id,files,locs added,locs removed,locs total,hunks,commit time,author time
4b825dc642cb6eb9a060e54bf8d69288fbee4904...9d7895c567e8f38abfff35da1b6d6d6a0a06f9aa,3,8,0,8,3,2009-02-16 00:02:00,2009-02-16 00:02:00
9d7895c567e8f38abfff35da1b6d6d6a0a06f9aa...61890720c8a22a7f1577327b32a180a2d267d765,5,993,0,993,5,2009-02-16 00:34:45,2009-02-16 00:34:45
61890720c8a22a7f1577327b32a180a2d267d765...6ded7fec5fb50c3d94e5b2abee49c93d93968fb8,3,73,65,138,19,2009-02-20 15:18:44,2009-02-20 15:18:44
6ded7fec5fb50c3d94e5b2abee49c93d93968fb8...4a5bab8ef62659f605f229fa6e21db776deb9ae5,1,6,5,11,5,2009-02-20 15:34:18,2009-02-20 15:34:18
4a5bab8ef62659f605f229fa6e21db776deb9ae5...7b7ceea4eca78cdbf63a01f3f7c8edcf36241026,3,51,113,164,6,2009-02-20 16:06:07,2009-02-20 16:06:07
7b7ceea4eca78cdbf63a01f3f7c8edcf36241026...b518ed9db20ef3f270732e4043aba2dccb930e64,2,7,2,9,3,2009-02-20 16:49:47,2009-02-20 16:49:47
b518ed9db20ef3f270732e4043aba2dccb930e64...74f4eb9a2e9e8756b195caaa9d678cbfea4aae06,5,36,88,124,17,2009-02-21 20:00:40,2009-02-21 20:00:40
74f4eb9a2e9e8756b195caaa9d678cbfea4aae06...cc1a61c1e7bd3050b9259163f6d8021a747bfa64,7,47,23,70,13,2009-02-22 16:46:11,2009-02-22 16:46:11
cc1a61c1e7bd3050b9259163f6d8021a747bfa64...096384ad5844ddf6ebeba9f98bbff03ea7396b3b,1,4,0,4,1,2009-02-22 16:50:43,2009-02-22 16:50:43
096384ad5844ddf6ebeba9f98bbff03ea7396b3b...90ea571602c4db8a25836ee53ab0c324e81ad72b,3,26,13,39,10,2009-02-22 17:17:02,2009-02-22 17:15:18
90ea571602c4db8a25836ee53ab0c324e81ad72b...d945ba68a29067a16391d319053cf2c0b6e70a66,6,248,672,920,25,2009-02-23 12:48:34,2009-02-23 12:48:34
d945ba68a29067a16391d319053cf2c0b6e70a66...f6b541bc373f84e9ef1e7e506968fc769b03962b,3,128,63,191,40,2009-02-23 20:04:30,2009-02-23 20:04:30
f6b541bc373f84e9ef1e7e506968fc769b03962b...aa72b99917f63382f6c549459e7569735d2b41c4,3,18,17,35,18,2009-02-23 20:53:03,2009-02-23 20:53:03
aa72b99917f63382f6c549459e7569735d2b41c4...1a71a3c9d49cb9298aea68b55dab4bdce524d929,2,11,5,16,6,2009-02-23 21:43:50,2009-02-23 21:43:50
1a71a3c9d49cb9298aea68b55dab4bdce524d929...2ee65b8ea25e767211eaad196fc02930c25c6190,2,129,10,139,12,2009-02-24 18:13:58,2009-02-24 18:13:58
2ee65b8ea25e767211eaad196fc02930c25c6190...bd136fae40c2351de29265b7e4d379cc7acb0384,2,22,46,68,2,2009-03-01 11:15:27,2009-03-01 11:15:27
bd136fae40c2351de29265b7e4d379cc7acb0384...1afe6d26dbcf76de15df7e2c8fc3aadbbb8b117d,7,268,37,305,23,2009-03-02 14:49:24,2009-03-02 14:49:24
1afe6d26dbcf76de15df7e2c8fc3aadbbb8b117d...19478ed4b14263c489e872156ca55ff16a07ebe0,8,355,208,563,66,2009-03-03 00:56:15,2009-03-03 00:56:15
19478ed4b14263c489e872156ca55ff16a07ebe0...f9374eeb778bcb000d6b0a717eba528bd691a51c,2,77,26,103,14,2009-03-03 01:15:26,2009-03-03 01:15:26
f9374eeb778bcb000d6b0a717eba528bd691a51c...f16e50d38713e89e02a4afbf69b23a55c0605740,1,81,71,152,5,2009-03-03 01:36:08,2009-03-03 01:36:08
f16e50d38713e89e02a4afbf69b23a55c0605740...a890b674061ff9e923a9f6bc106eadd4dab28649,5,381,212,593,26,2009-03-03 18:17:33,2009-03-03 18:17:33
a890b674061ff9e923a9f6bc106eadd4dab28649...e02b71ebe876afb66c325a55305e393a8fbcafe5,9,95,90,185,57,2009-03-03 23:33:55,2009-03-03 23:31:37
e02b71ebe876afb66c325a55305e393a8fbcafe5...dbbd25ae65d982524474b4f68d2e4350eedbf729,7,9,10,19,7,2009-03-04 09:08:33,2009-03-04 09:08:33
dbbd25ae65d982524474b4f68d2e4350eedbf729...559c1987bef279ae1dde466e3cf857b3720db4f8,1,2,0,2,1,2009-03-04 09:22:37,2009-03-04 09:22:37
559c1987bef279ae1dde466e3cf857b3720db4f8...9e5eff3b273ec51b2c17bf2c0727e9a375b62e1c,6,113,4,117,10,2009-03-04 10:35:43,2009-03-04 10:29:39
9e5eff3b273ec51b2c17bf2c0727e9a375b62e1c...8b71ba5e68347e5227823dff62eb7760d51f9d5b,3,22,2,24,3,2009-03-04 10:54:20,2009-03-04 10:54:20
8b71ba5e68347e5227823dff62eb7760d51f9d5b...ab248e8422b37c34cff90dba12bef8185386ed26,3,15,1,16,3,2009-03-04 11:04:04,2009-03-04 11:04:04
ab248e8422b37c34cff90dba12bef8185386ed26...02638103f79c96d60a4676b4ab120900c547c74c,2,359,0,359,2,2009-03-04 18:15:39,2009-03-04 18:15:39
02638103f79c96d60a4676b4ab120900c547c74c...4ea5ab63c1445ece928db723d8ee7f651d95ff7f,2,22,2,24,2,2009-03-04 18:16:07,2009-03-04 18:16:07
4ea5ab63c1445ece928db723d8ee7f651d95ff7f...93c7e88c879b02faac54e5c6c40b7281f30e025c,4,295,124,419,55,2009-03-05 12:41:10,2009-03-05 12:41:10
93c7e88c879b02faac54e5c6c40b7281f30e025c...e2d20fe2935156c3f367b8ba7e9c62205b953ae1,1,75,7,82,9,2009-03-05 12:57:09,2009-03-05 12:53:21
e2d20fe2935156c3f367b8ba7e9c62205b953ae1...bc1ebdf5a57fc9a513c4fd571984742493120020,2,62,39,101,17,2009-03-05 13:22:09,2009-03-05 13:22:09
bc1ebdf5a57fc9a513c4fd571984742493120020...db618cb7084926c151153bd6b19b716928a53eeb,3,12,7,19,5,2009-03-05 13:36:19,2009-03-05 13:35:54
db618cb7084926c151153bd6b19b716928a53eeb...ea728d35ef45882e2d8756d8a44da38fc971ee24,2,28,2,30,5,2009-03-05 13:46:40,2009-03-05 13:45:11
ea728d35ef45882e2d8756d8a44da38fc971ee24...16ef5029dee64e066505466f0d8223b18be6e883,2,44,0,44,6,2009-03-05 17:17:36,2009-03-05 17:17:36
16ef5029dee64e066505466f0d8223b18be6e883...b4985d1a6ed2887cd2669a0b9c7309fe027052ed,7,350,126,476,68,2009-03-06 18:49:52,2009-03-06 18:49:52
b4985d1a6ed2887cd2669a0b9c7309fe027052ed...64ac9efb3dd2bf86f2a43d153b6fbad751392779,4,63,138,201,31,2009-03-07 16:08:35,2009-03-07 16:08:35
64ac9efb3dd2bf86f2a43d153b6fbad751392779...5131e0a1ef735a10a6b1bacb8a86a0589455f3a7,1,108,68,176,10,2009-03-09 00:23:41,2009-03-09 00:23:41
5131e0a1ef735a10a6b1bacb8a86a0589455f3a7...e78917b3b0517d352c832fc9c3f5aeac9b2c2d99,1,8,18,26,2,2009-03-09 13:08:31,2009-03-09 13:08:31
e78917b3b0517d352c832fc9c3f5aeac9b2c2d99...a8ac42384d769ac0aefb81015a01c0cab0ba0e59,4,65,45,110,22,2009-03-09 13:09:09,2009-03-09 13:09:09
a8ac42384d769ac0aefb81015a01c0cab0ba0e59...7b45c911ef05ca69b111f2c071b6661354768b90,2,33,8,41,9,2009-03-09 16:26:46,2009-03-09 16:26:42
7b45c911ef05ca69b111f2c071b6661354768b90...5b08b827f9e41d6b28ebf7799758923bbb2b9a83,1,2,2,4,1,2009-03-09 17:21:59,2009-03-09 17:21:59
5b08b827f9e41d6b28ebf7799758923bbb2b9a83...1e5de42a75e229660145cff754991fdf09ba0c26,6,30,47,77,18,2009-03-13 11:22:35,2009-03-13 11:22:35
1e5de42a75e229660145cff754991fdf09ba0c26...adf18d84af42d2c8c32024b865714f9ae02bfe27,2,2,2,4,2,2009-03-15 08:44:26,2009-03-15 08:44:26
adf18d84af42d2c8c32024b865714f9ae02bfe27...55097bb572d9a6f9e5b3ed4ec9931d0977569718,3,13,11,24,10,2009-03-15 10:11:51,2009-03-15 10:11:51
55097bb572d9a6f9e5b3ed4ec9931d0977569718...742b221e4bbc46fd6e9ea6c60c0262d4e068c225,1,12,0,12,1,2009-03-15 11:31:35,2009-03-15 11:31:35
742b221e4bbc46fd6e9ea6c60c0262d4e068c225...fd52fa7c16ee537accd7d178985a23f2e54f2c90,1,13,0,13,2,2009-03-15 11:51:51,2009-03-15 11:51:51
fd52fa7c16ee537accd7d178985a23f2e54f2c90...878ca395b37fdcdbe23cdce903d6486b947048e1,1,4,0,4,1,2009-03-15 11:53:04,2009-03-15 11:53:04
878ca395b37fdcdbe23cdce903d6486b947048e1...2309196c34db62b96facf601f6b01a76a23deea8,1,15,1,16,4,2009-03-15 15:02:23,2009-03-15 15:02:23
2309196c34db62b96facf601f6b01a76a23deea8...c5183738388e8e5cbfcac7deccec1d960389ae9d,45,28836,0,28836,45,2009-04-03 11:43:03,2009-04-03 11:43:03
c5183738388e8e5cbfcac7deccec1d960389ae9d...1a126ed11c1ec1d10c4049c37ae4846c2b1a25b6,14,330,65,395,14,2009-04-04 12:50:15,2009-04-04 12:50:15
1a126ed11c1ec1d10c4049c37ae4846c2b1a25b6...0e9e927fcb71d44524340ae4f0392bd1dcced7fb,3,35,7,42,10,2009-04-04 14:53:43,2009-04-04 14:53:43
0e9e927fcb71d44524340ae4f0392bd1dcced7fb...63a9cd389773b0d986184f5989eeceb299b55ecd,17,1759,496,2255,55,2009-04-15 08:08:28,2009-04-15 08:08:28
63a9cd389773b0d986184f5989eeceb299b55ecd...e8ce6ef790ed791b98c797a75fbccb1b88c03cf0,3,217,14,231,17,2009-04-15 19:23:10,2009-04-15 19:23:10
e8ce6ef790ed791b98c797a75fbccb1b88c03cf0...0ab4f5c276dee2bee33e245ec3dcac3239ae15ad,2,0,572,572,2,2009-04-16 09:36:39,2009-04-16 09:36:39
0ab4f5c276dee2bee33e245ec3dcac3239ae15ad...7e1350f6e44a9f7b37b8fc1244dfe13c85488052,3,145,25,170,19,2009-04-16 09:37:44,2009-04-16 09:37:44
7e1350f6e44a9f7b37b8fc1244dfe13c85488052...844f923825cc8d548127fbc4fb77d93c5584749d,3,0,95,95,3,2009-04-16 11:20:02,2009-04-16 11:20:02
844f923825cc8d548127fbc4fb77d93c5584749d...86eab1f1310defaff7faec75998ca5daf2ca8f44,1,5,3,8,2,2009-04-16 11:20:22,2009-04-16 11:20:22
86eab1f1310defaff7faec75998ca5daf2ca8f44...470c6342ccb3c74c96e5764f0aaa9ebf6e1d2d94,2,53,65,118,23,2009-04-16 11:20:35,2009-04-16 11:20:35
470c6342ccb3c74c96e5764f0aaa9ebf6e1d2d94...c0b90ca763b3d619782e1ebb5cd761f81d4286c8,2,18,17,35,14,2009-04-16 11:42:34,2009-04-16 11:42:34
c0b90ca763b3d619782e1ebb5cd761f81d4286c8...e303d950d9d14b0a8597ee3b92365db1acc2733b,4,28,47,75,11,2009-04-16 11:58:10,2009-04-16 11:58:10
e303d950d9d14b0a8597ee3b92365db1acc2733b...12d31dd0b72131f3377b223ef731dc58b2ae0ac3,6,199,129,328,49,2009-04-16 18:09:55,2009-04-16 18:09:55
12d31dd0b72131f3377b223ef731dc58b2ae0ac3...c8e20fbf8114965013a5aa15abc198b94d265672,4,154,77,231,31,2009-04-16 19:05:41,2009-04-16 19:05:26
c8e20fbf8114965013a5aa15abc198b94d265672...e5a6b07d6aece6cff8492b6f763db4c427727d38,1,0,27,27,1,2009-04-16 19:40:25,2009-04-16 19:40:25
e5a6b07d6aece6cff8492b6f763db4c427727d38...dd691decd2845de001c61c82db4c8faf0b1a3c22,4,209,221,430,50,2009-04-17 16:54:29,2009-04-17 16:54:29
dd691decd2845de001c61c82db4c8faf0b1a3c22...5207226da36c73a72e69e701bfcea2b1907d6eae,4,23,9,32,17,2009-04-18 00:01:23,2009-04-18 00:01:23
5207226da36c73a72e69e701bfcea2b1907d6eae...e7dd20dc6e2888a2966bb3a5cbd73e0eb65fc3be,4,64,0,64,7,2009-04-18 08:58:41,2009-04-18 08:58:41
e7dd20dc6e2888a2966bb3a5cbd73e0eb65fc3be...e368571f462554caebaba70e2be9e4bb5264e876,1,5,14,19,6,2009-04-18 12:31:13,2009-04-18 12:31:13
e368571f462554caebaba70e2be9e4bb5264e876...102c6399ac342018c376f850290686bc0d13562f,1,41,41,82,4,2009-04-18 12:34:56,2009-04-18 12:34:30
102c6399ac342018c376f850290686bc0d13562f...67af958f812fd1e7aaa9e31b2cdb9f9809c66caf,7,44,25,69,23,2009-04-18 13:37:53,2009-04-18 13:35:42
67af958f812fd1e7aaa9e31b2cdb9f9809c66caf...c2decd720f5143e8553b3abbfc44147cc2308ce4,1,24,0,24,1,2009-04-20 00:54:36,2009-04-20 00:54:36
c2decd720f5143e8553b3abbfc44147cc2308ce4...93f7f0dca01ff00faf59e8c4e5dd01b043dee4f1,5,162,141,303,17,2009-04-20 00:55:08,2009-04-20 00:55:08
93f7f0dca01ff00faf59e8c4e5dd01b043dee4f1...64117d9c948e3e4fe0bf4baf2b9b13e36b63a003,1,12,33,45,10,2009-04-20 16:44:30,2009-04-20 16:44:30
64117d9c948e3e4fe0bf4baf2b9b13e36b63a003...7baacb56a9a0d93c3347d0e0f1c284b2d7b5fdda,1,2,0,2,1,2009-04-20 16:46:09,2009-04-20 16:46:09
7baacb56a9a0d93c3347d0e0f1c284b2d7b5fdda...f5b2a8f072ab8941eb5ac5fccb1fc8e1dcfc6c8b,8,0,189,189,8,2009-04-20 16:48:25,2009-04-20 16:48:25
f5b2a8f072ab8941eb5ac5fccb1fc8e1dcfc6c8b...ec9697b1ba442a21be2ad8046d96ace09ce95ac3,2,14,7,21,6,2009-04-21 11:51:05,2009-04-21 11:51:05
ec9697b1ba442a21be2ad8046d96ace09ce95ac3...408526a1c130dec847a50fb538657b70d6c45296,8,81,11,92,25,2009-04-21 11:52:21,2009-04-21 11:52:21
408526a1c130dec847a50fb538657b70d6c45296...a0f2b8a0c5da9de9d7f52ea0312b1a6ffc53277c,2,7,8,15,8,2009-04-21 12:38:55,2009-04-21 12:38:55
a0f2b8a0c5da9de9d7f52ea0312b1a6ffc53277c...47fad676b44976b2e8fc23450eaed4a538cc5c7a,4,37,53,90,25,2009-04-21 13:55:11,2009-04-21 13:55:11
47fad676b44976b2e8fc23450eaed4a538cc5c7a...5d57fa5060ff9d6a5c708ad4159fe582d146f700,2,75,118,193,32,2009-04-21 14:24:56,2009-04-21 14:22:14
5d57fa5060ff9d6a5c708ad4159fe582d146f700...d105d886254d0f36c958854f07fbb786c044779c,4,12,11,23,10,2009-04-21 14:30:47,2009-04-21 14:30:47
d105d886254d0f36c958854f07fbb786c044779c...707f244291ea098963e4226b2d9f5ed5c44a4991,3,186,236,422,58,2009-04-21 17:56:30,2009-04-21 17:56:30
707f244291ea098963e4226b2d9f5ed5c44a4991...1542fc6a0bf229f140f57742db2d9bbdd01400cb,4,108,46,154,32,2009-04-21 21:13:13,2009-04-21 21:13:13
1542fc6a0bf229f140f57742db2d9bbdd01400cb...140a032894512959c47b17482114fd30cb80f529,1,6,2,8,4,2009-04-21 21:36:01,2009-04-21 21:36:01
140a032894512959c47b17482114fd30cb80f529...822d7fa27e1c15b15df8fbe7204aa63f5f222cfb,4,134,30,164,29,2009-04-22 08:29:45,2009-04-22 08:29:45
822d7fa27e1c15b15df8fbe7204aa63f5f222cfb...5f902a61e1af296afec9af785856dd116bb1a570,1,73,8,81,10,2009-04-22 11:52:30,2009-04-22 11:52:30
5f902a61e1af296afec9af785856dd116bb1a570...3095861199f4efc2aae84707c033902fec87830b,1,2,2,4,2,2009-04-22 11:59:28,2009-04-22 11:59:28
3095861199f4efc2aae84707c033902fec87830b...c986b99ddc63945a845627a485ef8184c3372888,1,4,4,8,2,2009-04-22 12:01:45,2009-04-22 12:01:06
c986b99ddc63945a845627a485ef8184c3372888...48b4ac4a8d6e277e522687ee6ef914b698d6493f,1,5,1,6,4,2009-04-22 12:09:17,2009-04-22 12:09:17
48b4ac4a8d6e277e522687ee6ef914b698d6493f...d996b59d9c0d26b841be64ace39cc48040937438,3,36,13,49,19,2009-04-22 13:48:29,2009-04-22 13:48:29
d996b59d9c0d26b841be64ace39cc48040937438...63ec0454d257e21c31cbf8de4b70c5036c4cc726,2,49,2,51,2,2009-04-22 13:52:23,2009-04-22 13:52:23
63ec0454d257e21c31cbf8de4b70c5036c4cc726...f3f9a08de13383f61f301d268737deb20873b28c,1,7,6,13,8,2009-04-22 14:04:05,2009-04-22 14:04:05
f3f9a08de13383f61f301d268737deb20873b28c...e6d96e8e6665cc1d3c6c83dbe2dea3df42cd96c4,1,1,0,1,1,2009-04-22 14:05:14,2009-04-22 14:05:14
e6d96e8e6665cc1d3c6c83dbe2dea3df42cd96c4...7703ad5153d099d4f7cb85c4ef3815aa875d4786,5,44,10,54,10,2009-04-22 15:19:08,2009-04-22 15:19:08
7703ad5153d099d4f7cb85c4ef3815aa875d4786...a93cf503073ba0258c55dec4dc325bdc1509b739,4,0,12,12,4,2009-04-22 16:17:56,2009-04-22 16:17:56
a93cf503073ba0258c55dec4dc325bdc1509b739...40c0f755c998d2615fe8466aab20c6d81bd463e7,763,265280,22,265302,765,2009-04-22 17:35:47,2009-04-22 17:35:47
40c0f755c998d2615fe8466aab20c6d81bd463e7...c62b1240826b21fbafaefda698e57cbb6c8ac27c,178,44921,8,44929,185,2009-04-22 17:55:08,2009-04-22 17:55:08
c62b1240826b21fbafaefda698e57cbb6c8ac27c...8514e0627aa8b04a9c1b4d3d08164cb6ea0ff194,1,7,6,13,7,2009-04-22 23:14:11,2009-04-22 23:14:11
8514e0627aa8b04a9c1b4d3d08164cb6ea0ff194...0b1e3240be1534186b01261a6eaa8e389bb6a274,2,20,14,34,16,2009-04-23 10:10:57,2009-04-23 10:09:07
0b1e3240be1534186b01261a6eaa8e389bb6a274...a4593e3ebd0492edd7302b30f260b7fd211d1fca,4,43,25,68,19,2009-04-23 11:18:38,2009-04-23 11:18:38
a4593e3ebd0492edd7302b30f260b7fd211d1fca...8a8e9df72e23d2ef8ab071994351653f7fa506b6,3,8,4,12,4,2009-04-23 12:22:57,2009-04-23 12:22:57
8a8e9df72e23d2ef8ab071994351653f7fa506b6...0ea7577a725d27de30a4c2d6475728aa82158cb7,1,2,2,4,2,2009-04-23 13:07:54,2009-04-23 13:07:54
0ea7577a725d27de30a4c2d6475728aa82158cb7...29b528c980af1122df12843345a22e0a4ca9196a,3,28,21,49,11,2009-04-23 15:29:31,2009-04-23 15:29:31
29b528c980af1122df12843345a22e0a4ca9196a...f17ecf20befab4332d1a9cf5fdaa31b6f0f8c899,1,3,3,6,3,2009-04-23 17:04:01,2009-04-23 17:04:01
f17ecf20befab4332d1a9cf5fdaa31b6f0f8c899...8e7bbf26e2b5e616c61b896e7992af871c4fb94f,3,11,2,13,8,2009-04-23 17:26:56,2009-04-23 17:26:56
8e7bbf26e2b5e616c61b896e7992af871c4fb94f...90fc8d36220c0d66c352ee5f72080b8592d310d5,21,105,1573,1678,77,2009-04-28 20:37:03,2009-04-28 20:37:03
90fc8d36220c0d66c352ee5f72080b8592d310d5...cf1c58063e1ba07efcfc304a1f8372380b62cf95,13,67,50,117,48,2009-04-28 21:09:56,2009-04-28 21:09:56
cf1c58063e1ba07efcfc304a1f8372380b62cf95...064c8f0252026e892cae39dcaa9d89a6b932621a,4,72,101,173,42,2009-04-28 23:07:19,2009-04-28 23:07:19
064c8f0252026e892cae39dcaa9d89a6b932621a...f213a276572a02fa9997c6e0375dc6de1a7333ba,7,139,161,300,8,2009-04-29 09:00:46,2009-04-29 09:00:46
f213a276572a02fa9997c6e0375dc6de1a7333ba...0f5170339c0a504739b8de44eb8ca206a0340f94,7,15,67,82,14,2009-04-29 09:09:32,2009-04-29 09:09:32
0f5170339c0a504739b8de44eb8ca206a0340f94...cbd342a12db619dffb1154a9a35711cd048fe642,3,89,69,158,20,2009-04-29 12:00:22,2009-04-29 12:00:22
cbd342a12db619dffb1154a9a35711cd048fe642...fd392d0a50be985d0f1f57bf8b7acb3ae72e3da5,3,5,12,17,5,2009-04-29 12:05:25,2009-04-29 12:05:25
fd392d0a50be985d0f1f57bf8b7acb3ae72e3da5...3886e183fd5f2cf69f84f9829a39e96a905233ec,1,14,0,14,1,2009-04-29 12:12:24,2009-04-29 12:12:24
3886e183fd5f2cf69f84f9829a39e96a905233ec...15d24d8002ae92734a478e592a01234dffd0df2b,4,412,425,837,133,2009-05-02 14:34:24,2009-05-02 14:34:24
15d24d8002ae92734a478e592a01234dffd0df2b...1713386580d4247a583e1cfbfa94926b209b8aea,3,65,30,95,21,2009-05-02 23:01:42,2009-05-02 23:01:42
1713386580d4247a583e1cfbfa94926b209b8aea...13062832d8f8b68197933b3b9329e08936aee4fd,2,17,16,33,10,2009-05-02 23:06:21,2009-05-02 23:06:21
13062832d8f8b68197933b3b9329e08936aee4fd...bb6057d9ad16c15f14e8665e9df24a49e428d96a,3,13,13,26,9,2009-05-02 23:11:39,2009-05-02 23:11:39
bb6057d9ad16c15f14e8665e9df24a49e428d96a...5a071ad72fbfd04e9d67662f549e275b1b1f6576,32,7221,4011,11232,65,2009-05-03 12:09:16,2009-05-03 12:09:16
5a071ad72fbfd04e9d67662f549e275b1b1f6576...be6b3acf0e72808b4acc06ee775e0fb8476c0afd,6,211,16,227,20,2009-05-03 19:06:20,2009-05-03 19:06:20
be6b3acf0e72808b4acc06ee775e0fb8476c0afd...4860f1c92cb3ab111cc05d24ea7e5338e070779a,2,68,5,73,6,2009-05-03 19:37:10,2009-05-03 19:37:10
4860f1c92cb3ab111cc05d24ea7e5338e070779a...09c2ae5c3e85dfc8c6194bf48c6b1d6f81c1c24f,5,67,61,128,32,2009-05-04 10:08:13,2009-05-04 10:08:13
09c2ae5c3e85dfc8c6194bf48c6b1d6f81c1c24f...38726e7272662ae0e0c8215128129ea3fa61044a,5,100,77,177,39,2009-05-04 13:39:36,2009-05-04 13:39:36
38726e7272662ae0e0c8215128129ea3fa61044a...6149c6c49a1caed293bf88aa343ba6573301613d,3,15,14,29,7,2009-05-04 14:23:30,2009-05-04 14:23:30
6149c6c49a1caed293bf88aa343ba6573301613d...b763ee0ad457b1f7f3f80c6205bef0a483e3dfbc,1,21,12,33,5,2009-05-04 14:36:57,2009-05-04 14:36:57
b763ee0ad457b1f7f3f80c6205bef0a483e3dfbc...9c3770d999988a6543df3ee64019697f7649bbd8,5,101,20,121,25,2009-05-04 15:19:04,2009-05-04 15:19:04
9c3770d999988a6543df3ee64019697f7649bbd8...2e5b85a13bc71239ea318937622c8068699c425e,4,13,13,26,13,2009-05-04 15:38:17,2009-05-04 15:38:17
2e5b85a13bc71239ea318937622c8068699c425e...30450388d619788ca188183fb6fc15122ebf4f67,19,482,914,1396,191,2009-05-05 10:52:18,2009-05-05 10:52:18
30450388d619788ca188183fb6fc15122ebf4f67...cfd61622ae1808ed864829714b7c980c38c1c17c,7,134,41,175,52,2009-05-05 16:15:59,2009-05-05 16:11:04
cfd61622ae1808ed864829714b7c980c38c1c17c...ae7c6314cadff58d5688577af8bc364b58cb467f,3,30,12,42,11,2009-05-05 17:39:08,2009-05-05 17:39:08
ae7c6314cadff58d5688577af8bc364b58cb467f...0bb12be6609d1de3cb1b1dd929ed6f772dac256b,2,9,7,16,5,2009-05-05 19:16:19,2009-05-05 19:16:19
0bb12be6609d1de3cb1b1dd929ed6f772dac256b...a80591aff6704bd71ac5b136e23ddd7b52cf0299,3,202,127,329,21,2009-05-06 12:54:28,2009-05-06 12:54:28
a80591aff6704bd71ac5b136e23ddd7b52cf0299...9f2938b7134667d02f138d870df0d649e6f8337b,1,9,9,18,4,2009-05-06 13:03:13,2009-05-06 13:03:13
9f2938b7134667d02f138d870df0d649e6f8337b...62a14653323e2bfe4ec0950138581e67454518fd,1,43,11,54,11,2009-05-06 17:08:38,2009-05-06 17:07:43
62a14653323e2bfe4ec0950138581e67454518fd...103a8800c7bce44bf819523be553e10648cbcba8,2,98,49,147,22,2009-05-07 10:15:01,2009-05-07 10:15:01
103a8800c7bce44bf819523be553e10648cbcba8...ba179405519e64a2dd60d6b7722de02e36ea2e8b,5,119,68,187,22,2009-05-07 14:15:07,2009-05-07 14:15:07
ba179405519e64a2dd60d6b7722de02e36ea2e8b...43531093a307039bce83b925f874de1b0fc734f5,3,11,2,13,5,2009-05-07 14:32:36,2009-05-07 14:18:33
43531093a307039bce83b925f874de1b0fc734f5...55d840ea96f60b0e0ea6b57900a7bcc078d77143,2,4,0,4,3,2009-05-11 15:16:14,2009-05-11 15:16:14
55d840ea96f60b0e0ea6b57900a7bcc078d77143...421b9558887dc5d7bf7cee71c4108f3ccd5f994b,1,48,16,64,6,2009-05-11 16:54:52,2009-05-11 16:54:52
421b9558887dc5d7bf7cee71c4108f3ccd5f994b...918c71856a771a03f0ee4246b3792e65ac7455c3,1,43,7,50,5,2009-05-11 17:08:29,2009-05-11 17:08:29
918c71856a771a03f0ee4246b3792e65ac7455c3...7869ed6681e76f553f6380187e5349ee6854e207,2,17,7,24,6,2009-05-11 21:38:41,2009-05-11 21:38:41
7869ed6681e76f553f6380187e5349ee6854e207...3a41367c40863efc08d1f0922a91b5b0bdca6c80,251,15652,2807,18459,1592,2009-05-11 22:12:56,2009-05-11 22:12:56
3a41367c40863efc08d1f0922a91b5b0bdca6c80...15c1e0b0079e0fcfb4a01ac26dbd869b97e08e03,1,37,30,67,14,2009-05-12 01:46:04,2009-05-12 01:46:04
15c1e0b0079e0fcfb4a01ac26dbd869b97e08e03...94a182a2c8f970746b1c0d7bef4ddae7011a7f16,1,1,1,2,1,2009-05-12 01:46:30,2009-05-12 01:46:30
94a182a2c8f970746b1c0d7bef4ddae7011a7f16...4d39a3586c9df33ab22c7f59888c4497c9ab0e41,3,12,12,24,5,2009-05-12 09:39:42,2009-05-12 09:39:42
4d39a3586c9df33ab22c7f59888c4497c9ab0e41...b34792a480031f8c4b0d911eae25ea7bc99f4928,1,222,0,222,1,2009-05-13 15:46:00,2009-05-13 15:46:00
b34792a480031f8c4b0d911eae25ea7bc99f4928...d64a78ac46dd63595d092486617a77a102fa19c8,1,13,11,24,8,2009-05-13 19:37:01,2009-05-13 19:37:01
d64a78ac46dd63595d092486617a77a102fa19c8...f6c955b7f4310a03dc8a5d0a861948ba40f04af6,4,34,28,62,10,2009-05-13 19:42:18,2009-05-13 19:42:18
f6c955b7f4310a03dc8a5d0a861948ba40f04af6...3212b31ea1aadd5e87f0440cc25057629dd07b41,3,2,2,4,2,2009-05-13 19:43:24,2009-05-13 19:43:24
3212b31ea1aadd5e87f0440cc25057629dd07b41...740139408dae7d968966c57e13ee40afd35cacfb,3,39,40,79,23,2009-05-13 21:35:36,2009-05-13 21:35:36
740139408dae7d968966c57e13ee40afd35cacfb...8d00691f7843c3ef136919e5e996096def8d6046,1,4,2,6,4,2009-05-13 21:44:05,2009-05-13 21:44:05
8d00691f7843c3ef136919e5e996096def8d6046...427e3f5dcbcf67d35753a45d7b00cc1fcd47f56f,8,37,19,56,12,2009-05-14 11:16:45,2009-05-14 11:16:45
427e3f5dcbcf67d35753a45d7b00cc1fcd47f56f...4b2cd6f30595526c9cdeacfa6a61038100b511cc,1,2,2,4,1,2009-05-14 12:05:07,2009-05-14 12:05:07
4b2cd6f30595526c9cdeacfa6a61038100b511cc...028c278a054086c4a84f1ddb1654681b4ef70988,1,291,168,459,36,2009-05-14 13:55:28,2009-05-14 13:55:28
028c278a054086c4a84f1ddb1654681b4ef70988...28f86c7aa88d644bc6c65d7c4d63098f8c141884,2,73,4,77,8,2009-05-14 15:36:25,2009-05-14 15:36:25
28f86c7aa88d644bc6c65d7c4d63098f8c141884...dfde465483d0e4987ca711409a79607dbde236d5,1,0,11,11,1,2009-05-14 15:36:39,2009-05-14 15:36:39
dfde465483d0e4987ca711409a79607dbde236d5...de6036669d37b16fc9d169ff6f0eabd0c3f9b5b5,2,5,1,6,2,2009-05-14 16:37:53,2009-05-14 16:37:53
de6036669d37b16fc9d169ff6f0eabd0c3f9b5b5...31ba3cde17e8a164164319bfbfff6c65191e97e7,5,41,25,66,18,2009-05-14 18:34:14,2009-05-14 18:34:14
31ba3cde17e8a164164319bfbfff6c65191e97e7...73fb24f48d97e82cef816242b80f42087aebcaa4,6,139,124,263,65,2009-05-14 21:47:21,2009-05-14 21:47:21
73fb24f48d97e82cef816242b80f42087aebcaa4...febbf75302b51814861dace04c6b53c6dbdbcf78,3,36,6,42,18,2009-05-14 23:12:46,2009-05-14 23:12:46
febbf75302b51814861dace04c6b53c6dbdbcf78...589d8af5d4dbb64b75473c736ac7da8effde8870,4,23,5,28,8,2009-05-14 23:36:51,2009-05-14 23:36:51
589d8af5d4dbb64b75473c736ac7da8effde8870...81691c7dc5919cc04ff65ab354e47225604e1de1,2,9,10,19,6,2009-05-14 23:47:17,2009-05-14 23:47:17
81691c7dc5919cc04ff65ab354e47225604e1de1...baed9d514d0c145fdf696324601f67dda89adf3c,12,69,14,83,26,2009-05-15 14:28:10,2009-05-15 14:28:10
baed9d514d0c145fdf696324601f67dda89adf3c...fb96f07eceb57eaba3b43a781f8ea03682fd4705,4,149,9,158,12,2009-05-15 16:11:49,2009-05-15 16:11:49
fb96f07eceb57eaba3b43a781f8ea03682fd4705...2cb81113eccc0316db95bcdc52caecff53b585a8,2,31,2,33,4,2009-05-15 20:41:36,2009-05-15 20:41:36
2cb81113eccc0316db95bcdc52caecff53b585a8...91bd3124adf84c5cc572cf67cd55f548441f9599,2,27,8,35,6,2009-05-16 10:44:49,2009-05-16 10:44:49
91bd3124adf84c5cc572cf67cd55f548441f9599...175223d5d798e86b8c4d162e742a3a22d22ca3e4,4,15,20,35,16,2009-05-16 10:53:24,2009-05-16 10:49:33
175223d5d798e86b8c4d162e742a3a22d22ca3e4...9a63d8ec28b366d096411670f156003440f0bb5d,4,39,39,78,24,2009-05-16 10:54:44,2009-05-16 10:54:44
9a63d8ec28b366d096411670f156003440f0bb5d...9c0db09d950c3cd3a6f5403021b9ebd609294fc8,1,38,25,63,10,2009-05-16 11:53:18,2009-05-16 11:53:18
9c0db09d950c3cd3a6f5403021b9ebd609294fc8...d0b59619609fae6d82b95f075ab26c51745a3c25,4,132,117,249,64,2009-05-17 13:54:06,2009-05-17 13:54:06
d0b59619609fae6d82b95f075ab26c51745a3c25...478e45a32fa0a08e5a452b953fab751976523e6d,3,170,160,330,41,2009-05-18 10:44:01,2009-05-18 10:44:01
478e45a32fa0a08e5a452b953fab751976523e6d...69ab87ca53faae52555b3ced7659ba6c2ad73db4,3,63,6,69,7,2009-05-18 11:38:15,2009-05-18 11:38:15
69ab87ca53faae52555b3ced7659ba6c2ad73db4...310eed03e0051910c95d0bfb6d346589cfd768ab,3,41,19,60,12,2009-05-18 11:53:39,2009-05-18 11:48:58
310eed03e0051910c95d0bfb6d346589cfd768ab...9c70bf356be1a66d0abf70662f2894a97f7ad148,1,8,1,9,2,2009-05-18 12:02:50,2009-05-18 12:02:50
9c70bf356be1a66d0abf70662f2894a97f7ad148...edc38b4134e362138a505f2999d8049b735bd9f2,6,832,201,1033,49,2009-05-18 17:33:05,2009-05-18 17:33:05
edc38b4134e362138a505f2999d8049b735bd9f2...456bb1b9f81b7253b6339272eb11df371cb42216,1,59,75,134,17,2009-05-18 21:53:26,2009-05-18 21:21:11
456bb1b9f81b7253b6339272eb11df371cb42216...3bc73ba9674d0fda4dc04edbe08cfb92b15f2461,2,15,17,32,10,2009-05-18 22:01:11,2009-05-18 22:01:11
3bc73ba9674d0fda4dc04edbe08cfb92b15f2461...87e6578aa9e15c7c57cabc6562a8dc68aa04aff4,4,167,39,206,27,2009-05-19 11:12:46,2009-05-19 11:12:46
87e6578aa9e15c7c57cabc6562a8dc68aa04aff4...5dce17c5aae99885ffc595ee4d11e40d44924f72,2,2,7,9,4,2009-05-19 11:16:36,2009-05-19 11:16:36
5dce17c5aae99885ffc595ee4d11e40d44924f72...370056832227f7329fedb48f78990873a6fa9967,1,26,0,26,3,2009-05-19 12:46:07,2009-05-19 12:46:07
370056832227f7329fedb48f78990873a6fa9967...536eceaa2dbf9e3aa8e04998fab108c930df876d,5,79,18,97,13,2009-05-19 12:50:09,2009-05-19 12:49:28
536eceaa2dbf9e3aa8e04998fab108c930df876d...a5d50563273943a0747ec376f4ef2e7fe197a851,1,6,6,12,3,2009-05-19 14:19:47,2009-05-19 14:19:47
a5d50563273943a0747ec376f4ef2e7fe197a851...6a172d71199524af0fc3e5b75729b855502e25c9,5,70,27,97,29,2009-05-19 18:24:37,2009-05-19 18:24:37
6a172d71199524af0fc3e5b75729b855502e25c9...b9fedf05009c43173b6f3ab2fdc08ff8e55ecff3,1,4,1,5,2,2009-05-19 18:31:40,2009-05-19 18:31:40
b9fedf05009c43173b6f3ab2fdc08ff8e55ecff3...b445514898c200720400c04aeafc9fa326a966f4,1,0,1,1,1,2009-05-19 18:40:56,2009-05-19 18:40:56
b445514898c200720400c04aeafc9fa326a966f4...82e773630b38f4a5c0ec6eaf18c361fbe687fc15,4,67,5,72,10,2009-05-19 19:53:26,2009-05-19 19:53:26
82e773630b38f4a5c0ec6eaf18c361fbe687fc15...5e37dfca0251f8932b510c3a8bb3cb0aca58243c,3,28,21,49,7,2009-05-19 20:32:41,2009-05-19 20:32:41
5e37dfca0251f8932b510c3a8bb3cb0aca58243c...1b54e3d87d9cf9a3ef53bd95d69d49534b8cd077,4,32,48,80,7,2009-05-20 08:02:02,2009-05-20 08:02:02
1b54e3d87d9cf9a3ef53bd95d69d49534b8cd077...0ef5c99973f3596a481457e1d79e63e65ffc887f,3,6,16,22,5,2009-05-20 08:17:07,2009-05-20 08:17:07
0ef5c99973f3596a481457e1d79e63e65ffc887f...a1aecc9378e5d28f5c88de66499e82db6414b6f0,2,3,3,6,3,2009-05-20 08:28:10,2009-05-20 08:28:10
a1aecc9378e5d28f5c88de66499e82db6414b6f0...81b39a04cd92d2ff2fe6b7354461a4e990225a83,1,9,3,12,4,2009-05-20 11:00:20,2009-05-20 11:00:20
81b39a04cd92d2ff2fe6b7354461a4e990225a83...6a582a4d9a5fb0dce70252cfbb511d039370e3b2,1,62,73,135,14,2009-05-20 11:42:26,2009-05-20 11:42:26
6a582a4d9a5fb0dce70252cfbb511d039370e3b2...691467670dfd08f00fe482b8fbae7b03bb96c1a1,2,97,7,104,10,2009-05-20 14:05:11,2009-05-20 14:02:53
691467670dfd08f00fe482b8fbae7b03bb96c1a1...cb3a11d72a1e9735a5d3f1127993d740f56c686b,3,17,17,34,13,2009-05-20 14:06:08,2009-05-20 14:05:31
cb3a11d72a1e9735a5d3f1127993d740f56c686b...e787e11a1b168c48246807b6ec71b3e61816d9c6,1,74,12,86,7,2009-05-20 14:58:08,2009-05-20 14:58:08
e787e11a1b168c48246807b6ec71b3e61816d9c6...6244f7782209ec3bcd1d839e511d21564587d477,3,37,19,56,8,2009-05-21 10:33:57,2009-05-21 10:33:57
6244f7782209ec3bcd1d839e511d21564587d477...58c13e51924773e745d2fe70a7946341e1b31479,5,41,40,81,26,2009-05-21 10:49:41,2009-05-21 10:49:41
58c13e51924773e745d2fe70a7946341e1b31479...5c2389fada7e1e926d998f4c41ed5eeb82beb645,4,238,165,403,80,2009-05-25 11:17:35,2009-05-25 11:17:35
5c2389fada7e1e926d998f4c41ed5eeb82beb645...3eb4819db1e3cc1d41c369e7f4e96771ef6f6ed3,3,26,7,33,8,2009-05-25 11:38:36,2009-05-25 11:38:36
3eb4819db1e3cc1d41c369e7f4e96771ef6f6ed3...f3af6c6f531e5dbef144e2aa1f0ed2c3db75455a,1,22,14,36,7,2009-05-25 17:52:05,2009-05-25 17:52:05
f3af6c6f531e5dbef144e2aa1f0ed2c3db75455a...d1b0ce6d37accf5e0007df8f975d487f173b72fa,5,421,515,936,87,2009-05-26 01:30:51,2009-05-26 01:30:51
d1b0ce6d37accf5e0007df8f975d487f173b72fa...2fe090b7f6026d6b2a05f484f7e3c994d1892842,1,9,9,18,8,2009-05-26 01:37:18,2009-05-26 01:37:18
2fe090b7f6026d6b2a05f484f7e3c994d1892842...a9f29cd18d9ffccc90d7b7eb51162ff5d38b4a13,3,178,134,312,100,2009-05-26 09:39:40,2009-05-26 09:39:40
a9f29cd18d9ffccc90d7b7eb51162ff5d38b4a13...c326614c8d9f368cbb13c7547ed1fdf4ef7b9d0e,2,49,9,58,10,2009-05-26 10:11:31,2009-05-26 10:11:31
c326614c8d9f368cbb13c7547ed1fdf4ef7b9d0e...cf0eebf68545d09330e6ba101b82f62beee62543,1,157,23,180,17,2009-05-26 13:20:25,2009-05-26 13:20:25
cf0eebf68545d09330e6ba101b82f62beee62543...e8f177aa2d5b1e7e45d07df7e218482fb3b35d91,7,137,140,277,42,2009-05-26 15:48:59,2009-05-26 15:46:56
e8f177aa2d5b1e7e45d07df7e218482fb3b35d91...24ebd0360a2e9529600044bc46a574687595a1e3,2,21,6,27,7,2009-05-26 16:06:53,2009-05-26 16:06:53
24ebd0360a2e9529600044bc46a574687595a1e3...c4e53c7cebd68b4f6ba0214bae22dd63814b172c,1,13,10,23,4,2009-05-26 16:14:32,2009-05-26 16:14:32
c4e53c7cebd68b4f6ba0214bae22dd63814b172c...3bdd042a6e5077a43beaa4fe0608e998a33e1a6b,6,15,15,30,15,2009-05-26 16:18:17,2009-05-26 16:18:17
3bdd042a6e5077a43beaa4fe0608e998a33e1a6b...b260a9108b5f5a1809b89573350ce93d55099c83,7,482,62,544,18,2009-05-26 17:48:49,2009-05-26 17:48:49
b260a9108b5f5a1809b89573350ce93d55099c83...11b2e5dcc4b638805793c1d948ad491209510023,1,0,16,16,2,2009-05-26 18:35:42,2009-05-26 18:35:42
11b2e5dcc4b638805793c1d948ad491209510023...562db19d32d8ff9eaa6e8281dcd3298366247c4b,1,2,0,2,1,2009-05-26 23:35:54,2009-05-26 23:35:54
562db19d32d8ff9eaa6e8281dcd3298366247c4b...765815ba1f20a4d1c1ef1897a9fbdac0384bd8d6,2,42,0,42,2,2009-05-26 23:59:31,2009-05-26 23:59:31
765815ba1f20a4d1c1ef1897a9fbdac0384bd8d6...b3338273b4a28d91557f14c60d40f75cb0ab5bf1,3,846,840,1686,12,2009-05-27 12:53:36,2009-05-27 12:53:36
b3338273b4a28d91557f14c60d40f75cb0ab5bf1...1d8c4659d16d68d81726ecb1a944f7908df4f65a,3,27,28,55,18,2009-05-27 13:42:16,2009-05-27 13:42:16
1d8c4659d16d68d81726ecb1a944f7908df4f65a...a3627c06f8248b8c7a1580f2985f5b566fc12672,4,25,20,45,14,2009-05-27 14:29:55,2009-05-27 14:29:55
a3627c06f8248b8c7a1580f2985f5b566fc12672...80eed19612db0fe54191683e8a9f0bc5c1ca4ff6,2,7,2,9,2,2009-05-27 16:38:22,2009-05-27 16:38:22
80eed19612db0fe54191683e8a9f0bc5c1ca4ff6...d460bdd31f407d4f4775e7c045e13337f026d19f,1,6,4,10,2,2009-05-27 16:41:04,2009-05-27 16:41:04
d460bdd31f407d4f4775e7c045e13337f026d19f...d958befde10462d6e389d54f96d455eca5886bdc,1,0,0,0,0,2009-05-28 10:30:22,2009-05-28 10:30:22
d958befde10462d6e389d54f96d455eca5886bdc...3c701cb56d40ac42d6ee330d1cf7d15c4aae29d2,2,78,10,88,7,2009-05-28 11:45:18,2009-05-28 11:45:18
3c701cb56d40ac42d6ee330d1cf7d15c4aae29d2...34a6f10695e7ddc28de27a394e75f814a739a8a7,1,7,5,12,6,2009-05-28 12:47:16,2009-05-28 12:47:16
34a6f10695e7ddc28de27a394e75f814a739a8a7...247c9d2210663457dd1d4ac95758fd743b9eb823,1,0,1,1,1,2009-05-29 11:58:52,2009-05-29 11:58:52
247c9d2210663457dd1d4ac95758fd743b9eb823...aceb1987ed64b142595e7b74c88d6aff264e0144,1,0,33,33,2,2009-05-29 15:05:03,2009-05-29 15:05:03
aceb1987ed64b142595e7b74c88d6aff264e0144...272c4167da5263bd3ac715228394c5f5ebd79b21,1,13,8,21,8,2009-05-29 16:59:18,2009-05-29 16:59:18
272c4167da5263bd3ac715228394c5f5ebd79b21...7bd2282a9f8644621f21d798ed814ba53c788816,1,51,55,106,8,2009-05-30 16:14:26,2009-05-30 16:14:26
7bd2282a9f8644621f21d798ed814ba53c788816...d13d06467abb5cdfea2059f330c88730831eeda7,1,36,16,52,10,2009-05-30 17:36:41,2009-05-30 17:36:41
d13d06467abb5cdfea2059f330c88730831eeda7...739276b3a58f3a2b684d416ef0d4789263e54389,1,20,20,40,5,2009-05-31 12:24:10,2009-05-31 12:24:10
739276b3a58f3a2b684d416ef0d4789263e54389...4fbe15f065dfcc8de997e5ed32632e5d23ed3e64,1,1,1,2,1,2009-05-31 12:25:07,2009-05-31 12:25:07
4fbe15f065dfcc8de997e5ed32632e5d23ed3e64...ed283dc28000f2dc6f881803aa44fc8e65147c24,3,21,10,31,7,2009-06-01 10:56:28,2009-06-01 10:56:28
ed283dc28000f2dc6f881803aa44fc8e65147c24...8bf2a2fa55343fbecca934e8a78c241bfbcd81c0,2,11,3,14,4,2009-06-01 18:59:33,2009-06-01 18:59:33
8bf2a2fa55343fbecca934e8a78c241bfbcd81c0...d0988da515f1b497426f9dd8b05d56aaf917fbf6,1,7,8,15,5,2009-06-03 09:43:54,2009-06-03 09:43:54
d0988da515f1b497426f9dd8b05d56aaf917fbf6...b933743d83f4d86d297fb1d5fd72f7b4e9396428,1,4,3,7,4,2009-06-04 08:49:01,2009-06-04 08:49:01
b933743d83f4d86d297fb1d5fd72f7b4e9396428...8cfdd326a858262545dbf335da9ce0507145d8e5,4,38,11,49,9,2009-06-04 10:33:19,2009-06-04 10:31:45
8cfdd326a858262545dbf335da9ce0507145d8e5...c457b829e29574e9aeb7a71a6197b08deb06d485,2,11,1,12,3,2009-06-04 10:39:19,2009-06-04 10:36:08
c457b829e29574e9aeb7a71a6197b08deb06d485...c226f8176827067a0c1404655da1295f62cf0083,3,17,9,26,10,2009-06-04 13:44:38,2009-06-04 13:41:40
c226f8176827067a0c1404655da1295f62cf0083...9e6603476aa262bf92dd723cf8a224d76ca2db99,2,19,7,26,5,2009-06-05 08:38:41,2009-06-05 08:38:41
9e6603476aa262bf92dd723cf8a224d76ca2db99...bee7ef90bda9473b4e95072296806a198b1c8964,1,6,0,6,1,2009-06-05 10:27:09,2009-06-05 10:27:09
9e6603476aa262bf92dd723cf8a224d76ca2db99...565becb8ad61e41e3b21c9d23a45004951e7ec6e,2,998,812,1810,60,2009-06-05 10:23:51,2009-06-05 10:23:51
565becb8ad61e41e3b21c9d23a45004951e7ec6e...d04ef89758052eafd709bb5f8f0b2de7b6345083,1,6,0,6,1,2009-06-05 10:28:56,2009-06-05 10:28:56
1614f5104772d5d212c8dc515c956595a3b24612...6e4e22866514edf5cee35f78826f2f61c89b2485,1,15,14,29,6,2009-06-05 13:10:46,2009-06-05 13:10:46
6e4e22866514edf5cee35f78826f2f61c89b2485...5170823572927e8b71726cbbcb46a2e9576c4533,1,7,0,7,1,2009-06-05 13:18:05,2009-06-05 13:18:05
5170823572927e8b71726cbbcb46a2e9576c4533...5558bc4e6e166284d670d1346437d70f171502dc,4,31,5,36,7,2009-06-05 18:15:54,2009-06-05 18:15:54
5558bc4e6e166284d670d1346437d70f171502dc...887f05692353d01ec97e1e99ff34479a433ad985,2,11,4,15,3,2009-06-06 21:57:15,2009-06-06 21:57:15
887f05692353d01ec97e1e99ff34479a433ad985...b6fe4aec5017121fba5baebf50fc76f34d7eb626,13,153,162,315,33,2009-06-08 13:34:15,2009-06-08 13:30:10
b6fe4aec5017121fba5baebf50fc76f34d7eb626...f6a7fe26574defaa807a13248102ebe0f23270af,7,121,26,147,23,2009-06-08 14:17:33,2009-06-08 14:17:33
f6a7fe26574defaa807a13248102ebe0f23270af...696f02455792b368249bf9b013dde637b5ec31fd,310,13940,8075,22015,2547,2009-06-08 16:34:06,2009-06-08 16:34:06
696f02455792b368249bf9b013dde637b5ec31fd...8b49cef10b9edb97cf53511b7838ca94a47f0a18,12,109,95,204,53,2009-06-08 17:10:36,2009-06-08 17:10:23
8b49cef10b9edb97cf53511b7838ca94a47f0a18...8c146dfa0b6b2a79ab33e67e45a27691ebc7d785,1,2,2,4,2,2009-06-08 21:56:09,2009-06-08 21:56:09
8c146dfa0b6b2a79ab33e67e45a27691ebc7d785...ddac43f4ba0dc804626d84026b757503da70eacb,1,12,1,13,2,2009-06-09 08:06:04,2009-06-09 08:06:04
ddac43f4ba0dc804626d84026b757503da70eacb...dca7f7bada6488f1b9df75a102a55db0b0ca578d,1,54,0,54,1,2009-06-09 08:28:59,2009-06-09 08:28:59
dca7f7bada6488f1b9df75a102a55db0b0ca578d...90d584129d9ee0e695bf64d0db32c7fd3fd5e466,1,10,3,13,2,2009-06-09 11:59:13,2009-06-09 11:59:13
90d584129d9ee0e695bf64d0db32c7fd3fd5e466...88c04e74c99af8b0f05a7b01d14295270319f6db,2,55,4,59,4,2009-06-09 12:10:53,2009-06-09 12:10:53
88c04e74c99af8b0f05a7b01d14295270319f6db...4bd63d35fb917026b946c0a0db9d5e8329f6d021,4,179,46,225,28,2009-06-09 13:18:12,2009-06-09 13:18:12
4bd63d35fb917026b946c0a0db9d5e8329f6d021...44dc6735e3256e6fa381911a64068e622e384889,1,2,0,2,1,2009-06-09 13:20:10,2009-06-09 13:20:10
44dc6735e3256e6fa381911a64068e622e384889...2641582399ca941ac79c23f3de21955780793d6f,1,1,1,2,2,2009-06-09 15:47:42,2009-06-09 15:47:42
2641582399ca941ac79c23f3de21955780793d6f...0d780fe6b8734ac5179ad9f863593d976e6e304f,1,2,2,4,1,2009-06-10 13:24:14,2009-06-10 13:24:14
0d780fe6b8734ac5179ad9f863593d976e6e304f...00868b956534b767a36deee93b2ac64bd914dda5,1,0,28,28,4,2009-06-10 13:24:28,2009-06-10 13:24:28
00868b956534b767a36deee93b2ac64bd914dda5...080fa54a858a6abe6375f7bb11dc0eee7637d6c3,1,49,30,79,8,2009-06-10 16:29:59,2009-06-10 16:29:59
080fa54a858a6abe6375f7bb11dc0eee7637d6c3...4624906e2a97ca1ccf9d3c2865dd2b0d99880650,3,429,263,692,241,2009-06-10 16:56:37,2009-06-10 16:35:05
4624906e2a97ca1ccf9d3c2865dd2b0d99880650...6bfcfa7d7431f623500d3688b8dfc81b789ef16d,1,0,2,2,1,2009-06-10 17:05:54,2009-06-10 17:05:54
6bfcfa7d7431f623500d3688b8dfc81b789ef16d...2a7a2f671ac846b615749311e0c71d2034e4190a,1,25,0,25,1,2009-06-11 00:34:04,2009-06-11 00:34:04
2a7a2f671ac846b615749311e0c71d2034e4190a...f657a6324a08145263355c85dd37253c63c4c1b5,2,5,2,7,3,2009-06-11 09:42:43,2009-06-11 09:42:43
f657a6324a08145263355c85dd37253c63c4c1b5...452d3f141871722940b3be7e7a98a4bc527acbf7,1,7,5,12,4,2009-06-11 11:40:14,2009-06-11 11:40:14
452d3f141871722940b3be7e7a98a4bc527acbf7...728af1faa86ebb5130a3d9fee7f8bc3766f2129c,1,3,3,6,1,2009-06-11 11:40:25,2009-06-11 11:40:25
728af1faa86ebb5130a3d9fee7f8bc3766f2129c...1a1406c80e2b8bf2cdea35167d49ecc498dd21dd,1,1,1,2,1,2009-06-11 11:43:00,2009-06-11 11:43:00
1a1406c80e2b8bf2cdea35167d49ecc498dd21dd...4cfc982c776475eb65fb1080e6b575a86505a347,2,6,2,8,3,2009-06-11 11:54:03,2009-06-11 11:54:03
4cfc982c776475eb65fb1080e6b575a86505a347...1ec9f821e1de1f60149dda03f8693544a75d511c,1,1,1,2,1,2009-06-12 13:23:36,2009-06-12 13:23:36
1ec9f821e1de1f60149dda03f8693544a75d511c...3a0de007aacf065da92ce625ef9abf484ee16ba2,3,12,9,21,7,2009-06-12 13:26:06,2009-06-12 13:24:57
3a0de007aacf065da92ce625ef9abf484ee16ba2...fd83e1d7d801ad2c9c47127a8bbf38edb3449468,3,415,225,640,225,2009-06-12 15:27:44,2009-06-12 15:27:44
fd83e1d7d801ad2c9c47127a8bbf38edb3449468...825d7a8be83f2ef8956becad4cd42abb8c2a159b,2,0,7,7,2,2009-06-12 15:30:37,2009-06-12 15:30:37
825d7a8be83f2ef8956becad4cd42abb8c2a159b...916b9ca715b229b0703f0ed6c2fc065410fb189c,4,35,30,65,19,2009-06-12 15:37:43,2009-06-12 15:37:43
916b9ca715b229b0703f0ed6c2fc065410fb189c...f76c3dc3ca60e381cb22996f05ee139edc9e375b,2,5,1,6,2,2009-06-13 12:13:42,2009-06-13 12:13:42
f76c3dc3ca60e381cb22996f05ee139edc9e375b...6697cd0725166f7f572cbaecbe37635dd38cb9c7,3,18,12,30,9,2009-06-13 14:47:09,2009-06-13 14:47:09
6697cd0725166f7f572cbaecbe37635dd38cb9c7...9bcbcc4a7f647b95575b96af65ab8dda1eb52ed5,1,3,1,4,1,2009-06-13 14:50:37,2009-06-13 14:50:37
9bcbcc4a7f647b95575b96af65ab8dda1eb52ed5...dcf5e72036994873f0c911ae1f1bada51a33878c,2,31,24,55,8,2009-06-15 12:35:02,2009-06-15 12:35:02
dcf5e72036994873f0c911ae1f1bada51a33878c...870b5db46c1c39b8f11de54e273bb955bff040b5,5,39,60,99,18,2009-06-15 13:29:32,2009-06-15 13:24:55
870b5db46c1c39b8f11de54e273bb955bff040b5...7cce31d4e4c3b3c2b8cc29a34c2a853655f5d055,1,2,4,6,1,2009-06-15 14:57:10,2009-06-15 14:57:10
7cce31d4e4c3b3c2b8cc29a34c2a853655f5d055...7bad9dea513392b66b5b57d50ebb90122e7191df,1,13,7,20,5,2009-06-16 13:47:57,2009-06-16 13:47:57
7bad9dea513392b66b5b57d50ebb90122e7191df...3b05cf260ea2f1aa75b604724bb7437b669d2a40,4,42,26,68,15,2009-06-16 13:50:52,2009-06-16 13:50:52
3b05cf260ea2f1aa75b604724bb7437b669d2a40...225637a15c13c4e217314f2d3f50cb2b819798ee,1,48,10,58,10,2009-06-16 15:43:40,2009-06-16 15:43:40
225637a15c13c4e217314f2d3f50cb2b819798ee...193283bc381ff7b798e7bf5dff7d0a11e55e0b40,1,3,0,3,1,2009-06-16 15:47:59,2009-06-16 15:47:59
193283bc381ff7b798e7bf5dff7d0a11e55e0b40...40ee85242532b81dce7b64ed7e2357ca3a98cbc5,1,6,4,10,2,2009-06-16 17:32:31,2009-06-16 17:32:31
40ee85242532b81dce7b64ed7e2357ca3a98cbc5...194eeac0d9e607080d4f9bcf74a9470015931eef,1,35,0,35,1,2009-06-16 17:56:00,2009-06-16 17:56:00
194eeac0d9e607080d4f9bcf74a9470015931eef...d77f75774516fc9dfefe6c6523a94960df5100b5,2,15,7,22,6,2009-06-16 18:53:15,2009-06-16 18:53:15
7cce31d4e4c3b3c2b8cc29a34c2a853655f5d055...6b9e5eedf2fadbd192e9be522ea51bd8fd02bb71,1,18,0,18,1,2009-06-16 06:20:00,2009-06-16 06:20:00
d77f75774516fc9dfefe6c6523a94960df5100b5...b3b6f8c02efcd9f513045a6b532f51082e187f17,1,2,2,4,2,2009-06-17 08:16:48,2009-06-17 08:16:48
b3b6f8c02efcd9f513045a6b532f51082e187f17...27b268b8c13d4ca27a0755cc02446fb78886a3bf,3,58,56,114,19,2009-06-17 13:05:44,2009-06-17 13:05:44
27b268b8c13d4ca27a0755cc02446fb78886a3bf...84f9178e664e7a779cff10656848f89eb6795a73,109,6736,2046,8782,802,2009-06-17 16:15:28,2009-06-17 16:15:28
b581749255e76301ca88dac2d161f159b1e70800...79010540fccb7c4f6be34bfd76d2ce5c557a526e,1,23,0,23,1,2009-06-17 06:01:28,2009-06-17 06:01:28
79010540fccb7c4f6be34bfd76d2ce5c557a526e...ce85f84d152dde9dc2cead5a8e4889710b3f0a69,3,30,11,41,6,2009-06-17 06:52:47,2009-06-17 06:52:47
84f9178e664e7a779cff10656848f89eb6795a73...e30e4415eedfb7f97db5de0490b64f01e0f1d5fe,4,63,90,153,13,2009-06-18 12:34:49,2009-06-18 12:34:49
e30e4415eedfb7f97db5de0490b64f01e0f1d5fe...61fcbb1cd6947a21d92c109991451bfb4a3f5e20,2,95,0,95,1,2009-06-18 12:36:30,2009-06-18 12:36:30
61fcbb1cd6947a21d92c109991451bfb4a3f5e20...89d891f91215da941f4bf16585aeb6ba95be663e,1,12,8,20,4,2009-06-18 12:50:10,2009-06-18 12:50:10
89d891f91215da941f4bf16585aeb6ba95be663e...2b557c467f8411bbcf16bfe05e715821ecfe76ca,3,16,18,34,13,2009-06-18 12:58:17,2009-06-18 12:58:17
2b557c467f8411bbcf16bfe05e715821ecfe76ca...7ec90dbfd0aa8d36efc3f3e275b44281e1707286,1,3,20,23,3,2009-06-18 13:35:02,2009-06-18 13:35:02
7ec90dbfd0aa8d36efc3f3e275b44281e1707286...ec5f3dbae11ed121d24744861a8fce55636ecd66,2,5,1,6,2,2009-06-18 21:22:31,2009-06-18 21:22:31
ec5f3dbae11ed121d24744861a8fce55636ecd66...25d14bd0015b995913bfb5b9590ff5f0c9be09c1,1,4,0,4,2,2009-06-20 13:17:54,2009-06-20 13:17:54
25d14bd0015b995913bfb5b9590ff5f0c9be09c1...83cb156b6f77c11e2a2068e3b75b69c4eea2dfd2,4,273,0,273,5,2009-06-20 14:55:40,2009-06-20 14:44:06
83cb156b6f77c11e2a2068e3b75b69c4eea2dfd2...03c5772ce40f5415d25273aa3344bc68a91816cc,2,247,26,273,30,2009-06-21 11:10:00,2009-06-21 11:10:00
03c5772ce40f5415d25273aa3344bc68a91816cc...a78ea510a2f7a8f86ad00f7bf7c6202cd5aecc9f,2,15,4,19,4,2009-06-21 11:18:00,2009-06-21 11:18:00
a78ea510a2f7a8f86ad00f7bf7c6202cd5aecc9f...2fd4958698b6efa8b2f924ed28d3520806de1a38,2,27,4,31,7,2009-06-21 11:29:15,2009-06-21 11:29:15
2fd4958698b6efa8b2f924ed28d3520806de1a38...e39923a3d7a87ccd984bfafe3aacefe419a15cdb,2,28,11,39,8,2009-06-21 11:41:03,2009-06-21 11:41:03
e39923a3d7a87ccd984bfafe3aacefe419a15cdb...0f76d3e6d8b4dd4a072ec6655cdd298418567a14,1,137,0,137,2,2009-06-21 11:50:13,2009-06-21 11:50:13
0f76d3e6d8b4dd4a072ec6655cdd298418567a14...e71b089cd772754a54250d4c7fbb178a35d75006,1,26,0,26,1,2009-06-21 12:02:01,2009-06-21 11:57:23
e71b089cd772754a54250d4c7fbb178a35d75006...145072e73629b8b9b131b8a1117bb9d44a0fb155,1,15,0,15,1,2009-06-21 12:06:03,2009-06-21 12:06:03
145072e73629b8b9b131b8a1117bb9d44a0fb155...c5b5815ae7ff3767ec2d25bd3d02dae81b11e0e8,1,4,2,6,1,2009-06-21 12:07:52,2009-06-21 12:07:52
c5b5815ae7ff3767ec2d25bd3d02dae81b11e0e8...da03a02a98f67add4438002a3fb08510655f3507,1,61,0,61,2,2009-06-21 12:37:25,2009-06-21 12:34:13
3a44efea6915e93a4ae24634fffc0b9a6da8aebb...6550e8cfa07aab1c410ebb8d5b0676d625f93ea3,1,5,1,6,1,2009-06-21 14:28:23,2009-06-21 14:28:23
6550e8cfa07aab1c410ebb8d5b0676d625f93ea3...c192a1b5df977a412a6e7d49c0d0550dc58858f2,1,1,3,4,1,2009-06-21 14:28:58,2009-06-21 14:28:58
c192a1b5df977a412a6e7d49c0d0550dc58858f2...ad15067ea01bb619851ed7fb3e4b973046d02259,2,37,0,37,2,2009-06-21 14:40:08,2009-06-21 14:40:08
ad15067ea01bb619851ed7fb3e4b973046d02259...ea290e727de256a51f0a4ef9e4ff701da88f975c,5,20,11,31,11,2009-06-21 14:59:11,2009-06-21 14:59:11
ea290e727de256a51f0a4ef9e4ff701da88f975c...f17b76afa4082808919a554293fa03fa6fd7f0f0,1,49,9,58,12,2009-06-21 21:27:36,2009-06-21 21:27:36
f17b76afa4082808919a554293fa03fa6fd7f0f0...00d9b886c1458044cfb2cfa9ccd7b305c3d446e8,1,0,2,2,2,2009-06-21 21:28:12,2009-06-21 21:28:12
00d9b886c1458044cfb2cfa9ccd7b305c3d446e8...115c4942db4bd4a5ee99a83dc70c1c84574fe382,189,12,9,21,10,2009-06-22 11:08:32,2009-06-22 11:08:32
115c4942db4bd4a5ee99a83dc70c1c84574fe382...dce072a67e0f83e6ef45c5624e7a4410c8f796fb,2,51,55,106,33,2009-06-22 11:12:47,2009-06-22 11:12:47
dce072a67e0f83e6ef45c5624e7a4410c8f796fb...3fed1a095434877f6abe946ff6d788410b1dc66b,26,1455,229,1684,8,2009-06-22 12:08:42,2009-06-22 11:51:47
3fed1a095434877f6abe946ff6d788410b1dc66b...7703a4cacb3df41d2f1946997db6e87129d3c819,1,1,1,2,1,2009-06-22 12:15:10,2009-06-22 12:15:10
7703a4cacb3df41d2f1946997db6e87129d3c819...cc67d8efc765d37eae872431ffbf5e17210f62e1,3,6,5,11,5,2009-06-22 16:28:48,2009-06-22 16:28:48
cc67d8efc765d37eae872431ffbf5e17210f62e1...f56309deee758d7b113107d26cec20930f35966b,4,4,19,23,7,2009-06-22 17:32:42,2009-06-22 17:32:42
f56309deee758d7b113107d26cec20930f35966b...0ff62b2ea070aa4d1d3b11f6d7d71bc45643fecc,4,30,51,81,9,2009-06-22 17:48:02,2009-06-22 17:48:02
0ff62b2ea070aa4d1d3b11f6d7d71bc45643fecc...b9f3ae23cfffbeba5697b652689bc8e51bf0fe63,1,5,5,10,4,2009-06-23 08:26:17,2009-06-23 08:26:17
b9f3ae23cfffbeba5697b652689bc8e51bf0fe63...0e67b34c27755b5258c8a1600ca80b08979ff592,2,7,1,8,4,2009-06-23 09:27:18,2009-06-23 09:27:18
0e67b34c27755b5258c8a1600ca80b08979ff592...7363ccd27324c31e9fdab6c196fad9040136821f,3,113,32,145,23,2009-06-24 11:44:12,2009-06-24 11:44:12
7363ccd27324c31e9fdab6c196fad9040136821f...bdad5e7333b15a786cd999b411463ffba5e36592,1,8,6,14,3,2009-06-24 11:58:17,2009-06-24 11:58:17
bdad5e7333b15a786cd999b411463ffba5e36592...fbe0be19ebfb422d8fa20ea5204c1713e9214d5f,2,5,1,6,2,2009-06-24 14:43:37,2009-06-24 14:43:37
fbe0be19ebfb422d8fa20ea5204c1713e9214d5f...5b7fb1003ce4e45527dbfc38bd9d157efd0a3470,1,29,0,29,1,2009-06-26 22:11:20,2009-06-26 21:42:06
5b7fb1003ce4e45527dbfc38bd9d157efd0a3470...5ab93502d04657a0fdc08814970d875312912280,2,3,5,8,4,2009-06-26 22:13:37,2009-06-26 22:13:37
5ab93502d04657a0fdc08814970d875312912280...be963d68af4b22368a037cf490aff6898b238b92,1,19,6,25,2,2009-06-26 22:43:03,2009-06-26 22:43:03
be963d68af4b22368a037cf490aff6898b238b92...9615c93d2d27dd7e875b0578a9aa3622f97231e3,1,3,0,3,1,2009-06-26 22:49:47,2009-06-26 22:49:47
9615c93d2d27dd7e875b0578a9aa3622f97231e3...b77e603e04444e886ee298de8bfc95c8c4f0b6b5,1,12,4,16,4,2009-06-27 16:43:46,2009-06-27 16:26:25
b77e603e04444e886ee298de8bfc95c8c4f0b6b5...bd952ac61e2c8e57de0ae6db134ffe185db2ba3b,1,13,0,13,2,2009-06-27 17:06:29,2009-06-27 17:06:29
bd952ac61e2c8e57de0ae6db134ffe185db2ba3b...2ecd7ffe54160b81a42b2c053126fa3bbaa2d72f,8,146,63,209,32,2009-06-28 17:08:25,2009-06-25 17:13:20
2ecd7ffe54160b81a42b2c053126fa3bbaa2d72f...b4af3b9fb54f2c945f0e33484859de8cbea67f04,3,62,48,110,23,2009-06-28 17:08:25,2009-06-25 18:25:44
b4af3b9fb54f2c945f0e33484859de8cbea67f04...ed3d6a63d52b468506fcb71bc057fdcc49961757,16,138,162,300,50,2009-06-28 17:08:26,2009-06-26 10:51:27
ed3d6a63d52b468506fcb71bc057fdcc49961757...20c0e1fdfba2a237428332664a76b8b70e0dab9f,1,262,254,516,41,2009-06-28 17:08:26,2009-06-26 16:29:57
20c0e1fdfba2a237428332664a76b8b70e0dab9f...70fe920fb5fb3a50d75522ea4e5a558edcbd6ad9,8,103,149,252,40,2009-06-28 17:08:26,2009-06-26 16:30:55
70fe920fb5fb3a50d75522ea4e5a558edcbd6ad9...80bf451e6eed071b083a0058d8a77cc2edfc5336,2,13,33,46,9,2009-06-28 17:08:26,2009-06-26 23:02:03
80bf451e6eed071b083a0058d8a77cc2edfc5336...ed926da691b223c23e62f8e5cdf28152038ee2b9,12,74,76,150,60,2009-06-28 17:08:26,2009-06-27 18:40:43
ed926da691b223c23e62f8e5cdf28152038ee2b9...7cd09874c666f0ce64b1d7776de74f55ff3e53ab,4,70,3,73,6,2009-06-28 17:08:27,2009-06-28 10:40:20
7cd09874c666f0ce64b1d7776de74f55ff3e53ab...65324866bcfa72b8ed934e081ac7ef239f3a819b,13,416,255,671,112,2009-06-28 17:08:27,2009-06-28 17:05:58
65324866bcfa72b8ed934e081ac7ef239f3a819b...c9cb41cf8077cd36ee6dd498769c6d7aeadca942,1,1,1,2,1,2009-06-28 17:34:54,2009-06-28 17:34:54
c9cb41cf8077cd36ee6dd498769c6d7aeadca942...4787a41b848903f5016e341797cc45faf5ca28c8,2,2,2,4,2,2009-06-28 17:55:35,2009-06-28 17:55:35
4787a41b848903f5016e341797cc45faf5ca28c8...89320036a81e820e7b4f29279b5ed51191dab689,1,2,2,4,2,2009-06-28 17:58:13,2009-06-28 17:58:13
89320036a81e820e7b4f29279b5ed51191dab689...e876d6629e8682f5d818141bc0710f6d82311373,7,21,17,38,16,2009-06-28 18:11:55,2009-06-28 18:11:55
e876d6629e8682f5d818141bc0710f6d82311373...e763efdadf4bbd9c0155a4c7f782d271a2fd5814,162,54859,3108,57967,1047,2009-06-29 08:55:05,2009-06-29 08:55:05
e763efdadf4bbd9c0155a4c7f782d271a2fd5814...c2bdc01870939999193ea834052954c3fc444de2,1,1,2,3,3,2009-06-29 11:17:49,2009-06-29 11:17:49
c2bdc01870939999193ea834052954c3fc444de2...d428eff023046831bd40ca7b2e0ec9fb62c404fa,19,97,97,194,84,2009-06-29 11:18:30,2009-06-29 11:18:30
d428eff023046831bd40ca7b2e0ec9fb62c404fa...e7ad8ab4b0b0d5301a0e113e810ac4d7751c43c4,2,15,22,37,9,2009-06-29 12:11:01,2009-06-29 12:11:01
e7ad8ab4b0b0d5301a0e113e810ac4d7751c43c4...88ad880556673c06f44acacd5bf1c0eee8a71e52,1,24,0,24,1,2009-06-29 12:11:26,2009-06-29 12:11:26
88ad880556673c06f44acacd5bf1c0eee8a71e52...e4ba665c8784a0eac7af16927750aead76176705,2,6,6,12,6,2009-06-29 18:53:54,2009-06-29 18:53:54
e4ba665c8784a0eac7af16927750aead76176705...a623d763c189749ff8ce1f0cc25225be95686110,1,6,6,12,4,2009-06-29 19:17:06,2009-06-29 19:17:06
a623d763c189749ff8ce1f0cc25225be95686110...a3d77ee4e7662a0ccc2d9989359c441e680955c8,3,1018,1105,2123,5,2009-06-30 11:27:25,2009-06-30 11:27:25
a3d77ee4e7662a0ccc2d9989359c441e680955c8...d56552dc668ecd0759e9c0f76f5a4731ca2ee8c5,9,32,13,45,15,2009-06-30 11:46:35,2009-06-30 11:40:00
d56552dc668ecd0759e9c0f76f5a4731ca2ee8c5...8047b912c017c66b991f1735549a865f3d38db8d,5,17,17,34,11,2009-06-30 11:56:52,2009-06-30 11:56:52
8047b912c017c66b991f1735549a865f3d38db8d...7879e7fd25f69b6e91b85813d7a57c42efa60658,2,0,4,4,1,2009-06-30 11:58:30,2009-06-30 11:58:30
7879e7fd25f69b6e91b85813d7a57c42efa60658...94f03be7283401f5893a3801ac28d2191ace8ad5,1,55,0,55,1,2009-06-30 13:10:15,2009-06-30 13:10:15
94f03be7283401f5893a3801ac28d2191ace8ad5...813b53938b40484f63e7324c030e33711f26a149,4,25,2,27,4,2009-06-30 13:18:05,2009-06-30 13:18:05
813b53938b40484f63e7324c030e33711f26a149...0640517a919da3b0dae03a4ddf2f459c3bbfdb9c,1,1,1,2,1,2009-06-30 13:56:52,2009-06-30 13:56:52
0640517a919da3b0dae03a4ddf2f459c3bbfdb9c...4b9f26c51a25a07f314343b3f654ed3c048c4c8c,5,85,99,184,23,2009-07-01 00:33:08,2009-06-30 22:49:56
4b9f26c51a25a07f314343b3f654ed3c048c4c8c...1fc4dce08ba43c515e7bd708aeb276ec2452bcf0,13,134,202,336,34,2009-07-10 11:38:53,2009-07-10 11:38:53
1fc4dce08ba43c515e7bd708aeb276ec2452bcf0...22c3a1e2a5cb9b6fa06e822af74f54c39e4eb61c,5,26,27,53,24,2009-07-10 11:57:58,2009-07-10 11:57:05
22c3a1e2a5cb9b6fa06e822af74f54c39e4eb61c...51e77c37b5165aea7e0ce1cb8d67e9ee549975e4,2,7,2,9,3,2009-07-11 09:43:06,2009-07-11 09:43:06
51e77c37b5165aea7e0ce1cb8d67e9ee549975e4...c5ab0d5a806c3fe1099b46560297acbd359b76dc,17,1136,1029,2165,206,2009-07-13 14:38:25,2009-07-13 14:38:24
c5ab0d5a806c3fe1099b46560297acbd359b76dc...996d5ef5f10a26130eddf94dd508328fa1f04b34,2,8,3,11,4,2009-07-13 14:38:54,2009-07-12 09:48:37
996d5ef5f10a26130eddf94dd508328fa1f04b34...d4fcc0a753af01df137bebbcab6f2f79b2c145ed,1,5,0,5,1,2009-07-13 14:38:54,2009-07-12 09:49:37
d4fcc0a753af01df137bebbcab6f2f79b2c145ed...041af82b8c4d7655ee238e09259c4a69ed296583,6,37,20,57,27,2009-07-13 14:38:55,2009-07-12 13:02:13
041af82b8c4d7655ee238e09259c4a69ed296583...bf6a457f64d44fbd3cdd273559cad5dafd16676e,1,8,8,16,8,2009-07-13 14:38:55,2009-07-13 09:44:41
bf6a457f64d44fbd3cdd273559cad5dafd16676e...05d6319fa034b8ef4d26445c59e3049bde3c41fb,5,96,1,97,6,2009-07-13 14:38:55,2009-07-13 10:48:59
05d6319fa034b8ef4d26445c59e3049bde3c41fb...f99fbc61e1e1e357e63a45e0e323cff34a98537c,3,27,1,28,6,2009-07-13 14:38:55,2009-07-13 13:36:14
f99fbc61e1e1e357e63a45e0e323cff34a98537c...2819e3bcb8ae0ad5178c25ebea9ab704ccb67d61,2,3,7,10,4,2009-07-13 14:38:55,2009-07-13 14:35:48
2819e3bcb8ae0ad5178c25ebea9ab704ccb67d61...116069fab37d63fb17781335521942f3f5f44a8a,3,21,12,33,21,2009-07-13 22:00:07,2009-07-13 22:00:07
116069fab37d63fb17781335521942f3f5f44a8a...216e6204f072ebe826666fcef215e1383a54d29c,1,66,36,102,19,2009-07-14 10:03:47,2009-07-14 09:59:13
216e6204f072ebe826666fcef215e1383a54d29c...ef09b2c65dea6c2992d122f93c88dc743912fb06,2,262,282,544,65,2009-07-14 16:31:50,2009-07-14 16:31:50
ef09b2c65dea6c2992d122f93c88dc743912fb06...5e2a6f8c46ed2f13883b9f731bb181dc64a62a63,2,93,0,93,2,2009-07-15 05:54:08,2009-07-15 05:54:01
5e2a6f8c46ed2f13883b9f731bb181dc64a62a63...fc0222139338c54432c0cd2c1faca4c21d469cf7,1,0,1,1,1,2009-07-15 15:36:30,2009-07-15 12:36:38
fc0222139338c54432c0cd2c1faca4c21d469cf7...1b6bbc619dcaf5f97a2a18f29adf2e0146222640,3,71,1,72,3,2009-07-15 15:36:30,2009-07-15 15:00:15
1b6bbc619dcaf5f97a2a18f29adf2e0146222640...0292dea847920c728e7b0c51eef8e938c6da52fa,1,3,1,4,2,2009-07-15 15:52:11,2009-07-15 15:52:11
0292dea847920c728e7b0c51eef8e938c6da52fa...8b819d8546386378b25e759e65e0ee8025e8c4d4,1,3,3,6,2,2009-07-15 15:52:38,2009-07-15 15:52:38
8b819d8546386378b25e759e65e0ee8025e8c4d4...56c785ceae84a34f4e0a414032f1d4c6f5d8a5b5,2,17,47,64,22,2009-07-16 09:23:37,2009-07-16 08:59:40
56c785ceae84a34f4e0a414032f1d4c6f5d8a5b5...edbae656d63fd115281ee75f3d0096c9b133b03e,1,1,0,1,1,2009-07-16 13:43:03,2009-07-16 13:43:03
edbae656d63fd115281ee75f3d0096c9b133b03e...22e85cbc0b55f19a7adc679bb696caeb24fed6bc,1,1,1,2,1,2009-07-16 14:54:55,2009-07-16 14:54:55
22e85cbc0b55f19a7adc679bb696caeb24fed6bc...eb105536341a252c4997ce40ac336c8ecdb132ba,5,72,73,145,9,2009-07-16 15:19:36,2009-07-16 15:19:02
eb105536341a252c4997ce40ac336c8ecdb132ba...e7bbda0b7f13bd8aa98dff6f97db9afec13e3dbd,1,2,1,3,2,2009-07-20 10:52:03,2009-07-20 10:52:03
e7bbda0b7f13bd8aa98dff6f97db9afec13e3dbd...f4dfbe37a3f1fef2c91068958dfe1888ba100332,16,994,208,1202,192,2009-07-20 11:01:40,2009-07-20 11:01:40
f4dfbe37a3f1fef2c91068958dfe1888ba100332...88e9a5f122822b96e0ccfbba2083fe6ef43f3fdc,153,11061,4631,15692,1712,2009-07-20 11:18:42,2009-07-20 11:18:42
88e9a5f122822b96e0ccfbba2083fe6ef43f3fdc...2a695a9721016e0be5590cbfd6c070a2a00e2575,1,2,2,4,1,2009-07-20 16:19:13,2009-07-20 16:19:13
2a695a9721016e0be5590cbfd6c070a2a00e2575...b07dc31e1bbf93a098ce3e2422553b706a833fbf,1,1,1,2,1,2009-07-20 16:30:15,2009-07-20 16:30:15
b07dc31e1bbf93a098ce3e2422553b706a833fbf...e8a5d3d31141cca1bda02acd579da5a6eb5e4a44,2,4,4,8,4,2009-07-20 19:09:37,2009-07-20 19:07:34
e8a5d3d31141cca1bda02acd579da5a6eb5e4a44...b1588e78d97b6b1ed83e1afd3f84d99f7e0406a6,4,21,7,28,12,2009-07-20 19:22:19,2009-07-20 19:22:19
b1588e78d97b6b1ed83e1afd3f84d99f7e0406a6...0462b5d1ec55f601212c465059492f192f38f791,1,19,8,27,10,2009-07-23 16:35:03,2009-07-23 16:35:03
0462b5d1ec55f601212c465059492f192f38f791...dd1750f5730195ea6dfa70bf2b2d2ac47d83553b,1,2,2,4,2,2009-07-23 16:35:43,2009-07-23 16:35:43
dd1750f5730195ea6dfa70bf2b2d2ac47d83553b...646829262f2c33a84d1d4b892b0934e0ed93ba7f,1,2,1,3,1,2009-07-23 16:36:28,2009-07-23 16:36:28
646829262f2c33a84d1d4b892b0934e0ed93ba7f...78aaf8df67e75b1ce73da006fb383c4b8082f1f3,1,0,2,2,1,2009-07-23 23:15:21,2009-07-23 23:15:21
78aaf8df67e75b1ce73da006fb383c4b8082f1f3...50c0d16208aab392d815e420f3423d23283a31de,2,20,10,30,7,2009-07-24 13:11:18,2009-07-24 10:53:46
50c0d16208aab392d815e420f3423d23283a31de...d2222efc5ece379ccdb59c963c6e4ae592fb216f,1,3,0,3,1,2009-07-24 13:14:59,2009-07-24 13:14:59
d2222efc5ece379ccdb59c963c6e4ae592fb216f...854538d09440c4acc89dab7e9596995094ea8051,1,18,15,33,3,2009-07-24 18:20:01,2009-07-24 18:09:26
854538d09440c4acc89dab7e9596995094ea8051...b3e828991bf0b1033d75a0964b0aed6b9e713888,1,0,15,15,1,2009-07-24 18:42:54,2009-07-24 18:42:54
b3e828991bf0b1033d75a0964b0aed6b9e713888...4aac515202e6651d76d7a8355208fb9939ee53eb,2,0,2,2,2,2009-07-24 20:22:08,2009-07-24 20:22:08
4aac515202e6651d76d7a8355208fb9939ee53eb...842eaf446d2fdcb33b296c67c911c32a0dabc747,3,55,33,88,15,2009-07-24 20:23:50,2009-07-24 20:23:50
842eaf446d2fdcb33b296c67c911c32a0dabc747...0fb0af3a6c150df9ad1a0cc0cd73c97a5cb4ac13,12,306,306,612,239,2009-07-25 15:52:26,2009-07-25 15:52:21
0fb0af3a6c150df9ad1a0cc0cd73c97a5cb4ac13...d41197e02ca9be2cce585f7b0d015554f42e0ecf,1,0,0,0,0,2009-07-27 13:30:07,2009-07-27 13:30:07
d41197e02ca9be2cce585f7b0d015554f42e0ecf...77d407df2826b20e9177c26c0d2bb4481e497937,4,38,2,40,4,2009-07-27 13:48:16,2009-07-27 13:48:16
77d407df2826b20e9177c26c0d2bb4481e497937...41d89f611fef833daad5324cf638dd974a735c3a,46,9585,33,9618,80,2009-07-28 10:36:41,2009-07-28 10:29:18
41d89f611fef833daad5324cf638dd974a735c3a...4db8bb93758097dd63b9661ffdef80f312a95f04,1,23,27,50,3,2009-07-30 13:54:38,2009-07-30 13:54:38
4db8bb93758097dd63b9661ffdef80f312a95f04...5373c6869a8410e9a00771be09bc74cd17e9c843,3,42,23,65,11,2009-07-31 09:59:36,2009-07-31 09:59:36
5373c6869a8410e9a00771be09bc74cd17e9c843...2ebd6921510f9efbf1ef7eb6988ccecac25ee988,124,7951,2392,10343,893,2009-07-31 12:36:48,2009-07-31 12:36:48
2ebd6921510f9efbf1ef7eb6988ccecac25ee988...b27f8ba06d6c965056f9539660fb8704c6ca37f5,2,74,18,92,14,2009-07-31 16:34:27,2009-07-31 16:34:27
b27f8ba06d6c965056f9539660fb8704c6ca37f5...e25afc35bdb7b7b076f1ccba198a66e05921fb28,1,6,6,12,1,2009-07-31 16:49:30,2009-07-31 16:49:30
e25afc35bdb7b7b076f1ccba198a66e05921fb28...9d3ed1bb9231798df8a081746fd0dc75900d8276,2,48,1,49,2,2009-07-31 17:16:08,2009-07-31 17:16:08
9d3ed1bb9231798df8a081746fd0dc75900d8276...4f46c477734cfe9833562648c12a5c8f68404351,2,36,4,40,4,2009-07-31 17:48:19,2009-07-31 17:48:19
4f46c477734cfe9833562648c12a5c8f68404351...c745383b31a30ada8db79c653e9c3bf7d062cbe1,1,25,0,25,2,2009-07-31 18:01:49,2009-07-31 17:56:53
c745383b31a30ada8db79c653e9c3bf7d062cbe1...207bd3c76454cdc540a619b460c04e69bc3b0ca1,1,3,2,5,3,2009-08-01 10:58:39,2009-08-01 10:58:39
207bd3c76454cdc540a619b460c04e69bc3b0ca1...e10fbab00fd8325a7d05d1f854292143b8361e1f,4,22,2,24,4,2009-08-01 12:56:45,2009-08-01 12:56:45
e10fbab00fd8325a7d05d1f854292143b8361e1f...1bf9be6b374261a7fd4ac2cf5143d36268ed178f,3,4,3,7,3,2009-08-03 15:51:35,2009-08-03 15:51:35
1bf9be6b374261a7fd4ac2cf5143d36268ed178f...11df252cb93ca0934df8f1e5bebbe320787ea956,1,27,0,27,3,2009-08-03 16:21:34,2009-08-03 16:19:40
11df252cb93ca0934df8f1e5bebbe320787ea956...6acac912dd4da0479a0630a8d1b2878ca83b22de,1,3,0,3,1,2009-08-03 16:42:56,2009-08-03 16:39:37
6acac912dd4da0479a0630a8d1b2878ca83b22de...2312ff4b232a5931adcf01b4b9fec0f3ecc4f706,1,38,11,49,10,2009-08-04 10:05:59,2009-08-04 10:05:59
2312ff4b232a5931adcf01b4b9fec0f3ecc4f706...396ed96b2d43a41d40f4e5a80cc6d3bf8ed46720,4,115,72,187,54,2009-08-04 12:51:41,2009-08-04 12:44:40
396ed96b2d43a41d40f4e5a80cc6d3bf8ed46720...e111ccc014fdd332daf5496c03649bf009ce1da5,1,41,0,41,1,2009-08-05 09:17:26,2009-08-05 09:17:26
e111ccc014fdd332daf5496c03649bf009ce1da5...fb7dd029296e7c50b567b9ea41a90f05c4c246b5,1,2,0,2,2,2009-08-06 11:03:57,2009-08-05 13:33:42
fb7dd029296e7c50b567b9ea41a90f05c4c246b5...9b3baf3d508dbef355b2952b15b5dd3f854f92cb,2,34,1,35,2,2009-08-06 11:17:30,2009-08-06 11:17:30
9b3baf3d508dbef355b2952b15b5dd3f854f92cb...216fb3b9b2811444228d7af7a450839e58b80713,1,6,6,12,2,2009-08-06 11:29:24,2009-08-06 11:29:24
216fb3b9b2811444228d7af7a450839e58b80713...b849d50288a440fa6479f34f3caa56b8b57ce78f,2,0,7,7,3,2009-08-06 11:33:42,2009-08-06 11:33:42
b849d50288a440fa6479f34f3caa56b8b57ce78f...8bb8b4b570ab47a1423f79d35773428adac0137c,53,2256,231,2487,153,2009-08-06 11:36:45,2009-08-06 11:36:45
8bb8b4b570ab47a1423f79d35773428adac0137c...7946e98c1f08d49186e87c40ba9c0d974891e8e2,1,0,370,370,1,2009-08-06 11:59:09,2009-08-06 11:59:09
7946e98c1f08d49186e87c40ba9c0d974891e8e2...7464d423103b96c400d6875d390c19b637532ebf,4,24,2,26,4,2009-08-06 12:01:26,2009-08-06 11:59:38
7464d423103b96c400d6875d390c19b637532ebf...0486c091e1c82b182ae4ad3c0fee58d52dd5ce60,1,3,3,6,2,2009-08-06 13:08:07,2009-08-06 13:08:07
0486c091e1c82b182ae4ad3c0fee58d52dd5ce60...78024fa6894014f890248ca0021df01879de5cf9,1,1,4,5,1,2009-08-07 12:10:40,2009-08-07 12:10:40
78024fa6894014f890248ca0021df01879de5cf9...6ffe389c97f350e741437c2a68ac6e5da3a2c248,1,29,21,50,19,2009-08-07 13:45:11,2009-08-07 13:31:36
6ffe389c97f350e741437c2a68ac6e5da3a2c248...d8226af7f513ab32cef0844c4b9574abe8f9f016,5,948,883,1831,444,2009-08-07 16:25:25,2009-08-07 16:25:25
d8226af7f513ab32cef0844c4b9574abe8f9f016...abaab2ce9bd22755a6aabf650624b53f3c29f01b,1,1,1,2,1,2009-08-08 14:58:06,2009-08-08 14:58:06
abaab2ce9bd22755a6aabf650624b53f3c29f01b...65ec2d5db4901c45b028fbbf543d3a397076f368,1,10,5,15,6,2009-08-08 19:51:28,2009-08-08 19:51:28
65ec2d5db4901c45b028fbbf543d3a397076f368...75fc21537a408135a0147f97a9ef0de800bbbfc8,2,7,7,14,3,2009-08-09 16:04:10,2009-08-09 16:04:10
75fc21537a408135a0147f97a9ef0de800bbbfc8...ed8c43d2f3d20dec77a1206cfe80b8dfb5db5811,2,3,2,5,2,2009-08-09 16:10:16,2009-08-09 16:10:16
ed8c43d2f3d20dec77a1206cfe80b8dfb5db5811...7d60998ee1d06d9a03f69ac4ddc567a0183a8a59,6,489,496,985,323,2009-08-09 16:42:06,2009-08-09 16:27:56
7d60998ee1d06d9a03f69ac4ddc567a0183a8a59...94e87217716ad0dff7061591aaf2149b3b6011dd,4,91,1,92,7,2009-08-09 17:12:12,2009-08-09 16:49:51
94e87217716ad0dff7061591aaf2149b3b6011dd...0638a3a3ab680b99c36cc09904d10bbfd76c65ba,2,23,0,23,3,2009-08-09 17:16:25,2009-08-09 17:16:25
0638a3a3ab680b99c36cc09904d10bbfd76c65ba...738d20f6f02ac274abae0e178517c589e02533a4,3,79,6,85,8,2009-08-10 10:32:54,2009-08-10 10:14:41
738d20f6f02ac274abae0e178517c589e02533a4...ca0dda797a7282c9badaaeee80a24ba2ea56bee4,1,1,1,2,1,2009-08-10 10:46:22,2009-08-10 10:46:22
ca0dda797a7282c9badaaeee80a24ba2ea56bee4...4253baf4ab02c9700a9fe9e5440a9de35149e908,1,1,1,2,1,2009-08-10 10:54:57,2009-08-10 10:54:57
4253baf4ab02c9700a9fe9e5440a9de35149e908...3b0408ec1cbd7872aaf347c93674c33deb36f03f,7,652,693,1345,221,2009-08-13 11:47:16,2009-08-13 11:47:16
3b0408ec1cbd7872aaf347c93674c33deb36f03f...79ff085c4a7e4951158912ee502eef807233540c,52,7228,1231,8459,399,2009-08-13 11:52:47,2009-08-13 11:52:47
79ff085c4a7e4951158912ee502eef807233540c...af40ae6b8f9fd7b1e76f33beaf8df418bcd5f027,1,2,2,4,2,2009-08-13 13:03:28,2009-08-13 13:03:28
af40ae6b8f9fd7b1e76f33beaf8df418bcd5f027...dd5ae3183b090755feb8fa67c65de25197f3e8e0,1,0,0,0,0,2009-08-13 13:05:02,2009-08-13 13:04:24
dd5ae3183b090755feb8fa67c65de25197f3e8e0...9dc621f83a6ea79e95b7b9780df164df0b28bac7,21,325,109,434,61,2009-08-13 13:06:34,2009-08-13 13:06:34
9dc621f83a6ea79e95b7b9780df164df0b28bac7...b41ea5289e6d52ab350bb41857c65248bd29138f,20,6945,6509,13454,910,2009-08-13 13:07:37,2009-08-13 13:07:37
b41ea5289e6d52ab350bb41857c65248bd29138f...0f888ed6de153f68c17005211d7e0f960a5e34f3,4,27,2,29,4,2009-08-13 13:52:55,2009-08-13 13:52:55
0f888ed6de153f68c17005211d7e0f960a5e34f3...95f9209966f450e635939402d468311af6c74916,1,26,13,39,8,2009-08-14 10:43:46,2009-08-14 10:43:46
95f9209966f450e635939402d468311af6c74916...7aaab320b30738494359e49537c0a7e00921425f,10,23,22,45,20,2009-08-14 10:51:46,2009-08-14 10:51:46
7aaab320b30738494359e49537c0a7e00921425f...53b3d6be351907d2461f6a17d41932f24a7d8a61,1,1,1,2,1,2009-08-19 10:58:02,2009-08-19 10:56:06
53b3d6be351907d2461f6a17d41932f24a7d8a61...b590a45849307f5544b7a95854f45064527105ad,1,1,0,1,1,2009-08-19 11:29:22,2009-08-19 11:29:22
b590a45849307f5544b7a95854f45064527105ad...0cec74d03dc6a1735e731fe06056a1731e14c0df,110,6193,1307,7500,506,2009-08-19 14:37:15,2009-08-19 14:37:15
0cec74d03dc6a1735e731fe06056a1731e14c0df...368ea93bfea5c666e13118e78d2cab937cb692f3,13,1456,540,1996,267,2009-08-19 15:41:32,2009-08-19 15:28:41
368ea93bfea5c666e13118e78d2cab937cb692f3...90ac9ab078926fb11a3b1ce5f155caec230e0250,1,0,6,6,1,2009-08-19 15:46:44,2009-08-19 15:46:23
90ac9ab078926fb11a3b1ce5f155caec230e0250...048a1b8b9e5184f959ce924e76c61f8cd9e91089,33,726,145,871,134,2009-08-21 11:13:04,2009-08-21 11:13:04
048a1b8b9e5184f959ce924e76c61f8cd9e91089...f7f11352b7fc22d69eae22ed424cf1122245b77a,2,1,2,3,2,2009-08-21 12:47:33,2009-08-21 12:47:33
f7f11352b7fc22d69eae22ed424cf1122245b77a...ed3602dddcd0e7ddaedd8962252479ded992d95b,3,78,28,106,24,2009-08-21 12:53:58,2009-08-21 12:53:58
ed3602dddcd0e7ddaedd8962252479ded992d95b...8489bdbaeb07b18a736a438719adc8837c1908a0,1,3,4,7,2,2009-08-21 15:54:10,2009-08-21 15:54:10
8489bdbaeb07b18a736a438719adc8837c1908a0...a73998d6f491227e595524dc70589369fb458224,4,23,3,26,4,2009-08-21 16:03:15,2009-08-21 16:03:15
a73998d6f491227e595524dc70589369fb458224...a8813fcdf570843d428da9d08c806d28ee600300,5,16,4,20,6,2009-08-22 10:04:45,2009-08-22 10:04:45
a8813fcdf570843d428da9d08c806d28ee600300...9c97b1db3099d61cd292aa59ec2227a619f3a7ab,4,10,52,62,4,2009-08-22 11:07:31,2009-08-22 11:07:31
9c97b1db3099d61cd292aa59ec2227a619f3a7ab...316e2833f017150d58392f5ee82d86438ec22d5f,11,87,66,153,39,2009-08-23 10:32:49,2009-08-23 10:20:25
316e2833f017150d58392f5ee82d86438ec22d5f...1bbd5c6d556d4e3608121db35cf26e78c120e79c,1,2,0,2,1,2009-08-24 10:59:17,2009-08-24 10:59:17
1bbd5c6d556d4e3608121db35cf26e78c120e79c...4fab9dfc3650485a64947770ff985903639287ec,1,0,26,26,1,2009-08-24 11:00:45,2009-08-24 11:00:45
4fab9dfc3650485a64947770ff985903639287ec...69a9f66b070308a355308e31fcae80ad4f00f4bb,1,4,4,8,3,2009-08-24 11:02:55,2009-08-24 11:02:55
69a9f66b070308a355308e31fcae80ad4f00f4bb...0727fcc9edb35d1ce7fc9e3759e9755e78f7129a,1,1,1,2,1,2009-08-24 19:11:02,2009-08-24 14:51:37
0727fcc9edb35d1ce7fc9e3759e9755e78f7129a...17c6a67f15944962f27326072d9ea2df40ec0491,13,793,38,831,22,2009-08-24 19:20:26,2009-08-24 18:25:24
17c6a67f15944962f27326072d9ea2df40ec0491...8658999c7d0a722101765aa412e067dced82da6e,6,185,298,483,66,2009-08-24 23:06:49,2009-08-24 23:06:49
8658999c7d0a722101765aa412e067dced82da6e...82cb1b5acb53000690448bf3d9b5d1f40ee66f76,4,1,290,291,5,2009-08-24 23:18:44,2009-08-24 23:18:44
82cb1b5acb53000690448bf3d9b5d1f40ee66f76...19f182a39f90ec7ef16648cf6bc7dee213b74118,7,180,71,251,54,2009-08-25 02:25:35,2009-08-25 02:10:20
19f182a39f90ec7ef16648cf6bc7dee213b74118...aa664c80401508438b8570b0ca5b1012fbfc2eaa,1,10,0,10,6,2009-08-25 10:56:54,2009-08-25 10:56:54
aa664c80401508438b8570b0ca5b1012fbfc2eaa...b0a362a72734deb286830e26a3eb20e20234f3e9,1,28,22,50,8,2009-08-25 11:33:19,2009-08-25 11:33:19
b0a362a72734deb286830e26a3eb20e20234f3e9...b5b65ddcd776e59d35200105ed3420c04d07cae9,45,436,215,651,203,2009-08-25 11:47:18,2009-08-25 11:47:18
b5b65ddcd776e59d35200105ed3420c04d07cae9...b5a1585470ba4df54a01121798d99264b70a006e,6,107,83,190,16,2009-08-25 15:25:39,2009-08-25 14:23:01
b5a1585470ba4df54a01121798d99264b70a006e...db42ad959d5fa077e05015d56b0b374faf1d51cd,3,56,1,57,5,2009-08-25 15:28:06,2009-08-25 14:59:06
db42ad959d5fa077e05015d56b0b374faf1d51cd...8781b969e9f9150928adb9d3345faf9a1df725f3,1,5,5,10,4,2009-08-26 09:25:10,2009-08-25 22:55:43
8781b969e9f9150928adb9d3345faf9a1df725f3...51addf19d8dea396e4282d8fe050df86d46cadc1,1,21,17,38,9,2009-08-26 09:25:53,2009-08-26 09:25:53
51addf19d8dea396e4282d8fe050df86d46cadc1...18d051177784cad45fadb703e1a17a665fbc3a7b,4,120,54,174,10,2009-08-26 15:28:49,2009-08-26 15:12:44
18d051177784cad45fadb703e1a17a665fbc3a7b...7e7deed5106489f0ff2f8314c33311c0c75e7a45,1,4,0,4,1,2009-08-26 16:02:13,2009-08-26 16:01:54
7e7deed5106489f0ff2f8314c33311c0c75e7a45...79f121044cf9ad4a8c886353dcfcbaec983bf4c4,2,51,34,85,19,2009-08-26 20:14:01,2009-08-26 16:02:45
79f121044cf9ad4a8c886353dcfcbaec983bf4c4...31265be4a6584ff1b9a1ed0dedb5bc6c2f1c2e56,26,383,429,812,71,2009-08-26 20:14:44,2009-08-26 16:22:00
31265be4a6584ff1b9a1ed0dedb5bc6c2f1c2e56...6025da215351d43c711af56dcc2ef5b78b85618f,3,17,10,27,7,2009-08-26 20:14:44,2009-08-26 19:33:57
6025da215351d43c711af56dcc2ef5b78b85618f...723c7d9f7c4e5ba9600adae95bd481fad70a3d60,29,77,74,151,71,2009-08-26 20:14:44,2009-08-26 16:51:04
723c7d9f7c4e5ba9600adae95bd481fad70a3d60...116f4dea052c9d59f6666345ccde4af5774b1bc2,29,179,176,355,158,2009-08-26 20:14:45,2009-08-26 20:03:19
116f4dea052c9d59f6666345ccde4af5774b1bc2...ad9d683f9fe9eabe2d797bd6f2ffddf02b0ea009,13,106,104,210,75,2009-08-26 20:36:45,2009-08-26 20:11:51
ad9d683f9fe9eabe2d797bd6f2ffddf02b0ea009...00a03dfee2fa86c2aca569b0ef80769a7a19fa22,1,1,1,2,1,2009-08-27 10:23:53,2009-08-27 10:23:53
00a03dfee2fa86c2aca569b0ef80769a7a19fa22...31db4f1ed837f3835937f60d31368bdb31998386,4,29,5,34,4,2009-08-27 10:31:52,2009-08-27 10:31:52
31db4f1ed837f3835937f60d31368bdb31998386...2b6d72431b49adf49540ec5b1da98cd4cfff0b47,6,70,9,79,16,2009-08-27 14:08:40,2009-06-20 13:07:10
2b6d72431b49adf49540ec5b1da98cd4cfff0b47...4d92199d18bf025c859c98cdda765e73ab6c8fd6,2,41,0,41,5,2009-08-27 14:08:47,2009-08-26 23:11:16
4d92199d18bf025c859c98cdda765e73ab6c8fd6...b73264d9b3321208b591e257ab997b5532271c9d,4,42,12,54,11,2009-08-27 14:08:47,2009-08-27 00:15:11
b73264d9b3321208b591e257ab997b5532271c9d...a97dce7523c73b180d0b7c1eae9ef836f5df606e,5,84,34,118,32,2009-08-31 09:45:44,2009-08-31 09:14:34
a97dce7523c73b180d0b7c1eae9ef836f5df606e...18a192360440828aa5ae097dd9f176c5536a621d,1,1,1,2,1,2009-08-31 14:12:27,2009-08-31 14:12:27
18a192360440828aa5ae097dd9f176c5536a621d...7beea2cd5f0fe26f9e0fdc4bf487ec048363b1ab,8,169,33,202,46,2009-08-31 16:26:50,2009-08-31 16:15:27
7beea2cd5f0fe26f9e0fdc4bf487ec048363b1ab...afd9e714d3937288de51116a45234c1e86a9444f,2,30,17,47,12,2009-08-31 16:42:50,2009-08-31 16:22:09
afd9e714d3937288de51116a45234c1e86a9444f...3862fdade424793174a5bd2dba40f86c8f3f27c2,1,5,3,8,2,2009-08-31 16:48:47,2009-08-31 16:48:47
3862fdade424793174a5bd2dba40f86c8f3f27c2...fbf65b58f9702c57cfb202cfd2e71f9b1eebaad1,2,21,10,31,7,2009-08-31 16:57:01,2009-08-31 16:57:01
fbf65b58f9702c57cfb202cfd2e71f9b1eebaad1...8ea6adcae63d7114e9765d471168fb19d2818863,2,20,0,20,4,2009-09-01 09:39:30,2009-09-01 09:39:30
8ea6adcae63d7114e9765d471168fb19d2818863...8152f9cff221b1e10f0e0c2f49694e4571cb235e,4,15,43,58,11,2009-09-01 12:15:29,2009-09-01 12:15:29
8152f9cff221b1e10f0e0c2f49694e4571cb235e...ed9c3362ee57a1c1787381f4af0e40d9c903796e,3,2,25,27,7,2009-09-01 13:28:10,2009-09-01 13:28:10
ed9c3362ee57a1c1787381f4af0e40d9c903796e...78bb53b009e04c94f142aa3241b06c640395b170,1,1,0,1,1,2009-09-01 13:43:56,2009-09-01 13:43:56
78bb53b009e04c94f142aa3241b06c640395b170...97ce138621b375f24db98280972a56e063be0b1d,106,4662,997,5659,617,2009-09-02 09:13:46,2009-09-02 09:13:46
97ce138621b375f24db98280972a56e063be0b1d...82d986db2446651c28678fe07c31b4cc5e190f68,1,1,0,1,1,2009-09-02 18:18:57,2009-09-02 18:18:50
82d986db2446651c28678fe07c31b4cc5e190f68...8ddf930901c03a0a6c03b8da22da6f7b35f445af,3,28,11,39,10,2009-09-02 18:19:52,2009-09-02 18:19:52
8ddf930901c03a0a6c03b8da22da6f7b35f445af...aefbd57514160a8fa70e8dacbbf155e854cde6c4,4,70,3,73,11,2009-09-03 08:48:39,2009-09-03 08:38:49
aefbd57514160a8fa70e8dacbbf155e854cde6c4...342da6970159b280ec6fa1996afa0cb894d00998,1,74,0,74,1,2009-09-03 13:00:06,2009-09-03 13:00:06
342da6970159b280ec6fa1996afa0cb894d00998...1df6d612086bd24eb604f5f8064720294134e1e5,5,437,51,488,39,2009-09-03 13:59:48,2009-09-03 13:59:48
1df6d612086bd24eb604f5f8064720294134e1e5...1645b8f8b0cebd5b3e30dad02b0656b0e7b3d1d7,1,1,17,18,4,2009-09-03 14:01:45,2009-09-03 14:01:45
1645b8f8b0cebd5b3e30dad02b0656b0e7b3d1d7...c13773a71f68912f210f804fa6110c2a18aa1d3b,2,23,22,45,8,2009-09-03 16:12:50,2009-09-03 15:21:08
c13773a71f68912f210f804fa6110c2a18aa1d3b...747d6723aaa1bda543b8da40d8e279f8a1a080ff,4,290,297,587,58,2009-09-03 19:32:21,2009-08-25 00:29:45
747d6723aaa1bda543b8da40d8e279f8a1a080ff...9b3e2ae192e73f7ecc55e1686965a66c9a0107ff,4,79,0,79,6,2009-09-03 19:32:27,2009-09-03 19:29:20
9b3e2ae192e73f7ecc55e1686965a66c9a0107ff...3736bf9f4952c9e86decc8ee685cd671fe0234b2,3,30,0,30,5,2009-09-03 19:57:15,2009-09-03 19:57:15
3736bf9f4952c9e86decc8ee685cd671fe0234b2...b6eed30379e30b21894cadf7ea6e80f509e291a2,1,1,1,2,1,2009-09-03 19:59:31,2009-09-03 19:59:31
b6eed30379e30b21894cadf7ea6e80f509e291a2...1bd5277233b90a64c5f5e7590f49cf41ffcaa40d,1,30,0,30,1,2009-09-04 09:46:31,2009-09-04 09:46:31
1bd5277233b90a64c5f5e7590f49cf41ffcaa40d...2097b9d2e532624ab96cb548ac81d370bceea9fe,1,16,9,25,3,2009-09-04 09:46:56,2009-09-04 09:46:56
2097b9d2e532624ab96cb548ac81d370bceea9fe...733ee426dcb6a2d3a8210b9d283cc6d85ffc1f17,1,2,3,5,2,2009-09-04 10:15:21,2009-09-04 10:15:21
733ee426dcb6a2d3a8210b9d283cc6d85ffc1f17...734e86b9e568de5f694ae290a2b5c9395b70937c,4,36,13,49,12,2009-09-04 10:35:30,2009-09-04 10:35:30
734e86b9e568de5f694ae290a2b5c9395b70937c...9dbd92476e826e7f3b95921dd44297d6beaece50,2,37,2,39,2,2009-09-04 15:42:00,2009-09-04 15:35:38
9dbd92476e826e7f3b95921dd44297d6beaece50...485a9c148717b8e67376559b82ca833bbe7a0de0,1,1,1,2,1,2009-09-05 12:39:24,2009-09-05 12:32:19
485a9c148717b8e67376559b82ca833bbe7a0de0...ea29e137b5a9acda27bd9601448639aacfc1cd9e,2,30,0,30,6,2009-09-05 12:40:12,2009-09-05 12:13:06
ea29e137b5a9acda27bd9601448639aacfc1cd9e...ba6c5e38d54de30adfce69a21bafc81c35b07a03,4,11,5,16,4,2009-09-05 12:47:56,2009-09-05 12:47:56
ba6c5e38d54de30adfce69a21bafc81c35b07a03...2f46540d3037e1b91d0c86d00a19cf031a19b1b6,4,11,8,19,6,2009-09-07 10:53:44,2009-09-07 10:52:55
2f46540d3037e1b91d0c86d00a19cf031a19b1b6...94e627dc32e4d35837808ed416fcf090dc79d1ee,1,22,0,22,2,2009-09-07 10:54:08,2009-09-07 10:54:08
94e627dc32e4d35837808ed416fcf090dc79d1ee...86051ca5d23f50f746f39bba9a97f074aed8d16f,1,6,0,6,1,2009-09-07 10:56:10,2009-09-07 10:56:10
86051ca5d23f50f746f39bba9a97f074aed8d16f...0407145c11ae3bf28ce3d43a087df3bdfadc3f7f,1,2,0,2,2,2009-09-07 12:13:32,2009-09-07 12:13:01
0407145c11ae3bf28ce3d43a087df3bdfadc3f7f...1a2696f10a55f79cf5347066630da37503889615,2,7,36,43,6,2009-09-07 12:45:48,2009-09-07 12:20:41
1a2696f10a55f79cf5347066630da37503889615...063890b8da874eb191bbcf75732f376c5cc9f4f8,1,9,0,9,1,2009-09-07 12:46:56,2009-09-07 12:09:18
063890b8da874eb191bbcf75732f376c5cc9f4f8...6dd850aa16cb3161e1046840c204dba093e9f683,2,8,2,10,4,2009-09-08 12:59:43,2009-09-08 12:59:43
6dd850aa16cb3161e1046840c204dba093e9f683...21a1b045f5851180c5fddd454cf1a87e2c6242ef,6,140,212,352,19,2009-09-09 13:52:46,2009-09-09 13:51:49
21a1b045f5851180c5fddd454cf1a87e2c6242ef...8890070b88361c1fa7cc0d6f9ed9410a7dd0509a,5,104,7,111,11,2009-09-09 15:22:20,2009-09-09 15:22:20
8890070b88361c1fa7cc0d6f9ed9410a7dd0509a...393caeb4c926ec7a511b5845c5707c7b19cf8424,4,10,10,20,10,2009-09-09 15:35:59,2009-09-09 15:35:59
393caeb4c926ec7a511b5845c5707c7b19cf8424...efb2b703a655b29a692819c8bdb191792da6416e,1,2,0,2,1,2009-09-09 16:06:58,2009-09-09 16:06:58
efb2b703a655b29a692819c8bdb191792da6416e...fcff66bf29fef8a9d568ebb4cb7192ab32afe3f7,97,3184,981,4165,474,2009-09-09 20:01:54,2009-09-09 20:01:54
fcff66bf29fef8a9d568ebb4cb7192ab32afe3f7...d7e220cee1ac035dfaa742ffb2d671d709df8992,1,3,0,3,3,2009-09-09 20:39:27,2009-09-09 20:35:40
d7e220cee1ac035dfaa742ffb2d671d709df8992...2337630746d6c7e43a22250042ee997016428720,1,3,2,5,2,2009-09-10 10:34:51,2009-09-10 10:34:29
2337630746d6c7e43a22250042ee997016428720...8e5d4f9a69cc228afc377a8417bb98411a75cd9d,1,0,2,2,1,2009-09-10 10:41:18,2009-09-10 10:41:18
8e5d4f9a69cc228afc377a8417bb98411a75cd9d...68dda0a7d8939487c8191a5bdaae7af19d962482,11,22,12,34,11,2009-09-10 11:40:38,2009-09-10 11:40:38
68dda0a7d8939487c8191a5bdaae7af19d962482...dc39e8202456686513c43a4e2c4e5e505eb3a901,2,16,1,17,4,2009-09-10 12:07:35,2009-09-10 12:07:35
dc39e8202456686513c43a4e2c4e5e505eb3a901...3e4fc9f9667331c6039bb880e6f1a275c9a34ccb,1,2,0,2,1,2009-09-10 14:48:54,2009-09-10 14:48:38
3e4fc9f9667331c6039bb880e6f1a275c9a34ccb...241950c1dfd42b85d50a175c76efa275864b8ce7,5,152,19,171,15,2009-09-11 11:41:47,2009-09-11 11:41:47
241950c1dfd42b85d50a175c76efa275864b8ce7...d6c9d31cb5a343f8280035b1d3770e6d7c917201,2,110,144,254,67,2009-09-11 14:02:29,2009-09-11 14:02:29
d6c9d31cb5a343f8280035b1d3770e6d7c917201...1910c113cc4fa32254779607348b4103a1974666,1,12,5,17,5,2009-09-11 18:05:22,2009-09-11 18:05:22
1910c113cc4fa32254779607348b4103a1974666...8c41adb6288a3a4e7dd31c95d02d1828d2fafbcb,2,44,0,44,2,2009-09-11 18:32:24,2009-09-11 18:32:24
8c41adb6288a3a4e7dd31c95d02d1828d2fafbcb...412b4636c8b7edfa05b7cb97691a1ddb656cea55,10,421,1,422,10,2009-09-11 18:34:55,2009-09-11 18:34:55
412b4636c8b7edfa05b7cb97691a1ddb656cea55...d851bf9a66566daf9842b75d00a5449bc1ed0385,10,1,421,422,10,2009-09-11 18:47:45,2009-09-11 18:47:45
d851bf9a66566daf9842b75d00a5449bc1ed0385...d03c7e38e9dc6f02155617f10daf62e91a35bc35,3,3660,2,3662,4,2009-09-11 18:51:39,2009-09-11 18:51:39
d03c7e38e9dc6f02155617f10daf62e91a35bc35...5629fd574a01f2d932409b4008593cbf7d77fa74,3,15,20,35,6,2009-09-11 19:04:02,2009-09-11 19:04:02
5629fd574a01f2d932409b4008593cbf7d77fa74...12bb0d46ce761e3d00a27170e63b40408c15b558,5,30,9,39,6,2009-09-11 19:06:50,2009-09-11 19:06:50
12bb0d46ce761e3d00a27170e63b40408c15b558...97355f3613bb2c64ac2d6058c5ec73a26e1d7fef,3,33,33,66,31,2009-09-11 19:27:20,2009-09-11 19:27:20
97355f3613bb2c64ac2d6058c5ec73a26e1d7fef...dbe116ddfe877f49e3f4d61efcad58588864c545,10,35,45,80,28,2009-09-12 12:21:37,2009-09-12 11:01:03
dbe116ddfe877f49e3f4d61efcad58588864c545...227638bac135051ed22fe07f3c2e87452d5ecd02,11,344,434,778,198,2009-09-12 12:21:37,2009-09-12 12:18:42
227638bac135051ed22fe07f3c2e87452d5ecd02...bc6f381c98a624f600be451a1151f4b6c5741785,2,2,31,33,8,2009-09-12 12:22:57,2009-09-12 10:40:27
bc6f381c98a624f600be451a1151f4b6c5741785...69e8a01c58ff349e617375f67e837f99b008207d,3,9,5,14,7,2009-09-12 17:14:16,2009-09-12 17:14:16
69e8a01c58ff349e617375f67e837f99b008207d...8eb1294f87ca9e82c66d124762bd33430686108c,1,10,6,16,6,2009-09-13 10:44:09,2009-09-13 10:38:59
8eb1294f87ca9e82c66d124762bd33430686108c...ef300d19cbf6613f5521238bbc16d78eb26a0475,1,33,28,61,8,2009-09-13 15:43:19,2009-09-13 15:43:19
ef300d19cbf6613f5521238bbc16d78eb26a0475...d1a13bdd35e6a404b15d229fefdb361ac43a5d81,1,2,1,3,1,2009-09-13 16:19:03,2009-09-13 16:19:03
d1a13bdd35e6a404b15d229fefdb361ac43a5d81...0d1ec5fdbe8e9e162a527e8ce965e6ae680a8101,6,6,26,32,11,2009-09-13 16:31:17,2009-09-13 16:31:17
0d1ec5fdbe8e9e162a527e8ce965e6ae680a8101...f389f923b896c9c2d8a71b54b90a03cf3beafd3f,1,1,1,2,1,2009-09-13 21:44:56,2009-09-13 21:44:56
f389f923b896c9c2d8a71b54b90a03cf3beafd3f...4f98e2deb31ae015ce98e9503e73c20decddef8b,2,35,22,57,7,2009-09-14 14:25:41,2009-09-14 14:25:41
4f98e2deb31ae015ce98e9503e73c20decddef8b...5fdf9bbaa94fc9c91cf7c9aead81a3bc394e10b5,1,0,2,2,1,2009-09-14 14:34:31,2009-09-14 14:34:31
5fdf9bbaa94fc9c91cf7c9aead81a3bc394e10b5...7fa694a3b68b180e7b355787da74ee8943fca6d8,1,1,1,2,1,2009-09-14 20:44:25,2009-09-14 20:44:25
7fa694a3b68b180e7b355787da74ee8943fca6d8...fdc136df690d11a9b5b65ac58e9c1f420b24c274,3,54,3,57,6,2009-09-15 13:25:06,2009-09-15 13:25:06
fdc136df690d11a9b5b65ac58e9c1f420b24c274...083d150bc47bc7aadc5e8537e03c3df4c2056e09,5,126,1,127,6,2009-09-15 13:42:16,2009-09-15 13:42:16
083d150bc47bc7aadc5e8537e03c3df4c2056e09...16185ae57e11024ba0d35586eb0550e14782bd2b,3,12,16,28,6,2009-09-15 20:32:37,2009-09-15 20:32:37
16185ae57e11024ba0d35586eb0550e14782bd2b...9db2e5f375386a7ea8e31c5b86e120028e591bce,6,12,8,20,10,2009-09-15 20:41:25,2009-09-15 20:41:25
9db2e5f375386a7ea8e31c5b86e120028e591bce...e57c16bc2d72d23b2e897e3f79c4df607aa18a7b,1,23,0,23,1,2009-09-17 12:58:01,2009-09-17 06:28:31
e57c16bc2d72d23b2e897e3f79c4df607aa18a7b...b54fad9b3f5e19984a8e62b1337e12393afd3b10,1,8,1,9,3,2009-09-17 12:58:18,2009-09-17 12:58:18
b54fad9b3f5e19984a8e62b1337e12393afd3b10...6f31a3763d3520d8a3e030db783a251af2752b24,3,94,12,106,15,2009-09-17 13:15:05,2009-09-17 13:15:05
6f31a3763d3520d8a3e030db783a251af2752b24...605b7e9763c37f45c499d867f254345b56dfe9f6,2,2,0,2,2,2009-09-17 13:36:31,2009-09-17 13:36:31
605b7e9763c37f45c499d867f254345b56dfe9f6...ab530bb211148d89fc22ec2b2f2defe685f9aba9,56,1886,833,2719,343,2009-09-17 14:16:41,2009-09-17 14:16:41
ab530bb211148d89fc22ec2b2f2defe685f9aba9...5ddc4f5d0c002bac0ae3d62fc0dc58f0d2d83ec4,6,32,11,43,8,2009-09-18 16:32:25,2009-09-18 16:32:25
5ddc4f5d0c002bac0ae3d62fc0dc58f0d2d83ec4...c8b143bf30178bd8549af8a88f6a6f841fc0ae71,7,144,81,225,32,2009-09-19 15:21:12,2009-09-18 13:45:47
c8b143bf30178bd8549af8a88f6a6f841fc0ae71...389c80aece99f95c30662332af31fd113511dce3,1,3,1,4,1,2009-09-20 15:34:27,2009-09-20 15:34:27
389c80aece99f95c30662332af31fd113511dce3...3311122ccb63787288516df7f81cb9e52560efc0,1,7,1,8,1,2009-09-20 15:35:07,2009-09-20 15:35:07
3311122ccb63787288516df7f81cb9e52560efc0...949f24305b06617487d4d13b81d4ce756c6a224c,1,11,7,18,5,2009-09-20 15:40:14,2009-09-20 15:40:14
949f24305b06617487d4d13b81d4ce756c6a224c...7ddf1f569a809c746874d85527915ac68bc0510c,1,5,4,9,3,2009-09-20 16:03:55,2009-09-20 16:03:55
7ddf1f569a809c746874d85527915ac68bc0510c...4b8f503fac60623be3123dbf6421abb735ece7af,37,53,46,99,40,2009-09-20 16:19:33,2009-09-20 16:19:33
4b8f503fac60623be3123dbf6421abb735ece7af...cd70d4a9c073751796529cca3f09691a29d28126,2,166,0,166,2,2009-09-20 18:42:23,2009-09-20 18:40:20
cd70d4a9c073751796529cca3f09691a29d28126...2db7d6755e76a3fb9f54aa16378041d0a258be9a,2,1,1,2,1,2009-09-20 18:54:19,2009-09-20 18:54:19
2db7d6755e76a3fb9f54aa16378041d0a258be9a...07792afe0a443afa723ddb36650c96d4c5921f3b,14,189,281,470,62,2009-09-21 10:27:22,2009-09-21 10:27:22
07792afe0a443afa723ddb36650c96d4c5921f3b...a02ca7a590a9cb9ad76fe557e54a960a0452e90b,1,29,0,29,1,2009-09-22 10:15:49,2009-09-22 10:15:45
a02ca7a590a9cb9ad76fe557e54a960a0452e90b...8549994c4b9875403d6a6d183353c10d5a140af1,1,2,0,2,1,2009-09-22 15:28:04,2009-09-22 15:27:50
8549994c4b9875403d6a6d183353c10d5a140af1...663deb38282dccbc6002c413f565cdad50a4b86f,4,5,5,10,5,2009-09-22 22:17:49,2009-09-22 16:35:15
663deb38282dccbc6002c413f565cdad50a4b86f...76f4962636e434b91c9dea5de58d244f81db78ba,4,32,17,49,11,2009-09-22 22:17:50,2009-09-22 22:14:28
76f4962636e434b91c9dea5de58d244f81db78ba...be3dddeec9c970f5cc81b672a4cf034d917d450c,1,31,0,31,1,2009-09-23 09:25:31,2009-09-22 22:46:56
be3dddeec9c970f5cc81b672a4cf034d917d450c...2df13c73103d4bd95a5f4fec741e0ed2f17852f1,66,2564,569,3133,146,2009-09-23 12:49:51,2009-09-23 12:49:51
2df13c73103d4bd95a5f4fec741e0ed2f17852f1...e0ec0036ca2cee7317f63e6462b9631067cf1e38,8,58,3,61,14,2009-09-23 13:36:34,2009-09-23 13:35:03
e0ec0036ca2cee7317f63e6462b9631067cf1e38...c53aeb5a0258ae8715d2644ba3a03dfe3fb32bcb,1,12,5,17,3,2009-09-23 14:09:40,2009-09-23 14:09:40
c53aeb5a0258ae8715d2644ba3a03dfe3fb32bcb...8a5194b7cf2b355fc4e258dd3fd8258090d411b6,2,53,93,146,38,2009-09-23 14:33:24,2009-09-23 14:33:24
8a5194b7cf2b355fc4e258dd3fd8258090d411b6...106287c368b6eefee74a3cc3380bf87c947537ae,1,6,1,7,5,2009-09-23 14:40:04,2009-09-23 14:39:43
106287c368b6eefee74a3cc3380bf87c947537ae...a3229ed7b7abff0b617db4a1b75121befc20c68b,3,60,20,80,10,2009-09-23 14:53:34,2009-09-23 14:53:31
a3229ed7b7abff0b617db4a1b75121befc20c68b...8c7babdf10dde35c71d097130daa670cd52d1160,1,1,0,1,1,2009-09-23 14:58:28,2009-09-23 14:58:28
8c7babdf10dde35c71d097130daa670cd52d1160...2d256f34c5c8aa4243798e228052e7fa2d04632d,3,13,19,32,7,2009-09-23 15:00:20,2009-09-23 15:00:20
2d256f34c5c8aa4243798e228052e7fa2d04632d...55a2e8271edb613dd3532904c08e84616c3406af,4,8,8,16,8,2009-09-23 15:57:12,2009-09-23 15:54:38
55a2e8271edb613dd3532904c08e84616c3406af...ffded5ac86d603e2b254449ae9ab49af4acc6ce8,2,42,38,80,3,2009-09-23 22:56:24,2009-09-23 22:56:24
ffded5ac86d603e2b254449ae9ab49af4acc6ce8...cfffa0bdd8545224ffb17c7011471f28b6df70e8,1,4,26,30,3,2009-09-24 11:44:25,2009-09-24 11:44:25
cfffa0bdd8545224ffb17c7011471f28b6df70e8...2f56ccb45e87510de712f56705598b3b4e3548ec,6,26,11,37,8,2009-09-24 11:51:10,2009-09-24 11:51:10
2f56ccb45e87510de712f56705598b3b4e3548ec...6915188a461b455e7112634f7a72612a9c6de54d,1,156,18,174,12,2009-09-25 01:56:37,2009-09-25 01:56:37
6915188a461b455e7112634f7a72612a9c6de54d...7674bd500418cba020c69d0f5702ad45ec61d2a9,1,1,0,1,1,2009-09-25 02:53:11,2009-09-25 02:53:11
7674bd500418cba020c69d0f5702ad45ec61d2a9...028e24c9f587d2ae53d831e4198b5c3c701dfc57,1,4,0,4,1,2009-09-25 05:16:07,2009-09-25 05:16:07
028e24c9f587d2ae53d831e4198b5c3c701dfc57...0eb8d880f8b47c470e6bc164f9158685c10434dc,1,0,1,1,1,2009-09-25 06:40:47,2009-09-25 06:40:34
0eb8d880f8b47c470e6bc164f9158685c10434dc...45ea62a0f62a3421020f9da7b97119638b71bf4d,3,16,3,19,5,2009-09-26 13:11:31,2009-09-26 13:10:56
45ea62a0f62a3421020f9da7b97119638b71bf4d...5e7a8dc75ef2d23f0afc7c7024fe1131f6ec5353,1,4,0,4,4,2009-09-27 08:55:18,2009-09-27 08:45:52
5e7a8dc75ef2d23f0afc7c7024fe1131f6ec5353...9cd7864fd994dd2816ef54f3e21541c4d97323cd,1,2,2,4,2,2009-09-27 09:07:54,2009-09-27 09:07:54
9cd7864fd994dd2816ef54f3e21541c4d97323cd...4f69871c17bbc14d947be5447aedb94be86fa563,5,37,60,97,12,2009-09-27 10:33:44,2009-09-27 10:33:44
4f69871c17bbc14d947be5447aedb94be86fa563...3e7f0deef9c9c48de213d02f19e9d36bb6e2711a,1,2059,0,2059,1,2009-09-27 10:52:28,2009-09-27 10:52:28
3e7f0deef9c9c48de213d02f19e9d36bb6e2711a...27c750154e662f464493bee7d6b73b3945b83606,2,213,0,213,2,2009-09-27 14:58:56,2009-09-27 14:52:33
27c750154e662f464493bee7d6b73b3945b83606...c35dfdfd5e6c982af07476153ed41d690452cd79,1,0,1,1,1,2009-09-28 09:46:09,2009-09-28 09:46:09
c35dfdfd5e6c982af07476153ed41d690452cd79...7abad8b7b360bc328243475fa59b899fcb902c60,22,269,319,588,141,2009-09-28 10:06:30,2009-09-28 10:06:30
7abad8b7b360bc328243475fa59b899fcb902c60...f6657c3c9dd3e41df7147adc86ebc6469538e1ed,23,200,153,353,138,2009-09-28 10:36:36,2009-09-28 10:36:36
f6657c3c9dd3e41df7147adc86ebc6469538e1ed...83c9e6488923d9714202a9e40736923f344be1cf,1,1,1,2,1,2009-09-28 16:48:17,2009-09-28 16:47:45
83c9e6488923d9714202a9e40736923f344be1cf...0955b0c8de229f61f2e09e5e6fd68e25ce019b7b,1,69,0,69,1,2009-09-28 16:48:17,2009-09-28 15:44:52
0955b0c8de229f61f2e09e5e6fd68e25ce019b7b...095470854b48bc9f30c52a69a813945a9e908b61,16,99,73,172,73,2009-09-28 16:48:18,2009-09-28 14:08:09
095470854b48bc9f30c52a69a813945a9e908b61...459d644a5a99da3aa2b681a25e62c82e89b34710,1,0,1,1,1,2009-09-28 16:48:18,2009-09-28 14:13:33
459d644a5a99da3aa2b681a25e62c82e89b34710...c27d9f986a01b86d30b11fd20a3dbd43251ec13a,2,9,8,17,6,2009-09-28 16:48:18,2009-09-28 14:50:03
c27d9f986a01b86d30b11fd20a3dbd43251ec13a...23c7f472d066087d8053e31e3797a91053a79d9a,7,189,185,374,53,2009-09-28 16:48:18,2009-09-28 14:50:19
23c7f472d066087d8053e31e3797a91053a79d9a...835554c92b85e78a13498a428041f29962caaf3c,1,5,2,7,3,2009-09-28 16:48:19,2009-09-28 15:12:28
835554c92b85e78a13498a428041f29962caaf3c...27738d8e60bc57aac5dba25041faf413caefe1f8,6,145,25,170,26,2009-09-28 16:48:19,2009-09-28 15:37:34
27738d8e60bc57aac5dba25041faf413caefe1f8...9f07a690c6cb6d773e9e4c4a37e46a3732c9668c,4,63,1,64,5,2009-09-28 16:48:19,2009-09-28 16:03:43
9f07a690c6cb6d773e9e4c4a37e46a3732c9668c...b7526eb3244942bc17243f90b87d8426494d02f0,1,7,0,7,4,2009-09-28 16:48:19,2009-09-28 16:10:25
b7526eb3244942bc17243f90b87d8426494d02f0...e972add0ea6cc27848decff2c761452d75e42d0b,4,19,5,24,13,2009-09-28 17:44:40,2009-09-28 17:44:40
e972add0ea6cc27848decff2c761452d75e42d0b...4ba5b7e24b86cb533c61320656f94f0d72359d52,4,34,1,35,5,2009-09-28 20:16:43,2009-09-28 20:16:43
4ba5b7e24b86cb533c61320656f94f0d72359d52...18da8ffaeed3cf2bd3c5225a8f451db7e2883d73,1,45,2,47,3,2009-09-28 20:39:00,2009-09-28 20:39:00
18da8ffaeed3cf2bd3c5225a8f451db7e2883d73...cda659a8c8462f112d46c47029eefaaeae88b9b6,2,10,10,20,10,2009-09-29 16:06:14,2009-09-29 16:06:14
cda659a8c8462f112d46c47029eefaaeae88b9b6...1ae69a68a474f886d6fe39ebe176ff251f718c53,4,157,122,279,47,2009-09-29 16:06:36,2009-09-29 16:06:36
1ae69a68a474f886d6fe39ebe176ff251f718c53...a8c0211e73371a6783e5fccc90b494c6cdc8b88c,6,39,35,74,10,2009-09-29 17:28:54,2009-09-29 17:28:54
a8c0211e73371a6783e5fccc90b494c6cdc8b88c...45f540244660aed31d26eba38f8eda43519528e0,1,1,1,2,1,2009-09-29 23:38:07,2009-09-29 23:38:07
45f540244660aed31d26eba38f8eda43519528e0...7b337096c9d373617d8989c7afd67a4f4573ca9b,1,7,2,9,3,2009-09-30 09:55:03,2009-09-30 09:54:14
7b337096c9d373617d8989c7afd67a4f4573ca9b...9c9d67eb6ce1162c8da05ff59624f6c3ade19bf7,6,38,11,49,8,2009-09-30 21:21:25,2009-09-30 21:21:25
9c9d67eb6ce1162c8da05ff59624f6c3ade19bf7...bc9b343fd351ee47e1eb1330e0f31544902eadd7,1,4,0,4,1,2009-10-02 12:10:40,2009-10-02 12:10:40
bc9b343fd351ee47e1eb1330e0f31544902eadd7...763137e705376039f12d3927cfeb48e1dd7f2b40,1,1,1,2,1,2009-10-02 14:24:49,2009-10-02 14:24:49
763137e705376039f12d3927cfeb48e1dd7f2b40...84d2966377a757fca9760d3b8c57d5f2d74975e5,64,15737,1,15738,63,2009-10-02 15:05:42,2009-10-02 15:05:42
84d2966377a757fca9760d3b8c57d5f2d74975e5...b66c5c9808acc182cf16ad50e10db1900963fb3d,1,7,7,14,2,2009-10-03 12:45:35,2009-10-03 12:45:35
b66c5c9808acc182cf16ad50e10db1900963fb3d...602f9dbf3fb8da6af3339a27feb356ec286bd9fa,6,11,0,11,10,2009-10-03 13:08:03,2009-10-03 13:08:03
602f9dbf3fb8da6af3339a27feb356ec286bd9fa...eeaa267cbe6a3534dd8c21fa950521068a14ea34,5,444,6,450,11,2009-10-03 16:06:24,2009-10-03 14:40:06
eeaa267cbe6a3534dd8c21fa950521068a14ea34...6f17ca51c3303e86450206dee77c6969538b44a2,2,7,2,9,2,2009-10-03 17:09:00,2009-10-03 17:08:05
6f17ca51c3303e86450206dee77c6969538b44a2...861f28f37a2db115f598fc61553ac6e71853c495,3,65,140,205,4,2009-10-03 19:46:59,2009-10-03 19:46:59
861f28f37a2db115f598fc61553ac6e71853c495...bf0d278a4501b03e74d9e02309d667af2182c2a3,8,124,6469,6593,19,2009-10-03 20:48:33,2009-10-03 20:42:03
bf0d278a4501b03e74d9e02309d667af2182c2a3...13793aed2022c6884b7b8b4dac6c649c28f2c070,3,135,0,135,3,2009-10-03 20:48:44,2009-10-03 20:43:54
13793aed2022c6884b7b8b4dac6c649c28f2c070...39e6d959d74220762c20ae4d207972bc4a6118e9,2,51,0,51,2,2009-10-04 08:33:39,2009-10-04 08:33:39
39e6d959d74220762c20ae4d207972bc4a6118e9...5c9fe1fce11f25f4a73c6b7560802e6141a3e733,1,44,32,76,10,2009-10-04 09:14:39,2009-10-04 09:14:39
5c9fe1fce11f25f4a73c6b7560802e6141a3e733...7b8842b619a6b7eb235c2073d295571075f9fe5c,2,12,9,21,6,2009-10-04 09:50:53,2009-10-04 09:50:53
7b8842b619a6b7eb235c2073d295571075f9fe5c...e2b79024699c3f1171ef2f312067b0f05348e961,4,64,19,83,9,2009-10-04 10:19:01,2009-10-04 10:17:50
e2b79024699c3f1171ef2f312067b0f05348e961...bac16bd8ac27e1878e56826f8783b3f359614011,2,0,14,14,2,2009-10-05 11:04:21,2009-10-05 11:04:21
bac16bd8ac27e1878e56826f8783b3f359614011...4c51af882dfb4b32bff287575fbfd30f9a1d4bbb,1,1,1,2,1,2009-10-05 11:16:56,2009-10-05 11:16:56
4c51af882dfb4b32bff287575fbfd30f9a1d4bbb...522909bcbf6ff577ddf66b8c07148cf581615157,3,25,2,27,6,2009-10-05 12:52:26,2009-10-05 12:51:41
522909bcbf6ff577ddf66b8c07148cf581615157...8185e1fd2501d2d5001d254213c41002440ec7fc,46,136,93,229,68,2009-10-05 13:46:31,2009-10-05 13:46:31
8185e1fd2501d2d5001d254213c41002440ec7fc...3e9dd0e2e37fab21fb7eb406d50a12e82645876c,1,2,2,4,1,2009-10-05 17:15:38,2009-10-05 17:15:38
3e9dd0e2e37fab21fb7eb406d50a12e82645876c...a0c464638c3b04e22b38358b0526308b8dcd1c63,1,0,4,4,3,2009-10-05 18:29:59,2009-10-05 18:29:59
a0c464638c3b04e22b38358b0526308b8dcd1c63...d703813c27fbef30a3f9c7a63189365cc514db01,1,3,3,6,2,2009-10-05 18:35:05,2009-10-05 18:35:05
d703813c27fbef30a3f9c7a63189365cc514db01...78f8b6771cf1bb67b5380a75b45367600aee30d6,1,2,0,2,1,2009-10-05 18:35:48,2009-10-05 18:35:48
78f8b6771cf1bb67b5380a75b45367600aee30d6...d67288b64388f501c871c3ff264734a4418071ca,2,15,10,25,10,2009-10-05 19:01:30,2009-10-05 19:01:30
d67288b64388f501c871c3ff264734a4418071ca...ae6a1723085a7c66a34c3a07099847010a34be6a,1,1,3,4,2,2009-10-05 22:44:08,2009-10-05 22:43:56
ae6a1723085a7c66a34c3a07099847010a34be6a...2b994d9e3770fb5da9b062f287e0dff03e0b5a45,1,2,0,2,1,2009-10-06 08:45:18,2009-10-06 08:45:18
2b994d9e3770fb5da9b062f287e0dff03e0b5a45...39c61367a7d027de619aa89a43097d74ac5bc6bf,1,1,1,2,1,2009-10-06 14:28:52,2009-10-06 14:28:52
39c61367a7d027de619aa89a43097d74ac5bc6bf...82465fc4b1f458e0c211d280fc25be1b75982f05,7,93,18,111,21,2009-10-06 23:08:33,2009-10-06 23:04:27
82465fc4b1f458e0c211d280fc25be1b75982f05...f0682514940baa5d737065af6673b404221cb08c,5,140,0,140,6,2009-10-06 23:23:29,2009-10-06 00:56:33
f0682514940baa5d737065af6673b404221cb08c...1817d4b0626fda7821d8daf51db9559701603722,1,6,1,7,3,2009-10-06 23:35:21,2009-10-06 23:35:21
1817d4b0626fda7821d8daf51db9559701603722...3fd1cba073378277915d3defbc55021475764297,1,27,27,54,4,2009-10-07 00:03:24,2009-10-06 18:53:05
3fd1cba073378277915d3defbc55021475764297...abbc624f52defe1fcf3972eb5d0e7cb734f51705,4,41,12,53,16,2009-10-07 00:03:24,2009-10-06 19:38:35
abbc624f52defe1fcf3972eb5d0e7cb734f51705...1a2762b78e496dac4cc9fd0fb4ffb1d4f036692b,2,2,3,5,3,2009-10-07 08:24:50,2009-10-07 08:24:50
1a2762b78e496dac4cc9fd0fb4ffb1d4f036692b...1f31a7dbfe792fa6eee8a9cdcdfd662aad5cde06,123,3495,4380,7875,598,2009-10-07 09:53:45,2009-10-07 09:53:03
1f31a7dbfe792fa6eee8a9cdcdfd662aad5cde06...e982349b169d35cecb5219de3020ce728f72ad4a,1,2,2,4,2,2009-10-07 10:43:21,2009-10-07 10:43:21
e982349b169d35cecb5219de3020ce728f72ad4a...be2ca1ec8084cc7f5054795b3526d924f5acab3b,4,249,52,301,17,2009-10-07 13:02:42,2009-10-07 10:56:55
be2ca1ec8084cc7f5054795b3526d924f5acab3b...b76d853f0d6b75e3ae0f68413d108fbb91f38812,1,4,1,5,1,2009-10-07 13:39:39,2009-10-07 13:39:39
b76d853f0d6b75e3ae0f68413d108fbb91f38812...b404996cf3acf2bb9cdb80a2e540dbd8c64cf1b9,1,1,0,1,1,2009-10-07 14:01:03,2009-10-07 14:01:03
b404996cf3acf2bb9cdb80a2e540dbd8c64cf1b9...d03b67669c05338101ac460d170154a44c0cf9c5,9,127,46,173,14,2009-10-07 14:02:34,2009-10-07 14:02:34
d03b67669c05338101ac460d170154a44c0cf9c5...f623fd765813bba7d542e9ac9a8e2a8c2c16cba5,3,24,10,34,10,2009-10-07 14:56:19,2009-10-07 14:56:19
f623fd765813bba7d542e9ac9a8e2a8c2c16cba5...6219f2a2be07e0b428d8d4f14e2c4bd32001cb5b,1,2,14,16,3,2009-10-07 15:30:30,2009-10-07 15:21:39
6219f2a2be07e0b428d8d4f14e2c4bd32001cb5b...e46a832ded249b44ea94523a796c4e2847a104ab,1,1,9,10,1,2009-10-07 23:30:26,2009-10-07 23:30:26
e46a832ded249b44ea94523a796c4e2847a104ab...53ebe759301a0efe16855edf74793ae9284ca465,2,28,27,55,17,2009-10-08 21:20:14,2009-10-08 21:20:14
53ebe759301a0efe16855edf74793ae9284ca465...d85724d7414a08842e3e7a11eeb6dbf05335d451,1,8,3,11,2,2009-10-08 22:34:39,2009-10-08 22:34:39
d85724d7414a08842e3e7a11eeb6dbf05335d451...59b7a1bf26600f032f9d16b7753539b9c33cc8e7,1,3,0,3,1,2009-10-09 10:59:42,2009-10-09 10:49:48
59b7a1bf26600f032f9d16b7753539b9c33cc8e7...e742d077e0d3af74ebb6fd3413efb58aeff4160b,5,76,0,76,14,2009-10-09 11:26:23,2009-10-09 11:25:04
e742d077e0d3af74ebb6fd3413efb58aeff4160b...6325878d4328b7fbea7da1598b1210547104e9fe,1,4,0,4,1,2009-10-09 11:30:27,2009-10-09 11:30:27
6325878d4328b7fbea7da1598b1210547104e9fe...349200bd1cbb6f22e7240004fbd8fef2cc730702,1,1,0,1,1,2009-10-09 12:09:42,2009-10-09 12:09:42
349200bd1cbb6f22e7240004fbd8fef2cc730702...335d9af71fdfaf5b1ecb21705c621c0d9375a413,2,26,25,51,15,2009-10-09 12:18:10,2009-10-09 12:18:10
335d9af71fdfaf5b1ecb21705c621c0d9375a413...2060e32ec9dee243d007cd29a805ed0df3ea6a43,1,0,1,1,1,2009-10-09 12:21:41,2009-10-09 12:21:41
2060e32ec9dee243d007cd29a805ed0df3ea6a43...78d06eec0622cfbaf36dfb4fefaf0d87eff6bf3d,1,21,11,32,5,2009-10-09 12:55:29,2009-10-09 12:53:53
78d06eec0622cfbaf36dfb4fefaf0d87eff6bf3d...d979ac9c7f1b7395442e34da5e40ead24a74a552,1,9,2,11,6,2009-10-09 13:00:12,2009-10-09 13:00:12
d979ac9c7f1b7395442e34da5e40ead24a74a552...962e9291f7199c63b3f864b4078b9bdbedcfada6,1,1,1,2,1,2009-10-09 14:16:27,2009-10-09 14:16:27
962e9291f7199c63b3f864b4078b9bdbedcfada6...388145546ddca2d9424744bc359a0c924d7a3cd6,1,137,45,182,74,2009-10-09 15:44:59,2009-10-09 15:15:47
388145546ddca2d9424744bc359a0c924d7a3cd6...0ae02c9f04c6cc572de3fb59e889176fd9107fa4,1,1,0,1,1,2009-10-09 15:47:04,2009-10-09 15:47:04
0ae02c9f04c6cc572de3fb59e889176fd9107fa4...e7096fd769c060a0f596b0d642ce7c3b6ae65412,1,0,1,1,1,2009-10-09 15:49:29,2009-10-09 15:49:29
e7096fd769c060a0f596b0d642ce7c3b6ae65412...d79b6e9f7ffad4c6aabbe5bd89108e2005366469,4,32,5,37,4,2009-10-09 16:15:16,2009-10-09 16:10:59
d79b6e9f7ffad4c6aabbe5bd89108e2005366469...8b62e8616b9385fc15aa730a959941289170c251,2,8,6,14,7,2009-10-10 09:58:36,2009-10-10 09:58:36
8b62e8616b9385fc15aa730a959941289170c251...e7d0dcee10ea83d55ea8908e6fd490d4623c776d,1,4,0,4,1,2009-10-12 14:01:22,2009-10-12 14:01:22
e7d0dcee10ea83d55ea8908e6fd490d4623c776d...0dbf2d779259fa00adabbb6f33914492772747d4,3,101,0,101,4,2009-10-12 14:17:42,2009-10-12 14:09:15
0dbf2d779259fa00adabbb6f33914492772747d4...d949074014e69e660606396eaeaa4903c1cfeb6b,1,45,7,52,26,2009-10-12 14:46:18,2009-10-12 14:46:18
d949074014e69e660606396eaeaa4903c1cfeb6b...f09d0cd93c3458717b274d4e480861ce1cde1186,1,35,0,35,3,2009-10-12 15:07:17,2009-10-12 15:03:16
f09d0cd93c3458717b274d4e480861ce1cde1186...12c2ea05cab7bbfdea40fabe3e6771f91719bcc8,1,1,4,5,1,2009-10-12 19:09:26,2009-10-12 19:09:18
12c2ea05cab7bbfdea40fabe3e6771f91719bcc8...0329468e739161e0b4af6648c588b17d70490571,1,1,1,2,1,2009-10-12 20:23:17,2009-10-12 20:13:58
0329468e739161e0b4af6648c588b17d70490571...2b8ab7e24f2abc92474f44aad796b263582ab5d4,6,95,95,190,26,2009-10-13 17:55:28,2009-10-13 11:26:00
2b8ab7e24f2abc92474f44aad796b263582ab5d4...8bf9a42c700c2bb3f947e6ec37d7452c4b33468c,1,16,20,36,11,2009-10-13 17:55:33,2009-09-22 15:58:14
8bf9a42c700c2bb3f947e6ec37d7452c4b33468c...2b9a9f91401e4aa7b0f65acb35eb756c75b8863e,1,19,14,33,15,2009-10-13 17:55:33,2009-09-22 15:48:29
2b9a9f91401e4aa7b0f65acb35eb756c75b8863e...fd189c8a73a6eaccba5b27b07e0de8de035ad9df,1,23,0,23,2,2009-10-13 17:55:34,2009-10-13 17:45:13
fd189c8a73a6eaccba5b27b07e0de8de035ad9df...d2f5094096b7e40f8ee5f2243d00f34e8e90db6c,1,1,1,2,1,2009-10-14 12:21:30,2009-10-13 18:08:53
d2f5094096b7e40f8ee5f2243d00f34e8e90db6c...a1e5089d9b2f3af61da5a7231e328dc49b05aebe,2,25,1,26,5,2009-10-14 15:07:50,2009-10-14 15:07:50
a1e5089d9b2f3af61da5a7231e328dc49b05aebe...2dbd0d3806bde4c68374b7de4474d1e1a2257221,3,50,0,50,5,2009-10-14 16:51:23,2009-10-14 16:50:51
2dbd0d3806bde4c68374b7de4474d1e1a2257221...0283e681294276682bf91e0f70440b7012bb08b1,3,57,50,107,47,2009-10-14 17:29:17,2009-10-14 17:28:51
0283e681294276682bf91e0f70440b7012bb08b1...334d56d2be31f31b436683331b6fda14578f96d0,4,81,36,117,8,2009-10-15 12:40:52,2009-10-14 21:56:12
334d56d2be31f31b436683331b6fda14578f96d0...3456a16f711cdcace89687ebab6416d77f9aff9a,4,43,11,54,7,2009-10-15 13:45:04,2009-10-15 13:45:04
3456a16f711cdcace89687ebab6416d77f9aff9a...b893859c34f05db5c45f416949ebc0eee665cca6,13,3176,2998,6174,1475,2009-10-15 17:18:18,2009-10-15 17:18:18
b893859c34f05db5c45f416949ebc0eee665cca6...5f82c4baf0e5aadb86f6bfc7f54f8e534ae0338a,2,79,35,114,9,2009-10-16 12:29:51,2009-10-16 11:46:16
5f82c4baf0e5aadb86f6bfc7f54f8e534ae0338a...8e6d978bba0f3c52b297573157e4547ed9d291d1,132,7981,2226,10207,1015,2009-10-16 12:30:27,2009-10-16 12:05:12
8e6d978bba0f3c52b297573157e4547ed9d291d1...cfe5876350024790d2b0c84a9564dac8f9848182,2,2,2,4,2,2009-10-16 16:00:06,2009-10-16 15:59:54
cfe5876350024790d2b0c84a9564dac8f9848182...4bcb01c8bf6ec1074592a691cbadd2dc50ead35a,1,8,2,10,3,2009-10-16 20:53:44,2009-10-16 20:53:44
4bcb01c8bf6ec1074592a691cbadd2dc50ead35a...04e53cab90d14ee668e7e63e54a8ef9f4a8b564d,8,10,9,19,10,2009-10-25 21:51:57,2009-10-25 21:51:10
04e53cab90d14ee668e7e63e54a8ef9f4a8b564d...7d9d881e227e59d10d8210775573164b3dbd0b43,1,2,15,17,4,2009-10-26 21:27:52,2009-10-26 21:27:52
7d9d881e227e59d10d8210775573164b3dbd0b43...9a70abbf1378060d1b46240eed0dcd0dffd526ff,1,1,1,2,1,2009-10-26 22:07:37,2009-10-26 22:07:37
9a70abbf1378060d1b46240eed0dcd0dffd526ff...2bac299aed28d3aa03a06f5588bb451be941069f,1,0,4,4,1,2009-10-27 10:08:50,2009-10-27 10:08:50
2bac299aed28d3aa03a06f5588bb451be941069f...a5df0f6a65edda02aa70732de0321fae188d03ae,24,44,45,89,26,2009-10-27 10:46:58,2009-10-27 10:46:58
a5df0f6a65edda02aa70732de0321fae188d03ae...2b743aa5bbdf7df9372310454c35216faf3d7dac,1,6,0,6,1,2009-10-27 11:05:38,2009-10-27 11:05:38
2b743aa5bbdf7df9372310454c35216faf3d7dac...132d685796eeea6fe43b5a6613060a103c3e981f,1,13,0,13,1,2009-10-27 17:11:07,2009-10-27 17:11:07
132d685796eeea6fe43b5a6613060a103c3e981f...c77964760047f734c58dab49143ff6487f938c6e,3,4,3,7,3,2009-10-27 17:50:41,2009-10-27 17:50:41
c77964760047f734c58dab49143ff6487f938c6e...5f466c8762b8b7f1c0410832a8e952341924ba6b,1,3,3,6,1,2009-10-27 19:17:03,2009-10-27 19:17:03
5f466c8762b8b7f1c0410832a8e952341924ba6b...122e74b49bfbe82152399df15a57eb6a38a66b9c,1,8,6,14,6,2009-10-27 21:26:53,2009-10-27 21:26:53
122e74b49bfbe82152399df15a57eb6a38a66b9c...fc937aa3e599bccd387c63c77afbd31d93c7cbb3,1,8,13,21,4,2009-10-28 11:34:47,2009-10-27 21:50:46
fc937aa3e599bccd387c63c77afbd31d93c7cbb3...efe34f502374d273cd28601b338df734059657ab,5,9,66,75,14,2009-10-28 14:37:03,2009-10-16 12:55:30
efe34f502374d273cd28601b338df734059657ab...910c627fc647bdc6e5747b8135f89ebfdc94d40e,1,1,1,2,1,2009-10-28 14:37:58,2009-10-28 14:37:58
910c627fc647bdc6e5747b8135f89ebfdc94d40e...eca2de73ed786b935507fd1c6faccd8df9938fd3,4,23,4,27,4,2009-10-28 15:36:44,2009-10-28 15:36:44
eca2de73ed786b935507fd1c6faccd8df9938fd3...35589528992e8bf5ca70271beaef05a6d82f9dcf,1,8,20,28,7,2009-10-28 18:17:02,2009-10-28 16:49:22
35589528992e8bf5ca70271beaef05a6d82f9dcf...50f45d14b475a42d304e7d9872f8d91ff3a013c2,136,9071,2022,11093,839,2009-10-28 18:25:22,2009-10-28 18:25:22
50f45d14b475a42d304e7d9872f8d91ff3a013c2...ae7c9909be6bef9ba80955673bd673594be5929a,1,1,1,2,1,2009-10-28 20:35:49,2009-10-28 20:35:49
ae7c9909be6bef9ba80955673bd673594be5929a...3d8b14e6f785f72f1b4c399a9fcccbf1ca7ec633,12,88,80,168,43,2009-10-28 21:45:46,2009-10-28 21:45:40
3d8b14e6f785f72f1b4c399a9fcccbf1ca7ec633...c5367283350d54b7bcf5cf59d1e2e8b91255f2a4,2,21,15,36,11,2009-10-28 22:02:52,2009-10-28 22:02:52
c5367283350d54b7bcf5cf59d1e2e8b91255f2a4...7b2fdc098b518d1f182e3ac1581018a0d22e4606,1,10,8,18,7,2009-10-29 10:17:26,2009-10-29 10:17:26
7b2fdc098b518d1f182e3ac1581018a0d22e4606...659954d842acad282cf03850e09c702da0d0f381,3,98,1,99,9,2009-10-29 10:24:08,2009-10-29 10:19:47
659954d842acad282cf03850e09c702da0d0f381...6959a1d6d16164f40bbeb5f65faaf17028932054,54,1022,1370,2392,288,2009-10-29 15:11:05,2009-10-29 15:11:05
6959a1d6d16164f40bbeb5f65faaf17028932054...ad0a4cefb8b4bf469bb1caa6e671a1009e40a81f,55,339,343,682,248,2009-10-29 22:36:41,2009-10-29 22:34:10
ad0a4cefb8b4bf469bb1caa6e671a1009e40a81f...57890465bdea58f7cc576d917e30bca7a6683c5d,6,18,21,39,16,2009-10-30 04:49:23,2009-10-29 22:59:35
57890465bdea58f7cc576d917e30bca7a6683c5d...36f3bc33a399fe5839310cf54902d67a63afd6ba,1,3,0,3,1,2009-10-31 11:19:23,2009-10-31 11:19:23
36f3bc33a399fe5839310cf54902d67a63afd6ba...7a2e784ad7386771d15249d446c914fba1675068,50,473,387,860,167,2009-10-31 18:10:30,2009-10-31 18:02:30
7a2e784ad7386771d15249d446c914fba1675068...f5c95c388c8cb6bd885df56c7bb33d0fac71f2b8,1,11,11,22,11,2009-10-31 18:14:24,2009-10-31 18:14:24
f5c95c388c8cb6bd885df56c7bb33d0fac71f2b8...f683867b989a4e7ebec81103b56f44be01b70f98,2,29,29,58,18,2009-10-31 18:47:41,2009-10-31 18:47:41
f683867b989a4e7ebec81103b56f44be01b70f98...9a7321ebb0f4b1bfbda06325f6ca2983b1187d13,1,0,5,5,1,2009-10-31 18:53:09,2009-10-31 18:53:07
9a7321ebb0f4b1bfbda06325f6ca2983b1187d13...f230e45183f21278258cd47245f6f8ad7ef774bc,1,37,21,58,13,2009-10-31 19:03:40,2009-10-31 18:56:27
f230e45183f21278258cd47245f6f8ad7ef774bc...d582599c14ba2adcc1a8f94dcd9c583564e618a7,4,13,10,23,9,2009-10-31 19:06:46,2009-10-31 19:06:46
d582599c14ba2adcc1a8f94dcd9c583564e618a7...cf652b82a37d5e68ebd54fd00ed3b3ccbfe2a869,1,1,1,2,1,2009-10-31 19:26:03,2009-10-31 19:26:03
cf652b82a37d5e68ebd54fd00ed3b3ccbfe2a869...9bd2717e744126ebe7e41f2b13ba28ac1df7921e,1,6,7,13,5,2009-11-01 08:30:01,2009-11-01 08:27:21
9bd2717e744126ebe7e41f2b13ba28ac1df7921e...8fd472b9a1199b5da1f038d9c30f3952698b99bc,3,62,19,81,5,2009-11-01 14:39:49,2009-11-01 14:34:46
8fd472b9a1199b5da1f038d9c30f3952698b99bc...2e40a9e15fe410d849025d68c1b2a0bd7df10a06,3,5,1,6,2,2009-11-02 11:28:08,2009-11-02 11:28:08
2e40a9e15fe410d849025d68c1b2a0bd7df10a06...7069bee982c40bdca4157a1bebfed6a9ff44e70a,2,26,26,52,7,2009-11-02 20:20:44,2009-11-01 23:34:16
7069bee982c40bdca4157a1bebfed6a9ff44e70a...43d651daef4aa7d2ad8f3ff9eca87df4879d21af,2,7,1,8,4,2009-11-02 20:26:55,2009-11-02 20:21:02
43d651daef4aa7d2ad8f3ff9eca87df4879d21af...f97d339ce763d269b76aa8bb5add8c6006531c79,1,7,5,12,3,2009-11-02 22:09:57,2009-11-02 21:55:39
f97d339ce763d269b76aa8bb5add8c6006531c79...f481183140f5c3ad2c812ae5615b444aa684b2fc,3,15,2,17,5,2009-11-02 23:21:00,2009-11-02 23:21:00
f481183140f5c3ad2c812ae5615b444aa684b2fc...3a70129a9c52e98f4acd678a1810455f4767ddf8,4,110,0,110,5,2009-11-03 00:30:01,2009-11-03 00:30:01
3a70129a9c52e98f4acd678a1810455f4767ddf8...b3b3cfe007f79a019a76dc0d35e9e77504d3e835,3,112,75,187,11,2009-11-03 12:00:42,2009-11-03 12:00:42
b3b3cfe007f79a019a76dc0d35e9e77504d3e835...726865af7bbafe58435986f4a193ff11c84e4bfe,4,31,5,36,5,2009-11-03 12:48:02,2009-11-03 12:48:02
726865af7bbafe58435986f4a193ff11c84e4bfe...47fcf785ac1468744da55469bc78fbfd8628d9fb,2,28,0,28,3,2009-11-03 18:22:37,2009-11-03 18:13:38
47fcf785ac1468744da55469bc78fbfd8628d9fb...d3de943eb1a91aee7c7ece7016580cd29c29aafc,1,1,3,4,1,2009-11-03 23:18:05,2009-11-03 23:18:05
d3de943eb1a91aee7c7ece7016580cd29c29aafc...711774c1f0ace2ee9cf2d5b0024398971203d65e,1,0,3,3,1,2009-11-04 01:18:31,2009-11-04 01:18:31
711774c1f0ace2ee9cf2d5b0024398971203d65e...60131fc88c165b3b556a16bc25f244c6d63a0482,1,2,0,2,2,2009-11-04 11:37:52,2009-11-04 11:37:52
60131fc88c165b3b556a16bc25f244c6d63a0482...c6bd0e56cbdbc63e8b272239af63a394745c19c4,1,1,1,2,1,2009-11-04 11:39:08,2009-11-04 11:39:08
c6bd0e56cbdbc63e8b272239af63a394745c19c4...8ad47c8de7609f6b8f729f1b212271a39fdd03f9,1,2,0,2,2,2009-11-04 23:02:15,2009-11-04 23:02:15
8ad47c8de7609f6b8f729f1b212271a39fdd03f9...51c1526b6a00bd456d718041c6445527c89359f1,13,2992,3170,6162,1474,2009-11-06 11:44:20,2009-11-06 11:44:20
51c1526b6a00bd456d718041c6445527c89359f1...54c8ea5ea251a38660e10ec1e3d69c30cc86ffc7,1,6,4,10,5,2009-11-06 11:53:27,2009-11-06 11:53:27
54c8ea5ea251a38660e10ec1e3d69c30cc86ffc7...b833aa48e93095896448d1bf8bf998256a5567ee,1,61,0,61,1,2009-11-06 12:42:56,2009-11-06 12:42:56
b833aa48e93095896448d1bf8bf998256a5567ee...d737a060c841687907604d1a0885b11b29a1a8e4,6,183,193,376,7,2009-11-07 13:37:22,2009-11-07 13:37:22
d737a060c841687907604d1a0885b11b29a1a8e4...43121c15be7fa6ca80bb1c0448e8a643ab583c08,4,30,28,58,10,2009-11-07 13:45:39,2009-11-07 13:45:39
43121c15be7fa6ca80bb1c0448e8a643ab583c08...1020efb6f7f86e03c0d177bcd6db0acc15da4a08,1,21,22,43,10,2009-11-07 13:57:49,2009-11-07 13:57:49
1020efb6f7f86e03c0d177bcd6db0acc15da4a08...9cfa4fd7d6ce7e6fa3c0b7edcf60088adaf82bda,1,3,3,6,2,2009-11-07 14:08:46,2009-11-07 14:08:46
9cfa4fd7d6ce7e6fa3c0b7edcf60088adaf82bda...42dd629c1604114da0c9b87f107df8af72399c6d,1,5,0,5,1,2009-11-07 15:27:18,2009-11-07 15:27:18
42dd629c1604114da0c9b87f107df8af72399c6d...cff1df1f9ba2117dfcdcc4ab6cee8854da569761,1,1,1,2,1,2009-11-07 16:18:23,2009-11-07 16:18:23
cff1df1f9ba2117dfcdcc4ab6cee8854da569761...6c9ec1ac40be58c2feb0adb72d08c35ee5e2633d,1,1,1,2,1,2009-11-07 16:31:42,2009-11-07 16:31:40
6c9ec1ac40be58c2feb0adb72d08c35ee5e2633d...a021db151a6c890281e4367d2a2319290c70576d,1,1,1,2,1,2009-11-07 19:07:55,2009-11-07 16:56:49
a021db151a6c890281e4367d2a2319290c70576d...d1f69ef35dac810530df8249d523add168e09f03,4,15,5,20,4,2009-11-07 19:20:30,2009-11-07 19:20:30
d1f69ef35dac810530df8249d523add168e09f03...2ca788e6e2acdb07a61591a34f89811a7af67dc2,5,20,0,20,8,2009-11-10 16:43:37,2009-11-07 15:19:00
2ca788e6e2acdb07a61591a34f89811a7af67dc2...1026ffea4040af8630a223b28accbafdb0d754d1,1,3,2,5,1,2009-11-11 16:38:45,2009-11-11 16:03:13
1026ffea4040af8630a223b28accbafdb0d754d1...7371fcb312b83c5a6983911885a7c5eabdb5e6fe,2,24,0,24,3,2009-11-11 17:42:46,2009-11-11 17:10:58
7371fcb312b83c5a6983911885a7c5eabdb5e6fe...bffee5eda44b98991774d66998e7065355aa461f,2,23,1,24,2,2009-11-11 17:53:05,2009-11-11 17:32:00
bffee5eda44b98991774d66998e7065355aa461f...bb8f0725da017bbdca9a176508eab63c4761c1b0,1,7,1,8,4,2009-11-12 11:45:06,2009-11-12 11:35:27
bb8f0725da017bbdca9a176508eab63c4761c1b0...06d493e7e348bb023816658dda4f84336028c7fa,1,0,1,1,1,2009-11-12 11:47:02,2009-11-12 11:47:02
06d493e7e348bb023816658dda4f84336028c7fa...04f9c9fb095a2b85ecb38348f184fb6f4660192b,1,5,3,8,2,2009-11-13 14:17:23,2009-11-13 13:49:32
04f9c9fb095a2b85ecb38348f184fb6f4660192b...bd6c08a984edaec6c10ba5e68409aa2a2cecc7f8,2,14,0,14,2,2009-11-13 16:12:41,2009-11-13 16:12:41
bd6c08a984edaec6c10ba5e68409aa2a2cecc7f8...2b252acea47af3ebeac3d7e68277f015667264cc,3,69,3,72,4,2009-11-14 22:46:37,2009-11-14 22:07:54
2b252acea47af3ebeac3d7e68277f015667264cc...ca2c7d1745b3fa8d4ef89e657a888ce9b914b354,1,10,3,13,1,2009-11-15 00:06:13,2009-11-15 00:06:13
ca2c7d1745b3fa8d4ef89e657a888ce9b914b354...6e9e61b9dfaef84bb6f5ef97e31b710bf87957f6,1,1,1,2,1,2009-11-16 11:40:58,2009-11-16 10:21:23
6e9e61b9dfaef84bb6f5ef97e31b710bf87957f6...55f9fdd6b57e203753adf7e4e693afa7e12888cf,25,669,41370,42039,61,2009-11-17 11:41:19,2009-11-17 11:41:19
55f9fdd6b57e203753adf7e4e693afa7e12888cf...8d2f9e83a499801dc4f50c771cafb80070990da6,7,202,0,202,8,2009-11-17 13:07:48,2009-11-17 13:07:48
8d2f9e83a499801dc4f50c771cafb80070990da6...0bf34b598f61410bc2547870a666a8e3a77a3bf5,1,4,0,4,1,2009-11-17 13:22:23,2009-11-17 13:22:23
0bf34b598f61410bc2547870a666a8e3a77a3bf5...6e6562e551e74e7b8d86c77c582f92e708ef91e8,1,8,6,14,4,2009-11-17 14:05:01,2009-11-17 13:52:18
6e6562e551e74e7b8d86c77c582f92e708ef91e8...6cb0e0e5f584eab78a9be2065f021cefad976bcf,1,1,1,2,1,2009-11-17 14:05:10,2009-11-17 14:04:20
6cb0e0e5f584eab78a9be2065f021cefad976bcf...027829d2853a14490e6de9fc5f7094652d045ab8,4,33,8,41,5,2009-11-17 14:05:10,2009-11-17 13:30:40
027829d2853a14490e6de9fc5f7094652d045ab8...6de2173d7c6bd6bb41b571ccbd2c5d9e80131224,3,29,4,33,6,2009-11-17 21:35:47,2009-11-17 21:35:47
6de2173d7c6bd6bb41b571ccbd2c5d9e80131224...8195e0f7232fed3d6a3a2cc8464fec5e36f4433c,1,1,2,3,1,2009-11-17 22:07:31,2009-11-17 22:07:31
8195e0f7232fed3d6a3a2cc8464fec5e36f4433c...728d8a37f471afaeaa6af19823f9da8c41f1f65a,212,11281,5988,17269,1860,2009-11-18 14:28:54,2009-11-18 14:25:58
728d8a37f471afaeaa6af19823f9da8c41f1f65a...0b441462ab626cc7e582921b54143a22dbe896d1,1,7,6,13,2,2009-11-18 14:55:02,2009-11-18 14:54:27
0b441462ab626cc7e582921b54143a22dbe896d1...686bec4f35844dde840bf029f1428378b654f9ab,1,4,2,6,1,2009-11-19 18:08:47,2009-11-19 18:08:47
686bec4f35844dde840bf029f1428378b654f9ab...9d39e18c6d0ff236aa2688be63312b39dfbec52c,1,2,0,2,2,2009-11-19 18:12:42,2009-11-19 18:12:42
9d39e18c6d0ff236aa2688be63312b39dfbec52c...1eba0cadc15beb2f4a45f18c31ab2c7d80fc2807,1,6,3,9,5,2009-11-21 14:52:12,2009-11-18 01:12:55
1eba0cadc15beb2f4a45f18c31ab2c7d80fc2807...7719ce33db2a68f65f1bed58faece83a2342c7c3,12,2135,6904,9039,267,2009-11-21 15:27:02,2009-11-21 15:27:02
7719ce33db2a68f65f1bed58faece83a2342c7c3...39a12b2a222989bfaa9f82e3316fb1c95dd4a18e,1,0,1,1,1,2009-11-21 16:16:05,2009-11-21 16:15:39
39a12b2a222989bfaa9f82e3316fb1c95dd4a18e...528c449901a685e74f31eca9f35a84982eeae048,3,22,4,26,8,2009-11-21 16:16:06,2009-11-21 15:37:29
528c449901a685e74f31eca9f35a84982eeae048...8be6a896543c708f08e8bdbe944323084c0e3b1a,4,97,61,158,55,2009-11-21 21:03:52,2009-11-21 21:03:52
8be6a896543c708f08e8bdbe944323084c0e3b1a...1cacb50f2bf9465c7919a3c4be96aee409355dec,1,4,0,4,1,2009-11-21 23:47:36,2009-11-21 23:47:26
1cacb50f2bf9465c7919a3c4be96aee409355dec...b6dda612495d7edb73250649ae53bdf3e7fc223e,10,743,12,755,33,2009-11-22 03:03:53,2009-11-22 02:58:08
b6dda612495d7edb73250649ae53bdf3e7fc223e...27fcae738a7f6b3452a15c1bfcaee280b74ac71c,2,2,0,2,2,2009-11-22 14:09:55,2009-11-22 12:47:20
27fcae738a7f6b3452a15c1bfcaee280b74ac71c...2d54d664ff977652562e3c707d6819888251046c,2,15,0,15,2,2009-11-22 18:18:24,2009-11-22 18:18:24
2d54d664ff977652562e3c707d6819888251046c...0433d828cffaaf1a6a69a8ba175a172ae1af0f11,3,25,1,26,5,2009-11-22 18:52:52,2009-11-22 18:52:52
0433d828cffaaf1a6a69a8ba175a172ae1af0f11...9c1034b1832ea861fdacd4788dea4686c33bacc5,1,7,0,7,1,2009-11-22 22:42:02,2009-11-22 22:32:53
9c1034b1832ea861fdacd4788dea4686c33bacc5...dc093ef833561cfa8d85fbd649f62d2045d4e61f,2,30,34,64,5,2009-11-22 23:59:39,2009-11-22 23:59:36
dc093ef833561cfa8d85fbd649f62d2045d4e61f...4129305b7cdfb6df9695225e62714ab6e80fccd3,28,553,41,594,60,2009-11-27 21:53:39,2009-11-27 21:53:39
4129305b7cdfb6df9695225e62714ab6e80fccd3...516874f4a151ad50004c9e7ec73885319519bcef,1,7,2,9,1,2009-11-27 22:02:13,2009-11-24 11:13:21
516874f4a151ad50004c9e7ec73885319519bcef...0cea946cb9030d772897b468e2f4e32e40842c2a,1,1,1,2,1,2009-11-28 00:38:32,2009-11-28 00:38:32
0cea946cb9030d772897b468e2f4e32e40842c2a...633d6be328708055897b72327b88ac88e158935f,4,32,5,37,4,2009-11-28 00:49:11,2009-11-28 00:49:11
633d6be328708055897b72327b88ac88e158935f...44d5f212febeb7a7cb76e67ca7a686490fa37598,7,105,78,183,20,2009-11-28 14:13:12,2009-11-28 13:52:27
44d5f212febeb7a7cb76e67ca7a686490fa37598...8a58e83870956614ca9c9001f60e042c0be1c822,1,1,0,1,1,2009-11-28 14:25:10,2009-11-28 14:25:10
8a58e83870956614ca9c9001f60e042c0be1c822...38e425d9bfe3e5fc728576f623fdedf27432f106,2,20,1,21,2,2009-11-28 15:31:29,2009-11-28 15:31:29
38e425d9bfe3e5fc728576f623fdedf27432f106...aa42c6790da8ed2cd2b72051c07f6251fe1724d8,4,15,4,19,4,2009-11-28 16:04:42,2009-11-28 16:04:42
aa42c6790da8ed2cd2b72051c07f6251fe1724d8...1107a1bd1e367d3056b8c3975c2026b7402e9f61,1,3,3,6,3,2009-11-28 19:56:47,2009-11-28 11:15:37
1107a1bd1e367d3056b8c3975c2026b7402e9f61...a9ea21feb43188922f823ddc9a7f2e67bea95aea,1,1,1,2,1,2009-11-30 09:14:09,2009-11-29 08:00:30
a9ea21feb43188922f823ddc9a7f2e67bea95aea...5b1a535cd89624a021b4bd183cfaaccef5b63dd9,4,145,13,158,7,2009-11-30 15:51:20,2009-11-30 15:51:20
5b1a535cd89624a021b4bd183cfaaccef5b63dd9...485823f3e44013c4c83fcbbabd3a234f680ebb3c,2,21,5,26,7,2009-12-04 23:56:22,2009-12-02 05:38:42
485823f3e44013c4c83fcbbabd3a234f680ebb3c...530328f12b4a00dfbc8ea57bafb1f9344912f0db,55,1516,302,1818,212,2009-12-05 00:05:16,2009-11-28 17:26:59
530328f12b4a00dfbc8ea57bafb1f9344912f0db...4f679fd8d01c11c908bd5ca439a7aff956cda4ad,4,287,1084,1371,23,2009-12-05 00:05:16,2009-11-30 02:20:37
4f679fd8d01c11c908bd5ca439a7aff956cda4ad...7538e707677b29b276a543a4e1db9d4c3893c0c6,2,6,0,6,2,2009-12-05 06:55:24,2009-12-05 06:52:05
7538e707677b29b276a543a4e1db9d4c3893c0c6...c5d82380f46ed0c992ff56a9e9ddfe6ab2540e62,2,49,3,52,5,2009-12-05 07:37:46,2009-12-05 07:37:46
c5d82380f46ed0c992ff56a9e9ddfe6ab2540e62...c8b6ef248e5fc32df62041ec83463923bc8bdc68,99,4250,1460,5710,563,2009-12-05 14:27:56,2009-12-05 14:27:56
c8b6ef248e5fc32df62041ec83463923bc8bdc68...48452838b379b167a2aff5786d53c07e5f8bbcdc,1,6,9,15,5,2009-12-05 17:27:28,2009-12-05 17:25:07
48452838b379b167a2aff5786d53c07e5f8bbcdc...90ab0794dfc3d6d8343d22e76e0d86307538445d,2,9,9,18,8,2009-12-06 06:35:26,2009-12-06 06:35:26
90ab0794dfc3d6d8343d22e76e0d86307538445d...8141448fe5ed385233a8490f2ca8200f5a2d48cd,3,116,30,146,26,2009-12-06 08:26:09,2009-12-06 08:23:38
8141448fe5ed385233a8490f2ca8200f5a2d48cd...3414eab2f3ec626be090e34cb7bf44ea03d38c55,4,419,326,745,54,2009-12-06 09:50:03,2009-12-06 09:50:03
3414eab2f3ec626be090e34cb7bf44ea03d38c55...4d818f1fd3454f972ef6e0a4f32ed26585804dd5,5,77,204,281,13,2009-12-06 10:36:22,2009-12-06 10:36:22
4d818f1fd3454f972ef6e0a4f32ed26585804dd5...34c02357ff8e00c35e493754943f599dba0b0f29,2,90,20,110,7,2009-12-06 11:19:23,2009-12-01 10:20:14
34c02357ff8e00c35e493754943f599dba0b0f29...c6affb64f96a403a14d20035e7fbd6d0ce089db5,4,22,5,27,5,2009-12-06 16:59:37,2009-12-06 16:53:52
c6affb64f96a403a14d20035e7fbd6d0ce089db5...f8ba9c3bc9fbab6b822a8bb531c7a3c09035100a,9,37,33,70,21,2009-12-06 17:36:32,2009-12-02 22:25:56
f8ba9c3bc9fbab6b822a8bb531c7a3c09035100a...f080de53808061c2cd754960eb210c2f60d6e154,2,18,2,20,3,2009-12-06 18:21:06,2009-12-06 17:57:20
f080de53808061c2cd754960eb210c2f60d6e154...876b6d21832ece6c51021fe0acc1d31c2ad4e32a,2,8,2,10,2,2009-12-06 18:21:20,2009-12-06 18:02:55
876b6d21832ece6c51021fe0acc1d31c2ad4e32a...c3e0a4bc7c89e6eace8d4652092b0a37dac65d8b,4,201,190,391,100,2009-12-06 22:58:16,2009-12-06 22:58:16
c3e0a4bc7c89e6eace8d4652092b0a37dac65d8b...756544fd28d5e7156fe7d27adc3e0265268fd76d,2,3,1,4,2,2009-12-07 09:05:18,2009-12-07 04:44:41
756544fd28d5e7156fe7d27adc3e0265268fd76d...ee8530e0ee386492ca519004cfaa34de650b17b3,3,43,44,87,8,2009-12-07 14:21:12,2009-12-07 14:21:12
ee8530e0ee386492ca519004cfaa34de650b17b3...c1baa70fe5789de0c1eef7f2051a4e43fedced6e,10,173,46,219,44,2009-12-07 16:55:19,2009-12-07 16:55:19
c1baa70fe5789de0c1eef7f2051a4e43fedced6e...71680f512ce60130a8d0f9331e708b6fd90180ca,1,4,0,4,4,2009-12-07 17:13:45,2009-12-07 17:03:06
71680f512ce60130a8d0f9331e708b6fd90180ca...501b4a54be5188e06194597010b5f13067da1caf,1,1,1,2,1,2009-12-08 04:35:56,2009-12-08 00:18:43
501b4a54be5188e06194597010b5f13067da1caf...9599d2d0e97968b25585184f224cdb00f925785c,1,1,1,2,1,2009-12-08 05:19:12,2009-12-05 12:33:15
9599d2d0e97968b25585184f224cdb00f925785c...dbb1a267d78392a1919f9cd091ce68685e821064,1,1,1,2,1,2009-12-08 05:54:26,2009-12-08 05:54:26
dbb1a267d78392a1919f9cd091ce68685e821064...89df4d1c86852c707063c97115618e24bd98ee08,1,1,1,2,1,2009-12-08 06:20:51,2009-12-08 06:20:51
89df4d1c86852c707063c97115618e24bd98ee08...a30ac92b0c52ff85bff409ec0278bd42087bc4c3,2,0,127,127,2,2009-12-09 06:44:44,2009-12-09 06:44:44
a30ac92b0c52ff85bff409ec0278bd42087bc4c3...45a806a066b082fa95c56ba9715d72caabf45289,12,270,124,394,99,2009-12-09 08:12:01,2009-12-09 08:02:21
45a806a066b082fa95c56ba9715d72caabf45289...4ddfd8aa42c365a2351d9cbe2f98470fb81a8c41,1,3,3,6,2,2009-12-09 09:32:19,2009-12-09 09:32:19
4ddfd8aa42c365a2351d9cbe2f98470fb81a8c41...a73227bf28e07539867ee450288916bb87fb95f1,45,623,385,1008,201,2009-12-09 13:27:33,2009-12-09 13:27:33
a73227bf28e07539867ee450288916bb87fb95f1...e801f420d0b03a7a2bb16e8174ba9f7ecf5720c7,1,3,3,6,3,2009-12-09 13:28:02,2009-12-09 12:36:12
e801f420d0b03a7a2bb16e8174ba9f7ecf5720c7...89a3fa93a031dca3d9f1cef33f796b9194a2db98,1,1,1,2,1,2009-12-09 14:59:53,2009-12-09 14:59:53
89a3fa93a031dca3d9f1cef33f796b9194a2db98...164ce76e941490e82230e905e719b5b556b669f5,1,3,0,3,1,2009-12-18 13:59:33,2009-12-18 06:08:10
164ce76e941490e82230e905e719b5b556b669f5...20b945df706b2b9fcbc1a84230372d288d497544,108,7621,1615,9236,668,2009-12-18 14:05:04,2009-12-18 14:05:04
20b945df706b2b9fcbc1a84230372d288d497544...87077e03ccee3f4e96e66f33eddc4609a30799c4,1,5,2,7,2,2009-12-18 14:14:33,2009-12-15 21:32:50
87077e03ccee3f4e96e66f33eddc4609a30799c4...752da03eb03ac737ac696232f3dd670d0194d30f,1,20,14,34,6,2009-12-18 14:36:11,2009-12-15 21:46:38
752da03eb03ac737ac696232f3dd670d0194d30f...fa667f718ca1f6a887d5dddbed62ec6720f3f205,1,27,25,52,5,2009-12-18 14:36:25,2009-12-18 14:36:25
fa667f718ca1f6a887d5dddbed62ec6720f3f205...6eb8bbc64002842d5c42d4e95ed3610551ec3827,1,2,0,2,1,2009-12-18 14:37:24,2009-12-15 22:37:49
6eb8bbc64002842d5c42d4e95ed3610551ec3827...22d1d3dbf73d9471b0cc3d5391d26a3563eb0e24,1,4,3,7,2,2009-12-18 14:45:53,2009-12-18 14:45:53
22d1d3dbf73d9471b0cc3d5391d26a3563eb0e24...d8e69d31b398a22cae696182f837ad5ffec25efd,1,32,0,32,2,2009-12-18 15:17:10,2009-12-18 15:17:10
d8e69d31b398a22cae696182f837ad5ffec25efd...7873639f55ce9d4b1cbc87542e54a74b60a7b293,1,31,30,61,30,2009-12-18 15:21:21,2009-12-16 22:33:33
7873639f55ce9d4b1cbc87542e54a74b60a7b293...f3b0cefd0b1916c7f3ba0ca04560614bb6de9122,1,6,9,15,5,2009-12-18 17:42:20,2009-12-18 02:27:48
f3b0cefd0b1916c7f3ba0ca04560614bb6de9122...2f9722cca0a72122aa03763c085f6b5aa7f0ada2,2,427,0,427,2,2009-12-18 17:56:59,2009-12-11 23:25:35
2f9722cca0a72122aa03763c085f6b5aa7f0ada2...4a615ddd9c29b57dd5b526b46dcbcf4585acd95f,1,16,0,16,3,2009-12-18 17:59:02,2009-12-11 23:46:10
4a615ddd9c29b57dd5b526b46dcbcf4585acd95f...f65b36eec1e3bf07307e926981b3ec57a0145c1f,1,11,72,83,5,2009-12-18 18:02:16,2009-12-11 23:46:32
f65b36eec1e3bf07307e926981b3ec57a0145c1f...4526308560201bfcb9ae927abb96c2103ba31344,2,77,71,148,16,2009-12-18 18:02:27,2009-12-13 00:29:12
4526308560201bfcb9ae927abb96c2103ba31344...bfa36136dac787793bc5106da57cccbb8db1ce14,3,17,1,18,4,2009-12-18 22:58:04,2009-12-18 22:58:04
bfa36136dac787793bc5106da57cccbb8db1ce14...3b8e47755a16c72d7b3509685a89c834c42a9342,1,11,2,13,5,2009-12-18 23:12:38,2009-12-16 21:08:14
3b8e47755a16c72d7b3509685a89c834c42a9342...c2454a0d067d1587f7fcc529543e521cc73620f0,1,2,2,4,2,2009-12-18 23:13:20,2009-12-16 22:15:24
c2454a0d067d1587f7fcc529543e521cc73620f0...6301f18e62e8f90026dda3aec3457e4723ea319b,1,7,3,10,4,2009-12-18 23:14:10,2009-12-16 23:18:27
6301f18e62e8f90026dda3aec3457e4723ea319b...0ea2f9e04b411fa06277c478d2b2b28b47054873,1,2,2,4,2,2009-12-18 23:14:50,2009-12-17 22:06:56
0ea2f9e04b411fa06277c478d2b2b28b47054873...0981e7f663c9f6cfbccb49aa2956df499a63e60d,1,2,1,3,1,2009-12-18 23:45:01,2009-12-18 23:45:01
0981e7f663c9f6cfbccb49aa2956df499a63e60d...a98afdfb2f05d163b2d4145f2d98c4a7ffd13bfd,108,1615,7621,9236,663,2009-12-19 00:04:19,2009-12-19 00:04:19
a98afdfb2f05d163b2d4145f2d98c4a7ffd13bfd...a2d809fe902f6c4102dba8f2e3e9551aad137c0f,4,33,5,38,5,2009-12-19 00:24:59,2009-12-19 00:24:59
a2d809fe902f6c4102dba8f2e3e9551aad137c0f...4dcdfaf9291a5d6a2ed25b5742151a0de562a4a1,10,62,38,100,15,2009-12-22 16:22:12,2009-12-22 15:24:32
4dcdfaf9291a5d6a2ed25b5742151a0de562a4a1...120492e5c222f8d1b0890ea0e8170dfe7370d74c,1,3,3,6,3,2009-12-22 16:50:23,2009-12-22 16:50:23
120492e5c222f8d1b0890ea0e8170dfe7370d74c...e6c5ac4f73f69c4e87aa5a7c7e84bccfb3ba12e6,1,1,1,2,1,2009-12-22 17:01:13,2009-12-22 13:52:40
e6c5ac4f73f69c4e87aa5a7c7e84bccfb3ba12e6...5de04dafc6c21cbfedc0f89859a21066e2741295,1,0,4,4,2,2009-12-22 18:28:30,2009-12-20 19:27:06
5de04dafc6c21cbfedc0f89859a21066e2741295...f91e347eeeeac1a8bd6a7b462df0321b60f3affc,4,13,4,17,4,2009-12-22 19:31:45,2009-12-22 19:31:45
f91e347eeeeac1a8bd6a7b462df0321b60f3affc...64fe9fb85d70b4b37561054e57d5d9c1720700e8,1,55,55,110,7,2009-12-22 22:11:54,2009-12-22 22:11:54
64fe9fb85d70b4b37561054e57d5d9c1720700e8...3d24e119e06fe23386e068b5b83806d91735cc97,2,75,9,84,9,2009-12-23 21:24:29,2009-12-23 20:48:14
3d24e119e06fe23386e068b5b83806d91735cc97...0d7e88a4298740751bf0e8dabf9015baf88f455a,2,66,0,66,2,2009-12-29 18:11:04,2009-12-27 21:07:06
0d7e88a4298740751bf0e8dabf9015baf88f455a...dd35637603ca338c9fcbbeedecf695450fcdc95d,2,247,217,464,50,2009-12-29 19:10:59,2009-12-29 18:37:40
dd35637603ca338c9fcbbeedecf695450fcdc95d...0accebe58343d60e3f2f9af3971114e685837d5b,1,22,24,46,16,2009-12-29 19:15:05,2009-12-29 19:14:58
0accebe58343d60e3f2f9af3971114e685837d5b...53a841d96a70d9868772cf6c862149df43ec2c8b,1,25,26,51,3,2009-12-29 19:20:51,2009-12-29 19:20:51
53a841d96a70d9868772cf6c862149df43ec2c8b...359d0170ab2c9925b0408f358285c9a1d98547e6,1,1,1,2,1,2009-12-29 19:31:56,2009-12-29 19:31:56
359d0170ab2c9925b0408f358285c9a1d98547e6...fd73a3a3985b5d4064d3dbb1e5bda7eab259e9c7,109,7704,1621,9325,683,2009-12-30 01:35:15,2009-12-30 01:34:22
fd73a3a3985b5d4064d3dbb1e5bda7eab259e9c7...2c016badc25f51f057697c76d39c999dce2bfb75,1,5,3,8,4,2009-12-30 01:50:06,2009-12-30 01:45:15
2c016badc25f51f057697c76d39c999dce2bfb75...8fd46a34d669700e3c8920390d81d58963cbc7b1,1,0,1,1,1,2009-12-30 20:59:02,2009-10-09 12:21:41
359d0170ab2c9925b0408f358285c9a1d98547e6...0afed523299515762e97ff40c12bf3285d24a38a,4,309,0,309,5,2009-12-29 20:12:28,2009-12-13 07:39:20
0afed523299515762e97ff40c12bf3285d24a38a...630bb7a0127df7606fc3d99d36170c378f09f6b9,6,134,95,229,48,2009-12-29 20:12:28,2009-12-13 07:42:45
630bb7a0127df7606fc3d99d36170c378f09f6b9...e2569c402fc2b1b4f60c71c616a321134e7aa0ca,1,9,6,15,2,2009-12-29 20:12:28,2009-12-13 07:57:54
e2569c402fc2b1b4f60c71c616a321134e7aa0ca...3377a30fb844a9804b895e20d702bbfc865fb70e,3,23,30,53,7,2009-12-29 20:12:29,2009-12-13 07:58:12
3377a30fb844a9804b895e20d702bbfc865fb70e...f219938b69c0af4a18714fb73ff9a58b3ac831c1,4,173,2,175,7,2009-12-29 20:12:29,2009-12-13 14:43:58
f219938b69c0af4a18714fb73ff9a58b3ac831c1...c819abccb611735afa8fd2cd26ca23d43a98527c,4,194,0,194,5,2009-12-29 20:12:30,2009-12-14 08:42:02
c819abccb611735afa8fd2cd26ca23d43a98527c...469e2648e59c19154fd67ae1df17487f673fe9fc,4,506,96,602,29,2009-12-29 20:12:30,2009-12-15 08:22:36
469e2648e59c19154fd67ae1df17487f673fe9fc...0ecd0fa598e958c7f67fd3617cfb51045516d0e2,4,144,67,211,31,2009-12-29 20:12:30,2009-12-15 16:17:45
0ecd0fa598e958c7f67fd3617cfb51045516d0e2...1da15d623e0a2d817d31762b3dc8837d0ebbdf18,3,116,14,130,18,2009-12-29 20:12:30,2009-12-16 07:35:09
1da15d623e0a2d817d31762b3dc8837d0ebbdf18...bddd6e9ca33a069140501b76bdb336fa9cd65d07,3,227,31,258,29,2009-12-29 20:12:31,2009-12-16 12:50:28
bddd6e9ca33a069140501b76bdb336fa9cd65d07...b23ed4a98cdd78493e7d9111bd6819f16bf2c8ac,1,0,0,0,0,2009-12-29 20:12:31,2009-12-17 06:39:22
b23ed4a98cdd78493e7d9111bd6819f16bf2c8ac...3fce98c85349601898442cc95a8550016f31f19c,1,23,0,23,1,2009-12-29 20:12:31,2009-12-17 07:37:25
3fce98c85349601898442cc95a8550016f31f19c...0618f02f6f2fa326cef971522fc8d5066d7c38f3,3,209,116,325,45,2009-12-29 20:12:31,2009-12-17 08:31:10
0618f02f6f2fa326cef971522fc8d5066d7c38f3...6e5abf4551634ee27d6e3a25499ec6f4f94215c0,4,320,50,370,58,2009-12-29 20:12:31,2009-12-18 13:52:02
6e5abf4551634ee27d6e3a25499ec6f4f94215c0...153b75593678a801985ce27a2af0d2235dcf74d3,3,41,44,85,36,2009-12-29 20:12:32,2009-12-28 15:18:03
153b75593678a801985ce27a2af0d2235dcf74d3...25700e65eeb3493fc42c234e5dfd9413c4c02795,3,42,37,79,18,2009-12-29 20:12:32,2009-12-28 15:42:48
25700e65eeb3493fc42c234e5dfd9413c4c02795...48ccbb9afafd8f9bd2c3a93ac9db51afb2259f6c,1,18,8,26,6,2009-12-29 20:12:32,2009-12-28 16:01:49
48ccbb9afafd8f9bd2c3a93ac9db51afb2259f6c...07333a4ab05282eafa10669fad5da2992f5f88d0,3,20,11,31,11,2009-12-29 20:12:32,2009-12-28 16:52:26
07333a4ab05282eafa10669fad5da2992f5f88d0...8330316014678c6404bb49e09e353d8f9130321c,1,21,13,34,14,2009-12-30 07:53:19,2009-12-30 07:53:19
8330316014678c6404bb49e09e353d8f9130321c...1beb840fec05948b47d7d698558c258193bcdecb,1,1,1,2,1,2009-12-30 08:01:28,2009-12-30 08:01:28
1beb840fec05948b47d7d698558c258193bcdecb...2582560f913132deed61786cdaa9884aa6cb7980,3,90,48,138,12,2009-12-30 08:53:14,2009-12-30 08:53:14
2582560f913132deed61786cdaa9884aa6cb7980...402755b14a9d7828c0ae805c3d792774178cd6ee,2,8,3,11,3,2009-12-30 08:57:55,2009-12-30 08:57:55
402755b14a9d7828c0ae805c3d792774178cd6ee...de9bfdea8e0aaf9eab86b5ea3d08bb52a4f625ff,2,8,3,11,4,2009-12-30 18:06:40,2009-12-30 18:06:40
de9bfdea8e0aaf9eab86b5ea3d08bb52a4f625ff...0d31e9875f782c476e6f85791ceb8ae8a6758ae8,2,24,0,24,4,2009-12-30 18:43:47,2009-12-30 18:43:47
0d31e9875f782c476e6f85791ceb8ae8a6758ae8...a8ede8dd9e7b716624cb9b4a160c1260516ae3b3,2,97,0,97,2,2009-12-30 18:58:46,2009-12-30 18:58:46
a8ede8dd9e7b716624cb9b4a160c1260516ae3b3...8d0f756158f49eb9427991b0923b629d8e0e5332,3,65,27,92,12,2009-12-30 19:32:07,2009-12-30 19:32:07
8d0f756158f49eb9427991b0923b629d8e0e5332...20eec646b3bf5681fb93475d1f2272f448bd10ea,3,49,45,94,22,2009-12-30 19:51:43,2009-12-30 19:51:43
8fd46a34d669700e3c8920390d81d58963cbc7b1...9553503be5b9efa06cefd5c813fe7b861cba495b,1,58,2,60,4,2009-12-31 06:16:16,2009-12-31 06:16:10
9553503be5b9efa06cefd5c813fe7b861cba495b...642c2773a7eb2034f597af1cd404b9e086b59632,4,19,5,24,5,2009-12-31 08:30:53,2009-12-31 08:30:53
642c2773a7eb2034f597af1cd404b9e086b59632...732c6f2036a955e32e3f981f5681daefaeaf99a8,2,6,2,8,4,2009-12-31 17:57:29,2009-12-31 17:41:35
732c6f2036a955e32e3f981f5681daefaeaf99a8...6c68a9679b7589590440eb3b80315d0f5c25945c,2,31,2,33,4,2010-01-03 02:18:01,2010-01-03 00:25:09
6c68a9679b7589590440eb3b80315d0f5c25945c...fd184ee2fa5d11a4c1617d91bb8d891c1ef21dc8,2,6,6,12,5,2010-01-04 05:15:21,2010-01-03 20:04:35
fd184ee2fa5d11a4c1617d91bb8d891c1ef21dc8...7342fecaec20e9dc385ce1763c0f443b4bed360c,1,17,9,26,7,2010-01-04 19:36:52,2010-01-04 07:24:25
7342fecaec20e9dc385ce1763c0f443b4bed360c...d6fe7fb4c3f3ba0cb0da3f16255e0b5d9fbec8da,1,67,0,67,1,2010-01-05 04:58:16,2010-01-04 07:34:46
d6fe7fb4c3f3ba0cb0da3f16255e0b5d9fbec8da...7ff04c1f86d85876225fe7c3059efaedca8ed14a,5,1189,0,1189,5,2010-01-05 05:03:54,2010-01-04 07:14:12
7ff04c1f86d85876225fe7c3059efaedca8ed14a...2b3d9e4ad077393ea2af0f4d45d4c00c00071dcd,11,76,508,584,41,2010-01-05 05:22:46,2010-01-05 05:07:50
2b3d9e4ad077393ea2af0f4d45d4c00c00071dcd...a650138ebf96dda08157e94481fe1b5943602ab0,2,1,3,4,2,2010-01-05 06:06:18,2010-01-04 16:10:53
a650138ebf96dda08157e94481fe1b5943602ab0...caf22c8e0a808c2392f0cae1b6da36111cbc9467,1,3,1,4,1,2010-01-05 06:18:06,2010-01-04 00:45:17
caf22c8e0a808c2392f0cae1b6da36111cbc9467...af6c177b91dabf5176db7cb21bb465b197236ae0,5,76,15,91,20,2010-01-05 06:46:32,2010-01-05 06:46:32
af6c177b91dabf5176db7cb21bb465b197236ae0...933a37cd283ec9b561970a96517a55b86ebee88d,8,207,106,313,58,2010-01-05 06:52:48,2010-01-05 06:52:48
933a37cd283ec9b561970a96517a55b86ebee88d...04dd2d51be03c01d9ab259fe40e436730778bd01,2,23,0,23,2,2010-01-05 07:26:58,2010-01-05 07:26:58
04dd2d51be03c01d9ab259fe40e436730778bd01...52f088b966dad8a617f0cd3b41e833dcf111f992,1,3,1,4,2,2010-01-05 08:14:03,2010-01-05 08:00:41
52f088b966dad8a617f0cd3b41e833dcf111f992...d9a81374b2e6995a5118f76cf15cba67a67be66d,2,38,9,47,9,2010-01-05 21:23:56,2010-01-05 21:22:18
d9a81374b2e6995a5118f76cf15cba67a67be66d...aa73ed973ca19963cc2c9591a77412598607b3af,1,18,1,19,3,2010-01-05 21:28:03,2010-01-05 21:28:03
aa73ed973ca19963cc2c9591a77412598607b3af...f86c1783b739e1f495405a9e86af1e4326468ef1,2,16,3,19,6,2010-01-05 21:37:51,2010-01-05 21:37:51
f86c1783b739e1f495405a9e86af1e4326468ef1...7d947f87230c92abe3cac433142ca15226b6276a,1,54,34,88,15,2010-01-06 04:15:03,2010-01-05 21:44:09
7d947f87230c92abe3cac433142ca15226b6276a...d9085ea0cb73bfeb6c0c9bb89dc39ecc840f9dae,1,5,3,8,1,2010-01-06 04:15:16,2010-01-05 21:50:00
d9085ea0cb73bfeb6c0c9bb89dc39ecc840f9dae...3f3977283419fe81e09aa23b91e59de959a84abd,2,3,4,7,2,2010-01-06 05:09:02,2010-01-06 05:09:02
3f3977283419fe81e09aa23b91e59de959a84abd...f80cc69c236fdfbc2dc161887d798b92c5119e31,3,82,36,118,5,2010-01-06 09:27:31,2010-01-06 09:17:58
f80cc69c236fdfbc2dc161887d798b92c5119e31...b1e126f4152c41d1879182f72741778657377c57,1,3,1,4,1,2010-01-06 09:53:34,2010-01-06 09:47:56
b1e126f4152c41d1879182f72741778657377c57...947c577c0d247ea6b42b4ec16ac96bc7f0840cae,2,27,1,28,2,2010-01-06 10:12:11,2010-01-06 03:03:14
947c577c0d247ea6b42b4ec16ac96bc7f0840cae...1b9eaf43f5c8edeea5487f9b6c1edddae8fe0846,1,1,1,2,1,2010-01-07 01:12:22,2010-01-07 01:12:22
1b9eaf43f5c8edeea5487f9b6c1edddae8fe0846...d22952bfe0e6f7f6f0001cbfdc15433591d1f1cd,2,43,2,45,4,2010-01-07 07:37:27,2010-01-07 07:37:27
d22952bfe0e6f7f6f0001cbfdc15433591d1f1cd...75e6c397331fde8cd9895ff761dbdcac6a7028a0,3,68,70,138,42,2010-01-08 02:36:28,2010-01-08 02:36:28
75e6c397331fde8cd9895ff761dbdcac6a7028a0...53413598b6a0f23e64680f69abbb7b2ab80d8fb7,2,37,3,40,4,2010-01-09 06:20:23,2010-01-09 06:18:18
53413598b6a0f23e64680f69abbb7b2ab80d8fb7...73266cb486c8541e55865f9188d5097ebac13a1a,2,17,0,17,2,2010-01-09 06:28:27,2010-01-08 07:03:23
73266cb486c8541e55865f9188d5097ebac13a1a...b21056d63a87db3cc09ba82906b3f85f091ee3a4,1,17,13,30,6,2010-01-09 08:26:49,2010-01-08 20:46:13
b21056d63a87db3cc09ba82906b3f85f091ee3a4...988174a6294ab863be2961267174901440100944,1,27,0,27,1,2010-01-09 08:31:51,2010-01-08 20:46:50
988174a6294ab863be2961267174901440100944...b3349eb33abb65969dbb3b96bb797413c594652a,1,4,2,6,2,2010-01-09 08:38:05,2010-01-08 20:47:01
b3349eb33abb65969dbb3b96bb797413c594652a...c9e21435c02d07c052d02b1b1a55732fdbc880e2,7,137,118,255,96,2010-01-09 09:52:49,2010-01-09 09:52:49
c9e21435c02d07c052d02b1b1a55732fdbc880e2...39ca93549af91575ca9d4cbafd1e170fbcef3dfa,4,30,5,35,5,2010-01-09 10:11:54,2010-01-09 10:11:54
39ca93549af91575ca9d4cbafd1e170fbcef3dfa...bba23c0998a2384a024fbb6cb6f24f70b521a28f,1,1,1,2,2,2010-01-11 06:22:21,2010-01-11 06:06:05
bba23c0998a2384a024fbb6cb6f24f70b521a28f...1b2c57907d0aa0a514083b77b8b7b44ddbca3864,1,17,21,38,3,2010-01-11 06:27:48,2010-01-11 06:27:48
1b2c57907d0aa0a514083b77b8b7b44ddbca3864...8e0dad4a27dd0604e334eec02403d22c6007c2c5,1,1,1,2,1,2010-01-11 07:00:58,2010-01-11 07:00:58
8e0dad4a27dd0604e334eec02403d22c6007c2c5...f379b77735289087674906dee63b2d6275d43cec,1,2,0,2,2,2010-01-12 00:43:10,2010-01-12 00:43:10
f379b77735289087674906dee63b2d6275d43cec...a3631a383b8280d549087789c41d76a67f5d6da7,1,16,0,16,1,2010-01-12 00:43:23,2010-01-11 06:04:40
a3631a383b8280d549087789c41d76a67f5d6da7...c4397b801acd14b83f1674640346618e39c6ca88,1,1,1,2,1,2010-01-12 09:09:58,2010-01-12 09:09:50
d9757520fb9c247d3d7f7910e1c6e290590259a3...a876df6c715bfcff48a1fc518ec0cab9d53f20e4,4,364,24,388,32,2010-01-09 09:28:19,2010-01-07 21:50:19
c4397b801acd14b83f1674640346618e39c6ca88...6c5c8085693ebf3105caa3b41f683a9aaa2c09e3,1,12,6,18,5,2010-01-15 17:41:33,2010-01-13 03:23:21
6c5c8085693ebf3105caa3b41f683a9aaa2c09e3...8e6dd52683fee931235994c415aa4b9d303b1a32,2,16,8,24,9,2010-01-15 18:45:04,2010-01-15 18:45:04
8e6dd52683fee931235994c415aa4b9d303b1a32...70293a43c9d4075165e2f7f623fa86339eb9d27f,12,261,237,498,100,2010-01-15 20:46:08,2010-01-15 20:46:08
70293a43c9d4075165e2f7f623fa86339eb9d27f...fd183bdb07a8b5b869036594a21b90668c318190,1,2,2,4,2,2010-01-18 17:11:02,2010-01-18 17:04:49
fd183bdb07a8b5b869036594a21b90668c318190...820ca71a9152c0da335a1b082d6ab9d2034723ad,1,1,5,6,2,2010-01-18 17:11:26,2010-01-17 01:10:46
820ca71a9152c0da335a1b082d6ab9d2034723ad...aeb7d6d168204d5d37a7dd9fc4f9dc78a0e83a08,6,181,0,181,8,2010-01-18 18:12:04,2010-01-18 18:12:04
aeb7d6d168204d5d37a7dd9fc4f9dc78a0e83a08...8abeffa9ea5626e81d2d9d0164b2a43ea458a0b8,4,61,6,67,9,2010-01-18 18:32:36,2010-01-18 18:27:27
8abeffa9ea5626e81d2d9d0164b2a43ea458a0b8...6e3d12f617f2931ff6b56374be9e910bad6622b8,3,50,2,52,6,2010-01-18 18:41:03,2010-01-18 17:51:50
6e3d12f617f2931ff6b56374be9e910bad6622b8...4e16e386fec675b576669e67f25efe47854ffef6,1,1,0,1,1,2010-01-19 20:43:19,2010-01-19 20:20:26
4e16e386fec675b576669e67f25efe47854ffef6...f2274840a9737df45135fffaaaa9da266dbfd66a,4,1,78,79,9,2010-01-19 22:29:38,2010-01-19 20:02:48
f2274840a9737df45135fffaaaa9da266dbfd66a...d9dc2e0709a1db5b5b6ee8fa528290cb3df749e9,1,1,1,2,1,2010-01-19 22:29:44,2010-01-19 20:09:14
d9dc2e0709a1db5b5b6ee8fa528290cb3df749e9...f64371fccb61232be00534d6e9ecc9d73cbcb790,3,69,6,75,8,2010-01-19 22:29:49,2010-01-19 20:58:26
f64371fccb61232be00534d6e9ecc9d73cbcb790...bfd31448617dc4d66f6de5ced7c260562e01349f,3,79,13,92,9,2010-01-19 22:29:57,2010-01-19 21:27:55
bfd31448617dc4d66f6de5ced7c260562e01349f...e60d653a58a568017d6f69aeaed2e3a765a98104,128,7605,3274,10879,1297,2010-01-19 23:45:36,2010-01-19 23:45:36
e60d653a58a568017d6f69aeaed2e3a765a98104...0c1255453eb36144c2a895397ebcd3aec984e87f,17,857,40,897,41,2010-01-20 00:51:27,2010-01-19 23:38:20
0c1255453eb36144c2a895397ebcd3aec984e87f...b57d7d9b4e0caf7b7232957695383f195aad258a,1,3,1,4,1,2010-01-20 17:30:56,2010-01-20 12:38:37
b57d7d9b4e0caf7b7232957695383f195aad258a...152d956deb1f40070c9bf80c27116eab169b8d14,1,0,1,1,1,2010-01-20 17:39:03,2010-01-20 17:39:03
152d956deb1f40070c9bf80c27116eab169b8d14...faefb3f5a411ebaaa381ed77c5e00d405af92a3f,1,1,0,1,1,2010-01-20 18:06:44,2010-01-20 18:06:44
faefb3f5a411ebaaa381ed77c5e00d405af92a3f...f88d39de7416431db590f5e3034cc5ce81e6bc67,1,44,0,44,1,2010-01-20 19:19:17,2010-01-20 19:12:25
f88d39de7416431db590f5e3034cc5ce81e6bc67...da00413196e432247346d9e587f8c78ce5ceb087,4,28,5,33,5,2010-01-20 19:28:32,2010-01-20 19:28:32
da00413196e432247346d9e587f8c78ce5ceb087...fe48b5faa4c30c40d6f1b75e8ffd951615bec262,1,1,1,2,1,2010-01-20 21:48:35,2010-01-20 21:48:35
fe48b5faa4c30c40d6f1b75e8ffd951615bec262...7f652b63a950d85d2b763de3b3d019d0aa9f592f,1,20,57,77,6,2010-01-20 22:58:05,2010-01-20 20:39:10
7f652b63a950d85d2b763de3b3d019d0aa9f592f...87d92f619a9b6c307a45e5a92ae63152e3b5b059,1,1,1,2,1,2010-01-20 22:59:38,2010-01-20 21:04:00
87d92f619a9b6c307a45e5a92ae63152e3b5b059...971f43d63bc4fb9c4c5f634ed16b7e3ca3c1e589,1,16,21,37,8,2010-01-20 23:01:03,2010-01-20 22:21:44
02e52ef8e9e9c6e875e171a49b049d0663cb9739...df59f067345e3a45be7637122ba8566009aab830,2,45,41,86,18,2010-01-13 16:41:04,2010-01-13 16:41:01
971f43d63bc4fb9c4c5f634ed16b7e3ca3c1e589...5547450ca57bbb7b997e2cc8177b36dfeaa2c9a8,1,1,1,2,1,2010-01-21 00:33:20,2010-01-21 00:33:20
5547450ca57bbb7b997e2cc8177b36dfeaa2c9a8...a76c7a89ce7307c08ab98d18319cf6ea44f1d8cc,3,8,3,11,5,2010-01-22 18:10:15,2010-01-16 12:51:57
a76c7a89ce7307c08ab98d18319cf6ea44f1d8cc...c99e33bc903256bb3c80731d2c22d039c45df33b,1,96,88,184,64,2010-01-24 08:00:27,2010-01-24 07:44:27
c99e33bc903256bb3c80731d2c22d039c45df33b...c86c614cacf5385101db54528f5400536bd0a4ea,2,10,4,14,6,2010-01-24 22:20:17,2010-01-24 22:10:25
c86c614cacf5385101db54528f5400536bd0a4ea...3669c75f4dec0debeebe9fb97ed79361efc752bd,1,2,6,8,4,2010-01-24 22:25:31,2010-01-22 22:31:58
3669c75f4dec0debeebe9fb97ed79361efc752bd...c420c89dbd84cc9b7460f25126dd873627e9accf,1,1,0,1,1,2010-01-24 22:39:32,2010-01-24 22:39:32
c420c89dbd84cc9b7460f25126dd873627e9accf...cd6397cc45789149f30a7fd4917cfbc6b3f5c442,5,373,33,406,16,2010-01-25 17:03:27,2010-01-07 01:28:15
cd6397cc45789149f30a7fd4917cfbc6b3f5c442...30b0522157069360615402651d6b98c9397dfc19,1,42,0,42,1,2010-01-27 17:34:45,2010-01-27 17:34:45
30b0522157069360615402651d6b98c9397dfc19...1bb52947e06d5047d4d9e9945137fcb8c186d581,1,5,4,9,4,2010-01-27 18:00:46,2010-01-27 18:00:46
1bb52947e06d5047d4d9e9945137fcb8c186d581...5a702240813b172d096961edb4c461973b09998b,2,88,0,88,2,2010-01-27 22:12:31,2010-01-26 19:48:51
5a702240813b172d096961edb4c461973b09998b...b06dda1f5e6d89fc8412a7b14bb23a6582a40850,1,12,17,29,9,2010-01-28 02:33:15,2010-01-28 02:23:35
653bf580bfa88cacda28e8e4b26525c2cd421afd...2788064bc2f85325ea328258faabc226edb373d6,2,2,2,4,2,2010-01-20 23:43:06,2010-01-20 23:43:06
2788064bc2f85325ea328258faabc226edb373d6...6f738d6e7a90f5c7659074340baaeb098c9e40f7,1,29,25,54,8,2010-01-22 22:37:30,2010-01-22 22:03:54
6f738d6e7a90f5c7659074340baaeb098c9e40f7...42ee16978e81a0f1fba0768e163b5e9584178fa3,5,399,0,399,6,2010-01-24 19:21:45,2010-01-24 19:21:45
42ee16978e81a0f1fba0768e163b5e9584178fa3...bffa18befcdb275e5b1d3104c6a80dec56af0f28,2,6,6,12,4,2010-01-24 22:06:07,2010-01-24 22:06:07
bffa18befcdb275e5b1d3104c6a80dec56af0f28...dda1d681f73aa90cf7dc4ae7c4373507612b61a0,2,11,10,21,6,2010-01-24 22:12:15,2010-01-24 22:12:15
dda1d681f73aa90cf7dc4ae7c4373507612b61a0...741e3fa91bdeec0c5cdc6e96bc4ce0ae29acae75,7,124,31,155,37,2010-01-26 01:55:08,2010-01-26 01:55:02
741e3fa91bdeec0c5cdc6e96bc4ce0ae29acae75...ccd632f2784f6f3eea7ef62fbddb38844f8b6e9d,1,4,14,18,4,2010-01-26 20:00:17,2010-01-26 20:00:17
ccd632f2784f6f3eea7ef62fbddb38844f8b6e9d...b8c3d715fdb0c08065b98a640ee72dbcbd6c5c8c,2,16,7,23,5,2010-01-27 02:34:42,2010-01-27 02:34:42
b8c3d715fdb0c08065b98a640ee72dbcbd6c5c8c...c106c3740b0b24e15f25982b246781c77707bd16,2,31,52,83,18,2010-01-27 02:35:01,2010-01-27 02:35:01
c106c3740b0b24e15f25982b246781c77707bd16...824a2fd1c63dd027c394cb03a4bde4b10d05bd4f,1,5,6,11,7,2010-01-27 02:36:24,2010-01-27 02:36:24
824a2fd1c63dd027c394cb03a4bde4b10d05bd4f...a668d07484671c832b696c93f4895a8dfa23ea8a,1,51,46,97,18,2010-01-27 02:37:16,2010-01-27 02:37:16
a668d07484671c832b696c93f4895a8dfa23ea8a...bf803f478bfdee522adf42b5c1207deb75cdb7dc,9,293,351,644,121,2010-01-27 23:40:09,2010-01-27 23:40:09
bf803f478bfdee522adf42b5c1207deb75cdb7dc...e82893d3f26e2ecb21a4108ada57f4170d382156,2,29,23,52,15,2010-01-28 00:07:15,2010-01-28 00:07:15
e82893d3f26e2ecb21a4108ada57f4170d382156...b93b09a877cf01a0cd2dc5350bbcc7150c2f94dd,1,11,17,28,8,2010-01-28 02:23:35,2010-01-28 02:23:35
b93b09a877cf01a0cd2dc5350bbcc7150c2f94dd...4347906b7fa916a5e3ad9e53ab1801aba47d8b89,1,2,2,4,2,2010-01-28 02:45:07,2010-01-28 02:45:07
4347906b7fa916a5e3ad9e53ab1801aba47d8b89...c328f3e6c61a1fc97a921eb57a54c9954fa7b1bf,1,425,0,425,1,2010-01-28 19:17:21,2010-01-28 19:17:21
c328f3e6c61a1fc97a921eb57a54c9954fa7b1bf...aadce8e1a9b1bfd6a3b6e7de060e8bf8401e8ea8,2,201,150,351,35,2010-01-28 22:31:57,2010-01-28 22:30:31
aadce8e1a9b1bfd6a3b6e7de060e8bf8401e8ea8...344243db9232e668bff0467043735ecbbcaa1386,1,8,28,36,9,2010-01-29 03:13:13,2010-01-29 03:13:13
b06dda1f5e6d89fc8412a7b14bb23a6582a40850...ac2abe5b1e5e872a587da3593e8d764512f05438,2,15,3,18,4,2010-01-30 02:04:48,2010-01-28 16:16:18
ac2abe5b1e5e872a587da3593e8d764512f05438...704f394c6671af5b981900fc3666f1b97ef580a9,1,1,0,1,1,2010-01-30 07:46:56,2010-01-30 07:11:43
704f394c6671af5b981900fc3666f1b97ef580a9...7a755e04a94c1a58bf88c3643c1dd4a027865dbf,1,1,1,2,1,2010-01-31 04:58:24,2010-01-31 04:58:24
7a755e04a94c1a58bf88c3643c1dd4a027865dbf...9f5643f427dd507ebe696fb1550cedd4b5af3705,2,54,32,86,12,2010-01-31 07:22:34,2010-01-31 07:22:34
9f5643f427dd507ebe696fb1550cedd4b5af3705...fc025f878a0b7a5bbb5810005da3e09cb856b773,1,4,5,9,4,2010-01-31 19:13:30,2010-01-31 19:13:30
fc025f878a0b7a5bbb5810005da3e09cb856b773...987441283b77aecea42338d9379a82e5ff53b1f1,2,20,15,35,10,2010-02-02 19:04:59,2010-02-02 19:04:20
987441283b77aecea42338d9379a82e5ff53b1f1...ce4204a069047146b44e687b485bb91697268460,4,121,31,152,42,2010-02-03 00:40:59,2010-02-03 00:40:54
ce4204a069047146b44e687b485bb91697268460...c723acc72192334a62bea6ff4baa33aab0da50ad,1,0,10,10,9,2010-02-03 02:45:18,2010-02-03 02:40:26
c723acc72192334a62bea6ff4baa33aab0da50ad...c7cb4daa25966e4f9af3c6d5499d762736454da9,214,20096,11840,31936,2013,2010-02-03 17:07:02,2010-02-03 17:06:03
49451c1dab494500ea2d8a098c6a7ce14de9539e...785531691b20ca490ce24c4aac0c569124fe1273,3,91,0,91,7,2010-01-29 17:57:47,2010-01-29 17:57:47
785531691b20ca490ce24c4aac0c569124fe1273...4f56d8ae24909301a6fa144c494bf5fc2512ddf5,3,7,5,12,4,2010-02-01 21:10:37,2010-02-01 16:24:44
4f56d8ae24909301a6fa144c494bf5fc2512ddf5...33509bdbe5e4f38a4b25c5793f64fb6a78d2d0ec,3,6,6,12,6,2010-02-02 02:19:14,2010-02-02 02:19:08
33509bdbe5e4f38a4b25c5793f64fb6a78d2d0ec...7c9919f8108be7f8c52a338c08b66b4bcb548fd1,1,0,8,8,5,2010-02-03 02:37:14,2010-02-03 02:37:14
7c9919f8108be7f8c52a338c08b66b4bcb548fd1...1660db6b87703ca7c9c2ea1ac7cf3b27ea8c14bf,2,5,9,14,2,2010-02-03 03:35:06,2010-02-03 03:35:06
c7cb4daa25966e4f9af3c6d5499d762736454da9...173a8c984217dcf2ba32caa389f6abaca732382d,2,0,0,0,0,2010-02-03 18:05:24,2010-02-03 18:05:24
173a8c984217dcf2ba32caa389f6abaca732382d...8f52142116a134b95407d6f9f11d022bc6d9cf8f,1,1,1,2,1,2010-02-03 18:13:15,2010-01-31 04:41:22
8f52142116a134b95407d6f9f11d022bc6d9cf8f...f3ad63557611b7f6a1bafd412a97c5c6de127162,3,21,18,39,15,2010-02-03 20:19:21,2010-02-03 20:19:08
f3ad63557611b7f6a1bafd412a97c5c6de127162...0cfa789cc530848725a8cb5595224e78ae7b9dd0,4,39,5,44,5,2010-02-03 20:20:27,2010-02-03 20:14:51
0cfa789cc530848725a8cb5595224e78ae7b9dd0...e5a41a75b7b2f6bf423ead71823e7a7a024ec786,1,0,1,1,1,2010-02-03 20:57:05,2010-02-03 20:57:05
e5a41a75b7b2f6bf423ead71823e7a7a024ec786...b73f61a137841cebac8459203b6be3baa1756980,2,32,28,60,12,2010-02-04 22:08:39,2010-02-04 21:28:04
b73f61a137841cebac8459203b6be3baa1756980...c05b5d8b59b4f18926825f091b4d364f439cecb2,3,38,3,41,3,2010-02-05 18:58:00,2010-01-07 08:41:59
c05b5d8b59b4f18926825f091b4d364f439cecb2...fe85062046ac36c2207aa0bbd2f496663eaca996,3,178,75,253,25,2010-02-06 01:14:14,2010-02-06 01:14:14
fe85062046ac36c2207aa0bbd2f496663eaca996...1737cdc1120a9e64db58780cb1286490b0b108c0,1,10,8,18,4,2010-02-06 02:23:32,2010-01-13 17:38:27
1737cdc1120a9e64db58780cb1286490b0b108c0...77145ba22945892a38be53109ed95e04709bfe8e,1,8,0,8,1,2010-02-08 00:51:20,2010-02-08 00:51:20
77145ba22945892a38be53109ed95e04709bfe8e...76c1805c679f7abb65e58c4ffe7fb52ecf666239,3,36,0,36,5,2010-02-08 01:18:28,2010-02-08 01:18:28
76c1805c679f7abb65e58c4ffe7fb52ecf666239...a695065305b710044569e0ee24b15b932fd2bd67,3,57,0,57,3,2010-02-08 02:05:58,2010-02-08 02:05:58
a695065305b710044569e0ee24b15b932fd2bd67...ae1fc497bbf026007c9d44ea425f1f060ade609f,5,33,35,68,10,2010-02-08 05:56:36,2010-02-08 05:56:36
ae1fc497bbf026007c9d44ea425f1f060ade609f...6f92d8f3b078e93a65686655b05141ab456a9293,1,3,4,7,2,2010-02-08 05:59:56,2010-02-08 05:59:56
6f92d8f3b078e93a65686655b05141ab456a9293...a38607605c084b6ecb38ee1315aa3f1ae40902ab,2,33,0,33,4,2010-02-08 06:13:10,2010-02-08 06:13:10
a38607605c084b6ecb38ee1315aa3f1ae40902ab...4234ac53e26675492d39504a73a5672c24bbda97,3,3,222,225,4,2010-02-08 21:52:13,2010-02-08 17:47:01
4234ac53e26675492d39504a73a5672c24bbda97...3adcdfc2e1db7ce0adb017a92864d44424e99012,4,1345,338,1683,63,2010-02-08 22:03:06,2010-02-05 22:26:44
3adcdfc2e1db7ce0adb017a92864d44424e99012...e33c66654ab1634fea36de13065d1bfd52fce265,2,131,78,209,8,2010-02-09 16:57:38,2010-02-09 16:50:05
e33c66654ab1634fea36de13065d1bfd52fce265...3aca908db3be3b7354d409974fb9f84c7d980644,2,5,6,11,6,2010-02-09 17:20:15,2010-02-09 17:15:02
3aca908db3be3b7354d409974fb9f84c7d980644...49de41ef463292988ddacfb01a20543b963d9669,4,24,5,29,5,2010-02-09 21:20:20,2010-02-09 21:20:20
49de41ef463292988ddacfb01a20543b963d9669...88b935928419819a6547e30dd2c8fa68fa815291,1,18,2,20,3,2010-02-09 22:11:58,2010-02-09 22:11:58
88b935928419819a6547e30dd2c8fa68fa815291...3eaaaffadb85fd6187bdfaaffc6c0ab414a89a3a,1,7,1,8,1,2010-02-09 22:45:14,2010-02-09 22:42:56
3eaaaffadb85fd6187bdfaaffc6c0ab414a89a3a...9f6f19df1bab8bd3bad0ec00ed0489957c7cfacf,1,32,0,32,1,2010-02-09 22:47:37,2010-02-09 22:32:52
9f6f19df1bab8bd3bad0ec00ed0489957c7cfacf...3337e9da1ae6989c1815b02ad639cf9381a08db0,1,3,3,6,3,2010-02-10 15:42:16,2010-02-10 10:21:54
96f42745ff82cc632a1f9af40d317021345204e6...8fdb39a4aeeb064bb26ad49e7aacd22e9e027317,1,330,1,331,3,2010-02-06 03:26:55,2010-02-06 03:26:52
8fdb39a4aeeb064bb26ad49e7aacd22e9e027317...263813ae3e0644d5b1d5b41c3a3521594da9df5d,1,24,5,29,18,2010-02-06 03:34:27,2010-02-06 03:34:27
263813ae3e0644d5b1d5b41c3a3521594da9df5d...d979a7993eb20843a8dd01ef2b596295b4d4311d,1,41,22,63,5,2010-02-06 03:47:16,2010-02-06 03:47:16
d979a7993eb20843a8dd01ef2b596295b4d4311d...979f5889d5366e93e6fc4355e891f34098055059,2,24,17,41,13,2010-02-06 04:14:48,2010-02-06 04:14:48
979f5889d5366e93e6fc4355e891f34098055059...b6edae5671e24cc0b057096b4ab8beac083aea7b,2,16,4,20,5,2010-02-08 15:36:40,2010-02-08 15:36:40
3337e9da1ae6989c1815b02ad639cf9381a08db0...b02b54e0039263937f6a5e8e5b63b0973fbc2609,4,13,4,17,8,2010-02-11 19:23:19,2010-02-11 11:09:46
b02b54e0039263937f6a5e8e5b63b0973fbc2609...cd41e30bcc843d9267bab6c954403e9f23ca5b8e,1,4,1,5,1,2010-02-11 23:17:32,2010-01-06 09:47:56
cd41e30bcc843d9267bab6c954403e9f23ca5b8e...1b42276851c9d91709073e1ae3e9ce2710fc3127,1,4,5,9,5,2010-02-11 23:51:46,2010-02-11 23:51:46
1b42276851c9d91709073e1ae3e9ce2710fc3127...6c94b8e4e4d1a41a044ad1f535953a186ec9c982,2,22,0,22,2,2010-02-12 05:11:16,2010-01-07 10:34:42
6c94b8e4e4d1a41a044ad1f535953a186ec9c982...211e82e8d9b2bcd0b054412b60d25d228a65ca41,1,8,0,8,1,2010-02-12 05:45:03,2010-01-07 10:50:28
211e82e8d9b2bcd0b054412b60d25d228a65ca41...b20c343a7aa772865f0cc4dd76d4c1984c38b33d,1,26,29,55,25,2010-02-12 05:55:08,2010-02-12 05:55:08
b20c343a7aa772865f0cc4dd76d4c1984c38b33d...7d428a7741e04ab981b7da1408fbcae33172f94c,2,2,2,4,2,2010-02-12 08:08:26,2010-02-12 08:08:26
7d428a7741e04ab981b7da1408fbcae33172f94c...bc17d94a0a5d1e8d2b432c424b7def6556fc1abe,18,52,52,104,50,2010-02-12 08:25:19,2010-02-12 08:25:15
bc17d94a0a5d1e8d2b432c424b7def6556fc1abe...896cef23c4a9bb1e3e4eeaef8cf101ea4e43af74,2,4,0,4,2,2010-02-12 08:47:35,2010-02-12 08:47:35
896cef23c4a9bb1e3e4eeaef8cf101ea4e43af74...b82ef28d9d27df56fa3b7c00c8c4209c227ae68c,18,77,76,153,66,2010-02-12 09:04:14,2010-02-12 09:04:14
b82ef28d9d27df56fa3b7c00c8c4209c227ae68c...9c6263bff8b7c18b7f5ca1880102d05c5e0a2529,1,15,7,22,4,2010-02-12 18:43:07,2010-02-10 01:27:23
9c6263bff8b7c18b7f5ca1880102d05c5e0a2529...98e61db21619228e55453eeaab8bb59a3f8eb914,2,20,0,20,4,2010-02-16 01:08:22,2010-02-14 12:11:59
98e61db21619228e55453eeaab8bb59a3f8eb914...1793ee1c80df5d76a660f4982aba01303410fdb7,2,7,7,14,6,2010-02-16 01:12:40,2010-02-13 11:27:01
1793ee1c80df5d76a660f4982aba01303410fdb7...95fd3700961f865de9190d77651931990042cd08,1,0,1,1,1,2010-02-16 01:15:40,2010-02-16 01:15:40
95fd3700961f865de9190d77651931990042cd08...80ace36e4cb287c36b44c6b986c5e5dea2b1c825,1,15,0,15,2,2010-02-16 01:22:13,2010-02-15 22:46:06
80ace36e4cb287c36b44c6b986c5e5dea2b1c825...490cac0d7e9b455de74eb6038e555a60a2fafe13,1,12,0,12,1,2010-02-16 01:24:07,2010-02-15 22:54:55
490cac0d7e9b455de74eb6038e555a60a2fafe13...fbef11b679de92edb2d4b9fc69914a0c8e9ab8ee,2,3,3,6,3,2010-02-16 17:04:19,2010-02-16 15:33:36
fbef11b679de92edb2d4b9fc69914a0c8e9ab8ee...1bf46d1536f6401bffba88cb4a8c8a10cb9f358c,2,0,4,4,2,2010-02-16 17:32:25,2010-02-16 17:32:25
1bf46d1536f6401bffba88cb4a8c8a10cb9f358c...23cf502db779e57483410092a991a774b30edc66,18,56,44,100,44,2010-02-16 21:18:42,2010-02-16 21:15:30
23cf502db779e57483410092a991a774b30edc66...ecd61742a128a515d9c123add368fbc6942b0e7c,1,1,1,2,1,2010-02-16 22:38:51,2010-02-16 22:38:51
ecd61742a128a515d9c123add368fbc6942b0e7c...5a08a5653c9f944bba72da524fcd8fa5e3c23eb6,1,2,2,4,3,2010-02-17 00:16:01,2010-02-17 00:16:01
5a08a5653c9f944bba72da524fcd8fa5e3c23eb6...4322523fcfd7ab7d29e606b3be9a41f790ae1b9b,1,1,5,6,3,2010-02-17 03:45:01,2010-02-17 00:24:02
4322523fcfd7ab7d29e606b3be9a41f790ae1b9b...5468173ce929429845f607e3aec85b612371a4a5,2,3,1,4,2,2010-02-17 03:45:12,2010-02-17 03:34:42
5468173ce929429845f607e3aec85b612371a4a5...46a47d27991e3408a1b1e2216c6bc20284462224,1,21,4,25,18,2010-02-17 05:18:02,2010-02-17 05:14:00
46a47d27991e3408a1b1e2216c6bc20284462224...ae85d9af97b4dae40e6b04addd46dd128099ddb7,20,95,87,182,71,2010-02-17 06:16:29,2010-02-17 06:16:29
ae85d9af97b4dae40e6b04addd46dd128099ddb7...6115df6338379f93de6b50e95694371821257d56,11,101,217,318,26,2010-02-17 07:55:53,2010-02-17 07:06:26
6115df6338379f93de6b50e95694371821257d56...5013bf178195f91c36814658938a7193310ea933,18,113,82,195,60,2010-02-17 19:10:10,2010-02-17 19:10:10
5013bf178195f91c36814658938a7193310ea933...f57b0e993ba4616a45cbba674b305009e4401c3d,1,167,0,167,1,2010-02-17 20:48:14,2010-02-17 20:48:14
f57b0e993ba4616a45cbba674b305009e4401c3d...df94c763aef94756b2ebc0d655274c88903a825b,2,44,53,97,47,2010-02-17 21:14:34,2010-02-17 21:14:34
df94c763aef94756b2ebc0d655274c88903a825b...d9b0eb3922b2ce8aa40c43873051c94665aae640,1,0,27,27,3,2010-02-17 21:29:25,2010-02-17 21:29:25
d9b0eb3922b2ce8aa40c43873051c94665aae640...c622142692ee37fff77c7f2bbae9b77668210391,1,2,1,3,1,2010-02-17 21:39:03,2010-02-17 21:39:03
c622142692ee37fff77c7f2bbae9b77668210391...0b823dce616c7d6c05417c0ae5c81cfc9e242dc3,1,1,1,2,1,2010-02-17 21:56:47,2010-02-17 21:56:44
0b823dce616c7d6c05417c0ae5c81cfc9e242dc3...92292c8394df98c179dcdf8bae13c52a43f78001,2,6,6,12,2,2010-02-17 22:00:53,2010-02-17 22:00:53
92292c8394df98c179dcdf8bae13c52a43f78001...0314a10e10927a52287cb5930f3ddf3c10bb6a22,1,2,2,4,2,2010-02-17 22:30:50,2010-02-17 22:30:50
0314a10e10927a52287cb5930f3ddf3c10bb6a22...217b60a2726fb2a71fdb96274d374d9b903ae782,1,2,2,4,2,2010-02-17 23:07:44,2010-02-17 23:07:19
217b60a2726fb2a71fdb96274d374d9b903ae782...87d5e5b316a4276bcf881f176971c1a237dcdc7a,4,46,6,52,4,2010-02-17 23:12:42,2010-02-17 22:57:31
87d5e5b316a4276bcf881f176971c1a237dcdc7a...916d592be185eee86d16c87df120ed70f61186fa,1,1,1,2,1,2010-02-17 23:20:09,2010-02-17 23:20:06
916d592be185eee86d16c87df120ed70f61186fa...7c1c89fc29ccb1a27fb132e9299b5bb240b51df5,2,8,5,13,4,2010-02-17 23:37:12,2010-02-17 23:36:50
7c1c89fc29ccb1a27fb132e9299b5bb240b51df5...7811fa6fec8e5b24620002b8f637e461176a7c6f,1,2,2,4,2,2010-02-18 01:07:08,2010-02-18 01:07:08
7811fa6fec8e5b24620002b8f637e461176a7c6f...4f01c74e9f8cb9850ec48462809bc9ff3cbdcb1c,1,46,29,75,13,2010-02-18 02:41:56,2010-02-18 02:41:46
4f01c74e9f8cb9850ec48462809bc9ff3cbdcb1c...c2e58c9dee39accb16d2edd12a1f35394b967d4c,3,7,7,14,3,2010-02-18 05:28:31,2010-02-18 05:28:31
c2e58c9dee39accb16d2edd12a1f35394b967d4c...cb32883537bc7c499d08d57d005a6261ddb3cfd3,1,51,0,51,1,2010-02-18 06:43:28,2010-02-18 06:43:28
cb32883537bc7c499d08d57d005a6261ddb3cfd3...bcc032e43aac86d71739150009d8d75b5a9de26f,4,68,1,69,6,2010-02-18 18:13:57,2010-02-18 08:02:55
bcc032e43aac86d71739150009d8d75b5a9de26f...3bb7ad6fea42545e9d84ba5cbef8b48e470790fc,2,41,21,62,6,2010-02-18 18:17:13,2010-02-18 16:50:48
3bb7ad6fea42545e9d84ba5cbef8b48e470790fc...c5de1b635036236a11ce74acf10fe977acfc9503,1,1,1,2,1,2010-02-18 18:17:19,2010-02-18 18:17:03
c5de1b635036236a11ce74acf10fe977acfc9503...ca02b4f5860ad3e0a8ac70ab51e089f5a374ec3d,1,3,1,4,3,2010-02-19 00:46:20,2010-02-18 19:38:49
ca02b4f5860ad3e0a8ac70ab51e089f5a374ec3d...860d008d5418cecd48c25369f2f8709a1f7ffb5c,2,156,53,209,24,2010-02-19 18:06:49,2010-02-19 17:37:20
860d008d5418cecd48c25369f2f8709a1f7ffb5c...764783560ed8d2cd523e715567938f2c3afbb8d0,5,5,207,212,8,2010-02-19 18:19:46,2010-02-19 18:16:02
764783560ed8d2cd523e715567938f2c3afbb8d0...bcf163da27676e26108ec430a392baee84f2831c,213,23731,4858,28589,2303,2010-02-19 18:40:48,2010-02-19 18:29:41
bcf163da27676e26108ec430a392baee84f2831c...375131376f2120e805463c7e832cbf7831a608a9,1,49,59,108,29,2010-02-19 19:59:05,2010-02-19 19:25:40
375131376f2120e805463c7e832cbf7831a608a9...662fdfed378db3fde5de4fde09e8a8bfbebcac4d,1,1,0,1,1,2010-02-20 00:02:14,2010-02-20 00:02:14
662fdfed378db3fde5de4fde09e8a8bfbebcac4d...ef55324f1a572d410e8022b5152ebe4778e387e0,12,402,384,786,100,2010-02-20 00:02:30,2010-02-20 00:02:30
ef55324f1a572d410e8022b5152ebe4778e387e0...d0f2d465aa8e057595e98af42685d843376488a8,4,55,41,96,12,2010-02-20 00:26:48,2010-02-20 00:26:48
d0f2d465aa8e057595e98af42685d843376488a8...c04b679e12c0c09cd78e4dd06e53a90a08986105,2,53,85,138,19,2010-02-20 00:41:08,2010-02-20 00:41:08
c04b679e12c0c09cd78e4dd06e53a90a08986105...de7016eac5653cf101dd4b9aa935f1164ad7941f,5,57,59,116,13,2010-02-20 00:55:46,2010-02-20 00:55:46
de7016eac5653cf101dd4b9aa935f1164ad7941f...860fcf23f40912872b0564b963243c3d83350849,1,2,2,4,1,2010-02-20 02:35:35,2010-02-20 01:17:54
860fcf23f40912872b0564b963243c3d83350849...fcda5e8dfa6543e350f56dd4a7f9603a4b3c9580,1,5,3,8,2,2010-02-20 02:54:25,2010-02-20 02:54:25
fcda5e8dfa6543e350f56dd4a7f9603a4b3c9580...daacb81d3ab8008d0aa3437216df32394e46186e,1,39,0,39,2,2010-02-21 02:23:21,2010-02-21 02:23:21
daacb81d3ab8008d0aa3437216df32394e46186e...5fbc750db7c8b3b0d4c68aea4a9a00a31c6b3e9a,2,20,15,35,5,2010-02-21 03:17:58,2010-02-21 03:16:57
5fbc750db7c8b3b0d4c68aea4a9a00a31c6b3e9a...7a51184420048775bb1487fe7cafccc398bcdec4,1,9,10,19,8,2010-02-21 03:44:47,2010-02-21 03:44:47
7a51184420048775bb1487fe7cafccc398bcdec4...0485cc41d5c260458f590d249c073794047434fb,4,0,306,306,4,2010-02-21 03:49:00,2010-02-21 03:45:39
0485cc41d5c260458f590d249c073794047434fb...ea4956f0465e5ea1109283f161c6ec43c30d722c,1,11,25,36,6,2010-02-21 04:36:33,2010-02-21 04:36:31
ea4956f0465e5ea1109283f161c6ec43c30d722c...68af59ef6b97f7f20860a4aff5ea7379f6e80fea,1,1,1,2,1,2010-02-21 05:03:03,2010-02-21 04:53:31
68af59ef6b97f7f20860a4aff5ea7379f6e80fea...1db824a9c183a96dfcf13244b0774527ad6ade30,2,7,1,8,3,2010-02-21 06:30:56,2010-02-21 06:30:56
1db824a9c183a96dfcf13244b0774527ad6ade30...a0c48eecab70aea11cb32c4e6125ba6ce3a7e426,5,19,19,38,16,2010-02-21 06:38:42,2010-02-21 06:38:42
a0c48eecab70aea11cb32c4e6125ba6ce3a7e426...2916a2acd45a0d828c550be3f31e61022974cf18,2,14,13,27,11,2010-02-21 06:47:49,2010-02-21 06:41:27
2916a2acd45a0d828c550be3f31e61022974cf18...6eff8937d7a98d9c4b58bcabaa84c6b9384b2968,1,1,1,2,1,2010-02-21 18:35:48,2010-02-21 13:21:23
6eff8937d7a98d9c4b58bcabaa84c6b9384b2968...7a8ede6f8086904dbe3fad9817ba3dddb54d3273,1,3,0,3,1,2010-02-21 23:48:43,2010-02-21 23:48:43
7a8ede6f8086904dbe3fad9817ba3dddb54d3273...c094dda53ca82d14adba4f6221af1c0d5f724811,2,11,2,13,4,2010-02-22 00:01:12,2010-02-22 00:01:12
c094dda53ca82d14adba4f6221af1c0d5f724811...05d6da6c4af25fc417902ad1bbae9198e58ff37a,2,51,19,70,6,2010-02-22 00:32:20,2010-02-18 09:50:48
05d6da6c4af25fc417902ad1bbae9198e58ff37a...12d78cd1df084fd9ed63d11fab929a1af0c46bca,21,52,31,83,30,2010-02-22 00:53:49,2010-02-22 00:53:20
12d78cd1df084fd9ed63d11fab929a1af0c46bca...d98ea70168dec23b14c83e64b8a4bcfefa8050d6,2,90,11,101,13,2010-02-22 05:17:25,2010-02-22 05:15:44
d98ea70168dec23b14c83e64b8a4bcfefa8050d6...9acc8a686a45242c30f50e21d3166a1d4a933785,4,45,4,49,10,2010-02-22 05:43:45,2010-02-22 04:10:23
9acc8a686a45242c30f50e21d3166a1d4a933785...4c8889bba2a06d77b8e5835e70e10e3f9b412d6f,2,19,51,70,6,2010-02-22 05:53:35,2010-02-22 05:52:56
4c8889bba2a06d77b8e5835e70e10e3f9b412d6f...49cd1bbf84271f5a59954a176fc79a99814afa8b,2,7,5,12,6,2010-02-22 06:51:23,2010-02-22 06:47:15
49cd1bbf84271f5a59954a176fc79a99814afa8b...05ae932a0efa11678da9dfa3cf642c03859245f0,3,51,19,70,6,2010-02-22 07:06:08,2010-02-22 07:02:36
05ae932a0efa11678da9dfa3cf642c03859245f0...e8363abb6a1f1f61e2d4e3e8fcfe73aa1cc406c9,2,2,1,3,2,2010-02-22 07:13:40,2010-02-22 07:13:40
e8363abb6a1f1f61e2d4e3e8fcfe73aa1cc406c9...6ee0bf704a30281e5782fa2255cbce053bc2c51b,1,18,12,30,14,2010-02-22 09:26:40,2010-02-22 09:26:35
6ee0bf704a30281e5782fa2255cbce053bc2c51b...bb0d1e65e1671aaeb21fac186b066701da0bc33b,4,46,5,51,4,2010-02-22 09:31:14,2010-02-22 07:31:08
bb0d1e65e1671aaeb21fac186b066701da0bc33b...b8dee2eb204734a473d1dc9d7ea363dcdb28d869,1,12,12,24,7,2010-02-22 14:49:14,2010-02-22 14:49:14
b8dee2eb204734a473d1dc9d7ea363dcdb28d869...46ebaa00ce4fdf2e44ddb419088d813bf83c8ffe,2,4,2,6,2,2010-02-22 20:07:07,2010-02-22 20:07:07
46ebaa00ce4fdf2e44ddb419088d813bf83c8ffe...ffb4b47367cab304ec947ec4ebb0a6c0dc8028b7,1,1,1,2,1,2010-02-22 21:25:57,2010-02-22 21:25:57
ffb4b47367cab304ec947ec4ebb0a6c0dc8028b7...dc041628ce51aa87fe1733ebb773f875fdbd4607,1,2,0,2,1,2010-02-22 21:58:48,2010-02-22 21:58:48
dc041628ce51aa87fe1733ebb773f875fdbd4607...f0f2d2ee70a7b1e64d08827f961add853c8b718c,1,1,1,2,1,2010-02-22 22:04:54,2010-02-22 22:04:54
f0f2d2ee70a7b1e64d08827f961add853c8b718c...b57d946184e85c6fdf21ffca0f76a40500ca0685,4,161,0,161,8,2010-02-23 03:23:06,2010-02-23 00:46:03
b57d946184e85c6fdf21ffca0f76a40500ca0685...c5b149ab1ef546e3a1eac2ed5327957d204ef13b,1,5,0,5,1,2010-02-23 21:05:15,2010-02-23 06:12:21
c5b149ab1ef546e3a1eac2ed5327957d204ef13b...4fd0225e41f0af9ffcee0a9f1e38ce24f2551817,1,3,0,3,1,2010-02-23 21:08:04,2010-02-23 21:08:04
4fd0225e41f0af9ffcee0a9f1e38ce24f2551817...df1c1e593f8aac17e6edd8aa1fe278893b2e5a39,2,30,0,30,3,2010-02-23 22:45:02,2010-02-23 22:45:02
df1c1e593f8aac17e6edd8aa1fe278893b2e5a39...b80bdda14e2213e928d3dc3895b3c680d2ea674a,49,1618,387,2005,213,2010-02-24 01:52:50,2010-02-24 01:52:50
b80bdda14e2213e928d3dc3895b3c680d2ea674a...e0ecf4f8f58f1703b9c9db54376316242530d39c,1,0,1,1,1,2010-02-24 06:58:54,2010-02-24 06:58:50
e0ecf4f8f58f1703b9c9db54376316242530d39c...8f59cccb75904a2780cc7d9e4cb1adc63733bd4e,1,2,2,4,2,2010-02-24 21:16:52,2010-02-24 21:11:08
8f59cccb75904a2780cc7d9e4cb1adc63733bd4e...9ad7539cf9c36edf4b014adb1ce979f578de0aa1,1,2,2,4,2,2010-02-24 22:46:30,2010-02-24 22:26:46
9ad7539cf9c36edf4b014adb1ce979f578de0aa1...04fac198225ae48ed7726c15609d254fddce4862,97,325,94,419,92,2010-02-25 19:41:11,2010-02-25 06:36:17
04fac198225ae48ed7726c15609d254fddce4862...b08f2af34439685432c37723232edb48c10649b8,1,1,1,2,1,2010-02-25 20:01:23,2010-02-25 20:01:23
b08f2af34439685432c37723232edb48c10649b8...b1b84960cedcbc033b28c0644beada614b006a9b,19,29,28,57,27,2010-02-25 21:01:21,2010-02-25 20:54:48
b1b84960cedcbc033b28c0644beada614b006a9b...a2714be8b5c397700df4c80ba6f4abbaab073ea9,3,36,12,48,11,2010-02-25 21:17:05,2010-02-25 21:12:39
a2714be8b5c397700df4c80ba6f4abbaab073ea9...de1521413ef53bd63c87a9698eb3611790bc5a56,3,75,36,111,23,2010-02-26 02:23:11,2010-02-26 01:41:02
de1521413ef53bd63c87a9698eb3611790bc5a56...3497da370bc21f402eed9a455913399bc74d5dbf,9,14,17,31,4,2010-02-26 02:49:10,2010-02-26 00:32:30
3497da370bc21f402eed9a455913399bc74d5dbf...c219571eac675871e6b5ed98c876e44d8e7caf46,1,13,24,37,4,2010-02-26 02:59:02,2010-02-26 02:58:59
c219571eac675871e6b5ed98c876e44d8e7caf46...b2995829e1acce8379005f81fabea4ff2d3327f2,1,2,1,3,1,2010-02-26 08:30:43,2010-02-26 08:30:43
b2995829e1acce8379005f81fabea4ff2d3327f2...724ccf10df8c77010600e8e1a11066faef50eb28,31,31,59,90,51,2010-02-26 20:20:10,2010-02-26 20:06:32
724ccf10df8c77010600e8e1a11066faef50eb28...2b91f8d2659a7aa668a5073c054eb7176ad07b20,1,1,1,2,1,2010-02-28 05:33:27,2010-02-28 00:58:54
2b91f8d2659a7aa668a5073c054eb7176ad07b20...faa0c6d4493d565439a06abb1cb5cb8b564b32d1,1,3,1,4,1,2010-03-01 17:11:04,2010-03-01 17:11:04
faa0c6d4493d565439a06abb1cb5cb8b564b32d1...810882c1ad15c6eb6bc0fbe6225f58a01989c290,2,299,298,597,18,2010-03-01 18:14:49,2010-03-01 18:14:49
810882c1ad15c6eb6bc0fbe6225f58a01989c290...30b700ee225d0c5527390a5be90016895ae51189,4,69,68,137,9,2010-03-01 18:42:37,2010-03-01 18:42:37
30b700ee225d0c5527390a5be90016895ae51189...b021a845f7d3712c6b821a30ebfe69156c708a28,4,12,13,25,6,2010-03-01 19:39:35,2010-03-01 19:39:35
b021a845f7d3712c6b821a30ebfe69156c708a28...6034701f57354d7e44d7378d9d6f9860e49619fc,2,22,11,33,10,2010-03-01 21:34:46,2010-02-27 08:32:55
6034701f57354d7e44d7378d9d6f9860e49619fc...55ab9b4541b2507f4e5491dd07437fab10867425,2,11,2,13,3,2010-03-01 22:13:57,2010-03-01 15:05:28
55ab9b4541b2507f4e5491dd07437fab10867425...7a251f3bdf0feac24262a94f56a65c4b18640d26,1,1,1,2,1,2010-03-02 03:14:14,2010-03-01 22:39:31
7a251f3bdf0feac24262a94f56a65c4b18640d26...20d5963fae3795e0106f3b03ccee86b3590d044c,3,149,0,149,4,2010-03-02 03:14:24,2010-03-02 02:01:44
20d5963fae3795e0106f3b03ccee86b3590d044c...fdbc9a82e44511e3b94babf3534e9feac0c3f0cf,1,6,0,6,2,2010-03-02 18:39:07,2010-03-02 18:39:02
c6cc38681941a1400ff74fac8c6e8110a61ca2c5...71d237e6a0c9b66a8f2a7335e3f1231b556dc066,5,4,4,8,4,2010-02-26 20:13:33,2010-02-26 20:13:33
71d237e6a0c9b66a8f2a7335e3f1231b556dc066...16e32c8fd969847719d0b612439197c470b5eb67,1,17,13,30,6,2010-02-26 20:13:49,2010-02-26 20:13:49
fdbc9a82e44511e3b94babf3534e9feac0c3f0cf...e165859c2ebc08b3a00adf4d99003c50ae9936ab,1,5,5,10,5,2010-03-02 20:39:38,2010-03-02 20:39:28
e165859c2ebc08b3a00adf4d99003c50ae9936ab...62c4214711f1ac16c8ad4fe3f5fb9abc5e6b15c4,1,8,2,10,2,2010-03-02 20:59:47,2010-03-02 20:59:25
62c4214711f1ac16c8ad4fe3f5fb9abc5e6b15c4...776b099d7521df89a94ea8125576cf9b381b5246,1,5,2,7,2,2010-03-02 21:10:05,2010-03-02 21:10:05
776b099d7521df89a94ea8125576cf9b381b5246...66701548198634e494a0391f6257dd1db40f387e,1,4,1,5,2,2010-03-02 21:18:59,2010-03-02 21:18:59
d9e3b466a762cb25fd73909ad4cbf4415f560de1...7bd3280cc2462cf16367c65439031d2d83bced4c,1,2,2,4,2,2010-03-02 18:59:19,2010-03-02 18:59:19
66701548198634e494a0391f6257dd1db40f387e...9be3df08283af081668c4cdfdd4297c5d15cbd04,2,21,0,21,2,2010-03-03 01:35:01,2010-03-03 01:35:01
9be3df08283af081668c4cdfdd4297c5d15cbd04...5c602b750a64136cff86c6ffe8cf06a568c12717,2,360,119,479,14,2010-03-03 01:35:34,2010-03-03 01:08:53
5c602b750a64136cff86c6ffe8cf06a568c12717...0e844d3bcbcded9792774e38e8032ac493482e63,8,117,111,228,20,2010-03-03 05:16:17,2010-03-03 05:14:23
0e844d3bcbcded9792774e38e8032ac493482e63...548d59d07e21a54fb869345ff71ed08cbe2ffad1,1,1,1,2,1,2010-03-03 18:28:33,2010-03-03 18:17:45
548d59d07e21a54fb869345ff71ed08cbe2ffad1...769a35024f399e051f16dd6c8e663f82ed37cbf2,3,18,4,22,6,2010-03-03 18:45:58,2010-03-03 18:45:58
769a35024f399e051f16dd6c8e663f82ed37cbf2...0dba38eef0f026df3f232a4f5cf1cbbcaa57fc1b,1,1,1,2,1,2010-03-03 18:57:01,2010-03-03 09:11:47
0dba38eef0f026df3f232a4f5cf1cbbcaa57fc1b...64d0e328e8a03251223dcbba8c4cc92319036d16,1,1,7,8,3,2010-03-03 20:41:31,2010-03-03 20:41:31
64d0e328e8a03251223dcbba8c4cc92319036d16...9d4d232eaaa1ae0403eb4727ee03e8749fa1c2c3,1,27,28,55,4,2010-03-03 20:49:06,2010-03-03 20:49:06
9d4d232eaaa1ae0403eb4727ee03e8749fa1c2c3...d1500cee6e2750bb57f73f8e8bfd8ca034f96110,1,8,6,14,4,2010-03-03 21:06:19,2010-03-03 21:06:19
d1500cee6e2750bb57f73f8e8bfd8ca034f96110...d5ee777af2b6a89ab866c74171f6059c85079f88,1,7,0,7,2,2010-03-03 23:34:57,2010-03-03 23:34:57
d5ee777af2b6a89ab866c74171f6059c85079f88...409020a67d3388e4eda90af546e0fbe25b0adec3,2,8,4,12,5,2010-03-04 18:02:41,2010-03-04 17:58:31
409020a67d3388e4eda90af546e0fbe25b0adec3...1e710cafa704cf451782e8c96e1b57418561600e,1,0,14,14,2,2010-03-04 19:51:39,2010-03-04 19:51:39
1e710cafa704cf451782e8c96e1b57418561600e...e6dbf8d632b9fd6797db00e59b02d2179f221fb5,1,14,0,14,2,2010-03-04 21:00:37,2010-03-04 21:00:37
66701548198634e494a0391f6257dd1db40f387e...61785afb3d22133fb1968ac7c0274999d4e432eb,2,134,0,134,2,2010-03-02 22:29:54,2010-03-02 22:12:52
61785afb3d22133fb1968ac7c0274999d4e432eb...18a70ffda13d3692aee34c097ad9330756d6479b,1,15,12,27,13,2010-03-02 22:29:54,2010-03-02 22:28:00
18a70ffda13d3692aee34c097ad9330756d6479b...9415ca909ea0e5e5c0b390fa60759952143beed3,1,1,3,4,2,2010-03-05 17:42:32,2010-03-03 11:39:17
9415ca909ea0e5e5c0b390fa60759952143beed3...f6e00759effd1d550657aa6ce0208ee04eda87bd,2,144,0,144,2,2010-03-05 17:43:28,2010-03-03 11:39:41
f6e00759effd1d550657aa6ce0208ee04eda87bd...b4fba5fe8ee5fe3a43405fbd8838feab5f259bc8,1,5,11,16,3,2010-03-05 17:43:29,2010-03-04 13:25:59
b4fba5fe8ee5fe3a43405fbd8838feab5f259bc8...48562fa9389946ae7ac5b977004fc0d47e5af947,2,23,2,25,5,2010-03-05 17:43:29,2010-03-04 21:06:06
48562fa9389946ae7ac5b977004fc0d47e5af947...0fcc94525a59df4ae1a90a7c3d4c62df0e19b36c,3,4,4,8,4,2010-03-05 17:56:25,2010-03-05 17:56:25
0fcc94525a59df4ae1a90a7c3d4c62df0e19b36c...145fac2b56a29270c798996db508a9fc6338c1f2,1,10,2,12,5,2010-03-05 18:24:20,2010-03-05 18:24:20
145fac2b56a29270c798996db508a9fc6338c1f2...78c61000c20e0456a3d887bc397fe29815f2f9e5,1,7,0,7,2,2010-03-05 18:53:59,2010-03-05 18:53:59
78c61000c20e0456a3d887bc397fe29815f2f9e5...a96b5c792e49c0e2e425ce14746276d1c59c45ff,1,41,0,41,1,2010-03-05 18:54:28,2010-03-05 18:54:28
a96b5c792e49c0e2e425ce14746276d1c59c45ff...dbf9e466bc263cc08b217403cdf4a14a66f82935,2,39,1,40,2,2010-03-05 19:04:19,2010-03-05 19:04:19
5217eda1ae3ff02e8ac32af464f21ad13eea91a4...6d60d2db00d25b385bd978ea074486651ae10c50,2,4,8,12,5,2010-03-05 22:36:13,2010-03-05 22:36:13
6d60d2db00d25b385bd978ea074486651ae10c50...e72b072d5333c87e2ca972f0d88dabfa0cedbec2,3,42,21,63,19,2010-03-05 23:31:26,2010-03-05 23:31:21
e72b072d5333c87e2ca972f0d88dabfa0cedbec2...939a6c7484b31557878ae54faf0a6e5a31d6454e,1,29,24,53,11,2010-03-06 00:02:06,2010-03-05 23:59:31
939a6c7484b31557878ae54faf0a6e5a31d6454e...5c78c45fa3cb1ad91ec96eef6302e7f1c4b762af,3,59,0,59,3,2010-03-06 00:17:57,2010-03-06 00:12:31
5c78c45fa3cb1ad91ec96eef6302e7f1c4b762af...b9cd3363efc6d249c86ebc2a8e5b523c968aaac9,2,5,1,6,2,2010-03-06 01:07:02,2010-03-06 01:07:02
b9cd3363efc6d249c86ebc2a8e5b523c968aaac9...39b63dfe1737d46a8c8818c92773ef181fd174b3,5,39,5,44,5,2010-03-06 01:55:13,2010-03-06 01:55:00
39b63dfe1737d46a8c8818c92773ef181fd174b3...a258992855d05c78375fc8c23ebcb03e37c9ea63,1,1,0,1,1,2010-03-06 02:07:28,2010-03-06 02:07:01
a258992855d05c78375fc8c23ebcb03e37c9ea63...374300ca8d1a97989b9c50f8cc8f3ed893e3bdd8,3,21,10,31,4,2010-03-07 20:07:57,2010-02-27 17:18:41
374300ca8d1a97989b9c50f8cc8f3ed893e3bdd8...d67fdcc177622d8544163587d48de12bc74a6018,1,3,3,6,4,2010-03-07 20:13:16,2010-03-07 20:13:16
d67fdcc177622d8544163587d48de12bc74a6018...209b219b10cde8e225660baea3653645e8c0571c,1,9,1,10,2,2010-03-08 16:33:10,2010-03-08 16:33:10
209b219b10cde8e225660baea3653645e8c0571c...c47391526c171b1d9c3ce389197b9481ebf02fe3,1,1,1,2,1,2010-03-08 17:05:31,2010-03-07 14:33:02
c47391526c171b1d9c3ce389197b9481ebf02fe3...9a9f08b1bc01edff0b66943334b2e34d3afb7016,4,84,31,115,27,2010-03-08 17:05:56,2010-03-07 15:33:21
9a9f08b1bc01edff0b66943334b2e34d3afb7016...40e42e8107f9c580d83167305c42e8471e7b6259,1,5,3,8,3,2010-03-08 17:10:24,2010-03-08 17:10:24
40e42e8107f9c580d83167305c42e8471e7b6259...c98b0799bf77cc5e01ae9a3c39d8180d8ee976d4,46,335,174,509,103,2010-03-08 17:33:11,2010-03-08 17:33:11
c98b0799bf77cc5e01ae9a3c39d8180d8ee976d4...e898c1f2e30a05dd6a45f061468392ca44754b5f,37,1046,455,1501,258,2010-03-08 18:18:24,2010-03-08 18:18:24
e898c1f2e30a05dd6a45f061468392ca44754b5f...44dde5f24cf53ca1b01b5a4307dc861d53a53f4b,19,32,15,47,21,2010-03-08 18:20:07,2010-03-08 18:02:19
44dde5f24cf53ca1b01b5a4307dc861d53a53f4b...39472709f0ab076f587e261dbaf026ddc6e55405,1,2,1,3,1,2010-03-08 18:22:19,2010-03-08 18:03:43
39472709f0ab076f587e261dbaf026ddc6e55405...c9c13e07187bfa93d4dd3eb6c3a93a685ee2cc16,1,3,2,5,1,2010-03-08 19:13:24,2010-03-08 19:13:24
8c4561d2a0a59ba28e3a7a5b5eba00fb41c74ead...00333d59d6e6e692df9bce40ee94e39f25ed8674,1,1,1,2,1,2010-03-09 18:33:19,2010-03-09 18:33:19
c9c13e07187bfa93d4dd3eb6c3a93a685ee2cc16...5809483b78902df5e8162ca74e923369b1cb3bf3,1,3,1,4,2,2010-03-08 21:35:08,2010-03-08 21:35:08
5809483b78902df5e8162ca74e923369b1cb3bf3...74614c1bf173ce2c655a5d3595b45e38fd5f12d1,1,0,1,1,1,2010-03-09 01:45:57,2010-03-09 01:45:57
74614c1bf173ce2c655a5d3595b45e38fd5f12d1...5861db8a69695e4f1a8c82ad2de55e4b07ab981a,77,81,82,163,80,2010-03-09 01:57:04,2010-03-08 23:06:29
5861db8a69695e4f1a8c82ad2de55e4b07ab981a...a38aa02f9f31ab7ace90c737e064bb6f2b78e3cd,1,4,2,6,2,2010-03-09 01:57:08,2010-03-08 23:06:46
a38aa02f9f31ab7ace90c737e064bb6f2b78e3cd...c488e5775a57391b9b2a8037f849975c0084d05c,3,6,3,9,3,2010-03-09 01:57:38,2010-03-08 23:07:06
c488e5775a57391b9b2a8037f849975c0084d05c...04999ef969d62aa96291db34dcaf275efe6c0a63,2,1,3,4,2,2010-03-09 02:04:59,2010-03-09 02:04:54
04999ef969d62aa96291db34dcaf275efe6c0a63...fb6dc11f112b7b6ec989d5fa882d094327e8fdf3,3,11,19,30,9,2010-03-09 03:06:25,2010-03-09 03:06:25
fb6dc11f112b7b6ec989d5fa882d094327e8fdf3...602d1861a1cb5ff426aa17c3d1c2ddb8423b7ac1,1,2,1,3,1,2010-03-09 17:04:45,2010-03-08 23:07:26
602d1861a1cb5ff426aa17c3d1c2ddb8423b7ac1...b90d63b9983186a2f13a2ef7d399960f979fc486,1,1,1,2,1,2010-03-09 17:05:20,2010-03-08 23:08:30
b90d63b9983186a2f13a2ef7d399960f979fc486...f8eb16372835f1f17deeb2b169c6d5a14a50cd40,3,15,0,15,3,2010-03-09 17:30:14,2010-03-09 01:42:10
faffee0c62d67c5e5e159f0e63a277d02a56eb78...c69d3f4a3556753fc3c4a4ac292710fa0a7b7b7f,1,1,1,2,1,2010-03-09 18:54:01,2010-03-09 18:54:01
c69d3f4a3556753fc3c4a4ac292710fa0a7b7b7f...93c0c24a4ed4794572913eef3a92ed1e030c8ca9,1,1,1,2,1,2010-03-09 18:54:26,2010-03-09 18:54:26
93c0c24a4ed4794572913eef3a92ed1e030c8ca9...6310e717e4f1e0468d63ebe4e77b8dbfeee22ed6,1,1,6,7,2,2010-03-09 19:20:58,2010-03-09 19:20:58
6310e717e4f1e0468d63ebe4e77b8dbfeee22ed6...264a67aed2f4ac65a9b3f6fd3c2622793e83e6ad,3,52,45,97,38,2010-03-09 19:59:42,2010-03-09 19:59:42
264a67aed2f4ac65a9b3f6fd3c2622793e83e6ad...b07f2e25f414dde014528705ddbc0823d1aeb89f,2,28,20,48,13,2010-03-09 20:00:06,2010-03-09 20:00:06
b07f2e25f414dde014528705ddbc0823d1aeb89f...c1a0ade7e79067533a2d292d6d7aa3fe554eaf9c,5,174,109,283,60,2010-03-10 00:27:49,2010-03-10 00:27:49
c1a0ade7e79067533a2d292d6d7aa3fe554eaf9c...0918bb2070b8bea73cfb3d36f284904b6884239c,4,49,34,83,21,2010-03-10 02:37:23,2010-03-10 02:37:23
f8eb16372835f1f17deeb2b169c6d5a14a50cd40...dd21a4f4b9f76e31b7a7990be3937a836eb27c60,1,1,6,7,2,2010-03-09 19:21:19,2010-03-09 19:20:58
dd21a4f4b9f76e31b7a7990be3937a836eb27c60...c2c0cfb75f46ddcb3a0900f244966764d2640240,1,1,1,2,1,2010-03-09 21:05:44,2010-03-09 20:51:09
c2c0cfb75f46ddcb3a0900f244966764d2640240...073947c150316cfc0bd440851e590663c3b67814,194,10315,3224,13539,1383,2010-03-10 18:50:46,2010-03-10 18:50:46
073947c150316cfc0bd440851e590663c3b67814...70b2a44579393139603dbef8500e5efd3f34200e,1,0,1,1,1,2010-03-10 19:03:26,2010-03-10 19:03:26
777e1a6c69b78c7acc24812862a73c9ad9c4c7ba...03f2bfe51f4051009b5f8c66114a3a44929f2ed4,1,3,5,8,2,2010-03-11 20:37:37,2010-03-11 20:37:32
03f2bfe51f4051009b5f8c66114a3a44929f2ed4...9b67962a447540e062bb25fc1c324f806f9eecd7,2,14,0,14,3,2010-03-11 20:38:42,2010-03-11 20:38:42
9b67962a447540e062bb25fc1c324f806f9eecd7...462a8f8652dafaf01f05623dd311e57e226cead4,1,10,0,10,4,2010-03-11 20:39:50,2010-03-11 20:39:50
462a8f8652dafaf01f05623dd311e57e226cead4...4635ed7fdeef93c011d06ecbfa0030d3c0e1f9d8,1,11,0,11,3,2010-03-11 20:40:24,2010-03-11 20:40:19
4635ed7fdeef93c011d06ecbfa0030d3c0e1f9d8...ca862d75def02f3b09aa35f79c2df8bc0bd16788,1,191,5,196,20,2010-03-11 20:43:32,2010-03-11 20:43:32
ca862d75def02f3b09aa35f79c2df8bc0bd16788...3d10852c3368b492583f16e266374710ebdd54c3,1,11,2,13,5,2010-03-12 20:21:27,2010-03-12 20:15:25
3d10852c3368b492583f16e266374710ebdd54c3...177de8fefc9a06e1f54c151fc5658b41b86972a5,1,4,4,8,4,2010-03-12 20:21:27,2010-03-12 20:20:41
177de8fefc9a06e1f54c151fc5658b41b86972a5...836e6a3fcbe297fb22edfda521c3e6ea540b59e5,1,13,0,13,3,2010-03-12 20:27:41,2010-03-12 20:27:41
836e6a3fcbe297fb22edfda521c3e6ea540b59e5...b94af8d6b1671da9e89da8e6f13937f41d7c673a,1,5,1,6,2,2010-03-12 20:34:25,2010-03-12 20:34:17
b94af8d6b1671da9e89da8e6f13937f41d7c673a...3adf7a3dcfd68f0347b0ab38250b003f73344dad,1,11,11,22,2,2010-03-12 20:39:37,2010-03-12 20:38:27
70b2a44579393139603dbef8500e5efd3f34200e...976983960d69cb8aac8327880b0f3c1ef28ff81f,3,43,9,52,10,2010-03-11 05:44:59,2010-03-10 08:17:15
976983960d69cb8aac8327880b0f3c1ef28ff81f...358b7516c74df65bad7200ff4f9f9a5830cf580f,1,3,3,6,1,2010-03-11 18:27:20,2010-03-11 18:27:20
358b7516c74df65bad7200ff4f9f9a5830cf580f...6d9227b79a65c1d5df8e0ffb86c8a7fb1efe7884,1,3,5,8,2,2010-03-11 20:48:47,2010-03-11 20:37:32
6d9227b79a65c1d5df8e0ffb86c8a7fb1efe7884...c93bab141c0ebf119cd9f47d43c1e865c14e1620,1,55,22,77,8,2010-03-11 22:00:19,2010-03-11 21:15:32
c93bab141c0ebf119cd9f47d43c1e865c14e1620...ff2457754ce355caf2ba22210cbe42cbd412cdca,4,55,15,70,22,2010-03-11 22:31:51,2010-03-11 22:31:51
ff2457754ce355caf2ba22210cbe42cbd412cdca...6bd11f147ab6277a672f8e36e707306752d93538,1,2,0,2,1,2010-03-11 22:32:10,2010-03-11 22:32:10
6bd11f147ab6277a672f8e36e707306752d93538...0c17067d873f807b1280d5e922f44da3abc4c328,4,85,13,98,11,2010-03-12 06:00:55,2010-03-08 04:35:39
0c17067d873f807b1280d5e922f44da3abc4c328...dd857f9fdfa9bb2dcd71500173bd203aa2dd588b,1,1,1,2,1,2010-03-12 06:04:00,2010-03-12 06:03:55
dd857f9fdfa9bb2dcd71500173bd203aa2dd588b...c96b7e5ca05b7ca3b34b45deb01ac0498cb201c6,1,2,2,4,2,2010-03-12 06:05:09,2010-03-12 06:05:09
c96b7e5ca05b7ca3b34b45deb01ac0498cb201c6...116dfb87403af2f08d163dd8bf39f2ffaf7a4754,1,4,2,6,3,2010-03-12 06:07:50,2010-03-12 04:05:47
116dfb87403af2f08d163dd8bf39f2ffaf7a4754...b13081691e27f6cc62628d0fc38b1a9f5e290bc5,1,2,1,3,2,2010-03-12 07:32:13,2010-03-12 07:14:54
b13081691e27f6cc62628d0fc38b1a9f5e290bc5...6ec2f877c201ad238d44506a27fd26fc5518f891,1,1,1,2,1,2010-03-12 07:50:41,2010-03-12 07:50:41
6ec2f877c201ad238d44506a27fd26fc5518f891...ae10a483834d2870073b5513badc5b7003bcdade,2,75,0,75,3,2010-03-12 16:22:48,2010-03-12 08:36:00
ae10a483834d2870073b5513badc5b7003bcdade...c1613e6ebb37a74b103e600467c89e3df15d005c,2,5,12,17,3,2010-03-12 17:23:05,2010-03-12 17:23:05
28211519b6af14e5d49cf855195e1a360f15f68f...c857d65dd3e74bb34ee573bcc0ccf3840dcc2986,1,0,0,0,0,2010-03-12 20:43:28,2010-03-12 20:43:28
c857d65dd3e74bb34ee573bcc0ccf3840dcc2986...b571900d9ccf4d7f64bfa31a6920bdbdcbe45b64,2,8,3,11,2,2010-03-12 20:56:10,2010-03-12 20:55:34
b571900d9ccf4d7f64bfa31a6920bdbdcbe45b64...aa6eaae0aa8ba46ca2a25bd0b1e8eec5498df847,1,12,12,24,6,2010-03-12 21:06:05,2010-03-12 21:04:33
c1613e6ebb37a74b103e600467c89e3df15d005c...2c7cbbc1b08a1c5bb8ccee3fcb6dc0145d6f1a70,2,68,23,91,10,2010-03-12 21:47:56,2010-03-12 21:39:54
2c7cbbc1b08a1c5bb8ccee3fcb6dc0145d6f1a70...d7efb0fdb2b269f3fa16a26c0690f3f41c1dfe65,1,6,10,16,5,2010-03-12 21:48:03,2010-03-12 21:45:49
c6ebfb0cc6be203f702762c0fc484e18592ef2bb...96f08cf05c3bd5ee291e85e2135d8020dd7f662a,4,201,10,211,8,2010-03-13 02:39:02,2010-03-13 02:39:02
d7efb0fdb2b269f3fa16a26c0690f3f41c1dfe65...61c801413544a50000faa7f58376e9b33ba6254f,5,28,5,33,5,2010-03-13 02:50:46,2010-03-13 02:50:46
61c801413544a50000faa7f58376e9b33ba6254f...ffeb4722d48898a26739934b60afa9feeff1de08,1,1,1,2,1,2010-03-13 20:20:09,2010-03-13 20:20:09
ffeb4722d48898a26739934b60afa9feeff1de08...d2ec5c23cf14dda7c214d87ae5c9b34e2e0b18e4,1,1,1,2,1,2010-03-13 20:29:33,2010-03-13 20:21:21
d2ec5c23cf14dda7c214d87ae5c9b34e2e0b18e4...7be0d0623888f3e4791721e483949123b9b1dfec,1,1,1,2,1,2010-03-13 20:47:41,2010-03-13 20:47:41
7be0d0623888f3e4791721e483949123b9b1dfec...49d30c6478df14ca41540ee7c8d8d9279f2a3651,2,9,5,14,5,2010-03-14 04:45:26,2010-03-13 22:35:09
49d30c6478df14ca41540ee7c8d8d9279f2a3651...004faf384690aa67cfd377e6ebcfd1667d5f2489,1,6,0,6,3,2010-03-14 06:27:51,2010-03-14 03:36:45
004faf384690aa67cfd377e6ebcfd1667d5f2489...0d5a1fed33134d05911a153ade2bf8ae8710fc57,1,1,1,2,1,2010-03-15 06:08:45,2010-03-15 03:24:29
0d5a1fed33134d05911a153ade2bf8ae8710fc57...4ccdc501d48a0f198a040ee46f4dab27a611a489,8,100,77,177,39,2010-03-15 15:04:35,2010-03-15 15:00:19
4ccdc501d48a0f198a040ee46f4dab27a611a489...1395cba6cec0fb9179b39c12274e13e66e935130,1,5,5,10,5,2010-03-15 15:07:33,2010-03-15 15:07:33
1395cba6cec0fb9179b39c12274e13e66e935130...a6f904cab79c6d1f8dc93a877412695b8e3bc43d,1,0,2,2,1,2010-03-15 15:14:51,2010-03-15 15:14:51
a6f904cab79c6d1f8dc93a877412695b8e3bc43d...d96c52694a56e10f2ba5db239680cb6a0af02120,104,107895,1104,108999,509,2010-03-15 15:39:56,2010-03-15 15:18:45
d96c52694a56e10f2ba5db239680cb6a0af02120...1256df76bc47847cf377e40ca205049d55790f49,1,2,2,4,2,2010-03-15 16:02:52,2010-03-15 16:02:52
1256df76bc47847cf377e40ca205049d55790f49...5c712a7da5b9552e8ce6db6aa17cd51a39d4c483,2,60,61,121,7,2010-03-15 17:41:58,2010-03-15 17:41:58
5c712a7da5b9552e8ce6db6aa17cd51a39d4c483...3994340a4567d10a855f0c1f112f0965517e3e52,1,9,3,12,9,2010-03-15 19:50:00,2010-03-15 19:49:40
3994340a4567d10a855f0c1f112f0965517e3e52...627fb5adbbc324fae657d2c88523234e6d83cc1c,7,167,103,270,84,2010-03-15 21:24:15,2010-03-15 20:48:03
627fb5adbbc324fae657d2c88523234e6d83cc1c...8492c52e1529cf5988efd2b64e853b08a9c3a079,7,63,64,127,50,2010-03-15 21:24:15,2010-03-15 21:05:18
8492c52e1529cf5988efd2b64e853b08a9c3a079...c90546f138e42ee191a9ef240a0168007b243604,2,34,26,60,7,2010-03-15 21:24:15,2010-03-15 21:22:50
c90546f138e42ee191a9ef240a0168007b243604...6befc72f829bfc7c027da8e96b12cf9d2a8f6a8e,2,5,0,5,2,2010-03-15 21:25:06,2010-03-15 20:47:50
cbfd4da818b393628bb81d5ed449efd15c1e2635...fdf46a65c92efc6de21c20c2d65d6883f269d0e6,8,76,186,262,42,2010-03-15 22:11:40,2010-03-15 22:11:40
fdf46a65c92efc6de21c20c2d65d6883f269d0e6...953fa3a5f5561fd287832bc36c9bffb852b40bf1,3,50,27,77,11,2010-03-15 23:44:50,2010-03-15 23:44:50
953fa3a5f5561fd287832bc36c9bffb852b40bf1...04c06b91493762dea34d91c34f2a33ebaa919eca,24,518,520,1038,105,2010-03-17 21:00:17,2010-03-17 21:00:17
6befc72f829bfc7c027da8e96b12cf9d2a8f6a8e...5d5c8cf04a092cf2eb8093ad525b69e34924c977,1,2,2,4,2,2010-03-15 22:53:44,2010-03-15 22:53:44
5d5c8cf04a092cf2eb8093ad525b69e34924c977...943b2c61a80d24d67e353c90abd7ec6f1549f6d4,2,31,10,41,7,2010-03-16 17:27:47,2010-03-16 06:27:21
943b2c61a80d24d67e353c90abd7ec6f1549f6d4...3847add9436ce2eb080b9a91dd6955603ac6a714,1,13,13,26,8,2010-03-16 17:29:16,2010-03-16 08:18:21
3847add9436ce2eb080b9a91dd6955603ac6a714...3c97a4391af24aea35cb5efa7a40956f7a51d547,1,24,18,42,10,2010-03-16 17:29:43,2010-03-16 08:54:47
3c97a4391af24aea35cb5efa7a40956f7a51d547...217e4b40d410f1ecedf4bdb412d6b514a98c1eee,2,13,0,13,2,2010-03-16 17:48:14,2010-03-16 17:48:14
217e4b40d410f1ecedf4bdb412d6b514a98c1eee...31ed37fdf0a3f650bbd8c4a6c211fa6b78652ae8,2,14,17,31,7,2010-03-17 03:09:13,2010-03-17 01:36:42
31ed37fdf0a3f650bbd8c4a6c211fa6b78652ae8...84277ea84544d9999e7fea3eec30abada673f7c8,2,9,1,10,2,2010-03-17 07:46:44,2010-03-17 05:13:45
84277ea84544d9999e7fea3eec30abada673f7c8...8aaffe71eebd3dbf4e8713c79aea6b4413396f9e,1,1,1,2,1,2010-03-17 21:44:15,2010-03-17 17:20:36
8aaffe71eebd3dbf4e8713c79aea6b4413396f9e...2d7e86ef58ee341e323c65193115c2ad7385f131,80,3678,104697,108375,362,2010-03-17 22:52:57,2010-03-17 22:52:57
b865f9e9c8048254f61d3577f2f52731c6620a95...1332cafb7cedc59691f3ff60b777b3c3a2d9774c,4,44,44,88,38,2010-03-17 23:31:24,2010-03-17 23:31:24
1332cafb7cedc59691f3ff60b777b3c3a2d9774c...6db43f4c2992834274a33f818276731d4788cd7f,2,290,229,519,68,2010-03-18 20:21:52,2010-03-18 20:21:33
6db43f4c2992834274a33f818276731d4788cd7f...33d5c46e8cc92f5bc079b873f8baa20bee2f86ae,10,21,21,42,16,2010-03-18 21:01:17,2010-03-18 21:01:17
33d5c46e8cc92f5bc079b873f8baa20bee2f86ae...916e057feab485d05888f94b00dd0fe8753753b5,1,7,5,12,4,2010-03-18 21:33:42,2010-03-18 21:33:42
916e057feab485d05888f94b00dd0fe8753753b5...1762abcecefb41fd68692b12ceba441aaa33c7c3,3,43,35,78,17,2010-03-18 22:49:42,2010-03-18 22:49:42
1762abcecefb41fd68692b12ceba441aaa33c7c3...90295d9fce277a306149b185bd46a77eac818322,2,83,3,86,7,2010-03-19 09:24:16,2010-03-19 09:24:11
90295d9fce277a306149b185bd46a77eac818322...e01464373f1c4dfcc62a13cacf7bc8a498ccc925,1,2,2,4,2,2010-03-19 18:30:51,2010-03-19 18:29:14
e01464373f1c4dfcc62a13cacf7bc8a498ccc925...f8c3b6009d4b5aeaa0f5ca6ac9ff600e61e5e651,1,12,72,84,12,2010-03-19 18:34:26,2010-03-19 18:34:22
f8c3b6009d4b5aeaa0f5ca6ac9ff600e61e5e651...0c64768cb4d9d12c4815dc2f21efe3d2934d6803,1,0,5,5,1,2010-03-19 18:46:09,2010-03-19 18:46:09
0c64768cb4d9d12c4815dc2f21efe3d2934d6803...3e969f0f74a65c39453db352fcd723b61b6690bb,1,9,7,16,6,2010-03-19 18:46:35,2010-03-19 18:46:35
3e969f0f74a65c39453db352fcd723b61b6690bb...3a993d889704314329686695a01b58d60f0d4b85,3,15,8,23,8,2010-03-19 19:02:59,2010-03-19 19:02:59
3a993d889704314329686695a01b58d60f0d4b85...776c3e2b29f379c89187e3527d5f81757fdbc923,1,9,1,10,2,2010-03-19 19:08:57,2010-03-19 19:08:57
776c3e2b29f379c89187e3527d5f81757fdbc923...4278f35e892935787afb1db18ca8811fba0d18f7,2,104,26,130,12,2010-03-20 01:36:22,2010-03-20 01:36:22
4278f35e892935787afb1db18ca8811fba0d18f7...b80f6e9ed16f32920e81f9acf749d7bf9faf1320,19,414,414,828,123,2010-03-20 02:52:09,2010-03-20 02:22:04
b80f6e9ed16f32920e81f9acf749d7bf9faf1320...ac684f358391400a4533fc81fa7c522090aec884,4,58,4,62,12,2010-03-20 03:33:09,2010-03-20 03:33:09
ac684f358391400a4533fc81fa7c522090aec884...025116f8d01e2ff07af79d3f8bfaf9cd1b734740,8,36,18,54,12,2010-03-20 03:58:24,2010-03-20 03:50:29
025116f8d01e2ff07af79d3f8bfaf9cd1b734740...663269f6870ca6bf55303f2b1e297e684f9fe768,3,35,23,58,6,2010-03-20 04:22:11,2010-03-20 04:22:11
663269f6870ca6bf55303f2b1e297e684f9fe768...139c91e892b0f9dcf9015f81486e614eaf26d906,1,7,1,8,3,2010-03-20 04:25:29,2010-03-20 04:25:29
2d7e86ef58ee341e323c65193115c2ad7385f131...df8164c1c33b49431087327310bd22be6169aaa9,1,3,1,4,2,2010-03-18 14:51:32,2010-03-17 02:33:29
df8164c1c33b49431087327310bd22be6169aaa9...39f0ef9d4af6dbf75482b53b33ca3deafc2d4c5f,1,0,3,3,1,2010-03-18 14:56:54,2010-03-18 06:59:01
39f0ef9d4af6dbf75482b53b33ca3deafc2d4c5f...e5cbe73a82cd57d115f9bb29f127c686835c22b3,3,23,7,30,9,2010-03-18 21:08:20,2010-03-18 15:50:15
e5cbe73a82cd57d115f9bb29f127c686835c22b3...9e8afe9133f18382e787fd84a405f04990259d3e,1,10,8,18,3,2010-03-19 05:23:13,2010-03-18 23:29:49
9e8afe9133f18382e787fd84a405f04990259d3e...b29f78772ec183b4e4aee0f67f95c599a7d8060b,1,29,1,30,3,2010-03-20 03:56:03,2010-03-20 03:56:03
b29f78772ec183b4e4aee0f67f95c599a7d8060b...618296ef571e873976f608d91a3d6b9e65fe8284,5,20,5,25,5,2010-03-20 04:07:03,2010-03-20 04:07:03
903977d5e8e37f011e37057a066148e4ddebe5fc...ebe2721cbfdb2a9b7ed177d45b3c7eed92f18837,1,16,7,23,8,2010-03-20 04:50:11,2010-03-20 04:49:00
ebe2721cbfdb2a9b7ed177d45b3c7eed92f18837...04001fb591ee9adbe343d4b23aac48abce0809e2,1,0,5,5,2,2010-03-20 04:51:07,2010-03-20 04:51:04
cc053e7df7fb1bf44c094b62b8c33820b8497e35...c66a0a739f6549561c0108aabbafd67cf36cb5fd,1,36,36,72,22,2010-03-20 06:09:16,2010-03-20 06:09:16
c66a0a739f6549561c0108aabbafd67cf36cb5fd...069099a3e39b6b25fc5c1b10105c4d280760963f,1,0,58,58,1,2010-03-20 06:45:28,2010-03-20 06:45:28
069099a3e39b6b25fc5c1b10105c4d280760963f...bfdc421ddadd35b2ea5de07a756a52b881c7a981,1,5,0,5,2,2010-03-20 10:01:17,2010-03-20 10:01:17
bfdc421ddadd35b2ea5de07a756a52b881c7a981...765f0cdece338fcc09e6c318379a953132053194,1,1,1,2,1,2010-03-22 12:06:13,2010-03-22 12:06:13
765f0cdece338fcc09e6c318379a953132053194...54d4efd44b6a6d9ac4430012377a4c5064fec6c6,8,195,159,354,87,2010-03-22 16:00:43,2010-03-22 16:00:24
54d4efd44b6a6d9ac4430012377a4c5064fec6c6...6f84063a3b06dae2dc919ee9ab371e4cddcd9112,3,13,11,24,8,2010-03-23 15:13:17,2010-03-23 01:47:04
6f84063a3b06dae2dc919ee9ab371e4cddcd9112...6e603ccbe2dec3394ea0af86e226bfc9eea7bcd5,1,1,1,2,1,2010-03-23 15:54:05,2010-03-23 00:22:09
6e603ccbe2dec3394ea0af86e226bfc9eea7bcd5...b35d72df760bb7d65382b156de4863738e28c662,96,107109,896,108005,341,2010-03-23 22:19:32,2010-03-23 22:19:12
b35d72df760bb7d65382b156de4863738e28c662...a01d8a0d68511b14b3348143bce990329f14cc5d,3,12,9,21,12,2010-03-24 00:28:26,2010-03-24 00:28:20
a01d8a0d68511b14b3348143bce990329f14cc5d...3238944c7aaef10ffa966b5e730204f24beead68,1,5,5,10,5,2010-03-24 01:10:13,2010-03-24 01:10:13
3238944c7aaef10ffa966b5e730204f24beead68...8e9ec4abea57544dd2889a56fc5dbf9fe763669b,3,18,30,48,19,2010-03-24 03:54:19,2010-03-24 03:54:16
8e9ec4abea57544dd2889a56fc5dbf9fe763669b...218d7e9f2d54dfc63b2c3d650913cb965d67e7b7,1,1,3,4,1,2010-03-24 03:56:51,2010-03-24 03:56:44
218d7e9f2d54dfc63b2c3d650913cb965d67e7b7...6b6dcf4aad25db81eb6073252fa49237ef78fac8,1,0,0,0,0,2010-03-24 04:02:30,2010-03-24 04:02:30
6b6dcf4aad25db81eb6073252fa49237ef78fac8...70ffdf5db9d687b4a68d8feb53c5e7de338cdd85,2,3,3,6,3,2010-03-24 04:10:01,2010-03-24 04:10:01
70ffdf5db9d687b4a68d8feb53c5e7de338cdd85...5c6f063ef25e7223e1950d9de6f4f0aa7201ced2,1,49,50,99,26,2010-03-24 04:31:44,2010-03-24 04:31:44
5c6f063ef25e7223e1950d9de6f4f0aa7201ced2...6f21ac12827aab4e9c745442ea192ff8700161a4,1,0,1,1,1,2010-03-24 04:41:42,2010-03-24 04:41:17
6f21ac12827aab4e9c745442ea192ff8700161a4...3546106c43c08aed0f3e45f81f82496c9c51f6b9,1,5,0,5,4,2010-03-24 14:21:00,2010-03-24 14:20:56
3546106c43c08aed0f3e45f81f82496c9c51f6b9...6740dd48b38b8de1b490437cee09b2a052de583a,1,12,8,20,3,2010-03-25 16:50:49,2010-03-25 16:50:49
6740dd48b38b8de1b490437cee09b2a052de583a...48f5f77713db6cb9d13495f0b780a62dbad2a9a7,180,16938,3555,20493,1419,2010-03-25 16:53:58,2010-03-25 16:53:58
48f5f77713db6cb9d13495f0b780a62dbad2a9a7...a49bf8622fe396be232de7a9889e3d0d2d6ced29,8,0,6975,6975,8,2010-03-25 22:01:59,2010-03-25 22:01:59
a49bf8622fe396be232de7a9889e3d0d2d6ced29...7ed80451ca989bb8a03ce9917b1e3694f1bc45f8,1,2,4,6,3,2010-03-26 15:35:12,2010-03-26 15:34:56
7ed80451ca989bb8a03ce9917b1e3694f1bc45f8...bb00fef3cd2ff446aa5c1894fb4830f83750018a,1,15,3,18,2,2010-03-26 15:36:08,2010-03-26 15:35:46
bb00fef3cd2ff446aa5c1894fb4830f83750018a...6192b8659a3dedb86393cfb78121a26f2a3e31e6,43,2593,1822,4415,279,2010-03-26 16:09:40,2010-03-26 16:09:40
6192b8659a3dedb86393cfb78121a26f2a3e31e6...6ecdeada49efca8c0b4ff368eeb3336555dede47,1,0,1,1,1,2010-03-26 16:58:21,2010-03-26 16:58:21
6ecdeada49efca8c0b4ff368eeb3336555dede47...179f718d62c17c674a941a2539b81fee54152da5,7,2165,2385,4550,9,2010-03-27 01:28:40,2010-03-26 19:39:35
179f718d62c17c674a941a2539b81fee54152da5...aa6a7852868b341776ea7ebfa9f291f88c533dda,1,2,0,2,1,2010-03-27 02:32:19,2010-03-27 02:32:19
aa6a7852868b341776ea7ebfa9f291f88c533dda...d1b78c3f5d948728dcee852a9c2bfd59f4e01fbd,1,160,189,349,50,2010-03-27 21:07:43,2010-03-27 21:07:43
d1b78c3f5d948728dcee852a9c2bfd59f4e01fbd...40ea061c30a9f6be21a35239341a259847f8cac5,24,270,46,316,31,2010-03-29 08:04:53,2010-03-29 08:04:53
40ea061c30a9f6be21a35239341a259847f8cac5...7c77a56b4af0e8c61c47417a8c0f7334262593ea,1,234,100,334,75,2010-03-29 18:23:27,2010-03-28 07:41:58
7c77a56b4af0e8c61c47417a8c0f7334262593ea...52b295400d4a0d63de6f1ab332c230591572c6dc,24,46,270,316,31,2010-03-29 23:42:39,2010-03-29 23:42:39
52b295400d4a0d63de6f1ab332c230591572c6dc...9e97e185adaec1ca8723c8420157bef5ab41afca,1,3,0,3,1,2010-03-31 15:12:35,2010-03-20 13:37:16
9e97e185adaec1ca8723c8420157bef5ab41afca...da16128bf6e4c4d4b9ce4f57475a531c529c4910,1,1,0,1,1,2010-03-31 15:13:03,2010-03-31 14:59:09
da16128bf6e4c4d4b9ce4f57475a531c529c4910...aec80d47bb5e17890b41a4b0fc1e95c844aca2eb,1,3,3,6,2,2010-03-31 15:20:59,2010-03-31 15:20:59
aec80d47bb5e17890b41a4b0fc1e95c844aca2eb...18de108e4c0853ad846e8f1970a97974a33aad59,2,14,8,22,3,2010-03-31 17:38:25,2010-03-30 13:27:23
18de108e4c0853ad846e8f1970a97974a33aad59...d52f63d9b29446b26ec831acd8ec6da9147896e5,4,24,24,48,23,2010-03-31 18:27:57,2010-03-31 18:27:57
d52f63d9b29446b26ec831acd8ec6da9147896e5...4279725d790b5b23e89e4ff90cff2c03be21635d,2,17,12,29,7,2010-03-31 20:44:36,2010-03-31 20:36:20
4279725d790b5b23e89e4ff90cff2c03be21635d...7af9cb9e80cd803afb7775cb4bcd606e334b6b7b,1,1,1,2,1,2010-04-01 15:58:19,2010-04-01 15:32:26
7af9cb9e80cd803afb7775cb4bcd606e334b6b7b...3197cf291d8c2500f45bb33be7af5c8e0b2031fc,2,76,116,192,19,2010-04-01 22:53:48,2010-04-01 22:53:48
3197cf291d8c2500f45bb33be7af5c8e0b2031fc...e232cf3100a232ba824bf04fb8dd0bf39cb27373,1,4,1,5,1,2010-04-01 23:24:36,2010-04-01 23:24:31
e232cf3100a232ba824bf04fb8dd0bf39cb27373...fdae14070cde99d19de2ec03697b3151c1b8cb7f,1,13,23,36,7,2010-04-01 23:46:37,2010-04-01 23:46:37
fdae14070cde99d19de2ec03697b3151c1b8cb7f...fb3a9cd0d8e8cf5f3120012a28643230b31c1f83,5,1232,16,1248,28,2010-04-03 00:13:54,2010-04-02 23:11:53
fb3a9cd0d8e8cf5f3120012a28643230b31c1f83...c55c0a1fca6abec269538ea738749e2129242e1f,4,119,0,119,4,2010-04-03 00:14:03,2010-04-03 00:10:32
c55c0a1fca6abec269538ea738749e2129242e1f...129310676d276f2e6333d3af8f1122cdf7b9a634,1,73,63,136,22,2010-04-03 00:30:49,2010-04-03 00:30:27
129310676d276f2e6333d3af8f1122cdf7b9a634...c9f71a807c106fd5390e35054445a3f3b8111931,1,22,2,24,6,2010-04-12 17:57:22,2010-04-12 17:57:22
c9f71a807c106fd5390e35054445a3f3b8111931...45b8d24ea60b42f3c20932a96b57f148d7bf58f4,1,9,0,9,2,2010-04-12 19:36:46,2010-04-12 19:36:46
45b8d24ea60b42f3c20932a96b57f148d7bf58f4...80174392bbcec0cec1c79628fb09af351a6488aa,6,1664,33,1697,13,2010-04-12 20:25:16,2010-04-12 20:25:16
fdae14070cde99d19de2ec03697b3151c1b8cb7f...b9106b0ecdb712ecae9b0030c0f2c3f14803fa8d,3,122,116,238,52,2010-04-02 20:20:56,2010-04-02 20:19:02
b9106b0ecdb712ecae9b0030c0f2c3f14803fa8d...53530e981a81e25e527e6e6ee3aeae8b1beaac59,4,19,13,32,8,2010-04-02 21:55:28,2010-04-02 21:55:28
53530e981a81e25e527e6e6ee3aeae8b1beaac59...94644d743c0aa04fb2bc9e1267205b02c6ee7f82,5,0,1469,1469,5,2010-04-02 23:01:16,2010-04-02 22:57:32
94644d743c0aa04fb2bc9e1267205b02c6ee7f82...c0e18f37d40f0766fa214e6e3eaed6fa7caa72c0,1,1,1,2,1,2010-04-02 23:02:48,2010-04-02 23:02:48
c0e18f37d40f0766fa214e6e3eaed6fa7caa72c0...ae805f10573e008702741a1e1bf85ce974968d52,2,40,26,66,13,2010-04-02 23:15:53,2010-04-02 23:15:53
ae805f10573e008702741a1e1bf85ce974968d52...cd577d503d05ded96f11fa97d538509d87debc12,25,257,731,988,80,2010-04-05 01:07:32,2010-04-05 01:07:32
cd577d503d05ded96f11fa97d538509d87debc12...b72ffc0e0768c7ee689b32da56c52d4c685489b6,3,63,0,63,5,2010-04-05 01:59:40,2010-04-05 01:58:55
b72ffc0e0768c7ee689b32da56c52d4c685489b6...ec0266a56cca10c5faa92c54baf2d3bb447ece65,1,5,0,5,1,2010-04-05 02:33:12,2010-04-05 02:33:09
ec0266a56cca10c5faa92c54baf2d3bb447ece65...01f7d4484e5aa079155c0affc35210eee6959f99,23,193,96,289,72,2010-04-05 04:12:25,2010-04-05 04:12:25
01f7d4484e5aa079155c0affc35210eee6959f99...85487c82d0bc187398b0168d1ac9607f51e76867,2,34,23,57,23,2010-04-05 04:37:08,2010-04-05 04:37:06
85487c82d0bc187398b0168d1ac9607f51e76867...b0d1d6c2b905e03f910f611fe5f916b30164d9b2,1,27,13,40,6,2010-04-05 05:51:30,2010-04-05 05:51:27
b0d1d6c2b905e03f910f611fe5f916b30164d9b2...0301adf9b44a966ba0d2503ab79a6583e7f6436b,2,29,25,54,3,2010-04-05 18:32:18,2010-04-05 18:32:18
0301adf9b44a966ba0d2503ab79a6583e7f6436b...801fb8a614aeafb05235527557d762068e74e6ff,1,86,13,99,6,2010-04-05 21:04:14,2010-04-05 20:51:32
801fb8a614aeafb05235527557d762068e74e6ff...1b758ef268c1b83c8c838b2cac10f174a78c3064,8,10,14,24,8,2010-04-05 23:50:05,2010-04-05 23:50:05
1b758ef268c1b83c8c838b2cac10f174a78c3064...4befe93a4b4373cf2c3171d94e60a99bac854ee8,2,79,29,108,8,2010-04-06 00:05:35,2010-03-22 22:25:12
4befe93a4b4373cf2c3171d94e60a99bac854ee8...53dd9fe200d7cd1d6f3e5c5a96891b778303be37,3,13,2,15,3,2010-04-06 01:10:36,2010-04-06 00:54:48
53dd9fe200d7cd1d6f3e5c5a96891b778303be37...d7a450105778016c27446ab254dd579dbc509ad5,1,1,1,2,1,2010-04-06 17:23:43,2010-04-06 16:07:10
d7a450105778016c27446ab254dd579dbc509ad5...ca0038bf2f077ed3db186866befb97bdc5c4c14f,1,2,2,4,2,2010-04-06 22:23:42,2010-04-06 22:23:42
ca0038bf2f077ed3db186866befb97bdc5c4c14f...38041fcaa023e60fcec1373bf909f67f321aa775,5,42,0,42,6,2010-04-06 23:15:09,2010-04-06 23:15:04
38041fcaa023e60fcec1373bf909f67f321aa775...25adb2eb55ea46b25b9ddbe8f1e0208ea6b61d1f,1,2,1,3,2,2010-04-07 05:05:12,2010-04-07 03:39:29
25adb2eb55ea46b25b9ddbe8f1e0208ea6b61d1f...e9a116fe02ef77c6e809a788cde89a2e18b55f39,83,15448,4,15452,93,2010-04-07 08:17:49,2010-04-06 10:41:32
e9a116fe02ef77c6e809a788cde89a2e18b55f39...dc1f4ebd4478b9fe32039d79a553fac01efafcf5,5,809,0,809,7,2010-04-07 08:29:05,2010-04-06 10:28:37
dc1f4ebd4478b9fe32039d79a553fac01efafcf5...96df65e88e010efe8f222110814bf862aaaea9c7,1,5,4,9,4,2010-04-07 08:29:20,2010-04-07 01:37:40
96df65e88e010efe8f222110814bf862aaaea9c7...888a494ad814e73d8720bf9715916ec1397c3a49,1,4,0,4,1,2010-04-07 08:45:20,2010-04-07 08:45:20
888a494ad814e73d8720bf9715916ec1397c3a49...067f4086b640c0a56dbb5174a69ba8777f054822,8,1663,0,1663,10,2010-04-07 16:36:35,2010-04-07 16:05:37
067f4086b640c0a56dbb5174a69ba8777f054822...d36bb6536ed8e375dc5ff76a496e9e98c2c78765,2,6,1,7,4,2010-04-07 18:47:45,2010-04-07 18:07:57
d36bb6536ed8e375dc5ff76a496e9e98c2c78765...eac3dc9d5f9be2228297a9524acbaceab6728dfa,1,1,1,2,1,2010-04-07 18:47:46,2010-04-07 18:25:55
eac3dc9d5f9be2228297a9524acbaceab6728dfa...9ea8c9f2b0422ffaa4ff22722cfb20079c1a28eb,17,5,33,38,5,2010-04-07 20:34:40,2010-04-07 20:34:40
9ea8c9f2b0422ffaa4ff22722cfb20079c1a28eb...f56ff0de9280a1371a319e368380043bd8c8fe6c,6,1646,0,1646,6,2010-04-07 20:39:11,2010-04-07 20:39:11
f56ff0de9280a1371a319e368380043bd8c8fe6c...f13e2f96e40ecdd6e76854508c3b0cad6bcd1a8d,2,51,0,51,3,2010-04-07 22:37:08,2010-04-07 22:37:08
f13e2f96e40ecdd6e76854508c3b0cad6bcd1a8d...8f671041a52dd28fa473762b637b03c402f0db04,3,68,18,86,7,2010-04-07 23:04:33,2010-04-07 23:04:33
8f671041a52dd28fa473762b637b03c402f0db04...33e774eeba5a97af41fd17a8eb03b333a98ade33,1,5,46,51,7,2010-04-07 23:05:07,2010-04-07 23:05:07
33e774eeba5a97af41fd17a8eb03b333a98ade33...970e9025fe17756f658bea97cc2c2969d71a7fa1,1,0,5,5,5,2010-04-07 23:09:10,2010-04-07 23:09:10
970e9025fe17756f658bea97cc2c2969d71a7fa1...0281e1acf6e9cb3cd668dda91d4933160c4b95a7,1,5,1,6,2,2010-04-07 23:19:50,2010-04-07 23:19:50
0281e1acf6e9cb3cd668dda91d4933160c4b95a7...d923c94a0ca6ca4aa23318013de443dbb83398cb,45,126,9802,9928,63,2010-04-08 01:25:37,2010-04-08 01:25:37
d923c94a0ca6ca4aa23318013de443dbb83398cb...cb84cde4d42637fd79ceacea1f0123995c23eea5,1,3,0,3,2,2010-04-08 07:59:57,2010-04-08 07:59:57
cb84cde4d42637fd79ceacea1f0123995c23eea5...62277ab79b5cbdaba45693b33bfd55d61caa2f4a,1,7,3,10,2,2010-04-08 08:00:35,2010-04-08 08:00:29
62277ab79b5cbdaba45693b33bfd55d61caa2f4a...7a6b5635eb565f3c4d858e76d0f8eae8d86e746c,1,0,3,3,2,2010-04-08 14:19:42,2010-04-08 14:19:42
7a6b5635eb565f3c4d858e76d0f8eae8d86e746c...de9778b5bdc53d8011c4d3ac4ad8971635868223,1,1,1,2,1,2010-04-08 15:12:30,2010-04-08 15:07:15
de9778b5bdc53d8011c4d3ac4ad8971635868223...c16508c87ad86fd55fc5317efd89c92f90341603,2,11,0,11,3,2010-04-08 15:17:58,2010-04-08 14:15:56
c16508c87ad86fd55fc5317efd89c92f90341603...3819920d77c065215bc4e226ca528fb4a8230ab0,1,116,115,231,87,2010-04-08 18:26:26,2010-04-08 17:22:55
3819920d77c065215bc4e226ca528fb4a8230ab0...7faf7d5c8d5ddb35548a0754f0c0fc3ad713c195,1,157,146,303,43,2010-04-08 18:26:26,2010-04-08 17:37:10
7faf7d5c8d5ddb35548a0754f0c0fc3ad713c195...50c70ac7149907f00cea01dfb39703590c54de42,32,164,86,250,96,2010-04-08 19:24:29,2010-04-08 17:44:22
50c70ac7149907f00cea01dfb39703590c54de42...1a9c9b0c55544d024796baf27e519880f365e9e0,5,194,1,195,5,2010-04-08 21:20:33,2010-04-08 20:07:14
1a9c9b0c55544d024796baf27e519880f365e9e0...b544185bd8838115981003d48b62591b4b3028e2,1,2,1,3,2,2010-04-08 21:20:43,2010-04-08 20:29:39
b544185bd8838115981003d48b62591b4b3028e2...499c615c9e5151bc5d85165c68122171ddfa9e7f,2,400,324,724,139,2010-04-08 22:00:08,2010-04-08 21:22:30
499c615c9e5151bc5d85165c68122171ddfa9e7f...b8bb6e90074452b41c45a31b03d261484cb841d4,1,1,0,1,1,2010-04-08 22:20:13,2010-04-08 22:20:13
b8bb6e90074452b41c45a31b03d261484cb841d4...08a09bb50abcc355941f62deecece5cb6f3a2382,5,58,79,137,20,2010-04-08 23:31:02,2010-04-08 23:31:02
08a09bb50abcc355941f62deecece5cb6f3a2382...631e5bf5cb3d31f9245d9814e1de1d84c0d83395,1,139,24,163,17,2010-04-08 23:31:36,2010-03-31 06:12:15
631e5bf5cb3d31f9245d9814e1de1d84c0d83395...323a5e11e5ae53a081210da12dd43beb595839c6,1,11,13,24,11,2010-04-09 00:39:33,2010-04-09 00:39:33
323a5e11e5ae53a081210da12dd43beb595839c6...a5184fe938d2fd3de2018d97c601e7ce9b9eaafe,2,98,15,113,3,2010-04-09 05:42:02,2010-04-09 05:42:02
a5184fe938d2fd3de2018d97c601e7ce9b9eaafe...06b9c8bf1f75c20433413a6aececa26326641a3f,1,1,0,1,1,2010-04-09 15:01:36,2010-04-09 12:22:00
06b9c8bf1f75c20433413a6aececa26326641a3f...ff56d6364eb09079b1ab6e9ef32d66c2cb4c0bfd,1,1,1,2,1,2010-04-09 17:01:47,2010-04-09 16:56:22
ff56d6364eb09079b1ab6e9ef32d66c2cb4c0bfd...b36f11d7b50e12838b414b866878748109c056ec,1,2,1,3,1,2010-04-09 17:42:20,2010-04-09 17:42:20
b36f11d7b50e12838b414b866878748109c056ec...9331218449921290d699fc8eaaa77a9b7155223b,2,37,3,40,6,2010-04-09 17:44:13,2010-04-09 17:44:08
9331218449921290d699fc8eaaa77a9b7155223b...fd0bebcdbc1509af16229108a2e05c512a8c99ce,2,59,11,70,4,2010-04-09 19:45:44,2010-04-09 19:34:21
fd0bebcdbc1509af16229108a2e05c512a8c99ce...03ea4b644e98c59d41af4ee14fb01a2fbc69f867,2,687,555,1242,353,2010-04-09 21:51:20,2010-04-09 21:51:20
03ea4b644e98c59d41af4ee14fb01a2fbc69f867...ee3026797c00e84ae13ab216da7f54835404e6a3,3,34,90,124,31,2010-04-09 22:34:08,2010-04-09 22:34:08
ee3026797c00e84ae13ab216da7f54835404e6a3...54f02345b5bd456900643456857c98fec0dc8e02,4,27,42,69,18,2010-04-09 23:52:10,2010-04-09 22:50:38
54f02345b5bd456900643456857c98fec0dc8e02...07e64d45ffa1856e824c4fa6afd0442ba61d6fd8,3,25,4,29,3,2010-04-10 00:05:03,2010-04-09 23:58:29
07e64d45ffa1856e824c4fa6afd0442ba61d6fd8...dd50b864497dfa2854f12d10f175900e071e2b63,1,1,1,2,1,2010-04-11 19:16:36,2010-04-10 16:08:11
dd50b864497dfa2854f12d10f175900e071e2b63...93913dbdb8f621bef46c61d1f8a824a19a57dfa5,1,39,0,39,1,2010-04-11 19:21:36,2010-04-11 19:21:33
93913dbdb8f621bef46c61d1f8a824a19a57dfa5...57fbb627cadb356bc335274d203c21c71d022b5d,8,65,65,130,65,2010-04-11 21:48:23,2010-04-11 20:46:24
57fbb627cadb356bc335274d203c21c71d022b5d...8553e8a15d0ff3715fb3a8a02062de9dcb9339b6,3,11,1,12,4,2010-04-11 22:15:36,2010-04-11 22:15:36
8553e8a15d0ff3715fb3a8a02062de9dcb9339b6...715e119eea035930fc8e550cf982f6efb47580b3,1,1,1,2,1,2010-04-11 22:47:29,2010-03-24 06:27:31
715e119eea035930fc8e550cf982f6efb47580b3...cc9d5ab546e92ff9e56e4355e0cf0e557221bbab,2,15,16,31,2,2010-04-11 23:12:20,2010-04-11 23:12:20
cc9d5ab546e92ff9e56e4355e0cf0e557221bbab...b7441040f87ff5e0e7b4575852996b6a64e0ea8f,2,241,88,329,36,2010-04-12 07:31:51,2010-04-11 23:13:32
b7441040f87ff5e0e7b4575852996b6a64e0ea8f...62d9852c3d6ed32825abfd79645c72a66fb00e6f,8,116,58,174,23,2010-04-12 17:34:35,2010-04-12 16:57:24
62d9852c3d6ed32825abfd79645c72a66fb00e6f...4681e34c1e74e96f3027e88523dadf6b27a611c3,1,18,13,31,18,2010-04-12 19:38:11,2010-04-12 19:34:24
4681e34c1e74e96f3027e88523dadf6b27a611c3...afe3c1cdea8cd88e04a09961567216606f5f0117,1,32,16,48,6,2010-04-12 21:38:16,2010-04-12 21:29:49
afe3c1cdea8cd88e04a09961567216606f5f0117...1efd26157289ae52bf190dd044daf92b1db8fb80,1,1,3,4,1,2010-04-12 23:27:04,2010-04-12 23:27:04
1efd26157289ae52bf190dd044daf92b1db8fb80...b7947e45c092df8b032f3b689a020ed972ef485a,1,2,0,2,1,2010-04-12 23:34:39,2010-04-12 23:34:39
b7947e45c092df8b032f3b689a020ed972ef485a...57ea07ac912d88fb947a95ffd502c23f2d60f8b9,4,101,114,215,23,2010-04-12 23:57:45,2010-04-12 16:27:32
144200435f727027082da7383d5f49932aa0c3dc...fbad5dc06216ab6cdfd91a03f893b6671289a2a4,1,3,3,6,3,2010-04-15 05:17:22,2010-04-15 05:17:22
57ea07ac912d88fb947a95ffd502c23f2d60f8b9...b98cd6753b44563662f60ccf4feb22cfab404858,2,1,113,114,3,2010-04-13 20:45:31,2010-04-13 20:44:05
b98cd6753b44563662f60ccf4feb22cfab404858...57edff1f31903dbd9008fe8fe32304ede21eda00,1,0,5,5,1,2010-04-13 20:50:17,2010-04-13 20:50:17
57edff1f31903dbd9008fe8fe32304ede21eda00...4e7e2f872421e9c89538807ce191cd86e40341ab,3,90,7,97,11,2010-04-13 22:43:46,2010-04-13 22:39:15
4e7e2f872421e9c89538807ce191cd86e40341ab...a98d23d9058cdf71a452e71bf8831e4ba2445b50,2,6,3,9,3,2010-04-13 22:43:58,2010-04-13 22:43:22
a98d23d9058cdf71a452e71bf8831e4ba2445b50...71dc232f93a394daf9a372f6ef14c1458f38f534,1,3,3,6,3,2010-04-13 22:56:08,2010-04-13 22:56:06
71dc232f93a394daf9a372f6ef14c1458f38f534...6732e7fa1794d49078ac34fd0541dfa77c1df36d,1,63,0,63,1,2010-04-13 23:22:14,2010-04-13 23:22:12
6732e7fa1794d49078ac34fd0541dfa77c1df36d...b549b3fcce9aaff8936670420509bff25d2ed49e,1,20,19,39,7,2010-04-13 23:43:15,2010-04-13 23:43:15
b549b3fcce9aaff8936670420509bff25d2ed49e...a934566eb9b1cf7ee9e6bb669e73e46300aa1129,1,0,0,0,0,2010-04-13 23:57:19,2010-04-13 23:57:16
a934566eb9b1cf7ee9e6bb669e73e46300aa1129...b8c0349750a09b10245d633826e75c0c5d135039,2,12,1,13,2,2010-04-14 07:36:34,2010-04-14 07:36:34
b8c0349750a09b10245d633826e75c0c5d135039...684740c23200be67368fb1b225140e06c1fec295,1,1,1,2,1,2010-04-14 07:41:56,2010-04-14 07:41:56
684740c23200be67368fb1b225140e06c1fec295...af49187e57105a793ef4abf33339d854f2b5cda2,4,140,4,144,25,2010-04-14 10:22:38,2010-04-14 10:22:38
af49187e57105a793ef4abf33339d854f2b5cda2...760bba55186eba039ca00e532f7813d2aea450a2,2,38,8,46,10,2010-04-14 10:52:15,2010-04-14 10:52:15
760bba55186eba039ca00e532f7813d2aea450a2...41ef1717e096a9e1761efa0df97c395f59c51f16,182,9196,4788,13984,1556,2010-04-14 17:34:27,2010-04-14 17:34:17
41ef1717e096a9e1761efa0df97c395f59c51f16...9cf2a02d8ba49244779257969d0307c96b2d777b,3,73,6,79,11,2010-04-14 18:59:24,2010-04-14 18:59:24
9cf2a02d8ba49244779257969d0307c96b2d777b...4efe27bbabc1e6c6982303c8862f314d6b943dc4,1,12,4,16,5,2010-04-15 01:50:44,2010-04-15 01:50:41
4efe27bbabc1e6c6982303c8862f314d6b943dc4...ac3bc2ed41c18cfd45772ec895afe98a929ab78c,2,28,26,54,9,2010-04-15 08:30:58,2010-04-15 08:29:39
ac3bc2ed41c18cfd45772ec895afe98a929ab78c...d2e1b0855f3630ef2be45b477e93d8bc865cc7b7,2,0,0,0,0,2010-04-15 08:37:27,2010-04-15 08:37:27
d2e1b0855f3630ef2be45b477e93d8bc865cc7b7...5281f2901249de173704234238a4cb872b4fb884,2,9,5,14,6,2010-04-15 09:09:51,2010-04-15 09:01:49
5281f2901249de173704234238a4cb872b4fb884...2ad587cc354e2694bc47be01eca9b15b6db46377,1,1,1,2,1,2010-04-15 09:09:51,2010-04-15 09:09:36
2ad587cc354e2694bc47be01eca9b15b6db46377...311d7dee19034ff1c6bc9098c36973b8d687eaba,4,27,5,32,4,2010-04-15 09:09:51,2010-04-15 08:54:20
e6a1091cc60882c7cdefae8da164304a5839858e...e4a6b72ae354bdfee6da30eeb171c85ebf5077a3,2,110,83,193,28,2010-04-15 18:57:17,2010-04-15 18:57:17
311d7dee19034ff1c6bc9098c36973b8d687eaba...6ad18a27a0bf9a8f0c6d618c0011f2264239af04,1,1,1,2,1,2010-04-15 18:19:54,2010-04-15 18:19:54
8efab857d0a87b8a2cb00afaaac2239d8c23041b...3510669db23d0600d2a31f66838cc28d270e6ee9,2,7,5,12,7,2010-04-15 19:03:55,2010-04-15 19:03:55
3510669db23d0600d2a31f66838cc28d270e6ee9...39464b498fcd805d4e2d56861702ae4380f7dc71,2,118,27,145,9,2010-04-16 01:03:56,2010-04-16 00:52:42
39464b498fcd805d4e2d56861702ae4380f7dc71...c2a06725d6ebc0b23bfb20a8ce478b1ebf042c4e,9,454,4,458,14,2010-04-18 19:01:36,2010-04-17 15:18:15
c2a06725d6ebc0b23bfb20a8ce478b1ebf042c4e...4ff45c264c55eb43a746b8a4af7f833d49ddda3d,1,0,57,57,2,2010-04-18 19:44:23,2010-04-18 19:44:23
4ff45c264c55eb43a746b8a4af7f833d49ddda3d...8daa1f8d04bca8464a3192cad202980509096503,1,125,22,147,3,2010-04-18 21:23:01,2010-04-18 20:35:44
8daa1f8d04bca8464a3192cad202980509096503...fa514a9f1670741b3b54ef27f2ea1253dfd091d6,1,6,0,6,1,2010-04-18 21:25:05,2010-04-18 16:24:08
fa514a9f1670741b3b54ef27f2ea1253dfd091d6...6e715b82d0e87756fae75cf463aa7cb19c0eda4b,25,749,75,824,72,2010-04-18 23:57:13,2010-04-18 23:57:13
6e715b82d0e87756fae75cf463aa7cb19c0eda4b...ff6409469d3ce4e1ca28eddf6c6490fab34cd604,1,4,3,7,2,2010-04-19 22:48:12,2010-04-19 22:48:12
ff6409469d3ce4e1ca28eddf6c6490fab34cd604...60de86351ac9264845bc4033eb7e44b9b0c74c6d,1,12,0,12,1,2010-04-19 22:51:32,2010-04-19 13:17:37
60de86351ac9264845bc4033eb7e44b9b0c74c6d...61308a5bff0fe184744f5f6e9031991826b74796,1,2,0,2,1,2010-04-19 22:52:51,2010-04-19 13:18:16
61308a5bff0fe184744f5f6e9031991826b74796...ac9d9f4e9f05142f0877bcc89279369f36378a9d,1,4,4,8,2,2010-04-20 19:32:18,2010-04-20 17:07:55
ac9d9f4e9f05142f0877bcc89279369f36378a9d...27ec33aad73046b01fe23525e4d596771d2945be,1,8,3,11,2,2010-04-20 21:44:05,2010-04-20 21:43:08
27ec33aad73046b01fe23525e4d596771d2945be...5f8f561d610d4d308199cd8202029c89bd9e4452,4,81,2,83,8,2010-04-20 23:34:21,2010-04-20 23:01:41
5f8f561d610d4d308199cd8202029c89bd9e4452...4badb227cf10120bd6ab9b432381ec702ccb4d5e,1,3,5,8,3,2010-04-21 17:51:45,2010-04-21 10:54:56
4badb227cf10120bd6ab9b432381ec702ccb4d5e...7ff53f4c6aa5bbab8b623e4aedecea0511cb6da9,3,76,74,150,5,2010-04-21 18:38:46,2010-04-21 01:13:07
7ff53f4c6aa5bbab8b623e4aedecea0511cb6da9...e0061a511d6e9b4ac3ea0049c836e68278eaff42,3,72,66,138,3,2010-04-21 18:38:51,2010-04-21 01:17:54
e0061a511d6e9b4ac3ea0049c836e68278eaff42...cfd459abde7060a1785dcc80d4eab87276c64f51,3,478,474,952,14,2010-04-21 19:05:01,2010-04-21 01:22:51
cfd459abde7060a1785dcc80d4eab87276c64f51...94f9dc67c0ab3a2509aeadd62883cb11147b45cd,1,2,0,2,1,2010-04-21 20:16:46,2010-04-21 20:16:46
94f9dc67c0ab3a2509aeadd62883cb11147b45cd...3934cb54853ca23cee7ef3c6206a5b1264f8ba6d,2,47,6,53,5,2010-04-21 22:15:21,2010-04-21 22:15:21
3934cb54853ca23cee7ef3c6206a5b1264f8ba6d...d70474dc102639a355445af821fa2bd582acd703,3,31,0,31,4,2010-04-22 21:25:13,2010-04-22 21:25:13
d70474dc102639a355445af821fa2bd582acd703...76d525b03467ac342e83b3781e7efcee47739320,1,0,1,1,1,2010-04-22 21:43:25,2010-04-22 21:43:25
76d525b03467ac342e83b3781e7efcee47739320...11f673e819d79f07dbb42b75a5b070af66fcb4a5,1,9,5,14,3,2010-04-22 22:48:57,2010-04-22 22:48:57
11f673e819d79f07dbb42b75a5b070af66fcb4a5...6abdf051d3d91d05f262d2dfe98e1c768ff0b543,6,75,19,94,13,2010-04-23 00:22:06,2010-04-23 00:22:03
6abdf051d3d91d05f262d2dfe98e1c768ff0b543...0633e5cac981cf6433baeea581b34461e3f82dc2,1,15,6,21,4,2010-04-23 00:31:35,2010-04-23 00:31:35
0633e5cac981cf6433baeea581b34461e3f82dc2...c9e27b11c5b995b7ff9d3c1dde4687ccd54f0071,8,375,397,772,31,2010-04-23 00:53:45,2010-04-23 00:53:45
c9e27b11c5b995b7ff9d3c1dde4687ccd54f0071...40820ec8d53e89af9efa0b5caef52b7f42ad5186,1,3,2,5,2,2010-04-23 17:34:10,2010-04-23 15:31:50
40820ec8d53e89af9efa0b5caef52b7f42ad5186...7a34afba773a09c7862759872905657ec9629351,1,8,2,10,3,2010-04-23 17:53:09,2010-04-23 17:29:27
7a34afba773a09c7862759872905657ec9629351...e72b7b8002c487d32f3a651687acca13f2009b99,117,3467,1110,4577,496,2010-04-23 19:05:36,2010-04-23 19:05:36
e72b7b8002c487d32f3a651687acca13f2009b99...16f02403f8f92a58ba09cfad76ca468b07e47053,1,51,20,71,11,2010-04-23 21:08:54,2010-04-23 21:08:13
16f02403f8f92a58ba09cfad76ca468b07e47053...b299b4b7a1599083c89c1311710cb68efd71e7ba,3,479,192,671,9,2010-04-23 23:37:10,2010-04-23 22:46:31
b299b4b7a1599083c89c1311710cb68efd71e7ba...bb4ae1769be86eb9a04f66bef8f0c6f9feaae6ea,1,1,1,2,1,2010-04-23 23:37:14,2010-04-23 23:18:40
bb4ae1769be86eb9a04f66bef8f0c6f9feaae6ea...caa828a242f39b6158084ef4376355161c14fe34,5,34,15,49,15,2010-04-23 23:37:14,2010-04-23 23:05:19
caa828a242f39b6158084ef4376355161c14fe34...c72967d3351c4a28c3f2434748598017aa0126d5,19,8,5703,5711,30,2010-04-24 00:19:29,2010-04-24 00:10:01
c72967d3351c4a28c3f2434748598017aa0126d5...3d6ebbd296a9a3a5f56203b1099bda51da21ae69,1,2,13,15,3,2010-04-24 00:24:37,2010-04-24 00:24:37
3d6ebbd296a9a3a5f56203b1099bda51da21ae69...9926dacd14c39276299712ced4a83fb043f27162,1,0,160,160,3,2010-04-24 00:29:36,2010-04-24 00:29:36
9926dacd14c39276299712ced4a83fb043f27162...610faf713d9d4d5199e7e2d7d73538184602c9f2,1,2,2,4,2,2010-04-24 08:13:42,2010-04-24 07:37:46
610faf713d9d4d5199e7e2d7d73538184602c9f2...cee908038108e7aa0b70032a784ecbd603ceff46,2,3,3,6,3,2010-04-26 05:44:31,2010-04-26 05:29:55
cee908038108e7aa0b70032a784ecbd603ceff46...df07a713bda4230e8dd38a2b34ef18243d103302,2,37,0,37,2,2010-04-26 06:14:07,2010-04-24 20:27:11
df07a713bda4230e8dd38a2b34ef18243d103302...14d1ab5a3e32006575d321cd81c9f2d36d58a5ae,4,196,0,196,7,2010-04-26 22:09:03,2010-04-26 21:34:03
14d1ab5a3e32006575d321cd81c9f2d36d58a5ae...5caf53a0539c2f4a12be09f22f99931f3cc87008,3,38,1,39,8,2010-04-26 22:09:03,2010-04-26 20:26:16
5caf53a0539c2f4a12be09f22f99931f3cc87008...0802326fc9a07987c4af77b7b3ec5afa908ac508,1,12,8,20,7,2010-04-26 22:09:03,2010-04-26 21:23:17
0802326fc9a07987c4af77b7b3ec5afa908ac508...c6248efd73b57e9e0cd4387f4d30c27ddfd2ca3b,1,1,1,2,1,2010-04-27 01:53:30,2010-04-27 01:53:30
c6248efd73b57e9e0cd4387f4d30c27ddfd2ca3b...c7b3c1ecbc7c425eb1e0014166dcc051805f8cff,1,48,14,62,14,2010-04-27 03:26:36,2010-04-27 03:26:36
c7b3c1ecbc7c425eb1e0014166dcc051805f8cff...e235aae0181d7b3b47951d33616f5b007075acf5,1,6,1,7,1,2010-04-27 03:26:43,2010-04-27 03:26:43
e235aae0181d7b3b47951d33616f5b007075acf5...2374e557e30fab5c357d3f03716ca3b83131c3c0,1,310,137,447,89,2010-04-27 07:25:58,2010-04-27 07:04:32
2374e557e30fab5c357d3f03716ca3b83131c3c0...24931f840544c9970203660121a1ec4606bdd4f1,47,2252,579,2831,287,2010-04-27 07:31:47,2010-04-27 07:31:47
24931f840544c9970203660121a1ec4606bdd4f1...d1b352e4b329e889270d0c8ee44a8cb9ea75ca46,1,26,20,46,13,2010-04-27 07:52:40,2010-04-27 07:49:58
d1b352e4b329e889270d0c8ee44a8cb9ea75ca46...f6185516941c486c5abc8c856185495070a734d9,3,9,13,22,7,2010-04-28 00:26:10,2010-04-28 00:24:32
f6185516941c486c5abc8c856185495070a734d9...76f98c27de4564fcefee83878f525a9a66940a0e,6,51,21,72,13,2010-04-28 00:27:34,2010-04-19 22:22:59
76f98c27de4564fcefee83878f525a9a66940a0e...f2212fa59d546d31a83e870ed546c738b080072a,1,3,0,3,1,2010-04-28 00:31:04,2010-04-27 23:16:05
f2212fa59d546d31a83e870ed546c738b080072a...c143cba590cbfd58f3cc26394ce95a7d25eb0b00,4,62,23,85,12,2010-04-28 01:02:30,2010-04-27 23:17:28
c143cba590cbfd58f3cc26394ce95a7d25eb0b00...203561208e02f3072c540ed007518e6e42732bca,5,2,581,583,9,2010-04-28 01:17:30,2010-04-20 08:46:54
203561208e02f3072c540ed007518e6e42732bca...5aea12b4c4e14b7add179a9943487a3f766ccaf8,1,5,0,5,1,2010-04-28 01:45:10,2010-04-28 01:45:10
5aea12b4c4e14b7add179a9943487a3f766ccaf8...e7a1fa129372398631c9f05d85389d6beebc518b,3,32,29,61,30,2010-04-28 01:52:16,2010-04-28 01:51:41
e7a1fa129372398631c9f05d85389d6beebc518b...8f79169aef6cd447ff193616e49335473eeb15ba,1,0,18,18,3,2010-04-28 16:47:50,2010-04-28 12:32:00
8f79169aef6cd447ff193616e49335473eeb15ba...3b75f5070d491712eeaeefe5f12019e34e6b2250,47,1254,505,1759,267,2010-04-28 17:46:26,2010-04-28 17:46:26
3b75f5070d491712eeaeefe5f12019e34e6b2250...9b2aac61b28056418ee3a8fdb2c7226acc65d37c,1,4,2,6,1,2010-04-28 19:58:51,2010-04-28 19:58:00
9b2aac61b28056418ee3a8fdb2c7226acc65d37c...f8a3cf980f09b48ce1c56f11dc47e204093ac8b2,9,205,20,225,27,2010-04-28 20:54:17,2010-04-28 13:04:08
f8a3cf980f09b48ce1c56f11dc47e204093ac8b2...5d9753fccf271f75ab4dac246f24c3f05bf4161c,1,3,0,3,1,2010-04-28 21:21:52,2010-04-28 21:21:58
5d9753fccf271f75ab4dac246f24c3f05bf4161c...7e4c1285dc8fcdcd5bad5a9df4c2ce6a4fd81483,1,6,8,14,3,2010-04-28 21:39:41,2010-04-28 20:37:09
7e4c1285dc8fcdcd5bad5a9df4c2ce6a4fd81483...7a72885edeb002fc982b5125f4c64df2dbd0430d,1,9,1,10,1,2010-04-28 21:40:11,2010-04-28 20:51:16
7a72885edeb002fc982b5125f4c64df2dbd0430d...3bb21b51918241eebbff2e64b05b5e126f5c4ecb,1,8,8,16,5,2010-04-28 22:07:15,2010-04-28 22:07:15
3bb21b51918241eebbff2e64b05b5e126f5c4ecb...6d85802100cbc706711a0b2482efa2d708efe463,1,2,2,4,1,2010-04-28 22:28:21,2010-04-28 22:28:21
6d85802100cbc706711a0b2482efa2d708efe463...039d13b0c352766225c27cb6df0d7df05aac5c36,1,4,3,7,3,2010-04-28 23:08:36,2010-04-28 23:07:13
039d13b0c352766225c27cb6df0d7df05aac5c36...a63ce5cd729c1aef63774f21b983330b089963ba,3,49,5,54,10,2010-04-28 23:18:48,2010-04-28 06:31:28
a63ce5cd729c1aef63774f21b983330b089963ba...f919216446afe9136d9367900fa9c7878a6d9fea,4,172,12,184,20,2010-04-29 06:28:52,2010-04-29 06:28:52
f919216446afe9136d9367900fa9c7878a6d9fea...c75e4cb48ae6c0b618c73fda5f72c2708ca1f341,1,1,1,2,1,2010-04-29 17:11:06,2010-04-29 17:11:06
c75e4cb48ae6c0b618c73fda5f72c2708ca1f341...301b44d45da94b2f5ab175769fe655270a4cca92,2,13,4,17,4,2010-04-29 19:00:37,2010-04-29 18:57:52
301b44d45da94b2f5ab175769fe655270a4cca92...557ba6bd97bad3afe0f9bd3ac07efac0a39978c1,5,26,5,31,5,2010-04-30 00:44:51,2010-04-29 17:41:39
557ba6bd97bad3afe0f9bd3ac07efac0a39978c1...3b323027be86aa13bdd497aac7b12a8c60b2b65c,2,8,1,9,2,2010-04-30 17:29:35,2010-04-30 17:28:18
3b323027be86aa13bdd497aac7b12a8c60b2b65c...5b2801e3ea501aff9727a22ca97c1141603082c1,1,10,3,13,3,2010-04-30 17:31:21,2010-04-30 17:31:21
5b2801e3ea501aff9727a22ca97c1141603082c1...285c5ed36fe60731a244fe0de12e76c91753cb34,1,12,3,15,3,2010-04-30 17:33:56,2010-04-30 17:33:56
285c5ed36fe60731a244fe0de12e76c91753cb34...20372d2df3603f72bc557a9931b58363ef6b84b5,1,13,7,20,4,2010-04-30 22:35:51,2010-04-30 22:35:51
20372d2df3603f72bc557a9931b58363ef6b84b5...8d1f1186caf227edcd33dc60295b2ff50189dacc,1,3,3,6,3,2010-05-01 00:36:21,2010-05-01 00:30:14
8d1f1186caf227edcd33dc60295b2ff50189dacc...692f580a07c2787ed5db730b5eae8e9e1da43f12,1,130,29,159,14,2010-05-01 01:36:36,2010-05-01 01:36:36
692f580a07c2787ed5db730b5eae8e9e1da43f12...f990f24ad36ddaff3c378531d15ea5c052467d41,2,159,5,164,3,2010-05-01 18:52:40,2010-04-30 13:33:11
f990f24ad36ddaff3c378531d15ea5c052467d41...d6110fbd115e6e6a978b807e97f00791f4d2e80f,1,5,1,6,1,2010-05-01 18:56:00,2010-04-30 13:35:51
d6110fbd115e6e6a978b807e97f00791f4d2e80f...67fb0ece6b331284bdea1f75f5957f47bedca572,1,1,3,4,1,2010-05-01 21:45:14,2010-05-01 21:45:14
67fb0ece6b331284bdea1f75f5957f47bedca572...aee226b2434bfc9475713a805e303e87f0720790,2,39,25,64,22,2010-05-02 01:05:53,2010-05-02 01:01:06
aee226b2434bfc9475713a805e303e87f0720790...3db613e31acf66f8ae1b16f2caf8b719cdb93837,1,16,0,16,1,2010-05-02 02:15:50,2010-05-02 02:08:08
3db613e31acf66f8ae1b16f2caf8b719cdb93837...a1f23c1aa103a2c42c1855703d51b82ba5777f98,1,2,2,4,2,2010-05-02 02:16:00,2010-05-02 01:52:20
a1f23c1aa103a2c42c1855703d51b82ba5777f98...61364f9443fa59f261fd7ea3d1d4e8a0d747fd47,1,1,1,2,1,2010-05-02 18:19:01,2010-05-02 18:19:01
61364f9443fa59f261fd7ea3d1d4e8a0d747fd47...5457eae28c24739d2d0d779ab0f7deb4999a3636,1,2,5,7,1,2010-05-03 00:02:13,2010-05-03 00:02:13
5457eae28c24739d2d0d779ab0f7deb4999a3636...99984772df1cb63fd2a56f2eca62b012653e974e,1,5,1,6,2,2010-05-03 00:26:18,2010-05-03 00:26:18
99984772df1cb63fd2a56f2eca62b012653e974e...d13f5180106380fbd91be4092ca7ba7016ff2963,1,29,127,156,14,2010-05-03 00:38:32,2010-05-03 00:38:02
d13f5180106380fbd91be4092ca7ba7016ff2963...48d58f92f14c53b39bcc6dba7cc05058a155254b,1,2,2,4,1,2010-05-03 01:20:02,2010-05-03 01:20:02
48d58f92f14c53b39bcc6dba7cc05058a155254b...fd3e1ca3e21b9108c47c3de3e7d2da328214ea91,1,12,12,24,11,2010-05-03 07:15:35,2010-05-03 06:49:24
fd3e1ca3e21b9108c47c3de3e7d2da328214ea91...f0fec7352ac25650abe3b72b59e78aebd0a94ebc,1,1,4,5,1,2010-05-03 17:53:52,2010-05-03 17:53:52
f0fec7352ac25650abe3b72b59e78aebd0a94ebc...b5bdf9434bfa77c284678ef6ae043a8e205e8d65,2,56,2,58,3,2010-05-03 18:23:36,2010-05-03 18:23:36
b5bdf9434bfa77c284678ef6ae043a8e205e8d65...7a9c81d2dc38a6aa9be12c89d1c815cf06290a2a,1,2,5,7,1,2010-05-03 18:41:30,2010-05-03 18:41:30
7a9c81d2dc38a6aa9be12c89d1c815cf06290a2a...d76091d7d1046db750dd141844b245d6ec33c427,1,133,30,163,15,2010-05-03 19:56:11,2010-05-03 19:55:33
d76091d7d1046db750dd141844b245d6ec33c427...3202bce288c4b6e3a08b5bf525079504232f3291,1,14,12,26,7,2010-05-03 20:18:33,2010-05-03 20:18:33
3202bce288c4b6e3a08b5bf525079504232f3291...ea37d98949dd4f09cf08c29713c383059dbb697a,1,4,6,10,5,2010-05-03 20:26:09,2010-05-03 20:25:48
ea37d98949dd4f09cf08c29713c383059dbb697a...3fed1cf36fe6799b5987d376334d29dd7b7f70e8,1,4,17,21,6,2010-05-03 23:06:42,2010-05-02 03:40:21
3fed1cf36fe6799b5987d376334d29dd7b7f70e8...430cfd18252f482ca762913026c5dde4fbde94b8,3,32,5,37,4,2010-05-03 23:11:42,2010-05-02 18:21:43
430cfd18252f482ca762913026c5dde4fbde94b8...1a317135c5d65fe519ad8fa335342272ea53ddbc,5,200,6,206,8,2010-05-03 23:15:06,2010-05-03 22:37:49
1a317135c5d65fe519ad8fa335342272ea53ddbc...d9882395e2ceb0274e15a3ba80df900d1e527c0d,1,2,2,4,3,2010-05-04 17:32:01,2010-05-04 16:26:23
d9882395e2ceb0274e15a3ba80df900d1e527c0d...b6c5cf60b7e4c4746e187056a8f2a702a28aa176,1,8,0,8,1,2010-05-04 17:41:56,2010-05-04 17:41:56
b6c5cf60b7e4c4746e187056a8f2a702a28aa176...afce4c3ae8e3c79bc779673e60c1e928de564142,5,3780,11,3791,23,2010-05-04 21:12:54,2010-05-04 20:49:00
afce4c3ae8e3c79bc779673e60c1e928de564142...d044e2de07f147771dd68fa859165df6380264c0,1,1,1,2,2,2010-05-04 21:21:14,2010-05-04 21:21:01
d044e2de07f147771dd68fa859165df6380264c0...3892628657ca3e56d16473e65da35c77a74382c7,1,7,0,7,2,2010-05-05 01:37:00,2010-05-05 01:28:49
3892628657ca3e56d16473e65da35c77a74382c7...453c9e6411527018c61245fb2151946b79365bac,1,3,3,6,3,2010-05-05 04:35:46,2010-05-05 04:35:46
453c9e6411527018c61245fb2151946b79365bac...eb4951d499a18b7cc92929ddb6709b697edd3c3e,3,16,4,20,3,2010-05-05 04:36:10,2010-05-05 04:17:29
eb4951d499a18b7cc92929ddb6709b697edd3c3e...c0d42b036535ac976de802ff53e3c95f993d5eb7,1,1,1,2,1,2010-05-05 05:02:16,2010-05-05 04:58:43
c0d42b036535ac976de802ff53e3c95f993d5eb7...141565046375db6fa427ba014113abcc9f4d5833,1,3,3,6,2,2010-05-05 05:06:46,2010-05-05 05:06:46
141565046375db6fa427ba014113abcc9f4d5833...ab723d022d7a055f046216013c64032ced9ed081,1,14,0,14,3,2010-05-05 05:35:55,2010-05-05 05:35:55
ab723d022d7a055f046216013c64032ced9ed081...874b80bd6afa17ae5da0ec5b485a20c61cf7d875,3,823,0,823,3,2010-05-06 05:33:53,2010-05-06 05:22:05
874b80bd6afa17ae5da0ec5b485a20c61cf7d875...82c8973dfa5dc39a6164a6fdad4c20661d0b1215,1,3,3,6,2,2010-05-06 05:34:36,2010-05-06 05:23:45
82c8973dfa5dc39a6164a6fdad4c20661d0b1215...3674563dd5ec2c9ba301dfee6b046f3e3966c3dd,2,118,16,134,9,2010-05-06 07:44:07,2010-05-05 08:55:04
3674563dd5ec2c9ba301dfee6b046f3e3966c3dd...4ce1e1fca59bc6ad6e2d19643db2ed3159ccb7dc,1,1,1,2,1,2010-05-06 16:15:44,2010-05-05 08:32:18
4ce1e1fca59bc6ad6e2d19643db2ed3159ccb7dc...6aab6ebe6168464de8e7b0c7254fad4771f281c1,91,5630,2255,7885,810,2010-05-06 16:59:35,2010-05-06 16:59:35
6aab6ebe6168464de8e7b0c7254fad4771f281c1...f711d5343b29d1e72e87107315708e40951a7826,5,37,5,42,5,2010-05-06 17:39:27,2010-05-06 17:39:27
f711d5343b29d1e72e87107315708e40951a7826...d2415945c19991ed102308cfab985fea8721b1dc,1,1,0,1,1,2010-05-06 21:14:52,2010-05-06 21:14:52
d2415945c19991ed102308cfab985fea8721b1dc...62b642a88d24f872f049d73d39e6844cab1fb8df,1,1,1,2,1,2010-05-06 21:15:16,2010-05-06 21:15:16
62b642a88d24f872f049d73d39e6844cab1fb8df...c07c601c3b8132104b86c770ea751ddc8a1b0355,4,38,30,68,8,2010-05-07 05:22:14,2010-05-07 05:03:43
c07c601c3b8132104b86c770ea751ddc8a1b0355...bc45adcffac675a423d4d0e5a765650d73de952c,1,6,1,7,2,2010-05-07 20:17:57,2010-05-07 19:50:36
bc45adcffac675a423d4d0e5a765650d73de952c...3ac6deefa8112a285fb578875c0aa8eb741e1e23,1,67,55,122,17,2010-05-08 02:06:05,2010-05-08 02:05:59
3ac6deefa8112a285fb578875c0aa8eb741e1e23...a5b132ad630b843e822a332cef8c69efd6f86391,1,1,1,2,1,2010-05-09 02:52:22,2010-05-08 06:09:29
a5b132ad630b843e822a332cef8c69efd6f86391...264e540d008a251a7e37f367611677414c2591d1,2,32,10,42,6,2010-05-09 05:13:34,2010-05-09 05:11:55
264e540d008a251a7e37f367611677414c2591d1...d7762dffe34bcfb3f513087444fd07abbc7664c2,1,9,0,9,1,2010-05-09 06:24:24,2010-05-09 06:24:24
d7762dffe34bcfb3f513087444fd07abbc7664c2...d38d96eb610b50bdbfe869a6e7688e346984c0fa,1,13,5,18,3,2010-05-09 06:28:26,2010-05-09 06:28:26
d38d96eb610b50bdbfe869a6e7688e346984c0fa...1d28cfcfb9ad48e03a0b6c48eda97b5c91a5e3ae,1,4,2,6,3,2010-05-09 19:10:42,2010-05-09 19:10:38
1d28cfcfb9ad48e03a0b6c48eda97b5c91a5e3ae...ab068db9b12a9fb8619f6a94299a8d7a35d4695b,6,115,47,162,31,2010-05-09 20:55:42,2010-05-09 20:54:58
ab068db9b12a9fb8619f6a94299a8d7a35d4695b...1ecb11f9446f771500cec40f0cf3504eaec6e755,1,67,0,67,1,2010-05-09 22:08:54,2010-05-09 22:07:54
1ecb11f9446f771500cec40f0cf3504eaec6e755...b78508266bec6530e08ccedfd7608fe91d3fdcb4,1,1,1,2,1,2010-05-09 23:29:23,2010-05-09 23:23:29
b78508266bec6530e08ccedfd7608fe91d3fdcb4...15bb392afdfef26148b1d55f123b5ab00348496a,1,0,0,0,0,2010-05-10 01:46:04,2010-05-10 01:46:04
15bb392afdfef26148b1d55f123b5ab00348496a...8ab238e7de8429961ce4d6fd9114555e5df90a13,1,1,1,2,1,2010-05-10 04:29:51,2010-05-10 04:29:51
8ab238e7de8429961ce4d6fd9114555e5df90a13...615d8906226ffc56238b44141cdb3374f47e805a,92,103898,870,104768,517,2010-05-10 16:58:20,2010-05-10 16:58:20
615d8906226ffc56238b44141cdb3374f47e805a...35dd0fb2716f7848be34bd66f7420a5f2f3c80e7,2,3,6,9,2,2010-05-10 23:28:02,2010-05-10 23:25:43
35dd0fb2716f7848be34bd66f7420a5f2f3c80e7...032f651824869c429cc24fbd9f7a23e84ed34b1f,10,53,10,63,15,2010-05-10 23:30:31,2010-05-10 23:05:42
032f651824869c429cc24fbd9f7a23e84ed34b1f...8e5b91c79bab85d5a548dc3b19c3dce4f8ba29f9,10,10,53,63,15,2010-05-10 23:38:14,2010-05-10 23:38:14
8e5b91c79bab85d5a548dc3b19c3dce4f8ba29f9...c90e44e582385e36c3ac1618f6f4782f7a60617a,1,1,0,1,1,2010-05-10 23:38:47,2010-05-10 23:38:47
c90e44e582385e36c3ac1618f6f4782f7a60617a...f7ff548dd01c18f14e6f23c5d6ab628e00c429da,1,2,2,4,2,2010-05-11 17:25:27,2010-05-11 17:25:27
f7ff548dd01c18f14e6f23c5d6ab628e00c429da...d2cff34fa3db99dfd1ff622662964600d295325b,4,57,15,72,11,2010-05-12 17:06:13,2010-05-12 17:01:27
d2cff34fa3db99dfd1ff622662964600d295325b...ed0c109950bdd34ccfd1d3aaaa63e38b50d2097e,1,11,0,11,2,2010-05-12 17:42:14,2010-05-12 17:42:14
ed0c109950bdd34ccfd1d3aaaa63e38b50d2097e...7a2e6d674a94e01a17e856b4d51ec229fad9af51,2,25,14,39,9,2010-05-12 18:49:28,2010-05-12 18:42:01
7a2e6d674a94e01a17e856b4d51ec229fad9af51...d0128787e74c36d589f00ac89ab17902dd8e0de0,1,24,4,28,3,2010-05-12 19:15:58,2010-05-12 19:15:58
d0128787e74c36d589f00ac89ab17902dd8e0de0...1c7670aca2d1ec2909bffd48550a5556a3911c4e,1,5,5,10,4,2010-05-12 19:17:53,2010-05-12 19:17:45
1c7670aca2d1ec2909bffd48550a5556a3911c4e...67eeedd602b0a30b67fb2752ebef3507fed12147,1,0,0,0,0,2010-05-12 19:45:53,2010-05-12 19:45:53
67eeedd602b0a30b67fb2752ebef3507fed12147...c6c77d535f0e072913ba9a4d010105200ed9fa7e,4,67,5,72,11,2010-05-12 21:20:43,2010-05-12 20:35:33
c6c77d535f0e072913ba9a4d010105200ed9fa7e...976926376d249a92ee95cf585d58c31ccdd85545,3,14,0,14,2,2010-05-13 19:42:17,2010-05-13 19:42:17
976926376d249a92ee95cf585d58c31ccdd85545...ce2d5ad0d74c55e5081863eadad32244e5829d42,1,4,5,9,2,2010-05-13 22:55:02,2010-05-13 22:54:50
ce2d5ad0d74c55e5081863eadad32244e5829d42...23d680bb858134bb38a74423fb86b8d58477bbb4,2,5,2,7,4,2010-05-13 23:24:28,2010-05-13 23:24:05
23d680bb858134bb38a74423fb86b8d58477bbb4...0914d33842976c2c870df06573b68f9192a1fb7a,5,31,5,36,5,2010-05-13 23:24:28,2010-05-13 21:58:31
0914d33842976c2c870df06573b68f9192a1fb7a...4e40e8804b831ac0b0ba87e145060b084b980263,1,3,3,6,3,2010-05-13 23:56:13,2010-05-13 23:50:26
4e40e8804b831ac0b0ba87e145060b084b980263...1f0963558c2e3f7a02f4d3c2db8121c5f9a12c69,1,6,0,6,1,2010-05-14 17:11:47,2010-05-07 20:37:30
1f0963558c2e3f7a02f4d3c2db8121c5f9a12c69...307e70afaf4afffcbba714c727ba54359979dac8,1,0,1,1,1,2010-05-14 17:12:03,2010-05-14 07:07:01
307e70afaf4afffcbba714c727ba54359979dac8...cd4f94e71aea6282a50d72ee52624819fecbeb91,1,68,0,68,1,2010-05-14 17:16:55,2010-05-14 07:06:32
cd4f94e71aea6282a50d72ee52624819fecbeb91...320d3e9d332d77f8281055958f63c03343952b75,1,5,0,5,4,2010-05-14 18:15:31,2010-05-14 18:15:31
320d3e9d332d77f8281055958f63c03343952b75...da9323040f9cbb073edcf081e9369d0a4755a9f5,1,3,13,16,2,2010-05-14 18:48:14,2010-05-14 18:48:14
da9323040f9cbb073edcf081e9369d0a4755a9f5...0b7bda8f46db36f951e644377fd4c20c461a52ca,1,0,66,66,1,2010-05-14 23:30:58,2010-05-14 23:30:41
0b7bda8f46db36f951e644377fd4c20c461a52ca...a9b962a653162c0ff025698367aead308cb18b8e,1,22,15,37,3,2010-05-14 23:34:47,2010-05-14 23:34:47
a9b962a653162c0ff025698367aead308cb18b8e...ac3a2d899a12b7eabf01eb72b4c1de68b6a34e2b,3,65,23,88,11,2010-05-14 23:38:17,2010-05-14 23:36:17
ac3a2d899a12b7eabf01eb72b4c1de68b6a34e2b...95996070650c5d487c1abaa227b73ab1b771278e,4,113,0,113,6,2010-05-15 01:42:22,2010-03-22 07:25:24
95996070650c5d487c1abaa227b73ab1b771278e...50148022d16f7f0256fcd067411fa873bcf62a8a,3,62,32,94,23,2010-05-15 01:57:17,2010-05-14 07:57:02
50148022d16f7f0256fcd067411fa873bcf62a8a...4274e6b7d0f5eb3559dd8f91941ce47d9a68e370,2,39,12,51,4,2010-05-15 02:05:19,2010-05-14 07:59:31
4274e6b7d0f5eb3559dd8f91941ce47d9a68e370...fea6f829bf6cc0d2f3f698a786832797d5ddae8e,2,40,1,41,2,2010-05-15 02:13:50,2010-05-14 11:12:41
fea6f829bf6cc0d2f3f698a786832797d5ddae8e...53a9869ff7f724f687149fe95bc60609e7f5f9c7,1,2,2,4,1,2010-05-15 02:15:07,2010-05-14 11:13:27
53a9869ff7f724f687149fe95bc60609e7f5f9c7...45948e054d13fdf8ae7c8bfd12d7da58c94666b9,4,209,19,228,21,2010-05-15 02:46:16,2010-05-14 14:52:49
45948e054d13fdf8ae7c8bfd12d7da58c94666b9...0a539865dd5e94d1403bd15c43a644f4cd1958cb,3,55,0,55,5,2010-05-17 18:19:14,2010-05-17 13:33:56
0a539865dd5e94d1403bd15c43a644f4cd1958cb...1036aa9762c7f08a0f0e9552da7c4fbbb6eec091,1,44,1,45,2,2010-05-17 20:58:15,2010-05-17 20:58:15
1036aa9762c7f08a0f0e9552da7c4fbbb6eec091...e232f09d38194844305b4038a68b8a70717704e4,4,74,23,97,6,2010-05-18 02:44:14,2010-05-17 22:22:09
e232f09d38194844305b4038a68b8a70717704e4...caba9c70c34c1f517ae2fe20a7425cc20c0800fc,3,161,0,161,3,2010-05-18 05:12:30,2010-05-18 02:25:51
caba9c70c34c1f517ae2fe20a7425cc20c0800fc...ed5f1162fae2303a324017a98b247728dbe4718e,1,12,0,12,4,2010-05-18 08:02:15,2010-05-18 02:42:24
ed5f1162fae2303a324017a98b247728dbe4718e...f987ecf45be6f5c7c18d5cebd38be0b411648140,1,12,0,12,3,2010-05-18 08:04:39,2010-05-18 02:42:24
f987ecf45be6f5c7c18d5cebd38be0b411648140...2663c69f8d8ea4df9fbc40b03186259186011e97,1,2,2,4,2,2010-05-18 16:32:28,2010-05-18 16:32:28
2663c69f8d8ea4df9fbc40b03186259186011e97...2420f07e9479b5c40140e01dca53db3512b2faf4,2,71,6,77,7,2010-05-19 00:41:10,2010-05-19 00:40:44
2420f07e9479b5c40140e01dca53db3512b2faf4...c489c2c1b57c547c1cda011aec3ffb4116985606,1,7,6,13,3,2010-05-19 18:01:21,2010-05-19 18:01:21
c489c2c1b57c547c1cda011aec3ffb4116985606...c46cbe0de4613245095115dd909c254a9da2ed1b,5,95,107,202,16,2010-05-19 19:53:43,2010-05-19 18:17:50
c46cbe0de4613245095115dd909c254a9da2ed1b...d8af9d8edf88420fac821843156312a21f768118,2,14,14,28,5,2010-05-19 21:59:03,2010-05-19 21:59:03
d8af9d8edf88420fac821843156312a21f768118...78be1e49300752ee1c4b3eb491fbbe42f6beaaeb,1,0,48,48,2,2010-05-19 22:02:47,2010-05-09 23:20:15
78be1e49300752ee1c4b3eb491fbbe42f6beaaeb...5b740c488f0e4251a3e534cab79da8b05df7a195,1,2,2,4,1,2010-05-20 16:38:25,2010-05-19 06:04:24
5b740c488f0e4251a3e534cab79da8b05df7a195...44ad6a7db28578d0828fc3ceade7a6a12ebe7852,1,6,5,11,3,2010-05-20 16:44:10,2010-05-20 16:42:47
44ad6a7db28578d0828fc3ceade7a6a12ebe7852...022c0838480ddec334e85dd8a8ca7d376eb26d95,1,6,0,6,2,2010-05-20 17:12:05,2010-05-20 17:12:05
022c0838480ddec334e85dd8a8ca7d376eb26d95...36a45c4e0def497e3d1446057c1d91680d8bb259,2,17,1,18,2,2010-05-20 17:16:09,2010-05-16 19:29:29
36a45c4e0def497e3d1446057c1d91680d8bb259...cbd2c3945b1df5b538d9e257646f604d9189601c,5,64,54,118,25,2010-05-20 22:23:36,2010-05-20 22:21:40
cbd2c3945b1df5b538d9e257646f604d9189601c...cbbf9e43d1770047e98fe65d5f710815f432a5b4,5,130,115,245,24,2010-05-20 22:25:49,2010-05-20 22:13:22
cbbf9e43d1770047e98fe65d5f710815f432a5b4...e84395ff8c50a0b54cd2885de8d93a5b39b8477c,5,115,130,245,24,2010-05-20 23:11:33,2010-05-20 23:11:33
e84395ff8c50a0b54cd2885de8d93a5b39b8477c...c93e0aaf062081db3ec40ac45b3e2c979d5759d6,5,128,115,243,24,2010-05-20 23:31:18,2010-05-20 22:13:22
c93e0aaf062081db3ec40ac45b3e2c979d5759d6...8c562847764bf60c9dd658e4540ce6d887b6957f,1,10,21,31,12,2010-05-21 05:01:13,2010-05-21 05:01:13
8c562847764bf60c9dd658e4540ce6d887b6957f...f73b6e219046bf66505c1fa1cd07d82b8644329d,2,3,3,6,3,2010-05-21 05:11:26,2010-05-21 05:11:26
f73b6e219046bf66505c1fa1cd07d82b8644329d...0de138acb59e620e0a542ace665abce7df49439f,1,19,11,30,2,2010-05-21 08:22:20,2010-05-21 08:22:20
0de138acb59e620e0a542ace665abce7df49439f...9514a4d5476225e8c8310ce5acae2857033bcaaa,5,34,5,39,5,2010-05-21 09:55:38,2010-05-21 09:55:38
9514a4d5476225e8c8310ce5acae2857033bcaaa...2b34363d03e0718c9e9f39982c723b806558c759,176,8628,6128,14756,1366,2010-05-21 16:41:50,2010-05-21 16:41:50
2b34363d03e0718c9e9f39982c723b806558c759...fe3d8f2411209b202b7fe74cb48b582ffc5cfc5f,3,7,0,7,3,2010-05-21 19:06:12,2010-05-21 19:05:55
fe3d8f2411209b202b7fe74cb48b582ffc5cfc5f...1369d606f740545953dacd835dd7d36743f82d6f,1,9,0,9,2,2010-05-22 20:02:30,2010-05-22 20:02:30
1369d606f740545953dacd835dd7d36743f82d6f...b58db3cd737fffb9ab326b8dc5191fde56a7a0d3,1,16,1,17,5,2010-05-24 00:02:35,2010-05-23 20:48:50
b58db3cd737fffb9ab326b8dc5191fde56a7a0d3...0f143f6c23da9be0d88698f418c175dd5424f0b1,3,17,16,33,13,2010-05-24 00:02:35,2010-05-23 23:57:20
0f143f6c23da9be0d88698f418c175dd5424f0b1...ab5c0dd63ea3a521b8a9cf7ac9672f16051cede7,6,833,1,834,6,2010-05-24 00:08:57,2010-05-23 23:04:36
ab5c0dd63ea3a521b8a9cf7ac9672f16051cede7...c4876d01a1b87dbea2e965cef58432eae178fdf1,3,30,4,34,3,2010-05-24 16:56:28,2010-05-23 18:28:23
c4876d01a1b87dbea2e965cef58432eae178fdf1...3768aaaea406dd32db2f74395f6414bcd26dba74,3,18,9,27,7,2010-05-24 20:26:18,2010-05-24 19:59:22
3768aaaea406dd32db2f74395f6414bcd26dba74...19f475c5734714554c311b0f7e60ab40204d8917,2,132,75,207,19,2010-05-24 22:47:42,2010-05-24 22:47:40
19f475c5734714554c311b0f7e60ab40204d8917...e97a481785dc5920336f46c7b29c6d9ff5fe974b,1,1,1,2,1,2010-05-25 00:14:13,2010-05-25 00:14:08
e97a481785dc5920336f46c7b29c6d9ff5fe974b...2fca40e44f1a5d1f7f5285649760eb5ab7c96935,4,43,15,58,15,2010-05-26 02:25:35,2010-05-26 01:41:31
2fca40e44f1a5d1f7f5285649760eb5ab7c96935...35c14f637e7963bd6cc66776463339e006e60c01,2,5,3,8,4,2010-05-26 02:25:38,2010-05-26 01:39:23
35c14f637e7963bd6cc66776463339e006e60c01...15ec99ec5945c07616cd9299e126e9919bc9c8cc,2,47,2,49,9,2010-05-26 02:25:40,2010-05-26 02:24:30
15ec99ec5945c07616cd9299e126e9919bc9c8cc...895f89d62a63e02bd936deebafb494664bf4e248,2,46,7,53,3,2010-05-26 05:58:17,2010-04-29 02:25:43
895f89d62a63e02bd936deebafb494664bf4e248...d4345e1ff85ebfdb5458ea363a436e9cf0fce1d4,69,3821,869,4690,439,2010-05-26 17:15:43,2010-05-26 17:15:43
d4345e1ff85ebfdb5458ea363a436e9cf0fce1d4...4b216d266af9a7aa1ee034458e654264f074ee57,1,0,1,1,1,2010-05-26 17:48:20,2010-05-26 17:48:20
4b216d266af9a7aa1ee034458e654264f074ee57...311a62dea7478f75cf5a9fc725c8b3d6869faaae,2,8,2,10,4,2010-05-26 20:07:45,2010-05-26 20:05:31
311a62dea7478f75cf5a9fc725c8b3d6869faaae...29e867aaa062e6d05e3469aa16a5f4089c294033,1,5,6,11,6,2010-05-26 20:37:33,2010-05-26 20:37:06
29e867aaa062e6d05e3469aa16a5f4089c294033...d89de077582b6458d7586a29107f86fe4a4508a0,2,42,3,45,9,2010-05-26 20:37:45,2010-05-26 17:49:01
d89de077582b6458d7586a29107f86fe4a4508a0...31854c799081ba5d39cc0a2d3de0e7bb5beea896,1,6,0,6,1,2010-05-27 01:05:44,2010-05-27 01:05:42
31854c799081ba5d39cc0a2d3de0e7bb5beea896...8840ce340de2d22ee3f88698e907d4c8028a0345,3,36,22,58,14,2010-05-27 01:33:38,2010-05-27 01:32:56
8840ce340de2d22ee3f88698e907d4c8028a0345...72262060dbe6b18ef27078461fef92bc203dff3c,3,823,0,823,3,2010-05-27 21:02:16,2010-05-27 13:48:40
72262060dbe6b18ef27078461fef92bc203dff3c...0e713e7482b249bec4ee413ace69731045c5290f,2,5,4,9,4,2010-05-28 03:41:57,2010-05-27 23:49:21
0e713e7482b249bec4ee413ace69731045c5290f...74b7fa29a11bc010cefd7c6a571a12d790ab7fa8,7,265,150,415,79,2010-05-28 03:41:57,2010-05-27 00:59:55
74b7fa29a11bc010cefd7c6a571a12d790ab7fa8...80a8e71fe082511b15e5337b1687fc0955809b6e,2,101,47,148,21,2010-05-28 03:43:56,2010-05-28 03:28:12
80a8e71fe082511b15e5337b1687fc0955809b6e...7f5320b1673d247229308aef5d9441dab5259e18,1,5,0,5,1,2010-05-28 21:29:51,2010-05-28 19:17:16
7f5320b1673d247229308aef5d9441dab5259e18...b480184fd66a3e509d6a3556ce12d6373d421d66,1,6,1,7,1,2010-05-28 22:40:25,2010-05-28 21:48:37
b480184fd66a3e509d6a3556ce12d6373d421d66...2fa4de001c12d9524b7380930c58e64db14d8998,1,4,0,4,1,2010-05-29 19:25:28,2010-05-29 19:25:28
2fa4de001c12d9524b7380930c58e64db14d8998...3c7873bd3f7b823db07f08e55fdeac5e4fbde3e9,1,30,7,37,8,2010-05-29 19:31:46,2010-05-09 23:35:15
3c7873bd3f7b823db07f08e55fdeac5e4fbde3e9...82813f2f8cfb3fae36e8e5e0ea9aeb83650aa253,1,25,14,39,6,2010-05-29 19:33:55,2010-05-10 00:02:02
82813f2f8cfb3fae36e8e5e0ea9aeb83650aa253...a26f7d753dca57cfcf84867631de66da2ae58aa9,1,8,1,9,2,2010-05-29 19:35:30,2010-05-10 00:02:40
a26f7d753dca57cfcf84867631de66da2ae58aa9...78e49f1c88f7af5692fa6b95ac62072f42a60d0f,5,17,17,34,7,2010-05-29 20:08:05,2010-05-29 20:08:05
78e49f1c88f7af5692fa6b95ac62072f42a60d0f...c82d64649c93325392dd0f2d94cdb0de95c90680,1,4,0,4,1,2010-05-29 20:14:38,2010-05-29 20:14:38
c82d64649c93325392dd0f2d94cdb0de95c90680...1a5acd98509c694274bace277fa1bb0fad52c0ce,9,42,25,67,13,2010-05-29 20:38:00,2010-05-29 20:38:00
1a5acd98509c694274bace277fa1bb0fad52c0ce...16818ff250b1b115a3cd0572a3e0e3f899f882fe,1,0,7,7,2,2010-05-30 02:37:56,2010-05-30 02:37:44
16818ff250b1b115a3cd0572a3e0e3f899f882fe...0c1aa36835fa6a3557843dcbc6ed6714d353a783,5,28,5,33,5,2010-05-30 02:37:57,2010-05-30 02:32:33
0c1aa36835fa6a3557843dcbc6ed6714d353a783...f86a214357ce4e54d0d5c56c7db295ec745814c3,79,5208,3839,9047,1059,2010-05-31 18:52:20,2010-05-31 18:52:20
f86a214357ce4e54d0d5c56c7db295ec745814c3...d62b0f442a8bffc8f01a7edbece2c7c554a80948,1,34,8,42,19,2010-06-01 16:28:56,2010-06-01 16:28:31
d62b0f442a8bffc8f01a7edbece2c7c554a80948...75f0cf471af3c029290d4bf55c34d1fc470ef600,3,159,58,217,22,2010-06-02 03:18:43,2010-06-02 03:16:42
75f0cf471af3c029290d4bf55c34d1fc470ef600...501136b99940bacbdc436979af459ee5c0cfdb52,3,58,159,217,25,2010-06-02 16:16:28,2010-06-02 16:15:54
501136b99940bacbdc436979af459ee5c0cfdb52...92da636b977282d58f1d43560387f3e9bff6be4d,5,207,41,248,24,2010-06-02 17:41:24,2010-06-01 07:56:08
92da636b977282d58f1d43560387f3e9bff6be4d...ef9f4046c9df47385db627044ed75c27f6896e20,2,11,7,18,7,2010-06-02 20:03:31,2010-06-02 19:27:53
ef9f4046c9df47385db627044ed75c27f6896e20...55a6f0173294b2e89a7f1797704669f8ba0349d8,2,33,0,33,2,2010-06-02 22:07:15,2010-06-02 21:46:29
55a6f0173294b2e89a7f1797704669f8ba0349d8...8f0b4e9111cb48e5de13db3fda567edccb121dc4,4,527,139,666,50,2010-06-03 01:16:53,2010-06-03 01:16:53
8f0b4e9111cb48e5de13db3fda567edccb121dc4...55d73521891c5dbc9e7bd697b386e00620eac1df,1,1,1,2,1,2010-06-03 07:26:23,2010-06-03 04:15:02
55d73521891c5dbc9e7bd697b386e00620eac1df...55e964ec19e23467576466a5975f8fb91c176ea0,1,3,1,4,3,2010-06-03 16:40:40,2010-06-03 10:37:21
55e964ec19e23467576466a5975f8fb91c176ea0...987cbe35c60beee8b80b428bcd97abb2c709b958,1,13,15,28,3,2010-06-03 16:59:56,2010-06-03 10:39:12
987cbe35c60beee8b80b428bcd97abb2c709b958...62d9bff06b41cf70bc2a2a3129f81e24baa11313,1,2,0,2,1,2010-06-03 18:01:47,2010-06-03 18:01:47
62d9bff06b41cf70bc2a2a3129f81e24baa11313...3104662bab1fc4a0ce2fc847fbe7eadd9c8ba380,2,10,10,20,9,2010-06-04 01:45:35,2010-06-04 01:44:05
3104662bab1fc4a0ce2fc847fbe7eadd9c8ba380...0055dd133d108f5f02f9cfec1253cbcf7862c213,2,50,1,51,2,2010-06-04 01:50:44,2010-06-04 01:50:44
0055dd133d108f5f02f9cfec1253cbcf7862c213...78d33f4fd5a4d659caace216659fd3a311ac6fa3,1,6,5,11,7,2010-06-04 15:29:10,2010-06-04 15:29:10
78d33f4fd5a4d659caace216659fd3a311ac6fa3...9e8df0e83644381da5d01e69317acbde9cbfbecd,2,172,57,229,21,2010-06-04 18:42:34,2010-06-02 21:05:37
9e8df0e83644381da5d01e69317acbde9cbfbecd...935f8437fd375270a0c12a106ad5b0f64da93e01,1,6,3,9,1,2010-06-04 21:30:59,2010-06-04 21:23:45
935f8437fd375270a0c12a106ad5b0f64da93e01...9be6c501ecf3d9432bdfca18a1b007ef4868ef5f,6,242,140,382,55,2010-06-07 00:41:03,2010-06-07 00:41:03
9be6c501ecf3d9432bdfca18a1b007ef4868ef5f...a0134ff0f8a44e08823a0a8e219aff599fd5e011,1,15,2,17,2,2010-06-07 17:13:30,2010-06-07 17:08:57
a0134ff0f8a44e08823a0a8e219aff599fd5e011...41f213be185a22d654cfa5bc9867e2df6704a650,6,426,69,495,23,2010-06-07 22:24:21,2010-05-31 18:50:35
41f213be185a22d654cfa5bc9867e2df6704a650...e43d6fc879c9a40b7289b8f521f12450278363ba,1,1,1,2,1,2010-06-07 23:03:57,2010-06-07 23:03:57
e43d6fc879c9a40b7289b8f521f12450278363ba...6056d2ea2c5e158f9a0daaad4bd242c405e49ab3,4,20,20,40,7,2010-06-07 23:15:41,2010-06-07 23:15:41
6056d2ea2c5e158f9a0daaad4bd242c405e49ab3...0c3b6aba7a9da623fdfdd8ed89ce6c0245a046cd,1,0,1,1,1,2010-06-07 23:23:48,2010-06-07 23:23:48
0c3b6aba7a9da623fdfdd8ed89ce6c0245a046cd...09af242c898888697933b00a38a7c84a9a55ac38,2,72,36,108,8,2010-06-07 23:51:07,2010-06-07 23:43:50
09af242c898888697933b00a38a7c84a9a55ac38...a6942b345dcd83ff380fc7572181e514f44bcf62,2,25,22,47,19,2010-06-08 00:39:52,2010-06-08 00:39:24
a6942b345dcd83ff380fc7572181e514f44bcf62...0377b12964fd269e70bf08098984bf2dd87d74d8,1,43,63,106,23,2010-06-08 17:00:43,2010-06-08 04:19:25
0377b12964fd269e70bf08098984bf2dd87d74d8...adc06dd70566c9909fa4d61aedac1181b2ddfbba,3,25,39,64,14,2010-06-08 22:44:43,2010-06-08 20:05:21
adc06dd70566c9909fa4d61aedac1181b2ddfbba...bca16a0581ba6f9b95e2a8669def8a40a097f51f,2,16,0,16,3,2010-06-09 00:49:22,2010-06-09 00:49:04
bca16a0581ba6f9b95e2a8669def8a40a097f51f...de6d663a67dcec8b482e069d967ef4d1a3743c9b,1,2,1,3,2,2010-06-09 01:09:17,2010-06-09 01:09:17
de6d663a67dcec8b482e069d967ef4d1a3743c9b...0bb47b6c975ea1c7eaedc5e80e75c9fd5063e6bc,83,3445,1159,4604,812,2010-06-09 07:52:06,2010-06-09 01:19:00
0bb47b6c975ea1c7eaedc5e80e75c9fd5063e6bc...cec775a0de4948343078d205f45216ade6e331c3,1,18,20,38,11,2010-06-09 07:52:28,2010-06-09 06:25:55
cec775a0de4948343078d205f45216ade6e331c3...cd232a9ccecb5102170d4d40c91f06bb538104e0,61,1623,313,1936,274,2010-06-09 17:09:37,2010-06-09 17:09:37
cd232a9ccecb5102170d4d40c91f06bb538104e0...b3b81d67ff1bc7e795cff7baa00dd716eca95eba,12,2616,5,2621,17,2010-06-09 22:08:46,2010-06-09 04:08:05
b3b81d67ff1bc7e795cff7baa00dd716eca95eba...ce347124e6cd1e7489abdcba9a198d12a656f50d,1,2,2,4,2,2010-06-10 14:15:27,2010-06-10 13:06:23
ce347124e6cd1e7489abdcba9a198d12a656f50d...0e390d69a83c480a22500cf21a72592d474ec9f3,1,1,2,3,1,2010-06-10 14:58:24,2010-06-10 14:58:24
0e390d69a83c480a22500cf21a72592d474ec9f3...fe89caba2ee6304d62450fad79ab709f70fa755e,3,29,19,48,10,2010-06-10 22:17:46,2010-06-10 21:59:06
fe89caba2ee6304d62450fad79ab709f70fa755e...cbd1f1481c93396eea85f197ff66f7a207a4e2ef,1,14,14,28,5,2010-06-11 06:55:46,2010-06-11 06:19:43
cbd1f1481c93396eea85f197ff66f7a207a4e2ef...d127d15d1b4730629c8ab914bc07f405e5e0c737,1,10,2,12,2,2010-06-11 19:48:25,2010-06-11 19:34:34
d127d15d1b4730629c8ab914bc07f405e5e0c737...9c85357846fddebcd755df90ec37b8aa37c0a535,67,495,119,614,131,2010-06-11 19:48:58,2010-06-11 19:45:17
9c85357846fddebcd755df90ec37b8aa37c0a535...10d8adb08933d1d4cea60192c2a31c56d896733d,5,22,5,27,5,2010-06-11 19:58:14,2010-06-09 23:13:40
10d8adb08933d1d4cea60192c2a31c56d896733d...4e80587cbea3808ee5d201695b5f8e271eb08e49,1,1,1,2,1,2010-06-11 20:16:08,2010-06-11 20:16:08
4e80587cbea3808ee5d201695b5f8e271eb08e49...94be898fbc64ae8738d39fecbadd9740c4d8d065,2,0,6,6,2,2010-06-11 20:19:50,2010-06-10 21:56:59
94be898fbc64ae8738d39fecbadd9740c4d8d065...431e72cbe8feb990feb2ae4d8e05d6793bab1190,2,9,0,9,2,2010-06-11 20:25:03,2010-06-11 11:25:05
431e72cbe8feb990feb2ae4d8e05d6793bab1190...e65e6039a8310e2b110ea5b22be90e73a2eae84d,1,3,0,3,1,2010-06-11 21:04:58,2010-06-11 20:59:18
e65e6039a8310e2b110ea5b22be90e73a2eae84d...02da5ed4a1f63bb0990b8e7b1fd0793cd045cbb0,4,425,0,425,10,2010-06-12 09:41:45,2010-06-12 09:40:24
02da5ed4a1f63bb0990b8e7b1fd0793cd045cbb0...5f3906b65e3bced391de60b513299f6d7790fb2e,2,40,5,45,5,2010-06-14 17:58:17,2010-06-14 17:34:34
5f3906b65e3bced391de60b513299f6d7790fb2e...009b4569b3d118b8d0981af7b79fc4279bb97d84,3,7,19,26,7,2010-06-14 20:10:23,2010-06-14 20:10:23
009b4569b3d118b8d0981af7b79fc4279bb97d84...d6072766ed7650c4f2a60c988df696d8fd41db8e,1,5,4,9,3,2010-06-14 21:38:40,2010-06-14 21:38:40
d6072766ed7650c4f2a60c988df696d8fd41db8e...1ffdad010bdfc63c03b7291a7b80331e8ee7219c,1,2,0,2,1,2010-06-14 22:10:00,2010-06-13 06:03:11
1ffdad010bdfc63c03b7291a7b80331e8ee7219c...c9dde726c604a9b12380fd551c710e6c36a4f503,1,34,0,34,1,2010-06-15 18:44:33,2010-06-15 18:44:33
c9dde726c604a9b12380fd551c710e6c36a4f503...14414f81f33056e8cb0dacce7a6f108235e46e9e,17,51,65,116,42,2010-06-15 19:38:25,2010-06-15 19:38:22
14414f81f33056e8cb0dacce7a6f108235e46e9e...5f88097eb4d2766a7b23385d15d43693c7bb284a,1,0,322,322,1,2010-06-15 19:41:14,2010-06-15 19:41:14
5f88097eb4d2766a7b23385d15d43693c7bb284a...5bc00abed7682fc278c3004232e59e8042589a94,1,288,324,612,170,2010-06-15 20:16:20,2010-06-15 20:16:20
5bc00abed7682fc278c3004232e59e8042589a94...9854216d36cf7cd2662bcc3e87c50b4971908aec,1,86,51,137,59,2010-06-15 20:31:59,2010-06-15 20:31:59
9854216d36cf7cd2662bcc3e87c50b4971908aec...459440842f7b2fd91b2c9e33129eafd7b8db9004,1,70,64,134,10,2010-06-15 20:36:01,2010-06-15 20:35:47
459440842f7b2fd91b2c9e33129eafd7b8db9004...f3cd7bbe778bb69251637d49a33ddacc0973e973,1,1,1,2,1,2010-06-15 21:44:09,2010-06-15 19:16:08
f3cd7bbe778bb69251637d49a33ddacc0973e973...bc76624ec72792b23b4e951ef1ee8b95b454aa34,36,2142,237,2379,133,2010-06-15 21:52:00,2010-06-15 21:52:00
bc76624ec72792b23b4e951ef1ee8b95b454aa34...4b48042c175b6b8ea042a18853c9873ca1a587f8,1,14,6,20,2,2010-06-15 22:10:30,2010-06-15 20:33:44
4b48042c175b6b8ea042a18853c9873ca1a587f8...6bed15e0748590e2589e64b151c3f4b8aab7ae78,7,85,122,207,39,2010-06-16 01:19:27,2010-06-16 01:19:25
6bed15e0748590e2589e64b151c3f4b8aab7ae78...ed5f4f3a444e155292db2be6b499528c279fdefb,1,2,2,4,2,2010-06-16 01:29:45,2010-06-16 01:29:45
ed5f4f3a444e155292db2be6b499528c279fdefb...4ce100fa622d97de51d7cccde2301653ee95bbe7,3,95,24,119,12,2010-06-16 02:28:09,2010-06-15 04:13:09
4ce100fa622d97de51d7cccde2301653ee95bbe7...e48f0d1dd99a72925796bfd8d199198acca7845e,2,2,1,3,2,2010-06-16 02:52:37,2010-06-07 20:52:20
e48f0d1dd99a72925796bfd8d199198acca7845e...c2e2479cc51465ae18357d73f7d4aa7ba98ea0b3,1,2,0,2,1,2010-06-16 03:04:29,2010-06-16 03:04:29
c2e2479cc51465ae18357d73f7d4aa7ba98ea0b3...1d088fb9062bf67d7285a801a5c1630740d1357f,2,24,3,27,4,2010-06-16 06:58:32,2010-06-16 04:52:15
1d088fb9062bf67d7285a801a5c1630740d1357f...73f207fe5989da26882b05a5221625fabfed743c,1,18,9,27,9,2010-06-16 17:11:08,2010-06-16 07:24:41
73f207fe5989da26882b05a5221625fabfed743c...b05daaaf69c5445dd28ad3efab118ce92cd23afb,2,11,0,11,2,2010-06-16 17:26:11,2010-06-16 13:51:19
b05daaaf69c5445dd28ad3efab118ce92cd23afb...cf86527a28a9305bb8b2059362e89170e28a9cb2,1,1,1,2,1,2010-06-16 17:28:46,2010-06-16 17:28:46
cf86527a28a9305bb8b2059362e89170e28a9cb2...81ad8106dc3713e435eba7cb114c72b8e879112b,2,37,13,50,9,2010-06-16 17:45:16,2010-06-16 17:42:55
81ad8106dc3713e435eba7cb114c72b8e879112b...cbf2a2233eb2ef17b7a341b7e88c4309f80457e0,2,34,7,41,12,2010-06-16 18:03:34,2010-06-16 18:00:43
cbf2a2233eb2ef17b7a341b7e88c4309f80457e0...187f191558ef45562865e071fdcd11e1dbec79df,4,89,3,92,3,2010-06-16 18:27:56,2010-06-15 17:35:49
187f191558ef45562865e071fdcd11e1dbec79df...1c6671aa67c3d7f731fec415a58f7676e1468a15,48,2475,729,3204,354,2010-06-16 18:46:01,2010-06-16 18:45:48
1c6671aa67c3d7f731fec415a58f7676e1468a15...964ed9739b8984c6b9c78a20804e84c9e354bb1b,1,2,2,4,1,2010-06-17 22:38:02,2010-06-17 22:38:02
964ed9739b8984c6b9c78a20804e84c9e354bb1b...01a8d270cf4ed84887ab5e6829e929ba737e4cdf,7,244,207,451,16,2010-06-18 01:23:43,2010-06-18 01:23:40
01a8d270cf4ed84887ab5e6829e929ba737e4cdf...84c10265dbce359feedf8e59f100ecf119cf2b72,1,2,1,3,1,2010-06-18 01:36:31,2010-06-18 01:36:31
84c10265dbce359feedf8e59f100ecf119cf2b72...9bd3942f702fa4135986947b7cd4eb49d5c1addf,1,16,0,16,1,2010-06-18 16:46:18,2010-06-18 16:46:18
9bd3942f702fa4135986947b7cd4eb49d5c1addf...3f48276bf9e36d6af5760aeb4fbd1123f6c4f207,1,24,17,41,15,2010-06-18 17:21:38,2010-06-18 09:42:58
3f48276bf9e36d6af5760aeb4fbd1123f6c4f207...e0d30b545a737c43097f96446d82374ab2fd1e9a,11,0,0,0,0,2010-06-18 17:34:56,2010-06-18 17:34:56
e0d30b545a737c43097f96446d82374ab2fd1e9a...70c3e661b8a7338c3d959e19d48905e8161ea5e5,1,2,1,3,2,2010-06-18 17:39:17,2010-06-18 09:46:10
70c3e661b8a7338c3d959e19d48905e8161ea5e5...125b868e06853c86ef55a809939f7cef2ec806e1,6,233,1,234,7,2010-06-19 01:14:06,2010-06-19 01:14:06
125b868e06853c86ef55a809939f7cef2ec806e1...7d0252eae2ff0a6d711535af4712d0d67ba34106,4,89,89,178,4,2010-06-20 00:41:34,2010-06-20 00:41:34
7d0252eae2ff0a6d711535af4712d0d67ba34106...f1a4f17897c420295dafd703dda3abe0a50fc4ed,5,43,2,45,5,2010-06-20 02:31:09,2010-06-20 02:31:09
f1a4f17897c420295dafd703dda3abe0a50fc4ed...1c7057f09cfe4c1d27439b6ef9b1549ee0fa9496,1,1,1,2,1,2010-06-20 03:30:49,2010-06-20 03:30:49
1c7057f09cfe4c1d27439b6ef9b1549ee0fa9496...b93faf9afa6fcd88fcb8030f86cc15551b8e4d3c,1,2,2,4,2,2010-06-20 05:51:40,2010-06-20 05:31:15
b93faf9afa6fcd88fcb8030f86cc15551b8e4d3c...eda21cccb4caf0ba8be325b79c6c37ecaf1845c3,1,13,11,24,4,2010-06-20 06:13:28,2010-06-20 06:13:28
eda21cccb4caf0ba8be325b79c6c37ecaf1845c3...cb79614f73bf4dbdadbb7290577e22094b8b502f,9,11,12,23,23,2010-06-20 18:56:48,2010-06-20 18:54:51
cb79614f73bf4dbdadbb7290577e22094b8b502f...545e10f2399dd748f6261919ed3db177d02ef008,1,5,1,6,2,2010-06-21 17:21:55,2010-06-21 17:21:55
545e10f2399dd748f6261919ed3db177d02ef008...51bd1b4483f60d85ee19274aab98505a0b5c9105,2,63,5,68,4,2010-06-21 19:01:50,2010-06-21 18:53:17
51bd1b4483f60d85ee19274aab98505a0b5c9105...a620b7298f68f68a855306437a3b60b650d61d78,5,27,5,32,5,2010-06-21 20:34:10,2010-06-21 20:34:10
a620b7298f68f68a855306437a3b60b650d61d78...9bb890271b4539b39ba1dfb9efa6053a1791eb93,1,6,7,13,1,2010-06-22 00:03:19,2010-06-22 00:03:19
9bb890271b4539b39ba1dfb9efa6053a1791eb93...a8e9923b4440343d94a6e5565a054deece7d0af8,2,210,1,211,3,2010-06-22 02:40:22,2010-06-22 01:54:28
a8e9923b4440343d94a6e5565a054deece7d0af8...95b252e86dc3106710dca0340eee3b02a9bad5f4,1,3,3,6,3,2010-06-22 03:41:53,2010-06-22 03:41:53
95b252e86dc3106710dca0340eee3b02a9bad5f4...ca35ba640a933e4d7faab4266d20b32485f13149,8,88,0,88,10,2010-06-22 09:02:25,2010-06-22 06:31:19
ca35ba640a933e4d7faab4266d20b32485f13149...7105aeb22f80afa2b23fd6ee87a49273dcda75e1,1,5,0,5,1,2010-06-22 09:09:58,2010-06-22 09:09:58
7105aeb22f80afa2b23fd6ee87a49273dcda75e1...1b5ec7017da1829cb17347b7684855ea60be1f00,1,11,4,15,2,2010-06-22 20:19:49,2010-06-22 20:14:03
1b5ec7017da1829cb17347b7684855ea60be1f00...20905d9d62a115de63fe56d8128906f3ea4d5cd4,1,3,3,6,3,2010-06-22 20:23:45,2010-06-22 20:23:45
20905d9d62a115de63fe56d8128906f3ea4d5cd4...f62979da6b837237ea6c6c908e97cfa98c9477f6,3,69,0,69,3,2010-06-23 00:58:09,2010-05-29 00:52:59
f62979da6b837237ea6c6c908e97cfa98c9477f6...fc175a089de8f71e393a9031819a2588881d317e,2,2,169,171,4,2010-06-23 02:33:01,2010-06-23 02:33:01
fc175a089de8f71e393a9031819a2588881d317e...f541043618b8e02d65590a60489601d886f85f7d,3,0,141,141,3,2010-06-23 02:37:29,2010-06-23 02:37:29
f541043618b8e02d65590a60489601d886f85f7d...7b119f8b38671ca7ee26d369ccc7f629fb9bc3bf,1,1,1,2,1,2010-06-23 16:09:15,2010-06-23 16:09:15
7b119f8b38671ca7ee26d369ccc7f629fb9bc3bf...4c21aa736f4ca631efd77203113bf879e3fe4987,1,1,1,2,1,2010-06-23 22:27:56,2010-06-23 22:27:56
4c21aa736f4ca631efd77203113bf879e3fe4987...ba792ea2020f38ebf84925e740b42823b739d0d3,92,352,396,748,333,2010-06-24 03:05:29,2010-06-24 00:40:51
ba792ea2020f38ebf84925e740b42823b739d0d3...2c0d91be6c8972f325b64a15c798f45e68bf183a,72,1608,798,2406,459,2010-06-24 03:32:06,2010-06-24 03:31:48
2c0d91be6c8972f325b64a15c798f45e68bf183a...8825c74e7aea20f24bc2f6c165cb3ce3d5011b77,3,251,194,445,44,2010-06-24 04:10:13,2010-06-24 04:10:13
8825c74e7aea20f24bc2f6c165cb3ce3d5011b77...0499618c2bc013bb36332c7a72561aefe58279f0,1,3,2,5,2,2010-06-24 14:51:45,2010-06-24 14:51:45
0499618c2bc013bb36332c7a72561aefe58279f0...444b33584df0de604cf62744d6daa8f01aca34d5,1,0,2,2,1,2010-06-24 16:37:36,2010-06-24 16:37:18
444b33584df0de604cf62744d6daa8f01aca34d5...aa491518f4632cd4c9d6a56382ee8395d42f3adc,1,2,2,4,2,2010-06-24 21:37:55,2010-06-24 21:23:12
aa491518f4632cd4c9d6a56382ee8395d42f3adc...a2f70da4c9bf14a6e0c4a17cac11a5ab555ce90f,4,106,15,121,12,2010-06-25 16:10:49,2010-06-24 19:26:23
a2f70da4c9bf14a6e0c4a17cac11a5ab555ce90f...bbdd61dc3f9cb5607c7ac8f570b2b6b473e4378c,1,3,3,6,1,2010-06-25 16:46:10,2010-06-25 16:46:10
bbdd61dc3f9cb5607c7ac8f570b2b6b473e4378c...67f7fe5e5c210f42fd3c27809a97245b4eb242f9,1,6,0,6,1,2010-06-27 15:49:06,2010-06-27 11:51:39
67f7fe5e5c210f42fd3c27809a97245b4eb242f9...5a25338ac08ff9ab7656f91a67f06491e5cf8431,54,1473,1012,2485,465,2010-06-28 15:47:01,2010-06-28 15:47:01
5a25338ac08ff9ab7656f91a67f06491e5cf8431...242161bef2e3631d315f8da8a62c088bdc100c87,10,211,37,248,44,2010-06-28 22:16:26,2010-06-24 10:17:05
242161bef2e3631d315f8da8a62c088bdc100c87...e2db605308b4137930f658fbbe00312e1c5f8212,1,1,1,2,1,2010-06-28 22:37:29,2010-06-28 22:37:29
e2db605308b4137930f658fbbe00312e1c5f8212...23172c5d859e2ee90c4b440ee064a51039467baf,2,82,100,182,40,2010-06-29 02:37:50,2010-06-29 00:27:17
23172c5d859e2ee90c4b440ee064a51039467baf...c9e12204a20ab14b57b5811479a1f1a031f12b5b,1,29,3,32,5,2010-06-29 03:47:35,2010-06-29 03:47:12
c9e12204a20ab14b57b5811479a1f1a031f12b5b...b69c6a03b18ff9dd496368c58ae5db3fa1fafe08,1,1,0,1,1,2010-06-29 04:20:21,2010-06-29 04:12:33
b69c6a03b18ff9dd496368c58ae5db3fa1fafe08...5aadeae88893fc1d6e417c75e67169749a97f16c,2,6,39,45,7,2010-06-29 04:20:21,2010-06-29 04:09:44
5aadeae88893fc1d6e417c75e67169749a97f16c...6b430a95c9a8c965f32d641dced169e6cecd61d6,1,1,1,2,1,2010-06-29 16:53:20,2010-06-29 16:53:12
6b430a95c9a8c965f32d641dced169e6cecd61d6...d3f04933f151b233ccd1972a933d0e9873d78ca5,1,7,5,12,1,2010-06-30 02:11:40,2010-06-28 01:05:22
d3f04933f151b233ccd1972a933d0e9873d78ca5...8ec12339f556e5ccf7172abf7397e349fa78c37b,1,17,30,47,10,2010-06-30 02:22:28,2010-06-28 01:57:11
8ec12339f556e5ccf7172abf7397e349fa78c37b...0172cb39f0adc666dbe1339e16c252ad2bd94bef,1,1,1,2,1,2010-06-30 02:28:59,2010-06-30 02:28:59
0172cb39f0adc666dbe1339e16c252ad2bd94bef...5e86d013859ff749c185a1a2be46f9be05ffe5c6,4,17,24,41,12,2010-06-30 02:40:20,2010-06-29 16:36:50
5e86d013859ff749c185a1a2be46f9be05ffe5c6...898afbaf348a3f7188cfd759914528704350a448,2,20,8,28,3,2010-06-30 02:56:07,2010-06-30 02:10:39
898afbaf348a3f7188cfd759914528704350a448...02ed0ec93bc8f6bcd7f1d629dca64ba1f335ea05,1,10,3,13,1,2010-06-30 04:06:00,2010-06-30 03:10:01
02ed0ec93bc8f6bcd7f1d629dca64ba1f335ea05...0a8bd34b6993156da074ff89863f12e404e36ede,2,183,13,196,5,2010-06-30 05:15:28,2010-06-30 04:20:32
0a8bd34b6993156da074ff89863f12e404e36ede...f8ca6b383c1cac95ba9a9bcddfe66cc62b09558b,2,76,99,175,15,2010-06-30 06:52:42,2010-06-29 08:24:43
f8ca6b383c1cac95ba9a9bcddfe66cc62b09558b...8c8534046c5ce25ad58cde5b71bc4a189e7fb7a8,38,96,96,192,88,2010-06-30 06:59:24,2010-06-30 06:12:46
8c8534046c5ce25ad58cde5b71bc4a189e7fb7a8...d49d53fd499f7cf68fdfcc7d0c9d401e4e4407fb,1,12,0,12,3,2010-06-30 07:54:08,2010-06-30 07:54:03
d49d53fd499f7cf68fdfcc7d0c9d401e4e4407fb...ce8c30c9dee6ba03cfd37ca29bb397677a38f777,1,3,6,9,1,2010-06-30 21:30:37,2010-06-30 21:30:35
ce8c30c9dee6ba03cfd37ca29bb397677a38f777...8f8dcf8ed63b19a6c20915e12af83a3ad792f1d2,5,24,10,34,7,2010-06-30 22:04:40,2010-06-30 22:03:45
8f8dcf8ed63b19a6c20915e12af83a3ad792f1d2...8a52fb7aebcde0baa5682a19cdb1d03dfa63201f,5,10,24,34,7,2010-07-01 18:10:22,2010-07-01 18:10:22
8a52fb7aebcde0baa5682a19cdb1d03dfa63201f...24de2bd58ca6c4490d9af282ba16d4249565c41b,1,2,0,2,2,2010-07-01 21:29:50,2010-07-01 21:29:06
24de2bd58ca6c4490d9af282ba16d4249565c41b...2998e3bafa60d94e88eb6a4c7f82d24b9c9f7ca7,1,13,0,13,1,2010-07-01 21:31:42,2010-07-01 21:31:42
2998e3bafa60d94e88eb6a4c7f82d24b9c9f7ca7...192234c68958bbc2489d3bb3b7a020fb4393e144,1,0,13,13,2,2010-07-02 06:36:56,2010-07-02 06:36:53
192234c68958bbc2489d3bb3b7a020fb4393e144...82ce3481fe2d8d883af328f7a6dcec904e2e4fda,1,7,7,14,1,2010-07-03 06:16:36,2010-07-03 06:16:36
82ce3481fe2d8d883af328f7a6dcec904e2e4fda...94cd83ef34176f4e451e91c92d3b2596032b8e96,2,32,4,36,7,2010-07-03 06:18:42,2010-06-22 20:46:55
94cd83ef34176f4e451e91c92d3b2596032b8e96...2072925f121fe8785dfd046eba24f8d18c59ae75,54,1485,346,1831,265,2010-07-03 06:37:05,2010-07-03 06:36:33
2072925f121fe8785dfd046eba24f8d18c59ae75...a6b8586e947f9c3ced180fe68c233d0c252add8b,5,28,5,33,5,2010-07-03 06:37:46,2010-07-03 06:34:15
a6b8586e947f9c3ced180fe68c233d0c252add8b...515dc2161b3b6402d82102f1c0d08b19f3aaac58,2,2,1,3,2,2010-07-03 07:30:32,2010-07-03 07:30:32
515dc2161b3b6402d82102f1c0d08b19f3aaac58...0315251d01dfb439d297e05f0ab9dd0d3e537048,2,32,34,66,30,2010-07-03 08:54:35,2010-07-03 08:54:35
0315251d01dfb439d297e05f0ab9dd0d3e537048...3d948d85ce15f07d22feea12bd55fe040d993477,23,0,4204,4204,23,2010-07-04 02:16:55,2010-07-03 09:31:03
3d948d85ce15f07d22feea12bd55fe040d993477...0bceaaa3d4edfa29d716efdd58a8734fb83b9ec7,1,1,1,2,1,2010-07-07 14:48:53,2010-07-07 13:13:36
0bceaaa3d4edfa29d716efdd58a8734fb83b9ec7...8e9f59a4521f4af66ecd46b0efdda11e52329056,1,11,0,11,1,2010-07-07 14:48:59,2010-07-07 09:58:33
8e9f59a4521f4af66ecd46b0efdda11e52329056...1191ca052fbb1ee4ae20d0b47dc881ed4a737e01,1,45,15,60,15,2010-07-07 14:49:04,2010-07-04 06:08:35
1191ca052fbb1ee4ae20d0b47dc881ed4a737e01...70a8fb3763c92337bbc6a6138dd0c320134b847c,2,49,2,51,3,2010-07-07 16:46:24,2010-07-07 16:43:39
70a8fb3763c92337bbc6a6138dd0c320134b847c...facb904c5db23345a693bf3aa02b1497af12fddd,85,4064,1471,5535,831,2010-07-07 17:47:38,2010-07-07 17:47:38
facb904c5db23345a693bf3aa02b1497af12fddd...b1901cd5a5bd647cec9346f838da36e311d38500,1,1,1,2,1,2010-07-07 18:10:01,2010-07-07 18:10:01
b1901cd5a5bd647cec9346f838da36e311d38500...a7e1efc5bd137a950e4b04f90dfaf2391ee2eec0,1,33,9,42,7,2010-07-12 14:46:45,2010-07-10 18:38:42
a7e1efc5bd137a950e4b04f90dfaf2391ee2eec0...2b8a9a835821f64fccfc7b571a7c4fb99328f684,11,2259,5,2264,12,2010-07-12 17:24:09,2010-07-11 21:50:24
2b8a9a835821f64fccfc7b571a7c4fb99328f684...a7763d55e40bd37ac221279ba6d1f2cf957920a9,1,1,1,2,1,2010-07-12 17:35:35,2010-07-11 22:37:12
a7763d55e40bd37ac221279ba6d1f2cf957920a9...c8dba94ff6b57c367f72b4d712df07b101da94e1,1,92,0,92,1,2010-07-12 18:18:52,2010-07-11 20:53:41
c8dba94ff6b57c367f72b4d712df07b101da94e1...4e3c5d88b37046c954df19f8c4780799f7fb514b,2,16,10,26,10,2010-07-12 20:20:26,2010-07-12 15:47:45
4e3c5d88b37046c954df19f8c4780799f7fb514b...792c7caf405114556498d53a2d3e65c35ab1c4e3,2,39,20,59,22,2010-07-12 20:20:31,2010-07-12 15:48:16
792c7caf405114556498d53a2d3e65c35ab1c4e3...760fb17bbf5a991599d663a7f1ddcf4c337eeb53,1,17,10,27,6,2010-07-12 20:20:31,2010-07-12 15:48:28
760fb17bbf5a991599d663a7f1ddcf4c337eeb53...6eb0b6ac2774bc10d7f6a86b8019bbdc6339f34a,1,6,5,11,6,2010-07-12 20:20:31,2010-07-12 15:48:33
6eb0b6ac2774bc10d7f6a86b8019bbdc6339f34a...7a706e4206b1cf905fcf47cab5dc739eb1c3492f,1,29,29,58,30,2010-07-12 20:20:31,2010-07-12 15:48:37
7a706e4206b1cf905fcf47cab5dc739eb1c3492f...d700a6f74ad7b32b1f9106634ac6b13b4ae4244a,1,2,0,2,1,2010-07-12 21:18:09,2010-07-12 21:18:09
d700a6f74ad7b32b1f9106634ac6b13b4ae4244a...554b02a14c04979f197c9c862aafec02effee161,1,259,225,484,127,2010-07-12 21:23:35,2010-07-12 20:00:52
554b02a14c04979f197c9c862aafec02effee161...4be4b5f6f49f888c4226cf7862608bbb56a0bb72,1,1,1,2,1,2010-07-12 22:23:10,2010-07-12 22:18:59
4be4b5f6f49f888c4226cf7862608bbb56a0bb72...abd3f8a02abd1cb87fdbf370f51ec3bfbaacfaf3,1,1,1,2,1,2010-07-12 23:29:42,2010-07-12 22:43:09
abd3f8a02abd1cb87fdbf370f51ec3bfbaacfaf3...c9e505791a7eae47a0c3e6bcbeb33553ac3b85cb,1,3,1,4,2,2010-07-12 23:29:58,2010-06-29 01:33:21
c9e505791a7eae47a0c3e6bcbeb33553ac3b85cb...ac2404283e4b5718b91093403e1afcc6e4104180,1,1,0,1,1,2010-07-12 23:37:17,2010-07-12 22:04:15
ac2404283e4b5718b91093403e1afcc6e4104180...99a5d1e2939494c472542b2aee4af61e63f3ae21,1,1,0,1,1,2010-07-12 23:37:35,2010-07-12 22:05:06
99a5d1e2939494c472542b2aee4af61e63f3ae21...480164f923addd6d12f4d6808cbf7875cdd96c86,4,43,30,73,8,2010-07-13 13:39:47,2010-07-13 06:59:57
480164f923addd6d12f4d6808cbf7875cdd96c86...49066042a2df12b23a79fc4771f2e4324c3801df,1,30,0,30,1,2010-07-13 13:59:53,2010-07-13 07:22:33
49066042a2df12b23a79fc4771f2e4324c3801df...367b87d26db90015bdee12e3efea49f9d0c0a7ea,1,42,6,48,6,2010-07-13 14:08:08,2010-07-13 08:33:51
367b87d26db90015bdee12e3efea49f9d0c0a7ea...6bf294d71a172ccf6b9066c92b1aa8e772a31ffd,1,1,1,2,1,2010-07-13 17:16:33,2010-07-13 17:16:33
6bf294d71a172ccf6b9066c92b1aa8e772a31ffd...2085909aebcf47e6a6aa9c5d10cf6a960544eeec,3,18,1,19,4,2010-07-14 00:15:10,2010-07-01 18:19:54
2085909aebcf47e6a6aa9c5d10cf6a960544eeec...16cb45103f29a46fbd19eb19e3042678800e1b70,1,11,0,11,3,2010-07-14 00:17:20,2010-07-14 00:17:05
16cb45103f29a46fbd19eb19e3042678800e1b70...50c38dec705b3ebfd073bfa6c835572eb1527db8,1,2,2,4,2,2010-07-14 16:50:17,2010-07-14 16:50:17
50c38dec705b3ebfd073bfa6c835572eb1527db8...fb645f75fb45d5bf70f3d05a586ea067ff273ee5,2,19,17,36,10,2010-07-14 16:52:59,2010-07-14 12:10:17
fb645f75fb45d5bf70f3d05a586ea067ff273ee5...781d51285d603a7a0ded3ead3bdfc23e60567cf4,1,1,1,2,1,2010-07-14 16:58:18,2010-07-03 04:38:06
781d51285d603a7a0ded3ead3bdfc23e60567cf4...30dadfc033b45842691cef02caf059ba5db0b63a,7,83,27,110,17,2010-07-14 17:17:25,2010-07-14 06:22:41
30dadfc033b45842691cef02caf059ba5db0b63a...8dbfe5ea8fcb4124031859aa7511e8c993243671,1,58,100,158,10,2010-07-14 17:23:24,2010-07-14 06:32:38
8dbfe5ea8fcb4124031859aa7511e8c993243671...e5bb8abc9d3084b8d0ffaaaf06cbfc4ea5138431,3,4,7,11,4,2010-07-14 17:29:56,2010-07-14 06:38:49
e5bb8abc9d3084b8d0ffaaaf06cbfc4ea5138431...208290b524ced660e12f3b6794842ae1a460971b,3,3,5,8,3,2010-07-14 17:31:20,2010-07-14 06:42:23
208290b524ced660e12f3b6794842ae1a460971b...e51aef7f3c0182a47ee3188f01562a9ff8dffefc,3,3,4,7,3,2010-07-14 17:31:45,2010-07-14 06:45:24
e51aef7f3c0182a47ee3188f01562a9ff8dffefc...e65c27062f3003884cfc8316b65359e7da31c9ce,3,2,4,6,3,2010-07-14 17:36:24,2010-07-14 06:51:08
e65c27062f3003884cfc8316b65359e7da31c9ce...4f7f43762d3cb5da703eb289609e4c96a6c224bb,3,3,4,7,3,2010-07-14 17:36:52,2010-07-14 06:55:15
4f7f43762d3cb5da703eb289609e4c96a6c224bb...82daa46e26da1d6eb65bec478d02343ab724b309,3,3,4,7,3,2010-07-14 17:37:24,2010-07-14 06:58:15
82daa46e26da1d6eb65bec478d02343ab724b309...ace2be8aa60ba5f902823d915460012d877ea4da,4,98,92,190,9,2010-07-14 17:42:32,2010-07-14 07:10:38
ace2be8aa60ba5f902823d915460012d877ea4da...870aa3d97f65a58f80e8347c796f5ba685410462,4,12,5,17,4,2010-07-14 17:55:07,2010-07-14 07:17:21
870aa3d97f65a58f80e8347c796f5ba685410462...8e2530c320d19717ffd3a2685a41e277e35235fd,81,10880,10005,20885,1725,2010-07-14 18:16:20,2010-07-14 18:16:20
8e2530c320d19717ffd3a2685a41e277e35235fd...b64a521d665608379429614f5b337b8c6323233a,1,3,3,6,3,2010-07-15 16:54:53,2010-07-14 23:07:17
b64a521d665608379429614f5b337b8c6323233a...e7c4f8cdaa5905a45fa990354023330f3309e4ae,2,25,1,26,3,2010-07-15 17:20:42,2010-07-15 13:52:15
e7c4f8cdaa5905a45fa990354023330f3309e4ae...4e50197e5330b7f1f603981f6dc817cac7f9a4f9,8,547,252,799,59,2010-07-15 17:27:44,2010-07-05 20:38:13
4e50197e5330b7f1f603981f6dc817cac7f9a4f9...5f30377bbcf97ea68f9f26aec7078581129e0f76,4,56,10,66,11,2010-07-15 17:34:39,2010-07-13 23:40:54
5f30377bbcf97ea68f9f26aec7078581129e0f76...3a00470dbb0ac1ead14b52624b16e917e522fddf,1,2,0,2,2,2010-07-15 17:35:29,2010-07-14 21:22:58
3a00470dbb0ac1ead14b52624b16e917e522fddf...6a57a42109503b5327c4ffca20fe4048103c3b80,1,2,2,4,2,2010-07-15 17:35:29,2010-07-14 21:29:28
6a57a42109503b5327c4ffca20fe4048103c3b80...ddad872020cd4c60746a5ec2bd896a93fcbad811,1,2,0,2,1,2010-07-15 17:36:35,2010-07-15 17:36:35
ddad872020cd4c60746a5ec2bd896a93fcbad811...94728125696ce05f5308ccbc111874e9fa936936,1,1,1,2,1,2010-07-15 17:52:31,2010-07-15 17:52:31
94728125696ce05f5308ccbc111874e9fa936936...9fd5e3c89cb3664be7491c2da8e7060a0c36e135,141,624,499,1123,430,2010-07-15 21:21:31,2010-07-15 18:47:25
9fd5e3c89cb3664be7491c2da8e7060a0c36e135...4c6f4dabf5f43746719117ce176db7d39b893b57,1,2,2,4,2,2010-07-15 21:21:32,2010-07-15 20:42:39
4c6f4dabf5f43746719117ce176db7d39b893b57...8921bf454d7fd10beca1623c6cf76b72fc3b7751,1,13,57,70,8,2010-07-15 21:21:32,2010-07-15 21:09:33
8921bf454d7fd10beca1623c6cf76b72fc3b7751...c926ab77461d139db021299c52a5346b524cd049,1,10,11,21,5,2010-07-15 21:21:32,2010-07-15 21:14:05
c926ab77461d139db021299c52a5346b524cd049...bd05d83ae7ebfa4921b8a6f68deaf16951c16531,1,6,0,6,1,2010-07-15 21:21:35,2010-07-15 18:32:51
bd05d83ae7ebfa4921b8a6f68deaf16951c16531...6961bc568f2391a9abe53b9454174cae51308a62,1,6,5,11,6,2010-07-15 21:37:56,2010-07-15 21:32:45
6961bc568f2391a9abe53b9454174cae51308a62...02729d4af7b17ea4c7272a0d0d99f6f7418e3237,3,11,7,18,8,2010-07-15 22:58:35,2010-07-15 21:37:03
02729d4af7b17ea4c7272a0d0d99f6f7418e3237...98341daee2c34fa1534b7a332e824db2e1556dce,1,9,2,11,3,2010-07-15 23:46:46,2010-07-15 21:36:21
98341daee2c34fa1534b7a332e824db2e1556dce...078a48a97b5b2597443f867e904a4c7e7f061c42,2,40,7,47,7,2010-07-16 00:17:03,2010-07-09 13:05:54
078a48a97b5b2597443f867e904a4c7e7f061c42...dcd41ca864749b130b943c1e41eb993388f7e9d8,36,1012,423,1435,222,2010-07-16 01:52:48,2010-07-16 01:52:48
dcd41ca864749b130b943c1e41eb993388f7e9d8...1662c37c40c88dd37c35a1a6722c71a23eaa577c,1,1,1,2,1,2010-07-16 06:36:35,2010-07-16 06:36:35
1662c37c40c88dd37c35a1a6722c71a23eaa577c...458bbb46879ded3706978c05aabb38270d99276f,2,3,2,5,2,2010-07-17 02:05:28,2010-07-17 02:05:28
458bbb46879ded3706978c05aabb38270d99276f...0174ceb6b24caa0bdfc523934c56af9600fa9b58,5,33,5,38,5,2010-07-17 04:50:26,2010-07-17 04:50:26
0174ceb6b24caa0bdfc523934c56af9600fa9b58...fa344d8514f12028e94d69a542aa7b3a3bf7503e,1,6,2,8,1,2010-07-17 06:24:08,2010-07-17 05:36:22
fa344d8514f12028e94d69a542aa7b3a3bf7503e...11a784d6da1bbd3aea74fddc52c1e4dca7934ec9,3,89,50,139,37,2010-07-17 08:22:16,2010-07-17 08:22:16
11a784d6da1bbd3aea74fddc52c1e4dca7934ec9...341e41726febd84565cf7a4fbf2b13143faf7e0d,1,2,0,2,1,2010-07-18 06:10:38,2010-07-18 06:10:38
341e41726febd84565cf7a4fbf2b13143faf7e0d...02746eddd6f789f0719a2ec627fe1c79d5a274c6,1,5,6,11,1,2010-07-18 06:26:58,2010-07-18 06:26:58
02746eddd6f789f0719a2ec627fe1c79d5a274c6...0fd1656d63e5e1eb3048b718c53d35c6d5918846,1,5,0,5,1,2010-07-19 05:20:23,2010-07-18 23:12:27
0fd1656d63e5e1eb3048b718c53d35c6d5918846...65f2e72d770158502eacdc0a847ca538534749b7,1,2,3,5,1,2010-07-19 17:16:20,2010-07-19 17:16:20
65f2e72d770158502eacdc0a847ca538534749b7...0ed3532699fb67c5054c7732c2ab2371abdf3eb0,2,11,0,11,2,2010-07-19 17:16:31,2010-07-19 06:04:22
0ed3532699fb67c5054c7732c2ab2371abdf3eb0...9a26946aaa99a3f27905d5ba91220784e864e5d0,1,10,6,16,2,2010-07-19 17:32:56,2010-07-19 17:32:56
9a26946aaa99a3f27905d5ba91220784e864e5d0...eda1edd07f03dea04d30445308813af273b57454,1,3,0,3,1,2010-07-19 17:35:59,2010-07-19 17:35:59
eda1edd07f03dea04d30445308813af273b57454...bb2acd5e757cd37a94dc7f3bfab134a49963eb24,2,21,30,51,7,2010-07-19 17:53:32,2010-07-18 20:16:43
bb2acd5e757cd37a94dc7f3bfab134a49963eb24...c7e0c64506acb3095a903776d894c2c3058dd06b,1,1,1,2,1,2010-07-19 17:53:54,2010-07-17 11:20:20
c7e0c64506acb3095a903776d894c2c3058dd06b...f18d9d8466a540874d7d099a77f7867306f9cc69,1,11,8,19,3,2010-07-19 17:54:50,2010-07-18 19:09:13
f18d9d8466a540874d7d099a77f7867306f9cc69...299671b731e9ba790195b1c66ee8ee23c662abf9,2,9,8,17,8,2010-07-19 18:07:08,2010-07-19 08:55:11
299671b731e9ba790195b1c66ee8ee23c662abf9...a9d8cac4b05753e40051c0ffe1a883aef576aecd,1,2,2,4,2,2010-07-19 18:47:25,2010-07-19 15:48:58
a9d8cac4b05753e40051c0ffe1a883aef576aecd...49e0f14a2f9ad85ab5c9256e97d6ecb1a11fa936,6,54,41,95,11,2010-07-19 21:17:22,2010-07-15 17:41:40
49e0f14a2f9ad85ab5c9256e97d6ecb1a11fa936...352b8c3ad5d743aa2298afc2047ae9b92a453604,1,15,13,28,15,2010-07-19 21:18:55,2010-07-19 20:59:09
352b8c3ad5d743aa2298afc2047ae9b92a453604...7067a7155f26f595a6344c16f64ac1985e9e5403,3,28,9,37,10,2010-07-20 03:08:35,2010-07-20 03:08:33
7067a7155f26f595a6344c16f64ac1985e9e5403...d75b63bc3c56c3a9d8c006db2ac183bfc354204e,3,7,1,8,3,2010-07-20 17:26:24,2010-07-20 00:54:49
d75b63bc3c56c3a9d8c006db2ac183bfc354204e...5ebf6049d07a5fe03b7b748d4369b6de9faeb593,1,13,0,13,2,2010-07-20 19:38:03,2010-07-20 19:30:33
5ebf6049d07a5fe03b7b748d4369b6de9faeb593...8acea2693dd79f37e74c3f7af89528d01f666e22,1,3,3,6,1,2010-07-20 19:41:39,2010-07-20 19:41:39
8acea2693dd79f37e74c3f7af89528d01f666e22...56f200af5d8a1d98b40d70ed54cf643afa0008dc,2,12,1,13,2,2010-07-20 22:38:10,2010-07-20 22:23:30
56f200af5d8a1d98b40d70ed54cf643afa0008dc...f5f7cb92646169a7096360506cef79a7a45571fa,3,42,1,43,7,2010-07-21 18:33:35,2010-07-20 12:46:27
f5f7cb92646169a7096360506cef79a7a45571fa...07ab34cd582cf0bf75794c6b064cf70a44c8df6b,1,3,0,3,1,2010-07-21 18:44:47,2010-07-21 18:44:47
07ab34cd582cf0bf75794c6b064cf70a44c8df6b...e4eeaa7fbcce054e372633cd3724c530e26e5a54,62,2154,666,2820,329,2010-07-21 19:31:46,2010-07-21 19:31:43
e4eeaa7fbcce054e372633cd3724c530e26e5a54...cb97cdb256823433ca571f34f2fdd1a0063e4ef8,1,0,1,1,1,2010-07-21 19:43:19,2010-07-21 19:43:19
cb97cdb256823433ca571f34f2fdd1a0063e4ef8...e0d6f14b221423be41d5821993316d70e3e4e709,2,68,39,107,11,2010-07-23 16:08:30,2010-07-23 00:20:02
e0d6f14b221423be41d5821993316d70e3e4e709...f0f247d7e5bd9368fd4cb8e46dbd3882465086ff,3,5,6,11,3,2010-07-23 16:08:49,2010-07-23 07:41:28
f0f247d7e5bd9368fd4cb8e46dbd3882465086ff...138593b156c20b17429aeb1ab3f1da2c3b5b7892,1,1,1,2,1,2010-07-23 19:14:51,2010-07-23 19:14:51
138593b156c20b17429aeb1ab3f1da2c3b5b7892...528015e0d84063891f7fbbc7d5bde3a2a38d8b0d,4,95,0,95,5,2010-07-23 20:52:44,2010-07-23 20:52:44
528015e0d84063891f7fbbc7d5bde3a2a38d8b0d...2c1ca4078d12ea62745d0f3f72c0909befe86399,4,105,0,105,6,2010-07-23 23:36:52,2010-07-23 23:36:47
2c1ca4078d12ea62745d0f3f72c0909befe86399...a585c5bbb3fd02602f947890a78aee9a78439308,1,3,4,7,3,2010-07-26 03:14:12,2010-07-22 11:26:55
a585c5bbb3fd02602f947890a78aee9a78439308...8ab3c3e7c382bb9ee56423b5a9fa8e3fe9e09989,2,29,28,57,9,2010-07-26 03:16:37,2010-07-22 11:51:26
8ab3c3e7c382bb9ee56423b5a9fa8e3fe9e09989...402bcb83bc9455e066ec47a2dae7a21219b1e040,1,2,0,2,1,2010-07-26 06:21:39,2010-07-26 06:21:39
402bcb83bc9455e066ec47a2dae7a21219b1e040...2a4568c85f33869c75ff43ccd30f0ec188b43eab,5,32,5,37,5,2010-07-26 06:39:58,2010-07-26 06:39:58
2a4568c85f33869c75ff43ccd30f0ec188b43eab...6fdb874e2e9aa335eca2c6aacfb598f0c945575e,1,2,3,5,2,2010-07-26 17:35:45,2010-07-26 17:35:45
6fdb874e2e9aa335eca2c6aacfb598f0c945575e...66deea10c7bca2fe9c6b82495d141f0faf227216,1,6,0,6,1,2010-07-26 17:59:34,2010-07-26 06:38:37
66deea10c7bca2fe9c6b82495d141f0faf227216...28db0c2562ae7395dd01a034294fcda67fb9be71,1,1,0,1,1,2010-07-26 19:42:59,2010-07-26 19:42:59
28db0c2562ae7395dd01a034294fcda67fb9be71...eeb54c63d85ed4a03cab2539aae5753d7d3aa68a,1,5,17,22,6,2010-07-26 20:13:49,2010-07-17 15:45:47
eeb54c63d85ed4a03cab2539aae5753d7d3aa68a...93cb09642df30fc11e627a2ca6513e35a20f97a4,1,1,3,4,1,2010-07-26 20:14:10,2010-07-23 20:20:18
93cb09642df30fc11e627a2ca6513e35a20f97a4...eeaf1ef970a09cf8f77cff438fa7bcc004798295,1,4,4,8,1,2010-07-26 20:14:39,2010-07-24 13:29:11
eeaf1ef970a09cf8f77cff438fa7bcc004798295...552cf28260af30e63ba4e67d0f6032ee96dfe3b5,25,1450,643,2093,298,2010-07-26 21:26:42,2010-07-26 21:26:42
552cf28260af30e63ba4e67d0f6032ee96dfe3b5...23cf556c6ca1ec5c6d4e4f39d9b7c395b72961f3,3,46,11,57,11,2010-07-26 22:02:20,2010-07-26 22:01:54
23cf556c6ca1ec5c6d4e4f39d9b7c395b72961f3...f7c53341953c5029ed4b7366e98992dc089c6620,2,6,6,12,5,2010-07-27 02:02:15,2010-07-27 01:38:49
f7c53341953c5029ed4b7366e98992dc089c6620...d489555553fe2f41c827465adfc89519618b20fd,1,3,1,4,2,2010-07-27 02:07:31,2010-07-27 02:07:31
d489555553fe2f41c827465adfc89519618b20fd...b3c0359b567c92f130a5eb70db47c25c1d840fed,1,1,1,2,1,2010-07-27 02:08:21,2010-07-27 02:08:21
b3c0359b567c92f130a5eb70db47c25c1d840fed...5459e5c60622e45447abc291bcea8273096f710e,2,49,55,104,29,2010-07-27 17:58:45,2010-07-27 17:58:45
5459e5c60622e45447abc291bcea8273096f710e...8052dd0022b9a641fdd0096d51791e06b37d64f9,1,15,13,28,11,2010-07-27 19:16:48,2010-07-27 19:16:48
8052dd0022b9a641fdd0096d51791e06b37d64f9...505178d82bb6a6f4f92ddc0a9a5235d712b65f5f,1,5,1,6,1,2010-07-27 19:19:08,2010-07-27 19:19:08
505178d82bb6a6f4f92ddc0a9a5235d712b65f5f...b5b83b210bb9873cd6b5052e5f5d260eb1f9d2f9,1,1,0,1,1,2010-07-28 03:36:58,2010-07-28 03:36:58
b5b83b210bb9873cd6b5052e5f5d260eb1f9d2f9...95638c9b0d3a1133f944d9fcd65ae812dc914974,4,71,3,74,5,2010-07-28 18:37:23,2010-07-28 12:20:23
95638c9b0d3a1133f944d9fcd65ae812dc914974...f291fbc8a7668639126f1cfcb55841c527f042fd,2,20,14,34,13,2010-07-29 21:52:40,2010-07-29 21:48:07
f291fbc8a7668639126f1cfcb55841c527f042fd...cf49fc7bfe203eb585b1f4d2f2dc721950836966,1,1,1,2,1,2010-07-30 16:42:36,2010-07-30 16:42:36
cf49fc7bfe203eb585b1f4d2f2dc721950836966...f72ac17c89229428c4bed5c5267adb0e26d12565,2,53,79,132,7,2010-07-30 17:49:00,2010-07-30 12:01:03
f72ac17c89229428c4bed5c5267adb0e26d12565...c38dd24dc54d347cf200543c880b8befe9e7f04b,1,14,4,18,1,2010-07-30 17:54:43,2010-07-30 17:54:43
c38dd24dc54d347cf200543c880b8befe9e7f04b...b2a2bb736b01dfcd909d2c9087135bc6cb3e2e15,1,0,1,1,1,2010-07-30 19:20:32,2010-07-30 19:20:32
b2a2bb736b01dfcd909d2c9087135bc6cb3e2e15...e59b3f0eb3d1ac56b2953ac96e61985ceb7a9138,4,91,52,143,22,2010-07-31 21:32:59,2010-07-31 21:32:59
e59b3f0eb3d1ac56b2953ac96e61985ceb7a9138...dc8c079d904abc6d01357e70d72c9de7bacd7c1a,2,28,43,71,7,2010-08-02 03:04:31,2010-08-01 22:46:48
dc8c079d904abc6d01357e70d72c9de7bacd7c1a...65037eeb320f33b955923ff664f46b265e7bbccb,2,6,0,6,3,2010-08-02 03:20:17,2010-08-01 00:55:28
65037eeb320f33b955923ff664f46b265e7bbccb...71009ad3fe35af72af6694478405eaa3dc86ca35,1,1,1,2,1,2010-08-02 03:23:03,2010-08-01 00:13:47
71009ad3fe35af72af6694478405eaa3dc86ca35...3214116be6bd088a02d0447f57b0ba15038adce0,3,71,2,73,4,2010-08-02 05:34:17,2010-08-02 05:22:20
3214116be6bd088a02d0447f57b0ba15038adce0...d9fbb8a58071e339711e8c0ceeb31de5a645fd42,4,44,12,56,5,2010-08-02 07:46:09,2010-08-02 07:39:09
d9fbb8a58071e339711e8c0ceeb31de5a645fd42...4b19bd28967101b7afed3819cf595d4f04a1b11e,1,1,1,2,1,2010-08-02 18:25:53,2010-08-02 09:59:58
4b19bd28967101b7afed3819cf595d4f04a1b11e...a6bc68a83beda7609330e525a73b7b227a1b9207,48,1938,526,2464,233,2010-08-03 17:33:16,2010-08-03 17:33:16
a6bc68a83beda7609330e525a73b7b227a1b9207...e9aacd40c68e33bfeef24a396d63e42ccbb3b054,1,14,6,20,4,2010-08-04 01:11:43,2010-08-03 22:57:44
e9aacd40c68e33bfeef24a396d63e42ccbb3b054...1a1214866ff4d302833a0b7a0b56a9252aff9786,1,1,1,2,1,2010-08-04 16:58:56,2010-08-04 01:39:43
1a1214866ff4d302833a0b7a0b56a9252aff9786...31b59400f8527ea98b03ca23ae26f8d19e56c5f2,2,5,1,6,2,2010-08-04 17:20:40,2010-08-04 17:20:40
31b59400f8527ea98b03ca23ae26f8d19e56c5f2...adec544fddc87a8bb30f573b3ebc0af77349403e,4,12,44,56,5,2010-08-04 17:38:19,2010-08-04 17:38:19
adec544fddc87a8bb30f573b3ebc0af77349403e...24c6d26cca3c76f5c855a8584b753eba94e2ba3c,1,1,0,1,1,2010-08-04 17:54:02,2010-08-04 05:25:17
24c6d26cca3c76f5c855a8584b753eba94e2ba3c...7db5c8a10da7d864dc82a10867044346d11d9666,2,9,1,10,2,2010-08-04 18:38:48,2010-08-04 18:38:42
7db5c8a10da7d864dc82a10867044346d11d9666...81f5ed5c654c7b06e11563c36c79024265bcb7e7,10,224,27,251,27,2010-08-04 18:46:42,2010-08-04 18:46:42
81f5ed5c654c7b06e11563c36c79024265bcb7e7...0b925d075d359d03426f0b32bb58a5e05825b4ea,4,29,5,34,4,2010-08-04 19:04:12,2010-08-04 19:04:12
0b925d075d359d03426f0b32bb58a5e05825b4ea...78520ba4823f88aa17c4da9e5da00fc913269de9,3,50,28,78,12,2010-08-04 22:55:47,2010-08-04 20:45:52
78520ba4823f88aa17c4da9e5da00fc913269de9...0a3eff8021de38f11411369da3ea93bd9dbddd31,43,83,26,109,52,2010-08-04 23:03:08,2010-08-04 21:55:24
0a3eff8021de38f11411369da3ea93bd9dbddd31...a4906c7c83f8a1dce47963d39aa376ee6a87af19,1,7,3,10,3,2010-08-04 23:07:10,2010-08-04 23:07:10
a4906c7c83f8a1dce47963d39aa376ee6a87af19...6cd32fb62e28b1e530d050828fcf3e2f6b9aa07d,1,3,0,3,1,2010-08-04 23:50:59,2010-08-04 23:50:59
6cd32fb62e28b1e530d050828fcf3e2f6b9aa07d...ffbbc465d3af25f207ea36a14a98014e9ca27b1a,1,9,0,9,1,2010-08-05 17:23:17,2010-08-05 09:38:11
ffbbc465d3af25f207ea36a14a98014e9ca27b1a...fe3e4196872b8ea6e49be1dec2e7fff72432abda,2,4,0,4,2,2010-08-05 17:46:28,2010-08-05 07:13:40
fe3e4196872b8ea6e49be1dec2e7fff72432abda...e15221a8dee8383550cef15638f42c6fcf9ba0f8,1,5,1,6,2,2010-08-06 19:10:08,2010-08-05 17:15:22
e15221a8dee8383550cef15638f42c6fcf9ba0f8...a8e1e8d057a0127baa2e9d0069647e05841c863e,1,11,1,12,1,2010-08-06 19:11:04,2010-08-05 17:32:13
a8e1e8d057a0127baa2e9d0069647e05841c863e...e8795cea30436aad5b88b6885c60b543b35c4162,1,10,0,10,1,2010-08-06 19:15:04,2010-08-05 17:47:26
e8795cea30436aad5b88b6885c60b543b35c4162...d408de87fc2490c0e083ad438ac2cffbe8b56280,4,487,495,982,7,2010-08-06 19:34:02,2010-08-06 19:31:41
d408de87fc2490c0e083ad438ac2cffbe8b56280...94914135dfa5b536e4bb341b2c1e47fd2b9d74bc,8,168,22,190,22,2010-08-06 20:37:30,2010-08-05 02:15:20
94914135dfa5b536e4bb341b2c1e47fd2b9d74bc...aaa1f451e6392a530c3e32a64d8b6ad4fece988a,3,27,1,28,4,2010-08-06 20:38:41,2010-08-05 04:06:46
aaa1f451e6392a530c3e32a64d8b6ad4fece988a...e8c2453f6d5cbed581cc83d697a661135653418c,2,3,3,6,3,2010-08-06 21:48:38,2010-08-06 18:17:45
e8c2453f6d5cbed581cc83d697a661135653418c...7068912fbbe53c2f9bab6c6ab13bd6a6d31e2ede,1,1,0,1,1,2010-08-08 18:52:31,2010-08-08 18:52:31
7068912fbbe53c2f9bab6c6ab13bd6a6d31e2ede...cf5ae13f85063b907dd73719015529da3e5ada7a,1,0,1,1,1,2010-08-08 19:13:20,2010-08-08 19:13:20
cf5ae13f85063b907dd73719015529da3e5ada7a...5033da733ded0a38441ac57f24b9455a6cad8541,1,3,0,3,1,2010-08-08 20:37:51,2010-08-08 20:12:21
5033da733ded0a38441ac57f24b9455a6cad8541...3aa5cfde1052a7a027d398c66106869f7f722eee,1,7,11,18,8,2010-08-09 16:08:08,2010-08-07 14:11:59
3aa5cfde1052a7a027d398c66106869f7f722eee...e07f5682308dd48e840b6f8f3b3f52789d46e28e,1,1,0,1,1,2010-08-09 20:15:28,2010-08-09 00:40:54
e07f5682308dd48e840b6f8f3b3f52789d46e28e...f4f05a8851fdac46f359423ed88bcdd903d3e38a,1,8,5,13,6,2010-08-09 22:33:57,2010-08-09 22:33:57
f4f05a8851fdac46f359423ed88bcdd903d3e38a...7d4e8a9a7114d9477238e01703bb10129e5b4ba5,1,3,2,5,2,2010-08-09 22:37:14,2010-08-09 01:31:30
7d4e8a9a7114d9477238e01703bb10129e5b4ba5...1c5d5e0b72aefe6ca6b380d1b0a8c927e2e362e8,1,1,1,2,1,2010-08-10 04:23:52,2010-08-10 04:23:52
1c5d5e0b72aefe6ca6b380d1b0a8c927e2e362e8...a5be730906be67b3daf6650e84570ec60a9eac25,54,875,276,1151,174,2010-08-10 16:17:11,2010-08-10 16:17:11
a5be730906be67b3daf6650e84570ec60a9eac25...3d551e5538d98c7d049904c29124d168b2e4a6e4,1,1,0,1,1,2010-08-10 21:47:40,2010-08-10 21:47:40
3d551e5538d98c7d049904c29124d168b2e4a6e4...9395786d11b759bdefaa3ce0e6eb99582a5706fd,3,56,57,113,13,2010-08-11 00:48:37,2010-08-11 00:37:30
9395786d11b759bdefaa3ce0e6eb99582a5706fd...fd3cd755d15e37fd20aaadf22a30fc84a5cb737f,3,107,47,154,12,2010-08-11 00:53:32,2010-08-09 00:53:55
fd3cd755d15e37fd20aaadf22a30fc84a5cb737f...883b3e287385747f9e00a77676ff254fa49e6598,1,0,1,1,1,2010-08-11 07:23:12,2010-08-11 07:23:12
883b3e287385747f9e00a77676ff254fa49e6598...49888a01c34e9af51834e078ff7a8c7680f6b99a,1,99,0,99,1,2010-08-11 18:44:51,2010-08-11 16:27:41
49888a01c34e9af51834e078ff7a8c7680f6b99a...5185c15ef7473a02cb8d35237779a626156a797c,10,133,4,137,13,2010-08-11 19:39:42,2010-06-18 07:26:49
5185c15ef7473a02cb8d35237779a626156a797c...06634f48ebe64a3b21b45e16eefd59a50032dd0c,1,15,1,16,5,2010-08-11 20:15:00,2010-08-11 19:44:35
06634f48ebe64a3b21b45e16eefd59a50032dd0c...1c9a85b9a650d9566de699332e70b4c73c90e816,2,229,14,243,8,2010-08-11 20:42:45,2010-08-09 09:18:32
1c9a85b9a650d9566de699332e70b4c73c90e816...7059be19ecc90c0ad2d68b60672e84169b6990a2,15,322,295,617,77,2010-08-12 00:27:44,2010-08-11 23:38:42
7059be19ecc90c0ad2d68b60672e84169b6990a2...8d5e05668bf67e872a200a89c8414d2601c95520,2,97,0,97,6,2010-08-12 02:02:20,2010-08-11 21:03:56
8d5e05668bf67e872a200a89c8414d2601c95520...72e4a49cac61e9a721a1fdeda124f198301584e5,1,47,9,56,3,2010-08-12 07:07:26,2010-08-12 06:14:12
72e4a49cac61e9a721a1fdeda124f198301584e5...9acd76ed6e020fa540f64eabf4bdb33513795924,1,2,1,3,1,2010-08-12 17:06:52,2010-08-12 17:06:52
9acd76ed6e020fa540f64eabf4bdb33513795924...083ee0f8b7a8d98d51bf2debf47d68117f13087f,71,3528,2463,5991,464,2010-08-12 17:11:03,2010-08-12 17:11:03
083ee0f8b7a8d98d51bf2debf47d68117f13087f...758f12f34c23142d3fa63eb6d5d6d06b94885ccb,5,201,4,205,8,2010-08-12 23:23:41,2010-08-11 23:00:02
758f12f34c23142d3fa63eb6d5d6d06b94885ccb...cf909e8725f12fa2f6356727cdae3110dd388c18,1,18,4,22,3,2010-08-12 23:25:45,2010-08-12 16:51:23
cf909e8725f12fa2f6356727cdae3110dd388c18...d8642a8aa65dc7e69ecdab42743a545378621ca8,1,133,3,136,4,2010-08-13 14:01:32,2010-08-13 01:45:51
d8642a8aa65dc7e69ecdab42743a545378621ca8...0e8d858aba114c77b3fce96d052e2df162597ff2,1,8,6,14,2,2010-08-13 14:18:38,2010-08-13 03:23:41
0e8d858aba114c77b3fce96d052e2df162597ff2...4bbab1434635ada79b5a82a06872a15870213a52,71,2463,3528,5991,461,2010-08-13 14:43:53,2010-08-13 14:43:53
4bbab1434635ada79b5a82a06872a15870213a52...03123435e0c0730139aef147a6278fb068d2c364,1,0,2,2,2,2010-08-13 15:13:54,2010-08-13 15:13:54
03123435e0c0730139aef147a6278fb068d2c364...a8c2bb41af6aa164af6ce0fad5daff98c5228c33,5,102,94,196,23,2010-08-13 15:55:42,2010-08-13 15:54:40
a8c2bb41af6aa164af6ce0fad5daff98c5228c33...b14dd49222687c12f3e8eac597cff4f2674f84e8,4,19,5,24,4,2010-08-13 16:02:10,2010-08-13 15:06:31
b14dd49222687c12f3e8eac597cff4f2674f84e8...49cd211dffebbc265594da9fd01799891a226ebd,1,11,4,15,8,2010-08-14 05:29:38,2010-08-14 04:49:54
49cd211dffebbc265594da9fd01799891a226ebd...1b589be1d6f15baa26853b6566719bcb2b5cae27,1,0,1,1,1,2010-08-14 21:23:09,2010-08-14 21:23:09
1b589be1d6f15baa26853b6566719bcb2b5cae27...361759d179f6ac5c3dfbbb33f1f351347a1fcf9f,1,1,1,2,1,2010-08-15 18:05:48,2010-08-14 23:13:54
361759d179f6ac5c3dfbbb33f1f351347a1fcf9f...13a3bf5b7dc9390adb2ff0ca42271f9866a7223d,1,47,52,99,9,2010-08-15 18:06:36,2010-08-15 00:48:06
13a3bf5b7dc9390adb2ff0ca42271f9866a7223d...ff953dccf1c10aee37b26259c1e43aa78c95778a,1,15,21,36,3,2010-08-15 18:12:48,2010-08-15 17:23:50
ff953dccf1c10aee37b26259c1e43aa78c95778a...cde80d9859b57a5652085e700845582ea2f86d3a,1,5,0,5,1,2010-08-15 20:23:09,2010-07-18 08:52:09
cde80d9859b57a5652085e700845582ea2f86d3a...4593c049592d1dda6f61279887474bac132bb5ab,4,106,30,136,10,2010-08-15 21:01:55,2010-08-15 21:01:44
4593c049592d1dda6f61279887474bac132bb5ab...ae5d613b3e1253e23c6de54105053f4cf4a726aa,1,17,2,19,5,2010-08-15 21:27:05,2010-08-15 21:27:05
ae5d613b3e1253e23c6de54105053f4cf4a726aa...4db608dbbaa04ea359dfe8b4a2c2c40491e428a2,1,1,1,2,1,2010-08-16 22:17:17,2010-08-16 21:15:00
4db608dbbaa04ea359dfe8b4a2c2c40491e428a2...6744e59e461cc200a1c135c99450b2800c21b5e9,3,9,0,9,4,2010-08-17 06:57:01,2010-08-17 04:10:49
6744e59e461cc200a1c135c99450b2800c21b5e9...32e309440f1819d8c1e1ee0a91dc853b587da82d,3,4,4,8,4,2010-08-17 15:08:36,2010-08-17 10:59:36
32e309440f1819d8c1e1ee0a91dc853b587da82d...03dda31b7586e50ea8d9f3f0ca09026cf229e999,1,5,7,12,2,2010-08-17 15:15:46,2010-08-17 15:15:46
03dda31b7586e50ea8d9f3f0ca09026cf229e999...d4f4380f7ea04ee045fae1661242a5a7f2f1267a,1,1,0,1,1,2010-08-17 15:16:43,2010-08-17 15:16:43
d4f4380f7ea04ee045fae1661242a5a7f2f1267a...91757fa8400654b69de18e3840c402e369521b68,150,8072,6510,14582,963,2010-08-17 15:37:25,2010-08-17 15:37:25
91757fa8400654b69de18e3840c402e369521b68...1872719b8cad36dd8ea3add973ea58f638fc340c,1,1,1,2,1,2010-08-17 15:38:44,2010-08-17 13:38:57
1872719b8cad36dd8ea3add973ea58f638fc340c...cf2b206a8e410e677c890e941fa0bd1d7419b1a0,25,62,47,109,47,2010-08-17 15:41:05,2010-08-17 15:21:43
cf2b206a8e410e677c890e941fa0bd1d7419b1a0...41ad33910f56676ae13bf7ec184c3d5623f8a0e9,2,212,0,212,2,2010-08-17 15:43:26,2010-08-17 15:43:26
41ad33910f56676ae13bf7ec184c3d5623f8a0e9...39b432e42a2304f6abc8dca95a0845563f4c8ca0,1,13,0,13,2,2010-08-17 18:25:42,2010-08-17 18:24:10
39b432e42a2304f6abc8dca95a0845563f4c8ca0...925333385053f7a6a21dfa7b8ec5664392db4020,2,20,19,39,9,2010-08-18 18:46:37,2010-08-17 20:19:19
925333385053f7a6a21dfa7b8ec5664392db4020...5dc2b9331149436b9331deb890bbd2deb6dfe0e5,1,1,2,3,1,2010-08-18 18:47:43,2010-08-17 20:49:43
5dc2b9331149436b9331deb890bbd2deb6dfe0e5...2b126da395142f6ffad7ce1c6349056a707d86b4,5,74,0,74,5,2010-08-18 19:08:39,2010-08-18 15:47:36
2b126da395142f6ffad7ce1c6349056a707d86b4...5bce8ed11862048e317e18031f2d64599323564a,2,6,8,14,4,2010-08-18 20:16:32,2010-08-18 20:16:32
5bce8ed11862048e317e18031f2d64599323564a...28b21d15c3f5aee09041c4f5f888aba6dd83864e,1,4,4,8,2,2010-08-18 21:06:30,2010-08-17 20:59:14
28b21d15c3f5aee09041c4f5f888aba6dd83864e...0906f945bea1fb75824127f4c5209aa9ad927460,1,1,1,2,1,2010-08-19 05:50:16,2010-08-19 05:50:12
0906f945bea1fb75824127f4c5209aa9ad927460...c5eb1b55d9e329d477b9b9ba9b24d681c287491c,1,2,2,4,3,2010-08-19 05:50:55,2010-08-18 23:37:45
c5eb1b55d9e329d477b9b9ba9b24d681c287491c...2134982ea4d6262e96bcf2430dd79031d96ebf33,1,2,3,5,2,2010-08-19 05:59:35,2010-08-12 16:50:12
2134982ea4d6262e96bcf2430dd79031d96ebf33...5c1ffa165f67a2bb0fc726e4b7402249b7a895ab,1,72,1,73,4,2010-08-19 05:59:49,2010-08-17 15:39:54
5c1ffa165f67a2bb0fc726e4b7402249b7a895ab...1aeaf8d2890a7b82e1ff598483a86615cd76227b,1,26,3,29,4,2010-08-19 06:02:30,2010-08-17 23:53:27
1aeaf8d2890a7b82e1ff598483a86615cd76227b...293809b8b61d579a7a03fce562d11421a887019b,1,0,2,2,1,2010-08-19 06:02:54,2010-08-18 04:04:56
293809b8b61d579a7a03fce562d11421a887019b...12a169e8ff4036e160dbdc605eb9f15eae933b47,2,12,0,12,2,2010-08-19 08:40:28,2010-08-19 08:40:28
12a169e8ff4036e160dbdc605eb9f15eae933b47...60b93cca6da77222ca9082e54ba8acad547d9d94,1,47,35,82,16,2010-08-20 01:49:27,2010-08-20 01:49:27
60b93cca6da77222ca9082e54ba8acad547d9d94...81a53e83ab4815d84f065b8fd6c356931a48c695,1,5,2,7,2,2010-08-20 02:19:18,2010-08-20 01:58:28
81a53e83ab4815d84f065b8fd6c356931a48c695...0c20c588af8eeebdbf21b703934563f5c91c48dd,1,1,2,3,1,2010-08-20 02:25:00,2010-08-20 02:24:45
0c20c588af8eeebdbf21b703934563f5c91c48dd...51ecba8da9c8c9d974be9c01370c1bdd37031b1f,1,9,1,10,1,2010-08-20 06:29:06,2010-08-20 06:29:06
51ecba8da9c8c9d974be9c01370c1bdd37031b1f...9283e134e558900ba89d9a33c18a9bdedab07cb9,5,28,5,33,5,2010-08-20 08:53:08,2010-08-20 08:52:58
9283e134e558900ba89d9a33c18a9bdedab07cb9...4fcbc1b64a0c4caa6c7fb9edfc30005a7bc2463c,1,1,1,2,1,2010-08-20 09:00:37,2010-08-20 09:00:37
4fcbc1b64a0c4caa6c7fb9edfc30005a7bc2463c...7fc794a8ec55bd9d137c48884043e76e8face916,1,5,7,12,4,2010-08-20 15:49:20,2010-08-20 15:49:20
7fc794a8ec55bd9d137c48884043e76e8face916...33e919ae6f365c81f345f70e2fdb406a2268756a,1,43,0,43,1,2010-08-21 07:30:18,2010-08-21 07:30:18
33e919ae6f365c81f345f70e2fdb406a2268756a...488aff085b9d7b05593771ad2ef37463fce37f84,5,38,19,57,19,2010-08-21 08:24:14,2010-08-21 08:19:39
488aff085b9d7b05593771ad2ef37463fce37f84...2982e75a0b98a0c6707db2f0f6e7ed740b78a6be,2,108,20,128,3,2010-08-21 23:34:38,2010-08-21 23:34:38
2982e75a0b98a0c6707db2f0f6e7ed740b78a6be...a834d93d2ccc1be51d6f5a658ad5f5fd60d3d6f7,1,3,3,6,3,2010-08-22 19:31:58,2010-08-21 21:26:42
a834d93d2ccc1be51d6f5a658ad5f5fd60d3d6f7...bedca2e7a9714ad97bc12e1228ff08075fd25556,1,17,0,17,1,2010-08-22 19:34:00,2010-08-17 17:07:45
bedca2e7a9714ad97bc12e1228ff08075fd25556...0e1e00e68b8e530e592a2d851f32e587644f9904,1,2,2,4,2,2010-08-22 19:34:58,2010-08-20 11:16:42
0e1e00e68b8e530e592a2d851f32e587644f9904...8ec21059dd65765607a55151e40983a283715831,1,6,6,12,4,2010-08-22 20:10:18,2010-08-22 05:36:33
8ec21059dd65765607a55151e40983a283715831...e55c4868013adee90dba5a02a09d66770badc250,1,1,1,2,1,2010-08-22 20:45:39,2010-08-22 20:37:08
e55c4868013adee90dba5a02a09d66770badc250...072750e66293e378549c555ab8564fb59adb2cd3,1,5,1,6,2,2010-08-23 03:25:06,2010-08-23 03:18:25
072750e66293e378549c555ab8564fb59adb2cd3...c209e57e502514e92e3d8fafcd07901f81305aa1,1,6,0,6,1,2010-08-23 08:44:44,2010-08-23 08:26:19
c209e57e502514e92e3d8fafcd07901f81305aa1...fd3e84499e9848aa4bd644049b322ef40ef5ffb6,2,49,2,51,3,2010-08-23 08:46:14,2010-08-22 03:55:34
fd3e84499e9848aa4bd644049b322ef40ef5ffb6...748469c71c9a0860aada8b0d130aa181df13e370,2,77,11,88,8,2010-08-23 08:47:41,2010-08-22 05:50:40
748469c71c9a0860aada8b0d130aa181df13e370...6078c37be5caf15827a0d08aa4c0028648a2c9a6,1,5,2,7,1,2010-08-23 09:42:25,2010-08-23 06:55:22
6078c37be5caf15827a0d08aa4c0028648a2c9a6...d9eb64928ec779fa6937a7fb196611ad7756a17c,1,4,2,6,2,2010-08-23 16:18:36,2010-08-23 12:15:16
d9eb64928ec779fa6937a7fb196611ad7756a17c...51224f12ca9aa145d9ca5eb03f5cbfbb1d43f164,1,8,0,8,2,2010-08-23 17:25:55,2010-08-23 17:21:27
51224f12ca9aa145d9ca5eb03f5cbfbb1d43f164...e8b3751743a8d7c206fef8c2fa1f1085527f1ab9,1,6,5,11,1,2010-08-27 13:20:20,2010-08-27 13:20:18
e8b3751743a8d7c206fef8c2fa1f1085527f1ab9...44a287987e5eb791dc1092002a35f712d3451b95,2,3,1,4,3,2010-08-27 20:58:52,2010-08-27 20:58:52
44a287987e5eb791dc1092002a35f712d3451b95...f86ad1693f5fd21cb645bbe6672a30bcb83229e1,2,11,1,12,2,2010-08-27 22:23:51,2010-08-27 22:23:39
f86ad1693f5fd21cb645bbe6672a30bcb83229e1...4fdebab005a4c52310f310110a33a5884ee1b86c,2,6,3,9,5,2010-08-27 22:38:46,2010-08-27 22:38:46
4fdebab005a4c52310f310110a33a5884ee1b86c...57642e23497d5698aa4c5b8a44edff7b265c2283,2,51,2,53,3,2010-08-28 05:13:50,2010-08-27 08:50:12
57642e23497d5698aa4c5b8a44edff7b265c2283...37b6e106847b32bf0baf64825f5783498c3dfe10,3,60,2,62,3,2010-08-30 17:23:48,2010-08-23 20:12:57
37b6e106847b32bf0baf64825f5783498c3dfe10...e49be4768be8c84daca6c98a1aa344bc5065590e,2,35,2,37,3,2010-08-30 17:26:51,2010-08-25 08:18:24
e49be4768be8c84daca6c98a1aa344bc5065590e...635986e4338cf34cf8e1abc4343ffd69d109bb4e,1,11,0,11,1,2010-08-30 19:02:22,2010-08-30 19:02:01
635986e4338cf34cf8e1abc4343ffd69d109bb4e...db23af05b04442b7d910c535900a9f78a2983b56,1,2,1,3,1,2010-08-30 19:13:41,2010-08-30 09:04:31
db23af05b04442b7d910c535900a9f78a2983b56...d5214b3627fb317349736757263c86804a057149,1,13,13,26,7,2010-08-30 20:27:38,2010-08-30 20:26:53
d5214b3627fb317349736757263c86804a057149...9c7c6e93e1c11be8ed1d1a123d64d6499767b361,2,10,2,12,2,2010-08-30 20:58:50,2010-08-25 03:46:37
9c7c6e93e1c11be8ed1d1a123d64d6499767b361...af9aa93e0ccb7f91a2aab8950868cf0a62f9bb2e,2,5,1,6,2,2010-08-30 21:08:18,2010-08-25 04:36:08
af9aa93e0ccb7f91a2aab8950868cf0a62f9bb2e...f188b9d6d77d51e8023853d4828b07b0cac3f24e,1,3,16,19,4,2010-08-30 21:15:30,2010-08-30 21:15:28
f188b9d6d77d51e8023853d4828b07b0cac3f24e...a055153cdac2398e6eb536e3678639020914561a,1,19,14,33,11,2010-08-30 21:17:27,2010-08-30 21:17:27
a055153cdac2398e6eb536e3678639020914561a...5be6ab6cdbce6f45873945e8b2c6337c095c3efc,1,3,6,9,3,2010-08-30 23:35:58,2010-08-30 23:35:58
5be6ab6cdbce6f45873945e8b2c6337c095c3efc...7347fb3e2c445222598646262cec262f9dacee91,2,8,1,9,3,2010-08-31 23:45:17,2010-08-31 23:45:17
7347fb3e2c445222598646262cec262f9dacee91...0e311717b5bbec7f3fbf0b06592bfa19cc11becc,2,16,7,23,4,2010-09-02 16:24:21,2010-09-01 00:59:50
0e311717b5bbec7f3fbf0b06592bfa19cc11becc...cda1a384260886b5cf84056885dfc9169441248e,2,7,9,16,5,2010-09-02 16:24:39,2010-09-01 11:01:38
cda1a384260886b5cf84056885dfc9169441248e...3c00ec4e484da4b607f65fc56f997fe929254bc1,1,1,1,2,1,2010-09-05 09:27:02,2010-09-05 09:27:02
3c00ec4e484da4b607f65fc56f997fe929254bc1...1be722a2712e9959c204824604df3ab69612cbb0,1,9,0,9,1,2010-09-08 00:14:04,2010-09-07 23:28:49
1be722a2712e9959c204824604df3ab69612cbb0...4fe5e86a7ece2ebabb7fb7bd8877f57dd42517b9,1,2,2,4,2,2010-09-08 00:16:24,2010-09-06 19:12:36
4fe5e86a7ece2ebabb7fb7bd8877f57dd42517b9...1d0fb850d96c74c2edf6f01fe0a2875a8f799051,1,2,2,4,2,2010-09-08 00:17:12,2010-09-06 19:18:46
1d0fb850d96c74c2edf6f01fe0a2875a8f799051...cf4b5fc52a5614e341f6e0cb3988fda6e88170e9,1,17,0,17,1,2010-09-08 05:37:14,2010-09-08 05:34:21
cf4b5fc52a5614e341f6e0cb3988fda6e88170e9...5330fea954010addfd91fe3ac20bd391a11c90a0,1,11,0,11,1,2010-09-08 16:45:57,2010-09-04 04:53:53
5330fea954010addfd91fe3ac20bd391a11c90a0...1d961a66309f1ab649fbb54f9badaf53100c6020,3,77,26,103,25,2010-09-08 16:47:13,2010-09-04 04:25:35
1d961a66309f1ab649fbb54f9badaf53100c6020...24ac87f5437e067e01fc10d71ba4ee58f9ca1994,1,2,2,4,2,2010-09-08 17:14:04,2010-09-08 17:14:04
24ac87f5437e067e01fc10d71ba4ee58f9ca1994...8718fa54f60883245903392bff56326d9f1d19ac,1,0,11,11,1,2010-09-08 17:34:47,2010-08-20 13:32:22
8718fa54f60883245903392bff56326d9f1d19ac...2a03d5802b4cf58787417e50946ce270beebaa31,3,0,52,52,3,2010-09-08 17:36:45,2010-08-22 00:00:50
2a03d5802b4cf58787417e50946ce270beebaa31...6789ab16d8a7507791a918b699cb4a4d2b8653a3,2,2,4,6,2,2010-09-08 17:37:26,2010-08-20 15:15:37
6789ab16d8a7507791a918b699cb4a4d2b8653a3...71651bf8b240c985129f16545ded0bd14f6cee93,2,3,0,3,3,2010-09-08 17:40:55,2010-08-20 16:59:33
71651bf8b240c985129f16545ded0bd14f6cee93...75f922c863a9823e676192641241b1203c286405,1,2,0,2,2,2010-09-08 18:50:56,2010-09-08 11:15:05
75f922c863a9823e676192641241b1203c286405...f5e40470643d8cc97ad4aa85fbca4b2805cc0481,2,34,12,46,4,2010-09-08 18:51:29,2010-09-08 11:19:25
f5e40470643d8cc97ad4aa85fbca4b2805cc0481...ccf4afa256fc26838a1386b364f415776a47ef4e,2,15,1,16,3,2010-09-08 18:58:54,2010-09-08 12:28:31
ccf4afa256fc26838a1386b364f415776a47ef4e...0e501f4ec51602f14eb397b3c1bd29435cf65aad,1,8,6,14,3,2010-09-08 19:03:33,2010-09-08 19:03:33
0e501f4ec51602f14eb397b3c1bd29435cf65aad...512016fd7441d8919c29f369a38622ab1dd01942,1,14,0,14,1,2010-09-08 19:09:13,2010-09-08 19:09:13
512016fd7441d8919c29f369a38622ab1dd01942...8796ed22783bbbb9d286463e27db275325106fed,206,24637,25568,50205,2187,2010-09-09 00:14:42,2010-09-09 00:14:42
8796ed22783bbbb9d286463e27db275325106fed...9a6d2c35a1e71bbbe98224ef9f749bfa76eea5c7,7,1832,3,1835,9,2010-09-09 00:16:18,2010-09-09 00:16:18
9a6d2c35a1e71bbbe98224ef9f749bfa76eea5c7...ba0c32e2e1aa873728a54df12a3785091f475143,2,119,120,239,14,2010-09-09 00:35:58,2010-09-09 00:25:59
ba0c32e2e1aa873728a54df12a3785091f475143...17f3ffa6331c484206c9eeb7e704a21d8c67c90c,2,32,11,43,7,2010-09-09 17:30:43,2010-09-09 17:30:37
17f3ffa6331c484206c9eeb7e704a21d8c67c90c...ef54777fa5982da85dfb5e8ec4f2eaa36714e344,3,20,5,25,8,2010-09-09 17:47:30,2010-09-07 14:38:43
ef54777fa5982da85dfb5e8ec4f2eaa36714e344...746d487da86048d09574cd40c6a76bc489d19ca9,3,179,2,181,4,2010-09-09 18:03:47,2010-08-21 06:28:00
746d487da86048d09574cd40c6a76bc489d19ca9...2b07c9fcaee0f9cc42127434d5692b608b81bf82,1,27,28,55,25,2010-09-09 18:03:47,2010-08-21 11:18:15
2b07c9fcaee0f9cc42127434d5692b608b81bf82...b87669cbf48c544ab98e5d79c722d320bedbf003,1,21,17,38,21,2010-09-09 18:03:48,2010-09-04 20:48:04
b87669cbf48c544ab98e5d79c722d320bedbf003...565d862f3c6d16364356685364322b2df5b82b4d,2,0,16,16,2,2010-09-09 18:03:48,2010-09-04 20:56:27
565d862f3c6d16364356685364322b2df5b82b4d...2dda6be7991fc6809eedca4dc51935a178c63745,1,4,0,4,1,2010-09-09 18:03:48,2010-09-05 03:58:51
2dda6be7991fc6809eedca4dc51935a178c63745...1cf538a60a5306a554d3cfad412003578a96d5e5,4,114,51,165,45,2010-09-09 18:03:48,2010-09-05 03:59:24
1cf538a60a5306a554d3cfad412003578a96d5e5...6ea99721f12c6dcce4e7f1ca5d5dfcba20891a74,1,7,3,10,4,2010-09-09 18:03:48,2010-09-05 13:12:35
6ea99721f12c6dcce4e7f1ca5d5dfcba20891a74...d5bdda74c160d844f9c9d299b8a96efd8f6212ac,3,48,16,64,16,2010-09-09 18:03:48,2010-09-05 18:10:59
d5bdda74c160d844f9c9d299b8a96efd8f6212ac...7b772f3f68d083c387274397d19576fa4b68e0f5,3,103,130,233,35,2010-09-09 18:03:48,2010-09-05 20:30:30
7b772f3f68d083c387274397d19576fa4b68e0f5...1f947f7b417fcc442cf2afecae69b17452cd7a7c,1,4,4,8,4,2010-09-09 18:03:49,2010-09-06 03:49:20
1f947f7b417fcc442cf2afecae69b17452cd7a7c...ececd92f62782af3ec82fe7f9132f971d173905f,1,1,1,2,1,2010-09-09 18:03:49,2010-09-06 04:09:33
ececd92f62782af3ec82fe7f9132f971d173905f...5506f99dfaba02fdc2f389ad3c1ebea19dca12dd,1,14,4,18,6,2010-09-09 18:03:49,2010-09-06 10:07:32
5506f99dfaba02fdc2f389ad3c1ebea19dca12dd...5f935f6c14a480a2958c9619955efc9a2ce2cae5,1,34,21,55,19,2010-09-09 18:03:49,2010-09-06 19:10:33
5f935f6c14a480a2958c9619955efc9a2ce2cae5...5da4faf8c7b6b3bcb3579cd69b78fd2d92b2e479,1,55,29,84,22,2010-09-09 18:03:49,2010-09-06 19:16:47
5da4faf8c7b6b3bcb3579cd69b78fd2d92b2e479...8b4f1e05f92867699554bc828bb291ac294bedc9,1,9,10,19,3,2010-09-09 18:03:50,2010-09-06 19:50:13
8b4f1e05f92867699554bc828bb291ac294bedc9...6135941eeaa86733d73ecefe9df3a4b82490eff7,1,18,29,47,5,2010-09-09 18:03:50,2010-09-06 20:35:32
6135941eeaa86733d73ecefe9df3a4b82490eff7...d3fcd1c75ac63022a875918b6990e42b65260177,1,1,0,1,1,2010-09-09 18:03:50,2010-09-07 22:20:26
d3fcd1c75ac63022a875918b6990e42b65260177...17ba821e6093c0d36d2117cab41b0a860bfaa805,1,7,19,26,3,2010-09-09 18:03:50,2010-09-07 23:29:53
17ba821e6093c0d36d2117cab41b0a860bfaa805...ff027d571bdf4e006717747089aa4015d9bbd9ed,4,55,3,58,5,2010-09-09 18:03:50,2010-09-07 23:30:17
ff027d571bdf4e006717747089aa4015d9bbd9ed...8078ed1f865a2f8ed5d34e156ff0ac4e43ca8f20,1,16,0,16,1,2010-09-09 18:03:50,2010-09-08 04:40:15
8078ed1f865a2f8ed5d34e156ff0ac4e43ca8f20...3e9f636b648e334d7d25fa848f89df024ed563b6,2,17,17,34,14,2010-09-09 18:03:50,2010-09-08 05:00:16
3e9f636b648e334d7d25fa848f89df024ed563b6...ba2e4a23060e56e0bed95ccc1d2c877a83a77f70,1,9,12,21,4,2010-09-09 18:03:50,2010-09-08 05:36:41
ba2e4a23060e56e0bed95ccc1d2c877a83a77f70...71d67dbf48050c1f459946e978c431ff979ff1a5,1,0,20,20,1,2010-09-09 18:03:50,2010-09-08 05:52:09
71d67dbf48050c1f459946e978c431ff979ff1a5...efc723787a05b337a09e14f8b95e6ee1ce2e446e,2,7,7,14,4,2010-09-09 18:03:50,2010-09-08 06:04:27
efc723787a05b337a09e14f8b95e6ee1ce2e446e...380d12832c3ea333454f95425d560ecedccae079,1,0,34,34,1,2010-09-09 18:03:50,2010-09-08 06:31:04
380d12832c3ea333454f95425d560ecedccae079...5bc4efe8207b21a5884f62597af2dc4ff564a8d7,3,25,114,139,16,2010-09-09 18:03:51,2010-09-08 06:48:42
5bc4efe8207b21a5884f62597af2dc4ff564a8d7...b8bfbdab48d5ea08dd0f42cdb1a02f8b07490247,2,3,3,6,3,2010-09-09 18:03:51,2010-09-08 06:52:40
98683d285c7130076e4716943dcfd133823b4702...5d42cc3a44f87e401edcff11971b10dfd2180f3c,1,2,3,5,2,2010-09-09 22:47:37,2010-09-09 22:47:37
5d42cc3a44f87e401edcff11971b10dfd2180f3c...f870240dcf3589aadad40bd90f63bbe885bc22af,2,27,0,27,2,2010-09-09 22:51:17,2010-09-09 18:36:51
f870240dcf3589aadad40bd90f63bbe885bc22af...7628905a9b9bb775cbcea91c1f6521bbd37549e7,2,1,1,2,1,2010-09-09 23:22:57,2010-09-09 23:22:57
7628905a9b9bb775cbcea91c1f6521bbd37549e7...85fb47c11cc985889be9c1a802cfc0331d8ad7a8,5,31,11,42,10,2010-09-09 23:43:18,2010-09-09 01:42:32
85fb47c11cc985889be9c1a802cfc0331d8ad7a8...3a9570386a1cae3f9c787899f297bfd3816c905d,2,12,1,13,3,2010-09-10 01:49:28,2010-09-10 01:49:28
3a9570386a1cae3f9c787899f297bfd3816c905d...9a701b0a7031619853fb09da2b5bea190363075b,3,32,4,36,7,2010-09-10 06:35:17,2010-09-10 06:27:17
9a701b0a7031619853fb09da2b5bea190363075b...678fa311368a4e3112415f3f74dc8e1e1f5a419d,1,4,0,4,1,2010-09-12 03:40:46,2010-09-12 03:40:46
678fa311368a4e3112415f3f74dc8e1e1f5a419d...0ef8a86af24be8e209a7b6747bde358bb878272e,1,9,3,12,2,2010-09-13 04:23:53,2010-09-13 04:23:53
0ef8a86af24be8e209a7b6747bde358bb878272e...2d09ef854118692eefd6f04dbd8354811f8a78be,1,74,53,127,9,2010-09-13 04:47:56,2010-09-13 04:47:56
2d09ef854118692eefd6f04dbd8354811f8a78be...aef0d8086b233f97535841c9ea91f7139f8fc3bb,1,10,3,13,2,2010-09-13 04:58:18,2010-09-13 04:58:06
aef0d8086b233f97535841c9ea91f7139f8fc3bb...efdd73c8e4d7ad78cb497accc3be41e606a17f7c,1,10,8,18,9,2010-09-13 18:40:04,2010-09-13 18:40:04
efdd73c8e4d7ad78cb497accc3be41e606a17f7c...5c9b9c2e7092c8f77ea297050a2954ba517d68ed,1,2,0,2,1,2010-09-13 18:50:06,2010-09-11 04:37:43
5c9b9c2e7092c8f77ea297050a2954ba517d68ed...debf3894906e5b52f16c066e81679997538a55e2,6,33,6,39,7,2010-09-13 19:04:31,2010-09-11 07:44:29
debf3894906e5b52f16c066e81679997538a55e2...422d3c93bc7391e105cfb4363011088c27ec86a6,3,66,127,193,25,2010-09-13 19:39:30,2010-09-13 18:54:30
422d3c93bc7391e105cfb4363011088c27ec86a6...61448bfc4e0714dbee6744a10e01bc6c4535c406,3,133,36,169,28,2010-09-13 22:40:20,2010-09-13 22:40:20
61448bfc4e0714dbee6744a10e01bc6c4535c406...b8d63c10cd2e4210c5c43f146537eb24c00a0bf5,9,8179,6386,14565,817,2011-01-11 22:09:17,2011-01-11 22:09:17
61448bfc4e0714dbee6744a10e01bc6c4535c406...686d9f9cc6688b4febf8ebc4655c1d1bc3515829,2,55,3,58,4,2010-09-14 17:27:57,2010-09-14 16:23:48
686d9f9cc6688b4febf8ebc4655c1d1bc3515829...83ff473d30c45baa2c975793a7ffee06f19e0b3b,1,2,1,3,2,2010-09-14 17:29:56,2010-09-14 17:29:56
83ff473d30c45baa2c975793a7ffee06f19e0b3b...4fe3007a1ae4c35e18d297af3151eb51d0458859,3,118,2,120,6,2010-09-14 22:20:45,2010-09-09 06:29:35
4fe3007a1ae4c35e18d297af3151eb51d0458859...77fc61d5395a4cf0aa2c15e24d2a43d3708dbb58,3,10,7,17,3,2010-09-14 22:39:27,2010-09-14 22:39:27
77fc61d5395a4cf0aa2c15e24d2a43d3708dbb58...feea1330cc3858a5aa65f2072a6025cb5ca0cd56,2,34,2,36,2,2010-09-15 06:03:29,2010-09-15 06:02:48
feea1330cc3858a5aa65f2072a6025cb5ca0cd56...ae8f8e7258bb9db0bc6928e9dc1cd535d95a7910,1,1,1,2,1,2010-09-15 22:20:04,2010-09-15 22:20:04
ae8f8e7258bb9db0bc6928e9dc1cd535d95a7910...6bdc42cee7e7aa6884e0b91277ee038d755afb4c,1,9,9,18,7,2010-09-15 22:47:28,2010-09-15 22:47:28
6bdc42cee7e7aa6884e0b91277ee038d755afb4c...6560ab9073f5b23c467dd0662c4cd236685564ed,2,37,18,55,7,2010-09-15 22:55:30,2010-09-15 14:52:23
6560ab9073f5b23c467dd0662c4cd236685564ed...f47ad10db7ad69aa2bc4ab0d4bdb0b3ac805692b,2,0,10,10,2,2010-09-15 23:18:54,2010-09-15 23:17:11
f47ad10db7ad69aa2bc4ab0d4bdb0b3ac805692b...bcad5403d6031260c606180dae0c4f0810400466,1,42,48,90,14,2010-09-16 00:30:34,2010-09-15 22:16:57
bcad5403d6031260c606180dae0c4f0810400466...6abbfa09ff7a1b2d8ad7319892dd8597def04a1a,1,1,1,2,1,2010-09-16 20:44:16,2010-09-16 11:53:45
6abbfa09ff7a1b2d8ad7319892dd8597def04a1a...d429033fd721e7463a20198ea76f2141d3f9bd9a,1,211,210,421,2,2010-09-16 20:45:43,2010-09-16 12:04:37
d429033fd721e7463a20198ea76f2141d3f9bd9a...4e6b9b0992784784fe3f8a348814409a1667e3fe,1,1,6,7,2,2010-09-16 20:46:27,2010-09-16 12:30:08
4e6b9b0992784784fe3f8a348814409a1667e3fe...3e0a8f3ad8804b3d86fde0b0df572fd084ae7b91,1,7,9,16,6,2010-09-16 20:47:43,2010-09-16 11:08:09
3e0a8f3ad8804b3d86fde0b0df572fd084ae7b91...f08985c193a7b55e4c82a1681290fb10a9e8471e,1,17,3,20,4,2010-09-16 21:40:41,2010-09-16 21:40:41
f08985c193a7b55e4c82a1681290fb10a9e8471e...a63fd0fe560055428bc2edb8ee7af2ffe61cd7bd,1,1,52,53,5,2010-09-16 21:49:12,2010-09-16 21:49:12
a63fd0fe560055428bc2edb8ee7af2ffe61cd7bd...251d03197f05cc17ea35f811803f9acbfb30d016,2,2,22,24,4,2010-09-16 22:02:12,2010-09-16 21:59:55
251d03197f05cc17ea35f811803f9acbfb30d016...c8f9728de7510a539b4460b5280f90934b2fa9a5,6,60,32,92,10,2010-09-17 00:27:10,2010-09-16 21:58:04
c8f9728de7510a539b4460b5280f90934b2fa9a5...5a00d9d50f708135fb042f83f4f8b294bcd538cd,1,1,1,2,1,2010-09-17 00:32:30,2010-09-16 22:27:25
5a00d9d50f708135fb042f83f4f8b294bcd538cd...6da0593162dbc861d32c83b38e083dbfd2df870d,1,0,26,26,2,2010-09-17 01:51:50,2010-09-17 01:51:50
6da0593162dbc861d32c83b38e083dbfd2df870d...bbbcd1fee0a85fb21c6a3206760f4b24d545746e,3,6,2,8,4,2010-09-17 02:04:09,2010-09-17 02:04:09
bbbcd1fee0a85fb21c6a3206760f4b24d545746e...42eb5a6898bed3c66dd07afbdb08d281f10c1579,2,2,4,6,2,2010-09-17 03:50:56,2010-09-17 03:50:56
42eb5a6898bed3c66dd07afbdb08d281f10c1579...d2de8ba400abf5fffe4ed9c688df86508ea72ff1,2,25,5,30,9,2010-09-17 04:07:22,2010-09-17 04:07:22
d2de8ba400abf5fffe4ed9c688df86508ea72ff1...431e43009c1a90781bea57aa993797d0161bbf95,66,4721,1328,6049,456,2010-09-17 04:33:32,2010-09-17 04:33:32
431e43009c1a90781bea57aa993797d0161bbf95...3def66ac3b3c2644bc4f0261662236638b55ba51,1,6,0,6,1,2010-09-17 05:22:38,2010-09-17 05:22:38
3def66ac3b3c2644bc4f0261662236638b55ba51...6eca948ca24338743afdfbcadeefa928701d1c07,6,57,63,120,33,2010-09-17 06:16:07,2010-09-17 06:13:03
6eca948ca24338743afdfbcadeefa928701d1c07...6680c7fbf7ef971fbf2954c8bc3eadad2f52751e,1,1,0,1,1,2010-09-17 06:16:36,2010-09-17 06:16:36
6680c7fbf7ef971fbf2954c8bc3eadad2f52751e...31f8fa222e2c65642b28a3267adbe758f5af65b5,2,2,0,2,2,2010-09-17 06:22:58,2010-09-17 06:22:58
31f8fa222e2c65642b28a3267adbe758f5af65b5...f8ce848d9b9d40d4ac16e1d15de86b1b59cf33d3,2,5,7,12,3,2010-09-17 07:01:27,2010-09-17 07:01:07
f8ce848d9b9d40d4ac16e1d15de86b1b59cf33d3...5a801d63d19ad2ac05e518638416db1d8eda17c3,1,0,14,14,2,2010-09-17 07:03:17,2010-09-17 07:03:17
5a801d63d19ad2ac05e518638416db1d8eda17c3...01b3418e2ef919ef4c85311fccee35648e783618,5,27,17,44,14,2010-09-17 07:15:54,2010-09-17 07:15:44
01b3418e2ef919ef4c85311fccee35648e783618...9628e28aecd53243e4e450a5605980fa7417527c,2,0,48,48,2,2010-09-17 07:23:27,2010-09-17 07:23:17
9628e28aecd53243e4e450a5605980fa7417527c...776754c33f347ef4827cf2b9d3cea7c1d46be7b5,4,6,28,34,5,2010-09-17 08:06:44,2010-09-17 08:06:44
776754c33f347ef4827cf2b9d3cea7c1d46be7b5...4962702e4a06e3b986cbf1d1042a29c35ef7105d,3,280,261,541,11,2010-09-19 18:22:15,2010-09-19 18:20:25
4962702e4a06e3b986cbf1d1042a29c35ef7105d...db73c71280966b0587a8d16677b89be7fcfd1c2d,2,14,37,51,10,2010-09-19 18:55:18,2010-09-19 18:53:32
db73c71280966b0587a8d16677b89be7fcfd1c2d...124fbedc2fa3ca6620f6c18195bb42d6c1305af8,3,7,4,11,4,2010-09-19 20:13:59,2010-09-19 20:13:57
124fbedc2fa3ca6620f6c18195bb42d6c1305af8...1e63cd69f8494b922e21bd34b54b330443e1ff8c,1,0,1,1,1,2010-09-19 20:32:46,2010-09-19 20:32:46
1e63cd69f8494b922e21bd34b54b330443e1ff8c...8e246acd0e80d35356be6c592289487549a49300,1,2,2,4,2,2010-09-19 20:37:09,2010-09-19 19:54:41
8e246acd0e80d35356be6c592289487549a49300...27af64ef463966c87a81175d2d917595eaac6a74,1,7,0,7,1,2010-09-19 21:25:13,2010-09-19 21:25:13
27af64ef463966c87a81175d2d917595eaac6a74...2d348bb985db352176125d1efe60d05211adbe77,1,2,0,2,1,2010-09-19 22:32:10,2010-09-19 22:20:35
2d348bb985db352176125d1efe60d05211adbe77...bb08f0c219bf4ca99b1129f54ef415ce46b01f22,3,28,188,216,28,2010-09-19 23:52:39,2010-09-19 23:00:46
bb08f0c219bf4ca99b1129f54ef415ce46b01f22...354150f4e1f20506b95c5fbdaf4daad4e94a0ede,1,9,2,11,4,2010-09-20 00:22:18,2010-09-20 00:22:18
354150f4e1f20506b95c5fbdaf4daad4e94a0ede...fc334b3a977d45f8eecff7f9f48a86de8b5c0526,1,1,6,7,2,2010-09-20 01:02:27,2010-09-19 08:05:01
fc334b3a977d45f8eecff7f9f48a86de8b5c0526...0f16af7ee41edc29e9c850a4650b90a6e5e49f37,2,59,91,150,24,2010-09-20 16:56:43,2010-09-20 01:50:26
0f16af7ee41edc29e9c850a4650b90a6e5e49f37...1b1bee80995d83b77fe3090f4b4adaeff3e84218,1,1,1,2,1,2010-09-20 17:03:50,2010-09-20 17:03:50
1b1bee80995d83b77fe3090f4b4adaeff3e84218...754fde7325b54f7c2744b98bb2865721660622bb,1,3,1,4,1,2010-09-20 19:52:07,2010-09-20 19:52:07
754fde7325b54f7c2744b98bb2865721660622bb...9922e4e433996722a76edb46d14f1729f33b4bed,1,1,6,7,1,2010-09-20 23:51:52,2010-09-20 23:51:47
9922e4e433996722a76edb46d14f1729f33b4bed...dff1b5ad109113d007aca2c9a310f78129f48049,3,4,0,4,3,2010-09-22 17:13:25,2010-09-21 23:51:55
dff1b5ad109113d007aca2c9a310f78129f48049...cc1d61cbb3a9b2b75edac66295f2bc5314be5042,2,53,0,53,2,2010-09-22 17:17:07,2010-09-22 17:16:18
cc1d61cbb3a9b2b75edac66295f2bc5314be5042...e2274412488ab310decb8494ab41009342b3c2f6,73,103182,1577,104759,581,2010-09-22 17:21:15,2010-09-22 17:21:15
e2274412488ab310decb8494ab41009342b3c2f6...893ebe72305ea599c32c99e3ca4fda050ae7c983,2,15,4,19,5,2010-09-22 17:22:43,2010-09-22 17:11:37
893ebe72305ea599c32c99e3ca4fda050ae7c983...4df999f85f2cb7ac687d3281af012d9df9699657,73,1577,103182,104759,580,2010-09-23 02:20:06,2010-09-22 18:14:58
4df999f85f2cb7ac687d3281af012d9df9699657...4d0456f827c694e779d7fe754223929554206232,2,73,52,125,9,2010-09-23 05:06:32,2010-09-23 00:58:08
4d0456f827c694e779d7fe754223929554206232...5535aa3d51c6af2380540bb5f0908357b76ebd13,2,70,2,72,4,2010-09-23 17:29:20,2010-09-22 12:51:53
5535aa3d51c6af2380540bb5f0908357b76ebd13...3fc9192d0dda254888268093ab6693290d89344c,3,65,0,65,3,2010-09-24 05:27:44,2010-09-24 02:55:26
3fc9192d0dda254888268093ab6693290d89344c...353e2565d5867f457c03e5e011b5e13a2254b96f,4,26,15,41,19,2010-09-25 16:19:50,2010-09-24 09:21:17
353e2565d5867f457c03e5e011b5e13a2254b96f...f9d6b074cf75a250ccc705f51e7d71a85803085b,1,8,0,8,1,2010-09-28 08:14:38,2010-09-28 08:14:38
f9d6b074cf75a250ccc705f51e7d71a85803085b...7c5cc57ece06c64e20ee9bc45f2e95d7a540c01c,4,12,18,30,8,2010-09-28 08:14:58,2010-09-23 12:14:16
7c5cc57ece06c64e20ee9bc45f2e95d7a540c01c...069d973d74efdf8492512c58a71fd8f13e8c6696,6,0,8,8,6,2010-09-28 09:31:31,2010-09-28 09:31:31
069d973d74efdf8492512c58a71fd8f13e8c6696...3a64c22cc1bad10365d93389c538a9025e8df131,1,4,3,7,1,2010-09-28 10:11:33,2010-09-28 10:08:00
3a64c22cc1bad10365d93389c538a9025e8df131...fe060916ec80d7e70e060f416f7a9a3337721b39,1,17,17,34,9,2010-09-28 10:17:44,2010-09-28 10:17:44
fe060916ec80d7e70e060f416f7a9a3337721b39...d89f8dce28601a3414dd28a02bf181cf9cfa0979,1,35,33,68,24,2010-09-28 18:27:09,2010-09-28 18:05:10
d89f8dce28601a3414dd28a02bf181cf9cfa0979...7bd94712a8592d8d53596c727a0456db742dc5ed,1,9,11,20,4,2010-09-28 18:27:13,2010-09-28 18:14:24
7bd94712a8592d8d53596c727a0456db742dc5ed...163485c8aa7c443902bccd8a0d5b86f357e6a3f0,3,34,34,68,14,2010-09-28 18:38:27,2010-09-28 18:38:27
163485c8aa7c443902bccd8a0d5b86f357e6a3f0...9911629de01769357d66acf7a1e07136646990a3,3,141,146,287,68,2010-09-29 02:17:09,2010-09-28 18:42:47
9911629de01769357d66acf7a1e07136646990a3...55c65cc2d55b70def061da0c8fd38f08b2929433,10,56,9,65,12,2010-09-29 23:02:45,2010-09-24 15:02:08
55c65cc2d55b70def061da0c8fd38f08b2929433...f323f34353c054deed4bc0bc5c1b0c4d710186eb,2,7,7,14,6,2010-09-29 23:12:30,2010-09-29 23:11:00
f323f34353c054deed4bc0bc5c1b0c4d710186eb...c3bc48d451c77ff67a65338fefba4a6bc9478d7d,1,50,50,100,10,2010-09-30 18:41:50,2010-09-30 18:41:50
c3bc48d451c77ff67a65338fefba4a6bc9478d7d...ee9af669905aeddd6da32712e711aeee9f9d36b3,1,34,0,34,1,2010-09-30 18:48:19,2010-09-30 18:45:27
ee9af669905aeddd6da32712e711aeee9f9d36b3...1a2c1c8a96b4e05d496d05d99f7cf1f7c2fb1829,1,3,8,11,4,2010-09-30 19:18:58,2010-09-30 19:16:48
1a2c1c8a96b4e05d496d05d99f7cf1f7c2fb1829...5cc1428d5f7a8c72e12d7346488b87390f995a5d,1,0,5,5,1,2010-09-30 19:20:33,2010-09-30 19:20:33
5cc1428d5f7a8c72e12d7346488b87390f995a5d...43ddc04bb0bf9d5715e29de19d71185d28c63cea,1,1,0,1,1,2010-09-30 23:19:59,2010-09-26 16:36:40
43ddc04bb0bf9d5715e29de19d71185d28c63cea...1b24fc667802233b8e1c34c4189ab82ba5dd357a,3,53,12,65,18,2010-09-30 23:30:40,2010-09-29 09:38:48
1b24fc667802233b8e1c34c4189ab82ba5dd357a...265cda97d7e86292a7ad58ca09b97c9527d78542,2,42,1,43,2,2010-10-01 00:13:01,2010-10-01 00:12:56
265cda97d7e86292a7ad58ca09b97c9527d78542...914ff78df600a26a71b3ce01cd4ddee5006709cd,1,6,4,10,2,2010-10-01 01:23:30,2010-09-27 03:31:09
914ff78df600a26a71b3ce01cd4ddee5006709cd...5a4c40beea345d91a9b7520d7374336db928abe2,1,1,0,1,1,2010-10-01 18:16:51,2010-10-01 18:01:43
5a4c40beea345d91a9b7520d7374336db928abe2...5829716649a543f2c7e43859e5c0e32491b61198,1,2,1,3,1,2010-10-01 18:31:22,2010-10-01 18:31:02
5829716649a543f2c7e43859e5c0e32491b61198...c9627e0a0d191583e266836b8ce279e6dc527a40,149,108545,6058,114603,2359,2010-10-01 21:19:11,2010-10-01 21:18:59
c9627e0a0d191583e266836b8ce279e6dc527a40...4a7562d28fe8fb2de36c5d5ccf9e80cbf1a67d48,2,3,2,5,3,2010-10-01 22:16:25,2010-09-27 17:34:16
4a7562d28fe8fb2de36c5d5ccf9e80cbf1a67d48...d59512f6f406ceae4940fd9c83e8255f0c03173b,3,153,5,158,19,2010-10-01 22:30:53,2010-09-10 01:56:35
d59512f6f406ceae4940fd9c83e8255f0c03173b...e9b6b0b327e6f7beff05ef9b3c2fe1b166ad0a34,4,12,4,16,6,2010-10-02 13:44:28,2010-10-02 06:22:34
e9b6b0b327e6f7beff05ef9b3c2fe1b166ad0a34...29cc78f8245c1abfa9d88bd2180b111d847949f3,8,626,191,817,16,2010-10-02 13:44:55,2010-10-01 02:55:28
29cc78f8245c1abfa9d88bd2180b111d847949f3...3faa3b56f3d1b35e1e35c7a77dec27bda1675e01,2,198,0,198,2,2010-10-02 13:44:55,2010-09-25 09:13:11
3faa3b56f3d1b35e1e35c7a77dec27bda1675e01...48d7a1edc1bb5c004a0458c021e097050238edc9,10,2,2,4,2,2010-10-02 22:07:54,2010-10-02 22:07:54
48d7a1edc1bb5c004a0458c021e097050238edc9...38f8665f3a8c019ceee9437ca142635bb5ba13a3,2,24,10,34,9,2010-10-04 17:50:37,2010-10-04 17:50:35
38f8665f3a8c019ceee9437ca142635bb5ba13a3...8ff7954165205b2f3ade222d717ac62edb502932,2,7,2,9,3,2010-10-04 19:50:58,2010-10-04 19:22:59
8ff7954165205b2f3ade222d717ac62edb502932...dbf0d6bb70902fba80b10adccf3f54fe9cf5beb7,1,3,1,4,2,2010-10-04 19:52:46,2010-10-04 19:52:46
dbf0d6bb70902fba80b10adccf3f54fe9cf5beb7...7fca10133861348417f33dac2d656cbfd9d1bb0d,34,652,431,1083,128,2010-10-05 22:25:07,2010-10-05 22:25:07
7fca10133861348417f33dac2d656cbfd9d1bb0d...5986a582d9d43d2a58ff5dd5f59377c280fac802,1,3,2,5,1,2010-10-05 22:25:33,2010-10-05 06:22:53
5986a582d9d43d2a58ff5dd5f59377c280fac802...9481bc1009765b24390239a1d7d88bebae5db731,2,20,2,22,7,2010-10-07 02:09:22,2010-10-07 02:05:01
9481bc1009765b24390239a1d7d88bebae5db731...3d4e4d89099f1c08e586060961ed884e5f52301a,28,85,86,171,79,2010-10-07 03:40:57,2010-10-07 03:05:23
3d4e4d89099f1c08e586060961ed884e5f52301a...54e844cf08cdb55b4236eb3d1d2c1d13bbd4b921,2,5,0,5,2,2010-10-07 16:58:08,2010-10-07 16:58:08
54e844cf08cdb55b4236eb3d1d2c1d13bbd4b921...0003c701bcb1d916073f8893ee4cbe698515158d,1,1,0,1,1,2010-10-07 23:17:06,2010-10-07 23:17:06
0003c701bcb1d916073f8893ee4cbe698515158d...f7a9eea0d4bcce3067b2834f8298676c3c2aa31d,2,200,0,200,2,2010-10-09 07:56:16,2010-10-09 07:55:51
f7a9eea0d4bcce3067b2834f8298676c3c2aa31d...634c4bf0b0e15a84efaf49632e458e034a3eac40,1,197,0,197,1,2010-10-09 07:56:37,2010-10-09 07:56:37
634c4bf0b0e15a84efaf49632e458e034a3eac40...ae8700747866bff3390cf60f580f4c809d4ea7dd,1,2,2,4,1,2010-10-09 17:04:13,2010-10-09 16:25:02
ae8700747866bff3390cf60f580f4c809d4ea7dd...b5359e40be91c113feef45ff4e1be65cffe337d0,2,34,30,64,24,2010-10-09 19:15:16,2010-10-09 19:15:14
b5359e40be91c113feef45ff4e1be65cffe337d0...d164989e3fd7199ad8905d884c378eecc60f51ee,1,2,2,4,1,2010-10-09 19:18:17,2010-10-09 01:26:53
d164989e3fd7199ad8905d884c378eecc60f51ee...39b9043befe0914824733768f1218f516a21dca7,1,1,1,2,1,2010-10-09 19:40:17,2010-10-09 19:40:15
39b9043befe0914824733768f1218f516a21dca7...783f5019b0fe03cb03c494f7cc5d21d01e03b723,2,4,1,5,3,2010-10-09 19:46:06,2010-10-09 19:46:06
783f5019b0fe03cb03c494f7cc5d21d01e03b723...f23eb282c01723b94948d6c8a6ca9a135ac69764,2,8,16,24,8,2010-10-09 19:48:22,2010-10-09 19:48:22
f23eb282c01723b94948d6c8a6ca9a135ac69764...5dd08c6c71cf132c3ee538378bce1956e2854ac6,1,4,1,5,2,2010-10-09 21:21:33,2010-10-09 21:21:26
5dd08c6c71cf132c3ee538378bce1956e2854ac6...a6017660d8bd1099a49e7dc0d050587c542f0dca,1,2,2,4,2,2010-10-09 22:10:45,2010-10-09 22:10:45
a6017660d8bd1099a49e7dc0d050587c542f0dca...fe74283e1d29f64be38e42ae1be989a13050f3e4,6,101,35,136,46,2010-10-09 23:04:38,2010-10-09 23:04:38
fe74283e1d29f64be38e42ae1be989a13050f3e4...bc695475b908ccf30e5016689328df37b678b870,5,86,7,93,11,2010-10-11 00:27:03,2010-10-11 00:21:36
bc695475b908ccf30e5016689328df37b678b870...0cf03ab8002795fed572bfaa31c51cced553bc2c,2,13,0,13,2,2010-10-11 02:08:51,2010-10-11 02:08:51
0cf03ab8002795fed572bfaa31c51cced553bc2c...9d248f690a31299804854e0928cf6ecdcd2ce293,1,2,0,2,1,2010-10-11 02:24:33,2010-10-11 02:24:33
9d248f690a31299804854e0928cf6ecdcd2ce293...1af52d28ca3cc84a5df8dee7236481be0700ef05,1,5,5,10,5,2010-10-11 02:43:21,2010-10-11 02:38:57
1af52d28ca3cc84a5df8dee7236481be0700ef05...8ab691726d76026c123b4ad96bb771be94c96729,1,1,3,4,1,2010-10-11 03:16:21,2010-10-11 03:16:21
8ab691726d76026c123b4ad96bb771be94c96729...393f0071e4cabc05d083a43e8da76f166b9d0f0a,1,77,7,84,7,2010-10-11 03:18:47,2010-10-11 03:18:47
393f0071e4cabc05d083a43e8da76f166b9d0f0a...cdd1d675a7bba5693c63656bec5a32166a8279d6,2,0,12,12,2,2010-10-11 03:57:33,2010-10-11 03:57:33
cdd1d675a7bba5693c63656bec5a32166a8279d6...81ac0d5088c1741632424d28bfda0cef467fa970,2,47,23,70,22,2010-10-11 05:10:47,2010-10-11 05:05:49
81ac0d5088c1741632424d28bfda0cef467fa970...1d3142a882d08a5cd1bf221cf37e76692bd71205,2,18,2,20,6,2010-10-11 06:09:14,2010-10-11 06:09:14
1d3142a882d08a5cd1bf221cf37e76692bd71205...3cd09e7ba55b21586c338e177180449f22a5e56e,1,43,0,43,1,2010-10-11 07:25:48,2010-10-11 07:19:40
3cd09e7ba55b21586c338e177180449f22a5e56e...007881b6480e2ba67674b7949e6dbc6efec588fe,1,4,4,8,4,2010-10-11 08:22:24,2010-10-11 08:22:24
007881b6480e2ba67674b7949e6dbc6efec588fe...2944e03a030022e1420634b87e3a44e775184425,2,4,5,9,3,2010-10-11 08:22:38,2010-10-11 08:22:38
2944e03a030022e1420634b87e3a44e775184425...50443f08e0f359767c633bc04ecf340e79119453,2,10,0,10,4,2010-10-11 18:19:55,2010-10-11 15:19:11
50443f08e0f359767c633bc04ecf340e79119453...0a0e90dcca1642849ffa8b8cee4ad9b8f15c0fc1,1,65,0,65,1,2010-10-11 21:54:32,2010-10-11 21:54:32
0a0e90dcca1642849ffa8b8cee4ad9b8f15c0fc1...e38eb0c5a4d4e8497f5815be81994ddb01fbceb7,55,543,541,1084,142,2010-10-11 22:21:36,2010-10-11 21:04:09
e38eb0c5a4d4e8497f5815be81994ddb01fbceb7...7e24a05cba2373c0ab1f0629366b664a593f357f,2,3,3,6,3,2010-10-11 23:00:36,2010-10-11 23:00:36
7e24a05cba2373c0ab1f0629366b664a593f357f...1879d8211d4c05a512ea634126f35e2621831f4b,2,1,2,3,2,2010-10-11 23:07:18,2010-10-11 23:07:18
1879d8211d4c05a512ea634126f35e2621831f4b...ee8522996a6383bd661dea341816c63993eef47f,1,1,1,2,1,2010-10-11 23:08:53,2010-10-11 23:08:19
ee8522996a6383bd661dea341816c63993eef47f...c1aa8ea944072d224db42f8d05906f22702c9980,1,1,7,8,1,2010-10-11 23:16:18,2010-10-11 23:01:12
c1aa8ea944072d224db42f8d05906f22702c9980...83db91be4152a1a6aab5e82c844b8c5202a4959c,4,0,6,6,5,2010-10-11 23:20:04,2010-10-11 23:02:05
83db91be4152a1a6aab5e82c844b8c5202a4959c...7bfefb525027522150730916dbd8ad1a985a327a,1,0,46,46,6,2010-10-11 23:20:08,2010-10-11 23:03:02
7bfefb525027522150730916dbd8ad1a985a327a...0e1a58191601a177083862776b46fc4f43569c23,1,0,50,50,4,2010-10-11 23:20:08,2010-10-11 23:03:28
0e1a58191601a177083862776b46fc4f43569c23...a3604cf23368e5b6ab3ead44bedfcd4ba0472f53,1,0,5,5,1,2010-10-11 23:20:08,2010-10-11 23:04:18
a3604cf23368e5b6ab3ead44bedfcd4ba0472f53...d2c47b4f8743d88d4cc425b0a7829ddd1dbaf22c,1,0,3,3,1,2010-10-11 23:21:21,2010-10-11 23:06:44
d2c47b4f8743d88d4cc425b0a7829ddd1dbaf22c...372a7c9a3ef377f203ecf453042101ee73328c88,8,17,17,34,17,2010-10-11 23:21:45,2010-10-11 23:09:02
372a7c9a3ef377f203ecf453042101ee73328c88...8139bb24c1f72cdea41492bf3bf395a66e04104f,1,12,0,12,2,2010-10-11 23:36:14,2010-10-11 23:36:12
8139bb24c1f72cdea41492bf3bf395a66e04104f...32aadd9400c1ebf9eba940620030edcb1161a2f1,1,5,4,9,5,2010-10-11 23:39:40,2010-10-11 23:39:40
32aadd9400c1ebf9eba940620030edcb1161a2f1...901d5fd0d2475f8f912f9a73d14805d6898c8e02,1,0,1,1,1,2010-10-11 23:40:28,2010-10-11 23:40:28
901d5fd0d2475f8f912f9a73d14805d6898c8e02...c4636a578cee61a8a3b570146e168f7dffec9998,5,67,26,93,13,2010-10-12 18:49:41,2010-10-12 18:49:41
c4636a578cee61a8a3b570146e168f7dffec9998...0fcb3bd3a9f585562c5b421314c206c9438f6cef,1,1,1,2,1,2010-10-12 18:54:45,2010-10-12 18:54:45
0fcb3bd3a9f585562c5b421314c206c9438f6cef...f61b110cf6d77044e813499ec6ce667813a697cd,1,18,4,22,2,2010-10-12 21:01:58,2010-10-12 21:01:58
f61b110cf6d77044e813499ec6ce667813a697cd...6691aca2297b76cd3eb14506447f16a213dae2c6,1,1,1,2,1,2010-10-13 08:47:29,2010-10-13 08:47:29
6691aca2297b76cd3eb14506447f16a213dae2c6...045bd4c7a49b83a9e6cd4083763f12a698c48845,3,19,0,19,4,2010-10-13 08:49:33,2010-10-12 21:13:44
045bd4c7a49b83a9e6cd4083763f12a698c48845...73b29d79b96e2db853ef38c59d76d136f45caeae,2,50,1,51,2,2010-10-13 09:37:53,2010-10-12 04:19:44
73b29d79b96e2db853ef38c59d76d136f45caeae...9b1ff070e6df8560ec4ce60d78c68c96ddf206c8,3,37,13,50,14,2010-10-13 09:47:10,2010-10-13 09:45:37
9b1ff070e6df8560ec4ce60d78c68c96ddf206c8...cdde22a27d797b853efac161eaec630d3405e924,1,35,20,55,8,2010-10-13 21:30:50,2010-10-13 21:16:49
cdde22a27d797b853efac161eaec630d3405e924...ff456b38862de3fd0118c6ac6b3f46edb1fbb87f,4,83,5,88,5,2010-10-13 23:20:24,2010-10-13 23:20:24
ff456b38862de3fd0118c6ac6b3f46edb1fbb87f...3cf4827ae0c2a578d1831caffd8e9e15aee1907a,3,89,0,89,3,2010-10-15 17:11:50,2010-10-15 17:05:22
3cf4827ae0c2a578d1831caffd8e9e15aee1907a...a6ee3bac85c84c1a24c1a2aa621f77ba5d1c0bb9,2,29,1,30,3,2010-10-17 03:43:09,2010-10-12 20:52:26
a6ee3bac85c84c1a24c1a2aa621f77ba5d1c0bb9...ccf2a04ea2b004af58a2e599965b08e94bbe47d3,2,16,15,31,4,2010-10-18 05:57:40,2010-10-18 05:57:40
ccf2a04ea2b004af58a2e599965b08e94bbe47d3...cf1db4f3043fce0474c421dc547b8bd2f9616354,3,62,19,81,14,2010-10-18 18:34:35,2010-10-18 18:15:20
cf1db4f3043fce0474c421dc547b8bd2f9616354...25b5bc01a6ffddbe89e76f879be20f2bfa80ec08,1,135,0,135,1,2010-10-18 18:36:23,2010-10-07 23:25:30
25b5bc01a6ffddbe89e76f879be20f2bfa80ec08...74c8b5fd0858b8b61bbd3175ee830ab8b4903c7c,1,8,2,10,3,2010-10-18 18:39:56,2010-10-13 22:27:51
74c8b5fd0858b8b61bbd3175ee830ab8b4903c7c...56df0cbf93f78daf905eae7bd66daf0910650a72,1,63,25,88,6,2010-10-18 20:46:54,2010-10-13 14:51:53
56df0cbf93f78daf905eae7bd66daf0910650a72...97255c2651f726cc1d466700f35d5ba085cc07f5,5,156,75,231,60,2010-10-18 21:54:39,2010-10-18 21:46:25
97255c2651f726cc1d466700f35d5ba085cc07f5...4adadc38f4a3ba051a5edde54d87799fb21fe1ba,1,2,1,3,1,2010-10-18 22:00:49,2010-10-18 22:00:49
4adadc38f4a3ba051a5edde54d87799fb21fe1ba...40f675b64b99f0c0392599bd692c5a580500bfd2,1,40,36,76,9,2010-10-18 22:05:18,2010-10-18 22:05:18
40f675b64b99f0c0392599bd692c5a580500bfd2...c735b4663acad20c4d8ccd7a469de77927af22bb,2,20,1,21,3,2010-10-18 22:22:10,2010-10-18 20:08:42
c735b4663acad20c4d8ccd7a469de77927af22bb...b14eeb3c1ec15d94d20da4deea853582482a47b0,1,1,1,2,1,2010-10-18 22:38:46,2010-10-18 05:14:29
b14eeb3c1ec15d94d20da4deea853582482a47b0...5d400cfd3a2a9faf27a88bf82f33a57f78fa65af,2,21,4,25,2,2010-10-19 00:00:13,2010-10-06 17:18:08
5d400cfd3a2a9faf27a88bf82f33a57f78fa65af...1b2f6f9e29bf7137e177b8d9b600fe558d36f512,78,2217,3656,5873,462,2010-10-19 00:13:30,2010-10-19 00:13:30
1b2f6f9e29bf7137e177b8d9b600fe558d36f512...a313f38c34585516bcad322e9f489ae8bac83f49,1,1,1,2,1,2010-10-19 00:48:49,2010-10-19 00:48:49
a313f38c34585516bcad322e9f489ae8bac83f49...179a7f6ffa08b7df7c228f0912988e29324456e9,1,9,0,9,1,2010-10-20 18:09:40,2010-10-19 03:36:26
179a7f6ffa08b7df7c228f0912988e29324456e9...3407dab07fa6da8a5b117af87826280081384e3a,1,7,7,14,7,2010-10-20 18:10:43,2010-10-20 18:10:40
3407dab07fa6da8a5b117af87826280081384e3a...226eff510456b4e66b519e31212285ab6927e381,3,46,18,64,11,2010-10-20 19:12:07,2010-10-19 01:17:33
226eff510456b4e66b519e31212285ab6927e381...bd8e4f656e0cdbcf98a0a2cfe0c7b41645b56810,2,33,14,47,9,2010-10-20 19:46:51,2010-10-19 12:42:00
bd8e4f656e0cdbcf98a0a2cfe0c7b41645b56810...8c0e87f9c333f3519b6d6439099f669a316ed598,1,4,0,4,1,2010-10-20 20:03:49,2010-10-20 20:03:39
8c0e87f9c333f3519b6d6439099f669a316ed598...b0aadbea6b76e33c5a8079cf5ea327cc288cda1c,1,16,5,21,5,2010-10-20 22:20:04,2010-10-20 20:56:22
b0aadbea6b76e33c5a8079cf5ea327cc288cda1c...492fc0d7524c0a5b546fb1a16f1b49bb4db73da8,1,12,7,19,4,2010-10-20 22:21:33,2010-10-19 18:36:10
492fc0d7524c0a5b546fb1a16f1b49bb4db73da8...bfc6b51d955089a7e5b23807b4722cdaec0a8e0b,1,1,10,11,2,2010-10-20 22:22:02,2010-10-19 19:01:22
bfc6b51d955089a7e5b23807b4722cdaec0a8e0b...b0adaff67e492ab9ac583059f5e2dba54de0973b,2,27,5,32,7,2010-10-20 22:45:47,2010-10-14 00:15:56
b0adaff67e492ab9ac583059f5e2dba54de0973b...5e14c8bec0b4e1c19d8567cf8b843b215e8796ac,2,7,6,13,3,2010-10-20 22:46:13,2010-10-19 20:28:13
5e14c8bec0b4e1c19d8567cf8b843b215e8796ac...78da9cb052aa0f6483978957208d9df56e29d420,1,34,13,47,5,2010-10-20 22:57:13,2010-10-18 22:50:56
78da9cb052aa0f6483978957208d9df56e29d420...5a98fa4809457f843aae5447ce82b660c8b595f3,1,8,13,21,2,2010-10-21 00:55:25,2010-10-21 00:55:25
5a98fa4809457f843aae5447ce82b660c8b595f3...6570cd99e51adb082d0e0076a1205cd867f4ce41,2,56,19,75,9,2010-10-21 02:20:52,2010-10-21 02:20:44
6570cd99e51adb082d0e0076a1205cd867f4ce41...33e45bbe46305cdba03c06b6ac6e122c82e86dda,1,86,0,86,1,2010-10-21 04:28:49,2010-10-21 04:01:43
33e45bbe46305cdba03c06b6ac6e122c82e86dda...ceb5331a64e813f3a982c702fea5dcd2db2e7a29,2,38,1,39,2,2010-10-21 19:28:04,2010-10-21 19:27:58
ceb5331a64e813f3a982c702fea5dcd2db2e7a29...2629296c257b6d74e86e9f9139b04ba5e27b68d8,1,13,0,13,2,2010-10-21 19:34:37,2010-10-21 19:34:37
2629296c257b6d74e86e9f9139b04ba5e27b68d8...3b861db31d1ecc92149cf6b2497b6539276e0f70,78,2086,389,2475,266,2010-10-21 22:22:38,2010-10-21 22:22:38
3b861db31d1ecc92149cf6b2497b6539276e0f70...174a3a9a08ab964349d7f976f3c3025d21a2f2e8,16,1201,582,1783,429,2010-10-21 22:38:32,2010-10-21 22:38:32
174a3a9a08ab964349d7f976f3c3025d21a2f2e8...99e19aa398a2da1fcc77e36b202e1877b4a46c24,3,5,10,15,3,2010-10-22 00:11:59,2010-10-21 12:36:00
99e19aa398a2da1fcc77e36b202e1877b4a46c24...92c5634cbda0c339719ff1ed2d966fa594d192e5,1,0,3,3,1,2010-10-22 00:32:13,2010-10-22 00:31:38
92c5634cbda0c339719ff1ed2d966fa594d192e5...604f4fdf8c40e3039e1d1821a744c48e60df7a06,5,5,5,10,5,2010-10-22 17:02:30,2010-10-22 17:02:30
604f4fdf8c40e3039e1d1821a744c48e60df7a06...fb8830a64f267afb8a471f04d13c4eb2eafac810,1,16,1,17,2,2010-10-22 17:14:19,2010-07-16 08:07:43
fb8830a64f267afb8a471f04d13c4eb2eafac810...b2969a9155ff3a141fa1985cc20499b62990a783,1,0,1,1,1,2010-10-22 17:17:38,2010-10-22 17:17:38
b2969a9155ff3a141fa1985cc20499b62990a783...d9b08d66d6a7999601bc05a20f477e40c9dc1d71,2,2,22,24,9,2010-10-22 20:32:31,2010-10-21 09:37:08
d9b08d66d6a7999601bc05a20f477e40c9dc1d71...d5e966154c840cffa2d8d3f5bceff40ba80464a0,1,8,33,41,4,2010-10-22 20:32:48,2010-10-21 09:47:27
d5e966154c840cffa2d8d3f5bceff40ba80464a0...b3e60c7b253727a4075fdffa8714527a50673b74,1,6,4,10,4,2010-10-22 20:47:10,2010-10-21 09:53:02
b3e60c7b253727a4075fdffa8714527a50673b74...dd5273747670bf1be250df7b84525096e1d23775,2,77,24,101,16,2010-10-22 23:52:14,2010-10-22 10:08:55
dd5273747670bf1be250df7b84525096e1d23775...d9a5edb2b076063058a0631c5389b053f649dd1d,2,30,19,49,10,2010-10-23 18:22:24,2010-10-23 18:22:24
d9a5edb2b076063058a0631c5389b053f649dd1d...9bf2975f78ce097c82a720bdda82810c1188a8ef,3,18,12,30,16,2010-10-23 18:37:40,2010-10-23 18:36:30
9bf2975f78ce097c82a720bdda82810c1188a8ef...0ac2ef924f2564ab967be22c7b4ae18c20ff4fc2,2,24,1,25,3,2010-10-23 19:28:20,2010-10-23 18:59:32
0ac2ef924f2564ab967be22c7b4ae18c20ff4fc2...44234e9cc7295f09d0015b0f76b8abb0239fc025,2,42,41,83,9,2010-10-23 21:13:04,2010-10-23 21:11:30
44234e9cc7295f09d0015b0f76b8abb0239fc025...38f117cb6df78fc9ec718da9dae8918f80b08ffc,1,22,19,41,3,2010-10-23 21:26:31,2010-10-23 21:26:31
38f117cb6df78fc9ec718da9dae8918f80b08ffc...477df1aaec1b4824130c852da5babdf125e91a1c,1,0,4,4,1,2010-10-23 22:35:58,2010-10-23 22:35:58
477df1aaec1b4824130c852da5babdf125e91a1c...1582cfebd6719b2d2373547994b3dca5c8c569c0,5,97,5,102,5,2010-10-23 23:00:15,2010-10-23 22:46:58
1582cfebd6719b2d2373547994b3dca5c8c569c0...bb85e7751f1bd224fbce370ad84d8ce774e2d69a,1,2,2,4,1,2010-10-23 23:01:37,2010-10-23 23:01:37
bb85e7751f1bd224fbce370ad84d8ce774e2d69a...15594eaf87066abc8cf36520a1ad95e0c52da517,23,435,1698,2133,74,2010-10-25 01:39:36,2010-10-04 09:11:27
15594eaf87066abc8cf36520a1ad95e0c52da517...fcd0c3ebc0a40c62292779ea66318a0229d60b95,1,0,136,136,1,2010-10-25 02:21:12,2010-10-25 02:20:36
fcd0c3ebc0a40c62292779ea66318a0229d60b95...7eed71f8bb8d623a0768e8a99cd48527b839fef1,1,2,0,2,1,2010-10-25 03:11:47,2010-10-25 03:11:47
7eed71f8bb8d623a0768e8a99cd48527b839fef1...9977831078bff3b9d09872c115e34ee8d00b215c,3,15,3,18,4,2010-10-25 17:28:14,2010-10-25 17:27:39
9977831078bff3b9d09872c115e34ee8d00b215c...8da020d39e612a5dee9b25001332fd8c6ed55da1,3,10,13,23,5,2010-10-25 19:14:47,2010-10-23 01:28:26
8da020d39e612a5dee9b25001332fd8c6ed55da1...446d2ec19c92f8553c42f27629effb2e631e588c,2,17,6,23,5,2010-10-25 20:43:09,2010-10-25 18:22:36
446d2ec19c92f8553c42f27629effb2e631e588c...1ce4684a2751b5748e9351ea3bf7977c0f0032f2,2,70,23,93,14,2010-10-26 00:26:03,2010-10-21 06:40:15
1ce4684a2751b5748e9351ea3bf7977c0f0032f2...6ea61acf29f15dd8a1c1242fb86897adc42e832a,1,0,1,1,1,2010-10-26 00:26:44,2010-10-25 16:03:19
6ea61acf29f15dd8a1c1242fb86897adc42e832a...1128c0bf67221b3b3d6ba729ee212648521c226d,2,333,0,333,2,2010-10-26 00:26:58,2010-10-25 21:50:34
1128c0bf67221b3b3d6ba729ee212648521c226d...97977640bd3e45ef3c907a37a573716dba6e2a93,1,10,1,11,10,2010-10-26 00:28:21,2010-10-25 22:41:58
97977640bd3e45ef3c907a37a573716dba6e2a93...583c07bf8bfb0df40d2725ceb0ab88723847d281,2,1,4,5,2,2010-10-26 00:30:08,2010-10-26 00:30:08
583c07bf8bfb0df40d2725ceb0ab88723847d281...5cf4ceff592a5c3288330f32f9dff04451595b09,3,6,2,8,3,2010-10-26 01:21:45,2010-10-26 01:17:19
5cf4ceff592a5c3288330f32f9dff04451595b09...eaba4fc2bff27a4070b27ba1bc2d0918f12efe1c,1,1,0,1,1,2010-10-26 01:24:48,2010-10-26 01:24:48
eaba4fc2bff27a4070b27ba1bc2d0918f12efe1c...43022eabf79f3fa736684ccb1273804cbb31db95,1,3,1,4,2,2010-10-26 01:33:15,2010-10-26 01:33:15
43022eabf79f3fa736684ccb1273804cbb31db95...5175864c0e11cb06a6836d81ab64eefb9914a71e,1,1,2,3,2,2010-10-26 02:52:35,2010-10-26 02:25:49
5175864c0e11cb06a6836d81ab64eefb9914a71e...a7b4af0ae5408c96020e79c224e17891f836c28a,2,12,16,28,5,2010-10-26 02:52:58,2010-10-26 02:52:58
a7b4af0ae5408c96020e79c224e17891f836c28a...2470d2ee92b162ebcc4eda68958769715c3d17fb,7,56,26,82,21,2010-10-26 08:10:18,2010-10-26 05:04:39
2470d2ee92b162ebcc4eda68958769715c3d17fb...9bbc7e0bc7967ff5840fa811aa67dfbf2c890d9b,1,0,1,1,1,2010-10-26 08:10:32,2010-10-26 08:10:32
9bbc7e0bc7967ff5840fa811aa67dfbf2c890d9b...72aee8216cfe7a80c18ea171ee860a1c93ba60dd,1,0,0,0,0,2010-10-26 18:31:01,2010-10-26 18:31:01
72aee8216cfe7a80c18ea171ee860a1c93ba60dd...d1e5fbdde4d08efa6656a0df3bd9546030b80f1e,1,0,7,7,4,2010-10-26 18:33:18,2010-10-26 18:31:32
d1e5fbdde4d08efa6656a0df3bd9546030b80f1e...dcc4fffe4dc7ccec3db2d1b55ab3a42a492a0c98,2,19,0,19,2,2010-10-26 20:43:58,2010-10-26 20:43:58
dcc4fffe4dc7ccec3db2d1b55ab3a42a492a0c98...5cc29b80f23bdf3471c9c06e0be9d198ef41ea91,2,171,165,336,10,2010-10-26 21:53:17,2010-10-26 18:56:32
5cc29b80f23bdf3471c9c06e0be9d198ef41ea91...79944006e252170933e35862bdff2f7fba6bd762,2,94,73,167,22,2010-10-26 21:53:17,2010-10-26 19:14:17
79944006e252170933e35862bdff2f7fba6bd762...bc47353bbe1836e4415cb08f1b6619839bff4d82,2,81,25,106,21,2010-10-26 21:53:18,2010-10-26 19:52:31
bc47353bbe1836e4415cb08f1b6619839bff4d82...79ecc8e9b7f82b5159e04a42118f6d8b87dee2ee,2,39,41,80,33,2010-10-27 01:47:46,2010-10-26 04:05:04
79ecc8e9b7f82b5159e04a42118f6d8b87dee2ee...ac54272218a4d82f486aa163369962c98ba614c2,2,45,21,66,9,2010-10-27 09:12:25,2010-10-27 09:10:14
ac54272218a4d82f486aa163369962c98ba614c2...aeb9bed63e3521088aef3b919ac5129a9822e83c,2,20,13,33,7,2010-10-27 09:52:49,2010-10-27 09:52:49
aeb9bed63e3521088aef3b919ac5129a9822e83c...38dde9684f43dff636d1b798e7537b93d2b6b7fd,2,43,35,78,10,2010-10-27 19:09:16,2010-10-27 19:08:47
38dde9684f43dff636d1b798e7537b93d2b6b7fd...67652ddf27b471478ad0019bb328676e9c7b9479,1,130,100,230,16,2010-10-27 23:43:16,2010-10-27 22:29:08
67652ddf27b471478ad0019bb328676e9c7b9479...fd70d30a9cde6ddb46487035e57075e2ace19f15,1,2,1,3,1,2010-10-27 23:52:53,2010-10-23 20:39:25
fd70d30a9cde6ddb46487035e57075e2ace19f15...4c514a723cf13905bd0dbc2329f6efe7b5a68bc6,1,2,2,4,1,2010-10-27 23:54:10,2010-10-23 23:44:19
4c514a723cf13905bd0dbc2329f6efe7b5a68bc6...987cbbc191c030d1f35fdb11e96c01ee20fb26dc,2,40,7,47,15,2010-10-28 00:02:42,2010-10-25 19:28:53
987cbbc191c030d1f35fdb11e96c01ee20fb26dc...899fffa395a3b80ea8d8218c53b8ae166c4765d8,36,3902,46,3948,36,2010-10-28 00:15:32,2010-10-25 22:44:48
899fffa395a3b80ea8d8218c53b8ae166c4765d8...74d0a077ec278a767925c16f6a664512bd69b838,1,39,36,75,8,2010-10-28 18:12:59,2010-10-28 10:02:44
74d0a077ec278a767925c16f6a664512bd69b838...ad61d77fa358be6759cbf52a370ab2e53a83364c,2,36,27,63,10,2010-10-28 18:33:35,2010-10-28 18:33:33
ad61d77fa358be6759cbf52a370ab2e53a83364c...73cfda12bb7235fd99dc2d72521211ef6f78b014,2,31,10,41,6,2010-10-28 18:42:22,2010-10-28 18:42:22
73cfda12bb7235fd99dc2d72521211ef6f78b014...65dced730fa652675c8d92494220c135419bd419,1,5,5,10,5,2010-10-28 19:34:48,2010-10-28 19:34:46
65dced730fa652675c8d92494220c135419bd419...5171da5a6c4cd4444f9d0256a68a5af5e62d7bf5,1,0,3,3,2,2010-10-28 20:11:42,2010-10-28 20:02:51
5171da5a6c4cd4444f9d0256a68a5af5e62d7bf5...1eb547fec126ecbf9197d0bc949459d66509bcd1,1,4,6,10,6,2010-10-28 20:15:53,2010-10-28 20:15:53
1eb547fec126ecbf9197d0bc949459d66509bcd1...e190c9616ed0b05eb66e1ae6681a8bb4a5f5f3e5,33,3369,3408,6777,27,2010-10-28 21:59:15,2010-10-28 12:18:16
e190c9616ed0b05eb66e1ae6681a8bb4a5f5f3e5...c032350f64f4f39c6a23165ef275107c9d2b4df3,10,2584,0,2584,10,2010-10-28 21:59:15,2010-10-28 12:18:54
c032350f64f4f39c6a23165ef275107c9d2b4df3...d4f1e6a0236eac1f347a0130e1557656dc6aaef1,3,41,4,45,5,2010-10-28 21:59:15,2010-10-28 19:50:53
d4f1e6a0236eac1f347a0130e1557656dc6aaef1...c9f656baa9df73088af934c9b33cf3e407e9cf02,3,16,59,75,10,2010-10-28 21:59:15,2010-10-28 20:00:28
c9f656baa9df73088af934c9b33cf3e407e9cf02...a6f246b9f588250b30fe8d2817f54af4268c2dfc,3,0,494,494,3,2010-10-28 22:02:41,2010-10-28 22:00:16
a6f246b9f588250b30fe8d2817f54af4268c2dfc...23927751eb103a49ead658aa789527d7a2c023b2,1,16,17,33,5,2010-10-28 22:14:19,2010-10-28 22:10:20
23927751eb103a49ead658aa789527d7a2c023b2...818e56d44bc110753fa9c8003fa069af07cf0371,1,5,4,9,3,2010-10-29 00:17:04,2010-10-28 23:52:33
818e56d44bc110753fa9c8003fa069af07cf0371...9bea4c8d5875da3f3b714a879a6a588f9f0af56e,1,0,8,8,1,2010-10-29 02:41:44,2010-10-29 02:41:44
9bea4c8d5875da3f3b714a879a6a588f9f0af56e...fa7dcbec8be1332f16e62675203598f4bb15645c,2,1,0,1,1,2010-10-29 02:43:36,2010-10-29 02:43:00
fa7dcbec8be1332f16e62675203598f4bb15645c...7a48fd845542c6ee36ebc42c8af731a66da9082e,2,9,3,12,2,2010-10-29 07:00:43,2010-10-29 07:00:43
7a48fd845542c6ee36ebc42c8af731a66da9082e...ccdd979a690f5d0172f22b821f31672063629a31,5,22,4,26,7,2010-10-30 18:03:42,2010-10-29 23:49:39
ccdd979a690f5d0172f22b821f31672063629a31...268bcbde7c62e7bc781c79c8b07ea067bd4b9b59,104,6294,4270,10564,2056,2010-10-30 18:13:37,2010-10-30 18:13:37
268bcbde7c62e7bc781c79c8b07ea067bd4b9b59...ef9e716fd1ee49fa93dd2153c96c956b74c1dab9,1,1,1,2,1,2010-10-30 18:14:18,2010-10-30 18:13:55
ef9e716fd1ee49fa93dd2153c96c956b74c1dab9...98e7d3506f019d396db16a3598437e76ab508922,1,39,53,92,23,2010-10-30 18:45:43,2010-10-30 17:01:46
98e7d3506f019d396db16a3598437e76ab508922...016fdab43e908f8092e0b406f5fabcc107d13299,1,4,1,5,1,2010-10-30 19:04:30,2010-10-30 19:04:30
016fdab43e908f8092e0b406f5fabcc107d13299...9c2969253bbf74dc74721410fd0ca04643723343,2,7,8,15,6,2010-10-30 19:52:53,2010-10-30 19:52:53
9c2969253bbf74dc74721410fd0ca04643723343...5e11b8a9375d014a4be1bfcb3de405a4287f1206,1,44,38,82,7,2010-10-30 20:31:51,2010-10-30 20:31:51
5e11b8a9375d014a4be1bfcb3de405a4287f1206...7c90ff5d4161b24e1db8d785fa9f492b136d3b31,2,5,0,5,2,2010-10-30 23:11:30,2010-10-30 23:10:55
7c90ff5d4161b24e1db8d785fa9f492b136d3b31...ae802e3867f35d83a14e4115a92524717683265c,1,3,3,6,2,2010-10-31 00:03:26,2010-10-31 00:03:12
ae802e3867f35d83a14e4115a92524717683265c...2fa260cef68d5bb2b36bbd6fd4a2885ed4773940,2,7,6,13,4,2010-11-01 02:31:31,2010-11-01 02:31:22
2fa260cef68d5bb2b36bbd6fd4a2885ed4773940...2b08bacd56c8bea73d80cc93e1ec2d21f7d59494,2,8,10,18,8,2010-11-01 15:28:57,2010-10-30 10:06:59
2b08bacd56c8bea73d80cc93e1ec2d21f7d59494...fac6db1b569793176daaea456571306031aa5fac,1,9,8,17,2,2010-11-01 16:57:27,2010-10-29 13:07:27
fac6db1b569793176daaea456571306031aa5fac...6bf97808eedde1d2ef86349ef23fb2a7b590389a,1,18,0,18,2,2010-11-01 16:58:21,2010-10-29 14:10:37
6bf97808eedde1d2ef86349ef23fb2a7b590389a...7a7e88d44bae100932cc283912eb0937ee116bff,1,1,1,2,1,2010-11-01 19:57:28,2010-11-01 19:34:11
7a7e88d44bae100932cc283912eb0937ee116bff...fd725efa8f98c3a4d70165a6bcb4a3085621509e,1,4,0,4,1,2010-11-01 20:36:03,2010-11-01 18:40:11
fd725efa8f98c3a4d70165a6bcb4a3085621509e...ea78d995e06c3cd9037021d0deb59b1688548b83,61,1439,934,2373,285,2010-11-01 21:10:35,2010-11-01 21:10:35
ea78d995e06c3cd9037021d0deb59b1688548b83...f1391f33cd8795fc35935136a53a1c3089453171,1,1,1,2,1,2010-11-01 21:56:21,2010-11-01 21:56:21
f1391f33cd8795fc35935136a53a1c3089453171...41c1563584bfb018a444e92f01f8cff87ccda30b,1,1,11,12,1,2010-11-01 21:59:30,2010-11-01 21:59:30
41c1563584bfb018a444e92f01f8cff87ccda30b...97c97450632f2cfd2e8a246337ee4a780f5b35ff,45,919,4342,5261,41,2010-11-01 23:51:20,2010-11-01 23:03:32
97c97450632f2cfd2e8a246337ee4a780f5b35ff...07812c47a400efa34bfb95d149765afbceb411ad,1,55,0,55,1,2010-11-02 01:23:13,2010-11-02 01:23:13
07812c47a400efa34bfb95d149765afbceb411ad...515f006b6e4ddeb977580037fca6c0fbc27c3ad7,1,28,0,28,1,2010-11-02 17:09:59,2010-11-02 17:09:59
515f006b6e4ddeb977580037fca6c0fbc27c3ad7...6ce007e89a54084edd42e44a85a0c46702ad6639,1,3,2,5,2,2010-11-03 04:20:28,2010-11-03 04:20:28
6ce007e89a54084edd42e44a85a0c46702ad6639...029180a93c5752bacb2f92656d99591cb36b2259,1,1,1,2,1,2010-11-03 16:02:54,2010-11-03 16:02:19
029180a93c5752bacb2f92656d99591cb36b2259...b4def4806c50b5aa6a71376c41bb1d5cbe41d29a,2,103,13,116,4,2010-11-03 19:15:07,2010-10-15 13:48:34
b4def4806c50b5aa6a71376c41bb1d5cbe41d29a...a3750a983351f3646592d2cb831b947fb6bfbf5a,1,0,2,2,2,2010-11-06 00:38:02,2010-11-06 00:38:02
a3750a983351f3646592d2cb831b947fb6bfbf5a...07da49b095553bf440dab05072755343afbdc461,2,97,0,97,3,2010-11-07 21:07:14,2010-11-07 14:34:20
07da49b095553bf440dab05072755343afbdc461...c6029c75a4636099fc35f2e0b904385dda58eb1f,6,11,18,29,11,2010-11-08 01:22:56,2010-11-08 01:22:36
c6029c75a4636099fc35f2e0b904385dda58eb1f...8285f1286444718a3f1a9ff44290d0dfeccb0266,4,124,17,141,13,2010-11-09 23:02:18,2010-11-09 21:49:03
8285f1286444718a3f1a9ff44290d0dfeccb0266...d23643051e0f351a0c61b0de8c7769ee89cb8160,3,61,72,133,29,2010-11-11 06:12:47,2010-11-11 06:12:47
d23643051e0f351a0c61b0de8c7769ee89cb8160...06267f4d8d61d306e8bd6add207b661591fb31ea,1,2,2,4,2,2010-11-11 06:32:26,2010-11-11 06:32:26
06267f4d8d61d306e8bd6add207b661591fb31ea...4b4d4afa0ad257b54db256940399e73f3f837129,3,16,6,22,5,2010-11-12 00:34:11,2010-11-09 23:43:52
4b4d4afa0ad257b54db256940399e73f3f837129...c7b24efd21f5c02a519c429180245ed8c3c320f1,3,24,24,48,5,2010-11-12 00:34:26,2010-11-12 00:33:21
c7b24efd21f5c02a519c429180245ed8c3c320f1...d4af8a6b6ac0045620ad6da94e97a71e6e6fad52,1,18,4,22,4,2010-11-12 06:37:17,2010-11-12 06:36:39
d4af8a6b6ac0045620ad6da94e97a71e6e6fad52...564a48643bd3edc6da845e458277a54c8068d0e2,99,6813,2691,9504,690,2010-11-12 06:42:06,2010-11-12 06:42:06
564a48643bd3edc6da845e458277a54c8068d0e2...8e09b1e2e1948fe71d617d426ab2662264e60c98,1,4,20,24,5,2010-11-12 22:39:42,2010-11-12 22:37:05
8e09b1e2e1948fe71d617d426ab2662264e60c98...de6e88c4282d40bfc24093411d4c2857a1014d61,1,24,27,51,17,2010-11-13 22:26:42,2010-11-13 22:26:40
de6e88c4282d40bfc24093411d4c2857a1014d61...e5a0fbe500fa3b5f3e0c15f8d17a5d8026fac919,32,79,16,95,16,2010-11-13 22:29:59,2010-10-24 14:15:05
e5a0fbe500fa3b5f3e0c15f8d17a5d8026fac919...5d80bdb6aed3729a654c9b5839b7e4944b542410,1,11,0,11,3,2010-11-13 22:34:45,2010-11-13 11:58:24
5d80bdb6aed3729a654c9b5839b7e4944b542410...e129630e9e5df96b38ab5b15c6f3e0dee0eb93a8,2,32,18,50,20,2010-11-13 22:38:25,2010-11-11 22:08:26
e129630e9e5df96b38ab5b15c6f3e0dee0eb93a8...320e0020a2646d42bb2ab585c1780e707b94f09d,2,10,14,24,6,2010-11-13 22:59:15,2010-11-13 22:57:35
320e0020a2646d42bb2ab585c1780e707b94f09d...b842fbd602296baed1eaa871eeb11616c7ee187c,1,1,1,2,1,2010-11-13 23:02:18,2010-11-13 23:02:18
b842fbd602296baed1eaa871eeb11616c7ee187c...bc0118e519ac49248efa9a9698f4216cdef1dfbc,1,0,26,26,1,2010-11-13 23:08:09,2010-11-13 23:08:09
bc0118e519ac49248efa9a9698f4216cdef1dfbc...d787a444c5f54d468703b1d316e4e22a59ea7033,9,15,12,27,13,2010-11-13 23:19:15,2010-11-13 23:18:10
d787a444c5f54d468703b1d316e4e22a59ea7033...589e27948ba3a08651514f7d88574ad9f5200969,2,43,9,52,8,2010-11-14 09:43:30,2010-11-14 04:12:47
589e27948ba3a08651514f7d88574ad9f5200969...17595b5343b3eb9b75c71013e5f3f4cccadcbdfe,3,181,154,335,85,2010-11-14 21:52:31,2010-11-14 10:12:04
17595b5343b3eb9b75c71013e5f3f4cccadcbdfe...09e60aa435de39b4ce8c7eee88168328b3feae85,1,6,2,8,3,2010-11-14 21:52:34,2010-11-14 12:50:48
09e60aa435de39b4ce8c7eee88168328b3feae85...f9ad171085ba8834bbe73387c3a5fa53089dd93b,3,2,1,3,1,2010-11-14 21:52:34,2010-11-14 12:51:32
f9ad171085ba8834bbe73387c3a5fa53089dd93b...a6c3d7121b249867e8eaf9c6069ea5ab3cbd942d,1,41,45,86,20,2010-11-14 21:52:34,2010-11-14 12:51:57
a6c3d7121b249867e8eaf9c6069ea5ab3cbd942d...25eecd179bb50b08a97eccd80edde1b9afa124d0,1,1,1,2,1,2010-11-15 06:46:26,2010-11-15 06:46:26
25eecd179bb50b08a97eccd80edde1b9afa124d0...9996b459e15581fcbff22de2f9a2b5173fc2ba5f,4,184,43,227,31,2010-11-15 06:49:26,2010-10-26 21:41:06
9996b459e15581fcbff22de2f9a2b5173fc2ba5f...d7e7161b27f55f5ae1e7f3323c0795c2c70b4797,3,63,2,65,3,2010-11-15 07:12:43,2010-11-15 07:12:43
d7e7161b27f55f5ae1e7f3323c0795c2c70b4797...0b7fb01e677640deebf92d9756fb06fbca996cfa,1,0,3,3,1,2010-11-15 07:44:34,2010-11-15 07:44:26
0b7fb01e677640deebf92d9756fb06fbca996cfa...6b71e0b0380baeb22f877640cafc6023474d483b,9,0,2259,2259,9,2010-11-15 08:43:53,2010-11-15 08:43:53
6b71e0b0380baeb22f877640cafc6023474d483b...d39d3cec65a8ab884490a8ab7a33ddcc8883182d,1,8,0,8,1,2010-11-15 08:44:08,2010-11-15 08:40:38
d39d3cec65a8ab884490a8ab7a33ddcc8883182d...19ed02b28628a6febc68f66bd411715648a30131,1,31,34,65,27,2010-11-15 08:51:01,2010-11-15 08:51:01
19ed02b28628a6febc68f66bd411715648a30131...a375c6ae9a37db31210996a45c8646d3b32ebfe3,1,8,28,36,7,2010-11-15 19:20:49,2010-11-15 18:22:24
a375c6ae9a37db31210996a45c8646d3b32ebfe3...183f6c207793ce6e4edce544bd1819158e5ed6b7,1,1,0,1,1,2010-11-15 19:21:48,2010-11-15 19:20:35
183f6c207793ce6e4edce544bd1819158e5ed6b7...8b1082825c77cf4d2790e96a89167e26ba84425c,10,32,33,65,31,2010-11-16 02:37:27,2010-11-16 02:37:27
8b1082825c77cf4d2790e96a89167e26ba84425c...00a1d61cc860adf19c3ed3ed2e8c2789dc2c4e13,2,2,2,4,2,2010-11-16 03:06:18,2010-11-16 03:06:18
00a1d61cc860adf19c3ed3ed2e8c2789dc2c4e13...473721979d7b872e1d8885508b9299723c70398e,1,13,7,20,4,2010-11-16 03:19:01,2010-11-16 03:19:01
473721979d7b872e1d8885508b9299723c70398e...702a923da74a4c62a0635b97ccfb20021a45a760,1,4,4,8,4,2010-11-16 03:21:56,2010-11-16 03:21:56
702a923da74a4c62a0635b97ccfb20021a45a760...879a9e05486337190aadc4fead03e35f5b732bb4,1,0,0,0,0,2010-11-16 03:23:47,2010-11-16 03:23:47
879a9e05486337190aadc4fead03e35f5b732bb4...ade8cf96e0f19fab240b2a7fcf970e8b1d24d10b,3,117,133,250,29,2010-11-16 03:49:52,2010-11-14 23:50:14
ade8cf96e0f19fab240b2a7fcf970e8b1d24d10b...939fba40fd55d67f873e2edc89503029c616c17e,4,96,10,106,12,2010-11-16 03:59:21,2010-11-14 23:50:14
939fba40fd55d67f873e2edc89503029c616c17e...4144024e6b5d221d5aaf85771d17e382c79a20fe,2,20,1,21,2,2010-11-16 04:22:54,2010-11-16 04:22:54
4144024e6b5d221d5aaf85771d17e382c79a20fe...90d1e47323096b01ae78218e2ea21e7d68690cf8,2,18,16,34,6,2010-11-16 04:23:14,2010-11-16 04:23:12
90d1e47323096b01ae78218e2ea21e7d68690cf8...e5cc6388cbdfca14eadf0d89a4247db37af3e085,1,19,0,19,1,2010-11-16 04:26:46,2010-11-16 04:26:46
e5cc6388cbdfca14eadf0d89a4247db37af3e085...84a5a69d9f3ab7200ebdf763b5fa6c011fae3951,1,3,1,4,3,2010-11-16 04:34:15,2010-11-16 04:34:15
84a5a69d9f3ab7200ebdf763b5fa6c011fae3951...9bf93de53203b457e44df166abefca84b8632487,1,10,3,13,2,2010-11-16 06:18:52,2010-11-16 06:18:52
9bf93de53203b457e44df166abefca84b8632487...a01e09502e8921d08b9a6bb7f943a87761b8a71c,1,1,1,2,1,2010-11-16 06:25:09,2010-11-16 06:25:09
a01e09502e8921d08b9a6bb7f943a87761b8a71c...cf05257fb76ab41cccf8c54b923e93d6841b91ca,3,58,27,85,4,2010-11-16 23:33:21,2010-11-16 23:33:21
cf05257fb76ab41cccf8c54b923e93d6841b91ca...cea3a95f9fe6faaa504542d4f03349739d08a0f3,2,61,0,61,5,2010-11-17 00:26:55,2010-11-17 00:26:55
cea3a95f9fe6faaa504542d4f03349739d08a0f3...03fa258df7d9e642c3ccac82d27c9c8167681cce,99,2691,6813,9504,691,2010-11-17 03:14:14,2010-11-17 03:13:52
03fa258df7d9e642c3ccac82d27c9c8167681cce...ce9a54aa1fbf709dd30316af8a2f14d83150e947,4,72,9,81,5,2010-11-17 03:17:44,2010-11-17 02:46:15
ce9a54aa1fbf709dd30316af8a2f14d83150e947...c87b7b7c69c2d291b2b1070bf0818e13f409942e,1,2,2,4,1,2010-11-17 17:31:51,2010-11-17 17:31:51
c87b7b7c69c2d291b2b1070bf0818e13f409942e...17307e386ee3796fde659dfbadf7768adf879cef,1,2,1,3,1,2010-11-17 17:39:26,2010-11-17 17:39:26
17307e386ee3796fde659dfbadf7768adf879cef...241ea7e5954e4a049af85cd8d51b84202cf0ea3a,3,19,22,41,8,2010-11-17 21:22:11,2010-11-17 19:31:16
241ea7e5954e4a049af85cd8d51b84202cf0ea3a...9da29a61094e12511d628046676700e120cc0670,1,2,2,4,2,2010-11-17 22:51:06,2010-11-17 22:51:06
9da29a61094e12511d628046676700e120cc0670...d4b726a1a6e62c0d3a218d2f14a37b76d0878d4b,1,4,2,6,3,2010-11-18 00:06:17,2010-11-17 20:26:08
d4b726a1a6e62c0d3a218d2f14a37b76d0878d4b...8591057fa3b141da61849ebbb310bed96e0d03de,1,38,18,56,18,2010-11-18 00:11:51,2010-11-17 16:04:21
8591057fa3b141da61849ebbb310bed96e0d03de...8d27393aa20afe9e0cba211e08957183587540e4,3,99,102,201,23,2010-11-18 01:38:54,2010-11-18 01:26:37
8d27393aa20afe9e0cba211e08957183587540e4...9f1b27bf76dca5cba0e84c796baf6d2615ca4608,1,7,0,7,1,2010-11-18 01:50:00,2010-11-18 01:50:00
9f1b27bf76dca5cba0e84c796baf6d2615ca4608...57de0b11db75fdb4bb3ac9511602ae3c9634730c,7,3,326,329,9,2010-11-18 01:57:58,2010-11-18 01:51:07
57de0b11db75fdb4bb3ac9511602ae3c9634730c...bce092aeb84080bc4b3c8cb2e72bda4b9f712596,6,47,61,108,12,2010-11-18 02:25:14,2010-11-18 02:25:14
bce092aeb84080bc4b3c8cb2e72bda4b9f712596...5908bdab9a87a50af80e7100c3b1c52b8ecd4c85,1,1,1,2,1,2010-11-18 02:45:34,2010-11-18 02:41:36
5908bdab9a87a50af80e7100c3b1c52b8ecd4c85...2219c64a0418d0a1604631b547a644a1ff7fe5aa,1,7,3,10,3,2010-11-18 21:50:54,2010-11-18 21:50:46
2219c64a0418d0a1604631b547a644a1ff7fe5aa...57d817290649a53472664cd266d5f756e8e59e95,2,71,82,153,4,2010-11-18 23:12:31,2010-11-18 23:12:21
57d817290649a53472664cd266d5f756e8e59e95...6ff12c425e83522a72841f9966eefbe9a1eefc37,1,7,2,9,2,2010-11-18 23:18:06,2010-11-18 23:18:06
6ff12c425e83522a72841f9966eefbe9a1eefc37...57eb5cb9a0e2a1ca64599101422df3a1a9ec37df,1,1,1,2,1,2010-11-18 23:36:09,2010-11-18 18:30:47
57eb5cb9a0e2a1ca64599101422df3a1a9ec37df...8b980d729c712d2254618402f1e419ee14b85c5c,9,95,49,144,44,2010-11-18 23:41:15,2010-11-18 12:00:24
8b980d729c712d2254618402f1e419ee14b85c5c...2a750bffcc6b8c33df9f575b83979d245cd7b384,1,26,0,26,1,2010-11-19 00:22:14,2010-11-19 00:22:11
2a750bffcc6b8c33df9f575b83979d245cd7b384...df46c8e698b9400abaabd77ec836c7cdadf9735c,7,5,250,255,18,2010-11-19 00:46:37,2010-10-28 20:02:51
464f5d4e13ab5feff085be41011c8e478ac63ef8...6dbf49110b518b9c8d5d2673a6bd40de501c388e,3,220,237,457,5,2011-01-11 22:32:42,2011-01-11 22:32:42
6dbf49110b518b9c8d5d2673a6bd40de501c388e...b9540c28e998d52799a680611d4b4e60a814f978,1,10,8,18,4,2011-01-11 22:48:07,2011-01-11 20:06:58
b9540c28e998d52799a680611d4b4e60a814f978...8e461673c44cb550a7aadc20f0af6453810f1b18,1,2,1,3,1,2011-01-11 23:37:58,2011-01-11 23:37:56
8e461673c44cb550a7aadc20f0af6453810f1b18...7c0f453b7cccb04808d4c7d84b852f6d4b8be932,1,17,13,30,4,2011-01-12 00:30:01,2011-01-12 00:30:01
7c0f453b7cccb04808d4c7d84b852f6d4b8be932...82e9da9fb7fb79bf730d7c1b01cb4a46ed3d5994,1,1,1,2,1,2011-01-12 00:51:09,2011-01-12 00:51:07
82e9da9fb7fb79bf730d7c1b01cb4a46ed3d5994...86160a88079ab87b014131974697bf0320fb07e8,1,3,7,10,4,2011-01-12 00:53:05,2011-01-12 00:53:02
86160a88079ab87b014131974697bf0320fb07e8...fc634cd92c645f856cb9c773755cb0d08033517d,19,360,65,425,61,2011-01-12 02:19:22,2011-01-12 02:19:22
fc634cd92c645f856cb9c773755cb0d08033517d...1b63bd16ed56df5d03f04da6c19f9a50a451b638,1,37,1,38,2,2011-01-12 18:32:48,2011-01-12 18:32:48
1b63bd16ed56df5d03f04da6c19f9a50a451b638...72589b60ada148467caa42912585316cde0ce3e8,1,1,1,2,1,2011-01-12 18:33:10,2011-01-12 18:33:10
72589b60ada148467caa42912585316cde0ce3e8...33c33949b2965512e6e058e6e1e5c800a617d071,2,40,1,41,2,2011-01-12 18:57:03,2011-01-12 18:57:01
33c33949b2965512e6e058e6e1e5c800a617d071...5f795efd4e3d9f92183c8e83ff80ce6eb05456fd,2,59,19,78,21,2011-01-12 20:59:58,2011-01-12 20:59:58
5f795efd4e3d9f92183c8e83ff80ce6eb05456fd...5f5201db2ffaeb773f32e747d268307089156148,2,5,7,12,5,2011-01-12 21:29:45,2011-01-12 21:29:43
5f5201db2ffaeb773f32e747d268307089156148...2e5dfafcb06f769889bd4d08a07d1c53346e7be7,1,170,153,323,64,2011-01-12 21:32:06,2011-01-12 21:05:45
2e5dfafcb06f769889bd4d08a07d1c53346e7be7...f61277ecb0614e09856d7eacceb3972739b27b14,1,2,1,3,2,2011-01-13 00:07:07,2011-01-12 22:31:04
f61277ecb0614e09856d7eacceb3972739b27b14...f5fbb707b2c70053688448d2173f83644b134d70,1,1,1,2,1,2011-01-13 00:07:36,2011-01-12 22:42:21
f5fbb707b2c70053688448d2173f83644b134d70...4e1e6a2d15171bdfa23ec5f78362ce40c63d2f14,1,4,1,5,1,2011-01-13 00:43:05,2011-01-13 00:43:05
4e1e6a2d15171bdfa23ec5f78362ce40c63d2f14...09994438e58bef3c04dfb851f54fb547d9c22f02,2,148,27,175,18,2011-01-13 10:10:09,2011-01-13 10:09:03
09994438e58bef3c04dfb851f54fb547d9c22f02...29f48d48e51da1bb3a267584f0101e3b848957ae,2,14,10,24,5,2011-01-13 10:22:09,2011-01-13 10:22:09
29f48d48e51da1bb3a267584f0101e3b848957ae...cb71a7dab3043ecf7016caec2de234624e10360c,1,17,19,36,3,2011-01-13 21:32:16,2011-01-13 19:13:57
cb71a7dab3043ecf7016caec2de234624e10360c...7df8a05129c230ee0345c20c4416fac0279697a8,2,86,10,96,7,2011-01-13 21:32:16,2011-01-13 19:57:28
7df8a05129c230ee0345c20c4416fac0279697a8...d87ab5450bc09a91a741452946b68ca1df4a4add,1,76,10,86,8,2011-01-13 21:32:16,2011-01-13 20:48:20
d87ab5450bc09a91a741452946b68ca1df4a4add...533797a607fabf5d35ae786a1daed4013724c9b2,1,47,6,53,5,2011-01-13 21:32:16,2011-01-13 21:24:28
533797a607fabf5d35ae786a1daed4013724c9b2...0fa3f2febdadb09d5cd0152b55c1c7b4f6a183fa,1,18,4,22,4,2011-01-13 21:59:35,2011-01-13 21:59:32
0fa3f2febdadb09d5cd0152b55c1c7b4f6a183fa...53f29d86c0eb5e991097b24a62b5937acca682b0,1,8,0,8,1,2011-01-13 23:18:20,2011-01-13 23:18:13
53f29d86c0eb5e991097b24a62b5937acca682b0...4fa712c48f19a9c193e2d4ae8e3b7095e4e88af1,2,9,8,17,6,2011-01-13 23:29:53,2011-01-13 23:28:16
4fa712c48f19a9c193e2d4ae8e3b7095e4e88af1...860e7a7a5f423704cecfe3057c3282f32a078dd6,2,14,3,17,4,2011-01-14 00:04:33,2011-01-14 00:04:33
860e7a7a5f423704cecfe3057c3282f32a078dd6...496be457b6a2bc5b01ec13644b9c9783976159b2,1,10,0,10,1,2011-01-14 00:30:29,2011-01-14 00:30:27
496be457b6a2bc5b01ec13644b9c9783976159b2...9bcfc0745c83e5e8e60e8a4a53bab5c2d3609c60,3,0,12,12,3,2011-01-14 04:32:36,2011-01-14 04:32:14
9bcfc0745c83e5e8e60e8a4a53bab5c2d3609c60...d9087c10ad39c60b389b76c0da80bb7fbd122469,1,2,2,4,2,2011-01-16 08:33:16,2011-01-16 08:33:16
d9087c10ad39c60b389b76c0da80bb7fbd122469...f35773ad0767232aafaa9dfe9f788ca55b0a6138,1,44,0,44,1,2011-01-16 09:21:40,2011-01-16 09:21:38
f35773ad0767232aafaa9dfe9f788ca55b0a6138...c3b0d133aa5d8047bc6460b5170238887fb6f49a,1,8,2,10,4,2011-01-16 22:34:39,2011-01-16 22:34:39
c3b0d133aa5d8047bc6460b5170238887fb6f49a...f39fdf261050f37ef6c804ec012f2d03dc55e6eb,1,96,62,158,33,2011-01-16 22:51:21,2011-01-14 19:14:47
f39fdf261050f37ef6c804ec012f2d03dc55e6eb...0263f01475011691f6fbfbf32dceb28b56b69232,2,33,14,47,6,2011-01-16 22:52:55,2011-01-16 11:33:11
0263f01475011691f6fbfbf32dceb28b56b69232...b622bc6305e3c675e0edfcdbaa387d849ad0bba0,4,23,6,29,5,2011-01-16 23:12:28,2011-01-16 23:12:28
b622bc6305e3c675e0edfcdbaa387d849ad0bba0...082a4b6033df22a68518c58d320e86f688db7bda,1,2,2,4,1,2011-01-16 23:28:01,2011-01-16 23:28:01
082a4b6033df22a68518c58d320e86f688db7bda...cf2e4f44afbfb208c5976786c96ec963930323cc,221,18569,9630,28199,2482,2011-01-17 19:32:56,2011-01-17 19:32:56
cf2e4f44afbfb208c5976786c96ec963930323cc...595509bb4ccb5eb94e4bbf999482a22fc80fa2cc,1,1,1,2,1,2011-01-17 20:28:48,2011-01-17 20:12:56
595509bb4ccb5eb94e4bbf999482a22fc80fa2cc...a51063c13c602fe136302466fbe3e52c79d23b25,1,5,0,5,1,2011-01-17 21:35:11,2011-01-17 21:34:22
a51063c13c602fe136302466fbe3e52c79d23b25...86bf3309bf21231c6a248ad7753519a0ae22361f,1,2,2,4,2,2011-01-17 21:35:30,2011-01-17 21:35:01
86bf3309bf21231c6a248ad7753519a0ae22361f...b70f8aec8482a25471f2550ef97b4666815a55c8,1,1,1,2,1,2011-01-18 03:49:42,2011-01-18 02:57:14
b70f8aec8482a25471f2550ef97b4666815a55c8...dc99aa0c8ca33fd2e52cce2840c6bdab59157a0a,2,117,28,145,12,2011-01-18 03:49:54,2011-01-11 00:42:12
dc99aa0c8ca33fd2e52cce2840c6bdab59157a0a...43d75952ffc01a5edab77f8b4a745ec54ba5f7c1,1,4,18,22,4,2011-01-18 03:49:54,2011-01-17 22:38:34
43d75952ffc01a5edab77f8b4a745ec54ba5f7c1...e0f47be9d0d86a07faaf8eb74409592f2cdaecf3,13,98,62,160,53,2011-01-18 03:58:11,2011-01-17 23:22:36
e0f47be9d0d86a07faaf8eb74409592f2cdaecf3...c99962e4cdef1dfc87c5337de9dbde14df39c9a3,8,13,13,26,14,2011-01-18 03:58:29,2011-01-17 21:53:12
c99962e4cdef1dfc87c5337de9dbde14df39c9a3...0eb4c2157da0ff3a429a89badce91f4f3598af60,5,470,7,477,7,2011-01-18 03:58:30,2011-01-17 23:27:08
0eb4c2157da0ff3a429a89badce91f4f3598af60...2ce0961de181b5ccb0ff66ff3f0e1c6c417dda12,4,47,7,54,8,2011-01-18 03:58:30,2011-01-17 21:47:59
2ce0961de181b5ccb0ff66ff3f0e1c6c417dda12...5087c62f18fe0695ce7d09e7b3446fcfc6309f51,2,7,7,14,7,2011-01-18 03:58:31,2011-01-17 21:49:23
5087c62f18fe0695ce7d09e7b3446fcfc6309f51...bb3bf091d44715118709a70c2f42e69e831fee22,2,107,96,203,33,2011-01-18 03:58:32,2011-01-17 22:01:20
bb3bf091d44715118709a70c2f42e69e831fee22...6ad629895d5491036d1362c77516abc9c6bebd14,4,10,13,23,10,2011-01-18 03:58:32,2011-01-17 21:59:25
6ad629895d5491036d1362c77516abc9c6bebd14...b8879d64dd4280915e47f17142e38ce9bb220bde,1,0,9,9,2,2011-01-18 03:58:33,2011-01-17 22:30:13
b8879d64dd4280915e47f17142e38ce9bb220bde...2ec4cd552501b895c83c6871951c1a6256288c48,3,69,76,145,14,2011-01-18 22:26:32,2011-01-18 22:26:32
2ec4cd552501b895c83c6871951c1a6256288c48...b22b5e341bc1536815c7d80364be7b14cd62642d,2,57,0,57,3,2011-01-19 00:22:43,2011-01-19 00:22:43
b22b5e341bc1536815c7d80364be7b14cd62642d...4d0416caf6e9ff2f09494e1257fd714c65cf0da4,1,5,0,5,1,2011-01-19 01:56:52,2011-01-19 01:56:52
4d0416caf6e9ff2f09494e1257fd714c65cf0da4...2f6cb660094a91972e6037d2eb2982b1ed822042,2,59,3,62,3,2011-01-19 02:30:12,2011-01-19 02:03:55
2f6cb660094a91972e6037d2eb2982b1ed822042...66b418d6f30edbb2de0ceb472ed487e2f5b3f451,1,3,0,3,1,2011-01-19 06:22:50,2011-01-19 03:39:20
66b418d6f30edbb2de0ceb472ed487e2f5b3f451...39535d74df47d6f5f3fd73e15bf6b380c36e2628,1,0,0,0,0,2011-01-19 06:25:38,2011-01-19 06:25:38
39535d74df47d6f5f3fd73e15bf6b380c36e2628...cb14236bb442fa652c1f598576b868c2f878c2dd,1,2,2,4,2,2011-01-19 06:27:12,2011-01-19 06:27:12
cb14236bb442fa652c1f598576b868c2f878c2dd...4f8dd28f7e8fe6421a48e26a4c307793141b5a30,3,8,18,26,7,2011-01-19 07:22:38,2011-01-18 18:44:50
4f8dd28f7e8fe6421a48e26a4c307793141b5a30...b0eed65584187a87930577f9d6c468a93f3c9f0b,1,354,0,354,4,2011-01-19 07:22:38,2011-01-11 01:11:57
b0eed65584187a87930577f9d6c468a93f3c9f0b...4fddca09f115db89f526f1c12744fd40ce31e1ec,1,153,0,153,3,2011-01-19 07:22:38,2011-01-17 22:27:14
4fddca09f115db89f526f1c12744fd40ce31e1ec...87d898929ff18a5167ecaec32446bd64b0b07750,3,481,31,512,5,2011-01-19 07:22:38,2011-01-19 03:08:07
87d898929ff18a5167ecaec32446bd64b0b07750...0b5bf70bff86ce393de1a91d75e547a7a1feb34f,2,9,3,12,5,2011-01-19 07:22:38,2011-01-17 22:28:54
0b5bf70bff86ce393de1a91d75e547a7a1feb34f...8c9b2d1066380b3637ce77148a05127296999bf9,1,5,5,10,5,2011-01-19 07:22:38,2011-01-12 03:13:41
8c9b2d1066380b3637ce77148a05127296999bf9...4475b76535e529c8c197d90c7cb20b531d62df82,3,210,184,394,36,2011-01-19 07:22:38,2011-01-14 02:44:05
4475b76535e529c8c197d90c7cb20b531d62df82...f0bf325495e127936c6d52b76cce44dd2b71ab2f,1,6,5,11,1,2011-01-19 07:22:38,2011-01-19 03:14:42
f0bf325495e127936c6d52b76cce44dd2b71ab2f...e6e6e87463d4b1d3d8d5c129e4d008d35a1b5463,3,3,5,8,4,2011-01-19 07:22:38,2011-01-19 04:55:02
e6e6e87463d4b1d3d8d5c129e4d008d35a1b5463...b8f006ef72bb518397483d5b43111ddbcff250c8,75,4604,2076,6680,929,2011-01-19 19:06:13,2011-01-19 19:06:13
b8f006ef72bb518397483d5b43111ddbcff250c8...a61066ea1b0ab71d22cbaabac499323d49f76333,1,1,1,2,1,2011-01-19 19:06:49,2011-01-18 02:57:14
a61066ea1b0ab71d22cbaabac499323d49f76333...5895df4d0e21b00edb87165d8a79b1b4fde3d271,1,3,0,3,1,2011-01-19 19:17:25,2011-01-19 19:08:49
5895df4d0e21b00edb87165d8a79b1b4fde3d271...6e9f746a4690534e18cf04854df4acc401888fd0,1,1,1,2,1,2011-01-19 19:18:12,2011-01-19 19:18:12
6e9f746a4690534e18cf04854df4acc401888fd0...d4127717ac1bc2b5c2c601d3024a7028f29ef279,1,1,1,2,1,2011-01-19 19:33:42,2011-01-19 19:33:42
d4127717ac1bc2b5c2c601d3024a7028f29ef279...ba80d4d8a9e6141c00fe60b6fb65983a7f7b8fd9,3,24,15,39,9,2011-01-19 19:46:16,2011-01-19 19:46:14
ba80d4d8a9e6141c00fe60b6fb65983a7f7b8fd9...7c2869046ec3617d069b6076e12a3b56fec3d9cd,4,77,21,98,13,2011-01-20 00:39:32,2011-01-19 15:26:54
7c2869046ec3617d069b6076e12a3b56fec3d9cd...8ca0b9a3c5ebf04cb59f734d6e4b1a101324514e,1,6,9,15,4,2011-01-20 00:40:55,2011-01-20 00:40:55
8ca0b9a3c5ebf04cb59f734d6e4b1a101324514e...a763a4f4d9917c855922870181b67bbf64666504,1,1,1,2,1,2011-01-20 00:41:16,2011-01-20 00:41:16
a763a4f4d9917c855922870181b67bbf64666504...ae30af44cfb2f5dd18a2ed1cf49a825cce4847b0,1,17,8,25,3,2011-01-21 02:04:09,2011-01-21 02:04:09
df46c8e698b9400abaabd77ec836c7cdadf9735c...913789da3e33a0777bd26ccf022b8264521860ef,5,655,2,657,13,2010-11-19 00:47:31,2010-11-02 22:51:16
913789da3e33a0777bd26ccf022b8264521860ef...dcc547d798c11ed81f4617724a0120dad484d0ce,2,58,212,270,26,2010-11-19 00:47:37,2010-11-05 20:03:32
dcc547d798c11ed81f4617724a0120dad484d0ce...d74c5060447c01044e4122d9bcda9482bda2a351,3,12,6,18,7,2010-11-19 00:47:37,2010-11-11 22:26:41
d74c5060447c01044e4122d9bcda9482bda2a351...5ba0be61661a89fb92c784c1dbc24911eabfecd0,2,3,0,3,2,2010-11-19 00:47:37,2010-11-12 01:31:38
5ba0be61661a89fb92c784c1dbc24911eabfecd0...e1250a3333d22f003b37f66978a856e1f7ec96db,2,3,2,5,3,2010-11-19 00:47:37,2010-11-12 17:18:44
e1250a3333d22f003b37f66978a856e1f7ec96db...5a84461e46cdf4c05d6beb418645989db59a546a,1,8,4,12,2,2010-11-19 00:47:37,2010-11-12 17:54:48
5a84461e46cdf4c05d6beb418645989db59a546a...7c3c5c6861eed57c9b1a423bf0a6dab7a9f20c6a,2,17,5,22,9,2010-11-19 00:47:37,2010-11-12 19:24:30
7c3c5c6861eed57c9b1a423bf0a6dab7a9f20c6a...10ff559ec39ccb27d9f12b41960207fe493a27e7,3,21,0,21,7,2010-11-19 00:47:37,2010-11-12 19:31:39
10ff559ec39ccb27d9f12b41960207fe493a27e7...5d6a03c9fe562b80ecb6ae2b3fc34798a1235e7d,1,13,11,24,4,2010-11-19 00:47:38,2010-11-12 19:47:31
5d6a03c9fe562b80ecb6ae2b3fc34798a1235e7d...a6d84253824694b6e6ec148ec57cb344727d3a84,2,5,2,7,3,2010-11-19 00:47:38,2010-11-12 22:05:26
a6d84253824694b6e6ec148ec57cb344727d3a84...fa556a142512ab932b7359760e5e4585e4e035b6,4,63,29,92,20,2010-11-19 00:47:38,2010-11-13 00:24:53
fa556a142512ab932b7359760e5e4585e4e035b6...d3fbe3e3d141973a00722f5631f200cdf5c69c46,1,123,122,245,24,2010-11-19 00:47:38,2010-11-17 18:58:45
d3fbe3e3d141973a00722f5631f200cdf5c69c46...42357645cb322864d2dade81c6e29ecd42fc7a7f,3,7,1,8,4,2010-11-19 00:47:38,2010-11-17 19:40:43
42357645cb322864d2dade81c6e29ecd42fc7a7f...02039c9b53811cbce3b324c655f9bdfc7504813f,1,6,6,12,2,2010-11-19 00:47:38,2010-11-17 19:50:51
02039c9b53811cbce3b324c655f9bdfc7504813f...3884b4185a72d63ee0344d16390eea852e8b1f89,5,23,10,33,12,2010-11-19 00:47:38,2010-11-18 19:18:07
3884b4185a72d63ee0344d16390eea852e8b1f89...0b1214c16b4382deb67f70350240f910fe8a2114,4,28,15,43,23,2010-11-19 00:47:38,2010-11-18 19:45:32
0b1214c16b4382deb67f70350240f910fe8a2114...544877d12e24b84917d2358caedc00be1538bbe9,1,4,2,6,2,2010-11-19 00:47:38,2010-11-18 19:59:15
544877d12e24b84917d2358caedc00be1538bbe9...849792e46b36297b63e3424e4b2e183dd9f1d76f,1,5,1,6,1,2010-11-19 00:47:38,2010-11-18 20:04:33
849792e46b36297b63e3424e4b2e183dd9f1d76f...2ba3c10d6244d32a4196b59b4d46f069c7482795,1,4,1,5,3,2010-11-19 00:47:38,2010-11-18 22:19:09
2ba3c10d6244d32a4196b59b4d46f069c7482795...1f18648394d226246b231772257d62da9a06b9fa,1,2,2,4,2,2010-11-19 00:47:38,2010-11-19 00:28:10
ae30af44cfb2f5dd18a2ed1cf49a825cce4847b0...60aea96f84c850615bac7a6e00ef28fab5ae18ae,1,196,322,518,53,2011-01-21 02:10:15,2011-01-20 10:41:16
60aea96f84c850615bac7a6e00ef28fab5ae18ae...e576d4ec79ad983853d989819c78328aba0bb6f9,1,96,4,100,15,2011-01-21 02:10:15,2011-01-20 18:29:54
e576d4ec79ad983853d989819c78328aba0bb6f9...105c35b9fd66745d9b8abae77b93538873cf12ba,1,135,1,136,2,2011-01-21 02:10:15,2011-01-20 19:21:42
105c35b9fd66745d9b8abae77b93538873cf12ba...4125822bedfb84b052ead699946296ce3cfa691c,1,28,6,34,6,2011-01-21 02:10:15,2011-01-20 23:55:02
4125822bedfb84b052ead699946296ce3cfa691c...d89454e5d443ed39422fbf1c4280ba3ead842e18,2,62,3,65,12,2011-01-21 02:10:15,2011-01-21 00:25:24
d89454e5d443ed39422fbf1c4280ba3ead842e18...f46594951676de7ad8f481e85efb8bf43f8614a5,2,41,49,90,18,2011-01-21 02:10:15,2011-01-21 01:07:44
f46594951676de7ad8f481e85efb8bf43f8614a5...032f80efeaa4d4bab1d49c29f7bf15e7a6c9e20a,1,79,70,149,19,2011-01-21 02:10:15,2011-01-21 01:54:59
032f80efeaa4d4bab1d49c29f7bf15e7a6c9e20a...0866ecaf3fcda4603d8a0732e457d74248950b6b,2,1,1,2,2,2011-01-21 02:10:15,2011-01-21 01:55:13
0866ecaf3fcda4603d8a0732e457d74248950b6b...7a16e2a2a06ba88985ec62b78bd05f5257f882f3,1,4,2,6,4,2011-01-21 02:19:30,2011-01-21 02:19:30
7a16e2a2a06ba88985ec62b78bd05f5257f882f3...a86747603c3ca0713a8170157afe47a41d83bbd7,1,4,2,6,3,2011-01-21 02:24:00,2011-01-21 02:23:50
cd9515efd99dfa6510e72342a2621bb4b291a89c...296802c641783034a3d56f4eacc180191c8506cc,1,2,2,4,2,2010-11-19 00:57:46,2010-11-19 00:57:46
296802c641783034a3d56f4eacc180191c8506cc...952bbb86b5c243cc3479e8af1b1173d8854054f5,1,1,1,2,1,2010-11-19 05:47:15,2010-11-19 03:33:31
952bbb86b5c243cc3479e8af1b1173d8854054f5...9c29ac6febb128b2b6408919797ff76fe13d90f3,1,41,39,80,32,2010-11-19 18:05:41,2010-11-19 18:00:21
9c29ac6febb128b2b6408919797ff76fe13d90f3...f11291a220136164294e3cac5f09efd6c2b21be6,1,25,0,25,2,2010-11-19 18:09:01,2010-11-18 08:41:44
f11291a220136164294e3cac5f09efd6c2b21be6...cbdcc1d5f321cfff3d4d3f416e48733089de7e00,147,11695,4126,15821,1124,2010-11-19 18:49:09,2010-11-19 18:49:09
cbdcc1d5f321cfff3d4d3f416e48733089de7e00...7515360951dfeff6beee776f4a12f9d430d31165,1,1,6,7,3,2010-11-19 20:58:00,2010-11-19 20:58:00
7515360951dfeff6beee776f4a12f9d430d31165...d722c8df73f0da88b8b0ec979ae5ba417db9eba6,1,25,2,27,5,2010-11-19 21:02:14,2010-11-19 21:02:14
d722c8df73f0da88b8b0ec979ae5ba417db9eba6...15d5378684e630e341d674c7f67aecb76bd802c6,3,170,0,170,3,2010-11-19 21:28:13,2010-11-19 21:28:04
15d5378684e630e341d674c7f67aecb76bd802c6...464ced4a86e89163ec68a0c2f020720dc82b0191,1,1,5,6,2,2010-11-20 06:52:20,2010-11-20 06:52:20
464ced4a86e89163ec68a0c2f020720dc82b0191...a93634007a0c5366d415782c2a1f164a6d7ecbc5,1,11,4,15,3,2010-11-20 07:05:13,2010-11-20 07:05:13
a93634007a0c5366d415782c2a1f164a6d7ecbc5...56074d1056a4e4b7a9954f18805605d79b0a5c3a,2,7,16,23,2,2010-11-20 08:04:22,2010-11-20 08:04:22
56074d1056a4e4b7a9954f18805605d79b0a5c3a...118b88e44fc8119a32ba1d7e6507e0f9eece70e6,2,70,7,77,8,2010-11-21 04:36:14,2010-11-20 23:44:58
118b88e44fc8119a32ba1d7e6507e0f9eece70e6...d42098651bb8e3e2207c669df112e6b2fc4a4d6c,1,4,11,15,3,2010-11-21 04:45:22,2010-11-21 04:45:22
d42098651bb8e3e2207c669df112e6b2fc4a4d6c...794e7be4f8f2a4e4b99599fe743421d04b3268fc,1,5,1,6,2,2010-11-21 04:45:30,2010-11-21 04:45:30
794e7be4f8f2a4e4b99599fe743421d04b3268fc...23204979926a3f69144be182786c5d2dcf58c0c2,14,237,864,1101,75,2010-11-21 04:55:15,2010-11-21 04:49:44
23204979926a3f69144be182786c5d2dcf58c0c2...c321e9893d9eabefb125d9e4efa964603fed9dfe,1,19,6,25,7,2010-11-21 07:08:45,2010-11-21 07:08:45
c321e9893d9eabefb125d9e4efa964603fed9dfe...58902725387a87e363410519f9afb865c2c3300d,1,11,1,12,1,2010-11-21 21:58:47,2010-11-21 21:58:47
58902725387a87e363410519f9afb865c2c3300d...6063ea62dfef7dff10b850a5bc8258a2d0df30f6,1,18,1,19,16,2010-11-21 22:15:46,2010-11-21 22:13:54
6063ea62dfef7dff10b850a5bc8258a2d0df30f6...c11f3f8b0fa4378e0080f29a52bbe4c77070bea9,1,14,11,25,8,2010-11-21 22:20:22,2010-11-21 22:20:22
c11f3f8b0fa4378e0080f29a52bbe4c77070bea9...11b2ee76322c2d251d618ece286d23272ca92af5,15,98,98,196,79,2010-11-21 22:33:09,2010-11-21 22:22:34
11b2ee76322c2d251d618ece286d23272ca92af5...bb6d468dd83a3a9e59b053b706242ae7b7bf1a17,1,21,11,32,5,2010-11-21 23:06:20,2010-11-21 23:06:20
bb6d468dd83a3a9e59b053b706242ae7b7bf1a17...b1088d6bd20a9c07614871604bdd71fea6814629,1,2,4,6,1,2010-11-21 23:07:38,2010-11-21 23:07:34
b1088d6bd20a9c07614871604bdd71fea6814629...a16b3c3148554ec07ba3dd5581a6b1d2e4d62752,1,5,7,12,6,2010-11-21 23:16:02,2010-11-21 23:16:02
a16b3c3148554ec07ba3dd5581a6b1d2e4d62752...f6479f2fb62daf1f4d46e0ff4d6012995d079cd1,1,10,0,10,3,2010-11-21 23:22:08,2010-11-21 23:22:08
f6479f2fb62daf1f4d46e0ff4d6012995d079cd1...342226341467151f753814b1c1b4fbb0d8aac5d3,1,47,60,107,18,2010-11-22 02:17:44,2010-11-22 02:03:21
342226341467151f753814b1c1b4fbb0d8aac5d3...5749f9181480dc69c8e4b1d4755d50b8d9af56c7,1,34,0,34,1,2010-11-22 03:03:23,2010-11-21 05:28:19
5749f9181480dc69c8e4b1d4755d50b8d9af56c7...a87172f9b21eb36cfde9dc96cc011a33e6bb93fd,1,3,0,3,1,2010-11-22 03:07:27,2010-11-20 12:35:41
a87172f9b21eb36cfde9dc96cc011a33e6bb93fd...80b5a52217ad58b0d71993c2477a4a17bf6c84a2,2,8,6,14,5,2010-11-22 03:11:05,2010-11-20 12:35:56
80b5a52217ad58b0d71993c2477a4a17bf6c84a2...7a3971e433e3929caa15f34b8e5e29d44a0e8cbb,1,1,1,2,1,2010-11-22 03:27:23,2010-11-18 08:22:21
7a3971e433e3929caa15f34b8e5e29d44a0e8cbb...f0b8cc6a94b2e1ae7091219020c4035c5ee09673,2,46,7,53,8,2010-11-22 04:24:26,2010-11-16 14:44:06
f0b8cc6a94b2e1ae7091219020c4035c5ee09673...7b2f5ab7f8b245774572c1d06aac9f6cdc2e14fe,1,0,1,1,1,2010-11-22 04:33:04,2010-11-22 04:33:04
7b2f5ab7f8b245774572c1d06aac9f6cdc2e14fe...6aa92d5289996780834ebd5e9317718b3e55408c,1,16,2,18,3,2010-11-22 04:44:48,2010-11-17 09:41:30
6aa92d5289996780834ebd5e9317718b3e55408c...611dffabb6b6b88f7a1f4ca259d19a42f0e8359c,3,49,7,56,6,2010-11-22 04:53:57,2010-11-16 20:50:24
611dffabb6b6b88f7a1f4ca259d19a42f0e8359c...b64791c7e45b09615ea5528e104d059a85b745e6,1,1,1,2,1,2010-11-22 04:54:53,2010-11-16 20:38:13
b64791c7e45b09615ea5528e104d059a85b745e6...d695486185257533f3ef591654d2ce69dfeff74f,4,47,3,50,10,2010-11-22 05:39:14,2010-11-22 05:39:14
d695486185257533f3ef591654d2ce69dfeff74f...12554380d541d984d7ddff329d4c664ba48644d5,1,12,0,12,3,2010-11-22 05:44:23,2010-11-22 05:44:23
12554380d541d984d7ddff329d4c664ba48644d5...b52b4196ab22227aea7afef100c4ca8e2f1b8729,2,29,5,34,7,2010-11-22 19:55:31,2010-11-22 19:26:37
b52b4196ab22227aea7afef100c4ca8e2f1b8729...446beebd79d52b24bd8d9e0a44f6378a711f32b9,21,776,1,777,21,2010-11-22 21:32:49,2010-11-22 16:31:40
446beebd79d52b24bd8d9e0a44f6378a711f32b9...f123a1ab40d33dbfe35667e9357b4b03c4549ab1,1,3,0,3,2,2010-11-23 01:55:04,2010-11-23 01:55:04
f123a1ab40d33dbfe35667e9357b4b03c4549ab1...4f32a59307b15ce5c3b9d543b16ed90470b1132e,2,5,1,6,2,2010-11-23 20:20:22,2010-11-23 20:20:22
4f32a59307b15ce5c3b9d543b16ed90470b1132e...03e5da8429fb4c8b6f7f57ed31403e28c489e277,1,2,2,4,2,2010-11-23 22:09:16,2010-11-22 21:24:09
03e5da8429fb4c8b6f7f57ed31403e28c489e277...a2b3c865c92fd6394f717d06160ad01f8001ae3c,1,2,2,4,1,2010-11-23 22:09:59,2010-11-23 19:14:20
a2b3c865c92fd6394f717d06160ad01f8001ae3c...a6f6532dfbfda5723958d79aef2b0e0fc9805da8,4,42,27,69,25,2010-11-24 02:30:52,2010-11-24 02:30:52
a6f6532dfbfda5723958d79aef2b0e0fc9805da8...b57c1f51b9447b79d222f0c98b550eb6ed3f80ec,3,18,10,28,8,2010-11-24 02:46:13,2010-11-24 02:46:13
b57c1f51b9447b79d222f0c98b550eb6ed3f80ec...a530c23d96db854127afd0d92086dda2024248f0,2,77,0,77,2,2010-11-24 05:33:19,2010-11-23 06:15:04
a530c23d96db854127afd0d92086dda2024248f0...ea29cb4e46a96b6019b2d388c5e5562939d7a7f9,4,12,10,22,11,2010-11-24 05:33:19,2010-11-18 21:45:41
ea29cb4e46a96b6019b2d388c5e5562939d7a7f9...342b8b2ed21fe429187f91eb4314af54b801a5f5,1,6,6,12,1,2010-11-24 05:33:20,2010-11-23 06:53:00
342b8b2ed21fe429187f91eb4314af54b801a5f5...14e6b07f6354f0dbeabd3c723a4586bafa662cc0,4,21,1,22,5,2010-11-24 05:33:20,2010-11-23 18:27:03
14e6b07f6354f0dbeabd3c723a4586bafa662cc0...1b6b090cdc63301ccd1a2b1f3105c5bde7a73cf8,3,5,3,8,4,2010-11-24 05:33:20,2010-11-23 06:46:32
1b6b090cdc63301ccd1a2b1f3105c5bde7a73cf8...fa8ffaf9b2375f98ac86f887bf76f3aa81fa5aa4,1,11,1,12,2,2010-11-24 05:33:20,2010-11-23 06:46:56
fa8ffaf9b2375f98ac86f887bf76f3aa81fa5aa4...73318fa09d0b67a67c1033bf0bfcc0e78883f257,63,3148,6407,9555,430,2010-11-24 09:03:06,2010-11-24 09:03:06
73318fa09d0b67a67c1033bf0bfcc0e78883f257...7fcfb7b981f7898cc3c7f7d32573ad0c86f7cddf,1,2,0,2,1,2010-11-24 20:51:46,2010-11-24 17:32:58
7fcfb7b981f7898cc3c7f7d32573ad0c86f7cddf...6285fac23273c03428c66d023b2c817836fd33bd,1,1,1,2,1,2010-11-24 20:53:28,2010-11-24 16:34:53
6285fac23273c03428c66d023b2c817836fd33bd...a52f59b437d669138e27a9d04880c71b5c79a9cf,2,3,1,4,2,2010-11-27 19:36:34,2010-11-27 02:33:29
a52f59b437d669138e27a9d04880c71b5c79a9cf...102b1d999d9ea973bd033aaad66e42d673163ac4,2,130,2,132,3,2010-11-29 02:40:50,2010-11-29 02:40:30
102b1d999d9ea973bd033aaad66e42d673163ac4...8012f2cb7ad055385f95fff1ce84bd1a7ad6192c,1,2,0,2,1,2010-11-29 02:41:53,2010-11-29 02:41:53
8012f2cb7ad055385f95fff1ce84bd1a7ad6192c...be2457aaca6a5bae912a76a892952b4bd8f7b1e5,1,5,0,5,1,2010-11-29 05:03:41,2010-11-29 05:03:41
be2457aaca6a5bae912a76a892952b4bd8f7b1e5...bf89872306bc0157c1a1751f7ba5c4123fa2e7b0,3,46,30,76,34,2010-11-29 07:20:59,2010-11-29 07:20:59
bf89872306bc0157c1a1751f7ba5c4123fa2e7b0...97970b05fe37c0a0313c5e0cb2f13be9e15199a3,1,1,1,2,1,2010-11-29 07:24:32,2010-11-29 07:24:32
97970b05fe37c0a0313c5e0cb2f13be9e15199a3...105501c1958c1faff8a467c6d00ffb52457f427e,1,13,9,22,5,2010-11-29 08:10:37,2010-11-29 08:07:44
105501c1958c1faff8a467c6d00ffb52457f427e...7a7feb8cd344725a0d164b94f4500a1118c60d5b,1,17,0,17,1,2010-11-29 08:20:21,2010-11-29 08:20:21
7a7feb8cd344725a0d164b94f4500a1118c60d5b...1db59afb758fa3ad497334ce3f9422269f019d96,1,70,59,129,43,2010-11-29 16:57:40,2010-11-29 15:41:08
1db59afb758fa3ad497334ce3f9422269f019d96...6057747e9eda02d5b41385d6555f677314f5780d,1,12,11,23,12,2010-11-29 21:53:35,2010-11-29 21:53:35
6057747e9eda02d5b41385d6555f677314f5780d...85827bde344340daa7777f84db01a5a6fb8caede,1,8,2,10,3,2010-11-29 22:21:51,2010-11-29 22:21:30
85827bde344340daa7777f84db01a5a6fb8caede...735b9d50a3cb09c9a87045fce1493036fc742295,2,64,11,75,12,2010-11-29 22:21:51,2010-11-29 22:07:55
735b9d50a3cb09c9a87045fce1493036fc742295...b6face1dce050f78a905ffff789744d9404ffaba,1,0,1,1,1,2010-11-29 23:04:39,2010-11-29 23:04:36
b6face1dce050f78a905ffff789744d9404ffaba...3fceb491d4e866f6e66d265978a82b3d1df28e55,4,28,36,64,15,2010-11-30 00:19:28,2010-11-29 23:22:48
3fceb491d4e866f6e66d265978a82b3d1df28e55...711196cafa1617981b8d3aa2204db5143b9e5e03,1,2,1,3,1,2010-11-30 00:19:28,2010-11-30 00:18:08
711196cafa1617981b8d3aa2204db5143b9e5e03...bc02d47b213785f9560f4b9c5426bc16124e89c3,1,1,1,2,1,2010-11-30 01:07:25,2010-11-27 09:59:47
bc02d47b213785f9560f4b9c5426bc16124e89c3...86727b15f3f1d33a077e4044991264be74497b37,1,1,1,2,1,2010-11-30 01:07:30,2010-11-28 17:17:36
86727b15f3f1d33a077e4044991264be74497b37...02083412eb3eb673699ef9d3eef04078da8247d5,2,43,30,73,8,2010-11-30 01:22:36,2010-11-26 23:03:31
02083412eb3eb673699ef9d3eef04078da8247d5...144b2a5338e681965be2d39a0514abc3864a1046,2,41,7,48,4,2010-11-30 01:25:50,2010-11-28 06:03:14
144b2a5338e681965be2d39a0514abc3864a1046...1dbbaa7fa09e3bff48c5d7d9f6baf47fee49cc7b,1,24,0,24,1,2010-11-30 01:36:59,2010-11-30 01:36:59
1dbbaa7fa09e3bff48c5d7d9f6baf47fee49cc7b...e514f575f3461fb7d0d3c16918e36fbf83166f15,1,1,3,4,2,2010-11-30 01:43:27,2010-11-29 17:39:13
e514f575f3461fb7d0d3c16918e36fbf83166f15...22cf5a24dbc76c78acc161eec6c072263003b14e,1,3,5,8,1,2010-11-30 01:46:46,2010-11-29 18:06:15
22cf5a24dbc76c78acc161eec6c072263003b14e...645c3b37130ff5b8860868372ae3481759d7fb20,2,20,2,22,4,2010-11-30 02:17:13,2010-11-29 18:48:25
645c3b37130ff5b8860868372ae3481759d7fb20...a326eebac8388b8f8a00aaeeef8e9f5ec6d63007,1,3,0,3,1,2010-11-30 03:46:00,2010-11-30 03:46:00
a326eebac8388b8f8a00aaeeef8e9f5ec6d63007...6d7242b4851ca87944cbb6bbae3aab733f1e5cae,2,2,2,4,2,2010-11-30 03:52:47,2010-11-30 03:52:47
6d7242b4851ca87944cbb6bbae3aab733f1e5cae...aed0ba3211bf33314351572bc71b66b8b42fde87,2,3,2,5,3,2010-11-30 03:59:01,2010-11-30 03:59:01
aed0ba3211bf33314351572bc71b66b8b42fde87...9032bfce593d12fd1b779c112feed87ad406356d,1,3,1,4,2,2010-11-30 07:46:17,2010-11-18 09:37:13
9032bfce593d12fd1b779c112feed87ad406356d...99ba903d464e6291f80c767beb52f4bcda2c93f9,1,4,0,4,1,2010-11-30 07:46:30,2010-11-25 00:49:21
99ba903d464e6291f80c767beb52f4bcda2c93f9...5a36d1b86fbf9ed9bf7dce4be02db40a2f063b69,4,322,24,346,29,2010-11-30 07:46:35,2010-11-24 01:39:54
5a36d1b86fbf9ed9bf7dce4be02db40a2f063b69...d1d4695474b8ea3dcb9ccf324571da3d8b47f2d7,1,5,3,8,2,2010-11-30 07:46:40,2010-11-24 22:21:38
d1d4695474b8ea3dcb9ccf324571da3d8b47f2d7...4476ce04dc39f07edc97ca0312fdaf2492d04fe7,2,10,2,12,3,2010-11-30 07:46:46,2010-11-24 22:22:19
4476ce04dc39f07edc97ca0312fdaf2492d04fe7...4c16dd7c5c7d048ec91c30c1afb783c4b2c03a60,1,8,0,8,4,2010-11-30 07:47:48,2010-11-24 22:43:20
4c16dd7c5c7d048ec91c30c1afb783c4b2c03a60...4a329af418f768da0daa07510a581f9ed7da42aa,1,8,2,10,2,2010-11-30 07:48:34,2010-11-24 22:44:33
4a329af418f768da0daa07510a581f9ed7da42aa...fa94d55f879a8272e2bb6a008540e49df8b33753,3,822,0,822,3,2010-11-30 07:48:58,2010-11-24 23:17:59
fa94d55f879a8272e2bb6a008540e49df8b33753...5ea2a615960e4c8d0114d57129f3e577bd8904ef,1,246,0,246,1,2010-11-30 07:49:29,2010-11-24 23:34:13
5ea2a615960e4c8d0114d57129f3e577bd8904ef...db98d6e4e0c9e7adc4f2a4c335bf3b2df30b4b89,1,47,7,54,3,2010-11-30 18:55:04,2010-11-30 18:54:56
db98d6e4e0c9e7adc4f2a4c335bf3b2df30b4b89...81afb54c0aad56d65071ec1fab898f197fca21a2,1,1,1,2,1,2010-11-30 19:04:31,2010-11-30 19:04:31
81afb54c0aad56d65071ec1fab898f197fca21a2...70188499b072e2b205e2079fe093e781163bbd67,2,88,77,165,5,2010-11-30 19:18:02,2010-11-30 19:18:02
70188499b072e2b205e2079fe093e781163bbd67...486c74e72bd015ac178f881806a1d36accdcecce,1,1,1,2,1,2010-11-30 19:33:05,2010-11-30 19:33:05
486c74e72bd015ac178f881806a1d36accdcecce...7286b7952150672cded846e5eee5c533e72f3e9e,68,2767,1756,4523,186,2010-11-30 19:37:43,2010-11-30 19:34:27
7286b7952150672cded846e5eee5c533e72f3e9e...e15e214747d56b757a7ba8870f57f9b7495b2922,1,1,2,3,2,2010-11-30 19:53:51,2010-11-30 19:53:44
e15e214747d56b757a7ba8870f57f9b7495b2922...09157369b30da939a9096aa50514fe4441dbc489,1,22,12,34,8,2010-12-01 02:19:54,2010-11-30 23:59:59
09157369b30da939a9096aa50514fe4441dbc489...4b947310b2cca65f6d34e17fbe88364cb55422a0,4,3629,3589,7218,8,2010-12-01 02:19:54,2010-12-01 00:13:05
4b947310b2cca65f6d34e17fbe88364cb55422a0...ea540c94f8071acd8c21ab0955894727de3b4087,2,128,17,145,10,2010-12-01 02:19:54,2010-12-01 00:16:00
ea540c94f8071acd8c21ab0955894727de3b4087...355936dcde19c23ea6d4ccb6b87532ee38900129,2,10,1,11,2,2010-12-01 02:19:54,2010-12-01 00:28:50
355936dcde19c23ea6d4ccb6b87532ee38900129...5f3464cf4ecb6a2db66486bdd53a3698d88f0d29,2,42,2,44,3,2010-12-01 06:33:29,2010-12-01 05:20:25
5f3464cf4ecb6a2db66486bdd53a3698d88f0d29...09229820e7c0c9714ec083945639246180fb422f,1,11,3,14,4,2010-12-01 07:00:37,2010-12-01 07:00:32
09229820e7c0c9714ec083945639246180fb422f...1fe450c62c805b16905d28d0b12e8bd0d456caa5,1,1,1,2,1,2010-12-01 07:06:57,2010-12-01 07:06:57
1fe450c62c805b16905d28d0b12e8bd0d456caa5...504a80dc6d27ec1027d208c93849200a495fc9ed,2,4,4,8,4,2010-12-01 17:26:59,2010-12-01 08:46:04
504a80dc6d27ec1027d208c93849200a495fc9ed...28a86c3e567607017c9f5e302291fe8bcf9d3174,2,3,4,7,3,2010-12-01 17:27:13,2010-12-01 09:40:39
28a86c3e567607017c9f5e302291fe8bcf9d3174...855210ce0b949aa5e8b810d57ab1700b39837f3f,1,6,6,12,5,2010-12-01 17:27:13,2010-12-01 09:42:41
855210ce0b949aa5e8b810d57ab1700b39837f3f...89e398f075bf86958143378aebf5cb7bd803b5e0,1,1,1,2,1,2010-12-01 19:23:25,2010-12-01 19:23:25
89e398f075bf86958143378aebf5cb7bd803b5e0...5dab4be53ced9907ea27e7d8624a61031b31dd13,1,0,2,2,2,2010-12-01 19:31:22,2010-12-01 19:31:22
5dab4be53ced9907ea27e7d8624a61031b31dd13...c5d32b3c64ee42f1d5929492c6744a72bbf433a7,1,2,0,2,1,2010-12-01 20:32:37,2010-12-01 20:32:37
c5d32b3c64ee42f1d5929492c6744a72bbf433a7...127f17a0ea7ae8add8b9f82f3ee7b25c7e828593,2,3,7,10,4,2010-12-01 20:47:49,2010-12-01 20:47:49
127f17a0ea7ae8add8b9f82f3ee7b25c7e828593...ec1589875ce31ebd7a230aa5865f56cffb547e95,1,1,0,1,1,2010-12-01 20:52:34,2010-12-01 20:52:31
ec1589875ce31ebd7a230aa5865f56cffb547e95...d8f2880ca46b12c1e39f13c3a7e91b3bc910a98b,2,158,0,158,2,2010-12-01 21:00:17,2010-12-01 21:00:04
d8f2880ca46b12c1e39f13c3a7e91b3bc910a98b...cd48649c618655583d1060e57baed041798de4e3,1,1,1,2,1,2010-12-01 21:40:28,2010-12-01 21:40:28
cd48649c618655583d1060e57baed041798de4e3...08d8116f6b518cec8536b13659607906212324eb,1,51,52,103,6,2010-12-01 21:43:05,2010-12-01 21:43:05
08d8116f6b518cec8536b13659607906212324eb...a128451004201ce0b81269bb693c2bc43cd65aa6,46,9435,1,9436,47,2010-12-02 00:42:26,2010-12-02 00:35:46
a128451004201ce0b81269bb693c2bc43cd65aa6...db78043d52590c779911b240886e4e7cb38b859a,2,87,84,171,64,2010-12-02 00:42:31,2010-12-02 00:36:23
db78043d52590c779911b240886e4e7cb38b859a...11ea8da9c327eab58d618675a9c7b78b20d1e5bc,1,42,42,84,30,2010-12-02 00:56:03,2010-12-02 00:56:03
11ea8da9c327eab58d618675a9c7b78b20d1e5bc...ac58d3a6653425cb625684bc6ffc38ecc89646c8,3,3138,2,3140,5,2010-12-02 01:01:25,2010-12-02 01:01:19
ac58d3a6653425cb625684bc6ffc38ecc89646c8...f22c248e4c6f136981aa7afbd442a72b64c40b04,4,91,76,167,57,2010-12-02 01:29:11,2010-12-02 01:29:11
f22c248e4c6f136981aa7afbd442a72b64c40b04...09329cbb04a05d3b673eb8e84121b973b659c3e3,4,224,190,414,156,2010-12-02 01:43:30,2010-12-02 01:43:30
09329cbb04a05d3b673eb8e84121b973b659c3e3...ddbaeef1b36fc97c7bbd721e52b8b2df0cb61dfe,1,1,0,1,1,2010-12-02 04:28:17,2010-12-02 02:24:32
ddbaeef1b36fc97c7bbd721e52b8b2df0cb61dfe...e232f6e7356531bb6ab50cdf9c82386538ae2c79,8,564,556,1120,366,2010-12-02 04:28:28,2010-12-02 02:07:20
e232f6e7356531bb6ab50cdf9c82386538ae2c79...dd53ceebe4e87ed2c71486e17cdcd33af88cec59,7,144,147,291,103,2010-12-02 04:59:06,2010-12-02 04:59:06
dd53ceebe4e87ed2c71486e17cdcd33af88cec59...a1138c6f2ae1c8840caeea37526626b1c3f6f1a5,1,6,9,15,4,2010-12-02 17:21:02,2010-12-02 06:48:00
a1138c6f2ae1c8840caeea37526626b1c3f6f1a5...b46f10a11fbb5a8426c28e9113fff57cb7405958,4,32,8,40,8,2010-12-02 18:35:39,2010-11-24 06:34:50
b46f10a11fbb5a8426c28e9113fff57cb7405958...cf1811a6d3f19e8922fa205c77e216ce7981c5e3,2,9,1,10,3,2010-12-02 18:36:02,2010-11-24 07:25:41
cf1811a6d3f19e8922fa205c77e216ce7981c5e3...e681abe5cbcb58fb71baad1190135961fe39ebc7,4,35,2,37,8,2010-12-02 18:36:10,2010-11-29 18:02:06
e681abe5cbcb58fb71baad1190135961fe39ebc7...c5c1dc5ddaaaf228dc76b365a2d20a54f33aa97e,1,35,2,37,2,2010-12-02 19:07:47,2010-12-02 19:07:47
c5c1dc5ddaaaf228dc76b365a2d20a54f33aa97e...7c57eb2aec1d1f3a19e8ff6326dd1e340ae3f356,1,146,115,261,48,2010-12-02 19:46:32,2010-12-02 19:34:53
7c57eb2aec1d1f3a19e8ff6326dd1e340ae3f356...558e5ba2b0f9681633d307d6cb70fae59f1f989c,3,542,512,1054,104,2010-12-02 20:27:26,2010-12-02 20:11:23
558e5ba2b0f9681633d307d6cb70fae59f1f989c...ea9006a5bcd4e56313d7b5d18c5f585011d2d123,1,29,4,33,4,2010-12-02 23:59:35,2010-12-02 23:59:35
ea9006a5bcd4e56313d7b5d18c5f585011d2d123...712c74fc7a1b55cec2d22a86ee076292e7721396,1,6,10,16,4,2010-12-03 00:38:23,2010-12-03 00:38:23
712c74fc7a1b55cec2d22a86ee076292e7721396...da96e07bbe922fba3f6c4c7bd83fcbf4236a90da,1,1,0,1,1,2010-12-03 00:45:34,2010-12-03 00:45:34
da96e07bbe922fba3f6c4c7bd83fcbf4236a90da...33685fee48a4ebcc63af95dc597ade44ccf322f0,1,16,1,17,4,2010-12-03 00:57:16,2010-12-03 00:57:16
33685fee48a4ebcc63af95dc597ade44ccf322f0...d3532a4bf294e9cbb7e6f6edec47477310dda14b,1,2,2,4,1,2010-12-03 01:01:18,2010-12-03 01:01:08
d3532a4bf294e9cbb7e6f6edec47477310dda14b...c0d69a488380fb3cfc1fb257972730ad5c570ef9,50,483,482,965,276,2010-12-03 01:49:23,2010-12-03 01:03:18
c0d69a488380fb3cfc1fb257972730ad5c570ef9...a0e9a510b049b8593855f4be8e7b02d841b66de8,6,101,7,108,14,2010-12-03 02:06:43,2010-11-26 03:09:28
a0e9a510b049b8593855f4be8e7b02d841b66de8...e4bca198431acb420a44ea3a5dc1eaa5517159d4,1,4,0,4,2,2010-12-03 17:29:48,2010-12-03 12:40:26
e4bca198431acb420a44ea3a5dc1eaa5517159d4...e41e078159e3eb5907e53f54234ee3e1aed21bb1,1,38,30,68,8,2010-12-03 17:57:36,2010-12-03 12:45:00
e41e078159e3eb5907e53f54234ee3e1aed21bb1...c70acbb1a3b14ba1131807023f35416e2d79f72f,1,24,3,27,5,2010-12-03 20:49:25,2010-12-03 20:28:24
c70acbb1a3b14ba1131807023f35416e2d79f72f...fcc38129a3d333766fd7899eb0b45d4998e6d0a8,1,2,2,4,2,2010-12-03 23:55:03,2010-12-02 21:53:16
fcc38129a3d333766fd7899eb0b45d4998e6d0a8...c4f8f871c98fb689826ac8d763e8713739dc042b,1,8,0,8,1,2010-12-04 00:00:10,2010-12-01 22:31:20
c4f8f871c98fb689826ac8d763e8713739dc042b...8c6a7b5de4bd59a03efe90f1a02d81c16b0c12a5,1,5,5,10,3,2010-12-04 00:07:20,2010-12-03 23:49:26
8c6a7b5de4bd59a03efe90f1a02d81c16b0c12a5...e9c71954716e7046fec2290a3f2b927450aac9f9,1,42,32,74,6,2010-12-04 21:20:01,2010-12-04 19:37:35
e9c71954716e7046fec2290a3f2b927450aac9f9...5a21138e37e016c044eeb7d53ffa0ac77a5e71a1,1,1,1,2,1,2010-12-04 21:39:28,2010-12-04 21:39:28
5a21138e37e016c044eeb7d53ffa0ac77a5e71a1...fbdff52b447efd21c5a552bc47a113ffbe6e4d95,1,10,11,21,7,2010-12-04 21:40:21,2010-12-04 21:40:21
fbdff52b447efd21c5a552bc47a113ffbe6e4d95...a0159b4b295f69e5653ef96d88de579746dcfdc8,159,461,458,919,228,2010-12-04 23:58:50,2010-12-04 23:20:34
a0159b4b295f69e5653ef96d88de579746dcfdc8...92789b16e594f806dbdaee1a65c1d8440b96fc65,30,105,114,219,78,2010-12-05 00:36:21,2010-12-05 00:11:57
92789b16e594f806dbdaee1a65c1d8440b96fc65...02cc39f221980b6406dceab04c9ecafaee95a003,8,45,31,76,12,2010-12-05 00:36:21,2010-12-04 21:40:39
02cc39f221980b6406dceab04c9ecafaee95a003...e76cd5343179961b13b88417ffbd0858e6c43a0b,2,4,6,10,3,2010-12-05 02:47:32,2010-12-04 23:06:34
e76cd5343179961b13b88417ffbd0858e6c43a0b...0ce9cbab291fb533d158407471f8cc277293a27a,38,660,623,1283,355,2010-12-05 17:28:18,2010-12-04 22:45:52
0ce9cbab291fb533d158407471f8cc277293a27a...6525c0452299f2fd71869d93a5bcc6062cbb98d1,1,148,116,264,64,2010-12-05 23:26:48,2010-12-05 18:44:39
6525c0452299f2fd71869d93a5bcc6062cbb98d1...dc2b4b2a819307b2168376083f08d1bd818001f5,1,140,126,266,12,2010-12-05 23:27:01,2010-12-05 19:05:30
dc2b4b2a819307b2168376083f08d1bd818001f5...47c40bf18d393654b4f1d64ad386486c3f248942,1,30,20,50,14,2010-12-05 23:28:15,2010-12-05 19:35:41
47c40bf18d393654b4f1d64ad386486c3f248942...0665f0271e71270dc23ec5231b245adfe709a49f,80,975,878,1853,483,2010-12-05 23:41:58,2010-12-05 19:15:30
0665f0271e71270dc23ec5231b245adfe709a49f...093dfaf801a10905ba27df8cf3aa17b36ea5149a,72,1530,1427,2957,646,2010-12-05 23:42:41,2010-12-05 22:33:52
093dfaf801a10905ba27df8cf3aa17b36ea5149a...5bca100afef1e4b7c88932a855a7129c58f2dd31,4,120,41,161,26,2010-12-06 02:13:20,2010-12-04 01:07:09
5bca100afef1e4b7c88932a855a7129c58f2dd31...0b0faceb198c68669d078f00ebda0d80c3793866,5,396,403,799,11,2010-12-06 02:19:18,2010-12-06 02:19:18
0b0faceb198c68669d078f00ebda0d80c3793866...180dfca03f61e1cdda6260624b5258f33996d0de,1,1,10,11,1,2010-12-07 19:29:20,2010-12-07 19:29:10
180dfca03f61e1cdda6260624b5258f33996d0de...5b8c62f7d12c1c5a553e765ba05bbd8a7e17ee47,18,411,1,412,18,2010-12-07 19:53:41,2010-12-07 19:53:36
5b8c62f7d12c1c5a553e765ba05bbd8a7e17ee47...c30f1137121315b0d3641af6dc61e3b047f940e1,352,53660,2999,56659,2187,2010-12-07 21:56:11,2010-12-07 21:56:11
c30f1137121315b0d3641af6dc61e3b047f940e1...ee5366a4103cf0db942c715dcc19f71723f3d286,22,318,174,492,22,2010-12-08 00:36:10,2010-12-08 00:34:26
ee5366a4103cf0db942c715dcc19f71723f3d286...6bc9b2ef9206fc7e3da570db72931cc9a5e35b8e,2,14,9,23,7,2010-12-08 00:51:23,2010-12-08 00:50:30
6bc9b2ef9206fc7e3da570db72931cc9a5e35b8e...5d60b06b76b5ea213e62f7da7681ccc5aafdf786,1,12,1,13,5,2010-12-08 01:13:51,2010-12-08 01:13:51
5d60b06b76b5ea213e62f7da7681ccc5aafdf786...0ec57ea34c5e97b611ad668f1d4ce2662e4808a9,2,59,46,105,18,2010-12-08 19:27:17,2010-12-08 19:22:08
0ec57ea34c5e97b611ad668f1d4ce2662e4808a9...a0c55dfe0968dd48d80383e97b2198346ffb0dce,2,16,29,45,7,2010-12-08 19:46:19,2010-12-08 19:39:57
a0c55dfe0968dd48d80383e97b2198346ffb0dce...13b14300b9a8d08e3dc201ea0383a6a679835ccb,2,11,2,13,4,2010-12-08 19:51:41,2010-12-08 19:51:41
13b14300b9a8d08e3dc201ea0383a6a679835ccb...bb46b63e33e1261c9dc543a46cdcd3c440ff4709,1,11,0,11,1,2010-12-08 19:55:04,2010-12-08 19:55:04
bb46b63e33e1261c9dc543a46cdcd3c440ff4709...a9522316407cbafebd8fb1d48995368942adcc19,1,0,1,1,1,2010-12-08 19:55:13,2010-12-08 19:55:13
a9522316407cbafebd8fb1d48995368942adcc19...0ea0b921b7cdf682bacb2f692edd54f454da56a3,2,30,24,54,11,2010-12-08 20:05:19,2010-12-08 20:05:19
0ea0b921b7cdf682bacb2f692edd54f454da56a3...dac4d486ecb27baeedef7fd8d14d52c98629de56,2,64,50,114,18,2010-12-08 21:21:50,2010-12-08 20:49:53
dac4d486ecb27baeedef7fd8d14d52c98629de56...9a7fb3c98891a0d40565ecb90bf3a26c0a302327,2,124,0,124,2,2010-12-08 21:22:12,2010-12-08 21:22:12
9a7fb3c98891a0d40565ecb90bf3a26c0a302327...a3c91c216f8f4207b246016030a41ad43bdda544,1,13,14,27,3,2010-12-08 21:46:02,2010-12-08 21:43:42
a3c91c216f8f4207b246016030a41ad43bdda544...5a87bd168d8fbeca7d48b9ddaa3b4e8a9336719c,1,2,8,10,3,2010-12-09 00:04:21,2010-12-09 00:04:21
5a87bd168d8fbeca7d48b9ddaa3b4e8a9336719c...137c3615171cbe8cd92bdf0c9c00b724b79d7494,2,63,73,136,13,2010-12-09 08:10:27,2010-12-09 08:10:16
137c3615171cbe8cd92bdf0c9c00b724b79d7494...2ca63c8f79a9ac45e36732bc8f8e9b44179a276c,2,89,0,89,3,2010-12-09 08:38:12,2010-12-09 08:35:16
2ca63c8f79a9ac45e36732bc8f8e9b44179a276c...a473b8dafb10e4e9709c20c19a7c8bdeeddfef9e,3,30,29,59,5,2010-12-09 10:31:22,2010-12-09 10:31:22
a473b8dafb10e4e9709c20c19a7c8bdeeddfef9e...5138992f3c275a1bab1593c7468c08f1f24e96bb,2,14,8,22,4,2010-12-09 10:46:57,2010-12-09 10:35:16
5138992f3c275a1bab1593c7468c08f1f24e96bb...32e8692b0686e55954c9c5d30dde6db07b35cd01,3,141,79,220,15,2010-12-10 19:22:12,2010-12-10 19:21:47
32e8692b0686e55954c9c5d30dde6db07b35cd01...c444293be999985d23c5bf38c4f73c5531fc5d9b,2,127,16,143,5,2010-12-11 02:02:58,2010-12-11 02:02:51
c444293be999985d23c5bf38c4f73c5531fc5d9b...8ef683dead79620b8c9eacec00a39d3e02ab6a8c,2,0,0,0,0,2010-12-11 02:03:39,2010-12-11 02:03:39
8ef683dead79620b8c9eacec00a39d3e02ab6a8c...d4f1ab00d214bcb2d5ab53c6ec3b634dad7273e4,1,35,12,47,4,2010-12-11 02:25:23,2010-12-11 02:25:12
d4f1ab00d214bcb2d5ab53c6ec3b634dad7273e4...70baeba8a9021a8695716bfe104bf500cbf18048,3,19,6,25,5,2010-12-11 06:09:46,2010-12-11 06:09:46
70baeba8a9021a8695716bfe104bf500cbf18048...dc65cbd2e95f770de6dfb2786dd5a6e3bbb2e4bc,1,120,108,228,3,2010-12-11 06:29:46,2010-12-11 06:29:46
dc65cbd2e95f770de6dfb2786dd5a6e3bbb2e4bc...f1762ff815da22aaafffab7f9eba8aa2cd88604e,9,70,0,70,9,2010-12-11 08:51:20,2010-12-11 08:49:38
f1762ff815da22aaafffab7f9eba8aa2cd88604e...4f2ab03e9791c4975431f6efd9d51e1fdbf2fe51,1,1,1,2,1,2010-12-11 08:56:58,2010-12-11 08:56:58
4f2ab03e9791c4975431f6efd9d51e1fdbf2fe51...953561ab061eac781340f0418cf47753f6e3b782,2,17,22,39,4,2010-12-11 09:18:45,2010-12-11 09:18:32
953561ab061eac781340f0418cf47753f6e3b782...66767edf1276b3ceeb982f7f3ee9bb03c5aa3077,1,6,0,6,1,2010-12-11 09:21:25,2010-12-11 09:21:25
66767edf1276b3ceeb982f7f3ee9bb03c5aa3077...6636bfaa0ab3005ae50219e7ebe06fee5f50ff3f,1,79,117,196,15,2010-12-11 09:42:55,2010-12-11 09:42:34
6636bfaa0ab3005ae50219e7ebe06fee5f50ff3f...e3d1808ef0e5338dfabb6563b34d4eca8a40e2e7,4,74,71,145,47,2010-12-11 10:13:29,2010-12-11 10:13:24
e3d1808ef0e5338dfabb6563b34d4eca8a40e2e7...5bdcec67f05f759af32df75c5e8fb17abd67f6b7,1,24,0,24,2,2010-12-11 10:26:48,2010-12-11 10:26:48
5bdcec67f05f759af32df75c5e8fb17abd67f6b7...c9e5cfcc34843e32ef96b1ab8ca322c8b7ec8fbb,5,5,4,9,5,2010-12-11 10:32:48,2010-12-11 10:32:48
c9e5cfcc34843e32ef96b1ab8ca322c8b7ec8fbb...a59483bd1d63b8477ec72b44a2386f0a566c04ef,2,40,2,42,3,2010-12-11 10:45:38,2010-12-11 10:45:38
a59483bd1d63b8477ec72b44a2386f0a566c04ef...e27418ca3f1f4700a457145de899c0d67343ee77,2,25,3,28,3,2010-12-14 01:58:24,2010-12-13 22:56:16
e27418ca3f1f4700a457145de899c0d67343ee77...3d0627dc6aae4937c7542243535cade959ced2ee,1,2,1,3,1,2010-12-14 05:01:36,2010-12-12 19:13:38
3d0627dc6aae4937c7542243535cade959ced2ee...1d78159e8f8ad7f41167a38ebfa973ed055bc7b6,98,8447,7140,15587,901,2010-12-14 06:12:14,2010-12-14 06:03:33
1d78159e8f8ad7f41167a38ebfa973ed055bc7b6...7d73779446eeeb5158162a25601eb182e286f68c,2,6,2,8,3,2010-12-14 06:12:46,2010-12-14 06:04:54
7d73779446eeeb5158162a25601eb182e286f68c...1dad95a3a960c645ffec28f9ec023dad6a17c0d4,1,4,4,8,2,2010-12-14 06:13:51,2010-12-14 06:13:51
1dad95a3a960c645ffec28f9ec023dad6a17c0d4...c970968ee60555a63cecf2253b25fa0ea161b00f,3,38,6,44,5,2010-12-15 23:15:27,2010-12-15 23:15:27
c970968ee60555a63cecf2253b25fa0ea161b00f...c4161f32f5e2f36db25629b3bf2ab617e66070ae,4,52,11,63,24,2010-12-15 23:47:02,2010-12-15 23:47:02
c4161f32f5e2f36db25629b3bf2ab617e66070ae...632da2a393a633f8da432096b14bec5915480115,3,11,6,17,4,2010-12-15 23:57:41,2010-12-15 23:57:13
632da2a393a633f8da432096b14bec5915480115...ea700a8851023a1967083f22daa40f4c7a4366bf,97,7134,8472,15606,901,2010-12-16 19:52:08,2010-12-16 19:52:08
ea700a8851023a1967083f22daa40f4c7a4366bf...c6406f9e5775deb5d76baac572a3050a358beb17,3,141,79,220,15,2010-12-16 20:10:54,2010-12-10 19:21:47
c6406f9e5775deb5d76baac572a3050a358beb17...033ab7ebb6773f6831846fff1b6366adb4d798fb,1,7,0,7,2,2010-12-16 20:23:38,2010-12-16 20:22:30
033ab7ebb6773f6831846fff1b6366adb4d798fb...c9d3a81db0e795f67ae478fe2e910c7c429dff60,3,41,12,53,6,2010-12-16 22:05:13,2010-12-16 22:03:04
c9d3a81db0e795f67ae478fe2e910c7c429dff60...02aae22397fe38e70fb488195a035c913c4f71b1,2,103,1,104,2,2010-12-16 22:22:50,2010-12-16 22:22:41
02aae22397fe38e70fb488195a035c913c4f71b1...2dc17e93ee3b2a9256d775e5c61253201fdc7210,1,12,0,12,1,2010-12-16 22:25:02,2010-12-16 22:25:02
2dc17e93ee3b2a9256d775e5c61253201fdc7210...6d75c06e6425f67ec5d4e44b3c440c02ddf0d1d8,1,1,1,2,1,2010-12-17 01:37:00,2010-12-17 00:41:38
6d75c06e6425f67ec5d4e44b3c440c02ddf0d1d8...e530507cb1f7b3cc41e86fd1141c760055f9f890,1,23,0,23,1,2010-12-17 02:41:13,2010-12-17 02:40:06
e530507cb1f7b3cc41e86fd1141c760055f9f890...d0beac70f4d494c4c481281d6c8f672deae9a5d8,3,22,19,41,8,2010-12-17 02:41:13,2010-12-17 02:40:23
d0beac70f4d494c4c481281d6c8f672deae9a5d8...9eaf2329e7d1e7c2de20ab7e4461bf55b18595c2,5,30,5,35,9,2010-12-17 17:06:31,2010-12-17 03:57:41
9eaf2329e7d1e7c2de20ab7e4461bf55b18595c2...7d425a0a160e65b357ed1ad8b35dc01855b5f479,159,11579,8047,19626,1459,2010-12-17 17:47:55,2010-12-17 17:29:19
7d425a0a160e65b357ed1ad8b35dc01855b5f479...d1f36accbf473b9211b65b8c508ac76cc9c1530f,1,4,4,8,2,2010-12-17 17:50:41,2010-12-17 17:50:41
d1f36accbf473b9211b65b8c508ac76cc9c1530f...4bb914bde9f3c2d6de00853353b6b8fc9c66143a,5,51,7,58,6,2010-12-17 17:51:48,2010-12-16 20:19:45
4bb914bde9f3c2d6de00853353b6b8fc9c66143a...a8f666ebb8a77c2cb119adefa61f7efa9b76b02c,1,2,2,4,1,2010-12-17 18:10:23,2010-12-17 17:24:24
a8f666ebb8a77c2cb119adefa61f7efa9b76b02c...24aded078fd6838d2f21934e57c7cc8dfd7303d1,2,84,3,87,6,2010-12-17 21:56:47,2010-12-17 21:56:47
24aded078fd6838d2f21934e57c7cc8dfd7303d1...3cf2cbf9043573908360683c7547eae457411cab,2,28,4,32,4,2010-12-18 19:26:54,2010-12-18 19:18:33
3cf2cbf9043573908360683c7547eae457411cab...bb27885251fd8e0f5bff02e42e773e33ea37630c,1,1,0,1,1,2010-12-18 23:34:10,2010-12-18 23:34:10
bb27885251fd8e0f5bff02e42e773e33ea37630c...41d73e02a22722e9ebdfd6af47dc5ac34099055e,1,2,0,2,1,2010-12-19 00:38:32,2010-12-19 00:38:32
41d73e02a22722e9ebdfd6af47dc5ac34099055e...fca713eba45fb08d63dd677ca3163d002af15cca,1,3,0,3,1,2010-12-19 02:44:04,2010-12-19 02:44:04
fca713eba45fb08d63dd677ca3163d002af15cca...8db0bbe0dcdd77ba8e874d272fe3fe6b1a62c2bb,2,34,5,39,12,2010-12-20 19:08:51,2010-12-20 19:08:51
8db0bbe0dcdd77ba8e874d272fe3fe6b1a62c2bb...6f726cf8c7415d58acb5f6b8493fe53f272b1dd4,3,21,1,22,3,2010-12-20 21:48:44,2010-12-20 21:21:02
6eca6b1ec05c5b386121a992dc7f6502f001f052...86e687086b7a7fd452b941c454f1f86b2063c571,1,13,14,27,1,2011-01-21 03:07:19,2011-01-21 03:07:15
86e687086b7a7fd452b941c454f1f86b2063c571...e65f6b4ce1246fa32a30d4041f568acb93c7ca24,4,111,9,120,11,2011-01-21 21:13:02,2011-01-21 21:12:35
e65f6b4ce1246fa32a30d4041f568acb93c7ca24...db8736ad93231986b747e21131719fdacdf39a02,2,30,1,31,6,2011-01-21 21:21:01,2011-01-21 21:21:01
db8736ad93231986b747e21131719fdacdf39a02...b9574b995fb48219d8f4e1641f8730e10f2c9f3c,3,4,1,5,4,2011-01-21 21:47:27,2011-01-21 21:47:27
b9574b995fb48219d8f4e1641f8730e10f2c9f3c...8da7202d0bb6a092bbdc3349840a81603ce64ccd,1,12,4,16,3,2011-01-21 21:51:19,2011-01-20 23:47:55
8da7202d0bb6a092bbdc3349840a81603ce64ccd...d40af91b30113566fa3d4cf9e28972aae565fc56,2,482,482,964,2,2011-01-21 21:51:49,2011-01-21 00:52:30
d40af91b30113566fa3d4cf9e28972aae565fc56...49275524a5d33acc16eb440173f94f92d28b6352,1,7,2,9,2,2011-01-21 21:51:59,2011-01-21 18:08:48
49275524a5d33acc16eb440173f94f92d28b6352...68f2aa2715dbfda6a9ec4c007458ef66421dd6c1,2,45,2,47,5,2011-01-21 22:55:29,2011-01-21 22:53:31
68f2aa2715dbfda6a9ec4c007458ef66421dd6c1...7dfbccf9bdfe1d4d0e9df7e1be232fdb8507bda2,1,46,0,46,1,2011-01-21 23:56:27,2011-01-21 23:55:48
7dfbccf9bdfe1d4d0e9df7e1be232fdb8507bda2...4612b07604bf654bc521dd0473f82b166deb7412,1,15,4,19,6,2011-01-22 01:39:48,2011-01-22 01:39:45
4612b07604bf654bc521dd0473f82b166deb7412...76afea90cf5f5d07f5fdacc5e759a87700d2422c,1,2,0,2,2,2011-01-22 01:49:01,2011-01-22 01:48:14
76afea90cf5f5d07f5fdacc5e759a87700d2422c...6703a7f1e06d100ca560f22b6065e049dae30dce,2,2,0,2,2,2011-01-22 02:18:32,2011-01-22 02:16:56
6703a7f1e06d100ca560f22b6065e049dae30dce...bb3e71466e5240626d9d21cf791fe43e87d90011,3,17,6,23,4,2011-01-22 02:18:37,2011-01-22 01:57:04
bb3e71466e5240626d9d21cf791fe43e87d90011...7892918353409510d9d097754cf3a412994e87f6,1,2,2,4,1,2011-01-22 02:26:05,2011-01-22 02:26:05
7892918353409510d9d097754cf3a412994e87f6...8d37f80f4b582a55d229521cce83670b60300ec0,2,15,6,21,3,2011-01-23 20:02:43,2011-01-23 00:09:50
8d37f80f4b582a55d229521cce83670b60300ec0...5a49f96505e48d2a1aa3a21233976f41fe1257ce,3,334,334,668,5,2011-01-23 22:53:17,2011-01-23 22:40:56
5a49f96505e48d2a1aa3a21233976f41fe1257ce...d81afcb3a6d2ee38d731dfe97e42bff8911fcddf,2,38,0,38,2,2011-01-23 23:22:42,2011-01-23 21:43:59
d81afcb3a6d2ee38d731dfe97e42bff8911fcddf...555184663a4f1ff53e2e1d5fbe5d07753ab2b36e,1,1,1,2,1,2011-01-23 23:32:07,2011-01-23 23:32:07
555184663a4f1ff53e2e1d5fbe5d07753ab2b36e...25d0e38048592eccf15e73c26191395eb0ba85cf,3,25,0,25,3,2011-01-24 18:34:18,2011-01-24 16:26:22
25d0e38048592eccf15e73c26191395eb0ba85cf...f263b2914147c491a27ba49c8e2fe23fb3d81fd3,2,145,51,196,56,2011-01-24 18:35:41,2011-01-21 02:54:30
f263b2914147c491a27ba49c8e2fe23fb3d81fd3...9e976abad9879b473075a99ee5c66885ae7452e3,11,73,51,124,51,2011-01-24 18:55:30,2011-01-24 18:55:30
9e976abad9879b473075a99ee5c66885ae7452e3...cc5e9130bbdf3c765b8a8357fcfb0c2f21109995,1,9,0,9,3,2011-01-24 19:57:21,2011-01-24 19:57:21
cc5e9130bbdf3c765b8a8357fcfb0c2f21109995...91cc2d8c4bff5c5fbacd757f38b9a8c690dce131,2,308,236,544,70,2011-01-24 22:52:25,2011-01-24 22:15:10
91cc2d8c4bff5c5fbacd757f38b9a8c690dce131...068b733583a4f0781a8418ddf42f7912e3dd53a6,9,358,2,360,19,2011-01-25 02:59:06,2011-01-25 01:50:10
068b733583a4f0781a8418ddf42f7912e3dd53a6...f9fea12555c4d7cd63ffe8605d4fa0656e37bc9d,1,5,0,5,2,2011-01-25 04:37:15,2011-01-25 02:49:03
f9fea12555c4d7cd63ffe8605d4fa0656e37bc9d...430a7f1bed77ba1066d7b3999399ae3762226f6b,2,28,5,33,12,2011-01-25 04:42:52,2011-01-25 00:09:41
430a7f1bed77ba1066d7b3999399ae3762226f6b...07f3274ac425a55454b32caeb17f4b0d10683971,1,94,78,172,11,2011-01-25 04:43:50,2011-01-25 02:54:26
07f3274ac425a55454b32caeb17f4b0d10683971...4c5e570706c6e2a0fa2a6dbeef54553b8da07b6c,100,5959,3367,9326,985,2011-01-25 04:55:18,2011-01-25 04:55:18
4c5e570706c6e2a0fa2a6dbeef54553b8da07b6c...52f93185c783beb71535f59e478fcac8912d0c54,5,53,3,56,6,2011-01-25 05:33:30,2011-01-25 01:52:38
52f93185c783beb71535f59e478fcac8912d0c54...72dd8778b9b75836144da353aa4ee0987469240c,1,1,1,2,1,2011-01-25 06:40:06,2011-01-25 06:39:59
72dd8778b9b75836144da353aa4ee0987469240c...39ff40e5a23960862776fd68a840c36f98c9e9d9,1,222,61,283,25,2011-01-25 20:13:20,2011-01-25 06:27:31
39ff40e5a23960862776fd68a840c36f98c9e9d9...8bd7e4fad81bb62cb463831800ddde5059969f6b,1,1,0,1,1,2011-01-25 20:53:44,2011-01-25 20:53:36
8bd7e4fad81bb62cb463831800ddde5059969f6b...5ad93ab573dbe9555db0c1b9ab26de6672e7cb07,6,8,8,16,8,2011-01-25 20:56:35,2010-12-27 00:32:04
5ad93ab573dbe9555db0c1b9ab26de6672e7cb07...72bef516dc8082b4fb16c3bf26713b12d63ae6d1,1,0,1,1,1,2011-01-25 23:26:19,2011-01-25 23:26:19
72bef516dc8082b4fb16c3bf26713b12d63ae6d1...5ad00f82c6ade834e2cffddaa3293321aae18eb6,1,8,2,10,2,2011-01-25 23:50:12,2011-01-25 23:50:12
5ad00f82c6ade834e2cffddaa3293321aae18eb6...910a859b9c9d1d33611a003291b85228ddf6e5d1,1,50,0,50,1,2011-01-26 01:20:25,2011-01-25 16:03:21
910a859b9c9d1d33611a003291b85228ddf6e5d1...129217a4e92ed24eaa2dd03955d1bc0f4d4d6544,1,1,1,2,1,2011-01-26 01:35:08,2011-01-26 01:35:06
129217a4e92ed24eaa2dd03955d1bc0f4d4d6544...c70dd703016c111bf5f4a40c0b8869f423b9e327,3,30,2,32,5,2011-01-26 20:13:03,2011-01-26 08:06:22
c70dd703016c111bf5f4a40c0b8869f423b9e327...36ef5643c3a3dc1a43e80ede442d4d1cd29b6a68,2,40,2,42,3,2011-01-26 20:18:25,2011-01-26 07:36:45
36ef5643c3a3dc1a43e80ede442d4d1cd29b6a68...6cdeb3b3fd16d261efefd340ec3dd30b6a441444,4,17,5,22,5,2011-01-27 22:02:43,2011-01-27 21:14:47
6cdeb3b3fd16d261efefd340ec3dd30b6a441444...6c32e155d321e806f21ee1140e94e414f4580183,8,254,4,258,13,2011-01-27 22:06:40,2011-01-27 00:46:51
6c32e155d321e806f21ee1140e94e414f4580183...3d4a0211b6b91b27cc95dc63a1ad044719caab91,1,1,1,2,1,2011-01-27 22:22:17,2011-01-27 22:20:50
3d4a0211b6b91b27cc95dc63a1ad044719caab91...8f23583d10d1c33725c1f5b730f29b033af0b3eb,4,5,5,10,5,2011-01-27 22:24:10,2011-01-14 18:45:01
8f23583d10d1c33725c1f5b730f29b033af0b3eb...97e13748fac2fdf977ed0e8a77797a9bce96dbdf,2,2,2,4,2,2011-01-27 22:28:47,2011-01-10 21:50:46
97e13748fac2fdf977ed0e8a77797a9bce96dbdf...4ea6916974ba9a911ee521e4fd60adbc1e0e8f97,1,2,2,4,2,2011-01-27 22:37:45,2011-01-27 22:37:43
4ea6916974ba9a911ee521e4fd60adbc1e0e8f97...1a5e5130843b5eca79fce60a6c032f3d7ac61017,2,9,8,17,5,2011-01-28 00:16:22,2011-01-28 00:12:13
1a5e5130843b5eca79fce60a6c032f3d7ac61017...3a05a6eaca578cdaea19e8e23a1411de324e7d07,2,32,24,56,2,2011-01-28 00:20:31,2011-01-24 04:52:37
3a05a6eaca578cdaea19e8e23a1411de324e7d07...6e53cf8b3fdaf75c39610cdde5cd9b5210157157,1,4,3,7,2,2011-01-28 00:24:02,2011-01-28 00:24:02
6e53cf8b3fdaf75c39610cdde5cd9b5210157157...f9f0e5c75c6a6fa32dd91f242c7463d467f6dcd4,2,8,5,13,4,2011-01-28 00:38:49,2011-01-28 00:35:35
f9f0e5c75c6a6fa32dd91f242c7463d467f6dcd4...f71e4d8b431f53dc68d729b8eae3c610663e06de,1,2,1,3,2,2011-01-28 00:55:54,2011-01-28 00:55:49
f71e4d8b431f53dc68d729b8eae3c610663e06de...bfb6a67d6042ae06c28e770a75eadc37bdcaa230,7,7,6,13,7,2011-01-28 00:59:28,2011-01-28 00:59:28
bfb6a67d6042ae06c28e770a75eadc37bdcaa230...fbb74784b51701278f7bfdf1038922a02fc18632,2,3,3,6,2,2011-01-28 01:02:25,2011-01-28 01:02:25
fbb74784b51701278f7bfdf1038922a02fc18632...1f041fe73e73e69b0253deb0df58e856f3b650e1,1,6,0,6,1,2011-01-28 01:44:42,2011-01-28 01:44:42
1f041fe73e73e69b0253deb0df58e856f3b650e1...cb06abe1e586217e31907d792ef3b967936e3f77,2,17,1,18,5,2011-01-28 01:45:17,2011-01-28 01:45:17
cb06abe1e586217e31907d792ef3b967936e3f77...df5d5d63422b3624ae3c19c8d4424deacfcd9025,1,14,23,37,2,2011-01-28 03:25:08,2011-01-28 03:24:39
df5d5d63422b3624ae3c19c8d4424deacfcd9025...895968d8f8494a900cac68bfe038669119b75061,1,56,0,56,1,2011-01-28 03:27:25,2011-01-28 03:27:25
895968d8f8494a900cac68bfe038669119b75061...eb565e1ce24ab62521f9920896f4f1ad4943e168,4,11,119,130,12,2011-01-28 03:52:56,2011-01-28 03:47:17
eb565e1ce24ab62521f9920896f4f1ad4943e168...b6c66f735bf34621e0bcdfbdff47c10b6458bc7a,3,237,220,457,5,2011-01-28 03:55:52,2011-01-28 03:55:38
b6c66f735bf34621e0bcdfbdff47c10b6458bc7a...286389202febece60925123918424edb4e2f870a,1,1,2,3,1,2011-01-28 04:07:53,2011-01-28 04:07:28
286389202febece60925123918424edb4e2f870a...d8579c6afdbe868de6dffa8db78bbe4ba2d03e0e,5,46,8,54,6,2011-01-28 04:07:54,2011-01-28 03:41:07
d8579c6afdbe868de6dffa8db78bbe4ba2d03e0e...97375c475e17562a016aa4d13f94030bd0f3ae37,1,1,1,2,1,2011-01-28 05:11:56,2011-01-28 05:11:56
97375c475e17562a016aa4d13f94030bd0f3ae37...7eaa956baee9070f8a073aa5c1bff01b1b8f2f5d,117,5383,2670,8053,1220,2011-01-28 09:57:00,2011-01-28 09:56:31
7eaa956baee9070f8a073aa5c1bff01b1b8f2f5d...88947dc4f090ccf23ca297c7b692ab569f547928,1,1,1,2,1,2011-01-28 20:53:09,2011-01-18 02:57:14
88947dc4f090ccf23ca297c7b692ab569f547928...192d2e0803b5220666c0e2dfef2dade03afafada,1,5,1,6,1,2011-01-28 20:58:19,2011-01-28 20:58:19
192d2e0803b5220666c0e2dfef2dade03afafada...43d818a19cc07f347cb64eabe390b2731415ad36,1,1,1,2,1,2011-01-28 21:09:01,2011-01-28 21:09:01
43d818a19cc07f347cb64eabe390b2731415ad36...fda70b8b9096c8482d9bfda04100210a60e249bc,1,0,6,6,4,2011-01-28 21:40:41,2011-01-28 21:40:41
fda70b8b9096c8482d9bfda04100210a60e249bc...845df3cd2ef23a0d3d703a07ff6102c8cd00cc04,1,5,1,6,2,2011-01-28 22:35:20,2011-01-28 07:37:53
845df3cd2ef23a0d3d703a07ff6102c8cd00cc04...6ede26cb9cda09ef78891795a7bdf4031937ab4f,4,47,1,48,14,2011-01-31 18:41:52,2011-01-31 18:41:52
6ede26cb9cda09ef78891795a7bdf4031937ab4f...ef123600ce2c56143a52a894cec780c6180f4cc0,1,6,0,6,2,2011-01-31 18:44:08,2011-01-31 18:44:08
ef123600ce2c56143a52a894cec780c6180f4cc0...9f3a20c76d45e98c4f39463435837adebdf5d0dc,1,11,0,11,5,2011-01-31 19:01:59,2011-01-31 19:01:57
9f3a20c76d45e98c4f39463435837adebdf5d0dc...c5017851128dafc7427e24e7c07076672b53acec,2,3,3,6,4,2011-01-31 19:20:05,2011-01-31 19:19:59
c5017851128dafc7427e24e7c07076672b53acec...0634e3a8bc3f7d6d022a13f25638eb394fd9a11b,29,306,158,464,109,2011-01-31 21:19:50,2011-01-31 21:19:50
0634e3a8bc3f7d6d022a13f25638eb394fd9a11b...9526fef626c57cae3cb84fa54bbbf0e58260d850,1,1,1,2,1,2011-01-31 21:26:46,2011-01-18 02:57:14
9526fef626c57cae3cb84fa54bbbf0e58260d850...45b30a879bfec50107913baefe451055953881fb,1,29,30,59,13,2011-02-01 00:37:29,2011-02-01 00:37:18
45b30a879bfec50107913baefe451055953881fb...33e8e3d799f7b04991728218bb1c411e01ffcfe2,1,61,0,61,1,2011-02-01 00:38:05,2011-02-01 00:38:05
33e8e3d799f7b04991728218bb1c411e01ffcfe2...3e5b56850415638107a6465465c22659a91bb797,1,10,0,10,2,2011-02-01 01:29:11,2011-02-01 01:29:11
3e5b56850415638107a6465465c22659a91bb797...df6e497793381cbeca3e3bc09c007d8fe4473b74,4,185,3,188,10,2011-02-01 18:16:48,2011-01-24 07:39:54
df6e497793381cbeca3e3bc09c007d8fe4473b74...ff7fc093a1433be59dcdd7962d55e9b1d381aa5d,1,1,1,2,1,2011-02-01 18:23:03,2011-01-30 23:22:42
ff7fc093a1433be59dcdd7962d55e9b1d381aa5d...2ff593ad23e603ed2e831b12e79df2ad623188a8,3,114,82,196,51,2011-02-01 22:14:50,2011-02-01 21:00:00
2ff593ad23e603ed2e831b12e79df2ad623188a8...807fca6803bdb19964710453819624bf7d0e4216,2,25,4,29,10,2011-02-01 22:40:17,2011-02-01 22:40:15
807fca6803bdb19964710453819624bf7d0e4216...f86ec1366f71f33f3b39b769238076ca898fc619,3,20,3,23,5,2011-02-02 19:18:34,2011-02-02 17:56:32
f86ec1366f71f33f3b39b769238076ca898fc619...ee092f62caeae1acd088e2707fe15e18b992d17c,80,1898,861,2759,353,2011-02-02 19:44:25,2011-02-02 19:44:25
ee092f62caeae1acd088e2707fe15e18b992d17c...e6f14d6df572b31d63facbf0a0c313d14981d73b,1,12,12,24,9,2011-02-02 22:51:53,2011-02-02 22:51:53
e6f14d6df572b31d63facbf0a0c313d14981d73b...41b4ec7952f8bc497454fd6754fa35ebb5ff2e92,3,111,18,129,13,2011-02-02 23:34:21,2011-02-02 23:26:28
41b4ec7952f8bc497454fd6754fa35ebb5ff2e92...3e58696c07161ef84c6b12aeb7e03d271563dcb9,1,14,18,32,4,2011-02-02 23:39:03,2011-02-02 23:37:48
3e58696c07161ef84c6b12aeb7e03d271563dcb9...97f7c0645118ffb3844fec67345ad0ae7e71f6a9,3,46,13,59,11,2011-02-03 20:20:19,2011-02-03 20:17:26
97f7c0645118ffb3844fec67345ad0ae7e71f6a9...f6e5b8986f41c7a3cb2e31fdf0996e6fa402fdd6,1,2,1,3,2,2011-02-03 20:28:20,2011-02-03 20:28:20
f6e5b8986f41c7a3cb2e31fdf0996e6fa402fdd6...bc23ec8d05692aead3e227a8d4224569c6401fb9,2,13,0,13,2,2011-02-03 22:03:44,2011-02-03 22:03:44
bc23ec8d05692aead3e227a8d4224569c6401fb9...d8d627e2d4ac67daf60f43e38f7d487855f43c47,3,0,25,25,3,2011-02-03 22:05:40,2011-02-03 12:11:29
d8d627e2d4ac67daf60f43e38f7d487855f43c47...8ee9c53c77188acdadc2acce214bcc6dd610f083,1,25,9,34,2,2011-02-03 22:05:51,2011-02-03 21:35:00
8ee9c53c77188acdadc2acce214bcc6dd610f083...2f1f22ab26ed5afe3e8860f22fbf486f2e1f5d7f,1,34,25,59,4,2011-02-03 22:23:28,2011-01-28 01:55:33
2f1f22ab26ed5afe3e8860f22fbf486f2e1f5d7f...c10caca34cb0b11740e013e09c38d125591d4de3,2,40,37,77,20,2011-02-04 00:58:05,2011-02-04 00:56:54
c10caca34cb0b11740e013e09c38d125591d4de3...1a7830a92a251ae7e895945deea94cba60c54f12,1,1,1,2,1,2011-02-04 17:00:21,2011-02-04 17:00:21
1a7830a92a251ae7e895945deea94cba60c54f12...aa95e5708f240810cd434911cf029f5ee70047d8,3,5,1,6,5,2011-02-04 22:41:51,2011-02-04 22:35:14
aa95e5708f240810cd434911cf029f5ee70047d8...6329633a3e34ea9f5088757bd6c1a2c7c4c85a1e,1,5,0,5,1,2011-02-04 22:43:41,2011-02-04 22:20:24
6329633a3e34ea9f5088757bd6c1a2c7c4c85a1e...f99fc29e62c6375d1d09967c64723f3c1fbd675a,2,9,0,9,5,2011-02-04 22:49:50,2011-02-04 22:21:00
f99fc29e62c6375d1d09967c64723f3c1fbd675a...e42c74e14168af6803f3d674069ba823aa54f2dd,2,23,4,27,6,2011-02-05 02:03:26,2011-02-05 00:00:08
e42c74e14168af6803f3d674069ba823aa54f2dd...c783aefb0f3c64ba6b9681132171bc5abf3b1cd1,1,8,1,9,2,2011-02-05 02:07:00,2011-02-05 00:06:05
c783aefb0f3c64ba6b9681132171bc5abf3b1cd1...4733d0b1f08a644ecafc7a80e950fa3ac5814859,5,137,3,140,21,2011-02-05 02:07:00,2011-02-04 23:14:58
4733d0b1f08a644ecafc7a80e950fa3ac5814859...9493b7563bff31525b4080df5aeef09747782d5e,5,29,6,35,6,2011-02-05 03:35:43,2011-02-05 03:35:43
9493b7563bff31525b4080df5aeef09747782d5e...30f24bb2df212843bc5ba3b8019b2830837dc0ce,1,3,3,6,1,2011-02-05 03:54:18,2011-02-05 03:54:06
30f24bb2df212843bc5ba3b8019b2830837dc0ce...0da96cca594e2a5186fa82a61f6c7bdcf0693e5e,1,1,1,2,1,2011-02-05 07:05:25,2011-02-05 07:05:25
0da96cca594e2a5186fa82a61f6c7bdcf0693e5e...2b03ba59177fee8ad28b5be0bebd149b06f3c2a2,2,7,9,16,4,2011-02-05 10:35:44,2011-02-05 10:35:25
2b03ba59177fee8ad28b5be0bebd149b06f3c2a2...45c0faf39966250095750a2eb6173617b6da64eb,1,2,2,4,2,2011-02-07 18:52:19,2011-02-05 11:07:28
45c0faf39966250095750a2eb6173617b6da64eb...da2f4b2dc429df120188c5633ac3bd6f4a3c5373,5,53,0,53,6,2011-02-07 19:00:22,2011-01-28 01:57:45
da2f4b2dc429df120188c5633ac3bd6f4a3c5373...a98d0717e8f07e8a26f1042b20aca66f4d7a41aa,1,0,8,8,1,2011-02-07 20:50:05,2011-02-07 20:50:05
a98d0717e8f07e8a26f1042b20aca66f4d7a41aa...71a8a3b78c083bd884e68774599da3c3224a509b,3,10,1,11,5,2011-02-07 20:52:20,2011-02-05 23:02:41
71a8a3b78c083bd884e68774599da3c3224a509b...e6ede31554d2f23d1efe596bd02e8304ff0dc171,2,53,1,54,2,2011-02-07 20:59:25,2011-02-06 00:31:27
e6ede31554d2f23d1efe596bd02e8304ff0dc171...bf8f4aa9661a3bbf19836369c758abe5fa7db762,1,6,2,8,3,2011-02-07 21:11:03,2011-02-07 21:11:03
bf8f4aa9661a3bbf19836369c758abe5fa7db762...9e101f2b01ccec3653a3894cb79c1267c45b2df3,6,80,2,82,17,2011-02-07 21:35:06,2011-02-06 20:49:52
9e101f2b01ccec3653a3894cb79c1267c45b2df3...57fa247f53bccf5cb34d3dc23b8316600b4b7878,1,5,8,13,4,2011-02-07 21:46:15,2011-02-07 21:46:15
57fa247f53bccf5cb34d3dc23b8316600b4b7878...5f2e90934e523b2fe102e3e5bae3ea76535ab8b5,4,52,19,71,15,2011-02-07 22:05:06,2011-01-25 18:40:12
5f2e90934e523b2fe102e3e5bae3ea76535ab8b5...2e6a263e292ee641002336013866445fb271deb4,2,18,2,20,4,2011-02-07 22:13:18,2011-02-01 08:06:44
2e6a263e292ee641002336013866445fb271deb4...3ec030535c5a289cefbca7881da2554ef276253d,1,5,6,11,1,2011-02-07 23:14:21,2011-02-07 23:14:21
3ec030535c5a289cefbca7881da2554ef276253d...61af4207dae4e43aa16f17c77b34391bb1e3da5b,2,28,2,30,5,2011-02-07 23:30:17,2011-02-07 22:39:36
61af4207dae4e43aa16f17c77b34391bb1e3da5b...448e0f43940c1616d94353bd2323877b4814cec2,3,5,1,6,3,2011-02-08 05:11:43,2011-02-08 05:11:43
448e0f43940c1616d94353bd2323877b4814cec2...6b50a9f5f4a7d0aea82c2b1f8b2b88d5568be4e1,1,3,1,4,3,2011-02-08 05:15:58,2011-02-08 05:15:58
6b50a9f5f4a7d0aea82c2b1f8b2b88d5568be4e1...38d8cd60ea168d28349e041dc0f2a0bf853c2497,1,10,12,22,5,2011-02-08 22:30:24,2011-02-08 21:56:03
38d8cd60ea168d28349e041dc0f2a0bf853c2497...9de5043b506f9da8cd136e2acd55462030b21fcf,1,22,5,27,12,2011-02-09 01:29:33,2011-02-09 01:29:33
9de5043b506f9da8cd136e2acd55462030b21fcf...9bed5dcb2c58e9169ec44bcec44b47fd92b67e37,3,109,24,133,25,2011-02-09 02:02:59,2011-02-09 00:54:25
9bed5dcb2c58e9169ec44bcec44b47fd92b67e37...519dc2c114c650e4278aeb9373d74a702bcda8ef,2,53,17,70,15,2011-02-09 05:15:55,2011-02-09 05:15:46
519dc2c114c650e4278aeb9373d74a702bcda8ef...36846f9b6b272b60aa19f86470655da061737358,5,22,25,47,18,2011-02-09 05:21:39,2011-02-09 02:30:03
36846f9b6b272b60aa19f86470655da061737358...8d70294c31da06ff04279e47739c57a1b57cd5aa,1,1,1,2,1,2011-02-09 05:24:30,2011-02-09 03:07:18
8d70294c31da06ff04279e47739c57a1b57cd5aa...56ab929c55ff59a54819cae9e9e83df843e62e46,2,12,18,30,6,2011-02-09 09:30:31,2011-02-09 09:30:31
56ab929c55ff59a54819cae9e9e83df843e62e46...a48a0755358d322f4a593d09c331432c10a500bc,2,17,6,23,6,2011-02-09 18:23:26,2011-02-09 18:23:26
a48a0755358d322f4a593d09c331432c10a500bc...a0702b54d1db35a6006644882c0b5420d8670958,135,5878,1766,7644,914,2011-02-09 18:24:26,2011-02-09 18:24:26
a0702b54d1db35a6006644882c0b5420d8670958...dafd6d913747295efdc12aa12613a30703ef0f60,1,3,1,4,2,2011-02-09 21:27:23,2011-02-09 21:27:15
dafd6d913747295efdc12aa12613a30703ef0f60...46513483cd96438f33a67fb870b784d1d1f55dd0,9,89,3,92,13,2011-02-09 22:24:22,2011-02-09 21:28:30
46513483cd96438f33a67fb870b784d1d1f55dd0...81b4d4535472533e9e3919f5460ab2b0967ea4b1,2,6,4,10,4,2011-02-09 22:35:08,2011-02-09 21:52:29
81b4d4535472533e9e3919f5460ab2b0967ea4b1...35e32225d122b063713dead992068d38b687ad04,1,1,1,2,1,2011-02-09 22:53:15,2011-01-18 02:57:14
35e32225d122b063713dead992068d38b687ad04...ff39d413a3c14bec2d997570e26df61d372a4001,1,260,53,313,21,2011-02-10 01:34:21,2011-02-09 21:56:59
ff39d413a3c14bec2d997570e26df61d372a4001...43bc1d7ec89031c50f799a7b0964dcc22d24129c,1,32,44,76,12,2011-02-10 01:48:22,2011-02-10 01:48:22
43bc1d7ec89031c50f799a7b0964dcc22d24129c...8cd07bb273cea024fd70a3349a8e2f8b6c25d79f,1,124,46,170,19,2011-02-10 01:51:05,2011-02-10 01:51:05
8cd07bb273cea024fd70a3349a8e2f8b6c25d79f...778fb859c640f1cb67d11ce4550758b6bae31b43,25,132,128,260,45,2011-02-10 02:30:47,2011-02-10 02:10:55
778fb859c640f1cb67d11ce4550758b6bae31b43...e9257b859d6bbeb68b47abf03741bc5378538b05,9,232,15,247,36,2011-02-10 02:50:26,2011-02-10 02:50:26
e9257b859d6bbeb68b47abf03741bc5378538b05...67e352e4b1ad11c674c3e79a4a6e1d9bb159fcc6,1,3,3,6,3,2011-02-10 03:07:19,2011-02-10 03:07:17
67e352e4b1ad11c674c3e79a4a6e1d9bb159fcc6...fd013d17a21bbf7675d3bef59b2a76a58cb311f5,5,790,1,791,7,2011-02-10 03:13:31,2011-02-10 03:02:59
fd013d17a21bbf7675d3bef59b2a76a58cb311f5...583f2e599962f2664dbaafa0ae98a8d6c1242441,3,3,4,7,3,2011-02-10 05:55:59,2011-02-10 04:24:39
583f2e599962f2664dbaafa0ae98a8d6c1242441...634e7236f7456432107d05fe8ec5f8da19a6abe4,3,35,0,35,3,2011-02-10 07:04:35,2011-02-10 07:02:51
634e7236f7456432107d05fe8ec5f8da19a6abe4...01a864a29d64119054401784cd9255c3a813bdbc,19,186,70,256,37,2011-02-10 08:49:15,2010-11-23 18:00:42
01a864a29d64119054401784cd9255c3a813bdbc...b09c5889bee8388a6710ecf75d76ca242e0684bd,3,269,12,281,14,2011-02-10 10:31:41,2011-02-10 10:18:13
b09c5889bee8388a6710ecf75d76ca242e0684bd...eb155ea6f6a6aa341aa8c731dca8da545c6a4008,7,137,12,149,9,2011-02-10 10:40:11,2011-02-10 09:45:15
eb155ea6f6a6aa341aa8c731dca8da545c6a4008...485ce139fd6ce8d530c6a60a7220e9b208f85cba,1,2,2,4,1,2011-02-14 17:36:02,2011-02-10 12:58:54
485ce139fd6ce8d530c6a60a7220e9b208f85cba...5ceefec8206cf7635e25b16a12679d5e6690f5f0,1,2,0,2,1,2011-02-14 17:36:08,2011-02-10 12:58:33
5ceefec8206cf7635e25b16a12679d5e6690f5f0...c6712ced2031e4dbed3b8c365a2d4073329171a5,1,2,1,3,1,2011-02-14 17:36:28,2011-02-14 17:36:28
c6712ced2031e4dbed3b8c365a2d4073329171a5...fe838611f6d768a6b400e9ff13fabd07ffe47b6a,2,53,8,61,11,2011-02-14 21:40:31,2011-02-11 00:29:34
fe838611f6d768a6b400e9ff13fabd07ffe47b6a...f07041e6cd26b3e3617deccf6d8df86cb7c9d750,1,3,0,3,1,2011-02-14 21:43:22,2011-02-11 23:53:22
6f726cf8c7415d58acb5f6b8493fe53f272b1dd4...1a894b39b3c622e7c7d228c049e68b65e4334ee5,67,1850,971,2821,572,2010-12-21 18:24:08,2010-12-21 18:24:08
1a894b39b3c622e7c7d228c049e68b65e4334ee5...b202483e4775cec9168d1077ef00bb3a11b40881,1,1,0,1,1,2010-12-21 18:46:58,2010-12-21 03:08:41
b202483e4775cec9168d1077ef00bb3a11b40881...d793fcaabd788a7b3c9af39a4c83360c1f6e3924,1,4,1,5,1,2010-12-21 20:02:51,2010-12-21 20:02:51
d793fcaabd788a7b3c9af39a4c83360c1f6e3924...23cf938e4f7272635a50f8be9a5d99d40d60e0da,3,24,9,33,5,2010-12-21 20:41:57,2010-12-21 17:42:52
23cf938e4f7272635a50f8be9a5d99d40d60e0da...4227e9d79decac90f1aeff633fc9c3c39843be9e,1,1,1,2,1,2010-12-21 23:41:22,2010-12-21 23:40:10
4227e9d79decac90f1aeff633fc9c3c39843be9e...d02131d206d0012511cc068a70d15ffe59162f31,1,6,0,6,2,2010-12-22 18:24:47,2010-12-22 18:24:34
d02131d206d0012511cc068a70d15ffe59162f31...4b555091e42ec5e9d9568abead5011dea6c0be9b,1,44,26,70,6,2010-12-22 18:29:28,2010-12-17 23:26:58
4b555091e42ec5e9d9568abead5011dea6c0be9b...b38f4712c415d765d99fb9108b057d87e60242f4,1,2,2,4,4,2010-12-22 18:32:20,2010-12-21 21:52:07
b38f4712c415d765d99fb9108b057d87e60242f4...0d58353d66290c7138d5e96829e722772f8ca452,1,3,1,4,2,2010-12-22 18:33:46,2010-12-20 17:15:20
0d58353d66290c7138d5e96829e722772f8ca452...d75c338dd6e9afe09356870cde456fd0c0e87e76,14,932,44,976,62,2010-12-22 19:01:25,2010-12-22 18:55:47
d75c338dd6e9afe09356870cde456fd0c0e87e76...1f7026e2a0b6033595ff4c8e6e8098f6267935a0,1,5,0,5,2,2010-12-23 00:12:18,2010-12-05 14:10:05
1f7026e2a0b6033595ff4c8e6e8098f6267935a0...e03fae1447b6c1f2bd34da9a6218d124704abdc6,3,18,14,32,5,2010-12-23 00:12:39,2010-12-08 01:06:52
e03fae1447b6c1f2bd34da9a6218d124704abdc6...ae8262a176cfe47cf4a506433abe83d28ab97fe8,4,40,4,44,8,2010-12-23 00:12:49,2010-12-08 21:37:28
ae8262a176cfe47cf4a506433abe83d28ab97fe8...b2fd88ef7a24ac4ccb6d329e39b2d34ec8260697,2,3,3,6,3,2010-12-23 03:49:04,2010-12-21 04:35:40
b2fd88ef7a24ac4ccb6d329e39b2d34ec8260697...8275d7cd346d32939e10300bef39ca326c288acc,2,24,30,54,12,2010-12-23 17:52:04,2010-12-23 13:06:03
8275d7cd346d32939e10300bef39ca326c288acc...54b1f8028aceff9b3c3adcbe6e41def37dd1b890,1,1,1,2,2,2010-12-25 07:50:33,2010-12-23 21:49:55
54b1f8028aceff9b3c3adcbe6e41def37dd1b890...e3ce73a2145cb4e44a0a9ffeef78e22f3e91f21f,1,31,3,34,4,2010-12-30 09:35:01,2010-12-30 09:34:31
6f726cf8c7415d58acb5f6b8493fe53f272b1dd4...2463dbb3fd2133d56c8a3c683361f46240bcd4bb,1,4,0,4,1,2010-12-20 22:49:56,2010-11-24 22:46:22
2463dbb3fd2133d56c8a3c683361f46240bcd4bb...13699c1b3398ac711fb4e29dac0a7713974aa9cb,1,2,1,3,1,2010-12-20 22:50:26,2010-11-25 00:44:41
13699c1b3398ac711fb4e29dac0a7713974aa9cb...62af617f84a447473319eb7f0de836b953d147a3,2,12,3,15,2,2010-12-20 22:50:26,2010-11-24 22:19:23
62af617f84a447473319eb7f0de836b953d147a3...dae9752973af7a37c7b2d90a5507213084a73ab8,1,4,0,4,1,2010-12-20 22:50:27,2010-11-24 23:39:46
dae9752973af7a37c7b2d90a5507213084a73ab8...e98a06d90f090ac56e734b213159ca84af9af0b4,2,15,8,23,10,2010-12-20 22:50:28,2010-11-24 23:42:33
e98a06d90f090ac56e734b213159ca84af9af0b4...63bff5434d923ca94d527309a0551b31c32395ad,1,6,80,86,4,2010-12-20 22:50:28,2010-11-24 23:43:26
63bff5434d923ca94d527309a0551b31c32395ad...0b54514a86f746e75ff0d922ed3ab758de8caa0c,2,4,4,8,4,2010-12-20 22:50:29,2010-11-24 23:45:11
0b54514a86f746e75ff0d922ed3ab758de8caa0c...8a3132a4062e4c90e1727b1654a0261e9379a1d4,2,2,2,4,2,2010-12-20 22:50:30,2010-11-24 23:47:42
8a3132a4062e4c90e1727b1654a0261e9379a1d4...b85c4c445bb1ee37bd04a083130aa4624944e392,1,21,0,21,1,2010-12-20 22:50:30,2010-11-24 23:54:14
b85c4c445bb1ee37bd04a083130aa4624944e392...518fa2e29a6a83541d3a6875e26e276d71704a03,2,76,0,76,3,2010-12-20 22:50:31,2010-11-24 23:59:40
518fa2e29a6a83541d3a6875e26e276d71704a03...ae8906e7d1cdf853df5fcc51cebeb381bf39c516,1,1,0,1,1,2010-12-20 22:50:32,2010-11-25 00:02:05
ae8906e7d1cdf853df5fcc51cebeb381bf39c516...a177d60e2b8ab0969e9fa8d52af3a6aa294a2361,1,8,3,11,3,2010-12-20 22:50:33,2010-11-25 00:02:55
a177d60e2b8ab0969e9fa8d52af3a6aa294a2361...4a42e408d2209de51bf6913a39d8775b88a75738,1,11,0,11,2,2010-12-20 22:50:33,2010-11-25 00:03:51
4a42e408d2209de51bf6913a39d8775b88a75738...dcc350889094f66bfe6ca39a704f91490ce2b3e7,1,3,0,3,2,2010-12-20 22:50:34,2010-11-25 00:04:31
dcc350889094f66bfe6ca39a704f91490ce2b3e7...30bab52741910d2d2634463d9bf2b0afe49ad11a,1,24,1,25,14,2010-12-20 22:50:35,2010-11-25 00:09:06
30bab52741910d2d2634463d9bf2b0afe49ad11a...6d1af51de629e95cfc960ccb00e80f68a8cb1451,1,5,1,6,1,2010-12-20 22:50:35,2010-11-25 00:09:33
6d1af51de629e95cfc960ccb00e80f68a8cb1451...b4510d57dc7b36d8384d6653d84f034001051909,2,6,0,6,4,2010-12-20 22:50:36,2010-11-25 00:11:14
b4510d57dc7b36d8384d6653d84f034001051909...81b26dc55589fb6a11b9076f73597bc5e9939344,2,6,0,6,4,2010-12-20 22:50:37,2010-11-25 00:13:23
81b26dc55589fb6a11b9076f73597bc5e9939344...cd921c2c62cc5ab4d79ed403f8f646566b8ac526,1,9,0,9,5,2010-12-20 22:50:37,2010-11-25 00:13:52
cd921c2c62cc5ab4d79ed403f8f646566b8ac526...cbf73fcccd263c7f7a61d540de0ee3f0eb5e6564,1,12,7,19,5,2010-12-20 22:50:38,2010-11-25 00:19:13
cbf73fcccd263c7f7a61d540de0ee3f0eb5e6564...7a1917d86fc5fa377a64317a37ab57cf3382b4b3,1,11,0,11,4,2010-12-20 22:50:39,2010-11-25 00:20:08
7a1917d86fc5fa377a64317a37ab57cf3382b4b3...a85a77626846894aa5f5119ac9a35b6d2c9ec5c4,1,27,1,28,15,2010-12-20 22:50:39,2010-11-25 00:21:30
a85a77626846894aa5f5119ac9a35b6d2c9ec5c4...c7f0341d887eb23552778a193748c64660a03a3b,1,4,0,4,1,2010-12-20 22:50:40,2010-11-25 00:23:07
c7f0341d887eb23552778a193748c64660a03a3b...fae7b81589337c87536252fe690e478e180f21e7,1,7,0,7,1,2010-12-20 22:50:41,2010-11-25 00:24:59
fae7b81589337c87536252fe690e478e180f21e7...8fc3bac868dc7fcaa1a5760e4f3e1497c54ff577,1,6,0,6,3,2010-12-20 22:50:41,2010-11-25 00:25:25
8fc3bac868dc7fcaa1a5760e4f3e1497c54ff577...f9a74a2327f1a45e3da517e5c222b3e37464093d,1,4,0,4,2,2010-12-20 22:50:42,2010-11-25 00:25:46
f9a74a2327f1a45e3da517e5c222b3e37464093d...51c686728091657d9f16625c1c8500d4b987df81,1,2,0,2,2,2010-12-20 22:50:43,2010-11-25 00:26:19
51c686728091657d9f16625c1c8500d4b987df81...1937c5e3c14822045f1b7559ad2cd879ecc148ad,1,16,0,16,16,2010-12-20 22:50:43,2010-11-25 00:27:37
1937c5e3c14822045f1b7559ad2cd879ecc148ad...6e54f416ad1a04863da1aff304d17e1443d5e281,1,11,4,15,2,2010-12-20 22:50:44,2010-11-25 00:40:17
6e54f416ad1a04863da1aff304d17e1443d5e281...d7de459b80cceaa84827c3e87569d174c2307c9c,1,2,2,4,2,2010-12-20 22:50:45,2010-11-25 00:40:42
d7de459b80cceaa84827c3e87569d174c2307c9c...3947269f97ddd35388220be741160dac62bb8e64,1,12,0,12,1,2010-12-20 22:50:45,2010-11-25 00:41:28
3947269f97ddd35388220be741160dac62bb8e64...276b0b174e6a99e9d04b37b898da3b00e7d16ccb,1,6,1,7,1,2010-12-20 22:50:46,2010-11-25 00:43:33
276b0b174e6a99e9d04b37b898da3b00e7d16ccb...d56e1a3fcdd3e8c5af5c42389318126024ea7a1f,1,2,2,4,2,2010-12-20 22:50:47,2010-11-25 00:45:32
d56e1a3fcdd3e8c5af5c42389318126024ea7a1f...6f08fdbcca61b6cf2c9555717e12b124782b42b4,1,5,3,8,3,2010-12-20 22:51:05,2010-11-25 00:48:41
6f08fdbcca61b6cf2c9555717e12b124782b42b4...f37cc8720b4e80730fdd3d5a7a7131c39c7b56f9,1,4,0,4,1,2010-12-20 22:51:06,2010-11-25 00:50:28
f37cc8720b4e80730fdd3d5a7a7131c39c7b56f9...1d0193a7334379c0b7fbe750e950b4fe34e86bcc,2,2,2,4,2,2010-12-20 22:51:07,2010-11-25 00:55:29
1d0193a7334379c0b7fbe750e950b4fe34e86bcc...3216f08b6d9b24ed25227e2b7da9e435f263cff6,1,2,0,2,1,2010-12-20 22:51:07,2010-11-25 00:57:15
3216f08b6d9b24ed25227e2b7da9e435f263cff6...9a9edb0e8e6120b3b8a3868d0c44577111dd1857,1,5,0,5,1,2010-12-20 22:51:08,2010-11-24 22:51:32
9a9edb0e8e6120b3b8a3868d0c44577111dd1857...9f9332963afeb21914812c25dca49973a99f377c,1,16,6,22,2,2010-12-20 22:51:09,2010-11-25 01:14:53
9f9332963afeb21914812c25dca49973a99f377c...6e522fb27bd7ebf0d0bb7c569e13b1d7e71ddf9e,2,20,2,22,2,2010-12-20 22:51:10,2010-11-25 03:59:52
6e522fb27bd7ebf0d0bb7c569e13b1d7e71ddf9e...51300f36d6d09b1f51c81514fff8644df0e79eee,1,3,2,5,3,2010-12-20 22:51:10,2010-11-25 04:03:39
51300f36d6d09b1f51c81514fff8644df0e79eee...13fb6f7fa17f3a915c25d594f4a1b638ad64f5fe,1,79,6,85,23,2010-12-20 22:51:11,2010-11-25 04:05:35
13fb6f7fa17f3a915c25d594f4a1b638ad64f5fe...8b9f7c6eb2452c31613c25d165fcb2c35562805a,1,30,0,30,4,2010-12-20 22:51:12,2010-11-25 04:06:31
8b9f7c6eb2452c31613c25d165fcb2c35562805a...03a74efb16882061c9e5e8bf7cc88d7b56002c36,2,6,6,12,6,2010-12-20 22:51:12,2010-11-25 04:19:08
03a74efb16882061c9e5e8bf7cc88d7b56002c36...b0f048e97097ae17c5e8679a45054aa29e75f821,1,0,240,240,1,2010-12-20 22:51:13,2010-11-25 05:00:44
b0f048e97097ae17c5e8679a45054aa29e75f821...1361e87e8074e9cb129bb7a0e7b69d3c29f4da2e,1,7,5,12,3,2010-12-20 22:51:14,2010-11-25 15:08:24
1361e87e8074e9cb129bb7a0e7b69d3c29f4da2e...f48c36f74f98c606d2770259a4c950f8f9fd3329,2,21,9,30,7,2010-12-20 22:51:14,2010-11-26 00:23:04
f48c36f74f98c606d2770259a4c950f8f9fd3329...967b7b0d8cd48a6ec87ff9512987f845a5b4ed52,2,13,1,14,2,2010-12-20 22:51:15,2010-11-26 00:24:04
967b7b0d8cd48a6ec87ff9512987f845a5b4ed52...bea5e6eff6b2a9104da504cca0db01ed15cb90ae,2,0,6,6,4,2010-12-20 22:51:16,2010-11-26 00:27:14
bea5e6eff6b2a9104da504cca0db01ed15cb90ae...0580f9a9bfc96468e528237d28cbf5a06f22ccd9,1,51,0,51,1,2010-12-20 22:51:16,2010-11-26 01:10:04
0580f9a9bfc96468e528237d28cbf5a06f22ccd9...cecc35130369e485229bb75c4223000ffd060755,1,15,3,18,7,2010-12-20 22:51:17,2010-11-26 01:40:39
cecc35130369e485229bb75c4223000ffd060755...2d39e1341c156cb05bb594d76e5f963f7d8bdefb,1,11,7,18,7,2010-12-20 22:51:18,2010-11-26 02:03:01
2d39e1341c156cb05bb594d76e5f963f7d8bdefb...a807ac6660f246347084013b116cefed9329794e,1,27,14,41,11,2010-12-20 22:51:18,2010-11-26 02:06:12
a807ac6660f246347084013b116cefed9329794e...46dc393ff1716312e770045696909b9f688666f8,1,3,3,6,4,2010-12-20 22:51:19,2010-11-26 02:19:30
46dc393ff1716312e770045696909b9f688666f8...e85733a80ba624a45abda29d941614bdd778529e,1,7,2,9,2,2010-12-20 22:51:20,2010-11-26 02:27:44
e85733a80ba624a45abda29d941614bdd778529e...3c3d1d31c56ece6cebf56317403b8cc60cd349fe,4,9,6,15,5,2010-12-20 22:51:21,2010-11-26 03:10:39
3c3d1d31c56ece6cebf56317403b8cc60cd349fe...4eea3e45bd6c60d880ea68722be7dead9041407a,2,2,2,4,2,2010-12-20 22:51:21,2010-11-26 03:16:40
4eea3e45bd6c60d880ea68722be7dead9041407a...e047ec340dc2bfa0cc0dec40a19b14f36462c7ee,1,11,1,12,3,2010-12-20 22:51:22,2010-11-26 03:22:22
e047ec340dc2bfa0cc0dec40a19b14f36462c7ee...6d266219cc8603ea7034685e6f5afffae2a6ff2f,1,10,2,12,5,2010-12-20 22:51:23,2010-11-26 17:40:23
6d266219cc8603ea7034685e6f5afffae2a6ff2f...a6aca21ced21feca8a6fcbe9419a1b68ab0dab09,1,5,2,7,3,2010-12-20 22:51:24,2010-11-28 03:06:57
a6aca21ced21feca8a6fcbe9419a1b68ab0dab09...4a2cb0780882e842345a8454be768142e9c7d283,7,26,16,42,26,2010-12-20 22:51:25,2010-11-29 17:40:14
4a2cb0780882e842345a8454be768142e9c7d283...dd3308851d454e6904da1aaea67af7222a6d5717,1,1,1,2,1,2010-12-20 22:51:25,2010-11-30 09:33:51
dd3308851d454e6904da1aaea67af7222a6d5717...ad41e778b43608cb0bd58103a5848e94acba58f4,1,10,5,15,6,2010-12-20 22:51:26,2010-11-30 09:34:17
ad41e778b43608cb0bd58103a5848e94acba58f4...9be07f7fe196c574a895e12cc5b372c292edfc9d,1,6,6,12,5,2010-12-20 22:51:27,2010-11-30 09:36:25
9be07f7fe196c574a895e12cc5b372c292edfc9d...fe804d9bc7c4f0cca1f428acab1fd45155c956a9,1,5,3,8,2,2010-12-20 22:51:27,2010-11-30 09:39:01
fe804d9bc7c4f0cca1f428acab1fd45155c956a9...d66cf5f32cc8bcfa73b32b8a95911cc46c52b6bf,1,10,2,12,2,2010-12-20 22:51:28,2010-11-30 09:39:39
d66cf5f32cc8bcfa73b32b8a95911cc46c52b6bf...bd62203d13769a0422078b6b690f2826d2209c63,6,363,21,384,9,2010-12-20 22:51:29,2010-11-30 16:07:09
bd62203d13769a0422078b6b690f2826d2209c63...2655269911d5b0cbdbc5a20cb76139078d36f9f4,1,4,0,4,1,2010-12-20 22:51:30,2010-12-03 00:12:50
2655269911d5b0cbdbc5a20cb76139078d36f9f4...0b96c5bc3b060615719c001ec68279a114429083,2,134,0,134,6,2010-12-20 22:51:30,2010-12-03 00:14:40
0b96c5bc3b060615719c001ec68279a114429083...0a2f1cb334e1633f0687bbd3442d433599dc08b0,5,947,9,956,14,2010-12-20 22:51:31,2010-12-03 00:44:09
0a2f1cb334e1633f0687bbd3442d433599dc08b0...d1bf9cf1f8e2d6f44b71e11accfb4c939e60513c,1,2,2,4,2,2010-12-20 22:51:32,2010-12-06 12:46:49
d1bf9cf1f8e2d6f44b71e11accfb4c939e60513c...a6f2082b33d8f4a303f7cd792fea4787136655b1,1,1,2,3,3,2010-12-20 22:51:32,2010-12-20 22:31:28
a6f2082b33d8f4a303f7cd792fea4787136655b1...0b763213083779c9457c8fadf2110485cce2c477,1,17,7,24,7,2010-12-20 22:51:33,2010-12-20 22:32:04
0b763213083779c9457c8fadf2110485cce2c477...2d8ab906135bd00a0e6b6966852d15d77408f824,1,0,5,5,1,2010-12-20 22:52:38,2010-12-20 22:52:38
2d8ab906135bd00a0e6b6966852d15d77408f824...86518c3b1101a20fafb8d213d0d68988cb4407fe,1,9,1,10,2,2010-12-20 23:17:12,2010-12-20 23:07:02
f07041e6cd26b3e3617deccf6d8df86cb7c9d750...b11d78b386d7ae5e46d606dd1d738a5c6f5b3406,2,47,0,47,2,2011-02-15 00:36:23,2011-02-10 10:57:15
b11d78b386d7ae5e46d606dd1d738a5c6f5b3406...bd094103d791fdd53eccd15bbfd1875655ea4a01,1,15,0,15,1,2011-02-15 01:26:54,2011-02-15 01:26:54
bd094103d791fdd53eccd15bbfd1875655ea4a01...daeb5c9e8f457235438a2b4be9824f0db8ad8adb,1,1,1,2,1,2011-02-15 02:35:36,2011-02-15 02:35:34
daeb5c9e8f457235438a2b4be9824f0db8ad8adb...ad7c2a8938b7fd7bfd72b78338c53e1eba50ccd4,1,1,1,2,1,2011-02-15 02:37:43,2011-02-15 02:37:43
ad7c2a8938b7fd7bfd72b78338c53e1eba50ccd4...77ae87d3673f0f14994c269345abc04990778912,1,2,1,3,2,2011-02-15 20:08:26,2011-02-15 18:13:09
77ae87d3673f0f14994c269345abc04990778912...a293f90db465b6e561eb62f5ac4c2e352c73740a,4,148,151,299,32,2011-02-15 20:29:59,2011-02-15 19:48:05
a293f90db465b6e561eb62f5ac4c2e352c73740a...29b0dc4ec87a6cae39fd353e4c24762aa51a2d5b,2,19,1,20,3,2011-02-15 21:50:59,2011-02-15 13:30:58
29b0dc4ec87a6cae39fd353e4c24762aa51a2d5b...aabdd5d0456bba51d17e65f0ab7324e4a1a49a20,1,3,3,6,3,2011-02-15 21:57:41,2011-02-15 13:41:17
aabdd5d0456bba51d17e65f0ab7324e4a1a49a20...e56ee67e13c763bd4c73031bdccdfca2030e9bf4,1,5,3,8,2,2011-02-15 21:57:54,2011-02-15 13:47:30
e56ee67e13c763bd4c73031bdccdfca2030e9bf4...60ad3aa917a72de6f5ce0c7bb0521efa70f71fd0,1,0,0,0,0,2011-02-15 22:06:23,2011-02-15 22:06:23
60ad3aa917a72de6f5ce0c7bb0521efa70f71fd0...42a369620ff76af8f08a99aaa8ae94d23c97d807,2,30,6,36,3,2011-02-16 00:35:50,2011-02-15 17:40:41
42a369620ff76af8f08a99aaa8ae94d23c97d807...c365f5606121c4a1b8edbf260a0e32199e453fe7,3,90,6,96,7,2011-02-16 01:13:53,2011-02-16 00:45:54
c365f5606121c4a1b8edbf260a0e32199e453fe7...3ef6433255cfeabdeb70bbfa51ac32a287c5d243,1,44,3,47,8,2011-02-16 04:15:46,2011-02-16 04:09:02
3ef6433255cfeabdeb70bbfa51ac32a287c5d243...550f73ae3e3b29aa36e793e8ffc5cd23478df099,208,8294,3793,12087,1697,2011-02-16 18:38:49,2011-02-16 16:38:33
550f73ae3e3b29aa36e793e8ffc5cd23478df099...b1664daeb99e35d322aa4e56e5ba80b2b29ac712,6,741,4,745,9,2011-02-16 20:04:44,2011-02-16 18:55:40
b1664daeb99e35d322aa4e56e5ba80b2b29ac712...470ebe249f5ce310afb2dbf62f5bab0f2925fd37,17,150,103,253,90,2011-02-16 20:07:58,2011-02-16 20:07:58
470ebe249f5ce310afb2dbf62f5bab0f2925fd37...e0e52f930e0cf723d8c0eb9c1529db302e18419e,1,0,6,6,2,2011-02-16 20:22:48,2011-02-16 20:22:45
e0e52f930e0cf723d8c0eb9c1529db302e18419e...89bfa419a50cad962db4a44ceeea66b9809834b1,1,13,8,21,2,2011-02-16 21:17:19,2011-02-16 21:16:44
89bfa419a50cad962db4a44ceeea66b9809834b1...19b4c27ebf6d0b1aa2ded64d57fa44ec70e8756e,1,15,1,16,5,2011-02-17 02:10:53,2011-02-17 02:09:43
19b4c27ebf6d0b1aa2ded64d57fa44ec70e8756e...7f78e5857fb82108e9aaf2d3c6d6017e30d27896,1,0,0,0,0,2011-02-17 02:12:08,2011-02-17 02:12:08
7f78e5857fb82108e9aaf2d3c6d6017e30d27896...a5e67ad9e77a2d72f6b8743de5ac315bed862e9c,3,100,29,129,26,2011-02-17 18:46:38,2011-02-17 02:15:24
a5e67ad9e77a2d72f6b8743de5ac315bed862e9c...874321298bd5864326e2f830ee7d79dbf2782195,1,10,7,17,3,2011-02-17 18:47:04,2011-02-17 03:06:41
874321298bd5864326e2f830ee7d79dbf2782195...25ce5016f4d083649c0986e603936da96df6cfda,1,0,1,1,1,2011-02-17 18:52:28,2011-02-17 03:26:00
25ce5016f4d083649c0986e603936da96df6cfda...7e4f7550738d0a232978629535d6db34e380b04e,1,1,1,2,1,2011-02-17 19:07:19,2011-02-17 19:07:19
7e4f7550738d0a232978629535d6db34e380b04e...15a6aa75009e285113e4cc2b13daaf5c67633fb7,2,135,0,135,2,2011-02-18 05:06:16,2011-02-18 05:04:51
15a6aa75009e285113e4cc2b13daaf5c67633fb7...ab969bfaf85c1b0d95e1fa5ad54e53b2543ec014,1,65,0,65,1,2011-02-18 08:08:05,2011-02-18 06:41:13
ab969bfaf85c1b0d95e1fa5ad54e53b2543ec014...9b0c7618c54797ceb9be74dcdef0cb63e07185c4,1,8,2,10,2,2011-02-18 08:42:07,2011-02-18 08:35:39
9b0c7618c54797ceb9be74dcdef0cb63e07185c4...aac5cbe0252f82542258dea7b2657d6940dfe134,3,57,5,62,7,2011-02-18 18:40:09,2011-02-18 18:05:31
aac5cbe0252f82542258dea7b2657d6940dfe134...f8defa3e090e194ce2eca9937cf9fa16bfc780fd,4,8,1,9,4,2011-02-18 18:43:06,2011-02-17 20:00:39
f8defa3e090e194ce2eca9937cf9fa16bfc780fd...6a594fed967d54a5c45ef6a0acdfe6424c4b0fd0,1,2,0,2,1,2011-02-18 18:44:36,2010-12-24 01:14:08
6a594fed967d54a5c45ef6a0acdfe6424c4b0fd0...8bedde464fc411c8b9ce1fe49c3c06f79ea80205,1,13,2,15,4,2011-02-18 18:44:58,2011-02-11 23:44:01
8bedde464fc411c8b9ce1fe49c3c06f79ea80205...de2686c3e101f991fb1fa831c8593a1b95616665,2,3,5,8,4,2011-02-18 18:45:04,2011-02-11 23:51:27
de2686c3e101f991fb1fa831c8593a1b95616665...9d49c93cb54e08fc79f0f52fbce1483ff274f8ba,2,16,5,21,5,2011-02-18 18:45:17,2011-02-12 02:52:42
9d49c93cb54e08fc79f0f52fbce1483ff274f8ba...3313ff1d1b370d581e390f5826f9dbfce04f042e,3,61,0,61,5,2011-02-18 18:45:25,2011-02-11 23:02:55
3313ff1d1b370d581e390f5826f9dbfce04f042e...26e580bbc431b3801cbc99d7001235f58c704ba3,1,2,2,4,2,2011-02-18 19:20:45,2011-02-18 19:20:42
26e580bbc431b3801cbc99d7001235f58c704ba3...ebfc90b5059664f370f5f7e7dbfcdd6e827d3cbd,1,0,72,72,1,2011-02-18 19:30:52,2011-02-18 19:30:52
ebfc90b5059664f370f5f7e7dbfcdd6e827d3cbd...1fce3f0ef8da682701db0cd98859705d332723c9,1,1,0,1,1,2011-02-18 22:01:04,2011-02-18 22:01:04
f07041e6cd26b3e3617deccf6d8df86cb7c9d750...f11e73044420aa4a4bb9d8503c442fd4cbde040a,1,2,2,4,1,2011-02-14 22:27:00,2011-02-14 22:25:52
f11e73044420aa4a4bb9d8503c442fd4cbde040a...909a5b39d20f3cb72ed8c102b181ee46b886a54e,2,19,3,22,5,2011-02-14 22:27:02,2011-02-14 22:23:40
909a5b39d20f3cb72ed8c102b181ee46b886a54e...0474ce67908c9afddab69d3f0eb53564b10e2ad1,2,3,19,22,5,2011-02-15 20:07:43,2011-02-15 20:07:43
e3ce73a2145cb4e44a0a9ffeef78e22f3e91f21f...ca8cc71bd008b7e05d9eed3232093118c56a6721,1,2,0,2,1,2010-12-31 02:58:43,2010-12-07 16:44:21
ca8cc71bd008b7e05d9eed3232093118c56a6721...e5a47c8ce1fd1cd8fee5daeba6a3b6e983cc5936,1,11,5,16,4,2010-12-31 03:14:30,2010-12-31 00:20:47
e5a47c8ce1fd1cd8fee5daeba6a3b6e983cc5936...5b81897cf6afe371f540c8a5348d54b87e05d39e,1,4,4,8,2,2010-12-31 05:07:42,2010-12-31 05:07:42
5b81897cf6afe371f540c8a5348d54b87e05d39e...40f29dd48a52699c82af8b844a2e6f2832f23a6a,2,187,138,325,70,2011-01-01 21:41:04,2011-01-01 21:17:42
40f29dd48a52699c82af8b844a2e6f2832f23a6a...1c7cd4aac34f98953b81a1af46ddda5b62f87899,2,16,6,22,7,2011-01-02 00:38:31,2011-01-01 22:24:16
1c7cd4aac34f98953b81a1af46ddda5b62f87899...8f5f213a6fdc0781dd3f0b09555f3cbda733e54f,2,3,84,87,6,2011-01-02 00:41:39,2011-01-02 00:41:39
8f5f213a6fdc0781dd3f0b09555f3cbda733e54f...ce5ddacaf43e91069a2ec106bd125bd8733a4a37,1,36,5,41,7,2011-01-02 01:43:59,2011-01-02 01:43:07
ce5ddacaf43e91069a2ec106bd125bd8733a4a37...b45698e67629a894cc005efba5c39d0e8adae1b0,1,2,2,4,2,2011-01-02 01:54:48,2011-01-02 01:54:45
b45698e67629a894cc005efba5c39d0e8adae1b0...00974df3e524254737f885018941f4914d503246,1,16,3,19,2,2011-01-02 05:05:23,2011-01-02 05:04:13
00974df3e524254737f885018941f4914d503246...8b352bdc5d0988291750402ec4f30c8bcefcec2f,1,3,1,4,1,2011-01-02 05:14:06,2011-01-02 05:14:06
8b352bdc5d0988291750402ec4f30c8bcefcec2f...29626d8731792aaba94ddc7e680e93147b312ab9,1,5,4,9,4,2011-01-02 05:14:24,2011-01-02 05:14:24
29626d8731792aaba94ddc7e680e93147b312ab9...c82fe30ca14c815aa4c5d6126dd39ba1f5ea7c6d,1,42,28,70,36,2011-01-02 05:41:07,2011-01-02 05:41:07
c82fe30ca14c815aa4c5d6126dd39ba1f5ea7c6d...2e3e95ee89045966dbd6bf955c319ab448c1c85e,4,31,19,50,14,2011-01-02 05:54:46,2011-01-02 05:54:46
2e3e95ee89045966dbd6bf955c319ab448c1c85e...1345103c3abaf915d0bd62307635c4e95124017a,1,3,3,6,3,2011-01-02 09:13:27,2011-01-02 09:13:27
1345103c3abaf915d0bd62307635c4e95124017a...cd1ec27268513d9196ae9cedafc8d08946ae18da,1,18,1,19,3,2011-01-02 09:44:42,2011-01-02 09:44:42
cd1ec27268513d9196ae9cedafc8d08946ae18da...7e831bfba15bd0a834ac2561c7e28f7281f9e8b9,5,32,0,32,5,2011-01-02 09:54:19,2011-01-02 09:54:19
7e831bfba15bd0a834ac2561c7e28f7281f9e8b9...b5637170b17d4ad7d47362a394e360c44af60e46,1,1,1,2,1,2011-01-02 20:37:27,2011-01-02 20:37:27
e3ce73a2145cb4e44a0a9ffeef78e22f3e91f21f...0df804b9e7b509797e652a0e8657989023a01911,1,58,28,86,5,2010-12-30 09:35:10,2010-12-18 19:17:29
0df804b9e7b509797e652a0e8657989023a01911...8d82ec21308812132a71afe45c5bc517b4a43354,3,300,7,307,4,2010-12-30 09:35:11,2010-12-22 03:14:29
8d82ec21308812132a71afe45c5bc517b4a43354...797aa97e19bbb7b9536e2a7da03012e2db018d23,2,37,36,73,15,2010-12-30 09:35:11,2010-12-22 06:31:30
797aa97e19bbb7b9536e2a7da03012e2db018d23...8e96b8ab9bd559914c18b0bdf3b291862c961f94,1,42,9,51,7,2010-12-30 09:35:11,2010-12-22 08:48:22
8e96b8ab9bd559914c18b0bdf3b291862c961f94...a8417c128e0c871c6af03236fa42209dc1977caa,2,92,13,105,12,2010-12-30 09:35:11,2010-12-22 22:31:57
a8417c128e0c871c6af03236fa42209dc1977caa...4e81cf7def7c672b620086323c34010d2718e697,2,7,4,11,5,2010-12-30 09:35:11,2010-12-22 22:40:28
4e81cf7def7c672b620086323c34010d2718e697...0dcbe3f74a0d92a399c508c92110648e76917d9b,3,92,5,97,10,2010-12-30 09:35:12,2010-12-23 01:17:34
0dcbe3f74a0d92a399c508c92110648e76917d9b...b5aed43f04b50b2e21bf2c370b859f9b8fbd0270,1,119,26,145,21,2010-12-30 09:35:12,2010-12-23 02:30:56
b5aed43f04b50b2e21bf2c370b859f9b8fbd0270...3be4f097a3dc1228e99b48e9beca9120c9c70a5f,1,1,2,3,2,2010-12-30 09:35:12,2010-12-23 02:39:22
3be4f097a3dc1228e99b48e9beca9120c9c70a5f...8874c51d0465d80c9296cdd55b6eb17de49253db,2,2,18,20,3,2010-12-30 09:35:12,2010-12-23 07:31:06
8874c51d0465d80c9296cdd55b6eb17de49253db...0c928b124c25b01e4ff7f151f5c98fdf9cb7d532,1,49,12,61,8,2010-12-30 09:35:12,2010-12-23 07:31:54
0c928b124c25b01e4ff7f151f5c98fdf9cb7d532...0adc6b29bd193b27bdbbce0e2e414efbee0453ab,2,2,2,4,2,2010-12-30 09:35:12,2010-12-23 18:10:28
0adc6b29bd193b27bdbbce0e2e414efbee0453ab...080daf9ddddc05c4ed9efc3e37fac7d52fb9fb17,1,13,12,25,3,2010-12-30 09:35:12,2010-12-23 18:18:06
080daf9ddddc05c4ed9efc3e37fac7d52fb9fb17...74cc021ec289d1f61cc9b6a2b5528d2d0e8650e4,1,9,3,12,4,2010-12-30 09:35:12,2010-12-23 18:32:34
74cc021ec289d1f61cc9b6a2b5528d2d0e8650e4...50c1c1e12d073621fa372d5ece16d66932922af4,1,12,0,12,2,2010-12-30 09:35:12,2010-12-23 18:38:43
50c1c1e12d073621fa372d5ece16d66932922af4...90e55c3357cc264dfd38626f99a739e8d9927a26,3,101,172,273,21,2010-12-30 09:35:13,2010-12-30 06:07:38
90e55c3357cc264dfd38626f99a739e8d9927a26...e33d0de129533465276158980e53c0979096b8be,1,12,5,17,5,2010-12-30 09:35:13,2010-12-30 08:10:30
e33d0de129533465276158980e53c0979096b8be...bb400d5697dd41d50bb7307d8b3478fa8ae1092f,1,60,17,77,7,2010-12-30 09:35:20,2010-12-30 09:34:54
bb400d5697dd41d50bb7307d8b3478fa8ae1092f...f484cbf4c7bbbc8549de55984c072cf2f1132c7a,1,56,19,75,12,2010-12-30 18:02:42,2010-12-30 18:02:42
f484cbf4c7bbbc8549de55984c072cf2f1132c7a...481329ee7c4ca7f5fdb57ad6f687f229baec461e,1,16,21,37,10,2010-12-30 18:18:25,2010-12-30 18:18:25
481329ee7c4ca7f5fdb57ad6f687f229baec461e...2a7e7b1c46ab499f65121c6dc74590bab98b73be,1,58,28,86,5,2010-12-30 18:20:21,2010-12-18 19:17:29
2a7e7b1c46ab499f65121c6dc74590bab98b73be...9244a64b59f200282370192c87c5986103221389,1,39,0,39,10,2010-12-30 18:31:36,2010-12-30 18:31:33
9244a64b59f200282370192c87c5986103221389...109f845e4938ac7f213ebfb15f8d55c5135fc2ad,1,5,9,14,5,2010-12-30 18:34:33,2010-12-30 18:32:41
109f845e4938ac7f213ebfb15f8d55c5135fc2ad...d4859a55bc8f18f1834546af12a8d8f6a8802ebd,1,279,247,526,34,2010-12-30 19:17:12,2010-12-30 19:17:11
d4859a55bc8f18f1834546af12a8d8f6a8802ebd...074af67dd36b0e29d801c39cf7bd2b1170880df9,1,12,4,16,5,2010-12-30 19:53:55,2010-12-30 19:53:55
074af67dd36b0e29d801c39cf7bd2b1170880df9...a3c4e17c2a6dd602e21fcfeccc28bdb2fb79734d,1,7,2,9,2,2010-12-30 19:54:49,2010-12-30 19:54:49
a3c4e17c2a6dd602e21fcfeccc28bdb2fb79734d...866201bd74b8d06d06a19dc5cdfa9ff7c62e5a26,1,42,16,58,11,2010-12-30 20:35:13,2010-12-30 20:33:27
866201bd74b8d06d06a19dc5cdfa9ff7c62e5a26...0946474b5c03e39653930e0a7097088f5a1f21e3,1,21,7,28,13,2010-12-30 21:25:49,2010-12-30 21:25:49
0946474b5c03e39653930e0a7097088f5a1f21e3...62e0ca05a63863dd6628a9140ee6edb442aa53d0,3,65,10,75,16,2010-12-30 23:46:47,2010-12-30 23:46:47
62e0ca05a63863dd6628a9140ee6edb442aa53d0...294bcb33e6dc2d774deb4d6edbde2c1584e7bc20,2,50,0,50,2,2010-12-31 01:33:07,2010-12-31 01:33:06
294bcb33e6dc2d774deb4d6edbde2c1584e7bc20...aea568b04a26cb7d725df57e5c593a1e0d5147b3,2,7,5,12,3,2010-12-31 01:53:53,2010-12-31 01:52:14
aea568b04a26cb7d725df57e5c593a1e0d5147b3...7b9a2f29b40073ed3c172a2e1bdb95f9fd9e46f6,1,0,1,1,1,2010-12-31 02:07:19,2010-12-31 02:07:19
7b9a2f29b40073ed3c172a2e1bdb95f9fd9e46f6...af6662d5e5be3659d5d0c9b0721e0ec056dafaec,2,41,9,50,8,2010-12-31 02:50:07,2010-12-31 02:28:30
af6662d5e5be3659d5d0c9b0721e0ec056dafaec...916f567d23c9e665f71c63df05734823b085fff4,3,75,0,75,3,2010-12-31 02:50:10,2010-12-31 02:46:49
33118df8f98f7c81c36653563b2b58e44bcc4c6f...c3ffbf219ca8049c901ec58d4d4b3df5b96c5097,2,53,8,61,14,2011-01-02 22:44:43,2011-01-02 22:44:43
1fce3f0ef8da682701db0cd98859705d332723c9...1efac74958c03d6edcab7e1880fc841db7a8eb30,2,15,6,21,13,2011-02-19 23:14:07,2011-02-19 00:02:16
1efac74958c03d6edcab7e1880fc841db7a8eb30...8b9dbdad272d58b3db7cfa8956dad6b7db5d7c0e,2,8,0,8,2,2011-02-20 00:38:21,2011-02-18 01:38:36
8b9dbdad272d58b3db7cfa8956dad6b7db5d7c0e...c72ae27be12c9fd609b818cd18a6f75ffc6f6333,1,1,1,2,1,2011-02-20 00:56:56,2011-02-20 00:56:56
c72ae27be12c9fd609b818cd18a6f75ffc6f6333...c2a62951f64d5584d76fea5865e9bd94a898ed8b,4,36,3,39,4,2011-02-20 02:25:15,2011-02-20 01:51:32
c2a62951f64d5584d76fea5865e9bd94a898ed8b...e8aef84191bc2c1ba2bcaa54f30aabde7f03769b,5,38,7,45,7,2011-02-20 02:45:34,2011-02-20 02:45:34
e8aef84191bc2c1ba2bcaa54f30aabde7f03769b...e5a472229bbca00d5fa458e5572b11f07b1279e9,1,2,2,4,1,2011-02-20 03:06:10,2011-02-20 03:06:10
98515742b771eb35cc48f54d04822c41e19327d7...0aa1a8a005c83808f0167cebe759a6e1b75faf71,6,84,1,85,12,2011-02-20 03:24:23,2011-02-20 01:29:01
b5637170b17d4ad7d47362a394e360c44af60e46...feb77eab6563c849a99cf620c354d084faabc245,2,26,2,28,4,2011-01-03 02:27:14,2011-01-03 02:08:08
feb77eab6563c849a99cf620c354d084faabc245...57544ba1c54c7d0da890317deeb73076350c5647,4,32,6,38,5,2011-01-03 02:33:49,2011-01-03 02:33:49
57544ba1c54c7d0da890317deeb73076350c5647...2b5b128cbac3cee8535d3e4f54c94d6a7c962dac,1,2,2,4,1,2011-01-03 02:57:22,2011-01-03 02:57:22
6593a96373aae92fe7f12b5de4764cc1b7454815...282cce1ea58b6a450c397af22b64fac8fd03d579,1,2,1,3,1,2011-01-03 20:58:19,2011-01-03 20:58:19
282cce1ea58b6a450c397af22b64fac8fd03d579...d040f1d19d17e056223ab3de0e58ed470c8b9f52,1,5,1,6,4,2011-01-03 21:21:28,2011-01-03 21:21:28
d040f1d19d17e056223ab3de0e58ed470c8b9f52...e4dd5cd6fd7b44f4fc21a5cfd39615a7a5833957,4,4,8,12,7,2011-01-03 23:41:58,2011-01-03 23:27:57
e4dd5cd6fd7b44f4fc21a5cfd39615a7a5833957...94f8368cf9e5077050525e32a24188402f077074,4,79,2,81,5,2011-01-03 23:51:05,2011-01-02 09:13:56
94f8368cf9e5077050525e32a24188402f077074...73f4ec51fde3bfb3e16d6d706aae42656d083c1a,1,10,4,14,2,2011-01-04 18:36:05,2011-01-04 18:36:05
73f4ec51fde3bfb3e16d6d706aae42656d083c1a...2957382991c6559fa397d0f9a790ee82f5029b37,5,31,14,45,9,2011-01-04 19:22:19,2011-01-04 19:22:17
2957382991c6559fa397d0f9a790ee82f5029b37...bc1d758408ce67db8fbdb212d7677831eac55d9e,1,6,4,10,2,2011-01-04 19:25:36,2011-01-04 19:25:36
bc1d758408ce67db8fbdb212d7677831eac55d9e...cda4d56bcf235baf15c401276b281de5955edd5d,1,2,2,4,1,2011-01-04 19:39:12,2011-01-04 19:39:12
cda4d56bcf235baf15c401276b281de5955edd5d...131546e7339d6960ea91629915468c6f04a33cf7,1,2,1,3,2,2011-01-04 20:24:17,2011-01-04 20:24:17
3c330b05b10ffabe1b45d06efadc1f4e49830dc7...b7b0c92ac18fb9100977171ac23b6fd59961a6c6,1,2,0,2,2,2011-01-04 23:45:01,2011-01-04 23:45:01
b7b0c92ac18fb9100977171ac23b6fd59961a6c6...fe6f363837290b308b43538e422b97620faf6496,1,1,2,3,2,2011-01-05 01:04:00,2011-01-05 00:57:49
fe6f363837290b308b43538e422b97620faf6496...468042fc84e80d2ceb94a8d4be09cd1b5ce66ffd,1,47,9,56,3,2011-01-05 01:23:48,2011-01-05 01:23:48
468042fc84e80d2ceb94a8d4be09cd1b5ce66ffd...9e31e0837ec3c5a88ed477bec3980dd4608046be,3,12,1,13,3,2011-01-05 02:38:58,2011-01-05 02:30:27
9e31e0837ec3c5a88ed477bec3980dd4608046be...9ddfcfecca21cc7fde7d6388f35d07007de2a3a1,2,14,37,51,18,2011-01-05 19:17:38,2011-01-05 15:40:21
9ddfcfecca21cc7fde7d6388f35d07007de2a3a1...af15b4e45a7affa911307b0ad20f6b2a0a67df9d,1,25,20,45,6,2011-01-05 19:27:22,2011-01-05 15:32:04
af15b4e45a7affa911307b0ad20f6b2a0a67df9d...b62152bc8453011ff447a71182ff90dc351ff3e6,2,102,100,202,76,2011-01-05 19:53:56,2011-01-05 19:53:56
b62152bc8453011ff447a71182ff90dc351ff3e6...4e108ef9b64aa48f357f63ccf0924a58f9c0eb3b,1,3,17,20,3,2011-01-05 19:55:24,2011-01-05 19:55:24
4e108ef9b64aa48f357f63ccf0924a58f9c0eb3b...bb7bf58cc77c07b6421c44872926460479aee496,1,3,4,7,2,2011-01-05 19:59:04,2011-01-05 19:57:53
bb7bf58cc77c07b6421c44872926460479aee496...3770462ee3531c10f53071169555008ff970528d,1,1,1,2,1,2011-01-06 03:05:59,2011-01-06 03:05:59
3770462ee3531c10f53071169555008ff970528d...22561dfbcf56a8400dfc067913107de9eef58b68,1,1,1,2,1,2011-01-06 19:05:19,2011-01-06 19:05:19
22561dfbcf56a8400dfc067913107de9eef58b68...b6dafc1a4708a61c1335ced903f464fdd3ebb294,1,19,10,29,10,2011-01-06 21:42:32,2011-01-06 21:42:30
b6dafc1a4708a61c1335ced903f464fdd3ebb294...48334dc0b1b8211f07b2fac5a00a41be58c0c3ee,1,9,4,13,1,2011-01-06 22:39:06,2011-01-05 19:12:36
48334dc0b1b8211f07b2fac5a00a41be58c0c3ee...7c731ec9dd51cb9e8792a77bc7a1733a2fe4ea44,3,304,125,429,38,2011-01-06 23:36:25,2011-01-06 05:39:00
7c731ec9dd51cb9e8792a77bc7a1733a2fe4ea44...dea2331377632b2ca6f0c106e57774c4453b33ca,1,144,125,269,14,2011-01-06 23:38:50,2011-01-06 17:30:03
dea2331377632b2ca6f0c106e57774c4453b33ca...1ac133ea6f34bb8ef493f8f908d0cdda9a3e626a,2,12,18,30,9,2011-01-06 23:39:51,2011-01-06 20:06:29
1ac133ea6f34bb8ef493f8f908d0cdda9a3e626a...5a05992155126cacb32181b15f39d4448b66f376,11,143,114,257,88,2011-01-07 00:06:27,2011-01-07 00:06:27
5a05992155126cacb32181b15f39d4448b66f376...08bec7ab0a9be15373d89492123b210fd0a05763,1,0,1,1,1,2011-01-07 02:07:50,2011-01-07 02:07:48
08bec7ab0a9be15373d89492123b210fd0a05763...2e76cd382ff9bc413aa686c5ecae87650a5e9bb1,2,48,17,65,10,2011-01-07 18:58:13,2011-01-07 18:57:39
2e76cd382ff9bc413aa686c5ecae87650a5e9bb1...0853730c35e567b1cd2e553986298e57f3908f02,1,2,1,3,2,2011-01-07 21:00:19,2011-01-04 20:24:17
0853730c35e567b1cd2e553986298e57f3908f02...73f53e12e4a5b9ef7dbb4792bd5f8ad403094441,4,24,6,30,5,2011-01-08 23:46:07,2011-01-08 23:46:07
73f53e12e4a5b9ef7dbb4792bd5f8ad403094441...318b1a0a037eabd7b10ca9148549b1411e096409,1,2,2,4,1,2011-01-09 00:19:07,2011-01-09 00:19:07
318b1a0a037eabd7b10ca9148549b1411e096409...5580907c58554c94224cb63d280c4776a98c79a6,1,1,2,3,1,2011-01-09 02:20:39,2011-01-09 02:20:30
5580907c58554c94224cb63d280c4776a98c79a6...5342e3e925652fdd52da05f98768ac63b4fe7e7b,1,13,7,20,7,2011-01-09 03:09:33,2011-01-09 03:09:33
5342e3e925652fdd52da05f98768ac63b4fe7e7b...e1f4b3f009db6b80a4fb136926caba8a788ab7f8,1,78,1,79,4,2011-01-09 03:10:17,2011-01-09 03:09:54
e1f4b3f009db6b80a4fb136926caba8a788ab7f8...9da75f39d978c7b2ef1e7ba3a308bbf6f6769b72,2,40,1,41,4,2011-01-10 21:48:35,2011-01-01 02:32:52
9da75f39d978c7b2ef1e7ba3a308bbf6f6769b72...202dd8387fc60dbff644844db8bb23e02abb7c07,4,35,7,42,12,2011-01-11 00:24:49,2011-01-11 00:22:58
202dd8387fc60dbff644844db8bb23e02abb7c07...1f38046b516a8aee14654b9a1a048b9618cacf5b,1,12,3,15,4,2011-01-11 00:25:15,2011-01-11 00:25:13
1f38046b516a8aee14654b9a1a048b9618cacf5b...907e5699802ee07d20ab79b9dbc94ca4b6ac178a,15,101,101,202,28,2011-01-11 00:30:26,2011-01-11 00:30:26
907e5699802ee07d20ab79b9dbc94ca4b6ac178a...63bd237892e989dd41362058ff1ba8548b770535,3,11,11,22,10,2011-01-11 01:15:17,2011-01-11 01:15:17
63bd237892e989dd41362058ff1ba8548b770535...b9cfd9527acad0a686083078863bff028dfd785a,3,36,15,51,12,2011-01-11 01:25:48,2011-01-11 01:25:48
b9cfd9527acad0a686083078863bff028dfd785a...320a56b89d3cd86877a50f95e91e01d959a36b23,1,1,1,2,1,2011-01-11 02:00:21,2011-01-11 02:00:15
320a56b89d3cd86877a50f95e91e01d959a36b23...01148265cbf27548cf4a55024e2677119e237d2d,1,23,15,38,7,2011-01-11 02:05:15,2011-01-11 01:57:25
01148265cbf27548cf4a55024e2677119e237d2d...b7419dfaadc512f46898f4ca8dae30b19fede83f,16,2518,1361,3879,437,2011-01-11 16:47:18,2011-01-11 16:45:32
b7419dfaadc512f46898f4ca8dae30b19fede83f...6f5d95de6df6dad23b908fb15ad1a823b9d9a4d1,4,81,6,87,10,2011-01-11 18:02:58,2010-12-23 02:08:20
6f5d95de6df6dad23b908fb15ad1a823b9d9a4d1...b92329667ff1f32a112e277bbb3cd6bc192c6f6d,2,3,3,6,3,2011-01-11 18:18:46,2011-01-11 18:18:46
b92329667ff1f32a112e277bbb3cd6bc192c6f6d...435ece505897c8931548162a1ccc5389e3fc558c,3,126,25,151,19,2011-01-11 21:54:51,2011-01-11 02:20:12
e5a472229bbca00d5fa458e5572b11f07b1279e9...4ed66880106781b502ca02509c7c544d6c476369,1,322,0,322,1,2011-02-20 04:56:20,2011-02-20 04:56:20
4ed66880106781b502ca02509c7c544d6c476369...df215a67d4ee53be749693909aae266d41723aa7,1,5,0,5,1,2011-02-20 21:11:55,2011-02-20 21:11:53
df215a67d4ee53be749693909aae266d41723aa7...47f5fd01e1f91d875aecf1f7290ab9f2423c75b4,1,13,0,13,1,2011-02-20 21:53:40,2011-02-20 21:53:40
47f5fd01e1f91d875aecf1f7290ab9f2423c75b4...ab144f4843c2c7630564f26cfbdd69d01d8fbd00,1,2,0,2,1,2011-02-23 12:43:13,2011-02-23 12:43:13
ab144f4843c2c7630564f26cfbdd69d01d8fbd00...0248c87ec7c76617af3a3de11791c6f6cbb90aac,1,6,5,11,2,2011-02-23 20:56:50,2011-02-23 20:56:50
0248c87ec7c76617af3a3de11791c6f6cbb90aac...a91b1409636db20e931e14e1be03261f57ab3f7c,2,10,1,11,4,2011-02-23 20:57:05,2011-02-22 00:31:01
a91b1409636db20e931e14e1be03261f57ab3f7c...340291c085f629050bd66668dba7cb006f896d89,1,1,0,1,1,2011-02-24 00:38:30,2011-02-24 00:19:41
340291c085f629050bd66668dba7cb006f896d89...45adc907c9b3eff0bc560d0c6a0f904ff9ee0c39,3,8,8,16,8,2011-02-24 00:38:34,2011-02-24 00:19:13
45adc907c9b3eff0bc560d0c6a0f904ff9ee0c39...5287703cce59e2ee09c73a851bfdcd018a67926c,1,1,0,1,1,2011-02-24 20:02:22,2011-02-24 19:24:19
5287703cce59e2ee09c73a851bfdcd018a67926c...f423ec90fc6cfa47baf48485240dd338d61e9307,2,35,0,35,2,2011-02-24 20:41:51,2011-02-20 12:31:37
f423ec90fc6cfa47baf48485240dd338d61e9307...06ac129903d9b71782743dc77ec79689f4eab1a4,1,1,0,1,1,2011-02-24 20:44:21,2011-02-20 12:41:14
06ac129903d9b71782743dc77ec79689f4eab1a4...2680522d3a71fb5f12aa052555f3d04806338821,1,2,1,3,1,2011-02-24 20:46:17,2011-02-20 12:45:25
2680522d3a71fb5f12aa052555f3d04806338821...e33e7d1a3712add02cd08c0069bb56ba76e49aa5,125,6616,4014,10630,1338,2011-02-24 21:14:59,2011-02-24 21:14:59
e33e7d1a3712add02cd08c0069bb56ba76e49aa5...df15472d3476737cd90fd8d74d32b0da8c544f9f,2,96,28,124,23,2011-02-24 21:47:14,2011-02-17 02:15:24
df15472d3476737cd90fd8d74d32b0da8c544f9f...1f50d711b25c15228b4c85da0e44075239e17e68,2,35,1,36,2,2011-02-24 23:46:55,2011-02-24 23:19:12
1f50d711b25c15228b4c85da0e44075239e17e68...a2f498a5ef6c46a57a3e88bd6917c5e69d7a7321,1,0,1,1,1,2011-02-24 23:59:40,2011-02-24 23:54:25
a2f498a5ef6c46a57a3e88bd6917c5e69d7a7321...66601f13d9f841fe4e644a0b106ea3106054f46a,2,19,1,20,2,2011-02-25 00:14:04,2011-02-21 14:46:34
66601f13d9f841fe4e644a0b106ea3106054f46a...fd713e1dc75ebecafbeec3df8e2102f11cb7714e,2,4,0,4,2,2011-02-25 00:19:43,2011-02-21 07:04:55
fd713e1dc75ebecafbeec3df8e2102f11cb7714e...8a50f23fd3fed1b17f0fd06fc1966e4c188c4543,1,17,6,23,7,2011-02-25 00:28:45,2011-02-21 18:39:04
8a50f23fd3fed1b17f0fd06fc1966e4c188c4543...a9a252fda9054a90cd0be17ea1ea492c82c317c2,2,11,3,14,3,2011-02-25 00:36:23,2011-02-18 21:44:20
a9a252fda9054a90cd0be17ea1ea492c82c317c2...839fb8e19b74c1145875d316e7b896b48e1dbb23,9,12,12,24,12,2011-02-25 00:36:43,2011-02-25 00:36:43
839fb8e19b74c1145875d316e7b896b48e1dbb23...ea9f5b110a2e41ff7bff2fa73a8847229a21a4ba,2,55,4,59,2,2011-02-25 01:16:13,2011-02-25 01:16:11
ea9f5b110a2e41ff7bff2fa73a8847229a21a4ba...7276ff982216a3dfbdc8f9fd3b525f12372cf157,2,75,0,75,3,2011-02-25 01:39:59,2011-02-20 00:00:05
7276ff982216a3dfbdc8f9fd3b525f12372cf157...f918e57f8ba62a79a8c9c32acfad6531e68412f1,1,13,7,20,6,2011-02-26 00:48:19,2011-02-26 00:42:08
7dad30afe9b823b2edc86b7a3e907dcd6c93f4c9...b309192ffdbbbe91b723da70873b29b3614ef41f,1,1,5,6,1,2011-02-24 01:04:21,2011-02-24 01:04:14
b309192ffdbbbe91b723da70873b29b3614ef41f...360885a7e9b90bfab8380579df18ab3d89039dc2,1,2,0,2,1,2011-02-25 01:06:46,2011-02-25 01:06:46
f918e57f8ba62a79a8c9c32acfad6531e68412f1...0a51a6d3ac0818244ab4d73a72a541d3e8b65110,3,38,0,38,4,2011-02-27 21:06:08,2011-02-23 03:03:49
0a51a6d3ac0818244ab4d73a72a541d3e8b65110...2cfe7b847d986de3ca7b7191102b489913a7639e,1,1,0,1,1,2011-02-28 01:07:08,2011-02-16 05:24:50
2cfe7b847d986de3ca7b7191102b489913a7639e...f3d364122dc12f13cbfb848576a8b152849452ea,2,4,2,6,2,2011-02-28 01:08:14,2011-02-16 05:34:30
f3d364122dc12f13cbfb848576a8b152849452ea...a48f73d0d3440fe59d580d45726467d034d0b1ae,1,2,0,2,1,2011-02-28 01:13:52,2011-02-16 23:40:53
a48f73d0d3440fe59d580d45726467d034d0b1ae...3599c71dae1b293b712320afbd7e3961b056d458,2,9,2,11,3,2011-02-28 01:14:16,2011-02-18 22:18:38
3599c71dae1b293b712320afbd7e3961b056d458...d664bf376d1071b4418f0a71cd5ed22daabb9f6f,2,150,72,222,20,2011-02-28 01:17:40,2011-02-27 18:21:23
d664bf376d1071b4418f0a71cd5ed22daabb9f6f...0304f1fc22083dcf4fb45ea272f0f228850371e6,2,2,0,2,2,2011-02-28 17:54:16,2011-02-25 09:27:52
0304f1fc22083dcf4fb45ea272f0f228850371e6...a14bb04c0500567bc0579da50cc5bc3cb559ba20,1,1,1,2,1,2011-02-28 19:19:10,2011-02-28 19:18:56
a14bb04c0500567bc0579da50cc5bc3cb559ba20...6442cbef2058019d2e53050f432a80e47c08f517,67,1921,886,2807,336,2011-02-28 19:29:33,2011-02-28 19:29:33
6442cbef2058019d2e53050f432a80e47c08f517...4a34692903119f5765c072b44bdbad7a4047ed6f,2,96,28,124,23,2011-02-28 19:30:07,2011-02-17 02:15:24
4a34692903119f5765c072b44bdbad7a4047ed6f...bc8e9b340dd17ea5756c2ff0374763d9906efc92,1,30,28,58,2,2011-02-28 20:37:59,2011-02-28 20:27:51
bc8e9b340dd17ea5756c2ff0374763d9906efc92...5f95d9a75de023c7756b51ef0bab5eae671cab05,1,0,1,1,1,2011-02-28 20:58:15,2011-02-28 20:58:15
5f95d9a75de023c7756b51ef0bab5eae671cab05...4ab5476e89266194d82215214a1a870c9b79e295,1,18,15,33,5,2011-03-01 17:59:17,2011-03-01 17:59:17
4ab5476e89266194d82215214a1a870c9b79e295...4e7c37b87c0ea62aa419bc4b512ccf0f9511b8f5,2,34,1,35,2,2011-03-01 18:49:20,2011-03-01 15:35:32
4e7c37b87c0ea62aa419bc4b512ccf0f9511b8f5...452df69964d3e1955a17238a572fccf8d22bc881,1,6,1,7,2,2011-03-02 20:10:36,2011-03-02 18:32:13
452df69964d3e1955a17238a572fccf8d22bc881...cf7b680db9f61a9f757581b1e3f4335e4402b722,1,1,1,2,1,2011-03-03 05:00:06,2011-03-03 01:37:38
cf7b680db9f61a9f757581b1e3f4335e4402b722...14475c77a61795ab706ddca41be955ea8b8c9eeb,94,7645,2254,9899,691,2011-03-03 05:04:37,2011-03-03 05:04:37
8838e14ac0affd90b16ce724df90ca612d12c69b...1d5ff15a46102bb7f0611a42a028903f615acab0,4,257,0,257,7,2011-03-03 04:35:45,2010-10-29 10:38:13
1d5ff15a46102bb7f0611a42a028903f615acab0...11a06fe1e4c5f499fa2ce64acf2f5fe93c29ec5f,2,4,2,6,2,2011-03-03 06:09:39,2011-02-16 05:34:30
11a06fe1e4c5f499fa2ce64acf2f5fe93c29ec5f...cf78ce59b3c0a9e7cdcdbd84d71300b04150b6df,11,50,9,59,20,2011-03-07 18:45:25,2011-03-04 23:57:54
cf78ce59b3c0a9e7cdcdbd84d71300b04150b6df...502900c0bc9b78faf191489c0ea4d8c00f1642d2,2,139,0,139,3,2011-03-08 19:03:21,2011-03-06 02:42:33
502900c0bc9b78faf191489c0ea4d8c00f1642d2...2c185a9dfd3be8e718858b946333c433c375c295,3,48,4,52,8,2011-03-09 17:16:11,2011-03-06 00:11:09
14475c77a61795ab706ddca41be955ea8b8c9eeb...53dc74e12f87c49515082f409c9cdc5e6e67974c,8,74,49,123,28,2011-03-18 21:22:52,2011-03-18 21:22:52
14475c77a61795ab706ddca41be955ea8b8c9eeb...b3884c574b3607cbdea9c9998dee2dc26e8a0dd1,2,96,28,124,23,2011-03-03 05:06:17,2011-02-17 02:15:24
b3884c574b3607cbdea9c9998dee2dc26e8a0dd1...ca8be39b9ee22b583c844e5cad6030c438f0f4e0,1,0,0,0,0,2011-03-03 05:21:29,2011-03-03 05:21:08
ca8be39b9ee22b583c844e5cad6030c438f0f4e0...fbe36a7ca963e7e2e83fc4f3e10760d74a5e42b4,2,2,4,6,2,2011-03-03 06:10:16,2011-03-03 06:08:44
fbe36a7ca963e7e2e83fc4f3e10760d74a5e42b4...39280e1b5731f3fcd8cc42ad41b86cdfdcb6d58b,4,49,7,56,5,2011-03-03 06:10:26,2011-03-03 05:20:50
39280e1b5731f3fcd8cc42ad41b86cdfdcb6d58b...5e91042fcb70db6241a8f44bb2f6d927a8ecf125,2,20,2,22,4,2011-03-04 23:45:12,2010-12-08 21:39:50
5e91042fcb70db6241a8f44bb2f6d927a8ecf125...07426ef29c2eaa6f6b67f355cfdd2c4e3c3303b4,1,5,0,5,1,2011-03-07 18:17:22,2011-03-03 16:05:03
07426ef29c2eaa6f6b67f355cfdd2c4e3c3303b4...db6ea1094836621809284de7334fe90fd13905d9,2,2,2,4,2,2011-03-07 18:17:54,2011-03-03 16:08:12
db6ea1094836621809284de7334fe90fd13905d9...7a272d92e3e4ba1cc98e4f1b977552da89ec55bf,1,2,0,2,1,2011-03-07 18:47:29,2011-03-04 16:37:34
7a272d92e3e4ba1cc98e4f1b977552da89ec55bf...81d3de7e6db6abe36ac907d8f0fa6dfc01f7bbcd,2,7,0,7,2,2011-03-07 21:16:00,2011-03-07 21:16:00
81d3de7e6db6abe36ac907d8f0fa6dfc01f7bbcd...74954ce7d8b4b734302d295d0c816f04a694254e,8,74,13,87,15,2011-03-08 21:56:41,2011-03-08 06:00:51
74954ce7d8b4b734302d295d0c816f04a694254e...161f7aacf7ca0185f7cfbd34d81d45eaef20d118,1,1,1,2,1,2011-03-09 18:07:25,2011-03-09 17:42:03
161f7aacf7ca0185f7cfbd34d81d45eaef20d118...62f06fb8854943c8dc0bfe801950f97f31c09e2b,1,5,1,6,1,2011-03-09 18:53:06,2011-03-09 18:53:06
62f06fb8854943c8dc0bfe801950f97f31c09e2b...4e047d32b0a255eb6ff16a83a1acfcc90182096e,1,15,0,15,1,2011-03-10 18:57:47,2011-03-10 17:15:05
4e047d32b0a255eb6ff16a83a1acfcc90182096e...e14aa645912e5ee48003fe9059ad2d18556211ae,1,99,20,119,15,2011-03-10 20:48:49,2011-03-10 20:48:07
e14aa645912e5ee48003fe9059ad2d18556211ae...9a8e843ca3a6f381fb69d9a760f36ea9458d290b,1,12,0,12,1,2011-03-10 21:34:50,2011-03-10 21:34:35
9a8e843ca3a6f381fb69d9a760f36ea9458d290b...594642b31dbaa32d99c634421c615dc09c9afb29,1,1,1,2,1,2011-03-10 22:06:01,2011-03-08 20:46:20
594642b31dbaa32d99c634421c615dc09c9afb29...97853e07dee08911f9a08074d185aef8a03a8912,1,1,5,6,1,2011-03-11 03:04:25,2011-02-24 01:04:14
97853e07dee08911f9a08074d185aef8a03a8912...6802c90d1fb36723c69a3f676199b8262413fe74,1,5,12,17,2,2011-03-11 03:06:43,2011-03-11 03:06:43
6802c90d1fb36723c69a3f676199b8262413fe74...12c02b378db65b047e9a7ebcc06047265652de5e,1,1,5,6,1,2011-03-11 03:08:42,2011-03-11 03:08:42
12c02b378db65b047e9a7ebcc06047265652de5e...2a61e1cd4979fcab4f2bf58a7b21f685c42f641e,1,1,0,1,1,2011-03-12 00:14:39,2011-03-11 22:11:46
2a61e1cd4979fcab4f2bf58a7b21f685c42f641e...113b1e6e0cbd6f2bd6e0d4f15addf20e0c01659f,2,29,2,31,3,2011-03-12 00:33:07,2011-03-11 16:00:46
113b1e6e0cbd6f2bd6e0d4f15addf20e0c01659f...414fa4abae9059efb57c7c940ccbc6bc33cdacc1,1,14,12,26,12,2011-03-12 00:34:12,2011-03-11 16:35:02
414fa4abae9059efb57c7c940ccbc6bc33cdacc1...2e40328c823eada334ae3d7557638a584dc3999e,21,133,133,266,42,2011-03-14 18:30:21,2011-03-14 18:30:21
2e40328c823eada334ae3d7557638a584dc3999e...e3925b741ca1d063d350fc3419f54ab1e9fc4755,1,28,12,40,6,2011-03-14 19:05:25,2011-03-14 19:04:00
e3925b741ca1d063d350fc3419f54ab1e9fc4755...2a05fe784d1c7ced3cee11e0d9e066b3bb0f361e,1,33,47,80,7,2011-03-14 19:48:37,2011-03-14 19:48:35
2a05fe784d1c7ced3cee11e0d9e066b3bb0f361e...9d4c5a12f499fd59156e16efce17f019e16708d8,2,28,2,30,19,2011-03-14 20:16:31,2011-03-14 10:16:35
9d4c5a12f499fd59156e16efce17f019e16708d8...36e75b7351c483cdc8ae281e9c43278836ea94f8,3,91,2,93,2,2011-03-14 21:47:41,2011-03-14 21:42:01
36e75b7351c483cdc8ae281e9c43278836ea94f8...55048cdf79f3c607ab986c35d0422e591e7f6448,385,8114,64,8178,387,2011-03-15 00:37:05,2011-03-10 08:54:52
247d88011349be8e8b47486b67b70842de09a43c...3c0dd8196aeb2352a16ab41c296165747e8d52f3,2,33,11,44,2,2011-03-15 00:50:24,2011-03-15 00:48:05
3c0dd8196aeb2352a16ab41c296165747e8d52f3...ab190d38b779dd9efefc4419f7c3a49e2b5c32b7,1,1,1,2,1,2011-03-15 01:24:28,2011-03-15 01:23:01
ab190d38b779dd9efefc4419f7c3a49e2b5c32b7...59f7232a302687754a3df577a0e3f1b04933445f,1,38,78,116,6,2011-03-15 17:35:49,2011-03-15 17:35:49
59f7232a302687754a3df577a0e3f1b04933445f...4a9f2de9568e122d94dc82394b54c7f1f722ce30,1,21,2,23,2,2011-03-15 17:50:24,2011-03-15 17:50:24
4a9f2de9568e122d94dc82394b54c7f1f722ce30...3c9fb3ec1af991b1b1eb7105b2a790549ca2b844,2,10,1,11,2,2011-03-15 18:39:11,2011-03-15 18:34:47
3c9fb3ec1af991b1b1eb7105b2a790549ca2b844...6111c17a0e34fbd867660aedc2ae1a4c754492e0,1,1,1,2,1,2011-03-15 18:42:23,2011-03-15 18:42:23
6111c17a0e34fbd867660aedc2ae1a4c754492e0...19e53512b838a051523995311ab0ac0df1728678,12,150,2,152,14,2011-03-16 23:34:12,2011-03-16 23:31:38
19e53512b838a051523995311ab0ac0df1728678...911cbd0cef02c93f821c0c80a3d5dbad2b692c42,3,128,4,132,10,2011-03-17 17:35:47,2011-03-17 03:12:16
911cbd0cef02c93f821c0c80a3d5dbad2b692c42...b368a3b438cf174ddf82cf7334d4ff3d84a509fc,1,0,3,3,1,2011-03-17 19:49:47,2011-03-17 19:49:47
b368a3b438cf174ddf82cf7334d4ff3d84a509fc...f67e8f243c9cbddb4989d9950cf3ef1b11c8d528,2,58,36,94,15,2011-03-18 18:11:25,2011-03-15 22:39:16
53dc74e12f87c49515082f409c9cdc5e6e67974c...c8ee19a618c77539b9eeba6ab57ab6be03ddd163,14,235,48,283,39,2011-03-25 19:02:38,2011-03-25 19:02:38
55048cdf79f3c607ab986c35d0422e591e7f6448...61fdfcb13794a165d788691c5179c7c398a63a17,1,21,20,41,1,2011-03-15 02:50:52,2011-03-15 02:50:52
61fdfcb13794a165d788691c5179c7c398a63a17...566c67b7582da5f1e3d9041e658ef8b027260410,1,2,2,4,1,2011-03-15 02:53:59,2011-03-15 02:53:59
566c67b7582da5f1e3d9041e658ef8b027260410...c02db3229e81fd08f388dc37d5b368fb2d1e1e0d,1,5,0,5,2,2011-03-17 20:38:44,2011-03-17 20:32:27
c02db3229e81fd08f388dc37d5b368fb2d1e1e0d...f10150bc6a1a19d8c4b1a159916906d3e1b9b100,1,1,1,2,1,2011-03-17 20:49:32,2011-03-17 20:49:32
f10150bc6a1a19d8c4b1a159916906d3e1b9b100...af923154e23853598296b6c9cd7d3d3dabaeacd1,3,3,4,7,4,2011-03-18 16:14:15,2011-03-18 16:14:15
af923154e23853598296b6c9cd7d3d3dabaeacd1...975d02028608a59340ac33f234e3b981e2813b30,1,1,1,2,1,2011-03-18 17:01:45,2011-03-18 17:01:45
975d02028608a59340ac33f234e3b981e2813b30...66570c196429f01786c79f177c643b07f678c32c,2,136,1,137,2,2011-03-18 17:42:43,2011-03-18 17:31:38
66570c196429f01786c79f177c643b07f678c32c...4a6f4511c8183ce7df9b347c57304b673638363d,1,5,3,8,1,2011-03-18 18:11:10,2011-03-15 19:48:34
602a4637bf38e89490586530163d184809e0fcf1...52b9ede6dbc8968ac4cd334f799ef15c27fe7c9f,1,10,2,12,2,2011-03-18 18:15:02,2011-03-18 05:39:39
52b9ede6dbc8968ac4cd334f799ef15c27fe7c9f...a4dad95be3e0051da7109aa016e9023ba714769b,1,4,0,4,1,2011-03-18 18:18:40,2011-03-15 13:01:24
a4dad95be3e0051da7109aa016e9023ba714769b...f63120be78acf87fd4f5f9a494e86474445ac119,1,5,0,5,2,2011-03-22 20:07:18,2011-03-22 20:07:18
c8ee19a618c77539b9eeba6ab57ab6be03ddd163...6631983dd1a7e82d14a27e9be856b65e58f19393,12,138,6,144,21,2011-03-31 17:07:48,2011-03-31 17:07:48
5b161b09a35db4f01e7544eb0c64ada749d719d4...c095ce1a1b41ca015758a713283bf1f0bd41e4c4,5,34,7,41,6,2011-03-18 21:25:20,2011-03-18 21:20:37
c095ce1a1b41ca015758a713283bf1f0bd41e4c4...4ae5e085ff8cc8d9a88e65ef635807400c12b62c,1,2,2,4,1,2011-03-18 22:19:12,2011-03-18 22:19:12
4ae5e085ff8cc8d9a88e65ef635807400c12b62c...c8f5bf88e1fa14ef77b128348725c31f121d6175,1,2,2,4,1,2011-03-18 22:49:26,2011-03-18 22:49:26
c8f5bf88e1fa14ef77b128348725c31f121d6175...99068639d93de1e15a92c3cd42d91355e1caffe4,1,2,0,2,1,2011-03-20 03:28:31,2011-03-20 03:28:31
99068639d93de1e15a92c3cd42d91355e1caffe4...4198de280f7b391f67cf307471bff61b91fd806d,1,6,0,6,1,2011-03-21 01:07:29,2011-03-21 01:07:29
4198de280f7b391f67cf307471bff61b91fd806d...7e28630f5ea63fb34c03ca7c8abee566da3cba9d,1,12,14,26,6,2011-03-21 21:36:49,2011-03-21 21:36:30
7e28630f5ea63fb34c03ca7c8abee566da3cba9d...d7a86ff05ec25951a14d232b6c19e9d41c0a3541,2,9,0,9,2,2011-03-21 21:48:26,2011-03-21 21:48:26
d7a86ff05ec25951a14d232b6c19e9d41c0a3541...24f9bf4180d43c96c4d080bae4d0ec0e97a64bdc,1,1,1,2,1,2011-03-22 18:24:00,2011-03-22 18:24:00
24f9bf4180d43c96c4d080bae4d0ec0e97a64bdc...391f0879815fe0395484587dca485e15e75684b2,1,1,1,2,1,2011-03-22 19:02:35,2011-03-22 19:02:33
391f0879815fe0395484587dca485e15e75684b2...8b33a1d8e411e235d7834a1268ce74e42e5eec65,1,1,0,1,1,2011-03-22 20:10:53,2011-03-22 20:10:50
4a6f4511c8183ce7df9b347c57304b673638363d...5ccdff48f3c9cbc16c10ef05b1519a6756cd8e29,1,4,1,5,1,2011-03-18 18:23:37,2011-03-16 19:59:55
5ccdff48f3c9cbc16c10ef05b1519a6756cd8e29...aeed966fe05e63b725eed604ed79558abbb52a66,1,4,3,7,1,2011-03-18 18:39:44,2011-03-18 18:39:44
7a8c729830c10d630260d3a6cb9ac3e147ce2bde...7bff70268a4e618dc0b4158065f47dc0c59a382d,1,2,2,4,2,2011-03-22 20:16:45,2011-03-19 18:19:56
7bff70268a4e618dc0b4158065f47dc0c59a382d...4cc0a0878fb0b31547c9a8d27e31f1daceb49524,1,3,3,6,2,2011-03-22 20:19:42,2011-03-22 20:18:57
4cc0a0878fb0b31547c9a8d27e31f1daceb49524...75db1995b6529cb71513a45299e2ba742e7afde9,4,12,9,21,6,2011-03-30 17:06:25,2011-03-30 17:06:19
75db1995b6529cb71513a45299e2ba742e7afde9...f2dd8dd2b96c58e2c1a4b867c67355e674bbdd89,1,1,1,2,1,2011-04-01 19:36:58,2011-04-01 19:36:57
f2dd8dd2b96c58e2c1a4b867c67355e674bbdd89...7ee8c5676b5fe5ef1b5229e4affc45a97cccc6eb,1,13,5,18,4,2011-04-02 00:41:42,2011-04-01 19:25:21
6631983dd1a7e82d14a27e9be856b65e58f19393...0b1920b202098f80d1425eee186a9e4f4dab8c82,19,586,420,1006,196,2011-04-11 23:07:54,2011-04-11 23:07:54
cbcb7fb019c2a5c4176559c0eb370c9d85571d06...77044ed5fa7cb1327c3cfe82aeeb154a3d318153,1,3,1,4,1,2011-03-26 08:42:08,2011-03-26 08:41:54
77044ed5fa7cb1327c3cfe82aeeb154a3d318153...25122b986a90ba0982697b7abcb0158c302a1019,5,28,7,35,6,2011-03-26 08:48:02,2011-03-25 23:30:54
25122b986a90ba0982697b7abcb0158c302a1019...73ebea7a4d712668b3b2e98ea4f67caf72965655,1,2,2,4,1,2011-03-26 09:00:11,2011-03-26 09:00:08
73ebea7a4d712668b3b2e98ea4f67caf72965655...2a65d2962578db2cc841c6679a1762a17ac8dfb2,2,112,12,124,6,2011-03-28 18:19:44,2011-03-28 18:19:44
2a65d2962578db2cc841c6679a1762a17ac8dfb2...e7604b1ea71a761c43bb2a757ae5015e00303349,5,172,9,181,7,2011-03-28 22:28:55,2011-03-23 11:29:49
e7604b1ea71a761c43bb2a757ae5015e00303349...978a50c500b2f02c278f9cb754b1e4a067099b4f,1,0,1,1,1,2011-03-28 22:46:36,2011-03-28 22:46:36
978a50c500b2f02c278f9cb754b1e4a067099b4f...6788ad413f2770bad74dbf9952c01040d5417895,4,9,9,18,9,2011-03-28 22:53:17,2011-03-27 14:37:23
6788ad413f2770bad74dbf9952c01040d5417895...2f2c9d47fd1a565aa1a7ffd69595d0248aa8d392,1,0,2,2,1,2011-03-28 22:55:45,2011-03-28 22:55:45
2f2c9d47fd1a565aa1a7ffd69595d0248aa8d392...a66e45693ce19345cbe819e077340a882d67c5c8,1,20,20,40,7,2011-03-28 22:56:39,2011-03-23 22:10:57
a66e45693ce19345cbe819e077340a882d67c5c8...e9a1dd7930c89917a46ead39390424366ab7f87b,1,1,1,2,1,2011-03-28 22:59:43,2011-03-28 22:59:41
e9a1dd7930c89917a46ead39390424366ab7f87b...98b56636c02c08d318cdeb65e77125294e758e16,1,20,20,40,7,2011-03-29 00:36:50,2011-03-29 00:36:50
98b56636c02c08d318cdeb65e77125294e758e16...c0b461d9a18c193c269390c6d23841008df098e8,1,1,1,2,1,2011-03-29 00:37:14,2011-03-29 00:37:14
c0b461d9a18c193c269390c6d23841008df098e8...1768c721350cce16f406f13f05e886fc0b7d3d2c,1,13,0,13,1,2011-03-29 16:58:50,2011-03-29 16:58:50
1768c721350cce16f406f13f05e886fc0b7d3d2c...038306a6c36412f7c4be7094f344fccf163efc29,2,62,0,62,2,2011-03-29 17:47:14,2011-03-29 17:47:14
038306a6c36412f7c4be7094f344fccf163efc29...e35b2d9617491b49cf57ca1b03e81b6522c4081d,1,3,3,6,2,2011-03-29 19:23:42,2011-03-29 07:53:32
e35b2d9617491b49cf57ca1b03e81b6522c4081d...6394ba28c82335cdb6e3578728957cd3eb9f72f1,1,20,0,20,1,2011-03-30 17:18:58,2011-03-30 17:18:12
6394ba28c82335cdb6e3578728957cd3eb9f72f1...ed74db01f35c525d90a5d1ec93f96a7602ca2711,2,7,5,12,5,2011-03-30 22:53:07,2011-03-30 22:53:07
8b33a1d8e411e235d7834a1268ce74e42e5eec65...3ec391ba368ac24be377d74edea832b00970ce47,1,1,1,2,1,2011-03-22 21:33:23,2011-03-19 14:19:47
3ec391ba368ac24be377d74edea832b00970ce47...f0d0fcc4aabee42bf4725e5efbeffef65644d14c,1,2,1,3,1,2011-03-22 21:33:23,2011-03-19 14:22:50
f0d0fcc4aabee42bf4725e5efbeffef65644d14c...5e78f57087908005a274fd3f58c316be5d8b23f4,1,4,0,4,1,2011-03-22 21:34:25,2011-03-19 14:27:25
5e78f57087908005a274fd3f58c316be5d8b23f4...67913a023251dfd881b631c4eda8cac9ad79ed3e,1,6,0,6,1,2011-03-22 21:38:59,2011-02-18 23:30:15
67913a023251dfd881b631c4eda8cac9ad79ed3e...2b2736153db4e363121f016c94786e2d7770940f,1,4,4,8,3,2011-03-22 21:39:30,2011-03-17 21:13:19
2b2736153db4e363121f016c94786e2d7770940f...69c3e1961b67612fe8a801fc396e52fad7aa3391,1,2,1,3,2,2011-03-23 22:02:11,2011-03-23 22:01:49
69c3e1961b67612fe8a801fc396e52fad7aa3391...0fb44a2f93ef13be20086ab4288c9a7166905536,2,2,0,2,1,2011-03-24 02:24:09,2011-03-24 02:23:35
0fb44a2f93ef13be20086ab4288c9a7166905536...53bec1c8625c38888a15f7eb278cc19a212c154a,2,28,6,34,5,2011-03-25 18:51:29,2011-03-18 20:02:14
bfa9db9dd6a13af475f256bb1d95118ac38f8590...d63a551f86020be472ea0a047296626775a6b80d,1,30,20,50,8,2011-04-11 23:52:23,2011-03-29 18:08:39
d63a551f86020be472ea0a047296626775a6b80d...bc8489580cbc36eca511988ca134326b6ec2e2cc,3,50,2,52,4,2011-04-12 21:47:16,2011-04-07 14:57:33
bc8489580cbc36eca511988ca134326b6ec2e2cc...425b57bedc4695c152e500f1dff303e932791a9a,3,57,17,74,21,2011-04-13 08:10:47,2011-04-10 05:56:26
425b57bedc4695c152e500f1dff303e932791a9a...ac1da4b4073f77f329b8bdff974e33840a7598b8,3,40,1,41,3,2011-04-13 17:24:28,2011-04-13 16:19:15
0b1920b202098f80d1425eee186a9e4f4dab8c82...eb57d1b9b197a0d5be6047c0d5e653468f73cac7,4,11,5,16,6,2011-04-30 18:38:25,2011-04-30 18:38:25
ad861e135481c8ea380f5cd28bb71041c14942be...5c35dff4192b0e204ab4145b7f9dcdba6e76a93e,2,52,27,79,20,2011-04-01 06:40:19,2011-04-01 01:32:21
5c35dff4192b0e204ab4145b7f9dcdba6e76a93e...4877279efa9eb6c8dce51081df52e8f48750b61a,1,7,0,7,1,2011-04-01 16:19:08,2011-04-01 16:19:00
4877279efa9eb6c8dce51081df52e8f48750b61a...362785f704b5754f6025bc4bcbe5835688d3002c,1,12,3,15,2,2011-04-01 16:49:25,2011-04-01 02:27:28
362785f704b5754f6025bc4bcbe5835688d3002c...a7254f3df9362f2ff7fde940a2871303a64931b1,1,3,12,15,2,2011-04-01 19:38:42,2011-04-01 19:38:42
a7254f3df9362f2ff7fde940a2871303a64931b1...4d64f363385be9d5e83ededd70faf91ebc6e792b,2,5,4,9,3,2011-04-02 00:40:19,2011-03-29 21:41:23
4d64f363385be9d5e83ededd70faf91ebc6e792b...e1a72f0e2e4fa668d73657c55ed399f674af6ec0,2,10,2,12,4,2011-04-02 00:40:19,2011-03-29 21:54:49
e1a72f0e2e4fa668d73657c55ed399f674af6ec0...6d85da185c850cf871e1aeec25baa3da1971610f,3,164,5,169,8,2011-04-02 00:40:41,2011-02-23 22:46:35
6d85da185c850cf871e1aeec25baa3da1971610f...787a343b588de26784fef97f953420b53a6e1d73,4,26,7,33,5,2011-04-02 01:00:43,2011-04-02 01:00:43
787a343b588de26784fef97f953420b53a6e1d73...61d0b5af87c27d7e01a49a27fe24c2d6e41de172,1,2,2,4,1,2011-04-02 02:06:41,2011-04-02 02:06:41
61d0b5af87c27d7e01a49a27fe24c2d6e41de172...ffb3ee6084f1596399cc70e7e5bf27ce9d7485d4,1,0,2,2,1,2011-04-02 05:18:23,2011-04-02 05:18:23
ffb3ee6084f1596399cc70e7e5bf27ce9d7485d4...21e3b668cb4be40465e060c9248bee1b7d4635d9,5,7,0,7,4,2011-04-02 09:35:23,2011-03-16 07:44:05
21e3b668cb4be40465e060c9248bee1b7d4635d9...3002c01f408c1aebd0a20faa06ff5ec7e503440e,1,2,2,4,3,2011-04-02 09:35:44,2011-03-16 07:53:36
3002c01f408c1aebd0a20faa06ff5ec7e503440e...dcc2dd5e1fa7709f592c25dd91b9c2e18bbaca11,1,18,0,18,1,2011-04-03 08:09:00,2011-04-03 08:09:00
598792ba91a32d2c386b0394c20d87a69ecbbc61...2a88dd3bc1d0ee192dd0d5976db37765498df80b,5,94,2,96,10,2011-04-14 01:25:33,2011-04-02 04:53:07
2a88dd3bc1d0ee192dd0d5976db37765498df80b...d6f5b8a2a6d1f7f33e8638c18f736d49c94ceaaa,2,4,0,4,3,2011-04-14 01:35:39,2011-04-05 03:27:20
d6f5b8a2a6d1f7f33e8638c18f736d49c94ceaaa...e2d90185351b1d1b93f33f71cff10cc7040f708b,1,4,0,4,1,2011-04-14 01:35:56,2011-04-06 00:38:23
e2d90185351b1d1b93f33f71cff10cc7040f708b...80711b0ff90cede610365cba65e46c3128b57bfd,3,12,0,12,4,2011-04-14 21:26:46,2011-04-14 20:45:32
80711b0ff90cede610365cba65e46c3128b57bfd...b4ff36a41b242c0b379d3c27fb30818de54fe2d4,4,43,0,43,8,2011-04-15 06:42:08,2011-04-15 06:33:43
b4ff36a41b242c0b379d3c27fb30818de54fe2d4...da9b3340ebb7501ebb8a2896d2c259ffabdab340,1,60,0,60,1,2011-04-15 07:12:19,2011-04-15 07:12:19
eb57d1b9b197a0d5be6047c0d5e653468f73cac7...cee4ce39a94e105bb4f1a1b5e3df949d8e044d84,4,9,3,12,6,2011-05-21 02:24:37,2011-05-21 02:24:37
6b5a7033bb653b1463ffbfd0ef4a0036b7520ed1...d2298d225ca61cd5eb9b78b0a5e9c4b27b66d4aa,2,55,1,56,6,2011-04-12 00:01:25,2011-04-11 23:48:18
d2298d225ca61cd5eb9b78b0a5e9c4b27b66d4aa...752bbd6b426d4be9fc8a352c7bec0f89839828d7,3,110,2,112,7,2011-04-12 00:03:50,2011-03-27 10:14:34
752bbd6b426d4be9fc8a352c7bec0f89839828d7...d953856d87f2b12740332940011f9fd0e2cb41a2,1,0,1,1,1,2011-04-12 00:03:50,2011-03-27 11:31:55
d953856d87f2b12740332940011f9fd0e2cb41a2...ca028f4b37d764533ecf59601af3c393d44cc446,1,2,7,9,2,2011-04-12 00:27:24,2011-03-30 13:06:41
ca028f4b37d764533ecf59601af3c393d44cc446...682b66c0c1d8e04f6d589845047aa0b50fc80129,1,1,1,2,1,2011-04-12 00:28:28,2011-03-30 13:17:00
682b66c0c1d8e04f6d589845047aa0b50fc80129...0f47f63746df1e059ff2d99f0ce0123582952213,1,1,1,2,1,2011-04-12 00:30:36,2011-04-12 00:30:33
0f47f63746df1e059ff2d99f0ce0123582952213...83727a4c86e7e7fe1b698bb22b8ab2a7f119d67d,2,20,0,20,2,2011-04-12 21:55:18,2011-03-31 21:02:14
83727a4c86e7e7fe1b698bb22b8ab2a7f119d67d...9b3b37e498dfed0181a58b278eb508e1b9cf0f33,1,4,0,4,1,2011-04-12 22:21:04,2011-04-12 22:20:58
9b3b37e498dfed0181a58b278eb508e1b9cf0f33...81cbd42cf51902083148a575d3a52cae2851732b,2,13,0,13,2,2011-04-12 22:51:57,2011-03-31 14:55:26
81cbd42cf51902083148a575d3a52cae2851732b...af96447016a5a3811e703685bc4d46ecdbbcc032,1,2,2,4,1,2011-04-13 08:27:00,2011-04-13 08:26:57
af96447016a5a3811e703685bc4d46ecdbbcc032...301f53c2aa998fae3bd43d41b2730560a06d7601,3,19,18,37,4,2011-04-13 16:46:28,2011-04-05 21:37:40
301f53c2aa998fae3bd43d41b2730560a06d7601...9533e879f0d3cfaf5de90825813237b330e64ee5,2,14,1,15,3,2011-04-13 16:55:49,2011-04-13 16:17:18
9533e879f0d3cfaf5de90825813237b330e64ee5...296ff04cdc9c680f35e71ddecea4dde9c7ae1c92,2,153,0,153,2,2011-04-13 19:49:13,2011-04-13 19:49:11
296ff04cdc9c680f35e71ddecea4dde9c7ae1c92...e8cf98c841c8aa80975fa2bd96187f49a6cbb760,3,90,49,139,13,2011-04-14 00:18:19,2011-03-27 10:14:34
e8cf98c841c8aa80975fa2bd96187f49a6cbb760...2f984515619d7c303aa484dee7e243b454b663f6,4,13,161,174,11,2011-04-14 00:31:09,2011-04-14 00:30:12
2f984515619d7c303aa484dee7e243b454b663f6...90348a616d36922f87fac3c47fa026651c0fbbd8,3,150,15,165,10,2011-04-14 00:42:54,2011-03-27 10:14:34
90348a616d36922f87fac3c47fa026651c0fbbd8...d0e84b0088a865ed59afd4854b40a3eaf864928b,1,2,0,2,2,2011-04-14 00:49:50,2011-04-02 04:53:07
dcc2dd5e1fa7709f592c25dd91b9c2e18bbaca11...9ccf0e527f066ca69e610beb04d9507ee5bf187c,3,46,2,48,3,2011-04-11 22:33:24,2011-04-11 22:33:24
9e6498d5fad1687c5a9bd9321188f3626a9f007a...c9b40da368dfba3c026225cf37317beef187c16d,6,324,4,328,26,2011-04-19 18:32:26,2011-04-14 03:53:39
c9b40da368dfba3c026225cf37317beef187c16d...5cfac218526d5d2ca7983247c2e06a4793253178,3,101,6,107,15,2011-04-20 23:04:33,2011-03-29 22:31:41
5cfac218526d5d2ca7983247c2e06a4793253178...3935adced09cd557a836d00558b52d777b9a20a2,2,42,0,42,3,2011-04-20 23:04:39,2011-03-29 23:34:05
3935adced09cd557a836d00558b52d777b9a20a2...efca5f8e78a222ffba1efd9e99ebd9bc88ffe7f0,1,45,0,45,2,2011-04-20 23:04:46,2011-04-02 00:46:18
efca5f8e78a222ffba1efd9e99ebd9bc88ffe7f0...934c82b8b8f0dabbcc5635f1912fa905103a4865,1,61,0,61,1,2011-04-21 18:42:40,2011-04-20 16:04:42
934c82b8b8f0dabbcc5635f1912fa905103a4865...0b3ecc05a681c74d35334cdd269f68f4cd473281,2,27,10,37,7,2011-04-21 19:17:21,2011-04-21 19:17:21
0b3ecc05a681c74d35334cdd269f68f4cd473281...a2328dc73c425c4d6f58cb8d97ece92adafcb96b,4,135,12,147,15,2011-04-25 23:52:31,2011-04-25 23:04:07
a2328dc73c425c4d6f58cb8d97ece92adafcb96b...b1be5409bd82bf228a6e8678d100197c07e47af1,3,13,0,13,3,2011-04-27 02:56:10,2011-04-26 03:24:51
b1be5409bd82bf228a6e8678d100197c07e47af1...a7ce79124e6f992fa96f2dd60b8d984700e3448c,3,23,1,24,4,2011-04-27 03:04:32,2011-04-27 03:02:54
a7ce79124e6f992fa96f2dd60b8d984700e3448c...8a03cf7a7bace8c2c87a5d4d3f208715b9a321e3,1,1,1,2,1,2011-04-27 15:49:24,2011-04-27 15:49:24
8a03cf7a7bace8c2c87a5d4d3f208715b9a321e3...9812e31e8ba43be9c50d07f83cbf459427a5d877,6,1043,3,1046,10,2011-05-01 21:02:33,2011-05-01 18:38:10
9812e31e8ba43be9c50d07f83cbf459427a5d877...5e1b7cadb48aaf47978b7661a5ce58b0c4d21d27,4,73,0,73,5,2011-05-06 20:39:12,2010-11-30 11:18:02
5e1b7cadb48aaf47978b7661a5ce58b0c4d21d27...00aee736922b1fc1fae3953f08d24ced95b8a65f,1,10,0,10,1,2011-05-06 20:42:55,2011-05-06 20:42:55
00aee736922b1fc1fae3953f08d24ced95b8a65f...9f0b1a9bc60f70b7c5c014743eb1edd69c36db76,4,607,0,607,7,2011-05-06 21:36:04,2011-01-19 01:00:38
9f0b1a9bc60f70b7c5c014743eb1edd69c36db76...c33790262b0c84b977fd516bff15b9850ac2ab5e,1,8,0,8,1,2011-05-06 23:02:22,2011-05-03 21:56:04
c33790262b0c84b977fd516bff15b9850ac2ab5e...72824d8d2da24a6e9841937a37f8e8f8cc474af8,1,1,0,1,1,2011-05-06 23:03:39,2011-05-03 15:51:53
cee4ce39a94e105bb4f1a1b5e3df949d8e044d84...61553ccdda8008ceb04d7c19ed0890459aa48c58,22,252,56,308,46,2011-06-29 10:49:17,2011-06-29 10:49:17
8d88c00b777d404a7786d34b14f7ff8f67001337...82bc25d5ada29b8d60787259b13feb39eed3296e,1,1,18,19,5,2011-05-01 15:00:34,2011-05-01 14:34:05
82bc25d5ada29b8d60787259b13feb39eed3296e...75a0cf970fb48440a93a62796ab1f128fcbe7d76,4,25,8,33,7,2011-05-02 22:03:50,2011-05-02 19:13:06
75a0cf970fb48440a93a62796ab1f128fcbe7d76...c409aab397816ddfbe76e15fbedb435bf4061e5d,1,2,3,5,2,2011-05-05 04:41:01,2011-05-05 04:41:01
c409aab397816ddfbe76e15fbedb435bf4061e5d...ad487d3226928b7e3783c0d3b703e97a72cb5727,1,4,0,4,1,2011-05-05 22:40:55,2011-05-05 22:40:45
ad487d3226928b7e3783c0d3b703e97a72cb5727...fc8afd45c7150385897b867bb2123d81f4bb9943,1,4,1,5,1,2011-05-05 23:52:05,2011-05-05 23:52:05
fc8afd45c7150385897b867bb2123d81f4bb9943...55bff5bab90903783751677ff17b0fab1cd8157f,1,82,93,175,57,2011-05-07 00:06:36,2011-05-06 23:48:44
55bff5bab90903783751677ff17b0fab1cd8157f...5ab3ea3955dd90876ae8c1e9ce67395c767f787c,1,1,1,2,1,2011-05-06 23:05:04,2011-05-06 23:05:02
5ab3ea3955dd90876ae8c1e9ce67395c767f787c...c2b5ea218ca7ab11f0b0967b4037d9f109794096,2,38,21,59,7,2011-05-07 03:53:40,2011-05-03 21:51:15
c2b5ea218ca7ab11f0b0967b4037d9f109794096...110f06578da9fa4f5389269e9c86e56558a2d7dc,1,4,5,9,2,2011-05-07 19:30:58,2011-05-07 19:30:53
d0e84b0088a865ed59afd4854b40a3eaf864928b...050bbf0bc482178b4b5f4c81c50e22f6bbcb6b13,1,1,1,2,1,2011-04-14 01:43:08,2011-04-14 01:37:49
050bbf0bc482178b4b5f4c81c50e22f6bbcb6b13...bb621f7c2eb9561af6bca34549294b381a98cdac,1,18,6,24,14,2011-04-14 03:32:46,2011-04-13 20:54:47
bb621f7c2eb9561af6bca34549294b381a98cdac...58002d56bc79410c5ff397fc0e1ffec0665db38a,5,39,6,45,6,2011-04-14 04:20:05,2011-04-14 04:20:05
58002d56bc79410c5ff397fc0e1ffec0665db38a...61100788ada9e9dbf3cb04071ac642c1aab849f8,1,2,2,4,1,2011-04-14 05:03:48,2011-04-14 05:03:48
61100788ada9e9dbf3cb04071ac642c1aab849f8...8417870f513e6f1ab98e07fe95d3430dbec48b87,1,5,1,6,1,2011-04-14 17:42:57,2011-04-14 07:01:23
8417870f513e6f1ab98e07fe95d3430dbec48b87...6c5b31bd80d2d38600d84a5be0ae9c5bbad94c01,2,41,9,50,16,2011-04-14 21:12:01,2011-04-14 18:33:54
6c5b31bd80d2d38600d84a5be0ae9c5bbad94c01...74d94b0dd1d10402c765a6c0cf2578ce1a734f99,1,1,2,3,2,2011-04-14 21:40:50,2011-04-14 16:54:36
74d94b0dd1d10402c765a6c0cf2578ce1a734f99...ed316ae3508f817b4ae4568b445b39bb86a5f6f2,1,5,0,5,1,2011-04-14 22:11:35,2011-04-14 22:11:35
ed316ae3508f817b4ae4568b445b39bb86a5f6f2...cbdd92e1840e1f2d8df4c0be30d0795c025a7b0b,1,4,5,9,1,2011-04-16 20:55:03,2011-04-16 20:55:03
cbdd92e1840e1f2d8df4c0be30d0795c025a7b0b...d3d35ec3ca63c8e39996c4a9b5f0e3a0d276dcd5,4,58,0,58,4,2011-04-18 23:52:53,2011-04-18 23:52:53
205b9beb6be0d563a85027158e8af3bee8472b9e...9e26dab150e15cdbc7fbec76dcadeafed7d85646,9,238,8,246,22,2011-05-11 09:24:48,2011-05-11 07:41:16
9e26dab150e15cdbc7fbec76dcadeafed7d85646...7ea70943146c8ce5aad163d2440a299454a0eebd,1,11,4,15,3,2011-05-11 19:31:35,2011-05-11 19:31:35
7ea70943146c8ce5aad163d2440a299454a0eebd...337c48db5fe06ddaf626b03b7db6c6f48c5d3b62,5,8,8,16,8,2011-05-11 20:32:40,2011-05-11 20:32:40
337c48db5fe06ddaf626b03b7db6c6f48c5d3b62...efca334be2b999b2112eb963c3ece7517c06713f,90,45009,731,45740,85,2011-05-13 07:54:00,2011-05-13 02:16:40
efca334be2b999b2112eb963c3ece7517c06713f...17c88db1580e8afc3315efccc00514c7e4e19ca7,1,10,10,20,6,2011-05-13 13:59:33,2011-05-13 13:59:33
17c88db1580e8afc3315efccc00514c7e4e19ca7...a46c63bae77e82e11a12e935433913be182bfa07,1,7,7,14,3,2011-05-13 14:06:20,2011-05-13 14:06:20
a46c63bae77e82e11a12e935433913be182bfa07...91bd144d2ca38843bd35f2d7b06030cd730a03ff,1,8,8,16,4,2011-05-13 14:09:28,2011-05-13 14:09:28
91bd144d2ca38843bd35f2d7b06030cd730a03ff...e505a1215c5e1243c8790bf7d23c96c27900fff7,8,640,0,640,12,2011-05-16 01:39:07,2011-05-16 01:25:11
1e7769dfa374706de49d6b828dd5dcc809ebc30e...de44eafd7854d06cd85006f509b7051e8540589b,4,41,7,48,5,2011-06-29 11:24:02,2011-06-29 11:24:02
de44eafd7854d06cd85006f509b7051e8540589b...e286480e3495040bfe2d87f6fdf3c56c5f695bb3,1,2,2,4,1,2011-06-29 12:44:38,2011-06-29 12:44:38
80b0225b980ad257f5a67d521d0597d143d5f625...7dd22c26e4365698dc3efddf138c4d399cb912c8,4,46,6,52,5,2011-05-21 02:40:06,2011-05-21 02:40:06
7dd22c26e4365698dc3efddf138c4d399cb912c8...823604a4e0a6120ade470e98f8c0058d3fd0de05,1,2,2,4,1,2011-05-21 07:10:23,2011-05-21 07:10:23
110f06578da9fa4f5389269e9c86e56558a2d7dc...31ed87b0a964a9989c56a6e08906b96c492186ee,1,15,0,15,1,2011-05-09 17:29:09,2011-05-01 18:03:08
31ed87b0a964a9989c56a6e08906b96c492186ee...11beac70e22dd4fc2611cada19ca30031df8fa41,1,14,2,16,3,2011-05-09 17:49:27,2011-05-09 17:49:20
11beac70e22dd4fc2611cada19ca30031df8fa41...307f39ce9ed8f4d3de06f63cd1855157be2db82f,2,64,7,71,10,2011-05-10 20:57:25,2011-05-10 20:42:49
307f39ce9ed8f4d3de06f63cd1855157be2db82f...9a3dd754be6531b01c0eea2e60d501cba0332793,2,4,0,4,1,2011-05-11 20:40:42,2011-05-11 20:40:42
9a3dd754be6531b01c0eea2e60d501cba0332793...1fde5f51b4da77587e2f6ab6087d27d412e12464,2,56,0,56,3,2011-05-14 20:38:04,2011-05-14 19:17:13
1fde5f51b4da77587e2f6ab6087d27d412e12464...e7ac6d8fcd3841da072d8b4b6c328b33549d45c3,5,166,5,171,10,2011-05-14 21:15:31,2011-05-14 13:58:41
e7ac6d8fcd3841da072d8b4b6c328b33549d45c3...9d717f6bef74a1c555f891961faf0f32fd3cf82c,1,22,2,24,2,2011-05-14 21:21:41,2011-05-14 14:06:32
9d717f6bef74a1c555f891961faf0f32fd3cf82c...56aa2fd4c3d16ac136c90ee894ca835456476bf3,1,14,1,15,2,2011-05-14 21:36:58,2011-05-12 04:49:26
56aa2fd4c3d16ac136c90ee894ca835456476bf3...80c2fe9456a79338a236793c1afb0dd0687ae61d,2,32,3,35,3,2011-05-14 21:43:00,2011-05-12 06:18:21
80c2fe9456a79338a236793c1afb0dd0687ae61d...d4f82ea590765048ab390462e487266a9f5953eb,2,7,1,8,2,2011-05-16 17:21:16,2011-05-12 04:43:24
d4f82ea590765048ab390462e487266a9f5953eb...e83c6959db3e6f076eaf34388d0014f1c6677826,1,12,3,15,2,2011-05-16 17:33:19,2011-04-01 02:27:28
e83c6959db3e6f076eaf34388d0014f1c6677826...249361cab798420679ae7d3dee3b33f04c97cb35,1,23,13,36,8,2011-05-16 21:30:43,2011-05-16 11:56:40
249361cab798420679ae7d3dee3b33f04c97cb35...103a450d3a6ca5281a5ac6579dfecbebe748f745,2,15,1,16,2,2011-05-16 22:01:33,2011-05-16 22:00:33
d3d35ec3ca63c8e39996c4a9b5f0e3a0d276dcd5...90802d628df9ca516036c287c37610029a2e8dc7,2,171,19,190,18,2011-04-20 22:44:34,2011-04-20 22:44:34
90802d628df9ca516036c287c37610029a2e8dc7...d00739ce56b07ab438eceffb0d701e90dc8b3fdc,1,1,1,2,1,2011-04-21 19:20:50,2011-04-13 23:54:50
d00739ce56b07ab438eceffb0d701e90dc8b3fdc...6c7c4aeab6918425e27f1280842e39151cf270ae,1,1,1,2,1,2011-04-21 19:26:27,2011-03-30 19:05:56
6c7c4aeab6918425e27f1280842e39151cf270ae...ed657e9d462e5d3c8dda82569209ec3508d39401,1,9,0,9,2,2011-04-22 02:52:01,2011-04-22 02:39:16
ed657e9d462e5d3c8dda82569209ec3508d39401...3ce5e6fe5e646c6f768097028eac239574ea1e53,1,6,6,12,5,2011-04-22 23:01:34,2011-04-22 23:01:34
3ce5e6fe5e646c6f768097028eac239574ea1e53...c8e447ee63da9eb1d19141d8772f202edd4afe26,2,15,1,16,2,2011-04-22 23:38:29,2011-04-22 23:38:27
c8e447ee63da9eb1d19141d8772f202edd4afe26...c85455a954411b38232e79752d4abb61bb75031b,5,26,6,32,6,2011-04-23 00:06:25,2011-04-23 00:06:02
c85455a954411b38232e79752d4abb61bb75031b...1f470b68d6bf90b47339175fbd63bd7bd8fad06c,1,2,2,4,1,2011-04-23 00:49:56,2011-04-23 00:49:56
1f470b68d6bf90b47339175fbd63bd7bd8fad06c...621b024b6ed5e3af24867e2824dc4a9a77ca77ef,1,1,1,2,1,2011-04-23 00:50:40,2011-04-23 00:50:40
621b024b6ed5e3af24867e2824dc4a9a77ca77ef...0325a21ff329ea7044ea6e6ae13085dcd34cbf4f,1,1,1,2,1,2011-04-23 02:04:43,2011-04-23 02:04:43
0325a21ff329ea7044ea6e6ae13085dcd34cbf4f...8fd1c68f06221e04ccc5a40a04e0f5aa13bd1792,1,100,0,100,1,2011-04-23 02:33:23,2011-04-23 02:31:14
8fd1c68f06221e04ccc5a40a04e0f5aa13bd1792...8df6f9e54469902a3d1da30a57cbfbe6900f977d,7,125,3,128,9,2011-04-25 19:22:18,2011-04-25 19:22:18
8df6f9e54469902a3d1da30a57cbfbe6900f977d...68c8a69f4cdda9e6e1d80f1ed90efbabf410f20c,1,2,2,4,2,2011-04-25 20:45:58,2011-04-21 11:43:12
68c8a69f4cdda9e6e1d80f1ed90efbabf410f20c...bbffd9e5025ef22156c7d21c746a51529f821664,1,2,2,4,1,2011-04-26 16:48:28,2011-04-26 16:48:28
bbffd9e5025ef22156c7d21c746a51529f821664...7c6f0147dfa78641a65c7cb0d84f6723b29a946e,1,43,25,68,15,2011-04-28 05:08:21,2011-04-27 18:10:10
7c6f0147dfa78641a65c7cb0d84f6723b29a946e...1343ee8d54f1743b19e5b70b8f377ec65508f9a6,2,10,2,12,2,2011-04-28 08:54:28,2011-04-28 07:36:04
1343ee8d54f1743b19e5b70b8f377ec65508f9a6...fcc04e67c87f872910e2a77c4d6888ac1568faa7,2,6,1,7,2,2011-04-28 08:57:00,2011-04-28 06:38:28
85bc8d02fa17639d0f5eb225fed7ece5e358a631...0271b785a1926794e1408d67ebff7711f1504b89,1,1,1,2,1,2011-05-17 17:51:30,2011-05-17 17:51:30
0271b785a1926794e1408d67ebff7711f1504b89...85934bcf2a40980352b3fbe9cebd68aca7a1e074,1,0,7,7,1,2011-05-17 21:55:26,2011-05-17 21:55:26
85934bcf2a40980352b3fbe9cebd68aca7a1e074...68d840b47d18d5c64c33d80c95c39941b6e9ad6c,1,133,0,133,1,2011-05-19 04:12:15,2011-05-19 01:39:06
e286480e3495040bfe2d87f6fdf3c56c5f695bb3...99b210d7eaca6d0bf8731b338ce0a32d9df1e493,1,3,3,6,3,2011-07-01 07:33:41,2011-06-30 13:20:23
99b210d7eaca6d0bf8731b338ce0a32d9df1e493...f78f654131ae6d119110322e82484acf567e4f72,1,9,9,18,9,2011-07-01 22:38:53,2011-07-01 22:38:53
f78f654131ae6d119110322e82484acf567e4f72...efca5456b8dd3e94b3af02ccaf94d032ded6a48c,2,50,11,61,5,2011-07-01 22:49:42,2011-07-01 22:49:39
823604a4e0a6120ade470e98f8c0058d3fd0de05...d22259426c900f0083513d8b43c250792a5ca7f7,1,1,1,2,1,2011-05-24 17:44:14,2011-05-24 05:40:09
d22259426c900f0083513d8b43c250792a5ca7f7...2b91256c6185fbcaaa5fc49a3a541e5ed0ec0e75,2,59,1,60,2,2011-05-24 17:50:33,2011-05-23 09:02:53
2b91256c6185fbcaaa5fc49a3a541e5ed0ec0e75...9b3472637e37da3d5e93356a4ea0de6a53800226,1,2,2,4,2,2011-05-25 06:35:18,2011-05-25 04:26:57
9b3472637e37da3d5e93356a4ea0de6a53800226...eb4c9ed881cb93bc19401eb4270d113c4ba52d6b,1,29,7,36,6,2011-05-25 06:36:54,2011-05-23 11:10:00
eb4c9ed881cb93bc19401eb4270d113c4ba52d6b...58a1d7ec30a5e26625f42c97c3cbe9134368605d,2,29,5,34,3,2011-05-27 17:47:34,2011-05-20 04:50:35
58a1d7ec30a5e26625f42c97c3cbe9134368605d...b96ae6674d6b499c5cf1ed4825520adabb22c943,1,6,0,6,1,2011-06-03 06:14:35,2011-06-03 06:14:35
b96ae6674d6b499c5cf1ed4825520adabb22c943...f23c45f7f46143c225696b57422234d746698b73,2,24,0,24,8,2011-06-03 06:37:28,2011-06-03 06:35:11
f23c45f7f46143c225696b57422234d746698b73...0cb4484d433ce0dc27015f18159c2e9d0c601081,3,6,5,11,4,2011-06-03 11:27:35,2011-06-03 11:19:06
0cb4484d433ce0dc27015f18159c2e9d0c601081...4956e3c0a25992bfa454a43c377ac120e0ff7727,6,238,62,300,55,2011-06-03 12:12:14,2011-06-03 12:12:14
4956e3c0a25992bfa454a43c377ac120e0ff7727...1d7a46a58884de2cb566e4ae54e39b4895355527,1,3,7,10,3,2011-06-03 12:50:02,2011-06-03 12:38:55
1d7a46a58884de2cb566e4ae54e39b4895355527...37d529f818aacd1146b1d927b3251bbefcea389f,1,9,9,18,9,2011-06-03 12:50:12,2011-06-02 20:08:18
103a450d3a6ca5281a5ac6579dfecbebe748f745...63c0d71213da10944f8ed35759db744b313be931,2,9,2,11,4,2011-05-17 20:25:25,2011-05-17 20:22:34
63c0d71213da10944f8ed35759db744b313be931...f4e69e44ff3b73921e1a009df104f3db962f10ee,1,133,0,133,1,2011-05-19 04:13:49,2011-05-19 01:39:06
3ac0ada758004ffe141d79c282e16ed8c8f4cc83...4b60e87afec10e7e051e37cd5d00d0fbe3568a7d,24,523,873,1396,162,2011-05-19 17:37:51,2011-05-19 17:37:51
4b60e87afec10e7e051e37cd5d00d0fbe3568a7d...73ea01cd64666394683617b5f129f9f971be8d23,24,873,523,1396,163,2011-05-20 00:50:13,2011-05-20 00:50:13
73ea01cd64666394683617b5f129f9f971be8d23...317653b4dfa2286f7fd99fe3e6a936aa5efe5a8e,4,199,50,249,14,2011-05-20 15:34:18,2011-05-20 01:32:05
317653b4dfa2286f7fd99fe3e6a936aa5efe5a8e...7ea19d02fd95d50b6f76ddb457fd3836e1de6694,2,9,1,10,2,2011-05-20 15:34:25,2011-05-20 02:51:30
efca5456b8dd3e94b3af02ccaf94d032ded6a48c...432d54900e8605d994ec5a25924f7fdc02fa0f62,1,0,15,15,1,2011-07-03 18:26:44,2011-07-03 07:56:38
432d54900e8605d994ec5a25924f7fdc02fa0f62...38a0145869d408512657893f539a7be2a582934a,1,5,5,10,5,2011-07-03 18:27:23,2011-07-03 07:46:24
38a0145869d408512657893f539a7be2a582934a...220e2281e47ef13d99668685e26bbd8e45db18d5,1,11,6,17,1,2011-07-04 16:27:15,2011-06-15 15:07:23
220e2281e47ef13d99668685e26bbd8e45db18d5...075605f304b6eca8fe33d654bebdaed092485212,1,1,1,2,1,2011-07-04 16:50:10,2011-03-11 10:09:05
075605f304b6eca8fe33d654bebdaed092485212...8cecc50b9db23ef4bc6de228707c6dab728b52ff,1,1,1,2,1,2011-07-04 16:53:30,2011-05-11 09:33:16
8cecc50b9db23ef4bc6de228707c6dab728b52ff...7962eeef22d41621d06c2ae81d6bca9060b6a8d5,1,2,2,4,2,2011-07-04 17:00:31,2011-06-27 17:25:05
7962eeef22d41621d06c2ae81d6bca9060b6a8d5...c6846565cf44d5bcaeb184c1ef845293e188ebfc,1,10,3,13,2,2011-07-04 23:38:07,2011-07-04 23:06:39
c6846565cf44d5bcaeb184c1ef845293e188ebfc...f91988979f340000a416dfbdd7488b9ae84ee419,1,5,2,7,2,2011-07-04 23:41:30,2011-06-29 18:24:16
f91988979f340000a416dfbdd7488b9ae84ee419...3e2a2a76fdacd16d45cdbbd9ce0af57bc93f283f,1,142,30,172,9,2011-07-04 23:41:37,2011-06-29 19:14:02
3e2a2a76fdacd16d45cdbbd9ce0af57bc93f283f...1c174cc1aa1d0b13d8a1ee832fcc7f1943a2643b,1,1,1,2,1,2011-07-05 00:42:32,2011-04-02 14:43:55
1c174cc1aa1d0b13d8a1ee832fcc7f1943a2643b...82cfdb88facd946926a40822b6939737e0ebddc4,1,1,1,2,1,2011-07-06 00:24:37,2011-07-05 08:32:23
82cfdb88facd946926a40822b6939737e0ebddc4...073fbea0f5776ba3733075a283c094af85378612,4,81,2,83,5,2011-07-06 23:55:50,2011-07-06 23:52:14
073fbea0f5776ba3733075a283c094af85378612...b62ecdc5bbee2a3bdfa8b62d43bb94326a9b5e4b,2,3,6,9,3,2011-07-07 21:54:13,2011-07-05 19:54:06
b62ecdc5bbee2a3bdfa8b62d43bb94326a9b5e4b...fc80ee947a65e32c93439ede4afbd469fa58f20c,1,45,0,45,2,2011-07-08 20:41:30,2011-04-02 00:46:18
fc80ee947a65e32c93439ede4afbd469fa58f20c...87b6dc21c8caf57303d1ae5049805116118b998c,2,29,14,43,10,2011-07-09 04:23:28,2011-06-11 13:09:40
87b6dc21c8caf57303d1ae5049805116118b998c...7e8735b3fe66f216171f467666bef698cf2b09e1,1,21,2,23,1,2011-07-09 08:09:26,2011-07-09 07:59:35
7e8735b3fe66f216171f467666bef698cf2b09e1...b1c90a4e22d6e28c0b3fe2383e409e54f393d945,22,169,44,213,17,2011-07-11 15:30:37,2011-07-11 15:29:25
b1c90a4e22d6e28c0b3fe2383e409e54f393d945...360f4b78dd79364d3c4a29c5e99a0480bc4c202c,1,2,2,4,1,2011-07-11 15:48:02,2011-07-11 15:48:02
360f4b78dd79364d3c4a29c5e99a0480bc4c202c...6bcd96c253a679659ee01ecf2d662bbbed867079,1,0,0,0,0,2011-07-11 19:24:49,2011-07-11 19:24:49
6bcd96c253a679659ee01ecf2d662bbbed867079...d05afa50e697c95b163a563ab08905a59a5defea,1,3,0,3,1,2011-07-13 15:06:12,2011-07-09 17:04:56
d05afa50e697c95b163a563ab08905a59a5defea...8cc9ac0df2859fa53592d77d47454e4797010e87,1,9,0,9,1,2011-07-13 15:08:31,2011-05-19 19:49:29
8cc9ac0df2859fa53592d77d47454e4797010e87...701ae3c995a77160aeab19ba83ea3095f268f7bc,1,1,1,2,1,2011-07-13 15:10:17,2011-07-13 15:10:17
701ae3c995a77160aeab19ba83ea3095f268f7bc...128d1bab2a159ea4b4ef92ed786a08f58210b36b,1,1,1,2,1,2011-07-13 17:00:57,2011-07-13 15:31:56
128d1bab2a159ea4b4ef92ed786a08f58210b36b...5f97c9a0058c0d0cf8e06f38ac08e1cd2a8a494b,2,45,2,47,3,2011-07-13 17:08:24,2011-07-10 09:47:41
5f97c9a0058c0d0cf8e06f38ac08e1cd2a8a494b...5208abe7237a4840957072e4445a543515223e91,2,43,2,45,3,2011-07-13 17:21:56,2011-06-21 15:53:31
5208abe7237a4840957072e4445a543515223e91...7097eca5a76cc169fcd6e927a15dcd879fb61c0c,1,4,0,4,1,2011-07-13 19:06:46,2011-06-28 19:50:42
7097eca5a76cc169fcd6e927a15dcd879fb61c0c...901ebed8ffc804caf7f82a328eb7f2f7c74a242b,1,4,1,5,1,2011-07-14 15:32:46,2011-07-14 09:52:43
901ebed8ffc804caf7f82a328eb7f2f7c74a242b...5b02d564c31fffb13f1749a4734e5dd4dc9654c0,1,4,1,5,1,2011-07-14 15:33:28,2011-07-14 12:33:04
5b02d564c31fffb13f1749a4734e5dd4dc9654c0...8caf7fdb05b29325c57807074d55fa3f2713d197,2,90,0,90,2,2011-07-14 16:58:43,2011-07-14 16:58:43
23b8931b62b0e19e518501bdd00801a61f47eba3...263e33a738e164a4b2d6d28aed4b527bf1453a7b,4,271,0,271,5,2011-06-29 13:06:40,2011-06-29 13:06:40
263e33a738e164a4b2d6d28aed4b527bf1453a7b...d005cc5cc9e5c515f273c60571a800399394bc4a,3,235,4,239,2,2011-06-29 13:14:55,2011-06-29 13:14:55
d005cc5cc9e5c515f273c60571a800399394bc4a...d64e070e26cc3545367ef38098a0fe963be0ea8d,1,6,2,8,2,2011-06-29 13:20:53,2011-06-28 21:32:01
d64e070e26cc3545367ef38098a0fe963be0ea8d...20996dbc2b5474b3b289f2b79f72eeed26f2a0ec,3,4,128,132,10,2011-06-29 13:25:11,2011-06-29 13:24:55
20996dbc2b5474b3b289f2b79f72eeed26f2a0ec...6afdca885adeeeed9eef8cbb01c3d97af0bc084d,1,3,0,3,1,2011-06-29 15:16:52,2011-06-29 15:16:15
6afdca885adeeeed9eef8cbb01c3d97af0bc084d...33af2720f26c2b25bc7f75ce7eb454ff99db6d35,740,125878,108470,234348,21569,2011-06-29 15:26:51,2011-06-29 15:26:51
37d529f818aacd1146b1d927b3251bbefcea389f...1ba2c3213526ccacac587dd10362626cec862d36,1,6,1,7,1,2011-06-11 06:51:48,2011-06-11 06:51:48
1ba2c3213526ccacac587dd10362626cec862d36...f46811633cca986170a62d90e131f6a34e7c47ee,1,15,0,15,1,2011-06-13 20:39:02,2011-05-01 18:03:08
f46811633cca986170a62d90e131f6a34e7c47ee...88552c51aead1520a0d20d42b4af39520baab5d1,5,98,25,123,22,2011-06-14 10:50:00,2011-06-09 01:20:17
860cb906a683bcbf297a02a1e7e821ff469fafe4...2c79f13634371d284d9a7034671d057b00cc609f,29,1025,397,1422,192,2011-05-22 20:08:31,2011-05-22 20:05:48
2c79f13634371d284d9a7034671d057b00cc609f...d3426789d2d78246328d4f8116a31afdd5b4fe3a,2,9,7,16,5,2011-05-23 22:25:21,2011-05-23 22:25:21
d3426789d2d78246328d4f8116a31afdd5b4fe3a...207901e7de1ceeb35b73a9aa4bc1f3bb9ab0ff2c,1,13,10,23,5,2011-05-23 22:38:57,2011-05-23 22:38:54
207901e7de1ceeb35b73a9aa4bc1f3bb9ab0ff2c...9cec08e49022c57efca252a74c778e18c11b80d3,6,91,100,191,67,2011-05-24 00:31:29,2011-05-23 23:42:22
9cec08e49022c57efca252a74c778e18c11b80d3...a72284e2642474302e7bdac6d7201a004224ec6a,1,662,662,1324,7,2011-05-24 00:38:55,2011-05-24 00:38:55
a72284e2642474302e7bdac6d7201a004224ec6a...f0a440d886bf5d7f84203c0520b274dbe834a5da,2,1,12,13,2,2011-05-24 18:22:59,2011-05-14 10:24:48
f0a440d886bf5d7f84203c0520b274dbe834a5da...8f065475482705add7ea32844763df89e18e8222,1,1,1,2,1,2011-05-24 20:43:10,2011-05-24 20:43:03
8f065475482705add7ea32844763df89e18e8222...9d1bad8960e4e44b4dcdc127728640c361a6fe96,4,282,0,282,4,2011-05-25 17:17:02,2011-05-25 17:16:36
9d1bad8960e4e44b4dcdc127728640c361a6fe96...4d22405f0f831b37707cbb9e74d0649c564b470d,3,68,42,110,27,2011-05-28 20:21:03,2011-05-28 20:21:03
4d22405f0f831b37707cbb9e74d0649c564b470d...650a308634ef91767073829c76ca7be4edf66898,3,41,37,78,3,2011-05-28 20:44:03,2011-05-28 20:44:03
650a308634ef91767073829c76ca7be4edf66898...8971b593659b4ba48f63a095fb0b9a1bd4662db6,2,7,1,8,2,2011-06-01 05:10:39,2011-05-28 17:04:36
f4e69e44ff3b73921e1a009df104f3db962f10ee...5e409c2f1aa94b76f42e58001f7fcd0959a958aa,2,9,0,9,2,2011-05-19 19:13:48,2011-05-19 19:13:48
5e409c2f1aa94b76f42e58001f7fcd0959a958aa...6461af1baa4ed1f9b1f521a9e7dda33b3b946eb5,1,3,1,4,1,2011-05-19 19:41:17,2011-05-19 19:41:17
6461af1baa4ed1f9b1f521a9e7dda33b3b946eb5...21724ecaec63aad529a1ce2f0eebd82e52d399e3,2,30,17,47,8,2011-05-19 21:45:42,2011-05-19 19:42:13
21724ecaec63aad529a1ce2f0eebd82e52d399e3...5d9dc1c6d5babaf033f40d90c13e87563c7f5de5,1,27,2,29,2,2011-05-19 21:53:07,2011-05-19 19:15:12
5d9dc1c6d5babaf033f40d90c13e87563c7f5de5...6c28fcf661f1233bb17bf63c5df1fe8920b5cedc,1,12,12,24,12,2011-05-19 21:53:31,2011-05-19 19:20:08
6c28fcf661f1233bb17bf63c5df1fe8920b5cedc...8a0ac5b422ed3726b4aec090cd702c5e20c88a18,2,141,5,146,4,2011-05-20 01:44:42,2011-05-19 23:50:12
8a0ac5b422ed3726b4aec090cd702c5e20c88a18...2de0611b43f1587c511de65ef50c647e77e28abb,1,0,1,1,1,2011-05-20 15:51:55,2011-05-19 22:09:10
2de0611b43f1587c511de65ef50c647e77e28abb...9c7f89bf56abd37a796fea621ad2e47dd33d2b82,2,22,3,25,2,2011-05-20 17:20:22,2011-05-20 17:08:08
8caf7fdb05b29325c57807074d55fa3f2713d197...9a16f1c7d0ab6847bb8826e7e08eb7853a5a5f77,1,3,0,3,1,2011-07-15 16:54:20,2011-07-14 11:17:40
9a16f1c7d0ab6847bb8826e7e08eb7853a5a5f77...e8bc80cf152973037519f37da4d356a05cc704e1,1,4,4,8,3,2011-07-16 00:45:43,2011-07-16 00:45:43
e8bc80cf152973037519f37da4d356a05cc704e1...9f9a4cb9284794cea04098735f0dcc4c771db153,2,7,3,10,2,2011-07-16 14:00:06,2011-07-16 14:00:06
9f9a4cb9284794cea04098735f0dcc4c771db153...973153d1ccdbb06f9067f3698578e8a5685a87c4,2,62,0,62,3,2011-07-19 15:24:17,2011-07-08 04:04:27
973153d1ccdbb06f9067f3698578e8a5685a87c4...ddfc6b78cc15202789e58b9220c1897e9d9aa525,2,11,2,13,3,2011-07-19 18:56:44,2011-07-19 18:56:44
ddfc6b78cc15202789e58b9220c1897e9d9aa525...1b8dd65d6e3b82b6863ef38835cc436c5d30c1d5,7,65,38,103,10,2011-07-20 06:51:42,2011-07-19 17:46:40
1b8dd65d6e3b82b6863ef38835cc436c5d30c1d5...effc4469d00f53c0ce4057d385a968093db3d645,1,2,2,4,1,2011-07-20 07:37:26,2011-07-20 07:37:26
a1e8fcc5ae93b95c558732469235bf1176a5c639...69d20f535262dec0be74e521c32d151cb16694ab,2,49,8,57,16,2011-07-02 07:18:36,2011-07-02 07:18:36
69d20f535262dec0be74e521c32d151cb16694ab...44d30f2d65c1aebc64899e7f2bc022b9c2657ace,1,7,1,8,1,2011-07-03 17:49:20,2011-07-03 17:39:45
44d30f2d65c1aebc64899e7f2bc022b9c2657ace...6d8b43c366fde9af4b6d5c9e37d15cc854aa0a69,2,1,5,6,3,2011-07-03 18:05:14,2011-07-03 18:05:03
6d8b43c366fde9af4b6d5c9e37d15cc854aa0a69...3e2abd12d3534d76e480fce7a0475d228749f31d,1,16,10,26,6,2011-07-03 19:19:44,2011-07-03 06:20:25
3e2abd12d3534d76e480fce7a0475d228749f31d...bcf3c7d31c56557e0b6a5b4f60a6f755d0ad4cc4,1,5,5,10,5,2011-07-04 13:52:44,2011-07-03 07:46:24
bcf3c7d31c56557e0b6a5b4f60a6f755d0ad4cc4...d6188bdd2718c15742c62d38d40919a54d64d44d,1,2,1,3,1,2011-07-04 14:26:46,2011-07-04 14:26:46
d6188bdd2718c15742c62d38d40919a54d64d44d...8e0d788842fb831d70cc640ac124c4dee7e450ef,1,11,0,11,1,2011-07-04 15:07:50,2011-07-04 15:02:58
8e0d788842fb831d70cc640ac124c4dee7e450ef...bd0baf23383951182b10261b076cf6268152a68b,1,6,0,6,2,2011-07-04 15:23:14,2011-07-04 12:29:59
bd0baf23383951182b10261b076cf6268152a68b...c60cdcda4e39081fa56568df941aff1a4b56b39c,3,34,15,49,11,2011-07-04 15:52:16,2011-07-04 15:34:58
c60cdcda4e39081fa56568df941aff1a4b56b39c...02ebcd8e261d7a30b5873548d527a1b6b9ae8e98,1,1,1,2,1,2011-07-04 17:40:19,2011-03-11 10:09:05
02ebcd8e261d7a30b5873548d527a1b6b9ae8e98...20d7c47d6e591f1dc40f9c1901f8f8cc8580ef2a,1,8,3,11,4,2011-07-04 17:40:20,2011-07-04 16:21:38
20d7c47d6e591f1dc40f9c1901f8f8cc8580ef2a...ff50310cc5a1ccc5f868ef55510dee054650454b,1,1,1,2,1,2011-07-04 17:40:23,2011-05-11 09:33:16
ff50310cc5a1ccc5f868ef55510dee054650454b...f6fa20fd5551b0af76b6735a9af781462daf836d,1,2,2,4,2,2011-07-04 17:40:24,2011-06-27 17:25:05
f6fa20fd5551b0af76b6735a9af781462daf836d...38f3bf66108d398697f20dbca8c19df29329323d,1,32,0,32,1,2011-07-04 18:33:29,2011-07-04 18:25:31
38f3bf66108d398697f20dbca8c19df29329323d...a3e5da07b4c9da50511816d7959e64ae12083004,1,5,5,10,4,2011-07-04 19:15:00,2010-12-24 23:40:48
a3e5da07b4c9da50511816d7959e64ae12083004...04c916989291ccc28fb2a8230e4013f97cc9799d,1,1,1,2,1,2011-07-04 19:15:51,2011-07-04 19:10:14
04c916989291ccc28fb2a8230e4013f97cc9799d...7f30f135438f45f62a373d551764f0e804ff62ed,2,9,1,10,2,2011-07-04 20:50:27,2011-06-25 22:37:57
7f30f135438f45f62a373d551764f0e804ff62ed...3b16a89b3a39fd602487afbd42ff56c9f0c2e9ed,1,2,2,4,2,2011-07-04 22:04:57,2011-07-04 22:03:21
3b16a89b3a39fd602487afbd42ff56c9f0c2e9ed...c953ecfb9ed3f3a4399deb857240c451f26641c5,1,9,1,10,2,2011-07-04 22:04:58,2011-07-04 22:02:46
c953ecfb9ed3f3a4399deb857240c451f26641c5...858f23094e9f9382c780e5f11f13273242c9b26a,8,1149,10,1159,7,2011-07-04 22:17:20,2011-07-04 22:17:20
858f23094e9f9382c780e5f11f13273242c9b26a...24a671a8aa93447bc7c32286e01a6885ade491ee,1,1,1,2,1,2011-07-04 22:56:56,2011-07-04 22:56:56
24a671a8aa93447bc7c32286e01a6885ade491ee...092fc42fbf53b5884a44cdc39091603e9863431a,1,10,3,13,2,2011-07-04 23:13:57,2011-07-04 23:06:39
092fc42fbf53b5884a44cdc39091603e9863431a...8dc87731c76f8a4a86d62b3fb6d5641d084e528c,1,5,2,7,2,2011-07-04 23:13:57,2011-06-29 18:24:16
8dc87731c76f8a4a86d62b3fb6d5641d084e528c...222f85fdf4ac43bac316eceb8582200ac5b821c4,1,142,30,172,9,2011-07-04 23:13:57,2011-06-29 19:14:02
222f85fdf4ac43bac316eceb8582200ac5b821c4...1037f5c11369566b33debc47dedac2a1c65dae68,1,2,3,5,2,2011-07-04 23:31:23,2011-07-04 23:31:00
1037f5c11369566b33debc47dedac2a1c65dae68...1e29fe65c31165889b836ac0ffd1861af5ddf54e,1,1,1,2,1,2011-07-04 23:53:01,2011-07-04 23:53:01
1e29fe65c31165889b836ac0ffd1861af5ddf54e...1e6b72e8cbee0837dba3741f3358edf4e22fefb2,1,12,0,12,2,2011-07-05 00:05:09,2011-06-25 12:53:28
1e6b72e8cbee0837dba3741f3358edf4e22fefb2...0c3a7c075e91ed2fb4a992cb62aadc1167d8a7db,1,1,1,2,2,2011-07-05 00:05:37,2011-06-25 09:42:20
0c3a7c075e91ed2fb4a992cb62aadc1167d8a7db...4062a42aae4c8d2a11b867706c6b704258440115,1,3,1,4,1,2011-07-05 00:33:13,2011-07-05 00:32:51
4062a42aae4c8d2a11b867706c6b704258440115...f1b7c42524a5bd512297dcc39914be79699127bf,1,1,1,2,1,2011-07-05 00:42:56,2011-04-02 14:43:55
f1b7c42524a5bd512297dcc39914be79699127bf...d964b4c5aafd431cfb63529a462871c446522f7a,1,2,2,4,3,2011-07-05 17:08:35,2011-07-05 17:08:35
d964b4c5aafd431cfb63529a462871c446522f7a...e8542b6220379c3eeac663a46c29cd1405287f16,1,33,9,42,3,2011-07-05 17:31:37,2011-07-05 17:31:37
e8542b6220379c3eeac663a46c29cd1405287f16...ede1acc1ed6c5badd53226c4798afa23186ab12a,2,12,1,13,2,2011-07-05 17:56:15,2011-07-05 17:52:22
ede1acc1ed6c5badd53226c4798afa23186ab12a...9c771691122d88918f1458f85c37d5294c26900b,1,5,3,8,2,2011-07-05 18:26:21,2011-07-05 18:26:21
33af2720f26c2b25bc7f75ce7eb454ff99db6d35...6054dcc1302d1a1ef51e215dcf1ad16fb967f1ba,121,4575,3880,8455,1255,2011-07-05 18:41:56,2011-07-05 18:41:56
33af2720f26c2b25bc7f75ce7eb454ff99db6d35...be1b55289fdd0e654c660eca9bd1eb8a517f804c,1,10,6,16,3,2011-06-29 16:04:55,2011-06-29 16:04:55
be1b55289fdd0e654c660eca9bd1eb8a517f804c...dd175a4ede3d4cf64f8cf9849dae7d651b9f7df0,1,2,0,2,2,2011-06-29 17:12:26,2011-06-29 16:59:45
dd175a4ede3d4cf64f8cf9849dae7d651b9f7df0...1cb7b67ac3e43c9f1f051d59b9c38f07fcd7b337,19,590,178,768,73,2011-06-29 17:35:17,2011-06-29 17:35:17
1cb7b67ac3e43c9f1f051d59b9c38f07fcd7b337...2e1af6df499387c7d44655b4837a84d74c41acee,1,9,0,9,1,2011-06-29 18:51:30,2011-06-29 18:12:58
2e1af6df499387c7d44655b4837a84d74c41acee...e38ae476ef2af52d575b1941e19766bcbefbe4ee,1,5,0,5,1,2011-06-30 21:53:22,2011-06-30 21:53:22
e38ae476ef2af52d575b1941e19766bcbefbe4ee...4c480551c3cc0b6f10ebe4c033580b3a3c148550,1,17,6,23,4,2011-07-01 16:01:06,2011-06-30 23:37:30
4c480551c3cc0b6f10ebe4c033580b3a3c148550...412e413edc3864cf2d6da30b88248c0cbbe4e941,48,352,16287,16639,217,2011-07-01 16:30:44,2011-07-01 16:30:44
412e413edc3864cf2d6da30b88248c0cbbe4e941...17ac0316d06e057ad858e0149c03a18d390124fd,21,16410,0,16410,21,2011-07-01 16:38:47,2011-07-01 16:38:47
17ac0316d06e057ad858e0149c03a18d390124fd...2cfab040376679f7c49da92a541ee52e4add0d9a,1,147,85,232,31,2011-07-01 16:51:43,2011-07-01 16:48:34
2cfab040376679f7c49da92a541ee52e4add0d9a...70a8927a936928136a4ed087e2a1817ce106ad07,4,18,4,22,7,2011-07-01 17:59:42,2011-07-01 17:59:42
70a8927a936928136a4ed087e2a1817ce106ad07...56ec4e4f3cf8ebea1152ef8c295276168175e7c6,2,7,2,9,3,2011-07-02 00:53:48,2011-07-01 19:01:12
56ec4e4f3cf8ebea1152ef8c295276168175e7c6...5a2155dc711d516b1d28650f92fa7e3b935d2c44,1,5,4,9,4,2011-07-02 02:30:26,2011-07-02 02:30:15
88552c51aead1520a0d20d42b4af39520baab5d1...39246f65dfb019ddebcc9db8d5cc776954e12129,3,2,36,38,4,2011-06-14 22:32:41,2011-06-13 22:42:06
39246f65dfb019ddebcc9db8d5cc776954e12129...7c51275bcec6453e84fe267b44bef2ebba968f1f,1,4,10,14,3,2011-06-15 18:02:21,2011-06-15 17:47:25
7c51275bcec6453e84fe267b44bef2ebba968f1f...feb26d6c742980b660efc988133640cf14fc67d3,1,1,1,2,1,2011-06-20 10:48:38,2011-06-20 10:48:38
feb26d6c742980b660efc988133640cf14fc67d3...d627083ed508c0ed2a0c7251bcb4439375d97cca,1,1,0,1,1,2011-06-20 10:51:30,2011-06-20 10:50:58
d627083ed508c0ed2a0c7251bcb4439375d97cca...d6ec8f668e308763ba1db4b603113ba9085f4391,2,41,1,42,3,2011-06-20 11:47:27,2011-06-17 16:11:43
b6a742d76fa8a598f24c8c2ec5b18d0cdc22ef4a...e142fe2be6ef3e5cd27b89d59175a3937b9fdb31,4,136,18,154,17,2011-06-04 14:05:01,2011-06-04 14:04:38
e142fe2be6ef3e5cd27b89d59175a3937b9fdb31...580ab7ba2c1e0c89f351759b31f65bfed451ba9d,1,2,2,4,2,2011-06-04 17:38:49,2011-06-04 17:38:49
580ab7ba2c1e0c89f351759b31f65bfed451ba9d...794cb60f9e8689ec6e163aa1119fdbb07d3024eb,1,1,1,2,1,2011-06-04 17:41:41,2011-06-04 17:41:41
794cb60f9e8689ec6e163aa1119fdbb07d3024eb...7a5977b5d61186baaa71b19349f3fdfa41e6042e,35,1953,1109,3062,656,2011-06-07 16:59:44,2011-06-07 16:37:27
7a5977b5d61186baaa71b19349f3fdfa41e6042e...5c9a262eb0796981fdd07414ac61d2ff8e05b0be,1,3,3,6,3,2011-06-08 03:06:09,2011-06-08 01:57:15
5c9a262eb0796981fdd07414ac61d2ff8e05b0be...d9aa9b54cfb829bd0da9dc4b9efefa3cec1455b9,3,49,55,104,22,2011-06-08 03:06:13,2011-06-08 02:35:50
d9aa9b54cfb829bd0da9dc4b9efefa3cec1455b9...cc82724fdcd2c914be60e3073f87f053829f6baa,4,0,271,271,5,2011-06-08 03:06:14,2011-06-08 02:36:31
cc82724fdcd2c914be60e3073f87f053829f6baa...126e3ba2d381ae1b8a5539f4f369895f77711bdf,3,0,211,211,3,2011-06-08 03:06:15,2011-06-08 02:01:07
126e3ba2d381ae1b8a5539f4f369895f77711bdf...406f44a86b37d69600b904530c6a1518c939681e,8,63,38,101,45,2011-06-08 03:06:15,2011-06-08 02:41:28
406f44a86b37d69600b904530c6a1518c939681e...09ac99f1f4be6dc4d90152c79a4ab7e0f9068550,1,23,22,45,2,2011-06-08 03:06:16,2011-06-08 01:46:29
09ac99f1f4be6dc4d90152c79a4ab7e0f9068550...623f513071ac2551b9812e9d4ebaf482ba535d46,26,326,312,638,234,2011-06-10 16:17:44,2011-06-09 13:14:58
623f513071ac2551b9812e9d4ebaf482ba535d46...062759194b636ee14f2bb8abb071c49eb2257f6b,4,165,0,165,5,2011-06-10 16:17:48,2011-06-09 13:31:51
062759194b636ee14f2bb8abb071c49eb2257f6b...effeeb5cf20479be2064bbc115cfce286d0efebf,1,97,7,104,10,2011-06-10 16:25:27,2011-06-10 16:25:06
effeeb5cf20479be2064bbc115cfce286d0efebf...2eb1274d6cf136a1873b0c7cd33043c8203d0676,2,2,2,4,2,2011-06-12 18:53:04,2011-06-12 18:53:04
2eb1274d6cf136a1873b0c7cd33043c8203d0676...9967c369c9272335bb0343558673b689725c6d7c,10,117,4,121,15,2011-06-13 23:11:13,2011-06-12 17:36:05
9967c369c9272335bb0343558673b689725c6d7c...55636e55261a08e990273a5e6f13c4ace8d6a53e,1,6,43,49,9,2011-06-14 10:47:07,2011-06-14 10:46:10
55636e55261a08e990273a5e6f13c4ace8d6a53e...1261b171295bb9847363f422238dcd7364d70e5f,2,12,6,18,4,2011-06-14 11:03:49,2011-06-14 11:02:15
1261b171295bb9847363f422238dcd7364d70e5f...5fd9adccdbe38cbebc9f10a39394d5c8c716dbc8,1,0,3,3,1,2011-06-14 11:18:32,2011-06-14 11:18:32
5fd9adccdbe38cbebc9f10a39394d5c8c716dbc8...86214c9f164c152b57b140d33deefa48eff50920,3,191,0,191,8,2011-06-14 16:03:01,2011-06-14 16:02:58
9c7f89bf56abd37a796fea621ad2e47dd33d2b82...a55a9ff3c2e913f20230535fde1fcb703e25c996,1,4,3,7,2,2011-05-20 22:02:22,2011-05-20 21:38:49
a55a9ff3c2e913f20230535fde1fcb703e25c996...70dd6d4ea369ccbfd6e573d9a42b5144dc23b4b3,1,5,1,6,1,2011-05-20 22:41:04,2011-05-20 22:39:48
effc4469d00f53c0ce4057d385a968093db3d645...bbf7e8ed5ee48852a2adb97de3056ef067343500,2,67,0,67,2,2011-07-21 12:20:40,2011-07-21 05:42:10
bbf7e8ed5ee48852a2adb97de3056ef067343500...691497babe6ea1c59d3556acab743479e7a1efb9,1,4,1,5,2,2011-07-21 15:20:47,2011-07-21 15:20:47
691497babe6ea1c59d3556acab743479e7a1efb9...78487b6256ebbd8c3c0e16abe18f26c2db23d0a4,2,30,65,95,24,2011-07-22 14:33:55,2011-07-22 14:28:56
78487b6256ebbd8c3c0e16abe18f26c2db23d0a4...b8e9bf0993ebf59d995bdea7d0d44fb8643b783d,1,13,13,26,13,2011-07-23 12:16:45,2010-11-04 17:48:35
b8e9bf0993ebf59d995bdea7d0d44fb8643b783d...e357acc55b8126e1b8b78edcf4ac09dfa3217146,2,32,0,32,2,2011-07-23 12:56:41,2011-06-19 07:54:34
e357acc55b8126e1b8b78edcf4ac09dfa3217146...bf0802402d52f0ca78885f579b91014a859939d5,1,3,2,5,2,2011-07-25 00:18:33,2011-07-25 00:18:33
bf0802402d52f0ca78885f579b91014a859939d5...deb100fb176a40d59d4b961be7aef90ef7361b52,1,2,2,4,2,2011-07-25 13:37:21,2011-07-25 13:37:21
deb100fb176a40d59d4b961be7aef90ef7361b52...d32971a8cbc0ac6ab7a044e25ff400587bc1294f,2,25,9,34,7,2011-07-25 14:57:25,2011-07-24 06:56:23
d32971a8cbc0ac6ab7a044e25ff400587bc1294f...2d65f3c59a33730a2aed47070e4ac32bd2791aa5,4,4,4,8,4,2011-07-26 20:09:03,2011-07-26 20:05:08
2d65f3c59a33730a2aed47070e4ac32bd2791aa5...eab8bebcedd2d6ae46a25166964974bca263e616,1,4,0,4,1,2011-07-27 21:24:55,2011-07-27 20:58:39
eab8bebcedd2d6ae46a25166964974bca263e616...8b3ba47f88e5f59256818e3173c75c66ff5a82df,2,41,0,41,2,2011-07-29 15:07:37,2011-07-29 14:49:48
8b3ba47f88e5f59256818e3173c75c66ff5a82df...c72223e2a9aae2d5c20825562657c50a644d8a59,2,19,0,19,8,2011-07-29 18:18:33,2011-07-29 18:03:58
041c9832902f1258c6b0f93a5d0e800cdfa70f5b...f8bfa54d0fa509f9242637bef2869a1b1e842ec8,6,44,19,63,10,2011-07-14 23:10:36,2011-07-14 22:56:15
f8bfa54d0fa509f9242637bef2869a1b1e842ec8...306af2532574281b29c96c6c99e907d746a99a0f,1,2,2,4,1,2011-07-14 23:56:39,2011-07-14 23:56:39
306af2532574281b29c96c6c99e907d746a99a0f...e70702c62096860abeab1cc23ffc188850de592b,2,34,20,54,14,2011-07-15 00:19:07,2011-07-13 00:00:33
e70702c62096860abeab1cc23ffc188850de592b...3c733c57b7974fa9142babbe1515a4823cfde76b,1,9,0,9,3,2011-07-15 13:41:28,2011-07-15 03:38:45
3c733c57b7974fa9142babbe1515a4823cfde76b...25c1a5e804950ccbad1b94120e06816fe3d6c9fb,1,3,0,3,1,2011-07-15 16:54:56,2011-07-14 11:17:40
25c1a5e804950ccbad1b94120e06816fe3d6c9fb...48f65b3d57f331d8f810b6c6f8c05bdb5f0674af,10,1,83,84,11,2011-07-15 17:46:11,2011-07-15 17:46:11
48f65b3d57f331d8f810b6c6f8c05bdb5f0674af...f5a7de1ea7c747d986321c467c0acb41d13971d6,2,6,5,11,4,2011-07-15 18:05:12,2011-07-15 18:05:12
f5a7de1ea7c747d986321c467c0acb41d13971d6...130be31cfff34a2c6ccb477dbcfead97b3e09646,17,553,638,1191,318,2011-07-15 20:41:44,2011-07-15 18:15:02
130be31cfff34a2c6ccb477dbcfead97b3e09646...3a96469319291264e1caf21779cd3bfe546ceadf,3,41,15,56,21,2011-07-15 20:43:28,2011-07-15 20:20:24
3a96469319291264e1caf21779cd3bfe546ceadf...f4154d294054a09cea2990cd058f491b3dddc0c1,1,157,153,310,2,2011-07-15 20:52:38,2011-07-15 20:52:36
f4154d294054a09cea2990cd058f491b3dddc0c1...eb7d762c551a141db04f9fe0c627a3b6a880724e,1,3,0,3,1,2011-07-15 21:59:10,2011-07-15 20:11:14
eb7d762c551a141db04f9fe0c627a3b6a880724e...ebc4d5cd2902ef0cebc7c6738261d203a5f51f04,1,0,17,17,1,2011-07-15 22:11:32,2011-07-15 22:10:27
ebc4d5cd2902ef0cebc7c6738261d203a5f51f04...7f0047c2d52eb39c30ee49a6e5a9a3167ec6f54d,8,43,181,224,23,2011-07-15 22:11:33,2011-07-15 21:05:01
7f0047c2d52eb39c30ee49a6e5a9a3167ec6f54d...1c2dd454dbf9db45001db8044d320d9b787c7237,4,21,12,33,9,2011-07-15 22:31:47,2011-07-15 22:31:47
1c2dd454dbf9db45001db8044d320d9b787c7237...442c5c95adeb44700eda9b25d773d3f285ccfe3c,1,27,4,31,4,2011-07-15 22:38:34,2011-07-06 12:25:25
442c5c95adeb44700eda9b25d773d3f285ccfe3c...17bff6082a957515668e30fbf170d1356a92674f,4,7,7,14,7,2011-07-15 22:40:32,2011-07-06 12:36:05
17bff6082a957515668e30fbf170d1356a92674f...f3f3b12364db2211f83b98af87c78fa7a7887fa5,3,69,0,69,8,2011-07-15 23:44:13,2011-07-15 22:06:10
32a0752d4932705b652996be30f8e94ad3c12f45...c0d3f1f48582551e7e92bb810466ace1fdac0366,2,2,2,4,2,2011-07-05 19:08:17,2011-07-05 19:07:30
c0d3f1f48582551e7e92bb810466ace1fdac0366...72e18d7f19470b1786186998e3ff75245583fbc1,2,41,32,73,32,2011-07-05 19:17:17,2011-07-05 19:16:13
72e18d7f19470b1786186998e3ff75245583fbc1...b74d119b3487b62d81908c76151f252edd46e6cc,1,4,2,6,3,2011-07-05 20:25:27,2011-06-23 20:44:10
b74d119b3487b62d81908c76151f252edd46e6cc...f08720606757577d95bd09b48697c7decbf17f00,2,21,2,23,5,2011-07-05 21:39:13,2011-07-05 20:34:15
f08720606757577d95bd09b48697c7decbf17f00...149562555c9bf56457dee9a1ad70c53ed670a776,755,107851,128781,236632,22171,2011-07-05 21:51:29,2011-07-05 21:40:13
149562555c9bf56457dee9a1ad70c53ed670a776...64a06c5ffd92f678d318e61fb8da8c51f028627c,5,5,166,171,10,2011-07-05 22:48:31,2011-07-05 22:42:32
64a06c5ffd92f678d318e61fb8da8c51f028627c...8b2f5af2a0c17af6b615f7765ebca29f1a5ad9a6,1,1,1,2,1,2011-07-05 23:40:13,2011-07-05 23:40:13
8b2f5af2a0c17af6b615f7765ebca29f1a5ad9a6...d1eba2b18b5b8ef8341a284dfdbaa8dcd247a94c,1,10,16,26,6,2011-07-05 23:49:13,2011-07-05 23:49:13
d1eba2b18b5b8ef8341a284dfdbaa8dcd247a94c...a845bf74ae065a809dbe342c19db4774ae74f57c,2,60,0,60,2,2011-07-06 00:50:50,2011-07-06 00:50:50
a845bf74ae065a809dbe342c19db4774ae74f57c...111305c1bdc14546e515c8cf3f2975d610aafa84,2,22,1,23,4,2011-07-06 01:31:59,2011-07-06 01:31:33
111305c1bdc14546e515c8cf3f2975d610aafa84...ae7ed8482ea7e53c59acbdf3cf0e0a0ae9d792cd,4,66,3,69,6,2011-07-06 01:45:03,2011-07-06 00:41:24
ae7ed8482ea7e53c59acbdf3cf0e0a0ae9d792cd...2dfed9f69aaa39617f8d559365aa72e05b6e8fac,1,2,2,4,1,2011-07-06 05:13:55,2011-07-06 05:13:55
2dfed9f69aaa39617f8d559365aa72e05b6e8fac...08a334fa45e8e303b718226f7384b5c0cef43c19,12,206,22,228,36,2011-07-06 19:13:45,2011-07-06 19:13:45
08a334fa45e8e303b718226f7384b5c0cef43c19...2a848fa7279002259a3e651223ce6f3230ca22d7,5,357,12,369,12,2011-07-06 20:17:50,2011-06-13 12:43:16
2a848fa7279002259a3e651223ce6f3230ca22d7...8475e1527ddc3fcfa3ed30846130e05e183935c6,1,2,1,3,2,2011-07-06 20:17:50,2011-07-06 20:12:21
8475e1527ddc3fcfa3ed30846130e05e183935c6...87900b14da5f72ea7d049bdebc6a71034a9e34aa,1,7,11,18,2,2011-07-06 20:17:50,2011-07-06 20:12:37
87900b14da5f72ea7d049bdebc6a71034a9e34aa...3dbb3cdb6abcc3916ed6fa02e08e4759fc09cc6a,1,2,2,4,2,2011-07-07 04:31:13,2011-06-27 17:42:11
3dbb3cdb6abcc3916ed6fa02e08e4759fc09cc6a...cc834555347c38dd07d798f2f28fda0937142baa,2,6,6,12,3,2011-07-07 04:52:21,2011-06-26 07:30:23
cc834555347c38dd07d798f2f28fda0937142baa...a2f2aa97ad702ba76a121dca6fc664a35133b914,186,131,96371,96502,218,2011-07-07 15:56:48,2011-07-07 15:56:48
a2f2aa97ad702ba76a121dca6fc664a35133b914...8a9fdedc9e89f050974ba379468d8b4abfcea5d5,158,96280,0,96280,158,2011-07-07 18:32:12,2011-07-07 18:32:12
8a9fdedc9e89f050974ba379468d8b4abfcea5d5...6b78b6bf72cd7c09280804f48831dbaa53931bbe,1,8,1,9,2,2011-07-07 18:53:59,2011-07-07 18:46:02
6b78b6bf72cd7c09280804f48831dbaa53931bbe...132ae752fafe5eb8cee0c4ce1324c4534ad12d0e,1,8,5,13,3,2011-07-07 21:17:39,2011-07-07 20:52:04
132ae752fafe5eb8cee0c4ce1324c4534ad12d0e...395b670e580f9f46e5418d642784c017e5f2a62f,1,1,0,1,1,2011-07-07 21:39:25,2011-07-07 21:39:25
395b670e580f9f46e5418d642784c017e5f2a62f...3e8667d829b22456948737c8b87862f59023606b,2,3,6,9,3,2011-07-07 21:49:31,2011-07-05 19:54:06
3e8667d829b22456948737c8b87862f59023606b...b6f6a1ca110dc40074c63a30e86351aa4e9ddf71,3,64,17,81,14,2011-07-07 22:51:55,2011-07-06 20:34:04
b6f6a1ca110dc40074c63a30e86351aa4e9ddf71...3c52fd006e2fa186132b6a9aec8064a80dd7e09a,1,28,10,38,7,2011-07-07 22:55:12,2011-07-07 00:13:17
3c52fd006e2fa186132b6a9aec8064a80dd7e09a...e81a89b11610f4692d18f0515494a26a318119aa,1,1,1,2,1,2011-07-07 23:31:41,2011-07-07 23:22:50
e81a89b11610f4692d18f0515494a26a318119aa...1018e7d23f579f90948664b66752fee58b23ef40,2,7,1,8,3,2011-07-08 17:36:16,2011-07-07 18:23:27
1018e7d23f579f90948664b66752fee58b23ef40...15286c836159f7d4fc954ad9fd1d58f981686e34,1,7,0,7,1,2011-07-08 17:40:53,2011-07-08 17:40:35
15286c836159f7d4fc954ad9fd1d58f981686e34...ff49299b48f8d44f409bb4c902e6bf8a0c7f56ed,1,123,2,125,3,2011-07-08 20:06:36,2011-07-08 19:22:44
ff49299b48f8d44f409bb4c902e6bf8a0c7f56ed...19f248400f55eb26c306eab733ff6de12070dcd4,1,10,0,10,1,2011-07-08 21:30:12,2011-07-08 21:14:40
19f248400f55eb26c306eab733ff6de12070dcd4...0df2f74d364826053641395b01c2fcb1345057a9,1,19,1,20,6,2011-07-08 22:22:40,2011-07-06 21:02:55
0df2f74d364826053641395b01c2fcb1345057a9...e5564a3f29e0a818832a97c7c3b28d7c8b3b0460,761,130956,109165,240121,22380,2011-07-08 23:40:11,2011-07-08 23:40:11
3d7d994ffce2e79d516f76d7384a411b21021142...dafe32d3bf3b9a48fd14b3dae1ec85122764bd65,2,111,4,115,15,2011-06-16 11:16:54,2011-06-16 11:16:54
dafe32d3bf3b9a48fd14b3dae1ec85122764bd65...dae73dbd282a61adebb4805455d1df30c66ece04,2,26,24,50,9,2011-06-16 13:12:57,2011-06-16 13:12:57
dae73dbd282a61adebb4805455d1df30c66ece04...ddc989333dced1fd33baf1114fccd15a333771e3,3,90,3,93,7,2011-06-16 13:33:47,2011-06-16 13:33:47
ddc989333dced1fd33baf1114fccd15a333771e3...97296e405c90b482f5a4bebfdb7a4fd30379585f,2,22,0,22,10,2011-06-16 13:49:44,2011-06-16 13:49:44
97296e405c90b482f5a4bebfdb7a4fd30379585f...ea8969787cc7187ca1fd1783a06d8346f8fe92a0,1,14,7,21,3,2011-06-16 14:03:04,2011-06-16 14:00:29
ea8969787cc7187ca1fd1783a06d8346f8fe92a0...9696c27c457f5c6e0d9131c37a8d3dd93bef94d1,2,54,3,57,7,2011-06-16 14:08:17,2011-06-16 14:08:17
9696c27c457f5c6e0d9131c37a8d3dd93bef94d1...8bf5b8d352286f4963b226bfef6a5ac1e3fd1dc1,1,325,0,325,1,2011-06-16 19:11:05,2011-06-16 19:11:05
8bf5b8d352286f4963b226bfef6a5ac1e3fd1dc1...312ed83827dcf2f5b2caeedee8c77fddcc99d46f,1,26,13,39,4,2011-06-17 11:36:16,2011-06-17 11:36:16
312ed83827dcf2f5b2caeedee8c77fddcc99d46f...710f8e2acc64cc7944830a8c68db1dcbb63700d8,4,35,1,36,11,2011-06-17 11:51:40,2011-06-17 11:51:40
710f8e2acc64cc7944830a8c68db1dcbb63700d8...52b517c6ab962f6c51529f77a0b8226343c850cd,5,0,103,103,9,2011-06-17 12:03:05,2011-06-17 12:01:27
52b517c6ab962f6c51529f77a0b8226343c850cd...e697cfb6fc020c08afa2c794ee5802e5a4d2b97b,1,55,4,59,8,2011-06-17 12:27:02,2011-06-17 12:27:02
e697cfb6fc020c08afa2c794ee5802e5a4d2b97b...dc0556c8cde5a3b81a1f7a85e29171e252dcc85f,1,71,14,85,21,2011-06-17 15:10:12,2011-06-17 15:10:12
dc0556c8cde5a3b81a1f7a85e29171e252dcc85f...f6ce86af04787b0bdcaaace0858956558262a3d3,1,4,0,4,1,2011-06-17 16:09:15,2011-06-17 16:09:15
f6ce86af04787b0bdcaaace0858956558262a3d3...95b409c578f9f99d5e5d900125b303162e5dbd33,215,67663,9429,77092,349,2011-06-17 17:53:19,2011-06-17 17:52:31
95b409c578f9f99d5e5d900125b303162e5dbd33...b057770f8a04c7bfef38c8d10f24bdc358b6876f,1,6,0,6,1,2011-06-20 10:45:44,2011-06-19 06:06:33
b057770f8a04c7bfef38c8d10f24bdc358b6876f...5c38163787375b8c182295e2e597df9336c521ec,1,4,1,5,1,2011-06-20 11:31:14,2011-06-17 20:40:29
5c38163787375b8c182295e2e597df9336c521ec...d0a9e64245dbf60366ee25260effc2e3aea13542,1,3,4,7,4,2011-06-20 12:48:00,2011-06-20 12:48:00
d0a9e64245dbf60366ee25260effc2e3aea13542...02699a3a8e984caf740f991ed56cdb9278034acc,2,2,2,4,2,2011-06-20 13:51:03,2011-06-20 13:51:03
02699a3a8e984caf740f991ed56cdb9278034acc...c95da949ecc2731db2e3988958b7eb16422b589f,2,7,7,14,2,2011-06-22 22:35:35,2011-06-22 22:29:03
c95da949ecc2731db2e3988958b7eb16422b589f...c626f8bd8faad80c5e9c4b77aa3f2ee32e25de68,1,51,0,51,1,2011-06-27 11:18:31,2011-06-25 13:30:17
c626f8bd8faad80c5e9c4b77aa3f2ee32e25de68...6c121edc6008ad502317b7a3c12e8a78b92217c7,4,57,9,66,11,2011-06-28 11:36:45,2011-06-21 14:53:02
6c121edc6008ad502317b7a3c12e8a78b92217c7...f657d58fe1b47c67dabcd19fab31907e5f4eb784,139,6094,67564,73658,469,2011-06-28 11:37:03,2011-06-22 12:06:26
f657d58fe1b47c67dabcd19fab31907e5f4eb784...47a5d932563eb243a94441ea59b7d1a9023d5868,5,72,45,117,15,2011-06-28 11:52:36,2011-06-24 19:32:09
47a5d932563eb243a94441ea59b7d1a9023d5868...8cb5338f35c2738fd0e39fa2b8a0a13f770c1dc8,1,2,1,3,1,2011-06-28 11:56:02,2011-06-28 11:56:02
8cb5338f35c2738fd0e39fa2b8a0a13f770c1dc8...4e1e60fbf07479eca1cf71e36bd05315b363ae0c,3,4,4,8,3,2011-06-28 21:14:00,2011-06-28 20:32:35
4e1e60fbf07479eca1cf71e36bd05315b363ae0c...09b8a5e2cfbeb06274b4e6895d2bc22a2faec8b5,1,0,2,2,1,2011-06-29 00:44:26,2011-06-29 00:44:26
0ed1354119487f164887989715c9a43ac22a65f6...9e77b1a82ec126f52b20a4324f68edb855659d88,6,57,25,82,27,2011-07-22 10:23:56,2011-07-22 10:16:17
9e77b1a82ec126f52b20a4324f68edb855659d88...08ffce1a00dde1199174b390a64a90b60768ddf5,6,41,10,51,9,2011-07-22 10:55:26,2011-07-22 10:55:26
08ffce1a00dde1199174b390a64a90b60768ddf5...82905fa3aa7ea1e7930a760792554317c161c7cb,1,2,2,4,1,2011-07-22 18:51:43,2011-07-22 18:51:43
82905fa3aa7ea1e7930a760792554317c161c7cb...7a6a77e07c99569ba64a591db36fc845b0f4349f,2,30,65,95,24,2011-07-22 19:06:51,2011-07-22 14:28:56
7a6a77e07c99569ba64a591db36fc845b0f4349f...3eb246485a5567f2362203b0d467ea7999031bc0,3,2,11,13,3,2011-07-23 05:29:13,2011-07-23 05:29:13
3eb246485a5567f2362203b0d467ea7999031bc0...2fe780b36c3f13891930786ed82d5c0a495a731c,1,18,1,19,2,2011-07-23 14:23:01,2011-07-22 19:44:15
2fe780b36c3f13891930786ed82d5c0a495a731c...fa829b0fd31b4723a6d5ffb77816b06baa838267,2,23,3,26,6,2011-07-23 14:56:08,2011-02-11 02:35:39
fa829b0fd31b4723a6d5ffb77816b06baa838267...50e147bd03a9e2d722e2d7fc96adf8ccefe49866,3,122,33,155,27,2011-07-23 17:01:02,2011-07-21 17:53:11
50e147bd03a9e2d722e2d7fc96adf8ccefe49866...aa0308d6182b2f7a2508373770952eefd2fdb0ac,3,19,6,25,7,2011-07-23 21:16:48,2011-07-23 21:16:48
aa0308d6182b2f7a2508373770952eefd2fdb0ac...db993956d61dd1cff86787cf7b8d1661d3d23e30,2,196,6,202,4,2011-07-24 10:48:18,2011-05-08 12:17:21
db993956d61dd1cff86787cf7b8d1661d3d23e30...c050d0fa19a2dbb34e1e99403b597a5e8e51b6e5,3,5,6,11,3,2011-07-25 01:04:45,2011-07-25 01:04:45
c050d0fa19a2dbb34e1e99403b597a5e8e51b6e5...14b75a126f27286fea12bf1f918b8beb7abf01dd,3,83,0,83,7,2011-07-25 11:28:38,2011-07-21 08:20:01
14b75a126f27286fea12bf1f918b8beb7abf01dd...216829e7520a56ef0bede9fc8387c2de9683e4c0,1,8,0,8,1,2011-07-25 11:29:03,2011-07-23 07:00:43
216829e7520a56ef0bede9fc8387c2de9683e4c0...df3a8fcb62e44fa1b1c592f04a872648d26ec08c,3,13,8,21,6,2011-07-25 21:59:10,2011-07-25 21:54:44
df3a8fcb62e44fa1b1c592f04a872648d26ec08c...09ee29318f32fdbe68d04188795bb6c760f4835c,3,55,3,58,7,2011-07-26 09:07:17,2011-07-25 07:01:44
09ee29318f32fdbe68d04188795bb6c760f4835c...2b929c7f1944bc9ac33fb21927f2cc96c111371b,2,406,664,1070,51,2011-07-26 14:59:52,2011-07-25 22:15:15
2b929c7f1944bc9ac33fb21927f2cc96c111371b...915fa1e44fac1c7c367d6c43b33439f8352d63cd,1,74,76,150,11,2011-07-26 15:00:53,2011-07-25 22:13:24
915fa1e44fac1c7c367d6c43b33439f8352d63cd...2ed23314c35649f15d905cb1fca75d0b9d8b0d01,4,2318,406,2724,53,2011-07-26 15:00:53,2011-07-25 22:21:52
2ed23314c35649f15d905cb1fca75d0b9d8b0d01...0082ef271e7991d24873242bf6ea15715405a153,2,14,0,14,6,2011-07-26 15:00:53,2011-07-25 22:39:57
0082ef271e7991d24873242bf6ea15715405a153...1b3ebc32d7f64cf7a8b8a9cfc315d30bb74c04f6,1,5,3,8,3,2011-07-26 15:31:08,2011-07-26 15:19:05
1b3ebc32d7f64cf7a8b8a9cfc315d30bb74c04f6...a7bdaabf609e4db7151fff9a1f94c1bfffac8a02,4,4,4,8,4,2011-07-26 20:05:08,2011-07-26 20:05:08
a7bdaabf609e4db7151fff9a1f94c1bfffac8a02...d3a84bea7b361e786b43f5a00c1dfcc0eadb07ea,2,32,0,32,2,2011-07-26 22:19:02,2011-06-19 07:54:34
d3a84bea7b361e786b43f5a00c1dfcc0eadb07ea...de261713bfdffece3a5675fcf325dbcca7542e87,20,620,80,700,89,2011-07-27 01:54:00,2011-07-27 01:54:00
de261713bfdffece3a5675fcf325dbcca7542e87...187fe27a6e7da9d1f5ec9896af51a16c69d4c6c2,10,202,12,214,19,2011-07-27 01:59:33,2011-07-27 01:37:21
187fe27a6e7da9d1f5ec9896af51a16c69d4c6c2...83b82f900faa0c1ecb1adb9fcfe31936ce51fa41,2,4,4,8,4,2011-07-27 02:13:49,2011-07-27 02:13:49
83b82f900faa0c1ecb1adb9fcfe31936ce51fa41...562bef5ff3e04701098f180177d26634f5bcd003,1,12,12,24,5,2011-07-27 14:12:17,2011-07-27 03:16:50
562bef5ff3e04701098f180177d26634f5bcd003...8430148ccba72e313c9f99da05987a7c9d29c9ba,3,39,0,39,3,2011-07-27 18:10:11,2011-07-27 18:10:11
8430148ccba72e313c9f99da05987a7c9d29c9ba...1ca5b6cd0552e2c2b943876e878393d72104a62a,2,0,17,17,2,2011-07-27 23:21:54,2011-07-25 21:34:15
1ca5b6cd0552e2c2b943876e878393d72104a62a...497fe79f9759ff83161ff0620c47a6bdb7a205fe,1,50,36,86,7,2011-07-27 23:36:05,2011-07-27 23:36:03
497fe79f9759ff83161ff0620c47a6bdb7a205fe...bca6e35b2b533ce220376d5db43893e14bb8dbf3,1,8,8,16,3,2011-07-28 00:33:06,2011-07-28 00:33:04
bca6e35b2b533ce220376d5db43893e14bb8dbf3...ea9ee1fb7e3f785c21d04a155e0f18a354fe0173,3,95,1,96,6,2011-07-28 02:30:32,2011-07-28 02:30:32
ea9ee1fb7e3f785c21d04a155e0f18a354fe0173...8527f00c3c2beca11fe0c25048920ec50d177c28,3,6,11,17,9,2011-07-28 02:54:31,2011-07-28 02:54:31
8527f00c3c2beca11fe0c25048920ec50d177c28...799c7bdcb6ecbaee36b33154d40305636100746f,2,28,12,40,2,2011-07-28 03:03:02,2011-07-28 03:03:02
799c7bdcb6ecbaee36b33154d40305636100746f...759fb36df33f3dd0fa85fe01fa7b260bd22be40f,1,5,0,5,1,2011-07-28 13:16:04,2011-07-28 13:02:04
759fb36df33f3dd0fa85fe01fa7b260bd22be40f...62aaf56d1bf4819bf78ecb352092b625b9a4a0ea,2,41,0,41,2,2011-07-29 15:47:17,2011-07-29 14:49:48
62aaf56d1bf4819bf78ecb352092b625b9a4a0ea...bffb758243ca19d334696a07c8091cf5fb75fe7b,1,3,0,3,1,2011-07-29 15:47:54,2011-07-29 15:18:35
bffb758243ca19d334696a07c8091cf5fb75fe7b...703a1ffe52b66972f38db19fb68e0f70c3dd2631,10,4,116,120,15,2011-07-29 18:56:38,2011-07-29 18:56:05
703a1ffe52b66972f38db19fb68e0f70c3dd2631...de0b8d601c31314cb885e99609597084ab8a4d99,6,31,36,67,29,2011-07-29 18:58:02,2011-07-29 17:03:05
de0b8d601c31314cb885e99609597084ab8a4d99...9dd979228d73688af743a76ec59a38f7b8a39624,9,260,45,305,35,2011-07-29 22:43:56,2011-07-29 22:43:56
9dd979228d73688af743a76ec59a38f7b8a39624...9010f5fbab2695e6c0435db396f3e92118da6d76,8,315,22,337,33,2011-07-29 23:57:28,2011-07-28 15:52:04
9010f5fbab2695e6c0435db396f3e92118da6d76...874260b40fefc03aec7638a736b004b3ca0c23f3,3,85,42,127,9,2011-07-30 00:11:31,2011-07-29 15:26:45
874260b40fefc03aec7638a736b004b3ca0c23f3...f01b241057567818160f8cd4f58cf9cafdccf1ed,6,431,119,550,56,2011-07-30 01:03:44,2011-07-29 22:22:21
f01b241057567818160f8cd4f58cf9cafdccf1ed...5501a5a641e388855915f491130df7703bcbf107,1,1,0,1,1,2011-07-30 01:28:12,2011-07-30 01:28:12
5501a5a641e388855915f491130df7703bcbf107...d3d8f1b972e1fb99916b32647609ad58f6c16fd9,2,6,2,8,3,2011-07-30 14:56:17,2011-07-30 13:08:59
d3d8f1b972e1fb99916b32647609ad58f6c16fd9...7772f21b60e8b75dfaadd332c01bcae4e919dce9,6,31,6,37,9,2011-07-31 22:58:10,2011-07-31 22:58:10
7772f21b60e8b75dfaadd332c01bcae4e919dce9...4ac633bf2160b49746e279a745ac68e52009857c,1,154,0,154,1,2011-07-31 23:00:47,2011-07-31 23:00:47
4ac633bf2160b49746e279a745ac68e52009857c...19a62589b20000a64b5faf7992ad4f10801b2fe3,4,138,17,155,7,2011-07-31 23:24:29,2011-07-31 23:24:29
19a62589b20000a64b5faf7992ad4f10801b2fe3...ef767a152b1033c1dc67631b8cc377fb3acb933d,2,4,1,5,2,2011-07-31 23:50:53,2011-07-31 23:50:45
ef767a152b1033c1dc67631b8cc377fb3acb933d...624dd38d898d9a69a60320010d8598823ab1f603,3,11,2,13,4,2011-08-01 00:51:43,2011-08-01 00:51:41
624dd38d898d9a69a60320010d8598823ab1f603...baa6a925c2fe297555880345224a60e3c55ee421,17,1158,18,1176,39,2011-08-01 01:13:05,2011-08-01 01:13:05
baa6a925c2fe297555880345224a60e3c55ee421...f0f941a59e42a22771583da55d78e454a58eb051,1,4,0,4,1,2011-08-01 01:19:37,2011-08-01 01:19:37
f0f941a59e42a22771583da55d78e454a58eb051...8da4831ed0625f55017cb22e8c9096aa5d70b795,2,16,14,30,9,2011-08-01 16:16:27,2011-08-01 16:16:27
8da4831ed0625f55017cb22e8c9096aa5d70b795...b30ad11b59e121bbdc3f965a065615e3c85a999e,2,42,3,45,8,2011-08-01 17:22:24,2011-08-01 17:19:41
b30ad11b59e121bbdc3f965a065615e3c85a999e...9166f852858c79bec6441ff797f92fa96f36df39,1,0,5,5,3,2011-08-01 17:28:32,2011-08-01 17:28:32
9166f852858c79bec6441ff797f92fa96f36df39...c48b2a98d82904eaacbac32dde6de5ca9f9a51e7,1,30,14,44,6,2011-08-01 19:09:05,2011-08-01 18:58:56
c48b2a98d82904eaacbac32dde6de5ca9f9a51e7...7c07e75db9874f9172fe836b1412d53c13973b33,1,1,0,1,1,2011-08-01 20:26:28,2011-08-01 20:25:56
7c07e75db9874f9172fe836b1412d53c13973b33...1710bea3554db6506c698c651e639743f3f22e2e,1,4,0,4,1,2011-08-01 21:48:45,2011-08-01 21:48:19
1710bea3554db6506c698c651e639743f3f22e2e...925b467a4e6f76bee6252d5bc7b90ca579c77bf3,1,8,1,9,2,2011-08-01 21:49:10,2011-08-01 20:43:38
925b467a4e6f76bee6252d5bc7b90ca579c77bf3...76fd364dfee514c4081fc63cf6c962fce3839113,3,84,79,163,34,2011-08-01 21:49:58,2011-08-01 21:49:58
76fd364dfee514c4081fc63cf6c962fce3839113...707b1dee84685c0c17530d568192455cdf790078,11,125,63,188,30,2011-08-01 22:14:14,2011-07-28 05:56:41
707b1dee84685c0c17530d568192455cdf790078...e3ac47771c3408313223f34046891776834a000b,2,4,1,5,3,2011-08-01 22:40:44,2011-08-01 22:40:44
e3ac47771c3408313223f34046891776834a000b...ced0b14185614613573664d51913bea4296ef75e,1,1,1,2,1,2011-08-01 23:02:23,2011-08-01 23:02:23
ced0b14185614613573664d51913bea4296ef75e...99c15e5661ab2e4063db36a849a57f751c97606a,2,4,0,4,2,2011-08-01 23:05:57,2011-08-01 23:05:07
99c15e5661ab2e4063db36a849a57f751c97606a...e0d7c2cfa3f93e68d8036d8a98cbdf75e3b4ddc6,4,34,24,58,15,2011-08-01 23:16:58,2011-08-01 23:16:15
e0d7c2cfa3f93e68d8036d8a98cbdf75e3b4ddc6...e1bb241b51102a4212f71bc525b1c6687326d180,2,18,2,20,5,2011-08-01 23:52:24,2011-08-01 01:21:28
e1bb241b51102a4212f71bc525b1c6687326d180...bceab40b02f2da2ad282a0f649acf5ea251d2490,2,67,11,78,13,2011-08-02 00:06:03,2011-08-02 00:06:03
bceab40b02f2da2ad282a0f649acf5ea251d2490...a44748b3d7a53c710ee286c010e74d8aca117723,1,1,1,2,1,2011-08-02 00:18:01,2011-08-02 00:18:01
a44748b3d7a53c710ee286c010e74d8aca117723...2908f323e1cabd44329c8fcf67fd4b1fde41030b,2,19,3,22,3,2011-08-02 00:40:57,2011-08-02 00:40:46
2908f323e1cabd44329c8fcf67fd4b1fde41030b...70bf121f21c03d398a0d3c60e2088c29ff5a0b1b,1,13,4,17,3,2011-08-02 01:27:19,2011-08-02 01:19:57
70bf121f21c03d398a0d3c60e2088c29ff5a0b1b...1c09cc1550af44eaf9d8ba6365d5d7911c41fce3,1,6,0,6,2,2011-08-02 01:30:13,2011-08-02 01:21:38
1c09cc1550af44eaf9d8ba6365d5d7911c41fce3...89b14fc0ff4da52ec112e0af4d8e7d87bfe5d637,8,188,92,280,31,2011-08-02 03:26:26,2011-08-02 03:26:26
89b14fc0ff4da52ec112e0af4d8e7d87bfe5d637...a6e0a91a70ed450166a2066fe2a7d6a0d3969ca9,1,0,4,4,1,2011-08-02 03:44:27,2011-08-02 03:14:02
c72223e2a9aae2d5c20825562657c50a644d8a59...3056c2ca76c37ff03b24deb10e8dd538c70600f2,1,22,0,22,3,2011-08-06 14:31:17,2011-08-03 02:17:16
3056c2ca76c37ff03b24deb10e8dd538c70600f2...b267dc458d78c2fcbad2a9fa8e8942897d77c3d4,3,17,6,23,9,2011-08-07 22:57:30,2011-08-05 22:57:31
b267dc458d78c2fcbad2a9fa8e8942897d77c3d4...fc57df283c22f4be664ed72003870a3e813ae4c7,2,133,133,266,2,2011-08-07 22:59:14,2011-08-07 22:59:08
fc57df283c22f4be664ed72003870a3e813ae4c7...25118b0a26020d7d37ac91f92e575bae0ec947d5,1,1,1,2,1,2011-08-09 21:56:00,2011-08-05 20:52:27
25118b0a26020d7d37ac91f92e575bae0ec947d5...421b6e89aa58d1cdc3344d6fadb878f7b37eee1c,1,1,1,2,1,2011-08-09 21:56:00,2011-08-05 22:22:54
421b6e89aa58d1cdc3344d6fadb878f7b37eee1c...0d8d04e585cfbc526ff2eb6606d5ad83068878a2,1,1,1,2,1,2011-08-11 07:29:37,2011-08-11 04:09:33
0d8d04e585cfbc526ff2eb6606d5ad83068878a2...d1a26284991843417ce00da48005a3f8a8ff5399,1,78,21,99,13,2011-08-11 17:00:42,2011-08-11 08:13:13
d1a26284991843417ce00da48005a3f8a8ff5399...3210809d0acac59df9fbd887d4e45047b2a82507,2,7,2,9,2,2011-08-11 22:31:29,2011-08-11 22:30:56
3210809d0acac59df9fbd887d4e45047b2a82507...7ba30a4c2ec5b81f20373f5919510189e15f6f8c,1,1,1,2,1,2011-08-12 12:57:58,2011-08-12 11:05:46
7ba30a4c2ec5b81f20373f5919510189e15f6f8c...e00c2ec5e35ae631d01e96eb33f61c12dead3076,1,1,1,2,1,2011-08-12 13:32:43,2011-08-12 13:32:43
e00c2ec5e35ae631d01e96eb33f61c12dead3076...4e204f37fd994b3bd11a829c9f6938b5a3ca9774,1,7,1,8,1,2011-08-12 13:42:45,2011-08-12 13:42:45
4e204f37fd994b3bd11a829c9f6938b5a3ca9774...028b33b18ae16c52cb5eda879d92c20bf5b99c13,1,70,0,70,1,2011-08-12 13:46:18,2011-08-08 20:56:26
028b33b18ae16c52cb5eda879d92c20bf5b99c13...4d186f270fa4cea9835ec60b4417d7ca6f83422a,1,1,1,2,1,2011-08-14 14:10:36,2011-08-14 14:10:36
4d186f270fa4cea9835ec60b4417d7ca6f83422a...e8d268fd5fad5ac1356862a20b84cdd58bcb205c,1,6,6,12,6,2011-08-15 13:45:41,2011-08-15 13:09:03
e8d268fd5fad5ac1356862a20b84cdd58bcb205c...5e37e10e41c269b12ede9126126032e3a1c57973,1,5,1,6,3,2011-08-15 18:08:18,2011-08-13 23:25:39
5e37e10e41c269b12ede9126126032e3a1c57973...9cd510846eea5ebdd116fb45ef4d5be64acda022,1,0,1,1,1,2011-08-17 20:21:15,2011-08-17 20:21:15
570964328943d15ad8e195b38ce52f07615a3da6...d798866917529e894e881fbfa58acc190a07dd7e,1,2,0,2,1,2011-07-16 01:26:09,2011-07-16 00:46:56
d798866917529e894e881fbfa58acc190a07dd7e...562b469b35c4011217857f1e9d4e3e8e266a36cc,1,8,8,16,8,2011-07-16 03:56:14,2011-07-15 02:20:30
562b469b35c4011217857f1e9d4e3e8e266a36cc...4662ace9165ae6d8aab06ba7ef3ffff4c971c859,4,4,4,8,4,2011-07-16 05:12:00,2011-07-16 05:12:00
4662ace9165ae6d8aab06ba7ef3ffff4c971c859...292345fe626bc4185e8bb1c41bf3f859f48b3bd4,3,60,14,74,5,2011-07-16 06:24:36,2011-07-05 11:07:08
292345fe626bc4185e8bb1c41bf3f859f48b3bd4...61dfe5d2a9f613e3826997efa189ec8dd239aacf,1,0,9,9,1,2011-07-16 12:51:45,2011-07-16 12:51:45
61dfe5d2a9f613e3826997efa189ec8dd239aacf...93899cb0cb6389c5f51cc9f13bedea28405dd14a,1,1,1,2,1,2011-07-17 20:40:01,2011-07-15 14:15:07
93899cb0cb6389c5f51cc9f13bedea28405dd14a...448eab2587d35893bb9c3c05464643b40d0ce600,2,4,2,6,2,2011-07-17 21:35:49,2011-07-15 22:26:15
448eab2587d35893bb9c3c05464643b40d0ce600...404a4db6111f9dad8fe1bd924cc3ee6cc9eea06d,1,2,0,2,1,2011-07-18 10:08:54,2011-07-18 09:32:45
404a4db6111f9dad8fe1bd924cc3ee6cc9eea06d...1ae148909a2bd220cf48218a4c9ff295a611a65e,5,458,327,785,23,2011-07-18 10:08:54,2011-07-18 09:32:32
1ae148909a2bd220cf48218a4c9ff295a611a65e...cc0f608c7c24e52fe8e6a13f72e20ad520dcd5b4,3,233,0,233,3,2011-07-18 10:08:54,2011-07-18 10:07:26
cc0f608c7c24e52fe8e6a13f72e20ad520dcd5b4...0c7bf8132eed630c81fc96178091d1fc7ad8e65e,7,149,95,244,31,2011-07-18 11:22:16,2011-07-18 11:22:16
0c7bf8132eed630c81fc96178091d1fc7ad8e65e...61cda1e34ec8ea779f1a137e86eda81e2d394bae,1,3,1,4,3,2011-07-18 11:30:40,2011-07-18 11:30:40
61cda1e34ec8ea779f1a137e86eda81e2d394bae...bd2d90feff063f6727de44f623f724f811578c39,1,2,7,9,1,2011-07-18 11:36:36,2011-07-18 11:36:36
bd2d90feff063f6727de44f623f724f811578c39...e5cceffe6a59e6702b373051817f590acdcdf036,1,1,1,2,1,2011-07-18 11:39:22,2011-07-18 11:39:22
e5cceffe6a59e6702b373051817f590acdcdf036...85404c5c558ebbba3aaf27c56d1edccc2061d664,4,20,63,83,4,2011-07-18 20:47:56,2011-07-18 20:45:11
85404c5c558ebbba3aaf27c56d1edccc2061d664...2e16ae703ee5d14cf7199218b3112407a188af42,7,775,309,1084,165,2011-07-18 23:26:37,2011-07-18 23:26:37
2e16ae703ee5d14cf7199218b3112407a188af42...0a3fc1d9c8becc32c63ae736ca2b3719a3d03c5b,3,32,12,44,11,2011-07-19 08:23:50,2011-07-19 08:23:50
0a3fc1d9c8becc32c63ae736ca2b3719a3d03c5b...4ef8f06fe62edb74fded0e817266cb6398e69f36,10,10,153,163,17,2011-07-19 08:46:38,2011-07-19 08:46:38
4ef8f06fe62edb74fded0e817266cb6398e69f36...061ce7b0ac370c8a5ae93d95ab7da171cbd488f0,1,6,0,6,1,2011-07-19 09:04:34,2011-07-19 09:04:34
061ce7b0ac370c8a5ae93d95ab7da171cbd488f0...6050af4fd7c103c52c5081210f84237eac19108c,4,4,3,7,6,2011-07-19 09:19:27,2011-07-19 09:18:10
6050af4fd7c103c52c5081210f84237eac19108c...62f7c7961da7ca3f9731b84e8dec95a1fcd92480,14,115,3209,3324,42,2011-07-19 09:47:15,2011-07-19 09:47:15
62f7c7961da7ca3f9731b84e8dec95a1fcd92480...87d974bb8f4bc210fd6963901954f57cb6deb3fd,14,3699,0,3699,14,2011-07-19 09:50:33,2011-07-19 09:50:33
87d974bb8f4bc210fd6963901954f57cb6deb3fd...dcecfc5f1b417c5e06a8430143ccd9da17a6ae34,2,12,3,15,4,2011-07-19 16:55:01,2011-07-19 16:55:01
dcecfc5f1b417c5e06a8430143ccd9da17a6ae34...e3c1cf3b5be6a2d3e3b8999a5c8e63560bf4dce8,1,0,16,16,1,2011-07-19 22:01:05,2011-07-19 17:27:48
e3c1cf3b5be6a2d3e3b8999a5c8e63560bf4dce8...58655da3aa9d1f29776816ff553e5e93199cb312,1,3,5,8,3,2011-07-19 23:18:13,2011-07-19 23:17:43
58655da3aa9d1f29776816ff553e5e93199cb312...9cc2bd11d35fda0b000a16eca8fcef8a0d6fa339,13,84,45,129,33,2011-07-20 16:06:16,2011-07-20 16:06:16
9cc2bd11d35fda0b000a16eca8fcef8a0d6fa339...0599cb7afa7bd0b78741142b92b588a8f59609d5,1,1,1,2,1,2011-07-20 18:08:43,2011-07-20 18:06:45
0599cb7afa7bd0b78741142b92b588a8f59609d5...6f0740e67b785599cfd1112647249b5c678c7214,1,8,3,11,1,2011-07-20 20:24:11,2011-07-20 19:48:40
6f0740e67b785599cfd1112647249b5c678c7214...1b0e054737b207977981e0fc818b013ba8bb0caa,2,19,0,19,2,2011-07-20 22:51:48,2011-07-20 20:15:41
1b0e054737b207977981e0fc818b013ba8bb0caa...588d885e81dec667920383ac7246daceeb7f99fd,2,14,0,14,2,2011-07-21 00:39:23,2011-07-21 00:39:23
588d885e81dec667920383ac7246daceeb7f99fd...37cbc355d53077c3406ab4f1d7679f3504dcbe51,3,53,26,79,24,2011-07-21 01:51:23,2011-07-19 20:49:42
37cbc355d53077c3406ab4f1d7679f3504dcbe51...0c396c05fddca68f2d2378538ad7960f11f97141,2,16,3,19,8,2011-07-21 01:51:23,2011-07-20 22:36:54
0c396c05fddca68f2d2378538ad7960f11f97141...53aac9dde614bb5426c681ab9ba631bd5c33b1a3,12,279,99,378,48,2011-07-21 01:51:23,2011-07-20 22:19:31
53aac9dde614bb5426c681ab9ba631bd5c33b1a3...1b89323e92001481f7b0e1f14736d288b58b160e,1,2,2,4,4,2011-07-21 01:51:23,2011-07-21 01:42:39
1b89323e92001481f7b0e1f14736d288b58b160e...133036fdadbca1099cf1cf589987eea01236722e,16,289,136,425,89,2011-07-21 02:57:03,2011-07-21 02:55:12
133036fdadbca1099cf1cf589987eea01236722e...3c4c36068e0ead8d3442da59f46cd72d68a908bb,1,4,0,4,1,2011-07-21 11:35:47,2011-07-14 06:14:44
3c4c36068e0ead8d3442da59f46cd72d68a908bb...d3d776f97893961bfca597264ced1e7028ebf8af,1,52,0,52,1,2011-07-21 11:36:11,2011-07-20 02:17:58
d3d776f97893961bfca597264ced1e7028ebf8af...a8f96d3314f2eb75997a84ea002198ae7d6f6f46,2,67,0,67,2,2011-07-21 12:15:33,2011-07-21 05:42:10
a8f96d3314f2eb75997a84ea002198ae7d6f6f46...3de406cc58b9a30455b72e12008bdac4d994ba37,3,84,0,84,4,2011-07-21 13:26:10,2011-07-21 13:26:10
3de406cc58b9a30455b72e12008bdac4d994ba37...4d3a907f7324e7cea936421e5e2efca2f251cfe0,6,155,78,233,28,2011-07-21 13:41:28,2011-07-21 13:41:28
4d3a907f7324e7cea936421e5e2efca2f251cfe0...bff96029665ea430afff60aa481c09a5897168ed,1,6,0,6,1,2011-07-21 19:26:57,2011-07-21 19:21:06
bff96029665ea430afff60aa481c09a5897168ed...725fcf55873915e4660ae8f92056be7f834592e6,2,3,9,12,3,2011-07-21 19:27:01,2011-07-21 19:22:56
725fcf55873915e4660ae8f92056be7f834592e6...4b77626add4591c6d3aeb5fbd010fb173a5ef8ce,1,2,10,12,4,2011-07-21 19:27:01,2011-07-21 19:25:46
4b77626add4591c6d3aeb5fbd010fb173a5ef8ce...a0198d065d70d1ce4c06bdc12e6d31bfa1658a7a,1,1,0,1,1,2011-07-21 20:39:53,2011-07-21 20:39:53
a0198d065d70d1ce4c06bdc12e6d31bfa1658a7a...a6a3bf6d470dbc2cd167c9d7788181793d0dc8a0,1,1,1,2,1,2011-07-21 21:19:24,2011-07-21 21:19:24
a6a3bf6d470dbc2cd167c9d7788181793d0dc8a0...20ced0ea1e8c440c2dbd13f1aa67cc35f317a85c,1,12,0,12,1,2011-07-21 22:42:08,2011-07-21 22:42:08
20ced0ea1e8c440c2dbd13f1aa67cc35f317a85c...59b04427d36b3b2f271daf7be3010b8a915c84b4,1,13,12,25,6,2011-07-21 22:54:50,2011-07-21 21:00:47
59b04427d36b3b2f271daf7be3010b8a915c84b4...07bcdc2f5135c77baf37d4d037f88e8f7b06af5f,1,1,0,1,1,2011-07-21 22:54:50,2011-07-21 22:47:28
07bcdc2f5135c77baf37d4d037f88e8f7b06af5f...8ddb334c2aaf0f389779d4d8d5d5b8754bf8c74d,1,1,0,1,1,2011-07-21 22:54:50,2011-07-21 22:48:50
8ddb334c2aaf0f389779d4d8d5d5b8754bf8c74d...345df289eb775aa2c195056ab88adf2c6ab95d66,2,86,0,86,2,2011-07-21 22:54:50,2011-07-21 22:42:01
345df289eb775aa2c195056ab88adf2c6ab95d66...984dc057e39b09443cb31345b256b596509a588d,2,11,4,15,4,2011-07-21 23:23:50,2011-07-21 23:23:50
e5564a3f29e0a818832a97c7c3b28d7c8b3b0460...ef1be160d66b7da8bc2da857b1c33c6f680d86f1,165,3693,4290,7983,1128,2011-07-16 00:47:20,2011-07-16 00:47:20
e5564a3f29e0a818832a97c7c3b28d7c8b3b0460...91f1b250ecb4fb8151cd17423dd4460652d0ce97,1,8,3,11,3,2011-07-09 00:08:52,2011-07-09 00:08:52
91f1b250ecb4fb8151cd17423dd4460652d0ce97...8faf9411094220a4a221527207c7e7d939862c61,1,1,1,2,1,2011-07-09 00:18:31,2011-07-04 19:10:14
8faf9411094220a4a221527207c7e7d939862c61...d38fac2230e9803231f080568588446556753c45,1,16,10,26,6,2011-07-09 00:18:42,2011-07-03 06:20:25
d38fac2230e9803231f080568588446556753c45...a58b6439de56f44a6dc3e34f4867524c94395246,6,538,5,543,8,2011-07-09 00:44:58,2011-07-07 20:54:30
a58b6439de56f44a6dc3e34f4867524c94395246...dcf6955c1079b12b170a4b846a5c111f046b46e8,1,9,0,9,1,2011-07-09 01:21:29,2011-06-29 18:12:58
dcf6955c1079b12b170a4b846a5c111f046b46e8...13a521e6980ff586d720a710d44b0192ba6b5fa6,1,1,1,2,1,2011-07-09 01:24:51,2011-07-09 01:22:03
13a521e6980ff586d720a710d44b0192ba6b5fa6...09130147cfb553fab904ae36e9b881912a10a13b,1,2,0,2,1,2011-07-11 12:17:23,2011-07-11 12:16:00
09130147cfb553fab904ae36e9b881912a10a13b...fad91d16ea636e024f55201cc0ff4765275b41db,2,2,0,2,2,2011-07-12 16:54:40,2011-07-08 22:03:48
fad91d16ea636e024f55201cc0ff4765275b41db...9057d3f17eab0e22513410a27c75b95375f97de3,1,1,1,2,1,2011-07-12 20:42:09,2011-07-12 20:33:02
9057d3f17eab0e22513410a27c75b95375f97de3...92057554d59e9875407fa944c73eb93354418a02,2,3,2,5,2,2011-07-12 22:29:26,2011-07-12 22:26:45
92057554d59e9875407fa944c73eb93354418a02...a3e3ad40b1f34adcf4c039adb370da2e87cf5b5d,2,92,2,94,6,2011-07-13 17:52:54,2011-07-08 15:57:57
a3e3ad40b1f34adcf4c039adb370da2e87cf5b5d...8adc6b89219fc6efe1d2e479288d1f02d92c6921,2,6,0,6,2,2011-07-14 20:23:08,2011-07-14 20:18:28
8adc6b89219fc6efe1d2e479288d1f02d92c6921...a13506b48f7d35c80b86f2aadd4da9f91dc73d20,1,1,0,1,1,2011-07-14 21:18:17,2011-07-14 21:18:17
a13506b48f7d35c80b86f2aadd4da9f91dc73d20...876712a0749abf40d93d2546ad81a97fd37b8ba2,1,6,6,12,2,2011-07-14 21:18:47,2011-07-14 20:59:37
876712a0749abf40d93d2546ad81a97fd37b8ba2...9b5098f509a433d6eea93da8d74b6a118718058a,7,33,1,34,8,2011-07-14 21:25:49,2011-07-14 20:55:51
9b5098f509a433d6eea93da8d74b6a118718058a...b722aaa8c52e580a7214451dc068a63ee2a3c0a4,3,38,0,38,3,2011-07-14 21:25:49,2011-07-11 05:35:25
b722aaa8c52e580a7214451dc068a63ee2a3c0a4...7a782164b9b236e33cb5c7d586f8f3085f400ab5,47,2269,1441,3710,374,2011-07-14 21:29:24,2011-07-14 21:28:52
7a782164b9b236e33cb5c7d586f8f3085f400ab5...6d8b082eedc10a2827091b8b803760ba2fd8d616,1,1,1,2,1,2011-07-14 21:49:50,2011-07-14 21:49:50
6d8b082eedc10a2827091b8b803760ba2fd8d616...77ecc5a41a58a2588b607e2d9342a4282de79b19,1,9,0,9,6,2011-07-14 22:22:47,2011-07-14 22:17:35
77ecc5a41a58a2588b607e2d9342a4282de79b19...612875765d9d7a4911595085bc31c441f3cd46ab,1,0,1,1,1,2011-07-14 22:25:19,2011-07-14 18:48:19
612875765d9d7a4911595085bc31c441f3cd46ab...b5e7b7870a1714d61f17968416c37163bab73c13,1,1,1,2,1,2011-07-14 22:29:21,2011-07-14 22:28:54
b5e7b7870a1714d61f17968416c37163bab73c13...ab0d88142ec7fa7f6e7954a8c1fd3a9e1a9c9191,1,2,2,4,1,2011-07-14 22:34:08,2011-07-14 22:34:08
6d5218bc7d344b0f4e0a0cb50fdd25052946cc4f...3ce671284b61c34767994d94548a27836e706735,2,0,893,893,2,2011-08-02 05:34:16,2011-08-02 05:25:57
3ce671284b61c34767994d94548a27836e706735...8ace421bfda284f600edb5aeaa525b7817078922,1,1,1,2,2,2011-08-02 05:51:14,2011-08-02 05:51:14
8ace421bfda284f600edb5aeaa525b7817078922...21964fa779abd7d089cc843f67ffc1c8e8636e40,3,3,181,184,14,2011-08-02 07:16:15,2011-08-02 07:10:53
21964fa779abd7d089cc843f67ffc1c8e8636e40...4585330afef44ddfb6a4054bd9b0f190b352628b,4,50,9,59,7,2011-08-02 07:17:41,2011-08-02 05:18:17
4585330afef44ddfb6a4054bd9b0f190b352628b...158bfab92202e6a30c71ee34ba73abd82379a049,1,2,2,4,1,2011-08-02 08:08:01,2011-08-02 08:08:01
158bfab92202e6a30c71ee34ba73abd82379a049...91ecfbcae86cabd0b6872d6cda1d7a640b0d5737,9,2,532,534,10,2011-08-02 16:38:34,2011-08-02 13:28:19
91ecfbcae86cabd0b6872d6cda1d7a640b0d5737...a962cca390fed391ccf9bd0eb72617524470a970,2,8,0,8,3,2011-08-02 16:38:35,2011-08-02 16:34:11
a962cca390fed391ccf9bd0eb72617524470a970...48dcb905f6cfc44a8bbbddfa3d1c25415b2b5287,9,79,76,155,31,2011-08-02 19:12:14,2011-08-02 04:22:30
48dcb905f6cfc44a8bbbddfa3d1c25415b2b5287...38f948a373aa3dc8c46628bbd53edf07b6f16ea7,4,15,15,30,12,2011-08-02 21:40:56,2011-08-02 19:28:31
38f948a373aa3dc8c46628bbd53edf07b6f16ea7...6efc86df6a91fca05791812bbbfc4d265c1cb387,1,6,1,7,3,2011-08-02 22:27:16,2011-08-02 22:27:16
6efc86df6a91fca05791812bbbfc4d265c1cb387...09bb1d64dc774bc52f1b0dfd048715ad3243e550,1,1,1,2,1,2011-08-02 23:45:03,2011-08-02 23:45:03
09bb1d64dc774bc52f1b0dfd048715ad3243e550...12c8b27e243724a40128b6e335713edc63993d5a,1,15,3,18,4,2011-08-03 14:05:49,2011-08-03 14:05:49
12c8b27e243724a40128b6e335713edc63993d5a...88f416a5edf248681f550741b38f93a3a6dd6472,1,19,2,21,1,2011-08-03 14:50:47,2011-08-03 14:50:47
88f416a5edf248681f550741b38f93a3a6dd6472...0c4e7354011ec3dd419a8f0364ada28a3c3a0bf1,1,1,1,2,1,2011-08-03 23:38:53,2011-08-03 23:35:30
0c4e7354011ec3dd419a8f0364ada28a3c3a0bf1...f9cfd709460e04c8417e7784e6e3b264d3ff6c69,1,3,3,6,2,2011-08-04 14:43:11,2011-08-04 14:43:11
f9cfd709460e04c8417e7784e6e3b264d3ff6c69...ac722bbed6ea846991904ed205a6dc5ece4748c9,4,27,8,35,6,2011-08-04 14:52:55,2011-08-02 21:18:18
ac722bbed6ea846991904ed205a6dc5ece4748c9...2bbb46842848b8def1188932755054aa808ccbe6,2,29,4,33,5,2011-08-04 16:40:41,2011-08-04 16:40:41
2bbb46842848b8def1188932755054aa808ccbe6...b8c8e9c113e4611560948420e1ad67f1ee13d975,1,5,0,5,1,2011-08-04 19:05:42,2011-08-04 19:04:54
b8c8e9c113e4611560948420e1ad67f1ee13d975...eeece4f5eab2d192635e19c64ae2d429f96c2284,102,4397,2110,6507,754,2011-08-04 19:18:09,2011-08-04 19:18:09
eeece4f5eab2d192635e19c64ae2d429f96c2284...5a49522ba77e1b7bc648fd7f09d54e9583fb22ac,1,1,1,2,1,2011-08-04 19:28:49,2011-08-04 19:24:38
5a49522ba77e1b7bc648fd7f09d54e9583fb22ac...2fe4558c1074538dc419067e22108edafc6f083a,1,71,4,75,6,2011-08-05 02:27:18,2011-08-05 02:27:18
2fe4558c1074538dc419067e22108edafc6f083a...30d20cf40595e5d0c31b6d3cab9afc9fe8c54bfb,2,5,34,39,5,2011-08-05 02:29:16,2011-08-05 02:29:16
30d20cf40595e5d0c31b6d3cab9afc9fe8c54bfb...08782931205bc4f6d28102ebc29fd806e8ccdf1f,4,163,53,216,10,2011-08-05 07:15:04,2011-08-05 07:15:04
08782931205bc4f6d28102ebc29fd806e8ccdf1f...ae77b4d55315c36b35fda9392943951f247e86ea,1,30,0,30,1,2011-08-05 14:42:24,2011-08-05 14:37:16
ae77b4d55315c36b35fda9392943951f247e86ea...69ce415d38e093072cb60179e8d7f0f76f68c88c,1,4,4,8,1,2011-08-05 15:16:47,2011-08-05 15:16:43
69ce415d38e093072cb60179e8d7f0f76f68c88c...567470b136c2b170b327e26f15a0e59de7dec250,2,43,14,57,8,2011-08-05 20:57:45,2011-08-05 07:36:39
567470b136c2b170b327e26f15a0e59de7dec250...9e8d812ce998bf3ef2857c311730163b8fa45fef,1,6,1,7,2,2011-08-05 20:57:45,2011-08-05 08:03:38
9e8d812ce998bf3ef2857c311730163b8fa45fef...891a6f24a0a6df5a23b4ca417cb701d6c6718b00,1,19,0,19,1,2011-08-06 06:02:25,2011-08-04 03:39:19
891a6f24a0a6df5a23b4ca417cb701d6c6718b00...bbb38b89184a2e570c02fd1908ae0d5393c9dbc0,1,3,2,5,2,2011-08-06 06:25:40,2011-08-06 06:25:40
bbb38b89184a2e570c02fd1908ae0d5393c9dbc0...c3ccbea5cde63f6fea5729769370f43fe50cac8b,7,608,300,908,210,2011-08-06 10:04:42,2011-08-06 09:58:44
9cd510846eea5ebdd116fb45ef4d5be64acda022...a745d19ce7d1c0e3778371af4f0346be70cf2c8e,5,46,14,60,11,2011-08-18 01:18:10,2011-08-18 01:17:57
a745d19ce7d1c0e3778371af4f0346be70cf2c8e...dc578724b150a44ff9d42677b3208847f768f0ad,1,2,2,4,1,2011-08-18 01:45:28,2011-08-18 01:45:28
dc578724b150a44ff9d42677b3208847f768f0ad...b4712bf1ac261d37ddc2e6663cff0e0cd899a2bb,1,8,2,10,3,2011-08-18 01:47:48,2011-08-17 20:13:56
b4712bf1ac261d37ddc2e6663cff0e0cd899a2bb...e150bc4f2b73dce7b194edde72f89f11b9cddeae,1,2,1,3,1,2011-08-19 23:00:21,2011-08-19 22:26:21
e150bc4f2b73dce7b194edde72f89f11b9cddeae...ce9caa237fe730ecf18cc96f4a176352a1b1a2dc,2,15,0,15,3,2011-08-20 19:42:58,2011-08-20 19:38:31
ce9caa237fe730ecf18cc96f4a176352a1b1a2dc...509a676128a250884af2810b62a264298ae172b0,1,24,2,26,1,2011-08-22 16:15:32,2011-08-22 15:19:39
509a676128a250884af2810b62a264298ae172b0...827b9c5f1fa1ec5279658ee7bce141c4ed95d0b0,1,1,1,2,1,2011-08-23 21:30:12,2011-08-23 21:29:46
827b9c5f1fa1ec5279658ee7bce141c4ed95d0b0...0c91a835ff7d5fd1ee288d11d977a95122aa400e,2,35,9,44,2,2011-08-25 17:23:31,2011-08-25 17:22:35
fea524e145d7bd8d3f76d6f0fd266187144cc08c...8eb1edc8ea405c55b06e76111a4bc30fe16bb7fb,1,7,5,12,1,2011-07-22 08:20:27,2011-07-22 08:20:13
8eb1edc8ea405c55b06e76111a4bc30fe16bb7fb...daead5f5bb6dc9ce4fc5fd984bd48deecffe1dae,1,4,3,7,2,2011-07-22 09:11:02,2011-07-22 09:11:02
ef1be160d66b7da8bc2da857b1c33c6f680d86f1...f319e126218dcaafdb0ccf7e968ff839f8327bba,111,4227,920,5147,715,2011-07-22 05:20:37,2011-07-22 05:20:37
c3ccbea5cde63f6fea5729769370f43fe50cac8b...ad31e5af56ec1a68749fef1e597a50682851411a,1,2,2,4,1,2011-08-06 22:09:08,2011-08-06 22:02:29
ad31e5af56ec1a68749fef1e597a50682851411a...54bb53bf32f53f1a4aba962af22170af7fb19b75,1,1,1,2,1,2011-08-07 21:30:03,2011-08-07 21:30:03
54bb53bf32f53f1a4aba962af22170af7fb19b75...d5c95f02afd7c281c4e60cde1be693cd3703f53c,2,109,170,279,22,2011-08-07 22:56:04,2011-08-07 22:56:04
d5c95f02afd7c281c4e60cde1be693cd3703f53c...ef35f4d6c1b4cc0f0ff72e2b91c02e078bc19fa3,1,64,0,64,1,2011-08-08 00:37:56,2011-08-08 00:36:49
ef35f4d6c1b4cc0f0ff72e2b91c02e078bc19fa3...24a1f6ecc502ab67ca4aa33aa2af7e67747aad86,2,2,0,2,2,2011-08-08 00:37:56,2011-08-07 23:14:32
24a1f6ecc502ab67ca4aa33aa2af7e67747aad86...d439c092c20395b601aba9a68807868a85b422aa,3,15,3,18,6,2011-08-08 14:24:05,2011-08-07 06:55:44
d439c092c20395b601aba9a68807868a85b422aa...f69822c70e5f02e37f984d5282f675733d2de9c2,1,1,1,2,1,2011-08-08 15:38:50,2011-08-08 15:37:52
f69822c70e5f02e37f984d5282f675733d2de9c2...587f6c31175841e4171d81603a71460a2c082faf,1,1,1,2,1,2011-08-08 23:17:18,2011-08-08 23:14:30
c3ccbea5cde63f6fea5729769370f43fe50cac8b...4f3c8b397215f96e29b314c661e469f9afa58d64,4,150,348,498,4,2011-08-06 10:11:33,2011-08-04 00:01:30
4f3c8b397215f96e29b314c661e469f9afa58d64...81a999c954b09803f74ac3959ab78ea14172c0a4,16,245,1174,1419,16,2011-08-06 10:11:33,2011-08-04 00:23:38
81a999c954b09803f74ac3959ab78ea14172c0a4...518430db3a8e2e5374136a0ec9754b6d5a7e8ee6,3,8,2,10,8,2011-08-06 10:12:05,2011-08-04 02:57:04
518430db3a8e2e5374136a0ec9754b6d5a7e8ee6...bea4827de0d5c92320ce93295269a40c678e5168,2,28,1,29,4,2011-08-06 10:12:05,2011-08-04 06:36:27
bea4827de0d5c92320ce93295269a40c678e5168...f55f478523af85550bed29b8680c21458db82286,6,607,0,607,6,2011-08-06 10:12:06,2011-08-04 19:36:24
f55f478523af85550bed29b8680c21458db82286...a979ab9d9970f8d3017d069479d41b4e4aa0d44c,5,75,14,89,21,2011-08-06 10:12:06,2011-08-04 23:40:07
a979ab9d9970f8d3017d069479d41b4e4aa0d44c...43d7cfca1835951e4ca44f8cd39db9b3a195563a,3,16,5,21,6,2011-08-06 10:12:06,2011-08-05 00:13:37
43d7cfca1835951e4ca44f8cd39db9b3a195563a...51ffed1cd0d1214c2307e2ca1b77709e221237a4,2,23,11,34,11,2011-08-06 10:12:07,2011-08-05 00:14:20
51ffed1cd0d1214c2307e2ca1b77709e221237a4...f038252ba553bbcea28b5cd99b298710108784d9,2,33,5,38,2,2011-08-06 10:12:07,2011-08-05 00:32:45
f038252ba553bbcea28b5cd99b298710108784d9...4eeeb756bcd5b4ae2f33411d2c7ce64c836fd741,3,7,6,13,2,2011-08-06 10:12:07,2011-08-05 00:40:43
4eeeb756bcd5b4ae2f33411d2c7ce64c836fd741...7a38b63358310a47a30a86e328166c4858ce7761,1,1,1,2,1,2011-08-06 10:12:08,2011-08-05 00:42:52
7a38b63358310a47a30a86e328166c4858ce7761...466cbfef1b3707392eb94a67d5e1eea3486dcec9,3,3,4,7,2,2011-08-06 10:12:08,2011-08-05 20:26:55
466cbfef1b3707392eb94a67d5e1eea3486dcec9...bef9f56cacffe3a55d9154e304a57ad8de607c5a,38,18555,34,18589,37,2011-08-06 10:12:08,2011-08-05 22:03:30
bef9f56cacffe3a55d9154e304a57ad8de607c5a...bd270b48a790ba00dd5a0dc9624aabbdedacaea8,183,0,47322,47322,183,2011-08-06 10:12:09,2011-08-05 22:08:00
bd270b48a790ba00dd5a0dc9624aabbdedacaea8...13d6a1f67fe3d95ba674923c96c7f0ecc8e6575a,10,106,25,131,53,2011-08-06 10:31:29,2011-08-06 04:23:25
13d6a1f67fe3d95ba674923c96c7f0ecc8e6575a...88afc406caa64628a249d726659b3b054f8dc70d,25,2578,710,3288,312,2011-08-06 10:38:11,2011-08-06 10:38:11
88afc406caa64628a249d726659b3b054f8dc70d...610436f242c930871929334692d727d7d634193e,1,0,3,3,2,2011-08-06 10:46:41,2011-08-06 10:46:41
610436f242c930871929334692d727d7d634193e...3ebbf6ebf781b7798d9ffbd8c70c40560c6cef8c,1,1,2,3,2,2011-08-06 10:47:09,2011-08-06 10:47:09
3ebbf6ebf781b7798d9ffbd8c70c40560c6cef8c...5aa75ebe71df7449988a1c63435fd91072476cc7,202,35350,49,35399,223,2011-08-07 02:11:55,2011-08-07 02:11:39
5aa75ebe71df7449988a1c63435fd91072476cc7...71333b3f5b12183b2709704fec160df916cb637a,5,203,26,229,26,2011-08-07 02:53:11,2011-08-06 19:20:15
71333b3f5b12183b2709704fec160df916cb637a...b88c48177a5301cfabbb3d0790187d3b6dacdbda,1,8,0,8,4,2011-08-07 03:13:50,2011-08-06 04:23:25
b88c48177a5301cfabbb3d0790187d3b6dacdbda...6ac8c559897ae09a4f9e84cda1e90e6c56ca92bf,11,221,51,272,49,2011-08-07 05:39:28,2011-08-07 05:11:21
6ac8c559897ae09a4f9e84cda1e90e6c56ca92bf...cafe446f42cd07e50d7bc71918419e0f440fc974,1,305,3,308,3,2011-08-07 08:24:00,2011-08-07 08:24:00
cafe446f42cd07e50d7bc71918419e0f440fc974...79d9f62946cf2731334faa64d76039ae1db7fd3e,1,5,2,7,3,2011-08-07 21:22:17,2011-08-07 17:43:24
79d9f62946cf2731334faa64d76039ae1db7fd3e...bcff53dfb57652e8f58e613cc951275790608780,1,5,0,5,2,2011-08-07 21:22:34,2011-08-07 17:44:11
bcff53dfb57652e8f58e613cc951275790608780...588ef72ce02595e954aa28b1805e09d937a0ec5e,1,7,1,8,1,2011-08-07 21:22:45,2011-08-07 18:05:37
588ef72ce02595e954aa28b1805e09d937a0ec5e...e38fc6cc843c26a886cd16acad2585397d11924d,1,14,0,14,3,2011-08-07 21:22:59,2011-08-07 18:46:26
e38fc6cc843c26a886cd16acad2585397d11924d...b031429dc3726afa2823de289d819c44321c51d2,1,2,0,2,1,2011-08-07 21:54:14,2011-08-07 21:54:14
b031429dc3726afa2823de289d819c44321c51d2...13d685bdab370b64598667465f2095dd6a0d8d9b,1,2,0,2,1,2011-08-07 21:54:37,2011-08-07 21:54:33
13d685bdab370b64598667465f2095dd6a0d8d9b...f57d70d3c9aae692585478e3817dae512b526adc,3,89,16,105,9,2011-08-08 15:55:39,2011-08-08 15:55:39
f57d70d3c9aae692585478e3817dae512b526adc...f03ea7045c53fff157f239204814566be1511d8f,1,1,1,2,1,2011-08-08 17:25:55,2011-08-08 17:25:55
f03ea7045c53fff157f239204814566be1511d8f...db1bf679d8047e661b31ffcbd1418da335246413,4,93,109,202,23,2011-08-08 19:11:48,2011-08-08 19:11:48
db1bf679d8047e661b31ffcbd1418da335246413...d53fccbce577424d66cf5ac8961b26421d5d467a,1,10,2,12,2,2011-08-08 19:32:34,2011-08-08 19:32:34
d53fccbce577424d66cf5ac8961b26421d5d467a...03b5831f90acffa8a10580ff94f10665731b9031,4,487,118,605,27,2011-08-08 21:12:44,2011-08-08 21:12:40
03b5831f90acffa8a10580ff94f10665731b9031...09f2d386dfd46007941dc8170fc0f776caa2ff71,6,328,29,357,21,2011-08-08 21:14:47,2011-08-08 21:14:47
09f2d386dfd46007941dc8170fc0f776caa2ff71...c110fbcc99140547619f874ebcaf0597a877560d,183,47322,0,47322,183,2011-08-08 21:15:51,2011-08-08 21:15:51
c110fbcc99140547619f874ebcaf0597a877560d...71435ede815ee2c73b09f7071ee1b6d10945d409,2,99,102,201,7,2011-08-08 22:09:42,2011-08-08 22:09:42
0c91a835ff7d5fd1ee288d11d977a95122aa400e...ef27d56cc12ed34f4f8b4565304556a3fe426f30,1,0,29,29,1,2011-08-30 15:53:21,2011-08-30 15:35:16
ef27d56cc12ed34f4f8b4565304556a3fe426f30...96ede8cc9b946e23482f855b19428868cab6021a,2,10,2,12,3,2011-09-02 00:56:58,2011-09-01 07:48:35
96ede8cc9b946e23482f855b19428868cab6021a...3e853e627edc8f3766cca012b0b0c9bfc0efbd98,2,24,0,24,4,2011-09-03 02:48:27,2011-09-02 09:37:15
3e853e627edc8f3766cca012b0b0c9bfc0efbd98...fdbfc9ceb7383ab3481b75b3071af67c348875b2,2,58,9,67,3,2011-09-04 04:53:38,2011-09-03 06:28:36
8320af7ef370d8811d4a71bf094f3f432a72083c...711a356468da99d8f021cde6e6ca3ac92bd67c75,1,8,2,10,3,2011-08-17 20:43:09,2011-08-17 20:13:56
711a356468da99d8f021cde6e6ca3ac92bd67c75...8e8f36f9583cd4b0c1c76b5640a409647d0c260c,1,0,1,1,1,2011-08-17 20:53:42,2011-08-17 20:53:13
8e8f36f9583cd4b0c1c76b5640a409647d0c260c...63607a0304e99259d3b7a24c44f7d29384b93cb4,1,14,4,18,5,2011-08-17 21:26:23,2011-08-17 20:38:30
63607a0304e99259d3b7a24c44f7d29384b93cb4...05e6f318c6ecccea73698367010e51812c5b3862,129,3261,1527,4788,816,2011-08-18 23:59:30,2011-08-18 23:59:21
05e6f318c6ecccea73698367010e51812c5b3862...962a9e808cec3f2c872fd9470a0d0494ded48673,1,2,1,3,1,2011-08-19 22:59:31,2011-08-19 22:26:21
962a9e808cec3f2c872fd9470a0d0494ded48673...f5db3f1f859427d2b1252f937a45409c5d4eb38b,2,14,0,14,3,2011-08-20 19:39:40,2011-08-20 19:38:31
f5db3f1f859427d2b1252f937a45409c5d4eb38b...1adfd48448ea7528107319591eb183e0734183cf,1,1,0,1,1,2011-08-22 15:18:46,2011-08-22 15:18:46
1adfd48448ea7528107319591eb183e0734183cf...e80cac622569dda0f6753b452ba3e5085a9d09e5,1579,458639,14,458653,1581,2011-08-22 18:30:45,2011-08-19 21:03:32
e80cac622569dda0f6753b452ba3e5085a9d09e5...0110c90382f9a1e8f7aa3cc5388651ec2391a9a6,113,1119,652,1771,304,2011-08-22 18:30:47,2011-08-20 05:05:08
0110c90382f9a1e8f7aa3cc5388651ec2391a9a6...2e5a8e071e5999ece940dcfeae3cefb5a1f309df,1,4,5,9,1,2011-08-22 18:36:38,2011-08-22 18:36:38
2e5a8e071e5999ece940dcfeae3cefb5a1f309df...94963ab39adcf4b346646f9a4bb5cd3dbf09dac6,1,62,0,62,1,2011-08-22 21:30:58,2011-08-17 08:06:41
94963ab39adcf4b346646f9a4bb5cd3dbf09dac6...103990b64043b980cf98feefcae12019ae6e3108,2,18,7,25,6,2011-08-22 21:31:25,2011-08-15 20:51:20
103990b64043b980cf98feefcae12019ae6e3108...b8d40be6112a20d7508704241d944fc3d5b6dfc3,30,1107,608,1715,242,2011-08-22 21:52:28,2011-08-22 21:51:29
b8d40be6112a20d7508704241d944fc3d5b6dfc3...cf2e68d960750dbe36367463168764d7a32ddcb9,1,4,1,5,2,2011-08-22 22:03:27,2011-08-22 22:03:27
cf2e68d960750dbe36367463168764d7a32ddcb9...c2ae39b8d60407261d1963461087798458b31358,1,1,0,1,1,2011-08-23 00:07:07,2011-08-23 00:07:07
c2ae39b8d60407261d1963461087798458b31358...80dd8182907314ae99f5572798c86176e2086c47,10,963,92,1055,59,2011-08-23 00:09:57,2011-08-23 00:08:16
80dd8182907314ae99f5572798c86176e2086c47...c4454d2efc144ed0ba2d1d8d3585932e58b869ae,2,6,1,7,2,2011-08-23 02:11:38,2011-08-23 02:06:42
c4454d2efc144ed0ba2d1d8d3585932e58b869ae...e3413f08fdcd0476cd9e0c2f934a6f7c6816c322,1,13,2,15,3,2011-08-23 09:31:22,2011-08-23 09:31:20
e3413f08fdcd0476cd9e0c2f934a6f7c6816c322...485d5b5dff42d6d597e4e3107d7eb55edbf0a1b3,4,152,1,153,42,2011-08-23 18:01:41,2011-08-12 18:09:34
485d5b5dff42d6d597e4e3107d7eb55edbf0a1b3...a916d888f2ea67e47e01d84500276c20149afea1,1,48,52,100,4,2011-08-23 20:19:17,2011-08-23 17:40:51
a916d888f2ea67e47e01d84500276c20149afea1...8a29e5ea5b5a4aabeb2bff1f47540efe5724139f,2,6,1,7,2,2011-08-23 20:19:17,2011-08-23 18:04:08
8a29e5ea5b5a4aabeb2bff1f47540efe5724139f...85f7b78e9beb467d9f89746b9dd03219aa224967,1,0,3,3,3,2011-08-23 20:19:17,2011-08-23 19:42:49
85f7b78e9beb467d9f89746b9dd03219aa224967...879eb16280688436d791ebb79b05198ac4e4b038,7,60,60,120,43,2011-08-23 21:10:35,2011-08-23 20:56:19
879eb16280688436d791ebb79b05198ac4e4b038...a7300c8297693e26d2504da4a2e5813453306cd9,5,43,44,87,24,2011-08-23 21:10:39,2011-08-23 21:08:53
a7300c8297693e26d2504da4a2e5813453306cd9...ea156359e941a671e1773c5cb9d4d46933618af8,1,1,1,2,1,2011-08-23 21:27:50,2011-08-23 21:24:50
ea156359e941a671e1773c5cb9d4d46933618af8...42529ddfb500cc7df3601c3b5f1d1da9f787d08e,2,7,6,13,5,2011-08-23 22:13:09,2011-08-23 22:13:07
42529ddfb500cc7df3601c3b5f1d1da9f787d08e...b15ab5de51e51d8f9dfaba8bcf4f62eee74ff721,35,870,979,1849,300,2011-08-23 22:17:57,2011-08-23 22:17:13
b15ab5de51e51d8f9dfaba8bcf4f62eee74ff721...8ec31a3362d016d6209694fb70639bf3d963e48b,1,1,1,2,2,2011-08-23 22:35:36,2011-08-23 17:39:23
8ec31a3362d016d6209694fb70639bf3d963e48b...4fa13152af92dd862f8f4b9ae0c207a9134e2ca5,1,13,2,15,1,2011-08-24 02:59:07,2011-08-24 02:58:47
4fa13152af92dd862f8f4b9ae0c207a9134e2ca5...4e1d6fca8e6801292213be9a06914fe088df6e64,113,341,2,343,115,2011-08-24 06:45:21,2011-08-24 06:42:23
4e1d6fca8e6801292213be9a06914fe088df6e64...06428d853cdf96dca5c0dddbedecb303173d2394,2,27,197,224,9,2011-08-24 06:45:46,2011-08-24 05:46:39
06428d853cdf96dca5c0dddbedecb303173d2394...19ff87a9db6a2494a63d902ad1ca0199c89ca147,1,66,0,66,1,2011-08-24 06:55:11,2011-08-24 06:14:56
19ff87a9db6a2494a63d902ad1ca0199c89ca147...cdbecc48a13c09973f82e77c1cad3b873f8203fa,1,51,4,55,6,2011-08-24 15:55:51,2011-08-12 21:31:17
cdbecc48a13c09973f82e77c1cad3b873f8203fa...7003d6eff56193aa6f2370cafb7f7bf10db243c7,4,4,5,9,4,2011-08-24 20:27:24,2011-08-23 16:26:39
7003d6eff56193aa6f2370cafb7f7bf10db243c7...28998a8cfe92043b27ff573b54258e21123616a4,42,6505,109,6614,131,2011-08-24 20:27:24,2011-08-23 00:34:43
28998a8cfe92043b27ff573b54258e21123616a4...2aefea5a2f9291303b64b74ba9144dcc9d6611f6,2,4,4,8,4,2011-08-24 20:27:24,2011-08-19 23:47:09
2aefea5a2f9291303b64b74ba9144dcc9d6611f6...9cb624986c6ed52f73c322bdb3c3a0338fc2a15a,1,4,2,6,1,2011-08-24 20:27:24,2011-08-23 23:47:02
9cb624986c6ed52f73c322bdb3c3a0338fc2a15a...cbd4033619cc45abdf878285c412bac9c3f36e4e,7,687,2,689,8,2011-08-24 20:27:24,2011-08-20 01:47:40
cbd4033619cc45abdf878285c412bac9c3f36e4e...11e3cfce8bb1ff7b5c80492e99403832a837fc60,1,47,10,57,14,2011-08-24 20:27:24,2011-08-24 00:57:48
11e3cfce8bb1ff7b5c80492e99403832a837fc60...bba432f00e0513faa124cdb0606fa050663e63ca,1,2,0,2,2,2011-08-24 20:27:25,2011-08-24 00:42:49
bba432f00e0513faa124cdb0606fa050663e63ca...48f4b2be2bc7867e0c043d3da71ee8af15aa8f87,1,6,73,79,7,2011-08-24 20:27:25,2011-08-24 01:50:55
48f4b2be2bc7867e0c043d3da71ee8af15aa8f87...251353810902a154ec49f6d34851557a54a2fd28,1,192,0,192,1,2011-08-24 20:27:25,2011-08-24 02:11:54
251353810902a154ec49f6d34851557a54a2fd28...2876141c4292791bc12c0b8701dbcc366dde7297,1,9,0,9,1,2011-08-24 20:43:05,2011-08-24 20:42:20
2876141c4292791bc12c0b8701dbcc366dde7297...52a40e0fd5f59b295fe9bb74e7f14b35ca4bf96c,2,9,1,10,2,2011-08-24 21:16:35,2011-08-24 21:16:35
52a40e0fd5f59b295fe9bb74e7f14b35ca4bf96c...accc34c50f0d380c6fceb67a0fab57b55fabba15,1,2,1,3,2,2011-08-24 22:18:39,2011-08-24 22:18:39
accc34c50f0d380c6fceb67a0fab57b55fabba15...8f245486aa86391a71786b541d47d4c950aef9bd,1,14,3,17,3,2011-08-24 22:46:55,2011-08-24 22:46:55
8f245486aa86391a71786b541d47d4c950aef9bd...f9dae9e8d6eb3c40a1d61cbae92d0ebe0e85a7d6,1,2,1,3,1,2011-08-24 22:55:57,2011-08-24 22:55:10
f9dae9e8d6eb3c40a1d61cbae92d0ebe0e85a7d6...06f750c46694b6f6a41ad9527db30a5490fe2273,2,3,2,5,3,2011-08-24 23:20:14,2011-08-24 23:20:08
06f750c46694b6f6a41ad9527db30a5490fe2273...48918f55037e61c41e37ee52030822535f25440d,1,14,3,17,3,2011-08-24 23:23:12,2011-08-24 23:23:04
48918f55037e61c41e37ee52030822535f25440d...90da5339c18214706043e85de4c913df83d2f46e,5,14,736,750,6,2011-08-25 00:43:33,2011-08-25 00:43:33
90da5339c18214706043e85de4c913df83d2f46e...64b41680fd064c8690e064210a8266f0b953dd16,1,40,0,40,3,2011-08-25 02:12:39,2011-08-15 16:35:48
64b41680fd064c8690e064210a8266f0b953dd16...576b11662e394ac0fa9bd23b6f2be3384073e99b,3,142,9,151,18,2011-08-25 22:23:17,2011-08-25 22:23:17
576b11662e394ac0fa9bd23b6f2be3384073e99b...6ab4a4c05c266342b3a43d419bc7dbff3adba010,3,175,27,202,22,2011-08-26 00:39:54,2011-08-26 00:39:54
6ab4a4c05c266342b3a43d419bc7dbff3adba010...43cdbec3be496cf542dee8818746ec896a756129,1,10,18,28,2,2011-08-26 14:57:36,2011-08-25 16:01:08
43cdbec3be496cf542dee8818746ec896a756129...5e765fe5e826f6d431b1309be08a964fcca0f673,2,34,13,47,15,2011-08-26 16:10:35,2011-08-26 16:10:35
5e765fe5e826f6d431b1309be08a964fcca0f673...16b3f2c3ff3eb75b15c95f8bef2b1b39a99ae3cd,1,17,1,18,1,2011-08-26 17:31:42,2011-08-25 22:22:43
16b3f2c3ff3eb75b15c95f8bef2b1b39a99ae3cd...8af0abde3fab7d5e8b64f42c26d3dec06b9bdc68,1,1,1,2,1,2011-08-26 17:31:42,2011-08-26 17:31:27
8af0abde3fab7d5e8b64f42c26d3dec06b9bdc68...028908ab7cc576d3013960a4580fcd9bf21cc26e,44,731,402,1133,246,2011-08-26 20:07:04,2011-08-26 20:07:04
df22ccb0de058bbd3d72c14ba4d89d917ad298e0...f145e35a93991afb7db98ed76453b5a77b14e2f4,1,2,2,4,2,2011-08-09 00:01:44,2011-08-09 00:01:38
f145e35a93991afb7db98ed76453b5a77b14e2f4...0df08c6a0c07a3ec0e63cd34886fafbd87dd3c3b,11,426,435,861,218,2011-08-09 00:01:57,2011-08-08 20:26:00
0df08c6a0c07a3ec0e63cd34886fafbd87dd3c3b...2126989a32f74dea0476c770f5dda826f12bc457,3,9,21,30,6,2011-08-09 00:12:26,2011-08-09 00:08:38
2126989a32f74dea0476c770f5dda826f12bc457...ab0b1f9f13ed507c6cafbfb4fe5164a7e470a9a3,1,2,2,4,2,2011-08-09 00:35:26,2011-08-09 00:35:26
ab0b1f9f13ed507c6cafbfb4fe5164a7e470a9a3...7332c4022f90995a2ff7d9b8822f86df64ff8164,1,12,0,12,5,2011-08-09 00:50:43,2011-08-09 00:50:23
7332c4022f90995a2ff7d9b8822f86df64ff8164...2689d262ec4b0daa5050c50873d89b00cf22b7a5,2,7,3,10,4,2011-08-09 02:04:34,2011-08-09 02:04:24
2689d262ec4b0daa5050c50873d89b00cf22b7a5...9e5cd012e2ee07d260136534ed005df8ddd5e9c2,2,102,99,201,7,2011-08-09 17:19:48,2011-08-09 17:19:48
9e5cd012e2ee07d260136534ed005df8ddd5e9c2...cbecd88199265376fba996d7f845384b6c7531f7,3,504,0,504,1,2011-08-09 19:25:26,2011-08-09 19:25:10
cbecd88199265376fba996d7f845384b6c7531f7...bf6b5299b49747bd11f367c48494bed1ea2ea262,5,56,210,266,29,2011-08-09 19:26:54,2011-08-09 19:26:44
bf6b5299b49747bd11f367c48494bed1ea2ea262...acc120a37b8684d4bb4ef570ad221aea3b908565,2,20,5,25,10,2011-08-09 20:55:04,2011-08-09 20:53:56
acc120a37b8684d4bb4ef570ad221aea3b908565...fd1fc5080f6526e28c090b446400924ba08a1ae0,1,3,0,3,1,2011-08-09 20:57:09,2011-08-09 20:56:18
fd1fc5080f6526e28c090b446400924ba08a1ae0...0696e78d6436c3a30803fe0e2bea42781691dc01,2,29,18,47,4,2011-08-09 21:20:06,2011-08-09 21:18:16
0696e78d6436c3a30803fe0e2bea42781691dc01...a8692a0154747b38f1715bb339a2de27ff7998c1,1,1,1,2,1,2011-08-09 21:54:31,2011-08-05 20:52:27
a8692a0154747b38f1715bb339a2de27ff7998c1...94db871ecfd454ec264ee6c42524f36f7a790679,1,1,1,2,1,2011-08-09 21:54:49,2011-08-05 22:22:54
94db871ecfd454ec264ee6c42524f36f7a790679...03a119eb70eecde859dab544401bd0e769478e01,1,3,5,8,6,2011-08-09 23:07:16,2011-08-09 23:06:32
03a119eb70eecde859dab544401bd0e769478e01...665a4e4a1d666e69bafa6ccef248b68cea326c41,1,1,1,2,1,2011-08-09 23:38:48,2011-08-09 23:38:48
665a4e4a1d666e69bafa6ccef248b68cea326c41...3b0f2cecffb9b4a8be63185394064adb989d5ac8,3,21,6,27,3,2011-08-10 00:43:57,2011-08-10 00:43:57
3b0f2cecffb9b4a8be63185394064adb989d5ac8...501b0b91be88dab5d7064b9fc3ff2719d8efb3f4,1,3,0,3,3,2011-08-10 00:46:29,2011-08-10 00:46:29
501b0b91be88dab5d7064b9fc3ff2719d8efb3f4...b3bc009a89d605ab89d28857d19fea0975040b58,2,4,1,5,3,2011-08-10 01:01:54,2011-08-10 00:59:26
b3bc009a89d605ab89d28857d19fea0975040b58...3ce4adf3c6bd73fcd8de93a5bbaf8bdb321d43af,1,0,1,1,1,2011-08-10 01:05:57,2011-08-10 01:05:50
3ce4adf3c6bd73fcd8de93a5bbaf8bdb321d43af...764dfbb1bf146d3a196483f90ec41934665d35b1,1,1,1,2,1,2011-08-10 02:23:44,2011-08-10 02:23:44
764dfbb1bf146d3a196483f90ec41934665d35b1...27ef0b0903e348cc10d0c5d2ee2ef25aa1676440,2,2,1,3,2,2011-08-10 02:30:31,2011-08-10 02:30:31
27ef0b0903e348cc10d0c5d2ee2ef25aa1676440...942f8b5afb10ee0f01f60e6c63974ca601027e17,2,36,3,39,8,2011-08-10 16:44:35,2011-07-30 14:03:05
942f8b5afb10ee0f01f60e6c63974ca601027e17...c96ef84427e7010f21e547bce12888323e12551d,2,1,2,3,2,2011-08-10 17:59:36,2011-08-10 17:54:36
c96ef84427e7010f21e547bce12888323e12551d...43da0e6fe475cfac382d2b0960bbb4275c168c6c,1,1,0,1,1,2011-08-10 17:59:37,2011-08-10 17:56:56
43da0e6fe475cfac382d2b0960bbb4275c168c6c...4983bd348dfe50538990badc7c73c48ca1c68e0b,3,14,7,21,4,2011-08-10 18:23:55,2011-08-10 18:22:58
4983bd348dfe50538990badc7c73c48ca1c68e0b...35d0df919a5fffdd702754789b458cbdad335c15,1,5,0,5,1,2011-08-10 18:32:37,2011-08-10 18:32:32
35d0df919a5fffdd702754789b458cbdad335c15...4f03f1beadc6d8ceffa3e30a94c00397c2a89cb2,1,2,0,2,1,2011-08-10 20:27:11,2011-08-10 20:27:05
4f03f1beadc6d8ceffa3e30a94c00397c2a89cb2...c171a0851a12f692bc28070fc08e61e6ba8acd02,1,1,0,1,1,2011-08-10 20:33:22,2011-08-10 20:33:22
c171a0851a12f692bc28070fc08e61e6ba8acd02...72c412767d66c0ba69b6b8b193a72618805a08a1,1,9,0,9,3,2011-08-10 21:09:39,2011-08-10 21:09:21
72c412767d66c0ba69b6b8b193a72618805a08a1...46b0654347eec229f7dac5ec350bb45aab25e05f,15,512,306,818,38,2011-08-10 21:23:26,2011-08-10 21:23:26
46b0654347eec229f7dac5ec350bb45aab25e05f...460614125be90a39c95aa252348e8d211735d6eb,2,23,16,39,7,2011-08-10 22:36:58,2011-08-10 21:59:21
460614125be90a39c95aa252348e8d211735d6eb...c4549b857364e736cdac8cad15aa7b49283daa90,2,9,9,18,7,2011-08-10 22:37:45,2011-08-10 22:36:22
c4549b857364e736cdac8cad15aa7b49283daa90...e62cdd048872432ed9bcf20c0af70f0c4cd02a5e,2,11,11,22,8,2011-08-10 23:40:16,2011-08-10 23:40:16
e62cdd048872432ed9bcf20c0af70f0c4cd02a5e...e6b06bc6c5393b31f3b45dbcd0deeb95271fc8b8,3,35,2,37,11,2011-08-11 00:15:13,2011-08-11 00:14:23
e6b06bc6c5393b31f3b45dbcd0deeb95271fc8b8...ef496dc39de1ee778db71fc116fe7ed3bdb670eb,3,3,0,3,3,2011-08-11 00:46:02,2011-08-11 00:46:02
ef496dc39de1ee778db71fc116fe7ed3bdb670eb...fcf9cfa1374bbbc0e77dd77908b55d45d7735450,1,7,0,7,1,2011-08-11 00:47:43,2011-08-11 00:47:43
fcf9cfa1374bbbc0e77dd77908b55d45d7735450...74e8fa2e577c628734bd2d47357d64a6334ab0ed,2,75,26,101,13,2011-08-11 02:38:41,2011-08-11 02:00:39
74e8fa2e577c628734bd2d47357d64a6334ab0ed...b9d777734d0db37f3f38e5996bc62e0dbf9482c0,4,5,8,13,5,2011-08-11 02:52:33,2011-08-11 01:45:56
b9d777734d0db37f3f38e5996bc62e0dbf9482c0...f52a8db280512befb69eecfef8c65bdea48ffcd0,1,2,2,4,2,2011-08-11 14:26:01,2011-08-11 13:57:03
f52a8db280512befb69eecfef8c65bdea48ffcd0...79f064f565abdbdb09b8f394250e02cf2e2ff729,3,20,3,23,5,2011-08-11 15:51:03,2011-08-11 15:41:30
79f064f565abdbdb09b8f394250e02cf2e2ff729...3d4ae3ab4dfa4790ff3eefd1990ae08e7b1d3e97,1,5,3,8,1,2011-08-11 17:44:20,2011-08-11 17:44:20
3d4ae3ab4dfa4790ff3eefd1990ae08e7b1d3e97...eb09b0644b3cb910d318d1d2a80cd2215b63cdcc,1,1,0,1,1,2011-08-11 21:39:38,2011-08-11 21:39:38
eb09b0644b3cb910d318d1d2a80cd2215b63cdcc...ac4791393edd56e46a54b93ed8349eef7b7e1801,2,7,2,9,2,2011-08-11 22:36:02,2011-08-11 22:30:56
ac4791393edd56e46a54b93ed8349eef7b7e1801...3cd694c9f3724abf61480bf98209f848102e7d7e,1,1,0,1,1,2011-08-11 23:10:41,2011-08-11 23:10:41
3cd694c9f3724abf61480bf98209f848102e7d7e...3a219de5867477d7954dd321d4f57949b499fe6f,1,3,1,4,1,2011-08-12 00:25:54,2011-08-11 23:41:53
3a219de5867477d7954dd321d4f57949b499fe6f...2c11718d79bcb63615741f2b5512e133f107a772,1,15,0,15,4,2011-08-12 00:25:55,2011-08-11 23:42:14
2c11718d79bcb63615741f2b5512e133f107a772...fb7faefbf53f2e27aa2e9cf9dbd88163eeaefb38,3,25,6,31,17,2011-08-12 00:25:55,2011-08-11 23:46:26
fb7faefbf53f2e27aa2e9cf9dbd88163eeaefb38...89bed195134317a10e6ffffe23a90473790f0a7f,103,3961,2071,6032,641,2011-08-12 06:59:21,2011-08-12 06:59:21
89bed195134317a10e6ffffe23a90473790f0a7f...6c614fe585dea5a822f3759121536afcc30f5a1b,12,267,16,283,30,2011-08-12 08:14:46,2011-08-12 08:14:04
6c614fe585dea5a822f3759121536afcc30f5a1b...cfba1f59224ff8602c3fe9145181cad4c6df89a9,4,34,9,43,7,2011-08-12 08:17:05,2011-08-12 07:46:39
cfba1f59224ff8602c3fe9145181cad4c6df89a9...5b58473b4060094b07b4cbd1a7e77ea2338773d5,1,2,2,4,1,2011-08-12 09:15:19,2011-08-12 09:15:19
5b58473b4060094b07b4cbd1a7e77ea2338773d5...fa378ee4d8c431ac1312b8a1dd12681d59d8e1c3,2,14,2,16,2,2011-08-12 13:22:56,2011-08-09 14:26:42
fa378ee4d8c431ac1312b8a1dd12681d59d8e1c3...3cac57658fc613edad10d6772c331a39b99dc404,1,70,0,70,1,2011-08-12 13:23:29,2011-08-08 20:56:26
3cac57658fc613edad10d6772c331a39b99dc404...a002f4f4531eafaa2a5bb5d446616528e151dfc1,1,1,0,1,1,2011-08-12 13:46:44,2011-08-12 13:46:44
a002f4f4531eafaa2a5bb5d446616528e151dfc1...b7c23ac3f5e550e272d3695bf7076343e2d79c79,11,595,499,1094,258,2011-08-12 13:49:57,2011-08-09 04:40:10
b7c23ac3f5e550e272d3695bf7076343e2d79c79...01b64fc36bc18e22b10721e5fd5b01e4cc27f222,1,3,6,9,2,2011-08-12 14:14:58,2011-08-12 14:14:46
01b64fc36bc18e22b10721e5fd5b01e4cc27f222...04122ad2d389403cc4c453098ea0397414dcea39,4,149,0,149,6,2011-08-12 14:23:11,2011-08-11 09:40:55
04122ad2d389403cc4c453098ea0397414dcea39...7cab4d6870b67cbcf9dd994a56a9edc89ad9ba37,4,800,0,800,5,2011-08-12 16:42:24,2011-07-26 21:20:29
7cab4d6870b67cbcf9dd994a56a9edc89ad9ba37...83b211ecb2a4940f4fd327313370f41c8acc0b64,1,1,0,1,1,2011-08-12 16:42:24,2011-07-26 21:38:25
83b211ecb2a4940f4fd327313370f41c8acc0b64...efcbe3b21a3504cb2fb8516b3e324aa23c8bbc6a,1,5,0,5,3,2011-08-12 16:42:24,2011-07-27 02:34:28
efcbe3b21a3504cb2fb8516b3e324aa23c8bbc6a...47265046632a64fcd2f7c9e50e3c2caa598f51e7,3,45,0,45,3,2011-08-12 16:42:24,2011-07-27 03:08:47
47265046632a64fcd2f7c9e50e3c2caa598f51e7...cbea40eaf27349b0dbe2c8cbbe37cde9af2bb0d3,1,5,5,10,5,2011-08-12 16:52:06,2011-08-12 16:52:06
cbea40eaf27349b0dbe2c8cbbe37cde9af2bb0d3...97b0000c536746d05a9b1d776d29ba9d2868c54e,1,1,0,1,1,2011-08-12 16:58:54,2011-08-12 16:57:04
97b0000c536746d05a9b1d776d29ba9d2868c54e...a38bda9fb279c6dd01f9b8b7e55f9f60832e9721,1,1,1,2,1,2011-08-12 17:17:05,2011-07-30 18:06:46
a38bda9fb279c6dd01f9b8b7e55f9f60832e9721...c0d8311f6b86ef35cdb0b233f3c3d2b83c4a3381,1,1,1,2,1,2011-08-13 17:51:35,2011-08-13 17:45:38
c0d8311f6b86ef35cdb0b233f3c3d2b83c4a3381...59b815b0977e818bc1967a452e1a2082d1c7dc5f,1,13,0,13,1,2011-08-13 21:51:31,2011-08-13 21:51:31
59b815b0977e818bc1967a452e1a2082d1c7dc5f...eaac88163a4844b9efadce39cd33ac3310c7a043,1,5,1,6,3,2011-08-13 23:25:39,2011-08-13 23:25:39
eaac88163a4844b9efadce39cd33ac3310c7a043...bfc2982f10701651c2fda92a9be051d89b0f99f4,2,6,15,21,4,2011-08-14 01:15:12,2011-08-14 01:15:12
bfc2982f10701651c2fda92a9be051d89b0f99f4...a5d90c435cb7af5fafe5b370e412e1b965d24114,1,3,3,6,3,2011-08-14 02:10:42,2011-08-13 21:22:52
a5d90c435cb7af5fafe5b370e412e1b965d24114...16788f461aedaca7eb7fc658b6b115ac8a3f5d62,13,564,533,1097,38,2011-08-14 02:57:42,2011-08-13 18:17:47
16788f461aedaca7eb7fc658b6b115ac8a3f5d62...972872350818b4f2e8cc260ce6715ab14b3843d6,1,2,2,4,2,2011-08-15 00:30:35,2011-08-15 00:30:35
972872350818b4f2e8cc260ce6715ab14b3843d6...54b409d6508f926d2f122cac2bf449b37d5b7fe7,2,35,9,44,2,2011-08-15 15:22:48,2011-08-15 15:17:33
54b409d6508f926d2f122cac2bf449b37d5b7fe7...25a5e90289965d60f8aad5138b1321ce267c2242,3,172,172,344,4,2011-08-15 20:41:07,2011-08-15 20:40:17
25a5e90289965d60f8aad5138b1321ce267c2242...66f77963a368f8696c26db7b42e510fc0b2aebbf,21,1467,563,2030,137,2011-08-15 20:49:15,2011-08-15 20:48:20
66f77963a368f8696c26db7b42e510fc0b2aebbf...721f26520d7781e0ffe8a94d531b8c1a76118a8d,1,4,8,12,3,2011-08-15 22:47:18,2011-08-15 22:47:16
721f26520d7781e0ffe8a94d531b8c1a76118a8d...584ae7b08477fba93be4b77cb1e1511f40c95fdf,4,23,161,184,6,2011-08-15 23:24:41,2011-08-03 22:06:16
584ae7b08477fba93be4b77cb1e1511f40c95fdf...b433c42a566259525487e60b128e34b32c3eecc5,2,7,0,7,2,2011-08-16 01:17:02,2011-08-16 00:54:47
b433c42a566259525487e60b128e34b32c3eecc5...e57ed540e638da67259f59fede9dd43da920cf3b,1,2,1,3,1,2011-08-16 01:18:21,2011-08-16 01:18:14
e57ed540e638da67259f59fede9dd43da920cf3b...72246d97a243549c337ad91ab9c113ea7716a83e,1,3,2,5,2,2011-08-16 01:26:48,2011-08-16 01:26:48
72246d97a243549c337ad91ab9c113ea7716a83e...c05936ca13681059c7aeecfe3a608e4e1afa800a,3,52,1,53,3,2011-08-16 12:50:04,2011-06-02 19:45:30
c05936ca13681059c7aeecfe3a608e4e1afa800a...8293bb8a3277b23431766fd91c34ea6a163eba1c,26,159,146,305,54,2011-08-16 14:59:57,2011-08-14 06:02:14
8293bb8a3277b23431766fd91c34ea6a163eba1c...4cf931db1736a73717f4e6b9f11c3450de8606c6,2,103,0,103,3,2011-08-16 15:19:55,2011-08-14 07:56:41
4cf931db1736a73717f4e6b9f11c3450de8606c6...d72c6940f8b339a073979129fcc5a8cd3623aa2d,1,10,3,13,3,2011-08-17 18:39:20,2011-08-17 18:39:20
fdbfc9ceb7383ab3481b75b3071af67c348875b2...8b2a3354f9674c4e05a669e9b741340f1c37c167,2,53,9,62,12,2011-09-14 14:07:37,2011-09-14 14:07:33
8b2a3354f9674c4e05a669e9b741340f1c37c167...5724b54d2e19b6d061a75ecd727ba7ce7eaa185b,1,59,0,59,1,2011-09-14 14:29:32,2011-09-14 14:29:32
5724b54d2e19b6d061a75ecd727ba7ce7eaa185b...98990b97798f2bd46416df03f6f8b8a192feb9b9,3,20,3,23,6,2011-09-15 16:46:30,2011-09-15 16:46:30
98990b97798f2bd46416df03f6f8b8a192feb9b9...b3af074a0258aa6694bec8eabfc04d2871be57b9,1,4,3,7,1,2011-09-15 16:52:49,2011-09-15 16:52:49
b3af074a0258aa6694bec8eabfc04d2871be57b9...e06ce7562ca568ca9fa8072fbd554da4d20dc779,4,16,7,23,7,2011-09-15 17:54:08,2011-09-15 17:38:25
f1996ffebc79148b94dab4cb6e7eceecf6e17554...7d38a3b81c82269cbec877b3ea9a827dbee044fd,1,1,1,2,1,2011-08-26 20:20:27,2011-08-26 20:20:27
7d38a3b81c82269cbec877b3ea9a827dbee044fd...790f13df9c683c547c6eb27312bb928f2c10eef9,1,1,1,2,1,2011-08-26 20:38:45,2011-08-26 20:38:45
790f13df9c683c547c6eb27312bb928f2c10eef9...d2d53d4bb262f517a227cc178a1648094ba54c20,4,53,9,62,7,2011-08-26 21:24:18,2011-08-26 21:24:18
d2d53d4bb262f517a227cc178a1648094ba54c20...8342f31af91a709001c7f1a90d218278eaac9e07,1,2,2,4,1,2011-08-26 23:27:52,2011-08-26 23:27:52
8342f31af91a709001c7f1a90d218278eaac9e07...779c93c5232e9398117c5c399c0f197139f6bf3c,3,57,21,78,17,2011-08-27 00:06:01,2011-08-26 22:04:47
779c93c5232e9398117c5c399c0f197139f6bf3c...186364e24f5c6ddc22cb95c4775422730993e0cc,1,2,2,4,1,2011-08-27 02:55:25,2011-08-27 01:34:09
186364e24f5c6ddc22cb95c4775422730993e0cc...a4eee3d28fe2b6c944ae4f40caeaec0efa85f2dc,2,0,8,8,2,2011-08-28 21:47:10,2011-08-01 17:39:15
a4eee3d28fe2b6c944ae4f40caeaec0efa85f2dc...d2defa3012a5448a16a6cdab276a64f7bbd367e0,1,52,0,52,1,2011-08-28 21:49:24,2011-08-12 19:20:24
d2defa3012a5448a16a6cdab276a64f7bbd367e0...b5643cb2a62a5bfddb5be29e74fdf4c0206e1234,1,0,1,1,1,2011-08-29 14:00:48,2011-08-29 10:47:00
b5643cb2a62a5bfddb5be29e74fdf4c0206e1234...1a0edbca863f0071c5dc89504e10f99df28f8cd7,1,2,4,6,1,2011-08-29 16:20:58,2011-08-16 17:12:54
1a0edbca863f0071c5dc89504e10f99df28f8cd7...7c87e092fb97ab293e19b21a8b07f622c80c68b3,1,128,128,256,14,2011-08-29 19:22:19,2011-08-28 22:51:40
7c87e092fb97ab293e19b21a8b07f622c80c68b3...b5144b245b2b82ca430074da6bbbf2c848f19787,1,1,1,2,1,2011-08-29 19:26:58,2011-08-28 22:06:40
b5144b245b2b82ca430074da6bbbf2c848f19787...ff7f7ae386a1097de7ebdfad3439cd5cf7456b4f,1,3,11,14,4,2011-08-29 21:01:41,2011-08-29 21:01:05
ff7f7ae386a1097de7ebdfad3439cd5cf7456b4f...59fa16f648aea51c880fac46abb1817e61d0675e,20,1958,54,2012,51,2011-08-29 22:23:20,2011-08-29 22:23:13
59fa16f648aea51c880fac46abb1817e61d0675e...da00ff4999bd26e2c17df1f84d090d3b3296e043,74,2626,2021,4647,476,2011-08-29 22:47:16,2011-08-29 22:29:35
da00ff4999bd26e2c17df1f84d090d3b3296e043...1088638725aaa72b971cc6f822b9d0f11fbf68c4,196,487,35809,36296,256,2011-08-30 08:35:54,2011-08-30 07:59:56
1088638725aaa72b971cc6f822b9d0f11fbf68c4...bce41fac9458dd3dec844fc80c8144060e6a9f30,10,128,849,977,88,2011-08-30 08:36:10,2011-08-28 09:23:17
bce41fac9458dd3dec844fc80c8144060e6a9f30...2823ab47dc4a1393d5d691d7ba078b63960a6309,1,43,0,43,1,2011-08-30 08:59:38,2011-08-30 08:59:38
2823ab47dc4a1393d5d691d7ba078b63960a6309...b68c6bac96a480fe210220335bc685e89a927d2b,1,1,1,2,1,2011-08-30 09:26:29,2011-08-30 09:26:22
b68c6bac96a480fe210220335bc685e89a927d2b...fe4b7420a3e1d31d92f1c2fc03d89682bba0091b,2,31,18,49,7,2011-08-30 11:09:47,2011-08-30 11:09:47
fe4b7420a3e1d31d92f1c2fc03d89682bba0091b...80390864700567084b383c2cf026d8de64f589aa,1,6,6,12,6,2011-08-30 13:17:05,2011-08-29 22:21:37
80390864700567084b383c2cf026d8de64f589aa...6b6f2b1d2ca3104bcfe5d37dc67d65f3c0985fd8,1,0,29,29,1,2011-08-30 15:52:49,2011-08-30 15:35:16
6b6f2b1d2ca3104bcfe5d37dc67d65f3c0985fd8...d8f7a8655f78861e138866f4e8d2ae24482f3056,3,3,5,8,5,2011-08-30 16:44:19,2011-08-30 16:42:54
d8f7a8655f78861e138866f4e8d2ae24482f3056...6f606838025c4e87701f360135f1ae72e968dc4c,4,112,20,132,12,2011-08-30 18:47:23,2011-08-26 11:00:40
6f606838025c4e87701f360135f1ae72e968dc4c...21cc4c4985fdf40cc128cd88cfdc02fd49e33b26,146,2151,1687,3838,1388,2011-08-31 08:53:30,2011-08-31 08:53:01
21cc4c4985fdf40cc128cd88cfdc02fd49e33b26...f013f15c8916a1e3a65a99f99a512fa51e440642,1,4,4,8,3,2011-08-31 17:09:44,2011-08-31 11:03:47
f013f15c8916a1e3a65a99f99a512fa51e440642...8d70cc607cafc4c8caecd1d59727d2b2ab3fe550,1,1,2,3,1,2011-08-31 17:26:34,2011-08-31 13:29:37
8d70cc607cafc4c8caecd1d59727d2b2ab3fe550...c91ec225e607e000c289e2e3bcc6e4450a76685a,16,3281,3009,6290,52,2011-08-31 22:59:36,2011-08-31 22:38:02
c91ec225e607e000c289e2e3bcc6e4450a76685a...84cf0c52802906cc4d0491f55ad449bdc9920823,1,1,1,2,2,2011-08-31 23:11:08,2011-08-31 23:11:00
84cf0c52802906cc4d0491f55ad449bdc9920823...cf24f561a34a12d527560765e34244ad3cffb22e,1,5,1,6,1,2011-09-01 15:15:07,2011-09-01 00:58:00
cf24f561a34a12d527560765e34244ad3cffb22e...3efcbadf6b611b48ee9abad34dcecbf9388ec8da,6,135,47,182,23,2011-09-01 21:16:04,2011-09-01 21:16:00
3efcbadf6b611b48ee9abad34dcecbf9388ec8da...65c27638ec6195b0a5d35f47bceec5777e7ca551,1,33,5,38,4,2011-09-01 21:56:32,2011-08-31 12:33:40
65c27638ec6195b0a5d35f47bceec5777e7ca551...2b0a7d63a8c728cb95896a847dcd0dcfc3172d1a,3,156,209,365,22,2011-09-02 00:44:06,2011-09-02 00:44:06
2b0a7d63a8c728cb95896a847dcd0dcfc3172d1a...44574bc39b93c96d9bd15e79757cf2eec501ac3a,1,2,5,7,1,2011-09-02 15:29:20,2011-08-31 06:13:45
44574bc39b93c96d9bd15e79757cf2eec501ac3a...cafcc7e67a46fda9006cceeec516cd289c107f04,1,35,0,35,1,2011-09-02 15:29:33,2011-09-01 20:12:37
cafcc7e67a46fda9006cceeec516cd289c107f04...7b2536a1a2b4a83d1e75855896c6a35fda227569,2,47,0,47,4,2011-09-02 15:49:37,2011-08-30 20:46:07
7b2536a1a2b4a83d1e75855896c6a35fda227569...b7e36f85844789c8ceb2a39bbdc9783d4768a2d4,3,142,0,142,3,2011-09-02 15:49:37,2011-08-30 20:46:48
b7e36f85844789c8ceb2a39bbdc9783d4768a2d4...5ded5e274f8a9d6a836d5ff8346510a5d1418e59,1,20,16,36,2,2011-09-02 15:49:37,2011-08-30 21:47:21
5ded5e274f8a9d6a836d5ff8346510a5d1418e59...28a908471d9d1b6bcf19da207ebc10e1cfbcf183,2,11,20,31,11,2011-09-02 15:53:47,2011-08-31 16:57:11
28a908471d9d1b6bcf19da207ebc10e1cfbcf183...c28f20f8804a8754a39515fbb4dd17eb2225981b,1,3,24,27,1,2011-09-02 16:46:53,2011-09-02 16:36:56
c28f20f8804a8754a39515fbb4dd17eb2225981b...197628846dd4c9a281b60fc8a18cb4059511367d,3,3,0,3,3,2011-09-02 19:53:20,2011-09-02 19:53:16
197628846dd4c9a281b60fc8a18cb4059511367d...3bf20e43cf5c18a81337a66da15241f10885c59a,1,1,1,2,1,2011-09-02 20:01:05,2011-09-02 19:53:49
3bf20e43cf5c18a81337a66da15241f10885c59a...087d2106797ff7de7f811ad5a820ba8110f64241,1,14,0,14,1,2011-09-03 01:29:49,2011-09-01 18:23:17
087d2106797ff7de7f811ad5a820ba8110f64241...0df8ffe4728828c24a05b989007b5cc9bba1e365,8,276,36,312,41,2011-09-04 00:31:12,2011-09-04 00:31:12
0df8ffe4728828c24a05b989007b5cc9bba1e365...ee048aa3abc85aff85aee5805cee900be4a2434c,1,3,0,3,3,2011-09-04 00:44:54,2011-09-03 06:54:13
ee048aa3abc85aff85aee5805cee900be4a2434c...a3d7782c08a9ef6016b97cac11cfdc93b669bde3,1,1,12,13,12,2011-09-04 00:45:22,2011-09-03 18:24:32
a3d7782c08a9ef6016b97cac11cfdc93b669bde3...29e929de1eb7aa44ef37b7ccb027b6956f2d6116,1,5,5,10,3,2011-09-04 02:11:54,2011-09-04 01:41:12
29e929de1eb7aa44ef37b7ccb027b6956f2d6116...908ee33f2d7f0564d5e8160d2827fe9ec5ea109d,1,3,0,3,1,2011-09-04 15:26:05,2011-08-25 17:03:07
908ee33f2d7f0564d5e8160d2827fe9ec5ea109d...bc0a552a846bae78040cc15827a6099b579a4401,1,1,3,4,3,2011-09-04 15:48:35,2011-09-04 15:38:34
bc0a552a846bae78040cc15827a6099b579a4401...766430c7430502a8c81f677dd5951c5967adb93e,1,5,0,5,1,2011-09-04 17:27:04,2011-08-30 02:39:51
766430c7430502a8c81f677dd5951c5967adb93e...cb1a21b1d405312f8e5797039757b05a9733f569,15,257,130,387,55,2011-09-04 20:25:40,2011-09-04 20:25:40
cb1a21b1d405312f8e5797039757b05a9733f569...c82ab45ee6deab6b87dad0c6d08766417280952d,2,6,6,12,2,2011-09-04 20:53:01,2011-09-04 20:53:01
c82ab45ee6deab6b87dad0c6d08766417280952d...3742aeea4c6b0b18491cc80f940be28dfd301492,1,4,1,5,2,2011-09-04 20:54:24,2011-09-04 20:54:24
3742aeea4c6b0b18491cc80f940be28dfd301492...17021ea631dc1eb249f22035a79b7e63402dfa8c,12,621,69,690,66,2011-09-04 23:17:00,2011-09-04 23:13:03
17021ea631dc1eb249f22035a79b7e63402dfa8c...d01b87d9c44bda6f90b921ff30ca32c37c56bb98,1,12,1,13,2,2011-09-05 00:10:12,2011-09-04 22:35:42
d01b87d9c44bda6f90b921ff30ca32c37c56bb98...ae2ac4fb1b5bde8ceb0106590eb98da478d92bb5,1,48,46,94,3,2011-09-05 00:10:12,2011-09-04 23:01:53
ae2ac4fb1b5bde8ceb0106590eb98da478d92bb5...e20d0c1cd09000169e9023a12a1d5427f8341245,3,59,7,66,8,2011-09-05 00:10:14,2011-09-05 00:09:24
e20d0c1cd09000169e9023a12a1d5427f8341245...01bf209a3d8e89143739a0a9c5b4c523fb28e383,2,17,2,19,6,2011-09-05 00:17:00,2011-09-05 00:16:07
01bf209a3d8e89143739a0a9c5b4c523fb28e383...b5d58f11cb9e5a56a590631a8b87a5b99e942365,1,5,1,6,1,2011-09-05 01:30:12,2011-09-05 01:30:12
b5d58f11cb9e5a56a590631a8b87a5b99e942365...7272dbdbc60d03d264f33c4119e76561757a4801,4,141,12,153,29,2011-09-05 01:48:19,2011-09-05 01:16:33
7272dbdbc60d03d264f33c4119e76561757a4801...f5e486ebabc7c9faeeec126946b0a396426166f0,2,11,6,17,6,2011-09-05 01:48:19,2011-09-05 01:46:37
f5e486ebabc7c9faeeec126946b0a396426166f0...39ea27470c28df19a6e1125da8e4adc42062a4fc,2,27,16,43,13,2011-09-05 02:44:01,2011-09-05 02:44:01
39ea27470c28df19a6e1125da8e4adc42062a4fc...fcfec075e3201d5ed0dbfa3b6571d0ca9b5702d0,1,5,5,10,5,2011-09-05 02:48:55,2011-09-05 02:48:55
fcfec075e3201d5ed0dbfa3b6571d0ca9b5702d0...ef523e5719f52f7a9ea7bb091da0175593d61dfc,1,3,3,6,3,2011-09-05 05:14:03,2011-09-05 05:13:01
ef523e5719f52f7a9ea7bb091da0175593d61dfc...ece5c6450425ee6e08d96117e3b1e1cfd4414715,3,68,78,146,52,2011-09-05 07:32:15,2011-09-05 07:32:15
ece5c6450425ee6e08d96117e3b1e1cfd4414715...061811f3284d306598a50cbfddc1c5b35d9b31cb,1,1,0,1,1,2011-09-05 21:40:30,2011-09-05 21:40:30
061811f3284d306598a50cbfddc1c5b35d9b31cb...de978991d8dc11843a4d11ab438f53aea18d2526,1,12,5,17,5,2011-09-05 22:36:41,2011-07-31 20:19:36
de978991d8dc11843a4d11ab438f53aea18d2526...554dc63328deb35ccbde1aadc6d776200fbc317f,12,141,47,188,33,2011-09-06 00:15:08,2011-09-05 22:24:39
554dc63328deb35ccbde1aadc6d776200fbc317f...2d9ab49239d475cad3126384daefc6f365555dd9,3,66,4,70,4,2011-09-06 00:15:08,2011-09-06 00:03:43
2d9ab49239d475cad3126384daefc6f365555dd9...8153a216137728bdb3942d70f4aa52d4644b2ad2,2,73,21,94,10,2011-09-06 02:47:36,2011-09-06 02:46:44
8153a216137728bdb3942d70f4aa52d4644b2ad2...94b0481a5661e8d34955a33b50bfbbfe46e93469,6,278,53,331,33,2011-09-06 14:14:14,2011-09-06 14:14:14
94b0481a5661e8d34955a33b50bfbbfe46e93469...56efe9cbc5660b5b9bfa22d5ee64f186fa367b87,1,11,5,16,3,2011-09-06 14:34:21,2011-09-06 14:30:48
56efe9cbc5660b5b9bfa22d5ee64f186fa367b87...d0552949b97f4819a7b22c93858c1ee7d6fd4377,1,1,1,2,1,2011-09-06 15:03:52,2011-09-05 19:15:18
d0552949b97f4819a7b22c93858c1ee7d6fd4377...fb93ab4125362271d9e5eda07179cb725b90779d,1,7,0,7,1,2011-09-06 15:04:00,2011-09-05 19:16:00
fb93ab4125362271d9e5eda07179cb725b90779d...4cf0ce5bb4c20ed7e145785988d9be56671a0c69,9,83,46,129,45,2011-09-06 16:19:41,2011-08-31 13:12:34
4cf0ce5bb4c20ed7e145785988d9be56671a0c69...b66d225c6eb17cf0bd97da2e3d502cd0c0c05cb8,1,1,1,2,1,2011-09-06 21:11:17,2011-09-06 21:11:14
b66d225c6eb17cf0bd97da2e3d502cd0c0c05cb8...eb99083d0bbca437e62d0959ca8dd0cb73bb04fa,4,186,0,186,6,2011-09-07 18:01:14,2011-08-29 18:09:01
eb99083d0bbca437e62d0959ca8dd0cb73bb04fa...638773628cf8568025d51fd9582ed11a5866be28,1,7,15,22,4,2011-09-07 18:02:14,2011-09-07 15:29:34
e06ce7562ca568ca9fa8072fbd554da4d20dc779...6312e889b1cd76fb5089056fd80f335319ad103e,1,12,1,13,2,2011-09-15 22:04:09,2011-09-15 21:56:12
52044fd1b158b91304a4641eaf893f9fe225ea67...526c54c9790cd8edff259686785d7b844fd29005,2,3,0,3,2,2011-09-08 02:47:32,2011-09-08 02:47:32
526c54c9790cd8edff259686785d7b844fd29005...0bca54444a5bb869ddebaadc65cd0bf381bb1e81,213,5390,2908,8298,1243,2011-09-08 04:23:29,2011-09-08 02:22:41
0bca54444a5bb869ddebaadc65cd0bf381bb1e81...ee2c12d48e52c066c74fd646d6a38e880b0bfa0a,7,442,232,674,100,2011-09-08 08:11:45,2011-09-08 08:11:08
ee2c12d48e52c066c74fd646d6a38e880b0bfa0a...98b64422bbc30205a3152940fc93ad4bfde8234a,1,210,188,398,33,2011-09-08 15:53:37,2011-09-08 12:00:02
98b64422bbc30205a3152940fc93ad4bfde8234a...6139459d45f4205553c889682ac9c9361e3e2a5f,2,37,4,41,4,2011-09-08 15:57:42,2011-09-08 15:20:01
6139459d45f4205553c889682ac9c9361e3e2a5f...bb3a1d5b675511fdd287009e01430fc96f286cd0,2,59,1,60,2,2011-09-08 18:47:16,2011-09-08 11:46:57
bb3a1d5b675511fdd287009e01430fc96f286cd0...4527de8cba3bf5f107fcefcf43dbdaa308881ba4,3,74,22,96,13,2011-09-08 18:59:21,2011-09-08 11:42:44
6312e889b1cd76fb5089056fd80f335319ad103e...771ba34ca7b839add2ef96879e1ffc684813cf7c,4,36,13,49,9,2011-09-15 23:46:39,2011-09-15 23:46:39
771ba34ca7b839add2ef96879e1ffc684813cf7c...cfe0f4226bb1d14be0e4658a1a5cb602e38267a6,1,2,2,4,1,2011-09-16 00:31:35,2011-09-16 00:31:35
cfe0f4226bb1d14be0e4658a1a5cb602e38267a6...b31d5ac639a60139a31f0fc8124210c3a7a677ab,1,1,1,2,1,2011-09-16 00:49:29,2011-09-16 00:49:29
b31d5ac639a60139a31f0fc8124210c3a7a677ab...ed44098cf69307e79d9e2efc7a06c402f24fb861,1,1,1,2,1,2011-09-16 15:55:54,2011-09-16 15:54:28
ed44098cf69307e79d9e2efc7a06c402f24fb861...b93a7cc99e0251a2bfc2e4851b833faac49260d2,1,2,2,4,2,2011-09-20 06:50:36,2011-09-20 06:50:36
b93a7cc99e0251a2bfc2e4851b833faac49260d2...97d355c273583ec6226ab3f4f49bc909164bf801,2,13,1,14,3,2011-09-21 12:08:53,2011-09-15 21:22:05
97d355c273583ec6226ab3f4f49bc909164bf801...9ef962f9ee82f1d0610795f8ed28d82f2f6d04fc,1,1,1,2,1,2011-09-22 04:16:34,2011-09-16 17:16:30
9ef962f9ee82f1d0610795f8ed28d82f2f6d04fc...3a9b08f15651037cfeda2c515bb974990fec1f15,1,16,14,30,5,2011-09-22 04:16:42,2011-09-19 20:24:43
3a9b08f15651037cfeda2c515bb974990fec1f15...fdb0eb5825f31c03874a613f9d02d044870b609e,1,1,1,2,1,2011-09-22 04:16:47,2011-09-20 23:11:07
fdb0eb5825f31c03874a613f9d02d044870b609e...93aad553425d238233e77df20f71b2e06def5600,1,1,0,1,1,2011-09-22 04:16:53,2011-09-20 23:57:36
93aad553425d238233e77df20f71b2e06def5600...f6bce20e5e4e1fb26b1a35661c278f0b65569900,2,25,3,28,5,2011-09-24 16:31:56,2011-09-24 03:07:35
f6bce20e5e4e1fb26b1a35661c278f0b65569900...f9fec3a2d65580b7e39edc9afd5904cd4775c87c,1,3,1,4,1,2011-09-24 22:23:27,2011-09-24 04:05:40
f9fec3a2d65580b7e39edc9afd5904cd4775c87c...aff91f79aee2091eb2c92c679b09d4ba5496a865,1,2,0,2,1,2011-09-25 01:59:50,2011-09-25 01:31:39
aff91f79aee2091eb2c92c679b09d4ba5496a865...942b92a06e8adafc47a3fc0b01a2815797248b76,1,2,2,4,2,2011-09-25 01:59:50,2011-09-25 01:32:45
942b92a06e8adafc47a3fc0b01a2815797248b76...dea49e3d1900ffdc56a2077d1d701ec9e38bc58b,2,70,6,76,3,2011-09-29 00:49:33,2011-09-29 00:43:20
dea49e3d1900ffdc56a2077d1d701ec9e38bc58b...3fc01d9770058aaaf1bc09879f02bd277aaf2035,1,4,0,4,1,2011-09-29 10:50:25,2011-09-29 07:53:36
3fc01d9770058aaaf1bc09879f02bd277aaf2035...49ac083dc18529e9ac2e098b432ba2d5c7e5cc85,1,78,0,78,1,2011-09-30 06:44:13,2011-09-27 09:24:38
49ac083dc18529e9ac2e098b432ba2d5c7e5cc85...4cdf9d415864f124c3b17bf43731e40120f18ba0,1,41,7,48,4,2011-09-30 06:44:45,2011-09-27 09:25:10
4cdf9d415864f124c3b17bf43731e40120f18ba0...007ddcd2cd28da1ad057c11e96d30b53a9cf567d,1,0,0,0,0,2011-09-30 17:31:39,2011-09-30 16:57:08
007ddcd2cd28da1ad057c11e96d30b53a9cf567d...eb40dcb0974bbf845a9dae853524452b95da3bd9,1,1,1,2,1,2011-10-09 07:51:42,2011-10-08 12:00:43
eb40dcb0974bbf845a9dae853524452b95da3bd9...ff942c6b39d06e81d82c30bc91a159a0440b6d9b,1,2,1,3,1,2011-10-10 18:47:10,2011-10-10 18:46:36
a1bafc55665e9fe17c831ca23193cf51027af776...3e667804ebcc435f879354d0678d7d276308f70e,1,1,0,1,1,2011-09-15 19:03:06,2011-09-15 18:41:09
3e667804ebcc435f879354d0678d7d276308f70e...763059ee093f1d1aa50d587f2410ea67ca7c8753,1,0,8,8,1,2011-09-15 20:05:54,2011-09-15 20:05:54
763059ee093f1d1aa50d587f2410ea67ca7c8753...5cb1fd2e3239356cbddc833fb4c8b8817c49c5f8,2,5,0,5,2,2011-09-15 20:35:29,2011-09-15 20:35:24
5cb1fd2e3239356cbddc833fb4c8b8817c49c5f8...b2811710303bfaac92087b02b278a6effae39e4a,2,12,0,12,4,2011-09-15 20:57:41,2011-09-15 20:57:41
4527de8cba3bf5f107fcefcf43dbdaa308881ba4...65e6ba9cce7c86da2870247eab908f73b1d9ad4a,2,16,16,32,12,2011-09-08 19:52:08,2011-09-08 19:40:56
65e6ba9cce7c86da2870247eab908f73b1d9ad4a...26834b052402aa22fa1d5d5d791f18e82dfb390b,3,22,74,96,13,2011-09-08 20:30:52,2011-09-08 20:30:19
26834b052402aa22fa1d5d5d791f18e82dfb390b...b6e0433755eb97b04b308afefeee59b18f6fe341,20,2090,1047,3137,1040,2011-09-08 21:29:12,2011-09-08 21:29:12
b6e0433755eb97b04b308afefeee59b18f6fe341...0a127d6a694f2928f91d2ed51ef85a65768fdad3,3,13,5,18,5,2011-09-08 21:53:40,2011-09-08 21:53:24
0a127d6a694f2928f91d2ed51ef85a65768fdad3...03c2f62020e231db8be078d33e836cbe7e015460,60,3961,2776,6737,376,2011-09-08 23:11:20,2011-09-08 23:03:35
03c2f62020e231db8be078d33e836cbe7e015460...85357abba1126b80840de50696a34ef73b55db89,1,38,11,49,8,2011-09-09 12:45:37,2011-09-09 06:24:45
85357abba1126b80840de50696a34ef73b55db89...f81099887154642430a576c3bcd7f658325cacb2,1,4,4,8,4,2011-09-09 12:59:27,2011-09-09 12:59:27
f81099887154642430a576c3bcd7f658325cacb2...b5db0767d515d1a372d2bf97c0c44d00c4623eaa,1,1,1,2,1,2011-09-09 12:59:54,2011-09-09 12:59:54
b5db0767d515d1a372d2bf97c0c44d00c4623eaa...97cf216c74796e7f6dbc65e346ce69cbb160c67f,5,34,22,56,13,2011-09-09 13:05:12,2011-09-09 13:05:12
97cf216c74796e7f6dbc65e346ce69cbb160c67f...fa334ef0b72ff37338ef2d1202baadfc7cc389bc,1,1,1,2,1,2011-09-09 15:30:08,2011-09-09 15:29:54
fa334ef0b72ff37338ef2d1202baadfc7cc389bc...79ce48d3f02b974c19e0b9ea744e51c69fb1bbff,1,4,4,8,3,2011-09-09 19:09:59,2011-09-09 18:46:40
79ce48d3f02b974c19e0b9ea744e51c69fb1bbff...0a72ac377087fdaa606c7ce75eb983c7d34a0b97,7,2,166,168,8,2011-09-09 22:29:27,2011-09-09 21:51:32
0a72ac377087fdaa606c7ce75eb983c7d34a0b97...b49bec55806574a47403771bce1ee379c2b09ca2,4,85,9,94,7,2011-09-09 22:29:35,2011-09-09 21:55:49
b49bec55806574a47403771bce1ee379c2b09ca2...0be4812c353d7003ee4af1832068122ddcca5658,1,2,2,4,1,2011-09-09 23:38:51,2011-09-09 23:38:51
0be4812c353d7003ee4af1832068122ddcca5658...8821eb24c24cbb7566f102ecccc75f83d7f5f203,1,1,1,2,1,2011-09-10 03:18:40,2011-09-10 03:18:40
8821eb24c24cbb7566f102ecccc75f83d7f5f203...8c2c7bb8a9bdc7a8c6a0f8a82b68ee33810c7a85,2,63,22,85,8,2011-09-10 17:51:58,2011-09-08 11:42:44
8c2c7bb8a9bdc7a8c6a0f8a82b68ee33810c7a85...b942c6339ad679c0a7b9f2d68ebef70ee7231967,1,0,1,1,1,2011-09-11 00:44:52,2011-09-10 19:18:45
4527de8cba3bf5f107fcefcf43dbdaa308881ba4...bd69afbc830786566be6b341c8bee2d739aaa10a,1,72,171,243,36,2011-09-08 19:06:05,2011-09-06 20:08:48
bd69afbc830786566be6b341c8bee2d739aaa10a...42b8b77d9fe600ec2c38c7e4dc13b36bf1ad3fb9,2,206,162,368,35,2011-09-08 19:06:06,2011-09-07 07:39:49
42b8b77d9fe600ec2c38c7e4dc13b36bf1ad3fb9...71a9aefa0f2aea2e71860bb2d6d2d8f8da04334e,2,16,11,27,9,2011-09-08 19:06:06,2011-09-07 08:12:10
71a9aefa0f2aea2e71860bb2d6d2d8f8da04334e...134ab61131e371460a603125643b575e47e28851,1,67,26,93,16,2011-09-08 19:06:06,2011-09-07 08:12:58
134ab61131e371460a603125643b575e47e28851...eab65e214e6505f308e91d4aaf1896f92e5dca5e,1,63,36,99,10,2011-09-08 19:06:06,2011-09-07 10:31:29
eab65e214e6505f308e91d4aaf1896f92e5dca5e...e01635eb9bc6eb83cad00a821c68b3a9438cf744,1,206,205,411,17,2011-09-08 19:06:06,2011-09-07 10:31:43
e01635eb9bc6eb83cad00a821c68b3a9438cf744...3b2577b4fef924fde7b24f45ff98aff51183c9b7,1,105,58,163,41,2011-09-08 19:06:06,2011-09-07 14:29:01
3b2577b4fef924fde7b24f45ff98aff51183c9b7...f549f2bf1de5d2d1c1dddb8234b3251be7e2c27b,1,10,11,21,5,2011-09-08 19:06:06,2011-09-07 14:42:41
f549f2bf1de5d2d1c1dddb8234b3251be7e2c27b...0d4dc3a8b55ed7dae748b1866554845eceac887c,1,4,4,8,3,2011-09-08 19:06:06,2011-09-07 16:35:55
0d4dc3a8b55ed7dae748b1866554845eceac887c...77eb8eabe2e554f8fa85b75316e75c80eaf303fd,1,2,2,4,1,2011-09-08 19:06:06,2011-09-07 16:36:26
77eb8eabe2e554f8fa85b75316e75c80eaf303fd...00343a9af02d1686eefd16bcfa97d47468f2dd6f,1,14,0,14,2,2011-09-08 19:06:07,2011-09-07 16:43:59
00343a9af02d1686eefd16bcfa97d47468f2dd6f...2c2397d333f0ce55230f9cd4dc9b9d62fd063c38,1,7,0,7,2,2011-09-08 19:06:07,2011-09-08 03:59:38
2c2397d333f0ce55230f9cd4dc9b9d62fd063c38...e13ed4a8d0e612c2ec55fce4f3e390af91d1523c,2,54,77,131,22,2011-09-08 19:06:07,2011-09-08 09:03:27
e13ed4a8d0e612c2ec55fce4f3e390af91d1523c...3b593c9ec5d526991a9a60844b1e66597989d280,1,3,5,8,2,2011-09-08 19:06:07,2011-09-08 09:03:48
3b593c9ec5d526991a9a60844b1e66597989d280...22eb2d5084468ec7a8cec09097a80aec957a7a24,1,4,1,5,3,2011-09-08 19:06:07,2011-09-08 09:09:45
22eb2d5084468ec7a8cec09097a80aec957a7a24...199f90b13894252ea68afa0f41a1337eaee8295a,1,3,3,6,3,2011-09-08 19:06:07,2011-09-08 10:44:55
199f90b13894252ea68afa0f41a1337eaee8295a...d36d5c34dfe46888d2f039b065fd189581ef7cd3,1,4,7,11,2,2011-09-08 19:06:07,2011-09-08 14:18:23
d36d5c34dfe46888d2f039b065fd189581ef7cd3...46382a728a0d41f2018c5bb570bb1e1c5fa069ea,1,2,1,3,3,2011-09-08 19:06:07,2011-09-08 16:04:37
46382a728a0d41f2018c5bb570bb1e1c5fa069ea...01349bbd70985ba80771a32ed428ffe907b0c42d,1,36,32,68,9,2011-09-08 19:33:28,2011-09-08 19:33:28
01349bbd70985ba80771a32ed428ffe907b0c42d...8d7aade6634e6daa57164a2c9e634cae360a7c80,2,7,6,13,7,2011-09-08 20:05:21,2011-09-08 20:05:21
8d7aade6634e6daa57164a2c9e634cae360a7c80...03adceec62a76eb59cc705969e9d1e0514cf8859,1,9,3,12,4,2011-09-10 05:48:21,2011-09-10 05:38:42
03adceec62a76eb59cc705969e9d1e0514cf8859...3dd573e858dcc846a51b42cfbdaa01dd96ae11c5,1,32,27,59,20,2011-09-10 10:33:07,2011-09-10 10:33:07
3dd573e858dcc846a51b42cfbdaa01dd96ae11c5...5a3639985a8137137fb5429d21882c838943f1d0,1,10,0,10,2,2011-09-10 10:43:22,2011-09-10 10:43:22
5a3639985a8137137fb5429d21882c838943f1d0...79265fe38958afec59838feec5e9e4b30b5e47c3,1,4,4,8,3,2011-09-10 10:57:55,2011-09-10 10:57:55
79265fe38958afec59838feec5e9e4b30b5e47c3...69fa7ef65db18af840ab82db4d85bd1da3ecb20d,1,1,1,2,1,2011-09-10 11:19:47,2011-09-10 11:19:47
69fa7ef65db18af840ab82db4d85bd1da3ecb20d...db6526f9622258f18f3f66841c3b196164bcef13,1,32,10,42,8,2011-09-10 11:39:34,2011-09-10 11:39:34
db6526f9622258f18f3f66841c3b196164bcef13...54520981a40b7229fa6f2788c442a9b7d9cead3f,1,62,24,86,17,2011-09-10 12:18:36,2011-09-10 12:18:36
54520981a40b7229fa6f2788c442a9b7d9cead3f...fe4b0f40d6f105d502f341e41b0a9cf74bdf80bd,1,12,3,15,6,2011-09-10 16:55:38,2011-09-10 16:55:38
493d3b9f7c0fd4e09ed9289ae0968ef6c73be054...401c073dd278b282017c558089913c096fb9b53f,9,185,14,199,11,2011-10-22 01:09:17,2011-10-22 00:08:12
401c073dd278b282017c558089913c096fb9b53f...ac379b3be1394a8c1e7012f09560f4286319e6b7,3,38,2,40,6,2011-10-22 01:09:23,2011-10-22 00:07:11
ac379b3be1394a8c1e7012f09560f4286319e6b7...dd6faa5adf8a1ab3443f1646fcdbbc043f5f5826,5,10,3,13,6,2011-10-22 01:44:19,2011-10-22 01:44:06
dd6faa5adf8a1ab3443f1646fcdbbc043f5f5826...220e61c1f65bf4db09699fcf6399c0809c0bc446,5,63,8,71,8,2011-10-22 01:46:42,2011-10-22 00:02:11
220e61c1f65bf4db09699fcf6399c0809c0bc446...9b808c2d1bfb5d841aead91c2a51065314224a3e,1,2,2,4,1,2011-10-22 02:16:06,2011-10-22 02:16:06
9b808c2d1bfb5d841aead91c2a51065314224a3e...7e2d799328b0128ced21a5382748bd722f6f640c,1,1,1,2,1,2011-10-22 05:02:35,2011-10-22 04:53:15
7e2d799328b0128ced21a5382748bd722f6f640c...bdb9d09aefbc12daf4d9f9106d763cefd1a84c50,1,1,1,2,1,2011-10-22 05:02:35,2011-10-19 20:46:06
bdb9d09aefbc12daf4d9f9106d763cefd1a84c50...ed744ecbfd783a8b6eca46fd4f64013b3ae7bad0,1,0,2,2,1,2011-10-22 05:02:36,2011-10-22 05:00:42
ed744ecbfd783a8b6eca46fd4f64013b3ae7bad0...be4576de7abd0e109331ccf83c8b1ea71f1910b9,2,294,75,369,101,2011-10-22 05:14:39,2011-09-13 20:55:18
be4576de7abd0e109331ccf83c8b1ea71f1910b9...005d607aedf57eac046834060f3f6e8f24817407,10,453,3,456,15,2011-10-22 05:14:40,2011-10-15 00:10:49
005d607aedf57eac046834060f3f6e8f24817407...1ead20f27466438600be03af9cc92073e8f44c13,2,18,23,41,21,2011-10-22 05:14:40,2011-10-15 00:13:16
1ead20f27466438600be03af9cc92073e8f44c13...a2eaddaa514847aff5557223d9cd2b537d9017eb,3,13,2,15,6,2011-10-22 05:14:40,2011-10-19 22:06:49
a2eaddaa514847aff5557223d9cd2b537d9017eb...216570b5e1b1263083f145566112d3f343a2264b,11,37,38,75,27,2011-10-22 05:14:40,2011-10-19 23:28:44
216570b5e1b1263083f145566112d3f343a2264b...00aa8935d7f0c2b95dc95d0e335cbffbf80d6aa1,4,52,25,77,15,2011-10-22 14:40:15,2011-10-22 14:40:15
00aa8935d7f0c2b95dc95d0e335cbffbf80d6aa1...7ee29d1d5ba1655fa9f7a42afbe9ebf2f6e1c19f,1,5,2,7,4,2011-10-24 13:19:42,2011-10-23 09:20:03
7ee29d1d5ba1655fa9f7a42afbe9ebf2f6e1c19f...4c5751ba97763c7af866a5efe8505ffe1f830fdb,2,146,2,148,4,2011-10-24 19:55:45,2011-10-24 19:48:58
4c5751ba97763c7af866a5efe8505ffe1f830fdb...239b3d62deef56e8581a77aa00a81324cd757566,3,6,50,56,8,2011-10-24 20:23:59,2011-10-24 18:55:02
239b3d62deef56e8581a77aa00a81324cd757566...58cb0fa639e7105de1b479a877dbbd492f59f3c2,1,3,1,4,1,2011-10-24 22:45:35,2011-10-24 21:52:10
58cb0fa639e7105de1b479a877dbbd492f59f3c2...dddfd0f8b8bfdfd2811ae3130d3d20590a661f0a,1,1,1,2,1,2011-10-25 00:24:51,2011-10-25 00:23:07
dddfd0f8b8bfdfd2811ae3130d3d20590a661f0a...680765abece33eab94e7054de4d1fd43373f1dd6,1,9,3,12,4,2011-10-25 19:18:58,2011-10-25 19:18:41
680765abece33eab94e7054de4d1fd43373f1dd6...0a5708c3e99d49c46784cea0f579f85d02eaadd1,2,31,6,37,2,2011-10-25 21:10:12,2011-10-25 20:47:21
0a5708c3e99d49c46784cea0f579f85d02eaadd1...b8847e9ac6d71deaf4cc09e27f913fac1344ad0f,7,102,37,139,18,2011-10-25 22:05:24,2011-10-25 22:05:24
b8847e9ac6d71deaf4cc09e27f913fac1344ad0f...d7dff34bad8544602d0b26414b836dbf9705f05e,1,6,3,9,3,2011-10-26 04:59:31,2011-10-26 04:59:31
d7dff34bad8544602d0b26414b836dbf9705f05e...15628f673516e04c9051e4061cf1090247e063cd,1,7,8,15,8,2011-10-26 05:09:21,2011-10-26 05:09:18
15628f673516e04c9051e4061cf1090247e063cd...13871fa2f8ec999279a2460818380d6bef7b7b38,1,6,0,6,1,2011-10-26 05:11:38,2011-10-26 05:11:20
13871fa2f8ec999279a2460818380d6bef7b7b38...0e8a55d2a22b88dc3b9b0165f344602b0fa8c977,2,100,1,101,2,2011-10-26 15:18:29,2011-10-25 09:57:06
0e8a55d2a22b88dc3b9b0165f344602b0fa8c977...cbcaeedba9603a1e62cc56e0405b57efacb0659e,3,95,0,95,4,2011-10-26 15:28:16,2011-10-26 12:12:23
cbcaeedba9603a1e62cc56e0405b57efacb0659e...7fb8c7c37fb32689aa150f6dc88553769abdc19a,1,1,1,2,1,2011-10-26 18:00:10,2011-10-26 17:07:40
7fb8c7c37fb32689aa150f6dc88553769abdc19a...3961b5a13131c473047ed2826653934d541a089d,1,1,1,2,1,2011-10-26 18:00:54,2011-10-26 17:40:15
3961b5a13131c473047ed2826653934d541a089d...b3ddb895d2e3dc983d6f40dc95179dc7eda3440e,3,11,4,15,5,2011-10-26 18:36:21,2011-10-26 18:31:12
b3ddb895d2e3dc983d6f40dc95179dc7eda3440e...b8f3e18a5d3b9542e452274adb5422dfc0784e15,1,4,0,4,4,2011-10-26 18:38:29,2011-10-26 18:09:01
b8f3e18a5d3b9542e452274adb5422dfc0784e15...a6a04fb1ec8cd58c718a5314807a18d6fc9788a3,1,67,0,67,1,2011-10-26 18:38:29,2011-10-26 18:10:15
a6a04fb1ec8cd58c718a5314807a18d6fc9788a3...3524f41a27108eb998fd56416e44e4e3d432d308,1,56,0,56,1,2011-10-26 18:38:29,2011-10-26 18:10:23
3524f41a27108eb998fd56416e44e4e3d432d308...194511ff1a0309e01f6cad03292ccc2e67134390,1,27,6,33,6,2011-10-26 19:28:25,2011-10-26 19:27:31
194511ff1a0309e01f6cad03292ccc2e67134390...2dbb470ea10697f7514094934dfbf635969b8566,1,7,9,16,5,2011-10-26 19:33:24,2011-10-26 04:42:23
2dbb470ea10697f7514094934dfbf635969b8566...d4379fcee3b7d7838caf21bddca5248c33f8771f,3,9,5,14,8,2011-10-26 19:33:24,2011-10-26 18:22:16
d4379fcee3b7d7838caf21bddca5248c33f8771f...ebefe77bc09df7cdb844d837c9ba3dcbbb24bf28,1,5,5,10,5,2011-10-26 19:58:34,2011-10-26 06:56:07
ebefe77bc09df7cdb844d837c9ba3dcbbb24bf28...4fb2ac5be1ec2be2c1d97b7c70be8423dbae2db4,1,13,0,13,1,2011-10-26 19:58:51,2011-10-26 19:45:51
4fb2ac5be1ec2be2c1d97b7c70be8423dbae2db4...c5d54010bc9f69bf6ccc85ed38d004a9d3b5fdcf,4,50,22,72,13,2011-10-26 20:50:53,2011-10-26 20:41:31
c5d54010bc9f69bf6ccc85ed38d004a9d3b5fdcf...528c28587f11b64616ffa22b5cf3f53bea831792,2,53,27,80,3,2011-10-26 23:42:00,2011-10-26 23:21:08
528c28587f11b64616ffa22b5cf3f53bea831792...92f5a5d3caf01f382f90c235e9057590a5e76870,226,13999,7083,21082,3043,2011-10-27 07:48:23,2011-10-27 07:48:23
92f5a5d3caf01f382f90c235e9057590a5e76870...b9529545e1528442e03888ba640c6205319dbc0d,1,126,15,141,10,2011-10-27 11:22:07,2011-10-27 11:19:51
b9529545e1528442e03888ba640c6205319dbc0d...173f91c7918f8c5f7c23ba3bfb2a56eb2e1b2814,1,29,0,29,1,2011-10-27 12:21:54,2011-10-26 06:10:42
173f91c7918f8c5f7c23ba3bfb2a56eb2e1b2814...cc2ac1ccc7724b920cbc7bbb777f057ac062028c,5,0,244,244,6,2011-10-27 23:47:37,2011-10-27 23:47:37
cc2ac1ccc7724b920cbc7bbb777f057ac062028c...3dee0e4cd8ecee01e48b6d4a1b6ee910bc67a2dd,1,1,0,1,1,2011-10-28 15:31:40,2011-10-28 15:27:47
3dee0e4cd8ecee01e48b6d4a1b6ee910bc67a2dd...1d94d4fa70f67c1dfc319f7d638358f57f2ba76b,1,1,1,2,1,2011-10-28 16:22:39,2011-10-28 16:22:39
1d94d4fa70f67c1dfc319f7d638358f57f2ba76b...e35ce7baa18a90c4e6b47817b79ca066d43688c9,1,1,1,2,2,2011-10-28 20:32:04,2011-10-28 18:07:06
e35ce7baa18a90c4e6b47817b79ca066d43688c9...004e6fbe1f833523caf262e07577cbdeb4324c9b,1,4,4,8,3,2011-10-28 20:36:55,2011-10-28 20:36:55
004e6fbe1f833523caf262e07577cbdeb4324c9b...ccd8b55b019c675aa4449069f796eaee63f09bc8,2,4,19,23,4,2011-10-28 21:47:08,2011-10-28 21:29:56
ccd8b55b019c675aa4449069f796eaee63f09bc8...f35a396c54bb8e266905e092e12f18547f2e99dc,5,244,0,244,6,2011-10-28 22:35:38,2011-10-28 22:34:24
f35a396c54bb8e266905e092e12f18547f2e99dc...56315494dd5b70f308b84c6601c3a79c09677e8d,1,4,3,7,2,2011-10-28 22:57:39,2011-10-28 22:57:39
56315494dd5b70f308b84c6601c3a79c09677e8d...6a6a70e80e756cdc81c0fbf59242d3bc29d09d36,1,0,1,1,1,2011-10-28 23:06:40,2011-10-28 14:08:07
6a6a70e80e756cdc81c0fbf59242d3bc29d09d36...1e2d7776010bda6d7650019eaefdf40e67622681,1,0,1,1,1,2011-10-28 23:06:42,2011-10-28 09:31:43
1e2d7776010bda6d7650019eaefdf40e67622681...889620dcd25f021a55fd3f710e8f5826d7669698,2,12,6,18,6,2011-10-28 23:06:44,2011-10-28 09:34:53
889620dcd25f021a55fd3f710e8f5826d7669698...c0c4bd4efac130500335270f77964a515e70e206,1,2,0,2,1,2011-10-28 23:06:45,2011-10-28 10:10:24
c0c4bd4efac130500335270f77964a515e70e206...2f22024806269e9836f56ef9a55d08991acd8a21,21,697,205,902,150,2011-10-28 23:06:47,2011-10-28 23:06:09
2f22024806269e9836f56ef9a55d08991acd8a21...dd93c53c4e2e073e27280235581b6aca029e7157,1,53,44,97,18,2011-10-28 23:06:49,2011-10-28 10:05:09
dd93c53c4e2e073e27280235581b6aca029e7157...4a1efb2b9c02dd5acbf9c0bb3f41267b5acaab11,2,35,8,43,4,2011-10-28 23:06:51,2011-10-28 09:31:34
4a1efb2b9c02dd5acbf9c0bb3f41267b5acaab11...a56a95b65228a9f7fa584746d97abbad19a92edf,1,10,10,20,3,2011-10-28 23:06:53,2011-10-28 10:08:36
a56a95b65228a9f7fa584746d97abbad19a92edf...60efa608d6b310571667bac4e0ec809b76b3a8a0,1,1,0,1,1,2011-10-28 23:33:01,2011-10-28 23:33:01
60efa608d6b310571667bac4e0ec809b76b3a8a0...6d7aa65399ea302adb3965c57938ae8393f8dbb3,1,4,1,5,2,2011-10-29 01:32:27,2011-10-29 01:30:03
6d7aa65399ea302adb3965c57938ae8393f8dbb3...12cf730b69932b6f99aa6e71f73f75703ea1251a,2,44,3,47,3,2011-10-30 01:14:30,2011-10-23 11:19:45
12cf730b69932b6f99aa6e71f73f75703ea1251a...a7803c58e4969db90f6960160f364ce2fb5239c1,3,30,7,37,10,2011-10-30 01:56:51,2011-10-30 01:56:51
a7803c58e4969db90f6960160f364ce2fb5239c1...52c2988f16080c805da64e26547bfa221472d5a4,1,1,1,2,1,2011-10-30 02:40:31,2011-10-30 02:40:31
52c2988f16080c805da64e26547bfa221472d5a4...8a729270c144f93aaca72f5941c99217fe6e2d67,3,3,3,6,3,2011-10-30 15:49:20,2011-10-30 15:49:20
8a729270c144f93aaca72f5941c99217fe6e2d67...26874e2e07c1335d4bd3f20810326b441d2df39a,1,1,0,1,1,2011-10-30 16:15:10,2011-10-30 16:15:10
26874e2e07c1335d4bd3f20810326b441d2df39a...a1fa3efd2b8ef4b299218f16041fe2e979508dbe,1,1,1,2,1,2011-10-30 16:35:08,2011-10-30 16:33:42
a1fa3efd2b8ef4b299218f16041fe2e979508dbe...b6c582a3a31a9e53bed4f960e35b89d700985640,1,0,10,10,1,2011-10-30 20:22:46,2011-10-30 20:22:46
b6c582a3a31a9e53bed4f960e35b89d700985640...f53d092a2a981bebc0cf07d00709dd1433453d7d,9,135,4,139,12,2011-10-31 08:36:43,2011-10-26 17:34:56
f53d092a2a981bebc0cf07d00709dd1433453d7d...5fee1ff7bce8b867fe6e1379b7777954d24f8b36,1,17,0,17,1,2011-10-31 21:02:46,2011-10-31 20:58:22
5fee1ff7bce8b867fe6e1379b7777954d24f8b36...4d4900fc65104604820c99faeaf439f958634451,1,5,7,12,4,2011-10-31 21:31:14,2011-10-31 21:31:12
4d4900fc65104604820c99faeaf439f958634451...06190928c0c0cf9eb6419412293ef29040b1cb50,1,5,5,10,3,2011-10-31 23:31:59,2011-10-31 23:31:37
06190928c0c0cf9eb6419412293ef29040b1cb50...f5a01d17643a7c66876a84d53b33b8c3e6c75752,1,1,1,2,1,2011-11-01 10:30:19,2011-11-01 10:30:19
f5a01d17643a7c66876a84d53b33b8c3e6c75752...362b5a6c401d08eafad701f4b6023e357a82f910,2,26,0,26,2,2011-11-01 15:30:43,2011-11-01 15:30:41
362b5a6c401d08eafad701f4b6023e357a82f910...b4afe605f4e73278f34fc6490375d878abaf7aca,1,0,40,40,2,2011-11-01 16:45:21,2011-11-01 14:16:16
b4afe605f4e73278f34fc6490375d878abaf7aca...37bb37d151fb6ee4696730e63ff28bb7a4924f97,3,13,3,16,4,2011-11-01 17:10:06,2011-11-01 16:23:17
37bb37d151fb6ee4696730e63ff28bb7a4924f97...21b64dc7c9e8eb1381b2d1d09c9fd96a01a72785,9,158,33,191,16,2011-11-01 21:11:58,2011-11-01 21:11:58
21b64dc7c9e8eb1381b2d1d09c9fd96a01a72785...3060266ff149388ca5443725e6cdbc0e8c651bcf,3,48,0,48,7,2011-11-01 21:14:52,2011-11-01 08:35:48
3060266ff149388ca5443725e6cdbc0e8c651bcf...fc61134b1ae4c4fa5ee2cd22208c1e755cd665dd,11,32,32,64,28,2011-11-01 21:26:52,2011-11-01 19:52:35
fc61134b1ae4c4fa5ee2cd22208c1e755cd665dd...cc9223406837e7610b5f36b16b6a0e51861370cb,1,4,1,5,2,2011-11-01 23:44:08,2011-11-01 23:30:42
cc9223406837e7610b5f36b16b6a0e51861370cb...edea4122b1c725a9f7873c02fe04100995472ddc,224,6957,13983,20940,3035,2011-11-02 15:58:35,2011-11-02 15:58:08
edea4122b1c725a9f7873c02fe04100995472ddc...672b453a767bba2ddea2621e2a5598c930f56639,1,2,11,13,3,2011-11-02 16:28:46,2011-11-02 16:24:53
672b453a767bba2ddea2621e2a5598c930f56639...60818b957c1ee932a43750f6e2163125ba70a0e1,15,315,0,315,15,2011-11-02 17:00:57,2011-11-02 17:00:57
60818b957c1ee932a43750f6e2163125ba70a0e1...6bd0bcd5af1384378650bb74b7831776fefc16bb,1,1,0,1,1,2011-11-02 17:17:51,2011-11-02 16:52:47
6bd0bcd5af1384378650bb74b7831776fefc16bb...c8646e0c4159aa53b2ae94d1b69850ce5fa62ca2,1,2,0,2,2,2011-11-02 17:37:34,2011-11-02 17:37:34
c8646e0c4159aa53b2ae94d1b69850ce5fa62ca2...9ad27f7853089bd24f1093f1617b68808fc87457,3,7,4,11,5,2011-11-02 22:55:36,2011-11-02 22:38:38
9ad27f7853089bd24f1093f1617b68808fc87457...1ba834bd3fee57542479ab687f0030cf57968be4,1,6,3,9,3,2011-11-02 23:22:02,2011-11-02 23:21:25
1ba834bd3fee57542479ab687f0030cf57968be4...850609ea2d3e0de2aad5485edcc89bd6ddd94b6e,110,112,332,444,116,2011-11-02 23:38:59,2011-11-02 23:26:43
850609ea2d3e0de2aad5485edcc89bd6ddd94b6e...143aeb9ea716b1af0baeb700903961612b457143,14,156,39,195,34,2011-11-02 23:51:26,2011-11-02 23:51:26
143aeb9ea716b1af0baeb700903961612b457143...359a65a6db1c82ed3a4bb7f5be254912771f5062,2,46,3,49,4,2011-11-03 00:30:03,2011-11-03 00:20:54
359a65a6db1c82ed3a4bb7f5be254912771f5062...24a69d22a0e7c3e089ab56f5b3800a69a44c6963,4,38,34,72,14,2011-11-03 00:34:17,2011-11-02 22:06:48
24a69d22a0e7c3e089ab56f5b3800a69a44c6963...434ccd2e20b95d641ee3f108ee7c7e3cd94c62a9,1,1,1,2,1,2011-11-03 01:27:43,2011-11-03 01:27:43
434ccd2e20b95d641ee3f108ee7c7e3cd94c62a9...818f0cba55315d5d0d3033537af4399d6799ea10,1,95,13,108,10,2011-11-03 02:23:59,2011-11-03 02:23:59
818f0cba55315d5d0d3033537af4399d6799ea10...52eaac438269b1c391bf10496e2e52bf74cca35d,4,38,1,39,6,2011-11-03 02:25:11,2011-11-03 02:25:11
52eaac438269b1c391bf10496e2e52bf74cca35d...11d68eb3fc3c2f8d377cf8c50f1babb8d1f82d5f,1,2,2,4,2,2011-11-03 08:37:23,2011-11-03 08:35:49
11d68eb3fc3c2f8d377cf8c50f1babb8d1f82d5f...a6dbe0ff23a8d73cd747de30c426753ae743113a,1,3,3,6,3,2011-11-03 11:04:22,2011-11-03 11:04:22
a6dbe0ff23a8d73cd747de30c426753ae743113a...0e9c1ca67399868e8d602e146dc51d84ad9fdc15,307,17131,32381,49512,5808,2011-11-03 17:34:22,2011-11-03 17:34:22
0e9c1ca67399868e8d602e146dc51d84ad9fdc15...2dd68af33483d1deb079fa8c0a8b185e3aa423f4,1,1,2,3,2,2011-11-03 17:46:16,2011-11-03 17:46:16
2dd68af33483d1deb079fa8c0a8b185e3aa423f4...481c17504db0ab707d145b35c8bb1eb1a9cdb941,1,83,0,83,1,2011-11-03 17:54:00,2011-11-03 14:13:22
481c17504db0ab707d145b35c8bb1eb1a9cdb941...9c11e8a1ca75c55b59c2794d3b3840f1df2e2a65,2,48,2,50,3,2011-11-03 18:16:10,2011-11-01 22:42:45
9c11e8a1ca75c55b59c2794d3b3840f1df2e2a65...4a8088a603387697f24c65653e279f9d841d74e5,2,68,0,68,3,2011-11-03 19:37:04,2011-11-03 19:34:23
4a8088a603387697f24c65653e279f9d841d74e5...a936768890db2e4b14f8994a84edb7121e6c82d0,3,73,2,75,4,2011-11-03 20:27:33,2011-11-03 20:27:26
a936768890db2e4b14f8994a84edb7121e6c82d0...b904a078d84973e46aadfeab119743422d4061ea,1,6,1,7,1,2011-11-03 21:11:14,2011-11-03 21:09:07
b904a078d84973e46aadfeab119743422d4061ea...cf78d04ae29757e1756e5538cb64c268acdec809,13,86,12,98,17,2011-11-03 23:33:54,2011-11-03 23:30:58
cf78d04ae29757e1756e5538cb64c268acdec809...8974ba31a37f9ef2cea99d9a5c118e33c7bb2497,1,1,1,2,1,2011-11-04 04:30:00,2011-11-04 04:28:30
8974ba31a37f9ef2cea99d9a5c118e33c7bb2497...5fd012e67a94bd3d7832534cdf4b3a24a0029dd4,1,12,6,18,7,2011-11-04 12:10:07,2011-11-04 12:10:07
5fd012e67a94bd3d7832534cdf4b3a24a0029dd4...358f0ce96ba1147d0b382216af800e53682c5ff4,2,77,1,78,3,2011-11-04 12:36:06,2011-11-04 12:22:18
358f0ce96ba1147d0b382216af800e53682c5ff4...189dd8f8034213d476e79845ad43563eb934fcf9,10,39,39,78,13,2011-11-04 15:24:34,2011-11-04 15:06:48
189dd8f8034213d476e79845ad43563eb934fcf9...6ee73a2fee78eeda8eb5d171dbf0b9d13ce54119,2,43,233,276,6,2011-11-04 15:24:35,2011-11-04 15:10:48
6ee73a2fee78eeda8eb5d171dbf0b9d13ce54119...35f4182cee079e2c481dc436f5ea97966957def8,1,15,10,25,5,2011-11-04 15:24:35,2011-11-04 15:11:39
35f4182cee079e2c481dc436f5ea97966957def8...829735e738d34d880ba35c0e114cf9cff4dfedaf,3,199,32,231,26,2011-11-04 16:50:28,2011-11-04 15:23:02
829735e738d34d880ba35c0e114cf9cff4dfedaf...b5d32d4a9ecc76ccb5291badf5e9d91dbfc9fda4,3,20,28,48,14,2011-11-04 16:50:46,2011-11-04 16:20:53
b5d32d4a9ecc76ccb5291badf5e9d91dbfc9fda4...8ef2c13d6c8ac0430f504c7e86997f77026ab37d,1,2,2,4,2,2011-11-04 17:00:18,2011-11-04 16:56:21
8ef2c13d6c8ac0430f504c7e86997f77026ab37d...5213c3903870ff6072858fb923970672d7868233,3,176,2,178,5,2011-11-04 17:32:57,2011-10-24 16:29:24
5213c3903870ff6072858fb923970672d7868233...44a5452a4f9b195b4e88a23155c49027ac44e015,1,2,2,4,2,2011-11-04 19:10:21,2011-11-04 18:11:50
44a5452a4f9b195b4e88a23155c49027ac44e015...86528489ecb1213c95437d646d90eb3919c4f81a,4,95,68,163,32,2011-11-04 22:12:11,2011-11-04 22:11:19
86528489ecb1213c95437d646d90eb3919c4f81a...d42006c80a9c827e4c147e22f56bb3d789f578ce,2,1,22,23,3,2011-11-04 22:14:38,2011-11-04 22:14:26
d42006c80a9c827e4c147e22f56bb3d789f578ce...5496e67f83aea24ec6809e789611a5b62d3208a0,5,100,6,106,12,2011-11-04 22:19:46,2011-11-04 22:19:46
5496e67f83aea24ec6809e789611a5b62d3208a0...1e3e6b7c15f39500d30d91846ad3621fb72aa91b,1,38,0,38,1,2011-11-04 22:34:18,2011-11-04 22:33:49
1e3e6b7c15f39500d30d91846ad3621fb72aa91b...89014c9d4055803a4413de08e41983434eadfd3d,1,8,0,8,1,2011-11-04 22:53:01,2011-11-04 22:31:39
89014c9d4055803a4413de08e41983434eadfd3d...c1472ac105b9813552eeff3525cbef61b8290a7a,1,5,5,10,5,2011-11-04 22:53:01,2011-11-04 22:07:10
c1472ac105b9813552eeff3525cbef61b8290a7a...5c3954aa6fb2e0b23a7bcfec6fc4636d5d152333,1,11,6,17,2,2011-11-04 22:56:28,2011-11-04 22:55:06
5c3954aa6fb2e0b23a7bcfec6fc4636d5d152333...b54da8a10f390286203a5bbfc702cffecfbcee90,13,70,34,104,29,2011-11-05 00:50:05,2011-11-05 00:50:05
b54da8a10f390286203a5bbfc702cffecfbcee90...6545a6dc5dda33b01f9d842ec5502eb04abfe6ad,1,5,11,16,2,2011-11-05 01:01:03,2011-11-05 00:55:12
6545a6dc5dda33b01f9d842ec5502eb04abfe6ad...1a9286c6e9e5247110ddbf16684e713a1545cefa,1,1,1,2,1,2011-11-05 01:04:52,2011-11-05 01:04:52
1a9286c6e9e5247110ddbf16684e713a1545cefa...7335a4234aa9521954333526bff7f996f1df4d1e,1,2,2,4,2,2011-11-05 01:05:53,2011-11-05 00:48:24
7335a4234aa9521954333526bff7f996f1df4d1e...10edbbb927e6a573f9b21b15fcc10cefae01fdd7,2,14,12,26,6,2011-11-05 02:13:55,2011-11-05 02:13:55
10edbbb927e6a573f9b21b15fcc10cefae01fdd7...96fe50400dcef5fd696cbd88ebcd51a7d5674baf,1,2,2,4,1,2011-11-05 03:35:38,2011-11-05 03:35:38
96fe50400dcef5fd696cbd88ebcd51a7d5674baf...865b077819a9271a29f982faaef99dc635b57fbc,5,70,11,81,8,2011-11-05 06:48:57,2011-11-04 23:40:14
865b077819a9271a29f982faaef99dc635b57fbc...9e00b7d3d0a3b1ca13be5dbe48251ef10b0309f0,1,2,2,4,1,2011-11-05 08:55:34,2011-11-05 08:55:34
9e00b7d3d0a3b1ca13be5dbe48251ef10b0309f0...8f2b03242d79809854b72a4546ab1d9c0b9b5542,1,1,1,2,1,2011-11-05 09:41:39,2011-11-05 09:36:20
8f2b03242d79809854b72a4546ab1d9c0b9b5542...099c717baf7f23b6c009f9ad65c5323634c68a3c,1,1,1,2,1,2011-11-05 09:44:27,2011-11-05 09:44:27
099c717baf7f23b6c009f9ad65c5323634c68a3c...febe5c44c0a45847217278e8f82b89c23f6002a2,1,2,2,4,1,2011-11-05 12:00:20,2011-11-05 10:08:15
febe5c44c0a45847217278e8f82b89c23f6002a2...da82daf54c65b26112c020f4e2fe51a4ccab9041,1,13,8,21,5,2011-11-05 14:24:28,2011-11-05 07:47:21
da82daf54c65b26112c020f4e2fe51a4ccab9041...1001cf412c38bdd06bf686af80c7cea0d2fa1155,1,27,32,59,10,2011-11-05 16:25:07,2011-11-05 16:23:33
1001cf412c38bdd06bf686af80c7cea0d2fa1155...edcfea5d02c2ea89c2dae92b7ed7f008370187de,1,2,1,3,1,2011-11-07 05:46:09,2011-11-07 05:46:05
edcfea5d02c2ea89c2dae92b7ed7f008370187de...a9366818a154bce29165b0d5ca3df7961154690d,1,1,8,9,2,2011-11-07 18:41:01,2011-11-07 18:41:01
a9366818a154bce29165b0d5ca3df7961154690d...6a83df04b662866047c2e67ae9419e102bcc6a4c,1,5,1,6,2,2011-11-07 18:43:48,2011-11-07 18:43:48
6a83df04b662866047c2e67ae9419e102bcc6a4c...d7bcf21340b834791b56cdfc0af76e54327f928f,1,4,5,9,2,2011-11-07 23:25:54,2011-11-07 23:25:51
d7bcf21340b834791b56cdfc0af76e54327f928f...69d3bf10685c248a369abacc277c5adb344a8b48,1,2,2,4,1,2011-11-07 23:43:59,2011-11-07 19:37:05
69d3bf10685c248a369abacc277c5adb344a8b48...105d1787dc05e7f8785db1be7c84350bfde0bb98,1,1,1,2,1,2011-11-08 07:29:25,2011-11-08 07:29:25
105d1787dc05e7f8785db1be7c84350bfde0bb98...04958e88a41e1b1324f3684674f5f662486cc094,2,85,0,85,2,2011-11-08 11:48:09,2011-11-08 11:44:36
04958e88a41e1b1324f3684674f5f662486cc094...b1bb17fd2b432144045799950f49a6b52c6c53c0,1,1,1,2,1,2011-11-08 12:02:04,2011-11-08 10:17:33
b1bb17fd2b432144045799950f49a6b52c6c53c0...6f96e78dea5fd73eda9c1e88a2212a50347e38ff,1,14,0,14,2,2011-11-08 12:03:29,2011-11-08 12:03:25
6f96e78dea5fd73eda9c1e88a2212a50347e38ff...0d19d82498e1e94babe60942d143d40fa0bae1ed,1,1,1,2,2,2011-11-08 15:02:18,2011-11-07 21:54:34
0d19d82498e1e94babe60942d143d40fa0bae1ed...0ba8f05a423df0e2ef53fcbc6e8c490d6bd06395,4,44,8,52,4,2011-11-08 18:00:12,2011-11-08 18:00:12
0ba8f05a423df0e2ef53fcbc6e8c490d6bd06395...97cada0e6a130791ceafaa750f9009d8fdaaadbb,1,74,0,74,3,2011-11-08 19:04:23,2011-11-08 16:57:21
97cada0e6a130791ceafaa750f9009d8fdaaadbb...409915e955ee5992f118d6c6d01c81f017be774c,8,180,8,188,16,2011-11-08 19:52:18,2011-11-08 19:19:50
409915e955ee5992f118d6c6d01c81f017be774c...efb833f342db7b0ac66cf1169f0d6f44240822df,1,2,2,4,2,2011-11-08 19:56:45,2011-11-08 16:57:21
efb833f342db7b0ac66cf1169f0d6f44240822df...2d13cdfd2ab4ef00f0140aa02313fae98e47ac25,1,2,2,4,2,2011-11-08 21:37:08,2011-11-08 21:36:36
2d13cdfd2ab4ef00f0140aa02313fae98e47ac25...05727f6e3e334061ce5a592757509fc1d43d76b8,6,31,11,42,12,2011-11-09 00:52:45,2011-11-09 00:52:45
05727f6e3e334061ce5a592757509fc1d43d76b8...2a462abf5fe196342d9fa4db48212e87f74aae7e,1,1,1,2,1,2011-11-09 00:58:32,2011-11-09 00:58:32
2a462abf5fe196342d9fa4db48212e87f74aae7e...3ae644d48cad70bcde3b5c367aa9ac64c2a24ae3,1,1,0,1,1,2011-11-09 00:59:40,2011-11-09 00:59:40
3ae644d48cad70bcde3b5c367aa9ac64c2a24ae3...da9bf0ee809ea467358c5174b27b635ba2ae47ba,2,88,2,90,4,2011-11-09 01:03:29,2011-11-09 01:03:29
da9bf0ee809ea467358c5174b27b635ba2ae47ba...0fa3cf94a3861765b95114f6b33b455d0d5bfdf9,1,0,1,1,1,2011-11-09 01:07:49,2011-11-09 01:07:49
0fa3cf94a3861765b95114f6b33b455d0d5bfdf9...cdcb1118c83c9f5804b6d22c8b13b2dd084c140b,16,16,16,32,16,2011-11-09 15:34:09,2011-11-09 15:33:50
cdcb1118c83c9f5804b6d22c8b13b2dd084c140b...4fc0fdc6ee8c41320f4d4ea74e4fa8a3ac12ed57,1,2,1,3,1,2011-11-09 16:34:53,2011-11-09 16:32:39
4fc0fdc6ee8c41320f4d4ea74e4fa8a3ac12ed57...5d89540b776f07dcee43b9aeed1dce775ef63529,1,1,0,1,1,2011-11-09 21:53:19,2011-11-09 21:51:32
5d89540b776f07dcee43b9aeed1dce775ef63529...f84d86b66054273fb6a31346f0dd957078b58c1c,1,1,0,1,1,2011-11-09 23:04:44,2011-11-09 23:04:44
f84d86b66054273fb6a31346f0dd957078b58c1c...8dd4fcbe8f396fbc14a92a30ebb86c781b38e3dd,1,20,0,20,6,2011-11-10 12:17:51,2011-11-10 12:17:49
8dd4fcbe8f396fbc14a92a30ebb86c781b38e3dd...e34a2c170c5b6e27f5f61ae8c1df7dcd764b9299,10,223,247,470,42,2011-11-10 16:40:56,2011-11-10 16:40:56
e34a2c170c5b6e27f5f61ae8c1df7dcd764b9299...0757c73a20da712b06bccdee7a322fd21dd6c799,3,44,4,48,8,2011-11-10 19:10:54,2011-11-10 19:10:54
0757c73a20da712b06bccdee7a322fd21dd6c799...78ca5558451e29a6245f7a75c9b454a6ce7012f3,1,38,27,65,20,2011-11-10 20:13:37,2011-11-10 20:11:19
78ca5558451e29a6245f7a75c9b454a6ce7012f3...09329e78332369b46a7f38f2071c871262591bc0,7,63,0,63,2,2011-11-10 21:22:13,2011-11-10 21:04:34
09329e78332369b46a7f38f2071c871262591bc0...13324bf844d4527e91cf3777d3010aa4dca5f365,3,19,12,31,7,2011-11-10 22:51:16,2011-11-10 22:51:16
13324bf844d4527e91cf3777d3010aa4dca5f365...ec90ede1cf11f78b746da04a35d4eb32c05b535b,3,5,5,10,5,2011-11-11 02:40:49,2011-11-11 02:40:49
ec90ede1cf11f78b746da04a35d4eb32c05b535b...dc39ab3bbf22f624b7dccc66766aeda23c854579,8,33,75,108,10,2011-11-11 02:41:44,2011-11-11 02:16:51
dc39ab3bbf22f624b7dccc66766aeda23c854579...74f39041d4659809bab82dc78aed2ad38ab95811,1,2,1,3,2,2011-11-11 07:35:35,2011-11-11 07:35:35
74f39041d4659809bab82dc78aed2ad38ab95811...426298c8c1c0d5b5224ac3658c41e7c2a3fe9377,1,3,2,5,1,2011-11-11 09:39:32,2011-11-10 09:10:03
426298c8c1c0d5b5224ac3658c41e7c2a3fe9377...326b2cb34e27237427fb94c5b9ae4148d10e763d,2,562,220,782,2,2011-11-11 16:02:43,2011-11-11 15:57:05
326b2cb34e27237427fb94c5b9ae4148d10e763d...10d4bd8266f7983929b57f6394fb5d99d60fa711,1,123,2,125,2,2011-11-11 16:02:43,2011-11-11 10:33:12
10d4bd8266f7983929b57f6394fb5d99d60fa711...4e2343c6b5656ba9ca2faa44af7cb4b3634a37b8,1,1,1,2,1,2011-11-11 19:24:59,2011-11-11 17:18:31
4e2343c6b5656ba9ca2faa44af7cb4b3634a37b8...e0f10ecfd9a3d957398382a51f664b1562501a7e,3,212,9,221,10,2011-11-11 19:29:50,2011-11-11 06:37:34
e0f10ecfd9a3d957398382a51f664b1562501a7e...895fa3a56bd74d7bbf6ee575408ab659ee51085c,3,11,4,15,4,2011-11-11 20:09:48,2011-11-11 20:08:24
895fa3a56bd74d7bbf6ee575408ab659ee51085c...2af643161965182b8e19f7f2afa32c47cf0dcac4,1,16,0,16,4,2011-11-11 20:38:55,2011-11-11 20:38:55
2af643161965182b8e19f7f2afa32c47cf0dcac4...2095eea3da71ce70252d468b6e347b6918951f7a,3,36,9,45,6,2011-11-11 20:50:04,2011-11-11 20:40:47
2095eea3da71ce70252d468b6e347b6918951f7a...d214576d2b8c5a16f403d2522ceadd91381a6a94,2,2,2,4,2,2011-11-11 22:02:42,2011-11-11 22:02:42
d214576d2b8c5a16f403d2522ceadd91381a6a94...5bc1809b433f7ea9b3f1d02c6b007d36276efa48,1,20,4,24,6,2011-11-11 22:31:15,2011-11-11 22:31:15
5bc1809b433f7ea9b3f1d02c6b007d36276efa48...170f2addb2dd0c625bc4a6d461e89a31ad68b79b,5,46,15,61,9,2011-11-11 22:56:27,2011-11-11 21:39:40
170f2addb2dd0c625bc4a6d461e89a31ad68b79b...8082858ee7a2c3ac9c0f7415c51a463783e912cd,1,2,2,4,1,2011-11-11 23:35:10,2011-11-11 23:35:10
8082858ee7a2c3ac9c0f7415c51a463783e912cd...098fef674038dcc42ae991205fdc6e5d649c2b6a,2,69,16,85,6,2011-11-12 12:31:28,2011-11-12 12:31:26
098fef674038dcc42ae991205fdc6e5d649c2b6a...b00f5e2e14b98188d275be411a3ce03bffce69af,1,92,0,92,1,2011-11-12 19:34:55,2011-11-12 01:24:47
b00f5e2e14b98188d275be411a3ce03bffce69af...3421f433519411c290c732c64dadbb6547e42235,3,237,5,242,12,2011-11-12 19:34:55,2011-11-12 01:44:39
3421f433519411c290c732c64dadbb6547e42235...897208e06dbad5e07bb592af4ed6746aef68554e,1,25,21,46,7,2011-11-13 14:38:27,2011-11-13 09:39:24
897208e06dbad5e07bb592af4ed6746aef68554e...3222a04d5e8d1fef90ac6247c6febeebe02cf659,2,106,0,106,3,2011-11-13 18:54:35,2011-11-13 01:57:42
1b0a5cbaaa3e576c7759736f94dbbda78aedb6a2...2d0b1ed7ad3f025630d55d79d4ca9b5218e49a69,12,88,23,111,26,2011-09-15 22:37:57,2011-09-15 22:29:32
2d0b1ed7ad3f025630d55d79d4ca9b5218e49a69...0ad28fdd3761d69a6858bef1905e0a59cb7bf8d9,1,1,1,2,1,2011-09-16 17:16:32,2011-09-16 17:16:30
0ad28fdd3761d69a6858bef1905e0a59cb7bf8d9...8b754a9e02cb2404bd780322d440b73aacec7517,1,64,0,64,1,2011-09-16 22:05:15,2011-09-16 22:02:30
8b754a9e02cb2404bd780322d440b73aacec7517...d750927b360e5c7c1329992ca6cfcb2ab7e506a0,5,176,2,178,8,2011-09-16 23:19:33,2011-09-16 23:19:18
d750927b360e5c7c1329992ca6cfcb2ab7e506a0...cde81a6675caa5d64d2215b75105cf353ed98dc6,1,0,64,64,1,2011-09-17 00:24:34,2011-09-17 00:20:05
cde81a6675caa5d64d2215b75105cf353ed98dc6...d6088b2667311da324f97cdff03bfcc70cacf32a,1,1,1,2,1,2011-09-17 00:53:19,2011-09-17 00:47:35
d6088b2667311da324f97cdff03bfcc70cacf32a...4a537c1b88b21e8c6dad29396303367361186cf8,1,47,24,71,22,2011-09-17 00:53:19,2011-09-15 15:17:49
4a537c1b88b21e8c6dad29396303367361186cf8...145fac7fb1b1f2bec90003386a88f91aa7771831,1,6,0,6,1,2011-09-17 00:53:20,2011-09-15 15:21:04
145fac7fb1b1f2bec90003386a88f91aa7771831...558241166c4f3c516e5a448e676db0b57119212f,5,64,12,76,10,2011-09-17 00:54:20,2011-09-16 22:40:39
558241166c4f3c516e5a448e676db0b57119212f...dcd911e24b3cd8bdcc850e4c90213fcd6b180251,1,2,2,4,1,2011-09-17 01:38:46,2011-09-17 01:38:46
dcd911e24b3cd8bdcc850e4c90213fcd6b180251...5b8e1dabbc117b38c56f874f4e6d5b7e537cd3c1,49,17615,7,17622,56,2011-09-18 01:22:09,2011-09-06 23:13:05
5b8e1dabbc117b38c56f874f4e6d5b7e537cd3c1...d104bfd5a6d825c58a09e325b7475183d2738849,3,19,13,32,13,2011-09-18 06:03:23,2011-09-18 06:03:23
d104bfd5a6d825c58a09e325b7475183d2738849...f90264d2462e0e24b9a4479b23443c518d24ef0d,1,35,15,50,7,2011-09-18 06:03:36,2011-09-18 06:03:36
f90264d2462e0e24b9a4479b23443c518d24ef0d...100fc27ebb071b7833e0c6f0c10145206ad257e7,7,393,98,491,49,2011-09-18 19:25:30,2011-09-18 19:08:43
100fc27ebb071b7833e0c6f0c10145206ad257e7...12798c620d61a2e67f4cd76b774d4000affa43b0,1,21,29,50,19,2011-09-18 20:20:16,2011-09-18 20:20:16
12798c620d61a2e67f4cd76b774d4000affa43b0...243c218c7a768a5800f729fad02e8a22220d91f1,1,0,3,3,1,2011-09-19 14:28:22,2011-09-19 14:28:22
243c218c7a768a5800f729fad02e8a22220d91f1...3aa1975c5837a160b849d2b81fc7a4bcd7870155,1,1,1,2,1,2011-09-19 14:44:03,2011-09-19 14:43:53
3aa1975c5837a160b849d2b81fc7a4bcd7870155...6326b04b071c240955200bd92a080483d0397344,1,5,0,5,1,2011-09-19 20:41:48,2011-09-19 20:41:42
6326b04b071c240955200bd92a080483d0397344...44bebc0d52dd5b769b433e1519c37e70e1b604ca,1,16,14,30,5,2011-09-20 06:12:35,2011-09-19 20:24:43
44bebc0d52dd5b769b433e1519c37e70e1b604ca...ff05beeef33e9d48955ca5739e067d2aa1ffffdc,1,1,1,2,1,2011-09-20 15:35:15,2011-09-20 08:14:41
ff05beeef33e9d48955ca5739e067d2aa1ffffdc...4ff15512f571622e879680ab02010be92e4bb040,1,11,17,28,1,2011-09-20 15:35:15,2011-09-20 08:18:05
4ff15512f571622e879680ab02010be92e4bb040...c8ffbcd9f1a182bd16bbe664197b4b8d9d4d859f,1,49,14,63,29,2011-09-20 15:35:15,2011-09-20 08:30:39
c8ffbcd9f1a182bd16bbe664197b4b8d9d4d859f...292e2ea5add821645540d12fde57a2546ed77463,1,9,5,14,3,2011-09-20 15:35:15,2011-09-17 08:38:06
292e2ea5add821645540d12fde57a2546ed77463...41a41825f62c8bf428420148b187d78966fc5c7e,1,8,6,14,4,2011-09-20 15:35:15,2011-09-20 10:04:35
41a41825f62c8bf428420148b187d78966fc5c7e...a0556fcbe1a404a023785e4ac983b20873976df7,1,7,0,7,1,2011-09-20 15:35:15,2011-09-20 10:05:01
a0556fcbe1a404a023785e4ac983b20873976df7...b20c98e42708668c564d5f83bad83cf074cf4f58,1,2,0,2,1,2011-09-20 15:35:16,2011-09-20 10:12:32
b20c98e42708668c564d5f83bad83cf074cf4f58...6b98a6397468a802603d1566a45b4b578ae64ed4,13,86,12,98,27,2011-09-20 20:34:52,2011-09-20 20:34:52
6b98a6397468a802603d1566a45b4b578ae64ed4...c1ae6ea2f2abc6ca019cae9a171b5b52c725da68,5,119,0,119,5,2011-09-20 20:39:48,2011-09-20 20:38:07
c1ae6ea2f2abc6ca019cae9a171b5b52c725da68...ae0dd0d89ce4106d89657003208191a564651ae8,1,0,1,1,1,2011-09-20 21:08:55,2011-09-20 21:08:53
ae0dd0d89ce4106d89657003208191a564651ae8...1e7a0aa8837dd9244a4941560b2a20da1b4aa60d,1,50,20,70,13,2011-08-17 05:50:58,2011-09-20 21:48:03
1e7a0aa8837dd9244a4941560b2a20da1b4aa60d...0f077a78ad3cc43e847bbd7d797b923d8bf8ea5c,1,6,0,6,2,2011-08-17 05:50:58,2011-08-17 04:12:09
0f077a78ad3cc43e847bbd7d797b923d8bf8ea5c...52037d897d06fdb764e2fefc07352011b6a3f3d3,5,22,24,46,12,2011-08-17 05:50:58,2011-08-17 04:45:21
52037d897d06fdb764e2fefc07352011b6a3f3d3...decd81838abb265a81b71b379931199c1d5e2c77,1,8,1,9,1,2011-08-17 05:50:59,2011-08-17 05:44:53
decd81838abb265a81b71b379931199c1d5e2c77...b185751c3f8a9575263903bdcad528b5de470051,1,1,1,2,1,2011-09-20 23:58:27,2011-09-20 23:11:07
b185751c3f8a9575263903bdcad528b5de470051...320cf729db9ca75a17892fb2e3abd21176ff983b,1,1,0,1,1,2011-09-20 23:58:27,2011-09-20 23:57:36
320cf729db9ca75a17892fb2e3abd21176ff983b...3148f1400e0be04f9f7b3a8db3ab533e9785bfb8,1,50,18,68,13,2011-09-21 20:27:23,2011-09-21 09:59:20
3148f1400e0be04f9f7b3a8db3ab533e9785bfb8...79fd1f7f0b4e77b1c8660d45cd6628ed6a78ae5b,1,9,5,14,6,2011-09-21 20:27:24,2011-09-21 10:08:31
79fd1f7f0b4e77b1c8660d45cd6628ed6a78ae5b...8efe7a8304e33fce36a8b7add9ed2ba63b647e3d,1,15,16,31,10,2011-09-21 20:27:24,2011-09-21 10:59:04
8efe7a8304e33fce36a8b7add9ed2ba63b647e3d...de0066c697e1875c75551b1b9f7d246e191365be,1,0,1,1,1,2011-09-21 23:54:35,2011-09-21 23:10:34
de0066c697e1875c75551b1b9f7d246e191365be...74c02066fe0e963722b0d7d5a78c703fd14c0275,1,64,0,64,1,2011-09-23 02:38:01,2011-09-23 02:37:19
74c02066fe0e963722b0d7d5a78c703fd14c0275...8d37b6c92b61d9ab66b48ca67fd3e42751f5cf43,23,1050,7,1057,59,2011-09-23 05:29:20,2011-09-23 02:41:43
8d37b6c92b61d9ab66b48ca67fd3e42751f5cf43...8fe5712477e94879664d5d420c72f273c0a888ff,6,349,0,349,7,2011-09-23 05:32:33,2011-09-22 23:18:08
8fe5712477e94879664d5d420c72f273c0a888ff...9ad334085fc9bb4474265ce72c89da241234991e,1,3,0,3,1,2011-09-23 13:40:35,2011-09-23 13:40:35
9ad334085fc9bb4474265ce72c89da241234991e...66293f6e98e957646fab81a3434105374d960d1f,1,5,5,10,5,2011-09-23 16:20:15,2011-09-23 07:45:41
66293f6e98e957646fab81a3434105374d960d1f...1e37efb08bbd1ebd82437b417329b6f8f1639fd0,3,168,4,172,7,2011-09-23 16:38:24,2011-09-22 17:03:46
1e37efb08bbd1ebd82437b417329b6f8f1639fd0...94bedc60f4ea429c9051422916014835374c51d5,11,79,28,107,23,2011-09-23 18:10:18,2011-09-23 18:07:57
94bedc60f4ea429c9051422916014835374c51d5...a4e10cdb0729335a8e15f15387ecb94203723aa2,1,16,9,25,7,2011-09-23 19:00:26,2011-09-23 13:25:20
a4e10cdb0729335a8e15f15387ecb94203723aa2...20100713392f34db7937e779938946bc42c15dff,2,44,19,63,16,2011-09-23 20:42:41,2011-09-22 16:49:59
20100713392f34db7937e779938946bc42c15dff...78d91ff07475e75a4fd2ded66ea10b9f2267b60b,1,3,5,8,4,2011-09-23 20:42:41,2011-09-22 09:47:01
78d91ff07475e75a4fd2ded66ea10b9f2267b60b...e406613ee552bf87837dc7cbbfdba8a6b7caf2c6,2,28,29,57,7,2011-09-23 20:42:41,2011-09-23 15:28:32
e406613ee552bf87837dc7cbbfdba8a6b7caf2c6...39fec6003e2cd52dfcd4e25f6da7f6e54617630d,2,35,33,68,12,2011-09-23 20:42:41,2011-09-23 18:48:04
39fec6003e2cd52dfcd4e25f6da7f6e54617630d...43cb4ec76bba6829fd8ba8cfd2a8c7a3c305fdd9,1,2,1,3,1,2011-09-23 20:42:41,2011-09-15 17:45:32
43cb4ec76bba6829fd8ba8cfd2a8c7a3c305fdd9...fcba1459f2400b59927411578c99a022d41bbbe7,2,22,16,38,15,2011-09-24 03:23:41,2011-09-24 03:23:41
fcba1459f2400b59927411578c99a022d41bbbe7...d1571314390d9a0f8d697d8e70987f7a9e1ef98d,2,25,3,28,5,2011-09-24 16:27:03,2011-09-24 03:07:35
d1571314390d9a0f8d697d8e70987f7a9e1ef98d...6ee676c0e45556f3bf88516dfabfe015c4273f15,1,2,0,2,1,2011-09-25 01:34:12,2011-09-25 01:31:39
6ee676c0e45556f3bf88516dfabfe015c4273f15...d91f64fcbbe583ad9b8a494b0804ac589875840e,1,2,2,4,2,2011-09-25 01:34:19,2011-09-25 01:32:45
d91f64fcbbe583ad9b8a494b0804ac589875840e...9e09fc0508104f0262900116fb2f2371eb7ea86f,2,42,10,52,11,2011-09-25 18:58:22,2011-09-24 05:44:08
9e09fc0508104f0262900116fb2f2371eb7ea86f...2c9bcb28be213b01c559d200f144ef283a706281,1,1,1,2,2,2011-09-25 18:58:22,2011-09-24 06:04:35
2c9bcb28be213b01c559d200f144ef283a706281...9b6acc27aad706505dff937e3b2ae6f8185b0995,1,9,6,15,5,2011-09-25 18:58:22,2011-09-24 06:17:39
9b6acc27aad706505dff937e3b2ae6f8185b0995...26aab0dc5d324bad1fdd6204b6b29e5eafa168a5,1,5,14,19,4,2011-09-25 18:58:22,2011-09-24 07:28:27
26aab0dc5d324bad1fdd6204b6b29e5eafa168a5...82d0ac7ac783e3532fa3f0a833be4721907e0ada,1,21,0,21,3,2011-09-25 18:58:23,2011-09-24 13:51:59
82d0ac7ac783e3532fa3f0a833be4721907e0ada...02e0a0aa10959c3dcc1f44bcdac6cac67b65092e,1,41,30,71,8,2011-09-25 19:38:06,2011-09-25 11:10:21
02e0a0aa10959c3dcc1f44bcdac6cac67b65092e...c26cf84a088fae435d9a9a71cca40cfc7cc57b17,3,25,1,26,6,2011-09-26 17:57:19,2011-09-25 19:20:47
c26cf84a088fae435d9a9a71cca40cfc7cc57b17...c828ded0c2b6905c0f3ce0301e3c76923e9f5dec,1,1,1,2,1,2011-09-26 18:50:20,2011-09-26 18:50:20
c828ded0c2b6905c0f3ce0301e3c76923e9f5dec...040cf0272429547a09a1d6bb1efebe5b613e8c2a,1,46,0,46,1,2011-09-26 19:50:59,2011-09-26 19:47:49
040cf0272429547a09a1d6bb1efebe5b613e8c2a...fa2eaeafdaee2a8b5171e4c8fd4bf7c0b19ef2ac,1,1,1,2,1,2011-09-27 06:25:50,2011-09-27 06:25:48
fa2eaeafdaee2a8b5171e4c8fd4bf7c0b19ef2ac...f4124e18cb64c01975fae41e133a8716775647fd,2,74,31,105,9,2011-09-27 07:26:16,2011-09-27 06:25:31
f4124e18cb64c01975fae41e133a8716775647fd...67706b8bb75fefc6f00b911580cc20646d0166b7,2,4,4,8,4,2011-09-27 09:58:02,2011-09-27 09:57:30
67706b8bb75fefc6f00b911580cc20646d0166b7...c4eaf7e5a90e0b923c5b1aff3ccef09c8ea064a9,4,156,0,156,6,2011-09-27 18:27:53,2011-09-22 18:33:58
c4eaf7e5a90e0b923c5b1aff3ccef09c8ea064a9...413d38c43bc3fa6828e10c75736f81c3d6b7e944,1,70,0,70,1,2011-09-27 18:27:57,2011-09-22 19:26:33
413d38c43bc3fa6828e10c75736f81c3d6b7e944...abfcd1fb00a386c846b77b026e30f0f140a3c2a6,1,18,0,18,1,2011-09-27 18:27:57,2011-09-22 20:12:10
abfcd1fb00a386c846b77b026e30f0f140a3c2a6...0f8f8630433a0f33906bcb673b606a0e7843bee7,2,26,3,29,6,2011-09-27 19:41:59,2011-09-27 19:38:23
0f8f8630433a0f33906bcb673b606a0e7843bee7...95866a64457ae35b6c04f12dfae53194a431a4b1,1,2,2,4,2,2011-09-27 19:49:03,2011-09-27 19:37:56
95866a64457ae35b6c04f12dfae53194a431a4b1...f5bdce9cc0abd5e49674ac5791ba623bc8fda085,3,0,0,0,0,2011-09-27 19:52:48,2011-09-27 19:52:48
67cc5c921866aa7063c68a70a0b70f5f3b64e28b...0f211048a08c1a0c2d641a56f7c00f52309a48c8,9,57,49,106,22,2011-09-11 01:40:40,2011-09-11 01:40:40
0f211048a08c1a0c2d641a56f7c00f52309a48c8...10e7c52a70a8e5c6a817ca47c4c95ecde0c9f663,1,9,8,17,4,2011-09-11 01:52:44,2011-09-11 01:52:44
10e7c52a70a8e5c6a817ca47c4c95ecde0c9f663...55c1546f013f53e73256bd6b3d53fd3c01cf0b71,1,1,1,2,1,2011-09-11 01:54:08,2011-09-11 01:54:08
55c1546f013f53e73256bd6b3d53fd3c01cf0b71...df480e0357b597aa99f0ceb42c14d13129277e9d,1,11,7,18,6,2011-09-11 09:19:42,2011-09-11 07:05:00
df480e0357b597aa99f0ceb42c14d13129277e9d...389e2a07e676e5be3b8cbd94f0a0f7ebccb47f47,2,44,2,46,6,2011-09-11 14:13:06,2011-09-08 16:16:48
389e2a07e676e5be3b8cbd94f0a0f7ebccb47f47...e4ebeb630e770569480cdd6124bd9ad98f027803,1,11,18,29,11,2011-09-12 05:57:43,2011-09-08 23:19:28
e4ebeb630e770569480cdd6124bd9ad98f027803...e58c036c27f460873695d7b7c0a7b00da0bdf962,4,335,16,351,10,2011-09-12 05:57:49,2011-09-11 20:30:01
e58c036c27f460873695d7b7c0a7b00da0bdf962...7dc2c492e9816631aae0eb72c218e0389c5d6e5f,2,59,11,70,10,2011-09-12 06:59:00,2011-09-09 04:16:10
7dc2c492e9816631aae0eb72c218e0389c5d6e5f...7e7e983781e3a422093f373e337a1c23cf3202c7,3,14,2,16,3,2011-09-12 16:41:48,2011-09-12 16:41:48
7e7e983781e3a422093f373e337a1c23cf3202c7...0d80040adfdb4a46dcfcc9bbeea01ad3a51fd4cf,41,91,204,295,103,2011-09-12 21:46:39,2011-09-12 21:45:00
0d80040adfdb4a46dcfcc9bbeea01ad3a51fd4cf...fe7e00d51a05f379ad6323628226ea1b7c0ed339,2,90,18,108,14,2011-09-12 21:48:29,2011-09-01 01:13:49
fe7e00d51a05f379ad6323628226ea1b7c0ed339...9f986981f8b0818e610b0ed73e7341c5d934e762,2,206,66,272,15,2011-09-12 21:48:29,2011-08-29 22:01:43
9f986981f8b0818e610b0ed73e7341c5d934e762...12351a2591c20cabffa0fdd4af04ab541112564c,1,1,1,2,2,2011-09-12 21:48:30,2011-08-30 22:54:59
12351a2591c20cabffa0fdd4af04ab541112564c...d7c16fa37275c0799582f95b6959e13a8884762e,1,1,0,1,1,2011-09-12 21:48:30,2011-08-30 23:57:03
d7c16fa37275c0799582f95b6959e13a8884762e...e4e1917936d42d0d854c7c1467041756f40522b8,1,4,1,5,1,2011-09-12 21:48:30,2011-08-31 19:10:38
e4e1917936d42d0d854c7c1467041756f40522b8...c18ef0fed55d7daf3031850e0a7f4aba4372a69a,1,6,1,7,2,2011-09-12 21:48:30,2011-08-31 19:11:10
c18ef0fed55d7daf3031850e0a7f4aba4372a69a...d104e5b91cfa3ef3ef846d5a0ab07c0336263a92,1,7,0,7,1,2011-09-12 21:48:30,2011-09-02 14:39:04
d104e5b91cfa3ef3ef846d5a0ab07c0336263a92...77e4abbc3e66505af89c57cd7bff555890a33f3f,1,7,0,7,1,2011-09-12 21:48:30,2011-09-02 14:39:44
77e4abbc3e66505af89c57cd7bff555890a33f3f...51f2e8439e4e26f7f3b58193112916c711085c91,10,233,1,234,15,2011-09-12 22:09:26,2011-09-12 21:53:27
51f2e8439e4e26f7f3b58193112916c711085c91...caaa59c559f4ed8b26ab1438f4104f4e93adb098,3,30,12,42,6,2011-09-12 22:09:44,2011-09-12 21:59:51
caaa59c559f4ed8b26ab1438f4104f4e93adb098...718032777d486b9dcedcfeabd9a35e8ab5d5e15b,2,3,7,10,2,2011-09-12 22:52:56,2011-09-12 22:52:56
718032777d486b9dcedcfeabd9a35e8ab5d5e15b...8b6277a4602d72317d99849994b140e88db7ff11,4,5,1,6,4,2011-09-13 00:11:03,2011-09-13 00:10:51
8b6277a4602d72317d99849994b140e88db7ff11...190abcac9debb2f4c729af32f88703d26026a049,1,15,8,23,1,2011-09-13 00:13:12,2011-09-13 00:10:24
190abcac9debb2f4c729af32f88703d26026a049...0aad61e80205baa5e7e4b4bdc81f53f17edc983c,4,26,6,32,9,2011-09-13 00:32:52,2011-09-13 00:19:09
0aad61e80205baa5e7e4b4bdc81f53f17edc983c...0928f0f290c50b72c4f51988b2bd65fd373f24d7,2,63,36,99,17,2011-09-13 01:12:48,2011-09-13 01:10:42
0928f0f290c50b72c4f51988b2bd65fd373f24d7...8c872508166ced35a838292e4b950e7c929c7240,2,1,12,13,4,2011-09-13 01:25:23,2011-09-13 01:25:00
8c872508166ced35a838292e4b950e7c929c7240...cb6b9eb19e68556be5b21aba8b5542b5b4b7da2d,2,19,4,23,4,2011-09-13 02:42:12,2011-09-13 02:42:12
cb6b9eb19e68556be5b21aba8b5542b5b4b7da2d...dc8f4eed53bdf0280de105338523befb99aa0b0d,1,54,0,54,1,2011-09-13 17:59:42,2011-09-13 17:59:42
dc8f4eed53bdf0280de105338523befb99aa0b0d...69c35f990fdce521795a94aa41627d0b9adb2da3,1,5,0,5,1,2011-09-14 03:02:54,2011-09-14 03:02:54
69c35f990fdce521795a94aa41627d0b9adb2da3...57388d8b2ef491b00da9a008d2ca816d3036c9a8,1,3,1,4,1,2011-09-14 03:40:21,2011-09-11 14:52:24
57388d8b2ef491b00da9a008d2ca816d3036c9a8...9fb186892cb64086ba3d5d7a58177f027e765cbb,1,67,50,117,23,2011-09-14 03:40:26,2011-09-13 14:09:18
9fb186892cb64086ba3d5d7a58177f027e765cbb...70a5659a46e10115ac1e98b4271afe450a148d35,1,8,2,10,2,2011-09-14 03:50:49,2011-09-14 03:50:47
70a5659a46e10115ac1e98b4271afe450a148d35...e7f64a7d412c54cf6604a03235d72b0dbce41360,1,37,0,37,2,2011-09-14 11:17:30,2011-09-14 11:17:30
e7f64a7d412c54cf6604a03235d72b0dbce41360...244675cab193746e9ed35b1973e8cd3b09b229de,1,2,0,2,2,2011-09-14 14:48:42,2011-09-14 14:48:42
244675cab193746e9ed35b1973e8cd3b09b229de...92d4ed397bc9cd6591b245c8e4be3c28cf207c28,1,7,3,10,2,2011-09-14 15:33:07,2011-09-14 15:07:58
92d4ed397bc9cd6591b245c8e4be3c28cf207c28...0e0fbf7e6a750b1c9b27edfac6123bee32039537,7,212,63,275,26,2011-09-14 15:43:27,2011-09-14 15:43:27
0e0fbf7e6a750b1c9b27edfac6123bee32039537...f2ec46a7a73423a36cbc7389b8ac3f5910b87e71,1,22,40,62,10,2011-09-14 16:05:01,2011-09-14 06:59:56
f2ec46a7a73423a36cbc7389b8ac3f5910b87e71...3a7713ff10d69aa462c325ae65f806de3d234ce4,1,5,4,9,4,2011-09-14 16:05:04,2011-09-14 08:08:46
3a7713ff10d69aa462c325ae65f806de3d234ce4...19194f87c5a3a6184168babb6f8d2629a2443c0a,1,113,18,131,16,2011-09-14 16:05:04,2011-09-14 09:24:46
19194f87c5a3a6184168babb6f8d2629a2443c0a...1dd3b68c4f502bb39a589a63bbbea33aa04c87c9,1,17,3,20,6,2011-09-14 16:05:04,2011-09-14 09:35:51
1dd3b68c4f502bb39a589a63bbbea33aa04c87c9...d2dadf32dbb607d8ed6e5e6cd98a2bab70e7f8f2,1,22,15,37,2,2011-09-14 17:17:17,2011-09-14 09:36:26
d2dadf32dbb607d8ed6e5e6cd98a2bab70e7f8f2...70966002c05b5da594c219c080207c12709bb8eb,1,4,3,7,3,2011-09-14 19:33:42,2011-09-14 19:33:38
70966002c05b5da594c219c080207c12709bb8eb...a6ef3eb271833721e40938205a4894d9823db237,6,113,84,197,100,2011-09-14 20:46:54,2011-09-14 20:46:07
a6ef3eb271833721e40938205a4894d9823db237...6cb15403d342080fc0ecf0b2675852090fcfb1aa,1,0,11,11,3,2011-09-14 20:47:00,2011-09-14 20:27:44
6cb15403d342080fc0ecf0b2675852090fcfb1aa...f8b90946aec53b453d82dd66a4d812ec86487629,1,7,2,9,1,2011-09-14 22:32:07,2011-09-14 22:28:45
f8b90946aec53b453d82dd66a4d812ec86487629...1b15af9dd2bf4adb7a2e73ae17a12e2e98a88f72,201,4246,2128,6374,1444,2011-09-15 16:42:06,2011-09-15 16:41:08
3222a04d5e8d1fef90ac6247c6febeebe02cf659...14b04b06b4a7f31b3b489abba5e1467678f0f6be,186,445,47961,48406,204,2011-11-15 03:17:42,2011-11-15 03:02:44
14b04b06b4a7f31b3b489abba5e1467678f0f6be...b9e1bb3d92a1a9e07be05acf758fd3da355f9322,1,2,0,2,2,2011-11-15 16:17:05,2011-11-15 16:17:05
b9e1bb3d92a1a9e07be05acf758fd3da355f9322...cf2ee19049a3e2d87e48b3910a0fab6e8d4988e1,1,15,6,21,6,2011-11-15 21:56:11,2011-11-15 21:56:11
cf2ee19049a3e2d87e48b3910a0fab6e8d4988e1...5d0b5a00aac6589091dce4345612d3fccb3c430c,2,78,3,81,6,2011-11-16 20:27:26,2011-11-16 12:38:09
3222a04d5e8d1fef90ac6247c6febeebe02cf659...2cd51ef5d4e2cb51b708f2f4839acdb6e21f090a,1,1,1,2,1,2011-11-15 00:54:24,2011-11-14 18:58:58
2cd51ef5d4e2cb51b708f2f4839acdb6e21f090a...4b0241d5892f91dfac0438f9051c71e790be95ea,1,2,2,4,2,2011-11-15 01:09:44,2011-11-14 20:03:23
4b0241d5892f91dfac0438f9051c71e790be95ea...17a82e72f490c8c384fec9563f58128ef3234034,2,7,2,9,2,2011-11-15 01:17:23,2011-11-15 01:17:23
17a82e72f490c8c384fec9563f58128ef3234034...3b852d7faba82d5ec2367939ecc98c3ab03cb2e6,2,78,3,81,6,2011-11-16 20:30:26,2011-11-16 12:38:09
3b852d7faba82d5ec2367939ecc98c3ab03cb2e6...44314ccf48332c91db57a53d5fc0e3de48642681,10,27,31,58,16,2011-11-16 21:06:10,2011-11-16 21:05:35
f5bdce9cc0abd5e49674ac5791ba623bc8fda085...74b6426ec657aaa36bd3a6beab3f5723006a7ea0,4,429,0,429,5,2011-09-27 20:02:11,2011-09-20 22:57:23
74b6426ec657aaa36bd3a6beab3f5723006a7ea0...1de156abb10e646c05485d95dfce6d1805514822,2,95,47,142,5,2011-09-27 20:03:28,2011-09-23 05:00:00
1de156abb10e646c05485d95dfce6d1805514822...e1dc6e6d73eeb43c3f5366e0f316c91a32e513f9,3,17,21,38,6,2011-09-27 20:03:28,2011-09-23 02:55:15
e1dc6e6d73eeb43c3f5366e0f316c91a32e513f9...2e389c6531022ea571e1563f18a3ced7abf1a748,2,5,7,12,6,2011-09-27 20:03:28,2011-09-23 16:57:58
2e389c6531022ea571e1563f18a3ced7abf1a748...73fcd43b85c474534f19ecbd75edce24dcf50483,1,2,1,3,2,2011-09-27 20:03:28,2011-09-27 14:13:43
73fcd43b85c474534f19ecbd75edce24dcf50483...81425598db4ca99a65f54a69ea58aa34f519bfe9,1,1,5,6,1,2011-09-27 20:03:29,2011-09-27 14:13:59
81425598db4ca99a65f54a69ea58aa34f519bfe9...c06af229dcb066ba6c52f5866daf2e415a99a06e,17,1811,54,1865,51,2011-09-27 20:03:29,2011-09-27 14:16:59
c06af229dcb066ba6c52f5866daf2e415a99a06e...41d811f41fb6ede16038154b2182c4d60deebb59,1,5,4,9,4,2011-09-27 20:11:09,2011-09-27 20:06:35
93dc713670ac9aaef83118de0ffdca428218766d...40cb398867b1aae47aa4add04eb5cf7e8bfc131e,1,2,2,4,1,2011-11-16 21:38:04,2011-11-16 21:38:04
40cb398867b1aae47aa4add04eb5cf7e8bfc131e...8f15582ef333e6091af06f7095b9b785e82eb1ab,1,24,1,25,2,2011-11-17 12:36:29,2011-11-17 12:36:29
8f15582ef333e6091af06f7095b9b785e82eb1ab...4f38c5ece3017923eebf034b815755c98c8c6113,1,75,0,75,1,2011-11-17 15:32:09,2011-11-17 15:30:37
4f38c5ece3017923eebf034b815755c98c8c6113...e2581696669003fdd691c167ff1500ef16dddb32,1,0,3,3,1,2011-11-17 19:21:48,2011-11-17 07:20:06
44314ccf48332c91db57a53d5fc0e3de48642681...5e3b0095de96469a65f6e789e0d2b54d76711463,2,62,4,66,4,2011-11-16 23:01:41,2011-11-16 22:54:43
5e3b0095de96469a65f6e789e0d2b54d76711463...9c70b09e0ac959208f436d14d77ef12b89f68ef4,1,2,0,2,1,2011-11-16 23:10:14,2011-11-16 23:10:14
9c70b09e0ac959208f436d14d77ef12b89f68ef4...3e696d189ca0b22f73baaf367a2a6327bc449ab9,2,2,2,4,2,2011-11-16 23:54:42,2011-11-16 23:54:42
3e696d189ca0b22f73baaf367a2a6327bc449ab9...960ccdc72cefa9c7b9e588a1d149a1dba7a0c296,1,16,7,23,5,2011-11-17 12:15:49,2011-11-09 02:13:59
960ccdc72cefa9c7b9e588a1d149a1dba7a0c296...2c52ccea80e74d813ba678ad2f39bd2079c73bf7,1,7,0,7,1,2011-11-17 18:39:39,2011-09-02 14:39:04
2c52ccea80e74d813ba678ad2f39bd2079c73bf7...4f8a0cd2f9d92135fe6e9e94229d1332dff3e0e0,1,7,0,7,1,2011-11-17 18:39:39,2011-09-02 14:39:44
4f8a0cd2f9d92135fe6e9e94229d1332dff3e0e0...b0030af13566e22cca289595a7e80b76f5e2c2f2,2,2,0,2,2,2011-11-17 19:39:34,2011-11-17 19:39:14
f63a1f84097c6e81eacc5001c8ffa8458ae1f846...0a42266824edc10049f26659c83a35e304866617,1,4,1,5,2,2011-09-27 21:31:30,2011-09-27 17:37:37
0a42266824edc10049f26659c83a35e304866617...7e62bc9828ab0cf322a0769702656f824fe8165c,6,30,41,71,12,2011-09-27 22:01:28,2011-09-27 22:01:12
7e62bc9828ab0cf322a0769702656f824fe8165c...416c14f644fad139b00471719d025e1673279c45,1,0,3,3,3,2011-09-27 22:04:01,2011-09-27 22:04:01
416c14f644fad139b00471719d025e1673279c45...542156a6a17eef4acd5f7084e426ffe56380bb2f,1,17,51,68,9,2011-09-28 18:39:45,2011-09-28 18:17:12
542156a6a17eef4acd5f7084e426ffe56380bb2f...1b8b097fad31124f0d1b784c31e4d6884d31ce83,2,120,109,229,54,2011-09-28 18:40:51,2011-09-27 17:16:29
1b8b097fad31124f0d1b784c31e4d6884d31ce83...fa44659c66c5a9a692b5d675eda8724308174317,1,1,1,2,1,2011-09-29 02:51:40,2011-09-28 23:11:26
fa44659c66c5a9a692b5d675eda8724308174317...005448bdeb5b34761780ddf600c621315945d541,1,0,1,1,1,2011-09-29 16:52:24,2011-09-29 16:50:50
005448bdeb5b34761780ddf600c621315945d541...84641fcdf0b7611a258a152f55441165d7b23314,1,3,1,4,2,2011-09-29 18:35:21,2011-09-29 18:35:17
84641fcdf0b7611a258a152f55441165d7b23314...530082932d8a321095d9aba33d81be01da630022,1,1,1,2,1,2011-09-30 08:05:50,2011-09-30 08:05:50
530082932d8a321095d9aba33d81be01da630022...49806864e489dd73bdda56ec66a1c8a9450fa4a7,1,56,0,56,1,2011-09-30 16:56:37,2011-09-30 16:47:01
49806864e489dd73bdda56ec66a1c8a9450fa4a7...d1e6a1317958ac3bcc252609d799aee11c50ca85,94,12528,736,13264,485,2011-09-30 20:12:12,2011-09-30 18:22:38
d1e6a1317958ac3bcc252609d799aee11c50ca85...4e43afd9737f6c2f1b51d8dbfbb2bc42fabc4deb,1,2,2,4,2,2011-09-30 20:12:29,2011-09-30 20:11:47
4e43afd9737f6c2f1b51d8dbfbb2bc42fabc4deb...360ce526fd5391a955005b27f327bda83acac6dd,2,94,4,98,11,2011-09-30 20:22:56,2011-09-29 18:18:35
360ce526fd5391a955005b27f327bda83acac6dd...7cc17a0cea1d25188c103745a7d0c24375e3a609,4,32,9,41,7,2011-09-30 20:59:44,2011-09-30 20:59:44
7cc17a0cea1d25188c103745a7d0c24375e3a609...8f23fd545d1f479397a71ab641dd709b424bbd93,1,2,2,4,1,2011-09-30 23:49:30,2011-09-30 23:49:30
8f23fd545d1f479397a71ab641dd709b424bbd93...f30cba2ba4ebeddd72f82e5740588c80d4e05a0e,2,2,0,2,2,2011-10-01 00:01:07,2011-10-01 00:01:07
f30cba2ba4ebeddd72f82e5740588c80d4e05a0e...234afa5be1847dd73da1430918d5f20cf9fceab3,1,51,1,52,2,2011-10-02 00:19:17,2011-10-01 07:28:57
234afa5be1847dd73da1430918d5f20cf9fceab3...8c8d51872361c0a30e56d2497daaf03a04c82849,1,3,2,5,3,2011-10-02 00:25:52,2011-10-01 11:42:42
8c8d51872361c0a30e56d2497daaf03a04c82849...f4f037aa64879585d956992b11d4b3fb24da14ea,1,1,1,2,1,2011-10-02 00:25:52,2011-10-01 11:46:49
f4f037aa64879585d956992b11d4b3fb24da14ea...365fdbfc643ddd5b04bd704aab585c46a58598cf,1,6,0,6,1,2011-10-02 00:25:52,2011-10-01 11:52:24
365fdbfc643ddd5b04bd704aab585c46a58598cf...f1ca48535788d5e14193ba75e9019e4fd4d55306,1,1,1,2,1,2011-10-03 11:40:42,2011-10-03 11:40:42
f1ca48535788d5e14193ba75e9019e4fd4d55306...d9c67aebfff6ec2187890eb24f48edf087e385db,1,33,0,33,2,2011-10-03 14:41:29,2011-10-03 01:57:53
d9c67aebfff6ec2187890eb24f48edf087e385db...976c6b0826e2a2555f63917a4de852af50945868,1,12,0,12,1,2011-10-03 14:50:09,2011-10-03 14:50:09
976c6b0826e2a2555f63917a4de852af50945868...bc7cfd7cd7c2e513a9ac9a2820f3b6f7331735b5,6,417,2341,2758,53,2011-10-04 18:51:34,2011-10-04 18:51:34
bc7cfd7cd7c2e513a9ac9a2820f3b6f7331735b5...627f379f2273341426ab3d5cb7eb4d5c148d500a,30,776,209,985,117,2011-10-04 23:53:20,2011-10-04 23:53:17
627f379f2273341426ab3d5cb7eb4d5c148d500a...87286cc7371886d9856edf424785aaa890ba05a9,175,1237,1191,2428,671,2011-10-06 01:51:06,2011-10-04 22:08:18
87286cc7371886d9856edf424785aaa890ba05a9...97974825681a3760c5d94377975b9d77ca8bf0f4,1,96,57,153,36,2011-10-06 12:36:46,2011-10-06 05:56:50
97974825681a3760c5d94377975b9d77ca8bf0f4...4c1d4411591b99bcd978f7e11e777ec56818e573,1,0,2,2,2,2011-10-06 19:25:13,2011-10-06 19:25:13
4c1d4411591b99bcd978f7e11e777ec56818e573...311fe737e8cfa2880b45f95c53223629142818db,40,1629,647,2276,208,2011-10-06 19:34:24,2011-10-06 19:26:51
311fe737e8cfa2880b45f95c53223629142818db...c344fbc2852adfa495c0701fdf0e577cddfd6305,1,33,0,33,2,2011-10-06 21:59:38,2011-10-06 21:59:38
c344fbc2852adfa495c0701fdf0e577cddfd6305...f018be3b5f6dad3a92cf41706ad5ed74dc221f6e,1,3,0,3,1,2011-10-06 22:02:27,2011-10-06 22:02:27
bed405cfeafddfe7e3c8df5e4b3a93afe6deee08...534e41b4747b9f9311ccbc62d8525963a4d9708a,2,4,4,8,4,2011-11-17 20:17:21,2011-11-17 19:46:40
534e41b4747b9f9311ccbc62d8525963a4d9708a...29d8ff51c85ddd491672ade6f4f3404f0f68e1a4,3,4,14,18,3,2011-11-17 22:48:40,2011-11-17 22:48:40
29d8ff51c85ddd491672ade6f4f3404f0f68e1a4...4f8d6d0834ef7132aa9702f4c83033daf42f9d06,1,1,1,2,1,2011-11-17 22:49:55,2011-11-15 23:52:23
4f8d6d0834ef7132aa9702f4c83033daf42f9d06...48d21dd541929c85ee5bc0d7082811663442a698,2,3,3,6,3,2011-11-18 01:30:30,2011-11-18 01:18:29
48d21dd541929c85ee5bc0d7082811663442a698...1b2d333ee3f3f4deb79e09f07358a4b8aec4933c,19,722,106,828,34,2011-11-18 12:07:01,2011-11-18 12:07:01
1b2d333ee3f3f4deb79e09f07358a4b8aec4933c...a808ab4ac42cbcb3e8d37ff7c19da20cf610b388,1,18,38,56,11,2011-11-18 12:07:13,2011-11-14 21:27:57
a808ab4ac42cbcb3e8d37ff7c19da20cf610b388...585936157c796b0d446cdf68ce753c09b2799638,1,1,1,2,1,2011-11-18 20:03:35,2011-11-18 20:03:35
585936157c796b0d446cdf68ce753c09b2799638...3f862cf1795fb69378489e24ea6f69cbe9897b72,1,23,0,23,1,2011-11-21 11:34:19,2011-10-24 23:57:43
3f862cf1795fb69378489e24ea6f69cbe9897b72...e543b0e95e71539fe1f50bb59df4c24b46ab93f1,1,10,1,11,1,2011-11-22 16:51:19,2011-11-18 22:38:18
e543b0e95e71539fe1f50bb59df4c24b46ab93f1...b3f91f15b2482a8f3e5d37f0e09429a4b4775230,2,1,29,30,7,2011-11-22 16:51:19,2011-11-21 21:57:33
b0030af13566e22cca289595a7e80b76f5e2c2f2...1cb6fe47fce9ad02622b790e398cbbd3d600ec55,1,0,3,3,1,2011-11-17 22:01:39,2011-11-17 07:20:06
1cb6fe47fce9ad02622b790e398cbbd3d600ec55...3ac5f1106d31bad2e47ca158d9bc95afd38afdca,2,4,4,8,4,2011-11-17 22:01:39,2011-11-17 19:46:40
3ac5f1106d31bad2e47ca158d9bc95afd38afdca...9d3faf4f9ae54916ce704dd49e93cbcd5ef6ed5f,4,62,3,65,6,2011-11-17 22:01:39,2011-11-17 21:58:13
9d3faf4f9ae54916ce704dd49e93cbcd5ef6ed5f...06d71ad45769dfcd28b4fcc8ed62fa5c604d8cc8,1,9,4,13,3,2011-11-17 23:00:01,2011-11-16 23:19:46
06d71ad45769dfcd28b4fcc8ed62fa5c604d8cc8...59a9a9b5b02a933cb48f86f625faf2587d38b20c,9,101,48,149,34,2011-11-18 10:13:37,2011-11-17 13:14:43
59a9a9b5b02a933cb48f86f625faf2587d38b20c...8bdf6bae3062b06f947e1cde971e976020a2a490,1,8,0,8,1,2011-11-18 13:18:42,2011-11-18 13:16:06
8bdf6bae3062b06f947e1cde971e976020a2a490...3f92031aeb7e00f9d3594f023b570e17d2756206,6,49,2,51,7,2011-11-18 20:17:09,2011-11-18 13:05:35
3f92031aeb7e00f9d3594f023b570e17d2756206...f004d5aeac0a91a1731575d3ac9a80d710a1f48a,1,5,0,5,1,2011-11-18 20:17:13,2011-11-18 12:47:54
f004d5aeac0a91a1731575d3ac9a80d710a1f48a...975f1930b1c6ec1ee1a9e52e603aec097a088720,1,10,1,11,1,2011-11-18 22:38:44,2011-11-18 22:38:18
975f1930b1c6ec1ee1a9e52e603aec097a088720...a4402f0b2e410b19375a1d5c5fb7fe7f66f3c7f8,4,35,10,45,8,2011-11-18 22:43:03,2011-11-18 21:09:59
a4402f0b2e410b19375a1d5c5fb7fe7f66f3c7f8...61e796decc0fc77ee58d8e69f949220767da5dc8,1,2,2,4,1,2011-11-18 23:22:13,2011-11-18 23:22:13
61e796decc0fc77ee58d8e69f949220767da5dc8...9d1bdbcf05c9f23a9e18caccf305cf63b563c3b8,3,15,32,47,5,2011-11-21 03:22:30,2011-11-21 03:22:30
9d1bdbcf05c9f23a9e18caccf305cf63b563c3b8...4d05f56dcdf897eace79e28d052665c94131cbf9,1,48,0,48,1,2011-11-21 12:59:43,2011-11-20 23:09:07
4d05f56dcdf897eace79e28d052665c94131cbf9...05de01d707cd9a80f34da23445f507f5f2e2c277,1,74,54,128,25,2011-11-21 12:59:43,2011-11-21 12:58:30
05de01d707cd9a80f34da23445f507f5f2e2c277...b488be127a8cf1e59eb257db3f8eaf6efdb0f275,449,33131,4,33135,424,2011-11-21 18:50:52,2011-11-21 17:48:45
b488be127a8cf1e59eb257db3f8eaf6efdb0f275...7defbd27efe49850973f376c63cbf90ccb195468,4,86,1,87,6,2011-11-22 15:01:07,2011-11-22 15:01:07
7defbd27efe49850973f376c63cbf90ccb195468...6035651fad8b1b709d5340833e368e798f377454,1,3,3,6,2,2011-11-22 18:24:41,2011-11-22 18:22:53
6035651fad8b1b709d5340833e368e798f377454...2cd5adc28bcdfb5adcc56b70462703ecf4678a2d,2,15,1,16,2,2011-11-22 20:38:48,2011-11-22 20:38:48
2cd5adc28bcdfb5adcc56b70462703ecf4678a2d...38c49fbc4adae68b3d408d02f390e3bf058e4a6d,2,2,2,4,2,2011-11-22 20:44:01,2011-11-22 20:43:55
38c49fbc4adae68b3d408d02f390e3bf058e4a6d...3abebfea98b9a5b0e048106884c56f9162400ed4,6,81,23,104,14,2011-11-22 20:56:01,2011-11-22 20:54:12
f018be3b5f6dad3a92cf41706ad5ed74dc221f6e...471c5701c30ae0d8abfb2dbd83bd176cf18cb8e2,6,363,245,608,91,2011-10-07 05:31:57,2011-10-05 19:33:05
471c5701c30ae0d8abfb2dbd83bd176cf18cb8e2...f6d889523ddf222ed3739846f3b91918e9223e2d,1,0,0,0,0,2011-10-07 05:56:29,2011-10-07 05:56:29
f6d889523ddf222ed3739846f3b91918e9223e2d...08c12de8e2032f9998eebcd9a7b353fc4570b67f,4,44,15,59,20,2011-10-07 07:47:13,2011-10-07 07:47:13
08c12de8e2032f9998eebcd9a7b353fc4570b67f...26c5905a99538f1c8f5aea131d0e24149625f254,2,120,4,124,7,2011-10-07 07:57:41,2011-10-07 07:57:37
8595981195f8b73fb113a6da2c1449e79b9fcd11...1db9a2adbe5e2509d9fea9299835fc120ad6ba2b,1,3,0,3,1,2011-11-23 12:27:53,2011-11-23 12:19:19
3abebfea98b9a5b0e048106884c56f9162400ed4...246805d3865dc2d8f81037dc7c43069c537a7ed5,1,75,0,75,1,2011-11-22 21:47:20,2011-11-17 15:30:37
246805d3865dc2d8f81037dc7c43069c537a7ed5...6e1e9e2fcb8dd79eada404581c2cc3eb2cd245f8,1,7,3,10,3,2011-11-22 21:48:50,2011-11-22 20:54:17
6e1e9e2fcb8dd79eada404581c2cc3eb2cd245f8...0ba78d5f36256dacf625e96dc40e4e34bacfdd35,2,86,3,89,6,2011-11-22 22:00:48,2011-11-22 21:10:57
0ba78d5f36256dacf625e96dc40e4e34bacfdd35...3ab15cde2516564a2bc4fe6246fe447f07752ed4,138,1630,6819,8449,212,2011-11-23 01:03:58,2011-11-23 00:56:59
3ab15cde2516564a2bc4fe6246fe447f07752ed4...e5cf3f9751c32143e898bf1cd818d42a4f6f1407,4,14,3,17,10,2011-11-23 01:59:18,2011-11-23 00:10:32
e5cf3f9751c32143e898bf1cd818d42a4f6f1407...055a933fa9ecc3df2aefd6ea74dfb7c9fce684d7,1,9,1,10,5,2011-11-23 02:17:12,2011-11-23 02:17:12
055a933fa9ecc3df2aefd6ea74dfb7c9fce684d7...b906e8599662bae8bd518b0f5b732ade54468e05,3,3,0,3,2,2011-11-23 03:23:41,2011-11-23 03:23:41
b906e8599662bae8bd518b0f5b732ade54468e05...ce3ccc8d5ac62f6e583d6eec04598c117e676eef,1,1,4,5,1,2011-11-23 11:56:05,2011-11-23 11:54:45
ce3ccc8d5ac62f6e583d6eec04598c117e676eef...16889e22cc89721807bf166833d4e11dc1d8230a,1,1,1,2,1,2011-11-23 11:56:05,2011-11-23 11:55:49
16889e22cc89721807bf166833d4e11dc1d8230a...cbcf4fe768fc9e046d18e58510c77de17c83ed4d,1,1,1,2,2,2011-11-24 01:19:54,2011-11-24 01:19:54
cbcf4fe768fc9e046d18e58510c77de17c83ed4d...86fba381fdeadc00921d34024bdef357e6a56e6e,2,86,16,102,4,2011-11-24 01:38:34,2011-11-24 01:38:34
86fba381fdeadc00921d34024bdef357e6a56e6e...83152d174cbba36f967cab775260262d98706475,1,1,1,2,1,2011-11-24 18:11:13,2011-11-24 16:00:53
83152d174cbba36f967cab775260262d98706475...a639cf7d84c49a963f628db6fc9f2118a00f4efd,1,81,0,81,1,2011-11-24 18:56:41,2011-11-24 18:56:41
a639cf7d84c49a963f628db6fc9f2118a00f4efd...7244b9cee8d77144507af6f5d9a71f9af11df888,5,37,14,51,9,2011-11-24 18:57:17,2011-11-24 18:57:17
7244b9cee8d77144507af6f5d9a71f9af11df888...55a8a3aad47592e10f3689f579eec1d320ae47aa,1,1,1,2,1,2011-11-24 23:56:05,2011-11-24 23:55:10
55a8a3aad47592e10f3689f579eec1d320ae47aa...d51a0c353b1ca58a164b7a141ac9c81d502ef42c,1,1,0,1,1,2011-11-25 00:01:57,2011-11-25 00:01:17
d51a0c353b1ca58a164b7a141ac9c81d502ef42c...236b217cd705d03713c467b49d4c063f69187ddb,1,13,12,25,11,2011-11-25 00:25:38,2011-11-25 00:25:38
236b217cd705d03713c467b49d4c063f69187ddb...95eb729e6fff5c06ce2825381d9ed875be1b8508,1,10,6,16,6,2011-11-25 01:13:37,2011-11-25 01:13:37
95eb729e6fff5c06ce2825381d9ed875be1b8508...232e8e19a1f7ff482acaba708d30eaea0209467e,1,0,4,4,1,2011-11-25 02:08:27,2011-11-25 02:08:27
232e8e19a1f7ff482acaba708d30eaea0209467e...319580953d69819e07b1162dd6dee218d0d5bb95,1,23,1,24,4,2011-11-25 03:45:35,2011-11-25 03:45:35
319580953d69819e07b1162dd6dee218d0d5bb95...1f16a7b6e541694067178a022b9f7a082a6ce7f1,5,173,42,215,47,2011-11-25 08:35:52,2011-11-25 08:29:06
1f16a7b6e541694067178a022b9f7a082a6ce7f1...5b014e07251857967ecbb4b873f8279b1ffe4e51,1,2,2,4,2,2011-11-25 08:35:52,2011-11-25 08:30:50
5b014e07251857967ecbb4b873f8279b1ffe4e51...a056ef1f398a03c891236f33c5a7efef0688345f,3,5,6,11,6,2011-11-25 09:16:43,2011-11-25 09:16:43
a056ef1f398a03c891236f33c5a7efef0688345f...b480cfaf346a1e2d43d31073bd689bd599e3dae1,1,9,3,12,2,2011-11-25 09:27:30,2011-11-25 09:27:30
b480cfaf346a1e2d43d31073bd689bd599e3dae1...2335c4bb414013d9a826e7ac7738a4f06a440f00,1,9,9,18,9,2011-11-25 10:07:57,2011-11-25 10:07:57
2335c4bb414013d9a826e7ac7738a4f06a440f00...b159c6d62e5756d3f8847419d29c6959ea288b56,4,38,12,50,9,2011-11-25 10:23:28,2011-11-25 10:23:28
51f7ba4147ea5d62f5fde3760402cc1fba4dd7d3...d2ab314e08903fafcd61f77fa6e41e15d200c94b,1,3,0,3,1,2011-10-07 08:08:53,2011-10-07 08:08:53
d2ab314e08903fafcd61f77fa6e41e15d200c94b...b413c77583e4d383a0a7cd4c6c11ff8fdbd312f6,3,16,10,26,8,2011-10-07 08:30:28,2011-10-07 08:30:26
b413c77583e4d383a0a7cd4c6c11ff8fdbd312f6...698455384fca6c274c01048b651a3eefe712f5bb,9,10,270,280,22,2011-10-07 08:31:35,2011-10-07 08:17:51
698455384fca6c274c01048b651a3eefe712f5bb...4561d9e07b1b030ee8248756915879763431b119,1,0,4,4,1,2011-10-07 08:32:54,2011-10-07 08:21:23
4561d9e07b1b030ee8248756915879763431b119...899358e797044dcbeed3399d21dbfdabaa6b0ea4,6,55,6,61,10,2011-10-07 11:03:47,2011-10-07 09:43:44
899358e797044dcbeed3399d21dbfdabaa6b0ea4...fcad5e35fd03ce0066ed4d9b56c93e4d945728fd,1,3,0,3,2,2011-10-07 17:03:23,2011-10-07 17:00:48
fcad5e35fd03ce0066ed4d9b56c93e4d945728fd...10f97f94240cc0321f40bcf075b1f29d4b694824,1,4,4,8,4,2011-10-07 19:33:10,2011-10-07 03:04:39
10f97f94240cc0321f40bcf075b1f29d4b694824...ed65b7b375d5e5584b4133012a9e0b2854351040,1,6,7,13,6,2011-10-07 20:38:23,2011-10-06 19:27:10
ed65b7b375d5e5584b4133012a9e0b2854351040...1bb820a339e64898a4b1d66cfc3e7a6d2e6b8ef0,1,21,18,39,4,2011-10-07 20:38:23,2011-10-06 21:53:27
1bb820a339e64898a4b1d66cfc3e7a6d2e6b8ef0...29ec85047842dc4fc1a6127f90dc1110f7c5483e,1,20,23,43,4,2011-10-07 20:38:23,2011-10-06 23:57:35
29ec85047842dc4fc1a6127f90dc1110f7c5483e...153629c99a8f26efccfc9b75dd1e86741c968f17,2,10,13,23,2,2011-10-07 20:38:23,2011-10-07 01:07:45
153629c99a8f26efccfc9b75dd1e86741c968f17...26c08a3f35f251c86a881aa70a8e709216feb03d,4,106,47,153,27,2011-10-07 20:58:55,2011-10-07 20:58:49
26c08a3f35f251c86a881aa70a8e709216feb03d...a23d8ad3132ceb1a73fb02bcaf119a11a9d33e85,9,75,40,115,29,2011-10-07 22:20:35,2011-10-07 22:20:33
a23d8ad3132ceb1a73fb02bcaf119a11a9d33e85...12486a6437c7615af52f3d239f0b5a3000aee45d,4,68,72,140,26,2011-10-07 23:43:55,2011-10-07 23:43:53
12486a6437c7615af52f3d239f0b5a3000aee45d...af014c1a5efce54a8154d8758657852954685e0c,1,18,8,26,6,2011-10-08 00:48:47,2011-10-08 00:08:48
af014c1a5efce54a8154d8758657852954685e0c...d3f3f2e455aa2792769634c76f5ee733e65a7b38,1,1,0,1,1,2011-10-08 00:52:07,2011-10-08 00:18:26
d3f3f2e455aa2792769634c76f5ee733e65a7b38...326ba25451d41adced0f9e9f43b35dc422451dd7,1,6,2,8,2,2011-10-10 13:37:09,2011-10-10 13:37:07
326ba25451d41adced0f9e9f43b35dc422451dd7...025f5c89c76fb7b64a1a8bbd2b2ec91ea171660a,4,69,20,89,17,2011-10-10 14:56:02,2011-10-10 14:56:02
025f5c89c76fb7b64a1a8bbd2b2ec91ea171660a...0fec21365612621cedaabeec6300d97e49c601c0,3,23,24,47,6,2011-10-10 18:36:00,2011-10-10 18:31:40
0fec21365612621cedaabeec6300d97e49c601c0...56e6952e639ba1557a5b22333788583e9e39fa29,282,29520,15452,44972,5322,2011-10-10 18:52:42,2011-10-10 18:52:42
56e6952e639ba1557a5b22333788583e9e39fa29...4f91b72dbe46460888ae45b3eef7707f4a9f1b36,1,2,1,3,1,2011-10-10 19:44:20,2011-10-10 18:46:36
4f91b72dbe46460888ae45b3eef7707f4a9f1b36...7cf787a2d145ef118d983e4df693587a5c78f3ea,8,35,13,48,13,2011-10-10 20:33:45,2011-10-10 20:30:10
7cf787a2d145ef118d983e4df693587a5c78f3ea...e6092f337cdbeef3bb50a572a9c18dd9a8f02c34,1,1,0,1,1,2011-10-10 20:41:04,2011-10-10 20:41:04
e6092f337cdbeef3bb50a572a9c18dd9a8f02c34...6b9f5599849045a1f07cc9b9aca23d7a02aa5260,1,12,6,18,4,2011-10-10 20:52:37,2011-10-10 20:50:47
6b9f5599849045a1f07cc9b9aca23d7a02aa5260...2c25507b81a18ab927071f8383fb73f65e7453d3,3,72,62,134,13,2011-10-10 21:15:44,2011-10-10 20:52:18
2c25507b81a18ab927071f8383fb73f65e7453d3...982b19dbd79302eabdd1e2c58b1c33b641209f34,2,2,57,59,3,2011-10-10 21:24:56,2011-10-10 21:24:56
982b19dbd79302eabdd1e2c58b1c33b641209f34...ca4a0fce658da9fc0a0fea95eb3d651f66d62bb6,2,0,34,34,2,2011-10-10 21:27:52,2011-10-10 21:27:52
ca4a0fce658da9fc0a0fea95eb3d651f66d62bb6...8c738fa90c137932eb276cef3e48fadf6e56b234,1,2,1,3,1,2011-10-10 21:49:02,2011-10-10 21:49:02
8c738fa90c137932eb276cef3e48fadf6e56b234...75cfc77527e8b1e42f11644354ef982413843b2e,2,2,6,8,3,2011-10-11 00:05:18,2011-10-11 00:05:18
75cfc77527e8b1e42f11644354ef982413843b2e...9bbca99107652906a060679ee95bf1ad7381cbb5,1,126,15,141,10,2011-10-11 00:06:24,2011-10-10 22:32:54
9bbca99107652906a060679ee95bf1ad7381cbb5...3b1d656da56bdd403d1625a0c6a44d75cde36cc1,282,15446,29514,44960,5325,2011-10-11 00:58:30,2011-10-11 00:58:30
3b1d656da56bdd403d1625a0c6a44d75cde36cc1...07703fa78e9887a5a46a6eab0f1a6aee9a333b50,1,15,126,141,10,2011-10-11 01:18:12,2011-10-11 01:17:17
07703fa78e9887a5a46a6eab0f1a6aee9a333b50...3bd9b08fb125b606f97a4079b147accfdeebb07d,5,38,9,47,8,2011-10-11 01:18:56,2011-10-10 21:43:15
3bd9b08fb125b606f97a4079b147accfdeebb07d...24dabec039a83b52ebe1d8ff971caceda26b948e,1,2,2,4,1,2011-10-11 01:56:37,2011-10-11 01:56:37
24dabec039a83b52ebe1d8ff971caceda26b948e...c215262db4421e466d6110f03cd2e19c77a0a4df,1,25,5,30,4,2011-10-11 14:56:43,2011-10-11 14:56:43
c215262db4421e466d6110f03cd2e19c77a0a4df...6cb1d26924f5dc5416bdb8e04031ad1b41bbc7b5,1,3,0,3,1,2011-10-11 15:21:35,2011-10-11 15:21:27
6cb1d26924f5dc5416bdb8e04031ad1b41bbc7b5...6a371834d8b2e0d36649dcdedc421d905d70c306,14,0,732,732,14,2011-10-11 16:58:38,2011-10-11 16:58:35
6a371834d8b2e0d36649dcdedc421d905d70c306...a29421bcfd6b2c1bca9bb00df9bd11a2d36465b2,1,0,97,97,1,2011-10-11 17:07:36,2011-10-11 17:07:33
a29421bcfd6b2c1bca9bb00df9bd11a2d36465b2...4f4f6dfce8522bc1a10cfc40b3bb5d9b8f77f22f,1,0,33,33,1,2011-10-11 17:08:09,2011-10-11 17:08:09
4f4f6dfce8522bc1a10cfc40b3bb5d9b8f77f22f...b280a2d44d8826418e0231af6a7a13f1d91b6a5f,1,0,88,88,1,2011-10-11 17:08:49,2011-10-11 17:08:47
b280a2d44d8826418e0231af6a7a13f1d91b6a5f...6fadbec797bb7bb0160fb24c253be49961970945,7,143,2,145,11,2011-10-11 17:29:03,2011-09-14 21:51:49
6fadbec797bb7bb0160fb24c253be49961970945...728b04067dfcfdf260f98abbbea51698b18b281a,3,71,72,143,3,2011-10-11 17:51:07,2011-10-11 17:51:05
728b04067dfcfdf260f98abbbea51698b18b281a...53c163cd5b2a24a4382b70817b99b501839f228d,2,9,6,15,3,2011-10-11 18:27:58,2011-10-11 18:27:58
53c163cd5b2a24a4382b70817b99b501839f228d...49c3a910c67df8e8eeb3d33d284de29439b1e0e4,1,1,1,2,1,2011-10-11 19:05:45,2011-10-11 19:05:45
49c3a910c67df8e8eeb3d33d284de29439b1e0e4...178e2ce65fe4609a3f4c9a22d569b6d080bd5134,3,30,20,50,11,2011-10-11 19:44:09,2011-10-11 19:14:00
178e2ce65fe4609a3f4c9a22d569b6d080bd5134...d2b8037ed0a1724c41827718810421a6bb7cf97b,1,0,0,0,0,2011-10-11 20:03:29,2011-10-11 19:50:05
d2b8037ed0a1724c41827718810421a6bb7cf97b...be0bb2dc136ca20b44da81cded790417cbd1cfd2,13,2,3544,3546,19,2011-10-11 20:11:54,2011-10-11 20:07:14
be0bb2dc136ca20b44da81cded790417cbd1cfd2...96e423a6652185cc52f73915a74f4d862ec34120,9,1,1082,1083,10,2011-10-11 20:16:33,2011-10-11 20:16:33
96e423a6652185cc52f73915a74f4d862ec34120...58e892dadd4a93da74fca40a4d0b4d57fd5ce0fb,9,1,1186,1187,9,2011-10-11 20:21:30,2011-10-11 20:21:30
58e892dadd4a93da74fca40a4d0b4d57fd5ce0fb...71cce3f45bc677b4a6d12e4f590bb2503252ec89,4,1,316,317,3,2011-10-11 20:26:41,2011-10-11 20:26:41
71cce3f45bc677b4a6d12e4f590bb2503252ec89...cdf5d91fe56c82f61010ddd9035f3708b51e8b74,11,37,606,643,18,2011-10-11 20:41:33,2011-10-11 20:41:33
cdf5d91fe56c82f61010ddd9035f3708b51e8b74...4f59041990b1e47597eae396ab46879deb5bbea6,2,4,1,5,3,2011-10-11 21:25:50,2011-10-11 21:25:50
4f59041990b1e47597eae396ab46879deb5bbea6...c8dbaf579c0a8a479183ca9036be0abfda72a33d,2,1,34,35,10,2011-10-11 21:39:31,2011-10-11 21:38:38
c8dbaf579c0a8a479183ca9036be0abfda72a33d...9631e29933c3ac8a568ee8af6f0500e381d88d23,3,39,144,183,10,2011-10-11 21:47:02,2011-10-11 21:46:55
9631e29933c3ac8a568ee8af6f0500e381d88d23...0e2bbac4e0eb891f9c8e16c4650d17d95d30d813,1,5,8,13,5,2011-10-11 21:49:39,2011-10-11 21:49:39
0e2bbac4e0eb891f9c8e16c4650d17d95d30d813...83fce7570098790e4a72c3d408b3ac2b789bf6dd,4,0,1096,1096,4,2011-10-11 21:59:39,2011-10-11 21:59:39
83fce7570098790e4a72c3d408b3ac2b789bf6dd...7085a04a1e0d765e0ef36795116508869bcdcec8,1,0,12,12,1,2011-10-11 22:17:32,2011-10-11 22:17:32
7085a04a1e0d765e0ef36795116508869bcdcec8...e0b59e7dbcd5496fc77bf6e39da19196367a2388,1,0,11,11,1,2011-10-11 22:20:12,2011-10-11 22:20:09
e0b59e7dbcd5496fc77bf6e39da19196367a2388...f1647043830a89dfdbcb6375a12074a6de90cea7,1,49,0,49,2,2011-10-12 01:28:16,2011-10-11 23:01:37
f1647043830a89dfdbcb6375a12074a6de90cea7...2b46959075062c410d9e4f69f4decaef3dc5abd9,2,46,0,46,2,2011-10-12 05:40:04,2011-10-12 05:40:04
2b46959075062c410d9e4f69f4decaef3dc5abd9...99757cbeb22d34c8365637988e16db07fc380ec8,1,8,2,10,3,2011-10-12 05:50:16,2011-10-12 05:34:51
99757cbeb22d34c8365637988e16db07fc380ec8...87339a22b1cc539259c02119bd7381006d56396d,4,260,25,285,8,2011-10-12 09:58:35,2011-10-12 09:56:29
87339a22b1cc539259c02119bd7381006d56396d...752571c7ba847a1c78c232f48b50c25cff21e231,1,0,1,1,1,2011-10-12 13:47:20,2011-10-12 13:47:20
752571c7ba847a1c78c232f48b50c25cff21e231...c82828ec278c3792ada33d60414da76c3d20b6b1,1,31,0,31,1,2011-10-12 15:37:30,2011-10-12 14:28:46
c82828ec278c3792ada33d60414da76c3d20b6b1...bc96302fae117d36fad47adc1eec1fd7a8d5adb2,17,255,52,307,53,2011-10-12 15:37:35,2011-10-12 15:32:47
bc96302fae117d36fad47adc1eec1fd7a8d5adb2...6ed8d41ddd657116199ea186a7860057b539d097,1,3,1,4,1,2011-10-12 15:44:47,2011-10-12 15:44:12
6ed8d41ddd657116199ea186a7860057b539d097...b8966872b3694805135febffcd4e11e4a2bffaa0,6,199,4,203,10,2011-10-12 19:27:46,2011-10-12 19:27:46
b8966872b3694805135febffcd4e11e4a2bffaa0...16e1d5b5ceb43610dac3d73d5ea063f5e182d8bb,1,0,23,23,2,2011-10-12 19:29:40,2011-10-12 19:29:40
16e1d5b5ceb43610dac3d73d5ea063f5e182d8bb...25ff181300550005d1d3ca990929d874453872a8,1,42,48,90,15,2011-10-12 19:49:58,2011-10-12 19:46:41
25ff181300550005d1d3ca990929d874453872a8...08cb8fce6737262a6817716976be1536a8fbd0b6,1,0,1,1,1,2011-10-12 21:10:37,2011-10-12 21:10:30
08cb8fce6737262a6817716976be1536a8fbd0b6...de7fb3387980666f40ea5224992bc4068c430a6d,2,24,0,24,2,2011-10-12 21:19:32,2011-10-12 21:19:32
de7fb3387980666f40ea5224992bc4068c430a6d...73b4b86d29ada97e95198307412bd153a3f79a06,1,1,0,1,1,2011-10-12 21:51:25,2011-10-12 21:51:25
73b4b86d29ada97e95198307412bd153a3f79a06...59be97532269a208f0121060772528690a63677b,1,5,4,9,4,2011-10-12 22:06:51,2011-10-12 00:54:55
59be97532269a208f0121060772528690a63677b...9557020dc1bd2960313e1db52fbccb2bf3005ff8,1,60,1,61,1,2011-10-12 22:10:19,2011-09-06 19:28:15
9557020dc1bd2960313e1db52fbccb2bf3005ff8...651b8a06d6df9de7bdd4eba0a4fd95ed9b579edf,2,1,3,4,2,2011-10-12 23:12:24,2011-10-12 23:11:55
651b8a06d6df9de7bdd4eba0a4fd95ed9b579edf...7b4370e5f8d3a6faf9fc42c48ddd7a2137bea022,2,2,4,6,2,2011-10-12 23:19:46,2011-10-12 23:18:42
7b4370e5f8d3a6faf9fc42c48ddd7a2137bea022...e911171e03f0c5af9517a55d46116b153c83c7c5,2,0,0,0,0,2011-10-12 23:59:00,2011-10-12 23:59:00
e911171e03f0c5af9517a55d46116b153c83c7c5...e3d2ae0bfd4ade225b44aa990f20d8de72fc8ded,1,1,1,2,1,2011-10-13 00:21:37,2011-10-12 18:50:42
e3d2ae0bfd4ade225b44aa990f20d8de72fc8ded...39987cbc80d8983cb68977a1dab47a30f0076186,1,34,19,53,4,2011-10-13 00:25:30,2011-10-11 22:30:29
39987cbc80d8983cb68977a1dab47a30f0076186...3a349726720b609fb19f06e0a870f6f400e19a6e,2,11,5,16,5,2011-10-13 00:31:49,2011-10-13 00:31:32
3a349726720b609fb19f06e0a870f6f400e19a6e...f243ca199b2df647738294f1d46e8aee82b4ba7a,1,1,1,2,1,2011-10-13 03:06:42,2011-10-13 01:20:03
f243ca199b2df647738294f1d46e8aee82b4ba7a...1b55010a04be4401abc2aad12984e1eb337222f2,1,4,3,7,2,2011-10-13 08:06:27,2011-10-13 08:06:27
1b55010a04be4401abc2aad12984e1eb337222f2...5faff9ebdf22e0c7a63e851015d5f313f68bb93e,1,44,0,44,1,2011-10-13 13:47:05,2011-10-13 13:36:28
5faff9ebdf22e0c7a63e851015d5f313f68bb93e...fab68aa1edb942cd76a874fe3bca491837bbd528,1,58,17,75,7,2011-10-13 13:48:02,2011-10-13 02:56:11
fab68aa1edb942cd76a874fe3bca491837bbd528...4b0e36810a5afddc45c5c069055659137adbfa5f,2,20,1,21,2,2011-10-13 14:09:14,2011-10-12 10:06:16
4b0e36810a5afddc45c5c069055659137adbfa5f...683c1c6583d749324087cdd821a49ff53f12f179,1,15,0,15,1,2011-10-13 15:02:54,2011-10-13 14:10:24
683c1c6583d749324087cdd821a49ff53f12f179...66a10b6e581a62fc3844624d1190b3a81af3e47c,1,26,1,27,2,2011-10-13 16:10:01,2011-09-10 12:55:58
66a10b6e581a62fc3844624d1190b3a81af3e47c...59a5262041dce0760b1f960a900eca8b8ca1138f,3,53,0,53,3,2011-10-13 23:47:51,2011-10-13 23:37:49
59a5262041dce0760b1f960a900eca8b8ca1138f...33b5f2f7799081eafe04df3278aad40fd4ae3b55,306,32385,17109,49494,5810,2011-10-14 00:45:02,2011-10-14 00:45:02
33b5f2f7799081eafe04df3278aad40fd4ae3b55...f1d3ae77530b30e2ebbef9bf9e1c8b3553251226,1,1,1,2,1,2011-10-14 14:39:25,2011-10-14 14:39:21
f1d3ae77530b30e2ebbef9bf9e1c8b3553251226...dc0b7364b51af680d866f6a7267da0e85eef07ec,1,1,1,2,1,2011-10-14 14:43:49,2011-10-14 14:43:49
dc0b7364b51af680d866f6a7267da0e85eef07ec...0dc844de17c0d5fa024b9670b31f6448679b7ba5,1,0,1,1,1,2011-10-14 15:01:21,2011-10-14 14:50:38
0dc844de17c0d5fa024b9670b31f6448679b7ba5...9193062e70a23f3102dd3ed11ee8e39b14754e3d,1,10,0,10,5,2011-10-14 15:01:26,2011-10-14 14:58:41
9193062e70a23f3102dd3ed11ee8e39b14754e3d...87b34c94fa47cac4be62011e448f8e2cffc73ca6,1,3,0,3,2,2011-10-14 15:01:26,2011-10-14 15:00:37
87b34c94fa47cac4be62011e448f8e2cffc73ca6...e0297ca59b748eb7912aab0eebc9e49952dd4835,1,1,1,2,1,2011-10-14 15:05:02,2011-10-14 15:05:02
e0297ca59b748eb7912aab0eebc9e49952dd4835...a09b747f30284b058b78ae71cf04380abc8d2a93,2,4,2,6,3,2011-10-14 15:15:38,2011-10-14 08:04:04
a09b747f30284b058b78ae71cf04380abc8d2a93...19a855382c5c0b2e8db569e5fbb03ea52570dc64,6,129,1,130,8,2011-10-14 15:54:46,2011-09-21 04:19:22
19a855382c5c0b2e8db569e5fbb03ea52570dc64...3108a9ee3831b8b0a40a09314a005ef2430dacbc,11,680,114,794,122,2011-10-14 22:42:10,2011-10-14 22:42:10
3108a9ee3831b8b0a40a09314a005ef2430dacbc...018e110cd11720997e49c9b270ecc50a04de4ece,126,421,421,842,407,2011-10-14 23:08:36,2011-10-14 23:08:36
018e110cd11720997e49c9b270ecc50a04de4ece...b6a869ef4f7da353a7dfdba49c35483d94be5699,1,3,0,3,1,2011-10-14 23:08:41,2011-10-14 23:01:57
b6a869ef4f7da353a7dfdba49c35483d94be5699...e6f147141e4f187ef650c192efc9edee5138031d,1,83,3,86,3,2011-10-14 23:15:08,2011-10-14 16:20:05
e6f147141e4f187ef650c192efc9edee5138031d...4908e5bf7a9c8014eefcf344e958bf0dad95d907,1,126,15,141,10,2011-10-14 23:29:35,2011-10-10 22:32:54
4908e5bf7a9c8014eefcf344e958bf0dad95d907...2f8596ee107261f12fc226fc70c0bcc4da535f44,1,2,2,4,1,2011-10-15 00:07:57,2011-10-15 00:05:33
2f8596ee107261f12fc226fc70c0bcc4da535f44...107b05772a0bdc2e5f2460c8352232e2e8a3b246,1,0,1,1,1,2011-10-15 00:12:53,2011-10-14 23:58:18
107b05772a0bdc2e5f2460c8352232e2e8a3b246...971c3d90eb1140dc6a5a0df09f7c375ead28d8de,1,0,15,15,3,2011-10-15 00:50:16,2011-10-15 00:47:01
971c3d90eb1140dc6a5a0df09f7c375ead28d8de...6df574b744f376b18a6697595717c9fd6abd59e9,2,19,9,28,9,2011-10-15 01:24:34,2011-10-15 01:10:53
6df574b744f376b18a6697595717c9fd6abd59e9...0b92fa0e9326a395e3b5368091e2008be2ba8ae3,1,7,1,8,2,2011-10-15 01:34:09,2011-10-15 01:27:25
0b92fa0e9326a395e3b5368091e2008be2ba8ae3...68cc173c6d2cde4f1869b24ec3bc690ef34da7ad,3,77,10,87,8,2011-10-15 10:27:21,2011-10-15 10:27:21
68cc173c6d2cde4f1869b24ec3bc690ef34da7ad...86a67f15a0fac48a093d0e7217ac6942cbb7a106,1,89,60,149,3,2011-10-15 16:26:38,2011-10-15 16:26:38
86a67f15a0fac48a093d0e7217ac6942cbb7a106...d6191f593df6c4e09f4a1dba14a868ddb74dfe75,2,45,6,51,3,2011-10-15 16:30:19,2011-10-15 08:10:14
d6191f593df6c4e09f4a1dba14a868ddb74dfe75...5ca3dcd127bfc2f577bcde50d04c0d4fa34a0c8c,2,15,4,19,6,2011-10-15 20:55:24,2011-10-15 19:21:15
5ca3dcd127bfc2f577bcde50d04c0d4fa34a0c8c...cdec7e3ae50636b58210ec1fe43498390374655d,1,27,14,41,12,2011-10-16 07:50:16,2011-10-16 07:31:41
cdec7e3ae50636b58210ec1fe43498390374655d...f90ba614782cf254a2d3489ec513a8249351c94f,1,5,2,7,1,2011-10-16 16:14:45,2011-10-13 08:48:30
f90ba614782cf254a2d3489ec513a8249351c94f...d2698d182271c77bc5bca44a9cee625d9372301f,1,66,0,66,1,2011-10-17 07:14:35,2011-10-16 15:32:13
d2698d182271c77bc5bca44a9cee625d9372301f...d77ce4b9989d143c7b5ab7640bd6c0cbe261e458,4,6,41,47,9,2011-10-18 20:12:50,2011-10-11 23:06:40
d77ce4b9989d143c7b5ab7640bd6c0cbe261e458...5783a52a9c6dc12f6d60f69cb095efec84468373,12,11,24,35,24,2011-10-18 21:31:37,2011-10-18 21:30:31
5783a52a9c6dc12f6d60f69cb095efec84468373...dbfc8198a6879a0764314db701b610ca2f0c038b,11,341,170,511,111,2011-10-18 21:39:39,2011-10-18 21:38:48
dbfc8198a6879a0764314db701b610ca2f0c038b...6cc0c9e6a9a26d6604990993003aa8c7b8dcae0e,1,1,3,4,1,2011-10-18 22:12:18,2011-10-18 22:12:16
6cc0c9e6a9a26d6604990993003aa8c7b8dcae0e...d9bc8455cbda69df5c477f971176471cde45a5f6,1,9,5,14,1,2011-10-18 23:12:07,2011-10-18 23:12:07
d9bc8455cbda69df5c477f971176471cde45a5f6...200df8641b43902adc73cce6b89d3e84a91dd3e6,7,54,171,225,13,2011-10-19 00:56:35,2011-10-14 07:42:18
200df8641b43902adc73cce6b89d3e84a91dd3e6...b70fed48a7fb0ac884e6574253a89db6158b2f60,3,40,103,143,18,2011-10-19 01:18:32,2011-10-18 01:24:12
b70fed48a7fb0ac884e6574253a89db6158b2f60...6a72e525202972fe5d5a89cc94f48071380c1aa7,1,6,11,17,4,2011-10-19 06:03:00,2011-10-17 13:13:18
6a72e525202972fe5d5a89cc94f48071380c1aa7...b0f78afe58d54c6a062c7ce1616c58d424796069,2,71,0,71,4,2011-10-19 10:59:16,2011-10-18 13:15:58
b0f78afe58d54c6a062c7ce1616c58d424796069...9d27faa2c4147e3aa8c8b83ce91330f8ae96798b,7,171,54,225,13,2011-10-19 18:01:08,2011-10-19 18:01:08
9d27faa2c4147e3aa8c8b83ce91330f8ae96798b...67b235735e80209c6f199d15faa87cd0e068f6b8,3,8,356,364,7,2011-10-19 23:23:26,2011-10-19 23:23:26
67b235735e80209c6f199d15faa87cd0e068f6b8...88af0c86357cf627cd7e7cc6f83f7f546754f6c3,1,0,18,18,2,2011-10-19 23:28:58,2011-10-19 23:28:52
88af0c86357cf627cd7e7cc6f83f7f546754f6c3...6cc42927d83adf2f89809ff54732e13f9376ff6c,11,80,52,132,48,2011-10-19 23:53:07,2011-10-19 23:53:07
6cc42927d83adf2f89809ff54732e13f9376ff6c...9bb3a683fe9404682ee69bd51e3a06038e2cce34,1,2,2,4,2,2011-10-20 01:20:55,2011-10-20 01:20:42
9bb3a683fe9404682ee69bd51e3a06038e2cce34...b43eb9678bdbbf741a0eb573e05385fc2d1645c0,1,1,0,1,1,2011-10-20 15:37:51,2011-10-20 05:07:20
b43eb9678bdbbf741a0eb573e05385fc2d1645c0...95d530f2b4faa57662d3b052e7637246b6a7025f,1,1,1,2,1,2011-10-20 15:41:33,2011-10-19 20:46:06
95d530f2b4faa57662d3b052e7637246b6a7025f...be2320d408de89054b254a0c812280054d946490,2,130,8,138,8,2011-10-20 22:06:53,2011-10-20 22:06:53
be2320d408de89054b254a0c812280054d946490...145aa636b9349a375c36b3a3f1c20e03416c750d,21,1030,130,1160,103,2011-10-20 22:30:09,2011-10-20 22:25:57
145aa636b9349a375c36b3a3f1c20e03416c750d...00bbe958c41749b08f724cd5ddcd94e60c35e0a2,1,1,1,2,1,2011-10-20 22:40:08,2011-10-20 22:40:08
00bbe958c41749b08f724cd5ddcd94e60c35e0a2...fb3cccc2578681456ef03c8446d6bf61052b1d3a,3,4,0,4,3,2011-10-21 00:58:35,2011-10-21 00:52:32
fb3cccc2578681456ef03c8446d6bf61052b1d3a...c83dda89a4bc12925e2dd83db9ef978fe4efae12,3,48,45,93,11,2011-10-21 01:03:02,2011-10-21 00:52:50
c83dda89a4bc12925e2dd83db9ef978fe4efae12...84d0b1bcc5154f67d9f200f3c852bb8c5b64c6ef,3,829,172,1001,72,2011-10-21 02:19:02,2011-09-27 15:07:56
84d0b1bcc5154f67d9f200f3c852bb8c5b64c6ef...fafb5848819d3a17ae54955467ed651685d98672,1,1,2,3,1,2011-10-21 17:21:23,2011-10-21 17:21:23
fafb5848819d3a17ae54955467ed651685d98672...69b73f9cf0df80fe177f45cebe6a94ee16466245,2,25,13,38,5,2011-10-21 17:27:22,2011-10-21 16:08:19
69b73f9cf0df80fe177f45cebe6a94ee16466245...0ae98dfc664b3754eee1a46e46576391c5954459,1,2,2,4,2,2011-10-21 19:46:55,2011-10-21 19:46:52
0ae98dfc664b3754eee1a46e46576391c5954459...caf70f5e9419c307bc9f35c3062e9af8b7bf48ea,3,104,41,145,18,2011-10-21 20:00:37,2011-10-20 15:54:50
caf70f5e9419c307bc9f35c3062e9af8b7bf48ea...2d02e6a992087d2e2c3d096ebb562f7938130914,3,25,9,34,11,2011-10-21 20:02:49,2011-10-20 17:00:15
2d02e6a992087d2e2c3d096ebb562f7938130914...de09168e5a3a1d8b18f73d79ea750074aa80e064,1,3,1,4,2,2011-10-21 20:16:41,2011-10-21 20:07:48
de09168e5a3a1d8b18f73d79ea750074aa80e064...9b2335a35600ad4f9a04ed37da3f3f4a9fea869f,16,228,65,293,44,2011-10-21 20:44:30,2011-10-21 20:44:30
9b2335a35600ad4f9a04ed37da3f3f4a9fea869f...3c3ec7b2d76b2678930aafb63ae784eb0a49730c,2,112,22,134,18,2011-10-21 20:49:29,2011-10-21 20:43:49
3c3ec7b2d76b2678930aafb63ae784eb0a49730c...efa95c27181a948ccdcbe7ee8bdea8333fb2bb0e,1,6,6,12,5,2011-10-21 21:55:28,2011-10-21 21:54:11
efa95c27181a948ccdcbe7ee8bdea8333fb2bb0e...d5a21a29f847afcfee9344554ec5e35dda9f8467,2,3,3,6,3,2011-10-21 22:19:53,2011-10-21 22:19:49
d5a21a29f847afcfee9344554ec5e35dda9f8467...8f1ba251dd8285ad9761ad5be241e3816263bb35,2,61,0,61,2,2011-10-21 22:53:09,2011-10-21 22:32:12
8f1ba251dd8285ad9761ad5be241e3816263bb35...8498ee03bc271e4d886c02fab9af2d2d47d2ddb0,1,59,25,84,8,2011-10-22 00:31:32,2011-10-22 00:08:50
cffd0bb68d4b72601539b1f3cf2b7ff50def897c...1cf13bca1950723cb58400288d2e5a7ebc3b2257,1,1,0,1,1,2011-11-25 15:53:38,2011-11-25 15:49:52
1cf13bca1950723cb58400288d2e5a7ebc3b2257...2445fb8bdd1c69e6134690d3d068166e087e1bb7,1,0,1,1,1,2011-11-27 01:09:15,2011-11-27 01:09:15
2445fb8bdd1c69e6134690d3d068166e087e1bb7...a033261f3901c42498e7ac3f2372820f31f7d1e1,1,16,10,26,7,2011-11-29 15:30:35,2011-11-29 15:27:52
a033261f3901c42498e7ac3f2372820f31f7d1e1...eda15387a0e4b8e8fd1d7cce66911fa48f0278fb,1,2,1,3,1,2011-11-29 18:35:58,2011-11-29 14:31:31
eda15387a0e4b8e8fd1d7cce66911fa48f0278fb...bbd976b8c4f82d22dc3f6bc5075aeaf26f8b6fa9,3,5,8,13,5,2011-11-30 01:28:12,2011-11-30 01:28:10
bbd976b8c4f82d22dc3f6bc5075aeaf26f8b6fa9...f44d0b90442d9a1dc7457924f827722fc3a7c440,2,13,8,21,5,2011-11-30 13:27:53,2011-11-30 13:27:12
b159c6d62e5756d3f8847419d29c6959ea288b56...3a160646dfe1ee500df335e8a439653689e54627,1,2,2,4,1,2011-11-25 11:43:44,2011-11-25 11:43:44
3a160646dfe1ee500df335e8a439653689e54627...34f34e44110d0e1df9dc13536227654c5a6e4f75,7,13,13,26,13,2011-11-26 16:45:27,2011-11-26 02:26:11
34f34e44110d0e1df9dc13536227654c5a6e4f75...6392eba3f9c4dd0e1e0a9e1ed328eacc00d3fd15,1,6,6,12,2,2011-11-26 17:05:24,2011-11-26 17:05:24
6392eba3f9c4dd0e1e0a9e1ed328eacc00d3fd15...5451ba3aa8f3061851a1618374374f2f0f0e3275,2,101,2,103,2,2011-11-27 07:31:45,2011-11-26 15:43:57
5451ba3aa8f3061851a1618374374f2f0f0e3275...fc0a4c2781b4b579d247a24393dada7f92663abe,2,0,0,0,0,2011-11-27 20:52:27,2011-11-26 13:23:06
fc0a4c2781b4b579d247a24393dada7f92663abe...e85a95dfa3469dd9cc6a3a15c8e686c14b3238a6,218,23739,15,23754,218,2011-11-27 21:09:04,2011-11-26 17:21:03
e85a95dfa3469dd9cc6a3a15c8e686c14b3238a6...216019b72d5085a0a12489dd15a1d4234f12e3b8,1,8,3,11,1,2011-11-27 21:47:05,2011-11-27 21:38:54
216019b72d5085a0a12489dd15a1d4234f12e3b8...a5c51b485858ab97a6c6af75a8333b9b8123fd04,2,2,0,2,2,2011-11-28 15:47:53,2011-11-28 13:13:55
a5c51b485858ab97a6c6af75a8333b9b8123fd04...eba1f7b1a49ac095f891a8b8477e5f286a862280,1,1,1,2,1,2011-11-28 19:45:01,2011-11-28 19:30:48
eba1f7b1a49ac095f891a8b8477e5f286a862280...1c62e807e105d8335bf96d2cd3db786ceff33782,1,3,0,3,1,2011-11-28 19:52:40,2011-11-28 19:44:23
1c62e807e105d8335bf96d2cd3db786ceff33782...aab958b7130280e4862ab72458d120d159f24fc1,2,66,3,69,2,2011-11-29 07:52:15,2011-11-28 17:36:54
aab958b7130280e4862ab72458d120d159f24fc1...6ed721afd2a85305eb69a3c727e64848c99c76e1,2,20,30,50,5,2011-11-29 11:45:39,2011-11-29 11:45:39
6ed721afd2a85305eb69a3c727e64848c99c76e1...5fea00581b8bdc04256ede380cac0fd0da97489c,1,4,1,5,1,2011-11-29 18:22:13,2011-11-29 18:21:41
5fea00581b8bdc04256ede380cac0fd0da97489c...260383215bef153d59826a0272f314c6b097d118,2,84,21,105,14,2011-11-30 00:29:35,2011-11-03 04:15:09
260383215bef153d59826a0272f314c6b097d118...754e23db27b1d357cc257419384602dd6cc7e299,1,1,1,2,1,2011-11-30 01:11:40,2011-11-29 22:28:22
754e23db27b1d357cc257419384602dd6cc7e299...b204006105e556be07121abd52e5cf0da3d3d8ae,2,5,1,6,2,2011-11-30 13:14:24,2011-11-30 02:21:10
b204006105e556be07121abd52e5cf0da3d3d8ae...cf89beec6f7cf08a260e6d0383455a89f4cb2722,1,48,98,146,36,2011-11-30 14:28:48,2011-11-30 08:44:00
cf89beec6f7cf08a260e6d0383455a89f4cb2722...456dafc3c68727225781a9a5ac5946ffb74254a9,1,5,7,12,2,2011-11-30 14:28:48,2011-11-30 08:54:20
456dafc3c68727225781a9a5ac5946ffb74254a9...3ca05177494d82bccd7845462089850cbf58ddd5,1,11,1,12,3,2011-11-30 14:50:08,2011-11-30 14:49:42
3ca05177494d82bccd7845462089850cbf58ddd5...03eb41c2ec4e99c52a5338ecd021056d065ddaab,2,46,1,47,3,2011-12-01 13:57:06,2011-12-01 13:51:53
03eb41c2ec4e99c52a5338ecd021056d065ddaab...3d22dbf27bfb3cb681879784d2a80ac7246fa568,3,28,3,31,8,2011-12-01 17:02:15,2011-12-01 16:21:00
3d22dbf27bfb3cb681879784d2a80ac7246fa568...d5feb1c280d0b14fa8ef116dd02ce1a243b81869,1,0,5,5,1,2011-12-01 20:00:46,2011-12-01 20:00:46
d5feb1c280d0b14fa8ef116dd02ce1a243b81869...61764613d1b7b54788c3954735cbbdcb078e295d,253,724,968,1692,424,2011-12-01 20:12:17,2011-12-01 00:45:26
61764613d1b7b54788c3954735cbbdcb078e295d...d5f401147acb3fe409f303d3b1e0571cde33611e,1,1,0,1,1,2011-12-01 20:12:17,2011-12-01 18:49:07
d5f401147acb3fe409f303d3b1e0571cde33611e...3e7f4b0f822875c2fa16427315f08dca8fa3dc5c,2,30,3,33,6,2011-12-01 20:12:17,2011-12-01 07:53:35
3e7f4b0f822875c2fa16427315f08dca8fa3dc5c...0f6d3e22d9ed151b20887c13d3ba0d529ef55690,1,0,1,1,1,2011-12-01 20:23:43,2011-12-01 20:23:43
0f6d3e22d9ed151b20887c13d3ba0d529ef55690...9b4e8e0a0d09000597f4b3f8cc2ef69371db201f,1,2,2,4,2,2011-12-01 21:29:39,2011-12-01 21:24:40
9b4e8e0a0d09000597f4b3f8cc2ef69371db201f...ae648a44c48e0de0149f83880be542609588c80f,31,246,49,295,58,2011-12-01 21:50:09,2011-12-01 21:50:09
ae648a44c48e0de0149f83880be542609588c80f...dd4b280d8cb50bf818f2fae9f8e47f9f219e8328,4,41,5,46,10,2011-12-01 21:56:04,2011-12-01 21:56:04
dd4b280d8cb50bf818f2fae9f8e47f9f219e8328...99c9d19184fdd46ae88464d7a608aac57a530634,3,36,2,38,4,2011-12-01 21:57:47,2011-12-01 21:24:28
99c9d19184fdd46ae88464d7a608aac57a530634...1ad30a2af4926b97241b4041a048046d903dc6b9,95,99,97,196,98,2011-12-02 01:12:21,2011-12-01 23:01:01
1ad30a2af4926b97241b4041a048046d903dc6b9...823a443321360e089e9c6d169a6cc116e3fb50b2,3,88,87,175,7,2011-12-02 01:21:50,2011-12-01 23:02:51
823a443321360e089e9c6d169a6cc116e3fb50b2...e84edd2593d80b1d9bd72f2538b3b778ff95aae0,2,27,11,38,10,2011-12-02 01:21:50,2011-12-01 23:24:44
e84edd2593d80b1d9bd72f2538b3b778ff95aae0...ded97eb892a9b704a63a127db03922725d65b417,1,2,0,2,2,2011-12-02 01:21:50,2011-12-01 23:25:24
ded97eb892a9b704a63a127db03922725d65b417...641f2bedf3d4ac971ee748d140a8fca139499f6e,1,1,1,2,1,2011-12-02 01:21:50,2011-12-02 01:14:04
641f2bedf3d4ac971ee748d140a8fca139499f6e...9170077f13e5e5475b23d1d3c2e7f69bfe139727,3,10,10,20,7,2011-12-02 01:31:41,2011-12-02 01:31:41
9170077f13e5e5475b23d1d3c2e7f69bfe139727...a29a7c72fa7a06f01a9e7207461934def73a77be,1,2,2,4,1,2011-12-02 02:15:10,2011-12-02 02:15:10
a29a7c72fa7a06f01a9e7207461934def73a77be...3ebbdc6320a6e11e4c74c81ee700f77762931a21,1,37,12,49,12,2011-12-02 15:21:55,2011-12-02 15:21:55
49ba55b10045969d9dba89ee11a53ca2d35d8f7f...e90623edc2befb06602ff8c3e01809ba0a21d593,527,20547,334,20881,618,2011-12-03 20:28:17,2011-12-03 20:26:50
e90623edc2befb06602ff8c3e01809ba0a21d593...21d081fd7f83aa168ea0bef0870c7f1fed410a63,424,69689,34221,103910,12609,2011-12-06 00:29:01,2011-12-06 00:29:01
21d081fd7f83aa168ea0bef0870c7f1fed410a63...e609195202d79221edc037309c3ef459514e3ff4,4,144,6,150,13,2011-12-06 01:58:31,2011-12-02 07:53:56
3ebbdc6320a6e11e4c74c81ee700f77762931a21...ffc8110659854179cd002d8859668deb59c19a30,1,20,1,21,2,2011-12-02 21:45:08,2011-12-02 19:11:25
ffc8110659854179cd002d8859668deb59c19a30...46b6954acdfaba37cf133bd656ad6a23453e007b,1,1,0,1,1,2011-12-03 01:06:05,2011-12-03 01:06:05
46b6954acdfaba37cf133bd656ad6a23453e007b...1cf26e2bf1d305c1e444f50ed0f4ed08b8df7106,4,11,39,50,5,2011-12-04 07:31:02,2011-12-04 07:30:56
1cf26e2bf1d305c1e444f50ed0f4ed08b8df7106...60e26668b3c73b9163d9fb1ae6a7951c6acbc889,1,1,1,2,1,2011-12-04 08:09:10,2011-12-04 08:09:02
60e26668b3c73b9163d9fb1ae6a7951c6acbc889...6cc94db653a2739ab28e33b2d6a63c51bd986a9f,4,18,11,29,8,2011-12-04 08:10:23,2011-12-04 07:18:35
6cc94db653a2739ab28e33b2d6a63c51bd986a9f...c50b0c9237efb951f432b5792e9aec3ff1d9475f,1,2,2,4,1,2011-12-04 08:59:16,2011-12-04 08:59:16
c50b0c9237efb951f432b5792e9aec3ff1d9475f...a0fdd5f3f6539684ec1dd5bf7f2d2367bc7d4adb,2,10,1,11,2,2011-12-04 12:22:21,2011-12-04 12:22:21
a0fdd5f3f6539684ec1dd5bf7f2d2367bc7d4adb...aeb124f7f3625bff31d88dc3e42ad621028febf6,1,3,3,6,2,2011-12-05 05:37:18,2011-12-05 05:37:18
aeb124f7f3625bff31d88dc3e42ad621028febf6...fdf180f9ceefe9598f0a43e01dab825e19250e40,1,5,1,6,2,2011-12-05 07:42:11,2011-12-05 07:42:11
fdf180f9ceefe9598f0a43e01dab825e19250e40...1a89c8d061b36e01cd0f7f12704dc9688d351df7,1,11,0,11,1,2011-12-05 19:17:57,2011-12-05 19:17:57
1a89c8d061b36e01cd0f7f12704dc9688d351df7...36815e41796475b1f72aacb3acb406ff07ef90c7,2,38,1,39,3,2011-12-05 21:43:27,2011-12-05 21:42:05
36815e41796475b1f72aacb3acb406ff07ef90c7...db273818f6cafeab443746f128ef7522c0dedb90,5,8,8,16,7,2011-12-06 00:20:44,2011-12-02 02:19:17
db273818f6cafeab443746f128ef7522c0dedb90...6f86b9cb70f4b4d9b214ef3533efbf389fa43824,1,1,1,2,1,2011-12-06 00:25:32,2011-12-06 00:25:20
6f86b9cb70f4b4d9b214ef3533efbf389fa43824...cf20b6bf65bd037193d6e8b1b671c4659897861f,7,78,7,85,10,2011-12-06 00:47:11,2011-12-05 23:36:45
cf20b6bf65bd037193d6e8b1b671c4659897861f...9023b0b3a28824800e8a6a1bf921f47741691c48,1,14,0,14,1,2011-12-06 00:50:55,2011-12-04 00:23:59
9023b0b3a28824800e8a6a1bf921f47741691c48...89e894b17abcf1619346c6e74b46e20eb2c7f732,1,1,1,2,1,2011-12-06 00:51:03,2011-12-04 00:58:49
89e894b17abcf1619346c6e74b46e20eb2c7f732...580e67015c464e8d2746fed9d1f2dcd26138aaef,2,37,0,37,3,2011-12-06 18:13:31,2011-12-06 01:52:22
580e67015c464e8d2746fed9d1f2dcd26138aaef...57d28579384d8bf734b7af920c8dff4099c61c9a,1,7,0,7,1,2011-12-06 21:02:26,2011-12-06 17:09:43
57d28579384d8bf734b7af920c8dff4099c61c9a...23bb5986d4c97dde538622283864b3eed23493d8,1,2,3,5,2,2011-12-06 21:02:26,2011-12-06 20:47:30
23bb5986d4c97dde538622283864b3eed23493d8...70bc2e32af8a0215b5e1e4e83fb1c00a457cf663,2,33,0,33,2,2011-12-06 21:02:26,2011-12-06 20:53:52
70bc2e32af8a0215b5e1e4e83fb1c00a457cf663...fd29448be028125ec1521ddc268314ac20ebc440,36,755,0,755,36,2011-12-06 21:02:26,2011-12-06 20:59:25
fd29448be028125ec1521ddc268314ac20ebc440...7547c7df1a1d20ed194582f690076aa9c3bcc27b,1,35,39,74,30,2011-12-07 01:01:56,2011-12-07 01:00:33
ebe0fb697a1bd650e6dad4fe24028c01a4683778...e0a207c27a5e366b89133df3b60394e6cac7876b,6,195,78,273,18,2011-12-07 09:14:54,2011-12-07 01:06:36
e0a207c27a5e366b89133df3b60394e6cac7876b...f8c335d0caf47f16d31413f89aa28eda3878e3aa,5,207,5,212,9,2011-12-07 13:47:06,2011-12-07 13:47:06
f8c335d0caf47f16d31413f89aa28eda3878e3aa...06d86ebe84281ec53b83145b77e4a8a1a41a6fde,2,110,72,182,13,2011-12-07 21:31:55,2011-12-07 21:31:55
06d86ebe84281ec53b83145b77e4a8a1a41a6fde...e53e9c72cb06c82ae63a03dc896525da304562e7,4,84,40,124,10,2011-12-07 23:44:33,2011-12-07 23:44:33
e53e9c72cb06c82ae63a03dc896525da304562e7...59055b227ad7510d552e7b2bd757e92e5c3632bb,3,41,35,76,22,2011-12-08 00:01:46,2011-12-08 00:01:46
59055b227ad7510d552e7b2bd757e92e5c3632bb...e10fd321e44804b98f77d2eaedb9b47e7635fb41,7,48,33,81,26,2011-12-08 02:03:18,2011-12-08 02:03:18
e10fd321e44804b98f77d2eaedb9b47e7635fb41...cced79d4a840f1b8f0b044657aac033e0596cb03,4,27,18,45,13,2011-12-08 23:09:47,2011-12-08 23:09:47
cced79d4a840f1b8f0b044657aac033e0596cb03...3d3f29cf0626bcb1688da4fc0621b659a66fe4d9,1,0,1021,1021,1,2011-12-08 23:10:26,2011-12-08 23:10:26
3d3f29cf0626bcb1688da4fc0621b659a66fe4d9...c5e51cead8b8cf63fb000e3ce962e9c3476123e6,2,2,2,4,3,2011-12-08 23:58:29,2011-12-08 23:58:29
c5e51cead8b8cf63fb000e3ce962e9c3476123e6...06a22e2ea130b8aa8d36e74874d28b135e6bc8b0,1,0,1,1,1,2011-12-10 01:24:37,2011-12-10 00:46:21
06a22e2ea130b8aa8d36e74874d28b135e6bc8b0...bdd19ab40b0cdb11c85db7cb88081d8bda1370dc,1,2,1,3,1,2011-12-14 01:49:34,2011-12-14 01:49:34
bdd19ab40b0cdb11c85db7cb88081d8bda1370dc...be23c51f6979ef5fd519069a62648d81f25b2ec0,2,115,4,119,3,2011-12-14 22:41:44,2011-12-14 13:00:10
be23c51f6979ef5fd519069a62648d81f25b2ec0...b3a7de15b7f06e11bd326b60b0e5ffd762ae71c5,143,5937,2515,8452,894,2011-12-14 23:02:32,2011-12-14 23:02:32
b3a7de15b7f06e11bd326b60b0e5ffd762ae71c5...2240486d3d470491ce168bf8acb53bf3066ffffc,2,11,0,11,3,2011-12-15 01:02:15,2011-12-15 01:02:15
2240486d3d470491ce168bf8acb53bf3066ffffc...de5ba2db25600037af1221cbbf17392847d8b294,1,0,1,1,1,2011-12-15 21:19:36,2011-12-15 21:19:36
de5ba2db25600037af1221cbbf17392847d8b294...da3356bb388b391775b51e5c663a0424cf69c5e1,37,1887,33,1920,115,2011-12-15 23:56:42,2011-12-15 23:56:42
da3356bb388b391775b51e5c663a0424cf69c5e1...88cc688731eae791861db0c0dc68a1a9b41916b5,1,1,0,1,1,2011-12-16 01:20:49,2011-12-16 01:18:28
88cc688731eae791861db0c0dc68a1a9b41916b5...500c8f45f529cda33abbe86db67bb44d58567384,18,130,1952,2082,45,2011-12-16 02:01:22,2011-12-15 20:36:05
500c8f45f529cda33abbe86db67bb44d58567384...45822da46a6dd69c8c88ded92fbc4c7f8d76fcde,1,0,1,1,1,2011-12-16 02:42:03,2011-12-16 02:42:03
45822da46a6dd69c8c88ded92fbc4c7f8d76fcde...01e4fe5fbcb67a53c929005f4477a951b1cff0df,11,863,146,1009,34,2011-12-16 21:35:08,2011-12-16 21:35:08
01e4fe5fbcb67a53c929005f4477a951b1cff0df...67e12a0f84eb16bab804a6dde88154d66da9dba3,1,0,189,189,1,2011-12-16 21:46:42,2011-12-16 21:46:42
7547c7df1a1d20ed194582f690076aa9c3bcc27b...eef5d3257dc752d1c1eb1ade66bf3c5b86eee947,1,2,2,4,2,2011-12-07 13:36:21,2011-12-07 13:33:17
eef5d3257dc752d1c1eb1ade66bf3c5b86eee947...22c2c34952b22c982aca23d2ce74817d20f4c1cc,1,21,9,30,2,2011-12-07 22:19:57,2011-12-07 22:19:57
22c2c34952b22c982aca23d2ce74817d20f4c1cc...871194d5fdf5359ecc9021364d3cafaf1e5af66b,1,3,1,4,2,2011-12-08 14:47:18,2011-12-08 01:15:40
871194d5fdf5359ecc9021364d3cafaf1e5af66b...b24cdb3d362bd88e4a6486a589e9fb6c498f360b,3,9,4,13,5,2011-12-08 23:02:59,2011-12-08 23:00:48
b24cdb3d362bd88e4a6486a589e9fb6c498f360b...429efdd974e9f96208574dc7e0d00232ff9c3957,5,2,2,4,1,2011-12-10 01:14:39,2011-12-10 01:14:07
429efdd974e9f96208574dc7e0d00232ff9c3957...8e2c014e43809c0889b42ed4e567f4b734a82c01,2,23,13,36,5,2011-12-10 01:20:22,2011-12-10 00:42:15
8e2c014e43809c0889b42ed4e567f4b734a82c01...5bbb4cadc33387af73500c79386bd2d345300e9d,18,736,277,1013,38,2011-12-12 17:12:42,2011-12-12 06:25:42
5bbb4cadc33387af73500c79386bd2d345300e9d...e698dd38c3996199c47c944de873e368dce42608,2,8,4,12,4,2011-12-12 17:58:23,2011-12-12 17:19:30
e698dd38c3996199c47c944de873e368dce42608...8295c806181654fc6bbc8845c727b7378a196304,1,5,1,6,1,2011-12-12 21:45:44,2011-12-12 21:45:39
8295c806181654fc6bbc8845c727b7378a196304...93188918ea7e64e0572f0aeae12b277208b514f8,6,177,157,334,63,2011-12-12 22:28:49,2011-12-12 22:19:14
93188918ea7e64e0572f0aeae12b277208b514f8...95b034e484c0f77053ec2206501fdd9b82bd99c1,1,7,7,14,1,2011-12-12 22:30:54,2011-12-12 22:20:27
95b034e484c0f77053ec2206501fdd9b82bd99c1...19a18add4eea6225f5b3f921a5c3960a640f4227,1,7,7,14,1,2011-12-12 22:34:37,2011-12-12 22:34:37
19a18add4eea6225f5b3f921a5c3960a640f4227...6e76fc2866872468dec69db817d3baf0ad5584b7,1,1,1,2,2,2011-12-12 22:40:03,2011-12-12 22:40:00
6e76fc2866872468dec69db817d3baf0ad5584b7...e90db17392c7749bc44235dd9b7f69b298e481a9,1,1,1,2,1,2011-12-13 15:02:14,2011-12-13 15:02:14
e90db17392c7749bc44235dd9b7f69b298e481a9...b1b3dc62ff13f5bd5be1ec75630b0308c48d6399,2,10,1,11,2,2011-12-13 15:31:12,2011-12-13 15:30:53
b1b3dc62ff13f5bd5be1ec75630b0308c48d6399...d70ef199f160aee429a64af4085527cd6fda75d9,2,75,29,104,11,2011-12-13 17:08:18,2011-12-13 17:08:18
d70ef199f160aee429a64af4085527cd6fda75d9...77f21787d484fe287083a47750e9533bd362ddbc,1,13,3,16,4,2011-12-13 20:22:44,2011-12-13 20:22:15
77f21787d484fe287083a47750e9533bd362ddbc...321ec97d95c6fe23d83dfb7ed1ef217882dafda7,1,7,50,57,6,2011-12-14 01:32:07,2011-12-14 01:32:07
321ec97d95c6fe23d83dfb7ed1ef217882dafda7...ef12fa1bf7bd3fba9959360fc52d88b9d3760de0,1,177,211,388,33,2011-12-14 02:18:17,2011-12-14 01:56:23
ef12fa1bf7bd3fba9959360fc52d88b9d3760de0...43e91da0742c9f953b554f91bf12020ffc5be991,1,2,1,3,1,2011-12-14 02:38:41,2011-12-14 02:38:41
43e91da0742c9f953b554f91bf12020ffc5be991...d29be0dfa2e06ee55ce65e440aba5f36f21d23a2,2,93,0,93,2,2011-12-14 02:43:04,2011-12-14 02:39:20
d29be0dfa2e06ee55ce65e440aba5f36f21d23a2...97900776bb3611877d126aa58743eb9b5b2a4be8,3,20,15,35,4,2011-12-14 12:36:21,2011-12-14 12:28:51
97900776bb3611877d126aa58743eb9b5b2a4be8...1c3883bef2ed3024794ea54e4a5d550014a8f664,1,1,0,1,1,2011-12-14 19:11:55,2011-12-14 19:11:32
1c3883bef2ed3024794ea54e4a5d550014a8f664...f490934c33bdf134cfb24c6f26975a7e26d64953,1,17,5,22,4,2011-12-14 22:17:16,2011-12-13 19:11:14
f490934c33bdf134cfb24c6f26975a7e26d64953...bb9316da28feaad035eb2f61aeafc5f1a7a57ae2,160,936,605,1541,285,2011-12-14 22:17:16,2011-12-14 02:53:02
bb9316da28feaad035eb2f61aeafc5f1a7a57ae2...b04d4fff3539b233325e68fa0a98f3372a853458,1,14,5,19,3,2011-12-14 23:19:22,2011-12-14 23:19:03
b04d4fff3539b233325e68fa0a98f3372a853458...2255efa171e83b51dec77e68f2be2227b0538562,95,122,110,232,104,2011-12-15 00:27:01,2011-12-15 00:27:01
2255efa171e83b51dec77e68f2be2227b0538562...de3c16afae8c218d6ecdf9d0b651c40b47c80262,14,383,79,462,29,2011-12-15 00:33:11,2011-12-15 00:33:07
de3c16afae8c218d6ecdf9d0b651c40b47c80262...ae17e2d90afaea9a5ab094b74b0217dabec037f4,1,17,3,20,2,2011-12-15 02:20:11,2011-12-15 02:18:47
ae17e2d90afaea9a5ab094b74b0217dabec037f4...56f65e3c3e1a3b4958291fa79329bde22d8f2b10,115,399,98,497,114,2011-12-15 16:32:07,2011-12-15 16:32:07
56f65e3c3e1a3b4958291fa79329bde22d8f2b10...9a059ea69e1f6ebd8899246682d8ca257610b8ab,6,44,12,56,8,2011-12-15 18:55:52,2011-12-15 00:59:37
9a059ea69e1f6ebd8899246682d8ca257610b8ab...dd8018de9566029dc1f1aba5209eda0687d6db94,1,2,2,4,1,2011-12-15 19:08:28,2011-12-15 19:08:28
dd8018de9566029dc1f1aba5209eda0687d6db94...ee7313266a0d4dd1cc88779f1ede0719be326eee,1,1,1,2,1,2011-12-15 20:51:11,2011-12-15 20:50:48
ee7313266a0d4dd1cc88779f1ede0719be326eee...cc2861ee44c000a4696514e5b3718a371a5c9720,2,12,6,18,6,2011-12-16 01:26:01,2011-12-15 16:39:11
cc2861ee44c000a4696514e5b3718a371a5c9720...4b123f9ca22ee2622eb32233cb1d07af21e33826,1,13,2,15,2,2011-12-16 13:35:15,2011-12-01 05:41:06
4b123f9ca22ee2622eb32233cb1d07af21e33826...c744e925dfdd94f93e26c35e36334efe302bac73,1,6,4,10,2,2011-12-16 15:32:29,2011-12-16 09:20:27
c744e925dfdd94f93e26c35e36334efe302bac73...666aa0a343402d31ba51816968c2e9816f8d4e62,22,427,39,466,44,2011-12-16 16:57:56,2011-12-16 14:56:41
666aa0a343402d31ba51816968c2e9816f8d4e62...d6bae2cb9500b91370b3a21a7155257d404107a2,2,9,7,16,7,2011-12-16 19:16:33,2011-12-16 19:01:06
d6bae2cb9500b91370b3a21a7155257d404107a2...b9049d2f903cd412faa17662bc07255280fcdfcc,3,737,4,741,7,2011-12-16 19:38:20,2011-12-16 00:51:33
b9049d2f903cd412faa17662bc07255280fcdfcc...a599aeb2a8159c48eafbe066466ea5bc90d0c71c,2,21,23,44,21,2011-12-16 20:57:03,2011-12-09 12:00:40
1865b11dcb77b452ef84fac6970cc742b387dfab...64de69c1a4d2befb1be19aaf35028c1c833cdee3,16,1214,1104,2318,17,2011-12-16 22:06:29,2011-12-16 22:06:29
64de69c1a4d2befb1be19aaf35028c1c833cdee3...e61de70c96bf3f45a836c2b5b280513f71f165f7,1,20,12,32,5,2011-12-16 23:00:23,2011-12-16 23:00:23
e61de70c96bf3f45a836c2b5b280513f71f165f7...a9f2c4aa307c3dc838d9ecb0fb4e241a42f4f2a1,2,7,1,8,3,2011-12-17 08:39:04,2011-12-17 08:09:14
a9f2c4aa307c3dc838d9ecb0fb4e241a42f4f2a1...10d92b3dcd8dbe4e3fe7cce90f7e792fec3364d0,1,15,4,19,4,2011-12-17 11:23:17,2011-12-17 11:23:17
10d92b3dcd8dbe4e3fe7cce90f7e792fec3364d0...b084322f52e5ecf4a18db56dfadf16036c792918,3,82,4,86,3,2011-12-17 20:53:44,2011-12-17 10:52:40
b084322f52e5ecf4a18db56dfadf16036c792918...ee0a7b928bbdf638953fa8a0522ecb9a5bf35728,2,2,2,4,2,2011-12-18 22:07:47,2011-12-18 16:29:37
ee0a7b928bbdf638953fa8a0522ecb9a5bf35728...bb8f73419c27e05f65eb39655ae04bae3b815628,1,8,5,13,4,2011-12-18 23:12:25,2011-12-18 23:10:01
bb8f73419c27e05f65eb39655ae04bae3b815628...3f987cd925dd342b4695afd9c221bc19e76bdf7b,1,3,1,4,1,2011-12-19 14:46:41,2011-12-18 21:22:10
3f987cd925dd342b4695afd9c221bc19e76bdf7b...ec11525d33f01fd7c9183bf983ddeb3d48337b4e,1,3,0,3,1,2011-12-19 14:47:02,2011-12-18 21:31:16
ec11525d33f01fd7c9183bf983ddeb3d48337b4e...855f46677c1ff46c2d5217cf03ea8015f07a8040,1,9,0,9,1,2011-12-19 14:47:07,2011-12-18 21:33:48
855f46677c1ff46c2d5217cf03ea8015f07a8040...d9377f5eb0ca6b0dbf529c09f8506a141903250b,1,1,1,2,1,2011-12-19 19:09:16,2011-12-09 08:41:48
d9377f5eb0ca6b0dbf529c09f8506a141903250b...c07edd90f5bfb4edb98b57e76e56742e08142b91,3,5,5,10,5,2011-12-19 19:09:16,2011-12-09 09:24:15
c07edd90f5bfb4edb98b57e76e56742e08142b91...07ad11916f614416be828d0d20235af6c3235e0a,1,6,0,6,1,2011-12-19 19:09:16,2011-12-10 16:34:50
07ad11916f614416be828d0d20235af6c3235e0a...b0388ccad08ca94cd409dbf02996687770637fb8,2,32,6,38,10,2011-12-19 19:09:16,2011-12-10 16:52:07
b0388ccad08ca94cd409dbf02996687770637fb8...b00b2f08bf78e735f206051942f3d22ad5b3b0ed,1,1,1,2,1,2011-12-19 19:09:16,2011-12-14 07:53:30
b00b2f08bf78e735f206051942f3d22ad5b3b0ed...a239ea0d4027ff0edbced6aae8d08420cb41d871,1,1,1,2,1,2011-12-19 19:09:16,2011-12-14 12:33:58
a239ea0d4027ff0edbced6aae8d08420cb41d871...80858761a87bd3154ce080457baccaa6267b6f1d,1,27,5,32,7,2011-12-19 19:09:40,2011-12-17 06:02:51
80858761a87bd3154ce080457baccaa6267b6f1d...07b199738887ecce3d14d54cbf1f97f159759a19,3,94,10,104,11,2011-12-19 20:34:59,2011-12-19 19:48:03
07b199738887ecce3d14d54cbf1f97f159759a19...21e7292ea0ec1054fef8ad2af2ff68f6822c2449,57,1675,1116,2791,381,2011-12-19 21:06:37,2011-12-19 21:06:19
21e7292ea0ec1054fef8ad2af2ff68f6822c2449...3966e4e7a508c1180f09fbbe7f98fde782f22ff6,1,4,5,9,1,2011-12-19 21:25:19,2011-12-19 21:08:52
3966e4e7a508c1180f09fbbe7f98fde782f22ff6...802c4c6a61d586dccc55d6408424233d1a566bf2,1,2,0,2,2,2011-12-19 21:29:21,2011-12-19 21:09:54
802c4c6a61d586dccc55d6408424233d1a566bf2...c65a91c96fe9083bc8c49bf616b532cd6a771a8a,1,1,0,1,1,2011-12-19 21:41:04,2011-12-19 21:41:04
c65a91c96fe9083bc8c49bf616b532cd6a771a8a...15d0fa6dc125d986cdcd0ef02950c4a79e9fff77,1,1,0,1,1,2011-12-19 21:55:11,2011-12-19 21:55:11
15d0fa6dc125d986cdcd0ef02950c4a79e9fff77...213b8af2f605efc15b25ac33aaf55920962f7182,1,1,2,3,2,2011-12-19 22:24:29,2011-12-19 22:24:29
213b8af2f605efc15b25ac33aaf55920962f7182...a805012d6f083d0503ccca121f95c6bedb8dc933,2,13,3,16,4,2011-12-19 23:10:38,2011-02-02 11:09:02
a805012d6f083d0503ccca121f95c6bedb8dc933...5c7532e5b3fad40a50696e43fc2ff066af7037c3,2,19,2,21,4,2011-12-19 23:10:49,2011-12-19 22:28:42
5c7532e5b3fad40a50696e43fc2ff066af7037c3...f9994114ab42f447b494c4068fa9f21ad833ca0f,1,0,88,88,1,2011-12-19 23:10:49,2011-12-18 22:48:27
f9994114ab42f447b494c4068fa9f21ad833ca0f...45605c9b39ede7f0b7ccf0184949ad95ad7268ab,1,2,3,5,3,2011-12-19 23:10:57,2011-12-18 22:53:07
45605c9b39ede7f0b7ccf0184949ad95ad7268ab...aac717da8d93e35fc3f8d92c789f8494387ed8a7,1,1,0,1,1,2011-12-19 23:34:19,2011-12-19 23:30:41
aac717da8d93e35fc3f8d92c789f8494387ed8a7...b603578b536d2799674ec57c4906037be96ed998,1,4,0,4,1,2011-12-20 02:06:21,2011-12-20 02:06:19
b603578b536d2799674ec57c4906037be96ed998...6c5f1f58f3b55a5a6707aa5e27441cb9d8920c69,1,0,3,3,1,2011-12-21 04:26:13,2011-12-21 04:26:13
6c5f1f58f3b55a5a6707aa5e27441cb9d8920c69...7edfb029844cf10cc1d815dadc7384fdb285f4e9,1,0,3,3,1,2011-12-21 06:02:50,2011-12-21 06:02:47
7edfb029844cf10cc1d815dadc7384fdb285f4e9...18b92201be7e654ac9997b947d38aaf46adee06d,5,72,0,72,5,2011-12-21 06:03:35,2011-12-21 06:03:32
18b92201be7e654ac9997b947d38aaf46adee06d...b24c515dbf227114bf215aac7930ecce386cc131,11,96,33,129,21,2011-12-21 15:59:53,2011-12-20 19:55:14
b24c515dbf227114bf215aac7930ecce386cc131...a82f5389d9673a48ab0facd6e77b2244dfe084c6,1,13,1,14,4,2011-12-21 17:35:50,2011-12-21 17:28:34
a82f5389d9673a48ab0facd6e77b2244dfe084c6...4eaf4ce26a0e66179d199997d9e0290867557702,25,296,108,404,62,2011-12-21 18:54:24,2011-12-21 18:54:24
a599aeb2a8159c48eafbe066466ea5bc90d0c71c...90fb81ad54040f410cf14bfb6b37f0117e430347,107,361,239,600,108,2011-12-17 02:05:17,2011-12-17 01:24:25
90fb81ad54040f410cf14bfb6b37f0117e430347...d75de86e6d858bb289201b2250e615cd41fce726,1,6,0,6,2,2011-12-17 02:05:17,2011-12-17 02:04:39
d75de86e6d858bb289201b2250e615cd41fce726...c4d2244a0977494e520bf56c36bf2ea5562c1653,3,9,3,12,3,2011-12-17 10:10:08,2011-12-14 13:53:31
c4d2244a0977494e520bf56c36bf2ea5562c1653...6df7bdd954efb817b50dafad7f90a1285c59c0c9,2,10,1,11,2,2011-12-18 00:29:07,2011-12-18 00:26:00
6df7bdd954efb817b50dafad7f90a1285c59c0c9...f2f30286bf5e5332b1e788f3c745c5231e1b098b,2,7,1,8,3,2011-12-18 00:50:01,2011-12-18 00:22:22
f2f30286bf5e5332b1e788f3c745c5231e1b098b...ec51bfc99574c7b42072bcb8d62dfe3165a6a034,1,2,2,4,2,2011-12-18 15:00:55,2011-12-18 12:35:31
ec51bfc99574c7b42072bcb8d62dfe3165a6a034...f322bbe729febeccec34ef0146831be1a1d29533,2,19,6,25,5,2011-12-18 21:35:08,2011-12-18 21:28:30
f322bbe729febeccec34ef0146831be1a1d29533...4b455bafd0c909c2aa7a51a50615ef6b5d047781,1,1,1,2,1,2011-12-18 21:35:09,2011-12-18 21:27:21
4b455bafd0c909c2aa7a51a50615ef6b5d047781...926365c9f86d4c20162f56e675e20d2c66e73c7d,1,2,0,2,1,2011-12-19 06:54:15,2011-12-19 06:54:15
926365c9f86d4c20162f56e675e20d2c66e73c7d...d87f551f36aade9367e3a3f032983b01424794c8,1,1,1,2,1,2011-12-19 21:30:43,2011-12-09 08:41:48
d87f551f36aade9367e3a3f032983b01424794c8...348d8cd04abb8b38e5c308df8c393751467b354f,3,53,0,53,3,2011-12-19 23:57:15,2011-12-02 08:27:35
348d8cd04abb8b38e5c308df8c393751467b354f...f4e34f1b76fcfb2a9112998b54c46ce2978a0deb,1,0,1,1,1,2011-12-20 17:15:22,2011-12-20 17:15:22
f4e34f1b76fcfb2a9112998b54c46ce2978a0deb...7a7f1062bfed7ae2b816549de308c1b4e22415f1,1,0,1,1,1,2011-12-21 14:01:07,2011-12-21 14:01:07
7a7f1062bfed7ae2b816549de308c1b4e22415f1...07c27e040eb41a1f564f1d92dbe1ad07b78f3a4e,4,147,0,147,7,2011-12-21 18:48:15,2011-12-17 17:09:16
07c27e040eb41a1f564f1d92dbe1ad07b78f3a4e...73cf8e82e768af870964d6f3375ab758e774165c,1,16,10,26,5,2011-12-21 20:01:41,2011-12-21 20:01:39
f7f8af842077be4e6cc580ddedcccea71e073bbb...60a9e1e40fd520a224b4a971a464227e6838e7af,15,399,95,494,60,2011-12-21 20:39:36,2011-12-21 20:39:36
60a9e1e40fd520a224b4a971a464227e6838e7af...6ac22bfb04c5a4d17e44822d6c2e658220791788,1,5,0,5,1,2011-12-21 22:18:56,2011-12-21 22:18:56
6ac22bfb04c5a4d17e44822d6c2e658220791788...624f70e88f42a69b78e08278b5037359fe3a514b,4,9,10,19,10,2011-12-23 22:25:17,2011-12-23 22:24:50
624f70e88f42a69b78e08278b5037359fe3a514b...e4731f816817bc6ea52d1fa2d51cb024bd48c337,3,4,5,9,3,2011-12-23 23:57:10,2011-12-23 23:57:10
73cf8e82e768af870964d6f3375ab758e774165c...6029127ceae33dec541ef0457e650adb33d2763c,2,2,2,4,2,2011-12-21 20:38:07,2011-12-21 20:38:07
6029127ceae33dec541ef0457e650adb33d2763c...ef659192a14fcd521801d33374b4feaf5dfaf105,4,33,34,67,24,2011-12-22 08:30:41,2011-12-20 04:57:45
ef659192a14fcd521801d33374b4feaf5dfaf105...892ba87866b8b86e0cb2e2a5987bd37940c5f0de,1,0,1,1,1,2011-12-22 08:32:21,2011-12-21 04:25:56
892ba87866b8b86e0cb2e2a5987bd37940c5f0de...d8c178bc16295b11c445b6f25432e549ef624e77,1,7,6,13,4,2011-12-22 13:42:25,2011-12-22 13:42:20
d8c178bc16295b11c445b6f25432e549ef624e77...045bfe0da566d8c0b2ce998dbb38055ab783391c,1,4,3,7,3,2011-12-22 15:57:07,2011-12-22 14:39:53
045bfe0da566d8c0b2ce998dbb38055ab783391c...5976d5879621730b28b611da82c7f12286fd5fba,2,45,0,45,2,2011-12-22 16:25:14,2011-12-22 02:32:27
5976d5879621730b28b611da82c7f12286fd5fba...b261e37a342fbc9e1219cbb19bfe9730c98d1533,1,7,1,8,2,2011-12-22 16:28:23,2011-12-22 16:28:23
b261e37a342fbc9e1219cbb19bfe9730c98d1533...cf2513e1aaf8034162664e402267768bdaa349c1,1,2,2,4,2,2011-12-22 22:26:43,2011-12-22 01:38:12
cf2513e1aaf8034162664e402267768bdaa349c1...c6347dcfb43273214dc872e60c8cd94a93fee027,1,41,0,41,1,2011-12-23 02:09:36,2011-12-23 02:09:36
c6347dcfb43273214dc872e60c8cd94a93fee027...d85c85aac1e2e87c0dbac7feddeb38f23da6d700,1,1,1,2,1,2011-12-23 23:10:22,2011-12-23 23:10:06
c2d9e62f1691ace1c837811716aa515d5c4947fc...48a9a2d3557a2610f1f1597b367def90736f9c90,1,3,0,3,1,2011-12-24 01:42:27,2011-12-24 01:42:27
48a9a2d3557a2610f1f1597b367def90736f9c90...e6b6075024e9f1330575b10d7e6552e1ea6dad56,2,121,7,128,8,2011-12-26 15:14:47,2011-12-26 15:14:47
e6b6075024e9f1330575b10d7e6552e1ea6dad56...b962ff35ddcd7b2120dd1804dcd3109d924c513a,1,23,21,44,3,2011-12-27 08:33:23,2011-12-27 08:33:23
d85c85aac1e2e87c0dbac7feddeb38f23da6d700...ed5bad754c1ff5a4544ef8ac6f2eed0261a9aec7,1,2,1,3,2,2011-12-26 02:23:34,2011-12-26 02:23:34
ed5bad754c1ff5a4544ef8ac6f2eed0261a9aec7...0de6ec5f08161d481c9cca73ab49cb9fba1b7699,1,2,2,4,2,2011-12-26 02:27:28,2011-12-26 02:27:28
0de6ec5f08161d481c9cca73ab49cb9fba1b7699...7aa5924dc6e8d80980a9b79f3d5fc6305bf1aea7,4,41,21,62,16,2011-12-26 07:05:35,2011-11-29 11:55:05
7aa5924dc6e8d80980a9b79f3d5fc6305bf1aea7...70e6f3f115cfbd74462ec50e3cdc8fac89ae922a,1,1,0,1,1,2011-12-26 22:30:25,2011-12-26 22:30:25
70e6f3f115cfbd74462ec50e3cdc8fac89ae922a...a337ac75843ba4547a18d5b7c09930d5f5d954fa,2,73,0,73,2,2011-12-27 08:42:37,2011-12-27 08:42:37
a337ac75843ba4547a18d5b7c09930d5f5d954fa...e1c043f43a42d1645c67761be4b1db913862d968,13,177,146,323,127,2011-12-27 08:43:58,2011-12-27 08:43:58
e1c043f43a42d1645c67761be4b1db913862d968...a848a3efbfeb70181a95383e022474fdf2c83aae,2,59,2,61,3,2011-12-28 06:13:57,2011-12-28 06:13:57
a848a3efbfeb70181a95383e022474fdf2c83aae...d483acc5d9c67052366f10a23ebd46a96f989e05,1,0,7,7,1,2011-12-28 16:22:29,2011-12-28 16:13:28
d483acc5d9c67052366f10a23ebd46a96f989e05...448c5e07ca594399f3d3f93ea6f97124ea56af95,1,10,16,26,5,2011-12-28 22:08:19,2011-12-28 22:08:19
b962ff35ddcd7b2120dd1804dcd3109d924c513a...b037c16f55c3f03a52f85d6ba0a748eb11b7ec21,1,1,1,2,1,2011-12-28 06:18:11,2011-12-28 06:18:11
b037c16f55c3f03a52f85d6ba0a748eb11b7ec21...b7c05e1b75e5c64d53b7b0877791ce001020f671,28,270,87,357,52,2011-12-28 22:13:50,2011-12-28 22:13:50
b962ff35ddcd7b2120dd1804dcd3109d924c513a...0d5a6b2d9d5070606065eb9e0a7af1e4d7831777,1,2,0,2,2,2011-12-27 20:54:19,2011-11-22 15:07:34
0d5a6b2d9d5070606065eb9e0a7af1e4d7831777...c3346f6760f3f4e68a825a0826ebc93c2e150092,17,198,75,273,83,2011-12-27 20:54:20,2011-11-22 16:10:09
c3346f6760f3f4e68a825a0826ebc93c2e150092...2a7a2ca986a846630726602b94dcebe657ee2efa,4,793,3,796,10,2011-12-27 20:54:20,2011-11-23 19:50:28
2a7a2ca986a846630726602b94dcebe657ee2efa...39e2c469db86c4cdcef901dd619cdeb5a3e62065,2,12,0,12,3,2011-12-27 20:54:20,2011-11-29 15:41:41
39e2c469db86c4cdcef901dd619cdeb5a3e62065...a778a25cabdef7a94c34a315706568688d942028,3,102,14,116,3,2011-12-27 20:54:21,2011-11-29 16:35:19
a778a25cabdef7a94c34a315706568688d942028...edbec3f8f3e8f8239a9b1c9a9a0a229efcdb4938,2,56,1,57,5,2011-12-27 20:54:21,2011-11-23 20:46:22
edbec3f8f3e8f8239a9b1c9a9a0a229efcdb4938...9caeceef6dd497d922330a281fbae021a6ef200d,4,30,5,35,9,2011-12-27 20:54:21,2011-12-09 06:44:10
9caeceef6dd497d922330a281fbae021a6ef200d...8a538ce372c49b23af7582560cf40ba2c2637691,3,8,17,25,11,2011-12-27 20:54:22,2011-12-09 17:49:17
8a538ce372c49b23af7582560cf40ba2c2637691...3aadd4fe7678b35f0f4df55833bef081ec7b3ef5,1,44,42,86,16,2011-12-27 20:54:22,2011-12-09 18:02:33
3aadd4fe7678b35f0f4df55833bef081ec7b3ef5...9d71e74491081f2682224ce0b92079faf2f97782,2,9,9,18,5,2011-12-27 20:54:22,2011-12-09 20:12:48
9d71e74491081f2682224ce0b92079faf2f97782...3063ba080082ed5f32655b3b61b9ca06842dec31,2,18,0,18,4,2011-12-27 20:54:22,2011-12-09 20:14:00
3063ba080082ed5f32655b3b61b9ca06842dec31...d329fc7b09890876030542c53f932a510219bc0b,1,103,18,121,21,2011-12-27 20:54:22,2011-12-09 20:49:10
d329fc7b09890876030542c53f932a510219bc0b...469cb1b7b7fea6a2543547ce4723f2db699ed9d5,3,8,747,755,9,2011-12-27 20:54:22,2011-12-12 14:47:00
469cb1b7b7fea6a2543547ce4723f2db699ed9d5...39a492799dca305f330c4693765ea8a951fc0d19,3,29,30,59,15,2011-12-27 20:54:22,2011-12-13 19:49:32
39a492799dca305f330c4693765ea8a951fc0d19...78a25696f1ef88e245c9b88a25244d73e517ecd1,3,14,9,23,8,2011-12-27 20:54:23,2011-12-13 22:48:36
78a25696f1ef88e245c9b88a25244d73e517ecd1...1a433b9637791d57c4ef2c94675e9a6ae1722b81,3,45,4,49,16,2011-12-27 20:54:23,2011-12-15 22:20:27
1a433b9637791d57c4ef2c94675e9a6ae1722b81...2d8c1fe1ed7ed3be91cd2cb12eda626e77a61c1e,1,3,3,6,2,2011-12-27 20:54:23,2011-12-17 07:23:34
2d8c1fe1ed7ed3be91cd2cb12eda626e77a61c1e...41062e71a7fb5f6447d521f9cd9e6a34a2ea4bcc,4,107,82,189,26,2011-12-27 20:54:23,2011-12-18 18:56:48
41062e71a7fb5f6447d521f9cd9e6a34a2ea4bcc...a8506c41c6ecf6961c7502c97dcc1032440f14a4,2,22,6,28,6,2011-12-27 20:54:23,2011-12-19 06:49:20
a8506c41c6ecf6961c7502c97dcc1032440f14a4...8c476371f5996a261d17a6d4af6c8d9bb127eff9,1,21,10,31,5,2011-12-27 20:54:23,2011-12-19 07:39:49
8c476371f5996a261d17a6d4af6c8d9bb127eff9...87bb848268820ec9b91ea860dadf3ba3769cdea4,15,14,1,15,15,2011-12-27 20:54:23,2011-12-21 22:02:52
87bb848268820ec9b91ea860dadf3ba3769cdea4...02f24f54ba4cbe6f4d8e6eecd6eb08c07a4569bd,3,81,0,81,3,2011-12-27 20:54:24,2011-12-21 21:55:05
02f24f54ba4cbe6f4d8e6eecd6eb08c07a4569bd...c481f97a9c16c812979f8408171a5cece4b1d918,9,182,186,368,112,2011-12-27 20:54:24,2011-12-22 16:09:00
c481f97a9c16c812979f8408171a5cece4b1d918...9d792f3183be5490f5c3b3d579524fdf246795b9,15,93,82,175,82,2011-12-27 20:54:25,2011-12-22 21:40:26
9d792f3183be5490f5c3b3d579524fdf246795b9...533a4552745d24ab61fb1e0b8617903f19557046,6,130,91,221,18,2011-12-27 20:54:25,2011-12-23 22:06:32
533a4552745d24ab61fb1e0b8617903f19557046...036e59394a0d8055c19174e8834128712e6da9f4,1,9,0,9,1,2011-12-27 21:06:25,2011-12-27 21:06:25
036e59394a0d8055c19174e8834128712e6da9f4...b31969913240ab5d8fc2d570202ee86f0500f28f,3,26,1,27,3,2011-12-28 02:11:32,2011-12-28 02:11:32
b31969913240ab5d8fc2d570202ee86f0500f28f...59faab4330c2c07eed57232cde03d0484751c23b,1,2,2,4,2,2011-12-28 22:56:53,2011-12-28 22:56:53
59faab4330c2c07eed57232cde03d0484751c23b...2afd20b5425e62c3019278d6682b62171664f456,5,150,8,158,10,2011-12-28 23:18:23,2011-12-28 23:18:23
2afd20b5425e62c3019278d6682b62171664f456...9143b43e98ce2ea3d8eea49cc0f171f53ecf7029,2,107,0,107,2,2011-12-28 23:59:06,2011-12-28 23:40:40
9143b43e98ce2ea3d8eea49cc0f171f53ecf7029...5427311ae6800e0cdcbf1dfb352c084fd01d2b58,1,5,0,5,1,2011-12-29 00:43:24,2011-12-29 00:42:18
448c5e07ca594399f3d3f93ea6f97124ea56af95...8c3a757ffc7d77d367dd348eee97187564d5fb2f,1,1,1,2,1,2011-12-29 13:35:52,2011-12-28 20:14:30
8c3a757ffc7d77d367dd348eee97187564d5fb2f...744ed46970ad2acd25b7e8539578b856ec35383a,1,2,2,4,1,2011-12-29 13:46:04,2011-12-29 02:15:49
744ed46970ad2acd25b7e8539578b856ec35383a...3f5bb15f353d607783a5937972bc990fcd67892a,1,1,0,1,1,2011-12-29 13:57:53,2011-12-29 13:57:53
3f5bb15f353d607783a5937972bc990fcd67892a...432a2e4d397908965cfbdc44eb8a10c7fb840701,1,72,0,72,1,2011-12-29 21:37:03,2011-12-29 21:36:13
432a2e4d397908965cfbdc44eb8a10c7fb840701...8b2abed03df9bc16b37d1ac21bfc68b36dfa9f47,1,6,0,6,1,2011-12-30 01:03:10,2011-12-30 01:03:08
8b2abed03df9bc16b37d1ac21bfc68b36dfa9f47...539598b11f34344c4e17afcb56b04a257f4fa3b2,1,6,6,12,3,2011-12-31 02:17:19,2011-12-31 02:16:04
539598b11f34344c4e17afcb56b04a257f4fa3b2...8e57398b2032ca62712c3d846d22d4c04820bace,1,11,3,14,4,2011-12-31 02:20:41,2011-11-08 00:10:21
8e57398b2032ca62712c3d846d22d4c04820bace...c2fb062f60a596db3e03b3b34cb5b4d0c54d9553,1,2,2,4,2,2012-01-01 22:39:29,2012-01-01 22:36:03
c2fb062f60a596db3e03b3b34cb5b4d0c54d9553...41f2725639dd10378cb0a5a57fe29157d7b926e9,10,223,32,255,35,2012-01-02 09:43:10,2012-01-02 09:43:10
41f2725639dd10378cb0a5a57fe29157d7b926e9...884f689efecee487788d0b2d1289018735f2841c,1,6,0,6,1,2012-01-02 09:48:35,2012-01-02 09:48:33
884f689efecee487788d0b2d1289018735f2841c...6f8839d2ac362ced42235a34a023af5e2c656501,2,16,12,28,5,2012-01-02 11:02:07,2012-01-02 11:02:05
6f8839d2ac362ced42235a34a023af5e2c656501...2cde4983199473a1bf1650ef485f94b68194aa85,1,10,2,12,4,2012-01-04 01:15:25,2012-01-04 01:14:58
2cde4983199473a1bf1650ef485f94b68194aa85...f3da6c6c045fb9d629509cea53e3631342f785d3,2,51,33,84,22,2012-01-04 01:43:39,2011-12-30 00:06:14
f3da6c6c045fb9d629509cea53e3631342f785d3...3452477dcb652cc539eb878b103808113d31ac49,1,4,4,8,3,2012-01-04 19:20:50,2012-01-04 19:20:50
3452477dcb652cc539eb878b103808113d31ac49...baebd30eeec84d73617183be4b5be92557518d6c,1,1,1,2,1,2012-01-05 08:43:00,2012-01-05 08:43:00
baebd30eeec84d73617183be4b5be92557518d6c...760928bfad44119d8790311f63f8fcf64b59f836,1,1,1,2,1,2012-01-05 15:44:22,2012-01-05 15:44:11
760928bfad44119d8790311f63f8fcf64b59f836...78dbb4b5b1bd45824f9345e0435d0071263db176,204,835,326,1161,282,2012-01-05 19:22:49,2012-01-04 23:09:13
78dbb4b5b1bd45824f9345e0435d0071263db176...dd9593ccc4dd1de21faa1996c2577c7a6ac3d8ae,3,37,20,57,6,2012-01-06 06:45:21,2012-01-05 11:50:03
dd9593ccc4dd1de21faa1996c2577c7a6ac3d8ae...4a899c92742583ca9e0bb7d16e09a66b08c9d033,23,446,162,608,88,2012-01-06 16:02:01,2012-01-06 16:02:01
4a899c92742583ca9e0bb7d16e09a66b08c9d033...8bd80f49117d6a772584a8d93dface0fb31ad931,1,21,9,30,2,2012-01-06 18:22:24,2012-01-06 18:22:18
8bd80f49117d6a772584a8d93dface0fb31ad931...be67fa7e095d47806983e126ef45639c7d9a2867,2,12,16,28,5,2012-01-06 20:01:58,2012-01-06 20:00:36
be67fa7e095d47806983e126ef45639c7d9a2867...bca88b2dc120879c8e427db8bbc16a3f104e4cb4,2,11,1,12,5,2012-01-07 00:26:16,2012-01-07 00:20:45
bca88b2dc120879c8e427db8bbc16a3f104e4cb4...d84a6ba3d131471fa6dfc719cf48a4f7a2372a5e,1,2,2,4,1,2012-01-07 00:31:03,2012-01-07 00:30:46
d84a6ba3d131471fa6dfc719cf48a4f7a2372a5e...d5a189acef14a851287ee555f7a39431fe276e1c,6,61,12,73,8,2012-01-07 00:31:03,2012-01-05 23:44:04
d5a189acef14a851287ee555f7a39431fe276e1c...ff4096f958fcf1fb19f17159393bb8037f3db071,1,2,2,4,1,2012-01-07 01:36:39,2012-01-07 01:36:39
ff4096f958fcf1fb19f17159393bb8037f3db071...57653added992b3aa40f35b11d635b72e2b6b16c,3,6,5,11,3,2012-01-07 05:44:35,2012-01-07 05:44:35
57653added992b3aa40f35b11d635b72e2b6b16c...9ef3c6238b022a52d564799bab38bcdb78dd3565,1,1,1,2,1,2012-01-07 06:51:51,2012-01-07 06:51:51
9ef3c6238b022a52d564799bab38bcdb78dd3565...472a72d27faccbd0c22d38554286ae4200a96162,2,22,17,39,18,2012-01-08 20:25:04,2012-01-08 20:17:28
472a72d27faccbd0c22d38554286ae4200a96162...9a79bb694e52ea83fd09904f0684e9f7a1c39150,1,4,0,4,1,2012-01-08 23:50:26,2012-01-08 23:45:19
9a79bb694e52ea83fd09904f0684e9f7a1c39150...22d7fe12067be32ac456045f8f2014526e4aabb4,2,27,18,45,3,2012-01-09 03:02:01,2012-01-08 15:53:17
22d7fe12067be32ac456045f8f2014526e4aabb4...cc5cea35b0e25352ff40780532d4c5a6bba00359,1,12,0,12,1,2012-01-09 14:46:30,2012-01-09 14:45:51
bc7bae1d6be616b290e644ac3e2e403b29e199c1...e9f8e2842636650bdfa8101e6204003707661820,1,2,0,2,2,2011-12-29 00:56:09,2011-11-22 15:07:34
e9f8e2842636650bdfa8101e6204003707661820...356992fe4ded4d48e487aa9f0826a9b9ce022bcb,17,198,75,273,83,2011-12-29 00:56:09,2011-11-22 16:10:09
356992fe4ded4d48e487aa9f0826a9b9ce022bcb...66116924edb6fcdb2b30f809f479e3f750ca4d61,4,793,3,796,10,2011-12-29 00:56:09,2011-11-23 19:50:28
66116924edb6fcdb2b30f809f479e3f750ca4d61...b3d4938e3e04394f672f8f15feb779b231424bb6,2,12,0,12,3,2011-12-29 00:56:09,2011-11-29 15:41:41
b3d4938e3e04394f672f8f15feb779b231424bb6...09dc57793147cf6c56de1cb783c29053ef46e93a,3,102,14,116,3,2011-12-29 00:56:09,2011-11-29 16:35:19
09dc57793147cf6c56de1cb783c29053ef46e93a...eb6e60432b3930107c9e95538bf50c4accdc6ebc,2,56,1,57,5,2011-12-29 00:56:09,2011-11-23 20:46:22
eb6e60432b3930107c9e95538bf50c4accdc6ebc...828bf50a0eec3f5c7b7e86bbd636d78f7e0f15b5,4,30,5,35,9,2011-12-29 00:56:09,2011-12-09 06:44:10
828bf50a0eec3f5c7b7e86bbd636d78f7e0f15b5...2df81c57f6e40645478bdbaf20c668a6bdd277a4,3,8,17,25,11,2011-12-29 00:56:10,2011-12-09 17:49:17
2df81c57f6e40645478bdbaf20c668a6bdd277a4...5866f1a9aa4b489f7a44a5ecc7ac1c1dfe88426a,1,44,42,86,16,2011-12-29 00:56:10,2011-12-09 18:02:33
5866f1a9aa4b489f7a44a5ecc7ac1c1dfe88426a...ea97d6ed5ff659a48a0fa715fb6572758b7ddd34,2,9,9,18,5,2011-12-29 00:56:10,2011-12-09 20:12:48
ea97d6ed5ff659a48a0fa715fb6572758b7ddd34...ca19e792c6fab644bec73ffb116cbc126e4da13f,2,18,0,18,4,2011-12-29 00:56:10,2011-12-09 20:14:00
ca19e792c6fab644bec73ffb116cbc126e4da13f...809fdf26fbb48af8f441493b797a6a809b3aeff6,1,103,18,121,21,2011-12-29 00:56:10,2011-12-09 20:49:10
809fdf26fbb48af8f441493b797a6a809b3aeff6...6eeb59abf6beb514be2aee745dfa029048728827,3,8,747,755,9,2011-12-29 00:56:10,2011-12-12 14:47:00
6eeb59abf6beb514be2aee745dfa029048728827...45bb10cc325d86637fe01c36c2ef6e8d1900bd13,3,29,30,59,15,2011-12-29 00:56:10,2011-12-13 19:49:32
45bb10cc325d86637fe01c36c2ef6e8d1900bd13...863f17f68c4cbac9c310603bb174bb641d521a15,3,14,9,23,8,2011-12-29 00:56:10,2011-12-13 22:48:36
863f17f68c4cbac9c310603bb174bb641d521a15...4f46ee440005676b2724f41dfba3e81aa66d0d73,3,45,4,49,16,2011-12-29 00:56:10,2011-12-15 22:20:27
4f46ee440005676b2724f41dfba3e81aa66d0d73...4d02e77f44faa4184f14ad7dd061646acf745815,1,3,3,6,2,2011-12-29 00:56:10,2011-12-17 07:23:34
4d02e77f44faa4184f14ad7dd061646acf745815...268476549eeef01e9876ca3f1c58af61be414d75,4,107,82,189,26,2011-12-29 00:56:10,2011-12-18 18:56:48
268476549eeef01e9876ca3f1c58af61be414d75...a0f3eb015a9a062746b7dc5d562108d6fb98209a,2,22,6,28,6,2011-12-29 00:56:10,2011-12-19 06:49:20
a0f3eb015a9a062746b7dc5d562108d6fb98209a...2c560c5405c3b5fba9e37fb0c3d722421f1447ec,1,21,10,31,5,2011-12-29 00:56:10,2011-12-19 07:39:49
2c560c5405c3b5fba9e37fb0c3d722421f1447ec...f168f7d702828dc88bf3198b2a8bf01a385bda5d,15,14,1,15,15,2011-12-29 00:56:10,2011-12-21 22:02:52
f168f7d702828dc88bf3198b2a8bf01a385bda5d...40c98a977b2d4912e9f167257553063d6dd21272,3,81,0,81,3,2011-12-29 00:56:11,2011-12-21 21:55:05
40c98a977b2d4912e9f167257553063d6dd21272...dd0188ec088fc87ee689e4efa193e241199de615,9,182,186,368,112,2011-12-29 00:56:11,2011-12-22 16:09:00
dd0188ec088fc87ee689e4efa193e241199de615...20ba454ef9e8ff2bb19abb26f9b95265beb98e11,15,93,82,175,82,2011-12-29 00:56:11,2011-12-22 21:40:26
20ba454ef9e8ff2bb19abb26f9b95265beb98e11...5fc0c27d5cc3455ed37eccd748ffc2f90b45a635,6,130,91,221,18,2011-12-29 00:56:11,2011-12-23 22:06:32
5fc0c27d5cc3455ed37eccd748ffc2f90b45a635...649dbbbd833bd29d69d76afa74f5afd453003640,1,9,0,9,1,2011-12-29 00:56:11,2011-12-27 21:06:25
649dbbbd833bd29d69d76afa74f5afd453003640...4428b70cbaf94d0af4e18dd727facd3a6b7ec272,3,26,1,27,3,2011-12-29 00:56:11,2011-12-28 02:11:32
4428b70cbaf94d0af4e18dd727facd3a6b7ec272...cdb5864fc329b53a2b28fe404679ae72021757b1,1,2,2,4,2,2011-12-29 00:56:11,2011-12-28 22:56:53
cdb5864fc329b53a2b28fe404679ae72021757b1...25ca13ec1a6166c96a77d4d04e4de1a95472521b,5,150,8,158,10,2011-12-29 00:56:11,2011-12-28 23:18:23
25ca13ec1a6166c96a77d4d04e4de1a95472521b...fa43f04f6a360536c71e424d65f227a5af3c0db9,2,107,0,107,2,2011-12-29 00:56:11,2011-12-28 23:40:40
c123ac05dc37311d3dfb37ed6f22baef58280379...557fc396b4f5c165de90fbf9eaecb4370b46c057,18,301,60,361,50,2012-01-03 19:46:53,2012-01-03 19:46:53
557fc396b4f5c165de90fbf9eaecb4370b46c057...e21643d618a923a484b1f692ceeabffa6855e6cf,1,1,1,2,1,2012-01-04 15:36:08,2012-01-04 15:36:08
e21643d618a923a484b1f692ceeabffa6855e6cf...5f08c3cfa1ee3ece6032d1ffeda6f403e54dd5c0,11,928,165,1093,73,2012-01-05 02:30:19,2011-12-20 09:42:48
5f08c3cfa1ee3ece6032d1ffeda6f403e54dd5c0...e2f1e50c604be8e4f0280c3a35ffff6367800c9d,3,14,14,28,9,2012-01-05 08:31:49,2012-01-05 07:57:54
e2f1e50c604be8e4f0280c3a35ffff6367800c9d...a993d22c0f587beef44e56877b442db47da78ced,1,1,0,1,1,2012-01-05 15:50:44,2012-01-05 12:01:29
a993d22c0f587beef44e56877b442db47da78ced...55c21970fd7c180ebcaa4da2f9894bc76f7ca7bb,1,1,3,4,1,2012-01-05 15:50:55,2012-01-05 12:25:07
55c21970fd7c180ebcaa4da2f9894bc76f7ca7bb...5b05429bf0fa210fa8ac12ddff0d824b310da893,3,238,64,302,14,2012-01-05 19:56:41,2011-12-31 08:30:42
5b05429bf0fa210fa8ac12ddff0d824b310da893...aa67b1f3750646a0f30e12a3b4e4fcb84dc8cafa,4,278,4,282,8,2012-01-05 20:39:57,2011-11-02 18:06:16
aa67b1f3750646a0f30e12a3b4e4fcb84dc8cafa...075acfa2d6c823ec9ccedba5fdbca172752d1e4a,9,216,11,227,16,2012-01-05 23:00:40,2012-01-03 14:15:54
075acfa2d6c823ec9ccedba5fdbca172752d1e4a...dadc30318f812587405dd58d9a5d10ce392710b3,6,382,113,495,37,2012-01-05 23:42:55,2012-01-05 00:02:59
dadc30318f812587405dd58d9a5d10ce392710b3...1e73e4c62f14e8c68c284b20fd754523af63f157,3,14,57,71,13,2012-01-05 23:45:27,2012-01-05 00:12:48
1e73e4c62f14e8c68c284b20fd754523af63f157...42281124d4b83b0e99baf5d56b696ef242399f51,2,70,9,79,6,2012-01-05 23:47:14,2012-01-05 23:42:10
42281124d4b83b0e99baf5d56b696ef242399f51...8e5674fb5cb31fd872b9b74fde0430603806a48a,47,866,271,1137,186,2012-01-06 21:03:06,2012-01-06 21:03:06
8e5674fb5cb31fd872b9b74fde0430603806a48a...4b4d05979118b028f6d198ee1782c1b48a0ea8fc,1,27,20,47,5,2012-01-08 10:12:56,2011-11-01 15:23:30
4b4d05979118b028f6d198ee1782c1b48a0ea8fc...df0edf5fe693865948759000de194b5fa31a9a40,1,3,1,4,1,2012-01-08 10:13:18,2011-11-01 15:27:42
df0edf5fe693865948759000de194b5fa31a9a40...39484f49ef60e2ebf05ad70838d9572e56558347,14,29,21,50,28,2012-01-08 10:13:28,2011-11-01 15:28:04
39484f49ef60e2ebf05ad70838d9572e56558347...0321adbcf46caeeba96eddbc5e122be1cf0c8c11,1,8,2,10,2,2012-01-08 10:13:36,2011-11-02 00:27:50
0321adbcf46caeeba96eddbc5e122be1cf0c8c11...70033bd96098fd230fcb45287f4664115bc0ec63,3,150,40,190,22,2012-01-09 01:18:39,2012-01-09 01:18:39
70033bd96098fd230fcb45287f4664115bc0ec63...c1a63a9e905f90684c3c22eae59cbe12fced661c,3,67,2,69,4,2012-01-09 01:31:46,2012-01-09 01:28:49
c1a63a9e905f90684c3c22eae59cbe12fced661c...08a91acd76cd107dc2f3914f9ea7e277bb85206e,3,223,37,260,30,2012-01-09 02:51:06,2012-01-09 02:51:06
cc5cea35b0e25352ff40780532d4c5a6bba00359...d5d043f2d72e88669e2e3621651153316831034e,1,6,1,7,3,2012-01-09 19:54:37,2012-01-09 19:39:06
d5d043f2d72e88669e2e3621651153316831034e...b07acb38086c3ad16817743391b7520d27032b2a,1,8,6,14,2,2012-01-09 19:54:37,2012-01-09 19:42:11
b07acb38086c3ad16817743391b7520d27032b2a...e6a30bd1077ee6dc4139f423db052c3de50ad1ef,2,10,7,17,4,2012-01-10 18:49:38,2012-01-09 23:29:15
e6a30bd1077ee6dc4139f423db052c3de50ad1ef...2d8af39accc6e1a863aa60ed80289508f3df50e8,1,1,1,2,1,2012-01-10 20:01:18,2012-01-10 19:51:45
2d8af39accc6e1a863aa60ed80289508f3df50e8...0ad2717fd88e5ddd28a1c245c78b37bfe9aa4197,1,2,0,2,2,2012-01-10 20:01:19,2012-01-10 19:54:40
0ad2717fd88e5ddd28a1c245c78b37bfe9aa4197...290bc0c067a63a90f3c02c4cffc4892fad7562aa,5,2,2,4,1,2012-01-10 22:26:22,2012-01-10 20:13:48
290bc0c067a63a90f3c02c4cffc4892fad7562aa...8cca30f31b2b71812e340692f2892fd5bf9df5db,1,17,20,37,16,2012-01-11 00:42:52,2012-01-10 20:07:30
8cca30f31b2b71812e340692f2892fd5bf9df5db...b073989e17b4ae9ca43cbcc0c004f40e99812c2a,1,1,1,2,1,2012-01-11 09:42:33,2012-01-10 22:29:11
b073989e17b4ae9ca43cbcc0c004f40e99812c2a...07701e7cc85feaeaa0a2a6c8146b0cb3eefc12fe,1,15,23,38,12,2012-01-11 19:43:49,2012-01-11 17:46:10
0c3b357985fd1b0b402e17b1dcecaec9d9e4bdd3...c24276f0087a5f72f68be2384f32e20ba83dfa09,2,10,3,13,2,2011-12-29 18:30:07,2011-12-29 18:30:07
8b28d599a72e717dc00d10f2cc68e64ac6fd5330...b28e700ebdf6583364fec3171390a24153f79632,1,1,36,37,1,2012-01-09 20:59:28,2012-01-09 20:59:26
b28e700ebdf6583364fec3171390a24153f79632...787f62de8c98235a16288fb2b53912eddf59fada,1,61,33,94,13,2012-01-09 21:04:13,2012-01-04 14:28:13
787f62de8c98235a16288fb2b53912eddf59fada...97e4b3a7bff68b6f19edca8d1ca3ea540667fbd3,2,53,18,71,16,2012-01-10 01:09:08,2012-01-10 01:08:42
97e4b3a7bff68b6f19edca8d1ca3ea540667fbd3...a5f74b4da7ad3f4946cb5e0db7c94ee6bf8e5718,2,26,29,55,23,2012-01-10 01:19:14,2012-01-06 18:24:41
a5f74b4da7ad3f4946cb5e0db7c94ee6bf8e5718...44e703327970be080877ad7c02f57f0713b553b8,2,0,29,29,4,2012-01-10 01:19:14,2012-01-06 18:26:53
44e703327970be080877ad7c02f57f0713b553b8...99679c643028eba79b81d0a3eaa204af1cce2d15,5,288,8,296,21,2012-01-10 01:28:42,2012-01-06 18:27:55
99679c643028eba79b81d0a3eaa204af1cce2d15...6b2091b58ab7cdef5651aa16641c5f274687561f,2,53,16,69,11,2012-01-10 01:28:49,2012-01-06 18:28:20
6b2091b58ab7cdef5651aa16641c5f274687561f...7cee968c21278d7a947a58699f7ce5413ad48973,2,7,0,7,6,2012-01-10 15:46:41,2012-01-10 15:46:06
7cee968c21278d7a947a58699f7ce5413ad48973...4cbcdb4b2cfac0fb22775180c814258e4b694def,2,26,12,38,2,2012-01-10 15:48:45,2012-01-10 14:56:30
4cbcdb4b2cfac0fb22775180c814258e4b694def...d4ee61ffc7938e9a1167aadb94b9cf60e4310fe1,4,20,3,23,4,2012-01-10 19:48:02,2012-01-10 19:47:32
d4ee61ffc7938e9a1167aadb94b9cf60e4310fe1...e1b829d2a502b5181d7a9d13e79d839ba0601421,2,18,1,19,3,2012-01-10 20:04:19,2012-01-10 20:04:16
e1b829d2a502b5181d7a9d13e79d839ba0601421...4d49469d0df0730b16630d8f32fbfc55aaaa0952,1,1,1,2,1,2012-01-10 22:16:07,2012-01-10 22:07:12
4d49469d0df0730b16630d8f32fbfc55aaaa0952...c8108aad832b4734a4bc14ab6e2e052218be3990,2,2,2,4,2,2012-01-11 08:59:50,2012-01-11 08:02:51
c8108aad832b4734a4bc14ab6e2e052218be3990...8abb73ef58ccb6fd1b8cc4266c9981ce6574c78f,1,19,21,40,13,2012-01-11 09:42:39,2012-01-03 09:14:02
07701e7cc85feaeaa0a2a6c8146b0cb3eefc12fe...247d0da188e70949a48739fc42dbf5da4d7b8b40,3,77,24,101,13,2012-01-12 03:35:03,2012-01-12 03:34:56
247d0da188e70949a48739fc42dbf5da4d7b8b40...465e22e62f8eb927464bb6210ec786ab289813f9,1,18,16,34,4,2012-01-12 13:44:41,2012-01-12 13:41:04
465e22e62f8eb927464bb6210ec786ab289813f9...bd9fa2e8419dda3ecff55ca7d801af3db4aeb5b2,1,59,9,68,13,2012-01-12 16:34:15,2012-01-12 04:42:24
bd9fa2e8419dda3ecff55ca7d801af3db4aeb5b2...766f609838734f7ddf2ee9503e8205647ecb5dbf,2,28,13,41,4,2012-01-12 22:24:40,2012-01-12 22:08:08
766f609838734f7ddf2ee9503e8205647ecb5dbf...f0c1376e07e6d5a4deb3d088bd3153d7f6af1298,2,22,1,23,3,2012-01-14 01:13:24,2012-01-14 01:13:22
f0c1376e07e6d5a4deb3d088bd3153d7f6af1298...25410096b4c38eb9b17501ea06349872ab33e1ea,142,1824,798,2622,382,2012-01-16 23:06:16,2012-01-16 23:06:16
9e6957b0a55e7ef8cd2a2efc066555da8d781355...89556f5a2f64abcc6cecd3d412488e2ff6d6cd01,1,9,13,22,5,2012-01-11 21:11:31,2012-01-11 21:11:31
89556f5a2f64abcc6cecd3d412488e2ff6d6cd01...71ae1753196f41d569d20a940ed036a50c292069,3,93,32,125,10,2012-01-11 21:19:19,2012-01-11 21:12:13
71ae1753196f41d569d20a940ed036a50c292069...7dffbaf2ced12751b73e433b12721efa8b38ad5d,3,35,11,46,9,2012-01-12 05:17:19,2012-01-12 05:16:03
7dffbaf2ced12751b73e433b12721efa8b38ad5d...9ff86a2848c2e047ac05dd0fb6f584d8e3111ab7,1,4,0,4,1,2012-01-12 14:10:11,2012-01-11 22:36:27
9ff86a2848c2e047ac05dd0fb6f584d8e3111ab7...f2ba4cef2af79b89b0b1a201496ee134f4891b7f,1,3,0,3,1,2012-01-12 14:11:02,2012-01-11 22:44:39
f2ba4cef2af79b89b0b1a201496ee134f4891b7f...e03b42d1bb41f4e897a4f025f89db70582964814,1,28,0,28,1,2012-01-14 17:48:56,2012-01-14 17:48:56
e03b42d1bb41f4e897a4f025f89db70582964814...220288725fc05f9838ec0a77876d9d9f1491da5a,1,21,0,21,1,2012-01-14 17:51:53,2012-01-14 17:51:53
220288725fc05f9838ec0a77876d9d9f1491da5a...93465d30511db82d0f759905d0cde52c8d5ea53e,1,2,3,5,3,2012-01-15 15:50:58,2012-01-15 15:50:58
93465d30511db82d0f759905d0cde52c8d5ea53e...8a98c2f1d81cabb6594dc388789d60d2f3f67c09,5,49,6,55,12,2012-01-15 20:45:05,2012-01-15 19:45:31
8a98c2f1d81cabb6594dc388789d60d2f3f67c09...03cb903e7e3a35350ba09af052eac7844ae070e9,2,1,6,7,4,2012-01-16 00:41:29,2012-01-16 00:41:26
03cb903e7e3a35350ba09af052eac7844ae070e9...f1678bfc65bcb2cda47bcb38f46b1723f0b26877,2,105,12,117,6,2012-01-16 10:36:23,2012-01-16 10:11:29
f1678bfc65bcb2cda47bcb38f46b1723f0b26877...23de33968f2b61a784b67308980e31a8d11bf094,2,22,1,23,2,2012-01-16 10:36:24,2012-01-16 10:13:43
23de33968f2b61a784b67308980e31a8d11bf094...df62005ece4bb0be0d5af645fd9093b1506ce63d,1,10,9,19,3,2012-01-16 13:19:56,2012-01-16 12:54:35
df62005ece4bb0be0d5af645fd9093b1506ce63d...03e689fae45ce31282b588f424988f90c9d652bb,1,9,10,19,3,2012-01-16 13:33:16,2012-01-16 13:33:16
03e689fae45ce31282b588f424988f90c9d652bb...f0c629a36be217db68261eb54c6e134a4dba1c61,14,97,230,327,30,2012-01-16 14:18:37,2012-01-16 14:18:37
f0c629a36be217db68261eb54c6e134a4dba1c61...d5047f5fe669c0434da99e2aacd197e228d040a4,1,2,2,4,1,2012-01-16 18:45:14,2012-01-16 16:50:18
d5047f5fe669c0434da99e2aacd197e228d040a4...3d1476a3168effe3edb32510f56cf9b00bce8392,3,25,11,36,8,2012-01-16 20:44:26,2012-01-16 18:17:45
3d1476a3168effe3edb32510f56cf9b00bce8392...1afd0b52fe9bb4642a44b48dabf9d7b26d00e4ab,3,11,25,36,8,2012-01-16 22:07:35,2012-01-16 22:06:55
1afd0b52fe9bb4642a44b48dabf9d7b26d00e4ab...60040a4f366d436d759729530f4d19e7e1958e51,177,3329,1703,5032,1143,2012-01-16 22:37:57,2012-01-16 22:37:57
60040a4f366d436d759729530f4d19e7e1958e51...95844451b6651fa5ad66a09f971cc139b90c63aa,3,9,0,9,4,2012-01-16 22:44:49,2012-01-16 22:26:58
95844451b6651fa5ad66a09f971cc139b90c63aa...7584225873cd27b53f3fdfb6af5c12c6514acdfa,17,377,152,529,47,2012-01-16 23:15:34,2012-01-16 23:15:34
25410096b4c38eb9b17501ea06349872ab33e1ea...549443a7cc600e93cc1d1d1630108e7d0a035500,2,63,0,63,3,2012-01-17 15:20:39,2012-01-17 15:20:37
549443a7cc600e93cc1d1d1630108e7d0a035500...534df2f8d207877f9d09d172d4ba92406e351aa0,2,56,10,66,6,2012-01-17 16:09:27,2012-01-17 08:34:53
534df2f8d207877f9d09d172d4ba92406e351aa0...16953329413831b32f4c3b2255aeacec874ed69d,36,684,348,1032,240,2012-01-17 16:22:52,2012-01-17 16:20:28
16953329413831b32f4c3b2255aeacec874ed69d...ca6ededbd1af5cc759ec98952b84c0b34edb2d40,1,7,3,10,3,2012-01-17 17:37:02,2012-01-17 07:04:50
ca6ededbd1af5cc759ec98952b84c0b34edb2d40...48650639248e73f78b2bd4ba2d3d1590749753ce,38,251,216,467,131,2012-01-17 18:45:09,2012-01-17 18:43:34
48650639248e73f78b2bd4ba2d3d1590749753ce...892056bf97842b1bfe6a2e328df67d5a0043b79e,8,87,69,156,26,2012-01-17 19:16:49,2012-01-17 19:16:49
892056bf97842b1bfe6a2e328df67d5a0043b79e...54ad2f6cbb553eb55c5c3f687c8e47edf93d1c46,1,5,1,6,1,2012-01-17 19:34:16,2012-01-17 19:32:58
54ad2f6cbb553eb55c5c3f687c8e47edf93d1c46...091ab850aaca9591b3f77d57a55c3c78fc0b5442,1,1,1,2,1,2012-01-17 22:30:58,2012-01-17 04:36:01
091ab850aaca9591b3f77d57a55c3c78fc0b5442...d44ce9790948c69f0b9bc449f2488b30cd099105,2,62,0,62,2,2012-01-17 23:45:02,2012-01-17 23:10:22
d44ce9790948c69f0b9bc449f2488b30cd099105...d489a01f81d84739bde92e77b023f4b934c59212,2,30,2,32,3,2012-01-18 14:21:58,2012-01-18 14:09:42
d489a01f81d84739bde92e77b023f4b934c59212...f7b612550a8716b0266a83a86bad060e2688eb1b,1,7,0,7,1,2012-01-18 15:00:55,2011-12-29 07:39:56
f7b612550a8716b0266a83a86bad060e2688eb1b...e282c0a0813dd700cc6d9862e27eba448f43b1c9,1,542,5,547,5,2012-01-19 15:31:36,2012-01-19 15:18:15
e282c0a0813dd700cc6d9862e27eba448f43b1c9...4fdec07bd81a604762218a8e9d0649fb5cef7b6c,2,3,6,9,3,2012-01-19 15:55:48,2012-01-19 15:44:59
4fdec07bd81a604762218a8e9d0649fb5cef7b6c...4afc46d7bcbb1caec986ddba642c943d79b83105,27,586,834,1420,270,2012-01-20 02:29:11,2012-01-20 02:07:12
4afc46d7bcbb1caec986ddba642c943d79b83105...d18cebaf8a7ac701dabd71a3aa4eb0571db6a645,6,40,12,52,8,2012-01-20 02:29:43,2012-01-20 01:23:56
d18cebaf8a7ac701dabd71a3aa4eb0571db6a645...ec1d1ee61fa90471e1f9f1f89a4582ffc32424a0,1,2,2,4,1,2012-01-20 05:15:12,2012-01-20 05:15:12
ec1d1ee61fa90471e1f9f1f89a4582ffc32424a0...f25ec0782e379469d2dd097b6168a5a120f624e4,1,2,0,2,1,2012-01-20 18:17:48,2012-01-20 05:15:12
f25ec0782e379469d2dd097b6168a5a120f624e4...40c93486e8b08f7f37dfd8be95ff03990ab858bd,2,50,8,58,7,2012-01-20 21:12:32,2012-01-20 14:36:28
40c93486e8b08f7f37dfd8be95ff03990ab858bd...35fe3eb5c774d1c21fdafb010c633ab6bc42d2c7,2,73,3,76,6,2012-01-21 00:24:01,2012-01-20 12:54:34
35fe3eb5c774d1c21fdafb010c633ab6bc42d2c7...08ab306afd0161aebde527a145c49cb848718df2,18,353,136,489,43,2012-01-21 02:14:15,2012-01-21 02:13:58
08ab306afd0161aebde527a145c49cb848718df2...a38fd6056c2c6d4e2266a65fdefdbdc8dcbe4dee,3,217,6,223,7,2012-01-21 02:21:51,2011-10-12 17:55:15
a38fd6056c2c6d4e2266a65fdefdbdc8dcbe4dee...f749338e1eee390fc654f129f4419895db4f8e50,3,181,1,182,5,2012-01-21 02:26:04,2011-10-27 14:48:38
f749338e1eee390fc654f129f4419895db4f8e50...f2b1f57f74ce23ee7160de76844a71ab34276aa6,3,62,1,63,5,2012-01-21 02:26:09,2011-11-22 21:04:40
f2b1f57f74ce23ee7160de76844a71ab34276aa6...3df7c90c3059f49c81f9b8f59fc3abf18d5d392b,2,72,1,73,2,2012-01-22 05:55:41,2012-01-22 05:55:41
3df7c90c3059f49c81f9b8f59fc3abf18d5d392b...f9014438c79b06d222df861f87e9af3cb919e495,1,13,14,27,5,2012-01-22 08:29:40,2011-11-14 20:42:14
f9014438c79b06d222df861f87e9af3cb919e495...93298afc4e2835e5b526ab871922018999e98bcb,1,21,0,21,1,2012-01-22 08:35:28,2012-01-22 08:35:28
93298afc4e2835e5b526ab871922018999e98bcb...827180097c45d2ce84d798ca141bb3a170a20df9,1,48,46,94,3,2012-01-22 14:23:04,2012-01-22 14:23:04
827180097c45d2ce84d798ca141bb3a170a20df9...9edb9842742c0734a9063576ae283c86b90d0676,1,1,0,1,1,2012-01-22 17:20:03,2012-01-22 17:19:10
9edb9842742c0734a9063576ae283c86b90d0676...f5e742b26445c82177e786b71480d66f7eef9ebd,1,21,0,21,1,2012-01-23 09:34:05,2012-01-23 09:34:05
f5e742b26445c82177e786b71480d66f7eef9ebd...6c0c00a2052ec613503a0322dcbabb6fcf41dab0,1,4,0,4,1,2012-01-23 09:35:11,2012-01-23 09:30:56
ca2a047b8e044e72e0bd8d2200de97ac995b945b...ab18d72b35e3a5be61495b8699daeea4a432a189,1,0,1,1,1,2012-01-17 00:46:23,2011-12-16 02:42:03
ab18d72b35e3a5be61495b8699daeea4a432a189...2c1025706bb2778d575a1c4f016f9fb67921f4aa,7,63,32,95,31,2012-01-17 01:24:53,2012-01-17 01:24:53
2c1025706bb2778d575a1c4f016f9fb67921f4aa...317ba9fb645029786ec47e719a2c3bcb42b6cfd0,1,10,7,17,7,2012-01-17 02:40:29,2012-01-17 02:40:12
317ba9fb645029786ec47e719a2c3bcb42b6cfd0...716f5bc66bd78e5778de1c8e2c087d779de39fea,1,5,0,5,1,2012-01-17 02:52:36,2012-01-17 02:52:36
716f5bc66bd78e5778de1c8e2c087d779de39fea...9cc55dca6f67a6096c858b841c677b0593404321,3,18,3,21,4,2012-01-17 03:00:41,2012-01-17 01:19:17
9cc55dca6f67a6096c858b841c677b0593404321...72cbb7492cb5956c8265b415bd6ff473b7b89f35,1,1,1,2,1,2012-01-17 03:46:36,2012-01-17 03:45:39
72cbb7492cb5956c8265b415bd6ff473b7b89f35...6e76a7cb45d915e5d002ea5a6ee51cde6bf0c3ea,2,15,2,17,5,2012-01-17 05:56:05,2012-01-17 05:48:50
6e76a7cb45d915e5d002ea5a6ee51cde6bf0c3ea...21dd53f9d3d685018c5a9e52251c3c9b6b69f79d,1,5,2,7,3,2012-01-17 07:28:29,2012-01-17 07:28:25
21dd53f9d3d685018c5a9e52251c3c9b6b69f79d...70884875c9cc40ef1318d7a929f2de37546c4134,2,14,4,18,5,2012-01-17 18:07:57,2011-12-27 12:08:41
70884875c9cc40ef1318d7a929f2de37546c4134...4a38795b6f9050c12e0851a5bdaa7daf3246854a,1,61,0,61,1,2012-01-17 19:43:21,2012-01-17 19:37:11
4a38795b6f9050c12e0851a5bdaa7daf3246854a...e493b295987df5608ad2580631b9fd6e9fc7fd3c,3,14,8,22,3,2012-01-17 22:03:21,2012-01-17 22:02:15
e493b295987df5608ad2580631b9fd6e9fc7fd3c...29ce743385011e896ff2bebff13442a662ba463a,1,1,1,2,1,2012-01-17 22:29:16,2012-01-17 04:36:01
29ce743385011e896ff2bebff13442a662ba463a...ad42a82df556068ffe79e13bd36799a8eedb3ebf,1,0,1,1,1,2012-01-18 01:00:43,2012-01-18 01:00:43
ad42a82df556068ffe79e13bd36799a8eedb3ebf...0ca30187cfc4c437510bf0ed3d27a660ba54c80b,3,188,11,199,21,2012-01-18 20:20:25,2011-12-02 20:04:13
0ca30187cfc4c437510bf0ed3d27a660ba54c80b...90587b1ccbb740e603c5cc5f3222a3c25247fc07,1,126,15,141,10,2012-01-19 22:46:20,2012-01-19 22:46:20
90587b1ccbb740e603c5cc5f3222a3c25247fc07...0f33768059146250d35148f37de7bd07e35ed851,1,4,0,4,1,2012-01-19 23:09:00,2012-01-19 23:05:04
0f33768059146250d35148f37de7bd07e35ed851...2156e5eca10d1dc3bb8155dc70f1dc0718841028,1,8,2,10,3,2012-01-20 13:46:07,2011-11-08 15:27:52
2156e5eca10d1dc3bb8155dc70f1dc0718841028...4e5247772da5293a109dfff78a9eff89eb5eabdf,2,2,2,4,2,2012-01-20 14:57:50,2012-01-20 14:55:38
4e5247772da5293a109dfff78a9eff89eb5eabdf...6b5853794d77094f960795cacf21d37841f1a890,1,1,1,2,1,2012-01-20 15:00:27,2012-01-20 15:00:25
6b5853794d77094f960795cacf21d37841f1a890...f9a47debfca854666e45de299b0bb630db4a1548,5,294,114,408,16,2012-01-20 21:09:56,2012-01-05 19:09:43
f9a47debfca854666e45de299b0bb630db4a1548...de78922b12c06b80489ec8eb05f0e3d4cd3fe8fa,5,22,0,22,6,2012-01-21 02:03:05,2012-01-20 02:56:23
de78922b12c06b80489ec8eb05f0e3d4cd3fe8fa...56e34c2f814905a8fc3329485c64a70d59d8eeba,1,1,1,2,1,2012-01-21 13:34:33,2012-01-21 13:31:20
56e34c2f814905a8fc3329485c64a70d59d8eeba...e10ed097cb3b506009ab28af4dec93402aa48693,7,79,32,111,13,2012-01-21 13:37:14,2012-01-21 01:37:57
e10ed097cb3b506009ab28af4dec93402aa48693...6d00c089e36955a8c172b5615329280d10dec9da,1,4,5,9,2,2012-01-21 22:44:48,2012-01-21 22:35:25
6d00c089e36955a8c172b5615329280d10dec9da...ff512634acbf2ddd10f167a5600e2acba3484802,1,1,1,2,1,2012-01-22 22:10:32,2012-01-22 19:46:52
ff512634acbf2ddd10f167a5600e2acba3484802...2433eeb3850a91feb99bab530cb7183800166390,22,188,161,349,84,2012-01-23 12:35:36,2012-01-23 12:35:36
6c0c00a2052ec613503a0322dcbabb6fcf41dab0...831c8199f66fee18c68fcc56c96767cca5591e61,9,737,201,938,67,2012-01-23 21:11:32,2012-01-22 04:02:16
831c8199f66fee18c68fcc56c96767cca5591e61...4fd315192a2b705cb9b0501f45cd47d9ee109ac7,13,0,0,0,0,2012-01-23 21:11:32,2012-01-22 22:06:17
4fd315192a2b705cb9b0501f45cd47d9ee109ac7...5d7577c71ab535dfd5c3f29b8c15a725137ff3b8,1,14,4,18,3,2012-01-23 21:11:33,2012-01-23 10:07:15
5d7577c71ab535dfd5c3f29b8c15a725137ff3b8...5c0d11b12a8214110bb78639daab452ce3d252e0,1,13,3,16,8,2012-01-23 21:11:33,2012-01-23 10:07:59
5c0d11b12a8214110bb78639daab452ce3d252e0...6768d2fc936ea4d8786897ea9c5c415efedb5b24,9,321,176,497,91,2012-01-23 21:11:33,2012-01-23 10:12:20
6768d2fc936ea4d8786897ea9c5c415efedb5b24...7b93eb0000aa7f63d9e26e3ad5c390ca9c4aa033,1,1,0,1,1,2012-01-23 21:50:31,2012-01-23 21:50:31
7b93eb0000aa7f63d9e26e3ad5c390ca9c4aa033...f33a35e293fb51dc5644d514b154564ad330baa4,5,5,5,10,5,2012-01-23 21:53:11,2012-01-23 21:53:11
f33a35e293fb51dc5644d514b154564ad330baa4...ed111975a096cb44a7d737e46c6e0c73025e0670,1,6,2,8,2,2012-01-23 23:05:34,2012-01-23 20:09:56
ed111975a096cb44a7d737e46c6e0c73025e0670...fc6a9673c8ec6e22565bb5a837f33b845e5127ce,1,2,4,6,2,2012-01-23 23:05:34,2012-01-23 20:28:30
fc6a9673c8ec6e22565bb5a837f33b845e5127ce...6999fb3d1e342cc5bcd41c5ff41ff0c88ddfb250,1,6,2,8,2,2012-01-23 23:05:34,2012-01-23 20:36:48
6999fb3d1e342cc5bcd41c5ff41ff0c88ddfb250...9037decb28e324b78a310d2557dc12c177cbaee1,1,1,3,4,1,2012-01-23 23:11:21,2012-01-23 23:04:45
9037decb28e324b78a310d2557dc12c177cbaee1...aef62a03ee27ffb149950df5caccc2b4965169d8,1,2,2,4,2,2012-01-23 23:11:44,2012-01-23 21:39:07
aef62a03ee27ffb149950df5caccc2b4965169d8...57ddf5f50ae3c7e3fe463da9a36c3e0bd615519c,2,3,3,6,3,2012-01-23 23:11:44,2012-01-23 21:38:22
57ddf5f50ae3c7e3fe463da9a36c3e0bd615519c...986e61255736a74fad1d96cc928f049c93734e05,8,122,22,144,23,2012-01-23 23:11:44,2012-01-23 21:39:49
986e61255736a74fad1d96cc928f049c93734e05...46e86aa80348dd8e31ade16a3b19eeee6baee0de,3,33,4,37,7,2012-01-23 23:11:45,2012-01-23 22:38:25
46e86aa80348dd8e31ade16a3b19eeee6baee0de...2775c0e97ebdeed64743e4f56741118fdcfd8dda,3,27,43,70,10,2012-01-23 23:11:45,2012-01-23 22:52:08
2775c0e97ebdeed64743e4f56741118fdcfd8dda...ccf7b41a69a8037f721a3eb495c2a82a53613634,1,14,2,16,2,2012-01-24 18:07:38,2012-01-24 16:45:34
ccf7b41a69a8037f721a3eb495c2a82a53613634...352febe2519b0bb0e004086fa06a27217bdbebbb,1,8,0,8,1,2012-01-26 23:56:32,2012-01-26 23:53:37
352febe2519b0bb0e004086fa06a27217bdbebbb...5c0f039c9ca9f36dfc05b5d38d8a20343d02f9f0,95,97,97,194,97,2012-01-26 23:59:26,2012-01-26 20:25:51
5c0f039c9ca9f36dfc05b5d38d8a20343d02f9f0...a0119af0e477d12b69c730336916b49fe0a46aba,2,73,11,84,23,2012-01-27 00:33:56,2012-01-25 17:46:45
a0119af0e477d12b69c730336916b49fe0a46aba...ff0f0aeb401765646fefd9bbdc0f2a68d1ad342c,3,100,4,104,4,2012-01-27 01:55:44,2012-01-27 01:14:16
ff0f0aeb401765646fefd9bbdc0f2a68d1ad342c...f98999cc166918807aa8e06c26c5a15e4e353df5,3,52,5,57,6,2012-01-27 21:12:07,2012-01-27 21:12:07
f98999cc166918807aa8e06c26c5a15e4e353df5...8a413b076eb3ad83e4445d54e78e238d1d09912c,3,141,2,143,8,2012-01-27 21:18:17,2012-01-27 21:16:47
8a413b076eb3ad83e4445d54e78e238d1d09912c...38651521a8649f113e851e9ea1a8e81eaf2f0db6,1,1,1,2,1,2012-01-27 21:42:49,2012-01-27 21:42:08
38651521a8649f113e851e9ea1a8e81eaf2f0db6...22e23473ea7fd1a083c43aa33fe4d09c1b6bd34e,1,33,2,35,3,2012-01-27 23:17:01,2012-01-27 23:17:01
22e23473ea7fd1a083c43aa33fe4d09c1b6bd34e...4b6164ab491e48f30286f739a8a0e66587499bfd,1,9,9,18,8,2012-01-28 00:30:46,2012-01-28 00:30:46
4b6164ab491e48f30286f739a8a0e66587499bfd...f19e20d33f57c4d2853aaea7d2724d44f3b0012f,8,38,17,55,13,2012-01-28 00:32:19,2012-01-27 21:33:01
f19e20d33f57c4d2853aaea7d2724d44f3b0012f...5756d7916a1f6dfb9d0a7fc544b4a7fcc4e99a50,1,2,2,4,1,2012-01-28 00:54:40,2012-01-28 00:54:40
5756d7916a1f6dfb9d0a7fc544b4a7fcc4e99a50...ca4b91a1d00255da852ccfb856e2beda8a7030f7,1,1,1,2,1,2012-01-28 01:08:02,2012-01-28 01:07:43
ca4b91a1d00255da852ccfb856e2beda8a7030f7...b221fe9b29f7dd834af9716e077bc05a05156d64,2,67,1,68,2,2012-01-30 13:12:23,2012-01-29 22:30:13
b221fe9b29f7dd834af9716e077bc05a05156d64...3fd13c6426b338196d138b0dc564020daed78bcd,2,8,2,10,2,2012-01-30 15:16:01,2012-01-30 15:16:01
3fd13c6426b338196d138b0dc564020daed78bcd...0ad2a9a2e0c82f71efaa56cf4eb31c8912703065,1,3,3,6,2,2012-01-31 15:46:14,2012-01-31 15:46:14
0ad2a9a2e0c82f71efaa56cf4eb31c8912703065...fa490f64971a38c98d74dc6b55b2d88dd1f6c463,10,223,36,259,25,2012-01-31 16:41:46,2012-01-31 16:41:46
fa490f64971a38c98d74dc6b55b2d88dd1f6c463...35b3d151949e023eee07c118bf89826519fee488,2,71,29,100,28,2012-02-01 01:37:38,2012-01-30 15:04:20
35b3d151949e023eee07c118bf89826519fee488...840229a8251955d2b791928875f36d35127dcad0,1,8,11,19,8,2012-02-01 01:50:11,2011-11-22 23:46:01
840229a8251955d2b791928875f36d35127dcad0...7e0bf7d57de318f45a097e05644efa49beb65209,1,2,2,4,2,2012-02-01 01:50:16,2011-11-22 23:49:18
667aae596cded9336f50574386683ec39ada43f2...b1b16d117e6fe2ca889d10e7e0b62a5a60997d57,1,4,4,8,4,2012-01-23 23:44:53,2012-01-23 23:44:53
7e0bf7d57de318f45a097e05644efa49beb65209...3deceaf6e7351bec3572554baaccef70747f35f8,1,2,2,4,2,2012-02-01 21:49:56,2012-02-01 21:25:55
3deceaf6e7351bec3572554baaccef70747f35f8...5166758927e7538d413b030d3b586107cd53024d,1,11,3,14,1,2012-02-02 00:04:01,2011-12-02 18:42:32
5166758927e7538d413b030d3b586107cd53024d...a661830569f424ac929a075bacaa94d70e732924,1,3,3,6,3,2012-02-02 16:14:01,2012-02-02 15:56:58
a661830569f424ac929a075bacaa94d70e732924...e5ea6ad0f01e67db73a30190b520df25ba8e16f4,1,5,0,5,1,2012-02-02 16:14:03,2012-02-02 15:57:45
e5ea6ad0f01e67db73a30190b520df25ba8e16f4...67cd05472e0c3b2859469d2f1d83400b99464447,5,57,159,216,18,2012-02-02 16:42:08,2012-02-02 16:42:08
67cd05472e0c3b2859469d2f1d83400b99464447...f101f7c9babb31f077c78b52de7cc45ad687f57e,2,40,44,84,18,2012-02-02 18:13:56,2012-02-01 21:07:42
f101f7c9babb31f077c78b52de7cc45ad687f57e...7e40c7ddc93f9260a3f4b1683ff6f86aff91e761,2,31,1,32,2,2012-02-02 18:14:06,2012-02-01 21:37:26
7e40c7ddc93f9260a3f4b1683ff6f86aff91e761...30fd2f7bb27addadaf4c620eacc77f29a5716e37,1,3,0,3,1,2012-02-02 22:57:12,2012-02-02 22:57:12
30fd2f7bb27addadaf4c620eacc77f29a5716e37...465f57c56f9b915d9c8b4f5549457f3e7276ee06,3,11,3,14,5,2012-02-02 23:38:28,2012-02-02 23:35:14
465f57c56f9b915d9c8b4f5549457f3e7276ee06...71527e3a55b4a0ce895e62f74d5407317336d64b,2,8,2,10,3,2012-02-02 23:38:28,2012-02-02 23:37:59
71527e3a55b4a0ce895e62f74d5407317336d64b...5937d02aed663ca0832f2bad09620ee50579695c,1,2,1,3,2,2012-02-03 00:56:42,2012-02-03 00:56:23
5937d02aed663ca0832f2bad09620ee50579695c...051908e023f87894fa68f5b64d0b99a19a7db01e,7,40,17,57,12,2012-02-03 00:56:42,2012-02-03 00:04:47
051908e023f87894fa68f5b64d0b99a19a7db01e...74a2528bd71ced1061aee2ae7f171d7c446a7bfd,1,2,2,4,1,2012-02-03 01:19:28,2012-02-03 01:19:28
74a2528bd71ced1061aee2ae7f171d7c446a7bfd...9fb088e3ab71ed88a9cbf1f7e6c3bbe30e8d2f1a,1,189,33,222,23,2012-02-03 14:07:32,2012-02-03 01:02:09
9fb088e3ab71ed88a9cbf1f7e6c3bbe30e8d2f1a...68db20656e99da5a179e7139e4f2c3ed9de34d1a,1,6,6,12,5,2012-02-03 14:38:08,2012-02-03 14:37:46
68db20656e99da5a179e7139e4f2c3ed9de34d1a...4671e54495a29696ae8e5f9bd17ba4c63f5d1b23,1,1,0,1,1,2012-02-03 23:40:53,2012-02-03 16:27:53
4671e54495a29696ae8e5f9bd17ba4c63f5d1b23...07a983a6025cf788df2e2371e96924ffe8602e08,2,49,4,53,2,2012-02-03 23:41:24,2012-02-03 16:29:58
07a983a6025cf788df2e2371e96924ffe8602e08...f64989e63b9cf11c88e46b422de6234fc4699039,2,45,0,45,2,2012-02-04 21:14:58,2012-02-02 06:44:22
f64989e63b9cf11c88e46b422de6234fc4699039...11d1eca9f3c465045828e3a00b103620c8253258,1,1,0,1,1,2012-02-04 21:19:56,2011-08-10 21:39:03
11d1eca9f3c465045828e3a00b103620c8253258...0f0af55a0aadf3ca1a960de1b6072f6f4175434e,2,61,1,62,2,2012-02-05 08:41:49,2012-02-03 11:09:30
0f0af55a0aadf3ca1a960de1b6072f6f4175434e...a2cd31cbf110229941cc5af0d69ed35019ef40d1,3,23,5,28,9,2012-02-05 10:11:54,2012-02-05 10:11:54
a2cd31cbf110229941cc5af0d69ed35019ef40d1...7543c38dca2b4c64711f5667b82d80ffab3fd6a2,1,0,1,1,1,2012-02-05 22:36:38,2012-02-05 22:30:14
b1b16d117e6fe2ca889d10e7e0b62a5a60997d57...a6f3451e2549d0b82ff18990e8bfe28ea4386aba,1,1,2,3,1,2012-01-24 04:57:20,2012-01-24 04:57:20
b1b16d117e6fe2ca889d10e7e0b62a5a60997d57...40879f33cd083ad8e16860a19cce03a0126e12a5,141,2208,3930,6138,711,2012-01-24 01:16:27,2012-01-24 00:16:42
40879f33cd083ad8e16860a19cce03a0126e12a5...a74354735ab5d5b0fa35a1e4ff7e653757d2069b,5,32,13,45,8,2012-01-24 01:26:20,2012-01-23 23:55:15
a74354735ab5d5b0fa35a1e4ff7e653757d2069b...77f2cb66d1bdc83d7ff7651b0fd8a32294667c1d,1,2,2,4,1,2012-01-24 01:27:08,2012-01-24 01:27:08
7543c38dca2b4c64711f5667b82d80ffab3fd6a2...0a347559bf6dc2832aa9802d346f351dd9354e71,8,577,297,874,15,2012-02-07 21:32:53,2012-02-07 06:53:39
0a347559bf6dc2832aa9802d346f351dd9354e71...09c296b44daedfd2b5da3a46120507ed7bd198e0,1,1,1,2,1,2012-02-07 22:16:40,2012-02-07 22:11:34
09c296b44daedfd2b5da3a46120507ed7bd198e0...81d18398a8a6d3fcf74bb7325d0cd1af3c26eca4,2,49,0,49,1,2012-02-07 22:42:38,2012-02-07 22:42:38
81d18398a8a6d3fcf74bb7325d0cd1af3c26eca4...e5ed6b91f4600588ca5352dea19555178e0c568a,1,1,1,2,1,2012-02-08 18:16:19,2012-02-08 00:50:05
e5ed6b91f4600588ca5352dea19555178e0c568a...163900dc68e28fe8aacb72fb9d2fec1fe8d247f3,206,474,421,895,257,2012-02-08 20:36:20,2012-02-08 20:36:20
163900dc68e28fe8aacb72fb9d2fec1fe8d247f3...cacd3ae004d9796c746472433b83252cf5edb7e7,1,77,0,77,1,2012-02-09 05:32:33,2012-02-09 05:22:50
cacd3ae004d9796c746472433b83252cf5edb7e7...38eec57aefdd5e2bf55095b93f8b625aa07f941d,2,7,0,7,2,2012-02-09 16:16:46,2012-02-09 16:14:39
38eec57aefdd5e2bf55095b93f8b625aa07f941d...a8f357629d6b3405f9fff9b99a1fd391f7336250,1,3,6,9,1,2012-02-10 17:51:33,2012-02-10 17:51:31
a8f357629d6b3405f9fff9b99a1fd391f7336250...c9f58cc5956840848532fe8804a8c77c734019c1,13,150,25,175,26,2012-02-10 19:27:12,2012-02-10 19:27:12
c9f58cc5956840848532fe8804a8c77c734019c1...c7771bc2ec74afb8b9e239c34c183c92e10acd87,3,23,9,32,12,2012-02-10 19:28:43,2012-02-10 09:35:35
c7771bc2ec74afb8b9e239c34c183c92e10acd87...d3f6b094c71a8d2c78dc6cd8bb50b01db6d38e27,1,1,0,1,1,2012-02-11 13:24:15,2012-02-11 13:24:15
d3f6b094c71a8d2c78dc6cd8bb50b01db6d38e27...2f759a7090a15824a261e168221caa5109c86d44,1,12,5,17,6,2012-02-11 17:05:30,2012-02-11 17:05:30
5988872ff1f321388cfef0be6585ad6ba7f54884...e806ad39d0cf13800e21edd7ffd56f707e92b08d,3,8,11,19,4,2012-01-24 14:57:50,2012-01-24 14:49:32
e806ad39d0cf13800e21edd7ffd56f707e92b08d...27c85727edda169cbe9c04178c6fdee642cb8845,1,14,2,16,2,2012-01-24 17:13:37,2012-01-24 16:45:34
27c85727edda169cbe9c04178c6fdee642cb8845...c80abfa0e4b5ae234e53a2fc088eb8344a182820,1,2,2,4,2,2012-01-25 17:35:35,2012-01-25 17:35:35
c80abfa0e4b5ae234e53a2fc088eb8344a182820...f89beaf3ac80b9f2129f7a388c1aca2538ce198a,1,3,1,4,2,2012-01-26 22:49:57,2012-01-26 22:45:16
f89beaf3ac80b9f2129f7a388c1aca2538ce198a...85a86b5fd64ee4f5502552096dcc5f616158d7d6,1,10,3,13,4,2012-01-27 14:37:30,2012-01-27 14:23:32
85a86b5fd64ee4f5502552096dcc5f616158d7d6...14b7c4327f4547bed14bf2059321375b75d9c45e,14,294,28,322,44,2012-01-27 21:32:02,2012-01-27 21:25:04
14b7c4327f4547bed14bf2059321375b75d9c45e...e4afb2f724f0a42c946ded3805f6827f8ed3868c,1,4,0,4,3,2012-01-28 16:01:04,2012-01-27 23:49:07
e4afb2f724f0a42c946ded3805f6827f8ed3868c...e3c0c86b280854e4ad8db9bd5f6c645ffe9e9966,1,7,1,8,2,2012-01-29 21:17:31,2012-01-29 04:39:38
e3c0c86b280854e4ad8db9bd5f6c645ffe9e9966...5403a8ce4cce83a13569b09ee5b2ba3d1ad8c176,5,32,37,69,18,2012-01-29 23:27:07,2012-01-29 04:13:42
5403a8ce4cce83a13569b09ee5b2ba3d1ad8c176...52bd0f93bb786de028463ef56ddb1e22568584b9,1,15,6,21,5,2012-01-30 13:10:18,2012-01-30 07:41:40
52bd0f93bb786de028463ef56ddb1e22568584b9...836344c90ed139f2e18bbcfb18d0ff2e2e42da81,2,48,9,57,8,2012-01-30 15:35:27,2012-01-30 15:35:05
836344c90ed139f2e18bbcfb18d0ff2e2e42da81...e97b961815b8804e17d6793101960db53e4c32a2,1,19,13,32,1,2012-01-30 19:22:38,2012-01-30 16:58:08
e97b961815b8804e17d6793101960db53e4c32a2...ff40253566089cd5b89c1e6efca32d3b5772dbcb,16,165,19,184,23,2012-01-30 23:57:08,2012-01-30 23:57:08
ff40253566089cd5b89c1e6efca32d3b5772dbcb...26bfb6bea45348d6aaa213b4ee38ac002c429394,1,68,64,132,15,2012-01-31 06:11:19,2012-01-31 00:41:32
26bfb6bea45348d6aaa213b4ee38ac002c429394...a94ffdaec57d9999485b11183f8da10aec15ff8d,2,114,26,140,10,2012-01-31 07:58:41,2012-01-25 23:12:00
a94ffdaec57d9999485b11183f8da10aec15ff8d...88b919ea561824ffcdd180e57ba9f58846c6f84f,2,56,0,56,2,2012-01-31 13:29:27,2012-01-30 23:54:40
88b919ea561824ffcdd180e57ba9f58846c6f84f...279e7e7341dcbc9e3464ffaa0e41f3c8c1eb465a,3,58,16,74,15,2012-01-31 13:29:32,2012-01-31 00:36:57
279e7e7341dcbc9e3464ffaa0e41f3c8c1eb465a...42ea068a1a6f7528662cf4d77e7c94e64daf7804,1,105,0,105,1,2012-01-31 13:47:12,2012-01-31 13:46:23
42ea068a1a6f7528662cf4d77e7c94e64daf7804...03c4aa6aefa31bbefe8c7d5f60af75409e753742,1,0,1,1,1,2012-01-31 14:12:12,2012-01-19 15:18:37
03c4aa6aefa31bbefe8c7d5f60af75409e753742...33b7fc250f061af42b595decf6c0edf360c5aae9,2,4,4,8,3,2012-02-01 01:22:21,2012-01-31 16:14:42
2f759a7090a15824a261e168221caa5109c86d44...c3f176222a990387b030898592bea3bbd1c43dd3,1,20,19,39,2,2012-02-12 20:04:03,2012-02-12 20:04:03
c3f176222a990387b030898592bea3bbd1c43dd3...2e6ad6204758042ca715ed0acfa88c2c292074ff,1,89,0,89,1,2012-02-12 20:07:31,2012-02-12 20:07:31
2e6ad6204758042ca715ed0acfa88c2c292074ff...ef032cbe85b46584304c665b539b4f7561c4c26c,1,28,0,28,2,2012-02-13 19:55:29,2012-02-13 19:55:29
ef032cbe85b46584304c665b539b4f7561c4c26c...1ce14eca44c7c3bf9812b462e1931de58d09edc3,2,36,1,37,2,2012-02-14 13:10:21,2012-02-14 03:30:09
1ce14eca44c7c3bf9812b462e1931de58d09edc3...b19b8836c3bd9d8775103cddd68e7247a16e0a7f,3,68,2,70,4,2012-02-14 19:53:05,2012-01-09 01:28:49
b19b8836c3bd9d8775103cddd68e7247a16e0a7f...14b20ffc3006eaebb08840601a1330e5204c290c,1,156,0,156,1,2012-02-14 19:53:23,2012-02-14 08:03:13
14b20ffc3006eaebb08840601a1330e5204c290c...0685707bc643250de297b59f4f58878d4c17292e,2,2,8,10,2,2012-02-15 15:45:14,2012-02-15 15:45:02
0685707bc643250de297b59f4f58878d4c17292e...077f9d7293468ad5446b330999fe47bc40e47571,1,95,37,132,18,2012-02-15 23:10:33,2012-02-15 22:34:18
077f9d7293468ad5446b330999fe47bc40e47571...d91bc7cb0977b058750183199906590d95003fc0,2,7,76,83,3,2012-02-15 23:10:51,2012-02-15 22:50:04
d91bc7cb0977b058750183199906590d95003fc0...ef50bd2e541e3d62ed4ca91aa960b34c39516560,1,0,11,11,1,2012-02-16 17:10:59,2012-02-16 17:02:02
ef50bd2e541e3d62ed4ca91aa960b34c39516560...3415427dbfbd590bbee3d777ffc73dde3c67790d,5,191,0,191,9,2012-02-16 17:15:21,2012-02-15 18:26:43
3415427dbfbd590bbee3d777ffc73dde3c67790d...9364699be194cf9175d1bc421050b17ac9875447,1,0,28,28,2,2012-02-16 19:19:33,2012-02-16 19:05:18
9364699be194cf9175d1bc421050b17ac9875447...d52f5020cecc16349cce902e9f869d33a9213752,2,42,0,42,3,2012-02-16 19:58:45,2012-02-16 19:20:07
d52f5020cecc16349cce902e9f869d33a9213752...8f2694bb5380a0ae80e7503cf2fb9507d83573b6,2,57,42,99,22,2012-02-16 21:19:48,2012-02-16 21:19:48
8f2694bb5380a0ae80e7503cf2fb9507d83573b6...2c07712860398f863670c5b90fb4f4559d299e19,2,5,0,5,3,2012-02-16 22:11:49,2012-02-14 23:20:54
2c07712860398f863670c5b90fb4f4559d299e19...83fd1c1de51e6b0171101a725c8d92081c2fadbd,2,10,1,11,3,2012-02-16 22:12:38,2012-02-16 09:42:13
83fd1c1de51e6b0171101a725c8d92081c2fadbd...30e462e91937ced3847af3fe9c393ebd32294b68,3,133,6,139,4,2012-02-16 22:47:17,2012-02-10 19:26:56
116835561d118a19ab5b65644d83b7a054797ca9...986785c9d29947c43387ae48a87def52fd5aa2e6,1,0,16,16,4,2012-02-07 07:01:17,2012-02-07 07:01:17
986785c9d29947c43387ae48a87def52fd5aa2e6...349cab0b489d3bbb2966bf401b8af50240bf8657,1,9,0,9,1,2012-02-07 23:41:21,2012-02-07 23:41:21
349cab0b489d3bbb2966bf401b8af50240bf8657...99059aad8d654acda4abcfaa68df182b50f2ec90,7,32,17,49,12,2012-02-07 23:42:33,2012-02-07 23:42:33
99059aad8d654acda4abcfaa68df182b50f2ec90...e612143a896828f24ce81b9ba7745b8268670847,1,2,2,4,1,2012-02-08 00:44:57,2012-02-08 00:44:57
e612143a896828f24ce81b9ba7745b8268670847...9a6012edd9330296b7476bc6b7fbda2cd5c8165d,1,29,23,52,2,2012-02-08 13:40:33,2012-02-08 00:10:22
9a6012edd9330296b7476bc6b7fbda2cd5c8165d...02c1cb54aa250163918e884e604981c2a05ed3f2,1,2,1,3,1,2012-02-08 17:59:53,2012-02-08 17:59:31
02c1cb54aa250163918e884e604981c2a05ed3f2...9da830e8959393dc757d3b87478b9e5b8ea695f1,1,1,0,1,1,2012-02-08 19:42:38,2012-02-07 20:10:11
9da830e8959393dc757d3b87478b9e5b8ea695f1...d4ccdeaf00d7994b4a959a3ddfe8c52a2bd3c30d,1,3,0,3,1,2012-02-09 13:34:30,2012-02-09 03:47:31
d4ccdeaf00d7994b4a959a3ddfe8c52a2bd3c30d...830d0fe95a9fe36f536d823206af52af9c7f4017,1,1,1,2,1,2012-02-11 03:38:34,2012-02-11 03:38:13
830d0fe95a9fe36f536d823206af52af9c7f4017...e9adb7fbbc43035f960b1be99bacd7a7aec6bf83,1,3,0,3,1,2012-02-11 04:55:21,2012-02-11 04:55:21
e9adb7fbbc43035f960b1be99bacd7a7aec6bf83...a27320e00f12d26dad1b464bf89484faf429a688,22,270,385,655,55,2012-02-12 15:12:04,2012-02-12 15:12:04
bd21038078a2a20a128149c921cecb328e0a1116...05471f5c2aee3d264a5ae65dc3ad140ca85eb9dd,91,2228,1187,3415,623,2012-02-01 02:35:04,2012-02-01 02:35:04
05471f5c2aee3d264a5ae65dc3ad140ca85eb9dd...a3efcd2006614c3835c9395b91ab89c1f260806c,7,45,18,63,13,2012-02-01 19:37:12,2012-02-01 02:43:23
a3efcd2006614c3835c9395b91ab89c1f260806c...ec79acb3a6166e30f0bf271fbbfda1fb575b3321,1,2,2,4,1,2012-02-01 21:05:04,2012-02-01 21:05:04
ec79acb3a6166e30f0bf271fbbfda1fb575b3321...a9723df1b76777899a3819839cb7e8f0e2efaef1,1,2,2,4,2,2012-02-01 21:28:23,2012-02-01 21:25:55
a9723df1b76777899a3819839cb7e8f0e2efaef1...74a8215a8699f89ee4b82ca616a4eafa3b11203b,45,413,2257,2670,239,2012-02-06 14:44:42,2012-02-03 15:32:00
74a8215a8699f89ee4b82ca616a4eafa3b11203b...2e2df04b3538c83e4e3ddc81308ca1bde3d80fc6,1,2,0,2,1,2012-02-06 14:59:08,2012-02-06 14:37:37
2e2df04b3538c83e4e3ddc81308ca1bde3d80fc6...832efb1e011c7346c17426490ece66b881601797,1,0,61,61,1,2012-02-06 16:47:09,2012-02-06 16:47:09
832efb1e011c7346c17426490ece66b881601797...c2dc673eb5a7a6a706b024a5e501cd3939ad399b,2,90,2,92,3,2012-02-06 17:29:28,2012-02-06 17:24:50
c2dc673eb5a7a6a706b024a5e501cd3939ad399b...5e1471c806a387d9953ba3387892190d7f423fbb,2,4,0,4,2,2012-02-06 18:02:45,2012-01-06 23:48:23
5e1471c806a387d9953ba3387892190d7f423fbb...a20872045a1e153f6687d37f4d824739e3a60b27,1,7,21,28,3,2012-02-06 22:54:11,2012-02-01 16:16:15
a20872045a1e153f6687d37f4d824739e3a60b27...1595a6e885eebd5a9d854bd462ab1b80521ff754,1,4,5,9,6,2012-02-06 22:54:11,2012-02-01 16:23:25
1595a6e885eebd5a9d854bd462ab1b80521ff754...23514fc94648185c092355bf3e5bbce76844bd42,1,1,2,3,1,2012-02-06 22:54:11,2012-02-01 16:27:14
23514fc94648185c092355bf3e5bbce76844bd42...8be699494ec67c3ba895bd8e1c9e3e73b02311d3,130,4435,1705,6140,826,2012-02-06 23:21:49,2012-02-06 23:21:49
8be699494ec67c3ba895bd8e1c9e3e73b02311d3...e5db01ee29e8b25545c6558b8c1b8f8b8461294c,1,0,1,1,1,2012-02-06 23:22:52,2012-02-06 23:22:52
33b7fc250f061af42b595decf6c0edf360c5aae9...db3c4efd1d95e6c7fc47b9c07216beb7029cf7bc,4,165,48,213,28,2012-02-01 01:45:50,2012-01-20 00:52:23
30e462e91937ced3847af3fe9c393ebd32294b68...a118f2172880d338101f80647437b8832ac1f768,2,15,1,16,3,2012-02-17 14:51:33,2012-02-17 00:33:40
a118f2172880d338101f80647437b8832ac1f768...4ed7b035bd74a24c2a3d2cf15962a31b2ab204c8,3,14,19,33,10,2012-02-17 15:13:42,2012-02-16 06:38:05
4ed7b035bd74a24c2a3d2cf15962a31b2ab204c8...9764bea97db0a615d0baf905ded2760868443d21,1,0,2,2,1,2012-02-17 15:13:48,2012-02-16 06:47:23
30e462e91937ced3847af3fe9c393ebd32294b68...7a1a62ec6e168876493688cfa45097567a332267,5,53,46,99,36,2012-02-16 23:32:15,2012-02-16 22:52:03
7a1a62ec6e168876493688cfa45097567a332267...4672872ddde70e079670d2a12079cb303ef41dbb,1,2,2,4,1,2012-02-17 20:39:45,2012-02-17 18:08:40
4672872ddde70e079670d2a12079cb303ef41dbb...a2851b62345c59ab5d41d8e3d0da1bad8a9c59d3,3,6,210,216,5,2012-02-17 20:39:45,2012-02-17 18:10:02
a2851b62345c59ab5d41d8e3d0da1bad8a9c59d3...1eb1fe32250fc88cb5b0a97cddf3e02be02e3f4a,8,62,17,79,13,2012-02-17 20:39:45,2012-02-17 00:04:34
1eb1fe32250fc88cb5b0a97cddf3e02be02e3f4a...f73f07e1266cce36d41001297438b640cd6bb3b5,1,2,2,4,1,2012-02-17 21:33:58,2012-02-17 21:33:58
8a6576f764f73e4f74c277aa5f9bb4490ea07cf1...3f43b1c039727e12c7a27fb31010aa309a4a35d8,4,46,6,52,13,2012-02-12 16:27:12,2012-02-12 15:53:43
3f43b1c039727e12c7a27fb31010aa309a4a35d8...09ccbef3bbfc4ca14c58dbed4c3c067bd1f1e14c,1,8,7,15,2,2012-02-13 16:43:30,2012-02-13 13:28:43
09ccbef3bbfc4ca14c58dbed4c3c067bd1f1e14c...68a0c56a7d9c26661245b06c7d1231625a0aa5ac,112,3880,2281,6161,745,2012-02-13 18:05:16,2012-02-13 18:04:53
68a0c56a7d9c26661245b06c7d1231625a0aa5ac...5041bc1b6cc8c6424ed8dee41bd178187af7c094,2,1,3,4,3,2012-02-13 18:11:28,2012-02-13 18:11:28
5041bc1b6cc8c6424ed8dee41bd178187af7c094...3a915b02e8a12ab4c4cacc79aa1b4273a7917905,4,48,44,92,34,2012-02-13 19:10:12,2012-02-13 19:10:12
3a915b02e8a12ab4c4cacc79aa1b4273a7917905...e7e4f2f3aa2622d67136b4c9ed3983cb90f6619a,1,3,0,3,1,2012-02-13 20:36:08,2012-02-13 20:36:08
e7e4f2f3aa2622d67136b4c9ed3983cb90f6619a...a7af84f988a0d5dd0d8935f70e44a7e8fb1fbe2b,52,62,81,143,42,2012-02-13 23:27:06,2012-02-13 22:47:50
a7af84f988a0d5dd0d8935f70e44a7e8fb1fbe2b...df236e75a2fd51dacfaa566e94cdb91b50ffbf47,1,1,1,2,1,2012-02-13 23:27:32,2012-02-11 08:16:40
df236e75a2fd51dacfaa566e94cdb91b50ffbf47...9a0d90793ef85e7f65d2327156e0cfb636f87857,1,3,1,4,1,2012-02-13 23:27:41,2012-02-13 23:06:55
dfed2cef7533de43544625fe27a31f65654d7bc6...23c4278e0694c6c2cca3dc4f917f9ce74be64f40,1,32,30,62,21,2012-02-17 22:58:42,2012-02-17 22:58:42
23c4278e0694c6c2cca3dc4f917f9ce74be64f40...c1f474010e8e58793408fc1d8303aeb1a01ba735,1,3,3,6,3,2012-02-18 01:05:12,2012-02-18 00:40:26
9a0d90793ef85e7f65d2327156e0cfb636f87857...6141386f7eaedc66aafd39a5a842772e91b414af,2,5,0,5,3,2012-02-15 16:04:10,2012-02-14 23:20:54
9a0d90793ef85e7f65d2327156e0cfb636f87857...0a4f5e84734d3cab0e3a082c733d4e96c3e3d496,1,6,0,6,1,2012-02-14 22:34:43,2012-02-14 22:34:37
0a4f5e84734d3cab0e3a082c733d4e96c3e3d496...de21de920cf93ec40736ada3792a7f85f3eadeda,9,44,18,62,15,2012-02-14 22:34:43,2012-02-14 22:31:00
de21de920cf93ec40736ada3792a7f85f3eadeda...6a2cb6c506fffbe1fb1cf4529fcb2f5be0340af3,1,2,2,4,1,2012-02-15 19:37:34,2012-02-15 19:37:34
c1f474010e8e58793408fc1d8303aeb1a01ba735...96a137a18a07849bb3e897f55b8d908944561fe6,1,103,44,147,28,2012-02-18 21:36:34,2012-02-18 21:36:34
96a137a18a07849bb3e897f55b8d908944561fe6...c6019b8b4e4379af883b7bf1b64f242f33b62361,1,0,6,6,1,2012-02-21 14:52:40,2012-02-21 14:42:15
c6019b8b4e4379af883b7bf1b64f242f33b62361...186960fefb5fb71e3a2cba90b413aae1e097f41e,1,1,0,1,1,2012-02-21 20:04:09,2012-02-21 20:03:15
186960fefb5fb71e3a2cba90b413aae1e097f41e...634b4de2c835e5998a013c54303907878875115b,2,35,0,35,2,2012-02-21 23:31:50,2012-02-21 23:26:35
634b4de2c835e5998a013c54303907878875115b...35c1f682c10e29fede293492379d6d1c93a92f04,3,61,6,67,8,2012-02-22 20:04:39,2012-02-22 20:04:39
35c1f682c10e29fede293492379d6d1c93a92f04...e004721b482198fb9558f920f8101b27fb0bcb7c,1,12,1,13,2,2012-02-22 23:58:02,2012-02-22 19:48:43
e004721b482198fb9558f920f8101b27fb0bcb7c...ca0986fbd1a8ade47f3160853a257b6ae83a2151,133,1862,509,2371,254,2012-02-25 02:52:17,2012-02-25 02:52:17
ca0986fbd1a8ade47f3160853a257b6ae83a2151...cd4cb8e79509c3940a94bd70ff16cdb264884114,1,37,22,59,10,2012-02-27 08:36:20,2011-12-15 00:44:59
cd4cb8e79509c3940a94bd70ff16cdb264884114...4f8d7328a465f1dc6cd35c875afc0d5ea6b80538,1,1,1,2,1,2012-02-27 21:08:54,2012-02-27 21:08:54
4f8d7328a465f1dc6cd35c875afc0d5ea6b80538...70a393ea9ab34dfaedbe0a285dcf3e5c4a4c5f03,2,8,1,9,3,2012-02-27 21:16:06,2012-02-27 21:16:06
70a393ea9ab34dfaedbe0a285dcf3e5c4a4c5f03...483edbdf1aef40c208f6c96efbbcc3c34122e5f2,1,18,19,37,9,2012-02-27 22:03:18,2012-02-24 15:05:10
483edbdf1aef40c208f6c96efbbcc3c34122e5f2...7f58d207f32617e51017ee01a74e0f4042840e99,2,32,0,32,4,2012-02-27 22:17:09,2012-02-18 01:53:57
7f58d207f32617e51017ee01a74e0f4042840e99...692bcbe559b088247b8801cdb27c8ddc4b9eb8dd,1,22,37,59,10,2012-02-27 23:53:20,2012-02-27 23:53:20
692bcbe559b088247b8801cdb27c8ddc4b9eb8dd...63431796f4cdeb726cf8a4fe91806702cf09619c,2,50,2,52,3,2012-02-28 10:27:27,2012-02-26 19:13:08
63431796f4cdeb726cf8a4fe91806702cf09619c...4065b241e89000588131cac5228f397964ab034f,2,1,5,6,3,2012-02-29 01:06:20,2012-02-26 19:38:36
d6537321576a64e4994eed3e762920223261025e...1e425e3fa774fefd3553ecaa6f0ac35f9b0a1355,5,69,2,71,12,2012-02-15 20:35:34,2012-02-14 20:38:24
1e425e3fa774fefd3553ecaa6f0ac35f9b0a1355...71e975669cd22e496ad3d5b544bd84c448d52359,1,2,14,16,2,2012-02-15 21:32:46,2012-02-15 19:50:51
71e975669cd22e496ad3d5b544bd84c448d52359...3bc3af0276fd464cddec5118f750f92b4e667f9c,1,0,33,33,2,2012-02-16 03:45:33,2012-02-16 03:21:16
3bc3af0276fd464cddec5118f750f92b4e667f9c...ce485791db5507d160cbc204b8a58e770ac60a50,3,128,67,195,35,2012-02-16 06:12:03,2012-02-15 14:08:26
ce485791db5507d160cbc204b8a58e770ac60a50...ae5e23310e64db99ddefbf4904f74a42906d6451,2,6,1,7,2,2012-02-17 18:30:52,2012-02-17 18:18:11
ae5e23310e64db99ddefbf4904f74a42906d6451...977e211421fc0055fb46bde392207bef9703b0ce,1,1,1,2,1,2012-02-17 18:45:56,2012-02-17 18:35:05
977e211421fc0055fb46bde392207bef9703b0ce...7864bb9eb8211a6b5dfdaa65456ba05b393a6161,1,6,1,7,2,2012-02-17 23:30:00,2012-02-08 01:21:51
7864bb9eb8211a6b5dfdaa65456ba05b393a6161...07872870213ed38c1978b37e9e2e22db733b40f3,1,2,1,3,1,2012-02-17 23:34:19,2012-02-17 20:41:39
4065b241e89000588131cac5228f397964ab034f...217bb47b0271df61dc93a37a440404794679245a,15,1892,0,1892,15,2012-02-29 23:15:25,2012-02-27 18:59:01
217bb47b0271df61dc93a37a440404794679245a...4051c2843b17f481374036be0860b870f52be75a,52,62,81,143,42,2012-02-29 23:17:55,2012-02-13 22:47:50
4051c2843b17f481374036be0860b870f52be75a...ffcdcc7ff067935642f37984dc8974aed9b4811f,3,8,1602,1610,5,2012-02-29 23:18:51,2012-02-27 18:59:35
ffcdcc7ff067935642f37984dc8974aed9b4811f...8cd13eb74e3d3c23ecfcc104a1ad30668c676799,1,20,12,32,7,2012-02-29 23:19:47,2012-02-27 18:59:51
8cd13eb74e3d3c23ecfcc104a1ad30668c676799...63629614cbf3a28f4541f73971488046683ef79e,1,17,17,34,17,2012-02-29 23:19:59,2012-02-27 19:01:33
63629614cbf3a28f4541f73971488046683ef79e...1a181315eba88e56b3d13b115a1d669c5c8cd27d,1,6,5,11,6,2012-02-29 23:20:06,2012-02-27 19:01:53
1a181315eba88e56b3d13b115a1d669c5c8cd27d...5824881e4a840f25319c4757c9192e85b1683963,3,0,6,6,5,2012-02-29 23:20:13,2012-02-27 19:02:07
5824881e4a840f25319c4757c9192e85b1683963...f28d482cd43a2751f9a3efedf0ab0bce11fa7645,4,140,39,179,25,2012-02-29 23:20:53,2012-02-27 19:04:08
f28d482cd43a2751f9a3efedf0ab0bce11fa7645...d71f9944cc5bf485287442707bf31f0deb8b252b,3,61,2,63,3,2012-02-29 23:22:48,2012-02-27 19:06:14
d71f9944cc5bf485287442707bf31f0deb8b252b...df5be65415ce162725702d3a1a48f7dfce8538e8,1,9,9,18,9,2012-02-29 23:22:53,2012-02-27 19:06:31
df5be65415ce162725702d3a1a48f7dfce8538e8...5d4e3d2d0cb4e01f69ccba0c4ce2f152f648aa1d,1,1,1,2,1,2012-02-29 23:22:56,2012-02-27 19:06:55
5d4e3d2d0cb4e01f69ccba0c4ce2f152f648aa1d...d383954ffe0aca64036a7d1bfeb25f6a87e81203,1,12,12,24,12,2012-02-29 23:23:00,2012-02-27 19:07:12
d383954ffe0aca64036a7d1bfeb25f6a87e81203...03d6aa07ea8d267adb2101b333849251d45dd134,1,177,51,228,38,2012-02-29 23:23:04,2012-02-27 19:07:25
03d6aa07ea8d267adb2101b333849251d45dd134...6738d82e38e9f47df953f80dd9a30311afd152f7,1,6,6,12,5,2012-02-29 23:24:27,2012-02-27 19:07:49
6738d82e38e9f47df953f80dd9a30311afd152f7...032b877f31d83478df93076fc42ccfd25b898235,1,56,15,71,21,2012-03-01 00:04:50,2012-02-27 19:08:02
032b877f31d83478df93076fc42ccfd25b898235...f775c5cea4ff1e719e15a3dc8ef3a4abc9ea2650,1,11,11,22,10,2012-03-01 00:04:50,2012-02-27 19:08:17
f775c5cea4ff1e719e15a3dc8ef3a4abc9ea2650...db8c55e77c884b1c89e2bb7004a80b2965e4bf05,1,53,21,74,15,2012-03-01 00:04:51,2012-02-27 19:08:27
db8c55e77c884b1c89e2bb7004a80b2965e4bf05...cacb28c92ccdbfddaa119bcc3204d3f0070a443b,1,11,11,22,11,2012-03-01 00:04:51,2012-02-27 19:08:41
cacb28c92ccdbfddaa119bcc3204d3f0070a443b...14d4fbb00291a3f3864612d27792e86b50b0a8f6,1,13,12,25,11,2012-03-01 00:04:51,2012-02-27 19:09:33
14d4fbb00291a3f3864612d27792e86b50b0a8f6...2a6ff3f56b363f109264675be69cdcf2b9740fa6,1,89,86,175,73,2012-03-01 00:04:51,2012-02-27 19:09:33
2a6ff3f56b363f109264675be69cdcf2b9740fa6...a62ec4437baa0c5536aabb24a70ac1800038fb5f,1,57,15,72,14,2012-03-01 00:04:51,2012-02-27 19:09:33
a62ec4437baa0c5536aabb24a70ac1800038fb5f...4f24b20fcbfe32acb52b534c1ec8f1db1724a075,1,18,17,35,9,2012-03-01 00:04:52,2012-02-27 19:09:33
4f24b20fcbfe32acb52b534c1ec8f1db1724a075...c205d3b53a142a7490e692cec86ecf2f657bc998,1,3,3,6,3,2012-03-01 00:04:52,2012-02-27 19:09:34
c205d3b53a142a7490e692cec86ecf2f657bc998...e88a1ba74a6055687ad862a32e82ecd66cbd5e8a,1,93,12,105,15,2012-03-01 00:04:52,2012-02-27 19:09:34
e88a1ba74a6055687ad862a32e82ecd66cbd5e8a...e8ad5b9c1ca80447039b590d3095c18e45e9731f,1,51,71,122,49,2012-03-01 00:04:52,2012-02-27 19:09:34
e8ad5b9c1ca80447039b590d3095c18e45e9731f...8a121fa0e7b643bfd1f545fa30c5013427ec76f5,1,14,12,26,12,2012-03-01 00:04:52,2012-02-27 19:09:34
8a121fa0e7b643bfd1f545fa30c5013427ec76f5...3ce782b7f2bf5041e67d41babfacecbbc01a8728,1,8,8,16,8,2012-03-01 00:04:52,2012-02-27 19:09:34
3ce782b7f2bf5041e67d41babfacecbbc01a8728...e083720d548337b074b536c447ec81f81b743c97,1,33,34,67,30,2012-03-01 00:04:53,2012-02-27 19:09:34
e083720d548337b074b536c447ec81f81b743c97...798f8a0dc1041e18ef2d4f265e807e6fc66fe8ff,1,7,5,12,5,2012-03-01 00:04:53,2012-02-27 19:09:34
798f8a0dc1041e18ef2d4f265e807e6fc66fe8ff...3b6c1d74c7f981ace768122a05676b7383939191,1,7,4,11,4,2012-03-01 00:04:53,2012-02-27 19:09:34
3b6c1d74c7f981ace768122a05676b7383939191...d39297251f00ff44b52526057e3b259f01f4807a,1,5,3,8,3,2012-03-01 00:04:53,2012-02-27 19:09:34
d39297251f00ff44b52526057e3b259f01f4807a...8e22004cb54cb49cb21f6cca5be56ab7d9105f15,1,14,10,24,9,2012-03-01 00:04:53,2012-02-27 19:09:34
8e22004cb54cb49cb21f6cca5be56ab7d9105f15...774c289ba8581e4b358bd1b6415c3aefad97d282,1,5,1,6,3,2012-03-01 00:04:53,2012-02-27 19:09:34
774c289ba8581e4b358bd1b6415c3aefad97d282...8d1e5d3ae117e0f004866be5387ac559bdf775f1,1,3,1,4,1,2012-03-01 00:04:54,2012-02-27 19:09:34
8d1e5d3ae117e0f004866be5387ac559bdf775f1...4ed05da2beca97331845a692f457333707d20eb1,1,8,5,13,5,2012-03-01 00:04:54,2012-02-27 19:09:34
4ed05da2beca97331845a692f457333707d20eb1...c0446edcc2e984f5ea298d3f9256c9ccaa77ff78,1,15,7,22,8,2012-03-01 00:04:54,2012-02-27 19:09:35
c0446edcc2e984f5ea298d3f9256c9ccaa77ff78...c2f6405a0f4309a076d45a83d2558fe803a8e540,1,5,5,10,5,2012-03-01 00:04:54,2012-02-27 19:09:35
c2f6405a0f4309a076d45a83d2558fe803a8e540...c417de409dd5aae0448839199b40d7a1cc7cf2a9,1,4,4,8,4,2012-03-01 00:04:54,2012-02-27 19:09:35
c417de409dd5aae0448839199b40d7a1cc7cf2a9...3c195d04f303c783b6b40ee70c7640515c814513,1,11,11,22,11,2012-03-01 00:04:54,2012-02-27 19:09:35
3c195d04f303c783b6b40ee70c7640515c814513...169b0820f0e214e6cd5c919d4a4b5b5c23549b8a,1,12,6,18,7,2012-03-01 00:04:55,2012-02-27 19:09:35
169b0820f0e214e6cd5c919d4a4b5b5c23549b8a...b34feeeb8687c858e4f2185a837d9bbb3dda6fde,1,33,25,58,27,2012-03-01 00:04:55,2012-02-27 19:09:35
b34feeeb8687c858e4f2185a837d9bbb3dda6fde...674416fbc9b9343f05e407768e318736603cfbd9,6,7,8,15,7,2012-03-01 00:04:55,2012-02-27 19:12:35
674416fbc9b9343f05e407768e318736603cfbd9...7bfa5cf284de1f1c00dafa651bff5ea225e98825,7,13,11,24,12,2012-03-01 00:04:55,2012-02-27 19:18:10
7bfa5cf284de1f1c00dafa651bff5ea225e98825...17db291b5cc842073471d881ef05ce9cbfaa0911,2,3,1,4,2,2012-03-01 00:04:55,2012-02-27 19:37:26
17db291b5cc842073471d881ef05ce9cbfaa0911...86d077da0069506c378677d1c6c763a053ad0a34,1,1,1,2,1,2012-03-01 00:04:55,2012-02-27 19:44:30
86d077da0069506c378677d1c6c763a053ad0a34...4ca3fd0a01decf66d79972c52139cdb71f3d412d,1,6,0,6,2,2012-03-01 00:04:56,2012-02-27 19:44:36
31721da4b120ca2b1c0b6b9e93ce8beb5e810da3...0cdf85e28d57428a90026c6a402e624c1dcaabce,61,750,543,1293,274,2012-02-18 23:34:57,2012-02-18 23:01:35
0cdf85e28d57428a90026c6a402e624c1dcaabce...96338432e2b76ee294b7e9e8ee56164288a56a08,1,1,0,1,1,2012-02-19 00:04:10,2012-02-19 00:04:10
96338432e2b76ee294b7e9e8ee56164288a56a08...d530ee62cd1eb1fd038f4e86314c741422b4de25,4,11,10,21,7,2012-02-19 01:46:28,2012-02-16 19:52:47
d530ee62cd1eb1fd038f4e86314c741422b4de25...7ae0d473a6b6ac8cb3e55d665528667566cd8e60,1,34,17,51,7,2012-02-19 19:46:58,2012-02-18 09:13:17
7ae0d473a6b6ac8cb3e55d665528667566cd8e60...4af673e161138fbed287a8e00cf7b2b0aafdd8b3,130,3936,1529,5465,414,2012-02-20 10:47:03,2012-02-20 10:47:03
4af673e161138fbed287a8e00cf7b2b0aafdd8b3...af4a96ce6ee7f61d3766035cd7c115afec658def,1,2,2,4,2,2012-02-20 10:49:25,2012-02-18 20:02:53
af4a96ce6ee7f61d3766035cd7c115afec658def...546870edd8779db78d687a751d716c293928089d,1,8,0,8,1,2012-02-20 10:49:32,2012-02-18 20:03:47
546870edd8779db78d687a751d716c293928089d...028043dd024b074b7ebec7611f87ce4538edc27d,1,1,0,1,1,2012-02-20 10:49:57,2012-02-18 20:06:31
028043dd024b074b7ebec7611f87ce4538edc27d...7f4aba91d31394218fbd8a351cd1377975712d67,36,39,3,42,37,2012-02-20 12:29:11,2012-02-20 12:22:12
7f4aba91d31394218fbd8a351cd1377975712d67...999757983c8fafa140bef77705db77c7699f5830,1,3,1,4,2,2012-02-20 12:31:00,2012-02-20 12:24:21
999757983c8fafa140bef77705db77c7699f5830...8d3c46daa8a4a9a06a7753f594690edc4a8fe401,1,1,1,2,1,2012-02-20 12:42:27,2012-02-18 05:28:13
8d3c46daa8a4a9a06a7753f594690edc4a8fe401...b72277183f9cb79274d6f8915e02b895c56b2288,2,91,6,97,4,2012-02-20 12:56:27,2011-12-25 04:39:57
b72277183f9cb79274d6f8915e02b895c56b2288...c3a9733ac14aa0ebf06cc4d9e3ababe8c9be6220,1,1,1,2,1,2012-02-20 15:04:44,2012-02-18 15:32:06
c3a9733ac14aa0ebf06cc4d9e3ababe8c9be6220...1109c8fc4ec32d67a52334604473ceea2e0b00c9,1,1,3,4,2,2012-02-20 15:04:44,2012-02-18 15:45:22
1109c8fc4ec32d67a52334604473ceea2e0b00c9...b0c15412270f32e00c268c578f07a1ed032323f5,1,2,6,8,2,2012-02-20 15:04:44,2012-02-19 20:16:50
b0c15412270f32e00c268c578f07a1ed032323f5...f0c5165f81e1e326322619857b16689fe27fc978,7,1782,602,2384,300,2012-02-20 15:12:33,2012-02-20 15:12:33
f0c5165f81e1e326322619857b16689fe27fc978...de5e3f6a6f5eece5a6927ef17c8bf836c4d0779d,2,38,31,69,14,2012-02-20 15:12:48,2012-02-17 22:45:50
de5e3f6a6f5eece5a6927ef17c8bf836c4d0779d...0cebfc8ddb509fbf5f865bb660b73e96680b3f65,1,7,1,8,1,2012-02-20 16:07:19,2012-02-20 16:03:14
0cebfc8ddb509fbf5f865bb660b73e96680b3f65...86f4846c2166ce91b17674d066f8fb3a5a278a8c,2,28,9,37,7,2012-02-20 16:11:21,2012-02-17 17:08:48
86f4846c2166ce91b17674d066f8fb3a5a278a8c...f116e17a2300545451e3e7b60bd4e20fc4489d20,1,3,2,5,2,2012-02-20 16:24:14,2012-02-20 16:24:13
f116e17a2300545451e3e7b60bd4e20fc4489d20...3f4062309e6bead91111db9811b5e6e2c20ca2a9,1,0,4,4,4,2012-02-20 20:55:35,2012-02-20 18:55:37
3f4062309e6bead91111db9811b5e6e2c20ca2a9...c6c6f98f1c33e9569b885e89750278fc6a211080,3,20,33,53,11,2012-02-20 20:58:00,2012-02-20 17:59:56
c6c6f98f1c33e9569b885e89750278fc6a211080...da908364a8ece7186f408eb1307ecf54ac2a76a7,3,22,24,46,16,2012-02-20 20:58:00,2012-02-20 19:32:10
da908364a8ece7186f408eb1307ecf54ac2a76a7...19133cac029c6641e94f7f2e7fbce92c859e3846,1,31,17,48,4,2012-02-20 21:14:23,2012-02-20 20:27:07
19133cac029c6641e94f7f2e7fbce92c859e3846...c6a04ce78f9fcc07bc1ae108c402fba508344202,5,544,1,545,10,2012-02-21 13:07:25,2012-01-22 18:24:37
c6a04ce78f9fcc07bc1ae108c402fba508344202...feff9bbb67c59d02c11d50d17283cdcce7b5aecc,1,1,7,8,2,2012-02-21 14:18:16,2012-02-18 17:26:28
feff9bbb67c59d02c11d50d17283cdcce7b5aecc...b9127eb0a5d64a2317197e3b4956bdd7450523da,2,10,2,12,4,2012-02-21 14:33:14,2012-02-21 12:57:38
b9127eb0a5d64a2317197e3b4956bdd7450523da...080ffb8b2c598a75ee04e00378cbe65fbcf24744,1,0,6,6,1,2012-02-21 14:50:01,2012-02-21 14:42:15
080ffb8b2c598a75ee04e00378cbe65fbcf24744...bae4018b3015c480f1694036536b65c55e6c645e,1,1,1,2,2,2012-02-21 20:02:57,2012-02-21 20:02:57
bae4018b3015c480f1694036536b65c55e6c645e...3817b12fec5ce221796156bd950cd4e370476c7c,1,1,0,1,1,2012-02-21 20:03:15,2012-02-21 20:03:15
3817b12fec5ce221796156bd950cd4e370476c7c...5e3ca981556c305830553d006b76d5dcaaf49276,1,13,11,24,4,2012-02-21 20:17:26,2012-02-21 19:08:13
5e3ca981556c305830553d006b76d5dcaaf49276...27d8b059fa214c56de6dc359ebdb8c05ad6b9f99,2,35,0,35,2,2012-02-21 23:26:35,2012-02-21 23:26:35
27d8b059fa214c56de6dc359ebdb8c05ad6b9f99...21374c3903caa1d752b4212296cf0898483a56ab,1,0,2,2,1,2012-02-22 13:25:56,2012-02-19 21:27:09
21374c3903caa1d752b4212296cf0898483a56ab...3d1b67064085ef486a69c2fc69d195dc35f4f50c,2,18,3,21,5,2012-02-22 14:20:23,2012-02-22 11:57:32
3d1b67064085ef486a69c2fc69d195dc35f4f50c...7f94b5ccca369600ee438c5d8771a2455044f37d,1,0,5,5,1,2012-02-22 21:20:57,2012-02-21 22:32:19
7f94b5ccca369600ee438c5d8771a2455044f37d...e60b18bbdf1b25fdf4f438fa424fea11f31b3eff,1,12,2,14,2,2012-02-22 22:27:08,2012-02-22 22:03:22
e60b18bbdf1b25fdf4f438fa424fea11f31b3eff...ac9fa2b8463f46b6ecbc8294aa85224a1585024a,1,1,6,7,1,2012-02-23 00:05:55,2012-02-17 13:52:06
ac9fa2b8463f46b6ecbc8294aa85224a1585024a...fd61bfc73195063d984e7a1d3594015c7d5f4e25,3,10,4,14,7,2012-02-23 00:07:23,2012-02-17 13:53:24
fd61bfc73195063d984e7a1d3594015c7d5f4e25...defa637378ae3ce3978908c7b604082308868a8c,3,60,0,60,3,2012-02-23 01:07:39,2012-02-23 00:51:27
defa637378ae3ce3978908c7b604082308868a8c...3502e45b6c05eeabf9eae1ec8c455eedcdac79f8,1,4,1,5,1,2012-02-23 01:07:39,2012-02-23 00:52:45
3502e45b6c05eeabf9eae1ec8c455eedcdac79f8...92cb684e784d09c05d3e5d9fc16b2e4ef9fbeba8,1,46,1,47,2,2012-02-23 04:57:43,2012-02-23 04:19:12
92cb684e784d09c05d3e5d9fc16b2e4ef9fbeba8...9a6f936c8a62c1a6edad3bda0faa8d8112b7cf92,1,8,0,8,1,2012-02-23 04:57:55,2012-02-23 04:57:01
a63ce6ea941633b9466f129c3ee3dbe116b10553...3aa2fd3b2cf588196dbb12beef7ec242af5c0f2f,4,44,14,58,19,2012-03-01 16:02:20,2012-03-01 16:00:33
3aa2fd3b2cf588196dbb12beef7ec242af5c0f2f...d8c5ba21854cd45a1bcb898ccb9d6a574c3fd4ee,1,46,1,47,2,2012-03-02 17:17:09,2012-02-23 04:19:12
d8c5ba21854cd45a1bcb898ccb9d6a574c3fd4ee...edea94c332f07ed81ea7de9b93bbcec806c81544,2,62,5,67,9,2012-03-02 17:29:18,2012-03-01 17:19:51
edea94c332f07ed81ea7de9b93bbcec806c81544...054127112ce335ceb4477a481e99e3fb2176b457,220,1183,375,1558,312,2012-03-02 17:31:46,2012-03-02 17:31:24
054127112ce335ceb4477a481e99e3fb2176b457...1bf3a1435398b25673b79b6cc2393391d1684f88,100,105,103,208,103,2012-03-02 17:48:25,2012-03-02 17:48:25
9a6f936c8a62c1a6edad3bda0faa8d8112b7cf92...1b5048b288648cd963acd8a4e247a16bc2a52cc6,1,8,4,12,4,2012-02-23 08:18:17,2012-02-23 08:18:17
1b5048b288648cd963acd8a4e247a16bc2a52cc6...b92a919500daf9ec645cd42cd6a8c99883e5198d,3,1,8,9,4,2012-02-23 12:11:07,2012-02-23 12:11:07
b92a919500daf9ec645cd42cd6a8c99883e5198d...680d75af34f9c6a0b478977e9b3dbc4d25f26402,3,3,1,4,4,2012-02-23 13:11:26,2012-01-18 09:37:02
680d75af34f9c6a0b478977e9b3dbc4d25f26402...58e5d69250df16a7a4746a0c028320e2ef821672,2,3,1,4,2,2012-02-23 13:11:26,2012-01-18 10:18:13
58e5d69250df16a7a4746a0c028320e2ef821672...491ec171ec6b940536e77af0c61c50e10a1848d5,1,1,1,2,1,2012-02-23 13:11:26,2012-02-23 11:57:40
491ec171ec6b940536e77af0c61c50e10a1848d5...c1fcb1db996a79cdd6bb88c720c18ee734ea23c8,1,1,1,2,1,2012-02-23 13:11:26,2012-02-23 12:25:20
9a6f936c8a62c1a6edad3bda0faa8d8112b7cf92...73806b56e5680487ece06ce7b3e216fa89191c99,1,6,0,6,1,2012-02-23 04:58:24,2012-02-23 00:09:42
73806b56e5680487ece06ce7b3e216fa89191c99...d3b83726157a2700c4e90e9983b9dc5a205550ac,1,1,1,2,1,2012-02-23 04:58:24,2012-02-23 01:04:07
d3b83726157a2700c4e90e9983b9dc5a205550ac...a9130222bd36ac2c5dd7ae560f02bb99569749a7,2,3,18,21,5,2012-02-23 22:12:14,2012-02-23 22:11:28
a9130222bd36ac2c5dd7ae560f02bb99569749a7...d384b8b0d2ab7f05465f0a3e15fe20b4e25b5f86,7,53,17,70,12,2012-02-23 22:12:39,2012-02-23 00:48:25
1bf3a1435398b25673b79b6cc2393391d1684f88...c0c4e008aa051baadcc274d792f4a8f5c6b130b8,10,75,85,160,35,2012-03-02 19:26:05,2012-03-02 19:23:12
c0c4e008aa051baadcc274d792f4a8f5c6b130b8...2d6a076ab32b20447f7f173eb8b15bf15539932e,2,8,2,10,3,2012-03-02 19:26:05,2012-02-02 23:37:59
2d6a076ab32b20447f7f173eb8b15bf15539932e...b47ba2c431a272d05764ee92055e21969a860076,1,1,1,2,1,2012-03-02 19:26:06,2012-02-08 00:50:05
b47ba2c431a272d05764ee92055e21969a860076...ef5b0f4c8ebeba13239770a9541fc7178c7086dc,1,5,2,7,3,2012-03-02 20:36:45,2012-03-02 20:35:58
ef5b0f4c8ebeba13239770a9541fc7178c7086dc...48a2d34cfe6b7e1c9d15202a4ef5e3c82d1fba35,6,54,14,68,9,2012-03-02 20:36:45,2012-03-02 18:29:03
c5cbc3db474c72d2e5602cbef1fcefba2d6e5aa9...f492baa61dd1fa2955fc3821b34fb5c998c81503,1,2,2,4,1,2012-02-23 22:41:36,2012-02-23 22:41:29
f492baa61dd1fa2955fc3821b34fb5c998c81503...59ecf2ccf743489a2885cf824460070e6fc12d6a,2,18,3,21,5,2012-02-23 22:52:18,2012-02-23 22:52:18
59ecf2ccf743489a2885cf824460070e6fc12d6a...a84adad07850dac58c444dd59ab386be5ca0e413,1,1,0,1,1,2012-02-23 22:52:39,2012-02-23 22:32:24
a84adad07850dac58c444dd59ab386be5ca0e413...b73ec84ce1e867bcda9965ecf2a9e588625ee366,1,43,0,43,1,2012-02-24 04:23:24,2012-02-24 02:07:26
b73ec84ce1e867bcda9965ecf2a9e588625ee366...27a937bcf824093b7707a845c6376cbaae1df78f,1,6,2,8,2,2012-02-24 04:23:26,2012-02-24 02:18:32
27a937bcf824093b7707a845c6376cbaae1df78f...d4d45a175785832a4eb22e8ddb9887f8db66e782,133,1862,509,2371,254,2012-02-25 02:51:22,2012-02-25 02:51:22
d4d45a175785832a4eb22e8ddb9887f8db66e782...db8940dae2b545347b918e141dec6a699750be43,2,12,4,16,6,2012-02-25 06:37:38,2012-02-24 21:28:46
db8940dae2b545347b918e141dec6a699750be43...2f5e08414774a88a9451a2fdafbe38322c101fc6,1,0,5,5,1,2012-02-25 14:07:30,2012-02-25 14:07:30
2f5e08414774a88a9451a2fdafbe38322c101fc6...ae762b620e92891c033537924df14761221572c0,1,3,0,3,1,2012-02-25 14:17:05,2012-02-25 14:17:05
ae762b620e92891c033537924df14761221572c0...2d7b43f466c85cdb1cea1d01ab68a908d63b9977,1,1,3,4,1,2012-02-25 23:32:36,2012-02-24 16:37:16
2d7b43f466c85cdb1cea1d01ab68a908d63b9977...3c68c85f182758132b1c07a9ab7da5119306a54b,1,6,0,6,1,2012-02-27 01:28:06,2012-02-26 02:51:30
3c68c85f182758132b1c07a9ab7da5119306a54b...d03b8487c608cb030055a6ccff34ae59a230356a,2,36,2,38,5,2012-02-27 01:31:23,2012-02-26 23:02:21
d03b8487c608cb030055a6ccff34ae59a230356a...3f1f2d149724b617418ac2212ac829b12b50d321,1,11,1,12,2,2012-02-27 01:40:09,2012-02-26 21:23:42
3f1f2d149724b617418ac2212ac829b12b50d321...aa35564ca1c9f3854bc5f7983f2f00cb51f67ffe,1,2,4,6,2,2012-02-27 01:44:33,2012-02-25 19:18:45
aa35564ca1c9f3854bc5f7983f2f00cb51f67ffe...90fd70d284b7a3bb12e94ac5f7d7354ef1a36ddc,1,1,2,3,1,2012-02-27 03:00:22,2012-02-27 02:57:19
353bfbaf9339cd63bfec7d2fc19ab42777875c1e...2f256af412486b5402a1a6bf3da9c2b9c0ac0556,1,2,2,4,1,2012-03-02 21:09:09,2012-03-02 21:08:28
2f256af412486b5402a1a6bf3da9c2b9c0ac0556...2d44dcc8be9dc8d9b1dde3f68983478aa30de59c,26,52,12,64,27,2012-03-04 01:03:52,2012-03-02 23:14:03
2d44dcc8be9dc8d9b1dde3f68983478aa30de59c...3dfa98c9917ac23dd052fd66f996c2abc849b759,1,5,1,6,1,2012-03-04 01:03:56,2012-03-03 23:50:33
3dfa98c9917ac23dd052fd66f996c2abc849b759...c368e46e7fe5c7cda38a73ca7fd3335bd030c9a6,1,9,0,9,1,2012-03-04 01:03:59,2012-03-03 23:51:14
c368e46e7fe5c7cda38a73ca7fd3335bd030c9a6...f70be203e4abf05bc401e0eedc8646ac4da8be09,1,10,10,20,8,2012-03-04 01:04:02,2012-03-04 00:23:15
f70be203e4abf05bc401e0eedc8646ac4da8be09...2e487379adabe09b19e92e4f4ecb5bc143679aca,1,36,2,38,4,2012-03-04 01:04:02,2012-03-04 00:23:31
2e487379adabe09b19e92e4f4ecb5bc143679aca...cf6e4d82e76fe17dbc08b32e44917f4927590b13,5,14,14,28,14,2012-03-04 01:08:46,2012-03-04 01:08:46
cf6e4d82e76fe17dbc08b32e44917f4927590b13...1d59a73fefbe70188d32165cb5f738e31967ebca,1,2,0,2,1,2012-03-04 01:14:06,2012-03-04 01:14:06
1d59a73fefbe70188d32165cb5f738e31967ebca...a42b4ad44e62c2deacb2c4a76c5feab8ab7f9b04,1,3,3,6,3,2012-03-04 06:12:43,2012-03-04 06:12:35
a42b4ad44e62c2deacb2c4a76c5feab8ab7f9b04...f1742c93d7fac20112b7fa60f9b93bfc680b913a,1,0,1,1,1,2012-03-04 06:58:29,2012-03-04 06:58:29
f1742c93d7fac20112b7fa60f9b93bfc680b913a...5ca5ec33cca2ac7500c439aeb7e287bf6cc5f660,1,6,5,11,5,2012-03-04 06:58:47,2012-03-04 06:58:47
90fd70d284b7a3bb12e94ac5f7d7354ef1a36ddc...964d03bc3f09dbbdcd1569fbf63bc03f67542f08,15,1892,0,1892,15,2012-02-27 18:59:01,2012-02-27 18:59:01
964d03bc3f09dbbdcd1569fbf63bc03f67542f08...7d6d5e263e8cea5c34f6cb6947e7264ced0d6381,3,8,1602,1610,5,2012-02-27 18:59:35,2012-02-27 18:59:35
7d6d5e263e8cea5c34f6cb6947e7264ced0d6381...7aee49d9677af8114e3286d1871632b2f5ef4dbc,1,20,14,34,7,2012-02-27 18:59:51,2012-02-27 18:59:51
7aee49d9677af8114e3286d1871632b2f5ef4dbc...ac5e7072c9743f6b1bb1e291105dbd6cbdc59fa0,1,17,17,34,17,2012-02-27 19:01:33,2012-02-27 19:01:33
ac5e7072c9743f6b1bb1e291105dbd6cbdc59fa0...3d5f7594b58d5a7e8afcb7cf3b132897838a4511,1,6,5,11,6,2012-02-27 19:01:53,2012-02-27 19:01:53
3d5f7594b58d5a7e8afcb7cf3b132897838a4511...3bec62b01258846568b20bf4211c9b5be4a9630a,3,0,6,6,5,2012-02-27 19:14:16,2012-02-27 19:02:07
3bec62b01258846568b20bf4211c9b5be4a9630a...bd880e7f3fc882a2161db30f5f9f2008047224e4,4,140,39,179,25,2012-02-27 19:14:24,2012-02-27 19:04:08
bd880e7f3fc882a2161db30f5f9f2008047224e4...11d27367cdc150a0d7621c5432171ec0c2b9fe42,3,61,2,63,3,2012-02-27 19:14:31,2012-02-27 19:06:14
11d27367cdc150a0d7621c5432171ec0c2b9fe42...24a2706a3bb6c3f43ec42253a3bcb3f7336a846e,1,9,9,18,9,2012-02-27 19:14:31,2012-02-27 19:06:31
24a2706a3bb6c3f43ec42253a3bcb3f7336a846e...44559a32119b4a9a64cabce7eb3ff4b856777419,1,1,1,2,1,2012-02-27 19:14:32,2012-02-27 19:06:55
44559a32119b4a9a64cabce7eb3ff4b856777419...97ee38707bc3e88411e4c7639b75cdb72e98d566,1,12,12,24,12,2012-02-27 19:14:32,2012-02-27 19:07:12
97ee38707bc3e88411e4c7639b75cdb72e98d566...60aa852a036835c2fb74c6f0647cb1080c524d13,1,177,51,228,38,2012-02-27 19:14:32,2012-02-27 19:07:25
60aa852a036835c2fb74c6f0647cb1080c524d13...6e51db126893cabaecb18f7fdc019639e975adda,1,120,54,174,38,2012-02-27 19:14:32,2012-02-27 19:07:49
6e51db126893cabaecb18f7fdc019639e975adda...ab294ad93dff2b124c66a44097d58b790fe093b1,1,57,16,73,22,2012-02-27 19:14:32,2012-02-27 19:08:02
ab294ad93dff2b124c66a44097d58b790fe093b1...dd1b3b6dfd304dae20cd0901b34460bb51f0acae,1,11,11,22,10,2012-02-27 19:14:33,2012-02-27 19:08:17
dd1b3b6dfd304dae20cd0901b34460bb51f0acae...9a0495a4b0f599b8c5608b34d4c90d584663f6c2,1,53,21,74,15,2012-02-27 19:14:33,2012-02-27 19:08:27
9a0495a4b0f599b8c5608b34d4c90d584663f6c2...2f148845e8acdcaee2c6e1261cf8ff962fe9aa3c,1,11,11,22,11,2012-02-27 19:14:33,2012-02-27 19:08:41
2f148845e8acdcaee2c6e1261cf8ff962fe9aa3c...ec02e827602daa5f9b3ba168a40ab4a851da6c6a,1,13,12,25,11,2012-02-27 19:14:33,2012-02-27 19:09:33
ec02e827602daa5f9b3ba168a40ab4a851da6c6a...40190b7c92d53530a87418ddf8a94f89fffeaf17,1,93,90,183,77,2012-02-27 19:14:33,2012-02-27 19:09:33
40190b7c92d53530a87418ddf8a94f89fffeaf17...af7314e190ecbc6f7fee57bc2ec69a335f28ef15,1,54,15,69,14,2012-02-27 19:14:34,2012-02-27 19:09:33
af7314e190ecbc6f7fee57bc2ec69a335f28ef15...02e288b640b537dfdbafeceb2fde6c84c254acfe,1,18,17,35,9,2012-02-27 19:14:34,2012-02-27 19:09:33
02e288b640b537dfdbafeceb2fde6c84c254acfe...2806c6ce28caa04809db365ceeae7e5656f443d7,1,3,3,6,3,2012-02-27 19:14:34,2012-02-27 19:09:34
2806c6ce28caa04809db365ceeae7e5656f443d7...0cf7156f085298d469ddecefea193624fa8650eb,1,93,12,105,15,2012-02-27 19:14:34,2012-02-27 19:09:34
0cf7156f085298d469ddecefea193624fa8650eb...2fd5cb3d2e002a2bea9a78bfe7a2d38486289f64,1,49,56,105,44,2012-02-27 19:14:34,2012-02-27 19:09:34
2fd5cb3d2e002a2bea9a78bfe7a2d38486289f64...0e752246d38285a72dfc92e7f8a7bfd46fefdf45,1,14,12,26,12,2012-02-27 19:14:35,2012-02-27 19:09:34
0e752246d38285a72dfc92e7f8a7bfd46fefdf45...aef61ee36713a38e62dbdc12e965a8a47da985f2,1,8,8,16,8,2012-02-27 19:14:35,2012-02-27 19:09:34
aef61ee36713a38e62dbdc12e965a8a47da985f2...a52254d0d789d73dee298059c96584a37488f027,1,35,30,65,30,2012-02-27 19:14:35,2012-02-27 19:09:34
a52254d0d789d73dee298059c96584a37488f027...628bc835ae3f47630ccbebe6999a96d69d2b53e4,1,7,5,12,5,2012-02-27 19:14:35,2012-02-27 19:09:34
628bc835ae3f47630ccbebe6999a96d69d2b53e4...728386bfb21e6cd3a190bab4c597322b63099674,1,7,4,11,4,2012-02-27 19:14:35,2012-02-27 19:09:34
728386bfb21e6cd3a190bab4c597322b63099674...dfdf09d43d06afae9083ddb3a04b9114956f5cde,1,5,3,8,3,2012-02-27 19:14:36,2012-02-27 19:09:34
dfdf09d43d06afae9083ddb3a04b9114956f5cde...94c6bcfdad534ba1df5ddf1c2eb19cce748b46ee,1,14,10,24,9,2012-02-27 19:14:36,2012-02-27 19:09:34
94c6bcfdad534ba1df5ddf1c2eb19cce748b46ee...03968739c5c1c85512f99ecc5a0d0067eef6b694,1,5,1,6,3,2012-02-27 19:14:36,2012-02-27 19:09:34
03968739c5c1c85512f99ecc5a0d0067eef6b694...f0694e1e0c9da4a8bc26adc240a22d571b261eeb,1,3,1,4,1,2012-02-27 19:14:36,2012-02-27 19:09:34
f0694e1e0c9da4a8bc26adc240a22d571b261eeb...c4d6c7f82964559e5ddf07b6d9514e5520cf1c45,1,8,5,13,5,2012-02-27 19:14:37,2012-02-27 19:09:34
c4d6c7f82964559e5ddf07b6d9514e5520cf1c45...c9b35b992338bb1adf95bc6f39fde6bbe8b38c4c,1,17,9,26,9,2012-02-27 19:14:37,2012-02-27 19:09:35
c9b35b992338bb1adf95bc6f39fde6bbe8b38c4c...cf4700aff42ff09bb97a3e119dc24558ea24530f,1,5,5,10,5,2012-02-27 19:14:37,2012-02-27 19:09:35
cf4700aff42ff09bb97a3e119dc24558ea24530f...a54b70a355ee0e3197d9f6977f0848889f332db1,1,4,4,8,4,2012-02-27 19:14:37,2012-02-27 19:09:35
a54b70a355ee0e3197d9f6977f0848889f332db1...8e6086b40330dd0e02a5679d2276cea4311fd1ab,1,11,11,22,11,2012-02-27 19:14:37,2012-02-27 19:09:35
8e6086b40330dd0e02a5679d2276cea4311fd1ab...f4720d8dbd708c5758f624b833a30454d8b2a351,1,12,6,18,7,2012-02-27 19:14:38,2012-02-27 19:09:35
f4720d8dbd708c5758f624b833a30454d8b2a351...9fe92590b24fed4860d432753a447fc4724a9073,1,33,25,58,27,2012-02-27 19:14:38,2012-02-27 19:09:35
9fe92590b24fed4860d432753a447fc4724a9073...f9e464f95a75ac3b3e06ceb3b0c61554f36adf2b,6,7,7,14,7,2012-02-27 19:14:38,2012-02-27 19:12:35
f9e464f95a75ac3b3e06ceb3b0c61554f36adf2b...f9df88c6dae7dabd79bb889d8e6b23ca4bdc7f1e,7,13,11,24,12,2012-02-27 19:18:10,2012-02-27 19:18:10
f9df88c6dae7dabd79bb889d8e6b23ca4bdc7f1e...5571c1aaa4e37a56f6ef0a874eb758137f10c78e,2,3,1,4,2,2012-02-27 19:37:26,2012-02-27 19:37:26
5571c1aaa4e37a56f6ef0a874eb758137f10c78e...909ea3008ef3606def315807f334d028fa6afacd,1,1,1,2,1,2012-02-27 19:44:30,2012-02-27 19:44:30
909ea3008ef3606def315807f334d028fa6afacd...7af2d6b985192c17b68b7b1c4952df452d0e6f84,1,6,0,6,2,2012-02-27 19:44:36,2012-02-27 19:44:36
5ca5ec33cca2ac7500c439aeb7e287bf6cc5f660...8258bd467a178297096f409e305f0d04abc765a7,1,1,2,3,1,2012-03-05 18:28:47,2012-03-05 18:28:47
8258bd467a178297096f409e305f0d04abc765a7...33f9074a621f5f62dea018e61968a2617397f738,5,86,1,87,6,2012-03-05 18:59:14,2012-03-05 18:59:14
33f9074a621f5f62dea018e61968a2617397f738...daaccc7cb7f4ac208146ef3940fe61c3080fbc16,3,8,2,10,5,2012-03-08 01:57:37,2012-03-08 01:57:37
daaccc7cb7f4ac208146ef3940fe61c3080fbc16...3733a85d8d1fa82ca9998fd874f16084801d5db5,1,17,4,21,5,2012-03-08 01:57:44,2012-03-07 23:13:44
0e7dad3f6ee283904a34b08bfb5db38db8a89169...82ad1f87fa99b420a97cc9bfae727fce0b1bf8a4,2,20,7,27,6,2012-02-27 20:02:25,2012-02-27 11:32:13
82ad1f87fa99b420a97cc9bfae727fce0b1bf8a4...f4641bd4de566145e99b05c47c8f3d629b0223cd,179,7422,2793,10215,1602,2012-02-27 20:11:09,2012-02-24 00:35:46
f4641bd4de566145e99b05c47c8f3d629b0223cd...fde26002f176b4da87cc60bdb1b59b1d45c6a901,1,0,1,1,1,2012-02-27 20:11:10,2012-02-06 23:22:52
fde26002f176b4da87cc60bdb1b59b1d45c6a901...2e24ded6d23c58c97d3559bbfb37872b3981bc55,81,6248,824,7072,400,2012-02-27 21:43:31,2012-02-27 21:43:31
2e24ded6d23c58c97d3559bbfb37872b3981bc55...412cebec9e0b10eedf3547a1fde3cf56a9374c99,1,0,1,1,1,2012-02-27 21:43:58,2012-02-06 23:22:52
412cebec9e0b10eedf3547a1fde3cf56a9374c99...50cfeef65e60690b6d318a294981aaed4bc98dcc,1,1,1,2,1,2012-02-27 21:55:23,2012-02-27 21:55:23
50cfeef65e60690b6d318a294981aaed4bc98dcc...cacd651ec6944c7b6596d1c199ab9a37ba9abf7c,1,16,16,32,10,2012-02-27 22:00:18,2012-02-24 15:05:10
cacd651ec6944c7b6596d1c199ab9a37ba9abf7c...ba0892ba910bb6c60ac4e9ed2df2c37f67efdea7,1,2,2,4,2,2012-02-27 22:04:46,2012-02-27 21:54:30
ba0892ba910bb6c60ac4e9ed2df2c37f67efdea7...493a6bb19a2484829f340977d751ce6588c92ebc,2,32,0,32,4,2012-02-27 22:18:51,2012-02-18 01:53:57
493a6bb19a2484829f340977d751ce6588c92ebc...29463cb60c2079a046f9c255fb0eccecea2674fc,1,11,4,15,5,2012-02-28 00:41:30,2012-02-28 00:41:30
29463cb60c2079a046f9c255fb0eccecea2674fc...44daa9836b5bb4cfb8434b35bb1a12fc324223aa,1,29,7,36,2,2012-02-28 01:28:42,2012-02-28 01:19:12
44daa9836b5bb4cfb8434b35bb1a12fc324223aa...cd5d2473a463cec5d2d1eeeac4770aa1b20a692a,2,50,2,52,3,2012-02-28 10:57:13,2012-02-26 19:13:08
cd5d2473a463cec5d2d1eeeac4770aa1b20a692a...18acdff8d3e783cd067534994d10104780f2fd07,1,2,1,3,1,2012-02-28 16:27:52,2012-02-28 16:09:24
18acdff8d3e783cd067534994d10104780f2fd07...af7960b29525ec28ca58617e9b06c8b0df3085cd,23,568,301,869,89,2012-02-28 17:11:48,2012-02-28 17:11:48
af7960b29525ec28ca58617e9b06c8b0df3085cd...56cfcea4b4050140e13bc25574766da17c8b5b02,2,1,5,6,3,2012-02-29 01:10:56,2012-02-26 19:38:36
56cfcea4b4050140e13bc25574766da17c8b5b02...7343f8e776146bf4461348a9130f2c5040a0dfa0,3,28,5,33,5,2012-02-29 01:16:08,2012-02-10 05:58:58
7343f8e776146bf4461348a9130f2c5040a0dfa0...ebb79cdabaa8a9b4f095dac841955dae696cdd92,1,0,8,8,1,2012-02-29 13:26:04,2012-02-29 13:26:04
ebb79cdabaa8a9b4f095dac841955dae696cdd92...bab59f33e7e51a17771f6236aa236687f8ab899f,1,4,3,7,2,2012-02-29 15:16:13,2012-02-29 15:16:13
bab59f33e7e51a17771f6236aa236687f8ab899f...8cdbf014bd40c679970f6a73173a80d15e5f2275,1,1,1,2,1,2012-03-01 15:52:46,2012-02-28 19:19:50
8cdbf014bd40c679970f6a73173a80d15e5f2275...67b10f816c5bc72e1b251b800fa0987bc08d8847,1,19,14,33,5,2012-03-01 22:09:10,2012-03-01 21:49:23
67b10f816c5bc72e1b251b800fa0987bc08d8847...9be20afeb56f788319bea687ba16098fe2a915af,4,36,0,36,6,2012-03-01 22:12:19,2012-03-01 22:12:19
9be20afeb56f788319bea687ba16098fe2a915af...5e803219d84f75b5c24359360e84894d8763522c,1,2,1,3,1,2012-03-01 22:40:04,2012-03-01 22:40:04
5e803219d84f75b5c24359360e84894d8763522c...0613af0a20cdc845a0a9a1971d93e6e66ddd7268,1,0,26,26,3,2012-03-02 15:24:37,2012-03-02 15:24:34
0613af0a20cdc845a0a9a1971d93e6e66ddd7268...30b29d8f8745263475d67576c4b81ff164482676,2,27,21,48,8,2012-03-02 17:26:35,2012-03-02 01:14:27
30b29d8f8745263475d67576c4b81ff164482676...78db18739a740851b9800071a7fae0c734a915ce,2,92,4,96,3,2012-03-02 23:28:43,2012-02-29 01:14:40
78db18739a740851b9800071a7fae0c734a915ce...b6595c4d60cef34460f6cebce7c46a0dff6174f6,1,0,1,1,1,2012-03-03 17:07:22,2012-03-03 03:18:24
b6595c4d60cef34460f6cebce7c46a0dff6174f6...d6f0ecc622fed425d2ea8fb4dd6d885f4db4cda8,1,1,1,2,1,2012-03-03 17:07:39,2012-03-03 03:18:24
d6f0ecc622fed425d2ea8fb4dd6d885f4db4cda8...578ba76e6c0e16827bf9e471bdef500aedf3b09e,2,3,2,5,3,2012-03-03 17:22:34,2012-03-02 16:21:26
578ba76e6c0e16827bf9e471bdef500aedf3b09e...61be6844aaea681ce7269447ef850ce17dfa0b3e,2,9,1,10,2,2012-03-03 22:35:21,2012-03-03 22:35:21
61be6844aaea681ce7269447ef850ce17dfa0b3e...4053c01b53f6345b33ac1f377eb9f8d6a84a8b65,1,2,2,4,2,2012-03-03 22:40:29,2012-03-03 22:39:17
3733a85d8d1fa82ca9998fd874f16084801d5db5...c12a1dc5d8f04c3134be4131a77d283897500f9e,1,2,2,4,2,2012-03-14 23:20:40,2012-03-14 03:53:27
c12a1dc5d8f04c3134be4131a77d283897500f9e...c834ef409e85eaa43782bb3edd844af8923f3056,3,2,556,558,3,2012-03-14 23:44:36,2012-03-09 14:35:39
c834ef409e85eaa43782bb3edd844af8923f3056...ad5a108dfd5bb0a0b46c0f328adda28fa4edcd8e,21,447,148,595,120,2012-03-14 23:44:36,2012-03-14 23:30:35
ad5a108dfd5bb0a0b46c0f328adda28fa4edcd8e...f631c1d73b83d8c10b4121fb060f5817db6811d3,228,27565,344,27909,305,2012-03-14 23:44:36,2012-03-14 23:39:15
1d5b6f26fe960fb9ae9aa2ec2d96c2417503e069...959a19e1184ae5d460bb0bec364a2557c5fdbd27,2,5,3,8,3,2012-03-04 07:48:57,2012-03-04 07:48:57
959a19e1184ae5d460bb0bec364a2557c5fdbd27...e0796b6f1f854126adf5b2bbeca4cb580d0ca84a,10,110,8,118,18,2012-03-05 14:38:43,2012-03-05 14:38:43
e0796b6f1f854126adf5b2bbeca4cb580d0ca84a...c97b4f1971d79a687f32dd503326bde2bcc25729,1,0,6,6,1,2012-03-05 15:41:51,2012-03-05 15:41:51
c97b4f1971d79a687f32dd503326bde2bcc25729...707863c1fb13dacb48811b55801cdc83a4726904,1,1,2,3,1,2012-03-05 15:56:52,2012-02-27 22:56:34
707863c1fb13dacb48811b55801cdc83a4726904...5062741bd7a8ac6b7713defde62c0b8d3ab23fc8,1,11,8,19,6,2012-03-05 16:03:15,2012-03-05 15:55:24
5062741bd7a8ac6b7713defde62c0b8d3ab23fc8...5ebc05f56018d5ced52e4c41f9e8a92c425253e3,1,3,3,6,1,2012-03-05 16:03:27,2012-03-05 16:01:59
5ebc05f56018d5ced52e4c41f9e8a92c425253e3...e10bd5177f99ae029d08077ff77c50444697e25c,1,4,1,5,1,2012-03-05 21:20:13,2012-03-05 21:20:13
e10bd5177f99ae029d08077ff77c50444697e25c...1520c7bf5b4586c00ceef95ef9c52adb3ee86217,1,3,1,4,3,2012-03-05 21:39:12,2012-03-05 20:38:31
1520c7bf5b4586c00ceef95ef9c52adb3ee86217...39ce94276ae31be733d9e6de61764d0485322374,1,3,3,6,1,2012-03-05 21:53:16,2012-03-05 20:21:16
39ce94276ae31be733d9e6de61764d0485322374...59c3923672d33b4936fc9f82099be522b27f398e,3,71,2,73,5,2012-03-06 00:34:39,2012-02-26 12:26:09
59c3923672d33b4936fc9f82099be522b27f398e...9ea5a4c468fe290f00b6ebc78c33c2a60cc53625,1,6,1,7,1,2012-03-06 00:51:04,2012-03-06 00:50:21
9ea5a4c468fe290f00b6ebc78c33c2a60cc53625...1e9bcf26ce9e93caeda3280b8186168b49ae621d,8,186,20,206,27,2012-03-06 12:35:49,2012-02-23 15:37:49
1e9bcf26ce9e93caeda3280b8186168b49ae621d...443071db5749603f816199b9ec8bc512fb441d98,1,78,8,86,15,2012-03-06 12:37:42,2012-03-05 15:55:08
443071db5749603f816199b9ec8bc512fb441d98...544e5ee1fbddcc09418e1e99bd05d39bcee1ab3c,1,109,0,109,1,2012-03-06 17:11:53,2012-03-06 17:11:50
544e5ee1fbddcc09418e1e99bd05d39bcee1ab3c...07c886f94446daeb64aaab34904b319992895da4,3,92,0,92,4,2012-03-06 19:43:55,2012-03-05 16:51:58
07c886f94446daeb64aaab34904b319992895da4...b6023905ff16ec91b7cfbbf9fd31a9e4f07900a1,1,1,1,2,1,2012-03-06 19:46:27,2012-03-06 19:19:30
b6023905ff16ec91b7cfbbf9fd31a9e4f07900a1...b72d43cbf9116fb5eb0dc92006dbc180d4db7d3e,2,33,1,34,3,2012-03-06 21:20:23,2012-03-05 14:32:20
b72d43cbf9116fb5eb0dc92006dbc180d4db7d3e...d5fca08da45feb6e28c19a0ff2cfd819edf9238c,1,81,0,81,1,2012-03-07 02:19:17,2012-03-07 02:18:35
d5fca08da45feb6e28c19a0ff2cfd819edf9238c...17da4242b0dd8bd45f34d7f1610d83d1036b9e6d,1,13,0,13,1,2012-03-07 02:19:17,2012-03-07 02:18:53
17da4242b0dd8bd45f34d7f1610d83d1036b9e6d...fb53986a801bc36067a5b5b64cb23b05e3aa6d60,1,10,0,10,1,2012-03-07 02:19:17,2012-03-07 02:19:11
fb53986a801bc36067a5b5b64cb23b05e3aa6d60...150053b3fa6eb4f176323ee13ced924ab6e38bff,1,1,1,2,1,2012-03-07 03:31:16,2012-03-07 03:31:16
150053b3fa6eb4f176323ee13ced924ab6e38bff...408f450286d0e41ebd5c0085f354412d87967f92,1,0,1,1,1,2012-03-07 03:52:29,2012-03-07 03:51:55
408f450286d0e41ebd5c0085f354412d87967f92...c84b3c4b73bb7cbd7116b5872babe7e50b45d4a6,1,3,0,3,1,2012-03-07 14:05:34,2012-03-06 06:22:51
c84b3c4b73bb7cbd7116b5872babe7e50b45d4a6...024451c65cf0a1da4da48f99885cb8e7c2d20c72,1,1,1,2,1,2012-03-07 16:25:59,2012-02-13 00:50:19
024451c65cf0a1da4da48f99885cb8e7c2d20c72...f82ef0f7c3a024474847f10f18cf39df5f743b38,1,0,6,6,1,2012-03-07 19:17:36,2012-03-07 06:58:21
f82ef0f7c3a024474847f10f18cf39df5f743b38...5ad0140f487cae31859cc5fe82472420743ed29a,2,87,4,91,9,2012-03-07 21:37:39,2012-03-07 08:40:42
f631c1d73b83d8c10b4121fb060f5817db6811d3...571a51989e282edbe3d5e380797aa41498863514,3,12,8,20,7,2012-03-15 15:18:37,2012-03-15 15:14:22
571a51989e282edbe3d5e380797aa41498863514...06bf0707f7dc30b9b4e6966de76af324064c3a06,1,1,1,2,1,2012-03-15 15:22:36,2012-03-15 15:22:31
06bf0707f7dc30b9b4e6966de76af324064c3a06...9f7f86b534f8556290eb8cad915984ff4ca54996,7,39,15,54,10,2012-03-15 15:45:35,2012-03-15 00:07:24
31ad1d29c7e2a2d7ea140799b180c53cfa53863c...0c68604823ef71526aad604377f5a7db5d3dfb90,1,12,0,12,5,2012-03-08 19:39:39,2012-03-08 19:39:39
0c68604823ef71526aad604377f5a7db5d3dfb90...9d72a742e3c35c13e24e69184a4befe5a7e84fef,31,808,181,989,160,2012-03-09 17:42:12,2012-03-09 17:20:29
9d72a742e3c35c13e24e69184a4befe5a7e84fef...296b7a580b106ce07c7d5fc3018c9f05dc3fb70d,4,93,26,119,10,2012-03-09 17:42:13,2012-03-09 17:20:36
296b7a580b106ce07c7d5fc3018c9f05dc3fb70d...2589d5561191ac58f5c87efa796457c9936de73f,2,28,13,41,5,2012-03-09 22:31:03,2012-03-09 14:01:40
2589d5561191ac58f5c87efa796457c9936de73f...8c02f9b7c844909cf5977d065b793c99eb0f9c45,4,46,7,53,8,2012-03-09 22:57:03,2012-03-09 14:35:50
8c02f9b7c844909cf5977d065b793c99eb0f9c45...ff4a9d381d2c77d1e074f9886c71003d5b7db25f,43,129,129,258,65,2012-03-09 23:14:14,2012-03-09 23:11:11
ff4a9d381d2c77d1e074f9886c71003d5b7db25f...36761b2055040f670085eec070a74184762f3fd7,3,5,2,7,3,2012-03-09 23:22:42,2012-03-08 20:25:40
36761b2055040f670085eec070a74184762f3fd7...9b672bcaa2ea427fd84b647fceba97162d08540e,3,88,1,89,3,2012-03-10 14:43:16,2012-03-03 09:46:45
9b672bcaa2ea427fd84b647fceba97162d08540e...407ecc6b5f9db2b0008530651f1b9b773de3a2b3,1,1,1,2,1,2012-03-12 00:37:34,2012-03-12 00:37:32
407ecc6b5f9db2b0008530651f1b9b773de3a2b3...79cbe1fdbbf551438e8395b5e443d12d58338511,5,120,106,226,55,2012-03-12 01:20:52,2012-03-12 00:57:15
79cbe1fdbbf551438e8395b5e443d12d58338511...4472f7bbc3f50c13ee36df2806781c4b09f43c0b,1,13,78,91,5,2012-03-12 01:23:34,2012-03-12 01:23:34
4472f7bbc3f50c13ee36df2806781c4b09f43c0b...f8ce384446d38598df53fe18d004baabb65591ff,2,2,2,4,2,2012-03-12 01:27:55,2012-03-11 00:48:08
f8ce384446d38598df53fe18d004baabb65591ff...c450ac343f757d95516a42c686ffa7d9f86db099,1,1,1,2,1,2012-03-12 14:04:53,2012-03-12 08:27:44
c450ac343f757d95516a42c686ffa7d9f86db099...a10cfba766e2d219b311f12d7854ff448d0d3490,2,66,1,67,3,2012-03-12 17:27:11,2012-03-12 17:18:29
a10cfba766e2d219b311f12d7854ff448d0d3490...677c2c112c8f92910b85e14575c9c941799f5916,2,56,2,58,3,2012-03-12 19:46:56,2012-03-12 18:59:43
677c2c112c8f92910b85e14575c9c941799f5916...531eba18a67805f7a95d20f7f9e684d83c5091b6,1,1,1,2,2,2012-03-12 22:22:48,2012-03-12 22:13:10
531eba18a67805f7a95d20f7f9e684d83c5091b6...9701f1c4b27ac41928c22f076b185d0517bb0d9d,1,2,0,2,2,2012-03-12 22:29:20,2012-03-08 18:56:59
9701f1c4b27ac41928c22f076b185d0517bb0d9d...bcb0cc0b184c61313541002e504948ed21f59dad,234,27247,307,27554,269,2012-03-13 04:34:07,2012-03-13 04:10:40
9726a259bf9644e911a9c740fdf76d64baa413c6...b9bd2d3eb9aa57926dc76294a376ed95c76fc812,1,2,2,4,1,2012-03-15 17:33:33,2012-03-15 17:33:33
b9bd2d3eb9aa57926dc76294a376ed95c76fc812...90b785c09abfe07746e813f258b5654e1de86d9c,1,4,4,8,4,2012-03-16 14:51:33,2012-03-16 02:43:00
bcb0cc0b184c61313541002e504948ed21f59dad...109b16d4889a82afa80b044f0e73c704b75a4598,1,1,1,2,1,2012-03-13 18:58:49,2012-03-13 00:24:39
109b16d4889a82afa80b044f0e73c704b75a4598...4f63f9f327857a7ebb1021b55d9ed3bf7cf8d817,1,5,0,5,4,2012-03-13 18:58:50,2012-03-13 00:25:51
4f63f9f327857a7ebb1021b55d9ed3bf7cf8d817...659d449460d84c40fc5b3bf0e23575378d72d312,1,4,1,5,2,2012-03-13 18:58:50,2012-03-13 00:28:31
659d449460d84c40fc5b3bf0e23575378d72d312...b7ddd3018174b86c82f3e124e0c676c27cad045f,1,3,3,6,3,2012-03-13 18:58:51,2012-03-13 00:29:21
b7ddd3018174b86c82f3e124e0c676c27cad045f...6b5a34cdf30827a0e64c49008b4bcdb55738bc9b,1,1,2,3,1,2012-03-13 18:58:52,2012-03-13 00:58:45
6b5a34cdf30827a0e64c49008b4bcdb55738bc9b...f214758dd1ef74b7f9746ec7a859a9dc73887aa3,1,11,9,20,3,2012-03-13 18:58:52,2012-03-13 01:05:16
f214758dd1ef74b7f9746ec7a859a9dc73887aa3...f9da776b332fbb1b7443da3446de9127b98b3d94,1,3,0,3,1,2012-03-13 18:58:53,2012-03-13 18:53:49
f9da776b332fbb1b7443da3446de9127b98b3d94...884a209ccfd5bac74d891cdea50750cb6cd842a1,1,16,2,18,2,2012-03-13 18:58:54,2012-03-13 18:50:28
bcb0cc0b184c61313541002e504948ed21f59dad...e4fc2cbfd354d8ad74c465e508531d92de2b4d52,194,11153,4858,16011,2202,2012-03-13 04:46:36,2012-03-13 04:46:36
e4fc2cbfd354d8ad74c465e508531d92de2b4d52...4e85257c6ea1a802bc5eceb9645967cbb844a9cc,1,1,2,3,2,2012-03-13 04:50:31,2012-03-13 04:50:31
4e85257c6ea1a802bc5eceb9645967cbb844a9cc...c15e6905c43af4bf3ed77ed72b6bd90efa3bc9b4,1,6,0,6,1,2012-03-13 15:24:09,2012-01-30 02:33:08
c15e6905c43af4bf3ed77ed72b6bd90efa3bc9b4...943c396b86103a903af1933e4a5283c8edce2302,1,0,3,3,2,2012-03-13 16:16:48,2012-03-13 16:16:39
943c396b86103a903af1933e4a5283c8edce2302...1cecfee63484f5cd62236931f01fac1b41e582dc,3,2,556,558,3,2012-03-13 16:30:32,2012-03-09 14:35:39
1cecfee63484f5cd62236931f01fac1b41e582dc...1cdadb1e3b6108bb636213debacf2f93166fbf83,1,31,6,37,4,2012-03-13 16:35:42,2012-03-07 01:02:25
1cdadb1e3b6108bb636213debacf2f93166fbf83...8b79a31333dd9ae1fc745ac691f224beaf063ba0,1,2,0,2,1,2012-03-13 17:00:59,2012-03-13 16:45:01
8b79a31333dd9ae1fc745ac691f224beaf063ba0...10dc129a4b75ded392adbb483484949e653276ed,141,122,100,222,106,2012-03-13 20:02:02,2012-03-13 17:00:25
10dc129a4b75ded392adbb483484949e653276ed...f06abda6f58e517349d1b63a2cbf5a8d04a03505,7,68,14,82,10,2012-03-13 20:02:38,2012-03-13 16:12:53
90b785c09abfe07746e813f258b5654e1de86d9c...44527e602372839f0f9de1dd5168827e779dd2ef,3,58,9,67,8,2012-03-17 15:22:39,2012-03-17 14:50:43
44527e602372839f0f9de1dd5168827e779dd2ef...03077db45de5590a1f5651ec86abc70e4fd8a1d4,1,46,0,46,1,2012-03-17 15:50:47,2012-03-17 15:50:47
03077db45de5590a1f5651ec86abc70e4fd8a1d4...d980620010a2bc2dc1972ada80afdca53ea1037b,1,3,0,3,1,2012-03-17 18:07:35,2012-03-17 18:00:05
d980620010a2bc2dc1972ada80afdca53ea1037b...851b3970e721805644377a2b6c6038cdd6b33f8a,1,1,1,2,1,2012-03-17 18:07:35,2012-03-17 18:07:28
851b3970e721805644377a2b6c6038cdd6b33f8a...ea44d3031d101b42b427e2b33355e27ec616e731,1,4,1,5,1,2012-03-22 14:52:12,2012-03-22 14:52:12
ea44d3031d101b42b427e2b33355e27ec616e731...d1255914df46ac367d289614464cc249c3a4bb6c,2,45,13,58,8,2012-03-22 23:18:11,2012-03-22 23:06:35
d1255914df46ac367d289614464cc249c3a4bb6c...67f1778065b4f1d96a59f5290c57061c1808feb8,126,506,279,785,203,2012-03-22 23:38:58,2012-03-22 23:38:58
67f1778065b4f1d96a59f5290c57061c1808feb8...a7cd76bb3b3c0696d61c600d9b91e5e97cbb6367,5,0,285,285,5,2012-03-22 23:43:28,2012-03-22 23:43:28
a7cd76bb3b3c0696d61c600d9b91e5e97cbb6367...d227084339315e42623434027a68d96cdf1fff23,5,21,4,25,6,2012-03-22 23:44:04,2012-03-22 23:44:04
d227084339315e42623434027a68d96cdf1fff23...0dcc43316fa2b90572affb1091f8e6246340fd9e,2,52,26,78,24,2012-03-23 00:09:22,2012-03-20 07:21:38
73c874698b4a02bb58476e9c0f89a6acd7c963de...bda08bfa044705c1563080cd83cf4c1e5cbda899,1,2,2,4,1,2012-03-13 21:03:51,2012-03-13 21:03:51
bda08bfa044705c1563080cd83cf4c1e5cbda899...35043ad8ac77f568755fff6c8aea4f41f531330d,1,4,3,7,3,2012-03-14 00:40:29,2012-03-13 23:04:17
35043ad8ac77f568755fff6c8aea4f41f531330d...d2fba2bf35e3d55c55590116e7b7fd6951bb1fdb,1,1,1,2,1,2012-03-14 18:00:52,2012-03-14 02:21:14
d2fba2bf35e3d55c55590116e7b7fd6951bb1fdb...96e3be3aa30069f61636840accbb6a60934b3f4c,1,1,1,2,1,2012-03-15 20:28:01,2012-03-07 18:37:09
96e3be3aa30069f61636840accbb6a60934b3f4c...19fd5301bf45b7055d090b6132aef7c833f29248,3,56,6,62,10,2012-03-15 20:47:43,2012-03-05 17:53:15
19fd5301bf45b7055d090b6132aef7c833f29248...0113f5a72db8352c604a3fba4725f3e2d4a84345,1,40,0,40,1,2012-03-15 20:48:05,2012-03-05 18:28:34
0113f5a72db8352c604a3fba4725f3e2d4a84345...9a3565621011b66a27386cc5a4daca34502088c2,1,46,0,46,1,2012-03-15 20:48:06,2012-03-05 18:41:09
9a3565621011b66a27386cc5a4daca34502088c2...7fc835afe362ebd30a0dbec81d3360bd24525222,2,103,32,135,10,2012-03-15 20:56:30,2011-07-11 22:30:24
7fc835afe362ebd30a0dbec81d3360bd24525222...702b46c80dfe3ec8f67c15f802db9d2d86a40a6c,1,0,2,2,1,2012-03-15 21:53:17,2012-03-15 21:53:17
702b46c80dfe3ec8f67c15f802db9d2d86a40a6c...1a9799864481c789950388b3c344110ff923e30a,1,3,3,6,2,2012-03-15 22:10:32,2012-03-15 22:10:32
1a9799864481c789950388b3c344110ff923e30a...dc752327bbd700e686e14169c7d635960eafe456,2,35,12,47,6,2012-03-15 23:12:19,2012-03-15 22:17:25
dc752327bbd700e686e14169c7d635960eafe456...f9aa01de326477be6a77ae258f080c57171a55fa,1,2,1,3,1,2012-03-15 23:20:10,2012-03-15 23:15:41
f9aa01de326477be6a77ae258f080c57171a55fa...78dc13fbf97e2e3003e6f3baacdd5ff60e8de3f7,2,16,5,21,3,2012-03-15 23:20:10,2012-03-15 23:18:50
78dc13fbf97e2e3003e6f3baacdd5ff60e8de3f7...761a82bc9a35f6bac1308115eca1961ffcaec1d8,1,9,3,12,3,2012-03-15 23:25:42,2012-03-15 23:25:41
761a82bc9a35f6bac1308115eca1961ffcaec1d8...928ea564d16da47e615ddac627e0b4d4a40d8196,2,9,2,11,7,2012-03-16 00:01:29,2012-03-15 23:58:13
928ea564d16da47e615ddac627e0b4d4a40d8196...c7b8073afc018901a106564aaf6819b170a9538a,4,27,7,34,15,2012-03-16 00:07:11,2012-03-13 23:04:00
c7b8073afc018901a106564aaf6819b170a9538a...bea2e15864fb41c161dd47a0184ae07e83b7ce76,1,1,1,2,1,2012-03-16 00:12:37,2012-03-14 01:31:04
bea2e15864fb41c161dd47a0184ae07e83b7ce76...95fd517431c46e2083dd16d031eb79371b67da79,1,3,3,6,4,2012-03-16 00:12:45,2012-03-14 15:34:44
95fd517431c46e2083dd16d031eb79371b67da79...11d8823791644a307a7c521b08d1e213e7836885,3,87,0,87,4,2012-03-16 00:15:18,2012-03-16 00:15:18
11d8823791644a307a7c521b08d1e213e7836885...7cb0f5f84a2541578df8e62fcbe098108b0b8f43,2,5,11,16,4,2012-03-16 00:15:49,2012-03-14 04:04:24
7cb0f5f84a2541578df8e62fcbe098108b0b8f43...0fb4fb4797e5aaf91dddebc789cb4a9beb543866,1,8,0,8,2,2012-03-16 00:23:39,2012-03-16 00:09:47
0fb4fb4797e5aaf91dddebc789cb4a9beb543866...6628a3b6eafda57b99d4db04ddeff6f3205e872c,1,4,4,8,4,2012-03-16 14:42:26,2012-03-16 02:43:00
6628a3b6eafda57b99d4db04ddeff6f3205e872c...534264d2091e9662e73bc9bdab18b386831428f5,1,7,5,12,2,2012-03-16 15:01:18,2012-03-15 14:44:00
0dcc43316fa2b90572affb1091f8e6246340fd9e...76f31faa3b80c554842e6865bceae18e4f258268,6,16,13,29,9,2012-03-23 00:31:15,2012-03-16 15:13:41
76f31faa3b80c554842e6865bceae18e4f258268...d497bf845b9d0a029ae51686bfe0dc2b3fa2070a,5,12,12,24,12,2012-03-23 00:31:23,2012-03-16 15:19:18
d497bf845b9d0a029ae51686bfe0dc2b3fa2070a...e513ffef7549a56a5af728e1f0c2c0c8f290518a,3,30,2,32,3,2012-03-23 15:01:22,2012-03-23 00:32:11
ec735cbce05bd5ec501ab395ae552ef8c5efb3f2...46376888cd2afb5d34bfdb08ba7f9d1b4c6b5d4a,6,16,13,29,9,2012-03-16 15:13:41,2012-03-16 15:13:41
46376888cd2afb5d34bfdb08ba7f9d1b4c6b5d4a...76a771b749cb3948da4159b710a3ff07c932d228,5,12,12,24,12,2012-03-16 15:19:26,2012-03-16 15:19:18
76a771b749cb3948da4159b710a3ff07c932d228...5abcdc967173a8019d6b0f76c1ddfa5d6e90e4a6,1,1,1,2,1,2012-03-16 23:01:53,2012-03-16 23:01:53
5abcdc967173a8019d6b0f76c1ddfa5d6e90e4a6...7bee98bae25acbfd2f22c5ef9ae0eb3bf65324fb,1,3,0,3,1,2012-03-17 18:11:03,2012-03-17 18:00:05
7bee98bae25acbfd2f22c5ef9ae0eb3bf65324fb...815169383ee94ebcdb4805c40eefdba521f410bd,1,1,1,2,1,2012-03-17 18:11:07,2012-03-17 18:07:28
815169383ee94ebcdb4805c40eefdba521f410bd...70e68893fe2fe911faf73c130b943eaf027c0b18,1,1,1,2,1,2012-03-17 19:57:24,2012-03-17 19:57:24
70e68893fe2fe911faf73c130b943eaf027c0b18...fb47a337ba20239973b41d17b894f29543596054,1,3,3,6,3,2012-03-19 13:24:46,2012-03-18 09:44:52
fb47a337ba20239973b41d17b894f29543596054...d8c4ecea0b03a4524eda172dfd7f08992c1538c8,1,14,9,23,2,2012-03-19 16:12:52,2012-03-19 16:12:49
d8c4ecea0b03a4524eda172dfd7f08992c1538c8...f61d4b7a87123244e249a08c026ab0f941ef5cde,1,5,1,6,2,2012-03-19 16:21:28,2012-03-18 10:20:41
f61d4b7a87123244e249a08c026ab0f941ef5cde...b6cb6ce0d329c7b359dea403139c8759d952ea16,2,6,3,9,4,2012-03-19 16:21:28,2012-03-19 16:08:25
b6cb6ce0d329c7b359dea403139c8759d952ea16...7418905aef0c0fcbd13227526adc34f1e699fe45,1,17,6,23,4,2012-03-19 16:21:29,2012-03-18 10:54:07
7418905aef0c0fcbd13227526adc34f1e699fe45...89653cb32fa943735b1dd300c727ec5133d6f1da,100,109,102,211,105,2012-03-19 16:59:57,2012-03-19 16:59:51
89653cb32fa943735b1dd300c727ec5133d6f1da...ab32e9e04346fe627e01b3b9a852f6c4663681f2,1,4,1,5,1,2012-03-19 18:55:41,2012-01-31 18:51:01
ab32e9e04346fe627e01b3b9a852f6c4663681f2...d927fbc9ab01b8120d71dda0519c2ed2e82b030a,4,426,15,441,16,2012-03-19 20:29:01,2012-03-10 15:30:06
d927fbc9ab01b8120d71dda0519c2ed2e82b030a...94d337eb0fbf78bda2af6938b4a65d3c94808caf,2,111,37,148,6,2012-03-19 21:22:36,2012-03-11 13:19:02
94d337eb0fbf78bda2af6938b4a65d3c94808caf...dce86828273ee2bca41fe2bf41e62ba044544177,2,26,25,51,21,2012-03-19 21:28:39,2012-03-19 20:34:12
dce86828273ee2bca41fe2bf41e62ba044544177...891f9defeb9713d8da9428195ad594a6d3627400,1,0,1,1,1,2012-03-20 01:58:58,2011-12-02 01:17:19
891f9defeb9713d8da9428195ad594a6d3627400...18240193ba421695d984c3d73e88de7e1b324e0a,2,7,0,7,5,2012-03-20 02:00:16,2011-12-18 14:55:40
18240193ba421695d984c3d73e88de7e1b324e0a...415bff26fe5744001f185001fc49f9369ab76227,2,14,0,14,2,2012-03-20 11:27:59,2012-03-20 01:44:22
415bff26fe5744001f185001fc49f9369ab76227...253ec6a63dddbf13bea391a765fceada03a94d0f,1,6,11,17,3,2012-03-20 16:59:21,2012-03-20 15:39:49
253ec6a63dddbf13bea391a765fceada03a94d0f...8517089b3e1eb7cd3cd1a77666c1de756fd752a3,1,8,78,86,15,2012-03-20 22:37:06,2012-03-20 22:04:18
8517089b3e1eb7cd3cd1a77666c1de756fd752a3...06a058d731f387883bba6ba70d682f13fa6b0ce5,3,100,42,142,26,2012-03-20 22:37:06,2012-03-20 22:14:40
06a058d731f387883bba6ba70d682f13fa6b0ce5...7817f4832271efc51e3d6615d1d2aa8cdb781fa4,1,2,2,4,2,2012-03-21 00:46:08,2012-03-21 00:14:44
7817f4832271efc51e3d6615d1d2aa8cdb781fa4...f2ebf2469b5dbbb8d83eb57ed1fe3db602d9eb59,1,91,73,164,3,2012-03-21 00:59:33,2012-03-20 16:21:32
f2ebf2469b5dbbb8d83eb57ed1fe3db602d9eb59...4b1d49256193dd47a9f324a128c2a944bca72398,2,23,53,76,2,2012-03-21 00:59:40,2012-03-20 17:07:08
4b1d49256193dd47a9f324a128c2a944bca72398...81cd3a3cd6204adbf645bd0538f794c1414511ed,1,2,2,4,2,2012-03-21 02:42:34,2012-03-21 02:42:34
81cd3a3cd6204adbf645bd0538f794c1414511ed...c781f17742170f2e127f9ee6652c56b406c30586,1,25,4,29,1,2012-03-21 02:46:36,2012-03-21 02:46:36
c781f17742170f2e127f9ee6652c56b406c30586...d2389f8fab22e2ce187551addde3b18730030af5,2,26,17,43,13,2012-03-21 02:48:07,2012-03-21 02:48:07
d2389f8fab22e2ce187551addde3b18730030af5...feaa8a41c7533c254923ea7333457234ed44f8f9,3,56,2,58,6,2012-03-21 07:05:25,2012-03-21 07:05:25
feaa8a41c7533c254923ea7333457234ed44f8f9...ef046bf4f64161c6d0f4c4920ab62895789d576c,1,4,4,8,4,2012-03-22 22:35:22,2012-03-22 18:41:46
ef046bf4f64161c6d0f4c4920ab62895789d576c...e1199fa335e0cdbe11c8d2d7480409ce741d4406,1,1,1,2,1,2012-03-22 23:20:46,2012-03-22 02:50:58
e1199fa335e0cdbe11c8d2d7480409ce741d4406...249c3c165ab3b93e1bd0a05668d81b289b8d4ccf,12,62,62,124,57,2012-03-23 00:02:59,2012-03-21 16:47:16
249c3c165ab3b93e1bd0a05668d81b289b8d4ccf...2cf5f040a5818f7c1b37904f1cf4e73f1f3aa9f4,1,11,0,11,1,2012-03-23 16:09:50,2012-03-23 04:04:10
2cf5f040a5818f7c1b37904f1cf4e73f1f3aa9f4...8727e5f2becfa538d0f2f5f48172fd0d1c902546,1,53,0,53,1,2012-03-23 16:09:50,2012-03-23 06:10:48
8727e5f2becfa538d0f2f5f48172fd0d1c902546...75face6139b6adebbc6b344897eeddf99b725495,1,1,1,2,1,2012-03-23 16:11:13,2012-03-23 06:16:49
75face6139b6adebbc6b344897eeddf99b725495...4515987058427d1c55dd8712f6825b9c862367b0,1,1,1,2,1,2012-03-23 16:24:10,2012-03-23 09:21:53
4515987058427d1c55dd8712f6825b9c862367b0...83aae35b8ee14ba1e1517d5bda3eee2a92add9b5,1,2,2,4,2,2012-03-25 22:20:17,2012-03-24 16:25:23
83aae35b8ee14ba1e1517d5bda3eee2a92add9b5...0dd8e0167dfd4dbc812cf04035cc698087e84020,1,1,1,2,1,2012-03-25 22:25:45,2012-03-24 21:32:32
0dd8e0167dfd4dbc812cf04035cc698087e84020...e7792e5d46dc3c1e25915266d671070c945f1968,1,86,0,86,1,2012-03-26 12:03:51,2012-03-25 05:28:39
e7792e5d46dc3c1e25915266d671070c945f1968...ab518ae50e480b5ffe01bdaaabd8c652200d1d55,1,7,2,9,2,2012-03-26 16:21:55,2012-03-23 18:24:06
ab518ae50e480b5ffe01bdaaabd8c652200d1d55...aad12d0b265c9b06ae029d6ee168849260a91dd6,8,657,429,1086,78,2012-03-26 22:21:25,2012-03-26 22:21:25
aad12d0b265c9b06ae029d6ee168849260a91dd6...698e795a5ffb617c5a3e3e79de7dfdd0ce637695,2,12,7,19,5,2012-03-27 02:06:58,2012-03-27 02:05:32
698e795a5ffb617c5a3e3e79de7dfdd0ce637695...5e8c2b0768f32051457cb6cb7e068722e4348fa4,1,3,9,12,1,2012-03-27 18:37:54,2012-03-27 18:37:54
5e8c2b0768f32051457cb6cb7e068722e4348fa4...00224771e32e4d051e5ea33b7e854f0031359912,1,4,25,29,1,2012-03-27 18:40:45,2012-03-27 18:40:45
00224771e32e4d051e5ea33b7e854f0031359912...f41901cdf6e6236de3f588051b81340e9c1dd61f,5,96,1,97,6,2012-03-27 20:54:49,2012-03-27 19:41:42
f41901cdf6e6236de3f588051b81340e9c1dd61f...e7065eaa93466c090d3f3d13f67ed64aab5363a9,1,2,2,4,2,2012-03-28 00:34:55,2012-03-28 00:34:55
e7065eaa93466c090d3f3d13f67ed64aab5363a9...228ddddc1cee6876e951a5365b3d3de2a00ef9ef,1,2,1,3,2,2012-03-28 00:35:33,2012-03-28 00:35:33
228ddddc1cee6876e951a5365b3d3de2a00ef9ef...b187e96ec91b1aaf1ed4d7eed870cc5ba2e3259e,2,13,5,18,7,2012-03-28 00:39:14,2012-03-28 00:39:14
b187e96ec91b1aaf1ed4d7eed870cc5ba2e3259e...a33d1c959a449115883b42753f5140541561ba2b,1,66,0,66,1,2012-03-28 00:49:10,2012-03-28 00:49:10
a33d1c959a449115883b42753f5140541561ba2b...208b2307440f95946b232c6a23e2547b7dd94e89,5,22,7,29,11,2012-03-28 01:00:59,2012-03-28 01:00:59
208b2307440f95946b232c6a23e2547b7dd94e89...eb1ff034183b5178b26bb0d302e60e85b9dc3e20,1,2,0,2,1,2012-03-28 11:04:56,2012-03-12 12:17:46
eb1ff034183b5178b26bb0d302e60e85b9dc3e20...48bbdde66ba82c4c1274fc54385fa598352cdc15,1,0,1,1,1,2012-03-28 15:42:40,2012-03-28 04:40:03
48bbdde66ba82c4c1274fc54385fa598352cdc15...67fc1dafd0010f4c0a23db2aa472d0dc2a8f3492,3,30,1,31,7,2012-03-28 20:57:15,2012-03-28 04:38:52
67fc1dafd0010f4c0a23db2aa472d0dc2a8f3492...285d8c658914d43cb39bacbde1ae62d8f6be25cf,1,1,0,1,1,2012-03-28 23:31:31,2012-03-28 23:31:12
285d8c658914d43cb39bacbde1ae62d8f6be25cf...973bbecf1a6a75cae0fcbe7a152d2e0640ebc60b,2,36,21,57,10,2012-03-28 23:36:45,2012-03-21 11:33:49
973bbecf1a6a75cae0fcbe7a152d2e0640ebc60b...b031671138a6b997e934cfafa17f03247c036c71,2,3,3,6,3,2012-03-28 23:36:46,2012-03-28 23:27:57
b031671138a6b997e934cfafa17f03247c036c71...cda3b6ff52e78b61c25f1e04ff9f6f5f5046dec0,170,2168,3064,5232,367,2012-03-29 02:36:44,2012-03-29 02:36:44
cda3b6ff52e78b61c25f1e04ff9f6f5f5046dec0...8a15147bc53849417f8737dd873877d497867c9f,1,25,4,29,1,2012-03-29 02:41:29,2012-03-29 02:40:54
8a15147bc53849417f8737dd873877d497867c9f...4b64542fe09477fc5c70e974eb1a78cdce755eb7,199,6023,2240,8263,1361,2012-03-29 02:51:38,2012-03-29 02:51:38
4b64542fe09477fc5c70e974eb1a78cdce755eb7...af90faf198ff92a0b42e6f7bac033f0cb7f47aac,1,1,2,3,2,2012-03-29 02:54:01,2012-03-29 02:54:01
af90faf198ff92a0b42e6f7bac033f0cb7f47aac...b521ff3b4f8e79c5e28a1f4915d4203d8bcb0ab7,1,2,0,2,1,2012-03-29 03:12:38,2012-03-28 04:12:07
b521ff3b4f8e79c5e28a1f4915d4203d8bcb0ab7...238e12af221cfefdfa560ac0e6e80b1d266f2870,1,1,0,1,1,2012-03-29 03:13:23,2012-03-28 08:06:10
238e12af221cfefdfa560ac0e6e80b1d266f2870...26b6da134ff219a3ff14b0d540d19a911713856f,2,2,2,4,2,2012-03-29 03:13:28,2012-03-28 08:13:26
26b6da134ff219a3ff14b0d540d19a911713856f...44eb279ef815cbb9bbeaa3bd6bd7fd7d56dca2da,2,56,50,106,32,2012-03-29 12:22:37,2012-03-21 15:35:47
44eb279ef815cbb9bbeaa3bd6bd7fd7d56dca2da...5e7cb68be98920a9fca2fa07201ebb2414300b8d,1,0,108,108,1,2012-03-29 15:11:37,2012-03-29 14:34:19
5e7cb68be98920a9fca2fa07201ebb2414300b8d...daa6b95b08e41357f80821ff3e901b3620204236,1,0,0,0,0,2012-03-29 15:12:26,2012-03-29 15:12:23
daa6b95b08e41357f80821ff3e901b3620204236...d7c96cf289b643373d033decaff5a5534b7f0dc6,2,78,7,85,8,2012-03-29 15:17:15,2012-03-28 09:20:37
d7c96cf289b643373d033decaff5a5534b7f0dc6...11770bf5e2371064f87d55afdb5e5e405bf5b05a,1,0,0,0,0,2012-03-29 15:25:37,2012-03-29 15:25:36
11770bf5e2371064f87d55afdb5e5e405bf5b05a...6aa755070a5d89f5adeb6d53e6eea6fbf49a6bb7,1,2,2,4,4,2012-03-29 15:41:51,2012-03-29 15:41:04
6aa755070a5d89f5adeb6d53e6eea6fbf49a6bb7...304f1fcf86f38552d483eb69f6ccef331e691753,2,3,2,5,2,2012-03-29 20:15:24,2012-03-29 20:15:24
304f1fcf86f38552d483eb69f6ccef331e691753...6ebe9e0c1d28e82c5b49a9c8bbd166f6f296fd56,2,38,21,59,6,2012-03-29 23:04:48,2012-03-29 17:05:14
6ebe9e0c1d28e82c5b49a9c8bbd166f6f296fd56...7abbda8ba2ecabd93b11388bc593ad94da2546bc,3,37,1,38,5,2012-03-29 23:04:48,2012-03-29 23:01:27
dbd0e2b386f39e95d98c8875c86b796fef426f18...a7dce4785434ebb6eb259374174d9e5985c0baaa,1,2,2,4,1,2012-03-23 18:17:08,2012-03-23 18:17:08
a7dce4785434ebb6eb259374174d9e5985c0baaa...066789a6e33eccde3dcde420d58cb497f8f8b55d,1,7,0,7,1,2012-03-24 08:39:39,2012-03-24 08:39:39
066789a6e33eccde3dcde420d58cb497f8f8b55d...1e577f347b0b14f8c258c86bbcea674ded205cbe,4,1,10,11,1,2012-03-31 01:21:50,2012-03-31 01:21:50
1e577f347b0b14f8c258c86bbcea674ded205cbe...0965d2d9f61f12ea807e81024fc37fe8d29a5a27,1,1,1,2,1,2012-03-31 23:44:54,2012-03-14 01:31:04
0965d2d9f61f12ea807e81024fc37fe8d29a5a27...ffee8739417a5db1d4e32f98fd28fea4c9bc8f42,2,4,1,5,2,2012-04-02 21:44:38,2012-04-02 21:44:36
ffee8739417a5db1d4e32f98fd28fea4c9bc8f42...052aaa4c4dbb52c9430b609cdfe81fc942a7df64,2,70,36,106,20,2012-04-05 23:03:11,2012-04-05 23:03:11
052aaa4c4dbb52c9430b609cdfe81fc942a7df64...f178f2ae3fc6cd24221e8b9548902e18c63ab8e4,13,292,41,333,48,2012-04-06 00:10:39,2012-04-06 00:10:39
f178f2ae3fc6cd24221e8b9548902e18c63ab8e4...40b7302af84be97993c0b17432b331466e99f67c,2,55,2,57,4,2012-04-06 01:13:56,2012-04-06 00:54:33
40b7302af84be97993c0b17432b331466e99f67c...1042a8d887aef494435ad1e9da3c33b602f246be,1,3,1,4,2,2012-04-06 01:14:07,2012-04-06 01:02:23
1042a8d887aef494435ad1e9da3c33b602f246be...0b57fee3f8598e4d16af5ce89714e460dd042700,1,1,1,2,1,2012-04-06 01:18:48,2012-04-06 01:15:10
0b57fee3f8598e4d16af5ce89714e460dd042700...37ac5e52bfaa79be477b4ac123ed05980defe599,258,2010,2758,4768,417,2012-04-06 21:42:19,2012-04-06 21:42:19
37ac5e52bfaa79be477b4ac123ed05980defe599...331cd7c2519eb70d949f105fc5797f49b3dc8064,1,3,3,6,1,2012-04-06 23:15:24,2012-04-02 21:36:23
331cd7c2519eb70d949f105fc5797f49b3dc8064...cf75619bc3fe22e4af8470d6a3ebc2a703fde080,1,515,47,562,19,2012-04-06 23:15:33,2012-04-02 22:12:23
cf75619bc3fe22e4af8470d6a3ebc2a703fde080...c9f17305e611c2b304bd646093ef498a489ee504,2,3,3,6,3,2012-04-06 23:15:43,2012-04-02 22:14:52
c9f17305e611c2b304bd646093ef498a489ee504...13304194466eca3e85cc5e7cc16f102c2759eeb7,2,342,3,345,7,2012-04-06 23:15:51,2012-04-04 16:06:00
13304194466eca3e85cc5e7cc16f102c2759eeb7...ba055115e08b5ec46fc4350b6c3e95695a073b6f,1,6,2,8,3,2012-04-06 23:15:55,2012-04-04 16:06:33
ba055115e08b5ec46fc4350b6c3e95695a073b6f...e81a5e9c9cded5a22e87dfab43da0901684ce71c,1,0,7,7,1,2012-04-07 23:20:42,2012-04-07 23:20:42
e81a5e9c9cded5a22e87dfab43da0901684ce71c...57d722011aa7b5d2b8bbe02f05c87f5a45efef0c,1,8,2,10,2,2012-04-07 23:29:37,2012-04-07 23:29:37
57d722011aa7b5d2b8bbe02f05c87f5a45efef0c...08e2e570a7dfb8f89b9731cb04dda5d63882be52,3,36,1,37,5,2012-04-07 23:37:44,2012-03-29 23:01:27
08e2e570a7dfb8f89b9731cb04dda5d63882be52...45b772d8cb3fb2c3a4a07f30056879bc054ee627,1,3,0,3,1,2012-04-07 23:53:18,2012-04-07 23:53:18
7abbda8ba2ecabd93b11388bc593ad94da2546bc...0f0557d78dfa3d4f92daf4558570384ce73b0953,1,1,1,2,1,2012-03-30 12:52:38,2012-03-30 12:52:24
0f0557d78dfa3d4f92daf4558570384ce73b0953...b82b4f2993b5feaa51ce8edce60d945a34b88d26,2,19,20,39,13,2012-03-30 12:52:38,2012-03-30 12:49:40
b82b4f2993b5feaa51ce8edce60d945a34b88d26...6986d9316c7701277c286ddc1f1896216fd612ce,1,2,6,8,3,2012-03-30 12:52:38,2012-03-30 12:32:38
6986d9316c7701277c286ddc1f1896216fd612ce...8c97ad4c30e8e3f97c90dbc964478614db1fcd94,1,1,1,2,1,2012-03-30 12:52:38,2012-03-30 12:41:43
8c97ad4c30e8e3f97c90dbc964478614db1fcd94...db0a1dc7d9a7e85fe01f97f6348559a70c331359,1,0,7,7,1,2012-03-30 12:52:39,2012-03-30 12:42:23
db0a1dc7d9a7e85fe01f97f6348559a70c331359...17524432ff50c7e2ba53aa71b61c2f7409d5e02a,3,6,6,12,6,2012-03-30 14:07:05,2012-03-27 23:56:17
17524432ff50c7e2ba53aa71b61c2f7409d5e02a...6aa7f6f73274c8df52a20d823bd28fc928a46a23,44,902,442,1344,168,2012-03-30 17:25:07,2012-03-30 17:25:07
7abbda8ba2ecabd93b11388bc593ad94da2546bc...9a70d99980c7b22ec71e8fa15c2fbddfcc5b314e,98,100,100,200,100,2012-03-30 03:20:23,2012-03-30 03:17:25
9a70d99980c7b22ec71e8fa15c2fbddfcc5b314e...5cda2542fdb086f9fe5de889bea435a65e377dea,3,51,2,53,3,2012-03-30 03:20:23,2012-03-29 23:03:17
45b772d8cb3fb2c3a4a07f30056879bc054ee627...c75f71dd721d04e03204ffcc290bb3a370275cce,2,56,3,59,4,2012-04-09 16:03:00,2012-04-09 15:39:13
c75f71dd721d04e03204ffcc290bb3a370275cce...f160a45b254e591eb33716311c92be533c6d86c4,3,26,3,29,3,2012-04-09 16:03:00,2012-04-07 23:59:54
69ae75c66c6be5acaffd721b5761d798820d127c...8d3278b9620609c6c8970a456d9fc416989702d5,1,2,2,4,1,2012-03-30 18:54:39,2012-03-30 18:54:39
8d3278b9620609c6c8970a456d9fc416989702d5...32b2964eed176a803e047c75e8492772bad16c22,1,5,61,66,11,2012-03-30 19:24:01,2012-03-26 12:45:23
32b2964eed176a803e047c75e8492772bad16c22...f86359cc3fa689a991c1c102423bd349901cb61a,1,6,5,11,3,2012-03-30 19:24:01,2012-03-26 12:55:30
f86359cc3fa689a991c1c102423bd349901cb61a...9eacf93928f3357806e972c3ea79e7694f0cd7eb,1,10,11,21,8,2012-03-30 19:24:01,2012-03-26 13:55:08
9eacf93928f3357806e972c3ea79e7694f0cd7eb...1a49df5fa94364ea133ef719b33263f90d113757,1,3,3,6,3,2012-03-30 19:24:01,2012-03-26 13:57:28
1a49df5fa94364ea133ef719b33263f90d113757...300596526647adc9da8db2615b3e70258de9e1bd,1,3,3,6,1,2012-03-30 19:24:01,2012-03-26 14:02:00
300596526647adc9da8db2615b3e70258de9e1bd...036d907df702c1db3a4da826dd04ea85f384d69d,1,11,10,21,9,2012-03-30 19:24:01,2012-03-26 14:04:06
036d907df702c1db3a4da826dd04ea85f384d69d...9d1fde751908795e7d0b61fc8057a3e4c1e55702,1,3,3,6,3,2012-03-30 19:24:01,2012-03-26 14:05:13
9d1fde751908795e7d0b61fc8057a3e4c1e55702...a58659cd4a6aa8a24b7f5f1062c15aa627b386e5,1,7,3,10,3,2012-03-30 19:24:01,2012-03-27 13:42:51
a58659cd4a6aa8a24b7f5f1062c15aa627b386e5...08032efed00bb798cb9e1b4aaa0b626fc87d78cc,3,178,0,178,4,2012-03-30 19:24:02,2012-03-28 00:21:56
08032efed00bb798cb9e1b4aaa0b626fc87d78cc...1e13a2d242b98dd5ea944598157f449c771f7048,1,15,82,97,16,2012-03-30 19:24:02,2012-03-29 01:04:35
1e13a2d242b98dd5ea944598157f449c771f7048...1ab95a536abf62f9d5177613a8f4201cfc0c5b2b,2,33,36,69,12,2012-03-30 19:24:02,2012-03-30 13:54:06
1ab95a536abf62f9d5177613a8f4201cfc0c5b2b...7c02b5a58d796293426c7dc7e473ecc66d68977f,1,11,23,34,8,2012-03-30 19:24:02,2012-03-30 14:00:39
7c02b5a58d796293426c7dc7e473ecc66d68977f...407181538b5193f6810bf06a2056a200265c0e93,1,24,30,54,2,2012-03-30 19:50:15,2012-03-30 19:50:15
407181538b5193f6810bf06a2056a200265c0e93...90ce5b3d41a01bfd5793d1d634318fe607fa533c,6,32,32,64,28,2012-03-30 19:59:24,2012-03-30 19:24:46
90ce5b3d41a01bfd5793d1d634318fe607fa533c...c26a0b5aab2e43c03a73b1d0c2d28283f3d1c7e1,1,2,2,4,1,2012-03-30 20:54:13,2012-03-30 20:54:13
c26a0b5aab2e43c03a73b1d0c2d28283f3d1c7e1...2726c22f0b84c08d7a4c3a2d9f63248675374089,1,0,2,2,1,2012-03-31 00:37:35,2012-03-31 00:36:58
2726c22f0b84c08d7a4c3a2d9f63248675374089...bc834c395b45c01681d6cf0668a6574e70d9342d,1,4,0,4,1,2012-03-31 20:37:51,2012-03-31 20:27:42
bc834c395b45c01681d6cf0668a6574e70d9342d...dee8c51547860c05d33b695b37daa06633a022b8,1,4,8,12,3,2012-03-31 21:23:48,2012-03-31 21:23:46
dee8c51547860c05d33b695b37daa06633a022b8...a4a04f932ed99a8195f6d44227b1e89f5b9ea381,1,11,1,12,1,2012-03-31 23:17:25,2012-03-31 23:15:17
a4a04f932ed99a8195f6d44227b1e89f5b9ea381...7bdeed203991d35a56e7448540e3b74387c65d0d,1,1,1,2,1,2012-03-31 23:50:02,2012-03-31 23:50:02
7bdeed203991d35a56e7448540e3b74387c65d0d...cc15299c32b4fc39c2eb2c08b0265e462f875544,7,283,95,378,14,2012-04-01 00:14:36,2012-03-28 17:26:10
cc15299c32b4fc39c2eb2c08b0265e462f875544...01d46f3a204edd56465b970e1c6ca79bcc15de2e,3,157,32,189,33,2012-04-02 20:48:10,2012-04-01 04:01:55
01d46f3a204edd56465b970e1c6ca79bcc15de2e...08109367e8a7ad88bfbddeaae766e067a640abfb,1,3,3,6,1,2012-04-02 21:39:46,2012-04-02 21:36:23
08109367e8a7ad88bfbddeaae766e067a640abfb...92c0c6953a03a0860e8ea1b9c1a18fbd7a4fc3c9,1,1,0,1,1,2012-04-02 21:53:05,2012-04-02 21:53:05
92c0c6953a03a0860e8ea1b9c1a18fbd7a4fc3c9...55e971e33da6233c35d8f48da7eba08444cb7cbd,1,515,47,562,19,2012-04-02 23:49:03,2012-04-02 22:12:23
55e971e33da6233c35d8f48da7eba08444cb7cbd...30994aad30c4f0ee5658f7b1da8a3c4d506af0c7,2,3,3,6,3,2012-04-02 23:49:03,2012-04-02 22:14:52
30994aad30c4f0ee5658f7b1da8a3c4d506af0c7...930fabe43f83343e7f1a41cbfa506cd08be6bfa5,1,7,1,8,1,2012-04-03 01:07:47,2012-04-03 01:07:31
930fabe43f83343e7f1a41cbfa506cd08be6bfa5...2728dcc95bfaf9a4a084159e6f615238700c2060,2,342,3,345,7,2012-04-04 16:14:21,2012-04-04 16:06:00
2728dcc95bfaf9a4a084159e6f615238700c2060...3e8857271bf237d9edc19b2b3e75466801dd0405,1,6,2,8,3,2012-04-04 16:14:30,2012-04-04 16:06:33
3e8857271bf237d9edc19b2b3e75466801dd0405...b6d6a54f8057d0adad13d4bcc11eb3f443079ddc,1,1,0,1,1,2012-04-05 23:30:33,2012-04-05 23:30:33
b6d6a54f8057d0adad13d4bcc11eb3f443079ddc...d73b257d6543606e23361a0cd8a41e09591f4312,1,30,30,60,28,2012-04-05 23:44:03,2012-04-02 02:55:09
d73b257d6543606e23361a0cd8a41e09591f4312...b9bfb1bc916c3fff2caba85c4ee24a8195e86ee6,1,2,1,3,1,2012-04-06 21:16:09,2012-04-06 21:16:09
b9bfb1bc916c3fff2caba85c4ee24a8195e86ee6...e28f77cbad1dea617aeda18513b61e6ecce8e294,2,121,4,125,3,2012-04-06 23:13:40,2012-04-06 18:41:59
e28f77cbad1dea617aeda18513b61e6ecce8e294...aab7cb7dfed198db2b39de5ef3a82ea655754084,1,8,8,16,8,2012-04-06 23:13:40,2012-04-06 19:20:01
aab7cb7dfed198db2b39de5ef3a82ea655754084...ca8dea83a9e4cdb958e123edc7ff8f0d13599b03,1,1,1,2,1,2012-04-06 23:13:40,2012-04-06 19:54:48
ca8dea83a9e4cdb958e123edc7ff8f0d13599b03...8752ceef13a3c6478fee54b089fbfea1e3d8313c,1,8,0,8,8,2012-04-06 23:13:40,2012-04-06 20:49:27
8752ceef13a3c6478fee54b089fbfea1e3d8313c...8652c11031cf89d042aa9f0b9c0f33e60ab18c97,3,3,3,6,3,2012-04-06 23:13:40,2012-04-06 20:50:34
8652c11031cf89d042aa9f0b9c0f33e60ab18c97...78eb174ea2d26ee3bea89f707b78441a8c73c098,2,31,8,39,6,2012-04-06 23:13:40,2012-04-06 21:33:58
78eb174ea2d26ee3bea89f707b78441a8c73c098...93eca95aece9804d22b012cc89487f4b0064a86d,1,0,1,1,1,2012-04-09 05:31:28,2012-04-09 05:31:28
93eca95aece9804d22b012cc89487f4b0064a86d...06ada03ed93d6f81caef24c6dade6e616fd843b1,2,56,3,59,4,2012-04-09 15:39:13,2012-04-09 15:39:13
06ada03ed93d6f81caef24c6dade6e616fd843b1...0db4dc0024eaa538bf4913d6bf256a18126de2ba,41,1250,795,2045,158,2012-04-10 21:32:47,2012-04-10 21:26:28
0db4dc0024eaa538bf4913d6bf256a18126de2ba...70a5b53e03bfb77597d7183c311bfe4b30d3ac78,1,1,0,1,1,2012-04-10 21:38:47,2012-04-10 21:36:17
70a5b53e03bfb77597d7183c311bfe4b30d3ac78...7b71fd0c68ae103d77dbc11fb7ac87218626e3fd,1,1,1,2,1,2012-04-10 21:39:29,2012-04-10 21:39:29
7b71fd0c68ae103d77dbc11fb7ac87218626e3fd...3ba9519fafbbb765875db1ec4a5656d37cd34199,1,1,1,2,1,2012-04-11 01:34:57,2012-04-11 01:22:42
3ba9519fafbbb765875db1ec4a5656d37cd34199...e0660740d9e3cc7487aab46866b7a87f35128b73,4,94,0,94,5,2012-04-11 01:35:01,2012-04-11 01:29:25
e0660740d9e3cc7487aab46866b7a87f35128b73...fdeeabba784f5581d630589fb9667bdab237b5fb,1,2,2,4,1,2012-04-11 18:16:11,2012-04-11 18:16:11
fdeeabba784f5581d630589fb9667bdab237b5fb...9b7a6c523821f02ee85616160c56f7b6ffeddf7d,1,1,1,2,1,2012-04-11 18:16:47,2012-04-11 18:16:47
9b7a6c523821f02ee85616160c56f7b6ffeddf7d...3ec84a11f8ce70bde3a480a80cbe0875f8ea08ae,2,13,5,18,4,2012-04-11 20:02:12,2012-04-11 20:02:12
3ec84a11f8ce70bde3a480a80cbe0875f8ea08ae...e9dcfd4bd280fe3e819b2c992f33dad22bb8a967,41,795,1250,2045,162,2012-04-11 22:59:38,2012-04-11 22:59:38
e9dcfd4bd280fe3e819b2c992f33dad22bb8a967...aa5961a445acbd2b533ef870eb19733be7b7ede5,1,2,2,4,2,2012-04-11 23:34:04,2012-04-10 18:01:34
aa5961a445acbd2b533ef870eb19733be7b7ede5...30e7fb7307011a3c8d2586d73817ec967a863647,1534,172834,57085,229919,9793,2012-04-11 23:34:05,2012-04-10 13:57:21
30e7fb7307011a3c8d2586d73817ec967a863647...0f9d201183396c423bcfc6027ac2ce883e28cec5,3,561,277,838,4,2012-04-11 23:34:05,2012-04-10 14:08:50
0f9d201183396c423bcfc6027ac2ce883e28cec5...3694b6914a68e655c51a3d3ba8f538231bf07d1e,3,544,277,821,4,2012-04-11 23:34:05,2012-04-10 14:04:49
3694b6914a68e655c51a3d3ba8f538231bf07d1e...2639566c6e625c7e5b0f2cb1ad2c58d0aeac2530,2,23,40,63,10,2012-04-11 23:34:05,2012-04-10 21:41:34
2639566c6e625c7e5b0f2cb1ad2c58d0aeac2530...6cbed959e6dc61991e50bb95b3a9b1f530a50c0d,2,266,244,510,46,2012-04-11 23:34:05,2012-04-10 22:47:52
6cbed959e6dc61991e50bb95b3a9b1f530a50c0d...916b5d1fffd9a87a85e3bbf4f9418685ce202878,2,22,193,215,7,2012-04-11 23:34:05,2012-04-10 23:05:10
916b5d1fffd9a87a85e3bbf4f9418685ce202878...1c88c3b3b56c6047180e116c5614dad2b13995f9,3,100,0,100,5,2012-04-11 23:34:05,2012-04-11 16:20:54
1c88c3b3b56c6047180e116c5614dad2b13995f9...04271a5e9394e6dadf6c5172bcfac1d5f086db8f,1,3,3,6,3,2012-04-12 01:26:52,2012-04-12 01:26:52
04271a5e9394e6dadf6c5172bcfac1d5f086db8f...5b43c63c88ae191ca3a4b1b3d1a57222593c7f9c,2,51,1,52,2,2012-04-12 15:17:42,2012-03-13 16:22:47
5b43c63c88ae191ca3a4b1b3d1a57222593c7f9c...16fca262be5a6769ec425ab9d97e330f9c46fce2,2,5,3,8,3,2012-04-12 17:15:32,2012-04-12 17:13:04
16fca262be5a6769ec425ab9d97e330f9c46fce2...1444801374bafb9a467a7ddeb214a9f92b311b80,2,22,24,46,6,2012-04-12 21:48:49,2012-03-15 02:26:35
1444801374bafb9a467a7ddeb214a9f92b311b80...46acb09ed83958e7f3f06b9548f73f245d503b9f,1,37,41,78,12,2012-04-13 01:32:01,2012-04-13 00:24:35
46acb09ed83958e7f3f06b9548f73f245d503b9f...b7b7b29f509c46e6d5854b1cd04c0ec757de6389,1,0,17,17,1,2012-04-13 12:46:35,2012-04-13 12:46:35
b7b7b29f509c46e6d5854b1cd04c0ec757de6389...93cefab1a3a40a5693217c9ce43380a1e1cfad4e,1,4,1,5,1,2012-04-13 23:53:51,2012-04-13 23:53:51
93cefab1a3a40a5693217c9ce43380a1e1cfad4e...7ee15457edbd634c85b69fb3b865c4e27b17b672,3,8,0,8,3,2012-04-14 21:17:38,2012-04-12 08:29:15
7ee15457edbd634c85b69fb3b865c4e27b17b672...c945eae9421c94590bd8736e903551fac8a0c885,2,3,1,4,4,2012-04-14 22:05:17,2012-04-14 21:51:03
c945eae9421c94590bd8736e903551fac8a0c885...f065c87bcf65c3ffa50980bba5562ed7159b86db,1,0,2,2,1,2012-04-15 13:52:56,2012-04-15 09:09:37
f065c87bcf65c3ffa50980bba5562ed7159b86db...0a83b78ba8e1a12066f0977351e4c0cae455f0e5,1,6,6,12,6,2012-04-16 14:31:02,2012-04-16 05:24:25
0a83b78ba8e1a12066f0977351e4c0cae455f0e5...48d52d85c3e26e91e6e8f084f89af0a7c3f3ec65,2,89,0,89,5,2012-04-16 16:00:38,2012-04-13 23:35:28
48d52d85c3e26e91e6e8f084f89af0a7c3f3ec65...21d26839762c52f20edcfcc245a0cfe1acb21196,1,27,29,56,7,2012-04-16 16:00:47,2012-04-16 15:57:41
21d26839762c52f20edcfcc245a0cfe1acb21196...0d1314233248cb9b236b98477d7b69b2bbf97c08,4,76,11,87,10,2012-04-16 16:00:47,2012-04-13 07:45:38
0d1314233248cb9b236b98477d7b69b2bbf97c08...0f95a93a2c1928c4524521c52cc4c88d48612fe4,1,0,1,1,1,2012-04-16 19:38:26,2012-04-16 18:37:32
0f95a93a2c1928c4524521c52cc4c88d48612fe4...59e6b143951d524be2f1e3e4eaa4d777fbf1e8e1,1,2,2,4,2,2012-04-16 20:27:54,2012-04-07 15:10:22
59e6b143951d524be2f1e3e4eaa4d777fbf1e8e1...b4626afb610b1dc8ae48e4b87b7ec39d8ed7134e,1,1,1,2,1,2012-04-16 20:28:02,2012-04-08 16:07:28
b4626afb610b1dc8ae48e4b87b7ec39d8ed7134e...540a441259713b14f78fd3d149db2a51102ba013,1,15,8,23,8,2012-04-16 21:06:52,2012-04-16 20:43:02
540a441259713b14f78fd3d149db2a51102ba013...70005be4ffdcfed0ac371873fa79a308ae4cc546,3,71,0,71,3,2012-04-16 21:36:18,2012-04-08 15:24:53
70005be4ffdcfed0ac371873fa79a308ae4cc546...5bc07cc90b4fb0a18704bc7b60e120b22fc78df7,1,7,1,8,1,2012-04-17 12:14:09,2012-04-09 05:46:55
5bc07cc90b4fb0a18704bc7b60e120b22fc78df7...7cd1690f3dab62fea1c06ab26ade985cb1c85740,1,14,4,18,3,2012-04-17 12:17:41,2012-04-16 21:52:44
7cd1690f3dab62fea1c06ab26ade985cb1c85740...718aa505c47eecf0ef2c28ec3a7c1f5d63a9d6d6,1,18,0,18,1,2012-04-17 15:10:42,2012-04-17 05:15:51
718aa505c47eecf0ef2c28ec3a7c1f5d63a9d6d6...86bd9b6e703abe1ed10f797e4a794bcfa2ffe8a3,1,29,27,56,13,2012-04-17 18:53:49,2012-04-17 18:17:54
86bd9b6e703abe1ed10f797e4a794bcfa2ffe8a3...9c3559f0adce15f400c6792270cde40c1b67c017,2,104,13,117,9,2012-04-17 18:53:50,2012-04-17 18:31:07
9c3559f0adce15f400c6792270cde40c1b67c017...c5d35aca3382c7b79dba473138e69ec2ba97b6a7,1,6,6,12,4,2012-04-17 18:53:50,2012-04-17 18:34:37
c5d35aca3382c7b79dba473138e69ec2ba97b6a7...327286dbcdd91b9a6c983cdf307e36ac36acf05d,1,3,5,8,3,2012-04-17 18:53:50,2012-04-17 18:35:11
327286dbcdd91b9a6c983cdf307e36ac36acf05d...e28eb6de30a2c63f421526b80cc574d84e10e8f9,1,19,12,31,7,2012-04-17 18:53:50,2012-04-17 18:44:54
e28eb6de30a2c63f421526b80cc574d84e10e8f9...e621250116ee8ef9f6280ed351776e6e2eac39be,1,0,0,0,0,2012-04-17 18:53:50,2012-04-17 18:49:31
163d3cdf142576462b187b68f1c8016d989b43ab...e8067cb68563e3f3ab760e3ce8d0aeb873198f36,1,2,2,4,1,2012-04-09 17:34:54,2012-04-09 17:34:54
e8067cb68563e3f3ab760e3ce8d0aeb873198f36...d0365fd21f0320c05679b3713238cce5815754ee,1,1,1,2,1,2012-04-11 01:22:42,2012-04-11 01:22:42
d0365fd21f0320c05679b3713238cce5815754ee...8b82abb95327bc8a199136e74a7e6c2bf2577f0b,4,94,0,94,5,2012-04-11 01:31:12,2012-04-11 01:29:25
8b82abb95327bc8a199136e74a7e6c2bf2577f0b...d03b80bc1219c673aec8906b60cce6be0ad85700,2,53,0,53,2,2012-04-14 21:12:36,2012-04-14 21:12:36
d03b80bc1219c673aec8906b60cce6be0ad85700...3f4261276e31e615b32a8bb7c07fc0c177fd3951,1,4,8,12,3,2012-04-16 12:16:48,2012-03-31 21:23:46
3f4261276e31e615b32a8bb7c07fc0c177fd3951...69ca83f7552babe11969d2735245bed3c347ab35,5,36,11,47,7,2012-04-16 15:27:16,2012-04-16 15:27:16
69ca83f7552babe11969d2735245bed3c347ab35...0c0f13eda46c5e7649b75ba7c0fbe1ec7ff27db6,2,8,2,10,3,2012-04-16 15:28:33,2012-02-02 23:37:59
0c0f13eda46c5e7649b75ba7c0fbe1ec7ff27db6...0f7472975801e63a2bfdb8c708597f05dba6a118,1,1,1,2,1,2012-04-16 15:28:45,2012-02-08 00:50:05
0f7472975801e63a2bfdb8c708597f05dba6a118...5d69bbfbdbb389b6828122181a55df778eab2328,3,39,4,43,4,2012-04-16 15:40:17,2011-10-03 10:31:01
e621250116ee8ef9f6280ed351776e6e2eac39be...80a55e9c83592b8c1552cdf08f0a5513c6d51ea5,1,6,11,17,4,2012-04-17 18:56:32,2012-04-07 02:23:16
80a55e9c83592b8c1552cdf08f0a5513c6d51ea5...7407be896ef4cacaa96b383cb24b692c47debf62,2,36,7,43,6,2012-04-17 18:56:32,2012-04-13 23:33:09
7407be896ef4cacaa96b383cb24b692c47debf62...ac1aaddc00103e7a2130d642fca90e0a5be18e16,2,24,18,42,7,2012-04-17 18:56:33,2012-04-13 23:34:48
ac1aaddc00103e7a2130d642fca90e0a5be18e16...88f94fa28c4bc7f8a0cd080943a8169098bb33b2,1,6,2,8,2,2012-04-17 19:00:58,2012-04-17 04:27:12
88f94fa28c4bc7f8a0cd080943a8169098bb33b2...91701c2db1055fcd7c79a5cacf7a0823d2bf1eb6,1,1,10,11,2,2012-04-17 19:00:58,2012-04-08 07:48:10
91701c2db1055fcd7c79a5cacf7a0823d2bf1eb6...35c0cd219d0810c9e5324cf7d48cd6724b4e767b,1,9,20,29,4,2012-04-17 19:00:58,2012-04-12 05:28:44
35c0cd219d0810c9e5324cf7d48cd6724b4e767b...e1dd57058571c23c3a863ca00176cc0a99f6097e,1,1,7,8,2,2012-04-17 19:00:58,2012-04-12 05:29:18
e1dd57058571c23c3a863ca00176cc0a99f6097e...db45b2ca02dc23278a477625a8698ce136eb8807,1,1,7,8,1,2012-04-17 19:00:58,2012-04-12 05:29:36
db45b2ca02dc23278a477625a8698ce136eb8807...a26bee8fa16bcbdaafdee516288c6f59a43376f5,15,93,38,131,46,2012-04-17 20:14:54,2012-04-12 23:03:47
a26bee8fa16bcbdaafdee516288c6f59a43376f5...963459d736d6594de641aff4d8767da113359457,11,879,3,882,20,2012-04-17 20:14:55,2012-04-06 23:26:18
963459d736d6594de641aff4d8767da113359457...10ce3d129d4e466842a03545fdfdfc011e0b9fba,3,67,1,68,7,2012-04-17 20:14:55,2012-04-13 23:27:23
10ce3d129d4e466842a03545fdfdfc011e0b9fba...45c1d4f96f48c30bd3036938fb922e050e76c2e0,2,23,1,24,4,2012-04-17 20:14:55,2012-04-10 21:59:21
45c1d4f96f48c30bd3036938fb922e050e76c2e0...d4ed2e61f7acf9359c6c5c74674677f8f0c0db77,1,7,0,7,3,2012-04-17 20:14:55,2012-04-12 15:16:30
5d69bbfbdbb389b6828122181a55df778eab2328...e5b787e84d264caa5b8e183b09725c5ee4fe334a,1,1,1,2,1,2012-04-18 19:15:09,2012-04-18 17:32:02
8673a4aa25c860bf819e2d2f67eafb538b7de378...8559a4ae0f035a5627a9a87dd4b5b7fbdcdef35a,1,1,1,2,1,2012-04-17 21:34:12,2012-04-17 20:50:09
8559a4ae0f035a5627a9a87dd4b5b7fbdcdef35a...079b81358bf464b621146a90eeee9cd5d6631c56,1,1,1,2,1,2012-04-17 22:30:22,2012-04-17 22:30:22
e5b787e84d264caa5b8e183b09725c5ee4fe334a...c9a231db0e59658be419d926b1dfa17b939ba158,1,1,1,2,1,2012-04-18 20:01:33,2012-04-18 02:24:28
c9a231db0e59658be419d926b1dfa17b939ba158...642945cc00cd6e9a4e75fed65089118c3e0e17dd,1,0,5,5,1,2012-04-20 14:16:17,2012-04-20 06:57:14
642945cc00cd6e9a4e75fed65089118c3e0e17dd...27dfb1d4c0387b9b9100b344d60cb75738fe6b78,1,0,4,4,1,2012-04-20 14:46:42,2012-04-20 14:46:36
27dfb1d4c0387b9b9100b344d60cb75738fe6b78...a64acd8baadaa78910bb3cb429602f7f7619a486,1,45,0,45,1,2012-04-23 13:58:48,2012-04-23 13:58:32
a64acd8baadaa78910bb3cb429602f7f7619a486...76de7c0c26e9fa8d40e9e9e0fc5980acf6ed2d2b,2,11,8,19,4,2012-04-27 14:58:38,2012-04-27 14:58:38
76de7c0c26e9fa8d40e9e9e0fc5980acf6ed2d2b...e221cd4a53160c87a1a021916c9a865d53783be2,14,287,16,303,32,2012-04-27 19:28:56,2012-04-27 19:28:56
e221cd4a53160c87a1a021916c9a865d53783be2...0b75eee364230a6e08f4e7ada0735af1d1a25bc4,2,3,1,4,3,2012-04-27 20:00:44,2012-04-27 20:00:44
0b75eee364230a6e08f4e7ada0735af1d1a25bc4...51e66ec4102c64704553c9b646f11454496593ee,1,1,1,2,1,2012-04-27 20:06:12,2012-04-27 20:06:12
51e66ec4102c64704553c9b646f11454496593ee...55e4d54927536e6f796de87c0ab266a74b9e1c81,2,53,14,67,13,2012-04-27 20:13:00,2012-04-27 20:13:00
55e4d54927536e6f796de87c0ab266a74b9e1c81...3546383cf0c9738019ecee88858b9f78c5202428,1,30,30,60,2,2012-04-28 21:36:47,2012-04-28 21:36:47
3546383cf0c9738019ecee88858b9f78c5202428...db844b152a92bcc02c20e62ea85958c0f3dfc532,1,5,10,15,5,2012-04-28 21:51:41,2012-03-20 15:39:49
ecca7525cc7081bda1e2b3b171729dfd315cf2d8...33c76f19de1a93f1d712334e6b09fc78ee8db702,1,1,1,2,1,2012-04-18 19:24:41,2012-04-18 19:24:41
079b81358bf464b621146a90eeee9cd5d6631c56...20143b359c78577861309302fb56e11ddfd7f2db,1,4,0,4,2,2012-04-18 13:21:51,2012-04-10 05:59:13
20143b359c78577861309302fb56e11ddfd7f2db...d2860a6c7dc3e99f94585a5748f3713b5f7634db,1,9,0,9,1,2012-04-18 13:21:56,2012-04-16 19:03:30
079b81358bf464b621146a90eeee9cd5d6631c56...37fd953378ecdfcbe8e3656e1827b17fdc4fd969,4,26,29,55,5,2012-04-17 22:45:48,2012-04-17 22:45:48
37fd953378ecdfcbe8e3656e1827b17fdc4fd969...d8b33dc14787213a47a0f10f37137ec476d92952,1,1,1,2,1,2012-04-17 22:52:57,2012-04-17 22:52:57
d8b33dc14787213a47a0f10f37137ec476d92952...c8bbd13ea8d692f9f28f69cbb7ff321d7b998126,225,952,648,1600,394,2012-04-18 16:36:40,2012-04-18 00:14:25
c8bbd13ea8d692f9f28f69cbb7ff321d7b998126...6ed5ef5fe0201b99967d391bda1b5da389ae138a,8,89,9,98,18,2012-04-18 16:36:44,2012-04-18 01:16:27
6ed5ef5fe0201b99967d391bda1b5da389ae138a...6bb9868271640770fe76274df1db8e450bd9c784,1,1,2,3,2,2012-04-18 16:36:44,2012-04-18 01:16:52
6bb9868271640770fe76274df1db8e450bd9c784...7b3fb22290c3b6acb497ca85cf2f1648d75c8154,1,1,1,2,1,2012-04-18 16:36:45,2012-04-18 02:24:28
7b3fb22290c3b6acb497ca85cf2f1648d75c8154...c2b47097c0b483552efc1947c6766fa1128600b6,3,48,2,50,3,2012-04-18 16:37:18,2012-04-18 00:17:44
db844b152a92bcc02c20e62ea85958c0f3dfc532...1ac05cc5ad6d464d7ae56953006e6aa2f0d599fb,135,779,543,1322,282,2012-04-30 20:09:31,2012-04-27 22:01:31
1ac05cc5ad6d464d7ae56953006e6aa2f0d599fb...35bcb1d6a96252a1711675dfc9615be835bc26b8,1,2,2,4,2,2012-04-30 20:09:31,2012-04-30 15:37:53
35bcb1d6a96252a1711675dfc9615be835bc26b8...e5ef103b05059d066abb6465b05772c90dfcf219,1,36,19,55,13,2012-04-30 20:09:31,2012-04-30 17:30:05
e5ef103b05059d066abb6465b05772c90dfcf219...a1d193963ddc80a27da5da01b59751e14e33d1d6,3,33,2,35,3,2012-04-30 20:09:50,2012-04-27 21:33:15
b12b2b83fcd3d37aacc66c7fdf93b1622c63f964...3d69bbfa87551191171e61be858b2bf20658d73e,4,61,18,79,22,2012-04-18 19:40:25,2012-04-18 13:56:14
3d69bbfa87551191171e61be858b2bf20658d73e...605927fbd9c2fbcd7d88a8f8159a9ca78417a6d0,1,1,1,2,1,2012-04-18 19:44:28,2012-04-18 19:41:08
605927fbd9c2fbcd7d88a8f8159a9ca78417a6d0...ecfe32e3a0a4f6b62063a2b56fbb23599cfb51f1,1,20,8,28,4,2012-04-18 19:50:52,2012-04-18 13:56:14
ecfe32e3a0a4f6b62063a2b56fbb23599cfb51f1...12f77440ef17d947c704bc4a6e98c0de89d7cd57,1,46,23,69,8,2012-04-18 19:51:16,2012-04-18 13:56:14
12f77440ef17d947c704bc4a6e98c0de89d7cd57...c56d1559fc45375283cc9a616abf73b2e453d77e,2,2,8,10,2,2012-04-18 19:55:36,2012-04-18 19:55:36
c56d1559fc45375283cc9a616abf73b2e453d77e...57148f54e10f57a15deb51713bbe70f5f126b4dc,1,4,4,8,3,2012-04-18 19:57:39,2012-04-18 19:37:54
57148f54e10f57a15deb51713bbe70f5f126b4dc...e67a0f80e0184e2884fdf5c1c44a9b4df601d325,1,1,1,2,1,2012-04-18 21:36:46,2012-04-18 21:23:20
e67a0f80e0184e2884fdf5c1c44a9b4df601d325...c21c51a6fce878a4625c30032e669660ce6cbcaf,1,8,0,8,1,2012-04-19 23:29:02,2012-04-19 23:28:54
c21c51a6fce878a4625c30032e669660ce6cbcaf...d91ef153e7e863b2e1ece6dff0bee7eac01c1e76,1,24,0,24,1,2012-04-20 14:17:41,2012-04-20 06:32:58
d91ef153e7e863b2e1ece6dff0bee7eac01c1e76...77c1cc048259ca5d0818888fe0428d90ddcc1201,1,1,1,2,1,2012-04-20 14:43:19,2012-04-20 14:42:57
77c1cc048259ca5d0818888fe0428d90ddcc1201...da56c72f59db646faf877e027a8a8c5c808d2ace,1,0,1,1,1,2012-04-21 03:30:24,2012-04-20 16:59:54
da56c72f59db646faf877e027a8a8c5c808d2ace...525253d50e0a1dbfe1a06c89d3a94e16bab2fcb8,1,12,4,16,5,2012-04-21 03:31:47,2012-04-21 03:06:00
525253d50e0a1dbfe1a06c89d3a94e16bab2fcb8...c0a9985da7a7d3f6ebc51805d6955d92b1bd6e78,1,80,0,80,2,2012-04-21 17:32:03,2012-04-21 17:32:03
c0a9985da7a7d3f6ebc51805d6955d92b1bd6e78...e16021340dd38895b8c7f310355e3a79881f45ed,1,1,1,2,1,2012-04-21 20:53:49,2012-04-21 20:53:49
e16021340dd38895b8c7f310355e3a79881f45ed...ea50ebd36da2da4a7a8b5fe6e0925ecd113c9d59,2,9,6,15,7,2012-04-22 23:52:26,2012-04-21 20:40:48
ea50ebd36da2da4a7a8b5fe6e0925ecd113c9d59...491c8d92b857eea32c4f209cb1563169ef0b70ec,1,6,0,6,1,2012-04-23 14:30:28,2012-04-23 04:37:37
491c8d92b857eea32c4f209cb1563169ef0b70ec...4359e8154d418d7fa048a38b2415a94364ffb093,1,13,13,26,8,2012-04-24 02:11:11,2012-04-24 01:41:49
4359e8154d418d7fa048a38b2415a94364ffb093...ebfb8a5613b2e7f5961644cc24ca023d2ca73255,1,21,4,25,4,2012-04-24 02:11:22,2012-04-24 01:45:30
ebfb8a5613b2e7f5961644cc24ca023d2ca73255...48cdbffd24f7357b997e96b6ed4e5d27a999d9dd,1,15,6,21,2,2012-04-24 02:11:29,2012-04-24 02:01:28
48cdbffd24f7357b997e96b6ed4e5d27a999d9dd...d9bad09ede9603d89c3dddd62d811bebefa73d50,1,15,1,16,2,2012-04-24 03:25:09,2012-04-23 17:03:36
d9bad09ede9603d89c3dddd62d811bebefa73d50...0b5235e68c7f62116a27ea27d4aeb4fc6b211cf4,1,15,10,25,3,2012-04-24 18:30:14,2012-04-24 08:34:17
0b5235e68c7f62116a27ea27d4aeb4fc6b211cf4...ef3a874f41b617e9531909b2b6bbd6b02f1775a7,1,5,1,6,1,2012-04-24 18:31:02,2012-04-24 08:24:13
ef3a874f41b617e9531909b2b6bbd6b02f1775a7...6292df659f0c15d67827a9bf8d2739a32b38cabf,1,1,0,1,1,2012-04-24 18:31:26,2012-04-24 08:32:33
6292df659f0c15d67827a9bf8d2739a32b38cabf...df6c12cdcc2a80be141f855d35c0aaf60626aeea,1,1,1,2,1,2012-04-24 23:13:08,2012-04-24 21:04:39
df6c12cdcc2a80be141f855d35c0aaf60626aeea...5648d95c4a5f08bf252c98a12450567c150de383,1,0,1,1,1,2012-04-25 11:10:31,2012-04-25 11:10:31
5648d95c4a5f08bf252c98a12450567c150de383...98b4596a46eec9b3b06d3074aad24f5b80373638,1,1,1,2,1,2012-04-26 03:10:50,2012-04-26 03:10:50
98b4596a46eec9b3b06d3074aad24f5b80373638...f405daa92260b0bb9fc5cf8c5c2991679e00bdf2,2,10,0,10,2,2012-04-26 03:34:34,2012-04-26 03:08:30
f405daa92260b0bb9fc5cf8c5c2991679e00bdf2...70635753a3ff982ddb8686ecbb6b73b4780f8721,1,10,20,30,6,2012-04-27 17:32:40,2012-04-11 00:27:38
70635753a3ff982ddb8686ecbb6b73b4780f8721...4e84dfa6830336131a63993dcf2119b3edcb0f37,1,19,0,19,2,2012-04-27 18:38:58,2012-04-27 18:29:35
4e84dfa6830336131a63993dcf2119b3edcb0f37...12a90e98bfc347d78e622f0839898c065ed31dc1,1,127,0,127,1,2012-04-27 21:11:32,2012-04-27 21:10:35
12a90e98bfc347d78e622f0839898c065ed31dc1...ab072ee41693ee95667a06bce86588242c5b5869,1,10,3,13,4,2012-04-28 14:42:55,2012-04-28 12:24:17
889cbf9adae1fc9b456e12d2b1ef942b00fd3ac3...0fcb12460223cd3434c699e571a62a53aa65891d,1,2,2,4,1,2012-04-18 18:17:29,2012-04-18 18:17:29
518d28c23a5b809ec252b3a5984611022c0036fd...acf19500eed8805cd038e38c14d692f5684ea375,1,2,2,4,1,2012-05-01 20:31:26,2012-05-01 20:31:26
c8a10e97c8def4c6a89f34f655b675d4204e16d4...d2dd9d108d6bd61ac49522450b98ad57eac5be45,67,1965,1327,3292,401,2012-04-28 22:22:01,2012-04-28 22:22:01
d2dd9d108d6bd61ac49522450b98ad57eac5be45...3bcbd14bb18b444851b5f6c2cfdacea6403a694f,1,2,2,4,2,2012-04-28 22:24:51,2012-04-28 22:24:51
3bcbd14bb18b444851b5f6c2cfdacea6403a694f...77c18d1e1b470d99af317a2b1ed4b7e9bb81d5b6,2,14,1,15,2,2012-04-29 20:27:45,2012-04-29 13:17:16
77c18d1e1b470d99af317a2b1ed4b7e9bb81d5b6...248f552ab4567943e6254cead09ded6c4fd91f05,3,41,5,46,7,2012-04-30 17:42:13,2012-04-30 01:53:41
248f552ab4567943e6254cead09ded6c4fd91f05...89e311b1aee2009b2f710143e64332816374f617,3,61,14,75,19,2012-04-30 22:40:38,2012-04-30 22:36:40
89e311b1aee2009b2f710143e64332816374f617...75c6255d167a885de700c1fe71681514ac979d36,1,0,1,1,1,2012-04-30 22:55:46,2012-04-30 22:55:43
75c6255d167a885de700c1fe71681514ac979d36...4e4860579e7852666a761184c69b02e9a8f7af58,1,4,2,6,2,2012-04-30 23:08:31,2012-04-29 18:40:36
4e4860579e7852666a761184c69b02e9a8f7af58...f1f5de1c8d289766ee1628a06cb7dbab440e12f8,1,16,2,18,3,2012-04-30 23:20:27,2012-04-30 23:18:37
f1f5de1c8d289766ee1628a06cb7dbab440e12f8...c9e6d3696cffe1fb856dcf924ceda3e96ce93ad7,4,4,4,8,4,2012-05-01 00:25:08,2012-03-30 06:17:41
c9e6d3696cffe1fb856dcf924ceda3e96ce93ad7...e02d5c9d41be36445400b0e1819f7ddace91cb54,1,12,11,23,9,2012-05-01 00:25:08,2012-04-21 17:55:14
e02d5c9d41be36445400b0e1819f7ddace91cb54...6cacb9a21ee8f6f03d5e8dddc421522b7e33d5f2,1,2,0,2,1,2012-05-01 00:25:08,2012-03-23 02:03:18
6cacb9a21ee8f6f03d5e8dddc421522b7e33d5f2...f4403f90f846f401cf93ba17cbb6f5ddde8fb03d,1,1,1,2,1,2012-05-01 01:51:20,2012-05-01 01:51:20
f4403f90f846f401cf93ba17cbb6f5ddde8fb03d...94f1feeb5989d20372c8025b7284b4c1d26ab812,3,72,1,73,9,2012-05-01 12:50:17,2012-05-01 00:49:19
94f1feeb5989d20372c8025b7284b4c1d26ab812...e747daf60426e900fcd433148c391419bd5c2e65,1,13,13,26,6,2012-05-01 12:52:00,2012-05-01 12:52:00
e747daf60426e900fcd433148c391419bd5c2e65...b45a10818e56f8db8d692c5b5abe8bae3a6e0586,1,6,5,11,9,2012-05-01 13:19:30,2012-05-01 12:55:51
b45a10818e56f8db8d692c5b5abe8bae3a6e0586...6ba3e68bd2f9ad582ca0a20e1f42192ab527258e,1,2,2,4,1,2012-05-01 13:19:36,2012-04-21 05:58:15
6ba3e68bd2f9ad582ca0a20e1f42192ab527258e...4bd54dad33722e93bae5a16f6b274d08944c24cc,3,26,0,26,4,2012-05-01 13:19:37,2012-04-02 16:31:21
4bd54dad33722e93bae5a16f6b274d08944c24cc...9f9c333cbc5cc142beb4afb98c27650d44824721,2,41,3,44,2,2012-05-01 18:59:59,2012-05-01 18:59:59
9f9c333cbc5cc142beb4afb98c27650d44824721...b894521bd2ed81d3abfa3fc8931bd1b376a47b52,2,3,4,7,3,2012-05-01 21:09:31,2012-05-01 20:53:30
b894521bd2ed81d3abfa3fc8931bd1b376a47b52...fb400b48682ce717f5f904bd7517324f2775cb2d,1,1,0,1,1,2012-05-01 22:51:29,2012-05-01 22:51:29
fb400b48682ce717f5f904bd7517324f2775cb2d...ee2291eb0d6baa9fb82ed0fef623a3895bc1fc0d,1,2,3,5,2,2012-05-02 00:51:28,2012-05-01 02:32:20
ee2291eb0d6baa9fb82ed0fef623a3895bc1fc0d...c3898f3c1fb2aa75a0aa6f751dfc3b602871e07e,3,19,0,19,3,2012-05-02 08:48:23,2012-05-02 05:30:23
c3898f3c1fb2aa75a0aa6f751dfc3b602871e07e...880219645e3bf0a9d6eabefeaff47803ec4cf34a,2,62,105,167,17,2012-05-02 16:03:25,2012-05-02 16:03:23
880219645e3bf0a9d6eabefeaff47803ec4cf34a...6b426a2edd69364c095c1208171410cd29ccbd15,1,0,8,8,1,2012-05-02 22:53:45,2012-05-02 22:53:45
6b426a2edd69364c095c1208171410cd29ccbd15...4e290e48b218dd7a077b38ad6605ee78d54e4d20,2,89,26,115,8,2012-05-02 23:08:46,2012-05-02 23:03:08
4e290e48b218dd7a077b38ad6605ee78d54e4d20...6f82b9f482f50c68064e4a27a03e05068b517516,1,16,38,54,5,2012-05-03 05:39:23,2012-04-19 18:58:35
6f82b9f482f50c68064e4a27a03e05068b517516...e4a8d2617b49727c4de09ad9ca9bc8fa270adf1e,5,89,0,89,6,2012-05-03 14:11:42,2012-04-21 05:13:25
e4a8d2617b49727c4de09ad9ca9bc8fa270adf1e...ebbd4039bceb82e47573bdb213d1ec015ad67b61,3,18,3,21,7,2012-05-03 14:56:17,2012-05-03 14:55:25
acf19500eed8805cd038e38c14d692f5684ea375...47d6a946562b7825579211b0d617aee32bdf6f74,2,71,6,77,7,2012-05-02 23:01:46,2012-05-02 02:24:38
47d6a946562b7825579211b0d617aee32bdf6f74...df2c5fa81dbc8c584a1e3f6310b89385bca097bb,2,81,15,96,4,2012-05-03 00:49:36,2012-05-02 23:03:08
df2c5fa81dbc8c584a1e3f6310b89385bca097bb...ebd0f98e2bde2b8d345d1a0eedfd621f70cf00fa,1,2,2,4,2,2012-05-04 10:15:30,2012-05-01 02:41:29
acf19500eed8805cd038e38c14d692f5684ea375...bfe9cdb7f2f9b90c95a221dcdce29263f0da5c75,1,7,0,7,1,2012-05-01 21:26:18,2012-05-01 21:26:18
bfe9cdb7f2f9b90c95a221dcdce29263f0da5c75...bce68134b647e6f102acf8e8f8ab3b153858d32c,1,3,0,3,1,2012-05-01 22:25:59,2012-05-01 22:25:59
bce68134b647e6f102acf8e8f8ab3b153858d32c...c9be1d5ffdb3249332394e98a9f009379ac41873,1,28,3,31,4,2012-05-02 19:13:54,2012-05-02 19:13:54
c9be1d5ffdb3249332394e98a9f009379ac41873...75f23655581d6f0ac28bfaa864c1a578b94ffcd7,1,1,1,2,1,2012-05-03 14:45:46,2012-04-26 23:02:10
75f23655581d6f0ac28bfaa864c1a578b94ffcd7...b7e8e35c0ed2d1faeac1354fcc6b34c5590075fa,1,7,1,8,4,2012-05-03 17:20:45,2012-05-03 17:20:20
b7e8e35c0ed2d1faeac1354fcc6b34c5590075fa...91120e04297009ddabb6b7c68ec83a092041903c,9,466,3,469,11,2012-05-03 17:36:17,2012-05-03 17:16:25
91120e04297009ddabb6b7c68ec83a092041903c...e3ceee2dce63425f5c105d23a202dd4298507449,1,2,2,4,2,2012-05-03 17:39:16,2012-05-03 17:39:16
e3ceee2dce63425f5c105d23a202dd4298507449...62c12d21612ee0c9a6892c585eea83a02cb8de63,5,27,11,38,17,2012-05-04 17:40:38,2012-05-04 17:32:42
62c12d21612ee0c9a6892c585eea83a02cb8de63...2fc528ce009a455a69f5984e62c881a05cd4ca37,1,128,111,239,27,2012-05-04 17:40:50,2012-05-04 17:40:27
ebbd4039bceb82e47573bdb213d1ec015ad67b61...c33d3174b88b86a7fc4c2f48f361b794206cb8aa,1,27,21,48,7,2012-05-04 22:56:17,2012-05-04 22:29:42
c33d3174b88b86a7fc4c2f48f361b794206cb8aa...436a9b69f3732938a607196a023b890e9e804c64,3,132,9,141,6,2012-05-04 23:30:32,2012-05-03 20:27:06
ebbd4039bceb82e47573bdb213d1ec015ad67b61...9164fa6aaaa6e483c570d34109bcb06736ef5750,1,7,0,7,1,2012-05-04 21:27:24,2012-05-01 21:26:18
9164fa6aaaa6e483c570d34109bcb06736ef5750...0a414f4caad3430b4d73a69f54345245e1fad016,1,3,0,3,1,2012-05-04 21:27:30,2012-05-01 22:25:59
0a414f4caad3430b4d73a69f54345245e1fad016...2f93eb6102fc7f226e2bca641d6e1bcee14037e4,1,28,3,31,4,2012-05-04 21:27:35,2012-05-02 19:13:54
2f93eb6102fc7f226e2bca641d6e1bcee14037e4...5eac8d6739cda9a07d75528a17b115b225b196e8,1,1,1,2,1,2012-05-04 21:27:41,2012-04-26 23:02:10
5eac8d6739cda9a07d75528a17b115b225b196e8...e4dd8dc28efc8bbf8e2adb3d9ce17229db46219b,1,7,1,8,4,2012-05-04 21:27:47,2012-05-03 17:20:20
e4dd8dc28efc8bbf8e2adb3d9ce17229db46219b...e63c7821d5fc4e2f92c0606ab16b7846893ac3d1,9,469,5,474,12,2012-05-04 21:30:54,2012-05-03 17:16:25
e63c7821d5fc4e2f92c0606ab16b7846893ac3d1...0abe42a0f4be80bd659411656503e7ac2c243813,1,2,2,4,2,2012-05-04 21:31:08,2012-05-03 17:39:16
0abe42a0f4be80bd659411656503e7ac2c243813...a9fc63f7a188fd96db656a5bef940b4ed2076560,5,27,11,38,17,2012-05-04 21:31:13,2012-05-04 17:32:42
a9fc63f7a188fd96db656a5bef940b4ed2076560...1de43149bbb8c42b80cef4c25509390f3b4000cc,1,144,124,268,29,2012-05-04 21:58:30,2012-05-04 17:40:27
fbe143d9cbfa9ba5d1e948cd04380b187178ce9d...992e3464b8997210ea7f40f03f0386f8dd4f4f86,1,2,2,4,1,2012-05-04 20:34:33,2012-05-04 20:34:33
d1effbb338fe5916e5a25fc3d3587016d0725761...ab60efb535463757707fda6b712d5f68692b26dd,1,3,0,3,1,2012-05-04 17:57:33,2012-05-04 17:57:33
ab60efb535463757707fda6b712d5f68692b26dd...719cd461d39d01ab0d2a4a396813c59daf2ad7f1,4,28,2,30,8,2012-05-04 18:00:39,2012-05-04 18:00:39
719cd461d39d01ab0d2a4a396813c59daf2ad7f1...aaf0453b7cd6d9986925576303a20691136b278f,191,197,201,398,197,2012-05-04 19:52:55,2012-05-04 18:06:35
aaf0453b7cd6d9986925576303a20691136b278f...711ecdd54fa9a874d9f2836c71affc92e1a89e67,1,2,1,3,1,2012-05-04 19:52:59,2012-05-04 19:51:37
711ecdd54fa9a874d9f2836c71affc92e1a89e67...4ced23deaf36493f4303a18f6fdce768c58becc0,2,19,2,21,2,2012-05-04 20:12:52,2012-05-04 18:21:08
c1bf8101080f4cb7a4b3a7b2bf48196ba6c49ad8...a62dd44b20196d38d5c60840ef823615941a6f13,6,343,20,363,10,2012-05-05 00:28:21,2012-05-02 16:38:31
a62dd44b20196d38d5c60840ef823615941a6f13...eaf607e88b632a80d59dde04bd08dae5cb2c7bb8,1,1,1,2,1,2012-05-05 01:30:38,2012-05-05 01:29:56
eaf607e88b632a80d59dde04bd08dae5cb2c7bb8...ceb51ddaa187b188035dd0b01589f1d24d5e90c7,2,78,14,92,9,2012-05-05 03:24:01,2012-05-05 03:22:01
ceb51ddaa187b188035dd0b01589f1d24d5e90c7...5871c81181bc339e2265e56e1ba58bf3be73708d,1,5,1,6,2,2012-05-05 04:51:24,2011-12-19 00:13:51
5871c81181bc339e2265e56e1ba58bf3be73708d...40c4beeb57adebb8495124ecd6c21ddef712c00e,2,99,40,139,12,2012-05-05 13:47:24,2012-05-05 13:47:24
40c4beeb57adebb8495124ecd6c21ddef712c00e...9f3c639a9cf115d39af9ea1f09e33717e40b64cd,3,13,11,24,4,2012-05-05 14:10:36,2012-05-05 14:10:36
9f3c639a9cf115d39af9ea1f09e33717e40b64cd...792d9a921d492f8579c65e47214e6f91859e5e44,1,14,4,18,1,2012-05-05 14:31:27,2012-05-04 22:06:24
792d9a921d492f8579c65e47214e6f91859e5e44...1930772693d70998b4d2aab8bcd6972e7ec2d26b,1,0,0,0,0,2012-05-05 22:05:14,2012-05-05 22:05:14
1930772693d70998b4d2aab8bcd6972e7ec2d26b...3d84c3db257dfa1b92476cc6a50abf9c6e4b0583,3,53,43,96,35,2012-05-05 22:20:10,2012-05-05 22:07:58
3d84c3db257dfa1b92476cc6a50abf9c6e4b0583...1858d1c340ca2631e28a32eb542c85ee8f725cac,1,8,0,8,1,2012-05-06 02:27:42,2012-05-06 02:27:42
1858d1c340ca2631e28a32eb542c85ee8f725cac...33a9ac6087732da48e7d12ea7f7fbb41926fe46c,294,3778,2820,6598,840,2012-05-06 05:33:12,2012-05-06 05:33:06
33a9ac6087732da48e7d12ea7f7fbb41926fe46c...34f05a31952987c1d1f20e5e9838a18eecec1552,1,5,5,10,5,2012-05-06 18:23:09,2012-05-06 18:23:09
34f05a31952987c1d1f20e5e9838a18eecec1552...1eb9fc5f336aa1f797aad4b3374bd5acbd31f19d,1,39,1,40,2,2012-05-07 19:39:08,2012-04-25 07:11:06
1eb9fc5f336aa1f797aad4b3374bd5acbd31f19d...78e831a31c0ad31156457c7068726e3c0e93b266,3,0,7,7,3,2012-05-08 14:02:14,2012-05-08 14:01:36
78e831a31c0ad31156457c7068726e3c0e93b266...29b2fdb0c513f1735be9e16223b873c71ee7e7ab,3,10,4,14,5,2012-05-09 01:56:04,2012-05-08 12:38:24
29b2fdb0c513f1735be9e16223b873c71ee7e7ab...bb675baaa985d5f56d8e5936da9b356ec4a57f11,1,1,1,2,1,2012-05-09 01:56:06,2012-05-08 18:17:54
bb675baaa985d5f56d8e5936da9b356ec4a57f11...7f68f256cfac319fba1c47f60f5aab008fbb170e,1,41,41,82,21,2012-05-09 01:56:07,2012-05-08 15:38:02
7f68f256cfac319fba1c47f60f5aab008fbb170e...4ddafbd5633827b4e855472acebf4525c817e011,1,12,1,13,2,2012-05-09 01:56:09,2012-05-08 16:09:04
4ddafbd5633827b4e855472acebf4525c817e011...0e57aafbb1c4ad9c8157bfe7f5718e867861492e,8,260,22,282,29,2012-05-09 01:56:19,2012-05-07 21:30:55
0e57aafbb1c4ad9c8157bfe7f5718e867861492e...726ebad9bc89061b20f7b3f857e9683f727c70f9,1,6,34,40,4,2012-05-09 02:00:02,2012-05-09 01:54:28
726ebad9bc89061b20f7b3f857e9683f727c70f9...27ddd14e9f6bb08e0c19211c752565d3f7355842,1,22,3,25,5,2012-05-09 02:00:07,2012-05-08 18:19:38
27ddd14e9f6bb08e0c19211c752565d3f7355842...4624cf12141d23621db864d5825a22ddd25db8fd,1,1,1,2,1,2012-05-09 02:34:41,2012-05-09 02:34:41
4624cf12141d23621db864d5825a22ddd25db8fd...b673d0670f942d8401fc7f91347b8fdacac05759,3,3,3,6,3,2012-05-09 02:58:26,2012-05-09 02:58:26
b673d0670f942d8401fc7f91347b8fdacac05759...7d2e68fdbde04b683242d82c26b8cf1d47407729,2,9,6,15,3,2012-05-09 04:06:42,2012-05-09 04:06:42
7d2e68fdbde04b683242d82c26b8cf1d47407729...e85927119cd76dfa6541beb7954196c56d98a776,2,8,1,9,2,2012-05-09 14:44:44,2012-05-06 09:32:49
e85927119cd76dfa6541beb7954196c56d98a776...5979f096d1b702ca2ba95664a0bbc8210109775b,3,30,12,42,14,2012-05-09 17:08:54,2012-05-09 17:07:02
01d146c29f318fb3dce485e49c2541f53dc4a952...cd8f82c007bf316fcd857da1e00bfe358df7af44,2,14,10,24,7,2012-05-05 00:24:21,2012-05-05 00:14:09
992e3464b8997210ea7f40f03f0386f8dd4f4f86...8cd2b0e778e360df881122bc816af105768f4e26,1,1,1,2,1,2012-05-05 01:29:56,2012-05-05 01:29:56
8cd2b0e778e360df881122bc816af105768f4e26...e02af94947bf3702648a9eb04d073090833d4e43,1,50,0,50,1,2012-05-07 20:53:32,2012-05-07 20:49:10
e02af94947bf3702648a9eb04d073090833d4e43...b4fbf6d27590e0fae42cc39adca9694793efdce1,1,8,5,13,3,2012-05-07 21:17:17,2012-05-07 21:17:17
b4fbf6d27590e0fae42cc39adca9694793efdce1...8c758e127c9d81791cb55043abb418ce624dfcaf,1,0,1,1,1,2012-05-07 21:19:16,2012-05-07 21:19:16
8c758e127c9d81791cb55043abb418ce624dfcaf...ee437c0557c9f3a6a1960d3a8d64e09166d7048d,4,297,69,366,61,2012-05-09 02:44:04,2012-05-07 15:04:56
ee437c0557c9f3a6a1960d3a8d64e09166d7048d...814033365b146afb095fad6c2c05d0da0237615f,6,28,32,60,12,2012-05-09 18:54:43,2012-05-08 14:07:14
814033365b146afb095fad6c2c05d0da0237615f...bf9d8e9214e2098bacf18416564dc3a91bcdf5d6,5,20,15,35,6,2012-05-09 18:54:43,2012-05-08 20:02:28
5979f096d1b702ca2ba95664a0bbc8210109775b...928d28a7b326fb8f47ded5257ede7634fe44578b,2,10,1,11,2,2012-05-10 14:49:37,2012-05-10 14:49:35
928d28a7b326fb8f47ded5257ede7634fe44578b...68f63fe9ec2b8a7308cefa4a1ae1261cd6d1675f,1,4,7,11,5,2012-05-10 14:54:19,2012-05-10 14:54:17
68f63fe9ec2b8a7308cefa4a1ae1261cd6d1675f...12fc9fa8a7b30b701103e11ef4e76a444a4e9e19,1,27,0,27,1,2012-05-11 02:39:23,2012-05-11 02:39:20
12fc9fa8a7b30b701103e11ef4e76a444a4e9e19...a811a4a13042a4b3ba019fbe1221f4c83b02a699,2,8,1,9,2,2012-05-11 15:49:03,2012-05-11 15:49:03
a811a4a13042a4b3ba019fbe1221f4c83b02a699...38542f76a97e5c424aeada2e2dc8371797449335,1,9,47,56,7,2012-05-12 00:27:40,2012-05-06 19:47:25
38542f76a97e5c424aeada2e2dc8371797449335...d40415912f0807201a45d82a86a7f6e316bad5d7,2,5,4,9,3,2012-05-14 14:09:04,2012-05-14 02:17:51
d40415912f0807201a45d82a86a7f6e316bad5d7...49f16c4575b122a55d1842518d2395c928a78a41,1,54,63,117,6,2012-05-14 14:47:52,2012-04-12 07:18:12
49f16c4575b122a55d1842518d2395c928a78a41...dceebbfa31a2b82bb534ba120ef9354a7d348f65,6,696,31,727,23,2012-05-14 14:47:52,2012-04-12 07:23:07
dceebbfa31a2b82bb534ba120ef9354a7d348f65...d2eaabd0dff9fa8d7d11dcba0f13567e1f862ef3,1,3,3,6,3,2012-05-15 14:56:48,2012-04-27 02:37:27
d2eaabd0dff9fa8d7d11dcba0f13567e1f862ef3...25aea2a072ab75ac766c00aa9ddf3c022aa95d40,1,1,0,1,1,2012-05-15 14:56:49,2012-04-27 02:39:05
25aea2a072ab75ac766c00aa9ddf3c022aa95d40...f66f793c07ed263938748593bec0eec204291e84,1,7,7,14,7,2012-05-15 14:59:00,2012-04-27 02:42:10
f66f793c07ed263938748593bec0eec204291e84...4ec77e2e2861cdd43c2837d214d1478ebe5a0783,2,11,11,22,8,2012-05-15 14:59:01,2012-04-27 14:52:06
4ec77e2e2861cdd43c2837d214d1478ebe5a0783...a3908f47f1524ca82ddb0ea08dd7d8a5ab4c10e2,1,2,0,2,1,2012-05-15 14:59:01,2012-04-27 14:54:28
a3908f47f1524ca82ddb0ea08dd7d8a5ab4c10e2...636add246ca78be5c374cfd951c76de7f1010fb9,2,11,11,22,7,2012-05-15 18:59:43,2012-04-27 16:58:30
636add246ca78be5c374cfd951c76de7f1010fb9...5f0406534ca4a465d11892a747a38c0e5c884cf2,8,252,2,254,22,2012-05-15 19:00:27,2012-04-28 16:45:10
5f0406534ca4a465d11892a747a38c0e5c884cf2...88d7a101283dd4717ae6ccd1d757fdfe3f6d0089,1,58,0,58,1,2012-05-15 19:00:27,2012-04-29 22:58:15
88d7a101283dd4717ae6ccd1d757fdfe3f6d0089...e813e3491e3b9d828ae678391b7c926c4ad1f180,1,5,1,6,2,2012-05-15 19:01:36,2012-05-15 15:24:06
e813e3491e3b9d828ae678391b7c926c4ad1f180...9ae6d8fee345bdbc6f94e38eee57b60d231288eb,2,62,0,62,2,2012-05-15 20:05:36,2012-05-15 20:05:33
9ae6d8fee345bdbc6f94e38eee57b60d231288eb...c9676c9147e088171e60b1977ac239ded4f327df,1,14,10,24,4,2012-05-15 20:51:17,2012-05-01 10:33:36
bf9d8e9214e2098bacf18416564dc3a91bcdf5d6...3883f22ad18998e24246358e0d87e68bd9d2b2b0,1,2,2,4,1,2012-05-09 21:30:48,2012-05-09 21:11:14
3883f22ad18998e24246358e0d87e68bd9d2b2b0...493beb23f234e629ab9f929ebb03969966355dc3,1,0,5,5,1,2012-05-09 21:32:50,2012-05-09 20:39:27
493beb23f234e629ab9f929ebb03969966355dc3...52f0c37d0912f3a348ef52788be604ccbd9d1a07,3,47,4,51,6,2012-05-09 23:05:10,2011-10-12 10:35:42
52f0c37d0912f3a348ef52788be604ccbd9d1a07...cc8cfb145a2298868bd1b2520021544da5a93712,1,4,4,8,4,2012-05-11 11:00:53,2012-05-11 10:07:08
cc8cfb145a2298868bd1b2520021544da5a93712...884499d37e7cf6f553c0110dcfa4691f2c44ad80,1,21,22,43,5,2012-05-11 17:01:30,2012-05-11 01:09:51
884499d37e7cf6f553c0110dcfa4691f2c44ad80...07d8a4650e9e499d479715b6031cdba7096b7385,1,187,157,344,18,2012-05-11 22:01:38,2012-05-11 00:55:28
07d8a4650e9e499d479715b6031cdba7096b7385...9239088e873bb9570b9f21a2e819536bfb3e52ed,1,1,1,2,1,2012-05-11 22:01:38,2012-05-11 00:55:54
9239088e873bb9570b9f21a2e819536bfb3e52ed...5f9ffa17b171e1a62004f426247332f662001cf9,2,53,1,54,3,2012-05-12 01:24:46,2012-05-12 01:24:46
5f9ffa17b171e1a62004f426247332f662001cf9...d8351a2ef45756fb3458d3cdf964955e39fe4a76,1,1,0,1,1,2012-05-13 01:16:19,2012-05-12 17:37:33
d8351a2ef45756fb3458d3cdf964955e39fe4a76...d91004a73d7ae11829f06aea7f630129e8d2683c,1,3,0,3,1,2012-05-13 01:18:09,2012-05-13 01:18:09
d91004a73d7ae11829f06aea7f630129e8d2683c...a475e62a3e6bcec3be6ff03f1c4bdbf5b188065c,1,2,0,2,1,2012-05-13 01:29:44,2012-05-13 01:29:44
a475e62a3e6bcec3be6ff03f1c4bdbf5b188065c...bd907174e8082afd6dd8553940aac09cae3dcfb7,2,57,0,57,2,2012-05-14 05:19:11,2012-05-14 05:14:18
bd907174e8082afd6dd8553940aac09cae3dcfb7...fb7348ae060bf9dd4b0521ac2533fc1d66c44d8b,9,190,4,194,24,2012-05-14 15:12:59,2012-05-13 19:38:23
fb7348ae060bf9dd4b0521ac2533fc1d66c44d8b...9b42d7daaf2685d967b47e56c155225756a8cfec,1,56,0,56,1,2012-05-14 15:34:33,2012-05-14 15:34:33
9b42d7daaf2685d967b47e56c155225756a8cfec...ea4b1c1c0c2bf6e86385a84d49995553cc58360f,4,66,30,96,26,2012-05-14 19:01:38,2012-05-14 19:01:38
ea4b1c1c0c2bf6e86385a84d49995553cc58360f...14a5b45c06c327c838d93130cdfeec03e8fad1fb,1,8,2,10,2,2012-05-15 00:22:45,2012-05-15 00:21:20
14a5b45c06c327c838d93130cdfeec03e8fad1fb...8068f9bf3883bcf2768d47fe885961a0223e0c45,1,1,1,2,1,2012-05-15 00:29:47,2012-05-14 23:14:12
643f00d3f98d9379e371fab0e26ce0a5302c1162...dfcdd5b8aada95baf4c8365eb92f6507049b22ea,3,18,1,19,6,2012-05-15 22:14:46,2012-05-15 22:10:25
dfcdd5b8aada95baf4c8365eb92f6507049b22ea...1665b4a2a3bb35b24ca65b5797904aa47ce1a908,1,1,1,2,1,2012-05-16 01:04:43,2012-05-16 00:37:23
1665b4a2a3bb35b24ca65b5797904aa47ce1a908...05b81f333c8563e5d714a06bf98fc9f963ba9f64,1,2,3,5,1,2012-05-16 14:08:18,2012-05-16 14:08:18
05b81f333c8563e5d714a06bf98fc9f963ba9f64...4099d1eebae4e78864a6879c0b9e08f31d48d8cb,3,56,11,67,6,2012-05-16 14:43:18,2012-05-16 14:27:34
4099d1eebae4e78864a6879c0b9e08f31d48d8cb...3f3f958c14cf4e963a73d6f037ac381c77fe78bb,297,25595,6835,32430,2914,2012-05-16 21:22:33,2012-05-16 02:53:16
3f3f958c14cf4e963a73d6f037ac381c77fe78bb...2cca7488bf5f783c0b7a2c1258baa583a771164a,3,45,20,65,14,2012-05-16 21:22:57,2012-05-16 15:50:24
2cca7488bf5f783c0b7a2c1258baa583a771164a...3b95d88bf2dc1ac713cad527ff7780af2253d4d5,1,1,1,2,1,2012-05-16 21:22:57,2012-05-16 17:15:25
3b95d88bf2dc1ac713cad527ff7780af2253d4d5...564172510de27bfa47944ab70e24a60b69ce2236,1,3,3,6,1,2012-05-16 21:44:15,2012-05-16 21:44:15
564172510de27bfa47944ab70e24a60b69ce2236...c393853b4e04e0aae3b12f74ce2a06b482aea2e4,1,2,0,2,1,2012-05-16 21:49:51,2012-05-16 21:49:51
c393853b4e04e0aae3b12f74ce2a06b482aea2e4...9fc7283a403bb0dec096b76991226cba8e7b73c2,2,84,38,122,80,2012-05-16 22:41:28,2012-05-16 02:06:15
9fc7283a403bb0dec096b76991226cba8e7b73c2...a3753b496e468ac24eee280485704db1241e75b5,3,12,30,42,14,2012-05-16 23:32:37,2012-05-16 23:32:37
a3753b496e468ac24eee280485704db1241e75b5...ee6c11876aa0064a34420eb5039bdc6c509fcff6,1,72,0,72,1,2012-05-17 03:04:44,2012-05-16 00:02:39
ee6c11876aa0064a34420eb5039bdc6c509fcff6...1a2255ab44d4c81e6f62a69dca5710f4f31b8a00,2,68,69,137,14,2012-05-17 03:04:44,2012-05-16 00:35:42
1a2255ab44d4c81e6f62a69dca5710f4f31b8a00...ccc4e547ea91ce42a798b88c728d3d17c83ec079,1,4,0,4,1,2012-05-17 04:05:33,2012-05-16 03:24:05
ccc4e547ea91ce42a798b88c728d3d17c83ec079...18b94ea838f834209c311005ac9cd3cc6d205bca,1,10,8,18,2,2012-05-17 04:18:25,2012-05-17 04:18:25
18b94ea838f834209c311005ac9cd3cc6d205bca...a039bad299f915b68f01a961a3eb4ea70ed88795,3,7,25,32,6,2012-05-19 21:58:28,2012-05-19 21:05:43
a039bad299f915b68f01a961a3eb4ea70ed88795...b48f7f7eacb910b060515be9940f459f50fdeb02,1,2,1,3,1,2012-05-20 03:17:18,2012-05-20 03:17:18
b48f7f7eacb910b060515be9940f459f50fdeb02...d0c010e39beae175ecfdb213ec898dd88aefbb03,1,3,3,6,2,2012-05-20 12:24:47,2012-05-20 03:42:07
d0c010e39beae175ecfdb213ec898dd88aefbb03...75670d3f630cbd96cadc75c62f40747dcbf966bd,1,1,1,2,1,2012-05-20 12:40:10,2012-05-20 12:40:10
75670d3f630cbd96cadc75c62f40747dcbf966bd...ca642b020dbc94efdac38d573d164ab32580a40f,1,67,0,67,1,2012-05-20 22:31:28,2012-05-20 22:31:28
ca642b020dbc94efdac38d573d164ab32580a40f...968b49ba0a6329af83b46c598524d7ae2460df57,3,44,3,47,5,2012-05-21 16:30:16,2012-05-21 15:27:15
968b49ba0a6329af83b46c598524d7ae2460df57...81a4edcf6afc1180b80a516db894db400ce04b1a,4,11,6,17,6,2012-05-21 21:27:44,2012-05-20 13:57:24
81a4edcf6afc1180b80a516db894db400ce04b1a...45de259b436ab1bbeb15d7f582f29e795f162202,10,64,159,223,55,2012-05-21 21:29:06,2012-05-21 17:09:40
45de259b436ab1bbeb15d7f582f29e795f162202...2b9967fbcc560c2b2185fee19f82ea8b9902c644,1,9,6,15,3,2012-05-22 00:09:46,2012-05-21 22:41:56
2b9967fbcc560c2b2185fee19f82ea8b9902c644...3f69c711579dbc513915efd558da05170243fcf5,1,5,0,5,2,2012-05-22 00:09:46,2012-05-21 22:43:26
3f69c711579dbc513915efd558da05170243fcf5...a608f65b2454a83f08a60ba24088a672097540f5,1,1,1,2,1,2012-05-22 00:09:46,2012-05-21 22:46:57
a608f65b2454a83f08a60ba24088a672097540f5...039fac633eaf081a96bb1ed8bc7307d03dcbe9d9,85,3508,1289,4797,732,2012-05-22 14:14:24,2012-05-17 05:13:29
039fac633eaf081a96bb1ed8bc7307d03dcbe9d9...989ae81c713cbf97f6aa0ecf4a3674a881b2a7e8,1,4,2,6,1,2012-05-22 14:14:30,2012-05-21 16:00:25
989ae81c713cbf97f6aa0ecf4a3674a881b2a7e8...0888cdd4123e80fcb859d90808bd6cc708eec3d6,1,1,1,2,1,2012-05-22 14:14:30,2012-05-18 00:02:57
0888cdd4123e80fcb859d90808bd6cc708eec3d6...6e435da7f90b71c8a4459e12649d40de3254384c,1,3,2,5,1,2012-05-22 20:59:40,2012-05-22 20:55:47
6e435da7f90b71c8a4459e12649d40de3254384c...dff467d9825a174130bf9379e09b9421d70e3f0d,18,50,609,659,44,2012-05-22 23:49:19,2012-05-22 23:49:19
dff467d9825a174130bf9379e09b9421d70e3f0d...1358bac6d120a750546337ba5e4fe580cdeb81fb,12,448,210,658,107,2012-05-23 02:01:19,2012-05-23 02:01:19
1358bac6d120a750546337ba5e4fe580cdeb81fb...f079c0bd9f3f4fa6452b966e9287b53a201d8cb5,1,32,16,48,8,2012-05-23 02:01:45,2012-05-21 22:07:11
f079c0bd9f3f4fa6452b966e9287b53a201d8cb5...a2fcc47772546faecda1bca6140d87341246bff9,1,70,0,70,1,2012-05-23 02:04:12,2012-05-21 14:51:09
a2fcc47772546faecda1bca6140d87341246bff9...39e25528eb769c36e2f8fa534861a23822c819fb,4,91,6,97,9,2012-05-24 08:15:15,2012-05-22 23:02:10
39e25528eb769c36e2f8fa534861a23822c819fb...078763a94c6a8cb2fa7c8fc8b5b93e943e3d078a,1,1,1,2,1,2012-05-24 12:07:09,2012-05-24 12:07:09
078763a94c6a8cb2fa7c8fc8b5b93e943e3d078a...66e12dbd696f0b2b29bea7dc4a1732efdf2ea125,1,2,1,3,1,2012-05-24 16:55:08,2012-05-24 16:36:20
66e12dbd696f0b2b29bea7dc4a1732efdf2ea125...b4ed3c19697e875c289363381498a896347cbca6,1,0,24,24,12,2012-05-24 18:49:51,2012-05-24 18:49:51
b4ed3c19697e875c289363381498a896347cbca6...24de89bd0e47cb657afa386fa7b2d2ae94309254,20,130,160,290,76,2012-05-24 21:26:32,2012-05-24 21:26:32
24de89bd0e47cb657afa386fa7b2d2ae94309254...578f69bcf49ac98243e86650a596c4039296db18,5,83,54,137,16,2012-05-25 12:02:35,2012-05-25 12:02:35
578f69bcf49ac98243e86650a596c4039296db18...1fc2c3823ce4e4bb93caae30467f403020c407a1,2,2,2,4,2,2012-05-26 10:34:13,2012-05-26 10:25:44
1fc2c3823ce4e4bb93caae30467f403020c407a1...82bcdbb8aaa4cf58917dc8d3fd4fcfc272512a2c,1,2,0,2,1,2012-05-26 10:41:37,2012-05-26 10:36:05
82bcdbb8aaa4cf58917dc8d3fd4fcfc272512a2c...1f3e4a76f9cb06fae57f7c81371cc5e1351a7977,2,69,1,70,2,2012-05-27 18:00:19,2012-05-26 13:28:35
1f3e4a76f9cb06fae57f7c81371cc5e1351a7977...0fd28345392c2a16dfe143d2467ab14a236ce3c3,7,38,18,56,16,2012-05-27 22:32:16,2012-05-27 22:32:16
0fd28345392c2a16dfe143d2467ab14a236ce3c3...c96df0e37aed536867a41e8b6d3f0f523c37dfea,1,0,6,6,2,2012-05-27 23:35:36,2012-05-27 21:29:00
c96df0e37aed536867a41e8b6d3f0f523c37dfea...f721d02c8a356c1a9a40d8bf7099186749f01978,1,0,1,1,1,2012-05-28 21:26:02,2012-05-28 06:36:04
f721d02c8a356c1a9a40d8bf7099186749f01978...0bd410a66a379b6dbd1fa1458829a0aa623c5363,1,1,2,3,1,2012-05-28 22:10:38,2012-05-28 22:06:36
0bd410a66a379b6dbd1fa1458829a0aa623c5363...719376730d8d1db7bd98c7688906d0a543154f6b,121,263,169,432,147,2012-05-29 03:02:39,2012-05-27 05:36:04
719376730d8d1db7bd98c7688906d0a543154f6b...8a411bae665aba016724df50dc76b38b9f7d3619,1,1,7,8,1,2012-05-29 03:02:49,2012-05-27 15:32:31
07be9fc3a674d8a2e148041f3674c1abaee0907f...a98e845516204f59b682228a96289cd884769242,1,175,183,358,11,2012-05-15 18:26:47,2012-05-11 00:55:28
a98e845516204f59b682228a96289cd884769242...01103d077bce626a332be998813382d15bed3501,1,1,1,2,1,2012-05-15 18:29:32,2012-05-15 00:21:20
8068f9bf3883bcf2768d47fe885961a0223e0c45...4bc1d395de6abed2cf1e4d0b7b3a1480a21c368f,2,31,2,33,2,2012-05-15 00:30:00,2012-05-14 23:12:15
8a411bae665aba016724df50dc76b38b9f7d3619...fa9aa1c961125f5c5527c7b5e3720eadf84a979f,2,29,15,44,6,2012-05-29 11:05:51,2012-05-29 11:05:49
fa9aa1c961125f5c5527c7b5e3720eadf84a979f...761e0c460a8e9a40cd1126cf0ba354e50e38d6da,16,409,279,688,83,2012-05-29 14:26:40,2012-05-28 19:52:34
8a411bae665aba016724df50dc76b38b9f7d3619...782277f11a753ded831439ed826448c06fc0f356,3,53,2,55,3,2012-05-29 03:03:03,2012-05-26 05:20:21
5164ae38380dadce74e8f64d7bd3eaa1935dd101...9611354f08d2fc240bd67e3f4c8ca02d1d1a3ea1,1,1,1,2,1,2012-05-15 20:03:43,2012-05-15 20:03:43
9611354f08d2fc240bd67e3f4c8ca02d1d1a3ea1...f8519e10b823f576ddd0efa76ab425f0598b1223,1,3,3,6,1,2012-05-15 20:03:56,2012-05-15 20:03:56
f8519e10b823f576ddd0efa76ab425f0598b1223...faa4d9ff5f7ff676db06240e09140f9780e2638c,1,106,77,183,26,2012-05-15 21:19:46,2012-05-15 21:19:46
2498d15dde5973c647d1496d52dd915fbc500f3b...f19f980724fa07347a0d0a9d92e48b267555da5d,1,2,2,4,1,2012-05-15 17:21:57,2012-05-15 17:21:57
a9e40281e71cbd0324b439dcd516d728537133ff...dc8b488bbe2b411b56a45d56b384308957a07d76,1,2,2,4,1,2012-05-29 17:08:24,2012-05-29 17:08:24
dc8b488bbe2b411b56a45d56b384308957a07d76...b337577cf1b8321a8c814a331b046f6a505836af,1,1,1,2,1,2012-05-30 23:46:56,2012-05-30 23:46:53
b337577cf1b8321a8c814a331b046f6a505836af...30a0e58d63a8fb48ee47472a52450539e0656df9,36,914,597,1511,181,2012-06-01 16:19:42,2012-06-01 16:07:22
30a0e58d63a8fb48ee47472a52450539e0656df9...af98fc9d5f20a8c5dc0db95121f18355337762f1,11,472,246,718,74,2012-06-01 16:52:13,2012-05-16 16:04:24
af98fc9d5f20a8c5dc0db95121f18355337762f1...8a52a168473f57e0fbcd8de794e9da6529c5ca2a,2,5,0,5,1,2012-06-02 00:01:57,2012-06-02 00:01:57
8a52a168473f57e0fbcd8de794e9da6529c5ca2a...9fe39ede9f014a0e5a8f3d85d5373743188cea81,4,24,6,30,12,2012-06-02 00:18:09,2012-06-01 02:44:10
9fe39ede9f014a0e5a8f3d85d5373743188cea81...9a998d5e244dc58a1f7650e574371e0d4c75fcc1,1,3,2,5,3,2012-06-02 01:07:43,2012-06-01 07:33:19
9a998d5e244dc58a1f7650e574371e0d4c75fcc1...0262b6d2a563e8b96f02c3066b69fed66d956675,1,46,4,50,7,2012-06-02 05:12:48,2012-05-16 16:04:24
0262b6d2a563e8b96f02c3066b69fed66d956675...cbdf3393a21690178822c2d6ce2513270d70a02e,167,5054,3138,8192,1327,2012-06-02 05:31:04,2012-05-29 22:05:24
cbdf3393a21690178822c2d6ce2513270d70a02e...7946ad2634201e3ab730ee894a4723698bc7e6a1,1,1,1,2,1,2012-06-02 05:31:04,2012-05-29 22:09:31
7946ad2634201e3ab730ee894a4723698bc7e6a1...eabf3c8d0f42ee59b15fc150d2a0f2f058f094d6,1,13,13,26,8,2012-06-02 05:31:04,2012-04-24 01:41:49
eabf3c8d0f42ee59b15fc150d2a0f2f058f094d6...e0f5d8e86d630be8e0fd3386273472d829b44608,1,4,4,8,2,2012-06-02 05:31:05,2012-05-29 22:32:20
e0f5d8e86d630be8e0fd3386273472d829b44608...3b6a00b664afdc7695ddddefc637b1fbebf94fc6,1,0,1,1,1,2012-06-02 14:06:00,2012-06-02 14:01:18
3b6a00b664afdc7695ddddefc637b1fbebf94fc6...e2126e05e7a5a4a7f2cb97173ad3b8b4c11807d5,3,6,23,29,7,2012-06-02 16:39:41,2012-06-02 16:36:20
e2126e05e7a5a4a7f2cb97173ad3b8b4c11807d5...943448772e988eba86173e9d53746137070420f4,2,43,5,48,10,2012-06-02 22:45:39,2012-06-02 19:49:31
943448772e988eba86173e9d53746137070420f4...0699f5bfb40ca365f46eab775c7e6fc8a19d3eee,1,25,16,41,1,2012-06-04 12:12:59,2012-06-04 12:04:15
0699f5bfb40ca365f46eab775c7e6fc8a19d3eee...7161ecd31ba7639667ef9683a52172ab977be578,1,1,1,2,1,2012-06-04 12:16:39,2012-06-03 09:03:49
7161ecd31ba7639667ef9683a52172ab977be578...f0a561fe67d64415e28c817f336ad71be4d23b81,1,5,5,10,5,2012-06-04 13:02:09,2012-06-04 13:02:02
f0a561fe67d64415e28c817f336ad71be4d23b81...04e484c4843011640e14f8a9b5409eb8d8dac0fe,1,2,2,4,2,2012-06-04 18:10:31,2012-06-04 18:10:31
04e484c4843011640e14f8a9b5409eb8d8dac0fe...01432403afc81b727083034dcb5126e4350e9c45,2,28,0,28,4,2012-06-04 19:39:51,2012-06-04 16:59:01
01432403afc81b727083034dcb5126e4350e9c45...4f6882e8982aeee8065803e93acb2c6f0dff8d1d,2,33,39,72,20,2012-06-04 19:39:58,2012-06-04 19:39:23
4f6882e8982aeee8065803e93acb2c6f0dff8d1d...cc36cc5999937aeb0ed00f82b5c969edecaa1b1d,1,17,6,23,1,2012-06-05 00:32:59,2012-06-04 18:21:42
cc36cc5999937aeb0ed00f82b5c969edecaa1b1d...b9e40fbaacc60de562481b764b0e78bf021f7cfa,238,612,3231,3843,385,2012-06-05 00:32:59,2012-06-05 00:32:46
b9e40fbaacc60de562481b764b0e78bf021f7cfa...208d1715a788562dbdb8f7eae17ddfb254690e5b,1,3,3,6,5,2012-06-05 13:45:08,2012-06-05 10:24:15
208d1715a788562dbdb8f7eae17ddfb254690e5b...cc0e7efb3765ffd22d1394618e3f648cde7dfddc,1,2,0,2,2,2012-06-05 14:27:57,2012-06-05 13:58:55
cc0e7efb3765ffd22d1394618e3f648cde7dfddc...27061cc9f45afbc4ddc1efa8bed1ea22df7cb0f4,2,29,11,40,10,2012-06-05 14:48:17,2012-06-05 14:45:29
27061cc9f45afbc4ddc1efa8bed1ea22df7cb0f4...0a2076b26ac0dee453d664e0d0d6a0cc934bd579,45,1564,679,2243,181,2012-06-05 14:48:17,2012-06-05 13:45:46
0a2076b26ac0dee453d664e0d0d6a0cc934bd579...c69d7f1a6cbec87b2ef2fa3b5de6d8db05858d2d,1,1,0,1,1,2012-06-05 17:25:39,2012-05-27 07:47:40
c69d7f1a6cbec87b2ef2fa3b5de6d8db05858d2d...28e851c169ad589a7f6a1357fd84fd75254a2ab7,2,22,3,25,4,2012-06-05 19:35:49,2012-06-05 19:02:37
28e851c169ad589a7f6a1357fd84fd75254a2ab7...5f411405356cd184560507ce870a664e4ef5417f,5,219,61,280,26,2012-06-06 03:31:08,2012-06-06 03:21:07
5f411405356cd184560507ce870a664e4ef5417f...b9c5eee7d9ad8d720c6f28dc78ab288c7b0e004c,1,1,1,2,1,2012-06-06 03:31:09,2012-06-06 01:32:44
b9c5eee7d9ad8d720c6f28dc78ab288c7b0e004c...c381662cac0e897b4bfdb2c31cd3117c5ecd2130,1,1,1,2,1,2012-06-06 19:08:38,2012-06-06 19:07:54
c381662cac0e897b4bfdb2c31cd3117c5ecd2130...463d6bac8b349acc462d345a6e298a76f7d06fb1,2,53,38,91,32,2012-06-06 19:49:39,2012-06-06 19:33:29
463d6bac8b349acc462d345a6e298a76f7d06fb1...c45522df4c1a316d304d2d08d641c5b9da8df148,1,2,2,4,2,2012-06-06 22:02:23,2012-06-06 22:01:31
c45522df4c1a316d304d2d08d641c5b9da8df148...3116522e7c33c579bbb8ac0ee12c27ff3ff9825c,4,26,2,28,4,2012-06-07 19:20:56,2012-06-06 17:19:14
3116522e7c33c579bbb8ac0ee12c27ff3ff9825c...46b09e419039d2fbfde4029606de3d3aaef7af25,192,4210,7191,11401,1834,2012-06-08 00:54:21,2012-06-07 18:45:30
46b09e419039d2fbfde4029606de3d3aaef7af25...43ff46becfd3b16869b20c3aa9ffabb8b45fb043,1,1,1,2,1,2012-06-08 00:54:21,2012-05-29 22:09:31
43ff46becfd3b16869b20c3aa9ffabb8b45fb043...1fb9cfcdb197c108c1bd80f031c488242d761a1b,1,13,13,26,8,2012-06-08 00:54:21,2012-04-24 01:41:49
1fb9cfcdb197c108c1bd80f031c488242d761a1b...bd33fea732fa74d23fc31855631eba14a03a0c49,1,4,0,4,1,2012-06-08 00:54:22,2012-06-02 14:01:18
bd33fea732fa74d23fc31855631eba14a03a0c49...0435f9b28c8eefc6a3ccbe6f06d731dc6b3e7796,1,1,1,2,1,2012-06-08 00:54:22,2012-06-04 18:10:31
0435f9b28c8eefc6a3ccbe6f06d731dc6b3e7796...f62441367fbe23116faf800848d73036ad0b5ffd,1,4,0,4,1,2012-06-08 00:54:56,2012-06-07 23:21:04
f62441367fbe23116faf800848d73036ad0b5ffd...5046f8501c15ba42036f826c5fbb7a2fb5ee634d,1,0,4,4,1,2012-06-08 18:46:34,2012-06-08 18:46:34
5046f8501c15ba42036f826c5fbb7a2fb5ee634d...4b021a3541770ae64a415760339bdd3223fdf602,5,79,5,84,11,2012-06-09 05:57:22,2012-06-01 04:23:05
4b021a3541770ae64a415760339bdd3223fdf602...569acea0eefed2c7da7453b7dcef6ff47491ca1c,3,41,3,44,5,2012-06-09 06:32:13,2012-06-06 15:17:01
569acea0eefed2c7da7453b7dcef6ff47491ca1c...940a6863ead6622e5439e07be631359c31e63b68,253,5144,22143,27287,2200,2012-06-09 15:09:42,2012-06-09 15:09:42
940a6863ead6622e5439e07be631359c31e63b68...c08357c32fd52c89a4f952ff9dd4ac0608adb88a,1,1,1,2,1,2012-06-09 15:09:58,2012-05-29 22:09:31
c08357c32fd52c89a4f952ff9dd4ac0608adb88a...26f754d9ddcdab02cbed4eab6c3f7a36907e8a13,1,13,13,26,8,2012-06-09 15:10:03,2012-04-24 01:41:49
26f754d9ddcdab02cbed4eab6c3f7a36907e8a13...77cfbd9f2d286368627a8dfa4f4f5cbdfd6f89e1,1,2,10,12,3,2012-06-09 16:15:38,2012-06-08 17:59:35
77cfbd9f2d286368627a8dfa4f4f5cbdfd6f89e1...535e109a3ab8cc756504a9204fdcd428cbae7cba,2,5,1,6,2,2012-06-09 16:15:38,2012-06-08 18:06:10
535e109a3ab8cc756504a9204fdcd428cbae7cba...60b45dcbb66ad754c70693adba80595ae67dc026,2,9,1,10,4,2012-06-09 16:15:38,2012-06-08 18:24:52
60b45dcbb66ad754c70693adba80595ae67dc026...6332a4cf00425c63ae476d89f6705881eb06a3e1,1,144,182,326,28,2012-06-09 16:43:46,2012-06-08 22:26:04
6332a4cf00425c63ae476d89f6705881eb06a3e1...424bca15c8e227a9170cfe00f9ba7d9daae6fb03,1,44,11,55,8,2012-06-09 16:43:46,2012-06-08 23:49:03
424bca15c8e227a9170cfe00f9ba7d9daae6fb03...131a67e7efa2c3010578d9f5fc06ac6f0529af76,2,42,8,50,7,2012-06-09 16:43:47,2012-06-09 07:33:25
131a67e7efa2c3010578d9f5fc06ac6f0529af76...65242abc3bdc249916a22daad289c005a7d93ead,1,26,10,36,13,2012-06-09 16:43:47,2012-06-09 07:39:57
65242abc3bdc249916a22daad289c005a7d93ead...284816ee9ff67aaa997b803db4f1ebb207672c6d,1,26,0,26,1,2012-06-09 18:30:16,2012-06-09 17:47:18
f19f980724fa07347a0d0a9d92e48b267555da5d...7865c5c51dc6ef2f17644b4923ea451da21eee5a,1,10,20,30,6,2012-05-20 23:30:58,2012-04-11 00:27:38
7865c5c51dc6ef2f17644b4923ea451da21eee5a...7535e3930a6d78674fb163d62ab818f8cb924df1,1,109,0,109,1,2012-05-24 22:35:07,2012-03-06 17:11:50
7535e3930a6d78674fb163d62ab818f8cb924df1...5ff2ae8389c8e4ea37709d02340f1b60c32f0737,1,1,1,2,1,2012-05-24 22:35:10,2012-05-11 17:35:03
5ff2ae8389c8e4ea37709d02340f1b60c32f0737...2ae9b69871427697cf7c0abb6cd345f9778cc7a5,2,69,1,70,2,2012-05-29 13:34:01,2012-05-26 13:28:35
2ae9b69871427697cf7c0abb6cd345f9778cc7a5...ccc854d14ee73ff775f6425ba236aeaa62ff9fbf,1,0,4,4,4,2012-05-31 13:38:05,2012-05-31 12:11:12
ccc854d14ee73ff775f6425ba236aeaa62ff9fbf...434404e3bbb0a293106fd830378dfd4e8091a7d6,1,2,0,2,1,2012-06-01 17:21:02,2012-06-01 17:20:56
434404e3bbb0a293106fd830378dfd4e8091a7d6...0742f5629cea120e8569f8985983d295a5868ff9,1,19,18,37,9,2012-06-05 13:10:37,2012-06-05 13:10:37
0742f5629cea120e8569f8985983d295a5868ff9...cb76999bad6f20f3643fd6a052511fdca51f0efa,5,18,5,23,9,2012-06-05 15:07:43,2012-06-05 15:04:52
284816ee9ff67aaa997b803db4f1ebb207672c6d...13198357e9973c6d29283ca7d69d57f5986b9474,172,872,1906,2778,520,2012-06-11 15:13:36,2012-06-11 04:29:47
13198357e9973c6d29283ca7d69d57f5986b9474...54a4f99c4e0f3b6b3a0a5182c29051761a50bb2b,2,6,5,11,4,2012-06-11 15:13:36,2012-06-11 14:48:02
54a4f99c4e0f3b6b3a0a5182c29051761a50bb2b...5432a1d985df7df57db4106af72dc880d40ea497,1,2,1,3,1,2012-06-11 15:13:36,2012-06-11 14:50:07
5432a1d985df7df57db4106af72dc880d40ea497...76f6a4abb464c8d2d6cb62361bb016828c8369e7,1,1,0,1,1,2012-06-11 15:19:55,2012-06-11 15:18:30
76f6a4abb464c8d2d6cb62361bb016828c8369e7...8d9766a9dfb1eea901219d2a865ce9300fe4d68e,3,47,2,49,3,2012-06-11 15:19:55,2012-06-11 04:25:41
cb76999bad6f20f3643fd6a052511fdca51f0efa...e5d3ea77719b2466e8a474b0d660e5c9e6e3300a,248,760,3285,4045,421,2012-06-06 00:46:27,2012-06-06 00:20:05
e5d3ea77719b2466e8a474b0d660e5c9e6e3300a...debf552ed2d4a53957446e82ff3c52a8182d5ff4,3,20,2,22,3,2012-06-06 00:46:27,2012-06-06 00:23:41
4f235ef87f3d492a979c8732c4b9a8be296fc6c6...e9aa57e8bdfe71095773f8f8096aff1e8e00e265,1,2,2,4,1,2012-06-11 15:58:33,2012-06-11 15:58:33
e9aa57e8bdfe71095773f8f8096aff1e8e00e265...1358632e672e2e7097abe12924de5f2b82bde765,1,0,4,4,1,2012-06-11 16:07:42,2012-06-11 16:07:42
1358632e672e2e7097abe12924de5f2b82bde765...25e8ea17e1f03cd40cc5a6c9c1987bae58313ff5,40,2542,1,2543,39,2012-06-11 16:54:39,2012-06-11 16:30:44
25e8ea17e1f03cd40cc5a6c9c1987bae58313ff5...2eb181d28c71e20307166c06317cdd03d102854c,2,26,6,32,4,2012-06-11 17:27:51,2012-06-01 04:23:05
2eb181d28c71e20307166c06317cdd03d102854c...33be3016fb145d697187c14acf79485f408af5cb,3,10,4,14,5,2012-06-11 19:24:27,2012-05-08 12:38:24
33be3016fb145d697187c14acf79485f408af5cb...2301eb69b1eb1c9a5b71fe96adb878290262b1f2,1,2,2,4,2,2012-06-11 19:24:29,2012-06-11 19:22:50
2301eb69b1eb1c9a5b71fe96adb878290262b1f2...cfa28690db6532972fc9ec90ff874b400ca3a0a5,1,2,6,8,2,2012-06-11 21:46:17,2012-06-11 21:46:17
cfa28690db6532972fc9ec90ff874b400ca3a0a5...d53cdc5378db082cda85179f1172db27a14dd33e,3,93,0,93,3,2012-06-11 22:51:23,2012-06-11 22:24:38
d53cdc5378db082cda85179f1172db27a14dd33e...6ce013dd4bbe660c12ce11c338b788163305cd2b,2,118,13,131,12,2012-06-11 22:54:28,2012-06-11 21:49:31
6ce013dd4bbe660c12ce11c338b788163305cd2b...00ba1cbce1180bafbe4529c5783d31b9d5823a13,1,1,1,2,1,2012-06-11 23:43:45,2012-06-11 23:40:04
00ba1cbce1180bafbe4529c5783d31b9d5823a13...094f7426571c1361301716c193293dba38ba90ed,1,2,2,4,2,2012-06-11 23:56:48,2012-06-11 23:56:48
094f7426571c1361301716c193293dba38ba90ed...b27a4cbe2a3522430fd4dfc8cc44d726685c0a52,1,2,1,3,1,2012-06-12 00:04:44,2012-06-12 00:04:44
b27a4cbe2a3522430fd4dfc8cc44d726685c0a52...517cea3636b7a101799214d71ddb98eaea8e0198,1,14,8,22,3,2012-06-12 00:22:30,2012-06-12 00:22:30
517cea3636b7a101799214d71ddb98eaea8e0198...4eb2804db9e3bbc06ebda6296620ce5bf6f7b02e,1,1,1,2,1,2012-06-12 13:02:39,2012-06-12 06:01:34
4eb2804db9e3bbc06ebda6296620ce5bf6f7b02e...e3a2dd1b13344a8347265ab0f46181de33b1b1ef,1,1,1,2,1,2012-06-12 13:02:39,2012-06-12 07:01:03
e3a2dd1b13344a8347265ab0f46181de33b1b1ef...408bfece510520d73d9e19629450dfec691cc1e6,1,8,6,14,3,2012-06-12 14:31:44,2012-06-12 13:32:40
408bfece510520d73d9e19629450dfec691cc1e6...0385b17ce06b7c12ad3e4035477f6a0cf897580e,1,3,6,9,2,2012-06-12 14:31:49,2012-06-12 14:04:56
0385b17ce06b7c12ad3e4035477f6a0cf897580e...b615077bab71db73cf065d6162cae8d6cb84d8d2,33,410,115,525,76,2012-06-12 15:06:54,2012-06-12 15:05:49
b615077bab71db73cf065d6162cae8d6cb84d8d2...cbeeea62cf10bbf71636fe03282590050beb1d36,33,115,410,525,76,2012-06-12 17:52:38,2012-06-12 17:52:38
cbeeea62cf10bbf71636fe03282590050beb1d36...a55faeac18f4ec2121935b52b703ba5abf2a1767,32,396,111,507,70,2012-06-12 17:54:56,2012-06-12 17:19:26
a55faeac18f4ec2121935b52b703ba5abf2a1767...900196e13506bdfb525db1e69072a6a4c18aaba3,2,83,46,129,20,2012-06-12 19:50:05,2012-06-12 19:47:11
900196e13506bdfb525db1e69072a6a4c18aaba3...8963a5228df69dce6635c5589e2c201af473f3f3,1,8,5,13,2,2012-06-12 20:02:35,2012-06-12 20:02:35
8963a5228df69dce6635c5589e2c201af473f3f3...b53b8b8ae7d7e1328319b04b9030a7afb97a7924,1,20,8,28,8,2012-06-12 21:30:54,2012-06-12 17:58:05
b53b8b8ae7d7e1328319b04b9030a7afb97a7924...10f85fadfea0fade0642861116f7df79ee281e9a,2,43,10,53,12,2012-06-12 21:30:56,2012-06-12 20:37:36
10f85fadfea0fade0642861116f7df79ee281e9a...b866a96cfacf37bf40a9fd7bab6e56868e3c0800,1,0,4,4,1,2012-06-12 21:30:57,2012-06-12 20:39:55
b866a96cfacf37bf40a9fd7bab6e56868e3c0800...e4f4c633706297c3b695a6e590097a1c74ecf7c6,14,28,44,72,19,2012-06-12 23:35:51,2012-06-12 23:35:51
e4f4c633706297c3b695a6e590097a1c74ecf7c6...5209dad9073136153fa901d1c80f96458b4d3cf8,1,8,3,11,1,2012-06-13 00:49:33,2012-06-13 00:49:33
5209dad9073136153fa901d1c80f96458b4d3cf8...0dba4ad0f91ca926055c4df1d6a1699df17cb0a5,3,3,3,6,3,2012-06-13 01:02:53,2012-06-13 01:02:53
0dba4ad0f91ca926055c4df1d6a1699df17cb0a5...a11bf99ce0dae4d8f4de8a9c0c32159c1a9ecfbf,3,25,0,25,5,2012-06-13 02:08:47,2012-06-13 02:05:51
a11bf99ce0dae4d8f4de8a9c0c32159c1a9ecfbf...0187b657ae5c12ea98da8266c493d493566e1fc9,3,1,1,2,1,2012-06-13 15:40:50,2012-06-13 15:40:50
0187b657ae5c12ea98da8266c493d493566e1fc9...e733dc3bc3bcc876a29f2b78c5a29bae9dedb0c3,10,640,21,661,25,2012-06-13 19:24:45,2012-06-12 17:02:52
e733dc3bc3bcc876a29f2b78c5a29bae9dedb0c3...74c8041fb6d781981e5f7e58167dd4ac3c487a7d,1,1,1,2,1,2012-06-13 20:12:30,2012-06-13 20:10:59
74c8041fb6d781981e5f7e58167dd4ac3c487a7d...35a1421e9670e7b5bc042758170d20673aed666f,11,500,12,512,26,2012-06-13 22:36:08,2012-06-11 23:23:17
35a1421e9670e7b5bc042758170d20673aed666f...6a8b5b36b4570b4e9468f4c4599f8f6513c35017,8,537,10,547,17,2012-06-13 22:56:35,2012-06-13 22:55:29
6a8b5b36b4570b4e9468f4c4599f8f6513c35017...029e01bb809d792651e6c12cdaa34f04f5333c26,1,1,0,1,1,2012-06-13 22:56:43,2012-06-13 22:55:45
029e01bb809d792651e6c12cdaa34f04f5333c26...37d75ba241780c9199f601dd4c70713d190c68e6,7,571,430,1001,31,2012-06-13 23:27:31,2012-06-13 23:24:43
37d75ba241780c9199f601dd4c70713d190c68e6...09be360a0fee2c7619bae8c4248f9ed3d79d1b30,1,3,0,3,1,2012-06-13 23:28:51,2012-06-13 23:28:51
09be360a0fee2c7619bae8c4248f9ed3d79d1b30...50464cd4f49e40f4fe792ff46a81052319a222e9,373,36029,11562,47591,5592,2012-06-13 23:37:13,2012-06-13 13:34:45
50464cd4f49e40f4fe792ff46a81052319a222e9...48893af7bb7fef23a00b8fe672a1fd97e6cbd972,3,70,13,83,11,2012-06-13 23:37:14,2012-06-13 11:58:18
48893af7bb7fef23a00b8fe672a1fd97e6cbd972...ac64c9e54690e7b0bbf26a583d8f4689bb95eb63,1,1,1,2,1,2012-06-13 23:37:14,2012-06-13 13:37:15
ac64c9e54690e7b0bbf26a583d8f4689bb95eb63...fac6c69456d170ee19fa14bbccade67129d873b5,1,2,2,4,1,2012-06-13 23:37:15,2012-06-13 13:47:28
fac6c69456d170ee19fa14bbccade67129d873b5...2701a6bd483218acf512591b4d99ce59f5227c5d,1,0,1,1,1,2012-06-13 23:51:13,2012-06-02 14:01:18
2701a6bd483218acf512591b4d99ce59f5227c5d...54b74b8e85c8ca5827d4116a3943d95755a888bd,4,2,10,12,4,2012-06-14 00:16:27,2012-06-13 14:07:50
54b74b8e85c8ca5827d4116a3943d95755a888bd...4a1698c6ba7d0f018c8873abcc25d577806832f0,1,13,13,26,10,2012-06-14 00:52:55,2012-06-14 00:50:25
4a1698c6ba7d0f018c8873abcc25d577806832f0...511e3287274ce78aec1b1c781e94c4351b933457,1,18,0,18,1,2012-06-14 00:52:57,2012-06-14 00:52:30
511e3287274ce78aec1b1c781e94c4351b933457...c752f6c013805072c5dda17195ad3b2baf7e5dd7,1,1,0,1,1,2012-06-14 00:58:28,2012-06-14 00:32:53
c752f6c013805072c5dda17195ad3b2baf7e5dd7...05fe70b582c1f888e09ea7d21a70fe736bd09d12,1,10,1,11,1,2012-06-14 00:58:28,2012-06-14 00:39:20
05fe70b582c1f888e09ea7d21a70fe736bd09d12...39d23378592458bfe0644c43567e4103979a0236,2,10,14,24,4,2012-06-14 13:26:47,2012-06-14 08:33:56
39d23378592458bfe0644c43567e4103979a0236...34b0b6a6133ef70878c426af0812308869b5493b,1,9,4,13,3,2012-06-14 14:06:53,2012-06-14 14:06:53
34b0b6a6133ef70878c426af0812308869b5493b...dd85a8c183790baca5e97b0b7ac0709e76e1fafc,1,1,1,2,1,2012-06-14 15:37:44,2012-06-14 15:37:44
dd85a8c183790baca5e97b0b7ac0709e76e1fafc...c2c08196d80d6034ca63866249e6a6d4b88650ca,3,28,24,52,21,2012-06-14 16:32:56,2012-05-30 18:32:50
c2c08196d80d6034ca63866249e6a6d4b88650ca...ca003f4f3ee9a8d44f941b046ca5a5a16b49a314,1,8,1,9,2,2012-06-14 16:36:49,2012-06-14 16:34:38
ca003f4f3ee9a8d44f941b046ca5a5a16b49a314...58b8b3fa07df3ddeb32f37aeb7795de2b39a6b66,2,2,4,6,3,2012-06-14 16:36:49,2012-06-14 16:35:44
58b8b3fa07df3ddeb32f37aeb7795de2b39a6b66...f70fa3bae61cf203cc9a46fb449af793c08ff086,1,2,2,4,2,2012-06-14 17:11:55,2012-06-14 17:11:47
f70fa3bae61cf203cc9a46fb449af793c08ff086...8bec3febd848c4917c22c68d9de6d737f945b81f,1,10,1,11,2,2012-06-14 17:39:05,2012-06-14 17:22:33
8bec3febd848c4917c22c68d9de6d737f945b81f...a0a5c4c5af3aff9c7f8c9b493240eff394e96279,1,94,113,207,35,2012-06-14 17:39:05,2012-06-14 17:24:27
a0a5c4c5af3aff9c7f8c9b493240eff394e96279...7f896889ba88e0e90dd8cbcdc55ba3384fa01b02,1,29,12,41,6,2012-06-14 19:23:37,2012-06-14 19:18:12
7f896889ba88e0e90dd8cbcdc55ba3384fa01b02...c231321cd379ce3068d51b803322a54ed6dc0982,2,71,1,72,2,2012-06-14 22:35:37,2012-06-14 13:54:23
c231321cd379ce3068d51b803322a54ed6dc0982...00247d53db6896d5463ec8792ed9431b25915938,1,1,1,2,1,2012-06-14 22:40:35,2012-06-14 08:57:34
00247d53db6896d5463ec8792ed9431b25915938...412c1ab5bc254906d8f68b22fdabef82dea1a15a,2,166,92,258,59,2012-06-14 23:15:12,2012-06-14 19:58:59
412c1ab5bc254906d8f68b22fdabef82dea1a15a...13400e3e5851d81d4c79f1f4ac0e7aef85b64cb9,2,22,20,42,6,2012-06-14 23:37:24,2012-06-14 23:37:24
13400e3e5851d81d4c79f1f4ac0e7aef85b64cb9...c9a1b5d162d40235ac7ec5479059c66a33f5c1a1,2,11,13,24,2,2012-06-15 00:26:50,2012-06-13 17:25:43
c9a1b5d162d40235ac7ec5479059c66a33f5c1a1...032fc42e64fdb5ab0b5182ea39a0487b40638c82,1,2,4,6,3,2012-06-15 00:26:50,2012-06-14 23:59:02
032fc42e64fdb5ab0b5182ea39a0487b40638c82...e72addcf8e72e6a32a7561588aa3d73b30defc7b,1,18,2,20,3,2012-06-15 00:26:51,2012-06-15 00:24:40
e72addcf8e72e6a32a7561588aa3d73b30defc7b...283d735e2b7c8e2bc710cf7c646e184dd676f022,1,68,11,79,3,2012-06-15 05:17:39,2012-06-15 05:17:39
283d735e2b7c8e2bc710cf7c646e184dd676f022...8ccb3cbdbaa7302f9f1745b3878e604f8edaa073,1,6,13,19,2,2012-06-15 16:34:27,2012-06-15 16:32:59
8ccb3cbdbaa7302f9f1745b3878e604f8edaa073...a111390c566c61074e4452481abf190fd955fa30,1,1,19,20,1,2012-06-15 16:44:37,2012-06-15 15:41:36
a111390c566c61074e4452481abf190fd955fa30...c6185c8484b123f552c8af8bcaec21cf3d725559,11,171,131,302,81,2012-06-15 16:44:37,2012-06-06 19:05:18
c6185c8484b123f552c8af8bcaec21cf3d725559...1e0ce5d1bdf364bf6eca821635e3ae8e65807667,9,43,19,62,31,2012-06-15 16:49:05,2012-06-12 19:53:08
1e0ce5d1bdf364bf6eca821635e3ae8e65807667...911b0fddd3483ac58c3a5cec17f4f1b0e533521a,182,1427,2385,3812,355,2012-06-15 17:00:30,2012-06-15 17:00:30
79d77cfd818286cb6594dd380ace3d3f83873c94...1285cd9011159fda80c63996599c900c18f9a11c,1,2,2,4,1,2012-06-06 16:58:46,2012-06-06 16:58:46
1285cd9011159fda80c63996599c900c18f9a11c...f9abf5e0e22974bd14c1dc792b0ae41ff6e6475c,1,2,2,4,2,2012-06-06 22:01:47,2012-06-06 22:01:31
f9abf5e0e22974bd14c1dc792b0ae41ff6e6475c...f48223666554e67421e77afe30c9c0368c361eb9,1,3,1,4,1,2012-06-07 17:44:31,2012-06-07 17:44:31
f48223666554e67421e77afe30c9c0368c361eb9...bb2ce1a108b3c852a413c641bd021c9c25598d34,1,2,6,8,2,2012-06-12 13:57:27,2012-06-11 21:46:17
bb2ce1a108b3c852a413c641bd021c9c25598d34...eef57dddf4518e378551f2d016760ba2a0007ec2,50,136,136,272,75,2012-06-18 00:35:14,2012-06-18 00:35:14
eef57dddf4518e378551f2d016760ba2a0007ec2...dd1c3d72e254f7879a00104847c68f7f2f66ed1b,1,1,1,2,1,2012-06-19 00:23:19,2012-06-16 03:12:56
dd1c3d72e254f7879a00104847c68f7f2f66ed1b...8a946c2ee7aba1722aab9773bbf8534d063870e4,4,156,41,197,25,2012-06-23 17:03:12,2012-06-23 17:03:12
8a946c2ee7aba1722aab9773bbf8534d063870e4...ae5a209b114508ec4290ab31b37ef3a34bdab15a,396,8641,4122,12763,1187,2012-07-10 23:16:25,2012-07-10 23:16:25
ae5a209b114508ec4290ab31b37ef3a34bdab15a...17061d981ec60560add368ed6921d5184001cda0,1,0,1,1,1,2012-07-10 23:16:43,2012-07-10 23:16:43
17061d981ec60560add368ed6921d5184001cda0...952e513379169ec1b40909d1db056e9bf4294899,2,17,2,19,2,2012-07-10 23:25:12,2012-07-10 23:25:12
952e513379169ec1b40909d1db056e9bf4294899...b6e916db587f4f2f237e440eb0cebe06f3a3c717,1,2,2,4,1,2012-07-11 17:15:03,2012-07-11 17:15:03
911b0fddd3483ac58c3a5cec17f4f1b0e533521a...1f93aa5d5d207e8bd739d365dbf9ad6dbcc69571,4,42,4,46,5,2012-06-15 19:10:43,2012-06-15 19:10:43
d2e40f66cc21d38d1c887b45143b6b9de468b903...202df30aabc78fa571cf77ad93146b3c4d99fc6e,3,14,11,25,5,2012-07-12 14:17:25,2012-07-12 13:42:44
202df30aabc78fa571cf77ad93146b3c4d99fc6e...c6bb361b8411132891bdbc816ceda6c147754cf6,1,11,17,28,5,2012-07-12 14:29:46,2012-07-12 14:29:43
c6bb361b8411132891bdbc816ceda6c147754cf6...5d97d727536b33dfca6fc582033aed64f921f65f,1,2,1,3,2,2012-07-12 14:56:44,2012-07-12 14:56:42
5d97d727536b33dfca6fc582033aed64f921f65f...3a6314dbe159c40aa4cd95786bf55f6dcd0580bb,3,42,0,42,3,2012-07-12 16:18:38,2012-07-12 16:16:57
3a6314dbe159c40aa4cd95786bf55f6dcd0580bb...713b9249e1e7cbc028e7e4f29ef7dd6a68e03375,2,2,9,11,7,2012-07-12 22:43:35,2012-07-12 22:40:45
713b9249e1e7cbc028e7e4f29ef7dd6a68e03375...acbfc408880a12c32ccc9d69bca91aad4e93e879,1,3,2,5,2,2012-07-12 23:57:00,2012-07-12 23:43:14
acbfc408880a12c32ccc9d69bca91aad4e93e879...9d4362403c10dd28b5644b947945f853cd354f28,291,7653,480,8133,391,2012-07-13 19:08:17,2012-07-13 18:40:38
9d4362403c10dd28b5644b947945f853cd354f28...ef1b7dd3d76d385c027909b7cc3c3e5093f30743,1,15,20,35,6,2012-07-13 19:08:17,2012-07-13 19:08:10
de2eb600b38c0a5b548cc8174416bcc7cde9e1f8...2b15cf57dda55aa2048f28f4125bfb92662c960e,1,2,2,4,1,2012-06-15 19:47:08,2012-06-15 19:47:08
2b15cf57dda55aa2048f28f4125bfb92662c960e...c49f3b5df6917a30b5bb9b84113a990548558c43,1,5,3,8,3,2012-06-15 19:50:37,2012-06-15 19:50:37
c49f3b5df6917a30b5bb9b84113a990548558c43...145612c2f51e4dfa536f6d1a538ab600aad69e52,1,2,2,4,1,2012-06-16 15:38:47,2012-06-16 01:58:27
145612c2f51e4dfa536f6d1a538ab600aad69e52...bdd57f075631381e5ccff74dd78055f206b65f4d,1,11,0,11,1,2012-06-16 15:51:33,2012-06-16 15:51:33
bdd57f075631381e5ccff74dd78055f206b65f4d...8d5c1201f24a6102d047bd7ec70f30da70a5ea64,2,89,0,89,2,2012-06-16 16:00:20,2012-06-15 21:21:36
8d5c1201f24a6102d047bd7ec70f30da70a5ea64...bc18bf4ec0f0c3349920c05b59e51900f8e5276e,1,31,0,31,1,2012-06-16 16:05:28,2012-06-16 16:05:28
bc18bf4ec0f0c3349920c05b59e51900f8e5276e...8a068ce849f683752dd4df9a41237f3ea863ec21,1,1,1,2,1,2012-06-16 16:43:04,2012-06-16 06:19:31
8a068ce849f683752dd4df9a41237f3ea863ec21...e74a733024ba96d8ebf2b7d088030730fc8e18dd,1,4,2,6,2,2012-06-16 17:19:34,2012-06-16 17:19:34
e74a733024ba96d8ebf2b7d088030730fc8e18dd...3a5798b0971467bea8b72a03892121a410e2ff3b,1,38,38,76,11,2012-06-16 17:43:17,2012-05-16 14:10:31
3a5798b0971467bea8b72a03892121a410e2ff3b...91bf18fcc5340262d0672dbebcc1a34bc4a8cd95,3,81,0,81,4,2012-06-16 17:56:49,2012-04-25 14:39:52
91bf18fcc5340262d0672dbebcc1a34bc4a8cd95...a90bc78534d94940a6b726c01cf8427c296b4c63,3,0,81,81,4,2012-06-16 18:02:49,2012-06-16 18:02:49
a90bc78534d94940a6b726c01cf8427c296b4c63...55ef9ef6809d97e9c0c65d2b8f55d993bd8c5f13,2,0,89,89,2,2012-06-16 18:14:21,2012-06-16 18:14:21
55ef9ef6809d97e9c0c65d2b8f55d993bd8c5f13...41421ff9da1288aa241a5e9dcf915b685ade1c23,1,6,1,7,2,2012-06-16 23:26:16,2012-06-16 21:23:17
41421ff9da1288aa241a5e9dcf915b685ade1c23...d614d161c7f1ac340251271e911cd4752c158d38,1,9,2,11,1,2012-06-16 23:26:22,2012-06-16 22:50:22
d614d161c7f1ac340251271e911cd4752c158d38...b0b707cb6e48fd0393c24c80c9fe490855d24f84,141,1620,485,2105,211,2012-06-17 19:04:35,2012-06-17 19:04:35
b0b707cb6e48fd0393c24c80c9fe490855d24f84...71a2a2caa69865add8065cb0e282096e3f4d78f6,2,51,0,51,2,2012-06-17 20:00:00,2012-06-16 01:52:31
71a2a2caa69865add8065cb0e282096e3f4d78f6...3db2e034c44ccf6ef10aa8d648f8230f60272595,1,2,1,3,2,2012-06-17 20:07:20,2012-06-17 09:50:40
3db2e034c44ccf6ef10aa8d648f8230f60272595...6d70a4ae162e0f364c45ac2ad6d008bf99aae47f,2,9,2,11,3,2012-06-17 20:14:11,2012-05-22 09:06:05
6d70a4ae162e0f364c45ac2ad6d008bf99aae47f...ae5b0e1fc190118957e2eaa4f4c71424adbf9c6e,2,50,0,50,2,2012-06-17 20:59:31,2012-06-17 20:14:20
ae5b0e1fc190118957e2eaa4f4c71424adbf9c6e...ff552ddbaa3cde93301f5227c95971ddd02682ef,2,11,8,19,10,2012-06-18 02:31:40,2012-06-18 02:05:21
ff552ddbaa3cde93301f5227c95971ddd02682ef...f80513974ec525fe8e1a3aab7054af167d862d99,1,5,5,10,5,2012-06-18 13:13:39,2012-06-18 13:13:37
f80513974ec525fe8e1a3aab7054af167d862d99...1b7d23e81e9c4d507e96558c52c2a3962f0cd39f,1,25,16,41,7,2012-06-18 13:36:26,2012-06-18 13:35:40
1b7d23e81e9c4d507e96558c52c2a3962f0cd39f...30ab1f567d6dda2f1e6d48bd96a9034406b3c2b1,1,1,1,2,1,2012-06-18 13:58:43,2012-06-18 13:58:43
30ab1f567d6dda2f1e6d48bd96a9034406b3c2b1...057b80611f977789f6c1334fdf3680c105af364e,18,497,23,520,36,2012-06-18 21:03:11,2012-06-18 20:57:29
057b80611f977789f6c1334fdf3680c105af364e...0a89e8b838caf0769807c4e9a665a70d2e63b032,2,2,33,35,2,2012-06-18 21:46:28,2012-06-18 21:27:21
0a89e8b838caf0769807c4e9a665a70d2e63b032...d0111aa0c45d2735080d7a177470839af767f7f2,1,7,2,9,3,2012-06-18 21:51:41,2012-06-18 21:51:41
d0111aa0c45d2735080d7a177470839af767f7f2...0ef6cfd39beb4620989e77e84ecb0aefdc2d4302,1,8,0,8,2,2012-06-18 21:52:12,2012-06-18 17:18:49
0ef6cfd39beb4620989e77e84ecb0aefdc2d4302...196207c2280770d649755ec923f56befc2650d80,5,1,54,55,7,2012-06-18 21:56:42,2012-06-18 18:42:47
196207c2280770d649755ec923f56befc2650d80...de65ba7aba0e48a846e8cad86278f51372d3de23,2,48,0,48,4,2012-06-18 22:17:20,2012-06-18 22:17:20
de65ba7aba0e48a846e8cad86278f51372d3de23...1df222f179f3c7e6181a319ecc90a1e0fb0a2975,1,0,2,2,2,2012-06-18 23:04:36,2012-06-18 23:04:36
1df222f179f3c7e6181a319ecc90a1e0fb0a2975...f405517de1273bdf8493bc8a1e1294ded026c93a,3,257,1,258,3,2012-06-19 00:15:29,2012-06-18 15:18:03
f405517de1273bdf8493bc8a1e1294ded026c93a...1b22f5376bd8b9276030333558136f4bfab05745,3,75,1,76,3,2012-06-19 00:15:29,2012-06-18 23:56:55
1b22f5376bd8b9276030333558136f4bfab05745...5cfe0b86d5be266ef51bbba369c39e412ee51944,1,1,1,2,1,2012-06-19 00:48:16,2012-06-19 00:46:39
5cfe0b86d5be266ef51bbba369c39e412ee51944...10fa526fa037295165f7e179c7a0648a7c729009,1,5,0,5,1,2012-06-19 01:08:45,2012-06-19 01:07:43
10fa526fa037295165f7e179c7a0648a7c729009...edb62dd9023e0660bcb2d1939c709024f1fa15ca,125,623,271,894,185,2012-06-19 01:08:48,2012-06-19 01:08:21
edb62dd9023e0660bcb2d1939c709024f1fa15ca...7de6eba0616c9333566e0fb815b589a4e4536b49,2,45,47,92,2,2012-06-19 11:51:00,2012-06-19 11:50:58
7de6eba0616c9333566e0fb815b589a4e4536b49...8966480c0e332ecea5c39d4e42e36fa400b0a629,1,5,5,10,5,2012-06-19 15:50:34,2012-06-19 15:48:07
8966480c0e332ecea5c39d4e42e36fa400b0a629...bf682afb987f15e7522c74453a8f3165f001ca02,1,2,1,3,1,2012-06-19 15:56:49,2012-06-18 10:51:23
bf682afb987f15e7522c74453a8f3165f001ca02...f94b85db83630e95ea1744ecfcff76c6157d3d1c,5,14,66,80,10,2012-06-19 15:56:50,2012-06-15 11:53:09
f94b85db83630e95ea1744ecfcff76c6157d3d1c...7282ce9014a4d17297f5d0395aa60461d4a14823,1,0,2,2,2,2012-06-19 15:56:51,2012-06-18 08:28:32
7282ce9014a4d17297f5d0395aa60461d4a14823...8a6ef65c2c8b39a040c6566bc91841989803631d,2,68,45,113,15,2012-06-19 15:56:52,2012-06-18 11:16:02
8a6ef65c2c8b39a040c6566bc91841989803631d...6ba1c625cde5f30f500e61583764be57c905c035,105,160,110,270,113,2012-06-19 16:53:26,2012-06-19 16:53:03
6ba1c625cde5f30f500e61583764be57c905c035...5e1d844f3ddfd0a8acbad4a263ae128de4b03eea,1,9,6,15,2,2012-06-19 18:48:02,2012-06-19 17:20:36
5e1d844f3ddfd0a8acbad4a263ae128de4b03eea...3f687dbddf4d725e9f9faf560a665c4256480681,1,1,0,1,1,2012-06-19 19:12:48,2012-06-19 19:12:48
3f687dbddf4d725e9f9faf560a665c4256480681...067be2b3fe2723215dea3a5ac3b25eb36d6ca987,2,10,1,11,4,2012-06-19 21:04:59,2012-06-19 20:24:09
ef1b7dd3d76d385c027909b7cc3c3e5093f30743...8721667a2fc0750b644d4fddc78dd12ed8a81d4e,2,1,1,2,1,2012-07-13 21:09:06,2012-06-24 02:03:00
8721667a2fc0750b644d4fddc78dd12ed8a81d4e...23dc0992995fb1307d516e6c6f33439da8bc112b,1,86,0,86,1,2012-07-13 23:43:34,2012-07-13 23:43:34
23dc0992995fb1307d516e6c6f33439da8bc112b...19aa05fab89c70c4416efc36d689b460333cee2f,1,1,1,2,1,2012-07-16 00:27:01,2012-07-13 21:18:52
19aa05fab89c70c4416efc36d689b460333cee2f...d6b78d0e3769e4af1b1a60e89f53faf20e4bb2b3,2,48,0,48,3,2012-07-17 01:04:55,2012-07-16 23:38:11
067be2b3fe2723215dea3a5ac3b25eb36d6ca987...41d5fefc10ac238c74c6c47fe5f6eee728d205c8,1,0,0,0,0,2012-06-19 21:51:38,2012-06-19 21:42:04
41d5fefc10ac238c74c6c47fe5f6eee728d205c8...3795d771135309bff5f169111b6efdec1aef6c32,2,8,0,8,2,2012-06-19 22:53:01,2012-06-19 22:53:01
3795d771135309bff5f169111b6efdec1aef6c32...7a4dfb6aa8544805a638bf59d07648b1b6ce8142,1,2,2,4,2,2012-06-19 22:56:33,2012-06-19 22:56:33
7a4dfb6aa8544805a638bf59d07648b1b6ce8142...26b11915b1c16440468a4b5f4b07d2409b98c68c,1,18,3,21,3,2012-06-19 23:07:57,2012-06-19 23:07:57
067be2b3fe2723215dea3a5ac3b25eb36d6ca987...252f034b30b3bf9b0c38d683725868d899209870,1,1,1,2,1,2012-06-19 21:07:48,2012-06-19 01:22:34
252f034b30b3bf9b0c38d683725868d899209870...f105f2f2fd105a28e56f112bf759ae7f18743c4c,2,2,2,4,2,2012-06-19 21:07:48,2012-06-19 18:07:59
f105f2f2fd105a28e56f112bf759ae7f18743c4c...a72120190a8ffdbcd3d6ad2a2e6ceecd2087111e,2,40,2,42,2,2012-06-19 21:07:49,2012-06-19 01:28:31
d6b78d0e3769e4af1b1a60e89f53faf20e4bb2b3...c383befd257f451a12ccd4454784941f1bb9c41a,182,973,416,1389,225,2012-07-17 18:37:39,2012-07-17 18:37:39
c383befd257f451a12ccd4454784941f1bb9c41a...7397ab2cf13555a9f0aa3ccc50f9e76fc54fdcec,11,176,152,328,22,2012-07-17 18:40:13,2012-07-17 18:40:13
7397ab2cf13555a9f0aa3ccc50f9e76fc54fdcec...a0a0062d612cf76f8161af3be7896bd15a2682a1,7,78,56,134,17,2012-07-17 18:43:02,2012-07-17 18:43:02
a0a0062d612cf76f8161af3be7896bd15a2682a1...868ffed77c5745a13627d4e083929d014d07c1a6,1,3,8,11,5,2012-07-17 18:44:01,2012-07-17 18:44:01
868ffed77c5745a13627d4e083929d014d07c1a6...648fdc56a044dcdbbdd9d830eae064715c3c41ef,1,1,1,2,1,2012-07-17 22:56:02,2012-07-17 22:25:11
648fdc56a044dcdbbdd9d830eae064715c3c41ef...e1fb7b76e99a2e26bc5169e49f7ded3b41b21f8a,1,8,1,9,1,2012-07-18 00:09:34,2012-07-18 00:09:34
e1fb7b76e99a2e26bc5169e49f7ded3b41b21f8a...e8af3405574dfee2cb8c11bf27195b774332db96,1,12,3,15,2,2012-07-18 01:46:39,2012-07-18 00:13:55
e8af3405574dfee2cb8c11bf27195b774332db96...f6f2d42ee95e1cd0900af62a3cfe7d31c1ed8e62,1,16,7,23,6,2012-07-18 11:56:09,2012-07-18 11:32:26
f6f2d42ee95e1cd0900af62a3cfe7d31c1ed8e62...beb7425c186c405b7fbe4332435a9b552753b561,1,1,1,2,1,2012-07-18 12:23:39,2012-07-18 12:23:39
beb7425c186c405b7fbe4332435a9b552753b561...98b1ce91f6ab65b88b759e7ada18133b9257b203,1,2,0,2,1,2012-07-18 21:26:00,2012-07-18 21:26:23
98b1ce91f6ab65b88b759e7ada18133b9257b203...5a5e128165e85e15843f21d4ca01c8765323b030,2,1,5,6,3,2012-07-18 22:08:37,2012-07-18 22:08:35
5a5e128165e85e15843f21d4ca01c8765323b030...b2648934f013ccdf1a15bb74a5480d5a42a97943,1,14,7,21,2,2012-07-19 16:20:34,2012-07-19 16:20:34
db59c84ba0cfea9d85d9210679f44a2ce556daae...b8d861556a4438f63295bdd05e5c2894b3a2fe0e,1,0,50,50,1,2012-07-16 23:28:34,2012-07-14 00:28:49
b8d861556a4438f63295bdd05e5c2894b3a2fe0e...ff140075738dc29392165b5bdfe8f011dca97f1e,3,51,5,56,7,2012-07-17 01:32:03,2012-07-16 21:50:15
fbc2ad5815bf64158734f74ff30cf986053edb0d...e4017402ef8c786fae1a6162256c5e56ad45d673,1,3,3,6,1,2012-06-20 00:03:12,2012-06-20 00:03:12
e4017402ef8c786fae1a6162256c5e56ad45d673...7887e68ff752260d061d8cdc68dfcece2f6a150d,1,73,17,90,9,2012-06-20 02:23:32,2012-06-20 01:32:55
7887e68ff752260d061d8cdc68dfcece2f6a150d...1d3d02c70dffb29e9c80a35fe9f791b357a1dccf,2,57,2,59,3,2012-06-20 17:28:44,2012-06-20 17:28:44
1d3d02c70dffb29e9c80a35fe9f791b357a1dccf...fe464a2fea93880a7da883138f83a2ae8ad6a30f,3,5,5,10,5,2012-06-20 20:38:30,2012-06-20 20:31:49
fe464a2fea93880a7da883138f83a2ae8ad6a30f...6b26583e8450e837886b84610305698fa447fa7e,22,182,44,226,40,2012-06-20 22:33:44,2012-06-20 22:33:44
6b26583e8450e837886b84610305698fa447fa7e...6b8ae8e66d84ef363780c1b1f5c87c0771fca97a,1,3,4,7,4,2012-06-20 22:35:46,2012-06-13 13:37:15
6b8ae8e66d84ef363780c1b1f5c87c0771fca97a...81a889fd888ada89eea5512a4366fdf074d9ba9c,1,2,2,4,1,2012-06-20 22:35:52,2012-06-13 13:47:28
81a889fd888ada89eea5512a4366fdf074d9ba9c...57d53a47e86c310f99e991ea0afb4a3790a54751,2,8,1,9,3,2012-06-20 23:46:04,2012-06-18 09:03:32
57d53a47e86c310f99e991ea0afb4a3790a54751...ae7a3cddae67ac3d10df8a41e1ac4b8cc2f5d2f5,4,24,23,47,13,2012-06-21 00:39:13,2012-06-21 00:39:13
ae7a3cddae67ac3d10df8a41e1ac4b8cc2f5d2f5...09150b0616906a9ce1533796ec49c4bee8841e48,2,9,21,30,6,2012-06-21 00:42:28,2012-06-20 16:15:35
09150b0616906a9ce1533796ec49c4bee8841e48...d98a8578d62cd1b35574269dc028a0c8c34ef25b,1,73,0,73,1,2012-06-21 00:50:13,2012-06-21 00:25:56
d98a8578d62cd1b35574269dc028a0c8c34ef25b...f0ce98441ff7315e6a6c268dabcec58fc37da926,8,52,63,115,31,2012-06-21 01:05:18,2012-06-16 20:41:37
f0ce98441ff7315e6a6c268dabcec58fc37da926...ef1ffcb717aa16549eb4380badb9709aca3aeb46,3,14,34,48,15,2012-06-21 13:03:21,2012-06-21 13:03:21
ef1ffcb717aa16549eb4380badb9709aca3aeb46...8708bb028034d66ded3bd386e9b8e6d50fb9d5af,1,1,2,3,1,2012-06-21 13:03:49,2012-06-21 13:03:49
8708bb028034d66ded3bd386e9b8e6d50fb9d5af...1bf704a571b73d0d6dc6d2d488432c2f6ebf3890,1,2,0,2,1,2012-06-21 15:55:05,2012-06-21 15:55:05
1bf704a571b73d0d6dc6d2d488432c2f6ebf3890...6e5217d3208f6792a500fc408b4dcef0a17c5412,1,2,2,4,2,2012-06-21 18:52:38,2012-06-21 18:52:11
6e5217d3208f6792a500fc408b4dcef0a17c5412...260695afd07067254a704c050243d2e619bae8b7,1,4,4,8,2,2012-06-21 19:05:33,2012-06-21 17:04:21
260695afd07067254a704c050243d2e619bae8b7...5b39929d47f962fccafb4116f3c177ddc4fd3269,11,153,76,229,32,2012-06-21 19:05:33,2012-06-21 18:42:33
5b39929d47f962fccafb4116f3c177ddc4fd3269...48c3d2004180dda8d0d32386299dd918a0804389,4,10,4,14,6,2012-06-21 19:29:33,2012-06-21 19:20:23
48c3d2004180dda8d0d32386299dd918a0804389...8988af58f4126783eabaacfcaf6d158cf92b8d99,3,3,3,6,3,2012-06-21 20:55:40,2012-06-21 20:39:54
8988af58f4126783eabaacfcaf6d158cf92b8d99...fce7c958ed42664923161c48bab36700631cefd2,1,1,0,1,1,2012-06-21 21:47:25,2012-06-21 21:47:25
b2648934f013ccdf1a15bb74a5480d5a42a97943...0c91b0e48e0358cea2e52857275ca5880bf47a54,8,164,124,288,19,2012-07-19 16:33:02,2012-07-19 16:29:29
b2648934f013ccdf1a15bb74a5480d5a42a97943...845b9e92d8c12c42777495e7cb9aa1a458a982e2,8,164,124,288,19,2012-07-19 16:32:46,2012-07-19 16:29:29
845b9e92d8c12c42777495e7cb9aa1a458a982e2...60bf2d6cb33e4ce55604f73889ab840a9de8bdab,3,40,2,42,3,2012-07-19 17:01:56,2012-07-17 19:02:57
8973c3d2b6432f3dc1b00314f34c11f44b9ec072...0109a9f90acdfdb287436676f2384f7b072fbb6a,2,53,39,92,15,2012-07-17 01:45:14,2012-07-17 00:29:06
0109a9f90acdfdb287436676f2384f7b072fbb6a...4e5fe2d45aef5aacf4a6c6c2db28f0b9cc64f123,3,113,21,134,9,2012-07-17 04:05:10,2012-07-14 01:00:49
4e5fe2d45aef5aacf4a6c6c2db28f0b9cc64f123...19ecc17e6b6ed9c883a6cc939f0f3211c6dbc37c,2,7,1,8,3,2012-07-17 04:05:26,2012-07-16 18:45:12
19ecc17e6b6ed9c883a6cc939f0f3211c6dbc37c...a52a44e07299f2b46bd88f73c543828af52e60d0,1,89,16,105,14,2012-07-17 14:13:11,2012-07-14 01:11:38
a52a44e07299f2b46bd88f73c543828af52e60d0...430d94ef85f2786522671317ccbd034ef921ae14,4,109,7,116,8,2012-07-19 17:29:15,2012-07-17 15:17:34
fce7c958ed42664923161c48bab36700631cefd2...5ec056633f4ce1a19058dbb55a24e9d0dff3c183,2,56,0,56,2,2012-06-21 23:16:30,2012-06-21 23:03:48
fce7c958ed42664923161c48bab36700631cefd2...af52bc4fe679303ca4155ea5860a38565bf1fa51,1,8,1,9,1,2012-06-21 23:06:06,2012-06-21 23:02:43
4439f7b879ae5ebf5727304b9d3fc87417e104fa...02ff9741cce9185c6cacc23baba407401e16d78c,1,2,2,4,1,2012-07-19 17:19:45,2012-07-19 17:19:45
02ff9741cce9185c6cacc23baba407401e16d78c...f6484842b37d515b32e32e4e3bd33274154565a3,1,71,0,71,1,2012-07-19 17:20:44,2012-07-19 17:20:44
f6484842b37d515b32e32e4e3bd33274154565a3...d9057cc090b8e98fa35533ccf61ec3bfd7002955,102,108,110,218,106,2012-07-19 20:03:28,2012-07-19 20:03:28
3c998945aad4e5295452747c96f48a222e7b62f8...b0950cbea282024a21c735ba20803ac8b05e0b48,2,21,15,36,3,2012-07-19 20:43:41,2012-07-16 17:41:26
b0950cbea282024a21c735ba20803ac8b05e0b48...2b3ba3f538e9ff22cdb4172799ee38d06818165f,2,19,11,30,12,2012-07-19 20:45:10,2012-07-11 19:53:27
2b3ba3f538e9ff22cdb4172799ee38d06818165f...8ba189b8d32e3c6489e142101d3e37dcbc551179,4,305,13,318,11,2012-07-19 20:53:36,2012-07-11 19:54:20
8ba189b8d32e3c6489e142101d3e37dcbc551179...0cf235410dfa621668c34b5e70c6b7fb2dab2787,2,7,4,11,2,2012-07-20 16:47:05,2012-07-20 16:47:05
0cf235410dfa621668c34b5e70c6b7fb2dab2787...93d496a4ec029d13928e19aada428d2ef462e5ae,2,4,2,6,2,2012-07-20 17:13:54,2012-07-20 17:10:23
93d496a4ec029d13928e19aada428d2ef462e5ae...1ccdde9a6986e7e258e9aa0de10ca51fc0c5a9d4,2,11,17,28,12,2012-07-20 17:48:56,2012-07-20 16:51:02
1ccdde9a6986e7e258e9aa0de10ca51fc0c5a9d4...92e7433ff9f7e7bf051073978309ec392e329397,2,6,3,9,5,2012-07-20 17:48:59,2012-07-20 17:43:12
92e7433ff9f7e7bf051073978309ec392e329397...85185bbbaa9e99bd77232f529687e9fa5d26af78,1,6,7,13,2,2012-07-20 18:07:16,2012-07-20 18:07:16
85185bbbaa9e99bd77232f529687e9fa5d26af78...e16d506a58d46619c05b08f3f8ef4d5491b18b69,59,1970,2144,4114,296,2012-07-20 18:08:36,2012-07-20 17:01:46
c6f7fd7e47ac396f2356e05c1a418ff60b7bdea4...ddf52bd3473edd2d017e2eaeb2a95cd8611bfe3f,28,1460,0,1460,28,2012-06-21 23:18:17,2012-06-20 05:13:22
ddf52bd3473edd2d017e2eaeb2a95cd8611bfe3f...8f1a38d916326e37bc830a5c56c5d42866c8c423,166,11944,41,11985,184,2012-06-21 23:18:17,2012-06-20 17:14:45
d9057cc090b8e98fa35533ccf61ec3bfd7002955...1fa0bca2ad58ad1d91557f8ae7f467370c0290d6,2,21,15,36,3,2012-07-19 21:49:30,2012-07-16 17:41:26
1fa0bca2ad58ad1d91557f8ae7f467370c0290d6...53716eb0b5338999761d115fad9d392077836e63,2,19,11,30,12,2012-07-19 21:49:30,2012-07-11 19:53:27
53716eb0b5338999761d115fad9d392077836e63...eb2ca104628e415fc73c330cdd76fca77bf5ba97,4,306,13,319,11,2012-07-19 21:49:31,2012-07-11 19:54:20
eb2ca104628e415fc73c330cdd76fca77bf5ba97...e43fe5c833c941aba25bfdb6193ef41fc50ae405,2,11,17,28,12,2012-07-20 16:51:02,2012-07-20 16:51:02
e43fe5c833c941aba25bfdb6193ef41fc50ae405...4aa09d1e0e29139484e3f2c72294fd8315c9ca33,2,7,4,11,2,2012-07-20 16:51:38,2012-07-20 16:47:05
4aa09d1e0e29139484e3f2c72294fd8315c9ca33...5950db197c5ee73922beb67e3b8c060b5fcbc7f7,2,4,2,6,2,2012-07-20 17:10:23,2012-07-20 17:10:23
5950db197c5ee73922beb67e3b8c060b5fcbc7f7...50122fed8ae29c982fa4c806136c4b24dd2de382,2,6,3,9,5,2012-07-20 17:43:12,2012-07-20 17:43:12
50122fed8ae29c982fa4c806136c4b24dd2de382...42c6952edb5cfccd708bea8a9a6c02c67641a314,1,6,7,13,2,2012-07-20 18:07:39,2012-07-20 18:07:16
42c6952edb5cfccd708bea8a9a6c02c67641a314...bc30c90af65c482971901c7ec6980172d5f54849,1,0,12,12,1,2012-07-21 17:33:06,2012-07-21 17:33:06
bc30c90af65c482971901c7ec6980172d5f54849...e06b5d7af7619e9234bb7eb8a9d66b3c7d245ad9,1,0,2,2,2,2012-07-23 09:35:52,2012-07-23 02:08:13
e06b5d7af7619e9234bb7eb8a9d66b3c7d245ad9...688859afc09307d358b3f160cdd9aff2d2ce6c6f,1,24,0,24,2,2012-07-23 11:15:51,2012-07-03 19:21:37
688859afc09307d358b3f160cdd9aff2d2ce6c6f...43a0c8811627ea224bb18ba3c72b91ca2c4ea8d7,2,68,2,70,3,2012-07-23 11:55:42,2012-07-23 09:26:03
e16d506a58d46619c05b08f3f8ef4d5491b18b69...f9b237f478c372fd55e4590d7399dcd8f25f3603,3,26,2,28,3,2012-07-20 18:08:53,2012-07-19 21:27:31
9df5fda777ba265c3ffac90cb6d0fd60ed77f796...38250f9aef7bca4b6ab5069af19a7fe05df982ab,1,1,1,2,1,2012-06-22 00:09:45,2012-06-21 23:46:31
38250f9aef7bca4b6ab5069af19a7fe05df982ab...ff2a1b86c31d481917b942ff62492365b7801cd1,3,8,3,11,3,2012-06-22 02:15:03,2012-06-22 02:15:03
ff2a1b86c31d481917b942ff62492365b7801cd1...6014a62b3ec97557c60e6fa0d30d4cd6879820bb,1,1,1,2,1,2012-06-22 02:20:09,2012-06-22 02:20:09
6014a62b3ec97557c60e6fa0d30d4cd6879820bb...441e7928492b73b21b7d1d9dced4ee4537fc90c4,1,2,2,4,2,2012-06-22 02:36:17,2012-06-22 02:36:17
441e7928492b73b21b7d1d9dced4ee4537fc90c4...de89bbb00cb202bf0d71e505fcfc01709689f51f,1,5,5,10,3,2012-06-22 02:45:11,2012-06-22 02:44:58
de89bbb00cb202bf0d71e505fcfc01709689f51f...3bab12197fe6d25f1bd0f40d5e5e83ad0d9276c8,1,10,7,17,4,2012-06-22 13:24:21,2012-06-22 13:11:17
3bab12197fe6d25f1bd0f40d5e5e83ad0d9276c8...2dccebd4b829fbc53358568c348272f1e56522ba,1,3,0,3,1,2012-06-22 13:24:21,2012-06-22 13:11:38
2dccebd4b829fbc53358568c348272f1e56522ba...399731e3a05140214713a7ba9a22a9f36faea87b,1,1,1,2,1,2012-06-22 13:24:22,2012-06-22 13:13:28
399731e3a05140214713a7ba9a22a9f36faea87b...a1b274108fc7eb961c71eef3b61e5b332a9e187d,1,4,2,6,2,2012-06-22 13:24:23,2012-06-22 13:15:44
43a0c8811627ea224bb18ba3c72b91ca2c4ea8d7...0a0002b480dc40ecd94c542d1101e87404a47692,137,1046,487,1533,234,2012-07-24 19:34:13,2012-07-24 19:34:13
0a0002b480dc40ecd94c542d1101e87404a47692...f4f0daa44d57b93135bbaad3e81b8d199f42938b,6,108,4,112,12,2012-07-24 21:18:47,2012-07-24 21:18:47
f4f0daa44d57b93135bbaad3e81b8d199f42938b...2c487669f74aabff30d85813461ae9877fe913a3,1,3,8,11,5,2012-07-24 21:19:50,2012-07-24 21:19:50
2c487669f74aabff30d85813461ae9877fe913a3...e4c9c9f412ca64435fbe93a2700d569b84ba7b36,3,39,10,49,11,2012-07-24 22:36:53,2012-07-24 03:44:12
e4c9c9f412ca64435fbe93a2700d569b84ba7b36...1513848f8801d7d1141c10c4960b6bfe47a53ed2,1,16,10,26,4,2012-07-24 22:53:22,2012-07-17 13:16:23
839dfe75706bf076dc817ec1d25f3ce2c7fd9f40...ec299a13291032ca28244713137967324a234021,1,2,2,4,1,2012-07-20 18:51:08,2012-07-20 18:51:08
ec299a13291032ca28244713137967324a234021...5bb2fe660ed87c899e00ea391dbf78784a6767c1,1,61,0,61,1,2012-07-20 18:56:14,2012-07-20 18:51:38
5bb2fe660ed87c899e00ea391dbf78784a6767c1...19d43f852e3428fe231ce662f94b154ae51254e0,4,9,0,9,4,2012-07-23 16:31:29,2012-07-13 01:25:36
19d43f852e3428fe231ce662f94b154ae51254e0...2637b5c2610ca1f9d7889ea0d572f297b2bd5b2e,2,34,0,34,3,2012-07-23 16:31:30,2012-07-13 01:26:04
2637b5c2610ca1f9d7889ea0d572f297b2bd5b2e...cd6122edebe09a66a3a1a3fd0904ffda39d9007b,1,37,5,42,5,2012-07-23 16:31:30,2012-07-13 02:19:01
cd6122edebe09a66a3a1a3fd0904ffda39d9007b...bdd1a740cb5029860a2eef20d8e9814f378d99c4,3,53,0,53,4,2012-07-23 16:31:31,2012-07-13 19:08:32
bdd1a740cb5029860a2eef20d8e9814f378d99c4...77945d7f0fa6a0629ab7006d97d2e707e0431433,5,224,0,224,5,2012-07-23 16:31:32,2012-07-13 19:11:38
a1b274108fc7eb961c71eef3b61e5b332a9e187d...c40875ee13d8bab0b909e917a12282b06b892037,1,1,1,2,1,2012-06-23 00:29:36,2012-06-23 00:29:36
c40875ee13d8bab0b909e917a12282b06b892037...bc73abe5a8736359ff69f75948baf61f0431c42c,2,1,1,2,1,2012-06-24 02:34:23,2012-06-24 02:03:00
bc73abe5a8736359ff69f75948baf61f0431c42c...6003912f81c4658f2bb77b33c1421a3207615744,1,3,3,6,2,2012-06-25 14:36:02,2012-06-25 14:34:59
6003912f81c4658f2bb77b33c1421a3207615744...5a2cc626b2e86fd515301e92d6303bb31af62569,1,11,5,16,5,2012-06-26 00:54:13,2012-06-26 00:54:11
a1b274108fc7eb961c71eef3b61e5b332a9e187d...5565366a33e57436be08b00c14470ecafdf16632,7,175,28,203,9,2012-06-22 14:44:40,2012-06-22 14:44:40
1513848f8801d7d1141c10c4960b6bfe47a53ed2...8656c2654e4e197ea8c2ec29b482b575dedda50a,1,10,5,15,6,2012-07-25 17:25:37,2012-07-24 23:19:08
1513848f8801d7d1141c10c4960b6bfe47a53ed2...5809426d758af04bcd55de960081316729279838,1,6,6,12,1,2012-07-25 00:05:31,2012-07-25 00:05:22
5809426d758af04bcd55de960081316729279838...7fd3cb666bd2f39e675fb766a40cf83869ea232d,1,3,0,3,1,2012-07-25 00:06:57,2012-07-25 00:06:50
7fd3cb666bd2f39e675fb766a40cf83869ea232d...f98562fcd7d1cab573ca4dc1612157d6999befd4,3,22,2,24,3,2012-07-25 00:06:58,2012-07-24 23:04:40
4f27a0822aaae0de5580d49ce97c7c6ddc490b8c...57276ae70ade5faeb0be0d26a6d6ff08d8d579ac,2,6,9,15,4,2012-06-26 01:39:34,2012-06-26 01:39:32
57276ae70ade5faeb0be0d26a6d6ff08d8d579ac...e3074689f501eea413c29b99defac29659a2b615,2,13,3,16,4,2012-06-26 16:08:40,2012-06-24 02:31:21
e3074689f501eea413c29b99defac29659a2b615...42ea37afb2b6e8cf6cd2aad36b7106be87e89e4a,1,2,2,4,1,2012-06-26 16:13:59,2012-06-26 16:13:59
42ea37afb2b6e8cf6cd2aad36b7106be87e89e4a...6d98524609d5c0a1445f71b9930ff81c48c749be,41,3196,3434,6630,229,2012-06-28 00:33:12,2012-06-21 00:54:06
6d98524609d5c0a1445f71b9930ff81c48c749be...60ff789618b5d61650609c7df27359ed3a609cc2,1,11,26,37,5,2012-06-28 00:33:12,2012-06-21 01:02:49
60ff789618b5d61650609c7df27359ed3a609cc2...e7e34ddb66f61d123f00a173e6a7b196d567c9d0,1,20,2,22,4,2012-06-28 01:17:47,2012-06-18 05:16:16
e7e34ddb66f61d123f00a173e6a7b196d567c9d0...2d0011f53256e7a1a707a6672772d36260f81691,42,3460,3207,6667,234,2012-06-28 02:14:43,2012-06-28 02:14:24
5565366a33e57436be08b00c14470ecafdf16632...d34fea59e1b72d5da60ca97f3decb84f5ed87ef1,3,60,5,65,9,2012-06-22 15:49:20,2012-06-22 15:49:20
d34fea59e1b72d5da60ca97f3decb84f5ed87ef1...2603cc564da0184da10d36e2fb19625c5ae54893,1,5,0,5,1,2012-06-22 16:04:14,2012-06-22 16:04:14
2603cc564da0184da10d36e2fb19625c5ae54893...1b114162ab451b04604cc3fa2c88c1592e432b94,2,130,57,187,18,2012-06-22 18:53:04,2012-06-22 18:51:21
1b114162ab451b04604cc3fa2c88c1592e432b94...839bf025a8cd2c89dced086a20aa8b75c4fcfbea,7,65,75,140,26,2012-06-23 18:54:51,2012-06-23 09:31:26
5565366a33e57436be08b00c14470ecafdf16632...91835966eb00e912c8cb7a9942f369b0e640368b,102,126,105,231,112,2012-06-22 14:45:21,2012-06-21 23:44:22
91835966eb00e912c8cb7a9942f369b0e640368b...38250f640322a6cdbdfc818baa7a17006bbfc896,98,102,101,203,102,2012-06-22 22:14:12,2012-06-22 22:13:11
38250f640322a6cdbdfc818baa7a17006bbfc896...9a7158de18abe1d423d3e12b97f79a628e4a8dbd,1,1,1,2,1,2012-06-25 14:37:19,2012-06-25 14:37:07
9a7158de18abe1d423d3e12b97f79a628e4a8dbd...8b8a7a7f9b41e74e1e810d0330738ad06fc302ec,2,29,2,31,2,2012-06-25 14:37:20,2012-06-20 17:44:15
32141844f16e1493c1ae557e9db02a376dc70bc0...3d34590fbacafe0c99ab47ddf34b701f6ab3afad,1,2,2,4,1,2012-07-25 17:28:03,2012-07-25 17:28:03
3d34590fbacafe0c99ab47ddf34b701f6ab3afad...b207e24bcd168a5ca538476ee0b3b0960cdc6759,1,59,0,59,1,2012-07-25 17:38:41,2012-07-25 17:38:41
b207e24bcd168a5ca538476ee0b3b0960cdc6759...9eddaebb79ff1954b7ecdb209587d7db6554580d,1,2,4,6,2,2012-07-25 17:41:08,2012-07-25 17:34:13
9eddaebb79ff1954b7ecdb209587d7db6554580d...b0c0111b04201bf99fde0fe0616b9fdf1f33655d,2,231,3,234,6,2012-07-25 20:38:43,2012-07-25 19:00:25
e5498331f443fc8bd4dcf82f2a41e669dfe66cc9...59b584c92ddfe26430fdb4756737dd723dbee0b0,1,2,22,24,5,2012-07-26 20:32:06,2012-07-26 11:19:14
59b584c92ddfe26430fdb4756737dd723dbee0b0...332fea5ac1816e498030109c4211bca24a7fa667,1,29,41,70,8,2012-07-26 21:55:25,2012-07-09 15:53:48
332fea5ac1816e498030109c4211bca24a7fa667...105c6ec8d596be2b7cc95339923ca38ea614f54e,1,5,4,9,3,2012-07-26 21:55:29,2012-07-09 15:57:40
105c6ec8d596be2b7cc95339923ca38ea614f54e...edd3de8feaed468be7be2dfcbeb60aa3c94d65f7,4,68,16,84,8,2012-07-26 21:55:29,2012-07-09 16:05:46
edd3de8feaed468be7be2dfcbeb60aa3c94d65f7...2a30d328fa97eccef80256436f13651adadae4e4,2,96,101,197,22,2012-07-26 22:02:36,2012-07-25 23:45:04
2a30d328fa97eccef80256436f13651adadae4e4...c3d4c3560ea966149db39a889cb682d0fbf982ca,1,2,2,4,2,2012-07-26 22:55:35,2012-07-26 22:55:33
c3d4c3560ea966149db39a889cb682d0fbf982ca...f69234703f7b6aab71f312205fa2a269f7bbbdd1,1,9,17,26,4,2012-07-26 23:19:03,2012-07-26 23:06:12
f69234703f7b6aab71f312205fa2a269f7bbbdd1...20e12e4be37f394672c001fdb9b05c0275731901,3,53,17,70,4,2012-07-27 18:28:51,2012-07-20 17:51:45
20e12e4be37f394672c001fdb9b05c0275731901...c05f52c254a070f8b58f12b37687d4e40a0edb8e,1,2,2,4,2,2012-07-28 23:28:50,2011-04-14 23:56:09
ba0efd6de0628a835e77ab490ecfb5e53ab71273...0581afe531e5fa39d29c59ac5b3dcb323208375d,2,3,13,16,4,2012-06-29 15:03:37,2012-06-29 15:03:37
0581afe531e5fa39d29c59ac5b3dcb323208375d...fee02db705152a42c8db442d3ab76b2296e59bbd,2,13,3,16,4,2012-06-29 15:29:32,2012-06-29 15:29:32
5feea97b537a785fc20cd1f2a687b4c33d891e4a...b07b39130458b86f2e295fcc833d9fa836cc70b4,1,2,2,4,1,2012-06-25 14:58:03,2012-06-25 14:58:03
b07b39130458b86f2e295fcc833d9fa836cc70b4...782347402212e03dae5766ae6d064f018f46bcc2,1,381,0,381,1,2012-06-25 14:59:14,2012-06-25 06:02:00
782347402212e03dae5766ae6d064f018f46bcc2...d7825b3c1decd31556d583283a988ef2a7c8a248,2,2,0,2,2,2012-06-25 16:07:57,2012-05-26 04:56:41
d7825b3c1decd31556d583283a988ef2a7c8a248...3f932c52b0c04154f0e856da3b177d849b132c64,1,1,1,2,1,2012-06-25 16:40:12,2012-06-25 16:40:12
3f932c52b0c04154f0e856da3b177d849b132c64...41a4b734d3daed6beb6797ad17a563a75a3930d9,1,0,0,0,0,2012-06-25 16:40:48,2012-06-25 16:40:48
41a4b734d3daed6beb6797ad17a563a75a3930d9...3d51646c4b9e10ccfe901cd48020b32f72bc3b03,1,6,2,8,2,2012-06-25 21:17:18,2012-06-25 16:53:35
3d51646c4b9e10ccfe901cd48020b32f72bc3b03...74872b0dc9c45e9f87f748d70c5d6d3e53f9b560,5,84,10,94,10,2012-06-26 00:03:24,2012-06-26 00:03:24
74872b0dc9c45e9f87f748d70c5d6d3e53f9b560...f60def5e9a72fbfe087c92ec5658d38481bd54ca,1,3,4,7,4,2012-06-26 00:03:49,2012-06-13 13:37:15
f60def5e9a72fbfe087c92ec5658d38481bd54ca...07e5877144d5d719f9bab1f866affb02deb23a0d,1,11,5,16,5,2012-06-26 01:01:46,2012-06-26 00:54:11
b0c0111b04201bf99fde0fe0616b9fdf1f33655d...90efdb3a5b7eecb23d78cffee24c3181280efa56,1,62,6,68,5,2012-07-26 21:38:34,2012-06-23 01:39:10
90efdb3a5b7eecb23d78cffee24c3181280efa56...f70b138fcbf88e23ae5f645fa70041a7ae3f8359,1,1,0,1,1,2012-07-27 18:03:26,2012-07-27 17:56:40
f70b138fcbf88e23ae5f645fa70041a7ae3f8359...d559bed0d59c3666718b847a11a7ba42dd4de54e,1,2,2,4,2,2012-07-28 12:10:13,2012-07-28 12:10:10
d559bed0d59c3666718b847a11a7ba42dd4de54e...879d329a5a8d82d9c30e1439ff36accbf5d8a1e7,7,116,55,171,34,2012-07-28 14:50:55,2012-07-28 14:50:55
879d329a5a8d82d9c30e1439ff36accbf5d8a1e7...aa0650f4444c438d9538135a3707de3f2f313081,2,43,3,46,2,2012-07-29 00:07:16,2012-07-28 23:59:26
aa0650f4444c438d9538135a3707de3f2f313081...72bc4dcda4cfa99ed064419e40d104bd1b2e0e25,2,12,2,14,3,2012-07-29 10:48:16,2012-03-24 07:00:14
72bc4dcda4cfa99ed064419e40d104bd1b2e0e25...b3cf3f35fcf192c717e7a393fb984bf6f879d0cc,6,163,27,190,17,2012-07-30 15:21:39,2012-07-28 21:00:27
b3cf3f35fcf192c717e7a393fb984bf6f879d0cc...5b37da2ac0a7ed16e109d11899cfe0cac21fa378,1,3,3,6,3,2012-07-30 17:15:46,2012-07-30 09:26:25
5b37da2ac0a7ed16e109d11899cfe0cac21fa378...f8dab6acb60628d77b7f4438da6c76b37a93bb02,1,0,1,1,1,2012-07-30 18:01:57,2012-07-30 18:01:50
f8dab6acb60628d77b7f4438da6c76b37a93bb02...2eb6a62f4fafd6ed7aa4fa22b509686e5e910050,1,3,0,3,1,2012-07-31 01:09:49,2012-07-31 01:09:04
2eb6a62f4fafd6ed7aa4fa22b509686e5e910050...de16da532e4cff3574b2fe24d998e2dcf49fa2f0,8,0,64,64,8,2012-07-31 11:45:16,2012-07-31 11:45:16
de16da532e4cff3574b2fe24d998e2dcf49fa2f0...80ab9a891aa502458c4689dd1bf0bee7a428eae1,7,593,566,1159,274,2012-07-31 19:26:26,2012-07-31 19:26:26
80ab9a891aa502458c4689dd1bf0bee7a428eae1...9e2319f9772c9d07a3bd51cc67bd465bdb9f210d,1,1,2,3,1,2012-07-31 19:38:58,2012-07-31 19:38:58
9e2319f9772c9d07a3bd51cc67bd465bdb9f210d...2981f01b461fc69a25d3b7f0c23d32962dbc5ba7,1,3,0,3,1,2012-07-31 22:52:37,2012-07-31 22:52:37
2981f01b461fc69a25d3b7f0c23d32962dbc5ba7...af699c47d1d333dab2eaf438ed78b504ebdb6b79,1,4,0,4,1,2012-07-31 23:45:09,2012-07-31 04:15:46
af699c47d1d333dab2eaf438ed78b504ebdb6b79...285a46d1ca4d8fe1fb7477b8fdbe1d9b377443c4,2,5,3,8,5,2012-07-31 23:45:44,2012-07-31 23:42:36
285a46d1ca4d8fe1fb7477b8fdbe1d9b377443c4...cccce60b3e9ef2c0cafcc5c5248423900d424a66,1,1,1,2,1,2012-08-01 11:39:12,2012-08-01 11:36:56
cccce60b3e9ef2c0cafcc5c5248423900d424a66...f70be41d80b389cb0d1ce12fa93669b0b44e4005,1,52,52,104,1,2012-08-01 17:11:30,2012-08-01 17:11:30
f70be41d80b389cb0d1ce12fa93669b0b44e4005...fe659a60179c5816f888585894faa6d4134ec3cc,1,2,2,4,1,2012-08-01 17:11:36,2012-08-01 17:04:27
fe659a60179c5816f888585894faa6d4134ec3cc...fd56981b4c3a2de866f9cbeda09df0458d0f51b1,78,3031,3031,6062,79,2012-08-01 17:14:17,2012-08-01 17:14:17
fd56981b4c3a2de866f9cbeda09df0458d0f51b1...23f09d7e024f326ea0466af10b97ad46e76ac5e6,1,2,2,4,2,2012-08-01 18:30:40,2012-08-01 18:25:24
23f09d7e024f326ea0466af10b97ad46e76ac5e6...f1fba8d1f5e7411f055c00ca4b46646e5b840cf2,2,14,3,17,4,2012-08-01 23:25:53,2012-08-01 14:04:28
f1fba8d1f5e7411f055c00ca4b46646e5b840cf2...53f3b128f5efd5fdca2dcab9ff3e5d3e2b9debf1,1,8,8,16,3,2012-08-01 23:35:54,2012-08-01 23:35:51
3bf1846bb7653af718d8d5bf4e75d904b2ac285f...d13887512e37a0687b50ec66fc3f917620b61bf4,4,230,23,253,11,2012-08-05 05:13:07,2012-07-10 10:06:13
d13887512e37a0687b50ec66fc3f917620b61bf4...085a09874b03a1e5401d911ef61e9451b6ea3b30,4,88,111,199,31,2012-08-05 20:53:31,2012-07-14 07:38:00
085a09874b03a1e5401d911ef61e9451b6ea3b30...ddb02b978d2b577727370b36eeb828b1a522064a,1,2,1,3,2,2012-08-05 20:53:31,2012-07-14 07:43:10
ddb02b978d2b577727370b36eeb828b1a522064a...99ad0561c04a8b255f6049f494fe15cb56e0b382,3,62,45,107,11,2012-08-05 20:53:31,2012-08-05 18:26:18
99ad0561c04a8b255f6049f494fe15cb56e0b382...74d076caf1837ddacae0f7cd5d9e6ee0b47d63d2,1,2,1,3,2,2012-08-05 21:22:44,2012-08-05 21:22:44
74d076caf1837ddacae0f7cd5d9e6ee0b47d63d2...3219616f43d4512932f85106f02fe697fdc57051,2,5,3,8,3,2012-08-05 21:40:28,2012-08-05 21:31:28
3219616f43d4512932f85106f02fe697fdc57051...624788df7e71a1868ad0b1c8f10698c6186e8083,1,1,1,2,1,2012-08-05 21:40:39,2012-08-05 21:40:20
624788df7e71a1868ad0b1c8f10698c6186e8083...2f7e0f2da6a5c1be7ed6c79eca6c723d1b341aff,2,9,35,44,14,2012-08-05 22:45:32,2012-08-05 22:45:30
2f7e0f2da6a5c1be7ed6c79eca6c723d1b341aff...0414e14702af7258a9197f6b979e32261f96f910,1,1,1,2,1,2012-08-06 15:23:11,2012-08-05 21:47:23
0414e14702af7258a9197f6b979e32261f96f910...168a5557803b40b4930c3b4f9587b67a6d566b13,5,201,11,212,9,2012-08-06 15:40:56,2012-08-04 19:39:11
168a5557803b40b4930c3b4f9587b67a6d566b13...7b367a93ce126d4bf5a56e10ee44613c59ffbe84,2,5,1,6,2,2012-08-06 20:25:55,2012-08-06 20:18:31
7b367a93ce126d4bf5a56e10ee44613c59ffbe84...4c150ca0d0cc4bd8dc6d182e0bf850daf27a2422,7,100,286,386,38,2012-08-06 21:55:38,2012-08-06 21:43:47
4c150ca0d0cc4bd8dc6d182e0bf850daf27a2422...81791ff33cc5413b7711c957406635ed780d0b4e,92,29243,0,29243,92,2012-08-06 23:49:02,2012-08-06 19:27:47
81791ff33cc5413b7711c957406635ed780d0b4e...22d03c9108909499b9a16d5c6fb90344cd9d16b6,1,1,0,1,1,2012-08-06 23:49:13,2012-08-06 23:48:15
22d03c9108909499b9a16d5c6fb90344cd9d16b6...9e55ba7d6bbfeaa867e0f151dd27bc0ba034cad7,3,918,5,923,10,2012-08-06 23:57:50,2012-08-06 19:22:11
9e55ba7d6bbfeaa867e0f151dd27bc0ba034cad7...e0a603a4993e995080a8926fcddbbde752a2136e,28,630,196,826,96,2012-08-06 23:57:56,2012-08-06 23:25:06
e0a603a4993e995080a8926fcddbbde752a2136e...acea4c4123b346495de79498f5b4200d6fd1bf1d,3,16,52,68,9,2012-08-06 23:57:58,2012-08-06 23:35:10
acea4c4123b346495de79498f5b4200d6fd1bf1d...658cf43b7c631dfffe87fc5fd0dbad4599117993,102,10,29594,29604,143,2012-08-06 23:58:00,2012-08-06 23:36:31
658cf43b7c631dfffe87fc5fd0dbad4599117993...08b382c2fb88d790708f39ffdf4e4b41038ec9c5,1,1,3,4,1,2012-08-08 18:25:33,2012-08-08 18:23:27
08b382c2fb88d790708f39ffdf4e4b41038ec9c5...5fba3b85c5a50b6b8c9061d951dc09da8a221d40,1,1,1,2,1,2012-08-08 21:07:18,2012-08-08 21:07:18
5fba3b85c5a50b6b8c9061d951dc09da8a221d40...67705555514d6f40fbb9a989c400f824f764e5f7,1,1,1,2,1,2012-08-08 22:06:01,2012-08-08 22:01:38
67705555514d6f40fbb9a989c400f824f764e5f7...6b588007df68b92fb3afe3427189f5954c979176,1,9,10,19,3,2012-08-08 23:02:48,2012-08-08 23:02:47
6b588007df68b92fb3afe3427189f5954c979176...9693d3334c9906840132764c91b4ec399a7a5cfd,1,0,33,33,2,2012-08-09 23:25:00,2012-08-09 23:25:00
9693d3334c9906840132764c91b4ec399a7a5cfd...d15bfc04cde2bbfb2ce534639255dfcdab3cfcb3,1,9,9,18,9,2012-08-10 10:55:49,2012-05-20 19:26:29
d15bfc04cde2bbfb2ce534639255dfcdab3cfcb3...382f22f22959e686b10a5f42333c468e6654cb97,5,153,0,153,6,2012-08-11 22:07:22,2012-08-08 02:12:01
382f22f22959e686b10a5f42333c468e6654cb97...320ae691d8e6305f69263ee526ef1c164dd40208,2,61,0,61,2,2012-08-11 23:15:08,2012-08-11 22:31:44
320ae691d8e6305f69263ee526ef1c164dd40208...00fa8864b4b8ff0650e9c82a2ee1f5e87f452c4a,2,0,66,66,2,2012-08-12 21:49:44,2012-08-12 21:43:12
00fa8864b4b8ff0650e9c82a2ee1f5e87f452c4a...c492d43f4817eb65cd251749bd074df7bb4ebc28,1,1,1,2,1,2012-08-13 16:10:26,2012-08-13 15:31:22
c492d43f4817eb65cd251749bd074df7bb4ebc28...8eccc417a7deb8d831dd30aabe22fdfb3d1a6a03,1,1,4,5,2,2012-08-13 16:52:06,2011-11-14 13:43:49
8eccc417a7deb8d831dd30aabe22fdfb3d1a6a03...50c7d80fb0c5c8c13ce8755e1be54c1fd5543748,2,63,3,66,3,2012-08-13 17:04:40,2012-08-04 20:32:18
50c7d80fb0c5c8c13ce8755e1be54c1fd5543748...22804a9eb88570b80295705da6620b68c3a6c69f,2,41,1,42,2,2012-08-13 20:07:03,2012-08-12 01:58:40
22804a9eb88570b80295705da6620b68c3a6c69f...de32b38992b8adbf7a6b83f580b2cb60fe7b98af,54,0,13298,13298,56,2012-08-14 21:06:32,2012-08-14 21:06:32
de32b38992b8adbf7a6b83f580b2cb60fe7b98af...90ea68107a94b33e6b20cd9c2af8547b8c41da7c,1,22,34,56,8,2012-08-14 23:37:16,2012-08-14 23:30:12
41b129fbde966058d22f5dbdc64125bc30a6af62...2ba96451a9bf5d91e5df2cbff372c4983da16dd4,2,22,11,33,8,2012-07-04 11:45:14,2012-06-27 15:47:07
2ba96451a9bf5d91e5df2cbff372c4983da16dd4...3ea0397a1a679e7ffaaf353bc67afca2a4065fa5,1,6,4,10,3,2012-07-04 23:40:43,2012-06-13 17:37:31
3ea0397a1a679e7ffaaf353bc67afca2a4065fa5...d923269e13f903b02506d86f138369586862364e,1,7,2,9,3,2012-07-05 04:23:49,2012-07-03 22:30:53
d923269e13f903b02506d86f138369586862364e...f210530f46e8ddbd9e7cc0d0c37778888c27f526,1,48,17,65,9,2012-07-05 20:06:33,2012-07-05 19:50:21
f210530f46e8ddbd9e7cc0d0c37778888c27f526...76104f3414f10bd5df1aa8cdc69cff9f73e64b9d,1,4,4,8,3,2012-07-10 20:44:07,2012-07-10 17:39:41
07e5877144d5d719f9bab1f866affb02deb23a0d...06c82c50697e4dc45c07b5c1f525e1cb82f13018,1,1,1,2,1,2012-06-26 14:35:14,2012-06-26 14:34:07
06c82c50697e4dc45c07b5c1f525e1cb82f13018...401ff102955a3dc5a401601b54405259c8948c72,1,1,1,2,1,2012-06-26 15:30:07,2012-06-25 16:53:35
401ff102955a3dc5a401601b54405259c8948c72...10448487e5580b37b6656bc980357f88a6814784,1,3,3,6,3,2012-06-26 17:23:24,2012-06-26 17:23:24
10448487e5580b37b6656bc980357f88a6814784...69f594d22ccca81d76396b52c1c8ce11115882dc,1,20,17,37,10,2012-06-26 17:54:20,2012-06-25 18:14:10
69f594d22ccca81d76396b52c1c8ce11115882dc...1e50282ae8672ea2b6ea320e74389160bec951f0,6,36,52,88,14,2012-06-26 21:38:35,2012-06-26 21:38:35
1e50282ae8672ea2b6ea320e74389160bec951f0...21aa0df8b2f4fb8715943c4b0bdc944554be43e8,2,5,2,7,5,2012-06-26 22:20:26,2012-06-26 22:20:26
21aa0df8b2f4fb8715943c4b0bdc944554be43e8...f00c8bcef856d7ff7da40eb67a3c74f13f086256,2,1,7,8,2,2012-06-26 22:35:16,2012-06-26 22:33:50
f00c8bcef856d7ff7da40eb67a3c74f13f086256...0cdeb8ed9690dcad912996a37ac149c7e7622f64,2,115,42,157,14,2012-06-26 23:59:25,2012-06-26 23:59:25
0cdeb8ed9690dcad912996a37ac149c7e7622f64...9e72b7b65c2726ea192326261be45f4bcda6a86c,1,1,1,2,1,2012-06-27 17:52:01,2012-06-26 17:45:13
9e72b7b65c2726ea192326261be45f4bcda6a86c...d5f13f6c0803e328cd588c3c402f50d7891292fb,2,5,4,9,3,2012-06-27 23:07:45,2012-06-27 23:07:42
d5f13f6c0803e328cd588c3c402f50d7891292fb...be3afd0becdff628c4e57c90b889210ae7db7a23,1,2,14,16,2,2012-06-28 01:50:48,2012-06-28 01:47:40
be3afd0becdff628c4e57c90b889210ae7db7a23...6531f187d877da403af0bbe5aa9814705e5ace61,1,18,3,21,3,2012-06-28 01:51:42,2012-06-27 17:15:28
6531f187d877da403af0bbe5aa9814705e5ace61...37bdd36d70e86e3a3644bc73349e2f6f18909ea0,1,11,2,13,2,2012-06-28 06:32:50,2012-06-28 06:32:43
37bdd36d70e86e3a3644bc73349e2f6f18909ea0...3ea2a618adb0f8654b07a62bccf2a3473ec4b22d,3,169,147,316,30,2012-06-28 14:17:56,2012-06-28 14:17:30
3ea2a618adb0f8654b07a62bccf2a3473ec4b22d...f2a9ed487369ab7222522e1097708550adbe165c,1,24,1,25,1,2012-06-28 17:14:03,2012-06-28 17:13:28
53f3b128f5efd5fdca2dcab9ff3e5d3e2b9debf1...f5c07b65a09afe2f9571efece91a4898d7b79404,231,862,455,1317,414,2012-08-02 15:09:47,2012-08-02 02:10:42
f5c07b65a09afe2f9571efece91a4898d7b79404...37537d5720a563cb63929a0f4014491467767874,2,116,0,116,2,2012-08-02 15:11:18,2012-08-02 15:11:09
37537d5720a563cb63929a0f4014491467767874...2dd710e7ea5163af3573d7d53c64858aaa88cf58,3,28,1,29,6,2012-08-02 20:56:50,2012-08-02 20:35:41
2dd710e7ea5163af3573d7d53c64858aaa88cf58...9b86a4453f0c76f2707a75c0b2343aba33ec63bc,3,41,2,43,3,2012-08-02 20:56:50,2012-08-02 15:12:22
53f3b128f5efd5fdca2dcab9ff3e5d3e2b9debf1...6db9e12de5e35f360249f4dab190b3bd052fccf0,230,0,54675,54675,230,2012-08-02 10:20:19,2012-08-02 10:11:35
6db9e12de5e35f360249f4dab190b3bd052fccf0...34c750d7a96ad29c023d117f55239b94e90d23d5,2,37,1,38,2,2012-08-02 11:37:02,2012-08-02 11:37:02
34c750d7a96ad29c023d117f55239b94e90d23d5...50e00de92a7563f39ff50f9a53c7e2ed15e556c6,3,216,160,376,4,2012-08-02 11:51:35,2012-08-01 23:06:31
50e00de92a7563f39ff50f9a53c7e2ed15e556c6...931537769360c3816975e96040bfb6d83ac1078b,1,2,2,4,1,2012-08-02 15:47:33,2012-08-02 15:47:33
a177f55b0c022b5a77e9660beea5e190bc4c6e88...916832cd2c46edc498c3f71d0031cfa23a79f5c4,1,1,1,2,1,2012-08-17 11:45:45,2012-08-17 11:44:25
916832cd2c46edc498c3f71d0031cfa23a79f5c4...28d30346f442f848b8ecdcf208bc0d6bb565f38d,1,2,2,4,1,2012-08-17 12:03:26,2012-08-17 12:02:16
28d30346f442f848b8ecdcf208bc0d6bb565f38d...05b3f88064a3dc85f892d0ff07dbca4f90437809,1,2,2,4,2,2012-08-17 12:03:36,2012-08-17 12:03:01
05b3f88064a3dc85f892d0ff07dbca4f90437809...6c999fd2855f9bccf99666431cddc9b34930720b,1,3,1,4,2,2012-08-17 12:11:35,2012-08-17 12:11:33
6c999fd2855f9bccf99666431cddc9b34930720b...772b3bf4c806f881528718d1e0240392d0228c19,1,5,2,7,1,2012-08-20 16:13:05,2012-08-20 16:13:05
772b3bf4c806f881528718d1e0240392d0228c19...6bec5440ebced1bc2b91c1c9f3fbc7a361995331,72,2627,1527,4154,469,2012-08-20 16:41:31,2012-08-20 16:41:07
6bec5440ebced1bc2b91c1c9f3fbc7a361995331...600a6468dc9067a358893f26ff46f1cd865f3c97,6,165,20,185,14,2012-08-20 22:18:10,2012-08-20 21:59:21
600a6468dc9067a358893f26ff46f1cd865f3c97...34fc97880f5547314defce475a7d884726bd0cd0,3,0,184,184,3,2012-08-20 22:32:45,2012-08-20 22:32:45
34fc97880f5547314defce475a7d884726bd0cd0...2c5828b65be98fd5cb75fa266bd24e435ce0b71d,4,0,243,243,5,2012-08-20 22:37:59,2012-08-20 22:37:59
2c5828b65be98fd5cb75fa266bd24e435ce0b71d...2cdf427dce90d258d162eb308a0685e94ea78a73,1,1,1,2,1,2012-08-21 10:50:34,2012-08-21 10:50:34
2cdf427dce90d258d162eb308a0685e94ea78a73...63d13e86a58b2885c388f57a53227c2a23c83b49,4,71,3,74,7,2012-08-21 12:29:20,2012-08-21 11:29:53
63d13e86a58b2885c388f57a53227c2a23c83b49...ed093f1314807f55a472838eb82bb532768b0e79,13,317,12,329,35,2012-08-21 22:54:15,2012-08-21 22:54:15
ed093f1314807f55a472838eb82bb532768b0e79...1867511400e895989652af33aa4942b446a90151,1,1,1,2,1,2012-08-22 08:05:18,2012-08-22 08:05:18
1867511400e895989652af33aa4942b446a90151...c78678b081d8c37b8bbc616e4cb782cf32645619,2,29,29,58,7,2012-08-24 15:26:31,2012-08-07 00:42:13
c78678b081d8c37b8bbc616e4cb782cf32645619...c4fa77a5ecd801883e6c9a801c4cd2a903ff134b,1,1,1,2,1,2012-08-24 20:56:28,2012-08-24 20:56:26
c4fa77a5ecd801883e6c9a801c4cd2a903ff134b...025f53c306d91968b292051404aebb8bf2adb458,2,128,17,145,13,2012-08-24 21:31:32,2012-08-24 20:12:30
025f53c306d91968b292051404aebb8bf2adb458...0285dae26a8fabd2053ec8a893f9dc04b9961329,2,50,6,56,7,2012-08-24 21:31:32,2012-08-24 20:18:19
0285dae26a8fabd2053ec8a893f9dc04b9961329...05282588e00502f5cae597c0654005b0cb685c6c,3,51,0,51,3,2012-08-27 20:01:29,2012-08-27 19:31:14
05282588e00502f5cae597c0654005b0cb685c6c...e5d95ba939d29a47b57cc0edc680a5cd38db22fb,1,32,0,32,15,2012-08-27 20:03:30,2012-08-27 19:40:05
e5d95ba939d29a47b57cc0edc680a5cd38db22fb...985e3a25cb93f82dbef9b1b4279b8614f508898c,3,4,4,8,4,2012-08-27 20:03:30,2012-08-27 19:51:25
985e3a25cb93f82dbef9b1b4279b8614f508898c...4822d780bb913c9ef7c2301a181a5834887cddb4,29,460,322,782,65,2012-08-28 00:44:36,2012-08-28 00:43:55
424cd5a02033b5f9bf027431614ca5f9183fa3b1...3ad07ed0b8c8e350934bb07bdd2fffa5c129011f,1,1,1,2,1,2012-07-12 00:46:28,2012-07-12 00:46:28
3ad07ed0b8c8e350934bb07bdd2fffa5c129011f...eb9b8f51dadc4496e42b444a1a5dfab1c289145b,121,1167,414,1581,223,2012-07-12 00:54:53,2012-07-12 00:54:44
f2a9ed487369ab7222522e1097708550adbe165c...c721604d254f57eefef715d4bd83329fac0750c7,131,1538,244,1782,200,2012-06-29 02:08:32,2012-06-29 02:08:32
c721604d254f57eefef715d4bd83329fac0750c7...3644b0bc9637fbb17ec74b41fe2dcb1dd978699e,3,30,7,37,4,2012-06-29 02:11:30,2012-06-29 02:10:56
2bee3aeee93a2de6232da873dfa7e33f53ce94a6...02dae998c3506ee1a672911c036e660b28ba893f,1,2,2,4,1,2012-08-02 21:58:15,2012-08-02 21:58:15
02dae998c3506ee1a672911c036e660b28ba893f...575c12bba3ef220d923ed3ef2e466d10258f3f54,1,77,0,77,1,2012-08-02 21:59:47,2012-08-02 21:59:47
575c12bba3ef220d923ed3ef2e466d10258f3f54...585388bbd8d57669954a3c0c752d72bf8a3d3145,1,1,1,2,1,2012-08-02 22:00:57,2012-08-02 22:00:57
585388bbd8d57669954a3c0c752d72bf8a3d3145...5fdeebd94d58bf715d991d5bc63be6fff507f27d,3,105,48,153,7,2012-08-03 15:11:08,2012-08-03 15:11:08
bf16d9280ea7aadce5c5437184c1d80e651a997a...3b17f3b80a4b96713b4a98fc85c32df44b7ba6ab,1,3,0,3,1,2012-08-28 13:04:55,2012-08-28 07:03:51
3b17f3b80a4b96713b4a98fc85c32df44b7ba6ab...c06e1002c893deb1c705586193120dd606e264b0,1,6,1,7,1,2012-08-28 19:46:58,2012-08-28 19:46:44
c06e1002c893deb1c705586193120dd606e264b0...69d8e77f17d54d7e81e03c5eec28814399bf0bd8,1,1,0,1,1,2012-08-28 19:50:33,2012-08-28 19:50:33
69d8e77f17d54d7e81e03c5eec28814399bf0bd8...4cfd64e0db47cf5fcf03b3a98071230e4d825f21,1,64,37,101,25,2012-08-28 20:49:34,2012-08-28 20:49:34
3644b0bc9637fbb17ec74b41fe2dcb1dd978699e...2134aa3d5c622fc3c3b02ccb713fcde0e0df479a,3,44,2,46,3,2012-06-29 09:11:19,2012-06-29 02:28:00
3644b0bc9637fbb17ec74b41fe2dcb1dd978699e...3e0757c1012f2ff75bdb50eecfb585ec3982dc4d,1,1,1,2,1,2012-06-29 05:06:53,2012-06-29 05:06:53
3e0757c1012f2ff75bdb50eecfb585ec3982dc4d...1747eeff1aa3b8b9fc7f4febc71f1f315b8b439a,1,3,2,5,2,2012-06-29 05:23:53,2012-06-29 05:23:53
1747eeff1aa3b8b9fc7f4febc71f1f315b8b439a...103921dac07af45b4206ee0e191c0b1175b9faec,1,15,0,15,1,2012-06-29 07:45:55,2012-06-29 07:45:55
103921dac07af45b4206ee0e191c0b1175b9faec...5193d592197f6e77f2bf4c21d53102ba578031d6,1,14,8,22,2,2012-06-29 08:20:13,2012-06-29 08:20:13
5193d592197f6e77f2bf4c21d53102ba578031d6...b919e2987120cd7b78429751943201c5b5fb0fe3,1,4,1,5,1,2012-06-29 08:20:59,2012-06-29 08:20:59
b919e2987120cd7b78429751943201c5b5fb0fe3...40f70673c65de19183bfd9e32151383d23e7edf1,1,4,1,5,2,2012-06-29 08:22:10,2012-06-29 08:22:10
5fdeebd94d58bf715d991d5bc63be6fff507f27d...b21c8e0bfd7539859c79fab63da88a53abe4f25a,1,3,3,6,2,2012-08-04 00:18:18,2012-08-04 00:18:16
b21c8e0bfd7539859c79fab63da88a53abe4f25a...110e499fe7dc65429a2fade29fe1573c35d97059,1,1,0,1,1,2012-08-04 00:41:34,2012-08-04 00:41:32
4cfd64e0db47cf5fcf03b3a98071230e4d825f21...e6ce259d2caf338fec991c2dd447de763ce99ab7,2,67,2,69,2,2012-08-28 22:27:49,2012-08-28 15:46:29
4cfd64e0db47cf5fcf03b3a98071230e4d825f21...143e9bef477ab847aa1045a1a88f66a53e34d736,1,1,1,2,1,2012-08-28 22:16:53,2012-08-28 22:16:53
cb64adaadcef95cdc89ceaf4ece71d5ac1ab506f...bc718742620d908df90133ddd4b42e2da11570e6,1,77,0,77,1,2012-06-29 17:20:25,2012-06-29 17:15:40
bc718742620d908df90133ddd4b42e2da11570e6...b9abb64fbb1fcc7476e617dfd1d8bbd6f06f95f0,1,2,0,2,1,2012-06-30 00:23:31,2012-06-30 00:23:03
b9abb64fbb1fcc7476e617dfd1d8bbd6f06f95f0...7e5aeac28f06ab17bcdfd4fd8ede6a7bcd95dbaf,7,233,145,378,28,2012-06-30 01:27:54,2012-06-30 01:27:54
7e5aeac28f06ab17bcdfd4fd8ede6a7bcd95dbaf...f3150292687e04332e1ae252817ee703fe316a70,1,42,21,63,13,2012-06-30 02:30:49,2012-06-30 02:27:29
f3150292687e04332e1ae252817ee703fe316a70...f78ce087ba195540c8293f57a0a774c1de9e19bb,1,18,16,34,3,2012-06-30 15:49:37,2012-06-30 15:49:31
f78ce087ba195540c8293f57a0a774c1de9e19bb...b53cd9798f96637a8bb60ef2391f21bd017f071d,1,28,0,28,4,2012-07-01 18:09:55,2012-07-01 18:09:55
b53cd9798f96637a8bb60ef2391f21bd017f071d...a25a27817fc8796edd9181122e9aab7ab516751a,4,4,20,24,4,2012-07-01 22:07:11,2012-07-01 22:07:11
a25a27817fc8796edd9181122e9aab7ab516751a...a0add919873d6af805f3d70da57600f49a8f8cb3,1,3,11,14,3,2012-07-03 13:15:28,2012-07-03 13:14:33
a0add919873d6af805f3d70da57600f49a8f8cb3...b731c96679247a5dec9b2ed1470cc6c4feea2d1c,1,3,6,9,1,2012-07-03 13:19:17,2012-07-03 13:19:08
b731c96679247a5dec9b2ed1470cc6c4feea2d1c...b1cce046467f7fb64710160c5122a7883b739729,2,5,5,10,3,2012-07-03 13:28:45,2012-07-03 13:28:06
b1cce046467f7fb64710160c5122a7883b739729...5da78905a6c82aa40f79ae8ff1a74a53bc89a588,3,4,2,6,2,2012-07-03 18:56:26,2012-07-03 18:54:19
5da78905a6c82aa40f79ae8ff1a74a53bc89a588...fc4e12b8f1d6e3ea010d575504011deee2a97b16,611,2983,22714,25697,1026,2012-07-03 18:56:35,2012-07-03 18:56:06
110e499fe7dc65429a2fade29fe1573c35d97059...a7f3288a87c563f0910f17cbed503574b6ceea54,1,43,0,43,1,2012-08-04 18:30:44,2012-08-04 18:30:44
a7f3288a87c563f0910f17cbed503574b6ceea54...b48684c6f1958930741e2cf34a6a6d5cafa7f478,2,40,3,43,2,2012-08-04 18:30:58,2012-08-03 19:38:09
b48684c6f1958930741e2cf34a6a6d5cafa7f478...f4a4ef7a2da34ec9d155f82df0133b40382c53e9,2,37,0,37,2,2012-08-04 20:04:15,2012-07-24 14:40:58
f4a4ef7a2da34ec9d155f82df0133b40382c53e9...93be4ffd4b224ec10476340dcc7747ac20d4ac13,3,58,45,103,11,2012-08-05 21:33:23,2012-08-05 18:26:18
93be4ffd4b224ec10476340dcc7747ac20d4ac13...7bb814f9db02185c7a0900f73c2bbd52247a1907,1,2,1,3,2,2012-08-05 21:42:22,2012-08-05 21:22:44
7bb814f9db02185c7a0900f73c2bbd52247a1907...4ff56aa15e21372ab5d46baabea01d741d81431e,1,1,1,2,1,2012-08-05 21:47:23,2012-08-05 21:47:23
4ff56aa15e21372ab5d46baabea01d741d81431e...bc7479d2321f7cbfe7567195a5bcf59d92acbb90,1,3,3,6,3,2012-08-05 22:13:56,2012-08-04 19:45:50
110e499fe7dc65429a2fade29fe1573c35d97059...57f785151aa68b1d01c6ca1b08be379fc5e8b538,1,1,1,2,1,2012-08-04 07:10:58,2012-08-04 07:10:58
57f785151aa68b1d01c6ca1b08be379fc5e8b538...3254caceefda268247826cd9bb8178725a9f0b08,1,3,2,5,2,2012-08-05 21:02:30,2012-08-04 07:12:52
3254caceefda268247826cd9bb8178725a9f0b08...6bdd4d0205a86ad40f78d3140144eebb83f703ca,1,5,4,9,2,2012-08-06 17:16:09,2012-08-04 18:06:14
6bdd4d0205a86ad40f78d3140144eebb83f703ca...7a9db6cfb139a6cb5941b2ae09ab5671e474e160,1,9,1,10,1,2012-08-06 17:18:27,2012-08-06 17:18:27
7a9db6cfb139a6cb5941b2ae09ab5671e474e160...42aac41b9399dbdb14e3f250f358c14ec13ee5e4,1,16,0,16,3,2012-08-06 17:22:08,2012-08-04 19:07:17
42aac41b9399dbdb14e3f250f358c14ec13ee5e4...bd10bf44181909ce3aca8c312117482dcc14d066,1,3,1,4,2,2012-08-06 18:40:01,2012-08-04 19:12:22
bd10bf44181909ce3aca8c312117482dcc14d066...eadc2ec5c8d1f3697d22515d7808ca583ea43f45,1,3,1,4,2,2012-08-06 18:40:39,2012-08-04 19:12:37
eadc2ec5c8d1f3697d22515d7808ca583ea43f45...dc9ae01ef7a6fcafd82b306d80b9f715d72ed670,1,1,1,2,1,2012-08-06 18:40:44,2012-08-04 19:24:34
dc9ae01ef7a6fcafd82b306d80b9f715d72ed670...8b11f29cf3881cdc0e1e1a553c543f561128daed,1,8,0,8,2,2012-08-06 18:40:44,2012-08-04 19:39:54
8b11f29cf3881cdc0e1e1a553c543f561128daed...dc818135a573fa35a502417322e811f20e488e4c,1,26,24,50,5,2012-08-06 18:41:45,2012-08-04 22:34:04
dc818135a573fa35a502417322e811f20e488e4c...cc6034ac862e058ee9faa5306f240d11150f960e,1,8,0,8,1,2012-08-06 18:57:47,2012-08-06 18:57:47
1550ddaa6bd7e8850ffe9346e271fc4196f5bcd4...459717efb629cddb53d5b8cc64eb91a1e8de5340,1,2,2,4,1,2012-08-28 22:32:01,2012-08-28 22:32:01
459717efb629cddb53d5b8cc64eb91a1e8de5340...e4cef1a0833e6d677298600e205a142d15639bf2,2,2,2,4,2,2012-08-29 00:36:22,2012-08-29 00:30:15
e4cef1a0833e6d677298600e205a142d15639bf2...8bec26122d6de0b230f74731c1d09da267c95add,3,43,1,44,3,2012-08-29 20:53:07,2012-08-29 20:53:00
8bec26122d6de0b230f74731c1d09da267c95add...4784ea1a29dc4bace1c9a20f9f6a6376a7eecb7d,8,1641,231,1872,156,2012-08-29 22:06:47,2012-08-29 22:06:47
4784ea1a29dc4bace1c9a20f9f6a6376a7eecb7d...606a9339891a68144c6047356480f199ce04ae4c,1,8,0,8,1,2012-08-29 22:36:15,2012-08-29 21:57:25
606a9339891a68144c6047356480f199ce04ae4c...ed103409c4248296c2757fdbfc7a4b3a1f54bfcd,3,21,7,28,9,2012-08-30 15:29:47,2012-08-30 15:29:47
ed103409c4248296c2757fdbfc7a4b3a1f54bfcd...298f6bff5b7ce7448b8f537317e6a0369f6d5034,1,10,6,16,3,2012-08-30 22:40:18,2012-08-30 22:37:45
298f6bff5b7ce7448b8f537317e6a0369f6d5034...870307de75b4fb4a1a8dcc63294d442d1e13545b,1,1,1,2,1,2012-09-02 11:49:15,2012-09-02 11:45:56
870307de75b4fb4a1a8dcc63294d442d1e13545b...7f404e3509ecd349843eab7a3d16ad616e20c6e9,3,109,3,112,6,2012-09-02 12:01:43,2012-09-01 15:14:18
7f404e3509ecd349843eab7a3d16ad616e20c6e9...f03c3203a1acc048b413820ef4f792bc385413cd,2,8,10,18,5,2012-09-03 14:42:20,2012-09-03 14:42:18
f03c3203a1acc048b413820ef4f792bc385413cd...83b1dda12fa646a2a5f201a4401149c789ad9b1c,2,27,3,30,6,2012-09-04 12:39:31,2012-09-04 12:19:59
83b1dda12fa646a2a5f201a4401149c789ad9b1c...19a432260cd2a2981c067c88f37f71206d23ccd2,1,5,0,5,5,2012-09-04 12:41:08,2012-09-04 12:40:59
fc4e12b8f1d6e3ea010d575504011deee2a97b16...4fbe7a5fabbdcf9877fd1aa2b9e8c5ef40bd1306,2,2,2,4,2,2012-07-04 12:08:07,2012-07-04 12:08:07
4fbe7a5fabbdcf9877fd1aa2b9e8c5ef40bd1306...6a11f3edf429d614fd35a1cbac8b734d8a7e0797,2,4,2,6,2,2012-07-04 18:22:10,2012-07-03 02:13:24
6a11f3edf429d614fd35a1cbac8b734d8a7e0797...9126dd2d903f3cf842f0c11a8349d794dde68e98,2,4,1,5,2,2012-07-04 18:51:24,2012-07-04 18:51:24
9126dd2d903f3cf842f0c11a8349d794dde68e98...0c47219a72fcf58c639ccb37ddf6b01b2261e793,2,8,5,13,3,2012-07-05 21:07:27,2012-07-01 20:58:22
0c47219a72fcf58c639ccb37ddf6b01b2261e793...0dba28b5c29201a026a86e1d73b3c3c88a163b7d,1,1,1,2,1,2012-07-06 00:14:47,2012-06-29 09:33:58
0dba28b5c29201a026a86e1d73b3c3c88a163b7d...ed7fb149a20ee5e7aa9a0574a242a193d7acd761,3,40,1,41,3,2012-07-06 22:26:41,2012-07-06 22:26:41
ed7fb149a20ee5e7aa9a0574a242a193d7acd761...e11b6b8f756a86f9f5061b0429c902b14503795b,1,3,3,6,3,2012-07-07 02:28:35,2012-07-04 20:55:54
e11b6b8f756a86f9f5061b0429c902b14503795b...93d4259cf041928cba0e3cf32a7007ee0d3df92a,1,5,3,8,2,2012-07-07 02:28:35,2012-07-04 20:57:48
93d4259cf041928cba0e3cf32a7007ee0d3df92a...e5bb8391a84f62de2e7a818c142fbb2ad01ff9ba,1,0,5,5,1,2012-07-07 02:28:35,2012-07-04 20:59:23
e5bb8391a84f62de2e7a818c142fbb2ad01ff9ba...0b0b72c2fab5bdf32f5476e47a1e7f2da9db2064,1,28,28,56,4,2012-07-07 02:28:35,2012-07-04 21:01:03
0b0b72c2fab5bdf32f5476e47a1e7f2da9db2064...7e7d5d38eae74ac92daf304624a81c951be6ebf6,1,30,35,65,11,2012-07-07 02:28:35,2012-07-04 21:14:27
7e7d5d38eae74ac92daf304624a81c951be6ebf6...4cfdc57712ef4657157fbb0c14481bb05f91577f,1,2,3,5,2,2012-07-07 02:28:35,2012-07-04 21:17:14
4cfdc57712ef4657157fbb0c14481bb05f91577f...c7bc4cacde163f916b62f196194ff5c1cabb61a2,1,2,2,4,1,2012-07-07 02:28:35,2012-07-04 21:18:33
c7bc4cacde163f916b62f196194ff5c1cabb61a2...a9b0bcfafe33c3871bf3c3b18c538025eff526d7,1,1,1,2,1,2012-07-07 02:28:35,2012-07-04 21:19:09
a9b0bcfafe33c3871bf3c3b18c538025eff526d7...2297d638c17ef39fa17e08a7c50a09f1389bd990,1,3,3,6,3,2012-07-07 02:28:35,2012-07-05 16:46:09
2297d638c17ef39fa17e08a7c50a09f1389bd990...8a9e8d60d2ef1ca434fee2a4e2fdfc77813f83c1,1,3,4,7,3,2012-07-07 02:41:01,2012-07-07 02:41:01
8a9e8d60d2ef1ca434fee2a4e2fdfc77813f83c1...7accaeb490afdae968ef51372e159fb39e92d303,1,3,2,5,1,2012-07-07 16:51:00,2012-07-07 00:25:13
7accaeb490afdae968ef51372e159fb39e92d303...559a98f0d7ff03cebfe1344a01c2ff8e01d50a41,1,57,50,107,20,2012-07-07 16:53:33,2012-07-07 16:53:33
559a98f0d7ff03cebfe1344a01c2ff8e01d50a41...59a40fc8ed7b0ee5b0a4ea5b84a2d30d8cc2f31b,202,691,273,964,245,2012-07-07 19:40:06,2012-07-07 19:40:06
59a40fc8ed7b0ee5b0a4ea5b84a2d30d8cc2f31b...c49888bd847af0767c23c3fc38fca9376a99a9e9,1,2,2,4,1,2012-07-07 20:42:25,2012-07-07 20:42:25
c49888bd847af0767c23c3fc38fca9376a99a9e9...c6843f40c8d83b6552bc4c856a5528e55dee5e65,1,1,0,1,1,2012-07-07 21:19:12,2012-07-07 21:19:12
c6843f40c8d83b6552bc4c856a5528e55dee5e65...3e5139fd2f2df5ef5f532266e5015be8b0033b48,1,5,1,6,1,2012-07-07 21:40:12,2012-07-07 21:33:54
3e5139fd2f2df5ef5f532266e5015be8b0033b48...5b5c8b600528bc31e1bcae2fdcca95ed07427333,7,93,28,121,21,2012-07-07 21:45:00,2012-07-07 21:07:19
5b5c8b600528bc31e1bcae2fdcca95ed07427333...1c1ad9bcf440e137d5d09e5a188653ad136c1a5f,1,3,4,7,4,2012-07-07 21:45:02,2012-06-13 13:37:15
a23df7710ab89a926d105e52a903bd044c7cea2d...9badc002b4b109b237466c14de08278ef9be1e90,1,1,0,1,1,2012-08-06 19:40:40,2012-08-06 19:40:28
9badc002b4b109b237466c14de08278ef9be1e90...caf69aa91a94c7c05574afc9fcc97f45aa8d5ea5,198,855,839,1694,677,2012-08-06 20:07:31,2012-08-06 20:07:31
caf69aa91a94c7c05574afc9fcc97f45aa8d5ea5...093be8b16bb153d18bfec752d42f8b79a8958800,1,1,1,2,1,2012-08-06 20:22:05,2012-08-06 20:22:05
972cdf82f14c237577ed5031d9ce92d0c23910e4...2efa3ae64f1c713d90ea094f465695fd075db08f,1,1,1,2,1,2012-09-04 13:08:32,2012-09-04 13:08:29
2efa3ae64f1c713d90ea094f465695fd075db08f...d3135e0f57ffece13c70160606250006cd097c17,2,9,3,12,3,2012-09-04 14:04:01,2012-08-22 20:36:04
d3135e0f57ffece13c70160606250006cd097c17...7b6d3cea2c165c4f83222dce9243884397584b8c,2,30,11,41,8,2012-09-04 14:04:01,2012-09-04 14:03:01
7b6d3cea2c165c4f83222dce9243884397584b8c...790d651f0dfae13f1e2b799820ab18ac09f251b7,3,72,2,74,4,2012-09-04 20:07:48,2012-09-04 19:54:40
790d651f0dfae13f1e2b799820ab18ac09f251b7...8e0c830cd0038577e36456d3e027a4150d68c933,5,392,12,404,28,2012-09-04 22:01:54,2012-07-07 20:20:23
8e0c830cd0038577e36456d3e027a4150d68c933...a4ef01df07ce1d1365eec057911131c6212444f4,3,28,0,28,3,2012-09-09 18:04:16,2012-09-08 23:10:00
a4ef01df07ce1d1365eec057911131c6212444f4...dba47aefa560899243d95c8d6b6d6cd1bd68d09d,1,1,1,2,1,2012-09-09 18:15:45,2012-09-09 18:15:45
dba47aefa560899243d95c8d6b6d6cd1bd68d09d...5d9968f53dce708966eb92a612ca8a7833a51ced,1,0,21,21,1,2012-09-09 23:31:13,2012-09-09 23:31:11
5d9968f53dce708966eb92a612ca8a7833a51ced...98d53ac51ea3464754155e50e55106bd30aed193,1,67,0,67,1,2012-09-11 13:40:39,2012-09-11 13:40:39
98d53ac51ea3464754155e50e55106bd30aed193...eaf13431003b92521e3277dd7fa5dd223407052f,1,4,71,75,6,2012-09-11 13:42:04,2012-09-11 13:42:02
eaf13431003b92521e3277dd7fa5dd223407052f...c8c638a84195e5571f4ece881375909e1f4b82a8,1,9,4,13,2,2012-09-11 16:33:30,2012-09-11 16:33:28
c8c638a84195e5571f4ece881375909e1f4b82a8...b61ae54e18c9f6ada7e746052ef6b39272b18a15,774,126286,5766,132052,3951,2012-09-11 22:40:55,2012-09-11 12:56:42
b61ae54e18c9f6ada7e746052ef6b39272b18a15...ff22a0cb15c0513c0f40367f46de69da0056097d,8,149,14,163,25,2012-09-12 03:23:47,2012-09-11 19:33:15
ff22a0cb15c0513c0f40367f46de69da0056097d...1d9b4ace8a1f8ef4f17b701720511f8303171f41,8,117,8,125,21,2012-09-12 03:23:49,2012-09-11 19:33:23
1d9b4ace8a1f8ef4f17b701720511f8303171f41...2fad7a8c1beb4df94d6842bb6576442164c65794,1,1,1,2,2,2012-09-12 03:23:51,2012-09-12 02:22:02
2fad7a8c1beb4df94d6842bb6576442164c65794...c23ac14cba2df76fa049f1d1304bf7863ed24b08,1,8,0,8,3,2012-09-12 03:23:52,2012-09-11 17:06:07
c23ac14cba2df76fa049f1d1304bf7863ed24b08...988a164cd8820974753ba6a9fc1827d2832c59d4,1,1,0,1,1,2012-09-12 03:23:54,2012-08-15 00:10:02
988a164cd8820974753ba6a9fc1827d2832c59d4...9fc84fdad94cc8b30ed8aed0bcd06a53ceb1defd,2,98,0,98,3,2012-09-12 03:23:56,2012-04-11 16:20:54
9fc84fdad94cc8b30ed8aed0bcd06a53ceb1defd...709e935239764dac5a121d47bd4a05c70e121bcb,1,1,1,2,1,2012-09-12 03:23:58,2012-09-11 16:57:47
709e935239764dac5a121d47bd4a05c70e121bcb...c4b9be7c5a97b9cac99cd599dbd995da556a5a17,108,108,108,216,216,2012-09-12 03:23:59,2012-09-11 21:19:40
c4b9be7c5a97b9cac99cd599dbd995da556a5a17...8d082d0f884831e5eb02085c8b63643dd7bde4e5,5,46,235,281,39,2012-09-12 03:24:01,2012-09-11 17:00:05
8d082d0f884831e5eb02085c8b63643dd7bde4e5...4b8721aad098b75a2b2e9b6db8067ce8d1ad52a8,11,0,2777,2777,11,2012-09-12 03:24:03,2012-09-11 22:52:50
4b8721aad098b75a2b2e9b6db8067ce8d1ad52a8...d3fa0dcb89d986f267b2394d347ef30f6a03dc56,1,4,0,4,1,2012-09-12 15:57:22,2012-09-12 15:57:15
1c1ad9bcf440e137d5d09e5a188653ad136c1a5f...26f1bc8e8c7e640376a911356d48d5fc7e8a433f,1,2,4,6,1,2012-07-08 12:45:55,2012-07-06 14:37:03
26f1bc8e8c7e640376a911356d48d5fc7e8a433f...d3d83d7b909d34784b9cb96faa8541542630b9d6,2,51,0,51,2,2012-07-09 03:53:19,2012-07-08 02:57:02
d3d83d7b909d34784b9cb96faa8541542630b9d6...bf539f9bfd2cde4c18557f2607455a4f44fc1565,1,2,1,3,1,2012-07-09 05:22:01,2012-07-09 05:03:37
bf539f9bfd2cde4c18557f2607455a4f44fc1565...5b5362aa8d80d0822f37e2448d024452dd3c0a98,3,53,11,64,10,2012-07-09 13:48:43,2012-07-08 14:31:07
5b5362aa8d80d0822f37e2448d024452dd3c0a98...63c2391984b74bf04bc7f68e346e857ca9d63329,1,1,1,2,1,2012-07-09 13:48:43,2012-07-08 14:37:45
63c2391984b74bf04bc7f68e346e857ca9d63329...fba1e48fae094b3a54aee2228cbfe3e8c505a12c,1,2,2,4,2,2012-07-09 13:57:44,2012-07-01 15:35:51
fba1e48fae094b3a54aee2228cbfe3e8c505a12c...f4369d76c8f46c27329fc81a6e505d2612f00f88,2,115,15,130,15,2012-07-09 14:55:09,2012-07-09 14:55:09
f4369d76c8f46c27329fc81a6e505d2612f00f88...2a8380ce578a52a98a81b80d4747c6ca144874c5,1,43,17,60,30,2012-07-09 15:28:30,2012-07-09 15:28:30
2a8380ce578a52a98a81b80d4747c6ca144874c5...6530310ed59c1056aa71c17133b5dbee87e2415c,2,10,1,11,2,2012-07-09 16:37:46,2012-07-08 00:30:07
1c1ad9bcf440e137d5d09e5a188653ad136c1a5f...c4e9226bdb5ce00fbe8a8b2dcb4ac4ebfe5de119,1,4,3,7,1,2012-07-07 22:15:17,2012-07-07 22:01:51
c4e9226bdb5ce00fbe8a8b2dcb4ac4ebfe5de119...cc6084b9ac5cf1d4fe5e7165b71e8fc05d11be1f,3,40,2,42,3,2012-07-07 22:15:17,2012-07-07 20:56:39
093be8b16bb153d18bfec752d42f8b79a8958800...f11a3dfcd63f80a6435dbf126faec77a01256326,101,118,134,252,108,2012-08-07 02:09:58,2012-08-07 02:09:36
f11a3dfcd63f80a6435dbf126faec77a01256326...0544a586ca6b6b900a42e164033dbf350765700a,3,26,2,28,3,2012-08-07 18:56:58,2012-08-06 20:10:47
bb207c2827cd758dd273adb28badeb9ec2586939...f5c68b280fa45c9a392794364272ddfc711bc7a0,1,22,0,22,1,2012-09-12 23:21:53,2012-05-20 19:54:48
f5c68b280fa45c9a392794364272ddfc711bc7a0...10ba95c11a9a3857f5e378e343b3febd107dae70,1,41,22,63,1,2012-09-12 23:21:54,2012-09-12 23:18:09
10ba95c11a9a3857f5e378e343b3febd107dae70...1bcf29ef33386e0973ca4bea2105c84aa597b986,1,3,0,3,1,2012-09-13 03:51:40,2012-09-13 02:28:59
1bcf29ef33386e0973ca4bea2105c84aa597b986...2c97da82f5e23beb3f78258bb1340e63895e5125,1,2,3,5,1,2012-09-13 12:02:22,2012-09-13 12:02:22
2c97da82f5e23beb3f78258bb1340e63895e5125...dd1b9477063e39c5d916ebb602947340442d4d50,27,896,149,1045,102,2012-09-13 14:18:54,2012-09-13 14:18:54
dd1b9477063e39c5d916ebb602947340442d4d50...bec863b7de8ab45cf599372b16274fa526bd86a0,1,1,18,19,3,2012-09-13 14:20:36,2012-09-13 14:19:36
bec863b7de8ab45cf599372b16274fa526bd86a0...7ab4a77d6fdb2b98b3c34fda9d001ed9d91297c7,2,11,5,16,5,2012-09-13 14:31:04,2012-09-13 06:31:50
7ab4a77d6fdb2b98b3c34fda9d001ed9d91297c7...d908b83f59fd6b3ccb83680172a28866bb255364,30,689,68,757,65,2012-09-14 00:56:41,2012-09-14 00:56:41
d908b83f59fd6b3ccb83680172a28866bb255364...4c171a504d2357185efab21e81b33e2dee1ab1da,1,5,1,6,2,2012-09-14 02:00:30,2012-09-14 02:00:30
4c171a504d2357185efab21e81b33e2dee1ab1da...35607f3a2dda03af8cf2dd3704c0c915e28aa774,38,131,24,155,46,2012-09-14 22:19:06,2012-08-30 13:14:37
35607f3a2dda03af8cf2dd3704c0c915e28aa774...3806cf0d640da3024d50208452d2dd9e3cb015d2,31,183,164,347,98,2012-09-14 22:19:30,2012-08-30 14:43:20
9547ee90db5b9c07030f821329aa6ce98a4ff7fa...a4da6300c8ff857a42aca3ff2816069e4c6ac9e3,1,73,0,73,1,2012-07-09 17:24:34,2012-07-09 17:24:34
a4da6300c8ff857a42aca3ff2816069e4c6ac9e3...71078f91ed096c9aa687b5a6e556822769692c76,1,2,2,4,1,2012-07-09 17:25:17,2012-07-09 17:25:17
71078f91ed096c9aa687b5a6e556822769692c76...8146f2e6077df08ff9db01d400c186dc90df2d61,1,2,2,4,2,2012-07-10 14:36:08,2012-07-07 04:36:53
8146f2e6077df08ff9db01d400c186dc90df2d61...fecebe1dbf29f75e51e5fa2ebcfaac79cd4dfbc9,1,7,7,14,7,2012-07-10 15:02:30,2012-07-10 00:43:02
fecebe1dbf29f75e51e5fa2ebcfaac79cd4dfbc9...bf561c52a5ed3979dd77b62e4b537456bbba9506,1,51,0,51,1,2012-07-11 00:05:54,2012-07-11 00:01:30
bf561c52a5ed3979dd77b62e4b537456bbba9506...b40f813bab51b676efe37cc7f459c42ce806a18a,2,8,15,23,5,2012-07-11 01:52:13,2012-07-11 01:19:12
b40f813bab51b676efe37cc7f459c42ce806a18a...1d99441d3742045bdb7b8e8a8d013f81cdba8f40,1,1,1,2,1,2012-07-11 12:36:43,2012-07-10 14:50:49
e8834dc1a15050482a4c5380817819d7f499e980...e8bc2edabf3698e468ff510be477326fe296a9b6,1,2,2,4,1,2012-08-07 19:02:49,2012-08-07 19:02:49
e8bc2edabf3698e468ff510be477326fe296a9b6...c82e2889e8259ebd750c3b8f14fefcef74cb1caa,1,85,0,85,1,2012-08-07 19:05:23,2012-08-07 19:05:23
c82e2889e8259ebd750c3b8f14fefcef74cb1caa...64ac54a64d68c1fffd352d0453d81b6c3c0455b0,2,21,8,29,7,2012-08-10 00:11:41,2012-08-09 23:30:41
64ac54a64d68c1fffd352d0453d81b6c3c0455b0...4ef808ec0af61011f6015c29deb4bcc063845e8b,1,2,4,6,2,2012-08-11 22:08:43,2012-08-11 17:56:04
4ef808ec0af61011f6015c29deb4bcc063845e8b...6b18e88b68a723b3749d7770c043d7f711c89569,2,16,1,17,2,2012-08-12 19:48:26,2012-08-12 19:46:56
6b18e88b68a723b3749d7770c043d7f711c89569...9f26130a0eb87d88aa61ac08a90a0c309266342c,4,35,33,68,17,2012-08-13 13:33:27,2012-08-13 13:33:04
9f26130a0eb87d88aa61ac08a90a0c309266342c...100e163dda5ea0d16bb1c2f69e9ae75815978f12,2,12,2,14,5,2012-08-13 13:33:27,2012-08-13 13:04:03
100e163dda5ea0d16bb1c2f69e9ae75815978f12...786e1e87129611523cd7cbf255a479fe36dcba66,1,19,1,20,1,2012-08-14 21:00:09,2012-08-14 20:25:52
786e1e87129611523cd7cbf255a479fe36dcba66...bcb5bdebe7731739daa720c5bcc2728314db0534,1,1,1,2,1,2012-08-14 21:11:28,2012-08-08 22:01:38
bcb5bdebe7731739daa720c5bcc2728314db0534...2c13cbbc0b43287dfb86aef91e402a0719363e11,1,1,0,1,1,2012-08-15 00:15:47,2012-08-15 00:10:02
2c13cbbc0b43287dfb86aef91e402a0719363e11...3ccee087597c6a14c1b171d43a618c10889d4169,175,2549,983,3532,364,2012-08-15 03:27:28,2012-08-15 03:27:28
3ccee087597c6a14c1b171d43a618c10889d4169...15c6c0eeccd55395ecac5f02c7e09aea711ea96e,10,111,185,296,19,2012-08-15 16:09:23,2012-08-13 15:43:26
15c6c0eeccd55395ecac5f02c7e09aea711ea96e...afa57799e43b6cc0f36f37f059dcf33be28eca29,3,162,44,206,6,2012-08-15 16:10:03,2012-08-15 15:33:35
3806cf0d640da3024d50208452d2dd9e3cb015d2...fb6c314b6d34ee5c77d7f5fba67bb0bc216ce39b,1,4,4,8,5,2012-09-17 20:59:42,2012-09-15 01:06:25
fb6c314b6d34ee5c77d7f5fba67bb0bc216ce39b...90a625399f5ef6cb7d6dfd29f18095101ee4c77b,1,3,0,3,1,2012-09-18 00:13:29,2012-09-18 00:13:29
3806cf0d640da3024d50208452d2dd9e3cb015d2...7144be70db2e6ce337d0f6ec47a28a06802d1c7a,2,231,180,411,90,2012-09-17 17:44:23,2012-09-13 18:09:54
7144be70db2e6ce337d0f6ec47a28a06802d1c7a...b788c5e77b564183826a4ccb69ec9a43a758a54a,23,982,99,1081,55,2012-09-17 22:36:15,2012-09-17 22:36:05
b788c5e77b564183826a4ccb69ec9a43a758a54a...15101163377a3baa26f97db15735d794daa9cd4d,1,11,3,14,3,2012-09-17 22:49:07,2012-09-17 22:45:37
15101163377a3baa26f97db15735d794daa9cd4d...22974a1acd0acd1081c36cc6a3c79a005c955b8d,1,2,2,4,3,2012-09-18 00:54:59,2012-09-17 23:54:36
22974a1acd0acd1081c36cc6a3c79a005c955b8d...9423aa995b07b8edc4662e914e6ee195c14f5f76,1,3,0,3,1,2012-09-18 00:54:59,2012-09-18 00:13:29
9423aa995b07b8edc4662e914e6ee195c14f5f76...6e2055889091a424fbb5c500bc3ab9c05d1c28b4,3,52,2,54,3,2012-09-18 00:54:59,2012-09-17 04:51:47
afa57799e43b6cc0f36f37f059dcf33be28eca29...86778607c94afa11ef4d42f50674be4eb1476fda,1,1,1,2,1,2012-08-15 18:29:34,2012-08-15 18:28:52
86778607c94afa11ef4d42f50674be4eb1476fda...24ff8f4c79f89f6c859f3d3ee02048dd9d7db02b,5,63,34,97,8,2012-08-15 22:52:57,2012-08-15 22:47:52
24ff8f4c79f89f6c859f3d3ee02048dd9d7db02b...f640c5d35cba96634cd8176a525a1d876e361a61,3,26,2,28,3,2012-08-15 22:52:57,2012-08-15 16:20:56
f640c5d35cba96634cd8176a525a1d876e361a61...b6cf0454a9357bef156c8e4feb0153e8ac0ac35f,1,75,0,75,1,2012-08-16 00:23:59,2012-08-16 00:23:59
7fcb7b4d9cc9ac8ba4645bc6337a5af3ccc75496...d406a8250f8ef5de58ba0a90fcec42e209172258,1,2,2,4,1,2012-09-18 01:34:48,2012-09-18 01:34:48
d406a8250f8ef5de58ba0a90fcec42e209172258...21c4b9a9eb1cd60d2721783d91f8fdbb3cd7e80a,3,93,2,95,4,2012-09-18 06:56:37,2012-09-07 18:18:39
21c4b9a9eb1cd60d2721783d91f8fdbb3cd7e80a...3301c90ff7857ef71de69e090d182ede60554a90,1,1,0,1,1,2012-09-18 06:57:59,2012-09-18 06:57:59
3301c90ff7857ef71de69e090d182ede60554a90...63ff449d87e23b5e3d475da960135c1a2fd0ed58,6,173,142,315,65,2012-09-18 06:58:37,2012-09-12 20:35:59
63ff449d87e23b5e3d475da960135c1a2fd0ed58...c4aedf8a2adc3b17254a8f6233733630d0b0a64c,1,15,0,15,1,2012-09-19 11:22:29,2012-09-19 11:22:27
c4aedf8a2adc3b17254a8f6233733630d0b0a64c...bbf6b4ecbb55668a3ccd63695b38c4c41a76b82a,1,18,8,26,3,2012-09-19 12:38:25,2012-09-19 12:37:08
bbf6b4ecbb55668a3ccd63695b38c4c41a76b82a...cc1b09d6b7c3cc6b8729804cbf644634ba5d0815,3,385,0,385,3,2012-09-20 23:51:57,2012-09-20 23:48:55
cc1b09d6b7c3cc6b8729804cbf644634ba5d0815...3411a03dd114d635800cc50749d2351cd734eb2a,380,27563,11844,39407,5775,2012-09-20 23:52:24,2012-09-18 22:20:38
3411a03dd114d635800cc50749d2351cd734eb2a...d77c24de3f817b4c63040ac44d33a24d59ab5475,2,4,6,10,4,2012-09-20 23:52:27,2012-09-18 22:26:53
d77c24de3f817b4c63040ac44d33a24d59ab5475...017009f8c5c691dcb76b63ff38def6fef50b4414,1,13,4,17,3,2012-09-21 00:22:23,2012-09-18 23:56:34
017009f8c5c691dcb76b63ff38def6fef50b4414...7bd84de5ed7c5e8c072bcc02fb50037b8f3aac3f,1,13,4,17,2,2012-09-22 00:57:33,2012-09-18 22:35:29
7bd84de5ed7c5e8c072bcc02fb50037b8f3aac3f...d0e6c3f5a644e4f84e80e9081d28570bf7477391,1,39,4,43,2,2012-09-22 01:48:58,2012-07-31 15:47:53
d0e6c3f5a644e4f84e80e9081d28570bf7477391...84221fd1d690070877adacd365ac6429b92bd838,4,63,6,69,16,2012-09-22 01:48:59,2012-07-31 22:57:15
84221fd1d690070877adacd365ac6429b92bd838...b7fd55e9a0fe78d9c258039de51fc38f1ce5a74d,1,12,4,16,3,2012-09-22 01:48:59,2012-07-31 23:21:46
b7fd55e9a0fe78d9c258039de51fc38f1ce5a74d...56668f54d11225b0bcdf93dc2fba846febdbb19f,1,11,0,11,1,2012-09-22 01:48:59,2012-07-31 23:29:10
56668f54d11225b0bcdf93dc2fba846febdbb19f...212466bea23a8f92153cec0d009175cd94c7360d,3,37,4,41,6,2012-09-22 01:48:59,2012-07-31 14:14:34
212466bea23a8f92153cec0d009175cd94c7360d...5070eccf1b42f7678341659fe2674b5eced67a9f,2,62,2,64,4,2012-09-22 01:49:17,2012-08-01 11:33:22
5070eccf1b42f7678341659fe2674b5eced67a9f...86d4cf71d6abd861e3d12a5b1258536c6686176b,1,45,0,45,1,2012-09-22 01:49:17,2012-08-01 11:39:14
86d4cf71d6abd861e3d12a5b1258536c6686176b...17ef062db1f4b2a952d7c540ebb08acb8077f3e8,1,16,6,22,5,2012-09-22 01:49:17,2012-08-01 12:21:39
17ef062db1f4b2a952d7c540ebb08acb8077f3e8...5691e8aca7dc46f6b7c92defca61c6d91002657e,1,1,1,2,1,2012-09-24 22:50:37,2012-09-24 22:50:37
5691e8aca7dc46f6b7c92defca61c6d91002657e...a1ba29d110faf53ad7eb579a523a507ed28874bf,1,15,6,21,7,2012-09-25 12:42:59,2012-09-25 06:00:01
a1ba29d110faf53ad7eb579a523a507ed28874bf...ac17dc1764700f7413c240982c43717c41553ab0,2,5,0,5,3,2012-09-26 23:11:00,2012-09-24 08:18:05
ac17dc1764700f7413c240982c43717c41553ab0...b38277be266cfd6b6c3cc9e00730898f62a11f6e,3,12,0,12,4,2012-09-28 00:57:01,2012-09-18 16:26:08
b38277be266cfd6b6c3cc9e00730898f62a11f6e...8ac1a73635316024f05375d021344ae2b45db831,1,1,1,2,1,2012-09-28 06:21:37,2012-08-25 19:25:32
8ac1a73635316024f05375d021344ae2b45db831...d68c02e3fe50405279a138e908701558939ce926,2,33,5,38,17,2012-09-28 06:58:50,2012-09-28 06:58:50
25de1c1febed3cced22d718ac4b88028cbd6c9ad...073c7b4d083384cde62bcc4009f34888f44c793e,1,2,2,4,1,2012-08-16 00:25:25,2012-08-16 00:25:25
073c7b4d083384cde62bcc4009f34888f44c793e...c0558ff7748849ecb8d0224fd5f8c83c66502db6,1,1,0,1,1,2012-08-16 00:33:03,2012-08-16 00:33:03
c0558ff7748849ecb8d0224fd5f8c83c66502db6...f9df96b950885d6510ee6f5b4e525036fb4aba4e,1,4,4,8,4,2012-08-16 01:05:33,2012-08-16 01:05:33
f9df96b950885d6510ee6f5b4e525036fb4aba4e...226d37bb6883bcf5d409f82a9d6e910d46f175a9,1,4,4,8,4,2012-08-16 01:56:48,2012-08-16 01:56:48
226d37bb6883bcf5d409f82a9d6e910d46f175a9...73976b6c9ddbd2d22209ea292968ce700e97f1a2,4,14,9,23,10,2012-08-16 21:42:56,2012-08-16 21:42:39
73976b6c9ddbd2d22209ea292968ce700e97f1a2...b7223abbdc9ff8dd38da2bda6b87b28437edea9c,2,6,8,14,6,2012-08-16 21:43:42,2012-07-24 21:19:50
b7223abbdc9ff8dd38da2bda6b87b28437edea9c...060141c58a7cd49b1d243e8f5686195897ff83c4,3,80,22,102,14,2012-08-16 22:41:23,2012-08-16 16:56:31
060141c58a7cd49b1d243e8f5686195897ff83c4...e8fd808dfb0065466712e5115b25f2c6ce984c14,1,6,0,6,1,2012-08-16 23:02:03,2012-08-16 22:46:52
e8fd808dfb0065466712e5115b25f2c6ce984c14...9263213d8ec67af07498987cb3684a7623bc1dd4,1,2,1,3,1,2012-08-16 23:08:06,2012-08-16 23:08:06
9263213d8ec67af07498987cb3684a7623bc1dd4...9918e5d4f6fbc8fe63d0395170a2daef2484d17a,1,2,2,4,2,2012-08-17 00:30:57,2012-08-17 00:30:57
ae40f1c438050bf4607143862259ae10931e3a3c...5a0056703af70b5eab49c834903a0e9d589c0d1d,1,4,8,12,5,2012-09-28 16:55:29,2012-09-28 16:55:29
5a0056703af70b5eab49c834903a0e9d589c0d1d...3053f4d27d6b3a1182dce604b55c35f65104dccc,1,4,4,8,4,2012-09-28 17:42:52,2012-09-28 17:42:52
3053f4d27d6b3a1182dce604b55c35f65104dccc...41e53e557992a7d552a8e23de035f9463da25c99,3,41,8,49,9,2012-10-01 20:10:36,2012-10-01 20:10:32
41e53e557992a7d552a8e23de035f9463da25c99...109f8e2773bbdce8faeb45e616cd194129bab3a6,1,13,13,26,1,2012-10-02 12:50:25,2012-10-02 12:49:43
109f8e2773bbdce8faeb45e616cd194129bab3a6...016afe21aeb8e373e26b3554640cd5ff5f336b02,2,37,12,49,5,2012-10-03 17:57:31,2012-01-12 05:33:56
016afe21aeb8e373e26b3554640cd5ff5f336b02...836a06fc4f4920d5e9675763290c97aa4e7288fe,3,2,72,74,4,2012-10-04 00:40:14,2012-10-04 00:40:14
836a06fc4f4920d5e9675763290c97aa4e7288fe...ee77a6a953c65ff1fddf4017496387c42dd84d63,67,1958,19300,21258,331,2012-10-06 22:44:38,2012-10-06 21:04:30
ee77a6a953c65ff1fddf4017496387c42dd84d63...621caa7bc5e7dbac25684faebf4815be5d90e680,1,1,72,73,1,2012-10-06 22:46:35,2012-10-06 22:46:35
621caa7bc5e7dbac25684faebf4815be5d90e680...7611c7cd2588f33faae8e23d325f8538d01486a8,1,1,5,6,1,2012-10-07 18:33:33,2012-10-07 18:27:14
7611c7cd2588f33faae8e23d325f8538d01486a8...da1f48328cde3b3b04ec847bd3e9bf6ae269e1a1,1,1,1,2,1,2012-10-07 22:26:04,2012-10-07 22:25:07
da1f48328cde3b3b04ec847bd3e9bf6ae269e1a1...16a9dac8ea7ac3fd4c88b4696ed7a8dfc154d6c3,4,13,1,14,9,2012-10-07 22:44:47,2012-10-07 22:44:47
16a9dac8ea7ac3fd4c88b4696ed7a8dfc154d6c3...76ddf06f1081e51c163f1c5bc3d37895ed2c62c6,2,42,8,50,6,2012-10-08 00:23:46,2012-10-08 00:18:30
76ddf06f1081e51c163f1c5bc3d37895ed2c62c6...5288ed75be97f55604867b8a46ad3594f7298035,1,13,5,18,3,2012-10-08 22:47:38,2012-10-08 22:47:38
5288ed75be97f55604867b8a46ad3594f7298035...8bd4590a3196ac7b7d11f78564bc3ff13c8807ae,2,40,4,44,6,2012-10-09 14:18:26,2012-10-09 08:14:00
8bd4590a3196ac7b7d11f78564bc3ff13c8807ae...c668185adde3a474585a11f172b8387e270ec23b,2,45,1,46,2,2012-10-09 14:23:24,2012-10-09 01:01:03
c668185adde3a474585a11f172b8387e270ec23b...7394e89ff6167cf371e17cb43ff8d5c2f10d539c,1,0,6,6,1,2012-10-09 14:32:51,2012-10-09 14:32:49
7394e89ff6167cf371e17cb43ff8d5c2f10d539c...0ad005852c7bd7e896c9c94ae5284493aa35cb83,5,17,4,21,8,2012-10-09 14:38:00,2012-10-07 23:22:44
0ad005852c7bd7e896c9c94ae5284493aa35cb83...5823290390ed8a65976778e055e35ac5e1d857f2,12,444,37,481,23,2012-10-10 00:17:32,2012-10-10 00:17:32
5823290390ed8a65976778e055e35ac5e1d857f2...07774e6b9570f90166a54fa87af74b8a7cf9926a,3,43,20,63,12,2012-10-10 20:31:47,2012-10-10 01:47:08
07774e6b9570f90166a54fa87af74b8a7cf9926a...e3ee289cca5fd89e5ef2cbc3d3949526270f0881,2,18,4,22,18,2012-10-10 21:14:55,2012-10-10 21:07:33
e3ee289cca5fd89e5ef2cbc3d3949526270f0881...4eb5399bb28d3481dddafb5cc68843771bfe17a1,3,13,1,14,4,2012-10-10 21:40:36,2012-10-10 20:52:56
4eb5399bb28d3481dddafb5cc68843771bfe17a1...d7c45ea7d03de5c4a6c71b34780150fcd1e6314c,5,13,13,26,11,2012-10-11 12:36:23,2012-10-11 12:36:23
d7c45ea7d03de5c4a6c71b34780150fcd1e6314c...061f2075cf81017cdb40de80533ba18746743c94,7,132,2,134,11,2012-10-11 23:46:18,2012-10-11 22:53:11
061f2075cf81017cdb40de80533ba18746743c94...8509073458f227901dc84e872dc01651c3b912d3,3,4,3,7,3,2012-10-12 18:46:36,2012-10-12 18:44:02
8509073458f227901dc84e872dc01651c3b912d3...61978f57e6c3cfd8aeb3cc22490d10b1ea09f473,1,0,9,9,2,2012-10-12 23:27:15,2012-10-12 23:22:05
61978f57e6c3cfd8aeb3cc22490d10b1ea09f473...f53441ab1f5a6d479928de388660dd83029fa058,4,48,0,48,6,2012-10-12 23:49:57,2012-10-12 23:26:14
f53441ab1f5a6d479928de388660dd83029fa058...14a6c4efb853fe853698b9c8d6dc619fbe8a206d,4,51,0,51,6,2012-10-13 00:55:14,2012-10-13 00:44:11
14a6c4efb853fe853698b9c8d6dc619fbe8a206d...2fbf0612a1f0e25f1989e5858cbb65ef7411ee66,2,16,2,18,5,2012-10-13 00:55:17,2012-10-13 00:49:53
2fbf0612a1f0e25f1989e5858cbb65ef7411ee66...93efc7f78d47b2c06fddd2f85236001e07b003af,1,5,53,58,2,2012-10-13 22:54:20,2012-10-12 23:03:22
93efc7f78d47b2c06fddd2f85236001e07b003af...47643d2ec517ceb8f7ce180142262e393c4d8e89,1,2,3,5,2,2012-10-13 22:57:09,2012-10-12 23:24:25
9918e5d4f6fbc8fe63d0395170a2daef2484d17a...be3a77bd428612dc7c8b6bd0f76e51ef277f4fb0,1,0,1,1,1,2012-08-20 15:18:14,2012-08-19 18:11:47
be3a77bd428612dc7c8b6bd0f76e51ef277f4fb0...0844e2359bc6b5974db9ec5a8065561ffa87cdcc,10,124,96,220,40,2012-08-20 15:29:58,2012-08-20 15:20:41
0844e2359bc6b5974db9ec5a8065561ffa87cdcc...b1ffbdc975d58b31e3b13749c29fdc07049ea1d9,2,30,15,45,7,2012-08-20 15:29:58,2012-08-20 10:52:26
b1ffbdc975d58b31e3b13749c29fdc07049ea1d9...d38d7bea6c08ba9b1367ebd44f9ade1154e3d04d,1,5,2,7,1,2012-08-20 16:42:05,2012-08-20 16:13:05
d38d7bea6c08ba9b1367ebd44f9ade1154e3d04d...2d9239359db7ba8d23761ca18cef9455f812f111,6,57,10,67,13,2012-08-21 01:04:16,2012-08-21 01:04:16
2d9239359db7ba8d23761ca18cef9455f812f111...ef0ca2affd9f96327c9e72497bd0c74aae5c8861,2,6,8,14,6,2012-08-21 01:05:25,2012-08-21 01:05:25
ef0ca2affd9f96327c9e72497bd0c74aae5c8861...7c75ca7182872c95c798e192ed28c1c610b1024b,1,2,2,4,1,2012-08-21 11:44:29,2012-08-21 11:44:29
7c75ca7182872c95c798e192ed28c1c610b1024b...badbd1af27f5f3fd07862b8ee7d0810e7ae9ef56,2,34,19,53,4,2012-08-21 20:27:13,2012-08-21 20:27:13
badbd1af27f5f3fd07862b8ee7d0810e7ae9ef56...2bcb9ab7bcd474590f109bd04c43ba8e39a90dfa,170,1377,1051,2428,309,2012-08-21 22:29:37,2012-08-21 22:29:03
2bcb9ab7bcd474590f109bd04c43ba8e39a90dfa...024f4b12a5557a2e935fc16950240709c89178ea,104,152,111,263,115,2012-08-21 23:27:30,2012-08-21 23:27:30
024f4b12a5557a2e935fc16950240709c89178ea...2f1985ca7dc465c8b28318b903fe411385b211cc,101,106,106,212,106,2012-08-22 00:38:21,2012-08-22 00:38:21
2f1985ca7dc465c8b28318b903fe411385b211cc...2e1f2b535e91506a128062ead055da0a9447b17e,1,1,1,2,1,2012-08-22 07:33:52,2012-08-21 08:11:04
4b238b4c2ae8f5cf409cea5ca214b480b00e1a86...c11c19b92cb38532b1892c54ae25502873b14699,82,856,210,1066,270,2012-10-17 16:33:45,2012-10-17 16:33:40
c11c19b92cb38532b1892c54ae25502873b14699...cb6d084d356da501bbdcfb6d0ac90180e011a9e2,1,1,1,2,1,2012-10-20 13:03:48,2012-10-20 13:03:48
cb6d084d356da501bbdcfb6d0ac90180e011a9e2...72ce9baa75434f64e42ee4e666897ddfd754c822,1,0,1,1,1,2012-10-21 20:58:14,2012-10-18 15:53:53
2e1f2b535e91506a128062ead055da0a9447b17e...f90c9ce0e255e531fee4f07dbe53f0c6c893e700,24,4065,159,4224,150,2012-08-22 19:18:45,2012-08-22 19:18:45
2e1f2b535e91506a128062ead055da0a9447b17e...ee200942dd7af613892883def5ac53862afc9129,1,1,1,2,1,2012-08-22 18:03:14,2012-08-22 16:46:07
ee200942dd7af613892883def5ac53862afc9129...c259499945af1079b1e4e92c57a1140659f6261a,103,119,109,228,109,2012-08-22 18:03:15,2012-08-22 08:19:50
c259499945af1079b1e4e92c57a1140659f6261a...a299c97bbc701f4d460e91214d7bfe7a9589d361,3,28,2,30,3,2012-08-22 18:03:20,2012-08-22 08:23:47
0ee1760ee11f98afa392bc03d59f1e0acbf0e6e6...0ccdedab795a09c65336bba36005c2a96846fe36,1,2,2,4,1,2012-08-22 19:52:05,2012-08-22 19:52:05
0ccdedab795a09c65336bba36005c2a96846fe36...0407ecfcfbf0bf31951177be6ed14bf84051a592,1,77,0,77,1,2012-08-22 19:53:22,2012-08-22 19:53:22
0407ecfcfbf0bf31951177be6ed14bf84051a592...99ad52ecbe99df14e46d1a6bcd20d8c848fd6296,3,0,49,49,3,2012-08-22 21:58:34,2012-08-22 21:58:34
99ad52ecbe99df14e46d1a6bcd20d8c848fd6296...1597ce0eb3c1a836d9af3a02d9f07460dc939920,1,36,36,72,3,2012-08-22 22:11:34,2012-08-22 22:11:26
1597ce0eb3c1a836d9af3a02d9f07460dc939920...422772f23bea12a878d4e61418066576895bfef6,1,2,2,4,2,2012-08-23 14:03:48,2012-08-23 14:03:46
422772f23bea12a878d4e61418066576895bfef6...81b711ba0bf9b1ae418f4d0f8d56717b97a6b7e1,1,4,7,11,2,2012-08-23 14:04:53,2012-08-23 13:55:42
81b711ba0bf9b1ae418f4d0f8d56717b97a6b7e1...45cd4e211e77c34228560770a3e0199988328258,5,511,466,977,175,2012-08-23 15:54:12,2012-08-23 15:54:12
45cd4e211e77c34228560770a3e0199988328258...1eab51412f533069ee1f52006e50577fcbf0774a,1,1,1,2,1,2012-08-23 15:54:22,2012-08-23 13:42:34
1eab51412f533069ee1f52006e50577fcbf0774a...31ddd9516e65cf4504e671f3454497afc257885c,6,5,30,35,6,2012-08-23 15:54:23,2012-08-23 13:50:34
31ddd9516e65cf4504e671f3454497afc257885c...6c371c6a8c54bfe533f1ee01770d15bc2253e5ad,1,1,3,4,1,2012-08-23 15:54:24,2012-08-23 14:13:37
6c371c6a8c54bfe533f1ee01770d15bc2253e5ad...985fdf2cb38c3537fb31d57dc402793a19a5e43b,1,200,158,358,12,2012-08-23 15:54:25,2012-08-23 15:51:59
985fdf2cb38c3537fb31d57dc402793a19a5e43b...f8fd9aca8bd01fa7226e1abe75a5bcf903f287ab,1,5,1,6,2,2012-08-23 23:45:55,2012-08-23 18:28:17
f8fd9aca8bd01fa7226e1abe75a5bcf903f287ab...7142b260c6c299fc9697e6554620be47a6f622a9,1,10,7,17,4,2012-08-23 23:46:03,2012-08-23 18:28:47
7142b260c6c299fc9697e6554620be47a6f622a9...59011448c0c47a1ad374f5b184d2627fc68c06bd,1,18,6,24,4,2012-08-24 13:47:53,2012-08-24 13:47:53
59011448c0c47a1ad374f5b184d2627fc68c06bd...752ac320ae48d266fdc5d61a3963857b8f343c10,3,70,3,73,6,2012-08-24 14:56:06,2012-08-18 05:18:02
752ac320ae48d266fdc5d61a3963857b8f343c10...2d0c1da975d13910700c2591339e64be229607ac,1,1,1,2,1,2012-08-24 23:11:55,2012-08-24 23:11:55
2d0c1da975d13910700c2591339e64be229607ac...84590f3fe9507887cebdcc11b3d1bc93180dc5a7,1,1,1,2,1,2012-08-27 20:09:01,2012-08-27 20:06:34
84590f3fe9507887cebdcc11b3d1bc93180dc5a7...2786737417810c0a4f0b70ac80a9c298486de355,1,3,0,3,1,2012-08-27 20:09:23,2012-08-27 20:08:06
2786737417810c0a4f0b70ac80a9c298486de355...24184345688e1f545ffc87e5742de06ed9855007,1,2,1,3,1,2012-08-28 00:17:08,2012-08-27 22:26:29
18beea4a3f89ef52d0e8fe812475f3728af53726...e8b0427be28460205f99ba6e7fad0eef92e90b6f,3,78,64,142,43,2012-10-23 15:42:43,2012-10-09 08:24:58
e8b0427be28460205f99ba6e7fad0eef92e90b6f...160e4d053481f3ad85e5532a353a68c1565764d2,1,1,1,2,1,2012-10-23 15:43:38,2012-10-23 15:38:41
24184345688e1f545ffc87e5742de06ed9855007...ef3617c6f862900ab5b4963164641c70f86c23a5,1,2,2,4,2,2012-08-28 20:10:56,2012-08-26 03:20:42
ef3617c6f862900ab5b4963164641c70f86c23a5...0ef1e5b5eb31699ab5ec4272029f574c235b8a4c,1,116,0,116,1,2012-08-28 22:34:08,2012-08-28 22:34:08
0ef1e5b5eb31699ab5ec4272029f574c235b8a4c...dec16aa5c2e21de1d0db737f2a08872993c1b2dd,1,106,0,106,1,2012-08-29 19:26:28,2012-08-29 19:26:28
dec16aa5c2e21de1d0db737f2a08872993c1b2dd...a57d31595d842b7f250d06e14c58340d5c4c453e,1,2,2,4,2,2012-08-29 22:27:00,2012-08-29 16:52:55
a57d31595d842b7f250d06e14c58340d5c4c453e...355c14842734e790a2581b9db58041c7ca54edf9,1,8,0,8,1,2012-08-29 23:12:59,2012-08-29 21:57:25
355c14842734e790a2581b9db58041c7ca54edf9...b0d2795fe9501218dd8c953252fffe2d05d59c2a,3,69,1,70,5,2012-08-30 14:13:27,2012-08-30 14:13:27
b0d2795fe9501218dd8c953252fffe2d05d59c2a...9603f08f21987d5367d98267a16179a61e4400c1,5,25,3,28,7,2012-08-30 15:28:02,2012-08-30 15:28:02
9603f08f21987d5367d98267a16179a61e4400c1...f347077e786b1ca78d44e2c77b1bc1366735af76,3,68,27,95,7,2012-08-30 22:23:36,2012-08-30 15:11:05
f347077e786b1ca78d44e2c77b1bc1366735af76...6b9425fe3783193cf95cb04cbcbcbb97f5a77d31,3,109,3,112,6,2012-09-01 15:27:17,2012-09-01 15:14:18
6b9425fe3783193cf95cb04cbcbcbb97f5a77d31...6c5fdd5223963631ea97d8a20388fc3147a8bdeb,1,7,1,8,1,2012-09-02 11:32:57,2012-09-02 11:32:57
6c5fdd5223963631ea97d8a20388fc3147a8bdeb...37f0eb8df310fb43f29ff4ffff5e23fba660dbaa,3,3,109,112,6,2012-09-02 11:59:50,2012-09-02 11:59:50
37f0eb8df310fb43f29ff4ffff5e23fba660dbaa...ea1cba6246a8b1784e22d076139b9244a9ff42f8,1,4,0,4,1,2012-09-03 17:05:40,2012-09-03 17:05:40
ea1cba6246a8b1784e22d076139b9244a9ff42f8...d1eff9ab68ae3fa32285544ad9f1d2c2ed52ab82,2,44,14,58,6,2012-09-03 21:33:02,2012-09-03 21:09:17
d1eff9ab68ae3fa32285544ad9f1d2c2ed52ab82...7d0543c128839523e088f3ef3aeec88ee884b4e4,2,9,9,18,7,2012-09-03 21:33:02,2012-09-03 21:15:30
7d0543c128839523e088f3ef3aeec88ee884b4e4...7dfa587d18c9d55cf2625c138250ef02c464d911,2,12,15,27,7,2012-09-03 21:33:02,2012-09-03 21:26:19
7dfa587d18c9d55cf2625c138250ef02c464d911...9f57e422cf15fbd1abdaa7795d373058ea9ee133,1,1,1,2,1,2012-09-03 22:41:40,2012-09-03 10:09:50
160e4d053481f3ad85e5532a353a68c1565764d2...9901b69c8e372f39d6214fc0254b6465c4f329dc,4,304,73,377,44,2012-10-23 17:22:42,2012-10-10 22:44:47
9901b69c8e372f39d6214fc0254b6465c4f329dc...bfb9d5bbe61a0815a6505c6fd31a31f7dd5bfcf1,4,178,774,952,95,2012-10-23 17:48:50,2012-10-13 00:36:18
bfb9d5bbe61a0815a6505c6fd31a31f7dd5bfcf1...4266f5cf2ebe171b5b32ce780bed3c307d3a1a94,1,4,1,5,1,2012-10-23 17:48:50,2012-10-13 01:41:30
4266f5cf2ebe171b5b32ce780bed3c307d3a1a94...76b0bdf7207b275ec2e0de7c71ea333be8b38c70,8,929,148,1077,84,2012-10-23 17:48:51,2012-10-22 17:37:20
76b0bdf7207b275ec2e0de7c71ea333be8b38c70...c87b524c5f40f52a63d8b6f01e0d4df842c63f96,2,122,134,256,58,2012-10-23 17:48:51,2012-10-23 17:35:15
c87b524c5f40f52a63d8b6f01e0d4df842c63f96...f3621359f4866c8ed732a48ece4049cc6e9a8b91,1,1,2,3,1,2012-10-23 17:48:51,2012-10-23 17:27:11
f3621359f4866c8ed732a48ece4049cc6e9a8b91...d7da20c812c5842d134252c7b3cdbf20a7dab243,2,15,5,20,4,2012-10-23 17:48:51,2012-10-23 17:29:06
d7da20c812c5842d134252c7b3cdbf20a7dab243...f2fa97f178d72d2b10397d776add07cc02dddf28,1,46,62,108,34,2012-10-23 17:48:51,2012-10-23 17:28:51
f2fa97f178d72d2b10397d776add07cc02dddf28...1122e3af289d576a9f4437f579f0d8c241549bd6,1,29,29,58,25,2012-10-23 17:48:51,2012-10-23 16:08:40
9f57e422cf15fbd1abdaa7795d373058ea9ee133...6174ea6b4cc95dd2b6fbd0d8d5a82d37e736c4b5,16,33,33,66,32,2012-09-04 19:15:39,2012-09-04 14:24:20
6174ea6b4cc95dd2b6fbd0d8d5a82d37e736c4b5...4899116d4b24b50fa23ac1de9befd35d37c3bd29,10,345,37,382,32,2012-09-06 13:58:09,2012-09-06 13:58:09
4899116d4b24b50fa23ac1de9befd35d37c3bd29...c5e554dc7ef36c276760f55fb702b1ac0dfa4fa8,2,6,8,14,6,2012-09-06 13:58:37,2012-08-21 01:05:25
c5e554dc7ef36c276760f55fb702b1ac0dfa4fa8...052e63f27f7b1edf5635d6a266653fe77c42941c,2,86,6,92,5,2012-09-06 14:07:40,2012-09-06 14:06:15
052e63f27f7b1edf5635d6a266653fe77c42941c...0087bc6370c440fad0d8fc61515a7c02e9f8ae1b,1,18,1,19,2,2012-09-06 20:00:05,2012-08-17 20:57:23
0087bc6370c440fad0d8fc61515a7c02e9f8ae1b...9a3521cb25e5f0035cf38ed7b16729c8d0dc3c65,2,149,1,150,2,2012-09-08 19:43:57,2012-09-08 19:43:55
9a3521cb25e5f0035cf38ed7b16729c8d0dc3c65...fb383a0ad08470d2a50923c7f3baa3a59a530026,2,13,2,15,4,2012-09-08 22:09:59,2012-09-08 22:09:59
fb383a0ad08470d2a50923c7f3baa3a59a530026...608898c15b9181a583d99d0da05f145997a98db0,1,8,0,8,2,2012-09-09 18:41:05,2012-09-09 18:41:05
608898c15b9181a583d99d0da05f145997a98db0...54a4c639e9753c0094c49f9d9788e727643b3f28,657,43313,290,43603,685,2012-09-10 16:11:54,2012-09-10 16:11:54
54a4c639e9753c0094c49f9d9788e727643b3f28...41e1b171ec644a1a5645e819cec7c8ccc0ba5f2e,1,1,1,2,1,2012-09-10 23:00:27,2012-09-10 22:58:30
3570f2097f20e8ab9495995cc117c4fa5dc52ddd...95c9305874f2bcfd1df89a583c1f80a60a7fab54,21,301,135,436,84,2012-10-23 18:48:55,2012-10-23 18:48:55
95c9305874f2bcfd1df89a583c1f80a60a7fab54...a0ee291566511a7fd959384381e3a7981bd43e60,6,108,78,186,52,2012-10-23 18:50:46,2012-10-23 18:50:46
41e1b171ec644a1a5645e819cec7c8ccc0ba5f2e...005ae232502c391c9ddc9fc97537e4bab7288556,1,10,0,10,5,2012-09-11 15:43:28,2012-09-11 15:40:17
005ae232502c391c9ddc9fc97537e4bab7288556...e35cec5c05f75aa247f6c6cecbf2b76259e72158,1,2,0,2,1,2012-09-11 15:43:31,2012-09-11 15:43:20
e35cec5c05f75aa247f6c6cecbf2b76259e72158...6e0b8b169c18112fdedfdb89237b87007da4c466,1,1,1,2,1,2012-09-11 15:45:25,2012-09-11 15:45:18
6e0b8b169c18112fdedfdb89237b87007da4c466...1c2982b94f46765d85b71a0efe3b832d3caff35f,2,2,2,4,2,2012-09-11 17:57:25,2012-09-11 17:57:16
1c2982b94f46765d85b71a0efe3b832d3caff35f...b88c3902b241cf934e75443b934f2033ad3915b1,2,47,2,49,2,2012-09-11 18:08:07,2012-09-11 15:19:12
c3ca783525c3de368572a12e627e56090e49f594...abf37c1e6655be89afaf5822108ca6dcf0f99096,1,2,2,4,2,2012-10-24 16:21:44,2012-10-24 16:21:39
abf37c1e6655be89afaf5822108ca6dcf0f99096...1ed4c6776e4f52956918b70565502e0f8869829d,3,38,1,39,3,2012-10-24 16:21:44,2012-10-23 19:08:59
c3ca783525c3de368572a12e627e56090e49f594...6822488c93ddc683061cfbeb6063ad140417a365,1,2,1,3,2,2012-10-24 00:42:57,2012-10-24 00:42:57
6822488c93ddc683061cfbeb6063ad140417a365...8ac017eba7cf5147e7bdeec09cf6170c62536467,2,2,2,4,2,2012-10-24 13:37:34,2012-10-24 13:35:58
72d31248415745edd560d22dd9a35c950540e7e2...d80de98e9104074c9f2a4b4392a4c314e4a80c65,1,97,0,97,1,2012-09-11 18:59:10,2012-09-11 18:57:57
d80de98e9104074c9f2a4b4392a4c314e4a80c65...362189a5d35e7e17d4bcbb85e2296dae6579065e,1,2,2,4,1,2012-09-11 18:59:37,2012-09-11 18:59:37
362189a5d35e7e17d4bcbb85e2296dae6579065e...4870a4e3da44d61f1fec67449d311fba5fc71af6,1,10,1,11,1,2012-09-12 00:46:53,2012-09-12 00:46:45
4870a4e3da44d61f1fec67449d311fba5fc71af6...58a5bc1ec70a92590139607d3066f644cf945184,1,8,5,13,3,2012-09-12 15:08:32,2012-09-12 15:04:31
58a5bc1ec70a92590139607d3066f644cf945184...451ff1540ab536237e8d751d241d7fc3391a4087,2,96,0,96,3,2012-09-12 16:50:06,2012-09-09 12:32:40
9b3f63503e71ff4476ef37953238b892eb482181...78dbb15858f9d274442ed5be910ac853b11c2505,1,2,2,4,1,2012-10-24 17:10:57,2012-10-24 17:10:57
78dbb15858f9d274442ed5be910ac853b11c2505...fa94f0fe8338fcd7832a1146a4d847b27dea9a55,1,3,0,3,1,2012-10-24 19:29:46,2012-07-31 22:52:37
451ff1540ab536237e8d751d241d7fc3391a4087...25c2940a08453ec206268f5e86cc520b06194d88,14,192,165,357,141,2012-09-13 22:00:05,2012-08-20 00:01:32
25c2940a08453ec206268f5e86cc520b06194d88...1d52968d1dbd04053356d62dc0804bcc68deed8a,1,2,2,4,2,2012-09-13 22:00:46,2012-08-20 19:06:29
1d52968d1dbd04053356d62dc0804bcc68deed8a...07804c7c9a4c2eb50eb897fa5e41cb8c9e5a1ab5,3,83,40,123,3,2012-09-14 00:37:51,2012-09-13 23:59:44
07804c7c9a4c2eb50eb897fa5e41cb8c9e5a1ab5...db5c26e3b57c5c0c5c3e84931bc73b701f0258d1,1,10,5,15,2,2012-09-14 00:37:51,2012-09-14 00:34:10
db5c26e3b57c5c0c5c3e84931bc73b701f0258d1...96ca59fbf382773bd937e9e4ca06d23845dae46d,1,2,0,2,2,2012-09-17 05:20:47,2012-09-17 05:17:11
96ca59fbf382773bd937e9e4ca06d23845dae46d...a08271c7a8e0a07034c61028b69db993c0f61145,3,3,3,6,3,2012-09-17 14:05:53,2012-09-02 07:36:21
a08271c7a8e0a07034c61028b69db993c0f61145...39a0836d5c9bd4f76b07fa32cf81310ec8b80383,2,45,1,46,2,2012-09-17 15:52:50,2012-09-17 15:40:23
39a0836d5c9bd4f76b07fa32cf81310ec8b80383...43a2b291822416eb5f72d17ad250e7542abb0581,1,95,0,95,1,2012-09-18 01:33:36,2012-09-18 01:33:36
43a2b291822416eb5f72d17ad250e7542abb0581...040057167653e8e6ce4d5a368fbc6d73bb541e28,3,85,5,90,9,2012-09-21 16:22:50,2012-09-20 22:13:36
040057167653e8e6ce4d5a368fbc6d73bb541e28...4165f736e65215bc39b38186582022039068c108,1,13,4,17,2,2012-09-22 01:51:44,2012-09-18 22:35:29
4165f736e65215bc39b38186582022039068c108...f536eb176b0b4d167d2d34357a12a83a30c71c97,8,190,84,274,23,2012-09-22 01:53:48,2012-09-22 01:53:16
f536eb176b0b4d167d2d34357a12a83a30c71c97...4a2670740c0e8cb4831c2c089cc7de7337a55e80,2,7,0,7,2,2012-09-22 02:49:29,2012-09-22 01:46:16
4a2670740c0e8cb4831c2c089cc7de7337a55e80...0f2ed2bc2c1164a33c39d172960b4aca1be08baa,2,71,0,71,2,2012-09-24 18:48:39,2012-09-24 18:30:26
0f2ed2bc2c1164a33c39d172960b4aca1be08baa...d5e9895ce0fb708e35216753999b951bae571f39,1,24,24,48,9,2012-09-25 12:38:36,2012-09-22 22:48:47
9b61f570d86f994e9677d255c8fd413f38f4fe9c...953b049a89f803b0a152e776b8590e78ada180e4,1,5,2,7,1,2012-10-29 13:27:30,2012-10-25 23:51:46
953b049a89f803b0a152e776b8590e78ada180e4...21c741f2576bd096faf44d0aa66ec04c2dfa54a0,5,129,1,130,7,2012-10-29 17:53:39,2012-10-29 17:31:50
21c741f2576bd096faf44d0aa66ec04c2dfa54a0...570e4be932cc308c0f4daa0764564d267dbd0608,2,36,3,39,10,2012-10-30 14:03:17,2012-10-30 00:19:01
570e4be932cc308c0f4daa0764564d267dbd0608...a93424da4aeb03e71c39eab68e0b0588ecb401e1,1,6,0,6,5,2012-10-30 14:03:27,2012-10-30 13:40:50
a93424da4aeb03e71c39eab68e0b0588ecb401e1...19b87bbda05f2cf141aa17c2ece5878ee7991fea,1,0,1,1,1,2012-10-30 15:58:07,2012-10-30 14:42:44
19b87bbda05f2cf141aa17c2ece5878ee7991fea...54d293da560a86e48b302c0ef219ac6e38a9a1e9,2,49,0,49,2,2012-10-30 16:16:13,2012-10-15 17:07:24
54d293da560a86e48b302c0ef219ac6e38a9a1e9...cfbfaaa87d4145cfc2e2e2e8f9ee3e987d52ae43,1,1,1,2,1,2012-10-31 22:17:45,2012-10-30 22:04:29
cfbfaaa87d4145cfc2e2e2e8f9ee3e987d52ae43...07d3b21f4352e58928b6b6c2c3c0bfc59153bea9,2,21,10,31,9,2012-10-31 23:56:30,2012-10-30 17:16:28
07d3b21f4352e58928b6b6c2c3c0bfc59153bea9...a12c42ca2f8d5ce71c75cab334a53bd71bdaea09,1,1,1,2,1,2012-11-01 00:07:58,2012-11-01 00:07:58
a12c42ca2f8d5ce71c75cab334a53bd71bdaea09...ab1e66d93f4eddf23f62fd69094690124357e3e9,24,495,73,568,73,2012-11-01 00:22:16,2012-10-30 22:06:03
ab1e66d93f4eddf23f62fd69094690124357e3e9...06810b29fae7c549c3a016f2faa3cf6b444a1149,5,168,21,189,59,2012-11-01 00:25:22,2012-10-09 22:09:07
06810b29fae7c549c3a016f2faa3cf6b444a1149...2f5fa089e9cf8eb6a077ea5f96c48f4685413d70,1,9,0,9,2,2012-11-01 00:36:46,2012-11-01 00:36:41
2f5fa089e9cf8eb6a077ea5f96c48f4685413d70...66f64ae072271ef36e9f684a965f1fc410d86ebc,4,306,13,319,27,2012-11-01 13:06:26,2012-09-05 19:44:15
66f64ae072271ef36e9f684a965f1fc410d86ebc...2f03eaf76f8993a99343c4d975944e1635e6d98e,1,2,2,4,2,2012-11-01 15:16:27,2012-11-01 08:29:33
2f03eaf76f8993a99343c4d975944e1635e6d98e...148f5e65123c92f62776a769c54e6318d984225e,1,3,2,5,3,2012-11-01 21:20:21,2012-11-01 05:14:46
148f5e65123c92f62776a769c54e6318d984225e...a6fef475ceb3e7e001a0dc659c028ad947a50886,1,3,0,3,1,2012-11-02 14:58:21,2012-11-02 14:56:47
a6fef475ceb3e7e001a0dc659c028ad947a50886...a7ac1a1d8882a20636eeeb8e07e33cd0cfbaf578,21,109,308,417,36,2012-11-04 00:25:06,2012-11-04 00:25:06
a7ac1a1d8882a20636eeeb8e07e33cd0cfbaf578...83e5e20c2c24f440b9212453336e7495402a9ed8,1,0,5,5,1,2012-11-04 00:26:30,2012-11-04 00:26:27
83e5e20c2c24f440b9212453336e7495402a9ed8...05882668f97c2533a5de757637033d36bcf93fac,3,8,5,13,3,2012-11-04 00:34:46,2012-10-17 17:06:37
05882668f97c2533a5de757637033d36bcf93fac...fddb5dc2d3bf063ed5a06c4af7a86e644f5328c9,2,132,0,132,3,2012-11-05 23:13:26,2012-10-13 02:56:51
fddb5dc2d3bf063ed5a06c4af7a86e644f5328c9...bfd78b69fc7d0ac97106658e4eb6d475fa08e247,3,41,1,42,7,2012-11-05 23:18:35,2012-10-23 13:01:26
bfd78b69fc7d0ac97106658e4eb6d475fa08e247...73ff653a8db11cbe0142df4e764434f125e45e6b,3,41,1,42,7,2012-11-05 23:18:35,2012-10-23 14:27:19
73ff653a8db11cbe0142df4e764434f125e45e6b...d264b230775a9d386f3654b33ad639db7f4e7819,1,2,1,3,1,2012-11-05 23:18:36,2012-09-14 18:14:35
d264b230775a9d386f3654b33ad639db7f4e7819...ac047166f6fd6f9624294d5d9d2c672a7a76a828,1,8,0,8,3,2012-11-05 23:18:36,2012-09-14 18:16:43
ac047166f6fd6f9624294d5d9d2c672a7a76a828...0f3ddad0fc9501d511761b3a92e0fbc8f2ea0bab,1,0,1,1,1,2012-11-05 23:18:36,2012-09-14 18:29:33
0f3ddad0fc9501d511761b3a92e0fbc8f2ea0bab...02dffb063e423688557e2f8004eb817d7626bf41,1,3,0,3,1,2012-11-05 23:18:36,2012-10-25 14:53:51
02dffb063e423688557e2f8004eb817d7626bf41...f36bfd1590fe6712911c4584d32011d15b4c2df8,1,1,1,2,1,2012-11-05 23:25:21,2012-10-10 07:28:42
f36bfd1590fe6712911c4584d32011d15b4c2df8...fb6377ebd0aed7da8ad179d41455eba8510602c5,3,31,22,53,6,2012-11-06 15:49:21,2012-10-09 00:51:59
fb6377ebd0aed7da8ad179d41455eba8510602c5...e95e095289c8f043c0d1a8508b9952ae9684b4d9,2,7,7,14,7,2012-11-07 00:28:24,2012-11-06 22:54:58
e95e095289c8f043c0d1a8508b9952ae9684b4d9...3c91a7ae10f0ccabe4550c77189813f8d95785b0,2,97,91,188,12,2012-11-07 00:28:30,2012-11-06 22:58:47
3c91a7ae10f0ccabe4550c77189813f8d95785b0...5e4e87ade5ad2dbf525865a3a94694dabb9b1d7f,4,18,0,18,5,2012-11-08 20:31:45,2012-11-08 20:31:45
5e4e87ade5ad2dbf525865a3a94694dabb9b1d7f...13c5db977190f926a213fc8ad7204e1febe36009,1,0,33,33,3,2012-11-10 01:11:04,2012-11-09 22:02:45
13c5db977190f926a213fc8ad7204e1febe36009...b6e989759bfcfdc00d9d4b5a3b32d31ea29838c0,2,4,1,5,2,2012-11-10 17:21:17,2012-11-10 17:21:13
b6e989759bfcfdc00d9d4b5a3b32d31ea29838c0...e2bcff9aa75e51b9ba071330fe712180abed03e0,1,3,4,7,3,2012-11-11 18:02:33,2012-11-11 18:02:33
e2bcff9aa75e51b9ba071330fe712180abed03e0...b6a3b0a6297ee205aa34d357edd55b79f91cdf09,88,1146,56391,57537,362,2012-11-16 16:58:42,2012-11-16 16:57:15
b6a3b0a6297ee205aa34d357edd55b79f91cdf09...38809e3985d3c819ec58ca311d8e1eaef8124d6d,3,41,1,42,7,2012-11-16 22:34:13,2012-10-23 23:54:22
38809e3985d3c819ec58ca311d8e1eaef8124d6d...71ba7bc2a0b869ecafcfb3a62304b6713eb6d1ca,2,0,72,72,2,2012-11-16 22:44:44,2012-11-16 22:44:42
71ba7bc2a0b869ecafcfb3a62304b6713eb6d1ca...019ad346e0a9f1669a1e81b0ae3eb2e0f7e4ddd7,2,19,13,32,11,2012-11-16 23:52:58,2012-11-09 20:32:28
019ad346e0a9f1669a1e81b0ae3eb2e0f7e4ddd7...38c52a0575fa92a2413fbefb754bfdc7af144b89,22,971,479,1450,236,2012-11-20 15:40:51,2012-11-20 14:51:25
38c52a0575fa92a2413fbefb754bfdc7af144b89...6f9ed28fac9db8ca34169059962118209826b28a,1,1,1,2,1,2012-11-20 17:02:56,2012-11-20 16:15:17
6f9ed28fac9db8ca34169059962118209826b28a...8ba1bec47d1a3f16db25af4efc29fab2ad2ffd3c,8,28,43,71,26,2012-11-20 21:44:23,2012-11-20 19:11:08
8ba1bec47d1a3f16db25af4efc29fab2ad2ffd3c...815a181d03641573a92441d31764f53b0f6e778e,1,1,1,2,1,2012-11-20 21:44:23,2012-11-20 20:42:21
815a181d03641573a92441d31764f53b0f6e778e...1e738c5ef2cb5a1bf5794bb044114991e057d5e6,8,19,11,30,16,2012-11-20 21:47:45,2012-11-20 16:28:28
1e738c5ef2cb5a1bf5794bb044114991e057d5e6...a25ebb1997dc14ef16f1314cd8c8ede07a5a29e3,5,36,20,56,17,2012-11-20 21:48:26,2012-11-20 17:12:07
a25ebb1997dc14ef16f1314cd8c8ede07a5a29e3...bc9388342f59ed5c69d69c7095e5a17fcbd80ba8,2,94,10,104,8,2012-11-21 00:21:25,2012-11-21 00:00:45
bc9388342f59ed5c69d69c7095e5a17fcbd80ba8...f657ce685dddc1bf2d5b42f56d728df9176cceb9,17,827,30,857,48,2012-11-21 00:21:53,2012-11-20 23:27:22
f657ce685dddc1bf2d5b42f56d728df9176cceb9...11a5119e72f1a93fa7f30c144afd6ec4f04a275a,1,5,0,5,1,2012-11-21 13:06:37,2012-11-21 08:34:56
11a5119e72f1a93fa7f30c144afd6ec4f04a275a...8d2753c14120e7aef2d4ad1ca0c9dc612c0c9b8b,1,1,1,2,1,2012-11-22 15:10:36,2012-11-22 15:10:35
8d2753c14120e7aef2d4ad1ca0c9dc612c0c9b8b...335f20896aaf4a96b15e2fcc69b384ef3182f92c,1,2,4,6,2,2012-11-23 23:10:25,2012-11-23 22:53:15
335f20896aaf4a96b15e2fcc69b384ef3182f92c...aa3441ae45b348aa2e1b422d1c5a69b49e909a95,1,1,1,2,1,2012-11-24 00:14:09,2012-11-24 00:14:06
aa3441ae45b348aa2e1b422d1c5a69b49e909a95...ffb4c173a426647dbbb7bc7d2787140556de5e5b,1,4,4,8,4,2012-11-27 04:44:11,2012-11-26 18:40:24
ffb4c173a426647dbbb7bc7d2787140556de5e5b...0c9bee49fb27d4b7f6148ecbfa85c826bda9a8ab,1,4,0,4,2,2012-11-27 06:14:21,2012-11-27 05:03:36
0c9bee49fb27d4b7f6148ecbfa85c826bda9a8ab...8fc578b631d032778d49c65f9de48c946d01f902,3,0,2,2,1,2012-11-27 06:18:00,2012-11-24 04:49:42
8fc578b631d032778d49c65f9de48c946d01f902...3149d2f7dce4c90f28c82cdde5f011cffebd7ad6,1,95,0,95,1,2012-12-01 02:26:18,2012-11-12 19:01:03
3149d2f7dce4c90f28c82cdde5f011cffebd7ad6...4de274cbee902cc17608ca9507ffd45fab2b706e,1,2,6,8,4,2012-12-01 19:17:51,2012-12-01 02:21:01
4de274cbee902cc17608ca9507ffd45fab2b706e...f8999da51433b70015b1732682dc7f039b486fbd,1,9,4,13,2,2012-12-03 01:21:32,2012-12-03 01:19:15
f8999da51433b70015b1732682dc7f039b486fbd...9d02bfbc252ec24c3f8b26f6eaac2f28d8df3a6f,1,4,0,4,1,2012-12-03 02:08:19,2012-12-03 02:08:17
9d02bfbc252ec24c3f8b26f6eaac2f28d8df3a6f...51d5655efa6ab61063db2e37e2571a22621a9b7c,1,9,0,9,1,2012-12-03 16:30:41,2012-12-01 18:26:40
51d5655efa6ab61063db2e37e2571a22621a9b7c...03b00dcca912ae2dba515fb05221f2245e829479,1,3,4,7,2,2012-12-03 21:35:01,2012-12-03 21:34:27
03b00dcca912ae2dba515fb05221f2245e829479...a80434736bce22a9ac00376bb5786806752ef3dd,2,57,29,86,13,2012-12-04 07:05:55,2012-12-04 02:17:52
a80434736bce22a9ac00376bb5786806752ef3dd...1f76a2eddc3561ff2c434d491e0d2b893c374cfd,3,100,4,104,5,2012-12-04 07:12:12,2012-12-04 02:35:54
1f76a2eddc3561ff2c434d491e0d2b893c374cfd...1c8a5269c5aa4764832ff660aee0fadef30bbeeb,1,27,6,33,5,2012-12-05 03:31:22,2012-11-28 08:18:06
1c8a5269c5aa4764832ff660aee0fadef30bbeeb...c81dec70e64df2ceb5758d7aef4f28f4c1fa79e2,2,0,96,96,2,2012-12-05 04:46:20,2012-12-05 04:43:29
c81dec70e64df2ceb5758d7aef4f28f4c1fa79e2...c08e947fbdc80d670ed4547b253b95d7af8bd465,1,0,5,5,2,2012-12-06 03:45:11,2012-12-06 03:45:11
c08e947fbdc80d670ed4547b253b95d7af8bd465...3ece130ea21cdf18844e0ca99b4b73e3b3391286,3,314,58,372,18,2012-12-06 16:14:58,2012-12-04 05:36:23
3ece130ea21cdf18844e0ca99b4b73e3b3391286...5b65638124233e914f523af4c09f391d1ad969c1,6,231,1,232,7,2012-12-06 16:39:24,2012-12-03 17:29:01
5b65638124233e914f523af4c09f391d1ad969c1...33fa7405778444ca66470ab0729e6fa9fe43d2a6,2,158,14,172,43,2012-12-08 00:52:46,2012-12-08 00:50:12
33fa7405778444ca66470ab0729e6fa9fe43d2a6...0e95ea42ceec77370c97c87d7b027e70c9e10fa0,1,1,1,2,1,2012-12-08 00:58:16,2012-12-08 00:58:16
0e95ea42ceec77370c97c87d7b027e70c9e10fa0...3c293ba27250f1885efa8d8db8e75d3ea033c206,2,69,0,69,2,2012-12-08 01:13:51,2012-11-19 19:42:35
3c293ba27250f1885efa8d8db8e75d3ea033c206...0397223ab4a050f4acffeee6952660710327f2a0,1,2,2,4,2,2012-12-10 07:59:14,2012-12-10 04:34:33
0397223ab4a050f4acffeee6952660710327f2a0...1c7acd2c843d9f19a0b8ecee48ec48fa617eac5e,1,1,2,3,1,2012-12-10 12:04:46,2012-12-10 09:07:23
1c7acd2c843d9f19a0b8ecee48ec48fa617eac5e...eb502205d5a378f5300ace404f43d3da27d473ad,2,30,1,31,2,2012-12-10 12:07:35,2012-12-10 09:16:13
eb502205d5a378f5300ace404f43d3da27d473ad...0506d294dc5a51556e935a50a754aa7cbd7a7977,1,2,2,4,1,2012-12-10 12:08:26,2012-12-10 09:32:56
0506d294dc5a51556e935a50a754aa7cbd7a7977...6cf68aead6886d397772ea176a9f5c35fdb63071,34,1340,251,1591,191,2012-12-13 19:23:01,2012-12-13 19:23:01
d5e9895ce0fb708e35216753999b951bae571f39...83d39c8d535559bb7287c2a670ba256c5e9cb627,556,525,42780,43305,618,2012-09-25 15:29:05,2012-09-25 15:28:55
83d39c8d535559bb7287c2a670ba256c5e9cb627...7651228ab2149c252eaa3ed7ad3e050deb005d16,1,48,17,65,9,2012-09-25 15:37:08,2012-07-05 19:50:21
7651228ab2149c252eaa3ed7ad3e050deb005d16...3568edf71152ec164318374c0920adcd9e384b27,1,1679,0,1679,1,2012-09-25 15:51:02,2012-09-08 00:08:22
3568edf71152ec164318374c0920adcd9e384b27...09ac9d0b2c1ee99c9d023ee3aa5a42109aecf09e,1,1,1,2,1,2012-09-25 15:51:03,2012-09-12 23:03:50
09ac9d0b2c1ee99c9d023ee3aa5a42109aecf09e...d2fb507556498b9450b6397ac17e821edcab9a68,5,1,18,19,5,2012-09-25 15:51:03,2012-09-12 23:11:06
d2fb507556498b9450b6397ac17e821edcab9a68...66638a4435b5ccd46277019fea58794f04c82deb,2,4,4,8,2,2012-09-25 15:51:03,2012-09-21 16:07:08
66638a4435b5ccd46277019fea58794f04c82deb...202ecbc9c7f1af48add82688d1e357a2606bb063,1,178,0,178,1,2012-09-25 15:51:04,2012-09-10 16:35:58
202ecbc9c7f1af48add82688d1e357a2606bb063...62c3879cfac81df48e63353d084080d928dda10f,1,4,0,4,1,2012-09-25 15:51:04,2012-09-21 16:03:28
62c3879cfac81df48e63353d084080d928dda10f...823e807b5ba627b183623240148f9c8c0703506e,78,91015,0,91015,78,2012-09-25 15:51:04,2012-09-08 00:43:18
823e807b5ba627b183623240148f9c8c0703506e...e0e9f0c15ac9fba896dd135ced1afa2601687dfe,4,199,27,226,16,2012-09-25 15:51:05,2012-09-12 23:50:38
e0e9f0c15ac9fba896dd135ced1afa2601687dfe...2a9a5e2318821ed24c4c3b44d1949e0cb3ef53f9,1,0,2,2,1,2012-09-25 18:08:52,2012-09-25 18:08:44
2a9a5e2318821ed24c4c3b44d1949e0cb3ef53f9...411d46087f4027db69a5906985109a2b16f9ff52,1,1,1,2,1,2012-09-25 18:09:39,2012-09-25 18:09:34
411d46087f4027db69a5906985109a2b16f9ff52...ea2ceb731ca7dc6f2a11e501894adabf1cb4d20a,1,10,3,13,1,2012-09-25 18:15:52,2012-09-25 18:15:44
ea2ceb731ca7dc6f2a11e501894adabf1cb4d20a...d05d6a35b69ddbe4d8632a332c4f77b7fba78c37,1,14,8,22,8,2012-09-25 20:48:14,2012-09-25 19:25:55
d05d6a35b69ddbe4d8632a332c4f77b7fba78c37...0bc273da4fcaa79b209ed755ad249a3e7be626a6,3,51,2,53,3,2012-09-25 20:48:15,2012-09-25 15:09:30
77ed12fe7a16d3d97d637512db109f4273711bec...314c6b306038526209d284cf9fdbe978d2a634ec,1,7,0,7,2,2012-12-14 01:00:22,2012-10-05 00:43:15
314c6b306038526209d284cf9fdbe978d2a634ec...372cb32dc4975983184e7c83d69dbbb5302e6d8b,1,1,1,2,2,2012-12-14 01:00:23,2012-10-02 23:10:58
372cb32dc4975983184e7c83d69dbbb5302e6d8b...17834ed28cb9f376f9505a15273cff4317045feb,1,2,2,4,1,2012-12-14 01:00:23,2012-10-02 23:11:36
17834ed28cb9f376f9505a15273cff4317045feb...420e07c5777bdb2e493147d296abfc102f725015,7,829,4,833,10,2012-12-14 01:00:23,2012-10-02 22:44:50
420e07c5777bdb2e493147d296abfc102f725015...639fbe28d11fa9d75aa1531930b1e73d7b3a1e77,1,1,1,2,1,2012-12-14 01:00:23,2012-10-02 23:28:02
639fbe28d11fa9d75aa1531930b1e73d7b3a1e77...51a52c43a2887b354af55a891e478a6b4b194a79,1,3,2,5,3,2012-12-14 01:00:24,2012-10-04 00:43:27
51a52c43a2887b354af55a891e478a6b4b194a79...9b5abe5bfe31988da1180e5a47f38b8fed03f99e,1,71,16,87,23,2012-12-14 01:00:24,2012-10-03 23:52:14
9b5abe5bfe31988da1180e5a47f38b8fed03f99e...3b59fd70f4ef26742cc66a28105d2be75590e4d2,2,104,17,121,14,2012-12-14 01:00:24,2012-10-04 20:26:16
3b59fd70f4ef26742cc66a28105d2be75590e4d2...caa853bb06c9ef1ba4203a42ad9e1072c3988a38,1,15,1,16,4,2012-12-14 01:00:25,2012-10-04 23:58:43
caa853bb06c9ef1ba4203a42ad9e1072c3988a38...02f017d24f8cd93939bb4bd178b878d15cc5a08c,2,11,7,18,7,2012-12-14 01:00:25,2012-10-05 14:43:34
02f017d24f8cd93939bb4bd178b878d15cc5a08c...06e321d0f9692af1b6c6909cdfc49fd1b197129c,1,4,4,8,2,2012-12-14 01:00:25,2012-10-05 14:45:03
06e321d0f9692af1b6c6909cdfc49fd1b197129c...8acb416ad0532d249a0342f39103dd09fbbeeb2e,3,96,48,144,24,2012-12-14 01:00:26,2012-10-07 20:12:21
8acb416ad0532d249a0342f39103dd09fbbeeb2e...9b1b85490b6b242aabf84054a0a59ea1cf1c8dbc,6,1247,0,1247,6,2012-12-14 01:00:26,2012-10-07 20:26:03
9b1b85490b6b242aabf84054a0a59ea1cf1c8dbc...545f5126190acacd14ce54799d1e3c5d6dcd9edb,5,18,0,18,6,2012-12-14 01:00:26,2012-10-08 21:43:17
545f5126190acacd14ce54799d1e3c5d6dcd9edb...0678480b572b3d4d2a7a25060d5acd66fdd65199,1,20,8,28,7,2012-12-14 01:00:27,2012-10-09 18:01:53
0678480b572b3d4d2a7a25060d5acd66fdd65199...71e2b61388e09dad116cea4f6b3a3790d0d95654,1,36,5,41,9,2012-12-14 01:00:27,2012-10-10 00:31:29
71e2b61388e09dad116cea4f6b3a3790d0d95654...f3e71eb41707a375aa10970d5c1eda39d78dcb71,1,98,0,98,1,2012-12-14 01:00:27,2012-10-10 00:37:40
f3e71eb41707a375aa10970d5c1eda39d78dcb71...e82d06bef9c2de480f8c21ea195c876811b275e1,1,1,2,3,2,2012-12-14 01:00:28,2012-10-10 00:42:47
e82d06bef9c2de480f8c21ea195c876811b275e1...acfb0ef908a595d133a47b6c0f73236a0596a487,1,1,0,1,1,2012-12-14 01:00:28,2012-10-10 04:56:02
acfb0ef908a595d133a47b6c0f73236a0596a487...cf0b4ba4105bb3f0377f5f5e5d1d60d929a143fb,1,2,2,4,1,2012-12-14 01:00:28,2012-10-12 17:03:03
cf0b4ba4105bb3f0377f5f5e5d1d60d929a143fb...f624ccb475aa0d0f39f7fdf9d40a08fd3b98242b,1,23,1,24,3,2012-12-14 01:00:29,2012-10-12 18:45:17
f624ccb475aa0d0f39f7fdf9d40a08fd3b98242b...286aa04910f355699be2a99f89570fd6344e8d39,1,61,53,114,5,2012-12-14 01:00:29,2012-10-31 21:30:30
286aa04910f355699be2a99f89570fd6344e8d39...58568232234da60931817ccc98da2bf14d121177,1,3,24,27,4,2012-12-14 01:00:29,2012-11-13 07:28:56
58568232234da60931817ccc98da2bf14d121177...63ac07b32b0a6de8ea6e51d6ae52ea3b35f18935,2,3,1,4,2,2012-12-14 01:00:30,2012-11-13 07:30:10
63ac07b32b0a6de8ea6e51d6ae52ea3b35f18935...f20fd22abd5e1147d7bb89ff9783169532644671,2,33,5,38,6,2012-12-14 01:00:30,2012-11-13 07:31:25
f20fd22abd5e1147d7bb89ff9783169532644671...62dd04027b67f02856713e080651bb24b38206f8,1,1,1,2,1,2012-12-14 01:00:31,2012-11-13 07:31:40
62dd04027b67f02856713e080651bb24b38206f8...286c54439a6cf200271e6bd7fe3c21d6b20501ed,1,15,4,19,4,2012-12-14 01:00:31,2012-11-13 07:32:05
286c54439a6cf200271e6bd7fe3c21d6b20501ed...0118584433cb13717a509bbd67b22729dd4e8c98,1,130,69,199,24,2012-12-14 01:00:31,2012-11-13 07:33:06
0118584433cb13717a509bbd67b22729dd4e8c98...c2f62d496a08e9d44bea4a459c2eab7457d724ee,1,14,9,23,9,2012-12-14 01:00:32,2012-11-13 07:41:17
c2f62d496a08e9d44bea4a459c2eab7457d724ee...2ff499c022942e22fffc74709a2a99990bbec8ba,2,86,22,108,13,2012-12-14 01:00:32,2012-11-17 03:27:41
2ff499c022942e22fffc74709a2a99990bbec8ba...b15e19a2324c3dc11192ad3d4b66e88d37b136f2,3,72,51,123,41,2012-12-14 01:00:32,2012-11-17 04:24:14
b15e19a2324c3dc11192ad3d4b66e88d37b136f2...38e2b0053a0894b28c588a7e8b99f3842952574a,1,29,10,39,13,2012-12-14 01:00:33,2012-11-28 02:20:16
38e2b0053a0894b28c588a7e8b99f3842952574a...4b4ff2dff16ad4f5e7aa6e82673962d219057a70,1,29,10,39,6,2012-12-14 01:00:33,2012-11-28 09:25:39
4b4ff2dff16ad4f5e7aa6e82673962d219057a70...53fa66d9f79b4ba593f071334d58fda766fa5be3,1,4,0,4,1,2012-12-14 01:00:33,2012-11-28 02:21:05
53fa66d9f79b4ba593f071334d58fda766fa5be3...ac5a185edf16efb7738c00f4d35f00bc2f93bf04,1,26,19,45,7,2012-12-14 01:00:33,2012-11-28 18:46:24
ac5a185edf16efb7738c00f4d35f00bc2f93bf04...49ea653363da50c76a099839b4af555cec1d06c8,2,113,0,113,2,2012-12-14 01:00:34,2012-11-29 04:45:16
49ea653363da50c76a099839b4af555cec1d06c8...d58f2654bce637dea9a27ee1dd9dbec1ad7614cf,1,12,1,13,2,2012-12-14 01:00:34,2012-11-29 06:09:28
d58f2654bce637dea9a27ee1dd9dbec1ad7614cf...44b308b1f7beaa3398d869f1626f01ae6526bc0b,4,189,313,502,77,2012-12-14 18:52:26,2012-10-05 00:44:48
44b308b1f7beaa3398d869f1626f01ae6526bc0b...0e01d6398f14074675393a65cf430ea0a7a81ab8,4,104,167,271,36,2012-12-14 18:52:26,2012-10-02 23:15:39
0e01d6398f14074675393a65cf430ea0a7a81ab8...79fd9620f5eeb4c8165a6c354d93c62b56715696,1,2,1,3,2,2012-12-14 18:52:26,2012-10-02 23:54:49
79fd9620f5eeb4c8165a6c354d93c62b56715696...70461c39be754b3597e0c14da15d251caf4907f6,1,1,1,2,1,2012-12-14 18:52:26,2012-10-05 15:07:12
70461c39be754b3597e0c14da15d251caf4907f6...3d3a0b30466b19a7879ff6f92512861404ca6c74,1,2,1,3,1,2012-12-14 18:52:26,2012-10-05 15:26:49
3d3a0b30466b19a7879ff6f92512861404ca6c74...90de2ddb7739a0f1842066dffffcfbc83d2b3a88,2,32,1,33,6,2012-12-14 18:52:26,2012-10-29 18:31:59
90de2ddb7739a0f1842066dffffcfbc83d2b3a88...175f78c6ba716c7fb7326da4d3532b4c0c0a9605,2,10,1,11,7,2012-12-14 18:52:27,2012-10-29 22:21:25
175f78c6ba716c7fb7326da4d3532b4c0c0a9605...e336134658fe67265e4e0497e7972c088c5bb43a,1,32,4,36,15,2012-12-14 18:52:27,2012-10-29 23:36:20
e336134658fe67265e4e0497e7972c088c5bb43a...dd3ebb8cf643e88208adc5ec5bd2525f5288ddbb,1,15,5,20,10,2012-12-14 18:52:27,2012-10-30 17:18:55
dd3ebb8cf643e88208adc5ec5bd2525f5288ddbb...e0c600e00e846d252aeb75f5c0d2a5e2ccad120d,1,54,2,56,7,2012-12-14 18:52:27,2012-10-30 18:19:53
e0c600e00e846d252aeb75f5c0d2a5e2ccad120d...4a32d53155558ffb3d93f66f5cd8a11fc44b92d8,1,42,9,51,13,2012-12-14 18:52:27,2012-10-30 22:46:43
4a32d53155558ffb3d93f66f5cd8a11fc44b92d8...83704f127982cc958d0a9f702c103eb8c960f2aa,1,1,0,1,1,2012-12-14 18:52:27,2012-12-05 19:27:46
83704f127982cc958d0a9f702c103eb8c960f2aa...42981e2aadfdf1a16218dced31e55d9f62020c4d,2,6,4,10,2,2012-12-14 18:52:28,2012-12-05 01:20:12
42981e2aadfdf1a16218dced31e55d9f62020c4d...99021b7a4f7de955074095abfb03e5cbc5416e7b,2,7,7,14,8,2012-12-14 18:52:28,2012-12-05 01:34:17
99021b7a4f7de955074095abfb03e5cbc5416e7b...dbcacc5afe4c1fea4a0796d95090ea6aff7e67ed,1,4,1,5,2,2012-12-14 18:52:28,2012-12-05 02:19:07
dbcacc5afe4c1fea4a0796d95090ea6aff7e67ed...f8bb031bdc7067f3b69de771edd2c46df6386ad9,1,9,3,12,2,2012-12-14 18:52:28,2012-12-06 15:29:42
f8bb031bdc7067f3b69de771edd2c46df6386ad9...fc7d8d59f75b57545cd4951ef178d25ef6af9d64,1,2,2,4,2,2012-12-14 18:52:28,2012-12-06 18:21:22
fc7d8d59f75b57545cd4951ef178d25ef6af9d64...8f428f3b0deaaf74987076aafa47f36768a05d99,2,4,1,5,3,2012-12-14 18:52:28,2012-12-10 23:58:23
8f428f3b0deaaf74987076aafa47f36768a05d99...5760244cc622b986de0287a7f08bd88d9c0c21e4,1,3,2,5,2,2012-12-14 18:52:28,2012-12-12 08:59:54
5760244cc622b986de0287a7f08bd88d9c0c21e4...8fe7b0c910ed0e82b06316eb2eb78934b6459e59,1,11,6,17,5,2012-12-14 18:52:29,2012-12-13 06:03:19
8fe7b0c910ed0e82b06316eb2eb78934b6459e59...04541cf7bccb2be9fa4e587db8cfb21392d97c2d,1,4,0,4,4,2012-12-14 18:52:29,2012-12-13 06:17:57
04541cf7bccb2be9fa4e587db8cfb21392d97c2d...20a88feb8fe9a52382866166e897ddb5bfae199b,1,394,95,489,59,2012-12-14 18:52:29,2012-12-13 19:15:49
20a88feb8fe9a52382866166e897ddb5bfae199b...854171dc6f238be528e21e905c4764d9522b7033,1,0,3,3,1,2012-12-14 18:52:29,2012-12-13 19:15:29
854171dc6f238be528e21e905c4764d9522b7033...7742257febb511b97d8859cc03df9e09d8b7e0c3,1,1,1,2,1,2012-12-14 18:52:29,2012-12-09 23:12:19
7742257febb511b97d8859cc03df9e09d8b7e0c3...8a3befa0c65ba2ee653e3d3b39360e974536f3ef,1,252,218,470,76,2012-12-14 18:52:30,2012-12-13 05:18:57
8a3befa0c65ba2ee653e3d3b39360e974536f3ef...695abba5ac3365792c17ae3b83ba1272fb34ba5a,18,165,29,194,82,2012-12-14 18:52:30,2012-12-13 17:51:31
695abba5ac3365792c17ae3b83ba1272fb34ba5a...bb56dcc4505f1b8fe7fe5d9f975a96510787f2a7,2,43,29,72,11,2012-12-14 18:52:30,2012-12-13 06:06:35
bb56dcc4505f1b8fe7fe5d9f975a96510787f2a7...b4df1e62de102de5243ed6a5da2f2686fbde1b3c,3,28,11,39,12,2012-12-14 18:52:30,2012-12-13 06:07:05
b4df1e62de102de5243ed6a5da2f2686fbde1b3c...81e356279dcd37fda20d827fbab3550026e74c63,1,0,3,3,3,2012-12-14 18:52:30,2012-11-08 01:19:14
81e356279dcd37fda20d827fbab3550026e74c63...1d369317ea449424b98aec645f12b0d9e43876d6,1,64,70,134,31,2012-12-15 01:46:23,2012-12-13 06:24:17
1d369317ea449424b98aec645f12b0d9e43876d6...0977638ffb016c9e1ace5a9f6299d4bd4c27688c,5,15,3,18,8,2012-12-15 01:46:23,2012-12-13 17:52:08
0977638ffb016c9e1ace5a9f6299d4bd4c27688c...19ecc3a4a6ed8b7256da4425307e18dba547492d,21,43,17,60,36,2012-12-15 01:46:23,2012-12-13 15:47:33
19ecc3a4a6ed8b7256da4425307e18dba547492d...3751c0fe40ed22aaa281abda914ef9bf0c02edac,1,4,2,6,1,2012-12-15 01:46:23,2012-12-14 18:49:16
3751c0fe40ed22aaa281abda914ef9bf0c02edac...abbd47e4a3774a0448dcc5ab36d2e9275c9ac805,2,65,31,96,12,2012-12-15 01:46:23,2012-12-14 18:51:04
abbd47e4a3774a0448dcc5ab36d2e9275c9ac805...cd51fa8f5a97fcdf251aaccb954d324c13a3561b,2,18,14,32,8,2012-12-15 01:46:24,2012-12-15 01:43:02
02897bd8de6f8c3c9bd37974e61bd2a58393fc9e...37869f1c9a56f4ccbc7bd1bad65df85da50ff55c,1,2,2,4,1,2012-09-25 22:36:10,2012-09-25 22:36:10
37869f1c9a56f4ccbc7bd1bad65df85da50ff55c...8ca44f99285c8d557ac2db2e557f3194b6e79583,1,93,0,93,1,2012-09-25 22:37:53,2012-09-25 22:37:53
8ca44f99285c8d557ac2db2e557f3194b6e79583...ec03c47c192c9198a135acf51b114f43086b17c3,1,12,2,14,3,2012-09-25 23:20:56,2012-09-25 23:20:08
ec03c47c192c9198a135acf51b114f43086b17c3...b5db5fc9dc85ae0c6fa1ee9b51c634a161c07fdc,1,1,1,2,1,2012-09-25 23:57:24,2012-09-25 23:56:42
01db736c8d8e88a14278167197ee7f70f4c910c4...2433ec8276838e90136669d5b1215ba597f15fdd,4,114,5,119,9,2012-12-16 09:19:09,2012-11-18 00:14:44
2433ec8276838e90136669d5b1215ba597f15fdd...945f877d3044008fb16b6b4d3a5f88d931de3f97,2,3,0,3,3,2012-12-16 22:40:24,2012-12-16 22:39:59
945f877d3044008fb16b6b4d3a5f88d931de3f97...ddb15603e74e9aa865f3e1099dc2cc5886f9c46e,1,1,1,2,1,2012-12-17 10:29:03,2012-12-17 10:29:03
ddb15603e74e9aa865f3e1099dc2cc5886f9c46e...a3877ab53e7559e5055be9c8033e588a1db8b6aa,1,0,3,3,1,2012-12-17 15:20:44,2012-12-17 11:41:50
a3877ab53e7559e5055be9c8033e588a1db8b6aa...ba00fb01996f275412713fe78f4bb43239bcf714,2,24,22,46,6,2012-12-17 16:37:51,2012-12-07 20:59:48
ba00fb01996f275412713fe78f4bb43239bcf714...1c265c54a20a6f5c6d50ce671dc5df6901d11221,1,1,0,1,1,2012-12-17 16:37:51,2012-12-07 21:02:11
1c265c54a20a6f5c6d50ce671dc5df6901d11221...6c5356bfe26abcac24276681805744ea2d2d3af3,4,5,114,119,9,2012-12-17 18:47:17,2012-12-17 16:45:21
6c5356bfe26abcac24276681805744ea2d2d3af3...82c7c84e2550e79b816f87cd1dff3fe4cafb6bbb,3,144,5,149,6,2012-12-17 23:08:57,2012-12-16 20:47:01
82c7c84e2550e79b816f87cd1dff3fe4cafb6bbb...ba754524a9f6a729a337803aadd5f1b47af968b9,11,65,31,96,25,2012-12-18 10:15:02,2012-12-18 10:14:38
ba754524a9f6a729a337803aadd5f1b47af968b9...7b2ef2de208130f6cfe4775357eae0290a621653,1,1,1,2,1,2012-12-18 14:46:00,2012-12-18 14:45:33
7b2ef2de208130f6cfe4775357eae0290a621653...8ccfed2edceb9b4c216ce885d76fa03537e3eb5e,1,7,0,7,1,2012-12-18 15:07:31,2012-12-18 08:56:57
8ccfed2edceb9b4c216ce885d76fa03537e3eb5e...d607d856afc744b1e6bc42cdb9b67b6c4e7e4876,1,0,104,104,4,2012-12-18 15:16:33,2012-12-18 06:20:39
d607d856afc744b1e6bc42cdb9b67b6c4e7e4876...43538f4f8fc7c3395c53c8fff808d31d8faf79db,1,79,0,79,1,2012-12-18 19:56:53,2012-12-18 19:56:53
43538f4f8fc7c3395c53c8fff808d31d8faf79db...14ed1732cee8d1e721977eb2673b88995ef46608,1,27,1,28,3,2012-12-19 10:16:23,2012-12-19 04:10:17
14ed1732cee8d1e721977eb2673b88995ef46608...f3f4e290e0d7c38c6d3b8b60c104edd762949423,2,2,0,2,2,2012-12-19 18:55:23,2012-12-19 16:56:24
f3f4e290e0d7c38c6d3b8b60c104edd762949423...f63af64eb8da6424243ead150e0b2dd718bd95e9,2,22,23,45,5,2012-12-19 18:55:23,2012-12-19 16:57:05
f63af64eb8da6424243ead150e0b2dd718bd95e9...cab22644a5bbeba5091790f767d37783e79c4401,1,1,0,1,1,2012-12-19 18:55:23,2012-12-19 16:57:49
cab22644a5bbeba5091790f767d37783e79c4401...9f4c0988c37b9df60e45c26c25c91e45757d8f62,1,43,0,43,1,2012-12-19 18:55:23,2012-12-19 17:04:08
9f4c0988c37b9df60e45c26c25c91e45757d8f62...dcaebec2086a330b50f1494350021c3e0e64efa0,3,56,4,60,7,2012-12-20 10:25:39,2012-12-17 15:03:19
b5db5fc9dc85ae0c6fa1ee9b51c634a161c07fdc...e1f39468fa580c1e4cb15fac621f87944ee625dc,2,6,1,7,2,2012-09-27 16:39:23,2012-09-27 16:39:23
79ae8b7ae2fb67f39375f46e0ad7552aa9fb82ea...d1556fbdd298b58774f8560ac990cebb3e2875a6,1,23,4,27,6,2012-12-20 13:48:51,2012-12-20 13:02:38
d1556fbdd298b58774f8560ac990cebb3e2875a6...7eaea7f9e501db0072455fe5c05af261dc7e3204,11,359,1385,1744,23,2012-12-20 14:02:56,2012-09-25 01:57:11
7eaea7f9e501db0072455fe5c05af261dc7e3204...2e6180a62a450a89d6dda2df46ce3ed496414e43,1,1,1,2,1,2012-12-20 14:02:56,2012-09-12 23:03:50
2e6180a62a450a89d6dda2df46ce3ed496414e43...aeae22cbb25f018728177a14c10e20dfd511e461,1,1,1,2,1,2012-12-20 14:02:57,2012-09-12 23:11:06
aeae22cbb25f018728177a14c10e20dfd511e461...1d97db5acf0220d0dc2dd6cfb90227e09e7dd2a5,2,4,4,8,2,2012-12-20 14:02:57,2012-09-21 16:07:08
1d97db5acf0220d0dc2dd6cfb90227e09e7dd2a5...1b5c5b137d197629fa5673b7807cbe81dec2684f,1,24,0,24,12,2012-12-20 14:02:58,2012-12-19 16:13:46
1b5c5b137d197629fa5673b7807cbe81dec2684f...5edbb53c45bc087412d5192a8e3a5a89d88f9be5,68,47278,10803,58081,3966,2012-12-20 14:02:59,2012-12-19 16:08:16
5edbb53c45bc087412d5192a8e3a5a89d88f9be5...7475982801939e89528c90629cbbf76cb9fc604c,1,222,27,249,17,2012-12-20 14:02:59,2012-12-19 16:13:07
7475982801939e89528c90629cbbf76cb9fc604c...836593da23f753cb687ed0ee97410d635cf04c9f,1,22,12,34,8,2012-12-21 00:07:34,2012-12-18 22:44:32
836593da23f753cb687ed0ee97410d635cf04c9f...8624adf5d8b7e0429f7c127a2ede855680fe5c18,1,35,48,83,11,2012-12-21 00:07:34,2012-12-19 02:49:09
8624adf5d8b7e0429f7c127a2ede855680fe5c18...f9caf7020c65d543f29cb81692c53027da2c564f,2,12,25,37,11,2012-12-21 00:07:34,2012-12-19 02:49:42
f9caf7020c65d543f29cb81692c53027da2c564f...79ec9dc1dd09a3d05417b95f7c8bf5177e360153,1,7,5,12,5,2012-12-21 00:07:34,2012-12-19 02:50:07
79ec9dc1dd09a3d05417b95f7c8bf5177e360153...825af451fbd5216ee44ecdf5f9f68244743b2e6b,1,20,3,23,2,2012-12-21 00:07:34,2012-12-19 17:19:06
825af451fbd5216ee44ecdf5f9f68244743b2e6b...ec7455558f690fa5afb4e9f762a77ddaa51212f7,2,26,5,31,7,2012-12-21 00:07:35,2012-12-19 23:27:21
ec7455558f690fa5afb4e9f762a77ddaa51212f7...c048c814c79a8706f177573c76bfcba3cda0b633,1,3,3,6,3,2012-12-21 16:48:32,2012-12-21 16:48:32
c048c814c79a8706f177573c76bfcba3cda0b633...fb915ed9573d21c5b62c13b8eaa9642a6dbb4b02,2,9,8,17,2,2012-12-21 16:51:43,2012-12-21 16:51:43
fb915ed9573d21c5b62c13b8eaa9642a6dbb4b02...0edd93dcc1e0083511fc82fd5c44e96949200a4b,2,3,0,3,3,2012-12-21 16:59:20,2012-12-21 16:59:20
0edd93dcc1e0083511fc82fd5c44e96949200a4b...244924823ec0db092a39044408a1adb6e48cf3c3,4,116,18,134,13,2012-12-21 19:05:46,2012-12-21 02:08:40
244924823ec0db092a39044408a1adb6e48cf3c3...841b7f534b80b86d4f815ed3d66f7ac9c1944841,8,209,12,221,16,2012-12-21 19:05:55,2012-12-21 08:06:21
a9429052c2f86043fdeddf7f53ce7d631a085895...9877b8f41433e42e095f6e49d5e11ecfe6704fe5,1,2,2,4,1,2012-09-27 17:25:12,2012-09-27 17:25:12
9877b8f41433e42e095f6e49d5e11ecfe6704fe5...dcc01df968c0daf3f4e71af794604fbd4b7b436f,1,63,0,63,1,2012-09-27 17:25:37,2012-09-27 17:25:37
dcc01df968c0daf3f4e71af794604fbd4b7b436f...c08320c957f14fe93ab202f9325d43462d25033d,1,48,50,98,6,2012-09-27 20:25:55,2012-09-27 20:25:55
c08320c957f14fe93ab202f9325d43462d25033d...33a5c8a814483ff48ba3acd94e091335b3536870,2,5,0,5,3,2012-09-27 20:28:16,2012-09-24 08:18:05
841b7f534b80b86d4f815ed3d66f7ac9c1944841...837df70b7576089f808ab3acf626cb06e430f4f6,2,33,1,34,2,2012-12-21 19:42:40,2012-12-21 19:42:40
33a5c8a814483ff48ba3acd94e091335b3536870...d3e818cf8fd3e4c506e030cb6bc13bb7e30bd2be,1,13,0,13,1,2012-09-30 17:34:28,2012-09-30 17:34:28
d3e818cf8fd3e4c506e030cb6bc13bb7e30bd2be...fa912c246cdbce6d8698e1354d04b8620bc283fe,1,1,1,2,1,2012-09-30 22:47:27,2012-09-30 22:47:27
fa912c246cdbce6d8698e1354d04b8620bc283fe...f1722a280c0b0505ecb2cd92cd66195a6d53368a,2,5,0,5,2,2012-10-01 05:47:57,2012-10-01 05:43:35
f1722a280c0b0505ecb2cd92cd66195a6d53368a...3b7312d23af26d0c1bdcb977015bda7c4709f222,2,5,1,6,2,2012-10-01 18:36:06,2012-10-01 18:36:06
3b7312d23af26d0c1bdcb977015bda7c4709f222...b90c1502e5320f300e23724d774f634274c82daa,1,1,7,8,2,2012-10-01 21:30:02,2012-10-01 21:30:02
b90c1502e5320f300e23724d774f634274c82daa...f624be40938a9e72a747a7397a8e11d837760138,1,2,2,4,1,2012-10-02 22:49:27,2012-10-01 20:27:19
f624be40938a9e72a747a7397a8e11d837760138...b0d04ffbd877309b9ce56fe19957d78b47ad9cf4,1,4,0,4,1,2012-10-03 11:38:03,2012-10-03 11:38:03
b0d04ffbd877309b9ce56fe19957d78b47ad9cf4...bf0bc3565b21d857afc53a2d9c2fd773d973cdf5,1,4,3,7,3,2012-10-03 20:18:33,2012-10-03 19:02:14
bf0bc3565b21d857afc53a2d9c2fd773d973cdf5...fbb0ee6f24cb8679cb7b9de0cdbe9ad80f1363c7,2,46,32,78,6,2012-10-04 09:18:15,2012-10-02 14:57:38
fbb0ee6f24cb8679cb7b9de0cdbe9ad80f1363c7...f826b3269d62cd64439d68a145eeeb658973740c,1,13,0,13,1,2012-10-05 23:48:13,2012-10-05 23:48:13
f826b3269d62cd64439d68a145eeeb658973740c...59c166cfba380f108b45d4aab9ce61dcfdfff46a,1,18,12,30,2,2012-10-06 01:33:28,2012-10-06 01:33:28
59c166cfba380f108b45d4aab9ce61dcfdfff46a...8c5f269f908c759d934a1da42dd491bff67c1a37,1,1,1,2,1,2012-10-07 21:22:31,2012-10-07 08:04:26
8c5f269f908c759d934a1da42dd491bff67c1a37...be5a8e24c2fccf61133a7a6a3273a0d08e6b63f7,5,37,24,61,23,2012-10-08 20:58:11,2012-10-08 17:10:29
be5a8e24c2fccf61133a7a6a3273a0d08e6b63f7...eec8c2edafdb52a4c63dfab77a8d84293dc458d3,1,27,29,56,10,2012-10-08 22:46:51,2012-10-07 22:00:30
eec8c2edafdb52a4c63dfab77a8d84293dc458d3...87518f1e3c0c91418df260258ee99101b8cb86de,2,11,0,11,4,2012-10-10 15:18:48,2012-10-10 15:18:48
87518f1e3c0c91418df260258ee99101b8cb86de...6a128e037e5b9f0c5c84fc24d343db3364a56d64,1,61,1,62,6,2012-10-10 23:05:18,2012-10-10 22:44:49
6a128e037e5b9f0c5c84fc24d343db3364a56d64...99b2368a6cd408e75850ac73585de8800e2a10a1,1,33,1,34,2,2012-10-11 15:32:46,2012-10-11 15:32:36
99b2368a6cd408e75850ac73585de8800e2a10a1...218f08dbdeb2a5181cd562deb8783a64bb8e7e62,237,1250,333,1583,327,2012-10-11 21:11:38,2012-10-11 21:11:38
cdcac49cfee14b5a47401332a0b1d023393d0c16...70eb227e80f10cf51288a5a3018e858480099df4,1,2,2,4,1,2012-12-21 20:36:34,2012-12-21 20:36:34
70eb227e80f10cf51288a5a3018e858480099df4...f84bf5b6b174af0639813c9f3167f3593f2c5eb4,3,17,2,19,6,2012-12-21 20:44:33,2012-12-21 01:56:47
f84bf5b6b174af0639813c9f3167f3593f2c5eb4...6ecb0cd65d2f818a35adb80d23261555b63528ca,1,3,16,19,4,2012-12-24 15:02:13,2012-12-24 15:00:24
6ecb0cd65d2f818a35adb80d23261555b63528ca...526d852565e88349a1ba3aa66d30d0548e95f085,1,1,1,2,1,2012-12-25 21:18:56,2012-12-25 01:35:52
526d852565e88349a1ba3aa66d30d0548e95f085...d2e7ca0449299d29f66dd682e9c9118c535fd61e,1,26,0,26,1,2012-12-25 21:18:57,2012-12-25 21:05:06
d2e7ca0449299d29f66dd682e9c9118c535fd61e...27a91387ae79a3b7bc2b00a40a17c1b7846da55b,1,1,1,2,1,2012-12-26 22:54:56,2012-12-23 19:14:40
27a91387ae79a3b7bc2b00a40a17c1b7846da55b...5daa701aba47e321a572f2cd7bf706fc82ca34c6,2,87,9,96,10,2012-12-26 22:56:02,2012-12-22 15:14:42
5daa701aba47e321a572f2cd7bf706fc82ca34c6...d68ee22dda6aafa32520591f63ff3d248a3abc71,2,85,8,93,3,2012-12-26 22:56:02,2012-12-22 17:07:08
d68ee22dda6aafa32520591f63ff3d248a3abc71...ce30683012186f8573da7691c528ad6ab7e15407,1,5,0,5,1,2012-12-26 22:56:02,2012-12-22 17:27:08
ce30683012186f8573da7691c528ad6ab7e15407...8bf0c15a5b21755c4c66b54f5aad16e81a416c13,2,57,0,57,2,2012-12-26 23:20:48,2012-12-18 01:59:07
8bf0c15a5b21755c4c66b54f5aad16e81a416c13...31cffae2ba5246852a8826238b1f73f4a157d202,1,2,2,4,1,2012-12-26 23:23:31,2012-12-11 10:04:34
31cffae2ba5246852a8826238b1f73f4a157d202...0db521d0b0d2cd9dc6bc3b1a52ebab0d409030a2,1,1,1,2,1,2012-12-26 23:25:00,2012-12-11 10:14:49
0db521d0b0d2cd9dc6bc3b1a52ebab0d409030a2...d76eacd4e618d60714f2dd568d45bd6cd96019b6,1,3,1,4,1,2012-12-26 23:57:49,2012-12-26 23:57:49
d76eacd4e618d60714f2dd568d45bd6cd96019b6...4be9c695f0cc48e7f0fe51bf916770ecec16b3c7,2,5,2,7,2,2012-12-27 04:35:00,2012-12-27 04:35:00
4be9c695f0cc48e7f0fe51bf916770ecec16b3c7...8936868e9bf6b4a3f56684c4895e2a7c33395479,1,0,2,2,1,2012-12-27 23:09:04,2012-12-27 16:14:16
8936868e9bf6b4a3f56684c4895e2a7c33395479...697484df82eb227d81d8b91d29ffc90d5d5212ef,1,1,1,2,1,2012-12-28 01:45:36,2012-12-27 15:51:31
697484df82eb227d81d8b91d29ffc90d5d5212ef...fde338bf83bdc7c0524734bb03f374e90dcd1cf1,1,1,1,2,1,2012-12-28 01:46:34,2012-12-27 16:30:50
fde338bf83bdc7c0524734bb03f374e90dcd1cf1...e576208eba9c0b343b9c1510be0839282fa1aff5,2,53,4,57,5,2012-12-28 01:53:28,2012-12-27 14:57:19
e576208eba9c0b343b9c1510be0839282fa1aff5...192192a09e2d2e0d6bdd0934f602d2dbbf10ed06,3,58,10,68,16,2012-12-28 02:38:56,2012-12-28 01:32:53
192192a09e2d2e0d6bdd0934f602d2dbbf10ed06...a3297295371720e3781c2410ebfb2ae1698b880c,2,78,58,136,10,2012-12-28 12:20:07,2012-12-24 00:29:40
a3297295371720e3781c2410ebfb2ae1698b880c...c4fc0febfacf3a79ede812d44c012093b5f2e31c,1,17,18,35,3,2012-12-28 15:42:51,2012-12-28 03:40:06
c4fc0febfacf3a79ede812d44c012093b5f2e31c...910e24b53da11a38afe0e44d5d2e74a7c30a0710,3,0,87,87,5,2012-12-28 17:24:35,2012-12-28 17:23:08
910e24b53da11a38afe0e44d5d2e74a7c30a0710...c6e958d44d6674676581ced360530f85508121a2,1,1,1,2,1,2012-12-28 17:33:51,2012-12-28 17:31:47
c6e958d44d6674676581ced360530f85508121a2...4401bb47bfa4fe72c2755c428577903ece5cfaa0,5,129,102,231,31,2012-12-29 18:37:30,2012-12-26 20:28:33
4401bb47bfa4fe72c2755c428577903ece5cfaa0...ec8ebaf30090a9265cbad0535e8e0c9a02a49c9f,6,32,32,64,20,2012-12-29 18:37:31,2012-12-26 20:31:27
ec8ebaf30090a9265cbad0535e8e0c9a02a49c9f...1c2910d94c4f01d3dc929ed3fb3f0823dd6c256b,4,73,0,73,4,2012-12-29 18:37:31,2012-12-27 02:13:59
1c2910d94c4f01d3dc929ed3fb3f0823dd6c256b...ae1b0ca7a598438330854ccd83bae13db3e7d2b0,2,8,2,10,3,2012-12-29 19:19:14,2011-02-20 23:09:23
ae1b0ca7a598438330854ccd83bae13db3e7d2b0...9785ab605746593601752a278c93fdc784462115,1,6,6,12,6,2012-12-29 23:32:25,2012-12-27 17:13:58
9785ab605746593601752a278c93fdc784462115...aec2f733f97460ddde677b53bcc048b55878c7b3,1,26,35,61,7,2012-12-29 23:32:25,2012-12-27 19:39:57
aec2f733f97460ddde677b53bcc048b55878c7b3...ba94f9d6f8917377ce8a81c6c68666b692701803,2,55,50,105,5,2012-12-29 23:32:25,2012-12-27 19:40:42
ba94f9d6f8917377ce8a81c6c68666b692701803...f423287453e914c2668002fc4e6482821625a7ac,1,51,48,99,15,2012-12-29 23:32:25,2012-12-27 19:41:29
f423287453e914c2668002fc4e6482821625a7ac...e11668b244ee62d9997d4871f368075b8abf8d45,1,4,4,8,2,2012-12-29 23:32:25,2012-12-27 21:03:59
e11668b244ee62d9997d4871f368075b8abf8d45...ecdde7df15f534094b749c8febbf56972fd13795,1,1,0,1,1,2012-12-29 23:32:26,2012-12-28 05:12:43
ecdde7df15f534094b749c8febbf56972fd13795...7550e31d1ad68dac2fdecc93cc26fcc163de82dc,1,49,32,81,5,2012-12-29 23:32:26,2012-12-27 23:02:57
f119effc9f959dc1854dd8c95bf36009679429b1...982981442dc7b993b935f6db7c125415f4b433cc,1,4,4,8,4,2012-12-21 19:32:29,2012-12-21 19:32:18
982981442dc7b993b935f6db7c125415f4b433cc...d86d83c75f6343b5368bb7bd328b4466a035e1d4,3,58,2,60,3,2012-12-21 20:15:05,2012-12-21 19:27:11
218f08dbdeb2a5181cd562deb8783a64bb8e7e62...38c72d4e29574dec5205bcf23c2a85efe65331a4,3,25,2,27,3,2012-10-11 21:34:11,2012-10-11 21:22:13
7550e31d1ad68dac2fdecc93cc26fcc163de82dc...6c80ef01c1fb48a57a78ca64145e7312f8d052c4,4,51,1,52,4,2012-12-30 00:53:23,2012-12-30 00:49:18
6c80ef01c1fb48a57a78ca64145e7312f8d052c4...01994e8119c24f2284bac0779b32acb49c95bee7,3,36,2,38,3,2012-12-30 00:54:24,2012-12-30 00:31:43
d4116228144ea2932d242fd6dc2153841b75cac3...b3536ae0a8a9be0d996b61485a51c23782a22e6d,1,73,0,73,1,2012-10-12 15:57:12,2012-10-12 15:57:12
b3536ae0a8a9be0d996b61485a51c23782a22e6d...58db21e6c559a9bda979550f81dd3c485ea115e7,1,2,2,4,1,2012-10-12 15:57:25,2012-10-12 15:57:25
58db21e6c559a9bda979550f81dd3c485ea115e7...323bbdb0cb2518ff15ad361ad3495cc4739f3bdf,1,1,0,1,1,2012-10-12 22:54:21,2012-10-12 18:31:59
323bbdb0cb2518ff15ad361ad3495cc4739f3bdf...b1e78cef097c682ed63528ad7efe294b18a9fb1d,2,15,15,30,6,2012-10-12 23:37:17,2012-10-12 23:34:36
b1e78cef097c682ed63528ad7efe294b18a9fb1d...4a23add90f155e6761d443d1277a31c2a2a4abb2,1,12,5,17,3,2012-10-13 13:17:51,2012-10-12 13:27:47
9ff2b0b658630d55d6e71346193c44a69ed0782a...30bd774fbd379c86dd4e1bbaecd593b56112ddc3,1,2,2,4,2,2012-12-30 01:25:40,2012-12-30 01:25:40
30bd774fbd379c86dd4e1bbaecd593b56112ddc3...9e32c2ef3ede29ba0ae2086bdf658f6cd44182df,2,62,3,65,8,2012-12-31 16:53:00,2012-12-31 16:42:54
9e32c2ef3ede29ba0ae2086bdf658f6cd44182df...7b4d95a976f1b76e6dcefb6ca91dff738c80ab7a,494,50399,31833,82232,7186,2013-01-01 12:07:02,2013-01-01 08:28:07
7b4d95a976f1b76e6dcefb6ca91dff738c80ab7a...5e57bcc3cee41a666f05e5e4ffd1b76e18b66282,10,25,25,50,20,2013-01-02 08:13:46,2013-01-01 12:05:53
5e57bcc3cee41a666f05e5e4ffd1b76e18b66282...8a96bb42c6d100327f505b01f8ad5aba8c4b7c66,2,10,2,12,2,2013-01-02 08:13:47,2013-01-01 12:06:28
8a96bb42c6d100327f505b01f8ad5aba8c4b7c66...ce1b33a9dc8e31e74603d606da217743b7491aa8,1,0,9,9,1,2013-01-03 01:37:22,2013-01-03 01:33:40
ce1b33a9dc8e31e74603d606da217743b7491aa8...875c1106c672efe932a84f45ddee5e7299f23e55,2,0,272,272,2,2013-01-03 18:58:38,2013-01-03 16:58:58
875c1106c672efe932a84f45ddee5e7299f23e55...aad2013508eae5ee29a410c6fe44d27d6470ad24,2,4,9,13,3,2013-01-03 18:58:47,2013-01-03 17:21:52
4a23add90f155e6761d443d1277a31c2a2a4abb2...a7b5938715acb57b1a168fe8f1f60b9549ddcea5,1,1,1,2,1,2012-10-14 12:47:02,2012-10-14 12:44:06
a7b5938715acb57b1a168fe8f1f60b9549ddcea5...28b0cc08b8c9a461c1560da52c3bc30c4e7a996b,3,0,100,100,5,2012-10-15 21:40:15,2012-10-15 21:40:15
28b0cc08b8c9a461c1560da52c3bc30c4e7a996b...1205734e69df2cecce88d67aa9e6b32a843d1633,1,18,8,26,3,2012-10-15 21:55:26,2012-09-19 12:37:08
1205734e69df2cecce88d67aa9e6b32a843d1633...cca15e8e33e94258d8b881786c27d461d5488982,1,2,0,2,1,2012-10-15 21:59:57,2012-10-15 21:51:43
cca15e8e33e94258d8b881786c27d461d5488982...627f0d27e827295cf8e7442b89d4fc5708ef5d8d,1,1,1,2,1,2012-10-16 17:59:23,2012-10-16 17:59:23
a7d8c21bca112a83a711b89e432a2486f0049557...5a39df49593a862d0de9ef01db2f83e23b2fd67f,1,7,0,7,1,2013-01-03 22:31:26,2013-01-03 02:06:41
5a39df49593a862d0de9ef01db2f83e23b2fd67f...a6167742811a69d98a716de8f0defa5e50af17d9,9,26,24,50,10,2013-01-03 22:38:25,2013-01-03 22:36:04
a6167742811a69d98a716de8f0defa5e50af17d9...0459a230631f6ff44f63d46396c474c13e6c232c,2,4,1,5,2,2013-01-04 01:11:54,2013-01-03 14:27:55
0459a230631f6ff44f63d46396c474c13e6c232c...0054264d884394b06cedf4885d3a0e7c90c34c64,19,355,44,399,32,2013-01-04 11:44:47,2013-01-04 11:44:47
0054264d884394b06cedf4885d3a0e7c90c34c64...97056c064fd45e17471c682d1cbcdd925dc0c84e,1,2,0,2,1,2013-01-04 12:39:24,2013-01-04 12:37:38
97056c064fd45e17471c682d1cbcdd925dc0c84e...93591a2a8832dddc3c7627e502799d42d462235f,1,0,9,9,1,2013-01-04 16:06:03,2013-01-03 01:33:40
93591a2a8832dddc3c7627e502799d42d462235f...829f96badad44943ebb8540866d8695e17eb6d05,1,3,4,7,3,2013-01-04 18:00:16,2013-01-04 16:05:27
829f96badad44943ebb8540866d8695e17eb6d05...2b6c561040cb6528e1f23b88cd36be47448e1ccf,1,0,1,1,1,2013-01-04 18:02:05,2013-01-04 16:46:59
2b6c561040cb6528e1f23b88cd36be47448e1ccf...5664dd2fc1e872a850c2891ee11f86e98b69106d,5,11,11,22,11,2013-01-04 23:16:23,2013-01-04 23:11:37
5664dd2fc1e872a850c2891ee11f86e98b69106d...3f76419a04da48b92b50b51450685b8565886200,3,82,0,82,3,2013-01-05 16:05:13,2013-01-01 02:01:42
3f76419a04da48b92b50b51450685b8565886200...70ad9bbcbda192842b1e52159c5ee9d4a77e6902,3,67,1,68,4,2013-01-06 21:55:30,2013-01-04 19:58:35
70ad9bbcbda192842b1e52159c5ee9d4a77e6902...4e1a2f9a89e96c36919c8cfffb7edd1936143c80,1,0,0,0,0,2013-01-07 02:40:12,2013-01-07 02:36:47
4e1a2f9a89e96c36919c8cfffb7edd1936143c80...fa3bfc3a66cc081b0aacacc2124a7666c73c6288,1,11,1,12,2,2013-01-07 02:59:10,2013-01-07 02:59:08
fa3bfc3a66cc081b0aacacc2124a7666c73c6288...879efb3338c7be1925c26c7e2debfbf29ffda899,1,2,2,4,2,2013-01-07 15:04:33,2013-01-07 15:00:10
879efb3338c7be1925c26c7e2debfbf29ffda899...8adebb92bcd51a856cd44d4918502e133f67d63b,1,3,3,6,2,2013-01-07 16:19:09,2012-12-21 15:12:45
8adebb92bcd51a856cd44d4918502e133f67d63b...a5d4e74891dd5cf4351704ba554637b584f1840a,1,0,1,1,1,2013-01-07 16:36:49,2013-01-04 04:53:55
a5d4e74891dd5cf4351704ba554637b584f1840a...3e6f737eaf7042d5ffc1f0d560a94ac669975898,1,27,30,57,3,2013-01-07 16:36:49,2013-01-07 14:10:35
3e6f737eaf7042d5ffc1f0d560a94ac669975898...df3563aa65da6a45f7e9e9e02444b0ae2c862264,2,30,0,30,3,2013-01-07 16:36:49,2013-01-07 14:29:00
df3563aa65da6a45f7e9e9e02444b0ae2c862264...5d0816bf3e5f29a470356eebc81f703047c0dd73,2,9,7,16,3,2013-01-07 16:39:57,2013-01-06 22:06:48
5d0816bf3e5f29a470356eebc81f703047c0dd73...412b3cee0531ffdbfb9c2b38583513e3d0794bb9,4,4,4,8,4,2013-01-07 16:39:57,2013-01-06 22:09:39
412b3cee0531ffdbfb9c2b38583513e3d0794bb9...6573fc35022b783d1f93b79dbf127cf2b6c8fc23,20,183,159,342,144,2013-01-07 16:39:57,2013-01-06 22:33:09
6573fc35022b783d1f93b79dbf127cf2b6c8fc23...01c3d0aa888e3a2bf709da760588df191479b922,12,37,34,71,23,2013-01-07 16:39:57,2013-01-06 22:52:35
01c3d0aa888e3a2bf709da760588df191479b922...109f73b2c08a042bc2d788ba9df9469846dbc533,7,75,59,134,54,2013-01-07 16:39:57,2013-01-06 23:09:31
109f73b2c08a042bc2d788ba9df9469846dbc533...c7d7ae1fe2b41564a9cb1da8d40329664f5efdde,10,28,28,56,28,2013-01-07 16:39:57,2013-01-06 22:55:56
c7d7ae1fe2b41564a9cb1da8d40329664f5efdde...7788a6bf85d9dd98eed3ad2cfaf1823fd6f8ae90,15,103,95,198,95,2013-01-07 16:39:58,2013-01-06 23:15:59
7788a6bf85d9dd98eed3ad2cfaf1823fd6f8ae90...3b715edda97c8edfd95cc1fb8d31f92cef6bcc52,1,1,1,2,1,2013-01-07 18:30:15,2013-01-07 18:30:15
3b715edda97c8edfd95cc1fb8d31f92cef6bcc52...13296e4b13b5ed192c4faa6501f3efec2ded8ac1,1,394,394,788,53,2013-01-07 19:01:54,2013-01-07 18:53:50
13296e4b13b5ed192c4faa6501f3efec2ded8ac1...f9afb3f01002e5667a0df80ee784af0dfe2305c2,4,173,219,392,56,2013-01-07 19:04:11,2012-12-27 03:16:23
f9afb3f01002e5667a0df80ee784af0dfe2305c2...38df9d51a229e1d74b2d1c2835353f07c784cfc3,1,298,296,594,61,2013-01-07 20:23:41,2013-01-07 20:20:21
38df9d51a229e1d74b2d1c2835353f07c784cfc3...321b8eec08d445d60a4149bfa71959936fc189c6,1,46,46,92,5,2013-01-07 20:31:44,2013-01-07 20:31:44
321b8eec08d445d60a4149bfa71959936fc189c6...aeb030bead432a2de8fe8075afca2d070bb5540d,1,16,2,18,2,2013-01-08 02:41:26,2013-01-07 05:29:38
aeb030bead432a2de8fe8075afca2d070bb5540d...9b363b022f2de766e05f106c2c92eaf4f46fbcf8,2,52,1,53,2,2013-01-08 03:59:50,2013-01-07 01:37:35
9b363b022f2de766e05f106c2c92eaf4f46fbcf8...b50d51ef5b5ebdf250eefc387ed25c7aaae557f4,1,25,18,43,3,2013-01-08 04:08:00,2012-12-18 19:03:41
b50d51ef5b5ebdf250eefc387ed25c7aaae557f4...3f7545442687c8c0968e788e4bd5f4ccd664e247,2,0,3,3,2,2013-01-08 04:08:00,2012-12-23 22:43:51
3f7545442687c8c0968e788e4bd5f4ccd664e247...e6acfed9cc79cdad57bb27bff14627705676b434,1,3,1,4,1,2013-01-08 04:38:36,2012-12-31 18:44:51
e6acfed9cc79cdad57bb27bff14627705676b434...45941811dce8988a4cc296436a8843d511ae35af,2,53,1,54,3,2013-01-08 18:13:09,2013-01-08 17:56:55
45941811dce8988a4cc296436a8843d511ae35af...18c985919d93df97561157ab8e7de70f4e22dd44,1,1,1,2,1,2013-01-08 22:27:01,2013-01-08 22:27:01
18c985919d93df97561157ab8e7de70f4e22dd44...1211946a8c8b6ecad04e23d5c71783e9721a9ffe,1,2,2,4,2,2013-01-09 07:13:02,2013-01-09 02:17:06
1211946a8c8b6ecad04e23d5c71783e9721a9ffe...7d66a9d06048601121220084f7f6d5672866d2ec,1,29,37,66,29,2013-01-09 16:43:19,2013-01-08 16:08:58
7d66a9d06048601121220084f7f6d5672866d2ec...46a489be73fd87fa3e17dd929c53d9e90860f80a,2,188,20,208,9,2013-01-09 16:44:25,2013-01-05 21:06:35
46a489be73fd87fa3e17dd929c53d9e90860f80a...c207d400f118032a419f978e766acd99af980132,2,62,34,96,16,2013-01-09 16:44:25,2013-01-06 17:59:12
c207d400f118032a419f978e766acd99af980132...a6756a2c064c21b41fc0ab0379bd4e055feb8bc0,1,1,0,1,1,2013-01-10 00:58:30,2013-01-10 00:58:30
a6756a2c064c21b41fc0ab0379bd4e055feb8bc0...a993f740f04e1e5c935de734eaea9b520261310b,3,194,0,194,3,2013-01-10 21:49:53,2013-01-08 02:07:17
a993f740f04e1e5c935de734eaea9b520261310b...530585b2d10eea72e71007cb5d8ab18149653c99,1,9,45,54,5,2013-01-10 21:49:53,2013-01-08 03:40:08
530585b2d10eea72e71007cb5d8ab18149653c99...b43e544140ccf68580c02e71c56d19b82e1e1d32,2,19,51,70,16,2013-01-10 21:49:54,2013-01-10 21:49:19
b43e544140ccf68580c02e71c56d19b82e1e1d32...840401c024a31e35515e76155693131f6de0ea86,1,4,3,7,4,2013-01-10 21:50:05,2013-01-08 02:07:37
840401c024a31e35515e76155693131f6de0ea86...bc8feb151c731f5862a02fccb58638105b44d45b,1,9,13,22,9,2013-01-10 21:50:06,2013-01-08 04:23:07
bc8feb151c731f5862a02fccb58638105b44d45b...9ece63b1d74ec1359df7b3ef4d6ed534ac49c0cf,1,14,4,18,5,2013-01-10 21:50:06,2013-01-08 04:33:56
9ece63b1d74ec1359df7b3ef4d6ed534ac49c0cf...438e0c6d75eb0968202e2ccfcf0417cb56ba55c9,1,1,1,2,1,2013-01-11 01:02:59,2012-12-18 09:48:51
438e0c6d75eb0968202e2ccfcf0417cb56ba55c9...b916774255940c721df882b5b8ab63934891df99,1,11,5,16,4,2013-01-11 01:13:59,2013-01-11 01:13:59
b916774255940c721df882b5b8ab63934891df99...bb1c03989f8702e06072e6d9228b52661bf00ace,2,18,1,19,5,2013-01-11 01:58:37,2013-01-08 17:22:04
bb1c03989f8702e06072e6d9228b52661bf00ace...dc0c524ce681f53e2bd8f0974ed6aa3fd910054d,1,4,0,4,1,2013-01-11 02:16:43,2013-01-11 02:16:43
dc0c524ce681f53e2bd8f0974ed6aa3fd910054d...31fc52ab53b5dde882ebadbbc912c2848c7b6a83,65,948,592,1540,284,2013-01-11 13:00:19,2013-01-11 12:49:45
31fc52ab53b5dde882ebadbbc912c2848c7b6a83...7be27240b5b4f9a362c63b854e5e55890b858912,2,1,18,19,5,2013-01-11 15:19:21,2013-01-11 15:19:21
7be27240b5b4f9a362c63b854e5e55890b858912...35a137cf8dcec75fd4cc11bbd8eb22cc2c1d7ece,1,2,0,2,1,2013-01-11 15:52:49,2013-01-11 15:52:49
35a137cf8dcec75fd4cc11bbd8eb22cc2c1d7ece...d93346d0fcd176e5e8f489611eedee10a5a9dcb9,1,0,2,2,1,2013-01-11 17:01:14,2013-01-11 17:01:14
d93346d0fcd176e5e8f489611eedee10a5a9dcb9...3383d77c61f3292c4b39f9f85ce6218efd21f911,2,65,0,65,2,2013-01-11 17:14:09,2013-01-11 01:15:53
3383d77c61f3292c4b39f9f85ce6218efd21f911...b509ae67b794898ff5a2249cf86c7c298e2f3831,1,2,2,4,2,2013-01-11 17:35:03,2013-01-11 17:31:47
b509ae67b794898ff5a2249cf86c7c298e2f3831...6a91eab0970a87431743c79ecb8e3efaed1796d9,2,49,9,58,10,2013-01-11 17:50:09,2013-01-11 17:42:46
627f0d27e827295cf8e7442b89d4fc5708ef5d8d...82df345fbba15ba42eeb9955f3bc76609c86e677,1,4,0,4,1,2012-10-21 21:56:01,2012-10-21 21:55:52
82df345fbba15ba42eeb9955f3bc76609c86e677...de18e29784b5f10f695d0859b43c81f41d743e85,1,20,18,38,3,2012-10-21 22:20:32,2012-10-21 22:03:47
de18e29784b5f10f695d0859b43c81f41d743e85...844a0058d0c6815308a0e68192df6a1d6213c68e,1,8,2,10,3,2012-10-21 22:20:45,2012-10-21 22:18:14
844a0058d0c6815308a0e68192df6a1d6213c68e...9fa953d3e7a864cfce4a69f47cca27d21c124672,1,2,6,8,1,2012-10-23 14:43:38,2012-10-23 13:04:05
9fa953d3e7a864cfce4a69f47cca27d21c124672...49f0f618a92bf27caad000545bc1f460574a7504,1,4,4,8,4,2012-10-23 14:55:59,2012-10-23 05:43:51
49f0f618a92bf27caad000545bc1f460574a7504...b6b881378aec979efb3859ceb3b025d6cb262f25,1,8,0,8,1,2012-10-23 15:12:39,2012-10-23 15:07:23
97db62b4d9f7de385ccbcddb70ae048b050f5c24...9313fdc71ca8335d5e3a391c103230ee6219b3e2,3,40,1,41,3,2013-01-11 18:49:21,2013-01-11 18:49:21
b6b881378aec979efb3859ceb3b025d6cb262f25...7413df0c1fd1abaaf0594ef048304e7c59f8324a,111,175,127,302,129,2012-10-23 18:34:46,2012-10-23 18:34:46
7413df0c1fd1abaaf0594ef048304e7c59f8324a...29d12c734204b52e0afe6c41ac68a32ccbdfbde2,24,254,316,570,168,2012-10-23 18:35:27,2012-10-23 18:35:27
29d12c734204b52e0afe6c41ac68a32ccbdfbde2...76a6c4bf2e30f4c4a342b0acde2927cfd5bcd61d,18,295,183,478,151,2012-10-23 18:38:09,2012-10-23 18:38:09
f228e3cc0589ea1ab05eb2c4b5139bd572716a64...9a4a39fc97d97e7d63d5bda87f7db0acd3e808b5,1,2,2,4,2,2013-01-11 19:25:54,2013-01-11 19:25:54
9a4a39fc97d97e7d63d5bda87f7db0acd3e808b5...d22bd9e3c48bccb9c21980a88a24b7914dd47943,5,48,4,52,6,2013-01-11 20:10:45,2013-01-11 20:10:45
d22bd9e3c48bccb9c21980a88a24b7914dd47943...8018113910f12a9dc1f25bb6c8a257f4161a38a1,1,0,9,9,1,2013-01-11 20:34:36,2013-01-03 01:33:40
8018113910f12a9dc1f25bb6c8a257f4161a38a1...8e311d28b0927a3c02a1fa027945254e1a33712b,2,22,12,34,12,2013-01-11 21:24:48,2013-01-11 21:24:15
8e311d28b0927a3c02a1fa027945254e1a33712b...9bce5e8f3e1bcfae0d0732a6d05fcd3a809c93b3,2,23,11,34,3,2013-01-12 20:10:29,2013-01-12 20:07:06
9bce5e8f3e1bcfae0d0732a6d05fcd3a809c93b3...bac537b186bf6d8e96fa4802330440446664325b,1,3,3,6,3,2013-01-12 20:14:39,2013-01-12 20:14:39
bac537b186bf6d8e96fa4802330440446664325b...e4f2a140d2806b765abc2cf552b2aa34c884c78f,2,20,1,21,6,2013-01-13 00:29:34,2013-01-13 00:29:34
e4f2a140d2806b765abc2cf552b2aa34c884c78f...926c90bc64c02d155406ff464ec28d85667e3df0,1,1,1,2,1,2013-01-13 17:26:58,2012-12-18 09:48:51
926c90bc64c02d155406ff464ec28d85667e3df0...e4598aa241dabd8f30a90692b9c075e539b7cbd1,1,3,1,4,2,2013-01-14 12:06:29,2013-01-14 12:06:29
e4598aa241dabd8f30a90692b9c075e539b7cbd1...4dd70bb12c4c7be47d661ae2e950600ed7ab560d,1,2,3,5,3,2013-01-14 17:10:03,2013-01-14 17:09:35
4dd70bb12c4c7be47d661ae2e950600ed7ab560d...e501ce4b218fd462d20b45ba817f6232219e6fa2,1,8,2,10,4,2013-01-14 21:19:22,2013-01-05 21:14:50
e501ce4b218fd462d20b45ba817f6232219e6fa2...27fafd464870545eb2cce3f66064e9ffd49b3673,2,86,1,87,3,2013-01-14 23:22:42,2013-01-14 19:25:39
27fafd464870545eb2cce3f66064e9ffd49b3673...20a3c5d09c41e2e612885a6ac166144f14179f07,3,21,0,21,3,2013-01-15 00:03:38,2013-01-15 00:03:38
20a3c5d09c41e2e612885a6ac166144f14179f07...b4b750b6a52ebb893c9c8af93bdaca5238236547,2,36,12,48,8,2013-01-15 01:18:30,2013-01-14 23:29:46
b4b750b6a52ebb893c9c8af93bdaca5238236547...9668df8b3949f2a4643525fdab1e69853bcba9a5,2,9,0,9,3,2013-01-15 22:46:30,2013-01-15 22:42:23
9668df8b3949f2a4643525fdab1e69853bcba9a5...bc764f3dffe6906abd4df5e7189b7d96f225b4f0,1,7,7,14,7,2013-01-16 15:53:11,2013-01-11 08:57:24
bc764f3dffe6906abd4df5e7189b7d96f225b4f0...eef0ccbcafb82b1a47ce94fe257c991423a5bcdf,1,0,1,1,1,2013-01-16 16:10:14,2013-01-10 07:38:29
eef0ccbcafb82b1a47ce94fe257c991423a5bcdf...22b84e6216b86f9d5178e7d8a4d1a577209b7008,13,633,255,888,33,2013-01-16 18:17:20,2012-12-22 21:06:50
22b84e6216b86f9d5178e7d8a4d1a577209b7008...7393740c7b4c35205db27dbe3cfe03a624ee5704,1,115,218,333,67,2013-01-16 18:17:20,2013-01-11 00:59:39
7393740c7b4c35205db27dbe3cfe03a624ee5704...14e8f806deca0475da31676fd9952d341b8f50e5,2,95,2,97,3,2013-01-16 18:45:11,2013-01-16 00:44:29
14e8f806deca0475da31676fd9952d341b8f50e5...c93c99c7c359614c071fc0c4cd9cde0e729e712b,1,1,0,1,1,2013-01-16 18:49:19,2013-01-09 17:01:22
c93c99c7c359614c071fc0c4cd9cde0e729e712b...9fe3734f15c822d6efc5d0e07d2a9dfd41632d7c,1,8,2,10,2,2013-01-16 18:54:28,2013-01-15 18:35:52
9fe3734f15c822d6efc5d0e07d2a9dfd41632d7c...61741f9a83503e6fc198bb891b4197386888b9f2,1,1,1,2,1,2013-01-16 18:59:22,2012-12-11 10:13:22
61741f9a83503e6fc198bb891b4197386888b9f2...b9ffc537e66eddc460b5f0d4f7fbdb1880eac96c,1,3,3,6,3,2013-01-16 20:07:12,2013-01-16 20:07:12
b9ffc537e66eddc460b5f0d4f7fbdb1880eac96c...7465cf911ab944aece1463bc22c96f050751d9a2,2,10,0,10,2,2013-01-16 20:25:06,2013-01-16 18:53:16
7465cf911ab944aece1463bc22c96f050751d9a2...47f3fc9a2671bca3f70726f9bbbb8f2b56ac1dc3,1,11,9,20,2,2013-01-16 20:27:53,2013-01-16 20:27:53
47f3fc9a2671bca3f70726f9bbbb8f2b56ac1dc3...952e42de726dd4c25c81ad6dbad81f03a12096d4,85,230,429,659,229,2013-01-16 22:38:02,2013-01-16 22:38:02
952e42de726dd4c25c81ad6dbad81f03a12096d4...562d3f11f316a38b935f95841648da35fe754335,1,1,1,2,1,2013-01-17 12:51:21,2013-01-17 09:12:03
562d3f11f316a38b935f95841648da35fe754335...b48e303af023dc60b6f6590694ba94d9b8108702,4,86,44,130,34,2013-01-17 17:21:45,2013-01-16 19:26:28
b48e303af023dc60b6f6590694ba94d9b8108702...1528de23735d752f397371db9cc668aec0e67d36,3,42,4,46,5,2013-01-17 18:42:44,2013-01-17 17:52:48
1528de23735d752f397371db9cc668aec0e67d36...b7d76a1a7ba441ffb5dd0da05a226295f7a3a17c,4,44,86,130,34,2013-01-17 21:20:22,2013-01-17 21:20:22
b7d76a1a7ba441ffb5dd0da05a226295f7a3a17c...db5ee0b3decace9b5d80ee535ce53183aff02909,7,448,95,543,72,2013-01-17 21:46:31,2013-01-14 17:08:20
db5ee0b3decace9b5d80ee535ce53183aff02909...ae6f4b32c47e0597945b36a22e4b69c88a706145,1,1,0,1,1,2013-01-17 22:54:59,2013-01-17 22:54:59
ae6f4b32c47e0597945b36a22e4b69c88a706145...44cd121c63b7a4d647631f14631485ec725d7cde,7,95,448,543,72,2013-01-17 23:13:10,2013-01-17 23:13:10
44cd121c63b7a4d647631f14631485ec725d7cde...4488a69fac9a00ec8ce941464cfc16b9078249ee,7,463,99,562,76,2013-01-17 23:13:41,2013-01-14 17:08:20
4488a69fac9a00ec8ce941464cfc16b9078249ee...8b0f3ce397b473ab6c438aa9c002f38396713e44,1,3,0,3,1,2013-01-18 00:33:12,2013-01-18 00:23:34
8b0f3ce397b473ab6c438aa9c002f38396713e44...6b713b52537f2509e79fcb4d4f9433db1aee2dd9,1,22,1,23,2,2013-01-18 11:56:40,2013-01-18 11:44:10
6b713b52537f2509e79fcb4d4f9433db1aee2dd9...0459a60232744840a62da6885b2e779f2e41bb6b,125,560,300,860,201,2013-01-18 16:37:32,2013-01-18 16:37:32
76a6c4bf2e30f4c4a342b0acde2927cfd5bcd61d...626db18635d9cdb3c1ed6766b94eef5a2520bdab,1,2,0,2,1,2012-10-23 23:24:00,2012-10-23 16:45:10
626db18635d9cdb3c1ed6766b94eef5a2520bdab...f34f1e30a69ae52cd2ccf7bec639e365b961a548,1,2,1,3,2,2012-10-24 00:52:18,2012-10-24 00:42:57
f34f1e30a69ae52cd2ccf7bec639e365b961a548...82a72e9591b6970685a113a59a647fb79fc104ca,1,87,0,87,1,2012-10-24 17:08:58,2012-10-24 17:08:58
82a72e9591b6970685a113a59a647fb79fc104ca...de0303d3ad530d6a4f9b48fb5ac46795cfe4663f,2,92,3,95,2,2012-10-24 23:06:00,2012-10-23 12:06:04
de0303d3ad530d6a4f9b48fb5ac46795cfe4663f...28e6403a56bcb5af4b4127c3e2fe87d2113ab3b7,1,8,0,8,2,2012-10-24 23:06:00,2012-10-24 22:44:37
28e6403a56bcb5af4b4127c3e2fe87d2113ab3b7...4b8629db3717a587a44b373cd10351e005b190f3,1,0,10,10,1,2012-10-24 23:06:00,2012-10-24 22:52:15
0459a60232744840a62da6885b2e779f2e41bb6b...01a4be45542d6130b422991f035409d9a2d846ae,1,24,0,24,1,2013-01-18 19:04:10,2013-01-18 18:03:54
01a4be45542d6130b422991f035409d9a2d846ae...ee2fd79e434ed7096193602e614bccc075bac849,1,3,9,12,4,2013-01-18 19:04:10,2013-01-18 18:17:26
ee2fd79e434ed7096193602e614bccc075bac849...9e7bebeb8305edd55735a95955a98fdbe47572e5,3,33,2,35,3,2013-01-18 19:04:11,2013-01-18 16:42:54
4b8629db3717a587a44b373cd10351e005b190f3...c7b2e29e5e4b2a20e0cbc34d56c57d96720aadc2,1,4,5,9,3,2012-10-25 14:51:05,2012-10-25 14:48:36
c7b2e29e5e4b2a20e0cbc34d56c57d96720aadc2...822e13d375ee47d3b09a066061d7f65dc4aca57e,105,168,116,284,119,2012-10-25 16:15:35,2012-10-25 16:15:35
fa543da830b87dd9d573d45e3a9e318ecb74743a...fc3547bc828dfcaca83e9c4415743fb201a821f6,1,2,2,4,2,2013-01-18 19:49:35,2013-01-18 19:49:35
822e13d375ee47d3b09a066061d7f65dc4aca57e...e1bdde05c7ebbfdaad6cf51e67e69754a232751f,1,2,2,4,2,2012-10-25 18:46:13,2012-10-24 16:21:39
e1bdde05c7ebbfdaad6cf51e67e69754a232751f...ff4c974873f9a7cc6a5b042eb9b6389bb8dde6d6,3,41,18,59,19,2012-10-25 18:46:13,2012-10-25 18:32:31
3d7818fc42c5f9af2aeccf9d75ad6a2372179f28...33d22428fbb10dc04f07d73e22774e8f1f62b2e7,1,5,4,9,1,2013-01-18 21:18:37,2013-01-18 13:51:09
33d22428fbb10dc04f07d73e22774e8f1f62b2e7...14c911de77ae377ec777d6f1a59d0de904ec5ae7,2,50,1,51,2,2013-01-18 21:26:40,2012-12-27 20:08:23
14c911de77ae377ec777d6f1a59d0de904ec5ae7...539bf1d7b7070eae0d0da067741d5bedf41750a8,2,8,4,12,5,2013-01-18 23:39:08,2013-01-18 00:02:41
539bf1d7b7070eae0d0da067741d5bedf41750a8...00abc243dd2948027fd61729b647ec42f73a4027,2,8,186,194,7,2013-01-19 22:23:42,2013-01-19 20:26:38
00abc243dd2948027fd61729b647ec42f73a4027...2dd373894f76f768a72c9c08096c2598c0b8485b,2,10,1,11,2,2013-01-19 23:29:01,2013-01-19 23:24:19
2dd373894f76f768a72c9c08096c2598c0b8485b...3d67f895521cf905922d20af9b03e5c73c363868,1,5,5,10,5,2013-01-21 08:46:27,2013-01-20 14:31:30
3d67f895521cf905922d20af9b03e5c73c363868...e2592cc6a3b17b36ba11e2ca191f8ea875161d52,1,3,0,3,1,2013-01-21 08:47:26,2013-01-20 15:23:35
e2592cc6a3b17b36ba11e2ca191f8ea875161d52...d5a590134655c9a59cfcab72217442ac4c795fd7,1,4,4,8,4,2013-01-22 03:17:01,2013-01-07 19:35:42
d5a590134655c9a59cfcab72217442ac4c795fd7...814bdf0f51fd3219063a44f919dfcdb6e51951f7,11,84,33,117,30,2013-01-22 15:21:25,2013-01-22 15:21:25
814bdf0f51fd3219063a44f919dfcdb6e51951f7...e2acf26a91c68df83720b735d1abf484b967afb7,3,57,23,80,8,2013-01-22 23:17:01,2013-01-22 23:17:01
e2acf26a91c68df83720b735d1abf484b967afb7...2cbf4586df837e6b2cc7e04f7b9ae7766904df61,2,71,0,71,2,2013-01-23 00:47:24,2013-01-23 00:42:16
2cbf4586df837e6b2cc7e04f7b9ae7766904df61...3d286b68be680380f7cdfd78793544761a658f24,2,6,46,52,7,2013-01-23 12:55:04,2013-01-22 22:35:20
3d286b68be680380f7cdfd78793544761a658f24...0774798ce0766e9e340d33e0196a89930f6ad176,1,5,0,5,1,2013-01-23 18:54:00,2013-01-17 06:29:48
0774798ce0766e9e340d33e0196a89930f6ad176...4a7a98fd0ab3d39685888f15bb3a844e863be255,2,40,28,68,10,2013-01-24 10:23:36,2013-01-23 12:47:29
4a7a98fd0ab3d39685888f15bb3a844e863be255...193320aa3a128ae4ee06e91f1b4b25ce64aef82b,1,1,0,1,1,2013-01-24 10:35:29,2013-01-24 10:35:29
193320aa3a128ae4ee06e91f1b4b25ce64aef82b...444bbd4fa7315423a6b55aba0e0c12ea6534b2cb,9,757,42,799,61,2013-01-24 15:49:27,2013-01-12 04:59:57
444bbd4fa7315423a6b55aba0e0c12ea6534b2cb...782149ddc3c7a0ab8e72ad8afc3eb891ea0a6aef,2,77,16,93,4,2013-01-24 15:49:27,2013-01-24 01:52:45
782149ddc3c7a0ab8e72ad8afc3eb891ea0a6aef...5d3c51d937fe887b3bc16344b519d1ad20fa9ff6,1,75,0,75,1,2013-01-24 15:49:27,2013-01-24 03:15:03
5d3c51d937fe887b3bc16344b519d1ad20fa9ff6...82f1d340c1278af046916798f488b196e21ebf19,3,80,2,82,6,2013-01-24 16:47:07,2013-01-22 13:27:05
82f1d340c1278af046916798f488b196e21ebf19...80242528778cacb57d7f043309745d169f1d234c,14,196,10,206,17,2013-01-24 17:10:01,2013-01-24 16:59:39
80242528778cacb57d7f043309745d169f1d234c...7a2ebce8d8e939370ce24ff464e157d29dded806,3,6,10,16,4,2013-01-24 17:10:01,2013-01-24 17:02:21
7a2ebce8d8e939370ce24ff464e157d29dded806...e722ca32d9822e50954144c123794ee4380f03cb,139,1401,389,1790,226,2013-01-24 17:10:01,2013-01-24 17:06:31
d269f7e48c30f17065aedef7189a1c3e9a177853...648e38771e5139c2c1d0cbd3d5a251acda9f9933,1,2,2,4,1,2012-10-25 19:52:46,2012-10-25 19:52:46
648e38771e5139c2c1d0cbd3d5a251acda9f9933...d130bb060eb90f179ae1fd55130515d5d3b1bcf9,1,72,0,72,1,2012-10-25 19:54:00,2012-10-25 19:53:03
d130bb060eb90f179ae1fd55130515d5d3b1bcf9...45a13d96747deb52cd8fedcec7a2a32b2abf8fee,2,45,2,47,2,2012-10-25 20:37:08,2012-10-25 20:37:08
e722ca32d9822e50954144c123794ee4380f03cb...6e05faa3d0de2b8540187de261dd848c7a5ca0cf,1,81,0,81,2,2013-01-24 18:12:19,2013-01-24 18:12:19
e722ca32d9822e50954144c123794ee4380f03cb...5f2f8400f665dc32c3e10e7d31d53d756ded9156,3,28,2,30,3,2013-01-24 17:15:25,2013-01-24 17:15:25
45a13d96747deb52cd8fedcec7a2a32b2abf8fee...b00527fcf05c3d9fb5d5d790f9472906a59fe218,2,7,2,9,2,2012-10-25 20:49:32,2012-10-25 20:49:32
42309a36e34dfa11e7c4c915f96fb66195d5945c...f64742ea07d8f4b4f4ac391bc5f846fe7e4780de,1,2,2,4,2,2013-01-24 18:31:40,2013-01-24 18:31:40
f64742ea07d8f4b4f4ac391bc5f846fe7e4780de...595b5974d7fcb7ee415e8e4ce6ec182a07bc9dc1,4,111,1,112,5,2013-01-25 00:48:49,2013-01-23 23:17:04
595b5974d7fcb7ee415e8e4ce6ec182a07bc9dc1...83154aa15db01f46c7f59744bd8f65ca570ac397,1,7,0,7,1,2013-01-25 01:16:19,2012-12-06 00:01:41
83154aa15db01f46c7f59744bd8f65ca570ac397...16bbeccd40a9d08f7ae73eeeefa0fd6f206dc7a9,3,14,6,20,3,2013-01-25 10:58:51,2013-01-22 17:09:12
16bbeccd40a9d08f7ae73eeeefa0fd6f206dc7a9...49175e6ae293fdb564fa0e91fdb104a3a1f248f5,3,127,101,228,33,2013-01-25 10:59:21,2013-01-22 18:48:54
49175e6ae293fdb564fa0e91fdb104a3a1f248f5...cbe3941db9ec4f47a336fb36a2b91275c3acc7fa,2,48,58,106,36,2013-01-25 10:59:26,2013-01-22 19:10:11
cbe3941db9ec4f47a336fb36a2b91275c3acc7fa...00b4b7bb97c84d19c644a4491fe98170ab9675a6,1,4,5,9,2,2013-01-25 21:07:04,2013-01-25 21:03:11
00b4b7bb97c84d19c644a4491fe98170ab9675a6...15508589a163b0c9f09ac608281f9ebb015d4deb,6,52,13,65,15,2013-01-25 22:25:35,2013-01-24 23:40:58
15508589a163b0c9f09ac608281f9ebb015d4deb...f210710795240c646746cb9d9c752d46a026200b,1,37,29,66,25,2013-01-25 22:26:52,2013-01-21 03:20:43
f210710795240c646746cb9d9c752d46a026200b...bdc7251b64bf2a467fb7048cff5dc1814f3152ed,1,14,11,25,4,2013-01-25 22:27:46,2013-01-25 22:27:46
bdc7251b64bf2a467fb7048cff5dc1814f3152ed...99f0b022d528cc350f87150b5ecdf5c903aaeeb1,1,11,0,11,3,2013-01-26 18:38:00,2013-01-25 12:34:54
99f0b022d528cc350f87150b5ecdf5c903aaeeb1...7f2a78bf4d494806ccabcccdeb8579dcc4405a8d,1,0,11,11,3,2013-01-27 14:21:03,2013-01-27 14:21:03
7f2a78bf4d494806ccabcccdeb8579dcc4405a8d...0972acb5481065d79eaca1f1fc6e009fea70b144,1,14,0,14,3,2013-01-27 16:11:41,2013-01-27 15:25:54
0972acb5481065d79eaca1f1fc6e009fea70b144...2e371b8f926a6a0ae07a18c61c773dbd8cef7aeb,1,2,1,3,1,2013-01-27 20:50:01,2013-01-27 20:50:00
2e371b8f926a6a0ae07a18c61c773dbd8cef7aeb...acd0df4ad90c31ad5c605a39120e684ecb4b8cc2,2,2,2,4,2,2013-01-27 21:01:14,2013-01-27 21:01:10
acd0df4ad90c31ad5c605a39120e684ecb4b8cc2...a39f669bc7f6d3860329b0d2a1a78b59dd115b10,1,0,0,0,0,2013-01-28 11:41:56,2013-01-28 11:41:54
a39f669bc7f6d3860329b0d2a1a78b59dd115b10...0d7a0216dc8e0d79bdc32aa7c48097bebfcba8eb,2,71,0,71,2,2013-01-28 12:37:09,2013-01-28 09:04:58
0d7a0216dc8e0d79bdc32aa7c48097bebfcba8eb...e26622bd18fc86033cea393125cad49c577b524b,2,86,50,136,14,2013-01-28 16:40:45,2013-01-27 19:56:36
e26622bd18fc86033cea393125cad49c577b524b...faf78604ca980dbb3ad57df87640415c6a901fac,1,3,0,3,1,2013-01-28 16:54:08,2013-01-28 16:54:08
faf78604ca980dbb3ad57df87640415c6a901fac...4c78a52a3a0758fe71810689504220c6b6aeea01,1,3,0,3,1,2013-01-28 17:09:34,2013-01-28 16:54:27
4c78a52a3a0758fe71810689504220c6b6aeea01...c13354e339da3849156287b0ad3bb70b9c115632,2,4,4,8,2,2013-01-28 17:24:45,2013-01-28 17:22:59
c13354e339da3849156287b0ad3bb70b9c115632...5e7e51c2fe5b66f65a78afa8c931488c780fa0c4,9,355,48,403,38,2013-01-28 21:12:21,2013-01-22 22:52:20
5e7e51c2fe5b66f65a78afa8c931488c780fa0c4...6311f1c30a9c579dc354d84809099d28f074b3de,1,14,3,17,2,2013-01-28 21:19:02,2013-01-28 21:19:02
6311f1c30a9c579dc354d84809099d28f074b3de...02f7d1bfd8b5b75620352774967dce63b0934037,2,85,7,92,3,2013-01-29 00:16:21,2013-01-28 19:15:53
02f7d1bfd8b5b75620352774967dce63b0934037...bda45a8be1e80bb79343db019e450c1ded2382eb,2,7,85,92,3,2013-01-29 01:15:22,2013-01-29 01:15:22
bda45a8be1e80bb79343db019e450c1ded2382eb...9bd9c546c87f29e12821de6c2e8bc7fa33903596,2,21,3,24,4,2013-01-29 16:15:24,2013-01-28 12:13:28
9bd9c546c87f29e12821de6c2e8bc7fa33903596...60f18ede39e428867fbfe6df8c536fc2fcf79947,2,56,4,60,10,2013-01-30 02:21:31,2013-01-30 01:50:44
60f18ede39e428867fbfe6df8c536fc2fcf79947...3fe6aba558efe3f1cac17dd6c0c41fb11443788b,3,8,6,14,7,2013-01-30 03:24:58,2013-01-29 16:27:33
3fe6aba558efe3f1cac17dd6c0c41fb11443788b...f64d1febc887b8516ece378abcddfc409a2f0408,1,1,1,2,1,2013-01-30 07:57:23,2013-01-30 07:55:58
f64d1febc887b8516ece378abcddfc409a2f0408...016810913d48774e61f2c0f187f4121fd29aaa12,2,41,15,56,6,2013-01-30 17:04:30,2013-01-30 07:23:36
016810913d48774e61f2c0f187f4121fd29aaa12...7e1cf84c9efd491d72b25968a70656458ecb6b7c,2,99,7,106,4,2013-01-31 19:59:36,2013-01-31 19:22:07
7e1cf84c9efd491d72b25968a70656458ecb6b7c...a6c18472cd31c1367dd85ca0d864b1136027811b,2,88,55,143,10,2013-01-31 21:33:37,2013-01-31 21:33:37
a6c18472cd31c1367dd85ca0d864b1136027811b...6aed61f1cad0a267d9fdc75f90381fdfb4491e8c,1,5,1,6,2,2013-02-01 16:58:15,2013-02-01 16:33:19
6aed61f1cad0a267d9fdc75f90381fdfb4491e8c...c7c1ed01ae1798ed75e1c0733748c0d2d5239dd5,1,4,0,4,1,2013-02-01 18:17:53,2013-02-01 18:17:22
c7c1ed01ae1798ed75e1c0733748c0d2d5239dd5...3f65916fa995c74b0db2064911fe76d18d3509b6,3,22,15,37,4,2013-02-01 22:07:17,2013-02-01 21:35:57
3f65916fa995c74b0db2064911fe76d18d3509b6...916aebabb83745dd7b1402a92f120107fa6ea6b6,4,5,1,6,4,2013-02-01 23:58:51,2013-02-01 23:55:03
916aebabb83745dd7b1402a92f120107fa6ea6b6...cd42f56178c929da84046e750b9306b5656e3144,3,68,30,98,4,2013-02-02 00:01:42,2013-02-01 23:40:10
cd42f56178c929da84046e750b9306b5656e3144...a9c4a20331d123dc38dcc878af335d88e1933562,2,44,2,46,6,2013-02-05 23:12:06,2013-02-05 22:58:16
a9c4a20331d123dc38dcc878af335d88e1933562...202b5db4efd0beec788beb40ece205ce9aa79037,1,13,4,17,2,2013-02-06 09:30:59,2012-09-18 22:35:29
202b5db4efd0beec788beb40ece205ce9aa79037...01ee551e704776d8547250ac015a5463613afb45,2,103,38,141,11,2013-02-06 13:21:35,2013-02-05 13:24:43
01ee551e704776d8547250ac015a5463613afb45...b58efe77094e568889fc0619cc3cc6742e1c47d7,1,63,0,63,1,2013-02-06 14:10:53,2013-02-06 14:10:48
b58efe77094e568889fc0619cc3cc6742e1c47d7...c024d2d8c04405bc112226796c8d10421f58d441,2,50,5,55,4,2013-02-06 16:38:20,2013-02-06 14:45:06
c024d2d8c04405bc112226796c8d10421f58d441...d59beb9f686578a3c34606cba294df0fb7d844a9,1,280,386,666,61,2013-02-06 19:23:54,2013-01-31 17:20:49
d59beb9f686578a3c34606cba294df0fb7d844a9...7b0770bff56122c245f83e8ee9608e1a0082c15e,2,28,4,32,3,2013-02-06 21:26:50,2013-02-06 21:13:05
4379e498187237803ab19ebc46fa2e97bfe45940...54e88b3d619706a85aa081a757cb8f01deef67fb,1,2,2,4,1,2012-10-25 21:16:53,2012-10-25 21:16:53
54e88b3d619706a85aa081a757cb8f01deef67fb...7fe1671727635d760792a4a02b019cbaa7326747,2,82,0,82,2,2012-10-25 21:17:43,2012-10-25 21:17:43
7fe1671727635d760792a4a02b019cbaa7326747...5f0a10ad218e56f1ebbcbf59702d0759c12b19c9,1,6,5,11,3,2012-10-25 21:42:47,2012-10-25 21:42:47
5f0a10ad218e56f1ebbcbf59702d0759c12b19c9...326bce91d680ccf4a263f6c8696865cc800412d0,2,7,7,14,7,2012-10-29 19:34:03,2012-10-29 03:16:40
326bce91d680ccf4a263f6c8696865cc800412d0...44dd2c392a1378c081b5b21cf5d987e7509457c9,1,0,5,5,1,2012-10-30 00:20:17,2012-10-29 03:13:10
44dd2c392a1378c081b5b21cf5d987e7509457c9...9b22944b68a91dc41015022679779472c75d4e9b,2,3,2,5,2,2012-11-08 22:54:53,2012-11-08 22:54:53
9b22944b68a91dc41015022679779472c75d4e9b...b3bfb6fbb6ef51163f3db35d1057d277b2dd05fc,2,27,2,29,3,2012-11-08 23:49:24,2012-11-08 23:49:24
b3bfb6fbb6ef51163f3db35d1057d277b2dd05fc...77168281661d30e0002434522c544818d022bcd0,9,119,32,151,33,2012-11-20 18:21:48,2012-11-20 18:21:48
77168281661d30e0002434522c544818d022bcd0...bb867c0fa6c245e95009f18742997b4cf372d6e3,1,17,0,17,1,2012-11-22 17:30:18,2012-11-22 17:30:18
bb867c0fa6c245e95009f18742997b4cf372d6e3...db008f7cce0ef21c0f5253b3c3ab91e8ae0db85a,199,221,201,422,210,2012-11-23 20:51:23,2012-11-23 20:51:23
db008f7cce0ef21c0f5253b3c3ab91e8ae0db85a...fb5c7f03a040a4eb3684f0a9cff3141d959ea735,10,597,16,613,10,2012-11-23 20:54:33,2012-11-23 20:54:33
fb5c7f03a040a4eb3684f0a9cff3141d959ea735...4cb17cb219b3a2540b40458ed253695b3626a803,2,51,1,52,2,2012-11-24 14:27:14,2012-11-24 14:24:36
4cb17cb219b3a2540b40458ed253695b3626a803...121ed91331b015fa287b07a8270fd4e653d3173d,2,57,1,58,2,2012-11-26 00:51:05,2012-11-26 00:50:04
5cc3569f6d50560cec1c2dab17b9fb251d26a5df...6bcd9a4c9453873c712b051f5455bf0d4c8b8e9e,1,96,157,253,25,2013-02-07 14:07:21,2013-01-19 23:49:30
6bcd9a4c9453873c712b051f5455bf0d4c8b8e9e...33b2aebb6dc0ee9edbd4026552c8400aafbe871c,2,13,2,15,2,2013-02-07 16:50:18,2013-02-07 16:50:18
121ed91331b015fa287b07a8270fd4e653d3173d...fdf91afb494a7a2fff2913d817f589c191a2c88f,3,23,2,25,3,2012-11-26 16:39:49,2012-10-25 20:49:32
33b2aebb6dc0ee9edbd4026552c8400aafbe871c...4b9f0d190cd6b22853caeb0e07145a98ce1d1d7f,3,31,2,33,3,2013-02-07 17:11:11,2013-02-07 17:09:21
9f51fd6b8496d4979aad472ea3b3879cf6dfcb2d...e773be6f9082ee146d9d2eeb32d326732ad804ef,1,2,2,4,1,2012-11-26 17:18:33,2012-11-26 17:18:33
e773be6f9082ee146d9d2eeb32d326732ad804ef...122ac4e1f2173680836faf5933e1330321f5fb53,1,71,0,71,1,2012-11-26 17:20:07,2012-11-26 17:18:51
122ac4e1f2173680836faf5933e1330321f5fb53...83161455bd428c8c66befdf7c882a01e6255e3af,1,1,0,1,1,2012-11-28 02:11:40,2012-11-27 14:52:49
83161455bd428c8c66befdf7c882a01e6255e3af...c9f2531ae02d49add0b5eb00bbad0fc05b5a8881,3,35,22,57,7,2012-11-28 20:51:27,2012-10-09 00:51:59
c9f2531ae02d49add0b5eb00bbad0fc05b5a8881...acad8d9a77a96d9edf33e3ee9bf2e8be74904228,9,10,10,20,10,2012-11-29 22:00:09,2012-11-29 18:59:12
acad8d9a77a96d9edf33e3ee9bf2e8be74904228...6772308883f3025f94db208186224b887ff9bc69,2,12,4,16,2,2012-12-01 00:23:49,2012-11-30 21:02:39
6772308883f3025f94db208186224b887ff9bc69...4d0fcd515fe0a38127136a751e5d1517b250fa80,1,1,1,2,1,2012-12-01 02:14:26,2012-11-30 01:13:52
4d0fcd515fe0a38127136a751e5d1517b250fa80...22965da799e843525a1146ca37306dc4c740ffc1,1,5,1,6,2,2012-12-02 01:55:50,2012-12-02 01:54:14
22965da799e843525a1146ca37306dc4c740ffc1...e5649d4b3d0271c6fc248ac12ff73b6b253a91b7,1,11,6,17,2,2012-12-02 02:01:20,2012-12-02 02:01:17
e5649d4b3d0271c6fc248ac12ff73b6b253a91b7...276245d26f43d0eb9e5a78a046eab1f3a429365a,1,9,0,9,1,2012-12-03 16:30:16,2012-12-01 18:26:40
276245d26f43d0eb9e5a78a046eab1f3a429365a...c79fd0e167f55e8274ad8729a087076cf8903b53,1,0,8,8,1,2012-12-06 20:58:36,2012-12-06 20:58:29
c79fd0e167f55e8274ad8729a087076cf8903b53...92e92b02155c6d6bb0b88b9cf98b2d5865a7deca,1,3,1,4,1,2012-12-11 00:56:49,2012-12-11 00:56:49
92e92b02155c6d6bb0b88b9cf98b2d5865a7deca...65d824b488793ba8b92dfcf6edc6e87f41745580,1,39,4,43,2,2012-12-12 08:46:09,2012-07-31 15:47:53
65d824b488793ba8b92dfcf6edc6e87f41745580...6e97b2cc17851a3b96cd01bac40c82573650ce6b,2,55,2,57,2,2012-12-12 08:46:22,2012-12-11 13:45:45
6e97b2cc17851a3b96cd01bac40c82573650ce6b...d65832ccd0618a7f6051e5dd786c731bd89c8a1c,2,64,3,67,3,2012-12-12 08:46:22,2012-12-11 15:01:58
55c4d9b3971fefc08c50db357fb40d69b6a4b302...c3c8eee46db007ee77c384994d85285d94b98860,1,2,2,4,2,2013-02-07 18:34:07,2013-02-07 18:34:07
c3c8eee46db007ee77c384994d85285d94b98860...e418df7bb8030f86d4be8a10d1a2776f135a7da2,2,41,12,53,11,2013-02-07 23:29:01,2012-12-17 05:23:23
e418df7bb8030f86d4be8a10d1a2776f135a7da2...8164b2fda77d9f91c6cd83d360967bf55c0bd0f1,3,64,26,90,26,2013-02-07 23:31:21,2013-01-30 04:37:57
8164b2fda77d9f91c6cd83d360967bf55c0bd0f1...0c2e5ec840e2dc64585ea75f7539d87e5af4269e,21,379,55,434,43,2013-02-09 01:17:45,2013-02-09 01:17:45
0c2e5ec840e2dc64585ea75f7539d87e5af4269e...e4a856e0ba815fca99a8e9ba7b626ff50a20feae,4,19,14,33,6,2013-02-09 01:18:41,2013-02-09 01:18:37
e4a856e0ba815fca99a8e9ba7b626ff50a20feae...1ba39226b2235a6cad40c10d802cffc1f7cdf23d,1,3,1,4,2,2013-02-09 18:34:18,2013-02-09 18:32:24
1ba39226b2235a6cad40c10d802cffc1f7cdf23d...fd9d8b5e4ab221213fc493efa0044b068f81fa75,2,4,28,32,3,2013-02-10 14:22:27,2013-02-09 07:49:10
fd9d8b5e4ab221213fc493efa0044b068f81fa75...144e21ed30356b7f563c6a37471537b2057b56f4,2,38,103,141,11,2013-02-10 14:22:27,2013-02-09 07:49:45
144e21ed30356b7f563c6a37471537b2057b56f4...234551a22a1526c98f2154900149fed8801607d8,3,54,3,57,6,2013-02-10 14:22:40,2013-02-09 07:58:48
234551a22a1526c98f2154900149fed8801607d8...fe103357aeed7f7acdc687a759f9d443c6c25373,2,7,3,10,4,2013-02-10 14:22:40,2013-02-09 08:09:13
fe103357aeed7f7acdc687a759f9d443c6c25373...5a9d30bb86672ae3e10469adf0ca2d72d131fff2,2,30,34,64,4,2013-02-10 20:31:41,2013-02-10 20:28:11
5a9d30bb86672ae3e10469adf0ca2d72d131fff2...30b0bc4fa93ae553cd61484a0da34aa697708e63,1,8,14,22,3,2013-02-10 20:57:32,2013-02-10 20:41:06
30b0bc4fa93ae553cd61484a0da34aa697708e63...d5a5ae3c11b05895ffc2fbee4d1a92686c8f3897,1,3,1,4,1,2013-02-11 12:37:33,2013-02-11 12:33:50
d5a5ae3c11b05895ffc2fbee4d1a92686c8f3897...aff8d9e716a1953ed1526b3f8ce8455850f780da,3,10,26,36,4,2013-02-11 16:30:06,2013-02-11 16:30:04
aff8d9e716a1953ed1526b3f8ce8455850f780da...ed3d553d826963837dee5db9cf6cc88b2d5c62cc,2,9,3,12,5,2013-02-11 16:38:32,2013-02-11 16:34:56
ed3d553d826963837dee5db9cf6cc88b2d5c62cc...c7b84a1d01fa4fd6ccff1ceb917a5aaf59694244,2,17,20,37,13,2013-02-11 20:15:13,2013-02-11 13:01:18
c7b84a1d01fa4fd6ccff1ceb917a5aaf59694244...14a424505151486c5b58be4932e801fff8606e67,3,3,7,10,3,2013-02-11 20:31:21,2013-01-31 18:48:25
14a424505151486c5b58be4932e801fff8606e67...862b16420918a56284a794c7de040a7ca5783d6b,3,4,8,12,4,2013-02-11 20:31:21,2013-02-03 04:52:04
862b16420918a56284a794c7de040a7ca5783d6b...f5f9e8da7167d996b889a2265fed4e7ea1bf3190,2,32,32,64,13,2013-02-11 22:19:48,2013-02-11 20:22:34
f5f9e8da7167d996b889a2265fed4e7ea1bf3190...6bd450155c36f9e3dbaa8e4d6261e5e447af0a9a,1,1,1,2,1,2013-02-12 00:43:09,2013-02-11 23:45:53
6bd450155c36f9e3dbaa8e4d6261e5e447af0a9a...1762dd7ed98417cc7cf124c099f66af11dcf702b,1,10,0,10,1,2013-02-12 00:43:09,2013-02-11 23:37:50
1762dd7ed98417cc7cf124c099f66af11dcf702b...02374d0c178b7c8cccab2d1daaa1bf601838bea5,2,92,0,92,2,2013-02-12 00:43:10,2013-02-11 23:46:19
02374d0c178b7c8cccab2d1daaa1bf601838bea5...e235bce2ba399ac93f0ef86a33f25cc19b08af14,2,61,1,62,2,2013-02-12 10:11:22,2013-02-09 01:47:00
e235bce2ba399ac93f0ef86a33f25cc19b08af14...c34326b286fed0680a481f6c1d9c1c0f0857f56e,2,9,0,9,6,2013-02-12 11:00:13,2013-02-12 11:00:13
c34326b286fed0680a481f6c1d9c1c0f0857f56e...19d29aa0e8136cba87ab6bf1649b91b687e31a7a,1,4,2,6,3,2013-02-12 18:38:29,2013-02-12 18:37:30
19d29aa0e8136cba87ab6bf1649b91b687e31a7a...2789323902a745eea16c645e38d9d67b6fcb69a0,2,54,2,56,3,2013-02-13 00:49:26,2013-02-12 17:08:50
2789323902a745eea16c645e38d9d67b6fcb69a0...3f7e88a852afe54253eb93ddcb0fdf3a88b9f4ec,3,36,41,77,7,2013-02-13 01:09:19,2013-02-12 13:58:35
3f7e88a852afe54253eb93ddcb0fdf3a88b9f4ec...b1b7b4e4e806faafebfad85e828d7e6ed492b44a,1,23,30,53,4,2013-02-13 14:44:37,2013-02-13 14:44:35
b1b7b4e4e806faafebfad85e828d7e6ed492b44a...2d069c52107b02999476c8a2aee5cf2b190b8d12,1,12,2,14,2,2013-02-13 14:54:17,2013-02-13 14:54:17
2d069c52107b02999476c8a2aee5cf2b190b8d12...7bdd05bd66607886d633332e1397550d9b8d9b39,7,101,29,130,32,2013-02-13 15:11:20,2013-02-13 15:09:03
7bdd05bd66607886d633332e1397550d9b8d9b39...cd372510bb504b6d3414b01cc8c9ee457b2e16c4,2,77,24,101,16,2013-02-16 00:11:05,2013-02-06 02:13:02
cd372510bb504b6d3414b01cc8c9ee457b2e16c4...401cef797df39ca0e5d7a71b2202d6fc750ca912,1,4,3,7,1,2013-02-16 00:11:05,2013-02-06 02:14:24
401cef797df39ca0e5d7a71b2202d6fc750ca912...95ac576bf956055d3d5758cacbd336b53570f89f,4,51,77,128,16,2013-02-16 02:13:01,2013-02-01 22:23:28
95ac576bf956055d3d5758cacbd336b53570f89f...86c0745a5ebd75a4a5fa69420dfde657a5e717bc,7,234,112,346,48,2013-02-16 02:13:01,2013-02-07 01:26:18
86c0745a5ebd75a4a5fa69420dfde657a5e717bc...ec4200068c65689ad8da53b3226f10de01dd161f,2,92,83,175,40,2013-02-16 02:37:53,2013-02-13 14:30:06
ec4200068c65689ad8da53b3226f10de01dd161f...9299168f2a2ea231f63731894bc93e3807d1065a,3,3,3,6,3,2013-02-16 02:37:53,2013-02-16 02:31:43
9299168f2a2ea231f63731894bc93e3807d1065a...8476aefc8e21fb8db597937c7e8fbc3490a72f39,2,97,5,102,2,2013-02-16 02:48:43,2013-02-03 20:53:33
8476aefc8e21fb8db597937c7e8fbc3490a72f39...0a9930a230cf7fe8e2f7d431fc85a7f21517d39b,1,7,2,9,1,2013-02-16 02:51:22,2013-02-14 19:26:54
d65832ccd0618a7f6051e5dd786c731bd89c8a1c...b09f97068e983ff042dfe189221427e4ac0bd93d,239,3712,306,4018,281,2012-12-12 22:41:28,2012-12-12 22:41:28
b09f97068e983ff042dfe189221427e4ac0bd93d...1c9c6277d5cfcaaac8569c0c8f7daa64292048a9,3,17,2,19,3,2012-12-13 19:49:39,2012-12-12 22:44:54
d75e39794bb9e5663e9301087c06151f42071dfe...09b1212254445d1848e369462d3f91fb1c3f3cf4,1,2,0,2,1,2013-02-18 18:38:37,2013-02-18 18:38:37
09b1212254445d1848e369462d3f91fb1c3f3cf4...75df612cd7eb282c4d618b8018036a39b8941db9,1,8,4,12,5,2013-02-18 19:24:14,2013-02-18 19:24:14
75df612cd7eb282c4d618b8018036a39b8941db9...a77c29a0f981451dec3430d1e46bc77518e30ead,2,11,7,18,6,2013-02-19 10:22:14,2013-02-19 02:26:29
a77c29a0f981451dec3430d1e46bc77518e30ead...7f303707d5bc43dba1d4b6cb9baa082cd40cf1cb,1,1,1,2,1,2013-02-19 19:41:06,2013-02-19 02:26:29
7f303707d5bc43dba1d4b6cb9baa082cd40cf1cb...60238cce12d5c0c45c54c18033a439ac12429a29,1,4,0,4,1,2013-02-19 19:41:39,2013-02-19 19:37:48
a18507ce1158e9a60e4733933c607820c1311662...953673424ae8ade03ea046e9edd5621febd1ebb6,1,2,2,4,1,2012-12-13 19:50:35,2012-12-13 19:50:35
953673424ae8ade03ea046e9edd5621febd1ebb6...45cdb0e4c12d8f8e9450174ddd6ddad52a995831,1,65,0,65,1,2012-12-13 19:50:47,2012-12-13 19:50:47
60238cce12d5c0c45c54c18033a439ac12429a29...4911a30803eacfaf6e397cb91669109d13aeb92d,105,132,132,264,112,2013-02-19 21:18:36,2013-02-19 21:18:36
4911a30803eacfaf6e397cb91669109d13aeb92d...54d20ffba03fd1b45643b455935928b87eb5f08d,3,37,2,39,3,2013-02-19 21:23:47,2013-02-19 21:23:47
45cdb0e4c12d8f8e9450174ddd6ddad52a995831...827b2a9b0b2b938f458a7569bf6c73b6be25ddc7,2,29,29,58,7,2012-12-16 16:25:03,2012-08-07 00:42:13
827b2a9b0b2b938f458a7569bf6c73b6be25ddc7...53b826e6aeeb3fb98e3f9b1ee82f2dd100202e1b,1,1,1,2,1,2012-12-17 11:05:14,2012-12-17 11:05:14
53b826e6aeeb3fb98e3f9b1ee82f2dd100202e1b...496c0bd9364f48970d3467bb455451c1a69eacdd,1,2,0,2,1,2012-12-17 16:21:35,2012-12-17 15:53:52
496c0bd9364f48970d3467bb455451c1a69eacdd...04adf0e5a1e5f245c5b26c87bdce1648efb799f1,1,579,0,579,1,2012-12-18 16:45:03,2012-12-18 16:43:45
04adf0e5a1e5f245c5b26c87bdce1648efb799f1...ba407ce4106635949fcd5fdeced255d543ab1079,2,8,10,18,6,2012-12-20 10:44:10,2012-12-19 13:09:10
ba407ce4106635949fcd5fdeced255d543ab1079...5a19c07c087c5749e31737cb4fb5a113643f35d6,1,71,8,79,4,2012-12-20 11:02:06,2012-12-19 11:35:07
27a3ff632227f829ca55ede777d0cc8b76cb3d2c...727151afd31c54605142ab60595d5a9056d72853,1,2,2,4,2,2013-02-19 21:58:38,2013-02-19 21:58:38
5a19c07c087c5749e31737cb4fb5a113643f35d6...0c867ae618e575287c9b9a9a94d2a9ef22bdfd36,1,25,10,35,4,2012-12-21 00:08:50,2012-12-21 00:08:50
0c867ae618e575287c9b9a9a94d2a9ef22bdfd36...9d0103d22e1149c0379b15a07db86a58339acf5f,1,22,22,44,9,2012-12-21 00:46:40,2012-12-21 00:46:40
9d0103d22e1149c0379b15a07db86a58339acf5f...d30e76e0e834293981dba3b1ef838be24ab4d33a,1161,40338,1803,42141,1793,2012-12-21 16:42:29,2012-12-21 16:42:29
727151afd31c54605142ab60595d5a9056d72853...00e1962495f9d42b7bf403952566e420acdf48d0,1,110,0,110,1,2013-02-19 22:14:29,2013-02-08 03:10:58
00e1962495f9d42b7bf403952566e420acdf48d0...dd069a253940812282410b221276876b8968b3f1,1,41,1,42,3,2013-02-19 22:14:29,2013-02-12 07:26:43
dd069a253940812282410b221276876b8968b3f1...37077de83dbb97f1b51839fb0ebff608aa9ea3c8,1,52,7,59,7,2013-02-19 22:14:29,2013-02-12 07:21:48
37077de83dbb97f1b51839fb0ebff608aa9ea3c8...aa2edd4b89c51836424b211db756ba907230b58b,1,116,0,116,1,2013-02-19 22:14:30,2013-02-12 07:28:48
aa2edd4b89c51836424b211db756ba907230b58b...baea73ccda8a54d93f0de4f60ffcee568dac8c01,1,0,0,0,0,2013-02-19 22:14:30,2013-02-08 03:10:48
baea73ccda8a54d93f0de4f60ffcee568dac8c01...e82f97401f9d7c54155b52b310f1893e45205c46,6,711,65,776,16,2013-02-19 22:14:30,2013-02-08 03:13:26
e82f97401f9d7c54155b52b310f1893e45205c46...051c1317f99ede15a831d1f542bd89a47ab77397,2,0,45,45,2,2013-02-19 22:14:30,2013-02-12 06:08:25
051c1317f99ede15a831d1f542bd89a47ab77397...d5d04a51d641cca321e8470a64e84dd8b7a97e4a,1,0,80,80,1,2013-02-19 22:14:31,2013-02-12 01:57:49
d5d04a51d641cca321e8470a64e84dd8b7a97e4a...536ce446898f3b788d7f0134de8397db55161b07,3,69,11,80,8,2013-02-19 22:14:31,2013-02-12 07:43:22
536ce446898f3b788d7f0134de8397db55161b07...3b16657e77511d92b55d1d2157485d8dd0df0c00,1,7,7,14,8,2013-02-19 22:14:31,2013-02-12 07:51:53
3b16657e77511d92b55d1d2157485d8dd0df0c00...921c3c2097f170c881c2f3f264b89f792c204075,2,40,26,66,2,2013-02-19 22:14:31,2013-02-11 21:24:27
921c3c2097f170c881c2f3f264b89f792c204075...cc38528acf976c6f10da45b1d824f86444067fb1,1,15,6,21,1,2013-02-19 22:14:32,2013-02-11 21:37:24
cc38528acf976c6f10da45b1d824f86444067fb1...419607e8ebcab4b2235ec132623467fcf6fe74ee,2,17,6,23,2,2013-02-19 22:14:32,2013-02-11 21:41:16
419607e8ebcab4b2235ec132623467fcf6fe74ee...55aa2571a0f0fe1748960fcbf557737d922a05f3,4,91,200,291,4,2013-02-19 22:14:32,2013-02-12 07:53:27
55aa2571a0f0fe1748960fcbf557737d922a05f3...048f7fd37ceb2fcdc33b06d36b6e998bd1085952,2,3,5,8,4,2013-02-19 22:14:32,2013-02-11 22:09:41
048f7fd37ceb2fcdc33b06d36b6e998bd1085952...56b22956ad3c76a747b359452fec987eab4fac5e,2,0,48,48,2,2013-02-19 22:14:33,2013-02-11 22:12:35
56b22956ad3c76a747b359452fec987eab4fac5e...3f67a48dd461e1454b81cde33f5c005de5910fa3,2,57,104,161,2,2013-02-19 22:14:33,2013-02-12 06:01:50
3f67a48dd461e1454b81cde33f5c005de5910fa3...e87ed91faceb1c8418973f3c3a06edfc063f46cf,3,48,33,81,12,2013-02-19 22:14:33,2013-02-11 21:32:39
e87ed91faceb1c8418973f3c3a06edfc063f46cf...4e1bcdcab9f1d1eda72724b80d99cf6a564a3d52,7,46,61,107,10,2013-02-19 22:14:33,2013-02-12 02:22:43
4e1bcdcab9f1d1eda72724b80d99cf6a564a3d52...44be55fc4e490975eb3292dca12cfac1eec234bd,2,25,19,44,2,2013-02-19 22:14:34,2013-02-12 06:42:19
44be55fc4e490975eb3292dca12cfac1eec234bd...f7a4ccb409c14fed9c52956765c95b10bacb779a,1,16,17,33,4,2013-02-19 22:14:34,2013-02-12 06:50:30
f7a4ccb409c14fed9c52956765c95b10bacb779a...7e5cd08061dc17f38dec307ae8fc43e44b85a777,2,21,17,38,2,2013-02-19 22:14:34,2013-02-12 06:54:27
7e5cd08061dc17f38dec307ae8fc43e44b85a777...3761be3d99fc63858a5cf6f23f2374922d41be4b,2,40,5,45,2,2013-02-19 22:14:34,2013-02-12 07:00:18
3761be3d99fc63858a5cf6f23f2374922d41be4b...fef35fc4f1da9e06790d5b3b34b3bcdb085dd3a2,1,0,15,15,1,2013-02-19 22:14:35,2013-02-12 07:03:42
fef35fc4f1da9e06790d5b3b34b3bcdb085dd3a2...2a2942bd7f39f687e61188fc593ab9d23ceff1c8,2,16,6,22,2,2013-02-19 22:14:35,2013-02-12 07:07:37
2a2942bd7f39f687e61188fc593ab9d23ceff1c8...844b33205c77fe32d2aae76209eb444044b9aeff,1,5,2,7,2,2013-02-19 22:14:35,2013-02-12 07:10:12
844b33205c77fe32d2aae76209eb444044b9aeff...6d116be7cf26abf3a4940e9e75ec329248de96d8,2,48,72,120,2,2013-02-19 22:14:35,2013-02-12 07:55:36
6d116be7cf26abf3a4940e9e75ec329248de96d8...1fc6f993402f9b0f5b291c104e6edf379d75ba21,1,87,0,87,1,2013-02-19 22:14:36,2013-02-12 05:05:43
1fc6f993402f9b0f5b291c104e6edf379d75ba21...2a64edb025b5b62315748faecd76f8382755fc34,1,78,0,78,1,2013-02-19 22:14:36,2013-02-13 18:42:23
2a64edb025b5b62315748faecd76f8382755fc34...8a3f52170e1d5b0539f979894dc76a48d6d54a46,1,0,109,109,1,2013-02-19 22:14:36,2013-02-12 05:33:22
8a3f52170e1d5b0539f979894dc76a48d6d54a46...8c719f7c71ed415d7c5e2952782d1352d14a9389,1,1,2,3,2,2013-02-19 22:14:37,2013-02-12 05:33:37
8c719f7c71ed415d7c5e2952782d1352d14a9389...bafc51c0f9bbd178e347ff2ea9d110e2f1a4202e,2,63,86,149,2,2013-02-19 22:14:37,2013-02-11 22:38:00
bafc51c0f9bbd178e347ff2ea9d110e2f1a4202e...0a406869df990d030d2383abc7f1388aead57d0c,2,74,63,137,2,2013-02-19 22:14:37,2013-02-12 02:27:02
0a406869df990d030d2383abc7f1388aead57d0c...7d517458278bd364935e58abcae0944ea0766157,1,0,31,31,1,2013-02-19 22:14:37,2013-02-12 07:04:29
7d517458278bd364935e58abcae0944ea0766157...0e59efd079d6369cecd78719379cad2c3254e90d,1,27,1,28,2,2013-02-19 22:14:38,2013-02-12 07:22:12
0e59efd079d6369cecd78719379cad2c3254e90d...7658f4c29c162819f72219bacf73aa840c1e59e4,1,10,1,11,1,2013-02-19 22:14:38,2013-02-12 08:13:18
7658f4c29c162819f72219bacf73aa840c1e59e4...087c43796178733da54bff9e8291a5a312c466f1,1,26,4,30,7,2013-02-19 22:14:38,2013-02-13 18:47:29
087c43796178733da54bff9e8291a5a312c466f1...035aa6b4cefc0b1d5bab8ffdcb5c63593ef8d190,1,1,1,2,1,2013-02-19 22:14:39,2013-02-13 18:48:55
035aa6b4cefc0b1d5bab8ffdcb5c63593ef8d190...e850cbab1c83c9457f653c6241da5c74d2d0ab0e,28,5488,0,5488,28,2013-02-20 01:16:18,2013-02-13 20:19:08
e850cbab1c83c9457f653c6241da5c74d2d0ab0e...ef08f0fbb19ba1e45721b759f37efd6574c400a3,4,26,25,51,16,2013-02-20 01:16:29,2013-02-13 20:20:36
ef08f0fbb19ba1e45721b759f37efd6574c400a3...06fbcca6bb14093ca3bed6bd558d900ad8cead62,1,0,88,88,1,2013-02-20 01:16:55,2013-02-13 22:16:11
06fbcca6bb14093ca3bed6bd558d900ad8cead62...1eb6a92984d8de8cddc69d7628d1fca23d3f0277,1,4,2,6,2,2013-02-20 01:16:55,2013-02-13 22:18:27
1eb6a92984d8de8cddc69d7628d1fca23d3f0277...2ed56e52354d871622e6b9ca5bf44fa7409b511b,10,0,0,0,0,2013-02-20 01:16:55,2013-02-19 22:59:43
2ed56e52354d871622e6b9ca5bf44fa7409b511b...4b80f217cd91a5b29089d94398059b85b1ef8a93,11,11,11,22,11,2013-02-20 01:16:55,2013-02-19 23:03:41
4b80f217cd91a5b29089d94398059b85b1ef8a93...bd4d585b7a9d9ecab5e8c85c797220f87b64a46e,2,106,0,106,2,2013-02-20 01:16:55,2013-02-20 00:57:59
d30e76e0e834293981dba3b1ef838be24ab4d33a...6738e685921efd82b2ce73280d26e9fda4ab85c2,1,97,0,97,1,2012-12-21 20:37:39,2012-12-21 20:37:39
6738e685921efd82b2ce73280d26e9fda4ab85c2...54740c8b247c9ce50a4400142004fd05ec098e21,1,7,7,14,1,2012-12-26 23:26:53,2012-12-26 23:26:53
54740c8b247c9ce50a4400142004fd05ec098e21...c2e71dd51d8db42ab19cd9e5243af9a121ba0247,3,20,2,22,6,2012-12-27 04:15:17,2012-12-21 01:56:47
c2e71dd51d8db42ab19cd9e5243af9a121ba0247...a7cc53067d6113decc6755971358de2cb71e9cda,6,212,91,303,28,2012-12-29 16:34:41,2012-12-29 16:34:41
a7cc53067d6113decc6755971358de2cb71e9cda...44ceb5d8f5df92a49c0d25ff3438228d7003712c,1,82,0,82,1,2012-12-30 01:26:32,2012-12-30 01:26:32
44ceb5d8f5df92a49c0d25ff3438228d7003712c...acc085e13183d7d3760cca818a6496b8b625bf36,1,145,0,145,1,2012-12-31 00:50:48,2012-12-30 23:36:47
acc085e13183d7d3760cca818a6496b8b625bf36...50e88d0b66adda159739c6f1a875c255924e108d,1,5,5,10,5,2012-12-31 17:09:36,2012-12-20 22:29:45
f1780a6be63d85023053bc0cbec04106e4e8fe04...f317f5aee91a2c21d68a9b94b0742d6b45bc44e8,237,16422,1215,17637,720,2013-02-20 12:48:20,2013-02-20 11:54:22
f317f5aee91a2c21d68a9b94b0742d6b45bc44e8...eb29c4b2e6a294c66375bef19c2aaa9be8655f4a,2,4,4,8,2,2013-02-20 12:49:03,2012-09-21 16:07:08
eb29c4b2e6a294c66375bef19c2aaa9be8655f4a...da945a7376d0e7cfe76fd9839cffff548e902a7e,1,1,1,2,1,2013-02-20 13:00:29,2012-09-12 23:03:50
da945a7376d0e7cfe76fd9839cffff548e902a7e...0dcbecd32bf298b091d20d1bdf47aa132dc49f64,1,1,0,1,1,2013-02-20 13:01:47,2012-08-15 00:10:02
0dcbecd32bf298b091d20d1bdf47aa132dc49f64...57ef65916ba382fa29040d03d1cff1dc7bf7ddd8,1,1,1,2,1,2013-02-20 13:15:11,2013-02-20 13:14:58
57ef65916ba382fa29040d03d1cff1dc7bf7ddd8...053e02ef8e49a0a56dbae5b3e08ad9f09ae977b6,1,1,1,2,1,2013-02-20 17:17:29,2013-02-20 17:17:29
053e02ef8e49a0a56dbae5b3e08ad9f09ae977b6...d69a26b9650df7dc1f210c3c59df74ec4245dff3,1,27,26,53,12,2013-02-20 19:34:34,2013-02-19 07:52:34
d69a26b9650df7dc1f210c3c59df74ec4245dff3...6ad792610b9e3a0c96206fc1f6968b0eb69956c1,42,701,394,1095,195,2013-02-20 20:29:52,2013-02-20 20:12:18
6ad792610b9e3a0c96206fc1f6968b0eb69956c1...9d10bf58a3cd5a61a501e29efd174b4c8fe2b474,1,2,9,11,2,2013-02-20 21:17:36,2013-02-20 21:06:41
9d10bf58a3cd5a61a501e29efd174b4c8fe2b474...bbcb8b3ae09cafd8dfb0e3e5dcac0df6df418f6c,2,13,5,18,4,2013-02-20 22:04:30,2013-02-18 18:46:50
bbcb8b3ae09cafd8dfb0e3e5dcac0df6df418f6c...7301ba396915a54e1db9a2673a467639ff6cd0b1,1,5,0,5,1,2013-02-21 18:31:01,2013-02-21 09:40:09
7301ba396915a54e1db9a2673a467639ff6cd0b1...ebc95f0716331978bd3ebc90ba8c3e8254e1b104,2,83,3,86,5,2013-02-21 19:29:18,2013-02-21 09:28:51
ebc95f0716331978bd3ebc90ba8c3e8254e1b104...055110dab04678fe3716d9d292218830ee496d60,2,14,3,17,4,2013-02-21 19:50:47,2013-02-21 16:44:22
055110dab04678fe3716d9d292218830ee496d60...4b61522f16db0de94acbd34492532f9955d52ebd,3,80,0,80,3,2013-02-21 21:14:07,2013-02-21 19:02:33
4b61522f16db0de94acbd34492532f9955d52ebd...50c88e0ff24890cadf2f1730a0eb93ebd0a63c28,1,9,1,10,2,2013-02-21 21:14:07,2013-02-21 20:54:13
50c88e0ff24890cadf2f1730a0eb93ebd0a63c28...089ec586135726e82dc0d25c2e328478d577db24,2,14,6,20,8,2013-02-21 23:18:44,2013-02-21 20:22:12
089ec586135726e82dc0d25c2e328478d577db24...3b2e9d26480da0c73a3735314bee5910cb3844ab,19,76,192,268,54,2013-02-21 23:23:18,2013-02-21 18:51:15
3b2e9d26480da0c73a3735314bee5910cb3844ab...a63c28e6eb9659103f58cacfd201576ba4fb8ae5,2,110,11,121,5,2013-02-21 23:23:18,2013-02-21 22:30:36
a63c28e6eb9659103f58cacfd201576ba4fb8ae5...27d1babaae38aaa683121ff3ea2c70d04e611f13,4,62,2,64,8,2013-02-22 19:24:05,2013-02-22 19:24:05
27d1babaae38aaa683121ff3ea2c70d04e611f13...74c08403d89366d184089bee9a2ccd4e46cd05c4,1,1,1,2,1,2013-02-23 00:30:27,2013-02-23 00:30:27
74c08403d89366d184089bee9a2ccd4e46cd05c4...de9ee2a483012c0dc3fb48930c1e96baaa466b65,19,338,172,510,53,2013-02-24 03:03:49,2013-02-24 03:03:49
de9ee2a483012c0dc3fb48930c1e96baaa466b65...8df893c62e50ac727af25bb0dc5ffd78fed28a3f,1,1,1,2,1,2013-02-24 03:07:42,2013-02-24 03:06:14
8df893c62e50ac727af25bb0dc5ffd78fed28a3f...4231dab39f8d3769196fefede15e048f3ca09300,2,8,1,9,2,2013-02-25 14:21:52,2013-02-23 22:43:52
4231dab39f8d3769196fefede15e048f3ca09300...e03bc472f0b4a50ede3a0e0be7de9e5d12bb85a9,3,16,3,19,3,2013-02-25 15:38:10,2013-02-23 00:45:22
e03bc472f0b4a50ede3a0e0be7de9e5d12bb85a9...34046084c0665c8bb2dfd84683dcf29d7ffbad2d,4,29,74,103,12,2013-02-25 15:38:10,2013-02-23 00:47:27
34046084c0665c8bb2dfd84683dcf29d7ffbad2d...b15a10e7a014674ef6f71c51ad84032fb7b802e2,349,11406,24688,36094,4129,2013-02-25 22:45:02,2013-02-25 21:45:23
b15a10e7a014674ef6f71c51ad84032fb7b802e2...03fe7fb55cd5dad49ffc9ae5d4067ff46bf06c95,3,23,17,40,6,2013-02-25 22:45:02,2013-02-25 22:00:08
03fe7fb55cd5dad49ffc9ae5d4067ff46bf06c95...51f6e6a9b39c15fcfd34976005fc8496430545e1,27,382,396,778,355,2013-02-25 22:45:02,2013-02-25 22:25:21
51f6e6a9b39c15fcfd34976005fc8496430545e1...f80f3c5f62a3955636c1af1872ef9539a0b01cb0,4,303,259,562,73,2013-02-26 00:30:44,2013-02-26 00:21:23
f80f3c5f62a3955636c1af1872ef9539a0b01cb0...88befa6021d136257939a2caba14e69ad9c43dd5,2,3,4,7,3,2013-02-26 01:47:28,2013-02-25 16:30:05
88befa6021d136257939a2caba14e69ad9c43dd5...3d913fec83e7290fd0f694027f7f9904ffd09970,4,259,303,562,73,2013-02-26 07:57:12,2013-02-26 07:57:12
3d913fec83e7290fd0f694027f7f9904ffd09970...aa985392777dbe6159ce4ca56ae79d1039e43ec7,2,2,1,3,2,2013-02-26 08:17:21,2013-02-26 08:16:35
aa985392777dbe6159ce4ca56ae79d1039e43ec7...d4a297ccb054019aa582bab2a0746f762c930159,1,1,1,2,1,2013-02-26 14:18:40,2013-02-26 14:17:26
d4a297ccb054019aa582bab2a0746f762c930159...8fe72a7f27adb5d89165c0f4c72b6f358d0602ef,1,8,4,12,5,2013-02-26 14:33:13,2013-02-26 06:51:00
8fe72a7f27adb5d89165c0f4c72b6f358d0602ef...17c6fe2e22efada157b9d1e6cf8acbb7ab43b08f,1,3,3,6,3,2013-02-26 16:03:07,2013-02-26 14:28:53
17c6fe2e22efada157b9d1e6cf8acbb7ab43b08f...17a812618d6135c77c060e0f6ec396fb48eec6f0,1,1,1,2,1,2013-02-26 16:07:46,2013-02-26 06:19:16
17a812618d6135c77c060e0f6ec396fb48eec6f0...c80bde1781a99db34d3457620bc77aca7a37cc75,1,2,0,2,1,2013-02-26 17:27:30,2013-01-15 22:42:23
c80bde1781a99db34d3457620bc77aca7a37cc75...cfacde3ac6094281d77b19d846bfe3c57c28582f,1,1,1,2,1,2013-02-26 17:44:02,2012-12-18 09:48:51
cfacde3ac6094281d77b19d846bfe3c57c28582f...e505f91266c80d9846dd4cf2967e6f063772f24f,1,2,1,3,2,2013-02-26 18:42:08,2013-02-26 18:38:15
e505f91266c80d9846dd4cf2967e6f063772f24f...7bc449c06329716770d4bbf59b252c66ba17a9d1,20,526,205,731,97,2013-02-26 19:30:12,2013-02-26 19:30:12
7bc449c06329716770d4bbf59b252c66ba17a9d1...30e5366b2962c8a9b73ea89757523367d87c2aea,1,5,2,7,2,2013-02-27 00:46:26,2013-02-27 00:36:56
30e5366b2962c8a9b73ea89757523367d87c2aea...57f9f048d3081da3bea2223842ba90b7b618ee38,1,23,8,31,10,2013-02-27 00:48:44,2013-02-26 01:46:48
57f9f048d3081da3bea2223842ba90b7b618ee38...ec378aaa690dee25b34a696bd893f646ab4616d1,3,39,221,260,38,2013-02-27 00:49:17,2013-02-27 00:42:47
ec378aaa690dee25b34a696bd893f646ab4616d1...937662b03e55b639792d7b635f80fb82db5a6044,1,4,1,5,2,2013-02-27 01:33:30,2013-02-27 01:33:30
937662b03e55b639792d7b635f80fb82db5a6044...1b870b612777a549238e171a6cb20ba7dc9086ce,1,0,0,0,0,2013-02-27 01:39:04,2013-02-27 01:39:04
1b870b612777a549238e171a6cb20ba7dc9086ce...586e160a258336663bdf7f063aae9602fe9e1dc9,1,2,1,3,1,2013-02-27 01:54:18,2013-02-27 01:54:18
586e160a258336663bdf7f063aae9602fe9e1dc9...86433979c6f33f78035011b3a4aa29c26b1e9c67,2,31,0,31,3,2013-02-27 02:54:05,2013-02-25 06:14:30
86433979c6f33f78035011b3a4aa29c26b1e9c67...f054fec5354830123b9ff8d47d9f73dd85083bc3,20,20,26,46,20,2013-02-27 06:56:54,2013-02-27 06:52:58
f054fec5354830123b9ff8d47d9f73dd85083bc3...c6e2db2f14d98c6421401dea70f57333898ce782,1,10,0,10,1,2013-02-27 22:31:40,2013-02-27 22:31:38
c6e2db2f14d98c6421401dea70f57333898ce782...95862b23802175b5d6b509d6a6f83fa5fd53b474,2,13,13,26,12,2013-02-27 22:47:01,2013-02-27 19:23:20
95862b23802175b5d6b509d6a6f83fa5fd53b474...875e4a0c59efb0657389a353363fbd2f924cc9cf,8,43,22,65,20,2013-02-28 00:29:36,2013-02-27 19:24:02
875e4a0c59efb0657389a353363fbd2f924cc9cf...0c1e7b53d0a33e112107f5387fbde9b2d688fb52,3,25,14,39,7,2013-02-28 00:37:10,2013-02-27 19:46:35
50e88d0b66adda159739c6f1a875c255924e108d...872cb0d7fabdb23ad3378d28103228bc58218235,1,4,5,9,3,2013-01-04 22:06:40,2013-01-04 18:07:40
872cb0d7fabdb23ad3378d28103228bc58218235...ad6769fc92ed21c9d4a62719ed9d46538dc5a73b,2,35,0,35,2,2013-01-08 03:32:40,2013-01-08 03:27:34
ad6769fc92ed21c9d4a62719ed9d46538dc5a73b...7a2ae4c930224e9c8e9090b6aa3437833f415452,1,2,0,2,1,2013-01-09 08:16:04,2013-01-04 12:37:38
7a2ae4c930224e9c8e9090b6aa3437833f415452...aa742ddf80f104bc4f13321668a4ede0c518cd4a,222,665,300,965,283,2013-01-09 23:21:30,2013-01-09 23:21:30
aa742ddf80f104bc4f13321668a4ede0c518cd4a...ed825f488867d7586bee6ca4feb5fe5b0461775e,2,23,6,29,8,2013-01-09 23:55:27,2013-01-09 23:39:44
cb87920ba9c2871630ff37af6f0131fb1968dc95...1762ba37ca810d44933ae850fd4fd00fd16be732,1,1,0,1,1,2013-02-28 17:21:47,2013-02-28 17:18:12
1762ba37ca810d44933ae850fd4fd00fd16be732...12d0f0bd3a6c8491837b710b01816f40f32fb56b,11,54,54,108,49,2013-02-28 22:11:47,2013-02-28 16:50:14
ed825f488867d7586bee6ca4feb5fe5b0461775e...c50c33e9397d7a0a8717e8ce7530572907c054ad,4,24,2,26,4,2013-01-10 00:55:12,2013-01-10 00:04:21
d019bec72d12adae00e6a95600a858caf6bd33ce...c53b921648dd72bb59c547d340ded5fb0be1b775,1,5,0,5,1,2013-02-28 23:48:19,2013-02-28 23:44:55
c53b921648dd72bb59c547d340ded5fb0be1b775...bb431531a37411803abc152c1489e7430672783a,8,41,37,78,22,2013-03-01 01:04:29,2013-03-01 01:04:29
bb431531a37411803abc152c1489e7430672783a...c11612026fa28f7aedc60c577120f87d86fc15bf,3,8,14,22,3,2013-03-01 01:09:36,2013-02-28 22:25:29
c11612026fa28f7aedc60c577120f87d86fc15bf...7764b84297432ffb3535a9fe26ec386b315d499d,1,84,82,166,13,2013-03-01 01:38:17,2013-02-28 00:56:30
7764b84297432ffb3535a9fe26ec386b315d499d...4b67f0be6d682845661662f43602b4c0245b02a0,1,11,3,14,3,2013-03-01 01:38:17,2013-02-28 03:32:19
4b67f0be6d682845661662f43602b4c0245b02a0...88644eaa2db3e9b603efca00e640ff08d9320c1b,20,105,126,231,83,2013-03-01 01:38:17,2013-02-28 23:32:32
88644eaa2db3e9b603efca00e640ff08d9320c1b...4926ffd14be0c4c53f63915d5ebf0ada3190b0ae,1,210,16,226,14,2013-03-01 01:38:17,2013-02-28 23:42:55
4926ffd14be0c4c53f63915d5ebf0ada3190b0ae...f0f87d8afb9ce7bb58ea79eceb8b89574dc45bfb,1,6,0,6,1,2013-03-01 01:44:31,2013-03-01 00:56:37
f0f87d8afb9ce7bb58ea79eceb8b89574dc45bfb...55aa973bee095d5bd01922cad0bd05305fb5fbad,3,12,11,23,12,2013-03-01 16:55:05,2013-03-01 16:54:49
55aa973bee095d5bd01922cad0bd05305fb5fbad...0928a526dd5e15a4792ad8186fc85a9164ff6493,5,142,59,201,35,2013-03-01 17:48:57,2013-03-01 17:10:26
0928a526dd5e15a4792ad8186fc85a9164ff6493...687522c5a5149a463bb417da6e35100587315de3,1,2,1,3,1,2013-03-01 18:58:17,2013-03-01 18:21:21
c4b080f82d0ea0a97354e38994693ad983f04255...daf46669636545d2e8fa865fe1a1172c76eec9cb,1,2,2,4,2,2013-01-10 01:07:33,2013-01-10 01:07:33
daf46669636545d2e8fa865fe1a1172c76eec9cb...1388171d96de037cd897d19e5c40b87685052446,1,67,0,67,1,2013-01-10 01:08:24,2013-01-10 01:08:24
1388171d96de037cd897d19e5c40b87685052446...6d9ee4b1843868850d950c037bbf696f72170c0c,1,12,0,12,1,2013-01-10 01:21:16,2013-01-10 01:21:16
6d9ee4b1843868850d950c037bbf696f72170c0c...be54423782f511a9756e2412ad509d74ce809647,1,6,5,11,2,2013-01-10 03:05:37,2013-01-10 03:05:37
be54423782f511a9756e2412ad509d74ce809647...8e37a589a62eaea16e729a1514ed4a28a4a04788,2,2,2,4,2,2013-01-10 15:47:09,2013-01-10 15:47:09
8e37a589a62eaea16e729a1514ed4a28a4a04788...4fa3fd1cc0eb5a63d8b3644af5b4dc2d6cc0cc86,1,1,1,2,1,2013-01-11 01:05:14,2013-01-11 00:59:09
687522c5a5149a463bb417da6e35100587315de3...83392403b7a9b7782b37c17688938c75010f81ba,3,46,7,53,9,2013-03-01 18:59:24,2013-03-01 17:58:35
4fa3fd1cc0eb5a63d8b3644af5b4dc2d6cc0cc86...4c9de9d7169a4f0365ec1c754cdbb3f7d22fef45,1,87,0,87,1,2013-01-11 19:24:37,2013-01-11 19:24:37
4c9de9d7169a4f0365ec1c754cdbb3f7d22fef45...f3e78bd3c21028dfd96efed7ae2654ceff1e7878,2,69,1,70,2,2013-01-14 16:28:32,2013-01-14 15:35:03
f3e78bd3c21028dfd96efed7ae2654ceff1e7878...45024e7b7551eca7796e16fe453b2cbaee94b916,1,2,3,5,3,2013-01-14 17:31:34,2013-01-14 17:09:35
45024e7b7551eca7796e16fe453b2cbaee94b916...a6b8f63660c3f5ee50b2625f7a86f03fbe45ec12,1,8,2,10,4,2013-01-14 21:20:03,2013-01-05 21:14:50
a6b8f63660c3f5ee50b2625f7a86f03fbe45ec12...6b4a93577b5677f9738f6dd7d7acd71f86f46888,1,6,1,7,1,2013-01-15 08:34:07,2013-01-14 22:24:30
6b4a93577b5677f9738f6dd7d7acd71f86f46888...498200b87c186658c867772bd6cf0c8afcb2b56b,3,59,1,60,4,2013-01-17 00:22:11,2013-01-17 00:10:15
498200b87c186658c867772bd6cf0c8afcb2b56b...08ac9fe016e333a344469aa7e8a1fb483ae27c58,1,77,0,77,1,2013-01-17 12:37:23,2012-02-09 05:22:50
08ac9fe016e333a344469aa7e8a1fb483ae27c58...30e237041d5cd7c39e33a9382c96f109be23337d,1,3,2,5,3,2013-01-17 15:32:00,2013-01-17 15:32:00
30e237041d5cd7c39e33a9382c96f109be23337d...e70d1bfe647b2426afe769a26c8febbbfe0aff96,1,2,3,5,3,2013-01-17 23:47:47,2013-01-17 23:47:47
e70d1bfe647b2426afe769a26c8febbbfe0aff96...31583be04218c49d91440a58969dbfc4f5f7b472,2,36,12,48,8,2013-01-17 23:48:05,2013-01-14 23:29:46
31583be04218c49d91440a58969dbfc4f5f7b472...7295bb9435c10fe569d36e64d50769fed4b5d7e3,2,3,1,4,3,2013-01-18 11:13:32,2013-01-18 00:40:48
7295bb9435c10fe569d36e64d50769fed4b5d7e3...1c35ee8695aee8537ac929d9eed386b23ac65354,1,81,0,81,1,2013-01-18 19:48:21,2013-01-18 19:48:21
1c35ee8695aee8537ac929d9eed386b23ac65354...4d32fc59642bc22b9bb8bf5d4df8ebb07698ddc3,125,560,300,860,201,2013-01-18 20:12:07,2013-01-18 20:12:07
300802d5134069723f173ccf2067fb100cab2448...4cda016c264d08abc1db4a8ae187a21a6dbb0b33,1,2,2,4,2,2013-03-01 19:19:38,2013-03-01 19:19:38
4cda016c264d08abc1db4a8ae187a21a6dbb0b33...33aafbd88224b7e047df7368196d0321f626436f,1,1,1,2,1,2013-03-01 19:23:55,2013-03-01 19:23:55
33aafbd88224b7e047df7368196d0321f626436f...6366a3057ccb2fc42aba2c23d26e496eb836dee0,1,13,6,19,3,2013-03-01 21:30:25,2013-03-01 20:03:44
6366a3057ccb2fc42aba2c23d26e496eb836dee0...16ddc545bd8004868122520f0cc7560cc63750e8,1,1,0,1,1,2013-03-01 22:21:34,2013-03-01 20:10:36
16ddc545bd8004868122520f0cc7560cc63750e8...13c8bc8917a152487110b734680af631dfdae59c,1,2,1,3,1,2013-03-01 22:23:51,2013-03-01 22:15:28
13c8bc8917a152487110b734680af631dfdae59c...fc2298602323530bda9efa75f61dfb0e6433b401,1,7,0,7,1,2013-03-01 22:26:35,2013-03-01 22:26:35
fc2298602323530bda9efa75f61dfb0e6433b401...4b20f3440d32b0bc5678eef812b5f5733968819b,1,0,1,1,1,2013-03-02 00:33:48,2013-03-01 20:09:36
4b20f3440d32b0bc5678eef812b5f5733968819b...7707acd6efd40b15f9ee1190d75176d9d3639c0e,1,22,9,31,10,2013-03-02 00:49:19,2013-03-02 00:49:19
7707acd6efd40b15f9ee1190d75176d9d3639c0e...75305f3babd9e927e92b0d9b70d8bb026492ebd0,7,32,14,46,17,2013-03-02 01:36:47,2013-02-14 08:48:11
75305f3babd9e927e92b0d9b70d8bb026492ebd0...8ca43a7f4036c9f02ee00d6d29eb8bd804a52c5e,1,2,0,2,1,2013-03-02 01:36:47,2013-02-20 22:52:46
8ca43a7f4036c9f02ee00d6d29eb8bd804a52c5e...dd171d24df4fd6361e7db11dc7b6fd15e68934ab,1,7,6,13,6,2013-03-02 01:36:47,2013-02-20 23:04:58
dd171d24df4fd6361e7db11dc7b6fd15e68934ab...8ab346c98fd05b6e01ed01bd07dac71a2e7090f5,1,21,16,37,9,2013-03-02 01:36:47,2013-02-20 23:19:05
8ab346c98fd05b6e01ed01bd07dac71a2e7090f5...aba03ebb5a76dd1452a3dce991f0165252976f9c,1,7,4,11,2,2013-03-02 01:36:47,2013-02-20 23:33:24
aba03ebb5a76dd1452a3dce991f0165252976f9c...b3ea8443bdaf100bf178bcbbbd4810bfcf3a921e,1,28,23,51,10,2013-03-02 01:36:47,2013-02-21 07:54:38
b3ea8443bdaf100bf178bcbbbd4810bfcf3a921e...4f7f8bbdf891f1ba59c620b45c257b61dc65807a,4,20,18,38,18,2013-03-02 01:36:47,2013-02-26 17:47:36
4f7f8bbdf891f1ba59c620b45c257b61dc65807a...1ccc6fbe05653053bce015e24dd9aaa78b4ecc5b,1,13,16,29,11,2013-03-02 01:36:48,2013-02-26 18:20:44
1ccc6fbe05653053bce015e24dd9aaa78b4ecc5b...e1ac2ef7cffac256d794472f02c1160a075379fb,1,30,46,76,13,2013-03-02 01:36:48,2013-02-26 19:20:19
e1ac2ef7cffac256d794472f02c1160a075379fb...d1b4dcd6acb1d1c66e423f7992dc6eec8a35c544,1,7,7,14,5,2013-03-02 01:36:48,2013-02-27 08:15:28
d1b4dcd6acb1d1c66e423f7992dc6eec8a35c544...93156a60570fe4932bbc13a97b4c7ef0a791b7f4,1,7,0,7,1,2013-03-02 01:43:02,2013-03-02 01:43:01
93156a60570fe4932bbc13a97b4c7ef0a791b7f4...47e115063b24e83fe72acb36f76667ba2216cdd5,1,1,0,1,1,2013-03-02 19:06:45,2013-03-02 18:08:08
47e115063b24e83fe72acb36f76667ba2216cdd5...2106ef000c7d891385d5480a61d95327caf8e277,4,179,4,183,7,2013-03-02 19:26:39,2013-03-02 18:20:33
2106ef000c7d891385d5480a61d95327caf8e277...4ac73d2c99a4987c62465c7aa7b0bdd13d2c085e,1,1,1,2,1,2013-03-02 19:50:33,2013-03-02 19:50:33
4d32fc59642bc22b9bb8bf5d4df8ebb07698ddc3...2c4eef0d972838c51999d32c0d251857a713dc18,3,19,2,21,3,2013-01-18 20:15:41,2013-01-18 20:15:41
2d51036fb9655d5b775e7f9e5ab362cd91460ca3...d345c1173ac9c7ba861039707a142e187651f71d,2,4,0,4,2,2013-03-02 23:01:20,2013-03-02 19:58:21
d345c1173ac9c7ba861039707a142e187651f71d...63edde0e01e577691002c2f2e39fb30abccec1bc,2,13,3,16,3,2013-03-02 23:11:23,2013-03-02 23:11:23
63edde0e01e577691002c2f2e39fb30abccec1bc...5222d19a11ed0e29d207da0e8c9c8e0e3b18ad78,2,35,12,47,7,2013-03-03 00:09:16,2013-03-02 20:25:16
5222d19a11ed0e29d207da0e8c9c8e0e3b18ad78...f5d84965d784710c4a9a698b6966447ca26e80c6,1,1,1,2,1,2013-03-03 00:10:21,2013-03-03 00:10:21
f5d84965d784710c4a9a698b6966447ca26e80c6...80ea63b95810e60fcdeaf3db67fec60c27b49832,2,12,35,47,7,2013-03-03 01:21:28,2013-03-03 01:21:28
80ea63b95810e60fcdeaf3db67fec60c27b49832...22aa76742166967a8ed23426dbf78c182d1378e4,2,65,1,66,2,2013-03-03 23:28:45,2013-01-19 00:25:52
22aa76742166967a8ed23426dbf78c182d1378e4...0c57b31190e54b7b360a56439e34158c9f79d86c,1,12,2,14,2,2013-03-03 23:30:49,2013-03-03 21:11:08
0c57b31190e54b7b360a56439e34158c9f79d86c...384f1be739b747f6589169443ce687b44d434e09,2,34,13,47,8,2013-03-04 01:26:38,2013-03-02 20:25:16
384f1be739b747f6589169443ce687b44d434e09...e428bb7eaea14adc66374b704049c6e2123a9589,6,25,15,40,13,2013-03-04 01:26:38,2013-03-03 23:22:12
e428bb7eaea14adc66374b704049c6e2123a9589...906f824bab8f022e1686c29fbf3141e0c174bae9,1,1,1,2,1,2013-03-04 06:12:09,2013-03-04 02:03:40
906f824bab8f022e1686c29fbf3141e0c174bae9...009ba02e18a9ac8539c357be902573b1a014a13a,2,6,1,7,2,2013-03-04 15:20:40,2013-03-03 04:53:51
009ba02e18a9ac8539c357be902573b1a014a13a...119cbf48542ec2d04b20f78789654a53d94b5f2d,3,34,11,45,9,2013-03-04 15:38:32,2013-03-03 00:03:22
119cbf48542ec2d04b20f78789654a53d94b5f2d...890dc2eeb1bdf4a861cd3493245359238d033a12,1,2,2,4,1,2013-03-04 18:47:05,2013-03-04 18:47:05
890dc2eeb1bdf4a861cd3493245359238d033a12...04688614f70470dba1f7512844fd2c4008d9d8bd,2,4,15,19,7,2013-03-04 19:57:35,2013-03-04 19:33:03
04688614f70470dba1f7512844fd2c4008d9d8bd...d09ab61dcd4943ec543417df12487a2c8510cc1e,1,8,5,13,3,2013-03-04 19:59:55,2013-03-04 19:59:55
d09ab61dcd4943ec543417df12487a2c8510cc1e...3e64b5677f10abf849c2da762421437b89d1e11e,1,1,1,2,1,2013-03-05 08:47:57,2013-03-05 08:20:23
f05cf3bea738188b30bb36a48d7cd6eaedfe1e02...4598a4c6dd2036eb878c4f90845e0c023ed8199a,1,2,2,4,2,2013-01-18 20:51:34,2013-01-18 20:51:34
4598a4c6dd2036eb878c4f90845e0c023ed8199a...9c2c84546347df599840aceb59605b4b6d38a549,1,67,0,67,1,2013-01-18 20:54:22,2013-01-18 20:54:22
862f7b850d7155073b44afd85f8d6974fb500e4d...f7b06e0bbc21ec865797fe433b3dfcf10dbac819,2,5,3,8,3,2013-03-05 15:10:13,2013-03-05 15:10:13
f7b06e0bbc21ec865797fe433b3dfcf10dbac819...8e2376b376a44574899876be5d3adb06f0f8be0c,1,1,1,2,1,2013-03-05 16:15:54,2013-03-04 21:04:55
8e2376b376a44574899876be5d3adb06f0f8be0c...01fa5ee21d1846a9466c1301a19af28fdce72637,1,1,0,1,1,2013-03-05 18:39:45,2013-03-05 18:36:29
01fa5ee21d1846a9466c1301a19af28fdce72637...c0a5af8d07ccb9f51f6899cf1f41b20cdd5e11d7,1,0,1,1,1,2013-03-05 18:40:02,2013-03-05 18:38:28
c0a5af8d07ccb9f51f6899cf1f41b20cdd5e11d7...dd6432dcf0371d0c03478330ae2c5530e49d8858,1,1,0,1,1,2013-03-05 22:06:36,2013-03-05 20:17:48
dd6432dcf0371d0c03478330ae2c5530e49d8858...e4383c0170832368564bd39ddc5dba6e104eb1b2,1,3,1,4,2,2013-03-05 22:23:01,2013-03-03 23:44:36
e4383c0170832368564bd39ddc5dba6e104eb1b2...049903e333f843d7587e7c40845a7d51ea5955f8,3,163,149,312,34,2013-03-05 22:26:34,2013-03-04 00:12:02
049903e333f843d7587e7c40845a7d51ea5955f8...cd68d86c3283af2f4b3c349c2081c609e3978b9b,8,69,69,138,47,2013-03-05 22:27:15,2013-03-04 03:05:44
cd68d86c3283af2f4b3c349c2081c609e3978b9b...426b4c625802c7b6913fa09237aa9745bf3ae84a,16,100,98,198,61,2013-03-05 22:27:15,2013-03-04 03:14:06
426b4c625802c7b6913fa09237aa9745bf3ae84a...312289b791a5924eec5748fbd19ad6867ff37320,2,11,5,16,4,2013-03-05 22:27:16,2013-03-04 03:43:46
312289b791a5924eec5748fbd19ad6867ff37320...f9ba9f7badf40ad6360526095b7bec8e3319752b,2,7,5,12,5,2013-03-05 22:43:27,2013-03-05 19:05:50
f9ba9f7badf40ad6360526095b7bec8e3319752b...323120b5c943c0ec04c482c4414c23c01a27f4fc,1,2,2,4,2,2013-03-06 07:47:35,2013-02-16 01:25:57
323120b5c943c0ec04c482c4414c23c01a27f4fc...74784b63d627d3988234399de074d3bee5bf23f6,3,9,4,13,3,2013-03-06 10:10:10,2013-03-06 09:07:46
74784b63d627d3988234399de074d3bee5bf23f6...2ad98725d632d76bda1d668dce050409f103cc0d,3,86,0,86,4,2013-03-06 10:31:22,2012-09-18 09:21:38
2ad98725d632d76bda1d668dce050409f103cc0d...3dbbfd78030d07acf9b5d0e9c61113ff315a783a,1,0,7,7,2,2013-03-06 13:45:47,2013-03-06 13:45:47
3dbbfd78030d07acf9b5d0e9c61113ff315a783a...3d20905b7055dec006041c1fda0094bef17c80ee,3,7,5,12,5,2013-03-06 14:25:07,2013-03-06 14:24:20
3d20905b7055dec006041c1fda0094bef17c80ee...958ab661cbede92470ffd47b23607c61f5e61e17,2,29,13,42,12,2013-03-06 14:32:40,2013-03-06 14:32:40
958ab661cbede92470ffd47b23607c61f5e61e17...fb3ec32b0ea5e42f6a9a8f0d5f43779f92cfac4a,4,23,21,44,9,2013-03-06 15:15:18,2013-03-06 15:15:17
fb3ec32b0ea5e42f6a9a8f0d5f43779f92cfac4a...25ba971f41d4ddaf7e241645cfc2917bd3afa1f7,2,63,2,65,5,2013-03-06 18:45:37,2013-03-04 20:44:56
25ba971f41d4ddaf7e241645cfc2917bd3afa1f7...5038f4018534f498734fc39ef1bcd72650a3e7e2,4,17,2,19,6,2013-03-06 19:44:29,2013-03-06 01:46:37
5038f4018534f498734fc39ef1bcd72650a3e7e2...32ac8c0b69d87ff635c3827f1891907dec9ee381,1,9,2,11,1,2013-03-06 19:44:29,2013-03-06 01:47:12
32ac8c0b69d87ff635c3827f1891907dec9ee381...e0cec37d50b2fea9b6d8c79d52241afbf3d83c4e,1,20,16,36,5,2013-03-06 19:44:29,2013-03-06 01:53:37
e0cec37d50b2fea9b6d8c79d52241afbf3d83c4e...8c44869f1dc2cdc7337d5a2a4f64e10494b0fb2f,2,74,0,74,2,2013-03-06 19:44:30,2013-03-06 06:09:27
8c44869f1dc2cdc7337d5a2a4f64e10494b0fb2f...d5a0940fff9091dc6e5c4e3aaed35e07d69b52c8,2,2,7,9,4,2013-03-06 19:44:30,2013-03-06 06:16:46
d5a0940fff9091dc6e5c4e3aaed35e07d69b52c8...b0f6789a78dbb14778769d1d76b195c2fcd8a340,7,10,24,34,14,2013-03-06 19:44:30,2013-03-06 06:57:15
b0f6789a78dbb14778769d1d76b195c2fcd8a340...a978bedee79eee31b583a2bc9bdab27fa6cd95f3,2,70,0,70,3,2013-03-06 19:44:30,2013-03-06 07:37:37
a978bedee79eee31b583a2bc9bdab27fa6cd95f3...9208c890582305218716a2bdadb7461ef24f5830,2,27,5,32,6,2013-03-06 19:44:30,2013-03-06 17:55:00
9208c890582305218716a2bdadb7461ef24f5830...db5d58e84252042236b8de80fe0e1b722a83e61a,1,63,38,101,19,2013-03-06 20:33:05,2013-03-06 20:32:59
db5d58e84252042236b8de80fe0e1b722a83e61a...d258fb0212530329b9941be18bc6e90d7afec5b5,3,183,3,186,10,2013-03-06 20:43:48,2013-03-04 07:29:22
d258fb0212530329b9941be18bc6e90d7afec5b5...81c278d58d8154980d49b9c2713ec37f5017c2d3,37,479,154,633,94,2013-03-06 20:59:58,2013-03-06 20:57:49
81c278d58d8154980d49b9c2713ec37f5017c2d3...51c8b0ede3a6bdcca44626a004c15eac3a55c87a,4,27,18,45,9,2013-03-06 20:59:59,2013-03-06 20:58:37
9c2c84546347df599840aceb59605b4b6d38a549...1c32eb4ae227f09e0e442ecd0445ec34d85332fe,2,51,14,65,3,2013-01-22 12:34:43,2013-01-22 11:58:15
1c32eb4ae227f09e0e442ecd0445ec34d85332fe...d7bf7ed9935587a6681a090e5d12840f9a60f55e,2,23,3,26,4,2013-01-22 12:34:43,2013-01-22 12:23:46
d7bf7ed9935587a6681a090e5d12840f9a60f55e...13d86a86d615b3ca32a0870b2b4921e0e611309d,1,8,0,8,1,2013-01-22 12:53:49,2013-01-22 12:53:49
13d86a86d615b3ca32a0870b2b4921e0e611309d...7f6054ca81f3c7559b5de690a5a6d436d5b386ff,1,74,0,74,1,2013-01-24 18:32:35,2013-01-24 18:32:35
7f6054ca81f3c7559b5de690a5a6d436d5b386ff...34131af6067e6981d737bb8f58218d5d5e1b6484,1,1,1,2,1,2013-01-24 20:42:53,2013-01-23 22:38:09
34131af6067e6981d737bb8f58218d5d5e1b6484...72dd3b4e2521b4913f0a44117e6b69d70786e43d,1,37,6,43,3,2013-01-25 01:23:22,2013-01-25 01:23:11
72dd3b4e2521b4913f0a44117e6b69d70786e43d...65249ccd9bb7edae8bbaafc2e00cd25c9c5d640d,3,14,6,20,3,2013-01-25 18:42:38,2013-01-22 17:09:12
65249ccd9bb7edae8bbaafc2e00cd25c9c5d640d...5abde8161a2ca50ce88a589cf03167a1a5d1962c,1,1,1,2,1,2013-01-26 23:25:35,2013-01-26 23:07:09
5abde8161a2ca50ce88a589cf03167a1a5d1962c...1a87776be94ae8250b7c55e224ede0400996384d,5,130,115,245,51,2013-01-30 19:30:10,2013-01-30 19:30:10
1a87776be94ae8250b7c55e224ede0400996384d...9a488a667ccf17add7948cfbb931de60608e3e7c,1,5,3,8,2,2013-02-02 19:14:42,2013-02-02 19:14:42
9a488a667ccf17add7948cfbb931de60608e3e7c...5fe05464cb4b5bd1cc2e1be1056a75770a5a3553,1,1,2,3,1,2013-02-05 11:50:48,2013-02-05 11:47:23
5fe05464cb4b5bd1cc2e1be1056a75770a5a3553...8d14668992f156d8ec9e5fa31ddd83987db081ea,2,36,3,39,10,2013-02-05 21:25:54,2012-10-30 00:19:01
8d14668992f156d8ec9e5fa31ddd83987db081ea...6b99fd23237d30a269f35690920ed6a4ab75de1a,1,6,0,6,5,2013-02-05 21:26:03,2012-10-30 13:40:50
6b99fd23237d30a269f35690920ed6a4ab75de1a...a86ebbe2885fe6f2b6adeeaa95c8abc12d821d7b,1,0,1,1,1,2013-02-05 21:34:51,2013-02-05 21:34:49
a86ebbe2885fe6f2b6adeeaa95c8abc12d821d7b...5aef65a98a9427bcd6f41d8f65235bd26883d2d7,270,2139,749,2888,507,2013-02-06 16:39:31,2013-02-06 16:39:27
51c8b0ede3a6bdcca44626a004c15eac3a55c87a...0debf5a82934da805592b6496756cdf27c993abc,3,53,2,55,3,2013-03-06 21:06:10,2013-03-06 20:43:35
5aef65a98a9427bcd6f41d8f65235bd26883d2d7...53978bdf420622ff0121c63c0338c9e7c2e60869,3,25,2,27,3,2013-02-06 16:46:14,2013-02-06 16:46:14
b5dffdd69646ad61762dee19c9d7c880e00f6fd4...ff2639f9eac36f48ecc546d2d234d949c575d85b,1,1,1,2,1,2013-03-06 21:59:25,2013-03-06 21:59:25
ff2639f9eac36f48ecc546d2d234d949c575d85b...7df4652d7bec63661df546acdd9c5f118afa411f,1,2,2,4,2,2013-03-06 21:59:58,2013-03-06 21:59:58
8caf6572b6d14919555ee07dc498a14b05f75e81...ccf2712ee55a8285b8e6da2550b169665aace69b,1,2,2,4,2,2013-02-06 17:46:47,2013-02-06 17:46:47
ccf2712ee55a8285b8e6da2550b169665aace69b...13897279ae18445cff77cf17e3337c63cf8ac4fe,1,72,0,72,1,2013-02-06 17:48:20,2013-02-06 17:48:11
f780c6f5989c9c33b1b0f0a885e29b4389a03655...924f603e26b450d83234781e80de95d76fcf251a,1,7,3,10,3,2013-03-07 13:11:46,2013-03-07 13:10:47
924f603e26b450d83234781e80de95d76fcf251a...71694361f97035555a269625f68cfbd06effe58a,1,15,0,15,1,2013-03-07 13:13:42,2013-03-07 13:13:01
71694361f97035555a269625f68cfbd06effe58a...bdf7ac2c5dcdbb59d9a4db7e8eaa66462b1bed26,4,154,13,167,9,2013-03-07 16:51:17,2013-02-27 18:31:24
bdf7ac2c5dcdbb59d9a4db7e8eaa66462b1bed26...f23ec6b3cfdeddabe0d6378c27ec66f868c50db1,2,6,21,27,10,2013-03-07 19:53:18,2013-03-06 23:44:08
f23ec6b3cfdeddabe0d6378c27ec66f868c50db1...e7b8bad3d983e23e9b4981e6cfd05bba16d3e3b5,1,4,4,8,3,2013-03-07 19:56:53,2013-03-07 19:56:53
e7b8bad3d983e23e9b4981e6cfd05bba16d3e3b5...4b47bb4dbc875d1333d5a76cea4adcc880e93120,7,134,97,231,16,2013-03-08 02:17:28,2013-03-08 02:17:28
4b47bb4dbc875d1333d5a76cea4adcc880e93120...90368770e6acc224460376f3086ad47f54d363d3,1,1,1,2,1,2013-03-08 15:35:41,2013-03-08 15:35:35
90368770e6acc224460376f3086ad47f54d363d3...52f7a14aaff9e66a4a8d36d536b717cbac945c5d,1,11,3,14,3,2013-03-08 17:00:34,2013-03-08 00:28:18
52f7a14aaff9e66a4a8d36d536b717cbac945c5d...75147793888b3bda0d8b7b127e5e0b35ab24e76c,1,14,14,28,2,2013-03-08 17:00:34,2013-02-28 14:29:00
75147793888b3bda0d8b7b127e5e0b35ab24e76c...8542c9afba4c6f917c04d943af5c1680fbc4869f,1,0,8,8,2,2013-03-08 17:00:35,2013-03-06 14:39:07
8542c9afba4c6f917c04d943af5c1680fbc4869f...0604d9ab93311212b3f8bc3526c3c711ee7dc165,1,0,13,13,2,2013-03-08 17:00:35,2013-03-06 14:41:12
0604d9ab93311212b3f8bc3526c3c711ee7dc165...4348241bcc61b9956d9c0697b344d6234a2a240f,1,12,12,24,5,2013-03-08 17:00:36,2013-03-07 10:37:07
4348241bcc61b9956d9c0697b344d6234a2a240f...51e3a59946a25d96d69d338222dd0fe29b01f50c,2,33,22,55,10,2013-03-08 17:00:36,2013-03-07 10:55:47
51e3a59946a25d96d69d338222dd0fe29b01f50c...5e832ac7b95f3a89708e9fadc617f0334e4fd049,1,32,10,42,3,2013-03-08 17:00:37,2013-03-07 13:08:38
5e832ac7b95f3a89708e9fadc617f0334e4fd049...2320ffbdff5a361f8ed3f14578b51ae741af897d,1,51,13,64,4,2013-03-08 17:00:37,2013-03-07 13:44:46
2320ffbdff5a361f8ed3f14578b51ae741af897d...fb6253209e0e7d5a09862af1c64ad4596dea0cc6,2,50,46,96,8,2013-03-08 17:00:38,2013-03-07 16:48:43
fb6253209e0e7d5a09862af1c64ad4596dea0cc6...952d6c5e4c572da84405405f29489b55fb49f256,1,24,22,46,3,2013-03-08 17:00:39,2013-03-07 17:01:57
952d6c5e4c572da84405405f29489b55fb49f256...8365a56541d49ae5b0ffcd41053c99a82f90f0b8,1,1,1,2,1,2013-03-08 17:00:39,2013-03-07 17:22:06
8365a56541d49ae5b0ffcd41053c99a82f90f0b8...4147680d591dbc103b9dc8881c45c79067aca1d1,1,1,1,2,1,2013-03-08 17:00:40,2013-03-07 17:22:43
4147680d591dbc103b9dc8881c45c79067aca1d1...fa1efa3675d3d687969b2d2c800f4e656bb9b76d,1,29,29,58,7,2013-03-08 17:00:40,2013-03-07 17:25:06
fa1efa3675d3d687969b2d2c800f4e656bb9b76d...3c22c42519afbd3d42bb4d53835b3235b50893f1,1,0,1,1,1,2013-03-08 17:00:41,2013-03-08 00:44:42
3c22c42519afbd3d42bb4d53835b3235b50893f1...ea30ca95335f53da0909a435eefeb7834d88d641,1,181,0,181,1,2013-03-08 21:47:36,2013-03-08 21:47:36
ea30ca95335f53da0909a435eefeb7834d88d641...9f4c3b0d45f858d3d3021ef4b8edebf6005008ff,2,51,1,52,2,2013-03-08 22:14:58,2013-03-08 11:07:27
9f4c3b0d45f858d3d3021ef4b8edebf6005008ff...632b7d8750a93fbfea2c810ae123be41831dd602,2,1,51,52,2,2013-03-08 22:35:00,2013-03-08 22:35:00
632b7d8750a93fbfea2c810ae123be41831dd602...96a314b68b19277cc71ccac06b6517956b8f8a22,3,57,5,62,6,2013-03-08 22:42:15,2012-12-06 04:13:14
96a314b68b19277cc71ccac06b6517956b8f8a22...e325ace53c83a89c94b24247c810ccdfa46f35df,3,114,2,116,6,2013-03-08 22:42:15,2012-12-06 04:26:35
e325ace53c83a89c94b24247c810ccdfa46f35df...29cd0f2a77faa3b2a746e64e4871cded32e8aa98,2,94,5,99,5,2013-03-08 22:46:58,2013-03-08 19:12:15
29cd0f2a77faa3b2a746e64e4871cded32e8aa98...b3cbb16f41f3a7dfdbe9ad087ef9465b30529b09,3,93,17,110,12,2013-03-09 02:56:31,2013-03-08 15:55:45
b3cbb16f41f3a7dfdbe9ad087ef9465b30529b09...6d593a902685dfaf2c85304faa00a051e4b13f16,1,18,5,23,5,2013-03-09 02:56:31,2013-03-07 20:04:17
6d593a902685dfaf2c85304faa00a051e4b13f16...08f5db112f9e35160bd8b639782ec33f003fb1bd,1,9,11,20,7,2013-03-09 02:56:31,2013-03-07 22:28:32
08f5db112f9e35160bd8b639782ec33f003fb1bd...6076a25e80e1b294a62a0efe341bcc29b2eaa63b,1,1,1,2,1,2013-03-09 02:56:31,2013-03-07 23:14:22
6076a25e80e1b294a62a0efe341bcc29b2eaa63b...99a2059e40a6d83ee4e7b7a20304f012eff4aa3a,1,5,0,5,1,2013-03-09 02:56:31,2013-03-08 00:13:52
99a2059e40a6d83ee4e7b7a20304f012eff4aa3a...9826159bf102aaa5dad6eaea7998ede8460de471,1,2,1,3,1,2013-03-09 02:56:31,2013-03-08 00:29:30
9826159bf102aaa5dad6eaea7998ede8460de471...f5c293b5ed681ec8d058d81bb1e1e3169c9454b7,1,7,6,13,6,2013-03-09 02:56:31,2013-03-08 16:29:36
f5c293b5ed681ec8d058d81bb1e1e3169c9454b7...8cf2d4c2c16481020bc6e670c1f6596b77150634,1,2,8,10,2,2013-03-09 02:56:31,2013-03-08 17:10:57
8cf2d4c2c16481020bc6e670c1f6596b77150634...98c6a81771513622fbc21b01f623447ed38b70c4,1,9,1,10,1,2013-03-09 02:56:32,2013-03-08 17:29:13
98c6a81771513622fbc21b01f623447ed38b70c4...6e34dfd9e80b82180d3fdfaee9623ed06ff562a4,1,11,0,11,1,2013-03-09 02:56:32,2013-03-09 02:31:21
13897279ae18445cff77cf17e3337c63cf8ac4fe...255bc945c2bad35c01b65e3351337e30372907b4,2,69,0,69,2,2013-02-07 13:39:47,2013-02-07 13:39:47
255bc945c2bad35c01b65e3351337e30372907b4...e4d97b1dca5a01f120fb11b10f8cf04841d97d94,1,78,0,78,1,2013-02-07 18:34:45,2013-02-07 18:34:45
e4d97b1dca5a01f120fb11b10f8cf04841d97d94...2810b1ab00ffdaa1b7ed187e15fa8d7f036630db,1,2,2,4,2,2013-02-07 18:35:35,2013-02-07 18:35:35
2810b1ab00ffdaa1b7ed187e15fa8d7f036630db...c4f418d035ff0e75099fcee66a6605260ca12a00,1,0,0,0,0,2013-02-08 00:33:33,2013-02-08 00:33:29
c4f418d035ff0e75099fcee66a6605260ca12a00...6dcadb9fc8618d45e696169135141dde4a9780b0,1,133,0,133,1,2013-02-12 20:03:52,2013-02-12 20:03:52
6dcadb9fc8618d45e696169135141dde4a9780b0...82ad5fbe9aa862f0500b63ea2d739991ede74f48,1,1,0,1,1,2013-02-13 00:30:25,2013-02-13 00:30:25
82ad5fbe9aa862f0500b63ea2d739991ede74f48...2e1ebbf2c54585e67ec71d73b8a7f94214077368,1,1,1,2,1,2013-02-13 15:40:27,2013-02-12 20:04:23
2e1ebbf2c54585e67ec71d73b8a7f94214077368...aec6e9393126d1a3d40af6a639e93314db921b2f,1,4,4,8,1,2013-02-14 11:42:57,2013-02-14 11:42:54
aec6e9393126d1a3d40af6a639e93314db921b2f...3e2be6f39f70b444294a094cd47441b0107b2c35,1,2,0,2,1,2013-02-14 18:42:14,2013-02-14 18:41:33
3e2be6f39f70b444294a094cd47441b0107b2c35...c9dcf5718cf47322b00f2994797aebb68d7ed0fb,2,151,1,152,6,2013-02-15 00:03:40,2013-02-14 16:57:32
c9dcf5718cf47322b00f2994797aebb68d7ed0fb...987338fe31b39b7f57a8f5645593425722ba40af,2,108,1,109,2,2013-02-15 00:03:40,2013-02-14 23:37:12
061a7ddbff06b5ae313f9a8357993b9b44b522f2...77a776da90155a14569dde77dbda99a5456d479d,1,10,6,16,7,2013-03-09 04:09:21,2013-03-08 08:26:53
77a776da90155a14569dde77dbda99a5456d479d...7c9ff8e94a0d6e6b12501f3b4988e0bb7c60f8df,1,1,1,2,1,2013-03-09 04:26:26,2013-03-09 04:26:26
987338fe31b39b7f57a8f5645593425722ba40af...73be4608d9d7679a1b0233f64c7b60c329ccd235,131,663,186,849,200,2013-02-15 18:49:30,2013-02-15 18:49:16
73be4608d9d7679a1b0233f64c7b60c329ccd235...e10c75579b536581ddd7ae4e2c3bf8a9d550d343,3,14,2,16,3,2013-02-15 18:50:11,2013-02-15 17:57:32
7c9ff8e94a0d6e6b12501f3b4988e0bb7c60f8df...43c1830e0a9c046d0209421ca732187e1cc3d938,1,2,2,4,1,2013-03-09 05:52:36,2013-03-09 05:52:36
43c1830e0a9c046d0209421ca732187e1cc3d938...da8b0eefde10d24b22dc87c32d5fc76be41874f0,3,15,3,18,9,2013-03-12 20:15:03,2013-01-30 02:44:29
da8b0eefde10d24b22dc87c32d5fc76be41874f0...66280de133a56964641a08291b06fc0e5ca2b4e1,3,24,1,25,4,2013-03-12 20:18:16,2013-01-30 03:06:32
66280de133a56964641a08291b06fc0e5ca2b4e1...a15cc93ae35045062cb1ec968232250829df97f3,2,1331,1193,2524,414,2013-03-12 20:23:29,2013-03-11 21:59:46
a15cc93ae35045062cb1ec968232250829df97f3...83d17e509f11793b5ba5bb09fe573e8357ac5c81,3,180,513,693,68,2013-03-12 20:23:29,2013-03-12 10:09:27
83d17e509f11793b5ba5bb09fe573e8357ac5c81...78459182271874b0fab0cb2e2b68046571dba937,2,357,416,773,154,2013-03-12 20:23:29,2013-03-12 10:18:24
78459182271874b0fab0cb2e2b68046571dba937...68487a73f27b10af5225f72e269c17b3ebae2003,1,18,18,36,18,2013-03-12 20:23:29,2013-03-12 19:15:21
68487a73f27b10af5225f72e269c17b3ebae2003...3288bc953230ba94e2e8bb61c903bbcf60dd810c,1,1,1,2,1,2013-03-12 22:59:10,2013-03-12 22:58:27
3288bc953230ba94e2e8bb61c903bbcf60dd810c...26dae9a22a75e814a30f3f8093ea8ac627cdef16,2,47,0,47,2,2013-03-13 13:24:58,2013-03-13 12:53:27
7c9ff8e94a0d6e6b12501f3b4988e0bb7c60f8df...4d1e9e537029806cf873f21e41e92830c757e5cf,1,2,2,4,1,2013-03-09 05:52:09,2013-03-09 05:52:09
4d1e9e537029806cf873f21e41e92830c757e5cf...80472bc301234d9dc4142e62bbffc4300fffdd83,2,41,5,46,5,2013-03-09 15:00:21,2013-03-09 15:00:21
80472bc301234d9dc4142e62bbffc4300fffdd83...7becf156a92180c9b6455f60b143e18729592dfb,2,65,1,66,2,2013-03-09 16:19:57,2013-02-26 17:26:09
7becf156a92180c9b6455f60b143e18729592dfb...5757ce48b41eaa0bfff89b3b9bc6f8f4ebbfeb53,2,63,1,64,2,2013-03-09 16:46:44,2013-03-08 11:07:27
5757ce48b41eaa0bfff89b3b9bc6f8f4ebbfeb53...31b5d41f57cb717c14a29d789f1c0c1bb40a8bca,1,8,5,13,5,2013-03-09 17:11:22,2013-03-09 17:11:22
31b5d41f57cb717c14a29d789f1c0c1bb40a8bca...12713c3bb781c854f347ea9a04e344e980bea2f1,2,9,9,18,6,2013-03-09 17:22:00,2013-03-09 17:22:00
12713c3bb781c854f347ea9a04e344e980bea2f1...21a99664aedb12e06de6d5f6e5c76ad4811e6587,2,3,2,5,2,2013-03-10 02:34:59,2013-03-10 02:34:59
21a99664aedb12e06de6d5f6e5c76ad4811e6587...e2400f88d85f67fb241a30f8f527f60f464bc04c,2,58,1,59,4,2013-03-10 09:34:41,2013-03-10 02:46:39
e2400f88d85f67fb241a30f8f527f60f464bc04c...c9a4ec9c6392fefa7ce6c66168f4c535ea0702e1,3,86,50,136,5,2013-03-10 11:14:43,2013-03-10 11:10:19
c9a4ec9c6392fefa7ce6c66168f4c535ea0702e1...738347b90433a38538ab298bf38860e83a4abc53,2,43,0,43,2,2013-03-10 16:53:24,2013-03-08 18:41:28
738347b90433a38538ab298bf38860e83a4abc53...cd2b9f542c34ce59d2df7820a6237f7911c702f3,2,22,5,27,9,2013-03-10 18:04:48,2013-03-09 18:56:17
cd2b9f542c34ce59d2df7820a6237f7911c702f3...327b6e3e1de88ba1db83142d53b3a57f0d06d519,15,131,22,153,20,2013-03-10 18:08:22,2013-03-10 02:05:39
48521f12202b1bb2accbe9c1ac7596f406543cdb...01bff7e7a7b54df6b66ed81a50dabad0de856708,1,2,2,4,2,2013-02-15 19:24:08,2013-02-15 19:24:08
01bff7e7a7b54df6b66ed81a50dabad0de856708...3f38069acfae88be96a5ea8911081b3fde67ad71,1,62,0,62,1,2013-02-15 19:24:20,2013-02-15 19:24:20
59178286224917034a340a8fb1a93c252ae3d742...5e140b33e58bd0ac6779fb0cb635dd51e1a27289,3,31,39,70,8,2013-03-13 22:51:32,2013-03-13 22:36:52
5e140b33e58bd0ac6779fb0cb635dd51e1a27289...5eacdd4bf94edc8328f42e3591ba4dd79d347571,3,97,0,97,3,2013-03-14 20:49:14,2013-03-14 20:49:14
5eacdd4bf94edc8328f42e3591ba4dd79d347571...c0721bcd66829356950b58cc532d6e3d8bbfc641,4,99,6,105,11,2013-03-14 23:03:44,2013-03-14 21:16:13
c0721bcd66829356950b58cc532d6e3d8bbfc641...94284e7d2e558cc3f1a985460fb0cc6606133766,3,164,17,181,10,2013-03-16 02:18:30,2013-03-16 02:18:30
94284e7d2e558cc3f1a985460fb0cc6606133766...14a8fb8bbe906b20ee393b67c1425773e0e0f7db,2,75,0,75,2,2013-03-17 16:17:29,2013-03-15 18:49:31
14a8fb8bbe906b20ee393b67c1425773e0e0f7db...a05f973f82d2be8527aad4c371d40d3c7e4c564e,4,13,4,17,6,2013-03-19 16:38:11,2013-03-18 17:48:13
a05f973f82d2be8527aad4c371d40d3c7e4c564e...83261e789eb903da39f279cb5a161611482e7df5,543,73782,45824,119606,15829,2013-03-20 00:11:01,2013-03-18 20:49:34
83261e789eb903da39f279cb5a161611482e7df5...06bec0e08737ee6c3e165ec6dd16b54ffe1b4c91,1,0,9,9,1,2013-03-20 00:11:01,2013-03-18 20:50:55
06bec0e08737ee6c3e165ec6dd16b54ffe1b4c91...0bba59028381c146b90411d43425a18415d85f98,29,139,118,257,107,2013-03-20 00:11:01,2013-03-18 20:54:00
0bba59028381c146b90411d43425a18415d85f98...8bffa333d252d5761437b1d6ac572dd8950ec8da,1,13,4,17,2,2013-03-20 00:11:01,2012-09-18 22:35:29
8bffa333d252d5761437b1d6ac572dd8950ec8da...831af97df211f046803970f8d281b2001e6ed20a,2,1,2,3,2,2013-03-20 00:11:01,2013-03-19 09:06:13
831af97df211f046803970f8d281b2001e6ed20a...3cb5bf1c0d86d851f33822d9c1c2945d30bcf7f2,1,386,316,702,53,2013-03-20 00:11:02,2013-01-07 18:53:50
3cb5bf1c0d86d851f33822d9c1c2945d30bcf7f2...3375bd8db7d70b032f6d15c223684f196a017b5b,2,121,204,325,45,2013-03-20 00:11:02,2012-12-27 03:16:23
3375bd8db7d70b032f6d15c223684f196a017b5b...425163e0d6aa16db2c287ac37e946baae04e6e25,1,296,296,592,60,2013-03-20 00:11:02,2013-01-07 20:20:21
425163e0d6aa16db2c287ac37e946baae04e6e25...d9036a5d35d2c202e80efb9005c7776f1882d10c,1,46,46,92,5,2013-03-20 00:11:02,2013-01-07 20:31:44
d9036a5d35d2c202e80efb9005c7776f1882d10c...88217ec276be56d531912773045a262da4eb240c,1,20,7,27,5,2013-03-20 00:11:02,2013-01-20 14:31:30
88217ec276be56d531912773045a262da4eb240c...da4d79ac47c1ad5923b26fd78c385deeb82d9370,1,41,21,62,31,2013-03-20 00:11:02,2013-03-19 10:28:17
da4d79ac47c1ad5923b26fd78c385deeb82d9370...f65e14ed1daa20a6d2aae08556b2a059f5d90599,26,782,764,1546,731,2013-03-20 00:11:02,2013-03-19 21:55:05
f65e14ed1daa20a6d2aae08556b2a059f5d90599...dc29d64983f16fae79a9e293dbd3106bf69171db,1,6,6,12,6,2013-03-20 00:53:34,2013-03-20 00:53:14
dc29d64983f16fae79a9e293dbd3106bf69171db...ad819bcc4bf7fde1c12c91e4f4e2da7ea20e0aaa,1,1,1,2,1,2013-03-20 00:56:29,2013-03-20 00:56:29
ad819bcc4bf7fde1c12c91e4f4e2da7ea20e0aaa...40b1c9a66d2d32673dec4ac5ec03f927dd33b32b,1,1,0,1,1,2013-03-20 08:26:28,2013-03-20 08:25:46
40b1c9a66d2d32673dec4ac5ec03f927dd33b32b...f150d569159537f478b78c8132e055a4d3fbb44e,3,10,7,17,3,2013-03-21 17:15:28,2013-03-21 16:26:23
327b6e3e1de88ba1db83142d53b3a57f0d06d519...163ca274230fce536afe76c64676c332693ad7c1,3,35,2,37,3,2013-03-11 00:36:28,2013-03-09 17:24:56
3f38069acfae88be96a5ea8911081b3fde67ad71...326746458602d0bd313bc90e209e6818f7320905,1,84,0,84,1,2013-02-19 22:01:23,2013-02-19 22:01:23
326746458602d0bd313bc90e209e6818f7320905...9d45b945f7903ea7db8427fe8b9cf08fd8d42ef5,1,27,1,28,3,2013-02-20 17:50:55,2012-12-19 04:10:17
9d45b945f7903ea7db8427fe8b9cf08fd8d42ef5...ef945219090de0c04884528f4113435499cc8ec3,1,18,3,21,4,2013-02-21 23:08:26,2013-02-21 22:58:55
ef945219090de0c04884528f4113435499cc8ec3...22d3eff8f46d336337aa5d9625f6d5be9104bcff,1,3,1,4,1,2013-02-22 00:19:40,2013-02-22 00:19:39
22d3eff8f46d336337aa5d9625f6d5be9104bcff...f9a0140ef140d89fed1a194c410cd69ed9990305,2,19,15,34,5,2013-02-22 18:35:07,2013-02-22 18:35:07
f9a0140ef140d89fed1a194c410cd69ed9990305...b0e7dbf2c0bab37018e64d14d176d0236c11cd87,1,2,1,3,1,2013-02-25 17:06:46,2013-02-25 17:06:44
2f88272ba298f20f5756415d2a69e6f6617fcbbe...f7ebb4d8b6d1ef68b1176b3f2ced87dd481316bf,1,0,4,4,1,2013-03-21 17:54:17,2013-03-21 17:50:25
f7ebb4d8b6d1ef68b1176b3f2ced87dd481316bf...9430ca686504b6f178be512bf307f3e2a9eba6f0,1,0,20,20,4,2013-03-23 17:05:37,2013-03-21 21:56:02
9430ca686504b6f178be512bf307f3e2a9eba6f0...648a0726d01b1c0d075560bc9036252635c8f12f,8,182,101,283,39,2013-03-23 18:17:12,2013-03-23 18:17:12
648a0726d01b1c0d075560bc9036252635c8f12f...51f128d64b250dfeb128aab5117b5bbcd2cc51b5,4,17,15,32,11,2013-03-23 18:32:14,2013-03-22 20:51:11
dcfb6d828641575023feb20ab5735576bf1a5a00...e2b293c360a73178462cb8d50b31c03f9d1fc411,1,2,2,4,2,2013-03-11 15:49:33,2013-03-11 15:49:33
e2b293c360a73178462cb8d50b31c03f9d1fc411...228ad9357c0ad6cd817e620b406f479c1824f3db,1,487,0,487,1,2013-03-11 17:19:19,2013-03-11 15:56:47
228ad9357c0ad6cd817e620b406f479c1824f3db...da10bb85ff0098836c53ce96e521a9d3d3422e86,1,8,0,8,1,2013-03-11 23:07:18,2013-03-11 23:03:56
da10bb85ff0098836c53ce96e521a9d3d3422e86...598b5e4593bf39c71416183c36372d97e97852f5,1,1,1,2,1,2013-03-13 02:00:48,2013-03-13 02:00:48
598b5e4593bf39c71416183c36372d97e97852f5...7a07b31a2f678a319fc7cbb0ee4ee023fa812b14,1,1,1,2,1,2013-03-13 17:15:30,2013-03-13 17:15:30
7a07b31a2f678a319fc7cbb0ee4ee023fa812b14...53f2381455a0f8635168cd2b5728e2495086f2b7,1,1,1,2,1,2013-03-13 17:16:26,2013-03-13 17:16:26
53f2381455a0f8635168cd2b5728e2495086f2b7...8135ac1b7f6c44f20fc59c09a35e8ed181a1337e,2,47,0,47,2,2013-03-13 17:27:23,2013-03-13 12:53:27
8135ac1b7f6c44f20fc59c09a35e8ed181a1337e...9af0085f700294b3535fe9d324e3cdf71b071d03,1,3,1,4,1,2013-03-13 17:42:04,2013-03-13 17:27:09
9af0085f700294b3535fe9d324e3cdf71b071d03...110cacd1ed7350cd718b0d5aa0ce8c320c040bb1,2,6,6,12,2,2013-03-13 18:26:36,2013-03-13 18:22:33
110cacd1ed7350cd718b0d5aa0ce8c320c040bb1...615d809ac684a7d2cc7ee5e1aa58f0a921b529a0,2,5,0,5,2,2013-03-13 22:20:13,2013-03-12 14:56:30
615d809ac684a7d2cc7ee5e1aa58f0a921b529a0...7b7235a232439c4bb2038ed5fbbe63e3bffd8202,1,11,0,11,2,2013-03-13 22:27:16,2013-03-13 22:22:55
7b7235a232439c4bb2038ed5fbbe63e3bffd8202...fa05e8a2706e20a191942fe2b2273481605a1f14,1,5,20,25,1,2013-03-13 22:34:18,2013-03-13 21:52:33
fa05e8a2706e20a191942fe2b2273481605a1f14...6bd8b7e5405e1cdc9f56214f5f6b741806c32e5f,2,34,11,45,7,2013-03-13 22:34:18,2013-03-13 21:59:42
6bd8b7e5405e1cdc9f56214f5f6b741806c32e5f...6399839c398056756c0d668557339b99a54500e8,2,0,5,5,2,2013-03-13 22:48:56,2013-03-13 22:48:56
b0e7dbf2c0bab37018e64d14d176d0236c11cd87...ff540e19a4d5437477d25586fe1dd01d66f8f69a,2,8,7,15,4,2013-02-25 21:07:25,2013-02-25 21:07:08
ff540e19a4d5437477d25586fe1dd01d66f8f69a...530d8c05d4c546146f18e5ba811d7eb3b7b7c0c5,3,14,2,16,3,2013-02-25 21:07:25,2013-02-25 18:58:10
1a65154d7296b7936518dc084cd757960d3d5882...d20576165ae0e954743bed45b0c2ca33dff4b20c,6,185,0,185,10,2013-03-26 00:37:49,2013-03-18 14:10:41
d20576165ae0e954743bed45b0c2ca33dff4b20c...ccda6bb3ac99ee46508860385128f47a3d5547e5,4,0,52,52,17,2013-03-26 16:53:34,2013-03-25 18:55:44
ccda6bb3ac99ee46508860385128f47a3d5547e5...2eb847849fc133e39d64798bee01252d9f3c4b58,1,1,1,2,1,2013-03-26 17:17:47,2013-03-26 17:17:47
2eb847849fc133e39d64798bee01252d9f3c4b58...8548920969d351cfb5e4d90956f95ceee724be74,1,2,1,3,2,2013-03-26 22:23:00,2013-03-26 22:19:50
8548920969d351cfb5e4d90956f95ceee724be74...1f5570471896b6723b723342d55ad50013ce3b82,2,29,1,30,2,2013-03-28 12:50:52,2013-03-18 00:44:43
1f5570471896b6723b723342d55ad50013ce3b82...120e5a24df76deb5019abec9744ace94f0f3746a,1,13,6,19,3,2013-03-28 15:44:51,2013-03-19 06:58:44
6399839c398056756c0d668557339b99a54500e8...028c630ecd920d59fc0e8ad295e0fe0eac8e1ef1,1,13,13,26,13,2013-03-14 11:55:19,2013-03-14 02:17:07
028c630ecd920d59fc0e8ad295e0fe0eac8e1ef1...e99dff461772ea16586448667860edd13b4190e4,7,79,17,96,25,2013-03-14 14:55:26,2013-03-14 12:40:27
e99dff461772ea16586448667860edd13b4190e4...ca5022b8f10c95d834678108adcd12f1c907016e,2,31,20,51,6,2013-03-14 14:55:30,2013-03-14 14:13:58
ca5022b8f10c95d834678108adcd12f1c907016e...d62cf59dc152f8df6954ee7ffe9381fc9b524e32,2,67,0,67,2,2013-03-14 15:04:59,2013-03-14 14:48:18
d62cf59dc152f8df6954ee7ffe9381fc9b524e32...1f53cfdeae5549a0ecacbd8cd89d60d4faf17768,1,33,30,63,33,2013-03-14 20:06:49,2013-03-14 14:57:13
1f53cfdeae5549a0ecacbd8cd89d60d4faf17768...e8f80bf479d79bcd3c8bff7fba70aea483e66449,2,77,4,81,8,2013-03-14 23:13:10,2013-03-14 13:01:14
e8f80bf479d79bcd3c8bff7fba70aea483e66449...3537b57f3e6cdf385f0df44dd2a03f1a1ee06b09,1,0,24,24,8,2013-03-14 23:18:42,2013-03-14 23:18:42
3537b57f3e6cdf385f0df44dd2a03f1a1ee06b09...14947b6c5e12ec65e6df75d4db5bcf47f7b29819,2,97,1,98,4,2013-03-14 23:43:19,2013-03-14 23:43:19
14947b6c5e12ec65e6df75d4db5bcf47f7b29819...4432dc81879eddb39aee6aee19c525f53e2f4250,1,14,8,22,3,2013-03-15 00:31:05,2013-03-14 23:06:59
4432dc81879eddb39aee6aee19c525f53e2f4250...2b5bc8e0d60209679d6b17de97e1f8ef29434aa4,1,0,1,1,1,2013-03-16 22:22:10,2013-03-16 22:18:50
2b5bc8e0d60209679d6b17de97e1f8ef29434aa4...f5a337e09ca971b5d9675aaef4cc3afe66e7196c,4,17,18,35,8,2013-03-16 22:32:42,2013-03-16 22:32:42
f5a337e09ca971b5d9675aaef4cc3afe66e7196c...852444a72072dc7bf62e1e4df49a92d766b01268,1,1,1,2,1,2013-03-16 22:52:39,2013-03-15 16:31:48
852444a72072dc7bf62e1e4df49a92d766b01268...f217b5ed62f3f020e8cf346787e9ad5822d81b91,1,7,7,14,7,2013-03-17 12:45:14,2013-03-12 12:21:43
f217b5ed62f3f020e8cf346787e9ad5822d81b91...a0867e1c9395bc9c8af37c290f032bc8dbd847ce,1,25,15,40,6,2013-03-17 12:45:34,2013-03-17 04:59:47
a0867e1c9395bc9c8af37c290f032bc8dbd847ce...b5ddc0cf9658499e04c10b8e3158b81d2be0d5ac,2,75,0,75,2,2013-03-17 16:19:09,2013-03-15 18:49:31
b5ddc0cf9658499e04c10b8e3158b81d2be0d5ac...808b7ada07dfcf293ec40900240329efa7dc841c,1,5,5,10,2,2013-03-18 13:41:51,2013-03-18 13:40:03
808b7ada07dfcf293ec40900240329efa7dc841c...8019800c56c574aece5e345cde3259c58cd865a6,2,20,7,27,17,2013-03-19 19:07:38,2013-03-19 19:07:38
8019800c56c574aece5e345cde3259c58cd865a6...bf83251eea0060f1c153a5bf46f063692bcc8aea,1,0,4,4,1,2013-03-19 23:16:02,2013-03-19 23:16:02
bf83251eea0060f1c153a5bf46f063692bcc8aea...2f4a62c5e13ed7ebe608fc7c861b0bd600401537,1,2,2,4,2,2013-03-19 23:34:31,2013-03-19 17:58:18
2f4a62c5e13ed7ebe608fc7c861b0bd600401537...25eaacad9a14c27465dc65e15e3a5eb5544031e6,2,99,1,100,2,2013-03-20 00:37:43,2013-03-20 00:37:03
25eaacad9a14c27465dc65e15e3a5eb5544031e6...34e22b8ee742b4529c6982f8631fc07522d8197f,1,14,19,33,5,2013-03-20 13:58:01,2013-03-20 13:35:38
34e22b8ee742b4529c6982f8631fc07522d8197f...3dac421393b3379bc355c2776563da8537348c26,1,61,0,61,1,2013-03-20 16:16:30,2013-03-20 15:53:23
3dac421393b3379bc355c2776563da8537348c26...31314b697874eabe2308bd26b98b72aff3e13ef6,1,6,18,24,7,2013-03-20 19:25:48,2013-03-20 08:58:11
31314b697874eabe2308bd26b98b72aff3e13ef6...008ab12b7facea8ac4a718894044963e3b4ee901,1,4,1,5,3,2013-03-20 23:14:39,2013-03-20 23:14:36
008ab12b7facea8ac4a718894044963e3b4ee901...855caa82aaef5c6e6dd244b5d9df314994cb23eb,1,30,12,42,13,2013-03-20 23:49:08,2013-03-15 08:59:30
855caa82aaef5c6e6dd244b5d9df314994cb23eb...3dd7938c03389371ce1d142a8558a98b450ca2ee,120,358,221,579,162,2013-03-21 00:49:57,2013-03-21 00:49:57
7b92b301fa56a092c6f0f4943d0c5cbc08769417...33e8e694e875b56422045fc60485283a1523a71f,1,2,2,4,2,2013-02-25 21:52:13,2013-02-25 21:52:13
33e8e694e875b56422045fc60485283a1523a71f...f8ae4446ee7593b21882d566724796bcc74bf1b4,1,84,0,84,1,2013-02-25 21:56:46,2013-02-25 21:56:46
f8ae4446ee7593b21882d566724796bcc74bf1b4...fafb67c65bb5d2bd98cb298ae7f5e17d367428ce,1,2,0,2,1,2013-02-25 21:57:02,2013-02-25 21:57:02
fafb67c65bb5d2bd98cb298ae7f5e17d367428ce...82357b87eb112ca21c8abbb1ea41aaebf1f351a3,1,2,0,2,1,2013-02-25 22:17:11,2013-02-25 22:17:11
82357b87eb112ca21c8abbb1ea41aaebf1f351a3...522668b5d93b46d7beb7f4d4c5db2078cf08560b,1,3,1,4,1,2013-02-28 15:30:46,2013-02-28 15:30:45
522668b5d93b46d7beb7f4d4c5db2078cf08560b...d87904286024f5ceb6a2d0d5f17e919c775830a0,1,1,0,1,1,2013-02-28 15:40:13,2013-02-28 15:35:17
97c70a6628d284a95e3b17a02f2d78661c992263...9100dd4b0fa839cc1a939b4dcbd91e0a0ef851d2,1,2,2,4,2,2013-03-28 20:19:08,2013-03-28 20:19:08
3dd7938c03389371ce1d142a8558a98b450ca2ee...e47a3e3ff4436b5d58ec95bb7588f3f185cc4fa8,5,98,16,114,28,2013-03-21 13:59:16,2013-03-21 13:59:16
3dd7938c03389371ce1d142a8558a98b450ca2ee...c274d1643589bf104122674a8c3fd147527a667d,3,34,2,36,3,2013-03-21 01:15:04,2013-03-21 01:15:04
d87904286024f5ceb6a2d0d5f17e919c775830a0...d032ff495483f443a367d194a2699d4cb28f9fd6,1,2,2,4,2,2013-02-28 22:13:05,2013-02-28 19:46:59
9100dd4b0fa839cc1a939b4dcbd91e0a0ef851d2...bce38b3d74e64fcb7d04a2dd551151da6168cdc5,3,40,2,42,3,2013-03-28 20:53:13,2013-03-28 20:53:13
41405f4703aa19c0ad88e8875e6a2b023bc354fd...9d3a09f9a8c98b419ae3e2e47f97e908141cfe7a,1,2,2,4,2,2013-03-21 16:14:31,2013-03-21 16:14:23
9d3a09f9a8c98b419ae3e2e47f97e908141cfe7a...92cc1878812ca458462130a63d6f856854cf8cda,1,82,0,82,1,2013-03-21 16:14:39,2013-03-21 16:14:01
d032ff495483f443a367d194a2699d4cb28f9fd6...50ba0f27d9a14473201c93fab09c2c6cf96c063b,1,0,4,4,2,2013-02-28 23:01:06,2013-02-23 16:59:05
50ba0f27d9a14473201c93fab09c2c6cf96c063b...f26362e9381d88d4c906e3624f90fc76e9087c20,1,1,1,2,1,2013-03-01 12:11:40,2013-03-01 12:01:53
f26362e9381d88d4c906e3624f90fc76e9087c20...be770a3839f3bce6cc35c573390179bba05abcaa,1,88,0,88,1,2013-03-01 19:24:46,2013-03-01 19:22:07
be770a3839f3bce6cc35c573390179bba05abcaa...7189b3ed337484cbfeb7209bde2dae72c5bae743,2,15,9,24,3,2013-03-02 01:13:18,2013-03-02 01:09:14
7189b3ed337484cbfeb7209bde2dae72c5bae743...0b70a14abf9f5931d1d37896dffe59afc04a3d4d,1,1,1,2,1,2013-03-02 18:09:39,2013-02-26 06:19:16
0b70a14abf9f5931d1d37896dffe59afc04a3d4d...426cbedb44e1dfff645b9f275f7b27a389dc86b0,1,3,3,6,1,2013-03-02 22:04:06,2013-03-02 22:04:05
caacc19e4499bcaa718836ee45e2044d33b79faf...46da8c2da6d6c9da4f5fd17e982fc4fb59862f2d,1,2,2,4,2,2013-03-28 21:50:43,2013-03-28 21:50:43
46da8c2da6d6c9da4f5fd17e982fc4fb59862f2d...74ef94907277d8aa29d23cef29aee25161960376,3,118,28,146,17,2013-03-29 13:53:34,2013-03-25 19:15:10
74ef94907277d8aa29d23cef29aee25161960376...87f9ece334953bcf0f2d07811728df72cb572ea3,36,409,415,824,186,2013-03-29 15:10:56,2013-03-29 15:10:56
87f9ece334953bcf0f2d07811728df72cb572ea3...3f091c7293793a04d3391baa0a1a6d5318943717,1,1,1,2,1,2013-03-29 15:13:25,2013-03-29 15:13:06
3f091c7293793a04d3391baa0a1a6d5318943717...2093e7d91a76f035549cf073b0e5c58ed3265ead,2,3,3,6,3,2013-03-29 23:53:56,2013-03-29 15:32:53
2093e7d91a76f035549cf073b0e5c58ed3265ead...fe7440ce19c2ee406b2895766ff191479bea1014,2,26,10,36,6,2013-03-30 00:04:00,2013-03-28 18:36:00
fe7440ce19c2ee406b2895766ff191479bea1014...7634069614ea38e38458e4c3a3c3e17d8bc4137e,2,28,24,52,11,2013-03-30 00:04:00,2013-03-28 20:52:43
7634069614ea38e38458e4c3a3c3e17d8bc4137e...aa5da48594c1634de9f439bcf223acff3fb1fcd8,2,23,19,42,17,2013-03-30 00:30:16,2013-03-28 23:51:52
aa5da48594c1634de9f439bcf223acff3fb1fcd8...9b8dd395536df3dbb21423dba888998f2cd36d2a,1,6,2,8,1,2013-03-30 00:49:21,2013-03-30 00:49:19
9b8dd395536df3dbb21423dba888998f2cd36d2a...840a29fc0fd256a63b3f2f5e7528de5107a608a3,3,25,8,33,5,2013-03-30 20:52:22,2013-03-26 15:14:52
840a29fc0fd256a63b3f2f5e7528de5107a608a3...889fec3cc89392839f6e5ad342a9666d73b4a6f4,3,3,3,6,3,2013-04-01 16:44:02,2013-03-28 23:16:12
889fec3cc89392839f6e5ad342a9666d73b4a6f4...b3a8e0da4abf92d1b3df1eaa53222b8965c512a4,2,26,14,40,10,2013-04-01 16:59:48,2013-03-30 03:46:36
b3a8e0da4abf92d1b3df1eaa53222b8965c512a4...d8852aa9e8bf692f9259993c5f3749aa831e5165,1,3,0,3,1,2013-04-03 23:46:56,2013-04-03 07:35:39
d8852aa9e8bf692f9259993c5f3749aa831e5165...b9655fc75813fe452998cd41162bcac5dbceba25,1,3,1,4,1,2013-04-04 00:00:56,2013-04-03 23:59:36
92cc1878812ca458462130a63d6f856854cf8cda...bfd16de125020551bf6fac42c01bc63d5fab90f5,2,69,0,69,2,2013-03-21 18:09:05,2013-03-21 17:38:30
bfd16de125020551bf6fac42c01bc63d5fab90f5...c3aae9cf95749949194f5288bad7468a995b1162,2,37,0,37,2,2013-03-22 00:49:12,2013-03-17 14:04:01
c3aae9cf95749949194f5288bad7468a995b1162...132c77e9f968f7a9b44de3f491926061c42a06af,1,13,0,13,1,2013-03-23 14:38:17,2013-03-23 14:38:17
132c77e9f968f7a9b44de3f491926061c42a06af...628bd81afb73f6948524bebc2a7a30f6abaae4b1,2,11,3,14,3,2013-03-23 14:50:10,2013-03-23 14:48:56
628bd81afb73f6948524bebc2a7a30f6abaae4b1...14417fdb3fe68d0c0142e16359b75e9be44b1780,5,13,14,27,11,2013-03-23 16:14:28,2013-03-18 13:35:17
14417fdb3fe68d0c0142e16359b75e9be44b1780...1526909083537e1092316ccf306f3b32a4b0bf4a,1,0,20,20,4,2013-03-23 17:04:34,2013-03-21 21:56:02
1526909083537e1092316ccf306f3b32a4b0bf4a...9fae4dc102bc51996f518c0f073f0e81a8a0638e,2,49,1,50,2,2013-03-24 01:46:14,2012-10-26 05:49:22
9fae4dc102bc51996f518c0f073f0e81a8a0638e...329b5388ba5a74aa3c4a7e142ba33510e4282cc1,1,6,5,11,5,2013-03-24 12:28:46,2013-03-24 12:22:01
329b5388ba5a74aa3c4a7e142ba33510e4282cc1...8632af381e7086823db764f815cbee53681d450b,23,722,500,1222,181,2013-03-24 14:03:09,2013-03-24 13:29:17
8632af381e7086823db764f815cbee53681d450b...c0d500102a0a11e9d07ed9f0396aae81011e58da,3,72,1,73,3,2013-03-24 21:23:21,2013-03-22 01:18:55
c0d500102a0a11e9d07ed9f0396aae81011e58da...690a8cce418c919cf99d798f640d317f2487c596,1,7,1,8,1,2013-03-24 21:53:11,2013-03-24 21:53:07
690a8cce418c919cf99d798f640d317f2487c596...05bd6b7bcd5e1e962413afe66564f2b60b0178e6,1,28,0,28,1,2013-03-25 12:16:07,2013-03-21 12:12:41
05bd6b7bcd5e1e962413afe66564f2b60b0178e6...44843a60629ab5951a9c54ac6bf74208d607e3e0,2,37,1,38,4,2013-03-25 12:23:17,2013-03-14 15:59:07
44843a60629ab5951a9c54ac6bf74208d607e3e0...488b74d68bc259c066351dd24adebbdeb53f4d24,1,14,0,14,1,2013-03-25 12:54:32,2013-03-19 08:10:23
488b74d68bc259c066351dd24adebbdeb53f4d24...cfd0dca9ae0c834e91823c59784f697d0559a63b,6,60,23,83,17,2013-03-25 17:42:07,2013-03-18 23:16:55
cfd0dca9ae0c834e91823c59784f697d0559a63b...9352c1988574cbbc8649115007200315d8f79578,2,2,0,2,2,2013-03-25 22:07:30,2013-03-24 23:29:55
9352c1988574cbbc8649115007200315d8f79578...fb6dd0c0b5a9705d691054449e4beb4cf7a73ea1,1,1,1,2,1,2013-03-25 23:21:41,2013-03-25 23:16:44
426cbedb44e1dfff645b9f275f7b27a389dc86b0...a6a1659d85b83c0ca9d7fafcab6d9371bf8ff146,1,1,1,2,1,2013-03-04 06:12:53,2013-03-04 02:03:40
a6a1659d85b83c0ca9d7fafcab6d9371bf8ff146...ecf9f606c9540f12ba539ddfe7b7827e34388fc7,1,5,1,6,1,2013-03-04 19:54:36,2013-03-04 19:54:34
ecf9f606c9540f12ba539ddfe7b7827e34388fc7...532d9929c7e6eba8c35943f45dffc93926e34cb9,3,133,6,139,4,2013-03-05 14:23:55,2012-02-09 05:22:50
2c9a38d059d5c744dd111f3a9bc1f850b0d6a078...1fd95b57bf51b548651ef7868ce2dd8e65e7cf6f,1,1,1,2,1,2013-04-05 18:32:33,2013-04-05 18:32:33
1fd95b57bf51b548651ef7868ce2dd8e65e7cf6f...587e83c6d6fa9bba14f5b629fa2ee905dc6881e8,203,6257,3513,9770,1514,2013-04-08 18:35:27,2013-04-08 18:25:29
587e83c6d6fa9bba14f5b629fa2ee905dc6881e8...7357bcb7275c642391288183c208c8e7a4bf5161,2,16,10,26,4,2013-04-08 18:35:35,2013-04-08 18:34:11
7357bcb7275c642391288183c208c8e7a4bf5161...a2fd657b10c7609e1776004156a8cd3016e2c6c8,1,1,1,2,1,2013-04-09 10:39:17,2013-04-09 10:39:17
a2fd657b10c7609e1776004156a8cd3016e2c6c8...62a214268ae39aea394ce46cb8eb53d0bdb15f99,2,37,29,66,16,2013-04-10 12:55:10,2013-04-06 18:47:53
62a214268ae39aea394ce46cb8eb53d0bdb15f99...798d1772c09c718b6c9d350dd03d0461155c725a,1,1,1,2,1,2013-04-10 12:55:10,2013-04-06 19:26:00
798d1772c09c718b6c9d350dd03d0461155c725a...c9850952c9902cd213a9833efaf7294c3d670b87,1,1,0,1,1,2013-04-10 12:55:11,2013-04-06 19:26:24
c9850952c9902cd213a9833efaf7294c3d670b87...591cfe6b7bd622c00a07a77611ee14d64edcf484,6,7,7,14,7,2013-04-10 21:51:16,2013-04-09 22:19:47
591cfe6b7bd622c00a07a77611ee14d64edcf484...33fae69779b4b73a63927bac4d4258d57676c97b,2,3,3,6,3,2013-04-10 21:51:16,2013-04-09 22:29:03
33fae69779b4b73a63927bac4d4258d57676c97b...deda899d774209def9936827f70c074f1cdf795f,2,4,1,5,2,2013-04-10 21:51:17,2013-04-09 23:36:38
deda899d774209def9936827f70c074f1cdf795f...8428b52e25fca440aa54a017a0b446f21f27c79a,1,10,8,18,3,2013-04-10 21:51:17,2013-04-09 22:31:22
8428b52e25fca440aa54a017a0b446f21f27c79a...f83afd3c74865182bce62843fe23d28b4f876638,1,1,1,2,1,2013-04-10 21:51:17,2013-04-09 23:17:34
fb6dd0c0b5a9705d691054449e4beb4cf7a73ea1...0e08e147c74bd8435fd0faa7e9199cd816f36bc1,1,1,1,2,1,2013-03-26 15:09:51,2013-03-26 15:09:48
0e08e147c74bd8435fd0faa7e9199cd816f36bc1...a80a132b383e9aff2d42bbaebafd4436869eeadb,1,25,2,27,3,2013-03-26 15:34:43,2013-03-26 15:34:42
a80a132b383e9aff2d42bbaebafd4436869eeadb...f0b68892d4e85c078836eb0809c64dde82918aeb,4,97,41,138,17,2013-03-27 04:26:17,2013-03-26 05:32:41
f0b68892d4e85c078836eb0809c64dde82918aeb...28c6e42ee761b1c55cafd188aa49a174963d43df,1,7,1,8,1,2013-03-27 07:41:23,2013-03-26 18:33:14
28c6e42ee761b1c55cafd188aa49a174963d43df...372911ffc75c124a0adea731608b0530c7d14837,1,2,2,4,1,2013-03-27 11:37:54,2013-03-27 10:09:37
372911ffc75c124a0adea731608b0530c7d14837...ae86fa84feca482c752bf8d8541e9e13e256a4ff,2,75,9,84,6,2013-03-27 12:26:24,2013-03-27 08:18:43
ae86fa84feca482c752bf8d8541e9e13e256a4ff...61935bc167cc2de57c6417bd12493775dc9c1b81,2,15,5,20,5,2013-03-27 16:47:16,2013-03-27 16:47:16
61935bc167cc2de57c6417bd12493775dc9c1b81...982877ec856a1ad15108bbf2063e4a46d32742e4,10,154,27,181,27,2013-03-27 23:28:45,2013-03-27 23:28:45
982877ec856a1ad15108bbf2063e4a46d32742e4...024a8b0cb42a4ef4e07f9c1059717c1eba9340da,3,3,3,6,3,2013-03-28 15:50:37,2013-03-28 14:19:10
024a8b0cb42a4ef4e07f9c1059717c1eba9340da...5ae26f3750f6ecc0fb284c5ffe0f680c5d053530,1,153,17,170,7,2013-03-28 16:53:59,2013-03-28 01:41:41
5ae26f3750f6ecc0fb284c5ffe0f680c5d053530...eafa902632b1dac4a61c4583ddd4c1fbfe089d65,2,96,3,99,4,2013-03-28 17:27:18,2013-03-26 21:42:56
eafa902632b1dac4a61c4583ddd4c1fbfe089d65...929e4d9c9a09947c2ec86ee14f6d312b1bda1a16,2,25,1,26,2,2013-03-28 17:27:18,2013-03-27 05:43:53
929e4d9c9a09947c2ec86ee14f6d312b1bda1a16...39058bef0733e6fae3cf160d71935127eab97bdd,1,5,2,7,2,2013-03-28 17:40:15,2012-10-25 04:53:35
39058bef0733e6fae3cf160d71935127eab97bdd...4580be088238853ac84d600a56a05159190c1729,2,12,3,15,2,2013-03-28 17:59:19,2013-03-28 16:55:51
4580be088238853ac84d600a56a05159190c1729...dea0634f60887e6a72a8636b92d7c95e003b8e4f,18,218,83,301,59,2013-03-28 18:35:12,2013-03-28 18:35:12
dea0634f60887e6a72a8636b92d7c95e003b8e4f...1b5ec033eeea36880977d3578badd29a5063ae6a,4,19,2,21,4,2013-03-28 19:05:33,2013-03-28 19:05:33
532d9929c7e6eba8c35943f45dffc93926e34cb9...4d809e297f905daf198b252a5870e8732d4201e6,1,1,0,1,1,2013-03-06 05:15:45,2013-03-05 20:17:48
4d809e297f905daf198b252a5870e8732d4201e6...116d6c44025e6553359221fdb873fc738b02dc16,1,107,0,107,1,2013-03-06 21:57:57,2013-03-06 21:56:56
116d6c44025e6553359221fdb873fc738b02dc16...277a2545d2615420240f9b6f0e866ce1cde66890,1,312,55,367,37,2013-03-06 22:19:16,2013-03-06 22:19:16
277a2545d2615420240f9b6f0e866ce1cde66890...80fb580936d82bb274bd35fe66e7d61cc01b0fd4,229,934,336,1270,295,2013-03-06 23:41:06,2013-03-06 23:41:06
259839fe75dde67472b815d05637750360fd76bf...061151c5f5e56166c7db0384520b0a5f7efe4161,31,369,142,511,116,2013-04-12 15:43:05,2013-04-12 15:43:05
061151c5f5e56166c7db0384520b0a5f7efe4161...17a379ec39a34408477ac6a43751c1b9b2e952a4,2,13,3,16,3,2013-04-12 18:39:28,2013-04-12 18:39:28
17a379ec39a34408477ac6a43751c1b9b2e952a4...881ef7cc5fc897cca2f2f0a512e59111ff5a6cd8,2,4,4,8,2,2013-04-12 23:27:49,2013-04-12 23:27:42
881ef7cc5fc897cca2f2f0a512e59111ff5a6cd8...38149bb048d9833cc3cf9a13cbff5300fbed36ef,2,63,0,63,2,2013-04-12 23:27:50,2013-04-12 13:54:31
38149bb048d9833cc3cf9a13cbff5300fbed36ef...31d0d5af8e30362bb46a177afa4d74c2474c8e46,1,34,17,51,3,2013-04-12 23:27:50,2013-04-12 14:16:18
31d0d5af8e30362bb46a177afa4d74c2474c8e46...62e4f897655aedf22b562a80c9e572c7592fe0ac,3,160,130,290,4,2013-04-16 22:08:28,2013-04-11 21:47:15
62e4f897655aedf22b562a80c9e572c7592fe0ac...5909a9c9bddddaab91693d18a8840d8b300bbc28,3,184,153,337,4,2013-04-16 22:08:28,2013-04-11 22:00:45
5909a9c9bddddaab91693d18a8840d8b300bbc28...bb56489f21da9d668c279edb45d6a90d03517a30,3,213,180,393,7,2013-04-16 22:08:28,2013-04-11 22:15:41
bb56489f21da9d668c279edb45d6a90d03517a30...dc9f97b7b99f27eaf21faf29c7df8c9d823ef863,4,666,614,1280,8,2013-04-16 22:08:28,2013-04-11 22:37:14
dc9f97b7b99f27eaf21faf29c7df8c9d823ef863...6717fdccb4a3ebf55d87ae5df1e24ebebd4081f1,5,475,429,904,9,2013-04-16 22:08:28,2013-04-11 23:00:19
6717fdccb4a3ebf55d87ae5df1e24ebebd4081f1...951e0b69fa3c8b1a5d708e29de9d6f7d1db79827,4,500,461,961,7,2013-04-16 22:08:28,2013-04-11 23:11:12
951e0b69fa3c8b1a5d708e29de9d6f7d1db79827...9f682265d6631a29457abeb53827d01fa77493c8,288,15770,11359,27129,2599,2013-04-17 14:10:37,2013-04-17 14:10:37
9f682265d6631a29457abeb53827d01fa77493c8...c7d7072e603ef73af5e6d5070e830432d5a63c6e,2,16,10,26,4,2013-04-17 14:10:51,2013-04-08 18:34:11
c7d7072e603ef73af5e6d5070e830432d5a63c6e...f044a6f3faa057925813e7ab95a806a6edd0728d,1,2,1,3,1,2013-04-17 14:59:39,2013-04-17 14:59:19
f044a6f3faa057925813e7ab95a806a6edd0728d...39dfe94682063c9b38d18fff36f57b0080fcdacb,1,1,1,2,1,2013-04-17 23:18:16,2013-04-17 22:37:22
1b5ec033eeea36880977d3578badd29a5063ae6a...902d6cb6d768d92c53e21e6a214f65c08167126c,1,1,3,4,1,2013-03-28 19:12:05,2013-03-28 19:12:02
1b5ec033eeea36880977d3578badd29a5063ae6a...1e0de9c426e07a260bbec2d2196c2d2db8eb8886,3,39,2,41,3,2013-03-28 19:07:52,2013-03-28 18:46:21
80fb580936d82bb274bd35fe66e7d61cc01b0fd4...67a4cb4fe8c2346e30ffb83f7178e205cc2dab33,3,14,2,16,3,2013-03-06 23:47:29,2013-03-06 23:47:29
8106dc362488b6a73c2d2d5043af554b5ab1e6da...61d254ebdcd4bd20b6bb81155b864f6fc88751e6,1,2,2,4,2,2013-03-28 20:06:24,2013-03-28 20:06:18
61d254ebdcd4bd20b6bb81155b864f6fc88751e6...708e8589ea76548f61ccbf8c064fd65a34429b1f,1,87,0,87,1,2013-03-28 20:06:24,2013-03-28 20:06:00
d7a5f96fa5cbb6fab684b4266f95ae8d96dbd839...5c3c2ed9453c4a490306b3922be6863baf8ae3f7,1,2,2,4,2,2013-03-07 00:20:00,2013-03-07 00:20:00
5c3c2ed9453c4a490306b3922be6863baf8ae3f7...9c5812574f30ffb3e2580763394407ca10b2d4eb,1,62,0,62,1,2013-03-07 00:22:23,2013-03-07 00:22:23
9c5812574f30ffb3e2580763394407ca10b2d4eb...95871ac1db82edda8d398541ab331584813cbbc6,1,1,0,1,1,2013-03-08 11:38:13,2013-03-02 18:08:08
95871ac1db82edda8d398541ab331584813cbbc6...34461572697b3f16577403008385313a3802c2ff,1,1,0,1,1,2013-03-08 11:43:57,2013-03-05 18:36:29
34461572697b3f16577403008385313a3802c2ff...d5959c5ceae6cc65d5e756d86fafe69b7487b15a,1,0,1,1,1,2013-03-08 11:43:58,2013-03-05 18:38:28
0bccb341c41eb6680a03acf9fee5fb3371de447a...223607c90f80441284482bf4480a74d1fcf5edce,1,7,13,20,5,2013-04-19 12:54:37,2013-04-19 12:54:21
223607c90f80441284482bf4480a74d1fcf5edce...0a4ebc3d2c7434d46234264f3456fa3b2da060d6,8,31,31,62,27,2013-04-19 13:24:01,2013-04-18 23:52:07
708e8589ea76548f61ccbf8c064fd65a34429b1f...f1fa7566810e1ba7248f0aeab1a291378152f6b4,1,2,2,4,1,2013-03-28 21:39:52,2013-03-28 21:39:52
f1fa7566810e1ba7248f0aeab1a291378152f6b4...1d17ced200c6ea3cf634edb62565faad11aa1cb9,1,86,0,86,1,2013-03-28 21:53:29,2013-03-28 21:53:29
1d17ced200c6ea3cf634edb62565faad11aa1cb9...7af075ee30485e6f2d295d3ad32923dd5ecb7536,1,9,9,18,9,2013-03-29 16:39:51,2013-03-29 16:39:51
7af075ee30485e6f2d295d3ad32923dd5ecb7536...085f9d636b260724af2e80d6757e9d0f4bcd9193,2,17,0,17,2,2013-03-30 20:10:30,2013-03-30 20:10:30
085f9d636b260724af2e80d6757e9d0f4bcd9193...55ea7ccf704806fee7b8bc3090206f385817690c,1,1,1,2,1,2013-03-30 20:35:36,2013-03-30 20:35:36
55ea7ccf704806fee7b8bc3090206f385817690c...e5b90a14b816000a00b3e97dcc2f36805b893ab7,1,0,1,1,1,2013-04-01 10:30:34,2013-03-31 10:42:33
e5b90a14b816000a00b3e97dcc2f36805b893ab7...440dcae98744954d1528506f2648aff71aadde25,1,5,3,8,1,2013-04-01 17:09:27,2013-03-30 01:29:50
440dcae98744954d1528506f2648aff71aadde25...164d5b3465571a88da59cdddc03bb869126548eb,1,6,0,6,1,2013-04-01 17:53:49,2013-03-30 01:23:39
164d5b3465571a88da59cdddc03bb869126548eb...db8ce89fe4a8d857c5c35b0d4f5af6044e5330ac,1,27,7,34,13,2013-04-01 22:09:33,2013-03-31 06:16:52
db8ce89fe4a8d857c5c35b0d4f5af6044e5330ac...234fb122bbdf87bb33d8fba41165ecfa92031b71,2,75,2,77,4,2013-04-02 16:34:08,2013-04-02 00:19:05
234fb122bbdf87bb33d8fba41165ecfa92031b71...38106da7cddee38453a0c2393bd19e2d2bd6228b,1,2,4,6,4,2013-04-02 16:44:14,2013-04-02 16:27:19
38106da7cddee38453a0c2393bd19e2d2bd6228b...ec69fcf4256dfe6b8c90e96e71c2dff570fd36c3,2,26,10,36,6,2013-04-03 16:52:56,2013-03-28 18:36:00
ec69fcf4256dfe6b8c90e96e71c2dff570fd36c3...bf22f99f3a17e33b78df5c8f85fab5372c032143,2,28,24,52,11,2013-04-03 16:52:56,2013-03-28 20:52:43
bf22f99f3a17e33b78df5c8f85fab5372c032143...aca31e37f7bccbf229f460b236753072eecfeeab,2,23,19,42,17,2013-04-03 16:52:56,2013-03-28 23:51:52
aca31e37f7bccbf229f460b236753072eecfeeab...75463899c8ef90e5a429cb1dcd578ee2886e71d4,1,6,2,8,1,2013-04-03 16:52:56,2013-03-30 00:49:19
75463899c8ef90e5a429cb1dcd578ee2886e71d4...9f65b1edf7bffe8e99bd6ac2539336128e2f5900,2,26,14,40,10,2013-04-03 16:52:56,2013-03-30 03:46:36
9f65b1edf7bffe8e99bd6ac2539336128e2f5900...4716dc662d8d24d4d454dd4459ff724588e98eb1,1,10,14,24,5,2013-04-03 16:52:56,2013-04-03 16:43:17
4716dc662d8d24d4d454dd4459ff724588e98eb1...5902bc45c5e52df6ec821df54450acb7d7d7da83,1,29,0,29,8,2013-04-03 16:56:48,2013-04-01 20:07:24
5902bc45c5e52df6ec821df54450acb7d7d7da83...b319264d849d4149c757b4978f56dd5ae7662b6c,1,24,12,36,15,2013-04-03 17:01:50,2013-04-03 17:01:50
b319264d849d4149c757b4978f56dd5ae7662b6c...d46ebffb66edea43d17f4a9799ccd9dba21c4000,210,726,213,939,221,2013-04-03 17:17:04,2013-04-03 17:17:04
d46ebffb66edea43d17f4a9799ccd9dba21c4000...88686aa4106499a603365b887e2381b55c61c027,2,55,17,72,2,2013-04-03 17:18:42,2013-04-01 22:46:51
0a4ebc3d2c7434d46234264f3456fa3b2da060d6...42b8682a518e368869e86f01c4ff58978b98f0dd,1,4,1,5,1,2013-04-19 15:32:32,2013-04-19 15:32:24
42b8682a518e368869e86f01c4ff58978b98f0dd...4babd2b46ebf9fbea2c9946af5cfae25a33b2b22,3,34,2,36,3,2013-04-19 15:32:32,2013-04-19 14:39:44
88686aa4106499a603365b887e2381b55c61c027...55d058e624984fa5362203ba6a2bc7e033a4003b,1,5,2,7,4,2013-04-03 18:11:32,2013-04-03 18:11:32
88686aa4106499a603365b887e2381b55c61c027...d4982f6f5e4a9a703127489a553b8d782997ea43,3,29,1,30,3,2013-04-03 17:30:57,2013-04-03 17:30:57
92277808b67a6b64795037da16454b6abbd3e8a8...e4406b76dfc024cf5a4051dc73018fc447b3dc7f,1,2,2,4,2,2013-04-19 16:14:44,2013-04-19 16:14:44
e4406b76dfc024cf5a4051dc73018fc447b3dc7f...90266750617adb1ce1ca4ce43fe48f9b0fa11343,3,52,4,56,8,2013-04-19 17:15:22,2013-04-14 19:44:40
90266750617adb1ce1ca4ce43fe48f9b0fa11343...50624a50ee484b8a53cd4f1155e4e53f19c803be,105,1048,6519,7567,391,2013-04-19 17:50:44,2013-04-19 17:50:44
50624a50ee484b8a53cd4f1155e4e53f19c803be...2efb6cf0cfb4ef6ea87a7c16dfe1b8540fd19ea2,2,16,10,26,4,2013-04-19 17:51:01,2013-04-08 18:34:11
2efb6cf0cfb4ef6ea87a7c16dfe1b8540fd19ea2...cf0fa96db84caf9c1e6e5d0cb6f303cf6a8025c9,3,53,10,63,6,2013-04-19 23:21:37,2012-05-04 15:45:27
cf0fa96db84caf9c1e6e5d0cb6f303cf6a8025c9...c77312405e045037bd856f2b5b05d1de28159b25,1,1,1,2,1,2013-04-19 23:25:11,2013-04-19 23:25:11
c77312405e045037bd856f2b5b05d1de28159b25...41b75ca9263f368db790fbdcc3963bb1a8c5cb7e,1,237,505,742,53,2013-04-20 20:58:16,2013-04-15 12:17:17
41b75ca9263f368db790fbdcc3963bb1a8c5cb7e...025f9133bbdae6ecd8acfc623b42dfbd6d15d6f9,3,89,2,91,3,2013-04-22 17:38:14,2013-04-22 15:52:42
025f9133bbdae6ecd8acfc623b42dfbd6d15d6f9...ddf4d1a32a404ee3789bc17276702bb5536b03f6,2,27,19,46,16,2013-04-23 20:38:44,2013-04-23 18:17:09
ddf4d1a32a404ee3789bc17276702bb5536b03f6...85e4fc4306055656f0acab0052ae6da73bfbeb1f,1,4,0,4,1,2013-04-24 17:54:59,2013-04-24 17:15:36
85e4fc4306055656f0acab0052ae6da73bfbeb1f...5a16d258efa4f1b8a5611b143d5ee37d96f72990,1,0,77,77,1,2013-04-25 20:09:33,2013-04-25 20:00:06
5a16d258efa4f1b8a5611b143d5ee37d96f72990...872e720c9f13e4ecdde3395af608df772cfeee84,1,0,0,0,0,2013-04-25 20:20:33,2013-04-25 20:02:42
872e720c9f13e4ecdde3395af608df772cfeee84...45ed54600931eb6a81543dbb1e9b4bd77a10c4a5,1,10,11,21,11,2013-04-25 20:29:46,2013-04-25 20:01:24
45ed54600931eb6a81543dbb1e9b4bd77a10c4a5...74323a95a0923c08a396023ecbcc59f0c1be493e,4,179,113,292,9,2013-04-26 19:08:01,2013-04-26 19:07:56
74323a95a0923c08a396023ecbcc59f0c1be493e...fd9e01c031ac843955532af4dd87b5caec38ba73,1,1,1,2,1,2013-04-26 19:09:23,2013-04-26 19:09:08
fd9e01c031ac843955532af4dd87b5caec38ba73...5db936d2aecaddb5d539855a150813e36df45b66,6,167,23,190,14,2013-04-27 10:51:22,2013-04-26 06:05:33
5db936d2aecaddb5d539855a150813e36df45b66...21ed8df696833a12d8d12dc4f19b3e99434a50b4,2,99,25,124,16,2013-04-27 11:59:13,2013-04-14 12:15:15
21ed8df696833a12d8d12dc4f19b3e99434a50b4...60ed2c5434d893fccd3702d288c2ba2ab325805a,4,333,72,405,19,2013-04-27 17:03:40,2013-04-09 08:56:56
60ed2c5434d893fccd3702d288c2ba2ab325805a...df8a4f8f07cf274c6c9fae50e175879d6a1dc139,1,9,3,12,1,2013-04-27 17:03:40,2013-04-08 12:40:21
df8a4f8f07cf274c6c9fae50e175879d6a1dc139...0c7293664197e58771861ab8c1f212cf5dbcadd7,2,4,2,6,2,2013-04-27 17:03:40,2013-04-08 12:40:31
0c7293664197e58771861ab8c1f212cf5dbcadd7...f2d5cea73a53c59ce6314ecdf27bbf341e0465a2,1,42,0,42,1,2013-04-27 17:03:40,2013-04-08 22:04:38
f2d5cea73a53c59ce6314ecdf27bbf341e0465a2...9cfc92979b6296e431769f5569c5a979bf217e73,1,5,6,11,4,2013-04-28 06:41:16,2013-04-28 06:41:16
d1c9c93ef02953bb2baa260164d3e5a205953212...734a19060c0f6995c4a64383765e3411a25f865c,1,2,2,4,2,2013-04-03 18:28:04,2013-04-03 18:26:54
734a19060c0f6995c4a64383765e3411a25f865c...0f460b03f3143e17cb783186df13a3ad769cfb06,1,77,0,77,1,2013-04-03 18:28:09,2013-04-03 18:27:04
0f460b03f3143e17cb783186df13a3ad769cfb06...58f93ffc4a23aa7240808288acf8cf9f3022abea,4,412,5,417,8,2013-04-05 00:12:13,2013-04-03 12:58:10
af1ed99ce2d209e33a7c2aaedaff041fb1b5e8ad...d3ddee61c2f83e2a3b7ebabfbefee060801d27f5,2,6,0,6,2,2013-04-29 12:12:25,2013-04-29 12:12:24
d3ddee61c2f83e2a3b7ebabfbefee060801d27f5...179784e31e72fcdd0a2b1a596f7aebb43dc87913,512,42009,21212,63221,7849,2013-04-29 12:17:50,2013-04-29 12:15:07
179784e31e72fcdd0a2b1a596f7aebb43dc87913...5ddf7f4200894a7304d7c07bbbd8773fac3509d1,2,11,3,14,3,2013-04-29 12:40:00,2013-04-29 12:09:26
5ddf7f4200894a7304d7c07bbbd8773fac3509d1...2f75785c015fecc33565fe5ee3a483b0d4e5cc6d,225,8583,3787,12370,1736,2013-04-29 20:35:21,2013-04-29 20:35:21
2f75785c015fecc33565fe5ee3a483b0d4e5cc6d...4c1bb832afcb2c084e44f693e72bed2fbc12bfae,2,16,10,26,4,2013-04-29 20:35:46,2013-04-08 18:34:11
4c1bb832afcb2c084e44f693e72bed2fbc12bfae...b5c172138c8c27048f969ea9891f93474d937e19,2,98,2,100,2,2013-04-29 21:08:57,2013-04-29 21:08:02
b5c172138c8c27048f969ea9891f93474d937e19...c081809344bd6e35c49a1c573b954583c0e3a27d,8,252,20,272,32,2013-04-29 21:38:19,2012-10-08 19:24:08
c081809344bd6e35c49a1c573b954583c0e3a27d...ab518e88316857b53bba43fbef8a1954a55cf54d,3,221,2,223,6,2013-04-30 11:10:56,2013-04-30 10:43:32
58f93ffc4a23aa7240808288acf8cf9f3022abea...aeef9518c6ecea8bee896dee28b8796814d187c0,1,11,59,70,5,2013-04-05 18:07:53,2013-04-05 18:07:53
aeef9518c6ecea8bee896dee28b8796814d187c0...ea4f0b4a6b4c1785b1d112504a79ebf7d7f46e49,1,2,2,4,2,2013-04-05 19:05:58,2013-04-04 19:18:21
ea4f0b4a6b4c1785b1d112504a79ebf7d7f46e49...bd0d45818eac78d3bf2c5510373887cbe9c316d8,1,0,2,2,1,2013-04-05 19:05:58,2013-04-04 19:54:57
bd0d45818eac78d3bf2c5510373887cbe9c316d8...4108c31293b86f1323ec3d9012cfe8767ba78d00,1,2,2,4,2,2013-04-07 18:09:57,2013-04-04 19:10:53
4108c31293b86f1323ec3d9012cfe8767ba78d00...77715edee854ff9f2107a612de28e3fa5e20f8b4,2,74,1,75,2,2013-04-07 18:10:19,2013-04-07 14:03:27
77715edee854ff9f2107a612de28e3fa5e20f8b4...eb39c9854a29f20c9b77eb9379efccd6d245abbb,2,10,2,12,2,2013-04-07 21:17:40,2013-04-07 20:50:40
eb39c9854a29f20c9b77eb9379efccd6d245abbb...e8c01739cd622e808c4a4d11f6d323981296414d,1,8,0,8,2,2013-04-07 22:43:30,2013-04-07 22:41:33
e8c01739cd622e808c4a4d11f6d323981296414d...ff32ecd5bf32a3e2d1a3b3c6b7b12f640a8ea341,1,1,1,2,1,2013-04-08 07:48:46,2013-04-08 07:48:46
ff32ecd5bf32a3e2d1a3b3c6b7b12f640a8ea341...fed8cff1d0170bb6558da0e7d143599e7c37a47f,2,66,1,67,2,2013-04-08 10:45:42,2013-04-08 08:32:53
fed8cff1d0170bb6558da0e7d143599e7c37a47f...8c8ebe49b62c47b0ac87d697d0bc3515604667c3,2,37,29,66,16,2013-04-08 11:51:51,2013-04-06 18:47:53
8c8ebe49b62c47b0ac87d697d0bc3515604667c3...ba0f7b8066cb4dc8cb3cd4931e52aa94af40a709,1,1,1,2,1,2013-04-08 11:51:55,2013-04-06 19:26:00
ba0f7b8066cb4dc8cb3cd4931e52aa94af40a709...21f3c5c3670861436392f30da2033cccbc137309,1,1,0,1,1,2013-04-08 11:53:25,2013-04-06 19:26:24
21f3c5c3670861436392f30da2033cccbc137309...ccabd4a6fa8a6eb79d29bc3bbe9fe2b6531c2d8e,3,13,8,21,3,2013-04-08 14:48:18,2013-04-08 05:13:23
ccabd4a6fa8a6eb79d29bc3bbe9fe2b6531c2d8e...037bcac7ba0b10dac87538e2e6b7cc2177624039,2,48,1,49,2,2013-04-08 15:45:35,2013-04-08 14:00:18
037bcac7ba0b10dac87538e2e6b7cc2177624039...e4b716efaa00f34fe4d9f1c141c93e2aa994328c,2,10,5,15,5,2013-04-08 16:33:56,2013-04-08 15:46:51
e4b716efaa00f34fe4d9f1c141c93e2aa994328c...c93af860a079654becb3b1d06184ab7428dedffb,2,44,6,50,7,2013-04-08 22:09:51,2013-04-08 18:00:26
c93af860a079654becb3b1d06184ab7428dedffb...2e28832660099b49d861f4d4039d8d35ebb6c77e,2,35,2,37,3,2013-04-08 23:17:38,2013-04-05 14:48:18
2e28832660099b49d861f4d4039d8d35ebb6c77e...67096fdb38be8a057d8ee543928d41924195af98,1,69,0,69,1,2013-04-09 00:41:49,2013-04-09 00:41:49
67096fdb38be8a057d8ee543928d41924195af98...eeb4c3216d9f57bbf404c56bab7b9221cfbf6ae9,1,1,3,4,2,2013-04-09 23:39:00,2013-04-09 23:38:59
eeb4c3216d9f57bbf404c56bab7b9221cfbf6ae9...c665b8e9ba22e7ded460b08ca4ca4ea7ef6db9c3,2,10,2,12,4,2013-04-10 10:51:10,2013-04-10 10:21:41
c665b8e9ba22e7ded460b08ca4ca4ea7ef6db9c3...0d5595ac602630e36672f587023feb23b41fdb58,4,5,421,426,8,2013-04-10 11:54:15,2013-04-10 11:50:59
0d5595ac602630e36672f587023feb23b41fdb58...cd96f0aba8fcec2be2274ff56af767c1f16e7f50,1,1,1,2,1,2013-04-10 13:37:30,2013-04-10 13:25:40
cd96f0aba8fcec2be2274ff56af767c1f16e7f50...dbbfbe74caa8d5e76d32222735766435682b2b94,1,3,2,5,2,2013-04-11 11:42:34,2013-04-11 11:18:02
dbbfbe74caa8d5e76d32222735766435682b2b94...212eb8a52e835e3a8e71742fc557b0f4a43bf21c,1,6,8,14,4,2013-04-11 11:53:18,2013-04-11 11:50:45
212eb8a52e835e3a8e71742fc557b0f4a43bf21c...e5fdc4d6f1af4417ef9bb4ca7050fd633ea09267,25,291,107,398,76,2013-04-11 16:07:22,2013-04-11 16:07:22
e5fdc4d6f1af4417ef9bb4ca7050fd633ea09267...1ccae9cb1bde1045821a26b6c201d5eb6a17ad5f,330,33065,1092,34157,468,2013-04-11 16:16:47,2013-04-11 16:16:47
43951d7cfb773836c283c109d0b9c82affa98ae2...f8d81222e8284483c7fc0afd19a2a0ebe6de9b2f,2,2,0,2,2,2013-05-02 23:15:22,2013-04-30 22:26:14
f8d81222e8284483c7fc0afd19a2a0ebe6de9b2f...4c02282c7e9bd549267987d9961bd4e63444181e,1,3,0,3,1,2013-05-03 00:05:26,2013-05-02 23:38:16
1ccae9cb1bde1045821a26b6c201d5eb6a17ad5f...50be39792af00c2d1e2ce74bc50f5e561a8681a2,1,3,3,6,2,2013-04-11 18:06:20,2013-04-11 18:05:53
50be39792af00c2d1e2ce74bc50f5e561a8681a2...22c7d134e2763e1e1a8cbbe79253c47eb89c184f,2,5,4,9,3,2013-04-11 18:06:20,2013-04-11 18:06:07
1ccae9cb1bde1045821a26b6c201d5eb6a17ad5f...9712aa9f76073c30850b20a188b1ed12ffb74d17,3,38,3,41,4,2013-04-11 16:39:16,2013-04-11 16:39:16
fb9d66bceb6d3d6b0d90cbfaeab650e82e9e6db5...5037f9a5f4f899381c6517ae84de6be5737dee36,1,8,8,16,4,2013-05-06 17:19:08,2013-05-02 20:54:37
5037f9a5f4f899381c6517ae84de6be5737dee36...a90dc41df2a10858e7135cab55af335da9bc4b05,1,6,2,8,4,2013-05-06 18:31:57,2013-05-06 18:31:57
a90dc41df2a10858e7135cab55af335da9bc4b05...ee4f0baeac8ac6f26f7ed6ca96f8b70250e9fd17,1,9,2,11,4,2013-05-07 20:13:44,2013-05-07 18:59:22
ee4f0baeac8ac6f26f7ed6ca96f8b70250e9fd17...b7f6e6b42f1a87d230c9e290725fbfb1bae85791,2,4,8,12,4,2013-05-07 21:44:40,2013-05-07 19:38:14
b7f6e6b42f1a87d230c9e290725fbfb1bae85791...aca275f58db0ce3da247b35588ebec563c7ba937,1,3,3,6,2,2013-05-07 22:05:54,2013-05-07 22:01:42
aca275f58db0ce3da247b35588ebec563c7ba937...56492de5b9bcc6f34a39617b4687283c18f76693,1,11,6,17,8,2013-05-07 22:33:47,2013-05-07 22:17:33
56492de5b9bcc6f34a39617b4687283c18f76693...43ec1b1c2e77d21c7571acd39860b9783aaf5175,7,397,20,417,16,2013-05-08 23:53:52,2013-05-02 06:34:22
43ec1b1c2e77d21c7571acd39860b9783aaf5175...fbf464146241036598ddbe8141c09f12c06f9b95,1,14,11,25,5,2013-05-08 23:53:53,2013-05-02 14:42:49
fbf464146241036598ddbe8141c09f12c06f9b95...8a407f58b96ca6c8a5d1542bde39ebb879eb307d,3,29,13,42,7,2013-05-09 00:04:29,2013-02-10 22:19:43
8a407f58b96ca6c8a5d1542bde39ebb879eb307d...c38ce9bc0a143141abfa638289b458ddaaac26d6,3,53,8,61,15,2013-05-09 16:35:32,2013-05-08 19:54:29
c38ce9bc0a143141abfa638289b458ddaaac26d6...a58454226f4833e40c6a9040c813abd0c0e10893,2,132,5,137,7,2013-05-09 16:35:32,2013-05-08 20:29:54
a58454226f4833e40c6a9040c813abd0c0e10893...ec576235f1f4d7f5873cf3c0118b28c022740ffe,1,16,100,116,5,2013-05-09 16:35:32,2013-05-08 21:28:56
ec576235f1f4d7f5873cf3c0118b28c022740ffe...fede68fd68924117a46420c1ecfe42fe681b4ae3,31,566,323,889,109,2013-05-10 22:30:53,2013-05-10 22:30:53
fede68fd68924117a46420c1ecfe42fe681b4ae3...5e9c7a92f20877793003887093cf6920fe8d5c99,1,2,10,12,4,2013-05-10 23:40:03,2013-05-10 23:40:03
5e9c7a92f20877793003887093cf6920fe8d5c99...fc58a5d4bdf0457e6543e8bb1a0a58dd82aac677,495,21742,20290,42032,1141,2013-05-11 00:45:37,2013-05-11 00:45:37
fc58a5d4bdf0457e6543e8bb1a0a58dd82aac677...7ee538ddfe15b2de2e325f55d208b725ec1f8ea3,197,9021,3143,12164,1758,2013-05-13 01:28:40,2013-05-13 01:28:40
7ee538ddfe15b2de2e325f55d208b725ec1f8ea3...0c405cff684dfd7a30f18faa5e56f3ffce746137,2,16,10,26,4,2013-05-13 01:29:52,2013-04-08 18:34:11
0c405cff684dfd7a30f18faa5e56f3ffce746137...7349667467f5acf9897513236b6bfba0111a53cf,1,2,6,8,2,2013-05-13 02:40:14,2013-05-13 02:28:59
7349667467f5acf9897513236b6bfba0111a53cf...7bfcaa8f9117ac1923644346b33a8c493b895a7f,1,5,3,8,2,2013-05-13 04:45:05,2013-05-13 04:45:05
7bfcaa8f9117ac1923644346b33a8c493b895a7f...69572a3965825ecead1d5ee2cfabe3a5c981fa15,1,8,4,12,3,2013-05-13 04:46:55,2013-05-13 04:46:52
69572a3965825ecead1d5ee2cfabe3a5c981fa15...8db693a87e324d2354d253990e3f75a149c029e3,2,61,2,63,2,2013-05-13 10:35:17,2013-05-10 01:19:02
bf8ed11825f07c90f5be755742230f11ab64e8e3...440bc060b985a5c7779661e2dd6a9af79bfca599,1,2,2,4,2,2013-04-11 18:07:08,2013-04-11 18:07:08
440bc060b985a5c7779661e2dd6a9af79bfca599...b0de1e4a41615a8a9167909950b974cb14534a56,3,180,23,203,13,2013-04-11 23:12:48,2013-04-11 22:01:26
b0de1e4a41615a8a9167909950b974cb14534a56...8ee43006b81b713db1a0ca190f5332edd45121c1,1,1,1,2,1,2013-04-12 03:40:05,2013-04-12 03:40:05
bdc58811693fd4454b5c99cbbbdaddbce3950f6f...e72cd415adf2ca12daddc001cc3fe953cdb4b507,2,313,51,364,21,2013-05-13 19:31:18,2013-04-23 13:11:17
e72cd415adf2ca12daddc001cc3fe953cdb4b507...31e73a5cecd305abf55c3b04a4339a0d3ca1be5e,110,146,128,274,116,2013-05-13 21:24:36,2013-05-13 21:24:36
8ee43006b81b713db1a0ca190f5332edd45121c1...78c5de598bb6ebd68d8d93fabdcebdca1f024580,1,4,7,11,2,2013-04-15 18:57:14,2013-04-15 18:51:28
78c5de598bb6ebd68d8d93fabdcebdca1f024580...afbaddecd37a77d9304f55e440bc6c741516b580,1,6,5,11,4,2013-04-15 19:13:29,2013-04-15 19:05:20
afbaddecd37a77d9304f55e440bc6c741516b580...d58ee7e5c72c26b9ec81f2533d64cecd4b7959f8,1,6,0,6,2,2013-04-15 20:39:03,2013-04-15 20:36:49
d58ee7e5c72c26b9ec81f2533d64cecd4b7959f8...47198af55a384788cda34c430531d928e24ae261,1,4,1,5,2,2013-04-16 15:05:51,2013-04-10 13:38:02
47198af55a384788cda34c430531d928e24ae261...7592615aaa1eb7a18dca1b9ab70865bbfd99a80d,1,8,4,12,4,2013-04-16 15:05:51,2013-04-16 07:51:56
7592615aaa1eb7a18dca1b9ab70865bbfd99a80d...ccd37226c6d337ea8ce3c0f9b7ddd1bd7eeaec1f,2,25,2,27,3,2013-04-16 21:11:03,2013-04-16 20:59:35
ccd37226c6d337ea8ce3c0f9b7ddd1bd7eeaec1f...b02b93b2a22e1dbf5ef03aa0104f73836deb5d25,1,4,2,6,1,2013-04-16 21:44:00,2013-04-16 20:52:52
b02b93b2a22e1dbf5ef03aa0104f73836deb5d25...36503b523dbfc728e20a166758598cb6b339fd83,1,2,2,4,1,2013-04-16 22:04:17,2013-04-09 20:36:34
36503b523dbfc728e20a166758598cb6b339fd83...2e70ddad9d8ef8aa37bcb18ef912cf0ff5921656,1,3,2,5,1,2013-04-17 22:02:51,2013-04-17 21:59:49
2e70ddad9d8ef8aa37bcb18ef912cf0ff5921656...92023b4b37ad9bd1609b2dd2a13680dafc429f75,2,37,0,37,2,2013-04-17 22:54:57,2013-04-17 22:44:53
92023b4b37ad9bd1609b2dd2a13680dafc429f75...659fb238e7f1c837978c2ee661385b691a18a8ac,1,2,1,3,1,2013-04-17 23:30:36,2013-04-17 18:45:13
31e73a5cecd305abf55c3b04a4339a0d3ca1be5e...5d3dc0e4c3369dfb00b7b13e08936c2e652fa696,3,54,12,66,15,2013-05-13 21:54:38,2013-05-13 21:54:38
659fb238e7f1c837978c2ee661385b691a18a8ac...a835a2fc47d55c95c03780a78af09f971637a351,1,1,0,1,1,2013-04-18 20:06:04,2013-04-18 20:06:03
a835a2fc47d55c95c03780a78af09f971637a351...6101eb184db77d0b11eb96e48744e57ecce4b73d,2,19,12,31,5,2013-04-18 22:08:35,2013-04-14 01:48:00
dff93008a6a3c1c2a11dd3b067bf6b8d47bf3bf9...458c8bb9f86f1666cbbbe1f2951e7ca86756c48f,1,2,2,4,2,2013-05-13 22:54:19,2013-05-13 22:54:19
458c8bb9f86f1666cbbbe1f2951e7ca86756c48f...9498fd15c70c2daf386dda13c43d7a2d984f0892,59,940,754,1694,222,2013-05-14 00:07:35,2013-05-13 23:54:58
9498fd15c70c2daf386dda13c43d7a2d984f0892...8886c6bf624e6627f68a10c5f4c6399bb5257cdf,4,235,0,235,5,2013-05-14 21:15:24,2013-05-08 19:56:08
8886c6bf624e6627f68a10c5f4c6399bb5257cdf...79348256216ba0b3d6b9e0145ca27270152a6449,14,233,217,450,81,2013-05-15 00:13:42,2013-05-15 00:13:42
79348256216ba0b3d6b9e0145ca27270152a6449...3afa5e6b714ce3b8bc162f2f186b0690df67edb4,1,5,0,5,1,2013-05-15 19:25:11,2013-05-15 19:25:11
3afa5e6b714ce3b8bc162f2f186b0690df67edb4...6902f6536cee48904a1779b6e196b14b5f86d526,1,1,2,3,2,2013-05-15 20:47:42,2013-05-15 20:46:49
6902f6536cee48904a1779b6e196b14b5f86d526...b3d1e504f4a3a4c44be3ca53b2aa44282fc391df,4,60,0,60,4,2013-05-15 20:53:29,2013-05-07 18:55:12
b3d1e504f4a3a4c44be3ca53b2aa44282fc391df...7124387b3414c41533078f14a84446e2e0a6ff95,3,15,56,71,4,2013-05-15 20:53:29,2013-05-15 20:25:45
7124387b3414c41533078f14a84446e2e0a6ff95...04ce80760ed615f353e128efa447cdf11fdb903f,2,47,2,49,2,2013-05-15 21:57:58,2013-05-11 20:43:11
04ce80760ed615f353e128efa447cdf11fdb903f...f0d80d7db0df9f3be325eb160c3e7fff3902239c,2,6,3,9,3,2013-05-15 22:07:53,2013-04-16 23:18:07
f0d80d7db0df9f3be325eb160c3e7fff3902239c...88333f7ace007dc0ef57803b954c55976f523ffa,1,2,3,5,2,2013-05-15 22:10:56,2013-05-15 21:58:14
88333f7ace007dc0ef57803b954c55976f523ffa...999ee45d367256bca3d3fbecab37c4fbca49ebec,3,6,6,12,6,2013-05-16 22:58:33,2013-05-16 22:58:33
999ee45d367256bca3d3fbecab37c4fbca49ebec...79988438078f58f828811ec87394700ccef42293,1,11,10,21,9,2013-05-16 23:06:01,2013-05-16 22:45:53
6101eb184db77d0b11eb96e48744e57ecce4b73d...63466e5cae5d2365d11300129781d2be62339689,1,3,1,4,1,2013-04-19 09:58:18,2013-04-18 22:34:12
63466e5cae5d2365d11300129781d2be62339689...56e90dacb39f36a02c2b7b4e473ada6bc913c8bf,1,85,0,85,1,2013-04-19 16:12:22,2013-04-19 16:12:22
56e90dacb39f36a02c2b7b4e473ada6bc913c8bf...223f22a30d097e1c878d14cf666858e3bb3046c9,1,79,0,79,1,2013-04-19 16:12:53,2013-04-19 16:12:34
223f22a30d097e1c878d14cf666858e3bb3046c9...0b04abcb10ace8cf0f8705223c39328fd75722c9,1,5,9,14,3,2013-04-19 16:22:06,2013-04-19 16:21:29
0b04abcb10ace8cf0f8705223c39328fd75722c9...2322580dfbe28f0bff0a56928398c5607752ffb2,1,1,1,2,1,2013-04-21 03:30:20,2013-04-21 03:21:05
2322580dfbe28f0bff0a56928398c5607752ffb2...c4379a5554e421c55a38baaee4775b5c13a288d3,1,3,3,6,2,2013-04-21 03:30:21,2013-04-21 03:21:13
c4379a5554e421c55a38baaee4775b5c13a288d3...4bf1d1007fbd249d1d07b662278a5a34c6be12fd,2,63,13,76,2,2013-04-21 13:33:10,2013-04-08 15:43:20
4bf1d1007fbd249d1d07b662278a5a34c6be12fd...1d794ec43e5a5b72ab4aeafa91d2e54fd92503b8,1,4,1,5,1,2013-04-22 15:56:29,2013-04-19 15:32:24
1d794ec43e5a5b72ab4aeafa91d2e54fd92503b8...01e29202193cfc4257d6c638b8c08b7fcc2c9931,2,95,2,97,5,2013-04-22 16:54:04,2013-04-22 15:52:42
01e29202193cfc4257d6c638b8c08b7fcc2c9931...c77747354c573f57f4f5a2de42407c9fcf6dc10c,1,7,8,15,6,2013-04-22 18:00:52,2013-04-22 17:18:46
c77747354c573f57f4f5a2de42407c9fcf6dc10c...ff99cd527777da037906be7b1f97d8c02e8eb624,8,87,104,191,19,2013-04-23 00:39:22,2013-04-23 00:39:05
ff99cd527777da037906be7b1f97d8c02e8eb624...0602fbb49c159fe5eded343a0fbb447979d757ba,1,10,0,10,1,2013-04-23 14:41:11,2013-04-23 07:38:17
61c9f78c639459f28eea3d1de203b92debd9f513...812356049d67718aa8af51ce8dcac97144d54333,2,43,3,46,3,2013-05-17 23:43:07,2013-05-17 18:20:20
812356049d67718aa8af51ce8dcac97144d54333...d820b6441211ce79ed09ee3ef3992bc48e78bd93,3,22,0,22,3,2013-05-20 13:18:50,2013-05-20 13:14:30
0602fbb49c159fe5eded343a0fbb447979d757ba...deeaf8fab978e3cadb364e46fb32dafdebe5f095,3,29,2,31,3,2013-04-23 20:27:37,2013-04-23 01:00:41
0fefcc1690f65593aba768b78e1b97b925f8caad...896b2aa7074fc886efd7dd0a397d694763cac7ce,16,296,185,481,55,2013-05-21 23:39:50,2013-05-21 22:22:05
896b2aa7074fc886efd7dd0a397d694763cac7ce...52adc0d96309f9e04cbb220d63206e32b8309081,3,3,3,6,3,2013-05-22 18:46:52,2013-05-22 18:42:38
52adc0d96309f9e04cbb220d63206e32b8309081...506fc4de1e820d97b637f6e01dda2ab97667efa7,194,8638,5465,14103,1585,2013-05-22 20:13:11,2013-05-22 19:56:12
506fc4de1e820d97b637f6e01dda2ab97667efa7...e761ac2306e9d82a75e31156ccf96262c96403a9,2,16,10,26,4,2013-05-22 20:14:43,2013-04-08 18:34:11
e761ac2306e9d82a75e31156ccf96262c96403a9...2868bf94b690cc0bcb62400fbae7e90f4af916dd,2,3,9,12,4,2013-05-22 21:12:25,2013-05-22 20:04:41
2868bf94b690cc0bcb62400fbae7e90f4af916dd...f58eb8f5dbe5e530f1e37fc6978fdf853be81706,1,0,4,4,1,2013-05-22 23:09:06,2013-05-22 23:09:06
f58eb8f5dbe5e530f1e37fc6978fdf853be81706...f8193ab3c46475486eab38543650e2388bd3aedc,3,16,5,21,8,2013-05-23 03:13:14,2013-05-22 18:32:54
f8193ab3c46475486eab38543650e2388bd3aedc...23509eb9e8de89aafebca68dde491e82a06b3cc8,4,10,117,127,27,2013-05-23 03:19:31,2013-03-31 02:51:17
23509eb9e8de89aafebca68dde491e82a06b3cc8...17e696c3122d75d7341132d62b25e95ef9469997,2,180,0,180,2,2013-05-23 03:19:31,2013-03-31 03:56:39
17e696c3122d75d7341132d62b25e95ef9469997...9c7078cea2b719defbb6519d10a14ab15e733822,1,0,14,14,1,2013-05-24 15:57:30,2013-05-24 15:57:30
52aeb3f2fdc076143bb7df70bc01a722178b8336...ec5577cf9daa48691e039edbcd9ea1bab27ebc3a,1,2,2,4,2,2013-04-23 21:07:23,2013-04-23 21:07:23
ec5577cf9daa48691e039edbcd9ea1bab27ebc3a...72cf499b549fc831b451620ea3782f272fd5b550,1,73,0,73,1,2013-04-23 21:08:01,2013-04-23 21:08:01
72cf499b549fc831b451620ea3782f272fd5b550...8e56b4dd1caa8eb50b7fe3a168c48bf73b74beea,1,17,0,17,1,2013-04-23 21:43:46,2013-04-23 21:43:46
8e56b4dd1caa8eb50b7fe3a168c48bf73b74beea...8c2ad47f42b9c7ef1c5400173e8ea9d6ea22a0d8,4,179,113,292,9,2013-04-26 19:10:05,2013-04-26 19:07:56
8c2ad47f42b9c7ef1c5400173e8ea9d6ea22a0d8...7bd8a5a2a60b75266f89f9a32877d55294a3881c,1,12,0,12,2,2013-04-29 05:10:40,2013-04-29 05:10:24
7bd8a5a2a60b75266f89f9a32877d55294a3881c...626d7abdb43b672a6153510561afdd8856b7770f,1,1,1,2,1,2013-04-29 10:06:36,2013-04-29 10:06:30
626d7abdb43b672a6153510561afdd8856b7770f...4fdb8acdaef4c3cb1d855e992ada0e63fee520a6,512,21235,42032,63267,7843,2013-04-29 10:12:33,2013-04-26 12:49:54
4fdb8acdaef4c3cb1d855e992ada0e63fee520a6...dda7b402044a4ecde60baf386cb54997fbd570a1,1,2,2,4,2,2013-04-30 14:40:43,2013-04-30 14:40:43
dda7b402044a4ecde60baf386cb54997fbd570a1...2cf7e5de6f0af289f231ff499ef1acf731e9f3b1,512,42009,21212,63221,7849,2013-05-01 14:45:31,2013-05-01 14:21:21
2cf7e5de6f0af289f231ff499ef1acf731e9f3b1...a32a243d5f954ddbb4e7d1eac0b1e88a403a445d,6,175,23,198,14,2013-05-02 06:52:58,2013-04-26 06:05:33
a32a243d5f954ddbb4e7d1eac0b1e88a403a445d...0e21d7b985954f80bdb6842da005fb438e8b9b34,10,61,1,62,10,2013-05-02 16:48:33,2013-05-02 16:47:46
0e21d7b985954f80bdb6842da005fb438e8b9b34...41cbdc5e64d090e0708dd2a63d4cd63000019bb1,1,8,0,8,5,2013-05-02 23:10:01,2013-04-30 22:24:48
28659aba37fc9136dad6181306696ce4a6d6ba3f...4d68daea0f3b092743a7793748f684c2827d6210,11,44,34,78,26,2013-05-29 22:12:49,2013-05-26 15:06:45
4d68daea0f3b092743a7793748f684c2827d6210...448adaa4563fb035c5fccfe4a9a0cc74b5ca5ba0,9,7,29,36,12,2013-05-29 22:12:49,2013-05-26 18:04:17
448adaa4563fb035c5fccfe4a9a0cc74b5ca5ba0...7890a69e4d8e9689e8d3a16ebc427c08ba0c45ec,1,24,0,24,1,2013-05-29 22:12:57,2013-05-26 18:32:37
7890a69e4d8e9689e8d3a16ebc427c08ba0c45ec...d02f2282635755d8ab544bf18489eac3c3c03bf6,1,36,35,71,17,2013-05-29 22:12:57,2013-05-26 19:17:35
d02f2282635755d8ab544bf18489eac3c3c03bf6...ef0926ce428ca30baddbf6c10e3d6423bd499fbc,1,1,4,5,1,2013-05-29 22:13:04,2013-05-26 19:21:57
ef0926ce428ca30baddbf6c10e3d6423bd499fbc...36ebff0470e72b07226049042761da955ac33104,1,2,3,5,2,2013-05-29 22:13:04,2013-05-26 19:41:20
36ebff0470e72b07226049042761da955ac33104...c188a7510317bfdaa19e87c6870c5ee7d965a6b9,1,1,1,2,1,2013-05-29 22:13:05,2013-05-26 19:42:23
c188a7510317bfdaa19e87c6870c5ee7d965a6b9...6b654c0b13f5399137ca71b177081ee6d0beb22e,21,414,113,527,80,2013-05-29 23:09:54,2013-05-29 23:09:54
6b654c0b13f5399137ca71b177081ee6d0beb22e...6af8788f3ee53bc8471634e905a0a156e39e2ca9,1,4,3,7,1,2013-05-30 12:40:09,2013-05-29 03:36:26
6af8788f3ee53bc8471634e905a0a156e39e2ca9...7ce5a310612bfcfc153836e718fe3c6309369fb4,1,3,0,3,1,2013-05-30 12:50:14,2013-05-25 20:03:02
7ce5a310612bfcfc153836e718fe3c6309369fb4...49e3fcd058524826ecbdf57ae7dcb9edd2551af9,3,48,18,66,14,2013-05-30 13:57:25,2013-05-28 17:16:16
49e3fcd058524826ecbdf57ae7dcb9edd2551af9...5b636feaa8550ca39229e7d8805c73c72f7995dc,1,4,14,18,4,2013-05-30 16:29:15,2013-05-29 21:52:10
5b636feaa8550ca39229e7d8805c73c72f7995dc...0761c90204d7a0134c657e20f91bd83bfa6e677a,6,8,138,146,9,2013-05-30 16:30:19,2013-05-29 22:19:34
0761c90204d7a0134c657e20f91bd83bfa6e677a...9a6c0853bc164ad2d76f51cdcb0771e881cd0a5f,2,33,75,108,18,2013-05-30 16:33:21,2013-05-30 08:38:19
9a6c0853bc164ad2d76f51cdcb0771e881cd0a5f...b846842aff39cfbf0325ca895e661d2bd4a82fa2,2,2,59,61,9,2013-05-30 21:51:40,2013-05-30 17:33:29
b846842aff39cfbf0325ca895e661d2bd4a82fa2...bcb85a1d31ff64c35eb2edc1101ae95fb5b2d694,1,1,1,2,1,2013-05-30 22:09:50,2013-05-30 22:09:50
bcb85a1d31ff64c35eb2edc1101ae95fb5b2d694...4b31a2d8dafdeac404f5fb0c52b910bc30f458ae,1,7,6,13,3,2013-05-30 23:51:41,2013-05-30 23:51:41
41cbdc5e64d090e0708dd2a63d4cd63000019bb1...418c9bc60429ab4cd46d100fdfd866c66f0a853a,1,0,3,3,1,2013-05-03 09:32:32,2013-05-03 06:51:51
2900f0778a850ada6463e07de9725f9022029e67...72b92e92d39fa8c513d4166c1f0feed48241aac7,1,12,9,21,2,2013-06-04 09:54:05,2013-06-04 07:09:00
72b92e92d39fa8c513d4166c1f0feed48241aac7...a7820a15e7eb4e57a4fe2f076e877dcc6069358c,8,110,152,262,21,2013-06-04 10:22:03,2013-06-04 10:21:58
418c9bc60429ab4cd46d100fdfd866c66f0a853a...1c2b03dea5846916073efeb90f3c56db09e0dec5,1,0,8,8,2,2013-05-03 14:01:33,2013-04-26 23:14:39
1c2b03dea5846916073efeb90f3c56db09e0dec5...76cbd039b93905df1144d5ce8625d3c35a5244cc,1,4,4,8,2,2013-05-06 17:10:05,2013-05-02 20:54:37
76cbd039b93905df1144d5ce8625d3c35a5244cc...716176fa997c554e424485897894ec2898f8254f,1,9,2,11,4,2013-05-07 19:51:03,2013-05-07 18:59:22
716176fa997c554e424485897894ec2898f8254f...cf87ee67eed4409bdd14a4d75b5d7053328cce91,1,10,5,15,7,2013-05-07 22:40:04,2013-05-07 22:17:33
cf87ee67eed4409bdd14a4d75b5d7053328cce91...1ad93a65844e6bf5c87fb4c5ca46f9c7fb2ebc9f,2,66,52,118,14,2013-05-08 18:59:28,2013-04-29 13:25:08
1ad93a65844e6bf5c87fb4c5ca46f9c7fb2ebc9f...3b6fc600e2270b213450517c1406c26f0935e920,2,43,1,44,2,2013-05-08 18:59:40,2013-05-01 17:46:31
3b6fc600e2270b213450517c1406c26f0935e920...dc92ff85851efdbc5ddb44150a95265982437a59,1,4,0,4,1,2013-05-09 01:15:50,2013-05-06 19:53:35
dc92ff85851efdbc5ddb44150a95265982437a59...72c58158f7a8bd08a0af085f0e2012cfccbf19b5,1,5,6,11,1,2013-05-09 02:31:45,2013-05-06 23:37:03
72c58158f7a8bd08a0af085f0e2012cfccbf19b5...4b69bcfc66c2007a0550e928956bda0006c21aec,11,32,21,53,21,2013-05-09 22:15:39,2013-05-09 22:15:39
4b69bcfc66c2007a0550e928956bda0006c21aec...21bd45676390fd21ffa7c3cca91af4ad37ed3e5c,2,92,2,94,2,2013-05-13 17:49:59,2013-05-10 18:19:17
0882a7506394e07ae6564ccf3db401b8fb7f7071...4bb4f734b3dc3cd42ffd7c5d128fec2abd6b97dd,2,23,23,46,15,2013-06-07 15:01:16,2013-06-07 14:47:54
4bb4f734b3dc3cd42ffd7c5d128fec2abd6b97dd...9ae1d182ba98629ac7c7b9100022ac93133494b7,2,28,0,28,3,2013-06-08 11:40:57,2013-06-07 11:31:24
9ae1d182ba98629ac7c7b9100022ac93133494b7...6dd78074a3c0a7579ca5e919021587c22ff763ae,310,17278,10705,27983,4065,2013-06-11 21:46:00,2013-06-11 21:45:46
6dd78074a3c0a7579ca5e919021587c22ff763ae...2dbc5ea1b449c08b9af4655af1fe875e124b386b,2,16,10,26,4,2013-06-11 21:46:13,2013-04-08 18:34:11
2dbc5ea1b449c08b9af4655af1fe875e124b386b...393d33e7ea44a4410729e50303a6ad0d62558a8c,2,15,13,28,6,2013-06-11 22:07:28,2013-06-11 22:07:26
393d33e7ea44a4410729e50303a6ad0d62558a8c...3b0a759b6baa03bf7d293614bf7a8ee4500794f9,1,3,2,5,3,2013-06-11 22:24:41,2013-06-11 22:24:41
3b0a759b6baa03bf7d293614bf7a8ee4500794f9...45a08cb2160d3b94b6fa67d253f522619946a7cf,1,12,12,24,11,2013-06-11 22:42:49,2013-06-09 21:20:01
45a08cb2160d3b94b6fa67d253f522619946a7cf...87624ab911a3c8c0bf08d9f101ce68dbabc051eb,1,28,16,44,7,2013-06-11 22:42:50,2013-06-09 21:34:11
87624ab911a3c8c0bf08d9f101ce68dbabc051eb...642ea2b668c12773c371b333926ccc10070ef2cb,1,113,29,142,9,2013-06-12 21:43:24,2013-06-09 22:54:30
642ea2b668c12773c371b333926ccc10070ef2cb...e92f4879eb6c21d66ceaa819ae8f045226b74a3e,2,136,50,186,18,2013-06-12 21:43:37,2013-06-11 21:30:16
e92f4879eb6c21d66ceaa819ae8f045226b74a3e...56d9c48573e4bfe98021fc0c678e20b90538c976,2,16,5,21,3,2013-06-14 15:10:04,2013-06-11 10:49:03
56d9c48573e4bfe98021fc0c678e20b90538c976...4536b27ac1b71e92b26c5d4ba772ae8511db09eb,1,5,0,5,1,2013-06-14 15:10:04,2013-06-13 10:59:29
4536b27ac1b71e92b26c5d4ba772ae8511db09eb...5dd155a3bb04f84389d5544363407a3b0bfc8e2e,1,3,1,4,2,2013-06-15 19:43:24,2013-06-11 14:11:48
5dd155a3bb04f84389d5544363407a3b0bfc8e2e...0495b7031c9a33821e3a518e93911d2832f59d19,1,3,0,3,1,2013-06-15 19:44:50,2013-06-13 11:29:15
0495b7031c9a33821e3a518e93911d2832f59d19...6978e998ee7c08b3dd10e4cecd2a167696b74317,9,88,22,110,14,2013-06-15 19:44:50,2013-06-11 10:52:27
6978e998ee7c08b3dd10e4cecd2a167696b74317...4c48a39c65c175c2f0b1ec5bf58456dd83e71d99,2,219,122,341,32,2013-06-15 19:44:51,2013-06-11 10:55:49
4c48a39c65c175c2f0b1ec5bf58456dd83e71d99...03e008ddb8381b601dd42330ae57efedd5979ce4,6,1375,22,1397,11,2013-06-16 07:30:14,2013-06-11 10:59:10
03e008ddb8381b601dd42330ae57efedd5979ce4...af80e7bc6e6f33c582eb1f7d37c7f5bbe9f910f7,15,1455,1764,3219,69,2013-06-16 07:30:15,2013-06-13 13:36:00
af80e7bc6e6f33c582eb1f7d37c7f5bbe9f910f7...dc50f27d5260fcb4568be3d43b7dcc898355e748,3,15,10,25,8,2013-06-16 07:30:15,2013-06-13 19:47:31
dc50f27d5260fcb4568be3d43b7dcc898355e748...70a75cd41e250a29ef30d4f35dd40630c14b8d8f,1,3,0,3,1,2013-06-16 23:22:41,2013-06-16 23:22:41
70a75cd41e250a29ef30d4f35dd40630c14b8d8f...0581f5cb604f12d4467dfc0728ea62005ae76990,1,1,1,2,1,2013-06-16 23:23:57,2013-06-16 23:23:57
0581f5cb604f12d4467dfc0728ea62005ae76990...0a4260c8c0deff518d0586c6b0484d459f9a79f4,1,2,2,4,2,2013-06-17 01:56:00,2013-06-17 01:56:00
0a4260c8c0deff518d0586c6b0484d459f9a79f4...212e9cd8c9b10da3c471638ca9b0f8ebef2a67bb,7,480,11,491,32,2013-06-17 12:00:26,2013-06-17 10:11:13
212e9cd8c9b10da3c471638ca9b0f8ebef2a67bb...ffcd8b94c2111dcc72425ce0fbc48826ca8ba9ac,2,29,4,33,6,2013-06-17 14:19:12,2013-06-04 15:01:14
ffcd8b94c2111dcc72425ce0fbc48826ca8ba9ac...5e4e8ec429381a8d1eebe31647e9daaaae42c54b,6,57,17,74,20,2013-06-17 15:21:56,2013-05-08 12:10:07
5e4e8ec429381a8d1eebe31647e9daaaae42c54b...c0281f1b30871d37584a0387dbe72ca4924d8587,2,5,5,10,4,2013-06-17 17:41:48,2013-06-17 17:26:07
c0281f1b30871d37584a0387dbe72ca4924d8587...226a20da5d926795750c5ed4b434a9f40d8b8200,4,4,4,8,5,2013-06-17 21:10:31,2013-06-11 23:49:56
226a20da5d926795750c5ed4b434a9f40d8b8200...b9165252e3a9115fe991042b75caa08c0993e347,13,36,62,98,40,2013-06-17 21:32:19,2013-06-17 21:25:01
b9165252e3a9115fe991042b75caa08c0993e347...1bf6d78980fe77679c92d22b40b5d968e71d3299,1,0,1,1,1,2013-06-17 23:15:25,2013-06-17 23:15:25
1bf6d78980fe77679c92d22b40b5d968e71d3299...98aad77f466d9c36947f2cbb6d07b75009795ed2,1,13,9,22,7,2013-06-18 10:05:36,2013-06-13 05:05:33
98aad77f466d9c36947f2cbb6d07b75009795ed2...d3b06f19cbd6c9bff6bff3e5c0b2e787d9d0afc4,1,28,38,66,48,2013-06-18 10:12:10,2013-06-16 07:30:50
d3b06f19cbd6c9bff6bff3e5c0b2e787d9d0afc4...8f3f9f7830a48ebabb1d9f78f49b1218f5d0490c,7,575,0,575,8,2013-06-18 22:37:51,2013-04-17 23:18:47
8f3f9f7830a48ebabb1d9f78f49b1218f5d0490c...252cdfa43be38b99228b3caee373dccbb6e94e9c,4,88,0,88,6,2013-06-18 22:38:06,2013-05-14 23:27:10
252cdfa43be38b99228b3caee373dccbb6e94e9c...3a2f273bd73bc94a6e93f342d629106a9f022f2d,20,695,1286,1981,296,2013-06-18 22:39:13,2013-04-17 23:26:15
3a2f273bd73bc94a6e93f342d629106a9f022f2d...456942a920fe313ebe0b0da366d26ef400ec177e,2,58,8,66,5,2013-06-18 22:39:32,2013-04-17 23:29:14
456942a920fe313ebe0b0da366d26ef400ec177e...fb40da822fa8bb6da588af1989aaf32ef01d0a17,3,97,0,97,3,2013-06-18 22:39:32,2013-05-15 18:01:33
fb40da822fa8bb6da588af1989aaf32ef01d0a17...56869d9ae7dd08138cce8442d71f070b793e2d30,1,3,5,8,3,2013-06-18 22:39:32,2013-04-29 05:13:45
56869d9ae7dd08138cce8442d71f070b793e2d30...f4896491590032a42b892c59afd970f9ee031ab7,1,38,25,63,13,2013-06-18 22:39:32,2013-04-26 23:58:18
f4896491590032a42b892c59afd970f9ee031ab7...4b403588416e7928fbda31043d5e7aa56b5d87b0,2,42,8,50,6,2013-06-18 22:41:03,2013-05-24 17:58:30
4b403588416e7928fbda31043d5e7aa56b5d87b0...7373c4ddb7143fb7da75feda39c70788fb1bcfc7,2,29,27,56,11,2013-06-18 22:41:16,2013-06-07 17:31:53
7373c4ddb7143fb7da75feda39c70788fb1bcfc7...bf8dc0762a365302f742da85fa416886332ab73d,1,1,2,3,1,2013-06-19 20:03:07,2013-06-19 08:16:59
bf8dc0762a365302f742da85fa416886332ab73d...f5e13ae9b5ca6eaacbcf9aad36552d9cd6c8bde6,2,9,7,16,4,2013-06-19 20:15:05,2013-06-19 20:07:24
f5e13ae9b5ca6eaacbcf9aad36552d9cd6c8bde6...24ba9fdec8c4ba0fd367aef4a3f266f69d8655aa,1,54,56,110,20,2013-06-20 11:02:53,2013-06-20 10:40:44
24ba9fdec8c4ba0fd367aef4a3f266f69d8655aa...157d2bcc04fc1fb47033db7cae00c7d593c1bf0c,1,3,1,4,1,2013-06-20 11:23:12,2013-06-20 11:21:05
157d2bcc04fc1fb47033db7cae00c7d593c1bf0c...972465a3b05442ab9826f4b2baf27d61fc31bce2,1,7,9,16,6,2013-06-20 11:25:10,2013-06-02 12:25:51
972465a3b05442ab9826f4b2baf27d61fc31bce2...b255f4c10a80343f9ce1cee56d0288361429e214,2,11,1,12,2,2013-06-20 21:24:55,2013-06-20 21:13:28
21bd45676390fd21ffa7c3cca91af4ad37ed3e5c...f13a3fd2af3003226092f64524acb11613e1a84d,1,2,1,3,1,2013-05-14 10:31:38,2013-05-14 10:31:38
f13a3fd2af3003226092f64524acb11613e1a84d...dbe9f8da6b114873e781791bb31761d3161cad31,1,1,1,2,1,2013-05-14 10:37:39,2013-04-30 04:25:23
dbe9f8da6b114873e781791bb31761d3161cad31...6a833a38f6a30c983b93ab272eb31c0799364d94,1,87,0,87,1,2013-05-14 18:35:43,2013-05-14 18:35:43
6a833a38f6a30c983b93ab272eb31c0799364d94...201baa273b115350374312ae493d3502d0bf3436,3,164,3,167,4,2013-05-14 18:36:04,2013-04-30 21:50:21
201baa273b115350374312ae493d3502d0bf3436...0b8af89363f2ee9824376dd5e5fc5a918ea9aeeb,1,1,1,2,1,2013-05-14 18:36:04,2013-04-30 22:02:19
0b8af89363f2ee9824376dd5e5fc5a918ea9aeeb...bdb78b9945f65a0f2a364995eaf099561a902df7,3,24,11,35,14,2013-05-14 18:36:04,2013-04-30 22:09:54
bdb78b9945f65a0f2a364995eaf099561a902df7...d5158574c6cb69204d155b6ea0ee4c07ab07ddd6,2,16,3,19,4,2013-05-14 18:36:05,2013-05-02 19:25:50
d5158574c6cb69204d155b6ea0ee4c07ab07ddd6...3058f08e645bca41ee0f281ed83a697be1e3c8c4,1,0,14,14,2,2013-05-14 18:36:05,2013-05-01 22:36:09
3058f08e645bca41ee0f281ed83a697be1e3c8c4...64fc34b27005229487faba1c43ffdfa08ca4f982,3,703,0,703,4,2013-05-14 20:51:24,2013-05-01 22:40:43
64fc34b27005229487faba1c43ffdfa08ca4f982...69dac92c36b8e0981a2afd1fc8dd9483cba8aad5,2,14,66,80,11,2013-05-14 20:51:42,2013-05-01 22:40:13
69dac92c36b8e0981a2afd1fc8dd9483cba8aad5...4e8cddddcbb7af0d7dcb39dabce6b48cef8c9957,1,7,90,97,6,2013-05-14 20:51:42,2013-05-02 17:49:20
4e8cddddcbb7af0d7dcb39dabce6b48cef8c9957...119354f7356de47cb36b5a1cebf9423e89c7f10b,2,69,550,619,43,2013-05-14 20:51:42,2013-05-02 17:44:45
119354f7356de47cb36b5a1cebf9423e89c7f10b...a1eacdf12ae377b06e7ec5a89bafc2b73bfb7f4d,2,102,52,154,29,2013-05-14 20:51:43,2013-05-02 19:28:48
a1eacdf12ae377b06e7ec5a89bafc2b73bfb7f4d...430dc39e87dfeb95b840502b1d028ffb64b8bd9c,2,49,39,88,22,2013-05-14 20:51:43,2013-05-02 22:32:32
430dc39e87dfeb95b840502b1d028ffb64b8bd9c...c1e8c8de1cdef4ecf2a65e21b14e2aa75f1e6716,1,12,6,18,6,2013-05-14 20:51:43,2013-05-03 01:34:25
c1e8c8de1cdef4ecf2a65e21b14e2aa75f1e6716...a241deb19a6f5a8e95909127858b7b26cd64ae93,2,9,6,15,4,2013-05-14 20:51:43,2013-05-03 01:38:04
adf9b67e591fe1df9589412a75bad357a9410aa3...4ae96c885bd3118a1f19972b90aabbc83cf5b20b,1,3,1,4,2,2013-06-26 10:36:56,2013-06-25 21:31:10
4ae96c885bd3118a1f19972b90aabbc83cf5b20b...4bc024ddecf4e0daaa5d28155d3ad5977b98a68e,32,613,163,776,129,2013-06-26 17:48:23,2013-06-26 17:48:10
4bc024ddecf4e0daaa5d28155d3ad5977b98a68e...c16963b977b3cede4cef476c275226a513831407,9,211,34,245,42,2013-06-26 17:54:31,2013-06-17 19:19:59
a241deb19a6f5a8e95909127858b7b26cd64ae93...5deb1672f2b5794f8be19498a425ea4dc0b0711f,3,20,2,22,3,2013-05-14 20:51:43,2013-05-14 18:42:16
c16963b977b3cede4cef476c275226a513831407...38c0c47bbe280ddc42054418091571e532d82a1e,3,53,2,55,3,2013-06-26 18:15:10,2013-06-26 18:03:29
d855e9b1253c6869510790fb7e92c57c29508e8a...ef2b2a3f5205a626ad0dad9122f58da0565652b8,1,2,2,4,2,2013-05-14 21:33:56,2013-05-14 21:33:56
ef2b2a3f5205a626ad0dad9122f58da0565652b8...ca38def146c2255503103159677df40c169ccefa,1,65,0,65,1,2013-05-14 21:35:14,2013-05-14 21:35:14
ca38def146c2255503103159677df40c169ccefa...f7b10f5445248981a39f0f82e10fca7234fca08a,499,21780,20310,42090,1149,2013-05-14 21:37:59,2013-05-14 21:37:59
f7b10f5445248981a39f0f82e10fca7234fca08a...f564b6b58ae67cc4867cd3f307a63a68735d51bc,17,395,109,504,80,2013-05-14 21:41:41,2013-05-14 21:41:41
f564b6b58ae67cc4867cd3f307a63a68735d51bc...6bcf51e0302a587c6494feb3a6792fe7d2b1eea4,3,48,2,50,4,2013-05-14 23:52:47,2013-05-14 23:52:47
6bcf51e0302a587c6494feb3a6792fe7d2b1eea4...93391ae9cb162dc79d3307b0e7767f5f505a5c69,2,19,4,23,3,2013-05-15 19:05:57,2013-04-08 16:59:15
93391ae9cb162dc79d3307b0e7767f5f505a5c69...1deeab29f27ec5d11cb851e18449cfa2d634c7f5,1,4,4,8,4,2013-05-15 19:06:32,2013-04-08 16:59:58
1deeab29f27ec5d11cb851e18449cfa2d634c7f5...22533c035d0dbe8abfe699c982a1332b1bfb7b9b,2,32,12,44,10,2013-05-15 22:02:54,2013-03-21 11:19:03
22533c035d0dbe8abfe699c982a1332b1bfb7b9b...b06c82fd8825d1fb33dc40abf9448a16fef1fbca,1,2,2,4,2,2013-05-16 14:56:41,2013-04-07 08:19:50
b06c82fd8825d1fb33dc40abf9448a16fef1fbca...4cd643ee2d82d8bc2a4a7feab975b5c451ef692f,1,1,1,2,1,2013-05-16 14:56:56,2013-04-07 08:40:55
4cd643ee2d82d8bc2a4a7feab975b5c451ef692f...f59ab10a6415e7dce7a6c3b6e734c213298ec205,3,16,13,29,8,2013-05-16 15:25:24,2013-05-15 15:52:00
0449c3d0cb21ccabb987e91f043c27dac81f355a...c9644fbd7c75724f4be6c182e99f09c44b6fd3c2,1,8,2,10,3,2013-07-01 11:08:09,2013-07-01 09:42:19
c9644fbd7c75724f4be6c182e99f09c44b6fd3c2...e945903671354467bece2948c2c6c7ed2a8300cd,1,1,1,2,1,2013-07-01 11:08:09,2013-07-01 09:42:36
e945903671354467bece2948c2c6c7ed2a8300cd...0004ffa5da1437c5c104ab64c170b158e596f22d,1,1,1,2,1,2013-07-01 11:08:09,2013-07-01 09:42:57
0004ffa5da1437c5c104ab64c170b158e596f22d...086d4ccace1d28e410f9982155d6762676d14483,3,45,3,48,5,2013-07-01 11:08:09,2013-07-01 09:44:03
086d4ccace1d28e410f9982155d6762676d14483...9b09c9eedd74589111b9893f7b4154c45e027fc7,4,99,1,100,7,2013-07-01 11:08:09,2013-07-01 09:44:17
9b09c9eedd74589111b9893f7b4154c45e027fc7...6f8ddf375950f506f26e143900355871416a03e6,1,15,4,19,5,2013-07-01 22:04:56,2013-07-01 21:29:15
6f8ddf375950f506f26e143900355871416a03e6...07fbb43d78a5d193722bb544b44235cb6a6817a4,3,43,4,47,9,2013-07-03 12:15:31,2013-07-03 07:46:01
07fbb43d78a5d193722bb544b44235cb6a6817a4...c1db1ecd15fd796b68311c67288b395e7784defd,1,1,0,1,1,2013-07-03 12:16:44,2013-06-27 17:53:29
c1db1ecd15fd796b68311c67288b395e7784defd...ec90e6e80adbb9c6f31158c319eba4e35edda845,6,30,227,257,28,2013-07-03 21:56:27,2013-06-19 18:20:45
ec90e6e80adbb9c6f31158c319eba4e35edda845...fa10b757f50acc4330bffa11ad12ac46be89cbd5,6,59,17,76,18,2013-07-03 22:03:24,2013-06-20 23:44:02
fa10b757f50acc4330bffa11ad12ac46be89cbd5...278183a902d50f63e334c0ecde52c0186a523192,10,30,53,83,26,2013-07-03 22:03:41,2013-06-21 18:35:29
278183a902d50f63e334c0ecde52c0186a523192...26ca7d73ca9c45112f33579aa5a1293059010779,2,49,1,50,3,2013-07-03 22:07:01,2013-03-31 03:32:06
f59ab10a6415e7dce7a6c3b6e734c213298ec205...199fa9f8ddcb8be78673a93db8719819ab3a7deb,1,1,1,2,1,2013-05-17 20:55:29,2013-05-17 20:55:29
199fa9f8ddcb8be78673a93db8719819ab3a7deb...49300a4fa655f9d1150aba7dff08fec432e94a62,1,2,2,4,1,2013-05-17 20:56:24,2013-05-16 14:03:25
30e7d08d9316543367ca72678d8250f2afa4d105...71ade1c212365099dccb16ee7a9094261629c35a,2,5,29,34,3,2013-07-05 22:14:10,2013-07-05 22:03:04
71ade1c212365099dccb16ee7a9094261629c35a...28609d17790215ae1b7c7c59e8157ea92cd7cf2f,1,10,15,25,7,2013-07-05 23:52:30,2013-07-05 23:49:11
28609d17790215ae1b7c7c59e8157ea92cd7cf2f...f0a05e4bc39beb1a15b34dfe906fed3be37c5ac8,1,26,48,74,1,2013-07-06 11:55:46,2013-07-05 23:59:45
f0a05e4bc39beb1a15b34dfe906fed3be37c5ac8...eec43351c44c0bec31a83e1a28be15e30722936a,1,2,2,4,2,2013-07-06 22:05:04,2013-07-06 22:05:04
eec43351c44c0bec31a83e1a28be15e30722936a...704fd8f3745527fc080f96e54e5ec1857c505399,1184,168804,14270,183074,6269,2013-07-06 14:53:06,2013-07-02 15:11:31
704fd8f3745527fc080f96e54e5ec1857c505399...588040d20d87adc1dced78a3c7243b0a27ae8ec5,1,16,1,17,3,2013-07-06 14:53:06,2013-07-03 02:23:36
588040d20d87adc1dced78a3c7243b0a27ae8ec5...9b3de60d3537df657e75887436a5b1df5ed80c2d,2,8,35,43,6,2013-07-06 14:53:07,2013-07-06 12:59:15
9b3de60d3537df657e75887436a5b1df5ed80c2d...110a9cd8db515c4d1a9ac5cd8837291da7c6c5ea,43,2241,3609,5850,1355,2013-07-06 15:44:44,2013-07-03 02:23:44
110a9cd8db515c4d1a9ac5cd8837291da7c6c5ea...8985bb8bfd0c4b9fa8dcf001306f1cf7e6c886b4,1,18,14,32,8,2013-07-06 15:44:44,2013-06-29 05:16:46
8985bb8bfd0c4b9fa8dcf001306f1cf7e6c886b4...c56a96c25cabf40801a800c76b44f08d94ac839b,1,4,0,4,1,2013-07-06 15:44:44,2013-06-29 05:30:11
c56a96c25cabf40801a800c76b44f08d94ac839b...0693d22f86de01b179343cc568a5609726bef9bb,4,34,349,383,6,2013-07-06 15:44:45,2013-06-29 06:16:25
0693d22f86de01b179343cc568a5609726bef9bb...d2d07421cad4a20778bf591e279358dd0442382e,1,15,0,15,1,2013-07-06 15:44:45,2013-07-05 20:42:06
d2d07421cad4a20778bf591e279358dd0442382e...7684e0b554c7d7ee007959e250700473f64c9fa6,1,111,95,206,57,2013-07-06 15:44:45,2013-07-06 02:31:02
7684e0b554c7d7ee007959e250700473f64c9fa6...0181fee411e217236c4ec0bf22c61466df5a56b5,1,3,1,4,2,2013-07-06 16:49:02,2013-07-06 16:48:52
0181fee411e217236c4ec0bf22c61466df5a56b5...fe176929c2963d1e48d34e8f2cb367d9801395a0,1,2,2,4,2,2013-07-08 01:25:48,2013-07-08 01:20:07
fe176929c2963d1e48d34e8f2cb367d9801395a0...82ff891e226ecadde68d000a12e7eb1fd0a17d13,1,6,3,9,3,2013-07-08 04:12:07,2013-07-08 04:11:22
82ff891e226ecadde68d000a12e7eb1fd0a17d13...58e4edaf6855025099d400ccc1ac23291b109a41,7,646,2,648,9,2013-07-06 20:20:29,2013-07-06 20:18:39
58e4edaf6855025099d400ccc1ac23291b109a41...aa8c4a0766d4ae501433f0af5ec4d4d00300ea97,1,9,8,17,1,2013-07-08 16:17:22,2013-07-05 23:31:27
aa8c4a0766d4ae501433f0af5ec4d4d00300ea97...ead8e26b5bcafdbb978fcfc36853d4f88a9848b5,1,31,6,37,11,2013-07-08 18:09:09,2013-07-05 23:21:09
ead8e26b5bcafdbb978fcfc36853d4f88a9848b5...22668db73d1accf1e9332b6b780b84a144277888,3,8,11,19,8,2013-07-08 23:53:41,2013-07-08 23:53:41
22668db73d1accf1e9332b6b780b84a144277888...2fc34d75d96e2082a06490f8f08862e47a5cef35,1,2,1,3,1,2013-07-09 00:13:02,2013-07-08 05:03:57
2fc34d75d96e2082a06490f8f08862e47a5cef35...b8ce1da74d6ca01a7da2921b5911aa05aeaa6582,2,23,1,24,4,2013-07-09 06:12:52,2013-07-09 03:58:39
b8ce1da74d6ca01a7da2921b5911aa05aeaa6582...567c72b8c5f2650cc0d18b54afcfe84b692c5448,2,3,3,6,4,2013-07-09 18:27:37,2013-07-06 03:53:23
567c72b8c5f2650cc0d18b54afcfe84b692c5448...48e159faf2f9cc952474a99e6146ae2486c28115,1,1,7,8,3,2013-07-09 18:27:38,2013-07-08 02:11:07
48e159faf2f9cc952474a99e6146ae2486c28115...6176e49181fcf81eb22919e2880b503d3f70e738,1,9,3,12,6,2013-07-10 05:31:11,2013-05-15 21:24:08
6176e49181fcf81eb22919e2880b503d3f70e738...9fc9b87472806147b83c24d85b303c4f75d3021c,3,149,8,157,9,2013-07-10 05:31:11,2013-05-15 22:10:53
9fc9b87472806147b83c24d85b303c4f75d3021c...40e92650bb97b736b8e29c5de35c1c29ebd625ef,5,136,29,165,18,2013-07-10 05:31:11,2013-05-21 21:02:18
40e92650bb97b736b8e29c5de35c1c29ebd625ef...49519f121787d51394f00c871f854794e409bdda,9,128,86,214,55,2013-07-10 05:31:11,2013-05-23 01:44:24
49519f121787d51394f00c871f854794e409bdda...831de7cbb911ebae58237babed22a672dc6a9da0,3,13,17,30,4,2013-07-10 05:31:11,2013-05-30 23:08:03
831de7cbb911ebae58237babed22a672dc6a9da0...3220bc4254f53dec3a8c73a3a691fcfee56d8c8b,1,23,19,42,12,2013-07-07 11:30:20,2013-07-09 16:54:10
3220bc4254f53dec3a8c73a3a691fcfee56d8c8b...636ca7c68412f667a72328bbe1e110d99b58a690,8,55,33,88,28,2013-07-07 12:24:18,2013-07-07 12:24:18
636ca7c68412f667a72328bbe1e110d99b58a690...6acde2152fa5cc33ed87825c85ee59bdafd94cf7,5,11,11,22,9,2013-07-07 12:34:49,2013-07-07 12:34:49
6acde2152fa5cc33ed87825c85ee59bdafd94cf7...c679ac8f0089e2228e8f248cade91ec99cd424cb,5,46,59,105,12,2013-07-11 13:37:02,2013-07-11 13:37:00
c679ac8f0089e2228e8f248cade91ec99cd424cb...fa46483fe203f56dccd6e122573857cc2c322220,1,14,8,22,5,2013-07-12 05:22:56,2013-07-11 22:58:11
fa46483fe203f56dccd6e122573857cc2c322220...f88b8dad84cd8f37000e55f0b5de7963cbb252cf,2,59,5,64,2,2013-07-12 05:22:56,2013-07-11 23:04:49
f88b8dad84cd8f37000e55f0b5de7963cbb252cf...9da67fa5198f3c0839904ae05cbfe88c61b3ad09,1579,10913,57465,68378,3125,2013-07-12 15:56:59,2013-07-12 15:56:59
49300a4fa655f9d1150aba7dff08fec432e94a62...d2fdae197ac542f686ee06835d1153dd43b862e5,3,17,2,19,3,2013-05-17 20:59:10,2013-05-17 20:59:10
48c542db523d88c79f62c6346b91bdf4b828ff6b...b5b84197ed037918fd1a26e5cb87cce7c812ca55,2,37,1,38,2,2013-07-12 20:51:04,2013-07-12 20:51:04
cc7ec075e9171706962feb60dfa331669aa9a170...bae6d089a4d094434c7f5c9549a51aa70076eb15,1,2,2,4,2,2013-05-17 21:37:44,2013-05-17 21:37:44
bae6d089a4d094434c7f5c9549a51aa70076eb15...77de20708935d33123ac97f135d90197db8e800c,1,65,0,65,1,2013-05-17 21:38:02,2013-05-17 21:38:02
77de20708935d33123ac97f135d90197db8e800c...f57ff787aafc0ac20b489acd1ec4dc9d09193000,1,1,2,3,1,2013-05-17 23:58:05,2013-05-17 23:58:05
f57ff787aafc0ac20b489acd1ec4dc9d09193000...d5d5170c359fc96f36650cdd9b84cbb013c33735,2,11,8,19,4,2013-05-20 20:40:58,2013-05-20 19:35:31
d5d5170c359fc96f36650cdd9b84cbb013c33735...3a2b5030ae1cd200e92eaf3928bd20a8deda50c6,2,21,12,33,6,2013-05-20 21:27:32,2013-05-18 00:19:12
31109808ea0b0fe6191499062d21e86ee2fbb6fe...81c2a3643954e782d897f6091652200341f8a941,1,2,2,4,2,2013-07-12 22:17:16,2013-07-12 22:17:16
81c2a3643954e782d897f6091652200341f8a941...c898704db18fd3b8d7dd91bf7c1b74922c5de928,1,1,1,2,1,2013-07-12 22:18:53,2013-07-12 22:18:53
c898704db18fd3b8d7dd91bf7c1b74922c5de928...2c47030174b109cbb66fbfe4cd88215a0a458d0b,3,12,50,62,10,2013-07-13 12:08:23,2013-07-13 12:07:26
2c47030174b109cbb66fbfe4cd88215a0a458d0b...be940b45016380322430411b19a354867f0f9ef2,1,0,2,2,1,2013-07-15 18:08:23,2013-07-15 18:08:23
be940b45016380322430411b19a354867f0f9ef2...bd5ab9c601f0fa19486195698b6cd0297199da4d,1,18,3,21,5,2013-07-16 20:02:54,2013-07-13 22:20:27
3a2b5030ae1cd200e92eaf3928bd20a8deda50c6...2cad7a69ce3228b1e40f3bf8117ca739a5d6929d,2,13,0,13,2,2013-05-20 22:23:23,2013-05-20 21:37:55
2cad7a69ce3228b1e40f3bf8117ca739a5d6929d...f46ad012bc5a40194242ea1e9669c9cc25bd7047,1,108,0,108,1,2013-05-21 23:40:30,2013-05-17 22:04:24
f46ad012bc5a40194242ea1e9669c9cc25bd7047...a846d9388cbdf298f17b341d0ed669c1852185a8,2,54,7,61,8,2013-05-21 23:40:31,2013-05-17 22:07:28
a846d9388cbdf298f17b341d0ed669c1852185a8...99b737bd60a5c3c4e0569d7c24fae0326fda548d,1,19,13,32,13,2013-05-22 01:38:11,2013-05-21 16:26:42
99b737bd60a5c3c4e0569d7c24fae0326fda548d...89dcf22526044918ae3f79f6728ad4e603a1d710,1,1,0,1,1,2013-05-22 11:47:29,2013-05-22 11:47:29
89dcf22526044918ae3f79f6728ad4e603a1d710...fda2b319dc8a5dae528f8b12096911b71a0282db,2,87,2,89,3,2013-05-23 00:13:26,2013-05-22 19:43:35
fda2b319dc8a5dae528f8b12096911b71a0282db...279361b27729118481ca2e2fecc2c3f930c56f41,13,49,49,98,29,2013-05-23 20:39:12,2013-05-23 20:39:12
279361b27729118481ca2e2fecc2c3f930c56f41...dbe142c4eda0f15fad9fa85743dd11b81292fa8f,1,1,1,2,1,2013-05-23 21:00:19,2013-05-23 20:57:59
dbe142c4eda0f15fad9fa85743dd11b81292fa8f...e2385839d7bde937334e34da082293cae877fe2f,10,48,31,79,25,2013-05-23 21:00:20,2013-05-23 20:40:40
e2385839d7bde937334e34da082293cae877fe2f...a2f93cf77a8121db713bb003e26031bcca446f1f,2,96,1,97,2,2013-05-23 22:21:17,2013-05-23 22:12:13
a2f93cf77a8121db713bb003e26031bcca446f1f...007e63bb13b5d3af54081972ab88217571828906,2,16,1,17,2,2013-05-23 23:32:04,2013-05-23 23:23:07
007e63bb13b5d3af54081972ab88217571828906...a40133d10cdb911b27fe8d46d67a835b0103bbf1,6,28,17,45,22,2013-05-24 21:34:32,2013-05-24 17:34:38
a40133d10cdb911b27fe8d46d67a835b0103bbf1...1314c4aeeb96f59b010ca8fef2e8e86bbc1f398c,8,136,32,168,27,2013-05-24 21:41:00,2013-05-24 21:41:00
1314c4aeeb96f59b010ca8fef2e8e86bbc1f398c...074e823a81f2b1a5c954b0d6dfc5e10a4bed96ab,106,115,114,229,110,2013-05-24 21:41:43,2013-05-24 21:41:43
074e823a81f2b1a5c954b0d6dfc5e10a4bed96ab...f7ff8b4454513557ca8854cb1bf8a3539946fd11,2,58,1,59,3,2013-05-24 22:03:48,2013-05-24 21:02:34
f7ff8b4454513557ca8854cb1bf8a3539946fd11...179aa0a8f2cc19d1652febd9fab973d2d13c50d4,1,0,1,1,1,2013-05-24 22:06:12,2013-05-24 22:06:03
e71d9fd8342fef87a7624022da57034d591da153...46d11510ad6ea9a1fd9ffeafbe9e2345fabc8e93,1,4,1,5,1,2013-07-19 19:47:06,2013-07-19 19:47:06
46d11510ad6ea9a1fd9ffeafbe9e2345fabc8e93...d817843d2e0d8f9708620c76c471fc5e94f84264,10,298,125,423,36,2013-07-19 20:36:13,2013-07-12 22:18:21
d817843d2e0d8f9708620c76c471fc5e94f84264...2b7d86ec7369804af9ab5549e20d6ff021679e95,1,10,3,13,3,2013-07-19 20:56:28,2013-07-19 10:46:11
2b7d86ec7369804af9ab5549e20d6ff021679e95...db13983e68840b59705748f5321fdd1927bffd98,1,1,0,1,1,2013-07-19 20:56:28,2013-06-02 13:11:46
db13983e68840b59705748f5321fdd1927bffd98...2bedf6efb16deed2e5693c38fde75611826552aa,4,11,5,16,7,2013-07-19 20:56:28,2013-07-19 20:35:23
2bedf6efb16deed2e5693c38fde75611826552aa...4a34c69cbf471f0c7f470a7fb2569f5ed06ee2cc,3,32,8,40,19,2013-07-19 21:05:46,2013-07-12 23:29:54
4a34c69cbf471f0c7f470a7fb2569f5ed06ee2cc...d11e7c2075075aff7b6d1c39e46dfb69ff203315,1,2,2,4,2,2013-07-19 21:41:35,2013-06-04 10:45:12
d11e7c2075075aff7b6d1c39e46dfb69ff203315...221c689ebbac9bda42c005b7f0278ce420766b22,3,12,7,19,6,2013-07-19 21:41:35,2013-06-06 02:31:12
221c689ebbac9bda42c005b7f0278ce420766b22...0e48cb4998a89a2adae95d97f3bce5f89c77d762,132,3206,2991,6197,1525,2013-07-20 10:04:35,2013-07-16 19:04:31
0e48cb4998a89a2adae95d97f3bce5f89c77d762...d4c14c1fe5402b8c3b1d582070ccbf3ae40f5b1f,3,63,3,66,5,2013-07-20 10:04:35,2013-07-16 21:08:25
d4c14c1fe5402b8c3b1d582070ccbf3ae40f5b1f...0161ec87af3d71b10d8ce679c8a1a64358fae8dc,8,28,92,120,18,2013-07-20 10:04:35,2013-07-16 21:28:38
0161ec87af3d71b10d8ce679c8a1a64358fae8dc...ca9eb718fbf2cd2c60c7aeb3ca33413e17fcbbf0,25,725,781,1506,353,2013-07-20 10:09:29,2013-07-18 21:18:50
ca9eb718fbf2cd2c60c7aeb3ca33413e17fcbbf0...e1fe8d4ec08cc2576dd8ecd305f3f5654647a65e,7,26,67,93,15,2013-07-20 10:13:54,2013-07-19 21:33:06
e1fe8d4ec08cc2576dd8ecd305f3f5654647a65e...d75f67f949f2e3b7564671f02cb2ab8e86205e13,3,103,104,207,51,2013-07-20 10:13:54,2013-07-19 21:59:41
d75f67f949f2e3b7564671f02cb2ab8e86205e13...254b711155996e379a41a569a38dd98dbd7a6e47,1,2,3,5,2,2013-07-20 19:45:24,2013-07-20 19:42:20
254b711155996e379a41a569a38dd98dbd7a6e47...5777d7ab3038983d368046ab40eb34075f635348,463,22900,11467,34367,3547,2013-07-22 22:53:10,2013-07-22 22:26:27
5777d7ab3038983d368046ab40eb34075f635348...dfb1191f2273589c159f0ebcc602559cba8608b4,1,1,1,2,1,2013-07-22 22:53:43,2013-07-22 22:53:43
dfb1191f2273589c159f0ebcc602559cba8608b4...e3bb6e11c3b8bf1141499577c51259a53a54e340,1,16,1,17,3,2013-07-22 22:56:44,2013-07-03 02:23:36
e3bb6e11c3b8bf1141499577c51259a53a54e340...5fcd6e40385f45bc9091689337a7ab531861ba19,1,1,2,3,1,2013-07-22 23:07:40,2013-07-20 05:56:31
5fcd6e40385f45bc9091689337a7ab531861ba19...0f8de5e1f96a07fa6de837378d29ac5f2719ec60,11,433,201,634,91,2013-07-22 23:17:30,2013-07-18 01:24:02
0f8de5e1f96a07fa6de837378d29ac5f2719ec60...35e0d60d0cc654d88f05de6229ef7913bf2ba5e1,3,18,7,25,7,2013-07-23 00:27:59,2013-07-23 00:04:17
35e0d60d0cc654d88f05de6229ef7913bf2ba5e1...d904c231b6f5c4a0fd9c086c5e0d9a67e3e62866,1,11,0,11,2,2013-07-23 01:43:06,2013-07-04 14:22:31
d904c231b6f5c4a0fd9c086c5e0d9a67e3e62866...d74932e51837f87ef57c44204ccab2c3c2f05fa1,1,4,6,10,1,2013-07-23 17:43:48,2013-07-23 17:43:48
d74932e51837f87ef57c44204ccab2c3c2f05fa1...8ce02cf0aa218b43077d2deb851a85739d625248,1,17,27,44,19,2013-07-23 18:02:47,2013-07-23 18:02:47
8ce02cf0aa218b43077d2deb851a85739d625248...c76ed643484fc2e94e0533bcc2aec3e041372047,1,2,1,3,2,2013-07-24 16:17:10,2013-07-23 23:56:22
c76ed643484fc2e94e0533bcc2aec3e041372047...d8240769c6593e4dd6cff3b9e41d35f869c83eed,1,0,10,10,2,2013-07-24 16:49:47,2013-07-24 16:48:48
d8240769c6593e4dd6cff3b9e41d35f869c83eed...4b279f00921b251f58ff7213c6a1518c66281747,2,8,9,17,2,2013-07-24 19:49:18,2013-07-24 10:53:28
4b279f00921b251f58ff7213c6a1518c66281747...457d52924152c6f2baf2fddbe76a03bca7bdde7c,1,2,1,3,2,2013-07-24 19:49:34,2013-07-24 16:13:25
457d52924152c6f2baf2fddbe76a03bca7bdde7c...0330bdf5195eb77f04c26a09a8bd2088a261fe53,38,409,432,841,342,2013-07-24 19:49:35,2013-07-24 16:03:53
0330bdf5195eb77f04c26a09a8bd2088a261fe53...44ed42bd971d58b294222d983cfe2908e021fb5d,2,10,8,18,4,2013-07-24 20:17:35,2013-07-24 20:13:43
44ed42bd971d58b294222d983cfe2908e021fb5d...509cfbc2b73e9ef0f732ed12ebdc58546348b9c2,1,14,2,16,5,2013-07-24 21:15:59,2013-07-21 03:09:47
509cfbc2b73e9ef0f732ed12ebdc58546348b9c2...d62c2d975a2788fd565eca024d80291cc5d7b2ee,4,187,0,187,7,2013-07-24 21:16:00,2013-07-21 03:11:02
d62c2d975a2788fd565eca024d80291cc5d7b2ee...508a6c2eeec71310910fb2dc804a3c4b9f02de42,10,11113,5148,16261,155,2013-07-25 14:27:26,2013-07-25 14:27:26
508a6c2eeec71310910fb2dc804a3c4b9f02de42...993bb93e0a58279bba482c40da9a114cfd467f55,6,73,23,96,17,2013-07-25 20:14:49,2013-07-24 23:05:54
993bb93e0a58279bba482c40da9a114cfd467f55...7d654be627f187f10c8df6b2a1020f88860202be,1,1,1,2,1,2013-07-25 23:17:41,2013-07-24 18:17:28
7d654be627f187f10c8df6b2a1020f88860202be...d713db245b7a2492a1ac91029945d2d0414169ca,1,2,1,3,1,2013-07-27 00:55:55,2013-07-26 21:48:57
d713db245b7a2492a1ac91029945d2d0414169ca...2b569deed32d7f601e9c5af0415e842e1440d46e,1,0,1,1,1,2013-07-28 09:36:13,2013-07-28 09:36:12
2b569deed32d7f601e9c5af0415e842e1440d46e...04f87de3da3b2fcc1367a1e97acf23485fb8c126,4,117,70,187,16,2013-07-28 12:50:17,2013-07-28 10:19:34
04f87de3da3b2fcc1367a1e97acf23485fb8c126...e5233939be16c50e5676d8c84421a53f453f4b37,2,100,0,100,2,2013-07-28 12:52:01,2013-07-28 12:50:03
e5233939be16c50e5676d8c84421a53f453f4b37...8f571b52a74dd4f86906f21141cb003de2180828,1,0,4,4,2,2013-07-28 17:07:59,2013-07-28 17:07:59
8f571b52a74dd4f86906f21141cb003de2180828...38176d3a1aa84cd2e7566673a965b966dc69a269,1,1,1,2,1,2013-07-29 09:33:01,2013-07-29 09:33:01
38176d3a1aa84cd2e7566673a965b966dc69a269...c13bfdc0913d5828c049d727b1890fc9e398724c,2,8,0,8,2,2013-07-29 14:41:56,2013-07-29 14:20:24
c13bfdc0913d5828c049d727b1890fc9e398724c...17fbd6cd66453da565d77ab557188eab479dab15,1,4,4,8,4,2013-07-29 15:34:13,2013-07-29 15:34:12
17fbd6cd66453da565d77ab557188eab479dab15...1bd711c8a09e327946f2eca5030e9710dc0e1e6e,310,21550,3932,25482,1485,2013-07-29 19:21:03,2013-07-29 19:21:03
1bd711c8a09e327946f2eca5030e9710dc0e1e6e...34b0a36120a039968a87342b048d1596782524b0,5,7,112,119,10,2013-07-29 03:11:00,2013-07-29 03:07:07
34b0a36120a039968a87342b048d1596782524b0...6bd922fce83d505e44ee3706df9a78c0ad449d64,5,49,19,68,7,2013-07-29 04:48:46,2013-06-26 22:43:23
6bd922fce83d505e44ee3706df9a78c0ad449d64...dc9acd4faeba1aade414bdd8da28f30b16773575,1,1,1,2,1,2013-07-30 11:29:20,2013-07-30 11:28:48
179aa0a8f2cc19d1652febd9fab973d2d13c50d4...30d9e9fdd9d4c33d3d95a129d021cd8b5b91eddb,3,26,2,28,3,2013-05-24 22:06:33,2013-05-24 21:45:24
b8c04b921b626edd4201f805d0feb384c8e91ea7...2fc47ab10bdbcfb39521d04cf5417520e0035163,210,12282,1656,13938,635,2013-07-30 15:14:55,2013-07-30 15:14:55
2fc47ab10bdbcfb39521d04cf5417520e0035163...511af4dd5fb4d48f1aeabcd93b09fb1f2738e1b2,4,14,12,26,13,2013-07-30 19:31:04,2013-07-30 19:28:43
511af4dd5fb4d48f1aeabcd93b09fb1f2738e1b2...71b3138925fd19d23ae1d2e7223590239d0eebb0,1,0,1,1,1,2013-07-30 19:32:45,2013-07-30 19:32:43
71b3138925fd19d23ae1d2e7223590239d0eebb0...8111ca2f9fd89772581c1ec8c0ee8005269f59ff,3,89,85,174,65,2013-07-30 20:03:49,2013-07-30 19:42:47
8111ca2f9fd89772581c1ec8c0ee8005269f59ff...4cc57b4aca65ea86f4e42ddaeadfa796db239719,2,29,32,61,17,2013-07-29 18:49:28,2013-07-29 18:36:11
4cc57b4aca65ea86f4e42ddaeadfa796db239719...3ff2cbc892ce2d6aa01a986963f8437b8070b085,26,515,100,615,104,2013-07-30 21:33:45,2013-07-30 21:32:53
3ff2cbc892ce2d6aa01a986963f8437b8070b085...63fc6a63c8046081099aa1dadf9155398a498163,2,9,2,11,3,2013-07-30 21:41:01,2013-07-02 07:07:47
63fc6a63c8046081099aa1dadf9155398a498163...7ca77eaf38cbf6da451a0fb50c0940a47b642ae4,4,179,72,251,36,2013-07-30 21:42:30,2013-07-02 07:27:26
7ca77eaf38cbf6da451a0fb50c0940a47b642ae4...2cd7adc7f44e4dfe440162a31a168e6aa9a8cea1,3,14,2,16,3,2013-07-29 19:59:15,2013-07-29 19:00:33
2cd7adc7f44e4dfe440162a31a168e6aa9a8cea1...6a5a7b089ea77c0001bee3b38e657901364a0b5f,2,32,23,55,21,2013-07-31 16:25:19,2013-07-30 22:06:45
6a5a7b089ea77c0001bee3b38e657901364a0b5f...3c6b5d5df1e445d080737e435675e11b102f0126,1,18,13,31,7,2013-07-31 18:12:06,2013-07-31 18:05:31
3c6b5d5df1e445d080737e435675e11b102f0126...8e29ce9f13f7e4b6c0296325287c05f78ff22ce0,63,964,875,1839,398,2013-07-31 18:12:06,2013-07-31 18:07:29
8e29ce9f13f7e4b6c0296325287c05f78ff22ce0...ccf8f3eebc1dce961105523207b38f4bd78b768b,1,11,1,12,3,2013-07-31 18:12:06,2013-07-31 10:54:06
ccf8f3eebc1dce961105523207b38f4bd78b768b...6caf012d595c41d632c1125089059f42ddd14208,1,3,0,3,1,2013-07-31 18:35:46,2013-07-31 18:35:46
6caf012d595c41d632c1125089059f42ddd14208...58159e308b2356265faed168909122c4ef0f61d4,1,1,1,2,1,2013-07-31 19:50:09,2013-07-31 18:28:29
58159e308b2356265faed168909122c4ef0f61d4...847c6d980c83274b6c37e29a07d19a696435588b,1,29,30,59,8,2013-07-31 20:34:35,2013-07-31 20:34:34
847c6d980c83274b6c37e29a07d19a696435588b...02cab97490690610ab5c4ce5d76208d415f0d2c4,22,121,122,243,84,2013-07-31 21:16:26,2013-07-31 21:16:08
02cab97490690610ab5c4ce5d76208d415f0d2c4...168ca527be160c5d4287546198a8e407b300adce,2,4,2,6,3,2013-08-01 09:39:25,2013-08-01 09:39:25
168ca527be160c5d4287546198a8e407b300adce...6430c3f55dd09625b576ec08a1e234fd785c184b,1,1,0,1,1,2013-08-01 09:53:41,2013-08-01 09:53:41
6430c3f55dd09625b576ec08a1e234fd785c184b...1ef1be376c1e64d00bd61e746de5315d54c38315,1,0,1,1,1,2013-08-01 10:26:24,2013-08-01 10:26:23
1ef1be376c1e64d00bd61e746de5315d54c38315...a622bde9e62aec58793f08d804783515cb5e735e,1,5,3,8,3,2013-08-01 10:33:35,2013-08-01 10:33:33
a622bde9e62aec58793f08d804783515cb5e735e...30701d6e7478362d9748755267af24ae34a822f6,2,34,18,52,4,2013-08-01 10:47:05,2013-07-31 23:13:36
30701d6e7478362d9748755267af24ae34a822f6...dda22a520b8f9247938acd9d791d28bc1da8b450,3,95,17,112,16,2013-08-01 12:06:45,2013-07-21 16:16:26
dda22a520b8f9247938acd9d791d28bc1da8b450...76ada45342db20947ec638659276e39762b22c15,1,4,2,6,2,2013-08-01 20:53:19,2013-08-01 20:53:19
76ada45342db20947ec638659276e39762b22c15...9a29aa8c552eb2b120c101c1cfd66ba565a17ed5,1,3,4,7,2,2013-08-01 22:02:38,2013-08-01 22:02:38
9a29aa8c552eb2b120c101c1cfd66ba565a17ed5...22c68fdc1dae40f0ed9c71a02f66e5b2c6353691,38,439,389,828,366,2013-08-01 22:08:01,2013-07-26 21:38:08
22c68fdc1dae40f0ed9c71a02f66e5b2c6353691...e772a7deaf8e495160d9d3238387834b0871c434,1,1,1,2,1,2013-08-02 11:54:39,2013-08-02 11:52:20
e772a7deaf8e495160d9d3238387834b0871c434...3158ffb6ef153c0e76f4a6b5b98e91a8315c197c,1,5,0,5,1,2013-08-02 19:52:34,2013-08-02 19:52:34
3158ffb6ef153c0e76f4a6b5b98e91a8315c197c...da07709c74b7a695fa2155718a9d9b193ffd169a,2,35,4,39,9,2013-08-02 19:52:43,2013-08-02 19:52:43
da07709c74b7a695fa2155718a9d9b193ffd169a...2dafa193ee9fb64a33fe5d86f199b9df06236600,1,2,5,7,2,2013-08-02 20:00:54,2013-08-02 20:00:54
2dafa193ee9fb64a33fe5d86f199b9df06236600...78d90945d6c203a85402698258d96897379694e6,8,19,25,44,18,2013-08-02 21:16:00,2013-08-02 21:12:56
78d90945d6c203a85402698258d96897379694e6...c80f8fa8f108d8db598b260ddf26bafd2ec8a1f8,1,35,25,60,16,2013-08-02 21:17:29,2013-08-01 21:53:52
c80f8fa8f108d8db598b260ddf26bafd2ec8a1f8...350fc8064e3dfbd5723f5d952102a010cae94510,1,5,10,15,5,2013-08-02 23:30:42,2013-08-02 23:28:51
350fc8064e3dfbd5723f5d952102a010cae94510...e5791f74f0bb3f52efa5429b5ae9425cbde46f97,1,6,3,9,6,2013-08-03 10:04:55,2013-08-03 09:09:02
e5791f74f0bb3f52efa5429b5ae9425cbde46f97...d4cc30f18c2bf446c31ee8f7d05260a1c540fd1a,5,12,7,19,9,2013-08-03 20:23:28,2013-08-03 20:18:35
d4cc30f18c2bf446c31ee8f7d05260a1c540fd1a...5383e7588520dfcbb4372235ffa87d88101e1507,5,9,10,19,6,2013-08-03 20:50:16,2013-08-03 20:50:15
5383e7588520dfcbb4372235ffa87d88101e1507...ea7b817266512b93b99032189984a3bd0f8386dc,2,131,4,135,5,2013-08-04 10:11:28,2013-08-02 16:11:17
ea7b817266512b93b99032189984a3bd0f8386dc...222e5239fc5fc699cc5b4c2aa34377a52c699670,1,6,2,8,4,2013-08-05 00:53:43,2013-08-05 00:50:45
222e5239fc5fc699cc5b4c2aa34377a52c699670...32fdae2ca3bd4df057ae01b7cd78961968fa0fd0,2,3,2,5,2,2013-08-05 19:33:19,2013-08-05 19:33:19
32fdae2ca3bd4df057ae01b7cd78961968fa0fd0...72ad2c94df3f67674076b9d81b4e30f0cf448266,3,88,25,113,13,2013-08-05 19:53:12,2013-08-04 06:39:50
72ad2c94df3f67674076b9d81b4e30f0cf448266...f4b1e00071ce8f41acb75842f2df4a845f6ef531,1,0,0,0,0,2013-08-05 19:55:31,2013-08-05 19:55:31
f4b1e00071ce8f41acb75842f2df4a845f6ef531...e851fef60f5368927ea0a6b7bfc984ef18e93d6f,8,5132,0,5132,10,2013-08-05 21:19:29,2013-07-17 20:46:25
e851fef60f5368927ea0a6b7bfc984ef18e93d6f...032373df7fb5de03f24fe549484cc3e6930bf0e7,1,1,1,2,1,2013-08-05 21:33:55,2013-08-05 21:33:55
032373df7fb5de03f24fe549484cc3e6930bf0e7...13ed817fec5792c7272d9a149ad45cfeddea5638,1,1,1,2,1,2013-08-06 00:03:08,2013-08-02 16:57:46
13ed817fec5792c7272d9a149ad45cfeddea5638...6942a95ae1863503ad050113581b6eb708a3a6f3,1,1,1,2,1,2013-08-06 00:03:08,2013-08-05 21:09:32
6942a95ae1863503ad050113581b6eb708a3a6f3...8e28193cc239a8389a1edda6810402005c1336cc,8,535,413,948,36,2013-08-06 12:13:01,2013-08-02 12:16:13
8e28193cc239a8389a1edda6810402005c1336cc...048e0e77e0c341407ecea364cbe26c8f77be48b8,8,162,36,198,40,2013-08-06 12:13:01,2013-08-03 17:29:54
048e0e77e0c341407ecea364cbe26c8f77be48b8...576496632c96628eb47e8650987edf01d765a6ab,1,1,1,2,1,2013-08-06 13:39:43,2013-08-06 13:36:12
576496632c96628eb47e8650987edf01d765a6ab...45d056ee69568fd3d5758e3eb2e0252e17063a53,1,2,2,4,2,2013-08-06 13:47:44,2013-08-06 13:47:42
45d056ee69568fd3d5758e3eb2e0252e17063a53...b8a7eedea32df6f31704cb59f01c51c629bb958b,1,3,4,7,2,2013-08-06 15:51:22,2013-08-06 15:42:28
83a89430367b4c54e5550228b566b89d4ccd1fad...ccb77e1c9d5793992b07666855956c5d2cf90fce,1,2,2,4,2,2013-05-24 22:45:46,2013-05-24 22:45:46
ccb77e1c9d5793992b07666855956c5d2cf90fce...f904d614bf62d4bbf9c3adffb485f84d5c77c2d8,1,75,0,75,1,2013-05-24 22:45:59,2013-05-24 22:45:59
b26d346b57fc1964bc4b20d522a7bc2b68edb1be...166c405b33320a0d6aceca6dc356fc26dc8a1da1,1,2,9,11,4,2013-08-06 20:57:32,2013-08-06 16:30:21
f904d614bf62d4bbf9c3adffb485f84d5c77c2d8...14b10c40ac113c01d3831266388daf962fe7f02c,1,0,8,8,1,2013-05-25 11:30:30,2013-05-25 04:01:25
14b10c40ac113c01d3831266388daf962fe7f02c...28f4c15eb49e9b7f1a430f39f0f930c38adeff60,1,4,2,6,2,2013-05-25 11:30:34,2013-05-25 03:49:49
28f4c15eb49e9b7f1a430f39f0f930c38adeff60...fa170dd2b241bc0f22f88071158686075c3b269e,3,47,11,58,14,2013-05-28 16:14:44,2013-05-28 13:50:38
fa170dd2b241bc0f22f88071158686075c3b269e...4f14221f03516b30ea4fba3117f7f9e169ac82da,2,144,27,171,15,2013-05-28 18:27:07,2013-05-27 10:44:33
4f14221f03516b30ea4fba3117f7f9e169ac82da...f523f7041dc8c2b3c2e9be35b437ffa486f952a7,5,43,11,54,13,2013-05-28 19:10:14,2013-05-28 19:10:14
f523f7041dc8c2b3c2e9be35b437ffa486f952a7...30cb9fec918112b07b695e4830b8aa0b43fa3ac5,1,5,0,5,2,2013-05-28 19:40:52,2013-05-15 19:14:20
30cb9fec918112b07b695e4830b8aa0b43fa3ac5...675e85813f2c2083f9b401fadbf1b56c144c986b,1,4,0,4,2,2013-05-28 19:43:37,2013-05-15 19:16:09
675e85813f2c2083f9b401fadbf1b56c144c986b...9826b1549396ed05011d523ab5bf7a344b8cb8b6,1,1,1,2,1,2013-05-29 14:35:01,2013-05-29 14:35:00
166c405b33320a0d6aceca6dc356fc26dc8a1da1...e3c5019ac70cbd23f1104a8d911ceae1e8990842,1,1,1,2,1,2013-08-06 22:42:47,2013-08-06 22:42:47
166c405b33320a0d6aceca6dc356fc26dc8a1da1...fa8efa98de86ab2f069e055cc20d3d819a3c7f29,12,113,6,119,14,2013-08-06 21:35:33,2013-08-06 21:35:33
fa8efa98de86ab2f069e055cc20d3d819a3c7f29...6f92da2dd106b0c63fde563284f83e08e2a521b5,3,45,2,47,3,2013-08-06 21:41:21,2013-08-06 21:41:21
9826b1549396ed05011d523ab5bf7a344b8cb8b6...9ee86b718c8079474b2647385404042fd94fd116,1,33,22,55,7,2013-05-30 09:50:13,2013-05-30 09:35:24
9ee86b718c8079474b2647385404042fd94fd116...774b28fde7035b076f5d80ade2ea293b18f2084b,2,4,2,6,2,2013-05-30 12:41:00,2013-05-26 16:26:39
774b28fde7035b076f5d80ade2ea293b18f2084b...36e90da6df56d6efeb12a38c1ed092eede4182a5,1,0,1,1,1,2013-05-30 13:10:03,2013-05-22 14:22:21
36e90da6df56d6efeb12a38c1ed092eede4182a5...c86afa5d2eeeb841f879fb4903484dabb769862a,280,20530,895,21425,367,2013-05-30 17:19:45,2013-05-30 17:19:45
7aa4242844ceea4a5310df4289b4dd76c8074008...536037369e5787dfe6bd2e3149480f2d1795f047,1,2,2,4,2,2013-08-07 00:13:47,2013-08-07 00:13:47
536037369e5787dfe6bd2e3149480f2d1795f047...c079f6e21044053066a46c0533a6835c094aa706,2,4,6,10,4,2013-08-07 12:46:55,2013-08-07 12:45:37
c079f6e21044053066a46c0533a6835c094aa706...4692b725deaf263aac79e8959ce4ca2a2285f3a0,1,3,3,6,3,2013-08-07 12:53:50,2013-08-07 12:53:49
4692b725deaf263aac79e8959ce4ca2a2285f3a0...da5ad92ab221e45648c871cf488e0699b5708288,3,84,72,156,46,2013-08-07 15:16:47,2013-08-07 15:14:16
da5ad92ab221e45648c871cf488e0699b5708288...54a9ec4ef09f51c0903af515aa2404922d9f73f0,3,19,11,30,8,2013-08-07 15:27:35,2013-08-07 15:21:25
54a9ec4ef09f51c0903af515aa2404922d9f73f0...d24decb87ba736a33234713c1d824c9d05b48cce,9,0,20,20,9,2013-08-07 16:03:14,2013-08-07 16:03:13
d24decb87ba736a33234713c1d824c9d05b48cce...12cd13312b1bd1ea1642c0058bbc14be72c347f0,1,9,0,9,1,2013-08-07 17:29:15,2013-08-07 17:23:45
12cd13312b1bd1ea1642c0058bbc14be72c347f0...b9150344ac35c77debb1c915a1b44df085c5cc29,1,6,5,11,1,2013-08-07 19:33:21,2013-08-07 19:30:46
b9150344ac35c77debb1c915a1b44df085c5cc29...cd00064566f1233aee27896e8aac91097b37b3c7,2,21,24,45,12,2013-08-07 19:52:56,2013-08-02 17:11:35
cd00064566f1233aee27896e8aac91097b37b3c7...cec81593d7e42c83b9498be5835defb24d1743bd,5,300,39,339,45,2013-08-07 19:53:24,2013-07-19 23:15:25
cec81593d7e42c83b9498be5835defb24d1743bd...967b5dbb453f811060645c9bd2bcc8ca8fef0d96,6,48,45,93,32,2013-08-08 20:01:09,2013-07-26 02:33:15
967b5dbb453f811060645c9bd2bcc8ca8fef0d96...c0e70354dbf7dcc76e69dd1973451eb10a2ebdfe,1,16,9,25,3,2013-08-08 20:01:09,2013-07-27 00:05:36
c0e70354dbf7dcc76e69dd1973451eb10a2ebdfe...f674b09f40d22915e15b6968aafc5d25ac8178a2,29,749,514,1263,328,2013-08-09 09:44:50,2013-08-07 19:50:41
f674b09f40d22915e15b6968aafc5d25ac8178a2...41ec6d0580d91c4f2e5f30f279225eb4ec07886d,3,57,4,61,5,2013-08-09 01:05:46,2013-08-09 00:33:40
41ec6d0580d91c4f2e5f30f279225eb4ec07886d...1449739de00859d44a2eff9a676172fdabbfcd60,2,47,25,72,11,2013-08-09 16:56:45,2013-08-09 02:48:10
1449739de00859d44a2eff9a676172fdabbfcd60...78f709d0d431638a555391c6ec5444be49685c10,1,6,1,7,1,2013-08-09 16:56:46,2013-08-09 15:43:10
78f709d0d431638a555391c6ec5444be49685c10...f548433195ba08e77ba93640382f474c17a13ecf,1,2,2,4,2,2013-08-09 05:33:31,2013-08-09 05:33:18
f548433195ba08e77ba93640382f474c17a13ecf...f9b7714b4b3f04cba10c4d8b32dad48a68988799,4,9,10,19,9,2013-08-09 06:16:58,2013-08-09 20:35:54
f9b7714b4b3f04cba10c4d8b32dad48a68988799...2ef1782bbce15f81b4087d07abe33ef006e7c02d,2,4,19,23,6,2013-08-09 23:13:56,2013-08-06 21:22:13
2ef1782bbce15f81b4087d07abe33ef006e7c02d...3f5d5847e2f4f7e6d6f6557badda63b4cbf83e45,4,61,13,74,12,2013-08-09 23:54:45,2013-08-07 00:01:44
3f5d5847e2f4f7e6d6f6557badda63b4cbf83e45...c75251ced210a3d82b6222388dee08704edd658e,1,5,1,6,1,2013-08-10 11:13:46,2013-08-10 11:00:51
c75251ced210a3d82b6222388dee08704edd658e...d046e9d033071e3a5474510f983f83cc526cded9,1,6,0,6,1,2013-08-10 11:18:07,2013-08-10 11:17:26
d046e9d033071e3a5474510f983f83cc526cded9...52e47b24b37defc72c77d7f437074fc0ee18454d,1,235,234,469,7,2013-08-10 11:41:20,2013-08-10 11:34:57
52e47b24b37defc72c77d7f437074fc0ee18454d...c937f5b5874d9b799e8f43399bd4fcae076c7791,1,18,14,32,12,2013-08-10 13:26:11,2013-08-02 09:50:45
c937f5b5874d9b799e8f43399bd4fcae076c7791...39aa894035f9e3b58e04ce1a2b598e496e1f6bd6,1,8,6,14,3,2013-08-10 13:46:06,2013-08-10 13:40:26
39aa894035f9e3b58e04ce1a2b598e496e1f6bd6...f69be329f0d78f19e71ac9e75d6e4ee816e13c97,217,8264,6638,14902,2104,2013-08-10 14:27:43,2013-08-10 14:27:43
f69be329f0d78f19e71ac9e75d6e4ee816e13c97...a20d565d9c4be6ab8397cf3a9546c39a247c7aca,1,6,2,8,4,2013-08-10 14:28:18,2013-08-05 00:50:45
a20d565d9c4be6ab8397cf3a9546c39a247c7aca...2b5b37a3abdff5a2e02207ab1a68b8b462331563,1,3,2,5,1,2013-08-10 22:11:28,2013-08-10 21:25:38
2b5b37a3abdff5a2e02207ab1a68b8b462331563...4ffa943c3f25d801bb89744c94850484dc99231b,1,6,5,11,4,2013-08-12 15:33:59,2013-08-12 15:28:38
4ffa943c3f25d801bb89744c94850484dc99231b...6cd7fd7d243fcf36b047b9c22a79927fb714d6cd,2,33,42,75,12,2013-08-12 17:08:03,2013-08-12 15:54:11
6cd7fd7d243fcf36b047b9c22a79927fb714d6cd...e0a8e1bf77e561ec6894540ea2aae6a52fb1d7e0,2,0,257,257,3,2013-08-12 18:05:16,2013-08-12 18:04:38
e0a8e1bf77e561ec6894540ea2aae6a52fb1d7e0...756ae2c5360b7ab64649cb7587242a2fbd8dc95d,14,201,135,336,88,2013-08-12 18:49:53,2013-08-06 00:58:29
756ae2c5360b7ab64649cb7587242a2fbd8dc95d...5725864dfdc951ee7616188776b56b9e0a95e8e7,4,38,50,88,28,2013-08-12 18:59:35,2013-08-12 18:34:18
5725864dfdc951ee7616188776b56b9e0a95e8e7...35f789b02795ed8dd177b65f80b53f408dc7fe09,13,78,78,156,78,2013-08-12 19:54:49,2013-08-12 19:54:49
35f789b02795ed8dd177b65f80b53f408dc7fe09...624938d0529a2bad1edbf3ea5d72f6d10a57dd72,1,0,2,2,1,2013-08-12 20:42:23,2013-08-12 20:38:39
624938d0529a2bad1edbf3ea5d72f6d10a57dd72...d66d840e3b4750f64ae5a957a63159de49cc38ce,1,6,1,7,1,2013-08-12 20:48:56,2013-08-12 20:41:51
d66d840e3b4750f64ae5a957a63159de49cc38ce...4901353b982ddbe2820a69c5f7a7abf9f7d6374d,2,174,171,345,104,2013-08-12 21:51:01,2013-08-12 21:39:13
4901353b982ddbe2820a69c5f7a7abf9f7d6374d...d4ad5d1151d787f0c91e1662c9ef224d6e753901,2,24,24,48,23,2013-08-12 21:51:01,2013-08-12 21:47:04
d4ad5d1151d787f0c91e1662c9ef224d6e753901...4ac6912a778be5876cf1759bb46d7e03f82784d8,1,12,0,12,1,2013-08-13 09:46:07,2013-08-12 22:21:54
4ac6912a778be5876cf1759bb46d7e03f82784d8...ffc5d83568cc9ff694c6461aaa9dfc70545bf23c,2,5,4,9,4,2013-08-13 09:56:45,2013-08-13 09:56:44
ffc5d83568cc9ff694c6461aaa9dfc70545bf23c...d2b80b8a60bf1e966a4091e62bb603fb825a6ada,1,37,34,71,7,2013-08-13 10:14:33,2013-08-13 10:07:49
d2b80b8a60bf1e966a4091e62bb603fb825a6ada...d684f50acba12152126f0c4e9c83ad1626e8b91c,1,0,3,3,1,2013-08-14 16:08:04,2013-08-14 15:45:40
d684f50acba12152126f0c4e9c83ad1626e8b91c...2669966e7670653ea39a1b6d69ad52328bb00027,4,67,54,121,42,2013-08-14 16:08:04,2013-08-13 21:47:17
2669966e7670653ea39a1b6d69ad52328bb00027...c50750e1fd15ce757b6ef655e22e8fdc946043c1,1,11,2,13,4,2013-08-14 17:10:32,2013-08-07 12:50:36
c50750e1fd15ce757b6ef655e22e8fdc946043c1...dce02a10557f989385eb720c5032a8d1d77fa351,1,1,1,2,1,2013-08-14 21:50:08,2013-08-14 21:49:29
dce02a10557f989385eb720c5032a8d1d77fa351...98c54246c208698ded4c88abd37bb75b926d687d,1,18,13,31,5,2013-08-15 12:21:41,2013-08-15 12:17:41
98c54246c208698ded4c88abd37bb75b926d687d...9c59978f495204eb0e91bd7df396a176e8fad2bf,1,8,5,13,1,2013-08-15 14:47:54,2013-08-15 14:41:19
9c59978f495204eb0e91bd7df396a176e8fad2bf...7a3f7780dc9eed1391b389dec82849137ac9d5f5,2,23,0,23,2,2013-08-15 17:33:06,2013-08-15 17:22:44
7a3f7780dc9eed1391b389dec82849137ac9d5f5...0aa13357d67be84ea9021be43497dca7c91cabee,2,15,11,26,12,2013-08-15 17:33:34,2013-08-15 17:23:36
0aa13357d67be84ea9021be43497dca7c91cabee...ab5dabf876cca785314f198c6e4e47d5a3bcb46a,1,8,22,30,6,2013-08-15 19:52:21,2013-08-15 19:31:38
ab5dabf876cca785314f198c6e4e47d5a3bcb46a...a1ea8a27e6d3688cf694dfa9ce1d67d4c7174bad,2,3,2,5,3,2013-08-15 20:20:15,2013-08-15 20:20:04
a1ea8a27e6d3688cf694dfa9ce1d67d4c7174bad...65f6f06a61c36630ee405a697b1d876208212874,2,117,6,123,9,2013-08-15 20:54:28,2013-08-05 03:54:52
65f6f06a61c36630ee405a697b1d876208212874...1eedbdc361b654a7dc40e7e4514f9ffd6b92f13d,2,97,23,120,10,2013-08-15 20:54:28,2013-08-05 04:30:23
1eedbdc361b654a7dc40e7e4514f9ffd6b92f13d...e6c81bd67986e672b9b253c62ce6d4a519d3a2e1,3,157,14,171,7,2013-08-15 20:57:23,2013-08-06 01:41:17
e6c81bd67986e672b9b253c62ce6d4a519d3a2e1...7304a620ecc76f8a29a0ab7f9472262214a577f2,1,54,9,63,7,2013-08-15 21:12:12,2013-08-15 21:12:12
7304a620ecc76f8a29a0ab7f9472262214a577f2...ce3d18412c9cbd8259f1dac84f83a039436adf91,2,63,24,87,7,2013-08-15 22:05:40,2013-08-15 05:14:49
ce3d18412c9cbd8259f1dac84f83a039436adf91...da93d6adfb0abfcaac26e1509748edca0db8c003,3,142,23,165,24,2013-08-15 22:05:41,2013-08-15 15:51:37
da93d6adfb0abfcaac26e1509748edca0db8c003...e3157972e1f58a986442696f5bf32870210d40fb,1,34,39,73,3,2013-08-15 22:05:41,2013-08-15 15:54:49
e3157972e1f58a986442696f5bf32870210d40fb...7c9b607048f13741173d397795bac37707405ba7,4,101,7,108,11,2013-08-15 22:05:41,2013-08-15 18:08:19
7c9b607048f13741173d397795bac37707405ba7...df23ce138fbe4584a72d24e1f3e6858cf518f302,2,6,12,18,4,2013-08-15 22:05:41,2013-08-15 18:15:10
df23ce138fbe4584a72d24e1f3e6858cf518f302...1f9f86349410f0a008f8d0df9aa66aed60f7a8e9,1,4,4,8,4,2013-08-15 22:05:41,2013-08-15 21:55:43
1f9f86349410f0a008f8d0df9aa66aed60f7a8e9...6d842897c5966cee1924b5073e273568923c8693,19,5,50,55,29,2013-08-16 00:19:17,2013-08-15 21:55:05
6d842897c5966cee1924b5073e273568923c8693...e62d5964def23a619048237490f27ac781fb09ab,1,3,3,6,3,2013-08-16 00:19:18,2013-08-15 21:55:35
e62d5964def23a619048237490f27ac781fb09ab...d70e6491ae2c52c424369deb586276cd5857c66e,1,1,0,1,1,2013-08-16 00:19:18,2013-08-15 21:56:25
d70e6491ae2c52c424369deb586276cd5857c66e...f73ee94d4f595c2b2025e1133bc9f20a16f50ae9,1,2,2,4,2,2013-08-16 00:39:28,2013-08-16 00:39:28
f73ee94d4f595c2b2025e1133bc9f20a16f50ae9...9475ee41ad302d05c641b99cebef3e3f70b6c18f,1,8,1,9,3,2013-08-16 14:47:08,2013-08-16 14:36:21
9475ee41ad302d05c641b99cebef3e3f70b6c18f...ec548734cae52713432addacc6787b87f5c5051e,1,3,1,4,3,2013-08-16 14:47:30,2013-08-16 14:42:50
ec548734cae52713432addacc6787b87f5c5051e...2dd4a745b0ec5b5d44ee884d865b5094c63fe39a,2,35,4,39,5,2013-08-16 19:42:33,2013-08-16 18:32:56
2dd4a745b0ec5b5d44ee884d865b5094c63fe39a...dfb0461c4cfb21245c06d9a3c5e81bcc2ac45c87,2,43,1,44,3,2013-08-17 13:22:50,2013-07-30 13:43:31
c86afa5d2eeeb841f879fb4903484dabb769862a...878ffdbe6a8eac918ef3a7f13925681c3778060b,3,20,2,22,3,2013-05-30 17:31:07,2013-05-30 17:31:07
3b923a7ace319015856d5658a4000f1790de632b...3e25ed905cff08cb450aa82b5383ffd9365cd7ae,1,3,3,6,2,2013-08-19 14:42:12,2013-08-19 14:39:04
3e25ed905cff08cb450aa82b5383ffd9365cd7ae...b9a0eb0688104f3619e75e1b9a698080e10d1ec7,5,1098,1671,2769,285,2013-08-19 15:52:44,2013-08-15 15:28:26
b9a0eb0688104f3619e75e1b9a698080e10d1ec7...306f86343849401ea8b4c5e9e049d0f82286b782,1,0,6,6,2,2013-08-19 16:34:34,2013-08-19 16:34:34
306f86343849401ea8b4c5e9e049d0f82286b782...b80d11d46b3b2abff1cf1fe887971ea50fd7d497,1,1,1,2,1,2013-08-19 16:41:24,2013-08-19 16:41:24
b80d11d46b3b2abff1cf1fe887971ea50fd7d497...f97a1267e2e623f310bb3a18047017b7e50eb3e7,1,0,1,1,1,2013-08-19 18:15:16,2013-08-19 18:15:16
8c1a04dbf64881b8a3ac634b86277ca9122f4628...ce54f4ae50a5bd224e08bf058b118a7c68966cb4,1,2,2,4,2,2013-05-30 18:28:07,2013-05-30 18:28:07
fe0f12b100c4cf33db42eab561f4bca8875909ad...5555318bf375a3edc17179b09b0bff1bfa9b6253,2,86,6,92,8,2013-08-19 23:05:44,2012-09-10 02:04:37
5555318bf375a3edc17179b09b0bff1bfa9b6253...c171c490f2d850f63a37496bc7b31855193ce298,24,27,27,54,27,2013-08-19 23:42:16,2013-08-12 22:01:05
c171c490f2d850f63a37496bc7b31855193ce298...6ed861dd7feea33224d1cac8e64010b45974ae51,1,7,4,11,3,2013-08-20 00:27:08,2013-05-13 19:04:06
6ed861dd7feea33224d1cac8e64010b45974ae51...85d6b783432e1c58084c3bdebf15cf45384f6572,1,0,1,1,1,2013-08-20 00:43:38,2013-08-20 00:43:38
85d6b783432e1c58084c3bdebf15cf45384f6572...edd2fcccf022c7014b374674012283422faa1bed,3,67,1,68,4,2013-08-20 17:03:52,2013-08-20 12:31:40
edd2fcccf022c7014b374674012283422faa1bed...50cee6ecab869bd406a4a8806906c87a51b0b1b2,2,4,1,5,2,2013-08-20 18:05:36,2013-08-20 18:05:36
50cee6ecab869bd406a4a8806906c87a51b0b1b2...ed0677f42752fe0ec73b4b200e729b583307361a,2,6,1,7,2,2013-08-20 18:07:37,2013-08-20 17:12:29
ed0677f42752fe0ec73b4b200e729b583307361a...6b5c43ed18234a9bdf3873b1ed6c45cf1a4c76ab,2,30,11,41,8,2013-08-20 20:33:35,2013-08-20 17:30:40
6b5c43ed18234a9bdf3873b1ed6c45cf1a4c76ab...849cf1aa92532339ab78f5a3852cac2e7b4309cb,1,5,5,10,5,2013-08-20 20:33:50,2013-08-20 17:55:42
849cf1aa92532339ab78f5a3852cac2e7b4309cb...a1b3273a9d47af9a42aabbebee83d102668e1732,1,38,29,67,6,2013-08-21 08:33:09,2013-08-21 08:33:09
ce54f4ae50a5bd224e08bf058b118a7c68966cb4...df6ffc018ef0d166486d1323412472b981ecb648,2,82,1,83,2,2013-06-03 17:50:04,2013-06-03 17:50:02
df6ffc018ef0d166486d1323412472b981ecb648...5dc51d4e215b658a0fefe9d5eebc22f80747cd0b,2,87,34,121,9,2013-06-03 22:56:16,2013-06-03 20:39:57
5dc51d4e215b658a0fefe9d5eebc22f80747cd0b...5dd91b014711f0c305eb6b8963c6a59a14970b03,1,1,0,1,1,2013-06-03 23:02:51,2013-06-03 23:02:51
5dd91b014711f0c305eb6b8963c6a59a14970b03...99fe35c67a1acbf7ec8ce239ebf9b76fdc992c4b,1,67,0,67,1,2013-06-04 18:12:44,2013-06-04 18:12:44
99fe35c67a1acbf7ec8ce239ebf9b76fdc992c4b...0a763e35da1f9e17620b293e5049cc6984e302a5,1,63,0,63,1,2013-06-04 18:12:54,2013-06-04 18:12:54
0a763e35da1f9e17620b293e5049cc6984e302a5...e116ee7ba13d9dcabf554cf9e92657146601bef6,1,2,2,4,1,2013-06-04 18:19:10,2013-06-04 18:19:10
e116ee7ba13d9dcabf554cf9e92657146601bef6...51226b84cf5e2cac7a1fa4b4b5379727fa3415fc,1,11,0,11,1,2013-06-04 18:22:14,2013-06-04 18:22:14
51226b84cf5e2cac7a1fa4b4b5379727fa3415fc...f28f67cf759258492537495c016b2b01d2b0f9de,203,332,207,539,214,2013-06-04 18:42:32,2013-06-04 18:42:32
f28f67cf759258492537495c016b2b01d2b0f9de...414a909d01495eed2f6a411965c8984758322664,1,0,12,12,1,2013-06-04 18:43:42,2013-05-21 21:04:58
414a909d01495eed2f6a411965c8984758322664...96c30df10cdfa4d53083ae64ca9e11f9d1311988,10,113,65,178,29,2013-06-04 19:11:03,2013-06-04 19:11:03
cdf2a661f2e89cbf1bebd553f32f0afb570fd936...41f55dc59b423b8b76e6f7971fd8f3a326a6fbad,1,6,1,7,1,2013-08-21 17:51:42,2013-08-21 17:51:42
41f55dc59b423b8b76e6f7971fd8f3a326a6fbad...a784abaff631449533d44846987c1537c080e03d,28,513,268,781,88,2013-08-21 18:15:21,2013-08-21 18:15:21
96c30df10cdfa4d53083ae64ca9e11f9d1311988...25e51c396aa23018603baae2b1d9390f5d9db496,2,13,2,15,2,2013-06-04 19:13:46,2013-06-04 19:13:46
a784abaff631449533d44846987c1537c080e03d...04018d4b3938fd30ba14822e79195e4af2be36f6,3,68,2,70,3,2013-08-21 20:20:50,2013-08-21 20:20:50
fe0434ce1ea5db153d11d77531b8d53e14e95802...59c8f59171332b7adfe152827062a9e5b119ce70,1,63,0,63,1,2013-06-04 21:38:29,2013-06-04 21:38:29
59c8f59171332b7adfe152827062a9e5b119ce70...6ada73383cfc4b5b1e85ae96412a23c330433cf5,1,2,2,4,2,2013-06-04 21:38:41,2013-06-04 21:38:41
6ada73383cfc4b5b1e85ae96412a23c330433cf5...e0519ace315c7ce14278d5eaab8d1d72a0a0a054,2,141,2,143,7,2013-06-05 15:06:35,2013-06-05 06:43:29
51336a44bb990f2398aa88ea47c3c33f49f70883...3602d4c23bd8beccd925161adf5459068aec23e3,1,2,2,4,2,2013-08-21 21:16:46,2013-08-21 21:16:46
3602d4c23bd8beccd925161adf5459068aec23e3...7afdba6e0bc3b69c2bf5fdbd59f938ac8f7a64c5,26,799,588,1387,91,2013-08-21 22:52:23,2013-07-27 04:34:12
7afdba6e0bc3b69c2bf5fdbd59f938ac8f7a64c5...eef552774e1c78b113e1b543cb9463cd64ecd5ed,4,108,20,128,19,2013-08-22 00:58:12,2013-08-22 00:19:41
eef552774e1c78b113e1b543cb9463cd64ecd5ed...2769d97e67cb510706318f1c4a66e98a93472654,2,57,2,59,2,2013-08-22 03:50:28,2013-08-22 01:17:11
2769d97e67cb510706318f1c4a66e98a93472654...fa89cf545cad2ae6fc2ed15006b9c118cb9077d2,1,1,1,2,1,2013-08-22 05:18:20,2013-08-22 05:18:20
fa89cf545cad2ae6fc2ed15006b9c118cb9077d2...546ae2eef90c4ef0eb30ef4f52402e3c45e2f3f2,3,13,3,16,4,2013-08-22 23:54:17,2013-08-22 01:38:23
546ae2eef90c4ef0eb30ef4f52402e3c45e2f3f2...bc28acdd029687d24004f69f98617c7e171ca173,2,17,1,18,2,2013-08-23 10:01:47,2013-08-23 10:00:28
bc28acdd029687d24004f69f98617c7e171ca173...2891790dbdc0f1ac0cb23c8dd2f284d78c78abdb,1,1,7,8,3,2013-08-23 12:29:58,2013-08-23 12:29:57
2891790dbdc0f1ac0cb23c8dd2f284d78c78abdb...48976d29f4a2dd72cbef2096dd5e7b822ee19df0,1,1,3,4,1,2013-08-23 00:07:24,2013-08-23 00:01:29
48976d29f4a2dd72cbef2096dd5e7b822ee19df0...6fa8398853e009eaea0eed2157575e7054bdebb4,12,420,193,613,130,2013-08-23 17:04:38,2013-08-23 17:04:27
6fa8398853e009eaea0eed2157575e7054bdebb4...7555227a12be2b431b0446d573b9ac0653435ed6,1,3,1,4,1,2013-08-23 17:08:49,2013-08-23 17:08:49
7555227a12be2b431b0446d573b9ac0653435ed6...467e00ed0203b11646d027ed1f94a4129de6a9d4,2,61,52,113,9,2013-08-23 17:14:10,2013-08-21 23:12:17
467e00ed0203b11646d027ed1f94a4129de6a9d4...833385973521654629a38065c6c6ca9d45c201da,9,385,134,519,41,2013-08-24 17:47:45,2013-08-24 17:47:45
833385973521654629a38065c6c6ca9d45c201da...87405b0d98e5f96eec1bd3ddfea6fe4ad2489892,1,1,1,2,1,2013-08-25 16:45:38,2013-08-25 16:44:57
87405b0d98e5f96eec1bd3ddfea6fe4ad2489892...9ac75d1f06d0bdbd7b4b3cecadc2e2d651779d9f,3,5,43,48,8,2013-08-26 13:15:43,2013-08-26 13:13:35
9ac75d1f06d0bdbd7b4b3cecadc2e2d651779d9f...16a60ed2a39f0fd2d772a923697488582fe9ffba,2,23,37,60,10,2013-08-26 21:12:00,2013-08-26 10:20:23
16a60ed2a39f0fd2d772a923697488582fe9ffba...873b5f8428fccd7cb73378fff951a08d9aab4e91,1,3,1,4,1,2013-08-26 21:12:00,2013-08-26 10:26:31
873b5f8428fccd7cb73378fff951a08d9aab4e91...9fc006618fffdc377064531eb1e6793b6e8a4c0b,5,3,6,9,8,2013-08-26 22:13:50,2013-08-26 22:13:50
9fc006618fffdc377064531eb1e6793b6e8a4c0b...0523da64d2af3e75ea557443b8078adebebd6be6,1,1,1,2,1,2013-08-27 11:20:42,2013-08-27 11:20:39
0523da64d2af3e75ea557443b8078adebebd6be6...3a87b31bfa0e35d70cda6c0900648815ef3b9956,1,0,19,19,3,2013-08-27 12:09:37,2013-08-27 12:09:36
3a87b31bfa0e35d70cda6c0900648815ef3b9956...556b890ad91780c52c77dccaddcf69beb8184e27,1,1,0,1,1,2013-08-27 12:47:50,2013-08-27 12:47:46
556b890ad91780c52c77dccaddcf69beb8184e27...8d567f43d01bc0ab400b879ed19760468149fcf7,1,14,16,30,2,2013-08-27 14:14:46,2013-08-27 14:14:45
8d567f43d01bc0ab400b879ed19760468149fcf7...1df77a743890e6007126044c3331c936572e6e2a,2,42,0,42,2,2013-08-27 14:27:39,2013-08-27 02:14:42
1df77a743890e6007126044c3331c936572e6e2a...474d58c111a78dbcc74117034d6a162c3df1c910,1,7,2,9,3,2013-08-27 16:09:35,2013-04-08 22:33:49
474d58c111a78dbcc74117034d6a162c3df1c910...645418e9f1840f12cc954c2385e4c33f5415cc13,2,38,11,49,5,2013-08-27 17:42:18,2013-08-27 17:35:14
645418e9f1840f12cc954c2385e4c33f5415cc13...d86814aeca64d8985402dc073eff1fc8ac93c231,2,9,56,65,6,2013-08-27 18:05:14,2013-03-14 21:11:15
d86814aeca64d8985402dc073eff1fc8ac93c231...26bc8db33f15a365e22f23229d0700d70ac0d560,131,5439,3411,8850,877,2013-08-27 22:18:12,2013-08-27 22:18:12
26bc8db33f15a365e22f23229d0700d70ac0d560...711d1934eaf85443e87bee418be170143bb1c70d,2,74,9,83,6,2013-08-28 00:28:51,2013-07-13 23:34:52
711d1934eaf85443e87bee418be170143bb1c70d...ee695e935dfd31c6678ce4e9f2f472a33138530e,1,35,11,46,7,2013-08-28 00:28:57,2013-08-28 00:28:27
ee695e935dfd31c6678ce4e9f2f472a33138530e...ba72570eae938957d10494be28eac28ed75d256f,3,6,4,10,4,2013-08-28 01:02:30,2013-08-22 17:58:27
ba72570eae938957d10494be28eac28ed75d256f...ba72f8cad878338726e45ed6fa2b1514b8a9ff2e,1,2,0,2,1,2013-08-28 01:09:26,2013-08-28 01:09:26
ba72f8cad878338726e45ed6fa2b1514b8a9ff2e...73d328de248504d84dc4e550050679ead08b5ac2,1,1,1,2,1,2013-08-28 02:52:10,2013-08-28 02:52:09
73d328de248504d84dc4e550050679ead08b5ac2...a54f65ce75d56f3d0da670c127e79f048b6a78ae,1,27,50,77,19,2013-08-28 10:11:09,2013-08-24 01:17:15
a54f65ce75d56f3d0da670c127e79f048b6a78ae...a3bf3d10ef4b373870c6bb475f8fd5b6ede953cc,1,13,2,15,4,2013-08-28 10:11:09,2013-08-24 01:33:16
a3bf3d10ef4b373870c6bb475f8fd5b6ede953cc...9c110d80276282c0f8c63bd4c6973f28e57c9eb5,4,72,3,75,11,2013-08-28 10:11:09,2013-08-24 19:45:02
9c110d80276282c0f8c63bd4c6973f28e57c9eb5...29d3624daedc9a120fa596402e34173179e4a868,2,53,0,53,3,2013-08-28 10:37:49,2013-08-27 19:11:13
e0519ace315c7ce14278d5eaab8d1d72a0a0a054...4d13fcf4811f5dd680a12df940ed7054cf044221,230,126,14670,14796,233,2013-06-06 21:44:48,2013-06-06 21:44:48
4d13fcf4811f5dd680a12df940ed7054cf044221...f1b878cafa37105603632b484d4203ae33664a0d,3,28,1,29,5,2013-06-06 22:35:59,2013-06-04 00:05:56
f1b878cafa37105603632b484d4203ae33664a0d...82b3524bce845bfb38d99f52ce3ab6492847ce9e,2,16,0,16,2,2013-06-11 11:07:24,2013-06-10 21:34:11
82b3524bce845bfb38d99f52ce3ab6492847ce9e...5d4ac272c7ee88f44fa509e8fa2bc6def003a7f6,1,2,1,3,1,2013-06-11 21:39:25,2013-06-11 21:39:25
5d4ac272c7ee88f44fa509e8fa2bc6def003a7f6...49d9ad9d81e2db72fecc4d0c3c2d3a205dde8bee,117,460,193,653,166,2013-06-12 17:59:44,2013-06-12 17:59:44
49d9ad9d81e2db72fecc4d0c3c2d3a205dde8bee...48476273eb1a5868c2cccd7afdb9338fa52efccc,4,38,30,68,16,2013-06-12 20:10:39,2013-06-12 20:10:39
48476273eb1a5868c2cccd7afdb9338fa52efccc...e8500274e04bab2eb630b4000cbd35be8d23d3fd,6,18,28,46,22,2013-06-13 00:45:30,2013-06-13 00:45:30
e8500274e04bab2eb630b4000cbd35be8d23d3fd...884b25356f20cd95412d86a413283c98d0ac5ed2,2,5,3,8,5,2013-06-13 11:27:58,2013-06-12 15:47:10
884b25356f20cd95412d86a413283c98d0ac5ed2...9a4e5937ee9167430fbe4b9b794b82673bd2c833,5,14,14,28,11,2013-06-13 11:33:06,2013-06-12 22:51:17
96358613f9cfce8ea602033334ec80f2712e3756...93b062468b2078de1b34e064a05fbeb1b4bd680a,2,34,0,34,2,2013-08-28 18:29:33,2013-08-28 18:29:33
93b062468b2078de1b34e064a05fbeb1b4bd680a...de7d698df7d2e840d079336606d56cdaf9ee9c03,1,1,1,2,1,2013-08-28 21:36:00,2013-08-28 21:35:43
de7d698df7d2e840d079336606d56cdaf9ee9c03...fd3657610e49005dfc778c3f060dbba0a34f286a,17,331,88,419,64,2013-08-29 05:27:24,2013-08-24 22:53:24
fd3657610e49005dfc778c3f060dbba0a34f286a...02fde585b15f0dd117a297a6c4d35b181b530c63,1,176,146,322,56,2013-08-29 05:27:24,2013-08-24 23:46:31
02fde585b15f0dd117a297a6c4d35b181b530c63...699f636d975c6c0babb357c00a721ad27a05323a,1,1,1,2,1,2013-08-29 11:57:30,2013-08-29 11:57:29
699f636d975c6c0babb357c00a721ad27a05323a...21911db392d8118372b92d0db1d92a031f481d61,1,2,3,5,1,2013-08-29 12:02:11,2013-08-29 12:02:11
21911db392d8118372b92d0db1d92a031f481d61...8e596c4e15f64b53d66e91079ed733821fb3e88d,2,3,1,4,2,2013-08-29 12:05:44,2013-08-29 12:05:42
8e596c4e15f64b53d66e91079ed733821fb3e88d...653f62a709cdc50f18c3924b8db824d98ebcbffb,4,25,21,46,11,2013-08-29 12:25:57,2013-08-29 12:19:27
653f62a709cdc50f18c3924b8db824d98ebcbffb...a9eb96d0201fa7d13c898a154e81fd9531358d2f,1,0,2,2,1,2013-08-29 12:28:28,2013-08-29 12:28:24
a9eb96d0201fa7d13c898a154e81fd9531358d2f...e83a0cd016ef03d3ec3b491325b347be886c1476,25,543,198,741,78,2013-08-29 13:38:32,2013-08-29 13:04:27
e83a0cd016ef03d3ec3b491325b347be886c1476...4915884da69814bd4daab22393919a628c9ecf23,2,98,5,103,8,2013-08-30 16:39:37,2013-08-29 09:39:37
4915884da69814bd4daab22393919a628c9ecf23...8a272cabe21dbf4558db1de4b5e51e2b24386775,3,0,0,0,0,2013-08-30 20:55:53,2013-08-30 20:55:53
8a272cabe21dbf4558db1de4b5e51e2b24386775...bbed881ec413e8d6d266152c218ebee702d4d526,2,5,98,103,8,2013-08-30 21:28:14,2013-08-30 21:21:05
bbed881ec413e8d6d266152c218ebee702d4d526...10ccbd501f8a3122f0fa7359d1afc0d02da1af36,1,0,1,1,1,2013-08-30 21:28:22,2013-08-30 21:28:22
9a4e5937ee9167430fbe4b9b794b82673bd2c833...d9d5bc465450ae5d60da32e9ffcf71c2767f1fad,3,21,2,23,3,2013-06-13 17:35:30,2013-06-13 17:35:30
b45489af730ae5c3329694770c3a613e7acd5d77...17d00f165740b54946e0e599775938438bad193c,1,2,2,4,2,2013-06-13 18:37:04,2013-06-13 18:37:04
17d00f165740b54946e0e599775938438bad193c...fc4b4059ff3eebfacec3440241bb4f30397915ee,1,70,0,70,1,2013-06-13 18:37:18,2013-06-13 18:37:18
fc4b4059ff3eebfacec3440241bb4f30397915ee...876543602503da98f542cdea76b119385e5771d4,1,59,0,59,1,2013-06-13 20:22:07,2013-06-13 20:22:07
876543602503da98f542cdea76b119385e5771d4...4bca631c1a5673c7d02cc25c2f1c8c329f385b9b,1,7,0,7,1,2013-06-13 20:22:46,2013-06-13 20:22:46
4bca631c1a5673c7d02cc25c2f1c8c329f385b9b...acbdabb74b1b8484671fd3c44cd9eb9a7ea11f41,1,9,4,13,3,2013-06-14 14:10:51,2013-06-14 12:49:14
acbdabb74b1b8484671fd3c44cd9eb9a7ea11f41...cc517497e6be06943c4ace7da1967649c77ecc67,1,3,2,5,2,2013-06-14 15:48:33,2013-06-14 14:48:49
cc517497e6be06943c4ace7da1967649c77ecc67...fc71a63bafdd2d40c80b3785e4ad551f6deff0b6,2,0,7,7,2,2013-06-14 17:26:50,2013-06-14 17:25:47
fc71a63bafdd2d40c80b3785e4ad551f6deff0b6...5613803f8dbd154accad5e38918143244d9ccd55,1,0,0,0,0,2013-06-14 17:26:50,2013-06-14 17:26:15
5613803f8dbd154accad5e38918143244d9ccd55...10133aaa467648b62e537bd7160bea2e4e33824d,1,92,0,92,1,2013-06-15 18:35:59,2013-06-15 18:33:17
10133aaa467648b62e537bd7160bea2e4e33824d...3c7945bda10567af23daf5302842d99d4f9f3db0,2,81,1,82,2,2013-06-17 02:06:27,2013-06-14 22:57:11
3c7945bda10567af23daf5302842d99d4f9f3db0...41fc46e52ff8c0465800a35af1d1bda275e5d192,7,610,11,621,24,2013-06-17 13:24:45,2012-12-03 20:29:29
41fc46e52ff8c0465800a35af1d1bda275e5d192...18574bfaf1c408fd87b69fa4d041a9f3050d6754,1,6,0,6,1,2013-06-17 13:57:04,2013-06-15 07:48:36
18574bfaf1c408fd87b69fa4d041a9f3050d6754...9195455637be7ac68274c4e9a83003470efdb0c0,148,1962,300,2262,184,2013-06-18 16:42:42,2013-06-18 16:42:42
2be09f9493fb3723601c404c7989d58eed609b57...c5ed96a4b12fd254f18c7d5d630241546a4fde3e,1,3,3,6,3,2013-09-01 12:50:19,2013-09-01 12:47:25
c5ed96a4b12fd254f18c7d5d630241546a4fde3e...d6fb764cc2b77e439e842ae26811b34ff3f50235,2,2,2,4,2,2013-09-02 19:00:00,2013-09-02 17:10:36
d6fb764cc2b77e439e842ae26811b34ff3f50235...185c515c9febf2229ed2ac76bfdd0c767ea7fd43,3,138,117,255,34,2013-09-02 19:41:12,2013-09-02 14:42:01
185c515c9febf2229ed2ac76bfdd0c767ea7fd43...ed8d97f572fab15025da0c762e5edfbcbe45f425,78,1407,1198,2605,667,2013-09-02 23:17:58,2013-09-02 22:42:59
ed8d97f572fab15025da0c762e5edfbcbe45f425...cb53cfd8b58907074af464b0a94a550d0969b6b7,1,0,3,3,1,2013-09-03 03:15:40,2013-08-21 22:39:14
cb53cfd8b58907074af464b0a94a550d0969b6b7...906a175a0b40fc56dfafbe0929e4fbbb4df68ff2,3,101,1,102,5,2013-09-03 03:15:40,2013-08-21 22:36:50
906a175a0b40fc56dfafbe0929e4fbbb4df68ff2...7a235f924b1217b7d33401f65743dd85660c5870,1,10,4,14,4,2013-09-03 17:04:58,2013-09-03 11:04:26
7a235f924b1217b7d33401f65743dd85660c5870...358c2901567c005689dceef1361754cca95ca14e,1,0,1,1,1,2013-09-04 07:59:17,2013-09-04 07:55:57
358c2901567c005689dceef1361754cca95ca14e...7494c84fe6fa1127de5a9827119d9e389cbfb016,51,346,286,632,138,2013-09-04 16:11:32,2013-09-04 12:46:35
7494c84fe6fa1127de5a9827119d9e389cbfb016...4631c503e35cd3bb75a10424dd47a73c12ec468e,2,44,37,81,28,2013-09-04 18:13:41,2013-08-28 01:53:39
4631c503e35cd3bb75a10424dd47a73c12ec468e...54fbb1da96376688f2bffac28486c61f38bf6eaf,2,49,1,50,2,2013-09-04 18:13:41,2013-08-27 15:57:16
54fbb1da96376688f2bffac28486c61f38bf6eaf...9ef9a9dee54a464a46739b14e8a348bec673c5a5,1,53,62,115,15,2013-09-04 18:13:41,2013-08-29 21:48:24
9195455637be7ac68274c4e9a83003470efdb0c0...a088cf4f930d3928c97d239adf950ab43e7794aa,3,18,2,20,3,2013-06-18 16:50:53,2013-06-18 16:50:53
9ef9a9dee54a464a46739b14e8a348bec673c5a5...f91b047891c0deb402220b385f166c08edcb0591,2,7,0,7,2,2013-09-04 18:15:55,2013-08-19 17:14:42
f91b047891c0deb402220b385f166c08edcb0591...689e5c9d3db67ccfb81a1caefb04176c41a17744,5,21,2,23,12,2013-09-04 18:17:28,2013-08-28 01:59:58
689e5c9d3db67ccfb81a1caefb04176c41a17744...15a5a4a9453a056b783c7ff0966e31c3c6b7d7e1,3,18,8,26,7,2013-09-04 18:19:39,2013-08-18 01:50:59
15a5a4a9453a056b783c7ff0966e31c3c6b7d7e1...be52549bfa5311208b5fcdb3ba09210460fa9ceb,3,42,2,44,3,2013-09-04 21:01:26,2013-09-04 21:01:26
59dde8192636ad8eeeab43927d43f34d428a6cc8...637acb2b348266db3aec5e7e128c0fe7280e92f9,1,2,2,4,2,2013-06-18 18:14:57,2013-06-18 18:14:57
637acb2b348266db3aec5e7e128c0fe7280e92f9...67cb80158ce194954d97bccf5f721a94e74aba7c,1,67,0,67,1,2013-06-18 18:15:09,2013-06-18 18:15:09
67cb80158ce194954d97bccf5f721a94e74aba7c...5fc8efb87d7cf0badd7801625ddae054d6aa0b0b,4,4,4,8,5,2013-06-18 20:50:19,2013-06-11 23:49:56
5fc8efb87d7cf0badd7801625ddae054d6aa0b0b...a2c4ca09ed80e28a9035ec442269a4e5913ac292,1,2,2,4,2,2013-06-20 00:16:35,2013-06-20 00:10:02
a2c4ca09ed80e28a9035ec442269a4e5913ac292...3fac4157fef1b083e199e04affbb6432f70861c2,1,1,1,2,1,2013-06-24 09:18:24,2013-06-24 09:16:48
5a6b2853c319a4cab16aca2dea0452f198b69e4e...5b1a0e6ef8f5457c75b31d2780e06f7aa76b8c7c,1,2,2,4,2,2013-09-04 22:18:20,2013-09-04 22:18:20
3fac4157fef1b083e199e04affbb6432f70861c2...a0b6df080d210c5035574f378843aabd5074151c,1,4,9,13,3,2013-06-25 10:47:24,2013-06-25 10:47:24
a0b6df080d210c5035574f378843aabd5074151c...c1bf89df2e93c72f7dd22a8399d6f8734888916d,1,5,6,11,3,2013-06-26 23:37:39,2013-06-26 23:37:29
c1bf89df2e93c72f7dd22a8399d6f8734888916d...2a8c5ddc468670498b98231ea5c2464fd7e5c858,1,101,0,101,1,2013-06-27 00:06:51,2013-06-27 00:06:40
2a8c5ddc468670498b98231ea5c2464fd7e5c858...cf6acf2a1a8717eb55aec8df79121ee6a75611f4,1,2,2,4,1,2013-06-27 01:22:05,2013-06-27 01:18:41
cf6acf2a1a8717eb55aec8df79121ee6a75611f4...92903850579727d404916ccb39a65ed8beafc7a6,1,1,1,2,1,2013-06-28 10:31:37,2013-06-28 10:31:37
92903850579727d404916ccb39a65ed8beafc7a6...95dcd11dde4fff1ad69b5b5bd9e6c55a9ff1c4a0,1,8,2,10,3,2013-07-01 17:37:29,2013-07-01 09:42:19
95dcd11dde4fff1ad69b5b5bd9e6c55a9ff1c4a0...dc3c2d12c850e88de3fe352e5ac9bbea911a66d7,1,1,1,2,1,2013-07-01 17:37:50,2013-07-01 09:42:36
dc3c2d12c850e88de3fe352e5ac9bbea911a66d7...16b59cbc74c8fe2f8b30f3af4c2f885b7bfb6030,2,66,3,69,4,2013-07-01 23:02:25,2013-07-01 22:46:49
16b59cbc74c8fe2f8b30f3af4c2f885b7bfb6030...4c38742dd8a41f119b7113af6440014e25ae71c2,1,15,4,19,5,2013-07-02 00:41:38,2013-07-01 21:29:15
4c38742dd8a41f119b7113af6440014e25ae71c2...806e300878478db0a6f3c39762f35eed6aae0fe1,1,1,0,1,1,2013-07-05 00:20:39,2013-07-05 00:20:37
8ee50cea401d25d54ef884987ee7d0224e8cf637...af76b08666d4ee04d3574efa977b6c14c3b32c90,5,136,21,157,27,2013-09-05 14:10:31,2013-08-23 13:53:16
af76b08666d4ee04d3574efa977b6c14c3b32c90...b4b3a4deaffbcf21465622392669185a4ada5389,1,0,0,0,0,2013-09-05 19:04:31,2013-09-04 18:42:08
b4b3a4deaffbcf21465622392669185a4ada5389...6df4741f840832886716145cf81654d5a0a9e2e0,1,4,2,6,2,2013-09-05 19:47:10,2013-09-05 19:47:08
6df4741f840832886716145cf81654d5a0a9e2e0...f218d94af4a7f70086c931be01b1bed9c76bfee0,2,37,1,38,2,2013-09-05 22:56:34,2013-09-05 22:50:51
806e300878478db0a6f3c39762f35eed6aae0fe1...2d6d46172ed1d32ab0d6cad9cc5caea96bf06fac,1,0,4,4,1,2013-07-05 09:56:24,2013-07-05 03:57:13
2d6d46172ed1d32ab0d6cad9cc5caea96bf06fac...99a7e78e7789a1a0de31c493605abf0a0f35312a,2,69,0,69,2,2013-07-08 16:20:40,2013-06-26 16:13:48
99a7e78e7789a1a0de31c493605abf0a0f35312a...ed5324687ef6cc8bebcbe418301c3f06346f20ae,1,1,1,2,1,2013-07-08 18:25:40,2013-07-08 18:25:40
ed5324687ef6cc8bebcbe418301c3f06346f20ae...91698f77e527d6559285031eb91974119c80715e,1,5,2,7,2,2013-07-09 17:55:10,2013-06-23 22:33:13
91698f77e527d6559285031eb91974119c80715e...f5602bda181578cc83cf9b5723dd93c2281151f3,1267,3297,35141,38438,1442,2013-07-09 20:09:02,2013-07-09 20:09:02
f5602bda181578cc83cf9b5723dd93c2281151f3...8bac8857f5c60e3af1a986f55912ce507b6135ba,17,139,24,163,31,2013-07-09 20:20:38,2013-07-09 20:20:38
aaf4f8d685fcb90a82d626e1218b67b3d5aa1c9b...81655a224a36948291e1f21f03273b5b604b7e6a,3,11,27,38,8,2013-09-06 02:40:24,2013-09-06 00:44:16
81655a224a36948291e1f21f03273b5b604b7e6a...756b6222956b5d25b2e7db81f4e79033a3a4d20e,45,2520,1704,4224,757,2013-09-06 03:51:42,2013-08-10 22:26:11
756b6222956b5d25b2e7db81f4e79033a3a4d20e...b89b97ddedc5b659e5592917d4789a31723ceca3,5,44,29,73,22,2013-09-06 19:19:55,2013-09-06 18:59:27
b89b97ddedc5b659e5592917d4789a31723ceca3...a5dba82ee210685ffce17b35ff2da9cca1d268d2,4,100,3,103,10,2013-09-06 23:51:51,2013-09-06 23:46:35
a5dba82ee210685ffce17b35ff2da9cca1d268d2...6808706c3b8baf8d4b867806acebda949f6d8f38,2,17,2,19,5,2013-09-07 00:08:56,2013-09-07 00:08:56
6808706c3b8baf8d4b867806acebda949f6d8f38...39aafcf801de9c683fb0049b4c0186345ffed55e,2,2,2,4,2,2013-09-07 01:23:15,2013-09-07 01:23:02
39aafcf801de9c683fb0049b4c0186345ffed55e...b30a03eda02477ddef2b1b16ecc8762272e3a065,4,51,7,58,7,2013-09-07 01:23:15,2013-09-07 00:47:56
8bac8857f5c60e3af1a986f55912ce507b6135ba...5b6464f461fc20c6cc6d061232eaefac7d14d3b8,1,2,2,4,2,2013-07-09 20:50:45,2013-07-09 20:48:24
5b6464f461fc20c6cc6d061232eaefac7d14d3b8...e32660a984427d46af6a144983cf7b8045b7299c,3,27,1,28,3,2013-07-09 20:51:24,2013-07-09 20:32:22
1c58a07dd491282817e0999e511d88d18dd25b90...204228b57f06ece34b61d69c5e3b58218bbfed0e,7,0,0,0,0,2013-09-09 09:05:40,2013-09-09 08:57:09
204228b57f06ece34b61d69c5e3b58218bbfed0e...59dac01e4eaebd01714b6640ae2cd656796147fb,1,28,22,50,10,2013-09-10 02:39:21,2013-09-10 02:39:21
59dac01e4eaebd01714b6640ae2cd656796147fb...3d4c663ee68326990e0732a4aa76445688e1064e,2,17,2,19,7,2013-09-12 15:40:43,2013-09-12 13:51:55
3d4c663ee68326990e0732a4aa76445688e1064e...f31037ddfefdc8fab94980cd16a525827ba19abf,2,54,1,55,2,2013-09-14 19:29:48,2013-09-13 23:54:05
f31037ddfefdc8fab94980cd16a525827ba19abf...59a075e108c7ffcee87252255e60530cd15a8adb,2,18,7,25,5,2013-09-14 20:56:11,2013-09-14 14:29:24
59a075e108c7ffcee87252255e60530cd15a8adb...a1cf3ada624b90673ac6bd53ec38a3d27fecbd01,47,775,242,1017,146,2013-09-18 16:33:28,2013-09-18 16:33:28
a1cf3ada624b90673ac6bd53ec38a3d27fecbd01...d80d131c75d7defa06845d7daa634c4d51515e0c,2,16,4,20,2,2013-09-19 10:38:29,2013-09-04 22:57:43
d80d131c75d7defa06845d7daa634c4d51515e0c...a0f79867dcc4e58e0753af0644759025ad6e9749,2,27,0,27,2,2013-09-20 16:39:14,2013-09-19 03:59:54
a0f79867dcc4e58e0753af0644759025ad6e9749...03738183c74d0be43846f96562cb89dce929a953,2,42,11,53,2,2013-09-20 16:39:14,2013-09-19 04:38:37
03738183c74d0be43846f96562cb89dce929a953...7ac23910c526acc2db448c1093e2bebc7581a2aa,3,15,0,15,3,2013-09-20 20:11:42,2013-09-20 20:01:49
7ac23910c526acc2db448c1093e2bebc7581a2aa...75ea566f5abd09882b25b9335f5ae6c53a22fcb6,1,1,1,2,2,2013-09-23 12:27:35,2013-09-23 12:27:26
75ea566f5abd09882b25b9335f5ae6c53a22fcb6...970bdccc38fee27e10ff1a3b68f3fea3417788a1,19,500,52,552,57,2013-09-23 16:26:57,2013-09-23 16:25:11
970bdccc38fee27e10ff1a3b68f3fea3417788a1...42acbf809b67ff5015e12f2df12515342b223261,4,242,43,285,21,2013-09-24 16:46:59,2013-09-24 12:53:49
42acbf809b67ff5015e12f2df12515342b223261...14687ebfc0e1754a3208dfe024c4159e8318a82f,19,52,500,552,57,2013-09-24 14:16:04,2013-09-24 14:13:05
14687ebfc0e1754a3208dfe024c4159e8318a82f...25dce6d62d20b51eb7d8049b71a4b436508e6209,2,2,2,4,2,2013-09-24 21:35:30,2013-09-24 21:35:30
8d9897d735dcf808e5a32c9f376f4a993f8d0315...8a7e2b9da69f219ae41e274e2e3f5ffba761a7fc,1,2,2,4,2,2013-07-09 21:28:37,2013-07-09 21:28:37
8a7e2b9da69f219ae41e274e2e3f5ffba761a7fc...f1bb5dca85853e469c7d70582fbe4049e4316d72,1,76,0,76,1,2013-07-09 21:29:16,2013-07-09 21:29:16
f1bb5dca85853e469c7d70582fbe4049e4316d72...b3b8e74dbf63cfb4d980b5cfc54c14aae071248d,2,32,0,32,2,2013-07-09 22:58:15,2013-07-09 22:58:15
b3b8e74dbf63cfb4d980b5cfc54c14aae071248d...8a65df9baa934972f6da4543b89f92b132ed8007,2,8,8,16,4,2013-07-10 07:48:57,2013-07-10 07:48:55
8a65df9baa934972f6da4543b89f92b132ed8007...610269295b534b846d1e9afee540a216e5c7a56b,1,1,0,1,1,2013-07-10 08:10:29,2013-06-27 17:53:29
610269295b534b846d1e9afee540a216e5c7a56b...6d91bd37075a53f42bab01915fa89ba4a4f0a075,1,3,0,3,1,2013-07-10 17:46:48,2013-07-10 17:35:57
6d91bd37075a53f42bab01915fa89ba4a4f0a075...ff8a4058bfac4f360992cfe7adf04f910282cedc,385,7254,7701,14955,1619,2013-07-12 15:56:26,2013-07-12 15:55:57
ff8a4058bfac4f360992cfe7adf04f910282cedc...5e86519199b28e9fe2241c8f6531350ed753613d,112,127,908,1035,121,2013-07-12 20:14:50,2013-07-12 20:14:50
42af62f33adda57d8913768d939c1f4d0f8fe5a3...c79d5163e530892c62b08d8b814b588220c26ec8,12,297,155,452,139,2013-09-25 17:44:53,2013-09-25 10:57:03
c79d5163e530892c62b08d8b814b588220c26ec8...85898d196718ef2e2129ed98b8865ee4b2658f0b,20,551,52,603,58,2013-09-26 16:19:50,2013-09-26 16:18:06
85898d196718ef2e2129ed98b8865ee4b2658f0b...eb091458c0f264f6bf8246b7f5626b8e8500148e,1,27,0,27,1,2013-09-26 17:07:18,2013-09-26 17:07:18
eb091458c0f264f6bf8246b7f5626b8e8500148e...2e13d0ce17d75b30db22dea058f35207ecf1ad66,1,0,6,6,3,2013-09-27 07:17:55,2013-09-27 03:03:59
2e13d0ce17d75b30db22dea058f35207ecf1ad66...60a1dbddd2a4f6341c0fbc26e3fcdf3f16bcbbe8,3,67,3,70,4,2013-10-01 09:13:58,2013-09-28 22:57:33
60a1dbddd2a4f6341c0fbc26e3fcdf3f16bcbbe8...028e652a73319e9c31fd47ef02e10f592b899333,1,8,1,9,1,2013-10-01 09:17:34,2013-09-28 20:26:15
028e652a73319e9c31fd47ef02e10f592b899333...f311963ff94b87c50d146150226d6d3cb07d26c3,1,1,1,2,1,2013-10-01 00:55:32,2013-10-01 00:55:30
f311963ff94b87c50d146150226d6d3cb07d26c3...6820054d2d42ff9274ea0755bea59cfc4f26f353,1,23,0,23,2,2013-10-03 14:27:29,2013-10-02 10:17:57
6820054d2d42ff9274ea0755bea59cfc4f26f353...57231d5286b036f3277e778eca5c4501c99b9ce0,3,58,0,58,6,2013-10-03 14:50:54,2013-10-02 04:37:44
57231d5286b036f3277e778eca5c4501c99b9ce0...9566fe82cddda5b7fe59ace8f8d8851cf9d87268,1,17,5,22,5,2013-10-03 14:50:54,2013-10-03 08:45:32
9566fe82cddda5b7fe59ace8f8d8851cf9d87268...f649626c6faef9d74c1e77608f952b06f4c5205b,1,49,21,70,5,2013-10-03 14:50:54,2013-10-03 09:03:46
f649626c6faef9d74c1e77608f952b06f4c5205b...58729f1bcdcd7b8ac751d10c78a1f7ab867afb74,1,2,3,5,2,2013-10-03 17:28:01,2013-10-03 17:27:51
58729f1bcdcd7b8ac751d10c78a1f7ab867afb74...5b230007adba91163a2f49dbdd9a16d5834fd322,1,6,20,26,6,2013-10-06 11:15:07,2013-10-06 05:22:41
5b230007adba91163a2f49dbdd9a16d5834fd322...711ec07d3402c3494243afe191d6ecd13580fead,3,23,6,29,11,2013-10-07 17:18:13,2013-10-07 17:17:04
711ec07d3402c3494243afe191d6ecd13580fead...406846fcc5193b587d724e0d9a516b581458d499,1,19,4,23,6,2013-10-08 15:20:43,2013-10-05 17:48:33
406846fcc5193b587d724e0d9a516b581458d499...5921158cbe29465ce61285b42c14bfd4433f4b48,4,288,55,343,57,2013-10-08 20:48:53,2013-10-07 20:17:49
5921158cbe29465ce61285b42c14bfd4433f4b48...2b9e3fb1835d8ed0f10bd38e98f3915caf61e26c,1,0,2,2,1,2013-10-08 20:49:22,2013-10-07 21:20:00
2b9e3fb1835d8ed0f10bd38e98f3915caf61e26c...66b8c3c5a03717f3ddc0399c063713e7f6f4ad10,2,11,1,12,4,2013-10-11 17:15:03,2013-09-11 16:18:25
66b8c3c5a03717f3ddc0399c063713e7f6f4ad10...fe0bf6b7ac2063030924e0734d90b600e2c811cb,1,3,1,4,1,2013-10-11 18:57:05,2013-10-11 18:11:36
fe0bf6b7ac2063030924e0734d90b600e2c811cb...8a295cd520bf7fb0e4bf44b7451e1f1fe2456706,3,38,0,38,5,2013-10-11 19:17:23,2013-10-11 18:44:56
8a295cd520bf7fb0e4bf44b7451e1f1fe2456706...7503e4c88273d4c6559af9324174b98ed1ed27ec,1,1,1,2,1,2013-10-11 19:25:42,2013-10-04 03:43:35
7503e4c88273d4c6559af9324174b98ed1ed27ec...527cae22ff8ab193bf17e5dff7420dd50480e407,1,8,8,16,8,2013-10-14 09:07:14,2013-10-14 09:07:14
527cae22ff8ab193bf17e5dff7420dd50480e407...45885a1e8c3177acea04b61fffc7acd799a646ad,2,36,1,37,2,2013-10-14 09:46:09,2013-10-14 09:38:53
45885a1e8c3177acea04b61fffc7acd799a646ad...684dd28a6c684532336777348875ac11305727b9,3,13,2,15,3,2013-10-15 08:30:58,2013-10-15 01:26:18
684dd28a6c684532336777348875ac11305727b9...7f66e44dc1e90e7abda2a9ed02d7e8163e1f6358,7,287,0,287,8,2013-10-13 08:31:20,2013-10-10 20:24:53
7f66e44dc1e90e7abda2a9ed02d7e8163e1f6358...aa94450b31a28d6251df3b88fdd652ddd1e67a69,1,20,0,20,1,2013-10-15 19:12:47,2013-10-15 14:31:14
aa94450b31a28d6251df3b88fdd652ddd1e67a69...d9b4cc323f481bf465384b2012ba5043e18fe098,7,0,287,287,8,2013-10-15 22:58:58,2013-10-15 22:58:58
d9b4cc323f481bf465384b2012ba5043e18fe098...a555992d5ebd93ae873f002e8ff26dba596a62b8,1,0,20,20,1,2013-10-15 22:59:05,2013-10-15 22:59:05
a555992d5ebd93ae873f002e8ff26dba596a62b8...7bf46ba4cedefe8d3b6548a314ad64fc0cfd89f1,7,291,0,291,8,2013-10-16 16:43:19,2013-10-10 20:24:53
7bf46ba4cedefe8d3b6548a314ad64fc0cfd89f1...990141502d2056b93a62042933c574bb0d1fcdab,1,20,0,20,1,2013-10-16 16:44:46,2013-10-15 14:31:14
990141502d2056b93a62042933c574bb0d1fcdab...ab037455094c9e3b9922ae2a380911b2b41ba7ce,1,13,0,13,2,2013-10-16 17:17:12,2013-10-13 00:47:35
ab037455094c9e3b9922ae2a380911b2b41ba7ce...085dd30e93da67362f044ad1b3b6b2d997064692,4,148,5,153,7,2013-10-16 18:01:33,2013-10-10 22:00:05
085dd30e93da67362f044ad1b3b6b2d997064692...ca363cf1ae9631cd6465c3a0028ca0af823a68fb,6,64,109,173,24,2013-10-16 18:24:13,2013-10-15 21:32:18
ca363cf1ae9631cd6465c3a0028ca0af823a68fb...4234bcce486f5c037c9bcc5d121565b2bec9449c,2,36,4,40,6,2013-10-16 18:24:14,2013-10-16 00:54:24
4234bcce486f5c037c9bcc5d121565b2bec9449c...ceb8740a636e59b1e34cb3db0c3c4c79bb501dfa,2,30,31,61,30,2013-10-16 19:56:16,2013-10-15 10:51:12
ceb8740a636e59b1e34cb3db0c3c4c79bb501dfa...a2d1cbef6baabd767cef523078eb4e5921429d09,2,53,7,60,11,2013-10-16 19:56:16,2013-10-15 11:01:23
a2d1cbef6baabd767cef523078eb4e5921429d09...7063c59b97fa4f365f9e5ec1f563235ede4104db,12,86,83,169,24,2013-10-16 20:34:18,2013-10-16 16:34:39
7063c59b97fa4f365f9e5ec1f563235ede4104db...2bc30f239be3e56d642eda38df98c656d55b4d86,22,340,168,508,118,2013-10-16 20:34:19,2013-10-16 16:57:26
2bc30f239be3e56d642eda38df98c656d55b4d86...54910044b33a6405c72ad085915a55c575c027fc,3,72,6,78,9,2013-10-17 01:34:52,2013-10-17 00:11:19
54910044b33a6405c72ad085915a55c575c027fc...a53c763c16eeabb0901a05dbcf38a72fa96d2f26,433,27644,25355,52999,7300,2013-10-23 16:17:31,2013-10-22 22:14:25
a53c763c16eeabb0901a05dbcf38a72fa96d2f26...ef4a35bca5ca5596e04af367a8052959081a655e,4,15,7,22,6,2013-10-23 16:17:31,2013-10-22 22:17:45
ef4a35bca5ca5596e04af367a8052959081a655e...118957174497c67f51f951088dd88a45e97636de,1,3,3,6,3,2013-10-23 16:17:32,2013-10-23 11:42:53
118957174497c67f51f951088dd88a45e97636de...0079e575e03862819ed007404e01dc2e77318e6c,1,12,15,27,11,2013-10-23 16:17:32,2013-10-23 11:45:57
0079e575e03862819ed007404e01dc2e77318e6c...f153d6da450b6ba5c78381e6e90a7ba243657691,2,80,0,80,2,2013-10-23 20:39:05,2013-10-23 20:08:06
5e86519199b28e9fe2241c8f6531350ed753613d...21dd5f4ea90c71758d881d96462b8346ba1520a4,1,88,0,88,1,2013-07-12 22:12:49,2013-07-12 22:12:49
21dd5f4ea90c71758d881d96462b8346ba1520a4...875dd37a93b4d774bf0505c9e18081510b4a0f43,1,2,2,4,1,2013-07-13 00:05:53,2013-07-13 00:04:29
875dd37a93b4d774bf0505c9e18081510b4a0f43...e48536f4cda60987037652616eda73dc39f4122c,1,4,3,7,2,2013-07-15 03:08:07,2013-07-15 03:08:07
e48536f4cda60987037652616eda73dc39f4122c...db5776cf8b51e27967cc27c2a9e07f5310dd4366,2,1078,352,1430,106,2013-07-16 17:49:54,2013-07-15 23:56:02
db5776cf8b51e27967cc27c2a9e07f5310dd4366...04e0324f6a8a4bc39ec2e7488435d023626a6140,1,1,1,2,1,2013-07-16 17:49:54,2013-07-16 00:48:12
04e0324f6a8a4bc39ec2e7488435d023626a6140...48a4600c5669bb2b624bf004bbbb88a2d97ff6f8,2,11,1,12,2,2013-07-17 22:59:28,2013-07-17 20:10:09
61ccaf9a974bedf54622a1d6ad6b6ad00f95f5a5...610022851aaeff7a96518a8ee04826547dc33969,5,47,0,47,5,2013-10-28 12:35:34,2013-10-28 12:35:33
610022851aaeff7a96518a8ee04826547dc33969...4c0195e0340220e53fe5c44299eff53f2f0e210c,4,16,45,61,17,2013-10-28 12:57:22,2013-10-28 12:44:41
4c0195e0340220e53fe5c44299eff53f2f0e210c...3c5ea410ca56da3d4785e2563cb2724364669fd2,3,167,0,167,4,2013-10-28 15:43:43,2013-10-26 01:56:25
48a4600c5669bb2b624bf004bbbb88a2d97ff6f8...e0c4fba0ac2392566258d99f6973bba89ee3b35a,1,4,2,6,2,2013-07-18 18:49:24,2013-07-18 18:47:56
e0c4fba0ac2392566258d99f6973bba89ee3b35a...14f45ba739ac660fd437df9fc4a10415fa35d9a4,2,0,0,0,0,2013-07-20 10:36:33,2013-07-20 10:34:53
14f45ba739ac660fd437df9fc4a10415fa35d9a4...ed806385bfd6d7d0e7e31b49586a78dd33d82d37,1,8,8,16,4,2013-07-23 11:36:46,2013-07-23 11:28:14
ed806385bfd6d7d0e7e31b49586a78dd33d82d37...e20811a62881603ae2b2471a34f21d88716be99f,1,11,14,25,4,2013-07-23 15:12:17,2013-07-23 15:09:09
e20811a62881603ae2b2471a34f21d88716be99f...ff0de45929ab130bec268097c46a1047aba29825,191,1323,1247,2570,351,2013-07-24 20:23:44,2013-07-24 20:23:44
ff0de45929ab130bec268097c46a1047aba29825...4bf52118209753c0c8d48aecb8770e7095c73eee,1,4,4,8,4,2013-07-24 20:37:20,2013-07-24 20:37:20
4bf52118209753c0c8d48aecb8770e7095c73eee...5c81f41e7094ba3db3df27eb443a4f8521dd48dd,6,21,14,35,9,2013-07-25 17:48:29,2013-07-25 17:48:29
0396b20ff48a7adc6e6a59e0465f72fa21bc840f...81307440440127c7c99183734098f97fac5e214d,5,23,7,30,8,2013-10-28 23:18:18,2013-10-28 21:58:37
81307440440127c7c99183734098f97fac5e214d...f755ecf484a9789525746475b924ddf2b3f316d0,7,201,39,240,38,2013-10-29 10:19:47,2013-10-04 11:59:38
f755ecf484a9789525746475b924ddf2b3f316d0...c137e3d2492160433a78a5d453b8768a7a106864,4,1,5,6,5,2013-10-29 16:38:22,2013-10-24 20:10:43
c137e3d2492160433a78a5d453b8768a7a106864...7a7101ac9b5fc34115ba3db278a503b96dcd4a8b,1,1,10,11,3,2013-10-29 21:53:03,2013-10-29 18:43:31
7a7101ac9b5fc34115ba3db278a503b96dcd4a8b...a9a53ca05a410b8ca1067b4f1f2357c319e113d8,1,3,8,11,7,2013-10-29 21:53:03,2013-10-29 19:49:41
a9a53ca05a410b8ca1067b4f1f2357c319e113d8...4b84e42f67d7754574bf7d289524f6dffcb5e14a,4,34,26,60,26,2013-10-29 22:09:44,2013-08-27 18:30:06
4b84e42f67d7754574bf7d289524f6dffcb5e14a...93f75a86bf6c87aa897312740aab61282b0eff1d,17,137,202,339,104,2013-10-29 22:09:44,2013-10-29 19:27:24
93f75a86bf6c87aa897312740aab61282b0eff1d...60a3e695cb6ff09f81de4195368535fdb11e2da9,9,68,80,148,65,2013-10-29 22:09:44,2013-10-29 19:49:53
60a3e695cb6ff09f81de4195368535fdb11e2da9...f2e3be53bc33fc9269c248cec4ac26d6ec9054f7,12,17,45,62,25,2013-10-29 22:09:44,2013-10-29 20:09:52
f2e3be53bc33fc9269c248cec4ac26d6ec9054f7...613d76ef6a00ec091367de1e63bc51e3ab672cbd,20,156,156,312,156,2013-10-29 22:09:44,2013-10-29 20:23:58
613d76ef6a00ec091367de1e63bc51e3ab672cbd...a35a212f258812bd178f7f002660a0ddc0bf10b2,78,1389,580,1969,403,2013-10-29 23:33:17,2013-10-29 23:33:17
a35a212f258812bd178f7f002660a0ddc0bf10b2...74a664b22f2caf3ea42dcf66da638fb86aa4b81e,1,13,9,22,3,2013-10-29 23:46:15,2013-10-29 23:46:15
5c81f41e7094ba3db3df27eb443a4f8521dd48dd...fdf57f811f9683a4ec49a74dc7226517e32e6c9d,3,23,3,26,4,2013-07-25 18:49:01,2013-07-25 18:49:01
74a664b22f2caf3ea42dcf66da638fb86aa4b81e...f8d86e24f3463c36f7f3f4c3b3ec779e5b6201e1,3,52,1,53,3,2013-10-30 00:08:07,2013-10-30 00:08:07
e2a598b5f24973a481de7a0efc2d71ebec71fe1a...90c448de2398ffa5e646040715db04a9f764eacb,1,2,2,4,2,2013-07-25 20:54:16,2013-07-25 20:54:16
90c448de2398ffa5e646040715db04a9f764eacb...0256edc43ebbfc775c5cb8be62ecf838271f015f,1,72,0,72,1,2013-07-25 20:54:55,2013-07-25 20:54:55
0256edc43ebbfc775c5cb8be62ecf838271f015f...0de5b831e2e8f1de5ce16d8a002ce246ceea6e76,1,4,0,4,1,2013-07-25 21:21:54,2013-07-25 21:21:52
0de5b831e2e8f1de5ce16d8a002ce246ceea6e76...015ec05272cf9742bcfaea1f8884e81c31285f5f,1,4,4,8,2,2013-07-25 22:29:03,2013-07-25 22:24:27
e98d8a3eb2fa6f98ffc6ce38717066c5835d7baf...bae4c907bcaa728d81ee8c264be1bafba9a45b71,1,2,2,4,2,2013-10-30 15:55:06,2013-10-30 15:55:06
bae4c907bcaa728d81ee8c264be1bafba9a45b71...691b9ebc8c99acce9e8a57373b2b0daae3eadba0,4,89,10,99,11,2013-10-30 21:13:44,2013-10-22 02:08:28
691b9ebc8c99acce9e8a57373b2b0daae3eadba0...5977cba985a4a1831ab5679a7701026f544d9080,3,50,2,52,5,2013-10-30 21:57:17,2013-10-28 10:25:27
5977cba985a4a1831ab5679a7701026f544d9080...ba7c9ce9649886edf77d01cdcec216c8a0c76f48,2,2,3,5,2,2013-10-30 21:57:20,2013-10-28 12:10:10
ba7c9ce9649886edf77d01cdcec216c8a0c76f48...c4def505cb333d96915fa234b296327ae3a274c6,5,77,72,149,41,2013-10-29 20:55:48,2013-10-28 19:18:59
c4def505cb333d96915fa234b296327ae3a274c6...21fbbd579080bab569c66100471a4c7b462bb0d6,1,6,2,8,3,2013-10-31 19:39:43,2013-10-31 19:39:43
21fbbd579080bab569c66100471a4c7b462bb0d6...efa62fd9cc817434206d9fd8592b7bbeaa240e9c,26,1594,200,1794,128,2013-10-31 21:17:51,2013-09-24 21:12:11
efa62fd9cc817434206d9fd8592b7bbeaa240e9c...8b8e3b67980d5be9feb03839c2821bd8be3680a3,14,102,176,278,97,2013-10-31 21:17:51,2013-09-27 17:30:02
8b8e3b67980d5be9feb03839c2821bd8be3680a3...ccec14b5689b954cbc3b7c409fa36ffb4472226f,7,387,1,388,10,2013-10-31 23:34:11,2013-10-07 19:39:52
ccec14b5689b954cbc3b7c409fa36ffb4472226f...66d908f09a636ac5c27761daa0a70f5aa39e7505,2,75,40,115,22,2013-10-31 23:34:35,2013-09-29 06:33:29
66d908f09a636ac5c27761daa0a70f5aa39e7505...95c38107c2f589730228355e3cd8b1ed7ccc5ab6,1,128,66,194,19,2013-10-31 23:34:35,2013-10-01 00:24:41
95c38107c2f589730228355e3cd8b1ed7ccc5ab6...fbe7eec1eca4f26a40e32f169d5b48b1a6d41334,1,9,36,45,9,2013-10-31 23:34:35,2013-09-28 00:04:30
fbe7eec1eca4f26a40e32f169d5b48b1a6d41334...bc39bdd995d70238eea4a217386869d94c69f614,15,261,603,864,87,2013-10-31 23:34:35,2013-10-29 23:35:32
bc39bdd995d70238eea4a217386869d94c69f614...005cc05a5671996c67021e569c0f86241831ebb1,11,667,2,669,12,2013-11-01 00:10:23,2013-10-15 20:50:00
005cc05a5671996c67021e569c0f86241831ebb1...fe4fbc2a1e664516f54ca483d2726402c8518be4,2,216,2,218,4,2013-11-01 00:10:39,2013-10-30 00:05:40
fe4fbc2a1e664516f54ca483d2726402c8518be4...df3537102b9ba335f05315e513e7cb0123321362,1,2,1,3,2,2013-11-01 14:44:44,2013-11-01 14:44:43
df3537102b9ba335f05315e513e7cb0123321362...d2a600200ee0a4befd49176e8fc981a28bf611c6,1,3,3,6,3,2013-11-01 23:36:23,2013-11-01 20:57:09
d2a600200ee0a4befd49176e8fc981a28bf611c6...bb909ad64285194b3d02322e3fb4b17ff5192c50,28,363,145,508,49,2013-10-30 07:34:47,2013-10-14 14:53:59
bb909ad64285194b3d02322e3fb4b17ff5192c50...962686b67b995edab7b87ef8fba024eed24ae92d,1,16,14,30,5,2013-11-03 20:06:46,2013-11-03 20:00:37
962686b67b995edab7b87ef8fba024eed24ae92d...9bc53d887ad8b7da1b6656a14ccc56fa3312bda5,2,4,3,7,4,2013-11-04 17:39:29,2013-11-04 17:39:29
9bc53d887ad8b7da1b6656a14ccc56fa3312bda5...7acdabbf5005dd8b77548f4b0ff9edd525ea662d,1,1,1,2,1,2013-11-04 21:44:22,2013-11-04 21:42:48
7acdabbf5005dd8b77548f4b0ff9edd525ea662d...515607a740222f9a9d25009b739bcd572720b793,2,51,2,53,2,2013-11-05 07:27:05,2013-11-05 07:23:58
515607a740222f9a9d25009b739bcd572720b793...a6ddfe20d2bc256c71551b932a353d1b6491efd1,2,36,13,49,12,2013-11-05 14:14:28,2013-11-05 14:14:28
a6ddfe20d2bc256c71551b932a353d1b6491efd1...60958d235d6ad789b034a67a528a7d680ac1c727,1,1,1,2,1,2013-11-06 12:32:22,2013-09-01 17:41:00
60958d235d6ad789b034a67a528a7d680ac1c727...1ce5db4d95ef8d522592db33a131780754935fc3,2,160,9,169,3,2013-11-07 07:42:41,2013-11-06 11:58:03
1ce5db4d95ef8d522592db33a131780754935fc3...10cf8ade635602624641f953d78b53ca5a26aa6b,1,1,1,2,1,2013-11-07 11:38:00,2013-11-07 11:34:22
10cf8ade635602624641f953d78b53ca5a26aa6b...ea8feced871849715608cc47618d8ee1cf82742b,2,40,0,40,2,2013-11-07 16:24:50,2013-11-03 22:32:03
ea8feced871849715608cc47618d8ee1cf82742b...014ab77276378ed9be918e77cf07fb7e6ad6b424,2,27,10,37,4,2013-11-08 13:01:02,2013-08-15 21:30:47
014ab77276378ed9be918e77cf07fb7e6ad6b424...3facd4e1dc458aa6790403c0a86beb277cc33efb,1,3,0,3,2,2013-11-08 16:50:01,2013-11-08 16:47:39
3facd4e1dc458aa6790403c0a86beb277cc33efb...0619467bd349af64c89ac0c325e8663026364bbf,9,18,32,50,19,2013-11-08 21:26:23,2013-11-08 20:44:32
0619467bd349af64c89ac0c325e8663026364bbf...146b2e267b533d31a537414a6a1bb7009b814974,1,2,1,3,1,2013-11-08 21:26:50,2013-11-08 21:23:59
015ec05272cf9742bcfaea1f8884e81c31285f5f...2426d65af860bda7be9f0832a99601cc43c6cf63,2,7,2,9,2,2013-07-25 23:26:15,2013-07-25 23:26:15
a48b64716224d67727af592ff5a51b07c9580405...5ab863de2260b57ac35c4ab2c915904e322eb276,1,241,0,241,1,2013-11-09 22:01:27,2013-11-09 22:01:26
5ab863de2260b57ac35c4ab2c915904e322eb276...e159073da592324d60aefc3226560b8a954e81bf,1,30,70,100,18,2013-11-09 22:37:16,2013-11-09 22:31:54
e159073da592324d60aefc3226560b8a954e81bf...d4c09f20c8d18497aabdc1b75df11397158a7524,1,24785,0,24785,1,2013-11-09 22:37:55,2013-11-09 22:32:12
d4c09f20c8d18497aabdc1b75df11397158a7524...a12870c823b9b67110b27a470fcac342cf1dfbd6,2,3564,3587,7151,3,2013-11-09 22:46:07,2013-11-09 22:46:05
a12870c823b9b67110b27a470fcac342cf1dfbd6...f230a1cf749e984439b5bb9729d9db9f48472827,474,31104,26995,58099,9053,2013-11-11 01:40:36,2013-11-10 01:02:27
f230a1cf749e984439b5bb9729d9db9f48472827...7f09a13bbae62bbd9eb9df10d616974a8ed8c577,1,1,0,1,1,2013-11-11 19:24:31,2013-11-11 19:24:31
7f09a13bbae62bbd9eb9df10d616974a8ed8c577...09724b311ee44e6c7998c7a5cb39e739609eba66,21,76,59,135,119,2013-11-11 09:40:28,2013-11-11 21:02:03
09724b311ee44e6c7998c7a5cb39e739609eba66...fd819efbdfbcf03d4f68b297f9003e160bb6b58d,2,5,3,8,4,2013-11-12 21:01:21,2013-11-11 20:03:08
fd819efbdfbcf03d4f68b297f9003e160bb6b58d...c0d62c207ee67492619bde4af46502b5a3ce6a66,2,10,8,18,8,2013-11-12 21:06:48,2013-11-11 09:34:16
c0d62c207ee67492619bde4af46502b5a3ce6a66...27f115d715478b9a800927498ba606d4a62f927c,17,31,31,62,62,2013-11-12 21:06:48,2013-11-11 09:53:00
27f115d715478b9a800927498ba606d4a62f927c...5235d71f89502febbdab3cb0ce432e345ccf7534,1,18,9,27,9,2013-11-12 21:10:57,2013-11-11 10:31:36
5235d71f89502febbdab3cb0ce432e345ccf7534...4326c6d1b3c9293289b979f51933770eefb47f93,1,2,5,7,2,2013-11-12 21:38:30,2013-11-05 19:56:13
4326c6d1b3c9293289b979f51933770eefb47f93...6cea16f2c9ec0666708e924fa93c664ddb000b5c,1,7,7,14,7,2013-11-12 21:38:30,2013-11-01 21:45:46
6cea16f2c9ec0666708e924fa93c664ddb000b5c...d120d92bfef0b5012e76c636335fee80e9c1e4a9,12,188,160,348,92,2013-11-12 21:38:31,2013-11-04 18:49:55
d120d92bfef0b5012e76c636335fee80e9c1e4a9...9b4aa355e3817f5c5a8c5e5c78b92ce43db72f45,2,10,0,10,3,2013-11-12 21:38:31,2013-11-05 00:24:36
9b4aa355e3817f5c5a8c5e5c78b92ce43db72f45...c414ec1c2cdff8111a60f62f445011708bfd81ba,5,59,10,69,12,2013-11-13 23:29:50,2013-11-13 22:51:32
c414ec1c2cdff8111a60f62f445011708bfd81ba...26a795baa10943a94708646a001f594a38a0b238,1,10,13,23,5,2013-11-13 23:31:22,2013-11-13 23:14:34
26a795baa10943a94708646a001f594a38a0b238...85c8eeb838921ca76146387343a4b2e7d87e6324,1,0,1,1,1,2013-11-14 00:59:07,2013-11-14 00:59:01
85c8eeb838921ca76146387343a4b2e7d87e6324...a263abaa812010710958f89a493e0e5c8b29575a,1,15,6,21,5,2013-11-15 19:48:03,2013-11-14 00:27:20
a263abaa812010710958f89a493e0e5c8b29575a...e5346932bcbc523489c9418b82fde31cb666ee99,2,13,4,17,4,2013-11-15 19:48:08,2013-11-14 01:19:53
e5346932bcbc523489c9418b82fde31cb666ee99...d6df1b91579e95283768935ec3f43eb34e2dc818,1,40,44,84,39,2013-11-15 19:48:09,2013-11-14 23:40:56
d6df1b91579e95283768935ec3f43eb34e2dc818...bd9c66668c6fe45d640bce208da61bd1c864e104,2,55,28,83,8,2013-11-16 13:53:56,2013-11-16 13:39:41
272525714d8670d5c17035e9d728620b126dfb44...33267337fac5abbd9a935436a7310f2e909f7d2a,1,2,2,4,2,2013-07-26 00:03:03,2013-07-26 00:03:03
33267337fac5abbd9a935436a7310f2e909f7d2a...180f9871476dbc4b2f406ffe81c4e50c6b1fe518,1,58,0,58,1,2013-07-26 00:03:21,2013-07-26 00:03:21
180f9871476dbc4b2f406ffe81c4e50c6b1fe518...e4363145bad7fe1bd63fbb2d41101de38477e7fb,1,4,1,5,1,2013-07-25 10:29:20,2013-07-25 10:24:40
e4363145bad7fe1bd63fbb2d41101de38477e7fb...df1673202c94785dec49a17550e78e467e29e55d,1,3,1,4,1,2013-07-27 10:25:59,2013-07-27 05:20:08
df1673202c94785dec49a17550e78e467e29e55d...767c5bf01da8fede026939c52a1550f382b1a894,1,3,1,4,1,2013-07-27 14:02:05,2013-07-27 11:13:55
767c5bf01da8fede026939c52a1550f382b1a894...4881a6a9a3b4e466f852ab9b3a084f7c4a55d8b5,1,1,1,2,1,2013-07-27 22:05:10,2013-07-27 22:05:10
4881a6a9a3b4e466f852ab9b3a084f7c4a55d8b5...dce26ccea16455179ca538f32d2779cfbf20c51b,2,12,0,12,2,2013-07-30 12:32:47,2013-07-30 12:26:11
dce26ccea16455179ca538f32d2779cfbf20c51b...6327d67be3a939b1ce6ac8541504b1f6fc338fd9,2,52,12,64,19,2013-07-30 12:34:19,2013-07-30 12:27:13
2329a254b480a5a0bbe13079dd4bed6b38dfc126...b73967e9a0c1178bdb83dcf115fe7b07c37fdc94,29,522,267,789,101,2013-11-18 23:01:38,2013-11-18 23:01:38
b73967e9a0c1178bdb83dcf115fe7b07c37fdc94...d29fe0f2c667085ec403c4856efca8686c52ceef,1,7,7,14,4,2013-11-19 23:26:30,2013-11-13 23:58:18
d29fe0f2c667085ec403c4856efca8686c52ceef...3ac69469991eab4a4176f3cd851f351119c7efcd,1,15,0,15,3,2013-11-19 23:26:30,2013-11-14 00:48:19
3ac69469991eab4a4176f3cd851f351119c7efcd...aef652dc111bef8dc970353243ba8ce2c23f014e,1,3,0,3,1,2013-11-20 00:03:11,2013-11-20 00:03:11
aef652dc111bef8dc970353243ba8ce2c23f014e...1fef66ffd4cf302fec7be1e2fd86f209cf1ff0d3,56,3019,347,3366,173,2013-11-20 17:35:08,2013-11-20 16:25:24
1fef66ffd4cf302fec7be1e2fd86f209cf1ff0d3...40d5e9074a0001d53901df2a2e081c8821b3dc22,1,8,1,9,1,2013-11-20 17:35:08,2013-11-20 16:49:40
6327d67be3a939b1ce6ac8541504b1f6fc338fd9...6359e017ac76e971089bcfcffe8dcb921f7f4db4,1,7,5,12,5,2013-07-30 22:06:20,2013-06-11 20:56:03
6359e017ac76e971089bcfcffe8dcb921f7f4db4...3398cce1934004e4d60c7d7605fa7548582c362f,1,93,64,157,6,2013-07-31 11:23:06,2013-07-31 03:50:26
3398cce1934004e4d60c7d7605fa7548582c362f...fc6f8a69438d45640d4d0a76633b57965c1f843a,2,46,4,50,5,2013-08-01 12:52:06,2013-08-01 12:35:13
fc6f8a69438d45640d4d0a76633b57965c1f843a...98db7babccfbf2abe5de4fee6bcaa97aa7ebfe75,1,4,2,6,5,2013-08-01 14:07:46,2013-08-01 14:00:40
98db7babccfbf2abe5de4fee6bcaa97aa7ebfe75...9e1eb361e8deb3f296a3c9d01de8fcc10361443f,1,3,1,4,2,2013-08-01 14:14:14,2013-08-01 14:09:42
9e1eb361e8deb3f296a3c9d01de8fcc10361443f...bea9dfa14c5f0e248202cbc97d8f4ce20992f556,147,8088,198,8286,164,2013-08-02 21:55:22,2013-08-02 21:55:01
bea9dfa14c5f0e248202cbc97d8f4ce20992f556...6a7be99703000fedf738e46ca5937d73809c8167,1,14,10,24,8,2013-08-05 10:26:09,2013-08-02 19:41:24
6a7be99703000fedf738e46ca5937d73809c8167...231092d236de590a7448ed4257e121f308875326,1,34,0,34,1,2013-08-05 11:11:38,2013-03-14 20:31:18
231092d236de590a7448ed4257e121f308875326...6b92a7132141909eef8ebbf5283627e8e5a26786,2,12,1,13,2,2013-08-05 16:17:24,2013-07-15 11:41:41
6b92a7132141909eef8ebbf5283627e8e5a26786...366baedfd8bbdaa24f85d173125ee31d7f447c62,1,220,49,269,5,2013-08-05 20:56:05,2013-08-05 20:56:05
366baedfd8bbdaa24f85d173125ee31d7f447c62...23d92ec88e0dfe4c2224a2ec4a67ae1ca2bd448d,2,67,1,68,3,2013-08-06 15:15:13,2013-08-05 09:56:40
eaba9417b118c072191705d11c02ebce3326ed6a...dcfd032bdd69dfb38c120e18438d6316ae522edc,3,45,1,46,3,2013-11-21 00:03:31,2013-11-21 00:03:31
23d92ec88e0dfe4c2224a2ec4a67ae1ca2bd448d...b1acb2ebd6e023e00f5df23c46e66513ffda04a8,1,88,0,88,1,2013-08-07 00:14:53,2013-08-07 00:14:53
b1acb2ebd6e023e00f5df23c46e66513ffda04a8...255650f4d9738fd55800d9f16942f74dcb19f8a9,2,67,23,90,6,2013-08-15 22:01:28,2013-08-15 22:01:28
255650f4d9738fd55800d9f16942f74dcb19f8a9...f55aca65154e7df01f4bfd1809f200844673f6d4,1,2,0,2,2,2013-08-16 14:50:01,2013-08-16 14:49:00
f55aca65154e7df01f4bfd1809f200844673f6d4...5abdef790c5b9ea5d8424289bf026b3e422ccf7e,365,5267,10077,15344,645,2013-08-16 15:19:31,2013-08-16 15:19:31
9b985e58a939944faeae8161672d2aebaab0b74d...1a7d3e2b72abdd9a523409324ff7eca27633edf0,1,2,2,4,2,2013-11-21 00:40:47,2013-11-21 00:40:47
1a7d3e2b72abdd9a523409324ff7eca27633edf0...5757642e912c0a4de6476fc766748b6e33ac845b,2,39,0,39,2,2013-11-21 23:01:53,2013-11-21 22:41:40
5757642e912c0a4de6476fc766748b6e33ac845b...16a402c0b5444b167887a20bb44c2ab53aacb97c,3,91,3,94,5,2013-11-23 19:16:16,2013-11-21 10:04:39
16a402c0b5444b167887a20bb44c2ab53aacb97c...de8c0a51a7ab3ae8d70b58883b0705e62313b2fb,1,1,1,2,1,2013-11-23 22:07:41,2013-11-23 22:05:34
de8c0a51a7ab3ae8d70b58883b0705e62313b2fb...b3e4fc6a48b97b52bd19de43c76b7082dcab4988,2,10,1,11,3,2013-11-25 19:28:30,2013-11-20 18:10:41
b3e4fc6a48b97b52bd19de43c76b7082dcab4988...84c03a984a5aa70bd124b96556bcc9345871fd70,4,15,1,16,4,2013-11-26 13:24:37,2013-11-25 14:09:57
5abdef790c5b9ea5d8424289bf026b3e422ccf7e...50b4c905a4425430ae54db4906f88982309e128d,3,24,1,25,3,2013-08-16 15:32:38,2013-08-16 15:31:10
85c19175ed9d95b30e6c4c38129ee2901fa2d82b...04b92632bd9e1546b4c39cf52ea029d53e70cd8c,8,3585,0,3585,19,2013-11-27 16:39:57,2013-11-24 15:13:46
04b92632bd9e1546b4c39cf52ea029d53e70cd8c...c749a841cd828cc85a0fa2052e664ce5e0b6273b,3,7,4,11,7,2013-11-27 18:56:24,2013-11-22 23:18:06
c749a841cd828cc85a0fa2052e664ce5e0b6273b...5ce4eed54dceb15c34d3508e733124edd282601b,2,65,2,67,4,2013-11-27 23:37:56,2013-11-27 10:54:58
e679739b637eb3383547d36f45268576198b8ca2...0e043528a1b69d002fb1f06ad2ddf93ef2118c94,1,2,2,4,2,2013-08-16 19:47:29,2013-08-16 19:47:29
0e043528a1b69d002fb1f06ad2ddf93ef2118c94...a66d2400a09648dfe43902c1ab206ef4fd433db7,1,74,0,74,1,2013-08-16 19:47:54,2013-08-16 19:47:54
a66d2400a09648dfe43902c1ab206ef4fd433db7...5453619eb2a3bb3e5cae1c1379e3985c724e12c6,2,43,1,44,3,2013-08-17 13:35:09,2013-07-30 13:43:31
5453619eb2a3bb3e5cae1c1379e3985c724e12c6...0c2960ef4ab83f0eef2fc60c2575403c33ba4c6b,3,57,4,61,5,2013-08-17 15:11:02,2013-08-09 00:33:40
0c2960ef4ab83f0eef2fc60c2575403c33ba4c6b...545807918ee72f55dfefc6a4c557e3d4e2018ee1,2,85,4,89,4,2013-08-19 16:26:49,2013-08-19 14:59:39
4bd5f35889ed7d52b7c9030d921a7ece6930544e...9ba0d905b0da23d540c23b073d794989612d4664,1,1,4,5,1,2013-12-05 19:59:22,2013-12-04 19:04:47
9ba0d905b0da23d540c23b073d794989612d4664...9e32a7daaa62c809eaafa171e898f6d61865cff2,3,24,2,26,7,2013-12-06 00:15:21,2013-11-21 16:13:58
9e32a7daaa62c809eaafa171e898f6d61865cff2...f572b91c3ea71e6854cb699ae728a320662bc261,2,22,14,36,7,2013-12-06 03:45:19,2013-12-05 15:16:01
f572b91c3ea71e6854cb699ae728a320662bc261...1903240f2a5a3fbf723e7736c5dd14f906de98fb,18,18239,0,18239,56,2013-12-06 07:10:24,2013-11-27 22:14:00
1903240f2a5a3fbf723e7736c5dd14f906de98fb...f5ab3e4c5cd37b76d60f657190b315183dbefeba,2,4,2,6,2,2013-12-06 22:32:03,2013-12-06 10:30:13
f5ab3e4c5cd37b76d60f657190b315183dbefeba...03747f69fba646dc9902519c1736d5f4f267ef7b,4,43,4,47,5,2013-12-06 23:47:57,2013-11-27 22:49:30
03747f69fba646dc9902519c1736d5f4f267ef7b...06b194529828567086190681e2aee8ce2a00d760,1,16,11,27,4,2013-12-06 23:48:43,2013-11-27 20:11:17
06b194529828567086190681e2aee8ce2a00d760...0da4e0e8439a453d197484402f9f14798c6e00d0,2,57,16,73,16,2013-12-07 00:17:52,2013-11-22 02:49:41
0da4e0e8439a453d197484402f9f14798c6e00d0...aef09601b4320648f4b6fac0baba3e5c54b0406a,2,69,1,70,2,2013-12-07 00:25:42,2013-11-22 02:44:08
aef09601b4320648f4b6fac0baba3e5c54b0406a...f4f4a2b9f8f1a1e012e184c0265a577f180d789c,1,6,0,6,1,2013-12-07 00:48:45,2013-12-03 04:59:34
545807918ee72f55dfefc6a4c557e3d4e2018ee1...732f8b964152d4bff6033628c9b3904cf0ba554d,1,2,2,4,1,2013-08-19 22:45:35,2013-07-04 16:52:14
732f8b964152d4bff6033628c9b3904cf0ba554d...31a27ca72d696db94705dafa2e4dba682979ef52,1,22,0,22,1,2013-08-19 22:53:09,2013-05-23 01:04:36
31a27ca72d696db94705dafa2e4dba682979ef52...2385fbbc3ad9f2dbf1b49752667f035f593530ae,1,1,1,2,1,2013-08-19 23:10:05,2013-08-11 19:30:03
2385fbbc3ad9f2dbf1b49752667f035f593530ae...9456cf8fe2b42ccfb2a9561cd50430e623bdc6d2,1,18,5,23,4,2013-08-19 23:33:38,2012-12-04 10:12:10
9456cf8fe2b42ccfb2a9561cd50430e623bdc6d2...26a8c0c6b8f9ed51a574a0bbaebe95e8f36706d5,1,2,2,4,1,2013-08-20 00:55:58,2013-08-20 00:55:58
26a8c0c6b8f9ed51a574a0bbaebe95e8f36706d5...e04c8a8ee400b6453cdb1133e7dd6791b69c0834,2,17,11,28,3,2013-08-20 15:10:18,2013-08-20 13:53:54
e04c8a8ee400b6453cdb1133e7dd6791b69c0834...af6a2339c56e89d7cf999cd64a69842a531c05dc,1,8,1,9,1,2013-08-21 12:15:08,2013-08-21 11:58:33
af6a2339c56e89d7cf999cd64a69842a531c05dc...8d42c6344b7a96dbb42dd65e01617028d05d413a,2,30,9,39,12,2013-08-21 01:40:43,2013-08-21 01:33:20
fcca3585fea09ab4a5a86628dceeb248ff82b1ff...f9f9239fa2f1c33e17ed3b0e830099f64a70bd37,1,3,1,4,2,2013-12-07 19:49:49,2013-12-07 19:49:49
f9f9239fa2f1c33e17ed3b0e830099f64a70bd37...e0d31ea2dbdc33dda0f295ceda07b7fc1de4e09c,5,260,1,261,14,2013-12-07 20:00:02,2013-11-19 21:38:15
e0d31ea2dbdc33dda0f295ceda07b7fc1de4e09c...7222539936faa080f418f998e0eca6adda3af1fd,1,3,1,4,1,2013-12-10 01:11:38,2013-12-10 01:11:38
7222539936faa080f418f998e0eca6adda3af1fd...f9e3364a473256a0ef76db1d04f257b0fc4a3b0a,1,3,1,4,1,2013-12-10 16:09:07,2013-12-10 13:25:27
f9e3364a473256a0ef76db1d04f257b0fc4a3b0a...259d44962291bc73ae60919ea6442d762ee139d2,3,39,2,41,3,2013-12-10 17:33:33,2013-12-06 11:56:37
259d44962291bc73ae60919ea6442d762ee139d2...78cd4533d9f14cd83e9cd7817dffdd4e6af600c5,1,7,2,9,3,2013-12-10 18:08:41,2013-11-21 17:06:29
78cd4533d9f14cd83e9cd7817dffdd4e6af600c5...c17449df1675e482fc0350a27bc08b1b22ed261c,1,1,1,2,1,2013-12-10 18:28:26,2013-12-10 18:28:26
8d42c6344b7a96dbb42dd65e01617028d05d413a...8a9434c4ef96e39031a222b99080f68fef62759a,1,3,0,3,1,2013-08-21 18:11:02,2013-08-21 18:11:02
8a9434c4ef96e39031a222b99080f68fef62759a...985695e4d6ab333fcc50c48c7ffb5617587efb65,1,110,0,110,1,2013-08-21 21:26:32,2013-08-21 21:26:32
985695e4d6ab333fcc50c48c7ffb5617587efb65...e445fbda1f76ee87141c7320f31f29a8a9a1729f,3,12,3,15,3,2013-08-21 21:44:20,2013-08-21 21:44:20
e445fbda1f76ee87141c7320f31f29a8a9a1729f...469a4a5091a677df62be319675056b869c31b35c,3,22,2,24,3,2013-08-21 22:00:56,2013-08-21 22:00:56
ba706bacf31a0ebaf5e97dec2fa3f1b3b04a17d5...ceea1e845adb41f28568287708e956df682d1f7b,1,16,8,24,1,2013-12-11 06:13:05,2013-12-10 14:52:27
ceea1e845adb41f28568287708e956df682d1f7b...c5d49ba9c295078173247e11fac3ca635f60a5a6,1,1,4,5,1,2013-12-11 06:16:24,2013-12-10 19:32:29
c5d49ba9c295078173247e11fac3ca635f60a5a6...153784b3489e2feb9d93a3a5eee5a4aa34f74e39,1,13,6,19,5,2013-12-11 17:21:00,2013-12-11 17:19:04
153784b3489e2feb9d93a3a5eee5a4aa34f74e39...6f3d60388eb8be4f24e6e8312f7bc85f5f8773c3,13,182,119,301,29,2013-12-11 17:21:10,2013-12-11 17:20:17
6f3d60388eb8be4f24e6e8312f7bc85f5f8773c3...4d5489667cb073ec9d82ef292ecd0749de494238,1,19,11,30,5,2013-12-12 17:31:59,2013-12-11 03:10:10
fcf180327b95328dd25c64b8301cbf0c430530cd...3c66b1578925685fa9fedfd7476a8270e97a51d9,1,2,2,4,2,2013-08-21 23:37:43,2013-08-21 23:37:43
3c66b1578925685fa9fedfd7476a8270e97a51d9...1d27987dab20d1c793482ed8fa77ed8b07cd65ea,1,92,0,92,1,2013-08-21 23:38:30,2013-08-21 23:38:30
1d27987dab20d1c793482ed8fa77ed8b07cd65ea...92e43751731e2186e323f20b2ade57ac8adfba05,1,19,0,19,1,2013-08-21 23:55:27,2013-08-21 23:55:27
92e43751731e2186e323f20b2ade57ac8adfba05...3f1dba18b24a18d857462cd6153e281e96a1d295,2,80,1,81,2,2013-08-21 23:59:15,2013-08-21 23:59:15
3f1dba18b24a18d857462cd6153e281e96a1d295...5508236c49ee71792041fb6e62cfd2af3de60e6c,7,544,273,817,65,2013-08-23 17:02:14,2013-08-23 17:02:14
5508236c49ee71792041fb6e62cfd2af3de60e6c...a3da3e73121d68615c5408814284d333f38db692,2,62,0,62,2,2013-08-27 21:53:06,2013-08-27 21:53:06
a3da3e73121d68615c5408814284d333f38db692...02eb9c834a1ea6d97af17c556b6d63315da4aca5,1,1,1,2,1,2013-08-28 02:52:49,2013-08-28 02:52:09
02eb9c834a1ea6d97af17c556b6d63315da4aca5...fbb963b5d520a70d9c3f2f9ec116d79a0c676f80,1,1,1,2,1,2013-08-28 16:35:39,2013-08-28 16:35:36
069dd07a1732c6a752773aaed9e8c18ab472375f...f61d9405bfcf0fa113a13d57d41fef7d74a69538,32,824,139,963,90,2013-12-13 18:35:09,2013-12-13 18:35:09
fbb963b5d520a70d9c3f2f9ec116d79a0c676f80...01f3b468a917ba89c3deab0e5f90e3f37f3dc169,1,23,21,44,2,2013-08-31 17:36:44,2013-08-31 05:39:06
6b4dc61322a932d356ae44821f965fddccb4a7dc...8803aa3af7031e4844eb6eeb6d6e53919808ea3d,17,343,141,484,58,2013-12-13 23:16:52,2013-12-13 23:16:52
8803aa3af7031e4844eb6eeb6d6e53919808ea3d...8a79cca80cd3d4a577c680cfcb72877bcaab8df2,1,1,1,2,1,2013-12-15 10:24:51,2013-12-14 22:47:00
8a79cca80cd3d4a577c680cfcb72877bcaab8df2...95ee84fabe0b028ef964cc1032cd56a6cf89cb0e,4,39,5,44,6,2013-12-18 13:58:02,2013-12-14 21:09:28
95ee84fabe0b028ef964cc1032cd56a6cf89cb0e...cdc038ceb60cbdd14e98b69e5afc0671ff07c6fc,2,16,24,40,12,2013-12-18 23:16:36,2013-12-17 15:43:38
cdc038ceb60cbdd14e98b69e5afc0671ff07c6fc...9be6470b534a9da0c93878fa87e6f9574a57acaf,1,0,9,9,1,2013-12-19 08:44:50,2013-12-18 18:08:33
9be6470b534a9da0c93878fa87e6f9574a57acaf...2394b974cc2bc5fe93c901319895599d22fdca20,1,22,22,44,2,2013-12-19 08:51:34,2013-12-19 08:51:34
2394b974cc2bc5fe93c901319895599d22fdca20...59fb0185ec9f3a0a04e6c114c70b6121ab92a4f3,1,0,1,1,1,2013-12-19 11:43:21,2013-12-19 11:11:19
01f3b468a917ba89c3deab0e5f90e3f37f3dc169...00a1d3633c3ed71977a981105de189915eb70e6d,1,1,2,3,1,2013-09-01 00:58:17,2013-09-01 00:58:17
5b96d6baf6c29340ed455311127f0d08e49e0236...a15c44b1756f05c4445151268378ea990a1f5dad,1,24,4,28,5,2013-12-19 22:59:11,2013-12-19 22:57:30
a15c44b1756f05c4445151268378ea990a1f5dad...a35a2f0192f78c762ed1009025e673cf09862d4d,12,647,96,743,110,2013-12-20 13:33:29,2013-12-20 13:33:29
a35a2f0192f78c762ed1009025e673cf09862d4d...7ffe2ad6167e193c7eda46a2db31c153e07d97bd,7,102,1,103,14,2013-12-20 13:55:08,2013-09-22 14:06:58
7ffe2ad6167e193c7eda46a2db31c153e07d97bd...ea18aecc82786cf54abefbdd79f9a46753ad2363,1,11,2,13,4,2013-12-20 15:23:34,2013-12-19 16:44:33
ea18aecc82786cf54abefbdd79f9a46753ad2363...f030d8426aa3241ad180c385f15134548579e7ce,1,12,0,12,2,2013-12-20 16:40:28,2013-12-19 15:55:06
f030d8426aa3241ad180c385f15134548579e7ce...54da818e4bec4e5a0a1928441ec6fc90b4903ba0,1,13,10,23,2,2013-12-20 20:47:24,2013-12-12 22:59:40
54da818e4bec4e5a0a1928441ec6fc90b4903ba0...2ca69051608f3cdbfa28e65de9ddd326a13cd000,1,0,43,43,6,2013-12-20 21:01:17,2013-12-12 21:16:08
2ca69051608f3cdbfa28e65de9ddd326a13cd000...7c3643b76788b15a5712a316831a35f1ab9b7f91,2,9,0,9,2,2013-12-20 21:03:05,2013-12-19 09:04:34
7c3643b76788b15a5712a316831a35f1ab9b7f91...87cde4428036b7ddd1c51f2c00414c02bb46b8ee,4,5,39,44,6,2013-12-20 21:44:56,2013-12-20 21:44:56
87cde4428036b7ddd1c51f2c00414c02bb46b8ee...82098bb97bbed9404da1f6386490837a05318d5e,2,12,8,20,7,2013-12-21 02:57:46,2013-12-19 06:02:19
82098bb97bbed9404da1f6386490837a05318d5e...055f7e9da99561a549ea887bb88ec93ad423b182,3,31,1,32,3,2013-12-23 11:08:11,2013-12-23 06:18:08
055f7e9da99561a549ea887bb88ec93ad423b182...8c4b2c35a46b417867783393211a4870930fd342,1,1,1,2,1,2013-12-26 17:17:19,2013-12-26 03:08:10
8c4b2c35a46b417867783393211a4870930fd342...96dffb12177570a1311e97df501142e56b606c02,12,559,134,693,57,2013-12-27 16:06:12,2013-12-18 14:58:47
96dffb12177570a1311e97df501142e56b606c02...8d3bc88bbe3c0690f433a97c1df33fca099f18be,2,3,6,9,3,2013-12-30 19:41:37,2013-12-28 12:59:57
8d3bc88bbe3c0690f433a97c1df33fca099f18be...7ced966a32dd18b4de2768f41796af76638341f9,1,4,2,6,2,2013-12-30 22:58:38,2013-12-10 05:01:25
00a1d3633c3ed71977a981105de189915eb70e6d...95794641d2e3f37b7f7559ed7fd3e04a596c3295,1,1,1,2,1,2013-09-04 08:25:51,2013-09-03 22:00:45
3dcb71f962f4d0a1032b442840611cafdbea9676...58d6ca3a958f75487fa630004c683052b102dd74,1,1,1,2,1,2013-12-31 09:46:38,2013-12-31 00:51:51
58d6ca3a958f75487fa630004c683052b102dd74...8590f810a534628a7ee449530d93fee67597476a,24,299,58,357,57,2013-12-31 18:33:54,2013-12-31 18:33:54
8590f810a534628a7ee449530d93fee67597476a...3c649703c714f9654f8b6f47ecaa7f93c05a38f8,1,1,1,2,1,2013-12-31 19:43:43,2013-12-03 01:24:58
3c649703c714f9654f8b6f47ecaa7f93c05a38f8...6f40abe2d445516de629d289afe21f458e7cc1e9,2,41,3,44,2,2013-12-31 19:43:43,2013-12-12 18:34:16
6f40abe2d445516de629d289afe21f458e7cc1e9...dce35146e0e52de32c3836d01ada10f3ebbe8792,4,161,5,166,7,2013-12-31 19:43:43,2013-12-03 03:00:39
dce35146e0e52de32c3836d01ada10f3ebbe8792...876d3bd85aabe7fce71a025a89c6b3f6ddbf2053,2,9,7,16,3,2013-12-31 19:43:44,2013-12-18 00:04:20
876d3bd85aabe7fce71a025a89c6b3f6ddbf2053...cb1646f44eb092f1771740fc5f0ec6775d5fbe73,3,10,3,13,5,2013-12-31 19:43:44,2013-12-31 05:36:49
95794641d2e3f37b7f7559ed7fd3e04a596c3295...67a1f0c52e0708e2596f3f2134b8386d6112561e,2,11,2,13,2,2013-09-04 17:51:53,2013-09-04 17:51:53
13de0f1d278a49b2bafac6471bec6c14c3c9376b...bddea032b7f2b0f2854faa18855249286bd99428,4,121,4,125,6,2013-12-31 22:30:40,2013-10-21 13:47:57
86d881f888fe1a92dc52b346771e5b9ee5c4ed5e...65ed79a6dc9830a62d297caeb5278691df65fbde,1,2,2,4,2,2013-09-04 18:25:19,2013-09-04 18:25:19
65ed79a6dc9830a62d297caeb5278691df65fbde...9c19c1e19c8271a5a1b3126b15780d5fb37937f2,1,62,0,62,1,2013-09-04 18:25:19,2013-09-04 18:25:19
9c19c1e19c8271a5a1b3126b15780d5fb37937f2...8b05206665aa38475a4dd76cd313c53360f4e946,1,92,0,92,1,2013-09-04 22:27:06,2013-09-04 22:27:06
08c83bb172ca963763ef5f53f113e925926a6d7f...5ce4f3ec3d838bdfd77842488b2365706423abe9,2,2,1,3,2,2013-12-31 23:02:38,2013-12-31 23:02:38
8b05206665aa38475a4dd76cd313c53360f4e946...6301613ff57c0be81f9b9e0592ac15b6102daace,5,100,50,150,25,2013-09-05 14:50:47,2013-09-05 14:49:47
6301613ff57c0be81f9b9e0592ac15b6102daace...1da7bcc22ca115d4cb17193bc97cda027ebe2e30,2,54,1,55,2,2013-09-05 20:19:23,2013-09-05 20:11:51
1da7bcc22ca115d4cb17193bc97cda027ebe2e30...1be09dfc25816acc87d96f82348d3bb3844d328e,236,454,407,861,287,2013-09-06 00:13:50,2013-09-06 00:13:50
5ce4f3ec3d838bdfd77842488b2365706423abe9...66931791f06207d1cdfea5ec1529edf3c94026d3,3,62,1,63,4,2013-12-31 23:37:12,2013-12-31 23:37:12
1be09dfc25816acc87d96f82348d3bb3844d328e...ebeae2df518af168a8ebd9117540238f0df916a3,158,2179,1836,4015,276,2013-09-07 19:31:04,2013-09-07 19:31:04
c039bc3a0e80c8493be43a81e28a8bc3cee7adb8...c3e26d64f89537ae7d1741ef49a9c8ec86f15d01,1,2,2,4,2,2014-01-01 00:21:08,2014-01-01 00:21:08
ebeae2df518af168a8ebd9117540238f0df916a3...3546825b1400dfead0d5f87dbd2278586ab4a9e2,1,18,0,18,3,2013-09-07 20:25:50,2013-06-19 11:48:36
3546825b1400dfead0d5f87dbd2278586ab4a9e2...1c3863abfd40b2d95b7151a75427d9fd948e8e63,2,15,4,19,6,2013-09-09 14:18:05,2013-09-09 14:18:05
1c3863abfd40b2d95b7151a75427d9fd948e8e63...9fad8e5dc440b07507039d617bbaadc0be98edb5,3,3,3,6,3,2013-09-13 12:55:08,2013-09-13 12:46:06
9fad8e5dc440b07507039d617bbaadc0be98edb5...7196742852c9da5d29e2fb1e333bca9d21c8e205,2,58,5,63,4,2013-09-13 17:08:35,2013-09-12 01:18:10
7196742852c9da5d29e2fb1e333bca9d21c8e205...afabdf0e1595c2f3f8d4a634218bb7d89190d027,1,6,6,12,2,2013-09-16 20:57:00,2013-09-16 20:57:00
afabdf0e1595c2f3f8d4a634218bb7d89190d027...5bda2bed37526f5da9c27decd8968b0a2710dbeb,1,2,2,4,1,2013-09-16 20:57:34,2013-09-16 20:57:34
5bda2bed37526f5da9c27decd8968b0a2710dbeb...7c554a5cd0f1420e5017ef57252b3d3c6496cea0,1,7,3,10,5,2013-09-19 10:31:52,2013-09-19 10:27:06
7c554a5cd0f1420e5017ef57252b3d3c6496cea0...35ae69682253ea51e59610a9a9e132c78f5e71d5,2,13,1,14,2,2013-09-23 21:22:37,2013-05-20 18:44:26
35ae69682253ea51e59610a9a9e132c78f5e71d5...55546f55d44522a4ecac67ee040e4059b5bf06b0,4,32,19,51,5,2013-09-24 20:46:19,2013-09-24 20:45:57
13eb17f4127469f93db4f248e81e92c87c5b5f58...d9fc6af32a50684930b04f0f2b701eb2fd62192b,22,137,142,279,72,2014-01-03 21:20:23,2014-01-03 00:40:30
d9fc6af32a50684930b04f0f2b701eb2fd62192b...a40b46367406deb0e3c67dff8c5d609d1334519b,2,53,1,54,2,2014-01-04 00:48:11,2014-01-04 00:46:09
a40b46367406deb0e3c67dff8c5d609d1334519b...92b6417098371259730c00360979101ce38cbe12,6,168,2,170,12,2014-01-05 12:42:33,2013-12-14 11:28:07
92b6417098371259730c00360979101ce38cbe12...e1f4f6aa28e14406edab737677636603bf6ab81f,1,30,9,39,4,2014-01-05 13:15:08,2014-01-05 11:07:54
e1f4f6aa28e14406edab737677636603bf6ab81f...f057c7049eea6e6396dfd8117910ccb2a5c8977a,2,4,3,7,2,2014-01-07 19:35:04,2014-01-07 16:51:41
f057c7049eea6e6396dfd8117910ccb2a5c8977a...390598608c900adcc0ce753d5255c0a805505287,135,2024,1543,3567,483,2014-01-07 22:43:17,2014-01-06 15:35:36
390598608c900adcc0ce753d5255c0a805505287...4800310f6aa5dc9dcb564aff7428a2bea6f88d88,15,15,15,30,15,2014-01-08 19:40:24,2014-01-08 19:05:01
4800310f6aa5dc9dcb564aff7428a2bea6f88d88...730e511b3598c5fea416da680060c83ed2751a25,2,15,5,20,6,2014-01-08 20:00:30,2014-01-04 21:50:54
730e511b3598c5fea416da680060c83ed2751a25...0afdfae0eb1ab263337889e716d5e8fe5e54c453,1,1,1,2,1,2014-01-08 21:08:29,2014-01-08 21:08:29
0afdfae0eb1ab263337889e716d5e8fe5e54c453...828f14556e0daeae7fdac08fceaa90952de63f73,13,468,107,575,59,2014-01-09 21:25:20,2014-01-09 19:11:40
828f14556e0daeae7fdac08fceaa90952de63f73...646ac18d7933412dae672d6826154c1eb08d4e82,6,325,161,486,74,2014-01-09 21:47:03,2014-01-03 22:02:51
646ac18d7933412dae672d6826154c1eb08d4e82...82c2084b4ebb431153b54e598c70ced74217af79,1,51,0,51,1,2014-01-09 22:17:13,2014-01-09 13:03:33
82c2084b4ebb431153b54e598c70ced74217af79...2eddd7411234bf633df6a7bdb9c120ed89853324,1,7,3,10,3,2014-01-09 23:07:14,2013-12-07 01:17:02
2eddd7411234bf633df6a7bdb9c120ed89853324...5106cadffba559ac788a8c1b9a555a6d192d95aa,2,60,1,61,2,2014-01-09 23:25:58,2014-01-09 05:36:54
5106cadffba559ac788a8c1b9a555a6d192d95aa...38a07a929bb551451b21513ce6262f416651d12b,2,17,1,18,2,2014-01-10 21:13:46,2014-01-10 19:53:47
38a07a929bb551451b21513ce6262f416651d12b...ec57ecc982df6d4677fc5a347738201effeae5d1,2,129,29,158,6,2014-01-13 17:29:58,2014-01-06 07:59:40
55546f55d44522a4ecac67ee040e4059b5bf06b0...6b5e6a5a3ec8d994c9aab3b800b9edbf1b287904,3,20,2,22,3,2013-09-24 21:10:33,2013-09-24 21:10:33
cb150406c829221c373626653cd955fa981f7241...093efafce307da9f9b2f2880a8cd79a084a285be,1,2,2,4,2,2013-09-24 22:10:22,2013-09-24 22:10:22
093efafce307da9f9b2f2880a8cd79a084a285be...9135c7fea87af0693ef02732c296987a0e62bfef,1,50,0,50,1,2013-09-24 22:10:22,2013-09-24 22:10:22
9135c7fea87af0693ef02732c296987a0e62bfef...cfa03ad2e3423693f6bc56a82696f9c362d71ed0,1,20,0,20,1,2013-09-24 22:16:44,2013-09-24 22:16:44
fc52ed85f6062d1b2e84c6d211ef2a089fd0272d...2e3da9be84f543ecdbffef2e7bf4420d536c78e0,1,3,0,3,1,2014-01-13 23:15:10,2014-01-13 12:57:58
cfa03ad2e3423693f6bc56a82696f9c362d71ed0...671b5be6e9d74fec9e94b1ab88d2b2648c540078,1,1,2,3,2,2013-09-27 19:47:13,2013-09-27 19:47:13
671b5be6e9d74fec9e94b1ab88d2b2648c540078...994ce4c99fb1e284bcfdc2500ae62e0138bf140e,1,4,3,7,1,2013-09-28 08:35:57,2013-09-28 08:27:11
24856f04b23eca659ae05e79795b3e9570f9bd52...262a752c2943842df7babdf55a034beca68794cd,4,72,28,100,15,2014-01-17 18:51:25,2014-01-17 17:15:36
262a752c2943842df7babdf55a034beca68794cd...db5abd726f648cae9edf26cc02fc0e34e4064391,2,6,13,19,3,2014-01-17 18:55:33,2014-01-16 17:06:56
db5abd726f648cae9edf26cc02fc0e34e4064391...cda41f8775e6ad06ca4a500501b1d8712f412893,1,2,2,4,2,2014-01-17 23:37:20,2014-01-15 11:50:01
cda41f8775e6ad06ca4a500501b1d8712f412893...8c303115f5e58f5f3a387c3f433822614754aa36,1,9,3,12,1,2014-01-20 15:33:18,2014-01-20 15:12:37
8c303115f5e58f5f3a387c3f433822614754aa36...023f0a3122d54e3f331f32f5cfe0cb0df9e8f131,1,4,3,7,2,2014-01-20 15:33:18,2014-01-20 15:19:00
023f0a3122d54e3f331f32f5cfe0cb0df9e8f131...7f9b01509f28de5888a45b8b1af5667e507a0c94,5,112,0,112,6,2014-01-20 16:39:57,2014-01-17 18:46:49
7f9b01509f28de5888a45b8b1af5667e507a0c94...442d2d0cdec2dba97341ffd7dff7f7673f3dc242,12,56,21,77,22,2014-01-20 16:55:54,2014-01-18 12:18:25
442d2d0cdec2dba97341ffd7dff7f7673f3dc242...6cc95b06eaef681c66b5d5d574d3aabfc150f04a,5,152,519,671,9,2014-01-20 17:00:13,2014-01-14 01:09:12
6cc95b06eaef681c66b5d5d574d3aabfc150f04a...574f71444c0f4c281e73b5effc4f0bffb42f9e96,12,18,2,20,4,2014-01-20 17:00:13,2014-01-14 01:24:14
574f71444c0f4c281e73b5effc4f0bffb42f9e96...e12e72eb58c68b82f5bbd89e094cf7fb7b7e00c8,2,12,10,22,6,2014-01-20 17:00:14,2013-12-06 16:58:15
e12e72eb58c68b82f5bbd89e094cf7fb7b7e00c8...edfc0d9ffe02bbf72853e508f0f961e9cf5e7684,1,2,2,4,2,2014-01-20 17:00:14,2014-01-13 14:02:16
edfc0d9ffe02bbf72853e508f0f961e9cf5e7684...5393d02c0cbeaedd76ba2ca3c4263f06346363ba,1,8,7,15,4,2014-01-20 17:14:42,2014-01-17 14:28:47
5393d02c0cbeaedd76ba2ca3c4263f06346363ba...159da758e4f5b4279a1e70dc80a0be7125529d75,1,116,115,231,113,2014-01-20 19:29:58,2014-01-17 23:08:47
159da758e4f5b4279a1e70dc80a0be7125529d75...63ccfc35366774fff1ee8db313a1b9ea6d6eb66c,12,2,485,487,21,2014-01-21 18:20:07,2014-01-20 21:20:11
63ccfc35366774fff1ee8db313a1b9ea6d6eb66c...60fcc11be2562306f8961ad6c257959822578823,2,51,2,53,5,2014-01-21 18:20:14,2014-01-21 06:53:56
60fcc11be2562306f8961ad6c257959822578823...bf08ac462e2c706aa4a5da7e8363f6e66c5d18c9,1,3,3,6,3,2014-01-21 18:20:22,2014-01-21 17:22:00
bf08ac462e2c706aa4a5da7e8363f6e66c5d18c9...22879e749e595a730f194615874ca9710a0f5bf1,1,1,1,2,1,2014-01-21 18:21:50,2014-01-14 08:29:57
22879e749e595a730f194615874ca9710a0f5bf1...2a0b619f7b830b2e34f1707f4428c77a6fcf33fc,1,1,1,2,1,2014-01-21 18:23:16,2014-01-14 08:45:00
2a0b619f7b830b2e34f1707f4428c77a6fcf33fc...1442c1c6de1009a7f451a443c02b1450bcb5bc44,10,277,117,394,113,2014-01-21 20:39:13,2014-01-18 22:49:18
1442c1c6de1009a7f451a443c02b1450bcb5bc44...e57ab7ba06e079eb15c97b228d3fbee2a1514d9b,2,7,4,11,6,2014-01-21 20:39:13,2014-01-18 22:49:33
e57ab7ba06e079eb15c97b228d3fbee2a1514d9b...661190af13a82301c61d761c0949b4148e1761f3,2,158,121,279,44,2014-01-21 22:25:14,2014-01-19 23:38:15
661190af13a82301c61d761c0949b4148e1761f3...cdde9a386aca90ae151be9ad9455d0d0586d113b,2,87,3,90,6,2014-01-21 22:42:04,2014-01-20 00:37:15
cdde9a386aca90ae151be9ad9455d0d0586d113b...b9bec2031e5f44f47cf01c3ec466ab8cddfa94f6,1,22,9,31,4,2014-01-22 01:00:56,2014-01-21 22:24:58
b9bec2031e5f44f47cf01c3ec466ab8cddfa94f6...f32c1ffe56590ba7f8d3dc31d8ab1f1fec446d1c,2,57,1,58,2,2014-01-22 01:11:48,2014-01-21 23:28:23
f32c1ffe56590ba7f8d3dc31d8ab1f1fec446d1c...e6016dae348cf105be435abf4b8b318801c09900,1,12,36,48,9,2014-01-22 01:12:40,2014-01-21 23:03:12
e6016dae348cf105be435abf4b8b318801c09900...74d9aa49d57d2c505d1d3712414ca245a805173d,4,86,20,106,22,2014-01-22 11:58:07,2013-11-21 10:29:07
74d9aa49d57d2c505d1d3712414ca245a805173d...6514a4128c3e7aa6c1bb1c6f3f018412fa76e5d9,1,4,1,5,2,2014-01-22 11:58:07,2013-11-21 12:23:43
6514a4128c3e7aa6c1bb1c6f3f018412fa76e5d9...c7f5c98ee9374cee7cac14df44c91c80261cbd86,1,0,1,1,1,2014-01-22 18:55:52,2014-01-22 12:48:46
c7f5c98ee9374cee7cac14df44c91c80261cbd86...103b89673efb3e60892acc3cae73f90e3b7a8bcf,1,8,2,10,2,2014-01-22 20:27:58,2013-12-25 15:59:25
103b89673efb3e60892acc3cae73f90e3b7a8bcf...56ebf308dc9a641dbe432b38d7df257ffec855d5,1,2,0,2,1,2014-01-22 21:33:16,2014-01-22 21:33:16
56ebf308dc9a641dbe432b38d7df257ffec855d5...c79c304ead2e16082465a61156d9e29b01a7909e,4,114,5,119,7,2014-01-23 16:39:32,2014-01-23 12:55:28
c79c304ead2e16082465a61156d9e29b01a7909e...f78e5df85467343bf91b4811bc1cb6cd47cc7575,43,585,147,732,90,2014-01-23 20:26:51,2014-01-23 20:14:40
f78e5df85467343bf91b4811bc1cb6cd47cc7575...74656ca189202539c8805c832ca01dd8e7593cdd,1,1,1,2,1,2014-01-23 21:01:53,2014-01-23 21:01:53
74656ca189202539c8805c832ca01dd8e7593cdd...d019eac5b5fe3522f527547046a9baef8ab9572c,4,118,4,122,10,2014-01-24 18:09:17,2014-01-22 01:07:11
d019eac5b5fe3522f527547046a9baef8ab9572c...640912d18a63704fd493059a72b19e6367c2fc1c,8,141,53,194,45,2014-01-24 18:09:42,2014-01-24 18:08:25
994ce4c99fb1e284bcfdc2500ae62e0138bf140e...d7234c8d50a1af73f60d2d3c0cc7eed17429a481,2,8,2,10,2,2013-09-30 20:52:48,2013-09-30 20:52:48
c1b1f312035644fd33cbc59cacd7980e7ed432da...a454063ea17f94a5d456bb2666502076c0d51795,2,81,3,84,2,2014-01-25 20:03:20,2014-01-24 12:25:11
a454063ea17f94a5d456bb2666502076c0d51795...cc4b6e6e582e868cba9f84195f62a51721f8cbad,7,119,1,120,8,2014-01-25 23:48:36,2014-01-23 12:03:32
cc4b6e6e582e868cba9f84195f62a51721f8cbad...64d33a751935bb0fa9fad8f6525dcd378b5fe3da,46,385,94,479,98,2014-01-27 17:30:51,2014-01-27 17:30:51
451497c81ebfb38dc04343248b3e2d4bb9bdf26a...d537992d57b5f012206bcafdfd570c9b4cf07146,1,2,2,4,2,2013-09-30 22:06:14,2013-09-30 22:06:14
d537992d57b5f012206bcafdfd570c9b4cf07146...a63079f34cd29c0d599c43ab6142b271db2705a2,1,59,0,59,1,2013-09-30 22:06:14,2013-09-30 22:06:14
a63079f34cd29c0d599c43ab6142b271db2705a2...b7f36e187d1b5362a72b50779aff182d7131d8f5,1,13,0,13,1,2013-10-01 06:37:32,2013-10-01 06:35:24
b7f36e187d1b5362a72b50779aff182d7131d8f5...d97ea06d885c6c614bbe1d073cc9167cb66fd564,1,7,0,7,1,2013-10-05 12:54:57,2013-10-05 12:45:10
d97ea06d885c6c614bbe1d073cc9167cb66fd564...b011811a9ffec89721e6486e263e68db17546699,2,46,2,48,3,2013-10-08 09:35:12,2013-10-08 09:25:22
b011811a9ffec89721e6486e263e68db17546699...98c57c7c0724a3518f18a01a63fcc7bef2daf9f6,2,125,27,152,24,2013-10-09 15:49:39,2013-10-04 22:02:42
98c57c7c0724a3518f18a01a63fcc7bef2daf9f6...9777890f5d9ce95f15c64d29f1c0a55c12d24c3e,1,1,1,2,1,2013-10-09 17:25:47,2013-10-09 15:46:17
9777890f5d9ce95f15c64d29f1c0a55c12d24c3e...9c65387673eb51bfa17143edb24fc925045e62de,1,0,189,189,1,2013-10-09 21:00:32,2013-09-09 11:31:05
9c65387673eb51bfa17143edb24fc925045e62de...51cdce8322b78814a8dbc9e1b8bd19eb305af312,1,71,41,112,25,2013-10-10 12:09:39,2013-10-10 12:09:38
51cdce8322b78814a8dbc9e1b8bd19eb305af312...ff1efdd6eea23499797dd1b35c79cbdcd513fd09,1,0,1,1,1,2013-10-10 12:34:16,2013-10-10 12:34:15
ff1efdd6eea23499797dd1b35c79cbdcd513fd09...720675e7dbec2d3aabb16f316747a0517845bd17,1,1,1,2,1,2013-10-10 22:45:25,2013-10-10 16:41:59
720675e7dbec2d3aabb16f316747a0517845bd17...56c5806da36204e46b68e7f2c050242b0f635596,1,1,0,1,1,2013-10-14 10:14:51,2013-10-14 11:15:00
56c5806da36204e46b68e7f2c050242b0f635596...9a3a0ccc502f8799db34b7937a0e588980a8922d,1,8,1,9,1,2013-10-15 08:17:23,2013-10-15 08:01:50
9a3a0ccc502f8799db34b7937a0e588980a8922d...5ef03bc3eed4da297ffabafc633b07e4f0171861,1,33,24,57,20,2013-10-16 10:56:03,2013-10-16 10:20:25
5ef03bc3eed4da297ffabafc633b07e4f0171861...5bc5210b923697ab53f0ac0aa8616e28b16b73e9,1,2,5,7,1,2013-10-16 10:56:13,2013-10-16 10:32:47
5bc5210b923697ab53f0ac0aa8616e28b16b73e9...ed186c971c3a3c724bdccdcc2e5b70f57588dd69,1,25,19,44,8,2013-10-16 22:10:13,2013-07-26 00:35:21
ed186c971c3a3c724bdccdcc2e5b70f57588dd69...2e16037201b6338914d41048660c1ce713094893,1,141,85,226,48,2013-10-16 22:10:13,2013-07-26 01:17:38
2e16037201b6338914d41048660c1ce713094893...f051b8919fec8efd8ef050f580cfcabea3d2534c,1,11,0,11,2,2013-10-17 00:12:34,2013-10-14 18:57:45
f051b8919fec8efd8ef050f580cfcabea3d2534c...b97c28f59ee898a81f0df988c249359c9b42701d,2,151,5,156,7,2013-10-17 00:12:34,2013-10-16 19:57:46
b97c28f59ee898a81f0df988c249359c9b42701d...8fc48bcf4ca49f16b910b388481030870f78665f,9,301,540,841,71,2013-10-18 20:52:15,2013-10-18 20:52:15
8fc48bcf4ca49f16b910b388481030870f78665f...5e41c022af741444def80967aab6ea0f9ec73057,2,84,0,84,2,2013-10-18 21:14:21,2013-10-18 21:14:21
c37e1b7c4be31e9955c36c6c5bcad4f200a55c8e...14d6df87025b95e781f55101aaad4c7baec46cea,1,3,1,4,1,2014-01-27 19:54:53,2013-12-28 08:12:40
14d6df87025b95e781f55101aaad4c7baec46cea...dc1ffd0da6fcaa2b18bd6817ca3541264ebc8ce7,1,2,2,4,3,2014-01-27 19:54:53,2014-01-10 13:27:48
dc1ffd0da6fcaa2b18bd6817ca3541264ebc8ce7...f4c8020d1068ffba57458b327c62b61b1f29ec63,3,50,8,58,9,2014-01-27 23:28:09,2014-01-24 01:28:08
f4c8020d1068ffba57458b327c62b61b1f29ec63...76b98462e589a69d9fd48ccb9fb5f6e96b539715,25,159,236,395,59,2014-01-27 23:52:50,2013-12-17 00:00:44
76b98462e589a69d9fd48ccb9fb5f6e96b539715...cd2d3aedaab5cb1a19794ca3ca50d7436ed424cf,1,7,3,10,2,2014-01-28 01:39:45,2014-01-28 01:39:45
cd2d3aedaab5cb1a19794ca3ca50d7436ed424cf...2f5e77f55bb7af8ba0b9643a83abdb81b4255d9b,1,13,2,15,1,2014-01-28 02:14:57,2014-01-28 02:05:39
2f5e77f55bb7af8ba0b9643a83abdb81b4255d9b...114bff467eb67def0dbe3baddf06969bcadd0ecc,1,1,1,2,1,2014-01-28 02:27:10,2014-01-28 02:27:10
114bff467eb67def0dbe3baddf06969bcadd0ecc...eaf76648a6ba05932465fdb2478a16ca4b6c17a6,1,8,0,8,1,2014-01-28 08:38:02,2014-01-23 11:21:03
eaf76648a6ba05932465fdb2478a16ca4b6c17a6...9836a4eeda1e2d43aad0923f1f72b364792629bc,9,148,37,185,28,2014-01-28 22:49:03,2014-01-28 22:48:10
9836a4eeda1e2d43aad0923f1f72b364792629bc...ab54e32bbd53ba920ac8e6cd06330fc8aa317de3,1,11,8,19,2,2014-01-28 23:07:40,2014-01-28 22:11:32
ab54e32bbd53ba920ac8e6cd06330fc8aa317de3...8eaa1ac46306c429ae40a02de79bdafd35f0867d,1,0,3,3,2,2014-01-28 23:08:06,2014-01-28 15:33:48
8eaa1ac46306c429ae40a02de79bdafd35f0867d...657cd2c4e5940d32883a6791be41978a6d07afb8,1,3,3,6,3,2014-01-28 23:08:06,2014-01-28 16:18:36
657cd2c4e5940d32883a6791be41978a6d07afb8...597eb6a5aebbc2afbd76d16e568a86ed28509bc7,6,23,8,31,8,2014-01-28 23:23:52,2014-01-28 23:23:52
597eb6a5aebbc2afbd76d16e568a86ed28509bc7...fc26fd6b388796a09767bf698ddda5b5ff7c9e96,4,51,5,56,8,2014-01-28 23:27:23,2014-01-23 09:35:18
fc26fd6b388796a09767bf698ddda5b5ff7c9e96...95b8a75d5e471cc539cb9f3639cd1cbe098e5633,5,92,12,104,9,2014-01-29 01:16:28,2014-01-29 01:16:28
5e41c022af741444def80967aab6ea0f9ec73057...e2da042844a830fafb8031f6c477eb4f96195210,2,17,2,19,2,2013-10-18 21:26:27,2013-10-18 21:26:27
95b8a75d5e471cc539cb9f3639cd1cbe098e5633...b46e77421581ea358e221a8a843d057c747f7e90,3,60,1,61,3,2014-01-29 01:29:56,2014-01-29 01:27:13
7940833773a164708e29447aee3d2ea0cf8ddbde...85b2aaea3d6a033642cc7ebe95bcf85ae37de24a,1,2,2,4,2,2013-10-18 22:40:32,2013-10-18 22:40:32
85b2aaea3d6a033642cc7ebe95bcf85ae37de24a...2649ae839589fde045c4afbd05eb2f3f15407279,1,71,0,71,1,2013-10-18 22:43:55,2013-10-18 22:43:55
2649ae839589fde045c4afbd05eb2f3f15407279...028e524bce9e361dc0f10e3f235c91862ba5ec67,1,71,0,71,1,2013-10-18 22:46:02,2013-10-18 22:46:02
028e524bce9e361dc0f10e3f235c91862ba5ec67...97813ae58d19687f3c61f6355b4307c88908058a,1,37,0,37,1,2013-10-22 17:56:03,2013-10-22 17:56:03
97813ae58d19687f3c61f6355b4307c88908058a...91a0e52c03d8340f3aaf4c48a9f2c2d3a6fff368,1,1,1,2,1,2013-10-23 11:26:25,2013-10-23 11:25:35
91a0e52c03d8340f3aaf4c48a9f2c2d3a6fff368...eb291de00e6ec5c75d3c27d40403d3a842305d01,1,2,0,2,1,2013-10-24 14:17:56,2013-09-12 18:13:32
eb291de00e6ec5c75d3c27d40403d3a842305d01...808a968409b6c6cc305506efd3caa4477a376125,1,3,3,6,3,2013-10-24 14:31:31,2013-10-23 11:42:53
808a968409b6c6cc305506efd3caa4477a376125...f6f176e10872cac9dcdcd46a92c9ebfe4740f117,291,1712,1186,2898,397,2013-10-24 16:22:13,2013-10-24 16:21:59
f6f176e10872cac9dcdcd46a92c9ebfe4740f117...9c6e06bed30d6f8a68ba357b4b1f49ba766ebcb2,1,3,1,4,1,2013-10-25 09:17:35,2013-10-22 07:27:02
9c6e06bed30d6f8a68ba357b4b1f49ba766ebcb2...21265e20d3be515733418c5eef395ccec8f5f701,1,1,1,2,1,2013-10-25 17:33:22,2013-10-24 02:43:23
245cf3f7469a3055d30b354c45260eeceb9c1e59...e63268e433f2812d621013d1f303ca0ab214e5d0,1,2,2,4,2,2014-01-29 03:46:17,2014-01-29 03:46:17
e63268e433f2812d621013d1f303ca0ab214e5d0...c8c26f12e44fd79cf99c5dab8cde1b3213bf2dfb,1,11,11,22,2,2014-01-29 17:37:29,2014-01-29 17:37:29
c8c26f12e44fd79cf99c5dab8cde1b3213bf2dfb...49c2372e684ee91c2791488aaa8caaecfcf64e11,1,0,61,61,1,2014-01-30 17:52:07,2014-01-30 17:31:02
49c2372e684ee91c2791488aaa8caaecfcf64e11...9b37b83a2079447662e11c8ee8456be298606a2a,4,152,39,191,32,2014-01-31 23:45:45,2014-01-28 17:35:51
9b37b83a2079447662e11c8ee8456be298606a2a...3dcf7253a831946bd1cbb5ad74bfec6bc014f92e,1,0,1,1,1,2014-02-03 16:35:49,2014-02-03 12:47:29
3dcf7253a831946bd1cbb5ad74bfec6bc014f92e...9a60bf3726d3d42383842b9d99a69021ed3a5642,3,77,27,104,19,2014-02-03 21:35:08,2014-01-31 12:49:24
9a60bf3726d3d42383842b9d99a69021ed3a5642...231570303576fe2ee55de3ee9d01ccada030237c,3,52,20,72,19,2014-02-03 21:41:02,2014-02-03 07:55:47
231570303576fe2ee55de3ee9d01ccada030237c...f65ce02ddd6b559409176cc2b0c08d484c00f311,1,1,1,2,1,2014-02-04 08:44:15,2014-02-03 20:53:29
f65ce02ddd6b559409176cc2b0c08d484c00f311...15de8c2b606cb5665b346516304c4ce0b381fc09,1,13,6,19,5,2014-02-04 08:48:07,2014-02-04 01:23:15
15de8c2b606cb5665b346516304c4ce0b381fc09...bae545dab78d4b3c5425f119a8b5d7c6f2e9bd2b,1,1,1,2,1,2014-02-04 18:51:11,2014-02-04 17:16:44
bae545dab78d4b3c5425f119a8b5d7c6f2e9bd2b...5ce458032f33ad19a56c5b9c8c28bde245eb93b7,2,70,13,83,16,2014-02-05 10:20:02,2014-02-05 09:46:00
5ce458032f33ad19a56c5b9c8c28bde245eb93b7...528a3ce3ed0df7aaafb02877495c94caa1d77355,5,148,1,149,13,2014-02-05 19:28:34,2014-02-03 21:32:13
528a3ce3ed0df7aaafb02877495c94caa1d77355...1f2f3fa83a93d7b21306f1fd0b1e1793cc3a5b2c,3,77,70,147,43,2014-02-05 19:49:00,2014-01-27 02:58:16
1f2f3fa83a93d7b21306f1fd0b1e1793cc3a5b2c...4dc6f4adf48e9b1d35ff88e30dfbdc016d6621f7,1,3,3,6,6,2014-02-05 19:49:01,2013-11-16 19:05:42
4dc6f4adf48e9b1d35ff88e30dfbdc016d6621f7...010222d39fbbf766b9c24a448a804d23928929f4,7,403,4,407,30,2014-02-05 19:49:01,2013-10-28 13:57:47
010222d39fbbf766b9c24a448a804d23928929f4...d23ac0ea9cb11c90a385a8235e5ae51b486ffcb7,3,63,0,63,5,2014-02-05 19:49:01,2013-11-15 21:19:31
d23ac0ea9cb11c90a385a8235e5ae51b486ffcb7...1d2fab37e61ded49773a88babc68d36191a75b55,3,63,0,63,3,2014-02-05 19:49:02,2014-02-02 21:59:11
1d2fab37e61ded49773a88babc68d36191a75b55...c9abb59638bc4bc64176ded80ebdc05d066ad0db,1,12,12,24,11,2014-02-05 21:30:24,2014-01-21 20:36:28
c9abb59638bc4bc64176ded80ebdc05d066ad0db...4a9af3fecb4baf677f265e2e6e34a674a53810a6,21,109,38,147,36,2014-02-05 21:30:56,2014-01-20 21:33:16
4a9af3fecb4baf677f265e2e6e34a674a53810a6...d9e1e4c661debec77e36f2adcb2bac662b883502,3,13,0,13,6,2014-02-05 21:31:00,2014-01-21 19:32:55
d9e1e4c661debec77e36f2adcb2bac662b883502...6cbfcdad46d733bb04332063727e304e449dc86b,24,656,616,1272,76,2014-02-06 01:16:36,2014-02-05 23:37:12
6cbfcdad46d733bb04332063727e304e449dc86b...f1de13b8ab77f1bcab0d7cffee140a264cae4cce,11,191,90,281,38,2014-02-06 09:26:57,2014-02-05 16:38:33
f1de13b8ab77f1bcab0d7cffee140a264cae4cce...8874a317484b8865c5fbad74d3af6155994df583,2,84,0,84,5,2014-02-06 10:19:47,2014-02-06 02:09:23
8874a317484b8865c5fbad74d3af6155994df583...2b6e078833bf4c485f725a8c5633a3202e31868c,2,90,62,152,9,2014-02-06 11:30:38,2014-01-30 12:02:58
2b6e078833bf4c485f725a8c5633a3202e31868c...bbd56d881db20e84fd6d43e6ba750230692c5871,4,87,0,87,4,2014-02-06 11:30:38,2014-01-30 12:21:07
bbd56d881db20e84fd6d43e6ba750230692c5871...4b77bd39a40f1e9dbdd0c337159b496a7026949d,1,2,2,4,1,2014-02-07 20:19:50,2014-02-02 23:39:43
21265e20d3be515733418c5eef395ccec8f5f701...a60f67192fe1f3d06ac8eacd81830facee78f6d1,1,1,1,2,1,2013-10-25 21:40:46,2013-10-25 20:16:50
a60f67192fe1f3d06ac8eacd81830facee78f6d1...5ac6f4de13bb2f18c264dfccfdcfea5a9118d43e,2,58,24,82,12,2013-10-27 10:47:11,2013-10-26 05:03:02
5ac6f4de13bb2f18c264dfccfdcfea5a9118d43e...977c54adb5e5b7f083f02a294ca2825fe8eb7f2f,1,2,2,4,1,2013-10-27 20:02:19,2013-10-26 20:13:56
977c54adb5e5b7f083f02a294ca2825fe8eb7f2f...4b5e6a38df2f68fd407ccfbdcb70960f6af6e0e2,158,928,210,1138,210,2013-10-28 21:10:47,2013-10-28 21:10:47
eadb4f56063ff27781323451987e181fe724ed21...e3ec2f7dabb08fbe66b1f1ec92ddabe71499e5b6,1,5,6,11,1,2014-02-09 09:33:47,2014-02-06 13:43:55
e3ec2f7dabb08fbe66b1f1ec92ddabe71499e5b6...abe4c34c86ccbe06ff4ecd50774c0205009d4620,2,13,1,14,3,2014-02-09 09:37:50,2014-02-07 17:18:27
abe4c34c86ccbe06ff4ecd50774c0205009d4620...28dbc96a6cd4c995a36b38874ef9fdacb01ffa16,2,34,0,34,2,2014-02-09 09:38:23,2014-02-07 17:50:29
28dbc96a6cd4c995a36b38874ef9fdacb01ffa16...c0d81f90996667a658aa4403123e02161262506a,2,14,1,15,4,2014-02-09 11:10:38,2014-02-09 10:40:57
c0d81f90996667a658aa4403123e02161262506a...e2a1d9a9ac69281c1945658b11d1b141604b3572,3,6,6,12,7,2014-02-10 19:06:03,2014-02-09 11:09:34
4b5e6a38df2f68fd407ccfbdcb70960f6af6e0e2...0c5981b226350730126731bc0d546009570805e1,1,19,15,34,1,2013-10-29 09:32:15,2013-10-29 09:31:14
0c5981b226350730126731bc0d546009570805e1...9f7f9d124040c044ea38cbaa4a9457d76c0c598f,1,96,0,96,1,2013-10-30 16:09:04,2013-10-30 16:09:04
9f7f9d124040c044ea38cbaa4a9457d76c0c598f...155df9ca765d77c8b672340b6a9666bb4871c637,1,27,2,29,1,2013-10-31 20:19:04,2013-10-30 23:19:17
155df9ca765d77c8b672340b6a9666bb4871c637...849c92fec78ba11099e2e70109ecf8a7ab7aa999,1,50,27,77,11,2013-10-31 20:36:00,2013-10-31 20:35:54
849c92fec78ba11099e2e70109ecf8a7ab7aa999...0be5a94c56534c0debaf5416eac42d48c9617404,1,3,0,3,3,2013-11-07 19:02:19,2013-10-21 12:26:29
0be5a94c56534c0debaf5416eac42d48c9617404...8f221bc43d02d86da94186d5290c29a426039d15,209,235,217,452,217,2013-11-08 21:41:24,2013-11-08 21:41:21
d58c206862dc4f4ffe364cab5bf6b69afc0a52df...fa4eb47caacde4435c16f4ebef0c4f3fa001ccd2,4,1311,0,1311,19,2014-02-10 20:22:06,2014-02-10 20:22:06
fa4eb47caacde4435c16f4ebef0c4f3fa001ccd2...e8df2676748e944388896dfd767e01906ae2e4eb,6,687,80,767,17,2014-02-10 21:35:37,2014-02-10 20:40:48
8f221bc43d02d86da94186d5290c29a426039d15...ac2263b77f3f346458d06fc019de27e24c63cee0,2,85,4,89,2,2013-11-08 22:07:36,2013-11-07 21:22:02
ac2263b77f3f346458d06fc019de27e24c63cee0...3dcc9b93e1e4d80aa15a40a9d82a6b9f0bef0ec0,1,0,11,11,1,2013-11-09 21:27:22,2013-11-09 21:24:22
6b4f72b7ac95bf3ec100bb70e7f6552e9aa18d7e...e7a03f1c62414192bd96a8214e699a07051fa11e,1,5,3,8,3,2014-02-14 00:41:31,2014-02-10 21:41:03
e7a03f1c62414192bd96a8214e699a07051fa11e...3da36fe00e5d85414031ae812e473f16629d8645,1,23,4,27,5,2014-02-14 00:41:59,2014-01-16 11:18:55
3da36fe00e5d85414031ae812e473f16629d8645...527cabefcb874659cc796873b05eea9bf10a3d9e,1,3,1,4,2,2014-02-14 00:46:04,2014-01-24 15:03:10
527cabefcb874659cc796873b05eea9bf10a3d9e...8f94ef46b77eb290a2633811d7dfe6aab0d777a0,1,1,1,2,1,2014-02-14 00:46:04,2014-01-24 15:15:15
8f94ef46b77eb290a2633811d7dfe6aab0d777a0...0f10dd4cb2334474d3cab52df8507ddd8781b7f7,1,3,3,6,3,2014-02-14 00:49:08,2014-01-14 10:00:33
0f10dd4cb2334474d3cab52df8507ddd8781b7f7...bb2af7dd4dc7d6fe41e2fbffe4c7ddccba087a5b,1,1,1,2,1,2014-02-14 00:49:15,2014-01-14 09:32:07
3dcc9b93e1e4d80aa15a40a9d82a6b9f0bef0ec0...201098535443ef6588b0fd176a425fdf3213ee70,40,2225,2139,4364,464,2013-11-10 23:15:34,2013-11-10 23:15:34
201098535443ef6588b0fd176a425fdf3213ee70...568072ceae5566c4e3e14cef077538d2f454ee33,2,4,1,5,2,2013-11-11 23:45:09,2013-11-11 23:03:29
568072ceae5566c4e3e14cef077538d2f454ee33...007393a09d046909a6cc50297b8d39d61336a010,1,2,6,8,1,2013-11-12 14:15:32,2012-10-23 13:04:05
007393a09d046909a6cc50297b8d39d61336a010...ac799ba0afa9731e281bf23886d1a3f5adec1784,21,528,37,565,48,2013-11-12 18:57:57,2013-11-12 18:57:57
ac799ba0afa9731e281bf23886d1a3f5adec1784...16934d9210546bf19d4af8d98652aa5d636ce693,2,13,0,13,2,2013-11-12 19:23:19,2013-11-12 19:23:19
16934d9210546bf19d4af8d98652aa5d636ce693...cbff8f091c22fb1df6b238c7a1b9145db950fa65,3,26,2,28,3,2013-11-12 20:22:12,2013-11-12 20:22:12
0f40eac366dcb509e088f9c08b70e2281d3e745b...940abd0b19d65b59cea2c614fbebeae95413f485,1,4,0,4,1,2014-02-15 21:19:54,2014-02-15 11:56:37
940abd0b19d65b59cea2c614fbebeae95413f485...3421d29d6310f6bf0c90fa70d936d2646ccc9187,1,1,1,2,1,2014-02-16 02:54:40,2013-11-23 22:05:34
3421d29d6310f6bf0c90fa70d936d2646ccc9187...a4436bab7b83e311f8a4207b9c6d97acde4735ff,2,32,1,33,2,2014-02-16 03:24:42,2014-02-16 03:24:42
a4436bab7b83e311f8a4207b9c6d97acde4735ff...75ea11fc08019bb1ffac81583ed7d0da3241a5b5,9,111,15,126,25,2014-02-17 21:07:09,2014-02-14 13:01:34
75ea11fc08019bb1ffac81583ed7d0da3241a5b5...7589a0007c2ad8ab9178bfe626f835e6b0b6f48c,2,3,5,8,6,2014-02-17 23:22:18,2014-02-17 22:47:33
7589a0007c2ad8ab9178bfe626f835e6b0b6f48c...3ae0b17c76f693dd2e68a46f78c7dc7f595b33c6,5,104,39,143,28,2014-02-18 00:04:36,2014-02-15 14:21:26
3ae0b17c76f693dd2e68a46f78c7dc7f595b33c6...c9802801598a138df4bf58767c151e83ce328856,1,2,2,4,2,2014-02-18 00:04:36,2014-02-17 22:59:28
c9802801598a138df4bf58767c151e83ce328856...cfe0bab85b8b0974c3683c434fa33663e0b02906,3,30,3,33,6,2014-02-18 00:21:29,2014-01-22 01:53:23
cfe0bab85b8b0974c3683c434fa33663e0b02906...c0d73e6de1b59003a01c58733eabee9c33d1f56b,1,1,1,2,1,2014-02-18 00:21:38,2014-02-18 00:17:20
c0d73e6de1b59003a01c58733eabee9c33d1f56b...e5eadcfa199298d6b6f14df43cfcdd5b478c6208,1,0,3,3,1,2014-02-18 04:29:30,2014-02-18 04:29:30
36f2bf22b5c800e0aae57e1ee2f77f2fda7255bd...9142dc676fdf3098990369ee799a9e598540bb6c,1,2,2,4,2,2013-11-12 20:53:45,2013-11-12 20:53:45
9142dc676fdf3098990369ee799a9e598540bb6c...ac9cf002524d6817f4fdd42e08d4757fb0c29b5f,1,74,0,74,1,2013-11-12 20:53:45,2013-11-12 20:53:45
ac9cf002524d6817f4fdd42e08d4757fb0c29b5f...c9d93f34311ce0a9b59ed9f4511a2e3ba69e0f25,2,23,1,24,3,2013-11-12 23:21:04,2013-11-12 20:19:13
c9d93f34311ce0a9b59ed9f4511a2e3ba69e0f25...65b127572f274758eb2403fec4349350384de899,2,29,0,29,2,2013-11-13 13:09:25,2013-11-13 12:58:46
65b127572f274758eb2403fec4349350384de899...a763db8fc0ce1d13d74ebd8a67e342747b081aa6,1,16,27,43,1,2013-11-15 15:24:47,2013-11-15 15:24:46
a763db8fc0ce1d13d74ebd8a67e342747b081aa6...1394d5856b4c7b7ade1f1accbd9bffeea2e2144d,1,1,0,1,1,2013-11-15 15:29:30,2013-11-15 15:27:22
466a9b5c78abef8f6c5261f33df83672d78b41b5...a226be4f76b73f651404803777e4ecdcbb5ac4ff,8,219,55,274,39,2014-02-18 11:49:23,2014-02-18 01:57:08
a226be4f76b73f651404803777e4ecdcbb5ac4ff...59baab277691dcc7d788724020084414b96de22c,4,147,7,154,7,2014-02-18 11:55:04,2014-02-18 01:30:12
59baab277691dcc7d788724020084414b96de22c...937e2e351b2450cf1e9c4d8b3e1a4e2a2def58bb,4,29,14,43,13,2014-02-18 12:03:13,2014-02-18 00:29:23
937e2e351b2450cf1e9c4d8b3e1a4e2a2def58bb...ae0299287209e6d1dd0606c885ca087e82ed0e7d,1,7,0,7,2,2014-02-18 18:10:30,2014-02-18 18:10:30
1394d5856b4c7b7ade1f1accbd9bffeea2e2144d...5ce50ece16e52dad94834f977313f36f83732273,2,10,1,11,3,2013-11-19 08:44:06,2013-11-19 07:38:48
5ce50ece16e52dad94834f977313f36f83732273...5885f464f0ad372efa7ef44a72df6d44acec3085,1,6,4,10,2,2013-11-19 08:50:16,2013-11-19 07:02:26
5885f464f0ad372efa7ef44a72df6d44acec3085...fce0eb416b47f205605fe3dde47550dec337c673,2,13,1,14,2,2013-11-19 09:14:01,2013-11-19 06:58:23
fce0eb416b47f205605fe3dde47550dec337c673...88dc1fcb62f40c3c906802dcaa8a8e9dfef2a264,1,6,0,6,2,2013-11-19 09:15:50,2013-10-19 10:38:58
88dc1fcb62f40c3c906802dcaa8a8e9dfef2a264...c1452f4c6fac17dd8ab974372daee05cd5cdbdec,190,2552,2507,5059,681,2013-11-20 19:08:52,2013-11-20 19:08:52
845e5d345890fabe97d3aa58cbf4e131c91e1559...b105997193374ce1802e91d51ae0fd6e479e86a3,2,49,4,53,4,2014-02-19 17:24:16,2014-02-10 18:56:09
b105997193374ce1802e91d51ae0fd6e479e86a3...e746bbdc2b79881b2c991c829b5437340583a064,1,0,2,2,2,2014-02-21 17:43:06,2014-02-21 06:13:41
e746bbdc2b79881b2c991c829b5437340583a064...75adde07f9a2de7f38a67bec72bd377d450bdb52,42,1841,1232,3073,1079,2014-02-21 23:20:56,2014-02-21 13:02:42
75adde07f9a2de7f38a67bec72bd377d450bdb52...dbae8b569fd1afa04cddac47b30379e4ebf3388a,1,1,0,1,1,2014-02-21 23:35:29,2014-02-21 23:35:29
dbae8b569fd1afa04cddac47b30379e4ebf3388a...af1418325bac37f70b57580eec98ee211e11c2dd,5,129,95,224,25,2014-02-24 19:52:47,2014-02-24 18:20:30
af1418325bac37f70b57580eec98ee211e11c2dd...440b9e2245740af0168cf27c1af6bc681bbe5754,1,22,29,51,15,2014-02-24 19:54:22,2014-02-24 18:55:27
440b9e2245740af0168cf27c1af6bc681bbe5754...e324717f8daca4f6d09ea18263f0b6e55caf37fa,1,0,48,48,1,2014-02-25 00:34:01,2014-02-25 00:34:01
e324717f8daca4f6d09ea18263f0b6e55caf37fa...3a3b7488b58031ec8c9cd5faa28333eb93842d4f,1,8,2,10,7,2014-02-25 00:54:04,2014-02-25 00:54:04
3a3b7488b58031ec8c9cd5faa28333eb93842d4f...95bb347d6ca7af559f89dbec1b2688e320eb4365,1,2,2,4,1,2014-02-25 00:55:35,2014-02-25 00:55:35
95bb347d6ca7af559f89dbec1b2688e320eb4365...78a854f8721693cf9a9b33136b485825bfff2142,1,0,0,0,0,2014-02-25 01:03:28,2014-02-25 01:03:28
78a854f8721693cf9a9b33136b485825bfff2142...265fdc8e91b5670c4ee57f7f641b9e2741c7ddc6,1,10,1,11,1,2014-02-25 01:53:57,2014-02-25 01:53:57
265fdc8e91b5670c4ee57f7f641b9e2741c7ddc6...de56ffa58b08d69e428fa221681ef305464898a8,2,26,6,32,4,2014-02-25 02:38:41,2014-02-25 02:38:41
de56ffa58b08d69e428fa221681ef305464898a8...d2952cce36309b33125c749766e70960d20660f5,2,46,19,65,11,2014-02-25 19:28:45,2014-02-25 03:40:47
d2952cce36309b33125c749766e70960d20660f5...407e295f4359b62d2d298ec5aaa9f075cf45eb4f,219,115294,461,115755,409,2014-02-25 19:28:45,2014-02-25 03:49:45
407e295f4359b62d2d298ec5aaa9f075cf45eb4f...581b8585eb90a92c1c42aab2c646ae8bf31d224b,1,3,3,6,2,2014-02-25 19:28:46,2014-02-25 04:20:25
581b8585eb90a92c1c42aab2c646ae8bf31d224b...fa0ac99541f7722af63863f032beff0d485afdec,1,1,1,2,1,2014-02-25 19:28:46,2014-02-25 04:59:39
fa0ac99541f7722af63863f032beff0d485afdec...bfc823de9057b8cc9c7efd97e6216e2de02aa818,4,4,5,9,4,2014-02-25 19:28:46,2014-02-25 19:05:54
bfc823de9057b8cc9c7efd97e6216e2de02aa818...67dfcd55be6fb8750bc9c9d2c858ced85fe23cec,1,2,2,4,1,2014-02-25 19:58:33,2014-02-25 19:32:01
67dfcd55be6fb8750bc9c9d2c858ced85fe23cec...98a0909da0581888174e2dd326616426ad262a90,1,2,0,2,2,2014-02-25 21:44:37,2014-02-25 21:24:16
98a0909da0581888174e2dd326616426ad262a90...2ca4d9d662f638beb1ac99856848a1ac08ba0997,1,1,2,3,1,2014-02-25 21:44:38,2014-02-24 17:28:49
2ca4d9d662f638beb1ac99856848a1ac08ba0997...b5f9779c2f837eb500cd9ead37d88b2717c5ba91,1,11,11,22,10,2014-02-25 21:44:38,2014-02-25 17:57:43
b5f9779c2f837eb500cd9ead37d88b2717c5ba91...a22a2d8656419586647ca1aa6c5008f3e9045424,2,5,18,23,6,2014-02-26 13:33:10,2014-02-25 20:48:31
a22a2d8656419586647ca1aa6c5008f3e9045424...c1bb88699058011cce8df12a5cf39354666f6ab2,1,11,51,62,8,2014-02-26 18:36:23,2014-01-16 12:17:01
c1bb88699058011cce8df12a5cf39354666f6ab2...20176a98416353d4596900793f739d5ebf4f0ee1,6,98,3,101,9,2014-02-26 18:36:58,2014-02-26 14:03:59
20176a98416353d4596900793f739d5ebf4f0ee1...846f304fa80c0bb6bc4585c6d0ddd23106153648,1,7,4,11,6,2014-02-26 18:38:13,2014-02-26 18:33:21
846f304fa80c0bb6bc4585c6d0ddd23106153648...d307bebec4a7b087e4bb3576665235e4ab086a60,1,47,0,47,1,2014-02-26 21:05:56,2014-02-26 21:05:56
d307bebec4a7b087e4bb3576665235e4ab086a60...d6bbb19f1d1d6397d862d09304bc63c476f675c1,3,43,10,53,10,2014-02-26 21:18:54,2014-02-25 22:15:02
d6bbb19f1d1d6397d862d09304bc63c476f675c1...0a5d8ca197cac3d6e2e4f61d14192ae3a3f29d03,3,12,6,18,7,2014-02-26 21:19:06,2014-02-25 22:18:43
0a5d8ca197cac3d6e2e4f61d14192ae3a3f29d03...f3189ace6b5e31a874df421ac2f74da0e77cb14d,1,0,42,42,3,2014-02-26 21:19:36,2014-02-25 22:19:25
f3189ace6b5e31a874df421ac2f74da0e77cb14d...cd08c8a0e5e99ed4933b87fc5e188afcd4299f73,69,2267,388,2655,367,2014-02-27 02:08:30,2014-02-27 02:08:30
cd08c8a0e5e99ed4933b87fc5e188afcd4299f73...afc29ed397f71ff2ba4fa4518ab546b19123fece,2,16,7,23,10,2014-02-27 02:15:07,2014-02-26 23:24:03
afc29ed397f71ff2ba4fa4518ab546b19123fece...269de79fbfd47f65f1797fd6351702a8b406f85a,1,1,0,1,1,2014-02-27 02:16:07,2014-02-27 02:14:14
269de79fbfd47f65f1797fd6351702a8b406f85a...6e1eac744b0c1a84614568ac2b128168ce9138da,2,15,5,20,8,2014-02-28 10:01:52,2014-02-28 09:17:32
6e1eac744b0c1a84614568ac2b128168ce9138da...a2eeb43deda58e7bbb8fcf24b934157992b937c0,3,84,1,85,4,2014-02-28 10:43:30,2013-10-07 13:39:39
a2eeb43deda58e7bbb8fcf24b934157992b937c0...37d3c56c0b7870e5a03f389444c37cde063ca76a,3,102,0,102,3,2014-02-28 11:36:22,2013-10-25 21:05:39
37d3c56c0b7870e5a03f389444c37cde063ca76a...3b88dc6f19feda070ae1b9955dad7acfc6ed0142,2,13,8,21,7,2014-02-28 14:02:02,2014-02-28 08:14:05
3b88dc6f19feda070ae1b9955dad7acfc6ed0142...5596f936d81b6309b9703d2d3fd4c129bb351672,1,6,1,7,1,2014-03-01 17:30:17,2014-02-28 13:25:28
5596f936d81b6309b9703d2d3fd4c129bb351672...34bf6e46beb4b94e9ed3c51da8589d604f19bc4e,1,3,1,4,2,2014-03-02 08:05:13,2014-02-28 16:52:32
c1452f4c6fac17dd8ab974372daee05cd5cdbdec...a34bbaf31bd327a616adb3ef670174228924a80a,1,92,0,92,1,2013-11-21 00:45:27,2013-11-21 00:45:27
a34bbaf31bd327a616adb3ef670174228924a80a...71aabedad422748e67d1aab18742d03b829d95c9,2,8,1,9,2,2013-11-22 16:42:34,2013-11-22 14:17:16
71aabedad422748e67d1aab18742d03b829d95c9...953d7184ec95813f40916b40892db3150daf615f,1,4,0,4,1,2013-11-23 14:46:50,2013-11-21 15:39:23
953d7184ec95813f40916b40892db3150daf615f...90655a998e8805826e364571004bb995eaa08967,1,82,0,82,1,2013-11-26 15:27:59,2013-11-26 15:27:59
78d245f5b21eede58e79138330690d63cf3d86f8...caca4f33aad84f71b4f542d1455e954f4dd08313,1,2,2,4,2,2014-03-04 08:42:03,2014-03-03 05:25:11
caca4f33aad84f71b4f542d1455e954f4dd08313...31ce34887fc2f5e10d0c1f099e71664370794fec,5,62,4,66,12,2014-03-04 08:42:03,2014-03-04 05:05:23
31ce34887fc2f5e10d0c1f099e71664370794fec...68bfa91af702377bc4d0b36fc8ea25bcd16877a5,2,8,1,9,2,2014-03-10 20:20:28,2014-03-09 20:46:54
68bfa91af702377bc4d0b36fc8ea25bcd16877a5...e108ff4da7cd18d3b48cc6e769ae04c9578f7a8b,2,11,1,12,3,2014-03-10 20:23:56,2014-03-08 14:52:51
e108ff4da7cd18d3b48cc6e769ae04c9578f7a8b...a18c9b7dde22cce6cec5d47cfd6a16694c9992e8,1,4,2,6,3,2014-03-10 21:01:24,2014-03-10 21:01:24
90655a998e8805826e364571004bb995eaa08967...658aeb2ca0f7c99c002db149d6e91154ff0e2c2d,1,1,1,2,1,2013-11-27 02:53:45,2013-11-27 02:48:44
658aeb2ca0f7c99c002db149d6e91154ff0e2c2d...207a3e10f8d91d996ef89c9ef10832d2277d03e9,1,6,2,8,4,2013-11-28 21:31:11,2013-11-28 20:25:30
207a3e10f8d91d996ef89c9ef10832d2277d03e9...a32b8787a43a6bb9ec5fbd9e0dfd0932f16e5b69,1,11,0,11,1,2013-11-28 21:35:25,2013-11-26 20:49:28
a32b8787a43a6bb9ec5fbd9e0dfd0932f16e5b69...fcfaa392ae8c47da98f2b4f590b54dffa4f079dd,1,1,1,2,1,2013-11-30 13:05:45,2013-11-29 16:44:13
fcfaa392ae8c47da98f2b4f590b54dffa4f079dd...6877e64fa8ebd1a1017bb4e298a007d98136c133,2,9,1,10,3,2013-12-02 02:57:43,2013-12-02 02:57:43
b444392a98e66b49dfee8c7e36c59d4e7c6ea1ac...e92d35d80be6e193cb547e94c6fbf3654542dbaa,46,943,359,1302,201,2014-03-11 00:01:21,2014-03-11 00:01:21
e92d35d80be6e193cb547e94c6fbf3654542dbaa...d2f2a32b897840d91cf240830ad5cf5f0e33a0c8,1,8,6,14,4,2014-03-11 00:01:47,2014-03-02 22:18:26
d2f2a32b897840d91cf240830ad5cf5f0e33a0c8...e2fcfea46e334743aed24993eeebb2482c6ea762,2,8,17,25,5,2014-03-11 00:51:47,2014-03-11 00:51:47
e2fcfea46e334743aed24993eeebb2482c6ea762...e496707d3971d45cd0b9f4147ce6abe00e7d6cf1,4,503,118,621,123,2014-03-11 02:12:14,2014-03-11 01:07:52
6877e64fa8ebd1a1017bb4e298a007d98136c133...9b8fcff43575592ace3d391ee47184f98ed755df,3,31,15,46,6,2013-12-02 10:48:14,2013-11-22 14:33:50
e496707d3971d45cd0b9f4147ce6abe00e7d6cf1...0c2e28d68ff0f0bb40fcc392a031021d4815680e,3,74,2,76,4,2014-03-11 20:49:52,2014-03-11 20:49:52
0c2e28d68ff0f0bb40fcc392a031021d4815680e...7d6b8db40f32e817ff145b7cfe6b3aec3179fba7,1,6,0,6,1,2014-03-11 21:49:48,2014-03-11 21:49:48
9b8fcff43575592ace3d391ee47184f98ed755df...8aac118b69a10a134e57e8e066c56ba7370d25cc,3,14,4,18,4,2013-12-02 18:41:37,2013-10-11 05:28:01
8aac118b69a10a134e57e8e066c56ba7370d25cc...94c4ba9dd33bf6d1ab4936f5d4039ecf7957bb32,1,1,1,2,1,2013-12-02 21:31:23,2013-12-02 10:18:37
94c4ba9dd33bf6d1ab4936f5d4039ecf7957bb32...bd7fa92de421048b0eb8fb810eb66829424fc07f,1,2,0,2,1,2013-12-02 21:41:30,2013-12-02 05:31:06
bd7fa92de421048b0eb8fb810eb66829424fc07f...60f777d343c5aea9021f008c4fb07541ccba4ad4,2,76,8,84,6,2013-12-02 23:18:04,2013-11-29 16:09:59
60f777d343c5aea9021f008c4fb07541ccba4ad4...b371d4ae8fdbf1b9046b9076cae1ee5fdc196724,1,17,0,17,1,2013-12-04 09:00:07,2013-12-04 09:00:07
b371d4ae8fdbf1b9046b9076cae1ee5fdc196724...98be8df571f92ad0b846209c21cc00139bc14805,2,21,1,22,2,2013-12-04 15:52:15,2013-04-18 23:01:14
98be8df571f92ad0b846209c21cc00139bc14805...796834bf18d3af28216267ab54b8861e2ce981d3,1,4,0,4,1,2013-12-06 18:26:49,2013-12-06 15:36:43
796834bf18d3af28216267ab54b8861e2ce981d3...5cfee927cd09dc9e74e2bc1d7454284d90831456,1,2,0,2,1,2013-12-06 18:45:40,2013-12-06 18:28:39
5cfee927cd09dc9e74e2bc1d7454284d90831456...b5e161989cc3551ad7ec3723801a696fdbbf1525,1,9,5,14,6,2013-12-07 05:07:00,2013-12-07 04:58:00
b5e161989cc3551ad7ec3723801a696fdbbf1525...2905884b63eb24184b576b1a963a4d72b0159171,1,1,1,2,1,2013-12-07 05:07:46,2013-12-07 05:00:32
44bf5f8c502a881c3bf3a04fc366b5d8fe31e600...9bd934cb961655cbedcdc26f2aa2b0c764227320,1,2,2,4,2,2014-03-12 14:56:42,2014-03-12 14:56:42
9bd934cb961655cbedcdc26f2aa2b0c764227320...93c3674ff7115fb2a3dbb5b4ffd22f4d5ed9a472,2,33,1,34,4,2014-03-12 17:47:17,2014-03-09 06:46:54
93c3674ff7115fb2a3dbb5b4ffd22f4d5ed9a472...1c7bf245dc2d520c005e01bcb56ecb3275971395,1130,136556,54662,191218,15383,2014-03-13 16:56:54,2014-03-13 16:45:44
1c7bf245dc2d520c005e01bcb56ecb3275971395...ce04c726a31cd13be131915b1c8b8bc7a00a4d24,37,438,374,812,327,2014-03-13 16:56:55,2014-03-13 16:38:14
ce04c726a31cd13be131915b1c8b8bc7a00a4d24...030d03190f3daf323b78138717b2e84cf299cdbe,2,8,8,16,3,2014-03-13 16:56:55,2014-03-13 16:46:23
030d03190f3daf323b78138717b2e84cf299cdbe...0c5a0ecc7c8b203aa34a43f0fb8f3bf81cce7f41,5,113,25,138,12,2014-03-13 16:56:56,2014-03-13 16:47:02
0c5a0ecc7c8b203aa34a43f0fb8f3bf81cce7f41...d0ff900a65e4250ad49dcf02e07262af1fa5de25,1,3,0,3,3,2014-03-13 17:14:54,2014-03-13 17:13:59
d0ff900a65e4250ad49dcf02e07262af1fa5de25...1f17f88071cbfd6f02544d903c3b884f94dff052,4,30,22,52,19,2014-03-13 20:41:04,2014-03-13 17:53:48
1f17f88071cbfd6f02544d903c3b884f94dff052...91b4a561dfbaa5be170bc5dc1385519ea32ea9e2,1,0,3,3,1,2014-03-16 12:15:33,2014-03-14 20:58:14
91b4a561dfbaa5be170bc5dc1385519ea32ea9e2...a3dca9a3a6876e792509cbe47d7210eb4bdb114a,1,1,1,2,1,2014-03-16 12:15:33,2014-03-14 20:59:48
a3dca9a3a6876e792509cbe47d7210eb4bdb114a...f6ea0c203aa08c4817c7739461f8e7015d390279,3,12,8,20,6,2014-03-16 12:15:33,2014-03-14 22:22:27
f6ea0c203aa08c4817c7739461f8e7015d390279...8eb76075cf5f812249c343fa26eb299d59f63fa0,1,3,4,7,3,2014-03-16 12:15:33,2014-03-15 00:23:47
8eb76075cf5f812249c343fa26eb299d59f63fa0...ad15d75750d4482a752b84f3e599c6c6d16203e9,1,4,0,4,1,2014-03-16 12:15:34,2014-03-15 00:25:53
ad15d75750d4482a752b84f3e599c6c6d16203e9...e87ceb2b427a9b51a55af5898c2ef24b4cc08af2,1,151,82,233,9,2014-03-16 12:15:34,2014-03-15 00:12:53
e87ceb2b427a9b51a55af5898c2ef24b4cc08af2...c30cc4e3a5ead3ca5b48e8eec445740775888ed8,2,8,28,36,9,2014-03-16 12:15:34,2014-03-15 01:04:02
c30cc4e3a5ead3ca5b48e8eec445740775888ed8...23dfa71dd53617c3492f34787417ca60f03ea2ec,5,38,25,63,14,2014-03-16 12:15:34,2014-03-15 06:15:11
23dfa71dd53617c3492f34787417ca60f03ea2ec...ee4b9b552dee37ed5844da6c261e4d28a33d3c13,1,27,31,58,17,2014-03-17 17:19:47,2014-03-17 17:19:47
ee4b9b552dee37ed5844da6c261e4d28a33d3c13...4d140746f0978da2a6493b92d3b6de4b18f3394d,312,5836,79458,85294,2269,2014-03-17 20:33:01,2014-03-17 20:33:01
4d140746f0978da2a6493b92d3b6de4b18f3394d...7b9771f569238e9b92a22a027815ca08391cb367,2,77,20,97,13,2014-03-17 21:16:45,2014-03-17 20:46:40
7b9771f569238e9b92a22a027815ca08391cb367...b84ebfe8860edfb83bff945c30d41e2d9c32dfca,1,1,2,3,1,2014-03-17 21:39:37,2014-03-17 21:39:37
b84ebfe8860edfb83bff945c30d41e2d9c32dfca...b76a1ff940568195c032ba48dc0d2ee8f198bb86,2,35,1,36,2,2014-03-21 12:16:58,2014-03-18 10:03:22
b76a1ff940568195c032ba48dc0d2ee8f198bb86...9f23fe11418b66ab5812bed61e207af4e8f18efb,2,57,2,59,3,2014-03-24 22:59:31,2014-03-24 22:59:31
9f23fe11418b66ab5812bed61e207af4e8f18efb...69b8279d4bb416661394cbc224c4c64cdadd941f,1,2,1,3,1,2014-03-25 20:02:42,2014-03-25 20:02:42
2905884b63eb24184b576b1a963a4d72b0159171...92bbd60a3ffaf7b22e29576d720027cc835bf60e,1,1,1,2,1,2013-12-10 18:11:28,2013-12-10 18:10:34
92bbd60a3ffaf7b22e29576d720027cc835bf60e...4a2792cd2f86403a71edf65d82600b6aad5713bf,4,67,20,87,7,2013-12-10 18:56:01,2013-12-09 15:47:55
a030c7b902b0b8722af4122db78eff40cb81b3fd...e781832ea1b4c57e8277a93def70a2d894a82dd7,1,3,1,4,1,2014-03-26 07:52:00,2014-03-26 07:52:00
e781832ea1b4c57e8277a93def70a2d894a82dd7...ef096f8d8fb42b5ce030d3bef34bf363b401cbcb,2,7,5,12,2,2014-03-27 19:25:30,2014-02-25 16:38:33
ef096f8d8fb42b5ce030d3bef34bf363b401cbcb...d24946b1b45494df1c9a5ff4f80a8eb1d3acf968,2,4,1,5,2,2014-03-27 19:26:52,2014-03-06 22:25:38
d24946b1b45494df1c9a5ff4f80a8eb1d3acf968...85d595c8c252910559b82952753d831eae1798e5,1,1,0,1,1,2014-03-28 13:09:36,2014-03-24 19:36:59
85d595c8c252910559b82952753d831eae1798e5...6d15b163b090f7dd218843fdca55f874da5daead,2,8,7,15,7,2014-03-28 21:05:35,2014-03-25 20:48:57
6d15b163b090f7dd218843fdca55f874da5daead...b55c9d68aa713e75ff5077cd425cbaafde010b92,4,41,1,42,7,2014-03-29 07:51:41,2014-03-26 20:30:49
b55c9d68aa713e75ff5077cd425cbaafde010b92...5d2aef17ee56fbbf415ca1e3034cdb02cd97117c,17,222,163,385,65,2014-03-29 08:01:43,2014-03-06 23:27:01
5d2aef17ee56fbbf415ca1e3034cdb02cd97117c...e9ce8fc82a6d12e790511b62852e820d8be03186,4,100,40,140,16,2014-03-31 22:02:17,2014-02-27 20:45:18
e9ce8fc82a6d12e790511b62852e820d8be03186...490d5ab7808aedb998d1f4f933bf3de748758f62,3,9,28,37,5,2014-04-01 14:55:52,2014-03-31 12:22:49
490d5ab7808aedb998d1f4f933bf3de748758f62...8d6fa72d9720963387b73e0770eeec4dd0ba6dce,36,529,152,681,77,2014-04-01 18:46:28,2014-04-01 18:46:28
8d6fa72d9720963387b73e0770eeec4dd0ba6dce...f984555d47298cfb01b3e55c2861066379306fc3,1,8,2,10,2,2014-04-01 19:17:43,2014-04-01 14:18:09
f984555d47298cfb01b3e55c2861066379306fc3...67e078094b53861a5aa7e9354e33487d0bd4f73b,689,112843,22917,135760,9272,2014-04-01 20:05:24,2014-03-31 12:38:28
67e078094b53861a5aa7e9354e33487d0bd4f73b...5e24adbb90d085e6ac0e37ad6f016b1c94ce01d6,1,7,3,10,1,2014-04-01 20:05:25,2014-03-31 13:07:59
5e24adbb90d085e6ac0e37ad6f016b1c94ce01d6...c7214fe355596543d92d7c10b38d78ca65b4abfe,3,13,9,22,7,2014-04-01 20:05:25,2014-03-31 13:13:37
c7214fe355596543d92d7c10b38d78ca65b4abfe...d4fcb23e38e74d21e04b3a17d10e52949b630ec0,3,80,144,224,32,2014-04-02 00:31:28,2014-03-25 14:51:13
d4fcb23e38e74d21e04b3a17d10e52949b630ec0...08a5b442e42ff67bd5666604eebe69f1b4a1c919,23,211,145,356,148,2014-04-02 08:48:34,2014-03-06 20:44:18
08a5b442e42ff67bd5666604eebe69f1b4a1c919...006d42786e3123efb619210fb819b04f2b8b286f,5,10,10,20,9,2014-04-02 09:12:18,2014-03-01 02:09:29
006d42786e3123efb619210fb819b04f2b8b286f...42a33c1bb869a8fd64525ae282a0ab1d859218a9,2,19,2,21,2,2014-04-02 22:36:30,2013-12-24 12:33:03
42a33c1bb869a8fd64525ae282a0ab1d859218a9...95dbb6bf647d90947c0c738533dadf391559be98,2,3,4,7,2,2014-04-03 18:39:42,2014-04-02 00:04:15
95dbb6bf647d90947c0c738533dadf391559be98...962f96d3416ee00c78e729bc1c1b05e02d0c1ef2,82,1807,310,2117,257,2014-04-07 12:36:51,2014-04-07 12:36:51
962f96d3416ee00c78e729bc1c1b05e02d0c1ef2...42b93437102e63ded3e09bbeb24dc96d5b1b62f6,8,18,20,38,17,2014-04-07 12:37:20,2014-03-12 23:08:29
42b93437102e63ded3e09bbeb24dc96d5b1b62f6...a0a180a0adba6be3c567cd89e4bbca3561893e0d,1,1,7,8,2,2014-04-07 12:37:29,2014-03-12 23:22:50
4a2792cd2f86403a71edf65d82600b6aad5713bf...f16edd2632930e3fbfead4d6d52eeac87824f1a6,2,89,18,107,21,2013-12-10 19:17:00,2013-11-16 16:46:54
de7c0e8c021a4cce9be0e6e6a63d42455109ba94...3054decc199380e0d25c11ae12ce2d80262a303d,1,2,1,3,2,2014-04-08 04:56:12,2014-04-08 04:56:12
3054decc199380e0d25c11ae12ce2d80262a303d...c20b209dbb7e2f3ac8a75a8750bc4205d43952c8,1,13,6,19,5,2014-04-08 04:56:52,2014-02-04 01:23:15
c20b209dbb7e2f3ac8a75a8750bc4205d43952c8...592be014b680b70ee349dda5aa5928bde28da2cd,4,33,4,37,11,2014-04-10 15:39:49,2014-04-08 23:04:53
592be014b680b70ee349dda5aa5928bde28da2cd...045f765a1ac0632f90be0de3bf9630422aeee249,1,4,1,5,1,2014-04-10 15:55:38,2014-04-10 15:55:38
045f765a1ac0632f90be0de3bf9630422aeee249...525fad473bfafc2f44e1ab591152ca338fe45f2b,1,0,30,30,1,2014-04-10 20:54:12,2014-04-10 20:53:47
525fad473bfafc2f44e1ab591152ca338fe45f2b...4c36f3e7e6108660fc3629d76036e40c1938f639,3,49,1,50,5,2014-04-10 21:20:43,2014-03-27 17:45:15
4c36f3e7e6108660fc3629d76036e40c1938f639...8e823bcbe6543acac17cff790f6f19665f54556d,2,25,2,27,3,2014-04-10 21:22:05,2014-04-09 23:39:31
8e823bcbe6543acac17cff790f6f19665f54556d...c61b0e9cbc748c5e90fc5e25e4fb490b4104cae3,1,9,6,15,6,2014-04-12 08:40:31,2014-03-31 07:52:03
c61b0e9cbc748c5e90fc5e25e4fb490b4104cae3...2272052461445dfcae729cc6420a3d3229362158,1,13,5,18,4,2014-04-14 16:11:57,2014-04-13 15:11:56
2272052461445dfcae729cc6420a3d3229362158...940974ed039d3c9a8befe608d9c95b2ffdb457d3,1,1,7,8,1,2014-04-14 16:12:38,2014-04-13 17:19:14
940974ed039d3c9a8befe608d9c95b2ffdb457d3...c7f424e44b7e61b89f91cd344599c3d1cdfb88fe,3,8,0,8,4,2014-04-14 23:35:33,2014-04-14 23:35:33
c7f424e44b7e61b89f91cd344599c3d1cdfb88fe...2c6b424829caf0a4c07839c4daac3a438c0f0c9a,2,18,1,19,2,2014-04-15 20:00:31,2014-04-03 22:11:56
2c6b424829caf0a4c07839c4daac3a438c0f0c9a...77d1f4a91f2885fd3f39298754ae5b7ee75ad3d1,1,8,2,10,2,2014-04-17 10:27:09,2014-04-14 10:12:35
77d1f4a91f2885fd3f39298754ae5b7ee75ad3d1...b3ef289ffb7db476d284866658213f04415ea92d,19,622,145,767,73,2014-04-17 22:21:16,2014-04-14 17:15:57
b3ef289ffb7db476d284866658213f04415ea92d...345c40b6615c499b586b6f7f5528bcbea28ca12e,7,287,151,438,46,2014-04-17 22:21:16,2014-04-17 11:57:36
345c40b6615c499b586b6f7f5528bcbea28ca12e...afaff70a9b782c728b06a018d8473567c073df60,4,5,5,10,5,2014-04-17 22:24:48,2014-04-17 22:24:48
afaff70a9b782c728b06a018d8473567c073df60...0f3b72460b9987192d498700bbb02143a632f721,1,9,5,14,7,2014-04-22 12:19:57,2014-04-17 23:53:15
0f3b72460b9987192d498700bbb02143a632f721...89e88e96df551d070ca35576e7063f2a338d340a,1,1,0,1,1,2014-04-23 10:13:43,2014-04-22 15:53:59
89e88e96df551d070ca35576e7063f2a338d340a...3950024c2f54514916cb6e9fd5aec280a8823d3c,1,3,0,3,1,2014-04-24 06:14:48,2012-12-15 01:00:13
3950024c2f54514916cb6e9fd5aec280a8823d3c...a60a9b0dbd064cd70de9400ad47421c19d29b021,4,22,6,28,9,2014-04-24 06:40:35,2014-03-27 20:09:20
a60a9b0dbd064cd70de9400ad47421c19d29b021...bd24ab2bd788a196adaac316db20cde2c8c8e14d,3,58,0,58,3,2014-04-24 06:43:51,2014-04-09 13:02:03
bd24ab2bd788a196adaac316db20cde2c8c8e14d...681fe599d7a45fb537f948c08e64cdce06bc585d,4,40,1,41,5,2014-04-25 20:34:55,2014-04-25 12:06:06
681fe599d7a45fb537f948c08e64cdce06bc585d...226f98a356fb62a706bc860c36c9ebc6124d776e,6,164,0,164,10,2014-04-29 05:09:48,2014-03-06 18:21:04
226f98a356fb62a706bc860c36c9ebc6124d776e...d13e0297c362c99062ba61d9569248938b2bb72a,3,4,4,8,4,2014-04-29 10:13:28,2014-04-28 12:45:20
d13e0297c362c99062ba61d9569248938b2bb72a...26a1b712ec4e39cedc0b305165ce4660f47ba4d5,2,28,27,55,11,2014-04-29 10:20:14,2014-04-22 20:03:53
26a1b712ec4e39cedc0b305165ce4660f47ba4d5...ab7a3d098ddb13967014c723333c1df730da4940,2,9,0,9,2,2014-04-30 16:02:18,2014-04-21 16:26:11
ab7a3d098ddb13967014c723333c1df730da4940...7b72e156655afb6b998e8fb731cc65f4facb19ee,1,3,1,4,2,2014-04-30 16:14:55,2014-04-30 16:14:55
7b72e156655afb6b998e8fb731cc65f4facb19ee...d0fc5538d1ac769885c7e449b0d1f6759a7d4230,5,140,21,161,10,2014-04-30 17:44:31,2014-04-15 16:44:46
d0fc5538d1ac769885c7e449b0d1f6759a7d4230...3d3d48d4b78d48e9b002660fc045ba8bb4a96af2,30,294,108,402,88,2014-05-01 16:26:26,2014-05-01 16:26:26
3d3d48d4b78d48e9b002660fc045ba8bb4a96af2...d1fe6857ba40f895968217d281d79677a9f0d9ae,2,18,6,24,3,2014-05-01 16:40:54,2014-04-29 21:46:58
f16edd2632930e3fbfead4d6d52eeac87824f1a6...a22de4f7eed04f14e590fdc5c8739d2ee17753e5,415,13331,3883,17214,636,2013-12-11 18:20:26,2013-12-11 18:20:26
a22de4f7eed04f14e590fdc5c8739d2ee17753e5...4ec189b250188e04aad7ba1ccb1c498876df2af6,16,1785,119,1904,92,2013-12-12 04:06:11,2013-12-12 04:06:11
4ec189b250188e04aad7ba1ccb1c498876df2af6...910bc3c02d9248b098e3c00433ee6dd150a957e6,16,156,46,202,19,2013-12-12 04:24:36,2013-12-12 04:24:36
910bc3c02d9248b098e3c00433ee6dd150a957e6...04d52270b6a71256a89c20b8994c9de8d3bca532,1,1,1,2,1,2013-12-12 04:29:17,2013-12-11 15:14:10
04d52270b6a71256a89c20b8994c9de8d3bca532...f89a7185b7fb51fdbaf117f443bdc78925b44e50,1,3,2,5,1,2013-12-12 04:39:22,2013-12-12 04:39:22
f89a7185b7fb51fdbaf117f443bdc78925b44e50...4bc2ec90d72df1909d24c9fa52574fa90688d8da,1,3,3,6,3,2013-12-12 04:41:36,2013-12-07 21:33:26
4bc2ec90d72df1909d24c9fa52574fa90688d8da...0462bc23564e7e950a70ae4577a840b04db6c7c6,3,44,2,46,3,2013-12-12 05:20:06,2013-12-12 05:20:06
8637a40ea8c2b464c02ccad3ae42a66965b1b3f3...89223ae860fe1df0e1394d1df4782e1b5708a23f,3,71,2,73,3,2014-05-01 23:06:44,2014-05-01 23:06:44
593672c33dd40760e5a5f3d089ee4fd45553edba...bb1575b4c4d789919831f9aaf392bd3edd2e4c44,1,2,2,4,2,2013-12-12 06:11:19,2013-12-12 06:11:19
bb1575b4c4d789919831f9aaf392bd3edd2e4c44...7dca8d714f47b40a6f0118a86ee167507648583a,1,86,0,86,1,2013-12-12 06:11:19,2013-12-12 06:11:19
7dca8d714f47b40a6f0118a86ee167507648583a...1d5e7974451b04cd10afa29ca86641ad5cf68f46,1,6,6,12,5,2013-12-12 17:38:47,2013-12-12 16:16:48
0ed4aba0ac592fb5a38fba960cbb4d3f7c41a4c5...a6583ebd1131e8a4fc8687c5afaa8082f29e9a10,1,2,2,4,2,2014-05-02 14:53:42,2014-05-02 14:53:42
a6583ebd1131e8a4fc8687c5afaa8082f29e9a10...29518c17bea427924bb2179ea1b5429f89850266,1,3,3,6,2,2014-05-02 15:39:47,2014-05-02 15:22:19
29518c17bea427924bb2179ea1b5429f89850266...9479399d3b42f5e35715ebbc73b2c120db430bd9,1,1,1,2,1,2014-05-02 15:50:48,2014-05-02 15:50:48
9479399d3b42f5e35715ebbc73b2c120db430bd9...8398bf9128956b9c59bb7b0a6846f554707257b0,2,18,1,19,3,2014-05-02 18:12:54,2014-04-27 08:42:43
8398bf9128956b9c59bb7b0a6846f554707257b0...d3204b0225f9087cf419c69abeab7d1586e6af5d,1,1,0,1,1,2014-05-02 18:55:15,2014-04-19 13:29:26
d3204b0225f9087cf419c69abeab7d1586e6af5d...044da47353ea191f8521307abe1cd5c06f28efa2,1,2,5,7,1,2014-05-02 18:57:16,2013-08-14 19:31:33
044da47353ea191f8521307abe1cd5c06f28efa2...1ab98a130e560eaac0de4e2bdfc50c53fa01bbab,2,100,122,222,2,2014-05-06 13:44:36,2014-01-20 16:40:07
1ab98a130e560eaac0de4e2bdfc50c53fa01bbab...82fca9136deadc9ab176bb07145857efff7373e3,2,13,0,13,2,2014-05-06 13:50:25,2014-05-06 10:19:54
82fca9136deadc9ab176bb07145857efff7373e3...41d8e10f0d7b44c5c978f288f10091a877106f71,1,12,1,13,1,2014-05-06 17:45:20,2014-05-06 17:45:20
41d8e10f0d7b44c5c978f288f10091a877106f71...522dda2f12e2bc8cb1a83b4cc8d5c88020bb68b2,2,5,5,10,2,2014-05-07 20:44:12,2014-05-03 05:48:34
522dda2f12e2bc8cb1a83b4cc8d5c88020bb68b2...f7ede33f09187cd9b1874982e813380cd292ef17,2,31,3,34,3,2014-05-07 21:07:00,2014-03-25 21:16:55
f7ede33f09187cd9b1874982e813380cd292ef17...79e8f65cb1b1e20f8842d7fb012ccd9d04cc4f2f,1,1,1,2,1,2014-05-07 21:41:15,2014-04-30 19:14:59
79e8f65cb1b1e20f8842d7fb012ccd9d04cc4f2f...f10fd1ddba8a58151a58ca46008788b8bc82887f,1,2,0,2,1,2014-05-07 21:47:57,2014-05-07 21:47:57
f10fd1ddba8a58151a58ca46008788b8bc82887f...a4f2f9ea8a2a0388c1d76838b90e87b623863868,1,15,0,15,1,2014-05-07 21:56:21,2014-05-07 09:48:55
a4f2f9ea8a2a0388c1d76838b90e87b623863868...5344d0c1034b28f9e6de914430d8c8436ad85105,2,78,78,156,50,2014-05-07 23:31:00,2014-04-30 22:57:16
5344d0c1034b28f9e6de914430d8c8436ad85105...9b7888ef882698512e924ca824937cba30a77187,3,130,2,132,5,2014-05-12 10:59:16,2014-05-09 11:12:37
9b7888ef882698512e924ca824937cba30a77187...53b2e02a46b292ddc5b74fc7365f1037c60c0724,2,0,9,9,2,2014-05-12 20:52:33,2014-05-12 20:52:33
53b2e02a46b292ddc5b74fc7365f1037c60c0724...0f503cf0de8d43d1f4218dea25534a1cfac88266,1,1,1,2,1,2014-05-12 21:06:14,2014-05-06 12:05:32
0f503cf0de8d43d1f4218dea25534a1cfac88266...e1aa066fe16e5feb2d5621ce0d2163703da1110c,2,30,5,35,6,2014-05-12 21:13:14,2014-05-07 16:05:39
e1aa066fe16e5feb2d5621ce0d2163703da1110c...b1a44dfe9eb9297a260d584cf87af1d7b74e7d0a,3,0,38,38,4,2014-05-12 23:58:30,2014-05-12 23:45:44
b1a44dfe9eb9297a260d584cf87af1d7b74e7d0a...52527e03d30455e0cabd2a0911e763e0121c5fe6,1,54,75,129,10,2014-05-13 09:09:50,2014-05-12 03:23:21
52527e03d30455e0cabd2a0911e763e0121c5fe6...6569812531758c5ef63e5e8091edd77ef5ebb325,1,0,6,6,1,2014-05-13 09:13:23,2014-05-13 09:13:23
6569812531758c5ef63e5e8091edd77ef5ebb325...4a90f51bfe9934048520f6a3ffb717fc7ddbe843,2,215,181,396,11,2014-05-13 09:36:53,2014-05-12 09:42:21
4a90f51bfe9934048520f6a3ffb717fc7ddbe843...8ee9f04de6dfa89fc8fb96628b343d861c60bb2e,1,4,2,6,2,2014-05-13 18:48:26,2014-05-09 02:26:26
8ee9f04de6dfa89fc8fb96628b343d861c60bb2e...8a6c36dc3707212a83e44bdc01a09cf122a8e809,1,13,0,13,1,2014-05-15 23:05:31,2014-05-13 02:30:58
8a6c36dc3707212a83e44bdc01a09cf122a8e809...89cb740fc31f3be1c3af9fe787c7a405429ccac4,1,17,6,23,9,2014-05-16 08:25:03,2014-05-10 18:07:30
89cb740fc31f3be1c3af9fe787c7a405429ccac4...4a2c349473996fdf1b5f492ee27bf11c213b7747,1,12,5,17,4,2014-05-16 08:48:58,2014-05-16 08:47:51
4a2c349473996fdf1b5f492ee27bf11c213b7747...655ec2113aeb1050f26f714b43992c162ec168e2,2,10,10,20,3,2014-05-17 17:11:53,2014-05-17 07:25:10
655ec2113aeb1050f26f714b43992c162ec168e2...f1dc55d7018e2669550a8be2c5b6c091da616483,3,19,14,33,6,2014-05-18 13:59:52,2014-05-16 02:48:27
f1dc55d7018e2669550a8be2c5b6c091da616483...58cc36225165220ecf687d574e4b1427a50caacd,1,8,16,24,5,2014-05-21 20:14:10,2014-05-13 21:49:59
58cc36225165220ecf687d574e4b1427a50caacd...765b03255c65f0ebfd9896c5225a3402d837098a,1,1,2,3,2,2014-05-21 20:14:31,2014-05-20 09:26:37
765b03255c65f0ebfd9896c5225a3402d837098a...929e2ed5ba29693892ab134a86b218ea72a33e44,1,28,2,30,5,2014-05-21 20:16:00,2014-04-08 14:39:33
929e2ed5ba29693892ab134a86b218ea72a33e44...e7bfbaf891969785c3c59adbb19b1ff193dbf7d8,1,1,1,2,1,2014-05-21 20:56:29,2014-05-19 15:27:49
e7bfbaf891969785c3c59adbb19b1ff193dbf7d8...01c2a670a1ce07b4e942875b32324b1e62d4cd6d,2,7,4,11,2,2014-05-22 00:02:12,2014-05-16 11:32:43
01c2a670a1ce07b4e942875b32324b1e62d4cd6d...f09b02786ffd1f987df623aa670c26216b0682c9,2,47,1,48,5,2014-05-22 14:26:15,2014-04-28 01:25:02
f09b02786ffd1f987df623aa670c26216b0682c9...4729202d1ef102794616fbc460af6b2ac2a31131,3,56,8,64,14,2014-05-22 15:21:55,2014-04-29 01:40:40
4729202d1ef102794616fbc460af6b2ac2a31131...48675784fe6e3d575818c359c9892c5f508c9cc3,1,6,0,6,2,2014-05-22 17:31:29,2014-05-18 12:58:43
48675784fe6e3d575818c359c9892c5f508c9cc3...d0c7d93536d8bc7977ed2d3bd0b0246a558e5137,2,118,6,124,6,2014-05-22 17:46:44,2014-04-30 13:20:25
d0c7d93536d8bc7977ed2d3bd0b0246a558e5137...a367f62adfe6cb96f65ed6510545696852ceed37,2,59,1,60,4,2014-05-22 19:49:59,2014-05-21 11:47:21
a367f62adfe6cb96f65ed6510545696852ceed37...13553c133287141c92d088b148f4689e63859c09,1,7,5,12,2,2014-05-22 19:51:10,2014-05-22 11:00:55
13553c133287141c92d088b148f4689e63859c09...1bbb3cc00d2df63daf02b8e5b2f52b995923c008,1,2,2,4,1,2014-05-22 19:55:41,2014-05-22 19:55:03
1bbb3cc00d2df63daf02b8e5b2f52b995923c008...32b456328027875a719c879f96eae3f562ed8931,1,2,1,3,1,2014-05-22 23:04:27,2014-05-17 05:36:56
32b456328027875a719c879f96eae3f562ed8931...681013223f926378b3e18d43cc7f60b8ab3187b2,1,2,1,3,2,2014-05-23 10:42:46,2014-05-23 10:42:46
681013223f926378b3e18d43cc7f60b8ab3187b2...6f952845a6b2a482e62c138a9e030c00fc13e610,1,3,3,6,2,2014-05-23 19:10:23,2014-05-22 23:08:27
6f952845a6b2a482e62c138a9e030c00fc13e610...4394c8a9b3889436fa957ea52955936a2640407b,1,42,100,142,24,2014-05-23 22:21:35,2014-05-23 13:27:51
4394c8a9b3889436fa957ea52955936a2640407b...4c672c8a5e33e60a6d03b885a41a45abe9f31c69,1,20,0,20,1,2014-05-28 18:57:05,2014-05-23 03:37:47
4c672c8a5e33e60a6d03b885a41a45abe9f31c69...329103540c87becb0d9ee07478b0704f4d90af74,1,115,0,115,1,2014-05-28 18:58:08,2014-05-23 03:57:31
329103540c87becb0d9ee07478b0704f4d90af74...57c56558858f8348f938194c7fe563574cc46fd6,2,65,1,66,4,2014-05-28 22:05:19,2014-05-27 22:26:13
57c56558858f8348f938194c7fe563574cc46fd6...c7b02034ef80313564c50c59c63a5b640c24e234,1,6,1,7,1,2014-05-29 01:57:55,2014-05-28 22:34:04
c7b02034ef80313564c50c59c63a5b640c24e234...820aaf5b3d2728d900ba0ff8903d343840766912,12,61,34,95,26,2014-05-30 10:45:37,2014-05-27 21:31:31
820aaf5b3d2728d900ba0ff8903d343840766912...8ae32a98642fdb1cf9187c67fe0050129f6a5216,1,1,2,3,2,2014-06-04 21:37:27,2014-06-04 13:25:09
8ae32a98642fdb1cf9187c67fe0050129f6a5216...2f8627528b7fa389793d1be68de3b27ebfbc3748,1,0,19,19,1,2014-06-05 00:06:51,2014-05-15 15:56:04
1d5e7974451b04cd10afa29ca86641ad5cf68f46...39e2426b209799d5deaa29d2401dd98f060babda,8,140,34,174,14,2013-12-13 22:55:29,2013-12-13 21:21:10
9920ae67b53283192a7396cad63f6d92b80f1a95...bd988a590a387fc687ac4d182bce930993cc796c,1,1,0,1,1,2014-06-05 14:46:55,2014-06-05 14:46:55
bd988a590a387fc687ac4d182bce930993cc796c...1df32af74a450d456e264afbbaf6201a388d7572,2,2,0,2,2,2014-06-05 21:36:46,2014-06-04 03:49:38
1df32af74a450d456e264afbbaf6201a388d7572...ab50fad63bcbedd7c935a9c5d2ab9e4c7202c9f2,1,1,0,1,1,2014-06-08 17:02:25,2014-06-07 14:01:46
39e2426b209799d5deaa29d2401dd98f060babda...97738994e0bc2f3255659ca8f27e43a90aa0a24e,172,1235,742,1977,365,2013-12-17 07:09:16,2013-12-17 00:23:13
97738994e0bc2f3255659ca8f27e43a90aa0a24e...e10c223eb6b861b8aabb9c062298062e5b85d0d9,110,118,116,234,118,2013-12-17 17:04:30,2013-12-17 17:04:19
e10c223eb6b861b8aabb9c062298062e5b85d0d9...2a741f2d1219e3778899348bcb053b56161fda8e,111,119,115,234,117,2013-12-17 22:33:52,2013-12-17 22:33:52
2a741f2d1219e3778899348bcb053b56161fda8e...32478acf94ee3a787a65407b9f201bbb45405f3e,1,36,0,36,2,2013-12-18 23:06:20,2013-10-10 21:42:41
32478acf94ee3a787a65407b9f201bbb45405f3e...2eaef9f6daf996d5ea8fb4dcf3443724da5f7662,1,4,0,4,1,2013-12-18 23:36:12,2013-12-17 22:35:18
2eaef9f6daf996d5ea8fb4dcf3443724da5f7662...9371be0aa1548b199dd028f49e3f55ec922d4766,4,15,4,19,6,2013-12-18 23:42:46,2013-12-18 23:42:46
9371be0aa1548b199dd028f49e3f55ec922d4766...b7fd6bc899ccb629d790c47aee06aba87e535c41,2,17,2,19,2,2013-12-18 23:49:45,2013-12-18 23:49:45
61770f21258a688199c83af2716945c3366f6296...4cd522d15796ac558a2be8c623ed3fc1d7dfe3a0,1,10,10,20,4,2014-06-11 21:26:16,2014-05-23 19:41:40
4cd522d15796ac558a2be8c623ed3fc1d7dfe3a0...90c989108493aa7bcfcf69a965dcaa969188364c,1,38,0,38,1,2014-06-11 21:26:16,2014-05-23 20:15:15
90c989108493aa7bcfcf69a965dcaa969188364c...4d04c7b5ee73c5a375bc491ee99272698b1320dc,1,0,4,4,1,2014-06-11 23:00:47,2014-06-11 20:03:50
4d04c7b5ee73c5a375bc491ee99272698b1320dc...ca5503738045854d8e3b5ca4ed37975a93ddfc5d,1,2,2,4,2,2014-06-11 23:05:38,2014-06-08 02:25:02
ca5503738045854d8e3b5ca4ed37975a93ddfc5d...eef0715db56f8b9b0207c1b979e4ff9f5acef475,2,70,2,72,2,2014-06-11 23:10:11,2014-06-08 18:58:07
eef0715db56f8b9b0207c1b979e4ff9f5acef475...03e9f84933fe610b04b107cf1f83d17485e8906e,11,8,55,63,19,2014-06-12 03:41:12,2014-06-11 19:16:48
03e9f84933fe610b04b107cf1f83d17485e8906e...e00cafa311e2503dbd7e016623de718979161754,3,26,4,30,5,2014-06-12 17:33:15,2014-06-08 09:14:14
e00cafa311e2503dbd7e016623de718979161754...1cd48c7ae5f592307741865f2ba650515a0c4f01,2,5,8,13,3,2014-06-12 17:42:52,2014-06-08 10:02:54
1cd48c7ae5f592307741865f2ba650515a0c4f01...5413d9abe0df7e22bdb650a65f4c0ac462bbe147,1,1,1,2,1,2014-06-12 17:44:13,2014-06-05 00:15:22
5413d9abe0df7e22bdb650a65f4c0ac462bbe147...3a280b2034e3ea438cd3a2e7acd1a4cd40112ac5,835,44952,49510,94462,12350,2014-06-13 00:46:17,2014-05-12 03:07:46
3a280b2034e3ea438cd3a2e7acd1a4cd40112ac5...dde590d8b93ba0be86f048b752164ea8b8aa261f,1,1,1,2,1,2014-06-13 00:46:18,2014-05-12 03:38:47
dde590d8b93ba0be86f048b752164ea8b8aa261f...5d178188a7c64267a0086d9f7bc04a7c6b95ad8e,2,20,10,30,10,2014-06-13 00:46:18,2014-05-14 09:25:57
5d178188a7c64267a0086d9f7bc04a7c6b95ad8e...d78a3787d26488c0848509b84b09c3fd30185f58,2,25,1,26,3,2014-06-13 00:46:18,2014-05-23 14:01:17
d78a3787d26488c0848509b84b09c3fd30185f58...d5198768de26077a523ecaf7182dfbe94c5fa5ca,3,14,5,19,9,2014-06-13 01:30:26,2014-06-12 18:21:26
d5198768de26077a523ecaf7182dfbe94c5fa5ca...c047127410b96c705ffe8d9990fb4751b4ea1eaf,2,49,0,49,2,2014-06-13 01:30:41,2014-06-12 22:40:28
696ae46fd7592d786f7c573fad9abf386209d254...00e28ee6a8d02dede53391c0fb1df036b93eb3de,1,2,2,4,2,2013-12-19 17:05:14,2013-12-19 17:05:14
00e28ee6a8d02dede53391c0fb1df036b93eb3de...f84c7a27765667345935168172493da13b3d84ea,1,68,0,68,1,2013-12-19 17:05:14,2013-12-19 17:05:14
4f1782ef750fb171eb90a1d97b14e2ed3a8a165d...c08da463adab71c05017ad6fe81927fa66e2e11e,1,1,1,2,1,2014-06-24 04:44:11,2014-05-13 12:20:36
c08da463adab71c05017ad6fe81927fa66e2e11e...be8114e5c5afa461a47f617dad86f8de7b27b6cf,1,3,1,4,1,2014-06-24 04:45:29,2014-06-17 22:44:11
be8114e5c5afa461a47f617dad86f8de7b27b6cf...fcbffa71d030e48a10e29e35d973e40d0418fda0,1,9,6,15,1,2014-06-24 05:55:26,2014-06-22 15:34:47
fcbffa71d030e48a10e29e35d973e40d0418fda0...ad5e8ec3e2845d8d048ac8160f6af0194bc2b7e9,1,12,0,12,1,2014-06-24 16:21:25,2014-06-22 00:09:04
ad5e8ec3e2845d8d048ac8160f6af0194bc2b7e9...16ed1946598ed3ae58bcdd362e8dceca0f89d80a,1,2,2,4,2,2014-06-24 16:25:26,2014-06-15 16:04:12
16ed1946598ed3ae58bcdd362e8dceca0f89d80a...a55c60c71550dd82e7bdad4ae7df42e77631204f,1,14,1,15,4,2014-06-24 16:26:02,2014-06-12 18:12:54
a55c60c71550dd82e7bdad4ae7df42e77631204f...61baefce1e8cae13e40f01c04c8f684848cee3e2,2,49,1,50,3,2014-06-25 00:08:57,2014-06-05 00:26:34
61baefce1e8cae13e40f01c04c8f684848cee3e2...56d767fd698bbe1e3bdf5bf286cc573ef3248b5a,1,3,1,4,2,2014-06-25 07:17:59,2014-06-25 07:16:08
56d767fd698bbe1e3bdf5bf286cc573ef3248b5a...e50749bb056d84763b89b9f96a584592ab262c55,2,30,0,30,3,2014-06-25 10:11:09,2014-06-25 10:11:09
e50749bb056d84763b89b9f96a584592ab262c55...c147e81091750ed38500d75299be3d9ced04d946,3,16,7,23,6,2014-06-25 10:47:59,2014-06-25 10:47:59
c147e81091750ed38500d75299be3d9ced04d946...922afd91649f0c356521356c57c6e04796a59cc0,1,3,0,3,1,2014-06-25 10:50:00,2014-05-17 08:42:50
922afd91649f0c356521356c57c6e04796a59cc0...35b9580cd84452dd76aa19715479a47074d1761b,5,149,1,150,8,2014-06-27 00:02:19,2014-06-20 22:43:00
35b9580cd84452dd76aa19715479a47074d1761b...1a1b1a75347a4d68aedefb71b8bacce050b1768b,62,955,194,1149,173,2014-06-27 00:44:36,2014-06-27 00:44:36
1a1b1a75347a4d68aedefb71b8bacce050b1768b...2cae44f16934836f0a66b2ea930a0604f505e571,2,15,2,17,3,2014-06-27 09:36:44,2014-06-27 04:07:16
2cae44f16934836f0a66b2ea930a0604f505e571...6b09f9cd4145bf8e9543442cec2d92d699cd81e2,3,58,2,60,6,2014-06-27 12:09:52,2014-06-25 13:18:50
6b09f9cd4145bf8e9543442cec2d92d699cd81e2...73343d5ceef7cb4ddee1ed0ddd2c51d1958e3bb1,1,3,18,21,3,2014-06-27 13:00:10,2014-06-12 04:38:58
73343d5ceef7cb4ddee1ed0ddd2c51d1958e3bb1...7fa4a9697d82fe811b73aea92492b66798420609,2,2,2,4,2,2014-06-30 08:45:54,2014-06-28 18:46:42
7fa4a9697d82fe811b73aea92492b66798420609...b5175003bca45e23bd20d9559096dafda3e0ad7c,1,15,6,21,9,2014-06-30 09:04:36,2014-06-07 06:00:55
b5175003bca45e23bd20d9559096dafda3e0ad7c...1c0ec7172534e0a1f64f388a0eeb08eb0ac333df,1,2,2,4,2,2014-07-01 11:45:55,2014-07-01 06:44:09
1c0ec7172534e0a1f64f388a0eeb08eb0ac333df...423725b34d80ad09d6ed47393cda2aa183814010,1,2,1,3,1,2014-07-01 11:48:42,2014-07-01 07:48:28
423725b34d80ad09d6ed47393cda2aa183814010...02b8109c140bb5c9bcab0282ea19481f769cfce4,2,44,26,70,15,2014-07-01 12:28:50,2014-03-31 19:06:03
02b8109c140bb5c9bcab0282ea19481f769cfce4...613654e882d9b3eda43680de0811d5f52caed994,1,4,1,5,1,2014-07-01 15:04:35,2014-07-01 13:35:35
613654e882d9b3eda43680de0811d5f52caed994...1100f3de7a2053d98f6ee81703df2d5bd17523d1,2,39,1,40,2,2014-07-02 19:35:06,2014-06-28 05:32:50
1100f3de7a2053d98f6ee81703df2d5bd17523d1...ae1e325e8a3f05bb17959ec507664e2d06588327,4,13,1,14,6,2014-07-02 20:01:07,2014-07-02 11:26:46
ae1e325e8a3f05bb17959ec507664e2d06588327...e34525356201654bfe35b4bb7edec6f5b47b6374,5,88,54,142,37,2014-07-02 20:41:39,2014-04-14 16:08:38
e34525356201654bfe35b4bb7edec6f5b47b6374...20247064b63b7937d5374368e236bcf4b184888a,2,32,1,33,2,2014-07-02 20:45:00,2014-07-02 17:35:50
20247064b63b7937d5374368e236bcf4b184888a...a382c9a97c7440f79f0be2f6e2689f4338d35396,6,159,8,167,10,2014-07-03 03:59:27,2014-07-02 13:24:17
a382c9a97c7440f79f0be2f6e2689f4338d35396...803c3f0aa0fb7d41291abd93a2c6dea4dbee721a,1,2,2,4,1,2014-07-03 04:02:36,2014-07-03 04:02:36
803c3f0aa0fb7d41291abd93a2c6dea4dbee721a...df205360f5cdf3310a69748e74c636ec011d2e64,2,53,0,53,2,2014-07-03 11:06:33,2014-07-03 00:59:28
df205360f5cdf3310a69748e74c636ec011d2e64...46ccb201cb41b2979ce4127c67935cbf0932e15c,1,3,5,8,6,2014-07-07 10:40:22,2014-07-03 20:39:29
46ccb201cb41b2979ce4127c67935cbf0932e15c...fc6eae8da240c49d29f02bb0d7e506273038af0f,1,1,0,1,1,2014-07-07 11:19:23,2014-07-03 23:15:46
fc6eae8da240c49d29f02bb0d7e506273038af0f...832d4db5f221705f8a1058a6aa3e4bcc9a5de8ad,2,0,36,36,2,2014-07-08 18:43:48,2014-07-08 18:43:48
832d4db5f221705f8a1058a6aa3e4bcc9a5de8ad...e1fec22f9783ad28c35639b3766170c620f2d0be,3,20,17,37,8,2014-07-10 10:28:55,2014-07-08 22:06:40
e1fec22f9783ad28c35639b3766170c620f2d0be...245469587c7a6326d1b55bdf6c6d6650d72bfa22,1,6,3,9,2,2014-07-10 12:07:07,2014-07-08 00:04:42
245469587c7a6326d1b55bdf6c6d6650d72bfa22...feac62d8d629a2225c93ae5c797efe3a899acba2,1,0,9,9,2,2014-07-10 12:07:07,2014-07-08 18:33:50
feac62d8d629a2225c93ae5c797efe3a899acba2...a7b14f7a89e7d319d193a6be179bb13b376cc031,3,2,2,4,2,2014-07-10 12:07:08,2014-07-08 19:14:58
a7b14f7a89e7d319d193a6be179bb13b376cc031...9452ea2ef5bbaf4c0b03764c53899d97d0f210f3,2,79,16,95,13,2014-07-10 12:20:33,2014-07-07 23:38:05
9452ea2ef5bbaf4c0b03764c53899d97d0f210f3...c4e5fde3629f386ab73453b9d5e85f071da1fc55,3,33,1,34,3,2014-07-12 09:46:16,2014-06-25 03:18:00
c4e5fde3629f386ab73453b9d5e85f071da1fc55...da30c0084a326d705b6a27453ed5b3cc69009cc0,1,5,3,8,3,2014-07-13 19:07:46,2014-07-09 11:36:50
da30c0084a326d705b6a27453ed5b3cc69009cc0...b69249376650251f24e90f81656ded1d10e8cae0,1,1,1,2,1,2014-07-13 19:15:52,2014-07-13 19:15:52
b69249376650251f24e90f81656ded1d10e8cae0...b96e38ac3a8b143a1129104569ff1b17acac1df4,4,156,16,172,11,2014-07-14 20:12:43,2014-05-23 01:56:18
b96e38ac3a8b143a1129104569ff1b17acac1df4...04d6fc2c3feea209a2c20f41ef4aaeebe3c6e0ab,3,72,4,76,4,2014-07-14 20:12:43,2014-07-10 16:13:27
04d6fc2c3feea209a2c20f41ef4aaeebe3c6e0ab...857975d5e7e0d7bf38577db0478d9e5ede79922e,1,0,1,1,1,2014-07-17 04:46:26,2014-07-17 04:23:15
857975d5e7e0d7bf38577db0478d9e5ede79922e...4c48df5a35754c459e32f03dbc21a7d43f23b6be,3,47,3,50,8,2014-07-23 12:25:50,2014-07-21 18:12:11
4c48df5a35754c459e32f03dbc21a7d43f23b6be...ba094094790b76e324b527a3b318444260e9b6a9,1,16,0,16,1,2014-07-23 18:47:05,2014-07-18 07:16:28
ba094094790b76e324b527a3b318444260e9b6a9...2f0017aa53236dc9715ff4989aea8afb02aaa302,6,96,26,122,23,2014-07-23 19:08:46,2014-07-23 19:08:46
2f0017aa53236dc9715ff4989aea8afb02aaa302...ea89fdfec4f7a6ff180149a5eacc3c7d84b87e39,2,11,4,15,2,2014-07-23 19:39:28,2014-07-20 02:35:07
ea89fdfec4f7a6ff180149a5eacc3c7d84b87e39...300dd3499c2b939e3bc3501d9b060a7b364dd5e2,1,15,1,16,2,2014-07-23 19:42:22,2014-07-23 13:24:07
300dd3499c2b939e3bc3501d9b060a7b364dd5e2...2bb48673126ffc5f4b291f3d74b8be8d850c2d56,2,68,0,68,2,2014-07-23 19:43:58,2014-07-17 14:01:40
2bb48673126ffc5f4b291f3d74b8be8d850c2d56...e1ce8ba639b5591675a43859697b00b9134e30ec,6,20,2,22,10,2014-07-23 19:44:57,2014-07-16 14:04:34
e1ce8ba639b5591675a43859697b00b9134e30ec...61ddad1314824ac32bb2eadd88c44df53ab4792c,2,18,12,30,7,2014-07-23 20:41:51,2014-07-19 05:27:34
61ddad1314824ac32bb2eadd88c44df53ab4792c...9a63a1d89b5a2a015eadd5ef5d7e42039858c5ae,1,12,1,13,1,2014-07-24 22:44:24,2014-07-24 09:31:45
9a63a1d89b5a2a015eadd5ef5d7e42039858c5ae...832ec1cd507ed344badd2ed97d3da92975650a95,2,68,0,68,2,2014-07-28 14:30:26,2014-07-23 21:22:22
832ec1cd507ed344badd2ed97d3da92975650a95...e1fb1b58f92e74794199ac4604e608ffc6d74aec,2,55,0,55,2,2014-07-28 14:44:36,2014-07-25 17:11:10
e1fb1b58f92e74794199ac4604e608ffc6d74aec...ef3c4ed3dd23522d871e5951766441a7a0512f47,1,30,1,31,2,2014-07-29 01:13:04,2014-07-29 00:19:03
f84c7a27765667345935168172493da13b3d84ea...55b0bd639dea3e0d56b596aaa6ba2d26458c2be1,1,1,0,1,1,2013-12-20 19:03:06,2013-12-20 08:29:06
55b0bd639dea3e0d56b596aaa6ba2d26458c2be1...7f82faee307de546a91c647086a0bb0c36de3132,124,277,168,445,148,2013-12-26 03:15:23,2013-12-26 03:15:23
7f82faee307de546a91c647086a0bb0c36de3132...d2d56d04f87b1ab0d45bb25da588781ca11cb91f,1,9,0,9,1,2013-12-28 12:58:01,2013-12-27 19:39:55
d2d56d04f87b1ab0d45bb25da588781ca11cb91f...34b9280da4c015b666724068e3eb3139b5b01c95,1,1,1,2,1,2013-12-30 19:44:13,2013-07-24 18:17:28
34b9280da4c015b666724068e3eb3139b5b01c95...cb5da7b443513627436a276ea4249779930d4648,12,559,134,693,57,2013-12-30 23:52:47,2013-12-18 14:58:47
f310c0f16b7d30c1f60eb4ae794748ef5d2ba77c...7166b55015261de8ab69758320f3d9159b3eaadd,3,18,9,27,12,2014-07-29 08:53:05,2014-07-09 10:01:05
7166b55015261de8ab69758320f3d9159b3eaadd...0381cf5698825a7e72de850bae0616e1108f21d3,1,8,1,9,1,2014-07-30 22:10:05,2014-07-30 01:06:47
0381cf5698825a7e72de850bae0616e1108f21d3...bae019f1824aafdfbf92d2115ebd9a677cb754f3,1,77,0,77,1,2014-07-31 08:02:39,2014-07-28 23:53:10
bae019f1824aafdfbf92d2115ebd9a677cb754f3...1a52d6abccf8f314f6b6274076ab88664261437f,3,9,18,27,12,2014-07-31 08:12:18,2014-07-31 08:12:18
1a52d6abccf8f314f6b6274076ab88664261437f...1a84ba2d66129c36581a42dd7aa3a6707cfd1704,1,10,4,14,3,2014-07-31 08:30:46,2014-07-31 08:30:46
1a84ba2d66129c36581a42dd7aa3a6707cfd1704...4e68a28e20b348f3519b359a17fcb941b235202b,1,1,17,18,4,2014-07-31 08:32:28,2014-07-24 09:59:00
4e68a28e20b348f3519b359a17fcb941b235202b...ff6117b8ed57089001bdc3659b79d23bea1107fe,1,17,1,18,4,2014-07-31 08:38:46,2014-07-31 08:38:46
ff6117b8ed57089001bdc3659b79d23bea1107fe...4b59db008cec1bfcca2783f4b27c630c9c3fdd73,1,22,0,22,2,2014-07-31 18:56:46,2014-07-01 19:28:49
4b59db008cec1bfcca2783f4b27c630c9c3fdd73...d287b8e58adb7c3b09ca5c0aa8e9420322d40d10,2,103,40,143,14,2014-07-31 20:34:40,2014-07-31 02:20:52
d287b8e58adb7c3b09ca5c0aa8e9420322d40d10...bbb2dccd1b650db656918f12311f04efa2495ee6,1,1,1,2,1,2014-08-01 14:10:15,2014-08-01 06:08:52
bbb2dccd1b650db656918f12311f04efa2495ee6...aab126bb0604a0159ebc139644a71407661aa6fc,1,3,0,3,1,2014-08-02 07:07:18,2014-07-31 23:49:28
aab126bb0604a0159ebc139644a71407661aa6fc...37c2a528336b41b31abe4826b308071896e42423,1,2,2,4,2,2014-08-02 07:19:20,2014-08-02 05:33:35
37c2a528336b41b31abe4826b308071896e42423...47a103a029498a67e137891994beb54f355b34ce,2,9,0,9,2,2014-08-02 11:07:07,2014-08-02 11:06:25
47a103a029498a67e137891994beb54f355b34ce...962e651476ce2035ce6e15eff5abd0f9c54e039c,2,22,1,23,2,2014-08-02 16:14:46,2014-08-01 11:26:09
962e651476ce2035ce6e15eff5abd0f9c54e039c...20229d6896ce4b802a0789b1d2643dcac55bebb9,1,1,1,2,1,2014-08-04 20:39:12,2014-08-04 14:18:54
20229d6896ce4b802a0789b1d2643dcac55bebb9...7da63a10ac5e3f4c63ed9b2fa6dfdbfa32df4063,1,1,1,2,1,2014-08-04 20:48:19,2014-08-01 18:06:54
7da63a10ac5e3f4c63ed9b2fa6dfdbfa32df4063...430678640c52868c571e1d71ce8ad1501866bafc,6,198,27,225,23,2014-08-04 23:57:18,2014-05-22 02:13:09
430678640c52868c571e1d71ce8ad1501866bafc...e643fe4c4b79f2683914c6435f7166fc6be9f1a7,2,2,8,10,7,2014-08-05 01:19:45,2014-08-05 01:12:54
e643fe4c4b79f2683914c6435f7166fc6be9f1a7...63a42682187a963873211da8f647fa3c077489f4,2,67,4,71,2,2014-08-05 12:13:07,2014-08-05 09:34:56
63a42682187a963873211da8f647fa3c077489f4...aa3b4b4d106415b3afbc31df0db2476a04c997f1,178,3475,6032,9507,1011,2014-08-07 09:36:56,2014-08-07 09:36:56
aa3b4b4d106415b3afbc31df0db2476a04c997f1...e49429ebd2fe0b7c24e2ee533311dd97f6febd1f,60,3243,928,4171,478,2014-08-07 11:03:17,2014-08-07 11:03:17
e49429ebd2fe0b7c24e2ee533311dd97f6febd1f...7ca4fa56d054926873e22f390f9ddc97e3182e3e,1,1,17,18,4,2014-08-07 11:03:54,2014-07-24 09:59:00
7ca4fa56d054926873e22f390f9ddc97e3182e3e...28eee0adb7884e21217c99cbf10a681c7d91b64a,1,1,1,2,1,2014-08-07 11:05:04,2014-07-05 09:02:33
cb5da7b443513627436a276ea4249779930d4648...3e9f2e61db371f8208ccb04824fdfb186de72f36,4,83,9,92,6,2013-12-31 17:47:33,2013-12-27 17:20:52
3e9f2e61db371f8208ccb04824fdfb186de72f36...6f8aa24d1ee0c8502ec4c3dae3820668ae7fc435,1,19,16,35,7,2013-12-31 19:57:13,2013-12-31 19:57:13
28eee0adb7884e21217c99cbf10a681c7d91b64a...92598e8f2b50ee434fe2ffb7e02a97290cae1d31,1,2,2,4,1,2014-08-07 19:44:36,2014-08-07 19:43:42
6f8aa24d1ee0c8502ec4c3dae3820668ae7fc435...3917232030ec3b096fa08bb03b0bdc82301c0ac0,1,4,3,7,3,2013-12-31 22:38:09,2013-11-06 03:23:35
3917232030ec3b096fa08bb03b0bdc82301c0ac0...ffb718b5a36302d98dac1fef683600e621560255,1,7,5,12,2,2013-12-31 22:48:20,2013-12-31 22:48:20
ffb718b5a36302d98dac1fef683600e621560255...5a8de857f0bd05941f54b20415ab7c374c4b1720,1,5,0,5,1,2013-12-31 22:52:43,2013-11-12 10:28:44
a5778cdf01425ae39cea80b62f9ec6740aec724a...4516e6dda4ed7ecc25a5ad164e4d7ade039bb657,1,3,1,4,1,2014-08-07 23:47:01,2014-08-06 06:35:35
4516e6dda4ed7ecc25a5ad164e4d7ade039bb657...2a415358ee8585e9480c425678234fa8d05fc620,1,7,0,7,1,2014-08-08 00:22:53,2014-08-07 14:45:53
2a415358ee8585e9480c425678234fa8d05fc620...b1741ea1fadf2dfd6eb2ad26dee828b795b440c9,1,3,0,3,1,2014-08-08 14:03:04,2014-08-06 18:00:31
b1741ea1fadf2dfd6eb2ad26dee828b795b440c9...10fa8e399958bb00113c05b0be8da48734c3f866,1,13,6,19,5,2014-08-08 16:40:24,2013-12-11 17:19:04
10fa8e399958bb00113c05b0be8da48734c3f866...6ea5d1673145a8e8c554035f88f15ce4610be0fd,1,3,1,4,2,2014-08-08 21:50:49,2014-08-08 02:36:56
6ea5d1673145a8e8c554035f88f15ce4610be0fd...93f3b640d06df5e123e7ede90e40df06258d9d47,1,9,2,11,6,2014-08-11 14:19:55,2014-08-05 13:33:16
93f3b640d06df5e123e7ede90e40df06258d9d47...42bda05af8d628db90f3ee64fa2dd89973cb1e03,5,235,0,235,7,2014-08-11 18:00:34,2014-05-05 14:35:28
42bda05af8d628db90f3ee64fa2dd89973cb1e03...0718426506275fdaf97b2f8688e68dbbb3964c23,1,4,2,6,1,2014-08-12 00:10:43,2014-08-12 00:10:43
0718426506275fdaf97b2f8688e68dbbb3964c23...931cbc175f7664d785e6a59642b07471851826fb,2,6,5,11,4,2014-08-12 22:57:13,2014-08-11 08:41:18
931cbc175f7664d785e6a59642b07471851826fb...678ead2608aaf746c2fcf3df11097c2ca4d5a990,2,15,1,16,2,2014-08-13 03:38:30,2014-08-13 02:32:22
678ead2608aaf746c2fcf3df11097c2ca4d5a990...00004160a1230892197041f5628e7b1545bd8146,3,6,5,11,4,2014-08-13 04:04:41,2014-08-08 17:49:24
00004160a1230892197041f5628e7b1545bd8146...a8845ebd45ea7a96e7c63c6bb0a122b264aced5e,1,2,2,4,2,2014-08-13 04:43:20,2014-08-13 04:03:25
a8845ebd45ea7a96e7c63c6bb0a122b264aced5e...807acf7f9871c6ee25915e7e159c9ea8b168028b,1,1,1,2,1,2014-08-13 04:50:21,2014-08-13 04:50:21
807acf7f9871c6ee25915e7e159c9ea8b168028b...44743eaf24b0c0a7fbaa8d9aa04b4a211d8ec5e2,1,11,3,14,3,2014-08-13 09:58:51,2014-08-10 02:46:11
44743eaf24b0c0a7fbaa8d9aa04b4a211d8ec5e2...7d1860a6788621111381bd63d3e486bb15c01485,1,11,1,12,2,2014-08-13 18:43:09,2014-08-11 22:15:21
7d1860a6788621111381bd63d3e486bb15c01485...f5f5bd76e6e4791d1098cc71c0d8927fdf34d318,2,89,2,91,3,2014-08-13 18:43:41,2014-08-06 21:32:46
f5f5bd76e6e4791d1098cc71c0d8927fdf34d318...c7b42fe2e5342c903cf36351d1d13b9d43261b70,5,29,2,31,7,2014-08-13 18:43:58,2014-08-02 08:42:42
c7b42fe2e5342c903cf36351d1d13b9d43261b70...0565d52a71313ca1334fa89f11cb626e4bc2b522,1,12,6,18,4,2014-08-13 18:44:15,2014-08-11 20:29:00
0565d52a71313ca1334fa89f11cb626e4bc2b522...0d357fa135dedaae644d73b0b9a907b90c66f200,2,15,13,28,6,2014-08-13 18:44:20,2014-08-12 14:48:02
0d357fa135dedaae644d73b0b9a907b90c66f200...9134a3bf413fe7e498e75ea3d6ad7d6f33040f68,1,2,2,4,2,2014-08-17 10:17:30,2014-08-17 10:17:30
9134a3bf413fe7e498e75ea3d6ad7d6f33040f68...b9960eefc2093ea639353171189652b7cf116326,1,7,8,15,5,2014-08-18 23:21:03,2014-08-14 14:54:44
b9960eefc2093ea639353171189652b7cf116326...7be96f52857732d64d88ea98d70308f97a7ddf97,2,5,3,8,3,2014-08-19 17:23:20,2014-08-13 18:02:37
7be96f52857732d64d88ea98d70308f97a7ddf97...437c2f438335541084136480a9a5308075dd3dfd,1,1,0,1,1,2014-08-19 17:28:06,2014-08-19 17:28:06
437c2f438335541084136480a9a5308075dd3dfd...5086d6ef94d1ce2b67193781052be84bb6913e63,2,44,1,45,2,2014-08-20 20:51:09,2014-08-15 14:40:09
5086d6ef94d1ce2b67193781052be84bb6913e63...4ef2a5a6720c17870e3b91b224fb3dc1e3655d27,5,102,1,103,5,2014-08-20 20:58:12,2014-08-19 21:38:55
4ef2a5a6720c17870e3b91b224fb3dc1e3655d27...c0f30f6058f27694dd4faaf4040c804769999ac1,1,3,0,3,2,2014-08-21 23:29:52,2014-08-21 16:05:42
c0f30f6058f27694dd4faaf4040c804769999ac1...8a7d7f8b2b40f670d2fceb14d7d16cda1bea6bcf,1,0,1,1,1,2014-08-23 19:22:23,2014-08-23 19:22:23
8a7d7f8b2b40f670d2fceb14d7d16cda1bea6bcf...6adf3ecebb42c05662f7c6a792953589ffdfd4dc,6,83,7,90,13,2014-08-26 20:24:57,2014-08-23 13:38:32
6adf3ecebb42c05662f7c6a792953589ffdfd4dc...f7d6147e43b8a80a0d627f2034271239db500d9f,1,9,6,15,1,2014-08-27 10:13:31,2014-08-25 12:55:11
f7d6147e43b8a80a0d627f2034271239db500d9f...6e453fad87c51dc15327628aa75886d3fbb3fa1c,6,426,0,426,9,2014-08-28 20:27:09,2014-08-27 14:01:01
6e453fad87c51dc15327628aa75886d3fbb3fa1c...0dfedb7127ac388f66f5ea5d38330c86af6539b5,11,178,1,179,14,2014-08-28 20:36:48,2014-08-27 09:00:13
0dfedb7127ac388f66f5ea5d38330c86af6539b5...f6877f37b216a955b41eb2b6ec10bf0d8510a024,2,14,10,24,2,2014-08-28 20:36:51,2014-08-28 07:51:42
f6877f37b216a955b41eb2b6ec10bf0d8510a024...53fc14c5691151d85e7a337e94202e84b004ab7c,1,2,0,2,2,2014-09-01 15:30:13,2014-08-29 19:47:42
53fc14c5691151d85e7a337e94202e84b004ab7c...92419f8762bca849622da3061d978b5a09a4cb62,1,13,0,13,2,2014-09-02 12:20:56,2014-08-23 14:48:13
92419f8762bca849622da3061d978b5a09a4cb62...16b0a3393ecf18a02410f359af3d6f6f18c6caf5,1,2,1,3,2,2014-09-02 13:41:21,2014-09-02 13:26:14
16b0a3393ecf18a02410f359af3d6f6f18c6caf5...fcfe820481fa1d167d4d4a9a487036cbd447fb05,1,2,2,4,2,2014-09-02 13:41:30,2014-09-02 13:27:33
fcfe820481fa1d167d4d4a9a487036cbd447fb05...90d1147b8be188cb53de3d5faea2818310509cf9,5,134,19,153,16,2014-09-02 18:14:04,2014-08-16 00:20:32
90d1147b8be188cb53de3d5faea2818310509cf9...cdc01faed2b92f43a58cb86ff3300af1322cfaf6,1,15,0,15,3,2014-09-02 18:20:52,2014-08-23 21:01:06
cdc01faed2b92f43a58cb86ff3300af1322cfaf6...81a9739108bd3959b4b1331d3a2833a18bc2b2b4,5,139,24,163,7,2014-09-02 18:30:45,2014-09-02 18:30:45
81a9739108bd3959b4b1331d3a2833a18bc2b2b4...a054f8eb29561873f0ae678e579d99f690d3032d,6,18,0,18,6,2014-09-03 10:36:17,2014-09-03 10:36:17
a054f8eb29561873f0ae678e579d99f690d3032d...4bd396a9bfd72dd17b26e91679e6fcc8d627cb1c,1,1,1,2,1,2014-09-03 11:43:01,2014-09-01 14:44:19
4bd396a9bfd72dd17b26e91679e6fcc8d627cb1c...68c14d69232d2b9dac3c56c0661e08a39f0b5115,1,3,12,15,6,2014-09-03 13:36:32,2014-09-01 12:07:45
68c14d69232d2b9dac3c56c0661e08a39f0b5115...7343c77cdba04e3b7ea6041285fe9b1e9f4fdaeb,3,8,5,13,8,2014-09-03 13:36:54,2014-09-01 14:44:07
7343c77cdba04e3b7ea6041285fe9b1e9f4fdaeb...73631bbcc83888ec61a0aebf4eff3904e9384a2e,3,100,8,108,8,2014-09-03 13:36:54,2014-09-01 14:44:57
73631bbcc83888ec61a0aebf4eff3904e9384a2e...9b8837b3554cb38fe9412922f064529329f5fff7,3,6,2,8,4,2014-09-03 21:24:50,2014-09-03 21:24:50
9b8837b3554cb38fe9412922f064529329f5fff7...029cfc12a0736b0b03d0101d24b8a1a3023137a5,6,232,20,252,17,2014-09-03 22:16:16,2014-08-22 20:51:53
029cfc12a0736b0b03d0101d24b8a1a3023137a5...86bb7fa5cdc2f0492ecc2972c00b6805b6be8e9c,1,56,0,56,1,2014-09-04 22:18:48,2014-09-04 15:10:44
86bb7fa5cdc2f0492ecc2972c00b6805b6be8e9c...176f0bd3dfd58faf1675851cd2029e05d302f1fb,6,52,30,82,15,2014-09-05 16:19:32,2014-08-14 03:15:24
176f0bd3dfd58faf1675851cd2029e05d302f1fb...de9a444ab4c1219d36578b9594aee3d039564c3e,1,1,1,2,2,2014-09-05 16:33:49,2014-08-22 21:57:46
de9a444ab4c1219d36578b9594aee3d039564c3e...1e99486cc83d0e3c41de37c924150f2853870902,2,6,0,6,2,2014-09-05 16:33:58,2014-09-04 02:23:03
1e99486cc83d0e3c41de37c924150f2853870902...b33a47ef473c169be2f11a2ee434f0f89ea1d106,3,15,2,17,7,2014-09-05 16:34:15,2014-08-22 22:31:44
b33a47ef473c169be2f11a2ee434f0f89ea1d106...8e6706ea95c81534357c84237f561a0a8073c38e,1,7,2,9,2,2014-09-05 16:34:27,2014-08-22 22:33:04
8e6706ea95c81534357c84237f561a0a8073c38e...150d6f124942617428c36728c023341c83166449,3,15,10,25,10,2014-09-05 16:34:37,2014-08-22 22:57:45
150d6f124942617428c36728c023341c83166449...299cf84490a2f28ffdc4c82e4fb7078ac591b6d3,1,0,1,1,1,2014-09-05 16:34:43,2014-08-22 23:25:40
299cf84490a2f28ffdc4c82e4fb7078ac591b6d3...06526a2a93794a973b01514ce43fcd40b911e143,3,6,22,28,5,2014-09-05 16:54:10,2014-09-05 15:33:28
06526a2a93794a973b01514ce43fcd40b911e143...bf5e2f246eff55dfc33318f0ffb4572a56f7645a,3,95,2,97,6,2014-09-09 16:15:50,2014-09-05 14:56:55
bf5e2f246eff55dfc33318f0ffb4572a56f7645a...f9ce97084cbaf90d0669c7cd829da34232b75bdb,44,430,356,786,127,2014-09-09 23:52:10,2014-09-09 21:03:08
f9ce97084cbaf90d0669c7cd829da34232b75bdb...6f07d2fa1bbc55d0159764dfe8b0d8c93b0e1990,1,1,1,2,1,2014-09-09 23:52:45,2014-05-12 03:38:47
6f07d2fa1bbc55d0159764dfe8b0d8c93b0e1990...b8a8e5558d74333e141e3a72730eb72c3463c3ef,2,20,10,30,10,2014-09-09 23:52:45,2014-05-14 09:25:57
b8a8e5558d74333e141e3a72730eb72c3463c3ef...8d9493c315aad5487b5e2a0e48c33ceefb590f2e,2,25,1,26,3,2014-09-09 23:52:45,2014-05-23 14:01:17
8d9493c315aad5487b5e2a0e48c33ceefb590f2e...f3836af2f8029274fc793bd55e53ef23ba8b4ec2,1,41,2,43,6,2014-09-09 23:52:45,2014-07-21 18:12:11
f3836af2f8029274fc793bd55e53ef23ba8b4ec2...630f0c4660f9c9fb7c6b1f032e92fc1ca238f0e9,1,12,1,13,1,2014-09-09 23:52:46,2014-07-24 09:31:45
630f0c4660f9c9fb7c6b1f032e92fc1ca238f0e9...11d57a535c21a64885808afd41612406ff854c69,8,170,12,182,18,2014-09-15 13:42:20,2014-09-13 22:37:34
11d57a535c21a64885808afd41612406ff854c69...174f7d2820dcb12f1b4b511840416a03cd65b9cf,2,6,1,7,6,2014-09-16 11:32:04,2014-08-06 14:53:59
174f7d2820dcb12f1b4b511840416a03cd65b9cf...21e60643b0795fe7b6a46ff29d73df60e6a7c9f5,4,82,0,82,7,2014-09-16 19:28:47,2014-08-22 13:09:24
5a8de857f0bd05941f54b20415ab7c374c4b1720...aa56d9d35405a56b8478c0a83106ffa4ada903db,1,106,0,106,1,2014-01-01 00:24:58,2014-01-01 00:24:58
7ca5af87a0662a1f8dca2391ae90a6342592302b...468fb547bb29e71535c09631a54c4e106b313a43,1,10,3,13,3,2014-09-17 19:19:05,2014-09-12 09:25:15
468fb547bb29e71535c09631a54c4e106b313a43...378d9723f25cb5db88d2d0c74190800606d120f1,1,3,0,3,3,2014-09-17 21:16:29,2014-09-12 10:07:05
378d9723f25cb5db88d2d0c74190800606d120f1...03e93526e6b38279c04d69ddf98c493342730e85,2,19,0,19,2,2014-09-17 21:26:35,2014-08-15 16:25:38
03e93526e6b38279c04d69ddf98c493342730e85...c6155454163a439bf9c74a876f9ac201673b20fc,1,1,1,2,1,2014-09-17 21:40:01,2014-09-17 21:40:01
c6155454163a439bf9c74a876f9ac201673b20fc...cb4ed3c78fd6c795c29ff67df19d358a90c777cc,3,18,24,42,13,2014-09-17 22:31:47,2014-09-17 22:21:32
cb4ed3c78fd6c795c29ff67df19d358a90c777cc...9c992bdb752063913067feb533cd3db37d2e4d01,1,79,0,79,1,2014-09-18 21:06:21,2014-09-02 17:52:45
9c992bdb752063913067feb533cd3db37d2e4d01...30bd7b672cbb7ef9a400eb34f6d5c778991e1b3c,4,178,1,179,10,2014-09-18 21:13:06,2014-09-04 16:02:04
30bd7b672cbb7ef9a400eb34f6d5c778991e1b3c...d66adf0c85fa8b26c7f72c5bd030fbcb79dbb0bb,1,1,1,2,1,2014-09-19 23:55:25,2014-09-19 05:09:24
d66adf0c85fa8b26c7f72c5bd030fbcb79dbb0bb...4c9b30db675ba3094a733e2691e968b658105334,1,1,5,6,2,2014-09-20 00:11:10,2014-09-19 15:14:37
4c9b30db675ba3094a733e2691e968b658105334...64d6de9f34abe63bf7602ab0b55ff268cf480e45,2,61,0,61,2,2014-09-23 07:54:26,2014-09-23 00:21:40
64d6de9f34abe63bf7602ab0b55ff268cf480e45...6e08bb94e8b1aaf913cf88106cb59f9d2ae85925,3,51,0,51,8,2014-09-23 09:54:03,2014-09-12 12:27:22
6e08bb94e8b1aaf913cf88106cb59f9d2ae85925...c5f5d4cd11c2aec74fa03985405122d1ecb06f69,110,6370,1680,8050,494,2014-09-23 15:18:41,2014-09-19 17:37:55
c5f5d4cd11c2aec74fa03985405122d1ecb06f69...7fd35e6ea43ece7ef40d50820a80d798eceaa362,2,13,2,15,9,2014-09-23 20:19:39,2014-09-23 20:19:39
7fd35e6ea43ece7ef40d50820a80d798eceaa362...7c3c51b8ff3d41a2714e6d3a1379f2357b5bebc7,1,4,2,6,2,2014-09-24 00:10:36,2014-09-23 20:19:31
7c3c51b8ff3d41a2714e6d3a1379f2357b5bebc7...4dbb84fc52645cd4f1ab6983f5fc268d9749229a,2,3,1,4,3,2014-09-24 10:02:40,2014-09-23 09:49:42
4dbb84fc52645cd4f1ab6983f5fc268d9749229a...2f7234d89c3b7e17d6cf341ab12aaffebb337470,1,32,0,32,1,2014-09-24 16:48:41,2014-09-24 16:36:25
2f7234d89c3b7e17d6cf341ab12aaffebb337470...f773fb41cc2a59f981146763e9f378f9a8586714,1,5,0,5,1,2014-09-24 21:17:42,2014-09-24 21:13:58
f773fb41cc2a59f981146763e9f378f9a8586714...efa47e593d0fe63127b39b5c0ef67ac534af5eb4,1,72,0,72,1,2014-09-24 22:48:55,2014-09-13 09:06:28
efa47e593d0fe63127b39b5c0ef67ac534af5eb4...b26dd4e5ab9192bad72b9dc61fa4ad2d8f215da2,2,33,1,34,2,2014-09-24 23:06:46,2014-09-17 18:54:24
b26dd4e5ab9192bad72b9dc61fa4ad2d8f215da2...9fad8958df671c0e894506ef59b4c781c3dfb349,556,13939,10696,24635,3956,2014-09-25 00:15:10,2014-09-24 21:41:07
9fad8958df671c0e894506ef59b4c781c3dfb349...fd896d5acfe0832cfb211d861f78845bcad4f301,2,170,1,171,2,2014-09-25 00:15:10,2014-09-24 21:46:41
fd896d5acfe0832cfb211d861f78845bcad4f301...8e4fc88c797857c55c84558708fa7e72bb7e4eca,1,2,2,4,2,2014-09-25 00:15:10,2014-09-25 00:14:23
8e4fc88c797857c55c84558708fa7e72bb7e4eca...51b6b6844e9156ab84ae9d0f4592e09f994060b2,24,183,183,366,156,2014-09-25 18:26:15,2014-09-24 22:41:31
51b6b6844e9156ab84ae9d0f4592e09f994060b2...f3473d7db696f78b284c7a874ba33ec5e2b91309,1,4,1,5,2,2014-09-25 19:17:11,2014-09-14 15:40:49
f3473d7db696f78b284c7a874ba33ec5e2b91309...9d957747222da95e7c55142d25f59466c07857dc,2,61,24,85,15,2014-09-25 22:13:14,2014-09-20 04:07:33
9d957747222da95e7c55142d25f59466c07857dc...2122a77f5177a039b80403a3772fdd14323e158a,4,87,41,128,32,2014-09-26 04:21:36,2014-09-24 09:42:33
2122a77f5177a039b80403a3772fdd14323e158a...de312cfd7c21c551d497af49aa981e07ed2f5ba3,1,9,14,23,8,2014-09-29 17:13:35,2014-09-29 17:13:35
de312cfd7c21c551d497af49aa981e07ed2f5ba3...979d0ca874df0383311ca06f154f6965074196ee,2,25,10,35,9,2014-09-29 19:32:42,2014-09-29 19:32:42
979d0ca874df0383311ca06f154f6965074196ee...f4df80584d57904edf72c2f71f7df644ba91d2f5,1,1,1,2,1,2014-09-29 20:42:41,2014-09-25 03:19:22
f4df80584d57904edf72c2f71f7df644ba91d2f5...734fb49a2af580f2d9c97a0bdd82ad3e6a1f64a2,1,6,6,12,6,2014-09-29 20:47:17,2014-09-18 12:10:53
734fb49a2af580f2d9c97a0bdd82ad3e6a1f64a2...f2a78de6ec134f4050531ba6a52dee47e0aee165,20,99,82,181,68,2014-09-29 23:32:34,2014-09-29 23:32:34
f2a78de6ec134f4050531ba6a52dee47e0aee165...57ed3daebfe4700b14cd551f50240f1a634dbd64,4,91,53,144,16,2014-09-30 00:36:03,2014-09-30 00:29:59
57ed3daebfe4700b14cd551f50240f1a634dbd64...1781c8b85bbabc4c5c1e054bd5c50903cc0eb47b,1,2,1,3,2,2014-10-01 00:00:29,2014-09-24 05:14:48
1781c8b85bbabc4c5c1e054bd5c50903cc0eb47b...95726b0fce0ae1ae60591f0a535515e8dabfd6df,1,4,2,6,2,2014-10-01 18:45:23,2014-09-23 14:51:33
95726b0fce0ae1ae60591f0a535515e8dabfd6df...ac2857b12cd819b68405b15c3f8e95e48bcc32d8,16,1605,20,1625,32,2014-10-01 19:16:51,2014-09-05 05:03:24
ac2857b12cd819b68405b15c3f8e95e48bcc32d8...b705b73e46193c7691be40b732330a49affacedb,3,21,3,24,3,2014-10-01 19:23:01,2014-09-25 16:59:18
b705b73e46193c7691be40b732330a49affacedb...8dc6be1747d3a48af56f89e973ecb5665f89a2e1,6,252,0,252,9,2014-10-01 21:42:05,2014-09-22 16:19:50
8dc6be1747d3a48af56f89e973ecb5665f89a2e1...862cc28183b03f0e1a67b052b5c8250a3e2e8995,3,81,17,98,24,2014-10-01 22:00:02,2014-09-22 20:21:11
862cc28183b03f0e1a67b052b5c8250a3e2e8995...e9ca7b9d8de68e13d40698f34145e2a0428aa9d7,2,99,41,140,10,2014-10-01 22:59:55,2014-10-01 22:42:02
e9ca7b9d8de68e13d40698f34145e2a0428aa9d7...83d7d9e6d81fc35764a9000b6d7b17a0e7d8cc92,3,278,2,280,7,2014-10-03 08:31:20,2014-10-02 23:24:58
83d7d9e6d81fc35764a9000b6d7b17a0e7d8cc92...cb97bcd6f982b35a6fe4d41d884354f72905365d,2,13,0,13,3,2014-10-03 17:12:00,2014-10-01 02:44:39
cb97bcd6f982b35a6fe4d41d884354f72905365d...87ce067636a6ea52cd978c68f9e837d5d115b4f0,1,1,0,1,1,2014-10-07 00:24:21,2014-09-28 23:03:25
87ce067636a6ea52cd978c68f9e837d5d115b4f0...8392e8cdfb71e8cc03e110f7b30ed104b3b136bd,1,2,0,2,1,2014-10-07 00:24:29,2014-03-30 10:34:45
8392e8cdfb71e8cc03e110f7b30ed104b3b136bd...640ad632e3bf04fe07fa2b9dc3ca940c2e8d0261,2,32,4,36,4,2014-10-07 00:25:25,2014-09-26 15:59:39
640ad632e3bf04fe07fa2b9dc3ca940c2e8d0261...f769d133b7612edb8115d53d28fad7aab5387580,3,26,9,35,7,2014-10-07 22:17:44,2014-10-04 00:42:37
f769d133b7612edb8115d53d28fad7aab5387580...0a22ed4cc8dded1404c1999939fef402523d1117,1,73,68,141,54,2014-10-07 22:24:02,2014-10-04 05:41:05
0a22ed4cc8dded1404c1999939fef402523d1117...f04f3a0d012603fb7bbc3e1c05a5a6cd01ab4010,3,95,0,95,3,2014-10-08 00:04:10,2014-10-07 23:32:05
f04f3a0d012603fb7bbc3e1c05a5a6cd01ab4010...6e4bd494a50c3dfd432a5a6dd4a13556443dfa79,1,9,9,18,8,2014-10-08 06:30:42,2014-10-03 05:53:15
6e4bd494a50c3dfd432a5a6dd4a13556443dfa79...4809c7aa4f84385ba358d1947203fbeba8555b76,2,11,10,21,11,2014-10-08 08:06:06,2014-10-08 08:06:06
4809c7aa4f84385ba358d1947203fbeba8555b76...7b4a540422f2155f0e57d963be69960c1325474d,1,2,1,3,1,2014-10-08 08:13:43,2014-10-08 08:13:43
7b4a540422f2155f0e57d963be69960c1325474d...573e6afc090d9bf194aef307de4b4bfe59c5867f,1,2,2,4,3,2014-10-08 08:19:25,2014-10-02 08:20:51
573e6afc090d9bf194aef307de4b4bfe59c5867f...bdc2ea4d52bd4a9871970ec2bfbf80292ca6e8e8,3,8,8,16,8,2014-10-08 08:34:46,2014-10-08 08:34:46
bdc2ea4d52bd4a9871970ec2bfbf80292ca6e8e8...6462519d3cb7c34671dddb3cedd8441699574f35,2,43,24,67,8,2014-10-08 09:24:32,2014-10-08 09:08:54
6462519d3cb7c34671dddb3cedd8441699574f35...a2a3fd48934f36d94575dd33d2a2cb732f937f77,1,8,0,8,2,2014-10-08 11:32:55,2014-10-06 12:23:01
a2a3fd48934f36d94575dd33d2a2cb732f937f77...9116b240c924d37627313416b7ee038d0580afbc,1662,245110,74650,319760,28287,2014-10-08 11:44:38,2014-09-29 09:20:04
9116b240c924d37627313416b7ee038d0580afbc...270e998c90323785ef5da32acc247b2963afd0b8,5,34,7,41,8,2014-10-08 11:44:40,2014-10-02 04:16:24
270e998c90323785ef5da32acc247b2963afd0b8...8efcc7f456f863cb04724c7b35fb935a8c441fe6,1,5,9,14,5,2014-10-08 11:44:40,2014-09-29 09:20:50
8efcc7f456f863cb04724c7b35fb935a8c441fe6...7a0cfe9b116c6b5d56f7412d6ea71f5a8d8440e2,17,1009,93,1102,63,2014-10-08 11:44:40,2014-10-04 14:44:39
7a0cfe9b116c6b5d56f7412d6ea71f5a8d8440e2...42ecd48c7f68f204a4986477089b496bf994ee6e,1,23,5,28,2,2014-10-08 11:44:40,2014-10-04 14:44:46
42ecd48c7f68f204a4986477089b496bf994ee6e...685ac099e9d8085c363a51a15c718d160a6dcd5c,9,44,35,79,17,2014-10-08 11:44:40,2014-10-08 10:34:51
685ac099e9d8085c363a51a15c718d160a6dcd5c...d87480beb29b764ba37cd983b594ad25a406a4c7,2,32,4,36,5,2014-10-08 11:44:40,2014-10-08 10:35:07
d87480beb29b764ba37cd983b594ad25a406a4c7...1a4a189578944f62b3dfb6f4fc8dabe20a7535ee,2,21,0,21,2,2014-10-08 22:38:46,2014-10-08 22:38:46
1a4a189578944f62b3dfb6f4fc8dabe20a7535ee...47f119cabfc2eb7e524bc6584fd01328f9ce95d1,1,4,4,8,3,2014-10-08 23:48:31,2014-10-04 14:50:50
47f119cabfc2eb7e524bc6584fd01328f9ce95d1...61dd74bc5dfbab6b4db50ea1dd1cc7b7d2867a30,1,2,2,4,1,2014-10-09 16:38:17,2014-10-08 18:30:01
61dd74bc5dfbab6b4db50ea1dd1cc7b7d2867a30...db7df57e0342a5a6922bd2700ffc78c5a99841c8,2,1,3,4,2,2014-10-09 18:46:58,2014-10-09 17:15:05
db7df57e0342a5a6922bd2700ffc78c5a99841c8...874dd590cf385baa534556eadee0fa5c2f985519,2,8,14,22,10,2014-10-09 23:48:59,2014-10-09 20:07:50
874dd590cf385baa534556eadee0fa5c2f985519...d22637c36c0749baaf50e05fea010fbc3a698a74,1,12,3,15,3,2014-10-10 13:14:47,2014-10-10 13:14:47
d22637c36c0749baaf50e05fea010fbc3a698a74...f6e574018090ed4d63596b8a3bb614f8f48b6267,3,9,3,12,5,2014-10-20 18:48:00,2014-09-17 10:59:59
f6e574018090ed4d63596b8a3bb614f8f48b6267...6a68d646297b5264fc3c0672fc58dcbf64523bdc,1,5,4,9,1,2014-10-25 21:27:23,2014-10-25 21:27:23
6a68d646297b5264fc3c0672fc58dcbf64523bdc...15aa47e2618a565aba0c1ca29ef63f269f26dc74,1,7,1,8,3,2014-10-27 19:58:05,2014-10-21 09:00:37
15aa47e2618a565aba0c1ca29ef63f269f26dc74...c2b4f4809b8c30537b08f2dc76f798ea7a225907,3,80,4,84,6,2014-10-27 21:11:20,2014-10-18 01:45:40
c2b4f4809b8c30537b08f2dc76f798ea7a225907...849fcdeca05a67e656f9f2c82eef194ff6f97231,2,15,1,16,2,2014-10-30 22:49:02,2014-10-28 12:32:07
849fcdeca05a67e656f9f2c82eef194ff6f97231...f65a5cbcde51ef7da0ff5617dcab1a164b9a217b,2,8,2,10,3,2014-11-05 08:33:00,2014-10-31 22:15:12
f65a5cbcde51ef7da0ff5617dcab1a164b9a217b...3589a62104eac1daae782ab479bec09f4df4dc9a,2,8,3,11,4,2014-11-05 18:35:42,2014-10-09 20:01:27
3589a62104eac1daae782ab479bec09f4df4dc9a...272aa589af50566a20a491910d4dc40bb3692102,1,13,1,14,1,2014-11-05 18:35:42,2014-09-24 01:59:35
272aa589af50566a20a491910d4dc40bb3692102...28ae70ebad8debd8aa7b521a693aa3de89ad84d6,715,18443,6525,24968,3061,2014-11-05 18:35:43,2014-11-04 23:08:12
28ae70ebad8debd8aa7b521a693aa3de89ad84d6...ce112c27c636ba17129d6061f8db636a80faeb48,32,921,150,1071,143,2014-11-06 00:49:57,2014-10-20 22:45:30
ce112c27c636ba17129d6061f8db636a80faeb48...a5f1307e45305cb7cf41e0e99cf1df74730cad6c,1,5,5,10,5,2014-11-06 00:50:58,2014-10-17 07:31:23
a5f1307e45305cb7cf41e0e99cf1df74730cad6c...e46cbaa06d6f69ae37c56d9ed1b854fbea779e30,1,1,1,2,1,2014-11-06 00:51:12,2014-10-17 07:31:59
e46cbaa06d6f69ae37c56d9ed1b854fbea779e30...5845a6bcd5b36168bdddeb85da8d8d9d36de7642,9,4,65,69,13,2014-11-07 21:44:09,2014-11-07 21:44:09
5845a6bcd5b36168bdddeb85da8d8d9d36de7642...03bae7bded4cfea0a5ca7c77fcfd1fb531eafe86,1,0,2,2,1,2014-11-07 22:33:05,2014-11-07 22:24:12
03bae7bded4cfea0a5ca7c77fcfd1fb531eafe86...d8a3c4ab2aba94f1faac36e51220b270f9b88227,1,1,5,6,1,2014-11-10 05:39:24,2014-11-10 05:09:58
d8a3c4ab2aba94f1faac36e51220b270f9b88227...fd2226894ace84c622b0ca228346da58b20e2949,1,6,0,6,1,2014-11-10 05:46:35,2014-06-16 22:05:58
fd2226894ace84c622b0ca228346da58b20e2949...0339446cf736e2b741794a7023a46243306b2bef,1,3,0,3,1,2014-11-12 00:14:59,2014-10-04 06:10:29
0339446cf736e2b741794a7023a46243306b2bef...ea4dc7d44425aba111105c00ced031f680a65820,1,30,32,62,15,2014-11-12 00:18:22,2014-11-06 03:09:43
ea4dc7d44425aba111105c00ced031f680a65820...855b1c98caf60a1b19d6d6bb9c9cb160d338f7f0,1,2,2,4,1,2014-11-13 19:25:55,2014-08-05 01:00:55
855b1c98caf60a1b19d6d6bb9c9cb160d338f7f0...00d7b13a18dcf39cb7e7ace87c5c7b43d8024f41,2,13,1,14,3,2014-11-14 03:58:52,2014-09-09 02:22:37
00d7b13a18dcf39cb7e7ace87c5c7b43d8024f41...f6556b678d93eb7a13ab5b67cc0524bed2289f85,2,14,2,16,4,2014-11-16 01:01:13,2014-11-01 10:07:03
f6556b678d93eb7a13ab5b67cc0524bed2289f85...743a009bad64c4302a724f70c42d73601a16aed4,2,39,51,90,12,2014-11-17 20:15:54,2014-10-08 21:36:21
743a009bad64c4302a724f70c42d73601a16aed4...0fef2500900aa115271b456c76633ce47765c5d8,2,48,0,48,2,2014-11-17 20:34:37,2014-11-16 02:33:20
0fef2500900aa115271b456c76633ce47765c5d8...adc0206de9a405cd904fb79bf4db027143f82682,1,4,4,8,4,2014-11-17 23:35:00,2013-02-15 22:21:48
adc0206de9a405cd904fb79bf4db027143f82682...6a6782343cdcb9ccab413509f2fa33c5508df12a,1,1,1,2,1,2014-11-19 22:18:50,2013-08-14 23:15:49
6a6782343cdcb9ccab413509f2fa33c5508df12a...4dc8b26bbefb21fd313b0c003cbc9102fb1c2205,1,1,1,2,1,2014-11-20 23:38:29,2014-11-20 18:35:30
4dc8b26bbefb21fd313b0c003cbc9102fb1c2205...6a90a060023dac4fc827613243e496237403f29f,3,517,484,1001,74,2014-11-21 00:10:55,2013-06-11 00:09:54
6a90a060023dac4fc827613243e496237403f29f...2d17193f20930bfe594d7008fe5c08f813f03c7b,3,247,11,258,13,2014-11-21 00:21:11,2014-04-08 21:48:24
2d17193f20930bfe594d7008fe5c08f813f03c7b...9d9ed61c5a97562b93a2326f33922783ed509d47,26,269,222,491,49,2014-11-26 20:08:36,2014-11-21 14:43:12
9d9ed61c5a97562b93a2326f33922783ed509d47...e0a0e913c7b340e756a6728226eb5c638f76be05,1,23,41,64,9,2014-11-26 20:16:56,2014-11-21 08:22:07
e0a0e913c7b340e756a6728226eb5c638f76be05...bf3e0f417bbf4ba749730a76dd36a3e59d44da3e,3,10,0,10,4,2014-11-26 20:39:02,2014-11-18 09:30:27
bf3e0f417bbf4ba749730a76dd36a3e59d44da3e...69904c8a7838ce4ef4023bb4b980bf87531d74ad,12,45,23,68,21,2014-11-26 23:56:48,2014-11-26 21:37:41
69904c8a7838ce4ef4023bb4b980bf87531d74ad...0308ad2ce53f73368f265d5e7ee4c0e9f07600a6,1,1,1,2,1,2014-11-26 23:57:21,2014-11-26 21:50:19
0308ad2ce53f73368f265d5e7ee4c0e9f07600a6...cb8cadbe6245ffc94948194240e4e5f9fbffd5e7,1,1,1,2,1,2014-11-28 12:11:36,2014-11-28 12:11:36
cb8cadbe6245ffc94948194240e4e5f9fbffd5e7...304c0b43aa88fdeb13ac4607a89ff096b87c8b86,1,2,1,3,1,2014-11-28 12:12:14,2014-11-17 15:44:19
304c0b43aa88fdeb13ac4607a89ff096b87c8b86...c131c1f92043ed8cfaf7474178d54c7bc4a74226,2,67,1,68,10,2014-12-01 23:07:43,2014-09-15 17:00:22
c131c1f92043ed8cfaf7474178d54c7bc4a74226...d312b6d15c69cf4c438ed7d884e6396c481a57f6,3,104,13,117,12,2014-12-02 18:55:22,2014-11-20 15:46:38
d312b6d15c69cf4c438ed7d884e6396c481a57f6...c4f6c22c2033038c3629bc5c48f0f2346d211378,1,2,2,4,1,2014-12-03 01:10:40,2014-12-03 01:10:40
c4f6c22c2033038c3629bc5c48f0f2346d211378...61204720361824881aefd64f5bccda7d7be6617a,2,27,14,41,11,2014-12-03 01:24:18,2014-11-27 02:02:25
61204720361824881aefd64f5bccda7d7be6617a...4815873bb52f19e670d9b541e95d468c09b87105,1,1,1,2,1,2014-12-03 06:35:36,2014-07-31 08:34:51
4815873bb52f19e670d9b541e95d468c09b87105...e67db0191db01aca6c25a36b05485026cfb309bb,1,1,1,2,1,2014-12-04 01:19:07,2014-12-04 01:16:31
e67db0191db01aca6c25a36b05485026cfb309bb...df3a2b2cf21274fe7afc19d14ec0259b964e13f7,1,32,14,46,16,2014-12-04 16:22:14,2014-11-07 13:15:24
df3a2b2cf21274fe7afc19d14ec0259b964e13f7...0674cbaceb81ba1130355aa7eb8e6389824e3cc4,2,21,0,21,2,2014-12-04 16:22:15,2014-11-07 13:31:39
0674cbaceb81ba1130355aa7eb8e6389824e3cc4...b6559553a42b05ad793e1ea755e252b230be6212,33,8,2580,2588,84,2014-12-05 12:33:26,2014-11-12 00:48:34
b6559553a42b05ad793e1ea755e252b230be6212...2593c1413155a42604c53327b9c2b23b017f0dfa,4,169,132,301,5,2014-12-05 12:35:44,2014-11-12 23:58:23
2593c1413155a42604c53327b9c2b23b017f0dfa...42df679c458b3edc2d4754baaf3b16ba015a1dd6,4,55,187,242,26,2014-12-05 12:37:53,2014-11-13 00:08:12
42df679c458b3edc2d4754baaf3b16ba015a1dd6...b1e9d330aa603e40430724f1c834d15fd66a55f2,1,1,1,2,1,2014-12-05 12:52:19,2014-11-13 00:35:48
b1e9d330aa603e40430724f1c834d15fd66a55f2...5962dbef49ae6dccc98004b6b955c34336ccbbf5,17,404,159,563,134,2014-12-05 12:52:42,2014-08-26 19:21:39
5962dbef49ae6dccc98004b6b955c34336ccbbf5...add955e6b831970fae6c9f693b64cb1f4aeb999d,10,12,12,24,12,2014-12-05 12:55:26,2014-11-14 23:47:34
add955e6b831970fae6c9f693b64cb1f4aeb999d...1293f0a228a3a01863896c82f6734aaaf93bd16b,2,51,22,73,6,2014-12-05 12:56:45,2014-11-15 00:15:06
1293f0a228a3a01863896c82f6734aaaf93bd16b...419f18d2e245405b839e7441e5f59bc08e9c8d6c,12,89,38,127,43,2014-12-05 12:57:01,2014-11-17 20:54:03
419f18d2e245405b839e7441e5f59bc08e9c8d6c...709fc160e5204f9a926c2867a8ee77e55d6c30aa,6,167,2,169,24,2014-12-05 13:00:45,2014-11-20 19:27:06
709fc160e5204f9a926c2867a8ee77e55d6c30aa...fe6d5be6b40bde07a5509f808576f7772b0fb4af,1,6,1,7,1,2014-12-05 13:34:03,2014-12-05 13:34:03
fe6d5be6b40bde07a5509f808576f7772b0fb4af...9653c4b8c7e58cfc17c4c759b2bbcb914b27fd95,1,11,8,19,8,2014-12-05 18:59:40,2014-12-02 03:14:57
9653c4b8c7e58cfc17c4c759b2bbcb914b27fd95...70195acbe36f56b87d697a16b5bfc2699c89bac5,2,4,4,8,4,2014-12-05 20:30:40,2014-10-19 18:54:48
70195acbe36f56b87d697a16b5bfc2699c89bac5...4dc660e164417e0a1bc86eadd825b41d7abb053f,1,3,16,19,4,2014-12-09 20:06:33,2014-12-03 06:55:53
4dc660e164417e0a1bc86eadd825b41d7abb053f...20a7088d9c62c43fedf9ab077fbbeae92c7e6617,52,356,121,477,128,2014-12-10 01:03:50,2014-12-09 20:01:35
20a7088d9c62c43fedf9ab077fbbeae92c7e6617...8708c7abe59cbcaacc1d59cbc268f2a1d3ba3061,1,2,1,3,2,2014-12-10 11:58:32,2014-12-10 11:58:32
8708c7abe59cbcaacc1d59cbc268f2a1d3ba3061...946cec7b65716f4781808f5ae3b3345f6d8b6c6d,2,3,2,5,3,2014-12-11 18:31:06,2014-10-14 10:07:19
946cec7b65716f4781808f5ae3b3345f6d8b6c6d...4bba87050c2b8aa801d982e93ea767b3abdc2f17,1,35,0,35,1,2014-12-11 18:32:56,2014-12-09 18:47:49
4bba87050c2b8aa801d982e93ea767b3abdc2f17...5b9e5bdd03ef5c53f370e414c5a964fccb4ac030,1,9,0,9,3,2014-12-16 06:25:58,2014-07-26 14:04:46
5b9e5bdd03ef5c53f370e414c5a964fccb4ac030...6f6a97958e8723b4b4a3ccf352252b36cf7a0d85,5,282,8,290,15,2014-12-16 23:11:50,2014-09-09 16:30:15
6f6a97958e8723b4b4a3ccf352252b36cf7a0d85...e93ff4f0ce1b6e9077dfa64598006478276325b2,1,6,0,6,1,2014-12-17 21:00:48,2013-11-04 14:59:25
e93ff4f0ce1b6e9077dfa64598006478276325b2...93533e98f76c2c9e577af3352b4eb709791f4d1e,1,10,10,20,8,2014-12-17 22:13:20,2014-11-11 11:06:55
93533e98f76c2c9e577af3352b4eb709791f4d1e...91586661c983f45d650644451df73c8649a8d459,3,50,22,72,21,2014-12-18 17:39:05,2014-12-04 20:00:23
91586661c983f45d650644451df73c8649a8d459...890baa03a86de0bf8eb415126b4400195ad61750,1,5,0,5,2,2014-12-19 21:02:47,2014-12-10 03:20:11
890baa03a86de0bf8eb415126b4400195ad61750...6a03fce16eaa4ec1085463d94734d40b370f3ea4,1,2,0,2,1,2014-12-30 22:00:19,2014-10-28 12:08:37
6a03fce16eaa4ec1085463d94734d40b370f3ea4...a30839576c65b88e93bc915ae97b59874afde8ac,10,616,59,675,62,2015-01-03 00:51:53,2014-11-13 01:13:14
a30839576c65b88e93bc915ae97b59874afde8ac...8cfbeed27ab98dffff68c13188d4f3dc1a506c3c,1,1,0,1,1,2015-01-03 01:31:20,2015-01-03 01:16:47
8cfbeed27ab98dffff68c13188d4f3dc1a506c3c...b636ba8186d191c52ee36f2f2b1aebbbb4d95575,3,65,81,146,21,2015-01-04 01:02:27,2015-01-03 23:26:26
b636ba8186d191c52ee36f2f2b1aebbbb4d95575...372a2f56bed341a23c435c5a94fbb77dbbd6c600,1,1,1,2,1,2015-01-05 10:24:40,2015-01-05 10:20:31
372a2f56bed341a23c435c5a94fbb77dbbd6c600...c8ef97e4d9ef2546d8629c88a9cf4419fc188f22,5,8,282,290,15,2015-01-07 22:29:11,2015-01-06 20:48:06
c8ef97e4d9ef2546d8629c88a9cf4419fc188f22...1fad3730c2d6130c13b46ad78ded808fe9bb4c10,1,8,2,10,3,2015-01-08 23:41:51,2015-01-08 15:32:55
7c0419730b237dbfa0ec4e6fb33a99ff01825a8f...25702abc5638bbecffa92e8349d2a871a5f592c9,1,12,12,24,6,2014-10-01 05:07:38,2014-09-24 03:08:35
25702abc5638bbecffa92e8349d2a871a5f592c9...cfcb1de130867197cbc9c6012b7e84e08e53d032,1,3,3,6,2,2014-10-09 17:02:28,2014-10-02 16:00:40
aa56d9d35405a56b8478c0a83106ffa4ada903db...b922b5e90d2c14dd332b95827c2533e083df7e55,2,76,1,77,2,2014-01-05 15:44:45,2014-01-03 11:37:16
b922b5e90d2c14dd332b95827c2533e083df7e55...1be93659303c89c4cae2b7974e41c8fbeb7ea108,215,618,432,1050,254,2014-01-07 01:02:07,2014-01-07 01:02:07
1be93659303c89c4cae2b7974e41c8fbeb7ea108...30b3bc2f7ce122636acb780129a0d528c12f0be7,11,115,6,121,13,2014-01-07 22:05:58,2014-01-07 22:05:24
30b3bc2f7ce122636acb780129a0d528c12f0be7...fc7e217a3001bccc15a8a2026d4d6e60d73e72f2,1,1,1,2,1,2014-01-08 19:39:02,2014-01-06 14:29:24
fc7e217a3001bccc15a8a2026d4d6e60d73e72f2...270c2deb84b04b508c9d90f58684ee5bf7b3dbca,2,40,1,41,2,2014-01-09 22:01:53,2014-01-09 21:33:51
270c2deb84b04b508c9d90f58684ee5bf7b3dbca...56913d2cde43ba970a305e919472bee6cdea0356,1,1,1,2,1,2014-01-10 16:42:34,2014-01-01 21:26:14
56913d2cde43ba970a305e919472bee6cdea0356...196184d332ba2d2defc56ad0b37653659a7d3ec0,1,3,1,4,1,2014-01-10 23:32:08,2012-11-09 11:30:05
196184d332ba2d2defc56ad0b37653659a7d3ec0...8753bb38596f7148d0cf60b8c1ccad7db4eef609,1,5,2,7,2,2014-01-12 18:04:21,2014-01-12 18:04:21
8753bb38596f7148d0cf60b8c1ccad7db4eef609...1b74892807887fe89828ab874e9ce6b2831e7d54,1,8,3,11,1,2014-01-13 21:16:25,2014-01-13 21:16:25
1fad3730c2d6130c13b46ad78ded808fe9bb4c10...29449349da5ef7e23689396c21bae003d81e0081,5,213,0,213,9,2015-01-13 00:59:34,2014-11-11 22:43:18
885f72105bf0b18007100550f131c85ca56536e0...31d4847d8b18cf487775dee3471dd4653b7d860b,1,1,1,2,1,2015-01-19 21:52:05,2015-01-05 02:03:14
1b74892807887fe89828ab874e9ce6b2831e7d54...7bd6e333182c9d45a7376092c861d746592bf62b,1,3,1,4,1,2014-01-13 21:36:56,2014-01-09 01:16:17
0c7f6ca83091eb5516d07153f35f851e47f753ee...893fe4c67d7e769efb090264a5a19b41d130987b,1,0,5,5,1,2015-01-13 00:47:56,2015-01-13 00:47:56
893fe4c67d7e769efb090264a5a19b41d130987b...7325fe7987ee134589a9f44743ab24d69b305eb5,1,2,2,4,1,2015-01-13 00:49:33,2015-01-13 00:49:33
7325fe7987ee134589a9f44743ab24d69b305eb5...e64ee2b3f7b4067101b0291f1add842353cd6865,5,12,7,19,12,2015-01-13 00:51:14,2014-12-20 03:20:39
e64ee2b3f7b4067101b0291f1add842353cd6865...10703774f01a4005fc74d6b4131c713259e81657,1,5,4,9,1,2015-01-13 00:51:29,2014-12-22 21:39:51
10703774f01a4005fc74d6b4131c713259e81657...7f4b45dbe8d9e2b53779aae225f939368842805d,1,13,6,19,5,2015-01-13 00:51:46,2013-12-11 17:19:04
7f4b45dbe8d9e2b53779aae225f939368842805d...c3155779945ee21cee4cc5abf318b89d51905156,1,2,2,4,2,2015-01-13 01:40:47,2015-01-13 01:40:47
7bd6e333182c9d45a7376092c861d746592bf62b...346b59e4a3296b92f2f00c2a697819bc56b7df71,8,113,56,169,45,2014-01-14 06:03:40,2014-01-13 16:50:37
346b59e4a3296b92f2f00c2a697819bc56b7df71...a05dae2cedfd8e1c0f91cd8eb04f72941fbd42f7,1,2,1,3,1,2014-01-14 06:03:40,2014-01-13 16:51:57
a05dae2cedfd8e1c0f91cd8eb04f72941fbd42f7...e7f7e2aeca77485b99969dccedb4b71e2c157b9d,1,54,0,54,1,2014-01-15 17:03:45,2014-01-15 17:03:45
e7f7e2aeca77485b99969dccedb4b71e2c157b9d...7f81ca2c47a7c9376f831e8be5d62a5adc917e4e,2,41,5,46,3,2014-01-15 20:27:10,2014-01-09 05:19:31
3917596a940ff76805ac91f1b1abd941aac6b7d5...b3fcc245fb25539909ef1d5eaa01dbf92e168633,1,1,0,1,1,2015-02-17 00:40:25,2015-02-17 00:40:02
b3fcc245fb25539909ef1d5eaa01dbf92e168633...4c31cda272ec8bb7e6ecef8a3ae01d4589e007a8,3,53,5,58,5,2015-02-17 16:56:37,2015-02-07 18:27:20
4c31cda272ec8bb7e6ecef8a3ae01d4589e007a8...e42c4a38fddd3b44d3155cd39a0f2dd5ac11d030,3,106,1,107,3,2015-02-18 02:03:30,2015-01-10 03:25:07
7f81ca2c47a7c9376f831e8be5d62a5adc917e4e...549be1caa84b4746a3697943bf4b19acb6430cc2,1,1,1,2,1,2014-01-16 15:35:12,2014-01-16 01:12:20
549be1caa84b4746a3697943bf4b19acb6430cc2...198ed0bd0da9dee471bb8bfb7f6e97be506224ed,1,4,2,6,1,2014-01-16 15:35:12,2014-01-16 01:13:32
198ed0bd0da9dee471bb8bfb7f6e97be506224ed...67e9298fb6509d5f6ad2f7e67620a2d82549a1e8,1,10,2,12,1,2014-01-16 15:35:12,2014-01-16 01:16:22
67e9298fb6509d5f6ad2f7e67620a2d82549a1e8...abe02553f22e80681b8c623c2b0dd20a9952aaae,1,10,4,14,3,2014-01-16 16:41:04,2014-01-15 22:40:58
abe02553f22e80681b8c623c2b0dd20a9952aaae...61c0d571bf6317807fd0d569099397e5b26b09b9,2,13,6,19,6,2014-01-16 17:11:04,2014-01-16 16:39:12
61c0d571bf6317807fd0d569099397e5b26b09b9...1d57a5caa4dc2994906c2160eaa31ca700dff39c,1,52,0,52,1,2014-01-16 22:43:29,2014-01-16 22:43:29
1d57a5caa4dc2994906c2160eaa31ca700dff39c...f645c40fcd92ca929e03e65d8a8f4ebb05e2cea2,183,1190,5712,6902,254,2014-01-20 05:13:20,2014-01-20 05:13:20
f645c40fcd92ca929e03e65d8a8f4ebb05e2cea2...25f9e92813eda927c3d3eaa56dab3a397afadebe,1,1,1,2,1,2014-01-20 14:39:05,2014-01-20 14:39:05
25f9e92813eda927c3d3eaa56dab3a397afadebe...8b7ec733317a2cbee4916362f8f0fc11f604c441,8,148,22,170,15,2014-01-23 04:47:12,2014-01-23 04:47:12
307daedd2c13f30ba7bf487b308570ca77847fca...f260ef8c3edb45113776d1b570fe6245d4c7995e,2,37,1,38,2,2015-01-15 00:27:12,2014-12-10 04:33:02
f260ef8c3edb45113776d1b570fe6245d4c7995e...85360f06db82c17113fc44207e7156ac8d1c99e0,3,92,1,93,3,2015-01-15 00:27:13,2014-10-29 04:21:00
85360f06db82c17113fc44207e7156ac8d1c99e0...ae00e97ef27bf62bd8ec4f27d7f24761d6a64b52,1,1,1,2,1,2015-01-15 01:34:39,2015-01-14 22:27:31
ae00e97ef27bf62bd8ec4f27d7f24761d6a64b52...408bffe212c350a56218e3562e5315da65235a2f,1,13,21,34,2,2015-01-15 01:36:45,2015-01-14 01:54:53
408bffe212c350a56218e3562e5315da65235a2f...67f87a743dee4951374dd240c25e31cd507e6c5f,2,13,8,21,7,2015-01-15 01:41:21,2015-01-07 01:01:40
67f87a743dee4951374dd240c25e31cd507e6c5f...016e08458cc38d7324c907c6594f2b56a5a19719,3,2,14,16,5,2015-01-15 22:59:36,2014-12-23 20:35:35
016e08458cc38d7324c907c6594f2b56a5a19719...e9df9a0216550abab4923bcfc6dea4f4b32368d2,1,1,1,2,1,2015-01-16 07:41:22,2015-01-15 23:14:16
e9df9a0216550abab4923bcfc6dea4f4b32368d2...58fcc6598561b5b99a8c6756b3b1cca55b635b0f,1,30,30,60,10,2015-01-16 07:41:22,2015-01-15 23:19:32
4b69dcb9610c3fa6cb0bc96f379b749bba83a817...ef4344311e19a4f73c031508252b21712b22fe8a,51,103,0,103,51,2015-03-03 23:52:30,2015-02-28 01:41:20
8b7ec733317a2cbee4916362f8f0fc11f604c441...bc2f31ae1d05de123615241543fbe2282689b6c0,3,27,2,29,3,2014-01-23 05:03:08,2014-01-23 05:03:08
bc2f31ae1d05de123615241543fbe2282689b6c0...b0e5f195dfce3e2b99f5091373d49f6616682596,1,21,20,41,1,2014-01-23 05:05:51,2014-01-23 05:05:51
58fcc6598561b5b99a8c6756b3b1cca55b635b0f...70d04e7f35667381aa6e9d76f56ea962c019d5bc,1,385,0,385,1,2015-01-16 18:25:32,2015-01-16 00:15:01
70d04e7f35667381aa6e9d76f56ea962c019d5bc...28d0cbbdfdf3682adf1fe0c560e7379559fcd621,1,47,7,54,8,2015-01-16 18:35:44,2015-01-16 01:29:54
28d0cbbdfdf3682adf1fe0c560e7379559fcd621...bb1f68f9d6c918ad340bf0f86348a24a9033a9ad,1,0,2,2,1,2015-01-16 19:02:55,2015-01-16 15:41:27
bb1f68f9d6c918ad340bf0f86348a24a9033a9ad...efe1781f3d311d437ec2ae26f475e7bd0cdca4f0,1,3,3,6,3,2015-01-16 19:03:30,2015-01-16 15:41:55
efe1781f3d311d437ec2ae26f475e7bd0cdca4f0...89f3c9037faf19eb32c464b2e02a0a9191156c36,3,4,4,8,3,2015-01-16 21:42:43,2015-01-16 15:55:31
89f3c9037faf19eb32c464b2e02a0a9191156c36...7a8ea15d6fbbf14ee1aef50714ae254f2130b9b5,1,9,10,19,2,2015-01-16 22:59:29,2015-01-16 22:29:01
7a8ea15d6fbbf14ee1aef50714ae254f2130b9b5...430096a90f69fc98b1786dfa0009c02b0d011143,1,1,1,2,1,2015-01-20 15:51:00,2015-01-09 17:55:32
a995a6a776f1b2d01946702190c6ff837c338577...8c38b07252d86f4eef91344f8df4f0c3e38bca35,2,16,3,19,6,2015-03-16 18:35:50,2015-03-10 20:48:19
8c38b07252d86f4eef91344f8df4f0c3e38bca35...2b64132101f179c30957e3c5f16fc47a8ec942e1,1,3,3,6,2,2015-03-16 18:38:25,2015-03-15 11:29:18
24d05f21be4412e70e6ed490fb8009de0c9dfb55...eb7c7be7da4cbec851bed8c8f1f20cde953a0cd8,1,2,2,4,2,2014-01-23 19:44:32,2014-01-23 19:44:32
eb7c7be7da4cbec851bed8c8f1f20cde953a0cd8...5aebc7352589222b2bfe9aecddbe6ff35572613e,1,72,0,72,1,2014-01-23 19:44:32,2014-01-23 19:44:32
5aebc7352589222b2bfe9aecddbe6ff35572613e...5d4f4ee310eab1f82d99caefee4c4c60a48620ff,1,6,4,10,4,2014-01-23 20:42:36,2014-01-23 15:10:24
5d4f4ee310eab1f82d99caefee4c4c60a48620ff...42cd468901b8e5b0411761c43ab8fed06d241d51,1,15,7,22,8,2014-01-23 20:42:56,2014-01-22 16:28:24
42cd468901b8e5b0411761c43ab8fed06d241d51...485fcf9c6361230862eb273b763b5bb69c08a3d1,116,111,335,446,117,2014-01-23 21:04:49,2014-01-23 21:04:49
485fcf9c6361230862eb273b763b5bb69c08a3d1...9975ff603b5ba0e5f4b2f0ffb07474a9013dab36,1,1,1,2,1,2014-01-24 14:56:46,2014-01-23 14:59:21
430096a90f69fc98b1786dfa0009c02b0d011143...8a9f263a82089814e69f277f9fecd2888705101b,2,141,2,143,2,2015-01-20 21:22:17,2015-01-20 21:22:17
ae58fc407f916b2abb164453a5b09273c543dbc3...9b534e2e87489d219f0d0cf5be7f9119704fe424,2,10,2,12,2,2015-03-17 21:27:58,2015-01-11 22:55:12
9975ff603b5ba0e5f4b2f0ffb07474a9013dab36...0ec3770767dd24254d137ac45fe34897ec0443b8,1,20,0,20,1,2014-01-25 20:10:44,2014-01-23 11:35:50
0ec3770767dd24254d137ac45fe34897ec0443b8...896e19330ad06ace8973c5d7b75d2de538228062,1,37,41,78,6,2014-01-25 20:20:41,2014-01-23 10:27:36
896e19330ad06ace8973c5d7b75d2de538228062...00efcb4cd7609dcefad8acba915d850480436457,2,4,0,4,4,2014-01-25 20:20:45,2014-01-22 21:15:04
00efcb4cd7609dcefad8acba915d850480436457...b4c4e0bbaa19616f41857e20c2dc2824c780baf4,2,24,2,26,5,2014-01-26 18:24:57,2014-01-26 16:09:14
b4c4e0bbaa19616f41857e20c2dc2824c780baf4...d2de8ba34dc57d78a0bd0fedc4bd05e5c4457bac,2,37,1,38,3,2014-01-27 18:12:29,2014-01-25 17:50:17
2d8253d251bca05093801293e234990891813fbb...f2b378b850b3bc5ac7e30fb7a204ef19ca4f8604,1,2,2,4,2,2015-01-20 23:46:56,2015-01-20 23:46:56
f2b378b850b3bc5ac7e30fb7a204ef19ca4f8604...f34757398fcc393685b4dfbcbdc692fb38332d6c,4,44,10,54,7,2015-01-22 18:14:05,2014-12-16 22:17:28
f34757398fcc393685b4dfbcbdc692fb38332d6c...de5f24a084795439c10d943afc65bc8d864c607d,2,18,3,21,2,2015-01-23 21:47:58,2015-01-12 06:13:17
d2de8ba34dc57d78a0bd0fedc4bd05e5c4457bac...8c055702587ba752a4b901cd27c300abe3774b37,1,2,1,3,1,2014-01-28 23:39:54,2013-06-12 04:02:51
8c055702587ba752a4b901cd27c300abe3774b37...a98d541733336aa1e804e8397bf4e202a7150473,1,106,0,106,1,2014-01-29 03:48:54,2014-01-29 03:48:54
a98d541733336aa1e804e8397bf4e202a7150473...e796e11087f1f6d04422d52ac333cc0fc0862750,4,51,5,56,8,2014-01-30 17:26:19,2014-01-23 09:35:18
e796e11087f1f6d04422d52ac333cc0fc0862750...fac8f396ccc2d7133058848bd2531ee0fb525130,4,10,3,13,6,2014-01-31 20:45:55,2014-01-30 11:25:20
fac8f396ccc2d7133058848bd2531ee0fb525130...643a7d8c1605b61facc570a6f8b8b0ed0cf89eb7,1,2,2,4,2,2014-01-31 20:45:55,2014-01-31 20:12:42
643a7d8c1605b61facc570a6f8b8b0ed0cf89eb7...154d9d2163987f8f9c1be5fdc9d2a8cb3b2134a6,1,4,0,4,1,2014-02-03 08:38:40,2014-02-01 15:10:25
154d9d2163987f8f9c1be5fdc9d2a8cb3b2134a6...09c51d5e40aa0f9084fdee5b73a18cb8e864985c,2,3565,3587,7152,3,2014-02-03 21:42:52,2013-11-09 22:46:05
09c51d5e40aa0f9084fdee5b73a18cb8e864985c...d2147c55c25410e1666ee75360d918f973e25842,1,2,2,4,1,2014-02-04 08:50:24,2014-02-04 01:56:21
d2147c55c25410e1666ee75360d918f973e25842...1317032c9738790362b8e1bdd3638f1368b00188,2,25,0,25,7,2014-02-06 09:04:35,2014-02-06 06:29:58
1317032c9738790362b8e1bdd3638f1368b00188...e3d835902161eab536a1913a3edaa2bb0da9542c,1,2,2,4,2,2014-02-07 19:17:23,2014-02-07 19:17:23
e3d835902161eab536a1913a3edaa2bb0da9542c...56e80a37e0df0d131d3a3ad6426d52f887ef8e94,2,32,0,32,2,2014-02-07 22:08:28,2014-02-07 17:50:29
56e80a37e0df0d131d3a3ad6426d52f887ef8e94...2ee86c624ecd6b9dbaad10989143325fc64778cd,1,3,1,4,2,2014-02-07 22:10:01,2014-02-07 17:18:27
2ee86c624ecd6b9dbaad10989143325fc64778cd...96379f83e0f649090caf15e8a6e016491aeca776,1,1,3,4,2,2014-02-07 22:15:29,2014-02-07 22:15:29
96379f83e0f649090caf15e8a6e016491aeca776...d10a68736d338ea1d673f3f8bd410868b73318e2,2,0,32,32,2,2014-02-07 22:15:33,2014-02-07 22:15:33
d10a68736d338ea1d673f3f8bd410868b73318e2...3595139b51de11a33c2e7af1892e89130aac7474,1,1,1,2,1,2014-02-08 22:42:41,2014-02-08 18:19:04
3595139b51de11a33c2e7af1892e89130aac7474...2e8bb57fe37fd75323d3e3290be7264df97fe4dc,213,238,250,488,228,2014-02-08 23:10:43,2014-02-03 04:24:09
2e8bb57fe37fd75323d3e3290be7264df97fe4dc...5c832e44c3c61ad41506df0d283901aba6aea187,5,23,9,32,10,2014-02-08 23:31:27,2014-02-05 16:50:40
ddd40fd5dc42dd2ad841b0679611ac89c8f2d11d...e67073256d847be085be7049cd1d6ebd8d86ac62,1,11,1,12,3,2015-01-26 23:59:16,2015-01-26 23:42:15
e67073256d847be085be7049cd1d6ebd8d86ac62...491ac6a84365e143255cd1b75717b05dadeec219,705,30689,8490,39179,2033,2015-01-28 01:41:30,2015-01-24 01:51:45
491ac6a84365e143255cd1b75717b05dadeec219...3b392d33c7c2e9ec143e3e8fd0a00c242b9342aa,3,9,100,109,11,2015-01-29 20:07:16,2015-01-28 18:50:14
3b392d33c7c2e9ec143e3e8fd0a00c242b9342aa...bcff90e0c299ce472d3e00b8f886dac8e99478bd,2,19,28,47,11,2015-01-29 23:22:15,2014-11-13 17:27:09
bcff90e0c299ce472d3e00b8f886dac8e99478bd...59265264d56cfb7ced87f9b3666ec570152c5f47,9,34,8,42,11,2015-01-30 00:23:38,2015-01-26 07:57:22
5c832e44c3c61ad41506df0d283901aba6aea187...dee5270a6c093db32897d45c4ed18f56bd772987,3,56,3,59,6,2014-02-10 18:59:52,2014-02-09 10:59:31
59265264d56cfb7ced87f9b3666ec570152c5f47...8e42e5a0731040075e14cec087eea86729f2dc53,2,16,1,17,2,2015-01-30 06:13:10,2015-01-30 04:40:30
dee5270a6c093db32897d45c4ed18f56bd772987...b222374b072caf062df587aa7a7d8773c2c82f31,1,6,6,12,6,2014-02-12 22:18:10,2014-02-09 09:37:55
b222374b072caf062df587aa7a7d8773c2c82f31...37376debe54ccd2889174ebb8ffc3949e0bda298,333,4,24345,24349,291,2014-02-13 23:54:07,2014-02-13 23:52:01
37376debe54ccd2889174ebb8ffc3949e0bda298...55543d3c45777e2867b86109454e1686e9956c5f,176,1261,2139,3400,279,2014-02-14 00:35:41,2014-02-13 02:16:32
54d808d2ea12375f33104acc57ed9a1ddd2ac46b...f46b085fbec978fe867a2e62144aa257b0f9ed04,1,2,2,4,2,2015-01-30 17:05:48,2015-01-30 17:05:48
55543d3c45777e2867b86109454e1686e9956c5f...86b8d84811484763b251b9a8a2b9e673964ea6b5,1,448,0,448,1,2014-02-14 19:01:49,2014-02-14 19:01:49
f46b085fbec978fe867a2e62144aa257b0f9ed04...4312f8d760bdf574b5a461e426331f0b4d298f18,7,1524,220,1744,197,2015-02-05 20:34:38,2014-10-23 02:48:35
4312f8d760bdf574b5a461e426331f0b4d298f18...ebfa7e350aed8f61b68a290be2e8fefca9db939e,2,43,0,43,4,2015-02-05 20:35:27,2014-11-07 18:18:10
ebfa7e350aed8f61b68a290be2e8fefca9db939e...878c40e1b3762a5f3ed48094f954fbee705f69ff,2,29,7,36,8,2015-02-05 20:35:51,2014-11-14 00:21:33
878c40e1b3762a5f3ed48094f954fbee705f69ff...31610d0db42b4f61f85841a0d58f5014c98d0fc5,5,961,595,1556,14,2015-02-05 20:50:26,2015-01-23 02:53:49
31610d0db42b4f61f85841a0d58f5014c98d0fc5...02566a77c9cff462086f123104d25115dbe2535d,1,2,2,4,1,2015-02-05 23:29:13,2015-02-05 23:29:13
02566a77c9cff462086f123104d25115dbe2535d...087a7519cea9b8aed23f4c03111da724cf20a94f,514,14685,12460,27145,1637,2015-02-06 19:55:44,2015-02-06 10:50:39
86b8d84811484763b251b9a8a2b9e673964ea6b5...829a9b8cba0680f1d451551e12491e7b0e1ea92f,2,52,1,53,8,2014-02-17 21:11:05,2014-02-13 13:17:59
829a9b8cba0680f1d451551e12491e7b0e1ea92f...217bb0c9641f8b999f8a07d5fd9141e8c6cd1164,175,1556,609,2165,299,2014-02-18 03:37:33,2014-02-17 04:43:16
217bb0c9641f8b999f8a07d5fd9141e8c6cd1164...562b015170c4c0bf442d49d46332fb3918173306,2,13,3,16,4,2014-02-18 04:47:46,2014-02-15 03:30:30
087a7519cea9b8aed23f4c03111da724cf20a94f...2b18916ff054309a07408719b62e2b6a4f1e056a,2,9,2,11,2,2015-02-06 20:04:23,2015-02-06 20:04:23
562b015170c4c0bf442d49d46332fb3918173306...abbde2fafab5d722e156aa6fadd343e671446ace,1,3,0,3,1,2014-02-18 18:29:04,2013-05-21 21:10:34
abbde2fafab5d722e156aa6fadd343e671446ace...c2aea3747dafaa979c9d21cc7acead32324bfb3a,11,143,13,156,25,2014-02-18 21:04:29,2014-02-18 21:04:29
c2aea3747dafaa979c9d21cc7acead32324bfb3a...3e6e63406d04093be39bafab84845365a1d0c971,1,5,2,7,4,2014-02-18 21:10:09,2014-02-18 21:09:41
3e6e63406d04093be39bafab84845365a1d0c971...1d734a75b5764ac7414daab489ce82d6ca09f69f,1,14,6,20,2,2014-02-18 21:36:00,2014-02-17 15:22:05
1d734a75b5764ac7414daab489ce82d6ca09f69f...1fa5cff4f21782fb1ba499c38e690a13d70ba765,1,17,5,22,4,2014-02-18 21:52:14,2013-07-08 17:09:44
1de0ca8c44fe7d9aa842b64c6429d87ef00da365...a5dbcc9f1df6efd80ecbd0781931b4b786e4a523,1,2,2,4,2,2015-02-06 22:04:56,2015-02-06 22:04:56
a5dbcc9f1df6efd80ecbd0781931b4b786e4a523...605329d7f77397f5f3e1ae65b738cd4391e18f9a,4,18,1,19,6,2015-02-09 22:34:53,2015-02-05 23:22:25
605329d7f77397f5f3e1ae65b738cd4391e18f9a...04b63e022a477ee042fec38628b1686cfdb9493b,2,10,3,13,4,2015-02-10 20:56:05,2015-02-10 20:56:05
04b63e022a477ee042fec38628b1686cfdb9493b...8d8a2f2190238c45fad47393a0bea7e4c452c5b5,1,1,1,2,1,2015-02-11 21:48:17,2015-02-08 22:45:03
8d8a2f2190238c45fad47393a0bea7e4c452c5b5...d2b546187a86c3fc45f1b0e9336ca72ac30256e4,1,2,1,3,1,2015-02-11 21:53:44,2015-02-09 15:51:12
d2b546187a86c3fc45f1b0e9336ca72ac30256e4...4823afcbe26dd3a23aaa35d552a9656f37c8645d,2,15,10,25,5,2015-02-11 23:49:22,2015-01-19 09:52:07
4823afcbe26dd3a23aaa35d552a9656f37c8645d...6c60a72d2b6e3d2af281621ff109ccf8687b35f6,1,1,1,2,1,2015-02-12 21:25:33,2015-02-12 07:25:01
6c60a72d2b6e3d2af281621ff109ccf8687b35f6...b8604fa4807a3c06c5a668c074ef44e78c73986e,1,3,3,6,3,2015-02-12 21:37:30,2015-02-12 13:50:47
b8604fa4807a3c06c5a668c074ef44e78c73986e...6c3647c38d73f729ce85633a0440cd939d93dea2,2,26,10,36,4,2015-02-13 15:22:30,2015-01-29 19:25:52
6c3647c38d73f729ce85633a0440cd939d93dea2...a35ba2f67dfcdf21b87f4326c6d67150f40224b6,1,3,1,4,1,2015-02-16 21:13:53,2015-02-16 21:13:53
1fa5cff4f21782fb1ba499c38e690a13d70ba765...31c510ca8829ef6e6727e530a57d75b4233b275a,3,39,2,41,3,2014-02-18 22:55:58,2014-02-18 22:55:58
31c510ca8829ef6e6727e530a57d75b4233b275a...cc56c62ed879ad4f93b1fdab3235c43e60f48b7e,3,0,0,0,0,2014-02-18 23:34:29,2014-02-18 23:34:29
a6bdd8fd07c71298f6e21026939766ef80dd218e...2b095bb76c62d2e27f0fb9ca716f17198e925f62,1,15,0,15,2,2015-02-17 00:15:51,2015-02-16 23:38:57
2b095bb76c62d2e27f0fb9ca716f17198e925f62...a103712a625b9a9fd124250e864d497e9e9e95a4,1,1,1,2,1,2015-02-17 00:15:51,2015-02-16 23:45:08
a103712a625b9a9fd124250e864d497e9e9e95a4...7b554024cca6b3d5b7922c510ddf877dcfaba97f,1,4,0,4,4,2015-02-17 00:35:23,2015-02-17 00:35:23
0206925b0deb7f6196db654ce4e3ce86e16dad1d...ae418f974d78e52c22b8d49a84963b8b416b1438,1,2,2,4,2,2014-02-19 00:43:12,2014-02-19 00:43:12
ae418f974d78e52c22b8d49a84963b8b416b1438...085db9dd6c1f3faf526c16170e9ffe89b8ec6211,1,11,11,22,7,2014-02-19 02:57:45,2014-02-19 02:57:45
7b554024cca6b3d5b7922c510ddf877dcfaba97f...b3aa876f08563aaed1b51a9dc5c1a254a146af67,3,48,4,52,3,2015-02-17 17:09:20,2015-02-07 18:27:20
b3aa876f08563aaed1b51a9dc5c1a254a146af67...bada87bd666f103cc00d63ace48ef300b0caaabf,3,75,9,84,12,2015-02-19 18:46:59,2015-02-19 18:44:25
bada87bd666f103cc00d63ace48ef300b0caaabf...9deade432254ebb39a6afb468fad5586d24a5b50,5,137,7,144,11,2015-02-20 22:19:30,2015-02-20 17:32:29
9deade432254ebb39a6afb468fad5586d24a5b50...2fc5eeb3da0cbc5c17674818bc679d3d564d0d06,1,5,4,9,4,2015-02-20 22:25:27,2015-02-14 06:51:25
2fc5eeb3da0cbc5c17674818bc679d3d564d0d06...08a1192478ed84422902d59a8bfe056ff88cc88d,1,0,1,1,1,2015-02-24 19:32:03,2015-02-09 19:08:55
08a1192478ed84422902d59a8bfe056ff88cc88d...f1bf88395926d84fb75cc055849624caad8f0144,1,1,1,2,1,2015-02-25 20:00:44,2015-02-13 03:59:11
f1bf88395926d84fb75cc055849624caad8f0144...5d821fe0beec775fa3fbb0fd7ac1cbc3fff983c5,1,5,1,6,2,2015-02-25 20:00:53,2015-02-21 00:03:14
5d821fe0beec775fa3fbb0fd7ac1cbc3fff983c5...3e40e126eb078634c08ee59aa20229bd85570167,1,3,2,5,1,2015-02-27 17:14:06,2015-02-23 19:13:20
3e40e126eb078634c08ee59aa20229bd85570167...b233131901dea47132b0748d8e4d6bfcbba28abe,4,64,21,85,9,2015-02-28 00:28:57,2015-02-18 00:19:19
085db9dd6c1f3faf526c16170e9ffe89b8ec6211...b940e0fd86f29694c571e4fef5b49434eb1cbb8d,3,65,3,68,6,2014-02-20 20:46:26,2014-02-20 16:52:26
b940e0fd86f29694c571e4fef5b49434eb1cbb8d...b7776fb192b803847d07a582bdb62851e93cd98e,1,2,0,2,1,2014-02-20 20:46:26,2014-02-20 17:00:29
b7776fb192b803847d07a582bdb62851e93cd98e...a6f89ccd76a7b5daea774b84552385597c4a2579,1,2,2,4,2,2014-02-20 20:56:17,2014-02-20 20:56:17
a6f89ccd76a7b5daea774b84552385597c4a2579...e0c530259050c4ecc6fe9cf8963992575e43f376,1,2,4,6,1,2014-02-20 21:03:03,2014-02-20 21:03:03
e0c530259050c4ecc6fe9cf8963992575e43f376...1efe6837b23a2a70a226b4fcab8dc5ea1c7bf2c8,1,2,2,4,2,2014-02-23 14:09:26,2014-02-22 15:02:10
1efe6837b23a2a70a226b4fcab8dc5ea1c7bf2c8...70ea5bac431ae136368fc2c88e4bbe9e4b93a9aa,1,1,2,3,1,2014-02-24 11:08:11,2014-02-23 19:00:28
70ea5bac431ae136368fc2c88e4bbe9e4b93a9aa...aae51ecf7d407b2fb56c1f3e1edf91a16940c973,2,10,4,14,2,2014-02-25 16:32:49,2014-02-24 19:16:40
aae51ecf7d407b2fb56c1f3e1edf91a16940c973...0a01a42e8729cfb1c2bbf59e98daac9d13b06c80,2,50,1,51,2,2014-02-26 19:14:32,2014-02-26 02:17:35
0a01a42e8729cfb1c2bbf59e98daac9d13b06c80...47abdd9c43ae97ed11cb8cc4c770b43043718308,1,47,0,47,1,2014-02-26 19:39:53,2014-02-26 19:39:53
e82e86b1a7fc3e3d15daeb5845f0ce4d83e15e92...d9a309f718d738eb817195118f4daa06fb6f68ee,1,4,1,5,2,2015-03-03 22:35:36,2015-02-27 23:48:34
d9a309f718d738eb817195118f4daa06fb6f68ee...63fbd10b6cdea195bfbc55221d8fe279757d56cc,197,1573,305,1878,341,2015-03-03 22:45:37,2015-02-27 13:54:37
47abdd9c43ae97ed11cb8cc4c770b43043718308...06453a94a7b06df30be0148e8b1d89932350f677,4,38,3,41,7,2014-03-04 00:27:58,2014-03-04 00:27:58
06453a94a7b06df30be0148e8b1d89932350f677...6eb4d1d15ca8d2b82cf9db99d56633357ccc3320,2,82,0,82,3,2014-03-04 01:46:49,2014-01-29 01:36:22
6eb4d1d15ca8d2b82cf9db99d56633357ccc3320...bd8a5755dceda415eee147bc06574f5a30abb0d0,1,1,1,2,1,2014-03-05 11:26:09,2014-03-04 13:10:05
bd8a5755dceda415eee147bc06574f5a30abb0d0...a9d24fa40d2e02860efa7653164c0c4e0d515457,1,56,0,56,1,2014-03-05 17:36:32,2013-05-14 03:10:07
a9d24fa40d2e02860efa7653164c0c4e0d515457...5e06ce4fb949ab9bd5a7105dc0e8d924fd911d0c,1,10,1,11,3,2014-03-05 17:36:35,2014-02-26 10:37:13
5e06ce4fb949ab9bd5a7105dc0e8d924fd911d0c...6bd78fd7704a8a695fc76430b573bc482f42c320,1,1,1,2,1,2014-03-06 23:29:00,2014-03-06 21:59:56
6bd78fd7704a8a695fc76430b573bc482f42c320...f0d870501ed240f550b2be6b0a138312fb6f4a30,2,10,3,13,3,2014-03-10 21:08:43,2014-03-10 10:59:18
f0d870501ed240f550b2be6b0a138312fb6f4a30...43a29f53ca11ab48e1d1ef6b2a0e673ae43a42a0,1,1,1,2,1,2014-03-10 22:30:40,2014-03-09 11:16:39
b0425f0d2c3556a19ffe36fed4d777878e96e2eb...1a2a4dac232673987fcea4471b19bb82502f0205,4,97,33,130,14,2015-03-05 14:38:10,2015-02-23 16:23:53
1a2a4dac232673987fcea4471b19bb82502f0205...cc6ee3f010fe8b6f5d92097b56311e566bb2a8ac,291,2101,905,3006,454,2015-03-07 03:01:22,2015-03-06 09:09:26
cc6ee3f010fe8b6f5d92097b56311e566bb2a8ac...a33f23cbbcd68c0f534d874052311672d0dcaf5d,1,6,0,6,1,2015-03-11 18:47:54,2015-03-11 14:28:05
a33f23cbbcd68c0f534d874052311672d0dcaf5d...e8b21095670543ad6ee8e24e0a1b096b908e20b1,1,1,0,1,1,2015-03-13 14:00:46,2015-03-10 12:25:31
e8b21095670543ad6ee8e24e0a1b096b908e20b1...588c009781d84a523fd84bb5feb66fa074849427,2,5,8,13,6,2015-03-13 17:46:53,2014-11-17 20:00:11
43a29f53ca11ab48e1d1ef6b2a0e673ae43a42a0...7989f42f866699b726f596add387fb19fa39bc55,2,1,3,4,2,2014-03-23 23:11:08,2014-03-06 04:11:07
7989f42f866699b726f596add387fb19fa39bc55...bd547d65983c190eb69ca44d633ea31aca2b7c98,318,5566,4042,9608,874,2014-03-26 00:42:22,2014-03-19 16:25:40
bd547d65983c190eb69ca44d633ea31aca2b7c98...70f198ddb1ba464da97799f59ae9233320ecc49d,3,15,0,15,3,2014-03-26 07:31:32,2013-09-20 20:01:49
70f198ddb1ba464da97799f59ae9233320ecc49d...f68a116c3c061151ab120f10fdc9230192d6b157,1,37,0,37,3,2014-03-26 07:31:32,2014-03-25 22:35:28
f68a116c3c061151ab120f10fdc9230192d6b157...a9d22247ad2b519a42a9eb63a0531ad337554723,1,4,2,6,2,2014-03-27 18:54:13,2014-03-26 05:26:17
a9d22247ad2b519a42a9eb63a0531ad337554723...47bed4828c69abe39a18e267a7491bcc3d0ce5e5,1,2,2,4,2,2014-03-31 14:40:17,2014-03-29 00:20:14
47bed4828c69abe39a18e267a7491bcc3d0ce5e5...cdc093b31f61837321b146415f088ada2fc0c647,1,1,1,2,1,2014-04-02 11:34:16,2014-03-30 22:25:41
cdc093b31f61837321b146415f088ada2fc0c647...c2d32f4c0e60a31e6ee421f8f7f45541792c5c6d,1,1,1,2,1,2014-04-07 13:45:04,2014-04-07 02:08:50
c2d32f4c0e60a31e6ee421f8f7f45541792c5c6d...f2b297cc7ca1a7a4f4abd356bd1ad0af09e1b26b,2,97,3,100,2,2014-04-07 20:40:22,2014-01-24 12:25:11
f2b297cc7ca1a7a4f4abd356bd1ad0af09e1b26b...d6fd118727604bb94ca295f706e40119ad9de0a4,256,49230,6208,55438,828,2014-04-07 20:58:37,2014-04-07 20:58:37
d6fd118727604bb94ca295f706e40119ad9de0a4...af69f88a9d57e302af632c047faffed7cca90772,1,1,1,2,1,2014-04-08 16:06:28,2014-04-08 16:05:59
af69f88a9d57e302af632c047faffed7cca90772...632c13562220f1a1f1fdf89c60cf69fd8bbac359,1,4,7,11,3,2014-04-10 17:55:02,2014-04-05 20:49:47
632c13562220f1a1f1fdf89c60cf69fd8bbac359...bfb7de5e75f49ba250d1bb6f1b7a15bd3d6d7f2a,1,2,2,4,1,2014-04-10 20:52:33,2014-04-09 20:50:08
bfb7de5e75f49ba250d1bb6f1b7a15bd3d6d7f2a...1bd4f3a605216838619e4d7dc1eb1600b1deb91f,2,67,1,68,2,2014-04-14 16:15:09,2014-04-14 09:33:22
1bd4f3a605216838619e4d7dc1eb1600b1deb91f...9520adeb37f5ebe02a68669ec97770f4869705bb,2,32,0,32,3,2014-04-15 22:30:43,2014-03-25 21:16:55
9520adeb37f5ebe02a68669ec97770f4869705bb...75bc11cf12f53768654f7ac11f308fdf0296bd34,247,1136,335,1471,421,2014-04-15 22:31:36,2014-04-15 22:31:36
75bc11cf12f53768654f7ac11f308fdf0296bd34...4601e7c8927ba5655f0872f1f1794aec2b9a4d56,1,41,37,78,6,2014-04-24 06:19:30,2014-04-24 06:19:30
4601e7c8927ba5655f0872f1f1794aec2b9a4d56...b0fa931e0751df74242b9f069388b628e1ab43c2,1,2,2,4,2,2014-04-24 15:59:41,2014-04-24 11:18:31
b0fa931e0751df74242b9f069388b628e1ab43c2...0ee99565f9dd41225fd5d4084403db82733c575e,1,1,0,1,1,2014-04-24 15:59:41,2014-04-24 11:19:14
0ee99565f9dd41225fd5d4084403db82733c575e...f9ced08de30c37838756e8227bd091f80ad9cafa,1,22,4,26,3,2014-04-24 21:02:05,2014-04-24 02:27:40
f9ced08de30c37838756e8227bd091f80ad9cafa...250782d139ccec276ec24e401a78423a66dcf97a,3,13,2,15,3,2014-04-25 20:52:49,2013-10-15 01:26:18
250782d139ccec276ec24e401a78423a66dcf97a...3f3a71e61e90d45293704f21c98bc0ea53bb09ff,1,6,0,6,1,2014-04-28 15:34:07,2014-04-28 11:05:00
3f3a71e61e90d45293704f21c98bc0ea53bb09ff...793c76e5c65031009525fcb6e5e4af78c28d1c4f,1,3,1,4,1,2014-04-29 10:15:10,2014-04-28 19:38:06
793c76e5c65031009525fcb6e5e4af78c28d1c4f...1038959dbf70800545df319715e5d89dbd8ad8af,15,237,27,264,38,2014-05-01 16:27:39,2014-05-01 16:27:39
1038959dbf70800545df319715e5d89dbd8ad8af...f76c3938d0660378017bf276a72ea60e9adfe62c,257,880,487,1367,377,2014-05-01 18:09:00,2014-05-01 18:09:00
f76c3938d0660378017bf276a72ea60e9adfe62c...cb7911f78ae96ef7a540df992cc1359ba9636e86,3,42,2,44,3,2014-05-01 21:04:20,2014-05-01 21:04:20
7abd826366d1a46a001b9d3e367c53c26a94d95e...1285008fcaa4edc2f810577b42a37cf96696cdf4,1,2,2,4,2,2014-05-01 22:30:07,2014-05-01 22:30:07
1285008fcaa4edc2f810577b42a37cf96696cdf4...dbec0a0cd8a76974c06a8965765e2790c6fd4ccb,113,171,117,288,126,2014-05-01 23:30:33,2014-05-01 23:30:33
dbec0a0cd8a76974c06a8965765e2790c6fd4ccb...b148cbe09d4657766fdb61575ba985734c2ff0a8,2,7,2,9,2,2014-05-02 00:47:47,2014-05-02 00:47:47
d857d5ab09a40aba92185ff993c810df2b2eeb40...bfe1fdb8ab5deebe24be9862af2028e6713bd275,1,2,2,4,2,2014-05-02 14:46:15,2014-05-02 14:46:15
bfe1fdb8ab5deebe24be9862af2028e6713bd275...a960d1707a0038bfa5546c669b5b63c35bdb75c5,2,76,1,77,2,2014-05-02 18:53:27,2014-05-02 18:44:45
a960d1707a0038bfa5546c669b5b63c35bdb75c5...00890e43fb935c8bc5dc150f0f2c96bc465d8a4d,1,8,1,9,3,2014-05-02 18:54:08,2014-03-06 16:29:21
00890e43fb935c8bc5dc150f0f2c96bc465d8a4d...120f7cf55fb977a145dca0ed840ea5a07730da05,115,2925,4080,7005,1851,2014-05-06 01:20:40,2014-05-06 01:20:40
120f7cf55fb977a145dca0ed840ea5a07730da05...17fbdc18b8cec0b6b2827d9e3c6360b694e6e9c3,3,45,11,56,12,2014-05-07 19:11:57,2014-05-05 14:48:51
17fbdc18b8cec0b6b2827d9e3c6360b694e6e9c3...92875501d23c187c490a7f5ead454e1891b27aa1,2,47,1,48,3,2014-05-13 08:25:00,2014-04-30 01:24:44
92875501d23c187c490a7f5ead454e1891b27aa1...885142a5edc2c803fa8b9d92b5d0771379237764,1,10,4,14,3,2014-05-14 11:33:18,2014-05-13 11:45:21
885142a5edc2c803fa8b9d92b5d0771379237764...7bd08c5062bdcd2a71ddd9d79bd3e080f1e48090,1,0,2,2,1,2014-05-15 21:31:59,2014-05-14 05:32:57
7bd08c5062bdcd2a71ddd9d79bd3e080f1e48090...c06495713a95b40d28729e2211dc5a813611b2fe,2,19,5,24,9,2014-05-15 21:33:08,2014-05-14 17:07:29
c06495713a95b40d28729e2211dc5a813611b2fe...1d90b5b78e40ad5165e2eaec14e8f230bd08658d,2,11,8,19,2,2014-05-16 09:15:25,2014-05-15 23:11:51
1d90b5b78e40ad5165e2eaec14e8f230bd08658d...31150df92a5c5e726a4aa12b78a2589e7b20f1ec,1,11,1,12,3,2014-05-21 23:48:46,2014-05-13 15:52:38
31150df92a5c5e726a4aa12b78a2589e7b20f1ec...e86c9421ef688c513c2b5f4cc32170f41b12e6fa,1,7,0,7,2,2014-05-22 16:27:03,2014-05-07 10:59:23
e86c9421ef688c513c2b5f4cc32170f41b12e6fa...c862c0348530824bfacef8eadfaf448120d91664,1,4,9,13,2,2014-05-23 19:41:30,2014-05-23 18:55:34
c862c0348530824bfacef8eadfaf448120d91664...72cc66e5033ea8900582da5a19b4032d8120e24c,1,6,1,7,1,2014-05-29 01:58:32,2014-05-28 22:34:04
72cc66e5033ea8900582da5a19b4032d8120e24c...715bb7f89f727f0300d68af578450db27c225a10,1,2,1,3,1,2014-05-31 09:09:02,2014-05-30 21:25:52
715bb7f89f727f0300d68af578450db27c225a10...a7dd0e51f326dfcc478cc897033e0cd7de62b65d,147,1427,14051,15478,254,2014-06-05 14:11:23,2014-06-05 14:09:35
a7dd0e51f326dfcc478cc897033e0cd7de62b65d...2efe4ab7616669448f873b0417e9aa81221324e2,4,57,4,61,5,2014-06-06 04:12:07,2014-05-16 09:10:34
2efe4ab7616669448f873b0417e9aa81221324e2...22b839845c204310e8d78e28dd0cf9f6b3fff6aa,1,82,123,205,10,2014-06-06 22:07:29,2014-05-13 15:30:25
22b839845c204310e8d78e28dd0cf9f6b3fff6aa...9fbd0f0f7df16536533c331e3c634b203087d521,1,21,25,46,13,2014-06-06 22:07:29,2014-05-13 15:36:40
9fbd0f0f7df16536533c331e3c634b203087d521...80eff968292ab1024efbba6f55114ae2bba66579,1,25,0,25,6,2014-06-06 22:07:29,2014-05-13 15:42:48
80eff968292ab1024efbba6f55114ae2bba66579...881ac26f27f4ac9585d66c8d8a67d5b246a23d1b,4,55,17,72,17,2014-06-06 22:07:29,2014-01-20 08:43:43
881ac26f27f4ac9585d66c8d8a67d5b246a23d1b...0da4c671659cfbae12def127b2e94690b9d9b5e1,4,22,1,23,5,2014-06-06 22:07:29,2014-01-20 08:47:19
0da4c671659cfbae12def127b2e94690b9d9b5e1...535c7777ac674ba86cf93c44824e07b0e23ea8c4,10,158,68,226,73,2014-06-06 22:07:29,2014-04-10 00:33:33
535c7777ac674ba86cf93c44824e07b0e23ea8c4...f051f317905b3b31945dfe965a492e54902e595f,358,4050,2343,6393,713,2014-06-06 22:07:29,2014-06-05 22:18:15
f051f317905b3b31945dfe965a492e54902e595f...e9170cbc3d3a12cf6c02068916cc7c3bb3f10aaa,1,28,18,46,3,2014-06-06 22:07:30,2014-06-05 22:55:48
e9170cbc3d3a12cf6c02068916cc7c3bb3f10aaa...7fd5a4d096a8d868eb0f17fcb43779bab73ea030,1,1,1,2,1,2014-06-08 17:01:23,2014-06-07 15:53:23
7fd5a4d096a8d868eb0f17fcb43779bab73ea030...ce82d6b8474bde7ac7df6d425fb88fb1bcba35bc,3,34,2,36,3,2014-06-09 17:04:36,2014-06-09 17:04:36
fc21bcb017012fb19f555c1969e344639af325af...1cb6f1a46ad24c60ab1fccfa3f88aad9401e6444,1,2,2,4,2,2014-06-09 17:52:27,2014-06-09 17:52:27
1cb6f1a46ad24c60ab1fccfa3f88aad9401e6444...f6ba61bd1545a72636eb02b213772dd221b681be,1,0,6,6,1,2014-06-11 15:51:53,2014-06-11 15:51:53
f6ba61bd1545a72636eb02b213772dd221b681be...361aa5344d6b2bc5d09fc7de20de703a8501264c,1,2,2,4,2,2014-06-13 21:39:53,2014-06-13 21:39:53
361aa5344d6b2bc5d09fc7de20de703a8501264c...e22ea56647bb72602a0c2d4494a997a4d913bf72,1,1,1,2,1,2014-06-17 00:16:13,2014-06-17 00:16:13
e22ea56647bb72602a0c2d4494a997a4d913bf72...72dcc26c7af47fff906123f1afb3510a0c22b28c,1,8,3,11,1,2014-06-23 06:45:40,2014-06-20 10:02:13
72dcc26c7af47fff906123f1afb3510a0c22b28c...ee95e4f5f76cc2ac637ab53056a7c514bc49e13c,3,71,192,263,32,2014-06-23 23:58:55,2014-03-25 14:51:13
ee95e4f5f76cc2ac637ab53056a7c514bc49e13c...c94afdccf32443c9dd5a351fdfe1f19906327138,1,1,1,2,1,2014-06-27 10:22:01,2014-06-13 09:36:52
c94afdccf32443c9dd5a351fdfe1f19906327138...a97bdef06d1451c39df3a4a46f85f285c552a9df,2,44,0,44,4,2014-06-27 13:02:02,2014-06-12 04:11:28
a97bdef06d1451c39df3a4a46f85f285c552a9df...4128d4d2ba8f346cab2b062f57ae4cb4831e7bb5,4,4,57,61,5,2014-06-30 09:06:35,2014-06-30 09:06:35
4128d4d2ba8f346cab2b062f57ae4cb4831e7bb5...47ee9a48a842126af628d41450fd38a70e5408cc,1,4,10,14,3,2014-07-02 19:49:59,2014-06-30 08:43:28
47ee9a48a842126af628d41450fd38a70e5408cc...7cb38309fe96e0ec913af9f13b8ebbe0555ee67a,1,1,8,9,3,2014-07-02 19:49:59,2014-06-30 08:43:30
7cb38309fe96e0ec913af9f13b8ebbe0555ee67a...9cbfd6ef51899dd869a8ec809766cf06d14c9a36,1,4,0,4,1,2014-07-02 19:49:59,2014-06-30 08:43:47
9cbfd6ef51899dd869a8ec809766cf06d14c9a36...c7c904b1fc84aed16eea35bf02d5bd5b52c575f7,1,2,2,4,1,2014-07-02 20:02:46,2014-06-30 15:06:47
c7c904b1fc84aed16eea35bf02d5bd5b52c575f7...449ffecbb0608d1f222184d9f241697aede18c80,1,2,0,2,1,2014-07-02 20:32:11,2014-07-02 20:32:11
449ffecbb0608d1f222184d9f241697aede18c80...11337db35f6826c3f8f4c76eafd5ebf1c17294d7,2,32,1,33,2,2014-07-02 20:46:17,2014-07-02 17:35:50
11337db35f6826c3f8f4c76eafd5ebf1c17294d7...e2f2a202791293f2152a382852885bfd5eaf87e4,1,3,3,6,2,2014-07-07 05:44:40,2014-07-05 21:22:45
e2f2a202791293f2152a382852885bfd5eaf87e4...71fc4d9486ed13276e0f27ab755e6e233d91c714,1,2,1,3,1,2014-07-07 09:00:10,2014-07-07 06:29:59
71fc4d9486ed13276e0f27ab755e6e233d91c714...b87ca794e31096b61ead46911baf92ba1c020a7d,3,3,3,6,3,2014-07-10 12:21:50,2014-07-09 01:06:05
b87ca794e31096b61ead46911baf92ba1c020a7d...7f86baf5c7713b6bd541b549352795fe8a55b9de,1,1,0,1,1,2014-07-12 09:35:26,2014-07-12 09:35:26
7f86baf5c7713b6bd541b549352795fe8a55b9de...a96d6603b3be28b97029d5d150e761aeb172434d,2,79,2,81,5,2014-07-15 08:38:23,2014-07-09 09:16:45
a96d6603b3be28b97029d5d150e761aeb172434d...9d9fc3fa3063c9117119c56e69679269250c1213,1,2,2,4,1,2014-07-15 08:43:59,2014-07-15 08:43:59
9d9fc3fa3063c9117119c56e69679269250c1213...1d3d8c0e5545b1f253dbe4c3525eeb2f1312b689,2,9,1,10,2,2014-07-17 11:16:29,2014-07-17 05:55:07
1d3d8c0e5545b1f253dbe4c3525eeb2f1312b689...3530fa9cd09f8db8101c4649cab03bcdf760c434,2,48,3,51,4,2014-07-18 10:57:18,2012-12-21 17:52:00
3530fa9cd09f8db8101c4649cab03bcdf760c434...eba7aae107cb3b482e13b0e88908436fe69a3109,1,34,2,36,5,2014-07-23 14:56:49,2014-07-21 18:12:11
eba7aae107cb3b482e13b0e88908436fe69a3109...96b166f291ed2323a079146c484adef055008257,1,3,2,5,2,2014-07-23 19:09:41,2014-07-19 21:34:41
96b166f291ed2323a079146c484adef055008257...93390ffc209b49d136d92581f55ce65a2f156b0b,24,369,183,552,52,2014-07-23 19:51:14,2014-07-23 19:51:14
93390ffc209b49d136d92581f55ce65a2f156b0b...338ba2bc806ca1de7da7e55e164e460c1aa3cf88,1,23,12,35,6,2014-07-23 19:55:24,2014-07-23 19:55:24
338ba2bc806ca1de7da7e55e164e460c1aa3cf88...38f6fcd822103f7e896532239c60c47b8fcc7d22,2,18,2,20,2,2014-07-29 08:34:49,2014-07-29 08:34:49
38f6fcd822103f7e896532239c60c47b8fcc7d22...9f36c0d235f4eb7e6528face49c15045a5e41e14,1,13,0,13,1,2014-07-31 07:52:01,2014-07-30 10:54:36
9f36c0d235f4eb7e6528face49c15045a5e41e14...befbbad0513c5f1075c573570a678d148b645a82,9,228,13,241,22,2014-07-31 15:53:24,2014-07-23 01:03:10
befbbad0513c5f1075c573570a678d148b645a82...9d281934df9c7f38c4c750640dc7a915315ad125,1,0,1,1,1,2014-07-31 15:58:33,2014-03-30 08:51:01
9d281934df9c7f38c4c750640dc7a915315ad125...4f1ae11a62b97052bc83756f8cb8700cc1f61661,1,3,2,5,2,2014-07-31 15:59:46,2014-03-25 21:47:05
4f1ae11a62b97052bc83756f8cb8700cc1f61661...1223cafea647e2af4580f4990dc313abf4f7a802,424,6747,2536,9283,1079,2014-07-31 16:05:30,2014-07-31 16:05:30
1223cafea647e2af4580f4990dc313abf4f7a802...530af9cb8e700e7596b3ec812bad123c9fa06356,1,2,7,9,2,2014-07-31 16:26:09,2014-07-30 22:33:52
530af9cb8e700e7596b3ec812bad123c9fa06356...716987987966d21766fc4188d0c0041afe335437,10,125,10,135,15,2014-07-31 16:31:01,2014-07-31 16:31:01
716987987966d21766fc4188d0c0041afe335437...bc0ff830aff1e016163d855e86ded5c98b0899e8,3,42,2,44,3,2014-07-31 17:24:06,2014-07-31 17:24:06
98c69e892c4cf105353080777cc60fdba8477487...4f2b08c523c1cd65309c008c3cdd0503c68e863e,2,3,3,6,3,2014-07-31 18:12:08,2014-07-31 18:12:08
4f2b08c523c1cd65309c008c3cdd0503c68e863e...92518892ec8d99a04cee9d51ab071087f06032d2,1,1,1,2,1,2014-07-31 18:59:30,2014-06-25 17:08:46
92518892ec8d99a04cee9d51ab071087f06032d2...8e2cc69e7883b0a8d97a2f62e301ece209f61352,2,9,1,10,2,2014-08-01 20:01:23,2014-06-09 01:58:53
8e2cc69e7883b0a8d97a2f62e301ece209f61352...2fd7ee12d9ee02cc310bd1126a9f09a6a7abe630,2,40,2,42,2,2014-08-02 07:41:13,2014-07-31 23:44:15
2fd7ee12d9ee02cc310bd1126a9f09a6a7abe630...6f043940bdcbfb5272be8ae959cd74b9fb5cf4f8,2,34,0,34,2,2014-08-04 19:00:40,2014-08-04 16:52:35
6f043940bdcbfb5272be8ae959cd74b9fb5cf4f8...53b4accb6e5747b156be91a2b90f42607e33a7cc,1,8,1,9,2,2014-08-04 22:11:36,2014-08-04 20:43:50
53b4accb6e5747b156be91a2b90f42607e33a7cc...70cc9968f667ce110a3a99db6a24b64eb8a3c32e,1,9,1,10,4,2014-08-06 21:46:18,2014-08-03 00:27:02
70cc9968f667ce110a3a99db6a24b64eb8a3c32e...cc08106d6283040fc4c58005b639dae366b18b67,1,7,1,8,1,2014-08-07 18:27:12,2014-08-06 03:21:59
cc08106d6283040fc4c58005b639dae366b18b67...d6b4766a78bca2a9644057f983f3ad8c81e57646,1,4,0,4,2,2014-08-07 19:19:33,2014-08-07 18:56:34
d6b4766a78bca2a9644057f983f3ad8c81e57646...b0277f35bd86d441255dc5a4c19e577e03f03a47,1,38,24,62,13,2014-08-07 23:06:59,2014-07-31 23:16:42
b0277f35bd86d441255dc5a4c19e577e03f03a47...5d824c89c9c513bf56be82eb6432290920a0ebc2,178,3469,6019,9488,1006,2014-08-13 16:26:42,2014-08-07 09:36:56
5d824c89c9c513bf56be82eb6432290920a0ebc2...6b97c2e98627b5189e01b871f9130b5efc41988d,1,13,6,19,5,2014-08-13 16:26:53,2013-12-11 17:19:04
6b97c2e98627b5189e01b871f9130b5efc41988d...fd80a31e0697d6317ce8c2d289575399f4e06d21,1,50,56,106,12,2014-08-14 15:29:28,2014-08-14 15:29:28
fd80a31e0697d6317ce8c2d289575399f4e06d21...181b8a5d3af2e14c50dd32e1f16bf553fd3c7050,4,13,5,18,7,2014-08-17 10:19:14,2014-08-17 10:19:14
181b8a5d3af2e14c50dd32e1f16bf553fd3c7050...ffd0116eda9f48eacc1ce8772c5a85516871a2f9,4,5,13,18,7,2014-08-18 13:57:26,2014-08-18 13:57:26
ffd0116eda9f48eacc1ce8772c5a85516871a2f9...d1dd0d6b388a254468a0d3fa92b7a51847611a0f,1,2,2,4,2,2014-08-18 13:58:36,2014-08-18 13:58:36
d1dd0d6b388a254468a0d3fa92b7a51847611a0f...6a11bfe74bcbb4fbafb8877322c847fc2e2befc2,187,1996,660,2656,360,2014-08-19 15:17:36,2014-08-19 15:17:36
6a11bfe74bcbb4fbafb8877322c847fc2e2befc2...7fabdc23d843cb705d2d0739e7bbdaaf50aa3292,3,23,2,25,3,2014-08-19 15:19:52,2014-08-19 15:19:52
3998914ec8de55521c5592f090e6956ff83eeaab...adf2cfd54da2ffe3206a913d595dd3875ff73272,1,2,2,4,2,2014-08-19 22:12:30,2014-08-19 22:12:30
adf2cfd54da2ffe3206a913d595dd3875ff73272...3122e0eae64c5ab494b29d0a9cadef902d93f1f9,1,8,3,11,3,2014-08-22 10:19:08,2014-08-21 23:59:35
3122e0eae64c5ab494b29d0a9cadef902d93f1f9...ada85d73070b9a565a4a475be919bfae0c95db43,9,5659,17,5676,18,2014-08-26 20:18:55,2014-08-22 10:21:50
ada85d73070b9a565a4a475be919bfae0c95db43...f39e608c6eb11c91839ea4661caece1f89f1b12f,1,5,0,5,1,2014-08-26 20:20:10,2014-08-24 22:19:15
f39e608c6eb11c91839ea4661caece1f89f1b12f...0f2956192c51abc6fc8311102b004f1e975e157f,2,15,8,23,3,2014-08-27 09:49:16,2014-08-26 08:39:25
0f2956192c51abc6fc8311102b004f1e975e157f...b869797a2de4c806382975f4114aac8841edcb15,1,5,12,17,1,2014-08-27 10:36:04,2014-08-04 10:44:06
b869797a2de4c806382975f4114aac8841edcb15...8e60b4523cc9097aad81e0dbbc6d24617c279e66,1,50,0,50,1,2014-09-02 18:22:57,2014-08-26 18:45:12
8e60b4523cc9097aad81e0dbbc6d24617c279e66...627c1a92ebc3be841becd01937aa273bc73ba0a5,2,9,1,10,4,2014-09-03 13:35:18,2014-09-02 11:53:36
627c1a92ebc3be841becd01937aa273bc73ba0a5...7c5fabe4053c82806b0a22437bceab8aa7465b78,1,7,7,14,4,2014-09-15 13:17:05,2014-09-03 11:45:36
7c5fabe4053c82806b0a22437bceab8aa7465b78...0664ddc093961d771b22fafae4f38b0f38140ebf,1,23,0,23,1,2014-09-15 22:41:38,2013-11-11 19:51:34
0664ddc093961d771b22fafae4f38b0f38140ebf...6e689ece46726f39bdf93f1f35e01656f8fe27dc,3,61,0,61,4,2014-09-16 22:23:04,2014-09-16 17:14:24
6e689ece46726f39bdf93f1f35e01656f8fe27dc...1fddc1fee84785d296e37337dcb0dc12c13a049f,2,40,24,64,8,2014-09-16 22:24:19,2014-09-13 12:08:25
1fddc1fee84785d296e37337dcb0dc12c13a049f...daca803e9e333d85213a334f692e30e556e6e146,502,19055,8030,27085,1957,2014-09-16 22:38:50,2014-09-16 22:38:50
daca803e9e333d85213a334f692e30e556e6e146...0fe0d121551593c23a565db8397f85f17bb0f00e,3,21,2,23,3,2014-09-16 22:47:52,2014-09-16 22:47:52
1a8b0e807fbe818f53c26635d31ece494704c64a...84952da24192da98746573f1086b7f393f423a3c,1,2,2,4,2,2014-09-16 23:53:10,2014-09-16 23:53:10
84952da24192da98746573f1086b7f393f423a3c...542ac7f3d204be52c829f25270e840933e397bc0,2,9,3,12,4,2014-09-17 22:13:34,2014-09-17 21:26:46
542ac7f3d204be52c829f25270e840933e397bc0...c8e0bdd7cf628ee2f3f79e5538132467bbc50b4a,1,15,2,17,2,2014-09-23 11:53:58,2014-09-03 13:01:15
c8e0bdd7cf628ee2f3f79e5538132467bbc50b4a...d87ae24dfe148e8bd524c57cfd2c9fe0d3dfce93,1,1,1,2,1,2014-09-26 06:31:10,2014-09-23 12:49:14
d87ae24dfe148e8bd524c57cfd2c9fe0d3dfce93...2b7c8a2f02c2e132c2dbc59bd05e0e7246e10196,3,10,2,12,3,2014-10-13 21:17:39,2014-10-13 18:34:42
2b7c8a2f02c2e132c2dbc59bd05e0e7246e10196...641cea092699aaeba8c61ed5ca864f0a219d5c43,2,12,3,15,6,2014-10-13 21:17:39,2014-10-13 20:09:17
641cea092699aaeba8c61ed5ca864f0a219d5c43...1524d483336e1fba1c62693f65e79c2f251cd36a,4,821,402,1223,112,2014-10-13 21:17:39,2014-06-17 00:38:00
1524d483336e1fba1c62693f65e79c2f251cd36a...6a95e9f7e01b06e5318ef01b0be7bbc00ef43a3d,1,5,0,5,2,2014-10-15 09:19:54,2014-10-15 09:08:33
6a95e9f7e01b06e5318ef01b0be7bbc00ef43a3d...0ec78c961b32abf732620682678439c51f74dc86,1,12,4,16,4,2014-10-15 15:39:40,2014-10-15 08:58:01
0ec78c961b32abf732620682678439c51f74dc86...d6712917f5842fb7124f85902b7e6f68f12f4865,1,10,1,11,2,2014-10-15 15:39:56,2014-10-15 15:28:16
d6712917f5842fb7124f85902b7e6f68f12f4865...e0e38c2f470d1d82579aee28638685be39913e36,97,2418,714,3132,444,2014-10-15 21:06:03,2014-10-15 16:50:09
e0e38c2f470d1d82579aee28638685be39913e36...707cc25011d142fe4ade14ce2aa083a96ef15bcb,1,1,2,3,1,2014-10-15 21:07:00,2014-10-15 16:50:15
707cc25011d142fe4ade14ce2aa083a96ef15bcb...c1f4aacc75c0a64a81a2be8d6a3a23aa21a31b15,1,6,6,12,6,2014-10-15 21:49:41,2014-10-15 21:48:05
c1f4aacc75c0a64a81a2be8d6a3a23aa21a31b15...d601c76f4d728dd7adfa2fbbed2fe86de2e6b479,10,299,7,306,25,2014-10-16 00:36:05,2014-10-15 20:56:40
d601c76f4d728dd7adfa2fbbed2fe86de2e6b479...2afa3d8a03f1f0798d83dc57abc252bb78b7e591,1,7,1,8,2,2014-10-16 01:36:36,2014-10-16 01:23:42
2afa3d8a03f1f0798d83dc57abc252bb78b7e591...3859fbdb7dfa4132a77dbdc446f73f6ab8a10404,1,7,3,10,2,2014-10-16 01:48:34,2014-01-28 01:39:45
3859fbdb7dfa4132a77dbdc446f73f6ab8a10404...3139fa20d78260399a1e5b577690007a8a451c73,1,0,4,4,4,2014-10-16 16:45:47,2014-10-16 16:45:47
3139fa20d78260399a1e5b577690007a8a451c73...b259f245f8772a069fcc9218c33669962801e300,1,1,1,2,1,2014-10-17 22:14:45,2014-10-17 22:14:45
b259f245f8772a069fcc9218c33669962801e300...226c98649df1aa2fcccec7eec2629436f7609f8e,1,20,0,20,1,2014-10-17 22:15:45,2014-10-17 22:15:45
226c98649df1aa2fcccec7eec2629436f7609f8e...6c8593d4568b59770aeb5b2cfa1fdc23ac422523,2,22,12,34,6,2014-10-17 22:16:26,2014-10-17 22:16:26
6c8593d4568b59770aeb5b2cfa1fdc23ac422523...1349b680badeb5d08ad82811af8350dc3e0f0397,7,21,251,272,13,2014-10-20 21:35:18,2014-10-18 00:47:05
1349b680badeb5d08ad82811af8350dc3e0f0397...35443862a2319c31db50ea540d682f7614d9d959,10,160,44,204,33,2014-10-20 23:13:29,2014-10-20 23:13:29
6c8593d4568b59770aeb5b2cfa1fdc23ac422523...7dbc024c8573670170d4f561c01ae892d06399db,1,12,0,12,2,2014-10-20 09:41:15,2014-10-19 14:31:22
35443862a2319c31db50ea540d682f7614d9d959...fe2e8a4a24c01b9d67806e82a2dbfd28cfc04f6f,3,26,2,28,3,2014-10-21 00:43:37,2014-10-21 00:43:37
fe2e8a4a24c01b9d67806e82a2dbfd28cfc04f6f...b9283cf9d17a51f9654b438216ecb743ed69a7ce,3,167,20,187,6,2014-10-23 17:44:56,2014-10-22 17:27:56
b9283cf9d17a51f9654b438216ecb743ed69a7ce...69080f5474369fc7fc4be7ab74ad2e1619eb2fbc,1,6,1,7,1,2014-10-23 17:45:04,2014-10-22 19:14:10
69080f5474369fc7fc4be7ab74ad2e1619eb2fbc...8d045a30e95602b443eb259a5021d33feb4df079,3,745,0,745,3,2014-10-23 17:45:12,2014-10-23 00:58:16
d435f4b3eb53011f3dd00230e1818fa2720d6beb...88bd95cfef5973de0027b8eb5210e5e97252c7e2,1,2,2,4,2,2014-11-11 17:39:57,2014-11-07 15:05:00
88bd95cfef5973de0027b8eb5210e5e97252c7e2...5ff59453a483a43f1563504989f8e2d0ec253de1,1,7,4,11,1,2014-11-14 20:33:34,2014-11-14 18:58:54
5ff59453a483a43f1563504989f8e2d0ec253de1...13a992b1c2e1d0e69567fb94bc35f978c4c37ce5,1,3,3,6,3,2014-11-19 00:19:21,2014-10-27 18:03:13
13a992b1c2e1d0e69567fb94bc35f978c4c37ce5...2ff29cc7e35f486daf86710fd2db48275442c788,1,8,20,28,4,2014-11-19 00:19:52,2014-09-26 05:19:40
2ff29cc7e35f486daf86710fd2db48275442c788...e17c5a72b23f920f291d61f2780068c18768cb92,2,31,10,41,6,2014-11-19 00:20:06,2014-09-26 05:28:33
e17c5a72b23f920f291d61f2780068c18768cb92...70dafa7b624abd43432e03304d65cc527fbecc11,2,13,0,13,4,2014-11-19 00:20:21,2014-09-29 18:26:43
70dafa7b624abd43432e03304d65cc527fbecc11...8032a210250c86877898331ac4474f39b3a573c6,1,72,21,93,8,2014-11-19 00:20:31,2014-10-08 20:30:38
8032a210250c86877898331ac4474f39b3a573c6...fbff7054a47551387a99244e2cf0631f30406798,4,44,10,54,8,2014-11-19 00:37:54,2014-11-19 00:37:54
fbff7054a47551387a99244e2cf0631f30406798...caeb67735baa8e069902e23f21d01033907c4f33,4,364,31,395,7,2014-11-19 00:39:39,2014-10-30 02:55:16
caeb67735baa8e069902e23f21d01033907c4f33...a1b2875afd9affd3e0147a10f04a2daf8c598761,1,2,4,6,2,2014-11-19 00:42:10,2014-11-19 00:42:10
a1b2875afd9affd3e0147a10f04a2daf8c598761...3a08b7c3e0bc6757e7088919695336ab94c3b415,1,68,33,101,18,2014-11-19 03:28:46,2014-10-28 17:42:50
3a08b7c3e0bc6757e7088919695336ab94c3b415...0d051238be2e07e671d7d9f4f444e0cc1efadf1b,2,12,1,13,3,2014-11-26 20:27:57,2014-11-26 20:27:57
0d051238be2e07e671d7d9f4f444e0cc1efadf1b...3c9c920f5702955ea1c438cf5d932086a617353f,1,241,0,241,1,2014-12-04 13:57:48,2013-11-09 22:01:26
3c9c920f5702955ea1c438cf5d932086a617353f...479b0b4e5430297d959ff60d659087c559408753,1,30,70,100,18,2014-12-04 13:57:48,2013-11-09 22:31:54
479b0b4e5430297d959ff60d659087c559408753...f9456a2d3657145878dfcae52af1defc1e22e3bb,2,30865,373,31238,17,2014-12-04 13:57:48,2013-11-09 22:32:12
f9456a2d3657145878dfcae52af1defc1e22e3bb...8c868989be778246bc4b9558f087d0f93724b83d,1,2,1,3,2,2014-12-04 15:10:13,2014-11-06 19:03:08
8c868989be778246bc4b9558f087d0f93724b83d...5e503f45d2a147d37c5cd4970498b764024382d6,2,3,3,6,3,2014-12-05 22:12:48,2014-12-05 22:09:57
5e503f45d2a147d37c5cd4970498b764024382d6...f5cb330ab13de7d80aac6891f07abcb1b73da615,1,4,5,9,1,2014-12-07 03:27:05,2014-12-06 06:44:46
f5cb330ab13de7d80aac6891f07abcb1b73da615...8120015f4078e05ad350bb71b2839f1ce7bbc7f9,1,4,4,8,4,2014-12-08 23:23:22,2014-11-23 23:54:21
8120015f4078e05ad350bb71b2839f1ce7bbc7f9...1c031c84d25859cf7896b50996fe7e2f0dab5380,18,172,33,205,41,2014-12-09 20:41:46,2014-12-09 20:13:52
1c031c84d25859cf7896b50996fe7e2f0dab5380...d230fa9eb7364edac09f65a27e11718671d8e773,1,1,1,2,1,2014-12-12 07:27:49,2014-10-24 03:56:07
d230fa9eb7364edac09f65a27e11718671d8e773...0603c8345b7c40f9723277d5ae1f44041627dbab,1,4,2,6,3,2014-12-15 20:29:36,2014-12-01 20:27:33
0603c8345b7c40f9723277d5ae1f44041627dbab...69b122a6422e3be0417ba3ccf62f3ba914baff91,1,1,1,2,1,2014-12-15 21:55:11,2014-12-10 17:04:33
69b122a6422e3be0417ba3ccf62f3ba914baff91...813114dab05231b71f3cdc4f5889b9833d9a1d06,2,1,2,3,2,2014-12-15 23:36:00,2014-12-15 23:36:00
813114dab05231b71f3cdc4f5889b9833d9a1d06...934bfe23a16556d05bfb1844ef4d53e8c9887c3d,2,144,47,191,15,2014-12-16 19:44:23,2014-08-20 07:08:32
934bfe23a16556d05bfb1844ef4d53e8c9887c3d...33f74bbd900269b13c0122bf55869c3171c20a86,209,46440,3774,50214,1462,2014-12-16 23:35:09,2014-12-02 23:28:24
33f74bbd900269b13c0122bf55869c3171c20a86...710845cfd36a0602bc484b0d980d7a20647c2f6e,1,13,2,15,3,2014-12-16 23:35:09,2014-12-01 05:18:53
710845cfd36a0602bc484b0d980d7a20647c2f6e...bddea12026800b76fee58416fadb867a8b54c837,1,4,5,9,3,2014-12-16 23:35:09,2014-12-03 05:07:14
bddea12026800b76fee58416fadb867a8b54c837...0ff51c6e063e3eea9e4d9ea68edc82d935626fc7,1,1,1,2,1,2014-12-17 19:47:26,2014-11-28 23:33:35
0ff51c6e063e3eea9e4d9ea68edc82d935626fc7...45f1330425b671905a02fe30ee7a1dd9544c2709,2,8,6,14,8,2014-12-17 19:47:26,2014-11-28 23:33:45
45f1330425b671905a02fe30ee7a1dd9544c2709...542234ad984fd1fd90958f07f7f122530e7fb9c6,1,78,10,88,4,2014-12-17 19:54:31,2014-11-18 20:56:28
e59eca58ad62bb3166787de524233854fc6a6545...ea69dd7584a9af9a83fd4b5f4eb0a3f297a46004,1,2,2,4,2,2014-10-23 19:13:05,2014-10-23 19:13:05
ea69dd7584a9af9a83fd4b5f4eb0a3f297a46004...523929c9272a53c9429616564a45f2af59670e47,10,11,1,12,11,2014-10-25 07:36:04,2014-10-22 22:57:51
542234ad984fd1fd90958f07f7f122530e7fb9c6...52795f8fcc2de77cf997e671ea58614e5e425dfe,3,34,4,38,5,2014-12-17 21:21:23,2014-12-17 21:21:23
542234ad984fd1fd90958f07f7f122530e7fb9c6...f75a8ad7237f3bbe33d73725805c422f20f391ba,1,0,6,6,1,2014-12-17 20:08:22,2014-12-17 19:58:09
f75a8ad7237f3bbe33d73725805c422f20f391ba...1eb1e0a9af9b5f0782f4b877f6e50247e0276ba1,1,1,0,1,1,2014-12-17 20:37:30,2014-11-27 08:10:21
1eb1e0a9af9b5f0782f4b877f6e50247e0276ba1...afb488db868742408935fc8f05e859985bc1dac0,1,0,1,1,1,2014-12-17 20:45:23,2014-12-17 20:45:23
a6757fb9d09ad10304378309cfb45659bb5c53f1...1b81ea827674c6a0aaf4b2ce80fe4c66c86ac243,1,2,2,4,2,2014-12-17 22:39:51,2014-12-17 22:39:51
1b81ea827674c6a0aaf4b2ce80fe4c66c86ac243...78db74dd88bdf4159da4d278e89b0781119633d5,2,40,1,41,2,2014-12-19 23:41:55,2014-12-19 00:51:08
78db74dd88bdf4159da4d278e89b0781119633d5...1425ccd1b2baca267d3201bfc219e28bb84989fd,2,167,0,167,5,2014-12-20 01:11:40,2014-12-18 19:54:29
1425ccd1b2baca267d3201bfc219e28bb84989fd...fd2cb7c611595f1d9095e3087b06939d22238540,4,221,35,256,9,2014-12-22 19:45:31,2014-12-18 23:36:21
fd2cb7c611595f1d9095e3087b06939d22238540...48536394c954b2e3e41dcaee3778373ea79e2c25,1,13,5,18,4,2014-12-22 20:12:48,2014-12-19 17:53:20
48536394c954b2e3e41dcaee3778373ea79e2c25...102a861ec2e79ee78d8b8526fa410aac5db18753,1,42,9,51,4,2014-12-22 20:24:28,2014-12-19 17:46:44
102a861ec2e79ee78d8b8526fa410aac5db18753...a363f61ca839e817eb6853c5dc5af8c3b9b9226b,3,12,2,14,3,2014-12-22 21:22:32,2014-12-22 21:22:32
cd6dff972823cc1ad2dd4f1f393d40bb66cfa4d6...fe2019699add29bd903679b56498eef97dda2b4e,1,2,2,4,2,2014-12-24 01:31:00,2014-12-24 01:31:00
fe2019699add29bd903679b56498eef97dda2b4e...6ebd85e10535dfaa9181842fe73834e51d4d3e6c,7,7,26,33,7,2015-01-13 00:49:07,2014-11-27 06:15:54
6ebd85e10535dfaa9181842fe73834e51d4d3e6c...31051e5c7b253b6a0006b536188fc0494bd6e082,2,6,8,14,8,2015-01-13 19:25:09,2015-01-08 20:17:54
31051e5c7b253b6a0006b536188fc0494bd6e082...0a430b9aecf6a82fba5d76a41dba9b5279e8ce89,1,4,4,8,1,2015-01-13 22:54:44,2014-12-23 17:04:46
0a430b9aecf6a82fba5d76a41dba9b5279e8ce89...0c50195071a57bc40df82c8f57d341a435ff1eb6,2,0,57,57,2,2015-01-14 23:26:48,2015-01-07 21:51:15
0c50195071a57bc40df82c8f57d341a435ff1eb6...e45c52c573cc2799749050c60228a769231674f8,1,1,1,2,1,2015-01-20 15:39:10,2015-01-09 17:55:32
e45c52c573cc2799749050c60228a769231674f8...b28c76e9d265d42934adc7833c77f57c1d80d6eb,116,1983,5362,7345,566,2015-01-21 19:39:54,2015-01-11 13:08:14
b28c76e9d265d42934adc7833c77f57c1d80d6eb...deef605085be2dcd76bd2538ec32691e60a5e362,17,34,81,115,25,2015-01-21 19:39:54,2015-01-17 04:24:23
deef605085be2dcd76bd2538ec32691e60a5e362...f5e9b6e84a47a6990bd3b44d004026a6f0faaba2,1,1,2,3,2,2015-01-21 19:39:54,2015-01-11 15:33:19
f5e9b6e84a47a6990bd3b44d004026a6f0faaba2...9e387fb611e29aad3118e0b226199fdc70bbd0cd,1,1,1,2,1,2015-01-21 19:39:55,2015-01-11 13:08:27
9e387fb611e29aad3118e0b226199fdc70bbd0cd...6168fe6720650052728f3e78a495b723f0b41ce3,1,2,0,2,2,2015-01-23 23:17:05,2015-01-23 23:08:01
6168fe6720650052728f3e78a495b723f0b41ce3...09b482886bdd3d863c3d4e7d71264eac0daaf9e1,2,11,2,13,2,2015-01-26 18:28:23,2015-01-26 18:28:23
6b264dd1f93e521ffaa1afce489841a41d54176e...ff32b81516ea0bb738cc8dd6bd0ce3a23532651d,1,2,2,4,2,2015-01-26 20:28:48,2015-01-26 20:28:48
ff32b81516ea0bb738cc8dd6bd0ce3a23532651d...431eb172f97434a3b0868a610bc14d8ff7d9efd9,1,9,0,9,2,2015-02-04 19:46:17,2015-01-16 12:44:42
431eb172f97434a3b0868a610bc14d8ff7d9efd9...ad0684807c474db5cda7d28592e34e19910eb7ab,2,10,2,12,2,2015-02-09 21:49:10,2015-01-11 22:55:12
ad0684807c474db5cda7d28592e34e19910eb7ab...c8239c08d7ad7d375683fd85745b30da789bb591,2,55,15,70,10,2015-02-18 02:08:11,2015-02-13 22:38:59
c8239c08d7ad7d375683fd85745b30da789bb591...d01a900078abe4ea6159bc827ee0189a04459c8a,1,1,1,2,1,2015-03-05 01:44:53,2014-11-14 00:55:16
d01a900078abe4ea6159bc827ee0189a04459c8a...8bcd0a4c4a8e3d748bea53d036985609ea634b8d,1,0,4,4,1,2015-03-05 19:16:52,2015-01-13 18:40:05
8bcd0a4c4a8e3d748bea53d036985609ea634b8d...dcff5d565c000904cabf48c627534a779a40527a,26,595,105,700,74,2015-03-06 19:37:40,2015-02-24 10:05:39
dcff5d565c000904cabf48c627534a779a40527a...a5be84fe9b6862b9d132f87bcc915285e40432e2,2,2,10,12,2,2015-03-06 20:44:06,2015-02-20 22:00:32
a5be84fe9b6862b9d132f87bcc915285e40432e2...51fe319faf4399fd027f8b32d1c425200b911e44,1,31,22,53,24,2015-03-10 23:33:57,2015-03-08 02:52:18
51fe319faf4399fd027f8b32d1c425200b911e44...f2a45caf2e1b73fea01fa9a941bc61096a999664,2,54,7,61,4,2015-03-11 06:22:16,2015-03-09 22:27:04
f2a45caf2e1b73fea01fa9a941bc61096a999664...219c80d0996304ebb98383eb7eeead2135e37f15,1,2,2,4,2,2015-03-11 23:25:36,2015-03-11 18:45:57
219c80d0996304ebb98383eb7eeead2135e37f15...7d6b5b1d5ba726331f9ccaaae59af7cd53eee82e,3,21,2,23,3,2015-03-11 23:30:44,2015-03-11 18:31:30
50c23fb381c25c72538c2dce549bd26cdd03098a...4332c77bf7fd5f780fcdac5cac24a876883d8840,1,2,2,4,2,2015-03-12 04:13:15,2015-03-12 04:13:15
