id,files,locs added,locs removed,locs total,hunks,commit time,author time
4b825dc642cb6eb9a060e54bf8d69288fbee4904...e20401e04e057a39c228dbb99dda68ec7fa4235a,1,3,0,3,1,2009-08-28 18:14:03,2009-08-28 18:14:03
e20401e04e057a39c228dbb99dda68ec7fa4235a...5da20b9dddb1f7a9110675ded5df59c4c3ed1b83,12,259,0,259,12,2009-08-28 18:14:17,2009-08-28 18:14:17
5da20b9dddb1f7a9110675ded5df59c4c3ed1b83...ada3ce5045b44c24ea84cacdffb34e3e9382b385,1,1,2,3,2,2009-08-28 18:18:21,2009-08-28 18:18:21
ada3ce5045b44c24ea84cacdffb34e3e9382b385...4e2b71bab88cac16d40d12675dcd3949191dff60,1,9,3,12,1,2009-08-28 18:19:22,2009-08-28 18:19:22
4e2b71bab88cac16d40d12675dcd3949191dff60...39f8b30d4d1a157e2b0ffa2f2e50427e50563ce7,1,3,13,16,1,2009-08-28 18:37:53,2009-08-28 18:37:53
39f8b30d4d1a157e2b0ffa2f2e50427e50563ce7...14b219b5a282f4d2c1df67da533ff23cf0c03fac,1,10,0,10,4,2009-08-28 18:43:19,2009-08-28 18:43:19
14b219b5a282f4d2c1df67da533ff23cf0c03fac...d1e1869abfca8b6445095c5203d44c2fbbf3b03c,1,8,0,8,1,2009-08-28 18:46:01,2009-08-28 18:46:01
4e2b71bab88cac16d40d12675dcd3949191dff60...050a2b2c25b1575c4e870dbe1a6f371fea80b2d7,1,0,2,2,1,2009-08-28 18:35:22,2009-08-28 18:35:22
b5104350823ab936c93790b66fae8f50bfe81ae4...627a61a0651370c6b4285cddf8d83ecd526c3d32,1,1,1,2,1,2009-08-28 18:50:58,2009-08-28 18:50:58
627a61a0651370c6b4285cddf8d83ecd526c3d32...dcd664e41246c9ae6007c2e7fb6b1420fbcd2207,1,4,0,4,1,2009-08-28 18:53:43,2009-08-28 18:53:43
dcd664e41246c9ae6007c2e7fb6b1420fbcd2207...5dd3755ed54bea647fa9b5ca36d4ae21e31e7de8,1,1,1,2,1,2009-08-28 18:54:28,2009-08-28 18:54:28
5dd3755ed54bea647fa9b5ca36d4ae21e31e7de8...c1ac59d29a8ff69fab7225785c0758014fc0bbe2,1,2,1,3,1,2009-08-28 19:21:43,2009-08-28 19:21:43
c1ac59d29a8ff69fab7225785c0758014fc0bbe2...8b517ff666afcd06a96045b6c74887e394dfa297,2,4,13,17,4,2009-08-31 00:40:54,2009-08-31 00:40:54
8b517ff666afcd06a96045b6c74887e394dfa297...f39adb8d8cfa86ef1f8832c2285028c4fdb8b611,1,0,2,2,1,2009-08-31 00:41:31,2009-08-31 00:41:31
f39adb8d8cfa86ef1f8832c2285028c4fdb8b611...538c54ba8479e99964538755ab49dd47f3edf955,1,1,12,13,6,2009-08-31 00:43:24,2009-08-31 00:43:24
538c54ba8479e99964538755ab49dd47f3edf955...fe8f83cd78e5a514eeee7801a74f196a7d17d580,2,0,3,3,2,2009-08-31 00:46:51,2009-08-31 00:46:51
fe8f83cd78e5a514eeee7801a74f196a7d17d580...95f32b4f8b30fbd62e6df8ca66221cdf6f2cc4d9,1,9,3,12,3,2009-08-31 00:48:43,2009-08-31 00:48:43
95f32b4f8b30fbd62e6df8ca66221cdf6f2cc4d9...1092aba5b819882c75c33be24f97556e03baec26,1,2,0,2,1,2009-08-31 01:00:42,2009-08-31 01:00:42
1092aba5b819882c75c33be24f97556e03baec26...71769107dbff230ec7607368f50f9ff93b88b581,1,24,0,24,1,2009-08-31 01:36:11,2009-08-31 01:36:11
71769107dbff230ec7607368f50f9ff93b88b581...43fd24e81fe83e9c2978e55d1d8f18bc251716f9,2,8,1,9,2,2009-08-31 01:36:38,2009-08-31 01:36:38
43fd24e81fe83e9c2978e55d1d8f18bc251716f9...3ec52a13537ed9c56cf55d1ce7c02a3f6d75fdc4,1,2,1,3,2,2009-08-31 01:44:14,2009-08-31 01:44:14
3ec52a13537ed9c56cf55d1ce7c02a3f6d75fdc4...684eae38af9b00f2c743c7d198c387d5a817ee69,1,1,1,2,1,2009-08-31 01:50:09,2009-08-31 01:49:53
684eae38af9b00f2c743c7d198c387d5a817ee69...13ca4fab1a944799d8a27e28daea6d19fe9dd813,1,3,1,4,1,2009-08-31 01:51:41,2009-08-31 01:51:41
13ca4fab1a944799d8a27e28daea6d19fe9dd813...908fead30300c33a9eadc975309442a5ccf4f859,1,2,2,4,2,2009-08-31 01:54:39,2009-08-31 01:54:39
908fead30300c33a9eadc975309442a5ccf4f859...2c9f74b5c3f6910e7c66601008e9ddd0444b70c7,5,25,1,26,5,2009-08-31 14:45:31,2009-08-31 14:45:31
2c9f74b5c3f6910e7c66601008e9ddd0444b70c7...5af0ba8f91d10aab109febecc730cb8c42f141e6,1,4,0,4,2,2009-08-31 15:12:45,2009-08-31 15:12:45
5af0ba8f91d10aab109febecc730cb8c42f141e6...a19d1c0f53efbbc97eeaee4e496063abf7bf689d,1,2,0,2,1,2009-08-31 16:27:35,2009-08-31 16:27:35
908fead30300c33a9eadc975309442a5ccf4f859...da3be21b4f9dc510e6d6c91a58f3e1abb566369b,1,2,1,3,1,2009-08-31 12:58:53,2009-08-31 12:58:53
da3be21b4f9dc510e6d6c91a58f3e1abb566369b...7a7b0bc7f57ffabaa8e409975be4efe83e6eb924,1,6,1,7,1,2009-08-31 12:59:16,2009-08-31 12:59:16
7a7b0bc7f57ffabaa8e409975be4efe83e6eb924...0f2e63f8995bfaf35b2cfc149866c3be503d3820,1,2,1,3,1,2009-08-31 12:59:34,2009-08-31 12:59:34
0f2e63f8995bfaf35b2cfc149866c3be503d3820...5811a6b11f86a2807ebd57697eaa67947276b61d,1,1,1,2,1,2009-08-31 13:01:39,2009-08-31 13:01:39
5811a6b11f86a2807ebd57697eaa67947276b61d...45f05b9bbc84f0ac934bb137a9ff3a01f7710c5d,1,2,2,4,1,2009-08-31 13:02:19,2009-08-31 13:02:19
45f05b9bbc84f0ac934bb137a9ff3a01f7710c5d...a92158eab3dfce4c7010e600d88dcdcd2fbb8dcb,1,2,1,3,1,2009-08-31 13:03:33,2009-08-31 13:03:33
a92158eab3dfce4c7010e600d88dcdcd2fbb8dcb...3ab0d639d0f6feaf6612badd932542d206fc5450,1,23,1,24,1,2009-08-31 13:03:56,2009-08-31 13:03:56
a19d1c0f53efbbc97eeaee4e496063abf7bf689d...97cf1871ca1e6822200e0ae008cbbe4c24d88a4b,1,4,0,4,1,2009-08-31 18:17:05,2009-08-31 18:17:05
857ec726c8a713db5dbff79e1d3b80ba08e02768...3dfa677ede716cb7dd7026f47dc764fcabe1c823,2,2,0,2,2,2009-08-31 17:46:48,2009-08-31 17:46:48
3dfa677ede716cb7dd7026f47dc764fcabe1c823...df8ad95c6adfc91332e951f21d9a44c8612b0f04,1,0,1,1,1,2009-08-31 17:49:48,2009-08-31 17:49:48
df8ad95c6adfc91332e951f21d9a44c8612b0f04...841cca16a6b355f707585b96f75194381f49590f,1,4,1,5,2,2009-08-31 20:12:58,2009-08-31 20:12:58
841cca16a6b355f707585b96f75194381f49590f...a9c18304621b045d90a2fc328da79f29a2de6b42,1,1,1,2,1,2009-08-31 20:23:35,2009-08-31 20:23:35
a9c18304621b045d90a2fc328da79f29a2de6b42...652caa6b2591e773179b8e38992d516db1f99930,1,1,1,2,1,2009-08-31 20:23:59,2009-08-31 20:23:59
652caa6b2591e773179b8e38992d516db1f99930...076f9b15fff84f58009f73f19292729015d1c888,1,2,1,3,1,2009-08-31 20:25:12,2009-08-31 20:25:12
076f9b15fff84f58009f73f19292729015d1c888...5ace61de4e9d10b3257f9565f246abd28082592c,1,1,1,2,1,2009-08-31 20:49:24,2009-08-31 20:49:24
5ace61de4e9d10b3257f9565f246abd28082592c...845eabc8cc86ebfcab7a9ebca5eb87aa136e9ce3,1,2,2,4,2,2009-08-31 20:51:11,2009-08-31 20:51:11
97cf1871ca1e6822200e0ae008cbbe4c24d88a4b...a26cb28de4d095d547d774a3b3258a76f17507c3,1,2,3,5,2,2009-08-31 20:54:50,2009-08-31 20:54:50
a26cb28de4d095d547d774a3b3258a76f17507c3...6fd7da65a34e9a2e10ccef7e83d974bab63cb99e,1,4,0,4,1,2009-08-31 22:00:15,2009-08-31 22:00:15
6fd7da65a34e9a2e10ccef7e83d974bab63cb99e...e1f5c0c703c60d473144f58e1ab49d51c38ab526,3,28,0,28,3,2009-08-31 22:00:38,2009-08-31 22:00:38
517df8002d7a400899d3f1bd088fead83e2c6074...af8294d2068e3614a7635486de1d89e12e23a8e5,2,2,2,4,2,2009-08-31 21:24:03,2009-08-31 21:24:03
09e2193ae6a4ec64290e2a9be2ec54179f6e3b5b...0ce2fd0940e97fc19e7b3a38c374674bd1edc383,1,0,1,1,1,2009-08-31 22:10:46,2009-08-31 22:10:46
0ce2fd0940e97fc19e7b3a38c374674bd1edc383...1ec8a8848e5fa8f733af92f2c09387719e57e0d5,2,9,0,9,2,2009-08-31 22:48:09,2009-08-31 22:48:09
1ec8a8848e5fa8f733af92f2c09387719e57e0d5...f704193fd2732207c158aa3413e2ef9634e7b17f,1,3,0,3,1,2009-09-01 09:01:26,2009-09-01 09:01:26
f704193fd2732207c158aa3413e2ef9634e7b17f...ebc6ce25aa2aa2c8957724b916711ceee3bb15ce,1,1,0,1,1,2009-09-01 12:41:49,2009-09-01 12:41:49
ebc6ce25aa2aa2c8957724b916711ceee3bb15ce...53abb4e2a70a1e2c0871b83daa4dac6178a61803,1,5,0,5,1,2009-09-01 14:41:18,2009-09-01 14:41:18
53abb4e2a70a1e2c0871b83daa4dac6178a61803...4516bda0190aca430c57b6f8c6f5380db63e3b7e,1,0,0,0,0,2009-09-01 14:43:46,2009-09-01 14:43:46
4516bda0190aca430c57b6f8c6f5380db63e3b7e...af3e48445456cd08256f21add3b602cd513065e8,1,0,0,0,0,2009-09-01 14:45:49,2009-09-01 14:45:49
af3e48445456cd08256f21add3b602cd513065e8...261bf83d534cb129833bda773363e72c3693a2fa,1,1,4,5,2,2009-09-01 14:46:15,2009-09-01 14:46:15
261bf83d534cb129833bda773363e72c3693a2fa...fcc1cde56c1ed8cd0c4961e82dce4a721b4bd66c,1,2,2,4,1,2009-09-01 14:50:45,2009-09-01 14:50:45
fcc1cde56c1ed8cd0c4961e82dce4a721b4bd66c...d1a9efc4e2f054a549787ebba8a1ccced2ec15eb,1,2,2,4,2,2009-09-01 14:52:43,2009-09-01 14:52:43
d1a9efc4e2f054a549787ebba8a1ccced2ec15eb...1978c04daac2bc207c6a12ca05d94aeaefba029c,1,1,1,2,1,2009-09-02 03:34:58,2009-09-02 03:34:58
1978c04daac2bc207c6a12ca05d94aeaefba029c...71c59eaf8554f1677f88423065596f39eb41973f,2,16,7,23,3,2009-09-02 03:46:48,2009-09-02 03:46:48
71c59eaf8554f1677f88423065596f39eb41973f...4c69833eb1e8050a5b081d31b4c2873a18ee30f6,1,3,0,3,1,2009-09-06 12:19:33,2009-09-06 12:19:33
71c59eaf8554f1677f88423065596f39eb41973f...1875755f0a7aee1649b4778959cd9eeced725e01,1,9,0,9,2,2009-09-03 18:45:23,2009-09-03 18:45:23
44465ef4ce41f0928f6c59573da476a559a809a4...b67961d812c7f403aea223f40410bfc34f706b05,2,5,3,8,3,2009-09-07 16:11:34,2009-09-07 16:11:34
b67961d812c7f403aea223f40410bfc34f706b05...86925121069b2b33be6f3b76034ebcae98b14592,1,10,10,20,9,2009-09-07 16:18:40,2009-09-07 16:18:40
86925121069b2b33be6f3b76034ebcae98b14592...85a4e3028990b6583253308ada3d456c291487d7,5,31,4,35,9,2009-09-14 16:42:53,2009-09-14 16:42:53
85a4e3028990b6583253308ada3d456c291487d7...ff8e99beef3c61b66b3d3537634fcc6e07644ef7,1,6,1,7,1,2009-09-14 17:06:47,2009-09-14 17:06:47
ff8e99beef3c61b66b3d3537634fcc6e07644ef7...a9f21b381cd855bc2fe79cb7b8f472d9f41f6bfa,1,3,9,12,2,2009-09-22 18:38:24,2009-09-22 18:38:24
a9f21b381cd855bc2fe79cb7b8f472d9f41f6bfa...9f0df188f4dd820d2f72f8095619709e62808ff5,1,1,1,2,1,2009-09-22 18:48:55,2009-09-22 18:48:55
ff8e99beef3c61b66b3d3537634fcc6e07644ef7...8176645e8231955a7e1a385da9251efd2ddda5c7,2,43,1,44,3,2009-09-22 15:39:53,2009-09-22 15:39:53
8176645e8231955a7e1a385da9251efd2ddda5c7...1b784bbf4d2ce470ade3d0c2963c349a5a7af9cf,1,6,0,6,1,2009-09-22 15:41:22,2009-09-22 15:41:22
9f0df188f4dd820d2f72f8095619709e62808ff5...fff31c33bcb5d98fbceb84ef0341c366c2b1da46,1,6,0,6,1,2009-09-22 23:09:20,2009-09-22 23:09:20
bd5826980ea549d629feff0786f151c985525c98...2b61a2aa3a15de60503dd1e78fbee7fb8e6580a3,1,16,0,16,1,2009-09-22 22:01:55,2009-09-22 22:01:55
2b61a2aa3a15de60503dd1e78fbee7fb8e6580a3...7d511379c1eace3363433352a9e38831785d2e5e,1,5,0,5,1,2009-09-22 22:02:18,2009-09-22 22:02:18
7d511379c1eace3363433352a9e38831785d2e5e...89d86d869c298642e809dfa7530b7ef2539cd07f,4,53,21,74,7,2009-09-22 22:27:28,2009-09-22 22:27:28
89d86d869c298642e809dfa7530b7ef2539cd07f...8fe67686dba78a273b058f7f7e3d26c286d269f2,1,3,4,7,2,2009-09-22 22:36:25,2009-09-22 22:36:25
8fe67686dba78a273b058f7f7e3d26c286d269f2...556ee4198f26731c85bfdd40ee1a2edfee755cb5,1,5,7,12,2,2009-09-22 23:44:57,2009-09-22 23:44:57
556ee4198f26731c85bfdd40ee1a2edfee755cb5...1f05826afb13f3caafce091e438294e7939c57cf,1,6,0,6,1,2009-09-22 23:45:15,2009-09-22 23:45:15
1f05826afb13f3caafce091e438294e7939c57cf...93af38f154174f8af9e2aa71a1a64bdc640c3655,5,17,15,32,8,2009-09-22 23:49:00,2009-09-22 23:49:00
93af38f154174f8af9e2aa71a1a64bdc640c3655...b6d778201bae29d4b713f3651f500df10312f5d1,4,12,1,13,4,2009-09-23 00:18:15,2009-09-23 00:18:15
b6d778201bae29d4b713f3651f500df10312f5d1...1304baf9f9a18818246d1609be9da27f8ff79406,1,3,0,3,1,2009-09-23 00:20:08,2009-09-23 00:20:08
fff31c33bcb5d98fbceb84ef0341c366c2b1da46...2759586aae5bea9ec38bb16403381c73589776ed,1,2,2,4,2,2009-09-23 03:36:28,2009-09-23 03:36:28
2759586aae5bea9ec38bb16403381c73589776ed...8debd097fbea09032c27b2c8d69d8430d7ea0551,11,1,1,2,1,2009-09-23 14:43:36,2009-09-23 14:43:36
8debd097fbea09032c27b2c8d69d8430d7ea0551...107322c2e86db377cc8260958a4b6e26ea849a67,2,3,0,3,1,2009-09-23 15:02:58,2009-09-23 15:02:58
107322c2e86db377cc8260958a4b6e26ea849a67...ef9ce1e221e048b83edbe4def12d4b3a5c1c6dcb,1,3,1,4,1,2009-09-23 15:03:38,2009-09-23 15:03:38
ef9ce1e221e048b83edbe4def12d4b3a5c1c6dcb...19a08f15d6a09b8c7a1f4f306abe6e61bdf7d95d,1,1,1,2,1,2009-09-23 15:05:05,2009-09-23 15:05:05
19a08f15d6a09b8c7a1f4f306abe6e61bdf7d95d...1dc73537320ff86b7597fc097ad82c58aeba0566,1,4,0,4,1,2009-09-23 15:06:32,2009-09-23 15:06:32
1dc73537320ff86b7597fc097ad82c58aeba0566...ff545e6934b70945e778495f613d41a43681b662,1,2,2,4,1,2009-09-23 15:07:02,2009-09-23 15:07:02
8a8a7bafa037ef253ce582a182c77a74b76ac309...f363c025daa1dbf684f80ab7e29d34dbd5fb9d89,4,0,0,0,0,2009-09-23 15:14:43,2009-09-23 15:14:43
f363c025daa1dbf684f80ab7e29d34dbd5fb9d89...700a3f0badf89fc9bb5a8f54b5fd2e14aed2823d,1,28,0,28,1,2009-09-24 00:11:45,2009-09-24 00:11:45
700a3f0badf89fc9bb5a8f54b5fd2e14aed2823d...00a190bc017283ef8ab8c725c5f9fe93f030e31e,3,13,2,15,3,2009-09-24 00:12:19,2009-09-24 00:12:19
00a190bc017283ef8ab8c725c5f9fe93f030e31e...6ef2e1f51c42a1e8b96f5ffc8a5b8f1e715d1738,2,24,9,33,14,2009-10-12 19:17:36,2009-10-12 19:17:36
6ef2e1f51c42a1e8b96f5ffc8a5b8f1e715d1738...11d0b3c2ac271f8d87629c73c9832f135558a6a2,1,3,0,3,1,2009-10-16 20:12:31,2009-10-16 20:12:31
00a190bc017283ef8ab8c725c5f9fe93f030e31e...eddab5034cb19caa99a1a0e381de4dcf63ef0fe0,2,8,8,16,2,2009-10-01 07:55:07,2009-10-01 07:55:07
a75d0ba8d7b256fa2c21b0c8f04cbcab6b9289f2...886d97f41e72b8662232a2c6b196fb60508e4f67,1,3,4,7,3,2009-10-16 21:03:50,2009-10-16 21:03:50
eddab5034cb19caa99a1a0e381de4dcf63ef0fe0...8a8343b0de31f3adcd366fc0b9c113ee009287f0,1,6,0,6,1,2009-10-06 02:23:12,2009-10-06 02:23:12
eddab5034cb19caa99a1a0e381de4dcf63ef0fe0...172bb418304eb4c513f8ae43dd72ff201a046b38,1,4,0,4,1,2009-10-03 17:34:49,2009-10-03 17:34:49
172bb418304eb4c513f8ae43dd72ff201a046b38...60e99779d5658841026acb84483a7deeb6851246,1,1,0,1,1,2009-10-03 17:48:29,2009-10-03 17:48:29
2289cacecbf027e71380ab0c349dee6f902e7b65...fafa15676a8f398c95b909f719b07349df2c7d5b,1,1,1,2,1,2009-10-11 08:50:08,2009-10-11 08:50:08
fafa15676a8f398c95b909f719b07349df2c7d5b...7705ffaf0c38438b0e007f75553876cf5ae99803,1,1,0,1,1,2009-10-11 08:56:22,2009-10-11 08:56:22
7705ffaf0c38438b0e007f75553876cf5ae99803...fdac2b3f04f7b2c42bab7c7f6b53d8c8d32b62a5,1,1,0,1,1,2009-10-11 13:49:24,2009-10-11 13:49:24
fdac2b3f04f7b2c42bab7c7f6b53d8c8d32b62a5...788c9af05684f4b9e39e7f15de2c06c4c8291cbd,1,9,0,9,4,2009-10-11 14:09:10,2009-10-11 14:09:10
2289cacecbf027e71380ab0c349dee6f902e7b65...069e9b8752ddaa85b0e21b8033f0c2075ac42f11,1,7,0,7,1,2009-10-07 22:50:32,2009-10-07 22:50:32
2289cacecbf027e71380ab0c349dee6f902e7b65...cea6040c305d1e645f497e59133c2c5434a430ef,2,9,1,10,2,2009-10-07 20:03:23,2009-10-07 20:01:52
cea6040c305d1e645f497e59133c2c5434a430ef...c1444a96129b665bcbf67e9baad9bf7257c7c650,1,2,2,4,2,2009-10-07 20:08:54,2009-10-07 20:08:54
2289cacecbf027e71380ab0c349dee6f902e7b65...9890bbb24d23e82bbc8f8fea9ffe423fc3eda12a,1,1,1,2,1,2009-10-06 21:19:43,2009-10-06 21:19:43
a175f35bde56d0ce013dc95044ed7de9b888d427...b6c8ef41b1b8ed129f473377d4b8d549fa93b5b9,1,1,0,1,1,2009-10-13 01:34:53,2009-10-13 01:34:53
b6c8ef41b1b8ed129f473377d4b8d549fa93b5b9...c03aab51645fa7448f4e92b09ab00e2de989010e,1,1,1,2,1,2009-10-13 02:13:52,2009-10-13 02:13:52
56693663adbf9d8c5809612bd23324e90ceb4cd6...52f5eb20058796f3f4673b07c0f2c0463ed817b8,1,0,3,3,1,2009-10-26 16:09:00,2009-10-26 16:09:00
52f5eb20058796f3f4673b07c0f2c0463ed817b8...552e4b864a09ff25e8ef1cad169dae193201f214,1,1,0,1,1,2009-10-26 16:09:14,2009-10-12 06:56:55
552e4b864a09ff25e8ef1cad169dae193201f214...1779bedd5362c13e3096873c01c167f329e8fca8,1,1,1,2,1,2009-10-26 16:09:40,2009-10-14 13:12:17
11220ca4959b36f9676f68389bd5b0c8825d6c44...fd6861b8cd3ff12162d89babf27945a50d739ca8,1,3,10,13,3,2009-10-26 16:24:37,2009-10-26 16:24:37
fd6861b8cd3ff12162d89babf27945a50d739ca8...607ba0736b40c089546201f6324bf694c99ace2b,1,9,0,9,1,2009-10-26 17:35:51,2009-10-26 17:35:51
c03aab51645fa7448f4e92b09ab00e2de989010e...b865f2ab38156c33bdb1d6ffc6df56b3f2d53588,2,64,0,64,2,2009-10-26 04:47:23,2009-10-26 04:47:23
c03aab51645fa7448f4e92b09ab00e2de989010e...83907294d640d910968cf9152d11c6a5ab3205f5,1,2,2,4,1,2009-10-23 18:59:24,2009-10-23 18:59:24
607ba0736b40c089546201f6324bf694c99ace2b...83309294df29bba2deaac7a3412eacef5ee89691,1,1,0,1,1,2009-11-01 22:23:03,2009-11-01 22:23:03
607ba0736b40c089546201f6324bf694c99ace2b...c103c15e5c9a51c655d503256bfd005530e5baf6,1,7,0,7,1,2009-10-29 22:18:19,2009-10-29 22:18:19
c103c15e5c9a51c655d503256bfd005530e5baf6...f11366374c233fd37b7df3b98240cac96ee1cf9f,1,1,1,2,1,2009-10-30 17:15:45,2009-10-30 17:15:45
f11366374c233fd37b7df3b98240cac96ee1cf9f...8beb5a50f1e442733a624de73dedff99170b6b71,1,1,1,2,1,2009-10-30 19:41:38,2009-10-30 19:41:38
83309294df29bba2deaac7a3412eacef5ee89691...14a1ce80bbf7362ab2856cdd050714f02649fe3f,2,42,0,42,3,2009-11-08 23:14:52,2009-10-19 22:24:21
14a1ce80bbf7362ab2856cdd050714f02649fe3f...a21525ba0ccbdf35a0524f6cf7f2025fef578c78,1,4,0,4,1,2009-11-08 23:14:52,2009-10-19 22:26:06
a21525ba0ccbdf35a0524f6cf7f2025fef578c78...e24709a2b80c8f829c8ceb66130a4b3a6cb86261,1,6,6,12,2,2009-11-08 23:15:06,2009-10-31 22:16:24
e24709a2b80c8f829c8ceb66130a4b3a6cb86261...8f33231823dbf6c68ccc65fbb028fce6ff1efd74,1,1,1,2,1,2009-11-08 23:15:06,2009-11-06 12:55:08
8f33231823dbf6c68ccc65fbb028fce6ff1efd74...97c66649485e227aba86b6006a6058a981da5092,1,31,0,31,1,2009-11-08 23:15:52,2009-10-16 04:07:02
97c66649485e227aba86b6006a6058a981da5092...286559d18016f0aeaaed96dbea39c71b52c374eb,1,2,2,4,1,2009-11-08 23:24:20,2009-11-08 23:24:20
286559d18016f0aeaaed96dbea39c71b52c374eb...eb05b61483a9e03866404c903468360cb8df370b,1,0,1,1,1,2009-11-08 23:27:17,2009-11-08 23:27:17
eb05b61483a9e03866404c903468360cb8df370b...fc3a3c72b17c0e12ea85094cd8b2575ccf1f2d44,1,7,2,9,2,2009-11-08 23:34:02,2009-11-08 23:34:02
fc3a3c72b17c0e12ea85094cd8b2575ccf1f2d44...5c13930832b3e3bfcfd7b8ea99283ef477903bfd,1,0,4,4,1,2009-11-09 15:33:38,2009-11-09 15:33:38
5c13930832b3e3bfcfd7b8ea99283ef477903bfd...c620408962dd93fe920414eedd8e8e38b241eb08,2,0,42,42,3,2009-11-09 15:33:51,2009-11-09 15:33:51
e53f90425ede1ce823c5d699f80441bb2b6fec3b...e2dba2c3e94115829e9172294410cae4aedc7e96,6,39,41,80,6,2009-11-04 19:37:18,2009-11-04 19:37:18
e2dba2c3e94115829e9172294410cae4aedc7e96...1c65ab9dea8caf834d662d3d20e3b8a83ea609b0,1,6,1,7,3,2009-11-05 19:30:53,2009-11-05 19:30:53
1c65ab9dea8caf834d662d3d20e3b8a83ea609b0...08fcf7dc393d6254fdcd7eef26d3f4ddd1c53a6c,3,17,12,29,5,2009-11-05 19:44:28,2009-11-05 19:44:28
08fcf7dc393d6254fdcd7eef26d3f4ddd1c53a6c...bbef2db92b39c41705e0a3f05da525b5b1eb8901,1,2,1,3,1,2009-11-05 19:48:08,2009-11-05 19:48:08
729fd0ab3cae9636ea8d40b76b80a0763c9150da...147f1dc70212662fc60a5c21f87dda6b22993c74,1,1,1,2,1,2009-11-09 20:38:40,2009-11-09 20:38:40
147f1dc70212662fc60a5c21f87dda6b22993c74...5246e103c54b7e503cb0c7a715a9d88dc5a4f0e1,3,3,3,6,3,2009-11-09 21:05:00,2009-11-09 21:05:00
5246e103c54b7e503cb0c7a715a9d88dc5a4f0e1...e41d7305e55d144c324ba1adf1cf852e576457fc,1,10,1,11,1,2009-11-09 21:28:17,2009-11-09 21:28:17
e41d7305e55d144c324ba1adf1cf852e576457fc...80c20c32ddabac0ea590aba394a7b74128521508,1,1,10,11,1,2009-11-11 16:26:23,2009-11-11 16:26:23
80c20c32ddabac0ea590aba394a7b74128521508...b4712ad693ca38e44e8b1f98308bab152f9c570c,1,5,5,10,3,2009-11-11 17:14:25,2009-11-11 17:14:25
b4712ad693ca38e44e8b1f98308bab152f9c570c...9fde1531f379449faa4f103d8493e8d2665e3055,1,2,2,4,2,2009-11-11 17:15:33,2009-11-11 17:15:33
9fde1531f379449faa4f103d8493e8d2665e3055...81acebee57d3afdf5afea377b68ba671bba58f6e,1,4,4,8,2,2009-11-12 18:14:09,2009-11-12 18:14:09
81acebee57d3afdf5afea377b68ba671bba58f6e...b549dd49991b87e16aa3c7225d47e435969d46fe,1,8,0,8,1,2009-11-13 04:10:21,2009-11-13 04:10:21
b549dd49991b87e16aa3c7225d47e435969d46fe...473dd3b2121ae0e54803098a7fde4b4c1e673145,1,8,0,8,1,2009-11-25 20:45:16,2009-11-25 20:45:16
b549dd49991b87e16aa3c7225d47e435969d46fe...7aca512f32aaa9eff78d9c2bd73e3db4b124661f,1,2,2,4,2,2009-11-13 21:02:42,2009-11-13 21:02:42
7aca512f32aaa9eff78d9c2bd73e3db4b124661f...5bd19908919f9de691797a5a4589ac49bf6ed356,1,2,2,4,2,2009-11-13 22:39:07,2009-11-13 22:39:07
5bd19908919f9de691797a5a4589ac49bf6ed356...6524bee2ce5996bdb03e9efff174b16028beca68,1,2,2,4,2,2009-11-13 22:44:28,2009-11-13 22:44:28
6524bee2ce5996bdb03e9efff174b16028beca68...3f49658cb53c589808e7fac47f4a6837c503292d,1,2,2,4,2,2009-11-13 22:55:37,2009-11-13 22:55:37
473dd3b2121ae0e54803098a7fde4b4c1e673145...41f13ccb0a5d04496605f69b7ae284d9d639b625,1,15,9,24,5,2009-12-12 21:45:30,2009-12-12 21:45:30
473dd3b2121ae0e54803098a7fde4b4c1e673145...bee94dbd6276d53aae56938920466faf15d2495b,1,8,0,8,1,2009-12-12 09:06:46,2009-12-12 09:06:46
328e67eb00c13e8e1046fde576af390fa61fcac2...dca4651cee556ccdbfe678e695bf9523cc1fc11d,1,4,4,8,1,2009-11-30 22:28:40,2009-11-30 22:28:40
dca4651cee556ccdbfe678e695bf9523cc1fc11d...065ae00673f69c792a5778e19590ed50c99e8a04,1,4,4,8,1,2009-12-01 22:06:15,2009-12-01 22:06:15
065ae00673f69c792a5778e19590ed50c99e8a04...dfb3fb5a0a7566d6576d6fb964ff1a29eacbfef4,1,1,1,2,1,2009-12-10 18:04:06,2009-12-10 18:04:06
dfb3fb5a0a7566d6576d6fb964ff1a29eacbfef4...e429ff9e2bed41f88e3df3315b159fa79a7152fc,1,2,1,3,1,2009-12-12 09:12:14,2009-12-12 09:12:14
4419c5c3475c00b97671c7041c0fd7d7eb4b205e...59116a25f1b071a691a7df2abf2f41d0ed2a2798,1,1,1,2,1,2009-12-13 04:23:36,2009-12-13 04:23:36
59116a25f1b071a691a7df2abf2f41d0ed2a2798...20755df49e28b97e0ad4ba8eef16aef476e9f61a,1,1,1,2,1,2009-12-13 19:38:37,2009-12-13 19:38:37
20755df49e28b97e0ad4ba8eef16aef476e9f61a...98d56a3097237f4220d0f8833555ed37382281ee,1,2,1,3,1,2009-12-13 19:48:03,2009-12-13 19:48:03
98d56a3097237f4220d0f8833555ed37382281ee...2ecc228b2325bf5fadb5c12a5ffff73167e53152,1,17,0,17,1,2009-12-16 19:23:41,2009-12-16 19:23:41
2ecc228b2325bf5fadb5c12a5ffff73167e53152...90627d3d1c2e9c1528b1032b47732e21270609b9,1,1,1,2,1,2009-12-28 05:16:16,2009-12-26 06:41:37
90627d3d1c2e9c1528b1032b47732e21270609b9...f9509f365b633ea5f07de2de2a34abe52304d42c,2,16,16,32,3,2009-12-28 05:19:40,2009-12-19 13:35:57
f9509f365b633ea5f07de2de2a34abe52304d42c...7e6eaff7d39cb73d9af31e2b58f04aa984e1bda8,1,6,0,6,1,2009-12-28 05:26:23,2009-12-13 22:39:40
7e6eaff7d39cb73d9af31e2b58f04aa984e1bda8...5149679f86d54658f8a292f6e220d4edef32769d,1,12,0,12,1,2010-01-02 05:12:46,2010-01-02 05:12:46
5149679f86d54658f8a292f6e220d4edef32769d...9658449450685d5adae867a0b79eddc47262f65e,1,3,1,4,1,2010-01-02 05:51:49,2010-01-02 05:51:49
9658449450685d5adae867a0b79eddc47262f65e...be66fe9d7aab5cd1603a6e86d67b792ac9f5e6f5,1,1,1,2,1,2010-01-02 20:59:11,2010-01-02 20:59:11
be66fe9d7aab5cd1603a6e86d67b792ac9f5e6f5...3c87d483628267e48fc0f462f46488dcd4f87810,1,1,1,2,1,2010-05-07 03:37:00,2010-05-04 20:18:57
3c87d483628267e48fc0f462f46488dcd4f87810...02bd8ab53e82c1b9be5f13e72e087b7a5d95373c,1,20,0,20,1,2010-05-07 03:46:32,2010-04-26 23:02:19
02bd8ab53e82c1b9be5f13e72e087b7a5d95373c...e8ef16570f9828553f9b0e926563a1496bf3740c,1,8,8,16,2,2010-05-07 03:46:32,2010-04-27 05:01:41
e8ef16570f9828553f9b0e926563a1496bf3740c...91add78bdcecee469d6843e0b16f5ac353fd25c1,1,13,0,13,1,2010-05-07 03:46:32,2010-04-27 05:27:32
91add78bdcecee469d6843e0b16f5ac353fd25c1...4155adeefe2c6a941917ece7bbe19bd68950553e,1,1,1,2,1,2010-05-07 03:46:32,2010-04-27 07:55:15
4155adeefe2c6a941917ece7bbe19bd68950553e...447da5816eb2be9c7a79906a484cb78334fd1d7d,1,0,21,21,1,2010-05-07 04:04:09,2010-05-07 04:04:09
447da5816eb2be9c7a79906a484cb78334fd1d7d...926d9e8893789e1b70cb4df2144c868f4aa91515,1,4,8,12,4,2010-05-07 04:06:58,2010-03-09 13:09:08
926d9e8893789e1b70cb4df2144c868f4aa91515...7d036913c4476916fe8b0325ea9cd54266787021,1,2,0,2,1,2010-05-07 04:13:59,2010-05-07 04:13:59
be66fe9d7aab5cd1603a6e86d67b792ac9f5e6f5...6356d70710876edfe335022bdef79595c2e65d62,1,14,0,14,1,2010-04-08 18:11:42,2010-04-08 18:11:42
6356d70710876edfe335022bdef79595c2e65d62...51935f768d69470d92d2f00f14c98a0380605075,1,2,0,2,1,2010-04-08 19:02:56,2010-04-08 19:02:56
51935f768d69470d92d2f00f14c98a0380605075...a4dd691af5cdb3ce818fa14d32d58cbcecf45b4d,1,1,1,2,1,2010-04-08 19:07:43,2010-04-08 19:07:43
a4dd691af5cdb3ce818fa14d32d58cbcecf45b4d...99d72cad5573f7481c28a75228b940f2212c9e1b,2,3,3,6,3,2010-04-09 02:35:35,2010-04-09 02:35:35
be66fe9d7aab5cd1603a6e86d67b792ac9f5e6f5...3e1d5fa3164db236653756bde816c94af7d23b01,1,2,1,3,2,2010-03-22 20:44:15,2010-03-22 20:44:15
be66fe9d7aab5cd1603a6e86d67b792ac9f5e6f5...f9abe041e2b70217b0d2f5519a51a57854b49857,1,14,0,14,1,2010-03-17 18:25:17,2010-03-17 18:25:17
be66fe9d7aab5cd1603a6e86d67b792ac9f5e6f5...354ab87c85fb117d62cd314e957cd8708c3b7fe4,1,9,0,9,1,2010-03-14 20:08:27,2010-03-14 20:08:27
354ab87c85fb117d62cd314e957cd8708c3b7fe4...477835250273ce3f963e03ad4a75ca010f4d9972,1,5,0,5,1,2010-03-16 20:44:01,2010-03-16 20:44:01
74429549856521ea71fb4a3c9e6be0741f7c86f8...44cad95ed220a3a3a0c76de15186f395fc6e7ab0,1,19,7,26,6,2010-05-07 18:17:12,2010-05-07 18:17:12
7a9d4ceb75cbba745a6c0cecf098f6625ce50411...cd9a85500e9ddcb99c3340288b8f02fbed1fa3bb,1,8,0,8,1,2010-05-07 20:20:10,2010-04-26 21:47:02
86d0cd380dbb084ca998d9fbf7411481ca33780c...1d03ea53427c0658fc6924aa890c21f6e46c0a80,1,6,0,6,1,2010-05-07 20:20:59,2010-04-21 11:24:53
1d03ea53427c0658fc6924aa890c21f6e46c0a80...9efc086fb3140e6e9023f7d8543d5b8231075370,1,0,1,1,1,2010-05-07 20:22:34,2010-05-03 18:49:48
9efc086fb3140e6e9023f7d8543d5b8231075370...e3b9e981538d2bbb9a3c3934419162d1c2a6046e,1,23,0,23,1,2010-05-07 20:23:01,2010-03-30 16:21:42
e3b9e981538d2bbb9a3c3934419162d1c2a6046e...93f9825b79f7dc577d8891f0264fbdc484be80b0,1,3,0,3,1,2010-05-07 20:23:50,2010-03-30 17:31:41
93f9825b79f7dc577d8891f0264fbdc484be80b0...36f1f4e51595943d0b8e06a9078aa6f627a9734d,1,16,0,16,1,2010-05-07 20:24:24,2010-04-06 00:24:33
36f1f4e51595943d0b8e06a9078aa6f627a9734d...147acd22377d06eb41f4c4368ba33b98c9bbd034,1,19,0,19,1,2010-05-07 20:26:15,2010-03-24 00:51:57
147acd22377d06eb41f4c4368ba33b98c9bbd034...08a90297fe7c1105253619e42f0fb07a2538db21,1,8,0,8,1,2010-05-07 20:26:47,2010-04-16 00:22:50
08a90297fe7c1105253619e42f0fb07a2538db21...458da5895a5fd13823545c187cf64436b39c8266,1,6,0,6,1,2010-05-07 20:27:15,2010-04-30 08:36:03
458da5895a5fd13823545c187cf64436b39c8266...6213f3304f945b56dfea30d6e11e4c860afdbbc9,1,8,0,8,1,2010-05-07 20:28:40,2010-05-04 20:19:09
6213f3304f945b56dfea30d6e11e4c860afdbbc9...a649b2d410e3f3cd2b5749d199da03168d0c3920,1,3,1,4,2,2010-05-07 20:29:21,2010-05-04 20:58:10
a649b2d410e3f3cd2b5749d199da03168d0c3920...d8a10dbba5cff634193a9a957833ad0f395d7a7d,1,16,0,16,1,2010-05-07 20:29:58,2010-04-29 16:12:26
d8a10dbba5cff634193a9a957833ad0f395d7a7d...97aac4acb5913a042a12a4797f5cc1894f2e21f5,1,7,0,7,1,2010-05-07 20:30:50,2010-04-22 09:32:36
97aac4acb5913a042a12a4797f5cc1894f2e21f5...081deba3c4971a2a9af8c185f01ee9ea6754fdcb,1,6,0,6,1,2010-05-07 20:32:03,2010-04-13 20:44:51
081deba3c4971a2a9af8c185f01ee9ea6754fdcb...456834b9ea5aca1a7727f7070681e5d0336e3893,1,7,0,7,1,2010-05-07 20:32:35,2010-04-03 07:48:35
456834b9ea5aca1a7727f7070681e5d0336e3893...5a3bde78d804a0c20a18f7de02e60f1c835a3f28,2,9,1,10,2,2010-05-07 22:35:03,2010-05-07 22:35:03
5a3bde78d804a0c20a18f7de02e60f1c835a3f28...0a2a981dfeadf0e8cfcf361e792a3e3872f1aef4,1,80,0,80,1,2010-05-27 16:54:14,2010-05-27 04:49:55
0a2a981dfeadf0e8cfcf361e792a3e3872f1aef4...8247cbf8b56ebd5915813bb1fafb72e71fc06c8f,1,2,2,4,2,2010-05-28 00:09:57,2010-05-13 20:42:24
8247cbf8b56ebd5915813bb1fafb72e71fc06c8f...f02c9560b3089fae2639a466ea39263553619df5,1,8,0,8,1,2010-05-28 00:09:57,2010-05-13 23:15:31
f02c9560b3089fae2639a466ea39263553619df5...ba9c78fc9b83752e970f7a1bc1b16a582672bd58,1,7,0,7,1,2010-05-28 00:13:17,2010-05-19 06:53:16
ba9c78fc9b83752e970f7a1bc1b16a582672bd58...0dbfeb9c23cfd3bffd2f744a5db17c3613ea44d2,1,8,0,8,1,2010-05-28 00:13:17,2010-05-19 06:53:38
0dbfeb9c23cfd3bffd2f744a5db17c3613ea44d2...f2f34f5404e8ab674a0e345a709783b6c56a3b72,1,29,0,29,1,2010-05-28 00:13:36,2010-05-26 22:37:52
f2f34f5404e8ab674a0e345a709783b6c56a3b72...c5c870ac0556467a1b21f4298fda6aeefcc93ecd,1,7,0,7,1,2010-05-28 00:14:13,2010-05-27 19:20:27
c5c870ac0556467a1b21f4298fda6aeefcc93ecd...eb0f3c0234e88bbbf5ca014ace8d8d801207c222,1,6,0,6,1,2010-05-28 00:15:39,2010-05-23 20:03:27
eb0f3c0234e88bbbf5ca014ace8d8d801207c222...3cf9ab722e7c0829727f548c7d05a0d96055f707,9,69,64,133,12,2010-06-03 19:03:26,2010-06-03 19:03:26
3cf9ab722e7c0829727f548c7d05a0d96055f707...31dace882969e04e0256dac4ddb333f648707106,1,4,0,4,1,2010-06-03 19:05:12,2010-06-03 19:05:12
31dace882969e04e0256dac4ddb333f648707106...c21d3775a9663daf69133ae8dcd0a2697ef694fa,1,23,1,24,1,2010-06-03 19:32:55,2010-06-03 19:32:55
c21d3775a9663daf69133ae8dcd0a2697ef694fa...ab2c0744abc648da9c35dc52f4c0b3c0623b989d,1,0,21,21,1,2010-06-03 19:33:15,2010-06-03 19:33:15
ab2c0744abc648da9c35dc52f4c0b3c0623b989d...455669e97606bb512b9f69fc1ed9b8fea5105a33,1,0,8,8,2,2010-06-03 19:54:40,2010-06-03 19:54:40
455669e97606bb512b9f69fc1ed9b8fea5105a33...89bd2bf317fe458c6a6154824823670dd2d32660,3,15,16,31,4,2010-06-03 19:55:07,2010-06-03 19:55:07
89bd2bf317fe458c6a6154824823670dd2d32660...27904c117c3ee70938edbac45cee7a44ced5c38b,2,10,9,19,2,2010-06-03 19:56:11,2010-06-03 19:56:11
27904c117c3ee70938edbac45cee7a44ced5c38b...dea166411f134b33ae36c4ec4c51e71248dfa2a3,1,0,0,0,0,2010-06-03 19:59:49,2010-06-03 19:59:49
dea166411f134b33ae36c4ec4c51e71248dfa2a3...59bfd87e08c127e6aacf473e99d2ebbc20e633ff,1,6,0,6,1,2010-06-03 20:01:41,2010-06-03 20:01:41
eb0f3c0234e88bbbf5ca014ace8d8d801207c222...81aa74b73cc221b5050e28ccf35d29317812edf9,1,19,0,19,1,2010-06-03 18:43:24,2010-05-31 09:09:45
fca8b7e3e61056998c8d15836f907345b423b121...7f350da5b74c65ed99766c8ebd5137aee9479225,1,1,0,1,1,2010-06-10 14:50:13,2010-06-10 14:50:13
fca8b7e3e61056998c8d15836f907345b423b121...6774490a467016db70e9ec1ddd1bab6fe37a722a,1,1,0,1,1,2010-06-05 15:22:57,2010-05-09 13:17:20
6774490a467016db70e9ec1ddd1bab6fe37a722a...edc8e3d092bc758fa9dd4f3472d2c6ec9d03b737,1,1,0,1,1,2010-06-05 15:22:57,2010-05-09 13:16:33
edc8e3d092bc758fa9dd4f3472d2c6ec9d03b737...f9fbd079832637c192e35fe65532495a37a3e3d3,1,1,1,2,1,2010-06-05 15:22:57,2010-05-09 14:23:11
f9fbd079832637c192e35fe65532495a37a3e3d3...3bc73012041c8762fa0276c6e02ac46fb3698a32,1,2,0,2,1,2010-06-05 15:22:57,2009-11-12 06:52:53
3bc73012041c8762fa0276c6e02ac46fb3698a32...6efc79c74edbc8cfbb5cdc438332eeae9b950508,1,1,0,1,1,2010-06-05 15:23:53,2009-11-21 17:38:55
6efc79c74edbc8cfbb5cdc438332eeae9b950508...47e9914529e0807681c3c6dd2c11187ee67f0326,1,27,0,27,1,2010-06-05 15:24:21,2010-05-30 16:56:26
47e9914529e0807681c3c6dd2c11187ee67f0326...6bb13632f538db339520ab2b46794006a405430f,1,6,0,6,1,2010-06-06 18:06:40,2010-06-06 10:42:25
6bb13632f538db339520ab2b46794006a405430f...b26ff059653716fd38d1813b797572bbec718c16,1,8,14,22,6,2010-06-06 18:06:40,2010-06-06 14:14:13
321f5ef3596b5a3a1fb6cb40c0b19f041cde7ee2...d647a9b25c43b75eea6fee29f27affe5edc4b72e,1,9,10,19,3,2010-10-01 03:54:45,2010-10-01 03:54:45
d647a9b25c43b75eea6fee29f27affe5edc4b72e...b9056303669806be8e1e90eacfc471590c39f353,1,1,1,2,1,2010-10-01 04:00:38,2010-09-21 00:31:17
7c279856ed4f244a504e5fc89201ab0be86eade5...306cea0945166bd0b32290c0813bf90c7dee6369,1,12,0,12,1,2010-08-19 14:29:17,2010-01-13 19:45:10
7c279856ed4f244a504e5fc89201ab0be86eade5...eb14ee1c630a4ae02234e78eabf3e8416dc9d977,1,43,0,43,1,2010-08-19 14:17:31,2010-08-17 12:45:10
eb14ee1c630a4ae02234e78eabf3e8416dc9d977...1582570919b5bed145d38d1d60ae8572f4552f25,1,4,4,8,4,2010-08-19 14:17:50,2010-08-17 13:22:26
7c279856ed4f244a504e5fc89201ab0be86eade5...5b8bc7aeebdf5f28da811a29bdcdf41e0f08c218,1,7,0,7,1,2010-08-16 19:47:21,2010-08-16 19:47:21
7c279856ed4f244a504e5fc89201ab0be86eade5...8c419ae3b5b77a24485c6a68e6af1a0384db67a8,1,7,0,7,1,2010-06-12 22:31:02,2010-06-12 22:31:02
ed90f182ef5de7161a681c732c3223ce67305f9f...99f159e0a7c63e6756f8e6e40691914da8f7a96c,1,0,1,1,1,2010-08-24 18:08:20,2010-08-24 18:08:20
ed90f182ef5de7161a681c732c3223ce67305f9f...7b6be5611763f25eca043f9ed0d46066a3454205,2,73,67,140,2,2010-08-20 16:55:30,2010-08-20 16:55:30
622ee4ceb2cedfd97fe456ead5f20b7e6d84b088...95ccb4db1a33c3cdcf7afd134567b8930fe8b6f5,1,17,11,28,8,2010-08-19 14:25:22,2010-08-09 13:45:40
95ccb4db1a33c3cdcf7afd134567b8930fe8b6f5...75de90dc9eedc62edfbd34785f191c56fee802b0,1,7,0,7,1,2010-08-19 14:27:05,2010-08-08 17:45:49
75de90dc9eedc62edfbd34785f191c56fee802b0...aeabc3f616ccd407f68a621ecd676834e276c531,1,2,2,4,2,2010-08-19 15:04:18,2010-08-19 15:04:18
99f159e0a7c63e6756f8e6e40691914da8f7a96c...c24936ece51940536f3e62fc9e458b74c2affe68,1,68,0,68,1,2010-10-01 02:56:56,2010-10-01 02:56:56
c24936ece51940536f3e62fc9e458b74c2affe68...7fb0b210e88bcbdb71d2cb0022c35b2cc3810327,1,20,2,22,5,2010-10-01 21:11:53,2010-10-01 21:11:53
7fb0b210e88bcbdb71d2cb0022c35b2cc3810327...6fcf9393c31a51cef688b591de73817c5988c405,1,1,1,2,1,2010-10-01 21:17:13,2010-10-01 21:17:13
6fcf9393c31a51cef688b591de73817c5988c405...7405f5d9ff29f42e934fa5f3c87401437c16aedd,1,1,1,2,1,2010-10-01 21:40:06,2010-10-01 21:40:06
7405f5d9ff29f42e934fa5f3c87401437c16aedd...6d5e4eaebcde1c48413f89b4554983f489e4b017,1,21,7,28,5,2010-10-05 01:05:01,2010-10-05 01:05:01
6d5e4eaebcde1c48413f89b4554983f489e4b017...c6b339f532b05e907b0c554000643db5e896a75f,1,9,9,18,2,2010-10-05 05:08:38,2010-10-05 05:08:38
c6b339f532b05e907b0c554000643db5e896a75f...9b6dd1cd48a549d2868cfe16073bbd04357e27e5,1,1,1,2,1,2010-10-22 17:39:33,2010-10-22 17:39:33
9b6dd1cd48a549d2868cfe16073bbd04357e27e5...810b8f5ce8a58b03afba4e6ec5937e2cd0bcab5c,1,1,1,2,1,2010-10-22 17:42:49,2010-10-22 17:42:49
810b8f5ce8a58b03afba4e6ec5937e2cd0bcab5c...d2bfdc2d89cb08a870169af4f394f27d2b9c0aed,1,1,1,2,1,2010-10-22 17:51:58,2010-10-22 17:51:58
d2bfdc2d89cb08a870169af4f394f27d2b9c0aed...4ff0136079b8ffe29e0990d0a0ce8876554aa0d5,1,1,1,2,1,2010-10-22 18:34:52,2010-10-22 18:34:52
99f159e0a7c63e6756f8e6e40691914da8f7a96c...6c3b9daaf7cd1bf387d46e865f316c6815dc14d2,1,22,0,22,1,2010-09-26 20:25:31,2010-09-26 20:25:31
99f159e0a7c63e6756f8e6e40691914da8f7a96c...e37d62a282dc74b7cd265643dcb01f80e25b3e34,1,0,2,2,1,2010-09-26 16:28:29,2010-09-26 14:05:53
e37d62a282dc74b7cd265643dcb01f80e25b3e34...74b2c5d75ab6477ea3f72eeadb6fd81b42c1abd4,1,6,1,7,2,2010-09-26 16:29:14,2010-09-26 14:03:44
99f159e0a7c63e6756f8e6e40691914da8f7a96c...6764e50397f35eba635e57a231ff06f1685efc5f,1,6,0,6,1,2010-09-25 05:48:19,2010-09-25 05:48:19
99f159e0a7c63e6756f8e6e40691914da8f7a96c...62cea310fb97a98f6360397dfeef3a01507153fd,1,24,0,24,1,2010-09-25 00:46:52,2010-09-25 00:46:52
99f159e0a7c63e6756f8e6e40691914da8f7a96c...a0a8ba666b29cbcdbba05726e4e2d46eca708ca1,1,19,0,19,1,2010-09-20 01:33:41,2010-02-27 23:15:47
a0a8ba666b29cbcdbba05726e4e2d46eca708ca1...870551e960c6cb506fd7cc232a069432dfc72f2c,1,4,1,5,1,2010-09-20 01:33:41,2010-03-16 02:34:26
870551e960c6cb506fd7cc232a069432dfc72f2c...21e2a913bff765b8dc23f12309059f7446e0ff99,1,3,2,5,2,2010-09-20 01:33:41,2010-04-02 21:24:41
21e2a913bff765b8dc23f12309059f7446e0ff99...181a2ed5379f5bf9d0420c0caaea56034eb22732,1,1,2,3,1,2010-09-20 01:33:42,2010-04-22 17:26:08
181a2ed5379f5bf9d0420c0caaea56034eb22732...50fb2d037ee75ac6e558923c7a92c818a96d43c8,1,0,0,0,0,2010-09-20 01:41:01,2010-09-20 01:39:51
50fb2d037ee75ac6e558923c7a92c818a96d43c8...1862b1c0755770cffcbcb936bdecc3bfb050931d,1,13,0,13,2,2010-09-20 01:43:49,2010-09-20 01:43:49
1862b1c0755770cffcbcb936bdecc3bfb050931d...610f68c8e0401048f87d1f2bd48086b8c0cd0dbe,1,2,1,3,1,2010-09-20 04:39:11,2010-09-20 04:39:11
610f68c8e0401048f87d1f2bd48086b8c0cd0dbe...8f7609b4fabd3d02e3991221cbe35bea692c22e3,1,6,3,9,3,2010-09-20 04:40:47,2010-09-20 04:40:47
8f7609b4fabd3d02e3991221cbe35bea692c22e3...2ff567e16267274041f542b5bce18876b8815fca,1,2,1,3,2,2010-09-21 18:07:02,2010-09-21 18:07:02
2ff567e16267274041f542b5bce18876b8815fca...3add6a2ac47186240a2d02a986ae22b6519d965f,1,1,2,3,2,2010-09-27 03:30:57,2010-09-27 03:30:57
99f159e0a7c63e6756f8e6e40691914da8f7a96c...5215e74bf470b4baba571e879cbd1bfddc28daf3,1,6,0,6,1,2010-09-10 05:20:42,2010-09-10 05:20:42
5215e74bf470b4baba571e879cbd1bfddc28daf3...f9fce9bb8d293286d7d0fb7ecde170bd0c7f37fc,1,1,0,1,1,2010-09-10 05:25:17,2010-09-10 05:25:17
99f159e0a7c63e6756f8e6e40691914da8f7a96c...fe09064fcf4859b0e417c8040094f622f971012a,2,50,0,50,2,2010-09-01 11:21:11,2010-09-01 11:21:11
99f159e0a7c63e6756f8e6e40691914da8f7a96c...c96f5f78cbb95d29c712af173c5b9c630efcf710,2,68,0,68,2,2010-09-01 11:07:11,2010-09-01 11:07:11
99f159e0a7c63e6756f8e6e40691914da8f7a96c...fbc22d80fe098f9ee5ca935766bc3d411c53ed92,1,13,0,13,1,2010-08-30 18:59:23,2010-08-30 18:59:23
68f893cbe05e5a84adf7f26a0ed7492af6e03def...2a203b558fd6328c9a91e9dbbf145d91e7ba7ed1,1,5,5,10,2,2010-11-14 22:53:13,2010-11-14 22:51:19
7a09175bb4c32c7027dab872cd7b80503da3f5d5...26d97a9355d37c55e0b044d8dafc425cc0ca7217,13,1,1,2,1,2010-10-01 04:34:06,2010-10-01 04:34:06
d340bfab3345a223114b09d589356ff18a1a3efd...7936bbbd5a3895caa7153e4d03740ac12a333862,6,3,3,6,3,2010-10-01 08:59:48,2010-10-01 08:59:48
7936bbbd5a3895caa7153e4d03740ac12a333862...a4afcfddbf8c9e8769e4e78c23a144c9b3c9aaf3,1,10,0,10,1,2010-10-01 13:29:34,2010-09-05 14:52:38
a4afcfddbf8c9e8769e4e78c23a144c9b3c9aaf3...541da0c9d1cdf88583490fa06b6e307ea09bfc94,2,21,23,44,3,2010-10-01 19:15:52,2010-10-01 19:15:52
541da0c9d1cdf88583490fa06b6e307ea09bfc94...249fe1471cde3b12366729e5a869dd56c26b07ce,2,43,0,43,2,2010-10-09 13:29:24,2010-10-09 13:29:24
249fe1471cde3b12366729e5a869dd56c26b07ce...dfbed8fd9894ec4b13745e9e08233a750c2369ee,1,1,1,2,1,2010-10-09 14:03:08,2010-10-09 14:03:08
dfbed8fd9894ec4b13745e9e08233a750c2369ee...fcd88edfb3464e46d3337c3ee72d28248e92ac79,1,3,0,3,1,2010-10-09 14:18:35,2010-10-09 14:18:35
fcd88edfb3464e46d3337c3ee72d28248e92ac79...210c76c35b1db7a761df45cd7f85d3b324f8e0b5,1,0,2,2,1,2010-10-09 14:29:28,2010-10-09 14:29:28
541da0c9d1cdf88583490fa06b6e307ea09bfc94...df1e305736f23d8702a4d68b0fb8fc502e8c442a,1,14,0,14,1,2010-10-09 05:59:22,2010-10-09 05:57:43
541da0c9d1cdf88583490fa06b6e307ea09bfc94...aab235f6121a93b81a425d522a0c7f2aaac946bd,1,1,1,2,1,2010-10-09 05:55:09,2010-10-09 05:44:42
541da0c9d1cdf88583490fa06b6e307ea09bfc94...8059c0727a09257dc387aa9ba17dc99d1842aa19,1,28,0,28,1,2010-10-08 23:48:23,2010-10-08 23:27:40
8059c0727a09257dc387aa9ba17dc99d1842aa19...b6dde1e8cfb938e507e5e8db9eac99d28a020468,1,15,0,15,1,2010-10-08 23:49:35,2010-10-08 23:49:35
b6dde1e8cfb938e507e5e8db9eac99d28a020468...deb0f7478b292b48338bc4d6098b8f6b013d0b4b,1,6,5,11,3,2010-10-09 00:16:10,2010-10-09 00:16:10
deb0f7478b292b48338bc4d6098b8f6b013d0b4b...061ea5c7c98ada295ae4623692e6811c0baab88d,1,13,14,27,1,2010-10-09 16:06:00,2010-10-09 16:06:00
541da0c9d1cdf88583490fa06b6e307ea09bfc94...d53d0eac070b270222c042c2e187dcf3a109b39a,1,6,0,6,1,2010-10-05 22:06:08,2010-10-05 22:06:08
541da0c9d1cdf88583490fa06b6e307ea09bfc94...f2f49f9571cf56b2fa672f16260c000050f9349b,1,15,0,15,1,2010-10-03 21:41:45,2010-10-03 21:41:45
f2f49f9571cf56b2fa672f16260c000050f9349b...ba9ae6a1e5fe1b45a58e655ab3413bb95a82573e,1,1,1,2,1,2010-10-03 21:42:57,2010-10-03 21:42:57
541da0c9d1cdf88583490fa06b6e307ea09bfc94...f294eeb57175f5ef86f903d41c84ecacd96fe00c,1,15,0,15,1,2010-10-02 17:49:16,2010-10-02 17:49:16
210c76c35b1db7a761df45cd7f85d3b324f8e0b5...425b0ef89fcd40b6b235347e32d8efd44709a802,1,3,3,6,2,2010-10-09 17:38:01,2010-10-09 17:38:01
df1e305736f23d8702a4d68b0fb8fc502e8c442a...8b4858b6646ef2ce1bf4ab33ba94db33a95559b4,1,2,2,4,2,2010-10-10 00:43:38,2010-10-09 23:52:53
fb6fddda37b7693c0b6f49345e25f8cac66ba9e4...57e0b57434eb7f3b7d0fe0ca4849478477404e43,1,16,2,18,4,2010-11-19 19:25:19,2010-11-19 19:25:19
8bef74081e9dda6e1d6c5854c2fcedb9145031ba...dc12853b0c3e5af9e42f44cb9efdf57d44d20711,2,0,2,2,2,2010-10-09 18:11:07,2010-10-09 18:11:07
3e260a9ef63ed8e73650c72049002e6f9edd0dc9...48ab2ad6e261fc30caa7fe17bd4d3435100c7f3d,1,4,2,6,2,2011-02-22 08:53:02,2011-02-22 08:53:02
dc12853b0c3e5af9e42f44cb9efdf57d44d20711...148c14e4f7e3ee9134807304a7c38682276e918c,2,142,0,142,2,2010-11-15 19:46:15,2010-11-15 19:45:04
148c14e4f7e3ee9134807304a7c38682276e918c...ea274ab90c1a6d7f553e44ad7138f6205336b3b4,1,59,90,149,18,2010-11-15 19:56:01,2010-11-15 19:56:01
ea274ab90c1a6d7f553e44ad7138f6205336b3b4...6dbfdd9e31cefcb9510edf5e526cf572cbcfa776,1,32,36,68,6,2010-11-15 20:18:58,2010-11-15 20:18:58
dc12853b0c3e5af9e42f44cb9efdf57d44d20711...72d7c0363c849fe166577ad91f06ab087feb99b1,1,14,0,14,1,2010-11-14 12:21:28,2010-07-30 12:27:32
dc12853b0c3e5af9e42f44cb9efdf57d44d20711...9db8042c465faec4bc9ff591fe02e50694ab5c08,1,20,0,20,1,2010-11-09 13:56:26,2010-11-09 13:56:26
dc12853b0c3e5af9e42f44cb9efdf57d44d20711...9465ba0de456d270418457b486c308a2d49ed9c6,1,27,5,32,2,2010-11-03 20:57:15,2010-11-03 20:57:15
dc12853b0c3e5af9e42f44cb9efdf57d44d20711...ab170c38ea7f3db981303afc6eb4dabe7b37711b,1,2,2,4,2,2010-11-02 11:26:49,2010-11-02 11:26:49
dc12853b0c3e5af9e42f44cb9efdf57d44d20711...baa46b39e34a88da00f19411841ca9456fac4493,1,5,0,5,1,2010-10-25 21:02:16,2010-10-25 21:02:16
dc12853b0c3e5af9e42f44cb9efdf57d44d20711...60b560fc9ace116cde7e56954f386b1098751648,1,26,0,26,1,2010-10-15 14:50:39,2010-10-15 14:50:39
dc12853b0c3e5af9e42f44cb9efdf57d44d20711...4e433eb6bb578c864116cbcf0aa201227f80e4aa,1,6,0,6,1,2010-10-15 09:05:47,2010-10-15 09:05:47
8a102b941f80050a82b26b1e8ac79ffa4cc3a855...34f00f385ce1b322ee7de48f30d175746bba94fc,1,1,1,2,1,2011-07-23 15:54:47,2010-10-11 19:19:23
9db8042c465faec4bc9ff591fe02e50694ab5c08...bdaf872ce6e411f881e5e6138fc61a9c1645e67a,1,0,1,1,1,2010-11-17 10:17:03,2010-11-17 10:17:03
583c984a864969579a0c258528ae93f9529308d4...0e2d289fffbf15c95c5401aa484ad63a51e88e3c,1,12,0,12,1,2010-12-03 14:51:34,2010-12-03 14:51:34
0e2d289fffbf15c95c5401aa484ad63a51e88e3c...17c6c0376084d09a6cf3d1260d65447ba179c694,1,3,3,6,2,2010-12-03 14:58:18,2010-12-03 14:58:18
583c984a864969579a0c258528ae93f9529308d4...d230d2e519fb4720671ff7acf2b5a05f640eaebe,1,4,0,4,1,2010-12-02 00:49:13,2010-12-02 00:49:13
583c984a864969579a0c258528ae93f9529308d4...d02a3912cfd52636ad547fe0b1357303b77584a8,1,6,0,6,1,2010-12-01 08:56:54,2010-12-01 08:56:54
583c984a864969579a0c258528ae93f9529308d4...e5beb1a6b5f31d2fa1c77598ef48d888b773e26c,1,33,0,33,1,2010-11-24 17:03:14,2010-11-24 17:03:14
e5beb1a6b5f31d2fa1c77598ef48d888b773e26c...dc87b81b1b70d528643aece33dcb0f4c25621e72,1,26,6,32,5,2010-11-24 18:58:03,2010-11-24 18:58:03
dc87b81b1b70d528643aece33dcb0f4c25621e72...0cd956c59692d5e4e7bc01138b96b1537b6d821a,1,12,9,21,6,2010-11-24 19:04:40,2010-11-24 19:04:40
583c984a864969579a0c258528ae93f9529308d4...f624889aa4eacbd5f5f11ec02115abd59e567716,1,0,0,0,0,2010-11-20 17:06:23,2010-11-20 17:06:23
f624889aa4eacbd5f5f11ec02115abd59e567716...b0c39ec7f1625fafd4d51166b19d38f583a3cf9b,1,43,0,43,1,2010-11-20 17:07:45,2010-11-20 17:07:45
b0c39ec7f1625fafd4d51166b19d38f583a3cf9b...9b0a75ca84e9bb1956806f09ee7040ce8c0d647c,1,1,1,2,1,2010-11-20 19:12:19,2010-11-20 19:12:19
34f00f385ce1b322ee7de48f30d175746bba94fc...eb63ddf6bb119e3d0e62f012b2f9b5fe95e0d647,1,1,0,1,1,2011-07-23 16:11:08,2010-10-12 19:02:04
eb63ddf6bb119e3d0e62f012b2f9b5fe95e0d647...6bb0c1c9269025867e886b76bcbf737e5a54400d,1,2,0,2,1,2011-07-23 16:12:44,2010-10-11 01:43:51
6bb0c1c9269025867e886b76bcbf737e5a54400d...96b0af68242ec6235e4162f5e7e1f4d470cb2b22,1,6,0,6,3,2011-07-23 16:13:49,2010-10-09 22:09:42
4fadc302472f9b02e386da3e7182c1397ee3cd5c...943e09cd84baff55d36ebcfcf05b9fbfb4436a17,1,9,0,9,1,2010-12-29 04:36:29,2010-12-29 04:36:29
4fadc302472f9b02e386da3e7182c1397ee3cd5c...ff0b25b745494d96ae06694321b2299991620b14,2,23,0,23,2,2010-12-24 22:20:57,2010-12-24 22:20:57
ff0b25b745494d96ae06694321b2299991620b14...f0136f2aec4efdd11e976ddbbfd204ca5e113498,1,2,0,2,1,2010-12-25 13:28:16,2010-12-25 13:28:16
f0136f2aec4efdd11e976ddbbfd204ca5e113498...bcc235e1420f39a0dbd8a7672dffc0f0c81e9b53,1,13,0,13,3,2011-01-10 17:49:53,2011-01-10 16:34:38
4fadc302472f9b02e386da3e7182c1397ee3cd5c...2b03b95122361fa73e7651d1a06730ae95548a14,1,5,1,6,2,2010-12-21 19:28:40,2010-12-21 19:28:40
4fadc302472f9b02e386da3e7182c1397ee3cd5c...06472515e137df32ad2f898962a3ca05c24ad8d0,1,18,0,18,1,2010-12-20 21:51:29,2010-12-20 21:51:29
4fadc302472f9b02e386da3e7182c1397ee3cd5c...960eb52366abe6e8951b8b20a9fb59ef6d50a3e8,1,12,0,12,1,2010-12-20 15:19:59,2010-12-20 15:19:59
960eb52366abe6e8951b8b20a9fb59ef6d50a3e8...6aa8ee2f515875e9a75b30b3a5734451f585a3f1,1,0,4,4,1,2010-12-20 15:50:55,2010-12-20 15:50:55
4fadc302472f9b02e386da3e7182c1397ee3cd5c...8edf417375fa8468008fbea78b7532125ea6bd83,1,1,0,1,1,2010-12-20 15:13:47,2010-12-20 15:13:47
8edf417375fa8468008fbea78b7532125ea6bd83...1a8ceef514bc86f882adce1834bfab168afcb4d1,1,2,2,4,2,2010-12-20 15:57:23,2010-12-20 15:57:23
4fadc302472f9b02e386da3e7182c1397ee3cd5c...632181c3dc0930ddd147e11041f4ffe07b4ad18f,1,1,1,2,1,2010-12-20 14:13:46,2010-12-20 14:13:46
4fadc302472f9b02e386da3e7182c1397ee3cd5c...f2d60d3023b006e5e31928ed36491f4639a7a022,1,14,4,18,3,2010-12-20 03:08:21,2010-12-20 03:08:21
d02a3912cfd52636ad547fe0b1357303b77584a8...792e50c917b7c854fbcadbce10a895ab7fbaa7ec,1,1,1,2,1,2011-02-16 09:40:51,2011-02-16 09:40:51
8f95ca6b8d32b32659460c4aa47802bda75e5aae...fa7036b4eef177f25478091e660fca52b9ac725d,1,19,0,19,1,2010-11-25 20:48:07,2010-11-25 20:48:07
0cd956c59692d5e4e7bc01138b96b1537b6d821a...1a673fc1d582463c17168557b95fe6a55e0757e5,1,5,5,10,5,2010-12-01 17:07:28,2010-12-01 17:07:28
5e4d89385f8596b09a3bbb727015f81a53e9d6b4...9e783c0a8e276e89d9d81951a4c32ea61dadccf1,1,0,4,4,2,2011-07-23 16:14:44,2011-07-23 16:14:44
2b55ee07534ec34a699805dc35ca83ad8e22fc7a...d22b253ce2bd69d908f0c2fce75c5d9ab09edda3,2,30,24,54,3,2011-09-20 08:18:17,2011-09-20 08:16:51
ab2a7b51a8c3ead55a272fba58232d0823e519a2...23a082df129b12b6edf8ea04432b0cb2be0588fd,1,0,29,29,1,2011-06-01 07:33:12,2011-06-01 07:33:12
ab2a7b51a8c3ead55a272fba58232d0823e519a2...1c2eb40e876db3d2bfad22a0b52f0d410e1d51f3,1,17,0,17,1,2011-05-29 23:05:38,2011-05-26 18:00:23
ab2a7b51a8c3ead55a272fba58232d0823e519a2...205e2f4842d1d1808b0d8d16bcfd1daeadb111d9,1,95,0,95,1,2011-05-29 09:55:24,2011-05-29 09:55:24
ab2a7b51a8c3ead55a272fba58232d0823e519a2...3b8f65477e989d534d2ce19aaec65ab2c1179aa3,1,2,3,5,2,2011-05-28 21:30:15,2010-11-13 17:08:24
3b8f65477e989d534d2ce19aaec65ab2c1179aa3...b02094e50fe3cd2e3f8ba911d19257dda047bf48,1,0,0,0,0,2011-06-07 21:06:24,2011-06-07 21:06:24
b02094e50fe3cd2e3f8ba911d19257dda047bf48...efa5593f88e552fbd3fde850b283fa43d36f481c,2,19,20,39,2,2011-08-16 20:54:47,2011-08-16 20:54:47
efa5593f88e552fbd3fde850b283fa43d36f481c...cfeb57024d78d84521ea6676a49182dee9a98b52,1,1,10,11,2,2012-09-03 16:50:45,2012-09-03 16:50:45
ab2a7b51a8c3ead55a272fba58232d0823e519a2...18ab94bccd3cfe64f81ab2ea0e09ce4a630a21bc,1,15,0,15,1,2011-05-28 15:57:32,2011-05-28 15:57:32
ab2a7b51a8c3ead55a272fba58232d0823e519a2...3e433165502a01028fcd0368161a2193eaeb386c,1,25,0,25,1,2011-05-28 14:16:06,2011-05-28 14:16:06
3e433165502a01028fcd0368161a2193eaeb386c...e703c9591c64cd23bb0f0e1a892fbed0efe74fa7,1,3,0,3,1,2011-05-28 14:23:06,2011-05-28 14:23:06
e703c9591c64cd23bb0f0e1a892fbed0efe74fa7...9f34bbedc8d4843b0ed50f76d38b63e5aa48cc8b,1,9,0,9,1,2011-05-28 14:35:54,2011-05-28 14:35:54
9f34bbedc8d4843b0ed50f76d38b63e5aa48cc8b...572b27b75724d00fbc99ef64de3dbd21a28c8194,2,15,1,16,3,2011-05-28 14:50:06,2011-05-28 14:50:06
572b27b75724d00fbc99ef64de3dbd21a28c8194...e263f1f0057f6cac15ef588c681e6f49713c3975,2,30,7,37,11,2011-05-28 14:57:48,2011-05-28 14:57:48
e263f1f0057f6cac15ef588c681e6f49713c3975...befb02e3da0573fa788114e1c18c70b75f787f1f,1,10,0,10,1,2011-05-28 15:09:37,2011-05-28 15:09:37
befb02e3da0573fa788114e1c18c70b75f787f1f...d72b9c5ec5d55765998bb301b3425fbe84012c1f,2,10,0,10,2,2011-05-28 15:20:48,2011-05-28 15:20:48
d72b9c5ec5d55765998bb301b3425fbe84012c1f...18293cd724224282d6ca473fcbe6e7439d3eac0c,1,6,0,6,1,2011-05-28 15:27:50,2011-05-28 15:27:50
18293cd724224282d6ca473fcbe6e7439d3eac0c...ace84c8b7eb8b50842798bac9811d02928f58dd3,4,2,7,9,6,2011-05-28 17:06:03,2011-05-28 17:06:03
ace84c8b7eb8b50842798bac9811d02928f58dd3...18bfb14a2f774b115c8634cdaa3864cbdee91a94,1,4,0,4,1,2011-05-28 17:12:03,2011-05-28 17:12:03
ab2a7b51a8c3ead55a272fba58232d0823e519a2...04573324d52aaadf947f3a80190e4f54d8580932,1,9,2,11,2,2011-05-27 14:58:14,2011-05-27 14:58:14
ab2a7b51a8c3ead55a272fba58232d0823e519a2...1816e957770f8e3f0ad22658f741c5f0492da982,1,22,0,22,1,2011-05-27 03:56:45,2011-05-27 03:56:45
ab2a7b51a8c3ead55a272fba58232d0823e519a2...f8aae64e478066be7d05f5eb6970c356cafcfd36,4,10,3,13,5,2011-05-26 17:34:37,2011-05-26 17:34:37
746a10368acd38d80cd35c2b97202a9187d58a05...6654d5dd9982fb2f67c49e87b8b242c3964537b7,1,16,0,16,1,2011-03-15 00:41:51,2011-03-15 00:41:51
6654d5dd9982fb2f67c49e87b8b242c3964537b7...1b7868adca07d4a77b0d5b15d305eb6e15be9fe7,1,0,1,1,1,2011-03-15 00:42:12,2011-03-15 00:42:12
1b7868adca07d4a77b0d5b15d305eb6e15be9fe7...e1f37e311fe895916a5e821266617ddb3f26fef1,1,1,1,2,1,2011-03-15 00:42:51,2011-03-15 00:42:51
e1f37e311fe895916a5e821266617ddb3f26fef1...cb2362c006b25f8f2c655a50999c57ae48597c6b,1,1,1,2,1,2011-03-15 00:43:22,2011-03-15 00:43:22
cb2362c006b25f8f2c655a50999c57ae48597c6b...92cacc9552e720b7b29d788fdb24bd46548f5846,1,1,1,2,1,2011-03-15 00:43:37,2011-03-15 00:43:37
746a10368acd38d80cd35c2b97202a9187d58a05...5bbd87a33380ab4fb9cab6688b11cb98faa61cd7,1,62,0,62,1,2011-03-14 05:43:33,2011-03-14 05:43:33
5bbd87a33380ab4fb9cab6688b11cb98faa61cd7...ce41d0e5bdf7df7e4261ad6e5b3e3c0fa59dd890,1,60,0,60,1,2011-03-16 00:31:14,2011-03-16 00:31:14
746a10368acd38d80cd35c2b97202a9187d58a05...d4ea399b04ef57dd31097eadc316305d1e42a194,1,1,1,2,2,2011-03-13 23:11:32,2011-03-13 23:10:13
746a10368acd38d80cd35c2b97202a9187d58a05...fa344733e5d7cee33e4c3ba6a9a7241c7b6377ca,2,94,0,94,2,2011-03-13 22:21:48,2011-03-13 22:08:12
746a10368acd38d80cd35c2b97202a9187d58a05...a2d0bd7c296706b3a2f6b0125ab79748a95bb90c,1,26,0,26,1,2011-03-12 15:23:55,2011-03-12 15:23:55
a2d0bd7c296706b3a2f6b0125ab79748a95bb90c...a6b8bec8ecdb48a059f73e82a1df0bf3387beccc,2,71,0,71,2,2011-03-12 15:24:20,2011-03-12 15:24:20
a6b8bec8ecdb48a059f73e82a1df0bf3387beccc...f90cb7e7b9f8a3743071d6d15ca441f293379517,1,12,0,12,1,2011-03-12 15:25:27,2011-03-12 15:25:27
746a10368acd38d80cd35c2b97202a9187d58a05...c3a58b00040018743ead1e6672910433fc1ca7c2,1,1,0,1,1,2011-03-12 03:44:12,2011-03-12 03:44:12
746a10368acd38d80cd35c2b97202a9187d58a05...9d991a5080bea5c71e1b5f6838d5498c908c434b,1,1,1,2,1,2011-03-01 06:38:12,2011-03-01 05:21:49
746a10368acd38d80cd35c2b97202a9187d58a05...fadd5f74ce205ddb14735354170150745ae42ca6,1,37,0,37,1,2011-02-22 19:03:48,2011-02-22 19:03:48
fadd5f74ce205ddb14735354170150745ae42ca6...d926a55872b5a12ab8b987e9d86c02358d0c825e,1,2,2,4,2,2011-02-22 19:38:37,2011-02-22 19:38:37
746a10368acd38d80cd35c2b97202a9187d58a05...4144f4beea4e56231adeb3574d3516b35c3331cf,2,86,0,86,2,2011-02-22 16:05:25,2011-02-22 16:05:25
746a10368acd38d80cd35c2b97202a9187d58a05...7f69551498a78a6b30d706c89808fcd2ba000045,2,150,0,150,2,2011-02-22 15:56:25,2011-02-22 15:56:25
7a9cc198196cb0c935afe96e1de249c3a05ad413...26614b3478306d9f23ae9d817e70c1acba9b43de,1,16,0,16,1,2011-01-14 05:52:41,2011-01-14 05:52:41
26614b3478306d9f23ae9d817e70c1acba9b43de...5cca63a770ed78e17ffdf13bfbed5defc56edb92,1,3,4,7,2,2011-01-14 06:05:06,2011-01-14 06:05:06
5cca63a770ed78e17ffdf13bfbed5defc56edb92...c58942d3b25cf25867e3096e5f52f1c256647d8a,1,9,5,14,5,2011-01-14 07:26:31,2011-01-14 07:26:31
c58942d3b25cf25867e3096e5f52f1c256647d8a...277f664df33d4a9078bb55e7ddf0a669ca63c462,1,5,0,5,1,2011-01-14 07:29:24,2011-01-14 07:29:24
277f664df33d4a9078bb55e7ddf0a669ca63c462...e7c8673a45b9a65a672d2bb8e4e0d3f54a910c7c,1,1,1,2,1,2011-01-14 07:31:21,2011-01-14 07:31:21
7a9cc198196cb0c935afe96e1de249c3a05ad413...77d05fe8ab0f1b35af9332e889e384f935ce08f9,1,1,1,2,1,2011-01-10 16:01:11,2011-01-10 16:01:11
77d05fe8ab0f1b35af9332e889e384f935ce08f9...664b97a3c8fc167bda2c64e48b18b27de8dce4cd,2,60,0,60,2,2011-01-10 17:18:31,2011-01-10 17:18:31
7a9cc198196cb0c935afe96e1de249c3a05ad413...b61cae150a5f693ed1e2bd4a292feea899058e44,1,19,0,19,1,2011-01-10 15:16:04,2011-01-10 15:16:04
7a9cc198196cb0c935afe96e1de249c3a05ad413...f5c45c23ee7958395e80f97228c4267bfd0d4e6c,1,6,0,6,1,2011-01-10 04:31:18,2011-01-09 05:07:03
7a9cc198196cb0c935afe96e1de249c3a05ad413...8294cf44d1d348fd1590ee28b5be8483fb012153,2,3,2,5,2,2011-01-09 04:34:47,2011-01-09 04:34:47
7a9cc198196cb0c935afe96e1de249c3a05ad413...8d2b9d10e5105f9e0af0700e427e0567011ab45b,7,7,7,14,7,2011-01-09 02:15:57,2011-01-09 02:15:57
01b0366f3e27cf30f3882870100f14625fc267d1...c52fea808210bb4f81915306855b6bd00a5fe219,1,28,7,35,5,2011-02-18 13:11:24,2011-02-18 12:17:00
c52fea808210bb4f81915306855b6bd00a5fe219...6467e90efbb8a0064045ccd2c09f1b0513d782c3,1,25,0,25,1,2011-02-18 13:11:24,2011-02-18 12:48:27
01b0366f3e27cf30f3882870100f14625fc267d1...4b7038f8f46f842df02acdce9b8fb21f6f2b3050,1,14,0,14,1,2011-02-17 19:15:58,2010-11-23 04:05:33
4b7038f8f46f842df02acdce9b8fb21f6f2b3050...e0ab7f9fb5774381d846cd90d06a501ec91a3ee9,1,0,0,0,0,2011-02-17 19:15:58,2010-11-24 04:22:55
01b0366f3e27cf30f3882870100f14625fc267d1...6b610d7dd80ab6cf1142bc615931c17c41395f00,1,3,0,3,1,2011-02-15 19:27:25,2011-02-15 19:27:25
01b0366f3e27cf30f3882870100f14625fc267d1...ab1cbe9038bee71bae1d5b7ce1d8cd9f6a94d7f3,1,2,2,4,2,2011-02-14 09:19:01,2011-02-14 09:19:01
01b0366f3e27cf30f3882870100f14625fc267d1...6b5c4e27b24f0652e7e53b6abfe9634589271572,1,3,1,4,3,2011-02-13 11:05:12,2011-02-13 11:05:12
01b0366f3e27cf30f3882870100f14625fc267d1...8aec32b48bb88e980150a43586e7e02b9156e165,1,7,0,7,2,2011-02-07 20:37:18,2011-02-07 20:09:06
01b0366f3e27cf30f3882870100f14625fc267d1...90a9a5f251b2273735b58be55014d94582f1db91,1,4,0,4,1,2011-02-04 04:24:33,2011-02-04 04:24:33
01b0366f3e27cf30f3882870100f14625fc267d1...ae8b3b6dbaa444a1b08a63cadabaf3f1781b7c11,1,48,0,48,1,2011-02-03 22:02:51,2011-02-03 21:47:08
01b0366f3e27cf30f3882870100f14625fc267d1...051fb5f1d5d0c72812989bd4dfd0be33f43d75ad,1,60,3,63,4,2011-02-03 14:37:39,2011-02-03 14:37:39
051fb5f1d5d0c72812989bd4dfd0be33f43d75ad...cc90e3aa06cc3de32e4679dcccd0f00a2a4bdf79,1,1,1,2,1,2011-02-04 00:33:20,2011-02-04 00:33:20
01b0366f3e27cf30f3882870100f14625fc267d1...faac3ba8fcad6ad1742f82a7d508a37c0c70d809,2,26,44,70,2,2011-01-30 08:19:47,2011-01-30 07:21:49
01b0366f3e27cf30f3882870100f14625fc267d1...fcc7801435fd2c5c6defcfbfc736e22341500a9d,1,1,1,2,1,2011-01-24 14:49:49,2011-01-24 14:49:49
7b0b83623fb54d21932014c9a6267e6dc03976db...0d476e02cd1b5660b09acde25725191044f062ac,1,8,0,8,1,2011-06-01 10:45:15,2011-06-01 10:45:15
3ed19c4895cc64d4f51a7f370a93c9d0cee567d2...0c41b1cdc3ff7b00ffb2310b91becb91b31704f7,2,25,24,49,11,2011-06-03 18:05:25,2011-06-03 18:05:25
142c03dbd223683fd2d99f878b68f0f075cf33fb...c014dca141588737a13c4e3974adb4afd58c09bb,1,2,2,4,2,2011-05-31 22:59:38,2011-05-31 22:13:23
142c03dbd223683fd2d99f878b68f0f075cf33fb...f4878971752b6d76743c29d6f478d20c84755b8e,1,3,3,6,2,2011-05-31 12:16:43,2011-05-31 12:16:43
142c03dbd223683fd2d99f878b68f0f075cf33fb...714cfb1db2966ddfc0330a09e620164189233b49,1,98,0,98,1,2011-05-31 09:46:26,2011-05-31 09:46:26
714cfb1db2966ddfc0330a09e620164189233b49...9c306670a73ec3e313666fc497952153bdc16220,1,13,7,20,5,2011-05-31 12:07:38,2011-05-31 12:07:38
9c306670a73ec3e313666fc497952153bdc16220...a9b6f081b4a405dd1365df9c35aa3603196e3fc7,1,1,4,5,2,2011-06-01 08:11:06,2011-06-01 08:11:06
a9b6f081b4a405dd1365df9c35aa3603196e3fc7...70cb607b7bee04ceef74d6f7aa80589e009e4c78,1,4,9,13,5,2011-06-07 13:28:43,2011-06-07 13:28:43
142c03dbd223683fd2d99f878b68f0f075cf33fb...93dab36fcb7f138aba32e5102c621180055d67fe,1,26,0,26,1,2011-05-30 23:10:26,2011-05-30 23:10:26
142c03dbd223683fd2d99f878b68f0f075cf33fb...1e3b441ce7e0b8706867801c1e5e7ca6760ff17e,4,3,25,28,7,2011-05-30 14:09:00,2011-05-30 14:07:15
1e3b441ce7e0b8706867801c1e5e7ca6760ff17e...9801ad6453caa05925847f63401e6266378eb2de,1,0,3,3,1,2011-05-30 15:10:35,2011-05-30 15:10:08
23556491e66ab0229034681e1cce8481936e7e7b...52df85440ee8ead8f17d3aa3e1fedf187162313c,1,1,1,2,2,2011-03-16 19:20:35,2011-03-16 19:20:35
2440954f062a19f1b7393c02701cc71d19539e84...5c1b341132119f08047a506e2c2b06fa0c0db52e,1,1,1,2,1,2011-05-24 18:24:52,2011-05-24 18:15:58
70d0beae22e7d97d4380af32dae1618f45e3dd4b...14404eb7a00dcbafcaf81402844f0eb24243cbbb,1,8,0,8,1,2011-04-28 19:29:27,2011-04-28 19:29:27
70d0beae22e7d97d4380af32dae1618f45e3dd4b...e5f77b8f0496e5915383f2f456f91a20f5ff4ace,2,128,0,128,2,2011-04-28 19:05:52,2011-04-28 19:05:52
70d0beae22e7d97d4380af32dae1618f45e3dd4b...1783b16d25029b72bdd1aa164f3e76fd29702e70,1,1,0,1,1,2011-04-26 21:22:42,2011-04-26 21:22:42
8bf1d8edc39ca4575448b5e4483cbebf47d8dc67...0504a01012b88e6eb74040ed599bddf29163fd69,1,2,1,3,1,2011-03-07 12:49:30,2011-03-07 12:49:30
0504a01012b88e6eb74040ed599bddf29163fd69...c2e8bed253d25699f826fd7b65d965944b42a21c,1,54,0,54,1,2011-03-07 13:22:06,2011-03-07 13:22:06
3bb21afa88f136c18073808852118dedd7e21fbf...c1b5d72830629c737f40abebf87fcca797bf730c,1,26,0,26,1,2011-06-02 03:39:07,2011-06-02 03:38:25
3bb21afa88f136c18073808852118dedd7e21fbf...bf86502b6940d938c488254befdf9461cb50591b,1,80,0,80,1,2011-06-02 00:34:39,2011-02-03 22:25:45
3bb21afa88f136c18073808852118dedd7e21fbf...1db6575f14d07b9ed3b0ce530837a8a0713b69d0,4,91,36,127,4,2011-06-02 00:33:16,2011-02-04 03:46:52
1db6575f14d07b9ed3b0ce530837a8a0713b69d0...a5c383258b760ad1c34d550edb86d7d63e8f5877,1,7,5,12,2,2011-06-02 00:33:16,2011-04-18 03:17:48
3bb21afa88f136c18073808852118dedd7e21fbf...f401d6ef78a94b723ce841b77151eaac477b8074,1,85,49,134,11,2011-06-02 00:24:15,2011-02-23 04:32:50
f401d6ef78a94b723ce841b77151eaac477b8074...5e5096dad60ef0f41aea384c1e249a3bf0377be6,1,5,0,5,1,2011-06-02 00:24:15,2011-04-22 23:13:37
3bb21afa88f136c18073808852118dedd7e21fbf...5aa6b0fae5f1fa82c90003c2020849b4bb87c9e8,2,1,19,20,2,2011-06-02 00:22:36,2011-05-01 15:46:11
0c41b1cdc3ff7b00ffb2310b91becb91b31704f7...7c9474508cade14102a2fe1c63ad845fda521bec,2,8,10,18,4,2011-06-04 09:52:13,2011-06-04 09:02:25
11ff3b642db87012ed8a19d6a0c5baa5dcd6a004...ab13d0756fcbf690d9550ec1329ff99da0dc3c75,1,3,0,3,2,2012-12-02 20:16:14,2012-09-28 15:19:28
86b8827d27a72471eed0e39f3681b4d533811082...915c28752eb8bfb9610e14f62161ab3bd573d218,1,1,1,2,1,2011-06-07 13:32:48,2011-06-07 13:32:48
915c28752eb8bfb9610e14f62161ab3bd573d218...73946a6066fa8bf740b4765b7e204df9599f9689,1,1,1,2,2,2011-06-07 13:40:18,2011-06-07 13:40:18
73946a6066fa8bf740b4765b7e204df9599f9689...4a7392fdd0be8fafcaffccc206f23c7746129fb8,1,2,2,4,2,2011-06-07 13:40:32,2011-06-07 13:40:32
4a7392fdd0be8fafcaffccc206f23c7746129fb8...d99284f6b569a0860ed14330c8c9eaf5f0441fe8,1,1,1,2,1,2011-06-07 13:42:55,2011-06-07 13:42:55
d99284f6b569a0860ed14330c8c9eaf5f0441fe8...3eae652a6d4bc5f280bb7f9d33000f378becf13c,1,1,1,2,1,2011-06-08 15:33:29,2011-06-08 15:33:29
52df85440ee8ead8f17d3aa3e1fedf187162313c...2497c57976b1e5002ebecd7ffa5c35bc87ada903,1,2,2,4,2,2011-03-24 08:47:48,2011-03-24 08:47:48
52df85440ee8ead8f17d3aa3e1fedf187162313c...06063ab695ecfe6fa7737511a070b24412ee1b2a,2,10,3,13,3,2011-03-24 04:20:08,2011-03-24 04:20:08
52df85440ee8ead8f17d3aa3e1fedf187162313c...e8a7a31ef66093f1b1ab034e84e01a147fa8b28a,1,1,1,2,1,2011-03-24 04:01:53,2011-02-08 07:21:46
52df85440ee8ead8f17d3aa3e1fedf187162313c...d03a6176aacd583993c02c7e837d10751c431875,1,27,0,27,1,2011-03-20 11:31:13,2011-03-02 09:50:43
52df85440ee8ead8f17d3aa3e1fedf187162313c...2d5412e99be6d9fab50169ad0cf290e022fc6e9b,1,21,0,21,2,2011-03-20 00:50:24,2011-03-20 00:50:24
2d5412e99be6d9fab50169ad0cf290e022fc6e9b...a15a8c4a98bc1aff024c3ef44dec48309ff4f90b,1,18,0,18,1,2011-03-20 00:51:22,2011-03-20 00:51:22
52df85440ee8ead8f17d3aa3e1fedf187162313c...4facba9824b7c3d0115c5f66e5b1517bd5674027,1,9,0,9,1,2011-03-17 21:29:58,2011-03-17 21:29:58
52df85440ee8ead8f17d3aa3e1fedf187162313c...7cc4ab9b3f79ed2e56c8bebeb6fbd4b870b53de2,1,10,0,10,1,2011-03-17 18:22:51,2011-03-17 18:22:51
a89d33c0607320e6ce283dff745cb5aecfa19cd4...077baa7bb1aba75d3005b7c6e5df4f53e0ea15d1,1,21,3,24,3,2011-04-29 07:22:56,2011-04-29 07:22:56
dc76c5694dda120fcac02b2d75ef0a149de94a2f...57d699ee33e5d4673d8c6a2a9ba42bd25d7b737c,1,0,4,4,1,2011-04-27 23:46:23,2011-04-27 23:46:23
57d699ee33e5d4673d8c6a2a9ba42bd25d7b737c...58a7cf19b7af136c5f59ee706ffe4772871f00fa,1,3,3,6,2,2011-04-28 23:12:05,2011-04-28 23:12:05
c2e8bed253d25699f826fd7b65d965944b42a21c...d807221f607cc7ef02e17a9aa60b1f5f18a886ab,1,1,1,2,1,2011-03-07 13:36:12,2011-03-07 13:36:12
141d355e2ec9f0f516bbf07d08eb5f38903f48e8...9b63a03bcfb7a6c34281d7d905575c5647e9c8d2,1,4,4,8,4,2011-06-03 14:32:05,2011-06-03 14:32:05
e8bd400bffc51c83e0ef6671ecb5f364dc2f5065...715be61966acecb4d30953e3dd4c9d8a3f8637eb,1,107,0,107,1,2011-06-05 15:37:07,2011-06-05 15:37:07
e8bd400bffc51c83e0ef6671ecb5f364dc2f5065...35b879a17b965b0ea28009c4561962c9ed17ef1f,1,40,12,52,8,2011-06-05 02:34:17,2011-06-05 01:07:55
35b879a17b965b0ea28009c4561962c9ed17ef1f...40b7f2099d393950e26d1a9720743e161b1abe49,1,15,4,19,4,2011-06-05 02:34:49,2011-06-05 02:16:10
e8bd400bffc51c83e0ef6671ecb5f364dc2f5065...9b4a89f327a045ed5e756ae4e75d1aac68803164,1,1,3,4,2,2011-06-04 18:03:10,2011-06-04 18:03:10
1eb52d43851ae2d9bdeff3df073976e1935f5979...cbaa97d8c38bf7bc1a92480ae83e323e1e0cac02,1,8,0,8,1,2011-07-23 15:09:45,2011-07-23 14:42:43
1eb52d43851ae2d9bdeff3df073976e1935f5979...127d2ae57b01ae13dd6017c3c104a45a0086e88e,1,1,1,2,1,2011-07-18 04:01:06,2011-07-18 04:01:06
1eb52d43851ae2d9bdeff3df073976e1935f5979...edcd4f7eea357cefee37a25a371e1dd5d1a6b598,1,1,1,2,1,2011-07-17 18:01:48,2011-07-17 18:01:48
1eb52d43851ae2d9bdeff3df073976e1935f5979...e7e9e5bbe608fd7572a810f36e7f1b3321c25136,1,67,0,67,1,2011-07-16 22:42:09,2011-07-16 22:42:09
1eb52d43851ae2d9bdeff3df073976e1935f5979...66c6260c10422bf50c474c9654a7928ce99e7ceb,1,32,0,32,1,2011-07-16 15:15:15,2011-07-16 15:15:15
2497c57976b1e5002ebecd7ffa5c35bc87ada903...16f9dfb3aa6d301d4345df9af017bd6982273919,1,85,0,85,1,2011-03-31 18:51:29,2011-03-31 18:51:29
2497c57976b1e5002ebecd7ffa5c35bc87ada903...d5ce689a0c10f71967dcc163cd66ef9bd2778416,1,9,0,9,1,2011-03-26 14:06:30,2011-03-26 14:06:30
05fc020a081846245a5a4a26d190652cb8cf9add...57f55e69ed967e93c0fd44a6a7e470781eb38029,1,18,0,18,18,2011-04-03 18:01:48,2011-04-03 11:50:05
57f55e69ed967e93c0fd44a6a7e470781eb38029...2e9492969b0ea90932ad3f4298330b75ef8cf2ce,1,10,8,18,9,2011-04-03 18:01:48,2011-04-03 13:43:39
80ab595696f30d89bf52bb5189fa39518a3ca780...8fe6ea388973defc6bb77a32fb86cef5b8231aea,1,18,2,20,3,2012-12-02 19:55:19,2012-12-02 19:55:19
b6be2889aaa28250ec8ed504e35ac37024866fb7...971b071dc67f423d8b2a6f476e1dd58819049f41,1,50,0,50,1,2011-04-12 08:40:53,2011-03-07 14:15:46
da0cc3701e75e2c8be07ee4eb0dc6b1b68e3fa06...f1af41589960f7fc98d270c70a80b351b703e53e,1,1,1,2,1,2011-03-09 11:19:01,2011-03-09 11:19:01
db90589c8a02e98e657af17bb0b460b752d9ed61...3a408f326f1436a81ae481610c76c8938903df4f,1,3,2,5,3,2011-10-10 16:04:13,2011-10-10 16:04:13
3a408f326f1436a81ae481610c76c8938903df4f...a01b1fefe63101fdc36291d0ec2097bdc3994f22,1,9,5,14,4,2011-10-10 16:04:24,2011-10-10 16:04:24
077baa7bb1aba75d3005b7c6e5df4f53e0ea15d1...208b225a2f12076099255c329abbb3569723b39b,1,46,0,46,1,2011-04-29 11:11:38,2011-04-29 11:11:38
ed990f61ff66a5c409ef2d8a444820cecf098188...a38774c98d1c08f82b1325a40b2de1a76586e02a,1,3,0,3,1,2011-07-18 13:54:59,2011-05-17 18:13:07
ed990f61ff66a5c409ef2d8a444820cecf098188...f22460f18125421a73a60893ae97ed545465bca7,1,91,0,91,1,2011-06-19 01:48:35,2011-06-18 23:24:55
f22460f18125421a73a60893ae97ed545465bca7...03f71d14dd1866b9da58f28f8f40f5c12bf3072f,1,1,1,2,1,2011-06-19 16:22:23,2011-06-19 16:22:23
ed990f61ff66a5c409ef2d8a444820cecf098188...c5a01fe422c0b511be5972735b1dd9ac22a82dff,1,15,0,15,1,2011-06-15 14:15:52,2011-06-15 14:15:52
c5a01fe422c0b511be5972735b1dd9ac22a82dff...1d17502aed5fc04cd1ca3eb35757b5ba2822414a,1,4,15,19,1,2011-07-16 05:18:14,2011-07-16 05:18:14
ed990f61ff66a5c409ef2d8a444820cecf098188...527355eae3c8b019ce203c38b6aa5ffd818c3640,1,4,1,5,1,2011-06-14 22:17:22,2011-06-14 22:17:22
ed990f61ff66a5c409ef2d8a444820cecf098188...6c95c4b68a97b41682084834b6e30822b6f06ab9,1,1,1,2,1,2011-06-12 20:57:00,2011-06-12 20:57:00
ed990f61ff66a5c409ef2d8a444820cecf098188...55eda0c48b42e3ccd1b12579cd46d20332b828c1,1,14,0,14,1,2011-06-10 13:38:59,2011-06-10 13:38:59
ed990f61ff66a5c409ef2d8a444820cecf098188...f9bf396e4ac68299f1370ed54350cc14ce954eea,1,222,0,222,1,2011-06-10 04:22:33,2011-06-10 04:22:33
ed990f61ff66a5c409ef2d8a444820cecf098188...f0451195f63b3607461bda1570c5fb2a4e429b3e,1,5,1,6,1,2011-06-05 23:57:21,2011-06-05 23:57:21
ed990f61ff66a5c409ef2d8a444820cecf098188...5444d2088c97dc776dcbd17acf55dd54b9d7060a,1,11,0,11,7,2011-06-05 22:19:46,2011-06-05 22:19:46
ed990f61ff66a5c409ef2d8a444820cecf098188...25adbe81a55664335e0166c202b8d8424a67c8aa,2,2,6,8,3,2011-06-05 12:08:58,2011-05-29 13:32:44
e7e9e5bbe608fd7572a810f36e7f1b3321c25136...8e77ad468dd22f25c461a0f69f9c03cbb2fb2d05,1,2,1,3,1,2011-07-20 02:38:29,2011-07-20 02:38:29
66c6260c10422bf50c474c9654a7928ce99e7ceb...c09e2f2986aafbf2a67004f8df6b5dd10abb8d61,1,7,7,14,6,2011-07-18 15:05:05,2011-07-18 15:05:05
2e9492969b0ea90932ad3f4298330b75ef8cf2ce...14a1877311bd0a9cf9c4db0e44e55da0fba77c5c,2,11,0,11,2,2011-04-13 14:48:47,2011-04-13 14:48:47
14a1877311bd0a9cf9c4db0e44e55da0fba77c5c...ca4dabb45e14d8cd38e07c4ffadf9473ceb2193b,1,161,0,161,1,2011-04-13 15:23:25,2011-04-13 15:23:25
ca4dabb45e14d8cd38e07c4ffadf9473ceb2193b...bbf1f87ee6aa73a11bcb0a3b33fbe7349d20ebcb,1,1,1,2,1,2011-04-13 15:24:44,2011-04-13 15:24:44
bbf1f87ee6aa73a11bcb0a3b33fbe7349d20ebcb...2fba4486bfa63cf2a4a11a34c94ce123127ef4c9,2,21,0,21,2,2011-04-13 15:34:51,2011-04-13 15:34:51
2e9492969b0ea90932ad3f4298330b75ef8cf2ce...993e05da50543b9c2dcc5e4fedb93afd1c8b020c,10,4,19,23,10,2011-04-08 14:12:22,2011-04-08 14:12:22
993e05da50543b9c2dcc5e4fedb93afd1c8b020c...ef4175981b78ca6ef24f7776ab213f3b71488472,2,6,2,8,2,2011-04-08 15:10:14,2011-04-08 15:10:14
ef4175981b78ca6ef24f7776ab213f3b71488472...235733e5e224539cf5002a02694d021902fd9550,1,0,4,4,1,2011-04-08 15:12:21,2011-04-08 15:12:21
235733e5e224539cf5002a02694d021902fd9550...16ac094a43052fb57eda9503174006a84a61a414,2,4,4,8,2,2011-04-12 13:28:15,2011-04-12 13:28:15
16ac094a43052fb57eda9503174006a84a61a414...6bf906a2622ddea1e9aae5d23c544d37fc4b6a76,8,11,15,26,10,2011-04-12 21:41:09,2011-04-12 21:41:09
6bf906a2622ddea1e9aae5d23c544d37fc4b6a76...757ebfcbd20b0893d8c9529eed2dfd428868f431,1,3,3,6,2,2011-04-12 21:50:15,2011-04-12 21:50:15
757ebfcbd20b0893d8c9529eed2dfd428868f431...796f5164f306da2f4e6ab7cbadc17b78f5f683af,1,2,4,6,1,2011-04-12 23:53:55,2011-04-12 23:53:55
2e9492969b0ea90932ad3f4298330b75ef8cf2ce...d138751cbd721bf7036e88cb1a2bafc9ebb87366,1,3,3,6,2,2011-04-04 11:49:02,2011-04-04 11:30:39
d138751cbd721bf7036e88cb1a2bafc9ebb87366...a3e92892bbc95acc270d93b45be05c55348da55c,1,3,1,4,2,2011-04-04 11:56:00,2011-04-04 11:44:48
a3e92892bbc95acc270d93b45be05c55348da55c...0cc0915bf83c1915575182d1287abfc6dd3e6f3c,1,6,9,15,3,2011-04-04 12:02:50,2011-04-04 12:02:50
0cc0915bf83c1915575182d1287abfc6dd3e6f3c...91e4f3d667cc04148fafc4675174424daf5f6b5a,1,1,1,2,1,2011-04-12 08:11:53,2011-04-03 22:54:43
2e9492969b0ea90932ad3f4298330b75ef8cf2ce...4cd4167c8d988656eed4896d6d1343e311ce078c,1,5,5,10,5,2011-04-03 19:28:19,2011-04-03 19:28:19
971b071dc67f423d8b2a6f476e1dd58819049f41...6f7d51c68d4de102f295d3b543ccb5c61dea2c3c,2,16,2,18,3,2011-04-29 09:24:29,2011-04-29 09:24:29
971b071dc67f423d8b2a6f476e1dd58819049f41...07cee28e31753f8cf424e413aa5f9754720d367b,1,19,0,19,1,2011-04-23 20:31:15,2011-04-23 20:31:15
971b071dc67f423d8b2a6f476e1dd58819049f41...5a957c4d2ecc12e90304d13b3ae724843f0fcb7b,1,1,1,2,1,2011-04-21 22:53:44,2011-04-21 22:53:44
971b071dc67f423d8b2a6f476e1dd58819049f41...6f53b3130d5aee8461b0be30e5589e5673929318,1,1,0,1,1,2011-04-21 21:16:29,2011-04-21 21:16:29
971b071dc67f423d8b2a6f476e1dd58819049f41...eb3d1576bf593c900d0e0fd9465ca3a076779fe0,1,28,5,33,6,2011-04-21 11:40:34,2011-04-21 11:40:34
971b071dc67f423d8b2a6f476e1dd58819049f41...34f1944016a7671fe47aca99f18f25d19f6ff5dc,1,6,0,6,1,2011-04-20 20:32:28,2011-04-20 13:54:51
971b071dc67f423d8b2a6f476e1dd58819049f41...96ec1e12498fb2c3200fef941ad6eadece723a0d,2,8,6,14,2,2011-04-20 19:13:38,2011-04-20 13:50:55
971b071dc67f423d8b2a6f476e1dd58819049f41...c7c959de60add8371e08926d642b2bbb7406ce84,1,4,0,4,1,2011-04-19 23:01:18,2011-04-19 23:01:18
c7c959de60add8371e08926d642b2bbb7406ce84...7d9628b2dcccb5627c59380de331e3c906c8164d,1,1,0,1,1,2011-04-20 02:40:46,2011-04-20 02:40:46
971b071dc67f423d8b2a6f476e1dd58819049f41...1e2152fcf3103c3acbae49caa0f6184b55c7bb17,1,6,1,7,1,2011-04-18 11:48:35,2011-04-18 11:48:35
1e2152fcf3103c3acbae49caa0f6184b55c7bb17...5f415c465a576a78d7e1577e472309fdd4c7621f,1,1,1,2,1,2011-04-18 11:50:14,2011-04-18 11:50:14
5f415c465a576a78d7e1577e472309fdd4c7621f...1354eb124893df9c8f60f668550efcafb94eb05f,1,1,6,7,1,2011-04-19 02:51:28,2011-04-19 02:51:28
971b071dc67f423d8b2a6f476e1dd58819049f41...5bcfab37312511a7ffc3e8242ba8b8a622ecf061,1,137,0,137,1,2011-04-16 12:49:29,2011-04-16 12:44:38
971b071dc67f423d8b2a6f476e1dd58819049f41...14f07ebc68da8b06cdb0a4fdb435ac928ff419f1,2,146,0,146,2,2011-04-14 23:22:18,2011-04-14 23:22:18
971b071dc67f423d8b2a6f476e1dd58819049f41...60bae66bbfebe7bf78378564ffe9aed00c3342b4,1,12,0,12,1,2011-04-13 16:07:10,2011-04-07 08:23:06
971b071dc67f423d8b2a6f476e1dd58819049f41...d6c150decca10ba2a3566fe1dc1144f7e37f1c5b,1,5,0,5,1,2011-04-13 14:55:24,2011-04-13 14:55:24
d6c150decca10ba2a3566fe1dc1144f7e37f1c5b...b2d5b4365019a466fb8481598de87159704ded7a,1,1,1,2,1,2011-04-14 15:15:26,2011-04-14 15:15:26
971b071dc67f423d8b2a6f476e1dd58819049f41...911837c48fc6387daa341b3cc5be21b1b1cade57,1,2,3,5,1,2011-04-12 22:33:17,2011-04-12 22:30:45
f9e2af2bd7e567114724c4ca7f4a1727a656e7e2...21276546e9614576ce6e1a6be1393abce393d04f,1,14,3,17,2,2011-05-26 00:18:45,2011-02-23 08:38:15
c8ac3356c8da5ba0290066309b0fcd16d223f187...86fa4385c51d6778b1358d6f7134c1243feace87,1,27,7,34,3,2011-04-29 09:59:59,2011-04-29 09:59:59
c8ac3356c8da5ba0290066309b0fcd16d223f187...7377ba3f7a08bb11114ddae1b421599e4073da96,2,334,1,335,2,2011-04-29 09:54:42,2011-04-29 09:54:31
784c56cd09842c28df9a2e78279dd0667db8da47...5f103c750891b926aab9f24f896853ea2a0493d5,1,15,1,16,2,2011-04-29 17:26:20,2010-10-13 14:54:12
784c56cd09842c28df9a2e78279dd0667db8da47...626fa5b1d83abb145452deaa610fc8f7a59293c1,1,5,4,9,3,2011-04-29 15:12:40,2011-04-29 15:12:40
784c56cd09842c28df9a2e78279dd0667db8da47...6d899e23917ea9278b06f60df6b5cc4fcd5b60c3,1,30,0,30,1,2011-04-29 12:28:46,2011-04-29 12:28:46
3552423de3d5ae439dc815b7f9c4cbeab3fbebe8...9e8194355c1a4f69dc52fbe2699fbce1be5c6493,1,37,0,37,1,2011-07-13 21:54:30,2011-06-12 11:13:39
9e8194355c1a4f69dc52fbe2699fbce1be5c6493...05883f383143fa4821a5b07a748a800c0299f1fd,1,3,3,6,2,2011-07-13 21:54:30,2011-06-12 13:52:58
05883f383143fa4821a5b07a748a800c0299f1fd...3aee5c19412dea541495e10f1c4cc7a6d8e4af50,1,9,9,18,6,2011-07-13 21:54:30,2011-06-12 17:16:04
3aee5c19412dea541495e10f1c4cc7a6d8e4af50...86958a32f3d3e647fc61e92700a9ce393e11a3cb,1,2,2,4,2,2011-07-13 21:54:30,2011-06-12 18:28:27
86958a32f3d3e647fc61e92700a9ce393e11a3cb...69d30a6302f8c7daf6ad5ecf23224074789843db,1,4,7,11,4,2011-07-13 21:54:30,2011-06-12 21:16:47
69d30a6302f8c7daf6ad5ecf23224074789843db...37fcd4af049ad9b755d7b1d32cf63b537da0342c,1,1,1,2,1,2011-07-13 21:54:30,2011-07-13 21:39:23
37fcd4af049ad9b755d7b1d32cf63b537da0342c...a77e6fb003cc80fbbff5d453a5ca3d38638d99ed,1,15,15,30,4,2011-07-13 21:54:30,2011-07-13 21:40:23
a77e6fb003cc80fbbff5d453a5ca3d38638d99ed...60e104acd1710c04057d079cfa5ac9316762f580,2,34,34,68,2,2011-07-13 21:54:30,2011-07-13 21:41:09
60e104acd1710c04057d079cfa5ac9316762f580...ba5fa3abc8ccf1f05e48c9b201282792c956c337,1,1,0,1,1,2011-07-13 21:54:30,2011-07-13 21:41:36
ba5fa3abc8ccf1f05e48c9b201282792c956c337...7d19ae8fab80c826156f984aa6dd8221a9aaada0,1,0,11,11,2,2011-07-13 21:54:30,2011-07-13 21:42:44
3552423de3d5ae439dc815b7f9c4cbeab3fbebe8...8f62ef490de6945308c144a3bee7c3509a16d421,1,14,0,14,1,2011-07-13 03:20:21,2011-07-13 03:20:21
3552423de3d5ae439dc815b7f9c4cbeab3fbebe8...b61fcb64abfd733a95f0e83e3009086959623252,1,174,0,174,1,2011-06-30 13:19:50,2011-06-30 13:19:50
3552423de3d5ae439dc815b7f9c4cbeab3fbebe8...e43eec99f94c00a6a9d2b30f9c449aff5ab0dfe5,2,62,0,62,2,2011-06-29 02:09:00,2011-06-29 01:42:50
3552423de3d5ae439dc815b7f9c4cbeab3fbebe8...b727e337adb0264b3d03ffdd0a4af3ba9802572a,1,14,2,16,3,2011-06-27 08:37:27,2011-06-27 08:37:27
3552423de3d5ae439dc815b7f9c4cbeab3fbebe8...929c64e4c6f53e926757b7d9d89ab7da4f9a0d0d,1,47,0,47,1,2011-06-21 09:09:57,2011-06-21 09:09:57
929c64e4c6f53e926757b7d9d89ab7da4f9a0d0d...a335e9df9f13a5caa2b83cad9ebcfaa25b748202,1,3,0,3,1,2011-06-21 10:50:39,2011-06-21 10:50:39
a335e9df9f13a5caa2b83cad9ebcfaa25b748202...7ef7ffc5ebd21bff4ab8e42989c63ba8204c0e5b,1,0,1,1,1,2011-06-21 11:53:11,2011-06-21 11:53:11
7ef7ffc5ebd21bff4ab8e42989c63ba8204c0e5b...499819ced108aa4b0d90dd0ac922a174c965d814,1,22,3,25,1,2011-06-29 07:28:18,2011-06-29 07:26:42
dcab0cdc54df8dbd3c192106eb8b6b4c770ac118...512f3678c07accd6d121e9c0d6d50f008c99708a,1,25,17,42,6,2011-07-23 15:22:39,2011-07-23 15:22:39
c082174a4ed388a2f71260c7405dbfc89daee0e6...fea4e54b1053764df10f507c233286281133fe90,1,47,0,47,1,2011-07-19 19:47:26,2011-07-19 19:47:26
fea4e54b1053764df10f507c233286281133fe90...5d5d2f94be7a13c3a5069bed6bfc2070fa7f014c,2,11,3,14,4,2011-07-19 20:02:34,2011-07-19 20:02:34
5d5d2f94be7a13c3a5069bed6bfc2070fa7f014c...76dd2d8b05cb1b8d34653732e8b3939f68e8a67a,1,1,1,2,1,2011-07-24 09:58:41,2011-07-24 09:58:41
76dd2d8b05cb1b8d34653732e8b3939f68e8a67a...d15d3a5b01a527d8642cc0b173a2f8d1b92332c0,1,4,3,7,3,2011-07-24 18:51:27,2011-07-24 18:51:27
d15d3a5b01a527d8642cc0b173a2f8d1b92332c0...cbf662744ffcf998829cabbd7b2550861c13d1d8,1,69,21,90,9,2011-08-03 07:42:16,2011-08-03 07:42:16
3350c2298f6e0b629c8efe9821262a093f975fd3...fd732eb3ff4984ddc9109e950cf7ceb472cb9824,3,0,0,0,0,2011-07-27 17:28:55,2011-07-27 17:28:55
3350c2298f6e0b629c8efe9821262a093f975fd3...6bf468f92c9302f84d3b21358202c3a956cad02b,1,1,0,1,1,2011-07-25 15:02:25,2011-07-25 15:02:25
3350c2298f6e0b629c8efe9821262a093f975fd3...3cb33fc254290a848a602af634cfa26179d630e5,1,1,1,2,1,2011-07-24 23:46:17,2011-07-24 23:46:17
3cb33fc254290a848a602af634cfa26179d630e5...7b25a3fca90e31f2c272fd8d2ef1dfa3e61dc9e4,1,1,1,2,1,2011-07-24 23:50:54,2011-07-24 23:50:54
3350c2298f6e0b629c8efe9821262a093f975fd3...0848acfb25b6601adcabc406089b6c7788df5749,2,12,0,12,2,2011-07-24 19:48:21,2011-07-23 21:34:02
0848acfb25b6601adcabc406089b6c7788df5749...fc49b4a4ded376cd82b813dcb6d72fdc050b7bed,2,3,3,6,2,2011-07-28 17:52:53,2011-07-28 17:52:35
3350c2298f6e0b629c8efe9821262a093f975fd3...428f18cf428fd86bd6e99c4363e5f25d0e392506,1,5,0,5,3,2011-07-23 21:09:03,2011-07-23 21:09:03
2fba4486bfa63cf2a4a11a34c94ce123127ef4c9...5d90f58b37fd67184c4aed3d81a1d3703f8fe832,2,0,11,11,2,2011-04-13 18:21:13,2011-04-13 18:21:13
5d90f58b37fd67184c4aed3d81a1d3703f8fe832...a183bcbc6d8d61bd9c1077b45d1c5b3239e96a71,2,23,3,26,5,2011-04-14 05:17:10,2011-04-14 05:17:10
a183bcbc6d8d61bd9c1077b45d1c5b3239e96a71...49c0a1381a7bd48464a1c33cac6e09770749f795,2,19,3,22,5,2011-04-15 16:13:01,2011-04-15 16:13:01
49c0a1381a7bd48464a1c33cac6e09770749f795...9b29136ec65953004f064ec4a834ae7b1f2949e7,1,1,1,2,1,2011-04-15 16:21:22,2011-04-15 16:21:22
9b29136ec65953004f064ec4a834ae7b1f2949e7...6f1929f822d24c6cfc9cecf574cb21c6b3817bb5,1,1,2,3,1,2011-04-15 16:22:27,2011-04-15 16:22:27
6f1929f822d24c6cfc9cecf574cb21c6b3817bb5...574de93efbba22db0ec816ecec717d502dfa333e,1,10,3,13,3,2011-09-06 08:50:53,2011-09-06 08:50:53
574de93efbba22db0ec816ecec717d502dfa333e...7066bf7c6b522af9147ebf03c00361c4c6490d42,1,2,2,4,2,2011-10-10 12:54:20,2011-10-10 12:54:20
2fba4486bfa63cf2a4a11a34c94ce123127ef4c9...df0b37f9db3f8a1d445bebf30d04039eb247ab71,0,0,0,0,0,2011-04-13 15:45:04,2011-04-13 15:45:04
df0b37f9db3f8a1d445bebf30d04039eb247ab71...0c032aaf81afcb134668a462a9ea028e6fc64eeb,4,0,32,32,4,2011-04-13 15:46:36,2011-04-13 15:46:36
655e6e8df0aaba7da9a4a35a3c2017a9050fa99d...886af72125a108c2f928474c7f817dd2c164795e,2,0,8,8,2,2011-04-20 05:30:52,2011-04-20 05:30:52
d11fb9d47c85b623831919f1910dd862e600c63d...b3a78d2b287cc9789d1c791a91448c40dcab2e23,1,1,1,2,1,2011-04-12 08:19:15,2011-04-12 08:19:15
b3a78d2b287cc9789d1c791a91448c40dcab2e23...f9282283822771a7f471547569de481a66a70b0f,2,23,0,23,2,2011-04-12 08:22:31,2011-03-20 20:29:00
f9282283822771a7f471547569de481a66a70b0f...8883ace767997d1a629c165780af303f715ee78d,1,0,1,1,1,2011-04-12 08:24:06,2011-04-12 08:24:06
8883ace767997d1a629c165780af303f715ee78d...0447a0ec11ad56d24ad391e9149c8d7e0429b205,1,5,0,5,1,2011-04-12 08:24:52,2011-03-01 06:04:10
0447a0ec11ad56d24ad391e9149c8d7e0429b205...8ed33a8ccc5e926e84bf522951ecf80e97e2a8e6,1,1,1,2,1,2011-04-12 08:24:52,2011-03-02 02:34:25
8ed33a8ccc5e926e84bf522951ecf80e97e2a8e6...2717e147b303beef0f84e6dfbb2db562c8fc6740,1,2,2,4,1,2011-04-12 08:24:53,2011-03-03 01:00:40
2717e147b303beef0f84e6dfbb2db562c8fc6740...277057cb6399769340d41bba9421464c58742026,1,0,5,5,1,2011-04-12 08:24:53,2011-03-04 02:36:35
277057cb6399769340d41bba9421464c58742026...9406ae7929bc1d3a063b65e7559a28268aaf0a7a,1,6,0,6,1,2011-04-12 08:24:53,2011-03-04 02:38:56
9406ae7929bc1d3a063b65e7559a28268aaf0a7a...f0922006aba68e485480a81d83ba53b201270a69,1,3,2,5,1,2011-04-12 08:24:53,2011-03-19 14:29:22
f0922006aba68e485480a81d83ba53b201270a69...7d71148490511ae2ef849a9d95de07ec4a751121,1,21,0,21,1,2011-04-12 08:28:13,2011-02-26 07:04:45
7d71148490511ae2ef849a9d95de07ec4a751121...849e2834fb1e4fe27a0b5f997733fd2ae4d8f9b7,1,8,6,14,2,2011-04-12 08:36:45,2011-04-12 08:36:45
849e2834fb1e4fe27a0b5f997733fd2ae4d8f9b7...6cbd15f4035ffd79e6e325a256f87443c106c2c6,1,10,0,10,1,2011-04-12 08:39:14,2011-03-17 18:22:51
6c13721f553140d6cb136377c51eb55a281c5f17...00bff0a9963d4b36e6afc968449781c727bfef3b,1,7,1,8,3,2012-09-21 02:35:09,2012-09-21 02:35:09
7c3d12c7de1c2d8efdefe09b02349e24106e36c6...f78218f625846afe2b6a487d18b0d7c65daa4edf,1,1,0,1,1,2011-05-24 19:25:18,2011-05-24 19:25:18
f78218f625846afe2b6a487d18b0d7c65daa4edf...5da609e2c96c100c3c862e83f96e618d693c934f,1,280,0,280,1,2011-05-24 19:28:42,2011-05-24 19:28:42
5da609e2c96c100c3c862e83f96e618d693c934f...1e86678f9d3c8c979ff8d3c8b5aac19e9e611441,1,21,0,21,1,2011-05-24 19:29:05,2011-05-24 19:29:05
7c3d12c7de1c2d8efdefe09b02349e24106e36c6...1aacb74caf6800fe895ab3a40584c08bfded451e,1,1,1,2,1,2011-05-22 13:27:30,2011-05-22 13:27:30
7c3d12c7de1c2d8efdefe09b02349e24106e36c6...093f9077f5b358803a810d65fb0d4729477905cf,1,11,0,11,1,2011-05-20 20:26:45,2011-05-20 20:26:45
7c3d12c7de1c2d8efdefe09b02349e24106e36c6...210c1ef86deed805b3c5b25833d4b128f758b610,1,6,0,6,1,2011-05-20 13:14:10,2011-05-20 13:14:10
7c3d12c7de1c2d8efdefe09b02349e24106e36c6...31ef6199675be846e473c20681da339b6ea864cd,1,3,0,3,1,2011-05-19 14:20:30,2011-05-19 14:20:30
31ef6199675be846e473c20681da339b6ea864cd...bde77af40d28ed7a308a843d8bcad556d8115f84,1,4,4,8,1,2011-05-19 14:33:29,2011-05-19 14:33:29
7c3d12c7de1c2d8efdefe09b02349e24106e36c6...1d9eacb34f59f3bf82a9de0d7b474cb4c501e3fd,1,15,0,15,1,2011-05-19 09:55:19,2011-05-19 09:55:19
1d9eacb34f59f3bf82a9de0d7b474cb4c501e3fd...14411cb904b7682fe2a5c69861bfffa96f124707,1,9,6,15,5,2011-09-19 11:43:04,2011-09-19 11:40:29
14411cb904b7682fe2a5c69861bfffa96f124707...aa7ddd51cc4bd6afca23760ba3e3cc777305b1da,1,1,1,2,1,2011-09-19 11:46:20,2011-09-19 11:45:34
aa7ddd51cc4bd6afca23760ba3e3cc777305b1da...e94039d62b04e61507cbaa57c5fa955d97c8eca9,2,4,4,8,2,2011-09-19 17:36:41,2011-09-19 14:42:58
e94039d62b04e61507cbaa57c5fa955d97c8eca9...7ba54d197dac8d5ae380271259ba4d8843f01b4f,1,29,0,29,1,2011-09-20 08:27:15,2011-09-20 08:26:32
7c3d12c7de1c2d8efdefe09b02349e24106e36c6...e199e1dae8f43e3de3bfd59696226497a7c3c3d1,1,4,0,4,1,2011-05-15 13:02:46,2011-05-15 13:02:46
e199e1dae8f43e3de3bfd59696226497a7c3c3d1...8454542ddc33c4907bb864054b9adb0cf61d9002,1,1,1,2,1,2011-05-20 11:21:04,2011-05-20 11:21:04
a525993f6b62f3c5acec0afd204ff517408b6f29...e129fc5a285ccc8ff3c6ae9770908a0b5c2836e7,1,1,1,2,1,2011-05-09 11:32:42,2011-05-09 11:32:42
66b7fe1b27637feba61a4b47e113b18b69432bf2...e3cede37a0ac1ef427fb07b6f79839b8c6a64780,1,2,2,4,2,2011-05-02 11:51:16,2011-05-02 11:51:16
9e601c23f15a7da60ba8c17f4da0d85cd6bbb49e...9308a7d472a1dea6610887b98d6d789741f96a49,1,20,0,20,1,2011-07-14 18:06:06,2011-07-14 18:04:46
9e601c23f15a7da60ba8c17f4da0d85cd6bbb49e...913cf5325264960d4c1dfe678a2adadeaecdbf6a,1,2,4,6,3,2011-07-14 16:35:12,2011-07-14 16:34:18
9e601c23f15a7da60ba8c17f4da0d85cd6bbb49e...6774fb3d59365ddb8520cdb4d46444720f788be0,1,3,1,4,1,2011-07-14 06:23:01,2011-07-14 06:23:01
7d19ae8fab80c826156f984aa6dd8221a9aaada0...caa1cc70678e15fe0da93a89e52f543c6bda7494,3,661,0,661,3,2011-07-15 04:41:26,2011-07-15 04:41:26
499819ced108aa4b0d90dd0ac922a174c965d814...fe175661fddd04691cc03012f84490e729cf2bae,1,2,2,4,2,2011-09-02 13:06:32,2011-09-02 13:06:32
499819ced108aa4b0d90dd0ac922a174c965d814...053cb24d3160d69cb6c9579a3f154f45a72f065c,1,1,0,1,1,2011-06-30 08:45:24,2011-06-30 08:45:24
053cb24d3160d69cb6c9579a3f154f45a72f065c...4dc11fee35f21b295deb1a61503031c8e17f83a1,1,10,2,12,3,2011-08-13 10:29:13,2011-08-13 10:29:13
4dc11fee35f21b295deb1a61503031c8e17f83a1...7a89786139bcfd83e0e9caa9974f66a423c6ed48,1,1,1,2,1,2011-08-13 10:32:37,2011-08-13 10:32:37
762b55bb2bc0452ce3f5f2f21bc22b61936ef704...de29ef809dad9c1a1190a4b670cbb30b8b578f3c,1,1,1,2,1,2011-10-05 03:57:48,2011-10-05 03:57:48
762b55bb2bc0452ce3f5f2f21bc22b61936ef704...40cc4dabfb7cd91e09e70a3dd11f73b20d303303,1,5,0,5,1,2011-10-05 02:27:36,2011-10-05 02:27:36
40cc4dabfb7cd91e09e70a3dd11f73b20d303303...c373c7153be77a91d30a9c6d5ea96b18e911823c,1,4,4,8,2,2011-10-05 02:30:32,2011-10-05 02:30:32
762b55bb2bc0452ce3f5f2f21bc22b61936ef704...deb8543bb48eb8bde85e2285ac9ce276113c433b,1,3,2,5,3,2011-09-29 18:39:09,2011-09-29 18:39:09
762b55bb2bc0452ce3f5f2f21bc22b61936ef704...c1c7b0e4af8a33c25118679f075f63a3b67b14f4,1,2,0,2,1,2011-09-26 13:44:42,2011-09-26 13:44:42
762b55bb2bc0452ce3f5f2f21bc22b61936ef704...8287cc177e993aebc8ee0a9f5ee5a1cee6893253,1,13,9,22,8,2011-09-24 16:22:20,2011-09-24 16:09:57
762b55bb2bc0452ce3f5f2f21bc22b61936ef704...c2d0cdd5330ae072468ca801d0b5750bf4fae7c3,1,1,1,2,1,2011-09-23 17:18:09,2011-09-23 17:18:09
c2d0cdd5330ae072468ca801d0b5750bf4fae7c3...b2703a3c8a6c860eeea8a36bc693a1508372d8c1,1,4,4,8,4,2011-09-23 17:51:20,2011-09-23 17:51:20
762b55bb2bc0452ce3f5f2f21bc22b61936ef704...2ca2ad3fc5b8635b22d33fd0f1c1511f44e9fff8,1,6,1,7,1,2011-09-20 10:04:06,2011-09-20 10:04:06
762b55bb2bc0452ce3f5f2f21bc22b61936ef704...1ad8fde027ea3e66c0ed8f1498dfcfb07e0aefe6,1,26,0,26,1,2011-09-15 13:39:10,2011-09-15 13:00:47
1ad8fde027ea3e66c0ed8f1498dfcfb07e0aefe6...47d0735b5fb5e9e82d8fb5d71f4f4c814e977b68,1,12,0,12,3,2011-09-15 13:39:10,2011-09-15 13:18:15
47d0735b5fb5e9e82d8fb5d71f4f4c814e977b68...0d285e3a0f12b8bf9f0ac63d5ef7930ab9455bff,1,1,1,2,1,2011-09-15 13:39:10,2011-09-15 13:22:05
762b55bb2bc0452ce3f5f2f21bc22b61936ef704...701f775c18f1f8a1acdd3282cc3f68f1075904ad,1,1,1,2,1,2011-09-14 07:13:01,2011-09-14 07:13:01
762b55bb2bc0452ce3f5f2f21bc22b61936ef704...c6e8c856cb59e24362fe50fd93de097f30205420,1,62,0,62,1,2011-09-10 11:07:23,2011-09-10 10:48:40
c6e8c856cb59e24362fe50fd93de097f30205420...51736343595eb83f9d2364b50cf0b62227a4fab4,1,1,2,3,2,2011-09-10 11:07:31,2011-09-10 11:00:31
51736343595eb83f9d2364b50cf0b62227a4fab4...f9c143b69c30396f79e2cb75d11e70e4b983c1bd,1,0,7,7,1,2011-09-10 11:07:33,2011-09-10 11:06:26
762b55bb2bc0452ce3f5f2f21bc22b61936ef704...965e1cfefa41bd0419126d9321eecec4fcbbb0e3,1,6,1,7,1,2011-09-10 09:35:08,2011-09-10 09:35:08
762b55bb2bc0452ce3f5f2f21bc22b61936ef704...9c5c70dc0a2531b621ba825c2599189717694d56,1,1,1,2,2,2011-08-31 11:51:10,2011-08-31 11:51:10
9c5c70dc0a2531b621ba825c2599189717694d56...ee507c90461beb06590af1c5e30bd78a62d8c4be,1,1,1,2,1,2011-08-31 15:21:09,2011-08-31 11:53:02
dee8171fa9494d1aa6c01cb86de1b70b480ee5c4...f20cfc68e81be754521672541fd6ff25983f402c,2,5,3,8,2,2011-08-01 18:06:52,2011-08-01 15:10:42
dee8171fa9494d1aa6c01cb86de1b70b480ee5c4...d866662c4af4c6e6e661c59d2da8f60eabbfba1d,1,34,0,34,1,2011-07-30 02:38:57,2011-07-30 02:38:57
d866662c4af4c6e6e661c59d2da8f60eabbfba1d...c3412ca57d313a0a1419d26b5529f28de49285d0,1,1,1,2,1,2011-07-30 02:57:25,2011-07-30 02:57:25
dee8171fa9494d1aa6c01cb86de1b70b480ee5c4...f35bfd9c4b2a3924975b936d2ca946dbca48c51f,1,39,0,39,1,2011-07-29 19:17:22,2011-07-29 19:17:22
be2ab226949831f502a05adfb513691693e03702...c2a95b796b79b4ce4e36b8cb879cb9b0162bc438,1,119,0,119,1,2011-08-11 16:27:47,2011-06-14 21:01:28
c133f41833ba1ce6a3868a644ad29caa17bfa75a...98578ec2412d5b5d2e105f3ddd0d41eb21c3de14,1,0,1,1,1,2011-12-16 13:21:45,2011-12-16 13:21:45
c133f41833ba1ce6a3868a644ad29caa17bfa75a...70e51186ec3f67b1126339c7570bd9f6549f0408,1,2,10,12,1,2011-12-16 13:01:59,2011-12-16 13:01:59
c133f41833ba1ce6a3868a644ad29caa17bfa75a...1a49f6443c0230b8e182294546ed9ef2a5110bf2,1,64,0,64,1,2011-12-16 02:18:04,2011-11-13 05:09:27
0365ef0529ddfb912ca8202773e45916c55fdf4f...5440815c8303e715f04da48fb85e5d05400afb7d,1,1,1,2,1,2011-05-09 14:19:10,2011-05-09 14:19:10
0365ef0529ddfb912ca8202773e45916c55fdf4f...bd1a78ae34cc3ce81a7b858f459ad0ad8da2cf62,1,22,0,22,1,2011-05-05 22:42:50,2011-05-05 22:41:05
0365ef0529ddfb912ca8202773e45916c55fdf4f...e1210cdfaab6baba2eeb62599fea832ea446af85,1,4,0,4,1,2011-05-03 21:07:35,2011-05-03 21:07:35
a738ca9b645c3cc53bdb01e8676202ceca449ccf...d5333e8efc0f6669d64bba1b2aa6e80bc2e7c8e8,1,158,0,158,1,2011-08-11 14:40:35,2011-08-11 14:40:35
a738ca9b645c3cc53bdb01e8676202ceca449ccf...749feb2720948a4ac9a981286654962e699d8d94,2,27,16,43,8,2011-08-06 19:22:55,2011-08-06 19:22:55
749feb2720948a4ac9a981286654962e699d8d94...fd55d53eb22856883953bb6efc89bb2d643ef296,1,5,6,11,4,2011-08-06 19:41:52,2011-08-06 19:41:52
fd55d53eb22856883953bb6efc89bb2d643ef296...8ed6dd5fc4c5e9b28d0f8a87f72c0bbe5f628580,1,41,0,41,1,2011-08-06 19:58:40,2011-08-06 19:58:40
8ed6dd5fc4c5e9b28d0f8a87f72c0bbe5f628580...8c48f10a04ce8e6c789cead457e062602cc89931,1,30,16,46,6,2011-08-06 20:15:09,2011-08-06 20:15:09
8c48f10a04ce8e6c789cead457e062602cc89931...fac74012f81fc99eb2ba7a85e94a2cd74c352271,1,54,26,80,6,2011-08-07 19:30:55,2011-08-07 19:30:55
fac74012f81fc99eb2ba7a85e94a2cd74c352271...65393b4bb10de841edbe2026dba29b73625b33d7,1,65,27,92,21,2011-08-07 20:51:14,2011-08-07 20:51:14
65393b4bb10de841edbe2026dba29b73625b33d7...d3116d4f0b499bb76e371f7d60eed48b81068932,1,1,1,2,1,2011-08-13 14:53:24,2011-08-13 14:53:24
a738ca9b645c3cc53bdb01e8676202ceca449ccf...0061dda057bb3b8b67f2bf06b374ab0b786e80fe,1,1,0,1,1,2011-08-06 13:46:37,2011-08-06 13:46:37
a738ca9b645c3cc53bdb01e8676202ceca449ccf...3780247f633d99b6870e39ea77c540ebb5125095,1,10,3,13,3,2011-08-04 10:37:33,2011-08-04 10:37:33
a738ca9b645c3cc53bdb01e8676202ceca449ccf...3bc32eef6dbad942fd137a7c7d04050d9b87fed4,1,26,0,26,1,2011-08-02 07:42:23,2011-08-02 07:42:23
a738ca9b645c3cc53bdb01e8676202ceca449ccf...68b5ef2aabddc1049738a80f6cbfa470fd538e95,1,4,0,4,1,2011-08-02 01:54:09,2011-08-02 01:54:09
a738ca9b645c3cc53bdb01e8676202ceca449ccf...b160ee6512f58a3a7f2c18f12feab3e32884003b,1,9,9,18,2,2011-08-01 06:58:05,2011-08-01 06:58:05
8796fd01cce345e1efb82acd8222e31b72b8259e...54f199051124cbbbb3e555c681d65f1aa6942856,1,3,2,5,3,2012-12-02 18:54:24,2012-12-02 18:54:24
8796fd01cce345e1efb82acd8222e31b72b8259e...f9de64460ce51e105f27d30a9ecb20612ab65d57,1,142,0,142,1,2012-12-02 17:56:17,2011-05-21 23:29:41
f9de64460ce51e105f27d30a9ecb20612ab65d57...30687c414785fbc7d7d7d44ae60166075be75da7,1,9,3,12,2,2012-12-02 18:00:11,2011-05-21 23:31:11
30687c414785fbc7d7d7d44ae60166075be75da7...27841ca7c1bb6bd19e0eb66e1dcc8fa3a6a6ebba,2,1,5,6,3,2012-12-02 18:30:25,2012-12-02 18:30:25
757fa3314d1c041ab715dbda838f3e9b2ff9ce17...30890b9eb9e1b6fc4b553d94a97424049bd6003e,1,11,2,13,2,2011-12-15 14:28:02,2011-11-16 20:51:30
757fa3314d1c041ab715dbda838f3e9b2ff9ce17...7c36ef7faa65441f8eec27589f24ba9f18f8d66c,1,5,0,5,1,2011-12-06 21:51:31,2011-12-06 21:51:31
757fa3314d1c041ab715dbda838f3e9b2ff9ce17...b16099f3cb9855affa14d0f03adf6563f8df4cbe,1,7,0,7,1,2011-12-06 14:19:35,2011-12-06 14:18:29
757fa3314d1c041ab715dbda838f3e9b2ff9ce17...3fc812afc9af75e49a8f99bad3ada41672547503,1,5,8,13,3,2011-12-03 12:18:37,2011-12-03 12:18:37
757fa3314d1c041ab715dbda838f3e9b2ff9ce17...20b025ba2cd419a99630458052bfa9a9e8c99e91,1,36,0,36,1,2011-12-02 10:32:15,2011-12-02 10:32:15
757fa3314d1c041ab715dbda838f3e9b2ff9ce17...5260bfd4eba3787d5d32086b55ed728f3f3ab7f8,1,1,0,1,1,2011-11-27 14:07:31,2011-11-27 14:07:31
757fa3314d1c041ab715dbda838f3e9b2ff9ce17...2c660c16ad818d4e1f001e392f7e82c7c02cbbc6,1,11,1,12,1,2011-11-24 12:57:10,2011-11-24 12:51:55
757fa3314d1c041ab715dbda838f3e9b2ff9ce17...10618f323f2915c2a7281e258a42d05faf1cc1af,1,6,6,12,6,2011-11-16 16:14:26,2011-11-16 16:14:26
757fa3314d1c041ab715dbda838f3e9b2ff9ce17...3512eca2cefee9b89b08230021c25f6e30525e31,1,9,2,11,2,2011-11-16 14:27:34,2011-11-16 14:25:45
3512eca2cefee9b89b08230021c25f6e30525e31...258457ea4fe0b8fcb1f6d0242071edb82cab449a,1,6,6,12,2,2011-11-16 14:46:05,2011-11-16 14:46:05
757fa3314d1c041ab715dbda838f3e9b2ff9ce17...7ec2dd984a7605b28fcaed411f33403802bc876a,1,9,9,18,2,2011-11-16 09:32:05,2011-11-16 09:32:05
757fa3314d1c041ab715dbda838f3e9b2ff9ce17...4173ba1e95403f3d2cd28b0ad5d5f2c0691f86b7,1,17,7,24,4,2011-11-15 18:46:14,2011-11-15 18:46:14
757fa3314d1c041ab715dbda838f3e9b2ff9ce17...40c47a737571468b759bbc30e4b4dc4b5f77470f,1,7,3,10,4,2011-11-15 06:14:03,2011-11-15 06:14:03
40c47a737571468b759bbc30e4b4dc4b5f77470f...5277a0ffaacbc2e23c8753fefdf1c4fe6d1e7685,3,25,15,40,16,2011-11-15 06:20:29,2011-11-15 06:20:29
757fa3314d1c041ab715dbda838f3e9b2ff9ce17...444145b495338ca3fbc86f0956003a1074f845df,1,1,1,2,1,2011-11-09 22:01:45,2011-11-09 22:01:45
757fa3314d1c041ab715dbda838f3e9b2ff9ce17...419ffdc48d218156b578d46d7fb5c64adcccb3de,1,2,0,2,1,2011-11-09 10:46:38,2011-11-09 10:46:38
757fa3314d1c041ab715dbda838f3e9b2ff9ce17...452f1213018551f6a388224bbfd1c84ef73b3770,1,37,5,42,4,2011-11-07 18:42:16,2011-11-07 18:42:16
757fa3314d1c041ab715dbda838f3e9b2ff9ce17...914e1b52583e09298f10fab7a301711bd9613ac6,1,29,0,29,1,2011-11-04 23:34:15,2011-11-04 23:34:15
914e1b52583e09298f10fab7a301711bd9613ac6...c4434d2ddedd62737ad3f99111ef47d722e2b74e,1,3,0,3,3,2011-11-04 23:34:37,2011-11-04 23:34:37
c4434d2ddedd62737ad3f99111ef47d722e2b74e...8e6ce534a2cfa91d6398fecf42c4149fa1e5294f,1,8,6,14,2,2011-11-16 20:49:04,2011-11-16 18:44:02
757fa3314d1c041ab715dbda838f3e9b2ff9ce17...0f13387b074aa20b035251ea85e4f8a82eddbfa8,1,28,0,28,1,2011-11-02 02:55:26,2011-11-02 02:55:26
0f13387b074aa20b035251ea85e4f8a82eddbfa8...a78387cb5d46c98336a8fa0abd72d682f1c00c8b,1,3,3,6,2,2011-11-02 12:29:28,2011-11-02 12:29:28
a78387cb5d46c98336a8fa0abd72d682f1c00c8b...456993e03be3193056b9a18a809a18414cf9df00,1,1,1,2,1,2011-11-02 12:31:06,2011-11-02 12:31:06
456993e03be3193056b9a18a809a18414cf9df00...31badac2ea2ecdc77cf4c339fcef9472940cb261,1,5,19,24,4,2011-12-02 11:54:04,2011-12-02 11:54:04
757fa3314d1c041ab715dbda838f3e9b2ff9ce17...9e3776f1ecbaa29d646cdfe8fc204597ca98746c,1,7,10,17,6,2011-10-31 01:43:53,2011-10-31 01:43:53
757fa3314d1c041ab715dbda838f3e9b2ff9ce17...a2afccae194470e71dd256b594964ddfe0e5c221,1,1,0,1,1,2011-10-25 07:55:14,2011-10-25 07:53:59
757fa3314d1c041ab715dbda838f3e9b2ff9ce17...40508b79a4d25b0548e771fb3698675595230a04,1,13,0,13,1,2011-10-20 11:10:20,2011-10-20 11:10:20
757fa3314d1c041ab715dbda838f3e9b2ff9ce17...a5545bd31c76a4f34339dc4e7b87f74fa0174015,1,44,0,44,1,2011-10-20 06:12:56,2011-10-20 06:12:56
a5545bd31c76a4f34339dc4e7b87f74fa0174015...31cddcd32427a5f5d3daa0da168d39aba5b510b4,1,1,1,2,1,2011-10-20 07:27:49,2011-10-20 07:27:49
757fa3314d1c041ab715dbda838f3e9b2ff9ce17...6095fe4f7157ba444addaf436f9f44e3d491a784,1,20,0,20,1,2011-10-20 06:12:13,2011-10-20 06:12:13
757fa3314d1c041ab715dbda838f3e9b2ff9ce17...81d94e6c9e3ebe5f0cb094474b1b2f96d2cf567b,2,2,0,2,2,2011-10-19 00:11:49,2011-10-12 04:16:23
81d94e6c9e3ebe5f0cb094474b1b2f96d2cf567b...35d89ab85991e9a6dc055d0fd790b50c1aaa0cce,1,1,1,2,1,2012-01-27 00:50:28,2012-01-27 00:50:28
757fa3314d1c041ab715dbda838f3e9b2ff9ce17...7553d0171f7d1fe070a70af2c863fdadf6d7d5ac,1,1,1,2,1,2011-10-18 03:46:45,2011-10-18 03:46:45
757fa3314d1c041ab715dbda838f3e9b2ff9ce17...878d569c6845198005dacc4e9a56b6610e46ffd9,1,10,0,10,1,2011-10-16 21:20:34,2011-07-04 10:07:11
878d569c6845198005dacc4e9a56b6610e46ffd9...ebbead82abe59663cedd9f0ade4627e01548b4c1,1,3,1,4,2,2011-10-16 21:20:34,2011-07-16 12:01:57
757fa3314d1c041ab715dbda838f3e9b2ff9ce17...be6f0c90b8f7d56d812a0938cb2f6ef1a393c36c,1,7,2,9,2,2011-10-15 21:31:27,2011-10-15 21:31:27
dc7eee4db08a39ad73af67363f3d29b495cbd13f...11fcdb844d67492080befd8dcd1f995deb26b8ee,1,1,1,2,1,2011-08-12 21:53:23,2011-08-12 21:53:23
82568cc7e64502c953226bfa30a34fb4bcd46d99...03424fdadba13fea2297a94144e989926cabdcb3,1,13,0,13,1,2011-12-17 22:23:31,2011-12-17 22:23:31
b8b241f630377aacefade327c94655cec96b002f...0c9b4329efd79d33dd2c21bd960d5bd9b7627b7f,1,1,0,1,1,2013-04-10 07:54:59,2013-04-09 14:41:48
b8b241f630377aacefade327c94655cec96b002f...fc785de97b7ed1438b4d0e46d29079fb97a55338,1,54,0,54,1,2013-04-08 00:42:38,2013-04-08 00:18:39
b8b241f630377aacefade327c94655cec96b002f...6271941a919858a05e9abec120db90ca0c131153,1,1,1,2,1,2013-04-07 13:12:30,2013-04-07 13:12:30
b8b241f630377aacefade327c94655cec96b002f...d55262b6a1ac614b35603885f0759015dc9f59dd,1,1,1,2,1,2013-04-07 12:59:01,2013-04-07 12:58:55
b8b241f630377aacefade327c94655cec96b002f...0707bfce5386eb7ad83e6ad8d0b09358916eeb64,1,11,0,11,1,2013-04-04 19:18:48,2013-04-04 19:18:48
0707bfce5386eb7ad83e6ad8d0b09358916eeb64...c8423eb6d7149b9e73a94f4bf0c754771e27530a,1,4,4,8,3,2013-04-04 21:11:37,2013-04-04 21:11:37
b8b241f630377aacefade327c94655cec96b002f...889045068465c3aac25b212b80b07f3f1755d937,1,1,1,2,1,2013-04-04 00:41:05,2013-04-04 00:41:05
b8b241f630377aacefade327c94655cec96b002f...e4fb94306a91ea6b893ba0dad34ba8eb17c07f0a,5,528,0,528,5,2013-04-03 18:20:57,2013-04-03 18:20:57
b8b241f630377aacefade327c94655cec96b002f...8e368c1222a9ccd9203c6f19eba9db61bf4c27f8,1,17,0,17,1,2013-04-03 13:43:22,2013-04-03 13:43:22
b8b241f630377aacefade327c94655cec96b002f...48c0f6c2941941815bcccbed1b329f98b13c43c0,1,4,3,7,4,2013-04-03 01:18:01,2013-04-03 01:18:01
b8b241f630377aacefade327c94655cec96b002f...f358f614149e4f25b53abe140e0d0b8bc46928d6,1,1,1,2,1,2013-04-02 09:33:06,2013-04-02 09:33:06
b8b241f630377aacefade327c94655cec96b002f...5c1c536015ea3e87acc19653faf537c0fb22b7ba,1,7,5,12,1,2013-04-01 20:42:33,2013-04-01 20:34:59
5c1c536015ea3e87acc19653faf537c0fb22b7ba...520b0132e943252409457b550b39d8821663da7a,1,5,0,5,1,2013-04-01 20:44:53,2013-04-01 20:44:53
b8b241f630377aacefade327c94655cec96b002f...8d6b7573e77abf2fb114579806e6e749bef5eca5,1,55,0,55,1,2013-03-31 13:49:51,2013-03-31 13:49:51
b8b241f630377aacefade327c94655cec96b002f...af8d8df36cee517c55449e6aaeaa2f60a94ac9f8,1,11,0,11,1,2013-03-30 15:00:40,2013-03-30 15:00:40
af8d8df36cee517c55449e6aaeaa2f60a94ac9f8...3ad05df020f4ad672d99a325304a1c962991fd64,1,12,0,12,1,2013-03-30 15:01:31,2013-03-30 15:01:31
b8b241f630377aacefade327c94655cec96b002f...fc67399843f26d4f7851fa0b7727183f138bdfa2,1,4,2,6,1,2013-03-29 12:35:35,2013-03-29 12:35:35
fc67399843f26d4f7851fa0b7727183f138bdfa2...55da480da17701531daf6874e17cabf460c9a75a,1,3,3,6,2,2013-03-29 15:39:18,2013-03-29 15:39:18
b8b241f630377aacefade327c94655cec96b002f...c89afd2f6a7221152648c7c0e32879dfc98cad5b,2,1,7,8,2,2013-03-27 15:07:24,2012-12-11 19:17:32
3bc32eef6dbad942fd137a7c7d04050d9b87fed4...76e828691bedc345904716b04cfa746fd043e0e7,1,120,25,145,1,2013-01-30 17:58:58,2013-01-30 17:58:58
e4a596c09532ec1adae2951b3893fd9a7960cdbe...e226fc048afaf7c849e089304f855f4ebb26ee95,1,67,16,83,4,2012-12-02 19:36:33,2012-12-02 19:36:33
e226fc048afaf7c849e089304f855f4ebb26ee95...5f62d2c183f93ef02b79675c6a51950cb530dfcb,1,37,0,37,1,2012-12-02 19:46:53,2012-12-02 19:46:53
7c36ef7faa65441f8eec27589f24ba9f18f8d66c...1ced49b85a859b399728ce32ef77399874f5172b,1,8,1,9,3,2011-12-19 05:15:00,2011-12-19 05:15:00
7c36ef7faa65441f8eec27589f24ba9f18f8d66c...3e7e52a25fbfdb57f291ee9575a606f845dbff57,1,3,1,4,1,2011-12-14 10:47:24,2011-12-14 10:47:24
7c36ef7faa65441f8eec27589f24ba9f18f8d66c...8ca019f02a4dc718fe5fc8b1186108eb376360c9,1,23,0,23,1,2011-12-12 22:55:07,2011-12-12 22:55:07
7c36ef7faa65441f8eec27589f24ba9f18f8d66c...d25fb095a9d1f814fe2b4d0f42ffe827780d4a59,1,9,0,9,1,2011-12-09 18:18:54,2011-12-09 18:18:54
7c36ef7faa65441f8eec27589f24ba9f18f8d66c...42b0123427d2bdee0e3221d930bb48038c601932,1,42,18,60,6,2011-12-07 10:08:42,2011-12-07 10:08:42
42b0123427d2bdee0e3221d930bb48038c601932...1c4997f5cada6f1ff1f205b20cf321cfc6b6d347,1,5,2,7,2,2011-12-07 12:32:58,2011-12-07 12:32:58
1c4997f5cada6f1ff1f205b20cf321cfc6b6d347...5eae9421883d71b954d4abaa6056b28874ad47ec,1,1,0,1,1,2011-12-07 13:09:43,2011-12-07 13:09:43
b16099f3cb9855affa14d0f03adf6563f8df4cbe...a62d22726be1c3a02405bf327449e605be8fc5b2,1,1,1,2,1,2011-12-19 14:26:37,2011-12-19 14:26:37
f4944d5a9537eb4bdc4991fe63e6d249f9e5b478...9b05a44387f84ae0b24e24023286534d0bbdf65f,1,11,0,11,2,2012-04-05 17:18:22,2012-04-05 17:18:16
f4944d5a9537eb4bdc4991fe63e6d249f9e5b478...e0b235608032256f5b725676f7c6217480a52722,1,1,1,2,1,2012-01-22 11:34:25,2012-01-22 11:34:25
f4944d5a9537eb4bdc4991fe63e6d249f9e5b478...62a3ef643328a05c11a62cd42de12cf271ca1e69,1,1,1,2,1,2012-01-21 21:24:07,2012-01-21 21:24:07
f4944d5a9537eb4bdc4991fe63e6d249f9e5b478...5f95d018e89e886615c82bc180e7e70457188c9b,1,65,97,162,20,2012-01-19 01:29:31,2012-01-19 01:29:31
f4944d5a9537eb4bdc4991fe63e6d249f9e5b478...741f6747e418229deec62ae2d19c776f6494e219,1,20,5,25,3,2012-01-18 17:52:27,2012-01-18 17:52:27
741f6747e418229deec62ae2d19c776f6494e219...c1a04eb61fcdd740bef52cd9da75fd72aeac3cf4,1,34,9,43,5,2012-01-18 17:58:13,2012-01-18 17:58:13
c1a04eb61fcdd740bef52cd9da75fd72aeac3cf4...36cd5ed1a59394827d6e9d38eca33b614790ded3,1,4,1,5,1,2012-01-18 19:18:09,2012-01-18 19:18:09
36cd5ed1a59394827d6e9d38eca33b614790ded3...3841da15d02e6d36310b9cc1ebd62502d0bf2135,1,1,1,2,1,2012-01-18 23:07:31,2012-01-18 23:07:31
3841da15d02e6d36310b9cc1ebd62502d0bf2135...f9b4356e0ed9e95890ce79c982dd5481ba7803aa,1,15,2,17,4,2012-01-18 23:36:11,2012-01-18 23:36:11
7441438afa9f96ff1d39a6cd0d8692c2b9044bf2...d49e98267a741075f889808b04b1f0c699917f8a,1,4,5,9,5,2012-02-25 21:16:43,2012-02-25 21:16:43
3e9493fb301b7d34bb6861787d97067ec9365268...804c18ca53e832f20869a7681143464382e8a2df,1,5,5,10,2,2012-01-05 22:39:13,2012-01-05 22:39:13
3e9493fb301b7d34bb6861787d97067ec9365268...e3c34b4f9aee666ea5446a975b4a70cdbab3239c,1,5,1,6,1,2011-12-31 17:13:31,2011-12-31 17:13:31
3e9493fb301b7d34bb6861787d97067ec9365268...cb501645d70ad1e50b6b3d3553618e585074533f,1,1,1,2,1,2011-12-30 18:11:41,2011-12-30 18:11:41
3e9493fb301b7d34bb6861787d97067ec9365268...2176cf37fb1eed028c53a2095098d585489b1cce,1,1,1,2,1,2011-12-29 21:54:19,2011-12-29 21:54:19
3e9493fb301b7d34bb6861787d97067ec9365268...967e84ebaa180ad2ab1eebc9a512f94d93e84aea,1,1,1,2,1,2011-12-29 01:22:40,2011-12-29 01:22:40
3e9493fb301b7d34bb6861787d97067ec9365268...e43dd05a6a731462c6124598ce2e4d1a9d3a5160,1,58,0,58,1,2011-12-29 00:30:43,2011-12-29 00:30:43
3e9493fb301b7d34bb6861787d97067ec9365268...77045230f4e2c80f4f312fbbeeb8583a41aa5a92,1,30,5,35,2,2011-12-28 14:58:24,2011-12-28 14:54:47
77045230f4e2c80f4f312fbbeeb8583a41aa5a92...3445dada95f7d5c4730b73ebb8b3abb0e5723e26,1,1,1,2,1,2011-12-29 13:35:38,2011-12-29 13:35:38
3e9493fb301b7d34bb6861787d97067ec9365268...4a813cf1a2ccddc58059271065a8abc8f9079019,1,60,3,63,4,2011-12-28 03:02:31,2011-12-28 03:02:31
d41c588d1b2880b634babdb89b49e5b7e98ee2dc...b578eea2739e707d5ecfb79f5b072876264d8f1c,1,0,1,1,1,2014-03-25 15:47:57,2011-12-16 13:21:45
b578eea2739e707d5ecfb79f5b072876264d8f1c...95ffb167a1f7420b37ba74a4067d33ef6a71f3c5,1,3,0,3,1,2014-03-25 15:47:57,2012-02-26 10:29:24
95ffb167a1f7420b37ba74a4067d33ef6a71f3c5...c70fcd6f972473f1b0948143407656f4e58a3119,1,1,1,2,1,2014-03-25 15:47:57,2012-03-05 11:55:30
c70fcd6f972473f1b0948143407656f4e58a3119...48e53fb6ede984964bfb45021212f0097c9a3637,1,7,7,14,4,2014-03-25 15:47:57,2012-03-07 00:31:03
48e53fb6ede984964bfb45021212f0097c9a3637...640e5da6885ac39697f7c4ad6683af21fa1b8b96,1,19,9,28,9,2014-03-25 15:47:57,2012-03-09 13:53:09
640e5da6885ac39697f7c4ad6683af21fa1b8b96...8d1fa09007b3bbd67cbdcf191eb6cd6faa2af974,1,9,0,9,1,2014-03-25 15:47:57,2012-04-04 16:54:31
8d1fa09007b3bbd67cbdcf191eb6cd6faa2af974...cdea478f0f20545473454c069d8d6bb860555021,2,136,0,136,2,2014-03-25 15:47:57,2012-03-20 12:16:44
cdea478f0f20545473454c069d8d6bb860555021...83071a10e7bcb398269be37a77dd929cb9182434,1,3,1,4,2,2014-03-25 15:47:57,2012-03-20 13:55:25
83071a10e7bcb398269be37a77dd929cb9182434...5a81fda42a48587fb27acb8c5d1e64e1d7c90b6c,1,3,0,3,1,2014-03-25 15:47:57,2012-03-30 10:33:06
5a81fda42a48587fb27acb8c5d1e64e1d7c90b6c...46c2af396a80a4dda8ce46577249b7aa81ea0849,1,13,0,13,1,2014-03-25 15:47:57,2012-03-30 10:39:49
46c2af396a80a4dda8ce46577249b7aa81ea0849...ee8f9eebb5ea0c5d2df8445a46f2d31fdb16efd6,1,1,1,2,1,2014-03-25 15:47:57,2012-04-01 19:41:39
ee8f9eebb5ea0c5d2df8445a46f2d31fdb16efd6...7a94b760193306fd62c07c93e116439f2bd8059b,1,1,0,1,1,2014-03-25 15:47:57,2012-02-23 14:11:52
7a94b760193306fd62c07c93e116439f2bd8059b...d1323edb499d5f9fbe7641bcab402229ad773195,2,2,2,4,1,2014-03-25 15:47:57,2012-05-16 18:51:52
d1323edb499d5f9fbe7641bcab402229ad773195...d2a765e12d8638354b3cdc71ca535964fc379599,1,7,1,8,1,2014-03-25 15:47:57,2012-06-14 05:06:36
d2a765e12d8638354b3cdc71ca535964fc379599...1988958a1f960fcd5911745667a682daca2d0139,1,345,0,345,1,2014-03-25 15:47:57,2012-07-10 12:49:32
1988958a1f960fcd5911745667a682daca2d0139...7daf2f4a623e730c837299ce709c41a50d13e458,1,1,0,1,1,2014-03-25 15:47:57,2012-07-10 12:57:59
7daf2f4a623e730c837299ce709c41a50d13e458...4dcdd13009d288bce3ba5a6157f408c15fb351c5,1,624,60,684,1,2014-03-25 15:47:57,2012-07-12 12:05:33
4dcdd13009d288bce3ba5a6157f408c15fb351c5...f644d2eb6f6554de9f00c56b6356c306ce4c2c9f,2,3,1,4,2,2014-03-25 15:47:57,2012-07-12 12:17:59
f644d2eb6f6554de9f00c56b6356c306ce4c2c9f...9b4cf96ac0e8a5d7f490a927e40e7931fff2d3c3,1,209,209,418,209,2014-03-25 15:47:57,2012-07-13 10:08:41
9b4cf96ac0e8a5d7f490a927e40e7931fff2d3c3...95f83193dab1eab2ea6bfccec6119dc3ac412155,1,8,8,16,8,2014-03-25 15:47:58,2012-07-13 14:24:45
95f83193dab1eab2ea6bfccec6119dc3ac412155...f88b6bdc5109ba09e45f4c19bc3ea14e51794cae,1,769,625,1394,4,2014-03-25 15:47:58,2012-07-24 10:15:36
f88b6bdc5109ba09e45f4c19bc3ea14e51794cae...6d7d131a3c408e83d81b3f246abaeb9cb956e72b,1,20,8,28,9,2014-03-25 15:47:58,2012-07-24 14:16:55
6d7d131a3c408e83d81b3f246abaeb9cb956e72b...fd3d5bfb749e30b752b887d265f5561bd54e02c2,1,18,14,32,15,2014-03-25 15:47:58,2012-07-31 13:02:12
fd3d5bfb749e30b752b887d265f5561bd54e02c2...ee3a20a3dcd950f2959424bff9423807bf25b69e,1,200,123,323,126,2014-03-25 15:47:58,2012-07-31 14:59:56
ee3a20a3dcd950f2959424bff9423807bf25b69e...0f3208316392d84a39a3e378968d2253f2f2429b,1,1,1,2,1,2014-03-25 15:47:58,2012-08-03 08:02:19
0f3208316392d84a39a3e378968d2253f2f2429b...bc02c28b736f4f9e6af97829da21128f42a4b8ba,1,1,1,2,1,2014-03-25 15:47:58,2012-08-03 08:02:27
bc02c28b736f4f9e6af97829da21128f42a4b8ba...8194aa9554a0edf7998b1c5dabeb8e37f5807191,1,6,2,8,3,2014-03-25 15:47:58,2012-08-03 08:15:01
8194aa9554a0edf7998b1c5dabeb8e37f5807191...c1ada7a938268ce39cc83b71bd6d2da0047979db,1,1,1,2,1,2014-03-25 15:47:58,2012-09-03 06:31:54
c1ada7a938268ce39cc83b71bd6d2da0047979db...c0e3c553bcdd8e4bc74d602d239a4330ac2641e5,1,3,2,5,1,2014-03-25 15:47:58,2014-03-23 01:03:12
c0e3c553bcdd8e4bc74d602d239a4330ac2641e5...ffd5cb20eee51eb6e25a8ff50af912f1a4038c03,1,3,0,3,1,2014-03-25 15:47:58,2014-03-23 13:39:38
ffd5cb20eee51eb6e25a8ff50af912f1a4038c03...2697a1825724b243343f3fbf3f5cebf5d64dc00f,1,3,0,3,1,2014-03-25 15:47:58,2014-03-23 13:45:55
2697a1825724b243343f3fbf3f5cebf5d64dc00f...732bca071e0f1e53735645daf3c48eb8b03af71c,1,1,1,2,1,2014-03-25 15:47:58,2014-03-23 13:47:10
732bca071e0f1e53735645daf3c48eb8b03af71c...94a5cc5c631301bbcd4ea286144099223cee6011,1,5,3,8,3,2014-03-25 15:47:58,2013-12-31 13:54:34
94a5cc5c631301bbcd4ea286144099223cee6011...a3b357abd89c781776329253790e60d56f78b883,1,14,0,14,1,2014-03-25 15:47:58,2014-02-27 00:35:24
a3b357abd89c781776329253790e60d56f78b883...64bb1a255ae52db501fa98608f4db865a7b4811a,1,3,1,4,1,2014-03-25 15:47:58,2014-02-27 15:56:07
64bb1a255ae52db501fa98608f4db865a7b4811a...44467877a8eb7483cc462e679476a1ccf7c8fc18,1,2,2,4,1,2014-03-25 15:47:58,2014-03-25 12:43:36
362927003bcd8052e294dcbdf14f061ef4f2e173...6272b4854c0b13fa778fe7d4f6f9bb12d716299f,1,39,0,39,1,2012-02-21 03:37:23,2012-02-21 03:37:23
6272b4854c0b13fa778fe7d4f6f9bb12d716299f...867cb3f511fe8d0cad04ae799b595d7b0c86746a,1,0,2,2,1,2012-02-21 05:45:33,2012-02-21 05:45:33
362927003bcd8052e294dcbdf14f061ef4f2e173...bcd5b3b52b35a458df87b204119eb18a264a580b,1,44,0,44,1,2012-02-21 00:13:38,2012-02-21 00:05:27
362927003bcd8052e294dcbdf14f061ef4f2e173...ff7e0648965e027d1b8c995065b5152333a82b7a,1,2,1,3,1,2012-02-19 19:54:33,2012-02-19 19:54:33
362927003bcd8052e294dcbdf14f061ef4f2e173...8f8767a566b24ba62cfa73a7aa4b12a95a1af285,1,13,3,16,3,2012-02-17 21:58:34,2012-02-17 21:56:09
362927003bcd8052e294dcbdf14f061ef4f2e173...dc4d7a92c1a56509ed116a3ea44345f556c4f91b,1,34,2,36,4,2012-02-08 20:19:12,2012-02-08 20:19:12
dc4d7a92c1a56509ed116a3ea44345f556c4f91b...7ea758834baa2694c2e9301fed1a71faa9f12166,1,2,2,4,2,2012-02-08 20:25:12,2012-02-08 20:25:12
7ea758834baa2694c2e9301fed1a71faa9f12166...a9f6aed307f128a58176b151bc36854c9d3899f7,1,1,1,2,1,2012-02-08 20:30:58,2012-02-08 20:30:58
362927003bcd8052e294dcbdf14f061ef4f2e173...fbf5b0ecb6b551b7d4ee2f1e85780c9fdbe052a0,1,2,0,2,1,2012-02-07 02:50:17,2012-02-07 02:50:17
fbf5b0ecb6b551b7d4ee2f1e85780c9fdbe052a0...b62a3e89602bca23b794dd1e808d92a89880ad3f,6,6,6,12,6,2012-02-12 17:27:06,2012-02-12 17:27:06
362927003bcd8052e294dcbdf14f061ef4f2e173...72aeaa9d9ee55fbfe15b371c0bf127ab3948a965,1,12,0,12,2,2012-02-06 07:51:31,2012-02-06 07:51:31
362927003bcd8052e294dcbdf14f061ef4f2e173...8f89d4d5a5d584bae288d8111d83a6489a1369dc,1,2,0,2,1,2012-01-27 08:20:06,2012-01-27 08:20:06
9d92987b8a0456e6cc51dd893159071e1fcf43db...8769e5f8c959f3d3fc9e5b62ab48fc0f73aedb1f,2,2,2,4,2,2012-01-27 07:19:50,2012-01-27 07:19:50
9d92987b8a0456e6cc51dd893159071e1fcf43db...52733cb3bb0b1c85230c5c69e6c7231fb41c67fe,1,2,0,2,1,2012-01-26 23:20:08,2012-01-26 23:20:08
9d92987b8a0456e6cc51dd893159071e1fcf43db...0da18650c6d8f63c230c36e92786855361f42ef3,1,1,1,2,1,2012-01-26 18:31:45,2012-01-26 18:31:45
9f46eafae0bed7df50a0004fca5d25539425ff85...9d67d75b0ad62242e60db1bd6d22ae7ea252c7bc,2,3,3,6,2,2011-08-31 03:56:13,2011-08-31 03:56:13
9f46eafae0bed7df50a0004fca5d25539425ff85...1fb141cfb51f753fe997d17c12ac810ad321f36f,1,2,0,2,1,2011-08-27 21:16:51,2011-08-27 21:16:51
1fb141cfb51f753fe997d17c12ac810ad321f36f...bd6aba9c68db06758593e9ef707839c2f0271235,1,2,0,2,1,2011-08-27 21:23:49,2011-08-27 21:23:49
9f46eafae0bed7df50a0004fca5d25539425ff85...c113e88c454cf759078f06c95f4b35db90acb9d7,2,2,2,4,2,2011-08-17 04:36:27,2011-08-17 04:17:21
9f46eafae0bed7df50a0004fca5d25539425ff85...bf2c55ac5a789d8874e6d8e06360608b4234e872,1,2,0,2,1,2011-08-16 16:23:33,2011-08-16 16:23:33
9f46eafae0bed7df50a0004fca5d25539425ff85...85f388fabf657360960c3fcf55b52f2fb3c4e142,1,5,0,5,1,2011-08-16 16:18:23,2011-08-16 16:18:23
85f388fabf657360960c3fcf55b52f2fb3c4e142...ecfac1cd74cada9594531d6c0217e511914a14f6,1,22,1,23,1,2011-09-11 20:19:49,2011-09-11 20:19:49
a4748a2aad0c57f3fab01d7bd2dcbe6be00263d2...4d0c135798368a6241752060ffc6a2190a94a810,1,345,0,345,1,2012-07-10 12:54:11,2012-07-10 12:49:32
4d0c135798368a6241752060ffc6a2190a94a810...d2116f355742ffe3f0c44ee865d136cb979eedea,1,1,0,1,1,2012-07-10 12:57:59,2012-07-10 12:57:59
d2116f355742ffe3f0c44ee865d136cb979eedea...350720eca171513a5e959d01dbeceaf15f268c5c,1,624,60,684,1,2012-07-12 12:05:33,2012-07-12 12:05:33
350720eca171513a5e959d01dbeceaf15f268c5c...df176fb3dcdc036ecd6165beea47e64e307ea978,2,3,1,4,2,2012-07-12 12:17:59,2012-07-12 12:17:59
df176fb3dcdc036ecd6165beea47e64e307ea978...4caea1f7e143ac84583618cf8d2109212ba6909a,1,209,209,418,209,2012-07-13 10:08:41,2012-07-13 10:08:41
4caea1f7e143ac84583618cf8d2109212ba6909a...e4ffac154d4af9187b4d052c9fc1b3305a538076,1,8,8,16,8,2012-07-13 14:24:45,2012-07-13 14:24:45
e4ffac154d4af9187b4d052c9fc1b3305a538076...b49c97e08ee5abc705b001d846575c33dee1bf56,1,769,625,1394,4,2012-07-24 10:15:36,2012-07-24 10:15:36
b49c97e08ee5abc705b001d846575c33dee1bf56...0ebeb562523a33e636309a07b37fc1c291643f22,1,20,8,28,9,2012-07-24 14:16:55,2012-07-24 14:16:55
0ebeb562523a33e636309a07b37fc1c291643f22...fb3cae1b8f9740e03c8e107727c810feb97b5ec2,1,18,14,32,15,2012-07-31 13:02:12,2012-07-31 13:02:12
fb3cae1b8f9740e03c8e107727c810feb97b5ec2...a4e6a2ce9fe2edd98dd654763fac87cc08660dc3,1,200,123,323,126,2012-07-31 14:59:56,2012-07-31 14:59:56
a4e6a2ce9fe2edd98dd654763fac87cc08660dc3...8f0c617f6a7bdee3d6b3e61794f7035ceb90d545,1,1,1,2,1,2012-08-03 08:02:19,2012-08-03 08:02:19
8f0c617f6a7bdee3d6b3e61794f7035ceb90d545...c24d7f75d325b9d869036ecb06dcf020edec916c,1,1,1,2,1,2012-08-03 08:02:27,2012-08-03 08:02:27
c24d7f75d325b9d869036ecb06dcf020edec916c...265b2a559b60d1a36c63a82ab2c2071faf81e3fe,1,6,2,8,3,2012-08-03 08:15:01,2012-08-03 08:15:01
54f17588b363fa20df592366b6dd693ce3b7c820...f999fd8e121c1fd4d097c25be59c6020e1aed830,2,28,0,28,2,2011-12-26 17:20:02,2011-12-26 17:20:02
54f17588b363fa20df592366b6dd693ce3b7c820...59baf390e96751fc51299ecefe921ba8718ba3aa,1,6,0,6,1,2011-12-26 03:16:26,2011-12-26 03:16:26
54f17588b363fa20df592366b6dd693ce3b7c820...0b583638ae7bc58928b77669919600e27f4738b0,1,2,2,4,2,2011-12-25 14:23:55,2011-12-11 14:57:35
54f17588b363fa20df592366b6dd693ce3b7c820...12a04571bbe5551cff6c8095ede74e4c8d7cc5aa,1,1,0,1,1,2011-12-23 07:14:22,2011-12-23 07:14:22
54f17588b363fa20df592366b6dd693ce3b7c820...d8521693f4e2c140391065e7b721d7452134259f,1,2,0,2,2,2011-12-22 19:02:01,2011-12-22 19:02:01
54f17588b363fa20df592366b6dd693ce3b7c820...dd14e075b7dd39906e2075ac6dd8f5bcc66b6129,1,1,1,2,1,2011-12-21 14:03:55,2011-12-21 14:03:55
54f17588b363fa20df592366b6dd693ce3b7c820...a21dc477c26ce29c839ca3aa36af91efcad179ea,1,1,0,1,1,2011-12-20 22:16:02,2011-12-20 22:16:02
90c28b786ae8a8013fc5083e9cf941115152c706...ae1fe0029c63debfe44dcba52761389c6c876b31,1,20,18,38,3,2013-11-16 23:03:16,2013-11-16 23:03:16
90c28b786ae8a8013fc5083e9cf941115152c706...78df6e96f5ad2d6df77af39f70f4906a09700849,2,39,2,41,2,2013-10-30 03:33:23,2013-10-30 03:02:44
78df6e96f5ad2d6df77af39f70f4906a09700849...008e57aa5aec0f38445785da58a11462ef9451f9,1,42,1,43,3,2013-10-31 01:00:08,2013-10-31 01:00:08
90c28b786ae8a8013fc5083e9cf941115152c706...c81e42f050b9b7152d9ebfa4a3d5a0442159b8d1,1,9,0,9,1,2013-10-30 03:05:35,2013-10-30 03:05:35
90c28b786ae8a8013fc5083e9cf941115152c706...f731d6c16fd49e8140250a90e91d01f49d13da17,1,1,1,2,1,2013-10-28 15:06:10,2013-10-28 15:06:10
90c28b786ae8a8013fc5083e9cf941115152c706...103fc334d6ccb04120b87596e82b5ddaca6d6d44,1,1,0,1,1,2013-10-26 09:43:59,2013-10-26 09:43:59
90c28b786ae8a8013fc5083e9cf941115152c706...1e9f55f09ddae273836ad1a69a0068b039de9fcd,2,22,2,24,3,2013-10-25 21:50:27,2012-04-23 21:03:26
90c28b786ae8a8013fc5083e9cf941115152c706...e3c489bd08236828286e01b4561e6b73b5e518bd,1,3,3,6,1,2013-10-25 05:40:55,2013-10-25 05:40:55
c41807c82fa21e1fcdb18af03a428b88bf2d9673...480d1247b89ae089564eb0ca7d66aef989b9f5e5,1,8,0,8,1,2011-12-26 18:15:35,2011-12-26 18:15:35
5f62d2c183f93ef02b79675c6a51950cb530dfcb...5991bf3ac1865819fd43cbf38681c71c3d5c9ecb,1,2,2,4,2,2012-12-02 20:39:01,2012-12-02 20:39:01
ac910b85bd782ec7a033b67bab7be63785d063c2...a26f9b9948405a10d3c04280a0ad2e49e69ba6f8,1,1,1,2,1,2012-01-25 05:56:09,2012-01-25 05:56:09
ac910b85bd782ec7a033b67bab7be63785d063c2...6496acf58bf8531809490b52e34811f74a27cc7c,17,96,18,114,21,2012-01-24 01:42:54,2012-01-24 01:42:54
5516f8c42b8ef05e1ae8e8f839c251063ce7804b...a49fcea9f5d281cccce2ad421db253455a248109,1,1,1,2,1,2012-01-02 20:48:19,2012-01-02 20:48:19
8c45b739181ba58e91e2dceaa53b08161c46b03f...7a361870a97d9d34158542503f942fb0c67accfc,1,1,1,2,1,2012-01-06 21:10:57,2012-01-06 21:10:57
8c45b739181ba58e91e2dceaa53b08161c46b03f...9ac98f6ceb77df71c98558a122bc06f8adadf989,1,2,0,2,1,2012-01-05 21:41:27,2012-01-05 21:41:27
9ac98f6ceb77df71c98558a122bc06f8adadf989...ae735335e186447b370d299376970a7ea949b474,1,1,1,2,2,2012-01-09 23:19:19,2012-01-09 23:19:19
8c45b739181ba58e91e2dceaa53b08161c46b03f...a28b8889ee80856b65dd792dedd7735a1b94443c,1,11,0,11,1,2012-01-05 05:16:17,2012-01-05 05:16:17
8c45b739181ba58e91e2dceaa53b08161c46b03f...955825b1e9e484e4b6811a6ba8895924c1834493,1,8,4,12,1,2012-01-03 17:03:53,2012-01-03 17:03:53
955825b1e9e484e4b6811a6ba8895924c1834493...5809a4721dd1b575c1f4cbc3cc361520e97cd8b9,1,6,6,12,1,2012-01-10 09:01:16,2012-01-10 09:01:16
7a41498b0d4f68c537d494b5f849913361315fde...8f1a5d3f1581c80510728143e146143deecaa61e,1,6,0,6,1,2012-01-18 02:23:28,2012-01-17 02:11:01
7a41498b0d4f68c537d494b5f849913361315fde...4b3429d765f1f14f7dbf2cc451e3047388978bf6,1,9,3,12,4,2012-01-16 17:25:14,2012-01-16 17:21:27
7a41498b0d4f68c537d494b5f849913361315fde...78a129ca06cbe9f9dbfd171491d734249e91dc2c,1,11,11,22,5,2012-01-16 15:39:28,2012-01-16 15:39:28
7a41498b0d4f68c537d494b5f849913361315fde...73c2c8adc77568abdf2c7be1761c5cac6f06ad06,1,1,1,2,1,2012-01-16 14:19:36,2012-01-16 14:19:36
7a41498b0d4f68c537d494b5f849913361315fde...6040d72e2a438529f5850b68d1a87d54a3c96f45,1,1,1,2,1,2012-01-16 11:20:06,2012-01-16 11:20:06
6040d72e2a438529f5850b68d1a87d54a3c96f45...54a30c470145be2d7aa055bc7a05815ce051d540,1,1,3,4,1,2012-01-16 12:26:08,2012-01-16 12:26:08
7a41498b0d4f68c537d494b5f849913361315fde...0d99759cc371d7b8f70cde950f42cc3558559533,1,17,10,27,1,2012-01-15 06:49:52,2012-01-15 06:49:52
7a41498b0d4f68c537d494b5f849913361315fde...c04b4abe91b69c058bde8e5968abb759b9168b88,2,0,4,4,2,2012-01-13 12:40:59,2012-01-13 12:40:59
c04b4abe91b69c058bde8e5968abb759b9168b88...b73f95ab260f49bf6baa484faa40591c51629c02,2,0,5,5,2,2012-01-16 13:34:07,2012-01-16 13:34:07
631e3d8e03f77e1292370375f39fc6688e606350...5a5c93b33493b47d34dd470eb851aaf24fa87536,1,5,5,10,2,2012-02-21 15:47:05,2012-02-21 15:47:05
0d36ecfe387b164a13899ae2e7ac565b0abd0bbd...7eb2f528a65a45b88fdda6bdeb76ceb5ea16f5e3,1,0,0,0,0,2013-11-04 15:20:12,2013-11-04 15:20:12
4e34588a5b2e48c4ce901f47ed4c1a6b753c6926...2ffca0680623d2a3875ac6a8bb9458a06aa57938,1,4,1,5,2,2013-12-03 13:56:18,2013-12-03 13:56:18
4e34588a5b2e48c4ce901f47ed4c1a6b753c6926...858c515df2d8ce1f75ac3d505f77a71984653929,1,1,1,2,1,2013-12-03 08:52:51,2013-12-03 08:52:51
579f33d489c8b61e77279894cd467c3207955c09...18cb11903f8208403a0ba5a8f2ece1a0bd4ef9a3,1,1,1,2,1,2012-06-26 22:12:21,2012-06-26 22:12:21
989b6ec29eb523424ea4ec701068789878e62400...6b6208e1416b5eb5aa5a032139d4b61f8939386b,1,2,2,4,1,2013-04-08 11:02:48,2013-04-08 11:02:48
989b6ec29eb523424ea4ec701068789878e62400...58a6ed1eac57d3faf082070c21bc9770da90a044,1,2,2,4,1,2013-04-08 10:45:45,2013-04-08 10:45:45
989b6ec29eb523424ea4ec701068789878e62400...9af229539467adf010c1f81c0ac4f03dc9bc9542,1,29,0,29,1,2013-04-08 07:38:15,2013-04-08 07:38:15
a11c8142d3721f5921a304d8f67a89f26622a719...730e0296640fed91b6db83745abf920428aa5abf,1,2,0,2,1,2012-01-07 20:36:58,2012-01-07 20:36:58
730e0296640fed91b6db83745abf920428aa5abf...49d44adb09f417fac24ea8e664b12f6546f22e9d,1,1,1,2,1,2012-01-20 18:07:03,2012-01-20 18:07:03
1a0be15d8c9c008eeeca57b820fe090fcbf9c59a...96265d26454868b8b654e4a5271939748e1dd148,1,1,1,2,1,2012-01-17 18:00:12,2012-01-17 18:00:12
cf03ee6d884b3850775210acb18cfb669cd666fd...615e41b0ecdb25acba513fd09619bd56c2eb24eb,1,21,0,21,1,2013-01-15 14:45:27,2013-01-15 14:45:27
1120f973054836eeb53750f57d69fbec41a340dc...1876f1d5581e7b6907ead46a8371826db5eded49,1,18,18,36,7,2012-05-29 12:35:15,2012-05-28 21:14:51
1876f1d5581e7b6907ead46a8371826db5eded49...0673425331fe997224bab9f90579c40cd14934f1,1,3,0,3,1,2012-05-29 12:35:25,2012-05-28 21:17:38
1120f973054836eeb53750f57d69fbec41a340dc...3dd3c1f4158365b98e0754de9f0c1cbcb33d026c,1,12,0,12,1,2012-05-29 12:32:49,2012-05-28 23:07:36
1120f973054836eeb53750f57d69fbec41a340dc...b7bad0f69b064225a4557667eb1e95d3df8ad819,1,128,0,128,1,2012-05-29 01:24:05,2012-05-05 22:05:22
b7bad0f69b064225a4557667eb1e95d3df8ad819...8c18f007131eb242eacae16db85b07f986b08063,1,19,9,28,5,2012-05-29 01:24:05,2012-05-06 20:26:12
1120f973054836eeb53750f57d69fbec41a340dc...fcb153c2e32641bb13649bfdd8d3bbe8c17798c8,1,24,0,24,1,2012-05-29 01:22:10,2012-05-04 22:05:50
fcb153c2e32641bb13649bfdd8d3bbe8c17798c8...f970d8206e9245eb2f78728623fdfff354402644,1,22,1,23,7,2012-05-29 01:22:10,2012-05-05 08:52:46
f970d8206e9245eb2f78728623fdfff354402644...4c0b5c71d5332f6961156fc1cda0ab9cc54b8787,1,11,1,12,2,2012-05-29 01:22:10,2012-05-05 08:58:55
4c0b5c71d5332f6961156fc1cda0ab9cc54b8787...e0b271264460219e624ac378c40421490a8e193c,1,12,1,13,5,2012-05-29 01:22:11,2012-05-05 14:03:48
e0b271264460219e624ac378c40421490a8e193c...712f850f3a860e87458d35a7d8ebba13b9975a06,1,8,0,8,4,2012-05-29 01:22:11,2012-05-05 14:07:05
712f850f3a860e87458d35a7d8ebba13b9975a06...6f5599474f31516cec641242c0bdb391d8930cf2,1,13,0,13,1,2012-05-29 01:22:11,2012-05-05 14:08:40
6f5599474f31516cec641242c0bdb391d8930cf2...88f3f28e8c634e54e68769d72f2ec40f7c5d35f9,1,1,1,2,1,2012-05-29 01:22:11,2012-05-05 14:10:52
88f3f28e8c634e54e68769d72f2ec40f7c5d35f9...67290ffca93d3fb7ebeb9253cc551a5632299c16,1,27,13,40,12,2012-05-29 01:22:11,2012-05-05 14:17:26
67290ffca93d3fb7ebeb9253cc551a5632299c16...3af5cf3b1d40312101dae89c1d43c9d6afef8fcd,1,25,1,26,5,2012-05-29 01:22:11,2012-05-10 07:21:50
3af5cf3b1d40312101dae89c1d43c9d6afef8fcd...7a338ab6a5208a9f9b9fcbf69d225159fc4ae600,1,12,4,16,6,2012-05-29 01:22:11,2012-05-10 07:35:29
7a338ab6a5208a9f9b9fcbf69d225159fc4ae600...d573cddcc937be8c253b97b7343a0670aea3e9b7,1,4,4,8,4,2012-05-29 01:22:11,2012-05-29 01:07:15
d573cddcc937be8c253b97b7343a0670aea3e9b7...b1977d4049cbb7fd203f53511c1067a17150d3e4,1,14,14,28,7,2012-05-29 01:22:11,2012-05-13 08:22:45
b1977d4049cbb7fd203f53511c1067a17150d3e4...0f35726a003e133daf8879aa05ba276ed565c0dd,1,2,2,4,2,2012-05-29 01:22:11,2012-05-13 08:23:20
1120f973054836eeb53750f57d69fbec41a340dc...dbef8b1a92f789f4109435a3b7278f899e328767,1,30,0,30,1,2012-05-28 23:49:52,2012-05-05 08:39:05
dbef8b1a92f789f4109435a3b7278f899e328767...8f71efc09b42d69cc053649fade92485d282a561,1,28,0,28,1,2012-05-28 23:51:50,2012-05-05 08:39:31
1120f973054836eeb53750f57d69fbec41a340dc...af03da0dc91a32175f99f85ab1fc09dc4246fef9,2,2,2,4,1,2012-05-16 18:51:52,2012-05-16 18:51:52
1120f973054836eeb53750f57d69fbec41a340dc...51c55ad17e23db89e72424add0c34fa20654cd8f,1,1,1,2,1,2012-05-06 10:08:34,2012-05-06 10:08:34
51c55ad17e23db89e72424add0c34fa20654cd8f...f9018c5efbb6cf164139009eff1863837d72b412,1,2,3,5,3,2012-05-06 10:10:16,2012-05-06 10:10:16
1120f973054836eeb53750f57d69fbec41a340dc...e2f7623534054645e849db42a0030a1642e5ba97,1,1,1,2,1,2012-05-03 12:03:23,2012-05-03 12:03:23
1120f973054836eeb53750f57d69fbec41a340dc...79847ad77d1613fa823b2c6e097895b3b5193074,1,2,0,2,2,2012-05-02 17:32:30,2012-05-02 17:32:30
1120f973054836eeb53750f57d69fbec41a340dc...6f4c69cb48d6fb746149afddee264509a5245305,1,8,0,8,1,2012-04-25 14:59:53,2012-04-25 14:59:53
6f4c69cb48d6fb746149afddee264509a5245305...7fd1bf597fd866480d41a4208fa23d04b1a79044,1,1,0,1,1,2012-04-25 15:02:17,2012-04-25 15:02:17
1120f973054836eeb53750f57d69fbec41a340dc...5eb466a7886e1220584322a10964343a101ed1dc,1,3,0,3,1,2012-04-19 07:14:55,2012-04-19 07:14:55
5eb466a7886e1220584322a10964343a101ed1dc...99a3c3c5c85b7a72037022607f41d682b77db7d7,1,1,1,2,1,2012-04-22 15:36:37,2012-04-22 15:36:37
1120f973054836eeb53750f57d69fbec41a340dc...8ce35df2c5aa333dd394f6e7e2700538c10d9a90,1,9,7,16,1,2012-04-18 10:45:22,2012-04-18 10:45:22
1120f973054836eeb53750f57d69fbec41a340dc...e429a880e68982ce9ab0f35921174493fa3e4c03,1,5,1,6,5,2012-04-12 09:04:24,2012-04-12 09:04:24
1120f973054836eeb53750f57d69fbec41a340dc...8942d304ff55ad9467872ecab3f343552b5c2083,1,19,0,19,1,2012-04-07 16:23:12,2012-04-07 16:23:12
1120f973054836eeb53750f57d69fbec41a340dc...12e181c6f6167adabb688f63418037c8c1949335,1,7,1,8,1,2012-04-04 18:04:00,2012-04-04 18:04:00
1120f973054836eeb53750f57d69fbec41a340dc...dc3074309555965e47b604499ca64a1489f639ed,1,14,0,14,7,2012-04-04 17:52:14,2012-04-04 17:52:14
1120f973054836eeb53750f57d69fbec41a340dc...a75aabad1e455dcbf62891ba7370f6c0ea1108b2,1,99,0,99,1,2012-04-04 07:00:04,2011-11-09 21:43:32
a75aabad1e455dcbf62891ba7370f6c0ea1108b2...0b70b6d0483210b7fcc74ee1073c7de887f4f3ac,1,2,2,4,1,2012-04-04 07:00:04,2012-04-04 06:58:09
1120f973054836eeb53750f57d69fbec41a340dc...ce6a21c3b3c6b0fb6a8b8a2cb20991fec91ec86a,1,1,1,2,1,2012-03-23 19:31:13,2012-03-23 19:31:13
1120f973054836eeb53750f57d69fbec41a340dc...60c3fa937120f38b1215a57889c8207989c9a7f1,1,4,1,5,1,2012-03-21 21:34:19,2012-03-21 21:34:19
1120f973054836eeb53750f57d69fbec41a340dc...e652756fdb0495e58f3f4f3be3a82aa9f166731d,2,136,0,136,2,2012-03-20 12:16:44,2012-03-20 12:16:44
e652756fdb0495e58f3f4f3be3a82aa9f166731d...92227f171ad3777c2671395a9e1d7fbb86a11428,1,3,1,4,2,2012-03-20 13:55:25,2012-03-20 13:55:25
92227f171ad3777c2671395a9e1d7fbb86a11428...04a7536641621e0188987b5bb1362e6b922a8771,1,3,0,3,1,2012-03-30 10:33:06,2012-03-30 10:33:06
04a7536641621e0188987b5bb1362e6b922a8771...c2e459ad43b060c9dc2548e378a2f2d412d6da60,1,13,0,13,1,2012-03-30 10:39:49,2012-03-30 10:39:49
c2e459ad43b060c9dc2548e378a2f2d412d6da60...94dd6515365e0d2655485c5afc27e75a921fa6ec,1,1,1,2,1,2012-04-01 19:41:39,2012-04-01 19:41:39
1120f973054836eeb53750f57d69fbec41a340dc...605ad8725b06cc15f8523404f59060b6a71bb7a2,1,1,0,1,1,2012-03-20 01:25:21,2012-03-20 01:25:21
1120f973054836eeb53750f57d69fbec41a340dc...5f72c6313643f3e627394c540192b77781c08178,1,0,1,1,1,2012-03-18 01:03:01,2012-03-18 01:03:01
1120f973054836eeb53750f57d69fbec41a340dc...db27635d8b4cb60f4d3594893e53777179d00d43,1,2,0,2,1,2012-03-16 12:10:37,2012-03-16 12:10:37
1120f973054836eeb53750f57d69fbec41a340dc...aefacb69509f8cdd4ad3b0bba9b77cd9ee63e115,1,19,9,28,9,2012-03-09 13:53:09,2012-03-09 13:53:09
aefacb69509f8cdd4ad3b0bba9b77cd9ee63e115...8762b27d67156886d144213ba656aa3e8edfcf8b,1,9,0,9,1,2012-04-04 16:54:31,2012-04-04 16:54:31
1120f973054836eeb53750f57d69fbec41a340dc...c7105a53416866e8315c503546dc5bfe2b9da83f,1,3,1,4,1,2012-03-07 12:47:34,2012-03-07 12:47:34
1120f973054836eeb53750f57d69fbec41a340dc...4a88743d1eb28f7d928c6d7ce3ebeccc6b1991a8,1,7,7,14,4,2012-03-07 00:31:03,2012-03-07 00:31:03
1120f973054836eeb53750f57d69fbec41a340dc...09c5996cd0528eb03a93dd464f3cbd755eafd624,1,6,0,6,1,2012-03-05 13:36:50,2012-03-05 13:36:50
09c5996cd0528eb03a93dd464f3cbd755eafd624...c1e9d9226c106aaf973712b1a700dd045aeff9bc,1,0,0,0,0,2012-03-05 13:39:09,2012-03-05 13:39:09
c1e9d9226c106aaf973712b1a700dd045aeff9bc...bd4f1eeca2d1430029153f7be0aa432ef5d2fce9,1,1,1,2,1,2012-03-06 06:09:11,2012-03-06 06:09:11
bd4f1eeca2d1430029153f7be0aa432ef5d2fce9...7ffc3e745fa7ab020ec45e4ffe7a069c823e386a,1,1,1,2,1,2012-03-06 06:14:17,2012-03-06 06:14:17
7ffc3e745fa7ab020ec45e4ffe7a069c823e386a...814ecfc60daffc1eac250d41643d05fb1f43bd4c,1,1,1,2,1,2012-03-07 15:52:51,2012-03-07 15:52:51
814ecfc60daffc1eac250d41643d05fb1f43bd4c...e9feccf6a94f9f5238ff0b3501f62575d14ae148,1,6,0,6,1,2012-03-22 01:33:55,2012-03-22 01:33:55
1120f973054836eeb53750f57d69fbec41a340dc...071d0d68ec1a7f883c10529fda47630dcc3f5afe,1,1,1,2,1,2012-03-05 11:55:30,2012-03-05 11:55:30
1120f973054836eeb53750f57d69fbec41a340dc...b1e4ef17543d4a236ad35417ac36560917e6cadc,1,7,1,8,2,2012-03-01 14:57:00,2012-03-01 14:57:00
1120f973054836eeb53750f57d69fbec41a340dc...19bf83e17d90d64b9bb40f8fd4c36e660e4b17e3,1,1,1,2,1,2012-03-01 08:27:19,2012-01-29 14:41:40
1120f973054836eeb53750f57d69fbec41a340dc...f8802bd61216b7636b9065efe5441479d3e4f7fd,1,10,0,10,1,2012-03-01 08:19:34,2012-01-26 20:25:51
1120f973054836eeb53750f57d69fbec41a340dc...d693711f1419c4c4da1da8eca35c1d983bb42ab0,1,2,2,4,2,2012-02-28 18:52:57,2012-02-28 18:52:57
1120f973054836eeb53750f57d69fbec41a340dc...fa1657e10bc062394390d83d0bb5d3848905f5b6,1,4,0,4,2,2012-02-26 10:29:24,2012-02-26 10:29:24
1120f973054836eeb53750f57d69fbec41a340dc...4e0b5be145cb0f4eda769906e9e72e31aec7c236,1,1,0,1,1,2012-02-24 07:12:07,2012-02-24 07:12:07
1120f973054836eeb53750f57d69fbec41a340dc...c9c021478ea4a2b55aac8cda3cd0d05137443f36,1,1,0,1,1,2012-02-23 14:19:38,2012-02-23 14:11:52
178b5224e830845e45070ef803fcdb5a3f468dca...12e30faaca13a2e931c4062fdc8a3589e8069460,1,3,2,5,1,2014-03-23 01:09:38,2014-03-23 01:03:12
e6c81a58939c8aa1ff8dcf583c3c8b5d129f8aab...4199c1a6f77f1605157b1cfa6baa47c14c68a6c9,1,6,2,8,2,2012-06-13 20:14:23,2012-06-13 20:14:23
b2376c3770753087b35140cc21e5b3223f46ee07...dd4f57010cdfaba8c3240b21e138c5b3f8a3607d,1,1,1,2,1,2013-11-04 23:40:13,2013-11-04 23:40:13
8c93142b13fa76290f305e21596fb850629fd80f...f082d7a245da8767a11dcc20a7e68ababefa5f34,1,11,12,23,2,2013-12-05 03:59:57,2013-12-05 03:59:57
5193a1dbc9a1f666ba384b0ebb5fb94b9da56bb2...51e05b7579a26266a0ed26398ab9eb5071800cd8,1,6,0,6,1,2012-12-02 21:11:55,2012-10-05 20:27:05
b2b77be56f35a9753e7491fd88b3c4b7ec74c586...fe094712fb0c896eeec55b686807011226bc9208,1,1,1,2,1,2012-12-02 20:30:46,2011-12-21 02:15:19
4300b63462c063fbb195de5557064dcaa2490387...2bae7ef4f9972d4b3accf6bd614e38d9a2410a70,1,9,3,12,4,2013-04-08 21:07:06,2013-04-08 21:07:06
0198a12953ab92f5cc07ae464c34e3e37ab34d33...c50b9a24f1d80cf38f5f299ab02b5c9409faa7c8,1,5,1,6,2,2013-04-11 20:56:22,2013-04-11 20:56:22
0198a12953ab92f5cc07ae464c34e3e37ab34d33...872ef081d30f32fd7b38360bb0264452ebfd96eb,1,14,0,14,2,2013-04-10 02:52:49,2013-04-10 02:52:49
872ef081d30f32fd7b38360bb0264452ebfd96eb...c3b20a65415dacb87f8ea5c94144d8ed12f95341,1,1,0,1,1,2013-04-10 02:55:53,2013-04-10 02:54:50
0198a12953ab92f5cc07ae464c34e3e37ab34d33...32a42f27b62b62bd915ab632b0b36fa939d22c0e,1,2,1,3,2,2013-04-09 18:45:16,2013-04-09 18:45:16
0198a12953ab92f5cc07ae464c34e3e37ab34d33...c8db4f81fa4716ff627b63e4f7022d01c4b712d7,1,1,0,1,1,2013-04-09 10:11:51,2013-04-09 10:11:51
0198a12953ab92f5cc07ae464c34e3e37ab34d33...0854b18cdfa6b29b08848a23e79c3f214c5e0f8d,1,5,0,5,1,2013-04-08 20:32:00,2013-04-08 20:32:00
0198a12953ab92f5cc07ae464c34e3e37ab34d33...9c6b88607e8f2898ba3bc83fdf5cce616c6aec83,1,3,0,3,1,2013-04-08 20:11:22,2013-04-08 20:11:22
615e41b0ecdb25acba513fd09619bd56c2eb24eb...535fafde816b0c45521c5de2003ae9e0038cc424,3,327,0,327,3,2013-02-15 15:05:15,2013-02-15 15:05:15
615e41b0ecdb25acba513fd09619bd56c2eb24eb...a5a6f6bb6c95422964f9fe9b8e19d1a830202733,2,6,1,7,3,2013-02-07 21:26:41,2013-02-07 21:26:41
615e41b0ecdb25acba513fd09619bd56c2eb24eb...631a8473e2f3f20e1414dff4e409fe07cbb41aea,1,42,0,42,1,2013-02-05 08:45:00,2013-02-05 08:45:00
615e41b0ecdb25acba513fd09619bd56c2eb24eb...ef8e3a67f293ab3d4dfc67da5af321de7c019ca4,1,13,2,15,2,2013-01-31 01:46:08,2013-01-31 01:46:08
615e41b0ecdb25acba513fd09619bd56c2eb24eb...6d762fa053154a10befec1a42c963fff072ebece,1,12,0,12,1,2013-01-30 13:16:26,2013-01-30 13:16:26
615e41b0ecdb25acba513fd09619bd56c2eb24eb...8a463b6df7048c8507f95344c3dc5d7a1355c48d,1,3,0,3,1,2013-01-30 05:44:42,2013-01-30 05:44:42
615e41b0ecdb25acba513fd09619bd56c2eb24eb...2e213b9b8f96722d4978a80ae53849fec437eb10,1,1,1,2,1,2013-01-27 13:50:33,2013-01-27 13:50:33
2e213b9b8f96722d4978a80ae53849fec437eb10...171a76a3c45ac031262e4eb7eaa38cc020a59812,1,1,1,2,1,2013-01-30 08:32:01,2013-01-30 08:32:01
171a76a3c45ac031262e4eb7eaa38cc020a59812...11576dd40bfb78379724a9519081365bbd41d7a9,1,1,1,2,1,2013-02-13 10:28:13,2013-02-13 10:28:13
11576dd40bfb78379724a9519081365bbd41d7a9...9245a3086843c20ef1880f6d26720db73d5c724d,1,1,1,2,1,2013-02-13 16:14:43,2013-02-13 16:14:43
615e41b0ecdb25acba513fd09619bd56c2eb24eb...4c91f6d13e32d7389cae299d96f6778451a45fc8,2,21,0,21,2,2013-01-25 11:23:40,2013-01-25 10:58:55
615e41b0ecdb25acba513fd09619bd56c2eb24eb...8e9cf45200391db787b3a25ae00f4352d7a11e8e,1,20,0,20,2,2013-01-18 23:52:09,2013-01-18 23:52:09
8e9cf45200391db787b3a25ae00f4352d7a11e8e...28b737416fe1eadd1a0e0bad460941651ac20e49,1,23,6,29,6,2013-01-20 12:10:31,2013-01-20 12:10:31
0673425331fe997224bab9f90579c40cd14934f1...0aa4456d5657c957eaf0c54f6eb24e58b9149d4b,1,14,0,14,1,2012-06-30 00:04:56,2012-06-29 23:42:35
0aa4456d5657c957eaf0c54f6eb24e58b9149d4b...7d24f4cd407d61a17bd88157c594215ecc3b0bcd,1,1,1,2,1,2012-06-30 00:05:05,2012-06-29 23:42:47
7d24f4cd407d61a17bd88157c594215ecc3b0bcd...e3c87611fc75ff5149b13fdd84ee8c87c7c1d129,1,1,0,1,1,2012-06-30 00:05:05,2012-06-29 23:44:08
e3c87611fc75ff5149b13fdd84ee8c87c7c1d129...5f37649508f6b6323e78249671d7897af8076886,1,33,12,45,1,2012-06-30 03:17:10,2012-06-30 02:44:26
5f37649508f6b6323e78249671d7897af8076886...1b36c1beae21dafead692f83a099bdd69a0c6e50,1,1,4,5,2,2012-06-30 03:37:10,2012-06-30 03:37:10
3fdaf26006e3f075e7ccefd2721295b8bc5172f9...91b4758d8f5a910a60de783f15acb66acda68d7f,1,1,1,2,1,2012-05-31 16:52:53,2012-05-31 16:52:53
3fdaf26006e3f075e7ccefd2721295b8bc5172f9...8de877d63222ed4effad7d52d68fccca2c01b6dd,1,1,1,2,1,2012-05-29 08:20:49,2012-05-29 08:20:49
3fdaf26006e3f075e7ccefd2721295b8bc5172f9...0f9fff8aecb154627b42a57cede37f7bd7b6c3ba,1,6,0,6,1,2012-05-23 23:54:02,2012-05-23 23:47:06
0f9fff8aecb154627b42a57cede37f7bd7b6c3ba...548f68d7f028acc70f4a9026a28161a604edc405,1,39,0,39,1,2012-05-24 00:03:18,2012-05-24 00:03:18
3fdaf26006e3f075e7ccefd2721295b8bc5172f9...61c39b50390a7869f22001a6cd65b7e8cd977e88,1,1,1,2,1,2012-05-23 04:49:21,2012-05-23 04:49:21
3fdaf26006e3f075e7ccefd2721295b8bc5172f9...6f859c5837753a87544b2672678e36bcf167cc82,1,6,1,7,1,2012-05-21 14:42:12,2012-05-21 14:42:12
6f859c5837753a87544b2672678e36bcf167cc82...8923694fb42393d063487203e803199b394bbb47,1,5,4,9,1,2012-05-24 15:33:19,2012-05-24 15:33:19
3fdaf26006e3f075e7ccefd2721295b8bc5172f9...adab18f1616956beb10419dc52b8d713d6b6c9e0,1,5,0,5,1,2012-05-21 10:17:03,2012-03-24 22:00:05
adab18f1616956beb10419dc52b8d713d6b6c9e0...b4380aacb0a0a89618430b2bbb1221c602d43d62,1,2,0,2,1,2012-05-21 10:17:04,2012-04-19 10:49:15
db27635d8b4cb60f4d3594893e53777179d00d43...43c09216939d3936a3a3887a975c4b16e8664806,1,3,1,4,1,2012-06-14 10:31:00,2012-06-14 10:31:00
4a11d2c35c7a526e648b37a5b02b7695be46b16a...3fe1e5c78760b81335eef501ef7f89875ae7753a,1,117,0,117,1,2012-07-18 15:37:21,2012-07-18 15:37:21
e8d582aba98d57214a374bed01570ba791c54d9e...62a436bb95144b00f0ef8ba8906a4044b4be4d9c,1,1,1,2,1,2012-06-22 16:12:44,2012-06-22 16:12:44
e8d582aba98d57214a374bed01570ba791c54d9e...8ba97c36443d8551a28de194a3da4b7c4d6c7949,1,8,0,8,1,2012-06-22 12:33:27,2012-06-22 12:30:51
e8d582aba98d57214a374bed01570ba791c54d9e...7e1da28d27f42e4d873cdfc28ef362d59d8c2b07,1,1,1,2,1,2012-06-20 22:41:50,2012-06-20 22:41:50
e8d582aba98d57214a374bed01570ba791c54d9e...8088e8ac7935e9289d049278e117befd87f48809,1,18,0,18,1,2012-06-20 21:59:05,2012-06-18 08:01:05
e8d582aba98d57214a374bed01570ba791c54d9e...b97cc939ec50cbd424beb4d9d5d61625b209ccac,1,39,0,39,1,2012-06-20 20:17:41,2012-06-20 20:17:41
b97cc939ec50cbd424beb4d9d5d61625b209ccac...98d7a010994cd39758e4a1599cefe9e130a346db,1,7,10,17,7,2012-06-20 20:26:05,2012-06-20 20:26:05
e8d582aba98d57214a374bed01570ba791c54d9e...e9a9deacb09196a48a39adc827d861e1896f4c59,1,14,1,15,2,2012-06-18 17:15:57,2012-06-18 17:15:57
e9a9deacb09196a48a39adc827d861e1896f4c59...5931f64308cbf4b0a8ef740a6b4eda5834479bd7,1,3,3,6,3,2012-06-18 18:29:24,2012-06-18 18:29:24
e8d582aba98d57214a374bed01570ba791c54d9e...82f785bc6751dc7c199b5d1ea068567120b92511,1,3,4,7,3,2012-06-18 14:41:19,2012-06-18 14:41:19
e8d582aba98d57214a374bed01570ba791c54d9e...823cc9180c21c0520713b39fe3e3590645c76ad2,1,1,1,2,1,2012-06-16 10:41:44,2012-06-16 10:41:44
e8d582aba98d57214a374bed01570ba791c54d9e...c65a53df811953b9f4117ff0b8014d869565bf9d,1,1,1,2,1,2012-06-15 07:07:22,2012-06-15 07:07:22
e8d582aba98d57214a374bed01570ba791c54d9e...4f9cfee9bdfcab18bb83d17129f090a62dc05eac,1,7,1,8,1,2012-06-14 05:06:36,2012-06-14 05:06:36
315099d7785bba4d3a99c8e0636d2fcd18360192...f9ad3686bbedea0ca2adf3bc4ab19c3e90e8800a,1,3,0,3,1,2014-03-23 14:02:58,2014-03-23 13:39:38
f9ad3686bbedea0ca2adf3bc4ab19c3e90e8800a...04c2d293985adced1bd702fca16357b858002bb8,1,3,0,3,1,2014-03-23 14:03:16,2014-03-23 13:45:55
04c2d293985adced1bd702fca16357b858002bb8...6889dfaa46858ddacc82549a57d73118c66a32b6,1,1,1,2,1,2014-03-23 14:03:36,2014-03-23 13:47:10
e30a1243dc89814e9f31e4b4cc284d948ecbfbd8...9b37fcba5e350d049d4bbf145672cecd37356c23,4,71,78,149,13,2013-11-19 16:14:52,2013-11-19 16:05:48
9b37fcba5e350d049d4bbf145672cecd37356c23...1493d88e3f92c7034da5c1b1638ba19544aa3ccb,2,8,0,8,2,2013-12-01 14:31:48,2013-12-01 14:31:48
e30a1243dc89814e9f31e4b4cc284d948ecbfbd8...c6dce05fabd31c018cd77197329a6d5212e56787,1,1,0,1,1,2013-11-13 00:55:28,2013-11-13 00:55:28
e30a1243dc89814e9f31e4b4cc284d948ecbfbd8...4e7b0fe083ecc99c1ea8c250d8b9cfcde09f2cd3,1,3,3,6,3,2013-11-12 19:05:19,2013-11-12 19:05:19
e30a1243dc89814e9f31e4b4cc284d948ecbfbd8...bb2064e92bdb2f64dfeb148bc0b9a61dfeff8f43,1,1,1,2,1,2013-11-12 07:55:16,2013-11-12 07:55:16
e30a1243dc89814e9f31e4b4cc284d948ecbfbd8...27f9747143e421e6908e9c2d0eb6247df4a3af8c,1,25,23,48,2,2013-11-12 07:01:13,2013-11-12 07:01:13
e30a1243dc89814e9f31e4b4cc284d948ecbfbd8...96798c42f046fec7f01f53d10dd63f30ed6a1e07,1,7,5,12,3,2013-11-11 18:09:33,2013-11-11 18:09:33
e30a1243dc89814e9f31e4b4cc284d948ecbfbd8...009b906111ba0c71d3b2a5c6dd7a8f68ce3f521f,1,1,1,2,1,2013-11-09 15:02:38,2013-11-09 15:02:38
e30a1243dc89814e9f31e4b4cc284d948ecbfbd8...5c73cb671bde7a151a7a36fe782ce44dba1b0531,1,9,0,9,1,2013-11-08 19:26:05,2013-11-08 19:26:05
5c73cb671bde7a151a7a36fe782ce44dba1b0531...d34ab7f3732b49fd624c80e950aae3f166800a24,1,113,0,113,1,2013-11-08 19:26:25,2013-11-08 19:26:25
e30a1243dc89814e9f31e4b4cc284d948ecbfbd8...efc37c1f715eb77be5f30411fa36589727643126,1,10,0,10,1,2013-11-06 22:10:59,2013-11-06 22:10:59
efc37c1f715eb77be5f30411fa36589727643126...248890b6e699365dee469178ec96f5d1fad91871,1,0,10,10,1,2013-11-06 22:16:09,2013-11-06 22:16:09
e30a1243dc89814e9f31e4b4cc284d948ecbfbd8...8cfc7d66774e12c8502b63ed0c48f3a216c33acf,1,10,0,10,1,2013-11-05 02:00:11,2013-11-05 02:00:11
9f5a895192b7d6b75ba717ef4e2c9b6ed7977c68...ec779d5f737f0f70a7353bb0e78dc2d38606c8d9,1,1,1,2,1,2013-11-23 14:32:22,2013-11-23 14:32:22
9f5a895192b7d6b75ba717ef4e2c9b6ed7977c68...d12113a9e89fed866db625f7e110fb62333b2746,1,1,1,2,1,2013-11-22 13:59:04,2013-11-22 13:59:04
9f5a895192b7d6b75ba717ef4e2c9b6ed7977c68...b5b3519ac7c163b62bfc01a42a87a7a745d9df6d,1,4,2,6,1,2013-11-22 08:48:51,2013-11-22 08:48:51
9f5a895192b7d6b75ba717ef4e2c9b6ed7977c68...7c56364dc4a432a0ef2972ea1a6043e6154499df,1,1,1,2,1,2013-11-21 23:34:33,2013-11-21 23:34:33
9f5a895192b7d6b75ba717ef4e2c9b6ed7977c68...4d3fb286d84846b2c64368c38dd8b728da466eac,1,3,3,6,2,2013-11-21 16:58:57,2013-11-21 16:58:57
9f5a895192b7d6b75ba717ef4e2c9b6ed7977c68...fbd479b68e2c58068666f738a009ef7a1ca8abde,1,5,3,8,1,2013-11-20 17:30:55,2013-11-20 17:30:55
9f5a895192b7d6b75ba717ef4e2c9b6ed7977c68...613d116cda381b9747e22d13ed1381cec26eb8e3,1,31,0,31,1,2013-11-19 08:12:05,2013-11-19 08:12:05
9f5a895192b7d6b75ba717ef4e2c9b6ed7977c68...037b39a8172b8a268ca5c857e5badee047b32929,1,99,0,99,1,2013-11-16 23:40:55,2013-11-16 23:39:01
9f5a895192b7d6b75ba717ef4e2c9b6ed7977c68...81192343568b924c901e260f7b6beda887e43fff,1,5,10,15,4,2013-11-16 19:59:15,2013-11-16 19:59:15
357ab4912b98e5ffc14dd62a53b988053d7f9a6e...288604ef1a19c5808eff439acf32330fda126f93,1,80,0,80,1,2014-01-03 13:32:49,2014-01-03 13:32:49
357ab4912b98e5ffc14dd62a53b988053d7f9a6e...152e1e07e0397ecc3f1778ea597d081c33ee8ff4,1,7,0,7,1,2013-12-18 17:27:20,2013-12-18 17:27:20
357ab4912b98e5ffc14dd62a53b988053d7f9a6e...dbdd23d0fa1309444d01d7540a0f3065d514e741,1,1,1,2,1,2013-12-13 22:05:35,2013-12-13 22:05:35
357ab4912b98e5ffc14dd62a53b988053d7f9a6e...fdfc90705242841d7491bb945c35a3601d1c8996,1,1,0,1,1,2013-12-11 09:42:11,2013-12-06 10:20:38
357ab4912b98e5ffc14dd62a53b988053d7f9a6e...cbd63f220dff93ad6c9d00734949106443a5b03b,1,6,1,7,1,2013-12-09 19:38:27,2013-12-09 19:38:27
cbd63f220dff93ad6c9d00734949106443a5b03b...c05a28a7d9c5ca86b66b0fdf2f509e07b2a7b616,1,1,1,2,1,2013-12-10 00:11:22,2013-12-10 00:11:22
357ab4912b98e5ffc14dd62a53b988053d7f9a6e...0185d9920b7d6c380277a4a15c9e4818df41700a,3,103,0,103,2,2013-12-09 07:54:38,2013-12-09 07:54:38
0185d9920b7d6c380277a4a15c9e4818df41700a...349fa15b187a1b2c411db90f2022013caf3479e8,2,3,2,5,3,2013-12-09 21:07:19,2013-12-09 21:07:19
349fa15b187a1b2c411db90f2022013caf3479e8...44b23ae194a1580a6af6d692e4ba268d61828929,2,2,2,4,2,2013-12-09 21:18:20,2013-12-09 21:18:20
44b23ae194a1580a6af6d692e4ba268d61828929...8309b0a19baa351d643194f897d59de7b3d3b3dd,1,7,6,13,2,2014-02-23 09:07:26,2014-02-23 09:07:26
357ab4912b98e5ffc14dd62a53b988053d7f9a6e...be6b1b3b8fda01bebc499e02b6945eaddaf45b84,1,5,5,10,3,2013-12-08 05:11:33,2013-12-08 05:11:33
be6b1b3b8fda01bebc499e02b6945eaddaf45b84...e97811913b9349349e35853a8c2fe3e93cabacd9,1,0,1,1,1,2013-12-08 05:16:40,2013-12-08 05:16:40
357ab4912b98e5ffc14dd62a53b988053d7f9a6e...9b811fb625c03c30a766191cdf65a1c7c1fd96b2,1,1,1,2,1,2013-12-06 22:31:35,2013-12-06 22:31:35
178bce287ea26e5052091e66415521703848d5da...6c5e63022d9f8c0c9a930b0110da3a4b8fee6cf0,1,1,0,1,1,2012-12-05 08:13:53,2012-12-05 08:13:53
178bce287ea26e5052091e66415521703848d5da...f7fc164377f3f5243c9aade09e4d17efc60ffc47,1,1,0,1,1,2012-12-05 02:51:42,2012-12-05 02:51:42
51e05b7579a26266a0ed26398ab9eb5071800cd8...1b91c84d2b49f00b64e5b6048678c5d4f26cd971,1,4,4,8,4,2012-12-06 13:09:09,2012-12-06 13:09:09
51e05b7579a26266a0ed26398ab9eb5071800cd8...98bd19a036c0c702591f456e1081e420ffb17ce0,1,1,0,1,1,2012-12-03 10:13:13,2012-12-03 10:06:31
51e05b7579a26266a0ed26398ab9eb5071800cd8...e096e4041f76c70a621df2b02bb67bed88e6bcee,1,2,1,3,1,2012-12-03 10:03:43,2012-12-03 10:03:43
e096e4041f76c70a621df2b02bb67bed88e6bcee...8925cff334f9009a0f27d38922731bbcd82c42cb,1,1,1,2,1,2012-12-03 10:29:45,2012-12-03 10:29:45
51e05b7579a26266a0ed26398ab9eb5071800cd8...80f151e56d7d6d30858acf581141fa84bfd79bc7,1,29,2,31,2,2012-12-03 06:06:11,2012-12-03 06:06:11
51e05b7579a26266a0ed26398ab9eb5071800cd8...39e5c9a6d7a88feb570f340ca52e87c8ff8cce61,1,25,9,34,4,2012-12-03 05:59:05,2012-12-03 05:59:05
51e05b7579a26266a0ed26398ab9eb5071800cd8...b9d5a39098036f4f62b1e88b8c2c045a35582546,1,2,2,4,2,2012-12-02 21:40:40,2012-12-02 21:32:29
6e6cf4303712befb5a7fc3918494aefe4a65991f...3d81ecfb43d0da18a3b89b5aa12a78c1ad91f063,1,16,9,25,5,2013-02-09 07:00:49,2013-02-09 07:00:41
6e6cf4303712befb5a7fc3918494aefe4a65991f...dace87ae361722c0332c18e5470ca10f16720f7f,1,5,5,10,1,2013-02-09 02:11:40,2013-02-09 02:11:40
e4891c58918c85d6e1a4e7ca069667014ac99378...dd6247057ea9b8e238aea5e16446dee089f11f3e,1,2,5,7,2,2013-04-24 03:52:18,2013-04-24 03:52:18
5eb3ec6428809fcf02d724f913201abbd04a88a6...5128669a76a744883ad51df7682577e6654418e1,1,2,3,5,2,2013-03-26 08:57:11,2013-03-26 08:57:11
caa15548c107b9c31f61a67547ffab0b0cfe4934...dee54a2477d2a5be5d6cced7497f539ecfc2e05f,1,1,1,2,1,2012-06-13 19:57:15,2012-06-13 19:57:15
dee54a2477d2a5be5d6cced7497f539ecfc2e05f...4d6b532248fce0e71d762eb1ec3ef2ec8fcd5289,1,1,1,2,1,2012-06-13 20:14:31,2012-06-13 20:14:31
caa15548c107b9c31f61a67547ffab0b0cfe4934...37bce2b51a528c6be5dc4605c81aab70c949a3a3,1,1,1,2,1,2012-06-12 12:48:00,2012-06-12 12:48:00
caa15548c107b9c31f61a67547ffab0b0cfe4934...1bb715965c1dde1ed6f4456b462ae59e1b3769da,2,2,2,4,2,2012-06-12 08:18:02,2012-06-12 08:18:02
caa15548c107b9c31f61a67547ffab0b0cfe4934...61ceec528533bdc2865cf3d04a9214dda6f0f173,1,47,0,47,1,2012-06-09 01:04:58,2012-06-09 01:04:58
caa15548c107b9c31f61a67547ffab0b0cfe4934...083cff4a577f8889db4ec201d2309b126a65e894,1,1,0,1,1,2012-06-08 16:18:26,2012-06-08 16:18:26
caa15548c107b9c31f61a67547ffab0b0cfe4934...ce4431a160350e4d2d384251a9471cfed493b834,1,1,1,2,1,2012-06-04 08:50:42,2012-06-04 08:50:42
caa15548c107b9c31f61a67547ffab0b0cfe4934...df30eae4121802f8ac800cb3e92c7d08356217a6,1,4,0,4,2,2012-06-03 17:44:14,2012-06-03 17:44:14
caa15548c107b9c31f61a67547ffab0b0cfe4934...a04484e546e330a9cd2130ee160a53ec4580a844,1,1,0,1,1,2012-06-01 23:11:53,2012-06-01 23:11:53
caa15548c107b9c31f61a67547ffab0b0cfe4934...c4608ba281147af564fc0979b63bc8b23f1e55fb,1,1,1,2,1,2012-06-01 14:26:22,2012-06-01 14:26:22
0370de582bf25a83a3391113d2c6a854b08a8eb1...92b6cae02638f644e6359e3f553805e2c3eba957,1,1,1,2,1,2012-07-09 06:34:27,2012-07-09 06:34:27
92b6cae02638f644e6359e3f553805e2c3eba957...a15bcd6461b5b8237844c4e2968df0518dab5e9a,1,1,1,2,1,2012-07-09 07:11:07,2012-07-09 07:11:07
6d7a275972918bf535e80a688914ba8f39f65110...b9a989fea5f0462b3ced71a33abd3cec3e7809cb,1,4,1,5,2,2012-12-07 09:25:02,2012-12-07 09:07:45
6d7a275972918bf535e80a688914ba8f39f65110...f3fea45dd2c8208cd951e813b82453d38aea3539,1,1,1,2,1,2012-12-07 00:30:15,2012-12-07 00:28:41
3ad138a08aa3de1246cffde0b7187ffcd017298c...2fa02621b27fbb3b788ee8576717fa64b2cb0065,1,285,0,285,1,2012-10-14 14:07:38,2012-10-14 14:07:38
11034217a7ea3cffe6e0fe631837c518b8c7e1a5...1c23a52f5744ef419e83733d18a6a698ddd14d1e,1,3,2,5,2,2012-07-20 22:07:51,2012-07-20 22:07:51
11034217a7ea3cffe6e0fe631837c518b8c7e1a5...0b757825a2c23af6fcf17f540cbfacd390321fa8,1,265,0,265,1,2012-07-19 10:50:53,2012-07-19 10:50:53
0b757825a2c23af6fcf17f540cbfacd390321fa8...46b88b6a5a48f555c89a02d30e039758f4e3bfe7,1,20,0,20,1,2012-07-19 11:01:32,2012-07-19 11:01:32
46b88b6a5a48f555c89a02d30e039758f4e3bfe7...1e1e0fa44d8e97567f7a3ecd7f922c7ecca6e76f,1,1,1,2,1,2012-07-20 14:46:30,2012-07-20 14:46:30
11034217a7ea3cffe6e0fe631837c518b8c7e1a5...3fea7c3b278ccf73421cbdcc61a1c1dd6d4a0a70,1,120,0,120,1,2012-07-19 10:03:18,2011-11-06 12:07:16
11034217a7ea3cffe6e0fe631837c518b8c7e1a5...98ecfa4c7769226432075edec8f2f3de275a81ff,1,13,0,13,1,2012-07-19 10:02:57,2011-11-06 12:24:33
11034217a7ea3cffe6e0fe631837c518b8c7e1a5...bb34abd5186c0d87126b13af8643614d0aa50367,1,5,1,6,1,2012-07-18 10:07:16,2012-07-18 10:07:16
11034217a7ea3cffe6e0fe631837c518b8c7e1a5...6a2e04fefbd794f050d45e7a717d009e39204431,1,14,3,17,5,2012-07-15 23:59:30,2012-07-15 23:59:30
6a2e04fefbd794f050d45e7a717d009e39204431...d5bfbf05d16634fa3c2834c7097edb1cf2487d96,1,7,10,17,9,2012-07-24 02:36:18,2012-07-24 02:36:18
d5bfbf05d16634fa3c2834c7097edb1cf2487d96...decb9c82b5392d66e157ceef9c3b41466bdcbafd,1,0,1,1,1,2012-07-24 11:16:03,2012-07-24 11:16:03
11034217a7ea3cffe6e0fe631837c518b8c7e1a5...87ab8771dac655272895e5904fcf93217ea4a64b,1,1,1,2,1,2012-07-15 19:26:30,2012-07-15 19:26:30
11034217a7ea3cffe6e0fe631837c518b8c7e1a5...5001412f6d127d8360ea8e0d775e7184aae2091d,1,1,1,2,1,2012-07-12 11:19:10,2012-07-12 11:19:10
11034217a7ea3cffe6e0fe631837c518b8c7e1a5...0b2da8f11b2e84a73f3fbe019a086da28ae6d2a3,1,9,0,9,1,2012-07-12 03:40:12,2012-07-12 03:40:12
3ac3141cd610de995b2435011ac895ad15b89e2e...a39c9ffe5b7236b6e4dc78efa80b478cc411af7f,1,2,5,7,2,2012-06-23 11:58:04,2012-06-23 11:53:40
3ac3141cd610de995b2435011ac895ad15b89e2e...5e9a16b88a5cffe015101f992e29fa0d50027f5d,1,24,0,24,1,2012-06-22 17:43:39,2012-06-22 17:25:44
5e9a16b88a5cffe015101f992e29fa0d50027f5d...f7b1615b7cd6cd2088050a29f43650098eaba514,1,3,0,3,1,2012-06-22 17:43:39,2012-06-22 17:42:59
3ac3141cd610de995b2435011ac895ad15b89e2e...3aa0cb74d0a19a8053889a976404a7915585466e,1,3,0,3,1,2012-06-22 17:27:21,2012-06-22 17:27:21
3aa0cb74d0a19a8053889a976404a7915585466e...5c37c85fb49a377b59115efc2aa132665982ac06,1,1,0,1,1,2012-06-22 17:33:11,2012-06-22 17:33:11
7a7eda1287a6862e8d7d14a0dbd47018a787ad14...6f48f586ba55507bb90fa8dd078b01c0333b907d,2,210,0,210,2,2013-11-16 01:15:17,2013-11-16 01:15:17
7a7eda1287a6862e8d7d14a0dbd47018a787ad14...1f334ba66053038bfd5236ffa8e1000c5adf1b44,1,61,7,68,1,2013-11-15 01:36:15,2013-11-15 01:36:15
7a7eda1287a6862e8d7d14a0dbd47018a787ad14...3930a63253c08eafb5baf73508031932e0ed7437,1,32,32,64,1,2013-11-15 00:17:23,2013-11-15 00:17:23
7a7eda1287a6862e8d7d14a0dbd47018a787ad14...51b273a66f0b99202e79807c0651e2afd2399d1b,1,18,0,18,1,2013-11-15 00:04:38,2013-11-15 00:04:38
7a7eda1287a6862e8d7d14a0dbd47018a787ad14...ae6b26327a01211e7109c00c36650db05be75a55,1,14,0,14,1,2013-11-14 16:31:24,2013-11-14 16:30:21
ae6b26327a01211e7109c00c36650db05be75a55...dcf7c7cce0c4824a728de9ed0cabdfa073829e8d,1,10,0,10,1,2013-11-14 16:36:20,2013-11-14 16:36:20
7a7eda1287a6862e8d7d14a0dbd47018a787ad14...a7540844d5142d0ab3fae38b660c690859435bb5,1,4,0,4,1,2013-11-14 12:06:54,2013-11-14 12:06:54
66a33b80c3c5c768bab0fd4bbed37851fcc01675...c9f2c947e4bdc94676aeaf989ba16dbe35aa45ee,1,8,3,11,2,2013-11-29 13:25:46,2013-11-29 13:24:14
66a33b80c3c5c768bab0fd4bbed37851fcc01675...699c82eb89094e3c2ca81dfd96b44d155bca6fba,1,2,0,2,1,2013-11-29 10:34:12,2013-11-29 10:34:12
66a33b80c3c5c768bab0fd4bbed37851fcc01675...3d851daf456f4ba418fb00eccb20ea2f4f7dd4b5,1,21,0,21,1,2013-11-29 06:58:52,2013-11-29 06:58:52
288604ef1a19c5808eff439acf32330fda126f93...6a8f83bc5044f55e7386182683e853e6e7d2eebf,1,4,0,4,4,2014-03-21 18:02:26,2014-03-21 18:02:26
c9e5adb637c0220a471c2ec4f0fb0f4195fcfb35...a38af27991d15d14ac4ca55c919bb694d7eafb7a,1,0,7,7,1,2013-12-19 01:03:33,2013-12-19 01:03:33
a811ab0ba7f6915cce376ec6b2a7180ee1d04d5f...5bd590ceb30ca58d96ec8d5dcfc1fec71bc6ca1f,1,8,8,16,5,2014-03-08 21:13:52,2014-03-08 21:13:52
5bd590ceb30ca58d96ec8d5dcfc1fec71bc6ca1f...2e11e2ab5adaea762b7f2eaa6c63332a9618bb3f,1,3,0,3,1,2014-03-08 21:16:46,2014-03-08 21:15:18
2e11e2ab5adaea762b7f2eaa6c63332a9618bb3f...da1fa3b06a6369a5b3337025da164eeec275db70,1,2,0,2,1,2014-03-08 21:17:16,2014-03-08 21:17:16
da1fa3b06a6369a5b3337025da164eeec275db70...9f66d5b797ab73a54d944a7bd43d920a508625ea,1,13,2,15,4,2014-03-08 21:50:12,2012-04-23 21:01:14
397c085a19a22f6be515665835d09a2505cb3f23...c5ecb4e13691404a4555dbf6fa72fe411d463ad9,1,0,2,2,1,2012-12-31 13:25:07,2012-12-31 13:25:07
397c085a19a22f6be515665835d09a2505cb3f23...fa355a798c165fab65462238162c258394b1c7a0,1,8,1,9,1,2012-12-31 12:02:22,2012-12-31 12:02:22
fa355a798c165fab65462238162c258394b1c7a0...e5736d39103c59b115270dcf91d31419d3f08130,1,5,6,11,2,2013-01-03 12:44:17,2013-01-03 12:44:17
397c085a19a22f6be515665835d09a2505cb3f23...1f4bb8deb7bf166a43ed690b0961ab5a0b84523d,1,1,1,2,1,2012-12-30 08:52:32,2012-12-30 08:52:32
397c085a19a22f6be515665835d09a2505cb3f23...d0842b431e9ebae66ae9373e9e5614341c6f5803,1,1,1,2,1,2012-12-28 19:37:48,2012-12-28 19:37:48
d0842b431e9ebae66ae9373e9e5614341c6f5803...021e6de3237402aabd7e8bc0b99726a5149c33ef,1,8,0,8,1,2012-12-28 20:04:15,2012-12-28 20:04:15
397c085a19a22f6be515665835d09a2505cb3f23...dde4a8b6a3aaa69feb3243bb374a0af07fb5d033,1,1,1,2,1,2012-12-28 11:28:47,2012-12-28 11:28:47
397c085a19a22f6be515665835d09a2505cb3f23...e7f24a831990f7dc87b7931aac2a3c2cd6b6c7e8,1,1,0,1,1,2012-12-24 18:43:45,2012-12-24 18:43:45
397c085a19a22f6be515665835d09a2505cb3f23...a09cd713b4297b6720dc7c444cdcdbd8d3b9fb1a,1,1,0,1,1,2012-12-24 09:27:23,2012-12-24 09:27:23
397c085a19a22f6be515665835d09a2505cb3f23...e4624c6a36a48dbae2d16241ee39ee14ce003f9f,1,1,1,2,1,2012-12-21 16:45:57,2012-12-21 16:33:23
397c085a19a22f6be515665835d09a2505cb3f23...fdb3c0e68d36d20d1b75163755d568d42def5ac1,1,2,0,2,2,2012-12-19 15:22:03,2012-12-19 15:22:03
397c085a19a22f6be515665835d09a2505cb3f23...46ad7338333b57ce5966ca481d132d8626304d83,1,9,0,9,1,2012-12-18 08:16:28,2012-12-18 08:16:28
46ad7338333b57ce5966ca481d132d8626304d83...c95b6d91f7e45ac4ca9a1ce2207db7d515ba450b,1,4,1,5,2,2012-12-18 08:47:04,2012-12-18 08:47:04
397c085a19a22f6be515665835d09a2505cb3f23...55f09f89c8602efa6545411448e377aa87f64e7b,1,2,1,3,2,2012-12-13 17:09:28,2012-12-13 17:09:28
55f09f89c8602efa6545411448e377aa87f64e7b...6ce08acb27f14a2e73fdbd4c92f258a7e6899f64,1,59,45,104,9,2012-12-30 19:18:12,2012-12-30 19:18:12
b6ea876971b2270a2c73a07a6f6a337604132c6f...f28e16a15856baf92163dba8ac6eec1e02cf6c1f,1,6,1,7,1,2013-04-30 05:04:09,2013-04-30 04:51:09
b6ea876971b2270a2c73a07a6f6a337604132c6f...39b46f526c83a5d4704bd25eff03c7678230ec78,1,0,4,4,3,2013-04-29 07:51:21,2013-04-29 07:51:21
b6ea876971b2270a2c73a07a6f6a337604132c6f...17a092b0ffa1ecf4ef9f727054a414e26f9e1edd,1,3,2,5,3,2013-04-29 07:19:31,2013-04-29 07:19:31
b6ea876971b2270a2c73a07a6f6a337604132c6f...f77a545a4bfe07e0fd097a21ad8c1e80ff3d65f9,1,1,1,2,1,2013-04-28 14:34:36,2013-04-28 14:34:36
b6ea876971b2270a2c73a07a6f6a337604132c6f...2f7479b5cb58ebd006f4a7a023a86cad0da2ce0d,1,1,1,2,1,2013-04-26 04:31:02,2013-04-26 04:31:02
b6ea876971b2270a2c73a07a6f6a337604132c6f...bf9645224b529be0e03655b4cef9c32f66c76015,1,35,3,38,2,2013-04-24 06:33:02,2013-04-24 06:33:02
b51c2a0d0b0af68d4b2b70b922f7d56a14a23dcc...095a01d92adf6af6d33647b61718e4ad0a4cce2b,1,14,0,14,1,2013-09-18 19:54:23,2013-09-18 19:54:23
095a01d92adf6af6d33647b61718e4ad0a4cce2b...4dbe4378db658d29c10841791a95b8c57e7c77e5,1,2,2,4,2,2013-09-18 19:56:10,2013-09-18 19:56:10
b51c2a0d0b0af68d4b2b70b922f7d56a14a23dcc...91b6a6b5a496d7e7f3702040401cd99fd609514d,1,7,1,8,1,2013-09-18 15:13:12,2013-09-18 11:37:36
b51c2a0d0b0af68d4b2b70b922f7d56a14a23dcc...dfe36d7b7b6d70e5179f57afadfd923a36b3ff5a,1,1,1,2,1,2013-09-18 15:09:15,2013-09-18 15:09:15
b51c2a0d0b0af68d4b2b70b922f7d56a14a23dcc...a7c88c988a4be02b8883c06e57c6eb290c8fcb21,1,1,1,2,1,2013-09-15 21:16:11,2013-09-15 21:16:11
a7c88c988a4be02b8883c06e57c6eb290c8fcb21...9c11202fde61bf3db6755f4083c320d710fe3bd5,1,1,1,2,1,2014-06-13 18:28:37,2014-06-13 18:28:37
b51c2a0d0b0af68d4b2b70b922f7d56a14a23dcc...9d2b5c841e251840d7965163f4eb9797bc0db49f,1,1,1,2,1,2013-09-14 18:26:33,2013-09-14 18:26:33
fce68bbba0be99cfd49f9e46572b2d12d0a86d45...c2d42f5a90f12ca925702ed4e8fc5563baf8397c,1,43,0,43,1,2013-03-05 21:50:27,2013-03-05 21:50:27
c2d42f5a90f12ca925702ed4e8fc5563baf8397c...0b6e7358850f7fd74556289b1e0c1634896ed66b,1,1,0,1,1,2013-03-05 22:01:00,2013-03-05 22:01:00
fce68bbba0be99cfd49f9e46572b2d12d0a86d45...fdd46d8815f9c3a314e13d2dbb57685fd78f4e7c,1,20,13,33,3,2013-03-02 11:09:57,2013-03-02 11:09:57
fce68bbba0be99cfd49f9e46572b2d12d0a86d45...20fe5e6a570fa5d9dfd246d020ecc2c18427405f,1,1,1,2,1,2013-03-01 17:33:38,2013-03-01 17:33:38
fce68bbba0be99cfd49f9e46572b2d12d0a86d45...0744acd663216b8e1c0c75878c166d53684d75bc,3,206,149,355,4,2013-02-28 15:28:08,2013-02-28 15:28:08
0744acd663216b8e1c0c75878c166d53684d75bc...ac6f1a045c5511cda60167ab978cf127c370d955,1,21,21,42,9,2013-03-13 17:07:32,2013-03-13 17:07:32
fce68bbba0be99cfd49f9e46572b2d12d0a86d45...4bb7b698cabd33bd53f89688e83cf836e4c3f50c,1,2,1,3,2,2013-02-28 10:50:39,2013-02-28 10:50:39
fce68bbba0be99cfd49f9e46572b2d12d0a86d45...f4b12321a9e4d5e0fa208b48a4515156865a33bb,1,29,0,29,1,2013-02-27 20:26:03,2013-02-27 20:26:03
f4b12321a9e4d5e0fa208b48a4515156865a33bb...8cd1b21b931c0f7a310fc32c43dd3288203ecd40,1,2,1,3,2,2013-04-23 21:40:09,2013-04-23 21:40:09
fce68bbba0be99cfd49f9e46572b2d12d0a86d45...b979400cff17248147d95f6271edb6f2d6e36c84,1,12,0,12,1,2013-02-27 03:29:26,2013-02-26 19:05:22
b979400cff17248147d95f6271edb6f2d6e36c84...26ee66f179be08fab59d41a0522ad51610125c6c,1,33,4,37,5,2013-02-27 03:29:26,2013-02-26 22:50:15
26ee66f179be08fab59d41a0522ad51610125c6c...3aef6793c2bf0c0afec1fdb97a3a56e7f8d065c6,1,8,0,8,1,2013-02-27 03:29:26,2013-02-26 23:05:58
3aef6793c2bf0c0afec1fdb97a3a56e7f8d065c6...778ae57772a02d11c393708c4c0644fbd1ffac35,1,6,1,7,1,2013-02-27 03:29:26,2013-02-26 23:07:25
778ae57772a02d11c393708c4c0644fbd1ffac35...0cf871d51299a4f837e6dce4d4ae827b0c09f5bd,1,3,0,3,3,2013-02-27 03:29:26,2013-02-26 23:08:37
0cf871d51299a4f837e6dce4d4ae827b0c09f5bd...45a4db33f81c5dbdcafa25cfe5a75490d55ec185,1,5,0,5,1,2013-02-27 03:29:26,2013-02-26 23:09:01
45a4db33f81c5dbdcafa25cfe5a75490d55ec185...bf40d4e354ce33c0d9f42cc64372461bff14cde8,2,3,0,3,2,2013-02-27 03:29:26,2013-02-26 23:09:17
bf40d4e354ce33c0d9f42cc64372461bff14cde8...7b15627851983e63a5756f0b3633938c44ed7a7d,1,14,13,27,13,2013-02-27 03:29:26,2013-02-27 02:47:11
7b15627851983e63a5756f0b3633938c44ed7a7d...43c50f03e3c547ec51feef7ae3c99f734a66e6a6,1,8,11,19,4,2013-02-27 03:29:26,2013-02-27 02:52:26
43c50f03e3c547ec51feef7ae3c99f734a66e6a6...f096644c751cb7fe566e82de531435a405d76be8,1,1,1,2,1,2013-02-27 03:29:26,2013-02-27 03:03:22
f096644c751cb7fe566e82de531435a405d76be8...691630a89586c86dfafa32974c5c6dbaa1356c07,1,12,1,13,5,2013-02-27 03:29:26,2013-02-27 03:18:36
691630a89586c86dfafa32974c5c6dbaa1356c07...56c46c4ed8339c66c671927c197eb4511b5a664c,1,1,1,2,1,2013-02-27 03:55:18,2013-02-27 03:55:18
56c46c4ed8339c66c671927c197eb4511b5a664c...86c9b32031dc28b4c6a641a4475e0e55c7ff32e5,1,3,0,3,1,2013-02-27 03:57:37,2013-02-27 03:57:37
86c9b32031dc28b4c6a641a4475e0e55c7ff32e5...4e8681c6e19f77a9b54ceee5934e3356e4ffb207,1,10,2,12,3,2013-02-27 04:37:53,2013-02-27 04:35:45
4e8681c6e19f77a9b54ceee5934e3356e4ffb207...f0a920df5a4a5e5260ef45daf27d42a15cd75217,1,74,68,142,14,2013-02-27 15:21:19,2013-02-27 15:21:19
f0a920df5a4a5e5260ef45daf27d42a15cd75217...a91872df35d15f0544339ae9c61f87e761c19827,1,4,4,8,4,2013-03-26 19:41:34,2013-03-26 19:41:34
a91872df35d15f0544339ae9c61f87e761c19827...19ae0b576c4fd0c0c4af1a5c491df867fdce39a4,1,4,7,11,5,2013-03-26 19:42:05,2013-03-26 19:42:05
fce68bbba0be99cfd49f9e46572b2d12d0a86d45...8c74d80fd6cdc7e1b48e7eb321a3e3a22674c3be,1,1,1,2,1,2013-02-22 16:07:15,2013-02-22 16:07:15
fce68bbba0be99cfd49f9e46572b2d12d0a86d45...014ed1f0e5c85a10ab7538160e2d3421ab3dbf7e,1,20,15,35,5,2013-02-21 01:46:20,2013-02-21 01:46:20
014ed1f0e5c85a10ab7538160e2d3421ab3dbf7e...174e09ca8dec0e2c393718505e9fc0cfc0996e21,1,4,5,9,3,2013-02-21 02:40:32,2013-02-21 02:40:32
fce68bbba0be99cfd49f9e46572b2d12d0a86d45...3db22634a1dfe6797b2dafabce82b27f101c8e6b,1,1,1,2,1,2013-02-19 18:00:58,2013-01-22 17:02:21
fce68bbba0be99cfd49f9e46572b2d12d0a86d45...2264c51355542df082c72468eea2dfa5a8e54ada,1,1,1,2,1,2013-02-15 16:57:36,2013-02-15 16:57:36
fce68bbba0be99cfd49f9e46572b2d12d0a86d45...fb3dc24ff4aac55c5cb0cd4e448b26f223a68957,1,1,1,2,1,2013-02-14 08:37:58,2013-02-14 08:36:42
fce68bbba0be99cfd49f9e46572b2d12d0a86d45...ccdc5518f00ba3b4f35cb05a0daeb4ab4efd2268,1,13,1,14,2,2013-02-14 08:18:12,2013-02-14 08:18:12
fce68bbba0be99cfd49f9e46572b2d12d0a86d45...9674a96b5bc296a767c2560757626bf2bc3a9ad3,1,12,2,14,3,2013-02-13 11:02:36,2013-02-13 11:02:36
9674a96b5bc296a767c2560757626bf2bc3a9ad3...df67f2ee30dbad61117e1886b0a4de326cb6daf7,1,1,1,2,1,2013-02-13 12:39:47,2013-02-13 12:39:47
df67f2ee30dbad61117e1886b0a4de326cb6daf7...bce74975d055529cbd186782e2fd99e6da840460,1,2,5,7,1,2014-05-28 11:57:25,2014-05-28 11:57:25
fce68bbba0be99cfd49f9e46572b2d12d0a86d45...06d5cb93ab043a244e98630fdd7b7378210c9b6f,1,6,0,6,1,2013-02-11 03:33:24,2013-02-11 03:33:24
d05b2010ffd4cd33ff9402c402051b1caf985d97...fe4c2379c4ce9f4140fd16d2ea77138061e4a109,1,9,8,17,2,2013-02-04 21:21:34,2013-02-04 21:21:34
d05b2010ffd4cd33ff9402c402051b1caf985d97...fbf82ae62fe03f69af0114011c0d6848a83d4fb3,3,169,0,169,3,2012-09-01 15:12:53,2012-09-01 15:11:47
d05b2010ffd4cd33ff9402c402051b1caf985d97...28d3b80db1d5d976a809bc01da191be5b1768fcb,1,2,0,2,1,2012-08-30 14:25:36,2012-08-30 14:25:36
d05b2010ffd4cd33ff9402c402051b1caf985d97...6f92745761afc000b54bd782c7f3bcc0733302f7,1,1,1,2,1,2012-08-25 06:51:58,2012-08-25 06:51:58
6f92745761afc000b54bd782c7f3bcc0733302f7...d5e5b7ee5adaf74afa96cae00260c50581d8f46f,1,35,41,76,5,2012-08-25 07:27:05,2012-08-25 07:26:00
d05b2010ffd4cd33ff9402c402051b1caf985d97...f995218d081ac66b86d40a0141db5d445147b50d,1,1,0,1,1,2012-08-19 16:04:52,2012-08-10 15:01:55
d05b2010ffd4cd33ff9402c402051b1caf985d97...b2c1af91d3e70ea442ae5353cf7f140d89491c73,2,43,0,43,2,2012-08-19 13:03:23,2012-08-19 13:03:23
d05b2010ffd4cd33ff9402c402051b1caf985d97...d3f6507a2e432efe48a3b8ac8f45c32e7d2ab656,1,2,2,4,2,2012-08-17 16:13:09,2012-08-17 15:58:35
d05b2010ffd4cd33ff9402c402051b1caf985d97...76f2429e8ec30afacd3a913018c8c573962e214c,1,7,0,7,1,2012-08-14 15:23:11,2012-08-14 15:23:11
d05b2010ffd4cd33ff9402c402051b1caf985d97...36b42017aeda6629d487c080ff6b5c7d3650687d,1,44,0,44,1,2012-08-12 07:20:57,2012-08-12 07:13:02
d05b2010ffd4cd33ff9402c402051b1caf985d97...9172b3a89fb77f79043d185d247a501b3b93fa6f,1,2,2,4,2,2012-08-05 19:51:11,2012-08-05 19:51:11
d05b2010ffd4cd33ff9402c402051b1caf985d97...9af7f862999c458525d1a5c0f2470757ffe2f1dc,1,1,1,2,1,2012-08-01 21:58:09,2012-08-01 21:58:09
d05b2010ffd4cd33ff9402c402051b1caf985d97...027fcccc9256aaf63e0d1b812069a1a0880f46fa,2,6,4,10,3,2012-07-31 17:27:40,2012-07-31 17:27:40
d05b2010ffd4cd33ff9402c402051b1caf985d97...a3c2a2f6e8ff9db508070a905de056346386ef4f,1,10,1,11,2,2012-07-29 18:18:26,2012-07-29 18:18:26
d05b2010ffd4cd33ff9402c402051b1caf985d97...aaf705c5faf3ebe27604277809ca1260705430c9,1,8,1,9,2,2012-07-29 04:53:20,2012-07-29 04:53:20
d05b2010ffd4cd33ff9402c402051b1caf985d97...682961e9304c6bf7bd500d741b01640682d35ac9,2,16,9,25,3,2012-07-27 22:25:15,2012-07-27 22:25:15
d05b2010ffd4cd33ff9402c402051b1caf985d97...e709642f6f9e9e89cd95177b2867794b3183a43b,0,0,0,0,0,2012-07-26 17:50:56,2012-07-26 17:50:56
e709642f6f9e9e89cd95177b2867794b3183a43b...75029cda2a52b656543ae5477328150654de8ccb,1,1,0,1,1,2012-07-26 17:54:15,2012-07-26 17:54:15
d05b2010ffd4cd33ff9402c402051b1caf985d97...9ee4b9c8f7b21db2c20500cacd72471e8cdbf6a5,1,151,0,151,1,2012-07-26 14:05:03,2012-07-26 14:05:03
d05b2010ffd4cd33ff9402c402051b1caf985d97...a8d795872989ddce5bbda0926f5ebca1d769ff6b,1,2,2,4,2,2012-07-25 04:55:28,2012-07-25 04:55:28
d05b2010ffd4cd33ff9402c402051b1caf985d97...61e708f91f36420e1c5ebe68c23d94738989c9d1,1,13,0,13,1,2012-07-24 03:33:14,2012-07-24 03:33:14
d05b2010ffd4cd33ff9402c402051b1caf985d97...73df0c8e93399c8281076d660aa48b1fc5203ce1,1,2,0,2,2,2012-07-23 14:51:29,2012-05-02 17:32:30
921d2f49ef01acce973980c0aa9c6ffbbd2fbd0b...7284e6b397712dfff16a740ea12d1015b26f203d,1,2,0,2,1,2012-09-21 05:08:53,2012-09-21 05:08:53
921d2f49ef01acce973980c0aa9c6ffbbd2fbd0b...aeadd7371b244468aadf81a48e6009a4aa612f23,2,28,0,28,2,2012-09-20 12:29:05,2012-09-20 12:29:05
921d2f49ef01acce973980c0aa9c6ffbbd2fbd0b...baa187e4b903f39422a84b580e6e617ec3738e09,1,149,0,149,1,2012-09-20 12:23:58,2012-09-20 12:23:58
baa187e4b903f39422a84b580e6e617ec3738e09...cc831508d7c2e839e1c4effe31ac2d92f2741f94,1,4,5,9,4,2012-09-21 14:19:39,2012-09-21 14:19:39
921d2f49ef01acce973980c0aa9c6ffbbd2fbd0b...b609aa0e6c981f2039d777687cb01a84587f6edc,1,5,0,5,2,2012-09-20 12:03:09,2012-09-20 12:03:09
921d2f49ef01acce973980c0aa9c6ffbbd2fbd0b...55c69017c501e30c8aa5a89104575f2863a26663,1,14,0,14,1,2012-09-18 15:10:11,2012-09-18 15:10:11
921d2f49ef01acce973980c0aa9c6ffbbd2fbd0b...8510ac002f1dec92f6e9e62809f3dc5493d4b842,1,1,1,2,1,2012-09-18 02:06:24,2012-09-18 02:05:42
921d2f49ef01acce973980c0aa9c6ffbbd2fbd0b...11a4c67f340b400a3d9cc9913b4f49d708e01a57,1,34,0,34,1,2012-09-17 16:19:37,2012-09-17 16:19:37
11a4c67f340b400a3d9cc9913b4f49d708e01a57...00e11991e0fec9e4db783550a1c849c48920f02a,1,1,1,2,1,2012-09-17 16:25:19,2012-09-17 16:25:19
00e11991e0fec9e4db783550a1c849c48920f02a...b534b3806357492a19b25841c7c0ad6a416f33aa,1,1,1,2,1,2012-09-17 18:16:06,2012-09-17 18:16:06
b534b3806357492a19b25841c7c0ad6a416f33aa...a8d426087bf5f79ee4c8c05e8debca01b4af5fd5,1,1,1,2,1,2012-09-17 20:12:09,2012-09-17 20:12:09
a8d426087bf5f79ee4c8c05e8debca01b4af5fd5...9510eb0e5a2ae7526ac66bec8e01c39322a8b254,1,1,1,2,1,2012-09-18 17:13:36,2012-09-18 17:13:36
9510eb0e5a2ae7526ac66bec8e01c39322a8b254...8ecc252f0cfd21281be4e4549a8c86248e85a700,1,1,1,2,1,2012-09-19 15:34:45,2012-09-19 15:34:45
8ecc252f0cfd21281be4e4549a8c86248e85a700...8d86bb298d51d619c88d2aad400007b67c4d438b,1,1,1,2,1,2012-10-11 15:26:39,2012-10-11 15:26:39
8d86bb298d51d619c88d2aad400007b67c4d438b...bb5db62314b0fb31b21326d8483c5e97405c07bb,1,2,2,4,2,2012-10-11 19:48:38,2012-10-11 19:48:38
bb5db62314b0fb31b21326d8483c5e97405c07bb...2ba668b91ccfdf6dd273d5b1358ee9cafa302534,1,2,2,4,2,2012-10-11 19:57:21,2012-10-11 19:57:21
2ba668b91ccfdf6dd273d5b1358ee9cafa302534...5872daea49104607efd64208a314aba10823af0b,1,1,1,2,1,2012-10-11 19:59:08,2012-10-11 19:59:08
5872daea49104607efd64208a314aba10823af0b...53412de75c982a07fac902e8deec929c4fe32abc,1,2,2,4,2,2012-10-11 20:02:55,2012-10-11 20:02:55
921d2f49ef01acce973980c0aa9c6ffbbd2fbd0b...28d28ee6f6128b3194ac6e28839aabb9a9018c4e,1,1,0,1,1,2012-09-14 11:57:13,2012-09-14 11:57:13
921d2f49ef01acce973980c0aa9c6ffbbd2fbd0b...b11e28914139fb585c0a4de4ddb6a55f19a5493d,1,28,0,28,1,2012-09-13 12:02:09,2012-09-13 12:02:09
b11e28914139fb585c0a4de4ddb6a55f19a5493d...bf4157514f8880ac04ba328f7f1b74c34f1b39d7,1,75,17,92,8,2012-09-17 16:44:25,2012-09-17 16:44:25
bf4157514f8880ac04ba328f7f1b74c34f1b39d7...6e85ff5b44e81f5b9d743b6ba1df7ed7b62dc2df,1,64,35,99,18,2012-09-25 23:35:08,2012-09-25 23:35:08
6e85ff5b44e81f5b9d743b6ba1df7ed7b62dc2df...b207792f30f523e2fc82a70e75893bf1124bf7a8,1,1,1,2,1,2012-09-26 00:06:13,2012-09-26 00:06:13
921d2f49ef01acce973980c0aa9c6ffbbd2fbd0b...8d60a0c80039048b836205475dfcf258bd776912,1,29,9,38,5,2012-09-13 09:38:58,2012-09-13 09:38:58
8d60a0c80039048b836205475dfcf258bd776912...9a4fac184ea1aa7a2e86e50111548a0a98652aaf,1,1,1,2,1,2012-09-13 10:20:44,2012-09-13 10:20:44
921d2f49ef01acce973980c0aa9c6ffbbd2fbd0b...061a4c006c83c9ddb2c8c693c2169d5be663763f,2,53,0,53,2,2012-09-06 09:59:18,2012-09-06 09:59:18
921d2f49ef01acce973980c0aa9c6ffbbd2fbd0b...97ec5de7244c419c4ca484f318e15062910247ba,1,1,1,2,1,2012-09-03 06:31:54,2012-09-03 06:31:54
921d2f49ef01acce973980c0aa9c6ffbbd2fbd0b...fa859f90d2ba91be36c77520b1a23442c55d9cfe,2,6,148,154,3,2012-09-03 03:51:28,2012-09-03 03:51:28
921d2f49ef01acce973980c0aa9c6ffbbd2fbd0b...3ef82a908a10979d9a4d14e0674902c85b14a99e,5,335,0,335,5,2012-09-02 13:43:20,2012-09-02 13:43:20
3ef82a908a10979d9a4d14e0674902c85b14a99e...91303246ecb4f103a1a3e21dfd9bcb65d1d5e832,1,46,0,46,1,2012-09-07 20:15:43,2012-09-07 20:15:43
91303246ecb4f103a1a3e21dfd9bcb65d1d5e832...08f4d8b9ce43bae69a2d712456cc6bde68b4f0d1,2,21,30,51,10,2012-09-11 20:04:56,2012-09-11 20:04:56
08f4d8b9ce43bae69a2d712456cc6bde68b4f0d1...c5d575ccae5ae5f30dd59037210edb8220de2cbe,6,0,372,372,6,2013-01-03 06:07:40,2013-01-03 06:07:40
c5d575ccae5ae5f30dd59037210edb8220de2cbe...df7cae0f4fdd8221d6cf256cc29c48b1d0d54dbd,1,38,0,38,1,2013-01-03 06:18:38,2013-01-03 06:18:38
921d2f49ef01acce973980c0aa9c6ffbbd2fbd0b...2643ac975bff9513753b6e3d99a34164e48955f7,1,5,1,6,2,2012-09-01 22:38:08,2012-09-01 22:38:08
d19e01b14086319abae80e7624a8192025e88572...dfbafe6d58bf1463df393fd4478154be36a675aa,2,14,7,21,4,2012-12-02 21:08:06,2012-08-04 18:41:47
d165a84dc0e8d2eb0774ed26995e7046c0aff41f...74faabbcabf6dc9a60737bfd54ba1b3a341c547d,1,2,0,2,1,2012-08-07 18:38:48,2012-08-07 18:38:48
d165a84dc0e8d2eb0774ed26995e7046c0aff41f...e3ff4b58c6b0012c616ea7a1dc44cde7a2ecfb57,1,42,0,42,1,2012-07-03 07:59:42,2012-07-03 07:59:42
d165a84dc0e8d2eb0774ed26995e7046c0aff41f...c23392ac5b9e8655a42e827983ba93636801136b,1,22,0,22,1,2012-07-03 03:02:29,2012-07-03 03:02:29
c23392ac5b9e8655a42e827983ba93636801136b...8d60f9a0d8eaf7f72eb64f600fcecbe48a26300f,1,3,2,5,1,2012-07-03 05:12:55,2012-07-03 05:12:55
d165a84dc0e8d2eb0774ed26995e7046c0aff41f...e2ddf1ef8c1147586a11c25007b201e9cbcfe278,1,1,1,2,1,2012-07-01 18:13:59,2012-07-01 17:57:32
d165a84dc0e8d2eb0774ed26995e7046c0aff41f...d15ec4bf248cf091fb31dd10da066c040abcd744,1,1,1,2,1,2012-06-25 08:55:23,2012-06-25 08:55:23
ffc17b6b4d55f74b9d3786ba790b7340865e5014...9385b3ee0a8425ae8a2b5c16084d4fab1ebc3764,1,17,6,23,1,2014-04-18 20:03:36,2014-03-24 07:17:19
ffc17b6b4d55f74b9d3786ba790b7340865e5014...53323abdb1a18c7756ace473390ac6ca51660839,1,12,2,14,3,2014-03-26 17:37:56,2014-03-20 23:09:45
ffc17b6b4d55f74b9d3786ba790b7340865e5014...76e1edf31f73e20487d7d7fe4a579361bb86815b,1,114,48,162,36,2014-03-26 09:40:46,2014-03-26 09:40:46
ffc17b6b4d55f74b9d3786ba790b7340865e5014...9650861e56a3404313adc35cbcb1f32a7015b99d,1,2,2,4,1,2014-03-26 06:12:39,2014-03-26 06:05:00
ffc17b6b4d55f74b9d3786ba790b7340865e5014...5137e0e509ae4d6534be132d614d43ea53d8a4e4,1,4,1,5,2,2014-03-25 20:14:20,2014-03-25 20:01:34
ffc17b6b4d55f74b9d3786ba790b7340865e5014...7b08f494e3604f18e7b9b31959a6da6d97abcc65,2,23,17,40,2,2014-03-25 16:38:02,2014-03-25 16:37:25
ffc17b6b4d55f74b9d3786ba790b7340865e5014...015b742153654c0b127f8f158ab80e51f6ea8ec3,1,7,7,14,6,2014-03-25 16:16:20,2014-03-25 16:16:20
ffc17b6b4d55f74b9d3786ba790b7340865e5014...48f8f2809bf96033f92f95384fa51749d6985dda,1,7,2,9,1,2014-03-25 15:36:39,2014-03-25 15:36:39
ffc17b6b4d55f74b9d3786ba790b7340865e5014...37e619ed9b7c3b1bda9788861a9a4c5ca4647ed0,1,2,2,4,1,2014-03-25 12:43:36,2014-03-25 12:43:36
ffc17b6b4d55f74b9d3786ba790b7340865e5014...5f09d0f6dd3ade4e2968a13ba93ceef4850dedee,1,13,13,26,10,2014-03-25 11:12:30,2014-03-24 14:24:04
ffc17b6b4d55f74b9d3786ba790b7340865e5014...c451ff4bf317188da20bfe18021a93640d54133b,1,1,1,2,1,2014-03-24 11:10:18,2014-03-24 11:10:18
ffc17b6b4d55f74b9d3786ba790b7340865e5014...3976b93f3931a7ebc913576015ff395dcd495d95,1,1,1,2,1,2014-03-23 19:59:35,2014-03-23 19:59:35
3976b93f3931a7ebc913576015ff395dcd495d95...b2ce306c4f49ebb1ef2bde5b86d553ce6ea674aa,1,6,14,20,1,2014-03-26 03:37:28,2014-03-26 03:37:28
ffc17b6b4d55f74b9d3786ba790b7340865e5014...3bae9dd2bfc59e03a6aeded95ca45d2810058e09,1,17,0,17,1,2014-03-23 19:12:18,2014-03-23 19:12:18
3bae9dd2bfc59e03a6aeded95ca45d2810058e09...1fc40c60b506bc71f20efcafc7e7350ece3a1596,1,0,2,2,1,2014-03-23 19:13:41,2014-03-23 19:13:41
1fc40c60b506bc71f20efcafc7e7350ece3a1596...8db3e6329d25ae3e7d6c4996b5a0c3a5f31d645e,1,1,1,2,1,2014-03-24 17:36:26,2014-03-24 17:36:26
8db3e6329d25ae3e7d6c4996b5a0c3a5f31d645e...f8890f564648d647903f5b10358a4f25f312d54a,2,10,3,13,4,2014-03-24 18:09:57,2014-03-24 18:09:57
f8890f564648d647903f5b10358a4f25f312d54a...64c3ce35e1493728c65191d9b16183841ad73ca7,1,1,1,2,1,2014-03-24 18:24:00,2014-03-24 18:24:00
64c3ce35e1493728c65191d9b16183841ad73ca7...982b534ce8cdf439c96bc48ff58f890e9e350d30,2,28,4,32,9,2014-03-25 20:20:25,2014-03-25 20:20:25
982b534ce8cdf439c96bc48ff58f890e9e350d30...0605d53fa7f04c864e7bc5f9f68bd38f24fbbfd5,2,16,10,26,10,2014-03-26 22:47:57,2014-03-26 22:47:57
0605d53fa7f04c864e7bc5f9f68bd38f24fbbfd5...400643ff5b20521aebe16ca36fde34bde212db89,2,16,3,19,6,2014-03-27 14:34:54,2014-03-27 14:34:54
5643fac8870c2df284f1ccceab35fb1fe343fa3f...22c0db64eed9b771a4d83abfd6f4cb8980d82229,1,30,26,56,3,2013-12-02 15:51:25,2013-10-30 15:01:49
6f48f586ba55507bb90fa8dd078b01c0333b907d...240b25daaaee81ccdb9e6e2016667a60f5241f83,2,20,5,25,7,2013-11-25 23:45:24,2013-11-25 23:45:24
240b25daaaee81ccdb9e6e2016667a60f5241f83...b4ffe5cf0a9e0a076fc1c52f6a46eefe05ad5627,2,86,0,86,2,2013-11-25 23:46:13,2013-11-25 23:46:13
1f334ba66053038bfd5236ffa8e1000c5adf1b44...84e178fa3d5e6e5bc36cb353c5c051d4f12ec35d,1,3,3,6,1,2013-12-01 22:29:55,2013-12-01 22:29:55
14005be4452814f9a5896f614fc48a6403b174e6...96bd365542dd9df0afe37e944996936bdaa17969,1,1,0,1,1,2013-12-01 14:33:23,2013-12-01 14:33:23
69fa67cbacde297622452ddfe55a7320079eeaec...9eadaf562ae403d9721ce5d9ea998769dd500cc9,1,57,57,114,9,2014-03-25 15:56:09,2014-03-25 15:56:09
a38af27991d15d14ac4ca55c919bb694d7eafb7a...827d9dfcb406c5d25470010933fc6fde85a7ded7,1,3,3,6,2,2014-01-02 23:48:09,2014-01-02 23:48:09
827d9dfcb406c5d25470010933fc6fde85a7ded7...d60522c7a290565c9de7594817a9d201732d5dd9,1,2,2,4,2,2014-01-02 23:53:34,2014-01-02 23:53:34
a38af27991d15d14ac4ca55c919bb694d7eafb7a...6a40557a8bc5411881682e3993333da8fbe64e68,1,5,3,8,3,2013-12-31 13:54:34,2013-12-31 13:54:34
a38af27991d15d14ac4ca55c919bb694d7eafb7a...3e5e2d45e95f0ee523ce2572a5e88f6e761e7067,1,1,1,2,1,2013-12-31 11:41:28,2013-12-31 11:41:28
a38af27991d15d14ac4ca55c919bb694d7eafb7a...bbbff94cca497103d0f9854f9d8a67b9049f59c9,1,1,1,2,1,2013-12-30 23:35:57,2013-12-30 23:35:57
bbbff94cca497103d0f9854f9d8a67b9049f59c9...468b24a8d54f294ab9802cac3801ba580c5c4397,1,2,2,4,2,2013-12-31 00:06:14,2013-12-31 00:06:14
468b24a8d54f294ab9802cac3801ba580c5c4397...ae6ded5ad795a7f4174bc10a5a02e1c0502e1352,1,3,1,4,1,2013-12-31 00:15:35,2013-12-31 00:15:35
ae6ded5ad795a7f4174bc10a5a02e1c0502e1352...7aa766168cead04f677b4828cc5c837f823f7cd7,1,4,0,4,1,2013-12-31 00:44:51,2013-12-31 00:44:51
7aa766168cead04f677b4828cc5c837f823f7cd7...8a887c505282b771193ac3ee6df05a1fa3f8426a,4,22,16,38,4,2013-12-31 01:11:02,2013-12-31 01:11:02
8a887c505282b771193ac3ee6df05a1fa3f8426a...c6aacf611d51f7c00d216f77c3b32174cc3bed9c,1,3,7,10,1,2013-12-31 01:45:09,2013-12-31 01:45:09
c6aacf611d51f7c00d216f77c3b32174cc3bed9c...72392a2c27386706c78efe1ace9b84e602d9d1ff,1,9,6,15,2,2014-01-06 08:57:09,2014-01-06 08:57:09
72392a2c27386706c78efe1ace9b84e602d9d1ff...082607c165c6ae16b7b059e941c8bfa3eddabbb8,1,12,0,12,1,2014-01-06 08:57:23,2014-01-06 08:57:23
082607c165c6ae16b7b059e941c8bfa3eddabbb8...85fde31991dc04f34450390e7d20992a7334c90a,1,0,0,0,0,2014-01-06 08:58:40,2014-01-06 08:58:40
85fde31991dc04f34450390e7d20992a7334c90a...2d6d9d525fbf791affef71e2d7fd0a0f2cd0c30c,1,1,1,2,1,2014-01-06 08:59:50,2014-01-06 08:59:50
2d6d9d525fbf791affef71e2d7fd0a0f2cd0c30c...b0b79e0abae5f1d228e16c36174bad2bf7ba5fee,1,1,1,2,1,2014-01-07 18:08:20,2014-01-07 18:08:20
a38af27991d15d14ac4ca55c919bb694d7eafb7a...f6bb74e452590c18b8545cb444a998448c7ae4f0,1,5,1,6,1,2013-12-27 13:25:06,2013-12-27 13:25:06
a38af27991d15d14ac4ca55c919bb694d7eafb7a...b58b996b40f8de1f030d59336e3594b63ef598ee,1,0,0,0,0,2013-12-21 18:49:44,2013-12-21 18:49:44
a38af27991d15d14ac4ca55c919bb694d7eafb7a...e41b6acd2a34bd2ad2a092b94629c95b1f932f82,1,4,0,4,2,2013-12-19 19:24:38,2013-12-19 19:24:38
ec37c05cb350149ec77209bc7901c6aaa73f5567...0d212bb218617dfb62c9c31a19b64e321cb1d9b6,1,1,0,1,1,2014-02-12 03:14:02,2014-02-12 03:14:02
ec37c05cb350149ec77209bc7901c6aaa73f5567...0cb2ecff8002e478f5e7e64cb529eb2af71b0299,1,8,0,8,1,2014-02-11 07:05:59,2014-02-11 06:56:13
ec37c05cb350149ec77209bc7901c6aaa73f5567...c563fe95fbf58721caa7de0ffe5d8117a6ada51a,1,3,2,5,1,2014-02-09 13:06:58,2014-02-09 13:06:58
c563fe95fbf58721caa7de0ffe5d8117a6ada51a...5303793ef13b5dd3e7f52ac40f17fd37f015af44,1,6,2,8,1,2014-03-24 21:32:56,2014-03-24 21:32:56
ec37c05cb350149ec77209bc7901c6aaa73f5567...ed19ffee5ecc0db6617c1ae753e515d60cb486c6,3,492,0,492,3,2014-02-09 01:09:51,2014-02-09 00:49:54
ec37c05cb350149ec77209bc7901c6aaa73f5567...217d8f0540a41b2927caf986561e45634fa1952a,1,1,1,2,1,2014-02-06 09:29:33,2014-02-06 09:29:33
48579ebf2bff8d41cd36f8eae72d526f2a9e1864...b9841b0bae97049d426c652f6a9be361c7492040,1,9,0,9,1,2014-03-10 22:18:50,2014-03-10 22:18:50
48579ebf2bff8d41cd36f8eae72d526f2a9e1864...3c9a29b0d639f52162eb8056a9b657fe4b6f2850,1,1,1,2,1,2014-03-10 15:23:14,2014-03-10 15:23:14
48579ebf2bff8d41cd36f8eae72d526f2a9e1864...b71a2b9d0f21c0b95840a2534eca2d866a48a941,1,0,5,5,1,2014-03-10 08:05:14,2014-03-10 08:05:14
48579ebf2bff8d41cd36f8eae72d526f2a9e1864...de0e7b5dc82ca3f18d20bc0d8aab8d9c5dd13ff9,1,1,1,2,1,2014-03-10 03:41:25,2014-03-10 03:41:25
85426a57a2561f675a6ad51754d6687c3ec571c2...785b1c6337e1da6b2356e71b72ef6b4c93460e90,1,1,1,2,1,2013-04-22 23:01:09,2013-04-22 23:01:09
85426a57a2561f675a6ad51754d6687c3ec571c2...e41714d72c6c5629efe632b1052b590f5f8905c5,2,10,1,11,2,2013-04-22 08:59:08,2013-04-22 08:59:08
85426a57a2561f675a6ad51754d6687c3ec571c2...72a8c08cc897520ea74ae49e811cd9e34501c520,3,502,101,603,53,2013-04-21 07:57:05,2013-04-21 06:34:44
72a8c08cc897520ea74ae49e811cd9e34501c520...c944f8b465e6c28f9a42ac6d71c90ddf9a5b5742,1,2,1,3,1,2013-04-21 07:57:05,2012-11-29 14:54:17
85426a57a2561f675a6ad51754d6687c3ec571c2...d615f6437408d66fa8aad031eb45942bf84fed86,1,2,0,2,1,2013-04-21 07:56:39,2013-04-21 07:10:21
85426a57a2561f675a6ad51754d6687c3ec571c2...bc385531b0e71b90b800502117bbdc8d1531e4c2,1,8,4,12,2,2013-04-21 02:37:36,2013-04-21 02:37:36
85426a57a2561f675a6ad51754d6687c3ec571c2...a08f626f1c37043cdf1e2632f283e537396a205b,1,9,0,9,2,2013-04-20 19:40:15,2013-04-20 19:40:15
85426a57a2561f675a6ad51754d6687c3ec571c2...52dc3b99f9963576f50ba87a46953e92591e4d7d,1,1,1,2,1,2013-04-18 20:43:54,2013-04-18 20:27:02
85426a57a2561f675a6ad51754d6687c3ec571c2...f2b915c56741c846e845b037e9fdeb7c3f063bc3,1,2,2,4,2,2013-04-18 00:08:36,2013-04-18 00:08:36
85426a57a2561f675a6ad51754d6687c3ec571c2...7db2b20fc4982d0b523d5ac5c59d0351229bbc32,1,416,0,416,1,2013-04-17 13:07:53,2013-04-17 13:07:53
85426a57a2561f675a6ad51754d6687c3ec571c2...0b3d5608668880fd1f50f8c6a2099b4a5dd7871a,1,3,3,6,1,2013-04-17 13:07:11,2013-04-17 13:07:11
85426a57a2561f675a6ad51754d6687c3ec571c2...5dae44ac5965b36da1dfc20772059561d4973cda,2,2,2,4,2,2013-04-16 17:10:21,2013-04-16 17:10:21
85426a57a2561f675a6ad51754d6687c3ec571c2...460cb3d0e0eb79f909a46ae3c1b9d1c19c55e0dd,1,3,1,4,2,2013-04-14 11:08:03,2013-04-14 11:08:03
85426a57a2561f675a6ad51754d6687c3ec571c2...388ae92d4755dae0f2d205dbb40fb0bbd975c9b3,1,4,0,4,1,2013-04-14 05:07:17,2013-04-14 05:07:17
85426a57a2561f675a6ad51754d6687c3ec571c2...2d2aa641678f6cb691b67e40897c3fa185efadf8,1,7,2,9,1,2013-04-12 15:19:09,2013-04-12 15:19:09
85426a57a2561f675a6ad51754d6687c3ec571c2...07738ea86330b7b77127fc6f18474b3da2c6ecec,1,28,0,28,1,2013-04-12 14:19:42,2013-04-12 14:19:42
80a603259657acab97badbae20003b5a34c901f9...22da0a00b8a05652c08ba6744962c572746462ae,1,79,0,79,1,2013-01-08 05:34:33,2013-01-08 05:34:33
80a603259657acab97badbae20003b5a34c901f9...003dd8f4b68062b7fd5e4e1725264189ee56e28a,1,2,2,4,2,2013-01-02 21:20:22,2013-01-02 21:20:22
003dd8f4b68062b7fd5e4e1725264189ee56e28a...93c90a6bf5817d09e978bd720eaa7f9be971a1c6,1,6,11,17,2,2013-01-03 00:14:57,2013-01-03 00:14:57
80a603259657acab97badbae20003b5a34c901f9...3362899493662ae8295521bc8fa8eccec79c7550,1,17,0,17,1,2013-01-02 03:51:55,2013-01-02 03:51:55
b34aee7f76c4cd37e643a330409ac580776b3837...6de78ad2ba8688532b116de8322d7aaecbbcebbe,1,2,0,2,1,2013-05-09 09:12:11,2013-05-09 09:12:11
b34aee7f76c4cd37e643a330409ac580776b3837...cf3a03d45e6b4eb642238bbd7b6aeca1fd1bc868,1,2,1,3,2,2013-05-05 08:35:40,2013-05-05 08:35:40
0a96bb15779e8dad3586f77582f58e987b4c265a...16d07683058719811a7871cbf7bed066ac8fc784,1,1,1,2,1,2014-12-16 21:22:31,2014-12-15 05:10:48
0a96bb15779e8dad3586f77582f58e987b4c265a...1978a0923c864cacdc520adff83ed63f62c91073,1,3,6,9,1,2014-12-15 16:11:04,2014-12-15 16:11:04
0a96bb15779e8dad3586f77582f58e987b4c265a...77da20997e8dd753193768d46fe27175a21f23cb,1,29,0,29,1,2014-12-15 02:19:00,2014-12-15 02:19:00
77da20997e8dd753193768d46fe27175a21f23cb...02d647773a4331a5464918a0cebe35cf0bd614ed,1,2,2,4,2,2014-12-15 02:28:06,2014-12-15 02:28:06
0ab0e67ecfc52b4779b700149a9c51feeb05318e...b7608bf32de06a546ae509f872bba44a46e10f0a,1,58,0,58,1,2013-04-01 04:26:39,2013-04-01 04:26:39
b7608bf32de06a546ae509f872bba44a46e10f0a...f9722174f72f3eb184159e7c77751472cb73384e,1,2,2,4,2,2013-04-01 04:35:39,2013-04-01 04:30:35
0ab0e67ecfc52b4779b700149a9c51feeb05318e...c1c77685edbe0fcbb494b8e2c73fca6637193297,1,17,11,28,1,2013-03-25 14:47:22,2013-03-25 14:47:22
0ab0e67ecfc52b4779b700149a9c51feeb05318e...7c50867d2e71c911b5684c1613e1c1524f099c02,1,150,0,150,1,2013-03-20 17:32:03,2013-03-20 17:32:03
0ab0e67ecfc52b4779b700149a9c51feeb05318e...0ed1adeaadfc03a5abb767df5ad76a1ddd2d7c69,1,1,1,2,1,2013-03-20 15:57:32,2013-03-20 15:57:32
0ab0e67ecfc52b4779b700149a9c51feeb05318e...f7f487c42666adfe7b94ebed4714ed212ed22cb9,1,5,1,6,2,2013-03-17 23:00:12,2013-03-17 23:00:12
0ab0e67ecfc52b4779b700149a9c51feeb05318e...2a1c9ff340401ca63efd846ed626903d72771c25,1,12,3,15,5,2013-03-16 04:06:46,2013-03-16 04:06:46
0ab0e67ecfc52b4779b700149a9c51feeb05318e...3826c7bf85b0005438c872fedc7aa1b4174e82c9,1,3,1,4,1,2013-03-15 21:07:47,2013-03-15 21:07:47
0ab0e67ecfc52b4779b700149a9c51feeb05318e...1cfd813f796e4472575daf4b51cd816bacc833e0,1,2,1,3,1,2013-03-14 03:48:28,2013-03-14 03:48:28
1cfd813f796e4472575daf4b51cd816bacc833e0...4c8bba57acb0f64edde89321d5d6cbc3a5226cac,1,1,1,2,1,2013-03-14 03:51:14,2013-03-14 03:51:12
0ab0e67ecfc52b4779b700149a9c51feeb05318e...56e835426bc895a191540d4d640b7750a81ff23a,1,1,1,2,1,2013-03-13 23:31:14,2013-03-13 23:31:14
0ab0e67ecfc52b4779b700149a9c51feeb05318e...6c6072c492064abf613fc1b89b4d635020631ef4,1,1,1,2,1,2013-03-13 11:21:43,2013-03-13 11:21:43
0ab0e67ecfc52b4779b700149a9c51feeb05318e...7903f5185622b3ead5608f170b5457121bda413a,1,1,1,2,1,2013-03-13 08:36:48,2013-03-13 08:36:48
0ab0e67ecfc52b4779b700149a9c51feeb05318e...4bf174c38b2b8ff9b000accf63155d9756c63a02,1,3,1,4,2,2013-03-13 03:06:16,2013-03-13 03:06:16
0ab0e67ecfc52b4779b700149a9c51feeb05318e...300f94cb0e1121e7796edbedcbc6d686e755be5b,4,13,42,55,7,2013-03-12 17:23:30,2013-03-12 17:11:18
300f94cb0e1121e7796edbedcbc6d686e755be5b...bdf4f5a347789069dda438e64467344b551fff00,1,1,1,2,1,2013-03-12 17:23:34,2013-03-12 17:15:05
0ab0e67ecfc52b4779b700149a9c51feeb05318e...a66bc75ad7d01d1a223cb60cb73810e0c79d2e4e,1,22,0,22,1,2013-03-12 13:15:22,2013-03-12 13:15:22
a66bc75ad7d01d1a223cb60cb73810e0c79d2e4e...55c6fd5c38ad47c2dfa27e6e1a0913d2aa594172,1,19,7,26,8,2013-03-13 07:55:35,2013-03-13 07:55:35
0ab0e67ecfc52b4779b700149a9c51feeb05318e...72ec24108a88d79a13cc3581f17b440418048a72,1,7,4,11,3,2013-03-11 19:41:32,2013-03-11 19:41:32
0ab0e67ecfc52b4779b700149a9c51feeb05318e...6dd286bba3fe36278ca6de45567c3842e2db7cc0,1,3,1,4,3,2013-03-11 10:24:12,2013-03-11 10:24:12
6dd286bba3fe36278ca6de45567c3842e2db7cc0...295bac03297b3909712cdf68b3cc388d5b6feb5e,1,1,0,1,1,2013-03-27 06:16:46,2013-03-27 06:16:46
0ab0e67ecfc52b4779b700149a9c51feeb05318e...9991401aaa88c294c37dc8aaaf955d7d08b04508,1,2,2,4,2,2013-03-10 19:36:39,2013-03-10 19:36:39
0ab0e67ecfc52b4779b700149a9c51feeb05318e...49860bd61ff61d284f3b356bec0042cace98a686,1,3,0,3,1,2013-03-10 16:18:33,2013-03-10 16:18:33
eafd5f325208421b82a770e57441dd1063eb5745...ac053f4211ef2da6b66bd148a930cfdddd12991f,1,0,1,1,1,2014-08-23 15:50:54,2014-08-23 15:50:02
eafd5f325208421b82a770e57441dd1063eb5745...33ef34baa5f703ee7fcc502eabed4f1ab968127e,1,1,1,2,1,2014-04-29 17:20:39,2014-01-07 20:47:58
eafd5f325208421b82a770e57441dd1063eb5745...73bf940c34fe359c27031a1144237ccaad7d2b9b,1,1,0,1,1,2014-04-23 17:44:59,2014-04-23 17:44:59
b57284244ed14fb5e9be027e32f8dd3cb664b53d...b2421cc73fe4c531c5d8a699124a3ef62bb327bd,1,1,1,2,1,2013-04-08 02:26:40,2013-04-08 02:26:40
fbf82ae62fe03f69af0114011c0d6848a83d4fb3...692dca07158413ae27b2064c303240f5b9621cff,1,8,0,8,1,2013-01-06 06:08:12,2013-01-06 06:08:12
25a9cddc2191a1c6751d1e385389c0787a597a3e...2bbe6aba8f90dabdb3f7e2caaf12b6a3ecaf5f1f,1,22,0,22,1,2012-09-29 05:41:30,2012-09-29 05:41:30
2bbe6aba8f90dabdb3f7e2caaf12b6a3ecaf5f1f...2d660161027a5c6a6876520dd264df7fdab7c044,1,3,3,6,1,2012-09-29 05:48:18,2012-09-29 05:48:18
2d660161027a5c6a6876520dd264df7fdab7c044...b559f2f22127b3bf7f30dd5221fd8cb5ff3808fc,1,1,1,2,1,2012-09-29 06:00:15,2012-09-29 06:00:15
b559f2f22127b3bf7f30dd5221fd8cb5ff3808fc...9acfaee2567bcbe8dcd3dc73a8d40c0983766fb6,1,1,1,2,1,2012-10-01 16:27:52,2012-10-01 16:27:52
25a9cddc2191a1c6751d1e385389c0787a597a3e...c7c647d8039987b802509519ffa631818cd1d194,2,99,0,99,2,2012-09-27 09:51:16,2012-09-27 09:51:16
c7c647d8039987b802509519ffa631818cd1d194...b7383b097e2b1dc6aaec2c906e7d2031f9446fba,1,4,4,8,2,2012-10-01 14:24:50,2012-10-01 14:24:50
b7383b097e2b1dc6aaec2c906e7d2031f9446fba...b932312ab78b7f422f501d03aaa577440bcd3a0c,1,4,4,8,2,2012-10-02 16:10:40,2012-10-02 16:10:40
b932312ab78b7f422f501d03aaa577440bcd3a0c...a0bcbfb111cc28c7e3e8320f001d28297614698e,1,6,6,12,3,2012-10-09 06:47:18,2012-10-09 06:47:18
25a9cddc2191a1c6751d1e385389c0787a597a3e...3d1b788d8ad3b4c407d3c752de15318cf57cf03e,1,4,0,4,1,2012-09-26 20:56:37,2011-11-08 20:24:14
3d1b788d8ad3b4c407d3c752de15318cf57cf03e...a7fb6680789c0a45c23539f9cce623a920ae143e,1,1,7,8,2,2012-09-26 20:57:38,2012-09-26 20:57:38
25a9cddc2191a1c6751d1e385389c0787a597a3e...5e0fd9bb9f8f11da1d7562f5e867a28706accb57,1,2,0,2,1,2012-09-26 13:16:15,2012-09-26 13:16:15
73f777053725ce61d6fada67ff3f174130dd8c94...f09af5717923cca4e5c538e14846ea4816295949,1,4,4,8,4,2012-11-03 07:05:38,2012-11-03 07:05:38
73f777053725ce61d6fada67ff3f174130dd8c94...a97e117281fa495bf13b7aa4179647cb9c7f5c01,1,9,0,9,1,2012-10-08 19:42:27,2012-10-08 19:42:27
73f777053725ce61d6fada67ff3f174130dd8c94...e3de97ca89368bb433034431778a29f7f09db6c2,1,5,1,6,1,2012-10-05 20:12:40,2012-10-05 20:12:40
e3de97ca89368bb433034431778a29f7f09db6c2...6630919bce0ec9eb5ad33c26a32cd5f06529d570,1,28,0,28,1,2012-10-05 20:13:10,2012-10-05 20:13:10
6630919bce0ec9eb5ad33c26a32cd5f06529d570...9365fd03f62854c48bc06388542ba4933eb067db,1,1,0,1,1,2012-10-05 20:14:44,2012-10-05 20:14:44
73f777053725ce61d6fada67ff3f174130dd8c94...43bd46b780cdf60b318f452e40b893ae18e77c41,1,1,1,2,1,2012-10-03 15:18:14,2012-10-03 15:18:14
73f777053725ce61d6fada67ff3f174130dd8c94...58d904a28960f6962eb27a6105e83d57cb553aba,1,11,0,11,1,2012-10-01 14:29:06,2012-10-01 14:29:06
a9061f34d7dbb2e65d2c378dcee9402466ab63ae...7949a1cd8d69e7a79cbf20294cf41662aff15058,1,1,1,2,1,2014-04-19 07:03:28,2014-04-06 11:51:18
a9061f34d7dbb2e65d2c378dcee9402466ab63ae...cee52283d8f5e18ba962cdb7b0acec2627e647e3,1,1,1,2,1,2014-04-18 21:09:38,2014-04-18 21:09:38
a9061f34d7dbb2e65d2c378dcee9402466ab63ae...fcfa323974985cd202c95379f893a86d6cf975fb,1,6,7,13,4,2014-04-18 15:07:23,2014-03-25 21:16:36
a9061f34d7dbb2e65d2c378dcee9402466ab63ae...6f3cf195c67bec936b6b0799051859e1f0ddb9dc,1,1,1,2,1,2014-04-18 12:43:23,2014-04-18 12:43:23
70dfb91b982b91cd2bd052124e8b65b774f66db1...f46d06dae19f691e6666d4836766e9eb69d2e51b,1,1,1,2,1,2014-03-30 14:34:13,2014-03-29 14:14:37
70dfb91b982b91cd2bd052124e8b65b774f66db1...b2ea7d3ec12152ab4d864c27c33d8b9396c68858,1,12,0,12,2,2014-03-28 17:25:13,2014-03-28 17:25:13
00d6ef8a31dce3fabad159698856de358f29b5ba...7d696f79b8d864e7b6afb13512bcb0f0cd519f1a,1,1,1,2,1,2014-04-04 14:11:11,2014-04-04 14:11:11
e2838f75f0be001cf34da321c9c712d48699e518...a6671919ab2a5b0732dbc07d6f8becd9346917da,1,4,4,8,2,2014-01-10 21:52:18,2014-01-10 21:52:18
e2838f75f0be001cf34da321c9c712d48699e518...9ce1b6289aebc8e19b8bb25e4f7ac1cbc84e83de,1,64,0,64,1,2014-01-04 21:08:00,2014-01-04 21:06:09
9ce1b6289aebc8e19b8bb25e4f7ac1cbc84e83de...1304ed8d2521e452615bcf7563700018443f5470,1,11,5,16,4,2014-01-06 13:09:40,2014-01-06 13:09:40
1304ed8d2521e452615bcf7563700018443f5470...642ae64bc50f93739ca280e8dcb1d6dbb5932f58,1,16,20,36,9,2014-01-07 01:10:34,2014-01-07 01:10:34
642ae64bc50f93739ca280e8dcb1d6dbb5932f58...8bf8e1ecf9eeb4117b1196a5fd02d788979f05f7,1,50,38,88,9,2014-01-07 09:07:02,2014-01-07 09:07:02
8bf8e1ecf9eeb4117b1196a5fd02d788979f05f7...8ede6c6af3b3f11d9b688e4bf9c97be8a54c6c4d,1,30,34,64,9,2014-01-08 01:50:58,2014-01-08 01:50:58
8ede6c6af3b3f11d9b688e4bf9c97be8a54c6c4d...f66ab7f98f9be0486b3a55858d9466232fc97ef6,1,8,11,19,8,2014-01-08 02:04:54,2014-01-08 02:04:54
f66ab7f98f9be0486b3a55858d9466232fc97ef6...ca129bb55085cf93510346dcd70b1190b87d5bc0,1,3,1,4,2,2014-01-10 13:03:10,2014-01-10 13:03:10
e2838f75f0be001cf34da321c9c712d48699e518...4354f911710572f9ec0a8e4435571ea3c19cb0f8,1,1,1,2,1,2014-01-03 13:52:33,2014-01-03 13:52:33
d485044169c2ac18e9e8e7fe29f7d4d93864168a...78ffa71cb6ecb40ec8ca97d5fb9682ceb74a05b7,1,1,1,2,1,2014-01-29 00:02:40,2014-01-29 00:02:40
78ffa71cb6ecb40ec8ca97d5fb9682ceb74a05b7...7daaa188da6255ef89f3076ad70370dd31762437,1,1,1,2,1,2014-01-29 03:54:00,2014-01-29 03:54:00
7daaa188da6255ef89f3076ad70370dd31762437...685ea4a36162a0bca9b0176b268c25e45023e97e,1,2,2,4,2,2014-01-29 19:35:21,2014-01-29 19:35:21
d485044169c2ac18e9e8e7fe29f7d4d93864168a...3d41804fbce109a09f8d9549e875b428621cd85b,1,4,4,8,3,2014-01-24 22:01:35,2014-01-24 22:01:35
d485044169c2ac18e9e8e7fe29f7d4d93864168a...9b3344dd8085bdcb16d08b5e47492b275e44955e,1,1,1,2,1,2014-01-24 04:58:23,2014-01-24 04:58:23
9b3344dd8085bdcb16d08b5e47492b275e44955e...a48fd1e80882e1f3008d5ee027b3e41d38844414,1,1,1,2,1,2014-01-24 18:27:41,2014-01-24 18:27:41
d485044169c2ac18e9e8e7fe29f7d4d93864168a...cc8b09366b62d8f260e1cdd3d4a1acd868e5c9e0,1,69,11,80,8,2014-01-18 12:58:42,2014-01-06 01:09:15
d485044169c2ac18e9e8e7fe29f7d4d93864168a...7b9e48992fa82a72587e451018926e2607172e95,1,20,0,20,1,2014-01-17 09:59:14,2014-01-17 09:59:14
d485044169c2ac18e9e8e7fe29f7d4d93864168a...23e57c177c44b3177c0545acaf9f6211db78f774,1,5,2,7,1,2014-01-16 11:15:41,2014-01-16 11:15:41
ee21fe94473404b58cbaea5b2c279f7a07c34ce1...9e90bf0f23ff4343954e6533ccceace883cc16dd,1,6,0,6,2,2014-03-14 10:14:47,2014-03-14 10:14:47
df0305aba511266865b371fa74b94bb3ee321e09...4d83da770a85f4d2e6b0e0990cb83c925de128bd,1,13,0,13,1,2014-01-30 17:15:57,2014-01-30 17:04:09
4ce7f0a37f9a13c605225e2a595ad1bdf6171065...c3c8cc318de898257fd7c5be6f862098966fbbdf,1,3,3,6,2,2014-03-10 23:36:51,2014-03-10 23:36:51
4ce7f0a37f9a13c605225e2a595ad1bdf6171065...6cc240811fd5756a7e2fd1a79ac529ca5f284e1d,1,4,0,4,1,2014-02-26 04:27:33,2014-02-26 04:27:33
4ce7f0a37f9a13c605225e2a595ad1bdf6171065...1df7d01618f06cc80b7f9d14bd088c70e6382d33,1,1,1,2,1,2014-02-18 21:43:42,2014-02-18 21:43:42
4ce7f0a37f9a13c605225e2a595ad1bdf6171065...358b6ffcde9e3732ed08387fc176851e07c1862f,1,11,0,11,1,2014-02-18 21:37:59,2014-02-18 21:37:59
4ce7f0a37f9a13c605225e2a595ad1bdf6171065...fdd864bd5b5444848c492454e025257f3c4fa675,1,5,1,6,1,2014-02-17 00:32:24,2014-02-17 00:32:24
4ce7f0a37f9a13c605225e2a595ad1bdf6171065...354593e9b2b3a7ec3a0840eeadbc7d760cdd7263,1,17,0,17,1,2014-02-14 14:55:00,2014-02-14 14:54:28
4ce7f0a37f9a13c605225e2a595ad1bdf6171065...1a029f293541d37e545f4706791ca41ce129600b,1,56,0,56,1,2014-02-13 17:27:00,2014-02-13 17:27:00
1a029f293541d37e545f4706791ca41ce129600b...baeac5bec9cc9b2da5ac69054d91ae3838fde402,1,0,5,5,1,2014-03-16 20:52:37,2014-03-16 20:52:37
4ce7f0a37f9a13c605225e2a595ad1bdf6171065...f6f3e9301940dc21680aa50156355c8dba61b441,1,3,1,4,2,2014-02-13 09:32:52,2014-02-13 09:32:52
4ce7f0a37f9a13c605225e2a595ad1bdf6171065...2078e7d4deac2546deea6b707837b39c535eaa78,1,1,151,152,2,2014-02-13 02:09:44,2014-02-13 02:09:44
2078e7d4deac2546deea6b707837b39c535eaa78...aa9db3e8f9e03156f350b5d32fdf5dfde76a6038,1,22,12,34,9,2014-02-13 02:13:00,2014-02-13 02:13:00
4ce7f0a37f9a13c605225e2a595ad1bdf6171065...f3f0a54259f384c35dad48a40d6e931df079b3c9,1,59,16,75,15,2014-02-12 03:45:41,2014-02-12 03:45:41
6952105bfe1fd4121fd355dc5f8ec5e03de5541c...c1c107cfb9669beeda258efed9a17cc4bddf7aa7,2,165,163,328,36,2014-03-17 23:49:12,2014-03-17 23:49:12
86a272ef81a1094d21dfdd1d38ad20e7347f389d...b6cbba9dfee5985232b473e94595c2fb1ab83715,1,2,2,4,2,2014-03-12 14:52:20,2014-03-12 14:52:20
de78e47d27e758ab5dc418a2e546725da07d1ea3...47b0d754ae368af16957903f203ee902c7faeec1,1,5,9,14,5,2014-03-13 17:15:18,2014-03-13 17:15:18
de78e47d27e758ab5dc418a2e546725da07d1ea3...71d94206370c258383beddfa6d3122524c26d8e8,1,0,16,16,1,2014-03-13 16:48:58,2012-12-17 11:22:33
93ee93938337db6bc220eaa00595b40ad88c2a81...d4d8939410edf3b81e6cd6a63b39744262691185,1,2,1,3,1,2013-04-23 23:11:52,2013-04-23 23:11:52
93ee93938337db6bc220eaa00595b40ad88c2a81...d537193f262d277158f01bd319bfe76d154b751d,1,34,0,34,1,2013-04-23 08:41:58,2013-04-23 08:41:58
93ee93938337db6bc220eaa00595b40ad88c2a81...680302c9f6ce71f69afaf7d020ed400cec2e5d58,1,1,1,2,1,2013-04-23 06:35:27,2013-04-23 06:35:27
bc385531b0e71b90b800502117bbdc8d1531e4c2...ae1973de443525daeb87df9973ae83c6c9210cfe,1,7,3,10,3,2013-04-29 14:18:32,2013-04-29 14:18:32
5dae44ac5965b36da1dfc20772059561d4973cda...cf9b0119fa909f6e507759986b8e887ef771012f,2,4,1,5,3,2013-04-24 13:50:48,2013-04-24 13:50:48
914c47b3473b000288c693523f83fde998282a81...cd9c47430349826d4461d7c9e73f6c58e567f01b,2,61,8,69,2,2013-01-10 05:56:55,2013-01-10 05:56:55
c207c839689b49db96ebd60eecdc8026cbb107e5...9f8d7d85c2cacce54a5839d90b93e90b22228624,1,2,2,4,2,2014-08-31 18:30:30,2014-08-31 18:30:30
9f8d7d85c2cacce54a5839d90b93e90b22228624...671bd0cf4f0face60883a2b476e75e6364d0154e,1,1,0,1,1,2014-08-31 18:32:07,2014-08-31 18:32:07
79196f82130a97f8b6226f601c2f3424cf16e064...bd38c50241647a1d0b0e2ca49fb1d6b9a2b88806,1,9,2,11,3,2013-05-27 13:23:14,2013-05-27 13:23:14
27c6becffde091cc55e0df70875451ca82867935...e4884da5a09b121a43121c79449e4cfae7a5c9d0,1,17,0,17,1,2013-06-09 09:01:20,2013-06-09 09:01:20
e4884da5a09b121a43121c79449e4cfae7a5c9d0...60aa92bae3a589af93d8a52443f01609b81cd4ab,1,1,1,2,1,2013-06-09 09:04:39,2013-06-09 09:04:39
27c6becffde091cc55e0df70875451ca82867935...69116fa806f5a7405d33cc1f7c66d4c26ad4253b,1,23,13,36,7,2013-05-21 18:20:28,2013-05-21 18:20:28
27c6becffde091cc55e0df70875451ca82867935...25313814775c08c64dc541fbadceb38c669c541a,1,43,0,43,1,2013-05-21 05:18:07,2013-05-21 05:18:07
27c6becffde091cc55e0df70875451ca82867935...4ff861ee115fdba24033f945dcf3cacea3120074,1,4,4,8,3,2013-05-19 19:55:10,2013-05-19 19:55:10
27c6becffde091cc55e0df70875451ca82867935...d2fe03d7549558745f999865ea0e348cb44e818f,1,12,2,14,2,2013-05-17 15:17:33,2013-05-17 15:17:33
27c6becffde091cc55e0df70875451ca82867935...a9111488e4945a29b8afa9a4eab12ee2e6fc9a0e,2,30,3,33,2,2013-05-17 09:48:06,2013-05-17 09:48:06
a9111488e4945a29b8afa9a4eab12ee2e6fc9a0e...00848cd8b7347e9b793a2ac6170498e6592dde56,2,7,1,8,2,2013-05-22 09:00:08,2013-05-22 09:00:08
00848cd8b7347e9b793a2ac6170498e6592dde56...6b832b93588567cb00b9a9e8170a5ebf539dea51,1,3,0,3,1,2013-06-06 04:39:14,2013-06-06 04:39:14
cf3a03d45e6b4eb642238bbd7b6aeca1fd1bc868...29e696d902b4cf665e237969aa333a5e176a59f5,1,1,1,2,1,2013-05-08 09:03:33,2013-05-08 09:03:07
cf3a03d45e6b4eb642238bbd7b6aeca1fd1bc868...b36c42b76d5bb06e1a19b534177ad4980bc3b025,1,1,1,2,1,2013-05-08 09:03:07,2013-05-08 09:03:07
b36c42b76d5bb06e1a19b534177ad4980bc3b025...22dce9e71594d1cf191cd41cef845a34621826f8,1,2,1,3,2,2013-05-09 04:57:32,2013-05-09 04:57:32
b57118bd370666feef670e233e077e40408c92b1...61e3951e4be2f496d8ce8022afc58817c06e5dee,1,4,4,8,4,2013-09-19 20:18:16,2013-09-19 20:18:16
1978a0923c864cacdc520adff83ed63f62c91073...9e5f0f0e9d22af07bd6cb4d509e66dfc8cfcd3bd,1,12,0,12,4,2014-12-18 22:22:48,2014-12-18 21:59:00
1978a0923c864cacdc520adff83ed63f62c91073...f7deb52c478e3ae7045320130c1aa8ca9dca993f,1,9,23,32,7,2014-12-16 16:35:08,2014-12-16 16:35:08
1978a0923c864cacdc520adff83ed63f62c91073...83553597a1430e2f3459de74de1cf33ae4ce67be,1,0,2,2,1,2014-12-15 17:45:50,2014-01-15 05:13:49
1978a0923c864cacdc520adff83ed63f62c91073...7931d5ce1a72cc49cc64478042bc3ef3b667ac8e,1,5,2,7,3,2014-12-15 16:51:22,2014-12-15 16:17:58
175b4a807383530aa75145b5b6fdedb3ce1f11f2...bf7b9165fd725d2bdf45ca7e639b2c91f5ef65bb,2,8,1,9,2,2015-01-08 16:01:16,2015-01-08 16:01:16
bf7b9165fd725d2bdf45ca7e639b2c91f5ef65bb...ceb42ecdb6296b136e3ead9e6ab53c24a01fedc9,2,3,3,6,2,2015-01-08 16:38:05,2015-01-08 16:38:05
175b4a807383530aa75145b5b6fdedb3ce1f11f2...833e6f5958b9851d2dbcf8ae706474af4079a25e,1,1,1,2,1,2015-01-07 17:17:29,2015-01-07 17:15:00
175b4a807383530aa75145b5b6fdedb3ce1f11f2...8790fa3723afb15dcac56e9fc71b4a84cd6c9a1f,1,1,0,1,1,2014-12-30 22:53:31,2014-12-30 22:52:14
175b4a807383530aa75145b5b6fdedb3ce1f11f2...957564ab9f515dd3565689c9974119310a08f4bc,1,33,0,33,1,2014-12-27 15:56:57,2014-12-27 15:56:57
175b4a807383530aa75145b5b6fdedb3ce1f11f2...7295e38885080b0650cbb274f03efca737552116,1,14,2,16,4,2014-12-21 20:05:22,2014-12-21 20:05:22
3913106b2e7127d396f27b652df812340ec0c871...480ca2205846426c04fa46fb37e1f7246bba2b88,1,9,1,10,2,2014-06-28 11:23:40,2014-06-16 14:11:59
3913106b2e7127d396f27b652df812340ec0c871...45b61297113c7c2d2cb0eeb80537c8fa944865df,2,233,0,233,2,2014-06-20 02:27:40,2014-06-20 02:27:40
3913106b2e7127d396f27b652df812340ec0c871...d3acea3965ebe13d6ed9885984ba8f5cc8ab4936,1,4,0,4,3,2014-06-08 10:14:01,2013-12-14 17:57:46
d3acea3965ebe13d6ed9885984ba8f5cc8ab4936...859a37d4f14838b20d09b8d7814f270d9b54b8e5,1,1,1,2,1,2014-06-08 10:14:41,2014-06-08 10:04:52
859a37d4f14838b20d09b8d7814f270d9b54b8e5...1ab0f771bc85bbdd86d14e616281cc138c3afe91,1,3,2,5,3,2014-06-08 10:14:41,2014-06-08 10:08:02
1ab0f771bc85bbdd86d14e616281cc138c3afe91...1274a5e3ab23720e64cf2044cdbe6aa86d402864,1,1,0,1,1,2014-06-09 19:03:09,2014-06-09 19:03:09
3913106b2e7127d396f27b652df812340ec0c871...b7f51bbbdd9f0d9ff9ef59b559e91b916d53cdf1,1,4,1,5,3,2014-05-27 16:34:03,2014-05-27 16:34:03
3913106b2e7127d396f27b652df812340ec0c871...3c485db8c73bfebf379f3e9382eb8f300b608bd8,1,1,1,2,1,2014-05-25 12:13:07,2014-05-24 10:15:26
3c485db8c73bfebf379f3e9382eb8f300b608bd8...59c8fcc712556a4c0b612898073e212877c21d60,1,7,0,7,1,2014-05-25 12:13:21,2014-05-24 10:19:46
59c8fcc712556a4c0b612898073e212877c21d60...514693125b12d4b4cd099dcb09174f7bfd9a5b0e,1,2,1,3,1,2014-05-26 08:47:51,2014-05-26 08:47:51
3913106b2e7127d396f27b652df812340ec0c871...2c19c0e59e6a3fd1f844ee6f5f883e199a3c1adc,1,1,1,2,1,2014-05-24 06:31:59,2014-05-24 06:31:59
2c19c0e59e6a3fd1f844ee6f5f883e199a3c1adc...0b4bf905f50191c885315eec5536a973ea96b4cf,1,11,11,22,11,2014-05-24 06:34:22,2014-05-24 02:06:30
0b4bf905f50191c885315eec5536a973ea96b4cf...8355233f7fc055d8446c7ebf50569202fa5bd1f5,1,2,2,4,2,2014-05-24 06:35:54,2014-05-08 18:19:37
8355233f7fc055d8446c7ebf50569202fa5bd1f5...9590b96b3f0dc8e2f4a87b632ff59eab28a0081e,1,1,1,2,1,2014-05-24 17:40:30,2012-02-06 18:22:07
9590b96b3f0dc8e2f4a87b632ff59eab28a0081e...c1f5a1792be3f11f9b298a11232bc5913c8b71a2,1,0,1,1,1,2014-05-24 17:48:36,2014-02-14 00:33:27
c1f5a1792be3f11f9b298a11232bc5913c8b71a2...5e601d6515f9ee51c733aea71acf6757066943e2,1,1,1,2,1,2014-05-24 17:48:36,2014-02-14 00:41:38
5e601d6515f9ee51c733aea71acf6757066943e2...8d976e02b1da43ec74c1ca6f50584eed566ff73a,1,0,2,2,1,2014-05-24 17:51:08,2014-01-15 05:13:49
8d976e02b1da43ec74c1ca6f50584eed566ff73a...4c64cf4a253608022caeda0f83b6ae73b7a8513c,1,2,2,4,1,2014-05-24 18:07:05,2014-04-09 10:32:42
4c64cf4a253608022caeda0f83b6ae73b7a8513c...cd8d5c4410f96ee16a6349a0cf7bcac882e37604,1,10,10,20,2,2014-05-24 18:07:05,2014-04-09 16:13:19
cd8d5c4410f96ee16a6349a0cf7bcac882e37604...b64e695b35db8bf0ff01433669a3adc4ee04341c,1,5,5,10,3,2014-05-24 18:07:06,2014-04-09 16:16:57
b64e695b35db8bf0ff01433669a3adc4ee04341c...c0b094cf859899bd78db43a4dc59a0ae6786d49d,1,2,1,3,2,2014-05-25 09:15:12,2014-02-03 09:35:40
c0b094cf859899bd78db43a4dc59a0ae6786d49d...1ad1c52797e99c1060301e55cb726e290a06d063,1,9,4,13,2,2014-05-25 20:55:56,2014-05-16 15:46:48
1ad1c52797e99c1060301e55cb726e290a06d063...6fc241b0d2f4690f7fd00f26eb91045a04c05fbd,1,1,1,2,1,2014-05-26 10:15:20,2014-04-18 09:26:06
6fc241b0d2f4690f7fd00f26eb91045a04c05fbd...7bb42fb49a0dcbd0774a0e6efafe766fdfc82268,1,1,1,2,1,2014-05-28 09:19:16,2012-12-30 02:32:00
7bb42fb49a0dcbd0774a0e6efafe766fdfc82268...80828cd0d3d415b49530c0f7e989f6d251427985,1,1,1,2,1,2014-05-28 09:19:47,2013-01-14 09:46:01
80828cd0d3d415b49530c0f7e989f6d251427985...6bf7f39345db64e5c37a5c5ac2e8189df0f8a8c6,1,1,1,2,1,2014-05-28 09:20:41,2013-01-24 17:45:49
6bf7f39345db64e5c37a5c5ac2e8189df0f8a8c6...97ab436f7f8823586fd9f3ef21ec1248abdc1262,1,1,1,2,1,2014-05-28 09:22:35,2012-11-02 15:14:45
97ab436f7f8823586fd9f3ef21ec1248abdc1262...3fac127152e42a3149fa7174a0841de97f2fb82a,1,0,0,0,0,2014-05-28 09:23:39,2014-01-13 19:19:33
3fac127152e42a3149fa7174a0841de97f2fb82a...3c41da3172325d90397baed7b27b4c675def8a51,1,3,3,6,1,2014-05-29 08:56:41,2013-07-09 11:51:52
3c41da3172325d90397baed7b27b4c675def8a51...b5692730128f84da8cc03567099f58df2baf546b,4,0,0,0,0,2014-05-29 08:58:17,2013-06-29 10:09:37
b5692730128f84da8cc03567099f58df2baf546b...76e23e62c659fd61cf43b5e2cde350fd1d434d43,1,0,0,0,0,2014-05-29 08:58:51,2014-05-29 08:58:51
76e23e62c659fd61cf43b5e2cde350fd1d434d43...ac1a321abefb73f1eeb6c9ec76dd14a062482ac6,1,3,0,3,1,2014-05-29 09:06:02,2014-05-29 09:06:02
ac1a321abefb73f1eeb6c9ec76dd14a062482ac6...b1c97bc77ef6e6922c6aed5bb7a2a86506407efc,1,1,1,2,1,2014-06-02 14:11:22,2013-08-05 13:54:49
b1c97bc77ef6e6922c6aed5bb7a2a86506407efc...3cdfdad28a1b7efbcc1cd1282e7811d80f50a730,1,1,1,2,1,2014-06-02 14:11:22,2014-05-28 08:05:07
3cdfdad28a1b7efbcc1cd1282e7811d80f50a730...7297b446b87ae26e410b54b7398111a76f1ccbcc,1,1,0,1,1,2014-06-04 08:53:19,2013-12-21 15:21:34
7297b446b87ae26e410b54b7398111a76f1ccbcc...e5ed07e2b5740346d2a32b3a47204612d8808723,1,1,1,2,1,2014-06-04 10:36:34,2014-06-04 10:36:34
e5ed07e2b5740346d2a32b3a47204612d8808723...de41dee9e462e2a04cbe4658a002812d71f9e3c3,1,1,0,1,1,2014-06-04 10:50:45,2013-12-10 09:03:46
de41dee9e462e2a04cbe4658a002812d71f9e3c3...a9e1d9aa890c18ea3c3250442e7d9de555633237,1,6,0,6,1,2014-06-04 17:37:14,2014-06-04 17:26:46
a9e1d9aa890c18ea3c3250442e7d9de555633237...fbf4a78acfd9ad7b96e8add7990d871ba50b866e,1,2,2,4,2,2014-06-06 09:27:53,2014-06-02 10:42:21
fbf4a78acfd9ad7b96e8add7990d871ba50b866e...67d74cbc2d057ef8ae2d237f739b53f52919567f,1,3,1,4,1,2014-06-07 08:13:21,2014-04-23 04:34:22
67d74cbc2d057ef8ae2d237f739b53f52919567f...f82092a0e78985287c6eb1746234db688bb1a98f,1,2,0,2,1,2014-06-07 21:12:32,2013-10-18 13:23:27
f82092a0e78985287c6eb1746234db688bb1a98f...f7948ace66dd541e5b60666d840cce6b6d95f0e6,1,4,4,8,1,2014-06-08 08:33:54,2013-12-16 15:26:18
f7948ace66dd541e5b60666d840cce6b6d95f0e6...e04d3e0563217c2beef475b4eecf90bde4c8193a,1,2,0,2,2,2014-06-08 08:35:00,2013-10-25 23:34:23
e04d3e0563217c2beef475b4eecf90bde4c8193a...99c9dbed4722c66428323401d560aaa521c6932f,1,6,0,6,1,2014-06-08 08:41:51,2013-12-03 09:24:32
99c9dbed4722c66428323401d560aaa521c6932f...aee8877988e4cf2de907550e2561a4793fa00496,1,6,5,11,1,2014-06-08 08:43:26,2013-09-09 08:51:07
aee8877988e4cf2de907550e2561a4793fa00496...519d37fc389e1f2faec6fd34cb8ee64a35fa154e,1,1,1,2,1,2014-06-08 08:46:33,2013-11-08 09:11:38
519d37fc389e1f2faec6fd34cb8ee64a35fa154e...50fe95a69e471345f20fb88ae62e14ada43c134a,1,3,3,6,2,2014-06-08 09:06:13,2013-10-25 23:17:21
50fe95a69e471345f20fb88ae62e14ada43c134a...999bd355f75f699fc227af025d7f7d508685f7de,1,1,1,2,1,2014-06-08 12:04:50,2014-01-03 13:43:31
999bd355f75f699fc227af025d7f7d508685f7de...7fbbf28e6e37e604c7821a24993d32a478d857f8,1,1,1,2,1,2014-06-10 07:52:57,2014-06-10 07:50:53
7fbbf28e6e37e604c7821a24993d32a478d857f8...09fdf763114fc571debff96b48c85ecfaeb7a2e4,1,1,1,2,1,2014-06-10 11:33:33,2014-04-28 22:12:49
09fdf763114fc571debff96b48c85ecfaeb7a2e4...89a5075528f5e36a442330f13f89a0782f1c555d,1,1,1,2,1,2014-06-28 08:12:19,2014-02-12 17:23:29
89a5075528f5e36a442330f13f89a0782f1c555d...82d557a84e26ea79a3ecc5a8e975890c23099a00,1,1,1,2,1,2014-06-28 08:12:19,2014-06-11 19:31:24
82d557a84e26ea79a3ecc5a8e975890c23099a00...340da08b9ad92654e5e9bb45a1aedc8645f78b74,1,2,2,4,1,2014-06-28 08:12:19,2014-04-16 18:23:01
340da08b9ad92654e5e9bb45a1aedc8645f78b74...49161e78472b484015c2080f7a724e95d42b4987,1,1,1,2,1,2014-06-28 08:12:19,2014-02-02 10:24:35
49161e78472b484015c2080f7a724e95d42b4987...c5d9fc996819488801864407ad1b7624acf3c26c,1,1,1,2,1,2014-06-28 08:12:20,2014-06-24 11:01:41
c5d9fc996819488801864407ad1b7624acf3c26c...f2b81e2977c264713a2a0f6971c8f312f7560b52,1,1,1,2,1,2014-06-28 08:12:20,2014-06-16 14:18:22
f2b81e2977c264713a2a0f6971c8f312f7560b52...bc2e3ff15a55fd21c6eabd502981e035dd5629c1,1,4,1,5,3,2014-06-28 08:12:20,2014-06-24 14:26:12
bc2e3ff15a55fd21c6eabd502981e035dd5629c1...75c02dd53e65357658f08bafaec99cc4b15a55ec,1,1,1,2,1,2014-06-28 08:12:20,2014-05-23 08:52:37
75c02dd53e65357658f08bafaec99cc4b15a55ec...dbca185b05b79cdc5308936415602d81fb444821,1,1,0,1,1,2014-06-28 08:12:20,2014-06-22 01:29:05
dbca185b05b79cdc5308936415602d81fb444821...ce9ec85c63412036163781d3501e9ed74432d391,1,3,0,3,1,2014-06-28 08:12:20,2014-06-01 23:28:42
ce9ec85c63412036163781d3501e9ed74432d391...08632bb1780d51f6748b5c09ef5232862313f78f,1,2,0,2,1,2014-06-28 09:30:26,2014-06-02 15:14:57
9acfaee2567bcbe8dcd3dc73a8d40c0983766fb6...af21abb134c023699b2d39db4463180ebdf81a83,1,1,1,2,1,2012-10-09 16:02:45,2012-10-09 16:02:45
c2ae9e09ca1f33ff1e13e629a0b2e6bdd19f83a9...5d6252c6d0e3598f2e19b9a02f7eb8a49317b1f1,1,3,3,6,2,2012-11-28 09:39:59,2012-11-28 09:39:59
c2ae9e09ca1f33ff1e13e629a0b2e6bdd19f83a9...7c768543df965ce5102b34e83fab78cf5e73b626,1,13,0,13,1,2012-11-25 16:15:16,2012-11-24 19:33:25
c2ae9e09ca1f33ff1e13e629a0b2e6bdd19f83a9...b2b5e3a7549fc323d3801054c51143142baf4f17,1,1,0,1,1,2012-11-24 15:12:40,2012-11-24 15:12:40
c2ae9e09ca1f33ff1e13e629a0b2e6bdd19f83a9...7991562e768733be9565fb05615c3f0f83ba4eb0,1,1,0,1,1,2012-11-24 07:23:44,2012-11-24 07:23:44
c2ae9e09ca1f33ff1e13e629a0b2e6bdd19f83a9...5a11228e93c667dd6d1cc87ec385ddf39d9e4726,4,2858,0,2858,4,2012-11-22 16:45:37,2012-11-22 16:38:39
c2ae9e09ca1f33ff1e13e629a0b2e6bdd19f83a9...af729cc47698e4a894c074f5c5d19384cf175baa,1,1,1,2,1,2012-11-21 22:48:44,2012-11-21 22:46:50
c2ae9e09ca1f33ff1e13e629a0b2e6bdd19f83a9...7be660bf1d0d8ae054b645278ea4e79e71c8beec,1,4,0,4,1,2012-11-20 18:13:04,2012-11-20 18:13:04
c2ae9e09ca1f33ff1e13e629a0b2e6bdd19f83a9...003b0da9e5b2b9f230296aeaedfc946579222d81,1,1,1,2,1,2012-11-20 15:01:39,2012-11-20 15:01:39
c2ae9e09ca1f33ff1e13e629a0b2e6bdd19f83a9...6f6a3c84356f19f14d69fdf994497a4ebb3fa8c1,1,3,1,4,2,2012-11-20 00:33:52,2012-07-29 00:32:11
6f6a3c84356f19f14d69fdf994497a4ebb3fa8c1...6c45d217af77552a4f0b09542985520a577af3d5,1,1,1,2,1,2012-11-20 00:33:52,2012-08-27 16:20:07
c2ae9e09ca1f33ff1e13e629a0b2e6bdd19f83a9...4c96e530a3b4818b3d378949a5d13377ae7f45e9,1,71,0,71,1,2012-11-19 14:21:53,2012-11-19 14:16:21
c2ae9e09ca1f33ff1e13e629a0b2e6bdd19f83a9...7d9518d48d25c9510b765af04b3910de9a20a117,2,2,147,149,2,2012-11-19 08:04:10,2012-11-19 08:04:10
c2ae9e09ca1f33ff1e13e629a0b2e6bdd19f83a9...9ba799111c254f6edb537255d447b7052c8a45e6,1,4,3,7,3,2012-11-16 15:50:41,2012-11-16 15:23:33
c2ae9e09ca1f33ff1e13e629a0b2e6bdd19f83a9...5b2ca3875a15bbae4f064cb98935461df2e93e15,1,1,1,2,1,2012-11-14 11:09:13,2012-11-14 11:09:13
c2ae9e09ca1f33ff1e13e629a0b2e6bdd19f83a9...f2ac08832ad8a6a156117c870ace622b9a6035ac,1,2,2,4,1,2012-11-12 16:53:09,2012-11-12 16:53:09
f2ac08832ad8a6a156117c870ace622b9a6035ac...91c57e6d426a1b5b3db3d7d9aaa5d922c00a5f09,1,1,1,2,1,2012-11-13 17:48:37,2012-11-13 17:48:37
c2ae9e09ca1f33ff1e13e629a0b2e6bdd19f83a9...ebeae4abe9b3ef2e626eb545e991bb5696c57de0,1,1,1,2,1,2012-11-09 21:53:22,2012-11-09 21:53:22
c2ae9e09ca1f33ff1e13e629a0b2e6bdd19f83a9...1b768a3b407103cd77d21d856051183960e0349e,1,18,1,19,3,2012-11-08 20:48:43,2012-11-08 20:48:43
c2ae9e09ca1f33ff1e13e629a0b2e6bdd19f83a9...99468cb4ec38f11b78ac71cae0c9ac70ac0a516e,1,14,11,25,3,2012-11-08 06:53:44,2012-11-08 06:53:44
c2ae9e09ca1f33ff1e13e629a0b2e6bdd19f83a9...f967f2bfd7b104da78ec1b1f1c6f893c2356dabc,1,2,2,4,1,2012-11-06 21:38:08,2012-11-06 21:38:08
c2ae9e09ca1f33ff1e13e629a0b2e6bdd19f83a9...15e0dc9ec937d98094419b59a89be60fe6dbff3f,2,54,1,55,3,2012-11-06 17:39:59,2012-11-06 17:39:59
15e0dc9ec937d98094419b59a89be60fe6dbff3f...8723a2ce58abd951c6664ddb19b29d612219956a,2,41,41,82,2,2012-11-06 17:44:50,2012-11-06 17:44:50
8723a2ce58abd951c6664ddb19b29d612219956a...8871c7a6d00a7c0a1e586e4f4d7a21c255231783,1,4,2,6,2,2012-11-07 12:28:44,2012-11-07 12:28:44
8871c7a6d00a7c0a1e586e4f4d7a21c255231783...72974ce409277c52eb30461e48f0755916a49f05,3,75,2,77,3,2012-11-21 17:29:09,2012-11-21 17:29:09
72974ce409277c52eb30461e48f0755916a49f05...50e538aeb5cc2ac9388390fd03c2189635f17b57,1,3,2,5,2,2012-11-21 17:35:28,2012-11-21 17:35:28
50e538aeb5cc2ac9388390fd03c2189635f17b57...89614be1af55be2f2fb2b49782f80644d619ef6f,1,28,13,41,5,2012-11-21 18:01:28,2012-11-21 18:01:28
89614be1af55be2f2fb2b49782f80644d619ef6f...9b1c64d7ffeb9ee9ea806a560bc929a683ff15f1,1,4,1,5,3,2012-11-21 18:20:43,2012-11-21 18:20:43
9b1c64d7ffeb9ee9ea806a560bc929a683ff15f1...2acd30ed0508ddbda188144c4f7b0c4bb351bd43,1,3,2,5,2,2012-11-21 18:35:31,2012-11-21 18:35:31
2acd30ed0508ddbda188144c4f7b0c4bb351bd43...a366456284d5a454d8c5a25fdf88ce428ca28f54,1,7,7,14,2,2012-11-22 11:20:31,2012-11-22 11:20:31
a366456284d5a454d8c5a25fdf88ce428ca28f54...60b7dd8af55d8e27a7326585753867f738c35dcd,1,45,17,62,9,2012-11-22 12:42:11,2012-11-22 12:42:11
60b7dd8af55d8e27a7326585753867f738c35dcd...5ff4a0030f1b29d8e45e6f1336232a81c1b93b3d,1,2,0,2,1,2012-11-22 16:20:53,2012-11-22 16:20:53
c2ae9e09ca1f33ff1e13e629a0b2e6bdd19f83a9...ec9b5500a57a39f8937e50424868493087fa40b4,1,1,1,2,1,2012-11-06 00:33:21,2012-11-06 00:33:21
c2ae9e09ca1f33ff1e13e629a0b2e6bdd19f83a9...19aefa2bd6168a9d75ce9ccd255ffac20425232e,1,5,1,6,1,2012-11-05 08:55:55,2012-11-05 08:55:55
c2ae9e09ca1f33ff1e13e629a0b2e6bdd19f83a9...cd0e7c5e4906c810b87f7c8f1b2c6c79e4b04889,1,2,2,4,1,2012-11-05 08:34:29,2012-11-05 08:34:29
c2ae9e09ca1f33ff1e13e629a0b2e6bdd19f83a9...4e513d72b9542b7b5079451e3380b4a98b0b7b56,1,19,1,20,3,2012-11-02 15:06:32,2012-11-02 15:06:32
c2ae9e09ca1f33ff1e13e629a0b2e6bdd19f83a9...15563c1b785cee11aa09b5ce1e2c6b51cea11bdd,1,119,0,119,1,2012-11-02 00:41:07,2012-11-02 00:41:07
c2ae9e09ca1f33ff1e13e629a0b2e6bdd19f83a9...263446d7259e22a21fe797284607fd2423fb076b,1,6,2,8,2,2012-10-30 22:42:52,2012-10-30 22:42:52
c2ae9e09ca1f33ff1e13e629a0b2e6bdd19f83a9...1c9f2e81066a2e86d001fe14b5be48660273b5e4,1,1,1,2,1,2012-10-29 17:26:19,2012-10-29 17:26:19
c2ae9e09ca1f33ff1e13e629a0b2e6bdd19f83a9...4d8fe543ff8099daad155e2c41974525370dc435,1,35,7,42,3,2012-10-26 23:51:48,2012-10-26 23:51:48
c2ae9e09ca1f33ff1e13e629a0b2e6bdd19f83a9...c592f55af1fbb2050b6060666312149711873133,1,6,2,8,1,2012-10-26 16:38:17,2012-10-26 16:38:17
c2ae9e09ca1f33ff1e13e629a0b2e6bdd19f83a9...7e2156a1b17a16243e92569c4df82c562f75ffb2,1,1,1,2,1,2012-10-21 22:12:00,2012-10-21 22:12:00
c2ae9e09ca1f33ff1e13e629a0b2e6bdd19f83a9...b0cf0674ef732b4102bf793543ceed3d23897ab6,1,1,1,2,1,2012-10-21 09:19:56,2012-10-21 09:19:56
c2ae9e09ca1f33ff1e13e629a0b2e6bdd19f83a9...91e5619a585f3c94a3c6c536a5b40c772f64bf85,1,23,0,23,1,2012-10-17 18:36:51,2012-10-17 05:36:56
c2ae9e09ca1f33ff1e13e629a0b2e6bdd19f83a9...c2cbd31b3ceaabcab09686c1c6ecf10c51715868,1,1,0,1,1,2012-10-17 17:00:18,2012-10-17 17:00:18
c2ae9e09ca1f33ff1e13e629a0b2e6bdd19f83a9...68cec79d32baeb96efc357ba94c0bfe5b4059c90,1,0,50,50,1,2012-10-13 21:43:55,2012-01-31 03:51:58
68cec79d32baeb96efc357ba94c0bfe5b4059c90...f7708d4181374cfbd223e071f7253018f28e5509,1,54,0,54,1,2012-10-13 21:44:31,2012-01-31 04:04:06
f7708d4181374cfbd223e071f7253018f28e5509...3839c6e9e62a2671b1d3f5662e4d2bc3984c3f9e,1,0,1,1,1,2012-10-13 21:50:40,2012-03-18 01:03:01
3839c6e9e62a2671b1d3f5662e4d2bc3984c3f9e...ff0cafa14db5b728f823ee486ec1bf5a9d2725eb,1,13,0,13,1,2012-10-13 22:10:40,2012-10-13 22:07:47
ff0cafa14db5b728f823ee486ec1bf5a9d2725eb...174c9177aa34b4c05bb5a1c6f637e6fa479a8e10,1,9,16,25,5,2012-10-17 14:04:42,2012-10-14 00:32:48
c2ae9e09ca1f33ff1e13e629a0b2e6bdd19f83a9...daa6ecebc1034dab162c90b4fd7f4cb605d969d4,1,3,1,4,1,2012-10-13 21:16:39,2012-10-13 20:53:34
c2ae9e09ca1f33ff1e13e629a0b2e6bdd19f83a9...8f7b126d2f7369dde512f61f9351809ebf27649e,1,1,1,2,1,2012-10-13 20:34:02,2012-10-13 20:33:28
e744bf22ca31dc165115a1409fee121f98e62871...c249c69065f1216bd83f5bd92e87f560e42675fb,24,23,133,156,36,2014-03-08 17:51:59,2014-03-08 17:51:16
c9e7129341978cf0ba4767b20b31cd2fa712c05f...b56e8fb47868f8433c7da809be3d4df833d9f59c,1,8,7,15,1,2014-03-16 17:14:34,2014-03-16 17:14:34
6b3c9537754b4a2180648258341ae2d7ca203d1e...5f31190ab9fd41fd1ffe2b0878674adc02933f9b,1,14,4,18,1,2014-03-21 15:49:52,2014-03-21 15:49:52
6b3c9537754b4a2180648258341ae2d7ca203d1e...8f7971349b653706071bc41e2fdb953bb6f22678,1,20,1,21,2,2014-03-14 20:17:03,2014-03-07 19:17:18
6b3c9537754b4a2180648258341ae2d7ca203d1e...ae2f6f34e3c3a335d6cb16df8ea88a709ef6b36b,1,8,0,8,1,2014-03-11 03:29:25,2014-03-11 03:29:25
6b3c9537754b4a2180648258341ae2d7ca203d1e...d41ac7fe3e52783054610c2cc57bbbfcdb2202b0,3,102,87,189,22,2014-03-04 19:25:54,2014-03-04 19:25:54
6b3c9537754b4a2180648258341ae2d7ca203d1e...c0b98cd6aca5b6148a5ee147b087772bfb9f5e21,1,132,0,132,1,2014-03-03 15:18:10,2014-03-03 15:18:10
6b3c9537754b4a2180648258341ae2d7ca203d1e...564a708d6af90b1bc5bf4d13e7ad80abca92ad74,1,12,11,23,3,2014-03-02 17:47:43,2014-03-02 17:47:35
6b3c9537754b4a2180648258341ae2d7ca203d1e...5ba96e9a053514d6beb25e5c27cf4af746f142ef,1,7,7,14,4,2014-03-02 08:59:27,2014-03-02 08:59:27
5ba96e9a053514d6beb25e5c27cf4af746f142ef...2691520d6f84fd0022fcb82a497042bb92c777b7,1,24,17,41,3,2014-03-02 19:13:55,2014-03-02 19:13:55
6b3c9537754b4a2180648258341ae2d7ca203d1e...6dcdfe61e2005728ff7e1e48d452de4b38294799,1,1,0,1,1,2014-02-28 11:55:15,2014-02-27 09:52:21
6b3c9537754b4a2180648258341ae2d7ca203d1e...f139401485ba389cbec5c83357e8827b1c53447b,1,1,0,1,1,2014-02-27 14:26:17,2014-02-27 14:26:17
f139401485ba389cbec5c83357e8827b1c53447b...da573f635648efb07603d7172bb08c2f271e1164,1,2,1,3,1,2014-02-27 14:26:54,2014-02-27 14:26:54
da573f635648efb07603d7172bb08c2f271e1164...fdbf0cbe4687c32846764695fabdf4acdb63a62f,1,6,1,7,1,2014-02-27 14:32:01,2014-02-27 14:32:01
6b3c9537754b4a2180648258341ae2d7ca203d1e...56babe6538450f85ac2e8ef3dd04bf1654c46d75,1,14,0,14,1,2014-02-27 00:35:24,2014-02-27 00:35:24
56babe6538450f85ac2e8ef3dd04bf1654c46d75...185cb6e37352cc0d92042e35d259b0de3f5f3886,1,3,1,4,1,2014-02-27 15:56:07,2014-02-27 15:56:07
861290e40b74b090495182f2f3730a27896b4dc5...b0fbe0d11ac60074b4fdc20e332bc2db3e0c0066,1,2,3,5,1,2014-02-21 21:16:12,2013-12-12 22:27:22
b0fbe0d11ac60074b4fdc20e332bc2db3e0c0066...b73ced397fc74618d92f748e2744e65f901b368f,1,1,1,2,1,2014-02-21 21:16:12,2013-12-14 01:13:18
b73ced397fc74618d92f748e2744e65f901b368f...3e5de21dc5b71e332a1526ae14beb662a66d6e26,1,1,1,2,1,2014-02-21 21:16:12,2013-12-14 03:30:29
3e5de21dc5b71e332a1526ae14beb662a66d6e26...a951600b4e81d73d71a098e48aa8d296be853bc9,1,1,1,2,1,2014-02-21 21:16:12,2013-12-16 08:24:24
861290e40b74b090495182f2f3730a27896b4dc5...840ae4382ec5b60f9a5f4ef500e40b7193c4ee87,1,1,1,2,1,2014-02-19 23:55:52,2014-02-19 23:55:52
861290e40b74b090495182f2f3730a27896b4dc5...c0f716b2e5ce7bd36baf812e8b6175a65bb1097e,1,1,1,2,1,2014-02-19 20:33:02,2014-02-19 20:33:02
861290e40b74b090495182f2f3730a27896b4dc5...bd4f7e24ea1451eeab351b0a68ac3729213b369b,1,2,2,4,2,2014-02-19 12:08:47,2014-02-19 12:08:47
500cbbc79bf407f6a7933d9a8376c1bef2fb7ea9...8b667b229973dee2abb52edacbd056cbe52bb8f7,1,1,1,2,1,2014-03-06 23:09:04,2014-03-06 23:09:04
8b667b229973dee2abb52edacbd056cbe52bb8f7...7378765a79491c836831543a6da3d88dac9b7568,1,4,0,4,1,2014-03-06 23:22:37,2014-03-06 23:22:37
7378765a79491c836831543a6da3d88dac9b7568...fd8ce7f8e3ea96a7746e46339e447f7cbb83aa57,1,1,0,1,1,2014-03-06 23:23:37,2014-03-06 23:23:37
500cbbc79bf407f6a7933d9a8376c1bef2fb7ea9...598a9c6f990756386517d66b6bcf77e53791e905,1,4,0,4,1,2014-02-20 18:18:53,2014-02-20 18:18:53
12415a99d25beee8957fb93a49390901e3e134b2...3be2e34d9638b7e552208596eca49fbc66c05574,1,2,2,4,2,2014-03-17 02:17:30,2014-03-05 12:58:18
b6cbba9dfee5985232b473e94595c2fb1ab83715...cfe468f6f6bf7cfecb2c832c39f4bf9a065ef6fd,1,10,2,12,3,2014-03-13 18:44:58,2014-03-13 18:44:58
b6cbba9dfee5985232b473e94595c2fb1ab83715...5f5e5508b0560339f7f57fa125496d0b9f1ea077,1,1,1,2,1,2014-03-13 05:37:25,2014-03-13 05:37:25
46d4606e66c8060d281f181db8e8fdae4c264290...426f5f483925f5bd9d3f78fa03d6f7d9818bb288,1,3,3,6,3,2013-07-03 14:29:42,2013-07-03 14:29:42
46d4606e66c8060d281f181db8e8fdae4c264290...c164f2aab693f4b32c209cb34784818fba434b2d,1,4,1,5,2,2013-07-01 16:22:25,2013-07-01 16:22:25
46d4606e66c8060d281f181db8e8fdae4c264290...a18fa835503acb44ac656c5bb592873e66bd40f1,1,129,0,129,1,2013-06-25 14:06:24,2013-06-25 13:12:01
46d4606e66c8060d281f181db8e8fdae4c264290...decf9cdb3143fde3d2e608c008e61ba9838c0deb,1,23,1,24,4,2013-06-21 09:21:25,2013-06-21 09:21:25
decf9cdb3143fde3d2e608c008e61ba9838c0deb...85c43f8a894b7aa521a68d096e39587855d2d35f,1,0,6,6,1,2013-06-21 09:38:17,2013-06-21 09:38:17
86a889ea083d341ba2bc48656008e5af46a3df2d...b832ec92086df4648e270b3d44a10fe058ffd8f4,1,94,0,94,1,2013-06-11 12:58:25,2013-06-11 12:58:25
b832ec92086df4648e270b3d44a10fe058ffd8f4...dbcaafd03b084b94ebef9b04e91b3f04ad05d374,1,1,1,2,1,2013-06-12 09:54:45,2013-06-12 09:54:08
86a889ea083d341ba2bc48656008e5af46a3df2d...1e86e65e3a424145bda6096f7770c448f0286dce,1,1,1,2,1,2013-06-06 19:34:36,2013-06-06 19:34:36
1e86e65e3a424145bda6096f7770c448f0286dce...ec177659df38865c77c930c3f6223069e0cdab78,1,1,1,2,1,2013-06-06 20:37:39,2013-06-06 20:37:39
86a889ea083d341ba2bc48656008e5af46a3df2d...97849bd9b65300a839f3c340e9dbb30b494d9898,1,4,4,8,4,2013-06-06 11:06:29,2013-06-06 11:06:29
86a889ea083d341ba2bc48656008e5af46a3df2d...b1f41f6fa5fbfb9317704fa1416a8d081b4e2310,1,2,0,2,1,2013-06-06 05:18:25,2013-06-06 05:18:25
86a889ea083d341ba2bc48656008e5af46a3df2d...8300f62e92bd63a1b221889f98318e9c5b441e0b,3,6,0,6,3,2013-06-06 03:40:02,2013-06-06 03:40:02
86a889ea083d341ba2bc48656008e5af46a3df2d...0118e182894b1756ce292936b6a1ff64582879b4,1,3,3,6,3,2013-06-05 19:37:02,2013-06-05 19:37:02
86a889ea083d341ba2bc48656008e5af46a3df2d...82666e25e31451527520ab49a819e4135ed8a34c,1,36,0,36,1,2013-06-05 17:22:33,2013-06-05 17:22:33
86a889ea083d341ba2bc48656008e5af46a3df2d...46f0d8dba95aae400e4d9fc825691d0119cf7189,4,153,0,153,5,2013-06-05 13:16:51,2013-06-05 13:16:51
86a889ea083d341ba2bc48656008e5af46a3df2d...4b945a856c7d43891b645e99a91eb9d38b62b64a,3,281,0,281,3,2013-06-05 13:12:56,2013-06-05 13:12:56
86a889ea083d341ba2bc48656008e5af46a3df2d...6f8e8c58a05a3ff9d48ade08544e3a4d5cc4185d,1,1,0,1,1,2013-06-01 12:32:38,2013-06-01 12:32:38
67b2781f6200a0dff35055eb67937a0df2be2c51...6041e4938cc559b908d83b5664166cc1fd02f31e,1,2,2,4,2,2013-07-16 08:54:54,2013-07-16 08:54:54
61e3951e4be2f496d8ce8022afc58817c06e5dee...236c8de7f31a71878279ed2421bd2547ab3cdd03,1,1,0,1,1,2014-05-06 17:45:26,2014-05-06 17:45:26
236c8de7f31a71878279ed2421bd2547ab3cdd03...38fe100efe9b7d4df87746818bae508c4c00d4a6,1,2,0,2,2,2014-05-06 17:46:55,2014-05-06 17:46:55
38fe100efe9b7d4df87746818bae508c4c00d4a6...7f8ee9aabe5f551a83babd4083ab6490cd324bda,1,1,0,1,1,2014-05-06 17:48:49,2014-05-06 17:48:49
7f8ee9aabe5f551a83babd4083ab6490cd324bda...30d9952b6235694cb7fa370fcefebac623d48ce6,1,1,0,1,1,2014-05-06 17:53:12,2014-05-06 17:53:12
30d9952b6235694cb7fa370fcefebac623d48ce6...8ed800510262157adab151cad12959095a5a1b62,1,3,3,6,2,2014-05-15 19:26:39,2014-05-15 19:26:39
61e3951e4be2f496d8ce8022afc58817c06e5dee...190fcdffa7bc413dc7a9ebef4a6eaed37beb6896,1,17,0,17,1,2013-10-09 15:00:39,2013-10-09 14:42:28
61e3951e4be2f496d8ce8022afc58817c06e5dee...33b1a3bcfed1d52d48a3a467f81da1599d2fa883,1,11,0,11,1,2013-10-04 20:29:33,2013-10-04 20:29:33
33b1a3bcfed1d52d48a3a467f81da1599d2fa883...9afb139d20f12f93c086140db3e9bfd4913f15a0,1,2,1,3,1,2013-10-04 22:56:17,2013-10-04 22:56:17
61e3951e4be2f496d8ce8022afc58817c06e5dee...387de3a57e1927b1db210419b87e2404f8f809de,1,1,1,2,1,2013-10-03 06:48:49,2013-10-03 06:48:49
387de3a57e1927b1db210419b87e2404f8f809de...671db71d211e5596cb64c6185ac183c3d6930274,1,1,1,2,1,2013-10-03 10:00:12,2013-10-03 10:00:12
61e3951e4be2f496d8ce8022afc58817c06e5dee...fa85b4d6ee4817a91bece2987f72da22ffe007a4,1,2,2,4,2,2013-10-02 21:24:21,2013-10-02 21:24:21
61e3951e4be2f496d8ce8022afc58817c06e5dee...2be4158d8fc5f8e4999ddcbcd100c129ab7e9147,1,30,5,35,4,2013-10-02 08:51:21,2013-10-02 08:51:21
61e3951e4be2f496d8ce8022afc58817c06e5dee...05b3ea342ad581d02ed652a4bbe29786026a5b50,1,1,1,2,1,2013-10-01 16:08:15,2013-10-01 16:08:15
61e3951e4be2f496d8ce8022afc58817c06e5dee...244533320062afd470e4aa6aab92e1532cf2fec3,1,5,3,8,2,2013-09-24 18:20:52,2013-09-24 18:20:52
61e3951e4be2f496d8ce8022afc58817c06e5dee...e8c3619486289fc21158ecd63d7fd91e3576c75c,1,10,5,15,3,2013-09-24 09:58:48,2013-09-24 09:58:48
c78277fd8bda5fec87504469afdf121355876006...c4d3de1ea07b0d53f8b9b011ac5d44e23ac0c747,1,1,0,1,1,2015-01-28 12:02:36,2015-01-28 12:02:36
c78277fd8bda5fec87504469afdf121355876006...5f79ab5547f51bd32dcd0a1b21fc26c8720711ba,1,9,15,24,5,2015-01-28 03:00:07,2015-01-28 03:00:07
5f79ab5547f51bd32dcd0a1b21fc26c8720711ba...be7028012ecc97bf8976d5de0aed51869720be2a,1,2,2,4,2,2015-02-04 06:00:51,2015-02-04 06:00:51
c78277fd8bda5fec87504469afdf121355876006...4533c7a31c737622782ce3233d2eb536f9cb4f2e,3,65,8,73,13,2015-01-25 23:13:39,2015-01-25 23:13:39
c78277fd8bda5fec87504469afdf121355876006...49549d95582832a25957af6daca6621f60c775ac,1,2,2,4,2,2015-01-21 02:25:07,2015-01-21 02:25:07
c78277fd8bda5fec87504469afdf121355876006...fd3a34844f649b2be21fe4e5504a2cf086d1340b,1,2,2,4,2,2015-01-21 02:24:41,2015-01-21 02:24:41
c78277fd8bda5fec87504469afdf121355876006...b2f8764855e14d113bb2cfd1cd788bd7baaae05a,1,22,0,22,1,2015-01-15 18:55:32,2015-01-15 18:55:32
c78277fd8bda5fec87504469afdf121355876006...5cb0ed98d1e5f0119e7871e21948a6b931f14a78,1,1,1,2,1,2015-01-14 23:09:41,2015-01-14 23:09:41
c78277fd8bda5fec87504469afdf121355876006...3abc2a4375ef2b623aa579d991aa802f3746de52,1,13,13,26,1,2015-01-12 17:26:04,2015-01-12 17:26:04
c78277fd8bda5fec87504469afdf121355876006...3c4998319ab0796221a70ba19437629afb18ac31,1,1,0,1,1,2015-01-12 13:57:00,2015-01-12 13:57:00
c78277fd8bda5fec87504469afdf121355876006...5b90092555dc13c7577f1cad93857a859be02711,1,2,0,2,1,2015-01-11 14:52:08,2015-01-11 14:52:08
c78277fd8bda5fec87504469afdf121355876006...f997ed7ed8028e400216cfac9bee64b53017e588,1,16,0,16,1,2015-01-10 14:38:49,2015-01-10 14:38:49
c78277fd8bda5fec87504469afdf121355876006...a55a313328e7437e1ff9fcdc659e247c61a438f0,1,1,0,1,1,2015-01-09 13:46:02,2015-01-09 13:40:03
550ccca91cb45fcf26a8f2c3c60da675b995e3f3...b39dbec7e9d49083be5d9034604f98f1a4d264fd,1,4,2,6,3,2015-02-15 16:29:26,2015-02-03 16:58:09
550ccca91cb45fcf26a8f2c3c60da675b995e3f3...ec9525b94e938c476c07e68bb479eb848bb5dbc9,2,32,0,32,2,2015-02-15 14:39:50,2015-02-15 14:39:50
550ccca91cb45fcf26a8f2c3c60da675b995e3f3...6967393fe6dacc45f5339e0cfacbabe41f8882fb,1,6,0,6,1,2015-02-13 07:19:43,2015-02-13 07:19:43
550ccca91cb45fcf26a8f2c3c60da675b995e3f3...3ba10ad0a2ed85c26e096126a7899a401cf8f9e7,1,40,0,40,1,2015-02-11 00:19:42,2015-02-11 00:19:42
550ccca91cb45fcf26a8f2c3c60da675b995e3f3...7f636ba5901b1abe9bb01d94b9e290bed982a873,1,1,1,2,1,2015-02-09 21:12:02,2014-11-18 04:38:22
7f636ba5901b1abe9bb01d94b9e290bed982a873...013b2bffcf11d0bc3ff29c96a8e6846166639c2c,1,1,1,2,1,2015-02-09 21:12:02,2014-11-18 04:43:19
013b2bffcf11d0bc3ff29c96a8e6846166639c2c...349493a0b81ae98117ea1a115a92ba509476298f,1,1,1,2,1,2015-02-09 21:12:02,2015-02-09 20:43:51
550ccca91cb45fcf26a8f2c3c60da675b995e3f3...6bccb1a7b0448610d10518e3ac9f47315e94e7b9,1,1,1,2,1,2015-02-09 17:18:15,2015-02-09 17:18:15
550ccca91cb45fcf26a8f2c3c60da675b995e3f3...fc606d91a0cc8f58c69af39544ddefcb2bdccc55,1,2,0,2,1,2015-02-07 16:57:53,2015-02-07 16:57:53
550ccca91cb45fcf26a8f2c3c60da675b995e3f3...2e0da6864bc0d770855524ad54eecd4f0cd72829,4,913,0,913,4,2015-02-05 06:43:42,2015-01-30 19:31:05
550ccca91cb45fcf26a8f2c3c60da675b995e3f3...7de44dbdb767e52e509010b1468126259e0b8b87,1,8,0,8,1,2015-02-04 11:56:58,2015-02-04 11:56:58
550ccca91cb45fcf26a8f2c3c60da675b995e3f3...431faa924ea2a4176b8b83a75ba856f097e6a089,2,41,0,41,2,2015-02-04 10:09:34,2015-02-04 10:09:34
550ccca91cb45fcf26a8f2c3c60da675b995e3f3...8cb97d6f22378940e0238967d08f10ba62a630ce,1,1,3,4,2,2015-02-04 06:54:17,2015-02-04 06:54:17
550ccca91cb45fcf26a8f2c3c60da675b995e3f3...f2130fa1a3f440418a6c48f9bace43ce7443117f,1,5,1,6,2,2015-02-02 19:49:24,2015-02-02 19:49:24
550ccca91cb45fcf26a8f2c3c60da675b995e3f3...8ccfc3d444a36905003397083ac5ece46eda2a3b,1,1,1,2,1,2015-02-01 22:52:07,2015-01-08 19:33:51
550ccca91cb45fcf26a8f2c3c60da675b995e3f3...e60458793ab9703bb65adb6c326f43c6bd5fd126,1,1,1,2,1,2015-02-01 22:32:38,2014-12-17 10:11:53
13e5afe805f28749f4aa6a5e82272760a62ad573...4fc6dccb4286828c7cd53d3612ec69b0c0d9aaf2,1,20,4,24,4,2015-02-10 18:38:11,2014-12-20 07:24:26
4fc6dccb4286828c7cd53d3612ec69b0c0d9aaf2...b7e5dd35efb0750634eb16b7040337ce80f67684,1,6,6,12,1,2015-02-10 18:52:58,2015-02-10 18:43:25
b7e5dd35efb0750634eb16b7040337ce80f67684...2e41d06b7655067272cee1e54d2d66693136a90f,1,1,1,2,1,2015-02-10 18:53:40,2015-02-10 18:53:40
13e5afe805f28749f4aa6a5e82272760a62ad573...c3940cf44a58393906e896decc93542c3ab17f4a,1,2,1,3,1,2015-02-10 18:35:00,2014-03-14 10:52:40
c3940cf44a58393906e896decc93542c3ab17f4a...f04246aa4820031c025ed25baf0df23d786d38fd,1,7,6,13,2,2015-02-10 18:35:00,2014-04-19 01:04:58
13e5afe805f28749f4aa6a5e82272760a62ad573...0cc3afe27788e35d5f72236f41a7e4514c11491d,1,1,1,2,1,2015-02-10 18:32:59,2014-12-05 08:57:59
0cc3afe27788e35d5f72236f41a7e4514c11491d...5f4e8e57da117b5fc2325ea411aafc66053b8570,1,3,2,5,3,2015-02-10 18:32:59,2013-07-25 17:37:11
5f4e8e57da117b5fc2325ea411aafc66053b8570...ef220f0928269f3cdb613db3d3f9ba7775317109,1,3,0,3,2,2015-02-10 18:32:59,2013-08-17 15:11:21
ef220f0928269f3cdb613db3d3f9ba7775317109...6fb866183d84e53fa009853691e5c0bdd101820b,1,9,12,21,1,2015-02-10 18:32:59,2015-01-04 21:24:55
13e5afe805f28749f4aa6a5e82272760a62ad573...80d856e1655cc2b2e9d6899bae884631283a8063,1,28,27,55,6,2015-02-10 18:32:52,2014-12-26 21:33:36
80d856e1655cc2b2e9d6899bae884631283a8063...80ba54a94fe7d7628d159823d5c63e12811c68b0,1,3,0,3,2,2015-02-10 18:32:52,2014-12-27 01:27:24
80ba54a94fe7d7628d159823d5c63e12811c68b0...adaea31ca013054094a45b009ab22382c4d94666,1,1,1,2,1,2015-02-10 18:32:52,2014-12-27 01:30:16
adaea31ca013054094a45b009ab22382c4d94666...c45885093fd8fa3375286ef1dcba9bc296e08a80,1,1,0,1,1,2015-02-10 18:32:52,2014-12-27 01:56:30
c45885093fd8fa3375286ef1dcba9bc296e08a80...e8daf8150e923bfd30769e9a55c15daec523996b,1,1,1,2,1,2015-02-10 18:32:52,2014-12-27 02:15:56
e8daf8150e923bfd30769e9a55c15daec523996b...02d75684f3ddd2dcd181c9265545d5639d09bd5a,1,1,1,2,1,2015-02-10 18:32:52,2015-01-04 00:40:25
13e5afe805f28749f4aa6a5e82272760a62ad573...25b1cd687b28cb8d05229130ee5a0e2494276894,2,15,36,51,5,2015-02-10 18:22:38,2014-01-10 22:32:20
25b1cd687b28cb8d05229130ee5a0e2494276894...ace98846eac9726f7161617291e1fd2affc3f4eb,1,11,0,11,2,2015-02-10 18:22:38,2014-01-10 22:40:22
ace98846eac9726f7161617291e1fd2affc3f4eb...d33b0aae917c62012bf203538ba86d6236869834,2,9,14,23,2,2015-02-10 18:22:39,2014-01-10 22:50:19
d33b0aae917c62012bf203538ba86d6236869834...101149b1ae6fb5ce0b982289fca901b2feab5439,2,7,8,15,2,2015-02-10 18:22:39,2014-01-10 22:53:14
101149b1ae6fb5ce0b982289fca901b2feab5439...83c4e0620689d2410056bddcdfbf8e300673e982,2,3,3,6,2,2015-02-10 18:22:39,2014-01-10 22:55:10
83c4e0620689d2410056bddcdfbf8e300673e982...724143c3297249961977a957d8fa1bc92cd7be2c,1,0,6,6,1,2015-02-10 18:22:39,2014-01-10 23:04:53
724143c3297249961977a957d8fa1bc92cd7be2c...4b4292a496c139039807f082425cc5507f762c0d,1,1,1,2,1,2015-02-10 18:22:39,2014-03-14 23:00:14
4b4292a496c139039807f082425cc5507f762c0d...51946eb3ce8021aebe940f879225828d89c12317,1,0,1,1,1,2015-02-10 18:22:39,2015-02-09 19:29:10
51946eb3ce8021aebe940f879225828d89c12317...2193135ebc4ce0778ff6949b448e4526dbd34284,13,12,39,51,20,2015-02-10 18:22:50,2015-02-09 19:43:48
13e5afe805f28749f4aa6a5e82272760a62ad573...5fe22fcbc6364aaacce373d71fa7d6b6f2d11a33,1,23,6,29,4,2015-02-10 18:18:14,2014-12-15 23:43:01
5fe22fcbc6364aaacce373d71fa7d6b6f2d11a33...e93fd939adb69a498ba1296b1ce0c99786e26084,1,4,6,10,2,2015-02-10 18:18:15,2014-12-16 00:29:06
e93fd939adb69a498ba1296b1ce0c99786e26084...999bab187c0a59301f4055fb6239a5352d3c96ab,1,6,1,7,3,2015-02-10 18:18:15,2014-12-20 19:35:52
999bab187c0a59301f4055fb6239a5352d3c96ab...282240bf37d6fd9979da2c3a41006824dbb4e268,1,9,2,11,1,2015-02-10 18:18:15,2014-12-24 00:33:28
4131a59d1a57d53bf711115317116a6c57483636...aa82bd7400d2c604987236f8f65c353143d56324,1,1,2,3,2,2014-07-09 04:51:48,2014-07-09 04:51:48
4131a59d1a57d53bf711115317116a6c57483636...14ebcc83bec267859e2948f36f48cc69f5150def,1,8,8,16,4,2014-07-01 05:48:00,2014-06-27 22:03:10
14ebcc83bec267859e2948f36f48cc69f5150def...392af393e81a4f2bc3405bfd9e1f98675f0bd886,1,1,0,1,1,2014-07-15 13:13:13,2014-07-15 13:13:13
c925aabea9b8b0578735fab4c75bec86e4d20f16...bf134e9cb390c7ff464c1278782084bef2fae141,1,2,2,4,2,2014-07-15 19:37:53,2014-07-15 19:37:53
c925aabea9b8b0578735fab4c75bec86e4d20f16...346f6b7d24d6021efa8c5167088f98c10f00ad3f,4,113,91,204,58,2014-07-15 15:44:23,2014-07-15 15:42:30
c925aabea9b8b0578735fab4c75bec86e4d20f16...d29c53cb101d6949f9d2c341e511533046568b86,1,33,4,37,2,2014-07-15 14:42:22,2014-07-02 10:22:33
d29c53cb101d6949f9d2c341e511533046568b86...c4eec0b1349168a0c23819d153401ce7e802260c,1,1,0,1,1,2014-07-15 14:42:23,2014-07-02 18:35:49
c4eec0b1349168a0c23819d153401ce7e802260c...a22e0256a35e6e3378f253090029abfaf917a81c,1,0,1,1,1,2014-07-15 14:42:23,2014-07-02 18:36:16
a22e0256a35e6e3378f253090029abfaf917a81c...f5e69c6cab20f1ac6dbb67f0cd7b49d079e0a76c,1,0,1,1,1,2014-07-15 14:42:23,2014-07-02 18:36:33
f5e69c6cab20f1ac6dbb67f0cd7b49d079e0a76c...fdbfd410907c30c28184a339323fd5703cbd2309,1,0,1,1,1,2014-07-15 14:42:23,2014-07-04 12:29:16
fdbfd410907c30c28184a339323fd5703cbd2309...f8ea9270ebcb012aee8e0691e5ab2fc700e56492,1,0,1,1,1,2014-07-15 14:42:23,2014-07-04 12:33:24
f8ea9270ebcb012aee8e0691e5ab2fc700e56492...20c84eaafc0bddc8584902898c245dbe1a7b0f8f,1,13,0,13,5,2014-07-15 14:42:23,2013-05-14 17:15:13
20c84eaafc0bddc8584902898c245dbe1a7b0f8f...cfc98d3f8c234b48d34961ce18274ad365ebb97b,1,1,1,2,1,2014-07-15 14:42:23,2014-07-04 12:56:44
cfc98d3f8c234b48d34961ce18274ad365ebb97b...11f0d273b5849275909d5fcf37e4771e0449f897,1,1,0,1,1,2014-07-15 14:42:23,2014-07-04 13:16:29
11f0d273b5849275909d5fcf37e4771e0449f897...b007fee187bb111c13c0c95b39763b28dc3f8ca0,1,1,0,1,1,2014-07-15 14:42:23,2014-07-04 13:17:02
b007fee187bb111c13c0c95b39763b28dc3f8ca0...34bc91e79d8cbb7b889402746770f1671d9b5872,2,50,1,51,2,2014-07-15 14:42:23,2014-07-07 12:23:37
34bc91e79d8cbb7b889402746770f1671d9b5872...4b997429b3785aefa929732d7dbf431e7884bc4d,1,5,0,5,1,2014-07-15 14:42:23,2014-07-07 18:07:02
5728a5608d7e802999266ff2387747e4957be938...db3dd6d755776daf19b55f6a1cae080ae684030a,1,2,3,5,2,2014-07-29 07:21:10,2014-07-29 07:21:10
5728a5608d7e802999266ff2387747e4957be938...9d76784b3ed85115e1830d48d91b3a08236a6538,1,10,2,12,3,2014-07-15 13:22:24,2014-07-15 13:22:24
5728a5608d7e802999266ff2387747e4957be938...6adc89131c1cf9fe79c3eaa3df1cd65a292bfc4d,1,1,1,2,1,2014-07-15 13:20:39,2014-07-15 13:20:39
5728a5608d7e802999266ff2387747e4957be938...6b3a723c370e9867feb68f13f5bbb7adfd000e63,1,1,1,2,1,2014-07-14 23:41:57,2014-07-14 23:41:57
5728a5608d7e802999266ff2387747e4957be938...5e328e3a9c0784521ae4170f7958183c352bae83,4,35,2,37,6,2014-07-11 13:11:49,2014-07-11 13:11:49
5e328e3a9c0784521ae4170f7958183c352bae83...5f38a537cef0d79c9d53c01e8f88d150e985c70a,4,6,11,17,6,2014-09-16 16:59:52,2014-09-16 16:59:52
5f38a537cef0d79c9d53c01e8f88d150e985c70a...90762eee49efcdfd6b92ad5d5d9e5f43d113ae0b,1,3,1,4,2,2014-09-17 05:41:48,2014-09-17 05:41:48
90762eee49efcdfd6b92ad5d5d9e5f43d113ae0b...3a3973284534c318e2cb987a0db1121302d04e10,1,2,4,6,3,2014-10-14 06:35:01,2014-10-14 06:35:01
5728a5608d7e802999266ff2387747e4957be938...8d762e46f7c276ec81c1d0e1eda3dda250913689,1,2,0,2,1,2014-07-07 13:12:47,2014-07-07 13:12:47
5728a5608d7e802999266ff2387747e4957be938...676fb4e4203eae0f3755a729a6582eb32fe9834f,1,9,12,21,4,2014-07-03 02:38:19,2014-07-03 01:14:02
676fb4e4203eae0f3755a729a6582eb32fe9834f...2927ce37141d52a8b4e2ca1e60d0cf0688125781,1,5,1,6,2,2014-07-03 02:45:49,2014-07-03 02:45:49
12f416b125501e9faaae061bc55b833158348156...5c983257726dfc8ac97d5a5e259dcaa9540b808b,1,1,1,2,1,2012-11-28 09:47:31,2012-11-28 09:47:31
5ff4a0030f1b29d8e45e6f1336232a81c1b93b3d...75e5a6dcfc20a582a4b4653a25c074f4263dd7dc,2,1,124,125,2,2012-11-25 22:34:12,2012-11-25 22:34:12
22f827e122187032afb1f473d19a4238899e8ecd...ad3f59252beaf1a28e188dfc431a267875ca50b9,2,6,0,6,2,2013-04-16 07:22:28,2013-04-16 07:22:28
22f827e122187032afb1f473d19a4238899e8ecd...2916ef719444040528ffd1a56d91bdd1fb1b5aa5,1,5,1,6,1,2013-03-25 16:57:55,2013-03-25 16:57:55
22f827e122187032afb1f473d19a4238899e8ecd...f29daef2973018e60900553b0ea69074a5d9a5de,1,1,0,1,1,2012-12-02 12:16:58,2012-12-02 12:16:58
ca900216302aa1138c793971cf877b5d4e88fb06...1509ac9a0414801dbbe45060eae19ae6e6e9841c,1,1,1,2,1,2014-03-22 12:51:26,2014-03-22 12:51:26
ca900216302aa1138c793971cf877b5d4e88fb06...c3150edad2b8d9494127afa9528519a07bf8a64a,1,1,1,2,1,2014-03-22 01:18:29,2014-03-22 01:18:29
c3150edad2b8d9494127afa9528519a07bf8a64a...610655e827e5f4e5d081b9b0cd78129751eab272,1,1,1,2,1,2014-03-22 16:24:58,2014-03-22 16:24:58
ca900216302aa1138c793971cf877b5d4e88fb06...e537ee9db95966af3439b550c15d8971805c73cf,1,24,8,32,5,2014-03-21 02:10:44,2014-03-21 02:10:44
e537ee9db95966af3439b550c15d8971805c73cf...55a9d685fd960390a4f400ac461d901049a78beb,1,9,9,18,6,2014-03-21 02:29:06,2014-03-21 02:29:06
55a9d685fd960390a4f400ac461d901049a78beb...c5413d7dd18cad7cd4eb32ddf1b9976863b87dfa,1,9,9,18,6,2014-03-21 02:34:43,2014-03-21 02:34:43
c5413d7dd18cad7cd4eb32ddf1b9976863b87dfa...32a7824182731081c7cbeba363be7b6f56aeb2a5,1,4,0,4,1,2014-03-21 16:24:59,2014-03-21 16:24:59
ca900216302aa1138c793971cf877b5d4e88fb06...ef343eef307cf8d329240dcdf5e973f1d18d410e,1,15,35,50,5,2014-03-20 09:43:33,2014-03-20 09:43:33
ca900216302aa1138c793971cf877b5d4e88fb06...fb2d6eb5679370b7e8c971ab75b85d8f57d0da1b,1,10,9,19,9,2014-03-18 18:13:54,2014-03-17 16:01:00
ca900216302aa1138c793971cf877b5d4e88fb06...645fceb38b091e1dd5c9804a444730a9837bae07,1,4,1,5,2,2014-03-18 09:52:25,2014-03-18 09:52:25
ca900216302aa1138c793971cf877b5d4e88fb06...d3babe0d79dc7dbcce15c9285c4c5b604f595c9a,1,1,1,2,1,2014-03-17 16:02:47,2014-03-17 16:02:47
ca900216302aa1138c793971cf877b5d4e88fb06...a869ec9bc848a011a3068fbaed52b4cbd04681aa,1,1,1,2,1,2014-03-17 15:07:46,2014-03-17 15:07:46
ca900216302aa1138c793971cf877b5d4e88fb06...baf2ab1bf1096b954a759739cc41c587fb0cf5b2,1,0,3,3,1,2014-03-17 09:05:56,2014-03-17 09:05:56
598a9c6f990756386517d66b6bcf77e53791e905...7a546362d35d6c74f9c301aa477594fdf2cc1bfc,1,51,37,88,15,2014-02-22 06:47:56,2014-02-22 06:47:56
7a546362d35d6c74f9c301aa477594fdf2cc1bfc...c397000b3b0c1cf3bceb95dfc5fcdaf1844aa751,1,1,1,2,1,2014-02-22 06:48:38,2014-02-22 06:48:38
5d6a06bda64c59f94a9e7ef506d4523194a031b6...bab1800ded30331b289550b1de8d60bb64f5512f,1,2,2,4,2,2013-06-12 17:22:47,2013-06-12 17:22:47
5d6a06bda64c59f94a9e7ef506d4523194a031b6...9703eba66e2a45ee28cd895a852853fd34ea4ff0,1,14,14,28,12,2013-06-12 17:04:08,2013-06-12 17:04:08
5d6a06bda64c59f94a9e7ef506d4523194a031b6...ab7604e5c2a4e07e656b3e4edf0d3e45407665e5,1,3,1,4,1,2013-06-11 18:37:35,2013-06-11 18:37:35
5d6a06bda64c59f94a9e7ef506d4523194a031b6...3f44f51e9ca1b196e4c3caa439558996abdac273,1,2,0,2,1,2013-06-11 12:51:26,2013-06-11 12:50:32
5d6a06bda64c59f94a9e7ef506d4523194a031b6...d6945e2daad2b980da8cd6af9b1d1ea4f874ec95,1,2,0,2,1,2013-06-11 09:23:02,2013-06-11 09:23:02
5d6a06bda64c59f94a9e7ef506d4523194a031b6...894e1caa0a7fb2e02aa139d23d0b05d62c6d8932,1,3,4,7,2,2013-06-08 18:36:33,2013-06-08 17:02:32
5d6a06bda64c59f94a9e7ef506d4523194a031b6...e73dd2cdf895879a3584eca3a475f33f72f48da8,1,15,10,25,4,2013-06-08 18:36:14,2013-06-08 18:25:52
5d6a06bda64c59f94a9e7ef506d4523194a031b6...c5aaa11ceee00142e0f385f157b90910d692705f,1,2,1,3,3,2013-06-07 21:36:07,2013-06-07 21:36:07
78dba754d183804079474aa2b1390bd96cb67583...ebfc9042ed2121c1d330a6767736fbf7bff2e369,1,9,0,9,2,2013-06-25 04:29:48,2013-06-25 04:26:42
78dba754d183804079474aa2b1390bd96cb67583...87a1d8a02df5413b4e718eb0fb486535f0aae8e3,1,1,1,2,1,2013-06-25 04:08:02,2013-06-25 04:08:02
78dba754d183804079474aa2b1390bd96cb67583...711e96b1a277b1d5b9771c2eec19fa34f796839b,1,17,9,26,2,2013-06-23 09:34:03,2013-06-23 09:34:03
711e96b1a277b1d5b9771c2eec19fa34f796839b...64fc125eba09f48f17184cde4403267c1cb16999,1,1,1,2,1,2013-06-23 10:25:35,2013-06-23 10:25:35
78dba754d183804079474aa2b1390bd96cb67583...bc65443734ec96ddc8da61c022d630fa8303765a,1,4,2,6,3,2013-06-23 01:20:11,2013-06-22 22:58:45
bc65443734ec96ddc8da61c022d630fa8303765a...55f7990607ae413ae9f1edacf94f9c6369456983,1,1,1,2,1,2013-06-23 01:20:11,2013-06-23 00:43:42
b9baf377390dc79826bf10977d002a380c64ee74...f25e2d2856281698914f21f7d22f84ae7e421f39,1,8,2,10,3,2013-06-25 18:52:26,2013-06-25 18:52:26
fa85b4d6ee4817a91bece2987f72da22ffe007a4...5718d2b688e1711cdc571fa0ab39871dd4e5bb48,1,1,1,2,1,2013-11-04 22:35:42,2013-11-04 22:35:42
c79e5a97a906457d1778197bd4f29640d1917201...37be62ffb7856cda96a187f4acf79afe2fed2514,1,13,2,15,4,2013-10-31 12:38:12,2013-10-31 12:38:12
c79e5a97a906457d1778197bd4f29640d1917201...03dc3a84630a1e3227bd0e772cca5d5f1fd4a9d4,1,5,1,6,2,2013-10-25 15:54:56,2013-10-25 15:54:56
03dc3a84630a1e3227bd0e772cca5d5f1fd4a9d4...7567fd7f27f80bb6f168cd8fcf589157348b069f,1,1,0,1,1,2013-10-25 16:01:28,2013-10-25 16:01:28
c79e5a97a906457d1778197bd4f29640d1917201...d01ca03635e50c10b8d3fac0253da9cdfe5bb093,1,8,0,8,1,2013-10-24 06:17:43,2013-10-24 06:17:43
c79e5a97a906457d1778197bd4f29640d1917201...0f9db24f9f4c4e6d6882d5857e94da810b8f243d,1,1,1,2,1,2013-10-20 14:07:19,2013-10-20 14:07:19
c79e5a97a906457d1778197bd4f29640d1917201...f057737e57b3e3acbd32614b4f4f03103ce764aa,1,7,0,7,1,2013-10-16 10:36:48,2013-10-16 10:36:48
c79e5a97a906457d1778197bd4f29640d1917201...500e5a73b61b063f83e1eecbf424e4b3733e59b7,1,34,0,34,1,2013-10-16 08:43:03,2013-10-16 08:43:03
c79e5a97a906457d1778197bd4f29640d1917201...c0c9fc02543eb14de49b0416e3df1100845633d8,1,4,0,4,2,2013-10-16 07:50:52,2013-10-16 07:44:49
c79e5a97a906457d1778197bd4f29640d1917201...d608fbfc7fcabf9994f8064e67670e69130d2ee1,1,2,3,5,1,2013-10-15 12:34:03,2013-10-15 12:34:03
c79e5a97a906457d1778197bd4f29640d1917201...3ca3c5a126a937dc6d6d3daba241f9a0f5a4c2f2,1,7,1,8,2,2013-10-14 15:59:20,2013-10-14 15:59:20
c79e5a97a906457d1778197bd4f29640d1917201...a7693b096f2573dfcf47f47a8f99c2ccd2690cbf,1,3,2,5,1,2013-10-13 19:49:24,2013-10-13 19:49:24
a7693b096f2573dfcf47f47a8f99c2ccd2690cbf...c5902d3f3498f9cd7553f358f2bf741b0784dbd0,2,0,0,0,0,2013-10-14 11:39:59,2013-10-14 11:39:59
c79e5a97a906457d1778197bd4f29640d1917201...1dddec6f0f947ed80eed128033e4ebc4d4448138,1,2,2,4,2,2013-10-12 02:00:16,2013-10-12 02:00:16
677acc3a8c14887ceb8e9b8584fd59bc9f4af3e0...0dc7b5c049b9cfb747b48d13b32799266b231caf,2,60,0,60,2,2015-02-23 17:15:29,2015-02-12 13:08:19
677acc3a8c14887ceb8e9b8584fd59bc9f4af3e0...8b45118f266fd5422f80a7868add48234adc1d30,1,7,5,12,7,2015-02-23 11:43:19,2015-02-23 11:43:19
677acc3a8c14887ceb8e9b8584fd59bc9f4af3e0...7fc47e7ebcff3ec1e01399d32752451f14e3de6a,1,1,1,2,1,2015-02-22 21:14:37,2015-02-22 21:14:37
223197b4e0cf989f380d02ff326afc6371663d30...8ce1245770a0d9a8f738362bbf749e918b48d7e9,1,1,0,1,1,2015-02-19 15:55:32,2015-02-19 15:55:32
223197b4e0cf989f380d02ff326afc6371663d30...e10470f6a320f37a07a229c65c5c7a9646477992,1,1,1,2,1,2015-02-19 15:34:51,2015-02-19 15:34:51
223197b4e0cf989f380d02ff326afc6371663d30...152a751342d678a90dd8597e512c1d07f72e9477,1,2,2,4,2,2015-02-19 14:50:08,2015-02-19 14:48:29
ef7e53a78d0e4196c2d1e6e5b268209759d51753...3704fbb71eb4d886aff11cdaff79a1a23a895cd6,1,13,7,20,2,2015-02-13 14:57:18,2015-02-11 18:58:33
ef7e53a78d0e4196c2d1e6e5b268209759d51753...68955f17ad5fe1cc4461868b2b2d059976d43dfb,1,1,1,2,1,2015-02-13 12:49:54,2015-02-13 12:49:54
8830f65c4dbb1d1727540c0d1f983237383884f0...448e966129bb5c08c7b2da4636491f0f890cf0ab,1,12,2,14,2,2015-02-10 19:37:35,2013-07-29 18:04:23
448e966129bb5c08c7b2da4636491f0f890cf0ab...0edf416bea1a180e82a8f5f96444d74fabb5867f,1,3,10,13,2,2015-02-10 19:38:06,2015-02-09 17:57:23
8830f65c4dbb1d1727540c0d1f983237383884f0...4161aa4f9de45233bdee7073933498422a50d213,1,10,3,13,6,2015-02-10 19:32:52,2014-05-20 13:41:36
4161aa4f9de45233bdee7073933498422a50d213...b62911660d3743d3dfb0116f5b05aabd67a24a06,1,58,55,113,7,2015-02-10 19:32:52,2015-02-10 11:20:24
b62911660d3743d3dfb0116f5b05aabd67a24a06...732c7b8070a75ac5ad5384b4d22d19f499e8424f,1,2,7,9,1,2015-02-10 19:32:52,2015-02-10 11:24:05
cea29ff7ce4094809d0089b7469d0f9e1f22b407...877d55ce9213b668cf206c49ba3e38ab3b8ef7fd,1,1,1,2,1,2014-07-20 11:33:26,2014-07-20 11:33:26
cea29ff7ce4094809d0089b7469d0f9e1f22b407...bb928b59c409feacc660a64e800ce9129c058104,1,13,12,25,5,2014-07-17 09:27:00,2014-07-17 09:27:00
cea29ff7ce4094809d0089b7469d0f9e1f22b407...a6b655fae9640873c1629abe7ba25f4823f4b714,1,21,0,21,1,2014-07-16 10:27:01,2014-05-30 08:21:16
a6b655fae9640873c1629abe7ba25f4823f4b714...5756ea0101dc60f5c5d3874a4a5baf58647aec9d,1,1,1,2,1,2014-07-16 10:27:01,2014-07-08 14:49:05
5756ea0101dc60f5c5d3874a4a5baf58647aec9d...7478b754a1e53a6c058d7807700869474b68bb21,2,7,2,9,4,2014-07-16 10:27:01,2014-04-24 22:48:37
7478b754a1e53a6c058d7807700869474b68bb21...39a1e2a083872ccca63fcc9ead44834627c176cf,1,2,0,2,1,2014-07-16 10:27:01,2012-07-11 12:29:54
d750e7d9e3b7d04bafc93211f7db4c607ecea19b...5b201468d109f87b0ec3dd0b190fa71813af542e,1,2,2,4,2,2012-12-02 02:03:07,2012-12-02 02:03:07
5b201468d109f87b0ec3dd0b190fa71813af542e...60c38134725e4a41c9849bb9ffc1a5cea86c00e3,1,7,4,11,4,2012-12-02 02:10:23,2012-12-02 02:10:23
d750e7d9e3b7d04bafc93211f7db4c607ecea19b...263107ed7faa7df15e70f5592c352021e74c6958,1,1,1,2,1,2012-11-30 03:55:45,2012-11-30 03:55:45
d750e7d9e3b7d04bafc93211f7db4c607ecea19b...3b6fae14fb6f700bb623d48b2915736de552b387,1,2,2,4,2,2012-11-28 23:33:45,2012-11-28 23:33:45
d750e7d9e3b7d04bafc93211f7db4c607ecea19b...1b4393fbb67b24d90caad71067c1cb58e8706a69,1,348,0,348,1,2012-11-28 13:09:25,2012-11-28 13:09:25
d750e7d9e3b7d04bafc93211f7db4c607ecea19b...53854754e0d052c41587c7d84b9be7868f31bfe8,1,0,5,5,2,2012-11-28 07:02:58,2012-11-28 07:02:58
d750e7d9e3b7d04bafc93211f7db4c607ecea19b...7fc612bcb991919d561fedc18eeaedfd9c568942,1,2,2,4,2,2012-11-27 20:20:56,2012-11-27 20:20:56
7fc612bcb991919d561fedc18eeaedfd9c568942...3d7622831fd86a3eaf4bbe3a11102929716d3781,1,1,1,2,1,2012-11-27 20:43:23,2012-11-27 20:43:23
d750e7d9e3b7d04bafc93211f7db4c607ecea19b...79e620c392393f254d9614b18963af1c9ac234e7,1,2,2,4,2,2012-11-27 12:03:51,2012-11-27 12:03:51
79e620c392393f254d9614b18963af1c9ac234e7...120db35b2dd7792b981401f66323e8886668c909,1,4,1,5,3,2012-11-27 12:08:18,2012-11-27 12:08:18
d750e7d9e3b7d04bafc93211f7db4c607ecea19b...200a25818adf9570186c8ee0abf9d425577ae53b,2,10,1,11,3,2012-11-26 19:35:16,2012-11-26 19:35:16
c73047e296b4448b11a906658fa7f9f27d54460a...4eace8753be4793f109c997bede7f0985692bb0a,1,2,2,4,2,2013-06-16 05:25:29,2013-06-16 05:25:29
c73047e296b4448b11a906658fa7f9f27d54460a...f8e3f293e0ae4e5890f83d9233e2829e64a04df9,1,6,0,6,1,2013-06-16 04:04:02,2013-06-16 04:04:02
c73047e296b4448b11a906658fa7f9f27d54460a...b074886ae66ed73957858608b21401767e3c66c0,1,2,2,4,2,2013-06-13 22:36:37,2013-06-13 22:36:37
bc3cadf5c83697c176c9d4ce41c7fde7f57bf6e7...4d6b59f041f2d5eb9b61608a0ff33160faf48afa,1,159,0,159,1,2013-07-05 11:27:43,2013-07-05 11:27:43
bc3cadf5c83697c176c9d4ce41c7fde7f57bf6e7...744f3654e2bfb4806381ca4f0a5dfcfa5b1c3b83,1,22,0,22,1,2013-07-04 11:18:52,2013-07-04 11:18:52
bc3cadf5c83697c176c9d4ce41c7fde7f57bf6e7...44a26df8fdd85c3eeb774a6913b9102106228ebb,1,1,0,1,1,2013-07-03 03:57:31,2013-07-03 03:57:31
bc3cadf5c83697c176c9d4ce41c7fde7f57bf6e7...77cf8696053d5256b4deb7cddc79c31d26158451,2,17,2,19,2,2013-06-30 12:54:23,2013-06-30 12:46:10
bc3cadf5c83697c176c9d4ce41c7fde7f57bf6e7...d4a9467f89115c1e60b51d8c068ec4e5e1c5b195,1,7,2,9,2,2013-06-30 10:08:48,2013-06-30 10:08:48
bc3cadf5c83697c176c9d4ce41c7fde7f57bf6e7...15509ce0472a431867cc2ff21ca5ef0a1c1e855f,1,4,1,5,4,2013-06-30 09:29:02,2013-06-30 09:29:02
bc3cadf5c83697c176c9d4ce41c7fde7f57bf6e7...4fe4db51285af30f1195a817dadcf5d8b3b93e79,1,13,3,16,6,2013-06-28 07:08:26,2013-06-28 07:08:26
bc3cadf5c83697c176c9d4ce41c7fde7f57bf6e7...012afe238159d87701fde176309d8a1a5cf8ea41,1,72,29,101,2,2013-06-28 03:47:03,2013-06-28 03:47:03
bc3cadf5c83697c176c9d4ce41c7fde7f57bf6e7...644728bd225c70068e32501c81a95713d04b8ff1,1,3,4,7,2,2013-06-27 18:46:41,2013-06-27 18:38:04
bc3cadf5c83697c176c9d4ce41c7fde7f57bf6e7...c51ef9dce6a600976aa3d0a3d733bb99c477959b,1,1,1,2,1,2013-06-27 13:28:14,2013-06-27 13:28:14
bc3cadf5c83697c176c9d4ce41c7fde7f57bf6e7...10bd036dfe466d82f90f10edaa83dc67a90b8571,1,56,0,56,1,2013-06-27 00:02:07,2013-04-26 09:02:18
31e29e1efbd81df46d9e6ef03a4e4d3bfaf78007...1308515d1c2014a52aca3ac952a0172d9961eee0,1,6,7,13,5,2015-02-23 17:25:55,2015-02-22 19:15:33
9bf19603d303b43b85dc000a7dbf7461ebdcb8fd...bc8abe5ea26aa031395c754e3e9710dcc62dd0f0,1,6,2,8,1,2015-02-19 21:30:50,2015-02-19 21:30:50
bc8abe5ea26aa031395c754e3e9710dcc62dd0f0...d7837c6041b1099982e3f278b50e8868b8b30ff9,1,1,8,9,1,2015-02-22 02:08:54,2015-02-22 02:08:54
5ee54032da9e5f9c5bd96dae877fbf6e08ad7af6...099246dd9e74f7a2488fe7c51fe8c40502295def,1,4,0,4,1,2015-02-18 19:25:15,2015-02-18 19:25:15
099246dd9e74f7a2488fe7c51fe8c40502295def...33900dfd328ea21954cc7772af21e5d44ea71f3f,1,5,0,5,1,2015-02-18 19:29:44,2015-02-18 19:29:44
5ee54032da9e5f9c5bd96dae877fbf6e08ad7af6...6b29aab37a4984b5f31c4dae3dda1f54860eca51,1,23,0,23,1,2015-02-17 06:27:38,2015-02-17 06:27:38
6b29aab37a4984b5f31c4dae3dda1f54860eca51...f50b3fe7107d4bb6a9439a4032ac6922b9c0c20b,1,141,0,141,1,2015-02-17 06:33:45,2015-02-17 06:33:45
f50b3fe7107d4bb6a9439a4032ac6922b9c0c20b...3120b9ad458353915f03c1e5df1683b6e0122db2,1,1,3,4,1,2015-02-17 06:36:23,2015-02-17 06:36:23
3120b9ad458353915f03c1e5df1683b6e0122db2...660eeb19c7850fd6c5470b40538426d2dbeccfe6,1,1,1,2,1,2015-02-17 06:48:01,2015-02-17 06:48:01
660eeb19c7850fd6c5470b40538426d2dbeccfe6...d8b99321383b8d7982506709a07aaa92f5f2d9fc,1,1,1,2,1,2015-02-17 06:49:55,2015-02-17 06:49:55
d8b99321383b8d7982506709a07aaa92f5f2d9fc...393676387a99683f2a5ccf44557d874ffd272d63,1,10,10,20,5,2015-02-19 18:37:54,2015-02-19 18:37:54
393676387a99683f2a5ccf44557d874ffd272d63...aff01d920e36231c59f3d8c43ffdc8564019b818,1,1,1,2,1,2015-02-19 18:43:31,2015-02-19 18:43:31
5ee54032da9e5f9c5bd96dae877fbf6e08ad7af6...8b5950b812b56a652ce1101f8d4adc569e516160,1,1,1,2,1,2015-02-16 22:24:21,2015-02-15 16:12:51
5ee54032da9e5f9c5bd96dae877fbf6e08ad7af6...46e6e2e23a175ee7e571878a18b4fae03c269b69,1,3,5,8,3,2015-02-16 17:22:18,2015-02-16 17:22:18
5ee54032da9e5f9c5bd96dae877fbf6e08ad7af6...6ccf67a077e07bc57cdca6980dcdf346cbd2138e,1,0,1,1,1,2015-02-16 15:24:22,2015-02-16 15:24:22
5ee54032da9e5f9c5bd96dae877fbf6e08ad7af6...cd36deda23a1f6f53ba910077b22c200fb820299,1,7,0,7,3,2015-02-16 11:04:37,2015-02-16 11:04:37
5ee54032da9e5f9c5bd96dae877fbf6e08ad7af6...7c73a3aea4861a281bc931a064f13a7c7da3b6be,2,21,1,22,2,2015-02-16 08:28:54,2015-02-16 08:28:54
5ee54032da9e5f9c5bd96dae877fbf6e08ad7af6...2790a5e565ecf1a695c25c7ef0d5aa23f8bb5239,1,3,3,6,1,2015-02-15 19:37:28,2015-02-15 19:37:28
5ee54032da9e5f9c5bd96dae877fbf6e08ad7af6...7c00bcdb829fad5e7306358259761037d297fb15,1,2,2,4,1,2015-02-14 18:34:22,2015-02-14 18:34:22
5ee54032da9e5f9c5bd96dae877fbf6e08ad7af6...4b20bfe0ee4c5ae85a926b7c496b34cf9091f5f5,1,2,0,2,1,2015-02-13 16:29:44,2015-02-11 19:30:01
207b6a1e338e03ba06cccf255fbaa7e6147e8f94...961ca143b81fe5d15f67bd3a61fe174e41e155b5,1,3,1,4,2,2014-08-01 05:59:45,2014-08-01 05:59:45
207b6a1e338e03ba06cccf255fbaa7e6147e8f94...80323ec4c3497e49c8294752e96b033426ae09db,1,138,0,138,1,2014-08-01 00:37:22,2014-08-01 00:37:22
80323ec4c3497e49c8294752e96b033426ae09db...b8e10ca16d1caa55e3e6759b9130e32629986d98,1,105,0,105,1,2014-09-01 04:33:43,2014-09-01 04:33:43
207b6a1e338e03ba06cccf255fbaa7e6147e8f94...e5ac5009a4c5efbc1b9916d74d082ffc32761a4c,1,1,1,2,1,2014-07-31 20:30:15,2014-07-31 20:30:15
207b6a1e338e03ba06cccf255fbaa7e6147e8f94...0174feef0d57ac4110d2603ce2a25a5de4739414,1,1,0,1,1,2014-07-31 12:54:01,2014-07-31 12:54:01
0174feef0d57ac4110d2603ce2a25a5de4739414...fbdacbfb1ae586af1008fe561bc3962d78a5973f,1,1,1,2,1,2014-07-31 13:02:57,2014-07-31 13:02:57
207b6a1e338e03ba06cccf255fbaa7e6147e8f94...63bae2aba9c43a70bbb374fc46e287d7bc46cc54,7,7,7,14,7,2014-07-23 13:18:14,2014-04-23 14:13:26
207b6a1e338e03ba06cccf255fbaa7e6147e8f94...00b21d5ac322178b9b9e397b0b6178a3d7f4e9ee,1,3,3,6,1,2014-07-23 13:06:06,2014-04-23 13:41:09
207b6a1e338e03ba06cccf255fbaa7e6147e8f94...0e00f0b0342cc088c1c3d4163787efb8433b8ea1,1,1,1,2,1,2014-07-22 17:25:04,2014-07-22 17:25:04
207b6a1e338e03ba06cccf255fbaa7e6147e8f94...73212ded4ee70c010a92eb7a126daa20c7453cba,1,1,1,2,1,2014-07-21 15:15:09,2014-07-21 15:15:09
23bbf3cc2bffb059506b7995e34cd451dc0a947a...f0d5cfdc33561a16e26e9db2b2dbb9141eabe5c1,1,1,0,1,1,2014-09-01 03:30:42,2014-09-01 03:30:42
23bbf3cc2bffb059506b7995e34cd451dc0a947a...9c1255d358fa98397ce20370fa3843199c663990,1,1,1,2,1,2014-09-01 01:49:31,2014-09-01 01:49:31
23bbf3cc2bffb059506b7995e34cd451dc0a947a...2b83accbf8d8668f4b46e449087317dc90a43873,1,1,1,2,1,2014-09-01 01:14:03,2014-09-01 01:14:03
23bbf3cc2bffb059506b7995e34cd451dc0a947a...65f97a66c7fa2979ba454e9bcc578854912721d9,1,8,0,8,1,2014-08-31 19:42:49,2014-08-31 19:42:49
533a2819196db2e29d5eb30b0bbf946802211a13...ded745bf1471487c7dc537c781685615ff4c2515,1,3,3,6,2,2012-11-30 13:58:08,2012-11-30 13:58:08
434f3bc05c5245d7a27ab0bb1ede5b78acc370a4...69ce2362d6b4c46450a07d9ffdb3deabc48b5ffd,1,9,1,10,3,2013-09-05 16:22:46,2013-09-05 16:22:46
434f3bc05c5245d7a27ab0bb1ede5b78acc370a4...4da4d12d33eb7d36552fa1ffb0797380793970d1,1,2,1,3,1,2013-09-05 14:12:12,2013-09-05 14:12:12
434f3bc05c5245d7a27ab0bb1ede5b78acc370a4...5bf20572cc303cd02a915c91ffa91f96a26bba39,1,4,0,4,2,2013-09-05 12:37:37,2013-09-05 12:37:37
434f3bc05c5245d7a27ab0bb1ede5b78acc370a4...e3c02bfeba64b655ca506d0d46eca724f2889a87,2,27,0,27,2,2013-09-04 22:07:58,2013-09-04 22:07:58
e3c02bfeba64b655ca506d0d46eca724f2889a87...3007f96090e0f5a9e6430575afc7dfa92b235bc9,1,2,0,2,1,2013-09-05 14:09:19,2013-09-05 14:09:19
434f3bc05c5245d7a27ab0bb1ede5b78acc370a4...dd220152be26163c93ed1c0f9f98e7bad0653941,1,32,0,32,1,2013-09-01 16:20:08,2013-09-01 16:20:08
dd220152be26163c93ed1c0f9f98e7bad0653941...90b83b81017bbf55d5c10e6bced835f6d184499d,1,17,1,18,3,2013-09-01 17:23:21,2013-09-01 17:23:21
434f3bc05c5245d7a27ab0bb1ede5b78acc370a4...958c847f54a0c9101b4e0bc8c29b539a42c263ad,1,1,1,2,1,2013-08-29 14:20:40,2013-08-29 14:20:40
434f3bc05c5245d7a27ab0bb1ede5b78acc370a4...baffc3b0bd2594b789316cb135ba84fb54f50dd9,1,4,4,8,4,2013-08-29 12:07:09,2013-08-29 12:07:09
434f3bc05c5245d7a27ab0bb1ede5b78acc370a4...300118ec05e6a88d8331c007d076ec1fbf9c5e9c,1,9,1,10,1,2013-08-24 09:12:03,2013-08-24 09:12:03
434f3bc05c5245d7a27ab0bb1ede5b78acc370a4...9ebdbec58979b077e4790387b5927c74ce7184ef,3,435,363,798,107,2013-08-24 03:00:11,2013-08-24 02:58:29
434f3bc05c5245d7a27ab0bb1ede5b78acc370a4...f11934e00c711a09876e1cf776d04c231339ff18,1,2,0,2,1,2013-08-19 22:28:09,2013-08-19 22:28:09
434f3bc05c5245d7a27ab0bb1ede5b78acc370a4...e368bf1d4aea6ac08ae46d60308e0492e9ab3b85,1,21,0,21,1,2013-08-15 14:32:01,2013-08-15 14:32:01
e368bf1d4aea6ac08ae46d60308e0492e9ab3b85...73c22c146c57afe5c9ce341cff876abf00571463,1,11,4,15,5,2013-08-18 18:16:26,2013-08-18 18:16:26
b0e4381471f8df192b7ef74b10039cc9687a6f54...2defe0b5c54b08fc599005197761edf162600c78,1,37,24,61,9,2013-07-07 23:17:33,2013-07-07 23:17:33
b0e4381471f8df192b7ef74b10039cc9687a6f54...c26facb582eed3b63642665864258862aa49392b,1,82,0,82,1,2013-07-04 22:58:05,2013-07-04 22:58:05
c26facb582eed3b63642665864258862aa49392b...cf5ca2f4f3e6d98a4d4d4938be0e421645722fb2,1,170,53,223,7,2013-07-05 09:07:29,2013-07-05 09:07:29
cf5ca2f4f3e6d98a4d4d4938be0e421645722fb2...1d636fe8ab4a7258eddbe120d462cdda3d8adbaf,1,23,3,26,4,2013-07-05 09:17:33,2013-07-05 09:17:33
1d636fe8ab4a7258eddbe120d462cdda3d8adbaf...c48822b3a3a3f25922c184d1804fc11aea2b6432,1,5,1,6,2,2013-07-05 09:28:00,2013-07-05 09:28:00
c48822b3a3a3f25922c184d1804fc11aea2b6432...0892bce00b73fdf75d70e554b1fd64ae0fd5e61a,1,198,43,241,17,2013-07-09 12:41:41,2013-07-09 12:41:41
0892bce00b73fdf75d70e554b1fd64ae0fd5e61a...45314ee5b7ad2d7daafe940b801ddacd151d7017,1,1,1,2,1,2013-07-09 22:14:08,2013-07-09 22:14:08
45314ee5b7ad2d7daafe940b801ddacd151d7017...ba7fe6df62236dfa03a360a8707ebd0c0b1a645a,1,6,3,9,3,2013-07-15 12:37:31,2013-07-15 12:37:31
b0e4381471f8df192b7ef74b10039cc9687a6f54...9cec52c4495cc3e439b637ffd9dcdf7cea54a288,1,1,1,2,1,2013-07-02 08:29:25,2013-07-02 08:29:25
6ddd44a341c77910ac64ec2f67ee762ecebcc82d...2e1b964c002aa193fef733d52da252e2e11ca2ef,1,15,0,15,1,2015-02-24 12:58:50,2015-02-24 12:58:50
2e1b964c002aa193fef733d52da252e2e11ca2ef...01ec37e5f87281e91b174d068a43d0ce6e43944e,1,3,1,4,1,2015-02-24 13:05:58,2015-02-24 13:05:58
77140a2ea7f8fbf6d5618546d7e7dc8fd03eb707...8f1741d56c21f1daf50c1e1f76a5eea37106e239,3,176,112,288,3,2015-02-22 00:07:27,2015-02-22 00:07:27
8f1741d56c21f1daf50c1e1f76a5eea37106e239...caac64cf37912f37d85c7eb8fa6e053ceb7d2151,1,2,2,4,2,2015-02-22 00:11:57,2015-02-22 00:11:57
caac64cf37912f37d85c7eb8fa6e053ceb7d2151...5cd31822c72964b19b6c1938694697726b2ac3b9,1,1,1,2,1,2015-02-22 00:13:53,2015-02-22 00:13:53
5cd31822c72964b19b6c1938694697726b2ac3b9...a1de65e3595c9bc3438b98d9ca671c2890a4b613,1,1,1,2,1,2015-02-22 00:19:22,2015-02-22 00:19:22
77140a2ea7f8fbf6d5618546d7e7dc8fd03eb707...0a99ca0df0f53e546c9c6ac5240e38f3a2dd2c3b,1,1,1,2,1,2015-02-20 18:12:39,2015-02-20 17:17:00
1b7a3ea99a8b566510ab7881063148c43be6b98d...14f055d0bb737520edf6dfcf27d3e3d6e3aaa863,1,2,2,4,1,2014-08-31 13:41:02,2014-08-31 13:41:02
1b7a3ea99a8b566510ab7881063148c43be6b98d...f49220732904ed254400f14e621ea5ebe9e4a5f5,1,14,1,15,2,2014-08-30 16:20:28,2014-08-30 16:20:28
1b7a3ea99a8b566510ab7881063148c43be6b98d...cd98283a92a5b2726e3164653e6b8c674eeedb92,1,4,2,6,4,2014-08-29 08:40:08,2014-08-29 08:40:08
1b7a3ea99a8b566510ab7881063148c43be6b98d...25a3244353076cbffc8ddb2ee592b94b17383694,1,6,3,9,2,2014-08-28 22:39:33,2012-12-08 18:31:13
25a3244353076cbffc8ddb2ee592b94b17383694...17dd5792b4a34e65311fda6ab469b98f31cf30df,1,20,6,26,8,2014-08-28 22:39:33,2014-07-26 21:23:13
17dd5792b4a34e65311fda6ab469b98f31cf30df...142a6c7fd5bcda6c45c25aca582972a7d4e1da85,1,3,1,4,2,2014-08-28 22:39:33,2014-07-26 21:26:12
1b7a3ea99a8b566510ab7881063148c43be6b98d...1aadd63cfc98987c42033aeb4d7b826abf1f49ef,1,26,0,26,1,2014-08-28 22:38:12,2014-07-17 11:46:06
1aadd63cfc98987c42033aeb4d7b826abf1f49ef...1e2abe5d4e1cbf29b1630292ec3eb32cb993f49e,1,17,1,18,1,2014-08-28 22:38:12,2014-08-04 21:04:53
1b7a3ea99a8b566510ab7881063148c43be6b98d...325c18736e82d0688f7437cefff23910ebd7cedd,1,17,0,17,1,2014-08-26 13:37:04,2014-08-26 13:37:04
325c18736e82d0688f7437cefff23910ebd7cedd...362f2a56d276aebfb8da4e3244994f69899bbdbd,1,4,4,8,3,2014-08-27 13:27:31,2014-08-27 13:27:31
362f2a56d276aebfb8da4e3244994f69899bbdbd...a8dad6fa87867ff2629a55e26f78175635a0ad06,1,15,0,15,1,2014-08-31 17:55:46,2014-08-31 17:55:46
1b7a3ea99a8b566510ab7881063148c43be6b98d...9eb2118c556b81e4eb0965d3e4bc024e35687aba,1,12,0,12,1,2014-08-26 13:36:16,2014-08-26 13:36:16
9eb2118c556b81e4eb0965d3e4bc024e35687aba...9be81015d0fcb7864be9cdfe550aeee20c52bf7a,1,2,2,4,2,2014-08-27 13:31:18,2014-08-27 13:31:18
9be81015d0fcb7864be9cdfe550aeee20c52bf7a...9bf5b90c81ce2cbde321c3d6d97d5ff6d561b83c,2,13,0,13,1,2014-08-31 18:01:21,2014-08-31 17:57:58
1b7a3ea99a8b566510ab7881063148c43be6b98d...e20ce81c6663e354f9ef29618e7149800b9a3b26,1,21,0,21,1,2014-08-26 13:34:17,2014-08-26 13:34:17
e20ce81c6663e354f9ef29618e7149800b9a3b26...1b4d4266131eb760fc0cc25aab847a9c08d1c6de,1,4,4,8,3,2014-08-27 13:34:17,2014-08-27 13:34:17
1b4d4266131eb760fc0cc25aab847a9c08d1c6de...d7f77f818d3f094f42e02554b3c697c0f3d26ed6,1,20,0,20,1,2014-08-31 17:56:23,2014-08-31 17:56:23
1b7a3ea99a8b566510ab7881063148c43be6b98d...ee33cee83e78b53ca200b5647b024bcd93f8ee3d,1,1,0,1,1,2014-08-25 18:05:13,2014-08-25 18:05:13
1b7a3ea99a8b566510ab7881063148c43be6b98d...dc9e1764cfd0987f104f57bac0b974e0941f1e42,1,2,3,5,1,2014-08-22 22:59:17,2014-08-22 22:59:17
1b7a3ea99a8b566510ab7881063148c43be6b98d...5d6c73d7d38930443bdc4357c337e0baf7d5b5fb,1,2,0,2,1,2014-08-22 07:21:38,2014-08-22 07:21:38
1b7a3ea99a8b566510ab7881063148c43be6b98d...91ba6d98875c70d0736fd3eecd0ee4aae52cdc74,1,4,2,6,1,2014-08-21 10:47:48,2014-08-21 10:47:48
1b7a3ea99a8b566510ab7881063148c43be6b98d...dac2a6e27a23071226495bfee54b390135cb20b6,4,6,6,12,6,2014-08-20 21:52:05,2014-08-20 21:52:05
1b7a3ea99a8b566510ab7881063148c43be6b98d...eee7345f1f01df5f66151bc5bf34d8e2110224aa,1,1,1,2,1,2014-08-20 10:57:28,2014-08-20 10:57:28
1b7a3ea99a8b566510ab7881063148c43be6b98d...df1b0b328983dba57b4cea123b5a05c24493ae8f,1,39,2,41,4,2014-08-19 14:42:39,2014-08-19 14:42:39
1b7a3ea99a8b566510ab7881063148c43be6b98d...49e10ae449d2e5570542e4f9011ea4e2fb14a348,1,29,4,33,4,2014-08-13 14:01:35,2014-08-13 14:01:35
1b7a3ea99a8b566510ab7881063148c43be6b98d...9a0196dbf72521319a0fa0db4ae84603c2c79868,1,1,0,1,1,2014-08-10 19:01:47,2014-08-10 19:01:47
1b7a3ea99a8b566510ab7881063148c43be6b98d...45abe764e55a6c201acb3bf8e602f53e5d5574f0,1,12,0,12,1,2014-08-09 15:26:35,2014-08-09 15:26:35
1b7a3ea99a8b566510ab7881063148c43be6b98d...99e74b04981b2eb66714bf68245115520bcd25f0,1,2,2,4,1,2014-08-09 13:40:56,2014-08-09 13:40:56
1b7a3ea99a8b566510ab7881063148c43be6b98d...78a7c0c6aebc6415040464c704f64bce0c72d049,1,13,5,18,5,2014-08-09 00:04:28,2014-08-09 00:04:28
78a7c0c6aebc6415040464c704f64bce0c72d049...7d208be2a147657d6d8e936e3f03c26b3a936ac8,1,1,1,2,1,2014-08-09 00:09:06,2014-08-09 00:09:06
1b7a3ea99a8b566510ab7881063148c43be6b98d...89f1d94a3052e2eabd3e86b856eada8e51fc65b4,1,37,0,37,1,2014-08-06 11:51:58,2011-08-07 19:43:32
89f1d94a3052e2eabd3e86b856eada8e51fc65b4...8ad9122ba49bb0a41ca7dbad03cf5438477cc283,1,2,0,2,1,2014-08-06 11:51:58,2012-01-03 16:12:22
1b7a3ea99a8b566510ab7881063148c43be6b98d...fdb30392b15ef0b7edd6d670340d1ba390f4a7b8,1,4,5,9,3,2014-08-04 14:10:11,2014-08-04 14:10:11
1b7a3ea99a8b566510ab7881063148c43be6b98d...397a9f7b7bfd88678c5b10d2c3e96c0768677434,1,42,42,84,33,2014-08-02 10:43:32,2014-08-02 10:43:32
1b7a3ea99a8b566510ab7881063148c43be6b98d...4f1ee6c1eed04345c458458006a15381d35d8080,1,1,0,1,1,2014-08-02 01:16:33,2014-08-02 01:16:33
fdba0f43f51b28ac9b13d22d5ac526af85cf0c69...39fb6c9d35a555674de36ea02a4ae4c226c387a4,1,0,42,42,1,2014-09-01 10:59:47,2014-09-01 10:59:47
da94f45f9ce8b31f1f4a551f37c5be852e8fd570...ed6c2c9106cdaf570da6f7a260c41ca1c4b4ed2a,1,1,1,2,1,2014-09-03 09:13:21,2014-09-03 09:13:21
ed6c2c9106cdaf570da6f7a260c41ca1c4b4ed2a...677d8b1a21c4b1d8cffef4cbfa259797a11f338a,1,1,1,2,1,2014-09-03 09:36:22,2014-09-03 09:36:22
677d8b1a21c4b1d8cffef4cbfa259797a11f338a...8d2dd8cc6a530e79ffdf307d444cb15430004efa,1,2,0,2,1,2014-09-03 09:58:52,2014-09-03 09:58:52
a8ef111a796acbd7d235b52e5864c6af4b911aa5...5e2591317810dba5d61f085faaf4e3050f90559c,1,0,2,2,2,2014-09-04 10:53:43,2014-09-04 10:53:43
a8ef111a796acbd7d235b52e5864c6af4b911aa5...87fb118dd252d7e9b658c66c51b5e3cb905f10fb,1,2,4,6,3,2014-09-03 19:01:29,2014-09-03 19:01:29
a8ef111a796acbd7d235b52e5864c6af4b911aa5...ae901fa0d5163728de3dde787071df0e2fcf47d5,1,1,0,1,1,2014-09-03 14:08:27,2013-06-11 11:51:17
d7b594e5cdf828308474ca22e7ccd336dd0abc5e...dff966afad231f66f6e7345383412682992f9e84,1,2,0,2,1,2013-09-06 23:00:24,2013-09-06 23:00:24
73c22c146c57afe5c9ce341cff876abf00571463...128cd3f5661d42f10ef3bae742ae3416f401c7ad,1,4,4,8,4,2013-09-05 15:39:22,2013-09-05 15:39:22
128cd3f5661d42f10ef3bae742ae3416f401c7ad...a265acee4f991dfd96fb3a9057309e9c1a345a2c,1,1,1,2,1,2013-09-05 16:00:14,2013-09-05 16:00:14
7f74294d7aa7ab86e18e70a1153c15fa373c5849...00ccee1f33c90c8900e8c2efe4dca9bf5db040f9,1,18,0,18,1,2013-07-16 23:58:55,2013-07-16 23:57:08
00ccee1f33c90c8900e8c2efe4dca9bf5db040f9...9a9e6e929964cbb25c5ce656a995e31ab9636762,1,2,2,4,2,2013-07-17 00:01:58,2013-07-17 00:01:58
7f74294d7aa7ab86e18e70a1153c15fa373c5849...5c529b5daac6e22cb8a267dcd7796c8400c63679,1,1,1,2,1,2013-07-16 15:24:07,2013-07-16 15:10:47
7f74294d7aa7ab86e18e70a1153c15fa373c5849...849c80b02ddb52a3f28edaca875e154a9daacd01,1,1,1,2,1,2013-07-15 01:25:18,2013-07-15 01:25:18
7f74294d7aa7ab86e18e70a1153c15fa373c5849...57a2327ddff8ed88492dd32cc57ccd5fd5c6e9ac,1,2,0,2,1,2013-07-12 18:03:44,2013-07-12 18:03:44
7f74294d7aa7ab86e18e70a1153c15fa373c5849...3d204883a69355b95248b72e8c2078718fb07802,1,1,0,1,1,2013-07-11 06:36:50,2013-07-11 06:36:50
3d204883a69355b95248b72e8c2078718fb07802...cf8d76094c2e0032ebe5cc1d579e393521ed3b86,1,2,0,2,1,2013-07-15 13:51:08,2013-07-15 13:51:08
7f74294d7aa7ab86e18e70a1153c15fa373c5849...05d8fdf3d54af3243e5891d13969a766bd9570a1,1,21,0,21,1,2013-07-10 04:15:43,2013-07-10 04:15:43
a1de65e3595c9bc3438b98d9ca671c2890a4b613...aa16e18644b3fee0b3cf0320692d6566d539cdd0,2,7,7,14,2,2015-02-22 17:29:31,2015-02-22 17:29:31
6713aef977b00577eb24512c7d41d8b55888a140...ce607d3fcb4c730c991563b4c62725cd89ce0ced,1,1,0,1,1,2015-02-22 17:51:22,2015-02-22 17:51:22
ce607d3fcb4c730c991563b4c62725cd89ce0ced...43bdea4c2fab0ff313a28e2b45274a90c8cc3c76,1,1,7,8,2,2015-02-22 17:57:42,2015-02-22 17:57:42
eae6c38ea8a15ebf32878626cd7673411e18f450...e7fdb028b52505947c7c3eb088586590f5b0b8cd,1,1,1,2,1,2014-08-31 21:50:59,2014-08-31 21:50:59
96e4e5dd032d2df75f87d5b3e5594d527c655b16...36e05e95adf6218eb8c154706a5a101b687d6368,1,0,1,1,1,2014-10-22 13:39:27,2014-10-22 13:16:15
96e4e5dd032d2df75f87d5b3e5594d527c655b16...6f1eb081e343208f881b19d1c9499e6e93b29e4b,1,1,1,2,1,2014-10-18 14:06:24,2014-10-17 02:32:42
96e4e5dd032d2df75f87d5b3e5594d527c655b16...d794a502f6e551c2ccb1479fc68dbae352c839f5,1,1,1,2,1,2014-10-14 18:57:19,2014-10-14 18:57:02
d794a502f6e551c2ccb1479fc68dbae352c839f5...071de5fb39ff951bffe75a4d6f590d85f25871f3,1,6,1,7,1,2014-10-28 03:17:26,2014-10-28 03:17:11
96e4e5dd032d2df75f87d5b3e5594d527c655b16...71ee0d7b2bc717e815cddc9ee8e062f84587d2c4,1,16,12,28,3,2014-10-14 15:14:31,2014-10-12 03:00:08
96e4e5dd032d2df75f87d5b3e5594d527c655b16...b0013ceb29e4214a76c92bfbdc0d87354c374277,1,0,1,1,1,2014-09-16 15:21:08,2014-09-15 15:13:43
96e4e5dd032d2df75f87d5b3e5594d527c655b16...eb0549750fccde126584d6be59df8d2d62882750,1,2,0,2,1,2014-09-16 08:35:43,2014-09-16 08:35:43
96e4e5dd032d2df75f87d5b3e5594d527c655b16...1e7c6743a7b221cb2069a84c70890014597672d8,1,2,3,5,1,2014-09-15 13:36:34,2014-09-15 13:36:34
96e4e5dd032d2df75f87d5b3e5594d527c655b16...7a5d68c96332b5f50969f75384f67694639dbce2,1,0,1,1,1,2014-09-13 07:30:16,2014-09-13 07:30:16
96e4e5dd032d2df75f87d5b3e5594d527c655b16...6855dd4727a395bfe8bd471c939819d907cb6c27,3,355,79,434,51,2014-09-07 19:56:34,2014-09-07 19:56:34
6855dd4727a395bfe8bd471c939819d907cb6c27...b5093859af472c04dfca33adfeba49bfbe417c9d,1,1,1,2,1,2014-09-08 07:09:44,2014-09-08 07:09:44
b5093859af472c04dfca33adfeba49bfbe417c9d...9f801ff48d46847e3c91e58b2ba2f5b61f6dcef8,1,2,2,4,2,2014-10-21 07:54:15,2014-10-21 07:51:13
7a531666dc893c1fb591b35c87e23c14fa6508d2...a910aef0c4e33868d25e3410f1e8f8c9844b55c8,1,2,2,4,1,2014-09-01 11:01:01,2014-09-01 11:01:01
dff966afad231f66f6e7345383412682992f9e84...0fcb7dd55e02871f2280db5cabecc803e522ec0a,1,2,1,3,1,2013-09-10 09:28:31,2013-09-10 09:28:31
dff966afad231f66f6e7345383412682992f9e84...8735dfd87e98d79aa3a809117630cec907c1a86d,1,10,0,10,1,2013-09-10 09:20:07,2013-09-10 09:19:00
dff966afad231f66f6e7345383412682992f9e84...f6fb34845d31a840c73416f138dae1761ea4adb9,1,3,2,5,3,2013-09-10 07:14:24,2013-09-10 07:14:24
f6fb34845d31a840c73416f138dae1761ea4adb9...bdb2cabaa68a8c3af72df5a10bb3925fe1eda45e,1,2,2,4,1,2013-09-10 07:17:09,2013-09-10 07:17:09
bdb2cabaa68a8c3af72df5a10bb3925fe1eda45e...40b1cf01035a3d74395b5d9def4f79af17fca4c8,1,1,1,2,1,2013-09-10 13:20:57,2013-09-10 13:20:57
40b1cf01035a3d74395b5d9def4f79af17fca4c8...0eb86f82d6d3a6cf05b11818bb69ba4de80124da,1,9,2,11,4,2013-10-29 09:33:37,2013-10-29 09:33:37
9cd1afb871227ee13000274799fe2faadb0530c6...4517db6acc6e4217a25aa353da37fb8de617bfc4,1,12,1,13,6,2013-09-06 13:34:27,2013-09-06 13:34:27
4517db6acc6e4217a25aa353da37fb8de617bfc4...55d4873f91b8cebbb2e6df5f3a405022e76e0c2c,1,13,7,20,5,2013-09-06 13:40:44,2013-09-06 13:40:44
55d4873f91b8cebbb2e6df5f3a405022e76e0c2c...255b0c4f5e16465ace326ddf1884ea2e7c1f3df1,1,9,1,10,1,2013-09-06 13:55:43,2013-09-06 13:55:43
255b0c4f5e16465ace326ddf1884ea2e7c1f3df1...d3e005d6b42995021ad6f1009734a55cb65be6ce,1,4,5,9,4,2013-09-06 19:29:14,2013-09-06 19:29:14
2cc4801bd25a619cae8b41d698ff0489f7d629c3...107d196f94ee800907abcb3c2de8df1f73b2b31e,1,5,3,8,5,2013-07-23 13:51:35,2013-07-23 13:51:35
2cc4801bd25a619cae8b41d698ff0489f7d629c3...b456541cc392e79ce7b8b30f0cba98f2796ed9a4,1,1,1,2,1,2013-07-23 08:52:44,2013-07-23 08:52:44
2cc4801bd25a619cae8b41d698ff0489f7d629c3...d0e312fc13d8f2a1a6bb9a02ca4acf1bcdc0bbfe,1,1,1,2,1,2013-07-22 13:51:16,2013-07-22 13:51:16
2cc4801bd25a619cae8b41d698ff0489f7d629c3...4b8e10958467899765e0e4fedb80d31f8e0adb8d,1,63,0,63,1,2013-07-20 03:19:11,2013-07-20 03:19:11
2cc4801bd25a619cae8b41d698ff0489f7d629c3...cbbdc0dfeb579474e320a6acf46077bac8c78c28,1,1,0,1,1,2013-07-20 03:12:06,2013-07-20 03:12:06
cbbdc0dfeb579474e320a6acf46077bac8c78c28...c8dbadd3da204bbe3c15c870818aeb34800e26a2,1,1,1,2,1,2013-07-23 14:32:55,2013-07-23 14:32:55
7f07facf41e97d0de250f565d5e514f1e6c998a2...6f70d288cc4625142413227109bf1eeac7e2a180,1,8,2,10,2,2014-12-11 11:47:29,2014-12-11 11:47:29
7f07facf41e97d0de250f565d5e514f1e6c998a2...b6b1dd3cd713751c5295b8346af071b420a99f87,1,2,2,4,2,2014-11-21 01:07:23,2014-11-21 01:07:23
7f07facf41e97d0de250f565d5e514f1e6c998a2...eae70054d15948cc6ddb3d8d4f252ff2c7cf6ad5,1,2,0,2,1,2014-11-03 11:29:19,2014-11-03 11:29:19
7f07facf41e97d0de250f565d5e514f1e6c998a2...b6012bc2c32a124183d7c5713edee4e2341e1d3f,2,86,48,134,25,2014-11-02 17:33:56,2014-04-02 23:25:47
7f07facf41e97d0de250f565d5e514f1e6c998a2...b9a11b16fec80c5d68f8a215565da3624748197f,1,2,2,4,2,2014-10-22 16:13:15,2014-09-06 19:44:18
b9a11b16fec80c5d68f8a215565da3624748197f...69a0b280c7939406c930082469756e217d1bd789,1,4,4,8,4,2014-10-22 16:13:15,2014-10-15 13:33:49
69a0b280c7939406c930082469756e217d1bd789...04d1428fcbda05a96d54396679c6c74c7006b032,1,1,1,2,1,2014-10-22 16:13:15,2014-10-09 05:17:35
04d1428fcbda05a96d54396679c6c74c7006b032...b452cafb163cde6619ac741027251bed2709f78e,1,2,2,4,2,2014-10-22 16:13:15,2014-10-15 15:17:04
7034b01cd10cebb2658f54aa07ac0ce5ee64e0e0...e16d3e45d30fbf981f503b4d078d84c71a070a1d,2,104,0,104,2,2014-11-06 18:34:26,2014-11-06 18:34:26
e16d3e45d30fbf981f503b4d078d84c71a070a1d...0b0cc2cdea1e3b3e4af78d8d4a9992be468031eb,1,2,3,5,2,2014-11-06 18:34:47,2014-11-06 18:31:27
0b0cc2cdea1e3b3e4af78d8d4a9992be468031eb...adafe271f02ab767c29f80f5657f448d593cdaf6,2,3,1,4,3,2014-11-06 18:35:07,2014-11-06 18:32:29
adafe271f02ab767c29f80f5657f448d593cdaf6...3d376bbd5b0a230e9e1a2d5497623d92ec94615e,1,1,1,2,1,2014-11-07 16:35:31,2014-11-07 16:35:31
3d376bbd5b0a230e9e1a2d5497623d92ec94615e...cbec1d77b2b238eadcdad5d926339d4a034240e9,1,2,0,2,1,2014-11-07 18:58:11,2014-11-07 18:57:02
cbec1d77b2b238eadcdad5d926339d4a034240e9...98fc8dd91adb5e8754b857127c4d121871d5fadb,1,1,1,2,1,2014-11-08 22:16:56,2014-11-08 22:16:56
98fc8dd91adb5e8754b857127c4d121871d5fadb...fd69c34e0ccb8b7754b05e6f0c797abddb00f920,1,15,0,15,1,2014-11-08 22:20:37,2014-11-08 22:20:37
7034b01cd10cebb2658f54aa07ac0ce5ee64e0e0...74177c5320b2a1b2f8c4c695c05984b57fd7c6ea,9,12,15,27,10,2014-11-06 17:33:56,2014-10-09 11:44:54
74177c5320b2a1b2f8c4c695c05984b57fd7c6ea...4310a15de5d0587ef135f9e12857620c4788dec2,6,13,13,26,11,2014-11-06 17:33:56,2014-10-09 11:55:50
4310a15de5d0587ef135f9e12857620c4788dec2...95d795e8cad7d1a754dfad520309d7a41b69275f,8,8,8,16,8,2014-11-06 17:33:56,2014-10-09 15:05:48
d3e005d6b42995021ad6f1009734a55cb65be6ce...45438528761b0bbc143f8f2f013ee01917eb48cc,7,155,0,155,6,2013-09-10 09:33:58,2013-09-10 09:33:58
5fcb6e1263e9fa7938e4ebfc03bf44aa624a5d7b...e4d0b2b385113aa7fb89efe14c5d022fb646f261,1,8,3,11,3,2013-08-15 03:19:16,2013-08-15 03:19:16
5fcb6e1263e9fa7938e4ebfc03bf44aa624a5d7b...2c56345917624bd94bfc05fe7bdbb2051421d5e7,1,128,0,128,1,2013-08-10 23:19:30,2013-08-10 23:19:30
5fcb6e1263e9fa7938e4ebfc03bf44aa624a5d7b...619ecb5f4fcec9ceb3769f4697fcbb2cbe3f2a7a,2,290,0,290,1,2013-08-07 15:49:21,2013-08-07 15:49:21
5fcb6e1263e9fa7938e4ebfc03bf44aa624a5d7b...5bad3f890de691194b77cfc33846e2102e21ea93,1,22,12,34,4,2013-08-05 19:15:28,2013-08-05 19:15:28
5fcb6e1263e9fa7938e4ebfc03bf44aa624a5d7b...55c90b1d6cbda581f9ccd41ea1c8da15da98d5ee,1,253,0,253,1,2013-07-27 03:00:45,2013-07-27 03:00:45
5fcb6e1263e9fa7938e4ebfc03bf44aa624a5d7b...25913cf14402dbf71a95c56cae69008bcec71b69,1,17,4,21,5,2013-07-26 01:49:40,2013-07-26 01:49:40
25913cf14402dbf71a95c56cae69008bcec71b69...0456664463374f4872200ffc057c741433eba4f6,1,1,1,2,1,2013-07-26 01:53:53,2013-07-26 01:53:53
0456664463374f4872200ffc057c741433eba4f6...b9474c411b84c3a7985143060393619b459b0162,1,1,1,2,1,2013-08-14 04:04:06,2013-08-14 04:04:06
5fcb6e1263e9fa7938e4ebfc03bf44aa624a5d7b...7fb17127c7ef2ff11240af5c42430ae3ae1c0369,1,6,0,6,1,2013-07-24 21:30:12,2013-07-24 21:30:12
7fb17127c7ef2ff11240af5c42430ae3ae1c0369...1af012d4991a36bfb0e2def3e67f5a0e56fc49e4,2,5,6,11,2,2013-08-06 20:28:52,2013-08-06 20:28:52
7f75bb90e326fdb39de37c14a0813e52801b1bba...11253336cfc771537f63268fd03d466cd27936a0,1,1,1,2,1,2014-11-07 09:47:27,2014-11-07 09:47:27
43aa3783f8a5606e0f884a43d51daf36553af1e4...43a2e24c25531c27e502313d23c44bd5d7e0c405,1,31,0,31,2,2014-12-12 22:48:17,2014-12-12 20:56:59
43aa3783f8a5606e0f884a43d51daf36553af1e4...1d2c1e8ab80922fb673a08440a8e2b33b9231de1,1,1,2,3,1,2014-12-12 17:37:35,2014-12-12 17:37:35
43aa3783f8a5606e0f884a43d51daf36553af1e4...9677cfb34e896a59896c4cc747108ca8e3d20e86,1,1,1,2,1,2014-12-11 21:41:47,2014-12-11 21:41:47
43aa3783f8a5606e0f884a43d51daf36553af1e4...9bab8ccb89466be8bc8c579264f51b194aa89612,1,1,1,2,1,2014-12-10 12:40:34,2014-12-10 12:40:34
43aa3783f8a5606e0f884a43d51daf36553af1e4...ed029f18010ea10c7bc4a2a90f75111503e613d9,1,8,6,14,2,2014-12-08 14:30:28,2014-04-29 13:38:48
43aa3783f8a5606e0f884a43d51daf36553af1e4...a19d1d1f05281fc286991ff85010d6d431ae1d58,1,2,0,2,1,2014-12-04 03:38:37,2014-12-04 03:38:37
43aa3783f8a5606e0f884a43d51daf36553af1e4...011f25d492ab23b0f1dd50ea0f406892810e781e,1,2,2,4,2,2014-12-02 18:10:47,2014-12-02 18:10:47
43aa3783f8a5606e0f884a43d51daf36553af1e4...575bb91b5f2e1220e566385e2982ca4f72521819,1,1,0,1,1,2014-12-01 11:34:18,2014-12-01 11:34:18
43aa3783f8a5606e0f884a43d51daf36553af1e4...1ebc98b9ede5ad5084b3e504e4fc8c01cb93be71,1,7,3,10,2,2014-12-01 01:37:47,2014-12-01 01:37:47
1ebc98b9ede5ad5084b3e504e4fc8c01cb93be71...5bf715787a4483cafd70461417cb9a1bf8d1509f,1,2,2,4,2,2014-12-01 01:39:21,2014-12-01 01:39:21
43aa3783f8a5606e0f884a43d51daf36553af1e4...c6a8b2ea6d80e33716ce5590f4c4aff96776f06e,1,2,2,4,1,2014-11-28 16:40:56,2014-11-28 16:40:56
43aa3783f8a5606e0f884a43d51daf36553af1e4...4b05e548d0b56238521b07dac1969e8cd2dcf608,1,49,43,92,9,2014-11-28 13:41:34,2013-11-22 10:48:13
619ecb5f4fcec9ceb3769f4697fcbb2cbe3f2a7a...2d1a07a3f72353a59ed9ecda88969093406699f7,1,7,7,14,7,2013-08-07 16:41:49,2013-08-07 16:41:49
619ecb5f4fcec9ceb3769f4697fcbb2cbe3f2a7a...0a62f6636d6fc749b13a45b3d032f3616f2c828d,1,19,0,19,1,2013-08-07 15:59:53,2013-08-07 15:59:53
df5b09e20b05a5ba4234599602f7a74934c916db...a301f567e3a7ac2eb0b1f77d6ff97f50d63ba864,1,1,1,2,1,2014-11-19 17:40:18,2014-11-19 17:33:00
df5b09e20b05a5ba4234599602f7a74934c916db...0c04470f6370c329ce8252371fe617673b515d45,1,2,2,4,1,2014-11-16 19:38:27,2014-11-14 10:05:11
df5b09e20b05a5ba4234599602f7a74934c916db...00ec11d3c0a2b2b7413ad84940ddec299aafbb04,7,16,16,32,11,2014-11-16 08:47:35,2014-11-16 08:47:35
df5b09e20b05a5ba4234599602f7a74934c916db...923d2c85b40e14ea90d4342be1e1905bb238ea0b,1,2,0,2,1,2014-11-15 18:32:34,2014-01-19 19:10:16
df5b09e20b05a5ba4234599602f7a74934c916db...d0f3fb3a4fdce51e1f59bdf4817c7adec80b0784,1,2,8,10,1,2014-11-11 02:42:31,2014-06-10 14:24:38
df5b09e20b05a5ba4234599602f7a74934c916db...8bd8597e12d25ada4a288bffef946ac62b9f9de4,1,9,29,38,12,2014-11-08 10:03:24,2014-11-08 09:58:52
141c2e593401f245a9f9bb0799ada8bf14b677d7...08b9f8d6770e2f626bca0d320d2b577e0e1597c5,1,29,0,29,1,2014-12-14 05:43:52,2014-12-14 05:09:34
08b9f8d6770e2f626bca0d320d2b577e0e1597c5...7488e9b510f0fec31bb05362f8aa97ec857e8962,1,7,0,7,1,2014-12-15 02:18:18,2014-12-15 02:18:18
7488e9b510f0fec31bb05362f8aa97ec857e8962...00ff1bbd1c666be789f94c30cfdd837d16d190d8,1,2,2,4,2,2014-12-15 15:37:38,2014-12-15 15:37:38
141c2e593401f245a9f9bb0799ada8bf14b677d7...0bd3c9996fa58494fbefaad483abbe60ed332889,1,5,6,11,4,2014-12-13 18:44:38,2014-12-13 18:13:27
0bd3c9996fa58494fbefaad483abbe60ed332889...cf586b54b8aacd7fad7afc74d4f395da56e828b6,1,1,1,2,1,2014-12-13 18:45:02,2014-12-13 18:14:23
cf586b54b8aacd7fad7afc74d4f395da56e828b6...0190eb084bfb39bfa5920f85c2fc33730236217c,1,1,1,2,1,2014-12-13 18:45:04,2014-12-13 18:18:11
0190eb084bfb39bfa5920f85c2fc33730236217c...711843153d6e53a89d37931217f59c4f6a3a35db,1,11,10,21,7,2014-12-13 18:52:49,2014-12-13 18:36:57
711843153d6e53a89d37931217f59c4f6a3a35db...dd270878053a73600382de1c3592c04d985e5e08,1,2,2,4,2,2014-12-13 18:57:23,2014-11-24 12:08:39
0222e774978232c03795b0e858d105aba6ed8123...db8eacf6fd0570c8e49e59a44c214bd927479861,1,2,2,4,2,2014-11-26 14:20:00,2014-06-09 17:04:16
0222e774978232c03795b0e858d105aba6ed8123...1dfadc734cb10c5512be4ec1dbe329a3e362ab20,1,3,3,6,3,2014-11-24 08:54:50,2014-11-24 08:54:50
