id,files,locs added,locs removed,locs total,hunks,commit time,author time
4b825dc642cb6eb9a060e54bf8d69288fbee4904...4bb7653f67b60fcf464d6c30e2ebe1b87d2dbc31,3,316,0,316,3,2012-02-01 01:35:23,2012-02-01 01:35:23
4b825dc642cb6eb9a060e54bf8d69288fbee4904...eb81782cdbdc68aaebe4fa561b5fbb73ef866611,27,4313,0,4313,21,2011-04-27 20:53:51,2011-04-27 20:53:51
eb81782cdbdc68aaebe4fa561b5fbb73ef866611...677b5554f34d8206b7424796448ee1b5a9ba0e87,8,379,90,469,11,2011-04-27 21:49:56,2011-04-27 21:49:56
677b5554f34d8206b7424796448ee1b5a9ba0e87...b9d6acf766728b0bf28fe4d7644a80651f9b0e1c,2,233,208,441,12,2011-04-27 22:40:12,2011-04-27 22:40:12
b9d6acf766728b0bf28fe4d7644a80651f9b0e1c...b95e99a173f50dbbca2478338f42165532289db7,5,173,107,280,55,2011-04-28 06:00:33,2011-04-28 06:00:33
b95e99a173f50dbbca2478338f42165532289db7...0824ed4e3364bc0b49df89945dd69deff3ee7acd,2,13,2,15,3,2011-04-28 06:05:19,2011-04-28 06:05:19
0824ed4e3364bc0b49df89945dd69deff3ee7acd...8c2e1286984152c0a354296d8a9f6fcfc9a14dfd,1,6,1,7,3,2011-04-28 06:12:49,2011-04-28 06:12:49
8c2e1286984152c0a354296d8a9f6fcfc9a14dfd...eb3389303d169b4ad8e85292e23fbc1a1be87f1b,4,120,27,147,15,2011-04-28 18:46:32,2011-04-28 18:46:32
eb3389303d169b4ad8e85292e23fbc1a1be87f1b...e89ba29385d43ffed43b479be566e98ad2eaf1ff,2,202,2,204,2,2011-04-28 18:53:10,2011-04-28 18:53:10
e89ba29385d43ffed43b479be566e98ad2eaf1ff...d61317d7b5bb7a8aa11f7ac3fc60efcd359f1606,5,557,22,579,21,2011-04-29 00:24:59,2011-04-29 00:24:59
d61317d7b5bb7a8aa11f7ac3fc60efcd359f1606...bb8ebe2312e4424a4e40974f0f21dd008064f736,6,22,14,36,14,2011-04-29 18:40:24,2011-04-29 18:40:24
bb8ebe2312e4424a4e40974f0f21dd008064f736...a6d5f6743f41c0e62fa7e97dc7faa5d1a47f2456,3,183,4,187,6,2011-05-04 00:35:08,2011-05-04 00:35:08
a6d5f6743f41c0e62fa7e97dc7faa5d1a47f2456...d447898bf251cfa4cc6b1c8f9cb4c238ad12ef52,9,1800,0,1800,9,2011-05-04 01:09:25,2011-05-04 01:09:25
d447898bf251cfa4cc6b1c8f9cb4c238ad12ef52...96c3e709963516a06ad6e723a7bba3fbf5fc1ba2,32,49,1852,1901,21,2011-05-04 01:12:43,2011-05-04 01:12:43
96c3e709963516a06ad6e723a7bba3fbf5fc1ba2...037bf9fec59dd2ecdd449f8bc680ece12c54fb94,9,1813,542,2355,16,2011-05-05 06:49:31,2011-05-05 06:49:31
037bf9fec59dd2ecdd449f8bc680ece12c54fb94...15a679e2d1459e7c71b27c28d6823d40257db327,2,54,24,78,8,2011-05-05 07:59:16,2011-05-05 07:59:16
15a679e2d1459e7c71b27c28d6823d40257db327...0a627019a53e20851c34b69f6c131afcca371d82,2,223,8,231,6,2011-05-10 22:30:49,2011-05-10 22:30:49
0a627019a53e20851c34b69f6c131afcca371d82...b9e28e48a8ef480eff3420896d92b130ae6496a5,2,2,2,4,2,2011-05-11 17:53:06,2011-05-11 17:53:06
b9e28e48a8ef480eff3420896d92b130ae6496a5...dd769f9a6e4419f0588a4c947961ae148fdb3671,14,597,344,941,77,2011-06-27 23:47:12,2011-06-27 23:47:12
4bb7653f67b60fcf464d6c30e2ebe1b87d2dbc31...d66eb91437bc5394344b36c9f717bfb5e0e206d3,1,1,1,2,2,2012-02-02 05:17:04,2012-02-02 05:17:04
4bb7653f67b60fcf464d6c30e2ebe1b87d2dbc31...b6886bd5434774c83646b05027631e9e656f02ee,3,26,5,31,8,2012-02-02 01:41:24,2012-02-02 01:41:24
b6886bd5434774c83646b05027631e9e656f02ee...d90e519486500a8f7f460267767de2eba3cf8898,3,9,9,18,3,2012-02-02 01:57:39,2012-02-02 01:57:39
d90e519486500a8f7f460267767de2eba3cf8898...cc15d0f766692d9d5d2154319624f5acedd9802d,3,0,3,3,3,2012-02-02 02:00:40,2012-02-02 02:00:40
dd769f9a6e4419f0588a4c947961ae148fdb3671...243fc873d9a5a07dd85b9809fc845557d482369a,5,34,67,101,11,2011-06-28 00:15:26,2011-06-28 00:15:26
dd769f9a6e4419f0588a4c947961ae148fdb3671...9b5c2662e4a07aae82b32bef35eb5b5201dc1917,1,1,1,2,1,2011-06-28 00:09:20,2011-06-28 00:09:20
0c475b8e4c97e482d932cb018b5e6bc81b69b173...68a92876bc2627ab5578a3e11406a9b11fdd9b93,1,1,0,1,1,2012-02-07 18:58:01,2012-02-07 18:58:01
68a92876bc2627ab5578a3e11406a9b11fdd9b93...2f635765380dfcdcb63cadbed7a81a120e0d3eb9,1,1,0,1,1,2012-02-07 19:05:13,2012-02-07 19:05:13
2f635765380dfcdcb63cadbed7a81a120e0d3eb9...93aa5c869eb736bcafefa12e0077725c83163734,1,1,0,1,1,2012-02-07 19:06:08,2012-02-07 19:06:08
0c475b8e4c97e482d932cb018b5e6bc81b69b173...73db80666063c1cd75ac61edc87e3d01f8ee34d7,3,18,15,33,9,2012-02-05 07:53:24,2012-02-05 07:53:24
4392c9529855f295b93c815a9ea691290e505779...7c4d17755a6ae16598dc14597a23cb74c223d6a4,1,0,140,140,1,2011-06-28 00:32:51,2011-06-28 00:32:51
9b5c2662e4a07aae82b32bef35eb5b5201dc1917...0864bf3b7a855bf1432136d49eb85e14d3040c4b,1,1,0,1,1,2011-06-28 00:31:58,2011-06-28 00:31:58
d743b4b8812244de56dd36192d489feb260d14ba...1fbe0bb290e560ebd18d39dc448f0bcebd2ea72a,3,3,3,6,3,2012-02-28 02:48:28,2012-02-28 02:48:28
d743b4b8812244de56dd36192d489feb260d14ba...f17658b02d52fca265bc04e2a3a1ea713cf68f01,3,12,12,24,3,2012-02-24 22:06:02,2012-02-24 22:06:02
b54c07b5a8f0b1d2295034b73c271da38960cf48...bb665f157eccc6262c4e2c8c4f7d1b7d76d07eef,1,0,1,1,1,2011-06-28 00:48:40,2011-06-28 00:48:40
d4a48c96184b80b8b4761c99c285e003571b8c5d...a3bc40c4cd96383611ff9b14cb7854667e500d26,3,10,10,20,4,2012-03-12 07:21:52,2012-03-12 07:21:52
a3bc40c4cd96383611ff9b14cb7854667e500d26...582f4789ead572d0b7924556268a3e8248279350,3,3,0,3,3,2012-03-25 07:46:03,2012-03-25 07:46:03
582f4789ead572d0b7924556268a3e8248279350...13ae2b0fe69edb01cd7ea32141a726e3e03fc2e3,1,1,1,2,1,2012-03-25 08:21:47,2012-03-25 08:21:47
13ae2b0fe69edb01cd7ea32141a726e3e03fc2e3...d23a146d77ca45ed0bd8e799f06660272252b012,1,11,1,12,2,2012-04-02 08:52:06,2012-04-01 22:22:52
d23a146d77ca45ed0bd8e799f06660272252b012...d03abac6281ac7c63080e6ab96de8bdb746bbf1e,1,108,0,108,1,2012-05-14 15:57:24,2012-05-14 15:57:24
d03abac6281ac7c63080e6ab96de8bdb746bbf1e...a25e78f9c95d389a141c4dd7cee70f267fc75da2,1,181,0,181,1,2012-05-15 06:40:06,2012-05-15 06:40:06
a25e78f9c95d389a141c4dd7cee70f267fc75da2...d8ff335cfd6a291227aa0054573d2445e438acd2,1,0,181,181,1,2012-05-15 06:45:25,2012-05-15 06:45:25
d8ff335cfd6a291227aa0054573d2445e438acd2...1e2fdd0b7c94de26649ddc9e8442b9ac27c07f12,1,0,108,108,1,2012-05-15 16:45:53,2012-05-15 16:45:53
1e2fdd0b7c94de26649ddc9e8442b9ac27c07f12...b3b04ec3ff7af3d42d729a58ecd26e21798a584b,1,2,2,4,2,2012-07-29 19:07:18,2012-07-29 19:07:18
b3b04ec3ff7af3d42d729a58ecd26e21798a584b...47d66e0a3f9a65208853ae67b71aa108ae813d1c,3,6,6,12,6,2012-07-30 17:08:27,2012-07-30 17:08:27
47d66e0a3f9a65208853ae67b71aa108ae813d1c...2b31caae2d5ddf69da4a341ac8becdd53cc79cc8,2,8,11,19,3,2012-07-30 19:15:08,2012-07-30 19:15:08
2b31caae2d5ddf69da4a341ac8becdd53cc79cc8...f6271da47bf928700ce2472097069f00a05a2825,1,12,0,12,1,2012-08-14 23:24:58,2012-08-14 23:24:58
f6271da47bf928700ce2472097069f00a05a2825...8d97ae98d24e8f57a0c9cbbd4fcb506ceae057e0,2,284,0,284,2,2012-09-14 22:17:46,2012-09-14 22:17:46
8d97ae98d24e8f57a0c9cbbd4fcb506ceae057e0...7ea4783df824c84df686edebbd4af34c72503c08,6,104,10,114,11,2012-09-14 22:21:44,2012-09-14 22:21:44
7ea4783df824c84df686edebbd4af34c72503c08...fe4a2d2c963e606a3ef7bc3c967b454be1362988,1,96,52,148,17,2012-09-14 22:55:46,2012-09-14 22:55:46
fe4a2d2c963e606a3ef7bc3c967b454be1362988...2fd17aa6a86696e5cf76b426cffc7f083ae0db79,1,89,18,107,23,2012-09-17 04:54:06,2012-09-17 04:53:56
2fd17aa6a86696e5cf76b426cffc7f083ae0db79...f12b0239bc7d29e0fd527523265b3fb51a2e6867,3,0,493,493,3,2012-09-17 15:53:13,2012-09-17 15:53:13
f12b0239bc7d29e0fd527523265b3fb51a2e6867...6cfabf5e22edeec53841140e37b63b19356bc6ed,2,231,0,231,2,2012-10-01 04:28:20,2012-10-01 04:28:20
6cfabf5e22edeec53841140e37b63b19356bc6ed...cfc032fd4163bd0d2f33686ec942078979c2f11d,1,124,0,124,1,2012-10-01 05:09:51,2012-10-01 05:09:51
cfc032fd4163bd0d2f33686ec942078979c2f11d...01a7f175795248629bb3edd4cdb38226338c9b29,1,170,0,170,1,2012-10-09 01:58:35,2012-10-09 01:58:35
01a7f175795248629bb3edd4cdb38226338c9b29...9a25a10ba6fcb459576820fb32d8942b7d6f6bad,1,2,0,2,2,2012-10-09 01:59:44,2012-10-09 01:59:44
9a25a10ba6fcb459576820fb32d8942b7d6f6bad...e83a974afeca1c5a0f8283344a6068ef444f098f,1,384,0,384,1,2012-10-11 00:58:22,2012-10-11 00:58:22
e83a974afeca1c5a0f8283344a6068ef444f098f...814f9f17f9c0a4ee57d3ad5a4e9044347a0e4966,1,4,4,8,3,2012-10-15 18:57:09,2012-10-15 18:57:09
814f9f17f9c0a4ee57d3ad5a4e9044347a0e4966...8db7111a63f1fe999555b5c798893b8e0c10aade,1,254,196,450,54,2012-10-16 17:50:10,2012-10-16 17:50:10
8db7111a63f1fe999555b5c798893b8e0c10aade...4bfab509df289e34d2e29ddd00a3665563de9b3d,1,3,3,6,3,2012-11-30 04:59:14,2012-11-30 04:59:14
bb665f157eccc6262c4e2c8c4f7d1b7d76d07eef...68f421eac7d71d3815b394efbefe2abafc30c6a5,2,2,1,3,2,2011-06-28 17:45:27,2011-06-28 17:45:27
bb665f157eccc6262c4e2c8c4f7d1b7d76d07eef...471563eb819092894d9c89683c1159612cecaffb,5,268,378,646,99,2011-06-28 07:23:54,2011-06-28 07:23:54
471563eb819092894d9c89683c1159612cecaffb...e33808447e13f340755861f389d7b4db4557f10c,4,65,2,67,6,2011-06-28 08:15:03,2011-06-28 08:15:03
4bfab509df289e34d2e29ddd00a3665563de9b3d...d37d2692309eb65784672665508c51bc8cf019d1,1,57,47,104,10,2012-12-03 21:01:27,2012-12-03 21:01:27
d37d2692309eb65784672665508c51bc8cf019d1...5cf2e8a1cbd86a2c3c4d3683c2ffda248eb27355,8,24,24,48,16,2012-12-03 21:25:56,2012-12-03 21:25:56
4bfab509df289e34d2e29ddd00a3665563de9b3d...145ed23ac5d1c50e76727889cc54948bf80058d2,1,0,154,154,1,2012-12-01 00:18:40,2012-12-01 00:18:40
80abe21189992f165ff8c7091743bda727adfedd...9660f6f18d610ee4b03c0e3bf2823393fc66640b,9,147,123,270,47,2011-06-28 18:56:49,2011-06-28 18:56:49
5cf2e8a1cbd86a2c3c4d3683c2ffda248eb27355...312509e1c0d34b75e3c3bc769c77015efe5106c0,1,1,1,2,1,2012-12-10 04:10:38,2012-12-10 04:10:38
9660f6f18d610ee4b03c0e3bf2823393fc66640b...e3865e75ac27383b958df27b20281e4c5ce95ada,3,1,3,4,3,2011-06-28 19:39:58,2011-06-28 19:39:58
9660f6f18d610ee4b03c0e3bf2823393fc66640b...af95f5ce52546e94f988fbeb683ddaecbd3994f5,1,2,0,2,2,2011-06-28 19:04:27,2011-06-28 19:04:27
312509e1c0d34b75e3c3bc769c77015efe5106c0...ebd17141e8f9ff9119341afaab4355910149fe46,1,1,1,2,1,2013-01-10 10:10:52,2013-01-10 10:10:52
ebd17141e8f9ff9119341afaab4355910149fe46...69cc97dd3447370831ee400fdebd0a5667e5a420,1,1,1,2,1,2013-01-10 10:13:26,2013-01-10 10:13:26
69cc97dd3447370831ee400fdebd0a5667e5a420...82eeba11b134f79290dc23a38590e6ce936b25ca,1,1,1,2,1,2013-01-10 10:13:43,2013-01-10 10:13:43
82eeba11b134f79290dc23a38590e6ce936b25ca...d05006349ee3576d0f5a8ad4425d4c54b3f9f742,1,1,1,2,1,2013-01-10 10:13:57,2013-01-10 10:13:57
d05006349ee3576d0f5a8ad4425d4c54b3f9f742...e7a13a94168c9a83898ab1d549b8ced22b42774c,1,1,1,2,1,2013-01-10 10:14:14,2013-01-10 10:14:14
312509e1c0d34b75e3c3bc769c77015efe5106c0...7b4971e4d1022e0349dc01ea81756e801195fdf9,1,1,0,1,1,2013-01-09 10:23:17,2013-01-09 10:23:17
312509e1c0d34b75e3c3bc769c77015efe5106c0...0f9490bf3e15b76c502685ad2f000819ce49390a,1,2,0,2,1,2012-12-20 22:40:39,2012-12-20 22:40:39
0f9490bf3e15b76c502685ad2f000819ce49390a...b7f2a382b610a677a8cf58c983fcd750c9aa7fd9,1,0,0,0,0,2012-12-21 04:27:07,2012-12-21 04:27:07
b7f2a382b610a677a8cf58c983fcd750c9aa7fd9...4fa4d5254d8b1fc9dae9ee1dfbe555323aaa4e2b,1,1,0,1,1,2012-12-22 03:10:05,2012-12-22 03:10:05
2da82cd7ca8e7f8076416f300060c11bb2ab7d4e...e91a74e8e89240d061478326ad26bd4ffa9ce910,10,243,241,484,23,2011-06-28 21:24:02,2011-06-28 21:24:02
2da82cd7ca8e7f8076416f300060c11bb2ab7d4e...5949b8e14559464539541ee02f6af4fc2cfe1cbf,2,187,187,374,2,2011-06-28 21:23:07,2011-06-28 21:23:07
98b0d4946f187e5e5145fc8a218d1d0f9b58e4d7...99649aad71e1046b4e066eb9cc7129987fbc6513,1,0,5,5,1,2013-01-11 19:00:45,2013-01-11 19:00:45
99649aad71e1046b4e066eb9cc7129987fbc6513...07a5563a0b27f09e73b148b6bd2dc123d5f05780,1,1,1,2,1,2013-01-12 04:30:56,2013-01-12 04:30:56
07a5563a0b27f09e73b148b6bd2dc123d5f05780...d034ec74c41df536bc3bdfab8200dbf30031120f,1,9,0,9,1,2013-01-12 08:20:13,2013-01-12 08:20:13
4fa4d5254d8b1fc9dae9ee1dfbe555323aaa4e2b...ee9cd0180d25928f76bfd9b4457275df6a00a619,2,167,0,167,2,2013-01-10 03:53:42,2013-01-10 03:53:42
4fa4d5254d8b1fc9dae9ee1dfbe555323aaa4e2b...034155ec215f3c6dadbc22939737de5184128756,2,2,2,4,2,2013-01-02 22:39:21,2013-01-02 22:39:21
e91a74e8e89240d061478326ad26bd4ffa9ce910...08c318e0087ac9351bd3f883193c9a0886a43438,5,5,4,9,5,2011-06-28 22:10:43,2011-06-28 22:10:43
01c5e74bb3a351feb0c83ff14fb22244647eb82b...4e95e558db14a2de80c6cdfd5712c15c8130a951,10,178,292,470,108,2011-06-28 22:11:41,2011-06-28 22:11:41
d034ec74c41df536bc3bdfab8200dbf30031120f...0f9073c5cd88d362d5e9eb6541ec8ad25add6205,9,9,9,18,9,2013-01-14 08:11:55,2013-01-14 08:11:55
68475f87079124710e2f3c2eb96dbd6a45df16cd...dd582177122b317f414a07ca66fe7319203fa1be,1,10,11,21,7,2013-01-18 04:28:05,2013-01-18 04:28:05
dd582177122b317f414a07ca66fe7319203fa1be...0050688fecb58bb458824b0c1db2e40865cb3924,1,12,2,14,2,2013-01-18 04:30:19,2013-01-18 04:30:19
0050688fecb58bb458824b0c1db2e40865cb3924...0f1af68e69336810cc808c009427449df5804eab,1,0,0,0,0,2013-01-18 04:32:07,2013-01-18 04:32:07
0f1af68e69336810cc808c009427449df5804eab...56f8b735a5ab3e5a1825b9890c8589f5207757e4,1,55,46,101,9,2013-01-18 04:35:59,2013-01-18 04:35:59
56f8b735a5ab3e5a1825b9890c8589f5207757e4...70fca06f252c5e5b05013e2453fe71903f6832fd,3,31,35,66,16,2013-01-18 04:39:38,2013-01-18 04:39:38
70fca06f252c5e5b05013e2453fe71903f6832fd...8713fa1edf406b1bb2223dcbbdf37b9b1dd4b564,2,54,54,108,19,2013-01-18 05:05:23,2013-01-18 05:05:23
8713fa1edf406b1bb2223dcbbdf37b9b1dd4b564...a4ad96b848b81f117a111cc13c4ba230ba46395b,1,12,0,12,3,2013-01-18 09:33:55,2013-01-18 09:33:55
a4ad96b848b81f117a111cc13c4ba230ba46395b...07543a94032d57d1ebcae859e15c959651935922,2,25,19,44,8,2013-01-18 09:37:31,2013-01-18 09:37:31
07543a94032d57d1ebcae859e15c959651935922...e405a22301b77edfe57fb9adfd4247c86e354881,1,27,15,42,7,2013-01-18 09:52:16,2013-01-18 09:52:16
e405a22301b77edfe57fb9adfd4247c86e354881...4e938ff018a98429163db55d352d3b1a0ba64c86,2,42,38,80,13,2013-01-19 17:34:08,2013-01-19 17:34:08
4e938ff018a98429163db55d352d3b1a0ba64c86...57a66ee7cd306e7e8ac2338cc1812f16226d2b18,2,2,2,4,2,2013-01-19 17:39:56,2013-01-19 17:39:56
57a66ee7cd306e7e8ac2338cc1812f16226d2b18...5762b67a9f184f7016abdfcd2ab40e0d206da9e5,1,26,28,54,1,2013-01-19 17:40:26,2013-01-19 17:40:26
5762b67a9f184f7016abdfcd2ab40e0d206da9e5...bd265daa821e2968fc8d9c0f49de94795e739db6,1,4,1,5,2,2013-02-01 02:06:56,2013-02-01 02:06:56
bd265daa821e2968fc8d9c0f49de94795e739db6...c16aee941fae409e268a910a7a60fe738112ea63,1,48,22,70,8,2013-02-01 02:22:47,2013-02-01 02:22:47
c16aee941fae409e268a910a7a60fe738112ea63...c3fefca1beeb04ce302b925137786e9f7ae610a0,1,0,0,0,0,2013-02-01 02:25:44,2013-02-01 02:25:44
c3fefca1beeb04ce302b925137786e9f7ae610a0...7c55cf0660776474a44c20a6f6714f5746d12643,1,40,7,47,7,2013-02-01 02:34:12,2013-02-01 02:34:12
7c55cf0660776474a44c20a6f6714f5746d12643...b1088a2d493188adf80189ff4b96b58c590883bc,1,2,2,4,2,2013-02-01 18:30:48,2013-02-01 18:30:48
b1088a2d493188adf80189ff4b96b58c590883bc...ce497ae73088ecec492a5de2a2ae5a460ba27fbc,1,55,44,99,13,2013-02-01 18:32:08,2013-02-01 18:32:08
a92aeda6a11e9d40300bad48766e0f3b5f9d9397...b11784fec036e09e523df4a96b571071af88446a,6,22,15,37,12,2011-06-28 22:31:05,2011-06-28 22:31:05
b11784fec036e09e523df4a96b571071af88446a...25d9a2f2b8e5bcc266e676fdca43541206eb3dbf,6,41,13,54,15,2011-06-28 22:54:25,2011-06-28 22:54:25
25d9a2f2b8e5bcc266e676fdca43541206eb3dbf...890acaa356858ef71d2f267d8f09efa414b9c936,2,10,0,10,2,2011-06-29 02:49:42,2011-06-29 02:49:42
890acaa356858ef71d2f267d8f09efa414b9c936...a878b83e69f069ed62fb1c9766dd17e90727f5fa,1,0,1,1,1,2011-06-29 02:56:26,2011-06-29 02:56:26
a878b83e69f069ed62fb1c9766dd17e90727f5fa...5f818d3d22adfdd2db23dc373824a64baaebfac0,7,42,113,155,53,2011-06-29 14:40:14,2011-06-29 14:40:14
5f818d3d22adfdd2db23dc373824a64baaebfac0...e0b09867c23b421153f10235ec64d484bac6323d,1,15,11,26,9,2011-06-29 14:54:55,2011-06-29 14:54:55
0f9073c5cd88d362d5e9eb6541ec8ad25add6205...cc58a65fa125f119af713db5d92413c093503ce4,5,10,10,20,10,2013-02-01 18:33:36,2013-02-01 18:33:36
3db1b902c8a5905a382a572c7b54776b10ca2e6b...83f55eab5b14a22d4a6546b55a2f1ad36aff4457,1,1,1,2,1,2013-02-14 21:26:52,2013-02-14 21:26:52
83f55eab5b14a22d4a6546b55a2f1ad36aff4457...b9291929bf58693f13f2cd48c9644e0e4febdc2d,1,1,1,2,1,2013-02-14 21:30:22,2013-02-14 21:30:22
3db1b902c8a5905a382a572c7b54776b10ca2e6b...eb02887bc34130647a52f8152c13531d97f5a058,9,0,1632,1632,9,2013-02-12 20:25:05,2013-02-12 20:25:05
eb02887bc34130647a52f8152c13531d97f5a058...407e935c9c05b089c71550e93432ec42d95369e6,9,1632,0,1632,9,2013-02-12 20:44:41,2013-02-12 20:44:41
407e935c9c05b089c71550e93432ec42d95369e6...0765ea43dd7344b9485e5e3b43027ddd78cd34a8,8,1070,1439,2509,37,2013-02-15 07:38:00,2013-02-15 07:38:00
e0b09867c23b421153f10235ec64d484bac6323d...e72283ccafaf37996ee44f26fca1e44f1501f53e,9,86,144,230,63,2011-06-29 22:40:52,2011-06-29 22:40:52
e0b09867c23b421153f10235ec64d484bac6323d...025f74ef93fadf1f2615789e4560ebf420bf3d6f,5,22,5,27,10,2011-06-29 20:48:08,2011-06-29 20:48:08
87a317f42fbe6e1312937bc0cfa05a97f10a8096...c4b2bb5bcd189788407b9705cf043c916e8d05e7,2,2,2,4,2,2013-02-15 07:51:35,2013-02-15 07:51:35
c4b2bb5bcd189788407b9705cf043c916e8d05e7...34ca3d645a60ddd078bfeb742f2ca87d7c7df2b1,1,0,163,163,1,2013-02-16 09:43:23,2013-02-16 09:43:23
34ca3d645a60ddd078bfeb742f2ca87d7c7df2b1...c65063271a0744a35150cf0221342839b59c6ce3,1,6,6,12,6,2013-02-18 02:48:00,2013-02-18 02:48:00
c65063271a0744a35150cf0221342839b59c6ce3...9f279c60777532855a8e8ff681a6a494817dc383,1,7,2,9,2,2013-02-18 02:58:40,2013-02-18 02:58:40
9f279c60777532855a8e8ff681a6a494817dc383...42488cbb456d24ed0dca7b6d2a44333730a0bd56,1,6,5,11,3,2013-02-18 03:04:38,2013-02-18 03:04:38
025f74ef93fadf1f2615789e4560ebf420bf3d6f...936d7acb31d4f765638630a8c78c81ee9de57801,6,227,182,409,35,2011-06-29 22:51:27,2011-06-29 22:51:27
936d7acb31d4f765638630a8c78c81ee9de57801...f47b5765743dc7001b3f7d22ed2e8e2b3d9545a3,3,95,21,116,16,2011-06-30 00:10:53,2011-06-30 00:10:53
42488cbb456d24ed0dca7b6d2a44333730a0bd56...110c5b70a1727976bb6a8b8d1504d76a6ab8689f,4,5,5,10,5,2013-03-26 00:46:44,2013-03-26 00:46:44
110c5b70a1727976bb6a8b8d1504d76a6ab8689f...597d9e8965c71b89543602300474999701f06ab4,4,5,5,10,5,2013-03-26 01:13:13,2013-03-26 01:13:13
42488cbb456d24ed0dca7b6d2a44333730a0bd56...61174c3c1d6bc0bcdfdf5e59ef78936d63d30a37,3,198,0,198,3,2013-02-26 08:42:24,2013-02-26 08:42:24
61174c3c1d6bc0bcdfdf5e59ef78936d63d30a37...044b094b22085c9c1972ad961674fffcf770dd12,1,64,0,64,1,2013-02-26 08:49:21,2013-02-26 08:49:21
cddc565d07fed42576a55111ea60ce1b6ff5bbd9...1905a992d9cc8f1160930edad6ec5d52eaf06d85,5,110,47,157,30,2011-06-30 06:47:54,2011-06-30 06:47:54
1905a992d9cc8f1160930edad6ec5d52eaf06d85...9e33ab20abaa34bf761ca74ab843cb43d6ae138d,9,110,263,373,71,2011-06-30 07:15:37,2011-06-30 07:15:37
9e33ab20abaa34bf761ca74ab843cb43d6ae138d...ced32d5ceb28b9a69e5acce2218b17e0efcf7685,2,28,18,46,15,2011-06-30 07:31:56,2011-06-30 07:31:56
37ba2824bf01ba5db44b64147212763c5064c764...64946ce93b35eda95d0c936af7d6f176e7a3cfc5,1,14,16,30,1,2013-03-26 19:31:03,2013-03-26 19:31:03
64946ce93b35eda95d0c936af7d6f176e7a3cfc5...2d47cb699e699daabf70662bfd4e7ed32eb69364,5,17,81,98,16,2013-03-27 00:17:39,2013-03-27 00:17:39
2d47cb699e699daabf70662bfd4e7ed32eb69364...9a0ee742f65de5bc36b077ee21a2894d3713d8af,5,7,7,14,7,2013-03-30 07:11:38,2013-03-30 07:11:38
9a0ee742f65de5bc36b077ee21a2894d3713d8af...f8d78eba5cb1c93373a9f185e1c4a682052907c3,1,0,1,1,1,2013-03-31 05:53:35,2013-03-31 05:53:35
f8d78eba5cb1c93373a9f185e1c4a682052907c3...85cd847e472cc39f9b41af1312d34341779a480b,1,2,1,3,1,2013-03-31 05:54:31,2013-03-31 05:54:31
85cd847e472cc39f9b41af1312d34341779a480b...4df128264b766cc256d23f2e202994df0a516dcf,2,2,1,3,2,2013-03-31 18:24:31,2013-03-31 18:24:31
4df128264b766cc256d23f2e202994df0a516dcf...ccb9ecfe441214574298edf8a3859dbf9144bc2b,1,19,40,59,15,2013-04-01 01:47:02,2013-04-01 01:25:45
ced32d5ceb28b9a69e5acce2218b17e0efcf7685...518c882da08390d45194d318ab575ed10766a382,1,10,9,19,1,2011-06-30 17:43:06,2011-06-30 17:43:06
ced32d5ceb28b9a69e5acce2218b17e0efcf7685...6aae3930c92052a49686c1bd73a264da905ce898,4,34,29,63,12,2011-06-30 17:21:27,2011-06-30 17:21:27
6aae3930c92052a49686c1bd73a264da905ce898...588b2da937dd5c34766863fba3a9daaf2276d900,8,39,47,86,19,2011-06-30 17:40:28,2011-06-30 17:40:28
ccb9ecfe441214574298edf8a3859dbf9144bc2b...a1d64950a9626023e21e03811e580efa7800c66f,1,56,0,56,1,2013-04-01 19:55:48,2013-04-01 19:55:48
ccb9ecfe441214574298edf8a3859dbf9144bc2b...ff363323e6076e7a966eabe877e153fcc452e4dc,1,0,2,2,1,2013-04-01 13:27:49,2013-04-01 13:27:49
ff363323e6076e7a966eabe877e153fcc452e4dc...994e36806c9a09760e7ac72c507d1de8a9beffe0,1,6,0,6,1,2013-04-01 13:29:43,2013-04-01 13:29:43
994e36806c9a09760e7ac72c507d1de8a9beffe0...7991062f93d99f517d8d30c51ed865d7890d4bbe,1,1,37,38,4,2013-04-01 16:58:40,2013-04-01 16:58:40
588b2da937dd5c34766863fba3a9daaf2276d900...b57221e4cafd60d18e9a8cd5b2105f561656c2cf,4,5,9,14,7,2011-06-30 18:13:00,2011-06-30 18:13:00
8454d073722a23746c3f2209034fa8fa035b8302...ed54b6dcf754dc613ff77e4e957c551a354f6d0a,3,3,3,6,3,2013-04-02 11:22:31,2013-04-02 11:22:31
ed54b6dcf754dc613ff77e4e957c551a354f6d0a...fb94710d9a88dfd24a2aa2f3a1ecfa5d3d8a8b88,2,2,2,4,2,2013-04-02 11:26:35,2013-04-02 11:26:35
fb94710d9a88dfd24a2aa2f3a1ecfa5d3d8a8b88...6e6820b3883cf207b69cb7ea9e338ac9fbf7ac35,1,6,6,12,6,2013-04-02 11:30:13,2013-04-02 11:30:13
6e6820b3883cf207b69cb7ea9e338ac9fbf7ac35...8093426e40ed7be8e0ae612decb5f42f38e48aad,1,12,0,12,1,2013-04-02 11:39:04,2013-04-02 11:39:04
8093426e40ed7be8e0ae612decb5f42f38e48aad...b78dfb5a4c8b386fe5421be8252838d377e17558,1,56,34,90,20,2013-04-02 23:17:04,2013-04-02 23:17:04
b78dfb5a4c8b386fe5421be8252838d377e17558...7f0f731d6d0e7c91d12fa955ab0244b97dffbb16,8,8,8,16,8,2013-04-28 13:10:01,2013-04-28 13:10:01
7f0f731d6d0e7c91d12fa955ab0244b97dffbb16...f76c222089551c64f24d54cfb2888db454d0006c,5,25,25,50,18,2013-04-29 02:22:33,2013-04-29 02:22:33
015d2501b403fea18be5be1182717b721385e7d6...4c2614841e0f1bedbd5b56a7ee2f704276fb32a4,2,3,2,5,3,2011-06-30 18:13:53,2011-06-30 18:13:53
4c2614841e0f1bedbd5b56a7ee2f704276fb32a4...87f9ea00e4477b059453e8014693f621207c75eb,25,146,359,505,43,2011-06-30 20:17:58,2011-06-30 20:17:58
f76c222089551c64f24d54cfb2888db454d0006c...a0aaa222a66b2587ac68c4c6fcee4c6b0f3453bf,2,4,10,14,8,2013-05-03 03:23:10,2013-05-03 03:22:27
f76c222089551c64f24d54cfb2888db454d0006c...c8daf15985f82c08f43925dea13d5854313bd418,1,1,1,2,1,2013-05-02 17:03:54,2013-05-02 17:03:54
87f9ea00e4477b059453e8014693f621207c75eb...cde63b98bc97595e47a15b3178097f89edb7c6c7,21,28,79,107,38,2011-06-30 20:36:47,2011-06-30 20:36:47
87f9ea00e4477b059453e8014693f621207c75eb...89a05622ab03ea8278d746c39214daa8ab9107fa,7,0,1588,1588,7,2011-06-30 20:22:43,2011-06-30 20:22:43
1bce9b295d9f032c3728c994da6872f30efb8160...a0d02368a3c37d4cb20070deb6a8d5a5afedbc84,1,4,5,9,5,2013-05-03 22:18:27,2013-05-03 22:18:04
a0d02368a3c37d4cb20070deb6a8d5a5afedbc84...17713a6d395a31508216bc5b9a4d8288463a24df,3,7,7,14,3,2013-05-04 22:00:59,2013-05-04 22:00:59
bec94491364bb424541d92afd0daae046050e904...f725d60a76e6e9cca8e321589ad3d017f38965f4,4,0,0,0,0,2011-06-30 20:37:24,2011-06-30 20:37:24
f725d60a76e6e9cca8e321589ad3d017f38965f4...c53e394f71e54359e204f4e5f35eecb93dac65ef,5,26,14,40,15,2011-06-30 20:51:13,2011-06-30 20:51:13
89a05622ab03ea8278d746c39214daa8ab9107fa...68cfc85dea562008fce12c7e62c7c4feaa81b310,1,16,16,32,16,2011-06-30 20:47:07,2011-06-30 20:47:07
17713a6d395a31508216bc5b9a4d8288463a24df...71377771fe12e60b5b9363dec5893e9bc0e74736,1,1,1,2,1,2013-05-09 11:21:22,2013-05-09 11:21:22
71377771fe12e60b5b9363dec5893e9bc0e74736...4910e779ab14b596e53f39c87b264d59e1bd3045,3,9,9,18,9,2013-05-13 02:04:22,2013-05-13 02:04:22
4910e779ab14b596e53f39c87b264d59e1bd3045...551d72908355f869cdd94e8866f15678bef64ad3,1,0,2,2,1,2013-05-17 04:03:56,2013-05-17 04:03:29
551d72908355f869cdd94e8866f15678bef64ad3...9ecde4aab7e0376e5b89622df2dba800e78ed4a7,1,21,1,22,3,2013-05-17 05:11:31,2013-05-17 05:11:31
9ecde4aab7e0376e5b89622df2dba800e78ed4a7...afe0ab13dd292e54b4c1417dbf78512fd714e694,5,10,10,20,10,2013-06-02 21:51:36,2013-06-02 21:51:36
afe0ab13dd292e54b4c1417dbf78512fd714e694...37cd7b8596f2e288e8286ebbe11319cd8d480a80,5,24,24,48,17,2013-06-04 04:57:51,2013-06-04 04:57:51
37cd7b8596f2e288e8286ebbe11319cd8d480a80...993efebe4fad6b0c9fdba525963036f10991c31b,1,32,2,34,2,2013-06-10 06:43:43,2013-06-10 06:43:43
17713a6d395a31508216bc5b9a4d8288463a24df...5e033dcc20d63533f7b3073b8aff169d3a2c983c,1,195,0,195,1,2013-05-08 12:25:37,2013-05-06 13:58:04
17713a6d395a31508216bc5b9a4d8288463a24df...18be5f6d422e1b456a368853abd60aa345558dfb,1,195,0,195,1,2013-05-06 13:58:18,2013-05-06 13:58:04
e92be3f654be2cc5b1cbc8bb5c6cd3463f3ce2e6...6687acc8ecc6a69517386615749992b392fd797c,2,2,0,2,2,2011-06-30 20:57:29,2011-06-30 20:57:29
e92be3f654be2cc5b1cbc8bb5c6cd3463f3ce2e6...3c965e2981b0c1ea54581a6e4e22fffa867fba4c,1,4,4,8,4,2011-06-30 20:56:50,2011-06-30 20:56:50
84b6847c75c0a5ffe1bf69358f174fd6a66ceea0...9f73fef30a075949c1d9f3816a598b303dfe0bfe,1,36,26,62,25,2013-06-20 03:31:03,2013-06-20 03:31:03
9f73fef30a075949c1d9f3816a598b303dfe0bfe...f91559d85db1d7e41d19fa360a135fb9eb228bbe,4,5374,43,5417,4,2013-06-20 06:16:00,2013-06-20 06:16:00
f91559d85db1d7e41d19fa360a135fb9eb228bbe...a550ea51134e01d28512cdbab023673971307b73,1,1,5311,5312,1,2013-06-20 06:16:34,2013-06-20 06:16:34
a550ea51134e01d28512cdbab023673971307b73...14273cd53d6970c1bb7033659b5a7293c4d79dae,13,0,0,0,0,2013-06-20 06:17:17,2013-06-20 06:17:17
14273cd53d6970c1bb7033659b5a7293c4d79dae...522649011553f4d35dcdb71f2b8007e812c4d279,1,1,0,1,1,2013-06-22 22:35:58,2013-06-22 22:35:58
522649011553f4d35dcdb71f2b8007e812c4d279...471c409a121870ece95e729e881df97ebf8ad943,1,59,0,59,1,2013-06-23 01:29:13,2013-06-23 01:29:13
b08845808907ff46b383f4134c52b82bd9bd5875...460a84a926756768976cb0b24489971651475684,8,205,146,351,51,2011-06-30 22:56:25,2011-06-30 22:56:25
b08845808907ff46b383f4134c52b82bd9bd5875...291c1acd38875e8c9f96851974e584a53e9b1cb3,1,1,1,2,1,2011-06-30 21:18:48,2011-06-30 21:18:48
471c409a121870ece95e729e881df97ebf8ad943...8e50e7a8f264c65b453a9b7133c7532c439730f5,37,1527,1490,3017,41,2013-06-24 00:17:08,2013-06-24 00:17:08
471c409a121870ece95e729e881df97ebf8ad943...eec86051a47e32960b9f317cf8e6f4790e5d52f3,1,0,0,0,0,2013-06-23 20:21:40,2013-06-23 20:21:40
be3a57a692097a23c49062d50bfbcd2af652f940...7962b36dae6d0d793e2bfa04d69ae1a2e5dbd611,4,20,5,25,7,2011-07-02 05:15:16,2011-07-02 05:15:16
be3a57a692097a23c49062d50bfbcd2af652f940...8245a7087eac2e0725f2546d7bac9e68de94f58e,5,208,2,210,8,2011-07-02 04:30:12,2011-07-02 04:30:12
8245a7087eac2e0725f2546d7bac9e68de94f58e...5a7f3f72cbc86d79ac6c5967eed39be72bc08561,1,53,38,91,8,2011-07-02 04:37:12,2011-07-02 04:37:12
5a7f3f72cbc86d79ac6c5967eed39be72bc08561...26f9e8c4e8580c2d41f31a4fb504ee8c0fdeb145,1,3,1,4,3,2011-07-02 04:38:33,2011-07-02 04:38:33
0a1c46a12c628301f18bf5b8b394aaae1c188eb4...1a2ef331fdbe0a9f1e886146eba6d750f0ea5d3d,1,4,6,10,4,2013-07-18 21:57:27,2013-07-18 21:57:27
eec86051a47e32960b9f317cf8e6f4790e5d52f3...0dffb03c0b235625fc00b8914ea4ad4a961c33c0,2,56,0,56,2,2013-06-24 03:33:37,2013-06-24 03:33:37
163e68ade6eb9e1a8a2e52aadf975612ab850579...cbf69199599af69222f23ce2418f991c3a25d73b,3,6,6,12,6,2011-07-02 05:19:15,2011-07-02 05:19:15
cbf69199599af69222f23ce2418f991c3a25d73b...189d11593fc9db2baa89d29531218abc757ed5c7,1,3,3,6,3,2011-07-02 05:21:05,2011-07-02 05:21:05
189d11593fc9db2baa89d29531218abc757ed5c7...5992b4e0af8b65ecbd429ccb4c6809aaa50edbd9,1,3,3,6,2,2011-07-02 05:21:49,2011-07-02 05:21:49
26f9e8c4e8580c2d41f31a4fb504ee8c0fdeb145...52dfbe65006e1be7df88d1c1d39dc151ebc672aa,4,29,13,42,19,2011-07-02 06:21:11,2011-07-02 06:21:11
52dfbe65006e1be7df88d1c1d39dc151ebc672aa...088bfcc13a1f85557d12553a7942e3284c6ceae5,3,26,11,37,6,2011-07-02 17:45:59,2011-07-02 17:45:59
36c2a34c1e3dda18edbf4e0ce8f297309d55ef6d...bf51e24700627b17df5041f3a369f6f6b4a4bfbb,27,13,13,26,13,2013-07-21 06:17:01,2013-07-21 06:17:01
bf51e24700627b17df5041f3a369f6f6b4a4bfbb...6d269c2ed7e035101bac75eecd1551df5004ed1f,14,51,14,65,15,2013-07-21 06:30:08,2013-07-21 06:30:08
6d269c2ed7e035101bac75eecd1551df5004ed1f...9c13af8cb10f6e16322c50dfc82ae9263d99b82a,35,7536,24,7560,28,2013-07-27 03:42:47,2013-07-27 03:42:47
5992b4e0af8b65ecbd429ccb4c6809aaa50edbd9...3117fc979db9f678fa1782c6a9d0d1428b4894f8,5,411,52,463,14,2011-07-02 06:10:39,2011-07-02 06:10:39
e112d34b42d3ad23f662a646159f6266ab1b86ba...ff694b3522d99974e9f13b6a7c2af915e5b3f1ac,1,1,1,2,1,2011-07-02 17:47:41,2011-07-02 17:47:41
ff694b3522d99974e9f13b6a7c2af915e5b3f1ac...799fd6add0d82c203be5484ea92d139f9c2ea35e,8,93,37,130,19,2011-07-02 18:51:05,2011-07-02 18:51:05
c3e662641135b9fadeff589682e85eb4ace4bce6...2998929b39eb3a4d587c6237d98095f9f5b0df2f,3,23,13,36,15,2013-07-27 03:48:10,2013-07-27 03:48:10
768fa3c8a666f98294d21d046156439eef582696...5a1a01869ac803b71b148f126fd66558013d3dbf,4,14,14,28,14,2011-07-05 21:24:53,2011-07-05 21:24:53
5a1a01869ac803b71b148f126fd66558013d3dbf...a7d65d7d8fdb65d514fb7638209175f87eb92a04,1,3,3,6,3,2011-07-07 02:43:41,2011-07-07 02:43:41
2998929b39eb3a4d587c6237d98095f9f5b0df2f...934cf4f683c0ef2aba26c4cf600c7f6e28c65488,1,1,1,2,1,2013-07-30 17:09:30,2013-07-30 17:09:30
934cf4f683c0ef2aba26c4cf600c7f6e28c65488...6a8f76f020c77dde1da87a03f635437b5c9f2d99,1,4,0,4,1,2013-07-30 17:10:34,2013-07-30 17:10:34
2998929b39eb3a4d587c6237d98095f9f5b0df2f...a9144b50ea5de168f09a1d8136e72921edf0e8e2,1,1,2,3,2,2013-07-30 14:23:34,2013-07-30 14:23:34
2998929b39eb3a4d587c6237d98095f9f5b0df2f...c2b7e2ca278ba7ae2940690fc1a8e9c049ce9a95,1,2,2,4,2,2013-07-29 20:23:19,2013-07-29 20:23:19
2998929b39eb3a4d587c6237d98095f9f5b0df2f...07dd62ed7c297c6df10f05fe62a28dda83c165e3,1,2,0,2,1,2013-07-29 18:24:40,2013-07-29 18:24:40
2998929b39eb3a4d587c6237d98095f9f5b0df2f...582787342e850360ba4fd350c8876f753532fc4d,3,14,14,28,8,2013-07-28 15:37:53,2013-07-28 15:37:53
2998929b39eb3a4d587c6237d98095f9f5b0df2f...cee5f6fbdf79a030b6aadfd0c6f8a80c43b40b24,1,2,2,4,1,2013-07-28 03:39:24,2013-07-28 03:39:24
cee5f6fbdf79a030b6aadfd0c6f8a80c43b40b24...d149f651f2f4899113bdd9c95d88fca47b26d334,1,2,0,2,1,2013-07-28 03:40:24,2013-07-28 03:40:24
d149f651f2f4899113bdd9c95d88fca47b26d334...ad01dd8ce8120a774212a55513f6b8ef4cf0b6be,1,1,1,2,1,2013-07-30 17:33:48,2013-07-30 17:33:48
2998929b39eb3a4d587c6237d98095f9f5b0df2f...1a1bc334061a43414a7621a64941f13a506c46da,1,2,2,4,1,2013-07-28 03:24:28,2013-07-28 03:19:20
2998929b39eb3a4d587c6237d98095f9f5b0df2f...c834b4027c88f3d3fe28597f136968c9fdac848f,1,1,1,2,1,2013-07-28 03:14:49,2013-07-28 03:14:49
c834b4027c88f3d3fe28597f136968c9fdac848f...ce1fdc5ded80c3bfd0f0e7b1cce124f4e86ade6a,1,1,1,2,1,2013-07-28 03:17:53,2013-07-28 03:17:53
2998929b39eb3a4d587c6237d98095f9f5b0df2f...dfa71726a983c4fc1455f874bc389a3035e2d6de,1,1,1,2,1,2013-07-27 21:28:13,2013-07-27 21:28:13
dfa71726a983c4fc1455f874bc389a3035e2d6de...d8b477f273bb7c5856248bcebdd615ebdbef8073,1,2,2,4,2,2013-07-27 21:30:38,2013-07-27 21:30:38
a7d65d7d8fdb65d514fb7638209175f87eb92a04...68d4b85ffc542ef85eb4fe1bfba7acf6d504f522,4,9,6,15,7,2011-07-29 19:30:59,2011-07-29 19:30:59
a7d65d7d8fdb65d514fb7638209175f87eb92a04...7f99892b864295eef23bf24bd8c6c9b231d0c684,9,75,246,321,39,2011-07-29 00:50:38,2011-07-29 00:50:38
031ed98c8b942bdd97071a7f4e70829fcfd8f83e...ee6db981366747c589d10c841b052014fa133950,1,5,0,5,1,2013-08-02 09:53:25,2013-08-02 09:53:25
88bd6f72daaeb1cada7dab852e6f779af7b33823...5c687ee393945762403bbea8e7e86a618e474ac6,3,0,0,0,0,2011-08-18 05:26:22,2011-08-18 05:26:22
88bd6f72daaeb1cada7dab852e6f779af7b33823...946efe97cb03b1e0ed15f80a864377febf12a6cb,1,10,5,15,5,2011-07-29 21:24:27,2011-07-29 21:24:27
946efe97cb03b1e0ed15f80a864377febf12a6cb...a480e0f3f354fe997616890fe8ac8a9b424501ea,1,6,2,8,2,2011-07-29 21:26:33,2011-07-29 21:26:33
a480e0f3f354fe997616890fe8ac8a9b424501ea...5eb962faea0ef05392ba9109546d5d9fda07aa43,1,2,2,4,1,2011-07-29 21:28:37,2011-07-29 21:28:37
5eb962faea0ef05392ba9109546d5d9fda07aa43...6d0b083b7d594d3b8caa4b820a3712a5e3cc91c8,10,109,82,191,91,2011-08-17 05:58:01,2011-08-17 05:58:01
6d0b083b7d594d3b8caa4b820a3712a5e3cc91c8...7ecfc99a1422e87c8295bae2494da0b59bc5af55,4,1,0,1,1,2011-08-17 06:07:35,2011-08-17 06:07:35
7ecfc99a1422e87c8295bae2494da0b59bc5af55...f53ddcc6fe1ff95d74e87bc2dcb754a96108789f,1,2,0,2,1,2011-08-17 06:14:09,2011-08-17 06:14:09
f53ddcc6fe1ff95d74e87bc2dcb754a96108789f...9ec3bdd2d88103095af9a8b773ce68f39ccd5a8c,1,1,1,2,1,2011-08-17 06:15:45,2011-08-17 06:15:45
9ec3bdd2d88103095af9a8b773ce68f39ccd5a8c...07837a1c47321e97dde4a816cb2cd246724e7481,1,5,5,10,4,2011-08-17 18:31:20,2011-08-17 18:31:20
0a7b185224c15a7c84505625ae9d5484f78140e4...6e8ace4b2bfa7927ee19504fdbeb31de6b419c04,2,52,102,154,37,2013-08-10 11:36:05,2013-08-10 11:36:05
0a7b185224c15a7c84505625ae9d5484f78140e4...6739522d6c3127741daa83b235414fa386b97830,2,10,0,10,2,2013-08-06 06:46:08,2013-08-06 06:46:08
6739522d6c3127741daa83b235414fa386b97830...da249b55c41bd062a75b1597a60a5e0234d0f6b3,3,3,3,6,3,2013-08-06 06:47:58,2013-08-06 06:47:58
da249b55c41bd062a75b1597a60a5e0234d0f6b3...a24319eb44003d5464fd46928d3aab3b296ab81d,3,9,9,18,3,2013-08-06 07:00:40,2013-08-06 07:00:40
0a7b185224c15a7c84505625ae9d5484f78140e4...97a5c3613cb6d4f6ccce5d71175ab19bad32a363,1,1,0,1,1,2013-08-06 06:34:36,2013-08-06 06:34:36
68007404a87e5f40de85896f6d935fde469a032c...8ba5a2945637ee2de444bf959fd284284e65f61b,4,4,5,9,4,2011-08-18 05:38:14,2011-08-18 05:38:14
8ba5a2945637ee2de444bf959fd284284e65f61b...799a14d1cb5b7508d0240790203a0fc982c21a3b,1,11,11,22,9,2011-08-18 05:40:50,2011-08-18 05:40:50
799a14d1cb5b7508d0240790203a0fc982c21a3b...bd1d38975141454b9bf8206fae7431d157923535,4,5,5,10,5,2011-08-18 18:37:47,2011-08-18 18:37:47
07837a1c47321e97dde4a816cb2cd246724e7481...b80d118c50a63c005b654e81cb228422f0910569,1,4,179,183,3,2011-08-18 16:55:49,2011-08-18 16:55:49
b80d118c50a63c005b654e81cb228422f0910569...f376de1319bb9093adc731cc05b3b0e54607ae54,2,2,2,4,2,2011-08-18 18:27:45,2011-08-18 18:27:45
f376de1319bb9093adc731cc05b3b0e54607ae54...6d57f8a3db2620bb4e3f668dbf9c524ee11e83b9,1,7,0,7,1,2011-08-18 18:37:18,2011-08-18 18:37:18
33f8c43eefb0f0c9fdcdc488ddb5ffd1fd93156c...e47b0e5c9a928f71eb9d82d6c3069c59b7a6ebaf,12,0,635,635,7,2013-08-15 23:30:09,2013-08-15 23:30:09
e47b0e5c9a928f71eb9d82d6c3069c59b7a6ebaf...cfab4b1e9e3777bb146a8ef13c1df3ea5dcb5d31,11,0,6946,6946,7,2013-08-15 23:32:36,2013-08-15 23:32:36
ae02a8a30049844a8bd2f81e74c622196b4a8d2a...088b81f7cd6258384fa815a5600255df2e8499b3,1,12,0,12,1,2011-08-18 21:45:07,2011-08-18 21:45:07
088b81f7cd6258384fa815a5600255df2e8499b3...9de97057ec0f657f4d186e93d2eba458a87d331f,1,8,3,11,5,2011-08-18 23:58:22,2011-08-18 23:58:22
9de97057ec0f657f4d186e93d2eba458a87d331f...3ad9febe04c9ded7a1beb6fda578a4db6c444ba8,1,1,0,1,1,2011-08-18 23:58:49,2011-08-18 23:58:49
3ad9febe04c9ded7a1beb6fda578a4db6c444ba8...1a805151da1217e57f4cb655ee6567414162add0,1,3,1,4,3,2011-08-19 18:25:19,2011-08-19 18:25:19
54670ab64a2565fd35071eb17fc7eef3480eb724...3d99a4c15e0661df630dbaf7dddb5228cf044fe6,40,0,0,0,0,2013-08-15 23:40:39,2013-08-15 23:40:39
1a805151da1217e57f4cb655ee6567414162add0...19bbc01f2e5ecd4a5c9b3e695b6996dab3c03eac,1,1,1,2,1,2011-08-19 19:14:43,2011-08-19 19:14:43
1a805151da1217e57f4cb655ee6567414162add0...36b41f2e7a47bb2b7ffdf5bdb2d965ee73d35255,1,3,0,3,1,2011-08-19 19:53:19,2011-08-19 19:53:19
05ebd5ebf9b32e7c1d8ea05098c53a0b4496d442...024e320e5c3cf1adce8404f87e7c0c746461b6e8,18,276,153,429,75,2013-08-16 00:39:37,2013-08-16 00:39:37
024e320e5c3cf1adce8404f87e7c0c746461b6e8...7960845f50b8dcdc5b4fce29e6075f447e04318a,27,61,25,86,27,2013-08-16 01:55:20,2013-08-16 01:55:20
7960845f50b8dcdc5b4fce29e6075f447e04318a...fc88bcf0d15417c05c6d37027579bb5e3cb34236,3,6,6,12,6,2013-08-16 01:58:02,2013-08-16 01:58:02
fc88bcf0d15417c05c6d37027579bb5e3cb34236...b0a66e60c1ebf13e6bfdb9d844e9ca6d3cd88251,3,9,1,10,5,2013-08-16 03:25:20,2013-08-16 03:25:20
b0a66e60c1ebf13e6bfdb9d844e9ca6d3cd88251...0c582f722bf5e6430166ef0adb8d4c79948aeea5,2,18,15,33,10,2013-08-16 03:25:43,2013-08-16 03:25:43
0c582f722bf5e6430166ef0adb8d4c79948aeea5...111bdc4e93ffd61b08736e7ec87699dc4a8d3ca2,3,17,1,18,9,2013-08-16 03:31:11,2013-08-16 03:31:11
111bdc4e93ffd61b08736e7ec87699dc4a8d3ca2...c4b59fc1caab59fdc0220d8ad1a8b0df00c7fa56,2,15,2,17,3,2013-08-16 03:43:55,2013-08-16 03:43:55
c4b59fc1caab59fdc0220d8ad1a8b0df00c7fa56...b2f626837279bb8b0939aa6602bf9ee023e8a323,3,1,7,8,3,2013-08-16 04:09:25,2013-08-16 04:09:25
15ad86b7136f9f17cf4a56ecc0dbd74ebf1b9357...581f2563b0f087f7b955f99fccb3fb6b4635276e,1,11,11,22,6,2011-08-19 21:23:41,2011-08-19 21:23:41
15ad86b7136f9f17cf4a56ecc0dbd74ebf1b9357...e8c3b4e5c7d77b23ed6b105629f782f2e8c9318e,1,159,158,317,16,2011-08-19 20:19:07,2011-08-19 20:19:07
e8c3b4e5c7d77b23ed6b105629f782f2e8c9318e...0af179fdf6c5f190d263bfe455be9e830e63a485,1,1,1,2,1,2011-08-19 20:20:07,2011-08-19 20:20:07
b2f626837279bb8b0939aa6602bf9ee023e8a323...45e2d73e9360a82f203801962f22058a00134d56,1,1,1,2,1,2013-08-16 04:29:44,2013-08-16 04:29:44
4d0a80bdefe0fe412a1013c156bb7444ec1edcc0...d2515876f146384c04029e646aa802800c9eab50,1,29,29,58,28,2011-08-20 01:01:23,2011-08-20 01:01:23
45e2d73e9360a82f203801962f22058a00134d56...e04590babb90c0ca009e7fbcf3bd8de26680eb3f,1,0,6,6,1,2013-08-16 04:39:40,2013-08-16 04:39:40
962acdc0d8271bb991e09c41add851015409e9c9...630b874dbdcdff364976a07d0062a1be18fab119,3,9,6,15,7,2011-08-20 02:38:44,2011-08-20 02:38:44
630b874dbdcdff364976a07d0062a1be18fab119...b342c4cca322ab40763aaa4cc26108a8aeb3620d,3,12,31,43,7,2011-08-20 02:52:07,2011-08-20 02:52:07
b342c4cca322ab40763aaa4cc26108a8aeb3620d...73f1bcf7179b3050d2e8e0dd65c3f87667ceed7f,3,45,36,81,28,2011-08-20 03:20:48,2011-08-20 03:20:48
73f1bcf7179b3050d2e8e0dd65c3f87667ceed7f...f1a69722817072bf71802c78a34ae74b2c4c5ecc,1,3,4,7,1,2011-08-20 03:37:12,2011-08-20 03:37:12
e04590babb90c0ca009e7fbcf3bd8de26680eb3f...2fa0975956f646be627aaa4732527f6de5335a2c,1,1,6,7,2,2013-08-16 04:51:41,2013-08-16 04:51:41
f1a69722817072bf71802c78a34ae74b2c4c5ecc...ee6f3077c0f395c18b7a99ff46980162a097d35b,1,1,1,2,1,2011-08-20 10:12:39,2011-08-20 10:12:39
f1a69722817072bf71802c78a34ae74b2c4c5ecc...6dcfe94bab1110bb0d2b5ad9634396be7383ff22,1,1,1,2,1,2011-08-20 05:15:57,2011-08-20 05:15:57
6dcfe94bab1110bb0d2b5ad9634396be7383ff22...3f388ef07a5f0101e97b19479e472528a0c78ff9,4,20,29,49,17,2011-08-20 05:28:22,2011-08-20 05:28:22
3f388ef07a5f0101e97b19479e472528a0c78ff9...66fea662e4b15661cd05b40044a13a7443ed5224,1,1,1,2,1,2011-08-20 05:29:10,2011-08-20 05:29:10
66fea662e4b15661cd05b40044a13a7443ed5224...fc3324f88be85b698e095f5f20d00ffb25c3e917,1,3,4,7,3,2011-08-20 05:31:03,2011-08-20 05:31:03
fc3324f88be85b698e095f5f20d00ffb25c3e917...4f2b0d8aa4ae646fd5bc151252cf446c2cdba098,1,67,67,134,14,2011-08-20 05:32:14,2011-08-20 05:32:14
4f2b0d8aa4ae646fd5bc151252cf446c2cdba098...4a567fcb10a835bac16f195c93bc64f9546981bf,2,33,28,61,17,2011-08-20 08:11:48,2011-08-20 08:11:48
4a567fcb10a835bac16f195c93bc64f9546981bf...261a473a72b321b827e3e4cf55167a761af1916b,5,112,104,216,12,2011-08-20 08:51:06,2011-08-20 08:51:06
261a473a72b321b827e3e4cf55167a761af1916b...72899a4ee8f9c3b75ba5e015d6c88f5154705c62,7,135,64,199,40,2011-08-21 01:58:12,2011-08-21 01:58:12
2fa0975956f646be627aaa4732527f6de5335a2c...a9268c01c9f342d13e687e7a1897b55c525d0076,3,12,12,24,6,2013-08-16 05:42:43,2013-08-16 05:42:43
ee6f3077c0f395c18b7a99ff46980162a097d35b...f824009e20870596d4b75a933e5e827a41e6e7cf,1,1,1,2,1,2011-08-21 05:16:04,2011-08-21 05:16:04
ee6f3077c0f395c18b7a99ff46980162a097d35b...536529c255871361e3d5e8bc4d44648345877d6e,1,2,2,4,2,2011-08-21 03:27:06,2011-08-21 03:27:06
72899a4ee8f9c3b75ba5e015d6c88f5154705c62...2aeed35f24ad1ba3fa07c4d76fa3664dda91508a,5,80,76,156,33,2011-08-22 00:30:45,2011-08-22 00:30:45
2aeed35f24ad1ba3fa07c4d76fa3664dda91508a...80e0e9c41309f0ac525aa6f67bccb91916637351,2,45,56,101,20,2011-08-22 03:03:12,2011-08-22 03:03:12
80e0e9c41309f0ac525aa6f67bccb91916637351...c705521e08c9d673222b23aaca7ca465433cc245,3,168,174,342,115,2011-08-22 03:07:15,2011-08-22 03:07:15
c705521e08c9d673222b23aaca7ca465433cc245...12efeccdf74b61b61b8d784b55fa857eb409b8b9,3,18,16,34,12,2011-08-22 03:12:18,2011-08-22 03:12:18
12efeccdf74b61b61b8d784b55fa857eb409b8b9...59aea3bafd6bba4928e6ba561f54a11feb596d32,3,9,7,16,6,2011-08-22 03:17:10,2011-08-22 03:17:10
59aea3bafd6bba4928e6ba561f54a11feb596d32...f630615d2603337843a1b8766496cb313e60fb6c,3,71,71,142,52,2011-08-22 03:27:19,2011-08-22 03:27:19
f630615d2603337843a1b8766496cb313e60fb6c...027538e66d633b15c9074b14d206602ad8fb42a1,3,56,54,110,37,2011-08-22 03:30:58,2011-08-22 03:30:58
72899a4ee8f9c3b75ba5e015d6c88f5154705c62...1fc4491cd6f18809468dfc73ce5e55ac87352d1d,4,11,24,35,9,2011-08-21 18:22:33,2011-08-21 18:22:33
1fc4491cd6f18809468dfc73ce5e55ac87352d1d...3d73e674dd4f27159b2f3968c83547da4e7cb225,4,12,12,24,17,2011-08-21 18:45:24,2011-08-21 18:45:24
3d73e674dd4f27159b2f3968c83547da4e7cb225...2203ba3df1724a14ef948bd714e76e8d6c4a1929,4,15,9,24,18,2011-08-21 18:53:06,2011-08-21 18:53:06
2203ba3df1724a14ef948bd714e76e8d6c4a1929...0e8e30bf1dbc15aa42dc84898b088a76c3e7d536,3,7,5,12,7,2011-08-21 18:56:16,2011-08-21 18:56:16
0e8e30bf1dbc15aa42dc84898b088a76c3e7d536...612e5c3c9e9c4ead98ebbb52db8cebeee082289b,3,4,4,8,4,2011-08-21 18:57:25,2011-08-21 18:57:25
612e5c3c9e9c4ead98ebbb52db8cebeee082289b...d97fb89480383db9b259f3ded839e35f0f4dd53f,1,0,1,1,1,2011-08-21 18:59:50,2011-08-21 18:59:50
d97fb89480383db9b259f3ded839e35f0f4dd53f...5c1d364740d62bc6ebe47f0d6d4253e1c9112a37,2,2,3,5,3,2011-08-21 19:00:10,2011-08-21 19:00:10
5c1d364740d62bc6ebe47f0d6d4253e1c9112a37...bb94457b4b3cba13b90e45550fe7a6ffafbfa5fc,1,0,1,1,1,2011-08-21 19:01:27,2011-08-21 19:01:27
bb94457b4b3cba13b90e45550fe7a6ffafbfa5fc...c9f6e18f4ae27e8ce9173c3cd5941fbb8d9d100e,2,2,3,5,3,2011-08-21 19:03:20,2011-08-21 19:03:20
c9f6e18f4ae27e8ce9173c3cd5941fbb8d9d100e...1d96417201721280c2a0579b875c0b64ea12c1ba,3,6,9,15,9,2011-08-21 19:06:22,2011-08-21 19:06:22
1d96417201721280c2a0579b875c0b64ea12c1ba...b18e76f99072fe94f771ad30e492f2d8aca463cb,6,58,27,85,20,2011-08-21 19:19:01,2011-08-21 19:19:01
b18e76f99072fe94f771ad30e492f2d8aca463cb...2435b6417a442273f660ab368c532b2c84cb2601,2,5,3,8,3,2011-08-21 19:26:51,2011-08-21 19:26:51
2435b6417a442273f660ab368c532b2c84cb2601...6fa71861556f4f6c4b5e2b29e592ab9c118be8ef,2,6,4,10,4,2011-08-21 19:27:28,2011-08-21 19:27:28
6fa71861556f4f6c4b5e2b29e592ab9c118be8ef...971336c8086825e1a227bb956482708a3df0875d,3,4,2,6,4,2011-08-21 19:31:55,2011-08-21 19:31:55
971336c8086825e1a227bb956482708a3df0875d...d671d566e14a569feed87422c0b2f035f3dd9128,1,2,2,4,1,2011-08-21 19:35:14,2011-08-21 19:35:14
d671d566e14a569feed87422c0b2f035f3dd9128...5b505aaf97f9f5ccb05551ffed18eed25cbb826b,2,4,4,8,3,2011-08-21 19:35:42,2011-08-21 19:35:42
5b505aaf97f9f5ccb05551ffed18eed25cbb826b...7e67ddf78897b5cd256e28e2ccc220562827b396,3,10,6,16,4,2011-08-21 19:40:47,2011-08-21 19:40:47
7e67ddf78897b5cd256e28e2ccc220562827b396...8ec7566f8baae5807da86665d5ea915c5ec16ce2,3,6,4,10,4,2011-08-21 19:42:43,2011-08-21 19:42:43
8ec7566f8baae5807da86665d5ea915c5ec16ce2...f8e9c6cf4ee0ece4c9a5fe4b9e11c553877ce85c,3,8,12,20,4,2011-08-21 19:48:29,2011-08-21 19:48:29
f8e9c6cf4ee0ece4c9a5fe4b9e11c553877ce85c...d019c677adcc21a3df0865773431ddc0ecf0aefa,1,2,0,2,1,2011-08-21 20:04:09,2011-08-21 20:04:09
d019c677adcc21a3df0865773431ddc0ecf0aefa...de494200fc5a62f032828198f699f043a7fe77da,2,4,2,6,3,2011-08-21 20:04:36,2011-08-21 20:04:36
de494200fc5a62f032828198f699f043a7fe77da...96af4f6acfcfb731d9772643fa8ef43ac514b02d,4,9,3,12,6,2011-08-21 20:22:39,2011-08-21 20:22:39
96af4f6acfcfb731d9772643fa8ef43ac514b02d...7c45f6cc7fb5dbf0cc76d6eb6e4b42ac7fdf15c3,3,4,4,8,4,2011-08-21 20:26:01,2011-08-21 20:26:01
7c45f6cc7fb5dbf0cc76d6eb6e4b42ac7fdf15c3...0ca33aa1ba665fe82fe1f1a5863b62fb4b27ca71,3,4,4,8,4,2011-08-21 20:27:17,2011-08-21 20:27:17
0ca33aa1ba665fe82fe1f1a5863b62fb4b27ca71...22dbf9d8e4fc5568d9d49b40d1c1020fbab064c9,4,9,9,18,9,2011-08-21 20:36:06,2011-08-21 20:36:06
22dbf9d8e4fc5568d9d49b40d1c1020fbab064c9...e1e4ceee3f72d0892bf84aa7a1c7f1bdb719032e,4,22,6,28,7,2011-08-22 01:07:47,2011-08-22 01:07:47
e1e4ceee3f72d0892bf84aa7a1c7f1bdb719032e...48c3c6f1b67b1f2a2f2ea499cef65bdfd27dc21d,5,45,53,98,8,2011-08-22 01:14:53,2011-08-22 01:14:53
48c3c6f1b67b1f2a2f2ea499cef65bdfd27dc21d...c3143b47294df75eb830fb9156f9eef8fbaa956b,3,9,6,15,5,2011-08-22 02:49:31,2011-08-22 02:49:31
c3143b47294df75eb830fb9156f9eef8fbaa956b...f17b2633adb016ef58423c083d2a377368fc51c7,5,18,14,32,8,2011-08-22 02:56:43,2011-08-22 02:56:43
f17b2633adb016ef58423c083d2a377368fc51c7...60fc4eb7b9e7c5d881a40615b63c9dda724815b4,4,6,7,13,5,2011-08-22 02:59:43,2011-08-22 02:59:43
60fc4eb7b9e7c5d881a40615b63c9dda724815b4...842ad01fce710c50dc9c0174ab790f91e66c46b1,3,10,2,12,6,2011-08-22 03:21:59,2011-08-22 03:21:59
afdaa0e6f0488bb9fb9a1e2e5cf5d8f92cc29a3a...3bb5644c729f9636bc18cc933f9ee41bc96679b0,3,9,1,10,3,2013-08-16 07:54:12,2013-08-16 07:54:12
3bb5644c729f9636bc18cc933f9ee41bc96679b0...ffbec23c982de7496743212afb8d75005e52199c,6,26,33,59,29,2013-08-16 07:54:19,2013-08-16 07:54:19
031703190c036c5a7ec43959b93ae1a42bae8fb8...29fe7ed68402aee6c24949ed2509a415d179bb57,4,22,12,34,11,2013-08-16 17:58:28,2013-08-16 17:58:28
f824009e20870596d4b75a933e5e827a41e6e7cf...e45dbf52def5c7a32a673be1f4c381b7100b8225,1,4,4,8,2,2011-08-22 21:01:11,2011-08-22 21:01:11
e45dbf52def5c7a32a673be1f4c381b7100b8225...6145fd293141963f9581d741bc0489eb06c276f5,1,6,6,12,2,2011-08-22 21:19:39,2011-08-22 21:19:39
fa2bde05204e34e737f8efb6f8c957cd98b4b28a...a3caafb97e1da20ad07cb83206353fcf344bc373,1,1,1,2,1,2011-08-21 02:00:56,2011-08-21 02:00:56
fa2bde05204e34e737f8efb6f8c957cd98b4b28a...52e9f7eb6e3a3cb68756baeee9ec838440d8ab3b,1,2,2,4,2,2011-08-20 21:08:58,2011-08-20 21:08:58
52e9f7eb6e3a3cb68756baeee9ec838440d8ab3b...7852619e323973f41a84043a48a359210042644f,1,1,1,2,1,2011-08-20 21:16:15,2011-08-20 21:16:15
842ad01fce710c50dc9c0174ab790f91e66c46b1...0e92acd9fffd144445c403f8d725de51adf6bf2e,1,11,0,11,3,2011-08-22 03:41:34,2011-08-22 03:41:34
441e04c84a8a5dd4f55aad61c35c54aded41cc1d...214835c6b21f7c4f3a5a30d85580e4c5929fc73c,1,3,4,7,4,2013-08-17 21:21:58,2013-08-17 21:21:58
214835c6b21f7c4f3a5a30d85580e4c5929fc73c...5e31478a91e62fc022ba0141acf27937c9dd7719,2,1,1,2,1,2013-08-17 21:24:48,2013-08-17 21:24:48
29fe7ed68402aee6c24949ed2509a415d179bb57...1974aa6967184720d143cc510fe900f863cce63f,13,17,11,28,14,2013-08-16 18:03:52,2013-08-16 18:03:52
29fe7ed68402aee6c24949ed2509a415d179bb57...9464489720bc95671c46879b2c5156941a754e80,1,1,1,2,1,2013-08-16 18:03:28,2013-08-16 18:03:28
ffd851d93a6616db01db94a945a0dbc2810a5c1a...14b77f3a2164a5348ec8d9841ddc3ace27a64e37,1,0,1,1,1,2011-08-21 04:25:21,2011-08-21 04:25:21
2f6f9ec6e05348ab68859ebf043a0d22d8956efc...6fff171b5598257d65e069d8c2c114284f287c20,2,21,3,24,7,2011-08-22 03:43:05,2011-08-22 03:43:05
6fff171b5598257d65e069d8c2c114284f287c20...c6b162f6ca32fc429ec28d23d4c0b1f9d5ab4108,1,3,6,9,3,2011-08-22 03:53:54,2011-08-22 03:53:54
c6b162f6ca32fc429ec28d23d4c0b1f9d5ab4108...17f9aca6988d12559cefa76469f6e7b179265313,2,2,3,5,2,2011-08-22 03:57:09,2011-08-22 03:57:09
17f9aca6988d12559cefa76469f6e7b179265313...1db73edc5f041eb7f497a23a28da885b2a7867f3,1,0,4,4,2,2011-08-22 04:06:09,2011-08-22 04:06:09
1db73edc5f041eb7f497a23a28da885b2a7867f3...8ebdf4483f993da553fd966469cf34335685377a,3,6,2,8,4,2011-08-22 04:09:54,2011-08-22 04:09:54
8ebdf4483f993da553fd966469cf34335685377a...d90136b5850a39fc6b1291519662e27987598edc,3,2,6,8,4,2011-08-22 04:18:36,2011-08-22 04:18:36
d90136b5850a39fc6b1291519662e27987598edc...d8d12e20b44d134a474192d57382e2469d4abe06,3,6,2,8,4,2011-08-22 04:20:51,2011-08-22 04:20:51
d8d12e20b44d134a474192d57382e2469d4abe06...dd92f4e6e22e86c26b2643a0159aa9266f891376,1,6,0,6,1,2011-08-22 04:26:15,2011-08-22 04:26:15
dd92f4e6e22e86c26b2643a0159aa9266f891376...b39a9a680dcc47c77a8b44a1e38d87c961b31835,1,1,2,3,1,2011-08-22 04:30:19,2011-08-22 04:30:19
b39a9a680dcc47c77a8b44a1e38d87c961b31835...985ee6455a0ee86153cb8bca29f5fbf7b5dbfcf6,2,3,3,6,3,2011-08-22 04:30:41,2011-08-22 04:30:41
18766db63423e9151d1be4de061016b7a53ff8a1...6b74b871df0103d9afc089a2c0391c050d2666da,1,7,3,10,6,2013-08-18 05:43:15,2013-08-18 05:43:15
6b74b871df0103d9afc089a2c0391c050d2666da...40cbfb69d248a17ead8be41f04fc8b4ac7eae173,3,1,9,10,3,2013-08-18 05:44:59,2013-08-18 05:44:59
40cbfb69d248a17ead8be41f04fc8b4ac7eae173...c729f16282e8e3d1d272b2559708bb514d44c227,7,15,15,30,15,2013-08-18 05:51:00,2013-08-18 05:51:00
c729f16282e8e3d1d272b2559708bb514d44c227...d13c4e5e5b2eb1337739b6eabb2c06bfa26d76c5,2,9,5,14,4,2013-08-18 06:07:15,2013-08-18 06:07:15
d13c4e5e5b2eb1337739b6eabb2c06bfa26d76c5...578a14e14aa7c6ad37f307d5d78e9a2afb0e7bfb,1,418,341,759,55,2013-08-18 06:53:27,2013-08-18 06:53:27
4684e0c09bb74071f3411ceb6068acd9cf0ff3e9...771ac3207e1f5c0a624680a11e8245da13dcac12,3,4,4,8,4,2013-08-16 18:08:29,2013-08-16 18:08:29
771ac3207e1f5c0a624680a11e8245da13dcac12...6965c12e3002dce219ae063342218f197b1a0bfc,2,6,8,14,2,2013-08-16 18:10:35,2013-08-16 18:10:35
6965c12e3002dce219ae063342218f197b1a0bfc...ed4316d9b28e532d0bdbe3b5ddd23006ea7f7f9b,3,7,20,27,6,2013-08-16 18:16:32,2013-08-16 18:16:32
ed4316d9b28e532d0bdbe3b5ddd23006ea7f7f9b...e5f38207e0f8a356728e78f91a83b945934fd71d,3,6,3,9,5,2013-08-16 18:34:30,2013-08-16 18:34:30
e5f38207e0f8a356728e78f91a83b945934fd71d...4d36992180876fd233b079d4b8cad7fe65d2ec53,5,12,18,30,6,2013-08-16 18:35:19,2013-08-16 18:35:19
14b77f3a2164a5348ec8d9841ddc3ace27a64e37...aaf9f752c476877fa99a2f54576e3785b397dec6,3,99,119,218,22,2011-08-21 06:25:22,2011-08-21 06:25:22
aaf9f752c476877fa99a2f54576e3785b397dec6...c7c33561011d03cbcb961082689621144289d7f1,1,555,551,1106,21,2011-08-21 06:32:37,2011-08-21 06:32:37
c7c33561011d03cbcb961082689621144289d7f1...e179f0acb33beae609fb9abeb983ab799b1b1e1d,1,33,4,37,16,2011-08-21 06:38:00,2011-08-21 06:38:00
e179f0acb33beae609fb9abeb983ab799b1b1e1d...4512cc565241159fc9c19b05f6d72bf01106cae6,3,6,4,10,5,2011-08-21 06:45:01,2011-08-21 06:45:01
4512cc565241159fc9c19b05f6d72bf01106cae6...79bdb80543702348976a9cbd0c0b9bd2472fb148,3,11,11,22,7,2011-08-21 06:47:23,2011-08-21 06:47:23
79bdb80543702348976a9cbd0c0b9bd2472fb148...6db39d0ec3b48e299f8ced16e06bfa9e912b6be6,4,23,1,24,5,2011-08-21 06:56:32,2011-08-21 06:56:32
6db39d0ec3b48e299f8ced16e06bfa9e912b6be6...254e70550e2e10372736939702ee77072884bde2,5,81,21,102,19,2011-08-22 00:06:37,2011-08-22 00:06:37
254e70550e2e10372736939702ee77072884bde2...5cc933ccccfdc56b3cc0e440ea0022e43a1c3f84,1,1,1,2,1,2011-08-22 03:44:10,2011-08-22 03:44:10
5cc933ccccfdc56b3cc0e440ea0022e43a1c3f84...a98d2cccb8076b106e08e7ca76e59af013ab2851,10,615,477,1092,288,2011-08-22 03:47:24,2011-08-22 03:47:24
23ec21d0498a4a5c18dcbef9ec835bb0ef80aa22...5668723db24d4d3fd7015701ce5df5c1bdb58df1,1,1,1,2,1,2011-08-22 03:51:25,2011-08-22 03:51:25
5668723db24d4d3fd7015701ce5df5c1bdb58df1...0df17f06d8cb94ccee42cd5c8536965c2df7e643,3,13,13,26,11,2011-08-22 03:53:52,2011-08-22 03:53:52
0df17f06d8cb94ccee42cd5c8536965c2df7e643...f169c99f726c250f0bb2f68ea4eedaaf3fbe15c0,2,6,28,34,6,2011-08-22 03:56:06,2011-08-22 03:56:06
9dcae610e97c5422652d7212fda5985de1653d4c...841dac58caed00f5955aa0e16ed544ea304ea9d5,2,41,39,80,3,2013-08-19 02:04:30,2013-08-19 02:04:30
841dac58caed00f5955aa0e16ed544ea304ea9d5...cf09e6a6b5e314f4f7433f21bd32287885c95451,3,3,3,6,3,2013-08-19 02:05:48,2013-08-19 02:05:48
4d36992180876fd233b079d4b8cad7fe65d2ec53...c13772d5f7584a83476a12fec379d8424ea312d1,3,3,13,16,5,2013-08-16 19:38:41,2013-08-16 19:38:41
c13772d5f7584a83476a12fec379d8424ea312d1...551c561ee2471681c5c7536c2cfe81d15f180cf7,3,16,15,31,9,2013-08-16 19:43:54,2013-08-16 19:43:54
551c561ee2471681c5c7536c2cfe81d15f180cf7...3c880e681d49ade20f1b9fcbfb573172d24b3b89,8,112,111,223,86,2013-08-16 20:30:33,2013-08-16 20:30:33
3c880e681d49ade20f1b9fcbfb573172d24b3b89...af7b072a74f187f3c5f57a363ac9e1b19f7a35f5,2,37,31,68,9,2013-08-16 20:50:17,2013-08-16 20:50:17
af7b072a74f187f3c5f57a363ac9e1b19f7a35f5...e6f185acad5741fcbe0b3305e0660e5e6ea4f41c,4,48,17,65,16,2013-08-16 21:01:32,2013-08-16 21:01:32
e6f185acad5741fcbe0b3305e0660e5e6ea4f41c...d2e2ec0985d030fb230e0b8f133d5d97e453ac60,2,7,5,12,4,2013-08-16 21:04:11,2013-08-16 21:04:11
d2e2ec0985d030fb230e0b8f133d5d97e453ac60...62083a45b7864d23231505d1c9c6bcdfab31e52a,2,7,7,14,7,2013-08-16 21:12:18,2013-08-16 21:12:18
8497d935adc278e91d54a3f3054eb9cbc45299a1...112f7eff8ab53fbe09cf5de6fe07ad93a2b7c7f8,2,7,7,14,3,2011-08-22 18:29:01,2011-08-22 18:29:01
112f7eff8ab53fbe09cf5de6fe07ad93a2b7c7f8...16064bed2d2338b4d4ec617c10ffdc47d2e42edb,4,6,4,10,6,2011-08-22 19:34:55,2011-08-22 19:34:55
16064bed2d2338b4d4ec617c10ffdc47d2e42edb...d324a242685b433cdb48279235a7837c816052fe,4,96,3,99,8,2011-08-22 19:50:30,2011-08-22 19:50:30
e11c49cc48a70de1728ed18ca425db74e79c9938...25e21bab96bb784cc90db37a19b5681cc41da429,1,6,278,284,13,2011-08-22 05:05:07,2011-08-22 05:05:07
25e21bab96bb784cc90db37a19b5681cc41da429...b62b15c5e3e0a94c94545415efec323d097bf61d,1,1,2,3,2,2011-08-22 05:05:49,2011-08-22 05:05:49
b62b15c5e3e0a94c94545415efec323d097bf61d...f408f5c29b31a67c4f6a554f8ac79597325868cc,4,9,14,23,9,2011-08-22 05:13:35,2011-08-22 05:13:35
f408f5c29b31a67c4f6a554f8ac79597325868cc...109027433dc77d58fabaa5c90dada3ee7f400b05,4,12,3,15,7,2011-08-22 05:26:54,2011-08-22 05:26:54
a9378a92670f4bf5ccb753191af795c45bb64998...b360a97f5c03069e7b8a06492043fc2969248f84,3,11,11,22,6,2013-08-19 04:02:52,2013-08-19 04:02:52
b360a97f5c03069e7b8a06492043fc2969248f84...2713a751563a8da68a1d1e2ca50afe075eabfae9,1,2,2,4,1,2013-08-19 04:04:46,2013-08-19 04:04:46
2713a751563a8da68a1d1e2ca50afe075eabfae9...1a8d1b7586822d1105feb36a632be98da70781d0,4,38,19,57,12,2013-08-19 04:15:07,2013-08-19 04:15:07
1a8d1b7586822d1105feb36a632be98da70781d0...e989acfc7966b78c09bc9bbdb4e9284b983074b4,8,563,381,944,65,2013-08-19 04:43:05,2013-08-19 04:43:05
62083a45b7864d23231505d1c9c6bcdfab31e52a...de39c2f896a51d19e4402815cf3ec250d7f13252,1,9,9,18,9,2013-08-16 21:43:39,2013-08-16 21:43:39
de39c2f896a51d19e4402815cf3ec250d7f13252...07d15c49270ded26324d3bfd7e20ce815a247aac,1,9,9,18,9,2013-08-16 21:50:46,2013-08-16 21:50:46
d324a242685b433cdb48279235a7837c816052fe...2d99e3f8a61ef9d4a40cd0cad109d0d89ae3c661,7,516,273,789,93,2011-08-25 07:13:40,2011-08-25 07:13:40
d324a242685b433cdb48279235a7837c816052fe...2575547b15807b26eec636c71c51160a73f51e5b,1,74,0,74,1,2011-08-22 20:12:37,2011-08-22 20:12:37
2575547b15807b26eec636c71c51160a73f51e5b...9a9161488248a274282cd78ed7c846a414d3bd32,1,0,81,81,1,2011-08-22 20:14:54,2011-08-22 20:14:54
9a9161488248a274282cd78ed7c846a414d3bd32...8a27d281a9423bb7b7a400b3230217d2567850c9,3,2,4,6,4,2011-08-23 04:31:30,2011-08-23 04:31:30
8a27d281a9423bb7b7a400b3230217d2567850c9...899c6f8d12fb4c929212efb22c69273c724406ae,4,6,6,12,6,2011-08-23 04:47:34,2011-08-23 04:47:34
899c6f8d12fb4c929212efb22c69273c724406ae...40aba9ca1d1ab5e6288c2c1550e40c9263f5aa88,3,12,7,19,7,2011-08-23 04:51:17,2011-08-23 04:51:17
40aba9ca1d1ab5e6288c2c1550e40c9263f5aa88...411b90e4ff02e56c8d6637e5aa1951eb00a040da,2,21,41,62,3,2011-08-23 05:02:31,2011-08-23 05:02:31
411b90e4ff02e56c8d6637e5aa1951eb00a040da...0bfce13983ada3029d98916b01703d5c0cef2104,4,49,46,95,18,2011-08-23 06:53:02,2011-08-23 06:53:02
109027433dc77d58fabaa5c90dada3ee7f400b05...96ec9ee0835cac5f16c8f4a51f95a2c7e4263624,1,2,2,4,2,2011-08-22 07:36:35,2011-08-22 07:36:35
109027433dc77d58fabaa5c90dada3ee7f400b05...3ef86aa7031adf7b7e50b0841ee478c6803d37b0,6,8,8,16,7,2011-08-22 05:30:39,2011-08-22 05:30:39
3ef86aa7031adf7b7e50b0841ee478c6803d37b0...fef3672ad3b92ba085d55211e850a3dd4c0a76c6,2,4,3,7,3,2011-08-22 05:48:01,2011-08-22 05:48:01
fef3672ad3b92ba085d55211e850a3dd4c0a76c6...621f358dc051cf45f7da96df78ea673c7f0ac11b,1,2,2,4,1,2011-08-22 18:26:04,2011-08-22 18:26:04
140f6d3bdced56147038e55493bd49eea01ca2b9...e2938734849403ffc13366ca47db01fc7131aa17,5,8,11,19,10,2013-08-19 04:49:05,2013-08-19 04:49:05
e2938734849403ffc13366ca47db01fc7131aa17...8daa8a8dbdc7ced95e7385778c9b4f7f415ff8a6,1,8,1,9,1,2013-08-19 04:59:23,2013-08-19 04:59:23
8daa8a8dbdc7ced95e7385778c9b4f7f415ff8a6...2f2232cc3f1e99cf01e2f4628e2b183623ad18b2,1,0,7,7,1,2013-08-19 05:04:51,2013-08-19 05:04:51
2f2232cc3f1e99cf01e2f4628e2b183623ad18b2...869a163e67c02dd5550ea25291eb6cc7f4f56a77,2,3,3,6,2,2013-08-19 05:19:16,2013-08-19 05:19:16
869a163e67c02dd5550ea25291eb6cc7f4f56a77...87924abdc2ad1a747b3c4c6b0fd2d0a7983ff46e,1,9,1,10,2,2013-08-19 05:19:56,2013-08-19 05:19:56
87924abdc2ad1a747b3c4c6b0fd2d0a7983ff46e...73f56a90365ff5178ab27becd738f615137c1845,2,89,46,135,18,2013-08-19 05:43:29,2013-08-19 05:43:29
60d150dfd7da5bdebf117bfe4c9010085823cf17...f459d76e388b1d73b8b0065f8fbaf573f7eaed32,3,11,9,20,7,2013-08-16 22:07:45,2013-08-16 22:07:45
8c2df3ac3ad2c4d87e0057bc76986e902cd2959b...c715584428752c885193b8e72d1b3156eb770aa7,1,3,3,6,3,2011-08-26 06:18:15,2011-08-26 06:18:15
c715584428752c885193b8e72d1b3156eb770aa7...ab77d7abd39f44cbf281826c8721228e21c05ed3,2,2,1,3,2,2011-08-26 06:19:01,2011-08-26 06:19:01
ab77d7abd39f44cbf281826c8721228e21c05ed3...74a18b341c8e071437de9e1e8ba5e1e56531b93c,1,27,24,51,24,2011-08-26 06:25:21,2011-08-26 06:25:21
74a18b341c8e071437de9e1e8ba5e1e56531b93c...0fcda16209bc2a094a22c5652b7b9d62b0e3a077,3,48,48,96,22,2011-08-26 06:31:16,2011-08-26 06:31:16
0fcda16209bc2a094a22c5652b7b9d62b0e3a077...fc1118c87cfc82c85fe37f5cffd695652483c6db,1,1,1,2,1,2011-08-26 17:09:57,2011-08-26 17:09:57
fc1118c87cfc82c85fe37f5cffd695652483c6db...273659c8e754b924b1bdcab5d34b0498ce2036bd,7,9,9,18,8,2011-08-26 18:13:47,2011-08-26 18:13:47
0bfce13983ada3029d98916b01703d5c0cef2104...7d7156bff9818c8d50affffb750b6019a9f20f26,4,88,169,257,55,2011-08-24 03:16:39,2011-08-24 03:16:39
7d7156bff9818c8d50affffb750b6019a9f20f26...0739583a46833b4813524e69726f79fe1b009542,4,69,76,145,35,2011-08-24 22:55:08,2011-08-24 22:55:08
0739583a46833b4813524e69726f79fe1b009542...8368cfd523fab964ebd3132e29332b4680cedba5,3,3,2,5,3,2011-08-25 02:55:11,2011-08-25 02:55:11
8368cfd523fab964ebd3132e29332b4680cedba5...50f484eed6e9161cb7e50531b0fa3f16ada549e0,6,228,220,448,72,2011-08-25 09:00:07,2011-08-25 09:00:07
0bfce13983ada3029d98916b01703d5c0cef2104...70bac36a2233d7f12a9901994238943d4ea50977,1,8,8,16,8,2011-08-23 23:05:07,2011-08-23 23:05:07
0853ece4c89f66ea5438a9c460907cb52688655f...1b97f2a16e6994bb7d9d764d7cbfa99ad6ab7ac5,1,6,3,9,2,2013-08-19 06:07:36,2013-08-19 06:07:36
1b97f2a16e6994bb7d9d764d7cbfa99ad6ab7ac5...2e962e6599b230aaaa8dc1f3f88473c465f84366,1,1,1,2,1,2013-08-19 06:08:57,2013-08-19 06:08:57
2e962e6599b230aaaa8dc1f3f88473c465f84366...2234f0e333e140a4b8ee785c5198b6a67e92d70f,1,1,1,2,1,2013-08-19 06:09:09,2013-08-19 06:09:09
f459d76e388b1d73b8b0065f8fbaf573f7eaed32...e4bb388bc91790d2b0a0ff0be1f329945adcc3ff,4,17,39,56,9,2013-08-16 22:16:03,2013-08-16 22:16:03
a63fb4d234941c58547ed902eb198abaee71b89c...842683b6dfd799a5b665875d981196a623ca0840,2,3,3,6,3,2011-08-26 22:21:39,2011-08-26 22:21:39
50f484eed6e9161cb7e50531b0fa3f16ada549e0...a5e62657262aa9b0ca35377cc2e2619d54249b7b,1,3,3,6,3,2011-08-25 22:53:25,2011-08-25 22:53:25
50f484eed6e9161cb7e50531b0fa3f16ada549e0...0e9d7c1c4d9552dda438d6eb5d2f175a99fd4501,6,382,349,731,37,2011-08-25 20:31:46,2011-08-25 20:31:46
0e9d7c1c4d9552dda438d6eb5d2f175a99fd4501...04b8e667d0a8caaf241570721bbf7afb7a5e1b2d,4,32,48,80,15,2011-08-25 20:52:04,2011-08-25 20:52:04
04b8e667d0a8caaf241570721bbf7afb7a5e1b2d...ce615d016a8ac380dae871358cfc7e745b5e20c2,6,103,120,223,90,2011-08-26 05:41:45,2011-08-26 05:41:45
ce615d016a8ac380dae871358cfc7e745b5e20c2...7d821f18acf04cddd1067ee612773ce2f98cb4ac,3,16,16,32,12,2011-08-26 05:44:23,2011-08-26 05:44:23
7d821f18acf04cddd1067ee612773ce2f98cb4ac...0758f64045645849b21164149428719a005da1cb,4,29,30,59,19,2011-08-26 05:52:21,2011-08-26 05:52:21
0758f64045645849b21164149428719a005da1cb...dd4bb95c2db5db9bb6727147002d916cb86756e6,1,1,1,2,1,2011-08-26 06:10:18,2011-08-26 06:10:18
38999118ac28159ba98b4288f8c029add787da6d...9a00619d6e91152413abec56dd60ac88be0f8630,1,2,2,4,2,2011-08-26 06:17:38,2011-08-26 06:17:38
2234f0e333e140a4b8ee785c5198b6a67e92d70f...7eddb94fa67550d2b50843bd0c29d1a76c2e1076,3,78,88,166,45,2013-08-19 06:36:36,2013-08-19 06:36:36
7eddb94fa67550d2b50843bd0c29d1a76c2e1076...0e61e8783ba8acb9f04533fa812177eb301e13ee,1,3,14,17,4,2013-08-19 06:51:09,2013-08-19 06:51:09
0e61e8783ba8acb9f04533fa812177eb301e13ee...7dcfc44426dc7c294c2c0cb6b0469c3db1baa485,1,1,50,51,1,2013-08-19 06:51:24,2013-08-19 06:51:24
2234f0e333e140a4b8ee785c5198b6a67e92d70f...c9b4f7254bf16f6db32129e156b16f236cb0f5f1,1,1,1,2,1,2013-08-19 06:18:58,2013-08-19 06:18:58
c9b4f7254bf16f6db32129e156b16f236cb0f5f1...4ab4678f0f3cfddf197d27addfceb1013cf1e940,1,1,1,2,1,2013-08-19 06:24:31,2013-08-19 06:24:31
4ab4678f0f3cfddf197d27addfceb1013cf1e940...c0f477a1075321614db8a628fb0046207b5f455b,1,2,2,4,2,2013-08-19 06:27:46,2013-08-19 06:27:46
e4bb388bc91790d2b0a0ff0be1f329945adcc3ff...cd0df1d21aaed8751b8c29aab3b30ff027aac89d,5,11,11,22,11,2013-08-17 05:37:02,2013-08-17 05:37:02
842683b6dfd799a5b665875d981196a623ca0840...df8b65445c332c6fa68858a8f839c24f8b4413ad,3,4,4,8,4,2011-08-27 02:31:50,2011-08-27 02:31:50
b9c9f1d8d616bece3240aa8c3c78873947c7d88f...4f67e135dc2a8ad7a7b3d8946cc7a857a34881a0,5,392,376,768,57,2011-08-27 03:38:23,2011-08-27 03:38:23
4f67e135dc2a8ad7a7b3d8946cc7a857a34881a0...b552281558be2ae54e71df064527af5239c494ab,3,88,18,106,14,2011-08-27 06:18:39,2011-08-27 06:18:39
b552281558be2ae54e71df064527af5239c494ab...650251228bfda8d57a09b4b350ce2b9f1e0efcc1,6,41,43,84,14,2011-08-27 22:30:18,2011-08-27 22:30:18
650251228bfda8d57a09b4b350ce2b9f1e0efcc1...654cc5ad3fbbc618375a39f42ce9603c7f6897c4,2,160,166,326,28,2011-08-30 04:24:00,2011-08-30 04:24:00
654cc5ad3fbbc618375a39f42ce9603c7f6897c4...f17fc367f724ef68e287c45c129558fb62fc6b8e,6,221,59,280,46,2011-08-30 04:26:53,2011-08-30 04:26:53
cf47ef0b2eb737e00d37b41ae545fbfbf10c6196...9e0a526a660354ee7edf5d9b8250da65acae2ab1,1,1,1,2,1,2011-08-26 16:30:38,2011-08-26 16:30:38
cf47ef0b2eb737e00d37b41ae545fbfbf10c6196...0a34a6d4b2131d28ed3d09857c2ccf78f139f837,3,18,6,24,7,2011-08-26 07:00:05,2011-08-26 07:00:05
f7a7cb479fa53b38524f2f79cac262a0736be97b...39bc5198ae1b0617b2e58710e8e7fd2d9c6c9c2a,1,1,1,2,1,2013-08-19 06:54:25,2013-08-19 06:54:25
f7a7cb479fa53b38524f2f79cac262a0736be97b...35092a7cfd3188582c5c60d727ba7cdbc5a5562a,1,1,1,2,1,2013-08-19 06:54:18,2013-08-19 06:54:18
35092a7cfd3188582c5c60d727ba7cdbc5a5562a...2275277be405bf112424cc061f76a940127fd0a5,1,1,1,2,1,2013-08-19 06:54:42,2013-08-19 06:54:42
2275277be405bf112424cc061f76a940127fd0a5...de7cc0c17f2b4c01c05d2add7d55e20575605629,1,6,43,49,3,2013-08-19 06:58:31,2013-08-19 06:58:31
de7cc0c17f2b4c01c05d2add7d55e20575605629...c77bae308a689f6c38e0adec8acabd3ed4704e6a,1,10,15,25,4,2013-08-19 07:03:28,2013-08-19 07:03:28
6a8cc191b595a13e5a3b69912dd929fbe16384f0...0555d11665903d8103ddd6ff4114056de6c0af51,1,0,1,1,1,2013-08-17 13:24:37,2013-08-17 13:24:37
6a8cc191b595a13e5a3b69912dd929fbe16384f0...e12d6208b6912aefe7ead384e460006988ebdbec,1,3,3,6,3,2013-08-17 07:02:17,2013-08-17 07:02:17
df8b65445c332c6fa68858a8f839c24f8b4413ad...315af8e18b6ade15c372420cb256053697553716,1,18,0,18,1,2011-08-27 07:49:48,2011-08-27 07:49:48
df8b65445c332c6fa68858a8f839c24f8b4413ad...c26eb016fb519964366806a907dcb12d34451957,6,381,5,386,15,2011-08-27 06:57:35,2011-08-27 06:57:35
c26eb016fb519964366806a907dcb12d34451957...24c4ca0391486a555293831e9f1ba93366bd7de3,3,7,3,10,7,2011-08-27 07:03:11,2011-08-27 07:03:11
24c4ca0391486a555293831e9f1ba93366bd7de3...52c624079e685a5bcdc13af25b86ea08ca34d6d1,1,3,3,6,1,2011-08-27 07:07:42,2011-08-27 07:07:42
52c624079e685a5bcdc13af25b86ea08ca34d6d1...db706a2596bf18b60246fcf962134df8203b5cc9,1,13,13,26,12,2011-08-27 07:19:05,2011-08-27 07:19:05
db706a2596bf18b60246fcf962134df8203b5cc9...1cbda504a0a4bb4a34a43722a0f65d2a0bc8abb7,5,5,8,13,9,2011-08-27 07:28:58,2011-08-27 07:28:58
1cbda504a0a4bb4a34a43722a0f65d2a0bc8abb7...b68b53dca27d44525c07a39499a53ffb54780e7c,1,3,3,6,3,2011-08-27 07:42:20,2011-08-27 07:42:20
b68b53dca27d44525c07a39499a53ffb54780e7c...11721f376d9bdb019f31d3bbb273160d45ff1266,8,534,307,841,41,2011-08-27 20:03:06,2011-08-27 20:03:06
11721f376d9bdb019f31d3bbb273160d45ff1266...038a9809c4301344e5cc3f8f6a32c796b9b1a438,2,2,2,4,2,2011-08-27 20:06:01,2011-08-27 20:06:01
038a9809c4301344e5cc3f8f6a32c796b9b1a438...2ee7c206924ac616eeb9ae3d6eb6811a818af015,6,143,16,159,20,2011-08-28 00:22:49,2011-08-28 00:22:49
2ee7c206924ac616eeb9ae3d6eb6811a818af015...e05d39d4ccaadb750d251a268adbeef681472029,7,36,37,73,29,2011-08-28 01:03:01,2011-08-28 01:03:01
e05d39d4ccaadb750d251a268adbeef681472029...a00b849a51077ea52feefc3e39d67f05a3c669a9,2,3,3,6,3,2011-08-28 01:05:10,2011-08-28 01:05:10
a00b849a51077ea52feefc3e39d67f05a3c669a9...e91353f36286d7d7d2fdde4d6107f7ecc4c815d6,1,4,4,8,4,2011-08-28 01:09:03,2011-08-28 01:09:03
e91353f36286d7d7d2fdde4d6107f7ecc4c815d6...ed96f181c89a4bb152d58b5c9753ee5aedbd8c4b,5,132,128,260,13,2011-08-28 04:46:50,2011-08-28 04:46:50
ed96f181c89a4bb152d58b5c9753ee5aedbd8c4b...c26350470921f1e57636f30f992947be6b41060c,3,78,6,84,11,2011-08-28 20:30:04,2011-08-28 20:30:04
c26350470921f1e57636f30f992947be6b41060c...0b1d2cc03cddff8ef9e5385bc0d77d4d22d2d7ff,3,9,4,13,4,2011-08-28 21:06:37,2011-08-28 21:06:37
0b1d2cc03cddff8ef9e5385bc0d77d4d22d2d7ff...1a5f8205ff2f87c8f6277afa0a6616599390b7b1,3,6,9,15,4,2011-08-28 23:23:57,2011-08-28 23:23:57
1a5f8205ff2f87c8f6277afa0a6616599390b7b1...a0cb72f9ae27ded4cf3516e0d3edd042293d9e39,5,6,6,12,6,2011-08-28 23:36:44,2011-08-28 23:36:44
a0cb72f9ae27ded4cf3516e0d3edd042293d9e39...f1d17223b8a96aea5e11e289cddc488aaeb40f22,4,76,76,152,10,2011-08-28 23:47:38,2011-08-28 23:47:38
f1d17223b8a96aea5e11e289cddc488aaeb40f22...d8d6e400977e80fd50358b821bc643a2a73ca97e,1,6,3,9,5,2011-08-29 00:32:31,2011-08-29 00:32:31
d8d6e400977e80fd50358b821bc643a2a73ca97e...9059a72bf87cc7ac868d7d16333757445c28c31d,4,16,10,26,8,2011-08-29 00:40:25,2011-08-29 00:40:25
9059a72bf87cc7ac868d7d16333757445c28c31d...ebff55443076a95f171bffc80ccdbc3bb985792e,3,12,4,16,5,2011-08-29 00:42:09,2011-08-29 00:42:09
ebff55443076a95f171bffc80ccdbc3bb985792e...484ed088fc51666ac0f319e9cb66a567722e7113,3,12,9,21,7,2011-08-29 00:45:57,2011-08-29 00:45:57
484ed088fc51666ac0f319e9cb66a567722e7113...58cc70531ad1b5231386d8d3037891e25963801b,3,5,9,14,7,2011-08-29 00:50:14,2011-08-29 00:50:14
58cc70531ad1b5231386d8d3037891e25963801b...7b041f8419cf861931cf812deaad15120ffffd1f,1,2,2,4,2,2011-08-29 00:52:00,2011-08-29 00:52:00
7b041f8419cf861931cf812deaad15120ffffd1f...b4a84e1e7de1e5448cf9adc61a1a02badec80439,1,1,1,2,1,2011-08-29 00:52:55,2011-08-29 00:52:55
f17fc367f724ef68e287c45c129558fb62fc6b8e...7070d44aed65344ed52ffbf2a3a9c1ce91c69035,4,14,7,21,7,2011-08-30 04:41:32,2011-08-30 04:41:32
7070d44aed65344ed52ffbf2a3a9c1ce91c69035...d42a00c19df7442b3fa7c7703d333350a3dc74ac,1,0,10,10,1,2011-08-30 04:42:44,2011-08-30 04:42:44
d42a00c19df7442b3fa7c7703d333350a3dc74ac...ed1139e838110393748ee36cea4453cc4a700fb1,3,2,9,11,5,2011-08-30 15:27:55,2011-08-30 15:27:55
ed1139e838110393748ee36cea4453cc4a700fb1...6258832776b113b09e963680ef121b363dd8d292,2,3,3,6,3,2011-08-31 23:26:47,2011-08-31 23:26:47
f17fc367f724ef68e287c45c129558fb62fc6b8e...589204803bc34575a8ca2c3e624864d3dc8e63ba,3,2,204,206,4,2011-08-30 04:41:12,2011-08-30 04:41:12
589204803bc34575a8ca2c3e624864d3dc8e63ba...e8f1ae007339c98ea71b0f56b37c037d11fa6276,1,1,5,6,1,2011-08-30 04:52:45,2011-08-30 04:52:45
e8f1ae007339c98ea71b0f56b37c037d11fa6276...fc0471a450d8cf3fdeb0971ce2636ac11053891d,1,1,1,2,1,2011-08-30 05:34:13,2011-08-30 05:34:13
fc0471a450d8cf3fdeb0971ce2636ac11053891d...efd6fd609c7e1406d40906d4aa14949345a2d5ff,3,4,2,6,4,2011-08-30 05:36:05,2011-08-30 05:36:05
efd6fd609c7e1406d40906d4aa14949345a2d5ff...afec7859cc08b7d57100ab7d96f11a9df5bdb32e,3,7,5,12,7,2011-08-30 05:43:40,2011-08-30 05:43:40
afec7859cc08b7d57100ab7d96f11a9df5bdb32e...2ed869c2eef1ad89a26ecfa187638db6f84774cd,3,13,23,36,21,2011-08-31 06:03:01,2011-08-31 06:03:01
2ed869c2eef1ad89a26ecfa187638db6f84774cd...49e343c464c931210e6ffc896fb7a511e5e773d0,3,5,3,8,5,2011-08-31 06:08:34,2011-08-31 06:08:34
49e343c464c931210e6ffc896fb7a511e5e773d0...588cb1c06d372817e7be2a44384b177bef660f53,3,24,14,38,21,2011-08-31 06:25:37,2011-08-31 06:25:37
588cb1c06d372817e7be2a44384b177bef660f53...4fb1c5bd4b527797183a60e752f0276b01637fd5,8,10,91,101,10,2011-08-31 06:34:19,2011-08-31 06:34:19
fd844c6d5dca4e1c28d17baf7fc73c0883121efb...5193619ab0b5eaf937eaec01ba58f179dbc2484c,1,3,10,13,3,2011-08-26 17:53:21,2011-08-26 17:53:21
0730c22e2152c69b0cfde1c98566c3164fadcf3e...0682af9ee4fe810ab7288a883e8e8d407f215cae,1,5,5,10,5,2013-08-19 07:05:03,2013-08-19 07:05:03
0682af9ee4fe810ab7288a883e8e8d407f215cae...6262230d0f2ea1ed1aa695238727cf8facc81f8d,1,3,3,6,1,2013-08-19 07:06:26,2013-08-19 07:06:26
e279ffab146d89ea1044105f233a8680100f8bda...3505606d346488e3761dbe9c421b32547bcb9b0c,13,58,9,67,29,2013-08-17 19:32:11,2013-08-17 19:32:11
3505606d346488e3761dbe9c421b32547bcb9b0c...ab700d753c5dd77d278c7ee284b5d4c8250543c2,3,3,3,6,3,2013-08-17 20:07:21,2013-08-17 20:07:21
b0086cb3dee4072c550af082856e65ca2db0c860...35a069466cb094e12aa13a5c4309f6060273cc6f,1,1,1,2,1,2013-08-23 04:27:27,2013-08-23 04:27:27
35a069466cb094e12aa13a5c4309f6060273cc6f...b79a2b3b7ef871b6f146977c399f4c6a01f13644,2,42,17,59,11,2013-10-02 05:11:51,2013-10-02 05:11:51
315af8e18b6ade15c372420cb256053697553716...55022228bcdfea8d87eefb0c21249e6a9e219263,1,7,7,14,7,2011-08-30 10:47:40,2011-08-30 10:47:40
315af8e18b6ade15c372420cb256053697553716...a16dfb735aaa460c91e69f94679ca334e852225f,1,1,1,2,1,2011-08-30 10:19:46,2011-08-30 10:19:46
0e13f8dca10ff19397d577b0916a72129183bfeb...41242b5ce6411efcd66d985dd6853191de67fbbf,3,8,58,66,14,2011-09-03 04:06:20,2011-09-03 04:06:20
90d174a34d0c1c0da590fa8f21b1852e358ba0f9...f6a4dd95b62771b105530c85a98901f06bfecdd7,3,21,31,52,12,2011-08-31 17:55:53,2011-08-31 17:55:53
3260288df8273cd26749a4d2941ca3bc140e4a5a...5639287d5d06ca79aeaf71a31fdaf8c0db6b0188,2,30,14,44,12,2013-08-19 07:16:51,2013-08-19 07:16:51
ab700d753c5dd77d278c7ee284b5d4c8250543c2...82f6f08f89ab8b86aa2d5b175493e24d1f4329cb,4,15,15,30,15,2013-08-17 20:18:10,2013-08-17 20:18:10
ab700d753c5dd77d278c7ee284b5d4c8250543c2...5e89f71ab26147879812e3491eeacd4b15a5c152,4,3,4,7,4,2013-08-17 20:14:19,2013-08-17 20:14:19
44b18f4911e125cc07a6d56292983b0cbfa3ae19...e6ffd3a86fcc3585cf2291b151fb4625f435586e,1,3,0,3,1,2011-09-02 14:43:26,2011-09-02 14:43:26
e6ffd3a86fcc3585cf2291b151fb4625f435586e...ce1d1c2146fd9f11335671464232d7ec1fd7f401,2,5,2,7,3,2011-09-02 15:19:05,2011-09-02 15:19:05
ce1d1c2146fd9f11335671464232d7ec1fd7f401...5960afc3490a174cadaf3bc0f4fe3cf605666756,2,2,5,7,3,2011-09-02 16:45:03,2011-09-02 16:45:03
5960afc3490a174cadaf3bc0f4fe3cf605666756...55698b303d58c08636637bf4147b22c521beb8b8,2,6,9,15,6,2011-09-02 16:48:32,2011-09-02 16:48:32
3c9c85b1ed85ae633d4b94f421020b84d24d9a5c...2883888a57492aa080c4202bdb90fd2606b05365,2,34,24,58,5,2011-09-03 06:15:38,2011-09-03 06:15:38
0159524413f7a90b90cff50fa07d07b85380845d...0ed544a82ed8bf3758de2f57af1abd54202d38f3,3,27,24,51,17,2011-09-02 07:17:13,2011-09-02 07:17:13
0ed544a82ed8bf3758de2f57af1abd54202d38f3...3f1706f5f66bd6f4c5ae9fc33224ffdc0a82a261,3,25,25,50,18,2011-09-02 07:21:55,2011-09-02 07:21:55
0159524413f7a90b90cff50fa07d07b85380845d...02abdd60378aa5aecbb9d8bafe23f0cd2b86141a,4,8,6,14,8,2011-09-02 07:02:44,2011-09-02 07:02:44
02abdd60378aa5aecbb9d8bafe23f0cd2b86141a...479e0ccd6bd4c32c2445e0cb6291c17c5aa4f7a2,4,63,56,119,31,2011-09-02 07:28:54,2011-09-02 07:28:54
f6a4dd95b62771b105530c85a98901f06bfecdd7...72da5dd54d154bb2b87b0ec23107eca775c72f51,4,74,40,114,29,2011-09-02 05:53:24,2011-09-02 05:53:24
5639287d5d06ca79aeaf71a31fdaf8c0db6b0188...8b24c47788d71565047125470a5cb7acf1f5f591,1,2,1,3,2,2013-08-19 07:49:28,2013-08-19 07:49:28
8b24c47788d71565047125470a5cb7acf1f5f591...eb43c2685565cedec38f60b4812fd4431cbd2df1,1,6,0,6,1,2013-08-19 07:54:54,2013-08-19 07:54:54
5639287d5d06ca79aeaf71a31fdaf8c0db6b0188...515d7caa9491c1a82e965de992f6ae085a17b8b0,1,0,4,4,1,2013-08-19 07:31:38,2013-08-19 07:31:38
515d7caa9491c1a82e965de992f6ae085a17b8b0...5b2e3dd7698273d736c215c4e503477fb9c19767,1,16,18,34,1,2013-08-19 07:33:27,2013-08-19 07:33:27
5b2e3dd7698273d736c215c4e503477fb9c19767...efa8b40ce8a2ff8569683147903aad8b9ef38810,2,231,127,358,69,2013-08-19 07:34:16,2013-08-19 07:34:16
efa8b40ce8a2ff8569683147903aad8b9ef38810...14c4484ec455202a4ab622b5f30b14484adb96d9,3,7,1,8,3,2013-08-19 07:34:31,2013-08-19 07:34:31
14c4484ec455202a4ab622b5f30b14484adb96d9...d8128fca945c7a9e6aab3302e8ea0b9badb9b73f,3,3,3,6,3,2013-08-19 07:36:39,2013-08-19 07:36:39
d8128fca945c7a9e6aab3302e8ea0b9badb9b73f...07cecc88bc6794d7a27fb8530fd7813eb5e2b98a,1,5,0,5,1,2013-08-19 07:36:45,2013-08-19 07:36:45
07cecc88bc6794d7a27fb8530fd7813eb5e2b98a...17c1388f230d01a88b29f18a209094cffbe2a2d3,1,12,6,18,4,2013-08-19 07:38:20,2013-08-19 07:38:20
17c1388f230d01a88b29f18a209094cffbe2a2d3...38009ec8efa06c58fb21feed6ffc40e852cf38d5,1,2,2,4,2,2013-08-19 07:39:00,2013-08-19 07:39:00
38009ec8efa06c58fb21feed6ffc40e852cf38d5...20fed789f942bd88d507d7b10ac4432b9a854178,1,48,16,64,12,2013-08-19 07:41:03,2013-08-19 07:41:03
20fed789f942bd88d507d7b10ac4432b9a854178...2a3018a9a607d984a814d029255ad2465caf4acc,1,2,2,4,2,2013-08-19 07:42:12,2013-08-19 07:42:12
2a3018a9a607d984a814d029255ad2465caf4acc...7481aa73984fd51e6447a2928e339fd8c2e9abc6,1,1,0,1,1,2013-08-19 07:42:39,2013-08-19 07:42:39
7481aa73984fd51e6447a2928e339fd8c2e9abc6...08d19af710809bb0ac891e4973f451577fde5154,2,5,5,10,6,2013-08-19 07:43:22,2013-08-19 07:43:22
08d19af710809bb0ac891e4973f451577fde5154...ea3fa72f1df7a47f67177913389af6c1ca34ecf0,2,3,2,5,2,2013-08-19 07:45:20,2013-08-19 07:45:20
ea3fa72f1df7a47f67177913389af6c1ca34ecf0...4fd861a70492e8dea78f1a4da1c1e9ed2a4eebfb,3,10,4,14,3,2013-08-19 07:54:53,2013-08-19 07:54:53
0e39f9457491839fbb17a3cbaa5a14e14879718f...0c70744ea22126b6224bde75b4ccb6068941e38f,3,9,3,12,5,2013-08-17 20:33:53,2013-08-17 20:33:53
5e89f71ab26147879812e3491eeacd4b15a5c152...53c80ed9cbeff8a3c58abe0f824ff68ef56d617a,3,4,3,7,5,2013-08-17 20:40:28,2013-08-17 20:40:28
6d118411e1d456553baf5d09aea15ff13f7b8ef4...4dbd2334bd8156b7621e11c19a411db1308821d8,6,141,5,146,16,2011-09-03 06:01:38,2011-09-03 06:01:38
4dbd2334bd8156b7621e11c19a411db1308821d8...168551cd4f2139bbd050864c4231baa7e7b796dc,4,9,3,12,5,2011-09-03 06:09:59,2011-09-03 06:09:59
3f1706f5f66bd6f4c5ae9fc33224ffdc0a82a261...c098225cd52e212911c6eb1b71a23b7e8eb726ad,3,25,25,50,18,2011-09-02 07:26:58,2011-09-02 07:26:58
c098225cd52e212911c6eb1b71a23b7e8eb726ad...462287e25e0c2295884ad0d2cab31b0cd0b90b26,4,26,26,52,19,2011-09-02 07:31:19,2011-09-02 07:31:19
1b06f3e84e7f6bc57d2af6c9ffd97a94c911e072...5ef4519ca8ddf035a19d8f6dfff8745fdb380e32,3,2194,5,2199,4,2011-09-02 07:29:54,2011-09-02 07:29:54
dbd749c22603c8d0b9d27bd5a1ebf619ef30ba81...285393fb770bd3c3e3605d0d845a164887d0970d,4,14,10,24,6,2013-08-19 07:58:29,2013-08-19 07:58:29
0c70744ea22126b6224bde75b4ccb6068941e38f...2a4bd786edd2c03d576f9300d322b1e45cc14d3b,1,75,75,150,28,2013-08-17 21:09:35,2013-08-17 21:09:35
2a4bd786edd2c03d576f9300d322b1e45cc14d3b...6fe1264a8088bf627fc61d639e59acc65126c41c,1,6,6,12,6,2013-08-17 21:11:05,2013-08-17 21:11:05
6fe1264a8088bf627fc61d639e59acc65126c41c...903e92a3272420de058b2fdf8d301e4d06e3188c,1,5,5,10,5,2013-08-17 21:15:14,2013-08-17 21:15:14
903e92a3272420de058b2fdf8d301e4d06e3188c...6ca32589b59434574a9e9ed6cb12718b0234754e,3,16,1,17,5,2013-08-17 21:15:33,2013-08-17 21:15:33
728a5e17d667422cdad791e06375e8e9a0f80cc1...712b89ed4ebe71e44f2a7081be7ba372d8ca3f42,2,22,1,23,3,2013-08-17 21:24:38,2013-08-17 21:24:38
712b89ed4ebe71e44f2a7081be7ba372d8ca3f42...33f448f60563c7806f8f4b48dee8a1565bc270ad,2,4,2,6,3,2013-08-17 21:25:04,2013-08-17 21:25:04
4c5a0d2927a69bfd51de02a16e5707a2b206f7e8...78b2623fbfbb8b9703ee98c1a124f7504368b3e2,9,37,1,38,10,2013-11-07 18:14:18,2013-11-07 18:14:18
a4dc2c8955e0db79cc800f38d949db0ba0e7ba9a...62f891640714d86e1c26a0d5c9da9ee63ac22f21,3,20,14,34,14,2011-09-02 18:53:58,2011-09-02 18:53:58
0b70eb630e522c604973f945ea3010ecf0f38e9f...7882f0f64b2d8985520361885a17b403f9eafbcd,5,114,1,115,7,2011-09-04 05:53:21,2011-09-04 05:53:21
7882f0f64b2d8985520361885a17b403f9eafbcd...dfbb5919532b1dbe1868aadac6e2e95286cad969,9,76,31,107,29,2011-09-04 21:02:56,2011-09-04 21:02:56
dfbb5919532b1dbe1868aadac6e2e95286cad969...d0882c580de1fc2d5c52b684671b554bb8941ddf,5,35,16,51,20,2011-09-07 04:54:00,2011-09-07 04:54:00
168551cd4f2139bbd050864c4231baa7e7b796dc...df8eccbfe13a8c6d08a57dc939dff03c41721b6c,4,24,5,29,7,2011-09-03 06:28:01,2011-09-03 06:28:01
df8eccbfe13a8c6d08a57dc939dff03c41721b6c...bfa5ce70d490a82007c0f4b67ddacc2efba2b34b,1,19,7,26,1,2011-09-03 06:35:28,2011-09-03 06:35:28
ec82b613d3d19b47416924cde3e583da1e0d95c5...75afad4325d1208458b1a4d69ac3973646c45f42,2,5,28,33,6,2011-09-02 07:32:57,2011-09-02 07:32:57
75afad4325d1208458b1a4d69ac3973646c45f42...813c55489ff2f81eb46e859c93f089114a116e40,3,23,19,42,9,2011-09-02 07:42:22,2011-09-02 07:42:22
813c55489ff2f81eb46e859c93f089114a116e40...2a5d829c4a09f82aa9ce4ab8db2025aec91c120b,1,1,1,2,1,2011-09-02 07:47:06,2011-09-02 07:47:06
5ef4519ca8ddf035a19d8f6dfff8745fdb380e32...fa94b264fa9b552427a349235e176543af4be6d1,5,149,44,193,41,2011-09-02 07:50:05,2011-09-02 07:50:05
285393fb770bd3c3e3605d0d845a164887d0970d...7e82ceb53398968b8ce892d93639097d20bf78d6,3,14,11,25,8,2013-08-19 15:46:49,2013-08-19 15:46:49
7e82ceb53398968b8ce892d93639097d20bf78d6...a9297c7ad2b53014ff5111824646879776535fa2,3,9,9,18,5,2013-08-19 15:51:25,2013-08-19 15:51:25
a9297c7ad2b53014ff5111824646879776535fa2...f497b5e1f51be88a1e96773d5b57f7c2c522f11f,4,23,11,34,5,2013-08-19 15:54:40,2013-08-19 15:54:40
f497b5e1f51be88a1e96773d5b57f7c2c522f11f...55b7b1494f5145082e6e13a0c3eaf61918e898cf,1,1,1,2,1,2013-08-19 15:56:08,2013-08-19 15:56:08
285393fb770bd3c3e3605d0d845a164887d0970d...e82e8321f2397ad449c0e0d09817f2313805d770,1,1,1,2,1,2013-08-19 15:02:03,2013-08-19 15:02:03
285393fb770bd3c3e3605d0d845a164887d0970d...fabbb9e4bab3708f1fda7beaf6ced7b514350feb,1,0,3,3,1,2013-08-19 14:08:06,2013-08-19 14:08:06
1b814ddd0a5768ff8ee85bef28f026e06fbace93...3cb38197f2ce2453f88a01a69a5f26e84d1e6d16,1,3,3,6,3,2013-08-17 21:27:21,2013-08-17 21:27:21
3cb38197f2ce2453f88a01a69a5f26e84d1e6d16...3bcadfc2c560c5ecdb7fc943c34a721a49cb7309,1,15,17,32,15,2013-08-17 21:42:55,2013-08-17 21:42:55
2d875c8d5ecd77b833ff3af62a92d139f3382db7...484d51ce4897e81c018786b4ecc1825d4c67ee3c,1,1,1,2,1,2013-08-17 21:42:44,2013-08-17 21:42:44
db43777ddf2a72146621f385f54cba0d4103f80d...60409660d7537a83b6e1d6d66f9aa97e6c531f77,3,21,19,40,18,2011-09-02 19:01:41,2011-09-02 19:01:41
6638f87f5052cf9e1869e9811124daef1c6c1355...b9a53b146811ed5cc844aebf563d48bf5b6d2bc5,3,14,11,25,4,2011-09-02 19:02:20,2011-09-02 19:02:20
d0882c580de1fc2d5c52b684671b554bb8941ddf...d640c3b14b78bd17407ba123cbc718a6e34bb5d5,5,114,3,117,4,2011-09-07 06:30:21,2011-09-07 06:30:21
d0882c580de1fc2d5c52b684671b554bb8941ddf...fb8987148aeae4b9aa2b4c28fa3ad5346b8c56b1,11,33,113,146,12,2011-09-07 06:20:56,2011-09-07 06:20:56
251882892f27fa074d9f801c651060552a970282...46e4fb31338807be1535208fb07dfc3fff89fe08,3,11,11,22,7,2011-09-02 07:56:03,2011-09-02 07:56:03
46e4fb31338807be1535208fb07dfc3fff89fe08...411e32434095c9b6e9def4114d84df371e8e5d20,4,8,44,52,5,2011-09-02 07:58:07,2011-09-02 07:58:07
411e32434095c9b6e9def4114d84df371e8e5d20...db830140eea8e38c09cb80ff970f197b7ea1a11a,3,13,7,20,8,2011-09-02 08:03:16,2011-09-02 08:03:16
db830140eea8e38c09cb80ff970f197b7ea1a11a...3f2292514431b5ac4ca00776ff8348b5ca4c662b,3,2,4,6,4,2011-09-02 16:35:26,2011-09-02 16:35:26
3f2292514431b5ac4ca00776ff8348b5ca4c662b...b18633ee144789cf1c64b23040239223c5a2a1d4,1,1,1,2,1,2011-09-02 16:48:31,2011-09-02 16:48:31
d195d5989f2efc8cd9446db88f8c9a03c95d29e7...01f7bc4d8602467b10827ee279cc7e2877574615,2,1,5,6,2,2013-08-19 15:59:12,2013-08-19 15:59:12
01f7bc4d8602467b10827ee279cc7e2877574615...72fb2caf00b4d4a7c941bab5f98587efb751e21e,1,9,9,18,9,2013-08-19 16:10:19,2013-08-19 16:10:19
72fb2caf00b4d4a7c941bab5f98587efb751e21e...dacfb354ba33b98585b3e40449295759f45dbf39,1,1,1,2,1,2013-08-19 16:12:34,2013-08-19 16:12:34
dacfb354ba33b98585b3e40449295759f45dbf39...b5698361266345c653e7b21ec109bb0f9592129c,1,3,0,3,2,2013-08-19 16:17:49,2013-08-19 16:17:49
fdb7121f416048b2c06a90c4e00ab434e28e907e...6c765ac8211536e9701e996416b8a5296590d5fd,4,66,0,66,3,2013-08-17 22:02:38,2013-08-17 22:02:38
6c765ac8211536e9701e996416b8a5296590d5fd...4f97df8aa42d2609efd52ea21f1e84124afbe39d,3,8,4,12,4,2013-08-17 22:07:53,2013-08-17 22:07:53
484d51ce4897e81c018786b4ecc1825d4c67ee3c...a10ec62f6372d6c99da286cb1af59c44e411c5a8,3,3,3,6,3,2013-08-17 22:05:59,2013-08-17 22:05:59
1bac76af28097750066ac83a9db089e5a96e0580...0d51cde755573ed80f179ae82bf40e6eeb725dee,1,0,0,0,0,2014-01-23 19:04:45,2014-01-23 19:04:45
0d51cde755573ed80f179ae82bf40e6eeb725dee...9699e0fa2d03fdd17a78649659a4a13a719ee2ea,1,2,1,3,1,2014-01-23 19:08:23,2014-01-23 19:08:23
9699e0fa2d03fdd17a78649659a4a13a719ee2ea...5e612b463d4d9e36962d61a0534f543ac43c4f09,2,1,2,3,1,2014-01-24 04:55:06,2014-01-24 04:55:06
ac57331323e8a36ccc25d474859288f0403e669d...8c1e60c638ba9f2c564f9c0f05c255a673672a5e,5,28,21,49,15,2011-09-02 19:19:43,2011-09-02 19:19:43
8c1e60c638ba9f2c564f9c0f05c255a673672a5e...e0722fcb1bbaffa2adb20ce3d4793422921255e1,1,3,3,6,2,2011-09-02 19:24:28,2011-09-02 19:24:28
e0722fcb1bbaffa2adb20ce3d4793422921255e1...cb244d5d51f910ac891f4a3a4691cd0740dc8307,5,26,25,51,23,2011-09-02 19:31:14,2011-09-02 19:31:14
cb244d5d51f910ac891f4a3a4691cd0740dc8307...2f4c84bba976344b8fe198a7613184e32231b66a,3,11,2,13,5,2011-09-02 19:35:41,2011-09-02 19:35:41
2f4c84bba976344b8fe198a7613184e32231b66a...298e1b59bbf389ba8ec45de6428f1128ac71114c,5,15,11,26,8,2011-09-02 19:46:47,2011-09-02 19:46:47
298e1b59bbf389ba8ec45de6428f1128ac71114c...2589c0ac4ecc86feed81cfc5df344e0eb78cda64,1,1,1,2,1,2011-09-02 22:07:12,2011-09-02 22:07:12
daf903f8478644a642971fd8d87e7db81d64bde0...f6d20a8939f0231c16b9d6b826644a72a29e246a,1,1,1,2,1,2011-09-07 06:32:20,2011-09-07 06:32:20
f6d20a8939f0231c16b9d6b826644a72a29e246a...1af96b9a58b0bbd27a705000ed1ce68b5af04b7f,5,183,78,261,68,2011-09-08 16:43:37,2011-09-08 16:43:37
1af96b9a58b0bbd27a705000ed1ce68b5af04b7f...1c03a075919681c398622bc36ca9f78b5f3c1737,13,46,55,101,37,2011-09-08 17:36:56,2011-09-08 17:36:56
1c03a075919681c398622bc36ca9f78b5f3c1737...c474f996a902434572c238bb6e170473171cadad,4,50,26,76,13,2011-09-08 17:47:05,2011-09-08 17:47:05
fb8987148aeae4b9aa2b4c28fa3ad5346b8c56b1...8d2f14d8d0bfef3b472be7b7770177fad26d5068,2,101,0,101,2,2011-09-09 02:13:08,2011-09-09 02:13:08
b5698361266345c653e7b21ec109bb0f9592129c...7bc845abfa7aed4c1647ff537bd8bca80df20da3,4,6,3,9,8,2013-08-19 16:31:16,2013-08-19 16:31:16
b5698361266345c653e7b21ec109bb0f9592129c...bfe2dc4109a66d403f8681f2b13aa7291d6aca62,1,2,2,4,2,2013-08-19 16:30:38,2013-08-19 16:30:38
f4c76295920114e63cca5284aad89aee5eabfd0a...a01b1dd71ac56667becb42d245213bf698d2cc36,1,1,1,2,1,2013-08-17 22:07:26,2013-08-17 22:07:26
5ba19dc8849b1b87836404acfa8bbb336db1e496...61caed21e2553e1be29d98bd83c8e6ac06565ecd,7,77,72,149,63,2013-08-17 22:21:38,2013-08-17 22:21:38
61caed21e2553e1be29d98bd83c8e6ac06565ecd...665559a45051823479362ced72c99d2acc5a5590,14,0,0,0,0,2013-08-17 22:35:15,2013-08-17 22:35:15
665559a45051823479362ced72c99d2acc5a5590...3fbc1fc555804d87fc2b06852d08e3d06b3a7821,1,2,0,2,1,2013-08-17 22:43:54,2013-08-17 22:43:02
3fbc1fc555804d87fc2b06852d08e3d06b3a7821...663673438845b0bdb4f951ece7c6eabb2d51d065,3,22,1,23,3,2013-08-17 22:46:42,2013-08-17 22:46:42
015e063b72fd9fba4a053de02ff8f14f30ca3604...eaa2b8338a00ba7e8e8ffc00ed0368ea3f9ec318,1,1,1,2,1,2014-01-30 16:59:23,2014-01-30 16:59:23
eaa2b8338a00ba7e8e8ffc00ed0368ea3f9ec318...09673814c8a3572e4a678d2eda4cfa2451486149,207,2,23667,23669,98,2014-01-30 17:30:24,2014-01-30 17:30:24
2589c0ac4ecc86feed81cfc5df344e0eb78cda64...fe8cb55cc16fb0995428b7055c6f31c6a50f6ed5,2,5,4,9,4,2011-09-03 16:10:42,2011-09-03 16:10:42
2589c0ac4ecc86feed81cfc5df344e0eb78cda64...c4481b54a8c2cf05bd12d04196e3234523d27653,4,17,11,28,9,2011-09-03 04:00:01,2011-09-03 04:00:01
c474f996a902434572c238bb6e170473171cadad...ba08055a7be248582ce6b5ba00bf04f5c821bcdd,6,130,85,215,41,2011-09-09 06:01:28,2011-09-09 06:01:28
346122a0c7a883f1fcc1887899cf8bb37274c7f9...5960711d0f79f7031b444bafba9a856c77f697bc,11,143,120,263,39,2011-09-09 03:21:03,2011-09-09 03:21:03
7bc845abfa7aed4c1647ff537bd8bca80df20da3...16976cc49454b5ad9732f2ed3e572c9ecd806562,3,3,3,6,3,2013-08-19 16:36:56,2013-08-19 16:36:56
16976cc49454b5ad9732f2ed3e572c9ecd806562...48cddf9633c9823a60a63a327bcaa5aa072a8e1d,1,0,0,0,0,2013-08-19 16:54:16,2013-08-19 16:54:16
a01b1dd71ac56667becb42d245213bf698d2cc36...1d53dd31f5a6c9be04177e251756909847e6fc0a,3,42,42,84,40,2013-08-17 22:48:29,2013-08-17 22:48:29
663673438845b0bdb4f951ece7c6eabb2d51d065...c8b51e1cd8c3e14abbd7e8301a13c82238994cc7,1,1,1,2,1,2013-08-17 22:58:04,2013-08-17 22:58:04
09673814c8a3572e4a678d2eda4cfa2451486149...33899c8768f7538b6bef0179120a99989ae6f24c,3,8129,0,8129,3,2014-01-31 18:42:36,2014-01-31 18:42:36
43b01d1b80764a92ded6b47269433e2ecfd1919b...a40690a17c1a72fe2364518a62962d6bb5616373,3,4,4,8,4,2011-09-10 03:48:45,2011-09-10 03:48:45
c4481b54a8c2cf05bd12d04196e3234523d27653...d5e42cf81a5b0a680d59e3dc5ebdc45652b7b4e9,4,87,53,140,42,2011-09-03 04:54:11,2011-09-03 04:54:11
d5e42cf81a5b0a680d59e3dc5ebdc45652b7b4e9...5c3f0e32e6940e9e9482f8eaf6864c75dab3dacf,4,26,15,41,13,2011-09-03 05:08:38,2011-09-03 05:08:38
5c3f0e32e6940e9e9482f8eaf6864c75dab3dacf...162534139170e3416cb33a5b5c5093d4a2a5e8f0,3,6,6,12,6,2011-09-03 05:09:12,2011-09-03 05:09:12
1a8fb2dbf76b19c899ff8ae73a87c3727c1113cf...b086d9425345844df597a6ae6b450dde7f4fb762,2,8,10,18,10,2011-09-09 07:00:03,2011-09-09 07:00:03
1a8fb2dbf76b19c899ff8ae73a87c3727c1113cf...3a99b98ad9ef1d7bfbcfbe4311147562ffefc4e6,3,4,2,6,4,2011-09-09 06:08:38,2011-09-09 06:08:38
3a99b98ad9ef1d7bfbcfbe4311147562ffefc4e6...1d4e345ec1d9afce1f2d4cce8334a3bf6789eced,4,39,19,58,22,2011-09-09 07:02:47,2011-09-09 07:02:47
3d5ccc6c6f11f6b233e2cdb33711171b18011c28...c15b259f43945fd9cf0d66f04504665ae9298f1a,2,4,4,8,3,2013-08-19 17:43:58,2013-08-19 17:43:58
8b5314096f1bd30577d09aea2095bc5c5504a784...d754e6564d8fd8fe1447ba6674eb9e041a6190b2,2,6,6,12,4,2013-08-17 22:54:42,2013-08-17 22:54:42
a5b066859cc312071934ed264787c84de26777b7...76a8c7698705c309fe72b54a191b9ff23becb611,1,1,1,2,1,2014-02-03 06:11:55,2014-02-03 06:11:18
76a8c7698705c309fe72b54a191b9ff23becb611...8c5c80058d2ad29f2ce21ca8c7b535ea11e3ec0b,1,10,9,19,3,2014-02-03 11:01:17,2014-02-03 09:44:50
8c5c80058d2ad29f2ce21ca8c7b535ea11e3ec0b...c17e4c7f948ec6e27c41c2afa361213bb5ff35a7,103,11008,11860,22868,678,2014-02-13 17:36:49,2014-02-13 17:36:49
c17e4c7f948ec6e27c41c2afa361213bb5ff35a7...0458ae1cb3e66c3c30e47b38e22581277c91a3a8,1,5,5,10,5,2014-02-13 17:39:00,2014-02-13 17:39:00
0458ae1cb3e66c3c30e47b38e22581277c91a3a8...d861e0c781421729043a8738f85c184f5cdb7bec,1,2,1,3,1,2014-02-25 21:40:13,2014-02-19 19:19:41
d861e0c781421729043a8738f85c184f5cdb7bec...404997e01c290539c2d74bf640fbd1f1ab2c22f1,2,10,1,11,3,2014-03-11 18:17:07,2014-03-11 18:17:07
404997e01c290539c2d74bf640fbd1f1ab2c22f1...a892ab697fc5f92490aa5c3e05ad06c79a7bda8c,1,2,2,4,1,2014-03-12 17:12:55,2014-03-12 17:12:53
c30ac30751378e53035ff866eb628d1a26c6ee9b...164367fe03ba8e85299c0cd3914afee296952b4e,1,0,9,9,1,2014-01-30 20:26:24,2014-01-30 20:24:45
164367fe03ba8e85299c0cd3914afee296952b4e...eeeaa0b894cf0c126ca335e9baeba4296246f86a,1,1,1,2,1,2014-01-30 22:48:32,2014-01-30 22:46:58
eeeaa0b894cf0c126ca335e9baeba4296246f86a...648984f1cc5f4c97d4aafe8e3e7b4b8408dbffd7,1,1,1,2,1,2014-01-31 16:21:57,2014-01-31 04:39:12
648984f1cc5f4c97d4aafe8e3e7b4b8408dbffd7...b09eba80d3a6b260f30fc4f5e610420c5d2aaf53,2,85,230,315,37,2014-01-31 16:22:12,2014-01-31 07:26:11
a40690a17c1a72fe2364518a62962d6bb5616373...86bb0733a25e55b0ad940465bf0c90253b9e58d5,1,8,4,12,3,2011-09-12 04:56:54,2011-09-12 04:56:54
df3ca4d94a69436c1d6c53f5559aefca98fb2232...5f4e30ed1d33f83b0fad3afc9174e193e6c3fdf4,22,1997,83,2080,39,2011-09-10 05:47:49,2011-09-10 05:47:49
df3ca4d94a69436c1d6c53f5559aefca98fb2232...53135839f549a3278e39f912283b48180a2b6c8c,2,57,32,89,14,2011-09-09 17:04:07,2011-09-09 17:04:07
53135839f549a3278e39f912283b48180a2b6c8c...dad058326e5aca45161887c246861e64d7192dca,5,13,8,21,11,2011-09-09 23:00:59,2011-09-09 23:00:59
dad058326e5aca45161887c246861e64d7192dca...c56e229ed73824778c672a67e7e70c4521623fe9,1,67,13,80,4,2011-09-10 03:47:38,2011-09-10 03:47:38
c56e229ed73824778c672a67e7e70c4521623fe9...a0c3d4834225a2dd9fe3f3100b44ea316137c2d9,4,5,5,10,5,2011-09-10 04:43:19,2011-09-10 04:43:19
a0c3d4834225a2dd9fe3f3100b44ea316137c2d9...0b43bc9bb9266fa8e8d830b82ede20fb3a939acd,1,7,1,8,1,2011-09-10 04:50:41,2011-09-10 04:50:41
c15b259f43945fd9cf0d66f04504665ae9298f1a...3f87bf46e463b113760a2e45158a684825bf9d50,3,15,1,16,3,2013-08-19 20:16:32,2013-08-19 20:16:32
c15b259f43945fd9cf0d66f04504665ae9298f1a...c64a8cfc72c2c6ef1b766aeb019b22dc75f6d6bd,4,24,7,31,10,2013-08-19 19:19:00,2013-08-19 19:19:00
c64a8cfc72c2c6ef1b766aeb019b22dc75f6d6bd...c2d5861232628a3918ff1eaf773cd040ceb8e5a9,2,1,2,3,2,2013-08-19 19:22:42,2013-08-19 19:22:42
d754e6564d8fd8fe1447ba6674eb9e041a6190b2...c0eabdda9fd8e97f44117bd4bd77dd1344039024,3,3,3,6,3,2013-08-17 23:11:05,2013-08-17 23:11:05
70f1cac8418253af1814da8d1de57b1e2a0c19ea...63ac9e354fbbf89f40e019656b5f9f3e478a1082,2,12,10,22,2,2013-08-17 23:13:48,2013-08-17 23:13:48
63ac9e354fbbf89f40e019656b5f9f3e478a1082...4696565044de6216e95894986b579bf5efe57af4,1,2,2,4,2,2013-08-17 23:18:26,2013-08-17 23:18:26
4696565044de6216e95894986b579bf5efe57af4...2dbf02b129aa23e2ef17d7867dec74fa1818a671,2,3,3,6,3,2013-08-17 23:19:09,2013-08-17 23:19:09
2dbf02b129aa23e2ef17d7867dec74fa1818a671...5d84e02c1caf6c670dea2a877b4a375615871341,2,3,3,6,2,2013-08-17 23:44:54,2013-08-17 23:44:54
a892ab697fc5f92490aa5c3e05ad06c79a7bda8c...14dce26bac851773cb81d53ad0f50d413cdbb45c,1,5,375,380,2,2014-05-01 02:53:21,2014-05-01 02:53:21
a892ab697fc5f92490aa5c3e05ad06c79a7bda8c...cbf40924fb74a43bc192b4f0b42892be5ffe5554,2,29,1,30,6,2014-04-01 09:11:47,2014-04-01 09:11:37
cbf40924fb74a43bc192b4f0b42892be5ffe5554...f09ce07e3b93f29602ce6e343e16b52abdc007b0,1,1,4,5,1,2014-04-09 04:38:42,2014-04-09 04:38:42
0c46ade4d0b72a69c23426c179d150887512c6d1...b729ade54f511867be0173e402a95c0799317ca3,3,9,14,23,14,2011-09-12 16:25:57,2011-09-12 16:25:57
b729ade54f511867be0173e402a95c0799317ca3...a218475ffcd15f38894d0dc5db1aada66dede4da,1,10,4,14,4,2011-09-12 21:33:00,2011-09-12 21:33:00
a218475ffcd15f38894d0dc5db1aada66dede4da...427a001c476569684027567e5a7cec89058185ad,1,1,1,2,1,2011-09-12 21:33:39,2011-09-12 21:33:39
79d5f907130a030963b802647e3ed3bcb6300a46...48aa209348c47df65f4edb0d8a36ccaac357eb0a,9,205,33,238,32,2011-09-10 19:49:21,2011-09-10 19:49:21
48aa209348c47df65f4edb0d8a36ccaac357eb0a...1041977d0acedfcbd0d2a0d4a007496ccad10991,3,82,25,107,11,2011-09-10 20:17:08,2011-09-10 20:17:08
0b43bc9bb9266fa8e8d830b82ede20fb3a939acd...5b1615015931986b064aa12c222c1059e58f25e5,5,16,6,22,9,2011-09-10 20:00:07,2011-09-10 20:00:07
6248b7118329f0573b5e1d3502910aab356181f5...ee5f0307702b7488b786980d511a72f61892ccfa,1,1,1,2,1,2013-08-19 20:17:16,2013-08-19 20:17:16
ee5f0307702b7488b786980d511a72f61892ccfa...1a8f1e68efa0b5817447085b903147006345225a,1,6,6,12,6,2013-08-19 20:27:45,2013-08-19 20:27:45
1a8f1e68efa0b5817447085b903147006345225a...fadf0160435719fce4a1790b1ace7cfa044aa82b,1,2,1,3,2,2013-08-19 20:49:58,2013-08-19 20:49:58
5d84e02c1caf6c670dea2a877b4a375615871341...29bf254fc360deef21d89751aa5dc7ffefc86e15,4,330,1583,1913,279,2013-08-18 01:41:36,2013-08-18 01:41:36
5d84e02c1caf6c670dea2a877b4a375615871341...27424ee42287f5047345fc8d54c55eedcbc3c172,1,1,1,2,1,2013-08-18 00:26:54,2013-08-18 00:26:54
5d84e02c1caf6c670dea2a877b4a375615871341...b3e06aea012346dcead85248d7dee91f692b29fe,1,0,52,52,1,2013-08-18 00:26:05,2013-08-18 00:26:05
b3e06aea012346dcead85248d7dee91f692b29fe...90d5e48f5f2d9d9619eb819fc914804064a3adaa,2,32,2,34,2,2013-08-18 00:26:36,2013-08-18 00:26:36
90d5e48f5f2d9d9619eb819fc914804064a3adaa...e58721995879da2e866f27d389dfa9ed9da4d0b5,3,7,1,8,3,2013-08-18 00:26:52,2013-08-18 00:26:52
ed14e5132b73a4a1594997a2e2392a214281046e...2c3d8ce13473e2938798c48cef355fdbfa44bcbf,73,2983,11638,14621,941,2014-06-26 16:46:59,2014-06-26 16:46:59
2c3d8ce13473e2938798c48cef355fdbfa44bcbf...a1619676454ec65e62c8af4fa60ed172d71bf165,2,6645,0,6645,2,2014-06-26 16:48:42,2014-06-26 16:48:42
a1619676454ec65e62c8af4fa60ed172d71bf165...e4c276bcd131c9c349c5ed993370b6c6402e3338,1,2114,0,2114,1,2014-06-26 16:48:57,2014-06-26 16:48:57
e4c276bcd131c9c349c5ed993370b6c6402e3338...b7dd628dd501e6583ca69f242ac569f0d8631467,1,7,7,14,7,2014-06-26 18:51:56,2014-06-26 18:51:56
b7dd628dd501e6583ca69f242ac569f0d8631467...0ad6be24725e118ecc3195eaa7889753991a3426,2,9,9,18,9,2014-06-26 19:46:37,2014-06-26 19:46:37
0ad6be24725e118ecc3195eaa7889753991a3426...13e81219a87245707cb95b4875b723afd22c4a65,1,8,8,16,8,2014-06-26 19:57:57,2014-06-26 19:57:46
13e81219a87245707cb95b4875b723afd22c4a65...709ae8ef611d23e7cc5b997e2be9c0f90d4a6261,1,2,2,4,1,2014-06-26 21:27:46,2014-06-26 21:27:46
709ae8ef611d23e7cc5b997e2be9c0f90d4a6261...6d3086b7720814bcd50e37c2126ae9d7b7cb0ade,4,32,24,56,14,2014-07-01 04:11:21,2014-07-01 04:11:21
6d3086b7720814bcd50e37c2126ae9d7b7cb0ade...c373a610bf8213437250fa2c43c55b8565036ee8,1,1,1,2,1,2014-08-17 23:03:09,2014-08-17 23:03:09
c7c5ce8dcd4cc6c56bc64007bf31b93760dbf2ee...cd556cfacd83a30791b9efaeac61caea057cc8b0,2,2,127,129,13,2011-09-16 18:24:45,2011-09-16 18:24:45
cd556cfacd83a30791b9efaeac61caea057cc8b0...f03f7da08beede6e6a92ecc6bf28ca978750cd7a,1,1,1,2,1,2011-09-16 19:30:30,2011-09-16 19:30:30
f03f7da08beede6e6a92ecc6bf28ca978750cd7a...08d017592b8369bca64a90eb4b8305bf36ea1412,1,1,1,2,1,2011-09-16 20:01:49,2011-09-16 20:01:49
08d017592b8369bca64a90eb4b8305bf36ea1412...732ff9ed1c0b590c17951de412024cb7acd5763a,3,23,27,50,11,2011-09-16 21:07:18,2011-09-16 21:07:18
c797cb61a6a36459b0c3e7b628e22ad3518350e8...e5b4a1ced5aef8bd050b48873d3e74fb2dfe799e,3,8,6,14,7,2011-09-10 20:18:10,2011-09-10 20:18:10
5bc455d3707b87960d32c0672f5afb3b31173ec8...5f65df9e2db7c16c3c64930331a467e18501e20c,3,50,11,61,12,2011-09-10 21:04:22,2011-09-10 21:04:22
fadf0160435719fce4a1790b1ace7cfa044aa82b...f95ab89fb1da85ff0fcb95c43d4fe4af359e302a,2,3,5,8,3,2013-08-19 20:58:29,2013-08-19 20:58:29
a39cb4be909c667ade97f6575dd904f1ba34d96f...00d2986858832c3759778adfa31757f846a46b59,2,21,19,40,8,2013-08-18 02:04:41,2013-08-18 02:04:41
e29c23afab2577e05cfaa41f64a20f1ca87222fc...3780edd956e0666361ef2a366945455d78ff9183,7,7,7,14,7,2013-08-18 02:00:14,2013-08-18 02:00:05
e29c23afab2577e05cfaa41f64a20f1ca87222fc...50b9c7339a25265f42130907ca33684e74126a2a,1,1,1,2,1,2013-08-18 00:38:53,2013-08-18 00:38:53
50b9c7339a25265f42130907ca33684e74126a2a...cc3077ac17eac65837b81ec0d289c3913383c9a0,1,1,1,2,1,2013-08-18 00:41:47,2013-08-18 00:41:47
cc3077ac17eac65837b81ec0d289c3913383c9a0...405df13044adcbb5925159726a0b64918c8e263a,1,1,1,2,1,2013-08-18 00:44:42,2013-08-18 00:44:42
c373a610bf8213437250fa2c43c55b8565036ee8...8312d7fd782250f1728fe5e51f012cc37c65c0d4,23,313,279,592,110,2014-08-28 03:51:32,2014-08-28 03:51:32
732ff9ed1c0b590c17951de412024cb7acd5763a...159ccc9de38c0402d8dda37b7ea0295294f27f46,1,4,4,8,1,2011-09-18 15:10:36,2011-09-18 14:59:52
732ff9ed1c0b590c17951de412024cb7acd5763a...ec8619a9808b9b6e721334af8e6b5248ccbea8b5,6,180,251,431,64,2011-09-18 00:21:43,2011-09-18 00:21:43
ec8619a9808b9b6e721334af8e6b5248ccbea8b5...b5acabe4fd7dd2bb14424a88944152bbebd2e07d,1,8,8,16,3,2011-09-18 05:55:29,2011-09-18 05:55:29
b5acabe4fd7dd2bb14424a88944152bbebd2e07d...6d541a6066d46bff19833707deeca8f41279b180,4,11,19,30,8,2011-09-29 02:06:10,2011-09-29 02:06:10
6d541a6066d46bff19833707deeca8f41279b180...1b21d5e321ec77c6381becae2e2d7d1c4ab14d9a,3,51,82,133,18,2011-09-29 02:15:31,2011-09-29 02:15:31
1b21d5e321ec77c6381becae2e2d7d1c4ab14d9a...2d81d65533ded88c76712e787edbd745d38e403e,3,6,6,12,5,2011-09-29 03:21:09,2011-09-29 03:21:09
2d81d65533ded88c76712e787edbd745d38e403e...f919f6f94f3e8405d7653a5f16f8b3d587c47f4c,9,560,817,1377,176,2011-09-29 08:40:27,2011-09-29 08:40:27
f919f6f94f3e8405d7653a5f16f8b3d587c47f4c...ecdba931ec4a6eced099026c1aeab503567a4e0a,1,0,3,3,1,2011-09-29 08:41:03,2011-09-29 08:41:03
ecdba931ec4a6eced099026c1aeab503567a4e0a...4e9849966d0f7b18cd4b8a22f6ef98c6900a2099,3,19,20,39,8,2011-09-29 08:43:14,2011-09-29 08:43:14
4e9849966d0f7b18cd4b8a22f6ef98c6900a2099...00204a80cf1c45cb9d7d80986756401d304a3944,3,10,11,21,10,2011-09-29 08:44:51,2011-09-29 08:44:51
00204a80cf1c45cb9d7d80986756401d304a3944...f54568fa31396556a0df7bf8e2b180885e2b1c3f,3,16,1,17,4,2011-09-29 08:47:55,2011-09-29 08:47:55
f54568fa31396556a0df7bf8e2b180885e2b1c3f...0a6d8c30db0600ab8d33e14ead0ff120cd03ac9d,5,210,6,216,10,2011-09-29 09:21:02,2011-09-29 09:21:02
0a6d8c30db0600ab8d33e14ead0ff120cd03ac9d...96dd7a2903aa5213ddb364b385660e26396dc670,9,164,148,312,120,2011-10-04 07:20:38,2011-10-04 07:20:38
96dd7a2903aa5213ddb364b385660e26396dc670...cde17c94919ef26093145e5412c6d425d3199d9f,2,15,1,16,2,2011-10-04 07:48:31,2011-10-04 07:48:31
cde17c94919ef26093145e5412c6d425d3199d9f...bdbc35206630645e6cc6655ec9e50aa70081a2fb,1,11,0,11,3,2011-10-04 07:55:35,2011-10-04 07:55:35
bdbc35206630645e6cc6655ec9e50aa70081a2fb...913338f930736a1b186178469c6eafb55c1dbea8,3,4,2,6,4,2011-10-04 08:15:31,2011-10-04 08:15:31
732ff9ed1c0b590c17951de412024cb7acd5763a...2cb233319da422c9f003e8687d686e96a92be489,3,74,3,77,4,2011-09-17 20:08:16,2011-09-17 19:47:38
2cb233319da422c9f003e8687d686e96a92be489...7b614cfa01eccfef02d85f2f82e0b13023ce7baa,4,15,20,35,13,2011-09-17 21:20:51,2011-09-17 21:20:51
6d99ae56591f94327453f5dc51e3ce57c64cb831...99ede580cf85611bf446abd46fa1ad4daf850a59,8,211,19,230,31,2011-09-10 22:29:38,2011-09-10 22:29:38
39fc13093eb90ffcc047cbb7ab5f3b5b9ff3294f...a8d447582741486e66a6a073015a9e9bd431af29,6,28,59,87,12,2011-09-10 21:52:45,2011-09-10 21:52:45
f95ab89fb1da85ff0fcb95c43d4fe4af359e302a...b6ddaf63d67938eb75b1189c680f22946d6f4f54,6,11,13,24,8,2013-08-19 21:16:52,2013-08-19 21:16:52
9828aa5b4d9b194baac77ed870fe98ac1146c08e...06c3d87973207d4e9c4551572a8db0a08e422f37,1,2,2,4,1,2013-08-18 02:07:59,2013-08-18 02:07:59
ba20e512ce53e7cc771ba06d492a01d48db6cc97...c56a749323836b7e0b7401d41de1d0c68a7cb7a8,11,976,169,1145,20,2013-08-18 01:59:50,2013-08-18 01:59:50
4ab418ab1117ec5ce045e1dd72d0eb8c32185be6...b5224b188f0171d4adaa480e58aa2c52789a32b1,1,2,2,4,1,2014-09-03 17:48:53,2014-09-03 17:48:05
b5224b188f0171d4adaa480e58aa2c52789a32b1...0ea578d5eae257741140a3935bfc247c3f66537a,1,8,0,8,1,2014-09-08 18:10:35,2014-09-08 18:10:35
0ea578d5eae257741140a3935bfc247c3f66537a...06322239af4d5b23b2fb8c0f1cd3634c4a3d76db,1,40,22,62,12,2014-09-22 17:24:07,2014-09-22 17:24:07
06322239af4d5b23b2fb8c0f1cd3634c4a3d76db...bc20e24acf09d6871763b05217d701414d2d9795,1,13,0,13,2,2014-09-27 00:02:26,2014-09-27 00:02:26
bc20e24acf09d6871763b05217d701414d2d9795...ad2064c9adc35ff7460596c8f905957c9d56761c,1,1,1,2,1,2014-09-27 00:04:24,2014-09-27 00:04:24
ad2064c9adc35ff7460596c8f905957c9d56761c...8d88db8270dd81490057339eee0274ecafc18a64,1,6,0,6,2,2014-09-27 00:07:19,2014-09-27 00:07:19
8d88db8270dd81490057339eee0274ecafc18a64...4be838001b6aab98952f670848a53cc48b210b58,1,0,6,6,1,2014-09-27 00:47:24,2014-09-27 00:47:24
4be838001b6aab98952f670848a53cc48b210b58...f72a9082a0f2f36ac4bf885c5a258c58cc1075bb,1,3,2,5,3,2014-09-27 00:49:42,2014-09-27 00:49:42
f72a9082a0f2f36ac4bf885c5a258c58cc1075bb...ebedbf4c2eb5d46b8e5a094532b9a7332e628e1c,1,1,1,2,1,2014-09-27 00:50:51,2014-09-27 00:50:51
ebedbf4c2eb5d46b8e5a094532b9a7332e628e1c...08aa7aaa5135ed7d060cdf40726834da7b92e118,1,2,0,2,2,2014-09-27 00:53:35,2014-09-27 00:53:35
08aa7aaa5135ed7d060cdf40726834da7b92e118...5b4bf03a0c06128050714fbd523d64ceffaa3fdd,1,12,12,24,12,2014-09-27 00:55:40,2014-09-27 00:55:40
5b4bf03a0c06128050714fbd523d64ceffaa3fdd...3625fc01faa5087322fa76b421f3e84e51a08bdc,1,4,0,4,1,2014-09-27 00:57:34,2014-09-27 00:57:34
3625fc01faa5087322fa76b421f3e84e51a08bdc...df6b99a2c6789fda25e497be94833d83b354dfc2,1,4,0,4,1,2014-09-27 01:14:29,2014-09-27 01:14:29
df6b99a2c6789fda25e497be94833d83b354dfc2...7263693ed1587a00f12a882e5a57683201246d97,1,4,2,6,2,2014-09-27 01:16:10,2014-09-27 01:16:10
7263693ed1587a00f12a882e5a57683201246d97...c4eb216cf9d52ec8ce4d89dba047b6a611a378fc,1,2,1,3,2,2014-09-27 01:17:37,2014-09-27 01:17:37
c4eb216cf9d52ec8ce4d89dba047b6a611a378fc...1f8c19fe3c34b4587a5ecf084b3150cff6573103,1,3,3,6,2,2014-09-27 01:19:36,2014-09-27 01:19:36
1f8c19fe3c34b4587a5ecf084b3150cff6573103...99c1c37cd9b4e22247d0f834649e4120044ff0ec,1,1,1,2,1,2014-09-27 01:20:51,2014-09-27 01:20:51
99c1c37cd9b4e22247d0f834649e4120044ff0ec...7ac0c4a1839d8c18e6d902038ac52178b20411e5,1,4,4,8,4,2014-09-27 01:23:57,2014-09-27 01:23:57
7ac0c4a1839d8c18e6d902038ac52178b20411e5...9c1e09fa6f4e4dc5b80f3a85d84b31dd7d8aff31,1,5,1,6,2,2014-09-27 01:25:01,2014-09-27 01:25:01
9c1e09fa6f4e4dc5b80f3a85d84b31dd7d8aff31...31811a837c60c93ad3e7a80f0344c91fc7e00754,1,3,1,4,1,2014-09-27 01:26:14,2014-09-27 01:26:14
31811a837c60c93ad3e7a80f0344c91fc7e00754...55455720b261fae211fb4a29cf1b1fbd8405305b,1,5,0,5,1,2014-09-27 01:27:14,2014-09-27 01:27:14
55455720b261fae211fb4a29cf1b1fbd8405305b...f5b90440fab072d6e694daf132fb6b569c5fb89b,1,3,4,7,2,2014-09-27 01:33:07,2014-09-27 01:33:07
f5b90440fab072d6e694daf132fb6b569c5fb89b...33a87e5b104e2537fd4661d9940ffc44641812c3,1,9,15,24,3,2014-10-01 16:42:02,2014-10-01 16:42:02
33a87e5b104e2537fd4661d9940ffc44641812c3...71c3a9e36bc69cdcd76982c32b5c002b6f8e2856,1,0,4,4,1,2014-10-07 22:45:47,2014-10-07 22:45:47
71c3a9e36bc69cdcd76982c32b5c002b6f8e2856...7396fa597d57ffb339539dae14322e44c6033814,1,26,1,27,3,2014-10-21 02:08:10,2014-10-21 02:08:10
7396fa597d57ffb339539dae14322e44c6033814...ebeb110b7c02c0961f471d975fb9961fa22ceb83,58,6509,2888,9397,1690,2014-10-29 19:17:44,2014-10-29 19:17:44
ebeb110b7c02c0961f471d975fb9961fa22ceb83...4a3131f6ba1e2d8b80ccafd0ac78a6b3edcb4973,10,49,83,132,49,2014-10-29 19:52:33,2014-10-29 19:52:33
4a3131f6ba1e2d8b80ccafd0ac78a6b3edcb4973...ffbf6a7087c94569022ea3f5d1cd4ee33481f395,8,56,72,128,8,2014-10-30 01:30:56,2014-10-30 01:30:56
ffbf6a7087c94569022ea3f5d1cd4ee33481f395...d7313d0fe2bc6df41fbf9a56de00d04a51202b8f,1,12,0,12,1,2014-10-30 01:42:45,2014-10-30 01:42:45
d7313d0fe2bc6df41fbf9a56de00d04a51202b8f...11df32dd6b2e45ffc65f861cbdf1118da7c45a69,1,3,3,6,3,2014-10-30 07:13:07,2014-10-30 07:13:07
11df32dd6b2e45ffc65f861cbdf1118da7c45a69...d3085c9084cd4feb1a22b4ae790b6f31d8f9a330,1,1,1,2,1,2014-10-30 18:39:04,2014-10-30 18:39:04
d3085c9084cd4feb1a22b4ae790b6f31d8f9a330...69e2fae33e3a8b5a15a33981e41ac6bff9cd6558,1,3,3,6,3,2014-10-31 00:39:31,2014-10-31 00:39:31
69e2fae33e3a8b5a15a33981e41ac6bff9cd6558...aa309a1e9e521a42ea48078d89cd1b202f92fb8d,2,2,2,4,2,2014-10-31 10:07:19,2014-10-31 10:07:19
aa309a1e9e521a42ea48078d89cd1b202f92fb8d...85dea538a5b66ed9e1188f106c513b9bd138316f,1,7,1,8,2,2014-11-01 00:15:23,2014-11-01 00:15:23
85dea538a5b66ed9e1188f106c513b9bd138316f...19ca6389e2a968960f97ff39da12126ba5693984,1,1,1,2,1,2014-11-05 22:57:14,2014-11-05 22:57:14
19ca6389e2a968960f97ff39da12126ba5693984...79d0cdbef4e87f2169ae3b892afd4c5670a9c7d7,2,14,20,34,8,2014-11-07 08:31:34,2014-11-07 08:31:34
79d0cdbef4e87f2169ae3b892afd4c5670a9c7d7...46edabe554563920e099283440692068a78f5c6a,40,17318,910,18228,682,2014-11-12 17:15:07,2014-11-12 17:15:07
46edabe554563920e099283440692068a78f5c6a...c66e3029df84f55a31f785a3bd0bb255c8aeadcb,1,17,11,28,12,2014-11-12 17:53:05,2014-11-12 17:53:05
c66e3029df84f55a31f785a3bd0bb255c8aeadcb...64bb0a33081bf684a502c17c9b954911fb04251b,1,1,1,2,1,2014-12-05 21:33:13,2014-12-05 21:33:13
64bb0a33081bf684a502c17c9b954911fb04251b...850c4c05591be4cb45905e9056fe4039b09c8f37,1,1,1,2,1,2014-12-16 00:23:50,2014-12-16 00:23:50
850c4c05591be4cb45905e9056fe4039b09c8f37...fcd75b7fb6dfbf890b99ec119ae175dc7fbc1f52,1,5,0,5,1,2014-12-17 21:21:37,2014-12-17 21:18:37
fcd75b7fb6dfbf890b99ec119ae175dc7fbc1f52...daeb2c32d0fe43ed83408c13e9be910c13e0032f,1,40,28,68,28,2014-12-20 01:34:43,2014-12-20 01:34:43
daeb2c32d0fe43ed83408c13e9be910c13e0032f...418e7e34b7802d7b26dfcf146ffebd8f163bebd0,1,1,1,2,1,2014-12-22 20:21:02,2014-12-22 20:20:47
418e7e34b7802d7b26dfcf146ffebd8f163bebd0...59b5ca6909728cfaa89fcfec7610aa67e9f8e7be,1,44,40,84,38,2014-12-22 20:23:40,2014-12-22 20:23:40
59b5ca6909728cfaa89fcfec7610aa67e9f8e7be...bbbc8e862bc94ad9a294f582457bb361ba7b468a,1,22,14,36,14,2014-12-22 20:26:28,2014-12-22 20:26:28
bbbc8e862bc94ad9a294f582457bb361ba7b468a...6d926d2eee20e6937811591a8fd7f8b1ae3124a3,1,5,5,10,4,2014-12-22 20:27:32,2014-12-22 20:27:32
6d926d2eee20e6937811591a8fd7f8b1ae3124a3...24d2e39cf416c63585b46630f7126dd1e8c41d1d,4,372,362,734,348,2014-12-22 20:52:56,2014-12-22 20:52:56
24d2e39cf416c63585b46630f7126dd1e8c41d1d...63a5f9c112ba2667ba5e23819ac390937e6dba22,4,4,4,8,4,2014-12-22 20:53:56,2014-12-22 20:53:56
63a5f9c112ba2667ba5e23819ac390937e6dba22...7473dc5ac70208d55204790751fdca75bd8b47d1,3,336,245,581,192,2014-12-22 20:58:47,2014-12-22 20:58:47
7473dc5ac70208d55204790751fdca75bd8b47d1...fd964d6b0520fff5a8d25254fec80e0d84d2aaee,14,104,20,124,22,2014-12-22 21:03:54,2014-12-22 21:03:54
fd964d6b0520fff5a8d25254fec80e0d84d2aaee...8fbe58032ff6b6bacdc21a1f5140d028c23e56a5,1,4,26,30,6,2015-01-11 02:25:18,2015-01-11 02:25:18
8fbe58032ff6b6bacdc21a1f5140d028c23e56a5...0d8c85d8f9bce200a00f53aa3701c68a78bdb33d,55,4300,2537,6837,864,2015-01-19 17:10:41,2015-01-19 17:10:41
0d8c85d8f9bce200a00f53aa3701c68a78bdb33d...f67ca4d40669a2031f9ec7b0585f6ff5a12e621c,1,1,1,2,1,2015-01-19 17:22:00,2015-01-19 17:22:00
f67ca4d40669a2031f9ec7b0585f6ff5a12e621c...dc0e9a0379be8203e91dc914f01dfb2bf9db63bf,13,394,394,788,393,2015-02-06 03:40:29,2015-02-06 03:40:29
dc0e9a0379be8203e91dc914f01dfb2bf9db63bf...d940f7cd851b77b16315a25b41424f2e14bcef90,1,25,3,28,3,2015-02-23 06:13:27,2015-02-23 06:13:27
d940f7cd851b77b16315a25b41424f2e14bcef90...cc07218b04464043692e92912e11beb576ad2bee,1,22,18,40,14,2015-03-15 12:35:18,2015-03-15 12:35:17
cc07218b04464043692e92912e11beb576ad2bee...cc95cc75b81c492b7774299111cc1e7bc6d7b27b,50,11172,7159,18331,2092,2015-03-16 15:57:29,2015-03-16 15:57:29
89c5eb44911417a495275c015574b6eb715dd69c...ba6f4f03dacbf6971100fde58046d80340543c2e,7,13,13,26,13,2011-09-19 02:05:21,2011-09-19 02:05:21
ba6f4f03dacbf6971100fde58046d80340543c2e...ac8001190a4dda635a5df72f88e638759511bfd8,3,158,151,309,18,2011-09-19 04:03:52,2011-09-19 04:03:52
ac8001190a4dda635a5df72f88e638759511bfd8...fc6effae51769c5bd7dfe0d1720606dd42c5f6e9,1,2,2,4,2,2011-09-19 04:13:56,2011-09-19 04:13:56
913338f930736a1b186178469c6eafb55c1dbea8...f61fe3c4746ec09ff64756797fe6314be5f53b30,7,229,89,318,28,2011-10-10 04:13:26,2011-10-10 04:13:26
f61fe3c4746ec09ff64756797fe6314be5f53b30...dd1efdf0d5ec2469978a65c845cc5dfd16b74899,2,3,3,6,3,2011-10-10 04:25:28,2011-10-10 04:25:28
913338f930736a1b186178469c6eafb55c1dbea8...a91a407bd60a266f928b5fea70d3c4332394b3c8,6,80,52,132,35,2011-10-05 04:48:53,2011-10-05 04:48:53
a91a407bd60a266f928b5fea70d3c4332394b3c8...c9669be1ec2862b88ffdb296191e82fed79f56a4,2,10,13,23,13,2011-10-05 07:14:55,2011-10-05 07:14:55
7b614cfa01eccfef02d85f2f82e0b13023ce7baa...7da0e5cc0c01ded91544ecc2bca0c171d3176cb5,1,4,4,8,4,2011-09-18 00:35:34,2011-09-18 00:35:34
a95a0ed71c935c61c7c3d045e82df0b1d0cf5725...f556da42fce8005f298b3059108e57ac6f34b364,1,2,2,4,2,2011-09-10 22:30:42,2011-09-10 22:30:42
f556da42fce8005f298b3059108e57ac6f34b364...091402760903ed0f2393c09c315fd91e8b6579fe,1,1,1,2,1,2011-09-10 22:32:06,2011-09-10 22:32:06
a8d447582741486e66a6a073015a9e9bd431af29...23d2fed905c33e1e18c1e8a04bfccbdfe7029cf3,1,1,1,2,1,2011-09-10 23:50:42,2011-09-10 23:50:42
b6ddaf63d67938eb75b1189c680f22946d6f4f54...0886fee10328d5712055c87047b8040d0e64a356,1,6,6,12,4,2013-08-19 22:12:25,2013-08-19 22:12:25
b6ddaf63d67938eb75b1189c680f22946d6f4f54...e8a1df5f060bf7e6631554648e0abde150aedbe4,2,0,2,2,2,2013-08-19 21:18:20,2013-08-19 21:18:20
e8a1df5f060bf7e6631554648e0abde150aedbe4...af75dca908d672d7cc71fcf009b5c0a5f10aad06,1,2,1,3,1,2013-08-19 21:23:07,2013-08-19 21:23:07
06c3d87973207d4e9c4551572a8db0a08e422f37...734b6acf132d339995462b8949ab1d2fc9524cd1,6,24,18,42,17,2013-08-18 03:28:58,2013-08-18 03:28:58
fc6effae51769c5bd7dfe0d1720606dd42c5f6e9...0c6a2acd7e9a6d81eeec4dba99b4bdf33e86c744,1,1,1,2,1,2011-09-20 03:13:51,2011-09-20 03:13:51
fc6effae51769c5bd7dfe0d1720606dd42c5f6e9...9b61f71835f5214015269517ca9825de9064432a,1,1,1,2,1,2011-09-19 18:54:20,2011-09-19 18:54:20
7c98f1e1fccbb9664bddbc64edb626ffdcf8fe7d...8ba005d38dd7a79ea3e90efb6efc7ac9ebcadc26,5,224,195,419,39,2011-10-11 16:44:51,2011-10-11 16:44:51
8ba005d38dd7a79ea3e90efb6efc7ac9ebcadc26...8c2bb99085816617704b5d537b9c901e26e03569,4,9,9,18,5,2011-10-11 16:46:02,2011-10-11 16:46:02
8c2bb99085816617704b5d537b9c901e26e03569...b6443905411dcdcec54d7eaad2f998a582271728,5,20,29,49,18,2011-10-11 16:52:50,2011-10-11 16:52:50
b6443905411dcdcec54d7eaad2f998a582271728...fa8b1dc12dcfe993f1e4185f95ebe0981fbeb0f0,4,144,66,210,66,2011-10-12 02:31:25,2011-10-12 02:31:25
fa8b1dc12dcfe993f1e4185f95ebe0981fbeb0f0...f4fc56b1b3827254dd771536dcb2b711919f3867,5,332,65,397,42,2011-10-12 15:31:16,2011-10-12 15:31:16
f4fc56b1b3827254dd771536dcb2b711919f3867...fbe22f05800a3ce4ae3a880914d8e03cb1e01d1b,4,23,13,36,12,2011-10-16 00:21:39,2011-10-16 00:21:39
fbe22f05800a3ce4ae3a880914d8e03cb1e01d1b...9e9109469e5c86c4232cc744639b286bcd9ef0ba,7,433,481,914,156,2011-10-16 10:00:58,2011-10-16 10:00:58
9e9109469e5c86c4232cc744639b286bcd9ef0ba...be926a04bc7d1fec228b9cbd4c6d0bb0c75c30cd,4,38,41,79,29,2011-10-16 10:08:14,2011-10-16 10:08:14
be926a04bc7d1fec228b9cbd4c6d0bb0c75c30cd...3a4760637f3acca9cbd8af2819d163848852a23a,4,70,74,144,72,2011-10-16 10:15:17,2011-10-16 10:15:17
3a4760637f3acca9cbd8af2819d163848852a23a...d1d38079589f2cda2b28cc9f5a3da86cbfabbf25,1,147,0,147,1,2011-10-16 10:15:36,2011-10-16 10:15:36
d1d38079589f2cda2b28cc9f5a3da86cbfabbf25...6f44a90edbfc897082dd69630983391bf6e57ba7,6,104,53,157,49,2011-10-16 18:35:24,2011-10-16 18:35:24
6f44a90edbfc897082dd69630983391bf6e57ba7...756e7c8739266ec8594d545e7eec2a50ea06ce08,3,56,78,134,11,2011-10-16 19:11:48,2011-10-16 19:11:48
756e7c8739266ec8594d545e7eec2a50ea06ce08...2a82b38cff142ec86a6e1dc4f9366205260d262d,6,117,71,188,38,2011-10-17 01:01:05,2011-10-17 01:01:05
2a82b38cff142ec86a6e1dc4f9366205260d262d...1888511d676ced8f30743cc5b540f02257314bde,3,71,33,104,14,2011-10-17 01:45:11,2011-10-17 01:45:11
1888511d676ced8f30743cc5b540f02257314bde...c62a0239bd30a12e9f0d8c1e45f5818460e9df90,5,117,141,258,25,2011-10-17 02:12:33,2011-10-17 02:12:33
c62a0239bd30a12e9f0d8c1e45f5818460e9df90...e7d2218b2043742f21c368d074d97a4bde275730,8,177,212,389,60,2011-10-17 06:04:31,2011-10-17 06:04:31
e7d2218b2043742f21c368d074d97a4bde275730...6d2e39950d98dafbb82e94f00b3c99b82d0ba1c1,4,42,62,104,28,2011-10-17 07:03:52,2011-10-17 07:03:52
6d2e39950d98dafbb82e94f00b3c99b82d0ba1c1...f48baceeda7dc18e1fdf78f89c55b3de40a3357e,3,2,4,6,4,2011-10-17 19:45:09,2011-10-17 19:45:09
f48baceeda7dc18e1fdf78f89c55b3de40a3357e...d035fa731ab6b846c98b2f2b6f5e82c1b11c6791,1,7,7,14,7,2011-10-17 19:59:03,2011-10-17 19:59:03
d035fa731ab6b846c98b2f2b6f5e82c1b11c6791...27cbe7f63a13fad987dc2547ef5b6f526ceb268c,5,210,171,381,29,2011-10-17 21:17:29,2011-10-17 21:17:29
27cbe7f63a13fad987dc2547ef5b6f526ceb268c...b91d210a3cdb29d022f20646ed61e663ceea18dd,1,178,101,279,17,2011-10-17 21:43:43,2011-10-17 21:43:43
b91d210a3cdb29d022f20646ed61e663ceea18dd...ae5c5e10635049c65d73454ca9486539bdf324d4,2,21,21,42,18,2011-10-18 03:44:52,2011-10-18 03:44:52
ae5c5e10635049c65d73454ca9486539bdf324d4...369b9720c6090985c678076eebb59c080c0ed27c,6,100,5,105,7,2011-10-18 06:45:35,2011-10-18 06:45:35
c9669be1ec2862b88ffdb296191e82fed79f56a4...8545fe97877dc275df40ab98d408f21ce9a362cf,10,138,206,344,27,2011-10-20 04:56:06,2011-10-20 04:56:06
39a16811eb09b1a874d5a68dcd31808edb14a5b5...3eafbe5c8994e884744e4a664be51ab5b6558b80,2,3,3,6,3,2011-09-18 01:25:40,2011-09-18 01:25:40
091402760903ed0f2393c09c315fd91e8b6579fe...00b7dff3595d340be61894a0674800f8ed02b4ab,8,340,282,622,61,2011-09-11 04:05:23,2011-09-11 04:05:23
57a8672b77a219b99215b781740cc9cf5f7fc1a5...9c76070cbddfd02c034cba9e15960906844b76d0,4,48,25,73,19,2011-09-11 01:13:37,2011-09-11 01:13:37
9c76070cbddfd02c034cba9e15960906844b76d0...235246d6fcc7947d04555205a5f8a242eb3f6b97,4,17,45,62,14,2011-09-11 01:26:37,2011-09-11 01:26:37
235246d6fcc7947d04555205a5f8a242eb3f6b97...a71d5d8e991eee4073d3312743778b1991cfb650,6,43,16,59,14,2011-09-11 02:01:16,2011-09-11 02:01:16
af75dca908d672d7cc71fcf009b5c0a5f10aad06...a9d1f901c5006bd1cae8ab9eecd7491250067e87,1,12,12,24,12,2013-08-20 13:07:43,2013-08-20 13:07:43
af75dca908d672d7cc71fcf009b5c0a5f10aad06...db7cce42f2024b65ab57658dc20703f681331d28,1,20,20,40,20,2013-08-20 12:56:10,2013-08-20 12:56:10
af75dca908d672d7cc71fcf009b5c0a5f10aad06...3515964578101a43aba695f66aa4ab7aa129121b,1,1,1,2,1,2013-08-20 10:18:23,2013-08-20 10:18:23
f6c151aa208e7e475701333b180f45e23e6ade1a...d9e38312d24dc947ef479539fe2252f29bd1090d,1,1,1,2,1,2013-08-18 03:11:18,2013-08-18 03:11:18
761b80c39174ad2ee2cc06a248e9654834468be4...9a66906d3dec56d1e44083e8ee005affa71ffecf,1,4,4,8,4,2013-08-18 02:14:13,2013-08-18 02:14:13
01ab4caa5b967470edd11348e012386096d47506...f2e15402c811272552b78fe378aa6d4780706b13,1,4,4,8,4,2011-09-20 21:50:14,2011-09-20 21:50:14
01ab4caa5b967470edd11348e012386096d47506...bc6e4b8ed2b7bc5150f3d03a09aefd8d2da56e90,1,1,1,2,1,2011-09-20 17:09:28,2011-09-20 17:09:28
369b9720c6090985c678076eebb59c080c0ed27c...a5d2450e88693de5e96d9a9f3f4e82853723f764,2,46,40,86,6,2011-10-18 15:11:18,2011-10-18 15:11:18
5ab84f942dadc02db57fbe9dbcc619a5eae3920a...523e02f7df3bb706654b43cf604e61c9396212e1,10,78,57,135,29,2011-10-20 06:12:50,2011-10-20 06:12:50
3eafbe5c8994e884744e4a664be51ab5b6558b80...e16de59260c860af67748a484631ae3de56fc244,3,53,9,62,13,2011-09-18 08:15:24,2011-09-18 08:15:24
3407ed948d8454041f872d26e0c3e7752876147d...6a74a313a8383d43d6fd9f42626e1f620754799b,2,9,6,15,7,2011-09-11 04:10:18,2011-09-11 04:10:18
6a74a313a8383d43d6fd9f42626e1f620754799b...8130b113bb03aa134be3f977d493a3bed9bb1d3d,1,49,39,88,7,2011-09-11 04:50:12,2011-09-11 04:50:12
8130b113bb03aa134be3f977d493a3bed9bb1d3d...536fe2c7437969ec64c14d6d790c5e7c684a6ccc,2,15,3,18,3,2011-09-11 04:54:11,2011-09-11 04:54:11
a71d5d8e991eee4073d3312743778b1991cfb650...64176caa972fdf925fe244cdbf1d53d82da592f4,8,219,62,281,22,2011-09-11 05:14:57,2011-09-11 05:14:57
6fc988613ab8d42d937a7815f5fad3f59d5bde78...bc2e97756fcd00747fdc42ee2d58566a70378907,1,232,200,432,23,2013-08-21 22:12:55,2013-08-21 22:12:55
bc2e97756fcd00747fdc42ee2d58566a70378907...3318a982290817b40b21a6405b85f791180b5129,1,3,0,3,1,2013-08-23 06:18:45,2013-08-23 06:18:45
1a1394dc626a9525f93d9b4d739d0a72c4275238...df56ecbdcb31d1bf30470ab4c58a7a1224c2c8a8,1,1,1,2,1,2013-08-24 03:39:34,2013-08-24 03:39:34
1a1394dc626a9525f93d9b4d739d0a72c4275238...e3f97190965c2800ad94f216683b3abf0119ac52,1,1,0,1,1,2013-08-24 03:09:33,2013-08-24 03:09:33
0759dc4119178954bd86f1c89800cbb027877e1c...3d366038d739ca1ddf460c3c52372365818b9005,1,1,1,2,1,2013-08-21 15:44:54,2013-08-21 15:44:54
3d366038d739ca1ddf460c3c52372365818b9005...68b7998c05582305a746bf76ab895dd2b9842bc2,1,1,1,2,1,2013-08-21 15:46:13,2013-08-21 15:46:13
68b7998c05582305a746bf76ab895dd2b9842bc2...cb2e11ece4334d9e1dd0ecd60c651bbebb0561d2,1,1,1,2,1,2013-08-21 20:06:46,2013-08-21 20:06:46
0759dc4119178954bd86f1c89800cbb027877e1c...d924bca6f6a7184fdaa23476554321e2c7e088a7,1,1,2,3,2,2013-08-20 19:41:41,2013-08-20 19:41:41
d924bca6f6a7184fdaa23476554321e2c7e088a7...6735dc8c16ed337e406cd2554cc2ae261e742d77,1,1,1,2,1,2013-08-20 20:36:22,2013-08-20 20:36:22
6735dc8c16ed337e406cd2554cc2ae261e742d77...63f8c8caabe74159e85aafc1c244837850b8103c,1,3,11,14,3,2013-08-20 20:45:52,2013-08-20 20:45:52
63f8c8caabe74159e85aafc1c244837850b8103c...55088bbff8e43b7ec63c60a30a42a95456b789df,1,1,1,2,1,2013-08-20 21:00:48,2013-08-20 21:00:48
55088bbff8e43b7ec63c60a30a42a95456b789df...295fef252ecfcad784e04e752c6dedb873af4726,1,2,2,4,2,2013-08-20 21:16:31,2013-08-20 21:16:31
295fef252ecfcad784e04e752c6dedb873af4726...7c88db5c42bb692183cd0b31fd61e3789b0995a7,1,1,1,2,1,2013-08-20 21:18:30,2013-08-20 21:18:30
7c88db5c42bb692183cd0b31fd61e3789b0995a7...d666a89621ff85612390b3a0587e687eaae21060,1,1,1,2,1,2013-08-20 23:21:18,2013-08-20 23:21:18
9533a1339f4d841d26da43bc833ed997b56140c9...8d59d8def74ddeec11278a53ce00af1de1b4d4dc,1,2,0,2,2,2013-08-18 04:01:58,2013-08-18 04:01:58
8d59d8def74ddeec11278a53ce00af1de1b4d4dc...811120ffa2044825090ed3d0937fca1cddc7777c,1,4,4,8,4,2013-08-18 04:17:35,2013-08-18 04:17:35
811120ffa2044825090ed3d0937fca1cddc7777c...f891f91bacfa20647eb0a8814b6a993662564b67,3,1255,1259,2514,285,2013-08-18 04:18:00,2013-08-18 04:18:00
d9e38312d24dc947ef479539fe2252f29bd1090d...d713f8341c26b1705a94fd890a92695d271dfb5b,9,48,27,75,17,2013-08-18 03:33:52,2013-08-18 03:33:52
d713f8341c26b1705a94fd890a92695d271dfb5b...b413aff0458a9a2c1afdd6a66b1a58eef62c30b0,1,1,0,1,1,2013-08-18 03:35:31,2013-08-18 03:35:31
b413aff0458a9a2c1afdd6a66b1a58eef62c30b0...5539db523743c177a2ebb7d878343776abf6b7b4,5,80,63,143,21,2013-08-18 04:00:13,2013-08-18 04:00:13
6ec1abc53c6ad45d12d77e7ba610f3047d606004...41983bbe675d1aa293f72dc3d3297f03f100fbaa,3,14,15,29,11,2011-09-22 19:54:57,2011-09-22 19:54:57
6ec1abc53c6ad45d12d77e7ba610f3047d606004...7c637bc51c25827fe6fdb54483785ca57f20d681,1,5,5,10,5,2011-09-21 13:38:08,2011-09-21 13:38:08
80332e8340dfdb9d73caa682016746823b9d0d82...d4675bf4ef8019fc80e3b6816d3597c07cde81df,4,28,6,34,8,2011-10-22 22:49:42,2011-10-22 22:49:42
523e02f7df3bb706654b43cf604e61c9396212e1...2c0a60a777d85c9223abf245be56308b8c62804c,3,20,2,22,6,2011-10-21 16:56:13,2011-10-21 16:56:13
24b05fe94a46a5b21a122a08b967eeb3ee6e6a86...b827303511d68fdb3f913aef63f97b5f77725d68,3,8,8,16,5,2011-09-30 05:21:55,2011-09-30 05:21:55
b827303511d68fdb3f913aef63f97b5f77725d68...a0bf8b67ff4dd827f9298563616ecc519e7924c8,3,33,22,55,7,2011-09-30 06:00:10,2011-09-30 06:00:10
536fe2c7437969ec64c14d6d790c5e7c684a6ccc...40693f261838136499b11c728e5389815e3ee322,4,108,5,113,8,2011-09-11 05:31:43,2011-09-11 05:31:43
c40e0de3c1d837b2754f7717ebdc4a29c5f92cd8...7e5b304dbfd8f5413db0bbe557b8e3d9a81b09c4,7,127,11,138,12,2011-09-11 05:24:31,2011-09-11 05:24:31
7e5b304dbfd8f5413db0bbe557b8e3d9a81b09c4...709789d16dccc9c812b62e8d22c61d7f4748e9e2,1,4,1,5,2,2011-09-11 05:28:17,2011-09-11 05:28:17
495768bbf552c042a06a8b4f90b6058ffebeb970...c4c87fede5581b848abacc5810afa43b31d6f945,1,3,3,6,3,2013-08-23 06:25:26,2013-08-23 06:25:26
c4c87fede5581b848abacc5810afa43b31d6f945...5bbbdb399bbcd6695fedb73ae9f7b3f6a9300c06,3,96,53,149,22,2013-08-23 17:36:37,2013-08-23 17:36:37
5bbbdb399bbcd6695fedb73ae9f7b3f6a9300c06...a0d0864bd709878c721093ea6ab779f33b676917,3,25,9,34,7,2013-08-23 17:44:13,2013-08-23 17:44:13
d666a89621ff85612390b3a0587e687eaae21060...a3a02f9e6e0d1cb76a0214388c40df971f70a037,5,52,48,100,42,2013-08-21 06:25:13,2013-08-21 00:31:02
d666a89621ff85612390b3a0587e687eaae21060...9a4fbde4617da20490381da6dadd02507e67b693,2,13,6,19,2,2013-08-21 00:49:23,2013-08-21 00:49:17
9a4fbde4617da20490381da6dadd02507e67b693...631e200da358a0807b5454fbee8ccab18e5e3c80,1,1,1,2,1,2013-08-21 01:46:20,2013-08-21 01:46:20
631e200da358a0807b5454fbee8ccab18e5e3c80...bbc32f7e7993cd36190e458b47fc333174a9992e,1,16,0,16,1,2013-08-21 01:47:04,2013-08-21 01:47:04
d666a89621ff85612390b3a0587e687eaae21060...924e9e74506464203ef077a3019e46af8a9a2f71,1,1,1,2,1,2013-08-20 23:34:57,2013-08-20 23:34:57
f891f91bacfa20647eb0a8814b6a993662564b67...3e02b0f5d0fd237cf9ccd901b1cfb66cf6f9bcd1,1,1,1,2,1,2013-08-18 05:11:21,2013-08-18 05:11:21
f891f91bacfa20647eb0a8814b6a993662564b67...95732b429fc9b71f14c544586885a449bd5efddc,2,29,7,36,8,2013-08-18 04:50:01,2013-08-18 04:50:01
46958b2b67102ccd599dca377556848795913091...68605bdd51760a929cc661607f06f479c53b0bee,7,7,7,14,7,2011-09-22 20:13:55,2011-09-22 20:13:55
fb7fbdb278cc76c597acb69de5cd3a5d6eb77b00...b4c0d2a6b2fe1bc92c3635cda71b63ee08a05be4,6,40,21,61,19,2011-10-23 05:49:37,2011-10-23 05:49:37
b4c0d2a6b2fe1bc92c3635cda71b63ee08a05be4...e616026d678239104b93cafca9a77ea74a4c0ddf,5,37,24,61,20,2011-10-27 04:04:14,2011-10-27 04:04:14
e616026d678239104b93cafca9a77ea74a4c0ddf...648c4689273647c321dd6e3979d910282e9a9339,8,2426,2108,4534,38,2011-10-27 06:11:56,2011-10-27 06:11:56
648c4689273647c321dd6e3979d910282e9a9339...b4c894961c0b75361ead496f1686eb3cf41c5c97,5,24,54,78,18,2011-10-27 06:24:22,2011-10-27 06:24:22
b4c894961c0b75361ead496f1686eb3cf41c5c97...19feb1b1ff56db21bc36106e3b57943ca490a912,1,1,1,2,1,2011-10-27 06:25:57,2011-10-27 06:25:57
19feb1b1ff56db21bc36106e3b57943ca490a912...20b9390a9e3a94dae86af388821aa8f458ba057f,1,15,0,15,1,2011-10-27 16:35:58,2011-10-27 16:35:58
d2de00f1dfe6cad9272e8176dce055826caed0bb...87d9343a30105466cfd11f34ebebdb6368bd5a18,1,1,1,2,1,2011-09-30 06:09:53,2011-09-30 06:09:53
87d9343a30105466cfd11f34ebebdb6368bd5a18...fb749eee5ef62a41c3e007c738729e9712e08c8c,1,1,1,2,1,2011-09-30 06:12:27,2011-09-30 06:12:27
fb749eee5ef62a41c3e007c738729e9712e08c8c...a0c3250b97bd74a542c6b3dd555197097935e590,1,1,0,1,1,2011-09-30 06:24:34,2011-09-30 06:24:34
3755ee158f947bdb1d44b86faa9537ac9f3cbbc5...d0f7637a7d472dd8431b6b61376515bf852edaf8,4,51,2,53,6,2011-09-11 05:47:38,2011-09-11 05:47:38
709789d16dccc9c812b62e8d22c61d7f4748e9e2...265511774715b8cbe7cbabb9b2a1bf2f27c28c1e,1,7,2,9,2,2011-09-11 05:43:52,2011-09-11 05:43:52
f8de960c388c8235a32e05808e9d0a351d3492bf...acb338766ebe734296e412a9e1c46a5222ac1f13,1,2,0,2,1,2013-08-23 20:46:28,2013-08-23 20:46:28
7edd87dde901b30bb0cef9a2f72ab321c7dfb743...7a7149d2eef386912e497907e1b2322ee98c0234,2,41,22,63,16,2013-08-24 05:00:54,2013-08-24 05:00:54
8a96616726497640f7bc46318e21b10f9e4b356c...d5a27855459325290ace93538f5ceafb22dee27a,1,4,4,8,4,2013-08-24 05:51:39,2013-08-24 05:51:39
310642d5acd3b6c3f80f758c854b12a2de4cdeb6...2b37d2b5333c0b10d5be53865a1a153d5ac4a4b5,5,75,36,111,18,2013-08-23 21:22:51,2013-08-23 21:22:51
2b37d2b5333c0b10d5be53865a1a153d5ac4a4b5...12a70cec888da0c41dba287e7207be10b5504680,2,6,6,12,3,2013-08-23 21:23:13,2013-08-23 21:23:13
12a70cec888da0c41dba287e7207be10b5504680...fab039f29b6f60a0766201256a3439bf4459fdb4,2,1,7,8,2,2013-08-23 21:26:16,2013-08-23 21:26:16
924e9e74506464203ef077a3019e46af8a9a2f71...c76b7a53a416f74ced4ad7124e38a305ac477bb5,1,0,1,1,1,2013-08-21 07:30:12,2013-08-21 07:30:12
924e9e74506464203ef077a3019e46af8a9a2f71...56f1ff6ca7f4bee5f031f82b7b6191f7a7a61f48,1,1,1,2,1,2013-08-21 07:08:56,2013-08-21 00:32:39
924e9e74506464203ef077a3019e46af8a9a2f71...e965ef0df3ca57473276103955e2b0727134f299,1,5,5,10,1,2013-08-21 03:13:03,2013-08-21 03:13:03
e965ef0df3ca57473276103955e2b0727134f299...c8402e6e2a6ecad5ff572be8b43c0d0a6cf0149b,2,2,2,4,2,2013-08-21 03:46:01,2013-08-21 03:46:01
04a73ebe42b8beb9567220fe31cc11057badf40f...0c094efe28b34d9eba5a5690ec83c49de423ae1e,15,90,15,105,30,2013-08-18 06:28:52,2013-08-18 06:28:52
95732b429fc9b71f14c544586885a449bd5efddc...57f587246715f10d6fbce384fe9237936091ec73,4,222,24,246,14,2013-08-18 07:28:52,2013-08-18 07:28:52
68605bdd51760a929cc661607f06f479c53b0bee...1be7e09b97c096e2e6199feee348d483ba4a7d0f,1,1,1,2,1,2011-09-28 21:56:54,2011-09-28 21:56:54
68605bdd51760a929cc661607f06f479c53b0bee...9a2440aafa8902d713ac78c3aa0823ffcd83d70a,1,1,1,2,1,2011-09-28 21:08:26,2011-09-28 21:08:26
68605bdd51760a929cc661607f06f479c53b0bee...d541eceb51bcc4dff8a42124c0b8d5cdee46d705,1,3,1,4,2,2011-09-23 13:46:08,2011-09-23 13:46:08
d541eceb51bcc4dff8a42124c0b8d5cdee46d705...1066ec4a79bc2cbdc3dd428c5e241364ace96594,1,3,1,4,1,2011-09-23 18:38:08,2011-09-23 18:38:08
1066ec4a79bc2cbdc3dd428c5e241364ace96594...616f136371e84913ea934bdfba8a6f241381f8e7,1,1,1,2,1,2011-09-23 21:09:18,2011-09-23 21:09:18
20b9390a9e3a94dae86af388821aa8f458ba057f...f3128d0fa1f1f14104b7c4ffab54f083b99a108e,11,112,10,122,14,2011-10-28 06:00:09,2011-10-28 06:00:09
f3128d0fa1f1f14104b7c4ffab54f083b99a108e...9fd4e459fe829454c811118c64aa32eafd6e8b97,6,18,10,28,15,2011-10-28 06:34:48,2011-10-28 06:34:48
9fd4e459fe829454c811118c64aa32eafd6e8b97...2764cfda6dbda56b4a50561fb8cd2a8be86dc096,4,5,9,14,7,2011-10-29 01:38:06,2011-10-29 01:38:06
2764cfda6dbda56b4a50561fb8cd2a8be86dc096...0218d079ad83ce5f8fd08e9f68b6f661855a27a9,1,18,6,24,3,2011-10-30 01:11:17,2011-10-30 01:11:17
0218d079ad83ce5f8fd08e9f68b6f661855a27a9...3f512adf953da3a3fbbfca18b138fb6659f2b77f,7,78,83,161,18,2011-10-31 03:14:27,2011-10-31 03:14:27
3f512adf953da3a3fbbfca18b138fb6659f2b77f...ba597ef8458de4593b7a0269b0dd794f9ca89818,1,43,2,45,5,2011-10-31 23:32:13,2011-10-31 23:32:13
ba597ef8458de4593b7a0269b0dd794f9ca89818...02bf27592c8eec51795ac806390bc57db501926d,7,350,147,497,73,2011-11-01 02:37:10,2011-11-01 02:37:10
02bf27592c8eec51795ac806390bc57db501926d...27b8e5e4fce71ccc5ebd56230dedd9c2403239eb,1,0,1,1,1,2011-11-01 04:24:57,2011-11-01 04:24:57
20b9390a9e3a94dae86af388821aa8f458ba057f...cb13f010e2dd1eb8f37048b5664ff455b60eba05,1,62,10,72,2,2011-10-28 01:51:49,2011-10-28 01:51:49
7a153ac817f7d0fb7d07bbc852b91b9ec87d4af7...2715a1e09e6106a37170afbaf3a8f2bb8355efa7,1,2,2,4,1,2011-09-30 06:32:10,2011-09-30 06:32:10
2715a1e09e6106a37170afbaf3a8f2bb8355efa7...b2b8a789718d8a2cc3248509a94eee36ead6f504,1,8,2,10,3,2011-09-30 06:38:11,2011-09-30 06:38:11
d0f7637a7d472dd8431b6b61376515bf852edaf8...0c656e29fc77472381d9673d58b53da391c31773,4,32,32,64,18,2011-09-11 05:50:59,2011-09-11 05:50:59
68865002af6423c8c082a68acebe0f987670b591...a5964b07b14f77795925112bf4f94ad78b51d251,1,7,0,7,1,2011-09-11 05:48:39,2011-09-11 05:48:39
7b0d035dd4cea21bcbd01c3d16764a90e9ce009b...c4f1591e70bc7849a533cd7d3f81bd7960ca7448,1,1,1,2,1,2013-08-24 04:45:46,2013-08-24 04:45:46
34db0028757736d924eac6a1b0a25a55b3fbcfcf...3d7294238427f23a9110f9e00aaa4f7a79222a5f,1,2,3,5,2,2013-08-23 18:08:37,2013-08-23 18:08:37
3d7294238427f23a9110f9e00aaa4f7a79222a5f...0f669b6dcb5c47063c43cd6defcf9697874a0fab,1,4,0,4,1,2013-08-23 18:09:01,2013-08-23 18:09:01
0f669b6dcb5c47063c43cd6defcf9697874a0fab...ec7fa0a25488e2887db9666ea8014777a743ac55,1,1,1,2,1,2013-08-23 18:14:54,2013-08-23 18:14:54
7a7149d2eef386912e497907e1b2322ee98c0234...48d929d69edf06fd0b02e05522e0c8efe6b5b77f,6,15,8,23,9,2013-08-24 05:38:51,2013-08-24 05:38:51
7a7149d2eef386912e497907e1b2322ee98c0234...e25ca1e7a9ce7beaf5227b920913ec10a74a300e,2,13,0,13,2,2013-08-24 05:01:42,2013-08-24 05:01:42
e25ca1e7a9ce7beaf5227b920913ec10a74a300e...6de67c0ab60bc94931def838de2e66764d4838ea,3,11,4,15,5,2013-08-24 05:11:41,2013-08-24 05:11:41
6de67c0ab60bc94931def838de2e66764d4838ea...a66ccbc562dbdca983fa65a55bfcbe426bcca3dc,1,11,2,13,2,2013-08-24 05:19:58,2013-08-24 05:19:58
00895977ffca47c724bab9b1b230ba46f848f926...86f28f0380d5fbe365019c4c5f31d42955bbd2af,1,1,1,2,1,2013-08-24 21:47:58,2013-08-24 21:47:58
ae96cfd909b98398bbe888e87e35f3459d122030...9b2ff3713ed31b2a9e297c4891443c385d180d0b,1,4,0,4,1,2013-08-23 23:12:24,2013-08-23 23:12:24
e143c3547241a1f92f54849ffbcb0745f3f8002c...2cb16269070c3e5513722eb18ccc9fa9c3a6a024,3,9,5,14,5,2013-08-21 16:56:36,2013-08-21 16:56:36
e143c3547241a1f92f54849ffbcb0745f3f8002c...27d92f45a58861231a2e33e2a78764d16c7881e2,1,3,1,4,1,2013-08-21 12:08:43,2013-08-21 12:08:43
e143c3547241a1f92f54849ffbcb0745f3f8002c...004f2a2b2fa34dc8a15be811746a262b9c5f7b92,1,1,1,2,1,2013-08-21 11:36:33,2013-08-21 11:36:33
e143c3547241a1f92f54849ffbcb0745f3f8002c...4284fc0a5e9eb25c93e1b7579c23d002967a1b22,3,5,1,6,3,2013-08-21 09:57:48,2013-08-21 09:57:48
e5038a339c69c78e8a4b8de702a6b871c3653c04...8bea86e2efed39af9d7469b20593d639532b84d0,3,17,1,18,3,2013-09-06 16:50:38,2013-09-06 16:50:38
8bea86e2efed39af9d7469b20593d639532b84d0...f80fd0354204e068d89f2eb41480ab1a1a1d08fb,1,0,17,17,1,2013-09-06 16:57:19,2013-09-06 16:57:19
f80fd0354204e068d89f2eb41480ab1a1a1d08fb...d126d8c6f3ffde8c108bfdf2f554facc9ccc516b,1,1,1,2,1,2013-09-06 16:57:25,2013-09-06 16:57:25
09d80fab999c103dccbf56fc75f02d62a08a2fe4...1e0453f825cb7d6e14807b121210a594f242bc35,19,1534,30,1564,24,2013-08-18 07:36:51,2013-08-18 07:36:51
1e0453f825cb7d6e14807b121210a594f242bc35...f2e35bf7027e8274e28e46b41efb93f4c03184eb,5,223,270,493,15,2013-08-18 08:23:45,2013-08-18 08:23:45
f2e35bf7027e8274e28e46b41efb93f4c03184eb...b09fcc019c68b502f2f6809020bd3a8761c1d421,2,0,17,17,2,2013-08-18 08:32:33,2013-08-18 08:32:33
b09fcc019c68b502f2f6809020bd3a8761c1d421...e13ca6d38494e69ed1faeddbb12b469a778ade06,23,703,355,1058,11,2013-08-18 08:46:26,2013-08-18 08:46:26
e13ca6d38494e69ed1faeddbb12b469a778ade06...72a3819f6c1a34f4754ef48ccdb4c00f9d9d77e1,1,0,1,1,1,2013-08-18 08:55:47,2013-08-18 08:55:47
b790bbbafc1ca24f54b1a836601502feda49caad...4246f6a01f6d025962beb8dcc9a035d6e17e5d20,1,1,1,2,1,2013-08-18 16:58:21,2013-08-18 16:58:21
b790bbbafc1ca24f54b1a836601502feda49caad...142ada4219dd3da53a421f65940012cb7be2ab02,1,1,1,2,1,2013-08-18 15:17:07,2013-08-18 15:17:07
b790bbbafc1ca24f54b1a836601502feda49caad...ce410dc36ea50f152f617df6fbd29c3ac4d3a9eb,3,7,3,10,5,2013-08-18 12:13:48,2013-08-18 12:13:48
b790bbbafc1ca24f54b1a836601502feda49caad...d1519400f283fe4c850ce323196c4bc80c9a7604,1,140,0,140,1,2013-08-18 11:19:53,2013-08-18 11:19:53
d1519400f283fe4c850ce323196c4bc80c9a7604...863b03cf38a0126dd4764e862a813b4989776eb0,1,3,0,3,1,2013-08-18 11:20:56,2013-08-18 11:20:56
b790bbbafc1ca24f54b1a836601502feda49caad...e6e8499ab8a87a297b109d8162589d205b009744,3,38,62,100,6,2013-08-18 10:25:23,2013-08-18 10:25:23
fda10a609ce02920141e2b35504750ed9fa31a20...6fb0eb8833d4a16f198915487df6ff8a37584cb9,1,1,1,2,1,2011-10-03 01:12:50,2011-10-03 01:12:50
fda10a609ce02920141e2b35504750ed9fa31a20...a61a624e1d3d708128fc3ef184431d65c700e4e5,3,3,1,4,3,2011-09-30 12:19:56,2011-09-30 12:19:56
ac9073e1e4b118c47f3f6c91bf81840cc9a346f6...31ea00304626ea68b758def41769606d4c049671,4,109,70,179,29,2011-11-01 04:45:46,2011-11-01 04:45:46
31ea00304626ea68b758def41769606d4c049671...f459f826af827735f8bfea2e850dba1151b19efc,1,1,1,2,1,2011-11-01 04:46:45,2011-11-01 04:46:45
b2b8a789718d8a2cc3248509a94eee36ead6f504...f8be7a805264fe35edf233303d5954a74f32f637,1,3,5,8,2,2011-10-03 05:26:26,2011-10-03 05:26:26
62edafa1a4885bc826800acf715630961c699582...1ae603fda05c96a4bc3eed284aa6b5ce7a2a93cd,1,3,4,7,4,2011-09-11 06:05:30,2011-09-11 06:05:30
1ae603fda05c96a4bc3eed284aa6b5ce7a2a93cd...3ad034ea9671ffbc44278085ca3bb30979808278,4,24,7,31,8,2011-09-12 00:36:15,2011-09-12 00:36:15
3ad034ea9671ffbc44278085ca3bb30979808278...18a5ef83eff25130927e5b3a5ffb522752974eb8,1,3,0,3,1,2011-09-12 01:01:29,2011-09-12 01:01:29
18a5ef83eff25130927e5b3a5ffb522752974eb8...f3f60b21a6104be999cb04f6414878fc4dea98cd,4,7,23,30,6,2011-09-12 01:09:01,2011-09-12 01:09:01
f3f60b21a6104be999cb04f6414878fc4dea98cd...53812bc2d82adb1a4a96afb33391a1d59990c4fe,5,269,137,406,52,2011-09-12 01:44:25,2011-09-12 01:44:25
53812bc2d82adb1a4a96afb33391a1d59990c4fe...6bc867ed5c20972801226467feb63e85c9dec060,2,11,17,28,3,2011-09-12 02:53:48,2011-09-12 02:53:48
6bc867ed5c20972801226467feb63e85c9dec060...2674210ff06a9ceaaa98263a2cbe2246fcd21111,4,17,16,33,7,2011-09-12 03:00:45,2011-09-12 03:00:45
b781f6ca598a27b6c4ca776b7be682c5a1b9142f...d9cbcfc20ded5f1cd1af4e304415b3405631f0bc,2,11,18,29,3,2011-09-11 05:54:47,2011-09-11 05:54:47
86f28f0380d5fbe365019c4c5f31d42955bbd2af...e63b6c067593ae79402da990999eea90d82e3a1b,1,1,1,2,1,2013-08-25 04:01:08,2013-08-25 04:01:08
c429fd1a3c2bb3f08c031d37050b2e83186d8b16...e4bf27b223967772eceb1c4256a5fc5bd51565bf,1,1,1,2,1,2013-08-21 20:31:17,2013-08-21 20:31:17
c429fd1a3c2bb3f08c031d37050b2e83186d8b16...22ce6499102c2ab87bbd8a303b5d26531c6e7df2,6,12,12,24,12,2013-08-21 19:26:20,2013-08-21 19:26:20
b7e1103c3264cc441068e5544722266e62c52290...c10238c95f24b42c6caea9052ebd2a85c5650fd5,1,1,1,2,1,2013-09-11 07:54:38,2013-09-11 07:54:38
fc0e7686fba0ea64719ae968585b0e4846ea0c8b...700d7e7b2c31ee9e8ad4b208c9c0fb3f2d4a7237,1,3,7,10,4,2013-08-24 06:58:38,2013-08-24 06:58:38
802e5caf5166d176dccea003a7797a003c28cf83...9733a998e2b4933692cb453e9869c80d1043b6f6,3,19,1,20,3,2013-08-24 07:14:09,2013-08-24 07:14:09
d126d8c6f3ffde8c108bfdf2f554facc9ccc516b...3f158175ce851403f63e5740d7578e803fbf5c05,3,9,3,12,5,2013-09-08 15:04:11,2013-09-08 15:04:11
d126d8c6f3ffde8c108bfdf2f554facc9ccc516b...f9fe6cd05fd3a9c696be8855ebb2cdafba469915,1,1,1,2,1,2013-09-08 13:37:02,2013-09-08 13:37:02
d126d8c6f3ffde8c108bfdf2f554facc9ccc516b...7ee2b6a976a5041a06514805216673ff6331dc54,1,1,1,2,1,2013-09-08 01:49:27,2013-09-08 01:49:27
c7e5fa15e05daa1f39d20374e90ec0fb542ab9ba...fd97c2fce4c86bf64ae3f6afde2e37e124932ea4,1,27,27,54,9,2013-08-18 09:04:39,2013-08-18 09:04:39
fd97c2fce4c86bf64ae3f6afde2e37e124932ea4...6b24297c5beca5adc118d0524c50700928687c1c,3,3,6,9,4,2013-08-18 09:11:57,2013-08-18 09:11:57
a9e741bffc47d683e8588c09afece4cdee27cfd8...73a1a4133c484d0791efff87bc41eac3e2853e42,3,5,7,12,5,2013-08-18 17:08:18,2013-08-18 17:08:18
a5ac0b74987310c0c706437e57834cc160defbb4...6496ffb7d4fc042983882af8dadce39b1d7affac,1,319,128,447,4,2013-08-18 17:26:50,2013-08-18 17:26:50
8ae9736ead38a61e47146f709cd0faa7165117ec...0c9bf6bcce0e30688b78805fd539861cb081414f,1,0,7,7,1,2013-08-18 17:02:32,2013-08-18 17:02:32
0b625d0cb51005fd9b13c993cd7487e0b362d31a...823b063c568dfeaf7779fad92af9c57bfb56ef99,1,3,3,6,3,2011-10-03 06:00:11,2011-10-03 06:00:11
f459f826af827735f8bfea2e850dba1151b19efc...74dc83f211245dfaf06da9a1b2ad94f51f790be2,6,6,0,6,6,2011-11-07 09:22:28,2011-11-07 09:22:28
74dc83f211245dfaf06da9a1b2ad94f51f790be2...0e6cd670ca0619c663c016c08059530b598e15d3,6,6,6,12,6,2011-11-08 19:32:28,2011-11-08 19:32:28
f459f826af827735f8bfea2e850dba1151b19efc...4af6dac20ed17c616fbbee7e68b34a37252565e0,1,1,1,2,1,2011-11-07 07:06:13,2011-11-07 07:06:13
4af6dac20ed17c616fbbee7e68b34a37252565e0...ae5badc9fbe7bd6fc0724ab84926eaabd5eb130e,1,1,2,3,1,2011-11-07 07:09:17,2011-11-07 07:09:17
f459f826af827735f8bfea2e850dba1151b19efc...2534fee7538526e2b4e263258fe62953cf08f159,3,85,2,87,8,2011-11-01 20:56:00,2011-11-01 20:56:00
2534fee7538526e2b4e263258fe62953cf08f159...5a702cc6eece2713ac6f6a2f6cbae1b1dd9c5a69,1,16,2,18,2,2011-11-04 00:14:19,2011-11-04 00:14:19
5a702cc6eece2713ac6f6a2f6cbae1b1dd9c5a69...1fb98bed91977b710ae321443d0819939a1a8cc7,8,190,68,258,33,2011-11-12 08:46:02,2011-11-12 08:46:02
2674210ff06a9ceaaa98263a2cbe2246fcd21111...bd3448cf78c34f2215d7d29dc082119459ccbf92,4,20,16,36,19,2011-09-12 03:17:34,2011-09-12 03:17:34
d9cbcfc20ded5f1cd1af4e304415b3405631f0bc...173be3f1e87a83f8e85bef8ddb979a921ccee9d1,7,366,207,573,64,2011-09-12 03:08:43,2011-09-12 03:08:43
bae17265098ac2fc9a4d947b0e95ff84eb85db24...62fde12c8acc332db77b133bd26e687b8b1eab2e,1,14,10,24,11,2013-08-25 06:05:20,2013-08-25 06:05:20
aea1d8839fdfa6c517bf42719f82b56510a56d0b...31641d3d6d4c7584b9b4d0ecd1de178c18a75b6f,1,1,1,2,1,2013-08-21 22:11:56,2013-08-21 22:11:56
aea1d8839fdfa6c517bf42719f82b56510a56d0b...b32cfa2cf2c0b8bf54aac6bada6109c2cfe3d012,1,7,3,10,4,2013-08-21 22:11:33,2013-08-21 22:11:33
1497c21fe3ea2e0588a7ea75ed7848d41c7ca168...eebbee7c8163928735749d58c96a076967c7fb8d,1,1,1,2,1,2013-09-11 16:18:32,2013-09-11 16:18:32
1497c21fe3ea2e0588a7ea75ed7848d41c7ca168...d8202dd62618d086c3cf334f90ba55379f1fd0b1,1,8,8,16,5,2013-09-11 13:47:13,2013-09-11 13:47:13
1497c21fe3ea2e0588a7ea75ed7848d41c7ca168...b8a33eb1e075d10fbf06546b19034d4217f6bb28,1,1,1,2,1,2013-09-11 08:29:15,2013-09-11 08:29:15
b8a33eb1e075d10fbf06546b19034d4217f6bb28...e2e1c80d1a5f8949f699f2286c3a959353ed4913,1,2,2,4,2,2013-09-11 08:32:08,2013-09-11 08:32:08
e2e1c80d1a5f8949f699f2286c3a959353ed4913...a0653ef018bd588d3c6bfb2468c9f3f6ad29fcde,1,1,1,2,1,2013-09-11 08:33:30,2013-09-11 08:33:30
a0653ef018bd588d3c6bfb2468c9f3f6ad29fcde...d9613268b00093d319a14be121c6bd608b02d176,1,1,1,2,1,2013-09-11 08:35:12,2013-09-11 08:35:12
d9613268b00093d319a14be121c6bd608b02d176...50fcaba24f1836aea26bd928156ec9ab0740bff2,1,1,1,2,1,2013-09-11 08:38:42,2013-09-11 08:38:42
9733a998e2b4933692cb453e9869c80d1043b6f6...ab3e1762d4b20478c83c2eda7a2ff86e8a662020,2,45,29,74,7,2013-08-24 18:46:24,2013-08-24 18:46:24
16279056ae1b3534f8c54b812492ce222dda6c8d...ab3d0a27b3d93eebff3852728f94ddc4fcb35199,4,35,1,36,10,2013-09-16 09:38:26,2013-09-16 09:38:26
16279056ae1b3534f8c54b812492ce222dda6c8d...afb6cf1d01c28bd0a1c6803f727eb7408b70c16e,3,17,17,34,11,2013-09-08 23:58:56,2013-09-08 23:58:56
73a1a4133c484d0791efff87bc41eac3e2853e42...2488f2ae68628b9ec5fb54965605ab81164149d0,1,1,1,2,1,2013-08-18 17:23:42,2013-08-18 17:23:42
7e01ff8a15f9024fdebc3859283ccc1f4c63cec7...d7e3bf722d784b167b665e8bacb749f18ae0d0f4,4,34,10,44,11,2011-10-05 04:24:59,2011-10-05 04:24:59
7e01ff8a15f9024fdebc3859283ccc1f4c63cec7...bdbb1c92aab9e9379341c80b8d1c53cc14ac7198,1,15,12,27,2,2011-10-03 09:05:43,2011-10-03 09:05:43
607795e37a9cefd26ade772ceb8cb792602c6d8c...100954eeda40a5003ed14b41a031b77575afb8cb,2,3,3,6,4,2011-10-05 04:26:29,2011-10-05 04:26:29
100954eeda40a5003ed14b41a031b77575afb8cb...a2c263493a7b6ca1933778feada80bab38c78581,2,27,5,32,8,2011-10-05 05:11:44,2011-10-05 05:11:44
a2c263493a7b6ca1933778feada80bab38c78581...356227ef506a34f0f5b42076bd776474b3830e9c,1,4,8,12,3,2011-10-05 05:56:23,2011-10-05 05:56:23
5cae2220223e2dec689b452398ce4cc27e62fd26...088a9efa4c8cc2a352c786c7db4bf7f13a700f86,3,5,5,10,7,2011-10-04 07:58:12,2011-10-04 07:58:12
088a9efa4c8cc2a352c786c7db4bf7f13a700f86...d74dee5e0f74a09d850696b78840debf8334dcc2,3,4,2,6,4,2011-10-04 08:16:07,2011-10-04 08:16:07
d74dee5e0f74a09d850696b78840debf8334dcc2...9991f3faa1489d8edc517ffadb34e698930a9856,5,59,5,64,8,2011-10-08 06:53:32,2011-10-08 06:53:32
9991f3faa1489d8edc517ffadb34e698930a9856...970c51dd996da0da8e67a4fc8fd899a5ec5af34e,1,31,47,78,2,2011-10-08 06:54:50,2011-10-08 06:54:50
970c51dd996da0da8e67a4fc8fd899a5ec5af34e...e025de9a83a74822c8841142971f14eae2729fc1,3,4,4,8,4,2011-10-08 06:56:14,2011-10-08 06:56:14
e025de9a83a74822c8841142971f14eae2729fc1...7b665affd77c647111b089e4a178b09525a67863,4,98,36,134,24,2011-10-08 07:14:38,2011-10-08 07:14:38
7b665affd77c647111b089e4a178b09525a67863...aa3a8af2d082423e7cede05874b5a56b642ae1b7,3,7,7,14,7,2011-10-08 07:16:21,2011-10-08 07:16:21
aa3a8af2d082423e7cede05874b5a56b642ae1b7...0692530efc51efe73a0e40ced2040df9a68fb6f9,3,7,5,12,6,2011-10-08 07:19:01,2011-10-08 07:19:01
0692530efc51efe73a0e40ced2040df9a68fb6f9...464c2d529579cd3f29ae155bb18398ba136a30c7,4,45,37,82,23,2011-10-08 07:26:57,2011-10-08 07:26:57
464c2d529579cd3f29ae155bb18398ba136a30c7...eddc59c634bf8829c51c0a5846c502bf697cc95e,1,0,1,1,1,2011-10-08 07:27:52,2011-10-08 07:27:52
eddc59c634bf8829c51c0a5846c502bf697cc95e...13cc27a6b4f0ebbe90fcd9d9409d50fd46f6022b,3,6,5,11,5,2011-10-08 16:21:25,2011-10-08 16:21:25
13cc27a6b4f0ebbe90fcd9d9409d50fd46f6022b...8f0671adfb70a7037dfcecf84e584ae38fc89b27,3,8,1,9,4,2011-10-10 03:57:38,2011-10-10 03:57:38
8f0671adfb70a7037dfcecf84e584ae38fc89b27...831f279011fb0abf69a781541e6b7f33459ba26b,4,195,42,237,19,2011-10-10 05:02:40,2011-10-10 05:02:40
831f279011fb0abf69a781541e6b7f33459ba26b...b74776281d46f6745dd75fcc21fdd38fbc7e9f90,4,66,166,232,33,2011-10-10 05:32:19,2011-10-10 05:32:19
b74776281d46f6745dd75fcc21fdd38fbc7e9f90...0c1c23641460e3d08d04d0fefc57d950dc6c1da7,3,29,29,58,20,2011-10-10 05:38:48,2011-10-10 05:38:48
0c1c23641460e3d08d04d0fefc57d950dc6c1da7...a05be0cba38eef0c7507bb05c0988eb9efd70091,3,10,5,15,5,2011-10-10 05:44:45,2011-10-10 05:44:45
a05be0cba38eef0c7507bb05c0988eb9efd70091...770e7647d1372974a7e89d53259ce6b3a6ba8f68,1,33,0,33,3,2011-10-10 05:55:12,2011-10-10 05:55:12
770e7647d1372974a7e89d53259ce6b3a6ba8f68...1b19799d700b56f693fdeaf826edaea7cd030b98,3,25,21,46,25,2011-10-10 06:02:34,2011-10-10 06:02:34
1b19799d700b56f693fdeaf826edaea7cd030b98...b8a4921b5794f11c24100e2701f0df228d607698,3,2,4,6,3,2011-10-11 02:38:24,2011-10-11 02:38:24
b8a4921b5794f11c24100e2701f0df228d607698...12af75eef48a61357a3ab8714fa53b231ebfe40b,4,16,5,21,8,2011-10-12 04:49:37,2011-10-12 04:49:37
12af75eef48a61357a3ab8714fa53b231ebfe40b...e2a0ce2062b52bce362b68b5bd4dc2202ed397a8,5,286,74,360,29,2011-10-12 06:46:42,2011-10-12 06:46:42
e2a0ce2062b52bce362b68b5bd4dc2202ed397a8...740e64a2c93c885fcff1525c887657aa31a8180c,3,18,211,229,4,2011-10-12 06:49:43,2011-10-12 06:49:43
740e64a2c93c885fcff1525c887657aa31a8180c...958e55f6a472ce3912e0bc22900ecbacb82c2820,1,1,1,2,1,2011-10-20 05:22:44,2011-10-20 05:22:44
958e55f6a472ce3912e0bc22900ecbacb82c2820...6ad0559e0f23b668f5458a41a4d6d92df9a1304b,3,2,71,73,6,2011-10-20 05:26:14,2011-10-20 05:26:14
6ad0559e0f23b668f5458a41a4d6d92df9a1304b...35793d98e70e0c3b2c34fa51cca946374e782cce,4,8,42,50,14,2011-10-20 06:11:22,2011-10-20 06:11:22
35793d98e70e0c3b2c34fa51cca946374e782cce...b62475a22ef15b53a8401cfcc093375cb84e7528,5,44,47,91,31,2011-10-20 06:50:41,2011-10-20 06:50:41
b62475a22ef15b53a8401cfcc093375cb84e7528...12d7fc82f32f98d7158768ff53f5a4eeb0c3410f,3,6,6,12,4,2011-10-20 16:13:22,2011-10-20 16:13:22
12d7fc82f32f98d7158768ff53f5a4eeb0c3410f...d28f3d86f60c3af0765029c9f19943827d49da0e,1,12,11,23,3,2011-10-21 07:12:47,2011-10-21 07:12:47
d28f3d86f60c3af0765029c9f19943827d49da0e...41ada302eca8b3ed19159bc411b71aa08b43b50d,2,104,50,154,13,2011-10-21 07:37:01,2011-10-21 07:37:01
a4d6e7e9a38517a7fbe8061008798fc8bac68a96...275da020c275b2eb76ef28a1d210b6e6340e4e6e,1,37,1,38,1,2011-11-16 19:10:27,2011-11-16 19:10:27
cabf993bc6f2f984474503f636b4c4ba6d62912e...a0179322854a9d1e2b9363447c9884e40733d04f,14,1035,831,1866,40,2011-11-17 07:58:36,2011-11-17 07:58:36
a0179322854a9d1e2b9363447c9884e40733d04f...a8e88d14a422c3dfdb79eaf6d6a3a2f1144df150,4,40,38,78,18,2011-11-17 08:06:16,2011-11-17 08:06:16
b7c9a639d6ee6a4811c43dd8b831a640b9b47109...af2223efb1048c9b9dd53f7f2481646d731d0da7,3,4,2,6,4,2011-09-12 03:38:45,2011-09-12 03:38:45
e255b4f51dd690cbdcf75a1a7e93ddc5c07499f2...200f5817ba7eb4c9ccafed3faad45b06ba89dfa7,6,145,79,224,37,2011-09-12 04:03:17,2011-09-12 04:03:17
4c2b15d6f5a00490b0d3e34771550702be669f4f...92bb465ba3a33dd53f61e01aad97abf10e4f7166,1,1,0,1,1,2013-08-26 04:07:43,2013-08-25 19:49:15
4c2b15d6f5a00490b0d3e34771550702be669f4f...8401855f1632ce76ef27b9e92b3393b80c38231d,1,2,2,4,2,2013-08-25 21:58:01,2013-08-25 21:58:01
4c2b15d6f5a00490b0d3e34771550702be669f4f...79efeec874eda0042b4da1520b418005776466c2,1,1,1,2,1,2013-08-25 08:36:53,2013-08-25 08:36:53
d82030f482023732210814c05d34c2b15b47f3ff...adac269f950b6b75056ea8d578c5b3f179b712c7,2,2,1,3,2,2013-08-24 06:32:16,2013-08-24 06:32:06
adac269f950b6b75056ea8d578c5b3f179b712c7...ddd594c6e2a952bfb10f2a8f4aad678e3e15174f,3,20,20,40,11,2013-08-24 06:33:16,2013-08-24 06:33:16
ddd594c6e2a952bfb10f2a8f4aad678e3e15174f...705f7ba2790c4809fe8f04b717830e338d3fae40,1,0,24,24,2,2013-08-24 06:39:11,2013-08-24 06:39:11
1bcf9f126d2ab72b67190e9284bb7e7ce7a94719...ca63686fdaf3869074a3329b49a042d3e1d369fa,1,1,1,2,1,2013-08-22 16:20:56,2013-08-22 16:20:56
1bcf9f126d2ab72b67190e9284bb7e7ce7a94719...c5cfc690ddeb83eccd1fdafd115a3be6e4cc0897,1,27,0,27,1,2013-08-22 11:05:06,2013-08-22 11:05:06
1bcf9f126d2ab72b67190e9284bb7e7ce7a94719...8663b75c4d28bde0992e07b1caa666658bb64004,1,4,0,4,1,2013-08-22 01:54:54,2013-08-22 01:54:54
8663b75c4d28bde0992e07b1caa666658bb64004...31ab249809216291499f28af35826c2a5dfa814e,1,3,3,6,2,2013-08-22 09:30:18,2013-08-22 09:28:54
1bcf9f126d2ab72b67190e9284bb7e7ce7a94719...a40568a1e01b864c8ef813a672abd790bf902a83,3,19,3,22,5,2013-08-21 22:51:24,2013-08-21 22:51:24
24f57bdf41b81fd898db0fc2b946ffd1e7b843ee...4912f960f47c8b0008ca6bcfecb629d4a3ee148a,1,2,2,4,2,2013-08-23 17:18:39,2013-08-23 17:18:39
24f57bdf41b81fd898db0fc2b946ffd1e7b843ee...5d39794287c2a28d9d77ce3ac2b2c0fba0c24dfd,1,4,0,4,1,2013-08-23 16:10:52,2013-08-23 16:10:52
24f57bdf41b81fd898db0fc2b946ffd1e7b843ee...9bdc841accb46e77a7f7347e82d0b19aea5703b6,3,3,1,4,3,2013-08-23 15:55:02,2013-08-23 15:55:02
24f57bdf41b81fd898db0fc2b946ffd1e7b843ee...c52e1b85ab5ae00ba8c33d8db3c2850ea0065f66,1,4,0,4,1,2013-08-23 07:22:54,2013-08-23 07:22:54
24f57bdf41b81fd898db0fc2b946ffd1e7b843ee...343fd1bb1eead86e940e2526db1ef3efe5ec4f78,1,2,1,3,2,2013-08-23 06:53:09,2013-08-23 06:53:09
88ae76536d44433e8b6eb3da2adf102c2dd312f9...5caf7800814b0384297bfd69f83308985f510ebd,1,1,1,2,1,2013-09-12 07:52:33,2013-09-12 07:52:33
74a778a7e66339f71ba84e4855d54a203f1dd52b...c0b00f22fe47447155265a20d746889d92918d99,1,2,1,3,1,2013-08-24 19:30:46,2013-08-24 19:30:46
2eec3f919e7bd7ee847c2631ae9c53515cac1c8f...9a0849d81882a55dcc7a3fbd1148f4c75dbc84d2,1,1,0,1,1,2013-10-21 05:56:29,2013-10-21 05:56:29
afb6cf1d01c28bd0a1c6803f727eb7408b70c16e...fff5e540f5fb29ea3c2de713c0d6b10642c90e75,4,14,11,25,12,2013-09-09 03:03:52,2013-09-09 03:03:52
afb6cf1d01c28bd0a1c6803f727eb7408b70c16e...77549410d52f86c2d42136014f5a2ae21f4cabee,4,133,11,144,11,2013-09-09 01:37:39,2013-09-09 01:37:39
77549410d52f86c2d42136014f5a2ae21f4cabee...f00e6deb92bd64419667f2f85f06be489ced665c,1,4,4,8,4,2013-09-09 02:49:40,2013-09-09 02:49:40
f00e6deb92bd64419667f2f85f06be489ced665c...d42591e6e57ca0c940f0690325d9a8079311e8df,1,1,1,2,1,2013-09-09 02:56:11,2013-09-09 02:56:11
a44bd01628d66b92bee3eaef7e4b4f21b5525de6...27e2c56792bcf7df2c0cb9247d373c90cab7c198,1,2,2,4,2,2013-10-15 03:18:12,2013-10-15 03:10:35
d7eee9bd6ecbe4724ef0f9644edb92a9ede91bee...3c1d951d2948f418ab83a592634a1aa52e34c09b,1,0,0,0,0,2013-08-18 18:00:04,2013-08-18 18:00:04
3c1d951d2948f418ab83a592634a1aa52e34c09b...ef4590dfb461036c915d8fbc5b6fbf3ad7ba9c86,4,144,1,145,7,2013-08-18 18:08:20,2013-08-18 18:08:20
d7eee9bd6ecbe4724ef0f9644edb92a9ede91bee...5e2569f15bec7303a77f48a7dd079de8a8d4fa15,1,1,1,2,1,2013-08-18 17:54:28,2013-08-18 17:54:28
d7eee9bd6ecbe4724ef0f9644edb92a9ede91bee...0989babe5daa14a91b80f6347efa493bc100e28d,2,2,2,4,2,2013-08-18 17:47:40,2013-08-18 17:47:40
b41175f030505a3b649b2dd26970c18fa1c05832...0caa484aebebc68f0bfe5dda20e19c4059769859,1,1,1,2,1,2011-10-04 04:36:51,2011-10-04 04:36:51
0caa484aebebc68f0bfe5dda20e19c4059769859...948c59ddb39af2086efeb5c39b3e6b18e8bcb75f,4,21,14,35,12,2011-10-04 04:43:53,2011-10-04 04:43:53
948c59ddb39af2086efeb5c39b3e6b18e8bcb75f...a968d300b434598e8c1735f08fc7ad5da9d40033,6,154,94,248,60,2011-10-04 05:14:50,2011-10-04 05:14:50
a968d300b434598e8c1735f08fc7ad5da9d40033...c843e202b53502f8e973419bc5ea9c62f87f9c89,4,10,4,14,8,2011-10-04 05:27:15,2011-10-04 05:27:15
c843e202b53502f8e973419bc5ea9c62f87f9c89...1b245ffdf8f4bdc8d5845ae86aa78569dfb03cad,4,45,6,51,12,2011-10-04 05:36:51,2011-10-04 05:36:51
1b245ffdf8f4bdc8d5845ae86aa78569dfb03cad...45c9b489eeaffd61429425c1c6b9b3e723bf0514,3,4,4,8,4,2011-10-04 05:44:35,2011-10-04 05:44:35
45c9b489eeaffd61429425c1c6b9b3e723bf0514...3c31d8a258bf56357aa139f8d900b3faeee333a3,4,4,8,12,8,2011-10-04 06:50:14,2011-10-04 06:50:14
356227ef506a34f0f5b42076bd776474b3830e9c...527521b5028b1ad8dddf5d63f9d2a6222174e75a,1,1,1,2,1,2011-10-07 03:56:45,2011-10-07 03:56:45
527521b5028b1ad8dddf5d63f9d2a6222174e75a...b7d4be584ab43a7bf1f07df97a3197915450a695,1,1,1,2,1,2011-10-07 03:59:34,2011-10-07 03:59:34
b7d4be584ab43a7bf1f07df97a3197915450a695...df773debab6ae36737d211020fe7010fba75319b,1,3,1,4,1,2011-10-07 04:02:02,2011-10-07 04:02:02
41ada302eca8b3ed19159bc411b71aa08b43b50d...5736ba549c89b3885550fb52c92d1eb61a5660c9,5,52,5,57,8,2011-10-27 04:22:05,2011-10-27 04:22:05
5736ba549c89b3885550fb52c92d1eb61a5660c9...646870135baab13b7996ea5fb86c848af7b3e76c,3,4,4,8,4,2011-10-27 04:28:43,2011-10-27 04:28:43
41ada302eca8b3ed19159bc411b71aa08b43b50d...3045ce469234df6c7ba9bd5ac4c566b64d2b1121,1,4,0,4,1,2011-10-27 03:29:34,2011-10-27 03:29:34
b1ce89c24a20d3ce8ae6bdd45dc45206d86bd8ef...5abb4b32004d493ac6bbefcdd1b1f71bdf6e5437,1,3,3,6,3,2011-11-17 08:09:12,2011-11-17 08:09:12
5abb4b32004d493ac6bbefcdd1b1f71bdf6e5437...160970560b819fe3e3a3396f7385ed8cafc43bf9,3,31,26,57,11,2011-11-17 08:37:14,2011-11-17 08:37:14
160970560b819fe3e3a3396f7385ed8cafc43bf9...6418a40675a2354df757e949e2092a246485ff1c,1,1,1,2,1,2011-11-17 08:41:26,2011-11-17 08:41:26
6418a40675a2354df757e949e2092a246485ff1c...ba9fcd8b57ad7974a52aecabac7c90dccda4afcb,3,83,34,117,19,2011-11-17 08:49:51,2011-11-17 08:49:51
ba9fcd8b57ad7974a52aecabac7c90dccda4afcb...159c7a7fdae4a3bd929ee9cc76aaa3b509a969dc,3,20,9,29,11,2011-11-17 08:52:11,2011-11-17 08:52:11
159c7a7fdae4a3bd929ee9cc76aaa3b509a969dc...4e6275d0fe0880d32633a2c139dad8d3e2745bb6,13,105,118,223,157,2011-11-17 09:28:42,2011-11-17 09:28:42
af2223efb1048c9b9dd53f7f2481646d731d0da7...96e59eed20c24593208c8a216c13e6409fae7d9d,4,6,10,16,8,2011-09-12 03:46:40,2011-09-12 03:46:40
96e59eed20c24593208c8a216c13e6409fae7d9d...c876835a029f4137dcd64cec8a445d47bc0cf00f,2,2,1,3,2,2011-09-12 03:47:35,2011-09-12 03:47:35
c876835a029f4137dcd64cec8a445d47bc0cf00f...b77e3e2f304bfe0cf99a72a627095c5aa8046978,5,20,5,25,7,2011-09-12 04:12:55,2011-09-12 04:12:55
d977c9902d346862879f6b1c5cc4f8385ed27645...8f83a6010a05e673c3e0dcfbd97e8b8ddc3d9135,1,0,7,7,1,2013-08-26 16:42:03,2013-08-26 16:42:03
19c0d2ad94b81d0ef16b91f76cb6830ec99144c2...2f2ce15e587868cfbde2906560dae8def0b4880d,2,49,14,63,15,2013-08-27 15:34:17,2013-08-27 15:34:17
0c0400633aaa3591254630bf120bf477cee4381d...f7d6b488e6f5b2b82914c9afe1f04b4c4e5b8f11,1,1,1,2,1,2013-08-22 19:30:32,2013-08-22 19:30:32
f7d6b488e6f5b2b82914c9afe1f04b4c4e5b8f11...99b35150ee12d7a693de5ce45eded2f62e9e8354,1,1,1,2,1,2013-08-22 23:51:57,2013-08-22 23:51:57
0c0400633aaa3591254630bf120bf477cee4381d...354e2ee4f90d8a561ac7c04f35249ca30fdd1e50,1,8,0,8,2,2013-08-22 19:28:00,2013-08-22 19:26:04
0c0400633aaa3591254630bf120bf477cee4381d...f140084f2beb17b0a266b42ab9a03d0b935e5f66,12,12,12,24,12,2013-08-22 18:50:15,2013-08-22 18:50:15
d9e991fefed8a59ff50a326aa11526405d946e37...54dcb4b6996ab4bb880edd84b84c9c0a7d41953f,1,1,1,2,1,2013-08-24 07:41:12,2013-08-24 07:41:12
37933a9e08e24e0683c3909aaabe79888e006ba6...6519303549732d61de9e2905916f64a7d5b76910,5,38,26,64,12,2013-09-11 23:06:43,2013-09-11 21:46:31
37933a9e08e24e0683c3909aaabe79888e006ba6...6e064894db4a67ed2c1180212426a076a494d300,3,1,5,6,3,2013-09-11 21:56:02,2013-09-11 21:56:02
6e064894db4a67ed2c1180212426a076a494d300...fddcadbc21cf35fb584ab02dc0817612da6596a4,1,1,1,2,1,2013-09-11 23:35:00,2013-09-11 23:35:00
37933a9e08e24e0683c3909aaabe79888e006ba6...2dc7ab4bbb70abfcdb0aa179935c72ddbb3e66e5,5,38,26,64,12,2013-09-11 21:46:31,2013-09-11 21:46:31
129b85b70d5858e26ae6b5864ba5c9e45fb6e302...3c6229c4358c48c3cb3de7f9bdc2e9ecd72a5488,1,6,0,6,6,2013-09-12 11:46:03,2013-09-12 11:46:03
129b85b70d5858e26ae6b5864ba5c9e45fb6e302...869238c071a94c128afbcb1e6f9622a9b6f9e563,1,1,1,2,1,2013-09-12 08:15:38,2013-09-12 08:15:38
869238c071a94c128afbcb1e6f9622a9b6f9e563...9a21fdaf6daa315d5ec22ad81f7bd0fba8c549a0,1,1,1,2,1,2013-09-12 16:35:33,2013-09-12 16:35:33
c0b00f22fe47447155265a20d746889d92918d99...5491d53b99c3dfa54622ca0d0bba52206c883a14,3,16,13,29,10,2013-08-24 21:00:52,2013-08-24 21:00:52
c0b00f22fe47447155265a20d746889d92918d99...4c794aaaef1de961c764294f554b12ce861c8595,2,5,1,6,2,2013-08-24 20:59:03,2013-08-24 20:59:03
4c794aaaef1de961c764294f554b12ce861c8595...7c8d9551cc01536df505266218746655dc6a5a64,2,27,1,28,3,2013-08-24 21:40:24,2013-08-24 21:40:24
c0b00f22fe47447155265a20d746889d92918d99...0add7700adc3ccdef68b7a88ec3537b5e523bf9a,3,9,9,18,7,2013-08-24 20:29:35,2013-08-24 15:16:08
0add7700adc3ccdef68b7a88ec3537b5e523bf9a...dd9c15273c4aceeada22754ee9a0af2aae7eb8ea,12,30,30,60,30,2013-08-24 20:31:15,2013-08-24 15:32:23
fff5e540f5fb29ea3c2de713c0d6b10642c90e75...c8c3bf00b6f7e8f765ae9c51eb0d8b4498c34d02,1,7,11,18,3,2013-09-09 20:56:10,2013-09-09 20:56:10
c8c3bf00b6f7e8f765ae9c51eb0d8b4498c34d02...022e40404c283bc6f211cf3e5d55ef7a7d204cdb,4,0,3,3,1,2013-09-11 04:46:12,2013-09-11 04:46:12
022e40404c283bc6f211cf3e5d55ef7a7d204cdb...5d1707a25c0ee68644a182196439a86be1beafbd,3,1,10,11,3,2013-09-11 18:09:50,2013-09-11 18:09:50
fff5e540f5fb29ea3c2de713c0d6b10642c90e75...6bc1a5cf6e6103552d900a00a81efab375123b0e,1,14,0,14,2,2013-09-09 19:34:53,2013-09-09 19:34:53
fff5e540f5fb29ea3c2de713c0d6b10642c90e75...3d97454c09acf9636ff315f4ea601aa1fb340f1c,1,2,2,4,1,2013-09-09 10:36:56,2013-09-09 10:36:56
632e3c42d591d9cf32e6cff16905d6a18792f85b...674e83aa01c49d59c56677ae42ff4af3427357aa,1,6,6,12,4,2013-09-09 15:34:21,2013-09-09 15:34:21
674e83aa01c49d59c56677ae42ff4af3427357aa...ea99a0a6f178b467962d9f626c71207f1cbc8d2d,1,1,1,2,1,2013-09-09 16:51:38,2013-09-09 16:51:38
ea99a0a6f178b467962d9f626c71207f1cbc8d2d...fb9c81f8941b94b41eb815e879f045f989b5d14c,1,1,1,2,1,2013-09-09 17:19:53,2013-09-09 17:19:53
fb9c81f8941b94b41eb815e879f045f989b5d14c...c69092a17696b4a0ab6927d695f2fb56d65f498e,4,85,0,85,4,2013-09-11 19:30:46,2013-09-11 19:30:46
c69092a17696b4a0ab6927d695f2fb56d65f498e...25607c268337c6505f633309e2765cf328a6896b,3,27,3,30,5,2013-10-14 06:19:11,2013-10-14 06:19:11
67829c65713d0be72a7a893783f6d929d45e82bb...a28d9539c76e4ba4b3dba3df6137a8400840974d,1,1,1,2,1,2013-10-15 03:45:43,2013-10-15 03:45:43
a28d9539c76e4ba4b3dba3df6137a8400840974d...b05a287eb6d9cebe8590667ef260dd8ec70d5717,5,6,6,12,5,2013-10-15 03:47:56,2013-10-15 03:47:56
b5ac1b065ebd8ac5d67a11edcc0428abfef6a4a5...26067d3d7d4e16f2b46b5bde59566f5db3c4f2d7,3,3,3,6,3,2013-08-18 18:11:31,2013-08-18 18:11:31
26067d3d7d4e16f2b46b5bde59566f5db3c4f2d7...776fb435c54c016966f2125115d832797868d777,2,11,4,15,5,2013-08-18 18:13:56,2013-08-18 18:13:56
776fb435c54c016966f2125115d832797868d777...9b66e6b0f4e642609e8b7ba2b8590d2c31fe0469,3,8,1,9,3,2013-08-18 18:17:28,2013-08-18 18:17:28
40a1bcea7d16820adb8f12197f34438a11eff7d9...0cbffb3bcbc60582e90711e0b5ac36e2df51f7d8,1,0,0,0,0,2013-08-18 18:00:27,2013-08-18 18:00:27
c85e93cd9045ee00c29130bcb6d75d78d033ef5d...12cb0822e856c46805c7d25652e1d273ce591fc1,2,2,2,4,2,2011-10-10 19:32:59,2011-10-10 19:32:59
646870135baab13b7996ea5fb86c848af7b3e76c...15e0068979f7fdc75592de346e265398988ba5b5,3,4,9,13,6,2011-10-28 06:45:48,2011-10-28 06:45:48
15e0068979f7fdc75592de346e265398988ba5b5...61937a803b96748377dd49d50439d96d68a9e40c,2,7,1,8,2,2011-10-29 01:57:37,2011-10-29 01:57:37
3045ce469234df6c7ba9bd5ac4c566b64d2b1121...c9b7118a47c4b8cd6a9ede4ff093d37366586c41,1,2,1,3,1,2011-10-27 14:36:28,2011-10-27 14:36:28
4e6275d0fe0880d32633a2c139dad8d3e2745bb6...ecc9764c831078a186fed69c3ae0af2f7c9ee495,1,4,68,72,4,2011-11-27 08:44:30,2011-11-27 08:44:30
ecc9764c831078a186fed69c3ae0af2f7c9ee495...b36df463108e2e4df8c389a06f577823564788d9,7,428,460,888,273,2011-11-30 06:35:03,2011-11-30 06:35:03
4e6275d0fe0880d32633a2c139dad8d3e2745bb6...0b1d5d9189ea82cde5e848e5a8771a8f4850e21f,9,543,304,847,288,2011-11-21 02:19:50,2011-11-21 02:19:50
0b1d5d9189ea82cde5e848e5a8771a8f4850e21f...bc65b58551575c9dfb2e4d9f4f7af97009e39432,15,281,350,631,98,2011-11-21 04:58:04,2011-11-21 04:58:04
bc65b58551575c9dfb2e4d9f4f7af97009e39432...8a891f2a7b9720845932c0be8853fc25c6e49eed,1,4,3,7,1,2011-11-21 05:06:32,2011-11-21 05:06:32
8a891f2a7b9720845932c0be8853fc25c6e49eed...47c7f655ac455cf76a4865f129a523a91486d3ad,2,2,2,4,2,2011-11-21 05:13:28,2011-11-21 05:13:28
47c7f655ac455cf76a4865f129a523a91486d3ad...36a7eb3851855b608266f301a63b561ac316bca9,3,27,3,30,4,2011-11-21 05:36:26,2011-11-21 05:36:26
36a7eb3851855b608266f301a63b561ac316bca9...b2650859d6c6dcb0665311b6e983d230fee1111f,5,136,15,151,15,2011-11-24 22:43:26,2011-11-24 22:43:26
b2650859d6c6dcb0665311b6e983d230fee1111f...71654cbf69333c3cf6f0bb373121640c6f061d68,7,201,45,246,24,2011-11-25 02:55:44,2011-11-25 02:55:44
71654cbf69333c3cf6f0bb373121640c6f061d68...69372701cfe58876623c89a0bdeca5ce91dd839b,4,65,89,154,24,2011-11-25 03:40:25,2011-11-25 03:40:25
69372701cfe58876623c89a0bdeca5ce91dd839b...1fa02fbda2bb3710a9f26a487da2c34565e8c406,2,44,69,113,25,2011-11-25 04:04:07,2011-11-25 04:04:07
1fa02fbda2bb3710a9f26a487da2c34565e8c406...b14f551c9c1498247dc69251f8eebfde3b1002f6,1,3,1,4,2,2011-11-25 04:12:13,2011-11-25 04:12:13
b14f551c9c1498247dc69251f8eebfde3b1002f6...53ff2682cd95dd96fc1fbf234d7b0530127a464b,2,29,7,36,6,2011-11-25 04:27:18,2011-11-25 04:27:18
53ff2682cd95dd96fc1fbf234d7b0530127a464b...96adf8f91811a71bf2fbd6737c8bd80fe400b8c2,1,1,1,2,1,2011-11-25 04:27:55,2011-11-25 04:27:55
96adf8f91811a71bf2fbd6737c8bd80fe400b8c2...98fddaa3557b1c872f1e585d579ec7e5e989e95d,6,321,30,351,27,2011-11-26 01:23:14,2011-11-26 01:23:14
98fddaa3557b1c872f1e585d579ec7e5e989e95d...bd8745a98b93fb55e4c1c08a34e97bd30a16798c,2,4,4,8,5,2011-11-26 01:30:52,2011-11-26 01:30:52
bd8745a98b93fb55e4c1c08a34e97bd30a16798c...3157de8d1d4b69c0f5152b4a784bd185f76c9ac4,13,44,130,174,30,2011-11-26 05:34:55,2011-11-26 05:34:55
3157de8d1d4b69c0f5152b4a784bd185f76c9ac4...3925ea9986e70f5a87883563c47c8ecd3d631c02,7,7,7,14,7,2011-11-28 00:01:26,2011-11-28 00:01:26
3925ea9986e70f5a87883563c47c8ecd3d631c02...46fe38386afce7149810b1feb534726735ce28b2,8,161,124,285,31,2011-11-28 01:04:55,2011-11-28 01:04:55
46fe38386afce7149810b1feb534726735ce28b2...7f74f11262d9e6430f84a1c0861084b9d33a4053,1,1,1,2,1,2011-11-28 01:09:31,2011-11-28 01:09:31
7f74f11262d9e6430f84a1c0861084b9d33a4053...76f95f4ea2e4e0651e3fc6e3bf0e6872f1cd1b38,1,0,1,1,1,2011-11-28 01:11:31,2011-11-28 01:11:31
76f95f4ea2e4e0651e3fc6e3bf0e6872f1cd1b38...f77d0c21df60e2e9c1c4b4d6a1b79e54f18914aa,1,3,3,6,1,2011-11-28 01:12:17,2011-11-28 01:12:17
f77d0c21df60e2e9c1c4b4d6a1b79e54f18914aa...7522517b47521da731bf7a598d5e5a71721c4c44,1,3,3,6,1,2011-11-28 01:12:58,2011-11-28 01:12:58
7522517b47521da731bf7a598d5e5a71721c4c44...7eb340ec589acd56ad960a020969822636c2bc54,4,21,15,36,14,2011-11-28 01:31:12,2011-11-28 01:31:12
0afba3867d8d52178faa43434b94e2e9a1b1c5bd...dcf9aabc44d4ca7cd544b726d4eee15ef1cd35a5,4,46,38,84,33,2011-09-12 05:58:51,2011-09-12 05:58:51
dcf9aabc44d4ca7cd544b726d4eee15ef1cd35a5...02d668fd2e31b01e330400738bf2fa7bcbfaa822,2,8,8,16,8,2011-09-12 06:29:34,2011-09-12 06:29:34
02d668fd2e31b01e330400738bf2fa7bcbfaa822...fcf816a23644e9d077986a8c35e1487becb6ddc0,3,2,8,10,3,2011-09-12 06:36:59,2011-09-12 06:36:59
fcf816a23644e9d077986a8c35e1487becb6ddc0...44e2c7366896ac01e129f76fd2155d1a29f90ca8,2,9,9,18,9,2011-09-12 06:48:43,2011-09-12 06:48:43
44e2c7366896ac01e129f76fd2155d1a29f90ca8...cc05bce59723c227334d0cf0c168f541971db771,1,1,1,2,1,2011-09-12 06:56:44,2011-09-12 06:56:44
cc05bce59723c227334d0cf0c168f541971db771...89465f8ce1065f907180cfffa3eac317b7c9774d,1,7,15,22,7,2011-09-12 07:03:24,2011-09-12 07:03:24
0afba3867d8d52178faa43434b94e2e9a1b1c5bd...c73533ac73c5bed6f35576e8db2945ec11acb11c,3,13,13,26,11,2011-09-12 04:43:23,2011-09-12 04:43:23
c73533ac73c5bed6f35576e8db2945ec11acb11c...88f2f848b31f09dff025ee4270098a7c8f026000,4,6,6,12,9,2011-09-12 05:02:26,2011-09-12 05:02:26
8f83a6010a05e673c3e0dcfbd97e8b8ddc3d9135...4d23aa4ef50ac16fec9fbc12832ad99f362ac703,6,73,13,86,18,2013-08-27 00:37:52,2013-08-27 00:37:52
4d23aa4ef50ac16fec9fbc12832ad99f362ac703...dd9980e8c94eed0af65fbc60129aa315f24d13a4,1,4,4,8,4,2013-08-27 00:47:56,2013-08-27 00:47:56
dd9980e8c94eed0af65fbc60129aa315f24d13a4...7796e645c98fe527261d85ad2fec01720e3fe455,3,3,1,4,3,2013-08-27 00:48:32,2013-08-27 00:48:32
7796e645c98fe527261d85ad2fec01720e3fe455...4ad2ecf9757ba45fe41a05fb28a84e7dab5dc39f,2,30,1,31,2,2013-08-27 00:58:15,2013-08-27 00:58:15
4ad2ecf9757ba45fe41a05fb28a84e7dab5dc39f...2970653bdc745d2caab512bf32e51d6a29e51cc2,1,3,7,10,2,2013-08-27 01:19:31,2013-08-27 01:19:31
8f83a6010a05e673c3e0dcfbd97e8b8ddc3d9135...0adb4e35f0d773caa6cff65a6f760001089c5ffb,1,13,3,16,4,2013-08-26 18:57:47,2013-08-26 18:57:47
2f2ce15e587868cfbde2906560dae8def0b4880d...1786aed71dae025a351af3a5b2a715af658f6a27,1,4,4,8,4,2013-08-27 16:11:33,2013-08-27 16:05:18
2f2ce15e587868cfbde2906560dae8def0b4880d...c84374f9def122c31860260ddeb3049a27da6c2c,1,1,1,2,1,2013-08-27 15:53:48,2013-08-27 15:53:48
c84374f9def122c31860260ddeb3049a27da6c2c...4f28fdd22787c2ff96d69d037760db0b7b40648d,1,24,4,28,5,2013-08-27 16:10:06,2013-08-27 16:10:06
f1b0cd491c4e3a0a564d92e145c1ecf55105557f...89d489dfc701273b1898b69bde04cf5eb58b9f85,3,15,15,30,14,2013-11-06 00:58:18,2013-11-06 00:58:18
d88e743b417c3e149c9fcb02c8d5580afb8baee0...306d850d3a710fd2124b05b8ff23b7f498f3eaae,1,1,0,1,1,2013-09-12 03:08:59,2013-09-12 03:08:59
d88e743b417c3e149c9fcb02c8d5580afb8baee0...a1b0311597fdf79965044e6cb17c1c1acf08b1b6,2,2,2,4,2,2013-09-12 02:53:32,2013-09-12 02:53:32
d88e743b417c3e149c9fcb02c8d5580afb8baee0...a1cdbbe55e7c099b4ca93911cc8e6bf8311157df,1,1,1,2,1,2013-09-11 23:59:51,2013-09-11 23:59:51
a1cdbbe55e7c099b4ca93911cc8e6bf8311157df...ba818bc4e3548c74f62d0217df0865d4c4bb5a72,2,0,2,2,2,2013-09-12 04:12:58,2013-09-12 04:12:58
ba818bc4e3548c74f62d0217df0865d4c4bb5a72...291a23aa4fc62e7593d4471af2b438aa1017a86a,4,541,274,815,202,2013-09-12 04:14:10,2013-09-12 04:14:10
370130669c044d077226c9c0ce701fec5fd37dab...4f20a29c329aa58919919426cbd2190fabfdb723,1,1,6,7,3,2013-09-12 18:29:26,2013-09-12 18:29:26
33a1852336b720c94b2e59ac6d8bbce75acf6e94...03b1aed37b1607a6dccb19d5953cdc7f97cf892c,1,1,1,2,1,2013-09-13 15:54:48,2013-09-13 15:54:48
eef9d5ae7b21bebc34d7731aea8a41027299c54e...ee9be1a30fce8d00f6fe5fb4d23a290790aae5f6,3,32,32,64,32,2013-10-21 06:29:23,2013-10-21 06:29:23
ee9be1a30fce8d00f6fe5fb4d23a290790aae5f6...eed53d781188914c8328fb0ab77b700c3462fdbf,3,3,3,6,3,2013-10-21 08:53:41,2013-10-21 08:53:41
cd98b10ea5c0074a8f1a2ae3e54107d19141a9d4...10a9601560d6fd1c396b2abd8a4fe4a4a9b04a32,1,1,1,2,1,2013-09-10 16:00:58,2013-09-10 16:00:58
202f395b2f6a93b5a0b12e12822f949a2114741c...1f5c754d576f9534da2cc2176bf2193d31ed6937,2,0,75,75,2,2013-10-14 18:05:49,2013-10-14 18:05:49
b05a287eb6d9cebe8590667ef260dd8ec70d5717...dd5c8a53eec70ea84bc89235e2a4cd0439034219,3,25,1,26,3,2013-10-15 20:06:27,2013-08-21 14:47:22
b05a287eb6d9cebe8590667ef260dd8ec70d5717...042363561415939fb046092705c9624fd8008177,1,1,1,2,1,2013-10-15 15:35:11,2013-10-15 15:35:11
b05a287eb6d9cebe8590667ef260dd8ec70d5717...dc495fe9d94f693591dd0c4023c4ac8b7d96e2ec,1,0,14,14,4,2013-10-15 05:08:23,2013-10-15 05:08:23
dc495fe9d94f693591dd0c4023c4ac8b7d96e2ec...acd4a0a1403bb4675fc492d8fed45f512878243a,1,14,9,23,5,2013-10-15 21:11:21,2013-10-15 21:11:21
b05a287eb6d9cebe8590667ef260dd8ec70d5717...21fad338584aa08c6c1dab6b9be3198b684ebd75,1,17,13,30,5,2013-10-15 04:20:17,2013-10-03 17:52:30
21fad338584aa08c6c1dab6b9be3198b684ebd75...96a19c18fbef89a4f4ae261ae78e7fc26e9d2dd8,2,5,1,6,2,2013-10-17 21:47:27,2013-10-17 21:47:27
9b66e6b0f4e642609e8b7ba2b8590d2c31fe0469...9b61b7a72219888ff662186dbe552150497715f9,3,3,3,6,3,2013-08-18 22:10:28,2013-08-18 22:10:28
9b66e6b0f4e642609e8b7ba2b8590d2c31fe0469...abca00870f862d024a943b2c563bd42ff3f8418f,7,316,236,552,63,2013-08-18 21:05:56,2013-08-18 21:05:56
abca00870f862d024a943b2c563bd42ff3f8418f...546b2cc614ed57f1068eb455b592d6966d49d2d3,5,42,42,84,29,2013-08-18 21:30:40,2013-08-18 21:30:40
546b2cc614ed57f1068eb455b592d6966d49d2d3...ef68cf8ebdabccfa4bb9126acdc79f0510b04537,5,5,5,10,5,2013-08-18 22:35:40,2013-08-18 22:35:40
9b66e6b0f4e642609e8b7ba2b8590d2c31fe0469...d721c61d996d1eda9f6ace1163f38da8bce492b8,1,1,1,2,1,2013-08-18 19:06:56,2013-08-18 19:06:56
9b66e6b0f4e642609e8b7ba2b8590d2c31fe0469...0665b67760c112d70688b7d958c54a7f0d1e6315,5,0,0,0,0,2013-08-18 18:50:33,2013-08-18 18:50:33
70b1a6b56213bf9317c62784cd1a45c1c7290bb5...7002a01978190c2a272022463f10235b7f58699a,1,3,3,6,3,2011-10-21 19:00:39,2011-10-21 19:00:39
61937a803b96748377dd49d50439d96d68a9e40c...98007b8394a5cf892694000d066a07a32f8c517f,4,6,4,10,6,2011-11-01 06:18:36,2011-11-01 06:18:36
f4ba1908217fc91d9e916aecf2d775d638cc2c6f...602919aae83a0f6d12a2c3dcdcdb8c3f1579b647,3,18,13,31,9,2011-11-01 06:27:20,2011-11-01 06:27:20
7eb340ec589acd56ad960a020969822636c2bc54...dc628c9115b74e49940c0cc200a8914232c9d2a2,2,60,1,61,2,2011-12-01 06:05:09,2011-12-01 06:05:09
7eb340ec589acd56ad960a020969822636c2bc54...1af3596a5e09575d9f1c08e6bd69789baecef90f,2,10,10,20,9,2011-11-28 06:13:54,2011-11-28 06:13:54
89465f8ce1065f907180cfffa3eac317b7c9774d...1645b57efe01d7f2ebc5d28d527a00f1222d0070,1,7,3,10,1,2011-09-12 18:14:09,2011-09-12 18:14:09
6a5fb52bb1987913efc5b1b915d91ee18801fa66...72ce695cfdac130b998a21b42490aad53a91ef8b,1,3,3,6,3,2011-09-12 16:24:54,2011-09-12 16:24:54
2970653bdc745d2caab512bf32e51d6a29e51cc2...1445e09b5fcd8112e9753aa47c6df9c558782dd5,1,19,1,20,3,2013-08-27 15:05:26,2013-08-27 15:05:26
2970653bdc745d2caab512bf32e51d6a29e51cc2...c02f98a7bf99d3326b122111ff65591c11021762,1,1,1,2,1,2013-08-27 06:41:50,2013-08-27 06:41:50
c25fa0661aa974019664e21517d2122dccf70095...3161acd710029b57080d879738b13c91475149d8,3,15,5,20,7,2013-12-26 04:04:49,2013-12-26 04:04:49
3161acd710029b57080d879738b13c91475149d8...fc7049b18f52823e29d0eb9d30c32801113a1509,4,4,4,8,4,2013-12-26 04:33:05,2013-12-26 04:33:05
32c03994ee217ee4501146eeb555954d0ba86e9e...b3a23fa33a261295ed69adc9fbc75b70bf354962,1,2,2,4,2,2013-08-27 18:15:14,2013-08-27 18:15:14
b3a23fa33a261295ed69adc9fbc75b70bf354962...73f10843a487ee94bed755ecfd7c853cb657bf38,1,1,1,2,1,2013-08-27 18:18:10,2013-08-27 18:18:10
4f28fdd22787c2ff96d69d037760db0b7b40648d...58408b02329b620e4cd0c206bd9b4f5100f77a72,1,2,1,3,1,2013-08-27 16:21:09,2013-08-27 16:21:09
375b9edb419a0615bb70b399eea0b81f2f0ef48f...c84d96ac1fa6af162fdb069eec9cf5a426692677,1,2,2,4,2,2013-11-06 18:30:39,2013-11-06 18:30:39
c84d96ac1fa6af162fdb069eec9cf5a426692677...6a4230556532d3d947a84aa0d07f57e40a68a9ff,19,19,19,38,19,2013-11-06 20:57:28,2013-11-06 20:57:28
6a4230556532d3d947a84aa0d07f57e40a68a9ff...d1048a78371862c295613f484a06dacfb275d916,2,13,13,26,13,2013-11-06 21:02:15,2013-11-06 21:02:15
d1048a78371862c295613f484a06dacfb275d916...88a06640ddc6bba4f05b41666f53c5daeb00fac8,3,42,3,45,15,2013-11-06 21:03:08,2013-11-06 21:03:08
88a06640ddc6bba4f05b41666f53c5daeb00fac8...98acdaeb0070ed70bf4cdc3780a887ee47c9890b,2,7,7,14,4,2013-11-06 21:09:35,2013-11-06 21:09:35
98acdaeb0070ed70bf4cdc3780a887ee47c9890b...eaff6bc49ae12dd1fd0e75b725a0ba659938b92c,1,1,1,2,1,2013-11-06 21:10:51,2013-11-06 21:10:51
eaff6bc49ae12dd1fd0e75b725a0ba659938b92c...3887f540b978d593f433bfef15888bc2d103de72,3,3,3,6,3,2013-11-06 21:19:18,2013-11-06 21:16:40
cd7cf40aff400eb4ae587d6b375f8c804582a9fc...725e2b9ccf66cd54e64ff5d15bf8b2744b5122cd,1,1,1,2,1,2013-09-11 23:24:03,2013-09-11 23:24:03
682ee3ab1e3683d2352d01a5be94abd559573e10...28e5572bf4de4e98b62421dc7d33e8b353fff382,3,34,10,44,22,2013-09-12 06:11:18,2013-09-12 06:11:18
682ee3ab1e3683d2352d01a5be94abd559573e10...851acf3f33b8e8b3fe0440f4908f218ed3ad2c82,1,5,0,5,1,2013-09-12 05:58:07,2013-09-12 05:58:07
4f20a29c329aa58919919426cbd2190fabfdb723...776d3fd6a0b0803512ba3cf5bd365b4e18b9315f,1,2,2,4,2,2013-09-17 01:58:52,2013-09-17 01:58:52
b896ce0270572e0f377baddb68860cb4bd80ca8c...4d4976fdcc3f2e88408a7993854a7cfbafd0c6ec,2,2,2,4,2,2013-09-13 19:56:30,2013-09-13 19:56:30
4d4976fdcc3f2e88408a7993854a7cfbafd0c6ec...2381ab088bda18b4fa3fa041cc3f42ae4c959502,2,2,1,3,2,2013-09-13 19:57:10,2013-09-13 19:39:27
b896ce0270572e0f377baddb68860cb4bd80ca8c...6397ba11257641e8a37ff83a41e43b8ec6fcb3ac,1,1,1,2,1,2013-09-13 18:45:15,2013-09-13 18:45:15
25cc04c5abd07928b6df34aa582da85ccd49a526...50bf4d47b17f07627309dfd76f557ca28b9c94a6,1,6,6,12,3,2013-09-01 09:06:33,2013-09-01 09:06:33
50bf4d47b17f07627309dfd76f557ca28b9c94a6...b45c3ea6479e5129f13ab2100b7fffe984c5a935,5,32,1,33,5,2013-09-01 09:21:14,2013-09-01 09:20:58
eed53d781188914c8328fb0ab77b700c3462fdbf...63433fbef9e47f04658085e01d637559f4f14392,9,9,9,18,9,2013-10-22 16:41:33,2013-10-22 16:41:33
eed53d781188914c8328fb0ab77b700c3462fdbf...b034362363769e185418329c9ea17ec25a1c2bd1,1,1,1,2,1,2013-10-22 16:34:43,2013-10-22 16:34:43
eed53d781188914c8328fb0ab77b700c3462fdbf...214a78978dadfc9714139e23ffcfad33824f8514,1,1,1,2,1,2013-10-21 14:34:18,2013-10-21 14:34:18
10a9601560d6fd1c396b2abd8a4fe4a4a9b04a32...52516ecebaaa8efcc5bde1a48b81c8a95c961a82,1,1,1,2,1,2013-09-10 23:20:36,2013-09-10 23:20:36
10a9601560d6fd1c396b2abd8a4fe4a4a9b04a32...886e7037f6cfa5e63ae190ee1a9a63fb7f07dffe,1,0,1,1,1,2013-09-10 21:27:04,2013-09-10 21:27:04
6307d2c94d879e802610e366087bff75883d70a4...50dd5d5088637a074a64528c2b22091e1afc0d5d,3,32,22,54,4,2013-10-14 18:30:06,2013-10-14 18:30:06
2380b6be9937dfc0ca924a2334adfb21ddb91cc0...160ed8561672c4d59eff839d3e8bacd8ff1fb100,2,2,1,3,2,2013-10-15 18:53:56,2013-10-15 18:53:56
160ed8561672c4d59eff839d3e8bacd8ff1fb100...3bfa630d2afe70452861b2466daab78daa47dda8,2,6,1,7,2,2013-10-15 19:13:49,2013-10-15 19:13:49
481791411c2ff975821731eab0e8af8c1d4f6678...8ac1495c63c0996a2d22013a3c70fa1f3107a927,2,806,202,1008,3,2013-10-16 17:43:56,2013-10-16 17:43:56
481791411c2ff975821731eab0e8af8c1d4f6678...9d54a42951939fc8a4765aa3d8427a4227d459f9,1,2,1,3,1,2013-10-16 00:02:21,2013-10-16 00:02:21
5746979aad4b86dae951ef2120aa4dd1314e7ade...fe767a18d369080df509377e049b616c0c572dcc,3,23,12,35,7,2013-08-18 22:41:24,2013-08-18 22:41:24
7b4e2a9a4a9c3d6dc2298bb7a4cbfd9d86ac32fa...638db635d7b0c2bd6406d5ff891e92985e4b839b,1,1,1,2,1,2013-08-18 22:45:56,2013-08-18 22:45:56
896bd327c7396ca2b0f537e325efbd32c056e0fc...1b49b42683e4192a39f3d3d045a98b262a498097,1,8,8,16,2,2013-08-18 20:40:39,2013-08-18 20:40:39
f4b744e697c929c1b0b96ce812160f353a486ec5...9c12d670ed36951ad3d5cfcf2e83a819911f20a8,1,1,1,2,1,2013-08-18 23:27:20,2013-08-18 23:27:20
0810b7bcf4aceac78c28c14e6d783e0dc3f81c28...9f0b79da7eb541d59d4b8210adbc6d2eb4c709ee,1,173,10,183,4,2011-10-28 15:57:09,2011-10-28 15:57:09
9f0b79da7eb541d59d4b8210adbc6d2eb4c709ee...d3b8a96589ab6dd70fad89413e04c09008c7c133,1,2,12,14,2,2011-10-28 15:57:58,2011-10-28 15:57:58
9a30b8c05d26aa6c8e80c0b81f2fb3d979157a24...e8b66a9626055957a378464e2b9204f156b34c17,2,100,0,100,4,2011-10-30 00:58:58,2011-10-30 00:58:58
e8b66a9626055957a378464e2b9204f156b34c17...ea50e8aeeed6616a61a7e44d28fe60ced327be0c,13,109,34,143,33,2011-10-30 01:49:35,2011-10-30 01:49:35
ea50e8aeeed6616a61a7e44d28fe60ced327be0c...640fd15464306238de99a3391888a95156e27995,3,8,4,12,6,2011-10-30 02:27:02,2011-10-30 02:27:02
640fd15464306238de99a3391888a95156e27995...169b4b5dcbca740951735a60cc5c46a1366c2652,3,29,5,34,10,2011-10-30 02:59:51,2011-10-30 02:59:51
169b4b5dcbca740951735a60cc5c46a1366c2652...8f726dc6ef3ee725ef032ef4a11dbce26982ae24,1,16,3,19,3,2011-11-01 05:44:42,2011-11-01 05:44:42
5c86074fa9e5c8f39fa9ad4f4b8f028a8d5aebe6...0e91eddb66088a5dbab27c03139fede17614f1d2,1,4,4,8,4,2011-11-02 06:57:48,2011-11-02 06:57:48
0e91eddb66088a5dbab27c03139fede17614f1d2...d8118084948fd5315870c91bb543eef3cee357a2,3,17,7,24,9,2011-11-02 07:04:43,2011-11-02 07:04:43
d8118084948fd5315870c91bb543eef3cee357a2...1b4b97d53015bc628a2eb001bcd569fb923a3c0c,5,21,15,36,16,2011-11-03 21:45:53,2011-11-03 21:45:53
1b4b97d53015bc628a2eb001bcd569fb923a3c0c...869f11305aa3d4360f51a7ee08a86664c3caa860,11,12,12,24,12,2011-11-04 00:03:03,2011-11-04 00:03:03
8f3150cf7158d3d949e59fed44112350c0724b74...0c8d2e37e76db3d3b47ca9eb5340def031b9196b,1,37,2,39,2,2011-11-30 07:16:38,2011-11-30 07:16:38
0c8d2e37e76db3d3b47ca9eb5340def031b9196b...90c190d4efedd4080c574b34bffdf54cd5b9ed88,4,19,3,22,6,2011-11-30 07:48:27,2011-11-30 07:48:27
90c190d4efedd4080c574b34bffdf54cd5b9ed88...447c9322e96ebd1102115aea01d925536016351a,6,7,7,14,6,2011-11-30 07:56:01,2011-11-30 07:56:01
447c9322e96ebd1102115aea01d925536016351a...f2c40ee24d0caa26e79ed206370858918c603419,5,114,89,203,8,2011-11-30 08:39:38,2011-11-30 08:39:38
f2c40ee24d0caa26e79ed206370858918c603419...bc51c15709469fd0c2e78886a15e849626a8f191,4,89,1,90,5,2011-11-30 09:00:55,2011-11-30 09:00:55
8f3150cf7158d3d949e59fed44112350c0724b74...61e84d8762d79befb2d75685705fd4e451a609fe,1,9,0,9,1,2011-11-30 07:16:09,2011-11-30 07:16:09
b1cba98aab5ee2d0576bbbbb92ba3488516290eb...cee2f61898f4807311402fed747a93ee68a31f8f,10,30,12,42,12,2011-12-01 06:42:22,2011-12-01 06:42:22
ba17414d777919a84b1f055fcbb835d1f624f3d3...1da19bf65f9affec06ba6e1f6e5f545a8e2ea457,3,25,25,50,17,2011-11-29 20:06:31,2011-11-29 20:06:31
ba17414d777919a84b1f055fcbb835d1f624f3d3...d48027d49567c2d38211c357d6fb8d6a5a9e8a7b,3,32,32,64,18,2011-11-29 17:12:32,2011-11-29 17:12:32
7396cb8c51c3bc919a60b960770629a6749a5159...ad87e11f03b4d614a6beea56175289b6a1e576a3,7,7,7,14,7,2011-09-12 18:15:32,2011-09-12 18:15:32
72ce695cfdac130b998a21b42490aad53a91ef8b...bc41c58472b5c8d04f151bd1c847e3da76125dc2,4,5,5,10,5,2011-09-12 20:31:58,2011-09-12 20:31:58
bc41c58472b5c8d04f151bd1c847e3da76125dc2...7af4a4cfa1684eaf0a3d3e822f5a1171424b4295,3,4,4,8,4,2011-09-12 20:32:46,2011-09-12 20:32:46
4b68858f906a936cf3b1cee5266010556483bce8...e4a2c35b84b71082d46c21876bd34f39fff1d81d,1,3,2,5,1,2013-08-27 15:19:51,2013-08-27 15:19:51
f811c1b56cb109394268ec66cf3f956f987e5884...263d775777d4873b8889ab142eb62201ee2830fc,4,0,0,0,0,2013-08-27 13:56:03,2013-08-24 07:19:29
263d775777d4873b8889ab142eb62201ee2830fc...d98206bc062f94a2f862468d328e11968d58c161,1,2,2,4,1,2013-08-27 13:56:03,2013-08-27 13:54:27
d98206bc062f94a2f862468d328e11968d58c161...a586844c90e4700063710d0266f9db8c2b1ab5a9,1,3,3,6,3,2013-08-27 14:05:41,2013-08-27 14:05:41
a586844c90e4700063710d0266f9db8c2b1ab5a9...26728576f3ed385d292858a61b0458a9cf4b39aa,1,3,0,3,1,2013-08-27 14:21:15,2013-08-27 14:21:15
f811c1b56cb109394268ec66cf3f956f987e5884...d1f60671c7c123e9446f7819987f59670787fbb9,1,3,3,6,1,2013-08-27 13:45:38,2013-08-27 13:45:38
d1f60671c7c123e9446f7819987f59670787fbb9...77bee02c85073572accdbceb94cb2055744f0467,1,3,3,6,1,2013-08-27 13:46:10,2013-08-27 13:46:10
f811c1b56cb109394268ec66cf3f956f987e5884...f8dc1858b088e7f1f4550bb56260686bd4392937,1,2,2,4,2,2013-08-27 12:20:14,2013-08-27 12:20:14
f811c1b56cb109394268ec66cf3f956f987e5884...52c7bacd44d0d43d974bee9d7c57897cf5ea167d,1,2,2,4,2,2013-08-27 11:24:46,2013-08-27 11:24:46
fc7049b18f52823e29d0eb9d30c32801113a1509...b590b268adda65b317966ecc17e36b113d4b8eef,1,3,3,6,3,2013-12-26 17:54:04,2013-12-26 17:50:04
fc7049b18f52823e29d0eb9d30c32801113a1509...5cb8510a81a601a81d54145ca97f7fa3dc0fc71a,1,1,1,2,1,2013-12-26 17:52:39,2013-12-26 17:51:10
fc7049b18f52823e29d0eb9d30c32801113a1509...5eab9cbe82f90087516a7c45b2b01a58e3c037c8,2,7,2,9,4,2013-12-26 17:49:33,2013-12-10 14:11:08
73f10843a487ee94bed755ecfd7c853cb657bf38...5c7d339752f20627277ecd69945ae50508cefb8f,1,2,2,4,2,2013-08-28 21:57:41,2013-08-28 21:57:41
73f10843a487ee94bed755ecfd7c853cb657bf38...86632a242ba73f597e3fa8e32c6bb33aff72593f,1,1,1,2,1,2013-08-28 16:18:44,2013-08-28 16:18:44
73f10843a487ee94bed755ecfd7c853cb657bf38...32fbc882b913f2b8d26c4617433ebed5d1f22174,1,1,1,2,1,2013-08-28 11:09:17,2013-08-28 11:09:17
73f10843a487ee94bed755ecfd7c853cb657bf38...a19ff2f50fae73df3c80b104647260c13b1a8c00,2,2,1,3,2,2013-08-28 09:17:46,2013-08-28 09:17:46
73f10843a487ee94bed755ecfd7c853cb657bf38...901da1b2b4727e3d00990dcf66ea3d31703b4edc,3,35,34,69,11,2013-08-28 00:13:34,2013-08-28 00:13:07
73f10843a487ee94bed755ecfd7c853cb657bf38...5ce4b8c7ff95a01c0a02b940479d9b6ad21cb4de,1,1,1,2,1,2013-08-27 20:34:26,2013-08-27 20:34:26
5ce4b8c7ff95a01c0a02b940479d9b6ad21cb4de...ee2e2ae0ae9991432b16ffd69eb4f22ccfb2869a,1,3,0,3,1,2013-08-28 19:55:45,2013-08-28 19:55:45
3887f540b978d593f433bfef15888bc2d103de72...798e64cebf60e1d0d75b0c1c8f1cedfc259130cd,2,13,9,22,3,2013-11-07 02:33:07,2013-11-07 02:32:35
798e64cebf60e1d0d75b0c1c8f1cedfc259130cd...463343af63344dbbc3db04f40b0b804baa919b7e,1,12,8,20,1,2013-11-07 02:38:27,2013-11-07 02:38:27
3887f540b978d593f433bfef15888bc2d103de72...ceefbce100cd1a2fef057427a50fd08a401e93ad,1,2,1,3,1,2013-11-06 23:21:07,2013-11-06 23:21:07
f2750dd6bcb27648977d2c2de2931d945c5492a8...4e962c572e57ff0ee30e490f3f7eb819415c952f,1,4,4,8,1,2013-09-18 00:41:58,2013-09-18 00:41:58
f2750dd6bcb27648977d2c2de2931d945c5492a8...abee1cdf9d3e276e2fbc80b3a518004500f0f8e9,1,38,0,38,1,2013-09-17 16:03:02,2013-09-17 16:03:02
abee1cdf9d3e276e2fbc80b3a518004500f0f8e9...40d3e4c48b3218c78813552cb15a33b8289361f4,1,0,15,15,1,2013-09-18 11:44:56,2013-09-18 11:44:56
6b97970d31221edcad8016dbccf5246fa7a97dd2...ae3a9169e077a74baa1e2702ccdd06f8a4c91e3e,1,2,2,4,1,2013-09-16 14:16:53,2013-09-16 14:16:53
6b97970d31221edcad8016dbccf5246fa7a97dd2...31f32e848509392258e8802b07954730422075dd,1,1,1,2,1,2013-09-16 03:07:15,2013-09-16 03:07:15
6b97970d31221edcad8016dbccf5246fa7a97dd2...3a20ec410be05dac4138d1047cb47867d2eedd0c,1,6,6,12,6,2013-09-14 17:15:42,2013-09-14 17:15:42
26727bfefd46059a6ce66be7ed0e54910870efd9...bfda156bb95c115ac9abba880074d4582c81dc0d,1,7,13,20,4,2013-09-01 21:32:35,2013-09-01 21:32:35
bfda156bb95c115ac9abba880074d4582c81dc0d...1fd923784093f690cc953b1e28a115603603e1b1,2,8,3,11,5,2013-09-01 21:38:11,2013-09-01 21:38:11
1fd923784093f690cc953b1e28a115603603e1b1...de82c807847c18b0faaba3c438714d353179247b,1,2,2,4,2,2013-09-01 21:40:04,2013-09-01 21:40:04
de82c807847c18b0faaba3c438714d353179247b...8df05b95df85cdd636bcc47c5667c8a198b389df,1,1,11,12,3,2013-09-01 21:46:23,2013-09-01 21:43:51
8df05b95df85cdd636bcc47c5667c8a198b389df...741e0fc52cf00989437053657798362ae02a093d,1,43,2,45,1,2013-09-01 21:58:22,2013-09-01 21:58:22
eb77241ae2d4b90fccea1707e12caca355a1afce...0d122fc3230663cadfef7474bbf54aa297334c72,2,5,2,7,2,2013-10-24 06:25:17,2013-10-24 06:25:17
0d122fc3230663cadfef7474bbf54aa297334c72...54cd0f8c2f1aaadefd8447f9ff4cd9bb04fe4e72,6,36,35,71,33,2013-10-24 06:41:17,2013-10-24 06:41:17
eb77241ae2d4b90fccea1707e12caca355a1afce...9a2d16976285bd2f552a9c81bae719b4e7607bd0,2,12,6,18,3,2013-10-23 20:14:34,2013-10-23 20:14:34
9673c25e2cf8701e4fe0d255d38f1a9f6b193e9f...5a38a5775f8a3c58c09df0a0f3afc058c820c238,1,1,0,1,1,2013-10-22 11:31:23,2013-10-22 11:31:23
9673c25e2cf8701e4fe0d255d38f1a9f6b193e9f...5f2bd59abb06fa86b7ac06eb2b51282e7f894796,1,1,1,2,1,2013-10-22 04:50:08,2013-10-22 04:50:08
52516ecebaaa8efcc5bde1a48b81c8a95c961a82...a2a5be11a37b2095418c99139e2d648d770a5110,1,3,3,6,3,2013-09-10 23:34:56,2013-09-10 23:34:56
50dd5d5088637a074a64528c2b22091e1afc0d5d...710071157751dc9aac1b531d283c1ae756a3c902,3,22,22,44,8,2013-10-14 20:45:32,2013-10-14 20:45:32
c1bf625dfe07eab186b03b1d9c115b93c94018d5...cf95fe20ba2b54eb433d513754741dc32e76a4cc,17,17,17,34,17,2013-10-16 22:36:37,2013-10-16 22:36:14
401dca0ed74686a05d614e08cdf49eca3312dbbf...e317e116fda3b43a79cca672e120f5930a612ee1,1,2,2,4,1,2013-10-16 00:25:34,2013-10-16 00:25:34
4c043b7d5f3f9d1f7c4ebe1e82c77b29d282fc39...73bb911b2958219bc537c24efda26919e8b774d7,1,4,0,4,1,2013-10-18 02:12:24,2013-10-18 02:12:24
4c043b7d5f3f9d1f7c4ebe1e82c77b29d282fc39...c23d6a2766f550c63f7cf64f89296a2bcd52a324,17,58,0,58,17,2013-10-18 01:39:03,2013-10-18 01:39:03
af9fd026386c57fa63b7b24a3b1161f7fecd748b...b5d87fc42b04d74b25101293c83d8a4f01a3e22c,1,2,2,4,2,2013-08-18 20:43:53,2013-08-18 20:43:53
b5d87fc42b04d74b25101293c83d8a4f01a3e22c...518488cb4069b4181435873380d0738e8b63bc81,1,1,1,2,1,2013-08-18 20:47:16,2013-08-18 20:47:16
9c12d670ed36951ad3d5cfcf2e83a819911f20a8...35ad599df68f64c043e92b80842fd5a59ceb0418,2,148,0,148,6,2013-08-19 01:16:01,2013-08-19 01:16:01
9c12d670ed36951ad3d5cfcf2e83a819911f20a8...2ca46ff97e8a5eab7f652cd2e318bc201012b4ab,1,1,1,2,1,2013-08-18 23:36:49,2013-08-18 23:36:49
2ca46ff97e8a5eab7f652cd2e318bc201012b4ab...ed3e870da827cb7031b333a2c62212ad6912d670,1,4,4,8,4,2013-08-18 23:39:08,2013-08-18 23:39:08
d3b8a96589ab6dd70fad89413e04c09008c7c133...09743c89961d84e00bcd879661716ba2f34fe097,1,2,2,4,2,2011-11-02 07:38:44,2011-11-02 07:38:44
9defc212181c2c6f5a6066d307bed5c8e203896a...21877031449cae7c66a49da09a19c1d84ccb4a6e,1,1,1,2,1,2011-11-04 00:08:12,2011-11-04 00:08:12
21877031449cae7c66a49da09a19c1d84ccb4a6e...f92759b36db43e782e4235f1f214ac5851383f9b,1,4,0,4,1,2011-11-04 00:39:50,2011-11-04 00:39:50
f92759b36db43e782e4235f1f214ac5851383f9b...a560eb651d24bd3a6183c78ab8a9b88bfa57c3cc,3,6,12,18,12,2011-11-04 01:40:18,2011-11-04 01:40:18
bc51c15709469fd0c2e78886a15e849626a8f191...b12b71bf7ca76437a532122d8efff59506b61530,10,234,178,412,80,2011-12-09 19:32:07,2011-12-09 19:32:07
3726df695eedecee323920305cb5d486a787acd6...6e70d490e1c189518164d7f08035c34e21745715,3,11,1,12,4,2011-12-02 19:37:39,2011-12-02 19:37:39
cee2f61898f4807311402fed747a93ee68a31f8f...e603009fca162178de3265192b2e5da40ce3a151,1,1,2,3,2,2011-12-08 19:42:42,2011-12-08 19:42:42
ad87e11f03b4d614a6beea56175289b6a1e576a3...997c2cd6a05f39436a4238f78c78bacbee15bc7d,2,5,5,10,2,2011-09-12 21:28:26,2011-09-12 21:28:26
8f5f35e6db79599f8e72b78bbed9ee171c86461f...3f64aaf82b6b3486c1b2e98e19047089fdfc331b,4,17,9,26,11,2011-09-13 02:00:44,2011-09-13 02:00:44
e4b036d278d5e11d6c9fcdfd78a2bae78d281e4f...567dc12e86d76fa1dd7395c4251a75068558b2de,2,16,7,23,6,2013-12-27 03:08:19,2013-12-27 03:08:19
e4b036d278d5e11d6c9fcdfd78a2bae78d281e4f...2426a2aeef2634dacd44d23e9a9f116ea887af3a,1,2,2,4,1,2013-12-26 20:55:55,2013-12-26 20:55:55
5c7d339752f20627277ecd69945ae50508cefb8f...83354ab1566b224221aa27973c77d3c9a2cd3c35,1,1,1,2,1,2013-08-29 09:51:39,2013-08-29 09:51:39
5c7d339752f20627277ecd69945ae50508cefb8f...2ef147b16b8d48941aa725f8a44f0612e5771c33,5,5,19,24,7,2013-08-28 22:37:34,2013-08-28 22:37:34
e47ebf3686440df07a83a9d2643b70087ec4fb81...9e541fc717fdaa333bde760688dc6a16256e607d,1,3,3,6,3,2013-09-01 07:46:33,2013-09-01 07:46:33
9e541fc717fdaa333bde760688dc6a16256e607d...794d7845199d46b89f45026d47091e6f30de73a2,6,10,6,16,9,2013-09-01 07:49:28,2013-09-01 07:49:28
794d7845199d46b89f45026d47091e6f30de73a2...4b53ea52e9cc27ab27dde2695400fd6c95a0b6c2,4,4,2,6,4,2013-09-01 07:53:41,2013-09-01 07:53:41
463343af63344dbbc3db04f40b0b804baa919b7e...ce0d008bc3b6cdf2d3274158b01faf56604e35ae,1,18,0,18,1,2013-11-11 01:16:21,2013-11-07 21:15:46
463343af63344dbbc3db04f40b0b804baa919b7e...aad447e29075b52a46931be17a9be4016cc89ef1,3,30,12,42,4,2013-11-09 21:49:58,2013-11-07 19:58:17
463343af63344dbbc3db04f40b0b804baa919b7e...4bd263c4c170cad74b0425afd4a6cd0aa510880c,1,10,1,11,3,2013-11-09 21:14:21,2013-11-09 21:00:34
463343af63344dbbc3db04f40b0b804baa919b7e...4386650e60efea3fe8ecaab0e0e14b303eea4cac,2,6,6,12,6,2013-11-09 18:03:21,2013-11-09 18:03:21
463343af63344dbbc3db04f40b0b804baa919b7e...268f20e84c812de9eb2cbe13261c6fe70f591857,1,1,1,2,1,2013-11-08 10:55:06,2013-11-08 10:55:06
463343af63344dbbc3db04f40b0b804baa919b7e...0da3901ed5a6d498af8b7c76b61d004a003f716b,4,8,5,13,5,2013-11-08 09:33:22,2013-11-08 09:30:15
463343af63344dbbc3db04f40b0b804baa919b7e...03c161f0c445dbe55c57edabee70d816d19ba096,1,1,0,1,1,2013-11-08 07:03:37,2013-11-08 07:03:37
03c161f0c445dbe55c57edabee70d816d19ba096...37e46ec2b8feb2132c27ed443aba0a2973eba0d9,1,1,1,2,1,2013-12-02 04:27:09,2013-12-02 04:27:09
37e46ec2b8feb2132c27ed443aba0a2973eba0d9...1444a3ca638bd8661c0019560117ac75aace3402,1,1,1,2,1,2013-12-02 04:27:14,2013-12-02 04:27:14
463343af63344dbbc3db04f40b0b804baa919b7e...15fbc4bd06db91de3ee81a1894428e0ab17a5b82,1,2,2,4,1,2013-11-07 15:57:55,2013-11-07 15:57:55
463343af63344dbbc3db04f40b0b804baa919b7e...96109d3138fd6f5b67fb1108754e81c077630b36,4,70,93,163,13,2013-11-07 08:53:33,2013-11-07 08:53:33
c1c2a8e18867bfa1644928428c693b367a5617a1...4cbc8d49b10f707029019aaa5eba50e56390a3c5,2,4,4,8,2,2013-11-13 20:03:03,2013-11-13 20:03:03
6df6723c156ab565c7b6341fc58582fceadd7649...86678e66021657cf7d59a96b9cf0fe0cb42ee968,1,1,1,2,1,2013-11-17 00:50:47,2013-11-17 00:50:47
8f43820fffd8f7d6e8a6b40297d21b85180623a6...63d1d09ebda9839a6d84ce76dec45c25b752178e,3,47,145,192,25,2013-09-17 04:43:55,2013-09-17 04:43:55
4e962c572e57ff0ee30e490f3f7eb819415c952f...0cd6d35058e76deebcd5063cbc22cb33658c827f,1,16,6,22,7,2013-09-18 05:05:34,2013-09-17 15:30:36
0cd6d35058e76deebcd5063cbc22cb33658c827f...60afea85b4103634950586e651aeff6b29940b42,1,1,1,2,1,2013-09-18 05:14:19,2013-09-18 05:14:19
60afea85b4103634950586e651aeff6b29940b42...45b6c6de465bf9eb88e9a1726a21bb92e8e7f5c5,4,81,146,227,29,2013-09-18 05:14:39,2013-09-18 05:14:39
4e962c572e57ff0ee30e490f3f7eb819415c952f...b1208f380a6ea005e7936b50f67d1e3085d77c1d,1,5,0,5,1,2013-09-18 04:31:52,2013-09-18 04:31:52
b1208f380a6ea005e7936b50f67d1e3085d77c1d...29f24f746c9990f1d588bab0a0a8a89dcde940bf,1,5,0,5,1,2013-09-18 04:45:56,2013-09-18 04:45:56
4e962c572e57ff0ee30e490f3f7eb819415c952f...0de96b8f35f4882e2d876a40873a01572c5f2dfc,1,319,0,319,1,2013-09-18 01:58:15,2013-09-18 01:58:15
68099ec2756393f0996056b489a088048d3acc6c...3c0489102ee65bcb020a6fd5fc399d9806a46a51,2,10,10,20,8,2013-09-18 17:36:17,2013-09-18 05:20:46
559fcbfbd6c876c2a65b37015d953c9708c02cb7...66abfe577ef881fcfd5309735a41ac8f582a0a7a,1,3,3,6,2,2013-09-16 17:42:52,2013-09-16 17:42:52
66abfe577ef881fcfd5309735a41ac8f582a0a7a...d7fb54e5fb1db2ab691c1778d15c3a9cb6b2d10d,1,1,1,2,1,2013-09-16 18:40:12,2013-09-16 18:40:12
559fcbfbd6c876c2a65b37015d953c9708c02cb7...a6e2a93febb0d87e9bb916651474d168b158d4f3,1,1,1,2,1,2013-09-16 17:36:39,2013-09-16 17:36:39
559fcbfbd6c876c2a65b37015d953c9708c02cb7...cde1b9a1782a6592e2d41ce2ad60aadd74e5539c,1,2,1,3,1,2013-09-16 15:21:09,2013-09-16 15:21:09
559fcbfbd6c876c2a65b37015d953c9708c02cb7...bff23ee1fef96ba97ec15d2bbe2b81b4f852e1e1,1,2,2,4,2,2013-09-16 09:17:48,2013-09-16 09:17:48
bff23ee1fef96ba97ec15d2bbe2b81b4f852e1e1...0c39045222f5fcea5cddb9b1bbd1c17d53731cdb,1,8,8,16,8,2013-09-16 11:55:53,2013-09-16 11:55:53
0c39045222f5fcea5cddb9b1bbd1c17d53731cdb...cc6991133544e1ae23f3a14b086c5ef103f14dd6,1,2,2,4,2,2013-09-16 12:07:03,2013-09-16 12:07:03
741e0fc52cf00989437053657798362ae02a093d...14b3a3542f15051e1274ff27cf9c0cf453b93243,2,27,0,27,2,2013-09-01 22:09:49,2013-09-01 22:09:49
54cd0f8c2f1aaadefd8447f9ff4cd9bb04fe4e72...20cba845c26b04799de7a7a6d9554e9fd6d21eab,7,16,10,26,16,2013-10-26 08:57:09,2013-10-24 17:32:41
54cd0f8c2f1aaadefd8447f9ff4cd9bb04fe4e72...9d2cf56177cf3f8674aa327b4b30c56bde1a9381,1,1,1,2,1,2013-10-24 19:01:09,2013-10-24 19:01:09
ea40e7999dfb72a34c3f06f615a6bcd7c1c045c1...17fb7aee2d7d86e6c3250b95d11dd651a8cbe3cd,1,2,2,4,2,2013-12-31 18:20:57,2013-12-31 18:20:57
cf09ec3c77b080c8969d1c96ec4ee2db1c8bafed...a9335e94e1ed7578bc8ec20140b0846666f06a1a,2,3,2,5,2,2013-09-11 01:59:09,2013-09-11 01:59:09
a9335e94e1ed7578bc8ec20140b0846666f06a1a...76d8757b0a2a2669a67d2131cbc4330e4c0cd2e8,3,3,3,6,3,2013-09-11 02:01:40,2013-09-11 02:01:40
fa64846acfef78487859e5e9f311ea401ee4c1cd...e20b02ad0b1253c8e3d9703409a256927f55ede8,3,5,3,8,3,2013-10-14 23:10:49,2013-10-14 23:10:49
3abe86b7ed1293a3b8099b5921734c694da4ec21...9416cd3738ed30007aeebde458c00f650524cf48,1,99,57,156,13,2013-10-14 06:37:16,2013-10-14 06:37:14
323a40cc53dabf0561c588c8f8ccd690c5bb0a03...d79431ca02683c9d1c754201260f66e5dda15614,2,65,3,68,3,2013-12-15 00:29:55,2013-12-15 00:29:55
cf95fe20ba2b54eb433d513754741dc32e76a4cc...c88cd1cd95dc4bef63697124f795fe7e60308a99,3,21,0,21,3,2013-10-17 21:02:22,2013-10-17 18:33:04
c88cd1cd95dc4bef63697124f795fe7e60308a99...1f33dc8033b2b8245df98a79ebe8800c6c0b992e,3,12,9,21,5,2013-10-17 21:11:40,2013-10-17 21:11:40
cf95fe20ba2b54eb433d513754741dc32e76a4cc...4d663e38798451a2055bfc14c9b74e71563918a1,1,1,0,1,1,2013-10-16 22:50:40,2013-10-16 22:50:40
e317e116fda3b43a79cca672e120f5930a612ee1...397481903a539a67b7f7d794684760b5a8eefa8b,1,1,1,2,1,2013-10-16 14:42:32,2013-10-16 14:42:32
e317e116fda3b43a79cca672e120f5930a612ee1...976f6dfdad663e43237a3da07cb64a41932f264e,3,5,3,8,7,2013-10-16 14:20:34,2013-10-16 14:20:34
eb4a92bfedde23729bc812b9d6abe704bd8bca59...d2ad1dc88ff34a6924429947e873b9c836fe4aef,1,9,9,18,7,2013-10-18 19:34:18,2013-10-18 19:34:18
eb4a92bfedde23729bc812b9d6abe704bd8bca59...77bb7502bc7112f915b32940c1fe5d8555230c30,2,11,0,11,2,2013-10-18 13:05:50,2013-10-18 13:05:50
77bb7502bc7112f915b32940c1fe5d8555230c30...89e0f1669f2b4166051affa4eec819475660ed72,2,9,10,19,3,2013-10-21 18:39:31,2013-10-21 18:39:31
518488cb4069b4181435873380d0738e8b63bc81...fa3959a1e10da848867be73ac1d18d209367a9b0,1,5,5,10,1,2013-08-18 22:05:42,2013-08-18 22:05:42
518488cb4069b4181435873380d0738e8b63bc81...743fc9ac7e7d0b82a5443855631122c1e0a7e0bd,1,10,8,18,1,2013-08-18 21:28:55,2013-08-18 21:28:55
7241d7beb7c468d0573e469d2ad992072941324d...1bc13c659f1cadd66f1081c1a4f14a11c3b7cbf4,1,3,3,6,1,2013-08-19 01:44:40,2013-08-19 01:44:40
1bc13c659f1cadd66f1081c1a4f14a11c3b7cbf4...87a1d7e5a0bf0cbad69b39e8bca62b6e31d38dd8,1,0,0,0,0,2013-08-19 01:47:05,2013-08-19 01:47:05
87a1d7e5a0bf0cbad69b39e8bca62b6e31d38dd8...5bd2d7ed7e5a2bae56de81bf550f2e4b1451ab25,3,8,1,9,3,2013-08-19 01:49:07,2013-08-19 01:49:07
a560eb651d24bd3a6183c78ab8a9b88bfa57c3cc...c53347db79b190b9af67fa145be92def2862c9a1,1,1,1,2,1,2011-11-05 04:25:31,2011-11-05 04:25:31
a560eb651d24bd3a6183c78ab8a9b88bfa57c3cc...913d84d7d381d04feb2ecb691a2b28eb6eee8a71,1,2,2,4,1,2011-11-04 18:17:28,2011-11-04 18:17:28
a560eb651d24bd3a6183c78ab8a9b88bfa57c3cc...3b611357aaaef076467718dcd7ff1fb9381488bf,1,1,1,2,1,2011-11-04 13:17:12,2011-11-04 13:17:12
a560eb651d24bd3a6183c78ab8a9b88bfa57c3cc...79a01b7fcb15d6114c9ba15d5de9f9bd2dc8b983,1,1,1,2,1,2011-11-04 07:34:12,2011-11-04 07:34:12
312ee6cdfb20f7602924c90e6ae37cba62a39da4...1d1805ee5cb188f0c70b6a27e227ea6caca62c8e,6,57,1,58,6,2011-12-09 19:41:00,2011-12-09 19:41:00
1d1805ee5cb188f0c70b6a27e227ea6caca62c8e...7b810bf9a617e1f02e073aafcc70857dc915ee59,9,19,14,33,17,2011-12-09 20:10:01,2011-12-09 20:10:01
7b810bf9a617e1f02e073aafcc70857dc915ee59...97b285896f50bed4a66b00a70ed67eb3224bc7f3,4,9,3,12,5,2011-12-09 20:51:54,2011-12-09 20:51:54
97b285896f50bed4a66b00a70ed67eb3224bc7f3...5c8df1d2858c3d5f2cc65a80acaef5312b1ae87f,11,54,7,61,9,2011-12-09 22:34:38,2011-12-09 22:34:38
5c8df1d2858c3d5f2cc65a80acaef5312b1ae87f...4d55356e9b476cbfea5eb2ea01099dc19a5fc5f4,3,52,77,129,11,2011-12-09 22:39:23,2011-12-09 22:39:23
6de3ed53228c79bc4fde5086d1302f2367bc40a5...95048c271eb4166a4e22ab1f0ff6d69bade7d62b,3,5,5,10,5,2011-12-11 09:03:57,2011-12-11 09:03:57
95048c271eb4166a4e22ab1f0ff6d69bade7d62b...401f84a7ec65996a8573671b2c17077f85e63e6f,3,31,2,33,5,2011-12-11 09:58:06,2011-12-11 09:58:06
401f84a7ec65996a8573671b2c17077f85e63e6f...ecbc9ec4a2cbd3f68067b869c328d55e8afc8aa6,5,15,20,35,5,2011-12-11 10:03:16,2011-12-11 10:03:16
ecbc9ec4a2cbd3f68067b869c328d55e8afc8aa6...54a84f0f7f217ea12249857d2b2d5ad4795e41e2,1,4,4,8,4,2011-12-11 10:05:50,2011-12-11 10:05:50
54a84f0f7f217ea12249857d2b2d5ad4795e41e2...4e8c26d409c60f50e2ab245e74ec18af5131d838,3,7,14,21,8,2011-12-11 10:38:58,2011-12-11 10:38:58
4e8c26d409c60f50e2ab245e74ec18af5131d838...d681ae9f51b85d8e1efae2a819ce289266d7efd0,3,21,3,24,5,2011-12-12 17:51:41,2011-12-12 17:51:41
d681ae9f51b85d8e1efae2a819ce289266d7efd0...aa69286c306ab4d0e5fe748953cded81f8260cc1,2,1,1,2,1,2011-12-13 18:05:19,2011-12-13 18:05:19
4c5320b18fb24356553dc14e13db69883797d105...5ee11ec8bdba2e7d0d1cf95168f75905b61059fb,1,1,0,1,1,2011-09-13 04:06:29,2011-09-13 04:06:29
218976a7d8a3b2b39363bf939cf914250c0c9930...2978934bd529e9cd5b1182d1df98b9942066beda,3,6,70,76,5,2011-09-13 02:40:48,2011-09-13 02:40:48
2978934bd529e9cd5b1182d1df98b9942066beda...206334ba70c22dc91ec9381f9693ed6356358994,8,176,257,433,16,2011-09-13 03:07:26,2011-09-13 03:07:26
ca7498faa0c0dc4f29c4d47764e88d3d277dc6f9...d43eb0a513abf19c4c49b9cf7e2d56db6239fafb,1,4,4,8,4,2013-12-27 03:37:19,2013-12-27 03:37:19
0ce3d67f359d2385dd375ae35ee2462c26d6f012...5b21768c054b86dd9f27eea9879f75668546cdc4,1,8,0,8,2,2013-08-29 23:12:39,2013-08-29 23:12:39
644c227ae16a9870c6aa456e0dc826fab0e5fa2e...95c796d61e40e7c12aef75ba8dff4bf211ccbb8f,1,11,3,14,5,2013-08-31 18:43:57,2013-08-31 18:43:57
95c796d61e40e7c12aef75ba8dff4bf211ccbb8f...1ebd2826939b263be8ceeb9b3e8339d13547dfa9,1,2,2,4,2,2013-09-10 21:31:57,2013-09-10 21:31:57
644c227ae16a9870c6aa456e0dc826fab0e5fa2e...f849e65d5682139d09ed7e6d1138cf877de3eca8,1,4,4,8,4,2013-08-31 15:50:14,2013-08-31 15:50:14
9a32b21dc77071806116d9bbfa2a43306fa0dccf...58401daf1c6d97301af707045f8e1f0651e7290b,2,3,3,6,3,2013-09-01 08:15:39,2013-09-01 08:15:39
772e6e359e6efc9983c318905370ad9ac8d5a493...9616768659010979cd20f587791e966be38868d8,1,0,1,1,1,2013-09-01 08:19:55,2013-09-01 08:19:55
daa8330b414d5b12e943fd614aaad7a4cd2c0c51...e10bf3aa7ffc8a6544d0fff89196e5876d0fc600,2,6,1,7,2,2013-09-01 08:04:03,2013-09-01 08:04:03
e10bf3aa7ffc8a6544d0fff89196e5876d0fc600...3a4ea1a7bea5a8400672c7e6a47f71b5ea2ee749,1,2,6,8,4,2013-09-01 08:04:44,2013-09-01 08:04:44
4498e8f57b461327357327fc1e5418c2dd57f3ca...c0f6d722b02c8dcf167cc5f55fcfbadaf34d58a2,1,1,1,2,1,2013-09-04 19:16:46,2013-09-04 19:16:46
a639c6e1cf2eb0457be84290f7848c3eb9eaad27...934d1bcae588a278900018abb648242eb05328b3,1,6,0,6,1,2013-11-11 01:23:11,2013-09-03 02:23:51
934d1bcae588a278900018abb648242eb05328b3...5d6e9212a642430719702ead322103e19c6aa782,1,10,4,14,3,2013-11-11 01:23:11,2013-09-02 05:23:31
5d6e9212a642430719702ead322103e19c6aa782...7a3f41b11b15f4b931aa43cf1a2fd7a00db6f817,3,13,7,20,5,2013-11-11 01:25:17,2013-11-06 06:20:29
b5f9cc20578fb57b2b69e10cf32bba55f9c940e4...09cd5289ab540486a9c601e79860b34a2fe1873c,4,4,2,6,4,2013-11-30 01:47:27,2013-11-30 01:47:27
09cd5289ab540486a9c601e79860b34a2fe1873c...a4c54b5e5d948e9ec7cdd22bc0efa2241d2605c6,3,9,1,10,3,2013-11-30 02:33:59,2013-11-30 02:33:59
a4c54b5e5d948e9ec7cdd22bc0efa2241d2605c6...7d456aef76e0e9353269feb71aef8b7ae61f2c1d,1,9,2,11,3,2013-11-30 04:25:07,2013-11-30 04:25:07
7d456aef76e0e9353269feb71aef8b7ae61f2c1d...1e6c95cd5d04ae5750d46195d652e21e9a461647,1,15,10,25,4,2013-11-30 04:39:00,2013-11-30 04:39:00
1e6c95cd5d04ae5750d46195d652e21e9a461647...61c641ea05c317e06bb3b9df0d9956abffc32e7e,1,5,5,10,5,2013-11-30 05:08:16,2013-11-30 05:08:16
61c641ea05c317e06bb3b9df0d9956abffc32e7e...36b82c37ecbedd13f9a2f3eca545745eb8eedf75,3,8,8,16,6,2013-11-30 05:59:28,2013-11-30 05:59:28
36b82c37ecbedd13f9a2f3eca545745eb8eedf75...bf9f39270c7c6d50b0355a0b1a5e470c0820af07,3,7,7,14,5,2013-11-30 06:03:49,2013-11-30 06:03:49
bf9f39270c7c6d50b0355a0b1a5e470c0820af07...e4848286c86af39c5a30c845748fdc46de8b8dd5,3,8,6,14,5,2013-11-30 07:19:04,2013-11-30 07:19:04
b5f9cc20578fb57b2b69e10cf32bba55f9c940e4...08e41d769a5fc34b60a307721dacc34eb36f1a1c,3,11,7,18,7,2013-11-29 07:37:54,2013-11-29 07:37:54
08e41d769a5fc34b60a307721dacc34eb36f1a1c...702ad4c3025c8db0ec482e5eccd339cf1e6c2a5a,1,0,12,12,4,2013-11-29 10:37:06,2013-11-29 10:37:06
4876cbeef8c79686ba31c3ed22771357d71dbe51...ab73ff182820954a644a5648f11f51d0704f9390,1,5,5,10,3,2013-12-02 04:39:53,2013-12-02 04:39:53
bb4a39d51cd644b212323a7e36f0b5af2682d0ca...a7a9dcaeb2231b2580cf79fcee7d777b98ac24d8,7,7,21,28,14,2013-11-30 08:42:36,2013-11-30 08:42:36
4cbc8d49b10f707029019aaa5eba50e56390a3c5...c2a6e950d75ece24aa856b0cd7b0f50223c9a7f9,3,1,31,32,3,2013-11-13 21:32:46,2013-11-13 21:32:46
03501f9c4afc3a74bba958c388b32e5ac065e997...37f3944bd9a1cc2b7cb2dda6f767b708daab5fc1,4,39,70,109,28,2013-11-22 23:45:38,2013-11-22 23:45:38
02423caa856b7f7adef830ec048f84765c31b02c...ef636bd62d6ab82e7cc70170f23bffe7bc8bd3cf,3,1,3,4,3,2013-09-20 03:56:17,2013-09-20 03:56:17
8a181a138873bbec47c18d70055b0f2e40c810ce...d675e82e50d4cb7402f6993de5c9554f9b21776b,1,4,4,8,3,2013-09-23 13:51:49,2013-09-23 13:51:34
8a181a138873bbec47c18d70055b0f2e40c810ce...f350d1ba3df6f477203d721a213d4f9a753aa17d,2,2,0,2,2,2013-09-23 13:14:37,2013-09-23 13:14:37
86ec05793a83085af4507337b108cb4afd205106...dc3d16648c806f54e73d83fdc132abf77f1bf6bf,1,1,1,2,1,2013-09-21 12:19:11,2013-09-21 12:19:11
5deee652f927a0eebfceeea7d0584819bea0f766...b741608964310cb6886474f3fac70ffc264189bb,1,3,2,5,2,2013-09-19 05:33:52,2013-09-18 06:04:09
b741608964310cb6886474f3fac70ffc264189bb...0379c2056de96a9b17099d20d5e72228d9eef7bd,1,2,2,4,2,2013-09-19 06:27:09,2013-09-18 17:00:45
cc6951fa15ab990b5d90edd7acc9f1bbf2f16875...92a624a31ced5ef0e70052a00253f5edc70a104b,1,0,1,1,1,2013-12-03 14:03:07,2013-12-03 14:03:07
cc6951fa15ab990b5d90edd7acc9f1bbf2f16875...0fcaca86b57bf3a4fa2c8f709e90499c92e0db73,1,2,1,3,1,2013-12-02 20:56:23,2013-12-02 20:56:23
cc6951fa15ab990b5d90edd7acc9f1bbf2f16875...3a65b2c11f43154907923535b56ea84fb84cfb78,1,1,0,1,1,2013-12-02 19:29:54,2013-12-02 19:29:54
cc6951fa15ab990b5d90edd7acc9f1bbf2f16875...4392d43d7c7013a53c1cbaf270f27d2aeab14f54,1,202,106,308,29,2013-12-02 12:12:57,2013-12-02 12:12:46
4392d43d7c7013a53c1cbaf270f27d2aeab14f54...c56e63e967f8a55b25b35e7bcd8edde4aa936c6f,1,21,14,35,13,2013-12-02 12:13:10,2013-12-02 12:13:10
c56e63e967f8a55b25b35e7bcd8edde4aa936c6f...b8928340f4ef26f788dbf362076105adceb1fa1a,1,376,146,522,7,2013-12-02 12:15:57,2013-12-02 12:15:57
079fa16b9f067ea16995602d1da6f421ca31a191...a245c0d1cd6d82b5e1cdedd5039ba572e3b4373b,1,1,1,2,1,2013-09-02 03:52:23,2013-09-02 03:52:23
079fa16b9f067ea16995602d1da6f421ca31a191...626cef9fa40a3759753383ff61d5ebde32bd9a18,1,2,2,4,1,2013-09-02 01:24:27,2013-09-02 01:24:27
4fac7b6d25953eeedf54eba98d3861afc8ed25de...aff291e1ca998591b6615f6bde3e10e1dae2403b,4,8,10,18,5,2013-10-26 12:11:59,2013-10-26 12:11:59
4fac7b6d25953eeedf54eba98d3861afc8ed25de...72cfe877d8585054558cb83222d207159f854dd1,1,0,4,4,1,2013-10-26 11:43:50,2013-10-26 11:43:50
9d2cf56177cf3f8674aa327b4b30c56bde1a9381...c865a68e212e6ba35a5049b568f63730ee870a82,3,4,4,8,4,2013-10-25 02:20:08,2013-10-25 02:20:08
c865a68e212e6ba35a5049b568f63730ee870a82...3cd744fd5ec725b0fbba0d69b36e1c1f3bcf018a,1,0,1,1,1,2013-10-25 02:42:48,2013-10-25 02:42:48
3cd744fd5ec725b0fbba0d69b36e1c1f3bcf018a...f31aae469ec912833003a05a9a46acc4acf37db4,1,1,1,2,1,2013-10-25 02:48:42,2013-10-25 02:48:42
f31aae469ec912833003a05a9a46acc4acf37db4...aafe3f90bd5641a01123867bab2df1d5281959cd,1,1,1,2,1,2013-10-25 02:50:08,2013-10-25 02:50:08
aafe3f90bd5641a01123867bab2df1d5281959cd...a58c83a317f9fa741fe2f6df213616d5538b5c9b,1,1,1,2,1,2013-10-25 02:56:44,2013-10-25 02:56:44
9d2cf56177cf3f8674aa327b4b30c56bde1a9381...91fa801d33f077ae86095c3d99c1c76a7021a6ff,1,4,0,4,1,2013-10-24 22:16:02,2013-10-24 22:16:02
ed98ac75600b08f391df2fc0bffe009c8892e556...a127f3921eea284bb0656da1362fe4f2a45df8fe,2,29,6,35,5,2013-12-01 05:05:39,2013-12-01 05:05:39
a127f3921eea284bb0656da1362fe4f2a45df8fe...22da6fcfb269e78f6d89cd17e6f63f45d19ae8e3,3,12,7,19,5,2013-12-01 05:17:53,2013-12-01 05:17:53
22da6fcfb269e78f6d89cd17e6f63f45d19ae8e3...c6244a94d0af91faefa337b1f83965241f3694e0,4,4,4,8,4,2013-12-01 06:41:43,2013-12-01 06:41:43
c6244a94d0af91faefa337b1f83965241f3694e0...cf40b5db60fa238b24a92567860006c1581261f3,3,3,1,4,3,2013-12-01 07:04:55,2013-12-01 07:04:55
cf40b5db60fa238b24a92567860006c1581261f3...841da88f3fc93740cca07b6e4581a333d77964f0,3,3,1,4,3,2013-12-01 07:08:41,2013-12-01 07:08:41
841da88f3fc93740cca07b6e4581a333d77964f0...48269dcd282f05be79c9bb8cba032c745b3b337a,3,12,1,13,3,2013-12-01 07:17:43,2013-12-01 07:17:43
48269dcd282f05be79c9bb8cba032c745b3b337a...57070dcf4525fe82cab6a93300861867aa7f2d1e,1,1,1,2,1,2013-12-01 07:35:08,2013-12-01 07:35:08
0365796375157d3072298cde4be8b95eb61e5f86...92f007157aa2c9c0e3502f42ce2d135f4a0b37b6,1,1,1,2,1,2013-10-27 12:43:51,2013-10-27 12:43:51
0365796375157d3072298cde4be8b95eb61e5f86...b09417fd75b068f0eee37bef089f0d08d8ba9b58,1,6,0,6,1,2013-10-26 19:32:29,2013-10-26 19:32:29
b09417fd75b068f0eee37bef089f0d08d8ba9b58...58cb85be3732888c42003cbe42142ee0e77a9639,1,1,1,2,1,2013-10-26 19:52:38,2013-10-26 19:52:38
76d8757b0a2a2669a67d2131cbc4330e4c0cd2e8...1f3a87a8a0ba734778ca12681124c5a2385d1139,1,1,1,2,1,2013-09-11 02:12:47,2013-09-11 02:12:47
1f3a87a8a0ba734778ca12681124c5a2385d1139...2b5d7d23d0e6de93cd0ba8b1d4eee480e4cb504d,8,34,33,67,11,2013-09-11 02:22:20,2013-09-11 02:21:44
036712ed9015c1ea19f2f400526b37c5115446f6...4e1808930a7ad9cbfcf76a5b05ac90bced761eb8,2,7,7,14,7,2013-10-14 23:24:58,2013-10-14 23:23:20
9416cd3738ed30007aeebde458c00f650524cf48...df46b1b46edd1488c7934877250dabfc376a9f6a,1,4,4,8,4,2013-10-14 07:38:19,2013-10-14 07:38:19
df46b1b46edd1488c7934877250dabfc376a9f6a...3c69f59fe51fb816c07c890d7c2ccf616e69ec0c,1,5,5,10,5,2013-10-14 07:40:51,2013-10-14 07:40:51
9416cd3738ed30007aeebde458c00f650524cf48...ceb7694ee325db6b85de374192ecda2407a731ea,1,6,1,7,2,2013-10-14 07:10:30,2013-10-14 06:50:20
9416cd3738ed30007aeebde458c00f650524cf48...67c48f7703e8769da4efe52cf76caf08ce966f6a,1,1,1,2,1,2013-10-14 06:52:53,2013-10-14 06:52:53
67c48f7703e8769da4efe52cf76caf08ce966f6a...ee8ba8b54039b7192fbb2da862d152189a5bb766,1,3,3,6,1,2013-10-14 08:04:48,2013-10-14 08:04:48
3e9e339ee3140c44e1d3948981a551c16f22b1a9...d8a68e38f7f84750810cd6b8b8557f2210c2bca1,1,2,2,4,1,2013-10-17 07:52:59,2013-10-17 07:52:59
3e9e339ee3140c44e1d3948981a551c16f22b1a9...0c2055ef381d55388540496996788861fa04b7d8,6,73,2,75,6,2013-10-17 02:02:04,2013-10-17 02:02:04
0c2055ef381d55388540496996788861fa04b7d8...693915d1277d465844c6757fc107110342229d76,4,10,10,20,10,2013-10-17 05:56:13,2013-10-17 05:55:40
693915d1277d465844c6757fc107110342229d76...07de53c644b315852c5f315ab91bfd6d65660d50,7,181,57,238,21,2013-12-07 22:09:03,2013-12-07 22:09:03
369f5ba760993001fe6c4cc56ee3cf0327c3395d...5aa4c5cb0c1b8bed3a4bb6b6a867f48b4a59f2fb,3,3,1,4,3,2013-10-21 03:04:10,2013-10-21 03:04:10
32468b087b615d1ed710f9118ff4f669cc5ad5e8...291fd9828cdd50626b2b1afcc52122bfd9aecc08,2,2,2,4,2,2013-10-20 23:48:42,2013-10-20 23:48:42
32468b087b615d1ed710f9118ff4f669cc5ad5e8...6a93a6b88a4b874fba5a1d1edd817cbd91ccfacc,3,15,2,17,4,2013-10-20 23:46:38,2013-10-20 23:46:38
32468b087b615d1ed710f9118ff4f669cc5ad5e8...8a9e1af18d74a2aad34e0cdd10654c97f6e6ae12,1,1,1,2,1,2013-10-20 16:50:14,2013-10-20 16:50:14
32468b087b615d1ed710f9118ff4f669cc5ad5e8...15f15cafd6624724c05b31933f6ec0a096b9766e,1,1,0,1,1,2013-10-19 04:07:10,2013-10-19 04:07:10
fa3959a1e10da848867be73ac1d18d209367a9b0...7b0d93f79ea252f57cd6e132b1447a63efcdf095,1,200,201,401,1,2013-08-18 22:15:33,2013-08-18 22:15:33
7b0d93f79ea252f57cd6e132b1447a63efcdf095...9fa0a5d12718bef464e002d9b850aebcb63c79e4,1,5,5,10,4,2013-08-18 22:19:13,2013-08-18 22:19:13
9fa0a5d12718bef464e002d9b850aebcb63c79e4...0501d83f8baa642d5f2ea7c17f851db7d51359b8,2,71,71,142,19,2013-08-18 22:20:16,2013-08-18 22:20:16
0501d83f8baa642d5f2ea7c17f851db7d51359b8...c338f2782dde0b9d0884bcc6824964d3096df01a,1,176,161,337,19,2013-08-18 22:36:24,2013-08-18 22:30:44
c338f2782dde0b9d0884bcc6824964d3096df01a...fa7cc6cafda4f5a9363d17507bf91cba22777749,1,5,5,10,3,2013-08-18 22:37:07,2013-08-18 22:33:32
5bd2d7ed7e5a2bae56de81bf550f2e4b1451ab25...ea383804ecb4527d49c8603a09a37b983faf72d5,2,3,13,16,3,2013-08-19 02:40:26,2013-08-19 02:40:26
5bd2d7ed7e5a2bae56de81bf550f2e4b1451ab25...d5cd040f57b5b1036a7a927332a3220cceefae43,4,46,42,88,18,2013-08-19 02:24:10,2013-08-19 02:24:10
77a315d69d32eb054b93a656594db7ed0ea34fc9...de44b4c653d817c407983c9f94f535e2959749bf,4,38,38,76,16,2011-11-04 20:34:44,2011-11-04 20:34:44
4d55356e9b476cbfea5eb2ea01099dc19a5fc5f4...d587845149471ad9ed07bc57c1a8652c54d17c55,4,9,9,18,8,2011-12-11 06:21:08,2011-12-11 06:21:08
d587845149471ad9ed07bc57c1a8652c54d17c55...d2e56ad53d5d5c93cd6206a6829ee2054f583c5b,3,16,5,21,7,2011-12-11 06:29:49,2011-12-11 06:29:49
aa69286c306ab4d0e5fe748953cded81f8260cc1...72a536393c2f2aba4f855384e94c4ce09bc2e39c,9,364,129,493,44,2011-12-20 06:58:56,2011-12-20 06:58:56
aa69286c306ab4d0e5fe748953cded81f8260cc1...7df0d1c7d18a72f401094d08afa4eaa9142fe511,3,52,1,53,3,2011-12-15 02:45:33,2011-12-15 02:45:33
206334ba70c22dc91ec9381f9693ed6356358994...524948385013d0f4399a0e99539a5664c04cfce4,6,134,100,234,92,2011-09-13 05:19:28,2011-09-13 05:19:28
499cca2115bd51c39a8f4ee659ad81082a6b4a5f...c595db19ff21b5782cf0d510a34ee943508d115c,5,12,4,16,5,2013-12-27 04:26:27,2013-12-27 04:26:27
c595db19ff21b5782cf0d510a34ee943508d115c...201088cb5f9ab4af062b62ac3a10a2e8f07a6ec5,1,1,1,2,1,2013-12-27 04:33:44,2013-12-27 04:33:44
be6ad3fda01de07931d8768708cc17385a552b92...885a870f43d1767530c9c3ce449a7b14a26c3741,2,7,11,18,7,2014-01-19 11:52:31,2014-01-19 11:52:31
be6ad3fda01de07931d8768708cc17385a552b92...0bcc5a2814a19811d3c4dafdf2761250b5f441eb,1,4,0,4,1,2013-12-26 21:44:27,2013-12-26 21:44:27
5b21768c054b86dd9f27eea9879f75668546cdc4...ed1bd2b150dd645c11f92126a12183985ddbbc15,2,30,9,39,7,2013-08-31 06:03:09,2013-08-31 06:03:09
5b21768c054b86dd9f27eea9879f75668546cdc4...6d3ad5ed7fef5d0186b92d9bfcf077c902dc6fd3,2,0,77,77,2,2013-08-30 19:39:48,2013-08-30 19:39:48
5b21768c054b86dd9f27eea9879f75668546cdc4...ccb630e60f9db841c854c66bb3930146e54362d1,1,1,1,2,1,2013-08-30 19:01:07,2013-08-30 19:01:07
5b21768c054b86dd9f27eea9879f75668546cdc4...36044b3a119d87c675c814f9099d357aebef1fd3,1,1,1,2,1,2013-08-30 04:38:48,2013-08-30 04:38:48
36044b3a119d87c675c814f9099d357aebef1fd3...2e2fffe8f8ca6859ec65c8484c5e5d81bd364c2d,1,7,9,16,7,2013-08-30 05:07:09,2013-08-30 05:07:09
5b21768c054b86dd9f27eea9879f75668546cdc4...f5676467386be32a957e3a4753c852b4b541d00a,1,5,0,5,1,2013-08-30 04:21:07,2013-08-30 04:21:07
f5676467386be32a957e3a4753c852b4b541d00a...0aa4eecee15117329edc2105fd2d89f4275ec573,1,5,5,10,2,2013-08-30 05:14:21,2013-08-30 05:14:21
24d45f26ebb2cc895198e6806f88f143828845a8...604c3b2efca306151181d2c13353721a84349da4,1,4,4,8,4,2013-09-01 08:46:18,2013-09-01 08:46:18
9616768659010979cd20f587791e966be38868d8...e2c6d329974ac16fab28962fbed089b745a036a5,1,6,1,7,2,2013-09-01 08:21:27,2013-09-01 08:21:27
e2c6d329974ac16fab28962fbed089b745a036a5...129d8fcebc3e43a7dd03abd2baa8e8134f8e28f3,2,9,0,9,2,2013-09-01 08:27:20,2013-09-01 08:27:20
129d8fcebc3e43a7dd03abd2baa8e8134f8e28f3...e8f7d4fcef07a09c2ef767149d7e93a727b3732e,2,14,17,31,3,2013-09-01 08:34:21,2013-09-01 08:34:21
e8f7d4fcef07a09c2ef767149d7e93a727b3732e...62477653e70270ec386207f5d2d9fcfa0c66fc75,8,27,15,42,12,2013-09-01 09:00:40,2013-09-01 09:00:40
62477653e70270ec386207f5d2d9fcfa0c66fc75...d28abc4bf15ab00c7c7587f2fd520218ed6283f1,3,14,9,23,3,2013-09-01 09:03:19,2013-09-01 09:03:19
7f6210cea4f19a2f30892577e27744df02e1458a...dfda3dfe3727fdd292d73cb7d9de5699527e3216,2,3,3,6,2,2013-09-01 08:07:15,2013-09-01 08:07:15
c0f6d722b02c8dcf167cc5f55fcfbadaf34d58a2...07075456b7ec16e095dbbf1a2c3faea08e3ab8c2,1,1,1,2,1,2013-09-04 21:09:22,2013-09-04 21:09:22
07075456b7ec16e095dbbf1a2c3faea08e3ab8c2...d10ed7ef5e5ca3b8e4babcde12b9ee9a253f9336,1,8,8,16,4,2013-09-04 21:15:51,2013-09-04 21:15:51
d10ed7ef5e5ca3b8e4babcde12b9ee9a253f9336...a9b58181c6575e6d49c5d5d99132afbc4f079726,1,1,1,2,1,2013-09-04 22:25:07,2013-09-04 22:25:07
c0f6d722b02c8dcf167cc5f55fcfbadaf34d58a2...1c4bdb053bc526be1719b919b8a41b1248158cd5,4,55,8,63,8,2013-09-04 20:56:32,2013-09-04 20:56:32
1c4bdb053bc526be1719b919b8a41b1248158cd5...44fddf1c3e42bb2a67d9a65c434fa24919526c8b,1,8,8,16,6,2013-09-05 00:46:25,2013-09-05 00:46:25
e7d6af003e6af02c26cc8864da72dc807f8f97a1...9f30f557213f1e8f821414473550639f5f93f29a,1,1,1,2,1,2013-11-11 17:21:34,2013-11-11 17:21:34
9f30f557213f1e8f821414473550639f5f93f29a...24e3a8b859aa82707c53fd22dd785195fbb45c59,1,37,0,37,1,2013-11-18 14:29:10,2013-11-18 14:29:10
1bb000118971a5c68d8e7ececfb098ceec18d8b3...922cd046ef897a115d4db13e8fa6327d7b0a97ad,3,3,3,6,3,2013-12-18 23:13:50,2013-12-18 23:13:50
82bbccde9bc91543e7b1a4612d4d87c75c737bba...21e2ae94897376ff0303144a703f7eb54be9bf3c,3,4,1,5,3,2013-11-30 22:53:54,2013-11-30 22:53:54
21e2ae94897376ff0303144a703f7eb54be9bf3c...d2f8b5327b36b9a9839d595070d841146aa4c6ab,3,133,133,266,7,2013-11-30 22:58:35,2013-11-30 22:58:35
d2f8b5327b36b9a9839d595070d841146aa4c6ab...7aa6b4190be5316756fa179bb192258ce3b47548,3,12,1,13,4,2013-11-30 23:57:25,2013-11-30 23:57:25
7aa6b4190be5316756fa179bb192258ce3b47548...6a2ca0ab3a00a41bcd3c274af552f8a6e5c408fc,1,2,2,4,1,2013-12-01 00:08:49,2013-12-01 00:08:49
6a2ca0ab3a00a41bcd3c274af552f8a6e5c408fc...9bbdb87150dc8a324ce641380042fadd84d6d34e,1,2,2,4,2,2013-12-01 00:16:24,2013-12-01 00:16:24
9bbdb87150dc8a324ce641380042fadd84d6d34e...67d4e3323d322ec7c6719204ca02732576c7ee7e,3,3,3,6,3,2013-12-01 00:18:07,2013-12-01 00:18:07
98980b0fb2ebc813ac7cdb7b47dafd95c9d35db3...0e8baab34ae21c813afb9d8c24b3cb2105aebc46,9,219,129,348,34,2013-12-12 06:37:59,2013-12-12 06:37:59
e148923f2764d0af6f7d6fb1b601840d241759b5...000b445a042cc97d21d743ef917a35c23dde2a3e,3,1,5,6,3,2013-09-22 14:19:37,2013-09-22 14:19:37
e148923f2764d0af6f7d6fb1b601840d241759b5...c938c4438f9ee0c0226de6f65f5aa0a22c297c6f,1,1,1,2,1,2013-09-20 17:43:47,2013-09-20 17:43:47
e148923f2764d0af6f7d6fb1b601840d241759b5...2304ba6a256b55f79772ace77a04466790bcb161,1,13,23,36,4,2013-09-20 16:06:48,2013-09-20 16:06:48
229469e0598a230c8b11890d128a57618df838d4...8aa5181126d9480eef502403aa98e469a3597826,34,75,75,150,51,2013-09-23 20:02:26,2013-09-23 20:00:43
8aa5181126d9480eef502403aa98e469a3597826...f503efc49086becc312665000fcbce4b9df3750d,1,1,1,2,1,2013-09-23 20:02:33,2013-09-23 20:01:11
229469e0598a230c8b11890d128a57618df838d4...c4e7e3c933db27bf82b4190ed9c522bd1850c82f,2,7,15,22,7,2013-09-23 19:46:57,2013-09-23 19:46:57
229469e0598a230c8b11890d128a57618df838d4...29935e4e26df6768e8bd710dbd33a3c5fb757153,1,1,1,2,1,2013-09-23 19:06:33,2013-09-23 19:06:33
6baf266cdaf150de5f7deddb6d410cb8cb8de52a...3c73904e1728df9bfb6e6b7dfe3b3b732d066784,2,2,2,4,4,2013-12-27 02:27:43,2013-12-27 02:27:43
3c73904e1728df9bfb6e6b7dfe3b3b732d066784...cd0ad94aae42926e2bf86c2f14c6a8856c9b34ff,3,5,2,7,5,2013-12-27 02:30:16,2013-12-27 02:30:16
abad169f4beff8f2ee1f49074eb2df82f477b5db...607b802d2fe8bcf536198d44dd1914212d3b208d,1,1,1,2,1,2013-09-19 22:49:53,2013-09-19 22:49:53
abad169f4beff8f2ee1f49074eb2df82f477b5db...7823136a797f199ff77c022873d9a1091e4c2d8d,1,2,3,5,2,2013-09-19 18:48:16,2013-09-19 18:48:16
7823136a797f199ff77c022873d9a1091e4c2d8d...c6eca2c9ca8db3ece7c4492b15c25e0d677fa7a5,1,2,3,5,2,2013-09-19 18:49:16,2013-09-19 18:49:16
abad169f4beff8f2ee1f49074eb2df82f477b5db...73403b78cc9ac12add21cefca2d8bd4109bd333a,1,1,1,2,1,2013-09-19 14:41:06,2013-09-19 14:41:06
a7ceefc41b9b8ec2261ca786d0ce164c6f36b9e1...5a826a65b29f5c89a0c60bede111be7992027a0a,1,3,0,3,1,2013-12-03 18:49:37,2013-12-03 11:07:57
5a826a65b29f5c89a0c60bede111be7992027a0a...f2dab82d307259c9029e21fc5020ada482b0df7c,1,8,0,8,1,2013-12-03 19:06:31,2013-12-03 19:06:31
f2dab82d307259c9029e21fc5020ada482b0df7c...199872418c1d0aac6e79218cfb86ba2b751e571e,1,1,1,2,1,2013-12-03 19:14:13,2013-12-03 19:14:13
122245fe87bbd293a82ffa6b9c37d8b174b3dc0f...f6fe62cdf7327902267e89a79d78d42ee24db5b4,2,2,1,3,2,2013-12-15 22:13:25,2013-12-15 22:13:25
f6fe62cdf7327902267e89a79d78d42ee24db5b4...f5c13a3e1b2beef5e3335a710993ff8b383d76f7,4,29,29,58,7,2013-12-15 22:14:09,2013-12-15 22:14:09
a245c0d1cd6d82b5e1cdedd5039ba572e3b4373b...e521ee83094f5a70978cc9d879f400c3ac95369c,1,15,3,18,4,2013-09-03 02:52:59,2013-09-03 02:52:59
a245c0d1cd6d82b5e1cdedd5039ba572e3b4373b...d132c48ec9cc30de867188113ecc6d94b383996b,1,1,1,2,1,2013-09-02 09:47:04,2013-09-02 09:47:04
0c714c32f92391b6cda1657219295df57200befe...4cfe307abeee4f0193a0bcbc54aad08d1115b002,3,11,1,12,5,2013-10-26 13:13:34,2013-10-26 13:13:34
a58c83a317f9fa741fe2f6df213616d5538b5c9b...ca6729e3d3a3e26d71d6c5a8b3c14ca7e8bdf53e,1,1,1,2,1,2013-10-25 15:45:49,2013-10-25 15:45:49
53047fa587fc8ca5cc0cad751f71fca5470d453a...8dfe93d0b95939f36476105792592d7da7bf3c6a,1,19,2,21,3,2013-12-01 07:38:39,2013-12-01 07:38:39
8dfe93d0b95939f36476105792592d7da7bf3c6a...556d6cef3e1e5b9b6aeef42fb44d2eafcf2f38a7,4,8,8,16,4,2013-12-01 08:20:47,2013-12-01 08:20:47
8812856de1ce17bb2f482c75370fb2e3db7ac6de...e3aa3586966b59def58de095e5143f4006704e0a,1,1,1,2,1,2013-12-31 21:57:35,2013-12-31 21:57:35
162d9e1776ef55d741ffc80f8694c16c40de32ca...76f0d0ff32b6946dbd8c667a517a4deb69ad8890,5,23,20,43,21,2013-12-30 02:57:22,2013-12-30 02:57:22
76f0d0ff32b6946dbd8c667a517a4deb69ad8890...8a62f211131e2a5be7b7413281845c2f66716be4,3,3,3,6,3,2013-12-30 03:01:32,2013-12-30 03:01:32
30127a4296476f0b21acac8b919e74806dd5e474...f0c6ac0b709fe7ea95ddd52f5799e10d1fd262b0,4,0,0,0,0,2013-10-28 13:52:04,2013-10-28 13:52:04
30127a4296476f0b21acac8b919e74806dd5e474...f9eec5b60a1e84c6ffa1ae6bd53b9e064018d961,3,6,1,7,4,2013-10-28 08:59:24,2013-10-28 08:59:24
3431f32349815aa1ea05a46a6ed7d58984e59a3d...4ce1b08c32013cca8094c71463f088c9b406c5e9,1,1,1,2,1,2013-10-14 16:22:31,2013-10-14 16:22:31
3431f32349815aa1ea05a46a6ed7d58984e59a3d...b3c04c95d3d378f8473e76169e40e044895ec849,2,4,4,8,4,2013-10-14 13:06:58,2013-10-14 13:06:58
70278a4e4f6c2e9079d72a2993b69efd3a965ba0...4dffe7d2e31958955818dd5847901bd36215971b,1,1,1,2,1,2013-10-16 13:39:45,2013-10-16 13:39:45
70278a4e4f6c2e9079d72a2993b69efd3a965ba0...5c64ef393caf1331129e2360e1b7f3aaf1e5150e,3,3,3,6,3,2013-10-14 17:58:12,2013-10-14 17:58:12
a28b2cb9e1e68f0862f90a93d938dd68f0f0f0c6...25b7a5200d396145943f5b651792b868a95c663a,1,1,1,2,1,2013-10-17 18:21:06,2013-10-17 18:21:06
a9b86cbfde788b2ffc066353b4f77c45345c0e78...9edec7ed2193b0ffdf093188b0a63231bd813c8a,1,2,1,3,1,2013-12-07 23:57:17,2013-12-07 23:57:17
9edec7ed2193b0ffdf093188b0a63231bd813c8a...0bf5202b92d12ee19f65c7aa3bcf25c64835f459,1,0,8,8,2,2013-12-08 00:21:46,2013-12-08 00:21:46
0bf5202b92d12ee19f65c7aa3bcf25c64835f459...74408de61901b9bd4b7c1f6632ddebc8d21fb167,1,1,1,2,1,2013-12-08 00:22:00,2013-12-08 00:22:00
74408de61901b9bd4b7c1f6632ddebc8d21fb167...5e6f9b9a376bdacc8269ccb1b57c22d8f8f4112c,1,1,1,2,1,2013-12-08 00:22:43,2013-12-08 00:22:43
5e6f9b9a376bdacc8269ccb1b57c22d8f8f4112c...5fdd917918b9470ae3b0ec30ee89c8e20a14c157,2,814,806,1620,7,2013-12-08 00:28:29,2013-12-08 00:28:29
5aa4c5cb0c1b8bed3a4bb6b6a867f48b4a59f2fb...d8fab5aa6e828567feaa4cb3a171255e29f42165,3,8,1,9,8,2013-10-21 05:41:57,2013-10-21 05:41:57
5aa4c5cb0c1b8bed3a4bb6b6a867f48b4a59f2fb...e486bb4f39e79dd55b3c68af134a4624b2fa4c08,4,30,3,33,10,2013-10-21 03:30:16,2013-10-21 03:30:16
e486bb4f39e79dd55b3c68af134a4624b2fa4c08...c71f89518f88d05e4a2f202264498ac85242fcbd,1,4,3,7,2,2013-10-21 04:11:51,2013-10-21 04:11:51
c71f89518f88d05e4a2f202264498ac85242fcbd...76baacf2c94bec03273639ef0ed966dad87cf37a,3,4,5,9,8,2013-10-21 04:12:09,2013-10-21 04:12:09
ecc6d9873ff3f69b69a92fe739d8e20fd68e63cd...ecadbe56f71296aee26c48a504c248081c12600c,1,1,1,2,1,2013-10-20 23:53:45,2013-10-20 23:53:45
6ed5a844a8ca3582240ddda70d63a3d7bfea7c50...62299240d82b0024d6b369d2f38165b1a51e77a4,1,200,200,400,200,2013-11-21 21:59:12,2013-11-21 21:54:02
6ed5a844a8ca3582240ddda70d63a3d7bfea7c50...d873af866216c0c04a2457963cb1761444cd0b81,1,1,1,2,1,2013-11-21 17:13:05,2013-11-21 17:13:05
6ed5a844a8ca3582240ddda70d63a3d7bfea7c50...bf62a6241ac6c3d0de4c76d6048b679a7473c20f,1,1,1,2,1,2013-11-21 06:04:48,2013-11-21 06:03:06
d5cd040f57b5b1036a7a927332a3220cceefae43...108d10a920449d113f6bf446941683a05607db3c,5,26,35,61,16,2013-08-19 02:50:53,2013-08-19 02:50:53
108d10a920449d113f6bf446941683a05607db3c...03ba9ed9ed20f02b2d9254bcd72e92eba78af249,1,3,3,6,2,2013-08-19 02:53:28,2013-08-19 02:53:28
03ba9ed9ed20f02b2d9254bcd72e92eba78af249...e6ff75bcea01a75306e7a747103b0647bec909af,5,42,35,77,11,2013-08-19 02:57:25,2013-08-19 02:57:25
d5cd040f57b5b1036a7a927332a3220cceefae43...bab51d27ace206c9c691ab7a43657774cbd2b852,10,47,25,72,26,2013-08-19 02:40:57,2013-08-19 02:40:57
bab51d27ace206c9c691ab7a43657774cbd2b852...0615142834343af8c40cd7ad47c498431745f080,1,15,29,44,20,2013-08-19 03:08:03,2013-08-19 03:08:03
5d1c7216361ab02fa53338df91a734aed196a802...c3c700fd02dc1fbd096bd5926960dd9b80b8169d,1,1,1,2,1,2011-11-06 00:07:55,2011-11-06 00:07:55
0a268389cef3986fbdf67c361057c7cb543504c4...e87daa907877e5727ae054e83dc2de55153e9358,4,14,9,23,9,2011-11-04 20:44:25,2011-11-04 20:44:25
e87daa907877e5727ae054e83dc2de55153e9358...32086c7de59b9a17701aa689225e369d15ac454a,1,5,5,10,5,2011-11-04 20:46:03,2011-11-04 20:46:03
069ef6a020dc177bbf4e18a9b425af36b3395ecf...8a7abc7493a07935d4d91b2cc56a82523fd53970,8,190,33,223,40,2011-12-21 22:00:50,2011-12-21 22:00:50
8a7abc7493a07935d4d91b2cc56a82523fd53970...20aecb983838422c7b43e20960b10d4d79fefaa3,13,260,113,373,25,2011-12-21 22:22:20,2011-12-21 22:22:20
20aecb983838422c7b43e20960b10d4d79fefaa3...c854ed167ce37d6a008723c78f2e6336211fff69,4,3,3,6,3,2011-12-21 22:26:21,2011-12-21 22:26:21
c854ed167ce37d6a008723c78f2e6336211fff69...af5793e1cd358862cf510a54dda2476b95a26ca8,2,4,25,29,4,2011-12-21 22:41:46,2011-12-21 22:41:46
af5793e1cd358862cf510a54dda2476b95a26ca8...00cbadf9943fea6a196cc01c7705d7f2c012bfa1,3,7,5,12,7,2011-12-22 00:21:55,2011-12-22 00:21:55
00cbadf9943fea6a196cc01c7705d7f2c012bfa1...12a0d69454a2831031035d19237d36d38bb2c2a9,2,21,32,53,12,2011-12-22 00:38:03,2011-12-22 00:38:03
7df0d1c7d18a72f401094d08afa4eaa9142fe511...1ef5fa7d6b4e50230c0c12919b0a06a9a2ac07f1,27,9618,390,10008,137,2011-12-21 02:02:47,2011-12-21 02:02:47
1ef5fa7d6b4e50230c0c12919b0a06a9a2ac07f1...0980a33b4703677e1aaf3cd949c0437512fa6f33,10,110,78,188,51,2011-12-21 03:37:41,2011-12-21 03:37:41
0980a33b4703677e1aaf3cd949c0437512fa6f33...c4364285e456013c4b66308fea86e0f1fb852817,4,44,6,50,8,2011-12-21 06:12:23,2011-12-21 06:12:23
c4364285e456013c4b66308fea86e0f1fb852817...f72a94ae2879ebfc5206dd40d5db175e13113850,12,76,51,127,44,2011-12-21 07:28:48,2011-12-21 07:28:48
f72a94ae2879ebfc5206dd40d5db175e13113850...80cb760fac507ce207a6174f8886417d32d4b5ed,3,6,6,12,6,2011-12-21 21:29:12,2011-12-21 21:29:12
bc2ae90e3adde3ddb86c02b353b8c1048cdcef8f...1d50fa77e43be353d522c19a5b955b7819388fca,9,14,6,20,6,2011-09-13 16:35:43,2011-09-13 16:35:43
1d50fa77e43be353d522c19a5b955b7819388fca...35bc3ae8d22bdd4eadfbe523fe52737523e2af37,1,0,11,11,1,2011-09-13 16:44:43,2011-09-13 16:44:43
35bc3ae8d22bdd4eadfbe523fe52737523e2af37...121b62d54e6adb5836a1e09834056cf193407bbe,2,82,14,96,23,2011-09-13 17:08:24,2011-09-13 17:08:24
121b62d54e6adb5836a1e09834056cf193407bbe...2af3eb6ce28056ed76e6a2a96056e54e003968d7,4,20,13,33,5,2011-09-13 21:47:18,2011-09-13 21:47:18
2af3eb6ce28056ed76e6a2a96056e54e003968d7...01d9cd88e84441d1d1e70300f71e1feff4be2126,1,0,0,0,0,2011-09-14 03:24:30,2011-09-14 03:24:30
01d9cd88e84441d1d1e70300f71e1feff4be2126...32a690af985661f7d106984dc5ee1c211d0da2ed,3,19,1,20,4,2011-09-14 05:23:08,2011-09-14 05:23:08
201088cb5f9ab4af062b62ac3a10a2e8f07a6ec5...dd9c5fdb08a8445fc44117386ca3bead38b717a9,1,1,1,2,1,2013-12-27 20:27:51,2013-12-27 20:27:51
45e65eef3d3b97e4a13478d1af960f0476a89841...00cb50a41aa10789fcf36309a76343112f53e6d7,7,160,196,356,161,2014-02-05 03:27:25,2014-02-05 03:27:25
00cb50a41aa10789fcf36309a76343112f53e6d7...7861f6e8a50bc50d737366f1c89f248321383875,1,1,1,2,1,2014-02-05 18:45:05,2014-02-05 18:45:05
7861f6e8a50bc50d737366f1c89f248321383875...f16a2376c11ac8946c4aee102ff141117815e2de,4,28,4,32,5,2014-02-05 21:46:24,2014-02-05 21:46:24
fe7fffe034f8a97aae004351ee46fe9a704a971e...a93a753c7d50aadbdb9a0243a9aa04f366855e46,4,26,8,34,4,2013-12-24 21:07:42,2013-12-24 21:07:42
216df5bb46e1910de4aaf517066f3184111263f4...a18fefe9bc9974ef6d3499ae96765e7ab89aac30,1,3,2,5,2,2013-08-31 04:03:14,2013-08-31 04:03:14
2066ea50a28119f3f890b84cabeb9214a346a1b5...5418a7224346feaab6bf32a2fe9831d9a7a6d1b3,1,6,3,9,2,2013-09-01 08:35:56,2013-09-01 08:35:56
604c3b2efca306151181d2c13353721a84349da4...93694898838b479d2806c53c827847f724312bcc,1,1,1,2,1,2013-09-01 11:14:55,2013-09-01 11:14:55
604c3b2efca306151181d2c13353721a84349da4...d2e1fef34ac887937007e3459ec06c91c8b04ee6,1,2,2,4,1,2013-09-01 09:09:12,2013-09-01 09:09:12
dfda3dfe3727fdd292d73cb7d9de5699527e3216...a7863c112d9b990d4da7a9c9052f58a42b855a02,1,1,1,2,1,2013-09-01 08:09:28,2013-09-01 08:09:28
a9b58181c6575e6d49c5d5d99132afbc4f079726...fbd7f2e052280f1e4ccdf7654be2e97c43ef4594,1,36,8,44,12,2013-09-04 22:53:37,2013-09-04 22:47:38
fc8e66d2cb5004cd815b15cf69a860040201a337...124c80b30a3dccbc5718873d546b0912b91795a1,1,4,0,4,1,2013-09-05 00:58:01,2013-09-05 00:58:01
124c80b30a3dccbc5718873d546b0912b91795a1...56c8826c770376840d1873f4e524f096ab5c686d,1,6,1,7,2,2013-09-05 01:52:45,2013-09-05 01:52:45
e98c2dc3adfb3e480012454bb5f170c48cf99c45...88a8669656bd519369dde745b4964c439b4e09a5,1,33,0,33,1,2013-12-15 03:31:03,2013-12-15 03:31:03
88a8669656bd519369dde745b4964c439b4e09a5...4da03c83c5f850afc3211438227ba16d34c580e1,1,16,16,32,16,2013-12-15 03:31:20,2013-12-15 03:31:20
e98c2dc3adfb3e480012454bb5f170c48cf99c45...39a2dab722c2cccc8bb70ce43599211357d96f16,2,25,9,34,5,2013-12-15 03:11:04,2013-12-15 03:09:44
922cd046ef897a115d4db13e8fa6327d7b0a97ad...ccc894361f2c1fd8f403723e30aca6ff4beafa1f,1,28,33,61,1,2013-12-18 23:26:07,2013-12-18 23:26:07
922cd046ef897a115d4db13e8fa6327d7b0a97ad...5428523a3762ae274dffe3d2e7a4a434e6ff70f3,1,1,1,2,1,2013-12-18 23:16:29,2013-12-18 23:16:29
67d4e3323d322ec7c6719204ca02732576c7ee7e...359ac8f66a4f3de6ea4f5ab9cbe409879f3eeb90,1,1,1,2,1,2013-12-01 00:21:19,2013-12-01 00:21:19
359ac8f66a4f3de6ea4f5ab9cbe409879f3eeb90...6bc09dd94949e05827c541795e4133b0cdbf7cae,4,40,1,41,9,2013-12-01 00:29:52,2013-12-01 00:29:52
57b59fcfd02799915d9bf4fc19f30cfa71b2d66c...7545da2e3c5488b1bcc9c70fecac759232466756,5,13,13,26,12,2013-11-15 07:58:29,2013-11-15 07:58:29
4fc2907723e7f7bb5b14eb5cec94d629b6834e7f...da24a3e1186561ec34c175889931c4cbb5dc680b,1,1,1,2,1,2013-12-12 18:28:37,2013-12-12 18:28:37
da24a3e1186561ec34c175889931c4cbb5dc680b...f8a78d7de7a1ffa9fea1e02ccf1806e221e7c98a,1,4,4,8,4,2013-12-12 18:28:43,2013-12-12 18:28:43
f8a78d7de7a1ffa9fea1e02ccf1806e221e7c98a...0b4efcda9084183b4f8e60cf039707e25a40361a,2,79,38,117,18,2013-12-12 22:57:43,2013-12-12 22:57:43
0b4efcda9084183b4f8e60cf039707e25a40361a...d704bf0a520f0afa1598c5683cee18c1759ca41c,1,1,1,2,1,2013-12-12 22:59:25,2013-12-12 22:59:25
d704bf0a520f0afa1598c5683cee18c1759ca41c...885d14b0421eb6b5889fcc7fbe1f395039912219,3,807,804,1611,3,2013-12-12 23:21:34,2013-12-12 23:21:34
885d14b0421eb6b5889fcc7fbe1f395039912219...d2d2f77ffe7d6be3cb3ff7934ab2a5734abb1cc5,1,1,1,2,1,2013-12-12 23:21:49,2013-12-12 23:21:49
d2d2f77ffe7d6be3cb3ff7934ab2a5734abb1cc5...0cb570724dbfb266b363d0e5e27385077976dd65,1,1,1,2,1,2013-12-13 02:10:58,2013-12-13 02:10:58
d8ba5989cdda82121d865142306d1d86034d81d4...68c6deebda40a2a7b6f5f668fc26340509765bf1,1,1,1,2,1,2013-09-20 18:49:32,2013-09-20 18:49:32
9ce142ca1296ca4b8349f474f1c044e29cc4b69f...b80f58b336cd7a4b59d704ff4c311cbf8edf5e51,4,43,1,44,6,2013-09-24 05:34:36,2013-09-24 05:34:36
cd0ad94aae42926e2bf86c2f14c6a8856c9b34ff...d21369c1ed97d5719f6ccf360602150fc8ed16b3,4,34,30,64,12,2013-12-27 03:40:18,2013-12-27 03:40:18
199872418c1d0aac6e79218cfb86ba2b751e571e...7a9d9f7dc485bcd624c1e49c99029c9d2d410e11,1,2,4,6,2,2013-12-03 19:22:56,2013-12-03 19:22:52
9023c087dbc17e206d830f36a5049d95aa548b36...393d523cdbf14c4522ed13dca701120aeded352c,4,11,5,16,8,2013-12-15 22:23:55,2013-12-15 22:23:55
bfd8f8c83a5e135e1bc0f9bce5bf2f95370613bb...a1f737b43632f4615d54ec993dc645f858e3ca8d,2,5,1,6,2,2013-12-07 20:19:17,2013-12-07 20:19:17
54b75ffae314f43e5502a81df252246c3fd8056b...49373b9b45facc07e6a99223021536c9878dd2b2,4,13,8,21,5,2013-09-03 03:20:47,2013-09-03 03:20:47
49373b9b45facc07e6a99223021536c9878dd2b2...36afdbcaac504117d515240cc7294c3fcbde4e45,1,33,11,44,6,2013-09-03 07:49:59,2013-09-03 07:49:59
93dc003a83c5177149786b5f68699b259de60d2a...5d88943a52f9438d6e76c51e4315f603353b8b36,1,1,1,2,1,2013-09-02 12:36:54,2013-09-02 12:36:54
073f8c049d9d669bfc57315e7b3267ab422e599c...c77740bd3abf379ba5880219fc5719eaa0e484d6,5,51,6,57,8,2013-12-25 00:29:51,2013-12-25 00:29:51
c77740bd3abf379ba5880219fc5719eaa0e484d6...d9266aee969b2ad57851fffd77409a997ee157d1,1,40,0,40,1,2013-12-25 00:37:53,2013-12-25 00:37:53
f2f70a4a7428c2ada0aae2201a007b007d38fd7b...7b24f3c47c195b5519ddc2904840db98858ec015,4,18,18,36,15,2013-10-25 21:14:30,2013-10-25 21:14:30
556d6cef3e1e5b9b6aeef42fb44d2eafcf2f38a7...dd05c0e0a729a5601b4eec2bc2116a343b7ccbed,1,1,1,2,1,2013-12-01 21:51:17,2013-12-01 21:51:17
e3aa3586966b59def58de095e5143f4006704e0a...83d26de6d5da1e25ebc647a63066f0f8f4549bd5,1,5,6,11,3,2014-01-01 01:47:16,2014-01-01 01:47:16
83d26de6d5da1e25ebc647a63066f0f8f4549bd5...50cf0b1a9d883ae3c4054dfd4071963fdf8aa812,8,17,7,24,9,2014-01-01 02:23:10,2014-01-01 02:21:41
b253cb2c1e34a41940c4933fb95c46da833fc5f9...905adb5b838e58558195f45935b908e0980be7cd,4,3,3,6,3,2013-12-31 21:56:20,2013-12-31 21:56:20
0026e5655b7bff8a1c609e52bdfba946436f4616...d1dd1fcdee3a081dc2aa9874ba20ae5584652a01,1,4,0,4,1,2013-10-28 18:07:56,2013-10-28 18:07:56
d1dd1fcdee3a081dc2aa9874ba20ae5584652a01...4b8c66269894b3110ca74815dff134af7713d463,1,9,12,21,2,2013-10-29 04:19:09,2013-10-29 04:19:09
4b8c66269894b3110ca74815dff134af7713d463...96d7d4a489ef937657ba235dc384f92ef6c5a76e,1,1,1,2,1,2013-10-29 04:48:57,2013-10-29 04:48:57
dcf51315a3da3755248bc06c1131f335de5e5c62...67cab7fa05b31d5e9579a9b96c95a434489f5548,3,16,1,17,4,2013-10-29 03:51:39,2013-10-29 03:51:39
67cab7fa05b31d5e9579a9b96c95a434489f5548...c6e76d97bab6f174f2f877433985cb11ff9368b1,3,1,9,10,9,2013-10-29 04:19:48,2013-10-29 04:19:48
0d81c4e33993e6d8c2e83f80a0030ae6453c60e5...ed29a99df4f9573a2f312093f3aaac9acf2b9c02,1,1,5,6,1,2013-12-01 08:18:27,2013-12-01 08:18:27
0d81c4e33993e6d8c2e83f80a0030ae6453c60e5...ab87085625189282b9f6357e50416a21a532b790,2,2,2,4,2,2013-11-30 15:11:41,2013-11-30 15:11:41
25b7a5200d396145943f5b651792b868a95c663a...5f79354dbea3ec5b0d99d2b6cd2376f3e4ee268e,1,1,1,2,1,2013-10-17 19:25:08,2013-10-17 19:25:08
5fdd917918b9470ae3b0ec30ee89c8e20a14c157...73bc7d9f12b24ac71eed830ac1c345e890bc27c3,4,345,2,347,4,2013-12-08 04:51:25,2013-12-08 04:51:25
73bc7d9f12b24ac71eed830ac1c345e890bc27c3...6273604601c58284f49b38ae4e52533b9689437c,6,85,17,102,15,2013-12-08 04:52:51,2013-12-08 04:52:51
6273604601c58284f49b38ae4e52533b9689437c...90cbfc76e48659ac657ab272df9d37f99ca57cd4,4,246,2,248,5,2013-12-08 07:23:41,2013-12-08 07:23:41
6ecb5d6cf372ab4f7391503e0fb2e754a57d8d3b...6585c5898a47deb2df5f7db4f9ef3fe8fa1e5a4a,1,3,0,3,3,2013-10-21 05:46:21,2013-10-21 05:46:21
ecadbe56f71296aee26c48a504c248081c12600c...f45c05a97a4dda6a657ff89fcbfa283308d0b329,3,1,3,4,3,2013-10-21 00:40:19,2013-10-21 00:40:19
b34292ce82a622656dfec4d71cfde74e71abfdbf...ccd564650abd7024e81b69311c1f6bf75e1e9bab,2,2,2,4,2,2013-11-21 20:02:54,2013-11-21 20:02:54
c3c700fd02dc1fbd096bd5926960dd9b80b8169d...b15e24e3d460ef2cbe20f13c648b42024be096fa,3,17,3,20,7,2011-11-06 21:49:00,2011-11-06 21:49:00
32086c7de59b9a17701aa689225e369d15ac454a...f03679805e843674736dd84ae165f96b2d6983e5,4,8,7,15,5,2011-11-06 00:06:41,2011-11-06 00:06:41
32086c7de59b9a17701aa689225e369d15ac454a...f6a258ef36c0e9383b35e8f33cda14ba4718e0f3,1,5,3,8,3,2011-11-04 23:50:08,2011-11-04 23:50:08
a5a98a8a984512011dac1216b432b86c6eff96a4...6d5b5065176a9e46ce71ec5fc16ae4a079e9e636,3,10,7,17,5,2011-12-22 01:38:05,2011-12-22 01:38:05
6d5b5065176a9e46ce71ec5fc16ae4a079e9e636...efacac0d6c812abffa8a84a48fa760f5f56c92f0,9,165,298,463,55,2011-12-22 02:42:43,2011-12-22 02:42:43
efacac0d6c812abffa8a84a48fa760f5f56c92f0...87ac818253a26bcf09fa55f78ae3f55759c54e64,8,52,55,107,31,2011-12-23 03:10:32,2011-12-23 03:10:32
9fb380151d477f1741b7609ade7a9e7fd5450b2c...5de1e39a8fba831faa170f46e868068fa069dd0e,1,4,0,4,2,2011-12-22 05:41:26,2011-12-22 05:41:26
5de1e39a8fba831faa170f46e868068fa069dd0e...2ebc0ad2ef13c4eb9ab2e7b57ff6ca661687ca4e,1,24,0,24,1,2011-12-22 05:47:42,2011-12-22 05:47:42
9fb380151d477f1741b7609ade7a9e7fd5450b2c...369cedd87c4447241ce2a73ed6c8414a4cd8bdf8,4,5,5,10,5,2011-12-22 01:31:01,2011-12-22 01:31:01
369cedd87c4447241ce2a73ed6c8414a4cd8bdf8...690d3f4d1aeb97a76d22a4dfe056e33606e0bd94,3,1,41,42,4,2011-12-22 01:32:14,2011-12-22 01:32:14
32a690af985661f7d106984dc5ee1c211d0da2ed...8896497ea88037fe3e082eb7d7d9c3c3051b9b6b,3,12,12,24,12,2011-09-16 04:19:39,2011-09-16 04:19:39
8896497ea88037fe3e082eb7d7d9c3c3051b9b6b...68f89d109f1a3324267988159421f7c745d8f6b7,6,18,18,36,16,2011-09-16 05:27:41,2011-09-16 05:27:41
68f89d109f1a3324267988159421f7c745d8f6b7...39aca918d032fca589cbeb6c31cc3ef82684d0d0,3,14,20,34,7,2011-09-16 05:36:32,2011-09-16 05:36:32
39aca918d032fca589cbeb6c31cc3ef82684d0d0...5675d8f00a16d1f5c3eebbe7e9a0ec2b0f494855,3,2,4,6,4,2011-09-16 05:40:50,2011-09-16 05:40:50
5675d8f00a16d1f5c3eebbe7e9a0ec2b0f494855...472632ba51a50457370c55267a736e3efc4c09cc,9,12,12,24,11,2011-09-16 06:09:56,2011-09-16 06:09:56
472632ba51a50457370c55267a736e3efc4c09cc...d1b594db7a7307efd7de29a2875046166c69a76f,5,7,7,14,7,2011-09-16 06:16:06,2011-09-16 06:16:06
32a690af985661f7d106984dc5ee1c211d0da2ed...dcf6a051e71f73c6f53f36f4a3a9420535f70e42,4,22,1,23,5,2011-09-14 15:58:20,2011-09-14 15:58:20
dcf6a051e71f73c6f53f36f4a3a9420535f70e42...b188c0da8b51cd18d6fa3fa958e823a318ba5f10,6,22,22,44,14,2011-09-16 16:41:58,2011-09-16 16:41:58
140d24c8fb884cc74d8253687e795e91f6a5c6b1...a2aaf80c7e9f1848926e2c8817ee8475c8b30b43,3,3,3,6,3,2013-12-28 00:41:25,2013-12-28 00:41:25
5b02dbd97a0a480b0f800cb1011089dab9980300...a73767e518620e1b3fc317896e4c7ea8258152a0,1,1,1,2,1,2013-12-27 05:49:40,2013-12-27 05:49:40
a73767e518620e1b3fc317896e4c7ea8258152a0...87288da72c682e7225fdeffea957c0c2acdc764c,2,3,4,7,4,2013-12-27 06:03:37,2013-12-27 06:03:37
87288da72c682e7225fdeffea957c0c2acdc764c...84326a3e59309f1485f8b583e0bf03d3e1863377,3,119,30,149,17,2013-12-27 22:04:44,2013-12-27 22:04:44
37bfd8fa60874ee059e4fae7b77a635559e5f845...34fb5767cbe94bd379e792e8236a0f8f41d46545,4,6,6,12,6,2013-12-27 01:53:31,2013-12-27 01:53:31
a93a753c7d50aadbdb9a0243a9aa04f366855e46...f689a26a1cfa09eeeaa29137c1af7f91c94fc344,1,1,1,2,1,2013-12-24 21:43:09,2013-12-24 21:43:09
93694898838b479d2806c53c827847f724312bcc...9d2491a808a887f604c4ba091b6a1b7fc6f937b6,1,13,1,14,1,2013-09-01 19:50:24,2013-09-01 19:24:42
9d2491a808a887f604c4ba091b6a1b7fc6f937b6...f32abbb6e18b8be2fb35df06ed19b4dc7c6e0f7b,1,1,1,2,1,2013-09-27 12:04:33,2013-09-27 12:04:33
93694898838b479d2806c53c827847f724312bcc...f4fde255353e59adc7f046f9272379fd93510b86,1,1,1,2,1,2013-09-01 12:36:32,2013-09-01 12:36:32
31dfc3218e4aafca3a3963a632a22ee018362c00...6c0f20c446912276b723448b8d33a4462f2f8d29,1,16,16,32,8,2013-09-05 09:57:23,2013-09-05 09:57:23
56c8826c770376840d1873f4e524f096ab5c686d...63b61eea7fcc90db2f1839bc2cb660fee4f81075,1,18,24,42,21,2013-09-05 03:39:57,2013-09-05 03:39:57
63b61eea7fcc90db2f1839bc2cb660fee4f81075...f1fba93c1ed778e98e866cb809ddc3df109d42bd,1,4,4,8,4,2013-09-05 12:53:50,2013-09-05 12:53:50
f1fba93c1ed778e98e866cb809ddc3df109d42bd...e94b790e642976d2de53c58f1673dcf166807a87,1,10,10,20,8,2013-09-05 13:09:20,2013-09-05 13:09:20
e94b790e642976d2de53c58f1673dcf166807a87...bdb9fd9a7c3960d24784c2e7a5ba701f3abe88c6,1,2,2,4,2,2013-09-05 17:43:04,2013-09-05 17:43:04
bdb9fd9a7c3960d24784c2e7a5ba701f3abe88c6...00673991af034e2a0da03f72ac95683cea66e60d,1,2,2,4,2,2013-09-05 18:03:43,2013-09-05 18:03:43
56c8826c770376840d1873f4e524f096ab5c686d...0b0087f3a744e5e1e86a87cfa5c929b34e3ddd86,1,1,1,2,1,2013-09-05 03:33:18,2013-09-05 03:33:18
0b0087f3a744e5e1e86a87cfa5c929b34e3ddd86...121790c1062d8057b5bddedb3960ec7ceedb498d,1,1,1,2,1,2013-09-05 04:28:04,2013-09-05 04:28:04
4da03c83c5f850afc3211438227ba16d34c580e1...432b9f9cde8e2b067fd54ed148c5f8df510e30c5,3,7,1,8,3,2013-12-15 04:04:12,2013-12-15 04:04:12
766bf50b88fe3938837cb11d849f6646a77351fe...df3716647dcebc1af8abe6a2a0d5b28da687aac0,14,25,289,314,25,2013-12-18 23:29:19,2013-12-18 23:28:08
df3716647dcebc1af8abe6a2a0d5b28da687aac0...3315d4d9f4c47e67f1d1c9f6a0b262a5d8b688bd,1,1,1,2,1,2013-12-18 23:35:24,2013-12-18 23:35:24
7545da2e3c5488b1bcc9c70fecac759232466756...283c86db38df3c9273749cdd0c401e06a4e66c37,1,2,2,4,1,2013-11-17 20:15:25,2013-11-17 20:15:25
7545da2e3c5488b1bcc9c70fecac759232466756...9a8a571ad1517f9a622e5db52808fd0f905ecf16,3,4,4,8,3,2013-11-17 09:24:31,2013-11-17 09:24:31
7545da2e3c5488b1bcc9c70fecac759232466756...a2c6daafd05a54d1c944a9d6f2dc076914121117,5,5,11,16,7,2013-11-17 01:48:31,2013-11-17 01:48:31
a2c6daafd05a54d1c944a9d6f2dc076914121117...ae4d5f21a96fab3691ca33e9e3747a01c467e10e,5,5,5,10,5,2013-11-17 02:01:59,2013-11-17 02:01:59
7545da2e3c5488b1bcc9c70fecac759232466756...56f6847ed60b5a8a15861a5db31676fe9901ff41,1,2,2,4,2,2013-11-16 15:43:47,2013-11-16 15:43:47
7545da2e3c5488b1bcc9c70fecac759232466756...fbd3cf5f527af75f886eb08e22da3e4aa43c5135,1,1,1,2,1,2013-11-16 11:03:50,2013-11-16 11:03:50
7545da2e3c5488b1bcc9c70fecac759232466756...926b940e8674a7ebeef085af1860a78fcaaf813d,1,1,0,1,1,2013-11-15 23:33:23,2013-11-15 23:33:23
7545da2e3c5488b1bcc9c70fecac759232466756...f4eb3df50ad43171ae37ccd1208a5bed72cc6ecb,1,2,2,4,2,2013-11-15 16:48:24,2013-11-15 16:48:24
7545da2e3c5488b1bcc9c70fecac759232466756...1f340023e20049cc11eda3fcd3dbc0d7c3e48d49,1,2,1,3,1,2013-11-15 16:17:40,2013-11-15 16:17:40
1f340023e20049cc11eda3fcd3dbc0d7c3e48d49...9f0da54856f6a4111b4d9f8780db2b2257ef90b1,3,4,3,7,3,2013-11-30 07:29:34,2013-11-30 07:29:34
b6b2c90a7d6c00b54d844e52956334e4a0ab56cc...b93d6dfbdf1f01e5e89764d846e1f68828c61c02,1,7,6,13,6,2013-12-18 17:42:13,2013-12-18 17:42:13
b80f58b336cd7a4b59d704ff4c311cbf8edf5e51...dcfd9f27ffe7931a7fa882fe2af38d0022a1a87e,1,1,1,2,1,2013-09-24 16:52:06,2013-09-24 16:52:06
b80f58b336cd7a4b59d704ff4c311cbf8edf5e51...33e0877d21e701430f7bc185ab4e2c8b2e60f9c5,16,16,0,16,16,2013-09-24 16:43:16,2013-09-24 16:43:16
33e0877d21e701430f7bc185ab4e2c8b2e60f9c5...735105ae7274f5c6175d0b2550fc35597e09bee4,1,1,0,1,1,2013-09-24 20:49:47,2013-09-24 20:49:47
b80f58b336cd7a4b59d704ff4c311cbf8edf5e51...3663e3700540e08e9168d4066dc17b97554d9732,1,37,11,48,4,2013-09-24 06:33:20,2013-09-24 06:29:45
b80f58b336cd7a4b59d704ff4c311cbf8edf5e51...dca7be6b67df60a094c1e292871ee5be4c1edd8d,4,200,199,399,5,2013-09-24 05:41:43,2013-09-24 04:58:28
dca7be6b67df60a094c1e292871ee5be4c1edd8d...b160e61451493bfa48085a6e0e6209f4e4f6d561,1,10,10,20,1,2013-09-24 05:43:48,2013-09-24 05:06:11
b160e61451493bfa48085a6e0e6209f4e4f6d561...2d0f5565abd2d30db1f83442efff4e0b2bf60a60,1,10,10,20,11,2013-09-24 05:43:48,2013-09-24 05:30:59
2d0f5565abd2d30db1f83442efff4e0b2bf60a60...48f15faa5d7c23d4cb3a52a4d7c9a510633a2091,6,241,240,481,17,2013-09-24 05:43:48,2013-09-24 05:35:51
018a1d535b5b7310e31ba007769ca8a46fcd2f4a...2d4ee18162e4922c7cffbf0d71a7ec7fb303d2a1,1,1,1,2,1,2013-12-03 21:31:47,2013-12-03 21:31:47
2d4ee18162e4922c7cffbf0d71a7ec7fb303d2a1...bac153127c4fc9a8f7d511b1424f73f089b1cbb6,4,5,4,9,4,2013-12-03 21:54:56,2013-12-03 21:54:56
6bc7126643e42b2f2b4ef4006046757a55b8e86e...24eee65c2559950e321161965ff5afd4a4b51001,2,4,4,8,3,2013-12-15 22:32:14,2013-12-15 22:32:14
24eee65c2559950e321161965ff5afd4a4b51001...b04a1de9b097de7f4df95b30df040efe86563e75,3,12,1,13,4,2013-12-15 22:52:49,2013-12-15 22:52:49
0a5aa8e0a36875925e76a0561e81a4804d3f38b9...aac4f0189ed4d20701224d9782919bec042b427c,1,1,1,2,1,2013-12-05 06:54:03,2013-12-05 06:54:03
352f5923d768b7bfae0733844a263ad0405eb85e...dd441238815837816711216fd89bdc3665c8a6cf,1,0,5,5,1,2013-09-03 08:04:17,2013-09-03 08:04:17
d9266aee969b2ad57851fffd77409a997ee157d1...394e0fa6118febbe62ecfb431ab91fff42bdf7d8,4,6,6,12,4,2013-12-25 01:00:34,2013-12-25 01:00:34
948da5ce9ac46cf0512fbf04ce4be5e38e2e0c6c...33160d50437e1f26e1ddc7d126e528f41a8bc6a0,1,14,10,24,6,2013-12-02 02:06:57,2013-12-02 02:06:57
33160d50437e1f26e1ddc7d126e528f41a8bc6a0...d417fceceac8bec34a9f23c9a56122ba24097d35,3,18,1,19,3,2013-12-02 02:13:27,2013-12-02 02:13:27
d417fceceac8bec34a9f23c9a56122ba24097d35...25bc5322aa0edb9895cf3a1a409b586a5f7fafca,1,1,1,2,1,2013-12-02 02:35:58,2013-12-02 02:35:58
25bc5322aa0edb9895cf3a1a409b586a5f7fafca...5a0365524d8a190c718bcb4950c423c9bef75bd9,3,36,19,55,10,2013-12-02 03:27:33,2013-12-02 03:27:33
5a0365524d8a190c718bcb4950c423c9bef75bd9...118e901eb1589b14f5aab9bdb8d2cbf48883a0de,1,1,1,2,1,2013-12-02 03:30:10,2013-12-02 03:30:10
118e901eb1589b14f5aab9bdb8d2cbf48883a0de...8a74264344489e8b9e10c5c5e2098bb75116b8bd,24,41,41,82,38,2013-12-02 03:31:52,2013-12-02 03:31:52
50cf0b1a9d883ae3c4054dfd4071963fdf8aa812...0f060e7bc435e1048b7fc564673049704cc41dd4,12,24,12,36,12,2014-01-01 14:42:41,2014-01-01 14:42:41
50cf0b1a9d883ae3c4054dfd4071963fdf8aa812...1c83d68ca45adce77d8eca9bb5643db7b57b9ef7,22,23,23,46,23,2014-01-01 14:37:08,2014-01-01 14:37:08
50cf0b1a9d883ae3c4054dfd4071963fdf8aa812...e4508bb37cb5d923cfdb8359081f035ef37302ec,18,58,58,116,58,2014-01-01 14:29:13,2014-01-01 14:29:13
5729f2005410e7b6de3e152b101ad3e49b2881d7...e5c3f2d9d4fc23cda184a3ec54c9055e4f188e7a,1,3,3,6,3,2013-10-29 04:50:05,2013-10-29 04:50:05
e5c3f2d9d4fc23cda184a3ec54c9055e4f188e7a...a23740ec03a9c0f37224985c81be00f942ca6d28,1,2,2,4,1,2013-10-29 04:55:08,2013-10-29 04:55:08
265118a6a025a34f24e87cdedcaea1684c08565b...a52e528d2771e0f150682532b06c0f29fa6b0ad6,4,4,10,14,6,2013-11-30 19:56:06,2013-11-30 19:56:06
90cbfc76e48659ac657ab272df9d37f99ca57cd4...d70f4e895cfbe8915920d149bdcde8a14c9dab88,4,0,0,0,0,2013-12-08 07:49:03,2013-12-08 07:49:03
4c246c0117ea56cb10b91b635ff415ec20d9c97d...dbbd49b4f80b87dd4c7068d4974711adf78df6da,1,1,1,2,1,2013-11-23 17:29:27,2013-11-23 17:29:27
4c246c0117ea56cb10b91b635ff415ec20d9c97d...4160ff0e4497920ef2ea3a7a06b36eeb52deb6dd,1,1,1,2,1,2013-11-23 16:41:31,2013-11-23 16:41:31
f584500211af84038bcff9b363343eb02cda6ccd...1aa0eb32e3dc652afd0a1d59bb92f45d366b0c0d,1,3,3,6,3,2013-08-19 04:29:46,2013-08-19 04:29:46
1aa0eb32e3dc652afd0a1d59bb92f45d366b0c0d...2c2311c318165bc445f053854d7eace55b12b4da,1,1,1,2,1,2013-08-19 04:34:17,2013-08-19 04:34:17
2c2311c318165bc445f053854d7eace55b12b4da...74ae8ecc80ca6c416eaa317e6470ec219c51a0c0,1,1,1,2,1,2013-08-19 04:43:14,2013-08-19 04:43:14
f584500211af84038bcff9b363343eb02cda6ccd...5b3e6eb563f6f3a5836b89a8b004190e7fd40219,1,120,48,168,20,2013-08-19 04:23:53,2013-08-19 04:23:53
5b3e6eb563f6f3a5836b89a8b004190e7fd40219...988c03d4621b921ea3bf17eb358b65eab4f1a627,1,32,32,64,32,2013-08-19 04:46:09,2013-08-19 04:46:09
988c03d4621b921ea3bf17eb358b65eab4f1a627...7818c5e1868de501e2686ed1ff734c6f337bba79,1,56,0,56,2,2013-08-19 07:14:38,2013-08-19 07:14:38
3628eb79ae42ca1c398d190ca5e96108f3cd353b...4d2e32e80914dbc526dcde7c743b0537ded7c853,4,70,10,80,9,2011-11-06 02:20:09,2011-11-06 02:20:09
35fdbad24b908714ff1a1221945598527a641863...3396fc0542a5fbbed658a95f931472fc24feee56,1,1,1,2,1,2011-12-23 03:17:41,2011-12-23 03:17:41
3396fc0542a5fbbed658a95f931472fc24feee56...49fb910b11baef4ccfe9270479e8b9bf9e5e7731,3,13,17,30,6,2011-12-23 03:25:29,2011-12-23 03:25:29
49fb910b11baef4ccfe9270479e8b9bf9e5e7731...ea2346197075a30f0200665fcd2836b217f33fb3,1,2,2,4,2,2011-12-23 03:28:58,2011-12-23 03:28:58
544120264d33945c1537b6621b29c71be3405d07...058f47b33b3978bbb484e521e7fc14c6ebadc161,4,8,213,221,14,2011-12-26 23:25:25,2011-12-26 23:25:25
058f47b33b3978bbb484e521e7fc14c6ebadc161...324246e4f964437a2dfa7efbd2d1b6b039369b2c,4,10,1,11,5,2011-12-27 18:39:39,2011-12-27 18:39:39
324246e4f964437a2dfa7efbd2d1b6b039369b2c...b9adae14fc9fa64134aebb57655dd93e0a7e6ad6,1,0,1,1,1,2011-12-27 18:40:30,2011-12-27 18:40:30
b9adae14fc9fa64134aebb57655dd93e0a7e6ad6...5801c4d766205c6f1579b9c45e733df5dba3b1fe,2,19,1,20,2,2011-12-27 19:51:50,2011-12-27 19:51:50
5801c4d766205c6f1579b9c45e733df5dba3b1fe...fec02f50455c87f0e01fe74b1fb2e3cd032ade09,7,33,16,49,15,2011-12-27 21:40:58,2011-12-27 21:40:58
fec02f50455c87f0e01fe74b1fb2e3cd032ade09...3426877c894b858d89e68c72bc300cd4f670c40f,4,24,4,28,8,2011-12-27 21:51:36,2011-12-27 21:51:36
3426877c894b858d89e68c72bc300cd4f670c40f...46d2ad5e221646807fb2bd71881860462988008e,3,5,4,9,4,2011-12-27 22:08:07,2011-12-27 22:08:07
46d2ad5e221646807fb2bd71881860462988008e...e78d5f8ff33009e4c4ab57496913b43ff1e369dc,2,4,5,9,5,2011-12-27 22:25:22,2011-12-27 22:25:22
e78d5f8ff33009e4c4ab57496913b43ff1e369dc...550879cf666ec6445d1918604cb71c7202a52999,1,2,2,4,2,2011-12-27 22:50:27,2011-12-27 22:50:27
550879cf666ec6445d1918604cb71c7202a52999...53c6dbff0d6dd781df421f07acdd9e98719b41bf,5,34,14,48,13,2011-12-27 23:04:55,2011-12-27 23:04:55
53c6dbff0d6dd781df421f07acdd9e98719b41bf...704d713aadbfcd27e39226cb0d1b2243d52dde0a,3,38,1,39,4,2011-12-27 23:39:34,2011-12-27 23:39:34
704d713aadbfcd27e39226cb0d1b2243d52dde0a...553030ca7de8dac3c5180629ff84fa14173513ab,2,2,2,4,2,2011-12-31 00:01:29,2011-12-31 00:01:29
d1b594db7a7307efd7de29a2875046166c69a76f...f0d5caf0547da84c8e3b80e704510a36d8a4e39b,7,7,7,14,7,2011-09-16 18:09:26,2011-09-16 18:09:26
8ff18a9ffc9171977e58ecb517cad677ba1727b6...c579e4d5507170dd14cbfa804ccfca667bf39c28,1,1,0,1,1,2011-09-16 16:55:12,2011-09-16 16:55:12
c579e4d5507170dd14cbfa804ccfca667bf39c28...e663cfb43fdc9f0ce73865a2a9857579975ecb63,4,18,17,35,16,2011-09-16 17:14:35,2011-09-16 17:14:35
e663cfb43fdc9f0ce73865a2a9857579975ecb63...597590c15ddb324ea9eed28d5d54be020c4f1a2b,1,1,1,2,1,2011-09-16 17:15:45,2011-09-16 17:15:45
a2aaf80c7e9f1848926e2c8817ee8475c8b30b43...29e495f03cda05fd7fc362420ae86619c27b582e,6,78,2,80,6,2013-12-30 04:52:00,2013-12-30 04:52:00
a2aaf80c7e9f1848926e2c8817ee8475c8b30b43...0016b508cb0b07e943e96dd227e76d8eabb7ce2e,1,3,4,7,4,2013-12-28 22:33:32,2013-12-28 22:33:32
adab81ddcd0e48df716da18608604d90f381abbd...9e1153d0498a9e9612c1db85922642fe2aa38c2a,1,1,1,2,1,2013-12-28 00:44:00,2013-12-28 00:44:00
7eb532262fbd1112215b5a547b9285794b5360ab...9bb5c319b8364bab584cf970b942bc03d611660e,1,2,2,4,2,2014-02-06 18:39:45,2014-02-06 18:39:45
7eb532262fbd1112215b5a547b9285794b5360ab...96fd2dca020d6c43c5797cc29caec7bedb917d79,2,5,7,12,2,2014-02-06 10:37:39,2014-02-06 10:37:39
7eb532262fbd1112215b5a547b9285794b5360ab...08ff305ed7ba689238d4524b0285d37d15aaf8fa,6,18,4,22,8,2014-02-05 22:29:23,2014-01-31 05:49:37
bf3c525d0578c03a946af18c871f9690e7a72ec7...39091b0748d9825ec415a57a984a8b96a9fe2abe,1,1,1,2,1,2013-12-27 02:18:53,2013-12-27 02:18:53
c6d51be2d8ae25f4a78902ca3391b1bc800116ae...9361ebe4fdcb8a27468779bf36d6171bae549ecf,1,14,10,24,5,2013-09-03 00:01:36,2013-09-03 00:01:36
c6d51be2d8ae25f4a78902ca3391b1bc800116ae...259be69e257aa0a5eb0f160677f6e2ea75300df5,1,1,1,2,1,2013-09-02 19:24:55,2013-09-02 19:24:55
8651180ca79177aad2538d3a716fa52cb75065cb...ac244040d1054961f1e9a7a425a459ae0f30700c,1,17,0,17,1,2013-09-05 19:54:18,2013-09-05 19:54:18
ac244040d1054961f1e9a7a425a459ae0f30700c...b51579241fd37924b0d844f850b8c800f478a763,3,40,4,44,5,2013-09-05 22:10:56,2013-09-05 22:10:56
394161f281fc643d2f2ab7b7064972310730e018...b24adeb82f2ede7cac2884c7e155bb49cf23b68c,1,5,0,5,1,2013-09-06 16:22:19,2013-09-06 16:22:19
b50d4a176feb8a8a9ac0e31a64fc218dcf9769a2...17812b450cfd7a0b6b0dcdb874f09fa2cf43768c,1,1,0,1,1,2014-03-15 21:40:51,2014-03-15 21:40:51
b50d4a176feb8a8a9ac0e31a64fc218dcf9769a2...6d882a64201f2700bbb2c3a7342b4c8e447c694a,1,35,36,71,2,2014-03-14 17:16:36,2014-03-14 17:16:36
b50d4a176feb8a8a9ac0e31a64fc218dcf9769a2...74eb4882c07bf01827752f32acd3bb8eec02dcb0,1,1,0,1,1,2014-03-14 09:55:04,2014-03-14 09:55:04
bcc2c8b09e60138567b067b13a43630502463ddc...67b536ea51108c655ac59f1371f11fd8867eaf16,2,7,7,14,7,2013-12-15 05:25:57,2013-12-15 05:25:57
67b536ea51108c655ac59f1371f11fd8867eaf16...072ccd4ddad1dcf642e27497c5253ce578182719,6,131,38,169,12,2013-12-15 05:40:16,2013-12-15 05:40:16
072ccd4ddad1dcf642e27497c5253ce578182719...647e9eb0f192a18ee84b7e8a4ca162354d98cebb,2,2,1,3,2,2013-12-15 05:43:08,2013-12-15 05:43:08
647e9eb0f192a18ee84b7e8a4ca162354d98cebb...168469f545a189fa51e5d36546e7972f4748ec3f,3,7,11,18,7,2013-12-15 05:50:47,2013-12-15 05:50:47
3315d4d9f4c47e67f1d1c9f6a0b262a5d8b688bd...fe7c7ccf29bfb47bf348190837be35f1857a11fe,1,1,1,2,1,2013-12-18 23:50:59,2013-12-18 23:50:59
fe7c7ccf29bfb47bf348190837be35f1857a11fe...08854cf8a6fa4a139e3a3bf3cd0fdfc8cdff6d9f,2,6,2,8,2,2013-12-19 00:25:23,2013-12-18 23:37:46
08854cf8a6fa4a139e3a3bf3cd0fdfc8cdff6d9f...171c4b7fc4b5f9641d8ac2ed2e51d08cff2cd8f0,1,1,1,2,1,2013-12-19 00:56:41,2013-12-19 00:56:41
6b547b357aef8cadc2ddfc9ce41dc8e446cade95...ad86d9a51bca001a52969d6cae65957023e30e9c,1,1,1,2,1,2013-11-18 09:55:33,2013-11-18 09:55:33
6b547b357aef8cadc2ddfc9ce41dc8e446cade95...cdb243706e2fa4bedc359760f4955fd9fdd3fc0c,1,1,1,2,2,2013-11-17 22:07:28,2013-11-17 22:07:28
cdb243706e2fa4bedc359760f4955fd9fdd3fc0c...8aec527614608085d6cf92480abf843fbf720fdf,2,2,2,4,3,2013-11-17 22:45:42,2013-11-17 22:45:42
63206a17e87efa916a9bc67cc10bd83eb2396a4d...af4d1027671b278bdc3b0069bb7ef871bf936109,4,4,4,8,4,2013-09-25 01:02:18,2013-09-25 01:02:10
bac153127c4fc9a8f7d511b1424f73f089b1cbb6...1d20611d54e813884f3d85a35ccec81add12c6fa,1,1,1,2,1,2013-12-04 04:10:55,2013-12-04 04:10:55
bac153127c4fc9a8f7d511b1424f73f089b1cbb6...4a45650026a16d372feb1f150899e883d410a35e,4,10,7,17,7,2013-12-04 02:03:04,2013-12-04 02:03:04
bac153127c4fc9a8f7d511b1424f73f089b1cbb6...3f1e4b92eefaee617115973eba98fc7cc0905ab8,6,10,97,107,89,2013-12-03 22:13:55,2013-11-19 08:20:33
bac153127c4fc9a8f7d511b1424f73f089b1cbb6...303f8a33c354b5c8f6132574de55114b8f39a1f1,4,72,4,76,25,2013-12-03 21:57:28,2013-12-03 21:57:28
d1f15baa713764440e8335b8dbab580887caaa12...4f22670c6ecfd4239fe690719867531c18721234,1,5,0,5,2,2013-12-15 23:24:52,2013-12-15 23:24:52
4f22670c6ecfd4239fe690719867531c18721234...d9345ff7d55e3982b36f88cb7459239a773bbfda,3,12,1,13,3,2013-12-15 23:27:46,2013-12-15 23:27:46
d9345ff7d55e3982b36f88cb7459239a773bbfda...2979e4bcea25c428c801d77153dc0f663618ce20,7,184,37,221,30,2013-12-16 01:15:09,2013-12-16 01:15:09
2979e4bcea25c428c801d77153dc0f663618ce20...4ee93c9f8529cfeef56d4178b91e1ddcb0bff09c,3,24,1,25,3,2013-12-16 01:22:55,2013-12-16 01:22:55
aac4f0189ed4d20701224d9782919bec042b427c...6e9efb2024e76d72ae1b39eaa2fda9f01ff7a28f,1,1,1,2,1,2013-12-05 15:28:31,2013-12-05 15:28:31
aac4f0189ed4d20701224d9782919bec042b427c...c7e45fa4a71a17810d257e7a6dd471dccb427d8f,1,1,0,1,1,2013-12-05 10:33:55,2013-12-05 10:33:55
dd441238815837816711216fd89bdc3665c8a6cf...c2a5334dee163763004b5f42a90b13a8f6f3dd8f,1,8,4,12,4,2013-09-03 14:30:46,2013-09-03 14:30:46
dffd4ffad2b6cad7fb0bab747671d524d791054d...1e05029d1a9b8057e59b7046d08b09d75548c310,1,13,13,26,1,2013-12-25 19:22:52,2013-12-25 19:22:52
dffd4ffad2b6cad7fb0bab747671d524d791054d...d381771f6a9260a0c8c584bd3ef3ab57f8a59fed,1,2,2,4,1,2013-12-25 19:19:59,2013-12-25 19:19:59
5f328dce889823f1ec78844427a48da4c2eb6638...ec594887feff0ccdfcb934a0e63c8791cb89bb40,1,1,1,2,1,2014-01-07 21:40:23,2014-01-07 21:40:23
5f328dce889823f1ec78844427a48da4c2eb6638...8fd177bfa78d3e742486a66450465f3716cd11b2,19,258,246,504,80,2014-01-07 21:24:45,2014-01-07 21:24:45
c583b7965550e60dd51cb11b50628420291463fe...0cc4fe6ee37fd63f35288451e408a7a891a90079,1,1,1,2,1,2014-01-02 14:46:13,2014-01-02 14:46:13
70459c1454d2d4d1df87e59c9dfa359c92b310bb...9f44f17057455863cc20808fa7015e658529d6ba,4,2,2,4,2,2014-01-02 18:54:10,2014-01-02 18:54:10
1fea9656b604cd23e42be928e398969320b3b5ff...d18ba5083785052f37bc9e929fb315b144e88987,4,7,4,11,5,2013-12-30 03:40:31,2013-12-30 03:40:31
a23740ec03a9c0f37224985c81be00f942ca6d28...7df3e142ac2e55d7967ba369002a01f4a5b3d882,1,5,0,5,1,2013-11-06 07:25:40,2013-10-29 15:14:36
a23740ec03a9c0f37224985c81be00f942ca6d28...583697fec330b7f3aa3ae7dd6074d461ba91029c,12,12,12,24,12,2013-10-29 17:10:47,2013-10-29 17:10:47
a23740ec03a9c0f37224985c81be00f942ca6d28...ee9663728417dfbe9575d376c4fd2563a3787428,15,15,15,30,15,2013-10-29 16:13:35,2013-10-29 16:13:35
a52e528d2771e0f150682532b06c0f29fa6b0ad6...853b69f2dfe66a839efa6216e9e7c1a530f92f62,3,3,3,6,3,2013-11-30 20:52:08,2013-11-30 20:52:08
6d5c5105fa4037604417972eb8d2ebfc766e9bc8...23a85d6a7af6fdfdf59756515a760d332f51aa95,3,11,1,12,3,2013-10-21 00:59:15,2013-10-21 00:59:15
23a85d6a7af6fdfdf59756515a760d332f51aa95...dd34102cb6bb601c3103f2c74804d2382271c0e1,3,21,5,26,5,2013-10-21 02:54:22,2013-10-21 02:54:22
cad664e863b50bceb5d8cc310de1ff301191422f...bd44a4b5f35c38c75744e9c6cdc500f4e451c059,1,1,1,2,1,2013-11-25 19:41:00,2013-11-25 19:41:00
de2ab6453a0e7b727665f4d1d788693dbf61cb3e...a42d7ff3198ac246bec64d13363c6d911f2e71a3,1,8,1,9,1,2013-11-23 19:23:18,2013-11-23 19:23:18
74ae8ecc80ca6c416eaa317e6470ec219c51a0c0...2a2a8e9e20abbbaddecab67e8dd742cc334a9df3,1,3,3,6,1,2013-08-19 05:27:30,2013-08-19 05:27:30
b37a336417b0ef447eed78a66762be1ac0f0fba4...0c7a80c79bb9a2e1761b4af804050962aac2fe57,3,2,39,41,4,2011-11-08 19:04:26,2011-11-08 19:04:26
d725ac2feb0abc1469ff526a29de2cf426639ad2...1b43c87eafc8948c517770282a63227cd9c5d792,4,4,29,33,6,2011-11-07 01:11:08,2011-11-07 01:10:53
ea2346197075a30f0200665fcd2836b217f33fb3...1a295491b275cf55187c913db311e807eda5e989,1,1,1,2,1,2011-12-25 06:15:04,2011-12-25 06:15:04
ea2346197075a30f0200665fcd2836b217f33fb3...3aba68f832e3406fcd6687ba4687cd339ae3b42d,1,20,20,40,13,2011-12-23 14:39:29,2011-12-23 14:39:29
4ef5a90445f3adf86dd7cf96e588be1250403e84...12868933b9141ff9c63277efe36665cc7a8815df,1,11,4,15,2,2011-12-25 07:06:16,2011-12-25 07:06:16
553030ca7de8dac3c5180629ff84fa14173513ab...fb9401b355366452d310d39f51224999da4daa82,12,809,33,842,23,2012-01-05 09:34:14,2012-01-05 09:34:14
fb9401b355366452d310d39f51224999da4daa82...a13ab64870f40a67ffd85532c30620f8001d0822,1,3,0,3,1,2012-01-05 09:36:05,2012-01-05 09:36:05
597590c15ddb324ea9eed28d5d54be020c4f1a2b...08b6c47ad7ef91995abfadaef7493a1744f275a7,1,1,1,2,1,2011-09-16 17:30:47,2011-09-16 17:30:22
068010409b8738eaf92bc104fb708091fb9d20fb...6405442e66194329cafb3dad9936131fc8fe6677,1,1,1,2,1,2013-12-29 02:47:32,2013-12-29 02:47:32
6405442e66194329cafb3dad9936131fc8fe6677...5bf13914e49942409c0b21aeaf2ed756c41bd498,4,8,4,12,4,2013-12-29 04:59:45,2013-12-29 04:59:45
87219cfeca18562c0b5b4f204396501f439be794...37c21a3ac7f86f5cac904a12af897b3051170d02,2,9,24,33,5,2014-02-06 18:59:04,2014-02-06 18:51:49
119ed54bd112b369f260f96349fd1893711fea41...5769b776e5fb0dccf080878505c3c097f9c2ce3b,1,3,1,4,2,2014-02-06 21:34:02,2014-02-06 21:34:02
119ed54bd112b369f260f96349fd1893711fea41...aae64a9eba915bd4dd472c42de2e115e13c43dda,2,108,55,163,29,2014-02-06 21:10:37,2014-02-06 21:10:37
b51579241fd37924b0d844f850b8c800f478a763...cec89e20a92c3895421b4b79339be59e2764c2fe,1,1,1,2,1,2013-09-06 16:03:50,2013-09-06 16:03:34
28c230faba353a28175a71368193265617ce6bce...d475da5b0fb74562338df5b20da014d5865d1459,2,5,5,10,5,2014-03-16 04:53:15,2014-03-16 03:05:49
6d882a64201f2700bbb2c3a7342b4c8e447c694a...d787cffc5ac990efc5f0763bf32c900d8343b29b,1,1,1,2,1,2014-03-15 21:39:56,2014-03-15 21:39:56
6d882a64201f2700bbb2c3a7342b4c8e447c694a...da044d9c6923bb7472b110301b1e1d9cfc543258,1,23,0,23,1,2014-03-15 06:56:24,2014-03-15 06:56:24
da044d9c6923bb7472b110301b1e1d9cfc543258...8ab6746cbe567029400e0a50bff696599f358038,2,47,6,53,5,2014-03-15 07:30:09,2014-03-15 07:30:09
8ab6746cbe567029400e0a50bff696599f358038...bab63abee80eb2ceaa0c96b6417dde6baefa4718,2,5,5,10,2,2014-03-16 06:07:55,2014-03-16 06:07:55
bab63abee80eb2ceaa0c96b6417dde6baefa4718...4fa2d9e0ca3e3dcfc0db46329e2213550961ea7f,2,60,64,124,4,2014-04-23 10:36:49,2014-04-23 10:36:49
4fa2d9e0ca3e3dcfc0db46329e2213550961ea7f...d6d8e204e6fac2fbe77b91dd50c30bc0f2d472e4,1,1,1,2,1,2014-07-07 02:20:06,2014-07-07 02:20:06
d6d8e204e6fac2fbe77b91dd50c30bc0f2d472e4...30d1236a1d80dc085cd7925e64618a65300e0c03,1,8,3,11,3,2014-07-07 23:49:08,2014-07-07 23:49:08
1c6d303b766021f295cdf6dc322e005583af9b58...dcffbbab61fe717f5d379d417a5789b92a6ec488,2,2,3,5,3,2014-03-17 10:33:42,2014-03-17 10:33:42
168469f545a189fa51e5d36546e7972f4748ec3f...82c52a7e9d35d42df3ef3bc88bffdf5ba2bae98c,1,2,2,4,2,2013-12-15 18:38:54,2013-12-15 18:38:54
168469f545a189fa51e5d36546e7972f4748ec3f...ae170a5930106b5d36cc2a0ec47085f51c2c93f3,1,2,2,4,1,2013-12-15 10:47:23,2013-12-15 10:47:23
171c4b7fc4b5f9641d8ac2ed2e51d08cff2cd8f0...b59b37bc2cc52f3fba574cd03330d77de0be0ef2,1,137,30,167,15,2013-12-19 01:34:30,2013-12-19 01:32:32
171c4b7fc4b5f9641d8ac2ed2e51d08cff2cd8f0...b8810fb75dea59615a700e47284103e029833692,1,137,30,167,15,2013-12-19 01:32:52,2013-12-19 01:32:32
ee1c53dca054137e196467b8ca3a0ef96f74f64d...50578dda6072f104921ef1563d2928e5463f64cb,1,1,1,2,1,2013-11-18 18:58:14,2013-11-18 18:58:14
84a3aa3e0cdac2d4e3167bfde6459147d1bbca14...446f2325a6e4f730939e0fa3e12ba1f5fc53f27f,1,2,1,3,1,2013-11-18 22:22:17,2013-11-18 22:22:17
446f2325a6e4f730939e0fa3e12ba1f5fc53f27f...2172e2ea8a79f8c5d43863d83ff31b50abb391a0,1,4,4,8,3,2013-11-19 03:29:08,2013-11-19 03:28:37
5bba8744679ddead8673c003997410c71fc47000...d87e70fd49761daee24e894cf299c40af1eb80d5,1,2,17,19,7,2013-12-18 21:13:27,2013-12-18 21:13:27
d87e70fd49761daee24e894cf299c40af1eb80d5...1d0aa6e45c5ee09ee72f54f2bbdaa2f186bb9ea2,5,71,48,119,32,2013-12-18 21:40:29,2013-12-18 21:40:29
1d0aa6e45c5ee09ee72f54f2bbdaa2f186bb9ea2...bc265ac64798c01b2f35ca48ef1a65025e0c71b5,1,11,7,18,7,2013-12-18 21:52:39,2013-12-18 21:52:39
76e9d393baea6881d51b57def7b2b4f8a1a545c6...2fa03734a316e00cab283ab99d8a9e020cf9bd07,1,4,0,4,1,2013-09-25 01:48:38,2013-09-25 01:48:01
1d20611d54e813884f3d85a35ccec81add12c6fa...bd9332a58a9c75d831a1dc877ddfc9b846ef1344,5,104,49,153,9,2013-12-04 05:57:22,2013-12-04 02:42:31
1d20611d54e813884f3d85a35ccec81add12c6fa...7472c01ce2aad5fa9d79b78c21172dcc60ffc841,1,1,1,2,1,2013-12-04 04:21:54,2013-12-04 04:21:54
cf81cb60ef9e29fd5b97c7a7d213dbf80cad0be6...45930acdf7b7d03842011b1d20779f1762e99c30,3,11,6,17,7,2013-12-05 06:32:56,2013-12-05 06:32:56
a42e9163cbf6dcdd72a004a4a7c2b787478e18b0...149e7efb51a4b8c9e5eb140e3fdf5fc719cde9e4,1,4,0,4,1,2013-12-04 08:41:05,2013-12-04 08:34:38
4ee93c9f8529cfeef56d4178b91e1ddcb0bff09c...ca14b9652cb1d1adb2561fac37db0bb75c3b5838,1,4,0,4,1,2013-12-16 06:09:45,2013-12-16 06:09:45
4ee93c9f8529cfeef56d4178b91e1ddcb0bff09c...be508e043c2a5f53b352066a1628693adfa7755e,7,7,7,14,7,2013-12-16 02:13:50,2013-12-16 02:13:50
be508e043c2a5f53b352066a1628693adfa7755e...023731b4c74cac72f55299502a34eb5ef88b8db0,1,2,2,4,1,2013-12-16 02:19:10,2013-12-16 02:18:55
023731b4c74cac72f55299502a34eb5ef88b8db0...a2f7c3015eb433702163a7b307e9424816f22e7a,1,1,1,2,1,2013-12-16 02:45:56,2013-12-16 02:45:56
a2f7c3015eb433702163a7b307e9424816f22e7a...4db1d69e98c58762a2d849325a8bc82a6d422fb2,1,1,1,2,1,2013-12-16 03:00:37,2013-12-16 03:00:37
4db1d69e98c58762a2d849325a8bc82a6d422fb2...f8cee54f4bd59c4c311a39d3a1d482489125c585,1,6,6,12,6,2013-12-16 03:07:26,2013-12-16 03:07:14
f8cee54f4bd59c4c311a39d3a1d482489125c585...94bdea00541f5fd1e327cfcf8fc0dba0a8b624c0,1,32,32,64,18,2013-12-16 03:15:26,2013-12-16 03:15:26
6d03173a1aad98e75f7d33e65b411c519176c59a...73da46c8bb7e34b68ab6a8d150ba529d4db85078,2,0,2,2,2,2013-12-07 19:22:38,2013-12-07 19:22:38
73da46c8bb7e34b68ab6a8d150ba529d4db85078...4032dd0f265fc5aded7e480f349852f26a8f7c29,1,1,1,2,1,2013-12-07 19:32:39,2013-12-07 19:32:39
4032dd0f265fc5aded7e480f349852f26a8f7c29...775c29fef6d87dd91ebc6dba5980f3b59976b435,1,3,2,5,1,2013-12-07 19:40:08,2013-12-07 19:40:08
6d03173a1aad98e75f7d33e65b411c519176c59a...b8b250a5d29496db854bbc17cb3b560a9eafb3a3,1,0,1,1,1,2013-12-06 00:05:32,2013-12-06 00:05:32
6d03173a1aad98e75f7d33e65b411c519176c59a...813a4fafb6e268479e50c8ca4d84fbe2af26adb5,1,10,0,10,1,2013-12-05 16:45:22,2013-12-05 16:45:22
87df4784c12976dd8922c4eec8f6fde8ad84bfb8...6fb81f155b8e16a16e49b3fb2c0d38d516883f55,1,1,1,2,1,2013-09-03 22:33:36,2013-09-03 22:33:36
6fb81f155b8e16a16e49b3fb2c0d38d516883f55...5eead87ed73b61352126339e86a96ba7166e2754,1,0,1,1,1,2013-09-03 22:35:48,2013-09-03 22:35:48
5eead87ed73b61352126339e86a96ba7166e2754...0a78e7907d4082452e2bd41a0adf87ab3807675d,4,12,12,24,10,2013-09-03 22:49:03,2013-09-03 22:49:03
87df4784c12976dd8922c4eec8f6fde8ad84bfb8...a1b3fb339e911cd0c7d472d40cbca3e01ed221f4,1,1,1,2,1,2013-09-03 19:15:33,2013-09-03 19:15:33
a1b3fb339e911cd0c7d472d40cbca3e01ed221f4...82d19a41ba80386e4049371a17eb5fb9d3d44ee8,1,1,1,2,1,2013-09-03 19:17:30,2013-09-03 19:17:30
82d19a41ba80386e4049371a17eb5fb9d3d44ee8...488b8dad2b68c2053eb3e1b84ee624d26d8981a3,1,1,1,2,1,2013-09-03 19:21:19,2013-09-03 19:21:19
9eab6ffd1cca64363848f9c2c83978b0e1a80aed...bf5017c01c8985bc8c4c8c18fd202f003c41c044,3,3,3,6,3,2014-01-08 01:08:40,2014-01-08 01:08:40
bf5017c01c8985bc8c4c8c18fd202f003c41c044...07309edce54e72dd8cf8441b702a1c8c4eceff2e,1,42,34,76,8,2014-01-08 02:55:13,2014-01-08 02:38:37
07309edce54e72dd8cf8441b702a1c8c4eceff2e...c635d8f5474b5a84114f61161f86dc3d814d8d72,1,3,1,4,2,2014-01-08 02:57:15,2014-01-08 02:57:15
c635d8f5474b5a84114f61161f86dc3d814d8d72...ef7bf0abf8a8ecb6b19bb14cd2d38cb87373f6ba,2,3,3,6,2,2014-01-08 03:05:29,2014-01-08 03:05:29
ef7bf0abf8a8ecb6b19bb14cd2d38cb87373f6ba...c891be5e5f9bfba83e7e8ac6cd42150271eba626,3,2,2,4,2,2014-01-08 03:10:31,2014-01-08 03:10:31
c891be5e5f9bfba83e7e8ac6cd42150271eba626...a712abd06e76ff353c564f03125eaad8af4b2e74,1,1,1,2,1,2014-01-08 03:34:49,2014-01-08 03:34:49
60e6e7d4fb97242400348e7021375d361e6bad58...a53779d020fb596b14621a5682007168b51a3482,1,3,3,6,3,2014-01-03 18:55:06,2014-01-03 18:55:06
d18ba5083785052f37bc9e929fb315b144e88987...990c2392e5ff06d57ba4272de7563a42ddf3d38e,2,1,1,2,1,2013-12-30 04:25:40,2013-12-30 04:25:40
a8e0679554a1e3a34a8bce52f0b9e44a3c540c9a...8a881c78a10892102d3b303e9fc19b23f9039a91,1,3,3,6,3,2013-10-29 19:06:45,2013-10-29 19:06:45
9fbbce9b2ddfe46b87c2ef63f965c97c06a502bf...147837efaa48696debf93c62e8d872f72d866117,2,14,14,28,13,2013-10-30 15:00:32,2013-10-30 15:00:32
fa710fdb09e49511fd3d22c50f87d17ff5939e8a...ac6cfbbaad65a773590c61b82179d3b21c835338,1,11,0,11,1,2013-11-26 10:10:06,2013-11-26 10:10:06
fa710fdb09e49511fd3d22c50f87d17ff5939e8a...630fd1cff61dff336d0e91790a54d0aeb6eba5f1,1,1,1,2,1,2013-11-26 07:43:26,2013-11-26 07:43:26
fa710fdb09e49511fd3d22c50f87d17ff5939e8a...bff8ba2b794305842d7a712a1bf6e400b898b7c0,3,4,3,7,4,2013-11-25 23:19:11,2013-11-25 23:19:11
e3e408bb785abafb1c69d4b570ff26ba0d37b280...831d3215c6489486a641e2dfb29b1dc756111982,1,11,4,15,2,2013-08-19 05:45:30,2013-08-19 05:45:30
0c7a80c79bb9a2e1761b4af804050962aac2fe57...a6f055ee5e74e14ce28a5f3246d8132f680e63f5,2,12,3,15,4,2011-11-16 08:27:04,2011-11-16 08:27:04
0c7a80c79bb9a2e1761b4af804050962aac2fe57...ceeeffc14593d0a8558f56877639118dded8cceb,3,4,4,8,4,2011-11-12 08:52:18,2011-11-12 08:52:18
ceeeffc14593d0a8558f56877639118dded8cceb...1f51ce058b97117cfc3811c9695fcbe6733b70ad,3,9,7,16,5,2011-11-12 09:05:19,2011-11-12 09:05:19
04fee21121473606b425007f0d5cfd7853b1460b...076370f3f9076b177a1f9c8ba9f536faa1a58957,2,2,7,9,3,2011-12-25 06:31:39,2011-12-25 06:31:39
076370f3f9076b177a1f9c8ba9f536faa1a58957...823d89dbb23511b7ee929ddbd62661be751429d6,1,8,4,12,2,2011-12-25 06:56:01,2011-12-25 06:56:01
12868933b9141ff9c63277efe36665cc7a8815df...2d092dfeea969d82bc55a153c6a597a3e87a0a03,6,106,5,111,15,2012-01-03 00:04:01,2012-01-03 00:04:01
bdc22e71c8cbeddb1dbee9708ab68b4f23abb6f4...20add59de3f2b69aaa9c9b325dab20b13c75eaa1,18,2054,2105,4159,364,2012-01-05 18:01:42,2012-01-05 18:01:42
f8c0efbcb45ba81204488b398d1d8ef2950850c6...0c3bf7275cfe0757c876be6ba6f01cad31375923,1,1,1,2,1,2012-01-03 00:05:14,2012-01-03 00:05:14
0c3bf7275cfe0757c876be6ba6f01cad31375923...8b58a1c3d9fea740c89f48c1771a6c7dd44e1f41,4,86,17,103,15,2012-01-03 03:13:02,2012-01-03 03:13:02
8b58a1c3d9fea740c89f48c1771a6c7dd44e1f41...3fb6f6ee8670acff0c681c621b87a06a087f94be,5,158,53,211,31,2012-01-03 06:30:57,2012-01-03 06:30:57
3fb6f6ee8670acff0c681c621b87a06a087f94be...f5bcfaec2c13eb3102ffc2890a69a7c2b725ff36,3,8,8,16,4,2012-01-03 06:33:49,2012-01-03 06:33:49
f5bcfaec2c13eb3102ffc2890a69a7c2b725ff36...e89618a47f768eddf47164f89176e172b5c2972d,2,64,26,90,17,2012-01-03 06:55:51,2012-01-03 06:55:51
e89618a47f768eddf47164f89176e172b5c2972d...5661855be3da81f0a46bd99c7522a93f01706289,1,2,2,4,2,2012-01-03 06:57:04,2012-01-03 06:57:04
29033316e414748862b28eb69dfc2a6e71bd15b1...e8d9eb264c3ba8c263d37259f65eece7247b00b9,7,52,21,73,22,2011-09-16 17:51:44,2011-09-16 17:51:44
12c619f5b9149a4d3f4d24efe106504b6a8a5004...705ff7f2275ca823f71ca8dfba27a3b68119a2a4,18,127,114,241,20,2014-03-07 07:18:13,2014-03-07 07:18:13
5bf13914e49942409c0b21aeaf2ed756c41bd498...ce4a2e435268a2eeb5578cbb4ff70bfaaed0eef9,3,21,9,30,5,2013-12-30 01:53:59,2013-12-30 01:53:59
5bf13914e49942409c0b21aeaf2ed756c41bd498...a9c829bc0c75dd7723e6c74e1defaab5dbb4c00b,106,8357,73,8430,58,2013-12-29 06:47:03,2013-12-29 06:47:03
a9c829bc0c75dd7723e6c74e1defaab5dbb4c00b...f10cf21a8ff30d4af3a0452ab9a49462cd9c4faa,4,15,8041,8056,5,2013-12-29 07:05:02,2013-12-29 07:05:02
f10cf21a8ff30d4af3a0452ab9a49462cd9c4faa...70b8b330f04960091a99c159f7346ac99d22f31f,6,0,6,6,6,2013-12-29 07:08:46,2013-12-29 07:08:46
651b289e269f8806e4e30854b99410dd7c9b3c38...c4e242bdb170be26e64e859c5636f3cb0285f679,2,25,0,25,2,2014-02-10 18:34:38,2014-02-10 18:34:38
c4e242bdb170be26e64e859c5636f3cb0285f679...dc5917bedfda321b72310209d2807ea10347f7ed,4,7,6,13,6,2014-02-10 18:46:17,2014-02-10 18:46:17
651b289e269f8806e4e30854b99410dd7c9b3c38...7c1511502ed96549c1674d1cda102551afe6dd30,2,4,5,9,3,2014-02-06 23:52:26,2014-02-06 23:52:26
651b289e269f8806e4e30854b99410dd7c9b3c38...fda8d91c86a29cceab93285d920db56f7f26aaf8,2,4,5,9,3,2014-02-06 23:42:54,2014-02-06 23:39:15
b6444c6472f360a0b2a61868c3b2a9c256de32f7...26e2d7cdc948dfdd3b0646ed29c6d5c37d8df710,6,7,7,14,6,2014-02-09 00:13:30,2014-02-09 00:13:30
26e2d7cdc948dfdd3b0646ed29c6d5c37d8df710...7f88009394e72395aa7a458ae442b0c3037dbd15,1,1,1,2,1,2014-02-09 00:43:58,2014-02-09 00:43:58
96344acb3139293cc21215696afb1c58a300e456...bdb70fa471965728609d86c001384791fa44398b,1,1,0,1,1,2014-03-16 22:54:28,2014-03-16 22:54:28
c7970106a2c8edaac46b7bfa4e02aed10971a400...67d39404a2ccf6380bbd399f24499eb7659c926e,6,36,15,51,11,2014-08-03 01:41:00,2014-08-03 01:41:00
67d39404a2ccf6380bbd399f24499eb7659c926e...9d0872b74821a72f91e8604d69e6f94054ff0490,7,6,7,13,9,2014-08-03 02:05:46,2014-08-03 02:05:46
9d0872b74821a72f91e8604d69e6f94054ff0490...6424acf69ae40a916db04b5c3235f1780f11b4be,7,79,6,85,9,2014-08-03 04:16:32,2014-08-03 04:16:32
dcffbbab61fe717f5d379d417a5789b92a6ec488...86dfcd1a96396fba1e65d9ffad3c34a5d8dc41a6,2,10,3,13,4,2014-03-17 10:36:58,2014-03-09 12:04:48
8c13565e3c8a15a76a29b1131ebf0c64489c3a44...ad782ff89a9d78345d9d020744c4b0510329615f,1,3,17,20,17,2013-12-15 18:53:53,2013-12-15 18:53:53
ad782ff89a9d78345d9d020744c4b0510329615f...9a8e6195437f88fae8687e5aeeb8052797d4c6e4,1,48,48,96,5,2013-12-15 18:57:11,2013-12-15 18:56:51
02c40ab9919ee87ec8f7688133cc71f64f460013...16ff01f6299ebd3d6c35374556fcd5354081d417,1,0,804,804,1,2013-12-21 19:17:39,2013-12-21 19:17:39
16ff01f6299ebd3d6c35374556fcd5354081d417...176e35d33d1dfc5a81df58462d158e90e4cf4cd8,5,23,38,61,8,2013-12-21 21:40:42,2013-12-21 21:40:42
176e35d33d1dfc5a81df58462d158e90e4cf4cd8...12980e7ea47057d7e17c3606604c79c6450b272e,1,1,1,2,1,2013-12-21 21:42:10,2013-12-21 21:42:10
4eaa297e683ffb1e0718ea2d77d2babfae1863bc...fbb0e8b1464f065b71ee548580e701e49202ec9b,1,4,7,11,8,2013-12-19 07:29:52,2013-12-19 07:21:33
4eaa297e683ffb1e0718ea2d77d2babfae1863bc...b048ea545f06621e42d2f55afcc0ff819b5805ba,3,238,801,1039,4,2013-12-19 04:15:51,2013-12-19 04:15:23
4eaa297e683ffb1e0718ea2d77d2babfae1863bc...07da1d731a7117e1281b43e6c79c441dc47e9e48,2,2,1,3,2,2013-12-19 02:54:07,2013-12-19 02:53:32
2172e2ea8a79f8c5d43863d83ff31b50abb391a0...55af0036699573be96c4ad33a54836d31fb737b5,1,2,2,4,1,2013-11-20 21:44:44,2013-11-20 03:24:26
2172e2ea8a79f8c5d43863d83ff31b50abb391a0...ba4c5dae9b8e34e90e86ba28aa6bd5acf3351f0d,3,13,3,16,6,2013-11-19 09:24:49,2013-11-19 09:24:49
2172e2ea8a79f8c5d43863d83ff31b50abb391a0...afbdc21def8cf451e73895a6e2594e3dfa0a64e5,1,3,3,6,3,2013-11-19 03:59:09,2013-11-19 03:59:09
827fbc0a11e6920ee0b842369a5d6605ea3e4e19...1a476b623ebea6b5f95161b865fb38ddd766fa84,1,1,1,2,1,2013-09-25 02:27:49,2013-09-25 02:27:49
ed2360d05e2cccfe4fd4bf3551b992b27081febe...f8e0f166637e8e85cadf1538c809e738b781f436,1,1,1,2,1,2013-12-04 06:08:26,2013-12-04 06:08:26
3ae7e0afe9c05dff74f69980d4ae39d3bb8af58b...4ec13704d27a0138a90a59e766ce72702c5491c0,1,1,1,2,1,2013-12-06 00:03:35,2013-12-06 00:03:35
4ec13704d27a0138a90a59e766ce72702c5491c0...dde53a56e0a5b1e9a8c66dcccf904fd422fe5b91,1,2,2,4,2,2013-12-06 00:28:42,2013-12-06 00:28:42
7b945ad29641444133f3fb8db2b8f3e94332c3f1...4031f5ee82c2a63b6ae30320aab76083c6a488b5,1,4,0,4,1,2013-12-04 18:42:58,2013-12-04 09:16:33
7b945ad29641444133f3fb8db2b8f3e94332c3f1...89061b0517f716b9fbb7a1d7ec75afe37e051370,1,0,0,0,0,2013-12-04 12:26:12,2013-12-04 12:26:12
7b945ad29641444133f3fb8db2b8f3e94332c3f1...f7d21d6919f186dc6e760f0dc8a574dbb0c133d6,1,1,1,2,1,2013-12-04 10:15:48,2013-12-04 10:15:48
ec261a83a565cfa13d436feebd7a67360a920e9a...8142493b42935f70881f29ed67acf991029ebdcb,1,1,0,1,1,2013-12-18 17:42:37,2013-12-18 17:42:37
94bdea00541f5fd1e327cfcf8fc0dba0a8b624c0...43c3d785ef4d3ae67e097501e932fdad6751defc,1,2,0,2,1,2013-12-16 03:42:47,2013-12-16 03:42:47
cc1f95652bbf5c7d7ab5b040cdc15478d68e0369...2b4fa90902e9b911dafe76a7cd33f5bcb748a238,1,3,3,6,3,2013-12-07 19:44:32,2013-12-07 19:44:32
2b4fa90902e9b911dafe76a7cd33f5bcb748a238...107b334d349be065421967553f57aa186736ffcf,3,8,8,16,8,2013-12-07 19:45:11,2013-12-07 19:45:11
107b334d349be065421967553f57aa186736ffcf...c07632e4e8398f55d796d00b520ca43df38dbf29,4,70,70,140,9,2013-12-07 19:47:37,2013-12-07 19:47:37
c07632e4e8398f55d796d00b520ca43df38dbf29...fe58357df182b52f5905f432a3b2629c717656f1,4,40,1,41,7,2013-12-07 19:56:35,2013-12-07 19:56:35
7b06538c911f40c46ae67b0c0df7afdfbcb5d00a...b92bee99efd95a4c0ae469e3a5f4004da0164578,4,79,63,142,12,2013-12-06 14:11:58,2013-12-06 14:11:58
7b06538c911f40c46ae67b0c0df7afdfbcb5d00a...9ce7e5620c47b5ec205c42948c42fc468c05686f,1,4,4,8,1,2013-12-06 13:09:55,2013-12-06 13:09:55
7b06538c911f40c46ae67b0c0df7afdfbcb5d00a...4aad52797c9ec43c30561f481f595be178f6ab94,7,36,36,72,36,2013-12-06 10:43:48,2013-12-06 10:20:59
4aad52797c9ec43c30561f481f595be178f6ab94...5e2ef69e1cc0ee62dfe1206f25030d1f89d9e50f,3,9,9,18,9,2013-12-06 10:43:48,2013-12-06 10:23:08
7b06538c911f40c46ae67b0c0df7afdfbcb5d00a...b9ae594ca4c1dcc64849042d505828f144e79974,1,1,0,1,1,2013-12-06 10:33:20,2013-12-06 10:33:20
7b06538c911f40c46ae67b0c0df7afdfbcb5d00a...68a6e57b1507565f20f754118aede4ae4e2c9252,1,2,2,4,1,2013-12-06 09:32:57,2013-12-06 09:32:10
7b06538c911f40c46ae67b0c0df7afdfbcb5d00a...3de4f23ea210dd964748528503444bbaeed860ce,3,12,5,17,4,2013-12-06 09:25:29,2013-09-19 14:41:14
488b8dad2b68c2053eb3e1b84ee624d26d8981a3...1113224e97844675f92697ae6c6612bb5a2234d4,1,1,1,2,1,2013-09-03 19:53:52,2013-09-03 19:53:52
488b8dad2b68c2053eb3e1b84ee624d26d8981a3...7fbd8affe4c5eba842a362aecdf1a511ca1b5e24,1,3,3,6,3,2013-09-03 19:32:24,2013-09-03 19:32:24
a712abd06e76ff353c564f03125eaad8af4b2e74...9ae5d321b5b35388b7b734275963f7575b4fcc79,1,1,1,2,1,2014-01-08 03:50:58,2014-01-08 03:50:58
71688061b40d2e1bfd39b5e16ae9ae780485d43d...63df2ced6ebb173606cf53a84e8f02508823ca1f,1,5,4,9,2,2014-01-03 19:42:27,2014-01-03 19:42:27
7f20eff44def53a3c1e545a17c60f614f885e921...0e412dc1a3d1d806582fa554440b58f8766f749f,1,1,1,2,1,2013-12-30 04:45:36,2013-12-30 04:45:36
0e412dc1a3d1d806582fa554440b58f8766f749f...0fe777b271e04035d7007d5b44e8202576c965a9,1,0,1,1,1,2013-12-30 05:13:56,2013-12-30 05:13:56
0fe777b271e04035d7007d5b44e8202576c965a9...6ecdb310097617074b292d2f52971d082c3e2ec8,1,1,1,2,1,2013-12-30 05:15:29,2013-12-30 05:15:29
77bf572cba342f69d66f75c9b1c42c2451dae32f...b8f9f82d182d8300246ba9c4e75a5db6e77f62d3,3,4,1,5,3,2013-10-30 13:10:16,2013-10-30 13:10:16
77bf572cba342f69d66f75c9b1c42c2451dae32f...688ca328c995d112848f93266d8ffb11b5923827,3,6,11,17,5,2013-10-30 09:00:28,2013-10-30 09:00:28
147837efaa48696debf93c62e8d872f72d866117...867e2bef8d9c9b901022899227b306a532f5baf3,9,14,14,28,11,2013-10-30 17:03:56,2013-10-30 17:03:56
27abfba89fd91f788fa9621237fe7c6b20ca6c3f...9829c86f7ca5c76ef21892ec1198858eebc99392,4,5,4,9,4,2013-11-26 23:21:27,2013-11-26 23:21:27
90f8eb6c144bbd409f196a0b33ec4ae2b47e1eb5...978dfb9216b088d92bb8db14b6ddb409cc7c7f76,1,3,1,4,2,2011-11-16 08:30:11,2011-11-16 08:30:11
1f51ce058b97117cfc3811c9695fcbe6733b70ad...e3cfd2f5b3817c080cede9aaa276c229db8c1d35,1,1,1,2,1,2011-11-13 21:45:43,2011-11-13 21:45:43
1f51ce058b97117cfc3811c9695fcbe6733b70ad...638211b8965e95a1ebf5a783747e1c292a4d3f90,1,1,1,2,1,2011-11-12 21:18:08,2011-11-12 21:18:08
20add59de3f2b69aaa9c9b325dab20b13c75eaa1...f07bcafd397dd39c5490e192ab7b52c49acd3d9b,1,1,1,2,1,2012-01-06 10:16:29,2012-01-06 10:16:29
f07bcafd397dd39c5490e192ab7b52c49acd3d9b...969fbe71504f6a8159688634cce774d7ffc7ac67,1,11,0,11,1,2012-01-06 10:33:18,2012-01-06 10:32:11
20add59de3f2b69aaa9c9b325dab20b13c75eaa1...23e5fc2133dd748ba4a7df52b598a24a2915811a,6,49,25,74,11,2012-01-05 22:11:41,2012-01-05 22:11:41
23e5fc2133dd748ba4a7df52b598a24a2915811a...621dd13d87b6ba5fd351966056ea335c6a946f45,7,98,8,106,13,2012-01-05 23:43:07,2012-01-05 23:43:07
621dd13d87b6ba5fd351966056ea335c6a946f45...03d7c1a65e0321445842a4925d19331fda200c02,3,4,4,8,4,2012-01-05 23:46:48,2012-01-05 23:46:48
03d7c1a65e0321445842a4925d19331fda200c02...aa5342888bf9b3041d2f703349d7ff94cf8b5f43,3,4,2,6,4,2012-01-05 23:48:40,2012-01-05 23:48:40
aa5342888bf9b3041d2f703349d7ff94cf8b5f43...90e3a706ba8c01462516efd3c60cd124620950b9,1,11,0,11,2,2012-01-06 00:03:05,2012-01-06 00:03:05
61c9e9df4b13acc4124ddae58c1eaa40081a90f7...84a7431dfd036df64df9aa9ecab82a54bd8083d8,1,6,0,6,1,2014-03-07 07:19:16,2014-03-07 07:19:16
0df96d8c320d664336707e1f6f9e5b254a6edb23...1e4540f11bf460bf8f0dd53409951ad0fe14a603,1,5,5,10,5,2013-12-31 18:51:39,2013-12-31 18:51:39
1e4540f11bf460bf8f0dd53409951ad0fe14a603...b43371cd0acd8d8a176e23d5b1784c2a31bc71d6,1,9,16,25,3,2013-12-31 19:38:32,2013-12-31 19:38:32
b43371cd0acd8d8a176e23d5b1784c2a31bc71d6...78e1af58d6b38ee542c110fdb971cbb229d2d518,1,1,1,2,1,2013-12-31 19:57:44,2013-12-31 19:57:44
78e1af58d6b38ee542c110fdb971cbb229d2d518...ac3f48bb19a91f1bf23aa5838e11acd62f741b0f,3,2,2,4,2,2013-12-31 21:16:28,2013-12-31 21:16:28
e9199718d64dadc22d61b4cea8c77a2307455823...65b10706b32bd969d373fc4b84a9be68a132361e,1,1,2,3,1,2014-02-09 00:56:59,2014-02-09 00:56:59
bdb70fa471965728609d86c001384791fa44398b...2a43e7e78a59c70e217383c12c9ef0482cabb163,67,9239,9534,18773,69,2014-03-17 02:03:53,2014-03-17 02:03:53
bdb70fa471965728609d86c001384791fa44398b...615dcb5ca068b1290cfd74d0f3b30272328f60fa,2,38,6,44,8,2014-03-17 01:38:47,2014-03-17 01:38:47
615dcb5ca068b1290cfd74d0f3b30272328f60fa...dd7cab84f66892ce53f0b7a9d8bf6981033f7ce2,13,57,19,76,21,2014-03-17 01:44:58,2014-03-17 01:44:58
6424acf69ae40a916db04b5c3235f1780f11b4be...b10b373c6019666dbe1152245c9efdf214ceaa6a,3,9,9,18,6,2014-08-04 04:19:42,2014-08-04 04:19:42
4a4dff00262aa74510567890eecbf71675805b15...1b15cefa5c5342129bec9b794946f3fb2641077d,2,37,7,44,2,2014-03-17 20:55:39,2014-03-17 11:19:45
4a4dff00262aa74510567890eecbf71675805b15...d52ad3ee3ba5a0fc51e1f06abeebd888846856eb,3,72,76,148,3,2014-03-17 14:58:03,2014-03-17 14:58:03
9a8e6195437f88fae8687e5aeeb8052797d4c6e4...a319ec5b7d19a464d86fa604b53c84ff2c480ebb,1,15,0,15,1,2013-12-15 19:02:32,2013-12-15 19:02:32
091146ee73a4226e49dcbcc9ec11dd094a112c2f...09c78709714aba56764bef1b9acb2ee2f8c85e6a,1,2,2,4,2,2013-12-19 09:07:56,2013-12-19 09:07:56
523eca14e81dcb448468e6881f7e071e5d7896e4...2e0337a61b36cb53dcbf8d171fc6ebdc8c084ac5,1,1,1,2,1,2013-12-20 02:57:43,2013-12-20 02:57:43
87727370e06c1deba7d7aa7196a480cef293a047...22f9767714a9f80d5d12479725e8875bdd83f341,3,3,3,6,3,2013-12-19 05:14:01,2013-12-19 05:14:01
87727370e06c1deba7d7aa7196a480cef293a047...d9586e28638b14960bc2260f310dac76078d5f14,1,1,0,1,1,2013-12-19 05:10:58,2013-12-19 05:10:58
ec9d4708d2b3dcbe185e674d5d0ee15da67b4fb6...9d485db721ba248224696eb63eafdfabad1fcbe2,2,4,4,8,4,2013-11-28 20:34:42,2013-11-28 20:34:42
9d485db721ba248224696eb63eafdfabad1fcbe2...9f68a5b241fff2adce3b95b5c5b486e84a1d88d5,3,7,1,8,3,2013-11-28 20:39:39,2013-11-28 20:39:39
9f68a5b241fff2adce3b95b5c5b486e84a1d88d5...c13524e7e0f3d2a62935bbe2cb57c1388e04e052,3,10,1,11,3,2013-11-28 20:49:51,2013-11-28 20:49:51
c13524e7e0f3d2a62935bbe2cb57c1388e04e052...9d939080e6536277ec47d19e113bff7376489ff9,3,29,22,51,9,2013-11-28 22:22:31,2013-11-28 22:22:31
9d939080e6536277ec47d19e113bff7376489ff9...d654f905028a40893fa553f529d12dceec879cf7,3,3,1,4,3,2013-11-28 23:37:11,2013-11-28 23:37:11
d654f905028a40893fa553f529d12dceec879cf7...0be94180b99cec9be239124c666721e40fbfbc97,1,1,1,2,1,2013-11-28 23:45:45,2013-11-28 23:45:45
1a476b623ebea6b5f95161b865fb38ddd766fa84...5528c6501cd0f382289630665fa77394146ea68c,1,4,0,4,1,2013-10-01 00:44:50,2013-09-26 19:57:03
1a476b623ebea6b5f95161b865fb38ddd766fa84...5d6e1d742def19a730da188f0269f938928e503b,1,1,1,2,1,2013-09-26 21:49:03,2013-09-26 21:49:03
1a476b623ebea6b5f95161b865fb38ddd766fa84...1cf8fcda651f54e59f0c454579b457b666cb1880,1,1,1,2,1,2013-09-26 00:25:50,2013-09-25 18:45:26
1a476b623ebea6b5f95161b865fb38ddd766fa84...1c1850f63eac532b6a1fb89e6b5ea28b2c8168ec,1,1,1,2,1,2013-09-25 12:59:01,2013-09-25 12:59:01
f8e0f166637e8e85cadf1538c809e738b781f436...01afe84b316d22374ad2333b3c15b35ad17029af,1,0,1,1,1,2013-12-05 06:43:50,2013-12-05 06:43:50
dd28ecd0d5f5c16263649861f53000ad6b813d79...66f9c7d6d5de97965a119f6d5f4ad1704e8f789d,1,2,1,3,1,2013-12-05 05:10:13,2013-12-05 05:10:13
66f9c7d6d5de97965a119f6d5f4ad1704e8f789d...a45d83987466e61fd613ac9e7f98fafa8697d16f,4,11,2,13,4,2013-12-05 05:13:33,2013-12-05 05:13:33
a45d83987466e61fd613ac9e7f98fafa8697d16f...8c5dc542a553d93d4ee26db176e515f5164be8a7,1,2,2,4,1,2013-12-05 05:22:24,2013-12-05 05:22:24
c1f68dd4d4bf54ed406420be45974ed831dd4437...0d0b5c7ddbd60808716a4cd41f3ba6aa40707cc1,1,1,1,2,1,2013-12-18 17:48:04,2013-12-18 17:48:04
0d0b5c7ddbd60808716a4cd41f3ba6aa40707cc1...d15218a09ce68d0854d0aa5f5170c1ea859aee31,3,29,11,40,17,2013-12-18 17:49:05,2013-12-18 17:49:05
2ae39d716651be9c7bddfa6deeb7300a038afbaa...0f72123c43bad7db4e7ea1c163043c34707e6aa4,2,92,84,176,2,2013-12-16 08:42:45,2013-12-16 08:30:04
75db35507322ad02ded7fe32a2e74dcf3f4c58cf...95c72b573eda1cc16cec0899b433c4d1b5e6257b,2,52,32,84,12,2013-12-16 05:12:33,2013-12-16 05:09:01
75db35507322ad02ded7fe32a2e74dcf3f4c58cf...637b20f6d584913815a60f0429b8e76c3bd10375,1,11,9,20,1,2013-12-16 04:56:23,2013-12-16 04:38:06
fe58357df182b52f5905f432a3b2629c717656f1...b1215d1b2ecd6cd3898af19ce43cc647e2ec854a,6,42,4,46,7,2013-12-07 20:18:13,2013-12-07 20:18:13
4be126e0142556805b59cb5a62d33c4a3fd2b8d4...2fc2fe75bdfaa8c22929594d4846dfad6aab71c7,3,20,16,36,16,2013-12-07 03:05:13,2013-09-18 18:37:55
4be126e0142556805b59cb5a62d33c4a3fd2b8d4...f4087df47e6347a2f28b44a18914cfebf1cc3a9c,3,1,9,10,9,2013-12-07 02:52:20,2013-12-06 10:42:21
f4087df47e6347a2f28b44a18914cfebf1cc3a9c...b5008ebf9ca1c9c90a6ec73ae12e55a8f155017f,3,7,1,8,7,2013-12-08 09:59:44,2013-12-08 09:59:44
4be126e0142556805b59cb5a62d33c4a3fd2b8d4...351f86e1db6bbb5f37e67323094fc08f4aeceecd,6,8,8,16,8,2013-12-07 01:23:45,2013-12-07 00:51:59
351f86e1db6bbb5f37e67323094fc08f4aeceecd...c1dae1e13c0dd5c53aa39b6aa6af8e07e4d3037f,3,32,1,33,5,2013-12-07 01:26:07,2013-12-07 00:51:38
dc34c8a206cbbe7a7fbac9d56fc1683c394a5b3b...2e9cde6fd9d8804de47bcf901cfbc2211213d4ba,1,1,1,2,1,2013-12-06 19:33:18,2013-12-06 19:33:18
b15042233518c1912c7b23b9eeb042a9c1335332...f3c644cb1b6027a0365be3c30de290d6162c8d09,1,1,1,2,1,2013-09-03 23:36:13,2013-09-03 23:36:13
f3c644cb1b6027a0365be3c30de290d6162c8d09...3bb3680aacfe83c067cf6ee25ef297c10afe2404,1,1,1,2,1,2013-09-03 23:46:02,2013-09-03 23:46:02
b67fc6906a06169458bc9c72e7f717af68eeedb8...7e16425acb0af58f72af4e2cd06cb30b1d6876e8,1,2,2,4,2,2014-01-08 08:22:50,2014-01-08 08:22:50
b67fc6906a06169458bc9c72e7f717af68eeedb8...d1c29af5916b6cb629f0b4f442d796866f7a8b6c,2,24,18,42,3,2014-01-08 06:16:52,2014-01-08 06:15:48
d1c29af5916b6cb629f0b4f442d796866f7a8b6c...d7a128c63628cb886dfa233c2b4bc2648b831c53,2,29,23,52,3,2014-01-08 06:34:09,2014-01-08 06:34:09
096a72d8975e41f395cea4e3e84aec1744d25165...56b5f5b353254402b8e999d9ff003d00b7e381ac,1,2,4,6,2,2014-01-03 20:21:38,2014-01-03 20:21:38
56b5f5b353254402b8e999d9ff003d00b7e381ac...007d61cfadc6f962fc3abc7119f7b9d68f7cd204,1,1,1,2,1,2014-01-03 20:29:45,2014-01-03 20:29:45
78e6036c680594266e4e7c08d0c44cb13e9d98a4...12dacee313e49ff421fc81d5e0a6a70111c3a4af,1,1,1,2,1,2014-01-06 04:53:40,2014-01-06 04:53:40
6ecdb310097617074b292d2f52971d082c3e2ec8...df16f9f1235505350360a5b34d7b03e64eb732d4,1,1,1,2,1,2013-12-30 07:16:41,2013-12-30 07:16:41
867e2bef8d9c9b901022899227b306a532f5baf3...2b56ff04614c4617355d16c14784654e841bcf4d,4,14,446,460,31,2013-12-02 06:50:17,2013-10-31 09:32:23
867e2bef8d9c9b901022899227b306a532f5baf3...b593df183087d88940d7af3e59b401685ada3dfe,10,185,119,304,57,2013-11-06 19:00:39,2013-11-06 19:00:39
867e2bef8d9c9b901022899227b306a532f5baf3...0d4b9ef72e7e8e7210523aced9aced2d8cbad74a,9,9,9,18,9,2013-10-31 20:09:41,2013-10-31 20:09:41
867e2bef8d9c9b901022899227b306a532f5baf3...441f9d67179f766377eed4b0cedc5dc6eec290e4,4,10,6,16,6,2013-10-31 16:48:55,2013-10-31 00:37:17
c37b710e85e379ddffb305af8a765013c0cd0333...1f9bfa89dc219654b5e096bda9233a58c69216fa,5,5,5,10,5,2013-12-08 10:14:24,2013-12-08 10:14:24
1f9bfa89dc219654b5e096bda9233a58c69216fa...e349fb2114804f35e8602a3936b84242ae32420e,1,1,1,2,1,2013-12-08 10:14:43,2013-12-08 10:14:43
9829c86f7ca5c76ef21892ec1198858eebc99392...ea782486082251c5e28e974f5843b6c37147cf51,6,3,94,97,14,2013-11-28 16:41:43,2013-11-28 16:41:43
ea782486082251c5e28e974f5843b6c37147cf51...3d5e598e5c9bc4d0573266e9a0aa84f988683285,6,64,171,235,32,2013-11-28 17:40:15,2013-11-28 17:40:15
978dfb9216b088d92bb8db14b6ddb409cc7c7f76...4be902741b623431800a42eb50963184dd966b41,1,1,1,2,1,2011-11-16 18:25:36,2011-11-16 18:11:37
18d2a879ae3547060a4777d4d181f7b6c8aa3b19...721e7b85d750de950f4762a8c1cf6a26113eb373,10,164,2,166,12,2011-11-21 05:42:52,2011-11-21 05:42:52
721e7b85d750de950f4762a8c1cf6a26113eb373...13a59a0124c31c94fdfd4f770da506bae5dc147a,10,3,147,150,11,2011-11-21 05:45:09,2011-11-21 05:45:09
13a59a0124c31c94fdfd4f770da506bae5dc147a...e5fb1da164171a62612df8bded8ed3b2af8fed56,1,5,3,8,1,2011-11-21 05:59:31,2011-11-21 05:59:31
64c8623533752ab155e452335457285fa06c1b70...dd99e2d0488c503d929909e431a544e472782178,3,314,0,314,4,2012-01-07 02:30:32,2012-01-07 02:30:32
dd99e2d0488c503d929909e431a544e472782178...fbb42ccbbbfcab985a2c588532511f4af324ebc1,1,1,1,2,1,2012-01-07 18:56:00,2012-01-07 18:56:00
90e3a706ba8c01462516efd3c60cd124620950b9...c56e9d2d35299b4c9e4e3d1aabcf59cedc9143f2,8,338,232,570,89,2012-01-06 05:43:28,2012-01-06 05:43:28
90e3a706ba8c01462516efd3c60cd124620950b9...314feb702f9a95ee473e529650e16654714cd9f4,2,1,10,11,2,2012-01-06 02:32:08,2012-01-06 02:32:08
84a7431dfd036df64df9aa9ecab82a54bd8083d8...cb7eb674accd24b6b73f26ef23cf4a301b6ebfaf,14,305,56,361,160,2014-03-07 08:01:54,2014-02-22 10:17:58
b124c4a6a410bf2d0d883dcc9c650b4f2fe5a3b1...91595d38f3c08c986b2ecff4de6ee0e95d161448,1,1,1,2,1,2014-02-07 03:34:46,2014-02-07 03:34:46
65b10706b32bd969d373fc4b84a9be68a132361e...13b4e7a1a8b9be8793c59e3c1da4016ad0974b56,1,4,0,4,1,2014-02-09 01:19:45,2014-02-09 01:19:45
13b4e7a1a8b9be8793c59e3c1da4016ad0974b56...44bb7b20c7eb14f29827fc163fc5afb066a7ddf5,6,12,18,30,14,2014-02-09 01:29:10,2014-02-09 01:29:10
b7ab7998248696392d3d4c4b1335ef2b6b10d29f...0f366e03765ce1daa932562b77de78eb5f90ac28,2,4,4,8,4,2014-03-17 02:58:12,2014-01-22 13:09:41
0f366e03765ce1daa932562b77de78eb5f90ac28...ead17b7ca6342ceb39b614d7179b9031902ea63f,2,2,2,4,2,2014-03-17 03:10:52,2014-01-25 11:16:45
b7ab7998248696392d3d4c4b1335ef2b6b10d29f...b004c9ac393671489720be06739f01e5c1bec7fe,10,9,9,18,9,2014-03-17 02:32:08,2014-03-17 02:32:08
77b0dc69ebefb8c3ddb1b25a0bd51ef53c0d0e9b...f7acc1c77c88179cb35366c8f2dd0d20283e3049,1,6,0,6,1,2014-08-04 16:46:27,2014-08-04 15:15:06
dc2b24e62669beea9a5e65de13a7a61d79abd87b...f2952aeccf4e5653bd7fc2ba3f7ca183e570ab3e,2,2,2,4,2,2014-03-20 05:29:07,2014-03-20 04:46:32
f2952aeccf4e5653bd7fc2ba3f7ca183e570ab3e...1be0b57d34c4712ba747ccb0e917acef2117dc13,3,28,7,35,7,2014-03-20 08:13:21,2014-03-17 14:36:58
1be0b57d34c4712ba747ccb0e917acef2117dc13...0dc88edeb9cec0ed148301f3cb43c572b3f8c25d,6,6,6,12,6,2014-03-20 08:16:01,2014-03-20 08:16:01
d52ad3ee3ba5a0fc51e1f06abeebd888846856eb...8534e12523c7156b53e76393cc8d016ffdcf5b4f,4,253,41,294,17,2014-03-21 18:28:13,2014-01-20 19:54:22
d52ad3ee3ba5a0fc51e1f06abeebd888846856eb...4e2b92f310b4983dea176fd8042d13ef9ed139e2,1,2,2,4,2,2014-03-18 00:18:01,2014-03-18 00:18:01
d52ad3ee3ba5a0fc51e1f06abeebd888846856eb...1e41df6b69ffd4676024e310ac138f67341337c0,1,0,0,0,0,2014-03-17 15:49:27,2014-03-17 15:47:08
bc261ecc525518444887cb362c04f18d8f743da0...2b86e05a6150ef13905519070ea82ce895fbae85,2,13,13,26,2,2013-12-15 19:09:03,2013-12-15 19:09:03
2ea370f93ba83aab5d071311758bc1e7bd822dc6...ba3639b2025b8f0c510087ff8fe522c2bf0b06f1,14,99,98,197,31,2013-12-16 17:06:31,2013-12-15 19:04:32
fb8310fbc6d413a3446ecf1772a77911d45fbd62...ded1e722029a5f74116778a2b648ed8a4956cad6,1,1,1,2,1,2013-12-19 17:06:45,2013-12-19 17:06:45
fb8310fbc6d413a3446ecf1772a77911d45fbd62...1bf5abab3153159d09f83f5512735da2144394d6,8,133,137,270,19,2013-12-19 14:32:37,2013-12-19 14:32:37
fb8310fbc6d413a3446ecf1772a77911d45fbd62...9201ccd08b3aef48fd69f4cb4b731d893a9637f7,1,287,287,574,2,2013-12-19 12:11:05,2013-12-19 12:11:05
fb8310fbc6d413a3446ecf1772a77911d45fbd62...3bcb1cc255b2c06dff093c7d7fb9f70505629eec,1,1,1,2,1,2013-12-19 11:18:51,2013-12-19 11:18:51
3bcb1cc255b2c06dff093c7d7fb9f70505629eec...1ceab8b89fede53d7b62b80b456c058703de9a6c,1,1,1,2,1,2013-12-19 11:41:33,2013-12-19 11:41:33
2c5e5b23e132d59c3f459b25a31a81689cc088fd...81b1e6801faf71705a06e8e039a98b79b6c478c5,1,1,1,2,1,2013-12-20 03:28:22,2013-12-20 03:28:22
81b1e6801faf71705a06e8e039a98b79b6c478c5...2854c5c3fb65b709fbf32d05faccf7a294626cca,6,54,43,97,24,2013-12-20 03:40:08,2013-12-20 03:40:08
edbd1a81e05efb78d2ecf30b4f24263fc25c8620...50f1bc47ece352f1e647c345fd9b699707a40b98,1,1,1,2,1,2013-12-19 08:09:04,2013-12-19 08:09:04
eb3807609a936ba7fb6b032395c07071ab46beac...f39db19306677c7a6cf51774994ec44c1010669d,1,0,1,1,1,2013-09-27 17:17:02,2013-09-27 17:17:02
eb3807609a936ba7fb6b032395c07071ab46beac...12a3bb31f82b7fee96dbd5d91f4a5bef90c7acd6,1,1,1,2,1,2013-09-27 09:32:06,2013-09-27 09:32:06
f9dd7466cfbc89c2ed458ec83cd29db7aa83525a...41444cd83a95e5a6c7416f14bc9d3dbd8133cbb3,1,1,1,2,1,2013-10-01 08:20:31,2013-10-01 08:20:31
d15218a09ce68d0854d0aa5f5170c1ea859aee31...c4b0684e65d035c66df09bc16a9f2df1a4a6a28b,1,1,1,2,1,2013-12-18 19:45:30,2013-12-18 19:45:30
94635eb9723444ad69b00d33c96e129c1996b013...af1afb10bd587caa4ffbbfd0a38b2a59780af086,1,1,1,2,1,2013-12-17 09:29:19,2013-12-17 09:29:19
af1afb10bd587caa4ffbbfd0a38b2a59780af086...dcfe710fa4813da95dcfecc50a0581427d4cb491,1,1,0,1,1,2013-12-17 09:35:16,2013-12-17 09:35:16
94635eb9723444ad69b00d33c96e129c1996b013...ae640d4f1cea3b12fcfbf2d6c8d5bb3c29c9aadf,3,27,11,38,13,2013-12-16 21:56:28,2013-12-16 21:47:09
6bb73df50ee78f443105e9265721317eaebbbe6a...498f00a2447a3c873c239313beeb5dc263bf5c74,2,16,12,28,11,2013-12-16 07:52:44,2013-12-15 05:02:15
b441632db143e5deb729b5d7109ad73b5e4e73d6...6145cc026d5344c61ea6b517b396f490dac5e90b,1,4,4,8,4,2013-12-08 07:11:43,2013-12-08 07:11:43
b441632db143e5deb729b5d7109ad73b5e4e73d6...8087f95ca4ed948cd10b92836ddfce56307707da,1,1,1,2,1,2013-12-07 09:27:28,2013-12-07 09:27:28
ed63dfd8d301debf35bc93d155dff4527c94388d...eca8ff380388c1187bc2c86e0ae7fa80aa33111e,30,347,346,693,290,2013-12-08 10:44:14,2013-09-18 16:50:02
2e9cde6fd9d8804de47bcf901cfbc2211213d4ba...c545312bd677c06025dfffb0d927e782c48d18e8,2,11,1,12,2,2013-12-06 19:35:58,2013-12-06 19:35:46
3bb3680aacfe83c067cf6ee25ef297c10afe2404...73e4b817905145a965797c4ac026eae94f698141,1,6,10,16,7,2013-09-04 00:46:35,2013-09-04 00:46:35
3bb3680aacfe83c067cf6ee25ef297c10afe2404...01361951e695d4313131ba85c9517cbc50000439,1,4,0,4,1,2013-09-04 00:34:21,2013-09-04 00:34:21
3bb3680aacfe83c067cf6ee25ef297c10afe2404...19db69c902bca678165cf6da8ade018923e05ead,1,1,1,2,1,2013-09-04 00:01:21,2013-09-04 00:01:21
3bb3680aacfe83c067cf6ee25ef297c10afe2404...5dc65894c0ab82c441116b1c6c127c1533ca4b67,1,10,10,20,5,2013-09-03 23:51:17,2013-09-03 23:51:17
5dc65894c0ab82c441116b1c6c127c1533ca4b67...e62a04a19bb17c1da7644db25d08049707fcd6b2,1,11,13,24,6,2013-09-04 01:20:21,2013-09-04 01:20:21
692eb554aa3409f6f74de1605e1925ee295f4571...9f0afd57f0a569488b3f0ff334278efd631b4057,1,1,1,2,1,2014-01-08 15:43:56,2014-01-08 15:43:56
692eb554aa3409f6f74de1605e1925ee295f4571...ebf780798578ecaa15467e2d3af249abefe80709,4,15,7,22,6,2014-01-08 11:41:16,2013-12-10 22:29:42
ebf780798578ecaa15467e2d3af249abefe80709...f00bbdd994362a93a66a986c22846b25f11f8dc6,4,24,3,27,5,2014-01-08 11:41:17,2013-12-22 07:25:18
f00bbdd994362a93a66a986c22846b25f11f8dc6...9b71314fd8c5ae420b338e4719a4a86bf758a2cc,2,2,1,3,2,2014-01-08 11:41:17,2013-12-27 04:01:56
9b71314fd8c5ae420b338e4719a4a86bf758a2cc...016d573a80c1cadea15e5c588a170d2e5101c86f,4,27,8,35,8,2014-01-08 11:41:17,2013-12-27 04:14:28
016d573a80c1cadea15e5c588a170d2e5101c86f...d7bf9372ec56a58686797da769d22b584fa64574,5,6,10,16,10,2014-01-08 11:41:17,2013-12-30 06:25:52
d7bf9372ec56a58686797da769d22b584fa64574...d06d61dc127c62a7f121de6c90498ce326db4b03,2,2,2,4,2,2014-01-08 11:41:17,2013-12-27 04:08:40
1736bcb05cb2c0b96825099fbb05b93ba4f327e5...c9ba678b9facc1afea0bc717a5c0f48e557e8fe9,1,1,1,2,1,2014-01-08 20:37:10,2013-12-09 05:25:25
c9ba678b9facc1afea0bc717a5c0f48e557e8fe9...39861714a80b68cd42a2e2b812be53f0b0f6b70d,8,2198,1491,3689,168,2014-01-08 20:41:51,2013-10-18 02:52:16
39861714a80b68cd42a2e2b812be53f0b0f6b70d...db829f8620d7fb04b48adb5dd0ad297f0c930453,4,71,21,92,11,2014-01-08 20:41:51,2014-01-08 05:43:12
007d61cfadc6f962fc3abc7119f7b9d68f7cd204...84c33a822da54a48f0f4751fe519dfc6b324a453,1,1,1,2,1,2014-01-04 00:19:20,2014-01-04 00:19:20
007d61cfadc6f962fc3abc7119f7b9d68f7cd204...5141e4da10a10952ad5357df29f3381345e48070,1,1,1,2,1,2014-01-03 22:39:18,2014-01-03 22:37:03
19fdd707efecbb7fa26be242b6785a3bf9bf0211...77bc82d486d8c3cf58bd1ba48d57fcfa87509837,1,24,0,24,1,2013-12-08 10:54:04,2013-11-01 20:25:23
19fdd707efecbb7fa26be242b6785a3bf9bf0211...bb54ce0db62e795027a32f1e67cdee1273f7413a,1,1,1,2,1,2013-11-01 18:30:27,2013-11-01 18:30:27
e349fb2114804f35e8602a3936b84242ae32420e...0c457d48f85ad637d9c47b5167b83e8de2b868d6,2,3,2,5,2,2013-12-08 10:24:47,2013-12-08 10:24:47
2abaed98769bd3f5d9bf842c86bc25e4f6bfcd6d...594d0c700dacbce8805bab1be6111631c8e003fb,7,62,62,124,18,2013-11-28 19:33:00,2013-11-28 19:33:00
594d0c700dacbce8805bab1be6111631c8e003fb...56f4cf0316b03af888c22c62e4ef24e437b4a370,1,4,0,4,1,2013-11-28 19:38:28,2013-11-28 19:38:28
e5fb1da164171a62612df8bded8ed3b2af8fed56...eb123f6b83b95d413056657aa80ad24a72fecae8,1,1,1,2,1,2012-01-04 18:02:51,2012-01-04 18:02:51
e5fb1da164171a62612df8bded8ed3b2af8fed56...2b5b87db7de48703a38c3a87f8f3ae47ccffab42,1,2,2,4,2,2011-11-24 11:37:08,2011-11-24 11:37:08
2b5b87db7de48703a38c3a87f8f3ae47ccffab42...fe68f708ce723cef640c1cf784cb29da513bca22,1,1,1,2,1,2011-11-24 19:06:00,2011-11-24 19:06:00
94b825abc82abba14131824d57f3368871c5f4cb...36e7660383a7639f5d538efb7dc0f349e285b42d,9,36,24,60,29,2012-01-07 08:26:58,2012-01-07 08:26:58
36e7660383a7639f5d538efb7dc0f349e285b42d...0cb2866409c674f834f8e0f4e204c3c3331abbcd,2,9,3,12,5,2012-01-07 08:29:36,2012-01-07 08:29:36
0cb2866409c674f834f8e0f4e204c3c3331abbcd...bcf1136f2c8236cd3fa28eac7e57a9a3fc17d104,5,136,140,276,42,2012-01-07 08:47:53,2012-01-07 08:47:53
bcf1136f2c8236cd3fa28eac7e57a9a3fc17d104...d6a1402f2af5111e11a87a6029b642dc0b814854,5,29,16,45,10,2012-01-07 09:03:26,2012-01-07 09:03:26
d6a1402f2af5111e11a87a6029b642dc0b814854...e23448ab1b2cc627a3cab54406ffce6c915297b6,3,4,4,8,4,2012-01-07 09:08:58,2012-01-07 09:08:58
e23448ab1b2cc627a3cab54406ffce6c915297b6...45d671d97f4d448780729bbb6357e9ec776f980c,5,32,13,45,17,2012-01-07 09:22:52,2012-01-07 09:22:52
45d671d97f4d448780729bbb6357e9ec776f980c...5fb2c666acfd5e7d2f134d2cb5b65b828102c5a9,6,65,47,112,21,2012-01-07 09:59:53,2012-01-07 09:59:53
5fb2c666acfd5e7d2f134d2cb5b65b828102c5a9...8ccc3bcf03fedbe8c3a19a96c08a5cad6ae456e8,9,359,171,530,72,2012-01-07 11:45:24,2012-01-07 11:45:24
8ccc3bcf03fedbe8c3a19a96c08a5cad6ae456e8...33dad13014ae2272d3fcf799f114bfcf8256d968,3,9,6,15,5,2012-01-07 11:53:20,2012-01-07 11:53:20
33dad13014ae2272d3fcf799f114bfcf8256d968...2540caeddd59822cd8f7c805e777adc7504b87b3,3,6,2,8,4,2012-01-07 11:58:48,2012-01-07 11:58:48
2540caeddd59822cd8f7c805e777adc7504b87b3...8bdaf1f36451266064ec460b87a12f21a2caa65b,5,10,10,20,10,2012-01-07 12:01:09,2012-01-07 12:01:09
8bdaf1f36451266064ec460b87a12f21a2caa65b...5ba7c14afe0fbe1eb9ba18e6a06cc298362ec159,8,24,15,39,15,2012-01-07 12:07:53,2012-01-07 12:07:53
5ba7c14afe0fbe1eb9ba18e6a06cc298362ec159...e594107f37ede1ea8bee05d8f4b22aeba89bf458,6,25,16,41,13,2012-01-07 12:17:33,2012-01-07 12:17:33
e594107f37ede1ea8bee05d8f4b22aeba89bf458...b6d50c892d6ae8ed42ff0bfbba4252c7dc47417e,3,8,8,16,7,2012-01-07 12:20:56,2012-01-07 12:20:56
9bedfa447c52ae45c1a144fba27160811dfb40a2...7582520808ad6c3610831652d0d4d33ea4ebf15b,4,45,31,76,9,2012-01-06 06:37:23,2012-01-06 06:37:23
7582520808ad6c3610831652d0d4d33ea4ebf15b...5cb76037ae70ca26a923750ca9441b04d2fbd6a7,7,18,16,34,20,2012-01-06 07:24:19,2012-01-06 07:24:19
c03b8f1f0ff090a1aef53704cbb2526bdbbfafbf...5bd2799978d5af60a8b353fcdaabc0a4bd01fd2f,12,12,12,24,12,2014-03-07 08:26:38,2014-03-07 08:26:38
f5f4a2da782cb4cefc5099e09b84e6f402d4e090...e180258b60c04c7d365f60cebdc1593be39d683d,1,9,1,10,3,2014-03-07 07:51:07,2014-03-07 07:50:55
29f23576ee301cf476ce66b979ddec338663336b...27da9728bcb8f1d9222816bcc269689ac8e0279b,1,1,1,2,1,2014-03-09 20:50:55,2014-03-09 20:50:55
27da9728bcb8f1d9222816bcc269689ac8e0279b...9920251ca8f1923de41679da829dc56f703063cb,1,6,0,6,1,2014-03-09 21:17:18,2014-03-09 21:17:18
77d160151f2e9ae7330010d5d7034f6a000eda09...ebd132ce68b79a95daf6ef91225304e9656cd4a4,1,7,2,9,1,2014-02-07 09:10:21,2014-02-07 09:10:21
ebd132ce68b79a95daf6ef91225304e9656cd4a4...3b4b9a7fe58082cde1545167e511a4acc6d5a0fb,2,18,0,18,2,2014-02-07 09:16:34,2014-02-07 09:16:34
3b4b9a7fe58082cde1545167e511a4acc6d5a0fb...228d4e59fcdb0e05811821a9aff899e7b4e5f4d9,12,60,63,123,15,2014-02-07 09:22:30,2014-02-07 09:21:58
228d4e59fcdb0e05811821a9aff899e7b4e5f4d9...f83b20100728ee7fa6c661ccee289dd003822cdc,1,2,0,2,1,2014-02-07 09:27:07,2014-02-07 09:27:07
f83b20100728ee7fa6c661ccee289dd003822cdc...4f9cdefab7dc8b569eb5f630264559f230ff4df4,2,2,2,4,2,2014-02-07 09:31:42,2014-02-07 09:31:42
4f9cdefab7dc8b569eb5f630264559f230ff4df4...16bbcd7affb98d18bdbbaf7dbf9529dd511d5027,1,1,1,2,1,2014-02-07 09:33:27,2014-02-07 09:33:27
41841c99c4a5ddace09eff6af25aae605f2eeea1...769339ed18afbaf24121e1b4e5a12d0b6f1d1828,5,5,7,12,6,2014-02-09 01:30:40,2014-02-09 01:30:40
ead17b7ca6342ceb39b614d7179b9031902ea63f...4e4e4563418e44a2f73c6a4ec4299105824f7eda,2,2,2,4,2,2014-03-17 03:24:33,2014-02-26 01:04:38
c93c3714336ecefdb69b4dc7ebc40ea87eb40a36...43cf003f9a0648787ab0285ebec866b1a7263c8a,5,5,7,12,6,2014-03-17 03:40:30,2014-03-17 03:40:30
43cf003f9a0648787ab0285ebec866b1a7263c8a...b3f30bb70efc5211520d7a55596becebc5d14662,1,1,1,2,1,2014-03-17 03:46:00,2014-03-17 03:46:00
fd6c00d1418b8e36b69cfaba1d2a7bcdcfbfd723...6c87895eec6daf757d4c98a4edd88b975ae79c8b,5,639,715,1354,610,2014-08-04 17:01:20,2014-08-04 17:01:20
6c87895eec6daf757d4c98a4edd88b975ae79c8b...14e8ec2514c5bc342a638f0b1f2d3518b6a72e85,8,719,640,1359,612,2014-08-04 17:14:11,2014-08-04 17:14:11
a7bc66fc202ebed8e5cd6c17dc262445830b5678...874bb1b9b5b0ecaa63328cec4c3d2df11a227556,1,1,1,2,1,2014-03-20 20:54:14,2014-03-20 20:54:14
a7bc66fc202ebed8e5cd6c17dc262445830b5678...cd13e22de107ce626bd994e75069626ad3a86b29,1,1,1,2,1,2014-03-20 20:12:59,2014-03-20 20:12:59
2b27006c717bdd1e67fc663ef5dda58b78226b63...4f9270cc20c29cd3fbb0664379d620d14bb24a91,20,20,20,40,20,2014-03-24 07:28:40,2014-03-24 07:28:40
4f9270cc20c29cd3fbb0664379d620d14bb24a91...58ea8a5601fab5b290fc526528b3cbd2d75194de,2,139,69,208,56,2014-03-24 07:28:57,2014-03-23 17:49:25
58ea8a5601fab5b290fc526528b3cbd2d75194de...cfb7093dc090c73e4d1dfa7c5ddac31e4f6b1c50,1,1,0,1,1,2014-03-24 07:28:57,2014-03-23 17:50:42
cfb7093dc090c73e4d1dfa7c5ddac31e4f6b1c50...d74aee409342d086ae6b087ea6dc3e71f6da055c,1,68,68,136,10,2014-03-24 07:30:44,2014-03-24 07:30:44
fd62247bf8bbb1bce072f5ee03e996dfc4abed94...a7029edc612745db1edb318b366d7bf229c3a8a5,3,1,5,6,3,2013-12-15 19:29:58,2013-12-15 19:29:58
a7029edc612745db1edb318b366d7bf229c3a8a5...f60b8169c67fd5c79fb026071f9334dcf1e9f636,3,16,4,20,6,2013-12-15 19:33:06,2013-12-15 19:33:06
f60b8169c67fd5c79fb026071f9334dcf1e9f636...61ec569211d6e7b6fc8a93737f86ad8564f163eb,1,2,2,4,2,2013-12-15 19:36:16,2013-12-15 19:36:16
61ec569211d6e7b6fc8a93737f86ad8564f163eb...1264cb714057188c743fad416ffaef35bc0b9d2d,1,16,7,23,4,2013-12-15 19:41:46,2013-12-15 19:41:46
1264cb714057188c743fad416ffaef35bc0b9d2d...cb3d9dfe8310a94a7b742ed62e088d64e93baba3,1,26,0,26,4,2013-12-15 19:44:16,2013-12-15 19:44:16
cb3d9dfe8310a94a7b742ed62e088d64e93baba3...a925a0b985281ce34666c9a8a5630ba258904cb5,4,46,13,59,15,2013-12-15 20:27:46,2013-12-15 20:27:46
a925a0b985281ce34666c9a8a5630ba258904cb5...c7c9929c1265a536dd9a75f358c107de39681b35,3,23,23,46,5,2013-12-15 20:31:40,2013-12-15 20:31:40
c7c9929c1265a536dd9a75f358c107de39681b35...d57e81d06d3de015b0b3975497d80d301f4c1da2,1,1,0,1,1,2013-12-15 20:41:47,2013-12-15 20:41:47
d57e81d06d3de015b0b3975497d80d301f4c1da2...a13d459491d800fe182a9217da9dd740cd6b57a9,1,1,1,2,1,2013-12-15 21:08:17,2013-12-15 21:08:17
a13d459491d800fe182a9217da9dd740cd6b57a9...540677c42adc6771d9e755f5a3c2bd5887611ec9,1,4,1,5,2,2013-12-15 21:39:45,2013-12-15 21:39:45
540677c42adc6771d9e755f5a3c2bd5887611ec9...93a4d6cc5ecdc1cbc09c4b8af2e587f4480b36cf,1,71,60,131,12,2013-12-15 21:44:26,2013-12-15 21:44:26
3f577ab86c4e07493d5d24f5fdd3dba30c199400...2b312bf3c12772aa9d9c58ead289068374ed0e33,4,31,31,62,6,2013-12-18 21:58:13,2013-12-18 21:58:13
b298d2f481dca3f8f8c0c202ca1b9406a2c6849d...fc03fac9e4fe95b29bac58b223234cd6135e3a88,1,1,1,2,1,2013-12-19 19:12:31,2013-12-19 19:12:31
fc03fac9e4fe95b29bac58b223234cd6135e3a88...2898e73ec49e66d529abb6a8483d5d9b09358b0f,1,1,1,2,1,2013-12-19 19:39:57,2013-12-19 19:39:57
2854c5c3fb65b709fbf32d05faccf7a294626cca...b604c2fbacc1ffb7843a32f50f322db390766386,2,24,24,48,4,2013-12-20 19:09:51,2013-12-20 19:09:51
2854c5c3fb65b709fbf32d05faccf7a294626cca...e95c396f44012bf0efca4e3d5bb25aa29282d67d,1,1,1,2,1,2013-12-20 18:59:18,2013-12-20 18:59:18
2854c5c3fb65b709fbf32d05faccf7a294626cca...7f599cedf3a9b3302bbbd8b6442354f8cf123fb2,5,18,6,24,16,2013-12-20 16:06:53,2013-12-20 16:06:53
fc2cde0230802055da2c3854573d03502fa3f3cc...708dbe58f6a59d8ab439e943d827b792e0947fc9,1,2,2,4,2,2013-09-28 21:21:23,2013-09-28 21:21:23
93bc1af62340c950300c2b8ca5c190dd8dda5eff...a32b626f5cce692be2cec6fe9b8cb630ec47634c,4,28,0,28,4,2013-10-01 18:01:08,2013-10-01 18:01:08
da4a275473dd0830fb95eca8be08b60496643dad...d820c6d22580119f6fb631c365c47f7be6e5db5b,1,0,0,0,0,2013-10-09 22:34:39,2013-10-09 22:27:14
1bc8607bdffe641d58191084b214138a98aba229...c262e5b47c4136dd1a1e7974472aaae6852bcfdc,2,2,2,4,2,2013-12-18 18:23:46,2013-12-18 18:23:46
dcfe710fa4813da95dcfecc50a0581427d4cb491...575f29cee12f584b34d7dcef8d15cc3cd71c5b1c,1,2,2,4,1,2013-12-17 19:39:32,2013-12-17 19:39:32
91fdd891000b1110c7585aab1156a3edea718567...98ef4284f0af7a623c7afa8e70c99abc9b5e2d12,1,1,1,2,1,2013-12-18 08:57:55,2013-12-18 08:57:55
b5613c9af5ed412aace32419378137bf64342203...a5d9b358abe8fc19c69a5876c27491c8ecfe93f5,1,0,2,2,2,2013-12-08 12:36:52,2013-12-08 11:25:52
b5613c9af5ed412aace32419378137bf64342203...cbfbf1b2dd16b1aa17e3feef9a4643e98a0f967e,3,27,0,27,4,2013-12-08 11:23:25,2013-12-08 11:01:18
b5613c9af5ed412aace32419378137bf64342203...fdc5d1dc34bf28e55c6359aeb098e608585ca6cb,4,22,17,39,8,2013-12-08 11:05:10,2013-09-18 05:45:38
01a1c41d496ef2f339ea260a009f98bb02d88249...c78f3b2712b231b6d626ccefd84e65de53585ee7,1,0,1,1,1,2013-12-06 21:45:17,2013-12-06 21:45:17
01a1c41d496ef2f339ea260a009f98bb02d88249...78b43d4c99c5b091980a977656a378f6c46c7c16,3,3,3,6,3,2013-12-06 21:34:29,2013-12-06 21:34:29
dcdafa422057863aea3e328e1d86ee25eda7e37b...143403f3fd42aeafa204602da22c4fd481c81435,3,3,1,4,3,2013-09-04 03:11:27,2013-09-04 03:11:27
dcdafa422057863aea3e328e1d86ee25eda7e37b...6ac5a1e2dc53a3fb2ef9896669e8bfffb62a7039,1,5,0,5,1,2013-09-04 02:52:25,2013-09-04 02:52:25
e68d3b961e8fc4cadf1db378054d4f73bb99c81b...1127cd62871aaf5bf70b23859a8520c6edbd57d7,2,3,3,6,2,2014-01-11 22:48:47,2014-01-11 22:48:47
9443044606954bf58dab954fa081d9ec180e9a25...72ff8ff9fb188f94a117f77271e9c8dc64ba79d6,2,2,2,4,2,2014-01-09 02:39:08,2014-01-09 02:39:08
72ff8ff9fb188f94a117f77271e9c8dc64ba79d6...8a10bd5231b2f4fc397c4cb77be478e3b9afafb4,1,1,1,2,1,2014-01-09 02:39:45,2014-01-09 02:39:45
8a10bd5231b2f4fc397c4cb77be478e3b9afafb4...29547a2102afdf84842c77a7dd4ea5f15cadeb1f,1,1,1,2,1,2014-01-09 02:45:40,2014-01-09 02:45:40
29547a2102afdf84842c77a7dd4ea5f15cadeb1f...7ba6daabfe9686bbfbf12d1b83cda387378acc2b,1,1,1,2,1,2014-01-09 05:15:37,2014-01-09 05:15:37
84c33a822da54a48f0f4751fe519dfc6b324a453...a53cf55be2ed9fd823053c8320dc106272baf2a9,2,2,2,4,2,2014-01-05 19:15:48,2014-01-05 19:15:48
84c33a822da54a48f0f4751fe519dfc6b324a453...11f56bbb7b472f7fd17bd86909cf480ee860c751,3,8,8,16,8,2014-01-04 17:10:02,2014-01-04 17:10:02
11f56bbb7b472f7fd17bd86909cf480ee860c751...a617c805f298b8feefd7703c12decd035ef7d1ec,4,7,7,14,7,2014-01-04 17:28:56,2014-01-04 17:28:56
84c33a822da54a48f0f4751fe519dfc6b324a453...8662323cd5f35d329ad315a04b08cd841c2b925f,1,1,1,2,1,2014-01-04 15:46:05,2014-01-04 15:46:05
7653b845f8795632d592c4b450f7502f110d9ec3...c61314363821428ca08d7674f4d80952fda13116,1,0,1,1,1,2014-01-06 04:08:37,2014-01-06 04:08:37
9421f0af82bd80ad13815d180d95459f67d5fec1...745bec59cf049a8571890c1cd5d926a3540aa36d,2,23,17,40,4,2014-01-06 07:37:14,2014-01-06 07:36:57
745bec59cf049a8571890c1cd5d926a3540aa36d...a5e29a8f34ada08b6700ed9d94806d33b1c8f56b,1,1,1,2,1,2014-01-06 07:43:13,2014-01-06 07:43:13
a5e29a8f34ada08b6700ed9d94806d33b1c8f56b...f389111e6835e4f41f9c98f71652cf546638b130,1,2,0,2,2,2014-01-06 17:26:08,2014-01-06 17:26:08
f389111e6835e4f41f9c98f71652cf546638b130...04161a8c753c5f9ef83dd1f0848a17e8c4ab155c,4,44,27,71,23,2014-01-10 02:05:04,2014-01-10 02:05:04
99ffa2827874560dabfe532963b59f1e95b7a46a...8f589c6cfd6954b1f358b1e6c31466d7409c1c98,1,1,1,2,1,2013-11-19 12:29:19,2013-11-01 21:52:52
99ffa2827874560dabfe532963b59f1e95b7a46a...8ff7b48b7b700428c1fb55c648097c9aa364b461,1,1,1,2,1,2013-11-01 23:27:08,2013-11-01 23:27:08
99ffa2827874560dabfe532963b59f1e95b7a46a...56aa2af6e1eb10d1e7873393e46537e20ff4f43b,1,2,1,3,1,2013-11-01 21:51:11,2013-11-01 21:51:11
99ffa2827874560dabfe532963b59f1e95b7a46a...3dc0ed35d1f07da48f2adbe585a6fd7dcf268c49,1,11,12,23,3,2013-11-01 21:09:01,2013-11-01 21:09:01
296fad37b4e3e78bd952d419625d87f52a3d52d4...5f54e4aad15b406128356f5ddd9ac7aad583f928,1,4,1,5,1,2011-12-09 16:34:58,2011-12-09 16:34:58
296fad37b4e3e78bd952d419625d87f52a3d52d4...40604548ce91ffd2ccfcca782f4db5fc79d70417,3,4,2,6,4,2011-12-08 01:16:19,2011-12-08 01:16:19
b6d50c892d6ae8ed42ff0bfbba4252c7dc47417e...3eb80591b2c8bb2850caf27da7d6b8c8b747063a,7,385,2,387,10,2012-01-07 12:39:46,2011-11-26 18:41:17
b6d50c892d6ae8ed42ff0bfbba4252c7dc47417e...7728f7b8241dc43292c3f897fdfe08a13f58e40b,3,25,1,26,4,2012-01-07 12:28:30,2012-01-07 12:28:30
7728f7b8241dc43292c3f897fdfe08a13f58e40b...6dee40f46990b39bb33b4c42aa003df784cff8fc,3,77,246,323,11,2012-01-07 12:34:30,2012-01-07 12:34:30
6dee40f46990b39bb33b4c42aa003df784cff8fc...95c88a2953d6493050192f9c99c8e5597e591ac3,2,4,17,21,7,2012-01-07 12:41:51,2012-01-07 12:40:32
95c88a2953d6493050192f9c99c8e5597e591ac3...a339f0051b21f9e51d47c3eb1fd7d37f126e87a0,6,122,17,139,16,2012-01-07 20:22:51,2012-01-07 20:22:51
a339f0051b21f9e51d47c3eb1fd7d37f126e87a0...28420311d89fe2656320cee7306d01a361f1c3c7,1,244,170,414,19,2012-01-07 21:40:05,2012-01-07 21:40:05
5cb76037ae70ca26a923750ca9441b04d2fbd6a7...cfc2353059df628c67d19a3c5c3ead2cc6051f53,14,340,91,431,67,2012-01-07 07:59:22,2012-01-07 07:59:22
fe0d5959d27af6492c282b0389859937150577b6...d44e98b34da74f6db19db108ce3f13ba8fd5fe0e,2,2,2,4,2,2014-03-07 08:50:28,2014-03-07 08:50:28
fe0d5959d27af6492c282b0389859937150577b6...55b639e928754eff2fd04caf214ed4c52f3009e0,1,2,2,4,1,2014-03-07 08:50:05,2014-03-07 08:50:05
e180258b60c04c7d365f60cebdc1593be39d683d...164b41b28d2921ed19652095b483d3eaa8d00b1a,11,27,23,50,23,2014-03-07 08:19:26,2014-03-07 08:19:26
f3dcd4dba4a1ba58e50e669fd4e92f6a49eca589...ce634a0ba7ceb5f9da21b74aa084d31e2274e0f1,1,5,0,5,1,2014-03-09 21:49:52,2014-03-09 21:49:52
ce634a0ba7ceb5f9da21b74aa084d31e2274e0f1...4d870af2aad36563883ac5751f52d9f0288a0673,1,9,1,10,3,2014-03-09 22:19:26,2014-03-09 22:19:26
4d870af2aad36563883ac5751f52d9f0288a0673...15d44940387f716ec5d2efee12bc9d9a7530ae56,2,5,6,11,2,2014-03-09 22:32:36,2014-03-09 22:32:36
16bbcd7affb98d18bdbbaf7dbf9529dd511d5027...2865fde67fcf5902f5cb5952b01d43b8f2347127,1,1,0,1,1,2014-02-07 09:41:04,2014-02-07 09:41:04
769339ed18afbaf24121e1b4e5a12d0b6f1d1828...0d49920e0dd08643238aabad11783d58ee72798d,6,93,93,186,80,2014-02-09 07:24:38,2014-02-09 07:24:16
769339ed18afbaf24121e1b4e5a12d0b6f1d1828...bcf5d8884402f79102df7dd1fde0a684f224dffc,3,44,56,100,4,2014-02-09 06:13:29,2014-02-09 06:13:29
bcf5d8884402f79102df7dd1fde0a684f224dffc...95308509b3f60b4312e00ce9e473c2e98bd466b8,1,1,1,2,1,2014-02-09 06:46:25,2014-02-09 06:46:25
7cf7e42c67d51d9db50f8461d629d06bc0a7f331...96525fdec431f8d654ce0ea9b4f92c2a3ef9104b,3,3,2,5,2,2014-03-17 03:30:50,2014-03-17 03:30:04
b3f30bb70efc5211520d7a55596becebc5d14662...4a2d337bf5f329eac1ca16208414ec1ebfe0546e,2,29,1,30,2,2014-03-25 02:23:39,2014-03-25 02:15:58
b3f30bb70efc5211520d7a55596becebc5d14662...35ddc8427ed664241cf5a4b87cfd2d7d6ce70697,9,238,158,396,58,2014-03-17 09:03:16,2014-03-17 09:03:16
b3f30bb70efc5211520d7a55596becebc5d14662...1ff6d33aa87aea3e9bd028839e32fa2b9eb99ba3,2,37,15,52,2,2014-03-17 05:37:31,2014-02-18 09:45:58
1ff6d33aa87aea3e9bd028839e32fa2b9eb99ba3...910ff24b4bee69a132cef548d7854207223c1322,1,2,2,4,2,2014-03-17 05:37:32,2014-03-17 04:33:13
14e8ec2514c5bc342a638f0b1f2d3518b6a72e85...9096c2002123a6dafdf0c3d9df5d069c968d738e,4,5,4,9,4,2014-08-04 21:05:12,2014-08-04 21:05:12
14e8ec2514c5bc342a638f0b1f2d3518b6a72e85...75bffd84aeac85c98e6e537d05293e9c8823127d,2,5,5,10,5,2014-08-04 17:33:42,2014-08-04 17:33:42
14e8ec2514c5bc342a638f0b1f2d3518b6a72e85...dca8afa333f47dcdaf44162d66a0ac18f9ea126b,1,3,3,6,2,2014-08-04 17:21:49,2014-07-25 16:33:43
d96beffac38ff8e8d201c0e6b088a81387066a17...4fb1fdbf749ca4207232c928147aa7d333655522,2,8,8,16,4,2014-03-23 06:10:00,2014-03-23 06:10:00
4fb1fdbf749ca4207232c928147aa7d333655522...30cc625c5c686f00af15a926f9437cb0e3fdff42,2,2,2,4,2,2014-03-23 06:13:38,2014-03-23 06:13:38
d74aee409342d086ae6b087ea6dc3e71f6da055c...298427c0e43f250cf3cd782f342597cb6ba2d269,1,1,0,1,1,2014-03-24 20:57:46,2014-03-24 20:57:46
d74aee409342d086ae6b087ea6dc3e71f6da055c...8ae48183b236d4db104fa165b8aea762d70b9d67,14,16,21,37,10,2014-03-24 20:47:59,2014-03-24 20:47:59
d74aee409342d086ae6b087ea6dc3e71f6da055c...41628c90a259101291a679fa112307a354fd32ee,1,1,1,2,1,2014-03-24 16:49:03,2014-03-24 16:49:03
41628c90a259101291a679fa112307a354fd32ee...674b41dd632d4911d291a593a23a5563a1a67811,1,29,0,29,1,2014-03-24 17:49:06,2014-03-24 17:49:06
93a4d6cc5ecdc1cbc09c4b8af2e587f4480b36cf...ee80b5e1d4d36f37ec0408bbe2af7e4c2e5cb0d5,1,1,1,2,1,2013-12-15 21:52:56,2013-12-15 21:52:56
8598c700f5d3546932056eed9913194b6b5df77b...0a955844ab333283657f367eef3d6031d2500a44,1,14,14,28,6,2013-12-18 22:24:59,2013-12-18 22:24:59
0a955844ab333283657f367eef3d6031d2500a44...961687e4dbd3b88bf643f3e8496e191d812da382,4,47,47,94,22,2013-12-18 22:26:37,2013-12-18 22:26:37
961687e4dbd3b88bf643f3e8496e191d812da382...3416e87a97d6a70f97c41326afd8c5120acbeb22,4,7,4,11,6,2013-12-18 22:27:21,2013-12-18 22:27:21
3416e87a97d6a70f97c41326afd8c5120acbeb22...ab740f0f0f1780f87cf30c106bb0d8eef983cd10,4,15,15,30,13,2013-12-18 22:28:03,2013-12-18 22:28:03
ab740f0f0f1780f87cf30c106bb0d8eef983cd10...324f6ca562d75cf925ae272131b281be6a2f8400,2,26,26,52,3,2013-12-18 22:29:33,2013-12-18 22:29:33
324f6ca562d75cf925ae272131b281be6a2f8400...79e97fef40ea0f4373b39ad728a313c608b06a60,1,1,1,2,1,2013-12-18 22:37:30,2013-12-18 22:37:30
79e97fef40ea0f4373b39ad728a313c608b06a60...56c36346c189f83c225d867beac0ed8337165a31,1,2,2,4,1,2013-12-18 22:38:10,2013-12-18 22:38:10
810c7ec4f8004129b88eba4aee15475d5d6f79ba...120dce43e830c56225fbccb1e8a20091452b2b5a,1,6,2,8,2,2013-12-28 19:01:32,2013-12-28 19:01:32
810c7ec4f8004129b88eba4aee15475d5d6f79ba...88c3619d2cc1e3e308071fa5fc9df1ec4204576b,1,7,7,14,6,2013-12-22 18:01:00,2013-12-22 18:01:00
810c7ec4f8004129b88eba4aee15475d5d6f79ba...28adcbe43925c8a15ac18e6bfb37c632e5fe7b31,1,2,2,4,2,2013-12-22 15:26:05,2013-12-22 15:26:05
810c7ec4f8004129b88eba4aee15475d5d6f79ba...c84688fc4f865e4adf668b89e47b9485380d398f,2,20,9,29,6,2013-12-21 16:39:34,2013-12-21 16:39:34
810c7ec4f8004129b88eba4aee15475d5d6f79ba...66c280c8558e4cb0e81711e00c3894005d9b68ca,3,185,10,195,12,2013-12-21 05:02:25,2013-12-21 05:02:25
66c280c8558e4cb0e81711e00c3894005d9b68ca...033476ccc709079448bb3824bb1a997211e04714,1,1,1,2,1,2013-12-21 05:19:45,2013-12-21 05:19:45
1809894e8a6e82e4871cbb399fc15c7dee306605...355525b2b7b1df9119068fb1de4c411c8315ced5,1,1,1,2,1,2013-09-30 20:21:54,2013-09-30 20:21:54
1809894e8a6e82e4871cbb399fc15c7dee306605...e21c744a57d4bcfadd6aac61d88d849d683e44c9,1,23,0,23,1,2013-09-29 22:17:46,2013-09-29 22:17:46
e21c744a57d4bcfadd6aac61d88d849d683e44c9...80d74c1bf708bf6821c8f326e80b5640fb112893,1,2,2,4,2,2013-09-30 00:45:55,2013-09-30 00:45:55
1809894e8a6e82e4871cbb399fc15c7dee306605...429e92fd58491acc09e6695e4fb4cf9c39420c44,1,1,1,2,1,2013-09-29 20:14:24,2013-09-29 20:14:24
1809894e8a6e82e4871cbb399fc15c7dee306605...e34e73714a4a6d73145f434d74594a45d6d145a8,1,9,8,17,7,2013-09-29 02:51:30,2013-09-29 02:51:30
a32b626f5cce692be2cec6fe9b8cb630ec47634c...dc5625c85b088d031f7084f3c78443fce9dc170d,1,6,6,12,1,2013-10-02 12:33:17,2013-10-02 12:33:17
d820c6d22580119f6fb631c365c47f7be6e5db5b...58a47b6bfd274e7018316c0ea77ce0ca40a7e53f,1,12,5,17,7,2013-10-10 00:35:26,2013-09-14 08:26:42
58a47b6bfd274e7018316c0ea77ce0ca40a7e53f...aad70834fc2546d5e877898098707930a7d7a4c3,4,8,5,13,5,2013-10-10 01:03:04,2013-08-21 09:46:45
aad70834fc2546d5e877898098707930a7d7a4c3...f9ed8e6f003d60e50873976a6573eb0faa3c26c9,1,2,2,4,1,2013-10-10 01:03:08,2013-10-10 00:57:52
f9ed8e6f003d60e50873976a6573eb0faa3c26c9...ca090aef0211663a11022e1f6b139850b7d222f1,1,0,3,3,1,2013-10-10 01:07:08,2013-10-10 01:07:08
ca090aef0211663a11022e1f6b139850b7d222f1...a216589056e2b7d116caf9e8be23ff0b2eca9099,1,1,1,2,1,2013-10-10 01:18:05,2013-10-05 00:57:03
d820c6d22580119f6fb631c365c47f7be6e5db5b...d72768a16abe811d987f2a38f980329260686114,18,17,25,42,18,2013-10-09 23:36:02,2013-10-09 22:09:50
d72768a16abe811d987f2a38f980329260686114...5e652332d1d5b5c3c5e86da0938d571795ce6161,12,11,17,28,12,2013-10-09 23:36:15,2013-10-09 22:21:03
5eeaf114cc45731f2597518828bb7b2c2abb552a...2547f1e20f94c592b4125de9006cc45b560af51e,2,7,5,12,2,2013-12-11 13:36:26,2013-12-11 13:36:26
5eeaf114cc45731f2597518828bb7b2c2abb552a...27859f6b8f0da4d5325b0eae673dc75c37584a63,2,13,5,18,5,2013-12-11 13:25:21,2013-12-11 13:25:21
5eeaf114cc45731f2597518828bb7b2c2abb552a...bab736c7d71f376849d5bebfac855a0a90b40504,1,1,1,2,1,2013-12-08 21:39:29,2013-12-08 21:39:29
de218bbba83b83f96f62b689a56b18b3ebcd191e...b9b17bc72b292029171fd3912c88cdc41fc5aea0,1,1,1,2,1,2013-12-09 08:09:52,2013-12-09 08:09:52
b9b17bc72b292029171fd3912c88cdc41fc5aea0...d466d527a496e14ef1c8fdbeb7a221bd3a239f09,4,29,19,48,9,2013-12-09 08:12:11,2013-12-09 08:12:11
5773638329d5c3ce4fe6cde894e92bc865042744...34f148714623ad917e59a97c5660ec4c13630d5d,1,1,1,2,1,2013-09-04 16:08:52,2013-09-04 16:08:52
5773638329d5c3ce4fe6cde894e92bc865042744...7c7c0e6139fd85ce174b869bffd14ccfee5b8d33,1,2,2,4,2,2013-09-04 07:45:10,2013-09-04 07:45:10
5773638329d5c3ce4fe6cde894e92bc865042744...6ed44eded5901d81491d7ef65af7717eef9d3aaf,1,16,11,27,10,2013-09-04 04:20:28,2013-09-04 04:20:28
6ed44eded5901d81491d7ef65af7717eef9d3aaf...a82d038f5244c36fed65e7339e3082c4bfc7bf18,1,1,3,4,1,2013-09-04 13:03:03,2013-09-04 13:03:03
a82d038f5244c36fed65e7339e3082c4bfc7bf18...ea734863c34cebcbd116706b25b4e5a0b2f24df3,1,2,5,7,2,2013-09-04 15:29:51,2013-09-04 15:29:51
ea734863c34cebcbd116706b25b4e5a0b2f24df3...43efd4371715600634da3735b495bf95fb04e041,1,1,1,2,1,2013-09-04 16:17:39,2013-09-04 16:17:39
43efd4371715600634da3735b495bf95fb04e041...a37b37169f6d1213ababcc35a0dcf13bba00f24f,1,1,1,2,1,2013-09-04 16:18:58,2013-09-04 16:18:58
a37b37169f6d1213ababcc35a0dcf13bba00f24f...11c3ffe4fc149b986e5a8be6beb3c3d4f6b3219e,1,1,2,3,1,2013-09-04 16:22:51,2013-09-04 16:22:51
11c3ffe4fc149b986e5a8be6beb3c3d4f6b3219e...e3647c1320bd6d7fe070c33686cdc1eb0f879cf7,1,1,2,3,1,2013-09-04 18:40:32,2013-09-04 18:40:32
894aa93a9f212ee370faeef309e62d2742d08bb9...72b1f69bfc77c3ad792e4c297ae239b6b86fd42f,1,1,1,2,1,2013-09-04 01:31:02,2013-09-04 01:31:02
e2908975ad9beebb2b9bfd2ab8dbaa59577b1a0f...4787a69efbe0fcd81228781b3c91dfe198aa0f1b,6,14,7,21,6,2014-01-12 21:51:03,2014-01-12 01:27:34
e2908975ad9beebb2b9bfd2ab8dbaa59577b1a0f...80c9c14ab956459f07a7f1de8693a2ab693bcb51,1,2,2,4,2,2014-01-12 01:15:08,2014-01-12 01:15:08
7ba6daabfe9686bbfbf12d1b83cda387378acc2b...431c544fbc5a90a3c58442a58d4d405b05d91ef2,1,2,4,6,2,2014-01-09 10:20:23,2014-01-09 10:20:23
7ba6daabfe9686bbfbf12d1b83cda387378acc2b...04ba67d6f181dd99b7ee82f9244c8ccfd8b565e7,2,2,2,4,2,2014-01-09 10:16:27,2014-01-09 10:16:27
7ba6daabfe9686bbfbf12d1b83cda387378acc2b...f116106bf62ef06fa4bb34a16f41422aa7364065,1,1,1,2,1,2014-01-09 08:11:01,2014-01-09 08:11:01
41257fe794f6c8dbb1a7bf3a33fea3187a1565e9...ae255447f24ef3dc995ee7939e1c8704160f0055,3,284,264,548,13,2014-01-05 20:55:03,2014-01-05 20:55:03
72d4fafd6636b8b59c8c0983a2c27908a25d1a70...82ed81fddfbe3f72404cbf48d01f4279db52855c,1,1,1,2,1,2014-01-05 05:35:06,2014-01-05 05:35:06
34566f493478b6d7098dfb0e435e0af06e24f6d1...938bc12c58343dde20caf8c3e88a674774705172,1,3,0,3,1,2014-01-06 04:52:37,2014-01-06 04:52:37
41fa8ead77ebb6a9f3cb4c4b2028ffab31487059...4e0d022de5b0d27b063156533dfcc248fc08257e,14,25,25,50,25,2013-11-02 00:15:34,2013-11-02 00:15:34
fcfa231131f2bfba230786c7bb60c391ab1d8a62...49de3bef79ab873aab69d86ac6a4df721381b748,1,1,1,2,1,2012-01-06 12:15:18,2012-01-06 12:15:18
2dd0db8aa3bfd286d9c416a93d0040f16567fcc8...e28b080c7989e9725beb1218dc45267fdd3b9bca,1,1,1,2,1,2011-12-14 15:48:50,2011-12-14 15:48:50
418e2c7d58d9fc6a126a58427b14a2cf68f97423...1438b14f74fc30c3b9bd63bd54d3bcfe5ce33c3c,6,330,305,635,29,2012-01-07 23:52:57,2012-01-07 23:52:57
d44e98b34da74f6db19db108ce3f13ba8fd5fe0e...ac4dd304604af590debd75f942b6f247c47321f5,1,1,1,2,1,2014-03-07 09:08:29,2014-03-07 09:08:29
d44e98b34da74f6db19db108ce3f13ba8fd5fe0e...d1d5d9041365c92b5e5577d2133a26fe509223e8,14,97,13,110,19,2014-03-07 08:59:22,2014-03-07 08:10:46
ad61c27885c9440977d8c136f4415801e77e3541...6452b409aaaf837ba009cffb341cb287c315fe74,11,14,8,22,11,2014-03-07 08:23:22,2014-03-07 08:23:22
901f358d16fb4911141f56f3b8806a367b8454b7...c0749df5a467690676d7bc9dad4d44e42715b4ed,1,1,0,1,1,2014-03-07 08:20:38,2014-03-07 08:20:38
c0749df5a467690676d7bc9dad4d44e42715b4ed...6a3faa6ab37bc2692823442a648cda27ee68ef9f,3,129,129,258,3,2014-03-07 08:22:57,2014-03-07 08:22:29
15d44940387f716ec5d2efee12bc9d9a7530ae56...aedee95dbfc13c3629e6fcf3b45b9df7299a5a85,1,69,0,69,2,2014-03-09 23:13:37,2014-03-09 23:13:37
aedee95dbfc13c3629e6fcf3b45b9df7299a5a85...fc74ee5f672f8340a03f9741e0d0cae15142f92b,6,6,6,12,6,2014-03-09 23:15:35,2014-03-09 23:15:35
fc74ee5f672f8340a03f9741e0d0cae15142f92b...71e9902d9a4ee0bf8bc94b4c3123a92a52d6ef65,7,9,9,18,9,2014-03-09 23:25:27,2014-03-09 23:25:27
15d44940387f716ec5d2efee12bc9d9a7530ae56...aacafb2d5c28460477311e92de4de8ac88b2461a,1,5,1,6,2,2014-03-09 23:03:46,2014-03-09 23:03:46
a9b964b9c361d743f66eef03127f298b6878fb7a...c399bfb01581fcc89474bb1d23718d279e246b45,1,1,1,2,1,2014-02-07 09:49:12,2014-02-07 09:49:12
0d49920e0dd08643238aabad11783d58ee72798d...8dab75d40822580f1a34b023edebc8a637113d07,1,1,1,2,2,2014-02-09 17:18:11,2014-02-09 17:18:11
67c4deb5844b27ce74df44a250d945bdba1006c7...4973bfd5d777f8a92d7d95eee6bd3231242af3eb,3,7,1,8,3,2014-02-11 04:23:29,2014-02-11 04:23:29
4973bfd5d777f8a92d7d95eee6bd3231242af3eb...9427310a09c0f477a01943a114bd8126f103b854,3,4,4,8,4,2014-02-11 04:49:17,2014-02-11 04:49:17
9427310a09c0f477a01943a114bd8126f103b854...3350c73666b811dbe9f351f97c6f6df4b66c6d04,2,3,3,6,3,2014-02-11 04:52:20,2014-02-11 04:52:20
39fec66fc4cb529d05f2b116abedf1bb2bdb65a8...ce013440e7d5c70be811fe51061bbf5afe943d53,4,5,5,10,4,2014-03-25 02:31:12,2014-03-25 02:31:12
ac1aba43a915f5038845db059cc36f369751c6f8...e87c272ab445028cbd991834670ee9d2ec1bc589,1,1,1,2,1,2014-03-17 08:49:32,2014-03-17 08:49:32
e87c272ab445028cbd991834670ee9d2ec1bc589...cb3f3926d79935f5b38611c10e7109b380df2c4f,1,1,1,2,1,2014-03-17 08:53:20,2014-03-17 08:53:20
cb3f3926d79935f5b38611c10e7109b380df2c4f...4d859d177a30b3d6c01e77343118f6c0246cd290,1,1,1,2,1,2014-03-17 10:04:37,2014-03-17 10:04:37
4d859d177a30b3d6c01e77343118f6c0246cd290...eea9eabb83a54402f0219d799e2156525d3c7709,1,1,1,2,1,2014-03-17 10:12:03,2014-03-17 10:12:03
eea9eabb83a54402f0219d799e2156525d3c7709...4df96c768f823106949ea07898b231ab8d40b109,1,1,1,2,1,2014-03-17 10:15:27,2014-03-17 10:15:27
9096c2002123a6dafdf0c3d9df5d069c968d738e...aac0e16452301a4735a668dc228b6b084b2d63d0,2,66,0,66,2,2014-08-29 00:17:50,2014-08-04 20:03:11
9096c2002123a6dafdf0c3d9df5d069c968d738e...b3e8001be2a2fb9d2c461a3a875b6351a189425c,2,64,552,616,37,2014-08-06 01:38:29,2014-08-06 01:38:29
9096c2002123a6dafdf0c3d9df5d069c968d738e...ddadb2cf659745e6261912fdf64f3c00c0a8b400,1,3,3,6,3,2014-08-06 00:42:03,2014-08-05 23:59:13
8194668c52f9fd5f3974409f1871c3882f39f4c2...325defb63f0d73084717853caeece887f48826f0,1,2,2,4,2,2014-08-15 18:37:32,2014-08-15 18:37:32
859ddc11fb350f985c377474b7727010e7da57a9...c4f431d262c1443bdf07a32890967c2b9688db62,1,2,3,5,2,2014-09-17 07:21:09,2014-09-08 22:10:18
859ddc11fb350f985c377474b7727010e7da57a9...d15444d15e0adc89cfa42bb7bdfcd8ce76f1881b,1,1,0,1,1,2014-09-08 22:18:18,2014-09-08 21:58:27
859ddc11fb350f985c377474b7727010e7da57a9...9702579aeb3f0aeb677631782c2920d6cd804475,6,12,12,24,12,2014-09-08 22:12:33,2014-09-08 22:12:33
9702579aeb3f0aeb677631782c2920d6cd804475...fb1ca10b99edc0f92eddd68b840f021da942afe9,14,106,35,141,37,2014-09-08 23:19:20,2014-07-15 10:39:27
fb1ca10b99edc0f92eddd68b840f021da942afe9...9b9e2f5d139e0accd141d5b4b04bb332ed341e4f,7,17,11,28,11,2014-09-08 23:23:48,2014-09-08 23:23:48
9b9e2f5d139e0accd141d5b4b04bb332ed341e4f...e29c75041e2e7bf93273528b217e410045fa563d,1,2,2,4,1,2014-09-08 23:32:42,2014-08-09 17:17:26
0dfd7375c56ba7949701cdec4fd7e15ec00b661e...21084192b642f7a7340a58c88025771ea281f48d,13,98,74,172,46,2014-03-25 02:08:05,2014-03-25 02:08:05
b3421cf040c92d50ec709a7ed761eb6ce9057e5b...06451a58d0d69ca035d3564f4a69c6e7b7f15ff9,1,1,1,2,1,2014-03-25 02:48:21,2014-03-25 02:48:21
af2c6de6d529504dfc041a4b55a019f58503ccbe...f29132350cb7f433d70589cc241d4bd14b6e551b,1,2,2,4,1,2013-12-18 22:52:50,2013-12-18 22:52:50
f29132350cb7f433d70589cc241d4bd14b6e551b...cb40a2ee8c88efdec0c35adf173cc96ba25db21e,4,23,201,224,4,2013-12-18 22:54:24,2013-12-18 22:54:24
cb40a2ee8c88efdec0c35adf173cc96ba25db21e...e8e60ae4bce85eed17c7e6801b72404494ef436a,25,43,43,86,40,2013-12-18 22:56:08,2013-12-18 22:56:08
b734a2a435c74e232d74317ef7c0b70bb2825bd6...5f9695ae7cf66dd7f07a3cb3eb534e838d18c62b,1,1,1,2,1,2013-12-21 17:36:51,2013-12-21 17:36:51
0c49f846e32a84c894df6970c45891e9e7debc04...86e6c869a3a0114e3cbd1aa6f22b8d88d5b18ab3,1,0,2,2,1,2013-12-21 17:59:24,2013-12-21 17:59:24
86e6c869a3a0114e3cbd1aa6f22b8d88d5b18ab3...bb644eede6be7b31b56664de5d0fea48096a7f40,4,39,3,42,6,2013-12-21 18:08:04,2013-12-21 18:08:04
bb644eede6be7b31b56664de5d0fea48096a7f40...2f56922937cdc9018db80c7e394dece7b523c70e,1,4,4,8,4,2013-12-21 18:09:39,2013-12-21 18:09:39
2f56922937cdc9018db80c7e394dece7b523c70e...c66924cc1ba7c1031818aceb8cd126a68a700bcf,2,7,0,7,2,2013-12-21 18:36:20,2013-12-21 18:36:20
a84bd5d9f153ffae914f8660a77534fb120ca551...362c9c9f89a39b6e365595efd35f2566275ddc01,1,1,1,2,1,2013-09-29 22:37:22,2013-09-29 22:37:22
0e628b65467f82d069df42f71a9c6c98be7bfd22...b352061d1d005bd5ad1a17bec2353c851e014bc6,7,4,32,36,7,2013-10-01 16:37:47,2013-10-01 16:37:47
0e628b65467f82d069df42f71a9c6c98be7bfd22...a97918297e0fe8253b4ad9f8a63a1186eae979c4,1,2,0,2,1,2013-10-01 00:54:49,2013-10-01 00:54:24
a388b7906ec6f2e85aca188f5375f80a9617e31e...1a0df1fbd09d58713e19a62f2073ec2db2eb9839,1,82,97,179,55,2013-10-10 01:52:57,2013-10-10 01:52:19
1a0df1fbd09d58713e19a62f2073ec2db2eb9839...4da37222cf5b7f6924940fcc543c1727d5b563f2,1,0,0,0,0,2013-10-10 01:58:50,2013-10-10 01:58:50
84413f6e29dccbf94a27e02c954bc91e3454aa80...a96aff1e564227cc03f10aa757ff5c2b80c482b1,1,1,1,2,1,2013-10-10 09:27:26,2013-10-10 09:27:26
84413f6e29dccbf94a27e02c954bc91e3454aa80...4b175d908cdbe923cfb2509bd5549509c300a71e,18,29,29,58,29,2013-10-10 08:51:18,2013-10-10 08:51:09
84413f6e29dccbf94a27e02c954bc91e3454aa80...c42af6951f0a665f9ad1d35a3a74051adb0aae03,1,1,1,2,1,2013-10-10 08:42:34,2013-10-10 08:42:34
bab736c7d71f376849d5bebfac855a0a90b40504...997a1f4ed244c7f42214e0d5adcee24e8e3c83f1,1,1,1,2,1,2013-12-09 01:17:04,2013-12-09 01:17:04
997a1f4ed244c7f42214e0d5adcee24e8e3c83f1...e1247e3edc35ff8419af3ab984bda69529aa4da1,2,2,2,4,2,2013-12-09 01:17:51,2013-12-09 01:17:51
bab736c7d71f376849d5bebfac855a0a90b40504...1f35b6ec5c3ff4801048e8a8c051d8af618e71de,1,3,3,6,3,2013-12-09 01:15:26,2013-12-09 01:15:26
25ec09f06a08ed21a6997424456560cee705fcae...bbe551044c00bf89fdc9bdfac809fead62767bdb,1,3,2,5,2,2013-12-10 19:17:32,2013-12-10 16:17:43
25ec09f06a08ed21a6997424456560cee705fcae...10e74a94e6cb512f9c2d592aaf46252d95e7d498,2,11,11,22,7,2013-12-09 23:35:13,2013-12-09 23:35:13
25ec09f06a08ed21a6997424456560cee705fcae...9e38e255343a4fd5fa2fa932c96be9cb5c902337,5,22,2,24,6,2013-12-09 22:29:19,2013-12-09 22:29:19
d8dc805f9b2b89ee48eb0f00337c6c37a6434117...6ce9b4d0419b1afbea11afe65a47c82966a89a2a,1,12,1,13,1,2013-09-04 19:08:07,2013-09-04 19:08:07
4f7f1f6c6e90a2102b9fa47f3d5594909cf51630...12558bb504618429b132a75db99dcd735d2b95a4,1,1,1,2,1,2013-09-04 08:59:44,2013-09-04 08:59:44
80c9c14ab956459f07a7f1de8693a2ab693bcb51...77ff3871fdb008198497a4d2767062a3137d11f8,1,227,82,309,35,2014-01-12 22:23:41,2014-01-12 22:21:02
77ff3871fdb008198497a4d2767062a3137d11f8...ef22ab5aedb10e334eb4177922e26936ca11fa54,3,17,14,31,3,2014-01-12 22:32:58,2014-01-12 22:32:45
ef22ab5aedb10e334eb4177922e26936ca11fa54...4b5e73b842104cb2cc93fe46224b8d50587b296e,2,167,0,167,2,2014-01-12 22:41:30,2014-01-12 22:38:30
4b5e73b842104cb2cc93fe46224b8d50587b296e...f972331a10a7cfab6a2f07f48945e67f11499f6c,1,8,171,179,5,2014-01-12 22:47:54,2014-01-12 22:46:23
f972331a10a7cfab6a2f07f48945e67f11499f6c...80bed836e0a699d43c483e9957d153edff1ce3d1,3,8,7,15,3,2014-01-12 22:53:21,2014-01-12 22:53:21
12765037547211563e237053424847b183cd8117...fc62379e61aa953d67b1bcf07c2f87d663ba77bc,5,5,5,10,5,2014-01-09 19:11:13,2014-01-09 19:11:13
9af8692307abc164e45db80e095d806fbf627bd6...6684005f63a851810548d3bcd7ca0460c953050e,1,4,2,6,2,2014-01-05 22:44:48,2014-01-05 22:44:48
9af8692307abc164e45db80e095d806fbf627bd6...5fc434c5f1f86978670df2a3bdb0e3bd9fb6da81,2,12,0,12,2,2014-01-05 21:45:56,2014-01-05 21:45:56
9af8692307abc164e45db80e095d806fbf627bd6...1d0bf580c99e9b03a4219c8aa4e313808bccbf10,1,2,2,4,2,2014-01-05 21:26:15,2014-01-05 21:26:15
b9d779a73cc7c5b75cbec8248d8cf87b693616c6...f63cd94e431602a3f4127bde684df219b106f7fc,1,1,1,2,2,2014-01-05 10:51:49,2014-01-05 10:51:49
b9d779a73cc7c5b75cbec8248d8cf87b693616c6...78eb8cc0f431cf20f128823202e9a6cf5a118c6f,1,1,1,2,1,2014-01-05 10:38:26,2014-01-05 10:38:26
938bc12c58343dde20caf8c3e88a674774705172...9fa2c95d78bf3cf17a8474bd04b5cf0b1e7b9d4c,2,4,0,4,4,2014-01-06 05:29:26,2014-01-06 05:28:52
938bc12c58343dde20caf8c3e88a674774705172...0593a206382d03b5e44b561946bef42fb30d6cb6,1,1,1,2,1,2014-01-06 04:54:31,2014-01-06 04:54:31
bacfd65cb2f9de9e9b4b3fcc83a3aef73befcb80...79c18da4525b00c0fd8692d31c774b1f1c92f324,3,21,20,41,9,2014-01-12 03:35:40,2014-01-12 03:35:40
79c18da4525b00c0fd8692d31c774b1f1c92f324...613a95d8388ffa625e2a4a4451b2425beca6c5df,2,23,18,41,12,2014-01-12 03:42:10,2014-01-12 03:42:10
613a95d8388ffa625e2a4a4451b2425beca6c5df...36aa3afb4f18a6a4a4a0c04f8494ee0673879517,2,4,5,9,3,2014-01-12 07:15:37,2014-01-12 07:15:37
36aa3afb4f18a6a4a4a0c04f8494ee0673879517...4b1ff7fa49361fd4a13341767d53231fc9ecef21,5,4493,4577,9070,536,2014-01-12 08:04:24,2014-01-12 08:04:24
4e0d022de5b0d27b063156533dfcc248fc08257e...0bb122a377bc2c809a7ce64fb740ee9620b4b72e,2,20,0,20,5,2013-11-04 19:22:30,2013-11-02 01:15:25
4e0d022de5b0d27b063156533dfcc248fc08257e...b75d5f5fc4063a867521b78e82538cb273d951da,1,1,1,2,1,2013-11-02 01:19:11,2013-11-02 01:19:11
a063e1f736fb4255f4445dba0be18f08bfab8687...d2e710a2dfb1a6b4eaccedd975b96b24baa12390,1,1,0,1,1,2013-11-06 00:37:54,2013-11-06 00:37:54
1f0d8b22a47ff1a140b066b165e7eded61960326...62e504715ad5290d05aa2791472f1147e5b0d779,1,1,1,2,1,2012-01-07 17:30:47,2012-01-07 17:30:47
e71a5321856a831a92c5b3749694948b386b0fde...791fd6a141db8905f66b379912be60d764bf0636,1,2,0,2,1,2011-12-26 04:17:35,2011-12-26 04:17:35
791fd6a141db8905f66b379912be60d764bf0636...7fbb3660ef0b1fd759355fc3d65994f0c14b4a2f,2,4,2,6,3,2011-12-26 04:18:49,2011-12-26 04:18:49
1438b14f74fc30c3b9bd63bd54d3bcfe5ce33c3c...2948d1c3b247a5aff1fd1f15cf72540e3f492f57,13,1005,900,1905,97,2012-01-08 04:40:28,2012-01-08 04:40:28
1438b14f74fc30c3b9bd63bd54d3bcfe5ce33c3c...4961aa8c2306b77dae2c0d5d54edc9d40b138217,1,0,1,1,1,2012-01-08 01:17:54,2012-01-08 01:17:54
0b415c6099af274e13564d429ed9551004c71b5e...b69e4d636a43439ae53e2b7782f163b1d1887cf4,8,132,135,267,46,2014-03-09 23:50:30,2014-03-09 23:50:30
aacafb2d5c28460477311e92de4de8ac88b2461a...2f7b04a192f271f63e83db9e2e6322b63abff252,1,27,27,54,4,2014-03-09 23:09:36,2014-03-09 23:09:36
c399bfb01581fcc89474bb1d23718d279e246b45...da43f97be170b9c14623d1615721755a9a5959cc,1,14,0,14,2,2014-02-07 10:08:32,2014-02-07 10:08:32
d5f0ccba2b12c1f90ae81b16cd12c65b6d376940...477cf1396d1e3c95fcb008e99f750b1559c9a76b,1,2,2,4,2,2014-02-09 20:41:47,2014-02-09 20:41:47
b4ba964801fde644e1ef3d4ee0f7e9ea50d40413...728067b586d2d989c07e8a6265f06fa8631c6b1f,16,146,146,292,76,2014-02-11 05:28:05,2014-02-11 05:28:05
30b14cdc7f2f903fdb58ad4e4d0f0a316089b946...bc250fb1e7c289ea07b9bcd117d9093021b16f46,1,1,1,2,1,2014-03-25 02:41:20,2014-03-25 02:41:20
c22b2705829f43ccd79f83c3e89d011a3cf5461f...475152a9a14fe09035a596b71573d7325b23bdaa,1,8,5,13,3,2014-09-08 12:56:29,2014-09-07 20:45:54
c22b2705829f43ccd79f83c3e89d011a3cf5461f...5befcb991cc62b338abc0401e6496c3866000a12,2,97,37,134,23,2014-09-08 06:03:26,2014-09-08 06:00:53
5befcb991cc62b338abc0401e6496c3866000a12...5b9fcea9f2541a3adcbea5dff5bafaf956c7195e,12,39,15,54,14,2014-09-08 06:04:33,2014-09-08 06:04:10
ae20895fd06cdf7cd8092a1fb31368ba2c0dfcd9...d80be40d04d0763c0cead3334ca6967bc9db3f28,1,1,1,2,1,2014-08-06 02:22:16,2014-08-06 02:22:16
ae20895fd06cdf7cd8092a1fb31368ba2c0dfcd9...d9f1ea8252933d7c6234b63a3dcb646849a13833,1,1,1,2,1,2014-08-06 01:50:10,2014-08-05 09:32:24
d9f1ea8252933d7c6234b63a3dcb646849a13833...2c625c7d1a82147ac81c3038cdfd84c5a34d97d9,3,61,93,154,32,2014-08-06 04:10:51,2014-08-05 10:56:33
31f7cb152efbc22ea61801915d81ba2b13435f97...71c2c372f6a14eae4bf7ae51958f770583bc2ccc,1,1,0,1,1,2014-08-17 22:41:53,2014-08-17 22:41:53
71c2c372f6a14eae4bf7ae51958f770583bc2ccc...e7d5905f38f5bd4c10425733e7b78941550a9cf2,6,6,6,12,6,2014-08-17 22:44:25,2014-08-17 22:44:25
e7d5905f38f5bd4c10425733e7b78941550a9cf2...ea0e1606dc8f6a351c850a3e51889872c0f07c31,1,1,1,2,1,2014-08-17 23:08:49,2014-08-04 17:04:00
31f7cb152efbc22ea61801915d81ba2b13435f97...6b7142212fdc57d247d0327e15f8b19c8b3f9d6d,12,28,28,56,28,2014-08-16 01:09:05,2014-08-16 01:09:05
acf3c0bf4848528b7d7cd5e5a3e890c4d33515fe...36ebec5e7605f4e0fe7e0caa5149e6d5d2e3b31a,6,8,10,18,8,2014-09-22 19:47:24,2014-09-22 19:47:24
36ebec5e7605f4e0fe7e0caa5149e6d5d2e3b31a...4a3931d4c57e30f3ed01cc66092178bb9e565851,1,19,1,20,1,2014-09-22 20:22:34,2014-09-22 20:22:34
a97db648817356623961f2d4aeb2bbfb80f5be37...0cf94b82ee49aa1b2f65495f87945ad3af51354f,6,8,6,14,8,2014-09-13 00:42:18,2014-09-13 00:42:18
a97db648817356623961f2d4aeb2bbfb80f5be37...4849ec1ceacb4f66efce043f59fe1c29475d0f4f,1,12,12,24,12,2014-09-13 00:40:44,2014-09-09 06:38:06
e29c75041e2e7bf93273528b217e410045fa563d...759a95b0fe57a07dad61786a920a860311261adb,1,1,1,2,1,2014-09-09 01:03:14,2014-09-09 01:03:14
8198bbad2a9919e57620396433904623017aba0b...c6648d58f047a4889c9e46dc3d1d22e5e17ffe2a,2,3,3,6,2,2014-03-25 02:09:30,2014-03-25 02:09:30
c6648d58f047a4889c9e46dc3d1d22e5e17ffe2a...5c2a9fc9c3009276b3e11cb5a1587a51bb1deb78,1,1,1,2,1,2014-03-25 02:13:29,2014-03-25 02:13:29
5c2a9fc9c3009276b3e11cb5a1587a51bb1deb78...6f6bce5944bd0e6ab36ab6b39339f381d8a80b2a,10,10,7,17,10,2014-03-25 02:26:41,2014-03-25 02:26:41
09a7770919eb00218c8d719f4c001ae22b0e0be8...6951b48e65f6c10e8d29e1ea2853e109943f3c9c,12,21,11,32,20,2014-03-25 03:01:46,2014-03-25 03:01:46
6951b48e65f6c10e8d29e1ea2853e109943f3c9c...b4f4c7b16f26ca1cf9fabf4bca4447e1cb2a688e,10,10,7,17,10,2014-03-25 03:02:56,2014-03-25 03:02:56
b4f4c7b16f26ca1cf9fabf4bca4447e1cb2a688e...acf57073231ebd521a87f523de6c51930d3c1ff4,9,9,6,15,9,2014-03-25 03:07:54,2014-03-25 03:07:54
acf57073231ebd521a87f523de6c51930d3c1ff4...488c6b43ede8fe2e6fb3cab2543cc6f939953b0c,1,1,1,2,1,2014-03-25 04:16:07,2014-03-25 04:16:07
488c6b43ede8fe2e6fb3cab2543cc6f939953b0c...e5c2531a165a4f296703a9338b61767683a8fec9,2,524,0,524,8,2014-03-25 06:29:11,2014-03-25 06:29:11
e5c2531a165a4f296703a9338b61767683a8fec9...ff0a33ab8ca75983454173c6dadc61409cc44626,3,30,104,134,9,2014-03-25 06:57:38,2014-03-25 06:57:24
e8e60ae4bce85eed17c7e6801b72404494ef436a...40651cf1ea9caa97bf7af81e44eed5f30e8b896b,11,13,13,26,12,2013-12-18 23:08:16,2013-12-18 23:08:16
40651cf1ea9caa97bf7af81e44eed5f30e8b896b...629a4743f0740c924ce6c9ab95c614ef6f4db939,1,0,1,1,1,2013-12-18 23:08:38,2013-12-18 23:08:38
629a4743f0740c924ce6c9ab95c614ef6f4db939...27697ef7e3e29c17eadb077054fbf85d9d8e6885,1,1,1,2,1,2013-12-18 23:12:30,2013-12-18 23:12:30
7ccb0333e488a74b7ffc40f9ed6fda379e50af37...ec13eb8d38c4b34b19d763638688f85553b2daf4,2,4,6,10,2,2013-12-23 05:05:08,2013-12-23 05:05:08
ec13eb8d38c4b34b19d763638688f85553b2daf4...cb7cdd0c0565f2872ef46fdc55b956aeb270e346,1,1,1,2,1,2013-12-23 05:18:45,2013-12-23 05:18:45
5f9695ae7cf66dd7f07a3cb3eb534e838d18c62b...51628d20506ea34b353d52fa2edfc22e6b814367,2,3,3,6,2,2013-12-23 05:00:53,2013-12-23 05:00:53
5f9695ae7cf66dd7f07a3cb3eb534e838d18c62b...ea5a4ec31e298de0304fdfd383726c7e1859b1d9,1,16,1,17,2,2013-12-22 09:45:18,2013-12-22 09:45:18
5f9695ae7cf66dd7f07a3cb3eb534e838d18c62b...a05a11e5dc9fcf86111b4baf61ac6a8e08946d30,3,5,6,11,3,2013-12-22 07:02:08,2013-12-21 20:59:40
5f9695ae7cf66dd7f07a3cb3eb534e838d18c62b...6e3ac8f2a466e27939710a8390b6f00e91538197,1,7,7,14,4,2013-12-22 06:59:36,2013-12-16 09:36:31
6e3ac8f2a466e27939710a8390b6f00e91538197...29aaf66a8ac3744a62b05dd7534aa6fabed98136,1,14,4,18,4,2013-12-22 06:59:36,2013-12-17 12:39:36
29aaf66a8ac3744a62b05dd7534aa6fabed98136...b27fecb7a39cbc27ed3a0e4c30adee1f82aadc14,1,6,6,12,6,2013-12-22 06:59:36,2013-12-17 12:41:15
906b0c595bb9f02bdb305888804faf277602a0c1...8bc6aeb60aeacc79605549e3be12f807b0f31eb7,1,37,1,38,1,2013-12-23 05:27:12,2013-12-23 05:27:12
8bc6aeb60aeacc79605549e3be12f807b0f31eb7...fd15b00861776d0a66a3dd74653ea1331996b4e7,1,0,1,1,1,2013-12-23 05:42:08,2013-12-23 05:42:08
362c9c9f89a39b6e365595efd35f2566275ddc01...2306375d13d620abfc072b33cba3fd0a73ac65af,1,1,1,2,1,2013-09-30 07:36:20,2013-09-30 07:36:20
362c9c9f89a39b6e365595efd35f2566275ddc01...462f27813f3bf0c4af3674f069793b0c1966e7d6,1,9,9,18,9,2013-09-30 01:24:00,2013-09-30 01:24:00
ab34f27c37030b4615be198dfa7018ce28c2d4c7...c43462678cd0c561e075a536cc9796cabb1257c8,6,36,36,72,6,2013-10-03 17:42:55,2013-10-03 17:42:55
c43462678cd0c561e075a536cc9796cabb1257c8...70453c2327c3ebcf704e485f8f9e34140f6a099e,1,1,4,5,5,2013-10-03 17:43:35,2013-09-12 08:45:15
4da37222cf5b7f6924940fcc543c1727d5b563f2...ef1fc34e616a0efda482ec54247a84d589244d55,3,4,7,11,5,2013-10-10 02:29:27,2013-10-10 02:29:25
3ea40c0d4f7b139933200808f70f3d28ffb0dd8e...dfdde4631272edb3f22288725292a1a1c46870d8,1,5,0,5,1,2013-10-12 01:11:58,2013-10-12 01:11:58
3ea40c0d4f7b139933200808f70f3d28ffb0dd8e...40db8e811d0e9aebf6e19977221a6217ec6ca2e2,1,0,0,0,0,2013-10-11 20:53:38,2013-10-11 20:53:38
9966d035cd35c510369286cbb645340bdd6ffc95...e3d799fca3f64211c74c13b4ea85ad6a33d693b9,1,1,1,2,1,2013-12-13 22:15:02,2013-12-13 22:15:02
9966d035cd35c510369286cbb645340bdd6ffc95...4b47c608351d1ac40a4067a163227db29035c47f,1,3,0,3,1,2013-12-12 17:53:59,2013-12-12 17:53:59
9966d035cd35c510369286cbb645340bdd6ffc95...fbf31f965e27a6665c7e0f2d97eb74c0df7585d4,2,334,0,334,2,2013-12-12 00:45:41,2013-12-12 00:45:41
b98d6ed12b1d2d04339b1559afc412e4a7409f0c...cdb7d9839e4ea7860f3258b2760c8d7bfb9da14d,2,2,2,4,2,2013-12-09 01:21:37,2013-12-09 01:21:37
1f35b6ec5c3ff4801048e8a8c051d8af618e71de...ae0d48057e7527640209aae0d60e484aa7552014,2,22,4,26,5,2013-12-09 01:42:59,2013-12-09 01:42:59
88d8cd90e2cef123b9389187e0d5acd1c9f1026d...9664f8da58abe718463ee31398e5d15de37f7289,1,5,5,10,5,2013-12-10 00:02:24,2013-12-09 23:59:50
9664f8da58abe718463ee31398e5d15de37f7289...ab29b1a3352e89fe8756a34e49a38341edd06844,3,4,4,8,4,2013-12-10 00:14:44,2013-12-10 00:12:41
80bed836e0a699d43c483e9957d153edff1ce3d1...d62d7b0733fad9ffc54245f6ae47bdfd08b65dff,1,2,0,2,1,2014-01-13 10:37:55,2014-01-13 10:37:55
d62d7b0733fad9ffc54245f6ae47bdfd08b65dff...685fe722c2613c8118b8f90fa485f00d13ba2ddc,1,2,0,2,2,2014-01-14 01:00:26,2014-01-13 09:06:48
685fe722c2613c8118b8f90fa485f00d13ba2ddc...b9216a292cb4f7c6cee326dc1ff09a96cd3430f8,1,1,1,2,1,2014-01-14 01:50:17,2014-01-14 01:50:17
fc62379e61aa953d67b1bcf07c2f87d663ba77bc...62fe50df73b07045ffa74cefdbb5e2b93435674e,1,1,10,11,3,2014-01-11 21:04:33,2014-01-11 21:04:33
fc62379e61aa953d67b1bcf07c2f87d663ba77bc...8c85e1b5a33e68dad0ee3d22b113987edc686214,1,3,3,6,3,2014-01-09 19:33:13,2014-01-09 19:33:13
c7eac32d3e6e7993bd19f9005aa29df1f4eba8e6...3e92ab0149d9bb06d715aaec3ee6f2b327cfea11,1,2,2,4,2,2014-01-05 16:38:32,2014-01-05 16:38:32
bbe5041cbf7b4b03490820a4c1b2cb8579c85eab...aed56fc0a6679a54760be3079b68336fb32aa9a5,1,1,1,2,1,2014-01-06 07:45:15,2014-01-06 07:45:15
0593a206382d03b5e44b561946bef42fb30d6cb6...ed8ef845974d2c59254fca8e3e85cec62b1cae1e,1,1,1,2,2,2014-01-06 06:39:09,2014-01-06 06:39:09
13b96677bacf3de360a762d11ad0e0007f0710da...38d689491033cc3a95b7ac74999f34428a837895,1,1,1,2,1,2013-11-05 08:11:57,2013-11-05 08:11:57
38d689491033cc3a95b7ac74999f34428a837895...4f5a865684db1ade9185a6b4823a8e249fd616d3,1,13,1,14,2,2013-11-05 08:17:05,2013-11-05 08:17:05
4f5a865684db1ade9185a6b4823a8e249fd616d3...68fc2f2515b147ed0e55831f66e30e1e769e1079,1,1,1,2,1,2013-11-05 17:23:58,2013-11-05 17:23:58
68fc2f2515b147ed0e55831f66e30e1e769e1079...18318b81b080de83567488031f13d9394ae21c16,1,3,1,4,2,2013-11-05 17:39:50,2013-11-05 17:39:50
ea3c89189a6b922c08729857006713de209b66d8...f1bc840d4368a79f0f0872000c3fdf6356af2a87,3,23,25,48,5,2013-11-02 08:35:51,2013-11-02 08:35:51
ea3c89189a6b922c08729857006713de209b66d8...db314528eb5d6287d1d285ecb18d79cb0ffd7ebc,1,2,1,3,1,2013-11-02 01:56:27,2013-11-02 01:56:27
5217131657afbb14bd497d21d72f5383756f0ed1...0bc458dfd2931f9aa5a817734240b6e3797250a8,1,12,4,16,2,2012-01-16 07:32:08,2012-01-16 07:32:08
1c7c5f750fc221ee94e435e4e49bc2ba1a6be5e6...175c3226b762c5707896d5568648f52e7f32e31d,3,4,4,8,4,2012-01-04 16:28:48,2012-01-04 16:28:48
343dd9616d0c596f67331ce30e4811cedccf2d39...95f47026cf55dc029d266e80bb4fab00b85af0e8,6,220,242,462,39,2012-01-08 05:09:02,2012-01-08 05:09:02
95f47026cf55dc029d266e80bb4fab00b85af0e8...ecffa038903412419163c7aed9299a7289ad14ad,3,2,67,69,4,2012-01-08 05:10:17,2012-01-08 05:10:17
ecffa038903412419163c7aed9299a7289ad14ad...d0eecc85f89fd258a2e58d7be06a8b6068da90e4,2,20,2,22,3,2012-01-08 05:18:47,2012-01-08 05:18:14
d0eecc85f89fd258a2e58d7be06a8b6068da90e4...22e0c5f7c8c092531b111b6042a7d7ee87d406b6,4,321,189,510,47,2012-01-08 06:06:44,2012-01-08 06:06:44
22e0c5f7c8c092531b111b6042a7d7ee87d406b6...961c479422f10cb566ade1f3a08d1b807d590b7a,1,12,97,109,3,2012-01-08 06:07:36,2012-01-08 06:07:18
864a18f95e29f7573c658df5869ccaa5aba4c46f...6f9e3f0d23071dad82f0acf942b01d2d79455a6d,1,3,3,6,2,2014-03-07 11:25:59,2014-03-07 11:25:59
864a18f95e29f7573c658df5869ccaa5aba4c46f...acdc053ee3f17ce10088b146d7b154e609240d3c,1,5,1,6,2,2014-03-07 10:28:48,2014-03-07 10:20:31
0143e38a672335b7ca2d73d0de5b2a2b4618f9e9...0b8d27a125dfaace415818d2bcb7c018a0ec0bd0,1,4,4,8,4,2014-03-07 09:30:38,2014-03-07 09:30:38
37b342b18a921b46ad9e720c774274f9c4cf5981...2f955907f95ad9b7f42f624eb11142339709c188,10,34,8,42,11,2014-03-10 00:12:39,2014-03-10 00:12:39
2f955907f95ad9b7f42f624eb11142339709c188...1a5fb4ef24f6d1beb71df946fa4781df10eab6e1,9,17,11,28,13,2014-03-10 00:22:52,2014-03-10 00:22:52
b263a0197be84f4018c124b738e07e35c42d493f...488360562496fd3be1b647007b24679ab64390d2,3,3,3,6,3,2014-03-09 23:15:53,2014-03-09 23:15:53
6814393c9ae6be56dbf0fed983001468e2da761f...3ccc16cad078cfcc76f3b9362f0039b0566d8914,7,9,6,15,8,2014-02-07 10:24:37,2014-02-07 10:24:37
535cd57537842a23a4f2cee6eb18301620c88ee7...dc79fecacd37879eae9659e36ef8d41cf1b6f5d7,1,6,0,6,1,2014-02-10 18:06:33,2014-02-10 18:06:33
dc79fecacd37879eae9659e36ef8d41cf1b6f5d7...77eaa808dbe68d232f3c8e0416ed25fbc12f1ffa,1,1,1,2,1,2014-02-10 18:12:28,2014-02-10 18:12:28
77eaa808dbe68d232f3c8e0416ed25fbc12f1ffa...9afead3fb0b919dd7f7185dcdac7b3f2ab3b9c50,1,4,4,8,1,2014-02-10 19:09:59,2014-02-10 19:09:59
9afead3fb0b919dd7f7185dcdac7b3f2ab3b9c50...ba4206b6443ab3f5744f3a7f88bcdfcefa7c5756,7,46,28,74,19,2014-02-10 19:15:08,2014-02-08 20:59:17
535cd57537842a23a4f2cee6eb18301620c88ee7...221ac861e427028fdcadf91e2a06b8baf9541b54,1,4,4,8,1,2014-02-10 09:57:11,2014-02-10 09:57:11
535cd57537842a23a4f2cee6eb18301620c88ee7...a843bfda18d1a9c0eabffdcf0900b957aef7d5cd,1,28,14,42,4,2014-02-10 04:42:38,2014-02-10 04:42:38
728067b586d2d989c07e8a6265f06fa8631c6b1f...38ebf57af50ea9429b4b9d100e8720efa7254fb1,1,1,1,2,1,2014-02-11 05:41:14,2014-02-11 05:41:14
728067b586d2d989c07e8a6265f06fa8631c6b1f...784a95d94598301a35a89a591a426438cace96a7,4,28,4,32,7,2014-02-11 05:34:05,2014-02-11 05:34:05
285feb4dd7cefbce0531d16db7bec8b99754f5d8...6cec0399d0580f54cea5043a32ba7bb0868ac235,9,24,13,37,10,2014-09-08 18:40:23,2014-09-08 18:40:23
7f56233862a9706cec0131e272d7bf7c0ca9f90c...48a1308e5dcf3fac575b74174ef07731203e335e,5,9,9,18,7,2014-09-08 17:23:25,2014-09-08 17:23:25
b4895a0d6dc493f17fe9092db4debe44182d42ac...f25181615e0bc0e3b80e15f44bbe505842f477a4,1,2,2,4,2,2014-09-08 06:06:37,2014-08-08 17:11:10
b4895a0d6dc493f17fe9092db4debe44182d42ac...436015c191f8f1b01176f7ea330d4d3d2b80e4ce,1,1,1,2,1,2014-08-07 23:23:50,2014-08-07 23:23:50
b4895a0d6dc493f17fe9092db4debe44182d42ac...8c3f095fa4ab8b92be1060aca490a38020068088,1,1,1,2,1,2014-08-06 12:56:56,2014-08-06 12:56:56
a8437f0d2357368556368cbde1afecda4f0117f3...8d7700b2b63a8abeb96a6f309610e9e8b4b4792c,1,2,3,5,1,2014-08-16 15:20:13,2014-08-16 15:20:13
a8437f0d2357368556368cbde1afecda4f0117f3...b6fe7c43e388865eda6314aa3f72590dfc768eb2,1,16,16,32,7,2014-08-14 10:26:47,2014-08-14 10:26:47
a8437f0d2357368556368cbde1afecda4f0117f3...da8daa667cad6a872fd16c1e76338e2e7e3e2a9e,1,6,9,15,3,2014-08-13 19:12:09,2014-08-13 19:12:09
da8daa667cad6a872fd16c1e76338e2e7e3e2a9e...559f16572f6c1f0967ee7fcd72c07c67423d85d8,1,24,19,43,3,2014-08-14 00:36:13,2014-08-14 00:36:07
ea0e1606dc8f6a351c850a3e51889872c0f07c31...9c2e54bfeca744ca3d2ab811b23d9a083502c53d,2,33,1,34,2,2014-08-19 02:58:19,2014-08-19 02:58:19
9efedf8f7b87222289c517d6fedde8cb401c1003...c954ba4545d223ebaae3297e41e3192bdd04f301,1,1,1,2,1,2014-08-21 10:42:30,2014-08-21 10:42:30
4a3931d4c57e30f3ed01cc66092178bb9e565851...c37c1a67438b3c682bac3787069eb33fefa6f154,2,23,1,24,2,2014-09-23 21:34:58,2014-09-16 04:02:27
4a3931d4c57e30f3ed01cc66092178bb9e565851...f540569e87134942cc0a4e52f6b79f9dc9b7e968,1,0,1,1,1,2014-09-22 21:17:54,2014-09-22 21:17:54
4a3931d4c57e30f3ed01cc66092178bb9e565851...be79bef5270297630c10c3143846038c1d994c3b,1,1,1,2,1,2014-09-22 20:48:05,2014-09-22 20:48:05
0cf94b82ee49aa1b2f65495f87945ad3af51354f...76762169c359b381f70fa518daef09e76b0aefe3,1,6,2,8,4,2014-09-13 01:07:32,2014-09-08 22:17:32
ff0a33ab8ca75983454173c6dadc61409cc44626...00943d0ecb8d744f5d300fde8f7313e5f2610a60,2,2,3,5,3,2014-03-25 08:03:45,2014-03-25 07:45:26
f32796559acbd4e1b276df5515b67926abf97a6e...4376ce84667264f63048bc3d13541bf273052579,4,61,51,112,98,2013-12-23 21:25:51,2013-12-23 21:25:51
f32796559acbd4e1b276df5515b67926abf97a6e...608926e808712cfca1f4c7653c56a2b9aa94bf7e,5,4,8,12,7,2013-12-23 17:02:42,2013-12-23 17:02:42
6cde19fc33fd8d8a93589ab7e70afc58e889d87e...b505c8557d4145b38257fc51d6ca4e7d98a0b62c,1,6,2,8,1,2013-12-23 06:07:01,2013-12-23 06:07:01
df5aa7c0f1f00b394ec9d322191e28acd581b754...7247527f0440acc7d4266e4d7cad91e25de38297,1,8,8,16,4,2013-09-30 17:45:20,2013-09-30 17:45:18
df5aa7c0f1f00b394ec9d322191e28acd581b754...f2d90d12dcef5b7871e4b82f2c1de93e461ceec5,1,0,1,1,1,2013-09-30 17:31:41,2013-09-30 17:31:41
df5aa7c0f1f00b394ec9d322191e28acd581b754...40c61a9bd7bbde64c164f66878b3fa844fa7a8a3,1,1,1,2,1,2013-09-30 09:26:52,2013-09-30 09:26:52
70453c2327c3ebcf704e485f8f9e34140f6a099e...a8afb4668802aaba50ca90e5862d91a750d90dc6,1,1,1,2,1,2013-10-07 03:18:03,2013-10-07 03:18:03
70453c2327c3ebcf704e485f8f9e34140f6a099e...6f9d980139a38c7bd09dfc9d339f7ac809b5a3bf,1,1,1,2,1,2013-10-03 21:15:49,2013-10-03 21:15:49
70453c2327c3ebcf704e485f8f9e34140f6a099e...32c74832158a3be2d50ef65ba50a2a52813a89b6,1,1,1,2,1,2013-10-03 21:05:23,2013-10-03 21:05:23
dcef0a78d5151b492f1acc93656c6df5f6201c51...12fa502e67df45d27e151fd51b5a497489232626,2,18,0,18,3,2013-10-13 22:23:58,2013-10-13 22:23:58
12fa502e67df45d27e151fd51b5a497489232626...ef2e0c99f4c5958eb16a401b73a39465a301a484,1,14,14,28,14,2013-10-13 22:24:39,2013-10-13 22:24:39
dcef0a78d5151b492f1acc93656c6df5f6201c51...8098f4e5ba36814030304867092aa268aaf370f1,1,10,5,15,5,2013-10-12 21:28:50,2013-10-12 21:28:50
810a852f4a2725da9a8990774714e8fce4c93cb1...8450aa7dbfabfe59702943ef20d5e4417f29e1b2,1,1,1,2,1,2013-10-14 06:23:04,2013-10-14 06:23:04
810a852f4a2725da9a8990774714e8fce4c93cb1...c5da0597bcd0d2bd1daddd3a0f784b8a5e8e1a44,18,17,23,40,18,2013-10-14 06:18:30,2013-10-14 06:18:30
810a852f4a2725da9a8990774714e8fce4c93cb1...f0f1b8319dcdc894f49c51e3678082dc15987516,1,5,1,6,1,2013-10-14 05:55:50,2013-10-14 05:55:50
c31ec22661256d59328c7d87eb324bba433f220b...fd293be5a17aa71128beb1a2152f8eb05107e21c,1,12,0,12,2,2013-10-14 01:49:13,2013-10-14 01:49:13
fd293be5a17aa71128beb1a2152f8eb05107e21c...2d1fa8cb5bdb61043b1abad5497ce2c74764106e,1,5,1,6,2,2013-10-14 01:54:15,2013-10-14 01:54:15
2d1fa8cb5bdb61043b1abad5497ce2c74764106e...dcbe591fa977a6e8aa93ab47ffba6adff24fb519,1,7,0,7,1,2013-10-14 01:56:03,2013-10-14 01:56:03
dcbe591fa977a6e8aa93ab47ffba6adff24fb519...6085973e258a50e829405b1c6cca743f7782017d,3,1,26,27,3,2013-10-14 01:56:31,2013-10-14 01:56:31
6085973e258a50e829405b1c6cca743f7782017d...6351c30782a87fe03d5c27e75f2287cc657ba06d,1,2,1,3,2,2013-10-14 01:58:09,2013-10-14 01:58:09
730ccd2a20d64a18e7fa26db93ae8bf9a35c0352...ce39cbe6fa4601836ecfced002803576a7b569b0,2,2,2,4,2,2013-12-12 19:48:08,2013-12-12 19:47:16
768f8b00f3cb25b83720a955f45f73f960e668c8...6df909ad9b85e5e19ff7760da8981bf7563a5bb9,3,13,5,18,7,2013-12-09 03:19:06,2013-12-09 03:19:06
768f8b00f3cb25b83720a955f45f73f960e668c8...c0200426ee72b165de400db740a60bae5d344b3c,2,62,24,86,17,2013-12-09 03:09:27,2013-12-09 03:09:27
c0200426ee72b165de400db740a60bae5d344b3c...f1cb57c8c2625089a2cdc4890897923cfaf02174,1,1,16,17,1,2013-12-09 03:12:37,2013-12-09 03:12:37
f1cb57c8c2625089a2cdc4890897923cfaf02174...6b55e93570b97af5487db4c35a0048e54f31ce38,1,321,0,321,1,2013-12-09 03:17:43,2013-12-09 03:17:43
6b55e93570b97af5487db4c35a0048e54f31ce38...dbe95f027d7b0a97b3fade2621fdb939e5fb05af,1,10,9,19,2,2013-12-09 04:46:12,2013-12-09 04:46:12
dbe95f027d7b0a97b3fade2621fdb939e5fb05af...aae9c2d1363c1c3f05ef09961ff49c8f040c7e84,6,8086,2903,10989,2400,2013-12-09 06:11:46,2013-12-09 06:11:46
aae9c2d1363c1c3f05ef09961ff49c8f040c7e84...4540f9e2d26e4e5b4838dc55133110ef5eab2046,4,4,6011,6015,5,2013-12-09 06:16:43,2013-12-09 06:16:43
4540f9e2d26e4e5b4838dc55133110ef5eab2046...e90ce1c0d540f4ddfe54cc84c8bd6e96f9f92f10,2,6,431,437,419,2013-12-09 06:32:07,2013-12-09 06:32:07
e90ce1c0d540f4ddfe54cc84c8bd6e96f9f92f10...0991c7c34100c5138676fa057a17902d933a696a,2,690,690,1380,418,2013-12-09 06:33:24,2013-12-09 06:33:24
0991c7c34100c5138676fa057a17902d933a696a...e4c1ef7c6d64696bc7ef367f8fd4f7c47b4c696a,3,481,496,977,490,2013-12-09 06:55:09,2013-12-09 06:55:09
28d8be1634de80c4ddfb936b004fe9dfffd86e20...95992ef7e93ed53b66b38cef67ea6dffaa6116ab,1,3,0,3,1,2013-12-10 00:27:42,2013-12-10 00:06:35
b9216a292cb4f7c6cee326dc1ff09a96cd3430f8...3a97697456534d19d5e1e4fe4010822611c786e6,4,54,0,54,6,2014-01-14 22:13:52,2014-01-14 02:19:37
b9216a292cb4f7c6cee326dc1ff09a96cd3430f8...bfe74f7b2f4b90d2544ed5e927b5f81d3043bc3e,2,2,2,4,2,2014-01-14 03:09:51,2014-01-14 03:09:49
6645e5daad17d53b930b78ea8baa14900f9b525d...82eccef7e3de32dcc2149ec1bb59320bcbe1b8a3,1,1,1,2,1,2014-01-09 21:45:10,2014-01-09 21:45:10
6645e5daad17d53b930b78ea8baa14900f9b525d...cba9d813400b410540cbc6480791ec927b91f619,1,10,10,20,2,2014-01-09 20:22:31,2014-01-09 20:22:31
aed56fc0a6679a54760be3079b68336fb32aa9a5...7722ab556674bbaef33b819e2d49ee3444220785,1,10,1,11,3,2014-01-06 13:41:15,2014-01-06 13:41:15
eca81939ccb989d6677ed5660d1db812cfabbff8...b77674950721a749f4a6213b4b6d3a4bae2bbad6,2,18,26,44,14,2014-01-14 06:54:22,2014-01-14 06:54:22
b77674950721a749f4a6213b4b6d3a4bae2bbad6...c4b41ceae3cdcb3b02b354922833ec826fff70b7,2,6,3,9,6,2014-01-14 06:59:09,2014-01-14 06:59:09
c4b41ceae3cdcb3b02b354922833ec826fff70b7...edd0b97be521346da0cdd39573914d9b9902167b,3,6,154,160,3,2014-01-14 23:52:40,2014-01-14 23:52:40
be60ee1377c3d6ab37f1333443b903975df8f33b...88b651012d5ccefde2088010134079c8eccc6051,1,1,1,2,1,2013-11-02 12:34:31,2013-11-02 12:34:31
fcb906ce09dd29d88c55237e8d0fd700fcd5f44b...05c826d67d761e09546385b8470a8fa7f26925d6,1,0,4,4,1,2013-11-03 03:08:11,2013-11-03 03:08:11
9dcc16fa8c8c009c46ffe43a07969e5cd196e562...774d8d8d17275eff96e9933575c9863ca38b3cdc,1,1,1,2,1,2012-01-24 13:46:44,2012-01-24 13:46:44
961c479422f10cb566ade1f3a08d1b807d590b7a...4478df768168fe41599508688046612bf5f1e526,6,189,359,548,56,2012-01-08 08:49:38,2012-01-08 08:49:38
961c479422f10cb566ade1f3a08d1b807d590b7a...d170224457581b6ab7305b29b4e2a15cb50ab853,4,45,107,152,13,2012-01-08 07:21:40,2012-01-08 07:21:40
d170224457581b6ab7305b29b4e2a15cb50ab853...3c2f82f469be4792e85eb73fd1e3b882dcadd48d,1,1,1,2,1,2012-01-08 07:31:00,2012-01-08 07:31:00
6f9e3f0d23071dad82f0acf942b01d2d79455a6d...d08bbdc6ec50baca9e34d2aa6e8bcfc8d6135217,7,12,10,22,9,2014-03-07 16:37:23,2014-03-07 16:37:23
6f9e3f0d23071dad82f0acf942b01d2d79455a6d...de27e729da5deee4507fa9c949b9e59270d08da1,6,6,6,12,6,2014-03-07 12:39:07,2014-03-07 09:55:21
30bbab06d84c991e4c8c465162c90368287f4f54...51b825d6b3ffb611f07cb64add8013350b222420,1,14,1,15,2,2014-03-08 00:05:46,2014-03-08 00:05:46
51b825d6b3ffb611f07cb64add8013350b222420...c8379ff2c71d79f017db437369ebad438800d977,1,1,1,2,1,2014-03-08 00:20:53,2014-03-08 00:20:53
1a5fb4ef24f6d1beb71df946fa4781df10eab6e1...348b7de7f7c6c1fb72b0e47124d814c639475f5d,37,1075,1094,2169,41,2014-03-10 06:18:48,2014-03-10 06:18:48
1a5fb4ef24f6d1beb71df946fa4781df10eab6e1...b4d66b7f6b8ca49fbf45fccf445910d607969946,10,40,10,50,13,2014-03-10 03:45:32,2014-03-10 03:45:32
b4d66b7f6b8ca49fbf45fccf445910d607969946...a15c24410be8b94671dcfc3b154e0034a3aaf35f,10,64,6,70,12,2014-03-10 04:25:51,2014-03-10 04:25:51
a15c24410be8b94671dcfc3b154e0034a3aaf35f...b1f71e5292017aca978fabb74d256989e1eeea07,1,1,1,2,1,2014-03-10 04:35:48,2014-03-10 04:35:48
3ccc16cad078cfcc76f3b9362f0039b0566d8914...cae76171d0bb6f461829b063735ffd84d6b2a07f,1,2,2,4,2,2014-02-07 10:44:04,2014-02-07 10:44:04
cae76171d0bb6f461829b063735ffd84d6b2a07f...4d7b2ddba92e47f923d22d9d7b23cb7b0a3e0bc2,6,23,7,30,9,2014-02-07 10:58:10,2014-02-07 10:58:10
3ccc16cad078cfcc76f3b9362f0039b0566d8914...d91d9b0ade9165c20d781ced128a751d0ae1fbda,6,85,84,169,14,2014-02-07 10:38:01,2014-02-07 10:38:01
ba4206b6443ab3f5744f3a7f88bcdfcefa7c5756...2bc29b4581cf6293b7c57d4f5bb450e099af3758,1,3,3,6,3,2014-02-10 20:11:10,2014-02-10 19:22:08
b01f995ad740a92cd2851def00c1ebcd277274b3...4b622c60c1cc215aa30df572bbb638033cebaa29,10,10,11,21,10,2014-02-22 01:42:25,2014-02-22 01:42:25
38ebf57af50ea9429b4b9d100e8720efa7254fb1...fe811b8906749ea83a5d8409a65562af8223227c,4,0,0,0,0,2014-02-11 06:57:31,2014-02-11 06:57:31
38ebf57af50ea9429b4b9d100e8720efa7254fb1...6f0059c5273bc6b051df411b9844b91b2b46a0cd,1,1,0,1,1,2014-02-11 06:12:28,2014-02-11 06:12:28
6cec0399d0580f54cea5043a32ba7bb0868ac235...1e6849dd58846138f8e428a76c705daf865c4e0f,4,3,4,7,4,2014-09-08 20:35:07,2014-09-08 20:35:07
48a1308e5dcf3fac575b74174ef07731203e335e...8bb1a3fc754eeda62c3ccdcd4da7c82854220a20,1,1,2,3,2,2014-09-08 17:44:28,2014-09-08 17:44:28
48a1308e5dcf3fac575b74174ef07731203e335e...f2783fbf83fc063f85dd89af2d315ae290f7f38b,9,12,15,27,12,2014-09-08 17:29:45,2014-09-08 17:29:45
559f16572f6c1f0967ee7fcd72c07c67423d85d8...ff18f380d50ef5c0a0e948804a2e2f1e7c3d616c,1,10,1,11,1,2014-08-15 00:59:55,2014-08-15 00:59:55
559f16572f6c1f0967ee7fcd72c07c67423d85d8...06c400201901fea0d84fde5be911cff2ab5e2d99,1,20,15,35,12,2014-08-14 18:42:13,2014-08-14 00:47:16
70a5b849e8e495679bc8943976f4e83c5f6a2511...6a0eb4e6bd19c5a9ddd201fbd2accca54f9a7dc9,6,8,8,16,8,2014-08-23 19:19:36,2014-08-23 19:19:36
6a0eb4e6bd19c5a9ddd201fbd2accca54f9a7dc9...f265137c0517266206055d306ed41e9456878652,1,0,2,2,1,2014-08-23 19:21:17,2014-08-23 19:20:09
cfa4f4db23a9c6bc23f72b70661527ecbc68f627...4969c2055d058ff6b0b110fd59753c7181a4390b,8,6,10,16,8,2014-09-22 21:27:13,2014-09-22 21:27:13
a3a04bfe53827c88f70f4162e33535f6ed56d287...0a4c39dc40e16a3aa18721bf78935e77ac11f097,6,16,8,24,12,2014-09-13 01:15:04,2014-09-13 01:15:04
0a4c39dc40e16a3aa18721bf78935e77ac11f097...4c9850701069954375b19e19bd1513654130eacf,2,39,6,45,4,2014-09-13 02:25:34,2014-06-03 15:02:06
4c9850701069954375b19e19bd1513654130eacf...d0f76e416cda07ad98e5ee6d91d132b580c9d051,6,20,16,36,10,2014-09-13 02:46:31,2014-09-13 02:46:31
6e206f5e8f3efbd80ade3d6e9109a7f7db312d8c...cabace78da29dd2b2928ca5f42e6a2a80307ee34,6,20,12,32,10,2014-09-11 21:43:27,2014-09-11 21:43:27
ba1790ba0b11fd4aec9b1095b0d28d5a653432f0...1d6187956f3a0ae0a3527da533b21608b9e18c3e,1,23,1,24,3,2014-03-26 06:00:47,2014-03-26 06:00:47
37bc0c230da521d2cfe1c6fbd36a5bfad914014f...0bd5bca6957bd26b526c92a7c90da78daf636e7b,21,19,19,38,19,2013-12-23 23:16:25,2013-12-23 23:16:25
6fda30e1c4532f639ae3cfe3921ea6cfb143e11b...96b5ae8b6ad3a2208d6eea209e42a9d1a9e0eddc,1,1,1,2,1,2013-12-23 06:32:35,2013-12-23 06:32:35
b505c8557d4145b38257fc51d6ca4e7d98a0b62c...9fc0e20381ec06bc85c68a5e6f1f2a5103a3267a,4,4,4,8,4,2013-12-23 06:31:13,2013-12-23 06:31:13
7247527f0440acc7d4266e4d7cad91e25de38297...def45c1f7456bae48119db999d81c3469912d0b7,1,2,2,4,1,2013-09-30 18:01:29,2013-09-30 18:01:29
7247527f0440acc7d4266e4d7cad91e25de38297...0b8a3e65aab91baba038a8a0f5de6201077cdef4,1,12,12,24,6,2013-09-30 17:52:59,2013-09-30 17:52:57
56ee42d335df18d675decc0b67f76757d02ca7e9...a8f21b5ae98bf515d79ed6b8a7bfa2d1e84ff056,2,35,3,38,3,2013-10-05 16:44:41,2013-10-02 05:11:51
a8f21b5ae98bf515d79ed6b8a7bfa2d1e84ff056...548603a9268cebcbef805b9dcd22b2da85ba643a,1,13,13,26,13,2013-10-06 22:24:26,2013-10-06 22:24:26
56ee42d335df18d675decc0b67f76757d02ca7e9...80e86442308b2cc86ba948de87e854057933e3ab,3,3,1,4,3,2013-10-05 10:55:26,2013-10-05 10:55:26
56ee42d335df18d675decc0b67f76757d02ca7e9...e246a97b91c08e064f83cd1e8219ff432458a460,1,2,2,4,2,2013-10-05 09:37:52,2013-10-05 09:37:52
e246a97b91c08e064f83cd1e8219ff432458a460...e8d7fb0737a129c916d0a8ec688e18902732aade,1,20,20,40,20,2013-10-05 17:32:52,2013-10-05 17:32:52
56ee42d335df18d675decc0b67f76757d02ca7e9...38941881e9a04c2de61be86fd05e5840c93dd1fb,2,2,2,4,3,2013-10-05 01:43:31,2013-10-05 01:43:31
38941881e9a04c2de61be86fd05e5840c93dd1fb...4b27c087836018b639c08788d452892c59e6e297,1,1,1,2,1,2013-10-05 22:37:53,2013-10-05 22:37:53
4b27c087836018b639c08788d452892c59e6e297...c7120a7b043cb19b84928cf562bc9c352788e337,1,4,6,10,5,2013-10-05 22:38:45,2013-10-05 22:38:45
c7120a7b043cb19b84928cf562bc9c352788e337...0740d01b4ccbce54b9e852df63bdf891b532baa2,1,1,1,2,1,2013-10-06 00:48:28,2013-10-06 00:48:28
857e697d72eed7a02591e2f8eebd913a69d862df...6c9ec3d87f400d77dbb598bff22b0e98a517e29c,2,29,8,37,8,2013-10-13 22:54:49,2013-10-13 22:54:49
6c9ec3d87f400d77dbb598bff22b0e98a517e29c...590975b4077ae6a2d5cba7d01403bbc09484bd6c,3,8,12,20,4,2013-10-13 22:55:13,2013-10-13 22:55:13
590975b4077ae6a2d5cba7d01403bbc09484bd6c...be1f0b07f3b8d0b78a7e07f624f111c02789c2b6,1,1,1,2,1,2013-10-13 23:02:56,2013-10-13 23:02:56
be1f0b07f3b8d0b78a7e07f624f111c02789c2b6...49f177fe6034c00242705a2f02b29758aaf96879,2,8,4,12,4,2013-10-14 00:12:04,2013-10-14 00:12:04
49f177fe6034c00242705a2f02b29758aaf96879...727a91de1cdf5cbc4f25528e073480332a5940c5,1,1,1,2,1,2013-10-14 00:25:27,2013-10-14 00:25:27
570aa8a30936a122abb37b78d48e85c6c67157db...c75f8a5bf64acc5ffb45c8bb6221e412b0b08bcd,1,2,2,4,2,2013-10-13 12:31:47,2013-10-13 10:53:48
ce07ff84cd554e4381760bc4cf476264ca6ca1d5...22820d7151fa155a4e083bf6c940a52e55138735,3,13,1,14,3,2013-12-14 07:06:04,2013-12-14 07:06:04
2d693def4389cf7f6641b4213b090959b194eebb...42697a4ecb2c034c9e88e245932b3914dfd1206c,3,97,1,98,5,2013-12-14 01:20:32,2013-12-13 11:03:15
42697a4ecb2c034c9e88e245932b3914dfd1206c...6b6b059ac388da516ed60e7b20098379466821b1,1,5,5,10,3,2013-12-14 01:22:46,2013-12-14 01:20:45
6df909ad9b85e5e19ff7760da8981bf7563a5bb9...9ceff600571b40acd7c02ae315a6f79da3b25d74,1,16,15,31,3,2013-12-09 07:34:24,2013-12-09 07:34:24
2a4621b71f3440fac06f519fe9a0e61d4418dbe6...0016c17f9307bc71fc96d8d4680a9c861f137cae,10,54,239,293,29,2013-12-09 07:18:28,2013-12-09 07:18:28
a6b5c7db1287a614c918d08c0f7b127be03ebe62...3e0366a3df12840cd086ff632e1455aae5c5ee65,1,1,0,1,1,2013-12-10 16:15:41,2013-12-10 16:15:41
a6b5c7db1287a614c918d08c0f7b127be03ebe62...11180e0fa7420d4e8ecb0fd0286a69f98a068fad,2,17,12,29,2,2013-12-10 16:09:14,2013-12-10 16:08:33
a6b5c7db1287a614c918d08c0f7b127be03ebe62...3b5e0c9a3cae9bfae38253ae153a3426d1f81ad3,3,7,4,11,7,2013-12-10 15:47:12,2013-12-10 15:47:12
a6b5c7db1287a614c918d08c0f7b127be03ebe62...9f12f840b94293392cb0da008d744107b952d149,2,2,17,19,2,2013-12-10 09:28:44,2013-12-10 09:28:44
9f12f840b94293392cb0da008d744107b952d149...3583aa27749d863d2974d6494081ce42280c8fbb,1,1,1,2,1,2013-12-10 13:47:50,2013-12-10 13:47:50
a6b5c7db1287a614c918d08c0f7b127be03ebe62...5749039f8d236306cc019bb0ec6c5c707f7f3121,2,0,2,2,2,2013-12-10 08:11:10,2013-09-18 06:06:53
e2a18430f994fc89499be76be1783032e73fd972...5ead87d519682c68b18bf796273da70a32b68a96,3,9,25,34,5,2014-01-15 04:46:25,2014-01-15 04:37:11
bfe74f7b2f4b90d2544ed5e927b5f81d3043bc3e...dde38280f787e54482b773caec06e9316b449301,2,81,45,126,37,2014-01-14 03:21:07,2014-01-14 03:21:07
1c66664bed59c8fc3a416883226dcff870b8fba9...99b66c1f2c1556c00e1dd4aaf593f31b7b36071a,4,4,4,8,4,2014-01-10 02:06:46,2014-01-10 02:06:46
99b66c1f2c1556c00e1dd4aaf593f31b7b36071a...7f153974e10980dccbdd485e63941b591e925148,6,14,4,18,6,2014-01-10 02:07:14,2014-01-10 02:07:14
99338caed00df37cdb1969a2f96862543be45abc...7fcfe61f4da41356b2ae974ad20536db0d74e83f,34,54,54,108,55,2014-01-07 00:05:24,2014-01-07 00:05:24
df3b44f27a25d72895adf5755bf5fef4eb02ea67...eae1af1d27e585e33dbd2f59d27eaaeda029a3e2,1,3,3,6,3,2013-11-04 10:33:43,2013-11-04 10:33:43
df3b44f27a25d72895adf5755bf5fef4eb02ea67...70db224073ddaa6d4e8378e265955a0d9dbd7cbc,9,11,0,11,11,2013-11-03 19:08:24,2013-11-03 19:08:24
bc505560a05cd867ea8dbfbcefe2217223d58316...19986b3dd8e921e9f0b4e238af6b4af83ef5bebe,4,153,16,169,8,2012-01-08 09:45:49,2012-01-08 09:45:49
19986b3dd8e921e9f0b4e238af6b4af83ef5bebe...b780034a65faf99acffb2c5cea27a98883ddf819,3,26,12,38,8,2012-01-08 09:50:12,2012-01-08 09:50:12
b9a0d1e4cd17b26d93fc314cff755a1a459c5f7b...3bdaa831e9003b4a76c887a94d6e698f6405ca00,1,2,2,4,1,2014-03-07 22:11:59,2014-03-07 22:11:59
b9a0d1e4cd17b26d93fc314cff755a1a459c5f7b...f9a56c28db92264a72d867ef9a2ed7f1f8198c45,1,2,2,4,1,2014-03-07 22:07:38,2014-03-07 22:07:38
b9a0d1e4cd17b26d93fc314cff755a1a459c5f7b...0f3b176a763abdaddfe3f538cc386b2b15456d0d,2,19,19,38,6,2014-03-07 17:54:53,2014-03-07 17:54:53
b9a0d1e4cd17b26d93fc314cff755a1a459c5f7b...91e57e2738fb46df241d23038fed729fc6471466,1,3,1,4,2,2014-03-07 16:59:43,2014-03-07 16:59:43
91e57e2738fb46df241d23038fed729fc6471466...0d0cbb87ee1791eec550be8d8a75909bc46b2ed4,1,0,6,6,1,2014-03-07 19:08:05,2014-03-07 19:08:05
41b28689062eeb564f41fcf06fac95521d0449a6...dd9946e919fec7cd3f187da38188e51688d30c0c,1,3,3,6,1,2014-03-08 22:03:28,2014-03-08 22:03:28
41b28689062eeb564f41fcf06fac95521d0449a6...e4c9492ad9ca2bec5dd62fa03d5272b99a92de01,1,2,2,4,2,2014-03-08 09:54:41,2014-03-08 09:54:41
41b28689062eeb564f41fcf06fac95521d0449a6...4b53ea30b42991394206a9050355bb3db578e9c0,1,1,2,3,1,2014-03-08 09:49:48,2014-03-08 09:49:48
41b28689062eeb564f41fcf06fac95521d0449a6...cbec164a50c68e13ba8635fa3b5d7040d30ad1a2,1,1,1,2,1,2014-03-08 09:44:24,2014-03-08 09:44:24
2f380a968353e1adc4a331e0c5892a07e1241ae7...b0bc9ef8152bd5b7fa46501414c0ce4a99b8d3d8,27,26,8,34,27,2014-03-10 06:44:11,2014-03-10 06:44:11
b0bc9ef8152bd5b7fa46501414c0ce4a99b8d3d8...38d0908aff17ca461dca262aa34973c356499fef,3,2,7,9,3,2014-03-10 06:51:38,2014-03-10 06:51:38
38d0908aff17ca461dca262aa34973c356499fef...3a2d6e40503019823bf197f278681e830bc14f31,29,21,108,129,81,2014-03-10 07:05:57,2014-03-10 07:05:57
b1f71e5292017aca978fabb74d256989e1eeea07...309ef72ef4f4096a88ecae60fe38db689047bc9c,1,6,6,12,6,2014-03-10 05:38:13,2014-03-10 05:38:13
4d7b2ddba92e47f923d22d9d7b23cb7b0a3e0bc2...54aece34589b0f1ccbcc3b9847ea5d2348d4e268,1,1,1,2,1,2014-02-07 19:48:12,2014-02-07 19:48:12
4d7b2ddba92e47f923d22d9d7b23cb7b0a3e0bc2...bdf9ce4c45b81e62ab7ebd88a9e3daa98ecdd10c,4,16,16,32,9,2014-02-07 18:31:08,2014-02-07 18:31:08
4d7b2ddba92e47f923d22d9d7b23cb7b0a3e0bc2...a0052b5a3745737777c88409ae08585ce75b285b,8,6,8,14,8,2014-02-07 13:14:32,2014-02-07 13:14:32
4d7b2ddba92e47f923d22d9d7b23cb7b0a3e0bc2...6db1a3f9097c0375350ce133548de70a87572e59,1,2,2,4,2,2014-02-07 12:40:32,2014-02-07 12:40:32
4d7b2ddba92e47f923d22d9d7b23cb7b0a3e0bc2...aead10fafa12c2bf197c2cb4ea3b3055fcc191f0,6,4,6,10,6,2014-02-07 12:34:17,2014-02-07 12:34:17
4b622c60c1cc215aa30df572bbb638033cebaa29...7a80b801d750387fe34d38835b48051512b95978,1,26,2,28,1,2014-02-22 02:54:50,2014-02-20 05:27:50
4b622c60c1cc215aa30df572bbb638033cebaa29...bdd7651e323a93a4e3d207463451dd374b0a70fa,5,278,45,323,56,2014-02-22 01:44:40,2014-02-13 19:48:23
2cef0af211e8b6780fff90fe5f110493585aa97c...6d232c2b9b5588cc2e06d0011e33c58e0e80aea4,1,8,0,8,1,2014-02-11 16:18:21,2014-02-11 16:18:21
f6264b444a1d14089a59fc4d643489bc56da9966...56c8c1bb559aa63cddb08eeccdfe704f2eb9ddf3,1,6,6,12,6,2014-09-09 06:33:26,2014-09-09 06:33:26
f6264b444a1d14089a59fc4d643489bc56da9966...b2088366a34e58537d5eb0a61b6d4dda81fb39bf,2,98,74,172,17,2014-09-09 03:52:07,2014-09-09 03:34:26
f6264b444a1d14089a59fc4d643489bc56da9966...c9602c29c337c912dab9dbbcadf0954a54026681,6,7,7,14,7,2014-09-08 20:41:45,2014-09-08 20:41:45
55787332389208d21cae92e223cba63f18e448d2...c6d7d71549388b071163a36f3cf05cb201c9230c,4,9,2,11,4,2014-09-08 17:57:50,2014-09-08 17:57:50
a9cd2ce4c91de2f5ba68fa754f36279a5d2f7b57...0140198699a41d299cd2d100e01c12c967b765e4,4,4,4,8,4,2014-08-23 20:46:28,2014-08-23 20:46:28
0140198699a41d299cd2d100e01c12c967b765e4...1517bea4e272935a31fdc0caaa9a924bb8346ca3,1,1,1,2,1,2014-08-25 00:18:58,2014-08-25 00:18:58
f36e1c467c6d3080179de69a15641e9725ce636e...4fc96e802950cb7fe9aa0580203992f2c467afe5,10,17,21,38,17,2014-08-23 20:35:22,2014-08-23 20:35:22
4fc96e802950cb7fe9aa0580203992f2c467afe5...28c907f635bf4f3413c5ae641773b0cf38e80672,1,2,1,3,2,2014-08-23 20:35:39,2014-08-23 20:35:39
28c907f635bf4f3413c5ae641773b0cf38e80672...3c0e2e28f8c421c3e96ff39da2a088410fffff45,1,0,1,1,1,2014-08-23 20:37:29,2014-08-23 20:37:29
f265137c0517266206055d306ed41e9456878652...9a39ee90b4fd4d5b9b6f9a6f2c9d5a29ffeafe92,4,10,10,20,10,2014-08-23 20:26:37,2014-08-23 20:26:37
f265137c0517266206055d306ed41e9456878652...dfa2759a52e73e720b0cda302a1edb9e2dbebc1f,5,10,3,13,10,2014-08-23 19:25:27,2014-08-23 19:25:27
e7b5c4c18becb3af36e03157303490fbc32f5434...12091b9567e77f8b503d31860b3115791b072a3b,14,42,14,56,16,2014-10-03 04:19:20,2014-10-03 04:19:20
e7b5c4c18becb3af36e03157303490fbc32f5434...68b80836cfdf6b942053470291c31f27c9c1b335,5,5,5,10,5,2014-10-03 03:20:23,2014-10-03 03:20:23
e7b5c4c18becb3af36e03157303490fbc32f5434...038a63b0ebce276186fae93916703dd0e70ac4a1,3,90,2,92,5,2014-10-03 03:16:31,2014-09-10 20:55:33
5cba9ba5646a93765bd1ae1e2f0e005fac94663d...ccecb7cde4f954a8941100b24c1b0c2008088276,1,5,0,5,1,2014-09-23 03:27:23,2014-09-23 03:27:23
d0f76e416cda07ad98e5ee6d91d132b580c9d051...73224f6564313126e84afd3a07ef807db6e4eafc,1,2,2,4,2,2014-09-13 08:59:42,2014-09-13 08:59:42
d0f76e416cda07ad98e5ee6d91d132b580c9d051...ca7c75d9789d5fa33754f24c6046e35f67cdb188,1,2,1,3,2,2014-09-13 08:50:36,2014-09-13 08:50:36
d0f76e416cda07ad98e5ee6d91d132b580c9d051...e094d470d4c679a43b5678363c7078674de56490,1,0,8,8,1,2014-09-13 07:39:15,2014-09-13 07:39:15
1d6187956f3a0ae0a3527da533b21608b9e18c3e...7c50859e9338512dfb70e5b512e67c95725f0f1a,2,41,18,59,15,2014-03-26 19:40:23,2014-03-26 02:12:16
0bd5bca6957bd26b526c92a7c90da78daf636e7b...f3ce6a9696f61720f10576f5744296c67703558f,4,36,27,63,6,2013-12-24 00:07:55,2013-12-24 00:07:55
0647049513b2644776ee77861e65f892d6b57c49...352532cd63a2d8e03ba7db806aa3bd110c023532,3,1,15,16,3,2013-10-07 19:39:11,2013-10-07 19:39:11
352532cd63a2d8e03ba7db806aa3bd110c023532...969cb04acbdd1b5835acc203675c10ec2ba98c2c,2,29,29,58,13,2013-10-07 20:00:46,2013-10-07 20:00:46
56093dea995b48a11b1352e303b9db9853750581...bb50e33a3068cd0e25f3411b59d66d3bd6751e66,1,13,13,26,13,2013-10-06 23:17:32,2013-10-06 23:17:32
56093dea995b48a11b1352e303b9db9853750581...146cd38867f6bec01868a8605d303426547e8680,1,1,1,2,2,2013-10-05 19:17:49,2013-10-05 19:17:49
56093dea995b48a11b1352e303b9db9853750581...b1cc07fa1525f0900d32bdcbdf7b38a616971acd,1,1,1,2,1,2013-10-05 18:14:19,2013-10-05 18:14:19
1eca83336e2322f39c3f86e10541696d424cd101...61aa9a4f60e17b8fa9af690d88a4eff61a72f7f4,1,2,1,3,2,2013-10-06 23:35:07,2013-10-06 23:35:07
a54dbfdf2a08ff04fc65f8e4f77ee5dc76bf4ef3...fd4130534f6453bbe9c306cfd0869ee6599394b1,1,1,1,2,1,2013-12-14 23:56:01,2013-12-14 23:56:01
fd4130534f6453bbe9c306cfd0869ee6599394b1...544b8ecab78c322bf826797374c0b10279cedf1f,3,15,13,28,7,2013-12-15 00:03:21,2013-12-15 00:03:21
727a91de1cdf5cbc4f25528e073480332a5940c5...6fa9037e1c37759bdf446e83926b12073c3cddf3,1,1,0,1,1,2013-10-14 01:40:47,2013-10-14 01:40:47
6fa9037e1c37759bdf446e83926b12073c3cddf3...edca93b8c71829cbe09055e048a31b54ec19eb5b,1,1,0,1,1,2013-10-14 01:43:19,2013-10-14 01:43:19
a43696467f4bb4ae1abae82453a1a543894d6766...ed12d41caed288b47f1f225115503d3086d69e6a,1,16,0,16,1,2013-10-14 02:10:17,2013-10-14 02:10:17
ed12d41caed288b47f1f225115503d3086d69e6a...bf4c7148513920f25a5c086fdf2091d06683f2ce,1,1,0,1,1,2013-10-14 02:12:23,2013-10-14 02:12:23
bf4c7148513920f25a5c086fdf2091d06683f2ce...ee4a1ea295a363c040de21d728dab9848f26461f,1,5,0,5,1,2013-10-14 02:24:13,2013-10-14 02:24:13
ee4a1ea295a363c040de21d728dab9848f26461f...950453db43f02d7d8dc653427f77317639cf0874,1,1,0,1,1,2013-10-14 02:31:39,2013-10-14 02:31:39
950453db43f02d7d8dc653427f77317639cf0874...f660bd42052949124a2c3342dadcdb12fd979f02,1,6,0,6,2,2013-10-14 02:36:39,2013-10-14 02:36:39
ecc6f4e6bc00b16fe3316d51d54aebe98b07aa0d...914f5e6a1d6faf57988cd26c31200796a4b743a9,2,4,2,6,3,2013-12-14 19:44:54,2013-12-14 19:44:54
0e6d34f24ffcde12187919e8caa636a65213c3cb...5f9ecc7351df9bc45117ffe7c8ab51d3571ef878,1,6,6,12,6,2013-12-13 07:01:11,2013-12-13 07:01:11
1bce8c93012c3d0e9f646f18d78632a43d5d93d5...56d89ed7aea8939e08aa839c9774634e60c39793,1,4,4,8,2,2013-12-13 05:58:44,2013-12-13 05:58:44
1bce8c93012c3d0e9f646f18d78632a43d5d93d5...1d5621165361aa3322ae7321412dbbce8f511bbd,1,1,0,1,1,2013-12-10 23:13:02,2013-12-10 23:13:02
1bce8c93012c3d0e9f646f18d78632a43d5d93d5...fc3e7433c274617d5bd0f12dff8dba05a4e3576c,1,1,0,1,1,2013-12-10 22:06:25,2013-12-10 22:02:24
fc3e7433c274617d5bd0f12dff8dba05a4e3576c...b9f12a5637ceb122eafdaa405a5e59e3cb516857,1,1,1,2,1,2013-12-10 22:06:25,2013-12-10 22:04:59
5ead87d519682c68b18bf796273da70a32b68a96...9ebd8d39a9d5853dd66ebed9a5f17e327e99f3ac,2,6,2,8,3,2014-01-15 05:26:19,2014-01-15 05:26:19
5ead87d519682c68b18bf796273da70a32b68a96...2ba15c375067aa23e6876caba1bc5a2313ca793b,2,4,4,8,4,2014-01-15 05:01:09,2014-01-15 05:01:09
2ba15c375067aa23e6876caba1bc5a2313ca793b...811639c4528d9b6f96f4800a807cf8769fa765fc,2,2,2,4,2,2014-01-15 05:02:06,2014-01-15 05:02:06
811639c4528d9b6f96f4800a807cf8769fa765fc...76e226b136c27e164a9864ad7690d0705a2906fb,1,1,1,2,1,2014-01-15 05:02:56,2014-01-15 05:02:56
76e226b136c27e164a9864ad7690d0705a2906fb...488443c9ad477ebd7f3c22db5caf088faf08f31a,1,1,1,2,1,2014-01-15 05:03:49,2014-01-15 05:03:49
df70e8d8458b63ca813466c9d8d0fa3aa2b716ff...2d038186e3f9c2902812671b1e396f2bd37b6f47,1,1,0,1,1,2014-01-14 05:08:04,2014-01-14 05:07:17
2d038186e3f9c2902812671b1e396f2bd37b6f47...aff64cffce549fc4c33c09b85c5cbe8b88df7dd7,3,1,9,10,4,2014-01-14 05:31:40,2014-01-14 05:31:40
7f153974e10980dccbdd485e63941b591e925148...831bbb8b45ca5d6707433a724106b0d23949a3d9,1,5,4,9,2,2014-01-10 05:21:51,2014-01-10 05:21:51
831bbb8b45ca5d6707433a724106b0d23949a3d9...c6a5e6accb6ad9255b5ff3df6ddb4b9d75eb9b58,1,2,2,4,2,2014-01-10 22:34:25,2014-01-10 22:34:25
c6a5e6accb6ad9255b5ff3df6ddb4b9d75eb9b58...46f5bbcf33a1151890011dae16792a63a9228b08,1,2,0,2,2,2014-01-10 22:41:23,2014-01-10 22:41:23
46f5bbcf33a1151890011dae16792a63a9228b08...e8cabf332aef000d7e4fb169524ad4c3f2c438ea,1,1,1,2,1,2014-01-10 23:33:04,2014-01-10 23:33:04
e8cabf332aef000d7e4fb169524ad4c3f2c438ea...17f2ef46aa68319668ed36f846fc72027b79afda,1,2,2,4,1,2014-01-11 02:47:51,2014-01-11 02:47:51
7fcfe61f4da41356b2ae974ad20536db0d74e83f...8d903fbd0214a2b3854612a56c200a99f6586a80,1,2,2,4,2,2014-01-07 00:27:49,2014-01-07 00:27:49
7fcfe61f4da41356b2ae974ad20536db0d74e83f...c42b6a3f8b4abcfb2aa6420819818b6b3bf753e8,1,1,1,2,1,2014-01-07 00:22:13,2014-01-07 00:22:13
a633fc042d4060499964fca7333edc5ac55cde4b...14975e4ee949a64413bde6d934d2198450c4478c,3,1499,1528,3027,162,2014-01-15 21:24:34,2014-01-15 21:24:34
de271bf6122d2d43a449518c08d00f9a507af874...aeee718247711d70b766ef9fac5bf0723c7cf905,1,1,1,2,1,2013-11-04 18:41:10,2013-11-04 18:41:10
b780034a65faf99acffb2c5cea27a98883ddf819...0bbb64be4dc7a168534e5a18f3a493002ed31293,1,2,1,3,1,2012-01-08 10:04:23,2012-01-08 10:04:23
b780034a65faf99acffb2c5cea27a98883ddf819...9daf1661c5c9cce161e1981b484b7d7f04eac2e6,4,7,7,14,6,2012-01-08 09:54:59,2012-01-08 09:54:59
9daf1661c5c9cce161e1981b484b7d7f04eac2e6...916761d56854ca4fcc8ea4afa68511fb26a93e4c,3,10,2,12,4,2012-01-08 09:57:05,2012-01-08 09:57:05
916761d56854ca4fcc8ea4afa68511fb26a93e4c...cf05dc86774ea05aa0f40aff771538e6e2f405d2,3,32,17,49,13,2012-01-08 10:15:47,2012-01-08 10:15:47
cf05dc86774ea05aa0f40aff771538e6e2f405d2...9e7acc637057292205906edc99fb23a49c937afa,4,73,57,130,13,2012-01-08 10:30:18,2012-01-08 10:30:18
9e7acc637057292205906edc99fb23a49c937afa...b7acbd8476060bc1f2da9837693b0b86b68423c5,3,122,106,228,7,2012-01-08 11:00:06,2012-01-08 11:00:06
b7acbd8476060bc1f2da9837693b0b86b68423c5...2376da40fb020289bcec4d2fe49ca2dc6f4eae97,1,13,40,53,7,2012-01-08 11:11:51,2012-01-08 11:11:51
2376da40fb020289bcec4d2fe49ca2dc6f4eae97...21eb2dac8a650ba13dabb41fd2d221ff918cdd30,1,32,4,36,4,2012-01-08 11:18:48,2012-01-08 11:18:48
c7984d41ca967d600246d5729dd0b88c40a9650c...67c747a109fb26b27bc255dd267c5262e51d5dcf,12,14,14,28,12,2014-03-08 23:30:18,2014-03-08 23:30:18
67c747a109fb26b27bc255dd267c5262e51d5dcf...03701b8d4bdda30dc625cdd263ca586835f544e3,5,28,4,32,10,2014-03-08 23:32:24,2014-03-08 23:32:24
7c9a58f3d93442e64628883f03d466af22341d10...bcfb27b962556a528579d742a60762831ed0c0ba,6,6,6,12,6,2014-03-09 00:11:24,2014-03-09 00:11:24
bcfb27b962556a528579d742a60762831ed0c0ba...7c3881086f7a6bc3ae5ea41c80ac2572878c8cdc,4,4,4,8,4,2014-03-09 01:11:48,2014-03-09 01:11:48
7c3881086f7a6bc3ae5ea41c80ac2572878c8cdc...4b6e1b6754b8732fd71497997a43a5f92f0c8bcf,1,1,1,2,1,2014-03-09 01:40:58,2014-03-09 01:40:58
a36643dd338537a9b4319fbab6e1dbf2e7d1cf9c...0b7b374691710c9b07d890c444cdb04fbbe1b6f1,1,1,1,2,1,2014-03-10 07:10:07,2014-03-10 07:10:07
309ef72ef4f4096a88ecae60fe38db689047bc9c...3640d71ad724899f6d86ae82987eae2c0ff3eaff,1,1,1,2,1,2014-03-10 06:25:15,2014-03-10 06:25:15
ccb17f110de8e90773a6ebfda9e35306d625dc78...76883ff9b478935369613db5b59bd07b615a8140,1,2,2,4,2,2014-03-10 05:06:12,2014-03-10 05:06:12
76883ff9b478935369613db5b59bd07b615a8140...30deb5697c08c885b5b7fedac6c40c13d7aa034b,10,126,9,135,15,2014-03-10 05:06:14,2014-03-10 05:06:14
30deb5697c08c885b5b7fedac6c40c13d7aa034b...7bef778c48cd8e4dad69c4f843899ec7b7c64f93,1,1,1,2,1,2014-03-10 05:06:51,2014-03-10 05:06:51
7bef778c48cd8e4dad69c4f843899ec7b7c64f93...72837b11e392d1cb9d6a478b6863cab716efd348,1,1,1,2,1,2014-03-10 05:10:58,2014-03-10 05:10:58
72837b11e392d1cb9d6a478b6863cab716efd348...213860408e1e82a933a4c2d89081e997f13db7b9,1,1,1,2,1,2014-03-10 05:19:02,2014-03-10 05:19:02
213860408e1e82a933a4c2d89081e997f13db7b9...a7b0fa7ebf8e09aff8efc293f5430db3c3fd4291,1,1,1,2,1,2014-03-10 05:28:29,2014-03-10 05:28:22
f07423511d301afe408f7ffcdce2b0ada71317fd...b61d12ff175af030f894fb7bde961ffbd9cfdeef,1,1,1,2,1,2014-02-07 22:21:32,2014-02-07 22:21:32
b61d12ff175af030f894fb7bde961ffbd9cfdeef...a2f08158d032c1025ca0c6bf411b8282b606fb7b,6,4,9,13,6,2014-02-07 23:44:50,2014-02-07 23:44:50
c8315edd7397cd3b836da67d50a7c5d7eb7de90c...b683433f672525cbbe25a4d5aa928610a66ea030,2,6,1,7,2,2014-02-08 23:44:13,2014-02-08 23:44:13
c3f845641425ebafac09e0e664d3b543d91e172b...8f7170abd04a356654d92700d30c006d70bc7778,1,1,1,2,1,2014-02-08 02:51:32,2014-02-08 02:51:32
7a80b801d750387fe34d38835b48051512b95978...b99be29f32f3db208b47bd33fbef1f63405ccfdc,7,18,11,29,11,2014-02-22 20:13:11,2014-02-22 20:13:11
7a80b801d750387fe34d38835b48051512b95978...49094844ac55a0e08d6d847b0e07868f8b639037,9,62,8,70,11,2014-02-22 04:51:06,2014-02-22 04:50:27
e49c7758aa7bfc82c7d4b120a0144024fcd2c2fd...1e1f5102944632beedc60c059a5c493e5f71aff1,5,1,50,51,7,2014-02-11 18:11:38,2014-02-10 19:20:50
48c67095b01406b4b8c89230bab000a4a9dd1900...c5c67d0f54674dede58fc924d4d7c0f1d65705d9,1,3,0,3,1,2014-09-17 18:28:24,2014-09-17 18:28:24
c5c67d0f54674dede58fc924d4d7c0f1d65705d9...db9e8ee813d13546acc9663970c810c230ed026c,2,51,1,52,2,2014-09-17 21:11:04,2014-09-09 13:17:06
db9e8ee813d13546acc9663970c810c230ed026c...3beeb32bb000f95b59e2bd6ca518c5fc2e797eb3,1,6,6,12,6,2014-09-17 21:33:22,2014-09-17 21:33:22
3beeb32bb000f95b59e2bd6ca518c5fc2e797eb3...0013f1298982f8ba4035a96c75156c98b408a7d2,1,2,1,3,2,2014-09-18 00:36:07,2014-09-18 00:34:57
0013f1298982f8ba4035a96c75156c98b408a7d2...3a1bf02ebf9a04757784973e234fb81d8b44a025,1,2,2,4,1,2014-09-18 00:48:40,2014-09-18 00:48:40
994d0b20aa19d673744f303ad81c1347a26b0c96...28f4632e6c7e3bf6d03dcc7bd4b97e7a907f4554,1,4,0,4,1,2014-09-08 18:05:32,2014-09-08 18:05:20
994d0b20aa19d673744f303ad81c1347a26b0c96...0d8f5fffa5a9a287140946b57570a036b9d33b99,2,10,3,13,4,2014-09-08 18:04:12,2014-09-05 17:27:23
0d8f5fffa5a9a287140946b57570a036b9d33b99...c12928abdb6c41ba5d2c81de98275c565b31f3f7,1,1,1,2,1,2014-09-08 18:04:47,2014-09-08 18:04:47
1517bea4e272935a31fdc0caaa9a924bb8346ca3...22edcc8d5024b1dc03c3b5d3c91f27e6a484c19a,1,1,1,2,1,2014-08-25 16:14:11,2014-08-25 16:14:11
3c0e2e28f8c421c3e96ff39da2a088410fffff45...56bb92ac4fbf6d5773e91afd205fb8ec09e3a573,4,10,7,17,6,2014-08-23 20:42:45,2014-08-23 20:42:45
56bb92ac4fbf6d5773e91afd205fb8ec09e3a573...32a6d9b404751b343f9043bdf48b67295b0dbebc,6,8,7,15,7,2014-08-23 20:43:41,2014-08-23 20:43:41
f4eefd28d10198ea60ce4069c00236e74cda1bf5...190452a36df91cebb0d9c7c1b5f46693f583db53,4,4,4,8,4,2014-08-28 05:40:46,2014-08-28 05:40:46
f579b66b80724fc560cce8d8b0294c6f998be364...76268c4b965c247ba012fba257c9b6400d0533eb,5,5,5,10,5,2014-10-03 04:21:49,2014-10-03 04:21:49
2c562d2386dc7beb87f9c78e5ae72e66d34258a6...5bb08c50fa866a05e657c5f912809ba98c10c1bb,6,14,8,22,10,2014-10-03 06:17:49,2014-10-03 06:17:49
5bb08c50fa866a05e657c5f912809ba98c10c1bb...44894a40e58c9ac14f8f9be1331b1dbf57056edd,1,1,0,1,1,2014-10-03 17:55:13,2014-10-03 13:56:55
ccecb7cde4f954a8941100b24c1b0c2008088276...5d051736a41b905ceca47b8121602db22c252576,1,1,0,1,1,2014-09-23 21:29:48,2014-09-23 21:29:48
ccecb7cde4f954a8941100b24c1b0c2008088276...6cfd176ac3d0eedc5b9b50fd88bf0774af0f1222,3,8,2,10,6,2014-09-23 20:29:19,2014-09-23 20:29:19
ccecb7cde4f954a8941100b24c1b0c2008088276...bd66b12a94a8a73c364b63c7bf09737851f2c73c,1,1,1,2,1,2014-09-23 09:19:15,2014-09-23 09:19:15
4f983bbaca9329b80e47a083f70ce9257f19a1a1...ad00ad85fed5ae27b9bbc67dd8c2efae7cc457c4,1,6,6,12,5,2014-09-15 22:43:34,2014-09-15 22:37:47
152d9dfe2e1bd2c5f7a2e750f93c3f7f2b8aefb3...5a5cf224e19f5c2e9b464d6d4b94a5f5d989d5d8,5,3,19,22,5,2014-09-16 03:59:09,2014-09-16 03:59:09
c692c29c7d3dfd3209e3da14912dd5de634b1eac...c97e6d5cad74d20257d28734f85311ef5d00b560,1,6,8,14,1,2014-03-27 05:09:56,2014-03-27 05:09:43
c692c29c7d3dfd3209e3da14912dd5de634b1eac...138af82e298fd57d2f992a39934067fc5bd99a91,1,1,1,2,1,2014-03-26 22:21:54,2014-03-26 22:21:54
c692c29c7d3dfd3209e3da14912dd5de634b1eac...361f452ed42d04c565de41ffca018fff5b35295c,1,4,1,5,1,2014-03-26 19:49:15,2014-03-26 19:49:15
340e2f553459a6499d77800658a37724af81dfb0...71e9db41834ae1f9873e4047033f868be5e98036,1,5,0,5,1,2013-12-24 04:28:21,2013-12-24 04:28:21
969cb04acbdd1b5835acc203675c10ec2ba98c2c...c814ad18333d7deefd3bff5446b02d6933f49f02,6,581,600,1181,166,2013-10-12 05:00:37,2013-10-12 05:00:37
c814ad18333d7deefd3bff5446b02d6933f49f02...a46003b8c7cc20bf4f72b7638a74643353ae047f,1,0,3,3,2,2013-10-12 05:01:11,2013-10-12 05:01:11
969cb04acbdd1b5835acc203675c10ec2ba98c2c...730d7f0b13143061fd0607cbe6c303d7bd8b74ec,1,1,1,2,1,2013-10-08 18:44:30,2013-10-08 18:44:30
e62e7ffcbc382f76cb30aa09d770bed381fb05fc...704635818fb6c5518bc1bf2efca18f484c9f2d28,1,1,1,2,1,2013-10-07 19:31:41,2013-10-07 19:31:41
704635818fb6c5518bc1bf2efca18f484c9f2d28...1adbe2043a0ab6adad95e823397f6444730dfb83,3,3,3,6,3,2013-10-07 19:32:23,2013-10-07 19:32:23
fbc67a395f12209c177d72cca3d298b0350eaf48...e7379f75bdeba88868dd4d4f169122a932e73822,2,2,2,4,2,2013-10-14 03:04:28,2013-10-14 03:04:28
e7379f75bdeba88868dd4d4f169122a932e73822...9da73d79c220280928dcd68dbd43a56d94a1ab85,1,1,1,2,1,2013-10-14 03:12:07,2013-10-14 03:12:07
f660bd42052949124a2c3342dadcdb12fd979f02...f946ff5d254d0d8383200101f19b64bcd8ba2c58,3,5,1,6,5,2013-10-14 02:57:14,2013-10-14 02:57:14
914f5e6a1d6faf57988cd26c31200796a4b743a9...11c6ab767cab5384188a301f7c9366b212432e81,5,46,16,62,10,2013-12-14 21:22:56,2013-12-14 21:22:56
914f5e6a1d6faf57988cd26c31200796a4b743a9...7f6cf5e50c687bc369edbf8604bdffcc8b165fb1,1,1,1,2,1,2013-12-14 20:57:59,2013-12-14 20:57:59
5f9ecc7351df9bc45117ffe7c8ab51d3571ef878...b7bf212995b63d303281023e02777963b265b976,1,2,3,5,3,2013-12-13 11:24:20,2013-12-13 11:24:20
b7bf212995b63d303281023e02777963b265b976...37b2c8a812337a6ed9324ba2e5dab9afbc5ad3ce,2,3,4,7,4,2013-12-13 11:27:56,2013-12-13 11:27:56
f32ef36dafaa295fb71b4b38427f57cf148ad6b8...2bc08190ec607c5fe9981fb54516addc85b06542,1,1,2,3,1,2013-12-11 03:43:52,2013-12-11 03:43:52
1facbf6e7a32cfb1334e9c84a59c762c27f13cb5...00239f6034edce116634c9b11565704a19ab157b,2,3,2,5,3,2014-01-15 21:18:35,2014-01-15 21:18:35
aff64cffce549fc4c33c09b85c5cbe8b88df7dd7...ea591748edee4f8fe722274b71787ccf2b052c4a,8,77,18,95,15,2014-01-14 05:58:27,2014-01-14 05:58:27
17f2ef46aa68319668ed36f846fc72027b79afda...3a8e99e91eeb03d72c0a015de16f743dd5335312,6,9,4,13,6,2014-01-11 02:56:44,2014-01-11 02:56:44
17f2ef46aa68319668ed36f846fc72027b79afda...b192d29981a394ea7c7f390d926cedeb8887062f,1,1,1,2,1,2014-01-11 02:56:39,2014-01-11 02:56:39
158a2394a27d3f0be269ca969c9203f9e74c8c22...483974695c981610a414b1e2925b734fabc07cf1,1,1,1,2,1,2014-01-07 07:45:33,2014-01-07 07:45:33
14975e4ee949a64413bde6d934d2198450c4478c...a8e14bf1f810c68a52480a21063538fbf3673c82,1,1,1,2,1,2014-01-16 06:25:44,2014-01-16 06:25:44
a8e14bf1f810c68a52480a21063538fbf3673c82...2bdf99fcc188909979280798e1e6bb4f11e20334,1,1,0,1,1,2014-01-16 06:26:08,2014-01-16 06:26:08
14975e4ee949a64413bde6d934d2198450c4478c...6986bdb2a7a0e4b98d905e9de029ffac141c6b8d,2,4,11,15,5,2014-01-15 23:01:41,2014-01-15 23:01:41
aeee718247711d70b766ef9fac5bf0723c7cf905...ed5dbf1b2b8187b6939ab10d75573118d346f970,3,9,1,10,3,2013-11-07 14:39:57,2013-11-04 17:09:48
0bbb64be4dc7a168534e5a18f3a493002ed31293...f1cbd22b99c3fec54d18341c31cfb1c237db44f2,1,1,1,2,1,2012-01-08 19:23:51,2012-01-08 19:23:51
0bbb64be4dc7a168534e5a18f3a493002ed31293...b14426c176689c314a339eaaec389c015e3d33ec,2,35,6,41,2,2012-01-08 10:44:19,2012-01-08 10:44:19
4b6e1b6754b8732fd71497997a43a5f92f0c8bcf...e9cced72fd7b7924d8b2d2a6b4be9247aa567680,6,6,6,12,6,2014-03-09 03:20:47,2014-03-09 03:20:47
e9cced72fd7b7924d8b2d2a6b4be9247aa567680...74aab91671eeb3066330023e030108b9e4d0ba84,2,2,2,4,2,2014-03-09 03:32:40,2014-03-09 03:32:40
3fb5d0bbac39e62fb24c08eda2f6c22b6809007b...552f170e3c070e36b28defd22895b748139f56e3,6,6,6,12,6,2014-03-10 20:31:34,2014-03-10 20:31:34
1848b0f24935225add87b02f6096d8e50e604d6b...564b79ca875b2deb88adfc90e08fe4015b8001ce,5,11,11,22,11,2014-03-10 06:58:29,2014-03-10 06:58:29
564b79ca875b2deb88adfc90e08fe4015b8001ce...6dd51fab44df852697564f6257403b57f85f492b,1,1,1,2,1,2014-03-10 07:06:38,2014-03-10 07:06:38
e727973d8c8cec151f13bd65d24a664918efd28a...1a417357ad19e5797bb338cca7de9bd8b7dbabc6,2,2,1,3,2,2014-03-10 07:35:50,2014-03-10 07:35:50
e727973d8c8cec151f13bd65d24a664918efd28a...d985e5bf56ea4087730784a01ebec3067cbcc5ec,1,1,1,2,1,2014-03-10 07:31:55,2014-03-10 07:31:55
e727973d8c8cec151f13bd65d24a664918efd28a...d50a89bea9320c16272cb10fbaa779d26dbe700e,4,4,4,8,4,2014-03-10 06:55:29,2014-03-10 06:55:29
5d8491ac9fa1c89e649b28e0ba1b860e7fe07607...866c52b92862235982710c1ecfe141d6416f405f,1,1,1,2,1,2014-02-08 23:51:38,2014-02-08 23:51:38
8f7170abd04a356654d92700d30c006d70bc7778...938779ca93eb2da9b9c91edd6d1c047b6d10748e,4,5,3,8,2,2014-02-08 21:29:06,2014-02-08 19:34:26
8f7170abd04a356654d92700d30c006d70bc7778...4c163600364243fd710b5e69ef3ba5365b16fc6d,2,3,1,4,2,2014-02-08 21:12:18,2014-02-08 21:11:49
8f7170abd04a356654d92700d30c006d70bc7778...c3cb63b69fbd423e5bd6b8332e809d21df9b306a,2,234,86,320,37,2014-02-08 16:19:39,2014-02-08 06:20:17
4ccf088a24b8c0f9694458c81d44514559712a65...7e551ecaf71cb9971990e156c54e5ee0fb758a98,7,8,8,16,8,2014-02-22 20:38:56,2014-02-22 20:38:56
24bf4398802098097875a11f69dfd750a0550c87...eb20d6f13244052f7794825531c9ee7e76430559,7,18,5,23,7,2014-02-11 22:20:01,2014-02-11 22:20:01
eb20d6f13244052f7794825531c9ee7e76430559...5796b56d9665ed84b6c6635c7ceb7d68a068003c,4,16,2319,2335,4,2014-02-12 18:50:47,2014-02-12 16:47:08
5796b56d9665ed84b6c6635c7ceb7d68a068003c...40142bdc5197b69f26e4d8ea3e30cd4fcf0d7cdb,4,6,6,12,6,2014-02-12 19:02:56,2014-02-12 19:02:37
40142bdc5197b69f26e4d8ea3e30cd4fcf0d7cdb...dff122f7f0733f653d6845f7338b55388cd982f9,1,2,2,4,2,2014-02-12 19:07:04,2014-02-12 19:07:04
3a1bf02ebf9a04757784973e234fb81d8b44a025...6f6466330dda9a9738868f146ce4fae47d88e332,1,5,0,5,1,2014-09-18 01:33:39,2014-09-18 01:30:02
55dd964690380977cfbc71494e6030b70c17b949...b1bb57360cf494693abb623390263d27b7d97195,2,6,3,9,3,2014-08-26 10:12:54,2014-08-19 09:11:57
55dd964690380977cfbc71494e6030b70c17b949...c207b5b66b2f41472b706b9e37557c6105eb1a80,2,7,7,14,12,2014-08-26 01:02:29,2014-08-26 01:02:29
55dd964690380977cfbc71494e6030b70c17b949...a03d269287f39c22fb7d4f5a5edd94293aa0c1ae,7,2,9,11,8,2014-08-25 22:24:09,2014-08-25 22:24:09
55dd964690380977cfbc71494e6030b70c17b949...4c15fa86421f6ee276b15d971618bcd906ab6a5d,1,12,12,24,7,2014-08-25 22:04:34,2014-08-25 22:04:34
a25b866ec7afd7cce613d24c9f5a1955eedc1277...0a816e009f5596e4a73afe4380372bf8c16e55cb,4,6,4,10,4,2014-08-28 06:01:58,2014-08-28 06:01:58
0a816e009f5596e4a73afe4380372bf8c16e55cb...aa25ce779de9c4c012f7e0b881cddc9719a027cb,4,12,7,19,7,2014-08-28 06:17:37,2014-08-28 06:17:37
aa25ce779de9c4c012f7e0b881cddc9719a027cb...0ec05da0eea03849fc72bed84a2c7fe7be1de1b6,4,3,6,9,6,2014-08-28 06:31:34,2014-08-28 06:31:34
0ec05da0eea03849fc72bed84a2c7fe7be1de1b6...72ddad6fc88fc7ee9ff99556f1aa64b21539bd03,2,35,0,35,2,2014-08-28 06:33:03,2014-08-28 06:33:03
72ddad6fc88fc7ee9ff99556f1aa64b21539bd03...fe19211e4dee35374803788b24b8c44f1bc179f1,4,2,6,8,6,2014-08-28 06:34:46,2014-08-28 06:34:46
fe19211e4dee35374803788b24b8c44f1bc179f1...783e001786e21659a63aae2513a71bb73667c974,6,15,14,29,14,2014-08-28 06:35:54,2014-08-28 06:35:54
783e001786e21659a63aae2513a71bb73667c974...d869a5fb62888887178a75bfa295787e6f70eadd,2,1141,934,2075,209,2014-08-28 06:38:53,2014-08-27 18:21:49
76268c4b965c247ba012fba257c9b6400d0533eb...82eaf3cdce087d85ecd29cdf2a35a2deb8771d7a,1,15,15,30,6,2014-10-03 05:18:39,2014-10-03 05:18:14
44894a40e58c9ac14f8f9be1331b1dbf57056edd...d361470487a171eb7e4647b761db62c6e181a8bf,1,1,1,2,1,2014-10-03 23:26:53,2014-10-03 23:26:53
44894a40e58c9ac14f8f9be1331b1dbf57056edd...00b381ed9b86d1614a7feda0c59e222d1e83bff8,1,12,0,12,1,2014-10-03 22:16:46,2014-10-03 22:16:46
5d051736a41b905ceca47b8121602db22c252576...93f4426fed83e53e60bc36a280687085eca1d4aa,1,1,1,2,1,2014-09-24 00:18:15,2014-09-24 00:18:15
5d051736a41b905ceca47b8121602db22c252576...a28e5a3024d2d86e31acd030276c0d70bd109942,1,4,0,4,1,2014-09-24 00:14:13,2014-09-24 00:14:13
5d051736a41b905ceca47b8121602db22c252576...d6903e4239afaf5659ec655c8f73f411f441f415,1,4,2,6,2,2014-09-23 23:53:09,2014-09-23 23:53:09
28582080385ab8ade3949644b36794335a4ba80d...e70fc61eff8f4e08ccf1728ecbce7e32465cdd25,1,1,1,2,1,2014-09-24 18:10:18,2014-09-24 18:10:18
1783c7072726495f9cc9b41e04d8e5180e7868a5...73e3db0a2f0134d4755b8bd4153cb1b6b3d9842d,1,2,0,2,1,2014-09-16 03:01:06,2014-09-16 03:01:04
c97e6d5cad74d20257d28734f85311ef5d00b560...015569a138e2de222e7d0d7abbf1b4d91364e9c3,1,1,1,2,1,2014-03-27 09:54:39,2014-03-27 09:54:39
c97e6d5cad74d20257d28734f85311ef5d00b560...0c775f84ee4a7bb657c1dd1241c65053b6991f38,1,21,19,40,17,2014-03-27 06:00:20,2014-03-27 06:00:20
0c775f84ee4a7bb657c1dd1241c65053b6991f38...10586bf040655919260344695aeeb9e7977ed70c,11,12,12,24,12,2014-03-27 06:02:51,2014-03-27 06:01:21
c312d735d94300b09ad82d520c03a604634282c7...7e1f2994d10c6f5c2da4f7ec20cddf273e8b8b3d,3,3,3,6,3,2014-05-13 04:15:27,2014-05-13 04:15:27
c312d735d94300b09ad82d520c03a604634282c7...f219fee07b14ea1d37e197b1d80f5c7a8e3bc186,11,23,1,24,11,2014-05-13 04:15:16,2014-05-13 04:15:16
28e6c34268b70a0aa3cf32321fecfba568248dbe...0907244256d923807c3a4e55f4ea606b9558d0ca,4,30,20,50,10,2014-03-29 06:45:22,2014-03-17 19:04:58
0907244256d923807c3a4e55f4ea606b9558d0ca...35d34ccfaad366175978d9d737116a8537176ff8,2,2,2,4,2,2014-03-31 00:17:59,2014-03-31 00:17:59
35d34ccfaad366175978d9d737116a8537176ff8...db6572e726d93fbc056d22e60090c77ee703c536,2,4,4,8,4,2014-03-31 00:26:13,2014-03-31 00:26:13
db6572e726d93fbc056d22e60090c77ee703c536...a419e41c325c20a024ad0abea3d7cc8b537d2b26,1,1,1,2,1,2014-03-31 01:00:06,2014-03-31 01:00:06
71e9db41834ae1f9873e4047033f868be5e98036...679c7862374be9b742862923181302f76b3a8c06,27,46,46,92,42,2013-12-24 20:16:17,2013-12-24 20:16:17
71e9db41834ae1f9873e4047033f868be5e98036...a87b150bc771e3bc6e62fd2ca8a4ea938c48e28c,4,5,5,10,4,2013-12-24 06:08:43,2013-12-24 06:08:43
a87b150bc771e3bc6e62fd2ca8a4ea938c48e28c...1fc08c1973b30a1fc57a241a5bb68566cfc1d981,4,6,2,8,6,2013-12-24 06:57:39,2013-12-24 06:57:39
730d7f0b13143061fd0607cbe6c303d7bd8b74ec...62c905f5bc8c2132d434b9bedd5b75c2ea3d85a2,1,1,1,2,1,2013-10-09 07:45:05,2013-10-09 07:45:05
730d7f0b13143061fd0607cbe6c303d7bd8b74ec...ef3ac6808f21d1b6282982e94ef0784ae5236f7c,1,1,1,2,1,2013-10-09 06:33:03,2013-10-09 06:33:03
5a411af9676501c8916f814411d962b5594644ce...7bd955318ae9aeb989e1945f0834f15523a9cc15,2,2,2,4,2,2013-10-14 02:57:45,2013-10-14 02:57:45
7bd955318ae9aeb989e1945f0834f15523a9cc15...44b32a30366440b2127b343fbd1990fe15e88185,4,16,16,32,5,2013-10-14 02:59:42,2013-10-14 02:59:42
85316c8a0c012b2607b184248dce60a5bd535a4b...f1869771bc8b8e8a6c7a98385ec58e0bf0d2d98e,3,497,0,497,3,2013-12-14 22:18:43,2013-12-14 22:18:43
2bc08190ec607c5fe9981fb54516addc85b06542...a3a2525124cacae7c94a9280066cbe6eb6524059,1,1,1,2,1,2013-12-11 18:52:47,2013-12-11 18:52:47
2bc08190ec607c5fe9981fb54516addc85b06542...caa3d53dcbb99234ffb901b393196eef5b5f5452,2,2,2,4,2,2013-12-11 11:27:23,2013-12-10 22:29:42
2bc08190ec607c5fe9981fb54516addc85b06542...6355832e9062ebe8668fb49a9468bce5b5274f97,1,1,1,2,1,2013-12-11 10:57:18,2013-12-11 09:59:25
208df78971a6d0b5b8fd6e44c071cced03e9b169...8dc1d00dd49786bb0cb748aed95a3499d9907cb7,1,1,1,2,1,2014-01-15 21:44:23,2014-01-15 21:44:23
8dc1d00dd49786bb0cb748aed95a3499d9907cb7...91c6419d0924dc36ad6599519c2afc53e6a33721,1,1,1,2,1,2014-01-15 22:26:29,2014-01-15 22:26:29
8c0cb806c6471749761efb4f9c892344d357e769...4f58356e910d045f3ada73ec347bd86cee5e9d39,1,0,0,0,0,2014-01-14 12:47:18,2014-01-14 12:47:18
8c0cb806c6471749761efb4f9c892344d357e769...c335104957c4ecd30530fd63a5aafc8ffc764d46,2,1,1,2,1,2014-01-14 12:41:21,2014-01-14 12:41:21
8a04ed44a190a276287cec9230794713d6b0dea3...7a2c352b501cfd6dafebe2115c767609ca212a25,1,9,8,17,1,2014-01-11 03:04:11,2014-01-11 03:04:11
483974695c981610a414b1e2925b734fabc07cf1...3661c4b8fff65950a26b468df26f3ccfd0248257,1,2,2,4,2,2014-01-07 08:11:07,2014-01-07 07:57:43
81610c6048844d4de43422ad978afa4c39718c4d...93ab926dc7521327c6a403bfb460dd20c8d52400,1,2,2,4,1,2014-01-17 19:22:32,2014-01-17 19:22:32
81610c6048844d4de43422ad978afa4c39718c4d...ad64b0acc826a1ad1b1adc719960ac3020cc3539,1,1,1,2,1,2014-01-16 18:11:59,2014-01-16 17:34:16
0335b8df521e78befa7c91b9d7d0bff77aa310ad...9039a5e90b980c61cf820e499d84e2a30de948b2,2,0,2,2,2,2014-01-15 23:04:08,2014-01-15 22:29:58
c78016e3acaa84adbdde9297c1082825b165f77c...d4ded76a8fbd35ac66663a6b54f7ab6f85bf0350,3,8,150,158,6,2012-01-08 19:33:55,2012-01-08 19:33:55
d4ded76a8fbd35ac66663a6b54f7ab6f85bf0350...fbd686ad655e1a22450f517e9ec241eaafc167f7,2,3,1,4,2,2012-01-08 20:08:00,2012-01-08 20:08:00
2623f325ec8c2c22045cc8b8d634322de80c1edc...7b321e9c1fbd5ff124cb190f1375a78b132fb9cb,2,6,35,41,2,2012-01-13 08:03:23,2012-01-13 08:03:23
90eb52495b12149b7ed2d1301c7c9cf5990cca85...4d96e69a55a7d5c964d672fe2cf8f89c057bcb57,6,12,8,20,8,2014-03-09 03:45:38,2014-03-09 03:45:38
4d96e69a55a7d5c964d672fe2cf8f89c057bcb57...b8ab0c66accc28fb909bba54a0d09fa190ac20cf,2,2,2,4,2,2014-03-09 04:03:31,2014-03-09 04:03:31
6234ba561a5d6549b68825416905d4fdbabc695e...91d0a6d7792e8d76108701077b3d838f8f53e7ae,1,1,1,2,1,2014-03-10 16:32:49,2014-03-10 14:58:16
ac8db909c545751398c76b11f24096a25e07a67f...a83ca387133f4ce0aa5d773e25930363214b8e6f,10,15,13,28,13,2014-03-10 23:41:56,2014-03-10 23:41:56
7e551ecaf71cb9971990e156c54e5ee0fb758a98...7b60470e9b6e159205be5f5a38260ef5756d8569,6,6,4,10,6,2014-02-22 22:16:11,2014-02-22 22:16:11
7e551ecaf71cb9971990e156c54e5ee0fb758a98...983265b08aa3f5a1934eb5f6967885b9742b56cd,1,0,2,2,1,2014-02-22 20:49:58,2014-02-22 20:49:58
dff122f7f0733f653d6845f7338b55388cd982f9...55e6d4b9b567d2682cf3504f638892a0cb81c374,2,2,2,4,2,2014-02-12 19:27:31,2014-02-12 19:27:31
dff122f7f0733f653d6845f7338b55388cd982f9...f6d029f6abf0ae892a54c18bc283e0ef33ef430d,1,12,12,24,11,2014-02-12 19:13:54,2014-02-12 19:10:55
0a5ba4aab2d67003388a16044b9ab652c75dbec2...75204aeafa3ca7759d812e93becd4a311673f3a4,6,6,6,12,6,2014-09-19 01:33:52,2014-09-19 01:33:52
75204aeafa3ca7759d812e93becd4a311673f3a4...642fbf7e3671c9432bb3b7d321e0223721c2980a,1,29,0,29,1,2014-09-19 02:00:26,2014-09-19 02:00:26
642fbf7e3671c9432bb3b7d321e0223721c2980a...98b745a06bc6a4b73efbe5710b1eea68eef80e5b,1,1,1,2,1,2014-09-19 02:00:30,2014-09-19 02:00:30
98b745a06bc6a4b73efbe5710b1eea68eef80e5b...9ed65ab44456316805c298cbc258cd66857ab7e7,3,4,2,6,3,2014-09-19 02:09:51,2014-09-19 02:09:51
9ed65ab44456316805c298cbc258cd66857ab7e7...e33922eb06387fd4ed3a090360a2bc38cf7b8d70,4,8,3,11,4,2014-09-19 02:11:47,2014-09-19 02:11:47
e33922eb06387fd4ed3a090360a2bc38cf7b8d70...1f329f8f17aa989eabc6e94bdcab93e69ef0e463,2,2,2,4,2,2014-09-21 22:34:57,2014-09-21 22:34:52
1f329f8f17aa989eabc6e94bdcab93e69ef0e463...7f415e20e7c513d2932519b3a503c298d7aa04e3,1,0,6,6,1,2014-09-22 17:16:25,2014-09-22 17:16:25
7f415e20e7c513d2932519b3a503c298d7aa04e3...7441d3f4c55e9180dcc1f7700fe1c9710213f032,1,0,6,6,1,2014-09-22 17:59:38,2014-09-22 17:59:38
b1bb57360cf494693abb623390263d27b7d97195...701c27e22edd2e42e011029d2b7e44d57e729980,2,80,104,184,40,2014-08-26 10:51:05,2014-08-26 10:49:16
701c27e22edd2e42e011029d2b7e44d57e729980...ac132da789ab64b09f4944de0205167fd1cc5fc4,2,3,3,6,2,2014-08-26 10:54:22,2014-08-26 10:54:22
e851b8685a13ee4c8ab79ca517dcdbb49c891b9a...a7f58a83567af5be9ad8530379978a1d78b19a12,6,160,160,320,160,2014-10-29 03:30:31,2014-10-29 03:30:31
35f09315ed543a0479719afa2143240952c215db...f5890adb17fe085fdb3a3e5f169102a121dc1e25,4,4,4,8,4,2014-08-28 05:25:24,2014-08-28 05:25:24
35f09315ed543a0479719afa2143240952c215db...57c152e8ff946befab6ea1b2ddd18f63efea8c23,1,5,5,10,5,2014-08-27 20:37:55,2014-08-27 20:37:55
35f09315ed543a0479719afa2143240952c215db...3ce160754cd55540c68156da599c58f779826c3b,1,1,1,2,1,2014-08-27 12:20:49,2014-08-27 12:20:49
d14d60e04cb807bc2e1931a899f712056cf6ce13...1ebc7e62a8672c59c3bd886bc71ca90e9571d1bc,9,19,19,38,13,2014-08-28 05:37:10,2014-08-28 05:37:10
36f098dc07b13c245e9e81ac1302b2b436ee5795...28dd4a4407cbe70ade0b33aa03161c7081c2b213,1,6,0,6,1,2014-08-29 00:10:44,2014-08-29 00:10:44
28dd4a4407cbe70ade0b33aa03161c7081c2b213...551306fe9dde347c19c6b8d91a2e9b2dccf0f4c2,1,1,1,2,1,2014-08-29 00:22:08,2014-08-29 00:22:08
0f28bbf732312778886416c1e2d5f469412cd199...f75fc324622df92ffb0edef30dc87536dfba0b26,11,32,24,56,17,2014-10-03 05:21:02,2014-10-03 05:21:02
3fda099f5c69fe1cb7a217aaecf73a7131a4d513...582bb7dcdc85e54d09a14a0e9d9e87b22bc1d7d5,1,2,2,4,2,2014-10-03 04:52:53,2014-10-03 04:52:53
7af7a5eadb385246309f1c6460690fc768795cfa...61705d35fa314a16579169fb7379e5101716e715,1,5,21,26,3,2014-10-07 04:57:46,2014-10-07 04:57:46
93f4426fed83e53e60bc36a280687085eca1d4aa...afde59ef8768db97217b3be80515187360489076,3,13,0,13,3,2014-09-24 01:24:37,2014-09-24 01:21:12
93f4426fed83e53e60bc36a280687085eca1d4aa...f334a15e9e4e0dcb241f8755141fe6fdfbaede44,1,1,0,1,1,2014-09-24 01:06:39,2014-09-24 01:06:39
e70fc61eff8f4e08ccf1728ecbce7e32465cdd25...24ae068f21bd619235dfed5b9218b5b83b815160,2,39,5,44,3,2014-09-24 23:35:51,2014-09-11 21:40:15
9814256736fce32674c55a792b3b56185f50d47c...51f1f58be8d4d58e06dfd8ed2ed3ab6ea81295a5,6,29,11,40,9,2014-10-23 04:39:51,2014-10-23 04:39:51
0e18ee643b6e788324275929fa418cf0b8c96203...16f9529ed1291ed7e36b530f475b6705f9942347,1,1,1,2,1,2014-09-16 03:40:03,2014-09-16 03:40:03
e9982cad66839f82515079912f207ee1b9708f9d...dea1945b4769cf9097b5da67a587b29a982023e2,1,3,8,11,4,2014-03-27 17:48:23,2014-03-27 17:45:25
dea1945b4769cf9097b5da67a587b29a982023e2...98bddd8904f2d745ad16d8bd591a0771577bf414,1,1,0,1,1,2014-03-27 19:49:53,2014-03-27 19:47:59
8d3e9874202347eb9df0e7ca7e9679580c636756...90902db50cd9545639bb79ae30d1d81e84c12b6c,3,61,62,123,12,2014-03-28 11:48:19,2014-03-28 11:48:19
90902db50cd9545639bb79ae30d1d81e84c12b6c...440cedeed3e23960d0516153ef776c78f9efeabc,2,11,11,22,11,2014-03-28 12:03:22,2014-03-28 12:03:22
7e1f2994d10c6f5c2da4f7ec20cddf273e8b8b3d...d03fd289d997fc7d8c16ce451f61a34265b48fc4,1,2,2,4,1,2014-05-13 04:17:42,2014-05-13 04:17:42
a419e41c325c20a024ad0abea3d7cc8b537d2b26...11ffc7346b9a26735fe857e9b0794a5c609c1b7b,1,4,0,4,1,2014-04-01 03:23:14,2014-03-31 08:24:54
a419e41c325c20a024ad0abea3d7cc8b537d2b26...dffbf8ff780042d211835e68dc79ed6dbc24e779,1,11,2,13,6,2014-03-31 08:46:29,2014-03-31 08:37:55
a419e41c325c20a024ad0abea3d7cc8b537d2b26...e59da022308c613deae3091723d5517bdaee9e43,1,7,5,12,1,2014-03-31 07:00:05,2014-03-31 07:00:05
5c2dfbf33b133a5e31035df970ffa05585eba422...04ec4354ed66931c68b30eef6617e79e66a3dc7a,3,3,3,6,3,2013-12-24 20:18:53,2013-12-24 20:18:53
1fc08c1973b30a1fc57a241a5bb68566cfc1d981...50bd4edb8c2f498ac10a07250c57570489c427b0,4,32,10,42,10,2013-12-24 20:32:06,2013-12-24 20:32:06
1fc08c1973b30a1fc57a241a5bb68566cfc1d981...fe839e6e78fa07ab422b5d38189bc8f8929cead0,4,4,4,8,4,2013-12-24 07:30:06,2013-12-19 05:38:35
1fc08c1973b30a1fc57a241a5bb68566cfc1d981...3d65fc2b65e7c8d17e58adc385d642aff8065a89,20,20,20,40,20,2013-12-24 07:22:53,2013-12-23 17:23:07
44b32a30366440b2127b343fbd1990fe15e88185...be4e951b7dc254dac08a5d2c6b88be0cda6e420f,3,9,3,12,5,2013-10-14 03:02:24,2013-10-14 03:02:24
d1fd917b7aa0c9faf012c59d59f9adf60f5bbe05...c11f78d7ebedbe3a6759ec29760ac2b0db31c6b0,1,1,1,2,1,2014-01-14 13:40:27,2014-01-14 13:29:02
b790ea9011ca344c34cf02f3bba8d4a137ed1398...e5d6ab9b31315b189670a9a58d65054c1df35401,1,1,1,2,1,2014-01-18 22:50:45,2014-01-18 22:50:45
c5bed1a85017aea5d68b21600e09ee35395bb495...ffdc18cbbf7d519ad741eb621345e2e4e28a18e9,1,13,13,26,7,2014-01-17 19:52:35,2014-01-17 19:51:53
190ae7bb3175375ce095a63b44cc81f90e51105a...47f786e6ea21462a3653b3134b26f8088f855c82,1,1,1,2,1,2014-01-16 18:41:34,2014-01-16 18:41:34
9039a5e90b980c61cf820e499d84e2a30de948b2...53bcb829bbe9eee1ab2f65a9b1ca0c024711e34d,4,40,38,78,6,2014-01-15 23:34:10,2014-01-15 23:34:10
9039a5e90b980c61cf820e499d84e2a30de948b2...bb964b131ca3997e5a889743d0da06b94b612dd6,1,1,1,2,1,2014-01-15 23:17:04,2014-01-15 23:17:04
bb964b131ca3997e5a889743d0da06b94b612dd6...4c9433d13d789fac5edcc8531abc8f6b0fcf0f54,1,1,1,2,1,2014-01-15 23:22:05,2014-01-15 23:22:05
9039a5e90b980c61cf820e499d84e2a30de948b2...a624981ef334c64adf5df829f02cda95528782f1,1,1,1,2,1,2014-01-15 23:04:38,2014-01-15 23:02:13
fbd686ad655e1a22450f517e9ec241eaafc167f7...f83240a8f93349c93582a96c4f4a7541388d6a80,1,10,0,10,7,2012-01-08 21:39:27,2012-01-08 21:39:27
fbd686ad655e1a22450f517e9ec241eaafc167f7...1ef9cbc6e4b2a002eea4515f3779318f2ee60666,3,166,17,183,15,2012-01-08 20:40:30,2012-01-08 20:40:30
1ef9cbc6e4b2a002eea4515f3779318f2ee60666...cb9be7bd0cde19b3b401d2dcdfb6162dd00b5ab5,7,31,32,63,18,2012-01-08 21:21:44,2012-01-08 21:21:44
cb9be7bd0cde19b3b401d2dcdfb6162dd00b5ab5...0d62778b28147f599015489d281e749893907087,1,1,1,2,1,2012-01-08 21:22:20,2012-01-08 21:22:20
0d62778b28147f599015489d281e749893907087...6226b14e3b97819119da0f026e9d3ae6dd0a31c0,3,9,7,16,7,2012-01-08 21:30:23,2012-01-08 21:30:23
e4d13e238d0d6ea241f4e77328f6551206d17362...54b35d00a49afa94584aa871f20f9bfddf602722,1,23,16,39,16,2014-03-09 04:53:16,2014-03-09 04:53:16
54b35d00a49afa94584aa871f20f9bfddf602722...5e6d16ef4dc531e284bf629a9336f608847bd608,1,1,1,2,1,2014-03-09 05:05:23,2014-03-09 05:05:23
74c391b9ad8b35910e394bba39eee52e83f531c1...5f2845f3078a90c3562855c8ced98a9caab47298,1,1,2,3,2,2014-03-10 23:43:57,2014-03-10 23:43:57
5f2845f3078a90c3562855c8ced98a9caab47298...6f13a14e4b18a57cce5d7d0fd18338ea7d956560,4,4,4,8,4,2014-03-10 23:51:53,2014-03-10 23:51:53
5791a48db393c72cbbf18dc3e1eb2211e8afe490...a083f0deb77dd479a7690a4ab90f73f7f7f375cd,1,3,3,6,1,2014-02-22 22:19:00,2014-02-22 22:19:00
a083f0deb77dd479a7690a4ab90f73f7f7f375cd...66a229bdbf05861b5fa7e63f898e67bad38923a0,8,20,20,40,20,2014-02-23 06:46:03,2014-02-23 06:46:03
66a229bdbf05861b5fa7e63f898e67bad38923a0...af83e569c35e7f3732b34d599126ffe2aa207d82,2,2,2,4,2,2014-02-23 08:56:27,2014-02-22 11:23:37
32a8716d5c0c10f7559ade5be4061f6d035c7ccf...f3735d5b122007063653a923b7bc2ef547ac35f5,1,1,1,2,1,2014-02-12 20:01:37,2014-02-12 20:01:37
32a8716d5c0c10f7559ade5be4061f6d035c7ccf...fe2222e73355af18ad2b1869efb5fb0ab64f42f3,1,17,19,36,5,2014-02-12 19:54:43,2014-02-12 19:54:43
a7f58a83567af5be9ad8530379978a1d78b19a12...ed3a65f08456571f5d9939d428379760d34741dc,2,99,38,137,23,2014-10-29 03:34:05,2014-09-25 21:04:11
9aeaf19b1dca68ee71e916ae415a0c270a47d301...015ee2ed74bcdc48eea9bb7f6bb453f1c2f182aa,2,12,12,24,5,2014-08-28 01:39:41,2014-08-28 01:39:41
015ee2ed74bcdc48eea9bb7f6bb453f1c2f182aa...2bc417732c4142091e92fce07f93c4fff11173b1,1,1,2,3,2,2014-08-28 01:54:51,2014-08-28 01:54:51
2bc417732c4142091e92fce07f93c4fff11173b1...4ba4b7c3cf20b8e9df3ec41af63b68300b402814,2,3,1,4,2,2014-09-09 00:47:23,2014-09-09 00:47:23
4ba4b7c3cf20b8e9df3ec41af63b68300b402814...3440074bb7db51402e28d17f0da84d3a730bdf49,1,3,2,5,2,2014-09-09 00:50:35,2014-09-09 00:50:35
551306fe9dde347c19c6b8d91a2e9b2dccf0f4c2...629fe6329185460f29e684f9fd8679fcb60da3cd,1,3,2,5,3,2014-08-29 02:55:23,2014-08-29 02:55:23
61705d35fa314a16579169fb7379e5101716e715...0ca71396b5f15e0ac97ba5687836fa484141bbe1,4,10,7,17,9,2014-10-07 08:29:59,2014-10-07 08:28:50
61a4fee626f5c10eb56149d0d8abb093c9fbbf98...7ce682474843d10631b149b017cffa35eb9ee3c5,12,41,27,68,24,2014-09-25 00:23:48,2014-09-25 00:23:48
51f1f58be8d4d58e06dfd8ed2ed3ab6ea81295a5...41dbc53b9ba34deb99adcadf67d4580076b38276,21,21,21,42,21,2014-10-23 06:11:12,2014-10-23 06:11:03
98bddd8904f2d745ad16d8bd591a0771577bf414...b57396944a39b21571848728b6ad479cd50537cd,3,168,0,168,3,2014-03-27 20:57:50,2014-03-27 20:57:50
98bddd8904f2d745ad16d8bd591a0771577bf414...a696d47592ef19510087113fa8e88af31a6491e0,4,7,7,14,6,2014-03-27 20:26:21,2014-03-27 20:26:21
a696d47592ef19510087113fa8e88af31a6491e0...b2a67ffe55f5fedb0ae1d5dff331687c3e744be0,5,15,13,28,7,2014-03-27 22:03:42,2014-03-27 21:59:26
440cedeed3e23960d0516153ef776c78f9efeabc...5458134f5e02d377d50ca2fcabe80a75215273c3,2,27,12,39,9,2014-03-28 17:58:32,2014-03-28 05:07:20
5458134f5e02d377d50ca2fcabe80a75215273c3...e8551d4f5027e863cce7e8a6d38ff5086e65c3ea,3,4,4,8,4,2014-03-28 18:00:39,2014-03-28 18:00:39
fc462098113b869c5cff5ba907f8cf8ff0a3d9af...f39b272fed73c2f6144e5e6bceebb0d747c2d0cf,5,27,5,32,15,2014-05-13 04:19:01,2014-05-13 04:19:01
f39b272fed73c2f6144e5e6bceebb0d747c2d0cf...8ee6a6be80eaf7a5b80e22d7d2a890e5339998b4,1,1,1,2,1,2014-05-13 04:28:14,2014-05-13 04:28:14
8ee6a6be80eaf7a5b80e22d7d2a890e5339998b4...e52920ca8738590eff900cb6846414c945313ae7,1,7,7,14,4,2014-05-13 04:50:13,2014-05-13 04:50:13
e52920ca8738590eff900cb6846414c945313ae7...58f03754c6f55d183a2cde13bbc8a7a942d8266e,1,9,9,18,6,2014-05-13 05:01:29,2014-05-13 05:01:29
58f03754c6f55d183a2cde13bbc8a7a942d8266e...7a765d1f8b45dd10d40e6c9ac5ad144ff95a9b0d,17,20,20,40,17,2014-05-13 05:33:23,2014-05-13 05:33:23
47a3c6d60b5348ac68f5a0b6d6e6e7f490844cee...367da423c4ebfa71166c9f338c614753feb15aee,1,1,1,2,1,2014-04-01 05:26:39,2014-04-01 05:26:39
367da423c4ebfa71166c9f338c614753feb15aee...8c95ff748f3c290949e79bbc248dc3fed8e9cf37,3,6,6,12,6,2014-04-01 05:26:47,2014-04-01 05:26:47
8c95ff748f3c290949e79bbc248dc3fed8e9cf37...f9e98a1422134077aa429f9053295e4765260736,1,1,0,1,1,2014-04-01 19:49:52,2014-04-01 19:49:52
f9e98a1422134077aa429f9053295e4765260736...640923eb36890eb194799beeb8ec3555e2b379cc,1,7,1,8,2,2014-04-01 20:04:43,2014-04-01 20:03:14
158b491f26ed2b4cfec77cabc042f1004fc77507...26f6807a3d0f2c72907379087f5f8358c87b030e,1,4,4,8,4,2014-04-01 01:09:24,2014-04-01 01:09:24
1554b7cdd77ac35e7f327b96718c9f0c73060d77...bfb99413eefbbe2e8fbb1e477cbfa63ea7d36140,9,30,12,42,18,2014-04-07 03:49:22,2014-04-07 03:49:22
bfb99413eefbbe2e8fbb1e477cbfa63ea7d36140...f159ce8b9ee84f885222a48c856a0f64269ba079,12,26,26,52,26,2014-04-08 05:59:37,2014-04-08 05:59:37
f159ce8b9ee84f885222a48c856a0f64269ba079...9863344e9a7ef47379c8308baa5647a07d332799,1,1,1,2,1,2014-04-08 15:05:15,2014-04-08 15:05:15
558b6a478d6dfdc5a8ee579c93d1080b553ac9a0...0a75e4c09b77035e9492006647da8d1900d24f75,1,2,0,2,1,2013-12-24 20:40:24,2013-12-24 20:40:24
237b85a7c10ab961c9f193e46d16a862522ebac9...25390716ea2a0bf9cd476858c826775d68c2f1cf,1,5,3,8,2,2013-12-24 16:20:52,2013-12-24 16:20:52
237b85a7c10ab961c9f193e46d16a862522ebac9...8b564f9e3227ffda6a978303a9edf7d86619a3a6,1,1,1,2,1,2013-12-24 10:35:19,2013-12-24 10:35:19
027af6deb4cd1783b4a6cfcc98ec3f64d585958a...46b0874ef5035a71484a69e598a6f148c73c55fa,3,14,3,17,3,2014-01-14 21:27:50,2014-01-14 21:25:27
e5d6ab9b31315b189670a9a58d65054c1df35401...9e8afcc6616546d38204d5b8da96ed1126aa0ea8,1,1,1,2,1,2014-01-19 00:08:39,2014-01-19 00:08:39
ffdc18cbbf7d519ad741eb621345e2e4e28a18e9...58c4a8c0f18a10687ce63bd274fa2e4b8723f0fb,1,1,1,2,1,2014-01-17 19:56:53,2014-01-17 19:56:53
bc074d54883de361f98429ab39b004ea89f3557a...2f76821a4dce7683168ab190e53c64fdf13dd469,9,1755,1090,2845,249,2014-01-16 21:33:09,2014-01-16 21:33:09
2f76821a4dce7683168ab190e53c64fdf13dd469...3b2418e6885d31d9cd1eab33b4cb952e876f8cf7,8,9,18,27,10,2014-01-16 21:44:08,2014-01-16 21:44:08
3b2418e6885d31d9cd1eab33b4cb952e876f8cf7...82ff4e2e40a3f81c569cc46c1ae1f10ffde9e6ad,1,6,2,8,2,2014-01-16 22:25:28,2014-01-16 22:25:28
82ff4e2e40a3f81c569cc46c1ae1f10ffde9e6ad...4bd6a52562c48d6d798bcbe427e08ad306889b4a,1,1,1,2,1,2014-01-16 22:28:21,2014-01-16 22:28:21
fcb78bcef757fb2ce32e033dd5517d1e520fa5b0...47bbc30b2c67915e55467f84d8d8ad77a2615101,1,1,1,2,1,2014-01-15 23:55:47,2014-01-15 23:55:47
47bbc30b2c67915e55467f84d8d8ad77a2615101...fa052c9659e6cd16298ecf7c9316cc99e640badb,1,2,2,4,2,2014-01-15 23:58:13,2014-01-15 23:57:27
fa052c9659e6cd16298ecf7c9316cc99e640badb...5ac8dca8ad38cfe57665aee6b4f9f00e371203ef,1,1,1,2,1,2014-01-16 00:08:00,2014-01-16 00:08:00
93a8b331bb1e263095c4aa3fae61dea834adad86...561fc8cf2a955c28906216301d2fdb3c39b8e981,1,37,16,53,2,2012-01-08 21:54:00,2012-01-08 21:54:00
561fc8cf2a955c28906216301d2fdb3c39b8e981...5a33c1b96e13a4650a127b0e81a91eb235561170,1,3,1,4,3,2012-01-08 22:19:53,2012-01-08 22:19:53
6226b14e3b97819119da0f026e9d3ae6dd0a31c0...cb38d08ed4f8d11ddfd0ebb1093c7a3857a7863c,1,67,79,146,3,2012-01-08 22:33:03,2012-01-08 22:33:03
cb38d08ed4f8d11ddfd0ebb1093c7a3857a7863c...2c790304393cce3ba7db3b3d5bc9385b1986b838,4,21,22,43,21,2012-01-08 22:33:14,2012-01-08 22:33:14
b958ac77c122ebcf39ff7f155de7aaec2cad17b6...fc053ac8b27611e3dc7fae769ce28f154250d50e,4,13,22,35,10,2012-01-13 18:07:56,2012-01-13 18:07:56
5e6d16ef4dc531e284bf629a9336f608847bd608...1caeca3e01d91261ae0fadd0bc3f24a51e80b22a,1,1,1,2,1,2014-03-09 19:31:42,2014-03-09 19:31:42
5e6d16ef4dc531e284bf629a9336f608847bd608...9d027d2beedc5d287de2ec0ae740cf4be05b46ac,6,21,20,41,9,2014-03-09 09:10:52,2014-03-09 09:10:15
6f13a14e4b18a57cce5d7d0fd18338ea7d956560...3ea69a16f94987c0ccaf505c6ef1a39b6989ef0d,1,1,1,2,1,2014-03-11 16:42:49,2014-03-11 16:42:49
6f13a14e4b18a57cce5d7d0fd18338ea7d956560...7ea9538defbb997a0f891967e4f9c3f09a06d441,1,1,0,1,1,2014-03-11 09:32:46,2014-03-11 09:32:46
af83e569c35e7f3732b34d599126ffe2aa207d82...db69420d747fe3107c1abb3cb85219b6fc03027a,1,0,1,1,1,2014-02-26 12:46:06,2014-02-24 08:55:33
af83e569c35e7f3732b34d599126ffe2aa207d82...8556fa44a3d907be6282758f4fb769b50e2386f4,1,3,3,6,3,2014-02-24 21:11:17,2014-02-24 21:10:25
d8cfcad7c71a2b65325b36718c218fee4221e663...88fdd4542749275d6ab970ee040f2efe10018d5b,33,55,55,110,50,2014-02-13 09:12:26,2014-02-13 09:12:26
88fdd4542749275d6ab970ee040f2efe10018d5b...461404f6bea36c9cc3df60d949aaa7406a31e1bf,1,14,14,28,4,2014-02-13 09:21:35,2014-02-13 09:21:35
461404f6bea36c9cc3df60d949aaa7406a31e1bf...385fb6898128bbfdc3def581bb92e01818fa0525,7,7,7,14,7,2014-02-13 16:59:03,2014-02-13 16:59:03
385fb6898128bbfdc3def581bb92e01818fa0525...a365d8689c3f3cee7f1acf86b61270ecca8e106d,1,1,1,2,1,2014-02-13 17:24:59,2014-02-13 17:24:59
36e3d07c12a11878fe79d8e5d03ab92cf025b5d8...94b544c22940d8048e7ecda9f3484583894f45c5,6,104,38,142,22,2014-10-29 03:44:52,2014-10-29 03:44:52
94b544c22940d8048e7ecda9f3484583894f45c5...68b771a057b60ca5740cf9a1b0f8f9ec73e5dc56,3,15,5,20,5,2014-10-29 03:54:53,2014-08-26 21:34:21
68b771a057b60ca5740cf9a1b0f8f9ec73e5dc56...bf2ad00ee0e9f0f74b476f6245f781bcc9c0d350,6,36,16,52,14,2014-10-29 03:56:02,2014-10-29 03:56:02
0521913a99b1e6c4927b0d0f7bae746b14463a77...1b3237629a316af41945e20837cf3a332798b264,4,95,8,103,6,2014-10-26 02:51:55,2014-07-18 18:37:11
1b3237629a316af41945e20837cf3a332798b264...5f2e6fa58bf15984068ec5ce7c1093b628105f7f,7,59,22,81,13,2014-10-26 02:53:10,2014-10-26 02:53:10
5f2e6fa58bf15984068ec5ce7c1093b628105f7f...783eced7abfced5f021e9792405b4cfd6a829bb6,9,9,9,18,9,2014-10-26 03:20:24,2014-10-26 03:20:24
783eced7abfced5f021e9792405b4cfd6a829bb6...9740d8bb697dadf7dba1c271cce87d0d90c7ac62,2,33,0,33,3,2014-10-26 03:38:18,2014-09-03 12:11:40
9740d8bb697dadf7dba1c271cce87d0d90c7ac62...2cbb1d937474cd928c9c06b613ee3857d936e91a,6,10,4,14,8,2014-10-26 03:39:49,2014-10-26 03:39:49
2cbb1d937474cd928c9c06b613ee3857d936e91a...5da85f8e8b9341ffb0779b98eb7655f0bfab6f22,1,1,1,2,1,2014-10-26 03:41:47,2014-10-26 03:41:47
5da85f8e8b9341ffb0779b98eb7655f0bfab6f22...007fbdb66de629d63af5f811c1d881e95231ac9a,1,0,30,30,1,2014-10-26 03:56:52,2014-10-26 03:56:52
e99866447ba46d5bd28ceee806d14b6938f0a78a...1965f032ca27c6a44df08131fca691b246fd0b91,1,2,9,11,2,2014-08-29 21:20:48,2014-08-29 21:20:48
b93ebeaa9c4176f3c92e2cd0a7db639f0f972f32...909a1783620250f544a9bc61934223e8bd50c894,6,49,49,98,27,2014-10-07 12:28:41,2014-10-07 12:28:41
7ce682474843d10631b149b017cffa35eb9ee3c5...4d9890ea2e7e868221d0c2254c9dc86152304815,2,48,6,54,4,2014-09-25 03:46:49,2014-09-15 19:36:40
2df585ad6b9f0635d75eb479dc656119b590584f...d59b235242c1f0c17cfafaed49a4e9bda191b418,1,4,4,8,4,2014-10-23 20:26:48,2014-10-22 10:50:22
d59b235242c1f0c17cfafaed49a4e9bda191b418...16a5f874d09cb5a569288189b6c94c0d27aa0a45,1,320,224,544,103,2014-10-23 20:26:48,2014-10-22 19:11:45
2df585ad6b9f0635d75eb479dc656119b590584f...c6d1aa76fc91087caad8d05ba3e1ff1d61fad9d4,2,3,3,6,2,2014-10-23 06:17:54,2014-10-07 12:48:16
2df585ad6b9f0635d75eb479dc656119b590584f...f33ed634fc0f29ffda350177b22486e0e6038607,3,1,1,2,1,2014-10-23 06:17:27,2014-10-07 16:17:20
f33ed634fc0f29ffda350177b22486e0e6038607...af2fe1d76bc2727e57e8a0fa115a0003a12ce6e1,1,0,0,0,0,2014-10-26 03:49:10,2014-10-26 03:49:10
11a835f56662f8a93e2f8d27038c683d901a5a72...3424195e64f25993c202db9582035f5999bc01d9,1,0,0,0,0,2014-04-09 04:04:02,2014-04-09 04:04:02
3424195e64f25993c202db9582035f5999bc01d9...5d78200a665f37459af9e701d7a55658b0ce3987,1,1,1,2,1,2014-04-09 04:07:05,2014-04-09 04:07:05
44d32ed776e9c6c8a27e4f108b9f3cd7c87160dd...24c5a453b2314ded0fcdea20dc30f2e02c0cd501,2,12,5,17,5,2014-03-28 18:12:28,2014-03-12 21:01:09
24c5a453b2314ded0fcdea20dc30f2e02c0cd501...1853e31a1045bb797cdd730c18cc17cefd3e0eca,1,2,2,4,2,2014-03-28 18:12:28,2014-03-28 03:43:44
1853e31a1045bb797cdd730c18cc17cefd3e0eca...07314b5475e9aec63f490c266a011ec0b80cb339,1,16,5,21,2,2014-03-28 18:12:28,2014-03-28 04:28:21
07314b5475e9aec63f490c266a011ec0b80cb339...b5ae8f9722c0f4a5493e5fb81a53b6dd19d6fdd6,3,4,4,8,4,2014-03-28 18:19:22,2014-03-28 04:30:28
7a765d1f8b45dd10d40e6c9ac5ad144ff95a9b0d...d0fca8aaad4999d3389ebdada36102c89063e0f2,4,0,7,7,4,2014-05-13 06:26:24,2014-05-13 06:26:24
640923eb36890eb194799beeb8ec3555e2b379cc...2d1d5754f781f0f3fa1bc296c9e69da416043c4a,1,16,8,24,6,2014-04-03 03:00:52,2014-04-03 02:55:05
2a6b6f8537f3174c0a6b0baad3ef3346db12412b...b260d93c58be66d8f337e869721a37df159e927f,1,6,1,7,2,2014-01-15 04:21:15,2014-01-15 03:57:01
2a6b6f8537f3174c0a6b0baad3ef3346db12412b...8fb75ee9e78ecb0954e1634ab85e91d533d0ab42,1,1,1,2,1,2014-01-14 22:25:25,2014-01-14 22:25:25
2179f9d68acffeebf5bd3ee5dcc33daa614b13aa...a73dacf4a074e2ec57851b82e75dfe40063b866d,1,2,2,4,2,2014-01-19 00:32:14,2014-01-15 03:14:11
a73dacf4a074e2ec57851b82e75dfe40063b866d...3a1aa33860e444d2beac8c05e13de965f5d05a94,1,11,11,22,11,2014-01-19 00:47:12,2014-01-19 00:46:17
3a1aa33860e444d2beac8c05e13de965f5d05a94...0be0090983d3582f1a1876f42218b62cd6f7120e,1,1,1,2,1,2014-01-19 01:13:16,2014-01-19 01:13:16
0be0090983d3582f1a1876f42218b62cd6f7120e...20772462df9c44a838c87c2e1b2dc89b9059e9e4,1,1,1,2,1,2014-01-19 01:17:53,2014-01-19 01:17:53
20772462df9c44a838c87c2e1b2dc89b9059e9e4...b67cba2b4d1fe2b7a9685bb5c80eb77ee64e6ab1,2,6,7,13,5,2014-01-19 02:35:47,2014-01-19 02:35:47
d6e8006ea6dde5f295a919d63164af04927a8b33...084f0fb11351e899decc33faf53ada85d29ea7fa,3,7,7,14,7,2014-01-17 20:16:53,2014-01-17 12:21:57
084f0fb11351e899decc33faf53ada85d29ea7fa...d8c87ddc285c598f09cb70e2244d7cef5a8e5bad,2,4,4,8,4,2014-01-17 22:28:01,2014-01-17 22:27:54
d8c87ddc285c598f09cb70e2244d7cef5a8e5bad...172de467eb1ddf869fac06636e1dd8ae35cfba94,1,47,8,55,1,2014-01-18 01:12:52,2014-01-18 01:12:52
172de467eb1ddf869fac06636e1dd8ae35cfba94...dcdf716eef06ceed259c525a0ab70e7065e3a14a,1,1,1,2,1,2014-01-18 03:04:14,2014-01-18 03:04:14
4bd6a52562c48d6d798bcbe427e08ad306889b4a...4a50ac0bddc830575e9a7ddf6763746328e50ed1,1,5,5,10,1,2014-01-16 23:35:08,2014-01-16 23:35:08
4bd6a52562c48d6d798bcbe427e08ad306889b4a...d07e8fece474afee9de7edaf6359e60920e8268f,4,14,14,28,8,2014-01-16 23:03:34,2014-01-16 23:03:34
4bd6a52562c48d6d798bcbe427e08ad306889b4a...ded7008e407e70efb2d5719a0e5b817c72a9fa7a,1,1,5,6,2,2014-01-16 22:51:41,2014-01-16 22:51:41
4bd6a52562c48d6d798bcbe427e08ad306889b4a...1ca0f8dbc08df555dcd7696d5cf903fe5ca074ff,1,4,4,8,1,2014-01-16 22:47:11,2014-01-16 22:47:11
5ac8dca8ad38cfe57665aee6b4f9f00e371203ef...7e7264e22495ba1b85ec4dc95366f7abd146d4f9,2,4,2,6,3,2014-01-16 00:25:04,2014-01-16 00:25:04
5ac8dca8ad38cfe57665aee6b4f9f00e371203ef...95f24dca9aab5cfdd56d87d3ad8c6d3faa7d2928,4,4,4,8,4,2014-01-16 00:19:00,2014-01-16 00:19:00
bdfb05dbac0b07c7c6447a39b2658038563603d3...fd49d4a44f7fe73054b861461b9ec0f36a1bb29a,7,33,32,65,16,2012-02-01 01:35:23,2012-02-01 01:35:23
fd49d4a44f7fe73054b861461b9ec0f36a1bb29a...7f32d15fbb096fdf3146997f10cc91dbbd4589fc,3,22,22,44,22,2012-02-01 03:32:42,2012-02-01 03:32:42
5a33c1b96e13a4650a127b0e81a91eb235561170...76cadd1d2a493d4cbcfe8acd984bd4f908b25abf,1,2,1,3,2,2012-01-08 22:36:41,2012-01-08 22:36:41
76cadd1d2a493d4cbcfe8acd984bd4f908b25abf...aa0c4acd80562645ae85ef9a76f6b45e778d7acd,1,1,1,2,1,2012-01-08 22:38:21,2012-01-08 22:38:21
ac68bc39ff46aec1d4654165eb64c2dc11f5e968...4b79443bba6ad83d9da62e00765ef45121fb39ff,4,62,15,77,16,2012-01-08 23:33:44,2012-01-08 23:33:44
fc053ac8b27611e3dc7fae769ce28f154250d50e...f587e81b7d72e47b16bf808c721c3dfe45ae1062,6,172,253,425,65,2012-01-15 00:18:15,2012-01-15 00:18:15
fc053ac8b27611e3dc7fae769ce28f154250d50e...2cea94e892eabbe5edbca3a51347af57621d672d,1,2,2,4,2,2012-01-13 21:33:05,2012-01-13 21:33:05
57f09327cca8cedb8daa3cb25360df8a1dad0a39...f750f7e4488b557a1bf9b451a1411c8330fcbe1c,8,8,20,28,8,2014-03-11 17:49:11,2014-03-11 09:02:45
f750f7e4488b557a1bf9b451a1411c8330fcbe1c...b39a8c77c3f8c4d28ac75681330368d6a41b694b,1,17,27,44,3,2014-03-11 17:49:11,2014-03-11 17:48:14
bc8c33c82f066326e704120b4dab331419f8979b...db9fca23ff30ca464483f67391e95a898e7ada63,1,1,1,2,1,2014-02-26 17:32:30,2014-02-26 17:32:30
db9fca23ff30ca464483f67391e95a898e7ada63...63031a3ca5a44d828122226c26232c00f4463f98,3,2,2,4,2,2014-02-26 17:32:43,2014-02-25 23:25:57
63031a3ca5a44d828122226c26232c00f4463f98...1e06cdff2f6eddbe8392ce7ac6e93c321e293804,1,1,1,2,1,2014-02-26 17:34:02,2014-02-26 17:32:59
113fc1ded0ae49cec9c8f5a99060661976fd1ff3...a6fb770ebee4394d8b946636a738e3829cc59b28,1,1,1,2,2,2014-02-24 23:10:46,2014-02-24 23:10:46
113fc1ded0ae49cec9c8f5a99060661976fd1ff3...754791e3d9b67fd71b6a1250f93ea9723b68e221,1,1,1,2,1,2014-02-24 22:43:09,2014-02-24 22:43:09
a365d8689c3f3cee7f1acf86b61270ecca8e106d...2d18944d982a567b07b95d4b0719e7f85ff78e77,2,2,2,4,2,2014-02-13 19:12:05,2014-02-12 19:32:52
a365d8689c3f3cee7f1acf86b61270ecca8e106d...ff2c506d2bd298e508bb4a36323c6eb42a30e679,2,19,19,38,5,2014-02-13 18:54:21,2014-02-13 07:35:51
bf2ad00ee0e9f0f74b476f6245f781bcc9c0d350...c897f9d5f0b331dfafb571429d7bd845b6b73b6a,2,2,2,4,2,2014-10-29 04:24:45,2014-10-29 04:24:45
5eb08f5d8d4c71c59774903934e8e340687b7c1c...66e140db82d367710013707a327c67d67168b3c9,2,8,3,11,5,2014-10-26 19:43:41,2014-10-26 05:17:05
5eb08f5d8d4c71c59774903934e8e340687b7c1c...743aaf610040e73168055ebaba3086d3f2d057c7,3,10,4,14,5,2014-10-26 05:39:01,2014-10-26 05:39:01
743aaf610040e73168055ebaba3086d3f2d057c7...bab3679d1031ac77503c0c14b56aeda885721584,1,0,0,0,0,2014-10-26 06:08:33,2014-10-26 06:08:33
5eb08f5d8d4c71c59774903934e8e340687b7c1c...97b4364452aa45539aac11d866ebd17fa211200d,2,8,3,11,5,2014-10-26 05:17:05,2014-10-26 05:17:05
59d7772daa8d09e13858ad83701bda767db71fc8...fe896923fce4ec29f09055b4778ebc64eda8fccc,2,23,297,320,13,2014-08-30 05:43:44,2014-08-30 05:35:48
3bdafb1fa53ebb05cf971f1fbc1c4070cbd7ff53...07f1d89dd2bb893f7753797bf3b37f2d6cb33feb,5,7,6,13,7,2014-10-07 16:57:01,2014-10-07 16:56:32
07f1d89dd2bb893f7753797bf3b37f2d6cb33feb...7ded2d185d9c6354b29e44fa0fce0591139e55d5,2,24,6,30,7,2014-10-09 05:16:31,2014-07-25 05:40:05
7ded2d185d9c6354b29e44fa0fce0591139e55d5...924c68f8bb32fda7df1d96a779af1590b968cf26,2,15,6,21,6,2014-10-09 05:16:32,2014-07-25 05:40:14
924c68f8bb32fda7df1d96a779af1590b968cf26...a1a2dfebb535657b7a973ca2ae4ba22fe27004e1,1,13,13,26,3,2014-10-09 05:16:32,2014-08-26 10:16:40
a1a2dfebb535657b7a973ca2ae4ba22fe27004e1...9299f5dfa25d6fbf0933f7de7db58b50c868ab47,1,13,13,26,3,2014-10-09 05:17:56,2014-10-09 05:17:56
c15fffc73b990aeb65f91c9ac2ac50fd4b69bb65...443a1b11ee4f057d93bad6351b4ea606d8787b4d,1,1,1,2,1,2014-09-25 04:27:56,2014-09-25 04:27:56
443a1b11ee4f057d93bad6351b4ea606d8787b4d...e26fcf470ffb8b98c9f227a06161854e118bc007,2,222,110,332,59,2014-09-25 15:39:42,2014-09-25 15:37:07
e26fcf470ffb8b98c9f227a06161854e118bc007...89d437dedac599e0edf2320a55629773f4be1423,1,12,12,24,12,2014-09-25 16:09:19,2014-09-25 16:09:19
89d437dedac599e0edf2320a55629773f4be1423...0d04dcaebd7b0b0427ae3a6e79ddd86cd981b58f,6,18,18,36,8,2014-09-25 22:10:41,2014-09-25 22:10:41
0d04dcaebd7b0b0427ae3a6e79ddd86cd981b58f...a332c18c8793dee45e21cb3872d369600f394757,1,8,8,16,5,2014-09-25 22:14:48,2014-09-25 22:14:48
3bea2a45ef036b87dbf1a73897f471c46dab1f35...919b4ccb15209d47f7cc3f740654b0bcd5cf1870,4,145,86,231,34,2014-10-23 22:48:18,2014-10-14 21:09:57
919b4ccb15209d47f7cc3f740654b0bcd5cf1870...e8643ed8b3e9253d6d42cb811267525e931eb873,1,16,16,32,16,2014-10-23 22:48:50,2014-10-23 22:36:44
e8643ed8b3e9253d6d42cb811267525e931eb873...42c2918372aaf66d0cf8689d7a4375cdd3279920,1,25,27,52,7,2014-10-26 01:13:35,2014-10-26 01:13:35
42c2918372aaf66d0cf8689d7a4375cdd3279920...6e3c55a115ae0674c402a0c420c5b66a29ab072a,9,43,38,81,24,2014-10-26 01:13:50,2014-10-26 01:13:50
7d8bacb8178c33c389575d1fc0fc2d99590eb4b6...1f64aac6b9e04e9f5ba2cf2dcc29031c3d150d81,1,1,1,2,1,2014-11-01 10:51:11,2014-11-01 10:51:11
558e112de46213b352415f68eb3e05460e53be1b...d7a3771abde2bffedf0547c800cf84f97a252e34,1,2,2,4,2,2014-04-09 05:36:21,2013-10-30 01:56:09
d7a3771abde2bffedf0547c800cf84f97a252e34...de86b36b508096eea1f9326983ab4d50358f66a5,4,5,5,10,5,2014-04-09 06:59:17,2014-04-09 06:59:17
d178a9581be35ff9a5f7eda9e06e5431802f6005...7dec5c79c8ffb80592576a463472d6cf9bd959a8,1,2,2,4,1,2014-03-28 18:56:12,2014-03-28 18:56:12
19ac6e59b316c3867c0edee03517a8a28f76544f...828a5baa00093b5fd9ddcb83251775d2b4f40092,1,1,1,2,1,2014-05-13 09:08:25,2014-05-13 09:08:25
828a5baa00093b5fd9ddcb83251775d2b4f40092...239d5e0e3905c4463651fc94a9ed175bdc2e827c,1,1,1,2,1,2014-05-13 11:19:51,2014-05-13 11:19:51
239d5e0e3905c4463651fc94a9ed175bdc2e827c...ceda9483723fedb04ad6221a32be028cc81c5d4d,1,1,1,2,1,2014-05-13 14:14:34,2014-05-13 14:14:10
a444863268db0ff8a00e2b459d8ff1fdeaae70a2...76e717b23395ea3997de3d7039a8ec8ab216bbd4,1,2,2,4,2,2014-04-03 07:52:32,2014-04-02 13:23:20
76e717b23395ea3997de3d7039a8ec8ab216bbd4...2b30b48894c7e0026939977fcc3aa0721e23bddf,1,4,9,13,4,2014-04-03 07:53:13,2014-04-03 07:48:30
2b30b48894c7e0026939977fcc3aa0721e23bddf...4c2626fecb60f7f31f248ac10597294f2cd2471b,10,16,21,37,15,2014-04-03 07:53:44,2014-04-03 07:53:20
4c2626fecb60f7f31f248ac10597294f2cd2471b...9c7e86be994145b06ddfa2c6d184da3d63bb596b,2,23,8,31,8,2014-04-03 18:34:15,2014-04-03 18:34:15
9c7e86be994145b06ddfa2c6d184da3d63bb596b...2878d6ef8301c56bb2394f6657675a8c4b2615d3,1,1,1,2,1,2014-04-03 18:53:35,2014-04-03 18:53:35
2878d6ef8301c56bb2394f6657675a8c4b2615d3...1759569dbe8d9ebbcfc4bc1b7f87c3fe3e79e4d1,1,4,3,7,3,2014-04-03 19:23:42,2014-04-03 18:55:52
4c049e36000b2e994f75f73d976cac6805b8b44d...0b6f1906cd48b5c6b7f9f8dc151bb8f0dc7fd93b,1,41,8,49,10,2014-04-03 21:57:56,2014-04-03 21:50:57
0b6f1906cd48b5c6b7f9f8dc151bb8f0dc7fd93b...8ca182876debea1eb28c983606267b2bf9aa585d,1,6,1,7,1,2014-04-04 00:02:10,2014-04-03 23:58:07
8fb75ee9e78ecb0954e1634ab85e91d533d0ab42...413c8a6da533c59bb9a923901b5358ddb61564a5,7,18,5,23,7,2014-01-15 05:44:38,2014-01-15 05:44:38
8fb75ee9e78ecb0954e1634ab85e91d533d0ab42...edb221a20ceabebd427e27d0432e94a227717217,4,203,30,233,16,2014-01-15 01:42:29,2013-11-22 19:58:53
b67cba2b4d1fe2b7a9685bb5c80eb77ee64e6ab1...60298dd623550eed4bc2f2c92fe0a5bfdf51462c,1,1,0,1,1,2014-01-19 02:39:46,2014-01-19 02:39:46
dcdf716eef06ceed259c525a0ab70e7065e3a14a...092b1a47efb142a015f055fbf04e1d8db526f152,1,1,1,2,1,2014-01-18 17:15:37,2014-01-18 17:15:37
092b1a47efb142a015f055fbf04e1d8db526f152...a56cf753ceba9aebb31fdca48fae96ebfc188b1d,3,9,9,18,9,2014-01-18 17:40:47,2014-01-18 17:40:47
a56cf753ceba9aebb31fdca48fae96ebfc188b1d...7b42103df6aa207c4d6cc1d977ab0cd2bc04dc65,5,7,4,11,5,2014-01-18 19:33:50,2014-01-18 19:33:50
dcdf716eef06ceed259c525a0ab70e7065e3a14a...4bca3c79b36a621bfd6ccc258fbb9cb6de19e958,8,8,6,14,3,2014-01-18 06:15:21,2014-01-17 09:48:19
600f62dc785a188ebdebe58950df0b247bbd93fc...bd8ef99028de09363df72cf25887abe73f7ac346,1,5,4,9,1,2014-01-17 03:52:24,2014-01-17 03:52:24
d07e8fece474afee9de7edaf6359e60920e8268f...380019ccb28ef1205e0a114e386ab2cc4281efb4,6,12,6,18,6,2014-01-17 04:00:28,2014-01-17 04:00:28
78e81a1de99b23aae96ceec81499490538aafbb5...0ef8d1bad4cb146961c32a063f12a87116214d9e,1,3,3,6,3,2014-01-16 01:24:57,2014-01-16 01:07:08
7f32d15fbb096fdf3146997f10cc91dbbd4589fc...9b9e1d309bada7983434b092b40b088147a42a2e,3,4,2,6,2,2012-02-02 00:44:07,2012-02-02 00:44:07
7f32d15fbb096fdf3146997f10cc91dbbd4589fc...59016d2198d18904a02f122601dc828663c506b6,13,46,2,48,15,2012-02-02 00:38:58,2012-02-02 00:38:58
59016d2198d18904a02f122601dc828663c506b6...87df2304083b7e2da0cc0d43e77a1199948fb3e3,1,0,0,0,0,2012-02-02 00:39:15,2012-02-02 00:39:15
7f32d15fbb096fdf3146997f10cc91dbbd4589fc...11319f6da9f9a19ec40743cdfe868ac732698149,1,3,3,6,2,2012-02-01 21:14:49,2012-02-01 21:14:49
7f32d15fbb096fdf3146997f10cc91dbbd4589fc...981cbfb4fa6d22b13aff08fc5820481ab1e613c6,1,1,1,2,1,2012-02-01 18:40:10,2012-02-01 18:40:10
981cbfb4fa6d22b13aff08fc5820481ab1e613c6...12ed7a2b33a7a76ec29081c52cd9fc0814c9df9a,1,1,1,2,1,2012-02-01 18:44:33,2012-02-01 18:44:33
7f32d15fbb096fdf3146997f10cc91dbbd4589fc...b96e80cf3933cb5788cc21247e68b5cd2e0cbc94,2,2,2,4,2,2012-02-01 17:58:08,2012-02-01 17:58:08
7f32d15fbb096fdf3146997f10cc91dbbd4589fc...a486a6f20b6502cf260368f5e0e423a7db2c6284,1,4,0,4,1,2012-02-01 10:59:38,2012-02-01 10:59:38
7f32d15fbb096fdf3146997f10cc91dbbd4589fc...140d90db63d6dfc555478b68afc7c20c4b594853,2,2,2,4,2,2012-02-01 07:51:37,2012-02-01 07:51:37
aa0c4acd80562645ae85ef9a76f6b45e778d7acd...dbe5e666af51a4d85923c1a7754da1c929dfc249,1,1,1,2,1,2012-01-08 23:02:13,2012-01-08 23:02:13
aa0c4acd80562645ae85ef9a76f6b45e778d7acd...6e8a3bba32312cb13cf70acca0575ff14651437e,1,3,0,3,1,2012-01-08 22:54:36,2012-01-08 22:54:36
6e8a3bba32312cb13cf70acca0575ff14651437e...91d393fd4705faff072a33f9697e0bf194fe40db,1,1,1,2,1,2012-01-08 23:01:23,2012-01-08 23:01:23
91d393fd4705faff072a33f9697e0bf194fe40db...7aca72322effb717804af8348d3b58cfa2cbe000,2,2,2,4,3,2012-01-08 23:12:34,2012-01-08 23:12:34
e654ec13369761e252aa279d5e0a1002ba23cfb7...eaa8220d70f84a710c9dfa1bd49a7c35bcab1a3b,5,47,33,80,8,2012-01-08 23:38:57,2012-01-08 23:38:57
eaa8220d70f84a710c9dfa1bd49a7c35bcab1a3b...83c0896999c91f4d85bb75434f4a4ecfaff07fe0,7,619,492,1111,96,2012-01-09 05:48:07,2012-01-09 05:48:07
83c0896999c91f4d85bb75434f4a4ecfaff07fe0...5032ef9b54b92443f1dbaa2594468dcd84b6bd9e,4,14,107,121,15,2012-01-09 07:14:07,2012-01-09 07:14:07
5032ef9b54b92443f1dbaa2594468dcd84b6bd9e...5c2bf0feef7f7f64584cbd0cb6a2ef74dbba80d2,3,2,4,6,4,2012-01-09 17:15:42,2012-01-09 17:15:42
7455dd6b4564680ff7f80d8014ef7b973cd5755d...ceb6836e03b03c757578c9e5614f535d9be2ad7f,3,4,4,8,4,2012-01-15 00:24:23,2012-01-15 00:24:23
ceb6836e03b03c757578c9e5614f535d9be2ad7f...a40b2a636c908859c2bb7434f0c050be2dc7e70e,3,9,1,10,4,2012-01-15 00:38:40,2012-01-15 00:38:40
a40b2a636c908859c2bb7434f0c050be2dc7e70e...028726a9a3e2acd56195dacd903680db5d934b8e,2,11,3,14,3,2012-01-15 00:45:01,2012-01-15 00:45:01
028726a9a3e2acd56195dacd903680db5d934b8e...55ea574f8a56534b1313b5f2d85e7ee22565ea27,3,4,3,7,4,2012-01-15 00:50:36,2012-01-15 00:50:36
55ea574f8a56534b1313b5f2d85e7ee22565ea27...74c0fc17c826d3a16c1b3e45b71138c048f7d630,4,5,5,10,5,2012-01-15 00:56:47,2012-01-15 00:56:47
74c0fc17c826d3a16c1b3e45b71138c048f7d630...2c3365f99ef81e53d90593c45d10ebeb3426dea9,4,28,9,37,11,2012-01-15 01:16:46,2012-01-15 01:16:46
2c3365f99ef81e53d90593c45d10ebeb3426dea9...1c6048bac2d305085f40324223c32e40bb9ea938,1,1,12,13,2,2012-01-15 03:17:48,2012-01-15 03:17:48
1c6048bac2d305085f40324223c32e40bb9ea938...6d916763f82be8c2d4f87842275170c12bea72ec,6,207,74,281,29,2012-01-15 04:54:37,2012-01-15 04:54:37
6d916763f82be8c2d4f87842275170c12bea72ec...dab6d2b17cc2fd67c2462b5a5eb84eb58d9c72bc,11,120,121,241,88,2012-01-15 05:28:47,2012-01-15 05:28:47
dab6d2b17cc2fd67c2462b5a5eb84eb58d9c72bc...16eccc43d9fa6317818b5d1621d0477150214488,24,26,26,52,26,2012-01-15 07:28:48,2012-01-15 07:28:48
16eccc43d9fa6317818b5d1621d0477150214488...f989c6892f690cf46b0e67158ebb621c3fe690fe,3,8,1,9,4,2012-01-15 07:33:42,2012-01-15 07:33:42
07530073dd6fe56558703ff6c65994aacc1d4a25...a4b107bf879d47db0a6e036814f5aeee4316d36c,7,8,8,16,8,2012-01-14 20:15:24,2012-01-14 20:15:24
a4b107bf879d47db0a6e036814f5aeee4316d36c...f82fb2a1976060b2d0b71c3e6ad20f6d7a7772f7,7,7,7,14,7,2012-01-14 20:18:59,2012-01-14 20:18:59
f82fb2a1976060b2d0b71c3e6ad20f6d7a7772f7...b723db1e42b6450acdc02ee8086da51ac16fcef6,1,1,1,2,1,2012-01-14 20:21:09,2012-01-14 20:21:09
b723db1e42b6450acdc02ee8086da51ac16fcef6...1f54ff91b2dd70c9a8bb4e460dd7ad02a3c24247,1,2,2,4,2,2012-01-14 20:21:57,2012-01-14 20:21:57
1f54ff91b2dd70c9a8bb4e460dd7ad02a3c24247...ec7f8917b1bfa79dee54cd6c5f6cf0074764fce4,7,8,1,9,8,2012-01-14 20:24:35,2012-01-14 20:24:35
1902f0ab50fb473fe78334c8bdd830863915415c...4c76c792136c2fc1196bd9514d92bab471a303f6,1,4,4,8,4,2014-03-12 17:19:52,2014-03-12 17:19:52
1902f0ab50fb473fe78334c8bdd830863915415c...08f470ea689fd65386a10400519ba7c7ff25c411,1,1,1,2,1,2014-03-12 17:11:02,2014-03-12 17:11:02
08f470ea689fd65386a10400519ba7c7ff25c411...28d2de3703f3db35ec27aee73aec338d5bc23264,1,1,1,2,1,2014-03-12 17:15:41,2014-03-12 17:14:25
1902f0ab50fb473fe78334c8bdd830863915415c...4277ba62d35438aab1f445769d6263cb6e2114d2,4,28,28,56,25,2014-03-12 02:41:54,2014-02-11 21:15:40
1e06cdff2f6eddbe8392ce7ac6e93c321e293804...77cd015cf001856e1530babfa47b013bd08ab2ad,1,12,2,14,3,2014-02-27 09:05:58,2014-02-27 09:05:58
1e06cdff2f6eddbe8392ce7ac6e93c321e293804...f7c360d6206a8c5d2393215239649f9234bb600b,1,1,3,4,2,2014-02-27 08:39:46,2014-02-27 08:39:46
1e06cdff2f6eddbe8392ce7ac6e93c321e293804...8ff7e64359c5a45fb8fe2fb87ca01f8561bdf213,2,104,67,171,97,2014-02-27 08:12:52,2014-02-27 08:12:52
8ff7e64359c5a45fb8fe2fb87ca01f8561bdf213...2ef9f9b213f11f8a514b398c0829aa5d47f56815,2,2,2,4,2,2014-02-27 08:52:30,2014-02-27 08:51:52
7bfd2cc0af988d0136993dbe20d0abfa6fb19eb9...429fc9331e9c74a77f575d136351630e1271cd3d,4,4,4,8,4,2014-02-25 03:10:23,2014-02-25 03:10:23
1b4a3dbbec2669cffa43993dbdbac3a4b48a11d0...7100e3a37eedf31f6ba005bb045ee3074a6ee5ed,1,10,2,12,3,2014-02-13 19:26:55,2014-02-13 07:37:37
7100e3a37eedf31f6ba005bb045ee3074a6ee5ed...cdb381bb7559495ba257b9ac98910990c5527665,2,2,2,4,2,2014-02-13 21:55:36,2014-02-13 21:54:02
cdb381bb7559495ba257b9ac98910990c5527665...accc95ccd63f8aa903fa07bea55ef34794d84cc5,1,1,1,2,1,2014-02-14 01:57:24,2014-02-14 01:57:24
4e3ffa5629b4f347384a1d163d3db145004ed8dd...a515191afddb3952fa93c6aacf83c73c8024e069,2,11,0,11,3,2014-10-29 05:30:57,2014-10-29 04:46:02
4e3ffa5629b4f347384a1d163d3db145004ed8dd...cf88a65f309b5681002664ac0f9ac7abec7d6d49,2,3,3,6,3,2014-10-29 04:48:00,2014-10-29 04:47:51
657ff31c7448563abc7b11e0cfea971e060a3d3d...05c785bfae8475ee50e1363c94ebfd741168ebbc,2,2,2,4,2,2014-10-26 21:42:06,2014-10-26 21:42:06
bab3679d1031ac77503c0c14b56aeda885721584...b171451d77e58a0b81dc7b63a8f9a4c3ff247a79,1,5,0,5,1,2014-10-26 14:04:37,2014-10-26 14:04:37
bab3679d1031ac77503c0c14b56aeda885721584...3e9b461766fffe71c58da2d61cd3773f83caa2cf,3,6,4,10,6,2014-10-26 10:38:10,2014-10-26 10:38:10
bab3679d1031ac77503c0c14b56aeda885721584...37facee9224013d3b162c391562db458ef41924e,1,1,1,2,1,2014-10-26 07:35:14,2014-10-26 07:35:14
fe896923fce4ec29f09055b4778ebc64eda8fccc...989dafb153c927645c1afe93c7184b535a321038,1,4,0,4,1,2014-09-08 05:58:33,2014-08-30 20:02:05
fe896923fce4ec29f09055b4778ebc64eda8fccc...de0f78bc8e305f0a8d819a216566bbca5809ce49,1,6,6,12,6,2014-09-04 23:58:50,2014-09-01 13:47:26
fe896923fce4ec29f09055b4778ebc64eda8fccc...e37e06d73e8823c3e5fc062ae68d9d131c4c2bb4,4,6,6,12,4,2014-09-01 19:48:19,2014-09-01 19:48:19
fe896923fce4ec29f09055b4778ebc64eda8fccc...0531d1a776952576b331deb2b1b75f8b70076ada,1,2,0,2,1,2014-09-01 08:18:49,2014-09-01 08:18:49
9299f5dfa25d6fbf0933f7de7db58b50c868ab47...4bbe80658a9d32df131e5fb13bc20688b99a70d5,9,21,26,47,11,2014-10-10 03:01:51,2014-10-03 05:39:48
a332c18c8793dee45e21cb3872d369600f394757...ebe85270d95c86d422a9d1ad272f67ed4f3a25dc,1,1,1,2,1,2014-09-26 15:27:55,2014-09-26 15:27:55
dbd45f2f6c235821357747e5575d1a78b3a18807...23e3995cec0604c080784ab69cc162a329daf8b2,1,1,1,2,1,2014-10-24 20:24:28,2014-10-24 20:24:28
38217ee405de65a3fd3e2c217f8d5be8563da327...41a26ced249e5d4546823c2adf7f95f15005ecbf,9,28,28,56,12,2014-10-26 01:27:40,2014-10-26 01:27:40
38217ee405de65a3fd3e2c217f8d5be8563da327...0755d529c6ded76a6c04b13b36ce0471e4bb1ee8,3,48,13,61,10,2014-10-26 01:25:47,2014-09-09 16:17:56
947aa1f7e422a65d12ae92a05c9c7a313ea930af...f4129792874465a7950b871c6042110f47954248,1,1,1,2,1,2014-11-02 00:46:33,2014-11-02 00:46:33
de86b36b508096eea1f9326983ab4d50358f66a5...45b476bdbff7ac38518deb7898529bb9510f648f,11,31,32,63,31,2014-04-09 07:01:48,2014-03-01 16:19:50
45b476bdbff7ac38518deb7898529bb9510f648f...2f0f8ec6d13129cad43e710a3886e59214367c89,5,6,6,12,6,2014-04-09 07:02:34,2014-03-08 07:10:35
ceda9483723fedb04ad6221a32be028cc81c5d4d...6fef447a62dc079448d3c3429f0ce920645a2788,2,2,2,4,2,2014-05-13 21:54:41,2014-05-13 21:54:41
ceda9483723fedb04ad6221a32be028cc81c5d4d...e84b0c0433509bde0b42354754372595db523e1f,1,1,1,2,1,2014-05-13 14:57:04,2014-05-13 14:57:04
e84b0c0433509bde0b42354754372595db523e1f...c2e94eba8da462ba8cacbc1558f7fdf6b3e28007,1,36,2,38,3,2014-05-13 17:53:54,2014-05-13 17:20:18
1759569dbe8d9ebbcfc4bc1b7f87c3fe3e79e4d1...718a6c5da7e4d6031a8c217b1472d2247374813d,4,77,35,112,17,2014-04-03 20:44:42,2014-04-03 20:18:50
1759569dbe8d9ebbcfc4bc1b7f87c3fe3e79e4d1...1c19284a38ffc60c3a89bbda0f2f0355cf687417,1,4,0,4,1,2014-04-03 20:31:55,2014-03-28 23:54:16
8ca182876debea1eb28c983606267b2bf9aa585d...b94306d29bd4de8b16c81c39d7e6a639320a5284,1,1,1,2,1,2014-04-04 00:46:19,2014-04-04 00:46:19
7e145a13c8aaeab8c22fceab73e5e1e149dcd720...956064ec566bb3dfe1f0b5edc81455b43ced11ed,1,21,21,42,22,2014-01-19 21:41:01,2014-01-19 14:04:29
7e145a13c8aaeab8c22fceab73e5e1e149dcd720...cf8f1ec0cdfa8f8fb07ed0aa85030584dcadc8cf,19,21,20,41,20,2014-01-19 12:27:17,2014-01-19 12:27:17
7b42103df6aa207c4d6cc1d977ab0cd2bc04dc65...6856c9f7f6ee3a939d41e7578cb09c39958177dd,4,101,27,128,15,2014-01-18 21:43:57,2014-01-18 21:43:57
a521e982d55370770c1c5e0acef28a64e5a44a14...c32261221829f32c4ad808d1ccc1a2090a114bff,5,441,418,859,5,2014-01-18 22:09:09,2014-01-18 22:09:09
a521e982d55370770c1c5e0acef28a64e5a44a14...67594cb544e5b4b206558802318af4dbe77de1e0,5,5,5,10,5,2014-01-18 21:58:05,2014-01-18 21:58:05
bd8ef99028de09363df72cf25887abe73f7ac346...ee396aeb8e4ada83287500d7b5fd92706f783e6f,1,5,6,11,1,2014-01-17 03:53:02,2014-01-17 02:17:33
0ef8d1bad4cb146961c32a063f12a87116214d9e...b2e88d1359606ddf0a052d245db79ef70bd68dcd,2,2,1,3,2,2014-01-16 02:53:22,2014-01-16 02:53:22
0ef8d1bad4cb146961c32a063f12a87116214d9e...b121207e10ad20e6d1d8dc269f71697ad26a67e6,2,14,20,34,6,2014-01-16 02:21:56,2014-01-16 02:21:56
0ef8d1bad4cb146961c32a063f12a87116214d9e...b886fd2f012f3ebe68292aaedf55d5c3709f972b,2,14,20,34,6,2014-01-16 02:07:22,2014-01-16 02:07:22
0ef8d1bad4cb146961c32a063f12a87116214d9e...47ff60426d1f18302ff9c9ff148abdb461033d3d,1,4,0,4,1,2014-01-16 01:29:54,2014-01-16 01:29:54
f166c5a35b9a037fa0e314ce111812f4b7ef741e...5c1527abc560d38e695eb8d643953a83fb37da7a,5,6,33,39,6,2012-02-02 01:06:40,2012-02-02 01:06:40
98d1659ef836cb879ce7d6260351ff35e96ebd25...906028abdb394284b89cfb669deacd6a4f044709,2,4,4,8,4,2012-02-03 04:45:58,2012-02-03 04:45:06
98d1659ef836cb879ce7d6260351ff35e96ebd25...ced08f69359f3a70771804a98fa3c499f388cc74,1,1,1,2,1,2012-02-02 19:02:14,2012-02-02 19:02:14
98d1659ef836cb879ce7d6260351ff35e96ebd25...8c0b47a6a8315826a5128ec74d3479f2e070e78e,2,12,27,39,13,2012-02-02 13:09:27,2012-02-02 13:09:27
98d1659ef836cb879ce7d6260351ff35e96ebd25...41587018943ac02d91c6298008b01b808aab53fe,1,1,1,2,1,2012-02-02 10:01:16,2012-02-02 10:01:16
98d1659ef836cb879ce7d6260351ff35e96ebd25...99f395bcd7ad18ec1ef63b88516e98b294b5bc12,10,18,18,36,18,2012-02-02 07:30:37,2012-02-02 07:30:37
e36496fd84c504255f1348aab53be55c17fc9824...1b8863f925e3c4161259b4d2aafe132abe9ca49f,1,1,1,2,2,2012-02-02 05:17:04,2012-02-02 05:17:04
e36496fd84c504255f1348aab53be55c17fc9824...c3c13a247490cf177646dc2a9186b3a4e4c4242b,1,1,1,2,1,2012-02-02 04:20:24,2012-02-02 04:20:24
5c2bf0feef7f7f64584cbd0cb6a2ef74dbba80d2...a34231d94d37bd30b59577580a12c20a9939f5fa,1,1,1,2,1,2012-01-10 23:58:44,2012-01-10 23:58:44
5c2bf0feef7f7f64584cbd0cb6a2ef74dbba80d2...51e4e77034e14074cb442138e84b98efd288ccfd,1,3,11,14,5,2012-01-10 03:53:52,2012-01-10 03:53:52
f989c6892f690cf46b0e67158ebb621c3fe690fe...8ceea1f559fb432fc12df32153911de89caea36f,7,28,25,53,25,2012-01-15 19:26:06,2012-01-15 19:26:06
f989c6892f690cf46b0e67158ebb621c3fe690fe...ed9903f797fa6d94789d05c234164bd378a1f3df,1,1,1,2,1,2012-01-15 13:46:25,2012-01-15 13:46:25
acd8ba5816b0d13b26bbf33358ae640abe81a7fa...327980ddb0206b1a1dc2d9c3eed05d28c5f3bf76,1,0,1,1,1,2014-03-12 23:51:12,2014-03-12 23:51:12
327980ddb0206b1a1dc2d9c3eed05d28c5f3bf76...1751922ca063aa4499fe0de4a974bc33be57d69b,3,4,4,8,4,2014-03-12 23:59:58,2014-03-12 23:59:58
b136d42ba5b9f5e181954bb3ff719552b7d2e228...d4a4bbb729008bc1963ceee50c930ae21cc7d254,3,6,6,12,6,2014-03-12 18:22:22,2014-03-12 17:12:39
d4a4bbb729008bc1963ceee50c930ae21cc7d254...065fe98a29b1f1f90d46b9a2ab481fcaa9ea987d,1,1,0,1,1,2014-03-12 20:50:11,2014-03-12 20:50:11
56c6525f23908743c629e90056868018fc97823f...026e2f8d3034372b8f09d535771dba2c3f8dd27b,12,26,26,52,26,2014-03-04 22:24:09,2014-03-04 22:24:09
4d527f925109a75ab88ff8ec811b781190372506...2e02ed4e0c285ef36726f553e82819e76ec109fd,1,1,1,2,1,2014-02-27 19:08:24,2014-02-27 19:08:24
4d527f925109a75ab88ff8ec811b781190372506...17722e5ef23f58bf661c00c7bb8fea306318bcf2,3,33,1,34,3,2014-02-27 15:05:52,2014-02-23 11:33:33
4d527f925109a75ab88ff8ec811b781190372506...05ccc185d9f6b35451f0db53d49c56285d1f8ddd,1,6,2,8,2,2014-02-27 09:15:32,2014-02-27 09:15:32
05ccc185d9f6b35451f0db53d49c56285d1f8ddd...ef49635ae25352d2c9e9fb65048bd3cab90418ac,5,6,5,11,6,2014-02-27 09:15:53,2014-02-27 09:15:53
ef49635ae25352d2c9e9fb65048bd3cab90418ac...a7339a0f4c05f5b6a84cc457641a363e18ef2b85,2,7,5,12,2,2014-02-27 09:39:30,2014-02-27 09:21:52
429fc9331e9c74a77f575d136351630e1271cd3d...f1736e2d32c7f473e8b6a9d466dca4ee31a885cb,1,1,1,2,1,2014-02-25 18:17:44,2014-02-25 18:17:44
f1736e2d32c7f473e8b6a9d466dca4ee31a885cb...c48042f440a734ddde60b4d1a0b5c0cd6dc40e60,2,2,2,4,2,2014-02-25 23:23:52,2014-02-25 23:23:52
c48042f440a734ddde60b4d1a0b5c0cd6dc40e60...f27b864f7ba34c8484e31c1b430312ffd0e4e178,1,1,1,2,1,2014-02-26 01:28:16,2014-02-26 01:28:16
f27b864f7ba34c8484e31c1b430312ffd0e4e178...7b386a566f6f199698f200d9dff4b8cf5da3ed07,2,2,2,4,2,2014-02-26 03:40:15,2014-02-26 03:40:15
429fc9331e9c74a77f575d136351630e1271cd3d...b22f064c2ee38dbd84635d91b8a809a8923f5bfd,6,29072,0,29072,6,2014-02-25 03:22:41,2014-02-25 03:22:41
accc95ccd63f8aa903fa07bea55ef34794d84cc5...8a78bc065f866763607f104907b7a2ac9fa6ceec,3,16,16,32,14,2014-02-16 20:00:04,2014-02-16 19:06:31
accc95ccd63f8aa903fa07bea55ef34794d84cc5...dabb5041a43dd2a50d126c5ab11ae34462ce58a8,1,4,4,8,2,2014-02-15 01:14:52,2014-02-15 01:05:59
accc95ccd63f8aa903fa07bea55ef34794d84cc5...dfa5edca2c5a8dbdd48f27e031718a984f00c5da,1,2,2,4,1,2014-02-14 18:48:17,2014-02-14 18:48:17
accc95ccd63f8aa903fa07bea55ef34794d84cc5...eef939916bb840b405a2f0cceca1c00daa5ed328,2,4,2,6,3,2014-02-14 14:51:01,2014-02-14 14:51:01
accc95ccd63f8aa903fa07bea55ef34794d84cc5...2fba53e600a796995f07e96c53c11ed22bfe8e06,2,2,0,2,2,2014-02-14 12:56:36,2014-02-14 12:56:36
accc95ccd63f8aa903fa07bea55ef34794d84cc5...895b0006b9adbaf3c56953d2ab2967aa85071086,12,1471,1470,2941,97,2014-02-14 09:02:03,2014-02-13 07:55:12
895b0006b9adbaf3c56953d2ab2967aa85071086...65ffe69bdf1a36103241901cbec72b67632d60ce,1,3,3,6,1,2014-02-14 09:02:03,2014-02-13 08:05:04
c0c1588402366730dbbd03e3a1a855a90b8e2d8c...aad0f00887239a1971ae746a2828f037b5d30541,1,24,17,41,9,2014-10-29 06:04:25,2014-10-29 06:04:25
97ed62361e0ba6877b8fd2ccfb450524b2f3f26c...45b59f4307da4c343c605abe41b4909ba632abf1,2,1,3,4,2,2014-10-29 05:57:16,2014-10-29 05:57:16
66bb0b4fc963fec42e7168f40b18703d3f31bfa8...f0fd6df63acc7e845c3b94867120f2f117ea36a5,8,0,29,29,29,2014-10-27 05:33:55,2014-10-27 05:33:55
223d9b4b6b5518dcf498ac31497f2e63bce95259...5589a82e80446b1a2e20c95c6fc08dcc006a1a90,1,31,25,56,5,2014-10-28 18:35:21,2014-10-28 18:35:21
5589a82e80446b1a2e20c95c6fc08dcc006a1a90...780c9b05fe48b45628fe469dd780f8de03e23514,1,1,1,2,1,2014-10-28 20:11:35,2014-10-28 20:11:35
ce7363e0dbdd2ebe03f58acb37fbe493ebcd1db5...c447cc7bc18b61aa5fefb54b821f822cbf222ae9,2,6,0,6,2,2014-09-05 18:59:04,2014-09-05 18:59:04
ce7363e0dbdd2ebe03f58acb37fbe493ebcd1db5...5b7a5f84d4255b09778bdc9b3502660cff511a90,4,22,2,24,6,2014-09-05 02:06:01,2014-09-05 02:06:01
e37e06d73e8823c3e5fc062ae68d9d131c4c2bb4...b9bfc74c62accfe0094730c9c343a9af1b6ab1f8,2,7,1,8,2,2014-09-03 23:50:47,2014-09-03 23:50:47
e37e06d73e8823c3e5fc062ae68d9d131c4c2bb4...e646889fd6ad64459e407d667babd9ad7eee851f,1,1,1,2,1,2014-09-02 22:23:15,2014-09-02 22:23:15
42311c86c1bc25f4c0e32a5855e48754b20f3b63...4a89fd02b743d5a99e06dbf6e87b8a58366c3dcb,6,13,15,28,7,2014-10-10 06:35:56,2014-10-10 06:35:56
4e17a9be189e50bab2dc27497e853df18c6104ee...8e25695d09002eb528876435ebb4dadaabab9359,10,13,10,23,10,2014-09-26 20:45:28,2014-09-26 20:45:28
8e25695d09002eb528876435ebb4dadaabab9359...36fdd29413e002730e9f3f92562c29905afb4573,1,0,6,6,1,2014-09-26 20:47:26,2014-09-26 20:47:26
36fdd29413e002730e9f3f92562c29905afb4573...121b204b146a799f65c412b7d2cbddb9fe79dc10,8,6,14,20,8,2014-09-26 20:48:31,2014-09-26 20:48:31
121b204b146a799f65c412b7d2cbddb9fe79dc10...ef6378b9e8cf0d203e8efa8f4b7a0822fb59c39c,1,9,3,12,2,2014-09-30 20:50:46,2014-09-30 20:50:46
1979a311d4b67f5ecb2fdaf307627504412513a8...79b38361ab0bb1140a2df5ad02cf3bb4ed32a532,1,1,1,2,1,2014-10-24 20:26:05,2014-10-24 20:26:05
79b38361ab0bb1140a2df5ad02cf3bb4ed32a532...80aca8c17ec928be0cb3ffbac8a237e5f5fcae36,1,1,1,2,1,2014-10-24 20:27:28,2014-10-24 20:27:28
75620dadcc3e6f6372f8e53a8f91e31746c87c25...9bf9aab132698e34bc1eb5661563307fc4e86d02,6,34,12,46,10,2014-10-26 01:29:15,2014-10-26 01:29:15
9bf9aab132698e34bc1eb5661563307fc4e86d02...e795ea1084acfdca87d7715a7b6010095be8a28b,2,25,4,29,7,2014-10-26 01:44:55,2014-10-26 01:44:55
e795ea1084acfdca87d7715a7b6010095be8a28b...dbef67f198de6c5f862b044f64924cc41a7d77bd,1,3,3,6,3,2014-10-26 01:53:43,2014-10-26 01:53:43
dbef67f198de6c5f862b044f64924cc41a7d77bd...3fcd65af41a04e9c50365ddc670c4545d7e8994a,9,26,6,32,9,2014-10-26 01:57:27,2014-10-26 01:57:27
3fcd65af41a04e9c50365ddc670c4545d7e8994a...2c2564faefd99b044273f132275bb620b5eccb93,8,5,33,38,8,2014-10-26 02:10:03,2014-10-26 02:10:03
2c2564faefd99b044273f132275bb620b5eccb93...e8af21cc9db7941de217113cef5c7d1640dd86d5,2,52,6,58,5,2014-10-26 02:14:08,2014-05-23 22:27:05
e8af21cc9db7941de217113cef5c7d1640dd86d5...0e991ccba255574677e12d0ae3e8755275e2ec8b,1,1,1,2,1,2014-10-26 02:16:05,2014-10-26 02:16:05
0e991ccba255574677e12d0ae3e8755275e2ec8b...44cc76322981849192217df93a530d225ff9b789,6,24,14,38,10,2014-10-26 02:17:19,2014-10-26 02:17:19
ab6f79c472bc306c82f85dea660e7c7351e3413e...17a6b5e8432fe38397be01e8e79d473b8b84d77f,1,6,0,6,1,2014-11-03 17:17:35,2014-11-03 17:17:35
ee2df11e93c88dff946560d81fd5e2d8fbdd61d4...ee7498a69366c516ccba01ca7c977fb83ea23a7b,1,1,0,1,1,2014-04-09 19:07:27,2014-04-09 19:07:27
ee2df11e93c88dff946560d81fd5e2d8fbdd61d4...3f9076399536adac4bd34e9b0e666ab12e5d0b53,2,24,16,40,3,2014-04-09 07:15:02,2014-03-28 18:05:59
3f9076399536adac4bd34e9b0e666ab12e5d0b53...7950c0ff0ae216fbcb7f24f3fd93eae34ba6b4a6,1,4,0,4,2,2014-04-09 07:15:02,2014-03-28 18:08:42
7950c0ff0ae216fbcb7f24f3fd93eae34ba6b4a6...2c16b3151c3054381c97e9f9e7ab7dea3dcdbefd,1,2,1,3,2,2014-04-09 07:15:02,2014-03-28 18:11:23
2c16b3151c3054381c97e9f9e7ab7dea3dcdbefd...1267a9a02bf5e724b807b7abc97f007b48154b5d,2,8,18,26,4,2014-04-09 07:16:56,2014-03-28 18:11:30
5c11632bafd573462951e91ebda0fd020c63954e...7287582cf2187c59cfdd318fb03ceb2408f762f0,1,1,1,2,1,2014-05-14 23:41:40,2014-05-14 23:41:40
7287582cf2187c59cfdd318fb03ceb2408f762f0...f6bebbd83af66476da63fada2766165dac9fb0a7,1,1,0,1,1,2014-05-15 00:08:53,2014-05-15 00:08:53
5c11632bafd573462951e91ebda0fd020c63954e...95683ddfca4134b119a19143320b17d43cee64cd,1,1,1,2,1,2014-05-14 22:33:41,2014-05-14 22:33:41
5c11632bafd573462951e91ebda0fd020c63954e...122c05dbd87d9708086da4d097f7e715233f3b2c,3,22,0,22,3,2014-05-14 17:36:32,2014-05-14 17:36:32
475dbe58b03c214d973d50ba1fb48fba325cfd85...8e568a8e3652e48e6af23c1aedce2b63dbd2fa9e,5,6,5,11,6,2014-05-23 22:49:13,2014-05-23 22:49:13
f6d1a733f58f76864a137fa1d26db358dc2e9460...5ef634dab9bb39b9dc5beb10a568a05952a519ff,2,9,9,18,9,2014-04-04 01:13:16,2014-04-04 01:13:16
5ef634dab9bb39b9dc5beb10a568a05952a519ff...fa9e541f5e9aa9ce5ea039166826c5f195585daa,5,15,15,30,7,2014-04-04 08:28:45,2014-04-04 08:28:45
fa9e541f5e9aa9ce5ea039166826c5f195585daa...d56026d489fb8db66c2db6aa0d222f1a3fa9261f,1,2,2,4,2,2014-04-04 17:25:22,2014-04-04 17:25:22
faa783e9896c3353f9c4820dea5952bca900cda5...6af0013ac52c391dd7623f9cbbb25cd7d3c43d35,4,30,203,233,16,2014-01-17 04:32:59,2014-01-17 04:31:19
0349fe0f0b4e925b0abcf3de4f3bc8957af57831...0d153fa6438fdf4a6f4e1646b834d91415c67bde,1,1,1,2,1,2014-01-20 05:03:17,2014-01-20 05:03:17
4f1852d5c2cb97cd9bfb9918fdba1c88c860f431...0dc26b2e0707f3ff0f619a01d80c4debe59fb26d,1,4,3,7,4,2014-01-19 14:59:21,2014-01-19 14:59:21
572e6a959aba6fa905c6377b900566b7ecc7c8f4...10a158ff938781dd62440d88750db394d87143aa,1,2,2,4,2,2014-01-18 22:46:32,2014-01-18 22:45:24
5c1527abc560d38e695eb8d643953a83fb37da7a...73238701bd9c5fd43108e1e2a16ce6bdbcd728c9,3,26,5,31,8,2012-02-02 01:41:24,2012-02-02 01:41:24
73238701bd9c5fd43108e1e2a16ce6bdbcd728c9...3a2f0765bfe6cd5696bf3b054364b6a03cbe05da,3,5,4,9,4,2012-02-02 01:54:21,2012-02-02 01:54:21
3a2f0765bfe6cd5696bf3b054364b6a03cbe05da...2fd6a2e9f6df1c8c88a2e99d4ab7366127e1b1a1,3,0,2,2,2,2012-02-02 01:55:32,2012-02-02 01:55:32
2fd6a2e9f6df1c8c88a2e99d4ab7366127e1b1a1...3ea3950225766272313b081836b6d90fbf31e218,3,9,9,18,3,2012-02-02 01:57:39,2012-02-02 01:57:39
3ea3950225766272313b081836b6d90fbf31e218...2e1649410ce79964b43af275d189f5017dd5014b,3,0,3,3,3,2012-02-02 02:00:40,2012-02-02 02:00:40
2e1649410ce79964b43af275d189f5017dd5014b...4d918beb266e0e451aab100905989d5c5d228ff1,3,6,6,12,6,2012-02-02 02:06:52,2012-02-02 02:06:52
4d918beb266e0e451aab100905989d5c5d228ff1...1ebe51c834b0d8a25811ce7bd3fa9a3be0497415,3,2,2,4,2,2012-02-02 02:11:19,2012-02-02 02:11:19
1ebe51c834b0d8a25811ce7bd3fa9a3be0497415...f2d3026de8aae8188262034acc917b863848069c,3,6,6,12,6,2012-02-02 02:12:14,2012-02-02 02:12:14
f2d3026de8aae8188262034acc917b863848069c...8a1769c9e2ff74153b67aa8e0324c8f83280c86a,2,1,1,2,1,2012-02-02 02:18:39,2012-02-02 02:18:39
8a1769c9e2ff74153b67aa8e0324c8f83280c86a...54bfdf11835fef1fb10ebc08355cca584c0e1b30,2,2,2,4,1,2012-02-02 02:24:41,2012-02-02 02:24:41
54bfdf11835fef1fb10ebc08355cca584c0e1b30...94c2c70e6e0a67f30b45efc35806f29d7deaa810,3,2,2,4,2,2012-02-02 02:25:34,2012-02-02 02:25:34
94c2c70e6e0a67f30b45efc35806f29d7deaa810...f34ddb5c3f214b75de36aec2b1631844166bb8cc,8,22,22,44,22,2012-02-02 02:27:38,2012-02-02 02:27:38
c04241b615d7e5e012475d3a8b9dbcd5079eee14...7f0a64106dee57c49777481715c28011f842437d,11,2,137,139,11,2012-02-03 07:31:03,2012-02-03 07:31:03
f68f7870efd4e56dc1d651dc5de37b265558fce1...c8c4d5b3925b033723a3f589db9c579b37ca5ceb,6,22,8,30,12,2012-02-06 08:17:31,2012-02-06 08:17:31
f68f7870efd4e56dc1d651dc5de37b265558fce1...8a8daca71e7c979cc2cac6392e9cf810428a0423,1,1,1,2,1,2012-02-06 04:04:46,2012-02-06 04:04:46
f68f7870efd4e56dc1d651dc5de37b265558fce1...f922a0800b4ec46fe3aa1e31427308954e86940e,1,1,1,2,1,2012-02-03 16:34:03,2012-02-03 16:34:03
4c237e688bb62431d987b10916f0c746ab758851...bd0e95200390d773b4440d0b7e4cc46091300bbd,3,8,8,16,4,2012-02-02 17:36:33,2012-02-02 17:36:33
ab4345332da37fc64171088879d7518b59c400a3...e92e9f1138d8aa6a7ccc640ce3fb091bbf07acfd,3,8,10,18,8,2012-02-02 17:46:14,2012-02-02 17:46:14
e92e9f1138d8aa6a7ccc640ce3fb091bbf07acfd...9ab843b936a6bc9889f0f55a83f13cb25a3990bd,3,2,2,4,2,2012-02-02 17:57:22,2012-02-02 17:57:22
9ab843b936a6bc9889f0f55a83f13cb25a3990bd...ac98cee6092738eb431ebd4c944886358dab721f,5,9,2,11,4,2012-02-05 02:26:04,2012-02-05 02:26:04
ac98cee6092738eb431ebd4c944886358dab721f...9259e24f7370185b33520681000854d421ae1e1d,3,2,2,4,2,2012-02-05 02:27:05,2012-02-05 02:27:05
9259e24f7370185b33520681000854d421ae1e1d...81d1f3b96ea5c78d2e570c07c4c419a32a9b212c,3,0,2,2,2,2012-02-05 02:52:25,2012-02-05 02:52:25
81d1f3b96ea5c78d2e570c07c4c419a32a9b212c...7e81f84b29da8ba87fb4aefcc11946002ad9962c,5,21,15,36,12,2012-02-05 06:22:19,2012-02-05 06:22:19
7e81f84b29da8ba87fb4aefcc11946002ad9962c...468688638d69e23141ec4abda074a36e888c12c7,3,4,0,4,4,2012-02-05 06:23:20,2012-02-05 06:23:20
468688638d69e23141ec4abda074a36e888c12c7...b297a61f82e567a5dccb99d1a01d46c5d8329e95,3,14,14,28,14,2012-02-05 06:31:09,2012-02-05 06:31:09
b297a61f82e567a5dccb99d1a01d46c5d8329e95...6d8ac203e5b07a116336e172e9e1ebdb9ad76c33,3,2,2,4,2,2012-02-05 06:32:04,2012-02-05 06:32:04
6d8ac203e5b07a116336e172e9e1ebdb9ad76c33...679cd5ea02ca83d9c3755d6ac74f4a0bacd02897,11,50,50,100,20,2012-02-05 06:38:49,2012-02-05 06:38:49
aa8a7668cba4c9cc85c0902cb5abf703d0ac86c3...25ffe14c1bf43539d12b459a3807d37d826d1246,3,2,0,2,2,2012-02-02 07:02:31,2012-02-02 07:02:31
25ffe14c1bf43539d12b459a3807d37d826d1246...1ec6628e8005b17ecf16b194450874d8e988a45d,3,8,0,8,2,2012-02-02 07:10:00,2012-02-02 07:10:00
1ec6628e8005b17ecf16b194450874d8e988a45d...8dd2b3d3f8c84ac242469ae24fe7981b0a916b25,2,2,2,4,2,2012-02-02 07:10:37,2012-02-02 07:10:37
77871a420593c08ed6709c9fd0456ab7b6516627...dfdc63e87293efec9196897079ce3826a1a57275,3,2,2,4,2,2012-02-02 17:31:07,2012-02-02 17:31:07
dfdc63e87293efec9196897079ce3826a1a57275...cf488c2800293f4f243f59658b691741f4b78175,7,10,10,20,10,2012-02-02 17:33:18,2012-02-02 17:33:18
f9847b300b2db36bb1623bd1f4928e59aaef1d4e...85e401a6567e51016357acfe6b01cd5b5c330652,3,32,4,36,8,2012-02-05 10:36:21,2012-02-05 10:36:21
85e401a6567e51016357acfe6b01cd5b5c330652...575b82473f8d248ca3782fa86ce1c92eea03905c,7,53,39,92,17,2012-02-07 07:34:03,2012-02-07 07:34:03
f2fdbd91134da9af252bbbfa0601dd8e3c1e3cba...a2ebf0c0c1381c38dda24bf12aebd5f9b4907e06,3,8,1,9,4,2012-01-11 05:54:11,2012-01-11 05:54:11
51e4e77034e14074cb442138e84b98efd288ccfd...6f2f947a4309a8fdeb7067612447c0f1a15dcfd9,17,297,172,469,116,2012-01-12 05:42:55,2012-01-12 05:42:55
1385540d0a404cec680313c3116a27033ced816a...fe160261e460903cae251de25eaf41f236bd051e,4,48,48,96,29,2012-01-15 19:30:24,2012-01-15 19:30:24
fe160261e460903cae251de25eaf41f236bd051e...9f732e90d4e8f3a598a798fb8b29a4f59c0b7631,3,10,18,28,10,2012-01-15 19:33:30,2012-01-15 19:33:30
9f732e90d4e8f3a598a798fb8b29a4f59c0b7631...6077b7678c8d21eeb4bc33bbfede20a4cc41fa11,3,4,4,8,4,2012-01-15 19:41:46,2012-01-15 19:41:46
6077b7678c8d21eeb4bc33bbfede20a4cc41fa11...f43f2c0ea269e72251e7f858b44ccef966d079af,3,10,10,20,8,2012-01-15 20:53:35,2012-01-15 20:53:35
f43f2c0ea269e72251e7f858b44ccef966d079af...127c0d0b52c52227dcd3f346d371e5cd4219a08f,4,25,27,52,12,2012-01-15 21:12:29,2012-01-15 21:12:29
127c0d0b52c52227dcd3f346d371e5cd4219a08f...3d9298b04ba493d877afaa81d8f48545f0a89a3f,1,7,6,13,3,2012-01-15 23:06:30,2012-01-15 23:06:30
3d9298b04ba493d877afaa81d8f48545f0a89a3f...c02501e1b714ebb44c560483316ac36c4f709c50,9,174,164,338,35,2012-01-16 00:27:36,2012-01-16 00:27:36
c02501e1b714ebb44c560483316ac36c4f709c50...f48278dac6ac89fcf9d1ab7526ec3029dd1a4d8e,6,204,88,292,40,2012-01-16 02:40:17,2012-01-16 02:40:17
7b41aab775e98cf53bd13a8318eb80979c87dcff...8a6cdff825a114ec43532701e29087ed8cdedd50,1,1,1,2,1,2014-03-13 22:05:13,2014-03-13 22:05:13
88f01c4934b822b2e3e19496258d256dd1cb2914...a4df36317407fdbef1458a1c5e59b088b85d72c4,5,25,25,50,25,2014-03-04 22:35:23,2014-03-04 22:35:23
a4df36317407fdbef1458a1c5e59b088b85d72c4...a0ac99efbf201f03106f392bce7045d8563064d9,1,2,2,4,1,2014-03-04 22:48:52,2014-03-04 22:48:52
a0ac99efbf201f03106f392bce7045d8563064d9...e418377b119cbe8604370adcc17ab3de76b2a415,2,14,1,15,3,2014-03-04 23:16:38,2014-03-04 23:16:38
e418377b119cbe8604370adcc17ab3de76b2a415...13ed379767d19040c98fc23bd9b5cdb84e66474b,1,1,1,2,1,2014-03-05 00:19:30,2014-03-05 00:19:30
cd134f1ed6b83854bf1f327d092022cfacc1c655...745111ba524ea6cdcff3454cbb0cf1bed3f1b130,1,1,1,2,1,2014-03-03 22:18:03,2014-03-03 22:18:03
745111ba524ea6cdcff3454cbb0cf1bed3f1b130...1c3a3b759340336bd815f646175015499d3409ac,1,1,1,2,1,2014-03-03 22:18:22,2014-03-03 22:18:22
cd134f1ed6b83854bf1f327d092022cfacc1c655...80ce694b2499f45142b9746aa862cf288ce38e5e,1,7,0,7,1,2014-03-02 21:19:44,2014-03-02 21:19:44
cd134f1ed6b83854bf1f327d092022cfacc1c655...e872955737577e1f54651438edea7fc436696873,1,3,0,3,1,2014-03-02 10:03:09,2014-03-02 10:03:09
7b386a566f6f199698f200d9dff4b8cf5da3ed07...b878491b9a76e2c85787e38e6cc878cd3dca909f,1,4,0,4,1,2014-02-26 16:59:36,2014-02-26 16:59:36
b22f064c2ee38dbd84635d91b8a809a8923f5bfd...e40c1e5e6d78870a0e9c6b01c6dd8909181af479,10,601,21629,22230,200,2014-02-25 18:31:02,2014-02-25 04:46:45
e40c1e5e6d78870a0e9c6b01c6dd8909181af479...d1c971a1341050ef588b5a93ebfb297db1564496,1,1,1,2,1,2014-02-25 18:38:41,2014-02-25 18:38:41
5566c935f201b8af2ca7e1ba45a3beeb836d746d...dd60fcb4673e118c7f8f10be86f1b6c475b224e6,1,2,3,5,4,2014-02-16 18:57:39,2014-02-16 18:57:39
00b3b8b0b8d5515b6eb1ea7064f6d88175306ed9...db32afe6cf972d1101ee86a64b72a37b252173c7,3,3,3,6,3,2014-02-18 05:40:02,2014-02-18 05:28:27
00b3b8b0b8d5515b6eb1ea7064f6d88175306ed9...a06e15dd368ea2b24b911c7f77892a2b19a58f98,4,45,45,90,18,2014-02-17 19:56:46,2014-02-17 19:56:46
0c269c96394a5676b61ac9291595bf84c6061e97...1399497a02c6741c21a655b22a4ae71f8ed2b974,5,13,5,18,5,2014-03-04 08:30:40,2014-03-04 08:30:40
8eeab63e7e78da6016a847f106bee8b8c419176b...ca02f49013f6f505f4f0faa0ccd6cd81c178e890,1,1,1,2,1,2014-02-16 20:26:09,2014-02-16 20:26:09
2d20bba3079f194f657c993c8a99791f97074374...a75c6d84e102598ed39f7926a8e1cb4d3f6e487d,4,8,3,11,4,2014-10-29 06:08:42,2014-10-29 06:08:42
c672f9e07990c1f7d805938be74bc8cfa0eed1b1...af70ac8ae1e959e90e6859a36ae29d41f10ee880,2,7,24,31,23,2014-10-27 20:50:45,2014-10-27 20:50:45
c672f9e07990c1f7d805938be74bc8cfa0eed1b1...3908235e0fb0550a6fcffe6499f3b6786900e85d,2,1,2,3,2,2014-10-27 17:35:59,2014-10-27 17:35:59
c672f9e07990c1f7d805938be74bc8cfa0eed1b1...dcee894a8ca811abcc47ac59f63bb3918efafab1,5,5,5,10,5,2014-10-27 05:57:38,2014-10-27 05:57:38
780c9b05fe48b45628fe469dd780f8de03e23514...3eec86e2e5a2ea835f929eb3fa31e32f51ca6216,2,3,3,6,3,2014-10-28 23:05:32,2014-10-28 23:05:32
3eec86e2e5a2ea835f929eb3fa31e32f51ca6216...d87a636ff9f4febd9a09ed98dce35cecc4c9a43f,1,6,6,12,3,2014-10-28 23:10:43,2014-10-28 23:10:41
5b7a5f84d4255b09778bdc9b3502660cff511a90...83daf95c649ab9e2cf0aaf8c51cc2c88adf65375,1,3,3,6,3,2014-09-05 05:10:19,2014-09-05 05:10:19
af5f2213f066159e4bc51c627c4a853fec6ddc0f...c4a8d7617732911570e7d257788e9def6df50823,1,6,0,6,1,2014-09-04 19:30:38,2014-09-04 19:30:38
4a89fd02b743d5a99e06dbf6e87b8a58366c3dcb...9f82f27b9de22c96e1f9b0f0de3ff76cc2c0f284,9,118,104,222,12,2014-10-13 10:32:39,2014-10-12 20:40:45
4a89fd02b743d5a99e06dbf6e87b8a58366c3dcb...86eac52cceb6b215bf14636f9d8db97c6987777d,2,3,1,4,2,2014-10-12 09:40:10,2014-10-12 09:40:10
ef6378b9e8cf0d203e8efa8f4b7a0822fb59c39c...d8c02c7d296f1410f2fcf8a864d8e7ea366a85fa,1,2,2,4,2,2014-10-01 00:10:51,2014-10-01 00:10:51
d8c02c7d296f1410f2fcf8a864d8e7ea366a85fa...7398e1904b2f6ae97ef3213137cbb21aaf6fbef9,1,2,2,4,2,2014-10-01 00:54:34,2014-10-01 00:54:34
a92aea5127e805cb44c9d606a71c48fa19ee157b...0ad97ab4461bdd1d721dcf2f21dd3691dcbea37a,2,8,12,20,6,2014-10-25 11:12:20,2014-10-24 22:58:07
0ad97ab4461bdd1d721dcf2f21dd3691dcbea37a...db550a9235745474ebaa839c43dbbe0f46fa7134,5,9,4,13,5,2014-10-25 11:12:21,2014-10-25 11:08:06
a92aea5127e805cb44c9d606a71c48fa19ee157b...49bcdcb0a8223dee3ca0575f57c13a400b12ba7a,1,2,1,3,1,2014-10-24 23:15:04,2014-10-24 20:52:49
a92aea5127e805cb44c9d606a71c48fa19ee157b...0ba39d45b4655c6fca9c8faaf40dc1d576a31bf3,2,3,10,13,4,2014-10-24 22:48:02,2014-10-24 22:45:57
deab673d43b1293857f708fa7a64228c023093e1...069488dea398fa6124602e43ae633fe4781a4837,5,252,120,372,11,2014-11-04 06:25:52,2014-11-03 19:17:03
deab673d43b1293857f708fa7a64228c023093e1...594831f4f3f3c1164812cfdd60497fe6d7438376,3,92,0,92,3,2014-11-03 21:37:27,2014-11-03 21:37:27
deab673d43b1293857f708fa7a64228c023093e1...f0d8894d54afbd10b43a0919383b35fdbf961b51,2,12,3,15,3,2014-11-03 18:56:30,2014-11-03 18:56:30
ee7498a69366c516ccba01ca7c977fb83ea23a7b...2127eb563fafdad10d004d33533a44ad023440e5,1,2,2,4,1,2014-04-15 18:01:51,2014-04-15 18:01:51
ee7498a69366c516ccba01ca7c977fb83ea23a7b...82b066f0a91b6ff0fb5e49b43382dd44d0f35134,1,10,2,12,2,2014-04-12 19:44:35,2014-04-12 19:44:35
ee7498a69366c516ccba01ca7c977fb83ea23a7b...55336e6a9e93d8861c68d7df67ecea3a33efccbf,1,1,0,1,1,2014-04-11 21:49:52,2014-04-11 21:49:52
ee7498a69366c516ccba01ca7c977fb83ea23a7b...3777ef007d7329e44a415e12858606b8728e95b5,1,6,0,6,1,2014-04-11 00:43:53,2014-04-11 00:43:53
3777ef007d7329e44a415e12858606b8728e95b5...06f6c9f00691e9d536958f775b9bc72dc2b3f5c5,1,1,1,2,1,2014-04-11 21:15:33,2014-04-11 21:15:33
06f6c9f00691e9d536958f775b9bc72dc2b3f5c5...458cb6944beb7bfa65c12c6b20387757969617ba,1,18,2,20,3,2014-04-11 22:30:51,2014-04-11 22:30:51
458cb6944beb7bfa65c12c6b20387757969617ba...a80eb1eb50d0c5953c2dc35ceb67ad622aa9a732,1,1,0,1,1,2014-05-01 02:47:50,2014-05-01 02:47:50
a80eb1eb50d0c5953c2dc35ceb67ad622aa9a732...108b7c390efda6f9d56fb2749374a7999956b1a0,8,13,6,19,8,2014-05-01 02:47:56,2014-05-01 02:47:56
e0c3ae61333c76b5f1490f074c6558498d5e995d...eaddbd92bb19f0ee7e04ae12736de4d49e33c925,4,13,8,21,11,2014-04-20 23:19:13,2014-04-20 23:19:13
eaddbd92bb19f0ee7e04ae12736de4d49e33c925...d971ddb730c5577bd533e7c598e2990c128b1265,1,3,3,6,3,2014-04-20 23:33:23,2014-04-20 23:33:23
d971ddb730c5577bd533e7c598e2990c128b1265...a549e8c332c44ed3b79e3250a0a0d87cc06f7e00,23,23,23,46,23,2014-04-21 16:11:23,2014-04-21 16:11:23
a549e8c332c44ed3b79e3250a0a0d87cc06f7e00...52b6a3214574de58bee6e08049e5b477bb4f226c,23,23,23,46,23,2014-04-21 16:12:43,2014-04-21 16:12:43
52b6a3214574de58bee6e08049e5b477bb4f226c...9c4afc577253ada54d3ff27965e380a5c9f4e60e,1,3,3,6,3,2014-04-21 20:08:42,2014-04-21 20:08:16
f6bebbd83af66476da63fada2766165dac9fb0a7...99f6f700f47154c8126bfbdceadcd3a45627801a,2,51,51,102,7,2014-05-15 01:12:18,2014-05-15 01:12:18
99f6f700f47154c8126bfbdceadcd3a45627801a...90cfa1a44de353d1b0a8aef080e267bd765159e3,1,8,0,8,1,2014-05-15 01:20:55,2014-05-15 01:17:24
90cfa1a44de353d1b0a8aef080e267bd765159e3...e839a4999559eeea4a74dfeebb16428a48b44728,1,1,1,2,1,2014-05-15 01:21:19,2014-05-15 01:18:33
e839a4999559eeea4a74dfeebb16428a48b44728...6fdbd8e3cf90d1beaccc60396d30303287b4b1b8,1,1,1,2,1,2014-05-15 01:21:19,2014-05-15 01:19:50
6fdbd8e3cf90d1beaccc60396d30303287b4b1b8...3465d984fb934b1616b8d4ecf394b997cd1f0fab,1,1,1,2,1,2014-05-15 01:23:58,2014-05-15 01:23:58
3465d984fb934b1616b8d4ecf394b997cd1f0fab...00fcf072c6955b1e5ba51298db1026c91783eef6,1,1,1,2,1,2014-05-15 01:43:14,2014-05-15 01:43:14
5f59f96020a766267f9b1067d71110bcac357117...511240b37751f10fc5043c8155f9f097c8bdcb09,1,1,1,2,1,2014-05-18 05:55:29,2014-05-18 05:55:29
8e568a8e3652e48e6af23c1aedce2b63dbd2fa9e...ad34c3b061b1b565dc087dfb8679292cf8e828d4,1,2,2,4,2,2014-05-28 23:52:47,2014-05-28 23:52:36
8e568a8e3652e48e6af23c1aedce2b63dbd2fa9e...6e4825aef19a1480d48a85af297169849b0437d4,1,4,0,4,1,2014-05-27 11:01:13,2014-05-27 11:01:13
6e4825aef19a1480d48a85af297169849b0437d4...67a332c97b1ab06751798bf3b2f1690a2b27dc6c,1,2,2,4,1,2014-05-27 12:39:47,2014-05-27 12:39:47
8e568a8e3652e48e6af23c1aedce2b63dbd2fa9e...36616db81dbf463c932b77c9bae8c722f007f8a3,1,1,1,2,1,2014-05-24 03:50:45,2014-05-24 03:50:45
d56026d489fb8db66c2db6aa0d222f1a3fa9261f...58e6af3988f4fc2dff0fe585fecd14abf0644a35,1,5,0,5,1,2014-04-06 00:21:44,2014-04-06 00:21:44
d56026d489fb8db66c2db6aa0d222f1a3fa9261f...fce0254b2a90e99804e6433d01ca45a5378285ac,1,1,1,2,1,2014-04-05 22:33:57,2014-04-05 22:33:57
6af0013ac52c391dd7623f9cbbb25cd7d3c43d35...7fab3c30f225bd5b1f362575c684388041199fbd,3,3,3,6,3,2014-01-17 12:34:03,2014-01-17 12:34:03
adda5d55c660871b83726586e68ecca44d905e63...06a7bdd0b06e2c4b166104b09f69d146e85c6b33,2,4,4,8,3,2014-01-20 06:27:01,2014-01-20 06:27:01
0dc26b2e0707f3ff0f619a01d80c4debe59fb26d...f2d37ccc230a71f993d88239395d7990c449b219,3,4,4,8,4,2014-01-19 15:41:14,2014-01-19 15:41:14
3b6ab5075e881f6486145f2b3aea22bf53ee44e7...2115ac525b076f32003c28272703f4e279ab2f46,7,11,11,22,11,2014-01-18 22:40:48,2014-01-18 22:40:48
c1f0da7cce2b7c3258d17f5e81faac25e231bbf8...4211f21e39631179753d6775e3ad90be05ab5f8f,3,2,0,2,2,2012-02-02 06:27:11,2012-02-02 06:27:11
4211f21e39631179753d6775e3ad90be05ab5f8f...43d797dfff839013deb726a55edf082378444640,3,2,0,2,2,2012-02-02 06:29:15,2012-02-02 06:29:15
43d797dfff839013deb726a55edf082378444640...58fd0dea36173c8672fd77cf06df2ccfbeb4d068,8,20,22,42,21,2012-02-02 06:51:01,2012-02-02 06:51:01
c1f0da7cce2b7c3258d17f5e81faac25e231bbf8...6738042c61f72ade97107f47f48b3c9f1b276de4,1,0,0,0,0,2012-02-02 06:21:29,2012-02-02 06:21:29
6738042c61f72ade97107f47f48b3c9f1b276de4...e1deb4e767e927bb70633cdd577de3fda3919f0a,11,137,0,137,11,2012-02-02 06:27:46,2012-02-02 06:27:46
e1deb4e767e927bb70633cdd577de3fda3919f0a...e26da36b9afa513c605731b2111d44b9c05a65c9,1,1,2,3,1,2012-02-02 06:30:51,2012-02-02 06:30:51
63fd119c6e9fed19aaf8ca2a2ddb8a0832fe1523...7ce62ffc9813ea2958b353ee36374d3146034dbf,2,1,1,2,1,2012-02-07 07:42:57,2012-02-07 07:42:57
c8c4d5b3925b033723a3f589db9c579b37ca5ceb...91d0997c79722cebbfc00e45affe8ac6d03dd54a,1,1,0,1,1,2012-02-07 18:58:01,2012-02-07 18:58:01
91d0997c79722cebbfc00e45affe8ac6d03dd54a...9928e7fd3ccdf81b9990ed1dc95256d7d56ffc64,1,1,0,1,1,2012-02-07 19:05:13,2012-02-07 19:05:13
9928e7fd3ccdf81b9990ed1dc95256d7d56ffc64...d390a921dcb26ec4854e337acece36e6a36327c0,1,1,0,1,1,2012-02-07 19:06:08,2012-02-07 19:06:08
c8c4d5b3925b033723a3f589db9c579b37ca5ceb...25bf0af2492920d3da59cc64a23c1a776279a3eb,2,4,2,6,2,2012-02-07 18:29:45,2012-02-07 18:29:45
c8c4d5b3925b033723a3f589db9c579b37ca5ceb...3722bb9a88e95b37ded12cb40a67ac396ce140fd,1,2,2,4,2,2012-02-07 07:11:25,2012-02-07 07:11:25
c8c4d5b3925b033723a3f589db9c579b37ca5ceb...7e92b33f12d8c5840aa746094f9566f0a0a1aaf8,1,3,0,3,1,2012-02-06 22:37:47,2012-02-06 22:37:47
c8c4d5b3925b033723a3f589db9c579b37ca5ceb...407ca09226ab044d3d960561e0f98cdc90c96574,1,7,0,7,1,2012-02-06 22:33:12,2012-02-06 22:33:12
c8c4d5b3925b033723a3f589db9c579b37ca5ceb...9ba9185afc6a91d8047bb76654af429d7efba96b,1,6,6,12,1,2012-02-06 08:59:23,2012-02-06 08:59:23
3fa971378e7acc4c235821b71ca5ac6deb2ac423...3b57fba754c2536e9c8a8bcf10b24f3e2cec4677,2,1,1,2,1,2012-02-07 08:07:08,2012-02-07 08:07:08
3b57fba754c2536e9c8a8bcf10b24f3e2cec4677...2d9b3c45d3ae5b2e4055435783d0d9428353b70a,3,33,29,62,3,2012-02-07 08:13:52,2012-02-07 08:13:52
2d9b3c45d3ae5b2e4055435783d0d9428353b70a...adff17ac03e932d09d80d68d6a5b1c0463805dc1,2,1,1,2,1,2012-02-07 08:16:05,2012-02-07 08:16:05
9b5b8460b4e6d5e30357aaddbef5425a6150b0bf...83cb1053178241d95b0f53da062a4b742d0313cc,3,53,6,59,18,2012-02-05 09:36:11,2012-02-05 09:36:11
83cb1053178241d95b0f53da062a4b742d0313cc...abf4ecac4dbd378a4985880e27f2897ebca75e7b,3,34,1,35,3,2012-02-05 09:41:45,2012-02-05 09:41:45
abf4ecac4dbd378a4985880e27f2897ebca75e7b...f59b7ce8ea0051287488ff2119dc29a066429eaa,3,2,2,4,2,2012-02-05 09:43:22,2012-02-05 09:43:22
f59b7ce8ea0051287488ff2119dc29a066429eaa...53da88e561abf4a5802188ff1901e6915b85c18b,2,9,0,9,1,2012-02-05 09:49:36,2012-02-05 09:49:36
53da88e561abf4a5802188ff1901e6915b85c18b...ff91b233eb51da94451114f45e276ba325f67479,3,4,4,8,4,2012-02-05 09:50:55,2012-02-05 09:50:55
ff91b233eb51da94451114f45e276ba325f67479...d92523f3299c751d77ea43893fa39bbb687a5f80,3,2,2,4,2,2012-02-05 09:57:09,2012-02-05 09:57:09
d92523f3299c751d77ea43893fa39bbb687a5f80...2a192468d311289e9e219cf8cbe3047da4aa3381,3,2,2,4,2,2012-02-05 09:59:16,2012-02-05 09:59:16
2a192468d311289e9e219cf8cbe3047da4aa3381...4a09cf04d8d644734f91c9a9ce97091ad698fcce,3,6,6,12,4,2012-02-05 10:01:28,2012-02-05 10:01:28
4a09cf04d8d644734f91c9a9ce97091ad698fcce...91475c865dd8fe224c574c1a15e8949fccdda8c0,3,5,1,6,2,2012-02-05 10:14:25,2012-02-05 10:14:25
91475c865dd8fe224c574c1a15e8949fccdda8c0...59b32586af807d0e4f2985ef6e927e32d8ae2df5,3,3,8,11,5,2012-02-05 10:16:46,2012-02-05 10:16:46
59b32586af807d0e4f2985ef6e927e32d8ae2df5...f8c2d9b53d0b3cfba1f7fbced88457f53d1dbbd6,3,2,2,4,2,2012-02-05 10:24:14,2012-02-05 10:24:14
f8c2d9b53d0b3cfba1f7fbced88457f53d1dbbd6...546332d85de5837147b645bf6bab5fa06e2a1039,3,13,0,13,2,2012-02-05 10:28:42,2012-02-05 10:28:42
679cd5ea02ca83d9c3755d6ac74f4a0bacd02897...93fea1f1cf7902261a3743acadd9bb2a196e2190,1,1,1,2,1,2012-02-05 07:21:56,2012-02-05 07:21:56
93fea1f1cf7902261a3743acadd9bb2a196e2190...98cffdbf4684a85565d6ca7cf1173319863d03fd,1,1,1,2,1,2012-02-06 07:02:16,2012-02-06 07:02:16
679cd5ea02ca83d9c3755d6ac74f4a0bacd02897...87a8c9b677bff0d831f920922c86d5b0cff9949c,3,0,2,2,2,2012-02-05 06:40:50,2012-02-05 06:40:50
87a8c9b677bff0d831f920922c86d5b0cff9949c...418bf5221a70440aeecffe9ad9006b444aaf1747,3,2,2,4,2,2012-02-05 06:50:26,2012-02-05 06:50:26
418bf5221a70440aeecffe9ad9006b444aaf1747...35fdddbc4fdd134953ce2b1e4a88047850aa47a0,3,2,2,4,2,2012-02-05 06:55:47,2012-02-05 06:55:47
35fdddbc4fdd134953ce2b1e4a88047850aa47a0...a2848ebb0000f3dbe9ba29ec91713bef072b1668,3,18,15,33,9,2012-02-05 07:53:24,2012-02-05 07:53:24
a2848ebb0000f3dbe9ba29ec91713bef072b1668...125368d4db04fa5b2300975ed2ba59983309ee0f,3,8,0,8,2,2012-02-05 07:57:15,2012-02-05 07:57:15
125368d4db04fa5b2300975ed2ba59983309ee0f...31abeec0f2d84b3861d0c80c56c3112546bf0bfd,3,2,0,2,2,2012-02-05 08:05:01,2012-02-05 08:05:01
31abeec0f2d84b3861d0c80c56c3112546bf0bfd...cdb1ad1a52a9f55c63003b7b62ef8b1e9c6fcfaf,3,4,0,4,2,2012-02-05 08:11:21,2012-02-05 08:11:21
cdb1ad1a52a9f55c63003b7b62ef8b1e9c6fcfaf...f29e3263b04fd2ecbd42e864e03abc15439b4a1b,3,8,6,14,2,2012-02-05 08:16:25,2012-02-05 08:16:25
f29e3263b04fd2ecbd42e864e03abc15439b4a1b...dfcb2d1ed83e2c1bc76b4646ba28dccae4205d08,3,2,0,2,2,2012-02-05 08:25:40,2012-02-05 08:25:40
dfcb2d1ed83e2c1bc76b4646ba28dccae4205d08...0336f1e644b2b2e76bf797aab6d26644c41de897,3,4,4,8,4,2012-02-05 08:27:08,2012-02-05 08:27:08
0336f1e644b2b2e76bf797aab6d26644c41de897...6661639b37a6e577c4795e4394a0f0b6b75f4a01,3,2,2,4,2,2012-02-05 08:29:19,2012-02-05 08:29:19
6661639b37a6e577c4795e4394a0f0b6b75f4a01...2f42f35c69da66709247c2830935479dc97061a4,3,2,2,4,2,2012-02-05 08:35:13,2012-02-05 08:35:13
4ed1b13719083fb9bb7ab7273cc9bf84482992cc...1a97cce19bf4e4be082d8724a30b3c1425c660b4,2,2,2,4,2,2012-02-07 07:39:22,2012-02-07 07:39:22
a2ebf0c0c1381c38dda24bf12aebd5f9b4907e06...32c628725924ca014df208fa57de4c5a4050733e,3,13,1,14,4,2012-01-11 17:43:13,2012-01-11 17:43:13
19090ea33322e9d4309497f838f8627ca21734bf...1fa94bdbf47e592e8c51920bb9489ef760e04830,1,3,3,6,3,2012-01-12 11:04:17,2012-01-12 11:04:17
f48278dac6ac89fcf9d1ab7526ec3029dd1a4d8e...f1a88eede391cbb4beaadce60768a351724d7633,10,73,55,128,23,2012-01-17 01:27:30,2012-01-17 01:27:30
f48278dac6ac89fcf9d1ab7526ec3029dd1a4d8e...b4dd2b9a10a9313bbe0863b9da279e212f8d230d,1,1,1,2,1,2012-01-16 03:38:30,2012-01-16 03:38:30
13ed379767d19040c98fc23bd9b5cdb84e66474b...24de9b099438c09236b2066333744e3995cd88ab,10,74,6,80,10,2014-03-05 00:55:15,2014-03-05 00:55:15
13ed379767d19040c98fc23bd9b5cdb84e66474b...9dae5368f54a9a5a36849d19350a9109224ad542,1,1,1,2,1,2014-03-05 00:21:17,2014-03-05 00:21:17
ce4175b65e85dbc6ed7333fa19534afc8be016c9...6bd54ef14b880ed71844011f71484ac2e6f7d132,1,3,2,5,2,2014-02-27 20:17:08,2014-02-27 20:17:08
1c3a3b759340336bd815f646175015499d3409ac...bd37ea307686716edd6df409f2fb76951bfa6a5b,1,1,0,1,1,2014-03-03 22:42:39,2014-03-03 22:42:39
1c3a3b759340336bd815f646175015499d3409ac...cddf14b32d843482b0baa6fb9eb0462810d2a2fe,1,8,1,9,1,2014-03-03 22:21:46,2014-03-03 22:20:07
cddf14b32d843482b0baa6fb9eb0462810d2a2fe...6f1cc694fea395bf2669260ca8ebb593b3d9f169,2,15,2,17,2,2014-03-03 22:22:19,2014-03-03 22:20:37
caf332080e7dfa7818ab57fe04028ece60fdf975...5193f9f607affbb5c01f5215ed19168ce3530ca5,6,148,1,149,6,2014-03-04 21:32:02,2014-03-04 21:32:02
5193f9f607affbb5c01f5215ed19168ce3530ca5...64579505d24052e7edb14f7f8d63a44bb72b5fea,1,5,0,5,1,2014-03-04 21:52:13,2014-03-04 21:52:13
64579505d24052e7edb14f7f8d63a44bb72b5fea...f45df646705f12fe8ce97b886c5c9301ada0c9a5,9,17,6,23,9,2014-03-04 21:54:09,2014-03-04 21:54:09
f45df646705f12fe8ce97b886c5c9301ada0c9a5...1c66f30b6a67d43a7f4da0b3e4d58aa7094d25a7,1,3,9,12,3,2014-03-04 21:54:56,2014-03-04 21:54:56
1c66f30b6a67d43a7f4da0b3e4d58aa7094d25a7...7733f2437316c2ae10e669a50771646ae8b8e927,12,4793,4762,9555,1138,2014-03-04 22:12:57,2014-03-04 22:12:57
7733f2437316c2ae10e669a50771646ae8b8e927...8f2a787c369c51634093784ef903d428272285d7,1,1,1,2,1,2014-03-04 22:20:48,2014-03-04 22:20:48
af39290a9de8b156bacfdc93d209a683f611714c...4dd7b4bd8797448703acf3b8ce4c3cf04e6ce8c7,7,12,419,431,8,2014-03-04 05:54:07,2014-03-04 05:54:07
4dd7b4bd8797448703acf3b8ce4c3cf04e6ce8c7...7e764a29fae26fe71479bf3f682a253540ae9bda,2,3,3,6,2,2014-03-04 05:56:40,2014-03-04 05:56:40
7e764a29fae26fe71479bf3f682a253540ae9bda...587814f16e01c6aae4c5c7f882134732a812a182,2,3,6,9,3,2014-03-04 06:49:43,2014-03-04 06:49:43
587814f16e01c6aae4c5c7f882134732a812a182...559b90f944fe9cfd463c1be3f89cf5d7cf7f8cb4,6,38,5,43,7,2014-03-04 07:50:04,2014-03-04 07:50:04
559b90f944fe9cfd463c1be3f89cf5d7cf7f8cb4...477dc99ffa3a4a8c604e6fbbc4946ca2eb83ba01,1,0,1,1,1,2014-03-04 07:50:28,2014-03-04 07:50:28
db32afe6cf972d1101ee86a64b72a37b252173c7...a4dac463e082bbe11fef05e28f1430780d03980b,1,5,6,11,5,2014-02-18 09:43:24,2014-02-18 09:43:24
25d047ded4a828f114710f3f1f3af7a4839f96c9...ca15add174fdd8507699e1ab18591ecb037b4396,1,3,1,4,1,2014-02-19 20:30:55,2014-02-19 19:45:28
25d047ded4a828f114710f3f1f3af7a4839f96c9...8af1673ab775ef28d5492b33143bf5865d98ee1c,1,2,1,3,1,2014-02-19 19:27:16,2014-02-19 19:19:41
1399497a02c6741c21a655b22a4ae71f8ed2b974...02ca9de45f64947899290c141b0efcb05c927b0d,1,2,2,4,2,2014-03-04 14:29:53,2014-03-04 14:29:53
a75c6d84e102598ed39f7926a8e1cb4d3f6e487d...3fe6a04b903cae7592c26b6bb766c0714b991c0e,1,2,2,4,1,2014-10-29 06:20:51,2014-10-29 06:20:02
c4b053a0131e93a206429ee2575dd67fd9508e12...e528daf6d0c7709fa6c7d6091ff097cd4834a840,1,1,1,2,1,2014-10-29 05:57:56,2014-10-29 05:57:56
af70ac8ae1e959e90e6859a36ae29d41f10ee880...96801605a4c777a903766a895161a0e556a21c2f,1,1,1,2,1,2014-10-27 22:20:55,2014-10-27 22:20:55
af70ac8ae1e959e90e6859a36ae29d41f10ee880...032a5ab72f8a7f0e786cb1d796ef895395b86e1f,2,103,1,104,101,2014-10-27 22:00:30,2014-10-27 22:00:30
032a5ab72f8a7f0e786cb1d796ef895395b86e1f...a43d4767ba7a1d8d313f9c418a378b6749dd6040,3,374,381,755,375,2014-10-27 22:02:21,2014-10-27 22:02:21
2758cfecd8dc135012018af474d8509e9f5ace45...a7fd40950bb08ff09a0ded2778a7298136403a5f,1,6,0,6,1,2014-10-29 00:54:59,2014-10-29 00:53:55
2758cfecd8dc135012018af474d8509e9f5ace45...4f6aeaa6347725436296131c4d2b059243390a04,1,21,0,21,2,2014-10-29 00:41:25,2014-10-29 00:41:25
c20d00cf058a85dea22c6073623e93549bce32e0...9f5660c3e3b3d392529d07c4f2cfe0aba2abbe89,1,6,3,9,1,2014-09-07 04:25:33,2014-09-07 04:25:33
5603311acd6f06c15802ebdae5d94a6b2de6bb22...bb8ca6b786ce194e0de977c0410c4b208afc0217,1,12,28,40,4,2014-09-05 23:04:56,2014-09-05 23:04:56
87c166552803cda56757ca20f27c8abee1c1bf37...8a6a253355ab1d26865bfbfffaa2a194e173a3aa,1,1,1,2,1,2014-10-14 18:41:30,2014-10-14 18:41:30
8f912a76cd4bacc49140de665e027bff1800853d...0e236586aaf5bcb6a6b420a03144a295569cfc7b,1,0,6,6,1,2014-10-01 02:38:00,2014-10-01 02:38:00
0e236586aaf5bcb6a6b420a03144a295569cfc7b...89a873e204d27a12cff008f8e4434820026c551d,1,0,6,6,1,2014-10-01 16:19:29,2014-10-01 16:19:29
89a873e204d27a12cff008f8e4434820026c551d...91581e8c6c6a9e4d66895049b3f77962e4c4ae39,1,1,1,2,1,2014-10-01 16:38:09,2014-10-01 16:38:09
91581e8c6c6a9e4d66895049b3f77962e4c4ae39...32162b16cbb7c8d1ac9f5dd5e9e4514be14e70af,1,1,1,2,1,2014-10-01 19:10:33,2014-10-01 19:10:33
db550a9235745474ebaa839c43dbbe0f46fa7134...c1f669e83b9f867d38ba251bb1f944cec874fa4b,1,0,1,1,1,2014-10-25 23:50:38,2014-10-25 23:50:38
57b60e3a042999ef6f5f8988ca8297dc19cd6a72...a0e6bd96de844725fb5a4f414aef721be86204c5,8,10,8,18,8,2014-10-26 00:54:06,2014-10-26 00:54:06
203912b9c500c44e3091093965fc4dc4ffeef7ff...eb74d8c86399d41673b9aa0052c70582b13bd714,1,36,11,47,8,2014-11-10 08:55:58,2014-11-04 10:39:54
eb74d8c86399d41673b9aa0052c70582b13bd714...1786942d33d1c169b62cae18b52662c94a6224aa,1,3,0,3,3,2014-11-10 08:55:58,2014-11-04 10:50:50
1786942d33d1c169b62cae18b52662c94a6224aa...19520d46208161eb83cb5201ee8bac526483fe74,1,3,3,6,3,2014-11-10 08:55:59,2014-11-04 10:56:40
203912b9c500c44e3091093965fc4dc4ffeef7ff...d10700427805c40497b24d7f4ffdd58a7a83c997,5,73,70,143,15,2014-11-04 11:35:38,2014-11-03 15:19:40
1a833e75d5a12d4b7aeb2ef05e10fe14232fc725...0d291e862324bda24445e093651d6b5fe4f2d4c7,1,1,1,2,1,2014-11-04 18:40:39,2014-11-04 18:40:39
0d291e862324bda24445e093651d6b5fe4f2d4c7...e55feacf5be152694205b14491ad626537756314,2,13,0,13,2,2014-11-04 19:00:08,2014-11-04 16:50:34
d904429e05ce8ba68ebba673cab603a861792aba...2862c30320e8a1c0499f4bd83141e0c6cd959f1e,9,15,5,20,14,2014-11-08 06:17:39,2014-11-08 06:17:39
2862c30320e8a1c0499f4bd83141e0c6cd959f1e...8fbb2bbbd17449205339553ffdcf8e87c4354630,9,12,9,21,9,2014-11-08 07:01:20,2014-11-08 07:01:20
2127eb563fafdad10d004d33533a44ad023440e5...aec366c5910675067c02f5cf79a1846721707515,1,5,0,5,1,2014-04-16 03:03:44,2014-04-16 03:03:44
2127eb563fafdad10d004d33533a44ad023440e5...f18bff0a7c10fe7afe4276029e9eda15e1f0c227,2,8,1,9,2,2014-04-15 21:12:39,2014-04-15 21:12:39
d08f7dd80711f6096f9d2f413ed2933f9d6dd2bf...06fb9406bd16ef66e1f8587209a35e231189018e,3,12,4,16,4,2014-04-17 07:56:22,2014-04-17 07:56:22
06fb9406bd16ef66e1f8587209a35e231189018e...c8a8e768510cc1bd9e72d5cade23fba715efb59f,1,0,5,5,1,2014-04-17 08:08:54,2014-04-17 08:08:54
d08f7dd80711f6096f9d2f413ed2933f9d6dd2bf...132732e4220fb73c26ab07b4486b2e5ad91100ee,1,4,0,4,1,2014-04-17 07:21:09,2014-04-17 07:21:09
d08f7dd80711f6096f9d2f413ed2933f9d6dd2bf...1d77660c62f178407c3cd306cc745182de2abc03,1,4,1,5,1,2014-04-16 15:29:36,2014-04-16 15:29:36
1d77660c62f178407c3cd306cc745182de2abc03...ca45998fc9ac6ea2d83c32dfe590d2f76d37db0d,1,2,2,4,2,2014-04-16 16:39:29,2014-04-16 16:39:29
9c4afc577253ada54d3ff27965e380a5c9f4e60e...f6f74b5445fc2961d38d4432ec3eed61b12cb027,1,1,1,2,1,2014-04-23 14:10:38,2014-04-23 14:10:38
9c4afc577253ada54d3ff27965e380a5c9f4e60e...637808f2ee4f4b43897b115fa736353621639681,1,1,1,2,1,2014-04-23 07:34:32,2014-04-23 07:34:32
637808f2ee4f4b43897b115fa736353621639681...73f7acc01b7e2535c615045322822c617af1357b,1,2,1,3,1,2014-04-30 03:12:31,2014-04-30 03:12:31
9c4afc577253ada54d3ff27965e380a5c9f4e60e...a9f2b6ce0fb2ac059e30da259f7ae25282803c09,22,415,288,703,198,2014-04-22 05:03:33,2014-04-22 05:03:33
9c4afc577253ada54d3ff27965e380a5c9f4e60e...b9ae07d84a79b1a138e3e6068b0cdbdce9041e58,1,4,2,6,2,2014-04-22 00:35:29,2014-03-25 04:25:16
9c4afc577253ada54d3ff27965e380a5c9f4e60e...6161c982384cba2ba7eee4462b4a1b8f6caf2400,1,4,0,4,1,2014-04-21 23:42:22,2014-04-21 23:42:22
9c4afc577253ada54d3ff27965e380a5c9f4e60e...f66a747615c5216b8cd81c699149f993e8f28608,1,26,0,26,2,2014-04-21 20:14:53,2014-04-21 20:14:53
f66a747615c5216b8cd81c699149f993e8f28608...4d0a8e31a46e54bb180eadb2844d1e4a9c7c4e91,1,5,3,8,4,2014-04-25 02:02:47,2014-04-21 20:16:57
4d0a8e31a46e54bb180eadb2844d1e4a9c7c4e91...6617d8bcd1db42bf03a4b1d9288e16dae8acfd5a,1,5,0,5,1,2014-04-25 02:02:47,2014-04-21 20:28:21
6617d8bcd1db42bf03a4b1d9288e16dae8acfd5a...4bd29bfcff4a78d4828396d614139db2f308eb2a,1,3,3,6,3,2014-04-26 00:48:02,2014-04-26 00:48:02
4bd29bfcff4a78d4828396d614139db2f308eb2a...e114727ae94934f0f916eb2b5969b93ae4e408dc,1,3,3,6,1,2014-04-26 00:50:38,2014-04-26 00:50:38
a40ff40b8fb852af8034b215e2102ca8ff1618e0...f47ad79538458c4fe787335a5873c00073c5c2c9,2,13,4,17,5,2014-05-16 20:07:45,2014-04-15 07:46:58
a40ff40b8fb852af8034b215e2102ca8ff1618e0...a70da16f6fb8c665f22b78b49a1dff998f1da8a7,3,54,0,54,9,2014-05-16 17:45:38,2014-05-09 03:19:12
511240b37751f10fc5043c8155f9f097c8bdcb09...1da03a1e734c4b4e5666377045766e1417d1f837,1,3,0,3,1,2014-05-19 00:20:54,2014-05-18 22:48:40
1da03a1e734c4b4e5666377045766e1417d1f837...df9f576583a082ad53afe4d324581c1c92779b23,1,2,2,4,2,2014-05-19 00:20:54,2014-05-18 22:50:07
df9f576583a082ad53afe4d324581c1c92779b23...db26c9f4b479f7f1ace9f4a3af225be48c807139,1,7,3,10,4,2014-05-19 00:20:54,2014-05-18 22:52:42
db26c9f4b479f7f1ace9f4a3af225be48c807139...6638fc164970caf866344e9ef6a6127e2e2a6081,1,9,2,11,3,2014-05-19 00:20:54,2014-05-18 22:53:40
6638fc164970caf866344e9ef6a6127e2e2a6081...ca23e3913ba8ba91f77d25f9a9021a1238142999,1,1,0,1,1,2014-05-19 00:20:54,2014-05-18 23:03:15
ca23e3913ba8ba91f77d25f9a9021a1238142999...4a9ab6011d5fc250b216b90e028f2a4f4378b9e3,1,0,1,1,1,2014-05-19 00:20:55,2014-05-18 23:05:16
ad34c3b061b1b565dc087dfb8679292cf8e828d4...95ff94091ec63db6818b996fff71ef9f22498bf2,11,18,18,36,18,2014-05-29 00:18:22,2014-05-29 00:05:54
4fd4681221131d916d0d9693ce08fb856890d1cd...7bcd78847ffe3c85d024f097e7102667e3c79604,5,28,4,32,10,2014-06-11 05:51:17,2014-06-11 05:51:17
06a7bdd0b06e2c4b166104b09f69d146e85c6b33...336f5f1dce6294b185871ed1effe6c2c3dac31b5,3,2,2,4,2,2014-01-20 06:29:51,2014-01-20 06:28:25
2a75e559f64bf536423cbf63bce433cdfb2f9976...3e9ba3f6716943a3aee2d09d368eb6344820049e,2,6,6,12,6,2014-01-19 21:27:51,2014-01-19 21:27:51
6840d8f7763c97ad3e095020c7933be63ccf8916...b5f1d2f3a46e070427eb73857c653b0bf090a1d6,2,7,7,14,2,2012-02-07 07:48:48,2012-02-07 07:48:48
b5f1d2f3a46e070427eb73857c653b0bf090a1d6...7dffeb471f53bc3fa974abdd567690f770c8b647,3,2,2,4,2,2012-02-07 07:55:18,2012-02-07 07:55:18
00c13691a934c5662b638c2272d03c9bcf5f5fe0...11f72f6aa22c9d2daa9a95846e6c786afd7bc3e1,3,4,1,5,2,2012-02-07 08:31:01,2012-02-07 08:31:01
11f72f6aa22c9d2daa9a95846e6c786afd7bc3e1...139a07754303e1e53b34a0fca3b9c0a43ee5712b,3,2,2,4,2,2012-02-08 05:55:27,2012-02-08 05:55:27
139a07754303e1e53b34a0fca3b9c0a43ee5712b...04fd01d4b67b8f71fe58affb34fcf4907ccabc98,3,8,4,12,4,2012-02-08 06:04:52,2012-02-08 06:04:52
b0bd3efc4a5fba45020541115ec21ae7574442c7...18760393d7dbc3576622e1b99e2fbb5f973aa7d2,1,1,0,1,1,2012-02-14 20:16:55,2012-02-14 20:16:55
b0bd3efc4a5fba45020541115ec21ae7574442c7...28cfa8be03bad9430d14cc1a5b511ace65cdfa4d,1,7,0,7,1,2012-02-14 02:10:36,2012-02-14 02:10:36
28cfa8be03bad9430d14cc1a5b511ace65cdfa4d...9143d8e449a852c606194ea8c529e30ea1a52ddf,1,1,0,1,1,2012-02-14 02:11:41,2012-02-14 02:11:41
343012a9af04102dac033737db7999376bf5db59...5bb55e46157ec974120535acdb6335841c85fa37,3,2,2,4,2,2012-02-12 03:21:23,2012-02-12 03:21:23
5bb55e46157ec974120535acdb6335841c85fa37...158419c0455ea499197f8b7917bdfe299caaac19,3,8,0,8,2,2012-02-12 04:00:44,2012-02-12 04:00:44
158419c0455ea499197f8b7917bdfe299caaac19...b327420e524691808b59fa2d0d552e5ec65e2a45,3,2,2,4,2,2012-02-12 04:58:10,2012-02-12 04:58:10
b327420e524691808b59fa2d0d552e5ec65e2a45...2eedf60d6284f8eef256999d2a59dd18bcbd2b2a,4,258,282,540,10,2012-02-12 06:34:41,2012-02-12 06:34:41
620d987f9f4a6e5d7bcf270159aea10e01d32a35...5e3c21133430112bf8361827dc7a6a29f3f56c72,3,5,5,10,4,2012-01-12 18:19:07,2012-01-12 18:19:07
1c734281c9ba3bc820c3e30fb330c6f90ac0081f...810bba97a418ae641d9360c232c1492610463dcf,4,24,16,40,20,2012-01-16 05:48:58,2012-01-16 05:48:58
810bba97a418ae641d9360c232c1492610463dcf...036b98535711941ba64d9bb507f57ca60ec3cdc3,3,5,7,12,6,2012-01-16 05:50:04,2012-01-16 05:50:04
036b98535711941ba64d9bb507f57ca60ec3cdc3...87bd0e0b88b9c5a836bfde1478839e542c74ac05,3,12,6,18,8,2012-01-16 05:54:58,2012-01-16 05:54:58
87bd0e0b88b9c5a836bfde1478839e542c74ac05...7ec4e91324e6e490291f3de22e1127c4fa55f82a,3,7,7,14,10,2012-01-16 05:58:45,2012-01-16 05:58:45
7ffb90560e148e4c6818654e268252f81da9f5a0...fdbeefff590d2c185eae86f2e5976c5e8d0de28d,1,1,0,1,1,2014-03-05 00:56:35,2014-03-05 00:56:35
fdbeefff590d2c185eae86f2e5976c5e8d0de28d...10eb167e35f9047aa6b3c0e420467161a1bc4d2b,9,26,24,50,14,2014-03-05 06:42:13,2014-03-05 06:42:13
6bd54ef14b880ed71844011f71484ac2e6f7d132...db4b7553f04fd27c4998558f30b995b021f102b9,1,3,0,3,1,2014-03-01 20:42:31,2014-03-01 20:42:31
6bd54ef14b880ed71844011f71484ac2e6f7d132...6f09a8883c0de5a0f241d03a0e10d54b8da57e1b,1,3,1,4,1,2014-03-01 20:27:07,2014-03-01 20:27:07
6bd54ef14b880ed71844011f71484ac2e6f7d132...299f985e5d453c2a6b1202bbc545d83f84b09360,1,1,1,2,1,2014-02-28 15:29:36,2014-02-28 15:29:36
cb3cc42315df0847ede2d46ca9f45971e0799a98...e381635b1faf7480bcf54618804a62dd4a049a93,6,15,7,22,7,2014-03-04 05:39:53,2014-03-04 05:39:53
0c98895604902495bbc6107c62d9d8574b755193...5517f9907e5660858226b99138da36951660d564,2,8,0,8,2,2014-02-21 22:52:15,2014-02-21 22:52:15
5517f9907e5660858226b99138da36951660d564...f542fcc627557feb9ad7fb7998971d57da9fe794,1,8,2,10,2,2014-02-21 23:03:16,2014-02-21 23:03:16
f542fcc627557feb9ad7fb7998971d57da9fe794...449dd83ec32ab0cda37614006573be1e099f6133,1,3,1,4,1,2014-02-21 23:06:21,2014-02-21 23:06:21
0c98895604902495bbc6107c62d9d8574b755193...72565b69c24d0e58484544af0b220b9746589376,1,1,1,2,1,2014-02-21 15:32:24,2014-02-21 15:32:24
0c98895604902495bbc6107c62d9d8574b755193...4dde96b674b1d62720e33edeeff27bb28fad530f,1,0,1,1,1,2014-02-20 21:27:19,2014-02-20 21:27:19
0a56bf7bf2e6696ea38aaf8c5310a87c883e4a66...a369a0a72981d8bb68257889e077ad5b51d64cb5,1,1,1,2,1,2014-10-29 15:51:05,2014-10-29 15:51:05
96801605a4c777a903766a895161a0e556a21c2f...0b9f69b9c85cb611caaa264479bcad28522637d9,1,1,1,2,1,2014-10-27 22:26:55,2014-10-27 22:26:48
1e268ddfc30def5f4b2b0f2ace34b7de549ea830...647d30aa04ee777aad378f8d31f2735ec465d61c,2,19,21,40,3,2014-11-12 03:25:54,2014-11-12 03:25:54
892f6e35b855211b28a0f68354dec16f94ad2167...a5497da5bedf5aec842fbe26b764a0b5c1178942,4,4,4,8,4,2014-10-28 03:37:17,2014-10-28 03:37:17
8a6a253355ab1d26865bfbfffaa2a194e173a3aa...aa8269cfb6a251db60c3a86eb761650ecd81aefc,2,13,13,26,18,2014-10-22 12:06:09,2014-10-19 23:50:59
8a6a253355ab1d26865bfbfffaa2a194e173a3aa...a4f93895be88b7e5535ee9b4993d539c6e5b5d8d,10,7,9,16,14,2014-10-22 11:52:49,2014-10-22 11:52:49
8a6a253355ab1d26865bfbfffaa2a194e173a3aa...b43a7a932e0797488bb0bc4b48b76f343a75d15f,1,3,3,6,3,2014-10-20 19:43:03,2014-10-20 19:43:03
32162b16cbb7c8d1ac9f5dd5e9e4514be14e70af...2b70f94b159233665d85c19da66962b9c1f6f4cc,1,1,1,2,1,2014-10-02 04:30:36,2014-10-02 04:30:36
1403748907d1924eceb738a9f2132aca41fce66e...e9d6f256c25a51cfba5be818fa948a55a93b1379,5,3,5,8,5,2014-10-25 23:59:25,2014-10-25 23:59:25
5339f7c8d577f5890f324df2a9310d7c1f1cb2bd...7047f9df14d89c9b38bff2d76be5c1d5f0f2b5db,2,463,249,712,108,2014-11-10 10:54:23,2014-11-10 10:35:33
7047f9df14d89c9b38bff2d76be5c1d5f0f2b5db...bf4a331f1a6817b477bd5a931bb3b0671997f9de,2,2,2,4,2,2014-11-10 10:55:26,2014-11-10 10:55:26
9dea3060970002a5813fe4d8241d9499e1747d1f...15820391935170f9f7110a1d2d135044c95f722b,2,16045,11,16056,11,2014-11-04 18:34:29,2014-11-03 13:32:38
e55feacf5be152694205b14491ad626537756314...14e5fb04e9bf7c406b799b75b0427522d87a4ccb,2,19,2,21,7,2014-11-04 22:17:55,2014-10-30 03:46:14
39f8c8183bac23fdd05bb617a444e0941802ffac...852eef9689079b8781c102cce43dc352ae8325d6,8,32,6,38,8,2014-11-08 08:10:53,2014-11-08 08:10:53
852eef9689079b8781c102cce43dc352ae8325d6...df28b7e25f2c4008ad3a8179ccf7e556fcb13400,9,11,6,17,9,2014-11-08 08:13:19,2014-11-08 08:13:19
1254c322fa77edbd87a33ed30dc5904bdbb91a51...f2af95353e4656eeb01838caea10fe76af69ca4d,1,1,0,1,1,2014-04-16 04:52:34,2014-04-16 04:52:34
1254c322fa77edbd87a33ed30dc5904bdbb91a51...cd4696f7231cbf6f0478a3bfc1b5c4551e3a290e,2,3,3,6,3,2014-04-16 04:16:40,2014-04-16 03:28:08
ed2da1c3544458aa4f113dbf4864b99f803f404d...f09d6b7a9827452d259b4daafbe3f8341b557776,5,10,4,14,5,2014-06-11 06:15:09,2014-06-11 06:15:09
99b5405c7f58aa7cc0b45c72785310c5afb7273b...573ad10a9dba52e4a6f059e63b667f4034ad2b39,1,5,0,5,1,2014-04-18 02:08:46,2014-04-18 02:08:46
99b5405c7f58aa7cc0b45c72785310c5afb7273b...98acc69219d7f15f3d87225ad96851ec9ba0e3c0,2,20,6,26,20,2014-04-18 01:43:05,2014-04-18 01:43:05
59387742963801e6f03f567e8fe7e093d4aec323...d4c72487490169c11e4c0166d31cbb40b105c216,5,7,4,11,5,2014-05-13 03:26:01,2014-05-13 03:26:01
99f22d97ba4d82faa22c2b3a406dd4058b426e8e...42c8daea75b19424e026c78262e0fac1a95d715a,1,1,1,2,1,2014-05-01 18:45:48,2014-05-01 18:45:48
42c8daea75b19424e026c78262e0fac1a95d715a...b23ca2de41462f7de9d1be0cdf932e5b42e9fc75,1,1,1,2,1,2014-05-01 20:27:00,2014-05-01 20:26:03
b23ca2de41462f7de9d1be0cdf932e5b42e9fc75...d9edf28c5f8607a217ec2b7945ca98f66938b623,1,2,2,4,2,2014-05-01 20:37:44,2014-05-01 20:37:44
fcdaed49170ec5d566c289c22526720a03eacec1...b882a63ff710ec09904734cfb4658193d4210889,1,1,1,2,1,2014-04-23 21:01:40,2014-04-23 21:01:40
022dc30891dd435fb15a69a0830a92fd40c11b12...d4728b8c6dfb06b9e65d3ec31f8c7d3fe34b7c75,1,51,0,51,1,2014-04-25 02:14:06,2014-04-24 22:27:42
d4728b8c6dfb06b9e65d3ec31f8c7d3fe34b7c75...937ef4824e544343252e00a5aa5462e60e5ddd19,1,15,15,30,13,2014-04-25 02:14:06,2014-04-24 23:00:13
937ef4824e544343252e00a5aa5462e60e5ddd19...eab6d3ead83446cfa383b3e00b289a96b8a354e8,1,1,1,2,1,2014-04-25 02:14:06,2014-04-24 22:35:58
eab6d3ead83446cfa383b3e00b289a96b8a354e8...a84a3693b12f549e075424a63d34a83dc19d277b,22,44,22,66,43,2014-04-28 05:08:44,2014-04-24 22:35:05
aca859a13fc2f538aed7fffdd4d28a5393a195ea...9c25f5c06ee54c681919343524a55ebe9904c0ab,2,8,0,8,2,2014-04-25 01:06:59,2014-04-25 01:06:42
05d4932cadbcf5a7148f26483142cf347354a2d4...5ea66ba3b00659779dcdc4dae05e38cfe7a0da77,5,17,7,24,7,2014-04-26 19:24:25,2014-04-26 06:30:50
05d4932cadbcf5a7148f26483142cf347354a2d4...f2eff55064fed7cce93291da75e1f5233621e64f,1,5,5,10,2,2014-04-26 05:35:47,2014-04-25 05:29:22
f2eff55064fed7cce93291da75e1f5233621e64f...ab1087f6e58e3dc71fb2083c8e3047a5b15fe51a,1,15,5,20,10,2014-04-26 05:35:48,2014-04-25 05:30:52
ab1087f6e58e3dc71fb2083c8e3047a5b15fe51a...30b07b942e4d0e9ae5ad2ab1091058597f01a705,7,21,19,40,12,2014-04-26 05:35:48,2014-04-25 05:32:24
05d4932cadbcf5a7148f26483142cf347354a2d4...43b6d6c2f879b08c682433adfd6a8a78622500b3,1,3,3,6,2,2014-04-26 04:44:14,2014-04-26 04:44:14
e44f5b15b1330b00f62eb8bf5dc923b31f869995...3d1723d68911446e10dae18db37a9ff78d197578,1,1,1,2,1,2014-05-17 00:05:03,2014-05-17 00:05:03
082bc20bb9ff1eb26e23ea8f2144f966fac20336...8a62f9e61f84af1bb6f683431fbba15969c49eca,1,17,0,17,1,2014-05-22 04:07:16,2014-05-19 06:57:50
082bc20bb9ff1eb26e23ea8f2144f966fac20336...8e354c4240c87ce129c7c5f06d525fe89798cae0,1,7,10,17,3,2014-05-19 07:07:31,2014-05-19 07:07:31
5a1614466d02f1379287b8053a19fa90117ea7a8...5872a7e0aca5e2b5b8e0be5df8b2a7cdf987d805,4,8,3,11,4,2014-06-05 02:18:40,2014-06-04 02:48:36
5a1614466d02f1379287b8053a19fa90117ea7a8...22cdf4ae94cf0679ec6b40e6377f772116435095,1,1,1,2,1,2014-06-02 19:43:57,2014-06-02 19:43:57
5a1614466d02f1379287b8053a19fa90117ea7a8...445deb7e2d8d877237b0da81515e656428c6aecd,1,0,1,1,1,2014-05-29 20:13:03,2014-05-29 20:13:03
1d97cbed0fc522304feedead906c3f479370fa06...5c1357b3e96bfa87994251ee97bef6e7315b6b83,5,13,4,17,5,2014-06-11 05:58:21,2014-06-11 05:58:21
5c1357b3e96bfa87994251ee97bef6e7315b6b83...f77d0aa591d455159ae1d9927333227cf1ae0382,1,1,1,2,1,2014-06-11 06:06:25,2014-06-11 06:06:25
f77d0aa591d455159ae1d9927333227cf1ae0382...cb85f2ad9b7d4e5ca57b9417afc83a60a2274a05,1,1,1,2,1,2014-06-11 06:08:30,2014-06-11 06:08:30
3556f9e3ad3c5009049410ce229818cc9135d10a...4aca4cf8661ab6e17ffd58820679a081db80ceaa,5,5,5,10,5,2014-06-10 07:26:20,2014-06-10 07:26:20
4120aadd68ddd15d2b8f0cddc9c72118caec9923...317aa8092dcbf182ef3bdcc8d0222096fc6a51ea,1,1,0,1,1,2014-01-21 04:11:51,2014-01-21 04:11:51
4120aadd68ddd15d2b8f0cddc9c72118caec9923...4380ca434885f33072885e639a2d29cc203771bd,1,1,1,2,1,2014-01-20 21:46:41,2014-01-19 19:19:20
4120aadd68ddd15d2b8f0cddc9c72118caec9923...9818ad532e0db599ef48afa552a29cce99d5a0a9,1,1,1,2,1,2014-01-20 07:37:02,2014-01-19 09:50:40
4120aadd68ddd15d2b8f0cddc9c72118caec9923...79487ba499992c4bdfe41044e081a7ee4f5e4815,1,1,1,2,1,2014-01-20 07:07:32,2014-01-20 07:07:32
4120aadd68ddd15d2b8f0cddc9c72118caec9923...f59573db0d4dd6f7f1e3b2c62058298de771a257,4,18,18,36,15,2014-01-20 06:50:09,2014-01-20 06:50:09
a77fba3c37b4b471b98632c2300c2fea6a2f3571...04cfca25afcbab01bc4c7003a4f075c89412e952,1,1,1,2,1,2014-01-19 23:12:09,2014-01-19 23:12:09
04cfca25afcbab01bc4c7003a4f075c89412e952...937e067a27506cea4ffd58c71afafbcf6eae92dd,1,4,0,4,1,2014-01-19 23:28:30,2014-01-19 23:28:30
687c8bf761827fd676d5a7726fbe8b2d41f5719c...b36a744fa74ace319b9f924f777df50591ceb62c,3,2,2,4,2,2012-02-08 06:32:32,2012-02-08 06:32:32
c10661cf5d5e84bf840c0f2404218c0bc08add27...d7aefe67e3df78bde61eaa7ecab807bb03aeb1ef,8,31,11,42,15,2012-02-11 07:07:32,2012-02-11 07:07:32
d7aefe67e3df78bde61eaa7ecab807bb03aeb1ef...8a91f927f51fc96221dd553baef5dbe73b8b9b4c,3,4,4,8,2,2012-02-11 07:37:54,2012-02-11 07:37:54
8a91f927f51fc96221dd553baef5dbe73b8b9b4c...c720d951be4481dab684955b7ef1a4ebb03ed0cf,3,46,30,76,6,2012-02-11 07:50:45,2012-02-11 07:50:45
c720d951be4481dab684955b7ef1a4ebb03ed0cf...b4b3343a617f8b23abcfa502dfd5fb4ff7c50ba1,3,2,2,4,2,2012-02-11 07:57:31,2012-02-11 07:57:31
b4b3343a617f8b23abcfa502dfd5fb4ff7c50ba1...89205d9db43f6c2fb2ed14cdb11c50c858de0550,4,5,2,7,3,2012-02-11 07:59:00,2012-02-11 07:59:00
89205d9db43f6c2fb2ed14cdb11c50c858de0550...02cb4df4697acacfdc65560e14994eccd6ebda7e,3,4,4,8,4,2012-02-11 08:01:35,2012-02-11 08:01:35
02cb4df4697acacfdc65560e14994eccd6ebda7e...a63663a3b6309e98068a79b863b0f77031e5035e,3,2,2,4,2,2012-02-11 08:02:28,2012-02-11 08:02:28
a63663a3b6309e98068a79b863b0f77031e5035e...722c75d1b19fbb9ed98be0afa54f4f79c9f7ee48,5,4,11,15,5,2012-02-11 08:07:05,2012-02-11 08:07:05
722c75d1b19fbb9ed98be0afa54f4f79c9f7ee48...cbccbed8c8ebdfe0f02502b1915106d56c90b3cc,3,2,2,4,2,2012-02-11 08:10:26,2012-02-11 08:10:26
03e6dc66c2fe14e756723395752feefb687b6526...7ec09d0db9b1117d708682a08efaa55045e6926e,31,36,36,72,36,2012-02-17 06:42:38,2012-02-17 06:42:38
2eedf60d6284f8eef256999d2a59dd18bcbd2b2a...a72ef967ba7e4870fb1d737dedf8bf8a10ae6587,11,50,50,100,20,2012-02-12 19:08:33,2012-02-12 19:08:33
a72ef967ba7e4870fb1d737dedf8bf8a10ae6587...c02df9390330b3fa6b9c7cd0b4390093c163fae9,11,50,50,100,20,2012-02-12 19:08:58,2012-02-12 19:08:58
c02df9390330b3fa6b9c7cd0b4390093c163fae9...a2bc22bad5fd1b7ab6bba10087cea36aad63c550,3,24,9,33,6,2012-02-12 19:14:13,2012-02-12 19:14:13
a2bc22bad5fd1b7ab6bba10087cea36aad63c550...b9d5ceb14bf77e62dd8b017f76b72a3a14643620,2,1,1,2,1,2012-02-12 19:17:46,2012-02-12 19:17:46
b9d5ceb14bf77e62dd8b017f76b72a3a14643620...24df7f1e1d9cc018eca5f7adcca15500f5503022,2,2,0,2,1,2012-02-12 21:20:08,2012-02-12 21:20:08
f58aa16f59635c267ba507229a88d1e54e06d194...ef8b27cdc7ad490b4b52003a7178bd1465ee5dc9,2,3,3,6,2,2012-01-12 20:30:36,2012-01-12 20:30:36
ef8b27cdc7ad490b4b52003a7178bd1465ee5dc9...391248c0e3ba9b00b0b4a02e4d94475e9ae9877a,11,502,135,637,35,2012-01-12 23:29:16,2012-01-12 23:29:16
9372fdbf9787b35535cf0c475edc00cc46e3906f...51f5b7b8af6e0f6ef0dbe86528209cd664af240a,4,11,16,27,14,2012-01-18 07:24:59,2012-01-18 07:24:59
51f5b7b8af6e0f6ef0dbe86528209cd664af240a...47b8184bbb5784eb373ffbb905c8a1756eba3c6d,8,86,81,167,55,2012-01-18 07:39:18,2012-01-18 07:39:18
7ec4e91324e6e490291f3de22e1127c4fa55f82a...593b062c7a9781272b983a1a2e1af0824d79e1c4,1,27,23,50,6,2012-01-17 18:32:25,2012-01-17 18:32:25
d7dc8a7bd3cecffb437c8491dbe93665d33bbb62...58201d7f119df7976ef996f4c02efdc2ca6b3733,1,1,1,2,1,2014-03-05 08:25:35,2014-03-05 08:23:54
58201d7f119df7976ef996f4c02efdc2ca6b3733...c1d3337c747735b0230412124e82b5dde59a7a99,1,1,1,2,1,2014-03-05 17:07:50,2014-03-05 17:07:50
d7dc8a7bd3cecffb437c8491dbe93665d33bbb62...de8b784913530a00a6be1bcbb6d592bbf47506fa,1,4,0,4,1,2014-03-05 06:49:14,2014-03-05 06:49:14
d0bf4f4b630a85f1217bad20fbf22872d3bac1fc...269dae0cc8402ffb577cde7828a107cfafbd69d5,1,6,6,12,1,2014-03-01 21:07:33,2014-03-01 21:07:33
299f985e5d453c2a6b1202bbc545d83f84b09360...7d1fd44b9a9a998850533c1023667e2ee6cb1ad0,1,1,1,2,1,2014-02-28 19:11:02,2014-02-28 19:11:02
299f985e5d453c2a6b1202bbc545d83f84b09360...537e10033e055bc060ecbd57a678e6cfcfffed30,5,32,34,66,13,2014-02-28 15:30:08,2014-02-19 07:11:05
537e10033e055bc060ecbd57a678e6cfcfffed30...d65f749390a32ec8c7abb09199bf31a7cca415ac,3,2,3,5,3,2014-02-28 15:30:08,2014-02-19 07:11:25
d65f749390a32ec8c7abb09199bf31a7cca415ac...2619325626d25c2f7b342bfc17451e5ff451615f,1,3,0,3,2,2014-02-28 15:30:08,2014-02-19 12:28:05
2619325626d25c2f7b342bfc17451e5ff451615f...be8f125ce6225222507f0b7329ea88b99207ac21,2,1,1,2,2,2014-02-28 15:30:08,2014-02-27 15:38:37
be8f125ce6225222507f0b7329ea88b99207ac21...25450730247f4e77f30660f52762fa83e44d6fa1,2,1,1,2,2,2014-02-28 15:30:08,2014-02-27 15:38:46
25450730247f4e77f30660f52762fa83e44d6fa1...c586a56d573ed4498b9ba2a8742653b23d92de2b,2,3,1,4,2,2014-02-28 15:30:08,2014-02-28 12:21:21
c586a56d573ed4498b9ba2a8742653b23d92de2b...055730d84ef31936fd3e13d7809528c6cc006d96,1,4,4,8,4,2014-02-28 15:30:08,2014-02-28 12:24:35
055730d84ef31936fd3e13d7809528c6cc006d96...22d004e332700e4867691896b9f6db954c2d7c12,1,8,8,16,1,2014-02-28 17:07:14,2014-02-28 17:07:14
c8614c0f15f0ce78426c6403e57aff22c3ce2beb...0c9308a3b29be6d56c582dce33092164be7997b4,13,45,22,67,19,2014-03-07 05:40:22,2014-03-07 05:40:22
a369a0a72981d8bb68257889e077ad5b51d64cb5...22baa8153b58e80df248b38ddf2aeae4f3f9cc2b,3,308,194,502,166,2014-10-29 16:42:00,2014-10-29 16:42:00
a369a0a72981d8bb68257889e077ad5b51d64cb5...94b59b57d6cae8ba6503b3040d361a4efda5cdc6,37,108,108,216,101,2014-10-29 15:56:20,2014-10-29 15:56:20
94b59b57d6cae8ba6503b3040d361a4efda5cdc6...22f9c8fc0ac2d4c1f7da4b920b8a8a714bed80c4,5,5,5,10,5,2014-10-29 15:58:51,2014-10-29 15:58:51
ea8660520323cc0ea7395a5afb305fc189cbe52d...22e1f94b52b741c62d3f7d9d7891b395e7bb2372,1,31,31,62,29,2014-10-27 22:53:43,2014-10-27 22:53:41
ba2b3a013696acea8e140209a1d6eeb2628aa6e8...125945eb9058ad8db1f3843259ee9aa73e9bec5f,3,5,5,10,4,2014-11-12 03:51:10,2014-11-12 03:49:44
a5497da5bedf5aec842fbe26b764a0b5c1178942...bf3be5a456b3f6699a7832957dc0d1fbf6ac1590,8,13,10,23,11,2014-10-28 03:45:46,2014-10-28 03:37:52
60bb69acd512d3d54fc388823f9946cd0d350f6f...e1d40f7633886298a9fb417ed4f118844ed83a0d,3,27,3,30,6,2014-10-22 19:02:19,2014-10-17 14:17:57
e1d40f7633886298a9fb417ed4f118844ed83a0d...2bc5277b44ed5d2e79ab531e398f9930023426a5,11,15,9,24,11,2014-10-22 19:04:18,2014-10-22 19:04:18
2bc5277b44ed5d2e79ab531e398f9930023426a5...e2cfbd5f2df12cb207a66663925f5ee7e5cb2320,2,108,4,112,2,2014-10-22 19:35:44,2014-10-10 06:19:45
e2cfbd5f2df12cb207a66663925f5ee7e5cb2320...95e0f48e3a2b2f002ef50f34bb1559f8765fe262,1,4,4,8,1,2014-10-22 19:38:34,2014-10-22 19:38:34
95e0f48e3a2b2f002ef50f34bb1559f8765fe262...40c309b39aae2620ac501447f59eed23612e72fd,6,14,14,28,6,2014-10-22 19:39:37,2014-10-22 19:39:37
40c309b39aae2620ac501447f59eed23612e72fd...ab8dbc214e7ea43fec65c4464b8db7392f3df905,3,99,6,105,7,2014-10-22 19:42:35,2014-10-10 14:50:00
ab8dbc214e7ea43fec65c4464b8db7392f3df905...3c98dd35bafd4788d42eb3b083ef8d2defcdcf66,1,6,2,8,3,2014-10-22 20:09:58,2014-10-22 20:09:58
a096c3f6f66c3ce5d0517ef712479a9db22e6beb...e811a2411827ad2da3821b6357c920bc903c3b82,2,44,5,49,5,2014-10-22 02:25:05,2014-10-22 01:49:03
e811a2411827ad2da3821b6357c920bc903c3b82...930c422f22182710e84cc1d9cb575c6a759c1074,6,25,17,42,14,2014-10-22 02:28:16,2014-10-22 02:28:16
a096c3f6f66c3ce5d0517ef712479a9db22e6beb...f26dde085fc00752cf60fab9f4b48967bac08b82,2,3,3,6,3,2014-10-21 03:16:09,2014-10-21 03:16:09
a096c3f6f66c3ce5d0517ef712479a9db22e6beb...15236f517fae038526ad9d906ab2055c32e101e9,1,1,0,1,1,2014-10-21 00:35:36,2014-10-21 00:35:36
33afb8a37bda2fc9131bf8b853b6b185c22ee483...6fa74953333dab483e1e8452c3d256e04ed3436b,2,2,2,4,2,2014-10-02 17:44:20,2014-10-02 17:44:20
bf4a331f1a6817b477bd5a931bb3b0671997f9de...ff5f9db68ec7c7f89dd353e9d73b9fc1abc15ac7,1,0,1,1,1,2014-11-10 19:02:06,2014-11-10 19:02:06
3a988c358810e8e4a07dcd9de49b858f9cd1a570...0d851e8b8a39eb7f79a202ad20182676805e742d,1,12,0,12,1,2014-11-05 17:36:53,2014-11-04 22:46:44
3a988c358810e8e4a07dcd9de49b858f9cd1a570...da3870feacc64c337f4b298a79cb115d9fbb4194,1,1,0,1,1,2014-11-04 23:09:56,2014-11-04 23:09:56
df28b7e25f2c4008ad3a8179ccf7e556fcb13400...46d1bf8eefa5ca00357d7dd8f901ffb5c48c7be2,9,59,133,192,12,2014-11-09 23:03:33,2014-11-09 23:03:33
46d1bf8eefa5ca00357d7dd8f901ffb5c48c7be2...5670dd8930228af772157b933fe672ca5c5313ca,1,4,5,9,2,2014-11-09 23:04:32,2014-11-09 23:04:32
df28b7e25f2c4008ad3a8179ccf7e556fcb13400...a05f07528a7081ad3ce520831ba851a81b903d8e,2,7,9,16,3,2014-11-08 10:00:37,2014-11-08 10:00:37
b02d3c7effdaa4ca8ecf79b3cf6cc71d6efcc533...c2a86c55e681977b4c9f513e891a6fa63e679545,1,1,1,2,1,2014-04-20 19:45:21,2014-04-20 19:45:21
f09d6b7a9827452d259b4daafbe3f8341b557776...03b556bbc5c0aecc2d86edfcf143d7b3312c86cc,1,6,6,12,2,2014-06-11 06:33:30,2014-06-11 06:33:30
573ad10a9dba52e4a6f059e63b667f4034ad2b39...e9f0bed44da96e088e2e990bc29bcf05bcd3a87b,1,2,2,4,2,2014-04-19 01:53:05,2014-04-19 01:53:05
573ad10a9dba52e4a6f059e63b667f4034ad2b39...042f9e6e9a8c27d5e7cf02b96cee991a524a0612,1,4,0,4,1,2014-04-18 02:35:55,2014-04-18 02:35:55
ad1e1eb02682c04dec340af0a79a14c233dc2c7b...96e2f9332b7d2e6426e0a02dd5bc4ba34941f952,1,1,1,2,1,2014-04-20 00:38:00,2014-04-20 00:37:39
96e2f9332b7d2e6426e0a02dd5bc4ba34941f952...a6214273b9f9a7d4858e55ac2c5379f71ab71314,1,1,1,2,1,2014-04-20 00:42:06,2014-04-20 00:42:06
a6214273b9f9a7d4858e55ac2c5379f71ab71314...0aaf2cdd3a715b08bd41197b361ecd2af99cba0b,2,3,3,6,3,2014-04-20 00:45:58,2014-04-20 00:45:56
f9b88cbe9edbf3ab824ce2a3912a2943c3717e6d...348e7a011a624bc48983be337c9f5fd723318aaf,1,1,1,2,1,2014-05-03 23:43:02,2014-05-03 23:43:02
b882a63ff710ec09904734cfb4658193d4210889...21feb7c58ea86a7b988caca17a4d8d38dcee5214,1,1,1,2,1,2014-04-23 21:08:25,2014-04-23 21:08:25
9444df247698f65df05e345f525c14fbf14aead6...06fae12023293ea495c7c0e5f21dc9fa8cc86b44,2,9,9,18,2,2014-05-06 09:43:41,2014-05-02 06:17:46
06fae12023293ea495c7c0e5f21dc9fa8cc86b44...d36c150569c982a24935bfc90e77e7a59986497b,1,1,1,2,1,2014-05-06 18:34:46,2014-05-06 18:34:46
9f80cab0969b9bcb80a556107d16c2a418a6e7ab...b2173572527ece62c0e0055ebbc87e986ab1f844,11,96,66,162,50,2014-05-01 02:35:47,2014-05-01 02:35:47
e0d1e406d361ac0ed8b9df60f52e14d39fceb084...485b7d09409fec261f8f15cf018c9166fbd0d4d2,4,9,15,24,4,2014-04-25 17:04:07,2014-04-25 17:04:07
bde5f1fe9f837cce036821be5aaf6c40e19a8097...dd0b0cd664c800e0a1c6a4848716aa85d8eec66f,1,5,5,10,3,2014-04-30 00:08:24,2014-04-29 23:57:41
bde5f1fe9f837cce036821be5aaf6c40e19a8097...7026c9626aa16a9b9e225f49e9ca95fddd49f829,1,3,3,6,2,2014-04-29 19:52:35,2014-04-29 19:52:35
7026c9626aa16a9b9e225f49e9ca95fddd49f829...463e02511bcf584769052b6fc47c8d9af8901291,1,5,5,10,4,2014-05-01 19:26:42,2014-05-01 19:26:42
d66a15154efbe3ee239846f93c60189bac5808e3...3564369fdf7ed23c04774d0e023d3efeb060fa71,1,1,1,2,1,2014-04-27 19:40:25,2014-04-27 19:40:25
7d75734e10853806d3ef8022181c7b8e81e88014...b058c018eba059811f0c26074b813b843cfb5cb7,2,57,3,60,3,2014-05-19 09:14:14,2014-05-19 08:25:52
7d75734e10853806d3ef8022181c7b8e81e88014...e9b99d475cdc635d6e1435b5101500b84e0ef615,1,1,1,2,1,2014-05-19 07:47:06,2014-05-19 07:47:06
676fda9c8f59aa9c05f0579209d8018aceb1ac50...585f4787f7080e738e8172a56901c2f347a54a30,3,18,0,18,3,2014-05-24 13:33:15,2014-05-24 13:33:15
676fda9c8f59aa9c05f0579209d8018aceb1ac50...8be8fb61bb27ff33d0e6e18da6adc8bf447d1384,1,1,1,2,1,2014-05-23 19:29:24,2014-05-23 19:29:24
8be8fb61bb27ff33d0e6e18da6adc8bf447d1384...02ca217278ea67a130133ff79b6ca2a989bdabcf,1,1,1,2,1,2014-05-23 19:48:38,2014-05-23 19:43:08
3dd1531d81c90d6d1cf04962032f868d315ab21c...1340a491e545b60eaa4d367caa6fc043b1eedc30,10,16,14,30,14,2014-05-22 06:37:06,2014-05-22 06:37:06
1340a491e545b60eaa4d367caa6fc043b1eedc30...cae7dee2361c7023bd147570509a0c40ade3c4e9,21,21,21,42,21,2014-05-22 07:55:28,2014-05-22 07:55:28
3dd1531d81c90d6d1cf04962032f868d315ab21c...3261ab704e0608740919eeedcac866b0b470887c,1,4,2,6,2,2014-05-21 23:50:23,2014-05-21 23:44:09
3dd1531d81c90d6d1cf04962032f868d315ab21c...7da34cc0ec493355e8f6123875261e508d826d83,3,4,2,6,4,2014-05-21 21:24:43,2014-05-21 21:24:43
d1872b4c98f26b1bfcd7e007133b97e6602dd0d0...5dbfdd47c57a10cc8e97e74635a4197d31c24f7c,6,8,6,14,6,2014-06-08 21:08:06,2014-06-08 21:08:06
c0ba4622c1f55b6b1994efc9d24401a782644ba5...094e42883acae475c0a863de1231cd965744eae1,1,1,1,2,1,2014-06-04 19:06:03,2014-06-04 19:06:03
094e42883acae475c0a863de1231cd965744eae1...34621740b35df5d40d25ac32316b43940b8f39c2,1,1,1,2,1,2014-06-04 19:06:47,2014-06-04 19:06:47
34621740b35df5d40d25ac32316b43940b8f39c2...19987cc28593b7372c484b681d02d44488e26a74,1,1,1,2,1,2014-06-04 19:21:42,2014-06-04 19:15:32
aee18bcc4aab7d8e16e7ec7a89051622919bb616...85cde774b9c8a6970d9e29fc0458c53d09b628a1,9,9,9,18,11,2014-06-08 23:54:05,2014-06-08 23:54:05
85cde774b9c8a6970d9e29fc0458c53d09b628a1...8d9ef8f0a14c7bf95a3d7aa2eb7d15e42a2c9f38,8,9,11,20,11,2014-06-09 06:02:16,2014-06-09 06:02:16
8d9ef8f0a14c7bf95a3d7aa2eb7d15e42a2c9f38...1309085d57ca75ac123007e11f4bd9b819220fe0,2,3,4,7,3,2014-06-09 06:09:06,2014-06-09 06:09:06
1309085d57ca75ac123007e11f4bd9b819220fe0...91bed93d55390e96629a7164c9a1ea8070650117,1,20,7,27,6,2014-06-09 08:10:08,2014-05-28 05:08:32
91bed93d55390e96629a7164c9a1ea8070650117...8cdc34f6e3e732a1397c381b01b6df7a2d485ed4,1,28,29,57,15,2014-06-09 08:10:08,2014-05-28 17:48:51
8cdc34f6e3e732a1397c381b01b6df7a2d485ed4...41b92b967a2c0c0ba9722c1e34d72ebc0a895a15,2,6,6,12,4,2014-06-09 08:10:09,2014-05-28 17:50:11
41b92b967a2c0c0ba9722c1e34d72ebc0a895a15...48e2f92aab310d34e6777406198f539279249ec0,1,0,0,0,0,2014-06-09 08:13:24,2014-06-09 08:13:24
4aca4cf8661ab6e17ffd58820679a081db80ceaa...c6c809308546bd52d10378db61c151b46ce44e92,1,2,2,4,1,2014-06-10 14:46:04,2014-06-10 14:46:04
e4f33a91d9969edbddc369230965b3a5628f24ac...d1f69d4a7e23abbe8cdbc6ff7e642c0f8d51e624,1,2,2,4,2,2014-01-22 21:37:05,2014-01-22 21:37:05
cd78b431856d451d5d21df0920685da05e1baa56...c658e4e926cc313de6cbadb8034d58ba0b79ed21,1,1,1,2,1,2014-01-21 08:55:56,2014-01-21 08:55:56
937e067a27506cea4ffd58c71afafbcf6eae92dd...6f1236f81a110b4cc4e6e94ddc80146b79b7c9b7,1,100,0,100,1,2014-01-20 02:48:35,2014-01-20 02:28:31
b36a744fa74ace319b9f924f777df50591ceb62c...ed07a4d0ce0e769ef6efbd8d465670b26a0a5e37,3,4,4,8,4,2012-02-12 19:06:50,2012-02-12 19:06:50
b36a744fa74ace319b9f924f777df50591ceb62c...451a642ae813f0b3a3f61af69eaeca927547b755,2,14,2,16,4,2012-02-09 22:08:14,2012-02-09 22:08:14
451a642ae813f0b3a3f61af69eaeca927547b755...d9eff8efc1ee426f3622ab131d8b6726d471040d,1,2,1,3,1,2012-02-09 23:31:40,2012-02-09 23:31:40
b36a744fa74ace319b9f924f777df50591ceb62c...4c7b9b8fcedc1dfedf24858e821c3add487ffc68,1,1,0,1,1,2012-02-09 21:28:12,2012-02-09 21:28:12
b36a744fa74ace319b9f924f777df50591ceb62c...920d9958431b3d0a08401bfbc097416bc83211bd,1,6,5,11,2,2012-02-09 20:27:42,2012-02-09 20:27:42
b36a744fa74ace319b9f924f777df50591ceb62c...2e5a81601cfde62dca8a05125e2640787c8b7424,1,1,1,2,1,2012-02-08 15:11:51,2012-02-08 15:11:51
855dcd3f561df551b8739e4fc4d0b710b7f77ab8...efac5441d83079653dabcdd4879102ec8ccb72be,2,1,1,2,1,2012-02-11 08:11:34,2012-02-11 08:11:34
efac5441d83079653dabcdd4879102ec8ccb72be...60ee76853726f9711a41a865169d66cf136e5f71,3,2,2,4,2,2012-02-11 08:16:13,2012-02-11 08:16:13
60ee76853726f9711a41a865169d66cf136e5f71...8f1db4321a35851d5b726290b2d99e7ea1ec7239,5,23,2,25,4,2012-02-11 08:24:06,2012-02-11 08:24:06
8f1db4321a35851d5b726290b2d99e7ea1ec7239...2679c3ebe3bb21599826dd204b1c9df44d217497,3,6,6,12,6,2012-02-11 18:13:53,2012-02-11 18:13:53
2679c3ebe3bb21599826dd204b1c9df44d217497...102bb8e68439d28334c2c9f6e4579fdd9950c102,3,34,2,36,4,2012-02-11 18:38:41,2012-02-11 18:38:41
102bb8e68439d28334c2c9f6e4579fdd9950c102...4ddc8fd0e41a4bf76249645674806a7f11e64879,3,0,2,2,2,2012-02-12 00:43:53,2012-02-12 00:43:53
4ddc8fd0e41a4bf76249645674806a7f11e64879...5a3dfb72bfcf1859690c76a8ddb8457eb962bdb3,3,10,0,10,2,2012-02-12 00:50:57,2012-02-12 00:50:57
5a3dfb72bfcf1859690c76a8ddb8457eb962bdb3...a497e9010a5fcf4fce7e7112a0d3f32da57e8adb,4,20,16,36,9,2012-02-12 01:12:32,2012-02-12 01:12:32
0ed6d3b28ea6fa86a9a1d6fe9de2df29ae1dddaa...8609a77bd2f2b18a88efea5b31d6b6f90036e702,2,8,0,8,1,2012-02-22 19:16:32,2012-02-22 19:16:32
7ec09d0db9b1117d708682a08efaa55045e6926e...3d58b4622671bc51c22c857641db3b988e73632a,4,30,3,33,4,2012-02-19 07:29:58,2012-02-19 07:29:58
7ec09d0db9b1117d708682a08efaa55045e6926e...2068b74ea8b311aa984920bd115ca37963de56d1,1,1,0,1,1,2012-02-18 12:08:49,2012-02-18 12:08:49
7ec09d0db9b1117d708682a08efaa55045e6926e...7fa1578c497b4224f6eb84383fa76d6a3b2dd4f1,3,8,2,10,4,2012-02-17 22:39:30,2012-02-17 22:39:30
7fa1578c497b4224f6eb84383fa76d6a3b2dd4f1...5d02b8c3c639580825c15d1f7b2210fbb0c3e675,3,2,2,4,2,2012-02-17 22:41:41,2012-02-17 22:41:41
5d02b8c3c639580825c15d1f7b2210fbb0c3e675...e7d45184f1331bf4e82f7391d9607c4078b94278,3,2,2,4,2,2012-02-18 04:25:49,2012-02-18 04:25:49
e7d45184f1331bf4e82f7391d9607c4078b94278...b559f2b8d05f4f5425e5ba6ec32e00fa99dd3b25,3,6,6,12,6,2012-02-18 04:40:56,2012-02-18 04:40:56
b559f2b8d05f4f5425e5ba6ec32e00fa99dd3b25...1455bc9f8f288c112da4241d4dbb7549bcd81cd5,3,0,2,2,2,2012-02-18 04:47:02,2012-02-18 04:47:02
1455bc9f8f288c112da4241d4dbb7549bcd81cd5...ec05ebc5ed2c2ecf76f0ff7ae38056a0cc72f375,3,6,0,6,2,2012-02-18 04:53:12,2012-02-18 04:53:12
ec05ebc5ed2c2ecf76f0ff7ae38056a0cc72f375...b776cae902cf4cd6c0d7227214b8a835be8df750,4,6,6,12,5,2012-02-18 05:18:08,2012-02-18 05:18:08
d7953a8f1e491d6ec5e479e26d15ae3b545fbb5f...5b4a29d84e6290a93db98da34b89776a9740e455,3,2,2,4,2,2012-02-12 19:15:12,2012-02-12 19:15:12
391248c0e3ba9b00b0b4a02e4d94475e9ae9877a...8f09028cff87b68467fb20e295c9dc96ea4a5de0,3,9,0,9,3,2012-01-13 17:55:15,2012-01-13 17:55:15
391248c0e3ba9b00b0b4a02e4d94475e9ae9877a...11be9cd16370ecd15d227917d98ff63eccae68ae,7,42,42,84,14,2012-01-13 07:57:21,2012-01-13 07:57:21
8c1a908754cac2d5760d433318f81471ad164330...dd4140319ab4380dd21f5e90e65ef855c54c3420,4,74,31,105,20,2012-01-18 07:52:49,2012-01-18 07:52:49
dd4140319ab4380dd21f5e90e65ef855c54c3420...a920fa2993fa91f3ad62e154eaa6ff7b2481f615,1,44,54,98,8,2012-01-18 08:12:58,2012-01-18 08:12:58
a920fa2993fa91f3ad62e154eaa6ff7b2481f615...f2fadf1f0a3f444893fec394fd0180d03e1058a3,5,268,266,534,15,2012-01-18 08:24:10,2012-01-18 08:24:10
593b062c7a9781272b983a1a2e1af0824d79e1c4...4d098a7f8e2a39e7eb9baf36087e0c9856205413,1,1,1,2,1,2012-01-18 06:37:24,2012-01-18 06:37:24
c695d4315ab47a73a8fff4020b7d0b047591a46e...af5a2197183754629a8ff09c23b043c3c9711a1f,1,1,1,2,1,2014-03-05 22:17:20,2014-03-05 22:17:20
c16b43d9744caf7d37ecea7616044c00c7ce07ce...8526adf69c303e67d9bf8a63622b4144fc9b5cd1,9,14,14,28,13,2014-03-07 04:33:10,2014-03-07 04:33:10
8526adf69c303e67d9bf8a63622b4144fc9b5cd1...17e41098c89a6c74273dee81dbf6c260d19ff412,10,7,10,17,10,2014-03-07 04:39:19,2014-03-07 04:39:19
106af458313a0abc1aa4ac778c358c5e6a1bc974...cd65e512a21767861c57294dc720d7836a104d39,2,7,7,14,7,2014-03-02 07:27:01,2014-03-02 07:27:01
b3e3025f8f05ad9fd43dab6dbef6bc30cfdab22b...dfb49174935da795e99550df60b486494b9b25a9,1,5,5,10,2,2014-03-01 18:14:49,2014-02-28 07:39:28
dfb49174935da795e99550df60b486494b9b25a9...256baf802692b0a0e961f5b174e033e77fee837d,1,1,1,2,1,2014-03-01 18:58:26,2014-03-01 18:14:31
256baf802692b0a0e961f5b174e033e77fee837d...e5affbfa0af2f6079a4ffcc7b476a261e4b2a404,9,14,14,28,11,2014-03-01 18:58:53,2014-03-01 18:58:31
df3eb66ede02646c3ddc15b796d189f5effc60bb...7e299c6a49bced5d2c2581a5504ddf7dbcaf041f,10,7,10,17,10,2014-03-07 06:32:21,2014-03-07 06:32:21
22baa8153b58e80df248b38ddf2aeae4f3f9cc2b...5429e71401a671450f0b81d5fc9b53a7baec477a,8,19,5,24,8,2014-10-29 17:27:18,2014-10-29 17:27:18
5429e71401a671450f0b81d5fc9b53a7baec477a...5a83be362ac5028191aff53f59bba02e8364d23b,1,48,2,50,6,2014-10-29 17:44:14,2014-10-29 17:31:20
5a83be362ac5028191aff53f59bba02e8364d23b...15d668dd1528a629e3989bddab85d6339433f6a0,1,1,1,2,1,2014-10-29 18:13:25,2014-10-29 18:13:25
34c2f46c8b819eb765224ac4f161071489a53ccb...e07d741088600bcbf0f9a3ec7d02f8db02ab6f4e,1,1,1,2,1,2014-10-29 16:54:43,2014-10-29 16:54:43
e07d741088600bcbf0f9a3ec7d02f8db02ab6f4e...aa85e762eaff089c216f5bce79e7423989eec2f8,1,9,9,18,2,2014-10-29 17:02:51,2014-10-29 17:02:51
b2385016ecfc0cbd2059a595c66726236a7bc91f...fb70b13dc30dc94c610ae8bc3f98f07336694362,1,2,0,2,1,2014-10-22 15:56:12,2014-10-22 15:56:12
3c98dd35bafd4788d42eb3b083ef8d2defcdcf66...b421dc9490239809905d4c544bba4c48af096e22,1,12,4,16,4,2014-10-23 01:38:18,2014-10-23 01:38:11
3c98dd35bafd4788d42eb3b083ef8d2defcdcf66...8d806b0ae5f618065a466cdfc9853020fb72cd9d,1,1,0,1,1,2014-10-23 01:05:42,2014-10-23 01:03:31
3c98dd35bafd4788d42eb3b083ef8d2defcdcf66...58143b128b1250e9a99b4ea41cd6fa3f58a0b673,1,8,8,16,8,2014-10-23 00:53:59,2014-10-23 00:53:46
fc0eee7d47487af67b5fb2800c7e1a287b5c568d...908190a6c5b9c5efef357bc51b2035c5a9d50c1a,1,2,2,4,2,2014-10-22 10:49:24,2014-10-22 10:45:18
64a74e93547da1784240e1172fcaf4cff4385e4b...e5fc22ccfa39b792ff6702cb496079c77bf7162f,1,4,4,8,3,2014-10-03 04:11:17,2014-10-03 03:43:03
64a74e93547da1784240e1172fcaf4cff4385e4b...2aedd274f2ab8acb7e1239671747f1b4a79c736d,1,1,1,2,1,2014-10-03 03:09:23,2014-10-03 03:09:23
eaf3b53e44e1e1015f87181d27d651a2b1ea0a0d...c513f58c6a2e345da338aebe45ee422b07260017,1,1,1,2,1,2014-11-10 21:14:33,2014-11-10 21:14:33
0018723ccee06d704e31b83df6a0a3fd1f02d309...6020bb06f242450b34a55e6098e9549f33fcc226,14,84,26,110,37,2014-11-04 23:36:52,2014-11-04 23:36:52
6020bb06f242450b34a55e6098e9549f33fcc226...425a985491b5c8f72bfcf483f5449f52b8d21af0,11,126,13,139,26,2014-11-05 00:18:11,2014-11-05 00:18:11
99148166c5cb4017227c649849c8fe51bb8d7473...d1278efcc5a6b45467caca15206bb1a83ae99fc5,8,20,20,40,12,2014-11-10 02:04:00,2014-11-10 02:04:00
58ab1c64c5989bf6755c0b224b0d1813656d0e76...a69bc3bc095de588ae78b663f73395134ad6ee00,1,7,3,10,5,2014-04-20 21:47:32,2013-12-20 17:37:47
816ba56b451d28056a78bcaf262e7a2cc37fd5db...7a0f4416a5436a892ed4328cd42e1d708f0ba715,1,1,0,1,1,2014-06-11 15:39:02,2014-06-11 15:39:02
0aaf2cdd3a715b08bd41197b361ecd2af99cba0b...a54e6d4ea96b4391cc3e597a6e9c0693c0d4d1fd,2,1,1,2,1,2014-04-20 01:25:40,2014-04-20 01:25:40
bae289d1fe59d1c403b1a4fceaea6379f6008a2a...c4a3848d57b3d9760a8057ace2fec3eb1d2362a8,1,1,1,2,1,2014-05-04 06:02:48,2014-05-04 06:02:48
bae289d1fe59d1c403b1a4fceaea6379f6008a2a...588889cdc5908279c59ca418da3ad4f4e8dd235a,1,2,2,4,2,2014-05-04 05:56:45,2014-05-04 05:56:45
588889cdc5908279c59ca418da3ad4f4e8dd235a...fcbdbee9955ddcce76452b59aaee76b03005c507,1,3,3,6,3,2014-05-04 06:40:18,2014-05-04 06:40:18
bae289d1fe59d1c403b1a4fceaea6379f6008a2a...949b81f51171550bcec0d92e771793999e69a389,4,13,13,26,13,2014-05-04 02:53:34,2014-05-04 02:38:09
cbb645323d6af70534faef50843fcb3902af66de...d42b1a2d2d0911de918bcd7ec37c7bd3568a18f3,1,3,3,6,3,2014-04-25 17:43:59,2014-04-25 17:43:30
d36c150569c982a24935bfc90e77e7a59986497b...150ca95b19ddbac917be861ceeddfbe87d3e82d3,2,2,2,4,2,2014-05-07 20:28:02,2014-05-07 20:28:02
f9fde567be3c3ca7161351702f358b9db6ef7283...3c99de976497928fac0585bda2bf0961e3b162bf,11,15,15,30,15,2014-07-06 02:57:15,2014-07-06 02:57:15
3c99de976497928fac0585bda2bf0961e3b162bf...0378a6be2a5a42f408aeed24e20933039352ba74,7,7,7,14,7,2014-07-06 02:59:50,2014-07-06 02:59:50
0378a6be2a5a42f408aeed24e20933039352ba74...f22e7d857a4f7aa3f1def71e863b6ce761503928,7,4,17,21,7,2014-07-06 03:01:18,2014-07-06 03:01:18
f22e7d857a4f7aa3f1def71e863b6ce761503928...9677c95d83f361b7c3a43e56ef89590305c84905,7,4,15,19,7,2014-07-06 03:02:02,2014-07-06 03:02:02
656597e4dd3c738303c5d60abf0c2514a36924b4...7b2600cfc54ad8c42e3710f65e766d65cc6eb4d8,1,1,1,2,1,2014-05-23 19:53:12,2014-05-23 19:44:52
7b2600cfc54ad8c42e3710f65e766d65cc6eb4d8...c6cb8abdce19b2b9734f52dd3e79932230e03b4e,1,1,1,2,1,2014-05-23 19:55:08,2014-05-23 19:55:07
cae7dee2361c7023bd147570509a0c40ade3c4e9...fab9ab8fe9b51ebc88872482556df3f793e5ac4a,6,16,7,23,10,2014-05-23 01:42:21,2014-05-23 01:42:21
cae7dee2361c7023bd147570509a0c40ade3c4e9...ee12ce83057233d271f42162ef3dd2d42d315176,2,14,10,24,11,2014-05-22 22:13:41,2014-05-22 22:13:41
3ee5542c990817324f0a07b97d01d1fe206fd8d6...1e3b93804fa88d247d8708529fb44b28d73fd91f,11,48,36,84,26,2014-06-08 18:18:59,2014-06-08 18:18:59
707b362b801d7a430c1911493a65085e81b4ee8d...12b5d46f17a125021c5083fbc88b53a7fb86a096,5,19,20,39,12,2014-05-23 01:38:43,2014-05-23 01:38:43
5dbfdd47c57a10cc8e97e74635a4197d31c24f7c...9884a3d775b6d4f45d8a26c413f9bcd318f99564,1,0,0,0,0,2014-06-08 22:14:44,2014-03-25 07:22:03
9884a3d775b6d4f45d8a26c413f9bcd318f99564...79cbf5501e023118e3e59ccc68ae4843c71a6523,3,1,1,2,1,2014-06-08 22:14:44,2014-03-25 07:22:20
79cbf5501e023118e3e59ccc68ae4843c71a6523...29d00e0cd7285133c9260276acb0d99b02d6e3bc,21,20,20,40,19,2014-06-08 22:14:44,2014-03-25 07:30:04
29d00e0cd7285133c9260276acb0d99b02d6e3bc...d763b0fe5b5d83025b94212638b1bd5500c43c71,2,0,0,0,0,2014-06-08 22:15:08,2014-06-08 17:42:16
d763b0fe5b5d83025b94212638b1bd5500c43c71...e1f9c25f8d1d1c3730ca186057fe53f255f3e92d,1,0,0,0,0,2014-06-08 22:15:08,2014-06-08 22:11:11
6d7c0b2513d9e9a4c41fe0e522e93be5d3c82159...f0c97bf758a57148935516a9c94aebc3e891f4d9,1,1,1,2,1,2014-06-04 19:38:26,2014-06-04 19:38:26
f0c97bf758a57148935516a9c94aebc3e891f4d9...e91eaa2884aefd74291ba5897ec887f7530afa5f,1,1,1,2,1,2014-06-04 19:40:53,2014-06-04 19:40:51
48e2f92aab310d34e6777406198f539279249ec0...b35840e48d18c49fdb916e04516d29b534d64875,3,12,7,19,4,2014-06-10 04:00:27,2014-06-10 04:00:27
b35840e48d18c49fdb916e04516d29b534d64875...24a9b34adde1ae2cff9238853fb3207cfdb57209,1,1,1,2,1,2014-06-10 04:08:24,2014-06-10 04:08:24
24a9b34adde1ae2cff9238853fb3207cfdb57209...d2061e8aeb7517d08603fb40cb1a225ebb405576,1,1,1,2,1,2014-06-10 04:26:57,2014-06-10 04:26:57
48e2f92aab310d34e6777406198f539279249ec0...8b3d27e01c8181614eaa5489f2fc6c0086f71b97,1,1,1,2,1,2014-06-10 00:01:55,2014-06-10 00:00:39
e29a3b65cd61e5341447332a3b154a60c075dff9...3fdde76b742fd9721a651c37f429681cc09fdfe2,1,1,1,2,1,2013-12-25 12:32:00,2013-12-25 12:32:00
3fdde76b742fd9721a651c37f429681cc09fdfe2...9c97c5a729aff3f603e435f8c111866de830dcbe,1,2,2,4,1,2014-01-19 07:17:00,2014-01-19 07:17:00
9c97c5a729aff3f603e435f8c111866de830dcbe...7b24a3b99c74d9bcace9fcb18aee81356d484fcc,1,33,7,40,3,2014-01-23 03:15:17,2014-01-23 03:15:17
14baf4ef27e319990e66239b4a7639890f1cbe81...4a36ecaac64dea84be85b4876fc3c8d20d87f8e8,1,4,0,4,1,2014-01-20 22:36:52,2014-01-20 22:36:52
4a36ecaac64dea84be85b4876fc3c8d20d87f8e8...4552bcf66fcaa0a6b40888efd99769edd91aa3bf,1,8,3,11,1,2014-01-20 22:51:13,2014-01-20 22:51:13
4552bcf66fcaa0a6b40888efd99769edd91aa3bf...4ec861316f88f7af67453aea3d78e04c7462e62d,1,2,2,4,2,2014-01-20 23:00:52,2014-01-20 23:00:52
4ec861316f88f7af67453aea3d78e04c7462e62d...f4a916d35172e1f877dd88725052f6798d6a64ce,1,1,1,2,1,2014-01-20 23:02:48,2014-01-20 23:02:48
f4a916d35172e1f877dd88725052f6798d6a64ce...50000b593046f6609b6ae31140d448048aeebf0e,1,1,1,2,1,2014-01-20 23:05:25,2014-01-20 23:05:25
50000b593046f6609b6ae31140d448048aeebf0e...5cc3c62e307d5ec05ea2391b77f3ef111ec878c6,1,1,1,2,1,2014-01-21 00:53:31,2014-01-21 00:53:29
ebc4f998dccf0d709a143348c02777d9c4695abb...bc9335650c0825ddf5805ebcdb513f71540d9c82,1,1,0,1,1,2014-01-21 02:39:13,2014-01-21 02:39:13
c658e4e926cc313de6cbadb8034d58ba0b79ed21...ae579e950b4eb24b59c819be7f891a9d3554328c,1,1,1,2,1,2014-01-21 09:36:48,2014-01-21 09:36:48
b8493ed8b773b5e67966fec3837015e77dfed037...a57dbada0f17bc3dfd4a77de436a5e590fb0d1e3,6,45,12,57,9,2012-02-12 23:18:20,2012-02-12 23:18:20
a57dbada0f17bc3dfd4a77de436a5e590fb0d1e3...163c98ea7e321ce3a1b38128cfb2bec6cd76e6de,3,14,0,14,6,2012-02-12 23:43:04,2012-02-12 23:43:04
163c98ea7e321ce3a1b38128cfb2bec6cd76e6de...ac9ac4ddae7fc9f9c030d8ade789ec65d9a2ec05,3,6,2,8,2,2012-02-12 23:49:04,2012-02-12 23:49:04
ac9ac4ddae7fc9f9c030d8ade789ec65d9a2ec05...87ed82207ad10947c9f53b501b1fb40a1db7f56e,1,2,4,6,2,2012-02-13 00:04:02,2012-02-13 00:04:02
87ed82207ad10947c9f53b501b1fb40a1db7f56e...16f2e0e19e97b72d061b6c0041caad33cdd34067,1,1,1,2,1,2012-02-13 00:05:25,2012-02-13 00:05:25
16f2e0e19e97b72d061b6c0041caad33cdd34067...5fc62c5fcc93ab36a419c35e72674fbf632b09c3,6,256,76,332,59,2012-02-13 00:59:29,2012-02-13 00:59:29
5fc62c5fcc93ab36a419c35e72674fbf632b09c3...81d101a6a7195f8575296b19fbf4d36dd145a602,3,6,2,8,4,2012-02-13 03:50:36,2012-02-13 03:50:36
81d101a6a7195f8575296b19fbf4d36dd145a602...4d1f1f0fc7117b9edae1c1b1c0c2c899ffcd72e3,3,38,12,50,14,2012-02-13 04:07:25,2012-02-13 04:07:25
4d1f1f0fc7117b9edae1c1b1c0c2c899ffcd72e3...be6fdd9a62a41bf4316dbe4c139787a568ac5bb7,3,20,2,22,4,2012-02-13 04:10:48,2012-02-13 04:10:48
be6fdd9a62a41bf4316dbe4c139787a568ac5bb7...3e00c1261fa3d48b184874c9f5b94ce370bd6449,3,16,1,17,3,2012-02-13 04:28:22,2012-02-13 04:28:22
3e00c1261fa3d48b184874c9f5b94ce370bd6449...944c7298d345dd46142a8338c59777827bdbde0c,2,13,0,13,1,2012-02-13 04:46:39,2012-02-13 04:46:39
944c7298d345dd46142a8338c59777827bdbde0c...cbe10bd591412c5bff365c86451caacb7cedb4f8,3,8,0,8,2,2012-02-13 05:11:56,2012-02-13 05:11:56
cbe10bd591412c5bff365c86451caacb7cedb4f8...ce5976fb2901ec43c132fa7d517b9e2ca6041087,3,2,0,2,2,2012-02-13 06:49:06,2012-02-13 06:49:06
ce5976fb2901ec43c132fa7d517b9e2ca6041087...da948508447de169ab05c10a5f0a64bcb6a8aeb6,3,2,2,4,2,2012-02-13 06:50:21,2012-02-13 06:50:21
85d8fe884c62af4b9269f7d8f0b3d3c91a1244ee...c16ccf64f1f51bca4e4564d23211274e3d995e16,1,5,1,6,2,2012-02-12 01:25:30,2012-02-12 01:25:30
c16ccf64f1f51bca4e4564d23211274e3d995e16...a84092d2257ba8e000e2c656e6cb1b8415d0d9ac,3,12,4,16,6,2012-02-12 01:25:47,2012-02-12 01:25:47
a84092d2257ba8e000e2c656e6cb1b8415d0d9ac...5b22cf5cc3f06d4f63dfbd7579cfec32eb2c2c79,3,6,0,6,2,2012-02-12 01:27:08,2012-02-12 01:27:08
8609a77bd2f2b18a88efea5b31d6b6f90036e702...0e8427e7b1c955a70a24817f6c06abd6dfa0c572,5,13,11,24,16,2012-02-23 06:38:54,2012-02-23 06:38:54
8609a77bd2f2b18a88efea5b31d6b6f90036e702...80d03e143ce3041e9c3ec63db439ee7738679573,1,4,6,10,5,2012-02-22 19:19:55,2012-01-30 17:11:17
80d03e143ce3041e9c3ec63db439ee7738679573...70fecd111566eec3136457afb4143d0950c455b5,2,6,1,7,5,2012-02-22 19:19:55,2012-01-30 17:13:18
70fecd111566eec3136457afb4143d0950c455b5...3a6f58598cdad40916426f31564afada6c7b4bdc,1,1,0,1,1,2012-02-22 19:19:55,2012-01-31 14:23:58
3d58b4622671bc51c22c857641db3b988e73632a...3ff78d138a66eb3af4d4484adffabf4e4031806a,1,1,0,1,1,2012-03-09 13:52:50,2012-03-09 13:52:50
3d58b4622671bc51c22c857641db3b988e73632a...aa8e6b081c43651b2c54af4809d853acf58f62b4,1,1,2,3,2,2012-03-09 06:38:14,2012-03-09 06:38:14
3d58b4622671bc51c22c857641db3b988e73632a...1cc1852a9a7911641a30709a6447f3a1386c9919,1,8,8,16,8,2012-03-09 01:02:29,2012-03-09 01:02:29
3d58b4622671bc51c22c857641db3b988e73632a...d0120c94a0661342062ed2b1185923041bd3f621,1,1,1,2,1,2012-03-07 14:38:12,2012-03-07 14:38:12
3d58b4622671bc51c22c857641db3b988e73632a...3cbc40b12995ff1cfa2914e15582991466baa536,1,2,2,4,1,2012-03-05 04:38:20,2012-03-05 04:38:20
3d58b4622671bc51c22c857641db3b988e73632a...efd5e29ff46444e11cc1decc77fa53ed22a6b496,2,4,5,9,2,2012-03-04 20:49:55,2012-03-04 20:49:55
3d58b4622671bc51c22c857641db3b988e73632a...6a839fb2c3868f678be3771b02e6eafc2c91b124,1,1,1,2,1,2012-03-01 23:29:32,2012-03-01 23:29:32
6a839fb2c3868f678be3771b02e6eafc2c91b124...0112b56c9cb8e253acddc77290f3a432f881b594,1,1,1,2,1,2012-03-04 06:16:20,2012-03-04 06:16:20
3d58b4622671bc51c22c857641db3b988e73632a...ff8b997a1f6cfa76615bd23c99d184aa51f4e5e8,1,6,0,6,1,2012-02-28 23:39:35,2012-02-28 23:39:35
3d58b4622671bc51c22c857641db3b988e73632a...be9ae7006033f2be11f3547f30425417830158ba,2,4,4,8,4,2012-02-25 00:25:31,2012-02-25 00:25:31
3d58b4622671bc51c22c857641db3b988e73632a...591908eccf18c94e9394fcb71549cbae9c0864d8,3,12,12,24,3,2012-02-24 22:06:02,2012-02-24 22:06:02
3d58b4622671bc51c22c857641db3b988e73632a...1562a8a0108b7e1672fab4a9691a3ff36d873d8f,1,8,0,8,1,2012-02-24 10:37:26,2012-02-24 10:23:04
1562a8a0108b7e1672fab4a9691a3ff36d873d8f...15759d9e7c5284016f76c08065f407386ae7348a,1,1,0,1,1,2012-02-28 09:58:23,2012-02-28 09:57:24
3d58b4622671bc51c22c857641db3b988e73632a...e18a35784a57cba7554168ceb9b474e938c42f92,1,2,2,4,2,2012-02-20 21:16:49,2012-02-20 21:16:49
ba97f56912afca9903c31f54e4a0057fd0a30465...1948e985a355c519b8f3940af0ce83d9fd3c5f83,2,1,0,1,1,2012-02-19 04:09:34,2012-02-19 04:09:34
b776cae902cf4cd6c0d7227214b8a835be8df750...1a1816b5bd2cc0a92902fafa6ef9898911b4bdb6,3,2,2,4,2,2012-02-18 23:17:25,2012-02-18 23:17:25
b776cae902cf4cd6c0d7227214b8a835be8df750...c900d72857e5c3865abe9502ad7d255e84f1af0e,1,2,2,4,2,2012-02-18 13:28:44,2012-02-18 13:28:44
b776cae902cf4cd6c0d7227214b8a835be8df750...f5bd4b3c8f590472c1dd38fcbc573032e1c80c39,1,1,1,2,1,2012-02-18 08:40:18,2012-02-17 17:23:52
f5bd4b3c8f590472c1dd38fcbc573032e1c80c39...7609fd4dc62dfdc83c08fe32cbcd2b8e5cac5500,1,2,2,4,2,2012-02-18 08:40:28,2012-02-17 17:24:17
de6f3d4a6f3c2c55394e59e0a25ea85731166cfe...86b6ea4b5f2919c6dd962301b94af4e4096dbb16,1,1,1,2,1,2012-02-12 21:33:23,2012-02-12 21:33:23
86b6ea4b5f2919c6dd962301b94af4e4096dbb16...a9e469e75aba9edb6e4b0eb29f0a51dbef3167b7,5,4,1,5,4,2012-02-12 22:01:58,2012-02-12 22:01:58
a9e469e75aba9edb6e4b0eb29f0a51dbef3167b7...0ff88f2db3b9fa4604886494a711d74652a2fb4f,5,36,22,58,10,2012-02-12 22:10:07,2012-02-12 22:09:13
0ff88f2db3b9fa4604886494a711d74652a2fb4f...1b32e982ade1fc5275a851b711b45f6a0ed21b0c,3,74,0,74,4,2012-02-12 22:47:09,2012-02-12 22:47:09
5b4a29d84e6290a93db98da34b89776a9740e455...6e77c9d1233c1621deeaa2dd00e6eca3fd618610,25,26,26,52,24,2012-02-14 02:41:02,2012-02-14 02:41:02
f2fadf1f0a3f444893fec394fd0180d03e1058a3...87113396dfbf7bfcb41c52702c6d8c861ab215c9,4,5,5,10,5,2012-01-18 13:02:18,2012-01-18 13:02:18
f2fadf1f0a3f444893fec394fd0180d03e1058a3...d12560c0ee77e69011012095b04332aeb97b9c42,3,8,6,14,4,2012-01-18 08:30:49,2012-01-18 08:30:49
d12560c0ee77e69011012095b04332aeb97b9c42...ab8f2e2767be77120fedb07269dc7db078101dba,3,6,11,17,5,2012-01-18 08:35:14,2012-01-18 08:35:14
af5a2197183754629a8ff09c23b043c3c9711a1f...56a5d93b821b547924858628eb7c2fc7518879ce,4,4,31,35,6,2014-03-06 20:31:28,2014-03-06 19:37:32
56a5d93b821b547924858628eb7c2fc7518879ce...c0447026f13950cdfee59f89b36ae9045d767be6,1,0,1,1,1,2014-03-06 20:36:45,2014-03-06 20:36:45
af5a2197183754629a8ff09c23b043c3c9711a1f...297303a7cc73188d127cc7ac2f116e5c02feab1d,2,5,5,10,5,2014-03-06 19:12:17,2014-03-06 19:12:17
17e41098c89a6c74273dee81dbf6c260d19ff412...9dc796155cdc23040bb018f145634ad8deea5326,9,9,9,18,9,2014-03-07 05:25:34,2014-03-07 05:25:34
17e41098c89a6c74273dee81dbf6c260d19ff412...4868096dbdfbf9f82e08cf2906fd2ce19f8f1560,5,5,5,10,5,2014-03-07 05:05:29,2014-03-07 04:59:19
7e299c6a49bced5d2c2581a5504ddf7dbcaf041f...29d2de869e5118ee78e8d12a2c7e03933c116d64,1,3,0,3,1,2014-03-07 06:44:43,2014-03-07 06:42:48
29d2de869e5118ee78e8d12a2c7e03933c116d64...589f872d7408c0b02d636a2fc5696b46a3cb51c3,1,2,3,5,3,2014-03-07 06:45:16,2014-03-07 06:45:16
589f872d7408c0b02d636a2fc5696b46a3cb51c3...73ad81d89ca346e2eb147824bea8fdcfd90220e1,3,4,2,6,3,2014-03-07 06:47:23,2014-03-07 06:46:15
16dbdbd7a2c6cfa3be4e5dcc52249e577c02c84a...850a9a0250b6693293ce20195b4fe8ce3964e392,1,6,0,6,1,2014-10-29 23:11:42,2014-10-29 23:11:12
c672ed3fb0c15b4a3be4b707f206bda48f663bee...ff386147ce341a15f02b31f638500487246e34da,11,10,18,28,11,2014-11-12 04:25:09,2014-11-12 04:25:09
57e4b587828e79962dabe97e9e8ce3c231d7a820...1604af041b238c90d52f851c7601204e25fca2be,3,31,6,37,5,2014-10-23 03:57:15,2014-10-22 18:52:15
57e4b587828e79962dabe97e9e8ce3c231d7a820...e0cea19cbc8a22d6d576a773028cf89519e40901,6,34,18,52,14,2014-10-23 03:23:29,2014-10-23 03:23:29
908190a6c5b9c5efef357bc51b2035c5a9d50c1a...40ce5670e7a07a67f0ca5e4c236886c79104843b,1,3,3,6,1,2014-10-22 11:17:48,2014-07-25 05:40:27
40ce5670e7a07a67f0ca5e4c236886c79104843b...961ed36f01b1af749b58ffbf710867c96a10e4dc,1,7,653,660,3,2014-10-22 11:18:13,2014-08-19 09:01:02
961ed36f01b1af749b58ffbf710867c96a10e4dc...27478b966becf348fdc63263ba1f538e0cf93d9d,3,15,13,28,6,2014-10-22 11:18:18,2014-08-26 10:17:40
99919c036496d72030a965953f0e2d2d760d638c...bb89657bcb53a60d579d8fd9bbea56dde05dad8c,24,322,252,574,172,2014-11-11 06:46:14,2014-10-30 16:45:33
425a985491b5c8f72bfcf483f5449f52b8d21af0...da74fba490673cd4b60e9485b4f0a7aea225d7cc,1,33,8,41,12,2014-11-05 00:37:44,2014-10-30 10:25:28
425a985491b5c8f72bfcf483f5449f52b8d21af0...469dc3ab1fb991027d073cd3ffe6907361b1f058,2,43,0,43,2,2014-11-05 00:23:44,2014-11-04 02:35:35
d1278efcc5a6b45467caca15206bb1a83ae99fc5...eb74a8cbf363699eb822057650ddff2f36765ec9,17,162,162,324,96,2014-11-10 07:11:28,2014-11-10 07:11:28
d1278efcc5a6b45467caca15206bb1a83ae99fc5...1764c6e5090a687f3a3f3fc4a8ee595eea22a03f,2,2,2,4,2,2014-11-10 06:06:45,2014-11-10 06:06:37
a69bc3bc095de588ae78b663f73395134ad6ee00...448086f95a9114fb9ad96b76c5fc7b12a6fc51fd,24,86,14,100,24,2014-04-20 23:09:49,2014-04-20 23:09:47
e042c6398a21cc6d829307f7a6938af731712ae6...85935f75cce984b204b86067186867a58d566ef0,1,6,0,6,1,2014-06-11 16:27:07,2014-06-11 16:27:07
85935f75cce984b204b86067186867a58d566ef0...4949d26a1d3dc4b9899a6257b9bcd3be075539b0,1,1,1,2,1,2014-06-11 18:48:43,2014-06-11 18:48:43
efcd9604fa12047654c3c946a0bb0c92bafd17e5...170ba560c242a38293b46ac3871549a262b58e64,1,1,1,2,1,2014-04-20 01:53:23,2014-04-20 01:53:23
ce2cad6366d167c1fa17869478053dd490a94bd1...d6104b11511a69fb48d1e438141f135a14c04122,2,4,0,4,2,2014-05-04 09:09:34,2014-05-04 09:09:03
d6104b11511a69fb48d1e438141f135a14c04122...04028cf6feb62471a3788cd15804e62b9ce890d7,1,2,0,2,1,2014-05-04 09:20:07,2014-05-04 09:20:07
d42b1a2d2d0911de918bcd7ec37c7bd3568a18f3...f793853609ad0d292ba6291a8c87c66fd659a560,2,19,0,19,3,2014-05-01 03:15:46,2014-04-25 18:39:42
d42b1a2d2d0911de918bcd7ec37c7bd3568a18f3...31f01c1abbe9a5c5aa3dc94da424ff99d60c45a7,1,4,0,4,1,2014-04-25 19:02:16,2014-04-25 19:02:16
b5205bf84897e8e18dd4408e25a7d2aa95eca675...d55462fae830bbd93a42aba7144c2083b7ca3114,2,12,8,20,8,2014-07-06 03:10:44,2014-07-06 03:10:44
3b99a41246cb25b1fba79d14007ed0238409e63f...91103e6d1f750bc53dce7b4720cf78a50e1baa54,12,871,1,872,12,2014-06-08 02:11:44,2014-06-08 02:11:44
3b99a41246cb25b1fba79d14007ed0238409e63f...20c099d41a0802a7f377e7f996c35cade9e0c431,1,27,0,27,1,2014-06-08 00:54:10,2014-06-06 21:49:59
20c099d41a0802a7f377e7f996c35cade9e0c431...b23ed1b034caa90a4f6d0f97674022c80126d078,1,12,4,16,8,2014-06-08 00:54:11,2014-06-06 22:30:44
b23ed1b034caa90a4f6d0f97674022c80126d078...21de05c8c09b0ff9c11651596a84442b312381bb,1,3,2,5,1,2014-06-08 00:54:11,2014-06-06 22:34:56
fab9ab8fe9b51ebc88872482556df3f793e5ac4a...ef360b61b5eb79982e85d8c8380de69ef16395a6,1,1,1,2,1,2014-05-23 03:14:32,2014-05-23 03:14:32
1e3b93804fa88d247d8708529fb44b28d73fd91f...d1cf27bd0336b0dcec3fd40314e405e2a5bc0a66,2,8,13,21,5,2014-06-08 20:28:45,2014-06-08 20:28:45
f9495eab12558534f99458a9123d2bdd483c844c...53b8254fe01ebcd1b0b1f163e65cc231cb2a772a,1,3,0,3,1,2014-06-05 11:24:56,2014-06-05 11:24:56
f9495eab12558534f99458a9123d2bdd483c844c...ea99e3c91b0470a14a8c00c767f6dc627a2d274f,1,1,1,2,1,2014-06-05 11:07:40,2014-06-05 11:07:40
f9495eab12558534f99458a9123d2bdd483c844c...f87a023153c7bb460c3a2520fd1ec6310f60a11a,1,1,1,2,1,2014-06-04 22:20:36,2014-06-04 22:20:36
c20c0d9dff09de2b03d14a7fca48efb71212d9e1...a6fac741ea3bf8e60015d03fd971487e4e49704f,1,2,1,3,1,2014-06-10 00:05:01,2014-06-10 00:05:01
a6fac741ea3bf8e60015d03fd971487e4e49704f...b4ab047b81103dbcc96b0115200acdee51239e75,1,1,1,2,1,2014-06-10 00:26:49,2014-06-10 00:26:49
b4ab047b81103dbcc96b0115200acdee51239e75...2213a5b756ad01042bd6e68b9a17f591ca62e977,2,2,2,4,2,2014-06-10 00:32:10,2014-06-10 00:32:10
b9454914268f9720ef3c098c7cddfaf5e9db333f...e71a85a525da06100a4b3882fcb95909454c5dca,1,0,3,3,1,2014-01-19 18:23:00,2014-01-19 18:23:00
5cc3c62e307d5ec05ea2391b77f3ef111ec878c6...6b8d4e9c7692d045686a03acb4a72ceaac20c881,4,24,0,24,4,2014-01-21 00:56:24,2014-01-21 00:00:52
7938134fd1382deb7b300da1672559fe2afb3706...1942f36455a892dc4eebed284dbb48fdddd01581,2,8,7,15,4,2014-01-22 00:29:49,2014-01-16 03:17:32
7938134fd1382deb7b300da1672559fe2afb3706...9e862cdf70091e877a3de9c5dcf1ad5449e6623b,1,9,10,19,1,2014-01-22 00:28:38,2014-01-16 23:39:56
7938134fd1382deb7b300da1672559fe2afb3706...068d7a11f98c6c7ae834208f4ab99781fb91dd39,1,57,57,114,2,2014-01-21 18:28:54,2014-01-21 18:28:54
7938134fd1382deb7b300da1672559fe2afb3706...67271a18ac4398557ccbc3250a4b8b33447f24f3,2,2,1,3,2,2014-01-21 18:23:57,2014-01-21 18:23:57
da948508447de169ab05c10a5f0a64bcb6a8aeb6...64ea59234f30f51ab5497830d1825c7e043a575e,3,13,2,15,3,2012-02-13 16:18:19,2012-02-13 16:18:19
da948508447de169ab05c10a5f0a64bcb6a8aeb6...60826077e7384e548c44c26531e7ae94e12fbcf4,6,81,14,95,15,2012-02-13 08:41:28,2012-02-13 08:41:28
0e8427e7b1c955a70a24817f6c06abd6dfa0c572...430915305178cc091f1d121ad98a50b93ccf99cd,6,7,4,11,5,2012-02-25 05:02:24,2012-02-25 05:02:24
430915305178cc091f1d121ad98a50b93ccf99cd...6abb2059eb44b53c78bd61c72ad6eb3a83c70457,3,2,2,4,2,2012-02-25 05:06:17,2012-02-25 05:06:17
0e8427e7b1c955a70a24817f6c06abd6dfa0c572...74a3c763b47e146e354624cea56b73fbf514ad97,3,2,2,4,2,2012-02-24 00:24:33,2012-02-24 00:24:33
b410eeb6dd4025718cddfc435c507bad7d47af1b...354252b4b506221f14d3f95627b0c887eb160caa,1,1,1,2,1,2012-03-11 21:24:18,2012-03-11 21:24:18
ffbed0980cbfdd6a9763b524cbf28853362ab7d3...bf6cdff88a273b912567e37eb6b4809c65efd18e,2,1,0,1,1,2012-03-11 20:48:47,2012-03-11 20:48:47
bf6cdff88a273b912567e37eb6b4809c65efd18e...a97b9c112238d3f146276a97998ed5c2bb1bc1bc,5,23,0,23,4,2012-03-11 21:41:52,2012-03-11 21:41:52
a97b9c112238d3f146276a97998ed5c2bb1bc1bc...ce292a8bb8129cd16425e3428a461891e78e3a3c,4,39,9,48,8,2012-03-11 22:15:55,2012-03-11 22:15:55
ce292a8bb8129cd16425e3428a461891e78e3a3c...8fd126ba1ba8c76f9b11833380db91554a034794,20,76,100,176,17,2012-03-12 00:28:28,2012-03-12 00:28:28
1a11c526b93731881a4908d120e8231ad73e9cec...e5a284d442a9c197bf52c9e46e0e387ff45ab9d6,1,0,0,0,0,2012-03-12 05:26:07,2012-03-12 05:26:07
e5a284d442a9c197bf52c9e46e0e387ff45ab9d6...ac7f571e536f4a6d5ee28fba50810d84e4dc1403,3,7,0,7,2,2012-03-12 05:28:37,2012-03-12 05:28:37
ac7f571e536f4a6d5ee28fba50810d84e4dc1403...0090fa1a6ec429958fad8f74974bd03e99bbf55e,3,5,1,6,2,2012-03-12 05:43:35,2012-03-12 05:43:35
0090fa1a6ec429958fad8f74974bd03e99bbf55e...0630cd62b3e66cdc6c27cabc6bccae87df132391,2,2,1,3,1,2012-03-12 05:45:10,2012-03-12 05:45:10
0630cd62b3e66cdc6c27cabc6bccae87df132391...91eef351e40c7833041e68fdddba8c2b43ebc702,5,8,52,60,16,2012-03-12 05:58:14,2012-03-12 05:58:14
91eef351e40c7833041e68fdddba8c2b43ebc702...58cb7c631dddca72f5ea87f73b3a59b4c2ec312c,3,13,11,24,4,2012-03-12 06:12:45,2012-03-12 06:12:45
58cb7c631dddca72f5ea87f73b3a59b4c2ec312c...5eed370856424362e23b1a5e02dd3c58c83dd30f,3,12,14,26,6,2012-03-12 06:14:36,2012-03-12 06:14:36
5eed370856424362e23b1a5e02dd3c58c83dd30f...7c2ed0c0958dcdb518970617a013538310494d20,3,43,4,47,6,2012-03-12 06:21:38,2012-03-12 06:21:38
7c2ed0c0958dcdb518970617a013538310494d20...d36f3d0a59a16350647b5eb39a18adb69e725ba2,4,54,39,93,6,2012-03-12 06:33:08,2012-03-12 06:33:08
d36f3d0a59a16350647b5eb39a18adb69e725ba2...f4b51b373b9ee28f5b87caaa7a9bc4ae610701e2,3,6,3,9,4,2012-03-12 06:33:52,2012-03-12 06:33:52
f4b51b373b9ee28f5b87caaa7a9bc4ae610701e2...debc4b752ff0850d9d034598793bf6becf4eae76,3,0,6,6,6,2012-03-12 06:34:22,2012-03-12 06:34:22
debc4b752ff0850d9d034598793bf6becf4eae76...c35b04cccda86164268508b59aa28655a31c1793,5,58,10,68,12,2012-03-12 06:43:19,2012-03-12 06:43:19
c35b04cccda86164268508b59aa28655a31c1793...685039d608e16fc207ed2d8b5f31d47d6d0e6ae6,3,11,0,11,4,2012-03-12 07:16:01,2012-03-12 07:15:27
685039d608e16fc207ed2d8b5f31d47d6d0e6ae6...5dff63d767889b65a3bd039eb26b86fcce97ea15,3,10,10,20,4,2012-03-12 07:21:52,2012-03-12 07:21:52
5dff63d767889b65a3bd039eb26b86fcce97ea15...40fddffeec58565eac698de0ed5697fde8a46130,3,16,16,32,16,2012-03-12 16:38:12,2012-03-12 16:38:12
40fddffeec58565eac698de0ed5697fde8a46130...e12c66aabead93f3ac015e6a6aee307185bc7667,5,9,4,13,7,2012-03-12 16:57:10,2012-03-12 16:57:10
e12c66aabead93f3ac015e6a6aee307185bc7667...7f3a2b38134916e84dc7c7ddc149b02d6e56d971,6,87,14,101,10,2012-03-12 19:44:47,2012-03-12 19:44:47
7f3a2b38134916e84dc7c7ddc149b02d6e56d971...cd89c34d99f839be73e9179385d4da29de026431,4,12,3,15,4,2012-03-12 20:31:38,2012-03-12 20:31:38
cd89c34d99f839be73e9179385d4da29de026431...56fe54df4385bfa186b82da443b14920ea2b16ee,3,6,2,8,2,2012-03-12 20:37:44,2012-03-12 20:37:44
56fe54df4385bfa186b82da443b14920ea2b16ee...6d4867e799de3a38f2ef81f16b81915390e5468c,2,0,1,1,1,2012-03-12 20:45:36,2012-03-12 20:45:36
6d4867e799de3a38f2ef81f16b81915390e5468c...664a838cd6683fab8a199a1e0f961132100937fb,1,0,11,11,1,2012-03-12 20:56:50,2012-03-12 20:56:50
664a838cd6683fab8a199a1e0f961132100937fb...1f7a64aa3da3ed321d8c1cc58c986ca29d6830da,1,0,0,0,0,2012-03-12 21:00:19,2012-03-12 21:00:19
1f7a64aa3da3ed321d8c1cc58c986ca29d6830da...8182b1ef69c55c0ece5a4c809aa1436da587985e,1,0,0,0,0,2012-03-12 21:03:24,2012-03-12 21:03:24
8182b1ef69c55c0ece5a4c809aa1436da587985e...59503e71ff06d0fd065c2fb981f55f4651ebc274,28,30,30,60,30,2012-03-12 21:09:38,2012-03-12 21:09:38
203d75770c82abb0487e58fece960046c141877c...426feeef6a4cf251431c7a21a1c79b0477ef37a0,13,489,211,700,211,2012-03-08 19:09:33,2012-03-08 19:09:33
ac6eff280df58a96bfd429189d2dd2d6e5c38208...d98a2e92340509fe9835103c799d3433c0c0d961,4,38,12,50,30,2012-03-06 06:47:39,2012-03-06 06:47:39
d98a2e92340509fe9835103c799d3433c0c0d961...bcd9294cc43dcf712314fa3633531812cad39adb,5,76,36,112,18,2012-03-06 07:00:37,2012-03-06 07:00:37
bcd9294cc43dcf712314fa3633531812cad39adb...79090ac12115bb5402a4756e791fb14dd7a1257b,5,52,52,104,41,2012-03-06 07:06:27,2012-03-06 07:06:27
235811cd8a4302e94e0b65c5561ba98629445a04...1fa42e2f71ad2df0e2781e55bcb8e1487ad345df,3,5,0,5,2,2012-03-05 08:36:57,2012-03-05 08:36:57
492ccedcabed8303a9a1cda8a09f6dbd40405553...738fac18de63275fbac8e1f81d60121eff557fd3,6,28,2,30,7,2012-03-06 07:50:03,2012-03-06 07:50:03
5cc4fcf6a2ace006b8b4023c3e75d819d611b2e1...a7b96b3e59e6f2c5eca7d92a26780c5cfe20a815,3,2,0,2,2,2012-02-28 05:32:48,2012-02-28 05:32:48
a7b96b3e59e6f2c5eca7d92a26780c5cfe20a815...9ee77f2c1106513adfaa3b81588d67e99093e707,3,4,2,6,4,2012-02-28 05:50:54,2012-02-28 05:50:54
2b8fc018ba43abbe1443e4bf9c2e8dffbd169215...91fe8bc0f49bf2da396bd6904c8f954487247f57,2,2,2,4,2,2012-02-20 21:37:24,2012-02-20 21:37:24
91fe8bc0f49bf2da396bd6904c8f954487247f57...9c74f21966d134e8576cfcfae0bb5301fcd2facd,3,2,2,4,2,2012-02-21 00:06:42,2012-02-21 00:06:42
9c74f21966d134e8576cfcfae0bb5301fcd2facd...331c85724afa7dbf41799967718b16e75f7ca816,4,1,4,5,3,2012-02-21 00:18:13,2012-02-21 00:18:13
331c85724afa7dbf41799967718b16e75f7ca816...143b3db2c9c97b281b0c4ede937d136e9f904651,5,29,3,32,9,2012-02-21 02:56:05,2012-02-21 02:56:05
143b3db2c9c97b281b0c4ede937d136e9f904651...d2630ff84eba322bec79ee25e33e075493744931,4,25,14,39,11,2012-02-21 03:14:26,2012-02-21 03:14:26
d2630ff84eba322bec79ee25e33e075493744931...06d4756114f55406b99d20a83eec95039d9af4bd,8,277,10,287,11,2012-02-21 05:20:06,2012-02-21 05:20:06
ac6e667ad9ae57c5caa977fd6593a2299887737a...e145619f6dcc4387f11dd46b56262dacbeff94ed,3,0,2,2,2,2012-02-19 20:54:38,2012-02-19 20:54:38
ac6e667ad9ae57c5caa977fd6593a2299887737a...82457603b65b177e70793eebbcf5a9c23873a770,4,14,7,21,6,2012-02-19 20:49:17,2012-02-19 20:49:17
ac6e667ad9ae57c5caa977fd6593a2299887737a...ad546c9631075cc411345b9063eee651e82432a5,2,1,1,2,2,2012-02-19 20:42:12,2012-02-19 20:42:12
ac6e667ad9ae57c5caa977fd6593a2299887737a...51ec513b5c50123761350d2bcd27dafb07192a7e,3,5,25,30,12,2012-02-19 20:29:32,2012-02-19 20:29:32
ac6e667ad9ae57c5caa977fd6593a2299887737a...df757fb040e5736e55b3f7060260a79b6b79b781,3,0,4,4,2,2012-02-19 20:21:44,2012-02-19 20:21:44
df757fb040e5736e55b3f7060260a79b6b79b781...f08b40766749209709ec49c01f8aa122996657b3,3,2,2,4,2,2012-02-19 20:23:17,2012-02-19 20:22:37
f08b40766749209709ec49c01f8aa122996657b3...c1775da18714170847e1fb7768f375803b63c489,3,8,0,8,2,2012-02-19 20:24:06,2012-02-19 20:24:06
c1775da18714170847e1fb7768f375803b63c489...f28140897e92882a2bbecd8c3426e978bd29ba86,3,10,6,16,4,2012-02-19 21:14:18,2012-02-19 21:14:18
1948e985a355c519b8f3940af0ce83d9fd3c5f83...16d12396d0f1f352280ae195ac60a15e7e95d666,4,5,11,16,5,2012-02-19 22:53:07,2012-02-19 22:53:07
db940b3d8f48d1f664137c5adb427a35580f80c4...29e6ef7c703c5a8eb6e19dea22f797c20e1e533e,3,16,4,20,2,2012-02-18 23:23:38,2012-02-18 23:23:38
a8c478e05189d195d4b921c5d0eb6c601ea35711...792059b7adf65843a7befdd0d6a5b3b57aeb6d61,1,6,3,9,2,2012-02-17 04:04:26,2012-02-17 04:04:26
792059b7adf65843a7befdd0d6a5b3b57aeb6d61...f9b578260f8898748a2de10bc0bec74699ec5c10,2,6,3,9,2,2012-02-17 04:05:09,2012-02-17 04:05:09
f9b578260f8898748a2de10bc0bec74699ec5c10...e730f8adb562ccb885d48fea6f8f075530ef53d8,3,2,0,2,2,2012-02-17 04:22:01,2012-02-17 04:22:01
e730f8adb562ccb885d48fea6f8f075530ef53d8...6da16a6def486413b1897540aff1f335638ed5e6,1,4,4,8,4,2012-02-17 04:30:00,2012-02-17 04:30:00
6da16a6def486413b1897540aff1f335638ed5e6...1520ec446ce9fc748efa3390a58c447841c48e73,2,4,4,8,4,2012-02-17 04:30:18,2012-02-17 04:30:18
1520ec446ce9fc748efa3390a58c447841c48e73...b3e4e5ae2212c4bda6424815871499d9c7693ee6,3,2,2,4,2,2012-02-17 04:33:15,2012-02-17 04:33:15
b3e4e5ae2212c4bda6424815871499d9c7693ee6...9d12b2d60168505fdb68672f6fe7992bb264da90,3,4,0,4,2,2012-02-17 04:43:57,2012-02-17 04:43:57
9d12b2d60168505fdb68672f6fe7992bb264da90...c3d3cf7262ff53215f11ec4772c9c787643b33e2,1,2,5,7,3,2012-02-17 04:46:35,2012-02-17 04:46:35
c3d3cf7262ff53215f11ec4772c9c787643b33e2...0369c1fcfc22530171fdf6a1d6400767dc13f609,4,18,5,23,5,2012-02-17 05:04:16,2012-02-17 05:04:16
0369c1fcfc22530171fdf6a1d6400767dc13f609...489276f5be328773e4e4dbd7d6d8e326d3135437,5,6,6,12,6,2012-02-17 05:08:52,2012-02-17 05:08:52
489276f5be328773e4e4dbd7d6d8e326d3135437...61e2201c64a9a61792680c2b1d236b0a753ed182,5,18,18,36,18,2012-02-17 05:25:40,2012-02-17 05:25:40
61e2201c64a9a61792680c2b1d236b0a753ed182...268e7d67abb32ed5cfc575c71f03d635672e781c,5,22,2,24,6,2012-02-17 05:28:16,2012-02-17 05:28:16
268e7d67abb32ed5cfc575c71f03d635672e781c...6f6adfb52fc2f6043f84ac4fab876592c00b2894,4,21,1,22,3,2012-02-17 06:04:11,2012-02-17 06:04:11
6f6adfb52fc2f6043f84ac4fab876592c00b2894...091622644a0c619e1afbb21041c141da30df76b7,4,12,2,14,6,2012-02-17 06:34:30,2012-02-17 06:34:30
f7b5e0f6b58ae137cc878a1660f9513e343a74c3...2355ea034b2d2c46dde5faf01fd53aa324d13cae,2,9,9,18,9,2012-01-23 04:47:24,2012-01-23 04:47:24
2355ea034b2d2c46dde5faf01fd53aa324d13cae...1209a3756c88043008950f74dd287b837e00f7d8,3,7,7,14,5,2012-01-23 04:50:35,2012-01-23 04:50:35
ab8f2e2767be77120fedb07269dc7db078101dba...1c014613a9924a3a3715821ff4b65531bee5b630,1,35,1,36,2,2012-01-19 20:32:57,2012-01-19 20:31:45
1c014613a9924a3a3715821ff4b65531bee5b630...25ac318d33329a0fb532d5f9ec922ad76d791959,3,25,47,72,47,2012-01-19 20:33:22,2012-01-19 20:33:22
25ac318d33329a0fb532d5f9ec922ad76d791959...8825443d6e6ff28a97e092f46b42ec508e58cb05,3,6,5,11,5,2012-01-19 22:27:24,2012-01-19 21:02:00
ab8f2e2767be77120fedb07269dc7db078101dba...9c940784153257efcadc1aa420c57caa86e664bf,1,1,1,2,1,2012-01-18 19:53:59,2012-01-18 19:53:59
dec1c21e34d12493b1eb82c8659635e068d8919d...310465b035353e05524a998dc29605252dc976e7,2,2,0,2,2,2014-03-06 21:15:32,2014-03-06 21:10:40
839f8faa912477665c55e5f75f715cf5f77d744e...39f8bbac37cc6d53a5804d24105e8d5670c5ec3d,1,113,0,113,1,2014-03-06 23:19:27,2014-03-06 05:47:30
39f8bbac37cc6d53a5804d24105e8d5670c5ec3d...421e7af1377e5c17156e796c38fd075d3ce2566f,1,1,0,1,1,2014-03-06 23:19:27,2014-03-06 05:48:38
a41827377b5bc90aef88a2180a6dbddbb6eb0ff3...be7402f0d0876dbc9d4c4bd5d41d9202ae46f88d,1,6,0,6,1,2014-10-30 01:00:52,2014-10-30 01:00:52
a41827377b5bc90aef88a2180a6dbddbb6eb0ff3...b8dbb545ac7e467ad1e1b95e0e0c647ccd129c4a,1,2,2,4,2,2014-10-30 00:20:35,2014-10-30 00:20:35
ff386147ce341a15f02b31f638500487246e34da...b87370c28f6f8cd0d2de6cc541dcba22788e4001,1,6,11,17,4,2014-11-12 05:22:30,2014-11-12 05:22:27
ff386147ce341a15f02b31f638500487246e34da...1211a8155e9357ddd747f7ecba800e460e72465d,11,51,26,77,36,2014-11-12 05:16:34,2014-11-12 05:16:34
bb89657bcb53a60d579d8fd9bbea56dde05dad8c...0681971c8aea1c4de4ae3878506477b835cacc6b,10,23,23,46,23,2014-11-11 23:52:52,2014-11-11 23:52:52
bb89657bcb53a60d579d8fd9bbea56dde05dad8c...857aab0a1c121fb6929d61863e6c92f088d72e57,1,0,4,4,1,2014-11-11 23:43:00,2014-11-11 23:43:00
bb89657bcb53a60d579d8fd9bbea56dde05dad8c...eb580f739ce8aec357f0847a687a8b372ab0d58a,1,37,25,62,13,2014-11-11 22:13:25,2014-11-11 22:13:25
eb580f739ce8aec357f0847a687a8b372ab0d58a...9391ef207ff05f28e3952afdb92639c02b5920f5,6,38,38,76,25,2014-11-11 22:41:21,2014-11-11 22:41:21
bb89657bcb53a60d579d8fd9bbea56dde05dad8c...917decab6cc15c0178b1ebf9d30e4e3c0ef90c7f,1,5,0,5,1,2014-11-11 09:58:21,2014-11-11 09:58:21
72ad89b0777278044bd852c3ac4520b42d5504bb...db90ff6df7a1a3e3cc914a3edc0dad0518462f0d,6,72,22,94,28,2014-11-05 00:45:16,2014-11-05 00:45:16
6ac5708a0dc8ce0c4b8f7ba47736c53d2e1bb3c6...b1a9168b1553f043b3c8c8f516cf0ff721aa6444,3,17,7,24,5,2014-06-12 01:13:50,2014-06-12 01:13:50
04028cf6feb62471a3788cd15804e62b9ce890d7...06af640e825d71449c315e84c331a15aa0a7ee7e,1,5,0,5,3,2014-05-04 22:15:02,2014-05-04 22:15:02
04028cf6feb62471a3788cd15804e62b9ce890d7...ed410667dfd95502b3674806e7ad7b2b79a5627b,1,3,3,6,3,2014-05-04 16:02:55,2014-05-04 16:02:55
04028cf6feb62471a3788cd15804e62b9ce890d7...7627b24c1e6aa5301ee3f525dd931c2852e7ff0a,1,37,17,54,2,2014-05-04 09:24:31,2014-05-04 09:24:31
04028cf6feb62471a3788cd15804e62b9ce890d7...f71f2dbeb0ebafe0d8255317001396ce9ddb7e55,1,6,1,7,2,2014-05-04 09:24:04,2014-05-04 09:24:04
b4b82e815c45faaaff74e0e605336b5b37c015ab...043b40636c99c55d7331227401c447aefd699f4c,7,9,13,22,9,2014-07-06 03:17:57,2014-07-06 03:17:57
2ca6581798cf516d6ab2029bf63d1ed5f1070703...0be41096888201831c151864c0ab05cf0b5ca734,1,6,5,11,3,2014-06-08 01:09:53,2014-05-29 07:24:41
0be41096888201831c151864c0ab05cf0b5ca734...632313d631b51d96557bb6576c0b41e33cbfb009,1,1,4,5,2,2014-06-08 01:09:53,2014-05-29 07:30:18
632313d631b51d96557bb6576c0b41e33cbfb009...bc8e6ffb7d702895296050d2fd8847fb5eed2381,1,3,3,6,4,2014-06-08 01:09:53,2014-05-29 07:36:53
bc8e6ffb7d702895296050d2fd8847fb5eed2381...1cfa902e313e848732976ac6e538f3f72c135d90,1,8,2,10,2,2014-06-08 01:26:39,2014-05-29 07:51:49
a375069704e88b4f7659dcd4a74a6239bfefba8c...abbf6da6aaa37e337a527217982838bfff1d8027,3,22,6,28,8,2014-05-23 04:12:13,2014-05-23 04:12:13
abbf6da6aaa37e337a527217982838bfff1d8027...64bb8be70727d7764aa76ae9761b29f6f59bd09d,2,9,7,16,7,2014-05-23 04:34:24,2014-05-23 04:34:24
64bb8be70727d7764aa76ae9761b29f6f59bd09d...4f60a7fae9a3553e87752ff649a7877e6fe20981,1,0,1,1,1,2014-05-23 04:34:49,2014-05-23 04:34:38
4f60a7fae9a3553e87752ff649a7877e6fe20981...46974490e4041c5ff21006ffd51fc49dbfaeb8d4,1,1,1,2,1,2014-05-23 04:39:37,2014-05-23 04:39:37
46974490e4041c5ff21006ffd51fc49dbfaeb8d4...338cff13593a5e10abcab37da9f197fa4eafa3de,1,2,4,6,2,2014-05-23 04:39:47,2014-05-23 04:39:47
ef436c761b9587fbd0234788ec8bed4696aec516...739bf379a93a2a396e23f0423167b3552eb88191,2,33,11,44,9,2014-06-07 00:23:28,2014-06-05 20:31:39
739bf379a93a2a396e23f0423167b3552eb88191...dd7ee517e4541cddf98b46feb8b35d1568ff2346,1,26,1,27,5,2014-06-07 00:29:36,2014-06-07 00:28:02
ef436c761b9587fbd0234788ec8bed4696aec516...47a0de9b9314d03e983ca4122c4ac07aba81c119,1,1,14,15,2,2014-06-05 19:06:09,2014-06-05 18:56:23
14c3760033e77e0e0d754d27522d3c57219c5382...5cd72ce23058b47a739c7e2005ab5c3d4e28ff30,5,5,5,10,5,2014-06-08 20:55:40,2014-06-08 20:55:40
61dbc6134e26102eaa2fa0c8a0c9b6b45ac942e1...c7783f5ad8832e7046cd1d2fcdb7959bfa632c33,1,1,1,2,1,2014-06-10 05:24:51,2014-06-10 05:24:51
2213a5b756ad01042bd6e68b9a17f591ca62e977...af45472dfe5e81a3ad01ea33f039f7eefe9e5245,2,1,7,8,2,2014-06-10 18:48:12,2014-06-10 18:41:32
2213a5b756ad01042bd6e68b9a17f591ca62e977...5eaedbe09784372f5f0935c871754ec6bcfe1154,1,6,10,16,3,2014-06-10 04:59:03,2014-06-10 04:54:31
2213a5b756ad01042bd6e68b9a17f591ca62e977...2535f7c79ad98bcb372636c9c6ff90841ffd1c37,1,4,4,8,4,2014-06-10 04:45:55,2014-06-10 04:45:55
8d8524e5946fbc72e15cd206423e5ff1b10d6b2f...54939ef0f037b06bf0e6c5ba6ed288c58068f30c,1,5,2,7,2,2014-06-11 02:06:24,2014-06-11 02:06:24
54939ef0f037b06bf0e6c5ba6ed288c58068f30c...fd0a81a57ab9976a0c6a423498c0405357c7816c,1,2,2,4,1,2014-06-11 02:20:56,2014-06-11 02:20:56
8d8524e5946fbc72e15cd206423e5ff1b10d6b2f...9a51410fd37154e8b25937017bad4912fbf57d99,5,78,28,106,28,2014-06-11 01:11:26,2014-06-11 01:11:26
8d8524e5946fbc72e15cd206423e5ff1b10d6b2f...ff7e8d5054b95951541cbc01ee58cb46b753f597,1,1,1,2,1,2014-06-11 01:09:30,2014-06-11 01:09:30
8d8524e5946fbc72e15cd206423e5ff1b10d6b2f...571fd32bcee3d069d5f30167a887b47efd492f01,1,11,1,12,5,2014-06-11 00:38:42,2014-06-11 00:37:40
833c208bf5e88e438ae1eb360782b2364cd03915...08e83a62b7a3b12d459b2e025661e60024b10ca7,9,17,8,25,12,2014-01-23 03:43:08,2014-01-23 03:43:08
08e83a62b7a3b12d459b2e025661e60024b10ca7...f748390cf5bb436f732da9c43df269886c586a2a,6,4,12,16,6,2014-01-23 03:51:23,2014-01-23 03:51:23
8a1f4426a26d7a26b78fb72a84fba6db4ea51832...3de48d29f5b9b0f83e4fe0b4bfb51e141407a9a2,5,67,45,112,11,2014-01-21 02:06:16,2014-01-21 02:02:15
06dcf9136445b29018dc107a9cbfc60d8e947004...e5c7c2acc1035ca3600d78988adc82451901fe28,1,3,3,6,2,2014-01-22 06:02:54,2014-01-22 06:02:54
e5c7c2acc1035ca3600d78988adc82451901fe28...c08aef16554e0958666f736da40601af09896c1c,1,1,1,2,1,2014-01-22 06:12:44,2014-01-22 06:12:44
74a3c763b47e146e354624cea56b73fbf514ad97...fb74018ae293588db84c6fbf2f4f07aa4da21c5e,5,20,0,20,6,2012-02-25 05:51:39,2012-02-25 05:51:39
fb74018ae293588db84c6fbf2f4f07aa4da21c5e...43760eb2029c73b6be6b0dbeb753be1e247697d9,2,1,1,2,1,2012-02-25 06:17:36,2012-02-25 06:17:36
74a3c763b47e146e354624cea56b73fbf514ad97...34268672be8844d3a035cb2a7430eeeaf94a3666,1,1,1,2,1,2012-02-24 06:34:23,2012-02-24 06:34:23
d3721c504e7838ba3ee867d68536e6cf0b6b7f66...af1dbf6581e20ac67465706499a2732e7faf9c67,2,6,6,12,7,2012-03-08 19:39:50,2012-03-08 19:39:50
af1dbf6581e20ac67465706499a2732e7faf9c67...1562381114ce1ce5dc06d311ddb6d1e0f2048a1f,2,1,1,2,1,2012-03-08 19:42:12,2012-03-08 19:42:12
95cb6f07a8fc2410873c59addd3f1aad948e54fd...7154e378b241f753491c1aaf4aba310b7f0f179d,11,19,19,38,19,2012-03-12 00:53:17,2012-03-12 00:53:17
7154e378b241f753491c1aaf4aba310b7f0f179d...4109c62cf745250e05267c1c5498865b5b548dcf,5,16,12,28,6,2012-03-12 01:18:18,2012-03-12 01:18:18
4109c62cf745250e05267c1c5498865b5b548dcf...2e52946fd3e71ef33da7035471a0e1051010df52,3,6,0,6,2,2012-03-12 03:03:55,2012-03-12 03:03:55
2e52946fd3e71ef33da7035471a0e1051010df52...0f238832833a1189397028e882b9c8a11acd1adf,3,6,0,6,2,2012-03-12 03:16:39,2012-03-12 03:16:39
0f238832833a1189397028e882b9c8a11acd1adf...67714d8347d635ab1cd25c1312d14ec2973b0944,3,2,8,10,4,2012-03-12 03:38:17,2012-03-12 03:38:17
67714d8347d635ab1cd25c1312d14ec2973b0944...c8f4325c192f97e9c8d09e7d8ad3059be694fc4c,5,23,1,24,5,2012-03-12 04:12:59,2012-03-12 04:12:59
c8f4325c192f97e9c8d09e7d8ad3059be694fc4c...ee5d2ec91aab9ec086b57a21059617355639b32c,5,39,17,56,10,2012-03-12 04:21:51,2012-03-12 04:21:51
ee5d2ec91aab9ec086b57a21059617355639b32c...5a28bd1e78f6aae2bae87d1eb823687c5e1f7cd8,3,2,0,2,2,2012-03-12 04:44:00,2012-03-12 04:44:00
59503e71ff06d0fd065c2fb981f55f4651ebc274...d335adf644b213a5ebc9cee3f37f781ad55194ef,1,7,0,7,1,2012-03-22 07:33:18,2012-03-22 07:33:18
59503e71ff06d0fd065c2fb981f55f4651ebc274...a0203bc8e0aa79b8f8cfd8c082c4256bed29ae5b,1,7,2,9,3,2012-03-21 10:20:56,2012-03-21 10:20:56
a0203bc8e0aa79b8f8cfd8c082c4256bed29ae5b...02a67ea59eb8ee28ba4220898c1a0b2052a80915,1,2,2,4,2,2012-03-21 10:28:23,2012-03-21 10:28:23
02a67ea59eb8ee28ba4220898c1a0b2052a80915...2f06366399f1b0572b0dbcbadcf06df9e4867f2b,3,11,6,17,7,2012-03-21 11:09:00,2012-03-21 11:09:00
2f06366399f1b0572b0dbcbadcf06df9e4867f2b...cfce34e3000b2c02549e3af280668afea61fa752,3,12,8,20,6,2012-03-22 19:36:49,2012-03-22 19:36:49
cfce34e3000b2c02549e3af280668afea61fa752...239c178b685294ce24ab79d913c5df03d15191e9,3,14,6,20,2,2012-03-22 20:24:57,2012-03-22 20:24:57
59503e71ff06d0fd065c2fb981f55f4651ebc274...d115d169b72d165d8b84c6e16d3b132b28b96d1d,1,2,2,4,2,2012-03-19 17:58:55,2012-03-19 17:58:55
59503e71ff06d0fd065c2fb981f55f4651ebc274...8e0afbeaa42dfabb75817b7fc1c677cd372c8c43,4,19,13,32,7,2012-03-14 19:00:27,2012-03-14 19:00:27
59503e71ff06d0fd065c2fb981f55f4651ebc274...ffa0d2f180a328133a0d14d381678d15541a91cd,2,3,3,6,3,2012-03-13 16:35:08,2012-03-13 16:35:08
ffa0d2f180a328133a0d14d381678d15541a91cd...6a61e81b7a207c23f050accfb73043d0b571d4de,1,1,1,2,1,2012-03-13 19:36:58,2012-03-13 19:36:58
6a61e81b7a207c23f050accfb73043d0b571d4de...d3873b0fc7818c12ec42a6fcfce344950c19fea5,2,4,4,8,4,2012-03-15 02:28:24,2012-03-15 02:28:24
d3873b0fc7818c12ec42a6fcfce344950c19fea5...4c0905c5f2cc81df7726de32eb9238e111fb0513,2,2,2,4,2,2012-03-18 18:44:31,2012-03-18 18:44:31
4c0905c5f2cc81df7726de32eb9238e111fb0513...cdd158c57182092a7ced90af06e7dcc0e4e8e29b,2,2,2,4,2,2012-03-18 18:49:18,2012-03-18 18:49:18
426feeef6a4cf251431c7a21a1c79b0477ef37a0...bcef12dfcc8d7e0df03437589f22174042745d78,3,5,2,7,2,2012-03-08 19:39:00,2012-03-08 19:39:00
fb1d4a0f04504935eb17d13ac6d1dbb72c70b102...7a8d6b19767a92b1c4ea45d88d4eedc2b29bf1fa,5,30,33,63,18,2012-03-05 08:42:37,2012-03-05 08:42:37
7a8d6b19767a92b1c4ea45d88d4eedc2b29bf1fa...cb9234ba464d78d463a728dea2d40a0a3259d31a,5,48,0,48,8,2012-03-05 08:47:13,2012-03-05 08:47:13
cb9234ba464d78d463a728dea2d40a0a3259d31a...eaf464a2c513989ace98162074f84a14963e02a9,3,6,6,12,4,2012-03-06 04:14:54,2012-03-06 04:14:54
eaf464a2c513989ace98162074f84a14963e02a9...20b10b5d666209c333db27a3ea95465fd6267cf6,3,2,2,4,2,2012-03-06 04:15:35,2012-03-06 04:15:35
20b10b5d666209c333db27a3ea95465fd6267cf6...9c2b2c589da892bb15f276acc7d8f8707d4fc205,1,2,2,4,2,2012-03-06 04:20:42,2012-03-06 04:20:42
738fac18de63275fbac8e1f81d60121eff557fd3...6b9f70797d812f5a3a90035e4e8ccc2b7cfd0f66,3,22,0,22,2,2012-03-07 05:12:43,2012-03-07 05:12:43
6b9f70797d812f5a3a90035e4e8ccc2b7cfd0f66...69e4522a4e4c1b021f5abb3a7018926645eac2fa,2,1,1,2,1,2012-03-07 05:13:29,2012-03-07 05:13:29
738fac18de63275fbac8e1f81d60121eff557fd3...03bdf82ca270f5c50e310b452b37d01f81a15ba3,1,3,2,5,1,2012-03-06 21:45:43,2012-03-06 21:45:43
6c9547f4115dd0e5851c7cc093bd0a7e75aad89f...fbebb046f7134eaed90492bfc67720337c4b625e,4,9,1,10,3,2012-02-28 06:34:25,2012-02-28 06:34:25
06d4756114f55406b99d20a83eec95039d9af4bd...f3ad4c7183251713eb021a400211cc9b07577080,7,390,79,469,45,2012-02-21 16:24:18,2012-02-21 16:24:18
06d4756114f55406b99d20a83eec95039d9af4bd...f046c12bd21b03d9b34e7e5f6386f7f4b614eace,1,2,2,4,2,2012-02-21 06:01:38,2012-02-21 06:01:38
f046c12bd21b03d9b34e7e5f6386f7f4b614eace...d149a131c14bb8be32ecc306f2128dddec9e83bf,2,2,2,4,2,2012-02-21 06:02:04,2012-02-21 06:02:04
adbbf17ee4a241b14503289e6726fc52acefc8a4...8482cc4cb3632bbdf24aacb9793b90606e789c74,1,1,1,2,1,2012-02-19 22:55:07,2012-02-19 22:55:07
fed3b59e46d9c6c889159ac9cf5c685b3278cd5f...bbb2fb33957da815e88efa0797df5817268ce812,4,10,6,16,4,2012-02-19 04:06:38,2012-02-19 04:06:38
1209a3756c88043008950f74dd287b837e00f7d8...f764aee4b919c28974dba7b91edac9a04172ba25,85,15165,1581,16746,238,2012-01-23 22:14:16,2012-01-23 22:14:16
c75a59e74129d0519e0a011350d63ab22f7995a8...93c81522164421a03a9093502dae8125aa8b5584,1,1,2,3,2,2012-01-20 21:42:10,2012-01-20 21:42:10
93c81522164421a03a9093502dae8125aa8b5584...3ed836b19888215fe5ad9539898502d203712021,1,1,2,3,2,2012-01-20 21:50:36,2012-01-20 21:50:36
3ed836b19888215fe5ad9539898502d203712021...7444310c4d0a2f34c7cec66216fdf95d67a0e74d,1,1,1,2,1,2012-01-21 04:05:16,2012-01-21 04:05:16
7444310c4d0a2f34c7cec66216fdf95d67a0e74d...719713ca8730d92d3510e6d4a7cc542fd57fdeef,1,1,1,2,1,2012-01-21 04:28:40,2012-01-21 04:28:40
8825443d6e6ff28a97e092f46b42ec508e58cb05...782c994060a984c10d73fdd3cc8e3fe33a2e4477,7,132,176,308,58,2012-01-20 21:21:59,2012-01-20 21:16:40
33e78ed937f90019a2f589defe55eb18b9f60a56...5178d8b8bab50d5b9e03e00db5340178f8507035,1,1,1,2,1,2014-10-30 02:46:49,2014-10-30 02:46:49
00fa64650a604639dfd7ffc747a126a06c88e031...e27dc5d71e962effae1ec3b67fa72f77b14d3d98,8,11,9,20,8,2014-11-05 00:56:18,2014-11-05 00:56:18
b87370c28f6f8cd0d2de6cc541dcba22788e4001...f94cb5817a4b8ef1a645ae69251ff8b226b7d076,1,1,1,2,1,2014-11-12 06:52:32,2014-11-12 06:52:32
2006a435d98b51a8d8430abe14ac3611113c2dff...1d55ada581e2e669cc7c163dc469b9184bbd8f7d,2,42,1,43,2,2014-11-12 01:01:25,2014-11-12 00:18:06
b1a9168b1553f043b3c8c8f516cf0ff721aa6444...5e6967358fce043f847de2588b6d685f6a518eab,1,2,2,4,2,2014-06-12 03:35:27,2014-06-12 03:03:40
cd958497947c78dce3024c18bf2ac63ede1caa97...b100e15d419a6640c523e121b664330f819ea7af,1,1,1,2,1,2014-05-05 19:08:04,2014-05-05 19:08:04
b100e15d419a6640c523e121b664330f819ea7af...5728b5791c94b5f4df662045552e66bc05d85d31,1,1,1,2,1,2014-05-05 19:13:14,2014-05-05 19:13:14
cd958497947c78dce3024c18bf2ac63ede1caa97...d8ee1ba9b61ef4ba5b0494433e3a6eac414ef782,2,22,2,24,4,2014-05-05 17:07:47,2014-05-05 10:11:59
7408917887bc3c722ff5c4f892c2ba2f992e0cfd...f0daa64a29a66a663f6fedb9d8687524af754436,4,8,1,9,3,2014-05-07 22:30:27,2014-05-07 22:30:27
043b40636c99c55d7331227401c447aefd699f4c...e88fa909916ab8aa6e35a99b11f025470a4a067f,1,19,23,42,6,2014-07-07 05:56:52,2014-07-07 05:56:52
043b40636c99c55d7331227401c447aefd699f4c...22f851fa6232b2db2efedbabcc5b532e424525f3,1,2,3,5,2,2014-07-06 06:28:44,2014-07-06 06:28:44
043b40636c99c55d7331227401c447aefd699f4c...c1bd4fca61fe6aeed597f88ba20e67b26a4cfd66,1,1,1,2,1,2014-07-06 04:20:09,2014-07-06 04:20:09
36483af92c2d0be97aa86f16ffcf5f67abf2ed11...c22ec79d3f823ee38ef8a6ff592369d2bb0ddf5b,1,6,0,6,1,2014-07-23 17:24:23,2014-07-23 17:23:23
a8641b4db779da385782275b49abb796f64a413c...5ef9383f5388ba7a701c4377b43ebdbedb0bf748,6,28,21,49,16,2014-06-05 22:23:06,2014-03-17 07:07:21
5ef9383f5388ba7a701c4377b43ebdbedb0bf748...7b0acf14d8a7c7c6089035a848cba540ed963f36,24,171,152,323,123,2014-06-05 22:23:07,2014-03-17 07:12:55
7b0acf14d8a7c7c6089035a848cba540ed963f36...82fc03f3b6caccd134827a83c346456b920f4ba8,1,1,1,2,1,2014-06-05 22:23:07,2014-05-22 06:48:17
82fc03f3b6caccd134827a83c346456b920f4ba8...e2cabe4971927e3dbbbda4c81ae8f74abdee2d15,8,30,20,50,12,2014-06-05 22:23:07,2014-05-29 04:35:22
e2cabe4971927e3dbbbda4c81ae8f74abdee2d15...03a8949d7c7937dd56da0802acbbded1ee27152f,6,38,29,67,27,2014-06-05 22:23:07,2014-05-22 06:38:57
98574cd018f7892795a1157ecdc57082aae904c9...5fd8ca9089aaaf9af2bf9282f3b95343db896eb9,2,15,19,34,7,2014-06-08 17:51:32,2014-06-08 17:50:54
9ac3fe6fcfb5444d7fbde77f90e6546ea0a7b228...9e1652aa50a9d315d333362b68de88e931dc872b,3,8,12,20,5,2014-06-10 05:25:24,2014-06-10 05:25:24
6a2482447dbc33519a966753e47607be9f199182...1c6fa9010daf0d0c21de9e20fe6ac4dba1788d90,14,75,28,103,29,2014-06-11 00:16:29,2014-06-10 05:18:05
6a2482447dbc33519a966753e47607be9f199182...ff9ab6ce21571094ae6aee219c7694f7ae2f04d5,3,3,3,6,3,2014-06-10 05:14:09,2014-06-10 05:14:09
2fb31318d602c79978fa3493e246b3b53263d052...a1dad14f448b9885147a5ae05458a4c5f457b43b,1,13,3,16,3,2014-06-11 03:35:03,2014-06-11 03:24:19
2fb31318d602c79978fa3493e246b3b53263d052...c0e82accadea85094ef2f8b208975c449130f33f,5,9,6,15,6,2014-06-11 03:17:22,2014-06-11 03:17:22
c0e82accadea85094ef2f8b208975c449130f33f...631e04b6fc1cc643610684fe3d3c683ee486a9fe,6,11,6,17,10,2014-06-11 03:50:58,2014-06-11 03:50:58
631e04b6fc1cc643610684fe3d3c683ee486a9fe...e8100c3b3ced15114db8038a6dac7d9878f2c331,1,4,4,8,4,2014-06-11 04:14:04,2014-06-11 04:14:04
e8100c3b3ced15114db8038a6dac7d9878f2c331...dcbe484a09531da4ecc80fd2991a9910fb6a64ed,8,19,14,33,17,2014-06-11 04:20:34,2014-06-11 04:20:34
dcbe484a09531da4ecc80fd2991a9910fb6a64ed...5c6c0a194d61f8fb8ffca94bc5e695a7dda87fd7,1,11,11,22,7,2014-06-11 04:24:44,2014-06-11 04:24:44
5c6c0a194d61f8fb8ffca94bc5e695a7dda87fd7...97e0cd015f642ecbd42392def754d6e85c7e97c6,1,5,6,11,4,2014-06-11 04:47:51,2014-06-11 04:47:51
9cdbf0e80702b9a6a772a2d4a81d8d94dbe1c0eb...7f122be0041ff2d4314a196d53d32dc5f295ed02,7,24,25,49,16,2014-06-11 03:42:19,2014-06-11 02:56:08
e136ba0fa368d3c81da71ce0b6ce562a419e8593...dacaf619d2410e69ad8d3252ea2d0e992e296a84,1,5,0,5,1,2014-06-11 05:39:27,2014-06-11 05:39:27
dacaf619d2410e69ad8d3252ea2d0e992e296a84...bc38d3b3039014cba8757e2e05857fdecbfb36be,1,1,1,2,1,2014-06-11 05:41:48,2014-06-11 05:41:48
bc38d3b3039014cba8757e2e05857fdecbfb36be...57bd8f943b7768589cfa05ca8fcc8ec6cd123770,3,15,5,20,7,2014-06-11 05:47:25,2014-06-11 05:47:25
7a6bc67826d5aba3e551b04a054724c8cb817fa2...b30cff488876531424bf2ff248ae5900472052b5,1,4,1,5,1,2014-01-24 04:51:23,2014-01-24 01:23:57
7a6bc67826d5aba3e551b04a054724c8cb817fa2...aa8b1543be2b082320f9342c4226c3cda417b33e,1,1,0,1,1,2014-01-23 22:01:59,2014-01-23 22:01:59
7a6bc67826d5aba3e551b04a054724c8cb817fa2...2f26eaea5be499cbd42f2766e596bef59979cd23,1,1,0,1,1,2014-01-23 20:50:57,2014-01-23 20:50:57
7a6bc67826d5aba3e551b04a054724c8cb817fa2...7d015817ed04509c9699e5bedb5ddfc161e797f7,1,1,1,2,1,2014-01-23 19:18:56,2014-01-23 19:18:56
7d015817ed04509c9699e5bedb5ddfc161e797f7...31e8a48783c2c58becbd59f9c686f18c28e2d0ef,1,1,1,2,1,2014-01-23 23:07:04,2014-01-23 23:07:04
31e8a48783c2c58becbd59f9c686f18c28e2d0ef...b9d1ae092f480167aedd009f7f3148f1f53f26a7,1,1,1,2,1,2014-01-24 01:01:43,2014-01-24 01:01:43
b9d1ae092f480167aedd009f7f3148f1f53f26a7...44fc629d446d67035f27dc0c9b012f8339de0f13,6,8,8,16,6,2014-01-24 04:52:26,2014-01-24 04:52:26
81b234e74afc3889f301670201b7371daaeafb57...2022e15aa85368336e3decbb94f55d452c56add9,1,1,1,2,1,2014-01-22 16:00:09,2014-01-22 16:00:09
81b234e74afc3889f301670201b7371daaeafb57...6c7db9d56e572cbde7eedb58abe3a8876c6d2d81,1,1,1,2,1,2014-01-22 15:45:55,2014-01-22 15:45:55
f4f34ab12f0f89e6a11f6b752ab82fb01bd746d4...8247cb3362094fea315ec46acb0ff1ac42c8e47d,5,82,2,84,6,2012-02-20 00:28:46,2012-02-20 00:28:46
8247cb3362094fea315ec46acb0ff1ac42c8e47d...1c7d346767854eb11f723e100dbdce0b60d21e16,3,2,2,4,2,2012-02-20 00:40:41,2012-02-20 00:40:41
1c7d346767854eb11f723e100dbdce0b60d21e16...9b09d1de861b236ce27cbda8579d4ec1f6e4dd17,5,26,3,29,7,2012-02-20 05:55:09,2012-02-20 05:55:09
9b09d1de861b236ce27cbda8579d4ec1f6e4dd17...f81e5fbe9f3bf754757b059c62880cdca043d496,1,19,4,23,10,2012-02-20 06:52:32,2012-02-20 06:52:32
f81e5fbe9f3bf754757b059c62880cdca043d496...9f608411cbea9b2626f307008d82a26667872ccf,1,1,1,2,1,2012-02-20 06:53:34,2012-02-20 06:53:34
9f608411cbea9b2626f307008d82a26667872ccf...6df925bc756ab6f9e7a26d4b9c5afc858b34b2d2,3,3,1,4,3,2012-02-20 07:51:59,2012-02-20 07:51:59
6df925bc756ab6f9e7a26d4b9c5afc858b34b2d2...7ef7547a1421825cb73382ad6317aba8affe3dc8,7,63,19,82,14,2012-02-20 20:38:49,2012-02-20 20:38:49
1a781a707e0785a1abd079a9c29628b0d8d1867d...dd94f8d50971e657cd0b2b388965ba82b436354f,3,4,8,12,6,2012-02-27 07:30:15,2012-02-27 07:30:15
dd94f8d50971e657cd0b2b388965ba82b436354f...163f58ff8133a892bf1bcf57f5d00d466d441a3d,3,8,2,10,2,2012-02-27 07:31:12,2012-02-27 07:31:12
43760eb2029c73b6be6b0dbeb753be1e247697d9...0a8efd5320dca80ad911c2d5e4a9404a010ff78e,7,575,207,782,211,2012-02-26 03:21:05,2012-02-26 03:21:05
0a8efd5320dca80ad911c2d5e4a9404a010ff78e...d12737719f3750037409de299b4040d3d09dcf0f,4,196,499,695,197,2012-02-28 04:55:35,2012-02-28 04:55:35
d12737719f3750037409de299b4040d3d09dcf0f...0b78033f0b5645778d42289a5820a7708b4a71a7,2,8,15,23,5,2012-02-28 05:21:25,2012-02-28 05:21:25
d335adf644b213a5ebc9cee3f37f781ad55194ef...11064c4d344a9c922f05fba9783f36767a5febf1,1,173,10,183,4,2012-04-08 00:17:39,2012-04-08 00:17:39
d335adf644b213a5ebc9cee3f37f781ad55194ef...fedce0cec70a56713f95d36585f9e3adaad2c332,1,8,1,9,3,2012-04-05 20:08:32,2012-04-05 20:08:32
d335adf644b213a5ebc9cee3f37f781ad55194ef...ff57f595624de553dabc9fe334c273d6376763a1,1,1,1,2,1,2012-04-03 10:15:36,2012-04-03 10:15:36
d335adf644b213a5ebc9cee3f37f781ad55194ef...574592cba5dc8c7db9f62b83ff91bc679f98a10e,1,1,1,2,1,2012-04-01 15:25:43,2012-04-01 15:25:43
d335adf644b213a5ebc9cee3f37f781ad55194ef...6564afbe7314d8bccdf202d3e4d9c02a070d6f96,1,1,1,2,1,2012-03-29 11:56:53,2012-03-29 11:56:53
d335adf644b213a5ebc9cee3f37f781ad55194ef...2165ab262085c4c7e072453cbcaaed763742c94c,1,9,0,9,1,2012-03-28 14:05:49,2012-03-28 14:05:49
d335adf644b213a5ebc9cee3f37f781ad55194ef...de0aaff4338acc72b5c6220f4731b7fa7c52ac2c,2,10,0,10,3,2012-03-24 17:53:27,2012-03-24 17:53:27
d335adf644b213a5ebc9cee3f37f781ad55194ef...035b85eebaaec9dded4c46b8864c63ff20bdd4fd,1,13,13,26,3,2012-03-23 19:37:40,2012-03-23 19:37:40
035b85eebaaec9dded4c46b8864c63ff20bdd4fd...c7afe382a26834cce5b8bf2fc7333ce7e945a2d4,7,38,37,75,14,2012-03-24 03:56:04,2012-03-24 03:56:04
d839bf961bf2292e55516847a96a2ff231d69582...0e73a0e94b70eab01ca0cafbec48a892531304af,1,6,6,12,3,2012-03-23 00:09:54,2012-03-23 00:09:54
8e0afbeaa42dfabb75817b7fc1c677cd372c8c43...527fb87dadd1e677f132ca3db0b02825d5bd57e5,1,1,1,2,1,2012-03-18 04:29:56,2012-03-18 04:29:56
527fb87dadd1e677f132ca3db0b02825d5bd57e5...5a2c7eb50abae8d07cebb6b0e984f7e63843cf75,3,14,0,14,4,2012-03-19 22:18:00,2012-03-19 22:18:00
5a2c7eb50abae8d07cebb6b0e984f7e63843cf75...bf59220b87a3b5960381f500dbc6a310a8aef60b,3,2,2,4,2,2012-03-19 22:19:01,2012-03-19 22:19:01
bf59220b87a3b5960381f500dbc6a310a8aef60b...83a7a698939b5b4cba3c04a86befc12b9005df3d,2,18,1,19,2,2012-03-19 22:33:28,2012-03-19 22:33:28
83a7a698939b5b4cba3c04a86befc12b9005df3d...67f199678c6f764f2812260f42b553b22ec740f8,6,14,11,25,11,2012-03-19 22:48:57,2012-03-19 22:48:57
67f199678c6f764f2812260f42b553b22ec740f8...05e0d5f3d931e84f3bc86a5c1153e710237cb53a,1,3,1,4,2,2012-03-19 23:09:08,2012-03-19 23:09:08
05e0d5f3d931e84f3bc86a5c1153e710237cb53a...384a082e8d220115d0eb94b0c57d837b625ad2ab,1,1,1,2,1,2012-03-20 03:24:46,2012-03-20 03:24:46
384a082e8d220115d0eb94b0c57d837b625ad2ab...07d23b927ee4eefdee51d4fcbffb3dece33be698,4,33,1,34,4,2012-03-20 03:29:22,2012-03-20 03:29:22
07d23b927ee4eefdee51d4fcbffb3dece33be698...630ff4ff7dca4d51474b8b4168e48e60fc858e0c,3,2,2,4,2,2012-03-20 03:51:20,2012-03-20 03:51:20
630ff4ff7dca4d51474b8b4168e48e60fc858e0c...bce33bbb091e66a58418395188ea50be151f3f8e,3,2,4,6,4,2012-03-20 04:10:55,2012-03-20 04:10:55
bce33bbb091e66a58418395188ea50be151f3f8e...63bd7cb478500463ac7339667d89792f7108f3c0,3,14,14,28,4,2012-03-20 04:39:39,2012-03-20 04:39:39
63bd7cb478500463ac7339667d89792f7108f3c0...663e41d74f6369812da29a1dd66b0b1fcfd22827,5,12,6,18,4,2012-03-20 06:13:55,2012-03-20 06:13:55
8e0afbeaa42dfabb75817b7fc1c677cd372c8c43...bf09c979ca8f8275806e8ca3eef57ad484b2951e,3,3,2,5,3,2012-03-15 19:21:27,2012-03-15 19:21:27
bf09c979ca8f8275806e8ca3eef57ad484b2951e...99e96f64f7dbaba8c83d7d69e64247969765b9e8,2,4,0,4,2,2012-03-15 19:39:28,2012-03-15 19:39:28
8e0afbeaa42dfabb75817b7fc1c677cd372c8c43...51f37cbb8105ad632fae7367912130aafc0f6c86,2,7,3,10,4,2012-03-15 18:34:50,2012-03-15 18:34:50
51f37cbb8105ad632fae7367912130aafc0f6c86...2c4230e2d3abde2bbf3b9d2798d8c9ce2c9f81da,2,12,0,12,2,2012-03-15 19:46:27,2012-03-15 19:46:27
8e0afbeaa42dfabb75817b7fc1c677cd372c8c43...1a1cab2d0612d150045947da183fff2464e892e0,1,8,8,16,4,2012-03-15 17:11:17,2012-03-15 17:11:17
0f57bdab754d72697f412eb32723a83b2de9921e...d7af2714c66ce19ba63e0871837f35dac73ecf66,7,81,126,207,21,2012-03-22 23:02:00,2012-03-22 23:02:00
a613a8ebd01ab9206bc1a84a0bf6945a1238aa5e...305374ab1a49a1bdfbab0e52a2be218fc42f3cc0,4,26,5,31,22,2012-03-10 19:23:05,2012-03-10 19:23:05
fbebb046f7134eaed90492bfc67720337c4b625e...bd55824827079d6d7c4cbef9ac6e2cbd347b8466,3,2,0,2,2,2012-02-28 16:52:59,2012-02-28 16:52:59
7bf341964790937c2fe77875459b064bc63d2e29...d3e922f0c8dc309bc609ebd75fd7e90134c1eaca,6,107,43,150,32,2012-03-05 08:29:16,2012-03-05 08:29:16
d3e922f0c8dc309bc609ebd75fd7e90134c1eaca...a95c15a5307bd5c0028eaad51a4ceddc5498e436,4,7,6,13,7,2012-03-05 08:32:02,2012-03-05 08:32:02
d149a131c14bb8be32ecc306f2128dddec9e83bf...45cec4a6fa0145611dcc9ac4b4d6f56aa759e7e8,2,62,0,62,6,2012-02-21 18:07:55,2012-02-21 18:07:55
45cec4a6fa0145611dcc9ac4b4d6f56aa759e7e8...1cfb3fd03a529847ec1023c873fe71fbc279bfc1,1,6,6,12,6,2012-02-21 18:19:15,2012-02-21 18:19:15
d149a131c14bb8be32ecc306f2128dddec9e83bf...e423fc26297097d509a2557c2b43fe8740e6bcaa,1,2,0,2,2,2012-02-21 15:32:57,2012-02-21 15:32:57
d149a131c14bb8be32ecc306f2128dddec9e83bf...f50b2c9b92f6a70a636da0a65b601e65f41daee9,1,1,0,1,1,2012-02-21 08:20:46,2012-02-21 08:20:46
d149a131c14bb8be32ecc306f2128dddec9e83bf...dfd03261863b2ccd98cc8ea746e9d5e515ac0b6e,4,4,0,4,4,2012-02-21 07:17:16,2012-02-21 07:02:57
74521e835489066d58813c960bc98d1713ea6074...9a68f115e7d850c47297bc7931fcbd1125b39f59,2,7,11,18,7,2012-01-23 23:07:07,2012-01-23 23:07:07
9a68f115e7d850c47297bc7931fcbd1125b39f59...b4b1ef68398b68dcdfa29465d06cd76d6bf2c49d,16,2868,3316,6184,240,2012-01-23 23:17:32,2012-01-23 23:17:32
b4b1ef68398b68dcdfa29465d06cd76d6bf2c49d...82de03b67cf729291ea5a73741e44838a42940f8,10,247,257,504,140,2012-01-24 03:55:00,2012-01-24 03:55:00
82de03b67cf729291ea5a73741e44838a42940f8...16440eea92e97ae1027ba867839170bfe88ae38d,1,1,1,2,1,2012-01-24 03:59:05,2012-01-24 03:59:05
22fa3712598f6c7d7bcff44ed5ce01f96cbc6ca6...00d925819405ef46fb09d4bef83761ea121a9364,4,7,13,20,10,2012-01-23 19:35:39,2012-01-23 19:35:39
00d925819405ef46fb09d4bef83761ea121a9364...a7bf0295fbf3ce9abc1ca44680f4a6eaf17339b5,6,91,360,451,34,2012-01-23 19:55:04,2012-01-23 19:55:04
a7bf0295fbf3ce9abc1ca44680f4a6eaf17339b5...ea8f5883fd58ff5e356944e4a93543c05abf2220,2,34,4,38,4,2012-01-23 20:04:48,2012-01-23 20:04:48
719713ca8730d92d3510e6d4a7cc542fd57fdeef...2187e0838f522c102a8b5104970a9f129cdd001a,2,34,8,42,10,2012-01-22 05:35:20,2012-01-22 05:35:20
719713ca8730d92d3510e6d4a7cc542fd57fdeef...e0238bfb08b67c089c1c609e9e68e5252e0ba992,11,36,35,71,33,2012-01-21 23:24:06,2012-01-21 23:24:06
e0238bfb08b67c089c1c609e9e68e5252e0ba992...0f2dd75c975b56f082b82a464065c3b2ccc7af86,1,1,1,2,1,2012-01-22 06:35:03,2012-01-22 06:35:03
719713ca8730d92d3510e6d4a7cc542fd57fdeef...4a5867b18b0320b7365337c192b9e1bfe555f864,32,0,0,0,0,2012-01-21 21:52:39,2012-01-21 21:52:39
4b165332be72e8ba9315d4cb709dce5cb0a0db2c...b8c3c5c19b2154d157256cec839c9b0a40b3e7b4,6,8,8,16,6,2014-10-30 03:45:04,2014-10-30 03:45:04
e27dc5d71e962effae1ec3b67fa72f77b14d3d98...30df201abc482c5545bf4995feb957dec98d6d21,3,10,6,16,4,2014-11-05 17:35:13,2014-11-05 17:35:13
542c1040aae2da79432168e46d8e8efcd1363f48...07c1881bc27eacba74f4d975ca3428a24abd4940,2,127,245,372,63,2014-11-12 07:51:28,2014-11-12 07:49:29
07c1881bc27eacba74f4d975ca3428a24abd4940...143c4a2f8fc91513dc656e7bf3f234d21a45f849,1,1,1,2,1,2014-11-12 16:51:35,2014-11-12 16:51:35
143c4a2f8fc91513dc656e7bf3f234d21a45f849...9a7e365c2c4360335d25246dac11afb1f577210a,32,102,102,204,96,2014-11-12 17:03:16,2014-11-12 17:03:16
856d31b373622b9bc45cc893835fc9683ee708c0...ddf39cc2e7e1c676d5141e259e362e241e4c6f0f,11,15,10,25,11,2014-11-13 00:32:51,2014-11-13 00:32:51
856d31b373622b9bc45cc893835fc9683ee708c0...82eaefcd43fd6b10bda9c9b3f0d3b1cceb508c74,1,1,1,2,1,2014-11-13 00:16:10,2014-11-13 00:16:10
856d31b373622b9bc45cc893835fc9683ee708c0...75dfed7f8fb8d1f9d4b643429209e2e1b235e296,1,1,1,2,1,2014-11-12 21:31:36,2014-11-12 21:31:36
75dfed7f8fb8d1f9d4b643429209e2e1b235e296...bf43c9cf9f8127e7d3ad2b634413e7185bacc7b2,1,1,1,2,1,2014-11-13 15:12:31,2014-11-13 15:12:31
001d5e00c58bbb8e4d34c085c5b27b214a475bd5...3b2d1570fa85c0faac0e7da65b415e59996f4300,1,4,4,8,2,2014-11-12 03:26:10,2014-11-12 03:26:10
3b2d1570fa85c0faac0e7da65b415e59996f4300...5ba52001952b6a0744fc17252c0a07b97a836583,1,5,5,10,2,2014-11-12 03:29:56,2014-11-12 03:29:56
63767f8806f29b8b995533fcfefba88765fb402c...e9d6756a1ac76a9db31a41e8e03f663bedc41b70,12,12,12,24,12,2014-06-12 04:00:02,2014-06-12 04:00:02
5728b5791c94b5f4df662045552e66bc05d85d31...64fdbd762190fb1d2191e0e6aac1bccc621b54db,2,2,2,4,2,2014-05-05 19:31:17,2014-05-05 19:31:17
cb19f4f2279bc7e8dd3255585d5e71767933e679...ac18e5811d136c22d7f46d06f97bcc12ee0f665f,1,1,1,2,1,2014-07-06 22:08:33,2014-07-06 22:08:33
ac18e5811d136c22d7f46d06f97bcc12ee0f665f...354d4236688c5370cc345bbbde8cb5ef917ff2a1,5,36,27,63,23,2014-07-06 22:08:37,2014-07-06 22:08:37
354d4236688c5370cc345bbbde8cb5ef917ff2a1...e2029e122c58d5bca7f439ea4c8220957acc8903,8,8,8,16,11,2014-07-06 22:09:20,2014-07-06 22:09:20
e2029e122c58d5bca7f439ea4c8220957acc8903...b44d4ef72453133778159874834e4ec851310fbd,1,1,1,2,1,2014-07-06 22:35:24,2014-07-06 22:35:24
f0daa64a29a66a663f6fedb9d8687524af754436...5d8880fdfae7de50d867eb9695b704f50ab77775,4,41,36,77,5,2014-05-08 02:38:27,2014-05-08 02:38:27
f0daa64a29a66a663f6fedb9d8687524af754436...7d0f7e84412ab8018e6e9211f9e6a0f47d1100ce,4,31,0,31,4,2014-05-07 23:12:42,2014-04-29 22:54:05
7d0f7e84412ab8018e6e9211f9e6a0f47d1100ce...bdd822a94cdf2d452e067569e76ca1537dc74d8d,4,9,8,17,5,2014-05-08 03:19:40,2014-04-29 22:56:18
6f88238a6beb21dbcb817447e591030f839d11f8...9ed9eb97ee09e514da942d680dac032628124816,2,6,2,8,4,2014-07-07 07:56:06,2014-07-07 07:56:06
7933a50ee50e98c12caec7a4c197e92b9cd451be...c08e275000330db6d8883de6af2243216cc79837,1,2,2,4,2,2014-07-06 06:49:45,2014-07-06 06:49:45
912c4bcbe4174e4753c61b148a7f51f0c95f610d...5713bd74d617126796205d4ee29bfc6ff192ad39,11,112,48,160,46,2014-07-24 03:32:05,2014-07-24 03:32:05
9e1652aa50a9d315d333362b68de88e931dc872b...250e021ff1206a70188e46bc5ade81b491d50196,5,1091,0,1091,5,2014-06-10 05:30:16,2014-01-08 12:02:35
250e021ff1206a70188e46bc5ade81b491d50196...7d1365ce1cb5073754d92f2bd3c99689a958c5f6,5,68,1066,1134,27,2014-06-10 05:30:16,2014-02-11 08:04:53
7d1365ce1cb5073754d92f2bd3c99689a958c5f6...5057e7c7b8becf0adc25919336d05cb8dad4bf62,1,6,5,11,6,2014-06-10 05:30:17,2014-03-17 05:42:05
5057e7c7b8becf0adc25919336d05cb8dad4bf62...89c0e4d2abdf043ef77f5369c8936d2ed4286c43,6,11,11,22,4,2014-06-10 05:30:17,2014-03-20 05:26:37
89c0e4d2abdf043ef77f5369c8936d2ed4286c43...1b8935ee9514873d000b15dedeedb98a5457dd8b,4,13,5,18,5,2014-06-10 05:30:17,2014-03-22 06:33:53
1b8935ee9514873d000b15dedeedb98a5457dd8b...82bd8b6dfd0e590e9445d379ed6020f9d4c42a1f,2,2,2,4,2,2014-06-10 06:29:44,2014-06-10 06:29:44
696632d7dac91dba3f83c056263b527c56b63991...2b302f69eea416bc85e7827b7d7a74d49f879662,13,1551,1526,3077,478,2014-06-12 18:11:04,2014-06-12 18:11:04
2b302f69eea416bc85e7827b7d7a74d49f879662...37acbb983d02518e5d90857a2f2b42bf9c00a4a0,1,1,1,2,1,2014-06-13 18:37:40,2014-06-13 18:37:40
f1c1469b839d09fbc437de24afef5644b3c80305...5a3f1a90ba37a4d1c090dc1fa59b9f4501481adb,7,53,14,67,16,2014-01-26 22:22:06,2014-01-20 21:06:13
bd6751e932eebecb087880a3d999a13289ce7372...64e81324261548a8de8cda5fde4b87d0f7a8f8fb,6,9,4,13,6,2014-01-24 17:55:59,2014-01-24 17:55:59
86a5846ada371ea3056e9e1c71581dece141cd0d...87e5b16b177f5e6518f6850b708bd1ee878af9aa,1,0,6,6,1,2014-01-26 00:35:13,2014-01-26 00:35:13
87e5b16b177f5e6518f6850b708bd1ee878af9aa...9ec1e8694b3b9f8afd0090954075dc3df2fe9209,1,1,1,2,1,2014-01-26 00:38:47,2014-01-26 00:38:47
57597c4761adb2f6e838f67dbcf23a00ef783441...494014babe34f06dbf6fab9614c52c6cf83a59be,1,1,1,2,1,2014-01-22 18:04:19,2014-01-22 18:04:19
163f58ff8133a892bf1bcf57f5d00d466d441a3d...7bdd9551edddd379ac999d034aa5c435fbba9bc9,3,3,3,6,3,2012-02-28 02:48:28,2012-02-28 02:48:28
7bdd9551edddd379ac999d034aa5c435fbba9bc9...af8261af93c061f9bcc54bd948bd4652bd887c66,3,2,2,4,2,2012-02-28 03:09:44,2012-02-28 03:09:44
af8261af93c061f9bcc54bd948bd4652bd887c66...d57598827f804f75b1eb12fc7098b58f152830ea,3,2,2,4,2,2012-02-28 03:40:07,2012-02-28 03:40:07
d57598827f804f75b1eb12fc7098b58f152830ea...7525aac8306b0c69f56e479c9ecf4fa8ff55c712,3,0,2,2,2,2012-02-28 03:44:16,2012-02-28 03:44:16
7525aac8306b0c69f56e479c9ecf4fa8ff55c712...ca9588c89656855bcc36c2109070677d9447d2b9,3,2,6,8,2,2012-02-28 03:47:21,2012-02-28 03:47:21
163f58ff8133a892bf1bcf57f5d00d466d441a3d...ae3382d797e76a41be8bff9e7ac4ed3d06784a57,7,712,286,998,237,2012-02-28 02:15:59,2012-02-28 02:15:59
ae3382d797e76a41be8bff9e7ac4ed3d06784a57...86159872433e39800374d563dde28afaa29545f0,7,241,216,457,76,2012-02-28 02:21:21,2012-02-28 02:21:21
86159872433e39800374d563dde28afaa29545f0...1aeca545c8708dce6d05e7698589a20b98b39a76,4,377,585,962,134,2012-03-04 22:06:30,2012-03-04 22:06:30
1aeca545c8708dce6d05e7698589a20b98b39a76...2f598e35a0954532388960c5cf0e2855a076d48c,2,3,3,6,3,2012-03-04 22:11:51,2012-03-04 22:11:51
2f598e35a0954532388960c5cf0e2855a076d48c...3524aa909cd0cef16c9d244bd21da0dfd7b48cf9,4,135,135,270,69,2012-03-04 22:21:54,2012-03-04 22:21:54
3524aa909cd0cef16c9d244bd21da0dfd7b48cf9...29c63fdb6ae4877160dbad05cdcf34f8cf1f66ad,2,6,6,12,3,2012-03-04 22:27:13,2012-03-04 22:27:13
c414e57dccf0d0177f42df10d2f36f79581563d6...f4e879a93612e8ec121985f075812f63c0d4f355,4,6,5,11,4,2012-03-10 19:27:07,2012-03-10 19:27:07
f4e879a93612e8ec121985f075812f63c0d4f355...5d961eaeb385373786dd1b4cb877247bdb6d5475,3,2,2,4,2,2012-03-10 19:29:57,2012-03-10 19:29:57
5d961eaeb385373786dd1b4cb877247bdb6d5475...9ebc6b4c9700610fbc83173c95f5464999f83bff,3,94,94,188,52,2012-03-10 19:37:34,2012-03-10 19:37:34
11064c4d344a9c922f05fba9783f36767a5febf1...6506ede6323ee60d4d7f8171937d92141a64e09e,3,1734,0,1734,3,2012-04-15 23:45:13,2012-04-15 23:45:13
11064c4d344a9c922f05fba9783f36767a5febf1...16855b920e05b86aa7c54bfef050f1a81e5526cc,1,1,1,2,1,2012-04-15 02:31:07,2012-04-15 02:31:07
1d30225e2c194e50840e002c085a998d3f3a33dc...3ecf1098357618092280b2e7c562a1ef5bf11959,4,28,6,34,5,2012-04-07 23:44:03,2012-04-07 23:44:03
3ecf1098357618092280b2e7c562a1ef5bf11959...a20cd66ba479053f060b1a7ed61cb1f0cd90450f,3,8,8,16,8,2012-04-07 23:49:06,2012-04-07 23:49:06
28c4ed824ecec842b550970c8d29e60c89579ee3...0b2d23d4439429cdbd0758d01f4602e6b2afde6d,3,6,0,6,2,2012-04-08 06:41:09,2012-04-08 06:41:09
7bf4c8e76e1a77825ce560e4695594c02971d3b1...2988de6377d8ccc456af6d4ef1b3064c6c5a1f3b,3,30,30,60,20,2012-04-03 05:38:12,2012-04-03 05:37:58
2988de6377d8ccc456af6d4ef1b3064c6c5a1f3b...4462f24753463dda66a8301ff10b8e7c0abc5ac8,3,2,2,4,2,2012-04-03 05:40:06,2012-04-03 05:40:06
4462f24753463dda66a8301ff10b8e7c0abc5ac8...2ea437f353a636a277320513db04ced4fc0f7da2,3,11,2,13,2,2012-04-03 05:49:19,2012-04-03 05:49:19
7bf4c8e76e1a77825ce560e4695594c02971d3b1...030265eaecf2c7287df6fac1ba45e1057ff37483,4,90,53,143,27,2012-04-02 08:52:06,2012-04-01 22:22:52
030265eaecf2c7287df6fac1ba45e1057ff37483...4b81c0dff371edad2afd5df77c957265235e34b1,4,110,89,199,28,2012-04-05 20:13:16,2012-04-05 19:48:17
4b81c0dff371edad2afd5df77c957265235e34b1...5b85ed181a75b286ac4e898173da7b65e20e6d8a,3,2,2,4,2,2012-04-10 21:22:17,2012-04-10 21:19:10
2f4810e72ffa242aabeab5088d522d3927a3df68...37745cd8997bdc1d0bb21c276a7aa671bb018eed,6,122,40,162,45,2012-03-31 07:53:38,2012-03-31 07:53:38
37745cd8997bdc1d0bb21c276a7aa671bb018eed...56ecc6ba96550d8e66d0484c21fc20da5f8e52e6,4,71,0,71,5,2012-03-31 19:31:56,2012-03-31 19:31:56
56ecc6ba96550d8e66d0484c21fc20da5f8e52e6...2355fd224ddcd571765c5ad2f2242dac65789aa4,9,46,61,107,28,2012-04-01 04:06:16,2012-04-01 04:06:16
2355fd224ddcd571765c5ad2f2242dac65789aa4...f37d9aeaef12c3019112fa915b7bd4d927652a15,3,11,5,16,6,2012-04-01 04:31:01,2012-04-01 04:31:01
f37d9aeaef12c3019112fa915b7bd4d927652a15...452ddc0f0dd5cfd3bb867e17d603c98d6db2ec19,3,14,14,28,14,2012-04-01 04:36:45,2012-04-01 04:36:45
452ddc0f0dd5cfd3bb867e17d603c98d6db2ec19...d652af10971d79cde92336700e156c63ff2c0b24,7,42,0,42,8,2012-04-01 06:53:54,2012-04-01 06:53:54
d652af10971d79cde92336700e156c63ff2c0b24...33fa705c7fa9cc9e8c255cc2e161336ba21b3cff,3,2,12,14,4,2012-04-01 07:15:04,2012-04-01 07:15:04
33fa705c7fa9cc9e8c255cc2e161336ba21b3cff...fe05f9aeb259733de4598014db9df9193cc01ea2,7,56,21,77,14,2012-04-01 07:59:34,2012-04-01 07:59:34
fe05f9aeb259733de4598014db9df9193cc01ea2...647f1c98eda0f150e54e9193181acb462a3b9357,6,35,1,36,5,2012-04-01 08:05:00,2012-04-01 08:05:00
feccc6e705cad012818ff67c0666239bf29b71c7...04baa07547692f75dd708afaf50700075df1a60a,4,18,6,24,4,2012-03-29 01:25:27,2012-03-29 01:25:27
04baa07547692f75dd708afaf50700075df1a60a...a9f9949b3e4a0b3cd84f3088c050296e18a0f8df,3,82,92,174,22,2012-03-29 02:41:23,2012-03-29 02:41:23
a9f9949b3e4a0b3cd84f3088c050296e18a0f8df...2bbc9a1cb225ded877b9228ebf714ccb74f07c6d,1,15,15,30,1,2012-03-29 03:03:57,2012-03-29 03:03:57
2bbc9a1cb225ded877b9228ebf714ccb74f07c6d...8ea8c312ea631ec7f8c80ae8751da18e93094a4e,3,36,22,58,10,2012-03-29 19:35:06,2012-03-29 19:35:06
8ea8c312ea631ec7f8c80ae8751da18e93094a4e...30b3f47e31487b9f7db6a42ed633597c3f5e764c,3,2,2,4,2,2012-03-29 19:48:37,2012-03-29 19:48:37
30b3f47e31487b9f7db6a42ed633597c3f5e764c...422d04cb2b59ced380c2fa6dcb637dab70a916a3,3,38,40,78,12,2012-03-29 20:51:23,2012-03-29 20:51:23
422d04cb2b59ced380c2fa6dcb637dab70a916a3...0665c3ebf781e228b32c5714dd36f5279b4fb211,3,2,2,4,2,2012-03-29 20:55:56,2012-03-29 20:55:56
0665c3ebf781e228b32c5714dd36f5279b4fb211...2dc979a2029d909945011a8e6dac3543aa9f0198,3,2,2,4,2,2012-03-29 21:14:17,2012-03-29 21:14:17
223c8358ceb111fc7a9fc48f88b913e88df4006f...1837b8ef2c1a28f966965985c33d38a8f6a72438,3,8,2,10,3,2012-03-25 07:20:30,2012-03-25 07:20:30
1837b8ef2c1a28f966965985c33d38a8f6a72438...d1864b3608d215ee22daf96268f878b1818c6de1,17,14,0,14,14,2012-03-25 07:46:03,2012-03-25 07:46:03
d1864b3608d215ee22daf96268f878b1818c6de1...a7b8e52f8e08cc821d7324153885c085fad25c1a,9,65,70,135,22,2012-03-25 08:12:51,2012-03-25 08:12:51
a7b8e52f8e08cc821d7324153885c085fad25c1a...6c5c29ada2430c884888c9138ba09b0030584d17,4,14,1,15,3,2012-03-25 08:21:47,2012-03-25 08:21:47
6c5c29ada2430c884888c9138ba09b0030584d17...b81a082cd13759bd5f0ff2a90513a56d59ace313,3,10,3,13,5,2012-03-25 19:32:29,2012-03-25 19:32:29
b81a082cd13759bd5f0ff2a90513a56d59ace313...a5552a1d700a1caa2d87ea4bbccc59205b6e72f9,7,54,50,104,16,2012-03-25 19:42:47,2012-03-25 19:42:47
a5552a1d700a1caa2d87ea4bbccc59205b6e72f9...a62810918f8a27b5755258521422eb912a1edfd8,16,17,16,33,16,2012-03-25 20:33:36,2012-03-25 20:33:36
a62810918f8a27b5755258521422eb912a1edfd8...c0f28d81b06c9004d5860a623e333848710b5d53,4,46,0,46,22,2012-03-25 21:28:24,2012-03-25 21:28:24
c0f28d81b06c9004d5860a623e333848710b5d53...d0526e31fa291bd1ef943081ff7248e734edccb7,3,6,0,6,2,2012-03-25 21:31:04,2012-03-25 21:31:04
d0526e31fa291bd1ef943081ff7248e734edccb7...cbd77d0aeba4b4105dfcc51dc1298a0d00452869,3,5,0,5,2,2012-03-25 21:37:19,2012-03-25 21:37:19
cbd77d0aeba4b4105dfcc51dc1298a0d00452869...4c3e7690ba8b85b08c78344fb62cdef645d23093,3,6,0,6,2,2012-03-25 21:46:47,2012-03-25 21:46:47
4c3e7690ba8b85b08c78344fb62cdef645d23093...8d52e6d458e10c618698cc7698f252003e727eb7,3,4,4,8,4,2012-03-25 21:51:54,2012-03-25 21:51:54
f9f03d8976710b8aa10abd5f89c0a699758ff0a0...ef5ac02b698ffab3a42d21f20859b70df85543c0,4,53,14,67,13,2012-03-25 00:50:21,2012-03-25 00:50:21
ef5ac02b698ffab3a42d21f20859b70df85543c0...bccc2cb7191eb54a4d67563625a748d7ecd381d4,16,128,32,160,34,2012-03-25 01:20:09,2012-03-25 01:20:09
bccc2cb7191eb54a4d67563625a748d7ecd381d4...6dc59a9c3e0facab3abed7cb66d90c2316530014,3,4,4,8,4,2012-03-25 01:45:12,2012-03-25 01:45:12
6dc59a9c3e0facab3abed7cb66d90c2316530014...f02d017ffa2f63609db034410979f62fde328816,25,34,22,56,26,2012-03-25 01:59:04,2012-03-25 01:59:04
f02d017ffa2f63609db034410979f62fde328816...0dfff052cb27efdb81883449112adf6e0960aea4,1,2,0,2,1,2012-03-25 02:02:55,2012-03-25 02:02:55
0dfff052cb27efdb81883449112adf6e0960aea4...3e7920820a4c8b93282628ade9281ff0d4484a45,3,3,1,4,2,2012-03-25 03:01:51,2012-03-25 03:01:51
d8acc062c1503fbda10bfa5041677c1459654b62...4bcb89946bf556ff524a67c82e079f43b045e747,3,20,0,20,2,2012-04-15 01:18:11,2012-04-15 01:18:11
4bcb89946bf556ff524a67c82e079f43b045e747...def7ae7798916f105ba489b617cfa2b4af16afa4,3,2,2,4,2,2012-04-15 01:30:43,2012-04-15 01:30:43
def7ae7798916f105ba489b617cfa2b4af16afa4...fc7ae48c95af554cb36e4b52482c262ac34aa47f,4,88,45,133,32,2012-04-15 01:47:27,2012-04-15 01:47:27
663e41d74f6369812da29a1dd66b0b1fcfd22827...d5fb653914617d63739142f6ecef00afd4d3c796,5,4,12,16,6,2012-03-22 04:35:02,2012-03-22 04:35:02
663e41d74f6369812da29a1dd66b0b1fcfd22827...cb8dcfcebfbbd8f2ea26b786b44992f00d35ac30,3,32,8,40,10,2012-03-21 05:43:27,2012-03-21 05:43:27
b59cb505f8cf4e0010f422f0a83d9c001055cbd7...89ea238c32716aabe59dcab7d4e2480858bbba91,3,4,4,8,4,2012-03-23 00:13:20,2012-03-23 00:13:20
78e37e7d21eaa52e88f77df40c1334bce32ec84c...e0c85fb69cfc4a9956856e0b14afb12def2fccf0,4,22,22,44,12,2012-03-23 00:18:07,2012-03-23 00:18:07
e0c85fb69cfc4a9956856e0b14afb12def2fccf0...42f636032cf8ce66a61ef1fbdcac60b1d498aaf5,3,2,2,4,2,2012-03-23 00:22:19,2012-03-23 00:22:19
42f636032cf8ce66a61ef1fbdcac60b1d498aaf5...1a6a1828bf92aec044387ff7020a1f77abcd6730,3,2,12,14,4,2012-03-23 00:23:20,2012-03-23 00:23:20
1a6a1828bf92aec044387ff7020a1f77abcd6730...ceab161324119c1392e8c26b68d2a14c32d43ab8,3,9,9,18,9,2012-03-23 00:31:09,2012-03-23 00:31:09
ceab161324119c1392e8c26b68d2a14c32d43ab8...b7b84c7a0dfaad5134258b5a50e8d42bd0656b81,5,4,4,8,4,2012-03-23 00:36:32,2012-03-23 00:36:32
b7b84c7a0dfaad5134258b5a50e8d42bd0656b81...edca6f28f0ae78cdc3dbfe0ce5183153830a77ee,3,2,2,4,4,2012-03-23 00:41:20,2012-03-23 00:41:20
edca6f28f0ae78cdc3dbfe0ce5183153830a77ee...254bb40f006ebe0c546a9840bd3cae51047e3628,3,154,2,156,4,2012-03-23 00:49:13,2012-03-23 00:49:13
254bb40f006ebe0c546a9840bd3cae51047e3628...b011daf67fbb3cde6c33b40a0347d7e1a8d183ad,3,386,64,450,38,2012-03-23 02:36:55,2012-03-23 02:36:55
b011daf67fbb3cde6c33b40a0347d7e1a8d183ad...1852d077bfa15308808c470a031f6e6b5c3dc8d2,9,141,4,145,10,2012-03-23 04:08:41,2012-03-23 04:08:41
1852d077bfa15308808c470a031f6e6b5c3dc8d2...dbadac183df8efff4307b2c28daac8414165feaa,3,4,0,4,2,2012-03-23 04:09:27,2012-03-23 04:09:27
dbadac183df8efff4307b2c28daac8414165feaa...bdf8a6966be7d2b2e62ea1860501fbdf59ef671d,3,2,4,6,2,2012-03-23 04:17:55,2012-03-23 04:17:55
bdf8a6966be7d2b2e62ea1860501fbdf59ef671d...ab068f6fda525236220af6e1bf879a677ed6bfc0,7,140,456,596,17,2012-03-23 04:33:06,2012-03-23 04:33:06
ab068f6fda525236220af6e1bf879a677ed6bfc0...20da2c8ea08da9d15b72844f54bb91c9cba8b28e,5,337,0,337,5,2012-03-23 04:54:54,2012-03-23 04:54:54
20da2c8ea08da9d15b72844f54bb91c9cba8b28e...50b2245be5bd7cd12d37e38a00c4978a211bdcd3,3,2,0,2,2,2012-03-23 05:06:23,2012-03-23 05:06:23
50b2245be5bd7cd12d37e38a00c4978a211bdcd3...ac64d9405b3f650704f2e63b52c26b9f6f792cb8,8,77,108,185,30,2012-03-23 06:09:31,2012-03-23 06:09:31
ac64d9405b3f650704f2e63b52c26b9f6f792cb8...303ba1326bbe367598ab4cc063b4607507208e56,1,2,2,4,1,2012-03-23 06:31:52,2012-03-20 05:01:00
303ba1326bbe367598ab4cc063b4607507208e56...7376eef378fe7d5e69b8b8cce93c7c64b751d55a,1,1,1,2,1,2012-03-23 06:31:52,2012-03-20 05:02:00
7376eef378fe7d5e69b8b8cce93c7c64b751d55a...7ea34ae0ef79c793e9a9d393b4eef825b71e84b5,1,2,2,4,1,2012-03-23 06:31:52,2012-03-21 20:00:58
7ea34ae0ef79c793e9a9d393b4eef825b71e84b5...c4fb7032690ed10162562dfbf893311389a64dee,3,9,7,16,4,2012-03-23 06:38:50,2012-03-23 06:38:50
c4fb7032690ed10162562dfbf893311389a64dee...a28fa20018a2529ecc5d91604486abbd0730b511,1,0,4,4,1,2012-03-23 06:49:39,2012-03-23 06:49:39
81f31d95c8e5894ebc02535613bed700452df778...b8d8ab1aad8d222e245f9dc0e6776e50c98bc48d,2,8,8,16,8,2012-03-23 07:28:58,2012-03-23 07:28:58
b8d8ab1aad8d222e245f9dc0e6776e50c98bc48d...2729d15742e61c0bf52966064eb260409b55a600,3,16,7,23,4,2012-03-23 07:37:15,2012-03-23 07:37:15
2729d15742e61c0bf52966064eb260409b55a600...ee3fc11addc047f82b0e3629e22a9e439fb789b6,3,4,2,6,2,2012-03-23 07:38:13,2012-03-23 07:38:13
ee3fc11addc047f82b0e3629e22a9e439fb789b6...281e058ef24aabd6ed47e3a2a9de7617dc685964,3,2,2,4,2,2012-03-23 07:40:10,2012-03-23 07:40:10
281e058ef24aabd6ed47e3a2a9de7617dc685964...f330de0b5c506267dcee917c23844697ee56230d,1,1,0,1,1,2012-03-23 07:51:31,2012-03-23 07:51:31
f330de0b5c506267dcee917c23844697ee56230d...e84161076b6c54be4ab0950f5d91c23456a967a7,3,4,2,6,2,2012-03-23 07:58:41,2012-03-23 07:58:41
e84161076b6c54be4ab0950f5d91c23456a967a7...622b8fa3f0d54e1c356fbe76d7bdc407919ff840,4,3,1,4,3,2012-03-23 08:13:20,2012-03-23 08:13:20
622b8fa3f0d54e1c356fbe76d7bdc407919ff840...de7aee246591f0be9ee58079175b42af7f5a6947,5,376,4,380,8,2012-03-23 08:28:04,2012-03-23 08:28:04
de7aee246591f0be9ee58079175b42af7f5a6947...5179df1928e82670a2f16ce414a42f1008c6d652,3,38,24,62,2,2012-03-23 08:31:22,2012-03-23 08:31:22
575072b74be5211aca48b22c1a891f930b793f66...8665fa8c50bf93844f692e954fd9669ba4b8bd3b,5,501,5,506,15,2012-02-21 23:18:05,2012-02-21 23:18:05
8665fa8c50bf93844f692e954fd9669ba4b8bd3b...e3ae517555fb9500493fde8efeef4a9788cd3264,4,13,11,24,8,2012-02-21 23:21:18,2012-02-21 23:21:18
d908731566a18a236609708238e697b4fc3c1355...664a5c443849880972cf62aa85306be269d09270,5,21,8,29,10,2012-02-21 21:43:13,2012-02-21 21:43:13
664a5c443849880972cf62aa85306be269d09270...bb16b9bef200f269af545e13280254edc6b3f880,3,4,6,10,2,2012-02-21 21:52:02,2012-02-21 21:52:02
16440eea92e97ae1027ba867839170bfe88ae38d...222067b360ecf4c6c082d3d364d464a26ef13ae9,2,233,233,466,136,2012-01-24 20:11:05,2012-01-24 20:11:05
16440eea92e97ae1027ba867839170bfe88ae38d...7d2e13f1b4e0de55f3107f2aaa22326e26866541,2,4,4,8,4,2012-01-24 18:43:13,2012-01-24 18:43:13
7d2e13f1b4e0de55f3107f2aaa22326e26866541...b0bd1d82035c22031e75627df0d3853c9d1e285c,3,15,2,17,4,2012-01-24 18:45:29,2012-01-24 18:45:29
16440eea92e97ae1027ba867839170bfe88ae38d...eab4d34ea06a3a76bba59faa5412affb8877b44c,1,0,1,1,1,2012-01-24 16:55:01,2012-01-24 16:55:01
16440eea92e97ae1027ba867839170bfe88ae38d...ec68b84123f7938c7216c63525f37d38572c5a9e,1,1,1,2,1,2012-01-24 16:27:19,2012-01-24 16:27:19
ea8f5883fd58ff5e356944e4a93543c05abf2220...91b32f47838d1da117998cee3ffa2ec5e5cd905c,1,2,2,4,2,2012-01-24 17:12:35,2012-01-24 17:12:35
91b32f47838d1da117998cee3ffa2ec5e5cd905c...37b38fe2a0cf34142eb617a1e6db155849cf55ac,2,2,2,4,2,2012-01-24 17:49:30,2012-01-24 17:49:30
37b38fe2a0cf34142eb617a1e6db155849cf55ac...04efc8d0a85f76402527e5e8658df43a8e4deb6c,1,1,1,2,1,2012-01-24 17:52:06,2012-01-24 17:52:06
ea8f5883fd58ff5e356944e4a93543c05abf2220...1fa2801c2f8ad1e3c319fd6fc0d2e8baddccf6cc,1,0,1,1,1,2012-01-23 20:22:08,2012-01-23 20:22:08
ea8f5883fd58ff5e356944e4a93543c05abf2220...ff113acba88806380b995fba894d77b562ca0e0a,3,10,3,13,5,2012-01-23 20:21:00,2012-01-23 20:21:00
d3817cf4662971599bd4baffc6284c7d9b03f0e2...4fe11342d049f708c3416e5b29fa3ed5bfc3b393,1,2,1,3,1,2012-01-22 05:46:47,2012-01-22 05:46:47
4fe11342d049f708c3416e5b29fa3ed5bfc3b393...6e490628d1be1a165d95ecf9817fdc7070069947,1,30,20,50,10,2012-01-22 06:06:36,2012-01-22 06:06:36
6e490628d1be1a165d95ecf9817fdc7070069947...373a54187ed5d1f5d00d725e6ef6b84d506f07a8,2,29,5,34,9,2012-01-22 07:02:29,2012-01-22 07:02:29
b8c3c5c19b2154d157256cec839c9b0a40b3e7b4...cf482dbb0b7dde622c454d88e178430198837a02,1,7,0,7,3,2014-10-30 08:35:53,2014-10-30 04:19:48
b8c3c5c19b2154d157256cec839c9b0a40b3e7b4...ea23969150e7329dd4e996b844db0282c4d2319d,1,3,3,6,1,2014-10-30 06:20:41,2014-10-30 06:20:41
b8c3c5c19b2154d157256cec839c9b0a40b3e7b4...6b7d6565dee1e3a8bc41c1104866ed00f9945981,5,10,10,20,10,2014-10-30 06:08:06,2014-10-29 20:07:13
03834866654025396530e5c4dddcd74cd214db30...d77546963b823629c86fcbec949d9fd895fc0922,1,13,19,32,7,2014-11-05 18:14:52,2014-11-05 18:10:48
806490499a9c204071cae322cfbc6a47caed8c02...13d2a03379711479b87f7645a5dd305a92d494a5,2,243,125,368,63,2014-11-13 20:01:12,2014-11-13 19:58:22
806490499a9c204071cae322cfbc6a47caed8c02...e5c888f4a2676614dc8986fd70b5c36d92d3906c,1,8,3,11,5,2014-11-13 19:32:33,2014-11-13 19:23:40
c022d88ac5674410fbba00c1c869c4da16fc0067...c97d4d648f43255e4aa59e7ff2ad292eab1bfaff,1,0,10,10,1,2014-11-25 02:38:01,2014-11-25 02:33:34
c022d88ac5674410fbba00c1c869c4da16fc0067...44447eeefe61dbb16cab59900c3c061d9f207fbc,37,168,168,336,168,2014-11-25 01:09:32,2014-11-25 01:09:32
5ba52001952b6a0744fc17252c0a07b97a836583...69d42cef141624491705b0dafcf30b2f13f319a2,1,8,8,16,2,2014-11-12 03:42:29,2014-11-12 03:42:29
5ba52001952b6a0744fc17252c0a07b97a836583...e2e9613f8359189cc11a5c6c577f013b677dd59e,1,1,1,2,2,2014-11-12 03:40:47,2014-11-12 03:40:47
5ba52001952b6a0744fc17252c0a07b97a836583...d79e898d676dfc80f89c24cd52ad71967c796bf1,1,5,4,9,5,2014-11-12 03:38:06,2014-11-12 03:38:06
5ba52001952b6a0744fc17252c0a07b97a836583...ab1a9d4fac0cb1fba893559e417fc85badac518c,1,5,5,10,2,2014-11-12 03:35:08,2014-11-12 03:35:08
44f83fff90fc7b12961f6d7bdb92a7e1b869c306...9be2bbb5efdc09eb5446719daa8ac892b93f2ede,8,23,14,37,8,2014-07-06 23:48:41,2014-07-06 23:48:41
9be2bbb5efdc09eb5446719daa8ac892b93f2ede...5e41a23ec5da02e67be2a67dd0c692517b3b01bd,1,3,1,4,1,2014-07-06 23:55:35,2014-07-06 23:55:35
00b6f278971dca9f2e366d06e96a11139f4e4169...6a803ad77794a25dd8e0222619be3dac27b2c8ea,1,2,0,2,1,2014-05-08 06:37:41,2014-05-08 06:37:41
d5e2262782a12af00639c3a7914580556d9b3a2b...a0d8d56593388790fba2b20acf117fb954e0766a,10,132,52,184,44,2014-07-07 07:59:51,2014-07-07 07:59:51
5830febd9a37bc147ae5f368607e5dcdc562ddf9...1e64c4c0ba6167b95a7861974554204e869f3a57,2,44,41,85,17,2014-07-06 07:24:22,2014-06-18 19:32:03
1e64c4c0ba6167b95a7861974554204e869f3a57...4950fe6f4e325c0101d5e42ad2f32f8e1fd13fcd,1,7,1,8,2,2014-07-06 07:24:22,2014-06-18 19:32:18
4950fe6f4e325c0101d5e42ad2f32f8e1fd13fcd...95d7c9c3fb00aae2e77806c19361b72579ad351d,1,20,11,31,8,2014-07-06 07:24:22,2014-06-18 19:33:22
95d7c9c3fb00aae2e77806c19361b72579ad351d...b063de54a50ddbc13994f5c24ee0332b84038d99,1,15,15,30,13,2014-07-06 07:24:22,2014-06-18 19:33:30
b063de54a50ddbc13994f5c24ee0332b84038d99...f3345f68d777fe2b6fb5fa113ce19d604ab61583,1,78,78,156,20,2014-07-06 07:24:22,2014-06-18 19:33:38
f3345f68d777fe2b6fb5fa113ce19d604ab61583...6a523bf99d561c99e51bd2f85f3ee6bdbdbc8ffd,1,292,90,382,28,2014-07-06 07:24:22,2014-06-18 19:33:49
6a523bf99d561c99e51bd2f85f3ee6bdbdbc8ffd...77d055746828165ae9e3d90f4fb08e30d57cabb7,1,67,70,137,42,2014-07-06 07:24:22,2014-06-18 19:34:01
77d055746828165ae9e3d90f4fb08e30d57cabb7...9ff66a12bc2b123594d661933f317ddb1a323e4e,1,77,78,155,39,2014-07-06 07:24:22,2014-06-18 19:34:12
9ff66a12bc2b123594d661933f317ddb1a323e4e...998c3724e80f7687eed747104e91b8ed773a3d54,1,63,84,147,41,2014-07-06 07:24:22,2014-06-18 19:34:21
998c3724e80f7687eed747104e91b8ed773a3d54...56b8d5fe6ebe98631b4dd4f7879f4e60c943f5a1,1,66,74,140,31,2014-07-06 07:24:22,2014-06-18 19:34:31
56b8d5fe6ebe98631b4dd4f7879f4e60c943f5a1...05ba1e491e2b20a831aced3cd375383275d86d26,1,29,22,51,13,2014-07-06 07:24:22,2014-06-18 19:34:43
05ba1e491e2b20a831aced3cd375383275d86d26...b3a125e941fac35220ac94a892bb547547db4f8d,1,27,19,46,10,2014-07-06 07:24:23,2014-06-18 19:34:53
b3a125e941fac35220ac94a892bb547547db4f8d...e341355d283ca8fbbdb245c7df704ce43443083f,1,453,306,759,130,2014-07-06 07:24:23,2014-06-18 19:35:03
e341355d283ca8fbbdb245c7df704ce43443083f...8ff099585f5aaf3330c6a8d15f513075c03c433a,1,1,1,2,1,2014-07-06 07:24:23,2014-07-06 07:23:09
8ff099585f5aaf3330c6a8d15f513075c03c433a...dad56be96c5bbecf331c279e82db1dc6211616d2,1,1,1,2,1,2014-07-06 07:24:23,2014-07-06 07:23:41
dad56be96c5bbecf331c279e82db1dc6211616d2...58eb8b2ae39baeb37514e5bf5ffcaf2a7c221202,9,421,421,842,34,2014-07-06 09:56:12,2014-07-06 09:56:12
5713bd74d617126796205d4ee29bfc6ff192ad39...6dde491ddf4169fd1c9b063cfc6764cdf828737a,7,7,4,11,7,2014-07-24 03:49:47,2014-07-24 03:49:47
0a3fe8c79bd8c0a2b78fbf6271d97a5e3fa6c6b1...e06970948b963fa2fb11583533f726a3a8051967,3,3,3,6,3,2014-06-10 07:24:23,2014-06-10 07:24:23
37acbb983d02518e5d90857a2f2b42bf9c00a4a0...624800aa4f29a75e10c4c4d847cfa79141d34068,2,2,2,4,2,2014-06-13 19:02:14,2014-06-13 18:55:04
50ad304bb52b344828352e888b6f8ddc042ba176...e08e871f01fd8848101e152c9afdd758280de27d,1,3,0,3,1,2014-01-27 17:24:51,2014-01-27 17:24:51
50ad304bb52b344828352e888b6f8ddc042ba176...5c1852fb74b095a73fefbfd1544da10034c7b5f8,1,1,1,2,1,2014-01-27 17:17:57,2014-01-27 17:17:57
4b2fe3f96f1bc3e4a582a05bb20bf1b2831bb401...da86f6fbbb425426ad026273eff5ceea9c708a98,1,1,1,2,1,2014-01-24 18:37:12,2014-01-24 18:37:12
9ec1e8694b3b9f8afd0090954075dc3df2fe9209...d56def706ac76e74ec19a2497f2744635ce71b91,1,2,1,3,1,2014-01-26 01:02:02,2014-01-26 00:47:55
494014babe34f06dbf6fab9614c52c6cf83a59be...6d08763136599c405cbfaaafdf86c088e441a416,2,9,0,9,2,2014-01-23 01:28:00,2014-01-22 23:45:29
494014babe34f06dbf6fab9614c52c6cf83a59be...9798b0bf0b932687b7d85fe142a0be3fbec4e4dc,1,6,0,6,1,2014-01-22 22:57:32,2014-01-17 02:18:18
1fd5e558811a63703e01b6e5e75c44820e59dfc9...04851652dbcd9aa548e890fcdc4a9b2192e07123,1,0,0,0,0,2012-03-10 20:45:09,2012-03-10 20:45:09
04851652dbcd9aa548e890fcdc4a9b2192e07123...a07851d6afdd51ded9273083ec5c734b0af52ddb,3,29,29,58,29,2012-03-10 21:01:17,2012-03-10 21:01:17
9ebc6b4c9700610fbc83173c95f5464999f83bff...c7eb1ab49a585b58f2ef8ec8450a704cb5e0172c,3,4,4,8,2,2012-03-10 21:24:46,2012-03-10 21:24:46
c7eb1ab49a585b58f2ef8ec8450a704cb5e0172c...dd5cffc308f9c990ed40be074c864d0ed563ef12,6,129,8,137,8,2012-03-10 21:40:58,2012-03-10 21:40:58
9ebc6b4c9700610fbc83173c95f5464999f83bff...922b5fba5379531e38761c49be86d1ef82ed6b02,1,1,0,1,1,2012-03-10 20:11:03,2012-03-10 20:11:03
6506ede6323ee60d4d7f8171937d92141a64e09e...4fbb400754986b969b40fc12eacfd332ace1a174,6,308,2,310,9,2012-04-24 15:19:17,2012-04-20 15:54:51
6506ede6323ee60d4d7f8171937d92141a64e09e...f5fd5e752329d92d3fde2e3f37f3406db62c400b,6,308,2,310,9,2012-04-20 15:55:22,2012-04-20 15:54:51
3bc7553f66482d1c8209f4644d022a05b6a8319c...490eb1bd16177f951b7c66c364d2eee6a6288a5d,2,0,2,2,1,2012-04-15 03:56:50,2012-04-15 03:56:50
a20cd66ba479053f060b1a7ed61cb1f0cd90450f...5bc601d9a8c330a4ad14375e63519fcf11bb08ab,3,2,2,4,2,2012-04-08 06:37:58,2012-04-08 06:37:58
a20cd66ba479053f060b1a7ed61cb1f0cd90450f...08fee005a8a879498255611c18dede3112896d3d,3,4,0,4,4,2012-04-08 04:26:46,2012-04-08 04:26:46
48063afb3a53c762bb950e4246a06a3682707aed...0e6f12af861745961a90aef58d8d783bebd0b58e,2,2,2,4,2,2012-04-12 20:14:54,2012-04-12 20:14:54
4953629ccd0a1c43ae483a843db6d882fe66fc03...10ff5f16a64bf9b5cc45ba42e30cbf191e866eec,3,2,2,4,2,2012-04-07 21:25:58,2012-04-07 21:25:58
10ff5f16a64bf9b5cc45ba42e30cbf191e866eec...798363eda743f4e04bf8dd30964ee97f49e86a79,3,7,5,12,4,2012-04-07 21:31:55,2012-04-07 21:31:55
798363eda743f4e04bf8dd30964ee97f49e86a79...5591a9b96668c0f151872ce5f473a968d042a73c,2,2,2,4,2,2012-04-07 21:56:37,2012-04-07 21:56:37
5591a9b96668c0f151872ce5f473a968d042a73c...f563b1db43e702854a6065d132e487bc49dc4b24,1,0,0,0,0,2012-04-07 22:59:14,2012-04-07 22:59:14
f563b1db43e702854a6065d132e487bc49dc4b24...0a71f171bc63dcfea42fe002bab00454d728fc42,7,20,7,27,12,2012-04-07 23:17:15,2012-04-07 23:17:15
8dc1a0eadebb68e4e0c4523a32b1cc103e8a6d4e...a6f27ebed440919aac6f62e73e6748bfecd00ab9,3,54,49,103,33,2012-04-15 06:06:00,2012-04-15 06:06:00
2dc979a2029d909945011a8e6dac3543aa9f0198...4bd611884a5f1dd02878f73bccd51d85c1e49186,3,45,3,48,6,2012-04-04 21:58:04,2012-04-04 21:58:04
4bd611884a5f1dd02878f73bccd51d85c1e49186...83febb3452ecd81241ddc004509ec64de8b13a92,5,17,7,24,6,2012-04-04 22:02:30,2012-04-04 22:02:30
8d52e6d458e10c618698cc7698f252003e727eb7...95c2877ffca46aa5812b0b2b2ace6608d309586d,5,16,8,24,11,2012-03-25 23:41:46,2012-03-25 23:40:51
8d52e6d458e10c618698cc7698f252003e727eb7...998c8a6e3d3962152c1ebfe6cd0431b87ae3fb62,5,16,8,24,11,2012-03-25 23:40:51,2012-03-25 23:40:51
22963d73467a604b845dbebc03c9b8fa16ba2e23...94b24aaa473755093677cb4eb80faf3daee53357,3,8,4,12,8,2012-03-22 04:57:06,2012-03-22 04:57:06
94b24aaa473755093677cb4eb80faf3daee53357...706ee46b73b58059230b24589160da784778aad2,3,30,12,42,6,2012-03-22 06:45:58,2012-03-22 06:45:58
706ee46b73b58059230b24589160da784778aad2...20e085723b3f55fdc1db7f1687d535af7d127319,3,8,6,14,2,2012-03-22 06:51:32,2012-03-22 06:51:32
20e085723b3f55fdc1db7f1687d535af7d127319...b3bf223617754e658eb62ef0f068732e719a2c82,3,4,4,8,4,2012-03-22 06:59:27,2012-03-22 06:59:27
5179df1928e82670a2f16ce414a42f1008c6d652...0b4198492002e8aeff6a9106f62c140c82c6c75e,5,117,4,121,12,2012-03-23 16:47:57,2012-03-23 16:47:57
5179df1928e82670a2f16ce414a42f1008c6d652...eb4f708b915c8a7d0948b4837d7c8751de1c930b,3,6,6,12,6,2012-03-23 12:35:46,2012-03-23 12:35:46
e3ae517555fb9500493fde8efeef4a9788cd3264...5ad5dde1e24f668cf9b720dd59fc2a7d4808c0b3,7,137,647,784,26,2012-02-22 07:16:06,2012-02-22 07:16:06
e3ae517555fb9500493fde8efeef4a9788cd3264...b4cc6c74f59442879ba2b1ed3e86d26e62390835,5,53,10,63,15,2012-02-22 05:12:16,2012-02-22 05:12:16
b5503c4c28d4f9d80f3285922376f0552808d40e...7d52e1dcd479e017d85fee8df4032644970525bd,4,5,5,10,5,2012-01-24 21:47:24,2012-01-24 21:47:24
72861dfbf2759d6ea51ee557def37f85fb5f647d...e829001e5cb488a7708878b074205fc41e82fc82,3,2,4,6,4,2012-01-24 20:28:20,2012-01-24 20:28:20
10cb7c02f99b7ff27d95ca2ac7eab64846e13a41...cfa925cab6dbb10af28ddca6d38e76aed97bb1ef,2,2,5,7,3,2012-01-25 19:15:48,2012-01-25 19:15:48
cfa925cab6dbb10af28ddca6d38e76aed97bb1ef...d3c5dd4e6acc421e06ef72680e794cfd9d52a04a,3,15,4,19,8,2012-01-25 19:21:44,2012-01-25 19:21:44
91780529d5f355054d17420f56a6b11e2d40b2a9...bc9c89f1577aea454111a01a3d7a565c4cc63ded,1,77,77,154,49,2012-01-24 20:29:55,2012-01-24 20:29:55
bc9c89f1577aea454111a01a3d7a565c4cc63ded...a9c6dca0940f5f689e9e8d70eda42783265bee37,1,81,81,162,59,2012-01-24 20:45:42,2012-01-24 20:45:42
a9c6dca0940f5f689e9e8d70eda42783265bee37...425e5bfb71527e932858ad41f9e234fc05d65c6b,1,163,162,325,108,2012-01-24 21:17:32,2012-01-24 21:17:32
91780529d5f355054d17420f56a6b11e2d40b2a9...54f04d3b13a1103a1e45e5ad2290cd55fe96ffea,1,2,2,4,2,2012-01-24 19:37:57,2012-01-24 19:37:57
91780529d5f355054d17420f56a6b11e2d40b2a9...84a8aa1beac447cbbe77983730f7590fc955b312,10,12,12,24,10,2012-01-24 19:08:03,2012-01-24 19:08:03
b636ccb281022279030ef511ec1b01f2ddb16712...cf716bbeccf3ea94dc16d65a3b5800bc22e1472d,1,1,0,1,1,2012-01-23 21:03:09,2012-01-23 21:03:09
ff113acba88806380b995fba894d77b562ca0e0a...1954cf001926a94f7a4d51f16beaf9f2ba671d13,2,14,0,14,3,2012-01-23 21:46:26,2012-01-23 21:46:26
1954cf001926a94f7a4d51f16beaf9f2ba671d13...cd5ffbe39626303a395448a6c9a507f3ad04ff5e,3,5,3,8,5,2012-01-23 21:50:55,2012-01-23 21:50:55
373a54187ed5d1f5d00d725e6ef6b84d506f07a8...88596797f061f97255bb7ed9442ac43a41787405,1,0,0,0,0,2012-01-22 20:19:22,2012-01-22 20:19:22
373a54187ed5d1f5d00d725e6ef6b84d506f07a8...c3625ebb238edbfc4b352a97b964727a919b8599,1,2,2,4,2,2012-01-22 16:46:44,2012-01-22 16:46:44
373a54187ed5d1f5d00d725e6ef6b84d506f07a8...6a9f169fd6cd2203dee3f6230cc78f5dbbeafdab,1,2,2,4,2,2012-01-22 11:06:59,2012-01-22 11:06:59
6a9f169fd6cd2203dee3f6230cc78f5dbbeafdab...05fdd43e41bae02c8d4006c075b6360599b4467c,1,19,0,19,2,2012-01-22 11:32:37,2012-01-22 11:32:37
05fdd43e41bae02c8d4006c075b6360599b4467c...4882e6da2f887c1e8baad96f777b151882adaed8,1,0,0,0,0,2012-01-22 11:33:30,2012-01-22 11:33:30
dc5bedda1441bac36e266f409b3dd14f84e8fd32...b8c0388f8af8ae93a514efaa352f63ecdffde279,3,64,64,128,52,2012-01-23 04:07:17,2012-01-23 04:07:17
b8c0388f8af8ae93a514efaa352f63ecdffde279...36d56fb1ba803358e8244189fbef883290af87d0,3,12,5,17,7,2012-01-23 04:12:26,2012-01-23 04:12:26
36d56fb1ba803358e8244189fbef883290af87d0...36d2679f8358f91d8a2c746e0f14b3500b73c163,2,2,2,4,2,2012-01-23 04:31:58,2012-01-23 04:31:58
25ab1539a944638e089e58f762a048a7e36c7790...4102a67f33bf2a382203547fe821d0d41bbc4ece,1,1,1,2,1,2014-10-30 08:47:48,2014-10-30 08:47:48
1342c63893c76e5636af24b485628241faeefbe3...f85c5921dd14636793e927fc32defbebf803ae4b,1,2,2,4,2,2014-11-05 19:11:46,2014-11-05 19:11:46
20ba8ad6f05403833f0cbb5f820a2d1811269d41...5660be42faef7fecdd9121e052265da55202ae3c,1,1,1,2,1,2014-11-13 20:09:38,2014-11-13 17:27:47
0c816d910d56d7526e8d7db152640fc78acef0c1...cab74e32389eca8ace1d7d0d850e783d640b48b4,1,1,1,2,1,2014-11-20 17:49:10,2014-11-20 17:49:10
d763e0e2a08ade0d36872cb9624813b5e4a5255b...2c64fc2c4d6eea1b523e9d7f3a823b4fb2b5770f,1,1,1,2,1,2014-11-28 12:30:04,2014-11-28 12:30:04
d763e0e2a08ade0d36872cb9624813b5e4a5255b...c1885ef58b1c1dfcc3948c42da1053a13db9de46,1,3,1,4,3,2014-11-27 21:03:32,2014-11-26 21:58:23
d763e0e2a08ade0d36872cb9624813b5e4a5255b...8770f55f1e16ee5d1f7f91b2671c7365d3e91828,1,1,0,1,1,2014-11-27 11:06:42,2014-11-27 11:06:42
0c5a5563b271a6a15db7452f8f4878d4bd797074...d7d6384d397c457a69f1ec1ee8ebaf390334111f,1,1,0,1,1,2014-12-05 20:30:30,2014-12-05 20:30:30
0c5a5563b271a6a15db7452f8f4878d4bd797074...215fc93096f157ab49edc42baf81641af68aa369,1,3,1,4,3,2014-12-05 17:00:19,2014-12-05 17:00:19
0c5a5563b271a6a15db7452f8f4878d4bd797074...add44cae036d3350f2ff0dfc1cf261e5db764682,4,0,0,0,0,2014-12-05 16:52:23,2014-12-05 16:52:23
8bb59abf409d1473f16f87e560013300228cad78...8318227709352413800b2af3bd4c5267dc2005c8,1,2,2,4,1,2014-11-20 03:43:23,2014-11-20 03:38:21
5e41a23ec5da02e67be2a67dd0c692517b3b01bd...8e2348e9eda51296eb680192379ab37f10355ca3,9,41,4,45,9,2014-07-07 01:39:37,2014-07-07 01:39:37
6a803ad77794a25dd8e0222619be3dac27b2c8ea...5f6304bd65e01320ca93f80445d978ca37f59a01,1,0,7,7,1,2014-05-08 14:20:25,2014-05-08 14:20:25
a0d8d56593388790fba2b20acf117fb954e0766a...36b530892600648a6d6a24dd2520f84839cc0ace,2,1,45,46,4,2014-07-07 18:06:19,2014-07-07 18:00:32
a0d8d56593388790fba2b20acf117fb954e0766a...231744d628f4857d631e9e9e8554d0a29a1b9556,6,24,11,35,17,2014-07-07 11:03:56,2014-07-07 11:03:56
a34e52de4d5c95b4c1db448c298ce1ee9d8414c4...0a8845c3fdbcc30f6e314f5a97d41a8d67c88713,2,72,158,230,22,2014-07-06 11:25:56,2014-07-06 11:20:49
b5d86ad0bd47cae4e12126d8b84ca49d6c415e5d...587c09cb4859cbed5d19cfc161a7c0b6711da51a,1,11,11,22,3,2014-07-07 04:50:46,2014-07-07 04:50:46
abbb4d64e19384adde6a808be9820cde55beae42...078aafe7fd5d7f44725d4de76d0a0510ce43d344,8,22,5,27,10,2014-07-24 03:54:07,2014-07-24 03:54:07
078aafe7fd5d7f44725d4de76d0a0510ce43d344...7fcc6c78890de337808c1ea6f62f065a61cbb509,1,16,16,32,12,2014-07-24 04:00:48,2014-07-24 04:00:48
7fcc6c78890de337808c1ea6f62f065a61cbb509...98d693ba7bff3b14f92fea198f8ad49ac44b4872,7,21,4,25,7,2014-07-24 04:03:46,2014-07-24 04:03:46
ed06fd0936ba2c03ecb052eb65a89c5be94b1b8d...fdc33ced179680645b7b631c6e8c5760bb6fda5e,1,3,9,12,4,2014-06-15 14:41:53,2014-06-15 14:41:24
ed06fd0936ba2c03ecb052eb65a89c5be94b1b8d...c503f7b66ff3b6abeef90d5b29a2a373574b01f6,1,4,1,5,1,2014-06-15 12:26:32,2014-06-15 12:26:32
ed06fd0936ba2c03ecb052eb65a89c5be94b1b8d...03342f1a7e32158e44ed689c6cb2d4d515204813,1,1,0,1,1,2014-06-15 04:50:32,2014-06-15 04:50:32
03342f1a7e32158e44ed689c6cb2d4d515204813...33a6932d6fc2df2b5b1d1b34f1ca5343dd8f8868,1,1,0,1,1,2014-06-15 04:53:26,2014-06-15 04:53:26
33a6932d6fc2df2b5b1d1b34f1ca5343dd8f8868...689faaf16f255ae5bc37c6e348fd593ae270a103,3,13,2,15,3,2014-08-05 02:51:31,2014-08-04 02:07:21
689faaf16f255ae5bc37c6e348fd593ae270a103...e7991a9a1e2f474c8f1d8a2e0ed113816f1c5e82,3,41,12,53,4,2014-08-28 01:24:23,2014-08-28 01:24:23
ed06fd0936ba2c03ecb052eb65a89c5be94b1b8d...f071549c8408241b88a95192e477816d2402eb6e,1,1,0,1,1,2014-06-13 19:12:32,2014-05-22 16:00:19
45ea456468b331f3c1fef8ec1598c723608264b4...0a5cb2f9089d57bb9b027a6b39eabf8138e40aa3,1,1,1,2,1,2014-01-27 22:07:14,2014-01-27 22:07:14
0a5cb2f9089d57bb9b027a6b39eabf8138e40aa3...3a62811bbde4e428df1882bddf940f40381a8d41,1,1,1,2,1,2014-01-27 23:01:10,2014-01-27 23:01:10
45ea456468b331f3c1fef8ec1598c723608264b4...6a0a139cdabe9ad24f2dcee3044bb62f8738df15,10,208,181,389,64,2014-01-27 20:08:55,2014-01-27 20:08:55
6a0a139cdabe9ad24f2dcee3044bb62f8738df15...400720d00b2ebab99c2d54ad036b0100af499620,6,4,16,20,6,2014-01-27 20:24:35,2014-01-27 20:24:35
400720d00b2ebab99c2d54ad036b0100af499620...b7ac009a527869dc381b9e4c2272c822d85d2b1c,6,4,19,23,6,2014-01-27 20:25:39,2014-01-27 20:25:39
b7ac009a527869dc381b9e4c2272c822d85d2b1c...493d143cbdc30530eda0da803612e668d0992f80,1,1,1,2,1,2014-01-28 18:07:33,2014-01-28 18:07:33
493d143cbdc30530eda0da803612e668d0992f80...a9a4d81730dcebeceb5823804c289a5963731496,5,5,5,10,5,2014-01-28 18:08:40,2014-01-28 18:08:40
643e814e7bbd3230a89670599024e9514981257c...af1ba5cf74fb695674a166c3c6883bf62e91ceda,1,1,1,2,1,2014-01-25 00:58:54,2014-01-25 00:58:54
643e814e7bbd3230a89670599024e9514981257c...4b5991586dc501a219d19debd23238aac791d3a9,1,1,1,2,1,2014-01-24 19:24:50,2014-01-24 19:24:50
77362a3b457280c049239100cf2511669a81e677...6717f642bb8dca8fb78dbe17c07209ba98091e2d,1,5,6,11,1,2014-01-26 01:55:52,2014-01-26 01:55:52
f7d4fb61ce1c1f2acde74d779adbc91d137e157c...aef230d40ad79263cbdc2214509be4daa8ec92ea,3,2,2,4,2,2012-03-10 22:20:46,2012-03-10 22:20:46
aef230d40ad79263cbdc2214509be4daa8ec92ea...67aa00d0bbc638bc527de1c617f5a915eb5b4fcb,3,2,2,4,2,2012-03-10 22:36:58,2012-03-10 22:36:58
67aa00d0bbc638bc527de1c617f5a915eb5b4fcb...700457c62a71f160b752cfb324205f3cb5e7b5df,3,0,0,0,0,2012-03-10 23:09:35,2012-03-10 23:09:35
700457c62a71f160b752cfb324205f3cb5e7b5df...9c1d8e032b53d296788a56e58409c27c030dba91,15,10,10,20,10,2012-03-10 23:14:54,2012-03-10 23:14:54
9c1d8e032b53d296788a56e58409c27c030dba91...145a36323c209e03c47965f6e341245c63b4e6e2,1,0,0,0,0,2012-03-10 23:15:13,2012-03-10 23:15:13
145a36323c209e03c47965f6e341245c63b4e6e2...cecfe7206060fbf12233c01c4d517d77b624bac7,7,16,6,22,6,2012-03-10 23:37:28,2012-03-10 23:37:28
cecfe7206060fbf12233c01c4d517d77b624bac7...95a3cd87325fcd475478557e6c79a7e84865e56f,3,9,19,28,7,2012-03-10 23:41:41,2012-03-10 23:41:41
95a3cd87325fcd475478557e6c79a7e84865e56f...1dbb942d5b7b9a9893cca20b983cee060bfe8313,6,152,21,173,26,2012-03-11 00:01:06,2012-03-11 00:01:06
1dbb942d5b7b9a9893cca20b983cee060bfe8313...f4ac080f9e9cdf5f762d44ce931453f5cf483358,3,2,2,4,2,2012-03-11 00:06:56,2012-03-11 00:06:56
f4ac080f9e9cdf5f762d44ce931453f5cf483358...a3e9fc547cca06da9b0a3449aa447436665b6fb9,6,21,25,46,9,2012-03-11 00:15:54,2012-03-11 00:15:54
a3e9fc547cca06da9b0a3449aa447436665b6fb9...5de8b277c6bcc1102e61fa41e1f498617e5fcbf8,6,19,4,23,6,2012-03-11 00:21:34,2012-03-11 00:21:34
6a2c5191526ed01795d912eb0755884b6e301899...6e72760de5321bea4f8292df151d7bc7b0c1d2aa,3,6,6,12,6,2012-03-11 01:38:09,2012-03-11 01:38:09
6e72760de5321bea4f8292df151d7bc7b0c1d2aa...635ee36e11d4e981b06034057e4990e2e63eec2a,8,59,45,104,45,2012-03-11 02:03:59,2012-03-11 02:03:59
635ee36e11d4e981b06034057e4990e2e63eec2a...349bdc12a7f5aae02cab36f8ae87c52a903937ac,3,2,2,4,2,2012-03-11 02:15:28,2012-03-11 02:15:28
349bdc12a7f5aae02cab36f8ae87c52a903937ac...e8ef7d5e7b3f09f0dae54352146960f8bc3d2f05,3,4,4,8,4,2012-03-11 08:06:48,2012-03-11 08:06:48
e8ef7d5e7b3f09f0dae54352146960f8bc3d2f05...ad1e9697ae17ecdb758167b26f9272f9bfe150f4,3,14,24,38,6,2012-03-11 20:48:04,2012-03-11 20:48:04
e659dc7e1be2e09cec34703dce8c737496e3504e...f9744ff52207617ec4610809603f34d7eba1d077,3,12,8,20,10,2012-04-24 13:39:14,2012-04-24 13:39:14
f9744ff52207617ec4610809603f34d7eba1d077...5be84ad0b7156edcd53d4c1ef81ad0f8cf0cbe4b,6,13,2,15,8,2012-04-24 13:45:21,2012-04-24 13:45:21
5be84ad0b7156edcd53d4c1ef81ad0f8cf0cbe4b...7b282798a38517742714fba3868737e5d33fb0d7,2,23,3,26,6,2012-04-24 13:52:57,2012-04-24 13:52:57
7b282798a38517742714fba3868737e5d33fb0d7...66ac6e14db39e552510bc6f033c06f59e68c27eb,1,1,0,1,1,2012-04-24 13:53:48,2012-04-24 13:53:48
66ac6e14db39e552510bc6f033c06f59e68c27eb...aaabe2a46c64e7d9ffd5735dba2db4f3cf9906f5,6,22,8,30,7,2012-04-25 01:06:41,2012-04-25 01:06:41
c710f03995c653523053973635ae5aa61cadd4e0...a7d8145a321036e39a91fc9648710e62f7f164ac,3,2,0,2,2,2012-04-14 20:18:37,2012-04-14 20:18:37
a7d8145a321036e39a91fc9648710e62f7f164ac...8575a452942001bce522e8e258d9e192d24cb6ec,3,24,12,36,8,2012-04-14 20:31:48,2012-04-14 20:31:48
2dbce887df8ffec477929c92085745af9b93feaa...9e9be2dc0db5148e14a9fe2164dafd79c7dd71cd,3,2,0,2,2,2012-04-15 06:19:42,2012-04-15 06:19:42
9e9be2dc0db5148e14a9fe2164dafd79c7dd71cd...a4c2332eb1b5b4baf4309463ab88141d82c88c04,3,2,2,4,2,2012-04-15 07:06:11,2012-04-15 07:06:11
519384fae8cb2089ac48d81519d7052a9198f29a...3e2e111b17ff875a84773e00bd0b34ff8bf6bc3a,3,56,2,58,6,2012-03-26 00:11:50,2012-03-26 00:11:50
3e2e111b17ff875a84773e00bd0b34ff8bf6bc3a...825227474b57c90181e9c1b43da952d01b6c1dc1,3,16,0,16,2,2012-03-26 00:37:38,2012-03-26 00:37:38
825227474b57c90181e9c1b43da952d01b6c1dc1...4893928310288d7bccb400017d333c6a49700046,3,10,10,20,10,2012-03-26 01:03:30,2012-03-26 01:03:30
4893928310288d7bccb400017d333c6a49700046...ea437351ed115b240e9b150da7ee93582f31dd17,3,6,4,10,6,2012-03-26 02:47:13,2012-03-26 02:47:13
ea437351ed115b240e9b150da7ee93582f31dd17...473e5714f756d9be81e9321d451bb05431dd28ee,5,30,12,42,14,2012-03-26 03:41:59,2012-03-26 03:41:59
473e5714f756d9be81e9321d451bb05431dd28ee...4449c4e9e041136c7f03438ab3f078f4d837f6d5,3,2,2,4,2,2012-03-26 03:44:01,2012-03-26 03:44:01
4449c4e9e041136c7f03438ab3f078f4d837f6d5...cffadd8c71be0c7595801623d39e5f545d0f4028,3,2,0,2,2,2012-03-26 05:28:43,2012-03-26 05:28:43
cffadd8c71be0c7595801623d39e5f545d0f4028...d4914f47c34053fded5aea39fcb9b7747f7bbecc,3,2,2,4,2,2012-03-26 16:25:31,2012-03-26 16:25:31
d4914f47c34053fded5aea39fcb9b7747f7bbecc...917f11e6799ddd43b439ce1f7a10c1a7360bcf3b,3,20,16,36,20,2012-03-26 16:30:42,2012-03-26 16:30:42
20221a67c2590e5d5d2d3a78dd79d61498e80661...8bd67bb124ccc87ecfe7959f3e75bb497d7991e1,6,8,46,54,10,2012-02-22 06:09:51,2012-02-22 06:09:51
8bd67bb124ccc87ecfe7959f3e75bb497d7991e1...917df6703cf316f6609d3ef3b9b35fb250c30472,4,16,10,26,6,2012-02-22 06:40:21,2012-02-22 06:40:21
917df6703cf316f6609d3ef3b9b35fb250c30472...9b524a16e9cb5d8c9e0a6c4c7b83a3a881e415ee,5,86,97,183,51,2012-02-22 07:00:02,2012-02-22 07:00:02
9b524a16e9cb5d8c9e0a6c4c7b83a3a881e415ee...a139167489e249345933b1e58cc7c53542abab97,7,21,7,28,8,2012-02-22 07:15:43,2012-02-22 07:15:43
9e7f4ebd7711777ad4dd03dcac611729d3707346...3aea86370d7d6c717939eebcd6f3a93776c567d4,1,20,19,39,17,2012-01-24 21:48:05,2012-01-24 21:48:05
f32866c2fceee5b760d0647884b9e63be8ed8888...540d229eba6e65c0d18b706df73fb51322b5ea40,1,1,1,2,1,2012-01-24 20:57:30,2012-01-24 20:57:30
540d229eba6e65c0d18b706df73fb51322b5ea40...925fef411090f06b34c5e86f4d0ed5630adff87b,1,1,1,2,1,2012-01-24 21:11:09,2012-01-24 21:11:09
925fef411090f06b34c5e86f4d0ed5630adff87b...5fb31670af6df88afb0a82872b6f7935486f91c2,1,1,0,1,1,2012-01-24 21:12:37,2012-01-24 21:12:37
f32866c2fceee5b760d0647884b9e63be8ed8888...3f54db9c6ac0126b071a1874cd2f5c0379a4f393,1,1,1,2,1,2012-01-24 20:53:30,2012-01-24 20:53:30
3f54db9c6ac0126b071a1874cd2f5c0379a4f393...fecd4ddd135a893f2c5c103d565e9d1ab110d247,8,91,119,210,21,2012-01-24 22:25:30,2012-01-24 22:25:30
d3c5dd4e6acc421e06ef72680e794cfd9d52a04a...b8511568637dfa4decb3f0475436a3dfa637a57d,5,6,6,12,6,2012-01-25 19:26:45,2012-01-25 19:26:45
d3c5dd4e6acc421e06ef72680e794cfd9d52a04a...25519bacd56ee2507cdde727d85458e5e5ef7949,13,14,14,28,14,2012-01-25 19:25:35,2012-01-25 19:25:35
9602248ad5dcdcee69c696ca585ebc0c96f5463f...f2fe2b1798380ab65e88281ab4db47965cd5aaf8,4,6,9,15,8,2012-01-25 05:11:20,2012-01-25 05:11:20
a6eb972bf3f1a0ea172a44a25565df18da615f33...155b72e8730e9b8badb5fa80c8d7f8990f10cc82,4,5,5,10,5,2012-01-23 04:02:56,2012-01-23 04:02:56
a364d89936b52448c106683bbf7b219530fb055e...0523c053a79430b3dab775fab2d572841f743c5a,1,1,1,2,1,2012-01-22 20:45:20,2012-01-22 20:45:20
4102a67f33bf2a382203547fe821d0d41bbc4ece...1339ab7a130600330b1db4e3acae9760710a0a41,1,1,1,2,1,2014-10-30 17:20:54,2014-10-30 16:13:39
4102a67f33bf2a382203547fe821d0d41bbc4ece...87edaf295c44bbd5fa6ae4a435a27e8c8fc8e9eb,1,8,4,12,4,2014-10-30 15:33:14,2014-10-30 15:33:14
5660be42faef7fecdd9121e052265da55202ae3c...6ce4ca75a22ae490d0a5cf23f947868dba51e831,1,1,1,2,1,2014-11-13 20:18:02,2014-11-13 20:18:02
5660be42faef7fecdd9121e052265da55202ae3c...ea407666ce3c5d708b4a830fb2d00bdcb0d2d53e,26,98,98,196,96,2014-11-13 20:16:03,2014-11-12 04:23:49
3a96a80a1b304518879e73f945ea254b9aa023a9...a7682e3fde01e2b5e7c12cea10ca2d4251f73e69,2,13,23,36,7,2014-11-13 21:53:40,2014-11-13 21:51:53
cab74e32389eca8ace1d7d0d850e783d640b48b4...7711c9d60d0dc7db86ac13b200be856409d1d946,1,3,1,4,2,2014-11-20 18:59:16,2014-11-20 18:02:57
cab74e32389eca8ace1d7d0d850e783d640b48b4...44735c83bfd9224b0252feab7a12eef9da6ca8c9,1,2,2,4,2,2014-11-20 18:15:43,2014-11-20 18:15:43
a35ee9d21857cf34980645045aecec0d8ead9179...c9289691ba9c5094b81243a07d2aa78f008fcc7f,1,1,1,2,1,2014-11-30 00:53:37,2014-11-30 00:53:37
c9289691ba9c5094b81243a07d2aa78f008fcc7f...1de638f830a60297f4b27ae2af9b340d073a5a5a,1,33,6,39,5,2014-11-30 02:27:51,2014-11-30 02:27:51
1de638f830a60297f4b27ae2af9b340d073a5a5a...c22b8dca147dad63fa1d1eddc38b2ac4bcfb6cd0,1,1,1,2,1,2014-11-30 02:31:09,2014-11-30 02:31:09
c22b8dca147dad63fa1d1eddc38b2ac4bcfb6cd0...c2d868cfbe63431d02330f59c84871e18a2e25d8,1,4,0,4,1,2014-11-30 02:33:20,2014-11-30 02:33:01
c2d868cfbe63431d02330f59c84871e18a2e25d8...80d7be11263ea014f32aaefef51917f2bef29a89,10,16,10,26,12,2014-11-30 02:36:21,2014-11-30 02:36:21
80d7be11263ea014f32aaefef51917f2bef29a89...7c71b4874bfb992bd39e55c369d52f825de1946c,4,47,14,61,15,2014-11-30 04:57:04,2014-11-30 04:57:04
7c71b4874bfb992bd39e55c369d52f825de1946c...9c049c99e2839239552bef2d7e4d2a43cdf387b2,6,35,13,48,13,2014-11-30 04:58:14,2014-11-30 04:58:14
9c049c99e2839239552bef2d7e4d2a43cdf387b2...149f32d9d38d506bcdaa0361dc40d7743766cf9d,1,2,3,5,1,2014-11-30 05:18:05,2014-11-30 05:18:05
149f32d9d38d506bcdaa0361dc40d7743766cf9d...7e27e749d1e21dbdf36fef40882497ed3d4b52c1,1,10,4,14,2,2014-11-30 05:36:57,2014-11-30 05:36:57
7e27e749d1e21dbdf36fef40882497ed3d4b52c1...23bdfc45eb6da41ceaa59803caa667a8f8d4de4d,8,22,12,34,10,2014-11-30 05:40:04,2014-11-30 05:40:04
23bdfc45eb6da41ceaa59803caa667a8f8d4de4d...9928144dc4e8301ee0dd02ac073682d789b2adb1,5,35,5,40,5,2014-11-30 07:03:47,2014-11-30 07:03:47
1dd665c3ab7baed8e6a76245b022e02d14a04dc1...7e758f60fcb8f5391ea48cacf432c76e8b747909,1,2,1,3,1,2014-12-05 19:50:55,2014-12-05 19:49:53
e7818e979f46da63a91146c7051e6aaef24288c8...a1b8aa351edd80a7c0e7176b69b8087c126a34cd,3,2,4,6,3,2014-11-20 06:02:25,2014-11-17 17:31:13
e7818e979f46da63a91146c7051e6aaef24288c8...cb29c9a41d4835155d12cc48b7fcbabe97160db7,1,12,2,14,3,2014-11-20 06:02:05,2014-11-14 13:00:02
117ca8167a9ca919c38443ce7cc4643a73cc999d...ddffe769613dd94c7125e3a7a2546cc706f5e2b5,1,2,2,4,2,2014-07-07 07:04:14,2014-07-07 07:04:14
ddffe769613dd94c7125e3a7a2546cc706f5e2b5...520b3547a49c14874d59207a2a37f8542dc89c6e,1,2,2,4,1,2014-07-07 07:10:49,2014-07-07 07:10:49
91607900c017777a2c8346f14dd939d65b66fa9d...cb2ef1eff4cbfad8998f94adf7f61cdf574ca100,5,15,14,29,8,2014-05-08 23:35:03,2014-05-08 23:35:03
91607900c017777a2c8346f14dd939d65b66fa9d...510f4fe50ad30499adf1d19dd65ef694c414aacd,8,22,21,43,11,2014-05-08 22:41:08,2014-05-08 22:41:08
91607900c017777a2c8346f14dd939d65b66fa9d...78cac11cef392a740e4fae390e9957371243838b,1,1,1,2,1,2014-05-08 22:26:31,2014-05-08 22:26:31
9a8e6263da5897e14d9d28204f41763d1b975e75...c769d7c21ff50d3cf2b3a9a97f0627d401e11f95,1,0,1,1,1,2014-07-07 23:59:59,2014-07-07 23:59:59
c769d7c21ff50d3cf2b3a9a97f0627d401e11f95...4f5efb84c9e81120b26949cecc626ae866fef46a,1,4,0,4,1,2014-07-08 00:26:52,2014-07-08 00:26:52
8bf48121a0cfeb72f8e1553954327c120a0a4345...557d3e527cbbff5994b5ec48e11ec318aac4a776,1,0,6,6,1,2014-08-01 22:04:55,2014-08-01 22:04:28
557d3e527cbbff5994b5ec48e11ec318aac4a776...feed9aed5b471c20b02c4ca6620366cac9327db8,11,64,33,97,46,2014-08-02 20:05:11,2014-08-02 20:05:11
feed9aed5b471c20b02c4ca6620366cac9327db8...b9e6848dc8d8c146911e0999c9f1e68780a1606e,7,13,7,20,7,2014-08-02 20:55:02,2014-08-02 20:55:02
b9e6848dc8d8c146911e0999c9f1e68780a1606e...033f1654b07f7764a54e5b290e5cf36f688b95a3,1,1,0,1,1,2014-08-02 21:49:48,2014-08-02 21:49:48
98d693ba7bff3b14f92fea198f8ad49ac44b4872...8288cc9c0582b2433110911fe902b6c4c386e43c,1,0,6,6,1,2014-07-24 19:22:22,2014-07-24 19:22:22
045aceef943330a84042a6f3a5c81dc79a10e7e5...1b63d0b9ba0fad04a8428d27bc1d141079bdfa7b,1,1,1,2,2,2014-06-18 00:56:15,2014-06-10 21:36:03
045aceef943330a84042a6f3a5c81dc79a10e7e5...3f68c40ac1011059ad0e3a7098bc1c75e4cd92bc,1,10,1,11,1,2014-06-17 18:56:16,2014-06-11 17:09:35
3f68c40ac1011059ad0e3a7098bc1c75e4cd92bc...5b9e2bf1265eb50c0d4105b2eb3da12280c37430,1,2,2,4,2,2014-06-17 19:57:54,2014-06-17 19:57:54
4686d1483b3167c0b21097a97682c514b8f4e972...abe7afd87ae1e83d509a93ddafa91c79915a2bc8,11,11,11,22,11,2014-06-19 09:58:34,2014-06-19 09:58:34
3a62811bbde4e428df1882bddf940f40381a8d41...7037c6fc7291fc66af62fa0ba7b9e8fdb78cf7f0,2,20,28,48,12,2014-01-28 09:48:45,2014-01-28 09:48:45
7037c6fc7291fc66af62fa0ba7b9e8fdb78cf7f0...3fc7a4cffa94b63f3c4554376cf668e08b21f543,11,160,156,316,156,2014-02-09 00:31:42,2014-02-09 00:31:42
3fc7a4cffa94b63f3c4554376cf668e08b21f543...b36d19c3c6caf89fbe996678bdefe3f7e9a69281,1,1,1,2,1,2014-02-09 00:46:12,2014-02-09 00:46:12
01dabd3391591df44f8a0d960bbd14a23723f31d...00f062fc7e3d2867cf73a52f61a3009849113f73,2,2,2,4,2,2014-01-29 19:50:10,2014-01-29 19:50:10
01dabd3391591df44f8a0d960bbd14a23723f31d...f8bb6811bd0591b42b51b6d5fcb9ef70a19ac3af,1,0,1,1,1,2014-01-28 21:47:23,2014-01-28 21:47:23
01dabd3391591df44f8a0d960bbd14a23723f31d...615f1ad4aa8bd5c3343f14c794b27e53b67aa084,1,4,10,14,1,2014-01-28 19:07:56,2014-01-28 11:16:13
6d090e243dba41bf23dde5496202e0f6f1f4ab61...0cbfdd19bd96af899cbf4d4bbac814d543a7ee0c,1,2,1,3,2,2014-01-25 15:08:15,2014-01-25 15:08:15
6d090e243dba41bf23dde5496202e0f6f1f4ab61...a1b0bb7a104e0903bd6c3a625111e86c10c5959a,1,3,3,6,3,2014-01-25 12:35:46,2014-01-25 12:35:46
3157a3777536f1be7a8ccbb6170611492f9b2733...1a36e4fa1e9d9220a242d01062941a16ef07e660,5,6,6,12,6,2014-01-27 01:48:15,2014-01-27 01:48:15
3157a3777536f1be7a8ccbb6170611492f9b2733...602e5f8f115b6625011e2e6c2d36c1d28715c4b9,2,6,1,7,2,2014-01-27 01:44:01,2014-01-27 01:31:11
3157a3777536f1be7a8ccbb6170611492f9b2733...e38fd138ce04d73e03100a3ea42496fc914120e9,3,3,13,16,5,2014-01-26 05:40:56,2014-01-26 05:40:56
aaabe2a46c64e7d9ffd5735dba2db4f3cf9906f5...5ffb6d670683a32ec2a31c8550ea2669bfac7559,1,9,0,9,1,2012-05-01 15:01:26,2012-05-01 15:01:26
5ffb6d670683a32ec2a31c8550ea2669bfac7559...dcc89e7400ae9e7575ea2671d27b514db9beaf3f,1,1,1,2,1,2012-05-01 15:06:19,2012-05-01 15:06:19
dcc89e7400ae9e7575ea2671d27b514db9beaf3f...ca369c4b2af2a94acea00cd228d87a30fe5d2886,1,1,0,1,1,2012-05-01 15:54:53,2012-05-01 15:54:53
aaabe2a46c64e7d9ffd5735dba2db4f3cf9906f5...a29e5a9dd69f09b39b74f31e8131b7d9e633e9a1,4,4,4,8,4,2012-04-26 04:52:05,2012-04-26 04:52:05
a29e5a9dd69f09b39b74f31e8131b7d9e633e9a1...fc509e14b24fedde3fa6179b89ab2210a5630788,1,1,1,2,1,2012-04-26 05:14:39,2012-04-26 05:14:39
fc509e14b24fedde3fa6179b89ab2210a5630788...ffb4d9025b7ef3c198558cc71ca3d30cf8c99a1c,3,3,3,6,3,2012-04-26 05:15:39,2012-04-26 05:15:39
aaabe2a46c64e7d9ffd5735dba2db4f3cf9906f5...99c3b7810bd60cfad9a667a14f34c7b59de0ee84,1,1,1,2,1,2012-04-25 15:16:59,2012-04-25 15:16:59
ce944421042def2782fc8699e16d872ee6dce4e3...c7dc4cc573c61306ae849d316f432160b16a2099,4,6,4,10,6,2012-04-15 05:43:36,2012-04-15 05:43:36
8575a452942001bce522e8e258d9e192d24cb6ec...d5063e5dc8e62ecb23dd85d9dc3177b81852d1cf,5,0,0,0,0,2012-04-14 23:59:49,2012-04-14 23:59:49
d5063e5dc8e62ecb23dd85d9dc3177b81852d1cf...dbde2dc9e40f077af4fcaa1714ade7bc94398da9,5,162,29,191,18,2012-04-15 00:15:16,2012-04-15 00:15:16
8575a452942001bce522e8e258d9e192d24cb6ec...575f18aaf49abb0289185f6409bee031947ccf69,29,303,259,562,186,2012-04-14 23:29:53,2012-04-14 23:29:53
575f18aaf49abb0289185f6409bee031947ccf69...c291e4d78681b5111b4a2c7f480bd7bf18abc34c,1,2,2,4,2,2012-04-14 23:32:20,2012-04-14 23:32:20
c291e4d78681b5111b4a2c7f480bd7bf18abc34c...81a296d06ab4e445918c41bc885a610d55a33271,1,1,1,2,1,2012-04-14 23:38:44,2012-04-14 23:38:44
81a296d06ab4e445918c41bc885a610d55a33271...3408064d00bc1e4322c3ea1575bc2cab5aaa2be2,1,5,0,5,1,2012-04-15 00:15:03,2012-04-15 00:15:03
19469aa52cafb3d8d708858b02a33c25d4e5e620...cf4924764c94cc7c5f05cef60cc8a68199faf3f2,2,14,22,36,2,2012-04-15 06:11:19,2012-04-15 06:11:19
cf4924764c94cc7c5f05cef60cc8a68199faf3f2...1ca1ef94ee80b8c5fa5f2a1e908a8d00fdfdf268,3,6,8,14,4,2012-04-15 06:24:19,2012-04-15 06:24:19
1ca1ef94ee80b8c5fa5f2a1e908a8d00fdfdf268...be0efcfcfca603bc65484464e0aeaf7b2fc145c2,3,2,2,4,2,2012-04-15 06:38:11,2012-04-15 06:38:11
be0efcfcfca603bc65484464e0aeaf7b2fc145c2...c262ead6ed63408bbe062187fd4aa8aeb5da2e70,2,1,1,2,1,2012-04-15 06:51:08,2012-04-15 06:51:08
917f11e6799ddd43b439ce1f7a10c1a7360bcf3b...d27fc24aa027f4c9bdb9aa3648eebfcd6aed5acf,3,2,2,4,2,2012-03-27 16:21:13,2012-03-27 16:21:13
917f11e6799ddd43b439ce1f7a10c1a7360bcf3b...5d2062a3ccb0fed4901fc9f312c961d042f569bf,5,18,14,32,12,2012-03-27 06:36:34,2012-03-27 06:36:34
4410ede8ed976f449d9b1735652e081ed863a131...b86969f762c7c1c94e75eebd9905ef568713d647,4,103,90,193,42,2012-02-22 16:21:29,2012-02-22 16:21:29
b86969f762c7c1c94e75eebd9905ef568713d647...a0ec4224440d7f11ae971b1d5d2f3a5e343c6e4f,3,6,4,10,2,2012-02-22 16:36:07,2012-02-22 16:36:07
a139167489e249345933b1e58cc7c53542abab97...92a54a7b723065ad6c64520b2a75b410682fc755,4,10,10,20,6,2012-02-22 16:12:25,2012-02-22 16:12:25
3aea86370d7d6c717939eebcd6f3a93776c567d4...72117c3f9751d9ccb7bebf76f8a5776c99a51857,1,69,69,138,47,2012-01-24 21:57:44,2012-01-24 21:57:44
72117c3f9751d9ccb7bebf76f8a5776c99a51857...f03e170054be081738493c6dace4b37a7a3d40cd,1,67,67,134,44,2012-01-24 22:08:03,2012-01-24 22:08:03
58f7fd308a5c4511cf9a10a12c89d550c469b3f1...8ff621aa26dee69088b527089cdd719bce68be31,9,480,385,865,39,2012-01-25 00:07:30,2012-01-25 00:07:30
e24bd40b4a38b190caad2da9b90c683167c76004...a4b8cc2a9c8c7f16c4a93e64d2a187d839bfbb40,1,2,4,6,3,2012-01-25 19:30:30,2012-01-25 19:30:30
a4b8cc2a9c8c7f16c4a93e64d2a187d839bfbb40...58d08a2db3e2ed1b789a5290ced2f0327c9c163b,5,37,10,47,13,2012-01-25 19:35:08,2012-01-25 19:35:08
58d08a2db3e2ed1b789a5290ced2f0327c9c163b...06017b26ca5a9c835edb9d42188431fa30c7e499,3,12,1,13,4,2012-01-25 19:47:36,2012-01-25 19:47:36
25519bacd56ee2507cdde727d85458e5e5ef7949...319b65e64b6882ad2184f398f1763543cfa48a16,1,1,0,1,1,2012-01-25 19:49:00,2012-01-25 19:49:00
c1dd1f586dcb5bafc927d4eb1b180a0737a62cd8...731821b78f059f78800baa721410341f786698b5,1,22,8,30,9,2012-01-25 04:26:54,2012-01-25 04:26:54
731821b78f059f78800baa721410341f786698b5...a03fbc18cb50c7735b80e3ced6a6ebbe2ea05d2b,3,10,2,12,4,2012-01-25 04:30:26,2012-01-25 04:30:26
8db0cc6fdadb2b08cc4aaff7ef0527f69f271cc1...ef869776e5a4642f3cab1589cfef5d199a347362,1,333,333,666,187,2012-01-24 23:00:35,2012-01-24 23:00:35
8db0cc6fdadb2b08cc4aaff7ef0527f69f271cc1...fea1dc906e153440896a8c62d89fd2dfa7c39b9a,1,58,58,116,27,2012-01-24 22:23:43,2012-01-24 22:23:43
8db0cc6fdadb2b08cc4aaff7ef0527f69f271cc1...f4543ecb19f41f93db94e56601e0a4132ea4828f,1,37,37,74,19,2012-01-24 22:14:01,2012-01-24 22:14:01
f4543ecb19f41f93db94e56601e0a4132ea4828f...a800d6ceac11eb834295567c20e890abf88c64af,2,54,54,108,26,2012-01-24 22:22:02,2012-01-24 22:22:02
f2fe2b1798380ab65e88281ab4db47965cd5aaf8...6ab56051fdf916f03efb8aa6675e50bdd1cc3155,9,1117,721,1838,58,2012-01-25 07:35:34,2012-01-25 07:35:34
f2fe2b1798380ab65e88281ab4db47965cd5aaf8...5e5e87fbd0f577256d8a2b479bb9ed2187ff7f91,3,23,20,43,7,2012-01-25 06:33:33,2012-01-25 06:33:33
5e5e87fbd0f577256d8a2b479bb9ed2187ff7f91...5a54a98925f4f7375bdf63f86d21908b05af187e,6,6,6,12,6,2012-01-25 06:37:35,2012-01-25 06:37:35
0523c053a79430b3dab775fab2d572841f743c5a...a583f055b382ae2f721e49dea61340257e1482d0,1,7,7,14,4,2012-01-22 21:32:16,2012-01-22 21:32:16
1339ab7a130600330b1db4e3acae9760710a0a41...5f3a980950fdb30adb57806a39b15f254b6f6896,1,11,0,11,2,2014-10-31 00:06:54,2014-10-31 00:05:17
1339ab7a130600330b1db4e3acae9760710a0a41...88dfd954fa8b0eeefe37482ffd1dba19b1369098,1,5,5,10,3,2014-10-30 18:36:24,2014-10-30 18:31:28
b26eb44305ddc9f9d83192f8f734ecf27f2f04e7...7bdc307b70caaad69fd88a6a9dd6de6a97e1505c,1,1,1,2,1,2014-11-13 23:18:55,2014-11-13 23:18:55
a7682e3fde01e2b5e7c12cea10ca2d4251f73e69...0ada807ce6b99b95ce159a6b236309ab0ac425b3,1,6,1,7,1,2014-11-16 14:48:08,2014-11-14 15:09:50
7527ce93c97f37ca078893a90f19bd1e8f6c2702...bc5a753b67c2ce434f64ba4c2f9baa58773604fb,1,1,0,1,1,2014-11-21 07:26:37,2014-11-21 07:26:37
9928144dc4e8301ee0dd02ac073682d789b2adb1...d74fd9af2f694ba2b700ed95423ba865175992b9,2,83,1,84,5,2014-11-30 08:54:43,2014-11-30 08:54:43
d74fd9af2f694ba2b700ed95423ba865175992b9...bcb90ef3a0affa6540d141733a073593011af064,23,1315,655,1970,34,2014-11-30 09:31:49,2014-11-30 09:31:49
0eb2c922d892bdcd4356b7212ab61c7d8a44c2dc...a17f23c022aab37872b1801efa3a58cf73123fe0,1,0,9,9,1,2014-12-01 09:39:31,2014-12-01 09:39:31
a17f23c022aab37872b1801efa3a58cf73123fe0...0445f23b728da63dab41e82c9f4aaf084e48bd98,1,3,2,5,3,2014-12-02 20:31:55,2014-12-02 20:28:07
4d2f68c4376741d1b261fd172d64518662383a63...9c526bf519c21587273f3e5324ba42bc49507a3b,3,6,2,8,4,2014-12-21 06:20:46,2014-12-21 06:20:46
9c526bf519c21587273f3e5324ba42bc49507a3b...28d847a1e03005403a0bc01e3328edf7598656cd,8,13,9,22,10,2014-12-21 07:05:23,2014-12-21 07:05:18
7e758f60fcb8f5391ea48cacf432c76e8b747909...37183edfd5682de22d338760d84b6dcd75eb8fe9,1,14,8,22,5,2014-12-05 21:06:01,2014-12-05 20:58:47
4e2db80cbf60bac765f76aa1b10741cfd5ba0f67...61bbe74df11b302a4e61ae027c44ef5ec80edfcf,4,2876,2007,4883,528,2014-11-30 10:51:16,2014-11-20 06:04:47
520b3547a49c14874d59207a2a37f8542dc89c6e...dc22226b95adba748dfc82fddfe1d128d9d8e057,1,1,1,2,1,2014-07-07 07:23:12,2014-07-07 07:23:12
cb2ef1eff4cbfad8998f94adf7f61cdf574ca100...e6788ef979854800211cbb71c2a84e89e4873988,1,7,15,22,3,2014-05-08 23:49:19,2014-05-08 23:48:37
4f5efb84c9e81120b26949cecc626ae866fef46a...7c50b9ad7a5bbcc6728dcd501e396c3bf5247b31,5,17,17,34,17,2014-07-08 02:24:32,2014-07-08 02:22:00
4f5efb84c9e81120b26949cecc626ae866fef46a...bb939f0004ce96de8598c72197d39809f7af175c,2,3,2,5,2,2014-07-08 01:20:18,2014-07-08 01:20:18
5ea6b576161d1f931e3995548fe8e3f2153070ee...2c4641855dd0505608566489392ed35aaa6cf2e3,2,2,2,4,2,2014-07-24 22:16:08,2014-07-24 22:15:05
5ea6b576161d1f931e3995548fe8e3f2153070ee...43fe197da7556b77c421699aca61eddf93a59d7c,1,27,1,28,2,2014-07-24 20:58:13,2014-07-24 20:57:39
4300d430e6fd3c332eff78fe579002c25af44c23...8bee6549ade7103b7de805ae92ccff50102008b0,8,1538,1513,3051,514,2014-06-18 01:23:14,2014-06-18 01:23:14
5b9e2bf1265eb50c0d4105b2eb3da12280c37430...128e52ff29be0f275bb92693c9db3ba34d5c003d,4,10,9,19,8,2014-06-17 22:00:28,2014-06-17 21:35:35
d37b0ffa5f12a659e98a84f3f7d94c1fe1162405...3c4ba2a08cef519f2135922f0549bf787cf3010d,8,3607,53,3660,12,2014-06-19 18:46:37,2014-06-19 17:47:55
d37b0ffa5f12a659e98a84f3f7d94c1fe1162405...8c1160d91bf0a7599a1b519592829dfb396fd847,2,4,0,4,2,2014-06-19 14:07:18,2014-06-19 09:26:55
a0e98adebf949e83ffadcd1604ea5c1a3b3fe531...dc7da296e4f658a32c618b9b01bb00645c272be8,2,26,26,52,13,2014-06-24 15:58:38,2014-06-24 07:54:19
dc7da296e4f658a32c618b9b01bb00645c272be8...25ca51319b016bc4e42e1ba882d6f191e001d65d,1,2,1,3,1,2014-06-24 16:01:40,2014-06-24 15:57:33
25ca51319b016bc4e42e1ba882d6f191e001d65d...15c63fa137114dd660e48b00dc566246f5557bb9,10,1476,1549,3025,505,2014-06-24 16:01:40,2014-06-24 16:00:14
a0e98adebf949e83ffadcd1604ea5c1a3b3fe531...e9ac7c1e1c9198753f8a7ad706cc2bb20c9976ad,1,7,0,7,1,2014-06-24 15:08:16,2014-06-24 15:08:16
a0e98adebf949e83ffadcd1604ea5c1a3b3fe531...6b6476fcd93d8ab368afa9149361fac43d15019e,1,22,6,28,2,2014-06-24 06:39:54,2014-06-24 06:32:52
80ef14a11a8d1ee2c9e3f0fdfb90dec26c1377a8...7ba2eede4eb6130b2778a5efc019e41283c1cb52,1,1,1,2,1,2014-01-30 05:44:36,2014-01-30 05:44:36
7ba2eede4eb6130b2778a5efc019e41283c1cb52...9195d8e8eb51208e4272e4c7e0851e2695da1a0d,6,4,6,10,6,2014-01-30 05:57:44,2014-01-30 05:57:44
9ec5905c079230f2f770ca92912ce10860a07ed9...545c957f1741e1a6d6916dcbf08d15f6318d5575,6,17,4,21,6,2014-01-30 05:23:23,2014-01-30 05:23:23
545c957f1741e1a6d6916dcbf08d15f6318d5575...d631e0b92d6ff7c6737bcedb38acc58446b3e7cc,8,20,11,31,11,2014-01-30 05:34:10,2014-01-30 05:34:10
45b964c246001c45ef0108d45c421d527db7ef0e...72568ce588e5925d7d36a26c02f6e9f227344c70,1,1,1,2,1,2014-01-25 20:03:44,2014-01-25 20:03:44
d2f1887bb5e7b651b11d6dd22ce191c733717a83...d4b1bfd667631f1d96a0b6ec4e734338e5b8811d,3,6,2,8,3,2014-01-30 06:44:06,2014-01-30 06:44:06
b261f9781bbf31f499cb55c49451dc0c0ad43062...a85c8fe74e2bea9c99ad405dd667035b5307e31e,1,5,0,5,1,2012-05-28 03:07:58,2012-05-28 03:07:58
b261f9781bbf31f499cb55c49451dc0c0ad43062...34e5bc5f1d3ea24c7fa6249bc5103e1cf94c3d4e,1,3,0,3,1,2012-05-24 09:57:02,2012-05-24 09:57:02
b261f9781bbf31f499cb55c49451dc0c0ad43062...642f75141d96aa7a9bde3c2288112d09d34fb3d3,1,3,3,6,3,2012-05-21 00:56:57,2012-05-21 00:56:57
b261f9781bbf31f499cb55c49451dc0c0ad43062...faf2866f96513dc1c2775974518d979feb554dbd,1,0,3,3,1,2012-05-20 08:54:21,2012-05-20 08:54:21
b261f9781bbf31f499cb55c49451dc0c0ad43062...a404ac33bb9e78323b84d0840735445579634b9e,6,251,194,445,71,2012-05-17 02:09:57,2012-05-17 02:09:57
b261f9781bbf31f499cb55c49451dc0c0ad43062...e9a7d26d0636445fb20def22db54fe703164031b,1,2,1,3,2,2012-05-14 12:03:36,2012-05-14 12:03:36
e9a7d26d0636445fb20def22db54fe703164031b...e388a5e475867cd266d58caf83b614aafe06cc10,2,20,2,22,3,2012-05-20 17:59:53,2012-05-20 17:59:53
e388a5e475867cd266d58caf83b614aafe06cc10...8dda83906d72ade81ecf9b21d55b5a2922589d30,1,7,7,14,7,2012-05-20 18:10:21,2012-05-20 18:10:21
b261f9781bbf31f499cb55c49451dc0c0ad43062...ad46b0980caf9a943ca213ce240083f7a65ac993,2,68,0,68,2,2012-04-30 22:06:26,2012-04-30 22:06:26
ad46b0980caf9a943ca213ce240083f7a65ac993...6e9756ebb682dbb1ea9c9a75653838bd130a9cb6,3,8,8,16,4,2012-04-30 22:30:56,2012-04-30 22:30:56
6e9756ebb682dbb1ea9c9a75653838bd130a9cb6...c204bc66d693b1dece2d69384431ae7a4e88b80f,2,8,8,16,8,2012-04-30 22:33:35,2012-04-30 22:33:35
c204bc66d693b1dece2d69384431ae7a4e88b80f...59ec4c7154984bd2847ff434fae7874f0b8e5265,2,2,2,4,2,2012-04-30 22:40:49,2012-04-30 22:40:49
b261f9781bbf31f499cb55c49451dc0c0ad43062...ec56940c511df165784a2a203be8e05644661c46,1,5,5,10,5,2012-04-27 17:48:59,2012-04-27 17:48:59
b261f9781bbf31f499cb55c49451dc0c0ad43062...bf9d8fcc070fa826c342282e102fe00e1af76d10,3,50,8,58,7,2012-04-26 18:09:20,2012-04-26 18:09:20
b261f9781bbf31f499cb55c49451dc0c0ad43062...ab178060be19a60f52dc548d4cfd505c1e30ace5,1,1,1,2,1,2012-04-26 14:38:47,2012-04-26 14:38:47
c7dc4cc573c61306ae849d316f432160b16a2099...b14455b03a977cbbf99112d39b55461785666a3f,2,64,22,86,3,2012-04-15 06:10:03,2012-04-15 06:10:03
ce30d19c1507e71199f7dbbf680cf0d2b0ea6477...34132f0e890cacc8eb2dc0cf2ce3132986f14adf,1,0,0,0,0,2012-04-15 00:19:00,2012-04-15 00:19:00
34132f0e890cacc8eb2dc0cf2ce3132986f14adf...82267d48ffb522ed4c9cb491660f7d1c8a9e0236,4,16,9,25,9,2012-04-15 00:49:51,2012-04-15 00:49:51
cad8f2b43acac39958c5f3fb04e9d922900e7b89...498b7d984a8182442e2f543eedff6542c628cd55,4,12,37,49,27,2012-04-16 22:09:05,2012-04-16 22:09:05
cad8f2b43acac39958c5f3fb04e9d922900e7b89...13e4d1d5ac90484c09ecb1a98e540309d043a6f7,2,5,0,5,2,2012-04-15 07:35:30,2012-04-15 07:35:30
c262ead6ed63408bbe062187fd4aa8aeb5da2e70...2a6894d834c0866e2bbd3d7aa7d824b4355e61f7,2,7,7,14,3,2012-04-15 07:16:09,2012-04-15 07:16:09
2a6894d834c0866e2bbd3d7aa7d824b4355e61f7...e985681758c3fef534f5bbe86c12b884a8333cbe,2,2,1,3,2,2012-04-15 07:19:25,2012-04-15 07:19:25
5b3268317c479c9cc50d7a1270b9138e748b8956...0fe68de1a47b9204443d959ff9a96af6546c53ca,3,2,2,4,2,2012-03-27 16:22:15,2012-03-27 16:22:15
0fe68de1a47b9204443d959ff9a96af6546c53ca...e41584afb528f3e4f12d91ecd676e1be00d5febc,3,8,0,8,2,2012-03-29 00:02:13,2012-03-29 00:02:13
e41584afb528f3e4f12d91ecd676e1be00d5febc...93d42ca80e7f100f7543a9689ae80de51b978eae,3,56,48,104,28,2012-03-29 00:35:06,2012-03-29 00:35:06
93d42ca80e7f100f7543a9689ae80de51b978eae...66743676ce83552fbab86ced2fc9e890d0dde6a6,3,49,352,401,9,2012-03-29 00:41:40,2012-03-29 00:41:40
66743676ce83552fbab86ced2fc9e890d0dde6a6...369ca13c7594a2b21e867fb4c139ebc21abd4d2e,4,3,3,6,3,2012-03-29 00:52:03,2012-03-29 00:52:03
369ca13c7594a2b21e867fb4c139ebc21abd4d2e...d6680a50b9d4518449b569259a0f150619d4074d,3,28,50,78,14,2012-03-29 01:00:05,2012-03-29 01:00:05
d6680a50b9d4518449b569259a0f150619d4074d...3308d1968f37eb81ef1578a409742e93813a8492,3,2,2,4,4,2012-03-29 01:18:41,2012-03-29 01:18:41
7e6797880a969de8b3d44be91dbc765b6ab48612...b9bd5c65e76eea140b0121d5cbca00c43f3ae018,2,14,106,120,8,2012-01-25 00:18:12,2012-01-25 00:18:12
b9bd5c65e76eea140b0121d5cbca00c43f3ae018...c2312220e4e1da3939c9fa79e97d79f693058ea2,3,4,4,8,4,2012-01-25 00:19:01,2012-01-25 00:19:01
06017b26ca5a9c835edb9d42188431fa30c7e499...86191d898b2520611b537892e33be3b179f83199,3,4,4,8,4,2012-01-25 19:51:13,2012-01-25 19:51:13
86191d898b2520611b537892e33be3b179f83199...2b2c72b9aae6db9505d0fdb3abc1832de8e0ce7f,3,9,9,18,8,2012-01-25 20:04:19,2012-01-25 20:04:19
3250ecc674306ab82f9379325e6eec0bb4ba6dd0...04f84997c18f2f132c8173f728f72b6b7aef52d1,3,4,4,8,4,2012-01-25 19:49:34,2012-01-25 19:49:34
aa59f123c074c01f84e8e27c1ac5431f819d4816...a5c1d1f1828c333e373cdc5da5da2f6d946ad45e,9,34,24,58,15,2012-01-25 04:45:38,2012-01-25 04:45:38
4c5497bfcc2949aca8d16c7829960cfba9b68122...3a840075ddd4c9aea61b4aed792bda94ec0c3a66,3,5,5,10,5,2012-01-24 23:42:16,2012-01-24 23:42:16
3a840075ddd4c9aea61b4aed792bda94ec0c3a66...655a96869c9ba1c678eddc961332b9dd0fccb8af,1,1,1,2,1,2012-01-24 23:51:28,2012-01-24 23:51:28
e555f38ae4b1a2503b8bd3599894bb6011e0adbd...ae70d2a8b6db76d0b3a2a2ef4540a270f0f5c257,1,2,1,3,2,2012-01-25 07:44:59,2012-01-25 07:44:59
5a54a98925f4f7375bdf63f86d21908b05af187e...6be91368c07ad2b3201d1c669b27fbafb46d0d0e,2,7,1,8,2,2012-01-25 07:24:46,2012-01-25 07:24:46
6be91368c07ad2b3201d1c669b27fbafb46d0d0e...64f85e037102425062a43ba17b9d5b1f4c4acba7,1,1,1,2,1,2012-01-25 08:02:37,2012-01-25 08:02:37
5a54a98925f4f7375bdf63f86d21908b05af187e...5d3175e84b2ada0978aca7dbbe2ec532e99c869a,4,21,21,42,4,2012-01-25 06:48:30,2012-01-25 06:48:30
3711abf93622e11b36e9ff03583e904c28ce218a...505171ef5d127e0e9a4ec82641396fd43804ace4,1,3,3,6,1,2014-10-31 00:38:40,2014-10-31 00:37:54
505171ef5d127e0e9a4ec82641396fd43804ace4...b91474e53858b3aa5fd70674374befaf856453d9,1,1,1,2,1,2014-10-31 09:31:56,2014-10-31 09:31:56
2da290189e10ece9a381508287851dec2ae40f9f...08b0c373b54a88648ee88f2249e2ad5e4ae186fe,1,7,1,8,2,2014-11-01 00:08:28,2014-11-01 00:08:01
7bdc307b70caaad69fd88a6a9dd6de6a97e1505c...db4e5efb8f1ddf1720f20440bdc1e050f98e78e0,6,85,88,173,79,2014-11-14 13:40:09,2014-11-14 12:37:31
7bdc307b70caaad69fd88a6a9dd6de6a97e1505c...27d9d35ffd2ec9787374247b373d0cf96cdad3e8,1,1,1,2,1,2014-11-14 10:52:56,2014-11-14 01:15:54
27d9d35ffd2ec9787374247b373d0cf96cdad3e8...25cac1ea9a70ab192a4b4fb49b972de2f342d240,6,42,42,84,42,2014-11-14 10:52:56,2014-11-14 01:27:47
25cac1ea9a70ab192a4b4fb49b972de2f342d240...bab36220c98bc9552a483d5d091cb8d8acfd3d31,16,34,34,68,34,2014-11-14 10:52:57,2014-11-14 01:44:09
7bdc307b70caaad69fd88a6a9dd6de6a97e1505c...cd03436379cf911b111f5400e36c2ba7eb923714,1,1,1,2,1,2014-11-14 06:20:30,2014-11-14 06:20:30
bc5a753b67c2ce434f64ba4c2f9baa58773604fb...6e9d4e69077ddac730f65792469bdd8491315ad0,1,1,1,2,1,2014-11-23 01:48:49,2014-11-23 01:48:49
bc5a753b67c2ce434f64ba4c2f9baa58773604fb...7bf002d63d8abf8847f09673871edd4aed70670d,1,80,48,128,16,2014-11-22 12:45:32,2014-11-22 12:45:32
e6fc081c91475237348fb1c75cf307a4acd69161...88ec5152da1453a6376739e4f0dd7f24187b9b56,1,21,8,29,6,2014-12-01 01:10:13,2014-12-01 01:10:13
0445f23b728da63dab41e82c9f4aaf084e48bd98...a527aaa11485edb260e2058544569b6ab1f7330a,1,2,1,3,1,2014-12-02 20:56:30,2014-12-02 20:53:05
28d847a1e03005403a0bc01e3328edf7598656cd...dc7ab34cc9f857bcc059b584d67dea40548a3d56,1,0,11,11,1,2014-12-22 20:15:44,2014-12-22 20:14:44
f1102430eca4b498294b457020bedda8a8890d52...08f388679b7e77104d3129733feffb956b10dcf0,1,1,1,2,1,2014-12-06 21:55:31,2014-12-06 21:55:31
d5a4db48cce91e84feeb6f57cb9fdf9472e1c827...2a1a3e6806f2edb73e9f30e63f950a787032dae1,11,0,0,0,0,2014-11-30 11:16:27,2014-11-30 11:16:19
488778857a0602ec7c68b971b780b8961e3a22de...719cde1a111b25f05a3d254a8f5b8228e1e6158e,1,1,1,2,1,2014-07-07 07:25:55,2014-07-07 07:25:55
48fd9e29a24ae7fd8d8061e62a099c6097c41f18...056a192f95de23b6bb9092b224f36f85fe253b04,1,1,1,2,1,2014-05-10 16:39:34,2014-05-10 16:39:34
48fd9e29a24ae7fd8d8061e62a099c6097c41f18...b7ac0d401f4100a40028e8b75d6130b70e4d9390,4,12,12,24,11,2014-05-09 22:31:52,2014-05-09 22:31:52
48fd9e29a24ae7fd8d8061e62a099c6097c41f18...e9374c0609c9e63fd6033f684b18ff105e1756ae,5,12,12,24,12,2014-05-09 22:05:20,2014-05-09 22:05:20
e9374c0609c9e63fd6033f684b18ff105e1756ae...0a808fc56ca0983d45556fa9ccd5da80445b23c2,1,12,12,24,4,2014-05-09 22:12:57,2014-05-09 22:12:57
696844fe08f26a72725c984f160bba11cfbebc5d...b5f9e2eb608012e26666ec1e851e7765051b0726,1,12,3,15,3,2014-05-13 04:52:44,2013-09-14 08:11:07
b5f9e2eb608012e26666ec1e851e7765051b0726...d5d64c2e4e8afbbe8a5331ef1dd9b51f40c30160,1,1,1,2,1,2014-05-17 17:22:57,2014-05-17 17:22:57
696844fe08f26a72725c984f160bba11cfbebc5d...54284a13c6b503d925bf6f75db2830f1af7fcf98,1,36,0,36,2,2014-05-12 19:54:10,2014-05-12 19:54:10
696844fe08f26a72725c984f160bba11cfbebc5d...96bdc56fdebca9ec7d024d2fd07bf766b1e1881e,1,1,3,4,3,2014-05-10 20:31:18,2014-05-10 20:31:18
96bdc56fdebca9ec7d024d2fd07bf766b1e1881e...f5513fd30ef16228869b1ec3473217dab63f2c29,18,16,7551,7567,20,2014-05-13 02:47:53,2014-05-13 02:47:53
2c4641855dd0505608566489392ed35aaa6cf2e3...3e15e40ac9515d1774bad69fe3a88e912da50ab3,1,1,1,2,1,2014-07-25 12:54:05,2014-07-25 12:54:05
2c4641855dd0505608566489392ed35aaa6cf2e3...098242afd8cf24087ff76ecef53e945666ca9edf,1,0,1,1,1,2014-07-25 11:03:07,2014-07-25 11:03:07
8bee6549ade7103b7de805ae92ccff50102008b0...85c15eec0fc585b512cb323caf0044ae03aa2afe,1,1,0,1,1,2014-06-18 01:48:15,2014-06-18 01:48:15
8bee6549ade7103b7de805ae92ccff50102008b0...e42de7511ab95532c3d1fee5d58757def86ca607,2,13,13,26,8,2014-06-18 01:29:17,2014-06-11 06:30:30
77ff226e3f883cd0546e79f0430e3139e232886e...7bc8db9558bf222196ab57d176aff08fab6ee552,1,1,1,2,1,2014-06-19 19:08:04,2014-06-19 09:40:16
7bc8db9558bf222196ab57d176aff08fab6ee552...09c2e41ec4c7f3892ee3568f70bf5aef7245cdb2,1,4,4,8,6,2014-06-19 19:08:05,2014-06-19 09:40:56
09c2e41ec4c7f3892ee3568f70bf5aef7245cdb2...587451ad9a2b288ed54857c6ac291609a6394c6f,6,7,7,14,7,2014-06-19 19:08:05,2014-06-19 09:41:23
587451ad9a2b288ed54857c6ac291609a6394c6f...f983e4944f474d3bbfb9ac1890465881c759d397,1,784,500,1284,51,2014-06-19 21:37:01,2014-06-19 21:37:01
c975f42e042bd3df11ed574b79eae3e963f9edbb...df1aee56dfe91aabbba2df0d868447c82baae64d,2,97,33,130,16,2014-06-24 19:17:24,2014-06-24 19:11:39
df1aee56dfe91aabbba2df0d868447c82baae64d...6ec5b8cea8c7a787db3ae1393f258f2803c4da23,1,1,0,1,1,2014-06-24 19:17:38,2014-06-24 19:12:21
c975f42e042bd3df11ed574b79eae3e963f9edbb...8ad583063bd11e1b8841e1f27207660e0181df19,1,3,8,11,3,2014-06-24 16:30:24,2014-06-24 16:30:24
d4b1bfd667631f1d96a0b6ec4e734338e5b8811d...0da527f169dbf20a30db2a6ae57b479ac867fa6c,1,1,4,5,2,2014-01-30 13:55:19,2014-01-30 13:55:19
d4b1bfd667631f1d96a0b6ec4e734338e5b8811d...d002f0459dfa40309fc851eee4cf3bd46dbcfb05,1,2,2,4,2,2014-01-30 12:44:05,2014-01-30 12:44:05
917b46a3430b33b7f2cde9ffe67a13aaa935e9a3...143fef9f95daca088c1a910fccd07f2b520d8b0b,6,337,111,448,35,2012-09-18 01:15:39,2012-09-18 01:15:39
23401e811f28f1ef351274661bf1f1bc8a8bc8af...8f4424585094354589fbab80d5b0e6b1bb6d87cf,3,11,1,12,4,2012-05-13 21:31:31,2012-05-13 21:31:31
5657ab46c5351d5a5718eff3e8f7acf5cb43f752...ebc69356637143c938c07904d10928c11e742196,31,42,42,84,42,2012-06-01 18:04:27,2012-06-01 18:04:27
72e3b3beb375706254db144adc632ae90c8fbaad...7fa9f605d624fd1cc28ec610b3763714d3865a6b,1,4,0,4,1,2012-05-25 02:18:06,2012-05-25 02:18:06
7fa9f605d624fd1cc28ec610b3763714d3865a6b...c1c679b644998efa98374158d667b14cd99d4864,2,34,36,70,4,2012-05-25 03:13:59,2012-05-25 03:13:59
c1c679b644998efa98374158d667b14cd99d4864...76ee212343289577a2e06f03a0ecea9d09ab7bcc,2,8,8,16,4,2012-05-25 03:16:25,2012-05-25 03:16:25
76ee212343289577a2e06f03a0ecea9d09ab7bcc...fe30bd60553bea0f706725deb9a0ad9ef04f0247,2,9,0,9,2,2012-05-25 03:18:52,2012-05-25 03:18:52
fe30bd60553bea0f706725deb9a0ad9ef04f0247...aaf1825b49a5b6a197d482499f66bd931dc9bf7b,2,2,2,4,2,2012-05-25 03:26:08,2012-05-25 03:26:08
aaf1825b49a5b6a197d482499f66bd931dc9bf7b...7dbcd0be9a797bc3c537d4fea5e84ce40808e886,11,1008,1022,2030,34,2012-05-25 04:30:43,2012-05-25 04:30:43
7dbcd0be9a797bc3c537d4fea5e84ce40808e886...a7529e158be8153fd350d19445e9e93261050c55,2,0,2,2,2,2012-05-25 16:19:10,2012-05-25 16:19:10
a7529e158be8153fd350d19445e9e93261050c55...cc8b260ed8730f7e971e2c50fc01cdd0169cdddd,10,22,0,22,10,2012-05-26 23:35:28,2012-05-26 23:35:28
cc8b260ed8730f7e971e2c50fc01cdd0169cdddd...287086758be44fd35db83ffd763966b866381ce9,4,6,6,12,4,2012-05-27 06:17:23,2012-05-27 06:17:23
6fc5674466c19f7b70a41e73d8ba9671bab9235f...f53a0380885c9a5bd83aef4d17a386d99354a8f0,1,0,2,2,2,2012-05-29 00:17:55,2012-05-29 00:17:55
f53a0380885c9a5bd83aef4d17a386d99354a8f0...7875e4833cb7d00db2967078fd6f51adbfd4a351,5,65,32,97,29,2012-05-29 00:32:24,2012-05-29 00:32:24
5d27fbb32da4441fb27bdd886877013b934f8578...19489496c14525070bd759ec68583a34ea4c8547,1,0,3,3,1,2012-05-23 07:05:30,2012-05-23 07:05:30
4b53778150c37bf9b45798b3c54330b2403ac915...10c6db4b14e5eb26bd663996233e3ac3075d5cb4,7,15,33,48,19,2012-05-17 02:43:22,2012-05-17 02:43:22
10c6db4b14e5eb26bd663996233e3ac3075d5cb4...a7b49a7d92a0efa640179b775e309002afc50390,10,361,169,530,98,2012-05-17 07:23:11,2012-05-17 07:23:11
a7b49a7d92a0efa640179b775e309002afc50390...9889948f5851f5ce19668073b1f88eb4b6082ea6,8,68,89,157,62,2012-05-17 07:39:14,2012-05-17 07:39:14
9889948f5851f5ce19668073b1f88eb4b6082ea6...b1d7c34086ec95a2b0507c595e3a353cdc550b9b,1,0,2,2,1,2012-05-17 07:45:28,2012-05-17 07:45:28
bcd5097c0267a8285c2b60fd3b751cd3ae78ad7a...4eaeea81fd909e6711f57049fc4372f4045fa5aa,5,15,14,29,12,2012-05-31 17:24:23,2012-05-31 17:24:23
51153766f5f6bf557830f1cb364a99bdab389019...b6b354ceaa1b29650b2b131bf436d64b70f5f344,2,2,2,4,2,2012-04-30 22:42:55,2012-04-30 22:42:55
b6b354ceaa1b29650b2b131bf436d64b70f5f344...ef368f0076523a8d0cd6b411549d7e9af9d1cf98,2,2,2,4,2,2012-04-30 22:43:47,2012-04-30 22:43:47
c02c3c60c9a50d6e3e71805418fe41148e3d7f45...a2fb9ed42f4fedbf2045601bedc8dace4d8bbd36,2,5,5,10,5,2012-05-14 00:43:04,2012-05-14 00:43:04
a2fb9ed42f4fedbf2045601bedc8dace4d8bbd36...332d2a7384621e113282752d21987b04f1ec6388,1,1,1,2,1,2012-05-14 00:43:56,2012-05-14 00:43:56
332d2a7384621e113282752d21987b04f1ec6388...ea156609736513a4ad5aa22ef574bccbc3d23330,2,2,2,4,2,2012-05-14 04:52:18,2012-05-14 04:52:18
ea156609736513a4ad5aa22ef574bccbc3d23330...826a8714e266e488fc51bc9ca779556731b8afd3,2,18,4,22,6,2012-05-14 05:11:35,2012-05-14 05:11:35
826a8714e266e488fc51bc9ca779556731b8afd3...1b537c6f9c86806143c6e7afb3f720c99da7006c,1,108,0,108,1,2012-05-14 15:57:24,2012-05-14 15:57:24
1b537c6f9c86806143c6e7afb3f720c99da7006c...33061a8e0b5a5955c469c3e5184e989e497db4e3,2,8,4,12,2,2012-05-15 05:02:51,2012-05-15 05:02:51
33061a8e0b5a5955c469c3e5184e989e497db4e3...a0809ceebe5332a1c3e355a762d1bff3e477ce37,4,286,160,446,27,2012-05-15 06:40:06,2012-05-15 06:40:06
a0809ceebe5332a1c3e355a762d1bff3e477ce37...e28efd7da07d20d706421b3c868ccc08e0e3077d,1,3,13,16,14,2012-05-15 06:42:32,2012-05-15 06:42:32
e28efd7da07d20d706421b3c868ccc08e0e3077d...c8cafa5d5a352d33e96b8580a4a68b943f71882e,1,7,13,20,2,2012-05-15 06:45:25,2012-05-15 06:45:25
c8cafa5d5a352d33e96b8580a4a68b943f71882e...87f6e426b33590bf8b14d933cd9cbb101a9bed23,1,13,9,22,6,2012-05-15 06:50:34,2012-05-15 06:50:34
87f6e426b33590bf8b14d933cd9cbb101a9bed23...ecf84bdac51a9c56d18c4a25b3d5b0c66a09151a,2,53,12,65,9,2012-05-15 07:17:02,2012-05-15 07:17:02
82267d48ffb522ed4c9cb491660f7d1c8a9e0236...d65f7f204a918906d7ce5120b9719abf105d60c5,2,39,1,40,3,2012-04-15 04:44:57,2012-04-15 04:44:57
457859feba3ca9a64a23dd38a4d65e3faad11b04...a3ec868ac278fb4ec29b21b662f1fd417ac16f2a,3,3,3,6,6,2012-04-16 22:37:17,2012-04-16 22:37:17
a3ec868ac278fb4ec29b21b662f1fd417ac16f2a...2881269e16be1beb007633501496d6a8e8924b4b,11,137,144,281,194,2012-04-16 23:34:08,2012-04-16 23:34:08
13e4d1d5ac90484c09ecb1a98e540309d043a6f7...d374fe92e57cc75fa3bc1e664b96ed7f2191c7e0,2,17,1,18,4,2012-04-15 23:48:17,2012-04-15 23:48:17
13e4d1d5ac90484c09ecb1a98e540309d043a6f7...0b8042656fc52600e18fb1c7f54dbbe8a284e737,4,6,4,10,6,2012-04-15 23:15:32,2012-04-15 23:15:32
c2312220e4e1da3939c9fa79e97d79f693058ea2...a40d4993ed0a947083b7e85cf7772492d613afc8,2,27,0,27,2,2012-01-25 01:13:02,2012-01-25 01:13:02
c2312220e4e1da3939c9fa79e97d79f693058ea2...40e92221a616bfe4e9500bcf2b72c86844f7f03f,8,199,105,304,43,2012-01-25 00:54:35,2012-01-25 00:54:35
40e92221a616bfe4e9500bcf2b72c86844f7f03f...805a965f2e7373db42d99376d4dc3c1ca9ea509d,4,199,103,302,6,2012-01-25 01:14:19,2012-01-25 01:14:19
1c66779857066e662ff50bc8d6f05987965c0817...9c4a70c597a35f772bb21cb60dd7812146fc29ee,2,88,88,176,50,2012-01-25 20:43:38,2012-01-25 20:43:38
9c4a70c597a35f772bb21cb60dd7812146fc29ee...4ea63e5261ba0c10e2b729e2216105896108733b,6,329,270,599,65,2012-01-25 21:33:55,2012-01-25 21:33:55
4ea63e5261ba0c10e2b729e2216105896108733b...7ca3b98d885071bc032ca28e20452ad879cea422,5,37,37,74,35,2012-01-25 21:56:44,2012-01-25 21:56:44
7ca3b98d885071bc032ca28e20452ad879cea422...7d83f45ebbadf7d100b56f944718763a6ce3e55c,2,46,46,92,30,2012-01-25 22:08:51,2012-01-25 22:08:51
7d83f45ebbadf7d100b56f944718763a6ce3e55c...b6b7d1343b74713a60e86401d8b625f097a7b8dc,6,193,212,405,98,2012-01-25 23:03:44,2012-01-25 23:03:44
b6b7d1343b74713a60e86401d8b625f097a7b8dc...0db2d45350a67bc1a98c0f2d1c4706e3bd25ca50,4,6,10,16,6,2012-01-25 23:04:41,2012-01-25 23:04:41
0db2d45350a67bc1a98c0f2d1c4706e3bd25ca50...e877d125d7a2c673fec4e63600c2d8544c3128f6,8,17,17,34,13,2012-01-26 04:02:32,2012-01-26 04:02:32
e877d125d7a2c673fec4e63600c2d8544c3128f6...f62c9379fb60bfb70435517b4569f586ec729d5b,4,1,101,102,5,2012-01-26 04:07:27,2012-01-26 04:07:27
f62c9379fb60bfb70435517b4569f586ec729d5b...ce467f70915a6846ed0638422114ee35d29aa1cd,3,2,3,5,3,2012-01-26 04:11:13,2012-01-26 04:11:13
04f84997c18f2f132c8173f728f72b6b7aef52d1...0777e391ee19cbc3bda7637dcbb17b5b171afac5,1,2,4,6,4,2012-01-25 23:03:36,2012-01-25 23:03:36
ae70d2a8b6db76d0b3a2a2ef4540a270f0f5c257...b0fb31be5eff9cc4d7a1b2aab70643ff4fc82618,2,2,2,4,2,2012-01-25 07:45:48,2012-01-25 07:45:48
b0fb31be5eff9cc4d7a1b2aab70643ff4fc82618...b8fa6cfacf61a02ab769b9031253c7b06111fa7c,20,783,722,1505,51,2012-01-25 09:22:29,2012-01-25 09:22:29
b91474e53858b3aa5fd70674374befaf856453d9...12b3ba72787eedec75edd0af7c01616184930068,1,1,1,2,1,2014-10-31 09:58:03,2014-10-31 09:58:03
4613b366316649ed864d1443605a1e597aecf8d0...7c0f873659b52538706bef5212372167d83c82ec,1,11,0,11,1,2014-11-01 00:33:20,2014-11-01 00:33:20
450a9ece107a2010e7d0c4eddafc58bad697b569...03f35d2daba72f3fb9f74ffae0a0837a2ce59bdd,1,0,1,1,1,2014-11-17 11:19:05,2014-11-17 11:19:05
14857bd4a2d4486a12d0f8bacb3abd703cf8c1c7...a577f1922ee7054a97b455ccfaa16857cb2b79fc,1,1,1,2,1,2014-11-14 14:18:34,2014-11-14 14:18:34
14857bd4a2d4486a12d0f8bacb3abd703cf8c1c7...4d2fb67050a4d1aee254a7b18fdc75d64f7984ad,1,18,18,36,18,2014-11-14 09:28:17,2014-11-13 17:31:17
1a2baf48735ee1762ce046e5bb24f5c8d6ba187a...7876ebd2ed230334a3e591ce550bac702c845da5,1,1,1,2,1,2014-11-17 00:34:28,2014-11-17 00:34:28
6e9d4e69077ddac730f65792469bdd8491315ad0...8a4757dfb09438407ffd3b989db4e0f421a7c46e,1,1,1,2,1,2014-11-23 02:33:08,2014-11-23 02:32:47
33c4a2f1d7638fae91e03eeffce23c57cfb54e9e...7ea49019b86f8bf69008565b9369d8762223f4e2,9,10,10,20,9,2014-11-24 07:53:42,2014-11-24 07:53:42
5cb0d933c95deaa54b2e37ddd48fe4595d72389b...2c1c885ed4978900fb2a5e3310a428fd72b89c12,3,3,2,5,3,2014-12-03 00:51:08,2014-12-03 00:51:08
2c1c885ed4978900fb2a5e3310a428fd72b89c12...66217e4a85c1b443a9f9c2b772d508321612cb67,3,2,3,5,3,2014-12-03 07:02:46,2014-12-03 07:02:46
66217e4a85c1b443a9f9c2b772d508321612cb67...ac49a0990689439be471752f6c5ea8a91256ad32,3,3,2,5,3,2014-12-03 07:20:27,2014-12-03 07:20:27
bb9118f03a00b33f9859319d1237cdf13ae3ee4d...c27585098278c3629377de5fc5948e1d8fddb9ae,1,1,2,3,1,2014-12-22 22:58:44,2014-12-22 22:57:40
bb9118f03a00b33f9859319d1237cdf13ae3ee4d...3406a5c97a28810844e8553cc9d3bdef7712115f,1,2,2,4,2,2014-12-22 22:55:41,2014-12-22 22:52:04
08f388679b7e77104d3129733feffb956b10dcf0...c609272ac199cc9806ad6c4cf8c7f8f4253fb347,4,15,16,31,16,2014-12-07 14:29:03,2014-12-07 14:29:03
c609272ac199cc9806ad6c4cf8c7f8f4253fb347...8af8f7d5404536782f76e0ca02e01497f1e8b0ae,1,3,3,6,2,2014-12-07 20:56:29,2014-12-07 14:43:50
8af8f7d5404536782f76e0ca02e01497f1e8b0ae...353d8395aea20dad7d59bb54b8972a29ab2cb6e2,1,1,1,2,1,2014-12-07 20:56:37,2014-12-07 15:11:28
353d8395aea20dad7d59bb54b8972a29ab2cb6e2...202f1f8d69b119fd63d6788ee98e40321f53423b,1,1,2,3,2,2014-12-07 20:56:38,2014-12-07 15:17:49
2a1a3e6806f2edb73e9f30e63f950a787032dae1...a6950ce27661b74970c01f8280fb369136d2888e,1,16,16,32,16,2014-11-30 15:44:14,2014-11-30 15:44:14
a217ed776dc5dc21a92b5859ba303d2f79c6699d...ed98b3dfc012166d01c72fc80caa0113e37b4d45,23,23,23,46,23,2014-05-10 06:23:53,2014-05-10 06:22:43
54284a13c6b503d925bf6f75db2830f1af7fcf98...9900771aa7f1b3ddcee49aec84082104776ace70,1,1,0,1,1,2014-05-13 02:15:23,2014-05-13 02:15:23
54284a13c6b503d925bf6f75db2830f1af7fcf98...ae80cdca24b612655cb00f1e03598f8177d58c70,1,0,36,36,2,2014-05-12 19:58:47,2014-05-12 19:58:47
81a1825d6e7194926ec74114e388dbdac9dfd9dd...0d1018cb2fffd5780762cb4154ec01aba6956d16,5,5,4,9,5,2014-05-13 02:53:12,2014-05-13 02:53:12
0d1018cb2fffd5780762cb4154ec01aba6956d16...be00b82bb95c6defc02a66f2d599fec56fbcaa85,3,0,33,33,3,2014-05-13 02:55:58,2014-05-13 02:55:58
be00b82bb95c6defc02a66f2d599fec56fbcaa85...be18f50fd0e36e35342a100216b01fe00692d0db,2,0,662,662,2,2014-05-13 02:56:29,2014-05-13 02:56:29
5d1abf8b380aa94be26f52a662636cc6501fec2d...aa9182cab4bd84a6f8b7883850a825d4f4918bf9,2,3,2,5,3,2014-07-08 17:49:22,2014-07-08 17:46:10
5d1abf8b380aa94be26f52a662636cc6501fec2d...849bf58a549eb03bf420be7a893d4739893de995,3,16,2,18,9,2014-07-08 03:05:44,2014-07-08 03:04:22
5d1abf8b380aa94be26f52a662636cc6501fec2d...94eff8c159359c52eaebb6db6611ca337a557fd7,3,5,5,10,5,2014-07-08 02:53:57,2014-07-08 02:53:57
861cff8756fa4b39d749bbd3b86035e33bf217c1...2ccbc3868527bae457523b2ed285b46509971c36,2,55,69,124,11,2014-07-08 02:40:15,2014-07-08 02:40:15
2ccbc3868527bae457523b2ed285b46509971c36...32affe98356ccee4f3dfae17e3c4d47c7efb25ce,2,2,2,4,2,2014-07-08 03:29:43,2014-07-08 03:29:43
f023ddc64e80cad29e47eb9a5d8b2abf681fa544...c2f4e5fef1e9f11fa532cb98ccf088e8890e25fc,1,1,1,2,2,2014-07-25 18:02:30,2014-07-25 18:02:30
f023ddc64e80cad29e47eb9a5d8b2abf681fa544...519a087dbed55e3e350c5a7251ae3d76d195e47d,1,2,1,3,1,2014-07-25 17:16:44,2014-07-25 17:16:44
519a087dbed55e3e350c5a7251ae3d76d195e47d...531fc80885bd7ed9ead85017fb2c258a3069d7f7,1,1,2,3,1,2014-07-25 18:10:46,2014-07-25 18:10:46
5cfd6b515300a5c21762b6985d6bf54075410ef3...cb70382ed6866ce568be7488fd61c3d7eb8e9ac5,1,1,1,2,1,2014-06-18 01:59:33,2014-06-18 01:59:29
cb70382ed6866ce568be7488fd61c3d7eb8e9ac5...bb83d33812b4a1cb7cee654f90b26372211d27ad,1,1,1,2,1,2014-06-18 02:06:32,2014-06-18 02:06:32
bb83d33812b4a1cb7cee654f90b26372211d27ad...4f95989c386a3ffd826c063909ec70d54443c944,1,1,1,2,1,2014-06-18 02:09:28,2014-06-18 02:09:28
5cfd6b515300a5c21762b6985d6bf54075410ef3...f347d7d955bbb17234b8e12c68efae7d516ce62c,3,3,3,6,3,2014-06-18 01:53:52,2014-06-17 11:34:03
389210fca6960f9113d35bf3a0ebdf9ebee9979f...6352c85a654bd92651948e4ffcd7b088a2534d84,1,4,5,9,1,2014-06-24 19:37:44,2014-06-10 19:23:48
6352c85a654bd92651948e4ffcd7b088a2534d84...532dffdd46f1da2f557f6095d9f128ee64e4729e,1,10,10,20,1,2014-06-24 19:37:44,2014-06-10 19:24:56
c2784ddd751ea1f68b4c838889f64e449494eaf3...9a6b7ab3754ec8a6342280f53a9d7476d87f972c,1,1,1,2,1,2014-01-30 16:14:18,2014-01-30 16:14:18
9a6b7ab3754ec8a6342280f53a9d7476d87f972c...1409cde7e800ca83fd761f87e5ad8f0d259e38d1,29,50,50,100,46,2014-01-30 16:30:37,2014-01-30 16:30:37
26ca131a950398e0c3c447da01658939feb40df1...783f4885ab984acecfcb2a2986158aaa8933ea2d,2,2,0,2,2,2012-09-18 01:17:22,2012-09-18 01:17:22
783f4885ab984acecfcb2a2986158aaa8933ea2d...cedb3c7c56887d4ca42296ee193f2ff08dfe9ac4,4,24,4,28,6,2012-09-18 06:03:32,2012-09-18 06:03:18
cedb3c7c56887d4ca42296ee193f2ff08dfe9ac4...239e6a7d210a69413d0f4b4b000f2f38f53e1c44,2,20,3,23,5,2012-09-18 06:11:49,2012-09-18 06:11:49
239e6a7d210a69413d0f4b4b000f2f38f53e1c44...3b3def4898b7d60e9a8b9b95707ee56323b23f36,2,28,0,28,8,2012-09-18 06:19:52,2012-09-18 06:19:52
ebc69356637143c938c07904d10928c11e742196...857b8fb8be81178d14f59c126c1381b09aff7c0f,1,1,1,2,1,2012-06-07 17:31:26,2012-06-07 17:31:26
287086758be44fd35db83ffd763966b866381ce9...8a06339501587f9ecc62f6a831162cf40e8a0c70,3,8,10,18,5,2012-05-28 01:12:08,2012-05-28 01:12:08
5e5965ca6fe719e83f5eb06222170b87dba78f02...5b401a8c16bf54aad4df38790d20f05bfea03822,5,41,4,45,8,2012-06-03 00:28:38,2012-06-03 00:28:38
5b401a8c16bf54aad4df38790d20f05bfea03822...fc96bc8bba0687fb5845bffc72eb048535583499,3,5,5,10,5,2012-06-03 00:30:00,2012-06-03 00:30:00
fc96bc8bba0687fb5845bffc72eb048535583499...f836473129819c2e348f821ed268451b9b8bf2e4,8,37,37,74,17,2012-06-03 00:55:10,2012-06-03 00:55:10
f836473129819c2e348f821ed268451b9b8bf2e4...037107480de9dd11095553ee409cbc748b5c7a68,1,0,24,24,1,2012-06-03 00:57:36,2012-06-03 00:57:36
037107480de9dd11095553ee409cbc748b5c7a68...806a82ef8326e9a7b9b21fce91b827f478298519,6,26,6,32,7,2012-06-03 01:06:00,2012-06-03 01:06:00
806a82ef8326e9a7b9b21fce91b827f478298519...b07b869b267bd07e80ac193632284a0370d5c72c,4,4,4,8,4,2012-06-03 01:15:23,2012-06-03 01:15:23
b07b869b267bd07e80ac193632284a0370d5c72c...4ca1cba3f8279b9293fc1e5909508e8b6f69636f,2,8,18504,18512,2,2012-06-03 01:25:07,2012-06-03 01:25:07
4ca1cba3f8279b9293fc1e5909508e8b6f69636f...b8a8927b0cd85ab3873bb0e2841a9f77591d5b5f,1,1,1,2,1,2012-06-03 01:36:45,2012-06-03 01:36:45
b8a8927b0cd85ab3873bb0e2841a9f77591d5b5f...354f99f0bd8e1c2dcf9e094245b71e2587bd78c1,4,4,4,8,4,2012-06-03 02:02:30,2012-06-03 02:02:30
354f99f0bd8e1c2dcf9e094245b71e2587bd78c1...0b827965d36f87feddcee1ecb3f6e2f9c6dec9dc,4,102,82,184,10,2012-06-03 02:31:30,2012-06-03 02:31:30
0b827965d36f87feddcee1ecb3f6e2f9c6dec9dc...555a3b0478b001022d503304d7e5a7118bf8e3a5,5,19,3,22,8,2012-06-03 03:28:08,2012-06-03 03:28:08
555a3b0478b001022d503304d7e5a7118bf8e3a5...3a751a63d45814cab973cd6d9ca9fddf78a1a842,4,7,4,11,7,2012-06-03 04:01:45,2012-06-03 04:01:45
3a751a63d45814cab973cd6d9ca9fddf78a1a842...ebc1fe907d5dede1c7251dc1a25b9015a7f779d7,4,4,4,8,4,2012-06-03 04:09:13,2012-06-03 04:09:13
ebc1fe907d5dede1c7251dc1a25b9015a7f779d7...a38bc90b482c086e805aa2e942b56cd1429d5766,2,2,2,4,2,2012-06-03 04:19:56,2012-06-03 04:19:56
a38bc90b482c086e805aa2e942b56cd1429d5766...91a7274a43836484cdf27e34c45856e4b715f778,1,1,1,2,1,2012-06-03 04:26:34,2012-06-03 04:26:34
ef368f0076523a8d0cd6b411549d7e9af9d1cf98...526d77af6188427e1ed6cc3ec280e08e986379ac,2,52,100,152,24,2012-05-13 18:10:08,2012-05-13 18:10:08
526d77af6188427e1ed6cc3ec280e08e986379ac...3a21891824f3f0af06da750bb768902e171b2ca0,5,22,5,27,6,2012-05-13 20:58:42,2012-05-13 20:58:42
3a21891824f3f0af06da750bb768902e171b2ca0...6a896597277cd382e5bfe62b6f4312cdaa4a9d8e,2,2,2,4,2,2012-05-13 20:59:20,2012-05-13 20:59:20
ef368f0076523a8d0cd6b411549d7e9af9d1cf98...20eae67147da15a75250a09f0932c0f3f2198b2b,1,1,1,2,1,2012-05-10 09:25:22,2012-05-10 09:25:22
ef368f0076523a8d0cd6b411549d7e9af9d1cf98...452d8c1df0fe75acfc9431a0b0f349f85a6c1fd1,2,23,23,46,21,2012-05-04 20:50:16,2012-05-04 20:50:16
4a276b1620f84da7343635731f6b3dbfa301d381...2d3a0babd242d7eebe09cf3f4daad38e2d7df6ee,7,31,18,49,15,2012-06-03 05:10:35,2012-06-03 05:10:35
ecf84bdac51a9c56d18c4a25b3d5b0c66a09151a...a9d4b667ff6349a54cdd470c82c7ef3c88de4165,2,8,4,12,4,2012-05-15 16:07:19,2012-05-15 16:07:19
ecf84bdac51a9c56d18c4a25b3d5b0c66a09151a...532569fe59bbc8a1a74d7984279749f736cbdd3a,1,18,24,42,5,2012-05-15 16:04:44,2012-05-15 16:04:44
2881269e16be1beb007633501496d6a8e8924b4b...8e8b1ad03df4f1e723cb58696ebace642fce3946,1,6,1,7,3,2012-04-17 00:05:35,2012-04-17 00:05:35
8e8b1ad03df4f1e723cb58696ebace642fce3946...d5a95315eb2aac641d3a28de9f92f75e56813149,1,6,0,6,1,2012-04-17 00:24:51,2012-04-17 00:24:51
d5a95315eb2aac641d3a28de9f92f75e56813149...031fa47f68f5655bf68f0c9ebf551f92028bf5d8,1,2,2,4,1,2012-04-17 00:27:34,2012-04-17 00:27:34
b67a2d8a59198528aec81a0c50d36aa371e10a9f...6cf9906a60faa17c0463932c761b8280e9dce63c,3,1824,0,1824,3,2012-04-16 00:03:33,2012-04-16 00:03:33
b67a2d8a59198528aec81a0c50d36aa371e10a9f...5c5310dc877d4a42299f65c2b68f51154da8d523,1,0,1,1,1,2012-04-15 23:57:11,2012-04-15 23:57:11
5c5310dc877d4a42299f65c2b68f51154da8d523...a184806538b102614626b0dd1683065db4ce07d3,1,0,1,1,1,2012-04-16 00:25:32,2012-04-16 00:25:32
4793a6f8fa778a333afc15d142f5fe84acb00909...26ed8202ee270ce8b103491613fb2f5053472a70,3,4,3,7,3,2012-01-25 02:24:38,2012-01-25 02:24:38
26ed8202ee270ce8b103491613fb2f5053472a70...9ef4171d03e048ee9458fb7a1db83ea61bf845c2,3,3,3,6,3,2012-01-25 02:26:45,2012-01-25 02:26:45
9ef4171d03e048ee9458fb7a1db83ea61bf845c2...d3622235359c08f65d5396ee01523c7f7d8901b1,1,13,0,13,2,2012-01-25 02:29:17,2012-01-25 02:29:17
d3622235359c08f65d5396ee01523c7f7d8901b1...880486089888fbba04ed12083ad038ae38494fd1,2,2,2,4,2,2012-01-25 02:45:23,2012-01-25 02:45:23
880486089888fbba04ed12083ad038ae38494fd1...f70895a6059aab44c53048b0294204d2f53dfd65,2,4,8,12,8,2012-01-25 03:01:38,2012-01-25 03:01:38
f70895a6059aab44c53048b0294204d2f53dfd65...672ba4c2fd9a42d4f178e795ebc162cce81bbc2f,13,371,345,716,48,2012-01-25 03:19:50,2012-01-25 03:19:50
672ba4c2fd9a42d4f178e795ebc162cce81bbc2f...4a6d9106b8f92a85a528971c70f132c32b6c43cf,4,9,5,14,6,2012-01-25 03:36:42,2012-01-25 03:36:42
af01d37ab9aeb8e752db07f791b84299005795ae...b6b19866ac82089b9d3964f7fe9bbb3457306495,5,117,230,347,198,2012-01-26 04:32:19,2012-01-26 04:32:19
b6b19866ac82089b9d3964f7fe9bbb3457306495...94ea3b62f09c840db5efe5e48815d011ca7e43d1,5,126,103,229,21,2012-01-26 05:28:24,2012-01-26 05:28:24
94ea3b62f09c840db5efe5e48815d011ca7e43d1...106625a2ece84fd5e1e68144411c8d00db05c23f,2,8,8,16,8,2012-01-26 08:36:40,2012-01-26 08:36:40
106625a2ece84fd5e1e68144411c8d00db05c23f...0ef4b6419fd83170dd62049a2850c5e8466635c9,22,394,236,630,269,2012-01-26 18:00:09,2012-01-26 18:00:09
f4f7296fa8b371ed06addd4e7d1f0662c01b2b76...bd36e2a1633ea66fee2bcfdd1123bd70f41b43f2,2,24,58,82,26,2012-01-25 09:25:15,2012-01-25 09:25:15
bd36e2a1633ea66fee2bcfdd1123bd70f41b43f2...de4ada3b88d7514d0320540e5a298fbe878778e1,2,606,106,712,16,2012-01-25 09:45:15,2012-01-25 09:45:15
a7222a531a48ae3bbb5c26ccb6cc542a6d241898...a2c0bb49b187feab92ae96744b3bac88c9522aa9,1,1,1,2,1,2014-10-31 10:09:01,2014-10-31 10:09:01
03f35d2daba72f3fb9f74ffae0a0837a2ce59bdd...347ad61010dd2e9f72af656e84e5e7fe9bf31d78,1,1,1,2,1,2014-11-17 16:05:26,2014-11-17 16:05:26
a577f1922ee7054a97b455ccfaa16857cb2b79fc...61c6e186a97481d39997a23f463f610cc851f0ad,1,1,1,2,1,2014-11-14 22:13:25,2014-11-14 22:13:25
a577f1922ee7054a97b455ccfaa16857cb2b79fc...729a115c8816edfacae48c26f0a751937fd387ae,1,26,14,40,3,2014-11-14 20:03:54,2014-11-14 20:03:54
ac49a0990689439be471752f6c5ea8a91256ad32...f837a3f7754ccdc3045725c133cbec526ba60360,1,0,1,1,1,2014-12-05 00:00:31,2014-12-05 00:00:31
ac49a0990689439be471752f6c5ea8a91256ad32...dbe47654160d389c6991a312c9cecd2eeb9b6122,9,15,14,29,13,2014-12-03 16:44:35,2014-12-03 16:44:35
f2a0a78b179d3730c9e49e661ff0d6d87e67f58f...e5051e76feaeafb0b999b0b2662f0c2669c48d10,1,1,1,2,1,2014-12-22 23:03:48,2014-12-22 23:02:34
e5051e76feaeafb0b999b0b2662f0c2669c48d10...b61e4dd671830b803053c0da39f6fb975ff16a20,1,1,1,2,1,2014-12-22 23:10:45,2014-12-22 23:10:45
255e5d68751cb93f95d1cbddbf2a12d5f56d4b70...e11c634be998ccefef9587a059af680b17f9d9e2,1,1,1,2,1,2014-12-08 06:26:19,2014-12-08 06:26:19
0e5ec1ab7a8ffe97272e5e3c6dc7212e60cb479f...9445b84b0bdc5a97609ddeaf9b292d3a14083d55,1,1,1,2,2,2014-06-26 08:18:45,2014-06-26 08:18:45
be18f50fd0e36e35342a100216b01fe00692d0db...d8baec85f503f4078fe2ce9fda9f17bca14f8039,1,1,1,2,1,2014-05-13 03:14:39,2014-05-13 03:14:39
c23c663c7c9554a6169bdc284d33fd559f30cbe5...e2b4f3429c8bbbf8c2967cf0595087e37ea17ce9,1,16,16,32,7,2014-07-08 19:11:02,2014-07-08 19:09:38
c23c663c7c9554a6169bdc284d33fd559f30cbe5...5c1f4e1a0c7cd2f6adeedf2c2bd91ad87f32706d,6,67,67,134,27,2014-07-08 19:00:43,2014-07-08 18:58:33
25a90958406b04e07f5ba42c88112a170b043e20...ddee04038f946ac103eb4e70c8eb7adeb2cf563b,1,5,5,10,2,2014-07-08 03:44:43,2014-07-08 03:44:43
ddee04038f946ac103eb4e70c8eb7adeb2cf563b...933b38421cc3ec1809c20a565dc1927f205c4d60,1,1,1,2,1,2014-07-08 10:51:32,2014-07-08 10:51:32
933b38421cc3ec1809c20a565dc1927f205c4d60...7f359666c47946d9ea84d9387a7c88cbcbc9aa4f,1,2,2,4,1,2014-07-08 11:33:21,2014-07-08 11:33:21
c2f4e5fef1e9f11fa532cb98ccf088e8890e25fc...333af7d371ee56db24030786c3036f3198fd3016,1,6,0,6,1,2014-08-04 16:07:19,2014-07-26 21:55:18
c2f4e5fef1e9f11fa532cb98ccf088e8890e25fc...d6d9bb5bc857b2fd2cb21f89861d9f84904c1997,1,1,1,2,1,2014-07-27 16:35:16,2014-07-27 16:35:16
1c42dfcd532867acd1488de0d91edd71a6a19aea...6d45f733e57d0e520668a8a38b55d085bd5ef05a,9,11,11,22,10,2014-06-18 10:16:32,2014-06-18 10:16:32
a4fa8d07c8679628d50d66b239874078735897f1...14829474052cc30ca89c72e035f5b88978af6eb5,1,2,2,4,1,2014-06-19 22:25:50,2014-06-19 22:25:50
14829474052cc30ca89c72e035f5b88978af6eb5...856bc8694c7eed0bd5499daf733754da7c6ce977,2,4,4,8,3,2014-06-19 23:04:40,2014-06-19 23:04:18
856bc8694c7eed0bd5499daf733754da7c6ce977...8bd4163ad463a0f208a55a8f64ba7fc6cb826282,8,23,5,28,8,2014-06-20 01:14:56,2014-06-20 01:14:56
8bd4163ad463a0f208a55a8f64ba7fc6cb826282...166b66d08a1e3a01c96dd73856e3413677403ddd,1,0,5,5,2,2014-06-20 01:15:42,2014-06-20 01:15:42
166b66d08a1e3a01c96dd73856e3413677403ddd...1e53dcd137e7d8c8abe26af610ebb14c26de1043,6,11,14,25,8,2014-06-20 01:33:41,2014-06-20 01:33:41
1e53dcd137e7d8c8abe26af610ebb14c26de1043...34248437c3bc7278f912c9005d3fd4877b723d83,1,1,1,2,1,2014-06-20 02:54:25,2014-06-20 02:54:25
1aaad6481cb064f31f85d519cd56e3c1799585cf...49fe75d13830bd195a9a34c61926285388fea7b8,1,25,29,54,4,2014-06-24 21:49:44,2014-06-24 21:49:44
49fe75d13830bd195a9a34c61926285388fea7b8...e31c2edf885efd42d2e755f189cc15125d977d70,1,1,2,3,1,2014-06-24 21:54:51,2014-06-24 21:54:51
e31c2edf885efd42d2e755f189cc15125d977d70...a991cd572c8b3cafa6228915ca86f7a0cdd26e2d,7,7,7,14,7,2014-06-24 22:06:47,2014-06-24 21:55:51
a991cd572c8b3cafa6228915ca86f7a0cdd26e2d...b93b7b1b6d914f7b7ecd36734e371cffe6de4be4,1,2,1,3,1,2014-06-24 22:53:10,2014-06-24 22:53:10
b93b7b1b6d914f7b7ecd36734e371cffe6de4be4...4abb0957833c7158563244d1770ab9a5e6966150,7,32,14,46,9,2014-06-24 23:07:17,2014-06-24 22:53:18
1409cde7e800ca83fd761f87e5ad8f0d259e38d1...59a38b7bf6104f62fa5955a11739bd42e265d2e4,1,0,1,1,1,2014-02-01 13:37:19,2014-02-01 13:37:19
1409cde7e800ca83fd761f87e5ad8f0d259e38d1...1e09a9d1d7cbfe807d791bb806d1b56d2bd5830a,1,1,2,3,1,2014-02-01 13:20:41,2014-02-01 13:20:41
1409cde7e800ca83fd761f87e5ad8f0d259e38d1...8939268a33957c3a8599881f6312ccbe00b5c5dd,15,18,20,38,15,2014-01-30 18:50:17,2014-01-30 17:55:11
1409cde7e800ca83fd761f87e5ad8f0d259e38d1...9f26194489630e16b3b415ee08bcdf5615ab015a,1,1,1,2,1,2014-01-30 18:42:44,2014-01-30 18:42:44
9f26194489630e16b3b415ee08bcdf5615ab015a...7c6e4a231c97a3e55ffbfacd5c131554219f23c6,1,1,1,2,1,2014-01-30 18:49:43,2014-01-30 18:49:43
3b3def4898b7d60e9a8b9b95707ee56323b23f36...78992bbf42b93464737860948223e9f852a9f8e8,2,4,4,8,3,2012-09-18 18:23:16,2012-09-18 18:23:16
3b3def4898b7d60e9a8b9b95707ee56323b23f36...2a20761f072be4f1c7521c9a6ea38b06db3aeef1,1,34,0,34,1,2012-09-18 17:50:04,2012-09-18 17:50:04
857b8fb8be81178d14f59c126c1381b09aff7c0f...5df1e2c00a295c45db7fa75dba333dc9464b128c,1,2,2,4,2,2012-08-09 21:00:24,2012-08-09 21:00:24
857b8fb8be81178d14f59c126c1381b09aff7c0f...178397ae5ee8bc59561720fb7be582e294cf0437,1,1,0,1,1,2012-07-30 18:10:01,2012-07-30 18:10:01
857b8fb8be81178d14f59c126c1381b09aff7c0f...4d6434a2c76e7dc5a0b271aa8c222f8bfced0ff0,1,2,2,4,2,2012-07-04 06:34:11,2012-07-04 06:34:11
857b8fb8be81178d14f59c126c1381b09aff7c0f...3761d50c5a4bfd2b518cd6ab68ef3474e191ee6d,1,3,0,3,1,2012-06-26 00:35:42,2012-06-26 00:35:42
857b8fb8be81178d14f59c126c1381b09aff7c0f...e80f37b600d693c043d79d8f77ae4e91612bb163,1,1,1,2,1,2012-06-24 06:26:39,2012-06-24 06:26:39
857b8fb8be81178d14f59c126c1381b09aff7c0f...5bd9217f9bbf1b3840025402e0424306ea0c9f99,1,40,0,40,1,2012-06-20 22:50:28,2012-06-20 22:50:28
5bd9217f9bbf1b3840025402e0424306ea0c9f99...83e46b8df9333c1102f09efa402f5350dc2df80d,1,14,14,28,5,2012-06-21 02:36:06,2012-06-21 02:36:06
241cbd478dcacdbd0ddedaecb147bfc9b8f7e753...9699e1d70783122f99b7de67e58a95ddaef1e241,2,2,2,4,2,2012-05-28 08:13:24,2012-05-28 08:13:24
91a7274a43836484cdf27e34c45856e4b715f778...9a3a297a478e1a27cce913b8d30170a6949b52f7,25,5,5,10,5,2012-06-03 05:12:45,2012-06-03 05:12:45
6f61c96f02d82f8e908759f2d293b249e81665a0...d09db29039ba498c8d3255cadafb2c5c88ff1a2f,4,18,18,36,18,2012-05-13 21:01:57,2012-05-13 21:01:57
d09db29039ba498c8d3255cadafb2c5c88ff1a2f...7de65e0a628a3faa1b3837aabea43ae234c5b7a4,2,4,4,8,4,2012-05-13 21:03:32,2012-05-13 21:03:32
2d3a0babd242d7eebe09cf3f4daad38e2d7df6ee...31e8a358c3014d48900f4f266c75a7b62ad66dd3,4,4,4,8,4,2012-06-03 18:24:19,2012-06-03 18:24:19
6be09df1bfc71d46d60e7acadb7844c282b80637...3a27b4e6f6722ebde97644126b16da0fbb0ea474,1,35,24,59,3,2012-05-15 16:07:55,2012-05-15 16:07:55
3a27b4e6f6722ebde97644126b16da0fbb0ea474...0679f24606dff0a3d38f88bad220d393bb363dba,2,2,2,4,2,2012-05-15 16:37:28,2012-05-15 16:37:28
0679f24606dff0a3d38f88bad220d393bb363dba...67f81a2ed53d5608a26eae5eb301614ad53cf3b5,2,2,2,4,2,2012-05-15 16:41:06,2012-05-15 16:41:06
67f81a2ed53d5608a26eae5eb301614ad53cf3b5...e009ed23fcdfa87cc773c2c08f546b30e0e35950,1,9,9,18,4,2012-05-15 16:45:53,2012-05-15 16:45:53
e009ed23fcdfa87cc773c2c08f546b30e0e35950...5ecab6112cb3a53b3222f90c44b0938929e71ac9,2,2,2,4,2,2012-05-15 17:59:06,2012-05-15 17:59:06
ba202d77baa35125a521224d9a55ec013fc3ccfa...f3cf4cbaae8c3b3aaed299b63d1773d85cd7789a,4,13,9,22,8,2012-04-17 00:36:03,2012-04-17 00:36:03
41b695b8cd171578c78f740d902abcfae62bf7e3...5fa0fcc888bdeb5210b03445045ba61bdf7b0034,2,2,2,4,2,2012-04-16 21:38:22,2012-04-16 21:38:22
4a6d9106b8f92a85a528971c70f132c32b6c43cf...74b5dc8d3bd5ef34bb2cdc590b8a5dcbc43a8f4c,1,1,1,2,1,2012-01-25 04:06:50,2012-01-25 04:06:50
4a6d9106b8f92a85a528971c70f132c32b6c43cf...bacb05608f2d42ef7fdb6fa25241d4268b989387,3,49,34,83,19,2012-01-25 03:43:52,2012-01-25 03:43:52
0ef4b6419fd83170dd62049a2850c5e8466635c9...ef4d0dd7dbd959f830d4cb7976d6a4b061784ec6,1,2,1,3,1,2012-01-26 18:12:25,2012-01-26 18:12:25
0ef4b6419fd83170dd62049a2850c5e8466635c9...29f0e4c28b56e684a9be9931dcf77b418cb63ae0,4,34,41,75,22,2012-01-26 18:07:52,2012-01-26 18:01:03
29f0e4c28b56e684a9be9931dcf77b418cb63ae0...2c2f8ebe3a090bff0254aba10b745dae10bf242d,3,81,68,149,48,2012-01-26 18:09:13,2012-01-26 18:04:30
de4ada3b88d7514d0320540e5a298fbe878778e1...d8041f7c8f5f6fcb7777383429464f39879ba916,3,4,2,6,4,2012-01-25 16:34:20,2012-01-25 16:34:20
d8041f7c8f5f6fcb7777383429464f39879ba916...b01de5fc56ab031df8a08be9ce720c68ced7a5c1,6,218,214,432,32,2012-01-25 17:51:03,2012-01-25 17:51:03
b01de5fc56ab031df8a08be9ce720c68ced7a5c1...29b4ba0fc5a07ecbde11054dfa4406384a360d32,5,9,9,18,9,2012-01-25 17:53:53,2012-01-25 17:53:53
29b4ba0fc5a07ecbde11054dfa4406384a360d32...c381199968dc19a458f5e43e8b1aeebae284b7cc,2,4,4,8,4,2012-01-25 17:57:40,2012-01-25 17:57:40
c381199968dc19a458f5e43e8b1aeebae284b7cc...9553b1e3e9457a48b6da3724c906a36f935aa526,17,275,253,528,20,2012-01-25 18:02:52,2012-01-25 18:02:52
de4ada3b88d7514d0320540e5a298fbe878778e1...eb3440b56a8d6ebeb15eebcfa3d6987309acc8d2,1,2,2,4,2,2012-01-25 14:20:01,2012-01-25 14:20:01
eb3440b56a8d6ebeb15eebcfa3d6987309acc8d2...2193866bf0a62a9f900d7231bd4e7fd13b69d6f3,1,5,5,10,4,2012-01-25 15:26:51,2012-01-25 15:26:51
c04f95032d544c6d8050696c17aedfad6c0d7411...6503cb08228450eb14bbf4402f5bf7022f90216e,1,7,7,14,4,2014-11-17 17:54:55,2014-11-17 17:54:55
6503cb08228450eb14bbf4402f5bf7022f90216e...c2abfc0a4427237e288eee06a364662345fbbf9d,8,17,23,40,16,2014-11-17 17:57:02,2014-11-17 17:57:02
61c6e186a97481d39997a23f463f610cc851f0ad...25ef6ad625d02ef8832edabeee1319ffde4537cf,1,5,5,10,2,2014-11-15 00:25:13,2014-11-15 00:25:13
25ef6ad625d02ef8832edabeee1319ffde4537cf...cb8581580c86ba7e2805dc63ac7edd4548c9801c,2,32,31,63,4,2014-11-15 00:26:22,2014-11-15 00:26:22
0c1527010893065635b8af7df221db9edb3e8971...eb93b5db5f0144ed9e7ae872a1eaf9d7a66639c8,1,3,3,6,3,2014-11-16 05:20:45,2014-11-16 05:20:41
1bf1ba7103cf4de0364dfd8ec78a31eb813d7b8f...db8eeaa17a023d547646c33449b7b86d7efa36f3,9,10,7,17,10,2015-01-18 21:39:40,2015-01-18 21:39:40
1bf1ba7103cf4de0364dfd8ec78a31eb813d7b8f...161eac4fd71693a8a98a132645cfe325c04aa02c,1,2,2,4,2,2015-01-18 20:51:47,2015-01-18 20:51:47
b61e4dd671830b803053c0da39f6fb975ff16a20...c4a23cc04063443a8f02c5451c3d30a81728caba,3,3,3,6,3,2014-12-23 03:18:26,2014-12-23 03:18:26
c4a23cc04063443a8f02c5451c3d30a81728caba...c41970c5797cd1c3b61a5396031a3258c9c07705,4,22,16,38,5,2014-12-23 03:28:29,2014-12-23 03:28:29
b61e4dd671830b803053c0da39f6fb975ff16a20...15c9c3aef7f047c9cce45fd33ada799e99fbd390,4,5,3,8,5,2014-12-23 01:24:26,2014-12-23 00:54:50
15c9c3aef7f047c9cce45fd33ada799e99fbd390...d84f726da4f55434de853202961310d153f35739,1,2,2,4,2,2014-12-23 01:24:26,2014-12-23 01:02:29
d84f726da4f55434de853202961310d153f35739...75ec7393ec2940cb1f015dc2d002328833ad3ef8,1,1,1,2,1,2014-12-23 01:24:37,2014-12-23 01:03:45
5e8dd7d438fbcd3479b1a18d8f8d76f071c43843...3668bde098e1bce289ba313119fe3cf05d01825b,2,2,2,4,2,2014-12-23 03:20:44,2014-12-23 03:20:44
e11c634be998ccefef9587a059af680b17f9d9e2...e9dca8df523b5d625887e2a530ef3be6999e02c0,1,1,1,2,1,2014-12-08 08:41:44,2014-12-08 08:41:44
1de2f68bdcecd9a1e19548fe9152ead1b5e1bad4...ff6b279b3cd37e7e4e6bd93535afd016f6957afc,30,75,75,150,71,2014-06-26 16:13:24,2014-06-26 16:13:24
ff6b279b3cd37e7e4e6bd93535afd016f6957afc...c068162161154a4b85110ea1e7dd3d7897ce2b72,1,3,3,6,1,2014-06-26 16:36:48,2014-06-26 16:36:48
c068162161154a4b85110ea1e7dd3d7897ce2b72...43b7a942bc4eb2307353dcf32e7c245664546afc,1,2,2,4,1,2014-06-26 17:51:07,2014-06-26 17:51:07
43b7a942bc4eb2307353dcf32e7c245664546afc...43ecc8726b608472c67f70ac56eb77407414b0c2,1,1,0,1,1,2014-06-26 17:52:12,2014-06-26 17:52:12
1de2f68bdcecd9a1e19548fe9152ead1b5e1bad4...76ca3677f515d1a658a3360270e31e32dafc095e,1,2,1,3,1,2014-06-26 13:50:20,2014-06-26 13:50:20
76ca3677f515d1a658a3360270e31e32dafc095e...165c7889bdad142d0a9553fe7eae3abd96ec5a76,1,1,1,2,1,2014-06-26 14:31:37,2014-06-26 14:31:37
4683beeedf0e4d923f1556199f4d23d7d35bccea...878f720ea1d4d0f0e96b93ecb118dc91f68f480a,1,2,2,4,2,2014-07-08 19:47:44,2014-07-08 19:43:57
4683beeedf0e4d923f1556199f4d23d7d35bccea...81f67e925ace0437103b33d24ed275db85d9c3f1,1,6,6,12,6,2014-07-08 19:40:42,2014-07-08 19:39:15
d6d9bb5bc857b2fd2cb21f89861d9f84904c1997...9742bb2ee46f7a41fd162ec6fedb995e0c70c2f1,21,44,74,118,40,2014-07-28 00:01:34,2014-07-28 00:01:34
d6d9bb5bc857b2fd2cb21f89861d9f84904c1997...90424296eb339a579fc47eec18029af299e38b28,2,3,1,4,3,2014-07-27 23:51:07,2014-07-27 23:51:07
d6d9bb5bc857b2fd2cb21f89861d9f84904c1997...ff12a76e5aee26fda3452f88987c7d0d0c2c646a,2,9,3,12,3,2014-07-27 23:18:59,2014-07-27 23:18:59
86d698f4e4482f3f2a4cc614a3217dbf5380fa74...852d0d1144d9985ce8ebbd44675c4afcd19df7f8,2,141,135,276,10,2014-07-29 00:29:41,2014-07-28 13:01:06
6d45f733e57d0e520668a8a38b55d085bd5ef05a...d75506fbec6a50d13802a46b6a1e1fe6bd8655e6,1,1,1,2,1,2014-06-18 22:12:17,2014-06-18 22:12:15
6d45f733e57d0e520668a8a38b55d085bd5ef05a...8c403dc1dcccc38057aba85c49a314a36a93c0af,2,2,2,4,2,2014-06-18 21:47:14,2014-06-18 21:40:50
6d45f733e57d0e520668a8a38b55d085bd5ef05a...de55fb85a0295553e65231e6116985863acb7ad9,1,1,0,1,1,2014-06-18 17:07:55,2014-06-18 17:07:55
34248437c3bc7278f912c9005d3fd4877b723d83...09cf618acff6e6992aa14bc11c89206f104c6748,1,2,2,4,2,2014-06-23 17:00:18,2014-06-20 09:31:49
34248437c3bc7278f912c9005d3fd4877b723d83...e98fc373e3ef6e4a884a0142d50c765a9db5bd01,6,34,23,57,8,2014-06-20 20:24:14,2014-06-20 20:24:14
4abb0957833c7158563244d1770ab9a5e6966150...41f27fd81367f1f4bda48f02de6f3ed9999ad421,1,6,5,11,1,2014-06-25 14:00:41,2014-06-25 14:00:41
41f27fd81367f1f4bda48f02de6f3ed9999ad421...fdacff229752e413f2705c8378e5023301db92de,1,1,1,2,1,2014-06-25 15:09:57,2014-06-25 15:09:57
4abb0957833c7158563244d1770ab9a5e6966150...71974e2f4d2d42ebb13e357245e60b4b961a3bfa,1,1,0,1,1,2014-06-25 04:01:34,2014-06-25 04:01:34
71974e2f4d2d42ebb13e357245e60b4b961a3bfa...ac67bc857fb3e4a4da1240222d51dd8a76a1bacf,1,1,8,9,2,2014-06-25 05:16:25,2014-06-25 05:16:25
4abb0957833c7158563244d1770ab9a5e6966150...634ea59a259c8d3e4dc164528f984758eebd8883,1,2,2,4,2,2014-06-25 02:18:51,2014-06-13 12:06:55
634ea59a259c8d3e4dc164528f984758eebd8883...282f8fc04b3f138b2676a8e345883bd00f8f7599,1,105,4,109,6,2014-06-25 02:18:51,2014-06-13 12:07:34
9c054fd4c0db89cbbb1df3c868bafc4f2c17c3e3...69cb7be07f5673154da8cbbc838b03c32d3abe4b,1,0,1,1,1,2014-02-16 18:30:02,2014-02-16 18:28:43
9c054fd4c0db89cbbb1df3c868bafc4f2c17c3e3...880a38e1a4f2fb053d586fc196d6149e87ec80a4,1,1,0,1,1,2014-02-03 05:44:09,2014-02-02 04:57:00
9c054fd4c0db89cbbb1df3c868bafc4f2c17c3e3...f2344962396727fd9ec4b8d2023d60e711506f0a,1,1,0,1,1,2014-02-02 07:19:28,2014-02-02 07:19:16
9c054fd4c0db89cbbb1df3c868bafc4f2c17c3e3...f2d45fd2f8076da1fe414e1b71df546651aaf2a0,1,1,1,2,1,2014-02-02 05:25:19,2014-02-02 05:25:19
9c054fd4c0db89cbbb1df3c868bafc4f2c17c3e3...09f62f6a7a0ee4208bcc04d58f619e000a916ef8,1,1,0,1,1,2014-02-01 21:46:55,2014-02-01 21:46:55
c1a5e1443f58244975b68f7ac1d1d61a82689160...fd9b29b43e089719ca6d6b690f83874a05a83ab8,1,2,0,2,1,2014-02-03 01:33:40,2014-02-03 01:33:40
c1a5e1443f58244975b68f7ac1d1d61a82689160...a9567a9e0c0e2ed8bef5d91c8afcb8c8b8b940e3,1,1,1,2,1,2014-01-30 20:16:48,2014-01-30 20:16:48
a9567a9e0c0e2ed8bef5d91c8afcb8c8b8b940e3...c86c8de4f2c2e28fa02ae1f91b769945579610a4,1,0,9,9,1,2014-01-30 20:25:02,2014-01-30 20:24:45
c15877445c9f0d3f333d19f73cbfef3c09522454...13be8b2031e569f872047b14ae3bedd5729ebd89,1,5,4,9,4,2012-09-18 18:50:11,2012-09-18 18:50:11
13be8b2031e569f872047b14ae3bedd5729ebd89...cc3de8bd6eefe0c3edf3d3ef843276e0f4daae1e,3,141,4,145,3,2012-09-18 19:00:57,2012-09-18 19:00:57
5d63e8e2a84468351b4c1ee6cc21f48e95ea27bf...2b5e09038add287775dd6b27f5df9bf6373119ee,2,2,2,4,2,2012-08-20 23:21:57,2012-08-20 23:21:57
2b5e09038add287775dd6b27f5df9bf6373119ee...9e0d87a4dd7488e0c3987ef2869924d6c5aa9f46,1,5,1,6,3,2012-08-20 23:43:49,2012-08-20 23:43:49
9e0d87a4dd7488e0c3987ef2869924d6c5aa9f46...320b75de63f347027774ba7353eea7f6937ab14b,2,1,1,2,1,2012-08-21 06:13:43,2012-08-21 06:13:43
3d770ab7bd3ba189db8f1bcc8d84ff9bfbcfc81c...19ea4668e5d62303b26e322d32b45d6268837c18,3,20,0,20,20,2012-07-06 17:35:08,2012-07-06 17:35:08
19ea4668e5d62303b26e322d32b45d6268837c18...dc6eaafb00426315a3720324d7fc3a4a33a04ddf,2,2,0,2,2,2012-07-06 17:59:46,2012-07-06 17:59:46
fb29075926b08ed57d1fc6f3ff3c013c5f87d2b3...b4125748b0d0e12a7855350ee3d9089e0a2f93e7,6,201,1,202,25,2012-07-04 11:22:34,2012-07-04 11:22:34
fb29075926b08ed57d1fc6f3ff3c013c5f87d2b3...26dad5f56defc9efab0be87afc5c9c18d6d844a5,1,1,1,2,1,2012-07-02 21:21:26,2012-07-02 21:21:26
fb29075926b08ed57d1fc6f3ff3c013c5f87d2b3...70e81e6f55ad77f3777e87c4edd646a2f5ac8bee,7,120,18,138,31,2012-07-01 15:42:09,2012-07-01 15:42:09
70e81e6f55ad77f3777e87c4edd646a2f5ac8bee...3ad52ca632e07948153ffb072132527d74e67c1d,1,19,1,20,2,2012-07-02 05:49:01,2012-07-02 05:49:01
3ad52ca632e07948153ffb072132527d74e67c1d...62c386259b7fbd1ef665fc6baf4458c8e05ad1f8,11,249,182,431,64,2012-07-05 06:31:30,2012-07-05 06:31:30
62c386259b7fbd1ef665fc6baf4458c8e05ad1f8...a645664e503475af2b8ed6f81f6860aad188f327,5,144,104,248,26,2012-07-05 17:12:15,2012-07-05 17:12:15
a645664e503475af2b8ed6f81f6860aad188f327...c6ee96c02587aeea0da52018325c100bfd45127a,5,149,7,156,10,2012-07-05 17:37:23,2012-07-05 17:37:23
c6ee96c02587aeea0da52018325c100bfd45127a...3c07eaa251b73e6c5eff4b56e074c54708a4b4ba,19,194,258,452,117,2012-07-05 22:11:54,2012-07-05 22:11:54
3c07eaa251b73e6c5eff4b56e074c54708a4b4ba...68146db00454b46493545aff34d06cf2c11e0f6d,4,7,4,11,5,2012-07-05 22:15:57,2012-07-05 22:15:57
68146db00454b46493545aff34d06cf2c11e0f6d...cd6915cdb4f53f6c8e89599bfacbbb298412ec33,3,5,5,10,5,2012-07-06 02:45:32,2012-07-06 02:45:32
cd6915cdb4f53f6c8e89599bfacbbb298412ec33...095e052606a8e1afb496ec4a1e95567a7f123827,3,51,9,60,7,2012-07-06 17:10:56,2012-07-06 17:10:56
8df906e6413dab7e72c9b72dd98929c1e00174bf...c56eb0962afe869d233446003e5d68ce43122d25,2,4,4,8,4,2012-06-05 01:39:02,2012-06-05 01:39:02
c56eb0962afe869d233446003e5d68ce43122d25...b79c1009678258d96692b916eb4ad432c48ed73d,2,2,2,4,2,2012-06-05 01:44:50,2012-06-05 01:44:50
b79c1009678258d96692b916eb4ad432c48ed73d...589242604f06a87c78d0a2c324f532d2caaba3f0,2,24,0,24,2,2012-06-05 01:56:50,2012-06-05 01:56:50
589242604f06a87c78d0a2c324f532d2caaba3f0...348668ec13c534160e4560325a3b01e101cec704,2,116,6,122,6,2012-06-05 03:25:57,2012-06-05 03:25:57
348668ec13c534160e4560325a3b01e101cec704...eef87c96afb281e343b9ad6345220b41457a85d7,2,3,1,4,2,2012-06-05 03:27:42,2012-06-05 03:27:42
eef87c96afb281e343b9ad6345220b41457a85d7...632c6d22a27e5c78f22faae96a1dbd6cab51a9ab,1,47,0,47,1,2012-06-05 03:57:58,2012-06-05 03:57:58
632c6d22a27e5c78f22faae96a1dbd6cab51a9ab...c44bd1edf43c43ed8782f956813cb6142cbe068c,12,351,353,704,40,2012-06-05 04:08:31,2012-06-05 04:08:31
c44bd1edf43c43ed8782f956813cb6142cbe068c...094e12f68da2b40cc69d9a2e0a2b1ac3a2319498,2,24,34,58,8,2012-06-05 04:10:08,2012-06-05 04:10:08
094e12f68da2b40cc69d9a2e0a2b1ac3a2319498...060100cf3a5367830fb5f29a587874b7fe7c4cdb,2,478,544,1022,26,2012-06-05 04:13:35,2012-06-05 04:13:35
060100cf3a5367830fb5f29a587874b7fe7c4cdb...257890f8395c56e42f15fda475e6a7be8c26b9e8,2,902,978,1880,60,2012-06-05 06:03:21,2012-06-05 06:03:21
257890f8395c56e42f15fda475e6a7be8c26b9e8...f0ff20ec40435bfffc36b11e0cdf32eae5adc6be,3,556,612,1168,48,2012-06-05 06:10:30,2012-06-05 06:10:30
f0ff20ec40435bfffc36b11e0cdf32eae5adc6be...446f9199c60f3781c653cf39847ef881a4e197d4,12,41,117,158,51,2012-06-05 06:31:26,2012-06-05 06:31:26
446f9199c60f3781c653cf39847ef881a4e197d4...b8d8704f90bc7aa7e30280b5495ad506de429464,2,642,676,1318,24,2012-06-05 06:34:02,2012-06-05 06:34:02
b8d8704f90bc7aa7e30280b5495ad506de429464...47e2c43401bfe0cae3a62ee215af75c4ea8333a0,2,423,479,902,49,2012-06-05 06:37:18,2012-06-05 06:37:18
47e2c43401bfe0cae3a62ee215af75c4ea8333a0...de53f62a0464f92fe0c175478dc38696eebbda99,7,1077,1185,2262,126,2012-06-05 06:57:48,2012-06-05 06:57:48
de53f62a0464f92fe0c175478dc38696eebbda99...094e65eb9dd68a4076d5978025b65c7f03792287,2,1,1,2,1,2012-06-05 06:58:51,2012-06-05 06:58:51
094e65eb9dd68a4076d5978025b65c7f03792287...dd127611e12b9bab9d6da0c24532c5cd151108fd,12,80,72,152,47,2012-06-05 07:46:16,2012-06-05 07:46:16
dd127611e12b9bab9d6da0c24532c5cd151108fd...22918f8f92d29a12a42db4e357f3d439e41bad0a,13,322,182,504,61,2012-06-06 00:16:17,2012-06-06 00:16:17
22918f8f92d29a12a42db4e357f3d439e41bad0a...53cec198c025c094b564039cf81258be4c96b91e,1,84,0,84,3,2012-06-06 00:17:20,2012-06-06 00:17:20
53cec198c025c094b564039cf81258be4c96b91e...8ee067952202cc8a6e4865eab46598e346ad3971,18,3064,2416,5480,162,2012-06-06 01:25:46,2012-06-06 01:25:46
8ee067952202cc8a6e4865eab46598e346ad3971...09ec0b843eae59318f37d2e3598ce59a23aff1d0,2,96,130,226,8,2012-06-06 01:29:26,2012-06-06 01:29:26
09ec0b843eae59318f37d2e3598ce59a23aff1d0...5a614fb86d87cff1a2892fe76fb7bdcca231d764,12,177,1072,1249,93,2012-06-06 02:53:54,2012-06-06 02:53:54
5a614fb86d87cff1a2892fe76fb7bdcca231d764...2c5ac562d2b26485378e4183fe880777bef56bea,2,228,253,481,35,2012-06-06 03:47:40,2012-06-06 03:47:40
2c5ac562d2b26485378e4183fe880777bef56bea...10d68406fe5aa8e20183d02116f1a6e87b85a788,2,369,345,714,31,2012-06-06 06:59:50,2012-06-06 06:59:50
10d68406fe5aa8e20183d02116f1a6e87b85a788...2ecbd36cbf0cb8b2e894b2e36400e59a1c88eb1c,15,852,618,1470,55,2012-06-06 07:48:31,2012-06-06 07:48:31
2ecbd36cbf0cb8b2e894b2e36400e59a1c88eb1c...a1aa2b188a0267290cb17c2a0b5d4ad8b7c693c2,14,122,141,263,58,2012-06-07 17:20:52,2012-06-07 17:20:52
a1aa2b188a0267290cb17c2a0b5d4ad8b7c693c2...f109be4e8a186d0251055f0ac90822c11838fa55,1,1,1,2,1,2012-06-07 17:31:52,2012-06-07 17:31:52
f109be4e8a186d0251055f0ac90822c11838fa55...860a96939a58831228c2ea90055ca82cd9c84698,4,4,4,8,4,2012-06-07 17:58:15,2012-06-07 17:58:15
9a4ee790e1e58e321b604bb66380b2ce2f00faf6...ad9bfeef7a27cb470f520798cd806cb310f4e9c8,2,4,2,6,4,2012-06-03 05:34:20,2012-06-03 05:34:20
041b8bdfd32cc93c6594a0e3cb1e93e74faa2562...82ea5847a7188b2798c5dbb0792e53ee8f60db55,6,30,10,40,9,2012-06-04 04:26:54,2012-06-04 04:26:54
5ecab6112cb3a53b3222f90c44b0938929e71ac9...1dbf4c92ce4937a62db93094dd449982cb8c9639,2,2,2,4,2,2012-05-18 04:45:45,2012-05-18 04:45:45
1dbf4c92ce4937a62db93094dd449982cb8c9639...e5187e12c445fbba269c5a99f47ec2673e52969b,2,4,4,8,4,2012-05-18 04:48:13,2012-05-18 04:48:13
e5187e12c445fbba269c5a99f47ec2673e52969b...78790da03c2f18912215c6dc4c19d88e636c31dd,4,18,2,20,6,2012-05-18 05:00:49,2012-05-18 05:00:49
78790da03c2f18912215c6dc4c19d88e636c31dd...3b6b6eb242e1e459d741d5edc475ce6b3130d063,2,14,0,14,7,2012-05-23 07:04:54,2012-05-23 07:04:54
f3cf4cbaae8c3b3aaed299b63d1773d85cd7789a...8f98c4fbf6085e613314892de5da871dce862b34,4,4,4,8,4,2012-04-18 20:15:13,2012-04-18 20:15:13
f3cf4cbaae8c3b3aaed299b63d1773d85cd7789a...c09602d172059c9fac67639ee803c6652dcc2c29,1,1,0,1,1,2012-04-18 08:38:14,2012-04-18 08:38:14
5fa0fcc888bdeb5210b03445045ba61bdf7b0034...178a9f3b519342788f653e2d5680913e36da2c4e,2,6,6,12,6,2012-04-18 16:37:07,2012-04-18 16:37:07
bacb05608f2d42ef7fdb6fa25241d4268b989387...c6d5dcd872dcc3aa16a269cb5b4a434a8960f58c,2,2,2,4,2,2012-01-25 03:50:18,2012-01-25 03:50:18
ef4d0dd7dbd959f830d4cb7976d6a4b061784ec6...34488a450081422037e84d269ddb289aa709e9fb,2,8,8,16,2,2012-01-26 18:39:07,2012-01-26 18:39:07
34488a450081422037e84d269ddb289aa709e9fb...b8c1950cbfbb48d49f79b1e36f8c8294b19ed57d,2,2,2,4,2,2012-01-26 18:43:08,2012-01-26 18:43:08
2c2f8ebe3a090bff0254aba10b745dae10bf242d...7117db499f0b02da32a8d08f6371cab1f6b53338,1,1,1,2,1,2012-01-26 18:26:14,2012-01-26 18:26:14
7117db499f0b02da32a8d08f6371cab1f6b53338...86e0e89ee81d4a2a1daef6b68aa269419ee7d644,2,3,3,6,3,2012-01-26 18:26:28,2012-01-26 18:26:28
86e0e89ee81d4a2a1daef6b68aa269419ee7d644...cd907067b81eb5b46cd416a3e65fb2858c4603f9,1,7,1,8,3,2012-01-26 18:51:03,2012-01-26 18:51:03
cd907067b81eb5b46cd416a3e65fb2858c4603f9...62b2fdc4de2abe56a0366c5e46861ce4837aca56,2,41,11,52,12,2012-01-26 18:51:29,2012-01-26 18:51:29
e93c536df1d1bbe7ff9d746bd5c48966bc552680...9380ff8a06197de3f7a3f27a66284da540192f0c,1,1,6,7,2,2012-01-25 18:09:26,2012-01-25 18:09:26
9380ff8a06197de3f7a3f27a66284da540192f0c...1fa3eab20c827d0300cd4a4bb50e2c28e16a2872,9,9,9,18,9,2012-01-25 18:19:29,2012-01-25 18:19:29
1fa3eab20c827d0300cd4a4bb50e2c28e16a2872...324ebb59900fd69411aec323a85953aec8c55bb6,5,152,3,155,5,2012-01-25 18:47:08,2012-01-25 18:47:08
324ebb59900fd69411aec323a85953aec8c55bb6...4a3ad1aa891f65547bd2e3e6de8862e3b26f47c9,4,26,26,52,20,2012-01-25 18:48:08,2012-01-25 18:48:08
4a3ad1aa891f65547bd2e3e6de8862e3b26f47c9...97bad784b5b8fe4ea871a7d4d8c3f5714c26e2ee,4,36,36,72,12,2012-01-25 18:50:08,2012-01-25 18:50:08
97bad784b5b8fe4ea871a7d4d8c3f5714c26e2ee...e49e49ff9557676d9018b410cea14a7f9f399733,2,2,2,4,2,2012-01-25 18:51:26,2012-01-25 18:51:26
c2abfc0a4427237e288eee06a364662345fbbf9d...881f5fd5ca5b59aa7183a93a5df68d5b36683db7,1,3,3,6,1,2014-11-17 23:38:03,2014-11-17 23:38:03
378f9d43ec5acabe51ed1f7c93ce323e401a6ee7...a7ae8c91f2c997f0a1cdf4a0661a03627d00e385,1,1,1,2,1,2014-11-16 05:28:11,2014-11-16 05:22:46
efd7792488a8dd500b1e6c7e708107671ee3d473...767f3c87bc019e04888c82fa222ffae3e89b6f7e,1,2,1,3,1,2015-01-23 13:24:27,2015-01-23 13:18:52
efd7792488a8dd500b1e6c7e708107671ee3d473...ca0fb736c70b6fd2814254fd8750eef42a3c9d86,1,3,3,6,3,2015-01-23 10:02:21,2015-01-23 10:02:21
ca0fb736c70b6fd2814254fd8750eef42a3c9d86...d41f114e9b11eddd3c947755801a35c0687c40e1,1,4,4,8,2,2015-01-23 10:14:12,2015-01-23 10:14:12
d41f114e9b11eddd3c947755801a35c0687c40e1...6e782ed42d90a54e8d548cee66be3627b0a1d077,1,5,1,6,1,2015-01-23 11:16:07,2015-01-23 11:16:07
06c00d559135bd79024b3f6c92d7f77bc50cab6a...4ed95f5fa298d861c5fa53ae2a3a0dcb4901bd69,10,20,20,40,20,2015-01-18 23:03:14,2015-01-18 23:03:14
4ed95f5fa298d861c5fa53ae2a3a0dcb4901bd69...ce29def7a63c86f238d725ef5b7a284c054d28a6,1,1,1,2,1,2015-01-19 16:27:15,2015-01-19 16:27:15
b615bd938bccbebb7dc5f89081f4fa024784bf1f...977646d7a0cfd3453fb716af1bc0d458e2b0fd5d,6,15,7,22,7,2014-12-23 03:48:48,2014-12-23 03:48:48
deffd946ef585ec42268bf7439d351ef9123f376...4529a9e7b7fd7a12f4897acef8eed07a03b43099,1,3,1,4,3,2014-12-09 09:57:35,2014-12-09 00:44:31
deffd946ef585ec42268bf7439d351ef9123f376...1f6f95a245e613873b822fbcaba4fa78112c57b4,1,1,1,2,1,2014-12-08 22:58:06,2014-12-08 22:58:06
deffd946ef585ec42268bf7439d351ef9123f376...52e4b87b5a2ac6543f9a901946bea84966681216,1,1,1,2,1,2014-12-08 10:36:26,2014-12-08 10:36:26
52e4b87b5a2ac6543f9a901946bea84966681216...c918127e68ac320830f960ac8ab804378588db5b,1,16,9,25,4,2014-12-08 12:05:42,2014-12-08 12:05:42
c918127e68ac320830f960ac8ab804378588db5b...eee275762ff962121576f5aca93e0dfc52679d51,1,47,43,90,33,2014-12-08 22:29:33,2014-12-08 14:03:04
eee275762ff962121576f5aca93e0dfc52679d51...24bc10266425cbb401ce9d4b681060159162a8b2,1,13,18,31,18,2014-12-08 22:29:33,2014-12-08 14:54:20
24bc10266425cbb401ce9d4b681060159162a8b2...285ec7049393792503b2127932e4bc6a967d58b6,1,2,2,4,2,2014-12-08 22:29:34,2014-12-08 15:25:02
43ecc8726b608472c67f70ac56eb77407414b0c2...10ea20515c148a94fb52c43f22ce476a572d5bf1,1,1,1,2,1,2014-06-26 18:37:08,2014-06-26 18:05:50
43ecc8726b608472c67f70ac56eb77407414b0c2...c0b3f18c0c0bea75de6e1a2a8f461cb1e1251956,1,0,5,5,1,2014-06-26 17:53:58,2014-06-26 17:53:55
2b6f00c2a7f255fbc250a10ec16cb3071cadc32e...fec94e1695131a98187165bef9ec7528f0ec6ba2,10,141,30,171,20,2014-06-27 04:38:46,2014-06-27 04:35:22
fec94e1695131a98187165bef9ec7528f0ec6ba2...51f924ea24bf97837725d3147df296240914716d,1,6,0,6,1,2014-06-28 23:23:06,2014-06-28 23:23:06
2b6f00c2a7f255fbc250a10ec16cb3071cadc32e...92ca842830477c35d4449477c4b51afe08d55521,1,15,7,22,6,2014-06-27 00:08:58,2014-06-27 00:08:58
8c6061c1950f2bcd14baf8be549c3e532bd498cd...21571b3412545881f1127e83c82f8456732961c8,1,2,2,4,2,2014-07-08 21:40:20,2014-07-08 21:39:35
fc1db2e74b16b355656512eafd39f667f383a8a9...cbba8e53df2cfea3273072d94408fd2981dce460,2,35,3,38,5,2014-07-31 18:36:24,2014-07-08 02:05:48
fc1db2e74b16b355656512eafd39f667f383a8a9...0c03d0c273b3b7be2254f0585c1fd1b8592b629d,1,1,1,2,1,2014-07-31 02:21:56,2014-07-31 02:21:56
fc1db2e74b16b355656512eafd39f667f383a8a9...18c0a1c9774e0b726813b578a5046a30d0681e33,2,3,3,6,3,2014-07-30 21:54:25,2014-07-30 21:54:25
cde13fbe1124d5e93f55ec6a2bfed959c03abaeb...fdf174e498d8fbd9a73c45ccd805099a25e790f9,6,32,32,64,32,2014-06-18 22:46:38,2014-06-18 22:46:38
fdf174e498d8fbd9a73c45ccd805099a25e790f9...46e8a5817d0ddb98343dde1e0f0f8b335aba41e3,6,7,4,11,7,2014-06-19 00:34:09,2014-06-19 00:34:09
b8a04f8c60d805cc15ffd2fa3b48febad58c5e6a...25b06d927fa8fb056b3b146db263498a34401fb8,1,2,2,4,2,2014-06-23 21:36:18,2014-06-23 21:36:18
b8a04f8c60d805cc15ffd2fa3b48febad58c5e6a...29d97d07efef69034fa0eea644ed2966e750afae,1,2,2,4,2,2014-06-23 20:50:38,2014-06-23 20:50:38
e98fc373e3ef6e4a884a0142d50c765a9db5bd01...ca54cff4abf58155f27d1363cd124984b353a89c,2,17,17,34,5,2014-06-23 01:04:19,2014-06-23 01:04:19
e98fc373e3ef6e4a884a0142d50c765a9db5bd01...898328655f1978656fa2eba49bb0d2b43557e712,2,43,35,78,18,2014-06-23 00:12:16,2014-06-23 00:06:12
4045740c54504ede15f831c877f134752b6c12be...5fb1c065eb30b1987fa67452b9970c2e4284e75d,1,1,1,2,1,2014-06-26 01:04:49,2014-06-26 01:04:49
1a137ffb6db404e06e6effe15d5e792e4e02998b...e9212e8ab7fe3f0be823ae836696a397cb4f908f,1,1,1,2,1,2014-02-03 06:11:18,2014-02-03 06:11:18
e9212e8ab7fe3f0be823ae836696a397cb4f908f...27e080df4b80791860624ba17d4b57608200d5e0,1,4,0,4,1,2014-02-03 06:51:19,2014-02-03 06:51:19
02ae5a2728430c69aca33b1874c80ee326da5eeb...0ed6075010f90a8722e77a9b24ad8d9fd99c0189,1,4,0,4,1,2014-02-04 21:06:15,2014-02-03 16:20:31
02ae5a2728430c69aca33b1874c80ee326da5eeb...0ef0c7b2c079e9cfe0e13f0be78dd28ab05237d1,1,0,1,1,1,2014-02-03 16:12:59,2014-02-03 16:12:59
02ae5a2728430c69aca33b1874c80ee326da5eeb...d99d79d2e8a0d6c1605f6948adab9b7826a5da42,1,1,1,2,1,2014-02-03 05:38:37,2014-02-03 05:38:25
02ae5a2728430c69aca33b1874c80ee326da5eeb...847adb7dad2ad2b73f9180950e95b4258c8308ee,1,7,7,14,7,2014-02-02 22:14:22,2014-02-02 22:14:22
c86c8de4f2c2e28fa02ae1f91b769945579610a4...bf0cedc6241192cf2b166632924e3485eba69b00,1,1,1,2,1,2014-01-30 20:32:30,2014-01-30 20:32:30
c86c8de4f2c2e28fa02ae1f91b769945579610a4...dd6bb5a33574fd9d5bd598bb13ba336ae3953844,1,1,1,2,1,2014-01-30 20:30:55,2014-01-30 20:30:55
37460e58d3139ef43425583b50d967341ec43930...2769241aeb5e9eba4a34ddbd9d495f7f8271e360,6,143,235,378,54,2012-09-19 03:56:20,2012-09-19 03:56:20
2769241aeb5e9eba4a34ddbd9d495f7f8271e360...2d90c816accea106cbf70c988ddd866268851595,6,182,83,265,47,2012-09-19 04:16:08,2012-09-19 04:16:08
2d90c816accea106cbf70c988ddd866268851595...a6206c98d5dbf21b790638741c88f09a8fc25596,1,1,1,2,1,2012-09-19 22:18:14,2012-09-19 22:18:14
a6206c98d5dbf21b790638741c88f09a8fc25596...6c3cd6fd9d0c35d1d033dd97d22ec44cf74d0021,2,15,28,43,5,2012-09-20 16:06:43,2012-09-20 16:06:43
6c3cd6fd9d0c35d1d033dd97d22ec44cf74d0021...67585bd34e8e122c6a143c434c8dfdc7ba8de619,1,2,2,4,2,2012-09-20 16:07:48,2012-09-20 16:07:48
67585bd34e8e122c6a143c434c8dfdc7ba8de619...443c43f6c4bd98f1d35fffb59e0078b8b49791b4,7,47,9,56,14,2012-09-20 17:28:27,2012-09-20 17:27:59
443c43f6c4bd98f1d35fffb59e0078b8b49791b4...532ee082135eec9ba510d8f085add8722da5a03b,4,300,24,324,39,2012-09-20 18:37:34,2012-09-20 18:37:34
532ee082135eec9ba510d8f085add8722da5a03b...c92a75999f8b82c1a6fc997eca1cc0206c4c3bf1,4,10,9,19,8,2012-09-20 18:45:59,2012-09-20 18:45:59
320b75de63f347027774ba7353eea7f6937ab14b...8878facc67da1c60a033cdbc1c8de518dab7ce69,1,1,1,2,1,2012-08-29 14:13:55,2012-08-29 14:13:55
320b75de63f347027774ba7353eea7f6937ab14b...ec6b3200035a08c662490ea2696094c47caa2e60,1,6,0,6,1,2012-08-26 05:09:10,2012-08-26 05:09:10
320b75de63f347027774ba7353eea7f6937ab14b...6e7ba4e24a52f9a9b77da29b8d13515456525e1a,1,1,1,2,1,2012-08-21 21:10:36,2012-08-21 21:10:36
6e7ba4e24a52f9a9b77da29b8d13515456525e1a...45978b6674799839e5b842cb6d89664dc14d494e,3,2,2,4,2,2012-08-21 21:16:01,2012-08-21 21:15:50
320b75de63f347027774ba7353eea7f6937ab14b...6477ad1acf5b9b2dd0c849d818ff4474ade3ac85,4,3,3,6,3,2012-08-21 19:57:41,2012-08-21 19:57:41
6477ad1acf5b9b2dd0c849d818ff4474ade3ac85...55facf1f2ed9606f17504ac92a4c3b17a9c5e20b,2,2,2,4,2,2012-08-21 19:58:48,2012-08-21 19:58:48
55facf1f2ed9606f17504ac92a4c3b17a9c5e20b...06c718b1d36f2cf518004f6074611a4ccb10dca5,2,2,2,4,2,2012-08-21 19:59:26,2012-08-21 19:59:26
06c718b1d36f2cf518004f6074611a4ccb10dca5...099cec1ca7470acd32afaab60f2180557ad9bdab,2,2,2,4,2,2012-08-21 20:00:40,2012-08-21 20:00:40
099cec1ca7470acd32afaab60f2180557ad9bdab...8a2b9f4a5f0f0c83c22ed364ca096ad191437117,2,2,2,4,2,2012-08-21 20:02:02,2012-08-21 20:02:02
320b75de63f347027774ba7353eea7f6937ab14b...5fc5d26917f5e4be3c6448569da750ec52234e93,1,2,4,6,6,2012-08-21 14:21:28,2012-08-21 14:21:28
5fc5d26917f5e4be3c6448569da750ec52234e93...e5060b8d92cc05c5fc19e8e0bb1b1d1d4e31b8e6,3,2,3,5,4,2012-08-21 20:07:06,2012-08-21 20:07:06
be8d5243f4942a83d9c3e08c5d9f4419536c72c2...364dbb7931393cb8fa796d75ec1f32a757d335e1,3,27,0,27,3,2012-07-30 22:38:36,2012-07-30 22:38:36
364dbb7931393cb8fa796d75ec1f32a757d335e1...0e62011da056d74ca84d462c3d45bc1b7573ef57,4,4,4,8,4,2012-07-30 22:52:38,2012-07-30 22:52:38
0e62011da056d74ca84d462c3d45bc1b7573ef57...59eba9afbc4da210212688f84f679412760b96ed,2,11,0,11,2,2012-07-30 22:54:03,2012-07-30 22:54:03
59eba9afbc4da210212688f84f679412760b96ed...196fb1d86a80ae3dad45eee2d34b738b80171132,2,0,9,9,2,2012-07-31 05:26:54,2012-07-31 05:26:54
196fb1d86a80ae3dad45eee2d34b738b80171132...9795e9bbe62b05a95e3485a64ba139539113f2db,15,106,104,210,15,2012-07-31 06:48:26,2012-07-31 06:48:26
9795e9bbe62b05a95e3485a64ba139539113f2db...e191964ff800f5576576d6212be1e43112567ebe,1,125,127,252,7,2012-07-31 07:01:04,2012-07-31 07:01:04
e191964ff800f5576576d6212be1e43112567ebe...31b30ab88e6ac823653a6211365d6c9d46c5fa5d,4,4,4,8,4,2012-07-31 07:06:37,2012-07-31 07:06:37
dc6eaafb00426315a3720324d7fc3a4a33a04ddf...6d447079a41f8441c061a9d6f572e28c627ccd6e,4,78,78,156,52,2012-07-06 22:18:56,2012-07-06 22:18:56
6d447079a41f8441c061a9d6f572e28c627ccd6e...e2336ef02ab620277e2d81f3fc6b4ff69e027ae4,5,228,252,480,117,2012-07-07 07:30:43,2012-07-07 07:30:43
cb1a59caa013e0fbe992bb305502f37bc7141c92...aac3736eeaa1ff1eaf3a6a04502efd6d5b9e7e49,5,64,8,72,7,2012-07-18 06:32:52,2012-07-18 06:32:52
aac3736eeaa1ff1eaf3a6a04502efd6d5b9e7e49...c8fa2600f23ce9cfcbf7d98582198824d7c000a5,2,2,2,4,2,2012-07-18 06:38:29,2012-07-18 06:38:29
c8fa2600f23ce9cfcbf7d98582198824d7c000a5...6c23fff4d6d06953ae9804a4146cdc3fe2dd5a2e,3,1,25,26,5,2012-07-18 08:06:52,2012-07-18 08:06:52
6c23fff4d6d06953ae9804a4146cdc3fe2dd5a2e...89d7ec5290912ddd762f743f450b58b865afc6c3,3,51,11,62,8,2012-07-20 04:06:42,2012-07-20 04:06:42
89d7ec5290912ddd762f743f450b58b865afc6c3...3c1a0fbda40d06ab0b89d07ad808aa6975c8381d,3,92,8,100,11,2012-07-20 04:25:24,2012-07-20 04:25:24
3c1a0fbda40d06ab0b89d07ad808aa6975c8381d...1d4660beeaa8ef987256a5e7008340505b00c859,2,0,58,58,2,2012-07-20 04:25:42,2012-07-20 04:25:42
1d4660beeaa8ef987256a5e7008340505b00c859...ee750bbce154fd1e8f1137f5782d9ba21ec07406,1,4,0,4,2,2012-07-21 04:38:28,2012-07-21 04:38:28
ee750bbce154fd1e8f1137f5782d9ba21ec07406...b9105b98f9ee5f15d5b18bccf277344683d4a6db,16,905,894,1799,27,2012-07-21 05:06:47,2012-07-21 05:06:47
7ff1b074eab5ccf341c3da3dac799bca864778b6...9581cbfe3240583d898b788452788e40878b912e,1,2,2,4,2,2012-07-16 13:29:49,2012-07-16 13:29:49
9581cbfe3240583d898b788452788e40878b912e...426e7d9fbd87421e56a76e17a19de97a6e08c460,1,2,2,4,2,2012-07-16 13:31:18,2012-07-16 13:31:18
7ff1b074eab5ccf341c3da3dac799bca864778b6...7d1c8c2a0ce16331583a965821690f7715e62908,1,36,36,72,5,2012-07-07 20:20:50,2012-07-07 20:20:50
7cc916d1378847d9e6e353d553f6d73aeab386d2...e2b777d9a3ea12ec10f6046975ec0f43c6636601,3,4,1,5,4,2012-07-07 19:34:47,2012-07-07 19:34:47
e2b777d9a3ea12ec10f6046975ec0f43c6636601...3f2f96b0d71e64bd53d5175d0876f25f23a7835b,2,72,70,142,11,2012-07-07 19:52:05,2012-07-07 19:52:05
3f2f96b0d71e64bd53d5175d0876f25f23a7835b...5f861ef51735d8b0f2c0f0faf8f438808a480d99,14,314,422,736,74,2012-07-08 06:16:07,2012-07-08 06:16:07
5f861ef51735d8b0f2c0f0faf8f438808a480d99...20676ddd4d3e46c9fb32aadfeddb3a4a68efa6a3,20,656,29,685,47,2012-07-08 08:47:36,2012-07-08 08:47:36
20676ddd4d3e46c9fb32aadfeddb3a4a68efa6a3...db9925510ba9328f227e5ad3935f73e0c67904d8,3,21,4,25,8,2012-07-09 04:47:16,2012-07-09 04:47:16
db9925510ba9328f227e5ad3935f73e0c67904d8...8b696ad0b5fda07599bc3a865b1f2659345add3b,2,2,1,3,2,2012-07-09 07:14:35,2012-07-09 07:14:35
8b696ad0b5fda07599bc3a865b1f2659345add3b...16cf6b30cd0ea82dda210f021dfc163a3783fe1c,4,13,44,57,15,2012-07-09 07:17:36,2012-07-09 07:17:36
16cf6b30cd0ea82dda210f021dfc163a3783fe1c...410decafad0496033ba965dc594786b9c4629449,2,292,292,584,2,2012-07-09 07:17:52,2012-07-09 07:17:52
410decafad0496033ba965dc594786b9c4629449...9887d3cf4af4897c4959491ece2fe56bef3d1114,6,42,98,140,37,2012-07-09 07:26:32,2012-07-09 07:26:32
9887d3cf4af4897c4959491ece2fe56bef3d1114...25d0b341a9a89ae2f0da4a506c26ac77db011350,4,49,37,86,30,2012-07-09 07:31:54,2012-07-09 07:31:54
a85499749a2baf10dcb5192c2cc152cfd5ac463e...244a9ab79d13a88b8bb5ef59665a82088edd62d9,3,28,65,93,52,2012-06-26 03:20:32,2012-06-26 03:20:32
244a9ab79d13a88b8bb5ef59665a82088edd62d9...b77ed4a3a3c47af057e16db93ef41023d1cc5e08,2,9,2,11,4,2012-06-26 03:57:04,2012-06-26 03:57:04
860a96939a58831228c2ea90055ca82cd9c84698...f8d68002dc22a15a84c0a4dff5a5851ff131c9c8,1,13,1,14,3,2012-06-08 00:23:22,2012-05-09 13:50:13
f8d68002dc22a15a84c0a4dff5a5851ff131c9c8...c3f5d7c62d49de8de9947e84e9186bd2bf374008,1,1,1,2,1,2012-06-08 00:23:22,2012-06-07 21:36:45
860a96939a58831228c2ea90055ca82cd9c84698...ff6dd0cf56c1b50b7fa7cba35aab4d13cb251f05,11,24,35,59,23,2012-06-07 21:01:03,2012-06-07 21:01:03
ff6dd0cf56c1b50b7fa7cba35aab4d13cb251f05...df869f1eb074f5c2baaaf744f333c5f5d6ce0bee,10,31,31,62,27,2012-06-08 04:45:37,2012-06-08 04:45:37
df869f1eb074f5c2baaaf744f333c5f5d6ce0bee...c1c7528dd9f0617cb65bc5fac7aa6b2cfc2eb822,11,444,3,447,14,2012-06-08 04:48:03,2012-06-08 04:48:03
c1c7528dd9f0617cb65bc5fac7aa6b2cfc2eb822...bba0b34c36ae54e923cf89fe17914e715aaa9746,18,240,100,340,81,2012-06-08 05:10:36,2012-06-08 05:10:36
bba0b34c36ae54e923cf89fe17914e715aaa9746...97c7a83a8fd96ae9e2e227e150f967a4b476f0a9,2,0,24,24,24,2012-06-08 05:12:15,2012-06-08 05:12:15
97c7a83a8fd96ae9e2e227e150f967a4b476f0a9...269ce715f1a722a10d0a4a9229bcca8da3aa682a,3,61,127,188,4,2012-06-08 05:24:47,2012-06-08 05:24:47
ad9bfeef7a27cb470f520798cd806cb310f4e9c8...eb3a4b8f759299e4157bd32deb6016587f48acb4,2,10,4,14,4,2012-06-04 15:33:42,2012-06-04 15:33:42
37ba0eba024944ab13d2fd093d3e12340430fecd...8eb1488861447aad908e268931644a2b5c9adcd2,2,626,622,1248,24,2012-06-04 15:44:50,2012-06-04 15:44:50
8eb1488861447aad908e268931644a2b5c9adcd2...5563b8448eb4472743605cb006473387ebf1529a,2,2,2,4,2,2012-06-04 15:45:51,2012-06-04 15:45:51
b627898919bcd17cafe5b1cae69c555ebb9a769e...bc07e2adae7bc61795d54681915d791aee41c49a,4,25,7,32,10,2012-04-18 20:35:14,2012-04-18 20:35:14
bc07e2adae7bc61795d54681915d791aee41c49a...edb52a82d83d473071c20dfc4d8cb99742421950,4,1351,505,1856,1162,2012-04-18 23:16:42,2012-04-18 23:16:42
edb52a82d83d473071c20dfc4d8cb99742421950...f89394b8efda4bb9c969a7c69f8e9743ed546776,1,29,14,43,2,2012-04-19 05:49:31,2012-04-19 05:49:31
f89394b8efda4bb9c969a7c69f8e9743ed546776...fd009597b67fc8bbd599248ce832a3930c85a966,2,2,2,4,2,2012-04-19 16:28:40,2012-04-19 16:28:40
62a0f5fdcb147df8ec1084af3feba1555bed5669...47b6e6bd80040cdaa50c27cb7eb11881df679eee,3,30,2,32,4,2012-04-18 16:47:30,2012-04-18 16:47:30
358e3a53f77398363ba53108e6d2b1cdfaebf2c6...9c1ec6fb98efb72dbf9618e6c332702082dcd622,3,6,3,9,4,2012-01-26 19:40:29,2012-01-26 19:40:29
9c1ec6fb98efb72dbf9618e6c332702082dcd622...b7f22e27ec89049f4347ae5249e97c08eb8d6a2f,3,5,6,11,4,2012-01-26 19:47:40,2012-01-26 19:47:40
dd9a0a3f1639ea9a060b147c26601d236d240bf1...edef89f30efd73e5fca9952eef48136f8264aa93,7,49,24,73,29,2012-01-26 19:10:07,2012-01-26 19:10:07
e49e49ff9557676d9018b410cea14a7f9f399733...6cbf2f402432187f79aea1a938a08f1ce876fd2d,2,2,2,4,2,2012-01-25 18:59:45,2012-01-25 18:59:45
6cbf2f402432187f79aea1a938a08f1ce876fd2d...0b2dd16e7293fa11f453abf67395493cbfe18935,1,1,1,2,1,2012-01-25 19:02:28,2012-01-25 19:02:28
423825f50670174033e85a3ebe59743e05e4e415...da79ab94889dd72c83245c376e278a4c378f84b4,1,29,0,29,1,2014-11-18 02:17:40,2014-11-17 00:42:55
da79ab94889dd72c83245c376e278a4c378f84b4...36b4f90f250b96390f10057ba5b1312367fafe8c,1,1,1,2,1,2014-11-18 02:17:42,2014-11-16 21:01:32
939e759f69f2afb83be563a14d0df323db83b14b...8008fe707ec1259afcee1084bf4e79d29ed46ef4,1,153,0,153,1,2014-11-16 06:37:55,2014-11-16 06:22:15
8008fe707ec1259afcee1084bf4e79d29ed46ef4...b7398bc9c40f5f0e3404896adba10915b2a8304e,1,4,7,11,4,2014-11-16 06:43:20,2014-11-16 06:43:20
972a361e9825cc0e04463c07d28e713616b9a9df...a380e30f7e6a49a1438eca82d29d92c76168d9dd,20,20,0,20,20,2015-02-02 20:45:57,2015-01-23 19:34:52
972a361e9825cc0e04463c07d28e713616b9a9df...50a3e579ae9fce0fb285cc5b21c76ce76f085022,1,2,2,4,2,2015-01-23 23:59:37,2015-01-23 23:59:37
50a3e579ae9fce0fb285cc5b21c76ce76f085022...6a84b5a090e00e417b8b864f9d624cd2a2d5a4ef,1,33,77,110,20,2015-01-24 00:03:23,2015-01-24 00:03:23
ce29def7a63c86f238d725ef5b7a284c054d28a6...c683e7dea763b19e9bb172c34f74f99b926607e0,34,105,105,210,98,2015-01-19 16:32:13,2015-01-19 16:32:13
c683e7dea763b19e9bb172c34f74f99b926607e0...fa47de717eb32f044d012974aa72a0c0ad0441e1,3,3,3,6,3,2015-01-19 16:33:33,2015-01-19 16:33:33
977646d7a0cfd3453fb716af1bc0d458e2b0fd5d...28790491632befc63fb952dd79aab042d641176b,1,1,1,2,1,2014-12-29 02:25:49,2014-12-29 02:25:49
28790491632befc63fb952dd79aab042d641176b...952f7e9a4e7b455701f46cbdf7ae09f7918c12ad,1,157,119,276,55,2014-12-29 02:32:02,2014-12-29 02:32:02
7c228b3cfab854bf43b0ba8aa4899fdabf62467a...a9d92a5e419fd8b8c7d4136dc8214b06bf8721b7,1,1,1,2,1,2014-12-10 20:13:21,2014-12-10 20:13:21
7c228b3cfab854bf43b0ba8aa4899fdabf62467a...d9c3e5f3ad28a55102a6c880324ef8ac80ddf276,2,6,9,15,7,2014-12-10 16:50:21,2014-12-10 16:50:21
7cff5bb84fcaafe6970dd976f4d29074800f72e0...3ed0d586b7091e96745cf9a6ec10f3d20bb67d40,1,10,10,20,2,2014-12-09 01:57:55,2014-12-09 01:57:55
3ed0d586b7091e96745cf9a6ec10f3d20bb67d40...f932eaa525aab1970172043e6da95cd01717f830,1,11,11,22,2,2014-12-09 01:59:29,2014-12-09 01:59:29
d79082aac893996be1c887b7f910a64c57e25690...1939d017c5ed7ff7054e0598836bcf4dad1a08a8,1,1,1,2,1,2014-06-26 19:09:59,2014-06-26 19:09:59
018114fc09ef03e65fded8a50e12150210f9df3d...1098453f831fad3fdfcbf036237ed064a5d29b26,2,2,2,4,2,2014-06-29 05:39:40,2014-06-29 05:39:40
1098453f831fad3fdfcbf036237ed064a5d29b26...d23d9ee4a01a3db0fb2b843bbd7b69814a91790b,1,1,1,2,1,2014-06-30 02:58:09,2014-06-30 02:58:09
31373309a5ac2fb295cca21ba204e2e9a73fb640...05ddea314cb03832f0914939efc7ad6c1f7d8d9b,1,2,2,4,2,2014-07-08 22:42:02,2014-07-08 20:19:46
05ddea314cb03832f0914939efc7ad6c1f7d8d9b...0268b41c4f93e8f85c44a9ee2c8177c076c61ede,1,1,1,2,1,2014-07-08 22:42:02,2014-07-08 22:29:38
0268b41c4f93e8f85c44a9ee2c8177c076c61ede...1719d2b0516ef17afca36fc95249a10e8f3bd136,1,6,6,12,6,2014-07-08 22:42:02,2014-07-08 22:38:44
f026cfb8310f31db94823d031a382de5d5b0520b...9739271c04646ca49d8937043e45a6c9f6930bbc,4,122,18,140,11,2014-07-31 18:45:21,2014-06-11 10:06:32
46e8a5817d0ddb98343dde1e0f0f8b335aba41e3...11cf54f9df61738d15078cf6eba25a9a26f584be,2,2,2,4,2,2014-06-19 01:22:11,2014-06-19 01:22:11
46e8a5817d0ddb98343dde1e0f0f8b335aba41e3...74a264fb98ced0228d385d601e9edd913bb1b173,7,79,6,85,9,2014-06-19 01:19:17,2014-06-19 01:19:17
74a264fb98ced0228d385d601e9edd913bb1b173...00cc166671a4ecfe3284662db14c8bf151de5bb5,1,4,4,8,4,2014-06-19 22:22:49,2014-06-19 22:22:49
f4dd02f531f21207a29ffd966081e1a824155706...02642350f807c1431e686f03a97c0067fc0a2b51,1,1,0,1,1,2014-06-19 05:16:15,2014-06-19 05:16:15
f4dd02f531f21207a29ffd966081e1a824155706...2a380f6bd8c4f96ff59de88841968fd538caf538,1,2,1,3,1,2014-06-19 04:58:29,2014-06-19 04:58:29
f4dd02f531f21207a29ffd966081e1a824155706...c7cd63107b551ddb8fe201340f1fa9cbe97f8af0,2,4,2,6,3,2014-06-19 04:52:34,2014-06-19 04:52:34
f4dd02f531f21207a29ffd966081e1a824155706...783b2268c2f5b11a79a2e3ba3278e53321bdc9d5,1,3,3,6,2,2014-06-19 04:26:53,2014-06-19 04:26:53
b6e52d55ea2b0cfd01cddb539e0baf5abe01f89c...4dcdc08d89fa029c22fd7b51c61394f2c3405edc,3,6,11,17,5,2014-06-26 06:03:40,2014-06-26 06:03:40
9da127a8e513fc653c1016646331ffa27839a992...df7cfe86525252034cf85a365d09a4c2485116b4,6,4,8,12,6,2014-06-23 17:38:45,2014-06-23 17:38:45
9da127a8e513fc653c1016646331ffa27839a992...d4ce4dbf122158e3d0d714ac8eead0144f071d05,1,1,1,2,1,2014-06-23 16:25:14,2014-06-23 16:25:14
9da127a8e513fc653c1016646331ffa27839a992...7339759fd6e11473a633f55f53a0b4ced6a7fa7d,1,1,1,2,1,2014-06-23 15:51:02,2014-06-23 15:51:02
27e080df4b80791860624ba17d4b57608200d5e0...a2ff16c3cef2c4c6a04feace15b1541226705a8e,1,10,9,19,3,2014-02-03 09:51:32,2014-02-03 09:44:50
229bc6fef99c9e94bd8d2927688aadea85b9feb2...ec6c9d28240aa4ef32b13be51943f98c00f3437e,11,21,28,49,21,2014-02-04 08:18:34,2014-02-04 08:18:34
00685be0e96fcb6eb32f931865b19becfdd02946...e430675d147bb9e0991e43a4fd86bf6bdf3deda5,1,1,1,2,1,2014-01-30 22:46:58,2014-01-30 22:46:58
e430675d147bb9e0991e43a4fd86bf6bdf3deda5...2c6b099f91e8b325ff49e690b0718de726ac410b,1,1,1,2,1,2014-01-31 04:39:12,2014-01-31 04:39:12
00685be0e96fcb6eb32f931865b19becfdd02946...22e576c600547b10c8038ff68c13386bcb36477a,1,1,1,2,1,2014-01-30 21:59:54,2014-01-30 21:59:54
c92a75999f8b82c1a6fc997eca1cc0206c4c3bf1...a419e70a42f7f4c8165e640774082d3fec61b4c4,1,39,9,48,7,2012-09-21 17:24:16,2012-09-21 17:24:16
c92a75999f8b82c1a6fc997eca1cc0206c4c3bf1...667179f406ea66fbe2d688bb132eaa0c0f7383a6,6,31,31,62,13,2012-09-20 23:23:54,2012-09-20 23:23:54
667179f406ea66fbe2d688bb132eaa0c0f7383a6...fe38d12f122cc0a9e3435ffa0d7de58b6fa941f4,4,22,4,26,6,2012-09-20 23:26:00,2012-09-20 23:26:00
fe38d12f122cc0a9e3435ffa0d7de58b6fa941f4...1716b0fdb5023ff45f0d28e5266db053aa64ccc6,1,1,1,2,1,2012-09-20 23:31:10,2012-09-20 23:31:10
1716b0fdb5023ff45f0d28e5266db053aa64ccc6...ebf94c53a5497ff6d2aa353027d3a2ac3b67b18a,4,13,13,26,13,2012-09-20 23:50:36,2012-09-20 23:50:36
cfa039d2e0aff2bfd25b3cac129d01873f182eba...f15eb7b499e3afa628b7baba1b02eed4fc079d33,2,16,0,16,2,2012-08-27 06:06:56,2012-08-27 06:06:56
f15eb7b499e3afa628b7baba1b02eed4fc079d33...1b8f4f5bc5f72ada4395c40a70e645a09eac593c,2,11,8,19,3,2012-08-27 06:23:47,2012-08-27 06:23:47
1b8f4f5bc5f72ada4395c40a70e645a09eac593c...72f176d1f513b936483d37cf3b50f3c21a3d838e,2,6,0,6,6,2012-08-27 16:17:20,2012-08-27 16:17:20
72f176d1f513b936483d37cf3b50f3c21a3d838e...bdc3ff99f3fcf7a88d3a46b8b3b94b31232ee629,2,2,2,4,2,2012-08-27 16:18:32,2012-08-27 16:18:32
bdc3ff99f3fcf7a88d3a46b8b3b94b31232ee629...12d5c88c202f9f4bb60dfb07622a5dacffa4be1c,1,1,1,2,1,2012-08-27 16:53:23,2012-08-27 16:53:23
12d5c88c202f9f4bb60dfb07622a5dacffa4be1c...96542f14ab64cdf35b56df55752b28b95dc415c7,2,2,2,4,2,2012-08-27 17:04:58,2012-08-27 17:04:58
96542f14ab64cdf35b56df55752b28b95dc415c7...54e3a26ddadb7e16b9585fe1a77c6ac9667073fb,2,2,2,4,2,2012-08-27 17:08:16,2012-08-27 17:08:16
54e3a26ddadb7e16b9585fe1a77c6ac9667073fb...fcd08fce8faaa9fb1a72516a59d8426a496eac7a,2,15,0,15,3,2012-08-27 17:32:07,2012-08-27 17:32:07
fcd08fce8faaa9fb1a72516a59d8426a496eac7a...a2b9a5e1fecbcad93c0f1b08bf7f470c2aaaabdd,2,6,2,8,2,2012-08-27 17:52:11,2012-08-27 17:52:11
a2b9a5e1fecbcad93c0f1b08bf7f470c2aaaabdd...1c9d5c43b06dc81de1320227244246a17d3a79f3,4,54,34,88,17,2012-08-27 17:56:46,2012-08-27 17:56:46
1c9d5c43b06dc81de1320227244246a17d3a79f3...8a5dde556b4b029a18faa8c863284d72f7df3b28,2,4,2,6,2,2012-08-27 18:05:01,2012-08-27 18:05:01
8a5dde556b4b029a18faa8c863284d72f7df3b28...15317419f4900caf63cb61c4005d67064ba4b63f,2,6,0,6,2,2012-08-27 18:46:47,2012-08-27 18:46:47
15317419f4900caf63cb61c4005d67064ba4b63f...22c4f3d058412eff54642319ad345b48f64e050e,3,19,0,19,3,2012-08-27 19:05:15,2012-08-27 19:05:15
22c4f3d058412eff54642319ad345b48f64e050e...cf9334bd7d2017581300959ef3099bdd2db2182f,2,4,2,6,2,2012-08-27 19:07:28,2012-08-27 19:07:28
cf9334bd7d2017581300959ef3099bdd2db2182f...85dcbd0b345378046ae99f6001df1222a75046b2,3,4,0,4,4,2012-08-27 22:12:22,2012-08-27 22:12:22
85dcbd0b345378046ae99f6001df1222a75046b2...8610fd9b2b0ad4ac8ca5ae6aa092f48968dd8c74,1,0,5,5,1,2012-08-27 22:12:55,2012-08-27 22:12:55
8610fd9b2b0ad4ac8ca5ae6aa092f48968dd8c74...b444582ccdc8c4f0e4c21357d41498cd46532a70,2,2,2,4,2,2012-08-27 22:20:50,2012-08-27 22:20:50
b444582ccdc8c4f0e4c21357d41498cd46532a70...4674945fa83ce7459d5bad45d1d574a6496ec3be,2,2,2,4,2,2012-08-27 22:27:58,2012-08-27 22:27:43
4674945fa83ce7459d5bad45d1d574a6496ec3be...3b67ece2d10aaf573ffb93fc804dc4e382a50837,2,21,0,21,5,2012-08-27 22:39:55,2012-08-27 22:39:55
e2ecd2df6cc65efa3e5c70727e9bae2fbe159687...190d3c9c3ec2528a09a9639154bf6ad95b0fc6f2,3,32,6,38,8,2012-08-21 21:22:26,2012-08-21 21:22:26
190d3c9c3ec2528a09a9639154bf6ad95b0fc6f2...46c10c8b58919841d9adbc4908a127bf5eff88ad,2,2,2,4,2,2012-08-21 21:38:47,2012-08-21 21:38:47
94f9f9de73f0369094fd103bbde15ee9a4049c4c...4f918ce52c9aae4022171624d0b272e38848050f,2,2,2,4,2,2012-08-21 20:08:09,2012-08-21 20:08:09
4f918ce52c9aae4022171624d0b272e38848050f...b52d29095a781962e621db826fa5bc865b184179,2,4,2,6,2,2012-08-21 20:09:01,2012-08-21 20:09:01
b52d29095a781962e621db826fa5bc865b184179...1c134d9a7f28da89e451ea2c0649c0e3437579bc,34,47,47,94,47,2012-08-21 20:11:25,2012-08-21 20:11:25
1c134d9a7f28da89e451ea2c0649c0e3437579bc...6dc13573bf31f7bdfa954b3feb027cb2bd38eb13,2,23,5,28,6,2012-08-21 20:42:00,2012-08-21 20:42:00
6dc13573bf31f7bdfa954b3feb027cb2bd38eb13...13199c0020ba6eedd28779c858d480fb425ab506,2,0,4,4,2,2012-08-21 20:59:13,2012-08-21 20:59:13
13199c0020ba6eedd28779c858d480fb425ab506...311c00a29b9f0db1bdea768f8643cee6b642c24b,2,20,0,20,4,2012-08-21 21:07:20,2012-08-21 21:07:20
311c00a29b9f0db1bdea768f8643cee6b642c24b...b1c93c27003b433e6d9a29178ad3d8da8506ebd1,2,16,4,20,2,2012-08-21 21:15:01,2012-08-21 21:15:01
31b30ab88e6ac823653a6211365d6c9d46c5fa5d...1f70dd71c870804486d1dd57b7b6d319360edde2,1,3,3,6,3,2012-07-31 22:16:40,2012-07-31 22:16:40
b9105b98f9ee5f15d5b18bccf277344683d4a6db...5b8ff7061b659286bdd27c756bf8a58b05ba70d8,1,2,2,4,1,2012-07-22 21:31:39,2012-07-22 21:31:39
b9105b98f9ee5f15d5b18bccf277344683d4a6db...6c2fa9430c04b666ae5f490312be29116a7782d2,2,92,0,92,2,2012-07-22 19:57:39,2012-07-22 19:57:39
6c2fa9430c04b666ae5f490312be29116a7782d2...77dea2c5eb4c0abecfb3ccc50e6b4f78d3847181,1,1,1,2,1,2012-07-22 20:00:17,2012-07-22 20:00:17
77dea2c5eb4c0abecfb3ccc50e6b4f78d3847181...8281a9023a9a687be007de85f1731d131eedaf30,1,1,1,2,1,2012-07-22 20:21:44,2012-07-22 20:21:44
a1ad6d124a2ad22b9afcd16d90fc572b10fa9ffc...6a663081a78b2810e7b3904949cfc5a91df81eff,4,94,183,277,14,2012-07-18 04:45:57,2012-07-18 04:45:57
50a945e084e0153bd7e087cf29cdb2c176dbf4b8...07f80e6fd8664c9450b5e363631ed330bb7c3136,2,8,10,18,4,2012-07-09 07:42:38,2012-07-09 07:42:38
07f80e6fd8664c9450b5e363631ed330bb7c3136...7800fee7e0874446bbbcd6148206800cdebe2fe9,2,0,2,2,2,2012-07-09 07:51:38,2012-07-09 07:51:38
b77ed4a3a3c47af057e16db93ef41023d1cc5e08...a683497dbc0f9cc3f883f195206e87589d09caaf,13,322,2016,2338,22,2012-06-28 06:56:00,2012-06-28 06:56:00
a683497dbc0f9cc3f883f195206e87589d09caaf...c09e8473e2be483d3f53186840c002167647c44b,10,335,112,447,53,2012-06-28 17:03:46,2012-06-28 17:03:46
c09e8473e2be483d3f53186840c002167647c44b...c31a4e51316eb8767baebe9d8e370c782f15ea38,5,159,107,266,21,2012-06-29 03:59:16,2012-06-29 03:59:16
c31a4e51316eb8767baebe9d8e370c782f15ea38...6f4360c47b0fa2beaabf4595a58bbb929df7cecc,1,94,145,239,24,2012-06-29 04:06:54,2012-06-29 04:06:54
6f4360c47b0fa2beaabf4595a58bbb929df7cecc...98ebd548000bc080c6eb152cd2ef005938d2e516,2,26,18,44,14,2012-06-29 04:20:40,2012-06-29 04:20:40
98ebd548000bc080c6eb152cd2ef005938d2e516...cd2d82150cc27c1f81d2394a22efbf2dbec0e7be,38,147,85,232,47,2012-06-29 04:46:45,2012-06-29 04:46:45
b77ed4a3a3c47af057e16db93ef41023d1cc5e08...2e3306d5ddcbc5b906f36749007c0c8ea75d38c6,1,2,2,4,2,2012-06-26 09:30:43,2012-06-26 09:30:43
3875a9f31b278d67e3774fbf92972f9f400130aa...59153205b337df6900a681eb3b3681620bd20ec2,6,26,4,30,10,2012-06-21 06:46:29,2012-06-21 06:46:29
59153205b337df6900a681eb3b3681620bd20ec2...160fe7ca597ff0fdaab0bb49494713724468b05b,8,71,13,84,20,2012-06-21 06:46:51,2012-06-21 06:46:51
160fe7ca597ff0fdaab0bb49494713724468b05b...71669dda63644a7b4162ca63f8b9c88b3586c7e4,23,301,239,540,70,2012-06-25 03:26:48,2012-06-25 03:26:48
71669dda63644a7b4162ca63f8b9c88b3586c7e4...87af5d3bbe3546f9b876add2e35ad656accfc3ab,6,79,75,154,30,2012-06-25 03:42:31,2012-06-25 03:42:31
87af5d3bbe3546f9b876add2e35ad656accfc3ab...6662f62236cd1800952fb45a528b79d9a899f5d5,18,350,356,706,29,2012-06-25 04:03:39,2012-06-25 04:03:39
6662f62236cd1800952fb45a528b79d9a899f5d5...508a93d9e307457426f2aa2fcfa740858ebd851a,3,16,14,30,9,2012-06-25 04:07:20,2012-06-25 04:07:20
508a93d9e307457426f2aa2fcfa740858ebd851a...27845e4492741a973231ff1be6c493e001a28555,4,81,3,84,4,2012-06-25 21:11:37,2012-06-25 21:11:37
27845e4492741a973231ff1be6c493e001a28555...cd466f1d0b51c5165f7b615c671ee94d53f48eeb,3,83,1,84,3,2012-06-25 21:37:35,2012-06-25 21:37:35
cd466f1d0b51c5165f7b615c671ee94d53f48eeb...78849cf52ef2eba9dd8df621985ac277b67dd23b,2,0,2,2,2,2012-06-25 22:09:39,2012-06-25 22:09:39
78849cf52ef2eba9dd8df621985ac277b67dd23b...8c2db7d7d62d22183601364e7dcaee4a12b083ea,3,53,14,67,9,2012-06-25 22:47:07,2012-06-25 22:46:46
8c2db7d7d62d22183601364e7dcaee4a12b083ea...94a3d4eb14bc4674971617d6114c4fb7b08b3b7d,4,432,432,864,177,2012-06-25 23:25:50,2012-06-25 23:25:50
94a3d4eb14bc4674971617d6114c4fb7b08b3b7d...d65e815a48fd869bcdc4e4112cf675a1f987fc49,2,2,2,4,2,2012-06-25 23:47:29,2012-06-25 23:47:29
c3f5d7c62d49de8de9947e84e9186bd2bf374008...bd19b42c15108b3c60407924a1725473660120d9,1,9,3,12,2,2012-06-11 08:51:19,2012-06-11 08:51:19
269ce715f1a722a10d0a4a9229bcca8da3aa682a...550e375af08a5b6ad401c043f8c0d2f3b1d3b6c2,11,25,803,828,34,2012-06-08 23:35:04,2012-06-08 23:35:04
550e375af08a5b6ad401c043f8c0d2f3b1d3b6c2...aff3694f28946a0640f15dc07591dbfb332fcbaf,3,7,29,36,7,2012-06-09 19:58:55,2012-06-09 19:58:55
aff3694f28946a0640f15dc07591dbfb332fcbaf...ca63ea2f26facca1510390f85eed77d55f8f2b89,2,210,388,598,10,2012-06-09 20:15:28,2012-06-09 20:15:28
ca63ea2f26facca1510390f85eed77d55f8f2b89...c65006601e65cbfa23611f55c0af314fc762d84d,3,824,692,1516,57,2012-06-10 02:15:46,2012-06-10 02:15:46
c65006601e65cbfa23611f55c0af314fc762d84d...fc2481b8e57ec79a4ec0e7f6d26f4c8492bc84f7,2,2,2,4,2,2012-06-10 02:26:06,2012-06-10 02:26:06
fc2481b8e57ec79a4ec0e7f6d26f4c8492bc84f7...5ef2b6561a8409cc26c413e4a152df89a383f0e8,2,122,62,184,28,2012-06-10 05:47:45,2012-06-10 05:47:45
5ef2b6561a8409cc26c413e4a152df89a383f0e8...4a907709ba38767b118c1a880dadfb58df8ae1d6,2,84,108,192,24,2012-06-10 06:26:46,2012-06-10 06:26:46
4a907709ba38767b118c1a880dadfb58df8ae1d6...f2e39233f54a733df54d5d998abd79233e0f143f,5,317,173,490,56,2012-06-10 22:12:02,2012-06-10 22:12:02
f2e39233f54a733df54d5d998abd79233e0f143f...3985379ccabcdcf9f96432ba37be2dd38ed117bc,3,20,27,47,9,2012-06-10 22:14:21,2012-06-10 22:14:21
3985379ccabcdcf9f96432ba37be2dd38ed117bc...0c817bf5e2ab635777c17e00caed829e6939f34f,3,279,185,464,26,2012-06-10 23:46:46,2012-06-10 23:46:46
0c817bf5e2ab635777c17e00caed829e6939f34f...017b7cb804106a14d1a7b6f6b02109dddd4926a2,3,392,235,627,30,2012-06-11 03:39:00,2012-06-11 03:39:00
017b7cb804106a14d1a7b6f6b02109dddd4926a2...081a07c168b095c2e9d34e1a77164cf9ac21f449,2,68,46,114,14,2012-06-11 03:50:49,2012-06-11 03:50:49
081a07c168b095c2e9d34e1a77164cf9ac21f449...c90c66e61f5e3f09a46d63cd79086c7b2ab6db5c,2,537,533,1070,28,2012-06-11 04:00:20,2012-06-11 04:00:20
c90c66e61f5e3f09a46d63cd79086c7b2ab6db5c...a0cd886c56708bbd8d6896ee81b04579f86fb0aa,3,404,371,775,61,2012-06-11 04:24:13,2012-06-11 04:24:13
269ce715f1a722a10d0a4a9229bcca8da3aa682a...c028e333586c7ecdbc4cec6ca88ea99b26a11358,1,1,1,2,1,2012-06-08 13:19:08,2012-06-08 13:19:08
fd009597b67fc8bbd599248ce832a3930c85a966...192cb575da73ed2c056319b27613407729796a4f,2,2,2,4,2,2012-04-23 06:56:36,2012-04-23 06:56:36
192cb575da73ed2c056319b27613407729796a4f...99a916d5ebfdf5199be0232ac8bf6d569f54f07c,3,17,1,18,5,2012-04-23 10:05:10,2012-04-23 10:05:10
fd009597b67fc8bbd599248ce832a3930c85a966...c99dcd2e93a045701278d924470e10a4a180bc39,4,29,2,31,4,2012-04-19 23:09:59,2012-04-19 22:32:41
b7f22e27ec89049f4347ae5249e97c08eb8d6a2f...78652a707f8ae2d98b1cd434b4bca546d2948236,2,8,0,8,2,2012-01-26 21:51:12,2012-01-26 21:51:12
b7f22e27ec89049f4347ae5249e97c08eb8d6a2f...c13de3db607dad06ce992e78ffdb8c2fa6871e70,1,1,1,2,1,2012-01-26 21:04:24,2012-01-26 18:56:18
c13de3db607dad06ce992e78ffdb8c2fa6871e70...f76444c8585f3a720e0af2cedd33acddc718b962,1,1,0,1,1,2012-01-26 21:04:24,2012-01-26 19:11:05
f76444c8585f3a720e0af2cedd33acddc718b962...b9413460afe2bdfac18889953447622d13eb1968,3,9,9,18,8,2012-01-26 21:14:54,2012-01-26 21:02:27
b9413460afe2bdfac18889953447622d13eb1968...721b8a10785c548fa6a1cb26ccd698ceabc43e36,3,27,26,53,22,2012-01-26 21:15:09,2012-01-26 21:15:09
66f6535579e0d283d1ee24c99636c29ec1eef1c5...603aaa01ef487d912569459adc69bc06eb0ade52,2,6,6,12,6,2012-01-25 19:05:23,2012-01-25 19:05:23
603aaa01ef487d912569459adc69bc06eb0ade52...fd3c6733a2d7b8f3afa3fc8511162e23ad1ac412,2,2,2,4,2,2012-01-25 19:11:22,2012-01-25 19:11:22
403799023709c0cba0375258b7d8fb59356a4bf8...992644ee34348f81c77a1558e190d4ff56671e23,2,5,5,10,5,2014-11-23 11:50:09,2014-11-23 11:50:09
403799023709c0cba0375258b7d8fb59356a4bf8...e2520b8bd9f01abcf3f65fd4f0c989ad58627a46,1,2,2,4,2,2014-11-18 15:46:28,2014-11-18 15:46:28
391054fa2d50d0e19a2be852ca1a4bc0c356bb56...ab99374a9c281363afc4cafb61bfba2a4d91c758,1,1,0,1,1,2015-02-03 18:53:33,2015-02-03 18:53:33
391054fa2d50d0e19a2be852ca1a4bc0c356bb56...89ef0a5d34f1a1e59ce86b23dd711e073d291558,1,1,0,1,1,2015-02-03 18:48:56,2015-02-03 18:48:56
c015fec3254a8b83e009075e8ab8403c57704ea4...9f2589501562b86ddb6c58a1beb3193acca2f4e3,3,3,3,6,3,2015-01-26 15:58:09,2015-01-26 15:56:25
9f2589501562b86ddb6c58a1beb3193acca2f4e3...03e41b355c51474ebac21ba22f4626f05feba844,1,1,2,3,1,2015-01-26 16:02:58,2015-01-26 16:02:58
c015fec3254a8b83e009075e8ab8403c57704ea4...dc50153c933d1edbb28064ca13815ad7a6e15516,1,38,6,44,7,2015-01-24 02:48:33,2015-01-24 02:48:33
dc50153c933d1edbb28064ca13815ad7a6e15516...5688fc8d6592b8092ffe333feeb4b234de540b6a,1,1,2,3,2,2015-01-27 22:01:59,2015-01-27 22:01:59
5688fc8d6592b8092ffe333feeb4b234de540b6a...98d4464065b24cda9d1d1f893874cc0135997fa2,1,2,3,5,2,2015-01-28 18:47:02,2015-01-28 18:47:02
98d4464065b24cda9d1d1f893874cc0135997fa2...d78d9dc5d9284cc2cfb86517acba10028a418783,1,12,19,31,3,2015-02-10 13:57:56,2015-02-10 13:57:56
0cf14b37688c708fe3d966411f498d1936b05bdb...3efa9c46a40e49109e7a14d58ee7f8b170a3d17b,3,3,3,6,3,2015-02-09 01:41:04,2015-02-09 01:41:04
bcf7dd38b5ab180256e2e4fb5da0369551b3f082...24aad4fe3a9c3c607e52d5cd8de5b72527bca70b,1,1,1,2,1,2015-01-19 17:19:09,2015-01-19 17:19:09
688780eb07b00533ebffe1302e5c85cc0f154002...93cd02cd29bf750343429a0620e02008b3d7e1e9,1,1,1,2,1,2014-12-29 02:43:47,2014-12-29 02:43:47
93cd02cd29bf750343429a0620e02008b3d7e1e9...6099bfdea87fe70d61a13ea0627056e7998ea84d,1,21,45,66,5,2014-12-29 02:45:56,2014-12-29 02:45:56
a9d92a5e419fd8b8c7d4136dc8214b06bf8721b7...edba4a386c9e5f8849efdfb62ec8d2c7bb7e404f,1,4,0,4,1,2014-12-10 20:21:05,2014-12-10 20:18:52
f932eaa525aab1970172043e6da95cd01717f830...afa46515d07eecd41353a0134d3bf30de47245e0,2,95,83,178,37,2014-12-09 05:59:57,2014-12-09 05:55:38
f932eaa525aab1970172043e6da95cd01717f830...71f6dd25fc30c52c93fdb90fd6cb145593cdf2ee,3,184,1,185,5,2014-12-09 05:53:11,2014-12-02 11:50:20
83d9165287eb7f64c0135b1c0eb79573bce5c209...0bc2edd191ba38946b79bd92a96d3adcd11d26c8,1,6,1,7,3,2014-06-26 19:21:33,2014-06-26 18:41:40
0bc2edd191ba38946b79bd92a96d3adcd11d26c8...2f7d5fd26ba3bfa2bed3bfa5b348a77d66134178,1,1,1,2,1,2014-06-26 19:21:45,2014-06-26 19:15:20
2f7d5fd26ba3bfa2bed3bfa5b348a77d66134178...fde088751ab4fe87ea574c53afe1f9cada728a7d,1,1,1,2,1,2014-06-26 19:21:45,2014-06-26 19:17:37
d23d9ee4a01a3db0fb2b843bbd7b69814a91790b...dcb09f3b099ccea9251ffa683febe38e0b1cedaa,1,1,1,2,1,2014-06-30 12:19:18,2014-06-30 12:19:18
d23d9ee4a01a3db0fb2b843bbd7b69814a91790b...3dfad4f1addd50a066d28ca605f14d4dc9a2b82f,1,1,1,2,1,2014-06-30 04:16:44,2014-06-30 04:16:44
d23d9ee4a01a3db0fb2b843bbd7b69814a91790b...48e35cb83010915aafaa8ee1fe7e9b5eb54045d8,2,4,4,8,4,2014-06-30 04:08:42,2014-06-30 04:08:27
42fbcfdaef67970dae200d06957b1eb90fd84921...d88a837fead7a7d8f87827f1b2418b2156e51398,1,5,5,10,1,2014-07-09 07:22:43,2014-07-08 16:49:57
d88a837fead7a7d8f87827f1b2418b2156e51398...643effe382bb12b4ff1460e9e1987948b1763990,12,13,19,32,14,2014-07-09 07:24:39,2014-07-09 07:24:39
87ce3710188e4ffd1d2bdcfd4da136e284e50f62...80ca65915470c190a049efe327f96b6f1ba6f6bb,1,1,1,2,1,2014-07-31 20:15:27,2014-07-31 20:15:27
80ca65915470c190a049efe327f96b6f1ba6f6bb...460294ff77b8b8525d63d9043fe1ffa690950956,1,1,1,2,1,2014-07-31 20:16:04,2014-07-31 20:16:04
460294ff77b8b8525d63d9043fe1ffa690950956...553c5d6f86ddd022fd16d099729bd2291ac06ff4,1,668,248,916,91,2014-07-31 21:14:24,2014-07-31 21:14:03
11cf54f9df61738d15078cf6eba25a9a26f584be...43d21b97f24b0f6a593878ae4355413ce5b38884,1,6,0,6,1,2014-06-19 02:14:26,2014-06-19 02:14:26
43d21b97f24b0f6a593878ae4355413ce5b38884...508d9f0d65ca215dfdfca6aa8cdd877f8dfebd11,1,1,1,2,1,2014-06-19 02:18:02,2014-06-19 02:18:02
11cf54f9df61738d15078cf6eba25a9a26f584be...20b6ae63577d2d5101a1b27cb87f44cd113d0b6f,1,3,1,4,1,2014-06-19 01:47:32,2014-06-19 01:47:32
02642350f807c1431e686f03a97c0067fc0a2b51...74982cf101a8ca8e15c04e4f873d6b56e02c6c7c,12,48,11,59,18,2014-06-19 05:23:31,2014-06-19 05:23:25
d4eb5552b369e42026807edf469242df4ebd78ab...99f176e7ec678b4c9ea4fc973135d39a4553feab,11,45,33,78,25,2014-06-19 05:35:05,2014-06-19 05:35:05
99f176e7ec678b4c9ea4fc973135d39a4553feab...a012ba465dcc54fbf91aca61bb87cbba68eec1d4,1,1,1,2,1,2014-06-19 06:21:44,2014-06-19 06:21:44
4dcdc08d89fa029c22fd7b51c61394f2c3405edc...719ebd8239d3145c468d927971daf16802624968,3,32,13,45,5,2014-06-26 09:49:21,2014-06-26 09:49:21
e033c5be299b02d8c6d0afc2eb5dfef09bb30a0b...32bde78e1996a92e6b801e1f4a475d5ab48685f8,1,5,5,10,5,2014-06-23 17:41:45,2014-06-23 17:41:45
bc895a4b43ecfd2ad8c3793fdd6d8bada9d93186...c2c19a4d2d45d8ccb5c84d293dea35a94148c9a4,17,1491,1563,3054,480,2014-06-23 18:11:59,2014-06-23 18:07:18
1abc308399819b44b0cc1dad996edd429e6cf6bf...d5558621b22ef10abb43646b59c9823cad852e68,1,5,0,5,1,2014-02-03 10:04:21,2014-02-03 10:04:17
1abc308399819b44b0cc1dad996edd429e6cf6bf...69af98e6bb74b0bbc3b3964340f5952d83ae5130,1,5,0,5,1,2014-02-03 09:57:45,2014-02-03 09:57:45
9ba49426e972391bc4cbd42896baeb18b88ebd69...9f668a557336f271f3c1bf701cc6a472e59aeedf,15,72,68,140,94,2014-02-04 08:39:02,2014-01-31 12:20:33
9f668a557336f271f3c1bf701cc6a472e59aeedf...3ab2324df074cd21157d9e5e5ef57d0dd1fb9168,1,1,1,2,1,2014-02-04 08:39:02,2014-01-31 22:05:05
1387784d601de3e4cb500859c8db40a9e21ef2d8...ef3c560a06cce3b48a40f111d8bd8dd4bc2b2f9d,2,7,1,8,2,2014-02-04 10:04:23,2014-02-04 10:04:23
2c6b099f91e8b325ff49e690b0718de726ac410b...7b9c0a38a7270ca60429f10af083e59c928d0035,2,85,230,315,37,2014-01-31 07:32:55,2014-01-31 07:26:11
9f36bc2bf6a24e4e887e5f955936a5e5b0400f76...58bf3f9432e81a450b241134f2e0c319de41146d,7,7,7,14,7,2014-01-31 21:40:32,2014-01-31 21:40:32
c3ea955661568b9b05075e62c0b5d2e8bf7ef10c...af871d57c9eeb4ce1cdafd63c983bf706a89bec0,2,31,26,57,12,2012-09-23 05:16:12,2012-09-23 05:16:12
af871d57c9eeb4ce1cdafd63c983bf706a89bec0...a4bf6ef0a0ace19e2e939c0484095e8d45527548,1,1,1,2,1,2012-09-23 22:16:13,2012-09-23 22:16:13
a4bf6ef0a0ace19e2e939c0484095e8d45527548...f4d3d7da2e3ddbd751e053729935df1f3dd4c051,5,75,0,75,5,2012-09-23 23:06:28,2012-09-23 23:06:28
ebf94c53a5497ff6d2aa353027d3a2ac3b67b18a...003fcccceb869ac0420d542bac9860f5f32e68a1,5,6,5,11,6,2012-09-25 06:15:36,2012-09-25 06:15:36
afd931262cfa1ba377eaa9f9174de1f5779f5445...beb0b640967e69e50d1f813a99e8998e27787fdb,2,13,2,15,4,2012-08-31 21:02:18,2012-08-31 21:02:18
beb0b640967e69e50d1f813a99e8998e27787fdb...0f85e8b7f820a83559870ce0c00d5ea884475fdc,2,25,25,50,25,2012-09-01 05:37:46,2012-09-01 05:37:46
0f85e8b7f820a83559870ce0c00d5ea884475fdc...00d6f26270485cde0fb8474b76396eb81cd97eff,2,42,42,84,12,2012-09-01 06:12:02,2012-09-01 06:12:02
00d6f26270485cde0fb8474b76396eb81cd97eff...b1bdca0fdb1e14ede6904fe652746811d0e4c274,2,2,2,4,2,2012-09-01 06:25:58,2012-09-01 06:25:58
b1bdca0fdb1e14ede6904fe652746811d0e4c274...e8c5b3c9a518c58d16558a711dcd4843b26548de,2,2,2,4,2,2012-09-01 06:51:48,2012-09-01 06:51:48
e8c5b3c9a518c58d16558a711dcd4843b26548de...02f6bd65f5cd44b41e49d23ed7e6a068a04805a6,2,2,2,4,2,2012-09-01 19:00:13,2012-09-01 19:00:13
02f6bd65f5cd44b41e49d23ed7e6a068a04805a6...209852c805be35a8a59a1c71cf46e9048d1363d3,2,60,0,60,2,2012-09-01 19:03:55,2012-09-01 19:03:55
209852c805be35a8a59a1c71cf46e9048d1363d3...37379048599c1ce93aa2f36df46afbc09cb6d19b,2,2,2,4,2,2012-09-02 20:25:03,2012-09-02 20:25:03
37379048599c1ce93aa2f36df46afbc09cb6d19b...69d4c3f9a13df95267deccce9a20c5f822893155,1,0,4,4,1,2012-09-03 03:54:41,2012-09-03 03:54:41
69d4c3f9a13df95267deccce9a20c5f822893155...9d5f9eca85b9d413b4389b744bbf57c20c447c2b,4,68,4,72,9,2012-09-03 07:47:48,2012-09-03 07:47:48
3b67ece2d10aaf573ffb93fc804dc4e382a50837...1b7a3ca416e51414e8dc3f395f2f58d8ceb4bb15,1,5,4,9,1,2012-08-27 23:10:20,2012-08-27 23:10:20
1b7a3ca416e51414e8dc3f395f2f58d8ceb4bb15...96a1797af123e73ba05cc1b6ce5aa8ef0ef17694,1,1,4,5,1,2012-08-27 23:13:11,2012-08-27 23:13:11
96a1797af123e73ba05cc1b6ce5aa8ef0ef17694...67eae2a5038d5203220450c2a22ea559ab52d897,2,2,6,8,2,2012-08-27 23:13:37,2012-08-27 23:13:37
67eae2a5038d5203220450c2a22ea559ab52d897...2719ac3e9bec37813e1fd69e2ab69c9a015be647,6,11,11,22,11,2012-08-27 23:14:00,2012-08-27 23:14:00
3b67ece2d10aaf573ffb93fc804dc4e382a50837...303a33f15c9cc61fe7fa0e8c998d79c8105f0f5f,2,2,2,4,2,2012-08-27 22:48:54,2012-08-27 22:48:54
1973c64342758fdf5b6096a6e3e6efaa6b59756e...8d00fe4c03bbb7ac45dbba06dc167bb713079fd3,1,0,1,1,1,2012-08-21 21:43:13,2012-08-21 21:43:13
8d00fe4c03bbb7ac45dbba06dc167bb713079fd3...5d41742f170ad2722df34dcb337b83ade15d12cb,3,10,10,20,8,2012-08-21 21:53:34,2012-08-21 21:53:23
6905dbe98deb02ca53d23242e1bd914c3e325eb1...060e216712b023f637ad94b512c4cc90794cf065,2,8,0,8,2,2012-08-01 16:18:00,2012-08-01 16:18:00
060e216712b023f637ad94b512c4cc90794cf065...fab1a80dcb944f32fd9655d6bde3511d5df52aa2,2,2,2,4,2,2012-08-01 18:35:31,2012-08-01 18:35:31
fab1a80dcb944f32fd9655d6bde3511d5df52aa2...5637c6fb7031ed045902a4f74bbb164978b7dd38,1,11,3,14,2,2012-08-01 18:52:48,2012-08-01 18:52:48
5637c6fb7031ed045902a4f74bbb164978b7dd38...735001cb266def8185367ae9d48207e46f6e023f,4,39,39,78,39,2012-08-01 18:53:00,2012-08-01 18:53:00
735001cb266def8185367ae9d48207e46f6e023f...e8fd7e6c96d44f21422b65620ceacb084282745a,1,6,2,8,2,2012-08-01 23:15:21,2012-08-01 23:15:21
e8fd7e6c96d44f21422b65620ceacb084282745a...7aaf1413718140d0f27876f3c210a08f52d41cd6,2,2,2,4,2,2012-08-01 23:57:27,2012-08-01 23:57:27
7aaf1413718140d0f27876f3c210a08f52d41cd6...b979cd9e67968526a5918f2bdedc66bf274c96d1,2,4,4,8,2,2012-08-02 00:01:29,2012-08-02 00:01:29
b979cd9e67968526a5918f2bdedc66bf274c96d1...fbc053692de67f5b18ce6d95b0bea86aaa3b2fce,12,857,0,857,12,2012-08-02 01:06:02,2012-08-02 01:06:02
fbc053692de67f5b18ce6d95b0bea86aaa3b2fce...fe93b926b4712ea0d59f572f61b3eebd881ecb57,2,124,0,124,2,2012-08-02 01:08:31,2012-08-02 01:08:31
fe93b926b4712ea0d59f572f61b3eebd881ecb57...c2e899f2a014e18f9cf981ea89a20e18a5c9fefb,20,457,1061,1518,69,2012-08-02 02:00:25,2012-08-02 02:00:25
e9f374f04175820d254cfbcf619908e6ac1493ed...b05fc00d591d0d24f72cde6fc656fd021a52c82c,1,1,1,2,1,2012-07-23 19:51:36,2012-07-23 19:51:36
b05fc00d591d0d24f72cde6fc656fd021a52c82c...5b8838aeace0bf725438be84a7396d988749d62c,3,8,10,18,9,2012-07-23 19:51:48,2012-07-23 19:51:48
5b8838aeace0bf725438be84a7396d988749d62c...0dda2c4659c6e0407b5b9fda6618ab5c8c12a897,15,9268,9208,18476,942,2012-07-24 05:36:08,2012-07-24 05:36:08
8281a9023a9a687be007de85f1731d131eedaf30...fae6c36874b102408b53c6e5d980b247a9779dea,7,42,7,49,13,2012-07-22 21:50:52,2012-07-22 21:50:52
6a663081a78b2810e7b3904949cfc5a91df81eff...39f8996d6a34ac2fab1bdf47db65fd9bde891308,4,57,9,66,19,2012-07-18 05:26:53,2012-07-18 05:26:53
6a663081a78b2810e7b3904949cfc5a91df81eff...51c9fa1697d5df631fe37f1147d9265e89e5f4f6,2,12,6,18,10,2012-07-18 05:19:02,2012-07-18 05:19:02
646c87c15185ccad652541523b5774a0148fe9c4...dbea3e27849bc2e2aa5315e02e026872b913691f,1,3,3,6,3,2012-07-09 07:53:56,2012-07-09 07:53:56
a0cd886c56708bbd8d6896ee81b04579f86fb0aa...7ed02b461be8f520f672284f9984fdc9ce4487e7,3,4,3,7,3,2012-06-12 03:20:51,2012-06-12 03:20:51
7ed02b461be8f520f672284f9984fdc9ce4487e7...5dd47f11967f25aa8f5fe4ad25db807c5b33ccca,3,84,99,183,26,2012-06-12 03:33:00,2012-06-12 03:33:00
5dd47f11967f25aa8f5fe4ad25db807c5b33ccca...f453909f390f88664cc590fe3f1fa3c0df041200,5,463,221,684,121,2012-06-12 04:48:41,2012-06-12 04:48:41
176e0b11697565e8652ba6ed9f5fd09fe6318255...091a97c01c0dd9e725e42c6a1a6a19a74054d587,1,1,1,2,1,2012-04-23 10:06:30,2012-04-23 10:06:30
de9271bfd1113c8c6ca6cbcc2d56b77fd2763b77...1160935446e06339d8c7e09415d57086746fbce5,3,16,7,23,8,2012-04-19 23:38:43,2012-04-19 23:38:43
1160935446e06339d8c7e09415d57086746fbce5...03f78f7a60a631c01c1fb085b01d98bee61d7bb6,7,117,2,119,9,2012-04-20 00:34:07,2012-04-20 00:34:07
03f78f7a60a631c01c1fb085b01d98bee61d7bb6...f84882122ef98500af143ddaaf055262cfbdf0c3,2,66,68,134,9,2012-04-20 00:40:58,2012-04-20 00:40:58
78652a707f8ae2d98b1cd434b4bca546d2948236...43c8f41895cded171185f4f7ddac9d917f9912d2,2,10,10,20,10,2012-01-26 22:40:09,2012-01-26 22:40:09
43c8f41895cded171185f4f7ddac9d917f9912d2...8a6be6601dfb826e32a5004b7b0f09756ebb975b,5,25,10,35,16,2012-01-26 22:40:19,2012-01-26 22:40:19
8a6be6601dfb826e32a5004b7b0f09756ebb975b...7a6737512a18f56bb95a0024fdbd4a8823034b76,6,148,144,292,12,2012-01-26 22:50:55,2012-01-26 22:50:55
7a6737512a18f56bb95a0024fdbd4a8823034b76...f82db4b95bf12bc6c04a5ecc3d4a649ba9800db0,6,55,52,107,10,2012-01-26 22:53:35,2012-01-26 22:53:35
f82db4b95bf12bc6c04a5ecc3d4a649ba9800db0...945870d7785fcda985241582e15c53fab5ae6f64,2,2,2,4,2,2012-01-26 22:54:24,2012-01-26 22:54:24
78652a707f8ae2d98b1cd434b4bca546d2948236...2aa99d17d52cffe7fd4a1aad18a46cfc2ba91185,1,3,0,3,1,2012-01-26 22:36:30,2012-01-26 22:36:30
78652a707f8ae2d98b1cd434b4bca546d2948236...1f04481092f6021c721f48465b57f7a829f186f5,1,2,2,4,2,2012-01-26 22:07:06,2012-01-26 22:07:06
2d67c3408465f44be7336abc6a00af870d2c18f8...d8e1001836f869436df2de2905411b2236c8cbad,3,7,7,14,7,2012-01-26 23:39:37,2012-01-26 23:39:37
4fc8da4afdf7b53ac1327caa8a4073430913badf...dcd86a8a914f88bfa6369833e637c2030bb66aef,3,3,3,6,3,2014-11-19 19:01:04,2014-11-19 19:01:04
012af29efc30cce902318187d367fdc1e007cf9e...be2206edfc7b7ca47aff0a6b772f87c5ee6f6f51,2,2,2,4,2,2015-02-03 20:49:03,2015-02-03 19:38:02
03e41b355c51474ebac21ba22f4626f05feba844...37fbe1cf6294d08a13044460df6dc36de7110473,1,1,1,2,1,2015-01-27 11:51:55,2015-01-27 11:51:55
0b10c6b060a4d2af90ae96f1551abcd288e8466c...9596a51f543565b523b5e360b947d9cff4a83ce4,1,20,0,20,2,2015-02-19 20:53:00,2015-02-19 20:52:37
3efa9c46a40e49109e7a14d58ee7f8b170a3d17b...744c3646f5ae667aadf15d39a465aae00e05ebec,1,2,2,4,2,2015-02-19 21:38:03,2015-02-09 15:45:22
3efa9c46a40e49109e7a14d58ee7f8b170a3d17b...894ec6f71419a0a7028e49a655623934f03ba24c,1,1,4,5,1,2015-02-09 18:55:37,2015-02-09 15:09:44
24aad4fe3a9c3c607e52d5cd8de5b72527bca70b...fbc220defdd80e7471592262495869f0f52b02b9,2,24,16,40,11,2015-01-19 17:20:13,2015-01-19 17:13:43
4484700d10fca0e3ccaa9fe6727f49575797f305...b282e8a01fed462923de26f4568933611aa4e983,1,1,1,2,1,2014-12-29 02:53:55,2014-12-29 02:53:55
b282e8a01fed462923de26f4568933611aa4e983...109e4c7c163465c80ba3d2996322ebce7c9f77c2,1,28,104,132,11,2014-12-29 02:55:50,2014-12-29 02:55:50
266560585672413ab80a337bcd3a09a4186e1a63...46b0e94e25f7e488be1d4bd09e4f60c48df586f6,2,4,8,12,5,2014-12-11 06:14:07,2014-11-13 16:27:41
46b0e94e25f7e488be1d4bd09e4f60c48df586f6...aa1e3e7325b2141200d0866ea8f0153bca57f616,1,10,10,20,10,2014-12-11 06:14:07,2014-11-13 17:28:14
aa1e3e7325b2141200d0866ea8f0153bca57f616...4e27c48248a9846f8c89186c80915feac3388399,9,338,337,675,173,2014-12-11 06:24:31,2014-12-11 06:19:59
4e27c48248a9846f8c89186c80915feac3388399...cb4c3a0eae9114af42c3be9a5bca134431e3260f,1,1,1,2,1,2014-12-11 19:45:33,2014-12-11 19:45:33
ed8a64c5d827f404c6b5610c95ae625218be5a4b...b9527acc4539d112514dc4a539ac0f228966ba1e,1,1,1,2,1,2014-06-26 20:01:21,2014-06-26 20:01:15
a13f645d20758ff18d3bcf1141c03606aee2ce78...225351431eeb19178bf2679ee9e0936790a5c765,9,66,122,188,32,2014-06-30 15:35:50,2014-06-30 15:35:17
8deab3a95d24afa795c428572b7bfadbc7fb9ac5...a013c112c41e096a881de67cae76fbaeb88947ee,2,12,12,24,7,2014-07-01 04:32:50,2014-07-01 04:24:14
8deab3a95d24afa795c428572b7bfadbc7fb9ac5...91f329e4488c667c04ea0f3ccc8dc11aaa7124ef,2,40,2,42,3,2014-07-01 03:50:31,2014-07-01 03:50:31
8deab3a95d24afa795c428572b7bfadbc7fb9ac5...121bf6633e8704df0d69a1e44a6fbbc2dbe6f8d2,2,3,3,6,3,2014-07-01 00:53:57,2014-06-18 22:50:25
456bd67da84fcdcdffa7f2124673812db0552ba8...a14f6222a699f8dc4d4557f27c188ee51e35aca1,1,6,0,6,1,2014-07-04 00:17:18,2014-07-04 00:17:18
456bd67da84fcdcdffa7f2124673812db0552ba8...6b46d4d8c1f19bac7405518cb09bc11dbe7e40b7,1,4,0,4,2,2014-07-03 20:05:48,2014-07-03 20:05:48
6b46d4d8c1f19bac7405518cb09bc11dbe7e40b7...d9f356f05f2993896e9648c8c2f3d319448a011c,1,4,0,4,2,2014-07-03 20:06:54,2014-07-03 20:06:54
d9f356f05f2993896e9648c8c2f3d319448a011c...b793fbb13a8f0cb0fab04de8f7fe732b445e6daf,4,10,5,15,6,2014-07-03 20:12:58,2014-07-03 20:12:58
b793fbb13a8f0cb0fab04de8f7fe732b445e6daf...92fd25a2a29dbef6b47ba932e9ba836150b93eeb,4,7,3,10,5,2014-07-03 20:18:44,2014-07-03 20:18:44
92fd25a2a29dbef6b47ba932e9ba836150b93eeb...1dc54dc160d4352d894550c7c5d3f68c475ba2cf,9,14,7,21,6,2014-07-03 20:40:47,2014-07-03 20:28:30
643effe382bb12b4ff1460e9e1987948b1763990...9b90b8709956ed87543ec3679a81b7448c0bf20e,1,203,203,406,8,2014-07-17 05:22:42,2014-07-07 05:12:26
643effe382bb12b4ff1460e9e1987948b1763990...503ec4e5db855eca993304ee05bd4acadf2f03e0,2,91,53,144,31,2014-07-10 06:58:23,2014-07-10 06:52:11
503ec4e5db855eca993304ee05bd4acadf2f03e0...e598247bcc1cb231b84a00cf41252c7587eeae32,1,3,3,6,1,2014-07-10 07:02:41,2014-07-10 07:02:41
e598247bcc1cb231b84a00cf41252c7587eeae32...94472ee74ac6732a3abd0d32ad5c3a68370090c0,6,8,8,16,6,2014-07-10 07:03:24,2014-07-10 07:03:24
643effe382bb12b4ff1460e9e1987948b1763990...c298fb1a8839b722596253c30049bc971d47b87f,1,1,0,1,1,2014-07-09 23:21:45,2014-07-09 23:21:45
232b61a3ce36831d6167c7e2637d2e4162a9a5a4...1625102671e9b244efb57be1317fa7ce6ca7b5b9,2,0,2,2,2,2014-08-01 16:45:11,2014-08-01 16:45:11
1625102671e9b244efb57be1317fa7ce6ca7b5b9...de1d8c36ada0a36691c1c9120755455f3bbcd2ea,7,27,13,40,12,2014-08-01 16:49:54,2014-08-01 16:49:54
e93bf15f6076b109fb10cfad9d513d55b6f1b796...d222c21f842812088060be725d24213c7202c35f,5,9,4,13,5,2014-06-19 05:24:56,2014-06-19 05:24:56
f685f2a670b03e8eb1c1eabf6a5adb69b34a7cd5...ae793ad749ec0f39219dc7fb58fafd81d742cd74,3,4,4,8,4,2014-06-19 09:09:35,2014-06-19 09:09:35
f685f2a670b03e8eb1c1eabf6a5adb69b34a7cd5...162a27f67a988c37a55d476899e62b99cde8c969,3,3,3,6,3,2014-06-19 06:50:16,2014-06-19 06:50:16
162a27f67a988c37a55d476899e62b99cde8c969...bd541083f14f8293bc327255c17da4f376443d02,3,0,172,172,3,2014-06-19 09:02:23,2014-06-19 09:02:23
bd541083f14f8293bc327255c17da4f376443d02...0418c7678de442c06cd7b530482151d02e06ee63,2,9,9,18,2,2014-06-19 09:03:10,2014-06-19 08:59:31
32bde78e1996a92e6b801e1f4a475d5ab48685f8...e40df7cfacef0b581810c8ec661923054541638c,6,7,7,14,7,2014-06-25 23:56:36,2014-06-25 23:56:36
d8bb6c29870059d7d785ddb3340964f1bba72ed6...e958008048dbd359cec0cc16f23d69881107203b,1,1,1,2,1,2014-02-03 10:11:25,2014-02-03 10:11:25
ef3c560a06cce3b48a40f111d8bd8dd4bc2b2f9d...46f9d27142ed81cfbcc0dc7806829756357a7505,5,4,4,8,1,2014-02-04 21:18:54,2014-02-04 21:18:54
ef3c560a06cce3b48a40f111d8bd8dd4bc2b2f9d...40e1a3bd9fca8fa46c45ff8f1095d631b6e92f5f,4,64,84,148,16,2014-02-04 12:56:42,2014-02-04 12:56:42
40d3cf6cd7b28be2eb95c3f43fa9e5d493ecafce...4b194471b0352fa583e074c4394c1fd5085cf832,1,2,2,4,2,2014-01-31 18:32:32,2014-01-31 18:32:32
40d3cf6cd7b28be2eb95c3f43fa9e5d493ecafce...623d6507581c881f4ade642536858053d5323b09,1,1,1,2,1,2014-01-31 17:50:47,2014-01-31 17:50:45
362708acdd1f75bf5ccbcd98dfbb5e005297921b...d6f25e13ec4389fcb94ef16cd13eacf4d5aa173b,2,11,12,23,5,2014-02-01 08:26:46,2014-02-01 08:26:46
362708acdd1f75bf5ccbcd98dfbb5e005297921b...813467ddaf9d007a2a14273db80435faba401222,1,0,5,5,1,2014-02-01 08:11:23,2014-02-01 08:11:23
f4d3d7da2e3ddbd751e053729935df1f3dd4c051...498a28b4cd7ecfd5c02a7cb21f1d3a81e3e2d404,1,0,0,0,0,2012-09-26 23:01:45,2012-09-26 23:01:45
bda3d57a001a4cbaf54718a9c4b9c4dbd54bef09...4a2443901fc507b226b49dfe3a3ee9fa35bc2156,2,5,5,10,5,2012-09-25 06:19:33,2012-09-25 06:19:33
4a2443901fc507b226b49dfe3a3ee9fa35bc2156...88b1e44dd61afd8f08761346555521bd216ed73a,8,10,49,59,18,2012-09-25 06:28:38,2012-09-25 06:28:38
88b1e44dd61afd8f08761346555521bd216ed73a...aec8b089307d6bc8787aceb7001313e3751048c1,2,8,8,16,6,2012-09-25 06:32:55,2012-09-25 06:32:55
aec8b089307d6bc8787aceb7001313e3751048c1...0540b63ab0a2f9359fbd34967fbb74402534573f,4,10,4,14,4,2012-09-25 06:59:02,2012-09-25 06:59:02
f46813a8c8f275e2dd7102331de9873e1a029b27...f25129361be813af4c399da8e3041a43ccd2a943,1,1,0,1,1,2012-09-03 08:04:53,2012-09-03 08:04:53
f25129361be813af4c399da8e3041a43ccd2a943...8cda830eaf568be8204a96ca635c0bed373028ff,2,2,0,2,2,2012-09-03 08:13:42,2012-09-03 08:13:42
8cda830eaf568be8204a96ca635c0bed373028ff...acf2a64016a94c2017ab8aa0ec694835ee1ea42c,2,42,2,44,3,2012-09-04 00:35:35,2012-09-04 00:35:35
acf2a64016a94c2017ab8aa0ec694835ee1ea42c...1f0043a7f5285018a79e464503a60e0e3215aba9,2,6,4,10,2,2012-09-04 16:13:09,2012-09-04 16:13:09
1f0043a7f5285018a79e464503a60e0e3215aba9...de36456f5d3498320fae6e2ad106a9a7f38910cc,2,2,2,4,2,2012-09-04 18:00:25,2012-09-04 18:00:25
de36456f5d3498320fae6e2ad106a9a7f38910cc...a1d2ee654209305f20a621c4956417463d4cb00f,1,1,1,2,1,2012-09-04 18:08:08,2012-09-04 18:08:08
a1d2ee654209305f20a621c4956417463d4cb00f...bf590d8c810b1edde93ed3f14cafc6f4a3b70e74,2,2,2,4,2,2012-09-04 18:13:08,2012-09-04 18:13:08
bf590d8c810b1edde93ed3f14cafc6f4a3b70e74...73ef263d5fe39f1b22158e5945707f5183c78099,1,4,1,5,4,2012-09-04 18:31:48,2012-09-04 18:31:48
73ef263d5fe39f1b22158e5945707f5183c78099...7e4629fbbec63bda9986023dd29879d2565e570e,2,2,2,4,2,2012-09-04 21:27:48,2012-09-04 21:27:48
303a33f15c9cc61fe7fa0e8c998d79c8105f0f5f...17d8c78e520c3207765d4c077336a589cf64a698,1,1,1,2,1,2012-08-28 03:32:42,2012-08-28 03:32:42
17d8c78e520c3207765d4c077336a589cf64a698...1eaf1cf418c4b3595898346aeb32e0a1e5b31ea1,2,38,5,43,7,2012-08-28 04:06:21,2012-08-28 04:06:21
303a33f15c9cc61fe7fa0e8c998d79c8105f0f5f...b5a8c0a45e6bbc5c80cef65ec5848632af1a823b,1,7,7,14,3,2012-08-28 02:54:07,2012-08-28 02:54:07
5d41742f170ad2722df34dcb337b83ade15d12cb...115c7b82c4408519915f356833d44bc19025094b,2,2,2,4,2,2012-08-22 16:45:57,2012-08-22 16:45:57
115c7b82c4408519915f356833d44bc19025094b...5f97e04aa3a8257f4ae961ad4b095c1312cae7c6,2,2,2,4,2,2012-08-22 16:47:56,2012-08-22 16:46:07
5f97e04aa3a8257f4ae961ad4b095c1312cae7c6...6160667b1937115f799be5e8d5a5597b72f325e6,2,2,2,4,2,2012-08-22 16:48:57,2012-08-22 16:48:57
6160667b1937115f799be5e8d5a5597b72f325e6...535dfc21536f5766365047f0af532d8523c2affd,2,2,2,4,2,2012-08-22 16:51:41,2012-08-22 16:51:41
535dfc21536f5766365047f0af532d8523c2affd...582b178723ee9b1f757bbed433ac83809f7aff03,1,1,1,2,1,2012-08-22 17:44:41,2012-08-22 17:44:41
582b178723ee9b1f757bbed433ac83809f7aff03...5da217b96e28bcd4de6779fefe7f8b145aa4d01b,2,4,4,8,4,2012-08-23 03:23:58,2012-08-23 03:23:58
5da217b96e28bcd4de6779fefe7f8b145aa4d01b...4775bc910cbf01a455e4be3f40efb23410113e20,2,12,6,18,6,2012-08-23 03:28:08,2012-08-23 03:28:08
4775bc910cbf01a455e4be3f40efb23410113e20...ac4420237c166538e34768b7cdc64a38470ad493,2,9,2,11,4,2012-08-23 03:32:47,2012-08-23 03:32:47
ac4420237c166538e34768b7cdc64a38470ad493...3424df22ee9dd9b93c0af6237debd4e19e2110a6,14,0,981,981,14,2012-08-23 15:30:27,2012-08-23 15:30:27
5d41742f170ad2722df34dcb337b83ade15d12cb...361889def92af209c8d3315c4d1152fb9fc4bc36,4,33,2,35,8,2012-08-22 09:20:31,2012-08-22 09:20:31
361889def92af209c8d3315c4d1152fb9fc4bc36...a9764c34a7ece4213d50a8e0714ebd001daac529,4,59,2,61,6,2012-08-22 09:24:02,2012-08-22 09:24:02
c2e899f2a014e18f9cf981ea89a20e18a5c9fefb...6977d35eedd8a0b25b7b18eae67c3299eb18badd,6,63,33,96,29,2012-08-02 03:11:16,2012-08-02 03:11:16
c2e899f2a014e18f9cf981ea89a20e18a5c9fefb...72323051c31810138fdff4156a88ee863f4f8001,3,3,7,10,4,2012-08-02 02:18:42,2012-08-02 02:18:42
72323051c31810138fdff4156a88ee863f4f8001...3c742fc08bd1714bf9145cebac8e7f653e83c05d,2,18,0,18,2,2012-08-02 02:25:50,2012-08-02 02:25:50
3c742fc08bd1714bf9145cebac8e7f653e83c05d...1bb7c0e669bfa431b190ed3b283be93f27cf0eae,2,12,0,12,2,2012-08-02 02:33:37,2012-08-02 02:33:37
1bb7c0e669bfa431b190ed3b283be93f27cf0eae...225d0e0af36ef7aed818fb124c7ec13fbb52be5d,1,1,0,1,1,2012-08-02 02:36:28,2012-08-02 02:36:28
f085dbadd18208386649717f4f1bcba62d6119de...6245886b269cdba7e8006ebf59165d7558492ec3,1,10,7,17,6,2012-07-24 06:54:26,2012-07-24 06:54:26
6245886b269cdba7e8006ebf59165d7558492ec3...cd441e082f25836be85ecc14f0bed4d8e74965b2,2,14,8,22,4,2012-07-24 06:56:13,2012-07-24 06:56:13
fa1e1e34dfd9e8501ffdbb92a282ff5550685f3c...dcf75697ecd243517b23d8ef440f772d91f699c0,39,503,221,724,101,2012-07-23 01:28:39,2012-07-23 01:28:39
39f8996d6a34ac2fab1bdf47db65fd9bde891308...326b665065d8a1901cf53c145b98cbbdbdae6057,2,2,2,4,2,2012-07-18 05:40:38,2012-07-18 05:40:38
dbea3e27849bc2e2aa5315e02e026872b913691f...83846ba0d629a3882e727ccc7b64684507206cce,3,52,17,69,14,2012-07-10 06:12:16,2012-07-10 06:12:16
dbea3e27849bc2e2aa5315e02e026872b913691f...93be608bf0a4b85ec3331ebcc14e40f99a1974f2,6,129,21,150,32,2012-07-10 03:49:17,2012-07-10 03:49:17
93be608bf0a4b85ec3331ebcc14e40f99a1974f2...413c05a09d42d59df75267a14bd6019b0f6bf1cc,2,6,6,12,2,2012-07-10 03:55:11,2012-07-10 03:55:11
413c05a09d42d59df75267a14bd6019b0f6bf1cc...f495a8d0cc48d1440198e784a8f336a82e3a48bd,3,10,8,18,8,2012-07-10 04:01:29,2012-07-10 04:01:29
f495a8d0cc48d1440198e784a8f336a82e3a48bd...148e5a3d899d5c2d395e2d5749b755efeef2cd38,2,7,0,7,3,2012-07-10 04:07:49,2012-07-10 04:07:49
148e5a3d899d5c2d395e2d5749b755efeef2cd38...f4877c236968ba61ac76f4862bba49e0354c60e5,6,11,12,23,10,2012-07-10 04:13:33,2012-07-10 04:13:33
f4877c236968ba61ac76f4862bba49e0354c60e5...64e87a85f5e17e3cf603b97e21d58b077060e7b2,8,261,249,510,29,2012-07-10 05:14:30,2012-07-10 05:14:30
64e87a85f5e17e3cf603b97e21d58b077060e7b2...6f8226a393537ce349ce7d211539bb6f699afa8d,2,166,142,308,26,2012-07-10 05:25:00,2012-07-10 05:25:00
6f8226a393537ce349ce7d211539bb6f699afa8d...c74dddd02ea3809fe25af2036ae1981a6d0b2158,4,2384,2411,4795,206,2012-07-10 05:29:53,2012-07-10 05:29:53
c74dddd02ea3809fe25af2036ae1981a6d0b2158...3ea309568f77dbe72f35b682041537c8d467664f,2,2229,2242,4471,200,2012-07-10 05:34:33,2012-07-10 05:34:33
3ea309568f77dbe72f35b682041537c8d467664f...0ca210395c0e4c3337312a81c22b81bbd5d1a2be,2,759,772,1531,68,2012-07-10 05:36:12,2012-07-10 05:36:12
0ca210395c0e4c3337312a81c22b81bbd5d1a2be...75d952ffd80c3c3e18b2e47eac30a2b23d8ae7a7,2,2703,2751,5454,308,2012-07-10 05:40:58,2012-07-10 05:40:58
75d952ffd80c3c3e18b2e47eac30a2b23d8ae7a7...5d8e78e0faedb4365216f1ebbc5d70dc560f3f6e,4,116,24,140,25,2012-07-10 07:32:30,2012-07-10 07:32:04
5d8e78e0faedb4365216f1ebbc5d70dc560f3f6e...a750551feee3a70005327fb1ec9318629c4f1f29,2,5,3,8,4,2012-07-10 07:36:21,2012-07-10 07:36:21
a750551feee3a70005327fb1ec9318629c4f1f29...713105774fcccf1250a7555b47483b578cf82eb6,3,29,39,68,24,2012-07-10 07:45:44,2012-07-10 07:45:44
f2dadecbf39bf993efd3b82d33adcd87993e0499...b353565d4e0bf7d6a05b3295c0d8db5ca745bd1c,4,356,0,356,5,2012-06-21 03:26:50,2012-06-21 03:26:50
f453909f390f88664cc590fe3f1fa3c0df041200...bf875d9e360209503932e0ecbe5804b44961b34d,2,54,18,72,36,2012-06-12 05:19:25,2012-06-12 05:19:25
bf875d9e360209503932e0ecbe5804b44961b34d...2e6d4e9439d489dc1c45f27d626a4f5d3399e483,2,134,142,276,60,2012-06-12 05:28:10,2012-06-12 05:28:10
f453909f390f88664cc590fe3f1fa3c0df041200...c7ffe6edc894b00db16bc4386f421a3d8efadd50,10,10,10,20,10,2012-06-12 05:17:10,2012-06-12 05:17:10
091a97c01c0dd9e725e42c6a1a6a19a74054d587...419e50e33974f7741c4e6b25772f2be65aa73240,4,9,1,10,4,2012-04-23 17:06:35,2012-04-23 17:06:35
091a97c01c0dd9e725e42c6a1a6a19a74054d587...c896a182e13b0e5d12a5c2104119d7b873b22162,2,4,3,7,4,2012-04-23 10:18:13,2012-04-23 10:18:13
c896a182e13b0e5d12a5c2104119d7b873b22162...c408d8961b96f12c40aaf1d7647578cd3535bd64,3,10,15,25,5,2012-04-23 10:44:32,2012-04-23 10:44:32
c408d8961b96f12c40aaf1d7647578cd3535bd64...b8b1ffde055b9e04f658201f81cf7974d56ae0c2,1,5,4,9,5,2012-04-23 11:16:27,2012-04-23 11:16:27
945870d7785fcda985241582e15c53fab5ae6f64...5844aa550d5a2d22d527d80cfa42443914d28c1f,10,10,10,20,10,2012-01-26 23:00:59,2012-01-26 23:00:59
5a48b22b83e099faede2dfa108d5c808526e556b...6886022fe6c35d151888ae4a57e91e9e34da3f5d,2,3,3,6,3,2012-01-27 02:10:36,2012-01-27 02:10:36
d8e1001836f869436df2de2905411b2236c8cbad...d531f72645b72d648d52bd56698a80fcfff38043,3,60,53,113,10,2012-01-27 00:12:34,2012-01-27 00:12:34
d8e1001836f869436df2de2905411b2236c8cbad...b260544de02788bc921c4c713df0f754d96c5a27,11,32,32,64,12,2012-01-26 23:54:04,2012-01-26 23:54:04
d8e1001836f869436df2de2905411b2236c8cbad...ef4e3bc0f7549e327c45792884a264faab402400,6,46,21,67,9,2012-01-26 23:51:11,2012-01-26 23:51:11
dcd86a8a914f88bfa6369833e637c2030bb66aef...3cd88866c6f3e0d69dc4eae2afe9d5d65b05c093,1,2,0,2,1,2014-11-19 22:43:45,2014-11-19 22:43:45
592950cc22575ac192c983bbaab25b6db54cf5c5...ebedeaf2fed3aa7b02f5e5ba042116377b3ced1a,1,3,3,6,2,2015-01-27 19:15:55,2015-01-27 19:15:55
d0ec85081224fc48c7898f5b72b29aa98d3ddf6a...90e7fc418b0424ad01c7af6b87b43d4d1596342d,2,23,0,23,2,2015-02-19 21:11:58,2015-01-31 18:23:06
3748e44b2eba2e1a1e89bdd28f4461e1f718c5b4...89455afe97a267e7a37d5699d9f17e82630b8c04,1,1,1,2,1,2015-02-19 23:55:33,2015-02-19 23:55:33
89455afe97a267e7a37d5699d9f17e82630b8c04...e9afc74b016d638356b4174d261f7e88face09c2,1,1,1,2,1,2015-02-20 00:01:04,2015-02-20 00:01:04
e9afc74b016d638356b4174d261f7e88face09c2...504435e0b07e6c638df995959bb1f0a4a182ceca,1,96,0,96,1,2015-02-20 00:14:06,2015-02-02 15:35:21
e0f2db23d724f7ff1eb00d5e35fc4a911447a912...a3419df8293facc5b7e24811d751f818dc69042e,2,217,149,366,54,2015-02-10 06:30:51,2015-02-06 21:57:28
4fd01b7ac130dd815e7490950ed807487b684f4a...e90f98dd0ce83273db57eab164a5f25f439d1cf2,3,7,7,14,7,2015-01-19 20:26:01,2015-01-19 20:26:01
4fd01b7ac130dd815e7490950ed807487b684f4a...a8139a03921541a7b66f97a0cbbdd1f5a597bdb8,2,972,549,1521,173,2015-01-19 18:10:34,2015-01-19 17:05:24
a8139a03921541a7b66f97a0cbbdd1f5a597bdb8...b56d97f21065037523ec17f45685916df8aca678,11,226,226,452,167,2015-01-21 03:57:51,2015-01-21 03:40:50
b56d97f21065037523ec17f45685916df8aca678...df73535a2d99539f228afbdd54a387a9ad1a289c,1,1,1,2,2,2015-01-21 04:16:42,2015-01-21 04:16:42
df73535a2d99539f228afbdd54a387a9ad1a289c...1652efc3f6cba0e0b943bdf2a71f681bbd4e154f,1,7,2,9,5,2015-01-21 04:18:33,2015-01-21 04:18:33
120b1f164b6c0ac813d36bf5af0fc5eedb55d126...f5dad0fa39f93f467e771337d159b5bcae641afe,1,1,1,2,1,2014-12-29 02:59:49,2014-12-29 02:59:49
f5dad0fa39f93f467e771337d159b5bcae641afe...a4626760750b14cebb19efc7010833f05491f1ed,1,52,10,62,8,2014-12-29 03:37:16,2014-12-29 03:37:16
cb4c3a0eae9114af42c3be9a5bca134431e3260f...f0be5e0409ae2f2614dd3251cba7f55337340819,1,1,1,2,1,2014-12-12 11:53:50,2014-12-12 11:53:50
cb4c3a0eae9114af42c3be9a5bca134431e3260f...5b8ba0cb4dc68deee9ad5bb2dbbdc2718c14ea67,1,1,1,2,1,2014-12-12 09:58:21,2014-12-12 09:58:21
5b8ba0cb4dc68deee9ad5bb2dbbdc2718c14ea67...bc36e312800e72f1f76515fac8977602b66f012a,2,2,2,4,2,2014-12-12 10:07:16,2014-12-12 10:07:16
bc36e312800e72f1f76515fac8977602b66f012a...c8855a7ad120b37fd9a25125f90093478656362f,3,3,1,4,2,2014-12-12 13:22:41,2014-12-12 13:22:41
225351431eeb19178bf2679ee9e0936790a5c765...bf183e080e9dd5fda878866f0f5ac567c41568b3,1,5,3,8,1,2014-06-30 17:27:55,2014-06-30 17:27:55
a013c112c41e096a881de67cae76fbaeb88947ee...77c1a528ab48ba695f52f4f8f7b97bf7bbde05d1,1,9,4,13,2,2014-07-01 16:23:22,2014-07-01 15:15:00
77c1a528ab48ba695f52f4f8f7b97bf7bbde05d1...b4958aba69cd942271bba465d5cbc8ef4a1d0529,7,30,17,47,16,2014-07-03 05:54:56,2014-07-03 05:54:56
a013c112c41e096a881de67cae76fbaeb88947ee...2a4703459877c07345f6163de91aa5390d535d0a,4,8758,2,8760,4,2014-07-01 04:38:38,2014-07-01 04:35:33
83c9510da25ccfe3b1b3e84cc65af910645d8182...97ca848e16414ee995ed6cdce10246712e42d348,1,2,1,3,1,2014-07-05 12:51:03,2014-07-05 12:51:03
866ffc4f37def3d505a10a161720dc0ef9420dea...0fe4fe328c6916d2cac034b0da957f4452cc38d7,1,3,3,6,1,2014-07-18 21:26:14,2014-07-18 21:26:14
866ffc4f37def3d505a10a161720dc0ef9420dea...fc19cad60810684d6669ac55eaece2d96500f82a,1,12,12,24,12,2014-07-18 20:59:37,2014-07-18 20:59:37
fc19cad60810684d6669ac55eaece2d96500f82a...031cb969d7d11e3f64bea93009be3db365bfbf1b,1,2,1,3,1,2014-07-18 21:19:16,2014-07-18 21:15:47
031cb969d7d11e3f64bea93009be3db365bfbf1b...db352bcc94287bcef015752c059b31dd1d8ee4c3,1,1,1,2,1,2014-07-18 21:19:19,2014-07-18 21:01:33
866ffc4f37def3d505a10a161720dc0ef9420dea...976441ac1bad923a718d9db355153954b067f01a,1,8,0,8,2,2014-07-18 18:48:00,2014-07-18 18:48:00
866ffc4f37def3d505a10a161720dc0ef9420dea...d3dea01a11436921dac54032c83479ed1e41f6c7,1,63,5,68,8,2014-07-18 14:45:59,2014-07-02 20:53:00
d3dea01a11436921dac54032c83479ed1e41f6c7...8c0eb9b00e28dada2b4aaa3792e89099743c675f,1,45,18,63,10,2014-07-18 14:45:59,2014-04-25 03:15:38
8c0eb9b00e28dada2b4aaa3792e89099743c675f...724c4f526cd56a28bb305fe6f1f31f3091bf2cd6,1,1,1,2,1,2014-07-18 14:46:42,2014-07-18 14:46:42
724c4f526cd56a28bb305fe6f1f31f3091bf2cd6...eff9b063da87c940d627745fe218a6c5435b69c1,1,17,24,41,6,2014-07-22 05:37:04,2014-07-22 05:31:56
94472ee74ac6732a3abd0d32ad5c3a68370090c0...59171b337710293e5b6284802d2d433c0f7dd525,1,1,1,2,1,2014-07-10 23:42:09,2014-07-10 23:42:09
94472ee74ac6732a3abd0d32ad5c3a68370090c0...816c8f480a438d7a2b60d225ee0294ff442ac1ee,1,1,2,3,2,2014-07-10 17:44:46,2014-07-10 17:44:46
94472ee74ac6732a3abd0d32ad5c3a68370090c0...2fb107e918b3f2d99267d3787f94ed6f52d24b79,2,2,2,4,2,2014-07-10 17:30:21,2014-07-10 17:30:21
05ba466f6cb961ca4376958f03fdf3b10ec171ef...2962f845a5f07dea5060a7204a527eff1522d48d,8,8,6,14,8,2014-07-12 22:47:42,2014-07-12 22:47:42
2962f845a5f07dea5060a7204a527eff1522d48d...fe0ef388982399d8925ec7aa8a70c4b4df3aa7e6,8,23,5,28,8,2014-07-12 22:55:15,2014-07-12 22:55:15
de1d8c36ada0a36691c1c9120755455f3bbcd2ea...08393bf68a568a383688bf9d7ab90b824f6a5b34,1,36,0,36,1,2014-08-01 19:10:00,2014-07-31 23:03:45
5b4b4b5279d18dced7e2556f259aca6e38fb61f5...91d2cf848bc6fcd07bf2b16ce0308b0372d28b2e,1,1,1,2,1,2014-06-19 12:56:43,2014-06-19 12:56:43
e5665c241727a868c1f308632b22b0fcebba1f92...d675284cf65b0b1c30ed555f3148dd880a52da27,2,2,2,4,2,2014-02-03 10:38:18,2014-02-03 10:38:18
9cf9f6c099715538c858e64e537f8fe5c0223691...aeed64d1cb2a882b7904dc1c7cdbc41ebe814f7a,1,6,6,12,4,2014-02-04 09:14:20,2014-01-31 07:23:31
9cf9f6c099715538c858e64e537f8fe5c0223691...389e574aaacd8602aa9a4611ce8fba6c4566fa29,2,9,3,12,4,2014-02-04 09:08:12,2014-01-29 05:55:30
389e574aaacd8602aa9a4611ce8fba6c4566fa29...2576fecf95ec32f659d26e50f80c1a15c61a897b,2,2099,1303,3402,105,2014-02-04 09:08:12,2014-02-04 09:00:57
2576fecf95ec32f659d26e50f80c1a15c61a897b...ec050fa0ab6dc14b28148505318953825c947676,2,24,24,48,5,2014-02-04 09:11:40,2014-02-03 09:46:34
4b194471b0352fa583e074c4394c1fd5085cf832...1802cedbc11d9468705e9289297616f785e33a8d,5,46,46,92,46,2014-01-31 21:12:31,2014-01-31 21:12:31
4b194471b0352fa583e074c4394c1fd5085cf832...d3aad7e35505d0f06843921439f8d9f0a2f36b34,1,17,0,17,1,2014-01-31 20:17:49,2014-01-31 20:17:49
d3aad7e35505d0f06843921439f8d9f0a2f36b34...d1a7271ea1272e0f9775d49e6a84ee49819e0094,1,8,0,8,1,2014-01-31 20:25:09,2014-01-31 20:25:09
24e277b85abace0f77076b1cfa96e11b1d1dc891...8ecffcb32fc0d3a423f87fac9e613498b5104fe7,2,4,4,8,4,2012-09-28 17:39:15,2012-09-28 17:39:15
8ecffcb32fc0d3a423f87fac9e613498b5104fe7...f8374a754d2ffe153ab14cb1315365c1303c6bbe,2,4,4,8,4,2012-09-28 22:01:12,2012-09-28 22:01:12
24e277b85abace0f77076b1cfa96e11b1d1dc891...ecbb0ed4df3975d473e3c3558db322e26c6620ae,2,6,2,8,3,2012-09-27 09:46:54,2012-09-27 09:44:48
24e277b85abace0f77076b1cfa96e11b1d1dc891...474471b83140350de320f3ba940bd7dd8326b32e,8,8,8,16,8,2012-09-27 06:11:03,2012-09-27 06:11:03
474471b83140350de320f3ba940bd7dd8326b32e...e1f6458e3640a628cdb6b2e4c63950777d46e141,8,45,62,107,8,2012-09-27 22:00:02,2012-09-27 22:00:02
ce19e63d5b068ba0698dee4e2d99c725f6799b0d...f0b4f05a2751d96a6861a09db0115ad959e00d34,1,2,35,37,7,2012-09-26 05:02:29,2012-09-26 05:02:29
f0b4f05a2751d96a6861a09db0115ad959e00d34...0220015edd1c06e0475a346ca5882e3b1758af48,14,23,201,224,100,2012-09-26 05:07:53,2012-09-26 05:07:53
0220015edd1c06e0475a346ca5882e3b1758af48...9e97098802d969d338fdb6c553cf6cee903c8663,4,119,57,176,17,2012-09-26 05:16:47,2012-09-26 05:16:47
9e97098802d969d338fdb6c553cf6cee903c8663...151ed38cdcd938d4495482fb848736ee7b885c64,2,6,21,27,8,2012-09-26 05:18:34,2012-09-26 05:18:34
151ed38cdcd938d4495482fb848736ee7b885c64...08eea302ef05195e47cb32af85adcb1a735a6263,6,8,209,217,13,2012-09-26 05:20:24,2012-09-26 05:20:24
08eea302ef05195e47cb32af85adcb1a735a6263...f12946be5a8e8529f64606ca73fe06e48f9fd583,15,95,271,366,61,2012-09-26 05:40:48,2012-09-26 05:40:48
f12946be5a8e8529f64606ca73fe06e48f9fd583...c59e5251e12a57b5f305b4996d6f164b71c7f22c,15,604,727,1331,68,2012-09-26 05:48:02,2012-09-26 05:48:02
c59e5251e12a57b5f305b4996d6f164b71c7f22c...f8efc75a66590abb2b788b0d237fb91ba345d6a5,3,9,10,19,10,2012-09-26 05:51:05,2012-09-26 05:51:05
f8efc75a66590abb2b788b0d237fb91ba345d6a5...d1affe61540e53f3a292c6bfaaa8e5d4725a9b26,3,18,8,26,7,2012-09-26 05:53:41,2012-09-26 05:53:41
d1affe61540e53f3a292c6bfaaa8e5d4725a9b26...ecbf1159a43643a5b4eabbe035b6c7aabb8dde5d,4,16,12,28,9,2012-09-26 05:57:20,2012-09-26 05:57:20
ecbf1159a43643a5b4eabbe035b6c7aabb8dde5d...2eb4c6fc795b58c4d57ddf31b8917b0859d9ba22,1,6,6,12,1,2012-09-26 05:57:49,2012-09-26 05:57:49
2eb4c6fc795b58c4d57ddf31b8917b0859d9ba22...80c4d5a9bf3efcef3b2d53841315a6c808c86000,2,44,48,92,2,2012-09-26 05:59:49,2012-09-26 05:59:49
80c4d5a9bf3efcef3b2d53841315a6c808c86000...b6ba717b75d4a3985c8fe5997954e07d12d934fe,2,28,30,58,16,2012-09-26 06:01:18,2012-09-26 06:01:18
b6ba717b75d4a3985c8fe5997954e07d12d934fe...6b578ec8de0865c6c5b3e12c7824037a7d422789,4,54,62,116,15,2012-09-26 15:59:57,2012-09-26 15:59:57
6b578ec8de0865c6c5b3e12c7824037a7d422789...cd5ae9e0304dfba17d445b0c2dac7b17a1faa201,4,100,57,157,25,2012-09-26 18:20:27,2012-09-26 18:20:27
0540b63ab0a2f9359fbd34967fbb74402534573f...e9a648cd39dc6b5e0f126b7272adeac816ece758,4,53,10,63,5,2012-09-27 08:31:40,2012-09-27 08:31:40
0540b63ab0a2f9359fbd34967fbb74402534573f...b29d94747731b2dd9ef8e2e92e9c2705d95d3853,1,1,1,2,1,2012-09-25 20:12:01,2012-09-25 20:12:01
7e4629fbbec63bda9986023dd29879d2565e570e...bc4ecd998496d49ae6a7a687a2bdf1af6bcb740b,1,8,20,28,3,2012-09-05 03:13:27,2012-09-05 03:13:27
55982664d01686612facdfa09ad63ffabcbf28fe...7d412b1e14ea47884b5e3fd77fe0e7734f3cdd97,4,104,2,106,4,2012-08-28 04:18:55,2012-08-28 04:18:55
438f745ea21f100b1a8d3d8b1722ed07a743c359...d797a5fbd7dd883a09bf00e516e0bd509c898f53,3,8,7,15,6,2012-08-28 03:43:12,2012-08-28 03:43:12
d797a5fbd7dd883a09bf00e516e0bd509c898f53...601e252074eedf89de9cb080db9c463a4b67ba77,5,24,5,29,6,2012-08-28 03:58:51,2012-08-28 03:58:51
3424df22ee9dd9b93c0af6237debd4e19e2110a6...019d9bf0f3bf9dcb1e0e28f3f34ee09ef9cee011,1,1,1,2,1,2012-08-23 16:41:55,2012-08-23 16:41:55
3424df22ee9dd9b93c0af6237debd4e19e2110a6...be64955e25b4efb48fe140d0a8a05f9c34bbf285,2,2,0,2,2,2012-08-23 16:38:56,2012-08-23 16:38:56
5cbb8269619a42fe466d65e11b4dc730bcfe89cd...0682780cd858b327518b8664c3e332659e08c765,2,2,2,4,2,2012-08-23 22:04:41,2012-08-23 22:04:41
0682780cd858b327518b8664c3e332659e08c765...d9593e217d9ed8bf8f0b5c119b1eca021608ceeb,2,5,1,6,4,2012-08-24 21:45:02,2012-08-24 21:45:02
7ec1778103c94c66208e32c9d4c89c31c00802e0...48546c2735f445618fc3972a752393417d17ebb3,3,8,8,16,8,2012-08-02 03:26:44,2012-08-02 03:26:44
225d0e0af36ef7aed818fb124c7ec13fbb52be5d...86a577d76bd1dcd226dad90899886dbe18d36e39,1,1,1,2,1,2012-08-02 03:34:19,2012-08-02 03:34:19
7ce048bccd618bbae794a9115861d1927664b8ed...4912dd441d46dbacd7414628b6d70a8ae0d85d7f,6,15,8,23,10,2012-07-24 07:35:54,2012-07-24 07:35:54
4912dd441d46dbacd7414628b6d70a8ae0d85d7f...c37aa99e2836c333407db9d7d703ff731214f64e,2,2,2,4,2,2012-07-24 07:37:19,2012-07-24 07:37:19
c37aa99e2836c333407db9d7d703ff731214f64e...87aa61001e908857416f8114a892ced7e796c8b9,2,22,10,32,6,2012-07-24 07:44:11,2012-07-24 07:44:11
e25bcb93fca98797629e689f11dba5f20432714a...4ea7c472358e2d77f76193ed3c1bafd641dd74ae,5,19,11,30,16,2012-07-24 07:21:40,2012-07-24 07:21:40
e25bcb93fca98797629e689f11dba5f20432714a...76cfe1700248cd3c7086333b67050f418a897a03,1,1,1,2,1,2012-07-23 18:56:18,2012-07-23 18:55:27
cf70fb629fdef6659c76255204f4498141278517...66ad3d62c668710b4a2c98f0f3b91a4d5a5bb55c,1,1,1,2,1,2012-08-28 05:55:56,2012-08-28 05:55:56
713105774fcccf1250a7555b47483b578cf82eb6...5b5352c92d5edbcf02f0d210e04e7fe241f7e68b,2,16,26,42,20,2012-07-11 18:15:04,2012-07-11 18:15:04
5b5352c92d5edbcf02f0d210e04e7fe241f7e68b...338c7ef2b6aa62cc6b5f08f687f04eeb960719f0,3,11,16,27,6,2012-07-12 20:45:07,2012-07-12 20:45:07
338c7ef2b6aa62cc6b5f08f687f04eeb960719f0...c884d6eaa6bbcf4cb4d679c4d9be57d2f28ce93b,5,76,8,84,11,2012-07-12 20:50:27,2012-07-12 20:50:27
c884d6eaa6bbcf4cb4d679c4d9be57d2f28ce93b...280dfda6edda74772bfd5f2b16828411e7e8c5d0,1,3,3,6,2,2012-07-12 23:16:06,2012-07-12 23:16:06
280dfda6edda74772bfd5f2b16828411e7e8c5d0...3c775f24323d649f55aaa175eb6a1a19024ab30c,8,56,56,112,8,2012-07-12 23:23:21,2012-07-12 23:23:21
1db72f8d77ba79d4f306cb6abcac1959d650d90f...2cbff258b9351569c76be8e7be1dd9f227a7d2ae,3,10,6,16,7,2012-06-12 05:33:16,2012-06-12 05:33:16
2cbff258b9351569c76be8e7be1dd9f227a7d2ae...3ead14a1e082b95a792339a549b14df59f53de2b,2,2,2,4,2,2012-06-14 05:00:10,2012-06-14 05:00:10
3ead14a1e082b95a792339a549b14df59f53de2b...cda48d41baacf1f515dbdd4ef091a42eff26b469,2,2,2,4,2,2012-06-14 05:04:02,2012-06-14 05:04:02
f805a6080c961b2348d1d2e92259dfcc4f4a2392...7f6f3ff4622a9bd8394e8f418db7f9af3257ae47,2,9,0,9,2,2012-04-24 08:23:24,2012-04-24 08:23:24
7f6f3ff4622a9bd8394e8f418db7f9af3257ae47...805ca03457661d6e354c308bb98e7e985f8ca79f,2,2,2,4,4,2012-04-24 08:33:00,2012-04-24 08:33:00
805ca03457661d6e354c308bb98e7e985f8ca79f...1c2db11d58cfb35ab513d104eb845b4dce34f750,3,8,9,17,8,2012-04-24 08:46:20,2012-04-24 08:46:20
b8b1ffde055b9e04f658201f81cf7974d56ae0c2...73453c7f79e6bf6be13917f854ed172e214eada2,4,7,8,15,6,2012-04-24 09:02:06,2012-04-24 09:02:06
32e57efd1f21c368885ebe8b57ade4963466e42d...95356ee0622561b67327b3880bcdc3c5df97cf40,2,5,1,6,3,2012-01-26 23:04:36,2012-01-26 23:04:36
c31ac846d7f8cf59199fc5be58c1a4ba4417b1fa...12484a7471513f38be02e8420db3b09842968562,3,81,76,157,18,2012-01-27 00:41:28,2012-01-27 00:41:28
12484a7471513f38be02e8420db3b09842968562...1e9c2fb9d4a033304b5aa71d269af9f68eb72670,1,6,5,11,6,2012-01-27 04:23:15,2012-01-27 04:23:15
b260544de02788bc921c4c713df0f754d96c5a27...af96da6e895974dd4bd6fb19cf0c6d7e16bf050d,7,10,3,13,6,2012-01-27 00:27:37,2012-01-27 00:27:37
34a7518b19e515b07d863685bc3a946b96c14639...6cfd811fcc99e5800c9e6207c48a91f85f699ae7,1,2,0,2,1,2014-11-20 00:00:03,2014-11-19 23:22:45
6cfd811fcc99e5800c9e6207c48a91f85f699ae7...aaffe4b49860ed7f8084b6fd967dd0aa0099c9a3,1,1,0,1,1,2014-11-20 00:00:28,2014-11-19 23:41:05
aaffe4b49860ed7f8084b6fd967dd0aa0099c9a3...db95e0bd01739fb68c9b89979c7a214ffdde587e,1,3,1,4,1,2014-11-20 00:00:46,2014-11-19 23:43:23
db95e0bd01739fb68c9b89979c7a214ffdde587e...a1c170ed373d9076ecf76d264220a6a636239f17,1,3,0,3,1,2014-11-20 00:01:03,2014-11-19 23:51:11
a1c170ed373d9076ecf76d264220a6a636239f17...6575755dc49d9516840c0a0804185931f2edf9c7,1,2,2,4,1,2014-11-20 00:01:20,2014-11-19 23:44:43
27677fab5b704d8c61c4561dd7dd55d54fbcc8f2...e7de01eeed2c208ba76eddd677f5b6981359f28a,4,6,6,12,6,2015-02-06 19:54:07,2015-02-06 19:54:07
27677fab5b704d8c61c4561dd7dd55d54fbcc8f2...7dd72d83fab7394dee7326c0a6214374ec796ff6,1,0,1,1,1,2015-02-05 07:58:22,2015-02-05 07:58:22
b258a1f5b08122f3efacbd1521cfb6286bc399b8...cb939e2efe36eb3ad7914a423d8ff08ac7160ca5,1,3,3,6,2,2015-01-28 01:02:34,2015-01-28 01:02:34
2549b808a148f9037c63ff50b3b7f881cf326a26...9677d6685a575e1c5a54d887df5974c342536abc,3,5,2,7,5,2015-02-19 23:51:16,2015-02-19 23:51:16
504435e0b07e6c638df995959bb1f0a4a182ceca...b8a0ea12247f7e0de643ff445eaee8795575610c,3,209,84,293,42,2015-02-20 09:35:39,2015-02-20 09:22:06
b8a0ea12247f7e0de643ff445eaee8795575610c...e6dbaea97e72ccc8d6efd5e838fd4be963409f61,5,11,5,16,9,2015-02-20 09:35:45,2015-02-20 09:35:45
d0895faa0ad8459a39c1314ad05a642069ede103...47c3c6a59f6432a5f8a8e258fad810b930b1f948,1,1,1,2,1,2015-02-10 07:21:10,2015-02-10 07:21:10
47c3c6a59f6432a5f8a8e258fad810b930b1f948...c388870cefcd2e38371cdca6d07ee92770ecd9b1,3,4,4,8,3,2015-02-10 08:49:59,2015-02-10 08:46:30
c388870cefcd2e38371cdca6d07ee92770ecd9b1...81115cd089c452b3a69bbbec39ffd4a70dda3b2d,6,13,8,21,10,2015-02-10 08:50:57,2015-02-10 08:50:57
b6c0007f212b27a62207b3b914912022900e7677...c643a3d33184b79d2b802e76f947787b5ba28788,1,1,1,2,1,2015-01-19 23:20:54,2015-01-19 23:20:54
d5a2b27e1661f390e1f6cc00774f33effe0f03d3...a6f3bdb71f65e92e1ed4fe140683e49f99526442,15,67,46,113,35,2015-01-21 07:51:12,2014-11-20 08:09:47
a6f3bdb71f65e92e1ed4fe140683e49f99526442...53d2abff922ad1ca776750657d98415a6fedb635,3,20,6,26,8,2015-01-21 07:51:12,2014-11-30 11:09:30
d5a2b27e1661f390e1f6cc00774f33effe0f03d3...3f512c927bdee5e601a49ecd60e5fb78edfd7794,9,145,9,154,14,2015-01-21 07:50:51,2014-10-28 21:50:22
3f512c927bdee5e601a49ecd60e5fb78edfd7794...84e41378e678b402047a220e32e4398a27348a2b,6,38,52,90,24,2015-01-22 03:20:16,2015-01-22 03:20:16
ac78d16e41de8fe7a221576e098dfd0e2abf8b0e...139226157e43541f90991e1d4cf7b6cd3f4dbf07,1,1,1,2,1,2014-12-29 03:47:46,2014-12-29 03:47:46
139226157e43541f90991e1d4cf7b6cd3f4dbf07...d6ab6731e67e25d93e263bb70393071f5b3389ea,1,2,2,4,1,2014-12-29 03:49:12,2014-12-29 03:49:12
7e3ca05692301a390af326529c65f6d82852216b...a940e1fdd6408193af33ad6f28564ad031bb0095,1,1,1,2,1,2014-12-12 13:24:50,2014-12-12 13:24:50
b7be72c86c9b8b0289438f5e97a2263ecdb1344c...4945e370f057ef491b0197034ddedd969913b06c,1,1,0,1,1,2014-12-15 00:59:47,2014-12-15 00:59:47
b7be72c86c9b8b0289438f5e97a2263ecdb1344c...181f4aebea957f364a1b42a6331d0fa4624cf5e9,3,3,3,6,3,2014-12-15 00:30:39,2014-12-15 00:30:39
4715e05510b111b37e796f1458fc7a39a81d6571...afbe7114b4a362b6cae008328343d9e568c03457,1,1,1,2,1,2014-07-03 00:09:13,2014-07-03 00:09:13
4715e05510b111b37e796f1458fc7a39a81d6571...1e407c81f1033059adf85afbd9ba095d50587684,17,28,28,56,28,2014-07-02 20:49:03,2014-07-02 20:49:03
4715e05510b111b37e796f1458fc7a39a81d6571...1ce5e9f3aea1c5d2f63d9e0b5a81cf229daccf13,2,12,6,18,4,2014-07-02 17:09:28,2014-07-02 17:09:26
1ce5e9f3aea1c5d2f63d9e0b5a81cf229daccf13...f9ffb4993215687bb241cab1151956e6df1922cd,1,8,4,12,3,2014-07-06 07:16:54,2014-07-06 07:16:52
4715e05510b111b37e796f1458fc7a39a81d6571...afdc9c4b3216b628a9bf4dbaa5b5e070d95cb0f0,1,52,0,52,1,2014-07-02 16:05:28,2014-07-02 15:15:22
afdc9c4b3216b628a9bf4dbaa5b5e070d95cb0f0...1136f9346adb1cc9ef1b22b7c91ec1f06c225bc7,1,44,52,96,3,2014-07-02 16:32:25,2014-07-02 16:32:25
1136f9346adb1cc9ef1b22b7c91ec1f06c225bc7...ebdecacd650a766e8123dbe3f86c4aa0f9cd72b4,1,26,22,48,12,2014-07-03 05:06:28,2014-07-03 05:06:28
fb37ec16f87b2d3a5d194eb3f61d25f564a71110...96b545c6b5ebf5f74b75a735359187bd9b80689d,7,51,29,80,26,2014-07-03 06:14:23,2014-07-03 06:14:23
96b545c6b5ebf5f74b75a735359187bd9b80689d...fcf9470a20c18c36bd306d1a3a708ed09255a226,7,13,13,26,13,2014-07-03 06:35:37,2014-07-03 06:35:37
fcf9470a20c18c36bd306d1a3a708ed09255a226...4f8697cbbb86d0315bab9ac1fac5df403a2c57d7,1,1,1,2,1,2014-07-03 06:44:56,2014-07-03 06:44:56
4f8697cbbb86d0315bab9ac1fac5df403a2c57d7...3537481c972c4b5ebb678e91cd477d1941f99424,8,8,8,16,8,2014-07-03 07:55:32,2014-07-03 07:55:32
3537481c972c4b5ebb678e91cd477d1941f99424...23dd323da1dbb84da8aa64451303009684ac8a65,1,1,1,2,1,2014-07-03 07:57:37,2014-07-03 07:57:37
a035ee59ae73510ebdb1064e59b4b16f1da9fc66...49519e981614fb8e0c4fabcbb0a632db292c2b3c,4,6,30,36,6,2014-07-21 07:35:41,2014-07-21 07:35:41
502e8c069ea3377cc129ff4164a3797a69045b32...c3ae289f4a9e5fc14e489e3914d150954469f1ac,1,1,0,1,1,2014-07-10 23:58:18,2014-07-10 23:57:26
c3ae289f4a9e5fc14e489e3914d150954469f1ac...bd292ca3b89da982abf34473318c77ace3417fb5,10,14,14,28,14,2014-07-12 22:13:18,2014-07-12 22:13:18
bd292ca3b89da982abf34473318c77ace3417fb5...7ec6c9fd133396f4576d0a030b26931715fb8af2,1,32,10,42,8,2014-07-12 22:16:43,2014-07-12 22:16:43
7ec6c9fd133396f4576d0a030b26931715fb8af2...3e8cddf8671db110c1d46c46c13065f6b9a67ad1,7,4,9,13,7,2014-07-12 22:22:41,2014-07-12 22:22:29
3e8cddf8671db110c1d46c46c13065f6b9a67ad1...5850f637ab8247ab36d7153d1e7025feca0bb567,1,4,14,18,2,2014-07-12 22:36:08,2014-07-12 22:36:08
5850f637ab8247ab36d7153d1e7025feca0bb567...717a50ce19ed2f76e6b9eaf2f16be746cdfa23c0,2,2,2,4,2,2014-07-12 22:37:13,2014-07-12 22:37:13
4afe40db385dbe53e8d6182d086a89d04e70f16a...2000e854ed92de8986a990fd1ae20c62b84b05be,1,1,1,2,1,2014-07-13 00:23:51,2014-07-13 00:23:51
2000e854ed92de8986a990fd1ae20c62b84b05be...62d6d69c201f8c100700f616489226cb586c9e73,1,1,1,2,1,2014-07-13 00:26:43,2014-07-13 00:26:43
62d6d69c201f8c100700f616489226cb586c9e73...d9a38cd99f3346a7565bf31cb9143755158c8219,1,2,2,4,2,2014-07-13 00:51:57,2014-07-13 00:51:57
d9a38cd99f3346a7565bf31cb9143755158c8219...bb1286a0ab073bce1d18f704d7ac0545ea76c6ef,1,4,0,4,1,2014-07-13 00:53:31,2014-07-13 00:53:31
bb1286a0ab073bce1d18f704d7ac0545ea76c6ef...8c586a8e3ef3ce31cb18e064a0e78332a785d7a2,7,10,4,14,10,2014-07-13 00:59:02,2014-07-13 00:59:02
8c586a8e3ef3ce31cb18e064a0e78332a785d7a2...7a8d9dbdbfd150759847bbb8b230211b8bd1e5ea,2,2,2,4,2,2014-07-13 01:06:26,2014-07-13 01:06:26
7a8d9dbdbfd150759847bbb8b230211b8bd1e5ea...cd7250d6a8f2144c7cfa2103713b4a19ddb2ea90,1,1,1,2,1,2014-07-13 01:15:45,2014-07-13 01:15:45
cd7250d6a8f2144c7cfa2103713b4a19ddb2ea90...2c540b7e330eb2e8ecedfd7d62fb603f96ee39db,1,4,4,8,3,2014-07-13 07:08:25,2014-07-13 07:08:25
d675284cf65b0b1c30ed555f3148dd880a52da27...149c4be7264316b30024a9618c13110ee6294ebf,1,1,1,2,1,2014-02-03 18:02:58,2014-02-03 18:02:58
149c4be7264316b30024a9618c13110ee6294ebf...8ee208e9c197d48828767764d7c89147ebde2a7e,1,1,1,2,1,2014-02-03 20:19:50,2014-02-03 20:19:50
d675284cf65b0b1c30ed555f3148dd880a52da27...a484b3bd7a3d3f110aa85ff8698b8f0c53162eef,1,2,2,4,1,2014-02-03 15:24:07,2014-02-03 15:24:07
952afba70dd06433e19bae190511e3dac2030725...07098d1bb7e02cc2b7f8bcbc94931fdedd30830b,6,9,6,15,8,2014-02-04 10:01:31,2014-02-04 10:01:31
952afba70dd06433e19bae190511e3dac2030725...b16efebc8eadb4e57899c80b19cd9cf25af3bfa8,2,5,11,16,2,2014-02-04 09:51:40,2014-02-04 09:51:40
952afba70dd06433e19bae190511e3dac2030725...7dd51beb42e26a028037c2c8bf9e10e3b0bbac04,3,0,0,0,0,2014-02-04 09:33:28,2014-01-31 07:31:51
7dd51beb42e26a028037c2c8bf9e10e3b0bbac04...2deb5f9f9136f764df6f1d24b38b5ebaed4a1965,10,0,0,0,0,2014-02-04 09:33:28,2014-01-31 17:08:22
f8374a754d2ffe153ab14cb1315365c1303c6bbe...82715ae96dad4e97d208acf7f1654b25449e2bef,1,1,1,2,1,2012-10-01 04:41:37,2012-10-01 04:41:37
82715ae96dad4e97d208acf7f1654b25449e2bef...48a8dd2a23f11981d42785db4091c029b5b7e781,1,19,0,19,1,2012-10-09 05:29:44,2012-10-09 05:29:44
f8374a754d2ffe153ab14cb1315365c1303c6bbe...57f8dbe25cd073bbf4d28a52cd82a2554ab024fc,4,26,10,36,6,2012-10-01 04:26:43,2012-10-01 04:26:43
57f8dbe25cd073bbf4d28a52cd82a2554ab024fc...a2690c6d86e97655e87c77be59a0f252101b3a09,4,237,0,237,4,2012-10-01 04:28:20,2012-10-01 04:28:20
630a88d3ce0dde6365e224d84353d3cf24defc18...e73cd15fc8eaa80ab7913d51a23a8e61c0e1bb30,11,82,53,135,27,2012-10-03 00:01:18,2012-10-03 00:01:18
e73cd15fc8eaa80ab7913d51a23a8e61c0e1bb30...dd8b745b883a900aa637a7b8142be5691ebc3913,15,31,31,62,19,2012-10-03 16:26:52,2012-10-03 16:26:52
dd8b745b883a900aa637a7b8142be5691ebc3913...11ee1633b459352de9831a507c20e78f4f1fd5c3,2,5,2,7,2,2012-10-03 16:36:45,2012-10-03 16:36:45
11ee1633b459352de9831a507c20e78f4f1fd5c3...3726ce24bb68376e484a4cc2f29e8e5c28b0a0bb,2,8,4,12,2,2012-10-03 16:43:14,2012-10-03 16:43:14
3726ce24bb68376e484a4cc2f29e8e5c28b0a0bb...7d649c9d4a0c504ca29e6efa7fcb42af5d8996dd,2,2,2,4,2,2012-10-05 18:13:21,2012-10-05 18:13:21
7d649c9d4a0c504ca29e6efa7fcb42af5d8996dd...d76c305cbb55c40d19ca96fb093e40b59eebfcaf,1,1,1,2,1,2012-10-06 21:42:07,2012-10-06 21:42:07
d76c305cbb55c40d19ca96fb093e40b59eebfcaf...6203535d2f65502eb0beafc3568fa878ce63f97f,10,20,20,40,31,2012-10-08 04:38:28,2012-10-08 04:38:28
6203535d2f65502eb0beafc3568fa878ce63f97f...e4f522990e8cbab988650a52c8af19a738d74183,2,8,0,8,2,2012-10-08 04:43:37,2012-10-08 04:43:37
e4f522990e8cbab988650a52c8af19a738d74183...7e534ce98acf03229e09b8ae478cb3598d3882cd,2,2,0,2,2,2012-10-08 04:45:16,2012-10-08 04:45:16
df8e3c6ee3716a3fad45bff08fafc29c55967515...5ff5d351bfbdf13ea93ccfed79743e62f50f9747,1,0,2,2,1,2012-09-05 16:07:53,2012-09-05 16:07:53
5ff5d351bfbdf13ea93ccfed79743e62f50f9747...dfb3175d4b7904a4fe3f1d3ec41145c5021484dc,4,3,5,8,4,2012-09-05 17:04:28,2012-09-05 17:04:28
df8e3c6ee3716a3fad45bff08fafc29c55967515...c52368d3c5984b28e6a71e5e1240afdd788fc2e6,3,3,3,6,3,2012-09-05 03:44:11,2012-09-05 03:44:11
7d412b1e14ea47884b5e3fd77fe0e7734f3cdd97...609142eee254ef0981a72a1921a053d2a7f16bc6,2,14,2,16,4,2012-08-28 05:42:12,2012-08-28 05:42:12
601e252074eedf89de9cb080db9c463a4b67ba77...4751a0a2745b8480371678281ee6a7f874aaf096,2,19,1,20,2,2012-08-28 04:27:01,2012-08-28 04:27:01
aa07523e696c4418e9486b36d6fe49990fcd2f78...bb9d1af1ca80879b6a27c2471f33d1c3aa2579fc,1,1,1,2,1,2012-08-26 04:51:07,2012-08-26 04:51:07
bb9d1af1ca80879b6a27c2471f33d1c3aa2579fc...f744ad57fcd2d4686861192c453c9e1f2554e9e7,3,3,5,8,4,2012-08-26 05:31:10,2012-08-26 05:31:10
f744ad57fcd2d4686861192c453c9e1f2554e9e7...eb8aad85b832e01ee1abff4ec90ef751d4e73b78,2,4,0,4,4,2012-08-27 05:29:40,2012-08-27 05:29:40
48546c2735f445618fc3972a752393417d17ebb3...2b2b3303e1e93d627bf57d145173a523d991803c,4,4,4,8,4,2012-08-02 23:58:25,2012-08-02 23:58:25
4a84145c4328daf17f06704100671b7a0b6ee329...fc7ecd78c88771ca9b899f19d56f84970fe9429b,1,24,13,37,2,2012-08-02 03:58:33,2012-08-02 03:58:33
fc7ecd78c88771ca9b899f19d56f84970fe9429b...1e2edaef48e45c1a085cd21ad2cbf86cfe2c7c06,1,11,1,12,4,2012-08-02 05:52:53,2012-08-02 05:52:53
1e2edaef48e45c1a085cd21ad2cbf86cfe2c7c06...148203067978a13aeadd2127b0ddf00299cb8e98,2,121,17,138,15,2012-08-02 06:15:51,2012-08-02 06:15:51
148203067978a13aeadd2127b0ddf00299cb8e98...d27dcf3b070015aca81d86de00e1b2ea6e0f30ff,2,7,98,105,7,2012-08-02 06:16:49,2012-08-02 06:16:49
394922a1bfe3360b20aea29e8ffe22133f56b908...7590e65f6f4641d946d0bfec2f4a84bbd3f561cd,4,15,11,26,11,2012-07-24 08:44:12,2012-07-24 08:44:12
7590e65f6f4641d946d0bfec2f4a84bbd3f561cd...b7b4fd5c82ea321da3d7858e223eb6adcd225672,18,566,544,1110,98,2012-07-24 08:53:32,2012-07-24 08:53:32
5b2f2ed82181c651626b541aee6963f74bf8be31...e38fa4b1f40b8e8f64ad904fd5ea3d6d7ab9dffc,15,12,15,27,15,2012-07-24 07:30:58,2012-07-24 07:30:58
685785d2c2d0f6b61978e9fd76aed82de7e05aba...5247b15411a29f98832e38957f57a1e03e7065ae,1,1,1,2,1,2012-07-24 01:12:23,2012-07-24 01:12:23
5247b15411a29f98832e38957f57a1e03e7065ae...614d52bd7f86591a0b0ab09e1c16ee888610d8a3,2,1,7,8,2,2012-07-24 01:17:43,2012-07-24 01:17:43
7d324ee35b96a7d177bd301e2f11fe442713a1f6...549d61fc289cb9efe5f8959e706e170b080663ba,13,117,75,192,37,2012-07-13 00:02:55,2012-07-13 00:02:55
549d61fc289cb9efe5f8959e706e170b080663ba...a12f0e551f7da763a9be23013d1b51c161a0f6f8,19,8168,8300,16468,961,2012-07-13 01:11:49,2012-07-13 01:11:49
a12f0e551f7da763a9be23013d1b51c161a0f6f8...9343e1e933c1a38ec4cc58024b01edda631863b0,14,344,268,612,35,2012-07-13 04:38:18,2012-07-13 04:38:18
9343e1e933c1a38ec4cc58024b01edda631863b0...f36060dab5872268456a84aa0479bbacb022b959,1,2,2,4,2,2012-07-13 04:40:25,2012-07-13 04:40:25
f36060dab5872268456a84aa0479bbacb022b959...f22b06097ab51c7fdfbe715ebb9a408c4c56f04f,1,2,2,4,2,2012-07-13 04:41:07,2012-07-13 04:41:07
f22b06097ab51c7fdfbe715ebb9a408c4c56f04f...fae691c3d914e513a79e8fcde051c34b6c904f8c,2,4,4,8,2,2012-07-13 04:41:51,2012-07-13 04:41:51
fae691c3d914e513a79e8fcde051c34b6c904f8c...2d4f5eb5a48f26d024ce0bb329b46ceef7206e87,2,46,46,92,4,2012-07-13 07:56:18,2012-07-13 07:56:18
2d4f5eb5a48f26d024ce0bb329b46ceef7206e87...5cb116beb897b783195e059b205af52b0f5b72c1,4,8,4,12,9,2012-07-13 17:58:20,2012-07-13 17:58:20
5cb116beb897b783195e059b205af52b0f5b72c1...93b1519017ecf002883b72cd69d4e08fc2500697,2,30,10,40,14,2012-07-13 18:17:22,2012-07-13 18:17:22
cda48d41baacf1f515dbdd4ef091a42eff26b469...b1cb5565039f492766fdfd727f776f3e9dfa7e45,4,30,10,40,16,2012-06-14 18:56:46,2012-06-14 18:56:46
cda48d41baacf1f515dbdd4ef091a42eff26b469...7b726f974f5e00c57b1087bb62d516943d9a58e3,1,1,0,1,1,2012-06-14 12:53:04,2012-06-14 12:53:04
1c2db11d58cfb35ab513d104eb845b4dce34f750...d8aaf507981dbecb146bc77e288a3f10387923cd,6,291,0,291,44,2012-04-24 09:11:59,2012-04-24 09:11:59
95356ee0622561b67327b3880bcdc3c5df97cf40...b9589fcb8076aa6b2559553c56d7e65808568a86,1,2,2,4,4,2012-01-26 23:23:09,2012-01-26 23:23:09
95356ee0622561b67327b3880bcdc3c5df97cf40...f398926e4647df1e7e5a2abdbc9e2e9e775eeb34,1,1,0,1,1,2012-01-26 23:22:52,2012-01-26 23:22:52
e0e54d9c6cb39eae53e31117c38ceae0a08a6e0b...dc2deb9a1b1995bbabee91bfd579d9b466fe78f2,47,100,91,191,84,2012-01-27 05:48:46,2012-01-27 05:48:46
dc2deb9a1b1995bbabee91bfd579d9b466fe78f2...ed64276e5be1bbf808f2ab1451aa02522cc3aff0,15,26,595,621,21,2012-01-27 06:05:45,2012-01-27 06:05:45
ed64276e5be1bbf808f2ab1451aa02522cc3aff0...a25f0cce95bc538f3aa19e9edf17ac3a353e334e,1,2,23,25,2,2012-01-27 06:11:32,2012-01-27 06:11:32
a25f0cce95bc538f3aa19e9edf17ac3a353e334e...815a2ae9f26f49137382fd4b186d174c7b1b8c5b,5,6,5,11,6,2012-01-27 06:39:17,2012-01-27 06:39:17
815a2ae9f26f49137382fd4b186d174c7b1b8c5b...c63175dc1d41e2d26e50194a7e24cc0ea618446b,1,1,2,3,2,2012-01-27 06:52:44,2012-01-27 06:52:44
e7bc2063beb8ab1a36b5001d5847c6995b005a29...c8d2c4e44297d52339216f7e6664d9105ff554a1,1,1,0,1,1,2012-01-27 00:45:01,2012-01-27 00:45:01
c8d2c4e44297d52339216f7e6664d9105ff554a1...a4a8ea2328f163fad43f250f6b3311fe0b670946,2,46,46,92,4,2012-01-27 03:09:59,2012-01-27 03:09:59
a4a8ea2328f163fad43f250f6b3311fe0b670946...7a3d04d5bed9b9ddf5a3c78466b7115a0260b75e,3,271,271,542,97,2012-01-27 03:10:09,2012-01-27 03:10:09
38fbd8fe35d770651bbaee1f41e1d9d17d2a7879...253dfc0d3d824375d6119a78e76a676d91141ebe,3,2,3,5,3,2015-03-09 08:41:21,2015-03-09 08:41:21
38fbd8fe35d770651bbaee1f41e1d9d17d2a7879...b6b0fe7d22c1dccb83541f4d78fdbdf40bef2157,4,1,6,7,6,2015-03-09 08:40:26,2015-03-09 08:39:43
af8fa54fcd402996756394eaa955a030021a868c...4ebfbad9c799dd811d30ddc4a167e5525b174da1,2,2,2,4,2,2015-01-28 19:02:08,2015-01-28 19:02:08
89951a6608fa8c213779286af4e4a7b384298c89...7080e895d836edb03fa585bfc0d5345428bf6c34,2,6,6,12,6,2015-02-20 22:07:14,2015-02-20 22:06:42
81115cd089c452b3a69bbbec39ffd4a70dda3b2d...0013483d94f98694edc9863b8c42101ca39e38fb,2,1,2,3,2,2015-02-10 20:57:00,2015-02-10 20:57:00
0013483d94f98694edc9863b8c42101ca39e38fb...de90cd7a80bf0d8eb23672ebe332ca295485efef,1,13,13,26,6,2015-02-10 20:57:39,2015-02-10 20:57:39
c643a3d33184b79d2b802e76f947787b5ba28788...429809c9ccd189ead915081c21d229e2125bf919,2,131,277,408,26,2015-01-20 20:49:08,2015-01-20 20:49:08
429809c9ccd189ead915081c21d229e2125bf919...0b7f6b941a137daed328e6fcf87bc14d2541db66,1,12,36,48,6,2015-01-20 20:49:46,2015-01-20 20:49:46
1ce502dc4de0accf27a6c37c21d26f4739d09241...848701a1b3f4152a1c8b6b9dbb09ac805d779cc2,1,1,1,2,1,2015-01-21 17:01:25,2015-01-21 17:01:25
848701a1b3f4152a1c8b6b9dbb09ac805d779cc2...4c5d1faa3578918d6976f3e6fe32cb4a399210bd,1,2,1,3,1,2015-01-21 21:38:58,2015-01-21 21:38:58
a3890a72cfce45265028413b2e6677b968bdc6a5...c08bf4ba8b968ecda295391b41d5e965b642ba7c,2,3,3,6,3,2015-01-22 05:06:11,2015-01-22 05:06:11
f149e4309add96394ed072265cca84aabd623649...995c7683307b2e39d8505989615967b5d7843caa,1,1,1,2,1,2014-12-29 19:57:56,2014-12-29 19:57:56
995c7683307b2e39d8505989615967b5d7843caa...9e66526766ca0d1ca639a53dd6e830efdb2d83c0,1,16,4,20,5,2014-12-29 20:00:47,2014-12-29 20:00:47
9e66526766ca0d1ca639a53dd6e830efdb2d83c0...2ae4c0b03f7fde62f99ea8324859fa60cd890163,1,1,0,1,1,2014-12-29 20:02:33,2014-12-29 20:02:32
f149e4309add96394ed072265cca84aabd623649...f91071bc1bb0cb0999739d62dd46d18727312165,2,2,2,4,2,2014-12-29 03:58:29,2014-12-29 03:58:29
f91071bc1bb0cb0999739d62dd46d18727312165...c14ff80f01dff57bed749e400def9e83317bd10d,1,57,59,116,11,2014-12-29 04:29:42,2014-12-29 04:29:42
b12e24e7a12c66987f0ccc83e6e02500ddd15c08...f9db33d7dbc464a71d2143e3dd323fd7db47773b,3,3,3,6,3,2014-12-12 19:30:34,2014-12-12 19:30:34
181f4aebea957f364a1b42a6331d0fa4624cf5e9...9e5697a14f96e2d8755d7302d8dc2d0974422a87,1,2,1,3,1,2014-12-15 09:00:19,2014-12-15 09:00:19
d67fe0f5b9f2a5677a0c0dd5e4e8cc13ea57a91f...a091c90063441e6ccd93307477fe9e3335fd740a,1,4,4,8,4,2014-07-03 05:12:39,2014-07-03 05:12:39
23dd323da1dbb84da8aa64451303009684ac8a65...497597808319c74fe52aff1be41c0695ae40ee71,3,0,3,3,3,2014-07-03 11:17:14,2014-07-03 11:17:14
23dd323da1dbb84da8aa64451303009684ac8a65...47521fd7d0b43a6ec062c0e722bfae033eb0a4eb,4,7,0,7,4,2014-07-03 10:53:23,2014-07-03 10:53:23
49519e981614fb8e0c4fabcbb0a632db292c2b3c...1118e8103b485635249657d39a43a3563e810d6b,1,1,0,1,1,2014-07-21 19:27:55,2014-07-21 19:26:12
717a50ce19ed2f76e6b9eaf2f16be746cdfa23c0...95592e81a32396bb58e0bb6cf20f9ff87ed8d6cd,1,1,1,2,1,2014-07-12 23:02:46,2014-07-10 17:20:04
2c540b7e330eb2e8ecedfd7d62fb603f96ee39db...8167223b3bb0c45c703323d97e0d5c8a4e76604b,1,4,4,8,1,2014-07-13 22:13:17,2014-07-13 22:13:17
8ee208e9c197d48828767764d7c89147ebde2a7e...819b19e39c3dc12f4201e6c0f27d49e1742dbbba,1,1,1,2,1,2014-02-04 07:05:51,2014-02-04 07:05:51
8ee208e9c197d48828767764d7c89147ebde2a7e...3a89fbc9a31fd5c36a24d030ad96bb1749e08c61,1,2,1,3,1,2014-02-04 07:04:40,2014-01-31 09:49:33
3a89fbc9a31fd5c36a24d030ad96bb1749e08c61...48118576f1cc22b0dc72e897139fd0724e97af9d,4,3,7,10,8,2014-02-04 07:04:40,2014-01-31 12:03:42
24b5e6cb142ad5ac530c0815ebf1cc102e2e381b...280d4aeb30aa6b29ec74bd801ad1be3fc05e01f4,4,11,11,22,11,2012-10-18 05:51:39,2012-10-18 05:51:39
a2690c6d86e97655e87c77be59a0f252101b3a09...46764a71650f751820c0968bd33458f03dac0387,1,2,1,3,1,2012-10-01 07:32:51,2012-10-01 07:32:51
a2690c6d86e97655e87c77be59a0f252101b3a09...a4a6244eb7a7514ad7410403bf5b60d1bf3e88b0,4,144,2,146,5,2012-10-01 05:09:51,2012-10-01 05:09:51
7763cab6082700e052c12add8df71b22358b24ae...1b814458c9476c32a92390e9e5cd989a51d04f05,4,127,72,199,6,2012-10-01 23:41:13,2012-10-01 23:41:13
1b814458c9476c32a92390e9e5cd989a51d04f05...7c9597f4e76d45571fab7a0e19d90b2fea8aab02,2,8,8,16,4,2012-10-02 06:34:03,2012-10-02 06:34:03
0b9d4e78ad5e5ad2f6f34735f0ac73463e1d1af9...45046544a671b5bb27f1631c9a1bef453b3ca325,4,16,10,26,4,2012-10-18 06:36:22,2012-10-18 06:36:22
45046544a671b5bb27f1631c9a1bef453b3ca325...ba2a99e7c440e6dd88bcb33501a7ba790ceec445,4,10,1,11,4,2012-10-18 06:39:41,2012-10-18 06:39:41
ba2a99e7c440e6dd88bcb33501a7ba790ceec445...c33169a6bae8675bd65767690d9098a4f9c071a9,3,34,12,46,25,2012-10-18 18:19:16,2012-10-18 18:19:16
bbd543db53cd8c5d295db67af2bc2517d5c11f1c...2b06edc7d7b8658e1861362584e1dffd2dfb831b,2,0,20,20,2,2012-10-01 05:49:14,2012-10-01 05:49:14
2b06edc7d7b8658e1861362584e1dffd2dfb831b...840cad69af75590a2568b7c6a2a4d7bdb0c14b7b,1,0,11,11,1,2012-10-01 05:52:32,2012-10-01 05:52:32
840cad69af75590a2568b7c6a2a4d7bdb0c14b7b...0cd186183c5e18f0517d6037d53f29c56adbac72,1,1,2,3,2,2012-10-01 05:54:44,2012-10-01 05:54:44
0cd186183c5e18f0517d6037d53f29c56adbac72...9872902e4784220f3add1a1af256dfc89cd6e31a,26,152,322,474,158,2012-10-01 06:11:54,2012-10-01 06:11:54
9872902e4784220f3add1a1af256dfc89cd6e31a...443b6052463285b36752f97a656be95c01650fca,3,2,43,45,43,2012-10-01 06:17:07,2012-10-01 06:17:07
443b6052463285b36752f97a656be95c01650fca...08446563b92c64c3ac3b83d922797c94f5bc11a9,2,2,11,13,6,2012-10-01 06:19:55,2012-10-01 06:19:55
08446563b92c64c3ac3b83d922797c94f5bc11a9...3f2938948da34744cd297c5ea61cf8a334c74951,4,0,33,33,22,2012-10-01 06:20:43,2012-10-01 06:20:43
3f2938948da34744cd297c5ea61cf8a334c74951...de6ec034dbf08a2e9facb995c638ed6a9c156dcd,4,706,694,1400,6,2012-10-01 06:24:07,2012-10-01 06:24:07
de6ec034dbf08a2e9facb995c638ed6a9c156dcd...b6f6235e9bc31a4e5910077c1c7a0f43a0562216,2,4,8,12,8,2012-10-01 06:26:51,2012-10-01 06:26:51
b6f6235e9bc31a4e5910077c1c7a0f43a0562216...4b0d71abc1e888932a60982bacd3619b89aba7ce,2,30,21,51,8,2012-10-01 06:44:23,2012-10-01 06:44:23
4b0d71abc1e888932a60982bacd3619b89aba7ce...3934e55254a73d1e64c4a881e12dda3f52f38ffa,3,0,7,7,3,2012-10-01 06:46:48,2012-10-01 06:46:48
3934e55254a73d1e64c4a881e12dda3f52f38ffa...bfe51163e27abb90dd3ef56ca36a1c315d58c388,1,0,7,7,2,2012-10-01 06:47:00,2012-10-01 06:47:00
bfe51163e27abb90dd3ef56ca36a1c315d58c388...3f4076c635aae1d813694bb7f5cf9abb5a48a44b,2,3,5,8,5,2012-10-01 06:49:26,2012-10-01 06:49:26
3f4076c635aae1d813694bb7f5cf9abb5a48a44b...142643589ffa7ca2249c9a5e3005c1f1eb3abbb1,1,0,1,1,1,2012-10-01 06:50:54,2012-10-01 06:50:54
142643589ffa7ca2249c9a5e3005c1f1eb3abbb1...973646ea67b8e738cb456f897ad2af204e50607e,1,1,2,3,3,2012-10-01 06:52:02,2012-10-01 06:52:02
973646ea67b8e738cb456f897ad2af204e50607e...c82b9d1e7c63a2885d679e39913941a4c2188661,1,6,11,17,3,2012-10-01 06:54:35,2012-10-01 06:54:35
c82b9d1e7c63a2885d679e39913941a4c2188661...ecf6077f480f0ff255e38c6643a23b5d74ef53f3,3,5,183,188,9,2012-10-01 06:59:35,2012-10-01 06:59:35
ecf6077f480f0ff255e38c6643a23b5d74ef53f3...26386ad615a48be02d896a41b7c72a7470c8a9c3,6,2,468,470,8,2012-10-01 07:05:18,2012-10-01 07:05:18
26386ad615a48be02d896a41b7c72a7470c8a9c3...eb555b7a9d3924d6caba3a10c7f9cdd0e9afd38a,4,22,152,174,7,2012-10-01 07:06:44,2012-10-01 07:06:44
eb555b7a9d3924d6caba3a10c7f9cdd0e9afd38a...56935c64c088c7ea2db16fd78f4ad717dba825fc,2,0,7,7,2,2012-10-01 07:11:05,2012-10-01 07:11:05
56935c64c088c7ea2db16fd78f4ad717dba825fc...8da78223ffe7922f46167e7429c40339e7bc53d2,5,33,40,73,33,2012-10-01 07:19:29,2012-10-01 07:19:29
7e534ce98acf03229e09b8ae478cb3598d3882cd...432eaff29cc05f488fc0a1c87d1e28d86ef3641e,2,22,2,24,3,2012-10-15 19:35:32,2012-10-15 18:55:32
432eaff29cc05f488fc0a1c87d1e28d86ef3641e...cd5596393049e5c22f17f7f99764be1bfbc43ecc,1,3,2,5,3,2012-10-16 06:49:26,2012-10-16 06:49:01
cd5596393049e5c22f17f7f99764be1bfbc43ecc...ae0ba0686efcbf73116a21eb9aff3f9bede4a489,1,1,1,2,1,2012-10-16 08:16:38,2012-10-16 08:16:38
7e534ce98acf03229e09b8ae478cb3598d3882cd...ec8394cb6e07be7f20e53a4595f5e59974bf8bc3,1,170,0,170,1,2012-10-09 01:58:35,2012-10-09 01:58:35
ec8394cb6e07be7f20e53a4595f5e59974bf8bc3...4702e7541013922be933545057a9989136051a4e,1,2,0,2,2,2012-10-09 01:59:44,2012-10-09 01:59:44
4702e7541013922be933545057a9989136051a4e...b18c009051936e3dec86bf620da58847b321d307,1,1,1,2,1,2012-10-10 16:47:08,2012-10-10 16:47:08
3fa4ca2d871ba402f19f9c1d5e358baa023061a8...d4a16d35eb031cc4cffa4a3c4456fab406e286e5,2,2,2,4,2,2012-09-05 17:05:54,2012-09-05 17:05:54
c52368d3c5984b28e6a71e5e1240afdd788fc2e6...d19ca23f8fd8910eefbc344539fef0a8deed1992,1,1,0,1,1,2012-10-12 00:30:04,2012-10-12 00:30:04
c52368d3c5984b28e6a71e5e1240afdd788fc2e6...d49dd766c87ce97dc45f37f3198841ca4e02d9e6,1,4,2,6,2,2012-10-01 05:27:37,2012-10-01 05:27:37
c52368d3c5984b28e6a71e5e1240afdd788fc2e6...0944e036ae778f7efc9eeafcc33e58600e110fb0,2,8,3,11,3,2012-09-27 18:45:37,2012-09-27 18:45:37
c52368d3c5984b28e6a71e5e1240afdd788fc2e6...cc4f8b9f6c735400d76357884f8aa35d26e81574,1,3,0,3,1,2012-09-07 14:54:15,2012-09-07 14:54:15
c52368d3c5984b28e6a71e5e1240afdd788fc2e6...08b8571cb842e9fc668d9faf6c305a51523b27fb,36,49,49,98,49,2012-09-05 17:00:57,2012-09-05 17:00:57
545edf5459d0bdc25b65ba7ee9983cb6562c2842...e27b1355b58331eeb24915bee3e1c9dde4977f17,5,18,13,31,14,2012-08-28 17:12:04,2012-08-28 17:12:04
215d92bacd0d912cd9e73e822d928eeb891bf518...3568146b28e3eb22e4347062b1e4f923f87daeb8,4,6,6,12,6,2012-08-28 04:44:09,2012-08-28 04:44:09
88deb08ff27db0e016e0c030dce072f07b6bc7f4...80a645b52a7158a025e9bc88f615d5ad9343a1c8,9,0,0,0,0,2012-08-06 10:23:12,2012-08-06 10:23:12
88deb08ff27db0e016e0c030dce072f07b6bc7f4...25c61753113010887af7cd214f2950449e5e818c,1,30,30,60,26,2012-08-05 03:39:17,2012-08-05 03:39:17
88deb08ff27db0e016e0c030dce072f07b6bc7f4...fa38ab573b99e6e65184626b37867f50802b228f,1,1,1,2,1,2012-08-03 14:56:59,2012-08-03 14:56:59
d27dcf3b070015aca81d86de00e1b2ea6e0f30ff...33c6ab9b208ed01c4bd0909dd9aa5fc90280f049,1,1,1,2,1,2012-08-02 06:21:06,2012-08-02 06:21:06
33c6ab9b208ed01c4bd0909dd9aa5fc90280f049...f61dd7239bfe0aa750f4f0d4db74d5e060ea1183,1,1,1,2,1,2012-08-05 07:15:09,2012-08-05 07:15:09
fa6a131eb654515f690cea5209057af62e83505a...c10a357bb3aa75a0e1252f3bd17aa8a0476400a3,1,0,11,11,1,2012-07-24 19:57:00,2012-07-24 19:57:00
c10a357bb3aa75a0e1252f3bd17aa8a0476400a3...880bdbc4dd05f98389d039062ab956f79c6236a4,1,16,10,26,6,2012-07-24 23:07:25,2012-07-24 23:07:25
880bdbc4dd05f98389d039062ab956f79c6236a4...f75277e62d3025fbeb3588a6790caa2ce92122f0,4,461,469,930,49,2012-07-27 04:45:19,2012-07-27 04:45:19
f75277e62d3025fbeb3588a6790caa2ce92122f0...4bb2a13776ac5addd3aa286cdad6506313983712,1,413,413,826,40,2012-07-27 04:45:30,2012-07-27 04:45:30
4bb2a13776ac5addd3aa286cdad6506313983712...79067721b110a60e24637cf3996cb0ffe9350475,2,375,649,1024,30,2012-07-27 06:21:06,2012-07-27 06:21:06
79067721b110a60e24637cf3996cb0ffe9350475...6474190746fd163375200119b9d2cc7066e05d43,4,20,17,37,15,2012-07-27 06:42:36,2012-07-27 06:42:36
6474190746fd163375200119b9d2cc7066e05d43...1e9b4506196bd448c4038151964733ca524c10bb,5,100,0,100,7,2012-07-27 07:06:43,2012-07-27 07:06:43
1e9b4506196bd448c4038151964733ca524c10bb...9d5c4312232ebb53b2499ed495851c0d61eb648c,4,74,33,107,12,2012-07-27 17:06:54,2012-07-27 17:06:54
9d5c4312232ebb53b2499ed495851c0d61eb648c...16b4ac0d8fd5fd2aa588a8b486b71b449e3821ca,4,123,26,149,10,2012-07-27 17:35:15,2012-07-27 17:35:15
16b4ac0d8fd5fd2aa588a8b486b71b449e3821ca...fe6a4b0b5497a78a085e85125f4397a27b7737dc,4,71,42,113,8,2012-07-27 22:42:58,2012-07-27 22:42:58
e38fa4b1f40b8e8f64ad904fd5ea3d6d7ab9dffc...c98b75c97949c34be62b63e79fa517347df35018,1,11,0,11,1,2012-07-24 07:48:45,2012-07-24 07:48:45
614d52bd7f86591a0b0ab09e1c16ee888610d8a3...2a0cf0f1312ff9edf96bed047758eb6e295b18ff,1,0,1,1,1,2012-07-24 05:50:38,2012-07-24 05:50:38
93b1519017ecf002883b72cd69d4e08fc2500697...74b167b86d981190120cbc8ba350e99702f0ec00,3,3,3,6,5,2012-07-13 21:25:47,2012-07-13 21:25:47
93b1519017ecf002883b72cd69d4e08fc2500697...6e622ee763867baae6f0c58f026621ee0c200288,2,2,2,4,4,2012-07-13 18:18:35,2012-07-13 18:18:35
6e622ee763867baae6f0c58f026621ee0c200288...463de252a9d695d6b52045e5e7df4e7b82ffb116,4,118,28,146,14,2012-07-13 21:20:25,2012-07-13 21:20:25
463de252a9d695d6b52045e5e7df4e7b82ffb116...750badabf760d7fb0a68a1a214442ecbdff8a16c,5,11,6,17,8,2012-07-13 21:43:51,2012-07-13 21:43:51
750badabf760d7fb0a68a1a214442ecbdff8a16c...e20d2dfe9d1f43e164d8fdbef64f4041df70b762,8,35,19,54,18,2012-07-15 23:13:25,2012-07-15 23:13:25
b1cb5565039f492766fdfd727f776f3e9dfa7e45...3add79c071b3682c294bb4c50b8c008f9b91d0d8,1,1,1,2,1,2012-06-17 19:40:36,2012-06-17 19:40:36
b1cb5565039f492766fdfd727f776f3e9dfa7e45...626b45d691f9fc6c5ebc914ad0238bd8990e9c0b,1,2,2,4,2,2012-06-15 20:07:44,2012-06-15 20:07:44
b1cb5565039f492766fdfd727f776f3e9dfa7e45...fb31cdba9c839ffa1b75993534f6c682daf1a468,1,3,13,16,13,2012-06-15 12:23:40,2012-06-15 12:23:40
79d7092a393728ffeb94f592b8e8a0bca29f361e...839ef3a030b355d0f0c35d6c9e42ecba8b072036,25,36,36,72,36,2012-04-24 09:19:02,2012-04-24 09:19:02
11d7ef1515a09559b287089782abf85827e667c4...9d0328ff00a1fa28f58b3cefa826bed9e21ab580,2,6,2,8,4,2012-01-27 16:21:39,2012-01-27 16:21:39
11d7ef1515a09559b287089782abf85827e667c4...942d1b459568acb9f66525f8f6316a252a199e02,12,234,52,286,40,2012-01-27 14:33:18,2012-01-27 14:33:18
942d1b459568acb9f66525f8f6316a252a199e02...acaa3b59775d6e4c3f4776027bb325b418dca6b5,2,0,0,0,0,2012-01-27 16:02:57,2012-01-27 16:02:57
c63175dc1d41e2d26e50194a7e24cc0ea618446b...aa594501bd24d51181dc3504602aa4aaefb1cb60,4,19,6,25,8,2012-01-27 07:16:02,2012-01-27 07:16:02
8ef21c73aa49a487ffd2e406ae830edb2bf460b5...7d4ce8104a29699972ac817c5d8ac769bd658dd1,1,1,1,2,1,2015-02-09 00:31:19,2015-02-09 00:31:19
253dfc0d3d824375d6119a78e76a676d91141ebe...a14665e73e09b12f4ce6c742b524bd909087e2f7,2,6,2,8,2,2015-03-09 13:47:34,2015-03-09 13:47:34
253dfc0d3d824375d6119a78e76a676d91141ebe...a5243ad3d0a380c7c40c984f21200ca9932e43b8,1,1,1,2,1,2015-03-09 13:43:41,2015-03-09 13:43:41
f65bd7bed0de3e56cebdfc95ca9078c290ec6db4...f972a84dd79cf73a7eb14f8977aecafa142bba4c,3,2,8,10,8,2015-03-09 16:21:12,2015-03-09 16:21:12
cd4467b19404c9775764560b7636f51c4126ae78...a7747dedf24b1a7245bc3088f265280873acd627,2,6,2,8,2,2015-01-28 19:10:59,2015-01-28 19:10:59
690abbcc0cd74e31e0edeeebf2e7f576e39884c0...074419298eca781ea0cbe3a9988f44f85afb3eef,1,5,5,10,5,2015-02-21 04:02:20,2015-02-18 19:16:49
074419298eca781ea0cbe3a9988f44f85afb3eef...b4a5f89ab3a360d29994eea69b3bdce66115c244,1,1,0,1,1,2015-02-21 04:10:04,2015-01-23 19:14:10
b4a5f89ab3a360d29994eea69b3bdce66115c244...02f8cf9d0e3758d7fcffcda5ea7ba041b88b5e04,3,3,2,5,3,2015-02-21 04:21:05,2015-02-21 04:21:05
c8b0f59fbdc474b0e3cb48bff3b23f9c1793c5ae...5af5d6fa7b0309b9bd108c59ca26833db8b33f9c,1,1,1,2,1,2015-02-11 00:23:54,2015-02-11 00:23:54
136058b56271adbc8b4c2deb95d56d2baaad19f2...30b74105dd3d01dacfb0b232a671a8308c9fe588,2,3,3,6,4,2015-01-20 21:04:55,2015-01-20 21:04:35
30b74105dd3d01dacfb0b232a671a8308c9fe588...92b267f357c43148327e1247ac48c6eabc9891dd,1,24,24,48,2,2015-01-20 21:05:58,2015-01-20 21:05:38
22a4d96e9a04bbffed1a9b752eda5cc356300dc3...c8be2a063ae45497021a96dc53dc2d066f214867,2,2,2,4,2,2015-01-21 21:20:51,2015-01-21 21:20:51
2641ba6f0f4d3a616976005f5a1017741ad9da1d...5e26ad4921fe684623d0dabe5f2117ff9b07261a,3,4,3,7,3,2015-01-22 03:01:38,2015-01-22 03:01:38
e4c7a92c76865545f76a84d75cfa19024d5001a5...ad138ed885626280be7e9c55b1719b1282e73817,2,8,8,16,2,2014-12-30 00:44:33,2014-12-30 00:44:33
ad138ed885626280be7e9c55b1719b1282e73817...96e108f2b27a5a7f6ffc72dfd083171d07c8aa70,2,45,1,46,4,2014-12-30 00:54:29,2014-12-30 00:54:29
96e108f2b27a5a7f6ffc72dfd083171d07c8aa70...57a64be74970a6652b65168ebc7dd88c7f9093d8,1,1,1,2,1,2014-12-30 01:00:44,2014-12-30 01:00:04
57a64be74970a6652b65168ebc7dd88c7f9093d8...35073fc1287654caa657fb17a2ac97103717df7a,1,1,2,3,2,2014-12-30 01:01:05,2014-12-30 01:00:21
e4c7a92c76865545f76a84d75cfa19024d5001a5...27bfef5b35f3e12af8beb7140e3b19bb6a3b3a75,1,38,0,38,1,2014-12-30 00:09:37,2014-12-22 22:02:31
2166f238d7c01d35d663b762bb770227df50f65e...5a35555a72e96e4083e2be559b12d75e8095a1c6,4,12,24,36,7,2014-12-30 12:31:08,2014-12-30 12:31:08
5a35555a72e96e4083e2be559b12d75e8095a1c6...c3e6111eef4778e14d97cb932b7d1ee13443b5c0,1,4,4,8,1,2014-12-30 19:48:08,2014-12-16 07:00:04
f9db33d7dbc464a71d2143e3dd323fd7db47773b...f2ecc775620dc67f97179536d4638c9af6e1f9dc,1,1,1,2,1,2014-12-12 21:21:49,2014-12-12 20:41:51
f2ecc775620dc67f97179536d4638c9af6e1f9dc...5f41801083d202fda57d4581c24c6333afcb274a,1,221,31,252,17,2014-12-12 21:22:09,2014-12-12 21:20:06
e41127efe4f9f9acffe023a70a749a9cd8c8b977...8deda6116f8f72b34ee46cd43c083aad7e13e406,1,5,0,5,1,2014-12-16 00:25:43,2014-12-16 00:25:43
35bced0308de50036d1bf796bd4e5998463fcaef...e674ea553d13429e51044d46ccc6908c341c7fe2,1,1,0,1,1,2014-12-15 19:58:55,2014-12-15 19:54:50
13426c18a328cd89024d8f15d8f21822a21385d1...48b822db409d75e2531111e890d38e0eb1126f13,1,1,1,2,1,2014-07-03 17:52:22,2014-07-01 02:12:46
48b822db409d75e2531111e890d38e0eb1126f13...4b0883230866b018f2cbfdc90071ee405b1f3faf,1,1,1,2,1,2014-07-03 17:52:22,2014-07-01 02:22:18
a3ebd0104c2446850025f3826321788a53952b40...031734c1d142b667985a99956e9d31540eccff27,1,1,1,2,1,2014-07-22 02:37:22,2014-07-22 02:37:22
031734c1d142b667985a99956e9d31540eccff27...e3f4072a9e1f1163c5b7b6a52d9b2632569f90fb,1,1,1,2,1,2014-07-22 02:38:30,2014-07-22 02:38:30
ed8228e1cbf73c1919c291054f4ea1309923cdae...5c1746c556753a19a980ab13d0ce23daebb6022f,1,1,1,2,1,2014-07-14 21:52:36,2014-07-14 21:50:53
c77d4266c0ff1708c582d2c7d4fe5a777d274cdf...32181816f714b1e9ed83a925b6334efca3cbd5ff,1,2,1,3,1,2012-10-01 17:27:42,2012-10-01 17:27:42
32181816f714b1e9ed83a925b6334efca3cbd5ff...085d6d185d7695d0816315aeee5e3a8ed3c60585,2,40,34,74,6,2012-10-01 17:42:45,2012-10-01 17:42:45
085d6d185d7695d0816315aeee5e3a8ed3c60585...239ce24f92688f0dca44a4f74f9f5f70f04af1e5,2,4,2,6,2,2012-10-01 17:49:19,2012-10-01 17:48:57
239ce24f92688f0dca44a4f74f9f5f70f04af1e5...a90334eebb0199c15f32059d9d3a285498dec188,1,4,1,5,2,2012-10-01 18:11:33,2012-10-01 18:11:33
a90334eebb0199c15f32059d9d3a285498dec188...c6c1ada60074e420fa93174cb3db167faf618e2b,2,2,2,4,2,2012-10-01 18:18:49,2012-10-01 18:18:49
40a8a93b22b43629ae2f879a1dbae64bade5db49...da43c7c27cb08a76775ad64b5caa210630d0c2cd,1,4,2,6,2,2012-10-01 05:41:26,2012-10-01 05:41:26
7c9597f4e76d45571fab7a0e19d90b2fea8aab02...1bd47230389c9174849f88cc09eda433a6d8dee5,2,6,2,8,2,2012-10-02 20:19:11,2012-10-02 20:19:11
1bd47230389c9174849f88cc09eda433a6d8dee5...a2369021ce49e07c073c35426cc978dba2cb1b55,2,2,2,4,2,2012-10-02 22:10:22,2012-10-02 22:10:22
7c9597f4e76d45571fab7a0e19d90b2fea8aab02...b892a373208fd17eb7b0123147715d3bf0a5b2ca,1,4,4,8,4,2012-10-02 15:26:55,2012-10-02 15:26:55
c33169a6bae8675bd65767690d9098a4f9c071a9...92e7f166e7b65259cffcf20a27984bc365dd8b48,7,10,5932,5942,7,2012-10-30 04:27:34,2012-10-30 04:27:34
c33169a6bae8675bd65767690d9098a4f9c071a9...41ad16fe406956cc8604b295ae0b5f185386c595,38,57,57,114,54,2012-10-30 04:00:53,2012-10-30 04:00:53
c33169a6bae8675bd65767690d9098a4f9c071a9...233e050adfc171685fd2c2f6ad760a8556aa0eb2,4,104,28,132,23,2012-10-26 07:47:55,2012-10-26 07:47:55
b18c009051936e3dec86bf620da58847b321d307...31007c01d8e5a3ad87597e56e2240693347a2a2c,2,1,5,6,5,2012-10-10 17:29:22,2012-10-10 16:51:13
b18c009051936e3dec86bf620da58847b321d307...5af5c2ed368e8b728306b90082d32719d5a15b54,2,1,5,6,5,2012-10-10 16:51:13,2012-10-10 16:51:13
d4a16d35eb031cc4cffa4a3c4456fab406e286e5...7a0f5c6c00ab7f70346e59503f850c5b5623f908,2,20,18,38,10,2012-09-07 18:04:51,2012-09-07 18:04:51
d4a16d35eb031cc4cffa4a3c4456fab406e286e5...138b5a8c0569e548ec93803aaa88ea7033363680,4,10,10,20,8,2012-09-06 02:07:52,2012-09-06 02:07:52
1f8e2d2617e6fe9feebdf94c1cc0176899c1f722...f29f98501c11678e2ecfe8fd5c842adcd5a40091,1,3,0,3,1,2012-09-07 18:42:21,2012-09-07 18:42:21
e27b1355b58331eeb24915bee3e1c9dde4977f17...2137cd65fb528d0eadd15c2554250a12b5764bfd,2,21,19,40,2,2012-08-29 20:05:43,2012-08-29 20:05:43
2137cd65fb528d0eadd15c2554250a12b5764bfd...2da2169a56bf16c24c10914deaead344e2af3bb0,2,6,2,8,4,2012-08-29 20:06:47,2012-08-29 20:06:47
e27b1355b58331eeb24915bee3e1c9dde4977f17...a976a1583c462ddc50ed672c36c1a79a3c6acc4c,1,7,0,7,1,2012-08-29 11:24:00,2012-08-29 11:24:00
e27b1355b58331eeb24915bee3e1c9dde4977f17...0b122bc5c526724992036a8e286079188ade3b10,10,174,1235,1409,126,2012-08-28 20:33:06,2012-08-28 20:33:06
0b122bc5c526724992036a8e286079188ade3b10...cb46ddee72eb45f835504a625947c821c8f60635,1,9,3,12,2,2012-08-28 20:46:13,2012-08-28 20:46:13
a525a6fe33afde7d4ab4a0febaaed76ff0393505...4eee78e0513c2c08b26fb57c43d57b9cb0857a87,2,33,26,59,6,2012-08-08 05:50:49,2012-08-08 05:50:49
4eee78e0513c2c08b26fb57c43d57b9cb0857a87...03eee2395267f466475ee5f4369f21016b4b3a3b,1,3,3,6,3,2012-08-08 06:02:01,2012-08-08 06:02:01
03eee2395267f466475ee5f4369f21016b4b3a3b...85f1f2257bb33b6775177b309cc36b50ed801d02,1,0,0,0,0,2012-08-08 06:05:39,2012-08-08 06:05:39
85f1f2257bb33b6775177b309cc36b50ed801d02...3c89f7bb5f69900db2d89348428019edd8fa7850,3,5,5,10,5,2012-08-08 06:07:53,2012-08-08 06:07:53
3c89f7bb5f69900db2d89348428019edd8fa7850...08e4475f007c1342ee6f8ab7362a9b8965ac391a,2,86,84,170,10,2012-08-08 06:11:23,2012-08-08 06:11:23
08e4475f007c1342ee6f8ab7362a9b8965ac391a...f6c7ac51f2761a666c933f584a558f0c24381a3a,2,17,15,32,4,2012-08-08 18:26:22,2012-08-08 18:26:22
f6c7ac51f2761a666c933f584a558f0c24381a3a...e06c257e6b38d5db0c3eb97724faf21bc534faf6,2,4,4,8,4,2012-08-09 18:25:34,2012-08-09 18:25:34
e06c257e6b38d5db0c3eb97724faf21bc534faf6...9f8ce77751e3c80d3cb794af9a19170e7f47a1fa,5,10,3,13,5,2012-08-13 17:05:19,2012-08-13 17:05:19
aeed751a7fa2f55e5ec8e6814c22c5d763048098...0cb3ba6b23a55361727239614269a405d02ec8be,1,30,30,60,26,2012-08-08 05:34:39,2012-08-08 05:34:39
0cb3ba6b23a55361727239614269a405d02ec8be...8ed77c41f0a38556371eae7dbfdd07625bf7fca2,3,10,2,12,3,2012-08-08 05:37:38,2012-08-08 05:37:38
b0437bef7659c758398abd548fdee68e042cb336...6bfa58ea4d1eec673a4f99f3668ea558bef2feb9,1,2,2,4,2,2012-08-15 13:37:49,2012-08-15 13:37:49
6bfa58ea4d1eec673a4f99f3668ea558bef2feb9...ddefdbf31f8fcf9088d1ca59346bc42118bd991e,1,1,0,1,1,2012-08-15 13:38:21,2012-08-15 13:38:21
ddefdbf31f8fcf9088d1ca59346bc42118bd991e...27e9214e056b1f4e833adc92fe7afe2e75f53cb2,1,1,1,2,1,2012-08-15 13:38:59,2012-08-15 13:38:59
27e9214e056b1f4e833adc92fe7afe2e75f53cb2...48f5626499024df6a5cf386a5456c9ff03564644,1,1,1,2,1,2012-08-15 14:07:43,2012-08-15 14:07:43
b0437bef7659c758398abd548fdee68e042cb336...6a1521327b207b0043095f09511d43ddea5f7b25,1,1,1,2,1,2012-08-15 08:56:52,2012-08-15 08:56:52
fe6a4b0b5497a78a085e85125f4397a27b7737dc...5184da39f404416252c3586300eafc8d8f9938f9,20,0,1,1,1,2012-07-29 07:44:55,2012-07-29 07:44:55
5184da39f404416252c3586300eafc8d8f9938f9...e56a70084949269dbde3473a0f67b1a7eef30010,1,2,2,4,2,2012-07-29 19:07:18,2012-07-29 19:07:18
e56a70084949269dbde3473a0f67b1a7eef30010...134d11b5283de087a6f069e59fbceed3de52092e,1,1,2,3,1,2012-07-29 19:10:29,2012-07-29 19:10:29
fe6a4b0b5497a78a085e85125f4397a27b7737dc...a30045daef809edf5ed592ad842c04377898e444,21,625,284,909,86,2012-07-29 07:30:15,2012-07-29 07:30:15
40ab928315f4db0566c92b36373ff60b3abfffbc...2ee9b2717bfd532e93eb6d4037ae7ca7a5436957,5,26,8,34,13,2012-07-16 23:01:11,2012-07-16 23:01:11
2ee9b2717bfd532e93eb6d4037ae7ca7a5436957...117f65d43108d5d7ff1c5011f0b8b61f7ef3b9dd,5,8,2,10,8,2012-07-20 16:47:12,2012-07-20 16:47:12
117f65d43108d5d7ff1c5011f0b8b61f7ef3b9dd...393f4a7b4244233a6ad24a48b68869329f4756b8,2,4,4,8,3,2012-07-22 21:19:11,2012-07-22 21:19:11
393f4a7b4244233a6ad24a48b68869329f4756b8...d76c8991424b91050636fb94e740daa123306e95,3,4,18,22,7,2012-07-22 21:36:23,2012-07-22 21:36:23
e20d2dfe9d1f43e164d8fdbef64f4041df70b762...478396fd4eaacd505104f44f97e0470409ce433a,2,0,14,14,2,2012-07-18 02:11:41,2012-07-18 02:11:41
bae3cfd18343ce4909b26f03ee0008f0de1d2d46...9aa5a6db12fcbc1638610132c1a0f64633325f44,3,24,13,37,11,2012-06-19 20:21:35,2012-06-19 20:21:35
9aa5a6db12fcbc1638610132c1a0f64633325f44...143b6ae2de0e7f0c4e835a20765c81c26dba0423,2,4,4,8,4,2012-06-19 20:23:30,2012-06-19 20:23:30
143b6ae2de0e7f0c4e835a20765c81c26dba0423...d14f06fc4ed3f4753de9ae5ef247c48629714935,2,4,4,8,4,2012-06-19 20:25:35,2012-06-19 20:25:35
d14f06fc4ed3f4753de9ae5ef247c48629714935...64ba423b6d06c98e95e23d8c34df62a47a421a03,5,87,2,89,8,2012-06-19 20:52:07,2012-06-19 20:52:07
64ba423b6d06c98e95e23d8c34df62a47a421a03...b54264cde0b1e72fbb463e4aa272ed1c2876bd02,4,120,0,120,4,2012-06-19 21:42:46,2012-06-19 21:42:46
b54264cde0b1e72fbb463e4aa272ed1c2876bd02...ff92344f0d6cca2e00a73b9edf204c4231130d07,2,0,60,60,2,2012-06-19 21:46:14,2012-06-19 21:46:14
ff92344f0d6cca2e00a73b9edf204c4231130d07...40298ddbf1c26e2c9b7f67a39eeb35734417cc7e,2,14,18,32,4,2012-06-19 22:25:35,2012-06-19 22:25:35
40298ddbf1c26e2c9b7f67a39eeb35734417cc7e...9df832b4bb81d80fd02b4fe6cc9ea826b0b0454e,5,39,6,45,9,2012-06-20 02:17:42,2012-06-20 02:17:42
9df832b4bb81d80fd02b4fe6cc9ea826b0b0454e...ce140662a0a52d8ff2cd1acee4a57591d336249d,3,4,12,16,4,2012-06-20 03:01:03,2012-06-20 03:01:03
ce140662a0a52d8ff2cd1acee4a57591d336249d...d704d6f0ed3d87377b2c53f29c5d196f75c24e6d,2,20,10,30,10,2012-06-20 06:37:47,2012-06-20 06:37:47
d704d6f0ed3d87377b2c53f29c5d196f75c24e6d...089f42a07fd9e7ed393e9e4961ec4f5ff61aa173,2,4,4,8,4,2012-06-20 07:06:05,2012-06-20 07:06:05
089f42a07fd9e7ed393e9e4961ec4f5ff61aa173...b2b000b7502901e53cf499e68d8dd5bf522d3d4f,4,4,4,8,4,2012-06-20 17:40:56,2012-06-20 17:40:56
bae3cfd18343ce4909b26f03ee0008f0de1d2d46...6a974f9ff7962afc9aaf5510055e574d147a6c42,3,19,1,20,5,2012-06-19 02:25:54,2012-06-19 02:25:54
6a974f9ff7962afc9aaf5510055e574d147a6c42...47e06470866b95cc9c5a2885754a169afd74de39,2,19,0,19,2,2012-06-19 02:51:49,2012-06-19 02:51:49
47e06470866b95cc9c5a2885754a169afd74de39...af88f54e5d70c8a9e342f14f937aa5985b4b9d68,1,1,1,2,1,2012-06-19 02:56:52,2012-06-19 02:56:52
af88f54e5d70c8a9e342f14f937aa5985b4b9d68...3a5b4cc7df5f63b39218fbae75d6604e08f89e2a,2,2,6,8,2,2012-06-20 17:42:25,2012-06-20 17:42:25
9d0328ff00a1fa28f58b3cefa826bed9e21ab580...e44a7dd4ff2d505e6bc41ba0a5fdf66650cdf605,2,11,3,14,5,2012-01-27 17:36:49,2012-01-27 17:36:49
9d0328ff00a1fa28f58b3cefa826bed9e21ab580...6075b5dee6c892b991e8a00de70942f28f9a1c14,1,1,0,1,1,2012-01-27 17:08:56,2012-01-26 22:32:11
6075b5dee6c892b991e8a00de70942f28f9a1c14...841e386daf01e06f2eba00725545f3e3315334b3,1,7,0,7,1,2012-01-27 17:08:56,2012-01-26 22:32:44
841e386daf01e06f2eba00725545f3e3315334b3...526d38839332907062cde27727900deb06e0c50b,1,9,0,9,1,2012-01-27 17:16:17,2012-01-26 23:03:53
526d38839332907062cde27727900deb06e0c50b...f51e703ba6a87ad504682c16b6dd747ebcfd2afb,1,14,2,16,6,2012-01-27 17:16:36,2012-01-27 17:16:36
3b3dbd7229f53eb71759def4eca90dfd7a2699f8...70d95b1bd72a039d47695495aac6b71da17df7dc,1,2,1,3,2,2012-01-27 21:09:58,2012-01-27 18:27:55
70d95b1bd72a039d47695495aac6b71da17df7dc...7b31f4a33467d8e69c0723525b8d9d8e024eaeb6,1,7,1,8,2,2012-01-27 21:09:58,2012-01-27 18:56:41
7b31f4a33467d8e69c0723525b8d9d8e024eaeb6...43f1a42f7f254ad5d776564122bdae6547a4fbcd,2,2,0,2,2,2012-01-27 21:10:34,2012-01-27 18:57:51
43f1a42f7f254ad5d776564122bdae6547a4fbcd...347a15b69aff9cf3f9bc5c47c9bcadb459eb895b,3,40,10,50,8,2012-01-27 21:10:40,2012-01-27 19:17:06
347a15b69aff9cf3f9bc5c47c9bcadb459eb895b...8328987b15e0bb9e1c2ee1bd90e8dee9843f0ea7,2,39,12,51,10,2012-01-27 21:10:40,2012-01-27 21:06:58
8328987b15e0bb9e1c2ee1bd90e8dee9843f0ea7...faa719d59c45eb05a7e77db311d7bb277341f85d,1,2,0,2,2,2012-01-27 21:35:21,2012-01-27 21:35:21
faa719d59c45eb05a7e77db311d7bb277341f85d...a1fc352cc2b8e94557c1414178a59c73a6c3b849,1,1,1,2,1,2012-01-27 21:35:40,2012-01-26 22:03:15
a1fc352cc2b8e94557c1414178a59c73a6c3b849...1c9db106fadd544d8af93a60c128842f95724f03,2,23,25,48,2,2012-01-27 21:39:27,2012-01-27 21:39:27
1c9db106fadd544d8af93a60c128842f95724f03...84b9a1bfb6ff5d1406f5c0393d6556caff6de40c,2,57,8,65,25,2012-01-27 21:39:38,2012-01-27 21:39:38
e4d6fbf715e81717f12cef9f181c7dfa3430cb87...fbc5d8ee414519b7c7af0a1f35c86f900e0e7aa9,2,2,2,4,2,2015-03-09 14:03:04,2015-03-09 14:03:04
1383b883288887a90e6f04c8752364f3c85ded2a...a890ebde94793a0859ac79d06da03b8c9c103371,1,10,0,10,1,2015-03-10 10:29:58,2015-03-10 10:29:58
a7747dedf24b1a7245bc3088f265280873acd627...0ee76022841b1ef4ad48050680dafe4ea43f5967,1,3,0,3,3,2015-02-19 23:02:51,2015-01-29 13:19:09
a7747dedf24b1a7245bc3088f265280873acd627...2dfc58fa5cff5b8d4776df6229a7294548426c06,2,7,3,10,4,2015-02-03 13:58:11,2015-01-29 21:51:21
a7747dedf24b1a7245bc3088f265280873acd627...97e5ac1c92227c85599b7a20f610890c008ec90c,1,1,1,2,1,2015-01-30 02:00:49,2015-01-30 02:00:49
97e5ac1c92227c85599b7a20f610890c008ec90c...420088d3161fa7caf781afb1e6e553d0a42b99ef,2,195,77,272,44,2015-01-30 13:13:24,2015-01-30 13:04:53
420088d3161fa7caf781afb1e6e553d0a42b99ef...8fd5718e71844d575e5a46144e30ec07fc325703,4,12,8,20,7,2015-01-30 13:13:24,2015-01-30 13:07:05
8fd5718e71844d575e5a46144e30ec07fc325703...feb0da4c2f70cf88641de4c567dd85bea99de46a,1,2,2,4,1,2015-01-30 13:14:57,2015-01-30 13:14:57
a7747dedf24b1a7245bc3088f265280873acd627...119ce267a60732ba98513e5ed329baa3d866168a,1,1,1,2,1,2015-01-29 12:46:45,2015-01-29 12:46:45
a7747dedf24b1a7245bc3088f265280873acd627...91b384399c3c7c299466c595235640f336b3fc15,1,0,5,5,1,2015-01-29 03:21:07,2015-01-29 03:21:07
02f8cf9d0e3758d7fcffcda5ea7ba041b88b5e04...b9504feb80d7fa95d84ef292097c270744aa4127,1,1,1,2,1,2015-02-21 14:00:04,2015-02-21 14:00:04
51b00ce737e31a8494d2138b3fdefabc7aeef09d...5f5b148e498c065af6aee5274a7da75fbae6d449,1,2,2,4,2,2015-02-12 00:25:51,2015-02-12 00:25:51
5f5b148e498c065af6aee5274a7da75fbae6d449...6379674f35771ffe007f11bd498ad39c4defe8a4,6,4,64,68,57,2015-02-12 06:41:05,2015-02-12 06:41:05
6379674f35771ffe007f11bd498ad39c4defe8a4...19a6406ec4ca3b98a9a6a1aa205829117e07eab4,1,5,5,10,1,2015-02-12 18:36:15,2015-02-12 18:36:15
19a6406ec4ca3b98a9a6a1aa205829117e07eab4...0fe6ff9fca5acc1e605276057dbbaf7fee7446cc,1,2,2,4,2,2015-02-12 18:40:00,2015-02-12 18:40:00
0fe6ff9fca5acc1e605276057dbbaf7fee7446cc...763f8293da90a4c4102f9fae049232662ca2696f,1,1,1,2,1,2015-02-12 18:41:16,2015-02-12 18:41:16
d9f437f4ecf5d4be8d30219a1ed2a113d65e79d4...2e20e67dc1f1923ee144c5588ab0f686e4bdd130,2,4,0,4,2,2015-01-21 03:22:20,2015-01-21 03:22:20
d9f437f4ecf5d4be8d30219a1ed2a113d65e79d4...07a3ea5f54e6495fa3d8f548b374a312119ce0f1,3,20,0,20,9,2015-01-21 00:24:48,2015-01-21 00:24:34
c8be2a063ae45497021a96dc53dc2d066f214867...426e8e12cdbbfd6080d0a861b456538c0c123d4b,1,1,1,2,1,2015-01-21 22:13:26,2015-01-21 22:13:26
9dc3cf7f19f8b24367e0db005e2bc3ba8a39fd96...32cb0715949e5ab20716121234d858e51f3ff386,1,3,3,6,3,2014-12-30 02:34:35,2014-12-30 02:34:35
c3e6111eef4778e14d97cb932b7d1ee13443b5c0...5ccfd98c31c1a53f89a71f98307e1b52fa451988,2,7,0,7,2,2014-12-30 21:32:28,2014-12-30 21:03:36
79af63aac907a340e2eb9372f250b01442c86e08...74df3175b9ec9aae3d72e27a60f2faced6ac8750,1,1,1,2,1,2014-12-12 21:42:43,2014-12-12 21:42:43
74df3175b9ec9aae3d72e27a60f2faced6ac8750...0d413c5c0824223b77edf1c46309dde7fda6cf3d,1,380,200,580,12,2014-12-12 22:08:03,2014-12-12 22:08:01
8deda6116f8f72b34ee46cd43c083aad7e13e406...32f62bc565882b989fcef62874c0a90b0241dd1e,1,6,1,7,1,2014-12-18 06:29:34,2014-12-16 05:23:04
8deda6116f8f72b34ee46cd43c083aad7e13e406...f73b341639cebe9bce92c7edcadaa90fd1bbf1a8,1,5,0,5,1,2014-12-17 21:13:23,2014-12-17 21:10:47
8deda6116f8f72b34ee46cd43c083aad7e13e406...75517230540feabc270ff089c0008380a6dc0c37,1,4,0,4,1,2014-12-17 16:19:06,2014-12-17 16:19:06
9875ce8d633425365fa24e607c4080598cec1c2c...8340d664ce5875c15393017e4f3b06c458215469,1,1,1,2,1,2014-07-03 19:58:10,2014-07-03 18:45:49
8340d664ce5875c15393017e4f3b06c458215469...24e51590b78d60213042df2d454ee82b40745591,1,1,1,2,1,2014-07-03 19:58:20,2014-07-03 18:49:32
24e51590b78d60213042df2d454ee82b40745591...7f4af4aeeac5e93dcb69b5c820e8e791077cc787,1,3,1,4,1,2014-07-06 06:43:29,2014-07-06 06:42:30
e3f4072a9e1f1163c5b7b6a52d9b2632569f90fb...7ba5c5d5e4f8fba4877bae9e423afbecbffa3e17,2,10,5,15,4,2014-07-22 05:25:35,2014-06-11 06:30:30
7ba5c5d5e4f8fba4877bae9e423afbecbffa3e17...8d435cbb3c88760297a31f32a71c63c3b340ecda,8,295,250,545,60,2014-07-22 05:25:41,2014-07-22 05:25:41
5c1746c556753a19a980ab13d0ce23daebb6022f...aa730472549087e9a1a76d4031d7f54867372097,1,1,1,2,1,2014-07-15 16:28:48,2014-07-15 16:28:48
5c1746c556753a19a980ab13d0ce23daebb6022f...74691b7e27b1015085427e024ff31d2b6b24de0a,2,4,0,4,2,2014-07-15 00:17:38,2014-07-15 00:16:11
c6c1ada60074e420fa93174cb3db167faf618e2b...50355929887bf1ff3ecbf4269d0ff05438a6ef5a,2,10,0,10,2,2012-10-01 18:53:52,2012-10-01 18:53:52
50355929887bf1ff3ecbf4269d0ff05438a6ef5a...bc4f5d565ef2a7a8ff71f255d3c147efef4f7039,2,8,4,12,6,2012-10-01 19:04:10,2012-10-01 19:04:10
bc4f5d565ef2a7a8ff71f255d3c147efef4f7039...f8ac403d8b9fde348fe333903a62d644ce795826,2,38,109,147,14,2012-10-01 20:08:21,2012-10-01 20:08:21
f8ac403d8b9fde348fe333903a62d644ce795826...fd1e9b1498f3bae87025839bf44865d937795cc7,2,2,2,4,2,2012-10-01 20:28:54,2012-10-01 20:28:54
fd1e9b1498f3bae87025839bf44865d937795cc7...86d5ed6f4f688f8aa67a26c9b1f664123edf716f,2,8,8,16,8,2012-10-01 20:52:50,2012-10-01 20:52:50
86d5ed6f4f688f8aa67a26c9b1f664123edf716f...d36e37214b718ed27a49f49ac4c6e72f373cbd0c,1,1,0,1,1,2012-10-01 22:26:17,2012-10-01 22:26:17
4ab7b77aa3750ffb64bfc544850c2722053ebbda...3bb9e0d7538f1899ed8681b6ca2ced65822a155a,2,2,2,4,2,2012-10-02 06:42:21,2012-10-02 06:42:21
31c1eba51bf3f5a988e7bef9da88372e673c30c2...f595e146d604c24ff3ab4e76267973d5d6ce452e,1,1,1,2,1,2012-10-30 04:29:05,2012-10-30 04:29:05
41ad16fe406956cc8604b295ae0b5f185386c595...81c3c1c68cf7cb8a76f9766b1acc55868e647954,3,30,28,58,21,2012-10-30 04:02:05,2012-10-30 04:02:05
81c3c1c68cf7cb8a76f9766b1acc55868e647954...9352fe175044f85df6a60dfd1877735cb6c543d5,2,58,0,58,8,2012-10-30 04:30:39,2012-10-30 04:30:39
68f26d959f97c761206bf5f6f808e6199d620ca2...28da31218fc5dc39ece625705c37b8c86d494801,4,26,47,73,11,2012-11-04 20:36:37,2012-11-04 20:36:37
df9a1c29f4ba246667e51f477e66f5f95f57dd8e...fa778792c5a00577cc2f59f70499b60bda2a8457,10,384,0,384,1,2012-10-11 00:58:22,2012-10-11 00:58:22
a249d1c8ee597c4f0f29da55b15cf35accd4221c...a12eb2b9f5457f53639938b800766fd856bda415,3,9,9,18,8,2012-11-03 20:44:55,2012-11-03 20:44:55
a12eb2b9f5457f53639938b800766fd856bda415...c0eacca0dbf9fec606968e08e1b21f8ec80e67ef,6,204,302,506,72,2012-11-03 23:14:44,2012-11-03 23:14:44
6c5c3c81ecf6f329e950ca4e8970bbcaa7597043...f2bd7d9f276753a8a2ab27490d06c2a081abb3af,2,8,0,8,2,2012-09-07 18:10:00,2012-09-07 18:10:00
f2bd7d9f276753a8a2ab27490d06c2a081abb3af...61332d727e6e1d67def803b2f8d61047d79db0cc,4,60,0,60,5,2012-09-07 18:34:05,2012-09-07 18:34:05
b5af762ef59e1fa97f4386f5feadb67aa5183fef...404e4d9e9a082d2b7a6dfa1aee13709173f8e822,6,10,7,17,8,2012-10-31 04:32:15,2012-10-31 04:32:15
404e4d9e9a082d2b7a6dfa1aee13709173f8e822...3b3dd3ac3c7b69d02406ede69bffcc4ee8a1ed6b,37,50,50,100,50,2012-10-31 04:59:56,2012-10-31 04:34:39
b5af762ef59e1fa97f4386f5feadb67aa5183fef...cbf1dace2ff633503ef40d479d58e68647ef1534,2,2,2,4,2,2012-10-30 18:46:18,2012-10-30 18:46:18
f29f98501c11678e2ecfe8fd5c842adcd5a40091...76e42edb29301be6d2f1014bbd64939d3f6f39a4,2,2,2,4,2,2012-09-09 22:58:23,2012-09-09 22:58:23
7e2958121028b4fdfcd40f7d03dd3c37ceba6a51...9a39306abe0f21d60bfba649eda5394d6db017ab,2,0,208,208,2,2012-09-08 05:35:51,2012-09-08 05:35:51
9a39306abe0f21d60bfba649eda5394d6db017ab...b53da4b6e7744f2cb44a1cc323fa92ef6b52840d,5,107,14,121,13,2012-09-08 05:46:35,2012-09-08 05:46:35
b53da4b6e7744f2cb44a1cc323fa92ef6b52840d...dd1bce2611a83365c0b2fd14b14512180ec09ec1,6,256,8,264,11,2012-09-08 19:50:37,2012-09-08 19:50:37
dd1bce2611a83365c0b2fd14b14512180ec09ec1...7110b243f5c88274742477c80c2d08be3f259566,4,47,27,74,31,2012-09-10 17:11:02,2012-09-10 17:11:02
7110b243f5c88274742477c80c2d08be3f259566...527d01ce99a0cae8eae7868c0649dca60cda338c,7,434,399,833,117,2012-09-25 22:01:03,2012-09-25 22:01:03
9f8ce77751e3c80d3cb794af9a19170e7f47a1fa...e31f06b85785daba58fda8664adc4b0575763725,2,2,2,4,2,2012-08-13 18:22:08,2012-08-13 18:19:23
f9deb8017a81fd3d88306fab2d0a5715df9dfe74...5b947b8a2f801d33af2fe8d78f9655ce1ebd5e7c,4,22,5,27,14,2012-08-17 23:11:52,2012-08-17 23:11:52
5b947b8a2f801d33af2fe8d78f9655ce1ebd5e7c...256a25f25c8adc266f9af3099b5143cb49097443,2,4,4,8,6,2012-08-17 23:28:45,2012-08-17 23:28:45
256a25f25c8adc266f9af3099b5143cb49097443...1ae194597c3d0a9608803f9edbd05bc50b4844af,2,2,73,75,4,2012-08-17 23:32:34,2012-08-17 23:32:34
761429d88a0716b27c2c78d27dd1da467a8318e3...87ce3489d37ffa58c18de985808757785df8c7cc,2,8,21,29,4,2012-07-29 23:25:20,2012-07-29 23:25:20
87ce3489d37ffa58c18de985808757785df8c7cc...d63ebe3f3c885be05d93a1133d6feaa5be302536,2,6,6,12,4,2012-07-29 23:37:37,2012-07-29 23:36:16
d63ebe3f3c885be05d93a1133d6feaa5be302536...22a9a8365640cd8b09ee50580e7220e6d1d60e33,2,22,1,23,2,2012-07-29 23:51:24,2012-07-29 23:51:24
22a9a8365640cd8b09ee50580e7220e6d1d60e33...84a9c74efde9f5d7508a4c7cb330b452be9666ce,1,5,4,9,2,2012-07-30 06:51:18,2012-07-30 06:51:18
84a9c74efde9f5d7508a4c7cb330b452be9666ce...cfac4bb59d120c747a2b410f6574f28fa464e271,2,2,2,4,2,2012-07-30 06:51:40,2012-07-30 06:51:40
cfac4bb59d120c747a2b410f6574f28fa464e271...b63543181aad029167de60bc3563aadcd6f895fc,7,189,636,825,47,2012-07-30 17:08:27,2012-07-30 17:08:27
b63543181aad029167de60bc3563aadcd6f895fc...04164e4367134103a2ca94e49785a18b17032ec3,4,103,1,104,12,2012-07-30 17:25:04,2012-07-30 17:24:41
04164e4367134103a2ca94e49785a18b17032ec3...6bf661aceb934db79b148757aed5cd13ce174658,5,0,0,0,0,2012-07-30 17:33:48,2012-07-30 17:33:48
6bf661aceb934db79b148757aed5cd13ce174658...7fa99fb1fe9392f61cb5c46f7e5082e73e8b8784,5,18,17,35,10,2012-07-30 19:15:08,2012-07-30 19:15:08
7fa99fb1fe9392f61cb5c46f7e5082e73e8b8784...b2ebd5c46ca538142c5cd4164328c56053b5c79d,4,34,47,81,28,2012-07-30 19:52:44,2012-07-30 19:52:44
16fa610ea4303438e2c3f07759178803e8bc889c...4008d666a5e8c78766a68811b08f9b8500b1fc8e,2,18,1,19,2,2012-07-18 02:54:29,2012-07-18 02:54:29
4008d666a5e8c78766a68811b08f9b8500b1fc8e...25bc298aff5dc9175d36f1f1725d5ae39d110929,1,0,0,0,0,2012-07-18 02:55:02,2012-07-18 02:55:02
25bc298aff5dc9175d36f1f1725d5ae39d110929...62f6368344cd4d76eb7e10be209f9fe62e4456cf,1,2,2,4,2,2012-07-18 03:22:55,2012-07-18 03:22:55
97546adc90a9c8149bb4560641b4164338e38063...e8647c1b118d2c726a8987e9a41aad82da972b57,22,351,269,620,98,2012-01-27 21:20:02,2012-01-27 21:20:02
8da1c176ec9d1e48c6d9a9a26e37ae8a66103de2...3807a88ee9ba33f27bc8762efd789f7ff710ed1a,3,28,18,46,21,2012-01-27 21:56:50,2012-01-27 21:56:50
3807a88ee9ba33f27bc8762efd789f7ff710ed1a...6353e5070ae429297bdfb215f17093e4ccbc08f2,3,0,0,0,0,2012-01-27 22:03:36,2012-01-27 22:03:36
6353e5070ae429297bdfb215f17093e4ccbc08f2...003da1e089edf06c528667009fb59189b5f0e4cc,3,5,3,8,5,2012-01-27 22:21:17,2012-01-27 22:21:17
ccd963e622bdcadc8a79f5b8c1bb770b09f63f20...6fd1e9f4c0903ae4ff4f57bd3cb193ee0ed2b9ad,12,24,24,48,21,2012-01-27 21:36:31,2012-01-27 21:36:31
ccd963e622bdcadc8a79f5b8c1bb770b09f63f20...a0b40b361a59987c98688fafae05d2eb68b659db,3,75,85,160,38,2012-01-27 21:35:25,2012-01-27 21:35:25
a0b40b361a59987c98688fafae05d2eb68b659db...d7b8a9c9303f1f1bd69ae02f74bb17aaa87a2ceb,2,3,1,4,3,2012-01-27 21:36:08,2012-01-27 21:36:08
d9759abeebbca0681054f8da3ff7c3029948284e...997fc33af9a4cbdc078e85ee491f777d0dd2d51a,6,8,8,16,8,2012-01-28 00:40:14,2012-01-28 00:40:14
997fc33af9a4cbdc078e85ee491f777d0dd2d51a...7e72eb5063470a3728d612acd2cc0368aabc8664,7,50,13,63,15,2012-01-28 02:33:25,2012-01-28 02:33:25
7e72eb5063470a3728d612acd2cc0368aabc8664...aaa530c27e387ff266345aee026b50f779be88bc,3,8,39,47,9,2012-01-28 02:44:17,2012-01-28 02:44:17
aaa530c27e387ff266345aee026b50f779be88bc...7fc6e12b79a8ba445e41db00627530b06544bfde,2,7,7,14,7,2012-01-28 02:49:00,2012-01-28 02:49:00
5b5c61bb3008c8f0156fb2541f99b3bc223b6cc8...ad5c64a24f5eb98bdfc6f04d6fe1bb44a317e79a,1,1,1,2,1,2015-03-10 17:57:02,2015-03-10 17:57:02
a7a6e7f8d6c4900b83017f7ae2bd69ec509d32c4...114d1cf76c8fdde7e1eda4fe4aecbf0567674633,2,2,0,2,2,2015-02-23 18:53:01,2015-02-17 19:34:38
a7a6e7f8d6c4900b83017f7ae2bd69ec509d32c4...6e0009e18d6ed2580a7f571e3253b63404948804,3,6,3,9,4,2015-02-17 19:41:00,2015-02-17 19:41:00
6e0009e18d6ed2580a7f571e3253b63404948804...ed627ebcfb8ad38db36f7e69b335a311a9c44444,6,64,4,68,57,2015-02-19 04:21:09,2015-02-19 04:21:09
feb0da4c2f70cf88641de4c567dd85bea99de46a...4d4c7c40516a304e2902617131b3bf4ba86da70a,1,1,1,2,1,2015-01-30 16:03:07,2015-01-30 16:03:07
feb0da4c2f70cf88641de4c567dd85bea99de46a...c918289b46be4c78ae3fc83cf07bad612fadd6bb,1,7,6,13,3,2015-01-30 13:22:56,2015-01-30 13:22:56
c918289b46be4c78ae3fc83cf07bad612fadd6bb...8e18eb8c1876a3f2b0292928a2ffbdd8f7b35734,1,9930,6318,16248,1293,2015-01-30 13:24:39,2015-01-30 13:24:39
8e18eb8c1876a3f2b0292928a2ffbdd8f7b35734...2139f01a762ae253e10c54fa571621bfb1a12a73,1,5,4,9,1,2015-01-30 13:25:55,2015-01-30 13:25:55
2139f01a762ae253e10c54fa571621bfb1a12a73...f674f8786b59b710273aa4659f984e7a5f080e05,1,16,13,29,5,2015-01-30 13:26:31,2015-01-30 13:26:31
a339bfb0accc2bbb2ab91c777e1bdd431b08c0f5...1d34615758f04f20d7a2ab4d8f0e0c96aa9acfa8,2,2,7,9,2,2015-02-26 03:51:28,2015-02-26 03:51:28
1194f0d481e2a76b21b845477a346375c9e3b98f...36d6af9bcd1bce677135c255477307eafb31e045,1,1,1,2,1,2015-02-21 15:02:40,2015-02-21 15:02:40
763f8293da90a4c4102f9fae049232662ca2696f...4fc6317b400728a96ce01ff594e4f6db546b509d,1,4,0,4,1,2015-02-13 21:30:07,2015-02-13 21:30:07
32cb0715949e5ab20716121234d858e51f3ff386...adaabab81bcc7da1c832ecdab79db9d87f04e5b2,4,8,81,89,6,2014-12-30 04:08:22,2014-12-30 04:03:27
714cd6b60891036486c1102be1b2b3cbe67bdb02...1b375420fa1491f724c6c5a685b61bb93b803f05,1,1,1,2,1,2014-12-31 02:48:34,2014-12-31 02:48:34
714cd6b60891036486c1102be1b2b3cbe67bdb02...4f1000d77242f3cd9e363da9db9021cb1a227e59,1,3,0,3,1,2014-12-31 02:34:48,2014-12-31 02:33:40
714cd6b60891036486c1102be1b2b3cbe67bdb02...511f37dc049e99256838894b311b8847dba2c1c5,1,4,0,4,1,2014-12-31 02:17:09,2014-12-31 02:16:16
ae579b4b754f275b478440705721798670f35404...33cbf2142b477417ba9ad2f42ce8f3ad65f9aca3,1,1,1,2,1,2014-12-12 22:18:25,2014-12-12 22:13:17
33cbf2142b477417ba9ad2f42ce8f3ad65f9aca3...8be858aac43524f91e8c4bfceea302ff9a67e45d,1,2,2,4,1,2014-12-12 22:19:42,2014-12-12 22:19:42
16479e9051614696df3d21acd9d482018da17045...1cbbeef47c696fc4f389cd0df900cf6213ed327d,2,8,3,11,2,2015-02-24 02:41:30,2015-02-24 02:41:30
6fe9cd9fef3e0960d0ef8484dea7aecd0880de84...caed2c03035af2fb291e1e391c7cbb551b24cc87,1,8,8,16,8,2014-12-19 02:24:02,2014-12-19 02:24:02
caed2c03035af2fb291e1e391c7cbb551b24cc87...e1484cc65df07886bddffc3f6b65ff5fb7b39fdf,1,10,0,10,1,2014-12-19 02:28:15,2014-12-19 02:28:13
8b6d396adf4c4ab2095b47bca0020eb90fe0e04a...5c569dc4d4a24fde679a7986da6364ea93f7316d,1,2,2,4,2,2014-07-22 05:29:06,2014-07-02 04:58:39
5c569dc4d4a24fde679a7986da6364ea93f7316d...caed585033747ac27c3a0dccd72110eef829420a,1,19,26,45,14,2014-07-22 05:29:06,2014-07-22 05:08:31
caed585033747ac27c3a0dccd72110eef829420a...88b4016ce68f24822c8c6083616493ee0989411c,1,4,4,8,4,2014-07-22 05:31:26,2014-07-22 05:29:39
88b4016ce68f24822c8c6083616493ee0989411c...97cb2803d7698bdafc57820017ab8550b031d121,2,42,12,54,6,2014-07-22 05:31:36,2014-07-22 05:30:35
dc0fe18e35299d9c5b627de80cd8a631f0df2908...d7c92a0f08681e9e0753fcc57a54ddccf4e7e42e,1,1,1,2,1,2014-07-15 17:55:28,2014-07-15 17:55:28
f595e146d604c24ff3ab4e76267973d5d6ce452e...f1136228a789c6c0853771097f6292a478a056aa,1,10,0,10,1,2012-10-30 04:54:51,2012-10-30 04:54:51
a6968c4934f699c066b9e545b2f9c0c6da500fff...5bb6c42405d030cb481395e5fc4006bc1925f39d,2,9,0,9,2,2012-10-30 04:33:20,2012-10-30 04:33:20
5bb6c42405d030cb481395e5fc4006bc1925f39d...bf10a43ed91abc41fb6062811a2b1c4ed73c5094,2,4,11,15,5,2012-10-30 04:34:10,2012-10-30 04:34:10
28da31218fc5dc39ece625705c37b8c86d494801...22d1506d2325f432dfd35c8380b06f19b8f74441,2,2,0,2,2,2012-11-04 20:39:27,2012-11-04 20:39:27
8e6697f2b20da705377d2a7a2eb6957a4df59d77...edc3eee5eaae52384de1486639585c0b41318cf8,5,29,17,46,11,2012-10-18 05:26:44,2012-10-18 05:26:44
fa778792c5a00577cc2f59f70499b60bda2a8457...e24b46b7f3fb9eab5f34fb6e199d24781204c745,4,12,18,30,10,2012-10-16 16:27:43,2012-10-16 16:27:43
fa778792c5a00577cc2f59f70499b60bda2a8457...0048446db9901d70e0b2954bad40309a0029fe46,1,4,4,8,3,2012-10-15 18:57:09,2012-10-15 18:57:09
0048446db9901d70e0b2954bad40309a0029fe46...463eae25b0553161dc39875015ea62970c6edfbf,2,2,2,4,2,2012-10-16 17:37:36,2012-10-16 17:37:36
463eae25b0553161dc39875015ea62970c6edfbf...bf7833353145966f1934a2da4aa3771cb2436b48,4,268,214,482,62,2012-10-16 17:50:10,2012-10-16 17:50:10
bf7833353145966f1934a2da4aa3771cb2436b48...78f7ad95f4449506f4928e2407df91b0c0eb830a,2,11,9,20,5,2012-10-17 02:56:34,2012-10-17 02:56:34
78f7ad95f4449506f4928e2407df91b0c0eb830a...0ac50d28b57b2221abf9ce935f4957d66ee7fcda,2,2,2,4,2,2012-10-17 03:18:50,2012-10-17 03:18:50
0ac50d28b57b2221abf9ce935f4957d66ee7fcda...57eb2a801827ab2466f6ca4d5d470a72ae14e601,2,4,4,8,4,2012-10-17 03:28:07,2012-10-17 03:28:07
57eb2a801827ab2466f6ca4d5d470a72ae14e601...709870aa3e5edab74e9644273df092258569b449,2,2,2,4,2,2012-10-17 03:34:42,2012-10-17 03:34:42
fa778792c5a00577cc2f59f70499b60bda2a8457...6b017b9bea37629d0ee9bcd99e8e34b91aa3b5c0,2,11,2,13,2,2012-10-15 13:17:59,2012-10-15 13:17:59
fa778792c5a00577cc2f59f70499b60bda2a8457...fda641fb6cf78c577309b88668b5bae0b6f6912b,1,1,1,2,1,2012-10-14 01:38:34,2012-10-14 01:37:18
fa778792c5a00577cc2f59f70499b60bda2a8457...ed5c5994a780b7ba80854431b05d81e8692b819d,2,2,2,4,2,2012-10-14 01:31:41,2012-10-14 01:31:41
a56de2b84f8d6b4952c400847a7d73e7c3abd536...3de6f3ff88eeac5276af46e0262101b715dea1ad,13,91,91,182,13,2012-11-03 23:18:02,2012-11-03 23:18:02
3de6f3ff88eeac5276af46e0262101b715dea1ad...25fded1ff4a0ba13e1566adcf6ac82b88e291adb,8,17,13,30,8,2012-11-04 07:31:43,2012-11-04 07:31:43
25fded1ff4a0ba13e1566adcf6ac82b88e291adb...05a2d375594779d534a200ed112787649b67f3a2,8,0,8,8,8,2012-11-04 07:37:49,2012-11-04 07:37:49
05a2d375594779d534a200ed112787649b67f3a2...83a3789b5e8ccedc16db3a284c764067e6b25c25,4,129,52,181,6,2012-11-04 07:52:10,2012-11-04 07:52:10
3b3dd3ac3c7b69d02406ede69bffcc4ee8a1ed6b...8b959cacbc26666c13fd0e893a3f563ac4f9d09e,1,1,1,2,1,2012-12-04 00:21:07,2012-12-04 00:21:07
3b3dd3ac3c7b69d02406ede69bffcc4ee8a1ed6b...0dece7a71f4f3591c7d1fecb9dea7cba82c9624a,2,6,0,6,4,2012-12-02 11:35:33,2012-12-01 14:19:41
3b3dd3ac3c7b69d02406ede69bffcc4ee8a1ed6b...e6e4d93d5e9b991868341ca6086cdb498ce7ba71,1,3,3,6,3,2012-11-27 14:07:31,2012-11-27 14:07:31
3b3dd3ac3c7b69d02406ede69bffcc4ee8a1ed6b...4d593618e00b6052a1588fd4fb7312da6b3af194,1,10,0,10,1,2012-11-16 07:01:21,2012-11-16 07:01:21
3b3dd3ac3c7b69d02406ede69bffcc4ee8a1ed6b...46d38b10b8823d2a13329edb939e4811636c9aba,1,5,0,5,1,2012-11-02 14:04:34,2012-11-02 14:04:34
3b3dd3ac3c7b69d02406ede69bffcc4ee8a1ed6b...d5697fcf6b17721a243dc7e99060aa39c976cde7,10,9,9,18,9,2012-10-31 17:41:41,2012-10-31 17:41:41
d5697fcf6b17721a243dc7e99060aa39c976cde7...64326322b48a29fb7911fcb21addef981e3bd4d7,2,19,21,40,6,2012-10-31 17:46:04,2012-10-31 17:46:04
bf48c3140693fb4168627095857da93a9a6f3972...14b941744c5ef3cc67c41e3bae7284fafe052415,2,2,2,4,2,2012-10-31 17:51:27,2012-10-31 17:51:27
14b941744c5ef3cc67c41e3bae7284fafe052415...be03a5308663052be22d48cbe247b2c259fdefe9,4,18,55,73,14,2012-10-31 18:09:44,2012-10-30 09:22:09
be03a5308663052be22d48cbe247b2c259fdefe9...46347fff01d79225a140992947624c6afbea7691,1,1,1,2,1,2012-10-31 18:17:01,2012-10-31 18:17:01
46347fff01d79225a140992947624c6afbea7691...d350f577e9aed350bf82f3937f68d11d613773d1,2,6,9,15,7,2012-11-01 04:43:32,2012-11-01 04:43:32
d350f577e9aed350bf82f3937f68d11d613773d1...d0c75bbc8324a552b93817b1f565fa798f6574cf,3,21,2,23,4,2012-11-01 16:44:51,2012-11-01 16:44:51
10faf28aefdf311d7021608ca0ce6b70443648aa...cd2b12f788f9c1d32ae20929f7deefb5ad2d99e8,1,1,1,2,1,2012-09-11 05:41:14,2012-09-11 05:41:14
cd2b12f788f9c1d32ae20929f7deefb5ad2d99e8...39791a8ea8445932cebab737087da8710255556a,2,2,2,4,2,2012-09-11 05:44:08,2012-09-11 05:44:08
39791a8ea8445932cebab737087da8710255556a...0489c708c7104fffa7bddad18399f46db78e56fa,2,2,2,4,3,2012-09-11 05:51:16,2012-09-11 05:51:16
cf4fd1abbefc5b4d28c5839f1011bd33d420c467...41f4c60a91c11e6c25a9f277c8a26a022afe58b1,2,2,2,4,2,2012-08-14 04:34:40,2012-08-14 04:34:40
cf4fd1abbefc5b4d28c5839f1011bd33d420c467...d96047f45f4e0a0618903662f41a5b2f184589cf,1,2,2,4,2,2012-08-14 03:57:13,2012-08-14 03:57:13
d96047f45f4e0a0618903662f41a5b2f184589cf...d684607976578f15aa2981cc235a1964f47ff7a9,1,2,2,4,2,2012-08-14 05:51:50,2012-08-14 05:51:50
cf4fd1abbefc5b4d28c5839f1011bd33d420c467...a74457a203a967eb5db216b76fcf4c600c70d901,2,2,2,4,2,2012-08-14 00:10:07,2012-08-14 00:10:07
fd509cb370867d6a2d2ad45d3bae88d4fecdd088...54c645e33d379669015921116c87145f41099b56,4,110,6,116,4,2012-08-15 21:49:55,2012-08-15 21:49:55
1ae194597c3d0a9608803f9edbd05bc50b4844af...50638530e61307f174950ef295235a6dbddec6b9,2,16,9,25,6,2012-08-18 23:30:47,2012-08-18 23:30:47
1ae194597c3d0a9608803f9edbd05bc50b4844af...05571db10990ff66d312abc9cd25144dad36517d,2,2,0,2,2,2012-08-18 11:40:37,2012-08-18 11:40:37
05571db10990ff66d312abc9cd25144dad36517d...0c24f51d2a6e67446cf96c5a5a15319ff63f3f43,2,2,2,4,2,2012-08-18 11:56:02,2012-08-18 11:56:02
0c24f51d2a6e67446cf96c5a5a15319ff63f3f43...7f5aa177f5f6e67801db7f17d93092aeb47bfd75,2,4,2,6,2,2012-08-18 12:00:33,2012-08-18 12:00:33
7f5aa177f5f6e67801db7f17d93092aeb47bfd75...c8b8d914b83ffe736ce21b3848b6fb6467eaffe8,2,2,2,4,2,2012-08-18 12:22:41,2012-08-18 12:22:41
c8b8d914b83ffe736ce21b3848b6fb6467eaffe8...25f8ef32605a259648e2085102689bc797c9aa42,2,4,4,8,4,2012-08-18 12:36:30,2012-08-18 12:36:30
25f8ef32605a259648e2085102689bc797c9aa42...a8b18b6f54f42ab3d22357412933381998ed3f50,2,2,2,4,2,2012-08-18 12:54:32,2012-08-18 12:54:32
a8b18b6f54f42ab3d22357412933381998ed3f50...663fd4ff620b2a79cfba97623f24c3f1ff8c01fd,2,16,4,20,2,2012-08-18 13:29:55,2012-08-18 13:29:55
663fd4ff620b2a79cfba97623f24c3f1ff8c01fd...01dadc05f4522250f7a06b28ce27f8a0c3a91997,2,12,12,24,2,2012-08-18 13:31:11,2012-08-18 13:31:11
01dadc05f4522250f7a06b28ce27f8a0c3a91997...f37d4b0918bbcdd507c31f81d00621d03acf0248,2,24,6,30,2,2012-08-18 13:43:00,2012-08-18 13:43:00
f37d4b0918bbcdd507c31f81d00621d03acf0248...263ed4e2398e1c9416525f04f3bf52ff0c40bd5a,2,8,0,8,4,2012-08-18 13:48:18,2012-08-18 13:48:18
263ed4e2398e1c9416525f04f3bf52ff0c40bd5a...f4f6783cc0a4cf17d7c8344204e4d9a64982a831,2,4,4,8,4,2012-08-18 14:03:47,2012-08-18 14:03:47
f4f6783cc0a4cf17d7c8344204e4d9a64982a831...a3c474c4048eff0c43b24bc8134b7ca753ced975,2,6,6,12,2,2012-08-18 14:07:48,2012-08-18 14:07:48
a3c474c4048eff0c43b24bc8134b7ca753ced975...41253fb07366e49557d611b98d68b6057ca47417,2,50,26,76,12,2012-08-18 14:36:40,2012-08-18 14:36:40
41253fb07366e49557d611b98d68b6057ca47417...7b7a02542b5fa46338bc14fd83ca9b84d43c6b55,2,10,4,14,4,2012-08-18 14:41:40,2012-08-18 14:41:40
7b7a02542b5fa46338bc14fd83ca9b84d43c6b55...04a20fb402e45c4362c6e7804efb21d77f45e6a6,2,6,14,20,2,2012-08-18 14:47:15,2012-08-18 14:47:15
04a20fb402e45c4362c6e7804efb21d77f45e6a6...2ab0c8de1ab01986d4dacdd3455eaea6fe8a65a4,2,2,2,4,2,2012-08-18 14:50:08,2012-08-18 14:50:08
2ab0c8de1ab01986d4dacdd3455eaea6fe8a65a4...f1854a3cec75c56093ae920ab532bca51d6fdbb6,2,6,6,12,2,2012-08-18 14:53:43,2012-08-18 14:53:43
f1854a3cec75c56093ae920ab532bca51d6fdbb6...d8eb75d6e83a20f087856258cbd66ef01edee823,2,4,2,6,2,2012-08-18 16:14:20,2012-08-18 16:14:20
d8eb75d6e83a20f087856258cbd66ef01edee823...97247a157c6d8c5a1c42461a3a7b569ecb930e86,2,3,3,6,2,2012-08-18 16:24:18,2012-08-18 16:24:18
97247a157c6d8c5a1c42461a3a7b569ecb930e86...d71efb855bda3ecd0b0fd079d2d9cb231c8ba71b,2,102,30,132,8,2012-08-18 17:21:01,2012-08-18 17:21:01
d71efb855bda3ecd0b0fd079d2d9cb231c8ba71b...8b763286df34d4eadd8e5a254b7390a6c1ccbc3e,2,16,0,16,2,2012-08-18 17:31:29,2012-08-18 17:31:29
8b763286df34d4eadd8e5a254b7390a6c1ccbc3e...2327d30ef5bcbebd5519488178534f2b09de89af,2,18,0,18,2,2012-08-18 17:40:42,2012-08-18 17:40:42
2327d30ef5bcbebd5519488178534f2b09de89af...3f12c746e59de41fc13964a70eaa31891f71c760,2,2,2,4,2,2012-08-18 17:49:27,2012-08-18 17:49:27
3f12c746e59de41fc13964a70eaa31891f71c760...b7233a49dd42a17032389351f340c8175d77f36a,2,2,2,4,2,2012-08-18 17:51:57,2012-08-18 17:51:57
b7233a49dd42a17032389351f340c8175d77f36a...ae275dccb82023c9e8f0b8d8b689566ad07db8d9,2,16,16,32,16,2012-08-18 19:44:57,2012-08-18 19:44:57
ae275dccb82023c9e8f0b8d8b689566ad07db8d9...dda951d1e1283738c132f1132e9dec28f27fa1ec,2,8,8,16,8,2012-08-18 19:52:43,2012-08-18 19:52:43
b2ebd5c46ca538142c5cd4164328c56053b5c79d...a9bf1e6e354e9833ba365b2a817c12d6b7bfa784,3,17,1,18,3,2012-07-30 20:25:27,2012-07-30 20:25:27
003da1e089edf06c528667009fb59189b5f0e4cc...22359f9dfdf5d513da163416005345649415b90f,6,4,4,8,4,2012-01-27 22:48:35,2012-01-27 22:48:35
3c7e3eb7d37507ba12d95024f06d6f872a44eecd...8a2124faff2cad26498203c047c5dc9a2b6d0e73,1,2,0,2,1,2012-01-27 22:43:41,2012-01-27 22:43:41
8a2124faff2cad26498203c047c5dc9a2b6d0e73...748696a5532100f7a45cbb0d6a138fae6afac5cb,2,2,2,4,2,2012-01-27 22:44:05,2012-01-27 22:44:05
d7b8a9c9303f1f1bd69ae02f74bb17aaa87a2ceb...b1f38bbea85c313f1a9512c821de1255e2a0d537,3,9,1,10,3,2012-01-27 21:39:19,2012-01-27 21:39:19
a624ac1edf7484dbdf7f4176d9d4485f1878f4e5...d02c6957d44761c35121cb88af727802ce4d9e5e,6,177,210,387,32,2012-01-28 03:49:56,2012-01-28 03:49:56
d02c6957d44761c35121cb88af727802ce4d9e5e...0fa642291843fbeab66960c6fc635681c1241586,3,9,3,12,5,2012-01-28 03:57:53,2012-01-28 03:57:53
0fa642291843fbeab66960c6fc635681c1241586...9800196bf7067b560e062dabfcb51f9b9c7e8dd5,4,29,29,58,23,2012-01-28 04:05:03,2012-01-28 04:05:03
9800196bf7067b560e062dabfcb51f9b9c7e8dd5...4e191c423d2d1e834a4cb57ae246d03a82272ee4,2,7,12,19,7,2012-01-28 04:17:03,2012-01-28 04:17:03
03579c3f55c33dac9958159fa2e152d7a8d2c89f...9d0259d8d142b6b1ae19436507155e46359cd7c5,5,47,41,88,28,2015-03-10 18:50:26,2015-03-10 18:50:26
4d4c7c40516a304e2902617131b3bf4ba86da70a...c0892d14709736be72b0eb3ba6ad1718019e88e0,4,13,3,16,6,2015-01-31 13:09:57,2015-01-31 11:19:19
c0892d14709736be72b0eb3ba6ad1718019e88e0...214516da16c99c7118b29ecef3bdf10f977d4e29,1,2,2,4,2,2015-02-02 12:30:21,2015-02-02 12:04:01
33d8fde67cf9db663cc85b3990944109c5dcbe47...99fc85e8d0c43b201efc265c64dcea50c5a85861,1,3,0,3,1,2015-02-02 20:13:01,2015-02-02 20:13:01
99fc85e8d0c43b201efc265c64dcea50c5a85861...8a9374325be23115c5b432acb2b04d4befdb7baf,1,1,1,2,1,2015-02-02 20:16:26,2015-02-02 20:16:26
33d8fde67cf9db663cc85b3990944109c5dcbe47...b46dbef3264c87d16dbba3ba89cec3dc72065cac,1,8,8,16,3,2015-02-02 17:26:30,2015-02-02 17:26:30
33d8fde67cf9db663cc85b3990944109c5dcbe47...73b50769d894182d1fa9c540fb1cc30cc666e170,2,9,14,23,5,2015-02-02 02:36:13,2015-01-19 23:18:06
73b50769d894182d1fa9c540fb1cc30cc666e170...65a723b6024e443c9e5f9c2c0a49d2d8cdf69584,1,98,332,430,41,2015-02-02 02:36:13,2015-01-21 21:39:55
cac6cfcd845a33334f885a5500ab41252475f566...5debbec59f3d6c4d5c4feef9c53c0108b7b69208,2,14,14,28,5,2015-02-26 05:01:07,2015-02-26 05:01:07
5debbec59f3d6c4d5c4feef9c53c0108b7b69208...b395f3526e267c267c2d099b7cfc13325d873ee9,2,22,1,23,2,2015-02-26 05:42:09,2015-01-08 09:03:09
b395f3526e267c267c2d099b7cfc13325d873ee9...f43c67b0c5e98208bb85228d6d98752488d4e31c,2,2,2,4,2,2015-02-26 05:51:21,2015-02-26 05:51:21
f43c67b0c5e98208bb85228d6d98752488d4e31c...acc5f6575698b8cbaf18892842301c10303c4502,1,2,2,4,2,2015-02-26 05:53:58,2015-01-13 14:59:47
acc5f6575698b8cbaf18892842301c10303c4502...033dbfd06c9c5bb8dccdb96ec201a30fd14b178a,2,3,3,6,3,2015-02-26 06:01:15,2015-02-26 06:01:15
16a4a44a34732fb78822875ece04b11de71d414f...df2ea49c0a789e3689262497e8e1fac93022d0a8,1,1,1,2,1,2015-02-22 04:59:15,2015-02-22 04:59:15
d4ff58342895b16b701c41c3afeb8135ea037b59...3b783bd0b55da22e5a138670668b894b74d29676,1,1,1,2,1,2015-02-14 12:32:16,2015-02-14 12:31:31
df38cdad32cfb3639c30caa5574688c462235441...548d46eb8b88f3876ec325be8500080c78934925,2,2,2,4,2,2015-01-01 03:01:40,2015-01-01 03:01:40
df38cdad32cfb3639c30caa5574688c462235441...576230b92ae5a082eb8e058dc2fab7c67c99bd19,15,15,15,30,15,2015-01-01 00:23:48,2015-01-01 00:23:48
b0437f8ea961c0ff80c4fde35f3035229ac3c667...13d7cc7d4c0bd73a4875aa8dc65f52506431937f,3,9,5,14,5,2014-12-30 07:56:24,2014-12-02 11:31:52
8be858aac43524f91e8c4bfceea302ff9a67e45d...d5647e1f6277864cb776e4f958a54f6f5c30b6e6,3,22,2,24,3,2014-12-14 21:27:58,2014-12-14 14:31:02
d5647e1f6277864cb776e4f958a54f6f5c30b6e6...2d41894ce51a1ae3b6e9d96eb63bf9cc3b50f64b,1,3,2,5,3,2014-12-14 21:27:58,2014-12-14 14:47:05
1cbbeef47c696fc4f389cd0df900cf6213ed327d...bda4fe87ca37c2ca03c0609847de68c0bb5f81cd,2,5,5,10,5,2015-02-24 06:18:51,2015-02-24 06:18:47
1cbbeef47c696fc4f389cd0df900cf6213ed327d...7c19fee3f1f3a371445981cf7e88a3af92f3b602,11,504,504,1008,391,2015-02-24 06:14:11,2015-02-24 05:55:07
7c19fee3f1f3a371445981cf7e88a3af92f3b602...118b8c2695d026f1cad6cffc177d9672d9903ce9,11,204,204,408,204,2015-02-24 06:14:11,2015-02-24 06:04:48
118b8c2695d026f1cad6cffc177d9672d9903ce9...9c75c855c6bba0e9ef9facc7c948612cd0c2a855,7,90,90,180,81,2015-02-24 06:43:17,2015-02-24 06:41:08
46e059e9d72b09479fe6b4c6e25d273d4ed0f3cf...43b3c9d0a8ca85820ad0ad6d5e01a140106b54d4,1,10,0,10,1,2014-12-20 01:15:14,2014-12-20 01:13:13
dd22f599998cc07c18b6643a856d5acda6c5c122...f9349f36dfbfda7bf755f458d856d45d07745f29,1,10,10,20,4,2014-07-17 01:53:49,2014-07-17 01:53:49
f9349f36dfbfda7bf755f458d856d45d07745f29...31772677f959bf449fee2a57805da66476d8eec8,1,12,8,20,7,2014-07-17 03:16:34,2014-07-17 02:11:21
31772677f959bf449fee2a57805da66476d8eec8...38335b2a3dcaac8bb706b5542e10f8edd8ea6a5e,2,4,3,7,4,2014-07-17 03:16:48,2014-07-17 02:33:30
dd22f599998cc07c18b6643a856d5acda6c5c122...cc7fab893d2e3c24fdc0e26fd47478cc0006200b,1,2,14,16,2,2014-07-16 06:44:56,2014-07-16 06:44:56
dd22f599998cc07c18b6643a856d5acda6c5c122...11db482371ed8195093139ddb4eb31177ada0607,2,11,14,25,7,2014-07-15 23:57:54,2014-07-15 23:57:25
11db482371ed8195093139ddb4eb31177ada0607...b3d068f2d33e2753421691043ebda63ae7b6f199,1,1,1,2,1,2014-07-16 00:21:39,2014-07-15 23:57:40
22d1506d2325f432dfd35c8380b06f19b8f74441...2320a0989869900e92ab4e3cd78ffad9e6375337,2,2,2,4,2,2012-11-04 20:58:57,2012-11-04 20:58:57
2320a0989869900e92ab4e3cd78ffad9e6375337...fb51efcbd4d18a0a66cc94ee537623f567d059d4,2,2,0,2,2,2012-11-04 21:01:31,2012-11-04 21:01:31
fb51efcbd4d18a0a66cc94ee537623f567d059d4...953dc3a6f2cf09f461f03955e31fbba6bed0095f,3,0,0,0,0,2012-11-04 21:23:08,2012-11-04 21:23:08
953dc3a6f2cf09f461f03955e31fbba6bed0095f...21957a3d9ea0380ff472f36065d734b30313c739,1,10,0,10,1,2012-11-04 21:24:06,2012-11-04 21:24:06
21957a3d9ea0380ff472f36065d734b30313c739...075e320a83437b88665300ec043921e8f1fd8b8d,2,0,12,12,6,2012-11-04 21:26:03,2012-11-04 21:26:03
075e320a83437b88665300ec043921e8f1fd8b8d...51f293ba4c84d1a45a102e5904b42a34474cda29,2,2,0,2,2,2012-11-04 21:30:36,2012-11-04 21:30:36
269be76f4a5d8d6098bbd068b506e6bf72f23e00...508cc1fef4e11b2f985bff5bd663449676d10b0e,4,13,18,31,13,2012-11-04 20:38:35,2012-11-04 20:38:35
e0a007b9299e6991c78bcb77384e15979d6b7485...ac6625de5fb01067e6f64996c84e93ade654d7d5,3,24,12,36,25,2012-10-18 04:37:34,2012-10-18 04:37:34
2526c3fdbeb67732400b5cd5fce8d64de1eeee1a...66b70016d0f083098c32ad051173e6f52a6b2084,5,6,6,12,6,2012-12-07 22:14:49,2012-12-07 22:14:49
85c57c6ba895d39bad648903f8a085d336d256ea...32d425967a981838cb2e66701c0e814aeee8ab9c,3,8,7,15,7,2012-12-02 09:32:23,2012-12-02 09:32:23
32d425967a981838cb2e66701c0e814aeee8ab9c...ea61cdb7407f09c0c4a9b5a7f76b24982b51c3d7,2,0,9,9,2,2012-12-02 09:34:58,2012-12-02 09:34:58
ea61cdb7407f09c0c4a9b5a7f76b24982b51c3d7...139f1be49d8dd443343d7add5de849b647781743,2,2,0,2,2,2012-12-02 10:30:00,2012-12-02 10:30:00
139f1be49d8dd443343d7add5de849b647781743...c8862d91bcbf9cd32a3b11393a51ea53ff098666,1,24,51,75,19,2012-12-02 21:14:49,2012-12-02 21:14:49
c8862d91bcbf9cd32a3b11393a51ea53ff098666...439ff097019024c73f141431f6eb0da035cd2f04,1,1,1,2,1,2012-12-03 02:15:40,2012-12-03 02:15:40
439ff097019024c73f141431f6eb0da035cd2f04...30d6a71ccd383c6b2498cf58d99db399c850a551,2,20,20,40,20,2012-12-03 04:40:24,2012-12-03 04:40:24
30d6a71ccd383c6b2498cf58d99db399c850a551...f514c87d6b74de949732c325f70d195453fe2d28,2,12,0,12,2,2012-12-03 04:57:34,2012-12-03 04:57:34
f514c87d6b74de949732c325f70d195453fe2d28...eca23e9b0fc6265f570f5b8f8ac063b52ec5e57f,1,1,0,1,1,2012-12-03 05:01:53,2012-12-03 05:01:53
eca23e9b0fc6265f570f5b8f8ac063b52ec5e57f...68cbba347bc1e6edd8c2812f37236a622a6d3672,3,27,18,45,7,2012-12-03 13:20:14,2012-12-03 13:20:14
68cbba347bc1e6edd8c2812f37236a622a6d3672...d470fb72da7e4c12a44c79673b650fb8f7e63037,1,0,3,3,3,2012-12-03 17:23:02,2012-12-03 17:23:02
d470fb72da7e4c12a44c79673b650fb8f7e63037...06582edb2a396a12665699ed73625031a413ca93,1,57,47,104,10,2012-12-03 21:01:27,2012-12-03 21:01:27
06582edb2a396a12665699ed73625031a413ca93...869b69c66cbab0cc958db6a74d957233bff81c64,2,6,6,12,6,2012-12-03 21:09:38,2012-12-03 21:09:38
869b69c66cbab0cc958db6a74d957233bff81c64...15a4399015e13fdcd00bfff32ccca5244d60c95d,9,18,18,36,9,2012-12-03 21:22:10,2012-12-03 21:22:10
15a4399015e13fdcd00bfff32ccca5244d60c95d...0f2a423b8d48eddc9299b0bc4de40a185367556a,23,51,51,102,46,2012-12-03 21:25:56,2012-12-03 21:25:56
0f2a423b8d48eddc9299b0bc4de40a185367556a...e31c7fb8a5db119c894cb034dcfc423d7991c1d6,2,2,2,4,2,2012-12-04 17:49:18,2012-12-04 17:49:18
e31c7fb8a5db119c894cb034dcfc423d7991c1d6...12916b06aaf686c56a53feb16b8efbac6f38c8fd,3,47,13,60,14,2012-12-05 02:25:16,2012-12-05 02:25:16
12916b06aaf686c56a53feb16b8efbac6f38c8fd...ed74992853054c57f33ef5d21941f0869e287552,4,4,1,5,4,2012-12-05 02:36:18,2012-12-05 02:28:12
cb69aa976f4834d1b6c22ed3dea8a13328d63748...78390d12afe2bc6f2b15f21f8ba87f8ba69738c6,2,15,15,30,11,2012-11-28 23:40:51,2012-11-28 23:40:51
c5173cdb92f36c29ee4992ba68ea96cf623c55f1...721b56830358f283caf1e7887e3308a79e98b825,1,1,0,1,1,2012-11-30 07:27:09,2012-11-30 07:27:09
721b56830358f283caf1e7887e3308a79e98b825...322a56354fdc576492769c631cb7af51edcb7a68,1,4,0,4,1,2012-11-30 07:27:20,2012-11-30 07:27:20
d0c75bbc8324a552b93817b1f565fa798f6574cf...fc42ac6a56a5ce4ad58ff3d817a369cd57345d1b,2,0,2,2,2,2012-11-02 16:47:42,2012-11-02 16:47:42
d0c75bbc8324a552b93817b1f565fa798f6574cf...72198a59c056857d93d35b5e3251b1baf8b5ab1c,25,1443,911,2354,212,2012-11-02 08:20:06,2012-11-02 08:20:06
72198a59c056857d93d35b5e3251b1baf8b5ab1c...4b3fb3087738ba2836538bacd34256503b6afc96,3,13,14,27,6,2012-11-02 08:39:40,2012-11-02 08:39:40
0489c708c7104fffa7bddad18399f46db78e56fa...bbadd429a8e4704c55ac0d9a228decf4a77f484a,6,8,8,16,8,2012-09-12 22:48:56,2012-09-12 22:48:56
bbadd429a8e4704c55ac0d9a228decf4a77f484a...38303dd9975a8f1bca89b9f0f8ef06a26dd3f1e0,3,8,5798,5806,6,2012-09-12 22:53:29,2012-09-12 22:53:29
38303dd9975a8f1bca89b9f0f8ef06a26dd3f1e0...65d322958ca9b4217548807c54414606182666fb,1,1,1,2,1,2012-09-12 23:11:03,2012-09-12 23:11:03
65d322958ca9b4217548807c54414606182666fb...537c5cc33dd91772d51c1b767eb31afbc1e9c6cf,3,5792,2,5794,3,2012-09-12 23:18:52,2012-09-12 23:18:52
537c5cc33dd91772d51c1b767eb31afbc1e9c6cf...e1deba30aa6b894aa8228cc9bfcec8490df47873,2,6,6,12,6,2012-09-12 23:22:52,2012-09-12 23:22:52
e1deba30aa6b894aa8228cc9bfcec8490df47873...15bb78ce800dc74dfd5eed98f3d256ce095ccab0,2,5,12,17,5,2012-09-12 23:37:41,2012-09-12 23:37:41
15bb78ce800dc74dfd5eed98f3d256ce095ccab0...595e1a189c1911ada7c4bd4c769c28b1741611ac,9,9,9,18,9,2012-09-13 17:07:57,2012-09-13 17:07:57
0489c708c7104fffa7bddad18399f46db78e56fa...2c8eff0eecb92b7e1b585afe3b59bf907a3e3a78,12,9235,13,9248,14,2012-09-12 20:10:03,2012-09-12 20:10:03
2c8eff0eecb92b7e1b585afe3b59bf907a3e3a78...a40ab1cd66efb873413f20f926643f05d32de21b,6,0,3103,3103,4,2012-09-13 00:11:42,2012-09-13 00:11:42
0040a780581d83b77a3a3b04070b94089ba833ad...97a23ef2e66919094ecfc517d9b5b9278a64441d,5,31,17,48,11,2012-08-14 05:57:40,2012-08-14 05:57:40
97a23ef2e66919094ecfc517d9b5b9278a64441d...4bf93a2d76ddec19e22be771ef1832ef563c91a5,1,1,0,1,1,2012-08-14 06:03:35,2012-08-14 06:03:35
54c645e33d379669015921116c87145f41099b56...ded21ebc91ee155b8196155fc9598a51be8fb55e,2,6,6,12,2,2012-08-17 18:22:45,2012-08-17 18:22:45
54c645e33d379669015921116c87145f41099b56...bb61175eba7df43c21900658147031f132e746b2,1,1,1,2,1,2012-08-16 11:39:55,2012-08-16 11:39:55
80ced60778404462a83f70ea2192152e3dd4ffbc...9ae137aede2ec2664793c3d67c99c81188f1c6f5,2,42,36,78,32,2012-08-18 23:42:50,2012-08-18 23:42:50
9ae137aede2ec2664793c3d67c99c81188f1c6f5...4d2f584fdd921a9b463355513a0beba5052a199b,2,2,2,4,2,2012-08-18 23:47:04,2012-08-18 23:47:04
4d2f584fdd921a9b463355513a0beba5052a199b...e6e0e2ac9b0a31979531b6add3d1c8aaceb65f2e,2,11,0,11,4,2012-08-18 23:50:26,2012-08-18 23:50:26
e6e0e2ac9b0a31979531b6add3d1c8aaceb65f2e...e79eb75e0944c2852fc47e117f4e96b984e40051,2,3,3,6,3,2012-08-19 00:05:37,2012-08-19 00:05:37
91e9f6fa91ea2f6d8cc47b8dbf1428847ad6504f...a2a10ae4211f0cdba5fe54417d267e3ba3b63705,2,112,34,146,20,2012-01-28 00:13:53,2012-01-28 00:13:53
91e9f6fa91ea2f6d8cc47b8dbf1428847ad6504f...800d0b24e08dec4835e7f4126701428c5c5bae2c,3,20,9,29,4,2012-01-27 23:28:09,2012-01-27 23:28:09
800d0b24e08dec4835e7f4126701428c5c5bae2c...f6dc566963c63d5113e72f0098ad9da2c414f33f,5,228,139,367,18,2012-01-28 00:26:55,2012-01-28 00:26:55
4e191c423d2d1e834a4cb57ae246d03a82272ee4...3934d1b6c4cb975967235547b77e90b4c8c91be2,3,21,3,24,7,2012-01-28 05:08:04,2012-01-28 05:08:04
4e191c423d2d1e834a4cb57ae246d03a82272ee4...15d3a4797f3435d1531804369df87fa4e574b874,5,9,16,25,11,2012-01-28 05:06:09,2012-01-28 05:06:09
9d0259d8d142b6b1ae19436507155e46359cd7c5...a3b6c9072c3d62316f21c0be405b81121d71cdf9,1,1,1,2,1,2015-03-10 20:16:10,2015-03-10 20:16:10
a3b6c9072c3d62316f21c0be405b81121d71cdf9...ba1345f144283d579b07cd40b5ae5a5b84d2b2e7,2,2,2,4,2,2015-03-10 20:20:23,2015-03-10 20:20:23
ba1345f144283d579b07cd40b5ae5a5b84d2b2e7...f3ae9430f271c0cd8e15942d5c1ded6a0ea181e9,1,1,1,2,1,2015-03-13 20:53:12,2015-03-13 20:53:12
f3ae9430f271c0cd8e15942d5c1ded6a0ea181e9...0ca3fa42e86138c80beff9d2ae97e57ef2a204c8,2,488,224,712,103,2015-03-15 11:26:35,2015-03-05 22:24:17
0ca3fa42e86138c80beff9d2ae97e57ef2a204c8...d18a043ddc527fe08fe235f2bae51738a94fae5c,5,59,29,88,9,2015-03-15 11:27:44,2015-03-14 11:23:53
d18a043ddc527fe08fe235f2bae51738a94fae5c...fc991181792c1654f2adb75bed748e09b389e17b,2,4,4,8,2,2015-03-15 11:30:30,2015-03-15 11:30:30
fc991181792c1654f2adb75bed748e09b389e17b...d74608b934bba856ee52f1e4ac8ff5ad68f22193,1,1,1,2,1,2015-03-15 12:07:48,2015-03-15 12:07:48
9d0259d8d142b6b1ae19436507155e46359cd7c5...83371735fcc4ceba3c1b35d91bb3ba8c41365861,2,47,1,48,2,2015-03-10 20:04:15,2015-03-10 20:04:15
54bae8f021d319a7ae79e7f3197298d99b61c138...fa27dc13b6e69d7f7f1f0eae5d71d71c5697f7a5,3,4,4,8,4,2015-02-03 02:11:42,2015-02-03 02:11:42
033dbfd06c9c5bb8dccdb96ec201a30fd14b178a...142a9e4ae0c4517654ec381adb52c0c0fb3f6279,2,86,7,93,4,2015-02-26 07:02:06,2014-12-03 08:13:37
033dbfd06c9c5bb8dccdb96ec201a30fd14b178a...10c8dad84847314da26f559860e8cba26c389dbb,1,4,8,12,3,2015-02-26 06:53:21,2014-12-04 19:26:11
33d49f632411434eb5ba070274bda44ec4ddc493...65d209e25727396807eb2cd4b4cbb426075b3cf2,1,1,1,2,1,2015-02-23 02:42:23,2015-02-23 02:42:23
65d209e25727396807eb2cd4b4cbb426075b3cf2...d8ffd57b93a12572d67cf3ee85d6ab70a556450a,1,103,61,164,35,2015-02-23 02:47:00,2015-02-23 02:44:01
3b783bd0b55da22e5a138670668b894b74d29676...101cf6b1c077d4eb76dddf978d2a6f1a04cf6815,1,10,0,10,1,2015-02-15 09:43:36,2015-02-14 12:36:50
401889a8dc7d530d9be3b6b005afe03856089437...57260f16b364e4cb559cd65159197fd1cf5248f7,1,12,12,24,12,2015-01-01 19:02:43,2015-01-01 19:02:43
1b8f00b3893cdb503decc87802440df495f4d3cb...6c383c5102011102d0d5157f6e37d7520f103ae7,6,6,6,12,6,2015-01-01 00:02:16,2015-01-01 00:02:16
f4b734eebdc6ae528111f1e250bdc0673b467507...1ec651b3cdbefa76ed3ef5e3bc1f1e300e75c584,1,1,1,2,1,2015-02-24 13:47:03,2015-02-24 13:47:03
ecd469ec16225ca6de90992ceeb1c700db54df8a...2aab06bbaa6718f5e9df4d04d0c2eae0e49348b8,1,1,1,2,1,2015-02-24 22:20:29,2015-02-24 22:20:29
ecd469ec16225ca6de90992ceeb1c700db54df8a...696fc2e53c0664ef04123167c1dcb1d22ae24d18,1,47,0,47,1,2015-02-24 22:09:08,2015-02-24 19:55:08
ecd469ec16225ca6de90992ceeb1c700db54df8a...30d8cdf6398f05a58afa303ac324201d08744b90,1,26,0,26,2,2015-02-24 21:29:40,2015-02-24 20:28:57
cde3093351d9d0923c7f4c07dede33ca19de30cb...b8844f639fcddb2ef70758ad4b0dcf89f9792d73,2,2,2,4,2,2014-12-20 02:19:18,2014-12-20 02:19:18
b8844f639fcddb2ef70758ad4b0dcf89f9792d73...acef81d900054efcff1336271931152d9c63730c,1,1,1,2,1,2014-12-20 02:20:44,2014-12-20 02:20:44
541a75f92c9b9e5b13fe1c331f9d10ba2e12b4de...45acf4e0403d866f99cdd52d0bfd267f0665a707,1,1,1,2,1,2014-07-17 12:13:16,2014-07-17 12:13:16
51f293ba4c84d1a45a102e5904b42a34474cda29...7e6cc0bf7ec795189dc14e6b27ffd25940081c71,4,109,8,117,8,2012-11-05 03:08:02,2012-11-05 03:08:02
51f293ba4c84d1a45a102e5904b42a34474cda29...76f9c9128e95f55efee66ade30b7f8a31b34208e,2,9,9,18,3,2012-11-05 02:26:25,2012-11-05 02:26:25
66b70016d0f083098c32ad051173e6f52a6b2084...91fbadad5b058f160eb3b5eb8e88432e0088efee,4,1,4,5,4,2012-12-07 22:49:05,2012-12-07 22:49:05
5da30ee5fb60ca29b7810368a13dd792b8337c7e...e194c3e4f44aa0089a6615dbdeab5ade8c9c6f65,3,3,1,4,3,2012-12-22 01:25:31,2012-12-22 01:25:31
e194c3e4f44aa0089a6615dbdeab5ade8c9c6f65...82a758344d108721091d628e3a650931b29e2058,2,13,0,13,2,2012-12-22 01:31:54,2012-12-22 01:31:54
82a758344d108721091d628e3a650931b29e2058...818c56f078ff3b14fefceca77608d1e95f33a783,4,37,10,47,7,2012-12-22 01:42:24,2012-12-22 01:42:24
ed74992853054c57f33ef5d21941f0869e287552...306c1b49147c388b7c458a939989bf33d464a69d,2,0,118,118,2,2012-12-05 19:06:16,2012-12-05 19:06:16
fa6a6dbb92c2ea317269bf50157e278619748206...acc037de15665614e61563903dbcdc3e4115eea6,15,360,86,446,92,2012-11-30 04:59:14,2012-11-30 04:59:14
acc037de15665614e61563903dbcdc3e4115eea6...38c546c785d4e96da097253dd135fa7ff9cac69e,1,183,71,254,36,2012-11-30 05:35:45,2012-11-30 05:35:45
fe7b6decb17786c2cd1ce80205d06ad7a3f8ba0e...f087b3428c6b48ee34b8da3991fc692e04719898,2,2,2,4,2,2012-11-30 07:33:09,2012-11-30 07:33:09
f087b3428c6b48ee34b8da3991fc692e04719898...bca3ff4ed6f42701ceae1405f518c35ec8c623be,2,6,2,8,2,2012-11-30 07:39:33,2012-11-30 07:39:33
fc42ac6a56a5ce4ad58ff3d817a369cd57345d1b...ead5dbeba5cd7acfa560bfb353f5e7c4f4a19256,4,19,0,19,4,2012-11-03 20:18:23,2012-11-03 20:18:23
fc42ac6a56a5ce4ad58ff3d817a369cd57345d1b...381d967ec84021ebab3db4172435ff2a4c33e409,2,4,4,8,4,2012-11-03 18:15:01,2012-11-03 18:01:02
fc42ac6a56a5ce4ad58ff3d817a369cd57345d1b...46b5e0cbc6cc82cfcfef45c0eb69a0daac8ceb3c,5,9,9,18,9,2012-11-02 22:34:21,2012-11-02 22:34:21
595e1a189c1911ada7c4bd4c769c28b1741611ac...2ead9a5bc34608c982f06391a55fa82cbd856701,10,82,82,164,36,2012-09-14 13:06:15,2012-09-14 13:06:15
2ead9a5bc34608c982f06391a55fa82cbd856701...faa760f563635c6b3f4f94246ff23ed7f49ae8fb,2,22,24,46,2,2012-09-14 17:30:55,2012-09-14 17:30:55
faa760f563635c6b3f4f94246ff23ed7f49ae8fb...5aa10184968ac70b7d0d809d370623866252a663,1,5,5,10,2,2012-09-14 21:31:14,2012-09-14 21:31:14
5aa10184968ac70b7d0d809d370623866252a663...e4e2e37c5c713944df61dd807bedb2febca31c13,6,4,4,8,2,2012-09-14 21:48:03,2012-09-14 21:48:03
e4e2e37c5c713944df61dd807bedb2febca31c13...0bcbcf69ecdbbfb6e200f217f325ac52c6e4e380,2,284,0,284,2,2012-09-14 22:17:46,2012-09-14 22:17:46
0bcbcf69ecdbbfb6e200f217f325ac52c6e4e380...78570890659e26f60effee3324fc3255cf6f64a3,6,104,10,114,11,2012-09-14 22:21:44,2012-09-14 22:21:44
78570890659e26f60effee3324fc3255cf6f64a3...6c4b276cd4ca648db0afcd84aba809a74fa23bda,5,142,52,194,19,2012-09-14 22:55:46,2012-09-14 22:55:46
595e1a189c1911ada7c4bd4c769c28b1741611ac...5331fe39df7bf0f010d0001a91a2ff796e3989b5,1,1,1,2,1,2012-09-13 19:16:18,2012-09-13 19:16:18
4bf93a2d76ddec19e22be771ef1832ef563c91a5...dee57462e2805421a0fe0d786229446bbaef677b,20,95,74,169,65,2012-08-15 04:06:08,2012-08-15 04:06:08
4bf93a2d76ddec19e22be771ef1832ef563c91a5...2df0a0fdeb2ceec2cb193dee98d97cfb9c5e1b87,3,3,2,5,3,2012-08-14 11:58:12,2012-08-14 11:58:12
e9b04acb92538718f60b205909c385222406a84f...2a6deb92b1786d572ed23347e486043e0df63547,2,6,6,12,6,2012-08-14 21:29:31,2012-08-14 21:29:31
2a6deb92b1786d572ed23347e486043e0df63547...0b0d7f104c08307e0a6f275ccaa60db580d6f728,2,18,0,18,2,2012-08-14 21:32:03,2012-08-14 21:32:03
e9b04acb92538718f60b205909c385222406a84f...f6ac2979039ea151384781301f7020a65a9294be,1,1,1,2,1,2012-08-14 18:06:35,2012-08-14 18:06:35
39f779b5d3c94f51b4f606938bce72ace666d2b1...51b43acf2005993f7d9a0b5ac8abbad72d7a2dc1,1,2,1,3,1,2012-08-17 18:23:39,2012-08-17 18:23:39
51b43acf2005993f7d9a0b5ac8abbad72d7a2dc1...79e05d0c0e9dd658382607f2c1b8eb508b05b491,2,2,2,4,2,2012-08-17 18:24:48,2012-08-17 18:24:48
79e05d0c0e9dd658382607f2c1b8eb508b05b491...b8715ddfd03514da7fd56c46204d460cbb95dfcf,2,2,2,4,2,2012-08-17 18:27:11,2012-08-17 18:27:11
b8715ddfd03514da7fd56c46204d460cbb95dfcf...b86e1fb62a25fcd955b1dbe5764788f2de36b735,2,8,8,16,4,2012-08-17 18:31:21,2012-08-17 18:31:21
b86e1fb62a25fcd955b1dbe5764788f2de36b735...077577c7f3e71f7451513059ccd1c3775acc4025,4,75,5,80,7,2012-08-17 18:46:23,2012-08-17 18:46:23
077577c7f3e71f7451513059ccd1c3775acc4025...9e6322dbab50d416246317d0e0e1b02477845bb4,2,2,2,4,2,2012-08-17 19:59:32,2012-08-17 19:59:32
9e6322dbab50d416246317d0e0e1b02477845bb4...2b22c0c56efb86c213884897f14383f45e1414b3,2,6,2,8,2,2012-08-17 23:00:36,2012-08-17 23:00:36
e79eb75e0944c2852fc47e117f4e96b984e40051...c531a75ff00fd58a6d1c05a944145ff165dba837,2,2,2,4,2,2012-08-19 18:53:55,2012-08-19 18:53:55
e79eb75e0944c2852fc47e117f4e96b984e40051...1166b39630cb2394722456a38d99a3cca4c97354,2,1,15,16,2,2012-08-19 02:24:29,2012-08-19 02:24:29
1166b39630cb2394722456a38d99a3cca4c97354...937cfa6a88919eaa6bfd3e65405093f9bd46c95d,2,2,2,4,2,2012-08-19 02:32:50,2012-08-19 02:32:50
937cfa6a88919eaa6bfd3e65405093f9bd46c95d...44e35e9dfa33fe618218c770f0495bd9596f3485,1,1,1,2,1,2012-08-19 02:33:46,2012-08-19 02:33:46
44e35e9dfa33fe618218c770f0495bd9596f3485...45dddc59a19f3e9decaa4bf0e0db3f884a0f6ff7,9,26,17,43,15,2012-08-19 02:54:30,2012-08-19 02:54:30
45dddc59a19f3e9decaa4bf0e0db3f884a0f6ff7...c9cef741f6d97bb8549af8e4809fccce4339f2f4,4,13,13,26,7,2012-08-19 03:18:15,2012-08-19 03:18:15
d0447e9aa54898ea46596e0e2077f33f0dbd1968...78120edf728ede35f2338b42ae30fff1bd7f086e,2,9,0,9,2,2012-01-28 05:20:58,2012-01-28 05:20:58
78120edf728ede35f2338b42ae30fff1bd7f086e...ad78caa72639aa377caf584efc26fe7a5682b15c,2,2,0,2,2,2012-01-28 05:25:35,2012-01-28 05:25:35
15d3a4797f3435d1531804369df87fa4e574b874...0255f47eb3f4967851d014a9ef6fdf49a37dc548,4,38,3,41,9,2012-01-28 05:36:58,2012-01-28 05:36:58
43b8fd88d06ecee056288d1948d8b6f15b00d289...026e7ccf4e34561ce4ef3705a93e053312c9d477,4,4,4,8,4,2015-03-15 21:50:31,2015-03-15 21:50:31
026e7ccf4e34561ce4ef3705a93e053312c9d477...66ceae7b753137376ee00cd5a68004b7831c6eb9,1,1,1,2,1,2015-03-16 07:57:23,2015-03-16 07:57:23
66ceae7b753137376ee00cd5a68004b7831c6eb9...4d652035dcf8fd42783dc466605e4c5d045e11fc,19,32,32,64,31,2015-03-16 15:39:31,2015-03-16 15:39:31
4d652035dcf8fd42783dc466605e4c5d045e11fc...8dbdb8f977b250a8fa99f1a507f2207d5c7fafc1,1,1,1,2,1,2015-03-16 15:40:34,2015-03-16 15:40:34
8dbdb8f977b250a8fa99f1a507f2207d5c7fafc1...312e527cb099cd9bbed41233ba96a85f066f04f5,1,3,3,6,1,2015-03-16 15:41:00,2015-03-16 15:41:00
312e527cb099cd9bbed41233ba96a85f066f04f5...a10eb60bc0b07b747fa0c4ebd8821eb7307bd07f,14,65,65,130,63,2015-03-16 15:44:41,2015-03-16 15:44:41
a10eb60bc0b07b747fa0c4ebd8821eb7307bd07f...f5250d0a0e2a7cfed77f55654027ff151ebe5aeb,2,4,4,8,2,2015-03-16 15:50:28,2015-03-16 15:50:28
442d2dd458c6283c7ecb75c6eb7cb4bcee916eab...4cb39987f07ca50d9466fabdb0814ad7c6f71c05,2,11,9,20,4,2015-02-26 07:21:21,2015-02-26 07:21:21
442d2dd458c6283c7ecb75c6eb7cb4bcee916eab...3bb05b5fbb6bbf247923a53829b53a27f1b6972b,11,22,22,44,22,2015-02-26 07:20:42,2015-02-26 07:20:42
3bb05b5fbb6bbf247923a53829b53a27f1b6972b...4ff9c54cddc428e195d6a0c7ba9b4473402bcb3d,1,2,2,4,2,2015-02-26 07:29:27,2015-02-26 07:26:26
4ff9c54cddc428e195d6a0c7ba9b4473402bcb3d...9afb61fffddb00b35e36427c216c51aa2e20dd9e,1,2,2,4,1,2015-02-26 07:29:27,2015-02-26 07:27:12
de31b61e4238c8859f5ff9a5474ebd0cbcbd9c7c...9bdaf03607b0d2b8a6f9fc9ce29b1679925aa549,1,1,1,2,1,2015-02-23 03:01:36,2015-02-23 03:01:26
f60067f85939cd0c5504e048c4a401a2f67042e6...4131af8a67b5afef234f1a7f42adc97adef96804,1,1,1,2,1,2015-02-16 09:10:28,2015-02-16 09:10:28
4131af8a67b5afef234f1a7f42adc97adef96804...7a4fadb7b8d6a60f2cbfd42fab880bccb179081c,2,3,17,20,5,2015-02-16 09:39:14,2015-02-16 09:39:14
57260f16b364e4cb559cd65159197fd1cf5248f7...19222bfe8962c9987aa96d7bdeb0b5f2ce1505ba,1,1,1,2,1,2015-01-04 06:05:49,2015-01-04 06:05:49
57260f16b364e4cb559cd65159197fd1cf5248f7...ba8a40e7888f80ee22760b36e032417804ce3cec,1,1,0,1,1,2015-01-02 09:28:09,2015-01-02 09:28:09
feda77f1274cc22cacf21933bccb080add42a7d0...3425489273d8e0d1111427e5cdaeaa869750f03f,1,1,1,2,1,2015-02-24 19:03:28,2015-02-24 19:03:28
feda77f1274cc22cacf21933bccb080add42a7d0...ced312a90e5e4eeb9dc7143abc18364159ee3216,1,3,3,6,3,2015-02-24 14:14:50,2015-02-24 14:14:50
eefa0ada9611f7861a381050af03f1f5f98aae58...05513c52c4b31db3646639ba4e1b8a5ee7271ae9,2,2,2,4,3,2015-02-25 00:43:07,2015-02-25 00:43:07
2a6207c0c9888fb5d7961bf766bfd4e28a61ed19...7f7c7901ae2e9111540ef5c90bdba78df2e3381f,2,21,17,38,9,2015-02-24 22:14:59,2015-02-24 22:14:59
7e6cc0bf7ec795189dc14e6b27ffd25940081c71...823b5accd327e129e301b2f0508d911fe0d194c6,2,18,0,18,2,2012-11-05 03:41:41,2012-11-05 03:41:41
ee93541421e41f3a9589f9c945ef4a6614f48b4b...34880e3ef569c7ed8116f033bedb038129dd304b,1,1,1,2,1,2012-11-05 03:59:50,2012-11-05 03:59:50
10e72e158d5d85b1373375a5230fe2b9865c8bba...437654030aa283b92a260245b54fa17a417c20d8,5,9,6,15,9,2012-12-07 23:37:32,2012-12-07 23:37:32
437654030aa283b92a260245b54fa17a417c20d8...1747caf19d59cad7fdc90ae56a00e0e2849f95f4,4,7,7,14,7,2012-12-07 23:59:13,2012-12-07 23:59:13
1747caf19d59cad7fdc90ae56a00e0e2849f95f4...820a3b27b6cfd320584be5a8e1652c7dff9771e4,5,43,28,71,30,2012-12-08 00:16:48,2012-12-08 00:16:48
818c56f078ff3b14fefceca77608d1e95f33a783...24a36df9f6afa27de0dcc44799c9ab428969d8ca,6,31,10,41,12,2012-12-22 03:45:19,2012-12-22 03:45:19
24a36df9f6afa27de0dcc44799c9ab428969d8ca...ddd59f22c7d6e3df7f7e427febc1d08035e0ec8b,2,14,4,18,6,2012-12-22 04:19:33,2012-12-22 04:19:33
306c1b49147c388b7c458a939989bf33d464a69d...2c7ab23d7aae889b9bc649517f1c0654e69fd57e,2,5,5,10,2,2012-12-07 17:43:09,2012-12-07 17:43:09
306c1b49147c388b7c458a939989bf33d464a69d...f4466dd9c72da5604b1aa45c81d2d0e4cac3fad6,2,4,0,4,2,2012-12-06 18:33:00,2012-12-06 18:33:00
306c1b49147c388b7c458a939989bf33d464a69d...81679981c539338be9cba6c5650579ec796afb69,4,10,10,20,10,2012-12-05 23:28:14,2012-12-05 23:28:14
33e14fe5bfd7a7091ab491a961d66a2a2580f1de...be5f31480b53555c492e0077c8bb9f419fc48f62,8,1824,1824,3648,1039,2012-12-05 19:09:02,2012-12-05 19:09:02
bca3ff4ed6f42701ceae1405f518c35ec8c623be...fbec803b553c0b12a11ace0a48adfd8e4e129a8d,1,1,0,1,1,2012-12-01 23:53:05,2012-12-01 23:52:13
7ea343d57014555a3fd244b2308945d8c7684e18...c9dbd2d60147b1a2f05fe08c72a0a28a90c73dc7,3,38,4,42,8,2012-11-03 20:28:48,2012-11-03 20:28:48
c9dbd2d60147b1a2f05fe08c72a0a28a90c73dc7...a8b9342aea29632928cac4c3458faf80c682d9d1,2,135,0,135,2,2012-11-03 20:37:34,2012-11-03 20:37:34
a8b9342aea29632928cac4c3458faf80c682d9d1...2c931902832348b0c1425e9dd3c7059bfcb2a918,2,56,66,122,5,2012-11-03 20:42:08,2012-11-03 20:42:08
6c4b276cd4ca648db0afcd84aba809a74fa23bda...6e25aacc91b11e667f9822df411d97cc3866ecd6,1,89,18,107,23,2012-09-17 04:54:06,2012-09-17 04:53:56
6e25aacc91b11e667f9822df411d97cc3866ecd6...1ea09b751eca711a65f881a58ba67c71ee6b47e0,2,2,1,3,2,2012-09-17 15:52:19,2012-09-17 15:52:19
1ea09b751eca711a65f881a58ba67c71ee6b47e0...6f3bef195a7f24c241a0253bc4a402b863bd64cc,3,0,493,493,3,2012-09-17 15:53:13,2012-09-17 15:53:13
6c4b276cd4ca648db0afcd84aba809a74fa23bda...6aa15eb01f2e50e394ae172ff41e5bc0583de6da,1,34,1,35,2,2012-09-16 07:02:31,2012-09-16 07:02:31
ae9a2bd93a8863eca8346f19a29d55f6c726a156...ff38c149480cafce9612f65491667de78351b370,2,2,2,4,2,2012-08-15 04:23:29,2012-08-15 04:23:29
662fface3b73917b8424ad87995dee62f5e3053a...dbcd87331d8a84fe5f65da0420409e859effebf1,2,7,5,12,2,2012-08-14 21:51:33,2012-08-14 21:51:33
dbcd87331d8a84fe5f65da0420409e859effebf1...50df524ba1b504e069e69e6f317184357f397cd0,2,9,4,13,7,2012-08-14 21:53:45,2012-08-14 21:53:45
50df524ba1b504e069e69e6f317184357f397cd0...5144c77b272e12a48913faa0b7d1e54eccd2e638,2,5,4,9,5,2012-08-14 21:57:49,2012-08-14 21:57:49
5144c77b272e12a48913faa0b7d1e54eccd2e638...a80dafbb18bc689abcfe45cd4aec570e7790b171,3,2,3,5,3,2012-08-14 22:00:22,2012-08-14 22:00:22
a80dafbb18bc689abcfe45cd4aec570e7790b171...b14d946afbe1844ef026a120ee82bf1f2c3ef348,1,11,3,14,4,2012-08-14 22:12:22,2012-08-14 22:12:22
b14d946afbe1844ef026a120ee82bf1f2c3ef348...780636d955d5c121133de526ba72c1874f7c0337,2,2,2,4,3,2012-08-14 22:29:47,2012-08-14 22:29:47
780636d955d5c121133de526ba72c1874f7c0337...f933a41c7bb71e58a4c151389748b92c8a204a27,2,2,2,4,2,2012-08-14 22:34:10,2012-08-14 22:34:10
f933a41c7bb71e58a4c151389748b92c8a204a27...f3479a39537b7b10bf66846c11d500f3364af88a,5,8,7,15,5,2012-08-14 22:44:25,2012-08-14 22:44:25
f3479a39537b7b10bf66846c11d500f3364af88a...9c72246d491fa942635a27ee0047e473f4df05cc,6,32,17,49,16,2012-08-14 23:24:58,2012-08-14 23:24:58
75e5279e015c20e54308f9b8e8cd346ffc63ed4e...41093a328edd8b49f68bc1f817506ada11b568ef,1,2,5,7,2,2012-08-14 22:11:57,2012-08-14 22:11:57
8e271d664b80f7e04528ba25b81dfc4a7b316df7...7ed82c1223e2876c69ae8bc9c21ccff39db18b97,3,7,7,14,7,2012-08-19 18:59:28,2012-08-19 18:59:28
7ed82c1223e2876c69ae8bc9c21ccff39db18b97...bb85bbc657e9ba35292acb7dd37fbeb2551b94c2,5,19,20,39,18,2012-08-19 19:04:41,2012-08-19 19:04:41
bb85bbc657e9ba35292acb7dd37fbeb2551b94c2...47cf3cc62f249052f67b1390bdeb433684b6da0b,3,9,8,17,9,2012-08-19 19:07:23,2012-08-19 19:07:23
47cf3cc62f249052f67b1390bdeb433684b6da0b...887f11d47f052a0dd123f76a6ac39a955c2429d4,4,64,50,114,10,2012-08-19 20:12:43,2012-08-19 20:12:19
887f11d47f052a0dd123f76a6ac39a955c2429d4...b745b7768a837a38ca47f174c62b8689e18e2733,2,11,4,15,10,2012-08-20 00:07:41,2012-08-20 00:07:41
b745b7768a837a38ca47f174c62b8689e18e2733...94ba211c402a27f85b350ccdaac154509bd0013e,1,2,6,8,2,2012-08-20 03:32:29,2012-08-20 03:32:29
94ba211c402a27f85b350ccdaac154509bd0013e...e71e2b4be2ad484ece85ef22df934bd0acd926d1,2,2,2,4,2,2012-08-20 03:38:16,2012-08-20 03:37:31
e71e2b4be2ad484ece85ef22df934bd0acd926d1...e4d4ef43b091ce6e554d02cf473602aeae2e51ae,2,2,2,4,2,2012-08-20 03:38:27,2012-08-20 03:38:27
e4d4ef43b091ce6e554d02cf473602aeae2e51ae...4e979f084d0a0942cb820ca54786ad2b99e4acff,18,78,52,130,56,2012-08-20 04:12:52,2012-08-20 04:12:52
4e979f084d0a0942cb820ca54786ad2b99e4acff...a667fd93aba8e947f94af973518b7dce25c08765,16,43,51,94,40,2012-08-20 06:01:24,2012-08-20 06:01:24
a667fd93aba8e947f94af973518b7dce25c08765...a12c19b3c8e07516a38302feb4e8aa7c94600a4d,2,8,6,14,6,2012-08-20 06:05:16,2012-08-20 06:05:16
a12c19b3c8e07516a38302feb4e8aa7c94600a4d...e510306196b6433dc73302d24ca58313d3a31ec7,27,41,41,82,41,2012-08-20 06:07:18,2012-08-20 06:07:18
c9cef741f6d97bb8549af8e4809fccce4339f2f4...1e190d8036184077cac8c3acb670945853cb75ef,1,1,0,1,1,2012-08-19 14:32:40,2012-08-19 14:32:40
ad78caa72639aa377caf584efc26fe7a5682b15c...cb8606f2c84adb57c82dd7bd401574a2376ff952,5,355,234,589,29,2012-01-28 06:52:45,2012-01-28 06:52:45
1e07c066a5cefc2f73b406e1eebc5627bd9e7afb...e726b231ba0c0c0effb13c9458842d64bda0e58c,3,13,1,14,5,2012-01-28 05:59:06,2012-01-28 05:59:06
e726b231ba0c0c0effb13c9458842d64bda0e58c...7cbb5868259ef95aacbd16812c25ac73ea76ca2d,3,44,11,55,11,2012-01-28 06:27:06,2012-01-28 06:27:06
f5250d0a0e2a7cfed77f55654027ff151ebe5aeb...c26ffd43c39e2b6b31c67ba7f40c56d9caff8743,2,11,2,13,4,2015-03-17 17:29:36,2015-03-17 17:24:31
f5250d0a0e2a7cfed77f55654027ff151ebe5aeb...8d77efe359560bc00118e06dbad945088ba1f1ba,1,1,1,2,1,2015-03-16 21:41:16,2015-03-16 21:41:03
8d77efe359560bc00118e06dbad945088ba1f1ba...78025868e0d9720e0c957e87b5d6f9c1e63e8442,1,1,1,2,2,2015-03-16 21:47:07,2015-03-16 21:47:07
78025868e0d9720e0c957e87b5d6f9c1e63e8442...319cda7f6c10a092982677e0c049d84cfec72b34,4,31,13,44,7,2015-03-16 21:51:35,2015-03-16 21:48:49
c65deddcced37ae7df2d5a7676cef9d9ff1729a9...05b444aee3d6c9b8b18db2ffba1920fc5267fa5f,7,51,51,102,23,2015-02-26 09:30:23,2015-02-26 09:14:46
68fef8c2470be258107f5ab0d587c89ebfaaa221...79eb5854ea06c95b0640168d243f920ca1ba3f1d,3,14,14,28,14,2015-02-24 03:14:50,2015-02-24 03:14:50
68fef8c2470be258107f5ab0d587c89ebfaaa221...74b4f834344bddb7ef1531fcb3c177c0fe05d4e9,1,3,3,6,3,2015-02-24 02:59:27,2015-02-24 02:59:27
68fef8c2470be258107f5ab0d587c89ebfaaa221...8a64c684deabb12b4f5f4fd18c736645159a7cf1,1,6,6,12,6,2015-02-24 02:51:10,2015-02-24 02:51:10
68fef8c2470be258107f5ab0d587c89ebfaaa221...f8280e40a01e0affdb684d15e1bedc93310bd627,1,2,2,4,2,2015-02-24 02:41:53,2015-02-24 02:41:53
68fef8c2470be258107f5ab0d587c89ebfaaa221...3e2dee6bd523a66119b7be0d01f2d24d9b9fea14,1,2,2,4,2,2015-02-24 02:35:37,2015-02-24 02:35:37
68fef8c2470be258107f5ab0d587c89ebfaaa221...9159e44a7a17d2634da006c3545760c62c44d2f3,1,6,6,12,6,2015-02-24 02:16:02,2015-02-24 02:16:02
68fef8c2470be258107f5ab0d587c89ebfaaa221...36fdaa8030e28ed8300623d3947f0489b03d22ad,1,5,5,10,5,2015-02-24 02:01:54,2015-02-24 02:01:54
7a4fadb7b8d6a60f2cbfd42fab880bccb179081c...d13e879042b1ebe26ff41956510c3b71331272b6,2,0,2,2,2,2015-02-16 09:40:42,2015-02-08 01:53:51
d13e879042b1ebe26ff41956510c3b71331272b6...a2c7233ac05f3fec7caef614ec4dd35807414da9,2,4,2,6,2,2015-02-17 03:17:01,2015-02-08 01:59:19
19222bfe8962c9987aa96d7bdeb0b5f2ce1505ba...9d0f6c05f423347356876d5a5478ef4b74eacd24,1,1,0,1,1,2015-01-05 20:40:43,2015-01-05 20:40:43
be164f4d1a8703144cfed588ed53d7ec432149e4...6e0c84322371b26470567936185f768ab52bff07,1,14,17,31,6,2015-02-25 00:37:13,2015-02-25 00:37:13
ebed09ec01751493c216ddd4090dfd1df79812e4...91bcccd9a83ee8a351069283c80a749caa220080,2,10,11,21,4,2012-11-05 03:43:09,2012-11-05 03:43:09
91bcccd9a83ee8a351069283c80a749caa220080...62c78e46f8d027d0797c66bef5ce8cdb8d667ace,4,19,18,37,10,2012-11-05 03:53:13,2012-11-05 03:53:13
820a3b27b6cfd320584be5a8e1652c7dff9771e4...3bd9a26c01d6740d0b3a7aaad94ac53df3920c8c,2,8,8,16,8,2012-12-08 20:06:46,2012-12-08 20:06:46
f59bf470810c3be7867f6212bb0f20b97509d800...e2434fefbd9d68e79d4ecae1f41b018b2c1d4199,4,4,4,8,4,2012-12-22 04:27:53,2012-12-22 04:27:53
e2434fefbd9d68e79d4ecae1f41b018b2c1d4199...fad0fb683bdcc71f5ffc9c18300dd19427b588ae,6,53,29,82,12,2012-12-22 21:24:37,2012-12-22 21:24:37
fad0fb683bdcc71f5ffc9c18300dd19427b588ae...a9e661a2b5cc96e2148d62fa5ccd41522197ceef,1,1,1,2,1,2012-12-22 21:48:16,2012-12-22 21:48:16
a9e661a2b5cc96e2148d62fa5ccd41522197ceef...4d195222d46c21fe31dfa1246bdb11474476b36d,4,4,4,8,4,2012-12-22 21:48:28,2012-12-22 21:48:28
4d195222d46c21fe31dfa1246bdb11474476b36d...2c0ed072b07f79eb617f15062f52fa349e95305d,6,73,64,137,16,2012-12-22 21:57:57,2012-12-22 21:57:57
2c0ed072b07f79eb617f15062f52fa349e95305d...effba9e55c9598985a6be6acd6711ceb9daf2fb1,1,1,1,2,1,2012-12-22 22:22:45,2012-12-22 22:22:45
d23006a6bd76959db3c1ef2de6451e8905e77046...5a2966a2c2944f7c4ce963b82837c73faa2234ee,1,1,1,2,1,2012-12-22 02:59:51,2012-12-22 02:59:51
5a2966a2c2944f7c4ce963b82837c73faa2234ee...442012f0f5050f69467fabd6e44ac57394088b1b,1,1,1,2,1,2012-12-22 03:02:33,2012-12-22 03:02:33
442012f0f5050f69467fabd6e44ac57394088b1b...a55605ca57d3607689d8d6b8d2de1c1026bab405,1,0,0,0,0,2012-12-22 03:04:59,2012-12-22 03:04:59
a55605ca57d3607689d8d6b8d2de1c1026bab405...7f7039321d9078ff7127b56aabe6be0e85716350,1,1,0,1,1,2012-12-22 03:10:05,2012-12-22 03:10:05
cc6fda226274c0b0e1ac27fdf36889cec9d352dc...be45a821bb3387cac0944d80f7569b912cc21483,4,19,20,39,10,2012-12-07 17:51:01,2012-12-07 17:51:01
bc0b94a3fdc8fe480c74f4494073e2c0addb265e...2183ab63b7ea1894074d4306ddbbe9b82cbfc59a,1,0,1,1,1,2012-12-14 05:38:09,2012-12-14 05:33:07
bc0b94a3fdc8fe480c74f4494073e2c0addb265e...ecfa09decb7dff6ad601834c2ad400467a72ba96,1,8,2,10,3,2012-12-12 16:48:44,2012-12-12 16:48:44
bc0b94a3fdc8fe480c74f4494073e2c0addb265e...3b5d4f52a3c2a11ec732fd9ca3b58e83290cd03c,4,60,33,93,20,2012-12-10 07:42:05,2012-12-10 07:42:05
3b5d4f52a3c2a11ec732fd9ca3b58e83290cd03c...48759eee941729a2e21a89215123b2e05c0b8549,2,74,0,74,2,2012-12-10 09:33:02,2012-12-10 09:33:02
48759eee941729a2e21a89215123b2e05c0b8549...8c8a14ab59553984d6bb2b1d080e9f3917d6e981,2,4,2,6,2,2012-12-10 09:46:16,2012-12-10 09:46:16
dbb244cb97d8bdd1dc765a573aa9a77005f25e86...e8b3c36068e854bfa4f45bcb02257358e79fdd93,1,1,0,1,1,2012-12-02 08:09:45,2012-12-02 08:09:45
fca35c0dba060da14ccb29fc56dc37aa1de533c4...71d8bebfbc557c89497a1299762a3baf86334aca,1,2,8,10,2,2012-11-30 08:21:44,2012-11-30 08:21:44
71d8bebfbc557c89497a1299762a3baf86334aca...4fd164d45bdb3bfc52119d828ed7efebc92f8339,3,19,41,60,6,2012-11-30 08:24:17,2012-11-30 08:24:17
4fd164d45bdb3bfc52119d828ed7efebc92f8339...8d09e7c24d2174dd5c85461eaedeacfb299faeaa,1,0,3,3,3,2012-11-30 08:26:02,2012-11-30 08:26:02
8d09e7c24d2174dd5c85461eaedeacfb299faeaa...7313702cf3e609dfed685bccc66b327436f92385,6,54,325,379,53,2012-11-30 08:53:07,2012-11-30 08:53:07
7313702cf3e609dfed685bccc66b327436f92385...030a05817451a0c6fbbdc9842570303dbe9a367e,3,92,98,190,4,2012-11-30 20:36:55,2012-11-30 20:36:55
030a05817451a0c6fbbdc9842570303dbe9a367e...f9a47e3a5fc1f91f041f2d8cb264f1d5af142126,6,12,18,30,7,2012-11-30 20:42:37,2012-11-30 20:42:37
f9a47e3a5fc1f91f041f2d8cb264f1d5af142126...fe8061b84ecdda5ea70514fe487e2f46564439e2,5,125,86,211,38,2012-11-30 21:35:20,2012-11-30 21:35:20
fe8061b84ecdda5ea70514fe487e2f46564439e2...7a3d15eb210cc9343875760bfa575a9273244ed3,31,191,196,387,142,2012-11-30 22:37:24,2012-11-30 22:37:24
7a3d15eb210cc9343875760bfa575a9273244ed3...b0e2b5813db753bdfa3ee018ccdd73e78a69457e,33,221,219,440,158,2012-11-30 22:45:25,2012-11-30 22:45:25
b0e2b5813db753bdfa3ee018ccdd73e78a69457e...9239bfbc7bbd549d987da03046399dd5fcbd5f7f,17,152,155,307,120,2012-11-30 23:05:23,2012-11-30 23:05:23
9239bfbc7bbd549d987da03046399dd5fcbd5f7f...0ef347706c7585cb2a53fa99b03d59e18908fee1,5,44,34,78,35,2012-11-30 23:09:57,2012-11-30 23:09:57
0ef347706c7585cb2a53fa99b03d59e18908fee1...12a00f62a9a9915479767807ab03ba5ac19a4cef,7,8,49,57,8,2012-11-30 23:18:49,2012-11-30 23:18:49
12a00f62a9a9915479767807ab03ba5ac19a4cef...01421ecd62c0f3013f881ad3fcde10769d7328ec,8,12,31,43,9,2012-11-30 23:23:13,2012-11-30 23:23:13
01421ecd62c0f3013f881ad3fcde10769d7328ec...a09cea44aeb6f19f560205636e9312e71d58d58c,6,28,30,58,15,2012-11-30 23:27:13,2012-11-30 23:27:13
a09cea44aeb6f19f560205636e9312e71d58d58c...62a22200358639e860cad06c7b468cde9d446456,6,135,134,269,75,2012-11-30 23:33:56,2012-11-30 23:33:56
62a22200358639e860cad06c7b468cde9d446456...51c418d468e5fe1f26c95457b70f7a2ad6354646,1,19,19,38,4,2012-11-30 23:34:35,2012-11-30 23:34:35
51c418d468e5fe1f26c95457b70f7a2ad6354646...0a93bc143d8b45a365ee983b05e64699081ddc5f,5,22,18,40,13,2012-11-30 23:36:16,2012-11-30 23:36:16
0a93bc143d8b45a365ee983b05e64699081ddc5f...e34b3730b7a3a46b1b4dcbf3d5cab9bf2cbc94b1,8,68,68,136,45,2012-11-30 23:38:31,2012-11-30 23:38:31
e34b3730b7a3a46b1b4dcbf3d5cab9bf2cbc94b1...b8b266ca7ce4419d0b64d7c9cc895db9c1e79015,4,107,107,214,54,2012-11-30 23:40:44,2012-11-30 23:40:44
b8b266ca7ce4419d0b64d7c9cc895db9c1e79015...adc2c779a06f1eea4fefddcf0d666a7131477d8c,10,52,52,104,37,2012-11-30 23:43:07,2012-11-30 23:43:07
adc2c779a06f1eea4fefddcf0d666a7131477d8c...0fabca01dbd02c480cfb431d5abb0d6cd327622e,8,3,215,218,9,2012-12-01 00:18:40,2012-12-01 00:18:40
0fabca01dbd02c480cfb431d5abb0d6cd327622e...10c14e8955868ba2b0174ca3022a139f4b95dc75,6,300,8965,9265,10,2012-12-01 00:29:30,2012-12-01 00:29:30
10c14e8955868ba2b0174ca3022a139f4b95dc75...ebd2215e494e77a0da3283c1006a5ac164b8e862,9,8402,32,8434,10,2012-12-01 00:31:24,2012-12-01 00:31:24
ebd2215e494e77a0da3283c1006a5ac164b8e862...6961b284b6680c95dfe1610d7306dab3d4a72052,3,2,23,25,4,2012-12-01 00:42:48,2012-12-01 00:42:48
6961b284b6680c95dfe1610d7306dab3d4a72052...51b4de8eec1cb3351b5a6e711a54acae5424935c,2,2,2,4,2,2012-12-01 00:43:31,2012-12-01 00:43:31
51b4de8eec1cb3351b5a6e711a54acae5424935c...094710565693af887ca85324bd5251846bd1708a,2,2,2,4,2,2012-12-01 01:43:20,2012-12-01 01:43:20
094710565693af887ca85324bd5251846bd1708a...98b0d475ae9db023cc22b011388f1bea1c88c537,38,52,99,151,53,2012-12-01 06:30:50,2012-12-01 06:30:50
98b0d475ae9db023cc22b011388f1bea1c88c537...dd11d0a3fa4ba061f6dcb8db81f144d81101e052,11,179,65,244,15,2012-12-01 21:47:07,2012-12-01 21:47:07
dd11d0a3fa4ba061f6dcb8db81f144d81101e052...19ee7999f4db33406c4552d4eed568cd1fb8405a,4,55,137,192,36,2012-12-01 22:25:28,2012-12-01 22:25:28
19ee7999f4db33406c4552d4eed568cd1fb8405a...9c028ea54b7be6361f1be1e26b5a8a5dd6aa6bb0,1,1,1,2,1,2012-12-02 02:51:03,2012-12-02 02:51:03
9c028ea54b7be6361f1be1e26b5a8a5dd6aa6bb0...b3019d7aab877cccf03fda3e6894c0fdaa7330f3,22,296,18,314,12,2012-12-05 04:30:21,2012-12-05 04:30:21
5d6cf2ee1939515ad41b052ed1c406f96274ea37...e4866c4b3c50c1d1bef5c639c13a2210416b0157,2,2,2,4,2,2012-11-04 20:27:18,2012-11-04 20:27:18
f69e244a6036a40fd1721b4e56dc54e5ce1f6af4...03a406d920c0255533aa0f5bb7c3fe4569b8f687,5,209,37,246,9,2012-09-17 22:49:22,2012-09-17 22:49:22
03a406d920c0255533aa0f5bb7c3fe4569b8f687...6881c193ca838844cacaf343d5918fb166bdd437,4,23,3,26,6,2012-09-17 23:09:36,2012-09-17 23:09:36
6881c193ca838844cacaf343d5918fb166bdd437...caa79ed594daae704793a08e94a6e2d9da32eaf1,2,4,4,8,4,2012-09-17 23:26:51,2012-09-17 23:26:51
61a8ef2febf9b9f864d81a6a07aa833c04fc14d9...2ee035403d2dd9c19b7bfd3f90a83422a4ab7d7e,1,1,1,2,1,2012-08-14 23:28:17,2012-08-14 23:28:17
2ee035403d2dd9c19b7bfd3f90a83422a4ab7d7e...e1659b2c4ebcd1124665779fe045600207ea7333,2,12,4,16,4,2012-08-15 01:57:27,2012-08-15 01:57:27
e510306196b6433dc73302d24ca58313d3a31ec7...73cf9c4db8423f6987ff0eb828db32eaed21c975,2,2,0,2,2,2012-08-20 17:28:41,2012-08-20 17:28:41
73cf9c4db8423f6987ff0eb828db32eaed21c975...afaee0ca136033811f48cefc6873fc62fee02923,2,2,2,4,4,2012-08-20 18:09:16,2012-08-20 18:09:16
e510306196b6433dc73302d24ca58313d3a31ec7...a1951ed7c08bbaad37e323b460f440d9598d364e,2,29,8,37,10,2012-08-20 08:12:03,2012-08-20 08:12:03
ed13ec50f84f78a27b994fef73e9e4acaafecb19...78cb09b440c8a49d988aecaf2adfec042c43351d,2,2,1,3,2,2012-08-20 18:31:24,2012-08-20 18:31:24
78cb09b440c8a49d988aecaf2adfec042c43351d...6cf3752b9be2ad4f4804fc974d465e0f897a63df,3,7,4,11,6,2012-08-20 19:16:15,2012-08-20 19:16:15
6cf3752b9be2ad4f4804fc974d465e0f897a63df...58dd1f20aeee82d29693f731844a00cb9c5e4328,2,5,0,5,2,2012-08-20 19:20:22,2012-08-20 19:20:22
58dd1f20aeee82d29693f731844a00cb9c5e4328...01572f00bb5671aaab1763b85c9608c10362aef4,2,14,6,20,11,2012-08-20 19:27:45,2012-08-20 19:27:45
01572f00bb5671aaab1763b85c9608c10362aef4...aa2cec6f2f706f8c1754f8bf79a8c9f094445bd8,1,4,4,8,1,2012-08-20 21:26:38,2012-08-20 21:26:38
1d44f37fc9fb604ed88641c911639207b51d1008...7a756168b52f5bd0af2aedd629379a80e8682c14,2,3,1,4,3,2012-01-28 06:56:48,2012-01-28 06:56:48
7a756168b52f5bd0af2aedd629379a80e8682c14...08fea7587c536b7daa2c976cdb50144379ae2a62,2,74,32,106,20,2012-01-28 07:27:33,2012-01-28 07:27:33
05b444aee3d6c9b8b18db2ffba1920fc5267fa5f...984204c39e00d267f49c39d100d0ac2aab8dae9c,1,1,1,2,1,2015-02-26 14:21:13,2015-02-26 14:21:13
05b444aee3d6c9b8b18db2ffba1920fc5267fa5f...61415d8bb19e23c4ee5d6641486a60055c1a8945,3,240,1,241,4,2015-02-26 09:30:46,2014-11-14 13:00:02
36fdaa8030e28ed8300623d3947f0489b03d22ad...106445aea8befb53fc4b99c47cc34504d14df442,1,4,4,8,4,2015-02-24 02:23:50,2015-02-24 02:23:50
fd7c69b30f422b0e9b469cbd64c60920bbdd0346...b9aad573f9400693f6bcbf9af5374a93228dbe6f,3,146,121,267,61,2015-02-17 05:09:32,2015-02-09 04:15:59
08410280091ff1ef77e110c1e5e29eb8f3653a84...e0b5de6ab12f181247108529b8e7a473eabe3b39,1,1,1,2,1,2015-01-06 00:29:17,2015-01-06 00:29:17
e0b5de6ab12f181247108529b8e7a473eabe3b39...7f65b71cc3f7639eab7ca1f06388f16db2c630c5,1,1,1,2,1,2015-01-06 00:29:52,2015-01-06 00:29:52
7f65b71cc3f7639eab7ca1f06388f16db2c630c5...796634eb95099d229ba0e95222cf91c9d9b53ff2,1,14,366,380,11,2015-01-06 00:33:43,2015-01-06 00:33:35
08410280091ff1ef77e110c1e5e29eb8f3653a84...be6dc3a3c9ac75e9f0a730348dd960922d7aea46,1,81,0,81,8,2015-01-06 00:19:56,2015-01-06 00:19:56
08410280091ff1ef77e110c1e5e29eb8f3653a84...f6a837cbf1eb24429a4356ef95d7a52e6da35b43,3,17,0,17,3,2015-01-05 22:22:49,2015-01-05 22:22:49
f6a837cbf1eb24429a4356ef95d7a52e6da35b43...34f88e94fcc75d212a0076124c8d550bb9f7095d,1,1,1,2,1,2015-01-05 22:47:33,2015-01-05 22:47:33
08410280091ff1ef77e110c1e5e29eb8f3653a84...cd29d42320eb0372df054f6220c9d73d72d60315,2,58,4,62,5,2015-01-05 20:51:05,2015-01-05 20:34:17
6bf8636a91664ba2543ecd0baf40084c1bbbd3ff...149dac0a5873ff8547495dd21c5d65f8b24abf75,4,9,3,12,9,2015-01-15 23:41:25,2015-01-15 23:41:25
9ea98561dffd58b1f59b2687b3d09445b63ff756...daccfc3c0fba61275b514945428270437dba8427,1,7,7,14,7,2015-02-25 01:17:14,2015-02-25 01:17:14
daccfc3c0fba61275b514945428270437dba8427...e9b29a3ef0731683751fdb18c301da4fbf7cc57d,1,2,2,4,2,2015-02-25 01:19:00,2015-02-25 01:19:00
9ea98561dffd58b1f59b2687b3d09445b63ff756...1d892ceef106d5a296da9be9ae6382297a427bb9,2,15,18,33,7,2015-02-25 01:11:20,2015-02-25 01:11:20
1d892ceef106d5a296da9be9ae6382297a427bb9...c40c31a308ed05869c33a4ecb8b5af76fd20d25d,1,5,3,8,3,2015-02-25 01:53:39,2015-02-25 01:53:39
c40c31a308ed05869c33a4ecb8b5af76fd20d25d...769c27a19f4ce8d5d298cedc07905d5300022e24,1,3,0,3,1,2015-02-25 02:23:02,2015-02-24 23:02:16
769c27a19f4ce8d5d298cedc07905d5300022e24...0553300a36e5623e36f90132d24a7f0699a783aa,1,1,0,1,1,2015-02-25 02:30:58,2015-02-25 02:30:58
62c78e46f8d027d0797c66bef5ce8cdb8d667ace...d38bda1480377f2ce8154afd9b538ea104b9e949,3,13,13,26,12,2012-11-05 06:50:07,2012-11-05 06:50:07
d38bda1480377f2ce8154afd9b538ea104b9e949...79b701722797d9f5b2e90825c0621d44c0ad6030,38,51,51,102,51,2012-11-05 17:32:48,2012-11-05 17:32:48
b9292ff90ca90e2df70744d33195993fddf39b3d...cacc2137620675f81ab8895c2988778d12f92596,4,70,38,108,10,2012-12-08 20:52:19,2012-12-08 20:52:19
cacc2137620675f81ab8895c2988778d12f92596...9376a7c221a64c2bf508d02ea2ccd85748d10fcc,2,13,4,17,4,2012-12-08 20:57:21,2012-12-08 20:57:21
d09b46fe378819e80ac75ffc7118fed11ca8da03...0834bd51ec6115f5465340f7a0fc86ce803ccf35,1,2,2,4,2,2012-12-23 05:03:58,2012-12-23 05:03:58
7f7039321d9078ff7127b56aabe6be0e85716350...f74990d898b08be61f0f8b514378adf223d55a4b,38,51,51,102,51,2012-12-23 00:10:06,2012-12-23 00:10:06
1c5b8e967e2b421503bc010d4ed3b79406ea5b7b...a7eb9c294a575b5471ddec45ae75e1d09f7ace4c,40,519,22,541,95,2012-12-07 22:06:01,2012-12-07 22:06:01
09dde5c84ab890404703c95f704978f5cf88fa2b...14844db862a61c92be982921e14a526484f3b8a9,7,107,67,174,40,2012-12-20 07:37:33,2012-12-20 07:37:33
6649918c7f4df9ad8288728c6cef1ee48dc63b9a...6e9bbe6232217fb86e10d0f7623863cf1a1aa135,2,12,12,24,10,2012-12-10 06:08:11,2012-12-10 06:08:11
6e9bbe6232217fb86e10d0f7623863cf1a1aa135...4245e8ebb5c98ca1a89b7b56578d4fe52ee81802,4,76,50,126,8,2012-12-10 06:13:40,2012-12-10 06:13:40
4245e8ebb5c98ca1a89b7b56578d4fe52ee81802...ac20a082817e671250529b68147d5b60e2321e69,1,1,1,2,1,2012-12-17 18:11:33,2012-12-17 18:11:33
ac20a082817e671250529b68147d5b60e2321e69...840e47eabdcf41239d55d6bf046ea8cc9e2065da,3,34,51,85,27,2012-12-20 01:49:20,2012-12-20 01:49:20
6649918c7f4df9ad8288728c6cef1ee48dc63b9a...4c82dd3645ec60277b07a161c779f57dda10037c,6,393,786,1179,101,2012-12-10 05:46:14,2012-12-10 05:46:14
4c82dd3645ec60277b07a161c779f57dda10037c...19a94d08d659d39e718efca95812cac2db178b15,4,10,76,86,11,2012-12-20 03:33:14,2012-12-20 03:33:14
19a94d08d659d39e718efca95812cac2db178b15...26b999b76ac564b89f21e6f80cc3052f57b60aa2,2,0,2,2,2,2012-12-20 03:46:44,2012-12-20 03:46:44
e1659b2c4ebcd1124665779fe045600207ea7333...ada5589184550ea87b37ae3cba9edfce57c04e99,2,5,0,5,2,2012-08-15 21:45:35,2012-08-15 21:45:35
47697c5f352c08294fb8a077e1ab27dce7decdb9...2fda6a45aa762f66e573a81c279f79e362f3593f,4,54,22,76,18,2012-08-20 18:22:37,2012-08-20 18:22:37
2fda6a45aa762f66e573a81c279f79e362f3593f...e59642838fcac7af9a326b1d5a3830b18d9f3001,1,3,3,6,4,2012-08-20 18:28:30,2012-08-20 18:28:30
aa2cec6f2f706f8c1754f8bf79a8c9f094445bd8...cbc7873bb464dfd96621d9aa468801c3883c3b98,1,1,1,2,1,2012-08-20 23:33:41,2012-08-20 23:33:41
cbc7873bb464dfd96621d9aa468801c3883c3b98...471d913ab61d9e91802606a234f423d08b63567a,1,1,0,1,1,2012-08-20 23:37:46,2012-08-20 23:37:46
471d913ab61d9e91802606a234f423d08b63567a...fe3ed433e4ceffe7e935d56f932a97cbcaef081d,1,0,1,1,1,2012-08-21 10:33:15,2012-08-21 10:33:15
08fea7587c536b7daa2c976cdb50144379ae2a62...3451dcbc2816e86fc649d30bd9d6813ef5466b58,1,4,4,8,4,2012-01-28 08:03:26,2012-01-28 08:03:26
08fea7587c536b7daa2c976cdb50144379ae2a62...ce69b70719581f87e2542710fa92fa4163acefc7,2,11,0,11,2,2012-01-28 07:53:56,2012-01-28 07:53:56
984204c39e00d267f49c39d100d0ac2aab8dae9c...a1aa0f8afdc33403604e5415aed649e605e93efd,2,39,1,40,2,2015-03-01 23:55:39,2015-01-17 01:14:22
984204c39e00d267f49c39d100d0ac2aab8dae9c...d5071b19f181c1cb4f71ae77ca5effbccca6c66e,2,75,7,82,7,2015-02-27 02:48:20,2015-02-04 22:25:57
75b311552e5ed1f2761f916aff1a0cbac2f888b9...40961659acf84a8b0952f87e9a46462fac7a7e24,1,2,0,2,1,2015-02-17 06:27:31,2015-02-17 06:27:31
4d15438c4e3bc5cddee0b23426d5f8ec5acc8111...b3b7ece1742147df82af260143c94eec96eddcc7,1,179,147,326,76,2015-01-06 22:13:07,2015-01-06 21:36:39
149dac0a5873ff8547495dd21c5d65f8b24abf75...d4f1331e512bc12f04be126e5e7995f2d7768c9a,11,44,55,99,39,2015-01-15 23:51:02,2015-01-15 23:51:02
0553300a36e5623e36f90132d24a7f0699a783aa...3ed961e4c143d0ee217eb1863e1f1e3848b0f561,1,2,0,2,1,2015-02-25 04:04:59,2015-02-25 04:04:59
79b701722797d9f5b2e90825c0621d44c0ad6030...cea2a701f04a418b6a4627c5215b0c268a213917,17,901,490,1391,153,2012-11-06 02:36:16,2012-11-06 02:36:16
cea2a701f04a418b6a4627c5215b0c268a213917...b82bc97023183b7ed53a5a6d2872f64b2d378183,3,62,23,85,17,2012-11-06 02:38:59,2012-11-06 02:38:59
b82bc97023183b7ed53a5a6d2872f64b2d378183...33beb93e1bb6a9a7e5a7480fa19b32b60a88729d,1,5,1,6,1,2012-11-06 02:40:00,2012-11-06 02:40:00
33beb93e1bb6a9a7e5a7480fa19b32b60a88729d...23a7ab4b51f0f366bad00b5a8db7c9ee76eec16b,2,17,18,35,6,2012-11-06 02:44:10,2012-11-06 02:44:10
79b701722797d9f5b2e90825c0621d44c0ad6030...0a1d296e19b6ce3b979577995f1c806c44adc1e1,1,1,1,2,1,2012-11-05 20:38:59,2012-11-05 20:38:59
9376a7c221a64c2bf508d02ea2ccd85748d10fcc...b5ceca14dbcf398420ceff5f87167c7c08e1986e,2,2,2,4,2,2012-12-09 02:46:34,2012-12-09 02:46:34
b5ceca14dbcf398420ceff5f87167c7c08e1986e...68d1d7fc834cba9340fbecc4525e5af0cab80720,2,0,122,122,2,2012-12-09 05:02:37,2012-12-09 05:02:37
68d1d7fc834cba9340fbecc4525e5af0cab80720...070c125ceceb2a164773f51226950350445160ee,2,122,0,122,2,2012-12-09 05:05:05,2012-12-09 05:05:05
48211ad9f572504cdfa00273a66d701e62ec291d...da0217405f2d40f024bccafd937800b142e6a952,1,3,3,6,3,2012-12-23 11:51:46,2012-12-23 11:51:46
da0217405f2d40f024bccafd937800b142e6a952...5da8b315c0689a0625f5d6b7f9104226994865d1,1,11,11,22,5,2012-12-23 12:00:03,2012-12-23 12:00:03
5da8b315c0689a0625f5d6b7f9104226994865d1...dfbac13ad1cdaac808c1bedc869248d84fa46959,1,11,11,22,5,2012-12-23 12:04:24,2012-12-23 12:04:24
48211ad9f572504cdfa00273a66d701e62ec291d...d594d6377a7e9cda399c25a450b0d27df704d939,1,3,1,4,2,2012-12-23 09:18:16,2012-12-23 09:18:16
d594d6377a7e9cda399c25a450b0d27df704d939...b6960d8cf9b3626b260bb41cb4454abc738ff46a,1,10,0,10,1,2012-12-23 09:21:02,2012-12-23 09:21:02
b6960d8cf9b3626b260bb41cb4454abc738ff46a...68ff08cc914c49461cba41debc71e24564852866,1,9,0,9,1,2012-12-23 09:23:18,2012-12-23 09:23:18
68ff08cc914c49461cba41debc71e24564852866...f152dead9216fc870c58cd4b272edc21c6545edc,1,9,0,9,1,2012-12-23 09:25:27,2012-12-23 09:25:27
f152dead9216fc870c58cd4b272edc21c6545edc...e867ae7b603f3882832143ff315c9ab3fd3b8f13,1,1,1,2,1,2012-12-24 23:07:41,2012-12-24 23:07:41
e867ae7b603f3882832143ff315c9ab3fd3b8f13...9835549faf3c00a9f7ce1aa0303c020cc603a4a6,1,1,1,2,1,2012-12-24 23:59:37,2012-12-24 23:59:37
9835549faf3c00a9f7ce1aa0303c020cc603a4a6...2a5fde272cf9094a9b28afd1de2f5a473febc958,1,3,4,7,2,2012-12-25 00:01:56,2012-12-25 00:01:56
2a5fde272cf9094a9b28afd1de2f5a473febc958...340d90138c86bdd86e74712d53c776c77f17c477,1,3,4,7,2,2012-12-25 00:03:13,2012-12-25 00:03:13
48211ad9f572504cdfa00273a66d701e62ec291d...7a3a88acc60f7055720b919e281d3c881d05916f,2,88,0,88,6,2012-12-23 05:42:13,2012-12-14 07:35:11
7a3a88acc60f7055720b919e281d3c881d05916f...defe85bb51e13ef619c8d0dc1303e3b195c4a772,1,4,4,8,4,2012-12-23 06:17:41,2012-12-23 06:17:41
9749d6afc2730d41cab0111e1cc19bba7c5c3676...330b143b407b01d71b707860f21e0cc2accafd49,8,46,17,63,29,2012-12-26 15:36:07,2012-12-26 15:36:07
ec623c176b6fdb966b55d3863a2b3e2530065bd6...85971ff3e80ce90573ed243055b1b0ba7685e15e,2,2,76,78,4,2012-12-20 05:12:37,2012-12-20 05:12:37
85971ff3e80ce90573ed243055b1b0ba7685e15e...c6cc1b1a1d401e30e2cb7df853461dfc78134f7f,3,4,44,48,25,2012-12-20 05:18:32,2012-12-20 05:18:32
c6cc1b1a1d401e30e2cb7df853461dfc78134f7f...2011a0d50f717c95b706e10ac5e9e0f964c972a9,4,20,154,174,32,2012-12-20 05:29:57,2012-12-20 05:29:57
2011a0d50f717c95b706e10ac5e9e0f964c972a9...b6945a21682042948543fd6809976d06ad234384,6,19,19,38,16,2012-12-20 05:37:16,2012-12-20 05:37:16
b6945a21682042948543fd6809976d06ad234384...65edc9cd6e453a7bf30ccbd6a57b3ea340e21907,17,21,21,42,21,2012-12-20 05:42:36,2012-12-20 05:42:36
65edc9cd6e453a7bf30ccbd6a57b3ea340e21907...7449e2e5a18d3f5d3c0ef76b0960f70b77fb47e8,5,10,11,21,11,2012-12-20 06:02:57,2012-12-20 06:02:57
7449e2e5a18d3f5d3c0ef76b0960f70b77fb47e8...a932476f803fc97f05a60b6bedf4a09c1ed31d4d,2,2,2,4,2,2012-12-20 06:07:11,2012-12-20 06:07:11
a932476f803fc97f05a60b6bedf4a09c1ed31d4d...c38b7206eb049f57c7b1db570817739bdda0be6f,7,163,337,500,52,2012-12-20 06:25:56,2012-12-20 06:25:56
c38b7206eb049f57c7b1db570817739bdda0be6f...afef81c0d79fc0c8bc313f7f46f4f92f7e3a9988,4,16,140,156,14,2012-12-20 06:30:08,2012-12-20 06:30:08
afef81c0d79fc0c8bc313f7f46f4f92f7e3a9988...9b4e5746a4340855e86ed16e15331e10ac23a687,5,200,56,256,46,2012-12-20 06:54:04,2012-12-20 06:54:04
9b4e5746a4340855e86ed16e15331e10ac23a687...a27952efd0f25e99030a9384f66bcd602d6a1b37,3,26,70,96,23,2012-12-20 07:12:38,2012-12-20 07:12:38
b19fd8e4fa09afb7204cf4395ccbf86f5d11cf47...9921d219693a1b01f7c9275babbef3f9d0afd3be,1,2,8,10,3,2012-12-26 19:59:01,2012-12-26 19:59:01
9921d219693a1b01f7c9275babbef3f9d0afd3be...c17673dc6139de37ecb5d075231e426d1b238706,2,53,1,54,3,2012-12-26 19:59:09,2012-12-26 19:59:09
c17673dc6139de37ecb5d075231e426d1b238706...0da31ceb51e7339e1c7119b3877ce6f5a88ab4fc,1,34,35,69,16,2012-12-26 20:06:21,2012-12-26 20:06:21
0da31ceb51e7339e1c7119b3877ce6f5a88ab4fc...070109abc1624808873e6e172ff97d27eb05c406,4,2,188,190,6,2012-12-26 20:09:36,2012-12-26 20:09:36
070109abc1624808873e6e172ff97d27eb05c406...12b738bf302699a51721d030465e07f76de72bf9,2,54,2,56,2,2012-12-26 20:13:44,2012-12-26 20:13:44
12b738bf302699a51721d030465e07f76de72bf9...2ef4fde09fae0dd3e054a77b61b0738fe538b58d,6,1,45,46,7,2012-12-26 20:19:48,2012-12-26 20:19:48
2ef4fde09fae0dd3e054a77b61b0738fe538b58d...d0baa99aed07b6643d649350f3988b3d8a07a4ac,5,0,70,70,10,2012-12-26 20:59:58,2012-12-26 20:59:58
d0baa99aed07b6643d649350f3988b3d8a07a4ac...dc5c6d6be8e46e36aa8a2e1d35f6ed8c8e3cd8cb,5,64,138,202,47,2012-12-26 21:57:52,2012-12-26 21:57:52
dc5c6d6be8e46e36aa8a2e1d35f6ed8c8e3cd8cb...5a2dc0b897968838cf09e0ff990b3a411623ed68,2,22,12,34,10,2012-12-28 20:47:55,2012-12-28 20:47:55
72f13e2870c431f132b9f63cc9d7e87bc6810425...acde2dc1ee01384ca9a79573ad21c37863697946,2,6,6,12,6,2012-12-20 08:20:00,2012-12-20 08:20:00
acde2dc1ee01384ca9a79573ad21c37863697946...cc6974b74e34bd3b0a69fb8b6334fd8a328ca949,2,2,114,116,4,2012-12-20 08:27:05,2012-12-20 08:27:05
cc6974b74e34bd3b0a69fb8b6334fd8a328ca949...4e54e7bb358b3cc4ad5c228c76aa13c7ce94fe75,2,0,168,168,2,2012-12-20 08:27:46,2012-12-20 08:27:46
4e54e7bb358b3cc4ad5c228c76aa13c7ce94fe75...cdb25e11ef6f13f095eacbef731cf43902230203,2,12,12,24,5,2012-12-20 09:21:09,2012-12-20 09:21:09
840e47eabdcf41239d55d6bf046ea8cc9e2065da...28c928f01038a3edf61e7a3c9144a6456b929040,3,667,82,749,32,2012-12-20 02:43:55,2012-12-20 02:43:55
4a7d8de204b0d55a62935e01937fd12a8d32be21...4737d693e00989a0f90f832a7c8f4f784df14077,4,191,277,468,19,2012-01-28 08:36:37,2012-01-28 08:36:37
ce69b70719581f87e2542710fa92fa4163acefc7...d448e6921e6fc39e4fe7f484da004b2196517478,3,82,85,167,11,2012-01-28 08:23:30,2012-01-28 08:23:30
015e63f6df1bd9d93f0c84e14e85f7739b772943...de0722f989bcbb2b2296cfe969bd48b0add3b1f3,2,2,2,4,2,2015-03-02 00:11:14,2015-03-02 00:11:14
1623280f591723e703bce1dd206a3610be35c2cf...fb3610c3af5297045a6724e52ff236dd9bad0a9a,2,5,5,10,4,2015-02-27 04:11:09,2015-02-27 04:11:09
40961659acf84a8b0952f87e9a46462fac7a7e24...1bb3ef3e0b6e1d3cd4b1422d33b642622e882db9,2,2,2,4,2,2015-02-17 07:01:58,2015-02-17 07:01:58
9e01e308ca694a11eacfc8d8f829b7a100fda437...9db1de2a3aa734f41d9f5d0d1c0dfac5b77f4874,17,21,20,41,17,2015-01-06 22:31:18,2015-01-06 10:49:31
ec2ccf4219bafa18d3a83b5daa70680e73423a51...dbffb0b47f573097ec2a0500720accb6aeeab72e,4,26,2,28,6,2015-01-16 00:03:13,2015-01-16 00:03:13
dd1a31a7deff5fe18f727452cec7c24e7f849e29...804457c474c686d4b5f45545da0dbad5ed56e387,1,2,2,4,2,2015-02-25 07:49:08,2015-02-25 07:49:08
02c0b788cd72da8b9393434e67d366e66b89d1c0...cf7d7a7b5dcb0467903107c9b2fa212f737b6259,2,2,2,4,2,2012-11-09 07:46:40,2012-11-07 21:30:06
cf7d7a7b5dcb0467903107c9b2fa212f737b6259...ddf5ceccce58e6ee1104e16c3ad36ba9dbabf24e,2,2,2,4,2,2012-11-09 07:49:04,2012-11-09 07:49:04
ddf5ceccce58e6ee1104e16c3ad36ba9dbabf24e...f2bbee207596960062f2f5f280427abbb94bcc4f,1,0,1,1,1,2012-11-09 07:56:29,2012-11-09 07:56:29
f2bbee207596960062f2f5f280427abbb94bcc4f...54486de88c7774e83b66dd4d42885300c2692f67,1,0,1,1,1,2012-11-09 17:21:14,2012-11-09 17:20:26
a43bf14ea5fa7118cfdbed0469d227976fb92a79...fa1c130552022520161a2b0c595e2ca431df0c97,4,14,14,28,11,2012-11-15 17:17:11,2012-11-15 17:17:11
070c125ceceb2a164773f51226950350445160ee...c10590678019b9b78e0af7893361d005d839c8b5,2,16,16,32,10,2012-12-10 06:42:58,2012-12-10 06:42:41
070c125ceceb2a164773f51226950350445160ee...18adc441716002fcf6d3076c42f66297af08d66a,1,1,1,2,1,2012-12-10 04:10:38,2012-12-10 04:10:38
5a2dc0b897968838cf09e0ff990b3a411623ed68...206205a6b2a214fbdc76cfb5e9c63706bb11e0ea,2,2,2,4,2,2013-01-06 01:36:20,2013-01-06 01:36:20
5a2dc0b897968838cf09e0ff990b3a411623ed68...3d04d9ba751c08ab7909ee6146719171609d5cf9,2,2,2,4,2,2012-12-29 01:24:13,2012-12-29 01:24:13
3d04d9ba751c08ab7909ee6146719171609d5cf9...91dd77939b4183fa86973056778ad87950674410,4,42,0,42,4,2013-01-10 02:56:08,2013-01-10 02:56:08
cdb25e11ef6f13f095eacbef731cf43902230203...00ff34b9e6671d9363ce5cb1d11aaa6bd45e995a,2,2,2,4,2,2012-12-20 21:41:45,2012-12-20 21:41:45
cdb25e11ef6f13f095eacbef731cf43902230203...30f72e69e35d11a07729253c79b5ca34dca5c1d5,1,3,0,3,1,2012-12-20 19:00:47,2012-12-20 19:00:47
be74ad7e0d44c30333b08e8200ce128b1ead5b38...1c33b857a61c2523167a01a16e6b87fa70acdaf1,2,157,346,503,87,2012-12-20 22:08:09,2012-12-20 22:08:09
1c33b857a61c2523167a01a16e6b87fa70acdaf1...69f6149489d13868ccdc3195476096c1f70499bb,1,55,55,110,32,2012-12-20 22:11:40,2012-12-20 22:11:40
69f6149489d13868ccdc3195476096c1f70499bb...7b7581d44abd3cc4cffb42cfe099ca018871a45a,2,148,0,148,5,2012-12-21 04:52:20,2012-12-21 04:52:20
7b7581d44abd3cc4cffb42cfe099ca018871a45a...5508d3d5b3a7e23748bb10b2d5e837befa4040ca,1,0,205,205,1,2012-12-21 04:52:43,2012-12-21 04:52:43
7ffec335ca099adc2b1e60dc5dd2aadce75ef42d...09df780b7512b1e501aeed3ec3463470e33952aa,1,136,155,291,7,2012-01-28 08:46:04,2012-01-28 08:46:04
1453ea4bf74f66db2d88a73949b6e791fe91f108...873be0e4f2a7e961998a8726e9953ae5111b3d85,2,2,2,4,4,2012-01-28 08:25:54,2012-01-28 08:25:54
873be0e4f2a7e961998a8726e9953ae5111b3d85...963e5e0eda465f3718381fb8c02f69269b51afeb,1,1,1,2,1,2012-01-28 08:27:49,2012-01-28 08:27:49
963e5e0eda465f3718381fb8c02f69269b51afeb...342a99f1d01edfa20d744781cbecffcd4239fa39,2,10,0,10,2,2012-01-28 08:29:38,2012-01-28 08:29:38
342a99f1d01edfa20d744781cbecffcd4239fa39...cc01d3c367a26bfed36c9eabbf074dccc8570dfa,1,4,5,9,2,2012-01-28 08:31:55,2012-01-28 08:31:55
cc01d3c367a26bfed36c9eabbf074dccc8570dfa...18d95a163b23296b7c2242a98aa1f66b3bd22a7a,2,2,2,4,2,2012-01-28 08:34:54,2012-01-28 08:34:54
c80872235faaeaf1e8029665fb7674c2e1ba1d8c...ea3c7028bd7ce451a9878ba5dd575b90e949de42,5,10,10,20,8,2015-03-02 09:16:06,2015-03-01 19:15:22
ea3c7028bd7ce451a9878ba5dd575b90e949de42...f8e34ff48bf5107268d86bf050e1a1ed8299b399,2,2,0,2,2,2015-03-02 09:16:06,2015-03-01 20:35:43
c80872235faaeaf1e8029665fb7674c2e1ba1d8c...c291c12cb1331e27c26a567eee8189d1837f969c,1,28,0,28,1,2015-03-02 03:50:11,2015-03-02 03:48:06
049e86f47e90b35eeaf97d6b735f2fd3d62c0d1c...ad379ffb4a0fde7416ae076e68141300fc583018,1,1,1,2,1,2015-02-27 07:51:17,2015-02-27 07:51:17
0d7b85ece7d9aa52890517404f55556525dea61d...02195d366bca034c0b4c4235efe3d93be12e185b,1,1,1,2,1,2015-02-17 15:48:12,2015-02-17 15:48:12
e16e11fc433153c36d5ee5a96631fa5aa7714c25...b24e6cf2edb064046e648e0eb5ac109bf577a07e,1,1,1,2,1,2015-01-08 01:43:19,2014-12-29 20:09:39
b24e6cf2edb064046e648e0eb5ac109bf577a07e...050babda0d18bfbf6f25fa31ffd2447dcce59844,1,73,125,198,14,2015-01-08 01:44:16,2014-12-29 20:11:22
dbffb0b47f573097ec2a0500720accb6aeeab72e...63f31364508c1f18922867d5d66c4b84cdfb4db3,2,7,6,13,7,2015-01-16 01:18:00,2015-01-16 01:15:41
804457c474c686d4b5f45545da0dbad5ed56e387...94406bcae033e9c7c4f19d9664ed8d9a66165539,1,3,3,6,1,2015-02-28 22:07:20,2015-02-26 01:01:48
804457c474c686d4b5f45545da0dbad5ed56e387...238be65786ab78274dcc59c9de9fab27eec48304,4,12,12,24,4,2015-02-25 17:19:11,2015-02-25 17:19:11
54486de88c7774e83b66dd4d42885300c2692f67...6ec7c72e5b5152afb676c43ea57a51fb625f9ba2,2,19,2,21,5,2012-11-13 16:00:34,2012-11-09 16:48:21
54486de88c7774e83b66dd4d42885300c2692f67...41889f74d0dc97cfb8bbd80754fc0ec01ef39d58,1,16,7,23,8,2012-11-13 10:49:33,2012-11-13 10:49:33
54486de88c7774e83b66dd4d42885300c2692f67...c8856eeff3a8fdcb6d458860e4fbbc82b4620f05,2,8,0,8,2,2012-11-11 01:58:00,2012-11-11 01:58:00
9f29785783e58a7ffc6f8779c2ae55edebd54ba2...558bc52432840ea1b2f413438427164288f10350,1,0,0,0,0,2012-12-22 02:54:36,2012-12-22 02:54:36
9f29785783e58a7ffc6f8779c2ae55edebd54ba2...ab5d7f863c2b2e7c6fc9ae48ddaea405aa153629,2,35,35,70,4,2012-12-10 17:57:23,2012-12-10 17:57:23
ab5d7f863c2b2e7c6fc9ae48ddaea405aa153629...165729254be53a90d2c56389a7f736a46bd6de84,1,0,1,1,1,2012-12-10 18:13:04,2012-12-10 18:13:04
165729254be53a90d2c56389a7f736a46bd6de84...83a6a55d2c3448771925f467be1f2ced321e63df,4,11,13,24,4,2012-12-10 18:25:18,2012-12-10 18:25:18
83a6a55d2c3448771925f467be1f2ced321e63df...e324a1beb0d07a3b117e92c608daec591f8587de,1,1,1,2,1,2012-12-10 18:28:18,2012-12-10 18:28:18
e324a1beb0d07a3b117e92c608daec591f8587de...847b632577ee46f2acf0b0778c5a3014428cb528,4,11,11,22,4,2012-12-10 18:29:16,2012-12-10 18:29:16
847b632577ee46f2acf0b0778c5a3014428cb528...9d985978a3a5b341911d23c3b7fcf83178ef8e34,2,2,2,4,2,2012-12-10 18:55:42,2012-12-10 18:55:42
9d985978a3a5b341911d23c3b7fcf83178ef8e34...cddca18f122887b183aa3a8e601c5cd1aa80c206,2,9,4,13,4,2012-12-10 18:59:57,2012-12-10 18:59:57
cddca18f122887b183aa3a8e601c5cd1aa80c206...529ecc5a77c9e653dd7219bd4457cb994e338075,38,51,51,102,51,2012-12-11 02:31:04,2012-12-11 02:31:04
f69d12af3d47b26c0948f207b1fbb876edf0f1b3...1c0e4fc7bb6ab2ef12f1050ed177a02d16ebdbce,2,10,2,12,4,2012-12-28 20:18:59,2012-12-28 20:18:59
3773b999695c74c21959c046b511ba26efa65dbc...7a3f078fb487323246ccf64460b7efaf7d478afc,4,174,322,496,56,2013-01-12 21:15:19,2013-01-12 21:15:19
7a3f078fb487323246ccf64460b7efaf7d478afc...b1f0a7e62b32e97930d579ef24e414ace39bad29,2,0,475,475,2,2013-01-12 21:46:07,2013-01-12 21:46:07
b1f0a7e62b32e97930d579ef24e414ace39bad29...24f7df15e6a5b4b08201b3a6650340998f3ed381,3,1,7,8,3,2013-01-12 21:57:41,2013-01-12 21:57:41
91dd77939b4183fa86973056778ad87950674410...b9b5cd786d2e774f478704c9aa942f35ac5d2a0c,2,0,6,6,2,2013-01-12 04:23:37,2013-01-12 04:23:37
b9b5cd786d2e774f478704c9aa942f35ac5d2a0c...7626cc629ff165f84601ad7c35b64e0b30f491f1,2,0,7,7,2,2013-01-12 04:26:48,2013-01-12 04:26:48
91dd77939b4183fa86973056778ad87950674410...c91bf424b0c69da931b674a021f48fe471b1d053,2,10,5,15,2,2013-01-11 17:32:00,2013-01-11 17:32:00
a5e04c0799b64421f413321c29455e93187ad35a...6bd5dc7d9fefd6d936def8a224bf38c6beeac234,5,14,12,26,14,2012-12-20 21:53:38,2012-12-20 21:53:38
5d4e7184466a46d7844c8156edda5a7ccef54aad...7c04d573d0a08a365f3350c9d52d7cc870f702be,4,8,10,18,10,2012-12-21 05:44:45,2012-12-21 05:44:45
81c128fd0b15157cc270c4bde33c399d65fe859d...e61164e67a048c20c512e99335e3adfcc3b63604,10,39,19,58,18,2012-01-28 09:35:13,2012-01-28 09:35:13
81c128fd0b15157cc270c4bde33c399d65fe859d...d65ce1b64c0049e4fe37a79a4962d8444415ee00,2,371,172,543,2,2012-01-28 09:34:07,2012-01-28 09:34:07
edee985b96dea8f8fdca88a0aa171adede7b2d8b...f1851ab1338938bf6315e223789e345f20cfb4b1,5,13,5,18,7,2012-01-28 08:43:25,2012-01-28 08:43:25
18d95a163b23296b7c2242a98aa1f66b3bd22a7a...967030cb532c642f076d1e1fc4e5a1e2cee18561,5,19,8,27,7,2012-01-28 08:39:22,2012-01-28 08:39:22
ad379ffb4a0fde7416ae076e68141300fc583018...9c3e7e5861e6ba200a75bf4a63d0e5be0ef9f608,1,11,0,11,1,2015-02-28 15:41:55,2015-02-28 15:41:55
259245113a65fbc46aaf9a4ef0c3bf29df058734...e213bc0cccf236243210830626c415be48aed6f1,2,2,2,4,2,2015-01-08 02:01:51,2015-01-08 02:01:51
cd31bef5ce5b6ea3d7c5622b7b9c8fb0918c6a61...ca2c1e1576c48f21d6f2cd8fb4e22dffb31d8bce,1,1,1,2,1,2015-01-16 01:52:02,2015-01-16 01:52:02
cd31bef5ce5b6ea3d7c5622b7b9c8fb0918c6a61...2fa70f37da8b250db1fc0a6d8dc4d5aba61bf0df,1,36,8,44,5,2015-01-16 01:47:22,2015-01-16 01:44:38
3173efd9d96ae54992057df9259725d5732f5629...ba2f7e92d09071b48558e261570550dc5fcf0a3f,2,62,1,63,2,2015-03-07 07:27:00,2015-03-01 03:54:58
3173efd9d96ae54992057df9259725d5732f5629...4345e244796d90459d07173d7a58bbbf6779bd07,2,1,5,6,2,2015-03-01 08:20:00,2015-03-01 08:20:00
cd1f72f4847c24d46fa3c5022dd89568ed803601...0df0b5f1f518eb119e4747084f0ad3caaaf82668,1,12,0,12,1,2012-11-14 23:19:16,2012-11-14 23:19:16
0df0b5f1f518eb119e4747084f0ad3caaaf82668...1700e48e7f5393aec9c51c70ed4f0ca922e568ae,2,2,2,4,2,2012-11-14 23:20:38,2012-11-14 23:20:38
1700e48e7f5393aec9c51c70ed4f0ca922e568ae...05655ff4ff3b44f5c773dcc6079d03af498733d5,1,1,1,2,1,2012-11-15 17:14:54,2012-11-15 17:14:54
558bc52432840ea1b2f413438427164288f10350...c4eea3abde487567961fccab0d0cafd8bd4a7718,2,3,3,6,3,2013-01-29 21:54:00,2013-01-29 21:54:00
558bc52432840ea1b2f413438427164288f10350...6afb1055e35a65ef8180745b945b715eb8d25514,1,1,1,2,1,2013-01-26 00:01:10,2013-01-26 00:01:10
558bc52432840ea1b2f413438427164288f10350...2428904b4b2c293525b3a13bbe88ac60d9c7d5c2,1,11,0,11,1,2013-01-24 05:37:52,2013-01-24 05:37:52
2428904b4b2c293525b3a13bbe88ac60d9c7d5c2...d2ea2cdeddbfda468f9d972e7d76c29525bd7cd5,2,15,1,16,2,2013-02-02 05:41:02,2013-02-02 05:41:02
558bc52432840ea1b2f413438427164288f10350...22f1cc44caa1eb8557fad4bbb1d652d486b56a52,1,3,2,5,3,2013-01-22 14:46:53,2013-01-22 14:46:53
558bc52432840ea1b2f413438427164288f10350...650c77ddb9df25f2ef4bad7feaba2be9ce15c827,1,59,0,59,5,2013-01-17 10:34:00,2013-01-17 10:34:00
558bc52432840ea1b2f413438427164288f10350...5eff3cdd5d77f765bd9713fc6ebaa73b9cc93a6f,1,1,1,2,1,2013-01-10 10:10:52,2013-01-10 10:10:52
5eff3cdd5d77f765bd9713fc6ebaa73b9cc93a6f...1eb6a1d8c8e75d2f8019fbc554026def10066890,1,1,1,2,1,2013-01-10 10:13:26,2013-01-10 10:13:26
1eb6a1d8c8e75d2f8019fbc554026def10066890...edfc0bf8b3961ab2af81468f48e4ee99ea532200,1,1,1,2,1,2013-01-10 10:13:43,2013-01-10 10:13:43
edfc0bf8b3961ab2af81468f48e4ee99ea532200...9fdc9887cfcb71f05f6197a75511e1594de4c471,1,1,1,2,1,2013-01-10 10:13:57,2013-01-10 10:13:57
9fdc9887cfcb71f05f6197a75511e1594de4c471...cf852c1f62e3b62dbc51d78d558dd6f5a373a840,1,1,1,2,1,2013-01-10 10:14:14,2013-01-10 10:14:14
558bc52432840ea1b2f413438427164288f10350...2c2a847e752b638023f1f61e3cecf1e7ad46b453,1,1,0,1,1,2013-01-09 10:23:17,2013-01-09 10:23:17
558bc52432840ea1b2f413438427164288f10350...aeb0e85151a99a4a3689b067e437b68598378368,1,2,2,4,1,2013-01-09 09:15:15,2013-01-09 09:15:15
558bc52432840ea1b2f413438427164288f10350...3096a377a28627fae8b8fbdd543b7ab140b86929,1,6,0,6,1,2012-12-28 08:19:12,2012-12-28 08:19:12
558bc52432840ea1b2f413438427164288f10350...aa997e274e0759e8b3af0e846f38fcbd6ead8a05,2,2,2,4,2,2012-12-27 09:49:09,2012-12-27 09:49:09
529ecc5a77c9e653dd7219bd4457cb994e338075...5bd8cdca91615dfb502131c276bfc6d8457c5f79,6,36,42,78,22,2012-12-20 05:36:50,2012-12-20 05:36:50
5bd8cdca91615dfb502131c276bfc6d8457c5f79...dc4e80a655509dc1f68d45c950174e79da2f7f08,4,43,7,50,19,2012-12-20 05:55:23,2012-12-20 05:55:23
dc4e80a655509dc1f68d45c950174e79da2f7f08...219d275ae67e58f3a4c1d0a2b2daeff427adbaf6,4,6,4,10,4,2012-12-20 06:03:57,2012-12-20 06:03:57
219d275ae67e58f3a4c1d0a2b2daeff427adbaf6...7c456c85545b433759913051779bf4af9b000d48,1,1,1,2,1,2012-12-20 06:05:33,2012-12-20 06:05:33
7c456c85545b433759913051779bf4af9b000d48...96e5fa6143072db64f34482873c6f7d6b3ec4ffd,5,10,9,19,6,2012-12-20 06:26:36,2012-12-20 06:26:36
96e5fa6143072db64f34482873c6f7d6b3ec4ffd...e9eff0cbffdd4381ee990e6fc78bee6caec92a00,1,8,6,14,1,2012-12-20 06:37:41,2012-12-20 06:37:41
e9eff0cbffdd4381ee990e6fc78bee6caec92a00...7f9ff0ba5b679914defd8bdd45bcf930ee201286,8,73,25,98,29,2012-12-20 07:25:25,2012-12-20 07:25:25
7f9ff0ba5b679914defd8bdd45bcf930ee201286...bbe4625672c5122bb2b06c495f9ea41752c10467,5,3,21,24,7,2012-12-20 07:39:26,2012-12-20 07:39:26
529ecc5a77c9e653dd7219bd4457cb994e338075...dc6142751feced6761f67503323c0c6e62844d4e,2,4,4,8,4,2012-12-20 02:47:34,2012-12-20 02:46:55
30d8eb3ed572f2a91c0d4de1326779dec88cd911...b6575cc72e144378dd2c1d4e6f23ac80a167c195,6,9,9,18,9,2012-12-20 21:41:08,2012-12-20 21:41:08
b6575cc72e144378dd2c1d4e6f23ac80a167c195...5e4f663e699d6c03cf6c778d39ecac6cb949e285,2,4,4,8,4,2012-12-20 21:46:07,2012-12-20 21:46:07
1c0e4fc7bb6ab2ef12f1050ed177a02d16ebdbce...ccf4c2fbe3e4299c64e6a0d7446ba96100375502,2,167,0,167,2,2013-01-10 03:53:42,2013-01-10 03:53:42
1c0e4fc7bb6ab2ef12f1050ed177a02d16ebdbce...b5ad50686c892c5fb8d0e58571b9dc0b77b4f0d2,1,6,6,12,2,2013-01-08 01:13:28,2013-01-08 01:13:28
1c0e4fc7bb6ab2ef12f1050ed177a02d16ebdbce...bf3dea668f9052b8db3ecc766651c5844196c68d,1,0,1,1,1,2013-01-06 15:43:41,2013-01-06 15:43:41
1c0e4fc7bb6ab2ef12f1050ed177a02d16ebdbce...684c9d8d05d8bdbb886a23780244d34dbea14338,2,2,2,4,2,2013-01-06 01:14:22,2013-01-06 01:14:22
1c0e4fc7bb6ab2ef12f1050ed177a02d16ebdbce...848ca6e31562fc65da891cce9046853bd16564eb,19,870,1747,2617,1579,2013-01-02 22:39:21,2013-01-02 22:39:21
848ca6e31562fc65da891cce9046853bd16564eb...77c68e4bc2862321fbe9c1cfac4d9ab34d2a8073,2,1636,642,2278,1490,2013-01-12 11:02:13,2013-01-12 11:02:13
77c68e4bc2862321fbe9c1cfac4d9ab34d2a8073...a809daf2841f65ffac5030b2c6ce6aea60dd6233,2,64,64,128,28,2013-01-12 17:04:51,2013-01-12 17:04:51
a809daf2841f65ffac5030b2c6ce6aea60dd6233...4503ad7808f6602679ec4b89f00bda30c46505c1,2,64,64,128,28,2013-01-15 07:13:19,2013-01-15 07:13:19
4503ad7808f6602679ec4b89f00bda30c46505c1...370fa45fbe4ee879a626a67bb4df0ec9495102be,2,64,64,128,28,2013-01-15 07:16:33,2013-01-15 07:16:33
370fa45fbe4ee879a626a67bb4df0ec9495102be...c55329085ebc6d05d91412251331c0613ea2250b,2,64,64,128,28,2013-01-15 07:22:02,2013-01-15 07:22:02
a33d45f3082ac6db154aa6796eeb47a0f69f2249...ff02043bbc5a6dca3eec734a274e91cffc611dd4,4,20,55,75,23,2013-01-12 22:31:18,2013-01-12 22:31:18
ff02043bbc5a6dca3eec734a274e91cffc611dd4...a9a66e9c341cf21bc53f2ce174254d4c615b400a,4,151,78,229,44,2013-01-13 01:51:57,2013-01-13 01:51:57
a9a66e9c341cf21bc53f2ce174254d4c615b400a...fb4fc323a2ef97ec9b383a1084c148cd3c67f091,1,0,11,11,1,2013-01-13 01:54:30,2013-01-13 01:54:30
fb4fc323a2ef97ec9b383a1084c148cd3c67f091...583fc4b962f5d36a7a3bbe8707535558fd2dd229,5,12,130,142,13,2013-01-13 02:52:06,2013-01-13 02:52:06
583fc4b962f5d36a7a3bbe8707535558fd2dd229...7bcd02c16764cdcc82530f8a82961555f8cab6af,1,8,16,24,3,2013-01-13 03:02:48,2013-01-13 03:02:48
7bcd02c16764cdcc82530f8a82961555f8cab6af...1ea647ce987cddc07382eff6a719bea440c5b456,2,0,3,3,2,2013-01-13 03:02:58,2013-01-13 03:02:58
1ea647ce987cddc07382eff6a719bea440c5b456...867002193515ac7251e6fb874be4068e082db36c,2,0,13,13,5,2013-01-13 03:44:51,2013-01-13 03:44:51
867002193515ac7251e6fb874be4068e082db36c...ea1a12593db0fb037804ccb833f3c46c1ae6034d,2,0,3,3,2,2013-01-13 03:46:47,2013-01-13 03:46:47
ea1a12593db0fb037804ccb833f3c46c1ae6034d...01db5db2f6e0dfcd63e181303723e1aceeb01045,2,2,0,2,2,2013-01-13 04:08:13,2013-01-13 04:08:13
01db5db2f6e0dfcd63e181303723e1aceeb01045...0b31cfc90e1f3ca0f10dd188bf268cca470882f6,1,0,5,5,2,2013-01-13 04:10:42,2013-01-13 04:10:42
0b31cfc90e1f3ca0f10dd188bf268cca470882f6...1916eb7c7f7ed837cd2bd4bd2bda9d41ed91c1cc,4,18,9,27,10,2013-01-13 12:04:16,2013-01-13 12:04:16
1916eb7c7f7ed837cd2bd4bd2bda9d41ed91c1cc...76ed6b0b2ced6a29c5cb7b6ea62d0c738dbbd90a,2,7,49,56,3,2013-01-13 12:05:34,2013-01-13 12:05:34
6bd5dc7d9fefd6d936def8a224bf38c6beeac234...8eb1549842ef25e07cc062ba1d1c50c6b01381d7,2,0,8,8,2,2012-12-20 21:57:14,2012-12-20 21:57:14
7c04d573d0a08a365f3350c9d52d7cc870f702be...d206ec16595a022f10955eb025fd5756512399a8,4,2,68,70,6,2012-12-24 10:06:28,2012-12-24 10:06:28
d206ec16595a022f10955eb025fd5756512399a8...c063f7c9c26abad3d9ac605d70b60d86e4d79343,2,2,2,4,2,2012-12-24 10:08:45,2012-12-24 10:08:45
7c04d573d0a08a365f3350c9d52d7cc870f702be...c11f41ba04791a0c408071527994dfb22c91a436,7,74,238,312,50,2012-12-21 08:50:28,2012-12-21 08:50:28
68fa1e48267f7c8b2921001480a7a25835482dda...ab8f4a394c3ffef58e11c872f27927a9ffe4db11,1,0,6,6,1,2012-01-28 09:48:45,2012-01-28 09:48:45
d65ce1b64c0049e4fe37a79a4962d8444415ee00...28ba9d69c82895bbd9a1d66cea855119f4aba349,6,36,17,53,17,2012-01-28 19:21:39,2012-01-28 19:21:39
8e6934c1354645beb9743cbc87afea9fb43158a8...4311e09b04763bd4efd20212dbee8c6c95df56dc,3,5,2,7,3,2015-03-02 12:41:16,2015-03-02 12:41:16
e213bc0cccf236243210830626c415be48aed6f1...901ece7996e4573daef66f265ea7c60bbcedd77e,1,1,0,1,1,2015-01-08 21:35:05,2014-08-01 20:51:28
ca2c1e1576c48f21d6f2cd8fb4e22dffb31d8bce...f5a5621af2194b6757ed3028a79598575cc9e1e2,2,135,211,346,51,2015-01-16 15:49:58,2015-01-16 08:10:02
f5a5621af2194b6757ed3028a79598575cc9e1e2...0e79fe1a9f88a6e0ade7b6c38d8733d77ac3ceaf,1,1,0,1,1,2015-01-16 15:49:58,2015-01-16 15:43:39
0e79fe1a9f88a6e0ade7b6c38d8733d77ac3ceaf...0481ce973f2c10753e23d2de21aafb78c582a0e5,1,3,3,6,2,2015-01-16 15:50:05,2015-01-16 15:45:58
ca2c1e1576c48f21d6f2cd8fb4e22dffb31d8bce...21f7254e102bdffe84131db03a1a037ccd4c5013,1,1,1,2,1,2015-01-16 10:36:46,2015-01-16 10:36:46
ca2c1e1576c48f21d6f2cd8fb4e22dffb31d8bce...1c131fb95d312c0f555ffd3c71443bf4eaf96132,1,5,0,5,5,2015-01-16 09:06:35,2015-01-16 09:06:35
64ca888cbc4161bbf74243ed1b498a7b41b98048...e7efd810339eb538c4103a6d116956f1917c43d8,1,0,4,4,1,2015-03-07 08:11:28,2015-03-07 08:11:28
1ba2630ccf460106036129086c98c5bacd7baa98...673cd677981245551bbafe93c5ba3bf2f13b8165,2,2,2,4,2,2015-03-01 21:44:13,2015-03-01 21:44:13
1ba2630ccf460106036129086c98c5bacd7baa98...7b3e4d8423fcf7fa9a488efd9d5bcbd273445a55,2,2,2,4,2,2015-03-01 21:24:12,2015-03-01 21:24:12
1ba2630ccf460106036129086c98c5bacd7baa98...fd35779f0e15df27a8a05459a000d84320d8bb00,1,5,3,8,3,2015-03-01 09:01:14,2015-03-01 09:01:14
1ba2630ccf460106036129086c98c5bacd7baa98...20fb55a840f1b8ae7c3ccaa86acb10a2554b903c,1,11,6,17,2,2015-03-01 08:49:59,2015-03-01 08:46:49
05655ff4ff3b44f5c773dcc6079d03af498733d5...5702e1be6e9b0b813520c4a0ff2faf427429b720,2,2,2,4,2,2012-11-16 09:13:52,2012-11-16 09:13:52
5702e1be6e9b0b813520c4a0ff2faf427429b720...88c2497368f601e87ba2c1ec3b2e215c1f038975,2,5,5,10,5,2012-11-16 09:16:27,2012-11-16 09:16:27
88c2497368f601e87ba2c1ec3b2e215c1f038975...a367fd4938a50c99cb8e45e048a20d0a6459a786,2,2,2,4,2,2012-11-16 09:19:15,2012-11-16 09:19:15
a367fd4938a50c99cb8e45e048a20d0a6459a786...a10d68f291d1f0a0f47f3123d213fb686229692d,1,12,12,24,8,2012-11-18 20:30:35,2012-11-18 20:30:35
135e834bf499e9e4639e41c6a1642040503089d9...baadc33c88f701a068d468e15500ed87b84df43b,1,1,0,1,1,2013-01-31 02:22:20,2013-01-31 02:22:20
3b6b8e9f410474fc2f258b4d4637893dbfbb326e...a5fc3e06676769a0586d0cfed93632691c6e79a6,1,3,2,5,3,2013-01-31 01:45:02,2013-01-31 01:45:02
a5fc3e06676769a0586d0cfed93632691c6e79a6...dd4ce35ddc262f0b70a4851009317f153fbf6057,2,2,0,2,2,2013-01-31 01:46:18,2013-01-31 01:46:18
dd4ce35ddc262f0b70a4851009317f153fbf6057...3cc65cb86c10a6534935f3945090a33b4e87105e,2,3,3,6,2,2013-01-31 02:16:14,2013-01-31 02:16:14
bbb3c0a0e6b4134264f341c2714c4cadccb23e5c...01b465928ec47d460ea1fd705e49aa2e0e9a4d28,1,30,38,68,8,2013-01-17 20:24:16,2013-01-17 20:24:16
839f83c610e072d23967656e919996b88475fe80...649d8c985e94f9cf0b8aae82e03995a3347946d6,1,0,5,5,1,2013-01-11 19:00:45,2013-01-11 19:00:45
649d8c985e94f9cf0b8aae82e03995a3347946d6...53f9e25150c0dcd8f2285691b0e74a7bde553fbe,1,1,1,2,1,2013-01-12 04:30:56,2013-01-12 04:30:56
53f9e25150c0dcd8f2285691b0e74a7bde553fbe...d7c93fc647f38fb4baab9a2f95225600050dc1fe,2,20,20,40,18,2013-01-12 04:38:14,2013-01-12 04:38:14
d7c93fc647f38fb4baab9a2f95225600050dc1fe...d3b3b4c48f86be988148948eb97f0b2ef6ca41c1,3,3,13,16,5,2013-01-12 04:40:17,2013-01-12 04:40:17
d3b3b4c48f86be988148948eb97f0b2ef6ca41c1...56a24027c374fd9c75c150d99332fe12b0299b35,2,2,0,2,2,2013-01-12 04:42:44,2013-01-12 04:42:44
56a24027c374fd9c75c150d99332fe12b0299b35...767a293b4d7a1221a6c859fa24a38b724d564ba6,2,4,2,6,3,2013-01-12 04:46:21,2013-01-12 04:46:21
767a293b4d7a1221a6c859fa24a38b724d564ba6...b242ff7851e12dbca9b7e22ae1c9a74686ec606d,2,20,0,20,4,2013-01-12 04:51:11,2013-01-12 04:51:11
b242ff7851e12dbca9b7e22ae1c9a74686ec606d...88e816956a731c9e3284c55a7be0c81b447c2601,2,6,6,12,2,2013-01-12 04:52:39,2013-01-12 04:52:39
88e816956a731c9e3284c55a7be0c81b447c2601...4de3a77a64b8f8f130d6d5134fb916c91d271e82,2,5,3,8,3,2013-01-12 04:55:09,2013-01-12 04:55:09
4de3a77a64b8f8f130d6d5134fb916c91d271e82...42efd9f7308568bd4773dbc854f8608a677833ae,2,2,2,4,4,2013-01-12 04:58:24,2013-01-12 04:58:24
42efd9f7308568bd4773dbc854f8608a677833ae...6f894c62a57fd93e9ba41230d794cd8ad48c03d1,3,4,5,9,3,2013-01-12 07:35:22,2013-01-12 07:35:22
6f894c62a57fd93e9ba41230d794cd8ad48c03d1...19e2ad0eb64c0e6bd40557c2ce3585702b54f6f9,2,24,10,34,12,2013-01-12 07:38:53,2013-01-12 07:38:53
19e2ad0eb64c0e6bd40557c2ce3585702b54f6f9...aaf80d410a24b280c141bdc267056b1dde089089,1,9,0,9,1,2013-01-12 08:20:13,2013-01-12 08:20:13
1d87bcc9f50d030a74de4d6d9bc1b6e5cfe91547...6e5a2fedaaa75ea5052e495b04d424eaad4c3622,4,7,7,14,7,2013-01-11 02:51:04,2013-01-11 02:50:52
bbe4625672c5122bb2b06c495f9ea41752c10467...2c9f43f6858597b3bbc6d4036a3bd1dd18d6181f,1,1,1,2,1,2012-12-20 09:05:07,2012-12-20 09:05:07
5d776bcfd2e7da0bcce37252dc983149d8b2d377...9726fded1c587c14b57a61a92b88ac74fe21d320,3,52,2,54,4,2012-12-20 07:52:38,2012-12-20 07:52:38
5e4f663e699d6c03cf6c778d39ecac6cb949e285...43d130762be1b3124baafc5953e552934cb1dfd7,1,2,0,2,1,2012-12-20 22:40:39,2012-12-20 22:40:39
43d130762be1b3124baafc5953e552934cb1dfd7...a24e47b5b81a216bcb1bb786b359c7000759c5dc,14,27,6,33,9,2012-12-20 23:08:05,2012-12-20 23:08:05
a24e47b5b81a216bcb1bb786b359c7000759c5dc...c1e82732cf4c87e0e73458feaf3b7c76e1ea489e,3,2,6,8,8,2012-12-21 04:27:07,2012-12-21 04:27:07
566380b257e5322a014fe52f935381ff86637f43...a866a51a2ecac07748501f0375a324ebb57002f2,6,19,15,34,10,2013-02-06 04:34:39,2013-02-06 04:34:39
a866a51a2ecac07748501f0375a324ebb57002f2...a4b31d39a26bf493d60d4aaadddd19996966e43c,4,4,4,8,4,2013-02-06 05:08:56,2013-02-06 05:08:56
8a167465425f926913e532a780c12578339e8872...a7231854c91399aafb371ccdf2b930037a7ac5ed,2,38,0,38,2,2013-01-12 08:33:12,2013-01-12 08:33:12
a7231854c91399aafb371ccdf2b930037a7ac5ed...6f275c61486b6ed923d433dd1b24b762ea5d111f,2,2,18,20,4,2013-01-12 20:41:01,2013-01-12 20:41:01
6f275c61486b6ed923d433dd1b24b762ea5d111f...4b34f4947aedc0e8539eee779e3921f44e0bca8b,1,113,54,167,30,2013-01-13 03:49:15,2013-01-13 03:49:15
15c7e73abd8d97f0139d177d05c94e26faa17dd2...9443eb6e21dc784a98d01aa2206bf0807e549873,1,1,1,2,1,2013-02-06 03:40:32,2013-02-06 03:40:32
9443eb6e21dc784a98d01aa2206bf0807e549873...c97d304c0ca0c3b11f2c550590b54a75b41471fb,2,6155,4,6159,2,2013-02-06 03:43:49,2013-02-06 03:43:49
7d8d5c783815d83bddc6969052f1600c45246d57...d247f71217917f6e53354e410b8020289b841a47,1,0,10,10,1,2013-01-13 12:27:51,2013-01-13 12:27:51
ab8f4a394c3ffef58e11c872f27927a9ffe4db11...d4659521386eab794eaf67f57e8762656aa28de7,2,5,3,8,3,2012-01-28 19:03:39,2012-01-28 19:03:39
ab8f4a394c3ffef58e11c872f27927a9ffe4db11...8ade6989c3fb227fbd0a5acf08c1259e20af7dc2,1,0,1,1,1,2012-01-28 10:25:13,2012-01-28 10:25:13
245276825924acd0cfe5f4fd57b0f8b9970b64c3...f1dc214977ed2613565a0c4a9846864c84fb2602,2,3,3,6,3,2012-01-28 19:24:34,2012-01-28 19:24:34
f1dc214977ed2613565a0c4a9846864c84fb2602...39f70afed9998826f4a4ff548b721a5b065c985e,1,5,5,10,1,2012-01-28 20:03:26,2012-01-28 20:03:26
4311e09b04763bd4efd20212dbee8c6c95df56dc...4febcb4b492c322c71bdef579cc4ad99ea86e150,12,198,4,202,199,2015-03-03 13:45:07,2015-03-01 14:33:48
4311e09b04763bd4efd20212dbee8c6c95df56dc...9bbc0d76f5009645f8a8cc2f78c7e0e88ab0b1f9,1,1,0,1,1,2015-03-02 14:36:36,2015-03-02 14:36:36
c56219d223af5145c171defb9fa1426e1dd022f3...aa62f1b9447383cdf591ce785124da40bee6b953,1,0,10,10,1,2015-01-09 23:04:59,2015-01-09 23:01:53
f6a96e78244304bc3ec564078100e15f2be79a8b...b7c332f183d52c6b1432a4eb511b8c61478bfc81,1,3,3,6,2,2015-01-16 16:41:05,2015-01-16 16:41:05
b7c332f183d52c6b1432a4eb511b8c61478bfc81...85a6595a716fa6549383356e75c2091bfdfee585,1,1,1,2,1,2015-01-16 19:02:51,2015-01-16 19:02:51
85a6595a716fa6549383356e75c2091bfdfee585...2a1adb5f94917ffdbfcde5933f35bc4f17869108,1,1,1,2,1,2015-01-16 19:11:06,2015-01-16 19:11:06
02921b4d75aaefca9da1d0e55a581b50019774d5...e0da1371580fd8412e8d91f31c7e1be7e5baa6a6,1,1,1,2,1,2015-01-16 10:51:20,2015-01-16 10:51:20
e7efd810339eb538c4103a6d116956f1917c43d8...f41acae9fca55702a464bf126b7c1ab75703ae29,1,2,0,2,1,2015-03-09 04:31:58,2015-03-09 04:31:58
e7efd810339eb538c4103a6d116956f1917c43d8...6ddb8c2dd7535fc1a6e7eec97e9ae2236c680a3c,1,23,0,23,1,2015-03-07 14:39:46,2015-03-07 14:29:46
6ddb8c2dd7535fc1a6e7eec97e9ae2236c680a3c...a134491fe5d30af67ccabb432a7d303ee5f0c71d,1,18,0,18,3,2015-03-07 14:40:57,2015-03-07 14:40:57
a10d68f291d1f0a0f47f3123d213fb686229692d...ace6dc0c25270a7ffa974f45c2d41d9895f7eb94,1,1,1,2,1,2012-11-19 21:49:47,2012-11-19 21:49:47
8c7f9c66a7d12f47f50618ef420868fe836d0c33...e6a6fd2585d6d6bd80b0bbb500521514c48df1b3,1,11,10,21,7,2013-02-17 23:36:24,2013-02-17 23:36:24
8c7f9c66a7d12f47f50618ef420868fe836d0c33...ba8ba1fe7298a91ee44db6afceb77d82fc711d93,1,4,2,6,1,2013-02-17 03:37:08,2013-02-17 03:37:08
baadc33c88f701a068d468e15500ed87b84df43b...7d655c35494012f15bc1f9ae515e92ca4c432a66,5,10,10,20,10,2013-02-01 18:33:36,2013-02-01 18:33:36
baadc33c88f701a068d468e15500ed87b84df43b...e38d08d4c0c23e678549b10f96286b37a7d8c7ed,2,10,6,16,3,2013-01-31 16:03:53,2013-01-31 15:06:37
e38d08d4c0c23e678549b10f96286b37a7d8c7ed...ed2cf5b3e3e195d5ccf77b9e36c9508a877ccdd6,1,1,1,2,1,2013-01-31 17:04:12,2013-01-31 17:04:12
ed2cf5b3e3e195d5ccf77b9e36c9508a877ccdd6...6014e630547d08dcc9610546e4f04aaac0c30be5,1,1,1,2,1,2013-01-31 17:10:41,2013-01-31 17:10:41
6014e630547d08dcc9610546e4f04aaac0c30be5...2f44d8d2dac855ecaeb0ad4ac460c83bb2ca321b,2,0,2,2,2,2013-01-31 18:49:53,2013-01-31 18:49:53
0bfbf1446d853e5edb066acb68bcf3eb995b47b3...b1f1d7871fb4eaf0418a8ff4e626aa3dda0d4049,1,324,0,324,1,2013-02-03 02:57:24,2013-02-03 02:57:24
0bfbf1446d853e5edb066acb68bcf3eb995b47b3...6b9bb547bf275d8723d50b16fbb22ba9e334da39,1,6,7,13,6,2013-02-02 07:58:27,2013-02-02 07:49:55
01b465928ec47d460ea1fd705e49aa2e0e9a4d28...d6e3b6b5a449b7929e48916a77aca48d1266f5af,2,2,2,4,2,2013-01-28 18:01:59,2013-01-28 18:01:59
01b465928ec47d460ea1fd705e49aa2e0e9a4d28...6803ff70f9203595a04c5adb20d7556cd52c5923,2,65,9,74,5,2013-01-26 12:50:26,2013-01-26 12:50:26
6803ff70f9203595a04c5adb20d7556cd52c5923...929598784f3a2e4f706d5dcd5a41cea207dfd65e,2,19,1,20,2,2013-01-26 13:06:58,2013-01-26 13:06:58
929598784f3a2e4f706d5dcd5a41cea207dfd65e...e5be883bb9a5a9e4eb90df7f3d2e24237a3e010a,1,2,2,4,2,2013-01-26 13:31:33,2013-01-26 13:31:33
e5be883bb9a5a9e4eb90df7f3d2e24237a3e010a...db9ec13ce4088fc13a7ef7b07662317ea2c435c8,3,44,6,50,6,2013-01-26 20:39:05,2013-01-26 20:39:05
db9ec13ce4088fc13a7ef7b07662317ea2c435c8...d9a0abaa06b4e94ffffc921dcb1119b3bb83f522,1,1,1,2,1,2013-01-26 20:39:49,2013-01-26 20:39:49
d9a0abaa06b4e94ffffc921dcb1119b3bb83f522...5b0f956a60d8bd41084a167f83c25e276de11705,1,22,1,23,1,2013-01-26 20:45:21,2013-01-26 20:45:21
5b0f956a60d8bd41084a167f83c25e276de11705...ee71fb492ffc664627436431c5f7b71d2107a526,2,44,44,88,30,2013-01-27 09:56:01,2013-01-27 09:56:01
01b465928ec47d460ea1fd705e49aa2e0e9a4d28...f3268db4b4d4be9d53e54c57dba146714d986b0f,1,1,1,2,1,2013-01-19 21:27:10,2013-01-19 21:27:10
6b67a836316adad78f0cc0e7244af0f0ddddf0b7...5abe33f5d84e8b7357f50744a7ce7d4420745dd8,1,1,1,2,1,2012-12-20 09:13:03,2012-12-20 09:13:03
9726fded1c587c14b57a61a92b88ac74fe21d320...c00f29e4d4e157376c2b24a64bee67bc67e7136a,2,5,2,7,2,2012-12-20 08:54:58,2012-12-20 08:54:58
c1e82732cf4c87e0e73458feaf3b7c76e1ea489e...a27bf30f0d7a42f356d661db9835710bc8917067,6,6,8,14,8,2012-12-21 05:38:53,2012-12-21 05:38:53
a4b31d39a26bf493d60d4aaadddd19996966e43c...1629df80087c053c4c9b441e563f319a3ec8777f,3,3,3,6,3,2013-02-06 05:20:29,2013-02-06 05:20:29
9360a25abf1ab40c84a029c12a6a4e4c3d9a2206...2ba3b47dc697bdcb69b2100d664c51d69c453010,1,3,3,6,2,2013-06-22 11:34:17,2013-06-22 11:34:17
2ba3b47dc697bdcb69b2100d664c51d69c453010...b51e1e0d8c632d391058f5094295d9c4124c3f28,1,2,2,4,2,2013-06-22 11:41:31,2013-06-22 11:41:31
b51e1e0d8c632d391058f5094295d9c4124c3f28...aad76f21f6eefb3afc19c7cefeb97f00df058a9f,1,4,4,8,3,2013-06-22 15:44:04,2013-06-22 15:44:04
aad76f21f6eefb3afc19c7cefeb97f00df058a9f...72183d9a452fa43ac8d994374713c7a585d1744c,1,1,0,1,1,2013-06-22 15:45:25,2013-06-22 15:45:25
4b34f4947aedc0e8539eee779e3921f44e0bca8b...f9ee99cf6febd0b59ee95aa1866a3c1eb5c61320,19,26,18,44,19,2013-01-14 08:11:55,2013-01-14 08:11:55
4b34f4947aedc0e8539eee779e3921f44e0bca8b...fdd1daeae113fde24391ca4c58d46c29b3871fd9,1,8,0,8,1,2013-01-13 20:21:31,2013-01-13 20:21:31
fdd1daeae113fde24391ca4c58d46c29b3871fd9...98aeb0acf1bac40236eafc1342e88e3d7fc18e94,1,8,0,8,1,2013-01-13 20:23:22,2013-01-13 20:23:22
98aeb0acf1bac40236eafc1342e88e3d7fc18e94...ecc24953a50e4b0a5d91b9a72e91b3c038fc1e48,1,1,1,2,1,2013-01-13 20:32:03,2013-01-13 20:32:03
ecc24953a50e4b0a5d91b9a72e91b3c038fc1e48...a23eb065365e1c5d9d89f20506565d78db78d961,1,1,1,2,1,2013-01-13 20:32:51,2013-01-13 20:32:51
d247f71217917f6e53354e410b8020289b841a47...25c9b6b59a23ac572634e5314c0b682e2ec8cf3d,6,61,5965,6026,27,2013-01-15 06:05:55,2013-01-15 06:05:55
25c9b6b59a23ac572634e5314c0b682e2ec8cf3d...09696143e0301e30b931467a40d13a6d357dac07,3,1289,0,1289,3,2013-01-15 18:14:12,2013-01-15 18:14:12
09696143e0301e30b931467a40d13a6d357dac07...267690eb1bd0192338b07c6d4ed2f5b25d2fc143,6,354,238,592,38,2013-01-15 22:30:00,2013-01-15 22:30:00
267690eb1bd0192338b07c6d4ed2f5b25d2fc143...094767fbfe09b921da1f3f5deba4db2c79be37f5,1,4,2,6,2,2013-01-15 22:34:04,2013-01-15 22:34:04
094767fbfe09b921da1f3f5deba4db2c79be37f5...85db846b651842444d374f8e54f3f362ca18d08e,12,1623,48,1671,58,2013-01-16 01:55:14,2013-01-16 01:55:14
85db846b651842444d374f8e54f3f362ca18d08e...5a3cb0d778b22db3ecd412dd2c6367d09a356c6d,2,0,2,2,2,2013-01-16 18:49:19,2013-01-16 18:49:19
5a3cb0d778b22db3ecd412dd2c6367d09a356c6d...8fd26040d80f72e357692d257e80526bf2c36427,3,347,367,714,5,2013-01-16 18:52:33,2013-01-16 18:52:33
8fd26040d80f72e357692d257e80526bf2c36427...cb0691d92f214df385d512a3f63f8f5ea861f922,2,22,5,27,7,2013-01-16 18:57:00,2013-01-16 18:57:00
cb0691d92f214df385d512a3f63f8f5ea861f922...81a22e189a8e4a513fed6cb30a84aa30b793e246,1,53,1,54,2,2013-01-16 19:03:54,2013-01-16 19:03:54
81a22e189a8e4a513fed6cb30a84aa30b793e246...0df7411362bbfb1497c37d66e224ec88e34ffb8e,6,189,34,223,32,2013-01-16 19:38:34,2013-01-16 19:38:34
0df7411362bbfb1497c37d66e224ec88e34ffb8e...6ac6be2a5e28c39c5fe359c6b4d8270ad324a094,1,6,21,27,5,2013-01-16 19:45:16,2013-01-16 19:45:16
6ac6be2a5e28c39c5fe359c6b4d8270ad324a094...cb99c4b63a9f67f67388619f0438c05bce1daee5,2,176,0,176,2,2013-01-16 19:48:20,2013-01-16 19:48:20
cb99c4b63a9f67f67388619f0438c05bce1daee5...b6b8633542623b1d86254b6d2b653754bb2c933f,2,6,3,9,4,2013-01-16 20:02:45,2013-01-16 20:02:45
b6b8633542623b1d86254b6d2b653754bb2c933f...992e0d922ae5c15bf9df2d65cbc6293cf203734f,6,650,52,702,37,2013-01-16 20:23:05,2013-01-16 20:20:34
992e0d922ae5c15bf9df2d65cbc6293cf203734f...c76f1cd97ed6f075146e9c406e808e6683306f6a,2,656,1,657,4,2013-01-16 20:30:44,2013-01-16 20:30:44
c76f1cd97ed6f075146e9c406e808e6683306f6a...eb3cd5d7d20c53a0ca82c52a4d873dd8b3613313,1,75,0,75,1,2013-01-16 20:44:25,2013-01-16 20:44:11
eb3cd5d7d20c53a0ca82c52a4d873dd8b3613313...a4cc704220c3969fdf842d92846f77920613a003,2,146,0,146,2,2013-01-16 20:44:31,2013-01-16 20:44:31
a4cc704220c3969fdf842d92846f77920613a003...c18b5b9735d3cc95e81f0f02b7f1555b9f344e95,1,35,0,35,1,2013-01-16 21:02:15,2013-01-16 21:02:15
c18b5b9735d3cc95e81f0f02b7f1555b9f344e95...ab38493e91d3d0f95d57189af6e67de7671e4104,3,146,1,147,3,2013-01-16 21:04:29,2013-01-16 21:04:29
ab38493e91d3d0f95d57189af6e67de7671e4104...2407217686cda083d0c560733f159421b77bd0fe,2,55,0,55,2,2013-01-16 21:05:20,2013-01-16 21:05:20
2407217686cda083d0c560733f159421b77bd0fe...2127690e73df97ae95ce367043c4d6928eb78204,2,25,0,25,2,2013-01-16 21:06:15,2013-01-16 21:06:15
2127690e73df97ae95ce367043c4d6928eb78204...bc7fd582edd592bc3061f37c59e381fc5ec85187,3,155,1,156,3,2013-01-16 21:07:08,2013-01-16 21:07:08
bc7fd582edd592bc3061f37c59e381fc5ec85187...910ca85a7009885fb209cd7ea476303394116882,2,944,0,944,2,2013-01-16 21:07:41,2013-01-16 21:07:41
910ca85a7009885fb209cd7ea476303394116882...a7a06a05a49bc1cdd5798832e0b751ea01ec2cfb,2,0,94,94,2,2013-01-16 21:08:27,2013-01-16 21:08:27
a7a06a05a49bc1cdd5798832e0b751ea01ec2cfb...beb2c13f4d9648da38cefa019f1ee7039b8a7f28,3,35,0,35,3,2013-01-16 21:11:45,2013-01-16 21:11:45
beb2c13f4d9648da38cefa019f1ee7039b8a7f28...3e40e7dfbf24a227ca03bd6144af5ecdc8399bfa,3,32,10,42,9,2013-01-16 21:20:32,2013-01-16 21:20:32
3e40e7dfbf24a227ca03bd6144af5ecdc8399bfa...13a80f33c80bf8823b1d3addcfdb990ff42409ec,3,46,9,55,9,2013-01-16 22:10:33,2013-01-16 22:10:33
13a80f33c80bf8823b1d3addcfdb990ff42409ec...cf693b56321c457ce35e1ebb72a2a5f3606fc563,4,28,6,34,7,2013-01-16 22:48:25,2013-01-16 22:48:25
cf693b56321c457ce35e1ebb72a2a5f3606fc563...1288304e9199b8cd2be06faaece97dc0c878d9e7,2,27,14,41,10,2013-01-16 23:07:57,2013-01-16 23:07:57
1288304e9199b8cd2be06faaece97dc0c878d9e7...0b81dd217f88f21f1c9e7d4cd7a17f71c5dd6f49,1,3,2,5,2,2013-01-16 23:11:17,2013-01-16 23:11:17
0b81dd217f88f21f1c9e7d4cd7a17f71c5dd6f49...baa8c3ec9eeefcc1644aa7d0cf58b4cc3337b003,5,66,21,87,14,2013-01-16 23:16:04,2013-01-16 23:16:04
baa8c3ec9eeefcc1644aa7d0cf58b4cc3337b003...ee9403e2d2c726fa01e9e9b6d44cf5162cd05705,2,30,65,95,19,2013-01-16 23:19:55,2013-01-16 23:19:55
ee9403e2d2c726fa01e9e9b6d44cf5162cd05705...960804cea397d5616918341eaec41a384976c20e,3,54,34,88,24,2013-01-16 23:35:41,2013-01-16 23:35:41
960804cea397d5616918341eaec41a384976c20e...9ba14cfb7c0daa75453fd226d09198ffec142b1b,8,188,120,308,43,2013-01-17 00:14:41,2013-01-17 00:14:41
9ba14cfb7c0daa75453fd226d09198ffec142b1b...6b193dc22d544d55100c6c0eb237a30b8eaf184b,3,18,11,29,12,2013-01-17 00:20:29,2013-01-17 00:20:29
6b193dc22d544d55100c6c0eb237a30b8eaf184b...f5352017814b45a62a614f92cc7c687391c51021,4,43,20,63,12,2013-01-17 07:33:26,2013-01-17 07:33:26
f5352017814b45a62a614f92cc7c687391c51021...4129be6ebdeaefd976898b3b566a353af467530b,1,52,35,87,4,2013-01-17 08:13:04,2013-01-17 08:13:04
4129be6ebdeaefd976898b3b566a353af467530b...630005687d19846620138253df0033a22cd72fb8,2,1,445,446,10,2013-01-17 08:13:12,2013-01-17 08:13:12
630005687d19846620138253df0033a22cd72fb8...9374965b83e17df55cb3bb80072a297b117ec00c,1,1,10,11,4,2013-01-17 08:20:00,2013-01-17 08:20:00
9374965b83e17df55cb3bb80072a297b117ec00c...33864b4a3df961309d68ea8696c2d6d5b9e441a7,3,8,6,14,6,2013-01-17 08:23:25,2013-01-17 08:23:25
33864b4a3df961309d68ea8696c2d6d5b9e441a7...a8a60e94e329b730a99ce2db50eba96fb83d1f6c,1,3,1,4,2,2013-01-17 08:24:18,2013-01-17 08:24:18
a8a60e94e329b730a99ce2db50eba96fb83d1f6c...255cb877341e9f214f57c6ccd6297c90d9c4c5ad,2,12,58,70,8,2013-01-17 08:27:46,2013-01-17 08:27:46
255cb877341e9f214f57c6ccd6297c90d9c4c5ad...687d4a3eebf15fe9235ece784a541c1fad5852b0,7,163,121,284,17,2013-01-17 08:42:31,2013-01-17 08:42:31
687d4a3eebf15fe9235ece784a541c1fad5852b0...2398245e17279c602e8904baa72b806f19e0971b,6,47,406,453,14,2013-01-17 08:43:58,2013-01-17 08:43:58
2398245e17279c602e8904baa72b806f19e0971b...267d3e7ed7f50cc5625145ad714a5e1099612e87,3,27,114,141,36,2013-01-17 08:50:19,2013-01-17 08:50:19
267d3e7ed7f50cc5625145ad714a5e1099612e87...7e46b6f6364d754cb87fca35e0897cf2fad09206,10,15,8,23,10,2013-01-17 08:58:34,2013-01-17 08:58:34
7e46b6f6364d754cb87fca35e0897cf2fad09206...01b32f472d89e6c4f7e58aa85be7a6ad92a982ec,4,72,146,218,35,2013-01-17 18:49:10,2013-01-17 18:49:10
01b32f472d89e6c4f7e58aa85be7a6ad92a982ec...360f0c5359917d3a54d4822a7cc348ef787fef12,2,11,5,16,9,2013-01-17 19:20:19,2013-01-17 19:20:19
360f0c5359917d3a54d4822a7cc348ef787fef12...597a248d4ac8bf873d3227c2db285877061ed7b8,2,196,183,379,22,2013-01-17 19:34:46,2013-01-17 19:34:46
597a248d4ac8bf873d3227c2db285877061ed7b8...32ebe2efd1e72b60ceedd69bb1503257cdf22a41,2,139,307,446,12,2013-01-17 19:55:37,2013-01-17 19:55:37
32ebe2efd1e72b60ceedd69bb1503257cdf22a41...26f9f4e3a574a3a17999b4171b8ffdf813949719,2,0,30,30,2,2013-01-17 20:02:17,2013-01-17 20:02:17
26f9f4e3a574a3a17999b4171b8ffdf813949719...7c23d889bb89fa7dc5ea17347a6b3a44c01f652d,2,2,2,4,2,2013-01-17 20:13:37,2013-01-17 20:13:37
7c23d889bb89fa7dc5ea17347a6b3a44c01f652d...5c76518f7d4eb5e71ce3e196a1bc98496d3cc80c,9,14,8,22,17,2013-01-17 22:00:03,2013-01-17 22:00:03
5c76518f7d4eb5e71ce3e196a1bc98496d3cc80c...bb94de78735c92525f04d3ec65b12272d5de699d,1,1,0,1,1,2013-01-17 22:22:41,2013-01-17 22:22:41
bb94de78735c92525f04d3ec65b12272d5de699d...237f5e15d3376d141ac934a9264428a7b822384c,2,0,6,6,4,2013-01-17 22:25:40,2013-01-17 22:25:40
237f5e15d3376d141ac934a9264428a7b822384c...f6226c9b91c38afc7d5050a3cfd7217edef7fc16,9,28,8,36,10,2013-01-17 22:49:52,2013-01-17 22:49:52
f6226c9b91c38afc7d5050a3cfd7217edef7fc16...32bcbe5671faf83b9c0161dcae8a1ab0f1d61c59,3,14,2,16,3,2013-01-17 23:00:49,2013-01-17 23:00:49
32bcbe5671faf83b9c0161dcae8a1ab0f1d61c59...97975c5fcf3f671c26d1688f54c8d65bba41c87c,5,23,62,85,19,2013-01-17 23:36:36,2013-01-17 23:36:36
97975c5fcf3f671c26d1688f54c8d65bba41c87c...3a1e1167d66a0d9420d21b61fd3104d746b2eee1,1,8,0,8,1,2013-01-17 23:40:43,2013-01-17 23:40:43
3a1e1167d66a0d9420d21b61fd3104d746b2eee1...e3047981948b44641125ddc48b40b93548ae9627,1,2,1,3,3,2013-01-17 23:42:52,2013-01-17 23:42:52
e3047981948b44641125ddc48b40b93548ae9627...8765df47cd47930adf51fe996a2b55a037c1e12e,2,0,2,2,2,2013-01-17 23:43:23,2013-01-17 23:43:23
8765df47cd47930adf51fe996a2b55a037c1e12e...2523b91dad0a1f73ffe6945dfa389e0a5759608a,1,1,1,2,1,2013-01-18 00:11:01,2013-01-18 00:11:01
2523b91dad0a1f73ffe6945dfa389e0a5759608a...41ecc2a1713d4d81922cc3e033de987e5f820935,1,1,1,2,1,2013-01-18 00:35:30,2013-01-18 00:35:30
41ecc2a1713d4d81922cc3e033de987e5f820935...b30b8c2c1234686b330e86fe24d11894b5d08539,9,147,233,380,68,2013-01-18 01:02:35,2013-01-18 01:02:35
b30b8c2c1234686b330e86fe24d11894b5d08539...5663833bfc3ea815ee9fa82a53e1bd3e3f14f585,5,37,0,37,5,2013-01-18 03:51:22,2013-01-18 03:51:22
5663833bfc3ea815ee9fa82a53e1bd3e3f14f585...89b6477bdc3c86a59c22a62778a6879c220c5df5,2,0,14,14,4,2013-01-18 04:13:11,2013-01-18 04:13:11
89b6477bdc3c86a59c22a62778a6879c220c5df5...ca74b9882b1c2029bfd0d091fd372007b9dc7420,4,18,17,35,7,2013-01-18 04:16:04,2013-01-18 04:16:04
ca74b9882b1c2029bfd0d091fd372007b9dc7420...f068cdeb63770182b9e954eac9cbd11bf8df5d57,3,25,22,47,6,2013-01-18 04:18:03,2013-01-18 04:18:03
d247f71217917f6e53354e410b8020289b841a47...5204f206b982a9ded4a70e8f900fdf5811f4e557,1,8,4,12,6,2013-01-14 13:57:44,2012-11-12 00:13:43
5204f206b982a9ded4a70e8f900fdf5811f4e557...25803a966b07df24500dd74fc100c14656fb7d82,1,4,4,8,4,2013-01-14 13:58:16,2013-01-02 10:42:59
25803a966b07df24500dd74fc100c14656fb7d82...2a151d9e2f68d3658e90f08a23af15069a14d27e,1,1,1,2,2,2013-01-14 13:58:47,2013-01-02 10:59:55
2a151d9e2f68d3658e90f08a23af15069a14d27e...10a83b1e6270cf5eb0bc7cefcbe700f16c7fd5ee,1,6,5,11,5,2013-01-14 14:01:19,2013-01-02 11:12:14
10a83b1e6270cf5eb0bc7cefcbe700f16c7fd5ee...915ebf9f3001da3b818d358937955e32719e2251,1,2,2,4,1,2013-01-14 14:01:19,2013-01-02 11:13:46
915ebf9f3001da3b818d358937955e32719e2251...6512c5a5bccc80b1cfad84aa6b3efe267342fbba,1,4,4,8,1,2013-01-14 14:02:25,2013-01-14 14:02:25
c2c02d104c5e5a96330cf00a727d62687d863e02...12d3c2fe74bbe2570e47a2c8d7154a3011bd0770,7,29,38,67,15,2012-01-28 20:08:41,2012-01-28 20:08:41
39f70afed9998826f4a4ff548b721a5b065c985e...2bfda031cebcde7361797dd54badeb91d4cb98cf,5,61,54,115,27,2012-01-28 20:43:19,2012-01-28 20:43:19
420a8088a4086cf06d930070404531cba8db8a8d...457885075f8fa004f3a190efdcf381af218e1bb7,11,40,33,73,34,2015-03-03 16:22:09,2015-02-25 02:00:37
457885075f8fa004f3a190efdcf381af218e1bb7...0862d1410ec9347a75915c4eb0dc59447cb46dad,7,58,58,116,57,2015-03-03 16:26:38,2015-02-27 18:36:51
0862d1410ec9347a75915c4eb0dc59447cb46dad...20d3ad10eb5d40e48074229c4dcc6ed423c6fe87,2,21,21,42,21,2015-03-03 16:29:33,2015-02-28 23:59:54
20d3ad10eb5d40e48074229c4dcc6ed423c6fe87...168297c7791497c2b1a29c001799236d7ee77517,1,1,1,2,1,2015-03-03 21:06:32,2015-03-03 21:06:25
91002717d94a04d974c96dbf9beb93f2718f9a3a...399658178d3248f58f167233d99ae10990cf76fb,1,1,1,2,1,2015-03-02 14:51:23,2015-03-02 14:51:23
72a91b0205b3a76baebb68aeac8030fd015d906b...4576dbae95e74bd1b2cfa849757b9774bcde7ade,1,1,1,2,1,2015-01-10 03:04:42,2015-01-10 03:04:42
4576dbae95e74bd1b2cfa849757b9774bcde7ade...dbe38e89d074d5bcaab96b6b9bf29e3bba0f520f,1,1,1,2,1,2015-01-10 03:16:06,2015-01-10 03:16:06
dbe38e89d074d5bcaab96b6b9bf29e3bba0f520f...82d786b5fe510d27bd66f92214c0c586676814a3,1,1,1,2,1,2015-01-10 03:39:33,2015-01-10 03:39:33
2a1adb5f94917ffdbfcde5933f35bc4f17869108...be8eafd76bee6fc66c2975ce52ff2b1054877bf2,1,4,0,4,4,2015-01-16 20:44:27,2015-01-16 20:44:27
8b417c39e7d5b10a1ef54c54c225858857cff5e3...8df2811d4981f5b3cc9291ac1c8c7fddb41427c6,10,2,14,16,11,2012-11-22 07:29:20,2012-11-22 07:29:20
8df2811d4981f5b3cc9291ac1c8c7fddb41427c6...5d1b4206b1ed88e40a1f3029dc9b5dccebe7a110,2,14,14,28,6,2012-11-22 20:06:36,2012-11-22 20:06:36
5d1b4206b1ed88e40a1f3029dc9b5dccebe7a110...e0d0190803398ce12b2fe88e31e45993b35cf17e,3,8,7,15,8,2012-11-22 20:26:54,2012-11-22 20:26:54
16111a5e454a8af4407f4217b5defb6d7a9bdbd3...40b7a909a63eef53053de4595079ac1a06118cc5,4,4,4,8,4,2013-03-01 03:37:30,2013-03-01 03:37:30
40b7a909a63eef53053de4595079ac1a06118cc5...ef80765726f2be39c85080d257e7eac55abcc6a6,1,1,1,2,1,2013-03-01 03:47:01,2013-03-01 03:47:01
ef80765726f2be39c85080d257e7eac55abcc6a6...cf998040eca7154e8a55f0a8db8acab301acac7c,3,3,3,6,3,2013-03-01 03:49:08,2013-03-01 03:49:08
cf998040eca7154e8a55f0a8db8acab301acac7c...01e0f8c653db442326ee1559eac4691af246d49e,4,30,4,34,4,2013-03-01 04:39:07,2013-03-01 04:39:07
01e0f8c653db442326ee1559eac4691af246d49e...a61322c2fb55769cf89216879a17c1e924ca1be2,1,2,2,4,1,2013-03-01 04:46:51,2013-03-01 04:46:51
a61322c2fb55769cf89216879a17c1e924ca1be2...2f27d9851c72a28fc4591daf87fab8f05e0fb01f,1,0,1,1,1,2013-03-01 04:48:02,2013-03-01 04:48:02
2f27d9851c72a28fc4591daf87fab8f05e0fb01f...cec434a4c322bd12e639232495b38d54f9ca917c,1,0,1,1,1,2013-03-01 04:48:48,2013-03-01 04:48:48
cec434a4c322bd12e639232495b38d54f9ca917c...3469339068a5676b225af7a39dffcad41e391934,39,61,52,113,53,2013-03-01 04:55:14,2013-03-01 04:55:14
3469339068a5676b225af7a39dffcad41e391934...0992a859329c80d15b9868fc426de8aefa1f8ea0,1,1,1,2,1,2013-03-01 05:00:21,2013-03-01 05:00:21
0992a859329c80d15b9868fc426de8aefa1f8ea0...839b0c893fe2f2760682bee9dc49d5fa0b9c0412,5,21,4,25,5,2013-03-01 05:15:33,2013-03-01 05:15:33
839b0c893fe2f2760682bee9dc49d5fa0b9c0412...6b2a010357e184e670a2f4768e37d4886e8a6597,1,1,0,1,1,2013-03-01 05:16:08,2013-03-01 05:16:08
2aa1a4dc706606e060525907574bb648b773f312...ab1dc25ffc7ed617ed32670b93fbd663e9d6bf1e,2,10,143,153,14,2013-02-08 08:13:44,2013-02-08 08:13:44
ab1dc25ffc7ed617ed32670b93fbd663e9d6bf1e...3eed90c18752df8b86c97afe90e2c75d55ff1637,2,7,10,17,6,2013-02-08 16:24:10,2013-02-08 16:24:10
3eed90c18752df8b86c97afe90e2c75d55ff1637...1b2b049ef827553e20c995710d11982fa9d53f79,2,9,9,18,2,2013-02-08 16:32:29,2013-02-08 16:32:29
1b2b049ef827553e20c995710d11982fa9d53f79...63c1377ee7802d857bfa359fb3d9824abf5a91fc,2,2,0,2,2,2013-02-08 17:56:04,2013-02-08 17:56:04
7d655c35494012f15bc1f9ae515e92ca4c432a66...b7b2e4f8a1bda965442668869e1dc5e5118fd985,2,3,0,3,3,2013-02-01 20:34:30,2013-02-01 20:34:30
83e5c01856fbc7003ea949ac5c2416339145426e...5e5670a1b4c81bcfeaac67d6b25ca9649839097f,10,2,29,31,11,2013-02-01 02:00:11,2013-02-01 02:00:11
5e5670a1b4c81bcfeaac67d6b25ca9649839097f...061d2849a6384900f15cbf782e7299f215dbb087,1,4,1,5,2,2013-02-01 02:06:56,2013-02-01 02:06:56
dbe8aed76ed556a082a8dd99dbcc786e4d7ea8df...1fe4ed882341af29a3b709c06642e0dbb556560f,2,4,4,8,3,2013-02-02 23:58:56,2013-02-02 23:55:18
1fe4ed882341af29a3b709c06642e0dbb556560f...4b86a91e5339600e14e37d3309f2a4bb645cebc5,1,1,1,2,1,2013-02-04 14:10:48,2013-02-04 14:10:48
d6048031edd5f931080cf792c283d0d669838825...db8a78fae6aed5ecced5f20df65cea352af32bb9,2,2,4,6,2,2013-02-04 19:11:04,2013-02-04 19:11:04
ab0c055bc68d64019dcbcc939915c2fff057ab30...f20c3368e41cb654dfcb568968b171c45de22127,2,6,4,10,6,2013-01-31 01:42:03,2013-01-31 01:42:03
ab0c055bc68d64019dcbcc939915c2fff057ab30...b7764d8a3399fa8f91d702ac85cbe652fadb6bbe,1,1,1,2,1,2013-01-29 18:50:13,2013-01-29 18:50:13
5e4db94c240c5ac2af18bbf4238358a043ad4037...481428154084a9fafd31d8654157d6f6f78231d0,9,152,102,254,26,2013-02-06 06:29:59,2013-02-06 06:29:59
d9b35c2602b18c78a72ba4b1698b3ec93ccb868d...fd89531f6ae7c2ec9fdaf32f2a8ced34875571e6,9,64,45,109,64,2013-01-18 04:26:17,2013-01-18 04:26:17
fd89531f6ae7c2ec9fdaf32f2a8ced34875571e6...1b128b34310898382e1af54abbf6be3ec6e55361,10,19,20,39,16,2013-01-18 04:28:05,2013-01-18 04:28:05
1b128b34310898382e1af54abbf6be3ec6e55361...ac3c907799848a4be3cd80765e385306491acf43,1,12,2,14,2,2013-01-18 04:30:19,2013-01-18 04:30:19
ac3c907799848a4be3cd80765e385306491acf43...5075f4973b8bb926573bb7f45c720ff345e1eb54,2,2,2,4,2,2013-01-18 04:30:40,2013-01-18 04:30:40
5075f4973b8bb926573bb7f45c720ff345e1eb54...6466fe00a1c53691832095fe97f90e295f3489e6,3,2,2,4,2,2013-01-18 04:32:07,2013-01-18 04:32:07
6466fe00a1c53691832095fe97f90e295f3489e6...caed3a9dbb8de5f8269b0d9439c52a985c5b1a83,2,56,47,103,10,2013-01-18 04:35:59,2013-01-18 04:35:59
caed3a9dbb8de5f8269b0d9439c52a985c5b1a83...8111e307b960efa60220687d60496012d9903af1,3,31,35,66,16,2013-01-18 04:39:38,2013-01-18 04:39:38
8111e307b960efa60220687d60496012d9903af1...604f76dcf8666e4a9e98c613878761da81178085,2,54,54,108,19,2013-01-18 05:05:23,2013-01-18 05:05:23
604f76dcf8666e4a9e98c613878761da81178085...d4cb7077fe4405557b4b4a2f5999578be342f7e0,1,12,0,12,3,2013-01-18 09:33:55,2013-01-18 09:33:55
d4cb7077fe4405557b4b4a2f5999578be342f7e0...82bfa965a7f59ff9b3a40d3ea7fca18de216230b,2,25,19,44,8,2013-01-18 09:37:31,2013-01-18 09:37:31
82bfa965a7f59ff9b3a40d3ea7fca18de216230b...411e6b18cb3a45f6e15fcfef9048185d1c97eff3,1,27,15,42,7,2013-01-18 09:52:16,2013-01-18 09:52:16
411e6b18cb3a45f6e15fcfef9048185d1c97eff3...7c9295d44b5d5bc515afb0df1f5885f4f655410d,2,42,38,80,13,2013-01-19 17:34:08,2013-01-19 17:34:08
7c9295d44b5d5bc515afb0df1f5885f4f655410d...d7d5069be104c6de2627ee08891ff0b3983d168c,3,17,3,20,5,2013-01-19 17:38:49,2013-01-19 17:38:49
d7d5069be104c6de2627ee08891ff0b3983d168c...1a88367b72eb31acf42a941e95ef80eb27f00cde,2,2,2,4,2,2013-01-19 17:39:56,2013-01-19 17:39:56
1a88367b72eb31acf42a941e95ef80eb27f00cde...64bc5dc91f2a0770d3d563c53600a82f92f53c0f,1,26,28,54,1,2013-01-19 17:40:26,2013-01-19 17:40:26
3f493f0d0d81d21c3d6aa6ffac7e881ca00654e6...e21b6459ad162296f94b2d9aeaf8807a153d3c8a,1,3,3,6,2,2012-12-20 09:34:28,2012-12-20 09:34:28
e21b6459ad162296f94b2d9aeaf8807a153d3c8a...a6705246d048ade327c5f93b4cc610ffbba86ee6,1,9,1,10,1,2012-12-20 09:36:57,2012-12-20 09:36:57
c00f29e4d4e157376c2b24a64bee67bc67e7136a...f706acb11cdfaab03ecc7249dee7ed48228a41fa,2,4,4,8,4,2012-12-20 09:30:32,2012-12-20 09:30:32
704dfb2f1d4e8f74715c37547668d29aa8e3ea6c...dc32555f5b3b574087916529d58d3afac059d196,2,2,2,4,2,2012-12-21 23:46:10,2012-12-21 23:46:10
42f101d746414e29f1467ebdab0b5962137f1f84...7fd121fecb0e5b2774a2c1486d61f95b298035aa,1,1,0,1,1,2013-06-23 00:38:02,2013-06-23 00:38:02
337741fc9aa89e691f15c45d59cd4b70e4b16527...c34ef691001626728cf5263421899227aa4d3b5b,1,4,0,4,1,2013-01-15 18:15:02,2013-01-15 18:15:02
c34ef691001626728cf5263421899227aa4d3b5b...a67c86e40f0b79e8abf5c6c266166db80d8edb72,2,18,2,20,3,2013-01-15 18:27:30,2013-01-15 18:27:30
43da258bd9e67e0aaa850bd92c95937f7d586796...28e1702052172e2076f87732b43f2618701ae605,2,4705,1,4706,2,2013-02-06 03:59:02,2013-02-06 03:59:02
28e1702052172e2076f87732b43f2618701ae605...37a6879ca59f1001d60421163efc958de3d193f5,2,2,2,4,2,2013-02-06 04:39:09,2013-02-06 04:39:09
37a6879ca59f1001d60421163efc958de3d193f5...fb1db88256d94bf1844c2fcdb34fc98a76c313fb,29,130,20,150,15,2013-02-06 05:04:46,2013-02-06 05:04:46
fb1db88256d94bf1844c2fcdb34fc98a76c313fb...a92069738280924fcad7d58a3ee5e5d8873b2b4b,21,0,0,0,0,2013-02-06 05:05:24,2013-02-06 05:05:24
a92069738280924fcad7d58a3ee5e5d8873b2b4b...4270496e8a02085e13ab5335eacbd1e1b6b8ad65,3,10,0,10,2,2013-02-06 05:07:30,2013-02-06 05:07:30
4270496e8a02085e13ab5335eacbd1e1b6b8ad65...6d21d8600739fe16e8993a11f82a4727065ca78a,2,2,0,2,2,2013-02-06 06:29:01,2013-02-06 06:29:01
f068cdeb63770182b9e954eac9cbd11bf8df5d57...665de0455cb433c9e3c3b6d6ad72318b46098650,5,32,132,164,30,2013-01-18 21:35:23,2013-01-18 21:35:23
665de0455cb433c9e3c3b6d6ad72318b46098650...964cb773838379319903bcf4b678addc07a55e98,2,2,2,4,2,2013-01-18 21:50:58,2013-01-18 21:50:58
964cb773838379319903bcf4b678addc07a55e98...67ec13a44c945c61735882ce7e78174ea9e32d74,2,12,44,56,4,2013-01-18 22:03:43,2013-01-18 22:03:43
f068cdeb63770182b9e954eac9cbd11bf8df5d57...27ff51dae6b46b121080c892e07aa76a8eb18280,1,20,39,59,8,2013-01-18 15:55:17,2013-01-18 15:55:17
27ff51dae6b46b121080c892e07aa76a8eb18280...6e96cd1a7c503289bd7dfd41fccaa7eefcc5c91e,1,36,18,54,6,2013-01-18 15:58:12,2013-01-18 15:58:12
6e96cd1a7c503289bd7dfd41fccaa7eefcc5c91e...b741c731a2ce3aaf0d891770705b3feb5b09c853,2,26,26,52,19,2013-01-18 16:12:30,2013-01-18 16:12:30
b741c731a2ce3aaf0d891770705b3feb5b09c853...c77a459b3520a8ee14bebad887427c3cb540f76b,2,108,40,148,14,2013-01-19 23:32:55,2013-01-19 23:32:55
6663a35562a19d659fc16c8e2711479300a439f4...9134fa4eda2ce976a982d35b779c0849a9bd7c83,1,1,1,2,1,2013-02-18 00:56:57,2013-02-18 00:56:57
9134fa4eda2ce976a982d35b779c0849a9bd7c83...f59e4fdba32b99bdd4e6387f889dda4c9270f762,1,7,7,14,5,2013-02-18 00:58:43,2013-02-18 00:58:43
e1a1fdd35d347b8aef8b6d183c182be684314e89...f768242759903151c9957a493c5349f931d882ef,1,4,4,8,1,2012-01-28 20:14:41,2012-01-28 20:14:41
698d4b414c234f74ae93384a8d83c14c15ab2cc9...b77161f8647f791319c684a191c2308b6dd05100,2,2,4,6,2,2012-01-28 20:49:26,2012-01-28 20:49:26
b77161f8647f791319c684a191c2308b6dd05100...70c6a6cd855a617b086682ef919e02cf67d4e86e,5,11,59,70,7,2012-01-28 20:58:26,2012-01-28 20:58:26
70c6a6cd855a617b086682ef919e02cf67d4e86e...296d06a285d91200b4063f3bdde65c094495ee24,4,11,4,15,4,2012-01-28 21:07:01,2012-01-28 21:07:01
296d06a285d91200b4063f3bdde65c094495ee24...1a22c3b30aa67b4f092b164fad188050af8bbab2,2,24,0,24,21,2012-01-28 21:13:01,2012-01-28 21:13:01
168297c7791497c2b1a29c001799236d7ee77517...cc39f5c52d9dbab26132c86f8150c766c1dcb102,4,39,39,78,35,2015-03-03 21:18:36,2015-03-03 21:18:36
168297c7791497c2b1a29c001799236d7ee77517...2f17289ab6665620c52a4a69750294f892a42e81,1,1,1,2,1,2015-03-03 21:11:15,2015-03-03 21:11:15
399658178d3248f58f167233d99ae10990cf76fb...f5beebe726aa8c1810015d8c62931f4559b49664,5,74,29,103,17,2015-03-03 04:27:26,2015-02-24 00:00:04
82d786b5fe510d27bd66f92214c0c586676814a3...0dc83955903eafb6589447c2025d05d841f09d57,1,1,0,1,1,2015-01-13 20:21:32,2015-01-13 20:19:43
0dc83955903eafb6589447c2025d05d841f09d57...9fdf7a26e12f17282f565bc18ca16be2ad865153,2,2,1,3,2,2015-01-13 20:31:25,2015-01-13 20:31:25
9fdf7a26e12f17282f565bc18ca16be2ad865153...fb6622a7d44c99323bea5bd69cb0604470bbe21a,2,6,6,12,6,2015-01-14 01:06:31,2015-01-14 01:06:31
82d786b5fe510d27bd66f92214c0c586676814a3...0c8cb3f2dca3aa2dafec5762092fcf728dd2f962,1,1,1,2,1,2015-01-13 01:18:52,2015-01-13 01:18:52
b1daf3803ed62a82132123ba2af1c5aa8bc19483...46710efba409b1c78037609a915cd36f2e62ce96,1,1,1,2,1,2015-01-16 21:41:05,2015-01-16 21:41:05
46710efba409b1c78037609a915cd36f2e62ce96...8a1efe91df296e62bc560e51b462e9d51d31a988,1,1,1,2,1,2015-01-16 23:16:52,2015-01-16 23:16:52
21d56378e1f7ec1cd24ffefcad32357267930c74...c178995b87329f2284e846dea90fe1c3da6186f1,2,2,2,4,2,2015-03-09 08:11:37,2015-03-09 08:11:37
21d56378e1f7ec1cd24ffefcad32357267930c74...725c6848c362f90bbdb931dcea70d40a1753d768,10,104,64,168,62,2015-03-09 08:05:43,2015-03-06 12:34:28
e0d0190803398ce12b2fe88e31e45993b35cf17e...dc10e6bbf8d051d763ec0c14dd8f5307ac356654,2,20,20,40,20,2012-11-28 08:19:35,2012-11-28 08:19:35
dc10e6bbf8d051d763ec0c14dd8f5307ac356654...02097700e8ab24506dda5332778398119dc8b728,2,6,6,12,6,2012-11-28 08:31:52,2012-11-28 08:31:52
02097700e8ab24506dda5332778398119dc8b728...942f9c5df4f731720cb28d126e9202ab21c28996,1,2,1,3,2,2012-11-28 08:37:55,2012-11-28 08:37:55
942f9c5df4f731720cb28d126e9202ab21c28996...74f51105e980176caddda430959ffc536b3610ec,2,21,0,21,5,2012-11-28 08:42:17,2012-11-28 08:42:17
74f51105e980176caddda430959ffc536b3610ec...fda5bb135e0a91f335f1e3bd4e5313070f6e0708,4,18,2,20,4,2012-11-28 08:46:09,2012-11-28 08:46:09
fda5bb135e0a91f335f1e3bd4e5313070f6e0708...bfc97fdaf6cefceb4091e745977b5bac2ffda1c7,2,178,40,218,23,2012-11-28 09:38:21,2012-11-28 09:38:21
bfc97fdaf6cefceb4091e745977b5bac2ffda1c7...014d3cedf5f92e9b9f246cef2c639b2845e6741f,2,9,1,10,3,2012-11-28 09:48:34,2012-11-28 09:48:34
014d3cedf5f92e9b9f246cef2c639b2845e6741f...783120dffaab396955b0ad237bf3a82a73a6e1dc,2,6,6,12,2,2012-11-28 09:51:04,2012-11-28 09:51:04
783120dffaab396955b0ad237bf3a82a73a6e1dc...bf3a5df371dc58cc4030bf0177b2be964054d4d8,2,4,2,6,2,2012-11-28 10:10:23,2012-11-28 10:10:23
bf3a5df371dc58cc4030bf0177b2be964054d4d8...296b8384050746b11c02bde2e68954981c3ec5fe,2,28,28,56,20,2012-11-28 10:17:50,2012-11-28 10:17:50
296b8384050746b11c02bde2e68954981c3ec5fe...8fb36cb3dd60c34afdbb8e46cc457b2e8795b3c5,2,14,14,28,14,2012-11-28 10:21:34,2012-11-28 10:21:34
8fb36cb3dd60c34afdbb8e46cc457b2e8795b3c5...f1349a245096da5e29fd83fa99346e5e40faf077,2,2,0,2,2,2012-11-28 10:22:37,2012-11-28 10:22:37
e0d0190803398ce12b2fe88e31e45993b35cf17e...701f871e7db41a8c427b84fb045f89d1656f758d,1,2,1,3,1,2012-11-26 23:30:54,2012-11-26 23:30:54
701f871e7db41a8c427b84fb045f89d1656f758d...693fd0db2a91ce6c8bc5ac354a6c8d97552013b7,1,1,1,2,1,2012-11-28 08:47:59,2012-11-28 08:47:59
693fd0db2a91ce6c8bc5ac354a6c8d97552013b7...ddd154481bc9341668f236ca071c936803e43f7a,1,2,1,3,1,2012-11-29 09:40:23,2012-11-29 09:40:23
eb24718add4dd36fe92fdbdb79e6ff4ce5919300...1c7fe5d887d853ca95a2b7399ddd59c9b401568d,1,1,1,2,1,2013-03-07 06:01:21,2013-03-07 06:01:21
160ff23c852608f58c5142b7d156c26fac88ed13...28cdc8dc5f816bd2edde7d9c15f1540f0fc37914,1,26,2,28,4,2013-03-17 18:57:00,2013-03-17 18:57:00
28cdc8dc5f816bd2edde7d9c15f1540f0fc37914...3aee2adb4b4802c2e16dfe5693db9e79de4e851a,2,24,0,24,12,2013-03-17 19:10:58,2013-03-17 19:10:58
63c1377ee7802d857bfa359fb3d9824abf5a91fc...1f5f23f869a971a4c4395d5170d9b991048d244f,1,0,282,282,1,2013-02-12 05:38:44,2013-02-12 05:38:44
63c1377ee7802d857bfa359fb3d9824abf5a91fc...876a412c9007936cd69edd05013d6144eacc474d,2,4,4,8,4,2013-02-09 00:52:50,2013-02-09 00:52:50
2553d74b5459a3093e3dd42eecd9766005c024be...d53af49afea5af5ac2c3cf74f0f5439b58021198,5,173,179,352,84,2013-02-02 00:21:38,2013-02-02 00:21:38
d53af49afea5af5ac2c3cf74f0f5439b58021198...dad9889aeb703f7276a1c9e54e19df622ffadb99,2,43,10,53,15,2013-02-02 05:49:54,2013-02-02 05:49:19
dad9889aeb703f7276a1c9e54e19df622ffadb99...94e256c0162748dcddd6401d57a186576254f884,5,57,35,92,24,2013-02-02 06:56:09,2013-02-02 06:56:09
94e256c0162748dcddd6401d57a186576254f884...c64aa26d062b53a40be55ea62017bd04f523b290,4,14,24,38,9,2013-02-02 21:03:18,2013-02-02 21:03:18
fe5150d5dc17eb4331d5f73abe3d6a71588a8f0c...b02a0fe768e3703fe889953d9e9d26dae25bc074,2,3,3,6,2,2013-02-01 02:09:49,2013-02-01 02:09:49
b02a0fe768e3703fe889953d9e9d26dae25bc074...52aa67fa1c539aa9b31f3d9cf349287ab5c06120,2,2,2,4,4,2013-02-01 02:11:45,2013-02-01 02:11:45
52aa67fa1c539aa9b31f3d9cf349287ab5c06120...dfdf343825f7690ed5545236522307ade37f9c5a,1,48,22,70,8,2013-02-01 02:22:47,2013-02-01 02:22:47
dfdf343825f7690ed5545236522307ade37f9c5a...19b5ebcf2484d4cd9fdcbe9d5cb62858135107fc,4,4,4,8,2,2013-02-01 02:25:44,2013-02-01 02:25:44
19b5ebcf2484d4cd9fdcbe9d5cb62858135107fc...755f1776da53ff3e3e7987a11fb31f53a4f2d67f,1,40,7,47,7,2013-02-01 02:34:12,2013-02-01 02:34:12
755f1776da53ff3e3e7987a11fb31f53a4f2d67f...7528b6e10aae52f0ff3e0df13b09551ca63bc56b,1,2,2,4,2,2013-02-01 18:30:48,2013-02-01 18:30:48
7528b6e10aae52f0ff3e0df13b09551ca63bc56b...725cf7f6ec37668fab0ec8f59ae748feff5335f1,1,55,44,99,13,2013-02-01 18:32:08,2013-02-01 18:32:08
6a9cd513c02a6c156769d54910f1d3931da3e568...0fe9148b91eff50b83100b6795fb49cf894caed1,6,32,9,41,9,2013-02-06 06:17:28,2013-02-06 06:17:28
0fe9148b91eff50b83100b6795fb49cf894caed1...accfdaafdbfc172f4d8358bbab820a9862bd8eb9,2,2,0,2,2,2013-02-06 06:28:18,2013-02-06 06:28:18
3b56227553f40cc567e161c68c64f1e315fd5241...d8a7a380bcfd25c66ca1dc54d1619dc272f4bbb4,4,7,1,8,4,2013-02-08 03:45:42,2013-02-08 03:45:42
3b56227553f40cc567e161c68c64f1e315fd5241...2fa77bf197050a385e479e1b2e8f61d634499505,9,9,9,18,9,2013-02-06 06:46:45,2013-02-06 06:46:45
cb0fed66933d179b5bc3669a1df7df00b5688cbe...45656fc7fcedf5a98d20c72292b203a1023c4177,2,10,4,14,2,2013-02-06 04:00:50,2013-02-06 04:00:50
64bc5dc91f2a0770d3d563c53600a82f92f53c0f...72da31e0288e5febff8a18f6d81fd4b201100370,1,12,11,23,1,2013-01-30 17:14:22,2013-01-30 17:14:22
dc32555f5b3b574087916529d58d3afac059d196...ccafc8a01023d66768b34b2597e50d6f7df4ca58,1,12,8,20,6,2012-12-22 02:58:59,2012-12-22 02:58:59
bd2295014d52466b15a43de7041fc62379c4d33b...976322b2a682c1faf141f7f2241069defee790c6,1,1,0,1,1,2013-06-23 01:56:55,2013-06-23 01:56:55
976322b2a682c1faf141f7f2241069defee790c6...2a47037ab0d4aa644f04499bd704a85561b58e73,1,0,2,2,1,2013-06-23 17:24:50,2013-06-23 17:24:50
2a47037ab0d4aa644f04499bd704a85561b58e73...b76d98eee3fa4a1a8d7fb281a31a7d20982459d3,2,47,7,54,8,2013-06-23 22:05:50,2013-06-23 22:05:50
b76d98eee3fa4a1a8d7fb281a31a7d20982459d3...164e88781bc4437d654ab458e6393a8d15807d37,1,46,13,59,7,2013-06-23 22:05:58,2013-06-23 22:05:58
164e88781bc4437d654ab458e6393a8d15807d37...573a19741770338b9e08838d908f51b7a82cddd3,2,46,46,92,4,2013-06-23 22:15:42,2013-06-23 22:15:42
a67c86e40f0b79e8abf5c6c266166db80d8edb72...60bb95e611b6a096e5d50263e278b4be92e7468f,1,1,1,2,1,2013-01-16 12:45:31,2013-01-16 12:45:31
60bb95e611b6a096e5d50263e278b4be92e7468f...598e9e6f13f52249e5158c427f70d20b7c4622f4,1,1,1,2,1,2013-01-16 12:46:42,2013-01-16 12:46:42
a67c86e40f0b79e8abf5c6c266166db80d8edb72...1da1994ba4fa40ed868ab289e910ec9a0d177458,2,26,0,26,2,2013-01-16 02:16:44,2013-01-16 02:16:44
c21c3f101b334fb176b5fc4efd437b7da724e1fc...d30f47efb2580b0f435128940b48d5e5d30ca529,5,108,18,126,21,2013-01-20 02:53:41,2013-01-20 02:53:41
2f7087eae9790626b46223445b6406ff59b7a56e...9480eb89cb9995b6da2fe864911dedc6c312b070,2,25,55,80,13,2013-02-03 03:16:15,2013-02-03 03:16:15
9480eb89cb9995b6da2fe864911dedc6c312b070...1f6a988190d61128279250a444b9f028c35088c1,2,2,4,6,2,2013-02-04 19:11:25,2013-02-04 19:11:25
f768242759903151c9957a493c5349f931d882ef...6935f693b3bce10f9bfe7b7e1f3c2705ff2b6ca2,4,48,21,69,14,2012-01-28 21:16:05,2012-01-28 21:16:05
1a22c3b30aa67b4f092b164fad188050af8bbab2...fe6d2f2e1d181ef6e62eb02fab6a4e16e494d892,2,2,2,4,2,2012-01-28 21:30:15,2012-01-28 21:30:15
2f17289ab6665620c52a4a69750294f892a42e81...27bbc7dbe93799730112cb786a859331ca193130,4,26,2,28,4,2015-03-04 06:22:13,2015-03-03 21:32:24
200f6fb10d1b41db80fe0750c13eac4157a9149f...c1005f52839f56a49fea68cede63f29b35d77641,5,39,29,68,15,2015-03-03 05:01:43,2015-03-03 05:01:43
fb6622a7d44c99323bea5bd69cb0604470bbe21a...ccc3eb5cc608b4642196581ab1678ecfdae812a4,1,10,0,10,1,2015-01-15 02:43:08,2015-01-15 02:43:04
fb6622a7d44c99323bea5bd69cb0604470bbe21a...65721f531536e05026b1ae5f0359955c78d13156,1,1,1,2,1,2015-01-14 22:43:21,2015-01-14 22:42:22
fb6622a7d44c99323bea5bd69cb0604470bbe21a...7b847052863c1fa26e6a9175b2decd778a640f9a,1,2,2,4,2,2015-01-14 01:36:37,2015-01-14 01:33:27
e39b5b5b25c515a95f0293f076fe540742bd2a28...c020669b07f348ad4f3155850bbd5952cc47696e,3,3,3,6,3,2015-01-18 05:11:01,2015-01-18 05:11:01
f1349a245096da5e29fd83fa99346e5e40faf077...fe8df5022be4a009d01fb8a1bd2a1386803b2ea2,1,2,2,4,2,2012-11-28 23:33:05,2012-11-28 23:33:05
37d0a30589e8bd74299b2d857c348d91396563ed...322fc9a6c476ce89101c6b48e5308d2f6ee8eba9,1,11,0,11,1,2013-04-20 04:28:50,2013-04-20 04:28:50
322fc9a6c476ce89101c6b48e5308d2f6ee8eba9...7c41b318015f2e6f0963a75f0e1112828e17c977,1,21,5,26,2,2013-04-21 06:52:32,2013-04-21 06:52:32
7c41b318015f2e6f0963a75f0e1112828e17c977...4e9c8880f7c32f71727be15aa19b5f4b871e9488,1,7,20,27,3,2013-04-22 07:10:59,2013-04-22 07:10:59
4e9c8880f7c32f71727be15aa19b5f4b871e9488...08de4136089af30d99bae14526603ef14fc48040,5,5,5,10,5,2013-04-22 07:19:56,2013-04-22 07:19:56
37d0a30589e8bd74299b2d857c348d91396563ed...cc15c0e76913c479a848bc3fecffba6417d77dd8,1,1,0,1,1,2013-04-18 14:44:46,2013-04-18 14:44:46
cc15c0e76913c479a848bc3fecffba6417d77dd8...d3e0d4a7baad213ccbfa8049d5f920ed1863b76b,1,3,0,3,1,2013-04-18 15:05:50,2013-04-18 15:05:50
37d0a30589e8bd74299b2d857c348d91396563ed...496f1933bb5a3572f50bbb972124770e71c56e48,1,1,1,2,1,2013-04-16 20:07:05,2013-04-16 20:07:05
37d0a30589e8bd74299b2d857c348d91396563ed...cae90f30107773c7144278cd9517fdb8d69412e5,1,0,1,1,1,2013-03-17 20:22:26,2013-03-17 20:22:26
37d0a30589e8bd74299b2d857c348d91396563ed...812b99263f08d2306219ed6fcbe1685be17d6a10,1,1,1,2,1,2013-03-15 05:54:24,2013-03-15 05:54:24
a70c50d1f70ffa1582a2bdba7a9a0ce6c40fd60b...e0647e8273aee5bd09d5461f6f974e36b3d0c3c9,2,0,10,10,2,2013-03-01 20:37:36,2013-03-01 20:37:36
3aee2adb4b4802c2e16dfe5693db9e79de4e851a...f8b9e428f0bc2533dfb6e0bb56fbb54e731e1f24,1,1,1,2,1,2013-03-23 19:21:37,2013-03-23 19:21:37
3aee2adb4b4802c2e16dfe5693db9e79de4e851a...3c82ccaa2bf7738b41f8805232f3a96aec522655,2,12,0,12,12,2013-03-18 00:26:02,2013-03-18 00:26:02
1f5f23f869a971a4c4395d5170d9b991048d244f...5de8557398ec862ab94f48dc081865d8223de1cf,236,46646,5,46651,122,2013-02-12 20:16:32,2013-02-12 20:16:32
5de8557398ec862ab94f48dc081865d8223de1cf...8b9733b288a3daca0da04fe60e0b5a0ae8681362,176,0,36930,36930,116,2013-02-12 20:25:05,2013-02-12 20:25:05
8b9733b288a3daca0da04fe60e0b5a0ae8681362...8174705be8a78258a9167fab0800549978233b6c,1,13,13,26,3,2013-02-12 20:27:18,2013-02-12 20:27:18
8174705be8a78258a9167fab0800549978233b6c...e45f12ad427fddc9d9859fe86423bd49795d4f43,235,108,5772,5880,37,2013-02-12 20:44:41,2013-02-12 20:44:41
e45f12ad427fddc9d9859fe86423bd49795d4f43...b57c20a0572c56d629438e0a7c7371b3b57c4e8f,12,493,57,550,61,2013-02-13 19:48:22,2013-02-13 19:48:22
b57c20a0572c56d629438e0a7c7371b3b57c4e8f...96953c20724c200c1a5b53e6a991e24c821c8447,102,23,21179,21202,50,2013-02-13 20:30:56,2013-02-13 20:30:56
96953c20724c200c1a5b53e6a991e24c821c8447...d3c458c7d8f074c656c314d9b8904db5acbedbe3,1,2,2,4,2,2013-02-13 20:32:29,2013-02-13 20:32:29
d3c458c7d8f074c656c314d9b8904db5acbedbe3...2b05b335b070391e5be9d8580899cdac5daace46,1,16,11,27,8,2013-02-13 20:51:25,2013-02-13 20:51:25
2b05b335b070391e5be9d8580899cdac5daace46...0c1142f6fb28504eb2c7ed33d5cfb3355a8d7af4,2,4,3,7,3,2013-02-14 04:02:00,2013-02-14 04:01:36
0c1142f6fb28504eb2c7ed33d5cfb3355a8d7af4...b12ff91d482199ce64a6e2a39a0f1ba58d22de51,1,3,1,4,2,2013-02-14 06:01:34,2013-02-14 06:01:34
b12ff91d482199ce64a6e2a39a0f1ba58d22de51...d709dba284180679accb6e164686249bdf243211,11,474,364,838,28,2013-02-14 07:37:08,2013-02-14 07:37:08
d709dba284180679accb6e164686249bdf243211...5f0ecb740a71814c4b17bc2252a451548f329342,5,184,152,336,31,2013-02-14 08:23:23,2013-02-14 08:23:23
5f0ecb740a71814c4b17bc2252a451548f329342...7e6211e244fe0bc95ffa7327477b094b0bea836a,1,3,3,6,2,2013-02-14 08:39:32,2013-02-14 08:39:32
7e6211e244fe0bc95ffa7327477b094b0bea836a...6b14de292a53e00dc4fd9ef02b1d05dec391b613,2,32,22,54,6,2013-02-14 08:43:43,2013-02-14 08:43:43
6b14de292a53e00dc4fd9ef02b1d05dec391b613...edfee83ac2a012d23f42ac60a23a509004fc1be9,1,2,1,3,1,2013-02-15 00:17:16,2013-02-15 00:17:16
edfee83ac2a012d23f42ac60a23a509004fc1be9...0ff7fb0d050c4721dc0dfde8f267668ee586adc8,1,466,458,924,66,2013-02-15 00:43:50,2013-02-15 00:43:50
0ff7fb0d050c4721dc0dfde8f267668ee586adc8...37becbab8cf5c125df758a61ac4429eb8693d673,2,511,523,1034,97,2013-02-15 05:42:33,2013-02-15 05:42:33
37becbab8cf5c125df758a61ac4429eb8693d673...979ca4ea7a2e88fd9bbd8051259cd2803ca5088d,5,333,286,619,112,2013-02-15 06:33:26,2013-02-15 06:33:26
979ca4ea7a2e88fd9bbd8051259cd2803ca5088d...b1d4c589c5cb7b001a70423768e88a2548583eee,1,13,15,28,6,2013-02-15 06:57:25,2013-02-15 06:57:25
b1d4c589c5cb7b001a70423768e88a2548583eee...41ef649aa31745537674908d2f4d4f161f4867a5,1,1,1,2,1,2013-02-15 07:07:36,2013-02-15 07:07:36
41ef649aa31745537674908d2f4d4f161f4867a5...aa5f09037133f22093c4b97d15451d4e54180ba2,13,1087,1451,2538,50,2013-02-15 07:38:00,2013-02-15 07:38:00
1dda3c395a338e1342f7c4bfcdc708b525d22e1d...33a529f39885860d3c836d6eca5964988e626040,1,1,1,2,1,2013-02-14 21:26:52,2013-02-14 21:26:52
33a529f39885860d3c836d6eca5964988e626040...f273170f163b61b3e634a103b2c6da7dcec79bc3,1,1,1,2,1,2013-02-14 21:30:22,2013-02-14 21:30:22
1dda3c395a338e1342f7c4bfcdc708b525d22e1d...e8dc036d2522d586ae657d6102da0261c78e7e64,1,26,0,26,1,2013-02-12 02:23:21,2013-02-12 02:23:21
04aae2f56cca4438c90232b889fa5a6e1d78d223...6993fadf7ec217608653ec5c0d4434ad8d8b2eb7,5,84,53,137,29,2013-02-03 01:31:26,2013-02-03 01:31:26
6993fadf7ec217608653ec5c0d4434ad8d8b2eb7...3d74c670d329e2a21902cb8202ad044ee4ec5eed,2,238,236,474,6,2013-02-03 02:30:52,2013-02-03 02:30:52
3d74c670d329e2a21902cb8202ad044ee4ec5eed...5638b2559a042d8a89f352b03de60900229643ac,2,2,2,4,2,2013-02-03 02:50:13,2013-02-03 02:50:13
0a3e3a50fe78dab1ce6e2359a78b6aa5246e3c50...2c92b5f6a4ebc556034a16264c9ce499b1cdeb7a,1,0,2229,2229,1,2013-02-04 19:12:32,2013-02-04 19:12:32
2c92b5f6a4ebc556034a16264c9ce499b1cdeb7a...5c1cc722e7a91f8b0b386458e21ff471c577e495,1,0,2101,2101,1,2013-02-05 08:22:20,2013-02-05 08:22:20
5c1cc722e7a91f8b0b386458e21ff471c577e495...c09b994eea35da794b1905bf0a56485aeb28158a,4,63,58,121,18,2013-02-05 08:30:03,2013-02-05 08:30:03
c09b994eea35da794b1905bf0a56485aeb28158a...74c8a5611d64b2efd0b60774e184125ed4b5549f,5,65,191,256,40,2013-02-05 08:49:54,2013-02-05 08:49:54
74c8a5611d64b2efd0b60774e184125ed4b5549f...1f673b77bbe6f3a8400b901f8825edd1d4e33353,2,2,4,6,4,2013-02-05 08:51:19,2013-02-05 08:51:19
1f673b77bbe6f3a8400b901f8825edd1d4e33353...cf78f4b010b2b30bb973cf10f36a06105abe9370,2,6,24,30,8,2013-02-05 08:54:48,2013-02-05 08:54:48
cf78f4b010b2b30bb973cf10f36a06105abe9370...2576e6d1d6fe36fdec782a44bccf0d9ab239ef2b,2,20,14,34,12,2013-02-05 08:59:22,2013-02-05 08:59:22
2576e6d1d6fe36fdec782a44bccf0d9ab239ef2b...238566b4451e69c5558e0d48df7b02bfe871df6b,2,4,2,6,4,2013-02-05 09:01:23,2013-02-05 09:01:23
238566b4451e69c5558e0d48df7b02bfe871df6b...3949623eeee7315932f49cd13c5428241b690e9f,2,12,34,46,12,2013-02-05 09:07:43,2013-02-05 09:07:43
3949623eeee7315932f49cd13c5428241b690e9f...b65293dec022d88c2b1234b8385b0328547e3959,2,64,116,180,12,2013-02-05 09:11:41,2013-02-05 09:11:41
b65293dec022d88c2b1234b8385b0328547e3959...e4a74607b02f81e8007ac9903da1e6eddd8a5692,2,4,12,16,4,2013-02-05 09:12:39,2013-02-05 09:12:39
1bf070b4ce5ee40e4d248053d109c179bb42caf9...366e1e0a6d1442b8cf8546a27bac44a841b892a2,4,28,25,53,7,2013-02-08 04:13:40,2013-02-08 04:13:40
2fa77bf197050a385e479e1b2e8f61d634499505...beb60309d1dc312bbb69ace8c47764af783792bf,1,1,1,2,1,2013-02-06 11:17:48,2013-02-06 11:17:48
beb60309d1dc312bbb69ace8c47764af783792bf...60c9ff43649be2710e2896403908194c6721661b,1,2,2,4,2,2013-02-06 11:20:05,2013-02-06 11:20:05
d44acb7f886f6d501105c8cf9aab78aaeeab387c...e69912c163e64af91bdda623dce9cf84b7081eea,2,47,9,56,14,2013-01-31 21:00:22,2013-01-31 21:00:22
e69912c163e64af91bdda623dce9cf84b7081eea...24f0505bde5df08e9e7dd5b96bf0abeaab10901d,2,101,5,106,13,2013-02-01 03:39:26,2013-02-01 03:39:26
55120d124c6b9d0f43fa348963ecb67d79326fc2...c455d92f9e27b5845538e64ac354e544699ff82e,1,160,160,320,6,2013-06-24 03:27:05,2013-06-24 03:27:05
0b4668368bb3ffd7800e6cb7c49366d78b156167...8ca70bd83a92c0fdc1759b1d55b699e4162cf865,8,288,76,364,34,2013-02-06 10:07:40,2013-02-06 10:07:40
8ca70bd83a92c0fdc1759b1d55b699e4162cf865...cdb2147b132792dd29628055d0fd753ad6bf59a0,3,56,28,84,3,2013-02-08 03:00:48,2013-02-08 03:00:48
cdb2147b132792dd29628055d0fd753ad6bf59a0...a623b8c10f4293bd40a1e7c144b61fe374179826,6,132,91,223,17,2013-02-08 03:21:56,2013-02-08 03:21:56
a623b8c10f4293bd40a1e7c144b61fe374179826...b04acb37e830e1b1a299fab5d543b6ac0c70a1b0,5,38,43,81,22,2013-02-08 03:31:12,2013-02-08 03:31:12
b04acb37e830e1b1a299fab5d543b6ac0c70a1b0...cfa1e395103a8110e11b77917aa3896c99a0fd0e,2,0,2,2,2,2013-02-08 03:32:30,2013-02-08 03:32:30
cfa1e395103a8110e11b77917aa3896c99a0fd0e...9b1520ee60eb37f2078feb3a55b96207dccb674c,2,32,26,58,4,2013-02-08 03:34:06,2013-02-08 03:34:06
9b1520ee60eb37f2078feb3a55b96207dccb674c...52581839c732ef5b82b2fcb1a04e6e2a0dcbfcda,1,0,135,135,1,2013-02-08 03:34:23,2013-02-08 03:34:23
52581839c732ef5b82b2fcb1a04e6e2a0dcbfcda...a9729c5fd003abbfa0d1ab5bc318a069fd5b1382,4,4,4,8,4,2013-02-08 03:38:46,2013-02-08 03:38:46
6e0815bf4e09668ecd44d3c87634c2673dd52ee0...b83fc82aed64f961ba1397865ce29fe810d781ab,2,8,0,8,2,2013-03-04 02:19:31,2013-03-04 02:19:31
b83fc82aed64f961ba1397865ce29fe810d781ab...6239094ca67800b01274ebdae705dd720c75c80e,25,7,134,141,7,2013-03-04 03:40:47,2013-03-04 03:40:47
6239094ca67800b01274ebdae705dd720c75c80e...bfdc6f860710d434775982e1e47704c174314970,2,23,102,125,33,2013-03-04 07:31:09,2013-03-04 07:31:09
b38a13ef98bbdf33deb94462386ecffaea89b242...616cbf93d2ba2b21a72d81d2c9148a0f25e4810c,1,0,1,1,1,2012-01-28 22:47:59,2012-01-28 22:47:59
ab20c921df471f1101e37b2e7d39e81d01d11549...d96c0c781d49ae87b51221e4aefe025c2c1f3c5a,1,1,0,1,1,2012-01-28 22:20:27,2012-01-28 22:20:27
d96c0c781d49ae87b51221e4aefe025c2c1f3c5a...9db4f2a344ebf452b88ac4af0261192f3a8e9eb6,2,47,0,47,2,2012-01-28 22:30:45,2012-01-28 22:30:45
3c190908ca6d1bcc762bb22f7719fc951b51166f...a97b7ec3444d3aeff1e5bd6a533a57b87a684721,2,3,3,6,3,2015-03-04 09:41:15,2015-03-04 09:41:15
c1005f52839f56a49fea68cede63f29b35d77641...be68cdd4b82aa120e72dbd2f6e84c9e0e3160939,2,5,4,9,3,2015-03-03 05:45:38,2015-03-03 05:45:38
47ec330473977a437169d6904ff90ea553179cb1...f1cb639c3439d2cca006ebc28f05bc694c6c4ed2,1,1,1,2,1,2015-01-15 18:46:58,2015-01-15 18:46:58
c020669b07f348ad4f3155850bbd5952cc47696e...de491e914af50b205ce3a74c28df9f547cff36ca,4,12,4,16,4,2015-01-18 05:35:55,2015-01-18 05:35:55
73793637d1df450e9c8d07cf3760ba4eea2314a9...dea134d6eecc5e68244c67cd4f9237a493d95e8c,1,7,4,11,3,2013-04-23 06:01:11,2013-04-23 06:01:11
dea134d6eecc5e68244c67cd4f9237a493d95e8c...a4f896ef1a020edce1c5d3495deffc3bcd849f58,1,2,0,2,1,2013-04-23 06:02:57,2013-04-23 06:02:57
c3b9ac4676a72f19c9201972725ac524b875fffe...e0b9b86d32678b0675b11bf06ae5f8c6146decef,1,1,1,2,1,2013-05-04 00:38:58,2013-05-04 00:38:58
e60c07327b0b5d4ff6700b8848ba77c3040144d5...a956a3258b48e697666058889b3c0add591647a2,1,1,1,2,1,2013-04-20 19:23:27,2013-04-20 19:23:27
a956a3258b48e697666058889b3c0add591647a2...70f8d77012bea29b9544a14458450adb8fbd0a2c,1,1,1,2,1,2013-04-20 19:28:36,2013-04-20 19:28:36
70f8d77012bea29b9544a14458450adb8fbd0a2c...04d782efabb8648bdd67c2d0d164518c01d2603e,1,2,2,4,2,2013-04-20 19:29:12,2013-04-20 19:29:12
04d782efabb8648bdd67c2d0d164518c01d2603e...510c9a6ad87a1148fe59a7b8531d9b9e11b0ae17,2,54,32,86,17,2013-04-20 19:33:09,2013-04-20 19:33:09
510c9a6ad87a1148fe59a7b8531d9b9e11b0ae17...0c9b161bb889a5f47f7ef0752d90c41c9f957695,1,5,8,13,6,2013-04-20 22:32:16,2013-04-20 22:32:16
0c9b161bb889a5f47f7ef0752d90c41c9f957695...dc4436dbc9f328f4ad6ee391b6836b6c8d0324c2,3,6,11,17,6,2013-04-20 22:36:11,2013-04-20 22:36:11
dc4436dbc9f328f4ad6ee391b6836b6c8d0324c2...2d5ab9a2de88a5cb9c0e13d2c9024e8cc0719b4e,2,40,21,61,13,2013-04-20 22:47:07,2013-04-20 22:47:07
2d5ab9a2de88a5cb9c0e13d2c9024e8cc0719b4e...4b3a43e381c7c07b5a6f1ccaeb2c910ef2a93e0a,1,10,0,10,1,2013-04-20 22:54:44,2013-04-20 22:54:44
4b3a43e381c7c07b5a6f1ccaeb2c910ef2a93e0a...30d6e0530effef6379fb555491bc5064668f3359,2,22,0,22,3,2013-04-21 21:50:44,2013-04-21 21:50:44
30d6e0530effef6379fb555491bc5064668f3359...af63a4405decba82edc0b05fcd87890f859469bc,1,2,2,4,1,2013-04-22 01:25:49,2013-04-22 01:25:49
af63a4405decba82edc0b05fcd87890f859469bc...364f8330a159f9448833d88740e259219883d404,3,15,5,20,5,2013-04-22 01:29:06,2013-04-22 01:29:06
364f8330a159f9448833d88740e259219883d404...e0d60b1325591a347d9e49e44be6d77401b07749,13,49,49,98,43,2013-04-22 02:35:36,2013-04-22 02:35:36
8e59357bc56b57d1482847bff0706c12efb0039c...4c49458336f8bcc7ec7ebca5384e3430645e5fe8,1,0,1,1,1,2013-04-01 01:40:07,2013-04-01 01:40:07
7c3c5ed7cc07748d33989058d9e7eef11e367c28...bd69269426e16524757f1295d5c60263f36e2430,2,82,33,115,20,2013-03-30 20:09:56,2013-03-30 20:09:56
bd69269426e16524757f1295d5c60263f36e2430...9336a827c6396c2142be8de38615cd4d14c6685e,1,1,1,2,1,2013-03-30 20:11:15,2013-03-30 20:11:15
9336a827c6396c2142be8de38615cd4d14c6685e...e9dd1826be4e41c2464c95d9fbf62c8fd311b689,1,2,2,4,2,2013-03-30 20:12:03,2013-03-30 20:12:03
e9dd1826be4e41c2464c95d9fbf62c8fd311b689...171c7feae23227ac6c51b365614b63b266574232,2,16,12,28,10,2013-03-30 20:14:04,2013-03-30 20:14:04
171c7feae23227ac6c51b365614b63b266574232...62df38586a046064fcb93e26f7644801e8b4ca17,2,15,14,29,9,2013-03-30 20:16:34,2013-03-30 20:16:34
8d8f4e0cdda60172e2995cf2234ec1d272d14ae8...aee25786a73820b6c502ba099c55fb4008b4bd1e,10,132,17,149,28,2013-03-30 20:23:18,2013-03-30 20:23:18
aee25786a73820b6c502ba099c55fb4008b4bd1e...9fff2d3fb6a636c7ee61ad097c5b247e8def3ab5,11,256,36,292,21,2013-03-30 21:15:18,2013-03-30 21:15:18
9fff2d3fb6a636c7ee61ad097c5b247e8def3ab5...731903a17597f9095f9c26d969da8e04f50568ed,2,11,4,15,4,2013-03-30 21:16:30,2013-03-30 21:16:30
731903a17597f9095f9c26d969da8e04f50568ed...2a9604fdd297fee6661561d1ccf7922b4d599641,8,424,0,424,12,2013-03-30 23:07:50,2013-03-30 23:07:50
2a9604fdd297fee6661561d1ccf7922b4d599641...1683669eaa75555e1454105460ed6b7bcaca9f11,5,8,74,82,12,2013-03-30 23:56:49,2013-03-30 23:56:49
1683669eaa75555e1454105460ed6b7bcaca9f11...6edd5f291aba8f66816fe2ca1dfb61daeaab0efe,2,9,4,13,4,2013-03-31 00:00:11,2013-03-31 00:00:11
6edd5f291aba8f66816fe2ca1dfb61daeaab0efe...e560c41ed107cbaf00baf5082ffb18ac015afa4d,1,3,3,6,1,2013-03-31 00:06:59,2013-03-31 00:00:43
e560c41ed107cbaf00baf5082ffb18ac015afa4d...40f671a531a06facd0265b1d2c99453eb7e9dda8,3,61,12,73,7,2013-03-31 01:41:26,2013-03-31 01:41:26
954dcc0dc50212bc19a2789beb8d3c02214a198d...1e9be3644c51ec6b808728169a4d535062be2c5f,1,14,16,30,1,2013-03-26 19:31:03,2013-03-26 19:31:03
1e9be3644c51ec6b808728169a4d535062be2c5f...ca31f060a839b957ce3a85d3eaaaae09a78bbeb0,13,320,316,636,102,2013-03-27 00:12:17,2013-03-27 00:12:17
ca31f060a839b957ce3a85d3eaaaae09a78bbeb0...d5303906bd784619d8f2fa5a8244836056e5139d,5,17,81,98,16,2013-03-27 00:17:39,2013-03-27 00:17:39
71d4b5b6e7c5d1c5e3449f723de2fa7393c1a740...ef4898990ffd2d35d0e27b2e93b931a1f78e8ee7,1,14,21,35,1,2013-03-17 00:19:05,2013-03-17 00:19:05
ef4898990ffd2d35d0e27b2e93b931a1f78e8ee7...47f69c0d9e6136a2f8e6deec6093684a41969c85,1,1,3,4,1,2013-03-17 18:15:04,2013-03-17 18:15:04
47f69c0d9e6136a2f8e6deec6093684a41969c85...6012d8221b8e4f94c0cf842790ce70d868bb341a,5,64,62,126,37,2013-03-17 18:33:07,2013-03-17 18:33:07
6012d8221b8e4f94c0cf842790ce70d868bb341a...4aba489cfdc113682d2f1b18421eb58a229d66da,2,1,36,37,2,2013-03-17 18:34:27,2013-03-17 18:34:27
366e1e0a6d1442b8cf8546a27bac44a841b892a2...30fd4be093e09c639db005342a07f347eecf6a37,1,26,0,26,1,2013-02-08 06:08:04,2013-02-08 06:08:04
366e1e0a6d1442b8cf8546a27bac44a841b892a2...501aabf5723584eb0d1fba9569226f1b726a51b3,4,1,4,5,4,2013-02-08 05:42:34,2013-02-08 05:42:34
c8874ff2857bd2e0555dd2c43f50220c27827c9a...e3f3542d0b57fdcea0fbff2858b610f85a988d1d,5,9,3,12,5,2013-02-07 01:25:58,2013-02-07 01:25:58
5fe3de1cb34b8a0307ce3f095e8d08f3fc4bf871...9ed5b5e6534b45f29f318d983a7e09be1f7ac946,2,2,0,2,2,2013-06-25 12:34:57,2013-06-25 12:34:57
bfdc6f860710d434775982e1e47704c174314970...33913e4586dcd9bb08bb8daf4309f01ba4f7364a,1,1,1,2,1,2013-03-09 20:04:09,2013-03-09 20:04:09
bfdc6f860710d434775982e1e47704c174314970...d5c3307ffa95be37495418ea333eef9a6fb0e3b0,1,1,1,2,1,2013-03-08 00:13:56,2013-03-08 00:11:53
bfdc6f860710d434775982e1e47704c174314970...5054c17ab86948a4885c35165b0802e5e60d1ee6,9,57,57,114,37,2013-03-06 16:38:20,2013-03-06 16:38:20
bfdc6f860710d434775982e1e47704c174314970...ee5c7d7ece59f33108725979557d6b33850736ba,1,0,1,1,1,2013-03-04 19:03:05,2013-03-04 19:03:05
bfdc6f860710d434775982e1e47704c174314970...6e8ee02421ae41c42ca8dc986dc5c074510f0460,1,8,0,8,2,2013-03-04 07:41:16,2013-03-04 07:41:16
6e8ee02421ae41c42ca8dc986dc5c074510f0460...d219b8b96479f3390f37a6d14f1ee3fc12192221,6,16,19,35,10,2013-03-10 18:24:07,2013-03-10 18:24:07
29b1e86bf967e1cfbf869c0eed1a46655d8db126...6493cd22c0c72c60354ebbd6d7887bcbbf4e263a,2,11,10,21,5,2012-01-28 23:14:57,2012-01-28 23:14:57
9db4f2a344ebf452b88ac4af0261192f3a8e9eb6...7843a665fdc18c1199766d6c65f192209ec35741,3,18,1,19,5,2012-01-28 22:50:56,2012-01-28 22:50:56
a97b7ec3444d3aeff1e5bd6a533a57b87a684721...a884ce934980948fa723b2442803db697cc121c8,1,5,0,5,1,2015-03-05 14:39:47,2015-03-05 14:39:47
f1cb639c3439d2cca006ebc28f05bc694c6c4ed2...16089d92de03ba212882ad5082fc0d5e4da38ad6,1,7,3,10,3,2015-01-15 19:25:05,2015-01-15 19:23:09
f1cb639c3439d2cca006ebc28f05bc694c6c4ed2...bb479b8f4775507b5fe817b1724ccca335bc135c,1,1,0,1,1,2015-01-15 19:17:02,2015-01-15 19:17:02
f1cb639c3439d2cca006ebc28f05bc694c6c4ed2...7164d84953b86e3f896f74bf117abc699cdd0496,1,10,0,10,1,2015-01-15 19:10:02,2015-01-15 19:10:02
bf69fbdf1fb669eb077b641a63011c8f80b91421...22b79dae3c9307c329e6722ff1be8aa0a4143812,6,27,11,38,11,2015-01-18 20:22:43,2015-01-18 20:22:43
c81f0b5af23c7ef0edc41f941b217d4f0b841a7f...36ed570b7daba34931b3d788409f6b163f1d4ce8,1,1,1,2,1,2013-04-23 07:27:29,2013-04-23 07:27:29
36ed570b7daba34931b3d788409f6b163f1d4ce8...7ebfc170289b19260dae35c9e2965e600582174c,2,2,2,4,2,2013-04-23 07:30:22,2013-04-23 07:30:22
7ebfc170289b19260dae35c9e2965e600582174c...1b132ddcb484281d6d738e2058b0504b5bb5e126,27,27,27,54,27,2013-04-23 07:34:27,2013-04-23 07:34:27
1b132ddcb484281d6d738e2058b0504b5bb5e126...1a6dbc371e0ff445ba3fd613d073825715525b6c,17,17,17,34,17,2013-04-23 07:40:41,2013-04-23 07:40:41
e0d60b1325591a347d9e49e44be6d77401b07749...269b8aa7614b81789a4778c08b61ba8bc38a7fc2,2,2,2,4,2,2013-04-22 23:11:11,2013-04-22 23:11:11
4c49458336f8bcc7ec7ebca5384e3430645e5fe8...c69310153e5eec18f67df1df60c38ed807a75637,2,32,3,35,4,2013-04-01 02:26:40,2013-04-01 02:26:40
4c49458336f8bcc7ec7ebca5384e3430645e5fe8...d299ff4fce995543c29c0630d58d0a101c477b76,1,19,40,59,15,2013-04-01 01:47:02,2013-04-01 01:25:45
40f671a531a06facd0265b1d2c99453eb7e9dda8...a1587e2629a680e4636df88a05d58648f9904434,1,3,0,3,1,2013-03-31 13:12:02,2013-03-31 13:12:02
a1587e2629a680e4636df88a05d58648f9904434...74e06cb279db1ae297cf38c3c8d0e773fd04885d,1,24,0,24,1,2013-03-31 13:59:02,2013-03-31 13:59:02
40f671a531a06facd0265b1d2c99453eb7e9dda8...70ba9a880e55a4607c413671c99926f7bba9362e,1,0,1,1,1,2013-03-31 05:53:35,2013-03-31 05:53:35
70ba9a880e55a4607c413671c99926f7bba9362e...6c1ed5638b92b79c07a324268be204138812a048,1,2,1,3,1,2013-03-31 05:54:31,2013-03-31 05:54:31
6c1ed5638b92b79c07a324268be204138812a048...b96ab36d384752c42947297ce3a2d1f0ba941c0a,2,2,1,3,2,2013-03-31 18:24:31,2013-03-31 18:24:31
b96ab36d384752c42947297ce3a2d1f0ba941c0a...fc16e37aaa2764bfc9ae131d6f69bd59d8ac5858,4,7,10,17,8,2013-03-31 18:26:13,2013-03-31 18:26:13
d5303906bd784619d8f2fa5a8244836056e5139d...41c782567775d3bbcfc62d163ae22a531277b5e2,2,41,0,41,2,2013-03-29 16:17:03,2013-03-29 14:55:14
d5303906bd784619d8f2fa5a8244836056e5139d...5b298a2aaf5286564b1dc614bb439eb19edf2c25,7,34,22,56,24,2013-03-27 06:54:17,2013-03-27 06:54:17
5b298a2aaf5286564b1dc614bb439eb19edf2c25...f0f33eb9a3a25ae2f0032f630ff84c58cb0ca431,2,15,9,24,4,2013-03-27 22:42:11,2013-03-27 22:42:11
f0f33eb9a3a25ae2f0032f630ff84c58cb0ca431...6696ff5d927fd2d584ddc226521b89fc8b9882eb,1,1,1,2,1,2013-03-27 22:54:17,2013-03-27 22:54:17
5ac2f304a85bc9bfb8b0a23af60adb8c3a144509...0c25546e1c96aba47b981f3cb3cf7200d7405ead,1,29,29,58,3,2013-02-15 07:48:29,2013-02-15 07:48:29
0c25546e1c96aba47b981f3cb3cf7200d7405ead...bcb6dd5ee603d5f6681eb3483999e0dc366c5096,2,2,2,4,2,2013-02-15 07:51:35,2013-02-15 07:51:35
bcb6dd5ee603d5f6681eb3483999e0dc366c5096...e44f8cc560839cfd29f5b0e92ec66038705fbc74,1,6,6,12,2,2013-02-15 07:55:04,2013-02-15 07:55:04
e9951385b0507d2f28e332d7d5dcaea41b7e1d41...e46e63463ac7ea218e60ee9e5697a24f0f682528,1,1,1,2,1,2013-06-25 20:16:39,2013-06-25 20:16:39
e9951385b0507d2f28e332d7d5dcaea41b7e1d41...4be21c422a85b4b520349fac349667cec58bb89f,1,1,1,2,1,2013-06-25 20:09:24,2013-06-25 20:09:24
e9951385b0507d2f28e332d7d5dcaea41b7e1d41...83c4073ec76a4cc0d600b1c5fdb426d2adb69309,1,15,39,54,11,2013-06-25 19:23:56,2013-06-25 19:23:56
e9951385b0507d2f28e332d7d5dcaea41b7e1d41...abb112173e26c6785ee472ee3fa41bd06e16e1cc,1,5,0,5,1,2013-06-25 18:52:49,2013-06-25 18:52:49
abb112173e26c6785ee472ee3fa41bd06e16e1cc...30e5e89fac222d8e662b998134198dc8fb880411,1,5,0,5,1,2013-06-25 19:01:13,2013-06-25 19:01:13
30e5e89fac222d8e662b998134198dc8fb880411...0f0e7fc3769c70525f21d50988041534a8efcc81,1,1,1,2,1,2013-06-25 19:19:19,2013-06-25 19:19:19
0f0e7fc3769c70525f21d50988041534a8efcc81...a87ea9345beced2cea2009362c9aead9a2510e09,2,3,3,6,3,2013-06-25 19:59:34,2013-06-25 19:59:34
a87ea9345beced2cea2009362c9aead9a2510e09...fe25ebc2af03c9a81cb0f9879a49d387a6a2904e,1,1,1,2,1,2013-06-25 20:22:23,2013-06-25 20:22:23
e0a740ca9a431181275e9d6a97e77ec9b4127f40...086e8a5b3c2e442f525528db8e0c97425688f751,1,1,1,2,1,2013-03-10 23:07:52,2013-03-10 23:07:52
d0e1b56603a56abe94f99c30d94737dbe6ecae27...0c65a0e1eeffb0004eb2a36a977bfd25f7bf9c5a,1,5,0,5,1,2013-03-14 10:58:16,2013-03-14 10:58:16
d0e1b56603a56abe94f99c30d94737dbe6ecae27...e488e709a0869cf91b9af73cc03a7d7c00d59b5c,1,1,0,1,1,2013-03-12 20:58:41,2013-03-12 20:58:41
00169b48bd69ee0e203cfb557de99887811b924e...224296f6950ce0e5b00ba88aacf54fe4c638f14a,2,17,16,33,13,2013-03-14 20:29:43,2013-03-14 20:29:43
ea1c21d62d66b929be9fcdf389d4d5835c1e6546...b8a683d7f250a11d349a3e5de0d75ace9d67df0c,15,299,274,573,38,2012-01-28 23:42:07,2012-01-28 23:42:07
b8a683d7f250a11d349a3e5de0d75ace9d67df0c...22d52fca46c792c08bd316298c4dd85e52bf531f,1,11,6,17,4,2012-01-29 00:21:55,2012-01-29 00:21:55
dc74530fba5ba8fee19da7e53ad324718ac07a46...23e076c1bb73c4950d473cb36218937b2607bc13,15,1150,1022,2172,233,2012-01-28 23:09:23,2012-01-28 23:09:23
a97bfd630811796ee340d9a359fadfa0357de84c...2bb0ac38e19212365ddbae24d537463e6f7a2071,1,1,1,2,1,2015-03-05 23:44:55,2015-03-05 20:25:05
a97bfd630811796ee340d9a359fadfa0357de84c...c5a6f5a83177e839fe1596197387c1e7eac0f5d2,1,1,1,2,1,2015-03-05 22:28:15,2015-03-05 22:22:43
c5a6f5a83177e839fe1596197387c1e7eac0f5d2...f527ae575293cfe76c8094a7ac53915b5b1b3ed3,12,48,48,96,34,2015-03-05 22:28:15,2015-03-05 22:22:53
d8acd5f2a64168bd727371b994e4eff0663769cc...f31f6b9b2548a05e2cc63adad66f8bc8392d256a,1,1,1,2,1,2015-01-15 23:31:25,2015-01-15 23:31:25
49da7d80203544b4b7f613bb963338f7a48772af...716c869b899012db358c8e73456993a8864e9e22,3,7,7,14,3,2013-05-04 22:00:59,2013-05-04 22:00:59
b7dcefea83d6aa92c6f78d5fb84fa9a032bc3c7f...55bbb9ffd704353140cb1d42804ecd99f576f642,2,34,73,107,12,2013-04-22 13:34:23,2013-04-22 13:34:23
55bbb9ffd704353140cb1d42804ecd99f576f642...2eb9053d4af064d0b4ca760a2a0c023070709c27,1,11,0,11,1,2013-04-24 12:38:43,2013-04-20 04:28:50
2eb9053d4af064d0b4ca760a2a0c023070709c27...dd7249c0f15b29cd9648740ea4729f920eeb5624,1,21,5,26,2,2013-04-24 12:38:44,2013-04-21 06:52:32
dd7249c0f15b29cd9648740ea4729f920eeb5624...67fdb275188f7e72416ba20eee42e55190bd78a2,1,7,20,27,3,2013-04-24 12:38:44,2013-04-22 07:10:59
67fdb275188f7e72416ba20eee42e55190bd78a2...ec7f2cf2b6c24884eb107b31f1046ec466ff5fbf,4,4,4,8,4,2013-04-24 12:38:46,2013-04-22 07:19:56
ec7f2cf2b6c24884eb107b31f1046ec466ff5fbf...159105dad3def1fafdccee77c11947dce3d6db09,2,2,2,4,2,2013-04-24 12:38:46,2013-04-22 23:11:11
159105dad3def1fafdccee77c11947dce3d6db09...da4a08754af8ad33a808d610b3cc8b897e79925c,1,7,4,11,3,2013-04-24 12:38:47,2013-04-23 06:01:11
da4a08754af8ad33a808d610b3cc8b897e79925c...8a3b212043d87eb918584b44022c9eeb486a91a8,1,2,0,2,1,2013-04-24 12:38:48,2013-04-23 06:02:57
8a3b212043d87eb918584b44022c9eeb486a91a8...75ccaadae0159e1462395ca44400baa8e81b994f,1,1,1,2,1,2013-04-24 12:38:49,2013-04-23 07:27:29
75ccaadae0159e1462395ca44400baa8e81b994f...22a1a7273a4de67eb3b167b764cd79a6f3bf8568,2,2,2,4,2,2013-04-24 12:38:49,2013-04-23 07:30:22
22a1a7273a4de67eb3b167b764cd79a6f3bf8568...f40ea21a6cd147128c22707de8f75c371d592acf,27,27,27,54,27,2013-04-24 12:38:50,2013-04-23 07:34:27
f40ea21a6cd147128c22707de8f75c371d592acf...8311ad513f4300ddc3360305d2831c6310f1b71a,17,17,17,34,17,2013-04-24 12:38:51,2013-04-23 07:40:41
8311ad513f4300ddc3360305d2831c6310f1b71a...270db6f55e4c86b0375e32fa3d6eba4038aa15fb,1,23,10,33,10,2013-04-24 12:38:53,2013-04-24 11:54:17
3365d4a06ab966ffb0b83578c647fa4284aac5f5...0fbfa167e1e6ab8321f32fd050b655e8ccc8e467,1,2,2,4,2,2013-04-01 02:55:05,2013-04-01 02:55:05
0fbfa167e1e6ab8321f32fd050b655e8ccc8e467...2f8deea95ac246455a11511963ded2b63e963922,4,27,0,27,5,2013-04-01 05:22:52,2013-04-01 05:22:52
2f8deea95ac246455a11511963ded2b63e963922...d8b3e48e1450bc0c49548c6cbd1139f7910b1c00,1,11,1,12,2,2013-04-01 05:58:01,2013-04-01 05:58:01
d8b3e48e1450bc0c49548c6cbd1139f7910b1c00...9df6dc81b57cb710c1e623c4e06c39954fc82280,2,76,0,76,2,2013-04-01 07:02:51,2013-04-01 07:02:51
9df6dc81b57cb710c1e623c4e06c39954fc82280...7bee10a5ef240cd6dc738998b8ff64dd75df3804,1,358,0,358,1,2013-04-01 07:11:47,2013-04-01 07:11:47
7bee10a5ef240cd6dc738998b8ff64dd75df3804...19d5e616685cc0ad72c216e04a69758bf0ed67bf,2,27,16,43,11,2013-04-01 07:34:58,2013-04-01 07:34:58
fc16e37aaa2764bfc9ae131d6f69bd59d8ac5858...b018513aa51c021cee706c71921a80012ff79f64,1,1,1,2,1,2013-03-31 18:58:00,2013-03-31 18:58:00
6696ff5d927fd2d584ddc226521b89fc8b9882eb...090545ffdf8b8f750afb0601a16a7bbac07ff6eb,2,8,0,8,2,2013-03-28 10:33:18,2013-03-28 10:33:18
6696ff5d927fd2d584ddc226521b89fc8b9882eb...fe414d8566f647e65dc20bc7505630ce798e5445,5,86,15,101,22,2013-03-28 06:33:45,2013-03-28 06:33:45
fe414d8566f647e65dc20bc7505630ce798e5445...081c061281c96818bf9a904a7e5e2a673aa7a54d,7,229,282,511,114,2013-03-28 07:21:21,2013-03-28 07:21:21
081c061281c96818bf9a904a7e5e2a673aa7a54d...4b8b8d2e46e25820d190db957b4e837b66198f72,12,6520,6963,13483,31,2013-03-28 08:08:14,2013-03-28 08:08:14
4b8b8d2e46e25820d190db957b4e837b66198f72...ba46d859e37786de82b38415f5ce1b6dce18f9eb,1,0,11,11,2,2013-03-28 08:12:07,2013-03-28 08:12:07
ba46d859e37786de82b38415f5ce1b6dce18f9eb...df35e261421f84494b18a617322610bb9ae2a61c,2,206,193,399,14,2013-03-28 08:34:42,2013-03-28 08:34:42
df35e261421f84494b18a617322610bb9ae2a61c...3278c40631c6914f063b2eef551c668abb98c9ff,4,162,206,368,62,2013-03-28 10:06:00,2013-03-28 10:06:00
3278c40631c6914f063b2eef551c668abb98c9ff...384926a1d6be158ce6879bdd299f90e3c43a77ed,1,0,7,7,1,2013-03-29 00:19:41,2013-03-29 00:19:41
384926a1d6be158ce6879bdd299f90e3c43a77ed...e25ad912e2fa341244125288ef674d4b93161a7f,1,1,2,3,1,2013-03-29 00:20:17,2013-03-29 00:20:17
e25ad912e2fa341244125288ef674d4b93161a7f...3055f09a902cb26b01701fe41db0e8ec35d90a61,1,5,4,9,5,2013-03-29 17:45:00,2013-03-29 17:45:00
3055f09a902cb26b01701fe41db0e8ec35d90a61...d3fe506f046d54945e46abcf7668cf7105b0a684,1,7,1,8,5,2013-03-29 20:43:30,2013-03-29 20:43:30
d3fe506f046d54945e46abcf7668cf7105b0a684...2ebc060795aad6b64923d65426858b6e90cb2131,1,2,2,4,2,2013-03-29 20:43:37,2013-03-29 20:43:37
2ebc060795aad6b64923d65426858b6e90cb2131...9f59648702787dd6622e63d3103c815adfb44526,1,8,3,11,3,2013-03-29 21:04:11,2013-03-29 21:04:11
e44f8cc560839cfd29f5b0e92ec66038705fbc74...a77cd6cb5d42a9474a5b3da8b012065a681c0a81,1,1,1,2,1,2013-02-15 10:47:34,2013-02-15 10:47:34
03e67e44f9dfa95659ef904ad341d2301a43d82a...327a951ca3754285432ae97b6c6be62dcd815905,2,11,7,18,3,2013-06-25 20:32:21,2013-06-25 20:32:21
d8234b38cbc055f8dc18ba583df153d6c8f74ace...b5eca07be1fcb7cbfc4108d409f826e93af706cc,1,5,5,10,3,2013-03-15 01:23:08,2013-03-15 01:23:08
b5eca07be1fcb7cbfc4108d409f826e93af706cc...3cd6d00cc42c94167d03a56122fbf93d8e1130b0,1,1,1,2,1,2013-03-15 01:53:46,2013-03-15 01:53:46
3cd6d00cc42c94167d03a56122fbf93d8e1130b0...85e5d400995a89be16f5a350a9aa12f2d6a332a9,1,1,1,2,1,2013-03-15 01:54:43,2013-03-15 01:54:43
5b04985722a1b1637e85e35f74b1386a37af4dba...dd533aaaf0c4d7162d5746948b02b9c710a1df66,1,2,0,2,1,2013-04-09 17:16:37,2013-04-09 17:16:37
dd533aaaf0c4d7162d5746948b02b9c710a1df66...1a546278b93a08817152736247469c1155ae3ae2,1,26,25,51,3,2013-04-09 17:20:50,2013-04-09 17:20:50
1a546278b93a08817152736247469c1155ae3ae2...24f8d9e1374d88f852402f71de0f728d1e8d62ed,4,23,60,83,6,2013-04-09 17:43:37,2013-04-09 17:43:37
bd789ed158f4f8a5f4f9bab137e65d1b8cb29a28...09b97a3b95d3ab37e86461c71a75dbeb4fab7e91,1,1066,327,1393,1161,2013-04-08 12:46:12,2013-04-08 12:46:12
22d52fca46c792c08bd316298c4dd85e52bf531f...49d565a6da38359a776f83f31a1f1ccd658c88a7,4,34,23,57,6,2012-01-29 21:15:37,2012-01-29 21:15:37
22d52fca46c792c08bd316298c4dd85e52bf531f...475b985a0efaf534b56089f12c570d7861ce72f5,2,8,0,8,2,2012-01-29 00:37:43,2012-01-29 00:37:43
475b985a0efaf534b56089f12c570d7861ce72f5...06df91ac559686e947c3c1fbfbdd2b7dcfc5a56b,2,4,8,12,4,2012-01-29 00:48:03,2012-01-29 00:48:03
06df91ac559686e947c3c1fbfbdd2b7dcfc5a56b...4fa931e403ec3ae2f8f7f690c6c4040365f68ba9,9,210,154,364,39,2012-01-29 02:11:31,2012-01-29 02:11:31
4fa931e403ec3ae2f8f7f690c6c4040365f68ba9...e532228721734492d6f2741f729525cc1bb3c77c,2,33,36,69,30,2012-01-29 02:25:05,2012-01-29 02:25:05
e532228721734492d6f2741f729525cc1bb3c77c...e17c9249d2bef78355711ce305e1a8d36bd75c3e,1,1,1,2,1,2012-01-29 02:27:09,2012-01-29 02:27:09
e17c9249d2bef78355711ce305e1a8d36bd75c3e...99ac6ca08ed27126d2ad1dd4d0e820205aab9c48,4,58,12,70,8,2012-01-29 02:39:36,2012-01-29 02:39:36
99ac6ca08ed27126d2ad1dd4d0e820205aab9c48...cf1b46bda4853e8501c2b9587219535376a9cc36,2,2,0,2,2,2012-01-29 02:46:41,2012-01-29 02:46:41
cf1b46bda4853e8501c2b9587219535376a9cc36...3e462f1fb27b3ca97135948dc74ccef55336c8bb,1,0,30,30,2,2012-01-29 04:26:27,2012-01-29 04:26:27
3e462f1fb27b3ca97135948dc74ccef55336c8bb...5f314dcb85b011d30bbe845e00932a9a550d4e71,2,0,24,24,2,2012-01-29 04:27:18,2012-01-29 04:27:18
5f314dcb85b011d30bbe845e00932a9a550d4e71...f1e520badd51d01ebcd33758966ef868e5cdd1c2,4,4,4,8,4,2012-01-29 04:34:07,2012-01-29 04:34:07
f1e520badd51d01ebcd33758966ef868e5cdd1c2...59d9983ebcc889b5e5626d672311e92657bfe3e8,5,15,5,20,7,2012-01-29 06:03:14,2012-01-29 06:03:14
01aa0d840ab4a5a193ebf37446adee79fa81e5ee...872e56fcf2a7bb1ec936d9e0a5dfed8d31f87590,2,31,3,34,4,2015-03-06 14:58:48,2015-03-06 11:05:30
872e56fcf2a7bb1ec936d9e0a5dfed8d31f87590...5c8d56d515da49b2051743fa0bacba79967778c2,1,1,2,3,2,2015-03-07 02:10:53,2015-03-06 15:01:12
01aa0d840ab4a5a193ebf37446adee79fa81e5ee...69bcc49410fadb40010e77b60a9a5875204d68ba,2,95,41,136,27,2015-03-06 12:21:37,2015-02-10 06:11:35
1fc0d2c0f1a226ea77ddf0e2d1026518e713d537...57ba494409f91f63b1b1a6ac3d2e74da9635135e,3,25,15,40,14,2013-04-26 17:44:44,2013-04-26 17:44:44
716c869b899012db358c8e73456993a8864e9e22...f06294d80f7a8dd0752837aab3ed5fca17d3d9be,2,3,2,5,2,2013-05-07 17:33:41,2013-05-07 17:33:41
716c869b899012db358c8e73456993a8864e9e22...01d0cf22abb5345548b01e2e48310057d234b234,5,306,0,306,4,2013-05-06 13:58:18,2013-05-06 13:58:04
716c869b899012db358c8e73456993a8864e9e22...240305321f3923f2fe127807b57fe9867a86d410,1,17,17,34,2,2013-05-06 07:48:05,2013-05-06 07:48:05
19d5e616685cc0ad72c216e04a69758bf0ed67bf...c231dba7ee23bd72f3a158caaf66bb882b8eb2d5,1,1,1,2,1,2013-04-01 18:10:56,2013-04-01 18:10:56
c231dba7ee23bd72f3a158caaf66bb882b8eb2d5...93db7c2c74d67e946276f635094c4e997839ee97,2,9,9,18,8,2013-04-01 18:14:11,2013-04-01 18:14:11
93db7c2c74d67e946276f635094c4e997839ee97...e6d6fcffb0491534201e23867fffdc53b4568fab,1,4,4,8,4,2013-04-01 19:09:49,2013-04-01 19:09:49
e6d6fcffb0491534201e23867fffdc53b4568fab...a0726e605f0fdf5bbe83c149b18b4b238dbc61d8,1,2,2,4,2,2013-04-01 19:10:53,2013-04-01 19:10:53
a0726e605f0fdf5bbe83c149b18b4b238dbc61d8...eac987c0d2bdb93ea4c916d52f38655bcc5e1255,3,67,8,75,5,2013-04-01 19:55:48,2013-04-01 19:55:48
eac987c0d2bdb93ea4c916d52f38655bcc5e1255...292734d7f34b59152c66ade7490d18036dee7bb7,5,16,6,22,7,2013-04-01 20:14:39,2013-04-01 20:14:39
19d5e616685cc0ad72c216e04a69758bf0ed67bf...e183dd46a20daa725fe5ad7acb5313d7b20db6f1,2,3,2,5,2,2013-04-01 13:27:49,2013-04-01 13:27:49
e183dd46a20daa725fe5ad7acb5313d7b20db6f1...1816483baa9de59dc1ea0cec67fcbd00b28c6b79,1,6,0,6,1,2013-04-01 13:29:43,2013-04-01 13:29:43
1816483baa9de59dc1ea0cec67fcbd00b28c6b79...89bbeec898c07a191e9f1a696e9061278e4da9f2,1,1,37,38,4,2013-04-01 16:58:40,2013-04-01 16:58:40
42b69349302247955bca111b59865117359a9720...a2145df7c42bfc503437c51c7975727a829a7fae,1,4,0,4,1,2013-03-31 18:58:25,2013-03-31 18:58:25
a2145df7c42bfc503437c51c7975727a829a7fae...674768b1775a135a4ed66f299795d8221dc89982,2,30,30,60,30,2013-03-31 19:00:04,2013-03-31 19:00:04
674768b1775a135a4ed66f299795d8221dc89982...5c601e7ac24f916e31c7506e07f0a34b8442eba0,2,6,4,10,5,2013-03-31 19:16:16,2013-03-31 19:16:16
5c601e7ac24f916e31c7506e07f0a34b8442eba0...388a4c878db2a41d15f438632463dafb65e6e748,2,6,12,18,7,2013-03-31 20:20:54,2013-03-31 20:20:54
388a4c878db2a41d15f438632463dafb65e6e748...c5042e050e4f55f90ffa7ee28c84892e798f964f,2,4,4,8,4,2013-04-01 00:17:10,2013-04-01 00:17:10
c5042e050e4f55f90ffa7ee28c84892e798f964f...b56371b145678c1192bfb867b41dbdb8727327d5,1,1,1,2,1,2013-04-01 00:17:25,2013-04-01 00:17:25
b56371b145678c1192bfb867b41dbdb8727327d5...cf843c5cadb125eb639f4e63cf892518b2db9ac5,2,12,12,24,5,2013-04-01 00:18:07,2013-04-01 00:18:07
cf843c5cadb125eb639f4e63cf892518b2db9ac5...6b23a66c29c3613c6792a257aafa949c81746597,4,13,13,26,8,2013-04-01 00:19:12,2013-04-01 00:19:12
6b23a66c29c3613c6792a257aafa949c81746597...f2e5c3293644917161a2f01c877b817ea58c2631,2,2,2,4,2,2013-04-01 00:19:47,2013-04-01 00:19:47
f2e5c3293644917161a2f01c877b817ea58c2631...996ec4ca69a7f9ff2a5697356605f2d5b621ebe0,2,5,5,10,4,2013-04-01 00:20:16,2013-04-01 00:20:16
996ec4ca69a7f9ff2a5697356605f2d5b621ebe0...d5fa1d80bb040aac32caed8fa1c97eb1b3e1abfe,4,7,7,14,6,2013-04-01 00:22:12,2013-04-01 00:22:12
d5fa1d80bb040aac32caed8fa1c97eb1b3e1abfe...626189dbfcfc6edf2df151a332f2c1260823ab70,4,25,25,50,21,2013-04-01 00:24:06,2013-04-01 00:24:06
626189dbfcfc6edf2df151a332f2c1260823ab70...52e414830280118cd6c5dd5f39d24e02dc82b267,1,3,0,3,3,2013-04-01 00:25:27,2013-04-01 00:25:27
52e414830280118cd6c5dd5f39d24e02dc82b267...376bd20b3a8714546c87676a6cc87ed1f85e7c90,2,3,3,6,2,2013-04-01 00:25:52,2013-04-01 00:25:52
376bd20b3a8714546c87676a6cc87ed1f85e7c90...d6f37f3c568ed70a7e20fdaa5429501d5af406a7,5,7,7,14,5,2013-04-01 00:27:22,2013-04-01 00:27:22
d6f37f3c568ed70a7e20fdaa5429501d5af406a7...b7fa0d343446d394535063aca72fa6d7fdd1396f,4,10,10,20,8,2013-04-01 00:29:05,2013-04-01 00:29:05
b7fa0d343446d394535063aca72fa6d7fdd1396f...8b9d488377ab9ef10544e53620e0f082d310684e,2,19,19,38,12,2013-04-01 00:32:45,2013-04-01 00:32:45
8b9d488377ab9ef10544e53620e0f082d310684e...896ee794731f1159bfab247b12914caa1eb21850,2,6,10,16,6,2013-04-01 00:33:55,2013-04-01 00:33:55
896ee794731f1159bfab247b12914caa1eb21850...0441bbba429e9e030427757265b3f99dbd9119c5,2,12,12,24,9,2013-04-01 00:36:23,2013-04-01 00:36:23
0441bbba429e9e030427757265b3f99dbd9119c5...4cbefa117995b61444da9adf19bdd7761d2f55fd,1,0,4,4,1,2013-04-01 00:37:28,2013-04-01 00:37:28
4cbefa117995b61444da9adf19bdd7761d2f55fd...db284a97d6b0d6eb20c3b6724440cbd26b80ccbd,3,44,45,89,21,2013-04-01 00:56:31,2013-04-01 00:56:31
4ce9203f2ce61794e01f9a4d1b875befb83e3c95...f36709067172f8f0f663f58917429667fd04035b,1,1,1,2,1,2013-03-30 05:38:25,2013-03-30 05:38:25
f36709067172f8f0f663f58917429667fd04035b...4dfc4e102262f79a7048b2713ff5adea85ffec8b,1,9,1,10,2,2013-03-30 05:40:42,2013-03-30 05:40:42
4dfc4e102262f79a7048b2713ff5adea85ffec8b...23d7215dbe6f075436fd13ef5376419143a079f5,4,7,7,14,7,2013-03-30 06:32:47,2013-03-30 06:32:47
23d7215dbe6f075436fd13ef5376419143a079f5...88141252595b3875ac001741aa77c7905aac942c,4,109,142,251,36,2013-03-30 06:33:08,2013-03-30 06:33:08
88141252595b3875ac001741aa77c7905aac942c...21d6a5933a75e39e2412a91a891722ba36ce3254,1,1,1,2,1,2013-03-30 06:37:43,2013-03-30 06:37:43
21d6a5933a75e39e2412a91a891722ba36ce3254...3359b8d5f650c2d2f44511cf4483e64e140db2ad,1,1,1,2,1,2013-03-30 06:37:55,2013-03-30 06:37:55
3359b8d5f650c2d2f44511cf4483e64e140db2ad...601013ca04d6374362c12af5dc48b8c1d44b93cc,8,16,28,44,16,2013-03-30 07:11:38,2013-03-30 07:11:38
601013ca04d6374362c12af5dc48b8c1d44b93cc...49ebf542a29216c55d48306b58bd232506d67154,2,176,167,343,10,2013-03-30 07:19:05,2013-03-30 07:19:05
49ebf542a29216c55d48306b58bd232506d67154...361c776e2b4a143ce1332ac2ceab78325189a197,1,1204,1207,2411,112,2013-03-30 07:27:50,2013-03-30 07:27:50
361c776e2b4a143ce1332ac2ceab78325189a197...af470f4c7be5b6e5f2fba5966f890ddfa89c966d,2,1721,1694,3415,169,2013-03-30 08:06:50,2013-03-30 08:06:50
af470f4c7be5b6e5f2fba5966f890ddfa89c966d...1dcadede361e7f0dba8ad83b4a07171d0e39f3f4,1,38,38,76,30,2013-03-30 08:09:30,2013-03-30 08:09:30
64ae9e5bd87af6e5d2b5b40941a2185cc3b60722...866c8d60e966683af221af722df3f2f97ed2b16b,1,632,724,1356,102,2013-02-15 20:22:26,2013-02-15 20:22:26
866c8d60e966683af221af722df3f2f97ed2b16b...6789a30a3d4f184b02cd5c686309aa7bd547ea4c,1,1,1,2,1,2013-02-16 00:51:16,2013-02-16 00:51:16
6789a30a3d4f184b02cd5c686309aa7bd547ea4c...3d041096ba995c4ae8422a9a8491b77d0d4460fe,2,29,24,53,21,2013-02-16 01:21:41,2013-02-16 01:21:41
3d041096ba995c4ae8422a9a8491b77d0d4460fe...d1aae5f82bade48104da2ade7d94b22881840859,2,3,2,5,2,2013-02-16 01:27:05,2013-02-16 01:27:05
d1aae5f82bade48104da2ade7d94b22881840859...f38e50cdf146fb99f0f0178e7ea7f636544d7ce2,3,28,22,50,10,2013-02-16 08:19:17,2013-02-16 08:19:17
f38e50cdf146fb99f0f0178e7ea7f636544d7ce2...b688d8dcd4f55fffa567597f4bd9b974ec9546e6,1,1,1,2,1,2013-02-16 08:20:20,2013-02-16 08:20:20
b688d8dcd4f55fffa567597f4bd9b974ec9546e6...d8e2668c1df122f61e82008821bc6b56def4fe12,5,89,116,205,39,2013-02-16 09:22:15,2013-02-16 09:22:15
d8e2668c1df122f61e82008821bc6b56def4fe12...ce21926704778a2fb8ff76f5241b90a97abeea4c,9,273,273,546,44,2013-02-16 09:26:43,2013-02-16 09:26:43
ce21926704778a2fb8ff76f5241b90a97abeea4c...b6ec72a3a2d0e060ac60bfff5572a3d4bdc51c2b,3,0,0,0,0,2013-02-16 09:38:32,2013-02-16 09:38:32
b6ec72a3a2d0e060ac60bfff5572a3d4bdc51c2b...401d4fabd16113c2e612c2c6bc2969f0d26150df,1,0,981,981,1,2013-02-16 09:39:09,2013-02-16 09:39:09
401d4fabd16113c2e612c2c6bc2969f0d26150df...e74fb390806a6b9a8aeb1686877e94142b4d45cb,1,0,163,163,1,2013-02-16 09:43:23,2013-02-16 09:43:23
e74fb390806a6b9a8aeb1686877e94142b4d45cb...6d048471c47ed740453c01252ad62a42e185cb46,4,144,60,204,35,2013-02-16 10:47:15,2013-02-16 10:47:15
6d048471c47ed740453c01252ad62a42e185cb46...6dce3f63d8461623b110c1a2e3b6d62ccc0e3e21,2,0,4,4,4,2013-02-16 10:47:48,2013-02-16 10:47:48
6dce3f63d8461623b110c1a2e3b6d62ccc0e3e21...5fecb4a9f40cc6d5af9e766ec6999dd9174f226c,1,1,0,1,1,2013-02-16 10:49:12,2013-02-16 10:49:12
5fecb4a9f40cc6d5af9e766ec6999dd9174f226c...fdeb7f574385094da8b656e4cfef43de23c12f90,1,1,0,1,1,2013-02-17 21:35:08,2013-02-17 21:35:08
fdeb7f574385094da8b656e4cfef43de23c12f90...6ccf588a8e08a9f99e6a56f9201a4348eb946cde,4,225,8,233,10,2013-02-17 21:35:14,2013-02-17 21:35:14
6ccf588a8e08a9f99e6a56f9201a4348eb946cde...e2fabe2317cedb9cbee878e26ce740acd1df38a5,1,2,2,4,2,2013-02-17 21:42:31,2013-02-17 21:42:31
e2fabe2317cedb9cbee878e26ce740acd1df38a5...077b70112f50204bda57da3590633cb5ab1fdc20,1,2,0,2,1,2013-02-17 21:54:47,2013-02-17 21:54:47
211d6831fc8494123216f66aaa287b712e044c76...1bb159aa6f3ed2ea1adf73b287eb1c64e017292b,1,0,1,1,1,2013-06-25 21:53:48,2013-06-25 21:53:48
211d6831fc8494123216f66aaa287b712e044c76...9b97d63188538a387adcca1ae26f772c909d69dc,1,0,2,2,1,2013-06-25 21:48:57,2013-06-25 21:48:57
211d6831fc8494123216f66aaa287b712e044c76...f00c885d4ce1c36755aee64ee517b0dbb3ab52b3,1,15,2,17,3,2013-06-25 21:12:36,2013-06-25 21:12:36
f00c885d4ce1c36755aee64ee517b0dbb3ab52b3...b4e0e4fee65fb50f7981d28bb875083e0da1a303,6,82,51,133,44,2013-06-26 13:59:33,2013-06-26 13:59:33
85e5d400995a89be16f5a350a9aa12f2d6a332a9...706dd8c045152bd4fe02450df13d5ae066eb07d7,1,13,12,25,2,2013-03-15 02:11:37,2013-03-15 02:11:37
85e5d400995a89be16f5a350a9aa12f2d6a332a9...8f20a5ac910cf4db50a538662fb1809e3a002446,2,4,13,17,2,2013-03-15 02:05:54,2013-03-15 02:05:54
8f20a5ac910cf4db50a538662fb1809e3a002446...45606ae6a0c6517076260b7955f860c5be0f56f3,1,1,1,2,1,2013-03-15 02:06:47,2013-03-15 02:06:47
45606ae6a0c6517076260b7955f860c5be0f56f3...c9bfcfcfd5c944352b9ed1c9ba2043191cb3fb60,2,1,1,2,1,2013-03-15 02:08:09,2013-03-15 02:08:09
c9bfcfcfd5c944352b9ed1c9ba2043191cb3fb60...2b9c936a3a01facf03bc51353812dbe01251c4fa,1,9,2,11,2,2013-03-15 02:19:06,2013-03-15 02:19:06
070c77a960816de50adc62d2a65c57ec5620fc2a...7e933db2dd3409f2107518d8700581a0be1c9392,1,1,1,2,1,2013-03-16 22:03:22,2013-03-16 22:03:22
7e933db2dd3409f2107518d8700581a0be1c9392...fe2658ed6154b7b2be71f6582671ee13ebb59dc5,2,42,0,42,9,2013-03-16 22:31:03,2013-03-16 22:31:03
fe2658ed6154b7b2be71f6582671ee13ebb59dc5...68dfd322f42d7891cc6e41bce99bfb6cd89e1834,2,8,0,8,2,2013-03-16 23:17:32,2013-03-16 23:17:32
24f8d9e1374d88f852402f71de0f728d1e8d62ed...ece78ff086cab6c1a4381f108acd108be4d5b560,1,8,8,16,8,2013-04-09 22:04:44,2013-04-09 22:04:44
910e78d26ad476d11331e8bb9b0233e0b2ba21e3...2696c6a4bd5eaea9de1d447da8f24da5cb3f74bd,1,4,4,8,2,2012-01-29 21:20:39,2012-01-29 21:20:39
59d9983ebcc889b5e5626d672311e92657bfe3e8...af9de238fd335d10d5d1df079419fde9aedd3cc9,4,36,38,74,16,2012-01-29 06:48:51,2012-01-29 06:48:51
59d9983ebcc889b5e5626d672311e92657bfe3e8...487dbfdda4692e3212f13d5e6282d7818b4c9934,5,58,66,124,50,2012-01-29 06:14:51,2012-01-29 06:14:51
487dbfdda4692e3212f13d5e6282d7818b4c9934...62f4a1571a3801c867b80c228464cc9c695f1d13,6,46,28,74,32,2012-01-29 06:48:25,2012-01-29 06:48:25
57ba494409f91f63b1b1a6ac3d2e74da9635135e...8ae9c6ab34128ea863343abaeff39ca7c6f4618c,2,4,6,10,6,2013-04-27 06:14:06,2013-04-27 06:13:04
57ba494409f91f63b1b1a6ac3d2e74da9635135e...aa146582d6e4f23a36edf9bddb1570d16cd61f34,2,43,20,63,4,2013-04-27 03:51:48,2013-04-27 03:51:48
79dac4b77ad97176d8124b63949d9226d60cea9d...ad5f88e1c5384d8312655298dcff429253ad2d9c,1,1,1,2,2,2013-05-08 01:03:32,2013-05-08 01:03:32
b352f98f325adbd994f01cb94f4d0a454783bbce...739ef39050c0a9f59b726eb9b0ac5a3ba96aba00,1,1,1,2,1,2013-05-07 12:20:28,2013-05-07 12:20:28
12f043f1bb126d48b6e57eebbfdf12c94e131fb5...7e31bea11410f9c1838aeabcb97ad802b69b658c,1,4,0,4,1,2013-04-01 20:25:51,2013-04-01 20:25:51
1dcadede361e7f0dba8ad83b4a07171d0e39f3f4...501dfbe8aead9fbc50680de39400f1f1d1ff388f,1,2,2,4,2,2013-03-30 14:10:51,2013-03-30 14:10:51
1dcadede361e7f0dba8ad83b4a07171d0e39f3f4...a4901e2da8011aa60fbf3d02187f7392297043fb,1,3,2,5,3,2013-03-30 08:55:39,2013-03-30 08:55:39
077b70112f50204bda57da3590633cb5ab1fdc20...4cbb663d9d9f1399b37e97a54c0b9f67270c4943,4,7,7,14,6,2013-02-18 02:10:29,2013-02-18 02:10:29
4cbb663d9d9f1399b37e97a54c0b9f67270c4943...c0ea077fb4890a4212e1c517d5fc2369beb49773,2,19,25,44,7,2013-02-18 02:33:55,2013-02-18 02:33:55
c0ea077fb4890a4212e1c517d5fc2369beb49773...13ff3aced06d6918e0ba0e423a7cb7c9964155a8,1,1,1,2,1,2013-02-18 02:46:30,2013-02-18 02:46:30
13ff3aced06d6918e0ba0e423a7cb7c9964155a8...ee9a0f4b9489b5a86ddadb367fe8d44a6f6d4971,1,2,2,4,1,2013-02-18 02:46:49,2013-02-18 02:46:49
ee9a0f4b9489b5a86ddadb367fe8d44a6f6d4971...36aec5e484ae90fa427dae94814891d7d23f772c,2,2,2,4,2,2013-02-18 02:47:44,2013-02-18 02:47:44
36aec5e484ae90fa427dae94814891d7d23f772c...dba9eea98d84929c701f68e64817e9ad707f739e,1,6,6,12,6,2013-02-18 02:48:00,2013-02-18 02:48:00
dba9eea98d84929c701f68e64817e9ad707f739e...c6f341bd17f24b1d744e1ec07f6974fd85d8825b,4,18,11,29,13,2013-02-18 02:58:40,2013-02-18 02:58:40
c6f341bd17f24b1d744e1ec07f6974fd85d8825b...9b3262cb151346432756eba2625d19af733858c8,1,6,5,11,3,2013-02-18 03:04:38,2013-02-18 03:04:38
9b3262cb151346432756eba2625d19af733858c8...56e60d046837bc6efd88a959cf36ae4cdb9c7197,1,1,1,2,1,2013-02-18 03:12:30,2013-02-18 03:12:30
56e60d046837bc6efd88a959cf36ae4cdb9c7197...159167041f0e9e81bf80ccacb990aede1b459a7c,1,1,1,2,1,2013-02-18 03:15:09,2013-02-18 03:15:09
159167041f0e9e81bf80ccacb990aede1b459a7c...82d059de87ff05511ba4de4a0e345f1f26de89f8,5,48,42,90,8,2013-02-18 04:18:29,2013-02-18 04:18:29
82d059de87ff05511ba4de4a0e345f1f26de89f8...e2d829e511a117a28dd6528267d57738b54a4adc,1,4,5,9,1,2013-02-18 04:23:31,2013-02-18 04:23:31
e2d829e511a117a28dd6528267d57738b54a4adc...53091be6d28c05f114bc0a2f74604ceb6f41845e,2,0,10,10,2,2013-02-18 04:26:21,2013-02-18 04:26:21
53091be6d28c05f114bc0a2f74604ceb6f41845e...d3cc8f79f42be8a52fbf3e8eaf3f7d0f6623fa2e,1,0,1,1,1,2013-02-18 04:26:44,2013-02-18 04:26:44
d3cc8f79f42be8a52fbf3e8eaf3f7d0f6623fa2e...f6ec2c5dac371b0b1d56abd65be548ee5ed075c8,4,32,32,64,29,2013-02-18 05:06:20,2013-02-18 05:06:20
f6ec2c5dac371b0b1d56abd65be548ee5ed075c8...acdffe696cf29f51c659a18eeca304512ff47048,5,186,0,186,6,2013-02-18 06:20:49,2013-02-18 06:20:49
acdffe696cf29f51c659a18eeca304512ff47048...f51862f15850b5e14439bba5ae4990f993c199d8,1,0,8,8,1,2013-02-18 09:27:08,2013-02-18 09:27:08
f51862f15850b5e14439bba5ae4990f993c199d8...023568fe3dba59b7f5c12ac610e02fd8bd6c772f,4,92,54,146,44,2013-02-18 09:28:35,2013-02-18 09:28:35
ac90fbf4d815accf8c3e0c3c355ca6643dcabce9...266bdfcaaaa64b9e71fa3719a9b2e6b27fb6c2a1,1,0,15,15,1,2013-06-25 23:31:12,2013-06-25 23:31:12
ac90fbf4d815accf8c3e0c3c355ca6643dcabce9...d82941265c0407904dd19bc6903e99dbbca76540,1,2,2,4,2,2013-06-25 23:07:51,2013-06-25 23:07:51
ac90fbf4d815accf8c3e0c3c355ca6643dcabce9...321190535f09b41683589c7e255a087b4671d36a,1,15,1,16,1,2013-06-25 23:05:45,2013-06-25 23:05:45
ac90fbf4d815accf8c3e0c3c355ca6643dcabce9...8ee0e39ef9123c62bb0bf043fb7cecbd4dfbc00b,1,1,1,2,1,2013-06-25 23:05:26,2013-06-25 23:05:26
ac90fbf4d815accf8c3e0c3c355ca6643dcabce9...d2b5f4e45c5dc75bd7b096068a71d10271191520,1,1,1,2,1,2013-06-25 23:03:57,2013-06-25 23:03:57
ac90fbf4d815accf8c3e0c3c355ca6643dcabce9...64a01f01cb470a8c69e918c3086a03af700ebbba,1,1,1,2,1,2013-06-25 23:01:46,2013-06-25 23:01:46
542e03ae3a2209b87e4db999b6ea869faf9293a9...7cc34ea54765520b62491b53f9dfb24db6ffdfdc,3,4,4,8,4,2013-07-18 03:17:56,2013-07-18 03:17:56
2b9c936a3a01facf03bc51353812dbe01251c4fa...b375283597da51db63be2067287126e636d941dc,1,1,1,2,1,2013-03-15 03:54:53,2013-03-15 03:54:53
b375283597da51db63be2067287126e636d941dc...4247008e23b05a85d91c891b6cee9d2d09584a73,1,1,1,2,1,2013-03-15 03:55:23,2013-03-15 03:55:23
4247008e23b05a85d91c891b6cee9d2d09584a73...ed7fe0e5ba55d71d075a23b205b227665d47fc4f,2,4,5,9,4,2013-03-15 04:45:31,2013-03-15 04:45:31
78df99c8bd6f235a422b5f75524a15223d5aeacd...78d64e97e9f2bb2d0ae10a089e3f3f9ff53cd1f5,1,27,23,50,16,2013-04-10 17:18:04,2013-04-10 17:18:04
78df99c8bd6f235a422b5f75524a15223d5aeacd...7fb1c1cb89a33b924a8cb44235bfb8124ba10000,1,13,14,27,6,2013-04-10 09:27:11,2013-04-10 09:27:11
391661f14b734f378ecc704c724269f1d7efbd0f...9e7f5025b494927e9ffc88119b0b9426f7487a62,17,27,20,47,23,2012-01-29 22:07:58,2012-01-29 22:07:14
9e7f5025b494927e9ffc88119b0b9426f7487a62...e493f7fc19d75dba88f3c6594fb94ef1cea09131,2,2,2,4,2,2012-01-29 22:22:51,2012-01-29 22:22:51
62f4a1571a3801c867b80c228464cc9c695f1d13...bca269299b242c55a2511e752429c07d7639f7d2,6,52,34,86,22,2012-01-29 07:40:52,2012-01-29 07:40:52
8ae9c6ab34128ea863343abaeff39ca7c6f4618c...9ce7f22e991804cd08c4dc612cd929d07dc0a28f,10,31,15,46,15,2013-04-27 16:47:47,2013-04-27 16:47:47
9ce7f22e991804cd08c4dc612cd929d07dc0a28f...2ffa0e44094ab67e23fb1642d6b1b8d269d3a2f1,3,9,2,11,5,2013-04-27 18:55:45,2013-04-27 18:55:45
2ffa0e44094ab67e23fb1642d6b1b8d269d3a2f1...8b3a1702d443c4a451d02d3482ed2cb4aeff0d44,4,126,204,330,59,2013-04-28 01:28:39,2013-04-28 01:28:39
8ae9c6ab34128ea863343abaeff39ca7c6f4618c...efd3b0c1711a443e5ad97c6278addadfe2cedc5d,5,240,235,475,147,2013-04-27 06:59:51,2013-04-27 06:59:51
7cceaa69560b22acac6297d21a2e2e752d667912...9d9fd5e0d1b238613728ef27a024b0cc28b5151a,1,1,1,2,1,2013-05-03 21:46:09,2013-05-03 21:46:09
9d9fd5e0d1b238613728ef27a024b0cc28b5151a...e1d947f53e0591f2765290784f9e09f46e002558,2,79,78,157,20,2013-05-03 21:56:57,2013-05-03 21:56:57
ad5f88e1c5384d8312655298dcff429253ad2d9c...86598cac6b525ab122aa4de92aa3be696fa62e6a,2,2,2,4,2,2013-05-08 03:01:57,2013-05-08 03:01:57
86598cac6b525ab122aa4de92aa3be696fa62e6a...c0e23ad27b7a488f35bcd8bdb29e604823e9a1af,1,0,34,34,1,2013-05-08 03:48:37,2013-05-08 03:48:37
c0e23ad27b7a488f35bcd8bdb29e604823e9a1af...c459c657f8e10ae1af6378114f4943104597c590,3,61,70,131,27,2013-05-08 04:56:55,2013-05-08 04:56:55
c459c657f8e10ae1af6378114f4943104597c590...f03d3371513640724a88febc531f790947f68cf3,1,1,1,2,1,2013-05-08 06:43:51,2013-05-08 06:43:51
ad5f88e1c5384d8312655298dcff429253ad2d9c...d7f84d1220719cdf2272c9aa3c6731a932394c58,6,217,218,435,77,2013-05-08 01:07:06,2013-05-08 01:07:06
b0bece66f295df37b0cf3e61267de17640640da8...65ad52060e1f9b5928ac0d5a0bfead0cdf1b26f4,2,36,126,162,26,2013-06-20 03:31:03,2013-06-20 03:31:03
7e31bea11410f9c1838aeabcb97ad802b69b658c...9ecc43d21a7c26ad799e9c2dfd8149e1d8d50851,3,3,3,6,3,2013-04-02 11:22:31,2013-04-02 11:22:31
9ecc43d21a7c26ad799e9c2dfd8149e1d8d50851...aa51a36686a62ad5ec0bac3958b08151fc9d5d05,2,2,2,4,2,2013-04-02 11:26:35,2013-04-02 11:26:35
aa51a36686a62ad5ec0bac3958b08151fc9d5d05...e0bce6af123fc3d935a34aae87d0787e7e54e07f,1,6,6,12,6,2013-04-02 11:30:13,2013-04-02 11:30:13
e0bce6af123fc3d935a34aae87d0787e7e54e07f...8f99692f5609da492ece960277590e7252a72028,6,0,0,0,0,2013-04-02 11:31:15,2013-04-02 11:31:15
8f99692f5609da492ece960277590e7252a72028...e56461fbd71af38cabff4cc650f6050f765ec603,1,12,0,12,1,2013-04-02 11:39:04,2013-04-02 11:39:04
7e31bea11410f9c1838aeabcb97ad802b69b658c...3233155bb4ce84c3ca0ecd90ad2d284d3c65b99e,1,5,5,10,4,2013-04-02 02:02:35,2013-04-02 02:02:35
d23800c8283aa71fd2936750e41bff488c4c0091...8e6d5be8e495dfcf8e2f46d2f40e6ff82e0eb987,1,1,1,2,1,2013-06-28 06:26:04,2013-06-28 06:26:04
8e6d5be8e495dfcf8e2f46d2f40e6ff82e0eb987...1a09eada35259de198ffad56a460c6ffafe890a4,2,4,1,5,3,2013-06-28 07:08:19,2013-06-28 07:08:19
1a09eada35259de198ffad56a460c6ffafe890a4...09cdee2f03aaad5c5a767fbec2e3896ad3d1f980,3,22,9,31,8,2013-06-28 07:09:10,2013-06-28 07:09:10
023568fe3dba59b7f5c12ac610e02fd8bd6c772f...4c00f290f226876aa67d0440e64196e21729a0a5,1,1,1,2,1,2013-02-19 01:57:54,2013-02-19 01:57:54
4c00f290f226876aa67d0440e64196e21729a0a5...722ba5f2278f1163230e2a68f53895ae482a5a76,1,1,1,2,1,2013-02-19 02:03:52,2013-02-19 02:03:52
0c45458fcc305d3fbb606a65c945ccf7af81acee...d87431a29e6ca3e58df50209ba5f6d487cd1c780,1,5,4,9,5,2013-07-18 07:56:36,2013-07-18 07:56:36
d87431a29e6ca3e58df50209ba5f6d487cd1c780...181b27677492050adceaa52fe972115515759f07,3,7,6,13,5,2013-07-18 08:04:54,2013-07-18 08:04:54
cc43ba35d7c1bb4663a8aea4eb0ba3a97d782852...2471b9d725d2452a10f802af5667509af7b7eb2e,1,1,1,2,1,2013-06-26 12:27:12,2013-06-26 12:27:12
cc43ba35d7c1bb4663a8aea4eb0ba3a97d782852...242d92e09c60396bad0837581a9692bf7abe8aea,3,19,5,24,6,2013-06-26 03:18:30,2013-06-26 03:18:30
cc43ba35d7c1bb4663a8aea4eb0ba3a97d782852...274a3426576d7aef40bb2b760a3fc7a9bce95521,2,2,2,4,2,2013-06-26 02:50:37,2013-06-26 02:50:37
cc43ba35d7c1bb4663a8aea4eb0ba3a97d782852...694c650f8e61a16fb18bf1c7c6c092e26ad52333,1,18,18,36,18,2013-06-26 02:32:17,2013-06-26 02:32:17
5396c40877eed11a21e4c0934b691e95b8e35be2...392bf0c9c9086f2428c12ed5d9efa9b08a8cdb42,3,24,15,39,13,2013-07-18 03:29:41,2013-07-18 03:29:41
7e07c89b8b507102a3462dbfbea34faaf2472963...4c0719ea5f11aae5ec825229ee6e7143bbae4432,2,2,3,5,3,2013-03-15 05:34:20,2013-03-15 05:34:20
4c0719ea5f11aae5ec825229ee6e7143bbae4432...ecfdecea00eb5ee398814cdc2d5e8469e90ae1e4,3,78,22,100,26,2013-03-15 06:01:23,2013-03-15 06:01:23
ecfdecea00eb5ee398814cdc2d5e8469e90ae1e4...2a0fb08fad2e7ffff3aba2f9c406c7fd44db31b0,1,1,1,2,1,2013-03-16 04:23:59,2013-03-16 04:23:59
2a0fb08fad2e7ffff3aba2f9c406c7fd44db31b0...145eb054d9aac82977a339c0253e7bec6ad111d5,1,23,8,31,6,2013-03-16 04:57:16,2013-03-16 04:57:16
145eb054d9aac82977a339c0253e7bec6ad111d5...bb38fa52865397e933db95885eb6347ea6d54109,5,248,77,325,34,2013-03-16 06:21:10,2013-03-16 06:21:10
bb38fa52865397e933db95885eb6347ea6d54109...f77dc548a1a4abc03fc1547f9b1a2a6a38a359f8,1,6,2,8,2,2013-03-16 19:07:00,2013-03-16 19:07:00
f77dc548a1a4abc03fc1547f9b1a2a6a38a359f8...be8f992c94d8155248ddb10dc84bb04c6f7cbe28,1,0,1,1,1,2013-03-16 19:09:26,2013-03-16 19:09:26
be8f992c94d8155248ddb10dc84bb04c6f7cbe28...efbf8373a5060b2c9b4d97cdfd2c288124d339c6,4,88,26,114,20,2013-03-16 19:34:07,2013-03-16 19:34:07
efbf8373a5060b2c9b4d97cdfd2c288124d339c6...8c9e9e28cf63d9dc6a9424b00c9a2a82331c7bcc,2,2,0,2,2,2013-03-16 20:03:31,2013-03-16 20:03:31
a35b9b7d0cf3c046f2e8d72fe0de5efdf7918281...0d70b3c54e65f323655e07ff1c29cb9230852484,1,1,1,2,1,2013-04-11 19:02:29,2013-04-11 19:02:29
a35b9b7d0cf3c046f2e8d72fe0de5efdf7918281...43b0a1287aba6f32e4ea372a217a17d36e845cf7,1,0,2,2,1,2013-04-11 12:01:23,2013-04-11 12:01:23
a35b9b7d0cf3c046f2e8d72fe0de5efdf7918281...3dc8be74fe574a4f300c3f0d28678038d071e796,1,2,2,4,2,2013-04-11 10:24:13,2013-04-11 10:24:13
5b7596a5b3d160b3d78962b0e61a6724487e497c...b3bb89520d02cabbb75958bfea1b02b57fa3d7b0,1,5,2,7,2,2013-04-12 03:16:20,2013-04-12 03:16:20
d637db1a23883d905db8e086bfb97435738af940...702d3b6dfe7a150deb090f70d7d9c2a2964a3eb2,13,35,22,57,23,2012-01-30 00:35:55,2012-01-30 00:35:55
d637db1a23883d905db8e086bfb97435738af940...f622822459b792137768b71e7c7aa9253cc93a6b,10,6137,4,6141,8,2012-01-30 00:19:41,2012-01-30 00:19:41
f622822459b792137768b71e7c7aa9253cc93a6b...298e637d004c66a0e4351c7ce4a8d03866b75f66,11,17,6153,6170,11,2012-01-30 00:33:29,2012-01-30 00:33:29
f9e01e2258d77593bb05efc572290662a9c37aa0...15a1c0ce7988aaf715096760fa99eff7b23937f4,3,204,224,428,81,2012-01-29 07:58:39,2012-01-29 07:58:39
15a1c0ce7988aaf715096760fa99eff7b23937f4...7bf27674523c35f8803311a964dc72a7093351c0,5,80,81,161,14,2012-01-29 08:07:01,2012-01-29 08:07:01
8b3a1702d443c4a451d02d3482ed2cb4aeff0d44...bbee78b30b40ff0b1473a06ea7ecf5a42d51b614,4,18,6,24,9,2013-04-28 21:27:48,2013-04-28 21:27:48
8b3a1702d443c4a451d02d3482ed2cb4aeff0d44...3326e1b21e2368878a1c7f7bbd8d31d58fff5276,2,2,10,12,4,2013-04-28 14:09:57,2013-04-28 14:08:48
8b3a1702d443c4a451d02d3482ed2cb4aeff0d44...ddc0e98716d05b2b583c0097a8fc76f976730fc6,8,8,8,16,8,2013-04-28 13:10:01,2013-04-28 13:10:01
cd06c5baac64a3663820bc25b393e5b354c64a14...e13d05317ee5a944bdf34c1dda65bcc30a7915f6,2,2,2,4,2,2013-04-29 05:45:56,2013-04-29 05:45:56
cd06c5baac64a3663820bc25b393e5b354c64a14...62afdd01763466e413fbe67c7622e08a16fa30aa,5,25,25,50,18,2013-04-29 02:22:33,2013-04-29 02:22:33
cd06c5baac64a3663820bc25b393e5b354c64a14...447be1b3264eac4b22edc1584a6cb6f098bb2d7c,2,2,2,4,2,2013-04-29 01:51:02,2013-04-29 01:51:02
f03d3371513640724a88febc531f790947f68cf3...9013ff002adcf2f7a3bfe2d60329649fc159204a,5,306,0,306,4,2013-05-08 12:25:37,2013-05-06 13:58:04
509f2244da757a60d3548a7d34d63080dc01ee19...14651035deda4d02a1ca02c6088c34f770f897f6,137,24048,1212,25260,322,2013-05-16 18:06:30,2013-05-16 18:06:30
509f2244da757a60d3548a7d34d63080dc01ee19...1cb880b4f112463cbb8ad25ec680e561f978834e,2,2,2,4,2,2013-05-09 02:55:20,2013-05-09 02:55:20
1cb880b4f112463cbb8ad25ec680e561f978834e...54561f11212faee93ab682660503c6324d8b2cf8,2,4,4,8,4,2013-05-09 02:57:42,2013-05-09 02:57:42
54561f11212faee93ab682660503c6324d8b2cf8...88dd9de9bad56b30a12466477a810c78648200c9,7,2,1007,1009,8,2013-05-09 03:04:54,2013-05-09 03:04:54
88dd9de9bad56b30a12466477a810c78648200c9...edb733ebc7db2d76bdac2611cbd83c5ae36f4fee,20,7291,7246,14537,62,2013-05-09 04:56:08,2013-05-09 04:56:08
edb733ebc7db2d76bdac2611cbd83c5ae36f4fee...07aed1abc364cc5f493136eba34890b3670554d3,3,18,33,51,3,2013-05-09 05:07:28,2013-05-09 05:07:28
07aed1abc364cc5f493136eba34890b3670554d3...feeaaa6febea765433351d1313d39ad74e452ad4,2,49,59,108,22,2013-05-09 05:13:56,2013-05-09 05:13:56
feeaaa6febea765433351d1313d39ad74e452ad4...65289bb1eaa72a336472ed116183b69325fdbbc0,1,6,1,7,1,2013-05-09 05:17:26,2013-05-09 05:17:26
65289bb1eaa72a336472ed116183b69325fdbbc0...241d3423630f5a1ab4fcb379ec72248421a25874,2,15,6,21,4,2013-05-09 05:24:07,2013-05-09 05:24:07
241d3423630f5a1ab4fcb379ec72248421a25874...fa4d4e8d88eb8e3e2bb2daba9de3880e93fa5756,2,22,11,33,10,2013-05-09 05:29:53,2013-05-09 05:29:53
fa4d4e8d88eb8e3e2bb2daba9de3880e93fa5756...f09b07dc2a2cb110d5d129ea8c1aac6cbbb09c0d,1,6,4,10,6,2013-05-09 05:31:49,2013-05-09 05:31:49
f09b07dc2a2cb110d5d129ea8c1aac6cbbb09c0d...d7acf4e82d2e5ba5775b18870fb01ac22264e764,3,44,61,105,18,2013-05-09 05:42:42,2013-05-09 05:42:42
d7acf4e82d2e5ba5775b18870fb01ac22264e764...67b7a2fc34431a5db19a906328d772e5fc1af814,1,34,49,83,7,2013-05-09 05:50:41,2013-05-09 05:50:41
67b7a2fc34431a5db19a906328d772e5fc1af814...e5e5f6616c036bde1fd142c6721e1c5066c11d64,2,6,6,12,6,2013-05-09 05:51:44,2013-05-09 05:51:44
e5e5f6616c036bde1fd142c6721e1c5066c11d64...3c3e56ca50571c1efb6632fe39367de246cb3db6,4,6,6,12,6,2013-05-09 05:52:48,2013-05-09 05:52:48
3c3e56ca50571c1efb6632fe39367de246cb3db6...22f212379f296d9f267a05d739f44d4deba544db,1,2,7,9,3,2013-05-09 05:53:31,2013-05-09 05:53:22
22f212379f296d9f267a05d739f44d4deba544db...705063c73a9274333a9c5981aeb9cdfb9d443a02,2,8,9,17,7,2013-05-09 05:54:25,2013-05-09 05:54:25
705063c73a9274333a9c5981aeb9cdfb9d443a02...ac28ad81d0b1761c07607c89c0d1dfc6c7caf721,2,14,23,37,5,2013-05-09 05:55:17,2013-05-09 05:55:17
ac28ad81d0b1761c07607c89c0d1dfc6c7caf721...09c3a4b3bcb2d7bb6a786854abd0bc17a12c6d39,5,206,206,412,184,2013-05-09 05:56:29,2013-05-09 05:56:29
09c3a4b3bcb2d7bb6a786854abd0bc17a12c6d39...526dfb7735c8bce460b4960ec196f236fcd9d137,2,4,4,8,4,2013-05-09 05:57:42,2013-05-09 05:57:42
526dfb7735c8bce460b4960ec196f236fcd9d137...766be659c15d0fef1c83767504b3aac96af19c1c,5,37,37,74,36,2013-05-09 05:58:54,2013-05-09 05:58:54
65ad52060e1f9b5928ac0d5a0bfead0cdf1b26f4...110fc8860117d8675345806219ba313b18086db2,1,1,1,2,1,2013-06-20 16:40:30,2013-06-20 16:40:30
54b2a0b54153debbe27ea284f18c278e0014c8b3...2cd34a1a85030dd341f6a7037a378f0accc58730,1,1,0,1,1,2013-04-02 21:48:45,2013-04-02 21:48:45
0f51a750a86a108e8f8c2d2c31b52b0774b81c39...0ac711059ba7aaa2996a529d7f9bf4110a6dd765,4,71,59,130,31,2013-04-02 23:17:04,2013-04-02 23:17:04
0ac711059ba7aaa2996a529d7f9bf4110a6dd765...c570ae49ef7494f2b28f6f0dc27214e6912eef25,1,2,2,4,2,2013-04-02 23:22:42,2013-04-02 23:22:42
c570ae49ef7494f2b28f6f0dc27214e6912eef25...610eb8fb78952ad3b1b43df2362bcfef9b223a01,2,3,2,5,2,2013-04-03 01:02:53,2013-04-03 01:02:53
610eb8fb78952ad3b1b43df2362bcfef9b223a01...eadfa59d92ad8bd898b2586056fbbf55906e1420,5,105,6,111,13,2013-04-03 02:40:43,2013-04-03 02:40:43
09cdee2f03aaad5c5a767fbec2e3896ad3d1f980...0a92efce0cbded7b664a5e198bfe6bca3b13bcac,5,3,6761,6764,7,2013-06-28 16:24:46,2013-06-28 16:24:46
09cdee2f03aaad5c5a767fbec2e3896ad3d1f980...a85c11eb455eab5e57b66a5e8266f3e4ec772567,1,1,1,2,1,2013-06-28 12:09:46,2013-06-28 12:09:46
a85c11eb455eab5e57b66a5e8266f3e4ec772567...37e4fbf9cabc1aa064b8c04ca6f291fa13ad3160,1,1,1,2,1,2013-06-28 12:19:46,2013-06-28 12:19:46
09cdee2f03aaad5c5a767fbec2e3896ad3d1f980...55fa1acbd6f351d56b873eef6c59f72899cece49,4,17,3,20,6,2013-06-28 10:05:38,2013-06-28 10:05:38
a1913cbe7e969cb6763f12888a594666b2d28a65...3b7e5214e3c998e4c2652798dbd8aba4cfee737f,1,8,10,18,1,2013-02-19 19:32:28,2013-02-19 19:32:28
3b7e5214e3c998e4c2652798dbd8aba4cfee737f...62b54605a7b22011835fdb43474e9d8fa27ac384,1,2,2,4,2,2013-02-19 19:35:48,2013-02-19 19:35:48
62b54605a7b22011835fdb43474e9d8fa27ac384...ec9b01e69165c078a6a261c8d570eac70b20bf51,2,3,3,6,3,2013-02-19 19:40:05,2013-02-19 19:40:05
ec9b01e69165c078a6a261c8d570eac70b20bf51...ba7b1e8234982b3926e830798b5d3d34e1d1b369,1,2,2,4,2,2013-02-19 19:50:44,2013-02-19 19:50:44
ba7b1e8234982b3926e830798b5d3d34e1d1b369...17808731738cb9de385950db54bb156786b6c705,1,1,1,2,1,2013-02-19 19:54:56,2013-02-19 19:54:56
181b27677492050adceaa52fe972115515759f07...e72b524d416a5b3352274e0d748ffd77ceecf100,2,2,0,2,2,2013-07-18 08:25:08,2013-07-18 08:25:08
296b9d7293c99eaa0abda4a65f182ca104afbfdc...94761c221648c0968328bee1fc5970ad7b481bea,2,41,37,78,4,2013-06-28 01:47:35,2013-06-28 01:47:35
94761c221648c0968328bee1fc5970ad7b481bea...b0da97588e3d1e4d7eb688d16b3e40e0a27459f3,1,1,1,2,1,2013-06-28 02:19:22,2013-06-28 02:19:22
296b9d7293c99eaa0abda4a65f182ca104afbfdc...5e29c42211538e1e3885dc8c70779a17221c9569,1,0,1,1,1,2013-06-28 01:38:00,2013-06-28 01:38:00
5e29c42211538e1e3885dc8c70779a17221c9569...c9ccbd2cf0b5b37fe67e55a93223d4836f22da44,1,2,2,4,1,2013-06-28 01:43:29,2013-06-28 01:43:29
f0d071832284d968f2cb72b0bb576f8112a349de...97cdb4215ada5321351b2edd7d6964913d078ddd,1,2,2,4,2,2013-07-18 03:44:55,2013-07-18 03:44:55
97cdb4215ada5321351b2edd7d6964913d078ddd...6be1f9d00fd6daf7b255acd63d88f772aab9849e,2,15,17,32,2,2013-07-18 04:02:50,2013-07-18 04:02:50
6be1f9d00fd6daf7b255acd63d88f772aab9849e...0df791d1ac782d37243017214a1fb37e8ead07bd,1,1,1,2,1,2013-07-18 04:04:27,2013-07-18 04:04:27
0f64c21049dc5f3f184ec28bdab770f5c4ad594e...eb3333a612c4125ba2fa9f8825f70cc12cd9b439,4,11,10,21,9,2013-07-18 04:08:50,2013-07-18 04:08:50
eb3333a612c4125ba2fa9f8825f70cc12cd9b439...bf38241f0d95811dd6be0977f91e9a30c3da16c4,1,3,3,6,3,2013-07-18 04:10:33,2013-07-18 04:10:33
8c9e9e28cf63d9dc6a9424b00c9a2a82331c7bcc...e0de08c38975b6b4b12a075b4b7d924922d71c88,1,1,1,2,1,2013-03-16 21:49:21,2013-03-16 21:49:21
58c8c770d8978156b85003ebaa7c57f83c4fa0dd...96f332578ce027c5bb2b8471b8a6c29638a178be,1,1,0,1,1,2013-04-13 03:43:41,2013-04-13 03:43:41
b0976bb379d2c8826c13769a53f94079aa161c45...882bb9dbd3631124b8c5052dff5be5b22a1e3867,1,0,0,0,0,2012-01-30 00:43:03,2012-01-30 00:43:03
7bf27674523c35f8803311a964dc72a7093351c0...918a17a30bbaed3f7d8c80a30b7766b95e636dff,7,190,15,205,30,2012-01-29 22:50:47,2012-01-29 22:50:47
918a17a30bbaed3f7d8c80a30b7766b95e636dff...97b3057824272080166e592016131db53e55c427,4,46,0,46,10,2012-01-29 23:13:21,2012-01-29 23:13:21
97b3057824272080166e592016131db53e55c427...19b70dc4142bb0737f4ed71ac5e559585f9b9150,2,4,4,8,4,2012-01-29 23:22:10,2012-01-29 23:22:10
7bf27674523c35f8803311a964dc72a7093351c0...059ff6bcbd48f18431ed66e4b1b2a97a9567b9f7,3,112,34,146,9,2012-01-29 10:27:45,2012-01-29 10:27:45
059ff6bcbd48f18431ed66e4b1b2a97a9567b9f7...48529ad01fa2a60bfc9179743dcb5379e8ff944f,10,398,187,585,39,2012-01-29 21:06:57,2012-01-29 21:06:57
48529ad01fa2a60bfc9179743dcb5379e8ff944f...0952f3796ec7a4bb3efc0c6ba7b88ed4b7f45ada,1,1,1,2,1,2012-01-29 21:07:31,2012-01-29 21:07:31
0952f3796ec7a4bb3efc0c6ba7b88ed4b7f45ada...8c763589a2058785936a33088935c50f622859de,2,2,2,4,2,2012-01-29 21:09:10,2012-01-29 21:09:10
8c763589a2058785936a33088935c50f622859de...4e5b0e185e8cc9df3a77361380a44b16689fd2f7,2,14,4,18,4,2012-01-29 21:12:13,2012-01-29 21:12:13
4e5b0e185e8cc9df3a77361380a44b16689fd2f7...9fa8bde44d9bb6f26b16c7633a01bbe5ce7b20a4,2,2,2,4,2,2012-01-29 21:15:38,2012-01-29 21:15:38
5edfdc02f26cf4432a6cd798fc0064da779d6efb...c087e383ed6f5d741846d5d76de3cac96772bd8d,1,1,1,2,1,2013-04-29 00:45:42,2013-04-29 00:45:42
26bc36107edc54b685b6939807f9d41a09831606...e67d3818ed962a69cb970fa9255647a087c643c9,1,220,220,440,220,2013-04-30 18:32:11,2013-04-30 18:32:11
e67d3818ed962a69cb970fa9255647a087c643c9...0f17f9b7f7fe15bb4ce6301caa2600bfd30e63d7,1,10,14,24,3,2013-04-30 20:03:10,2013-04-30 20:03:10
0f17f9b7f7fe15bb4ce6301caa2600bfd30e63d7...6dd4cbd20be951d64defe52f04548e76ca8119c0,1,1,1,2,1,2013-05-01 02:06:30,2013-05-01 02:06:30
6dd4cbd20be951d64defe52f04548e76ca8119c0...e8b731864608d2f86db37705880ec92136e7347a,2,6,3,9,4,2013-05-01 02:07:28,2013-05-01 02:07:28
e8b731864608d2f86db37705880ec92136e7347a...69f5447afab3209cee5f96097447df058084d1c3,2,2,0,2,2,2013-05-01 02:12:48,2013-05-01 02:12:48
69f5447afab3209cee5f96097447df058084d1c3...0780faad45d106fbe8bd0de64e1cdfb3d6117d0e,2,4,4,8,2,2013-05-01 02:20:41,2013-05-01 02:20:41
0780faad45d106fbe8bd0de64e1cdfb3d6117d0e...47155e8aa38856ff928be02b33454ae79d84aa2e,2,8,0,8,2,2013-05-01 02:35:52,2013-05-01 02:35:52
47155e8aa38856ff928be02b33454ae79d84aa2e...f8fd524def9b0960403495c5183f0e1c616a82b4,1,2,2,4,2,2013-05-01 02:55:02,2013-05-01 02:55:02
747e108e0b8e6811d104d9a9e99b0fae6325c836...4357ed72e0b244a6ccb56626e49fff5ed046573f,2,7,6,13,6,2013-05-03 22:18:27,2013-05-03 22:18:04
4357ed72e0b244a6ccb56626e49fff5ed046573f...a6f7f96a93a650fc7e71337c836f0221433b65f2,1,6,0,6,2,2013-05-03 22:29:10,2013-05-03 22:29:10
a6f7f96a93a650fc7e71337c836f0221433b65f2...ee0789ff8f7ac0c60d8f326894fef5fd9db90adc,3,4,4,8,4,2013-05-03 22:29:32,2013-05-03 22:29:32
ee0789ff8f7ac0c60d8f326894fef5fd9db90adc...7d41a387693c49347e06572ceb7ec2207ee30d46,3,56,0,56,3,2013-05-03 23:16:26,2013-05-03 23:16:26
a4c16155a21c7bcad9b1d52e2141425cdb7df494...bdbd268cb9cb64d0a8f6c77e56c139d18e21af5f,1,76,90,166,30,2013-05-16 18:20:18,2013-05-16 18:20:18
bdbd268cb9cb64d0a8f6c77e56c139d18e21af5f...92245e8bc70f8d2e48036b7ba088551d07db29ca,9,345,421,766,163,2013-05-16 19:50:06,2013-05-16 19:50:06
92245e8bc70f8d2e48036b7ba088551d07db29ca...53bc93282fbeab3c1b779f1914ab040290668369,78,1,21852,21853,44,2013-05-16 20:46:12,2013-05-16 20:46:12
53bc93282fbeab3c1b779f1914ab040290668369...149ecd21bf7c56df897088d09ca309eb43a7dd9d,10,604,648,1252,189,2013-05-17 00:18:15,2013-05-17 00:18:15
149ecd21bf7c56df897088d09ca309eb43a7dd9d...19de2e86035746b4cda13d4e3860bc549b4f4841,1,3,3,6,3,2013-05-17 00:19:23,2013-05-17 00:19:23
19de2e86035746b4cda13d4e3860bc549b4f4841...a72d0d6e3a5f2691eaa7e036a7b081d021097159,23,1268,1350,2618,465,2013-05-17 00:44:50,2013-05-17 00:44:50
a72d0d6e3a5f2691eaa7e036a7b081d021097159...f37b351288883cca4ea435827b10fe6d8475dc6e,7,38,26,64,31,2013-05-17 01:15:34,2013-05-17 01:15:34
f37b351288883cca4ea435827b10fe6d8475dc6e...b239542a5ef8bfbf4775e58e64f0e68e02d077e9,4,4,4,8,4,2013-05-17 01:21:42,2013-05-17 01:21:42
766be659c15d0fef1c83767504b3aac96af19c1c...d731690352903218b8b88b924c9ee768f01139e9,1,1,1,2,1,2013-05-09 16:09:44,2013-05-09 16:09:44
766be659c15d0fef1c83767504b3aac96af19c1c...3a539abbd2dcc9dbb4e6891c4e8841dd1b208385,1,1,1,2,1,2013-05-09 11:21:22,2013-05-09 11:21:22
175e4676ddda6dc9e6136676a236a542b4328592...83832095215f0ba03d3f23fcb7e37c5782395237,1,4,4,8,4,2013-06-20 16:58:21,2013-06-20 16:58:21
eadfa59d92ad8bd898b2586056fbbf55906e1420...7a8d071735b5f6da28cd6235f1a76cf0cfa62c8e,1,1,1,2,1,2013-04-05 18:42:29,2013-04-05 18:42:29
eadfa59d92ad8bd898b2586056fbbf55906e1420...c1ab200985cf84f52f13997955396dea0618d9b1,1,33,33,66,32,2013-04-03 16:48:39,2013-04-03 16:48:39
2d2828d36ccaca2f6db42352d59ab4906a7439f6...a27ecfccf301f8996d7ddf6bd6f7f46f358a5a31,7,68,93,161,22,2013-07-02 00:32:07,2013-07-02 00:32:07
2d2828d36ccaca2f6db42352d59ab4906a7439f6...6a20810ca4970a681bd34274851365af011694e3,4,6,2,8,6,2013-06-29 20:06:14,2013-06-29 20:06:14
2d2828d36ccaca2f6db42352d59ab4906a7439f6...02351c0589be66edcc2dc10bd059aeac55eb6163,1,1,7,8,2,2013-06-29 14:37:53,2013-06-29 14:37:53
2d2828d36ccaca2f6db42352d59ab4906a7439f6...4252dff850e72269ea74aa86d63a880247ff22b3,3,3,3,6,3,2013-06-29 11:21:16,2013-06-29 11:21:16
102df4ff3334663b20c8730bbb32a673b4259edf...a7a9a1437914a86674c3fe9277484fcad21b08e8,1,6,6,12,3,2013-07-18 04:17:39,2013-07-18 04:17:39
a7a9a1437914a86674c3fe9277484fcad21b08e8...2cccc0889f63503d3a56ed80b3f0cde3424a5aff,3,3,3,6,3,2013-07-18 04:30:38,2013-07-18 04:30:38
2cccc0889f63503d3a56ed80b3f0cde3424a5aff...18d23b892c280f170ae4c02c9ae27183c3f7946e,3,3,3,6,3,2013-07-18 04:35:28,2013-07-18 04:35:28
18d23b892c280f170ae4c02c9ae27183c3f7946e...6387d8d5cccca1af3767258d6b38394c9f89afae,1,1,1,2,1,2013-07-18 04:38:52,2013-07-18 04:38:52
c6343a9d4a3445ab04a71761fae1f484cc6b9ec3...a9e9d9d54467b30e87639c6c32f91c1190bc1517,5,7,7,14,7,2013-03-26 00:46:44,2013-03-26 00:46:44
a9e9d9d54467b30e87639c6c32f91c1190bc1517...ab09fb25b9b56cc9d02091697f59551c0cc0482d,7,8,8,16,8,2013-03-26 01:13:13,2013-03-26 01:13:13
c6343a9d4a3445ab04a71761fae1f484cc6b9ec3...e1bb94c38370fd2542415557c660d0804d4f42b1,2,59,2,61,3,2013-02-24 09:29:19,2013-02-24 09:29:19
e1bb94c38370fd2542415557c660d0804d4f42b1...91660a0489e005d68a430bce298726d2313ac579,5,24,313,337,5,2013-02-26 08:37:59,2013-02-26 08:37:59
91660a0489e005d68a430bce298726d2313ac579...5b3b11c02a107573e6ff3e7a8da907792f6716f8,3,198,0,198,3,2013-02-26 08:42:24,2013-02-26 08:42:24
5b3b11c02a107573e6ff3e7a8da907792f6716f8...e2e5580c0ebbc333590a685693dcaa6d97ef18e7,2,1,22,23,4,2013-02-26 08:44:15,2013-02-26 08:44:15
e2e5580c0ebbc333590a685693dcaa6d97ef18e7...ea01e8bbc4fd42ac1e77b5af197b3b1198c50acc,8,71,1804,1875,8,2013-02-26 08:49:21,2013-02-26 08:49:21
ea01e8bbc4fd42ac1e77b5af197b3b1198c50acc...81a0306cce2d25da628122e32993b8ba0262b415,4,18,18,36,15,2013-02-26 08:56:06,2013-02-26 08:56:06
81a0306cce2d25da628122e32993b8ba0262b415...877d64dd77fbf43a4376ad44018bf00158a8405a,1,0,1,1,1,2013-03-01 03:32:39,2013-03-01 03:32:39
877d64dd77fbf43a4376ad44018bf00158a8405a...9d763e805b3c6a042b8da04cb7a49d2d0748bdd9,2,17,34,51,17,2013-03-01 03:34:02,2013-03-01 03:34:02
9d763e805b3c6a042b8da04cb7a49d2d0748bdd9...0dea8b0c7473c1db4aea7accfd0a68cbf09b9576,5,126,125,251,9,2013-03-01 03:42:51,2013-03-01 03:42:51
0dea8b0c7473c1db4aea7accfd0a68cbf09b9576...b19eb88b5abb7fd9dfc3aacc7ac3d296e1e98861,8,15,12,27,11,2013-03-01 03:46:49,2013-03-01 03:46:49
b19eb88b5abb7fd9dfc3aacc7ac3d296e1e98861...bfc4aaf6e84f20728258672276ccc9db84638082,5,91,79,170,36,2013-03-01 05:19:02,2013-03-01 05:19:02
bfc4aaf6e84f20728258672276ccc9db84638082...4418c82888745139d4adf0b5ecf8c5b1b3d3c39c,2,15,8,23,4,2013-03-01 06:47:32,2013-03-01 06:47:32
4418c82888745139d4adf0b5ecf8c5b1b3d3c39c...5a30e52aac451369bf9a6abfc34c3c5d10b304d3,5,36,4,40,14,2013-03-01 07:20:58,2013-03-01 07:20:25
5a30e52aac451369bf9a6abfc34c3c5d10b304d3...38ba057dee025052c4a602b1295571e94b524a27,2,2,2,4,2,2013-03-01 07:23:05,2013-03-01 07:23:05
38ba057dee025052c4a602b1295571e94b524a27...ba633949dc77919d41792700c8c28e8c50a6f127,2,17,1,18,2,2013-03-01 07:36:54,2013-03-01 07:36:54
ba633949dc77919d41792700c8c28e8c50a6f127...2e3ba4afe633eb9ea820f1b506e4e3840e2e2ecc,1,44,62,106,9,2013-03-01 08:04:41,2013-03-01 08:04:41
2e3ba4afe633eb9ea820f1b506e4e3840e2e2ecc...492c249537d7cdce6148ac8a1c056c4d89451fb2,4,20,3,23,6,2013-03-01 08:18:10,2013-03-01 08:18:10
492c249537d7cdce6148ac8a1c056c4d89451fb2...77e8e2aee9d560b9152ddb8f214da2aa6e03d516,2,2,2,4,2,2013-03-01 08:50:08,2013-03-01 08:50:08
6e04925328c74dde8d98676b5148d646ea055e9b...898ee8f13b2d7600cfea762edc95a901e4e60939,1,0,1,1,1,2013-07-18 08:46:31,2013-07-18 08:46:31
898ee8f13b2d7600cfea762edc95a901e4e60939...3ed05f60fd6e0fcb4f0f6b9d2f6c7ddb720afbe2,6,0,0,0,0,2013-07-18 09:05:41,2013-07-18 09:05:41
3ed05f60fd6e0fcb4f0f6b9d2f6c7ddb720afbe2...64efa8603662bc5af55e79db61e747b6788f2a0d,2,4,0,4,2,2013-07-18 09:19:13,2013-07-18 09:19:13
64efa8603662bc5af55e79db61e747b6788f2a0d...b372661a17bf88671450694573d64d08a0fd7ff5,1,1,1,2,1,2013-07-18 09:23:38,2013-07-18 09:23:38
7636577681fa07f4c3911c27a0617f4d137580ea...cb483b67589df7ac3ece33303b8ce944b3ac4b0e,1,10,10,20,10,2013-06-28 01:45:08,2013-06-28 01:45:08
9efba239b6c15b72a2872a6c5119fa3abe303951...d7d1c2a767987c8aec0745ea5f26ab319b55f5af,3,58,3,61,5,2013-07-18 06:22:28,2013-07-18 06:22:28
9efba239b6c15b72a2872a6c5119fa3abe303951...3ad0cf9e9417cc86ca6d18f2d47049e9180aef99,5,46,35,81,16,2013-07-18 05:58:49,2013-07-18 05:58:49
a96dd1bd284ba3c6f32bf378ec5f2baa131b1c12...ae98f1803f09fae7e427075f99c19d218d68f46c,3,11,8,19,8,2013-04-13 03:56:19,2013-04-13 03:56:19
882bb9dbd3631124b8c5052dff5be5b22a1e3867...0301d469e8f8bd9da6d63ffb929ad48cae573afc,3,2,2,4,2,2012-01-30 00:54:51,2012-01-30 00:54:51
882bb9dbd3631124b8c5052dff5be5b22a1e3867...90f2e8e196eaaf60256659d9a76205b66ba6e941,1,0,0,0,0,2012-01-30 00:46:40,2012-01-30 00:46:40
9fa8bde44d9bb6f26b16c7633a01bbe5ce7b20a4...278858e70698f0dcf8651cb59b13e48fe756d8bd,4,14,2,16,6,2012-01-29 21:25:13,2012-01-29 21:25:13
f8fd524def9b0960403495c5183f0e1c616a82b4...a4f2c9e156ed52e24ea779b8ef4a32adfb124444,1,3,0,3,1,2013-05-03 05:44:43,2013-05-03 05:44:43
a4f2c9e156ed52e24ea779b8ef4a32adfb124444...bec8c90fd7a126e23c1d3a66eba9782b32729e48,3,35,32,67,7,2013-05-03 05:54:14,2013-05-03 05:52:32
bec8c90fd7a126e23c1d3a66eba9782b32729e48...23ae6405f504a2627e1c1e8d856564fd8065dfe3,1,0,14,14,1,2013-05-03 05:58:30,2013-05-03 05:58:30
23ae6405f504a2627e1c1e8d856564fd8065dfe3...94792b9dae3800e739e0036d45a276c3127b103d,3,23,18,41,6,2013-05-03 06:05:09,2013-05-03 06:05:09
94792b9dae3800e739e0036d45a276c3127b103d...e1c67b149f7189f72acc5ca3e25d02f9dcd27e35,3,62,14,76,11,2013-05-03 06:13:43,2013-05-03 06:13:43
e1c67b149f7189f72acc5ca3e25d02f9dcd27e35...1587b8948f3f1e2471c3bf4005a8ba722bffc78d,1,15,60,75,11,2013-05-03 17:53:26,2013-05-03 17:53:26
1587b8948f3f1e2471c3bf4005a8ba722bffc78d...b5d68f59c20bbc9bd0290950d0d04db417697843,2,4,0,4,4,2013-05-03 18:56:00,2013-05-03 18:56:00
f8fd524def9b0960403495c5183f0e1c616a82b4...9237b25300a9a997c43389d66da36dacc9a90e02,1,1,1,2,1,2013-05-01 17:47:52,2013-05-01 17:47:52
7d41a387693c49347e06572ceb7ec2207ee30d46...dcf7cc084d6b2d0522860c4c9be6e914c67ab91a,2,9,3,12,3,2013-05-04 20:11:20,2013-05-04 20:11:20
b239542a5ef8bfbf4775e58e64f0e68e02d077e9...c072b6b2fc097db1fc369c377d0f0b7f7a7cf7e3,28,7,4254,4261,29,2013-05-17 01:34:51,2013-05-17 01:34:51
b239542a5ef8bfbf4775e58e64f0e68e02d077e9...d8b749a4d35b5a6f7a6ebba2bdac5651460aef27,2,2,2,4,2,2013-05-17 01:29:53,2013-05-17 01:29:53
d731690352903218b8b88b924c9ee768f01139e9...751eb0bdcc1e62f8822cefb5b99d6fbc64de2469,2,25,7,32,8,2013-05-09 16:22:49,2013-05-09 16:22:49
83832095215f0ba03d3f23fcb7e37c5782395237...f64fe29003159669404f8f5a7a20551fec263904,9,0,695,695,5,2013-06-20 22:40:37,2013-06-20 22:40:37
83832095215f0ba03d3f23fcb7e37c5782395237...c5fb401a626c3e0d99a764cb7961e1bd3e619e8f,30,9,1707,1716,20,2013-06-20 19:36:27,2013-06-20 19:36:27
330e9b16c2fcb96ae350b170cda61d5937aa5a78...7ff40635d4bc8c832b2890f9b7292cf89f02ea09,1,1,1,2,1,2013-04-07 18:44:17,2013-04-07 18:44:17
330e9b16c2fcb96ae350b170cda61d5937aa5a78...06a4bb38c02447a6434b6d1381f183d8678373b8,1,1,1,2,1,2013-04-07 04:02:24,2013-04-07 04:02:24
b99c170ef7064fb7aa89c2c9cce530a148fe56ad...05710e10f7d4a823bb4854add74e974ced858e14,2,2,0,2,2,2013-04-07 01:48:53,2013-04-07 01:48:53
7ad9fbef8bd79b7febaaadbd521ea7f60dd2b254...c9df1db50221fe033a0b7bc216fa2de5b6eea17a,2,16,12,28,8,2013-07-02 01:16:59,2013-07-02 01:16:59
c9df1db50221fe033a0b7bc216fa2de5b6eea17a...9da90adb4ca09e4c3b5ec549211c07292ec38d71,2,4,0,4,4,2013-07-02 01:21:19,2013-07-02 01:21:19
534eac52428ca6201ee60e28de2a7a5e949f2144...fea69df80c3d304868d816a85a8b027b40a13f3d,3,117,12,129,21,2013-07-01 19:13:57,2013-07-01 19:13:57
534eac52428ca6201ee60e28de2a7a5e949f2144...e5e9d5916ab6e14aff18e5fb2f9e8e1f2eccb5a1,1,34,38,72,4,2013-07-01 12:29:41,2013-07-01 12:29:41
534eac52428ca6201ee60e28de2a7a5e949f2144...2e8752b26f08b888300fad5a0e357c860ab594b2,1,1,1,2,1,2013-06-30 22:51:08,2013-06-30 22:51:08
6387d8d5cccca1af3767258d6b38394c9f89afae...57768d7ea9486f9fcf83701131880405e2fc01cf,2,25,5,30,2,2013-07-18 06:01:33,2013-07-18 06:01:33
b372661a17bf88671450694573d64d08a0fd7ff5...cc63096118d0d1cf4e0acb5c45daab508a07ae7c,2,27,24,51,4,2013-07-18 20:05:53,2013-07-18 20:05:53
b372661a17bf88671450694573d64d08a0fd7ff5...86efc140e2e245d134a8a6794fbe27bfb71abe3f,2,4,4,8,4,2013-07-18 18:49:39,2013-07-18 18:49:39
2af67238a4ce5e85e1ba9c83d3af3b0c13f811cd...51093fde18354d1fdea0d44fd1ab58f191b2b33b,1,1,13,14,3,2013-06-28 02:27:44,2013-06-28 02:27:44
51093fde18354d1fdea0d44fd1ab58f191b2b33b...416cc6b2eeb94287e45539d834b37846f3913e70,1,47,49,96,3,2013-06-28 02:33:26,2013-06-28 02:33:26
416cc6b2eeb94287e45539d834b37846f3913e70...81b5e74057da4a891419083f343b15090162e801,1,2,656,658,2,2013-06-28 02:36:09,2013-06-28 02:36:09
81b5e74057da4a891419083f343b15090162e801...6a2858f7bf9a1b6683f883870e898c9f0656b64f,2,2,2,4,2,2013-06-28 02:36:35,2013-06-28 02:36:35
6a2858f7bf9a1b6683f883870e898c9f0656b64f...ca8ca2177fd5b8e6523bd1599784b129c2d75937,2,8,0,8,8,2013-06-28 02:36:56,2013-06-28 02:36:56
5cb8bfd7da9b1e280fa8eb3332b83812f3aeac3a...451acb42dbf71d2902dbc9f2e2ab45294401e487,1,1,1,2,1,2013-07-18 06:15:50,2013-07-18 06:15:50
a34470ac5dedab1fbddcb674df0d54e6e87e36bc...3abfe029eaf75939d2ff05aad97eb40400e2876b,1,1,1,2,1,2013-07-18 20:35:55,2013-07-18 20:35:55
3abfe029eaf75939d2ff05aad97eb40400e2876b...5cb0d646865b0d92d38f695833c2ffd53323c6dd,1,1,1,2,1,2013-07-18 20:51:08,2013-07-18 20:51:08
5cb0d646865b0d92d38f695833c2ffd53323c6dd...63f070096bf2501657f14906e5ac68dff73121b1,1,1,1,2,1,2013-07-18 21:06:13,2013-07-18 21:06:13
63f070096bf2501657f14906e5ac68dff73121b1...36188d0884c51c9ef9aece3b2eaaa84ac67d0ff1,1,1,1,2,1,2013-07-18 21:08:40,2013-07-18 21:08:40
36188d0884c51c9ef9aece3b2eaaa84ac67d0ff1...a8005b3d0b8599611e8bfc864e704b50411fcb69,34,1,1,2,2,2013-07-19 00:41:30,2013-07-19 00:41:30
a8005b3d0b8599611e8bfc864e704b50411fcb69...7bb8817947dd6e453dc01a5131bc964a5d74e051,9,13,14,27,10,2013-07-19 01:14:49,2013-07-19 01:14:49
ae98f1803f09fae7e427075f99c19d218d68f46c...d7bc89b4334762e452c76458012305553cff7691,1,27,25,52,10,2013-04-14 02:04:01,2013-04-14 02:04:01
ae98f1803f09fae7e427075f99c19d218d68f46c...811a79e16c56fff81e970364c32cea720bf21ad3,1,4,0,4,1,2013-04-13 19:46:17,2013-04-13 19:46:17
811a79e16c56fff81e970364c32cea720bf21ad3...bec5679264d92b94c44c7d9ebe92c9f735ac0d07,1,6,0,6,1,2013-04-13 20:13:14,2013-04-13 20:13:14
bec5679264d92b94c44c7d9ebe92c9f735ac0d07...5fbe66307f145f921f1099a56908d70d1026ab55,1,5,4,9,2,2013-04-14 04:45:21,2013-04-14 04:45:21
b078050702d92551ab53545edfb484f39511278e...fda77e69eb825f6b098a303fedcc96d257b4b050,4,26,25,51,3,2012-01-30 00:58:51,2012-01-30 00:58:51
fda77e69eb825f6b098a303fedcc96d257b4b050...2ba1b01f8d9a0410d9cf45532d8924d858af74cd,1,7,0,7,1,2012-01-30 01:03:05,2012-01-30 01:03:05
90f2e8e196eaaf60256659d9a76205b66ba6e941...fae04c8ac1da675338c1cfaf3922223980667281,3,21,2,23,4,2012-01-30 03:04:26,2012-01-30 03:04:26
c63b793a0d0f7cd223dc988c2429f5f6c878a8b6...08fea3304ac8393ca5f549082f7e195e1762fb40,2,5,5,10,2,2013-05-03 03:33:12,2013-05-03 03:27:10
c63b793a0d0f7cd223dc988c2429f5f6c878a8b6...07117f97b6a156d1ddff0292c907599fb33d602a,2,4,10,14,8,2013-05-03 03:23:10,2013-05-03 03:22:27
c63b793a0d0f7cd223dc988c2429f5f6c878a8b6...a62e97091c6c1bd732a8f7e0761e724dfe50e0df,1,1,1,2,1,2013-05-02 17:03:54,2013-05-02 17:03:54
c63b793a0d0f7cd223dc988c2429f5f6c878a8b6...9cd3a92713bb8e2b78ea6496f69ee14ce1e46b3f,9,18,18,36,18,2013-05-02 06:05:00,2013-04-23 22:41:06
e74110bf4aeac89fe63cf6e73f48c36fdd00b392...5ab72f76878a85f105702a24096268fea73fba2d,4,4,4,8,4,2013-05-17 01:45:53,2013-05-17 01:45:53
d8b749a4d35b5a6f7a6ebba2bdac5651460aef27...94dec1bbd2e12eb6ef1c8b4f277041a8acbb278e,1,1,1,2,1,2013-05-17 01:37:00,2013-05-17 01:37:00
94dec1bbd2e12eb6ef1c8b4f277041a8acbb278e...d2b588b10eafc8b1d36ff23cf59f0f46d5f5e31e,1,0,9,9,1,2013-05-17 01:38:09,2013-05-17 01:38:09
d2b588b10eafc8b1d36ff23cf59f0f46d5f5e31e...c73588b3132b8c848f10561ad8f946f8c58a636b,4,0,57,57,4,2013-05-17 01:46:12,2013-05-17 01:46:12
7c94f5ef647dada658cdadc381b837c9c66c3336...cc5e6619b49d649632b9d76dfbdbf6329f978b7b,2,0,4,4,2,2013-05-09 20:09:33,2013-05-09 20:09:33
7c94f5ef647dada658cdadc381b837c9c66c3336...25b6df9944f59599642f1934fe7d13b0fa2c20db,1,0,0,0,0,2013-05-09 18:20:15,2013-05-09 18:20:15
25b6df9944f59599642f1934fe7d13b0fa2c20db...7fa6ae578b17012df67ce0cd3cdcad117f89df0a,5,13,13,26,7,2013-05-09 18:40:39,2013-05-09 18:40:39
7fa6ae578b17012df67ce0cd3cdcad117f89df0a...88a4712540d0efcaca0684dcb8fb236bd98fe2a9,1,21,21,42,19,2013-05-09 20:12:40,2013-05-09 20:12:40
62f76ad33f5a70c21f91e729963e049547ffc391...e5a9a1f5ff12bd0aa0159db4f12f46dcadf08456,1,0,8,8,1,2013-06-28 01:49:37,2013-06-28 01:49:37
e5a9a1f5ff12bd0aa0159db4f12f46dcadf08456...879d517cb353857e59b16cc7e8310ca4350ef99f,5,0,175,175,1,2013-06-28 01:49:59,2013-06-28 01:49:59
879d517cb353857e59b16cc7e8310ca4350ef99f...2981f0089f917deb39a6dd61a784c01aa2732e92,1,4,4,8,1,2013-06-28 01:51:06,2013-06-28 01:51:06
2981f0089f917deb39a6dd61a784c01aa2732e92...8cd5d0be71f51a857848b6c28b3f97dbbb838dee,4,20,4,24,5,2013-06-28 02:22:11,2013-06-28 02:22:11
3c60645ec023b48910946d3e2d1d10da5c851773...1b89a63a48f0bfd6ba024f1cf573c03a42aa5ef2,1,1,1,2,1,2013-06-20 22:38:18,2013-06-20 22:38:18
cfea6d295e697f82b25149f0c853e3a18fd11062...92977fb13e6a837cd0bc31cb2003fce7c235bf4b,1,1,1,2,1,2013-04-08 05:58:16,2013-04-08 05:58:16
cfea6d295e697f82b25149f0c853e3a18fd11062...c4d8aa2b0f1345ec9b51ad1e1fd9a9f61a3f5502,3,331,1070,1401,1163,2013-04-07 21:47:53,2013-04-07 21:47:53
c4d8aa2b0f1345ec9b51ad1e1fd9a9f61a3f5502...a05ff7e50749e7ca0bbc5eebf3fa16d8b24198f2,2,12,12,24,8,2013-04-07 21:52:12,2013-04-07 21:52:12
647e930e4971a35b5ca1e547e38f88d31c05d582...c78c66527dcb9b2481fd0494081adf4e9ebe94bd,1,5,0,5,1,2013-04-07 14:25:00,2013-04-07 14:25:00
9da90adb4ca09e4c3b5ec549211c07292ec38d71...08b3515fd7dfa76cdbb92d52a15d6797f3a1c4ed,5,11,18,29,12,2013-07-02 02:42:43,2013-07-02 02:42:26
08b3515fd7dfa76cdbb92d52a15d6797f3a1c4ed...5b2d933524616c9948c9e5229c14e109aa83727a,2,14,0,14,2,2013-07-02 02:49:29,2013-07-02 02:49:29
a049dcb7f60def107be3a141de811e5a875e8049...749dc35328862896d613bfe72fc961e490037fad,2,3,2,5,2,2013-07-02 03:18:44,2013-07-02 03:18:44
1f48e837000c8c2ec701c1442fa003ab836f818f...7d9fb1dda7a3009e986364b714313037bfb67d0c,2,3,4,7,4,2013-07-18 22:28:38,2013-07-18 22:28:38
7d9fb1dda7a3009e986364b714313037bfb67d0c...820558916f6b8d7d333de6d4d21404b75fd40fc2,2,20,3,23,5,2013-07-18 22:36:41,2013-07-18 22:36:41
ca8ca2177fd5b8e6523bd1599784b129c2d75937...5156234c23956cb944469173f28ffd5a85966f55,1,1,3,4,2,2013-06-28 02:54:30,2013-06-28 02:54:30
5156234c23956cb944469173f28ffd5a85966f55...d9a662ed1dbe3dbfe30980d45c831e3b454bff86,2,2,0,2,2,2013-06-28 03:15:44,2013-06-28 03:15:44
451acb42dbf71d2902dbc9f2e2ab45294401e487...ba0c6cd57c74be0438a5026d89c67be97f8694d3,2,8,7,15,3,2013-07-18 06:33:34,2013-07-18 06:33:34
ba0c6cd57c74be0438a5026d89c67be97f8694d3...d3a139622e50a5bbb29255eaca701d815dee716b,3,6,3,9,4,2013-07-18 06:34:04,2013-07-18 06:34:04
451acb42dbf71d2902dbc9f2e2ab45294401e487...8cf04911db36b1ad5f4a98db51b44050c78df18a,5,41,16,57,9,2013-07-18 06:25:26,2013-07-18 06:25:26
8cf04911db36b1ad5f4a98db51b44050c78df18a...59f847e8eef64c4adbc57a682ad626e068370b30,1,36,0,36,1,2013-07-18 06:30:05,2013-07-18 06:30:05
f771bf140d0ce64ccba63f5295a68600294fdc93...0a3722112c9dff08785689051e581857cce572de,2,11,0,11,3,2013-07-19 01:33:20,2013-07-19 01:33:20
382a86f46e91969d185bd79f8e535f3264615ede...fc8b9fb07df5d63a162c94ba165bc3759ec2a889,2,16,12,28,14,2013-04-14 05:10:34,2013-04-14 05:10:34
fc8b9fb07df5d63a162c94ba165bc3759ec2a889...20259e23505fdcb1a898be42ae27ff94f0d8884b,1,66,66,132,2,2013-04-14 05:48:44,2013-04-14 05:48:44
20259e23505fdcb1a898be42ae27ff94f0d8884b...eefddb1eab113de7aeb5d23c856e872841b4bef9,1,12,12,24,2,2013-04-14 05:49:21,2013-04-14 05:49:21
eefddb1eab113de7aeb5d23c856e872841b4bef9...86bb3b8126c94ee8c839eac4d9120f3edeafefdd,2,6,8,14,4,2013-04-14 06:17:39,2013-04-14 06:17:39
86bb3b8126c94ee8c839eac4d9120f3edeafefdd...f226463b057f945795661c3d19fbcabf63b931f7,2,2,0,2,2,2013-04-14 06:54:51,2013-04-14 06:54:51
2ba1b01f8d9a0410d9cf45532d8924d858af74cd...ae7f94eeff733584cbdc80a2d13a85f136a7744e,21,429,408,837,88,2012-01-30 08:39:44,2012-01-30 08:39:44
0de951f4f41c798dead8525e78153fc6c5da1479...f9b53d424e55bca4c7efe6220d36acafaee613cd,1,1,1,2,1,2012-01-30 05:14:07,2012-01-30 05:14:07
5ab72f76878a85f105702a24096268fea73fba2d...140ef2320bbb96ad90b73a884d83198706affaf9,22,105,103,208,102,2013-05-17 03:19:51,2013-05-17 03:19:51
bdd50228331128668be6e9cd68e1f6794b620243...e5d6a40a7781daea884dc4472e5eb3f1705a8498,5,44,42,86,32,2013-05-17 02:13:58,2013-05-17 02:13:58
e5d6a40a7781daea884dc4472e5eb3f1705a8498...af0b9cb41a5d86726c622529c5b8f8a43cd18e45,2,36,21,57,6,2013-05-17 03:07:41,2013-05-17 03:07:41
af0b9cb41a5d86726c622529c5b8f8a43cd18e45...55a1416789c9c9f448528926016d0fa97f233578,1,0,3,3,1,2013-05-17 03:07:48,2013-05-17 03:07:48
55a1416789c9c9f448528926016d0fa97f233578...1983ca03ec4f84bf9076d9327bc966caffda4ea6,4,12,12,24,12,2013-05-17 03:17:42,2013-05-17 03:17:42
1983ca03ec4f84bf9076d9327bc966caffda4ea6...5dd6dbd6240575db20f040fff8c112241adf8aea,1,0,8,8,1,2013-05-17 03:18:03,2013-05-17 03:18:03
5dd6dbd6240575db20f040fff8c112241adf8aea...8a3e98230544cd2197a57c6e9cb01e3ceeb7a678,1,2,2,4,2,2013-05-17 03:29:50,2013-05-17 03:29:50
ec39bed94f5b5d2145a926dbd9c0445b6451f2ec...d5e6bbba27a4193f02ca488f84057cfb2eeafb36,1,7,7,14,4,2013-05-09 20:28:05,2013-05-09 20:28:05
eee719f608cd0e1fe9db7cd1206b1d4dc2078bd5...2fccf927c5320a4dfe3ad58b0a2752ed8f15354e,1,1,0,1,1,2013-06-20 23:02:05,2013-06-20 23:00:38
2fccf927c5320a4dfe3ad58b0a2752ed8f15354e...2aec6dae597b69502d09aec983598e5f955ca558,5,5,9,14,5,2013-06-20 23:02:05,2013-06-20 23:01:59
2aec6dae597b69502d09aec983598e5f955ca558...4db90244c41c26492b4efa5d3a8694fc61cd1f9b,1,2,1,3,2,2013-06-20 23:27:39,2013-06-20 23:27:39
4db90244c41c26492b4efa5d3a8694fc61cd1f9b...90d4343f66d1cdafe24b6de0dbb6ae64312df323,2,0,29,29,2,2013-06-20 23:42:05,2013-06-20 23:42:05
90d4343f66d1cdafe24b6de0dbb6ae64312df323...82f9de94593ea5dd8a8efd6a317a6c8b319cfff2,2,63,51,114,4,2013-06-21 00:02:10,2013-06-21 00:02:10
82f9de94593ea5dd8a8efd6a317a6c8b319cfff2...ef8e5853cbfc4f4babacd3527ab3eb0e4b741acc,2,12,0,12,4,2013-06-21 00:15:09,2013-06-21 00:15:09
749dc35328862896d613bfe72fc961e490037fad...817972724afa3e8f12d6a1376820490d3c430184,4,1,10,11,5,2013-07-05 19:11:12,2013-07-05 19:11:12
749dc35328862896d613bfe72fc961e490037fad...2d56997c613ed77d2e7a85409e9a36289260bc76,1,0,21,21,14,2013-07-03 15:11:28,2013-07-03 15:11:28
749dc35328862896d613bfe72fc961e490037fad...5b69d3405301ebf9f7047a459f727cbe5f73aedd,3,5,12,17,6,2013-07-03 12:37:36,2013-07-03 12:37:36
749dc35328862896d613bfe72fc961e490037fad...da072fff21f565521d3dbe1f5f4f42550ecc989e,2,66,48,114,15,2013-07-02 18:42:37,2013-07-02 18:25:57
0682068929a97825095329f635ca581f574209b6...89117ec6b2c814c9629f2a2a0763a64582af1cce,1,18,0,18,6,2013-06-28 03:18:16,2013-06-28 03:18:16
89117ec6b2c814c9629f2a2a0763a64582af1cce...bf3c5e070e2ee74181aa8b2c75f32387827b01c2,4,2,206,208,6,2013-06-28 03:49:29,2013-06-28 03:49:29
bf3c5e070e2ee74181aa8b2c75f32387827b01c2...88ece4fc5902f7dd9582fb4e5956062fe97af84c,2,52,0,52,4,2013-06-28 03:50:21,2013-06-28 03:50:00
4d73aa60f953e0cb6c3b871d11a5c95617d0ca5b...3604b868064f6e48e1301b1148779a8a819200fc,1,1,1,2,1,2013-07-18 06:41:05,2013-07-18 06:41:05
3604b868064f6e48e1301b1148779a8a819200fc...e57758cbb453602549742360120653e08863671f,5,45,40,85,8,2013-07-18 06:54:09,2013-07-18 06:54:09
e57758cbb453602549742360120653e08863671f...bc79f8a399a01a8dc1c814a48103aadb11457ee6,2,2,2,4,2,2013-07-18 06:55:58,2013-07-18 06:55:58
bc79f8a399a01a8dc1c814a48103aadb11457ee6...e5bfd8c00b906b5be8030e2871399fe3634bf6e5,1,0,1,1,1,2013-07-18 06:56:20,2013-07-18 06:56:20
59f847e8eef64c4adbc57a682ad626e068370b30...b13eecaeec6f27db8d83a8808ed4178033370e05,1,8,7,15,4,2013-07-18 06:52:29,2013-07-18 06:52:29
0a3722112c9dff08785689051e581857cce572de...e440ff4b3f872af175873283899cb40f50b8010f,5,25,9,34,15,2013-07-19 02:53:32,2013-07-19 02:53:32
0a3722112c9dff08785689051e581857cce572de...3e8b3a246a3a7142f969ade63bbe21948085f4f2,1,1,1,2,1,2013-07-19 01:41:42,2013-07-19 01:41:42
3e8b3a246a3a7142f969ade63bbe21948085f4f2...896d159987299749b00909ed8fd68af3b2b9ff32,1,0,1,1,1,2013-07-19 02:09:33,2013-07-19 02:09:33
f226463b057f945795661c3d19fbcabf63b931f7...5f88887c7e979999e4852fa6207b7b2ba266db93,4,41,82,123,26,2013-04-14 19:49:35,2013-04-14 19:49:35
f226463b057f945795661c3d19fbcabf63b931f7...2b228bae60d652f07c38e5e52fa976e67ac2e99c,1,130,21,151,23,2013-04-14 16:36:11,2013-04-14 16:36:11
2b228bae60d652f07c38e5e52fa976e67ac2e99c...f78945ccc9c848318f2a2e58d3ea1cc2c3ea6b61,1,3,0,3,1,2013-04-14 19:54:02,2013-04-14 19:54:02
f78945ccc9c848318f2a2e58d3ea1cc2c3ea6b61...32761b33036eb3a0e186d310b56877b1c994ac89,1,41,43,84,38,2013-04-14 19:54:56,2013-04-14 19:54:56
32761b33036eb3a0e186d310b56877b1c994ac89...0a84a7c43d6eedcf25997857ed7ea30979108354,1,4,4,8,4,2013-04-14 19:56:21,2013-04-14 19:56:21
0a84a7c43d6eedcf25997857ed7ea30979108354...ccb6ac570f7b4cc022c29f42a4b36c667ba6eb1e,1,2,1,3,1,2013-04-14 20:00:53,2013-04-14 20:00:53
ccb6ac570f7b4cc022c29f42a4b36c667ba6eb1e...526534f337b1c2b60b08189618988256f0775cbd,1,2,3,5,2,2013-04-14 20:01:00,2013-04-14 20:01:00
0f088af855908dc2e093772cfcf54c30893b952a...dc3d2b1044afa5633291f856b451543f17ecd690,3,8,0,8,2,2012-01-30 08:44:27,2012-01-30 08:44:27
dc3d2b1044afa5633291f856b451543f17ecd690...8b77722a936f989cecaf93f97aa86d6ed8fdfa05,1,97,83,180,11,2012-01-30 09:06:20,2012-01-30 09:06:20
8b77722a936f989cecaf93f97aa86d6ed8fdfa05...8f448610a944efd134170f44e305ec6710bcff1a,16,18,18,36,28,2012-01-30 09:09:34,2012-01-30 09:09:34
8f448610a944efd134170f44e305ec6710bcff1a...db31efb99587cea660ba5359665b4a6828d9f384,1,5,5,10,4,2012-01-30 09:18:45,2012-01-30 09:18:45
db31efb99587cea660ba5359665b4a6828d9f384...f4e5bc1c536f0e2bd77958dd5575863808d4cfe4,4,32,32,64,8,2012-01-30 09:20:51,2012-01-30 09:20:51
f4e5bc1c536f0e2bd77958dd5575863808d4cfe4...144789788f123a8642c72082fd674125cac52a6e,3,8,0,8,2,2012-01-30 09:24:02,2012-01-30 09:24:02
144789788f123a8642c72082fd674125cac52a6e...175fd98a7c4668dbb5441ebf3ebc616b29bd8210,3,2,2,4,2,2012-01-30 09:25:02,2012-01-30 09:25:02
175fd98a7c4668dbb5441ebf3ebc616b29bd8210...160a0bf5608c00cc99465199d41c45177634b585,1,4,4,8,2,2012-01-30 09:30:18,2012-01-30 09:30:18
160a0bf5608c00cc99465199d41c45177634b585...33a969dd0c47d1e79b8c671eb2942383bf71f49f,5,22,12,34,4,2012-01-30 09:34:59,2012-01-30 09:34:59
33a969dd0c47d1e79b8c671eb2942383bf71f49f...9ba70796e2a25154689fa428d07018e877bbd6e4,3,2,2,4,2,2012-01-30 15:40:24,2012-01-30 15:40:24
9ba70796e2a25154689fa428d07018e877bbd6e4...9f5b619094e9023d775e2ebd438ed2d327baeda2,3,158,4,162,6,2012-01-30 15:49:28,2012-01-30 15:49:28
9f5b619094e9023d775e2ebd438ed2d327baeda2...2c8ca4f5e284d5160e021071ec5cda46710bb78d,2,14,1,15,2,2012-01-30 15:54:47,2012-01-30 15:54:47
2c8ca4f5e284d5160e021071ec5cda46710bb78d...a8400009dac99819c25e8b55c737f67810c35649,1,29,0,29,1,2012-01-30 15:59:24,2012-01-30 15:59:03
a8400009dac99819c25e8b55c737f67810c35649...a29dee44aca68585b04ef5156dd4f0a50ae70db0,2,0,29,29,1,2012-01-30 16:04:48,2012-01-30 16:04:48
a29dee44aca68585b04ef5156dd4f0a50ae70db0...2d40b07afc62ce9d899a290ab33222fd18287190,8,54,8,62,18,2012-01-30 16:15:28,2012-01-30 16:15:28
2d40b07afc62ce9d899a290ab33222fd18287190...3722c34b5032e5f1d4f6e8d28260b16ee48af4da,3,9,0,9,2,2012-01-30 16:20:37,2012-01-30 16:20:37
3722c34b5032e5f1d4f6e8d28260b16ee48af4da...774904464dc8237b36be8197ca7c91d701ce4f0e,3,4,4,8,2,2012-01-30 16:58:40,2012-01-30 16:58:40
774904464dc8237b36be8197ca7c91d701ce4f0e...ac581eebac209ce20591bac2f726f35a9b22d750,6,2,0,2,2,2012-01-30 17:19:25,2012-01-30 17:19:25
ac581eebac209ce20591bac2f726f35a9b22d750...e94e0f1cf94e8232933a05cfe61efdb49dd64249,4,3,3,6,4,2012-01-30 17:41:31,2012-01-30 17:41:31
e94e0f1cf94e8232933a05cfe61efdb49dd64249...74f2a89611b818fda662dbbbb5d978549cae14c2,3,2,2,4,2,2012-01-30 18:01:02,2012-01-30 18:01:02
74f2a89611b818fda662dbbbb5d978549cae14c2...155047c3e6cfe589f1f244cdeb4e37244ab206ca,3,3,1,4,3,2012-01-30 21:59:05,2012-01-30 21:59:05
155047c3e6cfe589f1f244cdeb4e37244ab206ca...21bebe77feb9265b06d65e1e941cf7c73c4d90c1,6,471,460,931,25,2012-01-31 04:50:51,2012-01-31 04:50:51
21bebe77feb9265b06d65e1e941cf7c73c4d90c1...0f3a073b8dca534e78c09b71999d5a2632e2245d,18,232,232,464,130,2012-01-31 05:15:57,2012-01-31 05:15:57
0f3a073b8dca534e78c09b71999d5a2632e2245d...31911659a200d39d8494f35f8fd71863ac1226d0,13,179,179,358,156,2012-01-31 05:29:50,2012-01-31 05:29:50
31911659a200d39d8494f35f8fd71863ac1226d0...47a68ae3aa8cad828eebe529403b46210c9d9d16,10,575,572,1147,183,2012-01-31 06:57:00,2012-01-31 06:57:00
47a68ae3aa8cad828eebe529403b46210c9d9d16...1cff29c33f97fc40de1f8d582d7b1a3f4c7783c5,3,0,2,2,2,2012-01-31 07:02:24,2012-01-31 07:02:24
1cff29c33f97fc40de1f8d582d7b1a3f4c7783c5...61b47e91b800e022f1736da772eb23aa9077f2f1,4,18,18,36,9,2012-01-31 07:10:29,2012-01-31 07:10:29
61b47e91b800e022f1736da772eb23aa9077f2f1...5c9a687665f7851435e29b28afb02b450a5903a4,3,4,4,8,4,2012-01-31 07:16:27,2012-01-31 07:16:27
5c9a687665f7851435e29b28afb02b450a5903a4...de994efac76aa9f3955c150115ff3ea75d084c1c,1,0,0,0,0,2012-01-31 07:17:05,2012-01-31 07:17:05
de994efac76aa9f3955c150115ff3ea75d084c1c...d533310bd2fa157edb076f9047af8f1cff0fca05,8,304,304,608,42,2012-01-31 07:24:35,2012-01-31 07:24:35
d533310bd2fa157edb076f9047af8f1cff0fca05...4d93b639164f4331dc8b52ae1bcb824dddb97370,3,2,0,2,2,2012-01-31 07:27:58,2012-01-31 07:27:58
2433a076acc4dc318d238fd78361130a92e0a341...abc49c729bdc54c8a66174ad802c83e577f8d80f,3,75,65,140,65,2013-05-17 03:42:31,2013-05-17 03:42:31
0f4b4acce1df7f2cdfc6e0ad6dca59480868bd8d...9762f95bde0fc251aa42d2e843cf5885f264cca3,5,39,18,57,11,2013-05-17 03:53:59,2013-05-17 03:53:59
9762f95bde0fc251aa42d2e843cf5885f264cca3...c0f5a0775d1b62deea29379d7b54eb8c4e2979c9,2,51,51,102,48,2013-05-17 03:54:06,2013-05-17 03:54:06
d5e6bbba27a4193f02ca488f84057cfb2eeafb36...9716b73f67de690d008cbfc8f1375ee85cd2539d,2,32,128,160,17,2013-05-09 21:48:27,2013-05-09 21:48:27
d5e6bbba27a4193f02ca488f84057cfb2eeafb36...7a7971d6db31587d3b283178ddf9dc26a7d19cf8,2,11,4,15,4,2013-05-09 21:08:06,2013-05-09 21:08:06
7a7971d6db31587d3b283178ddf9dc26a7d19cf8...293a3baca36fb8788fb75d331439f143f6762fc1,3,58,192,250,29,2013-05-09 22:05:06,2013-05-09 22:05:06
293a3baca36fb8788fb75d331439f143f6762fc1...3c72b1e9a0a56ad46fe7f330141ca18f6b348649,1,0,1,1,1,2013-05-09 23:31:10,2013-05-09 23:31:10
3c72b1e9a0a56ad46fe7f330141ca18f6b348649...7b6352d2cf6f04b46918b1cc8bad50ff92fdbe07,4,26,10,36,13,2013-05-09 23:41:35,2013-05-09 23:41:35
7b6352d2cf6f04b46918b1cc8bad50ff92fdbe07...6fba68eb8b036fad1bc4f33484889cccf2480bff,8,124,128,252,89,2013-05-10 00:20:46,2013-05-10 00:20:46
6fba68eb8b036fad1bc4f33484889cccf2480bff...a19fda699daa56bb0e3fc1b9f3c48762cdab893f,1,1,1,2,1,2013-05-10 00:21:18,2013-05-10 00:21:18
d5e6bbba27a4193f02ca488f84057cfb2eeafb36...4a03d456514a5c352a4ac5ee1eed1f7154b67f6a,2,2,0,2,2,2013-05-09 20:48:02,2013-05-09 20:48:02
ef8e5853cbfc4f4babacd3527ab3eb0e4b741acc...ac1058e4355b9492dc78e2aa6add08f0435fbbac,1,6,6,12,6,2013-06-21 01:44:19,2013-06-21 01:44:19
14056409c3c5ddc2e77a5829b6a99a1e809a811b...88a266b800a74b8445d06ac2fcb70ab97f035dfd,2,17,7,24,10,2013-07-05 19:15:00,2013-07-05 19:15:00
88a266b800a74b8445d06ac2fcb70ab97f035dfd...61823dbff1377443203f6ef6a98b8202b57abb29,3,19,17,36,4,2013-07-05 19:21:05,2013-07-05 19:21:05
d483e77553763813d90fb26b44146a9bf7edc298...3bd42511f41d6ea0ee1aa51535267ab19d3bbd20,2,56,46,102,3,2013-07-05 12:17:20,2013-07-05 12:17:20
3bd42511f41d6ea0ee1aa51535267ab19d3bbd20...969529c80eaa4946964c1e393b4cad420d13f4b2,2,8,8,16,2,2013-07-05 12:18:57,2013-07-05 12:18:57
d483e77553763813d90fb26b44146a9bf7edc298...e6529e9588bed07af84daeb7af2651f05cb9220e,2,0,10,10,2,2013-07-05 07:09:16,2013-07-05 07:09:16
02bddac091f7b6f1a0eaade272d24316088aae15...f757cf4cf312a55d44b6484692efe080107b7342,1,3,24,27,10,2013-07-18 07:50:57,2013-07-18 07:50:57
2a4a0f70ef6dde303d92ee2bcc082d9e9aad181b...37e899d76630d29565c0c6ff67885eee01777e1a,7,52,34,86,27,2013-07-18 07:59:31,2013-07-18 07:59:31
37e899d76630d29565c0c6ff67885eee01777e1a...4b40ee692dc066f2ad3c4dd96af67a83475f5cbe,4,15,15,30,7,2013-07-18 08:07:11,2013-07-18 08:07:11
e6906040de5d3d7eb9835185b6b903fd2f9ffc40...87adbf7aa4eb4ba73813f440d8baf05a3cb434f2,2,9,8,17,5,2013-07-18 06:56:38,2013-07-18 06:56:38
87adbf7aa4eb4ba73813f440d8baf05a3cb434f2...79a10feb7aaebfb8714f1b8abb0bcbb44eb53d65,3,63,24,87,15,2013-07-18 07:10:22,2013-07-18 07:10:22
79a10feb7aaebfb8714f1b8abb0bcbb44eb53d65...e7bc9e1c3d60c2ac748896fcc0e31855f63590ef,1,2,1,3,1,2013-07-18 07:23:35,2013-07-18 07:23:35
49f2f7fad9a0364a2d971b4c9f8e2969b29cc15b...bbe0d0d87460cf99262c8fec1e8e9bca69258aec,1,2,2,4,2,2013-07-19 04:04:58,2013-07-19 04:04:58
0b3e9ced54e8839e951e41ebb2ee15b749db0d17...8d9106f2c50d4eb1e3648ad6db07e03f4c15f4d8,2,1,56,57,2,2013-04-14 22:32:52,2013-04-14 22:32:52
8d9106f2c50d4eb1e3648ad6db07e03f4c15f4d8...7dca242b5e9563ce0d4ea4820557ace18519b8b6,7,0,4,4,1,2013-04-14 22:33:48,2013-04-14 22:33:48
7dca242b5e9563ce0d4ea4820557ace18519b8b6...02eba5e5fc624189fdbc154ab1adc81275d027bb,1,4,4,8,4,2013-04-14 23:31:52,2013-04-14 23:31:52
526534f337b1c2b60b08189618988256f0775cbd...ab7070bb49cf4cd68d19c84ce5a50ee939b9589d,3,6,6,12,6,2013-04-15 02:45:32,2013-04-15 02:45:32
ab7070bb49cf4cd68d19c84ce5a50ee939b9589d...5471ce8ea3471562cc56dd3e349982c54f6ed624,2,96,84,180,26,2013-04-15 03:33:54,2013-04-15 03:33:10
4d93b639164f4331dc8b52ae1bcb824dddb97370...b7713b83fa25f4b28869fe846b04baac00ca781b,17,606,606,1212,195,2012-01-31 08:11:19,2012-01-31 08:11:19
4d93b639164f4331dc8b52ae1bcb824dddb97370...d633dbb44e40f402c85d4339bb3ac0e7069915eb,2,10,10,20,10,2012-01-31 07:54:10,2012-01-31 07:54:10
e94e5e8b40b53a71b38d938aee4d4d3429477f4e...5fbb9e9f5d241744dc2e2cbd1bfd8676c566f22d,3,0,10,10,3,2013-05-17 04:03:56,2013-05-17 04:03:29
5fbb9e9f5d241744dc2e2cbd1bfd8676c566f22d...5f7352a6fe5f7a7eef4dce64184f55d1fec2676b,3,23,2,25,5,2013-05-17 05:11:31,2013-05-17 05:11:31
5f7352a6fe5f7a7eef4dce64184f55d1fec2676b...35573db810fbcbb9d7aefde090fbad3dbd332271,2,13,0,13,2,2013-05-20 05:06:10,2013-05-20 05:06:10
35573db810fbcbb9d7aefde090fbad3dbd332271...0c167a1d9dd7a8e4a1a6877ed0b23f5910a71ca2,2,3,3,6,2,2013-05-20 05:12:48,2013-05-20 05:12:48
0c167a1d9dd7a8e4a1a6877ed0b23f5910a71ca2...13a4fb678ba2fbaf4a0bac650ecf5110fbb257e8,1,27,9,36,9,2013-05-20 07:25:41,2013-05-20 07:25:41
13a4fb678ba2fbaf4a0bac650ecf5110fbb257e8...554c24d9ae740f59f78c8494337e67cf5c36670c,1,5,13,18,4,2013-05-20 07:33:08,2013-05-20 07:33:08
554c24d9ae740f59f78c8494337e67cf5c36670c...930913e0a0a7ab7f7b69fd97fc631bb9121e46aa,1,1,1,2,1,2013-05-20 17:45:01,2013-05-20 17:45:01
90e4ff73d25e426cf19bb84392510f78e2cd2fd8...94cc3335536507124451de1c9ec673f7dfcb5c2a,7,9,9,18,8,2013-05-10 15:21:27,2013-05-10 15:21:27
90e4ff73d25e426cf19bb84392510f78e2cd2fd8...3af1dd1dc861fdb2814d49c88160586f467da504,1,1,1,2,1,2013-05-10 11:37:14,2013-05-10 11:37:14
90e4ff73d25e426cf19bb84392510f78e2cd2fd8...dbbd48f7bcc476d7e7f4780d6b342f1bce581ff0,2,0,15,15,2,2013-05-10 00:29:07,2013-05-10 00:29:07
dbbd48f7bcc476d7e7f4780d6b342f1bce581ff0...562483b907860bc522fb34b3f76f96943d58ed85,2,25,9,34,6,2013-05-10 00:32:39,2013-05-10 00:32:39
562483b907860bc522fb34b3f76f96943d58ed85...e34abd02cc6d0a7d226dd0dc5a5dea59d53757de,2,8,4,12,6,2013-05-10 00:36:02,2013-05-10 00:36:02
e34abd02cc6d0a7d226dd0dc5a5dea59d53757de...758cb9d186e3fd9fbc94162d15a5ee0dfb1f9ef9,1,1,1,2,1,2013-05-10 17:29:54,2013-05-10 17:29:54
8f9cc5ae81794cc25154ab21a845c9d77ef47e78...579d566299c82fe91e5202b30ec2b2b062e0d902,3,66,86,152,32,2013-05-09 23:53:28,2013-05-09 23:26:35
2535e060a48393143e7a6c2eb93a0a5d06663801...8ef3df418f5f9a9b9a8dc2d0f41a3cf16447c8af,1,6,6,12,6,2013-06-21 13:59:34,2013-06-21 13:59:34
8ef3df418f5f9a9b9a8dc2d0f41a3cf16447c8af...9d43fbb57eb3ca0b1e7797365f548556600addc3,1,0,4,4,1,2013-06-21 14:03:28,2013-06-21 14:03:28
fffb37ecead04a12c9c1aedaf357433f5f61d6a3...95655e72754b9450d04108593f60647cf2e2241c,2,0,105,105,13,2013-07-05 19:27:54,2013-07-05 19:27:54
1363ffa473a7f68e540563632aaf8293cf1be5fc...8dc7807dcdd67881280ea8d7d3f58bc7ce5b31ca,2,7,5,12,5,2013-07-18 07:48:02,2013-07-18 07:48:02
710dbb5260a2cce13e613865c374ef36d71b7cdc...95be924926aff0bc80589eefa2660ebc673ff2fb,2,9,2,11,3,2013-07-19 13:18:01,2013-07-19 13:18:01
95be924926aff0bc80589eefa2660ebc673ff2fb...b37127e2fcb35ea992043c508231f9476302b653,2,7,3,10,4,2013-07-19 13:29:19,2013-07-19 13:29:19
b37127e2fcb35ea992043c508231f9476302b653...5e898fa2a1564f3103017874aea0c993fffe26cc,2,8,3,11,4,2013-07-19 13:39:51,2013-07-19 13:39:51
5e898fa2a1564f3103017874aea0c993fffe26cc...65ee36a7bf403588a105b09aae5ffa141f47a97f,4,11,14,25,9,2013-07-19 18:14:13,2013-07-19 18:14:13
710dbb5260a2cce13e613865c374ef36d71b7cdc...6f9ed7efeb0a4f3252f0f11d53d5f9be065abc4f,1,4,0,4,1,2013-07-19 10:28:26,2013-07-19 10:28:26
5b38a1a3578c7e1f69dd6b0005cbf04c173b844c...a8391da414fe1e2f7bd0abba1bae3290789d71da,1,3,10,13,10,2013-04-18 19:46:31,2013-04-18 19:46:31
5b38a1a3578c7e1f69dd6b0005cbf04c173b844c...dc97a1967b81e994ebb31ed3cad89f58794b46b9,2,173,151,324,24,2013-04-16 14:45:51,2013-04-16 14:45:51
bd9221ddc0fa0c14da65df89f8f6fb6c88ef85a1...a6253f0937a5d1f0bd18655729bff03bd5373f17,3,4,4,8,2,2012-01-31 08:15:43,2012-01-31 08:15:43
930913e0a0a7ab7f7b69fd97fc631bb9121e46aa...ddbfe4af7a4ad0732bc78de5db00491e0723b302,1,1,1,2,1,2013-05-21 21:43:12,2013-05-21 21:43:12
ddbfe4af7a4ad0732bc78de5db00491e0723b302...bb9d867cf83d6a9aed27f390b844fc02ad13ebc4,1,0,12,12,1,2013-05-22 02:56:25,2013-05-22 02:56:25
930913e0a0a7ab7f7b69fd97fc631bb9121e46aa...230d6de88aac73077a01f3d66d2bd498d553cb7e,1,5,5,10,2,2013-05-21 20:25:59,2013-05-21 20:25:59
230d6de88aac73077a01f3d66d2bd498d553cb7e...c47d9932cb8a9d8dedf900f62918e70f7a1f5a50,1,2,2,4,1,2013-05-21 20:29:35,2013-05-21 20:29:35
930913e0a0a7ab7f7b69fd97fc631bb9121e46aa...9a2218dd38cd34a27a8885941a55dc880db8c45f,1,1,1,2,1,2013-05-21 06:23:19,2013-05-21 06:23:19
8261866ff2657cc8e57d0c4ab689b742d70b4c78...76ecfdfdc1ef06997eafdeef68d7a9a945614af3,4,82,85,167,70,2013-05-10 17:33:35,2013-05-10 17:33:35
8051695c87d7420862307090ac49ca2d1e74b40b...60c24ddd976f24ac773c27d091a5a2559f54d2b0,2,12,8,20,4,2013-05-11 16:38:48,2013-05-11 16:38:48
8051695c87d7420862307090ac49ca2d1e74b40b...5e13f578706fd7339e8a5bc1e1c10370410ef765,2,339,1093,1432,1163,2013-05-11 13:58:59,2013-05-11 13:58:59
5e13f578706fd7339e8a5bc1e1c10370410ef765...9880f7c80305ee37737c44b0dd7e20337ee64628,1,13,13,26,9,2013-05-11 14:04:59,2013-05-11 14:04:59
9880f7c80305ee37737c44b0dd7e20337ee64628...23b32fec656f0193010682311879478bfc9e6297,1,1057,303,1360,1145,2013-12-04 20:06:19,2013-12-04 20:06:19
23b32fec656f0193010682311879478bfc9e6297...3b6b9b3fa6eea8e783d23c371cad8c54d711c940,1,1,1,2,1,2013-05-12 06:55:47,2013-05-12 06:55:47
3b6b9b3fa6eea8e783d23c371cad8c54d711c940...ca5685c1f8152acbde91d68e68dc4051aaa6fdb4,1,1,1,2,1,2013-05-12 06:55:56,2013-05-12 06:55:56
356100e74e474c48eade378d3a6ce8d58880379b...eba9b4de6c5d2dfe49ba6d2484307b1d6542620a,1,3,1,4,1,2013-06-21 18:56:47,2013-06-21 18:56:47
eba9b4de6c5d2dfe49ba6d2484307b1d6542620a...b0e943399df374b03f9ed5f676f33e42f5e53a74,3,6,4,10,4,2013-06-22 00:21:44,2013-06-22 00:21:44
95655e72754b9450d04108593f60647cf2e2241c...e40aee9c9e3e80b03ebe00e812262da09c43bc11,2,4,8,12,8,2013-07-08 03:03:52,2013-07-07 05:24:03
95655e72754b9450d04108593f60647cf2e2241c...d2fb35d546701325686487fafca73d992b2bb74a,2,13,16,29,5,2013-07-07 22:44:18,2013-07-07 22:06:16
95655e72754b9450d04108593f60647cf2e2241c...a7dd1088d247b533c483afb0cde85e9c49ab5ea7,2,16,28,44,5,2013-07-07 22:38:43,2013-07-07 21:26:51
95655e72754b9450d04108593f60647cf2e2241c...15bd6eadf39c4bbd5ac0971e9d77d26ab85635af,1,41,32,73,5,2013-07-07 22:31:18,2013-07-07 04:51:47
95655e72754b9450d04108593f60647cf2e2241c...f12d6401f22bc4c4f46bb8fa7fb2e7cf087b99d9,1,15,11,26,2,2013-07-07 22:27:06,2013-07-07 05:07:03
95655e72754b9450d04108593f60647cf2e2241c...e757ddd60fb48849159e19abb9ebbc6df10fc78d,2,17,27,44,4,2013-07-07 22:21:40,2013-07-07 05:01:34
95655e72754b9450d04108593f60647cf2e2241c...8a84da6341e19011ce8f8e518d7b1cb7f0931da5,3,39,10,49,13,2013-07-06 18:26:40,2013-07-06 18:20:56
416fd9d19b9f3f302bcf4479a202b041ff621a1b...b8348416b076453a23a99e3cf80be51e7ab64d84,1,3,0,3,1,2013-07-19 18:23:17,2013-07-19 18:23:17
b1819755b8f962be7e2d85f4145a71c6cfbe4d7d...4b0fa356f3c00c850ec56815f8a8e07eb927c960,4,28,25,53,13,2013-07-19 18:44:35,2013-07-19 18:44:35
4b0fa356f3c00c850ec56815f8a8e07eb927c960...f25d8c008041bbc6a008fab92915ca0073941ff0,3,32,26,58,3,2013-07-19 21:08:16,2013-07-19 21:08:16
f25d8c008041bbc6a008fab92915ca0073941ff0...95b9f44190813b578c6724680090f3b85b9fcf82,3,19,1,20,3,2013-07-19 23:49:38,2013-07-19 23:49:38
90b195872e0c88c337be8eb9c032d1952c75e578...afdab35aca4ccfbe9214c4cdf6f6b1d2da595cad,2,13,17,30,19,2013-04-20 19:09:08,2013-04-20 19:09:08
da35a6b4377e52e5509431dc5d60711e44f1430c...7b5fcc2c9ae7631e114cec106c2f14c560617cbd,2,0,4,4,2,2013-04-19 00:48:08,2013-04-19 00:48:08
da35a6b4377e52e5509431dc5d60711e44f1430c...5892cea20723c41532c61fe39b758ec86972e982,1,1,1,2,1,2013-04-17 04:27:30,2013-04-17 04:27:30
dc97a1967b81e994ebb31ed3cad89f58794b46b9...67a5d8ce74ca0c609348f3c77f571c0b3e608c8e,1,43,32,75,2,2013-04-17 15:32:48,2013-04-17 15:32:48
67a5d8ce74ca0c609348f3c77f571c0b3e608c8e...4bd6abaff2ce71f78e6f8c9fc2e42d70122c6de2,2,2,2,4,2,2013-04-17 17:47:23,2013-04-17 17:47:23
a6253f0937a5d1f0bd18655729bff03bd5373f17...cc5415b8896181ee784f63b0a4004671f175c1c4,3,2,2,4,2,2012-01-31 17:37:14,2012-01-31 17:37:14
cc5415b8896181ee784f63b0a4004671f175c1c4...9cfae03fd493b4fdadb0fe873fe63831cfb5ccfd,3,2,2,4,2,2012-01-31 17:37:44,2012-01-31 17:37:44
a6253f0937a5d1f0bd18655729bff03bd5373f17...d70ba6c5e66b27acfc46121bf2293773451a339e,2,8,2,10,4,2012-01-31 08:54:07,2012-01-31 08:54:07
59010184cb7b94cd08ea290c69bddf726673f5f4...ccfa989898bdfcd91aa8dd5ad1e2de2832bfda71,18,2531,101,2632,103,2013-05-22 02:31:51,2013-05-22 02:30:33
ccfa989898bdfcd91aa8dd5ad1e2de2832bfda71...7cbec6e89a0f8a14afe2e601159ecc6a52062205,2,0,2430,2430,2,2013-05-22 02:33:57,2013-05-22 02:33:57
41d2b707ed8a4b75df387269ec788b9b318822de...cdcc3e87688e470598fb8254194a5c86f72dd368,1,0,25,25,1,2013-05-23 04:50:25,2013-05-23 04:50:25
5ea070bdf600a26bbf7da31db94aa76f64c5423f...60575dfb461d5e01d36b564dccc55ef260982081,4,76,61,137,24,2013-05-25 20:16:15,2013-05-25 20:16:15
184018837b07c216d8667003ac0bd9958eb07cee...92adcfabb58cc5a8ce41c34bec0ec36a642e5610,3,27,29,56,13,2013-05-12 22:47:18,2013-05-12 22:47:18
92adcfabb58cc5a8ce41c34bec0ec36a642e5610...2d10d61fded8246673a5c7c14f955a80bc61a866,3,132,18,150,15,2013-05-12 23:03:56,2013-05-12 23:03:56
2d10d61fded8246673a5c7c14f955a80bc61a866...37c1122ded5f13737729e668bbe61cf1c271d8e2,2,61,158,219,39,2013-05-12 23:12:13,2013-05-12 23:12:13
37c1122ded5f13737729e668bbe61cf1c271d8e2...da4e7ab15c050314cfa5eea6d4853898757d182a,2,1,57,58,3,2013-05-12 23:13:39,2013-05-12 23:13:39
da4e7ab15c050314cfa5eea6d4853898757d182a...09098a7923b287cbf863c8dc1d6f41749dd4829c,1,0,53,53,2,2013-05-12 23:13:51,2013-05-12 23:13:51
09098a7923b287cbf863c8dc1d6f41749dd4829c...41a76e8e7ade28a8ac65b6948bddf1cd702f9579,3,51,51,102,20,2013-05-12 23:30:54,2013-05-12 23:30:54
41a76e8e7ade28a8ac65b6948bddf1cd702f9579...79a426943075e11458acd96aa71490aee76672c7,1,6,3,9,4,2013-05-12 23:34:12,2013-05-12 23:34:12
2093635de1fb0a6c37929c4a9167adca53b1d621...dd7bb71554ad2ba33b483ed187aed0930e7788ba,1,14,14,28,7,2013-05-13 04:00:37,2013-05-13 04:00:37
dd7bb71554ad2ba33b483ed187aed0930e7788ba...2c6e854eea823495d342a38e26863abf60ac32ec,1,50,48,98,1,2013-05-13 06:54:10,2013-05-13 06:54:10
b0e943399df374b03f9ed5f676f33e42f5e53a74...5af22ab89ff5997ef03366d332b91bddea710323,1,2,7,9,2,2013-06-23 21:15:32,2013-06-23 21:15:32
1045226544c6f9396227974b5543df1caf74f8cf...88d76e386f566b0c49d85aa32d0c385870bbbfb3,6,22,31,53,26,2013-07-09 13:32:28,2013-07-09 13:32:28
1045226544c6f9396227974b5543df1caf74f8cf...0d5c3c2ecf35d9bcbe4bd1ad67f3144f5341eb20,2,6,8,14,3,2013-07-09 01:22:36,2013-07-09 01:22:36
084291aac7e8873ce975a4b547a9de6ac4630473...0a7253042998e764265f02b1ff053123d375c5bf,1,1,1,2,1,2013-07-08 10:02:31,2013-07-08 10:02:31
084291aac7e8873ce975a4b547a9de6ac4630473...7e154740f3c9a06cfdd406672ba0ba143cd50b4d,1,31,23,54,4,2013-07-08 02:54:07,2013-07-07 05:27:56
084291aac7e8873ce975a4b547a9de6ac4630473...dcf1b60f2bb9f0aab63f09c1af533cfcedfbc8d2,5,32,29,61,7,2013-07-08 02:46:20,2013-07-07 05:02:58
084291aac7e8873ce975a4b547a9de6ac4630473...6bda16f6beb9db168d52b5e1f291328d8fd5d7c9,2,63,53,116,7,2013-07-08 02:30:51,2013-07-07 21:52:00
084291aac7e8873ce975a4b547a9de6ac4630473...d9cd5e4e0c252ca7db3bc8a217a576ad9e8e6257,2,71,57,128,13,2013-07-08 02:22:18,2013-07-07 21:40:18
084291aac7e8873ce975a4b547a9de6ac4630473...6e03639af22e2c1c06c5e146192c79b41f1d7385,2,28,29,57,4,2013-07-08 02:16:38,2013-07-07 05:13:37
95b9f44190813b578c6724680090f3b85b9fcf82...6cce56061f3c87826bb3217c9c21d58a2de2ab5c,1,22,16,38,5,2013-07-20 00:09:39,2013-07-20 00:09:39
6cce56061f3c87826bb3217c9c21d58a2de2ab5c...8ab77191ceec9648e47dbe764d876c536c9e6ec2,2,5,4,9,5,2013-07-20 00:17:52,2013-07-20 00:17:52
8ab77191ceec9648e47dbe764d876c536c9e6ec2...b6238c5f200821ebd564f36ff3882218e6093199,4,20,16,36,14,2013-07-20 00:36:03,2013-07-20 00:36:03
61ea1ae9092780bc673e6caa88dcf8483b458c8e...ce719925af8d0d4f443f46b6a93bd4e2d59aca8e,1,18,18,36,12,2013-04-20 17:26:18,2013-04-20 17:25:22
61ea1ae9092780bc673e6caa88dcf8483b458c8e...39bb8146f863474eee6c7daa946ea07f6ce2aa04,2,77,24,101,8,2013-04-19 19:31:55,2013-04-19 19:31:55
39bb8146f863474eee6c7daa946ea07f6ce2aa04...3861e3f5d5c0a579b1a77dc0f45131dd2499ff8b,1,11,11,22,10,2013-04-20 13:54:48,2013-04-20 13:54:48
09b9b8a586edf7463bb3bb0a88d29e5e41f4e4a5...cfc1c8a8cd69e86dc70a48766cd7cd318537dee3,6,36,51,87,30,2012-01-31 21:16:11,2012-01-31 21:16:11
7cbec6e89a0f8a14afe2e601159ecc6a52062205...52a348aa3f5e06e6429f386002f653dac7a35a99,4,1213,345,1558,10,2013-05-23 00:30:58,2013-05-23 00:30:58
7cbec6e89a0f8a14afe2e601159ecc6a52062205...e7b4fedee8f0e7590d0b8eff7aaae160bad0e483,3,3,3,6,3,2013-05-22 22:18:30,2013-05-22 22:18:30
9868d9403c303dcdab8919bbbd6295c2ef424a31...432d417ade569cce1a8a4a2e5fbbd32b57170891,1,4,4,8,4,2013-05-23 06:17:39,2013-05-23 06:17:39
432d417ade569cce1a8a4a2e5fbbd32b57170891...acc0875259593d3206a07ac24bf877d0c8c0c8b9,3,29,25,54,17,2013-05-23 06:34:28,2013-05-23 06:34:28
acc0875259593d3206a07ac24bf877d0c8c0c8b9...a3cba92edd6f778c061ff40dc34a5e939342d31c,1,82,85,167,45,2013-05-23 06:45:12,2013-05-23 06:45:12
a3cba92edd6f778c061ff40dc34a5e939342d31c...371d14e2173888932b1edf11083ccbf73bae313e,2,2,21,23,4,2013-05-24 04:06:02,2013-05-24 04:06:02
371d14e2173888932b1edf11083ccbf73bae313e...3160bd872ee02567ae369ad1d940207523cd5a44,4,138,156,294,75,2013-05-24 04:34:32,2013-05-24 04:34:32
79a426943075e11458acd96aa71490aee76672c7...046d82f0ef31520a64709f03b708721ed902a6c4,1,2,2,4,2,2013-05-13 02:04:01,2013-05-13 02:04:01
046d82f0ef31520a64709f03b708721ed902a6c4...d4546cbcc2f3a5cae79a69e4857d52d6e947a833,4,10,10,20,10,2013-05-13 02:04:22,2013-05-13 02:04:22
37898d5e19e5e550f43c0cf28f9100ebfa48d22f...4eeebe7e06bc93a8d4854acb82745f8409c2e3a1,1,1,1,2,1,2013-05-13 12:50:02,2013-05-13 12:50:02
606d6e81d445ff58295b934d52ac1e31ae2052a6...6aec8f36fcb87421f29207af1c6c93448c3a38f8,1,1,1,2,1,2013-07-15 19:00:01,2013-07-15 19:00:01
606d6e81d445ff58295b934d52ac1e31ae2052a6...5d9f51d4963393c4ec460c2cd6f451851a984342,1,6,6,12,6,2013-07-11 19:57:44,2013-07-11 19:57:44
606d6e81d445ff58295b934d52ac1e31ae2052a6...3a17578a94427b51841676a75128ba7dc204f1d2,1,1,1,2,1,2013-07-11 19:24:06,2013-07-11 19:24:06
606d6e81d445ff58295b934d52ac1e31ae2052a6...a41fd16da27da748b76a88a5ac032128cd245df0,1,1,1,2,1,2013-07-11 19:07:35,2013-07-11 19:07:35
7c5f7a4e82e2c58e833b3ad7682033c906f906db...72d913baeba17b5f50b4ff2c91e6f762fa9c3554,1,1,6,7,1,2013-07-20 06:43:17,2013-07-20 06:43:17
72d913baeba17b5f50b4ff2c91e6f762fa9c3554...4b7f63a3a269987a967a8d6f419bdda3c0f206bf,6,55,7,62,9,2013-07-20 07:03:08,2013-07-20 07:03:08
4b7f63a3a269987a967a8d6f419bdda3c0f206bf...a1065a1ef80d46dc4229aabdb9c7ebcabc0fb771,1,1,1,2,1,2013-07-20 07:07:04,2013-07-20 07:07:04
a1065a1ef80d46dc4229aabdb9c7ebcabc0fb771...e347fffb14595ac980ab083d2649e9bf25870b84,2,6,3,9,4,2013-07-20 07:10:51,2013-07-20 07:10:51
7c5f7a4e82e2c58e833b3ad7682033c906f906db...0f8d6e3112dae2e84a8aa083e3cb45a3cea9d603,1,2,2,4,2,2013-07-20 01:28:21,2013-07-20 01:28:21
cfc1c8a8cd69e86dc70a48766cd7cd318537dee3...390a9af936ce6350bec2660b579e3dcab5918fdb,26,11212,130,11342,35,2012-01-31 21:58:28,2012-01-31 21:58:28
cfc1c8a8cd69e86dc70a48766cd7cd318537dee3...aec0cb3303eaa6952e08227bed505f8b6527caad,3,2,2,4,2,2012-01-31 21:57:43,2012-01-31 21:57:43
3160bd872ee02567ae369ad1d940207523cd5a44...79666385f761bd27a31fc363fa26cdbe5b037017,2,2,2,4,2,2013-05-24 12:14:11,2013-05-24 12:14:11
8ae625626204c8a63a405a095a74cd457b7796e5...a38a3429fc132cbf3925a057db8b331db57aae87,2,0,2,2,2,2013-05-14 00:03:53,2013-05-14 00:01:59
ced641b1079ae9ab1b59c39ce9edf82b85b3fb37...522004e67ae72d48ae6a2aadc304cfdb2af4e92e,2,0,2,2,2,2013-07-16 18:26:48,2013-07-16 18:26:48
522004e67ae72d48ae6a2aadc304cfdb2af4e92e...5967ef64a3b91b76b6e1ac6e7e61c8306a954f4a,2,0,2,2,2,2013-07-16 18:49:04,2013-07-16 18:49:04
ced641b1079ae9ab1b59c39ce9edf82b85b3fb37...76063ea73967928ce648b54fb4088856d9bb32c8,1,1,1,2,1,2013-07-16 17:49:59,2013-07-16 17:49:59
89555cb61c6b63086a099823bf4c37f0798aa4c6...aab4c95cd259e707c45c814a8a1e91faa0bd489d,1,30,1,31,4,2013-07-14 10:50:14,2013-07-14 10:50:14
0190128ebc40c362dc618e2d4fcf52fa47b21a1d...124d7e6279e34cfd6480a9f33f934aaba93b9dde,3,5,3,8,4,2013-07-26 04:49:19,2013-07-26 04:49:19
453346262f879f5e4e37e50b1462de72f3f60f59...732e4196fb9dc76ce2250edcdc6c1b45bcbe5d2e,2,0,16,16,2,2013-07-21 02:31:56,2013-07-21 02:31:56
732e4196fb9dc76ce2250edcdc6c1b45bcbe5d2e...51dfa21009459c98b8d98a63cfc3d2abe29f9017,1,0,1,1,1,2013-07-21 02:32:21,2013-07-21 02:32:21
51dfa21009459c98b8d98a63cfc3d2abe29f9017...d651c01e10cd0f69529e5bcb20f5d1a4b6508c48,1,4,2,6,1,2013-07-21 03:11:53,2013-07-21 03:11:53
d651c01e10cd0f69529e5bcb20f5d1a4b6508c48...df851b40d1accb1c6db44ac77a28c2e76273581b,2,9,6,15,5,2013-07-21 03:58:23,2013-07-21 03:58:23
df851b40d1accb1c6db44ac77a28c2e76273581b...a63db4d2f91c056310fc9a24891dbd161672451b,4,5,7,12,4,2013-07-21 04:09:03,2013-07-21 04:09:03
453346262f879f5e4e37e50b1462de72f3f60f59...23015bc7c12f1b210e4691020a7422001a2f141d,1,1,1,2,1,2013-07-20 19:38:38,2013-07-20 19:38:38
453346262f879f5e4e37e50b1462de72f3f60f59...faa9a22f74a9b4c293e3894587f9103555321f88,1,2,2,4,2,2013-07-20 12:38:10,2013-07-20 12:38:10
453346262f879f5e4e37e50b1462de72f3f60f59...c2e37414d88180f2f7affe7655eddbb9468103c3,4,30,11,41,12,2013-07-20 07:56:20,2013-07-20 07:56:20
c2e37414d88180f2f7affe7655eddbb9468103c3...1683e6767a3e13585e67fb1d7e93aced83e8f8b2,3,26,9,35,10,2013-07-20 08:17:56,2013-07-20 08:17:56
1683e6767a3e13585e67fb1d7e93aced83e8f8b2...330f40c8641a3f9bc4b4295c0d5d958108518d2e,4,18,8,26,11,2013-07-20 08:38:27,2013-07-20 08:38:27
e75bc5eb5ffca534fd3a84d749e8b39824654ebb...80a752f52508ed8c2405da233c667210ed1d5379,1,4,1,5,2,2012-01-31 22:05:30,2012-01-31 22:05:30
aec0cb3303eaa6952e08227bed505f8b6527caad...013de18e6bb0e37dfe39828478aeac20e2110b85,3,0,8,8,2,2012-01-31 22:00:26,2012-01-31 22:00:26
013de18e6bb0e37dfe39828478aeac20e2110b85...6cf79a5b8e13e8c1e2919da9e334cc6c9275ab9b,11,111,330,441,22,2012-01-31 22:29:44,2012-01-31 22:29:44
f820de4b325c4a9049c822374701efd2bcb7e26e...f3e45c37780b12a3fa96e7d4578f38a883cba9a0,8,138,51,189,28,2013-05-25 06:15:04,2013-05-25 06:15:04
f3e45c37780b12a3fa96e7d4578f38a883cba9a0...e424b3879c751a8c0efc20d549ee066c8b1f9068,3,9,7,16,7,2013-05-25 06:53:44,2013-05-25 06:53:44
e424b3879c751a8c0efc20d549ee066c8b1f9068...7cbb1c0452a1d9904f7655aea78644def85b7f2e,1,8,1,9,2,2013-05-25 07:16:52,2013-05-25 07:16:52
b62fa23d9a11c48ab7557b8a0c397c92ec106653...19d0726609f860d4a7f1c214965164084aaf8a5f,3,270,205,475,67,2013-06-02 20:38:45,2013-06-02 20:38:45
b62fa23d9a11c48ab7557b8a0c397c92ec106653...19ce707a0021565317bf92c19c1d1b738e2c659a,1,89,82,171,4,2013-06-02 19:52:51,2013-06-02 19:52:51
5ebd6a4966758f54213f0a29a9648d7665061c2b...da9cf1009b5ba5004deca58a8e7b999d70dd9382,1,5,5,10,3,2013-05-14 01:40:48,2013-05-14 01:40:48
cb9cc972edd1af9c21a58a120374472256c1bccb...8a79590d051bbf110399dce2f27f6daf732014da,1,0,360,360,1,2013-07-18 00:20:47,2013-07-18 00:20:47
8a79590d051bbf110399dce2f27f6daf732014da...e7be60fd4d9be0aa71eae7dac926dea795855708,1,1,1,2,1,2013-07-18 00:21:11,2013-07-18 00:21:11
124d7e6279e34cfd6480a9f33f934aaba93b9dde...f5f04ae4a0cd57c59c782a45cca28220d5dbb3ea,5,45,12,57,17,2013-07-26 06:30:13,2013-07-26 06:30:13
12468c61037469985e0cc1669966d63208becc75...abb1013f258c7bc9e8b44e432af0e34e03c8c1e9,1,1,1,2,1,2013-07-21 19:57:41,2013-07-21 19:57:41
6952d655f4e48daee1b2f13ee40fe076d1383b23...c9263093717b63b18e590202565b52c6de07f0f8,1,1,1,2,1,2013-07-21 12:20:21,2013-07-21 12:20:21
6952d655f4e48daee1b2f13ee40fe076d1383b23...f5fc6254c7f0e1791998268d92586ffc2e24d6c1,1,6,5,11,1,2013-07-21 12:03:59,2013-07-21 12:03:59
6952d655f4e48daee1b2f13ee40fe076d1383b23...be2693369d109d5a0a8804d3f21be7aef15c6786,3,1,3,4,3,2013-07-21 11:44:30,2013-07-21 11:44:30
1803b2f09ee4ecdc23fb3d371441c4ac1526b43d...b0dd2f902d494f46c238e31ef3a711c11d44f501,2,4,1,5,2,2013-07-24 05:53:30,2013-07-24 05:53:30
b0dd2f902d494f46c238e31ef3a711c11d44f501...a5cc1300f60ae2a8a1c21adbc83b5de874155194,4,23,9,32,11,2013-07-24 06:03:57,2013-07-24 06:03:57
a5cc1300f60ae2a8a1c21adbc83b5de874155194...ba954db159138d5b9aeef3df638f91daec5e12eb,4,11,4,15,5,2013-07-24 06:09:06,2013-07-24 06:09:06
ba954db159138d5b9aeef3df638f91daec5e12eb...cdf6019e115a2dcc6521c3b13bf091119521e9fe,3,19,5,24,6,2013-07-24 06:13:15,2013-07-24 06:13:15
cdf6019e115a2dcc6521c3b13bf091119521e9fe...398038c798f065c3e42a7d296daeb59921424644,4,13,16,29,10,2013-07-24 06:18:53,2013-07-24 06:18:53
398038c798f065c3e42a7d296daeb59921424644...a049cdd46e382c87688f5bfb920d99c632f1dfd6,1,17,17,34,5,2013-07-24 06:22:13,2013-07-24 06:22:13
a049cdd46e382c87688f5bfb920d99c632f1dfd6...9029b4c06cd0f7daf263df57e6b8b3daf9297674,3,21,15,36,6,2013-07-24 06:25:46,2013-07-24 06:25:46
9029b4c06cd0f7daf263df57e6b8b3daf9297674...18157e9f390cc1dd389604c215017650400377a3,5,27,29,56,28,2013-07-24 06:48:17,2013-07-24 06:48:17
c84b5cf5f52ad9be72adf9de2956baad1d6e025b...c8fad2590247a9581c62dadb526a540e369a3e88,3,24,54,78,14,2012-02-01 01:24:20,2012-02-01 01:24:20
7cbb1c0452a1d9904f7655aea78644def85b7f2e...9257bdc0974beef0a2218c76851dc37f3cf9313a,3,21,11,32,11,2013-05-27 19:45:13,2013-05-27 19:45:13
9257bdc0974beef0a2218c76851dc37f3cf9313a...a7a87c8e8c3343f6d9dea868d578178de8907f98,2,12,9,21,8,2013-05-27 19:48:16,2013-05-27 19:48:16
7cbb1c0452a1d9904f7655aea78644def85b7f2e...2b088ef44e9476a6336487c65d42b74213cd2a19,1,3,3,6,3,2013-05-27 16:33:14,2013-05-27 16:33:14
2b088ef44e9476a6336487c65d42b74213cd2a19...6fda25b4c16df2d34d298b373a64ef6f41da7a5a,2,16,3,19,4,2013-05-27 20:00:39,2013-05-27 20:00:39
7cbb1c0452a1d9904f7655aea78644def85b7f2e...33b5c32c8cc5713fd446af5ddd8c86cff46b9710,1,1,0,1,1,2013-05-26 16:14:25,2013-05-26 16:14:25
bd170e8366ca959e854d7f6c338988bd3ee594a7...97e6e5f150957409b415463d81eaaee3c3c3159a,5,10,10,20,10,2013-06-02 21:51:36,2013-06-02 21:51:36
8544ef8734de46b927895f18ae4f149fa69a6fd2...1d8ff36afa73ac086004962ec2f3d02148f8a201,4,35,0,35,4,2013-05-15 01:55:37,2013-05-15 01:55:37
1d8ff36afa73ac086004962ec2f3d02148f8a201...e23f661f3fc66f83cb976f8a3b7e2c627af9162d,2,12,1,13,2,2013-05-15 01:59:13,2013-05-15 01:59:13
8544ef8734de46b927895f18ae4f149fa69a6fd2...9af88380c440f35387292946b2e18ad7b2ab84b2,1,6,20,26,6,2013-05-14 20:31:15,2013-05-14 20:31:15
9af88380c440f35387292946b2e18ad7b2ab84b2...cd2d7b5d1738aed211bf257de9094b192d0ac56f,1,1,1,2,1,2013-05-14 20:42:06,2013-05-14 20:42:06
8544ef8734de46b927895f18ae4f149fa69a6fd2...45f62f9589c50175161b627d0f5b6f34ee8592aa,2,20,19,39,11,2013-05-14 12:33:49,2013-05-14 12:33:49
e7be60fd4d9be0aa71eae7dac926dea795855708...13cad5061d46573c55def0e7a43cab1631317262,1,13,8,21,7,2013-07-18 02:28:43,2013-07-18 02:28:43
13cad5061d46573c55def0e7a43cab1631317262...f97dd5af493f532046a3782b12dea5354c947597,2,14,9,23,8,2013-07-18 02:33:21,2013-07-18 02:33:21
e7be60fd4d9be0aa71eae7dac926dea795855708...aa49c919c65ea4eb7777d3f54cdc9da0e1a05f9f,1,18,0,18,1,2013-07-18 02:08:08,2013-07-18 02:08:08
aa49c919c65ea4eb7777d3f54cdc9da0e1a05f9f...f4b9938d8c0c23ff3b1b5e1e8fee9229d2e67bfa,2,52,0,52,3,2013-07-18 02:20:08,2013-07-18 02:20:08
f4b9938d8c0c23ff3b1b5e1e8fee9229d2e67bfa...06d47b008233c487844146cf1cc037d691068a0a,1,5,0,5,2,2013-07-18 02:26:37,2013-07-18 02:26:37
f58827f24d6593bc36ff48b4c58a0fd954427326...7ae8db8b7e11f0f4f735a711301750743e179bd5,1,14,12,26,4,2013-07-26 06:53:34,2013-07-26 06:53:34
7ae8db8b7e11f0f4f735a711301750743e179bd5...778f3a3df7b2ff98fc698f75c6c804e708bea93a,1,1,1,2,1,2013-07-26 06:57:21,2013-07-26 06:57:21
f79740b48add99d647ccf4b281c98b6f6202fb66...94202b2b29c708d517e55ca6b03ec804e25daf18,2,3,3,6,3,2013-07-26 04:51:45,2013-07-26 04:51:45
94202b2b29c708d517e55ca6b03ec804e25daf18...8a7553aeda0a99598c54637bc22954ca890cb697,1,2,2,4,2,2013-07-26 04:52:21,2013-07-26 04:52:21
98ce40d0f689bb1f3aa822240fd53a659b2edd4c...0b1ddeb35359c16eba2682aec3c880706d747f53,1,2,2,4,1,2013-07-22 21:44:36,2013-07-22 21:44:36
a7a87c8e8c3343f6d9dea868d578178de8907f98...f5ce66177bba1e5613a481d7d2a0e9bcfab077f0,3,15,15,30,7,2013-05-29 15:24:00,2013-05-29 15:24:00
4fa1e729f0af36c1ca6214fe31e972d80b4ff4f7...56d6fea45e8c3f3ab60d07206b294bc71b893926,1,10,1,11,1,2013-06-02 22:22:53,2013-06-02 22:22:53
56d6fea45e8c3f3ab60d07206b294bc71b893926...05be4de8b81e6d87ae39100899e02b08dae6d3a2,1,3,1,4,2,2013-06-02 22:25:19,2013-06-02 22:25:19
e23f661f3fc66f83cb976f8a3b7e2c627af9162d...7e674efa22fa06e1ea825b934973c11fb03583ea,1,13,13,26,1,2013-05-15 05:00:08,2013-05-15 05:00:08
7e674efa22fa06e1ea825b934973c11fb03583ea...e56c809492b605f2bae242b67ff18fef426e7b7a,1,7,1,8,3,2013-05-15 05:08:32,2013-05-15 05:08:32
e56c809492b605f2bae242b67ff18fef426e7b7a...a41d566d5e38dd3227a0f5921f7be92969ff63f1,2,14,1,15,8,2013-05-15 05:08:56,2013-05-15 05:08:56
a41d566d5e38dd3227a0f5921f7be92969ff63f1...28a081cb20d4e9544967e7c6d5ab31ff4ad68862,9,88,153,241,74,2013-05-15 06:21:30,2013-05-15 06:21:30
28a081cb20d4e9544967e7c6d5ab31ff4ad68862...fcb7c9da6f5082e1306fab096c16020b4227c967,1,3,3,6,3,2013-05-15 06:24:29,2013-05-15 06:24:29
5588e14867ee5d917ec97a32329a216c3c0ed527...91b6a43ed934931ccfdb11213a3b63984457b07c,3,4,3,7,3,2013-07-26 07:22:20,2013-07-26 07:22:20
8a7553aeda0a99598c54637bc22954ca890cb697...ed4674a09ad80395eed83a345b1a556845eb8276,4,67,7,74,9,2013-07-26 06:29:43,2013-07-26 06:29:43
ed4674a09ad80395eed83a345b1a556845eb8276...1659ac64732b71f207a278aa54aaf551295bf222,1,7,7,14,7,2013-07-26 06:32:12,2013-07-26 06:32:12
0b1ddeb35359c16eba2682aec3c880706d747f53...8aa3c375f061edf2df044f22b9416bb8dda80850,3,3,3,6,3,2013-07-23 17:18:34,2013-07-23 17:18:34
0b1ddeb35359c16eba2682aec3c880706d747f53...4b9cacae91474b5a2e28bdfe1355d0555c4e95c3,4,4,4,8,4,2013-07-23 04:05:45,2013-07-23 04:05:45
930c75e5dd0f2ae861a505bda740f289570c9b8a...eaefed517a960893204cade3525bda100454e13f,5,52,7,59,8,2013-07-25 03:10:16,2013-07-25 03:10:16
930c75e5dd0f2ae861a505bda740f289570c9b8a...2e6fcefc5ca6aa3301f35b0600d963f82f1eb62a,3,47,7,54,6,2013-07-24 13:43:21,2013-07-24 13:43:21
2e6fcefc5ca6aa3301f35b0600d963f82f1eb62a...c63489def3af052b37608442dc5fd1d5c9f7b6c5,1,3,3,6,2,2013-07-24 23:28:34,2013-07-24 23:28:34
c63489def3af052b37608442dc5fd1d5c9f7b6c5...3080104642cd952d830e534eddd38ec67fee914b,2,5,6,11,7,2013-07-24 23:31:17,2013-07-24 23:31:17
930c75e5dd0f2ae861a505bda740f289570c9b8a...7e9532dabe7ae1136c9ee07b33ee5116bcfafac1,6,9,9,18,9,2013-07-24 09:10:27,2013-07-24 09:10:27
930c75e5dd0f2ae861a505bda740f289570c9b8a...0caab585f557513f936f4664ad1cdbddbfde9add,4,8,9,17,8,2013-07-24 08:39:16,2013-07-24 08:39:16
930c75e5dd0f2ae861a505bda740f289570c9b8a...7936f1478028fb759781014a2c93884f5f90a598,1,66,0,66,2,2013-07-24 07:08:19,2013-07-10 20:57:19
f5ce66177bba1e5613a481d7d2a0e9bcfab077f0...c89a6edf090348693a3dd7d43cc2812009249d30,1,0,2,2,1,2013-05-29 19:09:33,2013-05-29 19:09:33
1b8cd2d8eb209941303b8c03757721076a3e8f48...e5bdb2497e55eaf0a14a4136bbd35fbdc7395478,1,2,2,4,2,2013-06-03 18:55:55,2013-06-03 18:55:55
e5bdb2497e55eaf0a14a4136bbd35fbdc7395478...a05f6d4cea03a61f35223eab697d3caa4dc9e24c,2,44,44,88,24,2013-06-03 18:58:38,2013-06-03 18:58:38
a05f6d4cea03a61f35223eab697d3caa4dc9e24c...286955167a53862fdde84359ab3c21a1e4237627,1,66,66,132,6,2013-06-04 04:48:52,2013-06-04 04:48:52
286955167a53862fdde84359ab3c21a1e4237627...45c5b4e45c1d6479801dc205e13b350e334ebcd0,2,19,2,21,10,2013-06-04 04:51:35,2013-06-04 04:51:35
05be4de8b81e6d87ae39100899e02b08dae6d3a2...4e4e75d4acadb5283aec23ea4643058f0b48380e,1,1,1,2,1,2013-06-02 22:26:10,2013-06-02 22:26:10
4e4e75d4acadb5283aec23ea4643058f0b48380e...21441f129259b17c6112d923dc93d4fc4577e49b,2,51,51,102,4,2013-06-02 22:33:42,2013-06-02 22:33:42
21441f129259b17c6112d923dc93d4fc4577e49b...2f70477621fd45d0dd52284b7ca7e0a72319d4e1,1,1,1,2,1,2013-06-02 22:51:28,2013-06-02 22:51:28
31dcb911893c1f7b6eebe097705a3e64568c8654...6307dc40d738653d2fdf8c2316e27586fa8e975f,3,37,34,71,24,2013-05-15 17:01:09,2013-05-15 17:01:09
31dcb911893c1f7b6eebe097705a3e64568c8654...7780133c1cb1868a0e936dd68e951b1e22d3215b,1,1,0,1,1,2013-05-15 13:44:28,2013-05-15 13:44:28
7780133c1cb1868a0e936dd68e951b1e22d3215b...6289e24f6663e7465b9a902e70190b41100d16ac,1,6,28,34,4,2013-05-15 14:14:44,2013-05-15 14:14:44
995add132efdb6557f191f1a65097f19260a4f7d...5d766d9e2ff09ee5a8eeb148b86622297634a3ff,4,36,31,67,11,2013-07-26 08:43:43,2013-07-26 08:43:43
995add132efdb6557f191f1a65097f19260a4f7d...06980ae5a1c8c354bc023defb804a329dd439b14,1,1,1,2,1,2013-07-26 08:10:35,2013-07-26 08:10:35
995add132efdb6557f191f1a65097f19260a4f7d...0d33455ef486d0cf06cb29d427efda57f42f7ea9,12,898,812,1710,198,2013-07-26 07:39:14,2013-05-04 14:55:52
0d33455ef486d0cf06cb29d427efda57f42f7ea9...292d8d6819925dbc1957895c11eea2562f08bd17,3,644,644,1288,188,2013-07-26 08:07:56,2013-07-26 08:07:56
292d8d6819925dbc1957895c11eea2562f08bd17...a317f67c1cdc8e630fe18f5d48cfb582a0eda1de,3,5,2,7,4,2013-07-26 08:15:41,2013-07-26 08:15:41
d604052aa5eee4f5df8298f1e3a82be408f09629...210ee6369313b311b879cf1a773ecfd0276f3543,4,14,29,43,16,2013-07-26 07:18:18,2013-07-26 07:18:18
1659ac64732b71f207a278aa54aaf551295bf222...b4f023f80933613be8e72f81a616d33abc81a5de,2,6,6,12,3,2013-07-26 07:02:20,2013-07-26 07:02:20
b4f023f80933613be8e72f81a616d33abc81a5de...c23ba4d50b462b61a79eb5a46b52dc6904e88d28,6,14,15,29,11,2013-07-26 07:04:15,2013-07-26 07:04:15
b5f2482a58891c52cbf46c2419f883a519577bd3...4cec956e0cb5c89b12ca98063a9754b9a4b1a29c,4,11,140,151,13,2013-07-23 17:48:30,2013-07-23 17:48:30
a282dba58f54cb6912e419c7d890ff86d5e68e73...aad910465c3379061b15f3d515a806dad63375ad,3,11,11,22,7,2013-07-25 03:21:23,2013-07-25 03:21:23
aad910465c3379061b15f3d515a806dad63375ad...e9c83647afb90b95ab8d8e86fa33bb5c71768f2d,3,17,31,48,7,2013-07-25 03:57:26,2013-07-25 03:57:26
61ac20ebb5f30094d287048300348d58d5622afd...51de38e5b9f1df43e56166cea979b18108e98350,4,22,5,27,5,2013-07-24 23:52:47,2013-07-24 23:52:47
93eeb8578d3d5d2629f27316af71395817b23bdd...f83995684ca8f12674dce8881457cfeee92a75e5,1,2,10,12,1,2013-07-27 04:01:14,2013-07-27 04:01:14
a4c1248ca006617b371a739217cded5ae05ca33a...ab6dd6e76e2ba5a134ea1c156e63531aed8c0e9e,1,0,0,0,0,2013-06-01 20:59:13,2013-06-01 20:59:13
a4c1248ca006617b371a739217cded5ae05ca33a...cc684750e5f1143443779ebec2c418c84cec64e7,3,3,3,6,3,2013-06-01 12:15:40,2013-06-01 12:15:40
45c5b4e45c1d6479801dc205e13b350e334ebcd0...6771be1cedc38b0f0a912082eb3c9d1ec54344e1,1,7,6,13,4,2013-06-12 20:01:59,2013-06-12 19:40:37
45c5b4e45c1d6479801dc205e13b350e334ebcd0...7f8703ef86ee770051e38cc826e63549709366c3,1,3,3,6,3,2013-06-12 18:51:10,2013-06-12 18:51:10
45c5b4e45c1d6479801dc205e13b350e334ebcd0...df5ddeb7cc3b71c96b691e073c252690679dd4ea,2,24,0,24,4,2013-06-07 01:00:32,2013-06-05 20:14:58
45c5b4e45c1d6479801dc205e13b350e334ebcd0...232c03dc2f076534633f4579b8becf88633d07e7,1,1,1,2,1,2013-06-05 10:59:13,2013-06-05 10:59:13
45c5b4e45c1d6479801dc205e13b350e334ebcd0...245ebda651fcdbc9687c1a436e8bbe3916354da6,11,365,365,730,264,2013-06-04 04:57:51,2013-06-04 04:57:51
245ebda651fcdbc9687c1a436e8bbe3916354da6...567b8b56319994dc0488de629b2dd2447be10115,1,2,2,4,2,2013-06-04 04:58:58,2013-06-04 04:58:58
567b8b56319994dc0488de629b2dd2447be10115...b1cc11cd98e3ab3707c6c39a80df458f277239ff,1,6,6,12,2,2013-06-05 04:55:59,2013-06-05 04:55:59
b1cc11cd98e3ab3707c6c39a80df458f277239ff...441bbe1998c790dad1c4d44c5f85e6360209eaac,4,130,59,189,26,2013-06-08 21:04:16,2013-06-08 21:04:16
441bbe1998c790dad1c4d44c5f85e6360209eaac...eb21410cc8ad61db1656445d1e74e9e2937229d5,1,1,0,1,1,2013-06-08 21:06:29,2013-06-08 21:06:29
eb21410cc8ad61db1656445d1e74e9e2937229d5...0a18d33d2c1600c9d5133127dac4db2f690df71a,4,123,25,148,12,2013-06-10 06:43:43,2013-06-10 06:43:43
0a18d33d2c1600c9d5133127dac4db2f690df71a...9ba11ba60a444d84a9cf731bad49e91dd20826a4,2,0,12,12,2,2013-06-10 06:44:14,2013-06-10 06:44:14
9ba11ba60a444d84a9cf731bad49e91dd20826a4...9fac2c04679042ffc84ee74fce2516497f965419,1,1,1,2,1,2013-06-10 06:45:14,2013-06-10 06:45:14
bae9d8adf04f76c859826cd98ed2316c7c2f4fdc...f3d857773455a940fca0c8d2ef1ca26982700031,2,28,31,59,5,2013-05-15 17:16:11,2013-05-15 17:16:11
5b2b46fe28b0dad4c41c2fe9bd96fa166e54b96d...2a51ebf671aca07cdb549c264a9b2c2dd3d7d540,1,1,1,2,1,2013-07-26 08:46:30,2013-07-26 08:46:30
4cec956e0cb5c89b12ca98063a9754b9a4b1a29c...d8583a1064440c95ddb8cbcb2ebe744859443af5,1,1,1,2,1,2013-07-23 20:00:28,2013-07-23 20:00:28
4cec956e0cb5c89b12ca98063a9754b9a4b1a29c...4629bed2c40bfd26b10408ad69d2eaa29b75de44,1,1,1,2,1,2013-07-23 18:50:01,2013-07-23 18:50:01
e9c83647afb90b95ab8d8e86fa33bb5c71768f2d...0017f7fca4d34b37b63275f1aab79baad16ed5e1,1,1,1,2,1,2013-07-25 15:09:12,2013-07-25 15:09:12
e9c83647afb90b95ab8d8e86fa33bb5c71768f2d...f8d5a974bcf385a709a1c55514506427fa28e547,3,31,7,38,9,2013-07-25 06:58:25,2013-07-25 06:58:25
f8d5a974bcf385a709a1c55514506427fa28e547...a06afd8320418c50e433d1a4215b6553e3657152,4,83,15,98,14,2013-07-25 07:43:14,2013-07-25 07:43:14
1f40da9676d0e29329fcf0925409a70acd02daaf...72237acf524618ad941ff7a64e89fa64b5a4c12b,1,2,0,2,1,2013-07-25 16:57:33,2013-07-25 16:57:33
fff2854c5eab79de987aeeeb97356b0c1ca4be97...2cf1851d9f9ea73a9c2e446db88f5c2179ea2f40,5,26,14,40,6,2013-07-27 05:09:31,2013-07-27 05:09:31
fff2854c5eab79de987aeeeb97356b0c1ca4be97...ad235f5f51c8bade076c68cc6db4e89bfe6a6f32,1,5,1,6,1,2013-07-27 04:12:35,2013-07-27 04:12:35
ad235f5f51c8bade076c68cc6db4e89bfe6a6f32...8349236f8c322c048ca22e65ed797f2f35e9949e,3,13,3,16,5,2013-07-27 04:12:48,2013-07-27 04:12:48
8349236f8c322c048ca22e65ed797f2f35e9949e...70fa8ef4b04eeacc64d25477f4c5391b9385d4fb,2,82,50,132,2,2013-07-27 04:28:44,2013-07-27 04:28:44
70fa8ef4b04eeacc64d25477f4c5391b9385d4fb...572174652e905b1cefba10bb623b27d1c5f5e38a,1,40,38,78,1,2013-07-27 04:31:00,2013-07-27 04:31:00
572174652e905b1cefba10bb623b27d1c5f5e38a...2967cc1d60a6b557395549511368aceb18c7b139,2,35,32,67,9,2013-07-27 04:35:56,2013-07-27 04:35:56
2967cc1d60a6b557395549511368aceb18c7b139...85591d82ddeae95f7b89a76d1bcfa9c98fb1f3ea,1,2,2,4,2,2013-07-27 04:40:58,2013-07-27 04:40:58
85591d82ddeae95f7b89a76d1bcfa9c98fb1f3ea...88887f8c000aa2a94829575b30f0c96d58d247b7,3,4,7,11,7,2013-07-27 04:49:35,2013-07-27 04:49:35
88887f8c000aa2a94829575b30f0c96d58d247b7...5bed9f4635495cfd2f710cbdb631689dfa1d0d87,1,9,13,22,9,2013-07-27 04:52:23,2013-07-27 04:52:23
5bed9f4635495cfd2f710cbdb631689dfa1d0d87...44a4e7121534a4aeb74ac260e17ee536457449f9,2,152,132,284,20,2013-07-27 05:03:52,2013-07-27 05:03:52
44a4e7121534a4aeb74ac260e17ee536457449f9...4e2774091658c20fb0077f59f104a08144b2f8e3,1,4,1,5,2,2013-07-27 05:09:05,2013-07-27 05:09:05
4e2774091658c20fb0077f59f104a08144b2f8e3...bf5434dbec308d4f49a5da0981bd5900727018d3,3,3,5,8,3,2013-07-27 05:11:58,2013-07-27 05:11:58
bf5434dbec308d4f49a5da0981bd5900727018d3...bed8e959b3abe67ac6128ca74625839b991be3b2,1,463,433,896,16,2013-07-27 05:17:53,2013-07-27 05:17:53
949c7cca000de7eddd91e5a9a9886dc9066bb63e...1421a0e9bb3038803fe39c3083710a40ed94460b,1,1,1,2,1,2013-06-13 12:50:06,2013-06-13 12:50:06
949c7cca000de7eddd91e5a9a9886dc9066bb63e...436cffdaafbe7f588c26ebf1cbf4ede805b5e8a6,1,1,1,2,1,2013-06-13 12:36:52,2013-06-13 12:36:52
949c7cca000de7eddd91e5a9a9886dc9066bb63e...c6f51d09193ddfe58bd33a7a96f4ee84533e449f,1,2,2,4,1,2013-06-13 12:29:34,2013-06-13 12:29:34
949c7cca000de7eddd91e5a9a9886dc9066bb63e...2c00a2fe2fcc058bed46f5dd254571f87a213945,1,1,1,2,1,2013-06-13 11:27:26,2013-06-13 11:27:26
d74a9634b0cb21a712f5e805c7a21132dc9bee5e...3a02d07acae070b3d78d4c6b2c9e21c1fa4df673,1,2,2,4,2,2013-06-10 12:59:42,2013-06-10 12:59:42
2a51ebf671aca07cdb549c264a9b2c2dd3d7d540...102fad4ebdb2154a47e9d1bc91f9d3b085d595e5,1,1,1,2,1,2013-07-26 16:00:45,2013-07-26 16:00:45
2a51ebf671aca07cdb549c264a9b2c2dd3d7d540...a2f120a7aa2f0906c8a96ae70c6ad28968f423ba,3,1,3,4,3,2013-07-26 13:59:50,2013-07-26 13:59:50
a2f120a7aa2f0906c8a96ae70c6ad28968f423ba...e4300fa1bf22e1836abf47db45a97ee16cf7ad1f,3,1,3,4,3,2013-07-26 14:27:55,2013-07-26 14:27:55
2a51ebf671aca07cdb549c264a9b2c2dd3d7d540...0e7aad8b8d167f20925499b3a90b2bffdc32d469,1,2,2,4,2,2013-07-26 13:43:05,2013-07-26 13:43:05
2a51ebf671aca07cdb549c264a9b2c2dd3d7d540...6115f01adb0e5db407e09077972c3e3e1f82a54e,1,4,4,8,4,2013-07-26 12:58:47,2013-07-26 12:58:47
6115f01adb0e5db407e09077972c3e3e1f82a54e...2e7593a40dfc6149e81044325c6ad866dcbfa8a8,1,1,6,7,2,2013-07-26 13:04:39,2013-07-26 13:04:39
2a51ebf671aca07cdb549c264a9b2c2dd3d7d540...1b8ba0d15925a02e1522590423e38a7c888ea062,9,1392,1272,2664,99,2013-07-26 12:04:15,2013-07-26 12:04:15
2a51ebf671aca07cdb549c264a9b2c2dd3d7d540...f7a376569a29ef7feb128b600cc8378047d84b2c,1,3,3,6,3,2013-07-26 11:52:40,2013-07-26 11:52:40
2a51ebf671aca07cdb549c264a9b2c2dd3d7d540...fe095d17a28b78279498bb6439b6b7f3cac06b72,1,2,2,4,1,2013-07-26 09:16:27,2013-07-26 09:16:27
fe095d17a28b78279498bb6439b6b7f3cac06b72...cd23ae00ddfb7246ba56000a2ec6f83f9c82554f,1,1,1,2,1,2013-07-26 09:25:12,2013-07-26 09:25:12
e87508854e0818bad2c56bb6178abdb5b1105c7a...7b12a0dcbc9adb2835391713f1947e9213f4bbaa,3,3,3,6,3,2013-07-24 00:23:02,2013-07-24 00:23:02
7b12a0dcbc9adb2835391713f1947e9213f4bbaa...43e5e90a6d871dbbca2ac68429324719692777d3,1,2,2,4,1,2013-07-24 00:32:20,2013-07-24 00:32:20
43e5e90a6d871dbbca2ac68429324719692777d3...f1009c19b31c24df871b97efa74e8e10791bb2c3,10,91,85,176,32,2013-07-24 01:44:08,2013-07-24 01:44:08
f1009c19b31c24df871b97efa74e8e10791bb2c3...68e87183a0c2d82b0f62d6c9d79bb89311bb3409,1,1,1,2,1,2013-07-24 01:54:00,2013-07-24 01:54:00
68e87183a0c2d82b0f62d6c9d79bb89311bb3409...faa00629c440b45e9a151764a5518ff5691500c9,3,9,3,12,4,2013-07-24 01:56:00,2013-07-24 01:56:00
4d42100a3ea3b926b78d282898c421473fe52128...d4cd7efce6214d6a02b2d1254a512c03964c0459,2,2,2,4,2,2013-07-25 16:58:28,2013-07-25 16:58:28
d4cd7efce6214d6a02b2d1254a512c03964c0459...768e7edabf0613b1537ea2d5eb422b2069f4466c,3,25,9,34,9,2013-07-25 17:01:42,2013-07-25 17:01:42
f94d9ce096c27ac5092b01a1b412142dd30a54a5...0d2d65c8f126cea4a9ca4ea00b552e4039228673,2,16,16,32,15,2013-07-25 17:12:51,2013-07-25 17:12:51
0d2d65c8f126cea4a9ca4ea00b552e4039228673...c7995cf9645f52966c142d682f1746840572875d,2,16,12,28,10,2013-07-25 17:50:59,2013-07-25 17:50:59
2cf1851d9f9ea73a9c2e446db88f5c2179ea2f40...cfa4ab90f3d8de9dd419a6b30f0ba57c9b9ba518,3,11,7,18,11,2013-07-27 05:24:51,2013-07-27 05:24:51
ecf9b020ddf415c4a703cf5f6c80e671eaf3e422...0b7b40e281915be58bf058ded97f12c10312b097,1,1,1,2,1,2013-06-16 02:23:09,2013-06-16 02:23:09
ecf9b020ddf415c4a703cf5f6c80e671eaf3e422...258e1d62fbff743f8ae08ef75ffbc962fdb51e58,2,11,5,16,6,2013-06-15 18:37:59,2013-06-15 18:37:59
258e1d62fbff743f8ae08ef75ffbc962fdb51e58...6ce154c7ed64f3821cc7d6cbb0bfcf65b25f1b49,2,10,10,20,7,2013-06-15 18:46:13,2013-06-15 18:46:13
6ce154c7ed64f3821cc7d6cbb0bfcf65b25f1b49...ac3521fef4f69bfc025677e9d3020fb39de35f73,2,0,3,3,2,2013-06-16 17:56:30,2013-06-16 17:56:30
1cf0a07f174261e8ee05cfd294d5147e27e22d40...b513cd9addf7a6d08235b80043924c2fe2458241,2,1,5,6,2,2013-07-26 22:13:03,2013-07-26 22:13:03
e62e992b88cc1223c8485e9415bba9213764257a...9e98b733f165e32170bebb705b665770dcf966d2,4,25,24,49,18,2013-07-26 18:08:27,2013-07-26 18:08:27
9e98b733f165e32170bebb705b665770dcf966d2...e3af87967adb902aae341cbd6ec466893f787115,1,1362,1362,2724,57,2013-07-26 18:11:09,2013-07-26 18:11:09
e3af87967adb902aae341cbd6ec466893f787115...52e8aedb8e20673c49e1b390367abf026403b169,2,282,264,546,257,2013-07-26 18:17:48,2013-07-26 18:17:48
52e8aedb8e20673c49e1b390367abf026403b169...ded4ebfa7eb2dc10f2ec784732158c1e125d15f2,1,3,3,6,2,2013-07-26 20:50:55,2013-07-26 20:50:55
1ad3e1e8a79608cab9466a73f3d86b1c4787ae2f...bc1ba8f08bfa073c1f3f58465812e139f032d177,1,2,1,3,1,2013-07-26 20:58:18,2013-07-26 20:58:18
bc1ba8f08bfa073c1f3f58465812e139f032d177...953e0e445cdbb3fde7253810d0074e1172f4b9fd,1,1,1,2,1,2013-07-26 20:59:56,2013-07-26 20:59:56
faa00629c440b45e9a151764a5518ff5691500c9...72d2661ff0f842b2bcf76a7a5e911644d587cc79,1,1,1,2,1,2013-07-24 03:53:12,2013-07-24 03:53:12
faa00629c440b45e9a151764a5518ff5691500c9...984a0d1c7859f489f0770f75235b7645c38fb393,1,1,1,2,1,2013-07-24 02:52:44,2013-07-24 02:52:44
984a0d1c7859f489f0770f75235b7645c38fb393...ced204c7746e7ead0c9da02edbbd785e08792422,1,8,8,16,5,2013-07-24 03:16:02,2013-07-24 03:16:02
faa00629c440b45e9a151764a5518ff5691500c9...13f2a68a23e426f37b9127c7838233fc4f63ffe3,1,1,1,2,1,2013-07-24 02:38:23,2013-07-24 02:38:23
c7995cf9645f52966c142d682f1746840572875d...90fb40b7073af222478a99ee1ef93da879cac8b8,25,45,45,90,44,2013-07-25 19:24:13,2013-07-25 19:24:13
c7995cf9645f52966c142d682f1746840572875d...bc93a429a8dc981dce39a878c8dd279f250db92d,3,7,13,20,3,2013-07-25 18:55:12,2013-07-25 18:55:12
7b9a949a1887a2da291347a66f3c6ae132b24d29...0da0b321ab916b6f07f85e9d43a6e4f52683c3ce,1,1,1,2,1,2013-07-27 05:36:23,2013-07-27 05:36:23
7b9a949a1887a2da291347a66f3c6ae132b24d29...45f6f1629ba86d710ae401aa486246b3762db07d,1,1,1,2,1,2013-07-27 05:31:14,2013-07-27 05:31:14
4130a1093d8cf07cd7a22f9f9cacb83f40555d09...c6c3009dd0a801425c1a083f256222877d5b4dcf,1,1,1,2,1,2013-06-18 04:36:03,2013-06-18 04:35:58
c6c3009dd0a801425c1a083f256222877d5b4dcf...4b4079b2242d29b5fbec157ebdad76c5c22d2c1d,1,1,1,2,1,2013-06-18 18:16:43,2013-06-18 18:16:43
ac3521fef4f69bfc025677e9d3020fb39de35f73...50df5de14f80a9f0ba1252195303d64b574b483f,1,2,2,4,2,2013-06-17 03:36:56,2013-06-17 03:36:56
ac3521fef4f69bfc025677e9d3020fb39de35f73...c1655e6cbd59e0e9d1d969ca7471c615f8fa9fa6,2,147,129,276,40,2013-06-17 03:16:56,2013-06-17 03:16:56
ac3521fef4f69bfc025677e9d3020fb39de35f73...125e472d6f989a029c6def1c39afee1a21b2e41e,2,0,7,7,2,2013-06-16 20:18:46,2013-06-16 20:18:46
c75f3748e8b04c6147c04b03bfb9923739046c7b...73427f717d6c946317cec34df5d852321e20e3ca,1,7,7,14,5,2013-07-26 22:34:50,2013-07-26 22:34:50
73427f717d6c946317cec34df5d852321e20e3ca...68827689e877aca14197a1e889531dcc2130ce18,4,8,52,60,5,2013-07-26 22:41:16,2013-07-26 22:41:16
68827689e877aca14197a1e889531dcc2130ce18...01c6617f79b72c72ef9dfe5085638e69ec80f090,4,49,17,66,12,2013-07-26 22:51:25,2013-07-26 22:51:25
01c6617f79b72c72ef9dfe5085638e69ec80f090...6585c723f8c88cc1d4f3b99d8b3f73ed770c83c3,1,1,1,2,1,2013-07-26 23:01:24,2013-07-26 23:01:24
6585c723f8c88cc1d4f3b99d8b3f73ed770c83c3...e686464ad89e826a6e1222f6c94cff2ea8332be6,1,0,4,4,2,2013-07-26 23:01:34,2013-07-26 23:01:34
e686464ad89e826a6e1222f6c94cff2ea8332be6...75f5a70f7d86797913fb412ded4d2fd1c7061168,2,91,31,122,22,2013-07-26 23:52:09,2013-07-26 23:52:09
953e0e445cdbb3fde7253810d0074e1172f4b9fd...b82692b2bf328c6c0c8ecce1e872625f62bae122,1,9,9,18,6,2013-07-26 21:09:12,2013-07-26 21:09:12
953e0e445cdbb3fde7253810d0074e1172f4b9fd...0168ebade23ab7dc080c25c7382811b6cb6e1a50,1,1,1,2,1,2013-07-26 21:04:35,2013-07-26 21:04:35
faba6808b7713e8ab72ae5f21eedb3736a5b45ea...6841c5096888b9a1f8b4b9453adac23cee3788d9,3,10,10,20,10,2013-07-24 05:59:09,2013-07-24 05:58:14
2447f0375879b8db0461b8870e5eb5e0280fdc87...a346ea2a1a595fec447e3a86b2e14a504bd57456,2,2,2,4,2,2013-07-24 04:23:13,2013-07-24 04:23:13
a346ea2a1a595fec447e3a86b2e14a504bd57456...1d1bd62598f309eeffb9fa4e277e02b633520a7f,3,36,8,44,16,2013-07-24 05:27:49,2013-07-24 05:27:49
d242d536c4562ab0b30afafb3d2f663e2e55e15b...35aad0745645802dab39afcbf0c566aeeee34209,1,4,0,4,1,2013-07-26 02:56:04,2013-07-26 02:56:04
d242d536c4562ab0b30afafb3d2f663e2e55e15b...13bc74b636f4a9905010df84fc07790ccced0c93,4,239,321,560,84,2013-07-26 01:29:51,2013-07-26 01:29:51
13bc74b636f4a9905010df84fc07790ccced0c93...71d3d2c3f62574bc1722d46498147cc776069c08,1,0,3,3,2,2013-07-26 01:55:00,2013-07-26 01:55:00
71d3d2c3f62574bc1722d46498147cc776069c08...27cedf71d58e47c291b73e078adf939014dd838c,5,32,47,79,26,2013-07-26 02:45:14,2013-07-26 02:45:14
4f4e74be7875fc17f5d1079e0575bafd79046869...d0cafdd3a87179d6e85d82c613f32ea974271114,4,4,2,6,4,2013-07-27 05:59:21,2013-07-27 05:59:21
45f6f1629ba86d710ae401aa486246b3762db07d...c8883647ae05aa80667f3ae49c5b321487491ecb,2,2,1,3,2,2013-07-27 06:04:03,2013-07-27 06:04:03
4b4079b2242d29b5fbec157ebdad76c5c22d2c1d...7b60d04f0cd33b9734eee78d2ef9a65085095b65,1,5,5,10,5,2013-06-18 21:35:37,2013-06-18 21:35:37
1555992e35ddc50e2939fe370c484c2a308a0483...5c63883062f4186d93ce0a8a476dbb8ebaf0731d,1,1,1,2,1,2013-06-17 03:40:50,2013-06-17 03:40:50
5f3f73c6206acfb7d893aa3a8d26642723b8837d...731cbb302e3df670c15c46d277c39d0746d73a3d,2,4,4,8,2,2013-06-17 21:21:16,2013-06-17 20:35:50
731cbb302e3df670c15c46d277c39d0746d73a3d...84c0dc13babffe781fff96611b526f5fb58ff9dd,2,0,7,7,2,2013-06-17 21:21:16,2013-06-17 20:47:03
84c0dc13babffe781fff96611b526f5fb58ff9dd...4436e727ed52e45db2f5db9bf4efcea4ba8c64c3,2,4,4,8,4,2013-06-17 21:21:16,2013-06-17 20:49:22
4436e727ed52e45db2f5db9bf4efcea4ba8c64c3...37f4a25be436e8b25004d22541809032d8354600,2,20,20,40,8,2013-06-17 21:21:16,2013-06-17 21:19:44
37f4a25be436e8b25004d22541809032d8354600...bcc3af4b2ae64221a461283ce2c9d36a3c133d57,2,22,0,22,2,2013-06-18 03:56:02,2013-06-18 03:56:02
5f3f73c6206acfb7d893aa3a8d26642723b8837d...b0d202455d9d604050768b512ff96d3b65329867,2,2,1,3,2,2013-06-17 16:56:17,2013-06-17 16:56:17
b0d202455d9d604050768b512ff96d3b65329867...6a79f53899b0d1e02d41252d0753116b3a121cd0,1,2,2,4,1,2013-06-18 19:43:34,2013-06-18 19:43:34
e4159b53f6168f05041a10355ead9d35abd0abee...2c58fab318dece74289448841545a21537b60ae6,1,1,1,2,1,2013-07-27 00:15:11,2013-07-27 00:15:11
fd6f7dcce190ded570a1282f47d4154a82096eb9...5dd2bff38c9ed23b94aae2b7b1228f62360cc0c7,1,3,3,6,3,2013-07-26 21:15:48,2013-07-26 21:15:48
5dd2bff38c9ed23b94aae2b7b1228f62360cc0c7...444973e54d56b7d722978ea398f2910fbbfe6b69,3,10,12,22,10,2013-07-26 21:31:24,2013-07-26 21:31:24
3cfa1c8a30beb081167105b7ea006e9089e566f5...217eb988b8b328369e197e616b3a7adf7b38292c,5,99,3,102,8,2013-07-24 06:50:23,2013-07-24 06:50:23
2a4a6fe0f003540360a3389d9faee677cf42aaa2...15d9c82fc5e0c93974caf655e1c3b21138781f62,3,3,3,6,3,2013-07-26 04:33:26,2013-07-26 04:33:26
2a4a6fe0f003540360a3389d9faee677cf42aaa2...ac4e7db17f3999a3b4e8625b47dda1d186b19330,5,14,16,30,5,2013-07-26 03:56:44,2013-07-26 03:56:44
ac4e7db17f3999a3b4e8625b47dda1d186b19330...56404bc89b590ee48313634b0bf2be8591fae233,4,45,11,56,13,2013-07-26 04:16:43,2013-07-26 04:16:43
d0cafdd3a87179d6e85d82c613f32ea974271114...b1e01a1b04b88514f29fa66b8ca2c73c858ce85b,1,1,1,2,1,2013-07-27 06:14:21,2013-07-27 06:14:21
40d398bcd01e538d388b1dce376b47be63b5feb7...c884e51bfc9969de28c9e3b8daefb73452c12194,1,1,1,2,1,2013-07-27 06:24:02,2013-07-27 06:24:02
986c22a5c6658d2f8cd7a7e341e9c0cd61010319...112dabb3c2f8b75a15a7cc5445c7870d3bfbb85f,1,6,6,12,3,2013-06-19 02:16:50,2013-06-18 23:36:02
112dabb3c2f8b75a15a7cc5445c7870d3bfbb85f...546d40a143539ecc4205ea4a9f5640572a2d6833,2,148,22,170,18,2013-06-19 02:16:50,2013-06-19 02:16:42
bdac42ea40d2140d57d3272d5170b0943f9e7ebe...178d8e98deff6d3f69b7a8f89fc345d65b563670,3,53,36,89,38,2013-07-27 02:25:45,2013-07-27 02:25:45
bdac42ea40d2140d57d3272d5170b0943f9e7ebe...a285a3db3f46a8134ef53b85369b6797e6473acb,1,2,2,4,1,2013-07-27 01:52:05,2013-07-27 01:52:05
a285a3db3f46a8134ef53b85369b6797e6473acb...305455a9b323f0dd43477055dae28b0d063c0880,6,23,20,43,15,2013-07-27 02:05:43,2013-07-27 02:05:43
305455a9b323f0dd43477055dae28b0d063c0880...259ff8b6a49a76231c46d922bdfdf114f1e8f8ea,4,18,6,24,7,2013-07-27 02:24:59,2013-07-27 02:24:59
259ff8b6a49a76231c46d922bdfdf114f1e8f8ea...71acb0c42bd120c61e2943f3d794a0b8a905644d,1,6,9,15,8,2013-07-27 02:25:13,2013-07-27 02:25:13
444973e54d56b7d722978ea398f2910fbbfe6b69...6aa051b000fa7e056b1964f91f9e756806b68f2b,1,1,1,2,1,2013-07-26 22:12:32,2013-07-26 22:12:32
444973e54d56b7d722978ea398f2910fbbfe6b69...4ca3e3677a763b4a31d4ecc26212381316c8390e,1,1,1,2,1,2013-07-26 22:09:27,2013-07-26 22:09:27
295a87ab0f577661befcc106fe538d5bd58a58db...0f2b22a21087cc64fd67c1e3e72560d6fd469588,9,17,12,29,12,2013-07-27 07:18:12,2013-07-27 07:18:12
295a87ab0f577661befcc106fe538d5bd58a58db...dde6c2ae4524217b2817c2f9afbab28cb0a6aede,83,23980,0,23980,42,2013-07-27 06:55:46,2013-07-27 06:55:46
546d40a143539ecc4205ea4a9f5640572a2d6833...cd09f3213ba2e07b988708dec6b888f95660b0f9,2,2,0,2,2,2013-06-20 10:50:30,2013-06-20 10:50:30
546d40a143539ecc4205ea4a9f5640572a2d6833...98a8eaffc00482caf68812fd0b4f65422caa8045,1,2,2,4,2,2013-06-19 23:08:14,2013-06-19 23:08:14
178d8e98deff6d3f69b7a8f89fc345d65b563670...e2d4cf5f683e13440c98d36b6a38d1b501336adc,8,102,74,176,34,2013-07-27 03:34:39,2013-07-27 03:34:39
e647d54f25439df4a6ebe3324f7ee81c504e84df...e3b8081b7ec12649f2a260dbff6fd6540773f52d,1,4,5,9,2,2013-07-27 02:32:05,2013-07-27 02:32:05
e3b8081b7ec12649f2a260dbff6fd6540773f52d...e2d497c385261ee03b7f0ed6caf5cc466080eeb0,1,12,12,24,12,2013-07-27 02:32:15,2013-07-27 02:32:15
e2d497c385261ee03b7f0ed6caf5cc466080eeb0...d89c3b9d232e373eabb8559c8eb852e319c6b384,1,20,20,40,20,2013-07-27 02:35:24,2013-07-27 02:35:24
d89c3b9d232e373eabb8559c8eb852e319c6b384...22fda2f54d748bf9e9fd02846a4d111366ee56b5,1,34,35,69,35,2013-07-27 02:37:31,2013-07-27 02:37:31
22fda2f54d748bf9e9fd02846a4d111366ee56b5...b2c618c212b41f2c1674c7cd0034c25222e95417,1,8,8,16,8,2013-07-27 02:38:12,2013-07-27 02:38:12
b2c618c212b41f2c1674c7cd0034c25222e95417...20040868c120f00889ee835a0b250551607d24b7,1,986,1013,1999,113,2013-07-27 02:46:42,2013-07-27 02:46:42
20040868c120f00889ee835a0b250551607d24b7...d16396f44ab01b3da09851302036019bb880d5c7,2,15,10,25,3,2013-07-27 02:50:02,2013-07-27 02:50:02
d16396f44ab01b3da09851302036019bb880d5c7...46a332049fa37dc1c6baad822cdaa32995e1ea60,1,4,3,7,3,2013-07-27 02:58:46,2013-07-27 02:58:46
0f2b22a21087cc64fd67c1e3e72560d6fd469588...94df8090a7771b463c7661b7b0aeecac328b00f4,7,29,30,59,24,2013-07-27 07:28:23,2013-07-27 07:28:23
badececcdf028330166fcc81903545def938e721...5fcdf1229d1845ce9e115b0e6390610b702a3335,1,4,4,8,2,2013-06-20 02:02:29,2013-06-20 02:02:24
6fdb18b6418d17752ee868bc21584e747b84f809...38044e55aeeb80c370e9110a2e7d339d4575a222,6,8,2,10,6,2013-07-27 03:44:35,2013-07-27 03:44:35
46a332049fa37dc1c6baad822cdaa32995e1ea60...ae3a1ddd143c78d292d2f61602067581a1233478,1,1,1,2,1,2013-07-27 03:20:21,2013-07-27 03:20:21
ae3a1ddd143c78d292d2f61602067581a1233478...425ec58ea964b632b085c65daf415988ce12a4cb,1,1,0,1,1,2013-07-27 03:36:02,2013-07-27 03:36:02
94df8090a7771b463c7661b7b0aeecac328b00f4...80123fc0398b2354ff85ff45e065117a0ad56149,7,30,38,68,7,2013-07-27 07:35:26,2013-07-27 07:35:26
80123fc0398b2354ff85ff45e065117a0ad56149...d78c85c82a1d6b3c5b8750d663ddb8ecd72b7891,1,1,1,2,1,2013-07-27 07:47:08,2013-07-27 07:47:08
05ed37fbeb33a154aaa494fdb75a8e0ecdc9a91b...8c7b0785f4dfc1eaea080bcb5cfe396edb6b9bd1,7,76,1,77,10,2013-07-27 07:43:20,2013-07-27 07:43:20
d78c85c82a1d6b3c5b8750d663ddb8ecd72b7891...9c63ffa00fd55c7e61c51b58778b06b28f93e1a8,1,1,1,2,1,2013-07-27 08:06:59,2013-07-27 08:06:59
9c63ffa00fd55c7e61c51b58778b06b28f93e1a8...f670282b40489231be1d1257a6112936fb7cb058,1,1,1,2,1,2013-07-27 16:40:35,2013-07-27 16:40:35
9c63ffa00fd55c7e61c51b58778b06b28f93e1a8...9eef7e0b1d8389d8fa1a9da33d6f80ede1f4bc4a,1,1,1,2,1,2013-07-27 15:30:44,2013-07-27 15:30:44
9c63ffa00fd55c7e61c51b58778b06b28f93e1a8...7f6c089e455eef0fe0463ee9f9d2f9cc91edab73,1,2,2,4,2,2013-07-27 12:27:45,2013-07-27 12:27:45
7f6c089e455eef0fe0463ee9f9d2f9cc91edab73...273a388995424e0fe917ee83026c042aa4f83673,1,2,2,4,2,2013-07-27 17:57:12,2013-07-27 17:57:12
2572f6fcd79d8c9eb777ef5b96ae5fee7a390a37...3d06ee3fa86aaaf1ce5fc6ba9674415cdd1563a9,1,0,0,0,0,2013-07-28 06:40:39,2013-07-28 06:40:39
57bc65f7f8a7f763f10c1272fd6256da1f3926b1...d14c72f33486674dd771c992dd5d01a113e72733,1,0,3,3,1,2013-07-27 21:04:46,2013-07-27 21:04:46
51515e6791dd6cca8410a629bf21a1fcb427e5ee...14f688c7fc7fa6569d066320c62be02b17ca91dc,3,3,3,6,3,2013-07-27 23:37:45,2013-07-27 23:37:45
14f688c7fc7fa6569d066320c62be02b17ca91dc...8cb1b766f8c3991fdc59140681378e733ea5c93a,1,2,2,4,2,2013-07-27 23:41:02,2013-07-27 23:41:02
8cb1b766f8c3991fdc59140681378e733ea5c93a...e953c23019ca8abd14e29eb03290ec6bbf5fedd9,3,1,10,11,3,2013-07-27 23:51:04,2013-07-27 23:51:04
92bd778f45d36d79f5afe12515a6de84e7f65329...f319ec1f2a279343e2bc9f555b4078de85859d31,1,0,0,0,0,2013-07-28 07:04:09,2013-07-28 07:04:09
e953c23019ca8abd14e29eb03290ec6bbf5fedd9...b281ad64096d919145159ffbc4e1a5b284708d9b,10,645,562,1207,11,2013-07-28 01:56:31,2013-07-28 01:56:31
e953c23019ca8abd14e29eb03290ec6bbf5fedd9...b4f5687c05f0085193d99165f16259471d569c97,1,2,2,4,2,2013-07-28 00:52:39,2013-07-28 00:52:39
5aad25b34be47f59b78ee070d1b37cf2b6a8766a...ce5737870545b908da0dd0744906edd12a9c126c,3,7,13,20,7,2013-07-28 02:38:05,2013-07-28 02:38:05
0d30dabadea66c84a4746aa90e265d3ab64ba415...c5d3e1421fdb6d77c3635dc3ea86931f1b3fad12,1,0,0,0,0,2013-07-30 18:11:16,2013-07-30 18:11:16
ce5737870545b908da0dd0744906edd12a9c126c...e5a7af36d5a67bb4c3dfa5cc3e9924c3c901d0d3,4,12,8,20,4,2013-07-29 05:14:43,2013-07-29 05:14:43
ce5737870545b908da0dd0744906edd12a9c126c...ba62cfeffebb3be25241f430d63b2e229a1294d4,1,1,0,1,1,2013-07-28 04:38:59,2013-07-28 04:33:11
ba62cfeffebb3be25241f430d63b2e229a1294d4...03b2866b9e83d328d2199c3b44caa31ca4d3c41d,1,2,0,2,2,2013-07-28 04:39:11,2013-07-28 04:33:41
ce5737870545b908da0dd0744906edd12a9c126c...8a430b36987c98433fd8d9a8035df0d9ec73cb87,1,1,0,1,1,2013-07-28 04:33:11,2013-07-28 04:33:11
8a430b36987c98433fd8d9a8035df0d9ec73cb87...880f43221d0f0820d208afcb05f295c6a0afa27a,1,2,0,2,2,2013-07-28 04:33:41,2013-07-28 04:33:41
ce5737870545b908da0dd0744906edd12a9c126c...7b6f85c1799ea05471d955e2148a3bf9d7b3b541,2,0,28,28,3,2013-07-28 02:50:33,2013-07-28 02:50:33
5abdcb3e712a487a5ff73c6e6c8112067e6259af...3581c99afd9d13c32c0bdc3a22cd18562146382f,1,0,0,0,0,2013-08-03 02:47:01,2013-08-03 02:47:01
3581c99afd9d13c32c0bdc3a22cd18562146382f...a1c29c1e727286d3a732cee6cb8617533265befc,2,2,2,4,2,2013-08-03 03:01:21,2013-08-03 03:01:21
a31c5cea422b858f546529009723c4d33dd0d0ea...edaeb338168e99548e94e59d2d8ed43b95144d7d,1,5,6,11,5,2013-07-29 05:23:20,2013-07-29 05:23:20
03b2866b9e83d328d2199c3b44caa31ca4d3c41d...9c672c6b20f0eee1133f572468f1bbe8ab724c4d,1,2,0,2,2,2013-07-28 04:56:44,2013-07-28 04:56:44
c25bf6ba460125f7a99e0867062eceb2bc1dc9f5...efac0bf8d6cda1e6af85fb84d30d673c8e0a2ee8,6,5,19,24,11,2013-07-28 06:05:47,2013-07-28 06:05:47
939c9590e5825bd1b5c3849fe4b8293d56c94750...4f793752c5d512333a10f55196bbdf4b67662f84,1,1,1,2,1,2013-07-28 06:53:09,2013-07-28 06:53:09
e74a25a3b80c915565cbcf76b5f7d69063894b58...6c44246dc9e61c552a5d6f1d30732e458933d653,1,1,0,1,1,2013-07-29 16:42:50,2013-07-29 16:42:50
6c44246dc9e61c552a5d6f1d30732e458933d653...7b42b8b0fefa3511862040c58aaaf8f8b6800cbb,1,5,4,9,3,2013-07-29 19:28:54,2013-07-29 19:28:54
96136dbb56e136278cc7084caf84291949925d0c...c15f5a89a07316404b289fc0c65db1a4e52c95d1,5,78,2,80,6,2013-08-05 21:19:32,2013-08-05 21:19:32
96136dbb56e136278cc7084caf84291949925d0c...c321adf2896f67eb35d72c609409bd710a10fdec,1,1,1,2,1,2013-08-05 20:13:54,2013-08-05 20:13:54
4f793752c5d512333a10f55196bbdf4b67662f84...c6aedfb87735ef82f3e390818956f47eb15141fd,1,2,2,4,1,2013-07-28 07:03:24,2013-07-28 07:03:24
d771b549e3a0685591afd7a12a2bc6af6d69fd28...cb430701cc26d842cf5b4f74ade103cfb33af1b7,1,0,0,0,0,2013-08-05 15:25:03,2013-08-05 15:25:03
f3cff49d6d8e183b5e1b3a54dff360e1e42bbcbe...3a50ce359602b90decf7d038692c28641bcee875,1,2,2,4,1,2013-07-29 06:13:43,2013-07-29 06:13:43
3a50ce359602b90decf7d038692c28641bcee875...be0974802d9ff19d6b4c12c288b3a4fd5c625415,1,1,1,2,1,2013-07-29 07:21:18,2013-07-29 07:21:18
be0974802d9ff19d6b4c12c288b3a4fd5c625415...b1a1210f071b696450f323f35b55b399a17d5396,1,5,5,10,3,2013-07-29 10:35:45,2013-07-29 10:35:45
f3cff49d6d8e183b5e1b3a54dff360e1e42bbcbe...e77d13448186dd3bdbf466a681b46876882f16f2,3,7,1,8,3,2013-07-29 06:09:41,2013-07-29 06:09:41
d08d9a63c3b61e834d5109069805867dfa841dcf...d9c9afa6d180001fd4ae1f8be9f330fdffc959ca,3,4,1,5,3,2013-07-29 21:53:55,2013-07-29 21:53:55
d9c9afa6d180001fd4ae1f8be9f330fdffc959ca...09fff764eda8c5f10805ba7af6ae9aa93ecb79b4,1,2,0,2,1,2013-07-30 00:03:00,2013-07-30 00:03:00
d08d9a63c3b61e834d5109069805867dfa841dcf...1e0c0b8f94bee92cd34e4b323b75543f38c2fb42,1,1,1,2,1,2013-07-29 20:26:00,2013-07-29 20:26:00
bfe76273a0402f65687bdd56d6df9906edd248bd...844df9e0011c0dff5900bcbed3f1146564c0103c,4,22,12,34,6,2013-08-05 21:45:00,2013-08-05 21:45:00
bfe76273a0402f65687bdd56d6df9906edd248bd...f3fd67772e4466bd17ccffa114287f55ac09345d,1,1,1,2,1,2013-08-05 21:37:08,2013-08-05 21:37:08
f3fd67772e4466bd17ccffa114287f55ac09345d...e70d146b202819cefc198d76a32faca156b49b84,1,1,1,2,1,2013-08-06 09:44:55,2013-08-06 09:44:55
c6aedfb87735ef82f3e390818956f47eb15141fd...b9ff4234438e182aad434859bfeec7424d2be2a5,1,1,1,2,1,2013-07-28 07:08:55,2013-07-28 07:08:55
250ee7fc10142f86c27425c1ef309b9876dcaa14...d87745d94d1b205e5ed6757886a9f2a97d157630,1,4,4,8,4,2013-08-05 15:37:53,2013-08-05 15:37:53
b1a1210f071b696450f323f35b55b399a17d5396...270316f140e821d7ba9a5675def47086abe4fc39,3,5,5,10,3,2013-07-29 12:23:01,2013-07-29 12:23:01
2dcfa00e563d4a7649098d4bb41271791cb90074...5716355cda6ad163342daf2fa021045d8afe9c36,4,20,3,23,7,2013-07-30 00:08:04,2013-07-30 00:08:04
1e0c0b8f94bee92cd34e4b323b75543f38c2fb42...dfd10efd80ab56004cb34156b713e8ee7bffb075,1,1,0,1,1,2013-07-29 23:57:30,2013-07-29 23:57:30
844df9e0011c0dff5900bcbed3f1146564c0103c...c4281f39190b99ed543b046430e32ff488092ecd,5,26,12,38,10,2013-08-05 22:30:28,2013-08-05 22:30:28
c4281f39190b99ed543b046430e32ff488092ecd...0faf42b4bc3fd301beaa5b5f9b4d367f69899b05,3,1,3,4,3,2013-08-05 22:35:16,2013-08-05 22:35:16
b9ff4234438e182aad434859bfeec7424d2be2a5...111dc1492f4887d02cc3af9d8e564a339bb45462,3,4,6,10,3,2013-07-28 16:37:10,2013-07-28 16:37:10
b9ff4234438e182aad434859bfeec7424d2be2a5...89746174b73f36fcb6a85c4a1bf99878e77a6f51,1,1,1,2,1,2013-07-28 09:05:38,2013-07-28 09:05:38
89746174b73f36fcb6a85c4a1bf99878e77a6f51...c947ab1c9aae66e0ea11288bf21c4a129d6d0c02,1,1,1,2,1,2013-07-28 10:48:40,2013-07-28 10:48:40
d87745d94d1b205e5ed6757886a9f2a97d157630...587cd6c0d61d5e8b6726c71cee1642e9f385065e,1,1,1,2,1,2013-08-06 03:02:15,2013-08-06 03:02:15
5716355cda6ad163342daf2fa021045d8afe9c36...ddafa9a0bbc9cd89376a642ba9746ec668f6ce21,1,5,0,5,3,2013-07-30 00:21:22,2013-07-30 00:21:22
fa854a58bde51945d2f0d0d7ce9c6ceb51694105...7ae32074a09fe09906f5d007c2891601e0438a5b,1,0,1,1,1,2013-07-30 00:17:52,2013-07-30 00:17:52
9bbe8a020a9082cbec011c8fae66bc5ffc8fe5bd...7bc817bcbaa26bca46dcbd2e8a1c299d1f7c4097,1,1,1,2,1,2013-08-05 22:43:39,2013-08-05 22:43:39
7bc817bcbaa26bca46dcbd2e8a1c299d1f7c4097...c2737771b4e9b63655081c91878c6e66d9c3105a,1,0,2,2,2,2013-08-05 22:58:38,2013-08-05 22:58:38
41bdd1a4823feb8b46b2fccfeec3e9c5057a0665...fd3c4cab73e26af523ba87f49ac66b00ff27cbaa,2,6,1,7,3,2013-08-07 03:14:36,2013-08-07 02:54:15
e1180daca001f8f6f4b5df7ab895bd40481835d3...b0225c073a714c8172d6d59f9b21fc669f1cf747,1,11,0,11,2,2013-07-29 05:00:49,2013-07-29 05:00:49
e1180daca001f8f6f4b5df7ab895bd40481835d3...59ad7a9cf454a024ae0c9091d2e37f373181fb27,1,0,1,1,1,2013-07-29 03:53:59,2013-07-29 03:53:59
e1180daca001f8f6f4b5df7ab895bd40481835d3...8858ef4dae8587db7ad85930b7c4baa08d9a780d,1,3,0,3,1,2013-07-29 02:25:16,2013-07-29 02:25:16
e1180daca001f8f6f4b5df7ab895bd40481835d3...6652e2684d5852076d91203a26583000027a611e,1,2,2,4,3,2013-07-29 01:46:16,2013-07-29 01:46:16
e1180daca001f8f6f4b5df7ab895bd40481835d3...0d7940d950b74220558051c56b2a98babccd5515,1,33,35,68,3,2013-07-28 23:04:12,2013-07-28 23:03:46
0d7940d950b74220558051c56b2a98babccd5515...e0395b425d0a31d3cecda0793fcc2d0bb84ed8fb,1,30,31,61,2,2013-07-29 23:27:32,2013-07-29 23:27:32
e1180daca001f8f6f4b5df7ab895bd40481835d3...7dba45bae7efe68f7fbb501ffb9a9b25bf036638,1,1,1,2,1,2013-07-28 17:46:15,2013-07-28 17:46:15
e1180daca001f8f6f4b5df7ab895bd40481835d3...c649a042864ce672cb0a9407b6fc1e365b8cac3c,1,2,2,4,2,2013-07-28 17:40:50,2013-07-28 17:40:50
c947ab1c9aae66e0ea11288bf21c4a129d6d0c02...98a24cbd25fe93db17718c10031fb654b08e266c,1,1,1,2,1,2013-07-28 14:57:10,2013-07-28 14:57:10
c947ab1c9aae66e0ea11288bf21c4a129d6d0c02...1aedb7862ccf93bb983652bc24c11cc9f01699d3,8,1448,1392,2840,79,2013-07-28 12:32:08,2013-07-28 12:32:08
a57b93ee93bae8aee3a7a97cbb7320d56641a7d6...f16214a7460dcee2340123c4ca36514d9ebc9cc6,1,0,0,0,0,2013-08-06 18:57:03,2013-08-06 18:57:03
db051288c5b29472f62ddcec018e325babffc87e...47a56f54511b5ade215d9df9b743983aa91030e2,1,1,1,2,1,2013-07-29 19:11:28,2013-07-29 19:11:28
2acb0f40c058f6893e5bcf63b9cbdc3c9faeed4c...33a61baf388fee32c24698ecb3f9b79382454d40,1,1,1,2,1,2013-07-29 18:20:41,2013-07-29 18:20:41
2acb0f40c058f6893e5bcf63b9cbdc3c9faeed4c...13406c240a4c5fdf71e8ad7dff8291b7f61915f5,1,1,1,2,1,2013-07-29 18:15:17,2013-07-29 18:15:17
87c98478d2484c8b3cb46c33b01f412b5a8ed9a0...09edfcf8c2525cb9ff397d48d8b6c9990ede30aa,3,3,3,6,5,2013-07-30 00:23:08,2013-07-30 00:23:08
09edfcf8c2525cb9ff397d48d8b6c9990ede30aa...8b5e41d900987aa46f38ec990e1a1170fc69fc00,3,26,16,42,7,2013-07-30 00:30:36,2013-07-30 00:30:36
04dc22103706519dfc48c6634351a66a3218221f...98df9495cc92bd710a6d55c4d535da7aaf730031,3,1,5,6,3,2013-08-05 23:15:36,2013-08-05 23:15:36
c2737771b4e9b63655081c91878c6e66d9c3105a...2f786aa0c1be56219d8f0a2876b3adfcddb88038,1,2,2,4,2,2013-08-07 17:47:47,2013-08-07 17:47:47
1d1e21aff6c131be7c911e2b83febe339fa48272...db45a60cc86190a060f0baf0b3961cbc690f3a65,4,9,7,16,5,2013-08-06 03:55:30,2013-08-06 03:55:30
1d1e21aff6c131be7c911e2b83febe339fa48272...b29b8acd28984b1fae4817781c0553feea0958e7,1,1,1,2,1,2013-08-06 03:19:07,2013-08-06 03:19:07
e10081774038b8454fce187bcd6ad1375e497d78...18a4082553e0ec86022ba76fddf413fbc5a8085d,2,60,23,83,13,2013-08-07 04:00:12,2013-08-07 04:00:12
18a4082553e0ec86022ba76fddf413fbc5a8085d...d1e712d84882953b7d2a43a8e70aa3b976da5fcd,3,8,6,14,4,2013-08-07 04:11:16,2013-08-07 04:11:16
d1e712d84882953b7d2a43a8e70aa3b976da5fcd...a8d95d4721e714a7e1d683e14e997faa5ccddaff,14,189,70,259,80,2013-08-07 04:58:09,2013-08-07 04:25:36
a8d95d4721e714a7e1d683e14e997faa5ccddaff...fef413f9970c6985d4f11c08056d991bd3ed3e31,1,6,8,14,7,2013-08-07 07:28:23,2013-08-07 07:28:23
fef413f9970c6985d4f11c08056d991bd3ed3e31...03258683ed73b84ab51448dc8c52e292fee8104a,1,5,5,10,3,2013-08-07 07:28:44,2013-08-07 07:28:44
402dbfb6171e18aa44e19429e796169f02b0adf7...2af9cf10ce2e93fe0ac07651d405abc484e4c608,3,20,2,22,8,2013-08-07 01:42:10,2013-08-07 01:42:10
bcc6fe5b2bf6bba6a32f0a1b9bc3f129286f70fb...774f173a18d93ba5e80d8c4c8207c8f961004da6,1,32,10,42,9,2013-07-29 05:21:16,2013-07-29 05:21:16
bcc6fe5b2bf6bba6a32f0a1b9bc3f129286f70fb...e9b1422e8614a8f1deac08941e84d93b1c1f7d5b,1,2,2,4,2,2013-07-29 05:04:21,2013-07-28 08:39:15
e9b1422e8614a8f1deac08941e84d93b1c1f7d5b...d0a2a62cd774fca9fd2664e0eaf9b93377aa0dbf,1,1,1,2,1,2013-07-29 05:04:38,2013-07-28 08:41:39
7ae7aa667672b93f4344a39a93ed2d2e68ca7a24...6da346527ba6861738c0922ed84ab0c0c1a4612d,2,5,1,6,2,2013-08-06 23:02:07,2013-08-06 23:02:07
e6ac348bfc965890ae58f9a052fbe715c52b777d...46a424fc938d26a344f5cca1aab6004eaaa4a787,1,1,1,2,1,2013-07-30 22:14:38,2013-07-30 22:14:38
17f9ddd8ec6e7b76f6361b25b85e8b675a410880...bda3db0b552c92e67feca1833914b682f5ff1566,1,0,0,0,0,2013-08-13 23:11:41,2013-08-13 23:11:41
8b5e41d900987aa46f38ec990e1a1170fc69fc00...652f0565564fcee27a8268208e9119b9e953e4c7,1,1,1,2,1,2013-07-30 05:10:53,2013-07-30 01:48:50
8b5e41d900987aa46f38ec990e1a1170fc69fc00...7cfcfdfe64159b4ea7b94606f9303ab567049198,3,5,1,6,3,2013-07-30 01:30:21,2013-07-30 01:30:21
ab090a29fb84a7127c8aeb9ab7916a10049a1e8a...f3bd6dbf0356033e110fa13856c6ea28fa6623e9,3,11,4,15,6,2013-08-05 23:16:58,2013-08-05 23:16:58
440d8f5318c3cf15ec8845fe635c6e01caf27b2b...f266595092cd43aead1f6617933554110aeb46ac,4,19,7,26,7,2013-08-06 18:18:12,2013-08-06 18:18:12
f266595092cd43aead1f6617933554110aeb46ac...2f1fcca6c541d45839d39fec94462625526e4bed,4,14,14,28,13,2013-08-06 18:18:53,2013-08-06 18:18:53
2f1fcca6c541d45839d39fec94462625526e4bed...c731961f9d89a2fe868a85daf4bbb65e55680099,1,1,1,2,1,2013-08-06 18:40:02,2013-08-06 18:40:02
5db9a10138ad41b832a4f2e4c5f98bf658159acb...b35b65d0b3689f7999be998411e632046548af6e,7,1611,89,1700,14,2013-08-08 06:06:29,2013-08-08 06:06:29
5db9a10138ad41b832a4f2e4c5f98bf658159acb...3e3e6f13aa2a47c6319bc61face01b01ace98a5e,1,2,2,4,2,2013-08-06 12:57:34,2013-08-06 12:57:34
3e3e6f13aa2a47c6319bc61face01b01ace98a5e...3fb41d240065d40c084ff9cc5c9f856d2d947577,1,2,2,4,2,2013-08-06 13:04:52,2013-08-06 13:04:52
3fb41d240065d40c084ff9cc5c9f856d2d947577...4599eb69a4c213eacabd4a6372664e9efa849bfc,1,1,1,2,1,2013-08-06 13:06:25,2013-08-06 13:06:25
b29b8acd28984b1fae4817781c0553feea0958e7...c07717ce47882a334a9dd86eb3e56adbd2d720fb,1,1,1,2,1,2013-08-09 11:57:49,2013-08-09 11:57:49
03258683ed73b84ab51448dc8c52e292fee8104a...50d5a6d17a3b1289f36333a06d0b3789dbc41683,1,1,1,2,1,2013-08-07 10:42:46,2013-08-07 10:42:46
4ebb29e5bd499bab272038a35fa4db6ba8f82da1...7bcee1acd2e0c96ffb8895f6b72505bc377c8ec1,1,4,4,8,4,2013-07-29 05:09:01,2013-07-28 08:38:48
6da346527ba6861738c0922ed84ab0c0c1a4612d...223e0321504050d4642c3db2673be0cc7f4df569,3,33,3,36,6,2013-08-06 23:39:18,2013-08-06 23:39:18
6da346527ba6861738c0922ed84ab0c0c1a4612d...f3bf32ffc51c1bafd60f5704a638fc56cf464386,2,37,3,40,5,2013-08-06 23:30:28,2013-08-06 23:30:28
46a424fc938d26a344f5cca1aab6004eaaa4a787...873f884327db773edf9d1ec361558757c293a81a,1,1,1,2,1,2013-07-31 08:26:45,2013-07-31 08:26:45
46a424fc938d26a344f5cca1aab6004eaaa4a787...b9f59428f99f11f687948afae4271704c1a429f5,1,0,7,7,7,2013-07-31 02:30:24,2013-07-31 02:30:24
5ef1fe160eb60622027dc14ab0627da704d5b374...220fee80bfc4b80f43e4316d7f5fc081ba80a0db,2,2,2,4,2,2013-07-30 15:23:25,2013-07-30 15:23:25
220fee80bfc4b80f43e4316d7f5fc081ba80a0db...dcbf1e51c41ea774aa3ad62ca87ac5478c837275,2,3,3,6,3,2013-07-30 15:35:13,2013-07-30 15:35:13
5ef1fe160eb60622027dc14ab0627da704d5b374...3d54fe180c5384aecf9090daa0dd7a99f2bfb5c3,1,2,2,4,2,2013-07-30 14:34:13,2013-07-30 14:34:13
f3bd6dbf0356033e110fa13856c6ea28fa6623e9...668bc5f4580af3827d11cfad5bc8fbe9becd7206,1,2,2,4,1,2013-08-06 00:43:29,2013-08-06 00:43:29
89b69ed77035eeb9c0034534d75fdb2062f10d47...d32012337465b7584c0dfabf8cce845075193d6d,1,1,1,2,1,2013-08-08 06:15:03,2013-08-08 06:15:03
c731961f9d89a2fe868a85daf4bbb65e55680099...b976956432ccf2e0d6f809da1ca6a9d8e99eb39b,1,1,1,2,1,2013-08-06 19:09:44,2013-08-06 19:09:44
c9c2418a47cc887ea6bacd7783582741267dcd37...061535019c9b94745c95f4f8215a55bc59b11bdd,1,2,2,4,2,2013-07-29 05:24:49,2013-07-28 08:44:23
c9c2418a47cc887ea6bacd7783582741267dcd37...70bd9b936fe02917def4b142ff2dacbb5526c6c6,1,2,2,4,2,2013-07-29 05:17:08,2013-07-28 08:42:55
223e0321504050d4642c3db2673be0cc7f4df569...c3ac95333d3c8746e8877ff02cafc41c4a692414,3,14,4,18,6,2013-08-07 00:28:02,2013-08-07 00:28:02
c3ac95333d3c8746e8877ff02cafc41c4a692414...443ff0cc32bce946b43e0f0670efe82810324dac,2,3,3,6,4,2013-08-07 00:29:41,2013-08-07 00:29:41
ab79b4ac2defa9c9d86cc208ee203871f18af642...dbde90ec0dc28aea7d9bdb337fd8f621011f2054,1,1,1,2,1,2013-08-07 00:46:40,2013-08-07 00:46:40
55e1fcef60a569fc2ff2f3bc445c5f22936cc331...3696530aafebe5f16ad801d276b25252cc645d1c,3,12,12,24,10,2013-07-31 16:11:11,2013-07-31 16:11:11
55e1fcef60a569fc2ff2f3bc445c5f22936cc331...034fb3bc870854ebc7da21953aee43fdf54b766f,1,1,1,2,1,2013-07-31 14:14:27,2013-07-31 14:14:27
034fb3bc870854ebc7da21953aee43fdf54b766f...f5f171f0edab3ff336824aa6e1dc05be039434a4,1,1,1,2,1,2013-07-31 18:51:37,2013-07-31 18:51:37
55e1fcef60a569fc2ff2f3bc445c5f22936cc331...2433faa5280218492e6a08fb9a945a2167e6e758,1,1,1,2,2,2013-07-31 13:39:07,2013-07-31 13:39:07
55e1fcef60a569fc2ff2f3bc445c5f22936cc331...a538c8dfb337731191876ec291b5f99578662e6a,1,1,0,1,1,2013-07-31 10:57:39,2013-07-31 10:57:39
076ec90d0bb689099cd884d3bdbaf8f811b8b6d4...3f3dfc54e77036e726154e21d1a34f1f5918b4d7,4,3,12,15,12,2013-08-07 01:05:37,2013-08-07 01:05:37
d9266f95c4d0d9c3ea77a413f5f0eff2eeaaaa12...da98c5c2c39d0499bed07f27ad026f219a52b8f8,1,1,1,2,1,2013-07-30 19:35:39,2013-07-30 19:35:39
da98c5c2c39d0499bed07f27ad026f219a52b8f8...5ee2a221ca03a008ae17fa576df78dcd92620671,3,3,3,6,3,2013-07-30 20:31:57,2013-07-30 20:31:57
5ee2a221ca03a008ae17fa576df78dcd92620671...c54b8adb85a1dd8d51a29ffabce14d561f894b58,3,1,9,10,3,2013-07-30 20:33:56,2013-07-30 20:33:56
c54b8adb85a1dd8d51a29ffabce14d561f894b58...fc8f4f04652f6fb29657969f7ea6f167635fd01f,1,1,1,2,1,2013-07-30 20:41:24,2013-07-30 20:41:24
d32012337465b7584c0dfabf8cce845075193d6d...dec00eeeafaa1272b8fc3754b8d134e8d358a6ed,1,8,3,11,4,2013-08-09 06:07:14,2013-08-09 06:07:14
b976956432ccf2e0d6f809da1ca6a9d8e99eb39b...093cda244ae8e65b480282ef18427c45e976abab,4,69,2,71,5,2013-08-06 19:24:14,2013-07-30 16:41:17
093cda244ae8e65b480282ef18427c45e976abab...cdc92e8139a89e93579c5d340ec27fe66e5f6e8e,1,5,1,6,1,2013-08-06 19:25:26,2013-08-06 07:39:35
b8ed111a18deaa766862f9bb0a5dd340a3d02675...92c2ad98e753c64a2bd6e3fb94870a2ad3ee0333,6,21,8,29,11,2013-08-11 22:41:06,2013-08-11 22:41:06
d490c35af379341a51bf853a5b46852e527e4ca7...887125d9f5cf3e2f2ad93385497b052da2ca4652,1,2,2,4,1,2013-08-07 20:30:00,2013-08-07 20:27:27
d490c35af379341a51bf853a5b46852e527e4ca7...001e5d3da9c53474a61adda8046cb6d05901dcbd,1,47,14,61,11,2013-08-07 19:15:01,2013-08-07 19:15:01
d490c35af379341a51bf853a5b46852e527e4ca7...a24bc28de8d29b72d1eff652459957cc59a9fbab,1,11,0,11,1,2013-08-07 18:15:12,2013-08-07 18:15:12
a24bc28de8d29b72d1eff652459957cc59a9fbab...f90ac58410fcc511531484341e12c79023369a17,1,5,30,35,5,2013-08-07 18:19:12,2013-08-07 18:19:12
acc9f5d88a72f23cd58b13e8879a4a37588ea311...fe5580e4fc2117ccb7ad8cef26da99e614d99c3c,1,0,24,24,1,2013-08-07 00:56:20,2013-08-07 00:56:20
f62fb27b048c8b6b2d7cff1531e71df81f05395c...e66096368988300cce1b42c7788db6ffeec3acf8,1,16,0,16,4,2013-07-31 23:47:22,2013-07-31 23:46:21
ba05b7a63c6beacf6ba1ac66604b63421e9d893c...29b36bf962d8fb553516ddc865951a80deb7b347,2,36,5,41,8,2013-07-31 17:27:43,2013-07-31 17:27:43
000f89829e5a5f9acd6e687743ab2a63c54003dd...75b0e92bc4f6c0e5dd4506ac4f6970427b5854f8,1,2,2,4,1,2013-08-07 01:29:18,2013-08-07 01:29:18
fc8f4f04652f6fb29657969f7ea6f167635fd01f...69f99201327662ec1bd0e15516a064e6dcc9236c,1,1,1,2,1,2013-08-02 22:10:14,2013-08-02 22:10:14
4bac2c567a139958cb2ff35f7ad30c7dcd8527a3...602e0c0ba04449e5b84c0490e3a22cb7b82f7131,1,4,4,8,4,2013-08-03 08:18:15,2013-08-03 08:18:15
4bac2c567a139958cb2ff35f7ad30c7dcd8527a3...2fd8689b08ecef4f2d1efa5d1e1edede21d2403f,1,2,2,4,2,2013-08-03 07:56:06,2013-08-03 07:56:06
2fd8689b08ecef4f2d1efa5d1e1edede21d2403f...777ae911b6d5d290675b8d90d8262fa2d355cb9e,1,1,1,2,1,2013-08-03 07:59:37,2013-08-03 07:59:37
e46708f7cee19ebe4acf04c71ef71947e6c2e20f...ee62c37f17c7a741f6465f067a797881737e6fb3,1,2,4,6,2,2013-08-09 07:24:38,2013-08-09 07:24:38
e46708f7cee19ebe4acf04c71ef71947e6c2e20f...dbed9da77403337235acb652c3128ebc84672d60,3,27,23,50,21,2013-08-09 07:16:47,2013-08-09 07:16:47
d22bd3a6608e623a55907b65a9d953acfc784130...d3a26a5afeb3bdb2e116c822c1505b716e66dacb,1,2,2,4,1,2013-08-08 19:07:27,2013-08-08 19:07:27
d3a26a5afeb3bdb2e116c822c1505b716e66dacb...f86f6ee9555819468467d48387becf80c831d34f,5,10,10,20,8,2013-08-08 20:31:22,2013-08-08 20:29:46
d22bd3a6608e623a55907b65a9d953acfc784130...64888ce0b098402b77e198dca24b27861b3fde32,1,1,1,2,1,2013-08-08 16:31:48,2013-08-08 16:31:48
d22bd3a6608e623a55907b65a9d953acfc784130...5c98288122daefc6793b4e2fa1d100a7c3833b49,1,1,1,2,1,2013-08-08 10:26:06,2013-08-08 10:26:06
d22bd3a6608e623a55907b65a9d953acfc784130...f69833f9a92615dbad9cbd886f09b7e9e542b538,1,0,1,1,1,2013-08-08 10:21:27,2013-08-08 10:21:27
8b8bf91825862b989890605b9d934cc8172f9714...f816a18f7980d22de07f6e341551af68c3ba7958,1,1,1,2,1,2013-08-06 21:02:57,2013-08-06 21:02:57
8b8bf91825862b989890605b9d934cc8172f9714...521f852744399a6e9f1cf1b944db682b56b85c3a,1,1,1,2,1,2013-08-06 21:01:10,2013-08-06 21:01:10
83c236f5705822882e094d08e0bfa193d4e9f4ae...8b76e0d0f0c5679f12935c4a3dad98917636702b,2,5,3,8,5,2013-08-12 00:23:19,2013-08-12 00:23:19
8b76e0d0f0c5679f12935c4a3dad98917636702b...58b90dae1570eca6c921933742bf418ebf3ee47b,2,9,15,24,17,2013-08-12 00:47:30,2013-08-12 00:47:30
58b90dae1570eca6c921933742bf418ebf3ee47b...286636755a42887a24ec48c8c2db57b32f0df000,1,1,0,1,1,2013-08-12 00:47:53,2013-08-12 00:47:53
286636755a42887a24ec48c8c2db57b32f0df000...83f1a75e7a8ae4570641f1fcf88c2062373fff62,2,4,2,6,4,2013-08-12 01:06:26,2013-08-12 01:06:26
83f1a75e7a8ae4570641f1fcf88c2062373fff62...a66cdb0c304b701c299bdbf24a53dd6105d4429d,2,2,1,3,2,2013-08-12 01:09:56,2013-08-12 01:09:56
a66cdb0c304b701c299bdbf24a53dd6105d4429d...e9650f51bf9e335076ae2890915a99fee82ed9a7,3,3,3,6,3,2013-08-12 01:10:42,2013-08-12 01:10:42
e9650f51bf9e335076ae2890915a99fee82ed9a7...c2cfd3153bd181ebd05b347d04b3fff08fa1d890,2,2,1,3,2,2013-08-12 01:32:52,2013-08-12 01:32:52
c2cfd3153bd181ebd05b347d04b3fff08fa1d890...ba8026e00f85f76e88a4005162612a7568a0a405,3,14,39,53,17,2013-08-12 02:06:26,2013-08-12 02:06:26
ba8026e00f85f76e88a4005162612a7568a0a405...85ec6e741d278623e079528959360b2dbded4794,3,11,1,12,5,2013-08-12 02:19:44,2013-08-12 02:19:44
85ec6e741d278623e079528959360b2dbded4794...fca5c812c593b4c17121ae1d9c647c0387b51d8e,1,1,1,2,1,2013-08-12 02:19:56,2013-08-12 02:19:56
fca5c812c593b4c17121ae1d9c647c0387b51d8e...bf4900072dba32ba6db36321f6d3175bd4b43718,3,1,3,4,3,2013-08-12 02:20:23,2013-08-12 02:20:23
bf4900072dba32ba6db36321f6d3175bd4b43718...0819cfc4503ffc2084f9358b9c896b50c0ddf864,2,6,3,9,4,2013-08-12 02:32:16,2013-08-12 02:32:16
0819cfc4503ffc2084f9358b9c896b50c0ddf864...2ae8be3b316137fe63f5979480bdb731ed2b8c24,1,35,11,46,13,2013-08-12 03:33:58,2013-08-12 03:33:58
c587114f9964ac01183c01da30c3746cd9298729...407c966736c93ca63509fa3e1bffff8c5dc6f946,1,28,40,68,12,2013-08-07 20:47:49,2013-08-07 20:47:49
f50aea30c46e42ccfbdd1971f6f60bb2eadf3588...efe62a7ef4b52229403253f8d7fd39d2d96ac875,2,119,21,140,17,2013-08-12 07:36:22,2013-08-12 07:36:22
efe62a7ef4b52229403253f8d7fd39d2d96ac875...86fd07f93c2d336aa4b74aebfaa37662f5240897,1,1,1,2,1,2013-08-12 07:40:36,2013-08-12 07:40:36
86fd07f93c2d336aa4b74aebfaa37662f5240897...aefed0ada9791338be11dd5318b24f17f517d51a,2,24,0,24,2,2013-08-12 07:48:36,2013-08-12 07:48:36
aefed0ada9791338be11dd5318b24f17f517d51a...6dbf588237529fc8909bf65caa103fd4fc224fbc,5,56,35,91,21,2013-08-12 08:20:22,2013-08-12 08:20:22
6dbf588237529fc8909bf65caa103fd4fc224fbc...acdbe738517b592d8a92fb7c94da09c20d5e65f9,3,50,45,95,11,2013-08-12 08:38:06,2013-08-12 08:38:06
acdbe738517b592d8a92fb7c94da09c20d5e65f9...5e73cc90d9104dc251fba5dcaf203523785ee9a5,4,15,25,40,7,2013-08-12 08:39:43,2013-08-12 08:39:43
5e73cc90d9104dc251fba5dcaf203523785ee9a5...175a112548120500022882d6d2e9bede720f568b,3,11,1,12,3,2013-08-12 08:56:38,2013-08-12 08:56:38
f43fa23ae0bacee23c19a65e39b96b3a21b9adf1...4c27f3ce8018cab6340b8b801ee5e8f362fbe3d3,2,28,28,56,3,2013-08-01 00:07:55,2013-08-01 00:07:55
f43fa23ae0bacee23c19a65e39b96b3a21b9adf1...afef74d03d393863048f7374a1ff9e0c4ad93bbb,2,4,0,4,1,2013-08-01 00:05:06,2013-08-01 00:05:06
3cdb07fab3957ce3a97d17ea9cdf55b4c35c5cbc...e9413315b55ec036a6de9846e4fb2fed1f910b7c,3,3,1,4,3,2013-08-01 01:06:20,2013-08-01 01:06:20
e969d2ff18214c8d3b2730155d933c0acd614344...f6cec812a6a0a4488fc675bbe7d02cfe7d1f7a2d,3,7,3,10,3,2013-08-02 22:13:12,2013-08-02 22:13:12
5b66a1608e62fd9d82ae8f0fe300af69777423d0...3a96ff9a0a9c1eac4d19fb708e1901cc81d2d9df,1,1,1,2,1,2013-08-03 09:21:29,2013-08-03 09:21:29
3a96ff9a0a9c1eac4d19fb708e1901cc81d2d9df...364fdf7fa12c962600271d07c0cafd67d78c2e51,1,1,1,2,1,2013-08-03 09:22:55,2013-08-03 09:22:55
364fdf7fa12c962600271d07c0cafd67d78c2e51...fce2e89b7d772fcac3bf49117f203ec32c751dfe,1,1,1,2,1,2013-08-03 09:24:31,2013-08-03 09:24:31
32369b2f789c4c93310cf4663c716cacd98c9de6...d557fa283952362b46b863b150b52ebfc51f1b71,1,2,4,6,2,2013-08-09 07:44:10,2013-08-09 07:44:10
dbed9da77403337235acb652c3128ebc84672d60...a4f0e8d37ab109c3f4476877854d4aea149fb1f2,4,166,143,309,19,2013-08-10 20:35:20,2013-08-10 20:35:20
5eac5dab5dcca2e9b46e8053fdad72c8f2a29a99...308d40a729717fd49cf56b597ecbdcb0f22405cd,2,1,53,54,2,2013-08-10 23:11:10,2013-08-10 23:11:10
308d40a729717fd49cf56b597ecbdcb0f22405cd...d5290c61d80ee6ed108b498221fb48a84b4f2e6f,2,4,4,8,4,2013-08-10 23:11:34,2013-08-10 23:11:34
f816a18f7980d22de07f6e341551af68c3ba7958...a4638259a5f7358436ab24ef68e3589e30f18f0b,1,1,1,2,1,2013-08-07 13:18:12,2013-08-07 13:18:12
187e6641a86c8cd94fcb7649962958f0caaea010...06949d6a1801704282442696ec7f46c5c331918e,1,1,1,2,1,2013-08-06 21:57:14,2013-08-06 21:57:14
c52a3508c616da928622bdfc930e2e11741a65e2...ac746559980ab702b4feed6c29e22138b7b15937,1,3,1,4,2,2013-08-12 03:45:51,2013-08-12 03:45:51
32f6cbf9d0b3bb564590fb920364ddcebb0dee12...8bdffecf8f65a7bd4f27ad4d2afb922291a4e4ad,7,1652,230,1882,23,2013-08-12 01:42:13,2013-08-12 01:42:13
32f6cbf9d0b3bb564590fb920364ddcebb0dee12...06da4907070d59363a6434e7610703f358815650,1,1,1,2,1,2013-08-12 00:46:07,2013-08-12 00:46:07
175a112548120500022882d6d2e9bede720f568b...55cfa8d38f71623aaa5e2aae97b483af60650910,7,5,19,24,7,2013-08-12 17:01:13,2013-08-12 17:01:13
175a112548120500022882d6d2e9bede720f568b...8dd45053ce70227f9a18531f7a110cc05c41c15e,3,7,7,14,7,2013-08-12 15:56:10,2013-08-12 15:55:25
175a112548120500022882d6d2e9bede720f568b...38b2083f3cfd41711260a3b847e58594750a31eb,1,6,6,12,3,2013-08-12 15:38:20,2013-08-12 15:19:55
175a112548120500022882d6d2e9bede720f568b...587a001dcce9f8dcf223a1f0c7dbefc58efbd6ad,1,35,2,37,2,2013-08-12 15:05:15,2013-08-12 15:05:15
175a112548120500022882d6d2e9bede720f568b...d80d9251efe88f7ff80b84e28b01292a02dc634a,1,1,2,3,2,2013-08-12 12:20:17,2013-08-12 12:20:17
175a112548120500022882d6d2e9bede720f568b...6993db1840561e89dd772302d5b3d567bc92f033,2,13,8,21,3,2013-08-12 12:07:19,2013-08-12 12:07:19
175a112548120500022882d6d2e9bede720f568b...83293516b6b1785e8f57dc26b9023f26cd7a89a1,2,8,8,16,8,2013-08-12 11:55:09,2013-08-12 11:55:09
4c27f3ce8018cab6340b8b801ee5e8f362fbe3d3...60e1f5e0e80602f3e1d00a77920b41c794175c0a,3,142,3,145,5,2013-08-01 00:48:22,2013-08-01 00:48:22
60e1f5e0e80602f3e1d00a77920b41c794175c0a...3c39bc0d9609389f5e2e0357a677f50058d02a8a,2,21,1,22,2,2013-08-01 01:02:12,2013-08-01 01:02:12
3c39bc0d9609389f5e2e0357a677f50058d02a8a...7e19b6b02ccd5417a6c2d3d418c08219773f1112,1,55,0,55,1,2013-08-01 01:02:41,2013-08-01 01:02:41
e9413315b55ec036a6de9846e4fb2fed1f910b7c...ccd4c9d7b5f90cbbef7f2c9d6b9b3dec615185fc,3,9,5,14,7,2013-08-01 05:28:05,2013-08-01 05:28:05
ccd4c9d7b5f90cbbef7f2c9d6b9b3dec615185fc...7a3c61ee33b8a07de20b2d30ed2bcd5fd7649fd6,2,2,2,4,2,2013-08-01 05:57:00,2013-08-01 05:57:00
e9413315b55ec036a6de9846e4fb2fed1f910b7c...56aedcb71397c867396455b6860d627c1efe2707,3,3,1,4,3,2013-08-01 03:26:12,2013-08-01 03:26:12
e9413315b55ec036a6de9846e4fb2fed1f910b7c...521ff5c8a7c87b30de3491bfcefe4dd5f49382c4,2,18,6,24,6,2013-08-01 02:37:36,2013-08-01 02:37:36
f6cec812a6a0a4488fc675bbe7d02cfe7d1f7a2d...b1d21731adfc04adb654133988f3c8e444d8b240,2,0,9,9,2,2013-08-04 22:45:27,2013-08-04 22:45:27
f6cec812a6a0a4488fc675bbe7d02cfe7d1f7a2d...0fefbbe65964cf4dae2f60b7651e77df9324d796,1,1,1,2,1,2013-08-02 23:36:54,2013-08-02 23:36:54
0fefbbe65964cf4dae2f60b7651e77df9324d796...6b850132d056a136dc4734c4d68c9e1c23b7843e,4,38,38,76,7,2013-08-03 00:57:19,2013-08-03 00:57:19
fce2e89b7d772fcac3bf49117f203ec32c751dfe...55df26ae2061a09c5830423efc280783897fe8c9,1,131,114,245,10,2013-08-03 23:03:38,2013-08-03 23:03:38
fce2e89b7d772fcac3bf49117f203ec32c751dfe...bf0f3c7c1ca061616d8c6252b7024c8332248ffe,1,1,1,2,1,2013-08-03 19:09:56,2013-08-03 19:07:43
fce2e89b7d772fcac3bf49117f203ec32c751dfe...744b79a6662a82a01b87cccedc242b3aff6cfae9,1,5,5,10,2,2013-08-03 14:28:17,2013-08-03 14:28:17
4582eb704f39f0de0fb969ab8c16e5f4c0b5504a...4bbbf774a4b36ce5f36e4a35a2e7bed807dd640b,3,6,2,8,6,2013-08-04 01:27:23,2013-08-04 01:27:23
d0ac0f30b45bb7eede3ec541fbd37cb24ffd7db9...b2b44a53b7196084c0d4ba80db84c2f83171a42b,1,1,1,2,1,2013-08-10 00:48:29,2013-08-10 00:48:29
b2b44a53b7196084c0d4ba80db84c2f83171a42b...d48387aa4d7ba3e6b94947b22c2d7e9afc486f0b,1,1,1,2,1,2013-08-10 00:55:12,2013-08-10 00:55:12
d48387aa4d7ba3e6b94947b22c2d7e9afc486f0b...da417c3e7e1c621973348954a5a80c8db319789e,1,1,1,2,1,2013-08-10 01:01:11,2013-08-10 01:01:11
7998c45570dba841d92ab2071562221fa733fc6b...1abb7947c2b24041efe02ae8e243e62e6afeb2c8,4,23,23,46,19,2013-08-10 21:09:05,2013-08-10 21:09:05
d5290c61d80ee6ed108b498221fb48a84b4f2e6f...6b6241feaa56e3d123fc6ff5f176c08747154324,4,11,2,13,4,2013-08-11 19:43:43,2013-08-11 19:43:43
d5290c61d80ee6ed108b498221fb48a84b4f2e6f...aa454134ecb1b0c5c10bdb8c0639dc14f1b1a001,3,66,64,130,52,2013-08-11 02:33:53,2013-08-11 02:33:53
06949d6a1801704282442696ec7f46c5c331918e...287fdf83818da096559b7c56732e1bc41c25418e,1,23,0,23,1,2013-08-06 22:21:26,2013-08-06 22:21:26
287fdf83818da096559b7c56732e1bc41c25418e...726bc028857ad9e5a9e6255cd9a638b051ad8ba7,1,1,1,2,1,2013-08-06 22:52:06,2013-08-06 22:52:06
a0f301995cbd79ee3558dc106e693d4e32e2b297...95affa32e6b756e54cc86b85a352aaa02e65bf9d,3,5,7,12,7,2013-08-12 04:17:49,2013-08-12 04:17:49
95affa32e6b756e54cc86b85a352aaa02e65bf9d...a2b9988eb908e5b95fb253aac7fde0fbd61c375e,8,776,246,1022,128,2013-08-12 07:28:50,2013-08-12 07:28:50
63425cd8043d05225bef2fd156c85af002eae59b...a86f5d24f8ce1c0ce06be74ed3602fbb83ea6594,3,23,23,46,20,2013-08-12 01:45:50,2013-08-12 01:41:31
a9a27d37944bbc1edb1248d22e596707af85502a...f662dff6e9c52770511e5f674579a27eeac85549,5,94,68,162,10,2013-08-12 18:07:23,2013-08-12 18:07:23
7a3c61ee33b8a07de20b2d30ed2bcd5fd7649fd6...1583dd55e9f05275ee054884720dce2be8e2f07a,5,220,83,303,49,2013-08-01 16:16:20,2013-08-01 15:49:16
7a3c61ee33b8a07de20b2d30ed2bcd5fd7649fd6...a5641b0cca0d179d063bbf13fc3b7702605b091b,1,3,1,4,1,2013-08-01 14:05:07,2013-08-01 14:05:07
7a3c61ee33b8a07de20b2d30ed2bcd5fd7649fd6...15b98a0bb1c7500eb0e9dc556247f5ea39af03ae,1,1,1,2,1,2013-08-01 13:39:28,2013-08-01 13:39:28
f22a077f6ea0e0d85d9899a1f44eab4733ca6af6...700e742a9cfac5e90ff882a5437e95691b090de0,1,35,0,35,1,2013-08-05 06:59:30,2013-08-05 06:59:30
700e742a9cfac5e90ff882a5437e95691b090de0...fb57eda26857f1312e4415926135e675895b13e1,1,1,1,2,1,2013-08-05 06:59:57,2013-08-05 06:59:57
f22a077f6ea0e0d85d9899a1f44eab4733ca6af6...584759eac0839feeaf5fbde339e772d389dda16f,3,5,5,10,5,2013-08-05 00:29:01,2013-08-05 00:29:01
f22a077f6ea0e0d85d9899a1f44eab4733ca6af6...2b6ec389876fac116ae2a152e47be321632dd9ba,4,57,25,82,21,2013-08-05 00:22:49,2013-08-05 00:22:49
6b850132d056a136dc4734c4d68c9e1c23b7843e...9435991ff0ffa79c027f12c0a08aa13376c3b2fe,4,101,98,199,5,2013-08-03 01:48:44,2013-08-03 01:48:44
2a2acb6bf246a9a4667c8c9e0eed8ade5e8cbb83...42e78c322bab50ed979ebc658f8c741b66fe16d0,1,1,1,2,2,2013-08-05 07:38:18,2013-08-05 07:38:18
42e78c322bab50ed979ebc658f8c741b66fe16d0...52266cfdcdbb010a27cb9364ab4dc277a1cd75de,2,7,6,13,3,2013-08-05 07:39:03,2013-08-05 07:39:03
52266cfdcdbb010a27cb9364ab4dc277a1cd75de...11e46845b2d33889a7aa9bed7e63b686061e1db3,3,5,2,7,4,2013-08-05 07:47:23,2013-08-05 07:47:23
11e46845b2d33889a7aa9bed7e63b686061e1db3...d2389ec7c41183bde77b39ff8f86ff827c9b2174,3,3,1,4,3,2013-08-05 07:50:40,2013-08-05 07:50:40
30a01e0a3321426d581e63c97e21c2141357b631...23ef8c0c209844dd8b92d2a5ac82daffa7bd2914,16,121,121,242,91,2013-08-04 04:39:57,2013-08-04 04:39:57
23ef8c0c209844dd8b92d2a5ac82daffa7bd2914...7a04e95b719c118ef531511300617f3edd361b08,1,1,1,2,1,2013-08-04 04:58:31,2013-08-04 04:58:31
7a04e95b719c118ef531511300617f3edd361b08...b9c572184f18a5c228dedd41e3b93b94c8d71b7b,1,21,0,21,2,2013-08-04 04:59:01,2013-08-04 04:59:01
b9c572184f18a5c228dedd41e3b93b94c8d71b7b...cabcd36019cb7000c537bcd8292d4905239685f7,1,1,1,2,1,2013-08-04 04:59:30,2013-08-04 04:59:30
a19ed6dcc198143a13e0a945c4972c67a86ba77a...0b9efa95656a4f04b3bf09d55727fcfa9158e65a,1,2,2,4,1,2013-08-11 20:20:24,2013-08-11 20:20:24
f47a1905e2847e528d982fbd454b2b8c8ce900bb...1355c58cf2c09419d601f05ee16bdb9d8ef49367,1,2,2,4,2,2013-08-12 02:26:40,2013-08-12 02:26:40
a74d6cfe735bb7749ad5843d5faa2f5f9745a426...9564c356d32168ccb9a9c28e6b51d08234993754,3,3,1,4,3,2013-08-12 18:34:28,2013-08-12 18:34:28
a74d6cfe735bb7749ad5843d5faa2f5f9745a426...f5b14997766de3a7481936e669fba03e2a10241d,1,2,2,4,2,2013-08-12 18:31:45,2013-08-12 18:31:45
cbd0b7a5057038211ca482441fa126dac605b49a...9546fc9cf004d38f7aa4d2b64e8ab6bc65920718,1,1,1,2,1,2013-08-02 00:05:23,2013-08-02 00:05:23
cbd0b7a5057038211ca482441fa126dac605b49a...655e84c532075dbef99f73818eeb85c834c6b56e,1,5,5,10,5,2013-08-01 18:13:08,2013-08-01 18:13:08
cbd0b7a5057038211ca482441fa126dac605b49a...824d5d5de486c7540f7357972d69dd169cfcfe1c,1,6,0,6,1,2013-08-01 18:07:34,2013-08-01 18:07:34
83eea13e6395d414a3c297c24b7f0f5dd7d7acce...d46e645a0f19b24280bf700f4d4fb56caadb4409,3,3,3,6,3,2013-08-02 21:07:26,2013-08-02 21:07:26
dfd6c235271e92c20db9fdc854c3d7f4a237a217...08ce3ef9e1767fa57ebdccd6dfbae5a8fbcb9fa3,2,8,2,10,3,2013-08-02 17:11:39,2013-08-02 17:11:39
2b6ec389876fac116ae2a152e47be321632dd9ba...efc7514f9f9dc3da07fd8eb6f3b2308b5f0d130f,3,4,5,9,5,2013-08-05 01:40:25,2013-08-05 01:40:25
2b6ec389876fac116ae2a152e47be321632dd9ba...180034a4b450fb4a6567d6dbaaeb680905d798c4,1,1,1,2,1,2013-08-05 00:36:08,2013-08-05 00:36:08
d2389ec7c41183bde77b39ff8f86ff827c9b2174...9108ab9fb8a5cf98b50ecd42297b8abd931c0846,3,14,10,24,7,2013-08-05 22:06:57,2013-08-05 22:06:57
9108ab9fb8a5cf98b50ecd42297b8abd931c0846...9123163b8ff05d84f1f4bada5a3466216cff8ea1,1,1,1,2,1,2013-08-05 22:29:19,2013-08-05 22:29:19
d2389ec7c41183bde77b39ff8f86ff827c9b2174...7a98af5ec82f230dfab774b213f401f47bd9e953,1,1,1,2,1,2013-08-05 15:01:33,2013-08-05 15:01:33
7a98af5ec82f230dfab774b213f401f47bd9e953...d6ed590e830be786a7d63a2eacf70b788efd8097,4,10,25,35,12,2013-08-05 15:11:13,2013-08-05 15:11:13
d6ed590e830be786a7d63a2eacf70b788efd8097...233eef6861b8e3ccd02d14b3c622d0abefd509a9,1,2,2,4,1,2013-08-05 15:13:44,2013-08-05 15:13:44
233eef6861b8e3ccd02d14b3c622d0abefd509a9...e92518aec201e5b17d464853e1d6a9359f18849b,1,1,5,6,3,2013-08-05 15:17:41,2013-08-05 15:17:41
d2389ec7c41183bde77b39ff8f86ff827c9b2174...e444baa22fbe09761ba99796858f59e98f456a4b,1,1,1,2,1,2013-08-05 09:01:44,2013-08-05 09:01:44
c45edbe6b515daad00905d351c310e7d3fa2926f...eed4844fd2d12255c0e48acbf2b7132cefd6aaff,1,3,3,6,3,2013-08-04 06:01:05,2013-08-04 06:01:05
eed4844fd2d12255c0e48acbf2b7132cefd6aaff...899c147cd561a4fd8757cb76124036e5a73c5c92,1,1,1,2,1,2013-08-04 06:16:09,2013-08-04 06:16:09
899c147cd561a4fd8757cb76124036e5a73c5c92...a84e07b27220eddb075d4df65fe24d26c722df7a,1,1,1,2,1,2013-08-04 06:23:40,2013-08-04 06:23:40
0b9efa95656a4f04b3bf09d55727fcfa9158e65a...65c0f847e96df23dccd1aa76e2b7e2972618f86b,1,18,20,38,2,2013-08-11 21:44:32,2013-08-11 21:44:32
0b9efa95656a4f04b3bf09d55727fcfa9158e65a...f38241d77e5b67e3838e1185697ef175511efbcf,2,3,3,6,3,2013-08-11 20:34:48,2013-08-11 20:34:48
2a8e5765b999ab785558966034a0d17d1b90830e...9d5473255bcd1c7d37612e8098f463280df8a31a,1,2,2,4,2,2013-08-12 03:40:22,2013-08-12 03:40:22
1462fe2c8129b8d30d2fc797b8b465b17ef2d869...7eb07932232505e45ec04376ecba040390f11064,1,1,1,2,1,2013-08-12 18:52:25,2013-08-12 18:52:25
1462fe2c8129b8d30d2fc797b8b465b17ef2d869...a09531a40e8d892b49e5b3b630fa53f1926a4286,2,2,2,4,2,2013-08-12 18:48:35,2013-08-12 18:48:35
a09531a40e8d892b49e5b3b630fa53f1926a4286...abedd38c5b4f7f9e9abfd7528b9e7679cbd46fc2,2,7,7,14,4,2013-08-12 18:52:51,2013-08-12 18:52:51
9546fc9cf004d38f7aa4d2b64e8ab6bc65920718...f4b983ed11bba1d695990fa66b14f2ce277b3c7b,1,1,1,2,1,2013-08-02 16:07:31,2013-08-02 16:07:31
7cd54e52f2d731fcf08cd2508a45417637fba4d9...173dac4e54281312ebb7ff993df20caffbc56840,5,28,19,47,21,2013-08-02 22:09:48,2013-08-02 22:09:48
08ce3ef9e1767fa57ebdccd6dfbae5a8fbcb9fa3...c017e19ed236c1e2f6d3818e080f2a03ef4f947b,4,27,27,54,27,2013-08-02 19:33:03,2013-08-02 19:31:13
5e637313b7e1f1f5f967ea2c334972a23db6912d...2641fed73f51cdd2a77698c538403cc892e183a5,3,5,5,10,5,2013-08-05 05:30:09,2013-08-05 05:30:09
2641fed73f51cdd2a77698c538403cc892e183a5...73c048578dfce7c6d4e8c9d4fe6c6bd22b2ff9b2,5,29,9,38,6,2013-08-05 06:05:54,2013-08-05 06:05:54
73c048578dfce7c6d4e8c9d4fe6c6bd22b2ff9b2...f62ea2afe281383c7550441e80fcd808479a5e2c,3,1,5,6,5,2013-08-05 06:20:55,2013-08-05 06:20:55
f62ea2afe281383c7550441e80fcd808479a5e2c...d95ff9da81057ed0abb12dcfe9a8422416916516,3,6,3,9,3,2013-08-05 06:27:15,2013-08-05 06:27:15
d95ff9da81057ed0abb12dcfe9a8422416916516...a2823d0f5efa3bf8c831de65a13d240e295493e2,3,8,1,9,3,2013-08-05 06:44:02,2013-08-05 06:44:02
180034a4b450fb4a6567d6dbaaeb680905d798c4...9c14fe604465bb031fa768dcdcbba46fb01033f1,1,2,2,4,1,2013-08-05 06:19:14,2013-08-05 06:19:14
180034a4b450fb4a6567d6dbaaeb680905d798c4...300a9e7b5ac87aa95bf149e2e89ca66dbf1e531d,1,1,1,2,1,2013-08-05 04:09:05,2013-08-05 04:09:05
38a0eb6f7719110ae1d71922ad71d55f864e2984...550493a87e268e3ab2971daa5c2be258bf611cec,2,3,2,5,3,2013-08-05 15:33:15,2013-08-05 15:33:15
39e1261de114e8c472b28c0c0bd772b6d085e46b...5e9af6578ce0941f46b06f5dc05f066575a199dc,1,1,1,2,1,2013-08-05 09:50:31,2013-08-05 09:50:31
a84e07b27220eddb075d4df65fe24d26c722df7a...19e8342c7a53a72057730d766293c1b8a74ee828,1,19,4,23,4,2013-08-04 06:34:27,2013-08-04 06:34:26
da75d0d30b2b206953b41324f2002bd3932c8e4b...a88888aaeb9c0f0138abbf7824a55aa51c394ea9,1,7,7,14,7,2013-08-11 21:49:50,2013-08-11 21:49:50
b4081e6cd4c3dfd88c479f23438c455d755de782...6393a78bf01c9347f2ab0e6db46127bf43a5727c,3,7,11,18,3,2013-08-11 21:32:32,2013-08-11 21:32:32
6393a78bf01c9347f2ab0e6db46127bf43a5727c...5c6b995971a7795a1a95db2243d6fe2c006b1098,1,23,23,46,23,2013-08-11 21:39:11,2013-08-11 21:39:11
c3c02183790f689cfb3adccf28c0dbdb949b7904...7f8f1ca65e6d908da5dce4536c3d4d5f055dc6a7,1,2,2,4,2,2013-08-12 21:30:28,2013-08-12 21:30:28
abedd38c5b4f7f9e9abfd7528b9e7679cbd46fc2...a78c8d9c04e83a22d6eebc2e3d54cb2ccf6b614c,6,107,13,120,12,2013-08-12 21:03:57,2013-08-12 21:03:57
abedd38c5b4f7f9e9abfd7528b9e7679cbd46fc2...461b05f5b1d75341fd8b98a216c69e2cc33418be,1,1,1,2,1,2013-08-12 19:09:52,2013-08-12 19:09:52
461b05f5b1d75341fd8b98a216c69e2cc33418be...af2ea581b24bfae28a72275fac000a72e9e4130a,1,2,2,4,1,2013-08-12 19:13:15,2013-08-12 19:13:15
af2ea581b24bfae28a72275fac000a72e9e4130a...38d6e7179a03c5830030d96e2ab3190760a60695,1,5,0,5,2,2013-08-12 20:35:53,2013-08-12 19:32:32
21be3efad3b1392ebc15acf082cbf3ae83437420...d0b94ead9a660adeca599b2cc49ce5134d432f2f,5,21,51,72,9,2013-08-02 16:32:58,2013-08-02 16:32:58
d0b94ead9a660adeca599b2cc49ce5134d432f2f...34e5c7542be4bf4792d77294a839f95815825f35,1,1,1,2,1,2013-08-02 16:33:12,2013-08-02 16:33:12
34e5c7542be4bf4792d77294a839f95815825f35...048e19b8921ff0cae8ade7ace7700f0563c1fb82,3,61,62,123,5,2013-08-02 16:42:50,2013-08-02 16:42:50
e23b7ec20e672e7878ef235c751f3ab3fe793140...cfacd228ebd7f52faa2dd85a20c3d2534094ee5b,1,14,14,28,6,2013-08-02 20:30:13,2013-08-02 20:30:13
550493a87e268e3ab2971daa5c2be258bf611cec...e85b8f315fd2d9cf9b00225dbe319227c940aef4,1,2,2,4,2,2013-08-05 15:45:51,2013-08-05 15:45:51
e85b8f315fd2d9cf9b00225dbe319227c940aef4...2ee9bea890bbb4b0f43e861fb4d57b3277628c09,3,15,15,30,8,2013-08-05 15:52:22,2013-08-05 15:52:22
2ee9bea890bbb4b0f43e861fb4d57b3277628c09...41eef69e6f4d86b5a7ead7abb6d20f0bf6c5404c,5,27,22,49,21,2013-08-05 16:02:59,2013-08-05 16:02:59
41eef69e6f4d86b5a7ead7abb6d20f0bf6c5404c...6af693d1602d9e4c052c23215ac3130580bfcb17,4,50,46,96,4,2013-08-05 16:10:52,2013-08-05 16:10:52
509ffe110ecf78998a32e5603abedc79d526235d...b6390d298aa71e6dccb10e539097fbc7aaa45b8a,2,2,2,4,2,2013-08-04 07:06:56,2013-08-04 07:06:56
a88888aaeb9c0f0138abbf7824a55aa51c394ea9...0561cfec6bb0fc0738f9f1cf5f4463e96fa1c33c,3,23,2,25,5,2013-08-11 22:01:16,2013-08-11 22:01:16
5c6b995971a7795a1a95db2243d6fe2c006b1098...bf2ab457eae6d54954b8e2a22596bcdd216d0ca5,1,1,1,2,1,2013-08-11 21:59:39,2013-08-11 21:59:39
7c7c447d858d6d902848bfb602bf70d898813542...e6e60d325ca69010f1334283140dfd2a2ee3cc74,1,2,2,4,2,2013-08-12 21:48:46,2013-08-12 21:48:46
c02269a9f046d2f5b267e2316b0d616e8e343c80...eb1565681fc526c7f75b90ae3dae1d82b47eb4b6,3,1,12,13,4,2013-08-12 21:52:49,2013-08-12 21:52:49
c02269a9f046d2f5b267e2316b0d616e8e343c80...e245bffe8c951a0bba2bb045fb6bbe674d471693,1,1,1,2,1,2013-08-12 21:25:15,2013-08-12 21:25:15
f25a4805ed712f6da48d247ea7bec0a62a9caf75...54a3e4b780b711660e650d909e0e11875d7ff505,1,3,0,3,1,2013-08-13 05:47:19,2013-08-13 05:47:19
6af693d1602d9e4c052c23215ac3130580bfcb17...01c46bfc0f6f23697326bc5f8d69baa4f7ef3052,4,64,27,91,26,2013-08-05 18:30:50,2013-08-05 18:30:50
6af693d1602d9e4c052c23215ac3130580bfcb17...ea17069f6e5755d74a14496cdf56887857f08d57,1,2,2,4,2,2013-08-05 17:48:51,2013-08-05 17:48:51
0561cfec6bb0fc0738f9f1cf5f4463e96fa1c33c...1ff1dfb2bd031832c725c146deb8b7363cfeadf5,1,1,1,2,1,2013-08-11 23:07:45,2013-08-11 23:07:45
31ab07b32aeabd8df3c7430dbb31d03b474360f5...c49ecc5f21f520b739c0c8a29ff4b5ece84c06ec,1,4,0,4,1,2013-08-11 22:03:48,2013-08-11 22:03:48
c49ecc5f21f520b739c0c8a29ff4b5ece84c06ec...89b3cb0dacd71fc7b20e125851f05f9ed266b50d,4,5,5,10,5,2013-08-11 22:17:04,2013-08-11 22:17:04
8a669bea2e82c2ba1f02b3232b41a2fb26661091...394f6980567c0adcb80553e2b510abab588d4c53,3,1,11,12,7,2013-08-12 22:02:09,2013-08-12 22:02:09
54a3e4b780b711660e650d909e0e11875d7ff505...b0ab806dcc3c5d64a80f34acefeb3ac75e860b33,3,9,3,12,3,2013-08-13 06:44:50,2013-08-13 06:44:50
b0ab806dcc3c5d64a80f34acefeb3ac75e860b33...36c4223b1d316c391e62741d10ad16bcf58ee36a,1,1,1,2,1,2013-08-13 07:04:58,2013-08-13 07:04:58
54a3e4b780b711660e650d909e0e11875d7ff505...237640c70697ffa0605770dee625d9e3c6abf479,11,231,112,343,53,2013-08-13 06:36:25,2013-08-13 06:36:25
237640c70697ffa0605770dee625d9e3c6abf479...09b2a153fc7cefeeeeb728c3ace270a32583114f,1,1,1,2,1,2013-08-13 06:38:52,2013-08-13 06:38:52
d0d8ab83643064751246f945d194a67c5f6f2da4...a82ca0f9e1711b32f7c07e23ea1e23dd253cd21e,3,25,1,26,7,2013-08-05 18:47:12,2013-08-05 18:47:12
a82ca0f9e1711b32f7c07e23ea1e23dd253cd21e...bac9e80a460c314209d1ee676a0eb44b9574db89,3,9,6,15,5,2013-08-05 18:59:32,2013-08-05 18:59:32
bac9e80a460c314209d1ee676a0eb44b9574db89...e23906facaa63fcc97bddbd0895c301699c9e942,5,54,8,62,9,2013-08-05 19:17:09,2013-08-05 19:17:09
89346410c7579380dc19c51366bc2c57611e41a2...3f2408f9e8cbdf359fdc587a8b463c06860162f4,1,8,0,8,1,2013-08-12 22:13:38,2013-08-12 22:13:38
3f2408f9e8cbdf359fdc587a8b463c06860162f4...3d6efcf2508f6a055e137bb0d5e8ff6a758e0400,1,2,2,4,2,2013-08-12 22:25:41,2013-08-12 22:25:41
3d6efcf2508f6a055e137bb0d5e8ff6a758e0400...55c36f86d04381eea18d581ebe87d91d57ffe454,1,1,1,2,1,2013-08-12 22:44:01,2013-08-12 22:44:01
55c36f86d04381eea18d581ebe87d91d57ffe454...fb8ae7e51499c93f5db1aae94c74dc845b884630,3,5,5,10,3,2013-08-12 22:46:11,2013-08-12 22:46:11
fb8ae7e51499c93f5db1aae94c74dc845b884630...c558c035d7eee68276c76246260913663029f1dc,3,22,18,40,13,2013-08-12 23:02:27,2013-08-12 23:02:27
36c4223b1d316c391e62741d10ad16bcf58ee36a...6ec0fd7d43d1ab243a8796b7544a4634ef086117,2,26,33,59,5,2013-08-13 17:06:02,2013-08-13 17:06:02
36c4223b1d316c391e62741d10ad16bcf58ee36a...f15f259876d77004fadf5b5937af5ab6b5eabb8e,4,96,15,111,19,2013-08-13 16:59:38,2013-08-13 16:59:38
f15f259876d77004fadf5b5937af5ab6b5eabb8e...69a3e9b4d07cdaa281525c067f11ea83e1863f1b,4,60,21,81,10,2013-08-13 17:24:18,2013-08-13 17:24:18
36c4223b1d316c391e62741d10ad16bcf58ee36a...21a7de7a18707a7cec559cb419fac251feea405d,1,1,1,2,1,2013-08-13 16:21:07,2013-08-13 16:21:07
36c4223b1d316c391e62741d10ad16bcf58ee36a...052edcd8ded04253361df5a0ed9fd5a6459cd3f6,1,1,1,2,1,2013-08-13 16:10:57,2013-08-13 16:09:38
36c4223b1d316c391e62741d10ad16bcf58ee36a...ea04fa538e7e08db6284d4aeccec3e617909af8e,2,26,38,64,3,2013-08-13 11:27:45,2013-08-13 11:27:45
ea04fa538e7e08db6284d4aeccec3e617909af8e...e74ac0723bbb5f8f08d7ee53a6ecbc0ba6933070,1,1,1,2,1,2013-08-13 12:25:05,2013-08-13 12:25:05
c558c035d7eee68276c76246260913663029f1dc...1c64c8f43bece9a2e97be510266c48969dca0963,1,2,2,4,2,2013-08-12 23:54:58,2013-08-12 23:54:58
c558c035d7eee68276c76246260913663029f1dc...eac61de138278aa1c0d70dfed7a9515c714b6ad9,3,14,1,15,5,2013-08-12 23:09:21,2013-08-12 23:09:21
3e373a844c7763f513d1aec13fcd5da9d4bcd1e8...d482b712e750cb7bb17e8076fb06752e3627ac4a,1,1,1,2,1,2013-08-13 18:15:36,2013-08-13 18:15:36
9391f4de4b5371454a67f1e1bf627566dfcd367b...4876a3a7162ea2be8b1c316fde1039d22a6b64d3,1,1,1,2,1,2013-08-13 00:06:02,2013-08-13 00:06:02
eac61de138278aa1c0d70dfed7a9515c714b6ad9...8bb7def26cac4d3166fbf2cc98f16c4151794676,8,599,456,1055,91,2013-08-13 04:23:28,2013-08-13 04:23:28
9a3aa9f1defcdf5f7a1dc0bcb9dca0f0e2d675bf...270af4dda31692eb22d48d56db5c98a0c89f4c28,3,3,1,4,3,2013-08-13 20:16:56,2013-08-13 20:16:56
9a3aa9f1defcdf5f7a1dc0bcb9dca0f0e2d675bf...84b1ef504871155685e91ea166f9a3548cdc9cb7,1,1,1,2,1,2013-08-13 18:23:44,2013-08-13 18:23:44
4876a3a7162ea2be8b1c316fde1039d22a6b64d3...df59ecc9c40534e34a140cb5a00607c50b2b500c,1,4,4,8,4,2013-08-13 00:28:53,2013-08-12 22:52:47
df59ecc9c40534e34a140cb5a00607c50b2b500c...5b9717ef67e679d3ae2a70023d042136db00ce71,1,5,5,10,5,2013-08-13 00:28:53,2013-08-12 23:00:51
5b9717ef67e679d3ae2a70023d042136db00ce71...598f811fa0838ba6153e07862621f13e6c877ca4,1,10,10,20,10,2013-08-13 00:28:53,2013-08-12 23:01:43
598f811fa0838ba6153e07862621f13e6c877ca4...520bc8cf37c0b5424427d22ecc3190b6abf461d7,1,6,6,12,2,2013-08-13 00:28:53,2013-08-12 23:22:26
520bc8cf37c0b5424427d22ecc3190b6abf461d7...81ab8ffae0a89e38c105753fc865882e6345b232,2,9,11,20,9,2013-08-13 00:43:38,2013-08-12 23:40:42
81ab8ffae0a89e38c105753fc865882e6345b232...10356f9d67e6d5a1f3440e58c81e054f078501d7,1,1,1,2,1,2013-08-13 00:43:38,2013-08-12 23:48:00
10356f9d67e6d5a1f3440e58c81e054f078501d7...a13fe0a4a04c5712cb77bed6d508c89c9bcbb18b,1,32,32,64,22,2013-08-13 00:43:38,2013-08-12 23:59:50
a13fe0a4a04c5712cb77bed6d508c89c9bcbb18b...8a1fc99f50fc157a7c396bbf1955d03f46ae126a,1,3,3,6,3,2013-08-13 00:43:38,2013-08-13 00:21:16
8a1fc99f50fc157a7c396bbf1955d03f46ae126a...f4bb660974699f4336d22385e104347f6bd4dce0,2,7,2,9,3,2013-08-13 00:46:02,2013-08-12 22:23:37
0b338b0dc76fa3cf321c9a509e892bad41fd626b...40723c8716d79e5f27791caa2da5787151a6ee6b,3,7,3,10,3,2013-08-13 04:26:43,2013-08-13 04:26:43
40723c8716d79e5f27791caa2da5787151a6ee6b...49576704ea6c24fbc4cb32f44c5986a1e7714634,3,9,5,14,5,2013-08-13 04:27:15,2013-08-13 04:27:15
80eb09cc1b1db0e7899039f67adf78f0b14ac9a5...48e7468e3acc70ace27ed37cfbadfc54d88a689f,3,55,1,56,4,2013-08-13 04:43:59,2013-08-13 04:43:59
48e7468e3acc70ace27ed37cfbadfc54d88a689f...3c772b1cebfed73570247691917b40fcf3d95aa2,4,43,17,60,24,2013-08-13 20:39:21,2013-08-13 20:39:21
715e924217003446661ed0e6ff62a0a64ea8a510...bb5be0a2f9b9ed789e79603c106e8d2c7cf62305,4,25,1,26,7,2013-08-13 00:49:01,2013-08-12 22:01:06
bb5be0a2f9b9ed789e79603c106e8d2c7cf62305...3ec793072072773c2d834d99d7e4307629c18058,1,26,26,52,7,2013-08-13 01:09:25,2013-08-13 01:09:25
3ec793072072773c2d834d99d7e4307629c18058...b33989a97791560f064e723cfff2ec5b4ac65eba,3,24,24,48,22,2013-08-13 01:59:59,2013-08-13 01:59:58
b33989a97791560f064e723cfff2ec5b4ac65eba...f2cea2dc476806b164687da331128dd5cc5132fb,1,4,4,8,4,2013-08-13 02:46:34,2013-08-13 02:29:16
f2cea2dc476806b164687da331128dd5cc5132fb...df7c9a6d96cd5ff9ab4ad9282cd12206c0cfa5bb,1,4,4,8,4,2013-08-13 02:47:05,2013-08-13 02:29:30
df7c9a6d96cd5ff9ab4ad9282cd12206c0cfa5bb...f111c3e763b4a3e10efe0da4e41cd5b4847a2b74,1,9,6,15,6,2013-08-13 02:47:18,2013-08-13 02:45:13
9482a5f8128db47bbed1378cbc9cd9c8a57fb2ce...51f692f68635d37c5069dbbdf24bfeb52aef9a26,1,1,0,1,1,2013-08-13 21:12:11,2013-08-13 21:12:11
51f692f68635d37c5069dbbdf24bfeb52aef9a26...e61c71e0775f676c3e404e7a8853949c78bc4511,1,1,1,2,1,2013-08-13 21:23:10,2013-08-13 21:23:10
e61c71e0775f676c3e404e7a8853949c78bc4511...a2475f0145f0b4c2b94feed4310ebd464fbd2df5,1,2,2,4,1,2013-08-13 21:23:17,2013-08-13 21:23:17
a2475f0145f0b4c2b94feed4310ebd464fbd2df5...2bc67b334d756f7aa26aabcc337fb4e6f6545e6b,3,3,1,4,3,2013-08-13 21:46:34,2013-08-13 21:46:34
2bc67b334d756f7aa26aabcc337fb4e6f6545e6b...bb059f28dea0463f44f265ad8f924d3cb508aa42,1,18,16,34,4,2013-08-13 21:56:22,2013-08-13 21:56:22
a2475f0145f0b4c2b94feed4310ebd464fbd2df5...f0ee3aaac03ca74cb19fc6d287b44bd9f0293ba0,1,2,2,4,2,2013-08-13 21:31:33,2013-08-13 21:31:33
3da3f7e4741aa0bc316b0c70ecee31df2783739b...8d2948c0d6d5b9f753e917aa36fe43549e696e97,2,29,29,58,9,2013-08-13 21:56:58,2013-08-13 21:56:58
8d2948c0d6d5b9f753e917aa36fe43549e696e97...fa330f308aace22886fee3dbacbcbd4f8adb0fe6,4,42,25,67,20,2013-08-13 22:19:59,2013-08-13 22:19:59
fa330f308aace22886fee3dbacbcbd4f8adb0fe6...5b4fe08f42ec433d0f193d75dbaac8e6dacae526,3,5,5,10,5,2013-08-13 22:22:05,2013-08-13 22:22:05
5b4fe08f42ec433d0f193d75dbaac8e6dacae526...d1e18e55ac7ccc069671bed4314ca9f965a09de7,2,1,7,8,2,2013-08-13 23:00:05,2013-08-13 23:00:05
d1e18e55ac7ccc069671bed4314ca9f965a09de7...a380e80cd7830b285c98c16e3782d297739695ce,1,1,1,2,1,2013-08-13 23:56:12,2013-08-13 23:56:12
66122fa153e3d0e18c9796d93f674f0b04831ee9...09e1f69d3e5c7b2f8d68e757701d48811c1a0b65,2,3,2,5,3,2013-08-14 02:40:12,2013-08-14 02:40:12
66122fa153e3d0e18c9796d93f674f0b04831ee9...e29c2d0c246dee59c22c4b39d03e3c53963b1889,3,7,2,9,3,2013-08-14 02:30:02,2013-08-14 02:30:02
e29c2d0c246dee59c22c4b39d03e3c53963b1889...c79fa6ad044b0731ce04fcadaae9604bd764aadb,3,7,3,10,4,2013-08-14 02:53:23,2013-08-14 02:53:23
9d82a8ba1ff1fb788ffb71aaff3a7bdfb07a7da2...13d2616631d9c40d3022ab1949be52f86a23b712,1,1,1,2,1,2013-08-14 04:32:49,2013-08-14 04:32:49
13d2616631d9c40d3022ab1949be52f86a23b712...aa2c152d85d1220a7b93002b54edd04e6c15cc62,1,1,1,2,1,2013-08-14 07:09:42,2013-08-14 07:09:42
aa2c152d85d1220a7b93002b54edd04e6c15cc62...72785644bd2814abd36130f18963b4a21f78cbde,1,1,1,2,1,2013-08-14 15:09:13,2013-08-14 15:09:13
aa2c152d85d1220a7b93002b54edd04e6c15cc62...80d1b6b117c76ecbbb635b626a2485dda5cf801c,1,2,2,4,2,2013-08-14 14:40:26,2013-08-14 14:40:26
aa2c152d85d1220a7b93002b54edd04e6c15cc62...1800edc07c8a4334e938d50e780f22ad0ab55474,1,2,2,4,1,2013-08-14 09:02:57,2013-08-14 09:02:57
4b0590b0e7458b221df5495dd475138484b77832...5381ed085c2af4cbacca358a1352145b9bfae48b,1,4,3,7,2,2013-08-14 22:26:01,2013-08-14 22:26:01
1fd51b0fa30f3a5a9fe563be393f2917d3821fbb...1b3896fabfb2adef82d801132ef0c834c566fa0c,3,3,5,8,3,2013-08-14 15:39:38,2013-08-14 15:39:38
1fd51b0fa30f3a5a9fe563be393f2917d3821fbb...09464b5d4183183524373c0a1c08cc69a5883918,1,0,5,5,1,2013-08-14 14:33:35,2013-08-14 14:33:35
1fd51b0fa30f3a5a9fe563be393f2917d3821fbb...48c1add83b0b391e66db29793f705d3abaeeaa3b,1,1,1,2,1,2013-08-14 14:10:48,2013-08-14 14:10:48
1fd51b0fa30f3a5a9fe563be393f2917d3821fbb...c4568e4c3ba1f4e0caa596e2a6f708edad139eff,1,8,8,16,6,2013-08-14 13:16:30,2013-08-14 13:16:30
1fd51b0fa30f3a5a9fe563be393f2917d3821fbb...1e1b5c737ba33c0e7a86634bcb3baedc70498884,3,3,1,4,3,2013-08-14 10:37:48,2013-08-13 18:28:18
057a87ed6565b46c3c2da6c8da2599576117b655...4d527ec316081113808f54a67a5a0d825071f480,3,16,1,17,3,2013-08-14 23:08:24,2013-08-14 23:06:51
b9620a1d5e519d1befd14f811c91b87f3c49f00b...cde39f7b785e5931d204ea33937adfbd7194204b,1,1,1,2,1,2013-08-14 17:53:37,2013-08-14 17:53:37
cde39f7b785e5931d204ea33937adfbd7194204b...2be8a5a2457141edf823e853b8cacec8f997f2e4,1,6,6,12,2,2013-08-14 17:57:54,2013-08-14 17:57:54
b9620a1d5e519d1befd14f811c91b87f3c49f00b...80ff4bf870716dd140592813b4c854781d32c22f,1,13,9,22,2,2013-08-14 17:31:29,2013-08-14 17:31:29
80ff4bf870716dd140592813b4c854781d32c22f...b0aef6cde00bf9bd951eb7c611043dbc815a58d7,1,60,64,124,3,2013-08-14 18:30:35,2013-08-14 18:30:35
b9620a1d5e519d1befd14f811c91b87f3c49f00b...ef60b0e5fbccbd16b964c1397a7f4cc4c9b51663,3,1,3,4,3,2013-08-14 17:03:00,2013-08-14 17:03:00
00867616605363ab2f08a8603d898d4fa68fd7a3...db684a1a618a9f51f509210a1e58b1999b401d23,1,0,13,13,1,2013-08-14 22:37:21,2013-08-14 22:37:21
db684a1a618a9f51f509210a1e58b1999b401d23...8e8fe8de93b1d25273dcabe348e2d9205a428037,1,6,0,6,1,2013-08-14 22:39:21,2013-08-14 22:39:21
a9d6b7ee0b4dd7b109daabd586d6198898816dd0...e684758b55dbfe1e18f3e3aa4d5eddcfaf1bd010,4,29,4,33,6,2013-08-15 01:20:28,2013-08-15 01:20:28
3890ab3987a4fb0027fbfcafe1d6e3f31c9fcf4a...a9972c5d201079690eece84fac60939f416795b6,1,1,1,2,1,2013-08-14 20:45:20,2013-08-14 20:45:20
3890ab3987a4fb0027fbfcafe1d6e3f31c9fcf4a...fb6bd757df2a066d0effab5a1eafca05ffe8e50e,1,4,0,4,1,2013-08-14 20:08:17,2013-08-14 20:08:17
fb6bd757df2a066d0effab5a1eafca05ffe8e50e...a3b279c556560079a84c25a631ebcec8fcefe38e,1,1,1,2,1,2013-08-14 21:26:34,2013-08-14 21:26:34
a3b279c556560079a84c25a631ebcec8fcefe38e...fb71f402456b27b66184acbd341e8119188c3c20,1,1,1,2,1,2013-08-14 21:51:26,2013-08-14 21:51:26
3890ab3987a4fb0027fbfcafe1d6e3f31c9fcf4a...72a2efb3db4721c8ffac9f092165ee03ef732840,2,38,43,81,3,2013-08-14 19:16:45,2013-08-14 19:16:45
72a2efb3db4721c8ffac9f092165ee03ef732840...537910d4843c0c7edaa6c1501498d17466e63794,1,0,2,2,1,2013-08-14 21:12:47,2013-08-14 21:12:47
c5ca743cb7a3e4ca17979854f35d21d91a7b6ef7...0456e5e4b38e4b43a11da68d2e16187728dd05a0,3,3,2,5,3,2013-08-15 06:02:58,2013-08-15 06:02:58
0456e5e4b38e4b43a11da68d2e16187728dd05a0...622fe05ff4c7f4110d5de8d4648505cfbf7349b2,3,5,11,16,5,2013-08-15 06:06:37,2013-08-15 06:06:37
622fe05ff4c7f4110d5de8d4648505cfbf7349b2...6e26f846cdb96060afb0530f1d34fdfc2a11f83d,2,16,0,16,2,2013-08-15 06:11:38,2013-08-15 06:11:38
a58bf083601c096378276275edefc53e5cc4b8c6...3a67054536338c613c43078b6f48e5f502bf527d,1,1,1,2,1,2013-08-15 02:07:14,2013-08-15 02:07:14
3a67054536338c613c43078b6f48e5f502bf527d...2e8a146b61af1e197208ae2d52ee4bf4034352d4,3,8,22,30,9,2013-08-15 04:24:48,2013-08-15 04:24:48
2e8a146b61af1e197208ae2d52ee4bf4034352d4...9de788134fa40e37577a324c0d37377dc0369ec9,3,114,137,251,15,2013-08-15 04:32:23,2013-08-15 04:32:23
9de788134fa40e37577a324c0d37377dc0369ec9...dff88d66e2dda94907dfb8cf86b8286014aef45b,1,1,3,4,3,2013-08-15 05:45:26,2013-08-15 05:45:26
dff88d66e2dda94907dfb8cf86b8286014aef45b...039966a0fcb4a264a6461b2248d5a0109867f1ae,1,5,0,5,1,2013-08-15 05:48:04,2013-08-15 05:48:04
039966a0fcb4a264a6461b2248d5a0109867f1ae...083b7c0981656ff1c660482653645bb9e4f71543,1,3,0,3,1,2013-08-15 05:52:07,2013-08-15 05:52:07
083b7c0981656ff1c660482653645bb9e4f71543...70b0fb445ee373811ea952a0936493c4f574fba2,1,3,11,14,3,2013-08-15 05:57:59,2013-08-15 05:57:59
a9972c5d201079690eece84fac60939f416795b6...49932d60b49805934b54aa22c831aaf78fc22e30,1,2,2,4,2,2013-08-14 21:24:00,2013-08-14 21:24:00
6e26f846cdb96060afb0530f1d34fdfc2a11f83d...f058a6a3ea6196af859303ff4611fd9807842f7d,2,18,4,22,4,2013-08-15 06:52:57,2013-08-15 06:52:57
6e26f846cdb96060afb0530f1d34fdfc2a11f83d...c84d34b5f1ae6908c5a0b524c17b81103b831f35,1,1,1,2,1,2013-08-15 06:31:21,2013-08-15 06:31:21
e5e1270e57b3b726fffbd6aa883eeb1572844e9e...b02e80c6fb9fed877b667248df68c2cd48e251c7,1,2,1,3,1,2013-08-14 21:29:53,2013-08-14 21:29:53
b02e80c6fb9fed877b667248df68c2cd48e251c7...8d3dbe78c6f370e4a15da338502db329d5acb16a,1,3,0,3,1,2013-08-14 21:30:00,2013-08-14 21:30:00
7f4e05fcce54f7d9aae64c95ecde9316345584a4...1b6a5bbca2595c60189ae07fc771fe3a7fc4a55f,3,17,5,22,9,2013-08-15 07:08:21,2013-08-15 07:07:23
1b6a5bbca2595c60189ae07fc771fe3a7fc4a55f...fee3f1e733e80bd128736e1b9b403f49b701a6a9,4,26,11,37,9,2013-08-15 07:46:18,2013-08-15 07:46:18
8d3dbe78c6f370e4a15da338502db329d5acb16a...2002045b7f3acc0cacf1454d31f5bfc5d7e8968f,1,4,4,8,4,2013-08-14 21:59:08,2013-08-14 21:59:08
fee3f1e733e80bd128736e1b9b403f49b701a6a9...51f2c907e738a6dd531de36c52ddfc103f76b918,3,3,3,6,3,2013-08-15 17:30:37,2013-08-15 17:30:37
fee3f1e733e80bd128736e1b9b403f49b701a6a9...6b612ae3fe92f7a96d5d656e5e0c630f85acda0a,1,6,6,12,6,2013-08-15 12:57:24,2013-08-15 12:57:24
fee3f1e733e80bd128736e1b9b403f49b701a6a9...16191226034c93eabd6c35ee040e20d09cbf7da4,1,4,4,8,4,2013-08-15 09:40:39,2013-08-15 09:40:39
f681c9712d9863a2e94da747725e49b0ff44922f...e550e113a03d66b13fdf1a352813e78eb27ad408,1,51,0,51,1,2013-08-15 17:50:58,2013-08-15 17:50:58
e550e113a03d66b13fdf1a352813e78eb27ad408...4002ac7e6577ab7b7b3db9c4237a40a40b567360,2,13,0,13,4,2013-08-15 17:54:32,2013-08-15 17:54:32
4002ac7e6577ab7b7b3db9c4237a40a40b567360...da6a7827d25e8e6a8d5e143f8e76fb8842e7311a,1,1,1,2,1,2013-08-15 18:09:13,2013-08-15 18:09:13
da6a7827d25e8e6a8d5e143f8e76fb8842e7311a...a5cb6c7a152d5b20a9ced4cbd5315dc2c03dbaf0,1,1,3,4,1,2013-08-15 18:13:57,2013-08-15 18:13:57
a5cb6c7a152d5b20a9ced4cbd5315dc2c03dbaf0...209d3af30188a6b426f0cf84d81b367b2f056e1b,7,82,39,121,37,2013-08-15 18:31:26,2013-08-15 18:31:26
209d3af30188a6b426f0cf84d81b367b2f056e1b...06e6da09182f15f6eec6eaa68cb5e6c2af249a04,3,17,15,32,5,2013-08-15 18:36:08,2013-08-15 18:36:08
06e6da09182f15f6eec6eaa68cb5e6c2af249a04...3a7ddae39e5e7b75651c22d0ce95a473d87aba2f,1,1,0,1,1,2013-08-15 18:37:35,2013-08-15 18:37:35
3a7ddae39e5e7b75651c22d0ce95a473d87aba2f...49e95f2bcfd71e12b0c3d45c6019482288cbebd9,1,9,13,22,7,2013-08-15 18:47:45,2013-08-15 18:47:45
49e95f2bcfd71e12b0c3d45c6019482288cbebd9...5a0ba42a7becc00ea4c64806b714c5f351b9b96d,3,14,5,19,7,2013-08-15 18:47:56,2013-08-15 18:47:56
5a0ba42a7becc00ea4c64806b714c5f351b9b96d...2690a3dc3185e9666384cf6982354f0456473da7,3,11,7,18,6,2013-08-15 18:52:22,2013-08-15 18:52:22
2690a3dc3185e9666384cf6982354f0456473da7...4b350f8b79710d388ff8c711fba7a877812a6c1e,1,6,10,16,3,2013-08-15 18:56:07,2013-08-15 18:56:07
4b350f8b79710d388ff8c711fba7a877812a6c1e...33edb95b9862ef0c0edea73ca931fcbbeb1b5b6d,1,38,44,82,2,2013-08-15 19:35:22,2013-08-15 19:35:22
4b350f8b79710d388ff8c711fba7a877812a6c1e...5a4401ac91f456de749738eea32745ff315dfab2,1,4,4,8,2,2013-08-15 19:01:53,2013-08-15 19:01:52
834cbce9b75232d8dd3fcfb2fa86ffef02c9cfd8...69a7c167050bf766f850cc441b99777a111fbe9b,1,1,1,2,1,2013-08-15 20:00:06,2013-08-15 20:00:06
69a7c167050bf766f850cc441b99777a111fbe9b...8211b12c0fcb5890305a3768b769cbe754c8b1b8,2,23,16,39,12,2013-08-15 20:00:34,2013-08-15 20:00:34
8211b12c0fcb5890305a3768b769cbe754c8b1b8...4da7cad021eb42784faf1fca0d5c51342f196f32,2,20,19,39,9,2013-08-15 20:06:01,2013-08-15 20:06:01
4da7cad021eb42784faf1fca0d5c51342f196f32...dd4d618717d38123f714fc85ce56548b757e18cc,1,1,9,10,2,2013-08-15 20:06:25,2013-08-15 20:06:25
dd4d618717d38123f714fc85ce56548b757e18cc...3d378331342534ebfe99e717d4503c475d06ea7c,1,4,4,8,4,2013-08-15 20:06:51,2013-08-15 20:06:51
3d378331342534ebfe99e717d4503c475d06ea7c...f9d2f9b6cd805c39217dcef0a11d4b721dc8e045,4,54,29,83,26,2013-08-15 20:16:06,2013-08-15 20:16:06
834cbce9b75232d8dd3fcfb2fa86ffef02c9cfd8...a3cbdfab060c56d91d5802c070b9f5da3c96c463,1,1,1,2,1,2013-08-15 19:55:43,2013-08-15 19:55:43
5a4401ac91f456de749738eea32745ff315dfab2...5f311790b9a71645759c956d96df1de93cd43b66,2,5,5,10,4,2013-08-15 19:26:37,2013-08-15 19:26:37
c0c72a64b4c7a752e080c5470202e733641b88ef...98368c0ccae4cbcc80b322b996e08ec2b9740c14,2,168,154,322,13,2013-08-15 20:24:48,2013-08-15 20:24:48
98368c0ccae4cbcc80b322b996e08ec2b9740c14...0664b3f0da25a99c5e0d88fdc566480baeaf83aa,4,9,2,11,4,2013-08-15 20:29:45,2013-08-15 20:29:45
0664b3f0da25a99c5e0d88fdc566480baeaf83aa...418ca6c09b393096e80aef9dde0072943f6d7c63,4,19,5,24,6,2013-08-15 20:40:21,2013-08-15 20:40:21
418ca6c09b393096e80aef9dde0072943f6d7c63...61a395338d34270152ee8d6c46aff420aa73c431,1,6,0,6,2,2013-08-15 20:48:47,2013-08-15 20:48:47
61a395338d34270152ee8d6c46aff420aa73c431...25e11903e37f1b95f130f5b2ff8c435c52bf010d,1,13,18,31,4,2013-08-15 20:52:46,2013-08-15 20:52:46
25e11903e37f1b95f130f5b2ff8c435c52bf010d...2dbf2bb8fb388f84027ce33429e91c06c573acfc,3,13,1,14,3,2013-08-15 20:54:47,2013-08-15 20:54:47
2dbf2bb8fb388f84027ce33429e91c06c573acfc...bf1772130855ba0423fabe8fdce8015a3f7f739c,2,2,1,3,2,2013-08-15 20:58:16,2013-08-15 20:58:16
bf1772130855ba0423fabe8fdce8015a3f7f739c...5349075f36528e5fc8e2bd7423d2d3c0d2a2a8fa,1,4,2,6,3,2013-08-15 20:58:23,2013-08-15 20:58:23
5349075f36528e5fc8e2bd7423d2d3c0d2a2a8fa...e3c6a1fc4ffceb7cbcb1885aaa6e96515d0b872a,1,8,8,16,4,2013-08-15 21:35:15,2013-08-15 21:35:15
e3c6a1fc4ffceb7cbcb1885aaa6e96515d0b872a...e0c6a5a32f5526e2edf87b1b4aa6985929072063,1,22,14,36,3,2013-08-15 21:46:28,2013-08-15 21:46:28
e0c6a5a32f5526e2edf87b1b4aa6985929072063...c389c9e8f494f4093f670a206249aaedf1dfac86,1,3,0,3,1,2013-08-15 21:57:55,2013-08-15 21:57:55
c389c9e8f494f4093f670a206249aaedf1dfac86...16d7265c9b2bf89bf24a6e133dffc9308614cd49,3,15,8,23,8,2013-08-15 22:16:46,2013-08-15 22:16:46
16d7265c9b2bf89bf24a6e133dffc9308614cd49...7ab52272d70ea78d0a68316d9572eee927587f5c,1,2,2,4,2,2013-08-15 22:27:37,2013-08-15 22:27:37
7ab52272d70ea78d0a68316d9572eee927587f5c...7cd35f0cb6d17d6117264f71f175a9e5b0b09580,4,44,2,46,10,2013-08-15 23:17:44,2013-08-15 23:17:44
