id,files,locs added,locs removed,locs total,hunks,commit time,author time
4b825dc642cb6eb9a060e54bf8d69288fbee4904...5ea2a6390ce95f192720a95ad26d87d503ce8470,1,1,0,1,1,2010-09-27 17:21:32,2010-09-27 17:21:32
5ea2a6390ce95f192720a95ad26d87d503ce8470...de957eca7d7b2864f87bb273072f6ab91aba8ff5,10,1746,1,1747,10,2010-09-27 23:03:29,2010-09-27 23:03:29
de957eca7d7b2864f87bb273072f6ab91aba8ff5...817703b093c57e9e78982c0c93d736e1aebf557d,8,215,143,358,24,2010-09-28 00:35:34,2010-09-28 00:35:34
817703b093c57e9e78982c0c93d736e1aebf557d...c6b1ba7a547c4dbe53af2332005c25e6245d10d7,1,1,45,46,1,2010-09-28 17:42:49,2010-09-28 17:42:49
c6b1ba7a547c4dbe53af2332005c25e6245d10d7...edbf2ea78b45d3daf5620d95866d5c591b06daf3,1,20,20,40,9,2010-09-28 18:23:48,2010-09-28 18:23:48
edbf2ea78b45d3daf5620d95866d5c591b06daf3...2e96941b60d20f138ea0c839292a89af09b6073c,2,6,6,12,4,2010-09-29 00:28:06,2010-09-29 00:28:06
2e96941b60d20f138ea0c839292a89af09b6073c...657f81bd6c1e76e1d011384cb64c9083374a925f,1,3,3,6,1,2010-09-29 00:29:36,2010-09-29 00:29:36
657f81bd6c1e76e1d011384cb64c9083374a925f...4a6b768676911124355ab03c2fee70803705d07d,1,10,0,10,1,2010-09-29 18:46:08,2010-09-29 18:46:08
4a6b768676911124355ab03c2fee70803705d07d...46961371e3c4de9c2f5d07c2d81a009d19ac37a6,4,174,154,328,46,2010-09-29 19:50:34,2010-09-29 19:50:34
46961371e3c4de9c2f5d07c2d81a009d19ac37a6...8095516b16ff43faea1a07a2e11164056fc1fecb,11,143,16,159,8,2010-09-29 20:59:29,2010-09-29 20:59:29
8095516b16ff43faea1a07a2e11164056fc1fecb...c09dad72811c938defd4df60e7d05ae8ba0d3574,4,102,3,105,4,2010-09-30 23:15:57,2010-09-30 23:09:42
c09dad72811c938defd4df60e7d05ae8ba0d3574...e871cef6b7ef7aa434f4e793c6e13d70a29959a7,1,80,3,83,2,2010-10-01 04:24:21,2010-10-01 04:24:21
e871cef6b7ef7aa434f4e793c6e13d70a29959a7...c359b22170557f93dcf3e0277661c0bf968bc953,2,20,20,40,5,2010-10-01 04:34:14,2010-10-01 04:34:14
c359b22170557f93dcf3e0277661c0bf968bc953...4ef336e290b5d4bc2e3144a5fbf8ab85c0cf9048,1,43,22,65,11,2010-10-01 18:15:57,2010-10-01 18:15:57
4ef336e290b5d4bc2e3144a5fbf8ab85c0cf9048...9e006163c9f8c0e52a132b75d5759e66cada1be7,5,502,28,530,26,2010-10-01 22:53:06,2010-10-01 22:53:06
9e006163c9f8c0e52a132b75d5759e66cada1be7...cd422c7a830758e90df615104edf6eccd09b90be,1,6,6,12,1,2010-10-01 22:58:46,2010-10-01 22:58:46
cd422c7a830758e90df615104edf6eccd09b90be...311cabd367508bab722a7c6d2f960c7a8155af52,1,8,4,12,5,2010-10-02 01:28:02,2010-10-02 01:28:02
311cabd367508bab722a7c6d2f960c7a8155af52...0c466ccb25a2d2d16456405f0393c48429246a61,15,4028,889,4917,131,2011-01-15 21:45:32,2011-01-15 21:45:32
0c466ccb25a2d2d16456405f0393c48429246a61...71794fb1c68bade7a3083f5dd20a1e33798a1298,2,4,4,8,3,2011-01-15 21:48:23,2011-01-15 21:48:23
71794fb1c68bade7a3083f5dd20a1e33798a1298...ec6ed3fd183348f373a7576864468a3be5d042a0,3,53,29,82,13,2011-01-15 22:27:39,2011-01-15 22:27:39
ec6ed3fd183348f373a7576864468a3be5d042a0...535f13f2c954b565223afdebc7ebaef120f4d479,1,3,2,5,1,2011-01-15 22:30:08,2011-01-15 22:30:08
535f13f2c954b565223afdebc7ebaef120f4d479...dc3883c5103caa33089f015df8873989e6b81f4a,4,94,51,145,18,2011-01-17 02:43:05,2011-01-17 02:21:27
dc3883c5103caa33089f015df8873989e6b81f4a...9b160a9adf32120a6c571045412b04563c96e397,3,35,5,40,5,2011-01-17 03:09:32,2011-01-17 03:09:32
9b160a9adf32120a6c571045412b04563c96e397...cef47b29ef2e9aa4e028e771a55b6c03b3ae68c1,1,1,1,2,1,2011-01-17 03:10:27,2011-01-17 03:10:27
cef47b29ef2e9aa4e028e771a55b6c03b3ae68c1...e498353fce31c213e18ad92074fa511473717f38,5,234,40,274,7,2011-01-17 20:36:36,2011-01-17 20:36:36
e498353fce31c213e18ad92074fa511473717f38...9ea55714ba3838ed7a2d2be4889a3fa3273e0524,4,251,127,378,35,2011-01-19 19:20:54,2011-01-19 19:20:54
9ea55714ba3838ed7a2d2be4889a3fa3273e0524...d74d20431ed69d2956095af3997642222a0c8b25,1,9,9,18,4,2011-01-19 19:49:19,2011-01-19 19:49:19
d74d20431ed69d2956095af3997642222a0c8b25...7d77a8122a0ed021bb7534c82da20961d4507506,1,4,4,8,1,2011-01-19 19:50:27,2011-01-19 19:50:27
7d77a8122a0ed021bb7534c82da20961d4507506...01e021207dec4b2950d74d8a42ae025c49597286,4,453,7,460,5,2011-01-20 22:20:11,2011-01-20 17:50:51
01e021207dec4b2950d74d8a42ae025c49597286...a66b26b8458eaee3b94acdfff23bcfee494d75d1,1,48,38,86,17,2011-01-20 23:57:41,2011-01-20 23:57:41
a66b26b8458eaee3b94acdfff23bcfee494d75d1...9f8fb39f8ef094f862dac791af369c995685245f,10,29,5,34,2,2011-01-21 00:35:59,2011-01-21 00:35:59
9f8fb39f8ef094f862dac791af369c995685245f...7b62b7f296e08e7dd0b1004d4d203e3fedabaaf7,1,6,6,12,1,2011-01-21 19:11:58,2011-01-21 19:11:58
7b62b7f296e08e7dd0b1004d4d203e3fedabaaf7...c8ec2f1939df0ef058dc83f94009be8ab0c50741,5,158,7,165,6,2011-01-28 19:41:29,2011-01-28 19:41:29
c8ec2f1939df0ef058dc83f94009be8ab0c50741...527ae78fb975a364a7863d0daa7a47c7689e7bb3,5,272,86,358,29,2011-01-28 20:41:13,2011-01-28 20:41:13
527ae78fb975a364a7863d0daa7a47c7689e7bb3...875af41e5e30bef00a59df2fc01bb18b4fba16c7,4,221,121,342,32,2011-01-28 23:33:40,2011-01-28 23:33:40
875af41e5e30bef00a59df2fc01bb18b4fba16c7...0595890167c371354487ae01dbfb96d63f6ec164,1,0,1,1,1,2011-01-28 23:36:03,2011-01-28 23:36:03
0595890167c371354487ae01dbfb96d63f6ec164...d2c45cfc0a8621db8802a2bf604e1362489435b4,1,2,9,11,4,2011-01-28 23:37:10,2011-01-28 23:37:10
d2c45cfc0a8621db8802a2bf604e1362489435b4...1926d690252009f02a4140c914df9a4bb487dc93,1,21,11,32,5,2011-01-28 23:45:20,2011-01-28 23:45:20
1926d690252009f02a4140c914df9a4bb487dc93...c18d9d30da0726cfab7239262d6db104ad6d5e17,1,52,17,69,6,2011-01-29 00:22:42,2011-01-29 00:22:42
c18d9d30da0726cfab7239262d6db104ad6d5e17...48cb1148595049df6b6f851115f8e79685623d76,2,45,43,88,4,2011-01-29 00:28:21,2011-01-29 00:28:21
48cb1148595049df6b6f851115f8e79685623d76...713ef4a9c4aca406e6589032d13958ff64dac11f,13,271,138,409,31,2011-01-31 01:25:09,2011-01-31 01:25:09
713ef4a9c4aca406e6589032d13958ff64dac11f...4d8c61fef2c19e3680f1e98dee12169a16761a98,3,27,18,45,3,2011-01-31 05:32:05,2011-01-31 05:32:05
4d8c61fef2c19e3680f1e98dee12169a16761a98...bb821421550b7425ce0b46c1b037b91892b175ad,8,6780,1,6781,9,2011-01-31 06:06:29,2011-01-31 05:59:51
bb821421550b7425ce0b46c1b037b91892b175ad...5ead790ce74ba43be1d2760820c4a2ff87265bc5,12,179,184,363,71,2011-01-31 19:24:47,2011-01-31 19:24:47
5ead790ce74ba43be1d2760820c4a2ff87265bc5...8230fef066a4093aa6e50af1faac702f9ef2478a,5,242,6,248,12,2011-02-01 06:11:51,2011-02-01 05:59:25
8230fef066a4093aa6e50af1faac702f9ef2478a...e7e367ebe7badea4fbcd2218fe5ddb560204d7d3,8,342,103,445,61,2011-02-07 21:24:16,2011-02-07 21:24:01
e7e367ebe7badea4fbcd2218fe5ddb560204d7d3...2c158b5869e4da0d248d51d9e8ada41173a23019,1,27,20,47,7,2011-02-07 21:36:19,2011-02-07 21:36:19
2c158b5869e4da0d248d51d9e8ada41173a23019...381cb66d39ca03e6da98ca3ad7f216671c2b98e3,4,65,4,69,5,2011-02-08 00:26:37,2011-02-08 00:26:37
381cb66d39ca03e6da98ca3ad7f216671c2b98e3...afa04345388262d892c58109ab64105dcad40e87,21,4122,219,4341,94,2011-02-26 04:53:12,2011-02-26 04:41:18
afa04345388262d892c58109ab64105dcad40e87...82e44bebe01319fcef9f25771345d1fed51eedbe,26,226,274,500,68,2011-02-27 20:05:20,2011-02-27 19:51:38
82e44bebe01319fcef9f25771345d1fed51eedbe...7ba39d1f5443e79e51cc6bbf771f8fe7aefabebc,9,463,1,464,10,2011-02-27 20:18:22,2011-02-27 20:18:22
7ba39d1f5443e79e51cc6bbf771f8fe7aefabebc...228ca64960e3374f4fd5cbca93b0cc138f2fd785,12,387,161,548,14,2011-02-27 20:33:22,2011-02-27 20:32:01
228ca64960e3374f4fd5cbca93b0cc138f2fd785...41a84528e0e54fed7b983762a24803259ac5aa85,2,4,4,8,4,2011-02-27 20:36:30,2011-02-27 20:36:30
41a84528e0e54fed7b983762a24803259ac5aa85...63831b5085c7f4b661b53ce207f3985fb5ddd5a2,14,533,2,535,14,2011-02-27 21:04:16,2011-02-27 20:58:10
63831b5085c7f4b661b53ce207f3985fb5ddd5a2...d89dccf937f77c12add006e6a5697c74a3d49857,5,116,1,117,7,2011-02-27 21:09:11,2011-02-27 21:09:11
d89dccf937f77c12add006e6a5697c74a3d49857...a35738157ea733173b12867a97cdcb0eeb313642,4,56,8,64,8,2011-02-27 21:39:23,2011-02-27 21:39:23
a35738157ea733173b12867a97cdcb0eeb313642...70806021078d0e0f51c8ee883bb16322a7f117d5,1,1,1,2,1,2011-02-27 21:50:19,2011-02-27 21:50:19
70806021078d0e0f51c8ee883bb16322a7f117d5...a534c528f212995a0d2a3cf85ecc2455615780a0,7,142,124,266,34,2011-02-28 02:26:58,2011-02-28 02:24:33
a534c528f212995a0d2a3cf85ecc2455615780a0...fbe395607211fa4d10fe1638f6d7c0c86f283eda,3,2,7,9,4,2011-02-28 02:35:09,2011-02-28 02:35:09
fbe395607211fa4d10fe1638f6d7c0c86f283eda...e8f20d95cb559defaaef74326bcbe83314680ccf,7,160,0,160,8,2011-02-28 18:39:00,2011-02-28 18:39:00
e8f20d95cb559defaaef74326bcbe83314680ccf...3f9b542db7a082b4738f9023f5714cbabf5f6ebe,3,40,2,42,3,2011-03-01 01:03:56,2011-03-01 01:03:56
3f9b542db7a082b4738f9023f5714cbabf5f6ebe...1cfaa24af56ffac3a0ee9c9b078ab267b38cd07d,21,886,292,1178,48,2011-03-03 23:54:25,2011-03-03 23:54:25
1cfaa24af56ffac3a0ee9c9b078ab267b38cd07d...ab72c0de6567fa8ef6daedcd6946b9f1167193c0,16,200,897,1097,9,2011-03-06 02:43:06,2011-03-06 02:43:06
ab72c0de6567fa8ef6daedcd6946b9f1167193c0...917c2f1891985fe12e36313c1db540cdd463b57c,1,37,13,50,1,2011-03-06 03:06:42,2011-03-06 03:06:42
917c2f1891985fe12e36313c1db540cdd463b57c...ae4e0f87ab2f9f93d8533419aa43c4bf109efa8c,1,1,1,2,1,2011-03-06 03:09:28,2011-03-06 03:09:28
ae4e0f87ab2f9f93d8533419aa43c4bf109efa8c...40f90fc01f5efc15fafc2e3ccd10fa0a8a522c64,20,166,150,316,50,2011-03-09 18:39:59,2011-03-09 18:39:59
40f90fc01f5efc15fafc2e3ccd10fa0a8a522c64...33c221b402339c74d6a2bf739bb2f9324e5ee381,1,6,1,7,1,2011-03-10 18:36:54,2011-03-10 18:36:54
33c221b402339c74d6a2bf739bb2f9324e5ee381...24c3b3afb685c04ce3baa32572b12a36636acc4d,12,137,90,227,20,2011-03-10 20:07:17,2011-03-10 19:45:20
24c3b3afb685c04ce3baa32572b12a36636acc4d...4e05fa6ce3f734bd02442f96d558df4ce20e8f32,3,5,3,8,3,2011-03-11 19:42:41,2011-03-11 19:40:57
4e05fa6ce3f734bd02442f96d558df4ce20e8f32...120d43c4b13742f49147509883606f573fca70c0,30,554,266,820,84,2011-03-13 06:08:51,2011-03-13 05:27:43
120d43c4b13742f49147509883606f573fca70c0...e2d478d5b901d87e07c7431d1d23808448f800ef,20,264,132,396,42,2011-03-15 06:49:05,2011-03-15 06:45:27
4b825dc642cb6eb9a060e54bf8d69288fbee4904...b2aa3c7355f46634738b46789c649c4e2da94e3e,1,0,0,0,0,2010-09-27 17:20:44,2010-09-27 17:20:44
b2aa3c7355f46634738b46789c649c4e2da94e3e...0d7fe72609a7c1e53864ada436e31c1dfe73fd3d,1,1,0,1,1,2010-09-27 17:23:59,2010-09-27 17:23:59
0d7fe72609a7c1e53864ada436e31c1dfe73fd3d...8a722e124171c7e2972206242ad5cd00f1a9d3b1,3,463,0,463,2,2010-09-28 18:25:21,2010-09-28 18:25:21
8a722e124171c7e2972206242ad5cd00f1a9d3b1...6f3a7e7e7674506ae83c3dcd92018503fbc11739,26,2932,0,2932,26,2010-09-28 18:26:55,2010-09-28 18:26:55
6f3a7e7e7674506ae83c3dcd92018503fbc11739...fbf9831eb638d5896e517d44bd74faf4ef7083bf,1,27,0,27,1,2010-09-28 18:29:21,2010-09-28 18:29:21
fbf9831eb638d5896e517d44bd74faf4ef7083bf...ae0d06f209337436decae1df1b97339d19c7f068,23,2106,0,2106,23,2010-09-28 18:34:52,2010-09-28 18:34:52
ae0d06f209337436decae1df1b97339d19c7f068...370818e79913152b4c6f0bcfacedc3e3fcd18f0c,3,157,18,175,5,2010-09-28 19:55:33,2010-09-28 19:55:33
370818e79913152b4c6f0bcfacedc3e3fcd18f0c...7aaadad54294eb2db63ce3b3c3e0e5ed43a8fa3a,1,2,1,3,1,2010-09-28 20:00:28,2010-09-28 20:00:28
7aaadad54294eb2db63ce3b3c3e0e5ed43a8fa3a...6e7b06f60fbdf9780c6bbe8cb65e597b70c7a742,1,13,1,14,1,2010-09-29 00:36:53,2010-09-29 00:36:53
6e7b06f60fbdf9780c6bbe8cb65e597b70c7a742...91debece6044d05bb9b0d9c553c52ac10fd8f0e9,1,0,2,2,1,2010-09-29 00:37:59,2010-09-29 00:37:59
91debece6044d05bb9b0d9c553c52ac10fd8f0e9...b667421e510e63b9fd75fcc5c80f6d04e3b15418,1,1,1,2,1,2010-09-29 00:38:31,2010-09-29 00:38:31
b667421e510e63b9fd75fcc5c80f6d04e3b15418...bca36356ecc21b9ea422b13a6388201587840dd9,1,64,21,85,10,2010-09-29 01:04:58,2010-09-29 01:04:58
bca36356ecc21b9ea422b13a6388201587840dd9...373ae84c834f840ab1b45082a723289e9ac25362,1,1,1,2,2,2010-09-29 01:34:45,2010-09-29 01:34:45
373ae84c834f840ab1b45082a723289e9ac25362...661ff7fe827d9adec9c47a43ada00e833069f05e,16,320,373,693,109,2010-09-29 06:18:51,2010-09-29 06:18:51
661ff7fe827d9adec9c47a43ada00e833069f05e...ff98c89c9dadc4383afc7a89ab106ab525dc8e4e,1,5,3,8,3,2010-09-29 19:58:50,2010-09-29 19:58:50
ff98c89c9dadc4383afc7a89ab106ab525dc8e4e...018b79577a9ea09d8f96c1bb5351d61bb52af69f,23,89,89,178,85,2010-10-02 18:00:31,2010-10-02 18:00:31
018b79577a9ea09d8f96c1bb5351d61bb52af69f...5d7536385d0785e6a13d76c4ccae98fdb2bc5996,4,13,13,26,11,2010-10-02 18:38:50,2010-10-02 18:38:50
5d7536385d0785e6a13d76c4ccae98fdb2bc5996...544e88d0b8847b7cd1bd26d23c0612625538ee84,1,131,0,131,1,2010-10-04 20:01:56,2010-10-04 20:01:56
544e88d0b8847b7cd1bd26d23c0612625538ee84...5f47187f7d8aa7485618aa2330fa8ea781f08ddb,4,5401,6,5407,12,2010-10-05 00:28:01,2010-10-05 00:28:01
5f47187f7d8aa7485618aa2330fa8ea781f08ddb...97a9c4466b3f52f9da6833cb86a86aa1e23d0ed3,1,1,0,1,1,2010-10-05 03:36:36,2010-10-05 03:31:12
97a9c4466b3f52f9da6833cb86a86aa1e23d0ed3...5348d911938a0d1fdf43d7c86befbd908e431204,3,1396,0,1396,3,2010-10-05 03:41:18,2010-10-05 03:41:18
5348d911938a0d1fdf43d7c86befbd908e431204...af68d6b2ef0d867f5ef1070ba11678a48bcb77f9,2,43,16,59,11,2010-10-05 03:57:56,2010-10-05 03:57:56
af68d6b2ef0d867f5ef1070ba11678a48bcb77f9...bacf6762facc23611ded3f4b39d2708755532cd7,4,5392,2,5394,4,2010-10-05 18:37:14,2010-10-05 18:37:14
bacf6762facc23611ded3f4b39d2708755532cd7...a16adb1a395316e1ec20a0dec38a4bae049bc05f,10,72,45,117,16,2010-10-05 18:57:27,2010-10-05 18:57:27
a16adb1a395316e1ec20a0dec38a4bae049bc05f...917442a1a29bb3c4ed24de2094b8e0cc0654a8a5,4,23,14,37,9,2010-10-06 22:20:38,2010-10-06 22:20:38
917442a1a29bb3c4ed24de2094b8e0cc0654a8a5...2659546f48bdb46320063450c84e7bb922aa769a,1,15,16,31,3,2010-10-10 17:37:07,2010-10-10 17:37:07
2659546f48bdb46320063450c84e7bb922aa769a...7e0e19106e179110a7efc2ad6198c4ea4aa56b75,8,37,63,100,12,2010-10-14 17:21:07,2010-10-14 17:21:07
7e0e19106e179110a7efc2ad6198c4ea4aa56b75...6464020abb63b48105a9ab52669b3350dfc46ac6,4,64,36,100,9,2010-10-14 17:23:15,2010-10-14 17:23:15
6464020abb63b48105a9ab52669b3350dfc46ac6...5a99324d0bfba53a1d00263a33a5875bd8038090,1,0,0,0,0,2010-10-14 17:25:12,2010-10-14 17:25:12
5a99324d0bfba53a1d00263a33a5875bd8038090...c8799da06957b8c559523bd0a69eb574137cacf9,1,13,12,25,4,2010-10-14 17:25:56,2010-10-14 17:25:56
c8799da06957b8c559523bd0a69eb574137cacf9...c117dbe5273c42bbf0d271b1c59ee315f6f429b3,5,24,22,46,5,2010-10-14 17:29:17,2010-10-14 17:29:17
c117dbe5273c42bbf0d271b1c59ee315f6f429b3...92d15a447204db43e9b0c61c97a71d1c15e1680c,9,271,39,310,13,2010-10-20 18:07:42,2010-10-20 18:07:42
92d15a447204db43e9b0c61c97a71d1c15e1680c...78bca67502c9904c3ce0fbb8654de7156443a511,6,203,62,265,22,2010-10-20 22:22:22,2010-10-20 22:22:22
78bca67502c9904c3ce0fbb8654de7156443a511...291a732042d3c508be8ca95eec61a6a4bce8e003,1,19,23,42,13,2010-10-20 22:42:15,2010-10-20 22:42:15
291a732042d3c508be8ca95eec61a6a4bce8e003...a5089b8918ae32c3a54145e77a3196c3c020566b,7,129,35,164,11,2010-10-21 19:53:56,2010-10-21 19:53:56
a5089b8918ae32c3a54145e77a3196c3c020566b...aab852b19a10a8f7cfdd7d054946057a511679b3,3,26,23,49,3,2010-10-21 20:09:39,2010-10-21 20:09:39
aab852b19a10a8f7cfdd7d054946057a511679b3...936963e357d7d2e3e5b4f14f935276c4501ea54e,3,34,36,70,11,2010-10-22 19:16:43,2010-10-22 19:16:43
936963e357d7d2e3e5b4f14f935276c4501ea54e...d7bc33eafde93ad2caff504e620669f4f856cbe5,4,58,16,74,9,2010-10-22 19:55:50,2010-10-22 19:55:50
d7bc33eafde93ad2caff504e620669f4f856cbe5...5e381ba73e1426217ef498b0d4d791bdf4e0307d,4,74,46,120,18,2010-10-22 20:51:36,2010-10-22 20:36:48
5e381ba73e1426217ef498b0d4d791bdf4e0307d...55e13c778deacf474d196186136a40249a4fc66e,4,26,32,58,17,2010-10-22 23:06:59,2010-10-22 23:06:59
55e13c778deacf474d196186136a40249a4fc66e...0c3e453601ca078ef2e6bc76707a5b2b22b9cc4b,2,179,0,179,2,2010-10-23 03:02:34,2010-10-23 03:02:34
0c3e453601ca078ef2e6bc76707a5b2b22b9cc4b...a4f5945eea75dfa54294731f40dee58c0a8b3664,2,130,62,192,29,2010-10-23 05:32:14,2010-10-23 05:32:14
a4f5945eea75dfa54294731f40dee58c0a8b3664...607ed11267700c8a32e30b87e082efdbdab0dcd0,1,57,49,106,15,2010-10-23 05:52:54,2010-10-23 05:52:54
607ed11267700c8a32e30b87e082efdbdab0dcd0...a1608d1e3a2dfb4245c89a37041c56f2046babfa,2,18,5,23,6,2010-10-23 15:22:03,2010-10-23 15:22:03
a1608d1e3a2dfb4245c89a37041c56f2046babfa...04a6dce44c3a78cb10cb261cb0b89109db966ec4,2,109,12,121,13,2010-10-23 17:19:37,2010-10-23 17:19:37
04a6dce44c3a78cb10cb261cb0b89109db966ec4...b26f509dd498be03e6951f993e0210eabe71a5c6,2,20,24,44,14,2010-10-23 17:29:32,2010-10-23 17:29:32
b26f509dd498be03e6951f993e0210eabe71a5c6...85e45f5f5d2cfa2c8d6357ee5ce1e4769e84719a,1,169,78,247,27,2010-10-23 18:47:18,2010-10-23 18:47:18
85e45f5f5d2cfa2c8d6357ee5ce1e4769e84719a...d8e79be35c4127c1e5417152218cbbe0ccee7938,2,18,8,26,3,2010-10-23 18:52:26,2010-10-23 18:52:26
d8e79be35c4127c1e5417152218cbbe0ccee7938...3ee56574b88a6d67c5fed786c772297937ebb551,2,45,40,85,18,2010-10-23 19:28:31,2010-10-23 19:28:14
3ee56574b88a6d67c5fed786c772297937ebb551...4494b027901c17c746b26a266d6bdfea762db5aa,1,14,3,17,3,2010-10-23 19:32:46,2010-10-23 19:32:46
4494b027901c17c746b26a266d6bdfea762db5aa...f5517ea02d548529ffbccc47a9ed5a04822930e1,2,39,26,65,9,2010-10-23 20:06:12,2010-10-23 20:06:12
f5517ea02d548529ffbccc47a9ed5a04822930e1...3a898d7eb42533eddb5796a29dfb615c29a26a42,2,122,52,174,19,2010-10-23 22:14:47,2010-10-23 22:14:47
3a898d7eb42533eddb5796a29dfb615c29a26a42...3220c0b7174fb04dd5ea1ee471e0d47c2960f7cc,2,38,65,103,18,2010-10-23 22:34:30,2010-10-23 22:34:30
3220c0b7174fb04dd5ea1ee471e0d47c2960f7cc...1d15c3f6ef768946cc8b11c6266b957119ffc838,2,40,53,93,17,2010-10-23 23:08:54,2010-10-23 23:08:54
1d15c3f6ef768946cc8b11c6266b957119ffc838...b28a1dbfe0d77a9e51d9609c355423ab948852b4,2,106,125,231,47,2010-10-24 00:00:04,2010-10-24 00:00:04
b28a1dbfe0d77a9e51d9609c355423ab948852b4...a63f8c10a8da9e32fa25bbcfac5a2277b324a4e0,2,113,32,145,17,2010-10-24 00:46:43,2010-10-24 00:45:41
a63f8c10a8da9e32fa25bbcfac5a2277b324a4e0...4ff256dd76c1de662104389510e180da9ebb14f9,2,96,13,109,11,2010-10-24 01:39:26,2010-10-24 01:39:26
4ff256dd76c1de662104389510e180da9ebb14f9...3cfeb7c66420923f7d66bc4160423cba3c56df12,36,1100,2424,3524,139,2010-10-24 03:32:16,2010-10-24 03:32:16
3cfeb7c66420923f7d66bc4160423cba3c56df12...5705107036bd17d4844550e742316d9f3920f2da,4,98,114,212,46,2010-10-24 03:46:17,2010-10-24 03:46:17
5705107036bd17d4844550e742316d9f3920f2da...be2c57f9b5408ea7ea7c2e006ec6b3821deb5968,1,15,17,32,5,2010-10-24 03:48:51,2010-10-24 03:48:51
be2c57f9b5408ea7ea7c2e006ec6b3821deb5968...6b05816d79b1b9c998e2d76cf35da4cc7d7af735,3,9,9,18,7,2010-10-24 16:48:43,2010-10-24 16:48:43
6b05816d79b1b9c998e2d76cf35da4cc7d7af735...b6abd7dfddd83cc3c46a3512d8601db2c8abd003,7,151,155,306,29,2010-10-24 17:39:34,2010-10-24 17:39:34
b6abd7dfddd83cc3c46a3512d8601db2c8abd003...9a28acdc626de85c03d61136babbe04c5f91e1ee,12,155,117,272,28,2010-10-24 17:56:29,2010-10-24 17:56:29
9a28acdc626de85c03d61136babbe04c5f91e1ee...b979c84b2e835038f319dfd1baa262f985b11c4d,4,111,29,140,15,2010-10-24 18:10:51,2010-10-24 18:10:51
b979c84b2e835038f319dfd1baa262f985b11c4d...7897cdddd0c2f6cd5e09e2a81796116621c019de,7,128,97,225,33,2010-10-24 18:43:32,2010-10-24 18:43:32
7897cdddd0c2f6cd5e09e2a81796116621c019de...18a6e2941ae666cb1d48e58afbe40db9eb9f265e,10,129,161,290,62,2010-10-24 19:13:15,2010-10-24 19:13:15
18a6e2941ae666cb1d48e58afbe40db9eb9f265e...27dbb5a0fa62580266b36017b9957a26d6ebd6fe,12,155,154,309,55,2010-10-24 19:40:26,2010-10-24 19:37:59
27dbb5a0fa62580266b36017b9957a26d6ebd6fe...99d184027513e2c3f664add74a08c13253ac5660,5,71,41,112,8,2010-10-24 21:03:12,2010-10-24 21:03:12
99d184027513e2c3f664add74a08c13253ac5660...e25acce12489ea8fa3ed9e09bdc3b7cb5d6d7f8e,6,167,64,231,16,2010-10-24 22:27:04,2010-10-24 22:27:04
e25acce12489ea8fa3ed9e09bdc3b7cb5d6d7f8e...1901673b06932075005f04ae5116132613349a1c,5,76,64,140,13,2010-10-24 23:03:35,2010-10-24 23:03:35
1901673b06932075005f04ae5116132613349a1c...a0f2a670b208ef1de99c686926c0b7d2c5adc21a,7,91,65,156,18,2010-10-24 23:15:43,2010-10-24 23:15:43
a0f2a670b208ef1de99c686926c0b7d2c5adc21a...d16d06ef36fca98bab6d4a8268e1422596b5d794,9,316,112,428,38,2010-10-25 00:05:59,2010-10-25 00:05:59
d16d06ef36fca98bab6d4a8268e1422596b5d794...6739d05a0571c2bfdda23825b0e834199d44df66,5,29,28,57,8,2010-10-25 00:09:32,2010-10-25 00:09:32
6739d05a0571c2bfdda23825b0e834199d44df66...30482ba3be42e4bfe1f19610fed6226bc9c163de,1,9,10,19,5,2010-10-25 00:24:06,2010-10-25 00:24:06
30482ba3be42e4bfe1f19610fed6226bc9c163de...84e97371ba4c2f38068f7ab88e2d6772f9ccad13,5,92,36,128,8,2010-10-25 07:12:44,2010-10-25 07:12:44
84e97371ba4c2f38068f7ab88e2d6772f9ccad13...d66522bb3d0de4d5471b7117ac772416203637fb,3,48,40,88,8,2010-10-25 23:03:37,2010-10-25 23:03:37
d66522bb3d0de4d5471b7117ac772416203637fb...b772929db9ef30b443fbb08df9003496faedb7f2,7,123,43,166,12,2010-10-26 22:32:41,2010-10-26 22:32:41
b772929db9ef30b443fbb08df9003496faedb7f2...06189539c855e00591bc81ab49f1efaf2624340d,4,61,49,110,8,2010-10-27 05:48:37,2010-10-27 05:48:37
06189539c855e00591bc81ab49f1efaf2624340d...12ef81f0e0e08e713bc2e53cf8cd86ac49609fd2,4,33,29,62,7,2010-10-29 16:58:33,2010-10-29 16:58:33
12ef81f0e0e08e713bc2e53cf8cd86ac49609fd2...b7d391f5096f6617efc86d3ce52e3c70b89738f3,4,93,45,138,15,2010-10-30 06:24:53,2010-10-30 06:24:53
b7d391f5096f6617efc86d3ce52e3c70b89738f3...05a255ca9af0d3cc05e7805ca86866b91734e021,63,966,792,1758,118,2010-10-30 22:42:11,2010-10-30 22:30:10
05a255ca9af0d3cc05e7805ca86866b91734e021...5c72d2c1c641b4d4a45bd2fc82160cc904d0f6b9,5,171,33,204,16,2010-11-02 06:28:27,2010-11-02 06:28:27
5c72d2c1c641b4d4a45bd2fc82160cc904d0f6b9...a4a7613bc8b440b6748db1ef2c1aadd95e8662ab,1,27,0,27,1,2010-11-02 21:48:28,2010-11-02 21:48:28
a4a7613bc8b440b6748db1ef2c1aadd95e8662ab...20fb5a6e6f677c7e2e658962711edde47febf467,1,28,0,28,1,2010-11-02 21:48:51,2010-11-02 21:48:51
20fb5a6e6f677c7e2e658962711edde47febf467...a95efee58047c787723935eaf1e3a47e775d5ee6,12,3836,48,3884,20,2010-11-02 22:27:45,2010-11-02 22:27:45
a95efee58047c787723935eaf1e3a47e775d5ee6...758b69ba19b7c203219b7c881b2958c5742d235e,8,150,78,228,35,2010-11-02 23:54:18,2010-11-02 23:54:18
758b69ba19b7c203219b7c881b2958c5742d235e...657f02ee0a67dc644bc4cf4486b7c403f0b2b8d4,1,2,2,4,2,2010-11-03 00:07:51,2010-11-03 00:07:51
657f02ee0a67dc644bc4cf4486b7c403f0b2b8d4...2eda4baf36ff3dc89b9a6c34656acf28b5a914f2,12,270,141,411,41,2010-11-03 06:06:32,2010-11-03 06:06:32
2eda4baf36ff3dc89b9a6c34656acf28b5a914f2...4c1fd11e74d24247a661af31a8a29b93319b07fa,7,12,49,61,15,2010-11-03 06:25:09,2010-11-03 06:25:09
4c1fd11e74d24247a661af31a8a29b93319b07fa...a54574bcf99230a52acb44776a0382c623525e26,24,851,63,914,37,2010-11-03 18:19:20,2010-11-03 18:19:20
a54574bcf99230a52acb44776a0382c623525e26...ef084aaf615608441f136a270dafaa2f9b570f5a,4,14,10,24,10,2010-11-04 17:43:47,2010-11-04 17:43:47
ef084aaf615608441f136a270dafaa2f9b570f5a...9900d446e52e3d1ebb1e4b4e84a1602797af9d8d,2,68,0,68,2,2010-11-05 00:13:47,2010-11-05 00:13:47
9900d446e52e3d1ebb1e4b4e84a1602797af9d8d...1d395684f0c601aba7d4848dbd3396a85df310bc,1,4,4,8,2,2010-11-05 00:15:51,2010-11-05 00:15:51
1d395684f0c601aba7d4848dbd3396a85df310bc...7d2c407d9ab86a98616c2fb3c9605c9f57e49998,3,32,3242,3274,7,2010-11-05 00:56:04,2010-11-05 00:56:04
7d2c407d9ab86a98616c2fb3c9605c9f57e49998...9f51f46f6f7e5e71566d67b4cc436a55df98ca88,3,64,0,64,3,2010-11-05 02:06:31,2010-11-05 02:02:08
9f51f46f6f7e5e71566d67b4cc436a55df98ca88...fe073855a4f670130a00cab107ebf6466d7ed495,4,44,380,424,8,2010-11-05 02:09:21,2010-11-05 02:09:21
fe073855a4f670130a00cab107ebf6466d7ed495...a5ee43345ea9fef85b59c482612bb26193495fb1,1,0,67,67,1,2010-11-05 02:11:07,2010-11-05 02:11:07
a5ee43345ea9fef85b59c482612bb26193495fb1...e793ce880001c67923ae9206dd693c7bc5bf95a5,5,144,0,144,5,2010-11-05 02:54:24,2010-11-05 02:54:24
e793ce880001c67923ae9206dd693c7bc5bf95a5...3727826d7eff7675eca46c0d425eca3fde914c76,1,6,1,7,2,2010-11-05 03:04:13,2010-11-05 03:04:13
3727826d7eff7675eca46c0d425eca3fde914c76...4b0c68f8fc1b72e8a948f2aee80feff79fef3563,12,265,64,329,30,2010-11-05 05:27:21,2010-11-05 05:27:21
4b0c68f8fc1b72e8a948f2aee80feff79fef3563...b2a326233866b23a8ca2f4723013a218792a5e82,9,114,153,267,24,2010-11-05 05:33:43,2010-11-05 05:33:43
b2a326233866b23a8ca2f4723013a218792a5e82...16617a2d51054d72cce3161f82458e30ae7a6da7,4,5442,0,5442,4,2010-11-05 06:10:23,2010-11-05 06:10:23
16617a2d51054d72cce3161f82458e30ae7a6da7...cd645ec92579e4df8d3d504711d0aa099d69d73c,10,205,72,277,32,2010-11-05 07:11:34,2010-11-05 07:11:34
cd645ec92579e4df8d3d504711d0aa099d69d73c...e1b23445d16b2cefbd73bcbae520753d68d2bf5a,1,11,9,20,10,2010-11-05 07:19:38,2010-11-05 07:19:38
e1b23445d16b2cefbd73bcbae520753d68d2bf5a...6494412aee7b57af8a06ae9f594704e8b7bc9823,8,339,334,673,14,2010-11-05 07:25:24,2010-11-05 07:25:24
6494412aee7b57af8a06ae9f594704e8b7bc9823...4e6dc7c5a81c7e39679f3eade6bad58a6f1dc04f,5,66,62,128,34,2010-11-05 07:30:23,2010-11-05 07:29:42
4e6dc7c5a81c7e39679f3eade6bad58a6f1dc04f...197ff6bd56467bd97bf7bc31049a4b82f2507405,6,17,27,44,10,2010-11-05 07:36:34,2010-11-05 07:36:34
197ff6bd56467bd97bf7bc31049a4b82f2507405...8fb4ca44b897cbea81d1b89f97c95207c90c98db,2,111,0,111,2,2010-11-05 18:05:53,2010-11-05 18:05:53
8fb4ca44b897cbea81d1b89f97c95207c90c98db...46b80565c93cfececff790849ad682286f73724b,10,563,29,592,30,2010-11-05 23:23:53,2010-11-05 23:23:53
46b80565c93cfececff790849ad682286f73724b...ba23f28fef538d9bbdd0ec4bc6532d7861d2e981,2,192,0,192,2,2010-11-06 21:41:04,2010-11-06 21:41:04
ba23f28fef538d9bbdd0ec4bc6532d7861d2e981...603408aa52b1e4b57ddc7581c92f34ac4aebb2b7,3,533,0,533,3,2010-11-07 00:23:49,2010-11-07 00:23:49
603408aa52b1e4b57ddc7581c92f34ac4aebb2b7...c73ebe2052c42fb9c6395a3865e003041d1543e9,2,9,38,47,6,2010-11-07 00:24:24,2010-11-07 00:24:24
c73ebe2052c42fb9c6395a3865e003041d1543e9...56ef531a7977211fd5eb08e0800946b399ecb491,3,59,107,166,27,2010-11-07 02:10:50,2010-11-07 02:10:50
56ef531a7977211fd5eb08e0800946b399ecb491...cfe47b5ad5fcfdb8e6f169e467717c5d43dceff2,7,70,54,124,27,2010-11-07 07:12:45,2010-11-07 07:12:45
cfe47b5ad5fcfdb8e6f169e467717c5d43dceff2...57059e32a3d264f04df460802e66e4e942e53059,5,86,52,138,16,2010-11-07 16:53:34,2010-11-07 16:53:34
57059e32a3d264f04df460802e66e4e942e53059...a502859902d4be84e0a07a5efbdc67d35133acea,6,158,2,160,8,2010-11-07 21:49:59,2010-11-07 21:49:59
a502859902d4be84e0a07a5efbdc67d35133acea...ae5d3fbab9be4e96ebe7e6ccd7d38416e24c2bfa,3,3,3,6,3,2010-11-07 21:53:47,2010-11-07 21:53:47
ae5d3fbab9be4e96ebe7e6ccd7d38416e24c2bfa...ee580489b1a131438d4e490b162a9a898b65d799,3,62,54,116,37,2010-11-07 23:59:40,2010-11-07 23:59:40
ee580489b1a131438d4e490b162a9a898b65d799...841f35456831192fd008222c8ae15b6738acace9,3,26,26,52,23,2010-11-08 00:56:02,2010-11-08 00:56:02
841f35456831192fd008222c8ae15b6738acace9...bcf37e4a66c55d53eeb9263097c6120633baf6aa,6,109,186,295,18,2010-11-08 04:57:25,2010-11-08 04:57:25
bcf37e4a66c55d53eeb9263097c6120633baf6aa...156ff68f1677a82624019d734f2b7ca43023ef6a,9,492,62,554,20,2010-11-08 05:09:59,2010-11-08 05:09:59
156ff68f1677a82624019d734f2b7ca43023ef6a...f629ad5a686477a579928bfd7677206e964345ce,1,20,9,29,6,2010-11-08 22:34:14,2010-11-08 22:34:14
f629ad5a686477a579928bfd7677206e964345ce...f8557b993f8f3d10499f14c033dddf2bc8923d16,1,3,9,12,3,2010-11-08 22:51:07,2010-11-08 22:51:07
f8557b993f8f3d10499f14c033dddf2bc8923d16...ef4088ebbe0dde80d4e59d67d7521b074b4dac7b,4,98,122,220,32,2010-11-09 05:55:31,2010-11-09 05:55:31
ef4088ebbe0dde80d4e59d67d7521b074b4dac7b...caab7aabd7b5a3050e72c165acb32d38a45f05a2,6,104,82,186,35,2010-11-09 06:49:31,2010-11-09 06:49:31
caab7aabd7b5a3050e72c165acb32d38a45f05a2...fbdad9ca73ab1026a502c8409233aaf3d0d638cf,1,1,0,1,1,2010-11-09 22:41:14,2010-11-09 22:41:14
fbdad9ca73ab1026a502c8409233aaf3d0d638cf...d21a500ea894b8e0c0429f19e10c10a8b4eaaec3,4,12,12,24,8,2010-11-09 22:42:31,2010-11-09 22:42:31
d21a500ea894b8e0c0429f19e10c10a8b4eaaec3...138fd92978cbd9d41264bb0a430bf910a45084fb,10,202,10,212,10,2010-11-09 22:45:31,2010-11-09 22:45:02
138fd92978cbd9d41264bb0a430bf910a45084fb...cf6db8aed29c5f478ff7ab295db2f6f6bbabfddb,5,89,31,120,23,2010-11-10 00:14:49,2010-11-10 00:14:49
cf6db8aed29c5f478ff7ab295db2f6f6bbabfddb...7f7ce5cc09e8556686af8c795cc0f5858f5ef6e7,6,56,43,99,28,2010-11-10 01:54:52,2010-11-10 01:54:52
7f7ce5cc09e8556686af8c795cc0f5858f5ef6e7...9f9255800a8f2fdc1840c2beffa57fdd0b11ad85,4,69,45,114,25,2010-11-10 23:46:58,2010-11-10 23:46:58
9f9255800a8f2fdc1840c2beffa57fdd0b11ad85...5b43420991956919af693a0b7c55585a88fa03c4,1,1,1,2,1,2010-11-11 06:43:02,2010-11-11 06:43:02
5b43420991956919af693a0b7c55585a88fa03c4...7cb9d581b2cd88fcd631c9063964c275717df055,5,18,9,27,7,2010-11-12 02:32:13,2010-11-12 02:32:13
7cb9d581b2cd88fcd631c9063964c275717df055...35ec68a74eaa35b2b770884c1886d822ebf8e0c8,10,356,177,533,50,2010-11-16 08:05:22,2010-11-16 08:05:22
35ec68a74eaa35b2b770884c1886d822ebf8e0c8...9761e25a4a5da501dba9e73f356ff943f9bfc617,5,11,8,19,11,2010-11-19 01:33:56,2010-11-19 01:33:56
9761e25a4a5da501dba9e73f356ff943f9bfc617...bbe029fa7f55a90191a21b54b3575cffc59bd648,6,311,11,322,6,2010-11-23 00:21:46,2010-11-23 00:21:46
bbe029fa7f55a90191a21b54b3575cffc59bd648...46b5d541bd07f9e7d0a6d06ff231d4147cd99b1a,7,74,89,163,31,2010-11-23 07:58:27,2010-11-23 07:58:27
46b5d541bd07f9e7d0a6d06ff231d4147cd99b1a...1855ca2df62b7bd97a0492423d601921e0862c9c,1,53,0,53,1,2010-11-26 23:12:36,2010-11-26 23:12:36
1855ca2df62b7bd97a0492423d601921e0862c9c...b786b5c607abe5771ee2fdda07cd5703b272ffd6,6,399,125,524,30,2010-11-27 01:55:45,2010-11-27 01:55:45
b786b5c607abe5771ee2fdda07cd5703b272ffd6...d16d680412a15610c89ff97a5fff47f603493f82,1,6,17,23,2,2010-11-27 02:01:21,2010-11-27 02:01:21
d16d680412a15610c89ff97a5fff47f603493f82...163a37e7cd66732ea4e6c37de89e74c0e29e1169,7,343,59,402,13,2010-11-27 09:07:00,2010-11-27 09:07:00
163a37e7cd66732ea4e6c37de89e74c0e29e1169...c021172fe88b314176e015d165d7de7d4a4ee5c2,7,106,58,164,18,2010-11-27 18:35:11,2010-11-27 18:35:11
c021172fe88b314176e015d165d7de7d4a4ee5c2...ed9321d107a681525c01eab1959feb1d4158dade,1,3,0,3,3,2010-11-27 22:10:07,2010-11-27 22:10:07
ed9321d107a681525c01eab1959feb1d4158dade...5ae51b25388c0f5770f98458a9c953248499f259,9,225,235,460,47,2010-11-27 22:13:02,2010-11-27 22:13:02
5ae51b25388c0f5770f98458a9c953248499f259...c86d8bc1bece2b68910665c8ffa0f72d5aca5e22,6,199,71,270,28,2010-11-28 02:19:30,2010-11-28 02:19:30
c86d8bc1bece2b68910665c8ffa0f72d5aca5e22...e08ff41dadbaf3bd9fcb5fce8f0580979b109984,1,15,2,17,3,2010-11-28 04:35:57,2010-11-28 04:35:57
e08ff41dadbaf3bd9fcb5fce8f0580979b109984...f02364dada485d9d807b430c3a93406e38bd3b7c,4,107,116,223,19,2010-11-28 19:39:35,2010-11-28 19:39:35
f02364dada485d9d807b430c3a93406e38bd3b7c...6307364a45e07d0caa130615639dfe1c04e95858,12,344,74,418,23,2010-11-28 21:15:07,2010-11-28 21:15:07
6307364a45e07d0caa130615639dfe1c04e95858...bbcf25ef7d188d8e1fcf56ad4e6becffa0756398,7,94,60,154,25,2010-11-29 00:28:48,2010-11-29 00:28:48
bbcf25ef7d188d8e1fcf56ad4e6becffa0756398...6d97ab221829bd48a7fb20733799b9057245266d,7,144,66,210,23,2010-11-30 21:40:05,2010-11-30 21:40:05
6d97ab221829bd48a7fb20733799b9057245266d...2f63829ad3c041f4a59fb99d7977e80d0c909043,3,31,41,72,5,2010-12-06 20:52:37,2010-12-06 20:52:37
2f63829ad3c041f4a59fb99d7977e80d0c909043...7278115d96b64a24b17adef0b2e45c231e58be2a,3,3,3,6,3,2010-12-06 23:36:22,2010-12-06 23:36:22
e2d478d5b901d87e07c7431d1d23808448f800ef...558ee4ee18c7a2b0dca4b14364d17e319f4f852b,1,1,0,1,1,2011-03-15 13:39:52,2011-03-15 13:39:52
7278115d96b64a24b17adef0b2e45c231e58be2a...8a6d054e6b46578a89725f74d55560cf41bd59fa,1,2,0,2,2,2010-12-09 22:46:45,2010-12-09 22:46:45
8a6d054e6b46578a89725f74d55560cf41bd59fa...2bdf55ce9cf45ac2376849d6b57727c1cfa3f50b,10,112,53,165,26,2010-12-09 23:04:24,2010-12-09 23:04:24
2bdf55ce9cf45ac2376849d6b57727c1cfa3f50b...be857135840e4b276c57920f980a50aedc18cdab,4,13,9,22,8,2010-12-11 00:14:42,2010-12-11 00:14:42
be857135840e4b276c57920f980a50aedc18cdab...c8a2c9d800b920751e8eb34182fe31001da9776f,4,79,53,132,11,2010-12-14 22:41:04,2010-12-14 22:41:04
c8a2c9d800b920751e8eb34182fe31001da9776f...8f757c2ffea0184bf8f0dbf690d235b5a5970f30,2,2,2,4,2,2010-12-14 22:41:41,2010-12-14 22:41:41
7278115d96b64a24b17adef0b2e45c231e58be2a...ecf796c04ad3669d658ba6548f3610651d4183db,5,241,14,255,5,2010-12-07 04:27:25,2010-12-07 04:27:25
ecf796c04ad3669d658ba6548f3610651d4183db...b9ad0a4af1acd107678e2cd92be0678bef1b2e61,4,85,49,134,29,2010-12-07 04:48:11,2010-12-07 04:48:11
46b3dd24d6ed53e3ff05b85fe4adbccab491d2fb...7a9e2559083fbba594a87a5c1e4b7524d0993f45,2,12,0,12,1,2011-03-15 17:57:28,2011-03-15 17:57:28
7a9e2559083fbba594a87a5c1e4b7524d0993f45...c25d4092fac4e01f6d10ce5428bd80cb57cb9b28,1,9,1,10,2,2011-03-26 02:36:32,2011-03-26 02:36:32
c25d4092fac4e01f6d10ce5428bd80cb57cb9b28...6b60c6e301b8e1893b0aa241b6dcf3bed1de5fcd,1,4,6,10,2,2011-03-26 02:38:00,2011-03-26 02:38:00
6b60c6e301b8e1893b0aa241b6dcf3bed1de5fcd...7078086faaf68ac3da9aacc5f72eb8f85ac099a7,1,4,4,8,2,2011-03-26 02:39:36,2011-03-26 02:39:36
7078086faaf68ac3da9aacc5f72eb8f85ac099a7...266858f6898e9ee5f36a185c562e543edeabe9fd,1,1,0,1,1,2011-03-26 02:41:47,2011-03-26 02:41:47
266858f6898e9ee5f36a185c562e543edeabe9fd...121228fd729b393caf0f6d2ff6404e9d64f228cc,1,3,1,4,2,2011-03-26 02:46:57,2011-03-26 02:46:57
121228fd729b393caf0f6d2ff6404e9d64f228cc...ec184a7e94e5101250f95132fe3f2fcb3db037f4,1,2,2,4,2,2011-03-26 14:12:55,2011-03-26 14:12:55
ec184a7e94e5101250f95132fe3f2fcb3db037f4...0d1679a8532ebb3e515fe3fbdbaff1e756c044cf,1,1,2,3,1,2011-03-26 14:16:58,2011-03-26 14:16:58
0d1679a8532ebb3e515fe3fbdbaff1e756c044cf...d3512287448851b50035cd0ebbd51b59b817b792,1,2,0,2,1,2011-03-26 14:27:02,2011-03-26 14:27:02
d3512287448851b50035cd0ebbd51b59b817b792...6a7ed1165ef0f5670a3270a9162033541920c631,1,0,2,2,1,2011-03-26 14:27:17,2011-03-26 14:27:17
6a7ed1165ef0f5670a3270a9162033541920c631...70ca6d7d6f1d7cbc5efdb6e7a79368a3571caa5f,1,8,5,13,3,2011-03-26 17:17:37,2011-03-26 17:17:37
70ca6d7d6f1d7cbc5efdb6e7a79368a3571caa5f...f4b96a91efcec4fe9eca2347134dc75f95b53c6e,1,0,0,0,0,2011-03-26 17:17:57,2011-03-26 17:17:57
f4b96a91efcec4fe9eca2347134dc75f95b53c6e...ce4a84e7a592ae5c94a250169a34149218d58811,1,48,3,51,3,2011-03-26 22:00:41,2011-03-26 22:00:41
ce4a84e7a592ae5c94a250169a34149218d58811...1769ab641f7e3e5696d58b04534ffa083225d488,1,0,0,0,0,2011-03-26 22:00:53,2011-03-26 22:00:53
1769ab641f7e3e5696d58b04534ffa083225d488...660d3bc9c9dffaeb74858195da36c8d5755e1115,19,64,43,107,39,2011-03-27 19:42:40,2011-03-27 19:42:40
660d3bc9c9dffaeb74858195da36c8d5755e1115...1147061e7b490c769655a161f064e7163cf37496,1,0,0,0,0,2011-03-31 13:17:06,2011-03-31 13:17:06
1147061e7b490c769655a161f064e7163cf37496...68c9bdba52e05301381d289d5cdcf73b8d16cc1e,36,495,191,686,62,2011-04-09 19:59:18,2011-04-09 19:59:18
68c9bdba52e05301381d289d5cdcf73b8d16cc1e...930ef2c2b612efaee7421cdf1ed2833a2cc3e310,2,4,4,8,4,2011-04-09 20:00:56,2011-04-09 20:00:56
930ef2c2b612efaee7421cdf1ed2833a2cc3e310...0a7073d9fe9729cefc449ab7f21cb02da7abb180,19,23,21,44,19,2011-04-09 20:59:03,2011-04-09 20:59:03
0a7073d9fe9729cefc449ab7f21cb02da7abb180...65305cd61b9a311562f84475b6a8855284297a5e,26,441,22,463,27,2011-04-11 02:05:11,2011-04-11 01:55:15
65305cd61b9a311562f84475b6a8855284297a5e...8f5c017d6b89787bcc1ac31423fcbb777697caf3,1,7,1,8,2,2011-04-11 02:19:31,2011-04-11 02:19:31
8f5c017d6b89787bcc1ac31423fcbb777697caf3...84577e486b40d52c972df93e55d635e988b1568c,4,4,4,8,4,2011-04-11 02:21:58,2011-04-11 02:21:58
84577e486b40d52c972df93e55d635e988b1568c...be25d287d2bca41c4e32e7aa1cb1c10c5639b549,1,9,1,10,1,2011-04-11 21:43:36,2011-04-11 21:43:36
be25d287d2bca41c4e32e7aa1cb1c10c5639b549...179074e67518f31afe0c1aa6e1acf25597644a29,1,5,5,10,5,2011-04-11 21:44:15,2011-04-11 21:44:15
179074e67518f31afe0c1aa6e1acf25597644a29...89c3e5873242773aeb16041b049059ffeb2554fe,1,32,0,32,1,2011-04-11 22:10:06,2011-04-11 22:10:06
89c3e5873242773aeb16041b049059ffeb2554fe...48c7a19bd4fcaab39db5b23f123c294f5968ce91,1,13,8,21,9,2011-04-11 22:28:43,2011-04-11 22:28:43
48c7a19bd4fcaab39db5b23f123c294f5968ce91...42ed15b8e01c9168f369812f22a9201113b9472b,1,34,4,38,3,2011-04-11 23:03:44,2011-04-11 23:03:44
42ed15b8e01c9168f369812f22a9201113b9472b...7605fbcfdd9fc62200b70d8b0abf50acfcf21655,1,15,7,22,11,2011-04-11 23:08:48,2011-04-11 23:08:48
7605fbcfdd9fc62200b70d8b0abf50acfcf21655...4139d986aeab0e30a20b51bad072f96910e410ca,1,9,3,12,3,2011-04-12 02:20:08,2011-04-12 02:20:08
4139d986aeab0e30a20b51bad072f96910e410ca...92fd3c480dd8b9ba17acebe053a855235c941e35,1,2,2,4,2,2011-04-12 02:20:45,2011-04-12 02:20:45
92fd3c480dd8b9ba17acebe053a855235c941e35...6de3a28e316e2555d41d2cb385509f3336d059bc,1,66,32,98,23,2011-04-12 03:35:31,2011-04-12 03:35:31
6de3a28e316e2555d41d2cb385509f3336d059bc...6e6b694d679a7036118677c31a62aab87a6b11b5,49,1333,119,1452,93,2011-04-14 18:40:57,2011-04-14 18:37:51
6e6b694d679a7036118677c31a62aab87a6b11b5...07e4b89ff69ccb9d0f56776ccb16ee02f1e1ff8d,2,5,4,9,4,2011-04-17 18:35:08,2011-04-17 18:34:06
07e4b89ff69ccb9d0f56776ccb16ee02f1e1ff8d...367692ea28df9a6a22418099be5eeafa32b33cc5,27,285,167,452,81,2011-04-25 05:41:59,2011-04-25 05:41:59
367692ea28df9a6a22418099be5eeafa32b33cc5...47a07f173d63765681dba35dd2acc4ed08c0ee6e,7,163,0,163,8,2011-04-25 05:54:24,2011-04-25 05:54:24
47a07f173d63765681dba35dd2acc4ed08c0ee6e...0ef5e1cdb12c2df43af0b52028314b0fe515a335,34,724,207,931,156,2011-05-08 00:04:50,2011-05-08 00:04:50
0ef5e1cdb12c2df43af0b52028314b0fe515a335...416d6dcebf592856c46520db5ac0481666910fda,43,777,227,1004,159,2011-06-02 19:20:27,2011-06-02 19:20:27
416d6dcebf592856c46520db5ac0481666910fda...8c8f5cb06f806b1cb060af8d3c33cffc11a85d88,2,23,252,275,3,2011-06-09 05:27:40,2011-06-09 05:27:40
8c8f5cb06f806b1cb060af8d3c33cffc11a85d88...a6146e72d59eff5a1df545390b0f993a15133a14,24,112,77,189,49,2011-06-11 19:43:10,2011-06-11 19:43:10
a6146e72d59eff5a1df545390b0f993a15133a14...d8e23abc430675f926d6254f0f45fc27e9ae1eff,32,380,145,525,90,2011-06-24 03:58:54,2011-06-24 03:58:54
d8e23abc430675f926d6254f0f45fc27e9ae1eff...57fc71fff2dcc4bebc478b37277e833ba79a71db,24,31,34,65,25,2011-06-25 17:50:25,2011-06-25 17:50:25
8f757c2ffea0184bf8f0dbf690d235b5a5970f30...2cdaf6ad003d0390abe7b17d03b2b7f10b4b90e3,4,96,64,160,16,2010-12-17 20:50:53,2010-12-17 20:50:53
2cdaf6ad003d0390abe7b17d03b2b7f10b4b90e3...19d478f3e0febb3b2f57e9b692202db577248089,9,140,68,208,26,2011-01-03 18:30:36,2011-01-03 18:30:36
19d478f3e0febb3b2f57e9b692202db577248089...085eb2fcd0c48453e170dcf4e0365d835f1bffd9,6,160,23,183,22,2011-01-04 22:14:53,2011-01-04 22:14:53
085eb2fcd0c48453e170dcf4e0365d835f1bffd9...bfed47b9d9531398c5645075829e6e14f32afe65,4,15,6,21,8,2011-01-04 23:01:09,2011-01-04 23:01:09
bfed47b9d9531398c5645075829e6e14f32afe65...bdcb648849bbb68140d07c75a497fede1c139520,33,739,913,1652,177,2011-01-05 19:35:39,2011-01-05 19:35:39
bdcb648849bbb68140d07c75a497fede1c139520...888ee9dcfb5f840181216ac4b196c20319e73133,1,3216,1,3217,1,2011-01-05 23:38:17,2011-01-05 23:38:17
888ee9dcfb5f840181216ac4b196c20319e73133...f0bf36690cfb1e89dbc6c8964c9d05a0fbb3c5d9,4,13,11,24,8,2011-01-05 23:38:38,2011-01-05 23:38:38
f0bf36690cfb1e89dbc6c8964c9d05a0fbb3c5d9...373ddee70623b2765bfe1cae866f0b0bc493a2be,12,261,72,333,21,2011-01-08 23:18:38,2011-01-08 23:18:38
373ddee70623b2765bfe1cae866f0b0bc493a2be...7048af6b028528017cf4a140c9e6965897e2ac91,4,11,11,22,7,2011-01-10 01:33:35,2011-01-10 01:33:35
70cb5359c9a5e5a2ab8ba3309f524a7a35a3cddb...633a931f5bec52e9b0e7c16eca29c679e453a683,6,553,65,618,16,2010-12-15 17:32:29,2010-12-15 17:32:29
633a931f5bec52e9b0e7c16eca29c679e453a683...5067f0a35def83803178966ad900901ea5acce57,6,262,244,506,31,2010-12-16 06:06:24,2010-12-16 06:06:24
57fc71fff2dcc4bebc478b37277e833ba79a71db...5cc968d4062eb2bf4cae54c5d2e9f721b5e72337,2,12,0,12,1,2011-07-11 19:56:50,2011-07-11 19:45:56
57fc71fff2dcc4bebc478b37277e833ba79a71db...0973ed20d1c12dbb101f4627d0f3887973869c47,1,1,1,2,1,2011-06-30 01:52:10,2011-06-30 01:52:10
0973ed20d1c12dbb101f4627d0f3887973869c47...6015037db26f1a88d13b2f181e31727db7a314d3,24,104,81,185,37,2011-06-30 01:53:13,2011-06-30 01:53:13
6015037db26f1a88d13b2f181e31727db7a314d3...5efb062f3db842b8fcd8a0a8cbfdc619795b3e95,40,3798,173,3971,102,2011-07-03 00:19:39,2011-07-03 00:19:39
5efb062f3db842b8fcd8a0a8cbfdc619795b3e95...79f034de3112bb22888f312f9f643680d8473393,3,921,4,925,3,2011-07-05 00:12:55,2011-07-05 00:12:55
79f034de3112bb22888f312f9f643680d8473393...3b459efd51563976247223224596eaf1966daa72,1,8,8,16,4,2011-07-05 00:16:31,2011-07-05 00:16:31
3b459efd51563976247223224596eaf1966daa72...6843501f98b13cb09229c348f042ac0bd7455b2f,1,2,2,4,2,2011-07-05 21:41:52,2011-07-05 21:41:52
6843501f98b13cb09229c348f042ac0bd7455b2f...788697272abad044c83226aafb295c5d67be6796,1,1,1,2,1,2011-07-06 05:02:32,2011-07-06 05:02:32
788697272abad044c83226aafb295c5d67be6796...bca6c20089b042ea4986686c326e4c03ed67bbff,30,72,46,118,45,2011-07-09 05:46:55,2011-07-09 05:46:55
bca6c20089b042ea4986686c326e4c03ed67bbff...f5d621eb9b5a8cad33d6781eac59d50041c9f184,32,411,87,498,43,2011-07-10 17:37:58,2011-07-10 17:37:58
487037e1af6b653f4274cfc2886761562135b787...6a4a2d1cc6bb3f0182ec92e29b13d77d2ad245e9,6,65,29,94,16,2011-01-11 22:25:25,2011-01-11 22:25:25
6a4a2d1cc6bb3f0182ec92e29b13d77d2ad245e9...473ee4fa0b23e6b9b9ed9ee727f74f88f26e3083,1,2,0,2,2,2011-01-12 00:45:29,2011-01-12 00:45:29
473ee4fa0b23e6b9b9ed9ee727f74f88f26e3083...65307730a364becb671fec02d833c3522083b682,13,435,200,635,21,2011-01-17 20:27:29,2011-01-17 20:27:29
65307730a364becb671fec02d833c3522083b682...870bc20ea6cea44df7989b2d37cbeb3d90ed11c1,3,0,113,113,3,2011-01-17 20:32:19,2011-01-17 20:32:19
870bc20ea6cea44df7989b2d37cbeb3d90ed11c1...c678ecb447b73c04f8193b34d92e54ff5d96a40d,5,1,144,145,6,2011-01-17 20:34:02,2011-01-17 20:34:02
c678ecb447b73c04f8193b34d92e54ff5d96a40d...ca2e207573aea9aed920fd44373931d7f7f849d1,1,1,1,2,1,2011-01-17 22:16:53,2011-01-17 22:16:53
6059265aec220b025ef22f3427bcd9ed3c9646ca...69be02fae35fba879e6be841c257b0aeac9b9e1c,26,48,38,86,33,2011-07-17 03:47:54,2011-07-17 03:47:54
69be02fae35fba879e6be841c257b0aeac9b9e1c...36467e1cac275f482be95cb2b492541269b3bbb6,26,378,46,424,40,2011-08-01 00:32:27,2011-07-31 23:13:01
36467e1cac275f482be95cb2b492541269b3bbb6...d8d892a4e55228f944b205ee4f82419aebd5b91d,22,61,58,119,32,2011-08-01 18:26:43,2011-08-01 18:26:43
d8d892a4e55228f944b205ee4f82419aebd5b91d...1ade58a6f120c3a33da73e2d09ba0f199202d6b4,9,902,3,905,10,2011-08-01 22:00:21,2011-08-01 21:57:07
1ade58a6f120c3a33da73e2d09ba0f199202d6b4...c8b2acb60ae7ba12e496128e1f71c664c2ace019,1,3,2,5,1,2011-08-01 22:02:08,2011-08-01 22:02:08
c8b2acb60ae7ba12e496128e1f71c664c2ace019...7befec5e7e9b2789a310164449ee8d9e5e8b385c,3,11,7,18,7,2011-08-10 01:54:42,2011-08-10 01:54:42
7befec5e7e9b2789a310164449ee8d9e5e8b385c...77adfbf0be7aed3825075b054691bb7d7ec064a2,1,4,4,8,1,2011-08-12 20:58:42,2011-08-12 20:58:42
77adfbf0be7aed3825075b054691bb7d7ec064a2...41d5c65c63f243e26e59b409666878034969221e,29,57,54,111,44,2011-08-19 04:44:17,2011-08-19 04:44:17
41d5c65c63f243e26e59b409666878034969221e...879869577fbf1509c5c64f0a26a7bd2c44f3ebcc,1,1,0,1,1,2011-08-19 11:14:35,2011-08-19 11:14:35
879869577fbf1509c5c64f0a26a7bd2c44f3ebcc...2e6fe39b4a16ad39068448f5be4482d578446452,25,32,34,66,27,2011-08-19 18:05:28,2011-08-19 18:05:28
2e6fe39b4a16ad39068448f5be4482d578446452...2c77d091631f87d867b39034443ba7b043240e68,29,67,53,120,44,2011-08-22 21:21:42,2011-08-22 21:15:52
2c77d091631f87d867b39034443ba7b043240e68...c8e942993cc2f02e60dcd60a3db80794386454de,30,1310,1170,2480,194,2011-08-23 20:13:03,2011-08-23 20:13:03
c8e942993cc2f02e60dcd60a3db80794386454de...b2158d7067c201a2e63de392afa308192880ee20,23,53,69,122,43,2011-08-24 21:14:41,2011-08-24 21:14:41
b2158d7067c201a2e63de392afa308192880ee20...039e9e69035e3053de39f62ce2a6eb2c079c1fd1,25,57,48,105,39,2011-08-25 01:13:40,2011-08-25 01:13:40
039e9e69035e3053de39f62ce2a6eb2c079c1fd1...0f93f0415809cca1203c02ef765857c3a28dbf4b,25,74,69,143,42,2011-08-28 16:36:59,2011-08-28 16:36:59
0f93f0415809cca1203c02ef765857c3a28dbf4b...64e644f6adce673a8693399c3634ffdf0b7d5514,29,219,86,305,56,2011-08-29 19:00:21,2011-08-29 19:00:21
64e644f6adce673a8693399c3634ffdf0b7d5514...0aebab11d5f1974e6881913c335800d6d81563a2,23,29,29,58,24,2011-08-29 19:15:13,2011-08-29 19:15:13
0aebab11d5f1974e6881913c335800d6d81563a2...78acd1402706c184d9e3049b4b783ac41d030ae9,23,39,33,72,28,2011-09-01 00:52:40,2011-09-01 00:52:40
78acd1402706c184d9e3049b4b783ac41d030ae9...49ba8be6dc1c1a484dfaf80b44859fc9cf502684,23,29,29,58,24,2011-09-02 19:11:26,2011-09-02 19:11:26
49ba8be6dc1c1a484dfaf80b44859fc9cf502684...661d8f7badc5402cb0a0a180247ded005efe9ff5,27,137,88,225,57,2011-09-18 03:36:37,2011-09-18 03:36:37
661d8f7badc5402cb0a0a180247ded005efe9ff5...26610821b710584e2e7f6b09586d96d1fcd0cca6,62,13016,0,13016,56,2011-09-21 19:05:35,2011-09-21 19:05:35
26610821b710584e2e7f6b09586d96d1fcd0cca6...e9787814e612f36be29127ae0e7b99a53d1c4b33,30,118,1,119,33,2011-09-22 14:24:04,2011-09-22 14:24:04
e9787814e612f36be29127ae0e7b99a53d1c4b33...bc410a2dad4cc965610de72c965cc88d2bb92c1b,23,51,31,82,28,2011-09-27 15:48:18,2011-09-27 15:48:18
bc410a2dad4cc965610de72c965cc88d2bb92c1b...4975a90d687e2b3da245a0504638416c06e988b5,27,397,182,579,94,2011-09-27 22:02:47,2011-09-27 22:02:47
4975a90d687e2b3da245a0504638416c06e988b5...0c08054302afc4fd322a030b96596c785fc226d4,25,94,85,179,45,2011-09-30 04:56:06,2011-09-30 04:56:06
0c08054302afc4fd322a030b96596c785fc226d4...be86e79ea6d6ac8501b407720ad88ab0cd44bd29,1,17,0,17,2,2011-10-05 18:43:48,2011-10-05 18:43:48
be86e79ea6d6ac8501b407720ad88ab0cd44bd29...078f68c96529fd6ce4fd6e066cfa498cda43c9e5,27,202,111,313,71,2011-10-11 04:42:03,2011-10-11 04:42:03
078f68c96529fd6ce4fd6e066cfa498cda43c9e5...9364a7f1605044854c6598d17ea470fc5852b111,23,52,40,92,27,2011-10-11 23:48:42,2011-10-11 23:48:42
9364a7f1605044854c6598d17ea470fc5852b111...14460b4437beb30435c7ccad9625481896789b49,25,56,33,89,29,2011-10-12 01:03:26,2011-10-12 01:03:26
14460b4437beb30435c7ccad9625481896789b49...a62be8ed5378b156c6cf69470944cf87c0d6553b,81,50394,0,50394,73,2011-10-18 19:55:32,2011-10-18 19:55:32
a62be8ed5378b156c6cf69470944cf87c0d6553b...16f193d1f30ac42e426e6408694c521283b84599,32,153,192,345,76,2011-10-19 23:46:34,2011-10-19 23:46:34
16f193d1f30ac42e426e6408694c521283b84599...d7cc6f9e81978c7b842eec54a94334d5a0c6c9e9,29,69,68,137,31,2011-10-20 01:02:30,2011-10-20 01:02:30
d7cc6f9e81978c7b842eec54a94334d5a0c6c9e9...f05418a181530bcd0d59d24f6ccb472f686db2a9,1,1,1,2,1,2011-10-22 02:01:35,2011-10-22 02:01:35
ca2e207573aea9aed920fd44373931d7f7f849d1...1a6163cb1a147da02ee3369e7ae74c8c4355d0a5,9,338,16,354,9,2011-01-21 19:59:05,2011-01-17 22:55:50
ca2e207573aea9aed920fd44373931d7f7f849d1...9ae67c7851deb8d1b2ccf065db5eaa46e6215935,2,249,2,251,2,2011-01-20 18:25:03,2011-01-20 18:25:03
9ae67c7851deb8d1b2ccf065db5eaa46e6215935...ce07649c53c42367beae63192d79454128d6c8ce,1,245,245,490,1,2011-01-20 18:40:14,2011-01-20 18:40:14
f05418a181530bcd0d59d24f6ccb472f686db2a9...a508f6f04651e118602f8db4acdfc187656fd8f4,1,1,1,2,1,2011-10-24 18:37:19,2011-10-24 18:37:19
f05418a181530bcd0d59d24f6ccb472f686db2a9...baab7b48e81862ccd91322ab444bebf35f7e92b8,25,32,30,62,26,2011-10-24 02:41:08,2011-10-24 02:41:08
41c91fd0375579cb43d8d55be04ce37885e901ba...57489948540c4d88afd710695bfafd9053a5f005,7,123,65,188,12,2011-01-25 19:31:54,2011-01-25 19:31:54
57489948540c4d88afd710695bfafd9053a5f005...bf4c410a29f8d411e3f39cb1d79350cf93c89275,1,1,1,2,1,2011-01-27 22:58:29,2011-01-27 22:58:29
bf4c410a29f8d411e3f39cb1d79350cf93c89275...80366082e86001711883aaac14f4d32e9565ec68,1,1,1,2,1,2011-01-27 23:13:56,2011-01-27 23:13:56
80366082e86001711883aaac14f4d32e9565ec68...811aa10f037a1802e5d2f9039b9624ee264bda50,10,159,118,277,33,2011-01-28 21:14:43,2011-01-28 20:09:20
811aa10f037a1802e5d2f9039b9624ee264bda50...1de75bc55ce7e181b8a4ccbe37417e7687dc3cbf,4,48,44,92,7,2011-01-29 00:26:09,2011-01-29 00:26:09
1de75bc55ce7e181b8a4ccbe37417e7687dc3cbf...44e67e29c0a34d740cb03a0856c38e4c9d7461b0,6,192,277,469,8,2011-01-31 06:01:15,2011-01-31 05:48:15
44e67e29c0a34d740cb03a0856c38e4c9d7461b0...f8ae20da9d5b4e9db9f8c17005773eb68adf26bc,42,291,252,543,129,2011-01-31 19:00:35,2011-01-31 19:00:35
f8ae20da9d5b4e9db9f8c17005773eb68adf26bc...8186c4b76405547b068ace6edd7864f3ac4d6aeb,3,111,116,227,5,2011-02-01 05:59:49,2011-02-01 05:32:38
8186c4b76405547b068ace6edd7864f3ac4d6aeb...ea5ebb1304f06dfe5c5ad3d305e1bdf9a92fad5c,4,6,6,12,6,2011-02-02 20:10:39,2011-02-02 20:10:39
ea5ebb1304f06dfe5c5ad3d305e1bdf9a92fad5c...99c31e1637c551404c961418614ec83a50cb0003,4,7,9,16,10,2011-02-02 20:59:10,2011-02-02 20:59:10
99c31e1637c551404c961418614ec83a50cb0003...e4935b1bb59cf09c0b2349901e9b790daaa8cfe0,1,83,16,99,2,2011-02-07 17:56:05,2011-02-07 17:56:05
e4935b1bb59cf09c0b2349901e9b790daaa8cfe0...b4231227e101fb274c70522bb6b3275d24e973da,8,129,93,222,19,2011-02-08 23:59:03,2011-02-08 23:59:03
b4231227e101fb274c70522bb6b3275d24e973da...d215acef78eeecfa1b2646576c9c141f883b00ad,13,495,92,587,34,2011-02-11 21:00:41,2011-02-11 21:00:41
d215acef78eeecfa1b2646576c9c141f883b00ad...12eb5c13fe7f9fca9583e13f953bddf8f181b2b7,1,97,0,97,1,2011-02-11 21:44:56,2011-02-11 21:44:56
12eb5c13fe7f9fca9583e13f953bddf8f181b2b7...c34cd15077c7bb1ac77cc3f0cd990a1de413103c,1,55,0,55,1,2011-02-12 01:35:21,2011-02-12 01:35:21
c34cd15077c7bb1ac77cc3f0cd990a1de413103c...0e1c1fad1756467715f0b87f687a81e41ee8706d,10,255,78,333,32,2011-02-12 03:42:52,2011-02-12 03:42:52
0e1c1fad1756467715f0b87f687a81e41ee8706d...77a061f26d0fc59094401e09387acce1f057f20e,8,364,120,484,40,2011-02-14 07:20:10,2011-02-14 07:20:10
77a061f26d0fc59094401e09387acce1f057f20e...67f122b1768dc154c627d28d96d1fa38ea7761a4,4,62,55,117,8,2011-02-16 13:26:54,2011-02-16 13:26:54
67f122b1768dc154c627d28d96d1fa38ea7761a4...c31590e2f7e126e1fe161f37f22c1590197a245e,4,83,67,150,11,2011-02-16 17:53:48,2011-02-16 17:53:48
c31590e2f7e126e1fe161f37f22c1590197a245e...8da80dcc994ef660198b5cf2b88343c429296847,10,8590,124,8714,35,2011-02-17 19:56:13,2011-02-17 19:56:13
a6bda1b97564dcd19314c7bcde1d6720958b705a...bfb4359ce7c29f56f5946ea31337f29f0274b11e,1,1,1,2,1,2011-10-25 23:07:02,2011-10-25 23:07:02
bfb4359ce7c29f56f5946ea31337f29f0274b11e...4887ebbf0af4ed1a4668bcde1ffc51af39cf070a,7,45,18,63,14,2011-11-05 02:23:24,2011-11-05 02:23:24
4887ebbf0af4ed1a4668bcde1ffc51af39cf070a...c608936910767c19b2a80a8c60f01666120c72db,37,902,484,1386,124,2011-11-05 02:39:52,2011-11-05 02:39:52
c608936910767c19b2a80a8c60f01666120c72db...b5b7e1d51be78c52f83ce15293d4a38a1ce68296,2,4,4,8,2,2011-11-05 02:43:18,2011-11-05 02:43:18
b5b7e1d51be78c52f83ce15293d4a38a1ce68296...a6c02987b87f16fb1b67f36c32ed252dd13b96b7,59,32835,0,32835,54,2011-11-16 18:19:26,2011-11-16 18:19:26
a6c02987b87f16fb1b67f36c32ed252dd13b96b7...73e4b2b2c0fe994fc492f0a2dcaa53e727a22cb2,3,23,1,24,3,2011-11-16 18:42:23,2011-11-16 18:42:23
73e4b2b2c0fe994fc492f0a2dcaa53e727a22cb2...10b44b3561a01d2bd9d3e7a6edb3e96a925551b2,23,48,38,86,30,2011-11-16 21:58:07,2011-11-16 21:58:07
10b44b3561a01d2bd9d3e7a6edb3e96a925551b2...4156fdf97651353bdff1da0fde5e55ea64df1150,27,195,153,348,92,2011-11-23 21:08:10,2011-11-23 21:08:10
4156fdf97651353bdff1da0fde5e55ea64df1150...00de99b524cfef7b19f8430ace0c73ba754a2ff4,59,268,247,515,238,2011-12-09 02:08:58,2011-12-09 02:08:58
00de99b524cfef7b19f8430ace0c73ba754a2ff4...cd6f4e4efc011e9b1c96e305ff77b8dce4589f85,2,2,2,4,2,2011-12-20 16:40:09,2011-12-20 16:40:09
cd6f4e4efc011e9b1c96e305ff77b8dce4589f85...d51446eaf548f5112953f9ccf9e8e96068822ef5,2,20,12,32,6,2011-12-27 18:09:16,2011-12-27 18:09:16
d51446eaf548f5112953f9ccf9e8e96068822ef5...2c2b342746b096a50ffbf04f0746248507567065,25,60,57,117,37,2011-12-30 20:02:42,2011-12-30 20:02:42
2c2b342746b096a50ffbf04f0746248507567065...dfd6487219f0d262f2d9fc2080f7f4d9aeda19ae,5,142,155,297,142,2012-01-03 19:25:23,2012-01-03 19:25:23
dfd6487219f0d262f2d9fc2080f7f4d9aeda19ae...c275dac4dafc92edb02b47d2ec9b817bd4d51b35,25,50,46,96,39,2012-01-17 21:10:38,2012-01-17 21:10:38
c275dac4dafc92edb02b47d2ec9b817bd4d51b35...685ca402c67cc99d7d14da620e35af486b1edad0,27,51,43,94,38,2012-01-26 19:56:42,2012-01-26 19:56:42
685ca402c67cc99d7d14da620e35af486b1edad0...bd988db4b592a51ea69a65fb0dc36b0c1f9fd223,27,133,47,180,44,2012-02-02 04:10:30,2012-02-02 04:10:30
bd988db4b592a51ea69a65fb0dc36b0c1f9fd223...2cda6f4eb10e9803a47df5b2631ff49ec17cac33,2,4,4,8,2,2012-02-12 16:42:45,2012-02-12 16:42:45
2cda6f4eb10e9803a47df5b2631ff49ec17cac33...1ae165109399ef88ea8d0940e7f367f8e5f44012,2,9,0,9,1,2012-02-13 16:28:40,2012-02-13 16:28:40
1ae165109399ef88ea8d0940e7f367f8e5f44012...bdbc1b5911daa17becf8bb550ef95ccb7ea4b9bd,1,0,0,0,0,2012-02-13 16:33:52,2012-02-13 16:33:52
bdbc1b5911daa17becf8bb550ef95ccb7ea4b9bd...224ff06154d660504aec4a7831a10109897f37e6,1,0,286,286,1,2012-02-18 17:20:39,2012-02-18 17:20:39
224ff06154d660504aec4a7831a10109897f37e6...23a89a616b5cdec8d181adb6bf7e451b8d85b7a8,40,14826,4543,19369,62,2012-02-18 22:12:24,2012-02-18 21:30:06
23a89a616b5cdec8d181adb6bf7e451b8d85b7a8...6d7dddf88727fb90aae84e8c50d821dab3218935,16,1078,994,2072,244,2012-02-25 03:21:52,2012-02-25 03:21:52
6d7dddf88727fb90aae84e8c50d821dab3218935...11232194f670df9011db81391fbd358e82f83261,3,1038,953,1991,220,2012-02-25 03:24:42,2012-02-25 03:24:42
11232194f670df9011db81391fbd358e82f83261...5f7ba2923b0b3d82ddbb751450e01045e4868abd,8,210,172,382,96,2012-03-05 03:50:33,2012-03-05 03:50:33
5f7ba2923b0b3d82ddbb751450e01045e4868abd...04eae18ab207bf3620966e994a82dd98fa6d73b8,3,3,3,6,3,2012-03-16 16:34:33,2012-03-16 16:34:33
04eae18ab207bf3620966e994a82dd98fa6d73b8...0593bde812a563bf818f4e279424251d36b68b63,1,1,0,1,1,2012-04-11 23:01:34,2012-04-11 23:01:34
0593bde812a563bf818f4e279424251d36b68b63...a12f7665c7c9f077e52537ae997873ea91683f41,36,594,490,1084,266,2012-04-15 21:44:44,2012-04-15 21:44:44
a12f7665c7c9f077e52537ae997873ea91683f41...1c3a54b54d1293e92ae7b7d8b07008a173f36857,8,12,16,28,12,2012-04-19 01:32:19,2012-04-19 01:32:19
1c3a54b54d1293e92ae7b7d8b07008a173f36857...c385907bdd6dc8fce1a20ab024ed874e5b0f0d56,1,1,0,1,1,2012-04-25 18:50:59,2012-04-25 18:50:59
c385907bdd6dc8fce1a20ab024ed874e5b0f0d56...a1a662afd73b80dcdf153c3f54281af1347600b9,1,0,1,1,1,2012-04-25 18:52:25,2012-04-25 18:52:25
a1a662afd73b80dcdf153c3f54281af1347600b9...71ab6ff7d3efc76d1bc0b7e0663730df948e1377,25,42,582,624,42,2012-04-26 03:56:10,2012-04-26 03:55:10
71ab6ff7d3efc76d1bc0b7e0663730df948e1377...cb9a0256216cc698d41544237739c3c6d87edcb9,7,20,122,142,15,2012-04-26 04:00:44,2012-04-26 04:00:44
cb9a0256216cc698d41544237739c3c6d87edcb9...3b60b1a28b12be082bc68d299880245f40391afc,1,445,0,445,1,2012-04-26 04:03:00,2012-04-26 04:03:00
3b60b1a28b12be082bc68d299880245f40391afc...761e1800befde32fc512360933b25f6984e0a53c,1,0,247,247,1,2012-04-26 04:03:46,2012-04-26 04:03:46
761e1800befde32fc512360933b25f6984e0a53c...7516db250edef816d909a1fe668e307a752f7aa0,1,1,0,1,1,2012-04-26 21:10:28,2012-04-26 21:10:28
7516db250edef816d909a1fe668e307a752f7aa0...83be748d97dfbc65c6fcb90344e745d36b4c1cc1,3,3,484,487,3,2012-04-30 20:25:32,2012-04-30 20:25:32
83be748d97dfbc65c6fcb90344e745d36b4c1cc1...c0b8cf5acc4e394ae4b797828941c351e4f14fec,3,3,41,44,4,2012-05-01 14:49:35,2012-05-01 14:49:35
c0b8cf5acc4e394ae4b797828941c351e4f14fec...2d70cc618ef6a169e12de94ee91b0e56c5b1b23d,6,24,20,44,18,2012-05-17 19:11:13,2012-05-17 19:11:13
2d70cc618ef6a169e12de94ee91b0e56c5b1b23d...68084b81e59411f4ed82cf7ec66d22d015278d8a,6,50,44,94,14,2012-06-14 16:49:47,2012-06-14 16:49:47
68084b81e59411f4ed82cf7ec66d22d015278d8a...50f979f67396349a184648c15228f84c80f2697a,6,76,84,160,34,2012-06-24 18:06:28,2012-06-24 18:06:28
50f979f67396349a184648c15228f84c80f2697a...a4a95fc0b7be96f09d091956ba7e9189cf2f34e4,4,4,18774,18778,4,2012-08-02 19:47:41,2012-08-02 19:47:41
a4a95fc0b7be96f09d091956ba7e9189cf2f34e4...a01b584b267a211ef3a9d7c2b5ebd5532f9309a3,6,3191,3226,6417,8,2012-09-04 02:21:07,2012-09-04 02:21:07
a01b584b267a211ef3a9d7c2b5ebd5532f9309a3...165c6e54f5324006059738bf2e7ea85d52e930c3,1,1,11,12,3,2012-10-08 04:01:42,2012-10-08 04:01:42
165c6e54f5324006059738bf2e7ea85d52e930c3...9b38319536e2493b65f308b0ca4c773d514cac35,3,154,149,303,50,2012-10-08 04:01:54,2012-10-08 04:01:54
9b38319536e2493b65f308b0ca4c773d514cac35...7d9858f6be968bc9e580b04b271f00baa4f582fd,4,2,69,71,4,2012-11-12 16:40:58,2012-11-12 16:40:58
7d9858f6be968bc9e580b04b271f00baa4f582fd...b2f3c70f1366b299d737f08d51c0f64377f29bd4,5,2,95,97,10,2012-11-12 18:06:39,2012-11-12 18:06:39
b2f3c70f1366b299d737f08d51c0f64377f29bd4...ac9a4838bc422e0c56fd1f28f5d4f750a9c69638,2,0,6,6,3,2012-11-12 18:07:42,2012-11-12 18:07:42
ac9a4838bc422e0c56fd1f28f5d4f750a9c69638...6f39f8abc02482c67953e28742d93dbcc329f034,4,0,100,100,6,2012-11-12 18:12:08,2012-11-12 18:12:08
6f39f8abc02482c67953e28742d93dbcc329f034...ccdc0bba9bde90488530b290e9260ea005d6320e,17,6,610,616,20,2012-11-12 19:11:58,2012-11-12 19:11:58
ccdc0bba9bde90488530b290e9260ea005d6320e...d5d1fd81d9b9320a90a48a0ac36541c2236315f9,7,2,879,881,9,2012-11-12 19:56:20,2012-11-12 19:56:02
d5d1fd81d9b9320a90a48a0ac36541c2236315f9...61bda95e9c8b57e669d70ef9352a5be3b41f2f13,6,2,349,351,8,2012-11-12 21:22:43,2012-11-12 21:22:43
61bda95e9c8b57e669d70ef9352a5be3b41f2f13...b6db98eba5ea8493fb6af1fa2b1a14ac501aadfc,8,2,532,534,10,2012-11-12 21:28:23,2012-11-12 21:28:23
b6db98eba5ea8493fb6af1fa2b1a14ac501aadfc...78708890d79f3b0885c8d708f86521b9081c3f33,7,2,138,140,10,2012-11-12 21:33:07,2012-11-12 21:33:07
78708890d79f3b0885c8d708f86521b9081c3f33...c109ec30ead837535d449ebe182af30f31356fce,7,4,900,904,9,2012-11-12 21:43:43,2012-11-12 21:43:43
c109ec30ead837535d449ebe182af30f31356fce...b8cd0d41c52356f97e10244ab61ba451cff3a385,6,2,126,128,8,2012-11-13 01:30:05,2012-11-13 01:30:05
b8cd0d41c52356f97e10244ab61ba451cff3a385...e7ba2fe1cd92c2fef6ffdd9f5dedde3519a45ee2,7,2,5421,5423,11,2012-11-13 01:44:05,2012-11-13 01:44:05
e7ba2fe1cd92c2fef6ffdd9f5dedde3519a45ee2...ffea601869e6f4e64b7ba5c8345351381485bd1e,4,2,104,106,6,2012-11-13 02:11:34,2012-11-13 02:11:34
ffea601869e6f4e64b7ba5c8345351381485bd1e...ff99f71df1213d86a37a356bdfc0ea2afc349635,6,2,110,112,8,2012-11-13 02:14:34,2012-11-13 02:14:34
ff99f71df1213d86a37a356bdfc0ea2afc349635...dc758294689d643f9d3a0a029b95272371ff03ad,6,4,124,128,8,2012-11-13 02:20:34,2012-11-13 02:20:34
dc758294689d643f9d3a0a029b95272371ff03ad...3000d93b5ecb90b10afde33adc7a197fcce3461a,6,2,122,124,8,2012-11-13 02:23:05,2012-11-13 02:23:05
3000d93b5ecb90b10afde33adc7a197fcce3461a...f1c210a2fbab2f4c58499355cae405853b8a49b7,6,2,152,154,8,2012-11-13 02:31:08,2012-11-13 02:31:08
f1c210a2fbab2f4c58499355cae405853b8a49b7...1a57c1854335324193f345b03ffd43b06547f75b,7,1,5110,5111,10,2012-11-13 02:33:17,2012-11-13 02:32:29
1a57c1854335324193f345b03ffd43b06547f75b...df1adeeac7e929bcb9bb8321be3d42e558aa0f93,13,2,3697,3699,11,2012-11-13 03:02:33,2012-11-13 03:02:33
8da80dcc994ef660198b5cf2b88343c429296847...d563b53d1385739ddb9e34542c3fd1f01da7fa74,4,77,77,154,5,2011-02-18 23:10:17,2011-02-18 23:10:17
8da80dcc994ef660198b5cf2b88343c429296847...fe5fdb31c0495d492745e6221b1b5be785fd1de4,1,31,0,31,1,2011-02-18 18:40:35,2011-02-18 18:40:35
fe5fdb31c0495d492745e6221b1b5be785fd1de4...e6bfd66443d147d91b63be7aaf77754fba82cb3f,3,15,31,46,7,2011-02-18 19:50:26,2011-02-18 19:50:26
df1adeeac7e929bcb9bb8321be3d42e558aa0f93...4433843c54ddfcf51941dbf92af48c3ab59fc3b2,1,1,0,1,1,2013-03-03 03:12:13,2013-03-03 03:12:13
6d8a51b7de4f43e841642d28babdb082af6a4b81...3ecb7534ef3150dc465cf1024ce0114d4da52e12,11,333,33,366,17,2011-02-23 20:33:18,2011-02-23 20:33:18
6d8a51b7de4f43e841642d28babdb082af6a4b81...59c32fc669875fe77b1767113009dfa477450e98,6,8,8,16,8,2011-02-23 17:09:43,2011-02-23 17:09:43
18fbfe7e80cf73fdc40b8fb671cf6f394aeace7e...e2df6df0164f68a5bdaf094e7182f221c3a2f616,2,6,0,6,2,2013-04-25 12:46:07,2013-04-25 12:42:52
e2df6df0164f68a5bdaf094e7182f221c3a2f616...573b2433193e9fca4a85f35fbb4ebf2c4f578897,1,1,1,2,1,2013-04-25 13:05:09,2013-04-25 13:05:09
573b2433193e9fca4a85f35fbb4ebf2c4f578897...aff60e5f162f0e7ebf0f83bc300fcc6c75d3776d,1,4,3,7,3,2013-05-30 05:28:35,2013-05-30 05:28:35
77f81a01faac011f04a4253a927a520ef6783e7e...23dc44e5858585f8be2ba43e4963cc55c6b65bb4,1,2,1,3,2,2011-02-23 21:04:18,2011-02-23 21:04:18
23dc44e5858585f8be2ba43e4963cc55c6b65bb4...ade083dd56f7e795767a0e00d330a7ef5bfd3795,13,366,236,602,41,2011-02-24 22:13:05,2011-02-24 22:13:05
ade083dd56f7e795767a0e00d330a7ef5bfd3795...a29c802a77227df81668b0e3c556cbde8552b680,8,39,21,60,17,2011-02-24 22:36:57,2011-02-24 22:36:57
a29c802a77227df81668b0e3c556cbde8552b680...198ee5f86d0251d34540900cae8739ad985499c4,1,7,8,15,3,2011-02-25 18:01:34,2011-02-25 18:01:34
198ee5f86d0251d34540900cae8739ad985499c4...aa69f209360cdfcb2bdbe4b191d6a86d399d23ed,5,63,62,125,6,2011-02-26 04:51:05,2011-02-26 04:32:09
aa69f209360cdfcb2bdbe4b191d6a86d399d23ed...63638819230ae26d01cda33a589413f61975fe91,5,7,9,16,6,2011-02-27 19:56:25,2011-02-27 19:56:25
63638819230ae26d01cda33a589413f61975fe91...7b1df15bfef79c72c591d8690aed11ba1e907cb0,5,219,227,446,6,2011-02-27 20:09:27,2011-02-27 20:09:27
7b1df15bfef79c72c591d8690aed11ba1e907cb0...127ecdea25d2902fa4907f3c49f0938ac9f55577,3,160,162,322,4,2011-02-27 20:21:11,2011-02-27 20:21:11
127ecdea25d2902fa4907f3c49f0938ac9f55577...8a00d728503665ae99424f62a297573f37f61bc7,1,1,1,2,1,2011-02-27 20:33:02,2011-02-27 20:33:02
8a00d728503665ae99424f62a297573f37f61bc7...85de0bed709005129c39f04508f2e6222d31b7c8,2,4,4,8,4,2011-02-27 20:36:11,2011-02-27 20:36:11
85de0bed709005129c39f04508f2e6222d31b7c8...b8cc4c97086fe8df63152c8f2c291db5a8c22a55,8,259,255,514,14,2011-02-27 21:03:00,2011-02-27 20:41:31
b8cc4c97086fe8df63152c8f2c291db5a8c22a55...62ef98e817ec05441e78ce78da2179a09b1062e3,3,53,59,112,4,2011-02-27 21:05:55,2011-02-27 21:05:55
62ef98e817ec05441e78ce78da2179a09b1062e3...1d9ed5ae72ee07b3ee5e3acd9301e5912dc6e1f1,4,76,46,122,13,2011-02-27 23:05:18,2011-02-27 23:05:18
aff60e5f162f0e7ebf0f83bc300fcc6c75d3776d...7952a93f76da65d39fbf4f02c6612a99eb396ced,1,1,1,2,1,2013-07-13 00:16:26,2013-07-13 00:16:26
1d9ed5ae72ee07b3ee5e3acd9301e5912dc6e1f1...6b8839eab69f1eae4b59cab8925d4ab4dfb90f50,3,510,0,510,3,2011-02-28 23:04:20,2011-02-28 23:04:20
1d9ed5ae72ee07b3ee5e3acd9301e5912dc6e1f1...ced7b7242b575e6a35e4b9bf8059a77569ed4c76,4,80,79,159,23,2011-02-28 02:22:23,2011-02-28 02:22:23
ced7b7242b575e6a35e4b9bf8059a77569ed4c76...99b4f2ec302f00d06d2824df88cb0e1512d9116a,2,1,6,7,3,2011-02-28 02:34:47,2011-02-28 02:34:47
99b4f2ec302f00d06d2824df88cb0e1512d9116a...07fe0f5d90561293d43baaaeb99efde1a197498f,5,74,76,150,7,2011-02-28 18:12:25,2011-02-28 18:12:25
818bfe720ed2338cd21bcbaa2954e51672a9a4a7...7c0ef81e6e8a0543af089f802149774bc3f59dcb,1,1,1,2,1,2013-08-04 22:36:44,2013-08-04 22:36:44
32c06207a2aba686eeb863b9ab198d6e111e4cba...125ea93b63efd253922930488e6bc54874401df9,3,41,31,72,5,2011-03-01 01:02:58,2011-03-01 01:02:58
125ea93b63efd253922930488e6bc54874401df9...0585616df1ae6019b7f21fe163f386aba305a122,4,118,79,197,25,2011-03-01 20:01:09,2011-03-01 20:01:09
146e479207ebe33b346d5a53d7c090665187ee9a...caff61f3db2f1e3e8aecb830af75d29c372b21b7,1,1,0,1,1,2013-10-02 15:44:40,2013-10-02 15:44:40
caff61f3db2f1e3e8aecb830af75d29c372b21b7...f95d81aa6484540ef14aff77537630c3cd8625f8,2,2,450,452,2,2013-11-06 19:11:14,2013-11-06 19:11:14
f95d81aa6484540ef14aff77537630c3cd8625f8...ae8a4f9629a94bfef3e306d3733e04f0e9966554,2,2,482,484,2,2014-05-08 21:15:35,2014-05-08 21:15:35
ae8a4f9629a94bfef3e306d3733e04f0e9966554...4467f98846a6fab551b32f9d6f1d24eb4448036a,2,2,907,909,2,2014-06-14 04:28:35,2014-06-14 04:28:35
0585616df1ae6019b7f21fe163f386aba305a122...3cfb007d9dc0a8f32b67a4c7886bdfaa7a2c5e17,3,309,296,605,42,2011-03-03 22:20:18,2011-03-03 22:20:18
3cfb007d9dc0a8f32b67a4c7886bdfaa7a2c5e17...36e935a8c884daf5b465ccf3dd6b64ac614e5dbb,14,452,75,527,29,2011-03-03 23:43:57,2011-03-03 23:43:57
36e935a8c884daf5b465ccf3dd6b64ac614e5dbb...31c47f8f99b2a6a9f6f639be6423896501fe2aad,1,1,1,2,1,2011-03-04 00:01:18,2011-03-04 00:01:18
31c47f8f99b2a6a9f6f639be6423896501fe2aad...1fe1b466d9f6722e1682e4f093e376f0c9158823,25,37090,0,37090,25,2011-03-04 19:47:19,2011-03-04 19:47:19
1fe1b466d9f6722e1682e4f093e376f0c9158823...3568ecac2cdafb1f0826cfa54560577089bb65bf,1,1,3,4,1,2011-03-04 19:48:14,2011-03-04 19:48:14
3568ecac2cdafb1f0826cfa54560577089bb65bf...7df63b3cfebd0085276231a72b4a723abfc67f89,21,189,148,337,103,2011-03-04 21:42:49,2011-03-04 21:42:49
7df63b3cfebd0085276231a72b4a723abfc67f89...50ebc155cb66a2d941e82c401bc7af96f9940b01,7,323,74,397,25,2011-03-04 23:25:09,2011-03-04 23:25:09
0585616df1ae6019b7f21fe163f386aba305a122...92ad7c065c58272e47071a6cb4cc9624840bc709,7,232,11,243,7,2011-03-02 21:10:32,2011-03-02 21:10:32
50ebc155cb66a2d941e82c401bc7af96f9940b01...eaed6b880bc5550ad0a6b3a4542f6f8534a6a6da,9,90,27,117,11,2011-03-05 00:05:53,2011-03-05 00:05:53
eaed6b880bc5550ad0a6b3a4542f6f8534a6a6da...1be121ae200b1fd28faa4eed89efffd40c738d3b,6,2321,2396,4717,52,2011-03-05 00:35:16,2011-03-05 00:35:16
1be121ae200b1fd28faa4eed89efffd40c738d3b...9857dade141670d6d51606df1f36b129e4cf52bf,3,68,50,118,20,2011-03-08 22:23:31,2011-03-08 22:23:31
9857dade141670d6d51606df1f36b129e4cf52bf...871cefc0a40d899520895eabb56d598c17f1fa7b,3,90,1,91,3,2011-03-08 22:24:23,2011-03-08 22:24:23
871cefc0a40d899520895eabb56d598c17f1fa7b...e15183c32ab0e3fb9b3d127b8a6a32bb0976a170,3,3,3,6,3,2011-03-08 22:52:42,2011-03-08 22:52:42
e15183c32ab0e3fb9b3d127b8a6a32bb0976a170...166f8b5868beeae90966876a2a31bbe203cfb21f,7,86,88,174,32,2011-03-09 07:29:59,2011-03-09 07:29:59
166f8b5868beeae90966876a2a31bbe203cfb21f...7c7be4b17c38e2baaf8c7a54f27d0d34f2212d81,3,5,3,8,3,2011-03-11 19:39:11,2011-03-11 19:39:11
166f8b5868beeae90966876a2a31bbe203cfb21f...996e21eb1bc1afcee719f79ac1d6ac3c9b5eff5a,9,270,80,350,20,2011-03-11 01:33:53,2011-03-11 01:33:53
166f8b5868beeae90966876a2a31bbe203cfb21f...42237509de7e221b32b1c8454bf8dd04a307a75a,2,92,85,177,10,2011-03-10 19:55:26,2011-03-10 19:55:26
166f8b5868beeae90966876a2a31bbe203cfb21f...4bf129f49eb608e34e46f60edb1d23303dd2ed27,1,1,1,2,1,2011-03-09 17:28:21,2011-03-09 17:28:21
42237509de7e221b32b1c8454bf8dd04a307a75a...ae0cddd9f4e75959d75fd1d5b2f251ae70450f61,5,42,53,95,16,2011-03-12 11:32:20,2011-03-12 11:30:08
42237509de7e221b32b1c8454bf8dd04a307a75a...673151160bec809b107662d761d93cdf404a968a,3,3,5,8,3,2011-03-12 11:17:16,2011-03-12 11:17:16
673151160bec809b107662d761d93cdf404a968a...d2ede7ce6991e0b5ba5cd3d8c3bc07a6d36bc0d3,3,15,0,15,3,2011-03-12 12:09:30,2011-03-12 12:09:30
2ace7e68146fd3ba047752dcc26edde716da4ace...abae3f9263dcaeb85b68b743c5a343a2cd97e41b,15,422,198,620,44,2011-03-12 18:27:05,2011-03-12 18:27:05
abae3f9263dcaeb85b68b743c5a343a2cd97e41b...aad495add3ff94457e45bfb7fa1ac8e742c0e7b3,8,390,115,505,40,2011-03-12 20:43:51,2011-03-12 20:43:51
aad495add3ff94457e45bfb7fa1ac8e742c0e7b3...ff9da42269ce9ae5dadd75e1c5a373b471841514,11,258,46,304,28,2011-03-13 01:00:55,2011-03-13 01:00:55
ff9da42269ce9ae5dadd75e1c5a373b471841514...3fff37a56d17ed33c159342ae879d1a62eb19dec,3,108,1,109,3,2011-03-13 04:17:31,2011-03-13 04:17:31
3fff37a56d17ed33c159342ae879d1a62eb19dec...244338925fca477609b47805549e5200f361af48,3,19,0,19,3,2011-03-13 04:24:17,2011-03-13 04:24:17
244338925fca477609b47805549e5200f361af48...52bf6c978a1388d4f2fd3f4e0bad0fd51e86bcd6,13,120,41,161,32,2011-03-13 05:14:07,2011-03-13 05:14:07
52bf6c978a1388d4f2fd3f4e0bad0fd51e86bcd6...a00c9a5631934c2252c40613341548c3e0229cbf,1,1,4,5,1,2011-03-13 05:20:41,2011-03-13 05:20:41
8e3f8104ad42db327291c0c5ff7499a563aaf734...f216c18db852d3ec7736c077a28374999d4eec93,9,137,135,272,10,2011-04-25 11:14:47,2011-04-23 10:39:35
f216c18db852d3ec7736c077a28374999d4eec93...987755b01ee87f668b4a77e4a5e84f87a91d8e21,2,25,3,28,5,2011-05-14 17:58:30,2011-05-14 17:58:30
987755b01ee87f668b4a77e4a5e84f87a91d8e21...b9eff658a3244a92489ba60f725aaefc50034141,6,137,134,271,26,2011-05-28 07:13:53,2011-05-28 07:13:53
3fbded484a254ffc9e52ffadb05b1134b45971b6...2248e04ae4d4feac9c36e38475eddb916721961c,6,33,5,38,8,2011-03-12 20:43:15,2011-03-12 20:43:15
2248e04ae4d4feac9c36e38475eddb916721961c...e6d21d4d1222a33a3bacef81f3a7ad4850d8605f,5,20,8,28,9,2011-03-12 21:25:39,2011-03-12 21:25:39
8ce5ec60bb618874dc68370f54678739b6905907...651fb56c0a0b1f97a643f9e268a8891cbc22bf4b,5,47,10,57,9,2011-03-12 16:25:49,2011-03-12 16:25:49
e6b0924aa8eea74f20f1a23c2d908bfe57738146...aa0b9f8c3e8305bd0c61378fa20649984e59f670,5,365,366,731,7,2011-03-13 06:08:17,2011-03-13 05:54:51
aa0b9f8c3e8305bd0c61378fa20649984e59f670...723a53187460b8a960c24c204c27395c48f92145,10,281,102,383,22,2011-03-13 18:38:10,2011-03-13 18:38:10
723a53187460b8a960c24c204c27395c48f92145...5f4e950002202b4108f1091ca1ee6c644b35aa15,6,175,31,206,28,2011-03-15 06:39:11,2011-03-15 06:39:11
39a32e17d1023e878ac39976c2a363645e91fe0e...66c7357cc2acb214b0893dad15e318aa9fa6c593,1,2,0,2,1,2011-03-25 13:03:46,2011-03-25 13:03:46
39a32e17d1023e878ac39976c2a363645e91fe0e...1dfd3350dcd78ce29f76f4f15da0f94ca219ffad,96,5114,635,5749,98,2011-03-25 10:28:41,2011-03-25 10:25:43
bb6f3c6ca03bf9cd51a2cd963edb28a3406be7d9...f7cee9c225d9ae1477073b839f08ad6fe37c095f,1,1,1,2,1,2011-03-15 13:06:36,2011-03-15 13:06:36
204e00efde1b2813dae62fc1fe595d6f179146d5...2e560f6d6e020b471deb63116345221e7564eb22,9,126,66,192,37,2011-05-30 20:43:18,2011-05-30 20:39:32
2e560f6d6e020b471deb63116345221e7564eb22...d68551b59b4c3b954b020e7af4453993db683b70,2,134,0,134,2,2011-06-02 19:17:41,2011-06-02 19:17:41
d68551b59b4c3b954b020e7af4453993db683b70...953bebb17c339879a96c0edb09f73f4058529bea,3,141,2,143,4,2011-06-03 06:25:28,2011-06-03 06:25:28
66c7357cc2acb214b0893dad15e318aa9fa6c593...787e80a25c70c6da9b6ee9fa2049c05bacc605b8,1,6,12,18,3,2011-03-30 14:56:04,2011-03-30 14:56:04
66c7357cc2acb214b0893dad15e318aa9fa6c593...c572c7071f369a2b685e7ec30ddffd31d6c06a87,4,377,0,377,4,2011-03-26 17:50:32,2011-03-26 17:50:32
937529eff38cb065b4bf028ee873fe35b3f2ad67...4fcff607ab031bc3df0a1863435796b8515cfe5e,4,6,6,12,6,2011-03-17 17:24:02,2011-03-17 17:24:02
953bebb17c339879a96c0edb09f73f4058529bea...40ba7913e0540a0a2f31445addf80209a35d5299,3,24,18,42,5,2011-06-11 19:32:41,2011-06-11 19:31:13
40ba7913e0540a0a2f31445addf80209a35d5299...093089fd6b628e2eeb0a7675b12b1061d0027c81,2,36,0,36,2,2011-06-11 19:36:51,2011-06-11 19:36:51
953bebb17c339879a96c0edb09f73f4058529bea...d756caa0d852d981d0ad96ec65cb1b4cf4862ec9,9,170,73,243,32,2011-06-11 18:31:42,2011-06-11 18:31:42
953bebb17c339879a96c0edb09f73f4058529bea...de35e0d094681d3b9362818de4a69d49b8ac64bd,3,12,12,24,9,2011-06-11 18:12:51,2011-06-11 18:12:51
953bebb17c339879a96c0edb09f73f4058529bea...06b0b25de03fa701de7c3b4bcd19c5eca0ab381e,1,106,0,106,1,2011-06-07 02:55:18,2011-06-07 02:55:18
953bebb17c339879a96c0edb09f73f4058529bea...cdf5f2fa9035891aa30965a0458ffc13e6c5983d,4,39,2,41,4,2011-06-06 22:34:16,2011-06-06 22:34:16
cdf5f2fa9035891aa30965a0458ffc13e6c5983d...4a8ba2ad1284a6a1624cf3ce19e1ae6cd09b82ed,2,16,1,17,2,2011-06-06 22:40:04,2011-06-06 22:40:04
4a8ba2ad1284a6a1624cf3ce19e1ae6cd09b82ed...e1daa4764c3f883471eaae02f5acb8b6b81836d2,6,70,2,72,9,2011-06-06 23:29:45,2011-06-06 23:29:45
e1daa4764c3f883471eaae02f5acb8b6b81836d2...8421fca43d1c7dafa379971f4117646f45f6ca6e,4,22,10,32,5,2011-06-06 23:38:41,2011-06-06 23:38:41
8421fca43d1c7dafa379971f4117646f45f6ca6e...ea8e8785a78310b4ab49ad65fb6ac874fc1c3e2c,5,25,10,35,7,2011-06-07 07:44:02,2011-06-07 07:44:02
ea8e8785a78310b4ab49ad65fb6ac874fc1c3e2c...943e2d5a882919eb3f4539ad942208fcc6a58909,5,55,3,58,7,2011-06-07 08:31:23,2011-06-07 08:31:23
943e2d5a882919eb3f4539ad942208fcc6a58909...dc792de2ef331e55936dbd071d63e2241ec16623,5,23,15,38,7,2011-06-07 08:45:56,2011-06-07 08:45:56
dc792de2ef331e55936dbd071d63e2241ec16623...aeb1212f2537ed13b15f6e3ad600716caa0c42b6,2,8,8,16,8,2011-06-07 16:32:55,2011-06-07 16:32:55
aeb1212f2537ed13b15f6e3ad600716caa0c42b6...69324a46d5af5b97d590b9bc93feacebfb241065,6,35,57,92,12,2011-06-07 16:46:25,2011-06-07 16:46:25
69324a46d5af5b97d590b9bc93feacebfb241065...0607c580be8a24655d1298333c02acba3a68c12e,7,69,98,167,14,2011-06-11 19:17:47,2011-06-11 19:17:47
c572c7071f369a2b685e7ec30ddffd31d6c06a87...3b2a08a77abef4eb53d681161a19ad8b82cd8628,1,5,5,10,2,2011-03-30 09:32:09,2011-03-30 09:32:09
c572c7071f369a2b685e7ec30ddffd31d6c06a87...99c2580971c8f869c6fd31ea38881d8ff249243d,2,11,10,21,5,2011-03-29 21:57:01,2011-03-29 21:57:01
213057576fbca844dbf52d2bfeba412a3ab85fe7...a0a42f54dc628e388a0b584f39c86dbb37d244d9,4,8,10,18,7,2011-04-07 21:59:36,2011-04-07 21:59:36
213057576fbca844dbf52d2bfeba412a3ab85fe7...28fbabf768caaf6d85243290f82991db37d58557,7,276,1,277,6,2011-04-06 18:47:55,2011-04-06 18:47:55
28fbabf768caaf6d85243290f82991db37d58557...c85195b14b77aeeade413b0a48e548d663ba2c9c,4,23,26,49,12,2011-04-06 19:16:12,2011-04-06 19:16:12
c85195b14b77aeeade413b0a48e548d663ba2c9c...8e71b12c22824788dbc580ab53d8989cf2cbaefb,3,17,9,26,9,2011-04-06 19:18:04,2011-04-06 19:18:04
8e71b12c22824788dbc580ab53d8989cf2cbaefb...b08ecad5ed71acfa9408ad82eae39f47779fd7a6,4,137,27,164,29,2011-04-06 19:49:15,2011-04-06 19:49:15
b08ecad5ed71acfa9408ad82eae39f47779fd7a6...edf75a3c3659ec064dc21ada0de36ee164bdf2cb,8,171,160,331,13,2011-04-07 16:54:03,2011-04-07 16:54:03
edf75a3c3659ec064dc21ada0de36ee164bdf2cb...344d7da26d8c5b08b36955649129d8de95cb8a7d,4,97,68,165,53,2011-04-07 17:39:35,2011-04-07 17:21:11
344d7da26d8c5b08b36955649129d8de95cb8a7d...73de44469b9648b8c242b2f5b8875beafd112349,4,63,27,90,14,2011-04-07 17:54:31,2011-04-07 17:54:00
73de44469b9648b8c242b2f5b8875beafd112349...0e54ee835dfcbaea26fd798bcd854f90caa96e11,1,0,16,16,1,2011-04-07 18:05:15,2011-04-07 18:05:15
0e54ee835dfcbaea26fd798bcd854f90caa96e11...28c54a822f9cc9233fccc62815d7cc6b193b4772,4,64,36,100,26,2011-04-07 18:32:48,2011-04-07 18:32:48
28c54a822f9cc9233fccc62815d7cc6b193b4772...f0f146715d1652dfa4bec96f131a2ad7c8464ba8,3,13,3,16,13,2011-04-07 18:39:43,2011-04-07 18:39:43
f0f146715d1652dfa4bec96f131a2ad7c8464ba8...34a055adc4c0d221522dc5a5f855cff2e777be19,4,24,30,54,18,2011-04-07 21:29:04,2011-04-07 21:29:04
34a055adc4c0d221522dc5a5f855cff2e777be19...34ffbbf1d02d52d0605c9cdd22c0e2ed87e7eeba,4,18,4,22,8,2011-04-07 21:36:25,2011-04-07 21:36:25
34ffbbf1d02d52d0605c9cdd22c0e2ed87e7eeba...7fba63734fbe0b40c54c3aff6bef163f039c846a,3,9,9,18,7,2011-04-07 21:38:50,2011-04-07 21:38:50
afbeb4cec16e22f58d9e3511033fb9dbfceba314...3f6e2e2983cf571b772afc89d6c52e558dc039bf,1,1,1,2,1,2011-06-11 19:38:50,2011-06-11 19:38:50
06b0b25de03fa701de7c3b4bcd19c5eca0ab381e...bfa1a6e48fb68d573b8f7f2b9884d785871df398,7,328,109,437,23,2011-06-07 05:38:08,2011-06-07 05:38:08
bfa1a6e48fb68d573b8f7f2b9884d785871df398...96837e4d0dfcd4d338b66fdfc65bc91c5090ba97,1,5,3,8,3,2011-06-07 05:50:10,2011-06-07 05:50:10
06b0b25de03fa701de7c3b4bcd19c5eca0ab381e...b0d8d439a95b5912c57c3d8fa21cc834976843b5,1,35,16,51,9,2011-06-07 04:59:18,2011-06-07 04:59:18
b938171e7a57bdeecd9bd58515df7d149ce3318c...b49c878e1ce5333571eacaa243b922e774f07d46,1,0,18,18,1,2011-03-30 16:07:08,2011-03-30 16:07:08
b49c878e1ce5333571eacaa243b922e774f07d46...29efd2a6d5e27cfaa63ed559ec4986af53aaa80a,8,85,57,142,16,2011-03-30 16:18:14,2011-03-30 16:18:14
29efd2a6d5e27cfaa63ed559ec4986af53aaa80a...b6ec18374ba0220b6d9b06e67429cc8fbaeaaeb0,1,7,6,13,5,2011-04-01 19:08:37,2011-04-01 19:08:37
57f2ecf2c1dfc31e84aaf5f14d1304961266c4b2...05f58d3a089afe521d017187f6f4cad9c816ff8f,1,1,0,1,1,2011-04-09 19:03:52,2011-04-09 19:03:52
05f58d3a089afe521d017187f6f4cad9c816ff8f...0f8c8007a655315f459cf2e72a9aac163f16b00a,3,32,0,32,3,2011-04-09 19:05:55,2011-04-09 19:05:55
0f8c8007a655315f459cf2e72a9aac163f16b00a...3e1e4f1e7ccbc70a6da87cd1ac988c628d399f90,3,32,0,32,3,2011-04-09 19:08:22,2011-04-09 19:08:14
3e1e4f1e7ccbc70a6da87cd1ac988c628d399f90...40be541c4cc27b18d82688c86dea55c205384f80,6,68,205,273,8,2011-04-09 19:38:48,2011-04-09 19:38:48
40be541c4cc27b18d82688c86dea55c205384f80...d9d85f0e0347d56180e2abe8b4584f2e4637a650,1,2,2,4,2,2011-04-09 20:00:38,2011-04-09 20:00:38
8305844af595dc59e3a1b9be93708d29699dd84d...1b1a9485cb8204c0dc3eb5576479884271832136,6,365,275,640,34,2011-04-07 23:57:33,2011-04-07 23:57:33
7fba63734fbe0b40c54c3aff6bef163f039c846a...f4341fd678dbd3492a5d88bc95353c79c6b89d58,3,41,23,64,27,2011-04-07 22:14:15,2011-04-07 22:14:15
4964bb6362b875a7175dc289a66d93857a62e5dc...acdc72799e01cbe3b07cacb2828f2db31e19b8c8,1,4,3,7,3,2011-06-11 20:00:28,2011-06-11 20:00:28
852ac949d210159d24a3dcb4465a8557659e8d22...920d980b3bb7f4b333bf8945aa9ee1043e99b654,6,105,193,298,10,2011-06-11 19:54:44,2011-06-11 19:54:44
d9d85f0e0347d56180e2abe8b4584f2e4637a650...c687cc1672eee5ba740ea24c2baef6c397d79daf,1,0,2,2,1,2011-04-09 21:09:09,2011-04-09 21:09:09
d9d85f0e0347d56180e2abe8b4584f2e4637a650...bf180dc9afa60c945d8410002eab60dac2c4493a,7,10,8,18,7,2011-04-09 20:56:28,2011-04-09 20:46:25
4aeb42ba433d6c7a4cc5054b2a2daed72c087385...6aba18bc618080f385fd2a1a80bd1e32281dab29,4,87,34,121,41,2011-04-08 09:54:12,2011-04-08 09:53:48
6aba18bc618080f385fd2a1a80bd1e32281dab29...202205fa5e3beea9aaf5a692dcf488f4c9b48c42,3,5,5,10,5,2011-04-08 09:56:41,2011-04-08 09:56:41
202205fa5e3beea9aaf5a692dcf488f4c9b48c42...21c7ec3c26bbba164f1e98dfb3cd8ba3008eb27a,4,125,29,154,26,2011-04-08 10:24:51,2011-04-08 10:24:51
21c7ec3c26bbba164f1e98dfb3cd8ba3008eb27a...486dabaaf9193a2e141a744c34e17d976f2f6ed9,1,3,0,3,3,2011-04-08 10:29:33,2011-04-08 10:29:33
486dabaaf9193a2e141a744c34e17d976f2f6ed9...5f9148d3dbbd50797e8c985b5f0b2201dd222fd8,2,15,12,27,13,2011-04-08 17:17:35,2011-04-08 17:17:35
5f9148d3dbbd50797e8c985b5f0b2201dd222fd8...0f82a4d0470b17079911ae95f7ce4f298525c570,1,7,10,17,3,2011-04-08 17:25:08,2011-04-08 17:25:08
0f82a4d0470b17079911ae95f7ce4f298525c570...598f47e1c9728ca4ced58272430092d6b7ea4a10,4,49,79,128,20,2011-04-08 17:37:59,2011-04-08 17:37:59
598f47e1c9728ca4ced58272430092d6b7ea4a10...c7835ba4c84f0058ee7d2749cd73bd395b4808c5,3,61,71,132,41,2011-04-08 18:12:18,2011-04-08 18:12:18
c7835ba4c84f0058ee7d2749cd73bd395b4808c5...3e63dead40f22ab76ab50a094c648db6cb064eac,3,9,9,18,7,2011-04-08 18:15:55,2011-04-08 18:15:55
3e63dead40f22ab76ab50a094c648db6cb064eac...e1399b1182d17935a80b4d6201b3c6381ea0e2a6,3,3,3,6,3,2011-04-08 18:17:09,2011-04-08 18:17:09
acdc72799e01cbe3b07cacb2828f2db31e19b8c8...54031e1363534784fb6b07c20b2c2f773104cbc4,1,119,0,119,1,2011-06-11 23:59:42,2011-06-11 23:59:42
54031e1363534784fb6b07c20b2c2f773104cbc4...9bf55832ea1cc51c81f88f51821ff2e15441f24b,1,4,3,7,4,2011-06-12 00:15:35,2011-06-12 00:15:35
9bf55832ea1cc51c81f88f51821ff2e15441f24b...1dfcda48884498d5f0103e6eb91302d9a187067d,6,10,10,20,8,2011-06-12 01:11:15,2011-06-12 01:11:15
acdc72799e01cbe3b07cacb2828f2db31e19b8c8...f5c1d54b5741029d1fff3f218da6fd78040fff46,3,12,8,20,11,2011-06-11 22:56:18,2011-06-11 22:56:18
a262ba78a4eb075a95ac7528faa0a9968f24878d...a5055b47554e425f32767a0f8665139646a27d33,11,78,4,82,17,2011-04-10 21:42:25,2011-04-10 21:42:25
a5055b47554e425f32767a0f8665139646a27d33...26030821a9842201c5f3139b245f6b2db060a1ec,3,6,18,24,3,2011-04-10 23:16:13,2011-04-10 23:16:13
a262ba78a4eb075a95ac7528faa0a9968f24878d...f208a5be09b1d52d434e07f8db30687922d758fb,9,856,1,857,9,2011-04-10 15:20:51,2011-04-10 09:46:13
f208a5be09b1d52d434e07f8db30687922d758fb...824e176a84f1ce986cff94b9b12809049c9b4738,1,1,2,3,2,2011-04-10 15:25:04,2011-04-10 15:25:04
824e176a84f1ce986cff94b9b12809049c9b4738...dfd0ad354dbdae201a1c5fa775c73581774e7e94,1,30,16,46,4,2011-04-10 17:45:51,2011-04-10 17:45:51
dfd0ad354dbdae201a1c5fa775c73581774e7e94...0c88813f56b944622cb90c1993dc6d6e5731579f,4,211,279,490,56,2011-04-10 19:07:17,2011-04-10 19:07:17
0c88813f56b944622cb90c1993dc6d6e5731579f...3571cc3845fc871ecc67415bf23888526eee093d,3,45,45,90,11,2011-04-10 19:16:26,2011-04-10 19:16:26
3571cc3845fc871ecc67415bf23888526eee093d...ca3c272d98c450549312abf17ec4b1da9b73f3ee,3,127,129,256,49,2011-04-10 19:36:58,2011-04-10 19:36:58
ca3c272d98c450549312abf17ec4b1da9b73f3ee...111e8e53e65a5f62be31bbc98b629d0401f653db,3,55,59,114,25,2011-04-10 19:47:32,2011-04-10 19:47:32
111e8e53e65a5f62be31bbc98b629d0401f653db...6e901439fd9080c0bf29ee3552d2b1ca592e073e,3,107,111,218,49,2011-04-10 20:04:21,2011-04-10 20:04:21
6e901439fd9080c0bf29ee3552d2b1ca592e073e...ed1042f395e1e65979463fcbf5951e8257da5272,3,19,19,38,9,2011-04-10 20:15:15,2011-04-10 20:15:15
ed1042f395e1e65979463fcbf5951e8257da5272...7151746fbec639af35039ab151257b4687659102,4,73,1,74,4,2011-04-10 20:29:32,2011-04-10 20:29:32
7151746fbec639af35039ab151257b4687659102...2c030290457a4eac0efe34b1c7a61a29997ac3ef,4,77,23,100,11,2011-04-10 20:56:34,2011-04-10 20:56:34
2c030290457a4eac0efe34b1c7a61a29997ac3ef...f6975bb739c74bcd02441bfeb0bdeac11a29a2b0,3,37,35,72,29,2011-04-11 01:28:59,2011-04-11 01:28:59
f6975bb739c74bcd02441bfeb0bdeac11a29a2b0...597443b3b0b723943e70dd3fb3e326aa253b582c,3,8,8,16,8,2011-04-11 01:37:23,2011-04-11 01:37:23
e1399b1182d17935a80b4d6201b3c6381ea0e2a6...33260423a34e9938f397181a61f24a1215fb2ff2,6,178,190,368,73,2011-04-08 21:40:29,2011-04-08 21:40:29
33260423a34e9938f397181a61f24a1215fb2ff2...bb5a6d06ccc3f13abc10bd7e15ab23f6ee3587a5,3,12,12,24,9,2011-04-08 22:33:01,2011-04-08 22:33:01
bb5a6d06ccc3f13abc10bd7e15ab23f6ee3587a5...5e42387a0585e9ec3cd0faa9004f8cec070d6919,3,15,9,24,11,2011-04-08 22:35:26,2011-04-08 22:35:26
e1399b1182d17935a80b4d6201b3c6381ea0e2a6...ccdbccf5634e65a50928072a9b569419e4482926,1,9,4,13,2,2011-04-08 19:08:33,2011-04-08 19:08:33
1dfcda48884498d5f0103e6eb91302d9a187067d...24431337d77712c672c9b2d4738c319678f61df4,1,68,0,68,1,2011-06-12 20:11:48,2011-06-12 20:11:48
1dfcda48884498d5f0103e6eb91302d9a187067d...3d3ac3b14785b5e544867c765c684f0e001c8812,8,574,0,574,9,2011-06-12 19:09:15,2011-06-11 11:49:21
915be32ef7117c688652609eb7e6de6e32d7b024...ca3585ec977f2852173943fe594792a68a3d198a,4,5,3,8,5,2011-04-11 01:59:41,2011-04-11 01:56:16
ca3585ec977f2852173943fe594792a68a3d198a...9f71e4e211dd29cdd77212ba05004a28fcbc152c,7,22,25,47,18,2011-04-11 06:26:35,2011-04-11 06:26:35
2548d4fa32a10eda21855f6532216a45a0cecf63...c7c9e7fad476a92ccf4d4eda351b466e413a6936,9,33,22,55,19,2011-04-12 02:09:19,2011-04-12 02:09:19
c7c9e7fad476a92ccf4d4eda351b466e413a6936...24de130f4e1df2e04a6e751a4b586e1bf66af927,1,2,0,2,1,2011-04-12 02:10:27,2011-04-12 02:10:27
24de130f4e1df2e04a6e751a4b586e1bf66af927...98899158307ee77d57204c0f79293e5bc7881cc0,1,1,1,2,1,2011-04-12 02:11:44,2011-04-12 02:11:44
98899158307ee77d57204c0f79293e5bc7881cc0...7f31d333ad6f87266ef6b2427e2091ee4b70c4d8,3,17,17,34,9,2011-04-14 06:44:25,2011-04-14 06:44:25
7f31d333ad6f87266ef6b2427e2091ee4b70c4d8...2c80b091225340ebb080490fa94293a3f1186bb9,1,0,1,1,1,2011-04-14 06:45:54,2011-04-14 06:45:54
5e42387a0585e9ec3cd0faa9004f8cec070d6919...4fda3a3ebfd0dd8e7113dab60e905bd61c715e53,1,20,17,37,10,2011-04-08 22:46:14,2011-04-08 22:46:14
563b6d1cc388611f90d5ecbec58ef464e5905298...69dc5efceb3e0910f03850772fa5c05c9983c9fc,1,1,1,2,1,2011-06-13 22:54:45,2011-06-13 22:54:24
69dc5efceb3e0910f03850772fa5c05c9983c9fc...4f16bbd9e7ed1192ad914fab0f1efa14a197ce73,8,8,8,16,8,2011-06-14 00:30:30,2011-06-14 00:30:30
4f16bbd9e7ed1192ad914fab0f1efa14a197ce73...db0de498380ca08a8bc208c9f6a53f988644fa76,3,13,13,26,7,2011-06-14 00:34:51,2011-06-14 00:32:49
db0de498380ca08a8bc208c9f6a53f988644fa76...1cbda3067d6c11a05f08fcd4afa46ecfcfcba528,3,5,5,10,3,2011-06-14 00:35:08,2011-06-14 00:34:20
3d3ac3b14785b5e544867c765c684f0e001c8812...fe9ed1bd1d74d516b0164c89bc897676632f2b92,3,14,27,41,12,2011-06-12 19:59:02,2011-06-12 19:59:02
3d3ac3b14785b5e544867c765c684f0e001c8812...a8bc56d9145334c06b619c71fabc839aa930e890,4,43,43,86,25,2011-06-12 19:42:36,2011-06-12 19:41:21
f55d002f03cb70d9627b2c6490b5fd30cb0f8d87...34202d4f44e994a1af33f07837d62e172d05151f,2,2516,0,2516,2,2011-08-19 21:02:47,2011-08-19 21:02:47
34202d4f44e994a1af33f07837d62e172d05151f...4eedce984cfe410ea96d167722fe478be950516e,6,254,1,255,6,2011-08-19 21:26:39,2011-08-19 21:26:39
4eedce984cfe410ea96d167722fe478be950516e...7184c57fbb2e4368859dc63b1b8bf1d760278a66,5,82,4,86,7,2011-08-19 21:44:23,2011-08-19 21:44:23
7184c57fbb2e4368859dc63b1b8bf1d760278a66...83278300fdde9613246f9b6e62ab8398a9ed7c16,5,18,5,23,6,2011-08-19 21:45:56,2011-08-19 21:45:56
83278300fdde9613246f9b6e62ab8398a9ed7c16...05483196639d99524646a0b2dacbbf343d2c9b03,5,259,61,320,27,2011-08-19 22:22:46,2011-08-19 22:22:46
05483196639d99524646a0b2dacbbf343d2c9b03...18b9e11414e71e54b2bfa3355c0e7e078922a383,41,1548,1660,3208,161,2011-08-20 23:27:25,2011-08-20 23:27:25
18b9e11414e71e54b2bfa3355c0e7e078922a383...3b04b4f5ee2373147fcd02fbe88036125a38d022,1,32,32,64,1,2011-08-21 00:04:04,2011-08-21 00:04:04
3b04b4f5ee2373147fcd02fbe88036125a38d022...4b25f0a62b8028690a9b28f99ab9a2b32bb8bce6,3,8,14,22,3,2011-08-21 00:04:50,2011-08-21 00:04:50
4b25f0a62b8028690a9b28f99ab9a2b32bb8bce6...af418fb5a4871c6de971868f4d730f11dbe5ee4b,8,248,39,287,18,2011-08-21 06:50:34,2011-08-21 06:50:34
af418fb5a4871c6de971868f4d730f11dbe5ee4b...5764e49992131dae7f572a5dcacd1e5110deb63b,3,101,2,103,4,2011-08-21 22:01:31,2011-08-21 22:01:31
5764e49992131dae7f572a5dcacd1e5110deb63b...aeae92ca5c3ead614f23e952d454292f14988b37,2,31,1,32,2,2011-08-21 22:19:09,2011-08-21 22:19:09
aeae92ca5c3ead614f23e952d454292f14988b37...8cc290a00a12d742ed208ad8b8e3f8025d248b96,2,35,2,37,3,2011-08-21 22:21:57,2011-08-21 22:21:57
8cc290a00a12d742ed208ad8b8e3f8025d248b96...51c7e58fdb12f45ee4aef8bda013d5d2d29725d8,7,61,13,74,13,2011-08-21 22:54:17,2011-08-21 22:54:17
51c7e58fdb12f45ee4aef8bda013d5d2d29725d8...e2b112bc81f0f7d16d22c2e5ca1dd5e726657d45,4,154,10,164,10,2011-08-22 00:16:57,2011-08-22 00:16:57
e2b112bc81f0f7d16d22c2e5ca1dd5e726657d45...80fa16a35114620956ddb902f4294f8f36e136db,2,57,1,58,2,2011-08-22 00:28:32,2011-08-22 00:28:32
80fa16a35114620956ddb902f4294f8f36e136db...f577542effb586f670f171a9b34d6026724838f0,2,49,1,50,2,2011-08-22 00:36:24,2011-08-22 00:36:24
f577542effb586f670f171a9b34d6026724838f0...3f22d76fb32937a3625bd093a6f73a945e0fa0a4,3,32,10,42,11,2011-08-22 00:43:37,2011-08-22 00:43:37
3f22d76fb32937a3625bd093a6f73a945e0fa0a4...1704957cb03c929ba1e4df00177d42fa3cde2a7c,2,73,2,75,2,2011-08-22 00:50:22,2011-08-22 00:50:22
1704957cb03c929ba1e4df00177d42fa3cde2a7c...553bd4e36b48151b05e524fa8eb29c21f3f9e32e,11,57,25,82,21,2011-08-22 03:34:22,2011-08-22 03:34:22
553bd4e36b48151b05e524fa8eb29c21f3f9e32e...21f605bae5a572b8f455ecb173b017139f59b7ee,4,407,353,760,55,2011-08-22 04:07:29,2011-08-22 04:07:29
21f605bae5a572b8f455ecb173b017139f59b7ee...2f1472b67d7b7a4b2350da7d8ba833b479ec0451,37,211,257,468,123,2011-08-22 18:26:40,2011-08-22 18:26:40
2f1472b67d7b7a4b2350da7d8ba833b479ec0451...eecd123ecc7dc1365a3342077558694711101fbf,2,2,2,4,2,2011-08-22 18:33:13,2011-08-22 18:33:13
9f71e4e211dd29cdd77212ba05004a28fcbc152c...2e8cd200df552ac6182889deded7f780007e7403,9,386,1,387,9,2011-04-13 18:57:57,2011-04-13 17:53:52
2e8cd200df552ac6182889deded7f780007e7403...5719f192231dac7c095b2600f538a02cafdedae3,3,29,5,34,13,2011-04-13 19:14:29,2011-04-13 19:13:58
5719f192231dac7c095b2600f538a02cafdedae3...b6b39af26740b219bd3c30e0e325f3537ebf4f30,6,28,28,56,27,2011-04-13 19:34:13,2011-04-13 19:34:13
b6b39af26740b219bd3c30e0e325f3537ebf4f30...8fc521cb028ffaec6b1a0fd2af9df4105d169511,3,5,5,10,5,2011-04-13 19:35:33,2011-04-13 19:35:33
8fc521cb028ffaec6b1a0fd2af9df4105d169511...9518fec14a2d00363af78b974472f5b18661e4bd,3,11,21,32,9,2011-04-13 19:39:12,2011-04-13 19:39:12
9518fec14a2d00363af78b974472f5b18661e4bd...755529dba8973d6fbee5b56be10c68060cebd169,4,100,26,126,20,2011-04-13 20:23:49,2011-04-13 20:09:31
755529dba8973d6fbee5b56be10c68060cebd169...9721e6f045a2b9b041efad587f861ce4f4c60d37,4,69,9,78,16,2011-04-13 20:59:37,2011-04-13 20:59:37
9721e6f045a2b9b041efad587f861ce4f4c60d37...b693e0514e3684d0a0d105b6e2f545df2dfc83cb,3,41,13,54,15,2011-04-13 21:21:29,2011-04-13 21:21:29
b693e0514e3684d0a0d105b6e2f545df2dfc83cb...d288e6901637417d9c743b426ce688f52a29a8a8,5,17,34,51,18,2011-04-13 21:27:25,2011-04-13 21:27:25
d288e6901637417d9c743b426ce688f52a29a8a8...54756f4d32e55b9618b151a7e07de1a82c9b034c,3,3,3,6,3,2011-04-13 21:29:44,2011-04-13 21:29:44
54756f4d32e55b9618b151a7e07de1a82c9b034c...0b8aa07ed20ca262be71e993ca9188d714df17f8,9,49,49,98,47,2011-04-13 21:31:53,2011-04-13 21:31:53
0b8aa07ed20ca262be71e993ca9188d714df17f8...88eabf19697a86cbf257ad51ae9b3ca563ea7e25,3,10,10,20,7,2011-04-13 21:33:15,2011-04-13 21:33:15
88eabf19697a86cbf257ad51ae9b3ca563ea7e25...6c8cef1eefe8ca1beb4d34c7672acf3e38ba6cf8,4,120,9,129,6,2011-04-13 22:12:18,2011-04-13 22:12:18
6c8cef1eefe8ca1beb4d34c7672acf3e38ba6cf8...3477764db0f074437bee27132d23d367deb4c6ef,1,4,5,9,3,2011-04-13 22:16:10,2011-04-13 22:16:10
3477764db0f074437bee27132d23d367deb4c6ef...a7b3c3265c1fa82550944e7f631abe313aa04b6e,1,0,4,4,1,2011-04-13 22:20:16,2011-04-13 22:20:16
a7b3c3265c1fa82550944e7f631abe313aa04b6e...e7d359ea6ceda8ed49e582407129d69c6dfaac78,3,3,5,8,3,2011-04-13 22:27:25,2011-04-13 22:27:25
e7d359ea6ceda8ed49e582407129d69c6dfaac78...f9569c5aac95d5807f1638748e95d4383a6d6d4b,1,3,3,6,1,2011-04-13 22:27:52,2011-04-13 22:27:52
f9569c5aac95d5807f1638748e95d4383a6d6d4b...12663738d970e6c6f9e5dbd34ad63649c1fa3689,4,15,5,20,6,2011-04-13 22:40:00,2011-04-13 22:40:00
12663738d970e6c6f9e5dbd34ad63649c1fa3689...dd5b21a3638b4058c647ecd843a343781b77b261,3,8,4,12,5,2011-04-14 00:16:51,2011-04-14 00:16:51
dd5b21a3638b4058c647ecd843a343781b77b261...c29d4dc1a7b47614fc3b65ef091cc2d1ac395b2e,6,249,121,370,85,2011-04-14 00:44:20,2011-04-14 00:31:16
c29d4dc1a7b47614fc3b65ef091cc2d1ac395b2e...55ee1b8f873e922dc66c57aa7012cedd928bf014,3,115,0,115,3,2011-04-14 01:19:31,2011-04-14 01:12:16
55ee1b8f873e922dc66c57aa7012cedd928bf014...222629a7a774ce15f3c8326e052caa0a6b074ad0,7,47,37,84,24,2011-04-14 01:50:26,2011-04-14 01:50:26
222629a7a774ce15f3c8326e052caa0a6b074ad0...4356e4fb21538d982ff5eba750021207ffd3e53d,3,7,7,14,7,2011-04-14 06:28:04,2011-04-14 06:28:04
9f71e4e211dd29cdd77212ba05004a28fcbc152c...6ebe9e577967b8eea573a719e9130a37a5027d5a,12,678,2,680,12,2011-04-11 10:19:59,2011-04-11 09:50:34
6ebe9e577967b8eea573a719e9130a37a5027d5a...5ef525385a47c78b67e660ee0c4278b7f062d330,1,1,0,1,1,2011-04-11 10:25:19,2011-04-11 10:25:19
5ef525385a47c78b67e660ee0c4278b7f062d330...0ca148d37e888c712f53fa482f2faa959aec7764,2,16,5,21,3,2011-04-11 20:22:24,2011-04-11 20:22:24
0ca148d37e888c712f53fa482f2faa959aec7764...776f332af6644bbff1437824ad24035bbf4e09a7,2,17,6,23,4,2011-04-11 20:52:21,2011-04-11 20:52:21
776f332af6644bbff1437824ad24035bbf4e09a7...60b6a3d2e5c196d3fa09229f32bf3f5c72046583,7,157,207,364,52,2011-04-14 05:04:11,2011-04-14 05:04:11
60b6a3d2e5c196d3fa09229f32bf3f5c72046583...8d7bd910807e47fabf38d02ce2c8d940903abe3a,8,35,69,104,19,2011-04-14 05:41:30,2011-04-14 05:41:30
8d7bd910807e47fabf38d02ce2c8d940903abe3a...126e625d21ee7b6e67a7036b0be952a395871482,11,106,71,177,21,2011-04-14 06:13:06,2011-04-14 06:13:06
9f71e4e211dd29cdd77212ba05004a28fcbc152c...ccfbb06729f80b8d490183b83e5f92d60138f113,9,797,1,798,9,2011-04-11 09:01:11,2011-04-11 08:54:33
ccfbb06729f80b8d490183b83e5f92d60138f113...c5c6614d9eea6d7255e4bc20c26fcc47e5a64b96,4,203,242,445,85,2011-04-11 19:44:17,2011-04-11 19:44:17
c5c6614d9eea6d7255e4bc20c26fcc47e5a64b96...c7109df799e1bec465a4af3fc34d7b6cec879fc8,2,10,10,20,2,2011-04-11 19:55:27,2011-04-11 19:55:27
4fda3a3ebfd0dd8e7113dab60e905bd61c715e53...17259b94ff0773315659d4bbe9d74559e3145d0e,2,79,24,103,6,2011-04-08 23:03:01,2011-04-08 23:03:01
e2119b8ccf092455e728fbfa19385dfeaeea4032...0752a014afab5df9dc652e24c31cb47f617b25c9,5,41,10,51,7,2011-06-17 13:42:23,2011-06-17 13:42:23
e2119b8ccf092455e728fbfa19385dfeaeea4032...b7e20a43104e83f8c4a5e0ce8ef38890286962c7,1,9,2,11,4,2011-06-15 22:20:14,2011-06-15 22:20:14
e2119b8ccf092455e728fbfa19385dfeaeea4032...f90554f41e930514bacc5966cad3e346032d1425,6,88,2,90,7,2011-06-15 16:44:58,2011-06-15 16:44:58
f90554f41e930514bacc5966cad3e346032d1425...8e2d4ba59934cc580a2f3f8d094863086e3b0c37,4,34,34,68,12,2011-06-15 16:47:54,2011-06-15 16:47:54
e2119b8ccf092455e728fbfa19385dfeaeea4032...068e66de3112bb9ef73e4b79de161be2e827b38d,9,187,11,198,21,2011-06-15 07:16:46,2011-06-15 07:16:46
068e66de3112bb9ef73e4b79de161be2e827b38d...54805a6bc09e7ef74ad7e9da52e7f468aab71e72,3,145,0,145,3,2011-06-15 17:48:20,2011-06-15 17:48:20
54805a6bc09e7ef74ad7e9da52e7f468aab71e72...bbbf287daa0bf02e639c1801345d800b7926aaa4,5,73,64,137,5,2011-06-15 17:50:46,2011-06-15 17:50:46
bbbf287daa0bf02e639c1801345d800b7926aaa4...ba6fc569978412e874e8f2013270e5bcb18a0896,5,28,0,28,6,2011-06-15 17:59:15,2011-06-15 17:59:15
02700719844a7a2769b1fec85256229da0ed7f81...cac32ebc58be23913809827f63e7c96ea59be365,8,237,476,713,10,2011-06-12 20:40:58,2011-06-12 20:16:55
9dc97e87fe3c67973583684b6a266e29f706f7ef...15f1bee993fc7feafdca73fd0d97ac039b4c7059,4,67,22,89,22,2011-08-22 23:35:23,2011-08-22 23:35:23
15f1bee993fc7feafdca73fd0d97ac039b4c7059...770b24c742ceaa25042895ba312c3d69b1f6437a,4,109,7,116,8,2011-08-23 00:28:45,2011-08-23 00:28:45
770b24c742ceaa25042895ba312c3d69b1f6437a...a0fa7a00e5f949adbeb8c2790ae2fbb330ad617f,4,12,6,18,6,2011-08-23 01:05:41,2011-08-23 01:05:41
a0fa7a00e5f949adbeb8c2790ae2fbb330ad617f...a4500fcfb112a011a59c123b000508cb326b453a,4,35,15,50,12,2011-08-23 01:50:14,2011-08-23 01:50:14
a4500fcfb112a011a59c123b000508cb326b453a...8df955283f196fb68869c8b0b1fcf973ad09ec19,5,225,102,327,24,2011-08-23 05:53:51,2011-08-23 05:53:51
8df955283f196fb68869c8b0b1fcf973ad09ec19...d8557e0efe18c887612c61667b749d27625a8bea,4,6,6,12,6,2011-08-23 06:01:53,2011-08-23 06:01:53
d8557e0efe18c887612c61667b749d27625a8bea...5eeff4f0fd844c9347cfeb1f2d4d078a9bfac3cd,1,9,0,9,3,2011-08-23 15:38:18,2011-08-23 15:38:18
5eeff4f0fd844c9347cfeb1f2d4d078a9bfac3cd...5126024ad37a1703059220c2d6f9cc063a3a3641,5,177,45,222,40,2011-08-23 17:45:04,2011-08-23 17:37:38
5126024ad37a1703059220c2d6f9cc063a3a3641...ce947ecf7653791bc9fb0471b516728a426bce2c,4,65,41,106,22,2011-08-23 18:07:18,2011-08-23 18:07:18
ce947ecf7653791bc9fb0471b516728a426bce2c...95805adc9bca297fdc202aa7e0a2af07fef232e3,9,202,215,417,24,2011-08-23 19:02:12,2011-08-23 19:02:12
47f9ced9aa6fe1631be8c1d2d4a1130432c582a1...d4e571eb88ac098d1d69d2b8af05f52678aa79d2,3,3,858,861,6,2011-04-14 06:58:46,2011-04-14 06:58:46
d4e571eb88ac098d1d69d2b8af05f52678aa79d2...de3d1c1a6c8588cb86f832d680306eb2481b288f,1,0,50,50,1,2011-04-14 06:59:15,2011-04-14 06:59:15
17259b94ff0773315659d4bbe9d74559e3145d0e...448b72622ca39e79ebeb45136b314f986b86546e,1,4,4,8,4,2011-04-08 23:36:16,2011-04-08 23:36:16
b5465489e7efbd880db2ed80b23d292671488e8c...906e7eefc386f7fcf139569b3514e63692b31c45,5,99,39,138,32,2011-06-24 03:03:27,2011-06-24 03:03:27
68424aeff4fd0436033d66b6cff17c913ff56e41...886c4db94dc99425f96431e37fbf9f889687bfe3,3,4,12,16,5,2011-06-24 02:52:09,2011-06-12 06:10:42
68424aeff4fd0436033d66b6cff17c913ff56e41...c159980f7d9c82a6c42f179e159ad12d9f8a6f49,8,66,18,84,17,2011-06-17 20:18:40,2011-06-17 20:18:40
c159980f7d9c82a6c42f179e159ad12d9f8a6f49...209a020114b9a7e343c395dc7bd5fdb69667e411,2,28,0,28,2,2011-06-18 10:19:06,2011-06-18 10:19:06
209a020114b9a7e343c395dc7bd5fdb69667e411...2eba0320407442e85be97b2cd84398fb6c626fe3,9,139,119,258,42,2011-06-24 02:45:23,2011-06-24 02:45:23
68424aeff4fd0436033d66b6cff17c913ff56e41...a386da4e6c832f23b368cb8bc93ba49d67233424,8,508,1,509,8,2011-06-17 17:34:49,2011-06-17 15:59:34
a386da4e6c832f23b368cb8bc93ba49d67233424...b17d4e11331ba5390ddc656b5067d2c5b420d9de,3,2,11,13,5,2011-06-17 17:39:56,2011-06-17 17:39:56
b17d4e11331ba5390ddc656b5067d2c5b420d9de...65a237052675b3063c7b8ec15a05a38ec179ef0a,7,168,33,201,15,2011-06-22 08:11:23,2011-06-22 08:11:23
65a237052675b3063c7b8ec15a05a38ec179ef0a...0aba0702a55e15e7c510725895f669fa978aaab7,11,164,189,353,57,2011-06-22 16:46:52,2011-06-22 16:46:52
0aba0702a55e15e7c510725895f669fa978aaab7...5f41452ed2c2dbd205f40a528ebc51cc02fcce87,2,10,4,14,6,2011-06-22 17:25:57,2011-06-22 17:25:57
5f41452ed2c2dbd205f40a528ebc51cc02fcce87...c5450fa62aecf68421dfb1e0df833d5c17dd6d3f,1,23,2,25,3,2011-06-22 17:56:58,2011-06-22 17:56:58
c5450fa62aecf68421dfb1e0df833d5c17dd6d3f...4efd99f6bee5c0396c9a74f4fed9a31ad94c527f,1,2,23,25,3,2011-06-22 18:54:43,2011-06-22 18:45:40
4efd99f6bee5c0396c9a74f4fed9a31ad94c527f...9915e30d9cc02aad218ac4f47d25681d49530b7d,1,15,5,20,4,2011-06-22 19:03:49,2011-06-22 19:01:23
9915e30d9cc02aad218ac4f47d25681d49530b7d...e60ac77e25fab847ecc532546c911a12a2df644f,5,94,11,105,6,2011-06-22 20:17:18,2011-06-22 20:17:18
e60ac77e25fab847ecc532546c911a12a2df644f...96a565e3142eb7b0b07f2f4c01500798f5b7d0fe,6,51,12,63,6,2011-06-22 21:33:34,2011-06-22 21:33:34
96a565e3142eb7b0b07f2f4c01500798f5b7d0fe...2069d26e1aa9882c335286f1036fa48a8c6438a0,1,4,14,18,4,2011-06-22 23:42:14,2011-06-22 23:42:14
2069d26e1aa9882c335286f1036fa48a8c6438a0...641ccf18c3c8df53bc0b714db6b36e5a32462cb1,2,1,1,2,1,2011-06-22 23:49:01,2011-06-22 23:49:01
641ccf18c3c8df53bc0b714db6b36e5a32462cb1...a934fd0511ac9015b403ee6b3100e442fd010111,6,57,72,129,5,2011-06-23 00:09:31,2011-06-23 00:09:31
a934fd0511ac9015b403ee6b3100e442fd010111...b7fde1118c17ff473474fc05993c05f3c4b55b95,1,7,7,14,4,2011-06-23 17:40:39,2011-06-23 17:40:39
b7fde1118c17ff473474fc05993c05f3c4b55b95...cb3ffebc896eb316a6332ecdc2a6b8c71caf2a8d,7,56,70,126,22,2011-06-23 18:28:55,2011-06-23 18:28:55
de3d1c1a6c8588cb86f832d680306eb2481b288f...f028aa00d94d7bbe76274e74c8ce29f7e87a4716,4,79,0,79,4,2011-04-14 21:20:07,2011-04-14 21:20:07
f028aa00d94d7bbe76274e74c8ce29f7e87a4716...43e2ccca4141adfc8ca64764dcaa1a44e2b0958f,1,4,3,7,3,2011-04-14 23:53:33,2011-04-14 23:51:53
de3d1c1a6c8588cb86f832d680306eb2481b288f...1a800798659790639c8538da0d2677c6a5f5ade7,20,71,71,142,64,2011-04-14 08:41:19,2011-04-14 08:41:19
1a800798659790639c8538da0d2677c6a5f5ade7...df01727c63c36afb4ac8962de1dc87b59e59e8de,5,11,11,22,10,2011-04-14 22:23:53,2011-04-14 22:23:53
df01727c63c36afb4ac8962de1dc87b59e59e8de...87066fa1ab893751e2842ab89d4b41c7bcc1fd6d,2,2,2,4,2,2011-05-01 22:31:01,2011-05-01 22:31:01
87066fa1ab893751e2842ab89d4b41c7bcc1fd6d...6827da7ec92039bc9f3a8289493a6d70256650c8,11,82,80,162,72,2011-05-01 22:31:25,2011-05-01 22:31:25
a2ca0f704edef0e0692655403564dc7518c70e01...e8b345d0f88c219839d681e8ac0628ab1d1995c5,2,8,7,15,4,2011-04-08 23:42:43,2011-04-08 23:42:43
e8b345d0f88c219839d681e8ac0628ab1d1995c5...ef7b5ccb3c94683c9bbdec88636f41bf5a220807,4,51,27,78,19,2011-04-09 15:41:26,2011-04-09 15:41:26
ef7b5ccb3c94683c9bbdec88636f41bf5a220807...a8d4f77fe91f4d66f6b7f0e23df6a9a44920b3b6,3,18,36,54,23,2011-04-09 17:35:04,2011-04-09 17:35:04
a8d4f77fe91f4d66f6b7f0e23df6a9a44920b3b6...acb5fbe9cc93f643dbb50863067df1ed37313135,3,275,331,606,13,2011-04-09 17:43:09,2011-04-09 17:43:09
acb5fbe9cc93f643dbb50863067df1ed37313135...dab913575c2c1d26783cc1f1a5a7989c7a65fa5c,3,2,4,6,3,2011-04-09 17:55:33,2011-04-09 17:55:33
dab913575c2c1d26783cc1f1a5a7989c7a65fa5c...674ededfa15481f7a398c42ed695e304237a191c,3,3,3,6,3,2011-04-09 18:23:53,2011-04-09 18:23:53
9619d8795361c746abcc0b18c737ec96991a7315...eac8831208f16edfc897ab02b3d61d4fe87c92b0,8,107,66,173,21,2011-06-24 03:49:33,2011-06-24 03:49:33
7927a5739a087d7681e8d0d464b009827a4d16bf...b14b441f55bd2d4b19b2dac5eeecf2bd42d2bf2a,1,110,0,110,1,2011-06-25 17:41:38,2011-06-25 17:41:38
b14b441f55bd2d4b19b2dac5eeecf2bd42d2bf2a...a0fd9853f5c340e73c43deb2f77b70d84366664e,7,13,19,32,9,2011-06-25 17:48:31,2011-06-25 17:48:31
a0fd9853f5c340e73c43deb2f77b70d84366664e...e2cedca817154499edba24d50f49c968be3afdd2,1,1,2,3,2,2011-06-25 20:26:32,2011-06-25 20:26:32
e2cedca817154499edba24d50f49c968be3afdd2...f74ccb92437cbf1c4c211de1b4c9b32e122379d2,1,1,1,2,1,2011-06-26 00:31:02,2011-06-26 00:31:02
43e2ccca4141adfc8ca64764dcaa1a44e2b0958f...82153e60b5a41d9d35054198dab5239ed575d397,8,529,1,530,8,2011-04-25 10:44:34,2011-04-24 09:18:03
82153e60b5a41d9d35054198dab5239ed575d397...07674c286f9f4baaf61117d97f667ab487976087,5,188,3,191,11,2011-04-25 11:59:11,2011-04-25 11:59:11
07674c286f9f4baaf61117d97f667ab487976087...71622b7cdbce681a0d2b01acb5d84d846a5fe67a,9,291,356,647,86,2011-05-01 04:16:58,2011-05-01 04:16:58
43e2ccca4141adfc8ca64764dcaa1a44e2b0958f...62f03644701bdb326c935d12718599cfb22e81e1,2,4,4,8,4,2011-04-24 19:13:40,2011-04-24 19:13:40
43e2ccca4141adfc8ca64764dcaa1a44e2b0958f...7a6f04ed528d3e53b17df63530bf9a6a3e5f3f2b,5,21,27,48,17,2011-04-20 03:24:19,2011-04-20 03:24:19
43e2ccca4141adfc8ca64764dcaa1a44e2b0958f...587b1bb494a7549777298a98a46f6c9d43395b63,4,51,31,82,19,2011-04-19 19:19:04,2011-04-19 19:17:46
587b1bb494a7549777298a98a46f6c9d43395b63...fd804ce47f0307221f14ac30173b212bdcd61d2c,4,220,113,333,30,2011-04-19 19:39:37,2011-04-19 19:39:37
fd804ce47f0307221f14ac30173b212bdcd61d2c...7abebefe1ec5e3009a3a4c88180ddcbf5989e978,4,27,21,48,10,2011-04-19 20:03:41,2011-04-19 20:03:41
7abebefe1ec5e3009a3a4c88180ddcbf5989e978...6804b1c86ce4ea83633443206625ff86056cb1d7,4,231,98,329,21,2011-04-19 20:47:19,2011-04-19 20:47:19
6804b1c86ce4ea83633443206625ff86056cb1d7...5a41c5e9b499b57386bf223652fc49e50fe76ded,3,3,3,6,3,2011-04-19 20:56:50,2011-04-19 20:56:50
5a41c5e9b499b57386bf223652fc49e50fe76ded...48537d9d42852dc218af5971605be53720230358,3,64,48,112,27,2011-04-20 00:50:09,2011-04-20 00:50:09
48537d9d42852dc218af5971605be53720230358...83cb0f09f55a17c556c1bb4af3d656475cec46ac,4,14,8,22,10,2011-04-20 01:02:19,2011-04-20 01:02:19
83cb0f09f55a17c556c1bb4af3d656475cec46ac...7be927705cf892c9cd3e06670d31ce4b46e04de1,3,57,53,110,27,2011-04-20 02:18:35,2011-04-20 02:18:35
7be927705cf892c9cd3e06670d31ce4b46e04de1...379b8ad3626de51d28a078ee6c84742d838d4a15,3,53,5,58,5,2011-04-20 04:01:38,2011-04-20 04:01:38
f74ccb92437cbf1c4c211de1b4c9b32e122379d2...35fb91d16f9fa475ed7d84ce86d8ed994312750e,7,167,133,300,41,2011-06-28 20:27:03,2011-06-28 20:27:03
35fb91d16f9fa475ed7d84ce86d8ed994312750e...96710b4aa86951583847ab764c3813a16e1aa35b,6,58,4,62,7,2011-06-30 01:50:42,2011-06-30 01:50:42
f74ccb92437cbf1c4c211de1b4c9b32e122379d2...6b9d0337a5197e41843ee4bf05ba01f775e27531,2,2,2,4,2,2011-06-27 23:06:59,2011-06-27 23:06:59
2db0875d75c708c6167b4955ec146136b9903ca8...9d4b6a02fb7ef49444d0456e5861184e34267fba,15,88,82,170,39,2011-08-24 21:08:19,2011-08-24 21:08:19
2db0875d75c708c6167b4955ec146136b9903ca8...8223554e50a862ef5366b4461683b43578766799,4,8,4,12,7,2011-08-24 17:28:14,2011-08-24 17:28:14
f76e5159b5bf2af314209ca75b9ef95ae45c9d7e...603d86ac1a135bb73a07bd74a0cedfd5942a32be,6,10,8,18,10,2011-05-01 16:58:46,2011-05-01 16:58:46
603d86ac1a135bb73a07bd74a0cedfd5942a32be...df2e3c2a816caf0d9762628eae47e664935cea25,6,8,4,12,6,2011-05-01 19:31:34,2011-05-01 19:31:34
b15a273327b017dfc2574c22ed1d59801af417f2...420fed15d38b4916bf0c2c4f3fece5aebb3f61dd,3,4,4,8,3,2011-04-25 05:29:36,2011-04-25 05:29:36
12440fd54324d5ffa20de508e690178aa46491a6...020aaa53e1fe89d318557b1be0267777cc0127e8,3,3,3,6,3,2011-04-25 05:35:59,2011-04-25 05:35:59
6c4c7d8aae05f146276ee34ee67c757ca9620c63...4e96a35b6616f4d2a16199e9614368143888e434,4,34,30,64,21,2011-08-24 23:04:47,2011-08-24 23:04:47
4e96a35b6616f4d2a16199e9614368143888e434...ba2a68bb943b55fc2268a0ccdca8b6cc8215abcf,4,33,21,54,6,2011-08-24 23:11:28,2011-08-24 23:11:28
ba2a68bb943b55fc2268a0ccdca8b6cc8215abcf...0f4152e0425c506f8088ecd72bf13256692eaa06,4,9,3,12,4,2011-08-24 23:20:59,2011-08-24 23:20:59
0f4152e0425c506f8088ecd72bf13256692eaa06...d5533276bca6a641bbe9203c34e13f758fbbbdf5,5,16,2,18,7,2011-08-25 00:46:10,2011-08-25 00:46:10
d5533276bca6a641bbe9203c34e13f758fbbbdf5...4d161714b36d50e51c0913e10da5aca538b1679a,3,181,0,181,3,2011-08-25 00:56:34,2011-08-25 00:56:34
4d161714b36d50e51c0913e10da5aca538b1679a...8a77b18d849234a641d6c0066796945f91e499d8,3,3,3,6,3,2011-08-25 01:02:29,2011-08-25 01:01:13
df2e3c2a816caf0d9762628eae47e664935cea25...d1c406f43c2acb2bc5187db1a3a72f156b45df88,4,57,4,61,8,2011-05-03 00:11:44,2011-05-03 00:11:44
d1c406f43c2acb2bc5187db1a3a72f156b45df88...a0d4d0bd8e49a48f6fd55809c9df02e310f796f0,4,23,4,27,8,2011-05-03 01:42:39,2011-05-03 01:42:39
df2e3c2a816caf0d9762628eae47e664935cea25...ae5123f84b264ea19d3020fcd12bb84e00beea4d,8,158,5,163,10,2011-05-02 08:13:52,2011-05-01 15:08:24
df2e3c2a816caf0d9762628eae47e664935cea25...0f2846ef1701ee11ed1d71e298775e8073f2975d,20,20,0,20,20,2011-05-01 23:15:09,2011-05-01 23:15:09
a5586726f09b2e9b0e1941946957763701b5de44...1c70462de5b0aced98cc20602d5a53d63fe1ac9b,1,1,2,3,2,2011-05-01 17:22:45,2011-05-01 17:22:45
1c70462de5b0aced98cc20602d5a53d63fe1ac9b...995ab7e64b2f1c6d7c044fea1fa52a9313fe1f6c,2,3,4,7,3,2011-05-01 17:24:38,2011-05-01 17:24:38
020aaa53e1fe89d318557b1be0267777cc0127e8...beb53fe035aedf6a7a8990e3df4199c46a6a7cb8,6,242,93,335,9,2011-04-27 11:20:29,2011-04-26 11:10:48
beb53fe035aedf6a7a8990e3df4199c46a6a7cb8...de1e679cfc42fd6608228600f194313155982f09,3,45,41,86,21,2011-04-27 20:11:55,2011-04-27 17:30:47
de1e679cfc42fd6608228600f194313155982f09...3e72f75f3eb80d05d3f9816b2b4c21f381ab6bd4,1,30,37,67,6,2011-04-29 09:02:28,2011-04-29 09:02:28
3e72f75f3eb80d05d3f9816b2b4c21f381ab6bd4...1c2546050f91cc93dcd6960a4d317e3176b5b8aa,1,4,9,13,3,2011-04-29 09:14:15,2011-04-29 09:14:15
1c2546050f91cc93dcd6960a4d317e3176b5b8aa...5069739b0a067519dbf03fbdddc28e890c366707,3,96,88,184,19,2011-04-30 23:47:38,2011-04-30 23:47:38
020aaa53e1fe89d318557b1be0267777cc0127e8...c06e8996aeeccafc0bbe4ecaefbb4247e1d750bc,3,9,9,18,5,2011-04-26 21:35:46,2011-04-26 21:35:46
c06e8996aeeccafc0bbe4ecaefbb4247e1d750bc...01124f27b83fbde05628cf44afc620a18aca93ca,3,17,1,18,3,2011-04-26 21:40:21,2011-04-26 21:40:21
01124f27b83fbde05628cf44afc620a18aca93ca...7e5fc72202888bde2152ba381f6ef1032425bdb1,3,10,8,18,5,2011-04-26 22:03:10,2011-04-26 22:03:10
7e5fc72202888bde2152ba381f6ef1032425bdb1...233a1950eed2f87c9ffc7cd35d885fbc265eb773,3,41,21,62,19,2011-04-26 22:42:06,2011-04-26 22:42:06
233a1950eed2f87c9ffc7cd35d885fbc265eb773...f9d0d423f0a220955327ae2d32181f33dffb62f3,1,2,0,2,1,2011-04-26 22:50:22,2011-04-26 22:50:22
f9d0d423f0a220955327ae2d32181f33dffb62f3...ce2e52a6beaaad8f041d80cab1d5ae8ba6402b2f,3,85,13,98,11,2011-04-26 23:53:54,2011-04-26 23:53:54
ce2e52a6beaaad8f041d80cab1d5ae8ba6402b2f...3502c5fdf5bffa51e3925003ba782450e90fc3d5,1,3,3,6,4,2011-04-27 00:19:43,2011-04-27 00:19:43
3502c5fdf5bffa51e3925003ba782450e90fc3d5...f19d26581917421770ca38cc0dd2b234942122b7,3,29,39,68,11,2011-04-27 00:20:07,2011-04-27 00:20:07
a42e4e14ad33186b41af15672464a6c132940538...7f5fa42adc456fdcaf4dad26d31f35d87f32b900,3,25,7,32,11,2011-07-02 21:49:31,2011-07-02 21:49:31
7f5fa42adc456fdcaf4dad26d31f35d87f32b900...2773cd9f2792a449f44124fd588fccd8d18c5ae2,15,86,62,148,55,2011-07-02 22:49:50,2011-07-02 22:49:50
2773cd9f2792a449f44124fd588fccd8d18c5ae2...bd505a22a9a842103a4e76c6b2412434c1d35c8b,17,18,49,67,33,2011-07-02 22:59:19,2011-07-02 22:59:19
bd505a22a9a842103a4e76c6b2412434c1d35c8b...6bdbe4b8634f56276fa37fa418f7d7d5e629248d,30,431,388,819,49,2011-07-02 23:31:12,2011-07-02 23:31:12
6bdbe4b8634f56276fa37fa418f7d7d5e629248d...70b9f51ba415ad151c3b963533b36f25b8940bfe,1,6,5,11,3,2011-07-02 23:36:59,2011-07-02 23:36:59
70b9f51ba415ad151c3b963533b36f25b8940bfe...4bf829f46f9c886ec32cd38d0fe0e8daedc7a2c9,1,139,0,139,1,2011-07-02 23:38:00,2011-07-02 23:38:00
4bf829f46f9c886ec32cd38d0fe0e8daedc7a2c9...0696bf089f6606e1cd1adaab2c716051d457c49c,18,46,24,70,26,2011-07-03 00:14:34,2011-07-03 00:14:34
3f6fefb557533429a3177f8e7073f84d89e53533...fb7e69f75ea3b524d87dae454375c200a360cd2a,6,12,10,22,6,2011-08-25 01:11:35,2011-08-25 01:11:35
a3aebbad5689061bccba3373d5c46ff916ff7817...33486bb8f90d702fd6bf59f3e968f6da5ef30daa,3,3,5,8,5,2011-05-03 10:26:43,2011-05-03 10:26:43
33486bb8f90d702fd6bf59f3e968f6da5ef30daa...7367df8050d5f08aca00f26c3e7725a38448568a,5,130,84,214,16,2011-05-07 23:32:48,2011-05-07 23:31:03
0f2846ef1701ee11ed1d71e298775e8073f2975d...9e51c6efa376f6b520a48dd5b997b2808809f771,3,8,6,14,5,2011-05-05 17:53:52,2011-05-05 17:51:53
9e51c6efa376f6b520a48dd5b997b2808809f771...09cbe4d82b5373b1b4644c1c678e89a9f6c9078f,1,2,2,4,2,2011-05-05 20:46:49,2011-05-05 20:46:49
0f2846ef1701ee11ed1d71e298775e8073f2975d...1a83029485aea399ade3c34a0a8225b952624af7,8,95,49,144,24,2011-05-05 14:29:17,2011-05-05 13:32:26
1a83029485aea399ade3c34a0a8225b952624af7...e67e7d7d8b9a8b0d3e0c27cafae5bf1fd8028274,8,144,67,211,29,2011-05-08 06:20:02,2011-05-08 06:20:02
e67e7d7d8b9a8b0d3e0c27cafae5bf1fd8028274...c99678e6cf70cf36683ce7c46acd3f4e29e07576,2,6,6,12,4,2011-05-08 06:24:42,2011-05-08 06:24:42
c99678e6cf70cf36683ce7c46acd3f4e29e07576...7ead68822bf2e00dc61df2b8e22bca1f554892b9,4,2,23,25,4,2011-05-09 02:52:12,2011-05-09 02:52:12
0f2846ef1701ee11ed1d71e298775e8073f2975d...668cdaa7679829d939b5443fb0f1a43a42245ed8,6,88,4,92,6,2011-05-05 11:38:55,2011-05-05 11:32:14
668cdaa7679829d939b5443fb0f1a43a42245ed8...a5911601090292c128f5c3f20c66c8de89bab376,4,46,16,62,9,2011-05-05 16:27:43,2011-05-05 16:27:43
a5911601090292c128f5c3f20c66c8de89bab376...fa2f325c9d31838d93212bb5f62096a58d6ebdc9,1,1,1,2,1,2011-05-05 20:25:45,2011-05-05 20:25:45
fa2f325c9d31838d93212bb5f62096a58d6ebdc9...4024cb6681489e0d6db947afc62784650224637b,6,58,12,70,10,2011-05-05 20:44:40,2011-05-05 20:44:40
4024cb6681489e0d6db947afc62784650224637b...59b5ba99be24b64d018f2beb3c5c09ef37174a69,6,114,92,206,38,2011-05-07 17:59:49,2011-05-07 17:59:49
59b5ba99be24b64d018f2beb3c5c09ef37174a69...6a2c0ef05330268ff81a2a2e2d0026d0ade9790f,5,106,12,118,9,2011-05-07 18:08:48,2011-05-07 18:08:48
0f2846ef1701ee11ed1d71e298775e8073f2975d...01bf83601fe388274cf21e3717ad2f0f9954d12a,3,31,1,32,3,2011-05-03 23:23:09,2011-05-03 23:23:09
0f2846ef1701ee11ed1d71e298775e8073f2975d...05442751f9db86286012d779e5aad4f6250b44d8,6,24,6,30,8,2011-05-03 12:40:27,2011-05-03 12:38:56
05442751f9db86286012d779e5aad4f6250b44d8...316526a09e32400a589795aad0db17037a80557f,5,20,14,34,8,2011-05-07 17:32:17,2011-05-07 17:32:17
0f2846ef1701ee11ed1d71e298775e8073f2975d...1578595a18f6c7b3a46d98e5f68de18aebc4dd19,3,3,3,6,3,2011-05-03 11:24:51,2011-05-03 11:20:48
1578595a18f6c7b3a46d98e5f68de18aebc4dd19...7ab5e3567f6c5976c90e30d13e5b6ee3890590f1,3,26,12,38,9,2011-05-03 16:17:03,2011-05-03 16:17:03
7ab5e3567f6c5976c90e30d13e5b6ee3890590f1...bf1be6f5cc1921c619d7f15853d25f77c168d6fc,3,4,4,8,3,2011-05-03 16:27:02,2011-05-03 16:27:02
bf1be6f5cc1921c619d7f15853d25f77c168d6fc...333ddeb07c387024fb5ea90d56de701c1a67d26f,3,8,2,10,7,2011-05-05 12:30:06,2011-05-05 12:23:04
333ddeb07c387024fb5ea90d56de701c1a67d26f...94d0e1aa18931a52777775d078ea52038f9d1876,3,14,8,22,7,2011-05-05 12:31:24,2011-05-05 12:27:33
94d0e1aa18931a52777775d078ea52038f9d1876...2280d51c9defbaddb7e4129ba34aed88da863192,3,8,14,22,7,2011-05-05 15:20:54,2011-05-05 15:20:54
2280d51c9defbaddb7e4129ba34aed88da863192...8d2bc4b1b3489a3e9ec088aea2d3919533f56c9d,3,30,24,54,13,2011-05-05 15:25:49,2011-05-05 15:25:49
8d2bc4b1b3489a3e9ec088aea2d3919533f56c9d...99e2a556144efc3f3fc8c37bbb12905684976a9d,3,32,34,66,17,2011-05-07 18:21:59,2011-05-07 18:21:59
99e2a556144efc3f3fc8c37bbb12905684976a9d...1c413cda331988e72e7478e4cd4255d6c7e2e14b,3,64,0,64,3,2011-05-07 18:27:48,2011-05-07 18:27:48
9d80ac2d4699df58aa27161ecaba1fb757742e18...229a59cb3f4df5fc3553235dbd615e61470ccf04,5,21,7,28,9,2011-04-27 17:23:54,2011-04-27 17:23:54
7c518c547c5628063a5e2f136fd2caaa24a7207d...25a3a503b555f7bce9ebbb66f8c8195a8a12876b,6,83,2,85,7,2011-05-12 17:25:05,2011-05-12 17:25:05
25a3a503b555f7bce9ebbb66f8c8195a8a12876b...3018f873c147bc885b2e999e81ad0a286281e7ec,3,229,111,340,68,2011-05-12 17:56:31,2011-05-12 17:45:24
7c518c547c5628063a5e2f136fd2caaa24a7207d...5f2e430f25076dd222b1e88bde0ffef857cd80bb,3,9,3,12,3,2011-05-10 21:42:16,2011-05-10 21:42:16
5f2e430f25076dd222b1e88bde0ffef857cd80bb...a5f140709c852e7cac9a201821bf0345cc3aa141,5,49,32,81,9,2011-05-11 16:26:48,2011-05-11 16:26:48
a5f140709c852e7cac9a201821bf0345cc3aa141...1bb3e9b02599f92a21a5b7b7b8f7492a1ba1e011,4,20,10,30,7,2011-05-12 09:10:04,2011-05-12 09:10:04
1bb3e9b02599f92a21a5b7b7b8f7492a1ba1e011...ab28a0c83321f6fa96798bfd2b6cd9470dd3be26,4,10,20,30,7,2011-05-12 16:20:07,2011-05-12 16:20:07
94e20f74f8cc3f750a89dca67ef18b723bfe5444...6e972732d857132c6e63500d6d0fafd92ce292a9,5,135,3,138,4,2011-07-03 14:46:07,2011-07-03 14:46:07
fb7e69f75ea3b524d87dae454375c200a360cd2a...364bf941ca7efbb223d75932484242d8b5c8bc71,6,114,47,161,27,2011-08-26 23:50:29,2011-08-26 23:50:29
fb7e69f75ea3b524d87dae454375c200a360cd2a...f1bedbb0b0b7f973beee7c116d9da303f0913ce2,1,1,1,2,1,2011-08-26 20:29:21,2011-08-26 20:29:21
fb7e69f75ea3b524d87dae454375c200a360cd2a...5aeb3121965c5273577cf3e8e175321519bb127b,7,37,34,71,10,2011-08-26 20:17:27,2011-08-26 20:17:27
fb7e69f75ea3b524d87dae454375c200a360cd2a...04d2d546cfcd6616944cf23a0ad8eb935694e620,4,35,5,40,6,2011-08-26 17:46:01,2011-08-26 17:46:01
fb7e69f75ea3b524d87dae454375c200a360cd2a...f5302518995acc931aa882ebdb9112448b14f8b2,4,10,10,20,8,2011-08-25 16:13:45,2011-08-25 16:13:45
229a59cb3f4df5fc3553235dbd615e61470ccf04...8e0bc6342ff11025f6a74fdc918420c625b6f1bc,7,35,11,46,14,2011-04-27 23:33:09,2011-04-27 23:24:31
8e0bc6342ff11025f6a74fdc918420c625b6f1bc...1893d286e70e0ee1b35e50eafa49a55c7ef2ecae,7,43,35,78,16,2011-05-01 04:52:14,2011-05-01 04:52:14
229a59cb3f4df5fc3553235dbd615e61470ccf04...ee30e29332c9e4b1284d4c7ab3a4495e88d01523,6,25,21,46,11,2011-04-27 22:46:49,2011-04-27 22:46:49
ee30e29332c9e4b1284d4c7ab3a4495e88d01523...51b8e023c1fdceb92141d0d496676d8ac950b261,6,74,88,162,26,2011-04-28 17:25:23,2011-04-28 17:23:04
51b8e023c1fdceb92141d0d496676d8ac950b261...067959832875993b721a27a322c8944bf5dcd1a3,6,22,12,34,10,2011-04-28 18:43:26,2011-04-28 18:43:26
173a936d689ba61056b778527b354f227fdeb437...07e64e94fc195ec08ae15d84f8419e4298aaed1c,8,117,83,200,32,2011-05-23 19:03:23,2011-05-19 21:31:34
07e64e94fc195ec08ae15d84f8419e4298aaed1c...02b478367aa103e90931daf0930533dd77db521b,1,53,19,72,6,2011-05-23 20:09:04,2011-05-23 20:09:04
173a936d689ba61056b778527b354f227fdeb437...5e606729a42c36a94e15dcccbbe5675815685754,6,278,59,337,8,2011-05-21 09:24:23,2011-05-21 08:10:16
5e606729a42c36a94e15dcccbbe5675815685754...a462483b570bb2794b972d227890eaa642e59cec,3,21,5,26,5,2011-05-21 20:29:43,2011-05-21 20:29:43
a462483b570bb2794b972d227890eaa642e59cec...a15165398d8633d0eeb929cade77c0557def0479,5,263,160,423,59,2011-05-22 18:26:46,2011-05-22 18:26:46
a15165398d8633d0eeb929cade77c0557def0479...c75ebe10a99bdcfcce3aa4482bd41fb5e8ab3729,7,97,27,124,27,2011-05-26 07:10:14,2011-05-26 07:10:14
173a936d689ba61056b778527b354f227fdeb437...643efb98695b9c3e24dd3f27e844928a54edde04,5,132,14,146,17,2011-05-19 19:57:42,2011-05-19 19:43:12
643efb98695b9c3e24dd3f27e844928a54edde04...e89b53cc9e558a1fcfd9d3d07d31c9493cc75543,4,28,21,49,8,2011-05-19 20:04:51,2011-05-19 20:04:51
e89b53cc9e558a1fcfd9d3d07d31c9493cc75543...247e58e372ff7d43160b733254491108ae700025,2,16,0,16,5,2011-05-20 13:46:30,2011-05-20 13:44:07
247e58e372ff7d43160b733254491108ae700025...01fdc1d93d4725c5d57666958e26a2309f2d6ba3,6,155,2,157,7,2011-05-20 21:20:17,2011-05-20 21:20:17
01fdc1d93d4725c5d57666958e26a2309f2d6ba3...85a6feec66a0120f9c403b4a2dda79beae3bdc76,5,135,57,192,23,2011-05-20 22:38:09,2011-05-20 22:38:09
85a6feec66a0120f9c403b4a2dda79beae3bdc76...392aa11e9b25b5c90875a51cc816328030fe33f4,5,13,15,28,10,2011-05-22 00:19:31,2011-05-22 00:19:31
173a936d689ba61056b778527b354f227fdeb437...32b02b6902c8cd576c14642b980b2964da85b423,1,12,2,14,4,2011-05-14 19:38:20,2011-05-14 19:38:20
32b02b6902c8cd576c14642b980b2964da85b423...92a0ea172cfbb023e12d915f17709fb99ab380de,4,18,11,29,9,2011-05-27 22:48:54,2011-05-27 22:48:54
173a936d689ba61056b778527b354f227fdeb437...2d98bf10a4b4e41c5df54e0a1febb22ab687c48f,3,29,13,42,13,2011-05-13 13:28:44,2011-05-13 13:28:44
2d98bf10a4b4e41c5df54e0a1febb22ab687c48f...c29a12168770f34dd8117d698521d7a320c4a659,3,167,27,194,15,2011-05-13 18:17:00,2011-05-13 18:17:00
bdc70237767b7e7cbe6ed08551dc5654cc29ff0e...f1a2f62dcba78c9b2adf4d3f12847ab4b632c1f9,3,3,5,8,3,2011-05-12 18:28:31,2011-05-12 18:28:31
f1a2f62dcba78c9b2adf4d3f12847ab4b632c1f9...4c998ba2cc3abc996cb78f2c37f64cd1d6a5d138,5,99,30,129,10,2011-05-12 18:54:38,2011-05-12 18:54:38
6e972732d857132c6e63500d6d0fafd92ce292a9...598cd6a08cef6b93085c24a802b5d1fa0c254c44,3,3,3,6,3,2011-07-04 07:05:56,2011-07-04 07:05:56
6e972732d857132c6e63500d6d0fafd92ce292a9...1e64727eca30de37584c7157b4ab4ec52021f361,1,11,7,18,6,2011-07-03 14:59:09,2011-07-03 14:59:09
1e0b80fb3a8d3fe8133c1e89b6f5cd4d738c80e7...cd135d5e90c188d7cf06b7b455ceafb64d10b6a3,1,1,1,2,1,2011-08-27 17:59:24,2011-08-27 17:59:24
1e0b80fb3a8d3fe8133c1e89b6f5cd4d738c80e7...872c9ff13be83a20601c2989b4fc276c1aebaaff,8,278,7,285,14,2011-08-27 12:25:40,2011-08-27 11:00:27
872c9ff13be83a20601c2989b4fc276c1aebaaff...f97c2613ae029bf7740b1212c8a5a715c9e83074,5,19,19,38,11,2011-08-27 17:45:26,2011-08-27 17:45:26
f97c2613ae029bf7740b1212c8a5a715c9e83074...ba7bb1ff08d96bba52043dccbcb190749edba943,3,3,3,6,3,2011-08-27 17:48:47,2011-08-27 17:48:47
ba7bb1ff08d96bba52043dccbcb190749edba943...70c61684407b14f6587540c2afff8beec5ac2ddc,4,18,18,36,6,2011-08-27 17:54:50,2011-08-27 17:54:50
5259ee9dc446f4461fe5f27983e52bb79b5034e7...48980521018b63957655a9d319917d2629254029,14,136,28,164,26,2011-05-10 18:06:24,2011-05-10 18:06:24
48980521018b63957655a9d319917d2629254029...f00424f1cc4f3dd4c4f42a09cfe4b9a62f619167,3,3,3,6,3,2011-05-10 18:18:14,2011-05-10 18:18:14
f00424f1cc4f3dd4c4f42a09cfe4b9a62f619167...d6d6578c88bd74a84066141d5d6cb8db2888e939,3,3,3,6,3,2011-05-11 07:14:31,2011-05-11 07:14:31
d6d6578c88bd74a84066141d5d6cb8db2888e939...728fff5ba5be3c20f4fd2dcbdcdd9b897e37c19d,8,50,13,63,11,2011-05-11 07:35:12,2011-05-11 07:35:12
728fff5ba5be3c20f4fd2dcbdcdd9b897e37c19d...1bc1712b53627937bde0d05257653e345da88856,3,24,1,25,3,2011-05-11 09:03:39,2011-05-11 09:03:39
1bc1712b53627937bde0d05257653e345da88856...c9add727b4a38b5c76b1ed9457e1063c6a34b104,3,15,5,20,5,2011-05-11 15:42:24,2011-05-11 15:42:24
c9add727b4a38b5c76b1ed9457e1063c6a34b104...1e8c12067bb3dff40458b20c9dffe819b3bec1e2,2,4,4,8,2,2011-05-11 16:01:51,2011-05-11 15:52:37
1e8c12067bb3dff40458b20c9dffe819b3bec1e2...266452fb7729ac9b9f4ffab78a8a57666d3377c1,2,27,0,27,2,2011-05-20 19:04:35,2011-05-20 19:04:35
067959832875993b721a27a322c8944bf5dcd1a3...7c533d26ccaee4271dabdcf9bac2098b6f050883,13,334,101,435,15,2011-05-09 23:11:31,2011-05-09 22:58:54
067959832875993b721a27a322c8944bf5dcd1a3...48a40eccea6cd466e7d382b9f8be0f54de253832,5,217,1,218,5,2011-05-01 23:04:06,2011-05-01 08:48:01
067959832875993b721a27a322c8944bf5dcd1a3...392bcab8f8b8174621bb9d312fc766dc0a09a642,3,109,0,109,3,2011-04-29 23:19:42,2011-04-29 16:14:44
392bcab8f8b8174621bb9d312fc766dc0a09a642...c293fde197ede09e5b68eec00d9a1f43f13e8d3c,2,69,69,138,17,2011-04-30 20:13:51,2011-04-30 20:13:51
c293fde197ede09e5b68eec00d9a1f43f13e8d3c...93ac0c0b144856857f9ff24edc80ad6089954282,2,19,1,20,3,2011-04-30 20:19:28,2011-04-30 20:19:28
067959832875993b721a27a322c8944bf5dcd1a3...249c4f2f0fb61dab93503068074074f794d1ec7c,3,110,0,110,3,2011-04-29 14:14:55,2011-04-29 14:14:55
249c4f2f0fb61dab93503068074074f794d1ec7c...f049cb0eafbe49aac91d15a524619218365fb7c3,2,27,8,35,10,2011-04-29 15:09:56,2011-04-29 15:09:56
f049cb0eafbe49aac91d15a524619218365fb7c3...a92535ce8b8d09851b08a5395f7635b49e088710,2,77,78,155,19,2011-04-30 22:56:03,2011-04-30 22:56:03
aa928b6c3ed95ff448b9e61dcc7d9be9d1a19f93...c6c70d4730e182cae80277f0dc7ba1fb04cf296e,3,11,13,24,3,2011-07-09 23:03:07,2011-07-09 23:03:07
71264282b4930124dedc4cb2e1a499998fe87048...98ef2d185f5b027e888134a063b82ad4846106bb,16,52,53,105,47,2011-05-27 04:15:28,2011-05-27 04:15:28
71264282b4930124dedc4cb2e1a499998fe87048...3941be193a3391ab90272738bc17337c0cf5f58e,6,8,8,16,8,2011-05-22 09:22:28,2011-05-21 23:10:37
a5d46990c627ff03d1554f92f4a1cd619601815a...6ba3097766e39ab68cb3d04e4c8b81b6f51a29c5,16,596,150,746,44,2011-05-21 19:56:06,2011-05-21 19:56:06
6ba3097766e39ab68cb3d04e4c8b81b6f51a29c5...0e75d2770778b0469728269fea54bc2162cb3fe9,3,7,7,14,3,2011-05-21 20:08:52,2011-05-21 20:08:52
0e75d2770778b0469728269fea54bc2162cb3fe9...08a5aa383fbaeef2e3d1587b746bb44fd9ca0ce3,4,141,55,196,28,2011-05-21 23:38:29,2011-05-21 23:38:29
08a5aa383fbaeef2e3d1587b746bb44fd9ca0ce3...ce52261abf781bb2e1cb8ba15da8673a22a8570a,4,40,36,76,15,2011-05-21 23:56:12,2011-05-21 23:54:31
b6983951e12e48417d802f3fc37d33f5f70f350f...1104e6fd83b8b3b4e1e399bf621a417c6777964d,4,3,3,6,3,2011-07-04 16:41:32,2011-07-04 16:41:32
1104e6fd83b8b3b4e1e399bf621a417c6777964d...489eb0cde7e31ee84b48b1ad1f79d699737a9129,5,3,6,9,6,2011-07-04 16:43:37,2011-07-04 16:43:37
cd135d5e90c188d7cf06b7b455ceafb64d10b6a3...d1d1fc7f1bbc3557aec07f46e73953cbfbad7c72,1,2,2,4,1,2011-08-29 10:40:56,2011-08-29 10:40:56
cd135d5e90c188d7cf06b7b455ceafb64d10b6a3...c2e37352ac84eb8b4be89feed90bc2249866f715,8,28,19,47,10,2011-08-29 02:35:53,2011-08-29 02:35:53
cd135d5e90c188d7cf06b7b455ceafb64d10b6a3...55759258fdb5e01a2d42c6a1101d687f0c5ce01c,3,5,5,10,5,2011-08-29 01:35:32,2011-08-29 01:28:22
cd135d5e90c188d7cf06b7b455ceafb64d10b6a3...51f66413142bbc26d5ebd2d50fd245416709a16f,3,5,5,10,5,2011-08-29 00:10:52,2011-08-29 00:10:52
cd135d5e90c188d7cf06b7b455ceafb64d10b6a3...874c6f4503361fde7de81c7618d7909728ece3d2,4,61,41,102,24,2011-08-28 22:23:17,2011-08-28 22:20:58
cd135d5e90c188d7cf06b7b455ceafb64d10b6a3...399b145a201417ba44e93bcc9c06be3a1e73f696,5,157,1,158,5,2011-08-28 16:06:48,2011-08-28 15:59:35
399b145a201417ba44e93bcc9c06be3a1e73f696...f20f416a1755ac619ee9e2c44e3576b4c8e72022,4,125,56,181,14,2011-08-29 10:48:51,2011-08-29 00:33:17
f20f416a1755ac619ee9e2c44e3576b4c8e72022...c06043919f5595f6f483af5f0d9341cbcaf0b939,5,37,37,74,33,2011-08-29 17:05:09,2011-08-29 17:03:31
cd135d5e90c188d7cf06b7b455ceafb64d10b6a3...864c3e91140fbca1bb4d9407cd7c40bab5d171dd,4,23,20,43,14,2011-08-27 18:49:32,2011-08-27 18:49:32
864c3e91140fbca1bb4d9407cd7c40bab5d171dd...5390ac3f853e6f48b4db66dd81e97885bbea530b,3,43,39,82,11,2011-08-28 16:32:52,2011-08-28 16:32:52
cd135d5e90c188d7cf06b7b455ceafb64d10b6a3...a35fc5541021f0fa55a555de25ce2934baca39dd,6,13,5,18,7,2011-08-27 18:38:03,2011-08-27 18:38:03
5f03fa2276b382345e68f64b592ebcb6eff23b74...e8b717739697cdece8043ec21f1e4223b130d565,6,10,30,40,8,2011-06-06 08:12:32,2011-06-06 07:57:35
e8b717739697cdece8043ec21f1e4223b130d565...370d0f5726496c65dd28aa9d9fcffda70c04a50c,4,34,3,37,4,2011-06-06 16:54:22,2011-06-06 16:54:22
370d0f5726496c65dd28aa9d9fcffda70c04a50c...56cc7d3e57207532ff554dd91ceffcbfde10dea1,10,81,17,98,16,2011-06-06 17:48:00,2011-06-06 17:48:00
56cc7d3e57207532ff554dd91ceffcbfde10dea1...bb21bbd8ce264a4f42c750d3ce720c41885a7e6e,4,6,3,9,6,2011-06-06 22:51:05,2011-06-06 22:51:05
bb21bbd8ce264a4f42c750d3ce720c41885a7e6e...e0a0455f7becf5b6ad7aa16a0d597d4d4c8f7697,33,75,326,401,50,2011-07-06 17:57:14,2011-07-06 17:57:14
e0a0455f7becf5b6ad7aa16a0d597d4d4c8f7697...d9b98e282cdc3fd15bf4645ca4bf8681b2b7a9e6,1,0,5,5,1,2011-07-06 18:52:32,2011-07-06 18:52:32
48a40eccea6cd466e7d382b9f8be0f54de253832...1eb0932d04ce966cc034259f97334c53ec49af22,3,7,25,32,9,2011-05-09 08:05:44,2011-05-09 08:05:44
98ef2d185f5b027e888134a063b82ad4846106bb...a59683e3251192ac6b6586bfbbae31e74c259444,3,51,27,78,9,2011-05-30 09:09:53,2011-05-30 09:09:53
a59683e3251192ac6b6586bfbbae31e74c259444...6c5a1a3b0ebd53a08751bbfec6b7f8252ae0211c,3,21,21,42,3,2011-05-30 16:22:28,2011-05-30 16:22:28
98ef2d185f5b027e888134a063b82ad4846106bb...7e08dc10efa35112a8692bd371cc533c9aaa6328,9,66,10,76,10,2011-05-30 08:38:17,2011-05-30 08:38:17
7e08dc10efa35112a8692bd371cc533c9aaa6328...25e77c4f67034a42dec62ae44c54e78d8bbe5b2c,8,38,14,52,17,2011-05-30 08:45:27,2011-05-30 08:43:47
25e77c4f67034a42dec62ae44c54e78d8bbe5b2c...d8c8b5ddd6d433b7c80bc5e3e469fdf277c1aa16,8,24,10,34,13,2011-05-30 16:10:13,2011-05-30 16:09:39
98ef2d185f5b027e888134a063b82ad4846106bb...240329345553fb535a6ea5f9c10328e015c32f31,6,40,2,42,7,2011-05-27 08:36:36,2011-05-27 08:36:36
240329345553fb535a6ea5f9c10328e015c32f31...1baf57be30c96cd20baf1e79ae02df9d22a8f049,5,41,12,53,10,2011-05-27 19:50:27,2011-05-27 19:34:08
1baf57be30c96cd20baf1e79ae02df9d22a8f049...909b1650b6e6ac8adc22295aef016f13de87085f,4,23,23,46,8,2011-05-27 21:46:59,2011-05-27 21:46:59
1885dd55c8156607b0f56c5aea1b2ad929035b50...06ecb617a272d3b23faaa73240c4f2ec3fdb265c,6,304,290,594,54,2011-07-10 17:31:52,2011-07-10 17:28:38
489eb0cde7e31ee84b48b1ad1f79d699737a9129...d5eac02d566663b92fc8ad824797d6661544075f,3,19,7,26,13,2011-07-08 19:58:43,2011-07-08 19:57:17
d5eac02d566663b92fc8ad824797d6661544075f...210fb826164d7d369fdbf6a1641a977292e0ef86,3,3,3,6,3,2011-07-08 20:11:34,2011-07-08 20:11:34
210fb826164d7d369fdbf6a1641a977292e0ef86...6a406096247049119c789b09ebeed4e2a6737700,3,39,17,56,19,2011-07-08 20:20:38,2011-07-08 20:20:38
6a406096247049119c789b09ebeed4e2a6737700...71490ced64c71e65e4cd4f3d5a0d7045077272d3,5,15,3,18,5,2011-07-08 20:23:41,2011-07-08 20:23:41
71490ced64c71e65e4cd4f3d5a0d7045077272d3...679d816dfda99bc39d62019c15d393d141dcd530,4,88,0,88,4,2011-07-08 20:55:31,2011-07-08 20:55:31
679d816dfda99bc39d62019c15d393d141dcd530...bb5d7873a772c63f33e899f14be64df51428e2fd,1,31,35,66,11,2011-07-08 21:11:49,2011-07-08 21:11:49
bb5d7873a772c63f33e899f14be64df51428e2fd...564418ff62080ac377bf4bd509cbbba72a6250f8,2,7,3,10,4,2011-07-08 21:19:28,2011-07-08 21:19:28
564418ff62080ac377bf4bd509cbbba72a6250f8...9f0e6271f90c4a668d763ffa8e35318173e4503a,3,84,0,84,3,2011-07-08 21:41:01,2011-07-08 21:41:01
9f0e6271f90c4a668d763ffa8e35318173e4503a...287b2ea59e5222aafe8807431b89ac37e67182cd,2,7,1,8,2,2011-07-08 21:55:23,2011-07-08 21:55:23
287b2ea59e5222aafe8807431b89ac37e67182cd...ca8870778a74c49ef5d53b918990ae599a23a21c,5,77,23,100,20,2011-07-08 22:23:50,2011-07-08 22:23:50
ca8870778a74c49ef5d53b918990ae599a23a21c...7f8db7fd14ff54f43f07a049bafc3eba1861612f,5,14,36,50,14,2011-07-08 23:24:17,2011-07-08 23:24:17
7f8db7fd14ff54f43f07a049bafc3eba1861612f...5c0d8651dade375fae3496933099b01e10f0c856,3,15,9,24,13,2011-07-09 05:39:08,2011-07-09 05:39:08
5c0d8651dade375fae3496933099b01e10f0c856...4cb00f4e923a42e9c1bac9f8a15a35ece7de5c9b,1,104,0,104,1,2011-07-09 05:39:34,2011-07-09 05:39:34
489eb0cde7e31ee84b48b1ad1f79d699737a9129...9b520788940bd8007c87056ee3d3f912872c752b,1,7,7,14,5,2011-07-07 15:47:36,2011-07-07 15:47:36
9b520788940bd8007c87056ee3d3f912872c752b...629b13d806fe3d98f923073832c341a77d0487d5,3,15,15,30,11,2011-07-09 05:42:26,2011-07-09 05:42:26
cc3f5da0bb6d1ddede62834e1afe1b4fede1a10b...11c1e7a906409d7748dec3193768c58739b26e45,4,31,30,61,10,2011-11-23 20:56:03,2011-11-23 20:52:56
7c461b220523d2b25036f210287036cfd690c057...2e765ae60e97b4e3d2bdafef6c0e2f8aa008476c,6,2,4,6,4,2011-07-06 19:29:48,2011-07-06 19:29:17
2e765ae60e97b4e3d2bdafef6c0e2f8aa008476c...fe11bc649368bd09063c7c06dd80da5cb3c89c7e,1,0,1,1,1,2011-07-06 22:19:45,2011-07-06 22:19:45
06ecb617a272d3b23faaa73240c4f2ec3fdb265c...475f49b6ee536219335b7372f731ae9d53df80cf,3,5,5,10,5,2011-07-16 17:16:41,2011-07-16 17:16:41
06ecb617a272d3b23faaa73240c4f2ec3fdb265c...1a456a90c77b38ad46bdc61b74e390036e8ef1b1,3,4,4,8,3,2011-07-15 23:49:25,2011-07-15 23:49:25
06ecb617a272d3b23faaa73240c4f2ec3fdb265c...5d6ec6b4a7074250b43d2c98a1d76eb2b8b97662,1,1,1,2,1,2011-07-14 23:39:34,2011-07-14 23:39:34
06ecb617a272d3b23faaa73240c4f2ec3fdb265c...54a14c7c68ec5b23fbd8cbdb7ac3bc39d2903475,3,17,5,22,5,2011-07-14 09:02:43,2011-07-14 09:02:43
06ecb617a272d3b23faaa73240c4f2ec3fdb265c...da1006c50114a38ff1cae05a42b36585632aa799,3,13,3,16,3,2011-07-12 15:42:12,2011-07-12 15:42:12
da1006c50114a38ff1cae05a42b36585632aa799...ae6ce3f37326d7eac8cee42f6e814b5c85e75baf,3,3,3,6,3,2011-07-12 15:48:27,2011-07-12 15:48:27
ae6ce3f37326d7eac8cee42f6e814b5c85e75baf...006bdfe9b8a90d396fd478fcb395bc10d80e06df,3,7,15,22,5,2011-07-12 16:32:20,2011-07-12 16:32:20
006bdfe9b8a90d396fd478fcb395bc10d80e06df...45d376dbffb84e2519fedb93276de2ecfb9eec38,3,11,9,20,5,2011-07-12 17:29:55,2011-07-12 17:29:55
06ecb617a272d3b23faaa73240c4f2ec3fdb265c...6b1a71fcd2eca822dfd43a36802357f8c21f5a66,1,1,0,1,1,2011-07-12 03:53:57,2011-07-12 03:53:57
6b1a71fcd2eca822dfd43a36802357f8c21f5a66...25aa1d4df67a6d4c8f624a551fae4f80c84fb26a,2,2,1,3,2,2011-07-17 03:37:08,2011-07-17 03:37:08
a9160b539d9c7044adce66eb3527adb01ec6efd1...fd101894588e218dcd3ea4e2ece7765462a566f8,4,6,6,12,5,2011-08-29 19:13:19,2011-08-29 19:13:19
fd101894588e218dcd3ea4e2ece7765462a566f8...69bf26e6dbf0dac601aed044892419ac445e0ed7,1,109,0,109,1,2011-08-29 23:38:12,2011-08-29 23:38:12
0bedbd739f4f7bc3edf45523ad68219292c43781...075a8789a414f1026f6fb3386861b27b39c4d651,6,37,30,67,20,2011-07-09 22:15:14,2011-07-09 22:15:14
a40876cb5501064a18d1fd36b6cf832c5d0fb555...62bcec0998b153b078b31fc0a013b6e1c60d45f7,4,86,35,121,24,2011-07-19 20:35:19,2011-07-19 20:02:01
62bcec0998b153b078b31fc0a013b6e1c60d45f7...4b5cd90c1d04241ce1f4aa5691afd677bcdcfc49,3,7,7,14,7,2011-07-19 20:58:44,2011-07-19 20:58:44
4b5cd90c1d04241ce1f4aa5691afd677bcdcfc49...55b24ff985740c72170130f80483d8e08dac2f33,3,107,43,150,11,2011-07-19 21:45:57,2011-07-19 21:45:57
55b24ff985740c72170130f80483d8e08dac2f33...de9d62316929976a5712efe364177602ab0eceee,6,78,3,81,8,2011-07-19 22:07:05,2011-07-19 22:07:05
de9d62316929976a5712efe364177602ab0eceee...8ed5d4295562776b0932948cb9f74974d7d777f4,3,7,23,30,9,2011-07-19 22:45:15,2011-07-19 22:45:15
8ed5d4295562776b0932948cb9f74974d7d777f4...8e13b182dfc6e3d28f7ed4411c826d08148bee75,2,10,10,20,10,2011-07-19 22:47:00,2011-07-19 22:47:00
8e13b182dfc6e3d28f7ed4411c826d08148bee75...3c2cb84b950965e8677aeb6901cba732f038f44a,5,18,3,21,5,2011-07-20 07:07:44,2011-07-20 07:07:44
3c2cb84b950965e8677aeb6901cba732f038f44a...d4459481b24538854930affbf2e66376c3eb27ed,2,56,0,56,2,2011-07-20 08:07:14,2011-07-20 08:07:14
d4459481b24538854930affbf2e66376c3eb27ed...6ff9103ef172ca44edc9d4e54e179cb03cf93546,6,124,123,247,29,2011-07-20 22:11:07,2011-07-20 22:11:07
6ff9103ef172ca44edc9d4e54e179cb03cf93546...9af66f9acd92b2d57e4f36e653c429fbaad07b6f,6,45,3,48,6,2011-07-20 22:21:09,2011-07-20 22:21:09
a40876cb5501064a18d1fd36b6cf832c5d0fb555...ee74c4608a25b49df153f6838a8d00f3507db68d,46,808,2,810,47,2011-07-19 00:56:30,2011-07-19 00:56:30
ee74c4608a25b49df153f6838a8d00f3507db68d...e37031a38cd1de97d6db7525683bd475b4619643,104,185,185,370,53,2011-07-19 01:08:06,2011-07-19 01:08:06
e37031a38cd1de97d6db7525683bd475b4619643...e2187aab3703803c08577f14a6331846bdbc28af,8,866,3,869,9,2011-07-20 01:44:04,2011-07-20 00:08:40
e2187aab3703803c08577f14a6331846bdbc28af...f32995e8449be82c9a293affbe5d54cce4367fbf,2,32,32,64,24,2011-07-20 19:50:06,2011-07-20 19:50:06
f32995e8449be82c9a293affbe5d54cce4367fbf...4aae4f7560bd191f22990fb0a5d9c2faec898a35,19,848,75,923,36,2011-07-20 20:56:44,2011-07-20 20:56:44
b691732401d86b3b19e5bf32ada5ca635a1ed1b5...0afaaa248f4f63810456b4f72d6f8723dbcaf159,2,3,3,6,2,2011-07-17 03:42:49,2011-07-17 03:42:49
69bf26e6dbf0dac601aed044892419ac445e0ed7...3d064526d4bc21dffbd0024f7a099bd49e8aa3f7,4,10,10,20,5,2011-08-31 11:48:01,2011-08-31 11:48:01
69bf26e6dbf0dac601aed044892419ac445e0ed7...e7ac548105765301eee615859d5c415bc11a6f30,5,48,36,84,13,2011-08-30 20:07:41,2011-08-30 20:07:41
6a9eda0b57b0ed30bccdb40d7f360f33682137a1...7c3adbd771ed787e93b499bf7e304f4b18986f6c,3,5,3,8,5,2011-07-27 17:22:00,2011-07-27 17:03:40
7c3adbd771ed787e93b499bf7e304f4b18986f6c...94f4ed23beb96d7138fa3cdca36860daa0db550e,5,21,8,29,8,2011-07-31 23:09:13,2011-07-31 23:09:13
7a1f67b1b62c166efc409bb0dc4593d13fccf197...f90bc4fd50cdf8d9e47fa01fd3428e6b7705bcd3,4,6,6,12,5,2011-09-02 18:57:59,2011-09-02 18:57:59
7a1f67b1b62c166efc409bb0dc4593d13fccf197...d237320c3990da896c2d1bee8ec20701d9a2a5c7,4,75,25,100,8,2011-09-02 10:52:24,2011-09-02 10:52:24
d237320c3990da896c2d1bee8ec20701d9a2a5c7...1e4b11546bd40a6c50997c347bed01d49fb5b67a,3,7,7,14,5,2011-09-03 20:48:19,2011-09-03 20:48:19
1e4b11546bd40a6c50997c347bed01d49fb5b67a...833bc5dddff23b56ef6f5e820340a4eaf5867302,4,17,5,22,6,2011-09-03 21:24:10,2011-09-03 21:23:08
833bc5dddff23b56ef6f5e820340a4eaf5867302...5a69dc80aa26114945d7ea6937a9a2e1dfd1c862,3,7,5,12,3,2011-09-07 07:55:37,2011-09-07 07:55:37
e2346ad471673fddd9a023686c5fc884c66b6a8d...62c7399e06f991208c2b016d3c6f53b18d7abf84,1,0,1,1,1,2011-07-31 23:14:21,2011-07-31 23:14:21
62c7399e06f991208c2b016d3c6f53b18d7abf84...65d6d9005a42efba97da91006b89437746b1c753,1,23,5,28,5,2011-08-01 00:11:34,2011-08-01 00:11:34
f90bc4fd50cdf8d9e47fa01fd3428e6b7705bcd3...8436904cb3a1ea1bda5531de9d0c9c4242332681,3,26,34,60,17,2011-09-14 18:15:50,2011-09-14 18:15:50
f90bc4fd50cdf8d9e47fa01fd3428e6b7705bcd3...3c0cdb2285e8ce82df2f0bc6955800d423ac4bbb,6,805,3,808,9,2011-09-09 22:37:59,2011-09-09 22:37:59
f90bc4fd50cdf8d9e47fa01fd3428e6b7705bcd3...d024c3f82c620681187ab15ed23e3cba28e54e11,4,26,5,31,8,2011-09-07 23:26:44,2011-09-07 23:26:44
d024c3f82c620681187ab15ed23e3cba28e54e11...ab525c4784335113a9c60f6236a9ddc2a4c63af4,5,56,21,77,18,2011-09-08 07:58:29,2011-09-08 06:09:51
ab525c4784335113a9c60f6236a9ddc2a4c63af4...feef31a49217cdaf88ff551a6cf793dc74437134,1,39,0,39,1,2011-09-08 08:00:24,2011-09-08 08:00:24
feef31a49217cdaf88ff551a6cf793dc74437134...1873142295de428f336864599549106f382d1ca6,1,10,0,10,1,2011-09-08 08:04:13,2011-09-08 08:04:13
1873142295de428f336864599549106f382d1ca6...3b629b44936d42097751dc9b6cc33cef8b3bb958,1,11,0,11,1,2011-09-08 08:12:38,2011-09-08 08:12:38
3b629b44936d42097751dc9b6cc33cef8b3bb958...8d6511a2d08bcc406854f884df14c671e27eeeb4,1,3,3,6,3,2011-09-09 07:20:55,2011-09-09 07:20:55
9523f9499866f3d249402140962a2e0b2e669c4f...817358a7b270c5fa80a317910eba20ff06555d4e,1,7,7,14,7,2011-11-23 21:04:39,2011-11-23 21:04:39
65d6d9005a42efba97da91006b89437746b1c753...ac03adf0c5b4f9a87b4f491188ff19c59fd12007,30,454,111,565,73,2011-08-01 00:28:04,2011-08-01 00:28:04
e09f19c91a44580b54a33002a88b00e67e458e30...02da7024d3686abbe1cb456aa8f90b2406338a36,1,1,1,2,1,2011-09-12 00:36:16,2011-09-12 00:36:16
e09f19c91a44580b54a33002a88b00e67e458e30...71542f6bb170b40404763dbd00423f16ccc4d105,7,69,11,80,13,2011-09-10 11:51:19,2011-09-10 11:50:08
71542f6bb170b40404763dbd00423f16ccc4d105...1e017e60b67740b8d7602951abb0d096ed37a593,4,59,7,66,8,2011-09-10 12:34:19,2011-09-10 12:34:19
1e017e60b67740b8d7602951abb0d096ed37a593...afe60a14e63fb2fc2f2ae9b77ce38bb84d9b4bba,5,46,4,50,9,2011-09-10 12:42:45,2011-09-10 12:42:45
afe60a14e63fb2fc2f2ae9b77ce38bb84d9b4bba...abc6541cd5562f6640f82af930a94962f9dcf2e4,9,264,26,290,37,2011-09-12 08:27:57,2011-09-10 14:37:39
abc6541cd5562f6640f82af930a94962f9dcf2e4...aa2ee0197b085ef6b927367293c42be457dd0573,3,5,9,14,7,2011-09-12 09:24:43,2011-09-12 09:21:54
aa2ee0197b085ef6b927367293c42be457dd0573...0a1af36dcc11c229dfc826b74eea7f30cdb15bfa,5,11,9,20,9,2011-09-12 09:56:24,2011-09-12 09:56:24
0a1af36dcc11c229dfc826b74eea7f30cdb15bfa...e284f87b0dbf8fce7f982852e84f9c3c280c2d75,7,163,119,282,30,2011-09-12 11:46:19,2011-09-12 10:53:37
e284f87b0dbf8fce7f982852e84f9c3c280c2d75...90cd1bcffa361932d7521137506d70b6f1e1c068,7,59,61,120,19,2011-09-12 12:14:37,2011-09-12 12:14:37
90cd1bcffa361932d7521137506d70b6f1e1c068...cb8afe72b95b1fe91e65007f6131ee404926d0b4,6,54,14,68,18,2011-09-12 12:45:04,2011-09-12 12:45:04
cb8afe72b95b1fe91e65007f6131ee404926d0b4...b5b187c7e93c47bf827ade7f0deee9f12b1fbf06,2,2,2,4,2,2011-09-12 12:47:23,2011-09-12 12:47:23
b5b187c7e93c47bf827ade7f0deee9f12b1fbf06...8ad87e48e7dd7c086ab366d1c8d74fb645f0af05,3,5,7,12,5,2011-09-12 13:10:45,2011-09-12 13:10:45
8ad87e48e7dd7c086ab366d1c8d74fb645f0af05...2a6c2dbfa572962b45a83414f8e41ae9f40ea1f4,3,63,59,122,15,2011-09-12 14:23:30,2011-09-12 14:23:30
2a6c2dbfa572962b45a83414f8e41ae9f40ea1f4...15dda93e3b0ce91fd294a09b0a194b07403a9fff,7,61,61,122,19,2011-09-12 16:23:32,2011-09-12 16:23:32
15dda93e3b0ce91fd294a09b0a194b07403a9fff...d832335c6dda6437ad7b2a48ffc7e753bd8f0f57,4,30,12,42,16,2011-09-12 16:32:36,2011-09-12 16:32:36
41329688c23850c28e885fa438dec3635658bef2...76b718092a0f0aad73300371c2ed43f5388c9dd3,5,18,42,60,10,2011-09-18 02:19:23,2011-09-18 02:17:09
817358a7b270c5fa80a317910eba20ff06555d4e...a752b9627f9aeb0d743ff3e6cd0b425cd70855f5,4,7,3,10,4,2011-11-30 05:36:51,2011-11-30 05:36:51
817358a7b270c5fa80a317910eba20ff06555d4e...5a87998694f05863e10830a8f1594a0b2e25af5b,97,498,498,996,490,2011-11-23 22:48:13,2011-11-23 22:46:37
5a87998694f05863e10830a8f1594a0b2e25af5b...12711f2e49aecd5b71eb576ef26464035586da22,5,20,20,40,17,2011-11-23 22:54:09,2011-11-23 22:54:09
2c52c37b8cee74ad714b879104c079978dac18d5...759071327034770c54833a2aa5896ec4e95c8e18,7,206,44,250,19,2011-08-01 18:16:38,2011-08-01 18:16:38
759071327034770c54833a2aa5896ec4e95c8e18...9cd6a46019e9eea5aca93e24365cd1efc699d27e,5,15,29,44,12,2011-08-01 18:23:26,2011-08-01 18:23:26
02da7024d3686abbe1cb456aa8f90b2406338a36...93a0a0c3702160de3b920f897e34d3342b664f2f,1,26,0,26,1,2011-09-15 18:03:28,2011-09-15 18:03:28
93a0a0c3702160de3b920f897e34d3342b664f2f...8f7803977380faeed55db6151857f8bf047f1715,6,124,27,151,6,2011-09-18 02:02:34,2011-09-18 02:02:34
02da7024d3686abbe1cb456aa8f90b2406338a36...467b89ac965307fc9ce4f1e8e797768c8e0dff7a,1,9,3,12,1,2011-09-14 18:58:18,2011-09-14 18:58:18
467b89ac965307fc9ce4f1e8e797768c8e0dff7a...9ea694e99146ab7c5914ef5d2b088c1829ec488b,1,13,10,23,5,2011-09-14 20:17:30,2011-09-14 20:17:30
9ea694e99146ab7c5914ef5d2b088c1829ec488b...b9da841fd82c8f6a69935a785a6d1ed138b9f47c,1,8,4,12,4,2011-09-14 20:23:53,2011-09-14 20:23:53
b9da841fd82c8f6a69935a785a6d1ed138b9f47c...2c93581da7e190babac355b092805c28c7240e0f,1,8,14,22,6,2011-09-14 20:38:46,2011-09-14 20:38:46
2c93581da7e190babac355b092805c28c7240e0f...2ad361722d7d6a7d3bbfda56bb039a8f2f1373ce,1,4,3,7,1,2011-09-14 20:47:07,2011-09-14 20:47:07
2ad361722d7d6a7d3bbfda56bb039a8f2f1373ce...94af2035f804676e0056f13af081d226f6aba85f,1,3,3,6,3,2011-09-14 20:54:40,2011-09-14 20:54:40
94af2035f804676e0056f13af081d226f6aba85f...d2113c47955ab85cdf85b0fd4c1536dc37e0c82c,1,15,7,22,3,2011-09-14 21:01:08,2011-09-14 21:01:08
d2113c47955ab85cdf85b0fd4c1536dc37e0c82c...f66ea6e38e551f01bb46dc05e4fbd3e343481717,1,2,3,5,2,2011-09-14 21:04:48,2011-09-14 21:04:48
f66ea6e38e551f01bb46dc05e4fbd3e343481717...8be42d56828072dde45a8eec831e74600de12fe9,1,1,5,6,2,2011-09-14 21:08:25,2011-09-14 21:08:25
8be42d56828072dde45a8eec831e74600de12fe9...286b0000de786569a4987bfbbf2c882736c8161a,1,4,4,8,4,2011-09-15 00:13:31,2011-09-15 00:13:31
286b0000de786569a4987bfbbf2c882736c8161a...93863f86070177e6ea673b993de5b50b743e804b,1,7,7,14,4,2011-09-15 00:15:38,2011-09-15 00:15:38
b678e0876de05f7503f3bc528f7af21b19b07715...46b358b8a8c43db0ab5b5314efa80ab782c4f0a6,1,1,1,2,1,2011-09-27 07:31:22,2011-09-27 07:31:22
46b358b8a8c43db0ab5b5314efa80ab782c4f0a6...14dcdea8f651b191af04164219997e880985fd41,15,547,556,1103,136,2011-09-27 07:34:22,2011-09-27 07:34:22
14dcdea8f651b191af04164219997e880985fd41...b552513e6b5ea74483d2086b908c51ecdc8c2770,3,3,3,6,3,2011-09-27 07:51:00,2011-09-27 07:51:00
b552513e6b5ea74483d2086b908c51ecdc8c2770...bd585e265eecafe61ebd3d0825e3d87c966eb9b8,5,261,244,505,20,2011-09-27 16:00:23,2011-09-27 15:58:52
bd585e265eecafe61ebd3d0825e3d87c966eb9b8...254a8e3e78ff7cc448d3657c553218bdc90478c6,3,191,250,441,3,2011-09-27 18:59:42,2011-09-27 18:55:47
254a8e3e78ff7cc448d3657c553218bdc90478c6...f473cc29021db330871cb613b9331e01e9038c5b,1,6,6,12,6,2011-09-27 19:06:23,2011-09-27 19:06:23
f473cc29021db330871cb613b9331e01e9038c5b...839442d5238f796bebe980a4e9d17e9a9e3e52aa,3,3,3,6,3,2011-09-27 19:06:48,2011-09-27 19:06:48
839442d5238f796bebe980a4e9d17e9a9e3e52aa...1b611a253ade70ba68d77db56eff33e62fc036ad,1,54,1,55,1,2011-09-27 19:13:40,2011-09-27 19:13:40
1b611a253ade70ba68d77db56eff33e62fc036ad...a81faecc859b7d27108719ce1b864a4a04f16c51,3,29,39,68,7,2011-09-27 19:14:06,2011-09-27 19:14:06
a81faecc859b7d27108719ce1b864a4a04f16c51...9e913399004324089a0d920a9fcd7c70404e692d,4,83,15,98,6,2011-09-27 19:36:06,2011-09-27 19:27:17
8a58b52c33a96846e8545b82aa0eb622fd46aad6...0a7af55aa9f156a8a62b478bb27eee71e09961f8,3,53,38,91,25,2011-09-18 03:32:04,2011-09-18 03:32:04
fe671a70e236710412a514fa276e59f875f3c617...4a35d788484ec3eaeb45e5b1632b7bc41807b97b,7,83,19,102,8,2011-12-09 01:14:08,2011-12-09 01:14:08
4a35d788484ec3eaeb45e5b1632b7bc41807b97b...a6f87e751cc24070ea0dc9b3f498c44b76b133a8,6,37,8,45,14,2011-12-09 01:49:22,2011-12-09 01:49:22
fe671a70e236710412a514fa276e59f875f3c617...9ae8feea6f05862a9c76c897d5a99334b25a0b18,4,15,2,17,6,2011-12-07 00:07:45,2011-12-07 00:07:45
12711f2e49aecd5b71eb576ef26464035586da22...2be4efd609575bfbe18bdf8362f66ea5ee5645ef,4,10,8,18,5,2011-11-30 05:55:51,2011-11-30 05:55:51
5ba1c2a06640d7ad7c39d75255bdd415b9dfa7a5...3be57161b145ce5d70fe6eec23b851328a87267c,4,738,0,738,4,2011-08-01 21:58:30,2011-08-01 21:38:46
fb38f19b2e0811c0fd0bc67bf06c8b94d1248038...fdcf3079543ddce2c4cda69c9aae9128bca11a0b,1,13,14,27,7,2011-09-21 17:08:39,2011-09-21 17:08:39
fb38f19b2e0811c0fd0bc67bf06c8b94d1248038...612d23780c6eae7095d0c338edabacf909ab0932,3,3,1,4,3,2011-09-20 19:19:04,2011-09-20 19:19:04
fb38f19b2e0811c0fd0bc67bf06c8b94d1248038...b4c086061e184bf0e047a13a4700d2db5dfb0683,3,4,4,8,3,2011-09-19 08:26:25,2011-09-19 08:18:35
fb38f19b2e0811c0fd0bc67bf06c8b94d1248038...016ed70559d0bece6f475f6a24ed37110440a0e3,1,5,5,10,1,2011-09-18 09:47:03,2011-09-18 09:46:32
016ed70559d0bece6f475f6a24ed37110440a0e3...9a8b38370b8d8df63537d9189ace3acb5dffa470,1,15,0,15,1,2011-09-18 12:43:24,2011-09-18 12:43:24
05d871b71628fc55b0507031f3268372aa0961c5...7d2ce55914d11f7017b5e0d2576d409b799bddac,1,1,1,2,1,2011-12-20 16:39:01,2011-12-20 16:39:01
05d871b71628fc55b0507031f3268372aa0961c5...bb47c1096692e944820f120a3f1bad3cf813796d,6,46,13,59,12,2011-12-15 17:55:03,2011-12-15 17:55:03
bb47c1096692e944820f120a3f1bad3cf813796d...adb57e2aa843926eef5d641bcaca9d095da96472,4,13,13,26,5,2011-12-15 19:07:12,2011-12-15 19:07:12
05d871b71628fc55b0507031f3268372aa0961c5...1a98398be0954bc4240f848baf7c33f92d4b4702,4,15,9,24,10,2011-12-14 09:15:25,2011-12-14 09:15:25
1a98398be0954bc4240f848baf7c33f92d4b4702...beab19616411a584f59cb11872771cbc56619a33,4,12,12,24,11,2011-12-14 09:22:49,2011-12-14 09:21:15
beab19616411a584f59cb11872771cbc56619a33...ac7e87e0a788b6bcab5edf5602dee006f3493585,1,2,0,2,1,2011-12-14 09:27:58,2011-12-14 09:27:58
05d871b71628fc55b0507031f3268372aa0961c5...c603af8e5efe5e1102e3330744f23df466a65477,4,35,5,40,6,2011-12-13 13:32:51,2011-12-13 13:32:51
c603af8e5efe5e1102e3330744f23df466a65477...8efedd5386878a72e5d3997b3b9038b10c025a7c,3,11,19,30,5,2011-12-13 13:39:36,2011-12-13 13:39:36
8efedd5386878a72e5d3997b3b9038b10c025a7c...f13f3b5b29c323162ec967b95bcc611b4e9e3ac3,1,1,1,2,1,2011-12-13 13:40:46,2011-12-13 13:40:46
f13f3b5b29c323162ec967b95bcc611b4e9e3ac3...23bb946a5c7f5fd23ae6d0613e3a44b9cb1c1a0a,2,2,2,4,2,2011-12-13 14:43:15,2011-12-13 14:43:15
05d871b71628fc55b0507031f3268372aa0961c5...d49c499c68e6dda9b5c4a8e3559470543057d5a4,5,13,3,16,5,2011-12-13 12:49:09,2011-12-13 12:43:37
05d871b71628fc55b0507031f3268372aa0961c5...6477daa9ee0b1a099df00458301b221c6e48a2f9,3,9,9,18,7,2011-12-11 02:24:09,2011-12-11 02:24:09
05d871b71628fc55b0507031f3268372aa0961c5...5166102c2f590887f0b856462846c0ac6f6bb1e6,2,13,9,22,2,2011-12-10 09:42:12,2011-12-10 09:42:12
5166102c2f590887f0b856462846c0ac6f6bb1e6...0fc6b900bb0593b8d7a6da9ea08c39756d34ed3f,2,4,4,8,4,2011-12-28 11:41:55,2011-12-28 11:41:55
0fc6b900bb0593b8d7a6da9ea08c39756d34ed3f...f217c23472660d37537745b2015d6b8d5a4057e8,2,8,4,12,4,2011-12-30 18:41:40,2011-12-30 18:41:40
1c1cb35aed28c14d10052a1f27fe1c569b1e60b3...b3848afccabff7a9d37c491c8eaa264054257951,1,1,0,1,1,2011-12-09 01:55:46,2011-12-09 01:55:46
3be57161b145ce5d70fe6eec23b851328a87267c...d7ae2b8527960bc5c7270ff92bec3d3dbe058485,2,123,0,123,2,2011-08-09 18:24:48,2011-08-09 18:24:48
d7ae2b8527960bc5c7270ff92bec3d3dbe058485...315864545843535d2679aca38dedece17547fe6d,1,70,0,70,1,2011-08-09 19:28:59,2011-08-09 18:25:00
315864545843535d2679aca38dedece17547fe6d...ce75813d15280f2c59ccdf2796b0202cea740ce2,1,8,9,17,5,2011-08-09 19:29:17,2011-08-09 19:29:17
ce75813d15280f2c59ccdf2796b0202cea740ce2...ed71513b99efa509598183c0b08decba35bfc3fd,1,3,2,5,1,2011-08-10 01:52:52,2011-08-10 01:52:52
3be57161b145ce5d70fe6eec23b851328a87267c...dce7571381c9be26b33d1964abc7f0b02d2b8aa7,1,2,1,3,1,2011-08-08 02:50:47,2011-08-08 02:50:47
dce7571381c9be26b33d1964abc7f0b02d2b8aa7...3269658557e0c98bba411ad943c11aa1c45ce1d9,2,3,2,5,2,2011-08-08 02:51:41,2011-08-08 02:51:41
c974d3a941cf04900011cdfd4a6752df735ce0fe...f1c6adca8fa11fb9f9bcad8d53223e1151913491,1,6,8,14,4,2011-09-26 12:20:04,2011-09-26 12:20:04
c974d3a941cf04900011cdfd4a6752df735ce0fe...a6eb9284908fdd3853c26d70212e701701c805a7,5,276,1,277,5,2011-09-25 23:58:59,2011-09-25 22:40:28
a6eb9284908fdd3853c26d70212e701701c805a7...11c110465eeb1b6fcad9e3b6d1819a11426feb77,3,71,7,78,5,2011-09-26 01:37:51,2011-09-26 01:37:51
c974d3a941cf04900011cdfd4a6752df735ce0fe...46891e93eb1cf8f49d8e2d4beaee2e10fe40fdbc,2,5,4,9,2,2011-09-24 22:47:06,2011-09-24 22:47:06
c974d3a941cf04900011cdfd4a6752df735ce0fe...4e0edeb423e0f1604eb89296e19d6a4a5d6db783,4,32,16,48,25,2011-09-22 22:47:35,2011-09-22 22:22:08
4e0edeb423e0f1604eb89296e19d6a4a5d6db783...a7c318b138dba8651dae8dad604c0e7d71a49411,3,7,7,14,5,2011-09-22 22:50:30,2011-09-22 22:50:30
c974d3a941cf04900011cdfd4a6752df735ce0fe...7895afbda5d60eefa56c1851561b6a5c90175a21,4,64,21,85,12,2011-09-21 22:32:19,2011-09-21 22:32:19
5d0dbe29cf095a0d30c45166f6944fbde76e5298...80fafd527c92464e52fd9842446ddd2cb6521c1e,8,54,10,64,16,2011-09-27 15:45:06,2011-09-27 15:45:06
9a8b38370b8d8df63537d9189ace3acb5dffa470...0ca32a8f69b0f8342d582cf930b7e2ef8a9cf7c9,4,125,8,133,16,2011-09-20 23:20:06,2011-09-20 23:20:06
0ca32a8f69b0f8342d582cf930b7e2ef8a9cf7c9...af05f527c121c629db412d61716b4a07a38df104,1,7,7,14,6,2011-09-21 00:10:42,2011-09-21 00:10:42
af05f527c121c629db412d61716b4a07a38df104...4918c83f41bd8dabf099458e5ebfdd0be8c6d232,2,5,3,8,5,2011-09-21 00:23:55,2011-09-21 00:23:55
4918c83f41bd8dabf099458e5ebfdd0be8c6d232...8914a389812644fa3b8c89157ebff02ae8fcc7bd,2,2,1,3,2,2011-09-21 01:14:00,2011-09-21 01:14:00
9a8b38370b8d8df63537d9189ace3acb5dffa470...6ca72c41e7aa2cc7e8f3e710c965e542aed25983,2,2,0,2,2,2011-09-20 22:08:51,2011-09-20 10:05:09
6ca72c41e7aa2cc7e8f3e710c965e542aed25983...dbd738353db760f3c592d22e5c229c79bfddf645,3,3,4,7,3,2011-09-20 23:38:52,2011-09-20 23:38:52
6a65451b90edb379d2f374cdb720f5d9fbc1567f...bbcaa27732b4d6be464c900344e6da61951e4990,5,161,84,245,33,2011-09-27 21:58:39,2011-09-27 21:58:39
7d2ce55914d11f7017b5e0d2576d409b799bddac...2aecd70a364b564c223781b38334bb5059ab6dcb,1,1,1,2,1,2011-12-27 08:32:15,2011-12-27 08:32:15
7d2ce55914d11f7017b5e0d2576d409b799bddac...da76aa249c451fa1e3bb56c4996a26d315f390d0,2,8,4,12,4,2011-12-20 22:22:01,2011-12-20 22:22:01
da76aa249c451fa1e3bb56c4996a26d315f390d0...7d298c0e8f0ee76e60fbdd967a2e7eff532cda97,2,4,4,8,4,2011-12-27 10:24:46,2011-12-27 10:24:46
3e6969d0a492fc06b3bdffcf2c34f87701e21492...09c6e51dbd60f480a0486d1bb7f26c16c0fa8334,4,8,7,15,7,2011-12-30 19:22:13,2011-12-30 19:16:49
09c6e51dbd60f480a0486d1bb7f26c16c0fa8334...6c80963884b88d32d2ced16c56acd7343518447a,3,18,14,32,5,2011-12-30 19:24:59,2011-12-30 19:24:59
ed71513b99efa509598183c0b08decba35bfc3fd...0e9589d1f246b85d85746810fdbe0ea34203bb43,4,148,0,148,4,2011-08-13 01:07:42,2011-08-13 01:07:42
0e9589d1f246b85d85746810fdbe0ea34203bb43...07b068ea6ca80521024f4e13945fe3237fa2bf38,1,53,0,53,1,2011-08-13 04:42:40,2011-08-13 04:42:40
07b068ea6ca80521024f4e13945fe3237fa2bf38...1035e71450d7b35f51fdf7de5684a5ee00e8a05e,1,63,0,63,1,2011-08-13 04:50:50,2011-08-13 04:50:50
1035e71450d7b35f51fdf7de5684a5ee00e8a05e...53326dac6cd809c29c43c426dd55413b97b2441f,3,207,0,207,3,2011-08-13 04:52:10,2011-08-13 04:52:10
53326dac6cd809c29c43c426dd55413b97b2441f...822bcdd1a1fd3c3ce8fdde1460fb38c4bfeebaff,2,54,96,150,4,2011-08-13 04:52:45,2011-08-13 04:52:45
822bcdd1a1fd3c3ce8fdde1460fb38c4bfeebaff...1444698b22e0ace3df6559b36e7f362db9dedc0a,7,219,24,243,25,2011-08-13 06:26:46,2011-08-13 06:26:46
1444698b22e0ace3df6559b36e7f362db9dedc0a...2fb6d98ef158d8942c7df4683a927e2a3069731c,3,98,0,98,8,2011-08-13 06:58:56,2011-08-13 06:58:56
2fb6d98ef158d8942c7df4683a927e2a3069731c...d59f7a9f6f346f5a06e6b6d615ade0fbdf2ea94f,1,103,0,103,1,2011-08-13 17:18:40,2011-08-13 17:18:40
d59f7a9f6f346f5a06e6b6d615ade0fbdf2ea94f...b881b520eac6a4ffc45095a16dd710ba43e770a4,4,0,61,61,4,2011-08-13 17:18:49,2011-08-13 17:18:49
b881b520eac6a4ffc45095a16dd710ba43e770a4...7a6ebbfb151e2fbe6e1115fb758e2aa08b4a889a,2,0,119,119,2,2011-08-13 17:19:14,2011-08-13 17:19:14
7a6ebbfb151e2fbe6e1115fb758e2aa08b4a889a...983d77ba98f65b1d7f1d81f655f60f6cb3fadc84,3,65,31,96,3,2011-08-13 17:26:40,2011-08-13 17:26:24
983d77ba98f65b1d7f1d81f655f60f6cb3fadc84...ca424e17241046239d7d8108bf13e1e1954e9f73,3,187,63,250,3,2011-08-13 17:48:01,2011-08-13 17:48:01
ca424e17241046239d7d8108bf13e1e1954e9f73...7718469d91d6ee6d625d0631cbc0d5197a17ded0,1,53,0,53,1,2011-08-13 18:00:52,2011-08-13 18:00:52
7718469d91d6ee6d625d0631cbc0d5197a17ded0...c22d45027ce5971420f871f725addde39bd341f7,8,65,0,65,8,2011-08-13 18:13:38,2011-08-13 18:13:38
c22d45027ce5971420f871f725addde39bd341f7...badce35c7632aa1f909f0946a2686645f8db2066,1,47,0,47,1,2011-08-13 18:28:40,2011-08-13 18:28:40
badce35c7632aa1f909f0946a2686645f8db2066...2ed5801e72f8001faef46930ca7ae36778598c32,1,51,0,51,1,2011-08-13 18:34:41,2011-08-13 18:34:41
2ed5801e72f8001faef46930ca7ae36778598c32...68e9f96f03b8f1a2593ac605fe226302282541e0,1,50,0,50,1,2011-08-13 18:36:39,2011-08-13 18:36:39
68e9f96f03b8f1a2593ac605fe226302282541e0...f4a7a610f69bde9909e447f7e5e00f5ef9a4d151,1,77,0,77,1,2011-08-13 21:23:02,2011-08-13 21:23:02
f4a7a610f69bde9909e447f7e5e00f5ef9a4d151...f58bed27fdd051215573fa2662991436e064013f,1,103,0,103,1,2011-08-13 21:43:04,2011-08-13 21:43:04
f58bed27fdd051215573fa2662991436e064013f...f72cc3535904abd1364b1987b169f12bdacf6c76,1,115,0,115,1,2011-08-13 23:45:10,2011-08-13 23:45:10
f72cc3535904abd1364b1987b169f12bdacf6c76...94800d39d2f6b22bef10c6921ee44906dcaa85d3,2,70,0,70,2,2011-08-14 00:27:54,2011-08-14 00:27:54
94800d39d2f6b22bef10c6921ee44906dcaa85d3...247a6c6e9db2c2ecfd11db5ebb748133e7950552,2,74,0,74,2,2011-08-14 00:33:45,2011-08-14 00:33:45
247a6c6e9db2c2ecfd11db5ebb748133e7950552...8986f76af67963b906e9729a671a50ea3c070090,1,18,0,18,1,2011-08-14 01:04:34,2011-08-14 01:04:34
8986f76af67963b906e9729a671a50ea3c070090...354765c3092f144cdb9b2b8edf481043d9773969,3,162,2,164,3,2011-08-14 01:05:02,2011-08-14 01:05:02
354765c3092f144cdb9b2b8edf481043d9773969...b65f4de740eb9d2098fa7cc80bb619a062438409,1,9,0,9,2,2011-08-14 01:08:34,2011-08-14 01:08:34
b65f4de740eb9d2098fa7cc80bb619a062438409...c88d9d14c9b4343e2dc78ae9ef2b1740c48b3d98,1,28,1,29,1,2011-08-14 01:15:14,2011-08-14 01:15:14
c88d9d14c9b4343e2dc78ae9ef2b1740c48b3d98...e7ad8bb185ce2a57ced42f1705e9d52c3f480825,1,122,0,122,1,2011-08-14 01:22:13,2011-08-14 01:22:13
e7ad8bb185ce2a57ced42f1705e9d52c3f480825...5f5d8a227eb14f26f5c29515ea0fb2dfda1b00c8,14,79,2,81,27,2011-08-14 01:40:38,2011-08-14 01:40:38
5f5d8a227eb14f26f5c29515ea0fb2dfda1b00c8...ca8476097d7fc7068a7691b1a63ba7b8f42046b3,1,39,0,39,1,2011-08-14 01:46:20,2011-08-14 01:46:20
ca8476097d7fc7068a7691b1a63ba7b8f42046b3...695834b99d1c5e2b428dae5d3596211f10ac4b1e,4,0,62,62,4,2011-08-14 01:47:23,2011-08-14 01:47:23
695834b99d1c5e2b428dae5d3596211f10ac4b1e...9d85f339f806389e0da0ab2019caacccdfec60de,1,87,0,87,1,2011-08-14 02:10:38,2011-08-14 02:10:38
9d85f339f806389e0da0ab2019caacccdfec60de...96c2a750bb72667ef3f2738801aa571c91b5113a,1,2,2,4,2,2011-08-14 02:25:54,2011-08-14 02:25:54
96c2a750bb72667ef3f2738801aa571c91b5113a...e6638b66b8da1dc6f1e5e42c8198f92368a54550,6,100,148,248,6,2011-08-14 05:45:02,2011-08-14 05:45:02
e6638b66b8da1dc6f1e5e42c8198f92368a54550...318b6713e173d4c84bfaa4ca38a42d705fdf3421,3,32,39,71,3,2011-08-14 05:54:08,2011-08-14 05:54:08
318b6713e173d4c84bfaa4ca38a42d705fdf3421...6b74562910ab72d990d1b812aa330b3e4aa865f2,3,47,56,103,3,2011-08-14 06:00:24,2011-08-14 06:00:24
6b74562910ab72d990d1b812aa330b3e4aa865f2...5f998d68e391f04e059730ec1d9e3d740a22f8e0,3,31,23,54,3,2011-08-14 06:09:37,2011-08-14 06:09:37
5f998d68e391f04e059730ec1d9e3d740a22f8e0...15d7e87fdb1dd18e1202a5f2d15d97eaff609010,2,38,3,41,4,2011-08-14 06:13:28,2011-08-14 06:13:10
15d7e87fdb1dd18e1202a5f2d15d97eaff609010...80ca9b8f8e722abd2cc6babbff15c8191a259686,1,43,0,43,1,2011-08-14 16:03:00,2011-08-14 16:03:00
80ca9b8f8e722abd2cc6babbff15c8191a259686...cb7ebe11e81c2b25f8d5b968c523e013d5c41271,3,53,65,118,3,2011-08-14 16:11:33,2011-08-14 16:11:33
cb7ebe11e81c2b25f8d5b968c523e013d5c41271...01fb201f4efa8778748128aea3eb91f7dace9adf,3,70,141,211,3,2011-08-14 16:29:42,2011-08-14 16:29:42
01fb201f4efa8778748128aea3eb91f7dace9adf...6d138b2510600e1e86371f89178d165372fb8226,3,200,366,566,3,2011-08-14 17:11:37,2011-08-14 17:11:37
6d138b2510600e1e86371f89178d165372fb8226...3685a428fe55252527c6e072ce171b0004685d47,4,101,93,194,4,2011-08-14 17:53:34,2011-08-14 17:44:58
3685a428fe55252527c6e072ce171b0004685d47...3771bf5f64da908ece308b0b7e0e0012dcd7113d,4,90,96,186,5,2011-08-14 18:16:03,2011-08-14 18:16:03
3771bf5f64da908ece308b0b7e0e0012dcd7113d...0cd0ede54617cad4416b54961ca6a8e1f8edbc0e,3,203,150,353,3,2011-08-14 18:52:59,2011-08-14 18:52:59
0cd0ede54617cad4416b54961ca6a8e1f8edbc0e...03253fcff68f2efe6fb84b41343c78f73022bd5b,4,236,376,612,4,2011-08-14 19:57:09,2011-08-14 19:57:09
03253fcff68f2efe6fb84b41343c78f73022bd5b...3a5a6c6c0d1ff21e7a24b00908df6fcc5bf9cd7a,3,44,24,68,3,2011-08-14 20:07:20,2011-08-14 20:07:20
3a5a6c6c0d1ff21e7a24b00908df6fcc5bf9cd7a...26c69879c9227accbbf4489bb49bd4d15015d309,6,104,30,134,6,2011-08-14 21:37:24,2011-08-14 21:37:24
26c69879c9227accbbf4489bb49bd4d15015d309...08d785f6eaca26d9f541948df98d50abd4e5366d,3,89,65,154,3,2011-08-15 00:01:15,2011-08-15 00:01:15
08d785f6eaca26d9f541948df98d50abd4e5366d...e7d1a0a9b58f9a168fbef752d3f10458dbbb115a,4,67,38,105,5,2011-08-15 00:20:28,2011-08-15 00:20:28
e7d1a0a9b58f9a168fbef752d3f10458dbbb115a...c7eecb96279d1cd0dc87b5c106c34e8cd53b1955,3,103,113,216,3,2011-08-15 01:14:59,2011-08-15 01:14:59
c7eecb96279d1cd0dc87b5c106c34e8cd53b1955...b849f027bd7e1ab5c1f9c0982cdf7b596c7dace7,3,85,80,165,3,2011-08-15 01:59:01,2011-08-15 01:59:01
b849f027bd7e1ab5c1f9c0982cdf7b596c7dace7...4be8e48d4d0a6dfb70067a4ecdf6116e068301bd,3,43,32,75,3,2011-08-15 02:16:56,2011-08-15 02:16:56
4be8e48d4d0a6dfb70067a4ecdf6116e068301bd...4ee4398d6f6affcc670829de50163ebf9f03b177,1,35,1,36,2,2011-08-15 02:22:27,2011-08-15 02:22:27
4ee4398d6f6affcc670829de50163ebf9f03b177...356d30ce283db8d25e4cb2a443ffc62c643c14fc,5,87,64,151,5,2011-08-15 02:38:02,2011-08-15 02:38:02
356d30ce283db8d25e4cb2a443ffc62c643c14fc...959b8f9d18fabba158b78ff85dd5fa67d2db8590,3,53,36,89,3,2011-08-15 02:51:53,2011-08-15 02:51:53
959b8f9d18fabba158b78ff85dd5fa67d2db8590...a8d023d6f4d7688d266fe9e3a4d653b659d186b3,3,89,68,157,3,2011-08-15 03:02:49,2011-08-15 03:02:49
a8d023d6f4d7688d266fe9e3a4d653b659d186b3...3b38d71d2ed54d90e18750e877cb3036d4e6e3ee,4,64,0,64,8,2011-08-15 03:18:58,2011-08-15 03:18:58
3b38d71d2ed54d90e18750e877cb3036d4e6e3ee...af8f0c571f3e304a3be1a44cc95a22d01fba645c,3,41,36,77,3,2011-08-15 03:23:23,2011-08-15 03:23:23
af8f0c571f3e304a3be1a44cc95a22d01fba645c...521ca64a3355c7bf0534cee6198d41bfeccc12c5,3,101,70,171,3,2011-08-15 03:29:08,2011-08-15 03:29:08
521ca64a3355c7bf0534cee6198d41bfeccc12c5...69061ea5d1687e8765d9864d8264b093d38ea81b,3,59,36,95,3,2011-08-15 03:38:02,2011-08-15 03:38:02
69061ea5d1687e8765d9864d8264b093d38ea81b...e90a4666c38cfa066b386566a90df949f71d44aa,3,105,85,190,3,2011-08-15 03:47:20,2011-08-15 03:47:20
e90a4666c38cfa066b386566a90df949f71d44aa...9c56e7fd0e655940d4fb2497a226da7daf49f4ab,3,41,36,77,3,2011-08-15 03:54:48,2011-08-15 03:54:48
9c56e7fd0e655940d4fb2497a226da7daf49f4ab...5f29160efc15fe78276ea2ce2dce314e52d893a8,3,73,72,145,3,2011-08-15 03:55:11,2011-08-15 03:55:11
5f29160efc15fe78276ea2ce2dce314e52d893a8...6e7047fe5b9acfed7902a1ba61f643c523bffc9a,3,35,12,47,3,2011-08-15 04:03:01,2011-08-15 04:03:01
6e7047fe5b9acfed7902a1ba61f643c523bffc9a...7e04c3888ddc899b7b7c5a739f94617d789ab540,3,119,72,191,4,2011-08-15 04:28:10,2011-08-15 04:28:10
7e04c3888ddc899b7b7c5a739f94617d789ab540...3c3c9d122db7d7db892eb5107df68b613093b735,3,122,72,194,3,2011-08-15 04:30:17,2011-08-15 04:30:17
3c3c9d122db7d7db892eb5107df68b613093b735...9a05f86c924c998b87ea5ca85da8e28d7b68a1c5,7,156,303,459,8,2011-08-15 04:50:20,2011-08-15 04:50:20
9a05f86c924c998b87ea5ca85da8e28d7b68a1c5...b0d911e90e7d74ef7c5763cd3e42ceeb9e80dad3,5,471,1340,1811,5,2011-08-15 18:40:42,2011-08-15 18:40:42
b0d911e90e7d74ef7c5763cd3e42ceeb9e80dad3...aa5ac0342ec1ba3d07ab6f861e898007cad0d5c3,4,67,18,85,4,2011-08-15 19:16:14,2011-08-15 19:16:14
aa5ac0342ec1ba3d07ab6f861e898007cad0d5c3...aae78283b17c09379525753340f7d8ec3d664a5e,3,95,188,283,3,2011-08-15 19:50:20,2011-08-15 19:50:20
aae78283b17c09379525753340f7d8ec3d664a5e...5e9bead57f4297ebaa9a93800af5f456e5a1d675,3,83,143,226,3,2011-08-15 19:55:42,2011-08-15 19:55:42
5e9bead57f4297ebaa9a93800af5f456e5a1d675...b7e1413295f6d875243b584eb8384abb2b39f16c,3,96,106,202,3,2011-08-15 20:07:28,2011-08-15 20:07:28
b7e1413295f6d875243b584eb8384abb2b39f16c...f25c469d3d9249f066eb2daa42d2402f480319ce,3,91,41,132,3,2011-08-15 20:32:34,2011-08-15 20:32:34
f25c469d3d9249f066eb2daa42d2402f480319ce...67ab76bcc15803843cd42013b194d8822fc7dd4b,6,155,128,283,8,2011-08-15 21:12:17,2011-08-15 21:12:17
67ab76bcc15803843cd42013b194d8822fc7dd4b...9a2c6a065783b9d6182283205b098b391b6dde6a,7,141,210,351,11,2011-08-15 22:12:54,2011-08-15 22:12:54
9a2c6a065783b9d6182283205b098b391b6dde6a...9684389ea0bfc9da6b20e219739785ca6fa2558f,3,139,188,327,3,2011-08-15 22:26:10,2011-08-15 22:22:39
9684389ea0bfc9da6b20e219739785ca6fa2558f...7c25304ffe07a0ce1fd6bdcb45c768281c04620b,4,13,66,79,5,2011-08-15 22:30:55,2011-08-15 22:30:26
7c25304ffe07a0ce1fd6bdcb45c768281c04620b...780bf7cc070c1a23a5424dde768230d20701ecb6,3,76,140,216,3,2011-08-15 22:42:01,2011-08-15 22:42:01
780bf7cc070c1a23a5424dde768230d20701ecb6...0872e949ba96c9dae960fd3adfa5f7fd1a079187,3,176,146,322,3,2011-08-15 22:53:46,2011-08-15 22:53:46
0872e949ba96c9dae960fd3adfa5f7fd1a079187...d6f4b2a29913723ba56d77043fe4e9e474f75c31,3,166,89,255,5,2011-08-15 23:02:41,2011-08-15 23:02:41
d6f4b2a29913723ba56d77043fe4e9e474f75c31...cdfbca94a57d2a55fc930a1f66b70d5d39be66bb,3,64,247,311,3,2011-08-15 23:25:39,2011-08-15 23:25:39
cdfbca94a57d2a55fc930a1f66b70d5d39be66bb...59707f967eda5345b7188e69f1ea80b60a885ac0,26,2,37114,37116,27,2011-08-15 23:28:48,2011-08-15 23:28:48
ed71513b99efa509598183c0b08decba35bfc3fd...5d17075bf3875c7cda7e404ec0dfe1ca0b529eaf,12,207,143,350,78,2011-08-12 22:58:42,2011-08-06 16:09:27
ed71513b99efa509598183c0b08decba35bfc3fd...9579eedc3e57748a160e86373acd8dc90a50fde3,1,2,1,3,1,2011-08-11 08:22:17,2011-08-08 02:50:47
9579eedc3e57748a160e86373acd8dc90a50fde3...23d11dadc157377d984197590bfd42d43ac382ce,2,3,2,5,2,2011-08-11 08:22:18,2011-08-08 02:51:41
115caa63e6e2f0cc396b4fa65c9fddb99fd1d765...7d93964615f8d8322edb2603be930fda79897deb,2,7,3,10,3,2011-09-27 20:53:46,2011-09-27 20:45:34
fe83f16321d67e650003f539eb0196190efd6833...b5dc45a87c4fe9052ad77180251dd2d7ce4af09e,4,102,146,248,34,2011-10-11 04:13:25,2011-10-11 04:13:25
9e16bee0a5feed109df5454f345a6e1ff397bf00...927426f79f56802aa99e6620be714646bcee3b7b,4,61,4,65,6,2011-09-29 10:30:20,2011-09-28 20:10:59
927426f79f56802aa99e6620be714646bcee3b7b...adec0a64906e78f78e734bcb39f5aff61e9cf9ae,3,5,7,12,3,2011-09-29 15:33:34,2011-09-29 15:33:34
adec0a64906e78f78e734bcb39f5aff61e9cf9ae...cf882501efb75850e073a8421bf573a35c4d6498,3,17,23,40,5,2011-09-30 06:51:33,2011-09-30 06:51:33
9e16bee0a5feed109df5454f345a6e1ff397bf00...caefcaa0cc38018350de7d6005ae95c8657a1d1d,1,70,0,70,1,2011-09-28 22:37:50,2011-09-28 22:28:36
caefcaa0cc38018350de7d6005ae95c8657a1d1d...cd3d236015cc2206186b359227f54c4fc761a648,5,15,11,26,8,2011-09-29 22:00:51,2011-09-29 21:59:56
cd3d236015cc2206186b359227f54c4fc761a648...6804a60fe4899fa83586bad51b45ad94ef215203,9,125,111,236,43,2011-09-30 04:53:22,2011-09-30 04:53:22
5804a833a5667be9c645036f99daa8cf95ab677b...2d660756bb14ad9e54ff7f20f805133a3a90b36e,2,18,14,32,4,2011-12-27 18:08:22,2011-12-27 18:08:22
a92f8b3ed092f7b1eeb5c92a473121e67836bef8...1becccbdf625abd06ab8065bbda074d1bcb91b49,1,1,4,5,2,2012-01-13 13:16:14,2012-01-13 13:16:14
a92f8b3ed092f7b1eeb5c92a473121e67836bef8...30e6f51672fe4f8fb5fae5f025331153b271b501,6,119,61,180,8,2012-01-09 08:29:30,2012-01-09 01:32:12
30e6f51672fe4f8fb5fae5f025331153b271b501...b426e78dce9049c1339fcccd147f2ff17a68eaab,4,12,12,24,6,2012-01-09 08:35:57,2012-01-09 08:35:57
b426e78dce9049c1339fcccd147f2ff17a68eaab...7f4507fc38cba6413ee36b71aff8edca4cd905b3,6,26,26,52,21,2012-01-09 08:39:57,2012-01-09 08:39:57
7f4507fc38cba6413ee36b71aff8edca4cd905b3...2e098512907e8aa918ab995ce410eab8477c782a,10,15,15,30,15,2012-01-09 08:41:36,2012-01-09 08:41:36
2e098512907e8aa918ab995ce410eab8477c782a...2936a6b1e7f338364dbf816bcbe5dbb27f2cf705,3,1571,1567,3138,224,2012-02-14 18:45:13,2012-02-14 18:45:13
2936a6b1e7f338364dbf816bcbe5dbb27f2cf705...6a0ad0247a191a3008106bd3f71687a4e5d48581,3,6,30,36,3,2012-02-14 18:46:48,2012-02-14 18:46:48
6a0ad0247a191a3008106bd3f71687a4e5d48581...4f506339d46cbbcad0887033bf31243df839af07,2,2,0,2,2,2012-02-14 18:49:16,2012-02-14 18:49:16
4f506339d46cbbcad0887033bf31243df839af07...15357fa43e0bef31606e401e18ea9e13f054af07,3,6,4,10,3,2012-02-19 20:03:58,2012-02-19 19:54:32
15357fa43e0bef31606e401e18ea9e13f054af07...a59ade5f556952781884c306368b58b6404ae128,21,95,95,190,46,2012-02-19 20:10:47,2012-02-19 20:10:47
a92f8b3ed092f7b1eeb5c92a473121e67836bef8...5bae5f47889e751e5ebf3560814c8cb1c57af6e1,1,10,0,10,1,2012-01-01 19:44:49,2012-01-01 19:44:49
a92f8b3ed092f7b1eeb5c92a473121e67836bef8...b9a03ad84a0418db368a68cac3828469e5f8d5be,3,3,3,6,3,2011-12-31 09:28:42,2011-12-31 09:28:42
ceb5f7cc94b3fc8400ed900a6dc6a7354191c5b6...c8ad125aee43184b464b79b0652df3e76707ed2f,8,110,6,116,9,2011-08-16 04:23:34,2011-08-16 04:23:34
c8ad125aee43184b464b79b0652df3e76707ed2f...09c5e5157d568cac0850e1ed41da1f7f60c66426,1,27,0,27,1,2011-08-16 04:29:55,2011-08-16 04:29:55
09c5e5157d568cac0850e1ed41da1f7f60c66426...aa1ef3ba3b92d427272ebfa9326ceb7c1021aa76,1,34,0,34,1,2011-08-16 04:41:03,2011-08-16 04:41:03
aa1ef3ba3b92d427272ebfa9326ceb7c1021aa76...d756660748bddaba66e9a642b5c1fd4ec05d4bc7,1,29,0,29,1,2011-08-16 04:47:14,2011-08-16 04:47:14
d756660748bddaba66e9a642b5c1fd4ec05d4bc7...a0e3e84972f3ca30e0ed4acfb62433b174119a69,1,38,0,38,1,2011-08-16 05:19:58,2011-08-16 05:19:58
37a84d9117fe2f6295f61bef6967d98b6aa4846f...80a4078e8dbd0a7014be1cc0723f784233f57073,1,39,0,39,1,2011-08-15 23:43:59,2011-08-15 23:43:59
c513f515c6a00d40293b46049f4b2d18c8d4f3c1...d2b152ce7f1d09c5eb8c73ba795695b11496f539,10,1099,661,1760,60,2011-08-18 21:59:55,2011-08-18 21:59:55
9e303516f094dd3ad516b36314a956e3a41d0ddb...05e9a39837e4c07fe1f2482d8001c82a49c1def0,5,28,22,50,14,2011-10-07 19:22:56,2011-10-07 19:19:30
6804a60fe4899fa83586bad51b45ad94ef215203...ad066cd9034ea5045ab09ace6858f94f8ca41802,1,661,0,661,1,2011-10-01 00:59:54,2011-09-30 16:01:24
6804a60fe4899fa83586bad51b45ad94ef215203...68f555bfc23f4bd9c07f008eb8bd3c9c6784459a,1,4,0,4,1,2011-09-30 15:55:30,2011-09-30 15:55:30
6804a60fe4899fa83586bad51b45ad94ef215203...886b6599bbf7d81f20c3ef650bf86ee3e4a15a10,1,23,2,25,2,2011-09-30 07:43:22,2011-09-30 07:43:22
886b6599bbf7d81f20c3ef650bf86ee3e4a15a10...c7f58466ad83cefa33afe3ab32f2d178839bd873,1,2,3,5,2,2011-09-30 07:48:28,2011-09-30 07:48:28
9c124a687e8e4ed112d99530f39fdfd1ce30f09e...24cb609addab814573d9c26351462da81d6d0b23,1,1,1,2,1,2012-02-19 23:20:30,2012-02-19 23:20:30
24cb609addab814573d9c26351462da81d6d0b23...1a6efaddca9082cd57e4a1bc1dc87cf7fbabf44b,3,8,8,16,3,2012-02-19 23:20:56,2012-02-19 23:20:56
1a6efaddca9082cd57e4a1bc1dc87cf7fbabf44b...12ac60d273e372120088d2e6bc9ca011df78be2a,1,93,0,93,1,2012-02-19 23:54:42,2012-02-19 23:54:42
12ac60d273e372120088d2e6bc9ca011df78be2a...064822630ec25d284802d2a1ccf37d792ecd80a7,3,6,6,12,3,2012-02-19 23:56:06,2012-02-19 23:56:06
5bae5f47889e751e5ebf3560814c8cb1c57af6e1...149d174029e082dd1926dc6ba8fd1354ef32d62d,4,18,8,26,8,2012-01-01 20:15:22,2012-01-01 20:15:22
149d174029e082dd1926dc6ba8fd1354ef32d62d...d3d4ceecbbd020e3552248d8661920f3333f096e,3,25,1,26,17,2012-01-02 00:58:38,2012-01-02 00:58:38
930029ecbed412018c55fce39b8bf9a2f33fc7ab...f21d6b826bfdf74cfe43636e9755e66e0569759a,4,39,29,68,10,2012-01-17 21:02:19,2012-01-17 21:02:19
41f769e36c1d5a93cf1b0f36a5d6a0e35ad1fc53...ffb445bb1b581dd1e780d043cb130479300e5681,4,56,3,59,4,2011-08-16 17:51:55,2011-08-16 17:51:55
ffb445bb1b581dd1e780d043cb130479300e5681...22732f5da8a6bbf80d7b57fc206c57ca829068d3,1,50,0,50,1,2011-08-16 17:59:34,2011-08-16 17:59:34
22732f5da8a6bbf80d7b57fc206c57ca829068d3...eccef138e6f9bde5b1166bbb686f432260e7eb90,4,109,6,115,4,2011-08-16 18:16:53,2011-08-16 18:16:53
eccef138e6f9bde5b1166bbb686f432260e7eb90...7d018fbc41a40b8832026c0ed8b86233dcd48e57,1,116,0,116,1,2011-08-16 18:32:32,2011-08-16 18:32:32
7d018fbc41a40b8832026c0ed8b86233dcd48e57...e3886060b956e5d1ec203bd19b05a1a62c1be4a9,4,133,4,137,4,2011-08-16 19:26:47,2011-08-16 19:26:47
672b331283466feb0e7e787658fbcb57f728e4f1...4adfae719aef489843a47a4a41a5436d1be3d667,1,83,0,83,1,2011-10-11 04:40:52,2011-10-11 04:40:52
9edd4bc05833d15fe9f0f671b4556f899782b455...b9db0585cb8ae38e039b33923e439967e5e52291,3,4,4,8,4,2011-10-07 23:09:59,2011-10-07 23:09:59
b9db0585cb8ae38e039b33923e439967e5e52291...bf73f5c506edf1353a48bb403065d6b45e959c21,2,2,2,4,2,2011-10-08 11:42:45,2011-10-08 11:42:45
bf73f5c506edf1353a48bb403065d6b45e959c21...7a8460ede088710dc7f41c6480708be10b4674a3,1,1,0,1,1,2011-10-08 13:01:35,2011-10-08 12:58:41
9edd4bc05833d15fe9f0f671b4556f899782b455...0e0ba0890091071f55270ae37ffba50c212c6326,7,17,13,30,13,2011-10-07 22:37:51,2011-10-07 22:37:51
fe6128180e8741be1fd40c60175a129fbc41513a...4d1de5e175eb6a6d349c7fc1d2ae9017e45cfeda,5,33,22,55,17,2011-10-07 18:32:06,2011-10-07 18:32:06
fe6128180e8741be1fd40c60175a129fbc41513a...878d1c1c13e2c5d4f731604117def8e290e3bb62,5,36,5,41,10,2011-10-05 21:35:19,2011-10-05 21:35:19
878d1c1c13e2c5d4f731604117def8e290e3bb62...f5c60ecfded3080cc56c13b9ea164aac3858ac30,3,3,3,6,3,2011-10-05 21:38:30,2011-10-05 21:38:30
f5c60ecfded3080cc56c13b9ea164aac3858ac30...db65a3849f198663e26dcd596b277e1405e8bfb3,5,14,13,27,8,2011-10-05 22:05:42,2011-10-05 22:05:42
db65a3849f198663e26dcd596b277e1405e8bfb3...57a3b0dbcbbb4887c3617b25b3708042388c894c,7,49,31,80,19,2011-10-06 08:54:07,2011-10-06 08:54:07
57a3b0dbcbbb4887c3617b25b3708042388c894c...8f8c7108d8a9fc1655d57f7ce5f776cbcfe0d36e,3,6,6,12,3,2011-10-06 08:56:34,2011-10-06 08:56:34
8f8c7108d8a9fc1655d57f7ce5f776cbcfe0d36e...037493c2509f8c7b78badef97b410b313a5fe069,6,61,49,110,20,2011-10-06 19:06:14,2011-10-06 19:06:14
037493c2509f8c7b78badef97b410b313a5fe069...6b83af42565e0e2b2652019ca0e404f088428100,4,13,13,26,7,2011-10-06 19:34:06,2011-10-06 19:34:06
fe6128180e8741be1fd40c60175a129fbc41513a...1bd3a255d5f15f7d4b0113f130c3b90f81dece90,1,6,1,7,1,2011-10-03 20:07:38,2011-10-03 20:07:38
1bd3a255d5f15f7d4b0113f130c3b90f81dece90...f3b8c0ef041adbb871f4bb4462c9716e5fbbb2f7,1,13,21,34,3,2011-10-04 18:34:16,2011-10-04 18:34:16
fe6128180e8741be1fd40c60175a129fbc41513a...06e9ba99cf7f7be610d7344acb1954f8518d0f6d,1,2,1,3,2,2011-10-03 18:49:44,2011-10-03 18:49:44
ad76418aee189ef1fd60fb8b88b19a0310c442ea...e85eefe8ba52ad534d57473155478b2ec267ca6e,3,8,4,12,5,2012-01-26 10:00:35,2012-01-26 00:20:08
ad76418aee189ef1fd60fb8b88b19a0310c442ea...1708e5e7a57dcc856ad0352f3a76ff62c2366a1d,4,17,35,52,11,2012-01-25 17:36:45,2012-01-25 17:23:38
ad76418aee189ef1fd60fb8b88b19a0310c442ea...5f66b67c66fe540a0e5e81ededf88fe3ed481f7f,3,26,10,36,13,2012-01-24 05:43:11,2012-01-24 05:43:11
5f66b67c66fe540a0e5e81ededf88fe3ed481f7f...61141b0be2cec9aedf4032ec2b6c9f04321b71d7,4,142,46,188,15,2012-01-24 17:04:46,2012-01-24 17:04:46
61141b0be2cec9aedf4032ec2b6c9f04321b71d7...9960e12dd0a60f8eac778d0fda19021afeccc171,3,6,6,12,5,2012-01-26 16:29:26,2012-01-26 16:29:26
ad76418aee189ef1fd60fb8b88b19a0310c442ea...56818fd258c2c9c682c869b15428faf7b266786b,3,7,7,14,7,2012-01-23 23:02:18,2012-01-23 23:02:18
ad76418aee189ef1fd60fb8b88b19a0310c442ea...9cc5585aec2b37b7265a68c1d3a9e9817b077471,2,4,4,8,2,2012-01-23 20:45:10,2012-01-23 20:45:10
9cc5585aec2b37b7265a68c1d3a9e9817b077471...714a961c79f5220cb3e18bb592ce4c0b57e6b6a7,3,5,5,10,3,2012-01-23 21:35:08,2012-01-23 21:35:08
ad76418aee189ef1fd60fb8b88b19a0310c442ea...00ed4c41554031c129c35f52e0dfd2d8112558c7,1,2,3,5,1,2012-01-23 02:43:23,2012-01-23 02:43:23
ad76418aee189ef1fd60fb8b88b19a0310c442ea...9b0c280616abf970c3d478e17f9440b200a66f6c,1,1,1,2,1,2012-01-19 20:40:43,2011-10-01 14:27:25
9b0c280616abf970c3d478e17f9440b200a66f6c...29e39cf60afc9c8179010126a198b58c190ae4cf,1,5,0,5,1,2012-01-19 20:40:43,2011-10-04 19:01:52
29e39cf60afc9c8179010126a198b58c190ae4cf...24492a9cf298d213da3c357776eb9a85fe840f34,1,1,1,2,1,2012-01-19 20:41:54,2011-10-11 18:43:22
24492a9cf298d213da3c357776eb9a85fe840f34...bc433a2238110f34bc5a1dc2a08a1084f79ce2cd,1,1,1,2,1,2012-01-19 20:42:48,2011-10-11 18:48:43
bc433a2238110f34bc5a1dc2a08a1084f79ce2cd...8c2204c680a2feba3ad2af7ebadcf38d40e8b1b7,2,11,4,15,4,2012-01-19 20:43:57,2011-10-29 22:34:11
8c2204c680a2feba3ad2af7ebadcf38d40e8b1b7...d043d1126ab0611de60b336931d93056c0693a2a,2,46,4,50,4,2012-01-19 20:45:19,2011-10-30 11:12:25
d043d1126ab0611de60b336931d93056c0693a2a...321460eced80866513cc68293680939df6628f05,1,1,1,2,1,2012-01-19 20:48:21,2012-01-19 20:48:21
ad76418aee189ef1fd60fb8b88b19a0310c442ea...5b27271364615c93fe1add3e620c04ebbbefb9a8,4,34,8,42,8,2012-01-18 21:10:00,2012-01-18 21:10:00
5b27271364615c93fe1add3e620c04ebbbefb9a8...f176785b83d90df27580cb425e91e4bc686a1867,3,7,3,10,5,2012-01-22 18:12:41,2012-01-22 18:12:41
f176785b83d90df27580cb425e91e4bc686a1867...3e8e4e30eb871e4399b0a0e35aad1f3991a95dff,3,3,3,6,3,2012-01-23 23:23:10,2012-01-23 23:23:10
3e8e4e30eb871e4399b0a0e35aad1f3991a95dff...8b8e31b33aaa86e7a9895924d041fe4d66f58da5,3,236,5374,5610,11,2012-01-24 02:15:52,2012-01-24 02:15:52
8b8e31b33aaa86e7a9895924d041fe4d66f58da5...1a74fa2b5838ea6f4e97b588e79f5350cd797ba2,3,3,3,6,3,2012-01-26 08:16:44,2012-01-26 08:16:44
1fac89e74fd287961104865cf3d7de391cc03677...b9170fb3947fd89e8c31d5e692b47c5bd63f0e1a,4,47,13,60,15,2012-02-20 03:18:43,2012-02-20 03:18:43
ae4306eaa6f788e3b5df84d34c2411f493e57a1d...40b98c4d7bb7e86900c43691cf1892468ce32b50,5,74,18,92,10,2011-08-17 04:21:16,2011-08-17 04:21:16
40b98c4d7bb7e86900c43691cf1892468ce32b50...746ec74663582d499e5b8a9b6a84e33c6bee254b,14,378,72,450,14,2011-08-17 05:28:15,2011-08-17 05:28:15
746ec74663582d499e5b8a9b6a84e33c6bee254b...aa6401693df7fff0ef637b3927545a62cf4e147c,1,38,0,38,1,2011-08-17 05:30:46,2011-08-17 05:30:46
aa6401693df7fff0ef637b3927545a62cf4e147c...3db7fd1b65e1a4aad1149044b037484fbb4a54e0,2,40,1,41,2,2011-08-17 05:39:02,2011-08-17 05:39:02
3db7fd1b65e1a4aad1149044b037484fbb4a54e0...f23cb315dea07c811098b7dcc75ef974f65dad79,4,74,5,79,4,2011-08-17 05:51:32,2011-08-17 05:51:32
f23cb315dea07c811098b7dcc75ef974f65dad79...72c9cd4ddeb5cf4bbadc57cb996bafc0401a52fb,1,75,0,75,1,2011-08-17 06:11:52,2011-08-17 06:11:52
72c9cd4ddeb5cf4bbadc57cb996bafc0401a52fb...97db7800eafd100afe5d33fa15f977927f551849,10,4,3204,3208,10,2011-08-17 20:13:37,2011-08-17 20:13:37
97db7800eafd100afe5d33fa15f977927f551849...559394bdb990e5cb6f0c87efbbfc3c952d863828,5,135,16,151,5,2011-08-17 20:27:55,2011-08-17 20:27:55
559394bdb990e5cb6f0c87efbbfc3c952d863828...8f78f5ec39ec3db9660ce72da48c401bc4320369,1,164,65,229,1,2011-08-17 21:09:34,2011-08-17 21:09:34
8f78f5ec39ec3db9660ce72da48c401bc4320369...b5a857fda9219496d5d9f7ffc7e770dacf9cd736,2,90,0,90,2,2011-08-17 21:24:54,2011-08-17 21:24:54
b5a857fda9219496d5d9f7ffc7e770dacf9cd736...ff083fd068906bfbfdbb372f3fc943185ec25865,2,214,78,292,6,2011-08-17 21:58:49,2011-08-17 21:58:49
ff083fd068906bfbfdbb372f3fc943185ec25865...f12352c6f43b98c99ced54dd4f3f8a7c746c4110,4,222,11,233,10,2011-08-17 23:07:28,2011-08-17 23:07:28
f12352c6f43b98c99ced54dd4f3f8a7c746c4110...7c2062f2895376e823a4c0ac04671297d734fe99,4,8,4,12,4,2011-08-17 23:13:50,2011-08-17 23:13:50
7c2062f2895376e823a4c0ac04671297d734fe99...00d8bf71a3a0851d07eb7d7a437108a8e73b9e34,3,3,3,6,2,2011-08-17 23:23:11,2011-08-17 23:22:20
4adfae719aef489843a47a4a41a5436d1be3d667...307016e843af7c0977216eb6c91ca03bf6def501,9,164,29,193,16,2011-10-11 23:46:47,2011-10-11 23:46:47
4adfae719aef489843a47a4a41a5436d1be3d667...d2943a0724ee18797f7ba1265166f452d798176e,7,20,6,26,8,2011-10-11 08:12:56,2011-10-11 08:06:38
50ecefd734720e89b3a5182ab8697a7eb33a0f6c...d2ba3b2d2cb73807ae2713112a7f3e9849beed1d,4,55,49,104,15,2011-10-10 23:45:08,2011-10-10 23:45:08
0e0ba0890091071f55270ae37ffba50c212c6326...37407414416be9d8385b44879900db0fe0eb43fc,4,37,3,40,4,2011-10-08 17:01:53,2011-10-08 16:30:17
37407414416be9d8385b44879900db0fe0eb43fc...f9148ed4f430c7e75d106e39201b63566b6cc9b6,1,41,18,59,2,2011-10-08 17:19:01,2011-10-08 17:19:01
f70ab33e853d44b01819a7375744548000d9a38e...cc0ae766b7d44adf47be4511d79577b59f9ef057,18,93,98,191,65,2011-10-07 16:58:58,2011-10-07 16:40:58
cc0ae766b7d44adf47be4511d79577b59f9ef057...0b852dd89243fd4c82a1aaef94d38dedc90a8f0c,4,10,6,16,5,2011-10-07 19:10:10,2011-10-07 19:10:10
b073edfc08908feb1679531f4cd7f490515e65a7...9d56825122983e904515de1922694c66c95e5b1f,3,13,8,21,8,2011-10-28 23:29:23,2011-10-28 23:29:23
303478b90be1a12479c093561f00176219ac8abe...f67e89597db87f017c3d4706448ebe3ff8528853,1,4,1,5,2,2012-01-26 19:58:40,2012-01-26 19:58:40
522e269663f6ea57eca55750814d0f28df3766d0...cb97b4a1673eef6e325356303d1f45ba765a4479,4,59,18,77,13,2012-02-22 22:06:30,2012-02-22 22:06:30
cb97b4a1673eef6e325356303d1f45ba765a4479...7bd053014b09ad427a75fb44864f1acb2640566b,3,36,24,60,17,2012-02-22 22:13:25,2012-02-22 22:13:25
7bd053014b09ad427a75fb44864f1acb2640566b...e5e24305e2a6d4d95841c7d93b01e91ef5424085,10,170,150,320,67,2012-02-23 01:34:58,2012-02-23 01:22:00
42352b259de8420edc866ea546dd4536a1a10c8f...cc5de6d7d17668561608ac3b7ccc90cbe93632ba,3,6,5,11,3,2012-01-26 19:05:06,2012-01-26 19:05:06
b9170fb3947fd89e8c31d5e692b47c5bd63f0e1a...f37fd5210049800606d915174aac5fb100b0560d,4,66,5,71,4,2012-02-20 04:52:44,2012-02-20 04:52:44
f37fd5210049800606d915174aac5fb100b0560d...738b6347898aa7789936bfac8e5973f5f2768e3d,5,265,4,269,5,2012-02-20 19:23:36,2012-02-20 19:23:36
b7fb05ab0f54878bf40a163d8c2a2a541454fb5c...82385841fc2d1df007e198988ae85d2e60676559,6,42,8,50,7,2011-08-18 17:10:16,2011-08-18 16:54:50
307016e843af7c0977216eb6c91ca03bf6def501...2adcdfe9d0afb212957df5565d687b7e886901a4,5,64,11,75,16,2011-10-12 00:46:13,2011-10-12 00:46:13
9523c4d2d16585c7caad9d5049dc79a533402a7a...31cb66f9f158ee67f59b01c562d8ee6a06b0b426,7,67,6,73,12,2011-10-11 00:49:53,2011-10-11 00:49:53
f67e89597db87f017c3d4706448ebe3ff8528853...ca113b6cca79b6821bb69a8f0761c5679aef3a0b,3,98,4,102,3,2012-01-30 03:24:10,2012-01-30 03:23:14
f67e89597db87f017c3d4706448ebe3ff8528853...85ad3c16b031f2e21969123fbf3749f796623226,4,51,25,76,22,2012-01-29 22:29:14,2012-01-29 22:27:41
f67e89597db87f017c3d4706448ebe3ff8528853...117942e28462a46d7f24a8c805c250ddb9fe89d7,7,151,26,177,25,2012-01-29 21:28:49,2012-01-29 21:28:49
117942e28462a46d7f24a8c805c250ddb9fe89d7...0e5bca1e0ab2a9d00b6fd6ee94c12477c147a515,4,11,7,18,7,2012-01-29 21:44:48,2012-01-29 21:44:48
60e8fb5603eab39ad261e8ae3ad621c0e3c874c1...74be6c13d8e7726a1b610c53ad5bbcc88d85b567,4,41,17,58,10,2012-02-23 05:39:02,2012-02-23 05:39:02
74be6c13d8e7726a1b610c53ad5bbcc88d85b567...d2f0e0bbf48a43ae02cc02eff7715b13140211f4,3,122,170,292,27,2012-02-23 05:59:13,2012-02-23 05:59:13
d2f0e0bbf48a43ae02cc02eff7715b13140211f4...ec12de6eec51e01935449770ee3b0add0241865e,5,414,454,868,53,2012-02-23 06:40:44,2012-02-23 06:40:44
ec12de6eec51e01935449770ee3b0add0241865e...7663a9c2916848e309a85e68b968b528e36fa634,3,12,12,24,9,2012-02-23 06:50:40,2012-02-23 06:50:40
7663a9c2916848e309a85e68b968b528e36fa634...b59f117341b842abbe4624f8b4a17473bc39bc8f,4,174,8,182,6,2012-02-23 18:32:42,2012-02-23 18:32:42
ebab983b8a644b4e5a7fe3d392be67d44c3e900b...f1ef800c3cb02f383b6639bd59f2584c8dec90ab,3,7,5,12,5,2012-02-20 20:25:23,2012-02-20 20:25:23
f1ef800c3cb02f383b6639bd59f2584c8dec90ab...8ac45d9cdf950460737c430d606a93dd8d9c4358,3,12,48,60,7,2012-02-21 04:14:24,2012-02-21 04:14:24
8ac45d9cdf950460737c430d606a93dd8d9c4358...b1f9905557295130fa9ab2442444b8924daf03b6,2,18,18,36,10,2012-02-21 04:24:11,2012-02-21 04:24:11
b1f9905557295130fa9ab2442444b8924daf03b6...7069da0c79d3c7e1578e5a6df5c1bc1e2e539faa,8,61,50,111,37,2012-02-21 04:40:43,2012-02-21 04:40:43
7069da0c79d3c7e1578e5a6df5c1bc1e2e539faa...f1197ed8b6b4893237cdd3e27e7454af3c97a612,8,127,61,188,39,2012-02-21 05:30:23,2012-02-21 05:26:27
f1197ed8b6b4893237cdd3e27e7454af3c97a612...da43cf2068280a291eed17e3f17f0fd5222f5fa9,4,7,7,14,5,2012-02-21 06:28:42,2012-02-21 06:28:42
da43cf2068280a291eed17e3f17f0fd5222f5fa9...7187082ccc017b3903b7ad6e2a9145ca2cc50a5e,4,14,8,22,8,2012-02-21 06:32:46,2012-02-21 06:32:46
7187082ccc017b3903b7ad6e2a9145ca2cc50a5e...a52855962c778b838bc1b90fc8ed9ba1ed250f90,4,22,15,37,8,2012-02-21 06:49:31,2012-02-21 06:49:31
a52855962c778b838bc1b90fc8ed9ba1ed250f90...c6c4f3868cb107a86801f13f1730115b5eff9102,3,15,17,32,13,2012-02-21 06:54:38,2012-02-21 06:54:38
c6c4f3868cb107a86801f13f1730115b5eff9102...a1c5ada8f845d7ab27fab5728ab9929ab9b17259,3,18,18,36,9,2012-02-21 06:57:25,2012-02-21 06:57:25
4889a08e4c98e2966e2aa8f1876a3974cb259c32...2314b2a0cd75b4960bccf1e8b9bb581922b790dd,1,1,2,3,2,2012-02-20 04:52:53,2012-02-20 04:52:53
2314b2a0cd75b4960bccf1e8b9bb581922b790dd...84e58f1ee53c37c52c680986bf19b59ecce80ead,3,3,7,10,3,2012-02-20 05:00:01,2012-02-20 05:00:01
84e58f1ee53c37c52c680986bf19b59ecce80ead...bb61f88aaf9c6a6226a0a35034fc963536e857bd,4,24,11,35,12,2012-02-20 08:52:45,2012-02-20 08:52:45
82385841fc2d1df007e198988ae85d2e60676559...2ddc0f62e3210f37fd9b35bb82242f02d13eb5c8,14,269,175,444,32,2011-08-22 19:30:31,2011-08-18 19:21:47
82385841fc2d1df007e198988ae85d2e60676559...2440287d4558585a6d4673a2317cb376078d401a,3,7,9,16,5,2011-08-19 10:13:22,2011-08-19 10:13:22
82385841fc2d1df007e198988ae85d2e60676559...377e9e6065006a4027567a143ceb0509e35f664a,1,169,0,169,1,2011-08-18 17:14:34,2011-08-18 17:14:34
32907ec505b0adf63525a2a861dcc296b9cc7c4a...846bd5c5f5f71d36ee16ecf6882f778bfaffbbc2,2,121,1,122,2,2011-10-12 21:02:57,2011-10-12 21:02:57
846bd5c5f5f71d36ee16ecf6882f778bfaffbbc2...c86108e522952fdfb96d89ca840e66800bb36a3b,9,61,19,80,19,2011-10-12 22:37:32,2011-10-12 22:37:32
c86108e522952fdfb96d89ca840e66800bb36a3b...4731d2cbb2f0b499da6ba13ef2b16ad0532b81b2,6,91,134,225,33,2011-10-13 00:55:08,2011-10-13 00:55:08
4731d2cbb2f0b499da6ba13ef2b16ad0532b81b2...c62387746109aea8cdb0ef598271c7e6c07c3f55,1,223,0,223,1,2011-10-13 07:30:45,2011-10-13 07:30:45
6bf2071cc5fa0c59586a2483925940a97a8527c1...338094e6d88c67f2c4577aa72b042c2f9bec8438,2,2,0,2,2,2011-10-29 00:11:20,2011-10-29 00:11:20
338094e6d88c67f2c4577aa72b042c2f9bec8438...0ad900ab190d7dae27a38e1ac6197662ab7d3a11,2,22,2,24,4,2011-10-29 16:39:52,2011-10-29 16:39:52
0ad900ab190d7dae27a38e1ac6197662ab7d3a11...392ded0820247224b549cad66053a604d5b02eb3,12,153,136,289,55,2011-10-29 17:42:19,2011-10-29 17:42:19
76400ac15dc62aa37dbf897b00705da44c04fe7c...7a4a8ec8fed601f9f4e51c18aedb00b29fdc8458,1,2,2,4,1,2012-02-12 16:41:58,2012-02-12 16:41:58
76400ac15dc62aa37dbf897b00705da44c04fe7c...3a4f45fc5cf7d4ff8894d14f4cfdce40c144d6b4,2,27,1,28,2,2012-02-09 17:09:23,2012-02-09 17:09:23
76400ac15dc62aa37dbf897b00705da44c04fe7c...b2a701ead2c659ac5c6656191beb02ebf7bffe02,2,2,2,4,2,2012-02-08 21:46:01,2012-02-08 21:46:01
b2a701ead2c659ac5c6656191beb02ebf7bffe02...d6e184b451d8a39df92efe4d19c87ce2094fc072,2,4,2,6,2,2012-02-09 00:20:59,2012-02-09 00:20:59
d6e184b451d8a39df92efe4d19c87ce2094fc072...56bd6146b30927b14e02e576da721d8ad1b36add,2,2,2,4,2,2012-02-09 00:23:40,2012-02-09 00:23:40
56bd6146b30927b14e02e576da721d8ad1b36add...e0b733cc8d8629fb0b70ff664d35ab480dfefb0e,2,3,13,16,3,2012-02-10 09:39:29,2012-02-10 09:16:56
e0b733cc8d8629fb0b70ff664d35ab480dfefb0e...8182f8dfe72d303008c0ad27f77cef2241a72e8a,7,12,12,24,12,2012-02-13 21:44:53,2012-02-13 21:44:35
76400ac15dc62aa37dbf897b00705da44c04fe7c...87f48b7aa2dfffe821819146b347167ff60469ce,2,10,2,12,4,2012-02-07 22:09:39,2012-02-07 22:09:39
87f48b7aa2dfffe821819146b347167ff60469ce...8cd0872141785c3c6427e2b45d0a241f5dbd2f57,2,11,4,15,4,2012-02-07 22:37:18,2012-02-07 22:37:18
8cd0872141785c3c6427e2b45d0a241f5dbd2f57...76b13d547f83df8c37290cdeed249e707008dc05,2,6,2,8,2,2012-02-15 00:03:38,2012-02-15 00:03:38
76b13d547f83df8c37290cdeed249e707008dc05...25c0bca405b61cb80484bf56036a491cda724711,2,6,3,9,2,2012-02-15 00:04:03,2012-02-15 00:04:03
25c0bca405b61cb80484bf56036a491cda724711...de8cddc6b89f765b339855ec1fb6a8feebc9759e,1,1,1,2,1,2012-02-15 00:09:52,2012-02-15 00:09:52
de8cddc6b89f765b339855ec1fb6a8feebc9759e...8178c2961ba0f010ad6fbc891d3f9ecdf56d2a43,4,33,17,50,9,2012-02-15 22:23:27,2012-02-15 22:23:27
76400ac15dc62aa37dbf897b00705da44c04fe7c...61d3d897cbfd0d7afa0490f432cfa68be37d3e33,6,434,538,972,69,2012-02-03 01:41:35,2012-02-03 01:41:35
61d3d897cbfd0d7afa0490f432cfa68be37d3e33...b5f8f96155f28c0203ab1bfd1b8fef9d028a2cc5,1,73,0,73,1,2012-02-14 23:44:39,2012-02-14 20:14:45
b5f8f96155f28c0203ab1bfd1b8fef9d028a2cc5...2567c25cd384b2a42e5919b88adf506271a60699,1,5,6,11,1,2012-02-15 00:43:15,2012-02-15 00:43:15
0bd675ca49583303bde0e238bff256b55605a02a...eb607a51747a76dda4cb8b18b5dcad52d8eb91a4,1,1,1,2,1,2012-02-25 05:14:55,2012-02-25 05:14:55
030a48c154b1c6f45da984285a7a6bc6c8e5f005...1e10e2ca88dfa0f4b47e92ea8451833cd292ae61,7,18,18,36,17,2012-02-21 16:23:23,2012-02-21 16:23:23
1e10e2ca88dfa0f4b47e92ea8451833cd292ae61...003c45e5b3c5ec9a0d2d3adc13af5537317cf69c,4,40,24,64,18,2012-02-21 16:39:42,2012-02-21 16:39:42
003c45e5b3c5ec9a0d2d3adc13af5537317cf69c...0daedb234479d058d3d7ce002004f872233af99a,4,15,6,21,4,2012-02-21 16:42:37,2012-02-21 16:42:37
0daedb234479d058d3d7ce002004f872233af99a...6affe7eb94b56ca242c24db046cb6d30c14c14f0,3,48,40,88,19,2012-02-21 16:47:57,2012-02-21 16:47:57
6affe7eb94b56ca242c24db046cb6d30c14c14f0...d69cbbdaa7744f39f5e87c39d160f6fdfb7f6d28,6,30,16,46,15,2012-02-21 16:55:03,2012-02-21 16:55:03
d69cbbdaa7744f39f5e87c39d160f6fdfb7f6d28...2c5293675ee906421858ac3d9a7e79de88edee61,4,31,22,53,20,2012-02-21 17:03:00,2012-02-21 16:57:55
2c5293675ee906421858ac3d9a7e79de88edee61...72da0cd88a18c128242f203b242377387d502978,3,9,9,18,7,2012-02-21 17:04:00,2012-02-21 17:04:00
72da0cd88a18c128242f203b242377387d502978...31b0d3f197f34ba03cded98272c6d591b313c44d,4,23,31,54,7,2012-02-21 18:03:23,2012-02-21 18:03:23
31b0d3f197f34ba03cded98272c6d591b313c44d...f80b1cf244efa2bcdee016635d17664aed6d4581,14,105,67,172,16,2012-02-21 18:31:15,2012-02-21 18:31:15
f80b1cf244efa2bcdee016635d17664aed6d4581...0cf999b08f9757e5f782c4cc99031a48f96bf063,4,110,59,169,27,2012-02-21 21:31:20,2012-02-21 18:41:43
0cf999b08f9757e5f782c4cc99031a48f96bf063...f13d60b2ab303324f053d53f086b83f66712acf8,6,54,14,68,8,2012-02-22 02:35:13,2012-02-22 02:31:55
2acaf4efbc19eb25dcef93fe622592afc91214e1...34d5d276ae29a2e6440bae5264bfb50c7ed1c5a9,2,4,6,10,2,2011-08-19 17:56:37,2011-08-19 17:56:37
377e9e6065006a4027567a143ceb0509e35f664a...bb289bbdf3ebeda2b3099d6918fb58dc8f61af4a,3,3,3,6,3,2011-08-19 17:10:29,2011-08-19 17:10:29
c62387746109aea8cdb0ef598271c7e6c07c3f55...3f3569cc71ed074fa4b9f521f40f3fc489aabec9,10,63,24,87,24,2011-10-14 20:45:16,2011-10-14 20:45:16
3f3569cc71ed074fa4b9f521f40f3fc489aabec9...99f3cb9bf17ebd3797f7333bcf443c0a24dfa66e,1,61,28,89,18,2011-10-17 16:54:11,2011-10-17 16:54:11
c62387746109aea8cdb0ef598271c7e6c07c3f55...c724d95f77e8f3418adfcb8e49eb0beaf5299310,10,15,15,30,10,2011-10-13 10:35:59,2011-10-10 07:27:24
c724d95f77e8f3418adfcb8e49eb0beaf5299310...76bcd2a92f655d3140c28190cd009d9072d563d2,2,2,2,4,2,2011-10-17 07:43:27,2011-10-17 07:43:27
eda09f41c51db8c210c68d2f5974ddf2cdc1c8d6...e3d59bd581df3bfa2941c1120b8204551bef6844,10,529,19,548,18,2011-10-31 23:59:17,2011-10-31 23:59:17
e3d59bd581df3bfa2941c1120b8204551bef6844...c72f10a2fb090a177e8a07ee24b9473684f1d30a,3,118,22,140,13,2011-11-01 01:03:48,2011-11-01 01:03:48
c72f10a2fb090a177e8a07ee24b9473684f1d30a...42a59ac69fdcf84881f708347507ecee89bcb190,3,112,92,204,39,2011-11-01 18:57:37,2011-11-01 18:57:37
42a59ac69fdcf84881f708347507ecee89bcb190...a475cd5e5cef8e00a2a1ca47bb78fc16b2f2bb51,9,189,82,271,49,2011-11-01 20:30:58,2011-11-01 20:30:58
a475cd5e5cef8e00a2a1ca47bb78fc16b2f2bb51...6e1cad402dff1b1df59efb77c303ac758dec984d,6,301,168,469,101,2011-11-01 23:53:09,2011-11-01 23:53:09
6e1cad402dff1b1df59efb77c303ac758dec984d...20b68c312b71fe434e4aba809bc5948c81575fd3,3,88,25,113,19,2011-11-02 01:08:54,2011-11-02 01:08:54
20b68c312b71fe434e4aba809bc5948c81575fd3...49c5b60d42af209d5014d20a2f8c43531ea1120d,3,106,64,170,31,2011-11-02 02:14:12,2011-11-02 02:14:12
7a4a8ec8fed601f9f4e51c18aedb00b29fdc8458...4f37a4869b54063b3376a10be7e696b25dbfa6c2,3,7,7,14,5,2012-02-16 12:49:20,2012-02-16 12:49:20
7a4a8ec8fed601f9f4e51c18aedb00b29fdc8458...fef068d2da21b4c2b82dbbae74bb96d8b8b313c0,1,227,0,227,1,2012-02-16 09:02:06,2012-02-16 09:02:06
fef068d2da21b4c2b82dbbae74bb96d8b8b313c0...17fdd13509e36db86e9de810fde1252a43fcc276,1,13,20,33,5,2012-02-16 09:45:50,2012-02-16 09:45:50
17fdd13509e36db86e9de810fde1252a43fcc276...1a9cd3c2ea0f2c17d027db9870875c573d8ab124,1,3,5,8,1,2012-02-16 09:50:16,2012-02-16 09:50:16
1a9cd3c2ea0f2c17d027db9870875c573d8ab124...191445a5c59a72f2e0966707ba0b73f907ba0ef6,1,18,0,18,1,2012-02-16 16:16:51,2012-02-16 16:16:51
191445a5c59a72f2e0966707ba0b73f907ba0ef6...58e640cbcba1148e97d43c2bbdec99ea31f6b2e5,1,2,2,4,1,2012-02-16 16:19:53,2012-02-16 16:19:53
7a4a8ec8fed601f9f4e51c18aedb00b29fdc8458...fb02de8763ecba0343e617e1db3064961b78f98f,3,17,5,22,9,2012-02-15 05:18:42,2012-02-15 05:18:42
fb02de8763ecba0343e617e1db3064961b78f98f...ed0f227c41350bce5b43e25a5d59c29d70da19d9,3,13,1,14,3,2012-02-15 05:59:47,2012-02-15 05:59:47
7a4a8ec8fed601f9f4e51c18aedb00b29fdc8458...50bf5d3e38d5c839cbc3de9ca446547b6da20c1c,8,250,107,357,77,2012-02-15 04:19:31,2012-02-15 00:32:47
50bf5d3e38d5c839cbc3de9ca446547b6da20c1c...79708d8d2cc731135c301d27f262c1fb3fe22c0b,4,30,23,53,19,2012-02-15 06:07:57,2012-02-15 06:07:57
79708d8d2cc731135c301d27f262c1fb3fe22c0b...1ffbf9721f557225684419524aa6c040ec7b6a9c,3,5,5,10,3,2012-02-15 06:26:12,2012-02-15 06:26:12
7a4a8ec8fed601f9f4e51c18aedb00b29fdc8458...744aa9696ea9e7eee780cbfb2316ea82111c3ba8,5,14,6,20,6,2012-02-14 07:11:05,2012-02-14 07:11:05
c0424312229e040f6d624fe20e79d918953a14aa...c3516c06a64da5add803d384bb28e2118904c402,2,3,1,4,3,2012-02-18 19:51:45,2012-02-18 19:48:11
0b48ec4a9ab533254a0512329ad7dbb57f497806...e1473e2d4a155ae1695b2ca8baa6f7a6f23864b8,1,0,6,6,1,2012-02-19 21:34:19,2012-02-19 21:34:19
e1473e2d4a155ae1695b2ca8baa6f7a6f23864b8...67833444a994714a9794347789b337232717eb92,1,1,1,2,1,2012-02-19 21:35:09,2012-02-19 21:35:09
67833444a994714a9794347789b337232717eb92...c2780d5075cf1a929b03c30b1097077de175bc70,5,70,72,142,14,2012-02-20 01:00:04,2012-02-20 01:00:04
b42e818ce879bb8980c3831bb2308c9b2850ad59...e46b1615a10fef9e56cf62fc581feb5a135b383e,2,113,67,180,8,2012-02-29 01:52:16,2012-02-29 01:52:16
b42e818ce879bb8980c3831bb2308c9b2850ad59...3ec1d7178540bd8af5ecd7428068bdc0297ca2f5,6,76,64,140,31,2012-02-26 23:46:26,2012-02-26 23:46:26
3ec1d7178540bd8af5ecd7428068bdc0297ca2f5...af4d9e4c1a376941f87ea7e65de7310602c8c689,3,20,14,34,7,2012-02-27 00:16:49,2012-02-27 00:16:49
43aeb6018d5d6eb63e15d6a9292c09654220cb1b...3c0f29943c5f6373c34c1ccd51a2fb230c32bb51,4,26,5,31,4,2011-08-19 18:01:12,2011-08-19 18:01:12
402c2e49221ceca40fa43ca542ba8b0d9ac03632...da189667c1d2979da85671f6081c20d01621b2f1,5,62,2,64,5,2011-10-07 21:00:44,2011-10-07 20:57:59
402c2e49221ceca40fa43ca542ba8b0d9ac03632...45098edc7ad79b6b7ec655afacc0a05caa69e8d7,3,20,2,22,4,2011-08-23 13:03:24,2011-08-23 10:07:23
45098edc7ad79b6b7ec655afacc0a05caa69e8d7...a97464fa784f79e5b4cb942345280ac4e73dba5b,3,23,7,30,6,2011-08-25 23:36:40,2011-08-25 23:36:40
402c2e49221ceca40fa43ca542ba8b0d9ac03632...dd2d490524045ef37b743612a3824922c482d301,4,44,7,51,14,2011-08-22 20:48:21,2011-08-22 20:48:21
402c2e49221ceca40fa43ca542ba8b0d9ac03632...07affa2265a8efe0dcd498d28b5e462e40e02dc0,3,11,11,22,5,2011-08-22 20:23:26,2011-08-22 20:23:26
402c2e49221ceca40fa43ca542ba8b0d9ac03632...12c5de92bc7c25d8cbf2e61ba8fcd1c02fa8ffec,3,11,15,26,11,2011-08-22 19:40:45,2011-08-22 19:40:45
12c5de92bc7c25d8cbf2e61ba8fcd1c02fa8ffec...b275d26e385404bc2e267d9e03cb27b575bec1ea,3,15,9,24,7,2011-08-22 20:43:41,2011-08-22 20:43:41
402c2e49221ceca40fa43ca542ba8b0d9ac03632...debf96c742934543e210c48c7c11199aa614e381,2,2,2,4,2,2011-08-20 13:38:46,2011-08-20 13:38:46
99f3cb9bf17ebd3797f7333bcf443c0a24dfa66e...b4cf93f8b001af303f325592d764d197d6b45b1b,1,3,3,6,2,2011-10-19 21:23:14,2011-10-19 21:23:14
b4cf93f8b001af303f325592d764d197d6b45b1b...a62bd527ca7030b72d615daa217f958d73871695,7,46,41,87,12,2011-10-20 00:57:53,2011-10-20 00:57:53
99f3cb9bf17ebd3797f7333bcf443c0a24dfa66e...fb07750993711b6e30ec56e47c9c7a71310bd2c9,1,52,52,104,1,2011-10-17 17:27:57,2011-10-17 17:27:57
2f6d2fa07aa45b3fa081bfe1ba72ff61d442775e...c0e5b96336e676fd84cb4a7bbb70686a3c809359,7,13,9,22,9,2011-10-24 02:39:40,2011-10-24 02:39:40
2f6d2fa07aa45b3fa081bfe1ba72ff61d442775e...6830a0fca23fb4e67f06e5f0163b90d19329d198,4,65,15,80,18,2011-10-20 11:02:53,2011-09-22 14:17:23
6830a0fca23fb4e67f06e5f0163b90d19329d198...a93a3718789f2690f7b1e900bcb3f6672bbfd91a,5,86,62,148,25,2011-10-20 12:19:16,2011-10-20 12:15:57
a93a3718789f2690f7b1e900bcb3f6672bbfd91a...bc2394aabf4cecd807abc0d1be687787d3f68dbc,3,16,12,28,9,2011-10-20 14:27:02,2011-10-20 14:27:02
bc2394aabf4cecd807abc0d1be687787d3f68dbc...8bfa56cf37a180fe6a33e6de80cd1c72adb6c41d,3,10,10,20,5,2011-10-20 14:52:06,2011-10-20 14:52:06
8bfa56cf37a180fe6a33e6de80cd1c72adb6c41d...81db54c26310f0d31322246edd4cba3fef26469f,3,4,4,8,3,2011-10-20 14:54:24,2011-10-20 14:54:24
49c5b60d42af209d5014d20a2f8c43531ea1120d...6651c1785a2c94bd5cd6eaf9a46791a152ed6ea7,1,1,1,2,1,2011-11-02 12:32:50,2011-11-02 12:32:50
80e0e781273fcf16fc68072d2d3fc2c5ee634dfc...ef46aafd0633ed4fead7a0e29371f9b9f9cbbdb2,3,30,10,40,11,2012-02-17 14:28:59,2012-02-17 14:23:38
0b93bee13fccfb509ac22a72c89e1134190e5d13...b54181e5da16691732cd0fab02e32700be185374,3,34,26,60,13,2012-02-17 16:40:27,2012-02-17 16:40:27
230d8e908095a5650ea63bf29179f9bc1f842425...3081dd45efe27067e7b1f9677a6a2f1d894b651f,272,5612,6901,12513,302,2012-02-18 22:04:01,2012-02-18 21:14:52
e46b1615a10fef9e56cf62fc581feb5a135b383e...41371adc98551b339d760652db49d2ffb09e06bf,21,180,235,415,71,2012-02-29 19:27:30,2012-02-29 19:27:30
e46b1615a10fef9e56cf62fc581feb5a135b383e...93c78c625e79e8ff8ae58a4ef313002cc51091fd,4,116,24,140,26,2012-02-29 02:27:40,2012-02-29 02:27:40
93c78c625e79e8ff8ae58a4ef313002cc51091fd...4f552825ad81555e0dc1fe54bf2edad7b3f13baf,3,4,4,8,3,2012-03-02 00:25:30,2012-03-02 00:25:30
b21cc8138db1e3ad5b6e658ac3d144b45fcc85e6...c421f90dc0af22c9da0236499b7700ae336c479c,1,1,2,3,1,2011-08-22 21:20:54,2011-08-22 21:20:54
98da365557e25d98fdd582d2119d93f0b986a660...e60bc4d525267bd9ba0619263cba2a5b69d9db48,4,7,3,10,4,2011-11-04 22:01:55,2011-11-04 22:01:55
c0e5b96336e676fd84cb4a7bbb70686a3c809359...4a0c3842b9baa76f2989ea5157a8523171abf89e,3,3,3,6,3,2011-10-28 23:53:58,2011-10-28 23:53:58
4a0c3842b9baa76f2989ea5157a8523171abf89e...d57e2784859bf0f8b96934acb43da5a9253c5567,5,31,32,63,16,2011-10-29 00:04:03,2011-10-29 00:04:03
c0e5b96336e676fd84cb4a7bbb70686a3c809359...31d00a993f23a05b0b3b3dd6eef646f8da36c30c,2,2,3,5,3,2011-10-28 23:43:00,2011-10-18 20:30:20
31d00a993f23a05b0b3b3dd6eef646f8da36c30c...95a4dce0232a37dea9a6fce7c381b768b312d733,2,2,2,4,2,2011-10-28 23:47:31,2011-10-28 23:47:31
c0e5b96336e676fd84cb4a7bbb70686a3c809359...bd90a2f1bf1f0764b261ba92c468ffb11750d905,3,3,3,6,3,2011-10-25 08:12:42,2011-10-25 08:12:42
bd90a2f1bf1f0764b261ba92c468ffb11750d905...d0d665c671b7d17c659ad4aa3209a7067be4e52b,4,14,6,20,7,2011-10-25 08:30:59,2011-10-25 08:30:59
d0d665c671b7d17c659ad4aa3209a7067be4e52b...c16417cbccdd0da2801e9d0386a50dab98e862aa,3,8,12,20,7,2011-10-25 08:52:00,2011-10-25 08:52:00
c16417cbccdd0da2801e9d0386a50dab98e862aa...8f98f81958387693b4c5660f1d9894645991a7f2,3,8,10,18,5,2011-10-25 08:54:30,2011-10-25 08:54:19
81db54c26310f0d31322246edd4cba3fef26469f...14b8d482ebec37108416709584ba03ef4e7bc5f9,3,14,12,26,9,2011-11-04 20:14:20,2011-11-04 20:14:20
6ebc2fce95508d4b87a32bcbe99545d405224f88...af589a01fc4f8b6a4500484a563fb16bac494748,7,152,152,304,22,2011-11-02 18:44:29,2011-11-02 18:44:29
af589a01fc4f8b6a4500484a563fb16bac494748...149320f73f4be609d8b4aebcdef16d75343f81a0,7,562,6,568,16,2011-11-02 23:19:37,2011-11-02 23:19:37
3081dd45efe27067e7b1f9677a6a2f1d894b651f...6f509917f5af51fb50a297f7dfdfe30954979ee4,1,4,0,4,1,2012-02-22 00:07:01,2012-02-22 00:07:01
3081dd45efe27067e7b1f9677a6a2f1d894b651f...00eebb3ef08e66b2cf8484f50853aedc30175dc2,3,4,6,10,3,2012-02-21 13:15:38,2012-02-21 13:15:38
3081dd45efe27067e7b1f9677a6a2f1d894b651f...474dfecc9d88d4fa482b34c974362d953fdea394,1,3,0,3,1,2012-02-20 20:28:10,2012-02-20 20:28:10
3081dd45efe27067e7b1f9677a6a2f1d894b651f...1e63be0cddbf3d36b30bf6e9bee742195447a2a6,4,22,11,33,8,2012-02-20 03:18:10,2012-02-20 03:18:10
1e63be0cddbf3d36b30bf6e9bee742195447a2a6...1030db1cd67b76218fc99bfde769e434f2444765,4,15,9,24,8,2012-02-20 03:31:02,2012-02-20 03:31:02
1030db1cd67b76218fc99bfde769e434f2444765...19dd294c50e85d7766dcbfdd4a047b95dddf086c,6,45,13,58,7,2012-02-20 04:06:20,2012-02-20 04:06:20
19dd294c50e85d7766dcbfdd4a047b95dddf086c...95f6137ae2627add094ddd10c915cb772ab28634,3,6,6,12,3,2012-02-20 04:11:48,2012-02-20 04:11:48
95f6137ae2627add094ddd10c915cb772ab28634...55084d6e865bc2717e27dbea3b33ddbd033f8208,3,6,6,12,3,2012-02-20 04:15:14,2012-02-20 04:15:14
55084d6e865bc2717e27dbea3b33ddbd033f8208...2dbe80fd34c38a040c91cb789ffe676e257eb373,4,13,13,26,10,2012-02-20 04:43:44,2012-02-20 04:43:44
2dbe80fd34c38a040c91cb789ffe676e257eb373...d728a49172fd1e3621f0a448583690e289bf2daf,3,5,7,12,5,2012-02-20 04:45:58,2012-02-20 04:45:58
3081dd45efe27067e7b1f9677a6a2f1d894b651f...0e4fc7cdc68b9590f72417a8af4d259f6c8ca9ad,13,144,150,294,28,2012-02-19 04:36:06,2012-02-19 04:36:06
0e4fc7cdc68b9590f72417a8af4d259f6c8ca9ad...35dfb87d50f74f5092b94f78f7e198038b9c1aa3,18,556,206,762,72,2012-02-19 05:23:17,2012-02-19 05:23:17
35dfb87d50f74f5092b94f78f7e198038b9c1aa3...82cd7257f9a26b7606561972d1123952e17553e6,18,99,167,266,67,2012-02-19 06:00:47,2012-02-19 06:00:47
82cd7257f9a26b7606561972d1123952e17553e6...077411a236241244b3590dbf4fa0cdd68bc02dc5,28,383,337,720,93,2012-02-19 06:56:54,2012-02-19 06:56:54
077411a236241244b3590dbf4fa0cdd68bc02dc5...4af8633d8852a68138ebf352bc4d698ad96f30f0,10,399,5,404,19,2012-02-19 20:24:38,2012-02-19 20:24:38
af2af6ac9080529d102aacfa57807371fd983d2b...2737ec3617022dd7fa8b2835d4281cb2ce64c3e2,1,1,1,2,1,2012-03-06 23:36:00,2012-03-06 23:36:00
af2af6ac9080529d102aacfa57807371fd983d2b...ab231dca2a363cbb92030fce1981d499499f9534,3,10,6,16,7,2012-03-04 11:34:09,2012-03-04 11:31:47
ab231dca2a363cbb92030fce1981d499499f9534...dbee8568b3f1e31cc7867c76105c818d772a934c,1,4,2,6,2,2012-03-04 11:37:24,2012-03-04 11:37:24
dbee8568b3f1e31cc7867c76105c818d772a934c...0200f6501c2fc60d5d39da46145aa8bd0dc016b6,1,1,1,2,1,2012-03-04 11:52:51,2012-03-04 11:52:51
0200f6501c2fc60d5d39da46145aa8bd0dc016b6...1638d96d72a0002a165357a345f457a4479348f9,3,6,6,12,3,2012-03-04 19:41:39,2012-03-04 19:41:39
c421f90dc0af22c9da0236499b7700ae336c479c...892b607a1f72001c80ea24abf9c117048b379682,9,9,8,17,9,2011-08-23 16:06:00,2011-08-23 16:06:00
892b607a1f72001c80ea24abf9c117048b379682...ca159bfda8631f89d069b74a69f3b2a039f8eda4,2,15,1,16,3,2011-08-23 16:15:21,2011-08-23 16:06:39
8cba1d7e1ca1c0e1b6529bb494f209243a271762...af5fccdca1ab23d719e88ae16dca8e76f2270cf8,4,6,6,12,4,2011-11-05 02:42:59,2011-11-05 02:42:59
e60bc4d525267bd9ba0619263cba2a5b69d9db48...151f0ba0765c2bdd7d8d03f61b41eb9671f398fc,3,4,4,8,3,2011-11-04 22:12:05,2011-11-04 22:12:05
14b8d482ebec37108416709584ba03ef4e7bc5f9...60e80dc745bfc22de623baa1a3e7140b019cd1ad,3,4,26,30,9,2011-11-04 20:18:18,2011-11-04 20:18:18
60e80dc745bfc22de623baa1a3e7140b019cd1ad...a5b538b4c6a3e985c105b385b98175094d9ae177,2,8,8,16,6,2011-11-04 20:19:14,2011-11-04 20:19:14
a5b538b4c6a3e985c105b385b98175094d9ae177...d2c424aa099357e45699438fd4ca3afccebb9222,3,3,3,6,3,2011-11-04 20:23:51,2011-11-04 20:22:27
149320f73f4be609d8b4aebcdef16d75343f81a0...a4abdc3c4510c878e811d1fc73e83d3b8e71f9be,4,102,6,108,4,2011-11-03 16:59:41,2011-11-03 16:59:41
149320f73f4be609d8b4aebcdef16d75343f81a0...6c8b308aed800df27c4d0757b0583b0667f1caa2,1,1,0,1,1,2011-11-03 16:06:04,2011-11-03 16:06:04
6c8b308aed800df27c4d0757b0583b0667f1caa2...2b42dec9301a271bf702c6778b15c36c5da0e90c,4,57,5,62,4,2011-11-03 16:20:06,2011-11-03 16:20:06
3da58981bd6d2c6bdecf93edce88d47c667361c4...dad57834dfb941b5d04f9dc923ac019faf67b991,3,3,3,6,5,2012-03-16 14:49:10,2012-03-16 14:49:10
dad57834dfb941b5d04f9dc923ac019faf67b991...005e177e6efaebaa1a9c670202f2cd833a225d2c,3,6,4,10,5,2012-03-16 16:21:03,2012-03-16 16:21:03
005e177e6efaebaa1a9c670202f2cd833a225d2c...2e83e39f4d3af87608245e04aa8ffe78c2c6b2b1,3,4,4,8,5,2012-03-16 16:42:02,2012-03-16 16:42:02
2e83e39f4d3af87608245e04aa8ffe78c2c6b2b1...24058a9db4286f0b4a3f1907b5a51cf18456ca09,3,10,6,16,7,2012-03-16 16:50:54,2012-03-16 16:50:07
24058a9db4286f0b4a3f1907b5a51cf18456ca09...35ef75d05fa18844903244ce954135ad1a242465,3,6,6,12,3,2012-03-16 16:52:44,2012-03-16 16:52:44
35ef75d05fa18844903244ce954135ad1a242465...9cd23f82b623da8a10fcac56665c988392379409,3,6,8,14,7,2012-03-16 17:46:21,2012-03-16 17:46:21
d3c332438611a8c85ada648440081220b4e77ca6...9454e667755812fe317b973b8dbd1a751d693d4b,3,240,0,240,3,2012-03-17 23:18:59,2012-03-17 23:18:59
d3c332438611a8c85ada648440081220b4e77ca6...7f38862f9f23ee0e1e85968c40432d765bf1e331,8,41,34,75,32,2012-03-17 00:17:32,2012-03-17 00:16:58
7f38862f9f23ee0e1e85968c40432d765bf1e331...e2c666ab67358b34acaa52f7a88d14fc7693166b,3,38,6,44,9,2012-03-17 00:32:33,2012-03-17 00:32:33
e2c666ab67358b34acaa52f7a88d14fc7693166b...ef7c743636e7b441cb0929f48f6801198b3e4d0b,4,76,52,128,39,2012-03-17 00:40:58,2012-03-17 00:40:58
ef7c743636e7b441cb0929f48f6801198b3e4d0b...22b1c0ba49161767441dbd50269f0f645257a99e,13,189,186,375,61,2012-03-19 22:43:15,2012-03-19 21:45:28
d3c332438611a8c85ada648440081220b4e77ca6...aba3c572bb6f40bc0e3438ff11388c7745c45d00,3,11,5,16,3,2012-03-15 08:56:43,2012-03-15 08:56:43
aba3c572bb6f40bc0e3438ff11388c7745c45d00...ce0de3d7d88cbab7f9ab08f45e0d034e69083048,3,5,9,14,3,2012-03-16 01:14:48,2012-03-16 01:14:48
d3c332438611a8c85ada648440081220b4e77ca6...7ac9a5db202a73d3f93b4993d98c2154e0042e54,2,5,2,7,3,2012-03-08 23:44:09,2012-03-08 23:44:09
7ac9a5db202a73d3f93b4993d98c2154e0042e54...18724b081ab75b0d86e067edec77e4651260b15e,1,1,1,2,1,2012-03-09 00:08:41,2012-03-09 00:08:41
d3c332438611a8c85ada648440081220b4e77ca6...21fe6d10f244f1dc7a7d71d7e628253af4ff2ef5,4,12,5,17,5,2012-03-08 09:56:15,2012-03-08 09:41:13
af5fccdca1ab23d719e88ae16dca8e76f2270cf8...98b6abd484e59c272faa9a7d78aad4a078ce4953,1,14,5,19,8,2011-11-14 02:28:09,2011-11-14 02:28:09
af5fccdca1ab23d719e88ae16dca8e76f2270cf8...da47ae88bd689a2ae6a0b8bee26f1b0df51ceba1,4,7,7,14,4,2011-11-10 20:31:54,2011-11-10 20:31:54
da47ae88bd689a2ae6a0b8bee26f1b0df51ceba1...3de298bc3723f896a59810d66076d638ba443ef8,4,8,3,11,4,2011-11-10 20:35:09,2011-11-10 20:35:09
af5fccdca1ab23d719e88ae16dca8e76f2270cf8...4d6b5bc342da33bcca23b1cda529d6f6f8951d69,5,11,11,22,6,2011-11-09 19:19:15,2011-11-05 01:53:22
af5fccdca1ab23d719e88ae16dca8e76f2270cf8...9a279efefe94cbf0d7826e01971e65be761cd968,7,27,5,32,11,2011-11-08 04:28:18,2011-11-08 04:28:18
e78cd68acc740434c3bfc55aae027941031a50a3...ff8225b2085fae217b0ec4c293bba75f0912c7a8,1,52,52,104,1,2011-11-04 22:14:06,2011-11-04 22:14:06
83f9b82794c9d30fe2b882d6d0f8593d47cdc0c8...92b010fbd16f828e4f791f0db9b59e264f0eff4d,3,3,3,6,3,2011-11-04 20:35:09,2011-11-04 20:35:09
92b010fbd16f828e4f791f0db9b59e264f0eff4d...070b463ac097079f468253ed17b8d35a5643e163,3,18,10,28,7,2011-11-04 20:38:13,2011-11-04 20:38:13
83f9b82794c9d30fe2b882d6d0f8593d47cdc0c8...1637c4b1594115dcdab974b8e76fe03c0517914d,3,3,3,6,3,2011-11-04 20:32:14,2011-11-04 20:32:14
1637c4b1594115dcdab974b8e76fe03c0517914d...4cfdc9488fce50e91d6f43628610148030da5776,3,5,11,16,7,2011-11-04 20:39:06,2011-11-04 20:39:06
8ea41735d9e77f5474b39f43a1d5cd9bbe59e12c...1196f55b4327e8f655c1388ecf50b4d646f22a26,2,8,2,10,3,2012-03-18 18:03:29,2012-03-18 18:03:29
4090261597d83fa94c3755b1b2decb388e335db1...7fe3ae41839e059db6f985d5556bcfbd5d9d80ff,3,16,10,26,9,2011-11-15 00:07:11,2011-11-15 00:07:11
7fe3ae41839e059db6f985d5556bcfbd5d9d80ff...204506cfb9880faaae029d601221d167d7837171,4,115,12,127,10,2011-11-16 21:16:14,2011-11-16 21:16:14
204506cfb9880faaae029d601221d167d7837171...0ad865fa5d4164172f27b05b531cf4b37f412e9b,1,1,1,2,1,2011-11-16 21:23:33,2011-11-16 21:23:33
0ad865fa5d4164172f27b05b531cf4b37f412e9b...3007db2f43bea06b13c7f9c90c7e5892398c688e,3,6,10,16,5,2011-11-16 21:45:28,2011-11-16 21:45:28
3de298bc3723f896a59810d66076d638ba443ef8...18dcad7438eb658ba5cd9ce4997c515ef102c13b,7,139,47,186,37,2011-11-10 23:16:46,2011-11-10 23:16:46
18dcad7438eb658ba5cd9ce4997c515ef102c13b...2f16227ebdec059170391e870202e29148fb2ca0,4,60,48,108,31,2011-11-10 23:46:07,2011-11-10 23:46:07
557abcc7c544d82398e5828ec10122be1a22e008...306d5047d78429e4caadd2eb087f5cfcf5f598d1,1,1,1,2,1,2011-11-04 20:48:56,2011-11-04 20:48:56
306d5047d78429e4caadd2eb087f5cfcf5f598d1...6fe70a81d4bc394ac32a48f77d8010d4e4b7f2e7,3,6,20,26,5,2011-11-04 21:10:01,2011-11-04 21:10:01
a9043b9650ce35d69ad0a243086f7c1277e1ce7f...6aad8c7c44bc77b329edbcb780f215efc1629dce,1,19,12,31,7,2011-11-04 18:28:27,2011-11-04 18:28:27
6aad8c7c44bc77b329edbcb780f215efc1629dce...4882a6448b3c53b351ab6e8d15eb96e0d380c45b,4,21,12,33,10,2011-11-04 19:03:01,2011-11-04 19:03:01
1196f55b4327e8f655c1388ecf50b4d646f22a26...969645e900ae24a6be309e562485e8790d9eaa7d,3,8,8,16,3,2012-04-03 12:59:38,2012-04-03 12:59:38
969645e900ae24a6be309e562485e8790d9eaa7d...cb3767510729b64e3a77ce25c24b46846f602a9e,3,5,5,10,4,2012-04-03 13:00:44,2012-04-03 13:00:44
1196f55b4327e8f655c1388ecf50b4d646f22a26...40c731d6885b51e469b02c2f6b65524410c8b097,3,5,5,10,5,2012-03-28 16:43:18,2012-03-28 16:43:18
1196f55b4327e8f655c1388ecf50b4d646f22a26...bf151c2877f5a19f2ae2d79651b87fa940418c41,1,4,2,6,1,2012-03-23 12:30:08,2012-03-23 12:30:08
bf151c2877f5a19f2ae2d79651b87fa940418c41...f16141517aaafa8917dbe677e73e00bd652767ff,1,4,0,4,1,2012-03-23 13:22:07,2012-03-23 13:22:07
1196f55b4327e8f655c1388ecf50b4d646f22a26...3d701402bf46018e979671a1c653c92c53f89f93,3,11,5,16,3,2012-03-23 12:06:03,2012-03-23 12:06:03
1196f55b4327e8f655c1388ecf50b4d646f22a26...48c4d87632702cf1a8b3e5d6ea0e6a11c941e6eb,1,1,0,1,1,2012-03-20 18:48:13,2012-03-20 18:48:13
48c4d87632702cf1a8b3e5d6ea0e6a11c941e6eb...76d353d3bedd6c776f452e9c23eade14d5c7723a,1,1,1,2,1,2012-03-30 01:00:27,2012-03-30 01:00:27
40657dff993dea662944be2e77d535676731cb33...4a01fb17e28a677f4b03fd467138648fa4454acd,2,3,2,5,2,2012-03-30 05:00:15,2012-03-30 05:00:15
b04112af83ece9c50af43bee81580d73be3f0833...5d57fa73a5cc99464fcd92f1fa8c8650c038b84b,1,4,0,4,1,2011-11-19 00:52:35,2011-11-19 00:52:35
88c6f28a8e6138b627502344b4ac41be21ecaf82...faec4c8befe2bba9f565b50c92b5118b80579727,3,4,2,6,3,2011-11-16 01:17:05,2011-11-16 01:17:05
6fe70a81d4bc394ac32a48f77d8010d4e4b7f2e7...e3f6f33b3d6e8845ad47dc069a00b985e9d569e9,5,113,6,119,8,2011-11-04 23:19:58,2011-11-04 23:19:58
e3f6f33b3d6e8845ad47dc069a00b985e9d569e9...a7ff9fa6e5ac50c9d0a96424220bbd9e974f0763,6,28,14,42,15,2011-11-04 23:46:35,2011-11-04 23:46:35
a7ff9fa6e5ac50c9d0a96424220bbd9e974f0763...d85d29e88768cc0fa290c38c1b2e413906609936,3,8,10,18,5,2011-11-05 02:03:17,2011-11-05 02:03:17
d85d29e88768cc0fa290c38c1b2e413906609936...9460e7f175eaa964c7ede00d78cef166b9bdc651,1,60,0,60,1,2011-11-05 02:05:06,2011-11-05 02:05:06
907c5a50f0f7cdfc6a1f3eea83d8af72b9262d95...d3bad29fae4d383526f6be2f739fe6b4eb4ee592,5,6,10,16,8,2012-04-19 01:30:22,2012-04-19 01:30:22
d3bad29fae4d383526f6be2f739fe6b4eb4ee592...c384fad0b3e205b583092d449604277c4e39242f,1,3,53,56,3,2012-04-25 01:27:23,2012-04-25 01:27:23
e65580968ba516d2cffc8a60a15837a5bb809dd1...41a8a86f523cc58c03d94716e6f5d517c6b75ca5,3,97,0,97,3,2012-04-04 15:10:44,2012-04-04 14:30:48
41a8a86f523cc58c03d94716e6f5d517c6b75ca5...09fdab534930f99b622b9888dc166ed83602b3e7,2,165,0,165,2,2012-04-04 15:12:12,2012-04-04 15:12:12
09fdab534930f99b622b9888dc166ed83602b3e7...3adff5ab570583e79fed3049994afe1b2c8176ad,15,549,464,1013,36,2012-04-04 17:44:22,2012-04-04 17:44:22
80628239d5a1a43ca7e13c1919928d495f6edc5d...39a74f49aed1865f411b3ba6ef9626d0a5b17f62,4,19,15,34,4,2012-03-30 05:07:11,2012-03-30 05:07:11
9c3038874e0fd1b3662c6cf7b1a36337f2f549b2...c790c3346861730664044fe7cdad5381a16feea5,2,3,2,5,3,2012-03-30 05:11:25,2012-03-30 05:11:25
5d57fa73a5cc99464fcd92f1fa8c8650c038b84b...75ddc2836873916df3f74b208b2b9d00440648bc,4,22,14,36,10,2011-11-22 21:08:55,2011-11-22 21:08:55
75ddc2836873916df3f74b208b2b9d00440648bc...1b3a3b3cb3d234e550cfcb46bfd776883b5d458b,17,107,121,228,45,2011-11-22 22:36:09,2011-11-22 22:36:09
c384fad0b3e205b583092d449604277c4e39242f...00bc3f05a72a9f9f7cc262f0903b16ecb2fd6f88,5,11,10,21,10,2012-04-26 05:18:02,2012-04-26 05:18:02
c384fad0b3e205b583092d449604277c4e39242f...e5abda534f177a655d1f9171a5485a6d5c2ee0b2,1,1,1,2,1,2012-04-25 23:31:48,2012-04-25 23:31:48
e5abda534f177a655d1f9171a5485a6d5c2ee0b2...ddc3a5f95e246aef91872d583995ee9c9e2d2ef9,1,1,1,2,1,2012-04-26 01:39:03,2012-04-26 01:39:03
ddc3a5f95e246aef91872d583995ee9c9e2d2ef9...d70b00cd6029fb8fd40b491f782520a5e2c27999,1,2,0,2,1,2012-04-26 01:59:42,2012-04-26 01:59:42
d70b00cd6029fb8fd40b491f782520a5e2c27999...8759241f59ac6a21ff2f883edb5b6a5e8c72a42b,1,1,3,4,1,2012-04-26 04:51:18,2012-04-26 04:51:18
8759241f59ac6a21ff2f883edb5b6a5e8c72a42b...7b5175c75f71646665280cfe3d23c3d81cbf163e,1,1,1,2,1,2012-04-26 06:01:47,2012-04-26 06:01:47
7b5175c75f71646665280cfe3d23c3d81cbf163e...831a2418944585c5242ad33f55981c14ac1553ae,1,0,4,4,1,2012-04-26 16:27:35,2012-04-26 16:27:35
831a2418944585c5242ad33f55981c14ac1553ae...c36891e4445d4b5aa5532ef9e49a2826c791e8df,1,1,1,2,1,2012-04-26 16:31:22,2012-04-26 16:31:22
c36891e4445d4b5aa5532ef9e49a2826c791e8df...637896b3863ded7492bf86d6117faa80fa4f1cbe,2,3,0,3,2,2012-05-01 14:35:58,2012-05-01 14:35:58
637896b3863ded7492bf86d6117faa80fa4f1cbe...2697a60ba0f3a5bdfd29bfb5ec0d13942f551779,1,2,2,4,2,2012-05-01 15:50:25,2012-05-01 15:50:25
3adff5ab570583e79fed3049994afe1b2c8176ad...e7025c7e4ae71118c80fb99765eee7e1422f61c6,4,2,7,9,6,2012-04-15 18:59:56,2012-04-15 18:59:56
3adff5ab570583e79fed3049994afe1b2c8176ad...4ffe6b40f367c696107b9c01a67812559159633a,3,3,3,6,3,2012-04-15 18:45:57,2012-04-15 18:45:57
3adff5ab570583e79fed3049994afe1b2c8176ad...dbfc36ddcac03e3548969825c92764f3cd126cd0,6,90,71,161,37,2012-04-06 01:43:34,2012-04-05 15:21:17
dbfc36ddcac03e3548969825c92764f3cd126cd0...1fdebcd976a5c6134d31430094d1f5eb3fb77e8b,2,30,20,50,10,2012-04-06 01:58:38,2012-04-06 01:49:16
1fdebcd976a5c6134d31430094d1f5eb3fb77e8b...c8c6292b2663d8a5afb315a8616eb5a9f0d9dac9,1,8,8,16,4,2012-04-06 02:14:06,2012-04-06 02:14:06
c8c6292b2663d8a5afb315a8616eb5a9f0d9dac9...02764fd2f378d1bcb75dc686d2add7d4f3ba3abc,5,55,48,103,30,2012-04-06 02:29:02,2012-04-06 02:17:20
02764fd2f378d1bcb75dc686d2add7d4f3ba3abc...95c3c0b87af5d59e36d9e1f1bc262db3d10c3227,1,9,9,18,5,2012-04-06 02:33:12,2012-04-06 02:33:12
95c3c0b87af5d59e36d9e1f1bc262db3d10c3227...14bd4fb5c50d84a744d0a5fb60c902ade7396696,1,7,7,14,4,2012-04-06 02:38:33,2012-04-06 02:38:33
14bd4fb5c50d84a744d0a5fb60c902ade7396696...588c0e231d3cfbaae00321bc16a06060a10a4180,3,53,51,104,21,2012-04-06 03:53:11,2012-04-06 03:46:26
588c0e231d3cfbaae00321bc16a06060a10a4180...27da6c24830d8c21ac5c446252e09498ebd73468,2,19,19,38,12,2012-04-06 04:00:55,2012-04-06 04:00:55
27da6c24830d8c21ac5c446252e09498ebd73468...cdaf99e66330002fabdbebe12144281997e3f6d3,1,10,10,20,5,2012-04-06 04:16:33,2012-04-06 04:16:33
cdaf99e66330002fabdbebe12144281997e3f6d3...b99ed1d79ea9da22fc871e979d130ebe6668504b,2,10,10,20,7,2012-04-06 04:19:31,2012-04-06 04:19:31
b99ed1d79ea9da22fc871e979d130ebe6668504b...e379ac650cf931c30b35df60e601dcc52d0fe9cc,2,21,21,42,11,2012-04-06 04:25:59,2012-04-06 04:23:25
e379ac650cf931c30b35df60e601dcc52d0fe9cc...c6125036b239fe1e848437beaf1f349d425f62e5,1,4,4,8,2,2012-04-06 04:30:22,2012-04-06 04:30:22
c6125036b239fe1e848437beaf1f349d425f62e5...e9aa9f874cf45bf04417fdb08b20a409a7676265,1,5,5,10,3,2012-04-06 04:34:54,2012-04-06 04:34:54
e9aa9f874cf45bf04417fdb08b20a409a7676265...6b76d014bd4d1496a4df9f66e80f47b4b400e99f,22,254,215,469,102,2012-04-06 10:42:22,2012-04-06 04:42:30
6b76d014bd4d1496a4df9f66e80f47b4b400e99f...30fac09a53fbafbf4ed43bc0be1136954dccbf61,1,13,13,26,6,2012-04-06 10:47:11,2012-04-06 10:47:11
30fac09a53fbafbf4ed43bc0be1136954dccbf61...87ed836b21e285d02ed070258691ce32bb200a18,1,19,14,33,7,2012-04-06 10:48:58,2012-04-06 10:48:58
87ed836b21e285d02ed070258691ce32bb200a18...9a3cd7e3cf3273bc239b1b9a2e9c13c71b9230e8,1,9,9,18,4,2012-04-06 10:49:52,2012-04-06 10:49:52
9a3cd7e3cf3273bc239b1b9a2e9c13c71b9230e8...5e0be4778157bd59e9462a52898fa47ec33135c5,7,57,53,110,30,2012-04-06 11:18:45,2012-04-06 10:54:10
5e0be4778157bd59e9462a52898fa47ec33135c5...707fbec29d6300b1851052d2c07903dfae66b37b,1,4,4,8,2,2012-04-06 11:19:37,2012-04-06 11:19:37
707fbec29d6300b1851052d2c07903dfae66b37b...71978d9e06620b91103d5da786db8440b1dfd7a5,2,18,6,24,2,2012-04-06 16:07:16,2012-04-06 16:07:16
71978d9e06620b91103d5da786db8440b1dfd7a5...eb15be6325fba5333629af74ad9f561bf6cc4505,1,23,23,46,12,2012-04-06 16:09:32,2012-04-06 16:09:32
eb15be6325fba5333629af74ad9f561bf6cc4505...14fe6f1f69e8b2fd14a0a6f6be5b798629b09924,1,6,6,12,3,2012-04-06 16:10:40,2012-04-06 16:10:40
14fe6f1f69e8b2fd14a0a6f6be5b798629b09924...0305892a9619cda5a1e169d25743ddd7f86bed33,1,16,10,26,5,2012-04-06 16:17:09,2012-04-06 16:17:09
0305892a9619cda5a1e169d25743ddd7f86bed33...e778b476322c1dac9437223c39f09ef6fef6f378,1,16,10,26,3,2012-04-06 16:20:49,2012-04-06 16:20:49
e778b476322c1dac9437223c39f09ef6fef6f378...68047860fb6ef74b6eadf85979b404e3b6fbda0b,1,5,5,10,3,2012-04-06 16:22:20,2012-04-06 16:22:20
68047860fb6ef74b6eadf85979b404e3b6fbda0b...b7415fe136617a7fe3e2bd51ef71a7428984343c,1,6,6,12,4,2012-04-06 16:25:31,2012-04-06 16:25:31
b7415fe136617a7fe3e2bd51ef71a7428984343c...ff381ae00938d9e0bb095a140970c67205afc7b2,1,5,5,10,3,2012-04-06 16:26:45,2012-04-06 16:26:45
ff381ae00938d9e0bb095a140970c67205afc7b2...56557c9d750166489a9502a59ea7fca45f8b713f,1,11,9,20,5,2012-04-06 16:30:29,2012-04-06 16:30:29
56557c9d750166489a9502a59ea7fca45f8b713f...2fe66c1092e8603726eda814315722dc5bd76367,4,40,30,70,14,2012-04-06 16:37:01,2012-04-06 16:37:01
2fe66c1092e8603726eda814315722dc5bd76367...95ecb7e17a939c5b315eb49008051347c2e13284,2,16,15,31,9,2012-04-06 16:39:49,2012-04-06 16:39:49
95ecb7e17a939c5b315eb49008051347c2e13284...aa575adb9840d86de421b153ae189f711d3a8d48,1,12,8,20,4,2012-04-06 16:42:24,2012-04-06 16:42:24
aa575adb9840d86de421b153ae189f711d3a8d48...336b0cdbd8ce91e37e2f60d735ec496cc52328e4,1,9,9,18,5,2012-04-07 01:15:43,2012-04-07 01:15:43
336b0cdbd8ce91e37e2f60d735ec496cc52328e4...b808c8984e940c7887460574fe44e7c9bd704a52,1,8,8,16,5,2012-04-07 01:17:27,2012-04-07 01:17:27
b808c8984e940c7887460574fe44e7c9bd704a52...003dd7dd76634496125620999d35a95e38c9d3e4,1,14,8,22,3,2012-04-07 01:21:04,2012-04-07 01:21:04
003dd7dd76634496125620999d35a95e38c9d3e4...82af78cbd3f53fd04f838574d974b347bdb5d4c0,1,55,51,106,37,2012-04-07 01:26:49,2012-04-07 01:26:49
82af78cbd3f53fd04f838574d974b347bdb5d4c0...d5585fb8dd2c0d8d4290ebd956880566a00b9989,1,17,10,27,4,2012-04-07 01:33:30,2012-04-07 01:33:30
d5585fb8dd2c0d8d4290ebd956880566a00b9989...3fd8ce206025133f449e73693955447f45f8966b,1,9,9,18,5,2012-04-07 01:35:35,2012-04-07 01:35:35
3fd8ce206025133f449e73693955447f45f8966b...30e81f0eae6351e728fc53bb4aae6181999ca4af,1,7,2,9,1,2012-04-07 01:39:35,2012-04-07 01:39:35
30e81f0eae6351e728fc53bb4aae6181999ca4af...8b775c032c3738f7a8f04444165ad0936572afed,2,22,22,44,10,2012-04-07 01:48:52,2012-04-07 01:48:52
8b775c032c3738f7a8f04444165ad0936572afed...2fc903b550581b2f24d04eab85bc5ae3beacd3e0,2,24,16,40,8,2012-04-07 01:59:56,2012-04-07 01:59:56
2fc903b550581b2f24d04eab85bc5ae3beacd3e0...c5465cad02853d819d88f7f61e4bb675965d2c39,1,6,6,12,3,2012-04-07 02:03:58,2012-04-07 02:03:58
c5465cad02853d819d88f7f61e4bb675965d2c39...d4b0939ba15f9d6c45cee2512d3a4aeb717de820,4,23,23,46,15,2012-04-07 04:29:53,2012-04-07 04:26:22
d4b0939ba15f9d6c45cee2512d3a4aeb717de820...30ad8bcc551925532d4b90e168fc3b77f2632a2c,2,10,10,20,6,2012-04-07 04:30:46,2012-04-07 04:30:46
30ad8bcc551925532d4b90e168fc3b77f2632a2c...29ece588f0581eb1f7397017056cba18cb57b2b2,2,16,13,29,5,2012-04-07 04:33:34,2012-04-07 04:33:34
29ece588f0581eb1f7397017056cba18cb57b2b2...a5b94849c9492a4191c4076e604fb419ba376079,1,5,5,10,3,2012-04-07 04:34:26,2012-04-07 04:34:26
a5b94849c9492a4191c4076e604fb419ba376079...df1bacfedc9167868a5b53be222b81fd64ef83e3,1,11,4,15,1,2012-04-07 04:36:20,2012-04-07 04:36:20
2df8c62c14487017481f755c4149471528c962a8...3d6b4cf2fb12474a4c08e13efa866e4d821ace36,5,41,2,43,5,2011-11-23 20:44:04,2011-11-23 20:44:04
2df8c62c14487017481f755c4149471528c962a8...552622da17d5bacee0b3302ddc0ce722344a4441,8,211,95,306,23,2011-11-23 20:05:52,2011-11-23 20:05:52
552622da17d5bacee0b3302ddc0ce722344a4441...532bf71766904a11b5b2ec4f4f2dcc18c49f3475,6,134,26,160,26,2011-11-23 20:30:49,2011-11-23 20:30:49
2697a60ba0f3a5bdfd29bfb5ec0d13942f551779...fe6d0fd2f28566d4c2995769d0b2532972f881ed,4,38,30,68,4,2012-05-09 21:04:00,2012-05-09 21:04:00
2697a60ba0f3a5bdfd29bfb5ec0d13942f551779...1affcd21783f3143d07383c3aea039b2a6c01bda,2,2,1,3,2,2012-05-09 17:29:22,2012-05-09 17:29:22
2697a60ba0f3a5bdfd29bfb5ec0d13942f551779...95b1eaaf68a1e75e6cf95b88d7e4bbc834b8489d,3,38,4,42,5,2012-05-03 23:27:22,2012-05-03 14:59:42
95b1eaaf68a1e75e6cf95b88d7e4bbc834b8489d...53d117e6d3ce611c7f0d7f74a07e2506c9c1caa1,3,6,40,46,5,2012-05-04 07:24:33,2012-05-04 06:41:25
f87f85b9c6e236f20dec8151ae11438950aaf967...cdffe18d383e47f77d6388f875a377539b20dcd2,2,17,13,30,7,2012-04-15 21:30:52,2012-04-15 21:30:52
cdffe18d383e47f77d6388f875a377539b20dcd2...d165879534bfbbf682842a5c55001eb6d2d6360d,3,3,5,8,3,2012-04-15 21:39:54,2012-04-15 21:39:54
dd2a424f2bdb8fae1dab5ac27168f5bba186a0c4...4059d3b3f5197075686821aeaaa578fbb4c478bb,4,7,5,12,4,2012-06-22 00:35:23,2012-06-22 00:35:23
dd2a424f2bdb8fae1dab5ac27168f5bba186a0c4...0f12c1b8a8302d05464dd736d347f044b8e05156,4,25,9,34,7,2012-06-14 16:33:08,2012-05-29 22:16:22
dd2a424f2bdb8fae1dab5ac27168f5bba186a0c4...3594c39c29fecad9677b7ae18b41dfe3229f1c7d,4,9,6,15,4,2012-06-01 03:45:54,2012-06-01 03:26:45
dd2a424f2bdb8fae1dab5ac27168f5bba186a0c4...8e17e0f3a55c81e579d151331c2f6d2bf9ccd6dc,1,1,1,2,1,2012-05-29 13:43:52,2012-05-29 13:43:52
dd2a424f2bdb8fae1dab5ac27168f5bba186a0c4...82051284b1c8b0e468ed5c908347d2f15b575cb2,1,10,6,16,9,2012-05-27 14:25:43,2012-05-27 14:25:08
82051284b1c8b0e468ed5c908347d2f15b575cb2...40ca7f2df7c3360f569d0208609729c1a587e484,1,3,3,6,3,2012-05-27 15:13:10,2012-05-27 15:13:10
1affcd21783f3143d07383c3aea039b2a6c01bda...234c834d819bb0f7312e707ce747b533fa9b2184,1,2,2,4,2,2012-05-10 22:23:31,2012-05-10 22:23:31
234c834d819bb0f7312e707ce747b533fa9b2184...4860ec0cb05d5b7a3dbfb04bbfa8a009d9d8a7a0,3,5,3,8,3,2012-05-11 08:51:12,2012-05-11 08:51:12
4860ec0cb05d5b7a3dbfb04bbfa8a009d9d8a7a0...7827bdc83185ab7e075286ee0e0c9a8126b29681,3,6,4,10,3,2012-05-11 13:49:48,2012-05-11 13:49:48
e4f4a312529503bcab42c4f93b106121a4528b16...8598dc40bf25514f5ff25bad1daddf78d15cfd1e,5,134,7,141,5,2012-06-24 17:43:13,2012-06-24 17:43:13
ad43a2e843a0d1fc8a7d25a2f740cc0971656e16...cc359a9329a2f89ed917e722ea07807d23322e31,7,58,64,122,17,2012-06-24 16:27:09,2012-06-24 16:22:23
ad43a2e843a0d1fc8a7d25a2f740cc0971656e16...7e0daf2b4ef17a7010f31613d6c05ff28dbfb651,1,1,3,4,2,2012-06-20 22:14:10,2012-06-20 22:14:10
7e0daf2b4ef17a7010f31613d6c05ff28dbfb651...bd229712fb16c54aa9cd7670c63327a4f8cfad6f,2,5,7,12,3,2012-06-24 16:59:41,2012-06-24 16:59:41
bd229712fb16c54aa9cd7670c63327a4f8cfad6f...4142e432c4d03c006a3f657b29d196c95542bded,3,3,3,6,3,2012-06-24 17:00:28,2012-06-24 17:00:28
e71de33e31bf0ea539e5085566cca6061aa17c88...10570e915d6781f4af0e335bc67805764174678a,3,8,8,16,3,2012-07-02 08:27:37,2012-07-02 08:19:39
10570e915d6781f4af0e335bc67805764174678a...9865daadf80f6077f286847dea47a70324f450cd,3,16,6,22,3,2012-07-02 16:02:44,2012-07-02 15:53:51
9865daadf80f6077f286847dea47a70324f450cd...8710e5bbd174d9c6ae82642796aec1f5f4c36086,1,34,0,34,1,2012-07-02 16:02:52,2012-07-02 16:02:52
8710e5bbd174d9c6ae82642796aec1f5f4c36086...3c082bf2454fd69eb252754dca7f697f2c02a1a4,4,16,36,52,7,2012-07-02 17:59:06,2012-07-02 17:59:06
3c082bf2454fd69eb252754dca7f697f2c02a1a4...54b0dcba00730de2bca56c445b364cc8798088ff,5,140,82,222,37,2012-07-02 23:58:54,2012-07-02 23:58:54
54b0dcba00730de2bca56c445b364cc8798088ff...d0b0af50b6d369b3b7a4af7298034c981d364814,4,11,6,17,7,2012-07-03 00:42:23,2012-07-03 00:42:23
e71de33e31bf0ea539e5085566cca6061aa17c88...53fa8f1a4af1d37e5f5d94ff980b6acf46a44a23,5,59,54,113,22,2012-06-30 17:35:58,2012-06-30 17:35:58
e71de33e31bf0ea539e5085566cca6061aa17c88...fd6c591b76283fa291da0bf8b0c2a5709b1ebe64,4,48,28,76,29,2012-06-29 03:41:33,2012-06-29 03:41:33
e71de33e31bf0ea539e5085566cca6061aa17c88...ae1fed7f4f7c9a585190cfa08f30d4878cb311fa,9,22,20,42,17,2012-06-29 00:43:26,2012-06-29 00:43:26
e71de33e31bf0ea539e5085566cca6061aa17c88...66b439d4336110e4287b5c5d336567696a240df2,14,406,253,659,28,2012-06-28 19:58:39,2012-06-28 19:57:36
e71de33e31bf0ea539e5085566cca6061aa17c88...d12f42d8a3581b94835a15d61fbc1e258bb2bc35,3,64,86,150,43,2012-06-28 19:21:32,2012-06-28 19:21:32
e71de33e31bf0ea539e5085566cca6061aa17c88...47adcf5d098dc8da03b246f24fee80721fe27ae5,5,80,64,144,29,2012-06-28 03:20:22,2012-06-28 03:03:08
e71de33e31bf0ea539e5085566cca6061aa17c88...f7ed0304bfa5fb3162974302a8c2a1ef851359a8,3,54,36,90,11,2012-06-25 20:03:55,2012-06-25 20:03:55
c5d230d16eeea0d9cc1328add3bf2c2dbe658571...544addb462ee96fe9a0674203d1af462d9b8fd01,2,5,2,7,2,2012-07-13 16:02:12,2012-07-13 16:02:12
c5d230d16eeea0d9cc1328add3bf2c2dbe658571...42b9253f96aa5704eec941d34f5cf17a6bf71a90,4,18,18,36,9,2012-07-10 15:40:19,2012-07-10 15:37:52
c5d230d16eeea0d9cc1328add3bf2c2dbe658571...69f02eb5fc849a69941cf56d3ead70a9dfc4e26d,3,20,14,34,7,2012-07-05 07:44:28,2012-07-05 07:42:36
c5d230d16eeea0d9cc1328add3bf2c2dbe658571...9cf2595fd1b17f9f2bd693cad2a998f105f10be5,3,6,16,22,3,2012-07-04 18:21:05,2012-07-04 18:21:05
79a3c0d31cdb7410fc2da417405dc0cfe02c60c9...2d9fe177d0f89324552319eb8914314c2ae3c111,9,60,66,126,18,2012-08-09 00:53:46,2012-08-09 00:53:46
544addb462ee96fe9a0674203d1af462d9b8fd01...7e92806b740966a065913b4d28e0f91ce2d2d5a8,1,1,1,2,1,2012-07-25 23:23:22,2012-07-25 23:23:22
7e92806b740966a065913b4d28e0f91ce2d2d5a8...ef1730bdff3611fc4c0632c26b55568b18ae7dd2,1,1,1,2,1,2012-07-25 23:24:26,2012-07-25 23:24:26
ef1730bdff3611fc4c0632c26b55568b18ae7dd2...a912896e9728e8fb44b56e3024bf52d1a1afe8df,2,5,3,8,3,2012-07-26 00:25:03,2012-07-26 00:25:03
a912896e9728e8fb44b56e3024bf52d1a1afe8df...e4181f39b2a1ccbbf7b0f7baa3ba0312fa979299,1,4,4,8,1,2012-07-26 00:26:06,2012-07-26 00:26:06
544addb462ee96fe9a0674203d1af462d9b8fd01...1e69f5e7b960ab4290827c6c41c5b2045aeb96c3,3,18,31,49,13,2012-07-25 20:35:03,2012-07-25 20:35:03
544addb462ee96fe9a0674203d1af462d9b8fd01...7c289774205b2e9da0def2253009f2756607874c,3,12,12,24,5,2012-07-25 12:00:40,2012-07-25 12:00:40
7c289774205b2e9da0def2253009f2756607874c...9b3e7800067511188f60f626ff8ce165519dcbf0,4,16,16,32,5,2012-07-25 12:46:20,2012-07-25 12:46:20
9b3e7800067511188f60f626ff8ce165519dcbf0...eadf003d2f17d06bbd9d19fba21b45ea881724dc,3,8,8,16,3,2012-07-25 14:26:05,2012-07-25 14:26:05
544addb462ee96fe9a0674203d1af462d9b8fd01...1893f2941b6f25d55a9fd0c516b186fa77384bac,4,21,8,29,7,2012-07-25 09:02:49,2012-07-25 09:02:49
1893f2941b6f25d55a9fd0c516b186fa77384bac...418811360c170b974902a22ecf73f06307db42d1,1,4,0,4,1,2012-07-25 17:18:44,2012-07-25 17:18:44
418811360c170b974902a22ecf73f06307db42d1...5b04aa08388fb024b1c7c1c0183891a8e1278fcb,3,5,5,10,3,2012-07-25 17:22:03,2012-07-25 17:22:03
5b04aa08388fb024b1c7c1c0183891a8e1278fcb...aa3e38e398290cd6fd62905eba887300baf38606,6,128,21,149,9,2012-07-25 18:36:21,2012-07-25 18:34:38
544addb462ee96fe9a0674203d1af462d9b8fd01...839fcd4d4d0a7048ec3bbfaf39a47b735dd813ef,5,131,57,188,20,2012-07-24 17:45:52,2012-07-24 17:38:05
839fcd4d4d0a7048ec3bbfaf39a47b735dd813ef...feb2cefeae7ff5a42cbbf5bcc34f99c935070322,4,84,84,168,15,2012-07-24 18:49:39,2012-07-24 18:48:26
feb2cefeae7ff5a42cbbf5bcc34f99c935070322...a40c1537da4954da37031aa2e6c3c3e45605bf55,4,238,204,442,25,2012-07-24 20:17:11,2012-07-24 20:17:11
a40c1537da4954da37031aa2e6c3c3e45605bf55...c3716c72cb39065661e353000b6e3e0f0cd9c872,3,70,74,144,15,2012-07-24 20:25:55,2012-07-24 20:25:55
c3716c72cb39065661e353000b6e3e0f0cd9c872...29a674b9736be9384ec8e077edeba475f3a892e3,2,2,2,4,2,2012-07-25 09:58:06,2012-07-25 09:58:06
544addb462ee96fe9a0674203d1af462d9b8fd01...e8f5d860e2011c344c8e445963c3c8be35eec3c9,4,25,3,28,4,2012-07-23 17:34:39,2012-07-23 17:34:39
544addb462ee96fe9a0674203d1af462d9b8fd01...fe803629f1cd5460b385a34e7ae205dc842c6b96,4,16,11,27,4,2012-07-23 15:15:01,2012-07-23 15:08:26
544addb462ee96fe9a0674203d1af462d9b8fd01...7c3f2cce20c152c576717fea43f682d33439d0f7,3,11,9,20,9,2012-07-21 01:00:10,2012-07-21 01:00:10
544addb462ee96fe9a0674203d1af462d9b8fd01...fb86373a3d6fd8e88624209a180313bf3a1aafa7,1,2,1,3,1,2012-07-19 18:02:35,2012-07-19 18:02:35
544addb462ee96fe9a0674203d1af462d9b8fd01...5c1cd6bd2cab927c381f503120a124a91335b18b,1,2,1,3,1,2012-07-17 20:45:18,2012-07-17 20:45:18
5c1cd6bd2cab927c381f503120a124a91335b18b...83b5f459979a062a1da38d4675be746788697883,9,31,7,38,11,2012-07-17 20:45:34,2012-07-17 20:45:34
9cf2595fd1b17f9f2bd693cad2a998f105f10be5...8c9fed492bb7fac1aade18a660278562445e7673,4,15,5,20,6,2012-07-04 18:22:08,2012-07-04 18:22:08
15ba641fa35022a3becf48c1154a9f319fef0f47...3d4d67930bb532f367b3bf7da92d3f0bd4efe4fc,8,69,44,113,28,2012-08-09 02:12:43,2012-08-09 02:12:43
3d4d67930bb532f367b3bf7da92d3f0bd4efe4fc...e42eb90ca8f52bdcb6a6b346766f4e07af21f77f,5,107,4,111,5,2012-08-09 03:33:30,2012-08-09 03:33:23
e42eb90ca8f52bdcb6a6b346766f4e07af21f77f...952abefad0e92a628755938f8e4dc32c0a584ab2,4,78,11,89,6,2012-08-09 03:42:12,2012-08-09 03:40:36
952abefad0e92a628755938f8e4dc32c0a584ab2...cded852ba4c6bbe3c3f2936bf97d5a9248e558a9,10,434,6,440,12,2012-08-09 04:22:21,2012-08-09 04:22:21
7905b83694a5d6eb5cce6cb8894945a79c52904e...cb832c147b9999db5d67982163d0df1ebae3c7b7,2,3,5,8,3,2012-07-31 20:29:20,2012-07-31 20:29:20
14ab1b3d019b0e53887d72dc91b7ded4e3a8077f...ef8672cb7d2ab8c70a15285f1ac60f3f88f7bb5c,5,222,205,427,34,2012-07-31 02:42:32,2012-07-31 02:42:32
fb86373a3d6fd8e88624209a180313bf3a1aafa7...e0275d537f62e3023c4306f8c7a0672cfaeef391,1,3185,3215,6400,1,2012-07-31 00:05:24,2012-07-31 00:05:24
fb86373a3d6fd8e88624209a180313bf3a1aafa7...fd308af6ca4c1032904feb710d21b9385624509a,2,6579,9178,15757,212,2012-07-19 18:07:36,2012-07-19 18:07:36
43360e48ff91d2b7714ac344a409e2025847e516...b4d799375d373d7decb74073224b2b9be0006af5,4,22,11,33,9,2012-07-31 07:38:13,2012-07-31 07:38:13
b0686e2a5d6ed18ddae52219224895640264db06...05da7af849af2af81ce4f567caee9eeacd3aa9a3,4,11,6,17,4,2012-08-16 20:26:14,2012-08-16 20:26:14
b0686e2a5d6ed18ddae52219224895640264db06...51b2e678d25d34ed58a20751394ba5853712491d,7,49,41,90,9,2012-08-12 17:34:05,2012-08-12 17:34:05
51b2e678d25d34ed58a20751394ba5853712491d...16f56395a6937f959afd59656449ef5af424ad86,1,2,1,3,2,2012-08-12 17:45:12,2012-08-12 17:45:12
16f56395a6937f959afd59656449ef5af424ad86...739267446a1a7a8402f26230b313e0925104b86e,1,5,3,8,2,2012-08-12 17:45:27,2012-08-12 17:45:27
739267446a1a7a8402f26230b313e0925104b86e...550e84d36c3ea18917dd0130dc58ca3aac413cd9,2,4,13,17,5,2012-08-12 21:17:50,2012-08-12 21:17:50
550e84d36c3ea18917dd0130dc58ca3aac413cd9...55acabc8e9dd70266881a72bb353a991ef14cf48,8,93,64,157,15,2012-08-13 18:58:53,2012-08-13 18:55:54
55acabc8e9dd70266881a72bb353a991ef14cf48...87d65b8703aa7f39675877b8ed9ab71e6737dffe,3,6,7,13,3,2012-08-13 20:10:43,2012-08-13 20:10:43
87d65b8703aa7f39675877b8ed9ab71e6737dffe...7a5ed691a766a3d22493598ccc435d886df1ff00,3,22,20,42,7,2012-08-13 20:23:49,2012-08-13 20:23:49
7a5ed691a766a3d22493598ccc435d886df1ff00...48405f6cf6ef522dc3aaac3b474a1e774082fdd7,3,37,32,69,9,2012-08-13 20:31:55,2012-08-13 20:31:55
48405f6cf6ef522dc3aaac3b474a1e774082fdd7...9daa61fb70ec5ef024dd9bb1ef22a03351e734b5,3,16,23,39,5,2012-08-13 20:34:41,2012-08-13 20:34:41
b0686e2a5d6ed18ddae52219224895640264db06...7a2553dccf2c057ddc80fd76edd0161ec84ee2ae,1,14,0,14,1,2012-08-12 09:22:50,2012-08-12 09:22:50
ea48a4a5af7d9822210dfb12fbef79bcb947de5e...06deb8f86b642446dd202b1dd625052b1d38b3d2,4,12,27,39,10,2012-07-31 20:56:18,2012-07-31 20:56:18
108d65da0eebd431425bf3aa51f0ed234d04975e...d6d2792b53d90b041f840611d0a84bf6e0cf52fc,7,75,95,170,21,2012-08-07 19:21:49,2012-08-07 19:19:18
d6d2792b53d90b041f840611d0a84bf6e0cf52fc...fbcc82bf34c5a24dcf594e6aab13ffd3ff5545e3,6,46,55,101,11,2012-08-07 19:35:10,2012-08-07 19:35:10
108d65da0eebd431425bf3aa51f0ed234d04975e...1976674fc77000ae599a9595e5be4b68d1bdcd67,4,81,19,100,12,2012-08-05 16:52:31,2011-08-28 23:25:48
1976674fc77000ae599a9595e5be4b68d1bdcd67...5c1dd6d90493d0b295824eddfaa97da37b766841,5,106,16,122,14,2012-08-05 16:53:07,2011-08-28 23:59:40
5c1dd6d90493d0b295824eddfaa97da37b766841...ce8852b9b43c69a29da9f6e1f9e92d745cc787b3,4,81,12,93,9,2012-08-05 16:53:33,2011-08-29 00:07:55
ce8852b9b43c69a29da9f6e1f9e92d745cc787b3...b20c823d6ab82d2f24fd55d9b1fd432871052fba,3,31,28,59,12,2012-08-05 17:09:16,2012-08-05 17:09:16
b20c823d6ab82d2f24fd55d9b1fd432871052fba...d4f6f4dd8d354ecc307c6fc71d07b86e9876df14,4,42,35,77,13,2012-08-05 17:38:00,2012-08-05 17:38:00
d4f6f4dd8d354ecc307c6fc71d07b86e9876df14...a39ca24fb81e4f8d8dd0df2d43502b1b771f699f,3,24,22,46,9,2012-08-05 17:42:28,2012-08-05 17:42:28
a39ca24fb81e4f8d8dd0df2d43502b1b771f699f...f2b45c132d4770d5d7c4a2976a32f36fd45fb007,8,239,133,372,37,2012-08-05 21:54:02,2012-08-05 21:54:02
f2b45c132d4770d5d7c4a2976a32f36fd45fb007...74596a90f7b5b9efa6041caad612ea0b82c03e9c,10,27,141,168,31,2012-08-05 22:52:10,2012-08-05 22:52:10
74596a90f7b5b9efa6041caad612ea0b82c03e9c...07f72be0aa818da05fb597effa391de82e2bcb36,6,86,46,132,18,2012-08-05 23:29:04,2012-08-05 23:29:04
07f72be0aa818da05fb597effa391de82e2bcb36...48570c61bad7bc102ff5b2b2d4b9553ecf8a7050,4,44,5,49,5,2012-08-05 23:39:11,2012-08-05 23:39:11
108d65da0eebd431425bf3aa51f0ed234d04975e...3064f0aaf52f7cc3f1c68dd541b8c0cdb2ac18ce,5,22,18,40,7,2012-08-04 19:02:17,2012-08-04 19:02:17
3064f0aaf52f7cc3f1c68dd541b8c0cdb2ac18ce...91630afcab4cee316817ec930b9bfb034b8e10e0,6,23,181,204,15,2012-08-04 19:13:16,2012-08-04 19:11:35
108d65da0eebd431425bf3aa51f0ed234d04975e...da3131c87614b2a9924aa71931e37802eb0efae1,6,38,38,76,13,2012-08-03 00:48:26,2012-08-03 00:48:26
108d65da0eebd431425bf3aa51f0ed234d04975e...bb075f612e22a220b2fe0f3a47e5e387c8d19a07,3,28,22,50,5,2012-08-01 12:23:35,2012-08-01 12:07:13
bb075f612e22a220b2fe0f3a47e5e387c8d19a07...e56e246f8cb7b7f53723ea4a5918fba720f85144,1,1,1,2,1,2012-08-01 12:31:48,2012-08-01 12:31:48
e56e246f8cb7b7f53723ea4a5918fba720f85144...b484273b46a211205410469265ffc28da0821311,1,40,0,40,1,2012-08-01 21:29:21,2012-08-01 21:29:21
108d65da0eebd431425bf3aa51f0ed234d04975e...7133162c2a2b20a1fa32c65776beba08f378c759,8,40,24,64,12,2012-08-01 02:38:36,2012-08-01 02:38:36
62d18a111ea47074079ff8e6918128950573bf3f...f0c5c468859213e25bef0860f993637c68d4fbb5,1,7,7,14,3,2012-07-31 06:43:35,2012-07-31 06:43:35
f0c5c468859213e25bef0860f993637c68d4fbb5...b102a485fa8cdffe9e5ca28fc4c0c43f92f01bb2,3,79,79,158,17,2012-07-31 07:27:14,2012-07-31 07:27:14
b4d799375d373d7decb74073224b2b9be0006af5...65a464582d407d7ef6207623fec2782d9391cb00,4,71,5,76,10,2012-07-31 13:00:26,2012-07-31 13:00:26
b4d799375d373d7decb74073224b2b9be0006af5...ed131d2374bffd67f4ef4df9b2e652a9f0b3a70b,5,74,37,111,18,2012-07-31 12:01:45,2012-07-31 12:01:45
ed131d2374bffd67f4ef4df9b2e652a9f0b3a70b...e9abea57d30b10450f9ac7bffe1a122c5be43e8b,4,94,88,182,21,2012-07-31 12:42:48,2012-07-31 12:38:41
e9abea57d30b10450f9ac7bffe1a122c5be43e8b...11e1efa3a3fb369b5380b5be18a94d5e00a3ae34,4,53,10,63,8,2012-07-31 13:51:49,2012-07-31 13:51:49
11e1efa3a3fb369b5380b5be18a94d5e00a3ae34...20d38f82114e8f12358cd84cfdea4b7de64c73c2,1,11,14,25,6,2012-07-31 15:15:30,2012-07-31 15:15:30
b4d799375d373d7decb74073224b2b9be0006af5...ba009d9f3b04e001e0ae2a60eedc98c978365942,1,5,5,10,5,2012-07-31 11:03:01,2012-07-31 10:43:35
38a6c302de152dedc69e4d614c6eb457e6f5669c...dceb459a273466449af54c058b1f4a5b15557911,5,71,68,139,29,2012-08-31 20:11:34,2012-08-31 20:11:34
dceb459a273466449af54c058b1f4a5b15557911...0c1d23d384ea3ee65929cf100f7d3138dc3ae7d6,3,15,9,24,10,2012-09-04 01:56:32,2012-09-04 01:56:32
38a6c302de152dedc69e4d614c6eb457e6f5669c...82af000cbf65ef05a52566860bef7b25ee944567,5,5,5,10,5,2012-08-21 11:04:53,2012-08-21 11:04:37
38a6c302de152dedc69e4d614c6eb457e6f5669c...7155ffa9e317c94f99134ae5fac256dd51806b89,3,3,5,8,5,2012-08-20 21:20:44,2012-08-20 21:15:08
7155ffa9e317c94f99134ae5fac256dd51806b89...e5ae048b613f98b96ae8e6c7493516c6d1d07512,1,0,1,1,1,2012-08-20 22:25:10,2012-08-20 22:25:10
38a6c302de152dedc69e4d614c6eb457e6f5669c...abd6f89bb9a26d19d58b0845e686ec4b7efb8a36,3,7,7,14,3,2012-08-16 21:40:48,2012-08-16 21:40:48
38a6c302de152dedc69e4d614c6eb457e6f5669c...0c3ec49dd9e7d5688238fcdf98fe9512724b40ca,4,95,39,134,20,2012-08-15 22:25:15,2012-08-15 22:21:19
0c3ec49dd9e7d5688238fcdf98fe9512724b40ca...22bf99605acc26c01a5ff262d348502f68c33845,4,48,7,55,7,2012-08-15 22:58:58,2012-08-15 22:58:58
22bf99605acc26c01a5ff262d348502f68c33845...4946a8cf33faae4d61cb04d6fd6bc3ec810ed926,4,19,5,24,4,2012-08-16 07:32:47,2012-08-16 07:32:47
38a6c302de152dedc69e4d614c6eb457e6f5669c...22fddfb916e7ecbc9c428c7c03158965d4bd2f3f,4,139,4,143,5,2012-08-15 14:43:09,2012-08-15 14:43:09
22fddfb916e7ecbc9c428c7c03158965d4bd2f3f...604476dee96dda33efbe195392d50e541c0a04af,4,69,143,212,6,2012-08-15 15:08:37,2012-08-15 15:06:27
604476dee96dda33efbe195392d50e541c0a04af...e3f4b90aa52a34271893f8973ddb1615abe6b821,2,8,8,16,8,2012-08-15 15:13:01,2012-08-15 15:13:01
38a6c302de152dedc69e4d614c6eb457e6f5669c...31d205cb7bf8658668c7bd543a6ed2f3e3a6eb5e,4,6016,6016,12032,559,2012-08-12 22:14:44,2012-08-12 22:05:41
b878f258e01ccaa1f8dc177016e369486f8cbaa1...540d3ace3e4e4c25ff93c011b62f157684c510ca,1,1,1,2,1,2012-07-31 21:54:04,2012-07-31 21:54:04
ce502a4e5a040cd5085d31c4268446f4a2e7aa60...80009768b63c2f40283115be86ace3fed8e1e0fc,4,9,5,14,4,2012-09-04 02:18:32,2012-09-04 02:18:32
903fbb0a9bae2c17942c8dfb30feea35ef5ef7b1...fd2b1341f6abca876dc1bc21d0966c7026f0fad1,1,0,14,14,1,2012-10-29 16:42:33,2012-10-29 16:42:33
fd2b1341f6abca876dc1bc21d0966c7026f0fad1...891acedc358eae6745a0272f680fadbbb05b877a,4,13,4,17,8,2012-10-29 17:17:35,2012-10-29 17:17:35
891acedc358eae6745a0272f680fadbbb05b877a...5cacd70702702fe217fdee89910279477e956997,4,33,23,56,14,2012-10-30 02:49:35,2012-10-30 02:49:35
39347b4c53e8b3610db5afe4672d368535937c15...d1239985231820dbe6a4fac58b293d97c679182d,3,18,0,18,4,2012-09-14 19:38:35,2012-09-14 19:38:35
d1239985231820dbe6a4fac58b293d97c679182d...342924c23fea69b962293469e804ee6e276e929b,6,6,6,12,6,2012-09-14 19:48:53,2012-09-14 19:48:53
39347b4c53e8b3610db5afe4672d368535937c15...c0f27752a3a3a0b1f09d1e2061a69617fe417ffb,7,26,24,50,16,2012-09-06 14:53:18,2012-09-06 14:53:18
39347b4c53e8b3610db5afe4672d368535937c15...53897c846c29e68c8cb03f76985d3cd8008d5733,1,2,2,4,2,2012-09-05 21:16:40,2012-09-05 21:16:40
39347b4c53e8b3610db5afe4672d368535937c15...fffbb81739d087fa58511cf1422d40f8cabb23e7,1,5,3,8,2,2012-09-05 21:10:29,2012-09-05 21:10:29
39347b4c53e8b3610db5afe4672d368535937c15...67e04613adea74b267330e1d3924be9e7517f03b,4,4,4,8,4,2012-09-05 14:33:09,2012-09-05 14:33:09
5cacd70702702fe217fdee89910279477e956997...223c456d265799097743a83f2193abb9ca9b0c7e,3,14,14,28,10,2012-10-31 01:00:57,2012-10-31 01:00:57
223c456d265799097743a83f2193abb9ca9b0c7e...bf67747e7580661c24ab83bce56fb3626437a4d7,3,3,3,6,3,2012-10-31 09:12:26,2012-10-31 09:12:26
5cacd70702702fe217fdee89910279477e956997...835c3e12d00c6b458ce2e625e5cf9fff1554d666,4,95,60,155,32,2012-10-30 21:42:05,2012-10-30 21:42:05
835c3e12d00c6b458ce2e625e5cf9fff1554d666...ecb333903a76fcc322e2ea0142689824429ea490,5,4835,4812,9647,372,2012-11-02 19:50:20,2012-11-02 19:50:20
342924c23fea69b962293469e804ee6e276e929b...5afb9a955347175b9a16c4607e42eb44663dc7db,3,13,20,33,15,2012-09-22 23:03:55,2012-09-22 23:03:55
5afb9a955347175b9a16c4607e42eb44663dc7db...8f5ede349e554954ccc45e0dd743229ed2aabbe6,4,25,13,38,7,2012-09-22 23:08:27,2012-09-22 23:08:27
8f5ede349e554954ccc45e0dd743229ed2aabbe6...77adc10d86b0abf06ba6c7bebcce623982e1e0ff,31,860,782,1642,106,2012-09-23 23:49:11,2012-09-23 23:49:11
77adc10d86b0abf06ba6c7bebcce623982e1e0ff...aeaf00cb61422b00cc8ce3912f8a37fb1a01aa11,11,63,65,128,43,2012-09-24 00:05:12,2012-09-24 00:05:12
aeaf00cb61422b00cc8ce3912f8a37fb1a01aa11...d2a2f1466ffe7003410cc318fa8c15a0d25ad7a7,4,18,32,50,9,2012-09-24 00:27:46,2012-09-24 00:27:46
d2a2f1466ffe7003410cc318fa8c15a0d25ad7a7...0f8659adc7717c5ce2633c9745d84e220bc94753,1,1,2,3,1,2012-09-24 00:28:20,2012-09-24 00:28:20
0f8659adc7717c5ce2633c9745d84e220bc94753...1b7969f1c81a15f9f210bad8e902a52bffec5a0f,3,5,5,10,3,2012-09-24 00:29:25,2012-09-24 00:29:25
1b7969f1c81a15f9f210bad8e902a52bffec5a0f...f2b07f913b1c13a640eea4068b4989f8c23f870e,3,3,3,6,3,2012-09-24 02:33:04,2012-09-24 02:33:04
f2b07f913b1c13a640eea4068b4989f8c23f870e...6bba6a1868f9af2bb7a9ef94880c60fc92c40c76,3,1,25,26,3,2012-09-24 02:34:32,2012-09-24 02:34:32
342924c23fea69b962293469e804ee6e276e929b...1c32d23fa4d113b37dd76642b1a8cae4c0b5aba8,13,194,89,283,35,2012-09-18 22:49:03,2012-09-18 22:49:03
1c32d23fa4d113b37dd76642b1a8cae4c0b5aba8...72d5f9d5c2482d8c731f3985bf8e6ff9c03aeea4,3,5,5,10,3,2012-09-18 23:03:04,2012-09-18 23:03:04
342924c23fea69b962293469e804ee6e276e929b...3d0c548bf30f10053c6c748ae0def10656451fc5,1,6,0,6,1,2012-09-17 21:29:05,2012-09-17 21:26:54
3d0c548bf30f10053c6c748ae0def10656451fc5...e01f789017e7de784811c7c97edc3ddfc9568111,1,6,0,6,1,2012-09-18 03:34:08,2012-09-18 03:34:08
7b37e7d406f1c3ffd08a25dfc3e56ff2bd0c4a6b...d287b63511390dc403071b9b8dc8a29fa1e95d21,4,148,53,201,24,2013-02-06 18:48:13,2013-02-06 18:48:13
62b9153a321cddf38c37c2e5d2c500205bccf47d...772009dd43e8c317d804ae94b9cd9683e8dc337a,3,4,4,8,5,2013-02-06 16:51:20,2013-02-06 16:51:20
8bfd4e91b53feece0069ca1675de8e4e9886eb2f...79c9737d708d0d499edec8572a529dd04288b750,4,5,5,10,5,2012-09-19 17:39:24,2012-09-19 17:39:24
79c9737d708d0d499edec8572a529dd04288b750...e4ed3e3413488e8fdf1d2858a10b3f9d4b7b6254,8,101,92,193,25,2012-09-19 18:09:26,2012-09-19 18:09:26
e4ed3e3413488e8fdf1d2858a10b3f9d4b7b6254...f5e17e571406eb5ef10f7e45f92c1855e940a3d0,8,24,24,48,19,2012-09-19 18:21:32,2012-09-19 18:21:32
f5e17e571406eb5ef10f7e45f92c1855e940a3d0...68ea2513d23dc5cc907aea024d5be3f21c949738,3,12,6,18,7,2012-09-19 19:11:50,2012-09-19 19:11:50
68ea2513d23dc5cc907aea024d5be3f21c949738...e7ac3f8be1207218a813beb837e1654fc4bc4f1c,6,72,72,144,21,2012-09-19 19:59:06,2012-09-19 19:59:06
e7ac3f8be1207218a813beb837e1654fc4bc4f1c...244ba397a30ee4f902d6312ff525baf942400018,3,5,7,12,5,2012-09-19 20:08:57,2012-09-19 20:08:57
244ba397a30ee4f902d6312ff525baf942400018...7f0044e139ffd53ac7f06c4d023132f573e30b4a,3,11,4,15,7,2012-09-19 20:45:44,2012-09-19 20:45:44
7f0044e139ffd53ac7f06c4d023132f573e30b4a...809fd62682f62145ece41037563e4580a795686c,1,1,1,2,1,2012-09-19 20:47:37,2012-09-19 20:47:37
809fd62682f62145ece41037563e4580a795686c...9f0741acf43cf5aff47536576044fb7ae62cf482,1,1,3,4,2,2012-09-19 20:48:06,2012-09-19 20:48:06
9f0741acf43cf5aff47536576044fb7ae62cf482...a95cacd46c77d06720489a2f6a9b7c3be050bb12,2,5,6,11,3,2012-09-19 20:48:27,2012-09-19 20:48:27
a95cacd46c77d06720489a2f6a9b7c3be050bb12...1f500bffd5e927c9ec83c2e371ddcc443ed5c89a,3,37,48,85,16,2012-09-19 22:23:43,2012-09-19 22:23:43
1f500bffd5e927c9ec83c2e371ddcc443ed5c89a...85a5d7737594db5ea806b70729c5e7baa44092c0,3,6,9,15,7,2012-09-19 23:34:15,2012-09-19 23:34:15
85a5d7737594db5ea806b70729c5e7baa44092c0...b7dab21e0921ec01d66182c3be25d48a94c9d0a0,3,14,18,32,3,2012-09-19 23:39:53,2012-09-19 23:39:53
b7dab21e0921ec01d66182c3be25d48a94c9d0a0...f6c8059dd509d89502bc2a01c0edbd673c25884c,6,117,6,123,10,2012-09-20 01:37:23,2012-09-20 01:37:23
f6c8059dd509d89502bc2a01c0edbd673c25884c...1bfd9a48d383d01497561aec53eda76d42f7d459,6,6,117,123,10,2012-09-20 01:54:36,2012-09-20 01:54:36
61c0bd0d92af84b02b1d5f3565683b93a13045fb...d5e3add1f39cee043ed456cacb30f83c5b07227a,5,28,4,32,5,2012-12-07 03:50:36,2012-12-07 03:50:36
d5e3add1f39cee043ed456cacb30f83c5b07227a...09094cf3427a08892eb035341f2b13b9ecda0102,4,20,3,23,4,2012-12-07 20:44:21,2012-12-07 20:44:21
ecb333903a76fcc322e2ea0142689824429ea490...fcb658b45aac761044126bfcd1d9e67a53e51ca1,3,23,9,32,9,2012-11-03 00:02:43,2012-11-02 23:47:18
ecb333903a76fcc322e2ea0142689824429ea490...f011f213543385aa977d2061af26b341fcc9de65,4,9,16,25,7,2012-11-02 21:15:35,2012-11-02 21:15:35
6bba6a1868f9af2bb7a9ef94880c60fc92c40c76...a7d5245f5248a5c23b6b30bdc66fc3925678f87f,3,97,97,194,17,2012-09-24 09:22:48,2012-09-24 09:22:48
a7d5245f5248a5c23b6b30bdc66fc3925678f87f...f4bbeda78181da2fd42f6303fd02de43be400340,2,8,8,16,8,2012-09-24 09:23:59,2012-09-24 09:23:59
f4bbeda78181da2fd42f6303fd02de43be400340...c1047df95466bfa11ccdde06a23c6f9992c6fe9a,3,35,14,49,7,2012-09-24 12:44:01,2012-09-24 12:41:35
c1047df95466bfa11ccdde06a23c6f9992c6fe9a...38755cb9be269ad313e0e45819fedc4d653e1075,3,3,5,8,3,2012-09-24 17:11:40,2012-09-24 17:11:40
38755cb9be269ad313e0e45819fedc4d653e1075...3d9d05f33de1fbff67c73316f00cd723edc5bad2,3,12,32,44,11,2012-09-25 10:49:13,2012-09-25 10:49:13
e01f789017e7de784811c7c97edc3ddfc9568111...e294affffcf5333db3375b7c397cef9915721f39,9,54,53,107,39,2012-09-28 22:17:54,2012-09-28 22:17:54
e294affffcf5333db3375b7c397cef9915721f39...78a0284f629032ed8edf24be75c8426b2a77005d,1,3,0,3,1,2012-09-28 22:41:55,2012-09-28 22:41:55
78a0284f629032ed8edf24be75c8426b2a77005d...428ea4ff924180768b138961f438c036f8ca99df,4,30,3,33,4,2012-09-28 22:47:13,2012-09-28 22:47:13
09094cf3427a08892eb035341f2b13b9ecda0102...86e159872f567c9c45b147942434f0cbdf118b7d,2,5,5,10,5,2012-12-08 14:48:54,2012-12-08 14:48:54
b262629adadc13285a17b3d0da85df65aaf3b4fc...8ee6c126bcdc3f9965457b411794e9ae7c5972ec,19,57,100,157,52,2012-11-11 17:44:40,2012-11-11 17:44:40
8ee6c126bcdc3f9965457b411794e9ae7c5972ec...1b9aa90c38e23e55b22662a41a5830fdc80b10d9,60,1558,1882,3440,75,2012-11-11 19:20:15,2012-11-11 19:20:15
1b9aa90c38e23e55b22662a41a5830fdc80b10d9...ea265a87e3c59361b217e6be187d6041a960128f,23,4,7634,7638,11,2012-11-11 19:22:44,2012-11-11 19:22:44
ea265a87e3c59361b217e6be187d6041a960128f...a3ea2d0f393549e704d19f3f6ee62c15495ebaa2,2,4,4,8,2,2012-11-11 19:23:35,2012-11-11 19:23:35
a3ea2d0f393549e704d19f3f6ee62c15495ebaa2...3c4af15ac601885d72623e0b3ad3728b44e1c18c,4,7,6,13,4,2012-11-13 13:08:06,2012-11-13 13:07:27
3c4af15ac601885d72623e0b3ad3728b44e1c18c...d98a20aaf094f218c26275e454fb3b43bb3a8bba,3,11,22,33,7,2012-11-13 13:21:28,2012-11-13 13:21:28
d98a20aaf094f218c26275e454fb3b43bb3a8bba...112ed8489ab225c528dc24f20430144959fb620e,1,3,3,6,2,2012-11-13 13:29:03,2012-11-13 13:28:46
112ed8489ab225c528dc24f20430144959fb620e...1932de8c4b09a29e141adb3275e32637db60f423,3,3,3,6,3,2012-11-13 22:50:52,2012-11-13 22:50:52
1932de8c4b09a29e141adb3275e32637db60f423...4f1a849b63016c770aa904b986ff72a3df1e8a73,3,11,15,26,8,2012-11-13 22:51:56,2012-11-13 22:51:56
4f1a849b63016c770aa904b986ff72a3df1e8a73...8ac44493ce66fa5008c13404bbb064fcc91e055e,4,26,3,29,4,2012-11-14 11:50:37,2012-11-14 11:49:47
8ac44493ce66fa5008c13404bbb064fcc91e055e...18de5cd5c1348c2180d2730ee9696fd93a7fa234,4,29,8,37,8,2012-11-14 12:44:29,2012-11-14 12:44:29
18de5cd5c1348c2180d2730ee9696fd93a7fa234...0bb3d2953994a963c1b6f5d8b0c1d6197e718537,4,15,5,20,6,2012-11-14 13:24:16,2012-11-14 13:07:19
0bb3d2953994a963c1b6f5d8b0c1d6197e718537...dbd0745a8b0bcb1e96d3ccc09d7dedbcf650a009,4,6,4,10,6,2012-11-14 14:07:33,2012-11-14 14:07:33
dbd0745a8b0bcb1e96d3ccc09d7dedbcf650a009...fbbbfbf239a5c17b569103dc118b3796ba74d5d7,1,37,26,63,4,2012-11-14 14:51:11,2012-11-14 14:51:11
fbbbfbf239a5c17b569103dc118b3796ba74d5d7...ba192eaeea9ebeaa2c97d50a6d188eeb0e92a697,1,3,3,6,3,2012-11-14 16:19:24,2012-11-14 16:19:24
ba192eaeea9ebeaa2c97d50a6d188eeb0e92a697...bedff71625cdc7e3c7ef572a12b663688649cb97,3,30,21,51,8,2012-11-14 23:42:38,2012-11-14 23:23:54
bedff71625cdc7e3c7ef572a12b663688649cb97...7164af752fadf871aec73d296a39013aab4cbd9f,3,6,5,11,3,2012-11-15 16:06:17,2012-11-15 16:06:17
7164af752fadf871aec73d296a39013aab4cbd9f...091f3894994cd6eaccf4fdfadc58381c5f7d392c,4,15,16,31,9,2012-11-15 22:36:46,2012-11-15 20:33:31
091f3894994cd6eaccf4fdfadc58381c5f7d392c...514cdcf9585de4db962c70e77fee71ef69eb6da5,3,21,6,27,5,2012-11-15 23:27:14,2012-11-15 23:27:14
514cdcf9585de4db962c70e77fee71ef69eb6da5...f9f4e265f4389a8ec49efaaa9dea9d72e4ee6d92,1,6,0,6,1,2012-11-16 09:08:46,2012-11-16 09:08:46
f9f4e265f4389a8ec49efaaa9dea9d72e4ee6d92...ad30a774f03123746372ae4c45ad7c1ee6cf8da2,1,3,1,4,2,2012-11-16 09:35:37,2012-11-16 09:34:46
f011f213543385aa977d2061af26b341fcc9de65...ea7f617e92abfdbe37fda58bbad3b1b66267f870,3,74,38,112,27,2012-11-10 21:45:00,2012-11-10 18:23:57
ea7f617e92abfdbe37fda58bbad3b1b66267f870...38c304b68d0948ed8cad562aa0a4b1c9abccb646,4,17,12,29,8,2012-11-10 21:57:56,2012-11-10 21:57:56
38c304b68d0948ed8cad562aa0a4b1c9abccb646...b71d0c9c16535378efa4bf0720a386fc1d53da36,3,3,3,6,3,2012-11-10 23:23:06,2012-11-10 23:23:06
b71d0c9c16535378efa4bf0720a386fc1d53da36...5c97ac1411a054ee887e4abd83f4011f8df894f9,3,7,7,14,7,2012-11-10 23:24:45,2012-11-10 23:24:27
af6f24a269e2e9ee81ae9c74fdb098133b7e5b93...d7c2cc756fb55a35b764a8d025c37d545b38fb44,4,291,340,631,32,2012-09-25 17:41:20,2012-09-25 17:41:20
41fece5a7d7f2280c4c160c7f52af91f87c0dc1e...44e46209bd1db1abceff8d7abf629b3c6514ced6,2,86,77,163,27,2012-10-08 04:00:06,2012-10-08 04:00:06
41fece5a7d7f2280c4c160c7f52af91f87c0dc1e...223d6aa7153736b7904e1c60e0057440caa92c8b,26,311,247,558,118,2012-10-05 20:36:11,2012-10-05 19:00:16
223d6aa7153736b7904e1c60e0057440caa92c8b...59d579088458beeab308399d5985e45633a20e18,2,2,2,4,2,2012-10-05 21:46:57,2012-10-05 21:46:57
59d579088458beeab308399d5985e45633a20e18...60a25641af09788783bbbc49a37287817b9184db,4,14,14,28,13,2012-10-05 21:50:34,2012-10-05 21:50:34
60a25641af09788783bbbc49a37287817b9184db...09297b0983c93b423f50859b921718fc13d372c3,4,36,20,56,13,2012-10-05 23:12:17,2012-10-05 23:12:17
428ea4ff924180768b138961f438c036f8ca99df...443f0e648eaa9066350935c1058ab771877a3cf7,3,23,35,58,12,2012-10-04 17:11:24,2012-10-04 17:11:24
560a0918f57e7496bccc531ed709f25ec95ecf22...2467834ec207da63ada8bcf34e5bb9848ccd957a,6,272,27,299,7,2012-12-09 19:29:29,2012-12-06 17:15:47
2467834ec207da63ada8bcf34e5bb9848ccd957a...879aa43b82d90b6e6ff43418d9765c2cab6729e7,3,7,13,20,3,2012-12-09 19:29:50,2012-12-07 18:41:53
879aa43b82d90b6e6ff43418d9765c2cab6729e7...7860b0d31ee7954460dc7cbd8178709925b992a7,5,208,4,212,5,2012-12-09 19:42:05,2012-12-08 14:48:16
7860b0d31ee7954460dc7cbd8178709925b992a7...e0c91c1e278d89595e27ee8a3f32bea3a4e99bca,4,30,6,36,5,2012-12-09 20:32:01,2012-12-09 20:32:01
e0c91c1e278d89595e27ee8a3f32bea3a4e99bca...a9e47f3b8adb1421c0515bf68127108da9c23f19,4,7,4,11,4,2012-12-09 20:46:14,2012-12-09 20:46:14
ad30a774f03123746372ae4c45ad7c1ee6cf8da2...9d29a8514d126aec338153282df8b042d8f3299c,3,90,95,185,11,2012-11-18 15:40:10,2012-11-18 15:40:10
9d29a8514d126aec338153282df8b042d8f3299c...ae10693629bbd23f11456478162b18f65e6e113b,3,94,106,200,24,2012-11-18 16:29:37,2012-11-18 16:29:37
ae10693629bbd23f11456478162b18f65e6e113b...3297cf23e0e74dce83be52ff20b4b563e59aa72c,4,8,108,116,7,2012-11-18 16:40:57,2012-11-18 16:40:57
3297cf23e0e74dce83be52ff20b4b563e59aa72c...c9328da0b352cbd5f3f2d51490e387d6cd5a2fb6,2,8,8,16,4,2012-11-18 16:46:43,2012-11-18 16:46:43
c9328da0b352cbd5f3f2d51490e387d6cd5a2fb6...f2c948838b1561fd1f0942ea7beed238104d7ede,3,5,11,16,3,2012-11-18 17:01:00,2012-11-18 17:01:00
f2c948838b1561fd1f0942ea7beed238104d7ede...4605708ee6561ea0bc024f36844660b942e54294,1,6,22,28,5,2012-11-18 17:06:38,2012-11-18 17:06:38
4605708ee6561ea0bc024f36844660b942e54294...b3c69e1e495c1f10ed31bf94da77c5dc9f47babb,6,37,47,84,16,2012-11-18 17:12:10,2012-11-18 17:12:10
b3c69e1e495c1f10ed31bf94da77c5dc9f47babb...d52a3e7cb5d4af9581171954eb947251c14ad67b,3,42,177,219,7,2012-11-18 18:12:41,2012-11-18 18:12:41
d52a3e7cb5d4af9581171954eb947251c14ad67b...915702a11b2fe4580fdac333b04668606fb6342f,3,18,20,38,13,2012-11-18 18:15:13,2012-11-18 18:15:13
915702a11b2fe4580fdac333b04668606fb6342f...2fc940787fc9cad68f4d75218500fa3d1dac8684,1,1,34,35,1,2012-11-18 18:16:01,2012-11-18 18:16:01
ad30a774f03123746372ae4c45ad7c1ee6cf8da2...0eca7e3fae80f4bbcce58b95dc259f774e930168,3,30,25,55,18,2012-11-18 12:01:14,2012-11-17 17:56:07
d7c2cc756fb55a35b764a8d025c37d545b38fb44...1fe9eb5909e02ddbd6875c33df807dad295725bb,7,133,33,166,16,2012-09-25 21:14:32,2012-09-25 21:14:32
1fe9eb5909e02ddbd6875c33df807dad295725bb...262286bc6053447090e75712165d1fdf451ddda9,3,41,56,97,19,2012-09-25 21:45:41,2012-09-25 21:45:41
262286bc6053447090e75712165d1fdf451ddda9...5cf9d299ab0a8dfa5b01b08b077d8a954057d5a0,3,14,19,33,9,2012-09-25 21:52:25,2012-09-25 21:52:25
d7c2cc756fb55a35b764a8d025c37d545b38fb44...714f47cd2f8da08b85d2db11016428f3eea5f2b7,3,22,10,32,9,2012-09-25 18:31:35,2012-09-25 18:31:35
ca1451655e23392e4a484ea4698d47126ef5927d...315e3ab7b894f57fc691d564c930d1ad78c494ae,2,3187,1,3188,2,2012-12-21 06:47:10,2012-12-21 06:47:10
315e3ab7b894f57fc691d564c930d1ad78c494ae...74582d87d81dd7fc78070437c183080c1390de9e,5,5,5,10,5,2012-12-21 17:18:07,2012-12-21 17:18:07
a9e47f3b8adb1421c0515bf68127108da9c23f19...7dfdcda0b246b39a6aa8919205798911f6a51079,4,62,5,67,8,2012-12-10 12:01:36,2012-12-10 11:26:37
a9e47f3b8adb1421c0515bf68127108da9c23f19...61ffb8e0c8b4ec2fe4d8bdad5bb8f9a7cdc84808,2,2,4,6,2,2012-12-09 21:44:05,2012-12-09 21:44:05
cf6b2fad9010187fefcdad7028be6c2359ff3548...bc96647636af302c41ce311f3b46b9b2d0cd0dab,3,13,54,67,7,2012-11-18 20:05:33,2012-11-18 20:05:33
bc96647636af302c41ce311f3b46b9b2d0cd0dab...28fb58b6351956bf8490b5d60772dbff679db20a,5,208,97,305,32,2012-11-19 13:05:43,2012-11-18 15:53:29
28fb58b6351956bf8490b5d60772dbff679db20a...cba8a77badfc69faa91f863210ff028dde5ad21d,5,177,133,310,34,2012-11-20 22:20:54,2012-11-20 18:15:11
cba8a77badfc69faa91f863210ff028dde5ad21d...5d2416debc3db3e2a2101c548c909f5fc1670f1d,4,9,7,16,7,2012-11-21 00:36:25,2012-11-21 00:36:25
5d2416debc3db3e2a2101c548c909f5fc1670f1d...cb4cd46a6589d849928434962ff80ba6963e84a6,3,10,3,13,9,2012-11-21 00:54:32,2012-11-21 00:54:32
cb4cd46a6589d849928434962ff80ba6963e84a6...ba8c8ce170366c8c6b5e93f7654205c479d60988,5,171,118,289,21,2012-11-21 15:35:44,2012-11-21 15:22:57
ba8c8ce170366c8c6b5e93f7654205c479d60988...0a39765f3cbcb940e6fb354cec010a7ffeba9289,3,30,22,52,6,2012-11-21 15:56:46,2012-11-21 15:56:46
0a39765f3cbcb940e6fb354cec010a7ffeba9289...f5b16dab8790a1d258a64717dfd6d1d6c29213ed,3,7,4,11,5,2012-11-21 17:35:15,2012-11-21 17:35:15
f5b16dab8790a1d258a64717dfd6d1d6c29213ed...f23852a84127ba9600f70369a6b0d04eefcd6cde,3,6,6,12,3,2012-11-26 23:47:06,2012-11-26 23:47:06
f23852a84127ba9600f70369a6b0d04eefcd6cde...2eeb2057b2a058a15f9b4d155a4650dcab4ef070,3,24,21,45,7,2012-11-30 18:25:12,2012-11-30 18:25:12
2eeb2057b2a058a15f9b4d155a4650dcab4ef070...f58b5db7152244020e586ccc007e0df1c2e15528,4,43,7,50,6,2012-12-04 20:56:14,2012-12-04 20:56:14
f58b5db7152244020e586ccc007e0df1c2e15528...7069125fbc72b0c867d2b98b5de6865bdc161a27,2,4,4,8,2,2012-12-04 21:00:41,2012-12-04 21:00:41
7069125fbc72b0c867d2b98b5de6865bdc161a27...210085d3eac0c32934892bf2c7fa8d1ec081a415,4,29,12,41,12,2012-12-05 17:13:13,2012-11-21 09:55:00
210085d3eac0c32934892bf2c7fa8d1ec081a415...64829e52026210c83e1f6ee053038605297246b8,3,4,4,8,3,2012-12-05 17:13:31,2012-11-21 12:02:10
64829e52026210c83e1f6ee053038605297246b8...acbce53ec520df74a116bff67347768f4a220875,4,20,3,23,4,2012-12-05 17:13:51,2012-11-22 19:34:57
acbce53ec520df74a116bff67347768f4a220875...e6ab7219b814a7eb88a7e2f47db4db8dec14a5b4,6,380,235,615,87,2012-12-05 17:14:07,2012-11-22 20:14:23
e6ab7219b814a7eb88a7e2f47db4db8dec14a5b4...4d268a796644a2036336738889b7e095cbae3e98,1,36,0,36,1,2012-12-05 17:14:07,2012-11-29 09:25:37
4d268a796644a2036336738889b7e095cbae3e98...7712dcd59ed6ed0ef153c1f8e6ce5065e5d784b7,5,8,18,26,8,2012-12-05 17:48:24,2012-12-05 17:48:24
7712dcd59ed6ed0ef153c1f8e6ce5065e5d784b7...36702f197fe130de912512cb8cbf972f3595a866,5,18,8,26,8,2012-12-05 18:16:35,2012-12-05 18:16:35
36702f197fe130de912512cb8cbf972f3595a866...050b1c319e0985235e83a5f0303f422682475a54,5,72,50,122,12,2012-12-05 18:39:57,2012-12-05 18:39:57
050b1c319e0985235e83a5f0303f422682475a54...d33907be3735f47e8d5794849409ab65e8591d11,6,107,83,190,28,2012-12-05 18:55:24,2012-12-05 18:55:24
d33907be3735f47e8d5794849409ab65e8591d11...25098ab0ff180c9abe610e1987bd11a6d18527ca,5,70,21,91,17,2012-12-05 20:04:18,2012-12-05 20:04:18
25098ab0ff180c9abe610e1987bd11a6d18527ca...24df55bd00d5af34e87afab0551cb21f56c30acb,1,3,3,6,2,2012-12-05 20:12:45,2012-12-05 20:12:45
5cf9d299ab0a8dfa5b01b08b077d8a954057d5a0...4921757dbcffa333468b6e5cd7ccd965d416cd9f,3,9,8,17,5,2012-09-25 21:57:13,2012-09-25 21:57:13
4921757dbcffa333468b6e5cd7ccd965d416cd9f...e409935c660c84355b55d2df1167d4e99fadec94,3,12,12,24,7,2012-09-25 22:17:17,2012-09-25 22:17:17
74582d87d81dd7fc78070437c183080c1390de9e...33bf32723fe73c06d0140f82cea2d358c97a1825,1,23,0,23,1,2012-12-28 16:37:24,2012-12-28 16:37:24
33bf32723fe73c06d0140f82cea2d358c97a1825...1aa504645b65549d26ef12be64b1ec209513a944,3,9,9,18,5,2012-12-28 16:51:49,2012-12-28 16:51:49
74582d87d81dd7fc78070437c183080c1390de9e...e7ea256dc15b5488c5503d28fcdff0d880e0fbf1,4,43,16,59,11,2012-12-27 12:57:52,2012-12-27 12:57:52
e7ea256dc15b5488c5503d28fcdff0d880e0fbf1...131c883c6fe08fa883c26e1a9f7d3646de7fbe0c,3,9,11,20,3,2012-12-27 13:09:50,2012-12-27 13:09:50
74582d87d81dd7fc78070437c183080c1390de9e...963a5e862e6abf34d3518f057c5dc5440032499c,4,18,3,21,4,2012-12-25 02:51:36,2012-12-25 02:18:27
aa2e17e94c58445a1d2947d6bc7fc47d81396aa0...0b1b9fbbda797791c5bbfb0d74bef37d1f99d60e,7,3,133,136,7,2012-10-05 23:44:48,2012-10-05 23:44:48
0b1b9fbbda797791c5bbfb0d74bef37d1f99d60e...e7dcae75c9eaa008c9487273de2642cbe2c68b41,4,4,127,131,5,2012-10-05 23:46:05,2012-10-05 23:46:05
e7dcae75c9eaa008c9487273de2642cbe2c68b41...ea790608ac5dd165e4ddacc144de314f0ca92915,12,333,355,688,27,2012-10-05 23:56:49,2012-10-05 23:56:49
ea790608ac5dd165e4ddacc144de314f0ca92915...a2589d79fde2e5a49b6c4a557ec5c705488b2bc3,4,1,4,5,4,2012-10-05 23:57:39,2012-10-05 23:57:39
a2589d79fde2e5a49b6c4a557ec5c705488b2bc3...319d9954b9372ab6733093df40951f2417480ded,5,4,75,79,6,2012-10-05 23:58:19,2012-10-05 23:58:19
319d9954b9372ab6733093df40951f2417480ded...ac06afcdb04bbd98c03b1dc8d422e2311cf22536,3,4,5,9,3,2012-10-05 23:58:59,2012-10-05 23:58:59
ac06afcdb04bbd98c03b1dc8d422e2311cf22536...4eac85b5963910f3f1f14dd5a14f038fa13d91f7,5,2,8,10,5,2012-10-05 23:59:50,2012-10-05 23:59:50
4eac85b5963910f3f1f14dd5a14f038fa13d91f7...c3635192d87c3c8ad573224283185c1b01c6b69b,10,37,48,85,29,2012-10-06 00:05:59,2012-10-06 00:05:59
32213255d6bbc767a47c7c5f53d879e31ca10cea...1c8bff5d1d228b4d9254ef885dd1193fb731b1b6,5,71,103,174,20,2012-12-10 20:05:43,2012-12-10 20:04:58
1c8bff5d1d228b4d9254ef885dd1193fb731b1b6...881e0e5fcffd0d86d451c09fc88445b8ff493233,6,126,116,242,25,2012-12-10 22:49:20,2012-12-10 22:49:20
881e0e5fcffd0d86d451c09fc88445b8ff493233...c0f4a5faf99b738e550c877925c6c3aff5126142,4,10,8,18,7,2012-12-10 22:55:20,2012-12-10 22:55:20
c0f4a5faf99b738e550c877925c6c3aff5126142...34180a74851f6bd8f5131a44f44895e2f7448e21,7,94,92,186,44,2012-12-10 23:09:14,2012-12-10 21:23:27
34180a74851f6bd8f5131a44f44895e2f7448e21...d0ef84f6ec734f13e46043dd3554c816aabd2af1,3,17,17,34,3,2012-12-10 23:41:13,2012-12-10 23:41:13
d0ef84f6ec734f13e46043dd3554c816aabd2af1...75520ecb4608b5d5a88a9c6d41a1276e289aa3f0,7,708,674,1382,54,2012-12-11 12:53:01,2012-12-11 00:23:27
75520ecb4608b5d5a88a9c6d41a1276e289aa3f0...13c2d0cb21dae58fda5c2d93abd23c68ff5453be,5,88,63,151,32,2012-12-11 18:21:44,2012-12-11 18:21:44
13c2d0cb21dae58fda5c2d93abd23c68ff5453be...c5a27ec64376d66fa0d5ffcb3bb88202f54039b5,4,62,30,92,26,2012-12-11 19:03:41,2012-12-11 19:03:41
c5a27ec64376d66fa0d5ffcb3bb88202f54039b5...f2e479728ea452ac2f85ef733d9eaf5d29417cd6,2,2,2,4,2,2012-12-11 19:16:45,2012-12-11 19:16:45
f2e479728ea452ac2f85ef733d9eaf5d29417cd6...30beedd88661731f6cc2e4ba01cdeaedd7bfdc09,1,16,4,20,8,2012-12-11 19:26:09,2012-12-11 19:26:09
30beedd88661731f6cc2e4ba01cdeaedd7bfdc09...34fa7ea3854cec724d4f3550cac2f5db7dc3cdc9,8,95,138,233,39,2012-12-11 19:55:01,2012-12-11 19:55:01
34fa7ea3854cec724d4f3550cac2f5db7dc3cdc9...bc06b2ec57da640988d8cbcd305e9e503dea8431,11,738,653,1391,141,2012-12-11 21:43:14,2012-12-11 20:40:58
bc06b2ec57da640988d8cbcd305e9e503dea8431...73dd9b4c16d6e94c332df6991fb7937f7833f50c,4,77,80,157,26,2012-12-11 22:03:04,2012-12-11 21:58:45
73dd9b4c16d6e94c332df6991fb7937f7833f50c...eb7a56e9430d226c312e93162e53079ba22e302f,6,45,83,128,35,2012-12-12 00:11:08,2012-12-12 00:11:08
eb7a56e9430d226c312e93162e53079ba22e302f...7d8ef4f0478000f790224c2edf6418370388544e,3,29,35,64,24,2012-12-12 05:04:34,2012-12-12 05:04:34
7d8ef4f0478000f790224c2edf6418370388544e...7cf456515540b9daac06ba8670d0aba4667eaa8c,5,23,17,40,19,2012-12-12 05:22:50,2012-12-12 05:22:50
7cf456515540b9daac06ba8670d0aba4667eaa8c...bf88a484098ac0ef4ac63d9205f40713d0bd7bde,1,13,4,17,9,2012-12-12 05:31:12,2012-12-12 05:31:12
bf88a484098ac0ef4ac63d9205f40713d0bd7bde...3f1d801ebccf683ec9042e9e8f85cd32c4393723,3,90,90,180,15,2012-12-12 05:50:57,2012-12-12 05:50:57
3f1d801ebccf683ec9042e9e8f85cd32c4393723...4652d549d0a413e693dff9abc4bb11c0947d685f,4,10,4,14,7,2012-12-12 05:55:40,2012-12-12 05:55:40
4652d549d0a413e693dff9abc4bb11c0947d685f...31d59cfc93120e5f14fc4582a141d493e5a2b49d,4,13,6,19,6,2012-12-12 08:51:31,2012-12-12 08:43:32
31d59cfc93120e5f14fc4582a141d493e5a2b49d...6091249215e8687544482460ff83dcc76563a6b4,3,23,31,54,9,2012-12-12 09:19:58,2012-12-12 09:19:58
6091249215e8687544482460ff83dcc76563a6b4...c0f9ae7ad19e62882c76044d8343991bc2a7b440,5,191,179,370,13,2012-12-12 09:25:22,2012-12-12 09:25:22
c0f9ae7ad19e62882c76044d8343991bc2a7b440...d1aac46a5a5b5c6c7179342de7d6820efd6da8b7,2,18,17,35,15,2012-12-12 09:37:33,2012-12-12 09:37:33
d1aac46a5a5b5c6c7179342de7d6820efd6da8b7...7b5ce5abd9037b8d81f66a7ceea301b3c6c7da90,4,36,57,93,21,2012-12-12 10:20:49,2012-12-12 10:20:49
7b5ce5abd9037b8d81f66a7ceea301b3c6c7da90...913173ea7f140180452bf83dec81d1a6fb6c37c2,5,28,22,50,12,2012-12-12 11:57:25,2012-12-12 11:25:29
913173ea7f140180452bf83dec81d1a6fb6c37c2...b1d078db1a23d2275437f10e7bccb6fccc9bda72,4,4,3,7,4,2012-12-12 12:01:36,2012-12-12 12:00:29
b1d078db1a23d2275437f10e7bccb6fccc9bda72...573181bccd389c352792159aeb3db68a09935ec0,3,5,5,10,4,2012-12-12 12:08:50,2012-12-12 12:08:50
573181bccd389c352792159aeb3db68a09935ec0...876a6542d84a696b3e7b3b5e8cb9acd36a3d7074,4,7,7,14,6,2012-12-12 13:51:10,2012-12-12 13:51:10
876a6542d84a696b3e7b3b5e8cb9acd36a3d7074...6994640f323ffd2d98158efcf8ae4ddb23bd0eca,5,159,4,163,5,2012-12-12 17:09:21,2012-12-12 17:09:21
6994640f323ffd2d98158efcf8ae4ddb23bd0eca...0dce02229159bec58a651f3185b87d2bcc76659b,2,80,0,80,2,2012-12-12 18:16:27,2012-12-12 18:16:27
0dce02229159bec58a651f3185b87d2bcc76659b...e06a279d625d1fee15c0fb8fa0f2eb8467613886,4,76,23,99,6,2012-12-12 18:17:52,2012-12-12 18:17:52
e06a279d625d1fee15c0fb8fa0f2eb8467613886...6866cd08d50369118024f33a7858f92c7e036420,6,55,44,99,15,2012-12-12 18:35:14,2012-12-12 18:35:14
6866cd08d50369118024f33a7858f92c7e036420...4c264fb79805e3688c593dcdc0c608445b18c54f,3,15,10,25,10,2012-12-12 18:38:20,2012-12-12 18:38:20
4c264fb79805e3688c593dcdc0c608445b18c54f...c0b5b08af9d26dbfee56ed5d3a846c80b1b9c1a4,1,1,1,2,1,2012-12-12 18:40:03,2012-12-12 18:40:03
c0b5b08af9d26dbfee56ed5d3a846c80b1b9c1a4...8f5fe826c7b3b8e9ac09f001f3ae566f30c7a7cf,5,84,68,152,15,2012-12-12 19:32:08,2012-12-12 19:32:08
24df55bd00d5af34e87afab0551cb21f56c30acb...75e4ab519f5c76a068fcdf146a7ed506803db1d3,3,6,6,12,5,2012-12-06 16:45:36,2012-12-06 16:45:36
24df55bd00d5af34e87afab0551cb21f56c30acb...bf180cb8a00d3e3cc1ca5da40bf2644cad226d04,4,61,45,106,15,2012-12-05 20:35:50,2012-12-05 20:35:50
bf180cb8a00d3e3cc1ca5da40bf2644cad226d04...531b443c09364b9d6abc420492f8188824b4bcd6,4,44,72,116,14,2012-12-05 21:30:13,2012-12-05 20:58:43
531b443c09364b9d6abc420492f8188824b4bcd6...5cc41e6495bec0311693b75f60f26c320e299257,3,35,15,50,10,2012-12-06 00:39:57,2012-12-06 00:39:57
5cc41e6495bec0311693b75f60f26c320e299257...f4f2aca415bcae1baa9a37c9d5c0f8ca18463ce7,3,40,29,69,9,2012-12-06 00:56:24,2012-12-06 00:56:24
f4f2aca415bcae1baa9a37c9d5c0f8ca18463ce7...fb34ed371085fad9b85e3b4b35d8721365b88926,3,110,130,240,27,2012-12-06 09:17:53,2012-12-06 09:17:53
fb34ed371085fad9b85e3b4b35d8721365b88926...e7e76f7cb63a038d647e92c928a2745c8d9bb18c,3,73,105,178,14,2012-12-06 09:44:18,2012-12-06 09:44:18
e7e76f7cb63a038d647e92c928a2745c8d9bb18c...1cc0fe8292ba5b42314877f9b426fdda0bad6a75,1,1,1,2,2,2012-12-06 09:58:38,2012-12-06 09:58:38
1cc0fe8292ba5b42314877f9b426fdda0bad6a75...915f044b8fda78e04a845a71585c2d0529fa46d3,4,22,11,33,8,2012-12-06 10:40:06,2012-12-06 10:40:06
1b7c291179b88376152aa5b263d6fdd56e429f12...448c3d085f70efdb10f4fa717d38a8f085b1ae37,3,21,21,42,7,2012-09-25 22:36:07,2012-09-25 22:36:07
448c3d085f70efdb10f4fa717d38a8f085b1ae37...b12a5352d84ac8b3cb5624c9636fba7148f87b3b,3,6,6,12,3,2012-09-25 22:46:29,2012-09-25 22:46:29
b12a5352d84ac8b3cb5624c9636fba7148f87b3b...a59b718cfc15c192f391b6256123c05886e16649,3,56,6,62,3,2012-09-25 23:28:27,2012-09-25 23:24:07
a59b718cfc15c192f391b6256123c05886e16649...62fbc0c210e18a851beb76647f0f16f9b887af67,3,17,7,24,6,2012-09-25 23:35:02,2012-09-25 23:35:02
62fbc0c210e18a851beb76647f0f16f9b887af67...e4ead4e0082c99d60555c5fb07ee0ccebb21765a,3,5,9,14,9,2012-09-26 00:15:11,2012-09-26 00:15:11
d2ad9f7942d236cf1f14fd4cde1764e3252fcceb...2e072713e3cedcbe265198bdb7d8df90ea96abfe,5,32,13,45,13,2013-01-01 23:50:17,2013-01-01 23:50:17
d2ad9f7942d236cf1f14fd4cde1764e3252fcceb...f6891ef90191845b59b138810ad9e88746621bd3,4,8,3,11,4,2012-12-29 13:09:12,2012-12-29 13:05:27
3fe30782daaea7e38863ab81b3d0b2a45562ff7b...3cf08d3df199a4f3f46aa4107dd98c7619cb7144,4,212,42,254,25,2012-10-06 09:11:47,2012-10-06 09:11:47
3cf08d3df199a4f3f46aa4107dd98c7619cb7144...b97715b2d1fa41e83c39c49f19e5615d0e2251a2,3,28,42,70,5,2012-10-06 09:17:46,2012-10-06 09:17:46
3fe30782daaea7e38863ab81b3d0b2a45562ff7b...d3f855ae019f42bc6a85949e09fb92ee70c0a128,138,138,138,276,137,2012-10-06 01:46:05,2012-10-06 01:46:05
d3f855ae019f42bc6a85949e09fb92ee70c0a128...5fd98b63f38842c51cdad09aa92c7e1a8d3d0694,2,4,4,8,4,2012-10-06 04:33:03,2012-10-06 04:33:03
8f5fe826c7b3b8e9ac09f001f3ae566f30c7a7cf...2e88ce7f034da7bd4942a39be71abfde02d608da,3,328,72,400,6,2012-12-12 21:56:41,2012-12-12 21:56:41
8f5fe826c7b3b8e9ac09f001f3ae566f30c7a7cf...33e24962be72df40aa2c010d675c177ac5e40898,12,543,573,1116,100,2012-12-12 21:33:59,2012-12-12 21:33:59
e4ead4e0082c99d60555c5fb07ee0ccebb21765a...69b36c117f60af997b183fb844fd338bf1b558f0,3,41,18,59,18,2012-09-26 08:14:48,2012-09-26 08:14:09
69b36c117f60af997b183fb844fd338bf1b558f0...57ee53a232f2101e92950f85732bf8a4d9e48b59,3,13,10,23,7,2012-09-26 08:23:58,2012-09-26 08:23:58
57ee53a232f2101e92950f85732bf8a4d9e48b59...e431bc59626986e3473f9b1c34c55f5764dba235,3,35,36,71,24,2012-09-26 08:29:01,2012-09-26 08:29:01
e431bc59626986e3473f9b1c34c55f5764dba235...cc123a96beb2fe7d8d055972ad568669c5803dee,3,13,13,26,12,2012-09-26 08:51:47,2012-09-26 08:51:47
cc123a96beb2fe7d8d055972ad568669c5803dee...48dacb359990249ca9d2234ae7d1a946cf29e216,3,6,6,12,3,2012-09-26 08:59:49,2012-09-26 08:59:49
48dacb359990249ca9d2234ae7d1a946cf29e216...b8a47f1c8c982278a4236f44b3088a1b6075c63f,3,6,6,12,3,2012-09-26 09:01:32,2012-09-26 09:01:32
b8a47f1c8c982278a4236f44b3088a1b6075c63f...6b16dfa4cd5929ebc532873b80325b41baa75908,4,125,59,184,29,2012-09-26 11:07:00,2012-09-26 11:07:00
6b16dfa4cd5929ebc532873b80325b41baa75908...302576bbcd944a9069127d85c029d8c9caf1174e,3,23,12,35,5,2012-09-26 11:18:04,2012-09-26 11:18:04
302576bbcd944a9069127d85c029d8c9caf1174e...45d4b31461c3c0f0d9ba14fa8b27181852e606a4,3,38,25,63,11,2012-09-26 12:35:51,2012-09-26 12:35:11
45d4b31461c3c0f0d9ba14fa8b27181852e606a4...c7284d7dc3b8f04d19ef1fbcd6dccf4b1b9231bb,3,6,6,12,3,2012-09-26 13:14:13,2012-09-26 13:14:13
c7284d7dc3b8f04d19ef1fbcd6dccf4b1b9231bb...9399591f9a78f558b62c7fd4cfde3532419f2604,3,19,34,53,5,2012-09-26 13:16:03,2012-09-26 13:16:03
9399591f9a78f558b62c7fd4cfde3532419f2604...e8b3ac10bc902ae56a35c13eb9d966ee71f6a3e4,3,10,10,20,7,2012-09-26 13:30:40,2012-09-26 13:30:40
e8b3ac10bc902ae56a35c13eb9d966ee71f6a3e4...9c7e3a8d9a1c5290ff3382b49dd1cc1e0127645e,3,3,3,6,3,2012-09-26 13:47:21,2012-09-26 13:47:21
9c7e3a8d9a1c5290ff3382b49dd1cc1e0127645e...7af288439403bf2b721a4771f401fb2d7dff2803,3,8,8,16,5,2012-09-26 13:57:55,2012-09-26 13:57:55
662226bd842e9acc4cc1e0c30b4c8acfb972b718...63979e25d7e1082d73de3ae4e54387d98951b07d,1,1,1,2,1,2013-01-04 22:29:42,2013-01-04 22:29:21
d580a64eba0154ff7b160f1e9160497ea7880c9f...b957752b1df300f39db2aec10c7413e1e1185eb9,1,1,1,2,1,2012-10-06 14:11:07,2012-10-06 14:11:07
b957752b1df300f39db2aec10c7413e1e1185eb9...a77079280ad3fc8503fcff808b0c238440c0433e,4,106,40,146,13,2012-10-06 20:19:05,2012-10-06 20:19:05
a77079280ad3fc8503fcff808b0c238440c0433e...d9a1281e08c43e0073f4dabf791112b3f33e59aa,4,128,31,159,19,2012-10-06 23:40:37,2012-10-06 23:40:37
d9a1281e08c43e0073f4dabf791112b3f33e59aa...1e4b261b39d64501ca3d3741326cd1c6e9f32d6a,15,221,170,391,59,2012-10-11 19:39:24,2012-10-11 19:32:44
1e4b261b39d64501ca3d3741326cd1c6e9f32d6a...136a380a887c11a0805e5c299378e75633f5f891,8,65,109,174,40,2012-10-11 21:39:59,2012-10-11 21:39:59
136a380a887c11a0805e5c299378e75633f5f891...f8032a4268a25193d55cde4b4f15cb37b1db4f79,2,31,35,66,2,2012-10-11 21:52:35,2012-10-11 21:50:52
f8032a4268a25193d55cde4b4f15cb37b1db4f79...84a625523661052694d6101bcf51fdfaad088b39,163,2781,3766,6547,441,2012-10-11 23:34:17,2012-10-11 23:34:17
84a625523661052694d6101bcf51fdfaad088b39...06dae9c6d2d32e059eb64438c4545790a65d3c7b,3,35,8,43,7,2012-10-12 00:10:26,2012-10-12 00:10:26
06dae9c6d2d32e059eb64438c4545790a65d3c7b...f1c87d7e3a02074287326faa46e748543e25a219,3,23,4,27,13,2012-10-15 15:13:40,2012-10-15 15:13:40
f1c87d7e3a02074287326faa46e748543e25a219...200bdea796e8517db40025484bc513a0c9783382,3,3,3,6,3,2012-10-16 20:15:26,2012-10-16 20:14:28
200bdea796e8517db40025484bc513a0c9783382...0794607c39c94d2f4a3e7cfe0e786a8275f46633,4,8,12,20,11,2012-10-16 21:02:08,2012-10-16 21:02:08
0794607c39c94d2f4a3e7cfe0e786a8275f46633...3af91c35e4d639999dfeda01bb92f0a446376d3e,10,141,108,249,29,2012-10-16 23:47:20,2012-10-16 23:40:46
3af91c35e4d639999dfeda01bb92f0a446376d3e...b1844d74534b7242d49a2c16f0fa53413d2d2743,6,89,88,177,22,2012-10-16 23:58:37,2012-10-16 23:58:37
b1844d74534b7242d49a2c16f0fa53413d2d2743...9abaad9763dd9306bec3f5b1aa3beb2677fe23d9,6,80,96,176,19,2012-10-17 00:17:35,2012-10-17 00:17:35
9abaad9763dd9306bec3f5b1aa3beb2677fe23d9...23562065875b66fe21abb1f4e10c68028e8d010b,3,12,10,22,9,2012-10-17 04:51:11,2012-10-17 04:51:11
23562065875b66fe21abb1f4e10c68028e8d010b...2358fd0fb43d74cb72ddc4dd2218ab9153d0af02,3,50,58,108,23,2012-10-19 06:09:51,2012-10-19 05:19:32
32e13768bde686d17c4273d804a6a18935e7f140...3cbb9ceae9a36a96b98a832a6defc8f1da285610,3,12,15,27,7,2012-12-12 22:19:52,2012-12-12 22:19:52
3cbb9ceae9a36a96b98a832a6defc8f1da285610...88890a600f4db7a969d5683faa7915e672cfb95f,3,94,124,218,11,2012-12-12 22:57:24,2012-12-12 22:57:24
88890a600f4db7a969d5683faa7915e672cfb95f...6c68339cb2a6caca36ed42ab17eb950424d48bac,3,30,34,64,12,2012-12-12 22:59:51,2012-12-12 22:59:51
6c68339cb2a6caca36ed42ab17eb950424d48bac...278e08639b7a78b704d473a78b8e48561ecb13be,3,3,3,6,3,2012-12-12 23:07:09,2012-12-12 23:07:09
278e08639b7a78b704d473a78b8e48561ecb13be...3874af10559b0be875d4b71089f7050905768135,3,1,23,24,3,2012-12-12 23:16:49,2012-12-12 23:16:49
3874af10559b0be875d4b71089f7050905768135...a43ad720a127e0aec4fc1dddafabf3a4675226c7,3,4,7,11,7,2012-12-12 23:23:55,2012-12-12 23:23:55
a43ad720a127e0aec4fc1dddafabf3a4675226c7...e7fa28bb802f50aabc6637123ec0452f3452a6d9,3,3,3,6,3,2012-12-12 23:30:30,2012-12-12 23:30:30
e7fa28bb802f50aabc6637123ec0452f3452a6d9...ffd047b52753bc978539e8f59c7fbc9d7dc21e83,4,86,65,151,11,2012-12-12 23:48:37,2012-12-12 23:48:37
ffd047b52753bc978539e8f59c7fbc9d7dc21e83...8f02a72c952dced35dc96e880bb7e73c593a221b,3,4,1,5,3,2012-12-12 23:52:54,2012-12-12 23:52:54
8f02a72c952dced35dc96e880bb7e73c593a221b...1a779c6f4db80f9816e3b78c46d97c041741f152,6,158,222,380,13,2012-12-13 00:17:02,2012-12-13 00:17:02
1a779c6f4db80f9816e3b78c46d97c041741f152...342c1b8a46ac434a9cefbef0d6ec4f344b0b48cd,3,11,4,15,3,2012-12-13 00:18:39,2012-12-13 00:18:39
342c1b8a46ac434a9cefbef0d6ec4f344b0b48cd...6ca6d3ea076ede88c4440615e5862aff97024059,6,91,85,176,12,2012-12-13 00:42:07,2012-12-13 00:42:07
6ca6d3ea076ede88c4440615e5862aff97024059...08b4357087908c2b8b1282130184effbeb2d33b6,6,35,35,70,32,2012-12-13 00:54:58,2012-12-13 00:54:58
08b4357087908c2b8b1282130184effbeb2d33b6...604c57df6007743cdb8fe386bed0aa29d277d76f,5,83,50,133,39,2012-12-13 01:15:05,2012-12-13 01:15:05
604c57df6007743cdb8fe386bed0aa29d277d76f...37f64b74f225535b51e56e2fe4baca413e72b401,13,262,155,417,86,2012-12-13 02:01:04,2012-12-12 22:58:01
37f64b74f225535b51e56e2fe4baca413e72b401...d5bbc2ad8f42315bd4afacebc27bf9ff17321d68,3,9,5,14,7,2012-12-13 02:39:50,2012-12-13 02:39:50
d5bbc2ad8f42315bd4afacebc27bf9ff17321d68...3b11c2ca5b2aab7bed7bb85ab9eaf3e601eeafd9,3,12,14,26,14,2012-12-13 02:54:10,2012-12-13 02:54:10
3b11c2ca5b2aab7bed7bb85ab9eaf3e601eeafd9...4a9a9cad0ba26bd9384cc2c027f777530344c025,4,11,11,22,10,2012-12-13 03:02:09,2012-12-13 03:02:09
4a9a9cad0ba26bd9384cc2c027f777530344c025...1c529da03e3b246521cd64714f2d9379e96bf691,2,22,15,37,2,2012-12-13 05:22:54,2012-12-13 05:22:54
1c529da03e3b246521cd64714f2d9379e96bf691...b8ab3ad3ef7379ed50cbdbf9feb46ed0bbd1b04d,1,16,3,19,3,2012-12-13 10:57:38,2012-12-13 10:57:38
b8ab3ad3ef7379ed50cbdbf9feb46ed0bbd1b04d...7697f2022d2eb8c821be0da6ce18c993820620cf,4,53,23,76,8,2012-12-13 10:58:40,2012-12-13 10:58:40
7697f2022d2eb8c821be0da6ce18c993820620cf...b87bcbc22a727102bea73a009e82f38136197019,6,135,389,524,18,2012-12-13 12:22:41,2012-12-13 12:22:41
b87bcbc22a727102bea73a009e82f38136197019...3d84b49ae4a047c89c03963be33a070c3fd96b09,4,30,12,42,6,2012-12-13 12:48:52,2012-12-13 12:48:36
3d84b49ae4a047c89c03963be33a070c3fd96b09...5e0c131f32ee1ccea7c91146c5254cfbc3573cb8,4,39,9,48,16,2012-12-13 13:00:51,2012-12-13 13:00:51
5e0c131f32ee1ccea7c91146c5254cfbc3573cb8...44425c1874794be32d95dac93dd6e7356b4ab0f9,2,11,10,21,8,2012-12-13 13:10:44,2012-12-13 13:10:44
44425c1874794be32d95dac93dd6e7356b4ab0f9...e3b7823f746224d27369425ba214e4fddd499de1,7,86,19,105,19,2012-12-13 13:34:52,2012-12-13 13:29:17
e3b7823f746224d27369425ba214e4fddd499de1...2ecf8f35f013e4bc6c5f814c50aebcf5237029a9,3,1,3,4,3,2012-12-13 13:51:46,2012-12-13 13:51:46
2ecf8f35f013e4bc6c5f814c50aebcf5237029a9...157dc9fd1058d522f3cd8fc92df7482358c70ff8,3,140,124,264,24,2012-12-13 14:53:46,2012-12-13 14:53:46
157dc9fd1058d522f3cd8fc92df7482358c70ff8...cd1ccd3fd722c2869098f2a88d07b362783bddcb,3,6,6,12,3,2012-12-13 15:36:25,2012-12-13 15:34:55
cd1ccd3fd722c2869098f2a88d07b362783bddcb...c25939c9f5b8fe5f7baf4222ec444838fb5a2981,5,49,31,80,24,2012-12-13 15:59:45,2012-12-13 15:59:45
c25939c9f5b8fe5f7baf4222ec444838fb5a2981...361cac2044605c164700252d4695f70c34c607fa,1,0,1,1,1,2012-12-13 16:01:11,2012-12-13 16:01:11
361cac2044605c164700252d4695f70c34c607fa...ec1c7cfe044a2f332604fa32dc6a5c17e0e5a34e,2,5,5,10,2,2012-12-13 17:34:02,2012-12-13 17:34:02
ec1c7cfe044a2f332604fa32dc6a5c17e0e5a34e...ae86cce419abd94425bcac2c2673dbbc00e0b319,5,42,30,72,14,2012-12-13 17:50:37,2012-12-13 17:50:37
ae86cce419abd94425bcac2c2673dbbc00e0b319...623b594cf5d9e413da78e20cadbc00726521718e,3,3,3,6,5,2012-12-13 18:59:59,2012-12-13 18:59:59
623b594cf5d9e413da78e20cadbc00726521718e...b085292ea82e21bab44aa38c6573f33a72f14461,4,7,3,10,4,2012-12-13 19:09:15,2012-12-13 19:09:15
b085292ea82e21bab44aa38c6573f33a72f14461...ee2e784e3fd383a79520883e06ca78d16edbf68e,3,3,3,6,3,2012-12-13 19:11:38,2012-12-13 19:11:38
ee2e784e3fd383a79520883e06ca78d16edbf68e...cf2e8545a651e0c19a89b072abf8ed266ff4b422,4,5,5,10,5,2012-12-13 19:20:47,2012-12-13 19:20:47
cf2e8545a651e0c19a89b072abf8ed266ff4b422...c7d4fabb9dd9e8de818309eaa248f9daed278312,3,9,14,23,4,2012-12-14 00:05:59,2012-12-14 00:05:59
c7d4fabb9dd9e8de818309eaa248f9daed278312...01a7e187eab5ee5662cd78f6fc5cdf389768a20b,1,28,17,45,11,2012-12-14 01:12:30,2012-12-13 21:55:00
01a7e187eab5ee5662cd78f6fc5cdf389768a20b...32b04493331b4a5cbbc737dc340b9eb9e822224e,3,66,17,83,6,2012-12-14 13:05:59,2012-12-14 01:29:46
32b04493331b4a5cbbc737dc340b9eb9e822224e...1a7810bddd07ec87534bbe67a3889620201489f3,4,14,5,19,6,2012-12-14 13:05:59,2012-12-14 01:12:10
1a7810bddd07ec87534bbe67a3889620201489f3...8e8699bbd576c82162d57278209addc072ad68d2,2,3,3,6,3,2012-12-14 13:40:45,2012-12-14 13:26:43
8e8699bbd576c82162d57278209addc072ad68d2...c7be9688ef21037d0c8cf447adcb221b302c11ca,4,66,75,141,24,2012-12-15 02:35:02,2012-12-15 02:35:02
c7be9688ef21037d0c8cf447adcb221b302c11ca...a2753ee7a18dd0b4000721391b43663870b588bf,1,8,7,15,4,2012-12-15 14:41:09,2012-12-15 14:40:53
a2753ee7a18dd0b4000721391b43663870b588bf...75be0ab2727a1600534a2988b4377ee24178f152,8,612,634,1246,53,2012-12-15 20:42:00,2012-12-15 20:42:00
75be0ab2727a1600534a2988b4377ee24178f152...478285318295e0bc6b152e16fe56fed9babac9ad,4,34,45,79,11,2012-12-15 20:48:22,2012-12-15 20:48:22
478285318295e0bc6b152e16fe56fed9babac9ad...0c295a2f621e26b8ab79bd02800f21717b4ab51b,3,83,103,186,35,2012-12-15 20:59:55,2012-12-15 20:59:55
0c295a2f621e26b8ab79bd02800f21717b4ab51b...392ee52827319cc140231d5fa922c3d77c1a9f4b,1,3,3,6,2,2012-12-15 21:01:53,2012-12-15 21:01:53
392ee52827319cc140231d5fa922c3d77c1a9f4b...9cc79b4affda49db84accbf2a8bd9a10cd3a2fa6,3,0,21,21,3,2012-12-15 21:02:08,2012-12-15 21:02:08
9cc79b4affda49db84accbf2a8bd9a10cd3a2fa6...a76c08c80acd72c9909863888f3e0a7b575098be,4,14,34,48,9,2012-12-15 21:07:29,2012-12-15 21:07:29
a76c08c80acd72c9909863888f3e0a7b575098be...ca2c943a39835f4a333bb655e583afa386bb7dfd,3,9,18,27,7,2012-12-15 21:25:36,2012-12-15 21:25:36
ca2c943a39835f4a333bb655e583afa386bb7dfd...90f09a7574bdd40cc4bb67551593812c2af3039b,3,3,2,5,3,2012-12-15 22:23:05,2012-12-15 22:23:05
90f09a7574bdd40cc4bb67551593812c2af3039b...42d456f9280ed976d49c483fc5ffc69178962c23,3,54,54,108,10,2012-12-17 10:56:37,2012-12-16 23:57:39
42d456f9280ed976d49c483fc5ffc69178962c23...3f265835d884f609b71ab39658bdb2241f94d500,1,9,1,10,4,2012-12-17 11:30:02,2012-12-17 11:23:42
3f265835d884f609b71ab39658bdb2241f94d500...d33169e676e274de119f27f0b7d3e72ff6162a9e,4,7,8,15,5,2012-12-17 21:40:41,2012-12-17 21:40:41
d33169e676e274de119f27f0b7d3e72ff6162a9e...4dd25f7116f01ce355d9619d338ff33fd49ec884,3,5,5,10,5,2012-12-18 00:52:30,2012-12-17 17:44:55
4dd25f7116f01ce355d9619d338ff33fd49ec884...5396d39965c956256620d35caebe03827cf7fdcd,4,36,7,43,9,2012-12-18 01:00:58,2012-12-17 22:57:21
5396d39965c956256620d35caebe03827cf7fdcd...89c3e75f901a404c460478b995bf8bde0c58e0f0,3,3,3,6,3,2012-12-18 02:32:06,2012-12-18 02:32:06
89c3e75f901a404c460478b995bf8bde0c58e0f0...b632cf1902ece3df85230665f970064f00c6f37f,4,20,10,30,7,2012-12-18 19:38:12,2012-12-18 19:38:12
b632cf1902ece3df85230665f970064f00c6f37f...9356b3e45eb3454f0ad9cd51b444cd82bba231d6,3,17,6,23,5,2012-12-19 01:36:43,2012-12-19 01:36:43
9356b3e45eb3454f0ad9cd51b444cd82bba231d6...4e326813086d8254be2e6e2fc88d087f9d702975,4,24,3,27,4,2012-12-19 04:21:22,2012-12-19 04:21:22
4e326813086d8254be2e6e2fc88d087f9d702975...ebdffc02f8742e249d50d43eba5698f4febe892e,3,16,31,47,13,2012-12-19 04:36:32,2012-12-19 04:36:32
ebdffc02f8742e249d50d43eba5698f4febe892e...9c1d383818de5c52a9185e69df9444ef78b18c32,3,3,10,13,5,2012-12-19 04:38:45,2012-12-19 04:38:45
9c1d383818de5c52a9185e69df9444ef78b18c32...ef445357b3530038f4367e948f027e611fc84c59,2,0,742,742,2,2012-12-19 18:20:44,2012-12-19 18:09:03
ef445357b3530038f4367e948f027e611fc84c59...49fc1095cd3ae251a7b6c16f8a18424d48ac2667,1,0,68,68,1,2012-12-19 18:20:48,2012-12-19 18:10:18
49fc1095cd3ae251a7b6c16f8a18424d48ac2667...1674ee4c1f872511e45ab098112bc2712b996c03,1,0,656,656,1,2012-12-19 18:20:52,2012-12-19 18:11:12
1674ee4c1f872511e45ab098112bc2712b996c03...91faf8bd2d8e68c6b2e33fbea48ae5186afc53ca,1,0,79,79,1,2012-12-19 18:20:55,2012-12-19 18:11:39
91faf8bd2d8e68c6b2e33fbea48ae5186afc53ca...00e2274e542a8e54fde24f53e520a954143e9350,1,0,98,98,1,2012-12-19 18:20:58,2012-12-19 18:12:32
00e2274e542a8e54fde24f53e520a954143e9350...ef361257d2bcfac621628a7c031a80d050a1376c,1,0,102,102,1,2012-12-19 18:21:29,2012-12-19 18:21:29
ef361257d2bcfac621628a7c031a80d050a1376c...9675f54332edbe97ba4a0aca97d7753bb5e6225b,1,0,162,162,1,2012-12-19 18:29:00,2012-12-19 18:29:00
9675f54332edbe97ba4a0aca97d7753bb5e6225b...c9b997e97cf59d9f35103159b71772fa58f73c71,1,0,22,22,1,2012-12-19 18:29:22,2012-12-19 18:29:22
c9b997e97cf59d9f35103159b71772fa58f73c71...62c2f88754df16179018d7120588b6aa5d108f57,1,0,76,76,1,2012-12-19 18:30:32,2012-12-19 18:30:32
62c2f88754df16179018d7120588b6aa5d108f57...20ad1f1c366b8c7ca45b25229eacde2d60c0fb62,1,0,88,88,1,2012-12-19 18:31:10,2012-12-19 18:31:10
20ad1f1c366b8c7ca45b25229eacde2d60c0fb62...577a069f9b9d41545df901098d78683b8e90d574,1,0,60,60,1,2012-12-19 18:31:30,2012-12-19 18:31:30
577a069f9b9d41545df901098d78683b8e90d574...e9c05c308213763a95eedb5c9678672b78149766,1,0,124,124,1,2012-12-19 18:31:50,2012-12-19 18:31:50
e9c05c308213763a95eedb5c9678672b78149766...b4a26b3dc6f72d5d918b7650753d1805c3bc699f,1,0,65,65,1,2012-12-19 18:32:17,2012-12-19 18:32:17
b4a26b3dc6f72d5d918b7650753d1805c3bc699f...98af410ad4d45d0998cbb3fe850454e66984acc0,1,0,68,68,1,2012-12-19 18:38:01,2012-12-19 18:38:01
98af410ad4d45d0998cbb3fe850454e66984acc0...ff83d66006d3796e9ef82fe894a949bc0aa00aee,1,0,122,122,1,2012-12-19 18:43:25,2012-12-19 18:43:25
ff83d66006d3796e9ef82fe894a949bc0aa00aee...858e999c89db945da8ee03d1e19e8c14b965399e,1,0,134,134,1,2012-12-19 18:45:26,2012-12-19 18:45:26
858e999c89db945da8ee03d1e19e8c14b965399e...94e53f16a445d670d147fdc041d6c60be71edd49,1,0,89,89,1,2012-12-19 18:48:42,2012-12-19 18:48:42
94e53f16a445d670d147fdc041d6c60be71edd49...aaaf59d0c0bf68b8ec645a792dc5649e877eafc5,1,0,61,61,1,2012-12-19 18:49:10,2012-12-19 18:49:10
aaaf59d0c0bf68b8ec645a792dc5649e877eafc5...c491456735da87ecd20832e5ee0e514c3aaaac59,1,0,54,54,1,2012-12-19 18:53:16,2012-12-19 18:53:16
c491456735da87ecd20832e5ee0e514c3aaaac59...50119f3d3c8e1f6c08e4663877342fef8765c5ef,1,0,46,46,1,2012-12-19 18:54:01,2012-12-19 18:54:01
50119f3d3c8e1f6c08e4663877342fef8765c5ef...f0814254ca6658dc14b38bb2af0a6b6e304bbaa4,2,0,135,135,2,2012-12-19 18:54:39,2012-12-19 18:54:39
f0814254ca6658dc14b38bb2af0a6b6e304bbaa4...2b53a64a867cf114b76576b6ea7980f5ed30f812,3,0,258,258,3,2012-12-19 19:04:28,2012-12-19 19:04:28
2b53a64a867cf114b76576b6ea7980f5ed30f812...0250c3cc283abaf46d1656c41bb054e41126d01e,3,0,314,314,3,2012-12-19 19:05:38,2012-12-19 19:05:38
0250c3cc283abaf46d1656c41bb054e41126d01e...12720535ce8ed548040f94d5c977aebeb809ed64,4,0,149,149,4,2012-12-19 19:06:25,2012-12-19 19:06:25
12720535ce8ed548040f94d5c977aebeb809ed64...0b50c66e82e961e4dfa8696c4091e1b301963753,3,0,327,327,3,2012-12-19 19:07:26,2012-12-19 19:07:26
0b50c66e82e961e4dfa8696c4091e1b301963753...8ad3143d058fcef17322064ec3e4d35d1d79fcc7,2,0,187,187,2,2012-12-19 19:08:26,2012-12-19 19:08:26
8ad3143d058fcef17322064ec3e4d35d1d79fcc7...2926953c7a19f28d1fe09a9e7cd64fe9eea4940a,1,0,45,45,1,2012-12-19 19:14:19,2012-12-19 19:14:19
2926953c7a19f28d1fe09a9e7cd64fe9eea4940a...a62f01ee95058df87a51a9b6d7fa56a92e75bcd6,1,0,67,67,1,2012-12-19 19:16:04,2012-12-19 19:16:04
a62f01ee95058df87a51a9b6d7fa56a92e75bcd6...05a6664974654c39576b3c11b8df2fceaf095be1,1,0,66,66,1,2012-12-19 19:18:43,2012-12-19 19:18:43
05a6664974654c39576b3c11b8df2fceaf095be1...421bde92b77357540681943097923086ead8e4c9,3,0,125,125,3,2012-12-19 19:19:31,2012-12-19 19:19:31
421bde92b77357540681943097923086ead8e4c9...f455c4ac325f7c033e55daa79ee4ecf10d4a03c8,1,0,103,103,1,2012-12-19 19:20:29,2012-12-19 19:20:29
f455c4ac325f7c033e55daa79ee4ecf10d4a03c8...3a6fb753d1bbcf63ac882dcff32ea374d17d7371,2,0,125,125,2,2012-12-19 19:22:13,2012-12-19 19:22:13
3a6fb753d1bbcf63ac882dcff32ea374d17d7371...5ba4ee320cc711d5b883b13cc849291af6b1b1a1,2,0,159,159,2,2012-12-19 19:23:19,2012-12-19 19:23:19
5ba4ee320cc711d5b883b13cc849291af6b1b1a1...14eb09e25ebda41843377f35102795453ce2c543,1,0,69,69,1,2012-12-19 19:38:08,2012-12-19 19:38:08
14eb09e25ebda41843377f35102795453ce2c543...b7802c57b9abc865c085bf31b45020bbbc8b2504,1,0,98,98,1,2012-12-19 19:41:07,2012-12-19 19:41:07
b7802c57b9abc865c085bf31b45020bbbc8b2504...78ca20fc4449182d558ae0fc96a108c7016f43d4,1,0,109,109,1,2012-12-19 19:41:26,2012-12-19 19:41:26
78ca20fc4449182d558ae0fc96a108c7016f43d4...382b3e9223e1e2ec65d321fdb457e257af6eccb0,1,0,78,78,1,2012-12-19 19:41:51,2012-12-19 19:41:51
382b3e9223e1e2ec65d321fdb457e257af6eccb0...6c7f7f029f5b523f36a265778870c364197c43a2,1,0,57,57,1,2012-12-19 19:42:16,2012-12-19 19:42:16
6c7f7f029f5b523f36a265778870c364197c43a2...0251fcf584520ae9ecc7c3b78c17b169c9bd05c3,1,0,73,73,1,2012-12-19 19:42:54,2012-12-19 19:42:54
0251fcf584520ae9ecc7c3b78c17b169c9bd05c3...7b532d9c4a21b70a9442e88c8a55131fdd482a05,14,0,600,600,14,2012-12-19 19:43:31,2012-12-19 19:43:31
7b532d9c4a21b70a9442e88c8a55131fdd482a05...345deb956f2768be01483251c655e363c416f3a5,1,0,224,224,1,2012-12-19 19:43:54,2012-12-19 19:43:54
345deb956f2768be01483251c655e363c416f3a5...6deae4a971351cdc2f9d61ddb537935b0a83858d,1,0,97,97,1,2012-12-19 19:45:21,2012-12-19 19:45:21
6deae4a971351cdc2f9d61ddb537935b0a83858d...00efc577817fce0abadc33bef7fa5f339fa63720,2,0,126,126,2,2012-12-19 19:46:48,2012-12-19 19:46:48
00efc577817fce0abadc33bef7fa5f339fa63720...17b584969a19b21e963ed93c46af4ba16c766f91,1,0,101,101,1,2012-12-19 19:47:01,2012-12-19 19:47:01
17b584969a19b21e963ed93c46af4ba16c766f91...223a047b3ae421c6d5278609c6bc488150a89292,2,1,6,7,2,2012-12-19 19:49:16,2012-12-19 19:47:54
223a047b3ae421c6d5278609c6bc488150a89292...a913d6e24840491365c6176b8c2d54775c0b2d30,1,0,63,63,1,2012-12-19 19:50:25,2012-12-19 19:50:25
a913d6e24840491365c6176b8c2d54775c0b2d30...f03708d6eff5ef41a8c976433d191703d1eb5470,2,0,217,217,2,2012-12-19 19:51:07,2012-12-19 19:51:07
f03708d6eff5ef41a8c976433d191703d1eb5470...96ff57fd25af78ac72b8458fc9830b4857939885,1,0,88,88,1,2012-12-19 19:51:53,2012-12-19 19:51:53
96ff57fd25af78ac72b8458fc9830b4857939885...8b91f76c28209ec1aff82eb30dabfeab64aaadf0,1,0,103,103,1,2012-12-19 19:52:49,2012-12-19 19:52:49
8b91f76c28209ec1aff82eb30dabfeab64aaadf0...b5021f13c8b12b2890f51aa3e936b9ba4ef611b6,1,5,0,5,1,2012-12-19 20:20:14,2012-12-19 20:20:14
b5021f13c8b12b2890f51aa3e936b9ba4ef611b6...79e3a8de747f69a37f7ef83a06b0f645b8220f87,1,0,61,61,1,2012-12-19 20:21:03,2012-12-19 20:21:03
79e3a8de747f69a37f7ef83a06b0f645b8220f87...5eac18167a86ddc2f2c4ee9aac1896b06b017445,1,0,136,136,1,2012-12-19 20:41:01,2012-12-19 20:41:01
5eac18167a86ddc2f2c4ee9aac1896b06b017445...e6da19f7d040fa7997f7dc557834d0d5375c153c,3,0,0,0,0,2012-12-19 20:52:35,2012-12-19 20:50:07
e6da19f7d040fa7997f7dc557834d0d5375c153c...2782e793e3d078f73087ca8f0e45ca13d4325b16,1,0,0,0,0,2012-12-19 20:53:05,2012-12-19 20:53:05
2782e793e3d078f73087ca8f0e45ca13d4325b16...d354200f5e6a7b787d57c2fc2233aebe0689beaa,2,2,0,2,2,2012-12-19 20:55:44,2012-12-19 20:55:44
d354200f5e6a7b787d57c2fc2233aebe0689beaa...96f1be94cf36ab2b2f18d84834b0ec9d69a1bf6f,1,0,87,87,1,2012-12-19 22:31:38,2012-12-19 22:31:38
96f1be94cf36ab2b2f18d84834b0ec9d69a1bf6f...c9629d479b03620d26fe8924173a8835b786bb0b,6,0,10794,10794,6,2012-12-19 22:33:19,2012-12-19 22:33:19
c9629d479b03620d26fe8924173a8835b786bb0b...7c8abc09832484e450c3a1e770bbc8b279a73e67,1,0,38,38,1,2012-12-19 22:47:14,2012-12-19 22:47:14
7c8abc09832484e450c3a1e770bbc8b279a73e67...24f0b575b7d9b3282eb6f0bc973e57b707c8b0b9,1,0,118,118,1,2012-12-19 23:10:27,2012-12-19 23:10:27
24f0b575b7d9b3282eb6f0bc973e57b707c8b0b9...2cfbbe7144d4b2afc8ea2e73690c6a51e6fb0bfd,1,0,135,135,1,2012-12-19 23:11:57,2012-12-19 23:11:57
2cfbbe7144d4b2afc8ea2e73690c6a51e6fb0bfd...356d55cbf79424a72142ed78f3053fcabc172aff,2,0,537,537,2,2012-12-19 23:14:50,2012-12-19 23:14:50
356d55cbf79424a72142ed78f3053fcabc172aff...d07d709832468c84c9f9c30dff4073d91ac065f7,1,0,64,64,1,2012-12-19 23:22:16,2012-12-19 23:22:16
d07d709832468c84c9f9c30dff4073d91ac065f7...e7c6120bb86262608f9983c8d226fbc48bb8aa47,1,0,164,164,1,2012-12-19 23:29:47,2012-12-19 23:29:47
e7c6120bb86262608f9983c8d226fbc48bb8aa47...ea202e32e0bbba53784b7a09037f454ea1fe247b,1,0,69,69,1,2012-12-19 23:38:01,2012-12-19 23:38:01
ea202e32e0bbba53784b7a09037f454ea1fe247b...1926a8890a8ffc5f485295d3e01246b9179dc911,1,0,56,56,1,2012-12-19 23:38:37,2012-12-19 23:38:37
1926a8890a8ffc5f485295d3e01246b9179dc911...688da4a8201e1c88ed2dbb48f703d34cf05acc5a,3,0,186,186,3,2012-12-19 23:39:42,2012-12-19 23:39:42
688da4a8201e1c88ed2dbb48f703d34cf05acc5a...8728e24e4dff535fb726f9841817cc3f6edff9c7,25,0,7483,7483,25,2012-12-19 23:42:46,2012-12-19 23:40:31
8728e24e4dff535fb726f9841817cc3f6edff9c7...8e4deb31624be6ad79de3e7674ce606c3ada84d6,1,0,69,69,1,2012-12-20 00:27:09,2012-12-20 00:27:09
8e4deb31624be6ad79de3e7674ce606c3ada84d6...f940bbdb7f6913bd001dee56fdfa30dfa70de7ae,1,0,73,73,1,2012-12-20 00:30:40,2012-12-20 00:30:40
f940bbdb7f6913bd001dee56fdfa30dfa70de7ae...8d331997797eba632d40d2eeaa489c1ebd55a8c2,1,0,51,51,1,2012-12-20 00:31:52,2012-12-20 00:31:52
8d331997797eba632d40d2eeaa489c1ebd55a8c2...8fb69fa252ee9030c1df8fe2166c3463604b8d8e,2,0,129,129,2,2012-12-20 00:32:54,2012-12-20 00:32:54
8fb69fa252ee9030c1df8fe2166c3463604b8d8e...f430c20fe334a3bf5c766bf4fd11988647d09aeb,1,0,58,58,1,2012-12-20 00:43:06,2012-12-20 00:43:06
f430c20fe334a3bf5c766bf4fd11988647d09aeb...6d27e13f9fefc1be1d2304b67e5c5621a1405e50,1,0,0,0,0,2012-12-20 00:50:07,2012-12-20 00:50:07
6d27e13f9fefc1be1d2304b67e5c5621a1405e50...542726c4af0f0a2bdd6745fe0130b451994f66a4,1,0,115,115,1,2012-12-20 00:51:52,2012-12-20 00:51:52
542726c4af0f0a2bdd6745fe0130b451994f66a4...211ae9fd39f2df94476d9a76582fafa8f2a41446,1,0,157,157,1,2012-12-20 00:52:08,2012-12-20 00:52:08
211ae9fd39f2df94476d9a76582fafa8f2a41446...301abe6f99198e9a97f48a000f8d4748cc82bb56,1,0,70,70,1,2012-12-20 01:01:55,2012-12-20 01:01:55
301abe6f99198e9a97f48a000f8d4748cc82bb56...c7ef8330222c9c34e90ec024fe976d65cca3b5f5,1,0,154,154,1,2012-12-20 01:07:27,2012-12-20 01:07:27
c7ef8330222c9c34e90ec024fe976d65cca3b5f5...67fcbfb3330a778f3c1363b171ee04a4cbd014bb,1,0,255,255,1,2012-12-20 05:35:52,2012-12-20 05:35:52
67fcbfb3330a778f3c1363b171ee04a4cbd014bb...42b17f937842f3f88a4f7f5473912f075f3c2e87,1,0,109,109,1,2012-12-20 06:01:07,2012-12-20 06:01:07
42b17f937842f3f88a4f7f5473912f075f3c2e87...e56f2175b3fee06576043b65d3390bcaf929ecf3,1,0,62,62,1,2012-12-20 06:02:30,2012-12-20 06:02:30
e56f2175b3fee06576043b65d3390bcaf929ecf3...29f7adefc53cc2113bc9a2feec49daf284f3212a,1,2,0,2,1,2012-12-20 16:15:20,2012-12-20 16:15:20
29f7adefc53cc2113bc9a2feec49daf284f3212a...3b641b63fff881570ad544f6bc3af3d679e9fa8e,1,0,38,38,1,2012-12-20 18:29:10,2012-12-20 18:29:10
3b641b63fff881570ad544f6bc3af3d679e9fa8e...626dd3ada033819d8dd3911884d1ed9713534dec,1,0,70,70,1,2012-12-20 20:43:45,2012-12-20 20:43:45
626dd3ada033819d8dd3911884d1ed9713534dec...3208345a27c972616b784dd38de73e77fac1c0cd,1,0,89,89,1,2012-12-20 20:44:12,2012-12-20 20:44:12
3208345a27c972616b784dd38de73e77fac1c0cd...dba9baf2ad2ee479c046c41a8fcf4afc46ee9e25,1,0,111,111,1,2012-12-20 20:55:26,2012-12-20 20:55:26
dba9baf2ad2ee479c046c41a8fcf4afc46ee9e25...e1443c9e3c62afb3534ea56818564bdd7c34227e,1,0,64,64,1,2012-12-20 22:13:45,2012-12-20 22:13:45
e1443c9e3c62afb3534ea56818564bdd7c34227e...6e89c9836d333259e8d88f0714aee32f1c8c859d,2,0,381,381,2,2012-12-20 22:37:10,2012-12-20 22:37:10
6e89c9836d333259e8d88f0714aee32f1c8c859d...57308ff165823de0a20e14d6f72d53b305201c0f,3,0,265,265,3,2012-12-20 22:39:56,2012-12-20 22:39:56
57308ff165823de0a20e14d6f72d53b305201c0f...fc5df1076867a4d6bf18b23a49c757d7cdc15d13,4,0,229,229,4,2012-12-20 23:19:05,2012-12-20 23:19:05
fc5df1076867a4d6bf18b23a49c757d7cdc15d13...dd3dceddd499effd707a20d99357471b10f86582,1,0,106,106,1,2012-12-20 23:31:38,2012-12-20 23:31:38
dd3dceddd499effd707a20d99357471b10f86582...36876f171079d6c56b6369caf4edf7cac7a7b5e9,1,0,90,90,1,2012-12-20 23:31:59,2012-12-20 23:31:59
36876f171079d6c56b6369caf4edf7cac7a7b5e9...7a67b00b3e040535a25a288c4065749baa443e64,3,0,276,276,3,2012-12-20 23:33:13,2012-12-20 23:33:13
7a67b00b3e040535a25a288c4065749baa443e64...abaa6f1645911216627bc8a68ece7abb471e5383,11,20,10,30,15,2012-12-20 23:37:09,2012-12-20 23:37:09
9ac8ad3c7da201dacaa295744171a4b1b9a2bc6b...04b85ef3647e28c78327463b520fea78d587423b,3,20,9,29,7,2012-09-26 18:25:14,2012-09-26 16:29:44
04b85ef3647e28c78327463b520fea78d587423b...f7e6dc93dc3e96a23f71aa0b078b5f1771ed205e,3,10,12,22,9,2012-09-26 18:25:14,2012-09-26 17:30:36
f7e6dc93dc3e96a23f71aa0b078b5f1771ed205e...3b480a2549e9e856da02b77f0317cf8f9738306c,3,3,2,5,4,2012-09-26 18:34:39,2012-09-26 18:34:39
3b480a2549e9e856da02b77f0317cf8f9738306c...83af6c4c0b480b2862c9ba3c8b559bbd521cb6a1,3,55,38,93,10,2012-09-26 18:50:20,2012-09-26 18:40:49
83af6c4c0b480b2862c9ba3c8b559bbd521cb6a1...e40787c165cb4478c1a7053d38dabfb046a93c75,3,5,1,6,3,2012-09-26 18:51:49,2012-09-26 18:51:49
e40787c165cb4478c1a7053d38dabfb046a93c75...650ebcffab3fe486fa3f7fb41f090867d90c181f,3,15,9,24,9,2012-09-26 19:23:32,2012-09-26 19:23:32
7af288439403bf2b721a4771f401fb2d7dff2803...f7174ce1a161c5912ad83bad3f98cb582b1ee40c,3,20,9,29,7,2012-09-26 16:29:44,2012-09-26 16:29:44
f7174ce1a161c5912ad83bad3f98cb582b1ee40c...a91954bbac70bb43d21006893b73855a1d159bc1,3,10,12,22,9,2012-09-26 17:30:36,2012-09-26 17:30:36
63979e25d7e1082d73de3ae4e54387d98951b07d...2810d3cc1bbcb4fb94300db4104b2bd5eb237c5d,4,23,33,56,23,2013-01-08 23:18:59,2013-01-08 23:18:59
2810d3cc1bbcb4fb94300db4104b2bd5eb237c5d...9c6be3c57401a9bc76211ddce19c34191add6013,4,38,3,41,6,2013-01-08 23:32:21,2013-01-08 23:32:21
9c6be3c57401a9bc76211ddce19c34191add6013...4e167cf1d593eca535537a4596675aafd95578f2,3,4,5,9,5,2013-01-08 23:42:47,2013-01-08 23:42:47
63979e25d7e1082d73de3ae4e54387d98951b07d...679b9b94bfa5e9b2e6c7a68af789a039495c9432,1,2,2,4,2,2013-01-07 14:16:37,2013-01-07 14:16:37
63979e25d7e1082d73de3ae4e54387d98951b07d...475b18f2dfa96c399f9197609033819cc4cbf3ff,5,26,5,31,6,2013-01-05 01:45:43,2013-01-05 01:45:43
2358fd0fb43d74cb72ddc4dd2218ab9153d0af02...b04954bc9f5532a9a5b49e3c7618353cc7359e14,5,70,6,76,9,2012-10-25 17:31:12,2012-10-25 17:29:24
e499edf5337cebcfb22f4163d8463c724c5b7ab9...f36a6acdf3a2ae38551889ec1dd68852f6bfac7e,3,10,8,18,6,2012-09-27 00:33:55,2012-09-27 00:33:32
f36a6acdf3a2ae38551889ec1dd68852f6bfac7e...99c444ddaff37ae04d8d4ded477fddb495d55d5f,4,6,1,7,4,2012-09-27 04:01:42,2012-09-27 04:01:42
99c444ddaff37ae04d8d4ded477fddb495d55d5f...06cf988c5afa8771fe6428a0aa0558e144a62cd9,10,35,42,77,31,2012-09-27 04:19:56,2012-09-27 04:19:56
06cf988c5afa8771fe6428a0aa0558e144a62cd9...815c76f79ff620f0f16d84b0c566489f0b15b455,3,38,32,70,8,2012-09-27 19:11:20,2012-09-27 19:11:20
815c76f79ff620f0f16d84b0c566489f0b15b455...96d2f9adb0901ae5a11156460570b1af96099206,3,5,5,10,4,2012-09-27 19:13:01,2012-09-27 19:13:01
96d2f9adb0901ae5a11156460570b1af96099206...5d02d49877fc653feee9ad9d5842578847b62ad5,3,52,46,98,14,2012-09-27 19:39:23,2012-09-27 19:39:23
5d02d49877fc653feee9ad9d5842578847b62ad5...c2fdedd348700e6fd0db627a8b79be07de969a05,3,45,39,84,13,2012-09-27 22:14:39,2012-09-27 22:14:05
c2fdedd348700e6fd0db627a8b79be07de969a05...2616f03311208a0ae1da410d3c3a6145521165a2,3,7,7,14,4,2012-09-27 22:21:51,2012-09-27 22:21:51
2616f03311208a0ae1da410d3c3a6145521165a2...67c4bf8b3ff64ba8743686ca2dd57011dd32eef2,3,6,6,12,3,2012-09-27 22:29:36,2012-09-27 22:29:36
baf78553069cffa6b7925a5781872024fe5d1eac...58fb99d589426e717fd882f3196bfb117a5292c7,4,37,17,54,12,2013-01-13 19:02:16,2013-01-13 19:02:16
60c6204f5a35d1c630530e3e84013bbca93ee841...92ae464cc9ceff7a3f113af9c6ab7030955644f1,4,15,11,26,11,2012-10-27 00:29:00,2012-10-27 00:28:27
35ac9dd9aeaa96fae7b2a05a7c150724d30ef7fa...1e0eb6e2868b36dbc4451470c5b1b446c8a1d611,2,237,36,273,2,2013-02-14 18:09:35,2013-02-14 18:09:35
35ac9dd9aeaa96fae7b2a05a7c150724d30ef7fa...50a552093f33ce05583af066d0257c192ae75e54,4,74,41,115,22,2013-02-11 19:56:32,2013-02-11 19:56:32
35ac9dd9aeaa96fae7b2a05a7c150724d30ef7fa...fcf36f456eddf0c561826dd1329bb9b9c309256a,7,123,1,124,7,2013-02-11 14:35:14,2013-02-11 14:35:14
fcf36f456eddf0c561826dd1329bb9b9c309256a...d99e1176c5be88e517fb4ab0db306276b7fc9c74,5,3,49,52,5,2013-02-22 16:42:51,2013-02-22 16:42:51
d99e1176c5be88e517fb4ab0db306276b7fc9c74...ed7974d262410fbf9e7c4d9ad3bcc9306f8ec555,6,57,8,65,7,2013-02-22 17:18:28,2013-02-22 17:18:28
ed7974d262410fbf9e7c4d9ad3bcc9306f8ec555...27d9e638c4cb1ed8338481eed5245b4ce9d04b3c,5,24,23,47,10,2013-02-22 17:40:01,2013-02-22 17:40:01
27d9e638c4cb1ed8338481eed5245b4ce9d04b3c...8a96586c906d799537c886f44b1fe3e763566c67,3,27,14,41,5,2013-02-23 12:48:25,2013-02-23 12:48:25
8a96586c906d799537c886f44b1fe3e763566c67...9977983f8df4528a87a6dba05d64842b6c692d01,4,5,5,10,4,2014-05-23 08:55:35,2014-05-23 08:55:35
9977983f8df4528a87a6dba05d64842b6c692d01...b99ab732d12727769503c3c36fb4b3a6c68915db,4,44,35,79,9,2014-09-27 11:17:03,2014-09-27 11:17:03
b99ab732d12727769503c3c36fb4b3a6c68915db...be6ad60c5e99e38b503652ff06c9f7edbc40bb96,5,21,21,42,9,2014-09-27 11:23:03,2014-09-27 11:23:03
be6ad60c5e99e38b503652ff06c9f7edbc40bb96...f8021704d2de4154fc01b5e8c58f162702d3d646,1,28,28,56,1,2014-09-28 12:49:31,2014-09-28 12:49:31
35ac9dd9aeaa96fae7b2a05a7c150724d30ef7fa...1e8a57981039cfbe41a63a819ab0f7ec3ff2d01f,5,210,4,214,5,2013-02-09 22:42:04,2013-02-09 22:42:04
1e8a57981039cfbe41a63a819ab0f7ec3ff2d01f...1f422ae3e990c8c68681f95813f3ea94e0a31efe,3,12,16,28,11,2013-02-10 21:14:24,2013-02-10 21:14:24
35ac9dd9aeaa96fae7b2a05a7c150724d30ef7fa...c593abe6d8f43440a4d5b0e04035304c5ced871f,1,1,1,2,1,2013-02-07 13:53:31,2013-02-07 13:13:00
c593abe6d8f43440a4d5b0e04035304c5ced871f...86b59d40f659311d8be283bda1898afd2126782d,1,1,1,2,1,2013-02-07 14:37:29,2013-02-07 14:37:29
67c4bf8b3ff64ba8743686ca2dd57011dd32eef2...71df2b80e62f844d7fd2e1942f64552e363637b0,3,14,12,26,4,2012-09-28 07:57:26,2012-09-28 07:57:03
71df2b80e62f844d7fd2e1942f64552e363637b0...8d326607ff84c34fe634d5d0d74ba81568272f06,3,6,6,12,3,2012-09-28 08:15:06,2012-09-28 08:15:06
11a19ec03d21a2908ce2d0ceed954e6a41a58cfc...183060d40ffce8a8bd233feeedd80f84d4707642,13,50,1483,1533,30,2013-01-24 17:26:22,2013-01-24 17:07:38
11a19ec03d21a2908ce2d0ceed954e6a41a58cfc...246d8197e354868d628b0d5f8b061e2ef232ba36,3,12,12,24,6,2013-01-22 02:52:15,2013-01-22 02:52:15
246d8197e354868d628b0d5f8b061e2ef232ba36...4dc996e5753b089c4fb47a5643a852a4c7de9886,3,4,5,9,5,2013-01-23 18:28:44,2013-01-23 18:25:35
4dc996e5753b089c4fb47a5643a852a4c7de9886...a4de685aad096f6d1924595ce2e26b51244ba69f,3,7,13,20,5,2013-01-23 20:26:09,2013-01-23 20:26:09
11a19ec03d21a2908ce2d0ceed954e6a41a58cfc...1eeb8c0fa46b41b565ac17c4a0b8526e40a1b008,3,79,19,98,15,2013-01-15 18:23:30,2013-01-15 18:23:30
1eeb8c0fa46b41b565ac17c4a0b8526e40a1b008...45d3a181782bcb3caeec76183883e0d41d8ef717,4,155,58,213,18,2013-01-16 18:21:29,2013-01-16 18:21:29
45d3a181782bcb3caeec76183883e0d41d8ef717...2145cc60084e3d7ae6b0ec110e327aa01832ca5a,3,4,4,8,3,2013-01-20 19:50:46,2013-01-20 19:50:18
2145cc60084e3d7ae6b0ec110e327aa01832ca5a...6b06c4526bedfa7294bd547f8115cdf7cd019872,12,73,75,148,36,2013-01-23 23:46:34,2013-01-23 23:38:44
6b06c4526bedfa7294bd547f8115cdf7cd019872...5c9b90ce078c8035de3385f2d74ed0fd4f3cd188,4,13,6,19,4,2013-01-31 13:27:21,2013-01-31 13:23:54
1e0eb6e2868b36dbc4451470c5b1b446c8a1d611...4cc7599b5f19ae8630e0085a226f00e6bba39049,1,1,1,2,1,2013-02-14 19:17:57,2013-02-14 19:17:57
c58471c9a91d40eb4f84f9a774ffa2f3999ab171...ddbdf2fbe83d3bd4aaf9fe71e646a51339e51de1,4,30,17,47,12,2013-03-06 05:08:48,2013-03-06 05:08:48
ddbdf2fbe83d3bd4aaf9fe71e646a51339e51de1...600666e8c1d56a8dc1d989ebf5c516a1c543f9ba,6,354,318,672,53,2013-03-06 08:57:28,2013-03-05 15:29:45
600666e8c1d56a8dc1d989ebf5c516a1c543f9ba...d789645231ac62c641653bf28663e6b9696bda26,5,76,17,93,21,2013-03-06 14:13:37,2013-03-06 13:46:42
d789645231ac62c641653bf28663e6b9696bda26...772c2f07ef570614e452587c878c4368f78095cf,3,6,6,12,3,2013-03-06 14:56:54,2013-03-06 14:56:54
772c2f07ef570614e452587c878c4368f78095cf...8b703e22c28b10dab859277cd1dd14172ce1749e,3,3,3,6,3,2013-03-06 16:54:38,2013-03-06 16:54:13
8b703e22c28b10dab859277cd1dd14172ce1749e...fe09bb0cc25935ee0ecd9dbe0ab2cb438dc971be,5,68,7,75,6,2013-03-07 15:53:08,2013-03-07 15:45:00
fe09bb0cc25935ee0ecd9dbe0ab2cb438dc971be...368f80c215f2a17dfca485f9b20b6a7390162aa3,2,20,5,25,4,2013-03-07 17:53:00,2013-03-07 17:53:00
368f80c215f2a17dfca485f9b20b6a7390162aa3...37ac848f5f1eacae796bd71e65786bdd84442730,1,3,0,3,1,2013-03-07 17:54:19,2013-03-07 17:54:19
37ac848f5f1eacae796bd71e65786bdd84442730...f1c8b090da2b6eb4f83fe7f8046823ba6eeb6476,5,36,5,41,5,2013-03-07 20:05:49,2013-03-07 20:05:49
7042c931700131db762fb5049511d9897ebbd253...60df29662570a7d454b2f709226a8db19c0c5e76,4,35,55,90,13,2014-11-15 01:59:23,2014-11-15 01:59:23
60df29662570a7d454b2f709226a8db19c0c5e76...2dc51055b4aa85496ceb12363f492ad0ad697780,4,23,20,43,11,2014-11-15 16:57:34,2014-11-15 16:57:34
d7454e5e33a3c96a5334e9ea507af7354afa5ab1...ff137ede764014eb214470f79961fecb0f1cdfac,3,31,29,60,8,2013-03-03 17:06:48,2013-03-03 17:06:48
e3b58c4550a3124b61bedf9ac39f926555ae8900...85041c616d8543785f4692befdbf23313afd483b,4,56,54,110,11,2012-09-29 20:55:30,2012-09-29 20:55:30
85041c616d8543785f4692befdbf23313afd483b...a0ef36d5d58cb9672fa819effb7d5449aef400e7,3,64,65,129,42,2012-09-29 21:11:12,2012-09-29 21:09:12
e3b58c4550a3124b61bedf9ac39f926555ae8900...cb6db53fa62cc0d465380b5113906ac1366b5f19,3,457,101,558,38,2012-09-28 19:25:29,2012-09-28 19:25:29
cb6db53fa62cc0d465380b5113906ac1366b5f19...35726439ca3f6c2f06cd80406bb9037c36cf39ea,4,423,308,731,67,2012-09-29 11:08:26,2012-09-29 10:24:28
35726439ca3f6c2f06cd80406bb9037c36cf39ea...256c2ea39117b044cc7f46a31efdf2f534dee911,3,18,21,39,12,2012-09-29 11:22:57,2012-09-29 11:15:17
256c2ea39117b044cc7f46a31efdf2f534dee911...9235c9d83ccc974f3bda364c39df21088f8924ce,3,7,11,18,5,2012-09-29 13:09:58,2012-09-29 13:09:58
9235c9d83ccc974f3bda364c39df21088f8924ce...df913fe96b0bb0b190ddfab111136a7b868b8350,1,5,3,8,3,2012-09-29 13:12:42,2012-09-29 13:12:42
df913fe96b0bb0b190ddfab111136a7b868b8350...d556ed1a316008f3b52138375a938b7c547809e8,5,66,66,132,17,2012-09-29 13:40:10,2012-09-29 13:40:10
d556ed1a316008f3b52138375a938b7c547809e8...c2d6903f8b2441b893d33c5ad24bdf8b8f652ef9,3,183,176,359,18,2012-09-29 14:01:39,2012-09-29 14:01:39
c2d6903f8b2441b893d33c5ad24bdf8b8f652ef9...bc05aca4b551b3307447bc13ee72666cf240736b,3,20,23,43,9,2012-09-29 17:20:45,2012-09-29 17:20:45
183060d40ffce8a8bd233feeedd80f84d4707642...093bd8485af3479b8b42986716b341196e58ae7f,4,25,8,33,8,2013-02-06 18:25:19,2013-02-06 18:25:19
183060d40ffce8a8bd233feeedd80f84d4707642...2a0e2a12667b85279cfeaa653cc376136a5202e0,4,30,9,39,5,2013-02-06 18:18:52,2013-02-06 18:18:52
183060d40ffce8a8bd233feeedd80f84d4707642...4917fa86ca03cb6ba903640d105aa21d62f6e366,4,80,4,84,4,2013-02-05 23:08:20,2013-01-22 08:54:00
183060d40ffce8a8bd233feeedd80f84d4707642...45ca793083b69820c3ebb4bed3969ee385a73ae0,3,8,8,16,4,2013-02-01 18:57:37,2013-02-01 18:57:37
183060d40ffce8a8bd233feeedd80f84d4707642...cd2712dc65a1217bb00ef0ed5762dd7030599089,3,21,54,75,7,2013-02-01 17:58:24,2013-02-01 17:58:24
cd2712dc65a1217bb00ef0ed5762dd7030599089...72f7c95883319c0e34902c6804b496137ca55cc9,1,1,1,2,1,2013-02-01 19:06:29,2013-02-01 19:06:29
183060d40ffce8a8bd233feeedd80f84d4707642...a31f59274e44e23e74987ea8e7badf1dcd68b1df,4,14,8,22,8,2013-02-01 16:09:12,2013-02-01 16:09:12
a31f59274e44e23e74987ea8e7badf1dcd68b1df...3dcdfbfe1fb45e98ec5fad62cd03f2316b2d8bea,4,5,3,8,4,2013-02-01 16:51:47,2013-02-01 16:51:47
3dcdfbfe1fb45e98ec5fad62cd03f2316b2d8bea...2e24cf9be8c95942dca2b56d4a5ed56451f41d5d,5,21,13,34,8,2013-02-01 18:30:51,2013-02-01 18:30:48
183060d40ffce8a8bd233feeedd80f84d4707642...0991f3b010860889bd4693ee3bbd7dcf4963e17b,22,75,76,151,52,2013-01-31 23:11:40,2013-01-31 23:11:40
0991f3b010860889bd4693ee3bbd7dcf4963e17b...46a586d4eefbf26c8dc4f19ca3c18805442e4dbf,5,12,13,25,8,2013-02-06 16:55:05,2013-02-06 16:55:05
183060d40ffce8a8bd233feeedd80f84d4707642...9c3ad8f53b23cea9acbabf221b570ad37276676f,5,55,50,105,19,2013-01-31 17:34:05,2013-01-17 09:47:24
9c3ad8f53b23cea9acbabf221b570ad37276676f...b9bf5302b4f4bd6724ba57df397865c68ecfe955,1,8,0,8,1,2013-02-05 21:35:58,2013-02-01 13:20:05
48f3fa871639d1cf0744f3c7c0cb608a9f5bad55...f6668a804b94b5097fa5a41e11743cc1a28f87a2,1,2,3,5,1,2013-03-06 04:41:35,2013-03-06 04:41:35
4648db5bdd809a13d3600330a152c381b5b659e9...b2c2f2cff27973981d247891d6b325c92720929b,3,26,10,36,3,2013-03-03 11:33:32,2013-03-03 11:19:04
4648db5bdd809a13d3600330a152c381b5b659e9...88c4a86e714280476a63ddb71bf3d8975ed842a6,5,189,2,191,5,2013-03-02 22:46:45,2013-03-02 22:46:45
4648db5bdd809a13d3600330a152c381b5b659e9...aeb620b3a8aeb4166fee476574e3a67eff7890da,4,63,12,75,10,2013-03-02 21:49:50,2013-03-02 21:49:50
aeb620b3a8aeb4166fee476574e3a67eff7890da...95543f7babacb9df4c4a706912e2ecf0fde986a7,4,27,12,39,8,2013-03-02 21:54:44,2013-03-02 21:54:44
95543f7babacb9df4c4a706912e2ecf0fde986a7...cb9977430d7da6d0aa561363a549820ec5a97288,3,5,7,12,3,2013-03-02 21:56:04,2013-03-02 21:56:04
4648db5bdd809a13d3600330a152c381b5b659e9...873db8d8930998ef92141f200dc967e9358d39c9,4,21,13,34,9,2013-03-02 18:32:22,2013-03-02 18:32:22
4648db5bdd809a13d3600330a152c381b5b659e9...c871da4e988d04bedb9acf8cdc537a6083f95d93,3,10,1,11,3,2013-02-26 23:48:45,2013-02-26 23:48:45
c871da4e988d04bedb9acf8cdc537a6083f95d93...da7262d05beb324e8a921beed865d945359b0685,4,18,12,30,6,2013-03-02 22:57:21,2013-03-02 22:57:21
da7262d05beb324e8a921beed865d945359b0685...9323c2314fda1de78153dce95b119672d49939b0,154,183,152,335,154,2013-03-02 23:09:02,2013-03-02 23:09:02
4648db5bdd809a13d3600330a152c381b5b659e9...4ce9bffe91bc7264024e41a67956b36ff11962de,5,105,10,115,12,2013-02-26 00:55:58,2013-02-18 12:50:11
4648db5bdd809a13d3600330a152c381b5b659e9...07366aae38c0c0609468888331b04b921c35edc9,3,31,14,45,12,2013-02-20 15:51:32,2013-02-20 15:51:32
4648db5bdd809a13d3600330a152c381b5b659e9...1a516aa576135874f85dc787776bf88f138d43f2,3,85,41,126,13,2013-02-19 03:12:57,2013-02-19 03:12:57
4648db5bdd809a13d3600330a152c381b5b659e9...889aacc43d076382d11316e65646a316161265e3,6,47,13,60,11,2013-02-18 13:06:29,2013-02-18 13:05:42
f1c8b090da2b6eb4f83fe7f8046823ba6eeb6476...5ed6583eeecef8a146c5be172d613794948dcd5d,4,34,21,55,15,2013-03-07 23:03:56,2013-03-07 23:03:56
2dc51055b4aa85496ceb12363f492ad0ad697780...94168faabc8828973d7ba33e33f0dc89bb8faeca,4,46,40,86,20,2014-11-15 22:19:49,2014-11-15 22:19:49
2dc51055b4aa85496ceb12363f492ad0ad697780...b06af6491c362e32c654a8f1ba516fbf46c15c5f,4,37,65,102,12,2014-11-15 17:59:09,2014-11-15 17:59:09
a0ef36d5d58cb9672fa819effb7d5449aef400e7...4d49ef72b38067dbc3f14450a7911e17b60191b2,3,12,12,24,5,2012-09-29 22:52:37,2012-09-29 22:52:37
4d49ef72b38067dbc3f14450a7911e17b60191b2...fb449fca26330097ddbf5e68e409549947b5c7f0,3,12,8,20,5,2012-09-29 22:54:07,2012-09-29 22:54:07
2c019c300c0377fe38bb3b4f262f45c0091f12cf...f4a4d700dc906664606ac15ed676b8c335198ad8,4,53,14,67,6,2013-03-01 22:12:24,2013-03-01 22:12:24
7dbb732a6f0d6e5a3bf2e3bfab1a93563621655e...ed987d06b6306ebedf0f3b5fb6db7401cca1f767,6,12,10,22,7,2013-03-03 18:28:58,2013-03-03 18:28:58
1071c71b888f8ec9dab87417930a14dc84e48403...7a212a5ef12ed9150f9943be79e964f9a0a23c68,1,5,5,10,1,2013-03-07 23:14:58,2013-03-07 23:14:58
7a212a5ef12ed9150f9943be79e964f9a0a23c68...8d3c6d43f66aea4add5ee5c2519321212cb62c47,4,23,23,46,17,2013-03-11 17:57:57,2013-03-11 17:56:20
8d3c6d43f66aea4add5ee5c2519321212cb62c47...28c7b46b5af21dd1ecc65b54fd575a8d9a83a507,10,94,22,116,17,2013-03-11 19:58:00,2013-03-11 19:58:00
28c7b46b5af21dd1ecc65b54fd575a8d9a83a507...09f6c76329928e91ea37ee7f694a45631674f54c,16,859,676,1535,64,2013-03-11 20:43:05,2013-03-11 20:43:05
fcd87f6b34b19720c70dff7e68a61e3695c81dff...b850f113ce9f24368ede9564e83b55fb3a69b55c,8,78,95,173,52,2014-11-16 06:50:27,2014-11-16 06:50:27
b850f113ce9f24368ede9564e83b55fb3a69b55c...080147d5d7a3c505198d521901138e3472607fc1,4,80,27,107,22,2014-11-16 23:28:29,2014-11-16 23:28:29
080147d5d7a3c505198d521901138e3472607fc1...c0e236056e5432f9dff425c2398d571e59c70f6a,3,11,7,18,6,2014-11-17 02:58:58,2014-11-17 02:58:58
c0e236056e5432f9dff425c2398d571e59c70f6a...4229bd8af2f378fbfdb8b66d9b303afcf37b0a85,3,17,18,35,5,2014-11-17 04:39:47,2014-11-17 04:39:47
4229bd8af2f378fbfdb8b66d9b303afcf37b0a85...c989fef67f6a489861f11f0c41a921b285d1f4b2,3,23,9,32,3,2014-11-17 04:46:02,2014-11-17 04:46:02
c989fef67f6a489861f11f0c41a921b285d1f4b2...89ffe0e7f4b23a4ac585248e22b4a65afd8798a0,3,73,66,139,10,2014-11-17 05:58:29,2014-11-17 05:58:29
89ffe0e7f4b23a4ac585248e22b4a65afd8798a0...659e181bf5f31668751cfbfd3266bcdf4ef3d03a,3,19,24,43,9,2014-11-17 06:09:18,2014-11-17 06:09:18
659e181bf5f31668751cfbfd3266bcdf4ef3d03a...d2d87924a980663e0681592e363e11742142b41d,4,48,33,81,24,2014-11-17 07:40:44,2014-11-17 07:40:44
d2d87924a980663e0681592e363e11742142b41d...d28cc3b5dd89efec7c16ee4691687704c34a54d8,3,12,1,13,3,2014-11-17 07:47:12,2014-11-17 07:47:12
d28cc3b5dd89efec7c16ee4691687704c34a54d8...f1db2ea548801a519f0733dab8af429fd02336b4,3,3,3,6,3,2014-11-17 07:49:24,2014-11-17 07:49:24
f1db2ea548801a519f0733dab8af429fd02336b4...56e004942934480f49ba16a3becd01b7b52cae19,3,15,3,18,4,2014-11-17 17:03:43,2014-11-17 17:03:43
56e004942934480f49ba16a3becd01b7b52cae19...947757bb02913ffba013e18db4a96b9962cc56b8,3,28,19,47,11,2014-11-17 19:01:59,2014-11-17 19:01:59
947757bb02913ffba013e18db4a96b9962cc56b8...2aeb26c6439275b259899fb69dc0d8227f382e24,3,11,11,22,8,2014-11-17 19:30:05,2014-11-17 19:30:05
2aeb26c6439275b259899fb69dc0d8227f382e24...363bf42221dd1a61b1505777dec701ad67b4f4bf,3,54,17,71,15,2014-11-17 21:53:33,2014-11-17 21:53:33
363bf42221dd1a61b1505777dec701ad67b4f4bf...fa6634aa503ac44544e73ca46e6c06993fd0cc53,3,34,81,115,21,2014-11-17 21:59:30,2014-11-17 21:59:30
fa6634aa503ac44544e73ca46e6c06993fd0cc53...687b886da9fb06478f78d7d990c5e4781bf5165b,4,13,12,25,11,2014-11-17 23:21:57,2014-11-17 23:21:57
687b886da9fb06478f78d7d990c5e4781bf5165b...8b084819c134383d1abf05f6796b7281e33c74b4,1,1,1,2,1,2014-11-17 23:43:14,2014-11-17 23:43:14
8b084819c134383d1abf05f6796b7281e33c74b4...7d78859a15b06cb72d793e00930d76533d105cff,3,60,37,97,18,2014-11-18 05:48:23,2014-11-18 05:48:23
7d78859a15b06cb72d793e00930d76533d105cff...e2ef1c776f1143e16209baebfcd1c3ee934b7aa6,3,185,93,278,17,2014-11-18 07:02:44,2014-11-18 07:02:44
e2ef1c776f1143e16209baebfcd1c3ee934b7aa6...60b67982aa464b0b2bfb8c598bb04ef4a4f94ce8,3,19,11,30,7,2014-11-19 03:54:55,2014-11-19 03:54:55
60b67982aa464b0b2bfb8c598bb04ef4a4f94ce8...f7887e9477189cd7e9ac03130a691164262dd499,3,102,99,201,11,2014-11-19 05:28:43,2014-11-19 05:28:43
f7887e9477189cd7e9ac03130a691164262dd499...b792bd959df8d474f5ae64a2879dcd687eace72e,3,5,9,14,6,2014-11-19 05:32:10,2014-11-19 05:32:10
b792bd959df8d474f5ae64a2879dcd687eace72e...cc57ddbc1b0e0b3b90c07292ae8d96e15ee6dc9b,3,71,26,97,13,2014-11-19 07:50:51,2014-11-19 07:50:51
cc57ddbc1b0e0b3b90c07292ae8d96e15ee6dc9b...bc83c0f49d5c6ae0493005e8c934646f668f89a0,3,7,15,22,12,2014-11-19 08:04:32,2014-11-19 08:04:32
bc83c0f49d5c6ae0493005e8c934646f668f89a0...13c647b0d9cf0e81cf39df03615b872c1fd8e773,3,58,45,103,30,2014-11-19 17:41:00,2014-11-19 17:41:00
13c647b0d9cf0e81cf39df03615b872c1fd8e773...af3f25f7b97a6a90425af9fd065ee12aa0c1c1b5,4,38,38,76,22,2014-11-19 17:57:21,2014-11-19 17:57:21
af3f25f7b97a6a90425af9fd065ee12aa0c1c1b5...7dedda9e57dbbaf0abfa2e710897fb350a55a7a9,4,15,14,29,13,2014-11-19 18:25:27,2014-11-19 18:25:27
7dedda9e57dbbaf0abfa2e710897fb350a55a7a9...dd3b903095c910e391d21a1ee0bdd4e15fc56ae1,3,18,19,37,12,2014-11-19 18:31:48,2014-11-19 18:31:48
dd3b903095c910e391d21a1ee0bdd4e15fc56ae1...a6cc4cc84e10996ef83385c1b25f4b38129bb427,3,26,35,61,10,2014-11-19 23:19:45,2014-11-19 23:19:45
a6cc4cc84e10996ef83385c1b25f4b38129bb427...c1d78384fd324fb5d3eeda6e9c642616df6b0c82,3,3,3,6,3,2014-11-20 03:30:12,2014-11-20 03:30:12
c1d78384fd324fb5d3eeda6e9c642616df6b0c82...78380cac8aed3a4bc98b90443b38b38d9d02dbae,3,7,5,12,5,2014-11-20 05:38:29,2014-11-20 05:38:29
78380cac8aed3a4bc98b90443b38b38d9d02dbae...57a649965e04d3b68c4bd7abe9929d0b14be5ea2,3,4,4,8,3,2014-11-20 05:39:58,2014-11-20 05:39:58
57a649965e04d3b68c4bd7abe9929d0b14be5ea2...76536082b14c018c5cc56ca6992d689e0c658f2b,3,7,7,14,7,2014-11-20 05:48:07,2014-11-20 05:48:07
76536082b14c018c5cc56ca6992d689e0c658f2b...446e219d8cae621b7249c644b76956dc3d4d2412,3,5,10,15,5,2014-11-20 17:58:14,2014-11-20 17:58:14
446e219d8cae621b7249c644b76956dc3d4d2412...c1a786ed023002946e9733aaf136b7c7eea9caaf,3,31,10,41,14,2014-12-01 19:42:10,2014-12-01 19:42:10
fb449fca26330097ddbf5e68e409549947b5c7f0...95c88ebd06f311cabdb08254dd4465be76bbb2fa,4,154,38,192,18,2012-10-02 01:20:14,2012-10-02 01:20:14
95c88ebd06f311cabdb08254dd4465be76bbb2fa...bdc7c3f9e6e63510ec0d5dc015006eae201a6954,1,99,0,99,1,2012-10-02 03:39:38,2012-10-02 03:39:38
bdc7c3f9e6e63510ec0d5dc015006eae201a6954...d27a70f0c03e36b8347d3320293409e909ab6e9b,9,276,346,622,49,2012-10-02 04:50:18,2012-10-02 04:50:18
d27a70f0c03e36b8347d3320293409e909ab6e9b...8bdfc67f98433266bdef5354d1541b152b2ec77a,2,4,4,8,4,2012-10-02 04:58:19,2012-10-02 04:58:19
8bdfc67f98433266bdef5354d1541b152b2ec77a...c9cffe7a62b9b0ddcd24e0681b83e55df7e34319,6,131,82,213,26,2012-10-02 05:39:17,2012-10-02 05:39:17
c9cffe7a62b9b0ddcd24e0681b83e55df7e34319...14235f4aa61d40c99c997aeb6895510363526e19,3,5,5,10,5,2012-10-02 05:45:14,2012-10-02 05:45:14
f91bf692d625b982aa119cb7b35d7d3a2ee4eb16...a8adbde339ee854a3bf9fa116e0e874f92f06ccb,4,343,426,769,46,2012-10-02 09:38:23,2012-10-01 22:48:51
ed987d06b6306ebedf0f3b5fb6db7401cca1f767...a3bb93a7492df517d870cb24de9296912671e95e,154,154,153,307,154,2013-03-05 17:01:18,2013-03-02 23:09:02
ed987d06b6306ebedf0f3b5fb6db7401cca1f767...c1a02e06f7a8baf2407c2f70a8fbcdabaa322550,4,179,4,183,4,2013-03-04 15:08:38,2013-03-04 15:08:38
c1a02e06f7a8baf2407c2f70a8fbcdabaa322550...a805aec9f4ecae68bdf0f87cb71080dfde77b7ac,3,5,1,6,5,2013-03-04 15:32:33,2013-03-04 15:32:33
a805aec9f4ecae68bdf0f87cb71080dfde77b7ac...4571fb785baf4228bb2043905f5d7ed228cbf92c,3,122,44,166,15,2013-03-04 23:20:44,2013-03-04 23:20:44
ed987d06b6306ebedf0f3b5fb6db7401cca1f767...2cbeb7582235e955d3e89361c1f87065b1899c84,3,14,28,42,7,2013-03-03 22:27:33,2013-03-03 22:13:01
09f6c76329928e91ea37ee7f694a45631674f54c...13e2781206c1fc29b8a3cab4db5e3d8844649462,15,419,402,821,45,2013-03-11 22:33:40,2013-03-11 22:33:40
09f6c76329928e91ea37ee7f694a45631674f54c...759947a2ad4d56efd960cbb01bc216662b71f3f8,4,23,7,30,8,2013-03-11 21:49:54,2013-03-11 21:49:54
fbc15628ede96ca459811495d9774dc849d6e1ff...bdbeec9e58735a9164adb52d59f952237c785dc0,2,5,0,5,5,2014-12-06 21:26:08,2014-12-06 21:26:08
bdbeec9e58735a9164adb52d59f952237c785dc0...97bc2fe356476aed4157bf6e69dd2ac87a838a96,3,26,19,45,3,2014-12-06 21:31:35,2014-12-06 21:31:35
14235f4aa61d40c99c997aeb6895510363526e19...b6d7c5e49e72e638462fecf1c33eee44f31700e7,3,7,12,19,3,2012-10-02 13:19:31,2012-10-02 13:19:31
cdf79a464898ba8a25f85799db5ddf3a57eb9a57...13c91c2e0109e4484e946b6c02843630b0d511f3,4,75,57,132,36,2012-10-02 10:25:35,2012-10-02 10:14:18
13c91c2e0109e4484e946b6c02843630b0d511f3...27749b20330da50b84b9694c737c42295820a116,3,4,17,21,3,2012-10-02 11:41:45,2012-10-02 11:41:45
27749b20330da50b84b9694c737c42295820a116...d413776ce21907b56dfd609ca5f817c6ae0de590,3,17,12,29,5,2012-10-02 11:47:20,2012-10-02 11:47:20
d413776ce21907b56dfd609ca5f817c6ae0de590...fcea0f1f48d70d8b3533663dfd6e577640a76271,4,4,52,56,5,2012-10-02 12:38:46,2012-10-02 12:38:46
a3bb93a7492df517d870cb24de9296912671e95e...16d786c24db4dba6dd71ebfaa43b407b8ce8dfea,1,66,0,66,1,2013-03-07 15:05:51,2013-03-07 15:05:51
16d786c24db4dba6dd71ebfaa43b407b8ce8dfea...a997600163abe281f017f1ca122fe3f06940a7bd,1,366,0,366,1,2013-03-07 15:12:47,2013-03-07 15:12:47
a3bb93a7492df517d870cb24de9296912671e95e...5ef9dcd38a1b19fc606937575b70a71c208e682f,5,104,77,181,46,2013-03-05 17:26:46,2013-03-05 16:59:23
5ef9dcd38a1b19fc606937575b70a71c208e682f...04e4b57e2a785fd0f04702b13453ddbb3b336c6e,4,30,7,37,8,2013-03-05 17:40:00,2013-03-05 17:40:00
6d3f829e4600e0782cd1397eee9664800ed72328...dcd784246e74d2a4f1e882e5af9db7a555bf106c,1,11,11,22,11,2013-03-21 12:56:54,2013-03-21 12:56:54
dcd784246e74d2a4f1e882e5af9db7a555bf106c...f9c1bbb1c0b43aeee6e507dee237786f84b0e6ee,4,4,4,8,4,2013-03-21 21:49:19,2013-03-21 21:49:19
f9c1bbb1c0b43aeee6e507dee237786f84b0e6ee...34059e22c4bf36b5639d0b12d552fc518b90ebc7,13,19,19,38,19,2013-03-21 22:01:51,2013-03-21 22:01:51
34059e22c4bf36b5639d0b12d552fc518b90ebc7...b180995ebecaf75375838e8982bc86d773cf6360,1,0,3,3,1,2013-03-21 22:24:53,2013-03-21 22:24:53
ed81d3db2f5e523aef5f40ccbf6b52f183fa6391...9e24c9dd18c292c0c65b918562fa58c266955ccc,1,5,5,10,1,2013-03-11 22:35:05,2013-03-11 22:35:05
0f9e0c9037d5c5bb4eff49cb26e8f590047b7471...23cfc1f4f29f046797ab21fc37fc838150f672c3,3,22,8,30,7,2014-12-06 21:54:07,2014-12-06 21:54:07
b6d7c5e49e72e638462fecf1c33eee44f31700e7...893e0091a3da7cc6ae9d1a22c9cbe322da4d9c96,3,12,7,19,3,2012-10-02 13:28:19,2012-10-02 13:28:19
8264f44d37beb07db7aeeb214a96c31d1cfc4e38...d06cffada5d12e03b9931791f4d3d74b72541843,2,11,2,13,2,2013-05-16 07:49:00,2013-05-16 07:03:42
d06cffada5d12e03b9931791f4d3d74b72541843...8fe1c1fd963ba9aa545061c01ff591a4bbcb2de8,2,2,11,13,2,2013-05-18 10:30:20,2013-05-18 10:30:20
8264f44d37beb07db7aeeb214a96c31d1cfc4e38...5212a56ccd787a64fcf7e47de9de4bb3693a0911,3,3,3,6,3,2013-03-16 22:23:26,2013-03-16 22:23:26
51228ccc4b54789f2d92d268e94716d1c016c774...3de9ef311eb837cfea4a64f5a159725f6c7fb581,3,11,16,27,7,2013-03-21 23:41:40,2013-03-21 23:41:40
9e24c9dd18c292c0c65b918562fa58c266955ccc...63a95a390a5825962efac583de3319174206f823,1,2,2,4,2,2013-03-11 22:55:29,2013-03-11 22:55:29
737a9913063ba3d0156555d63e69147284506825...bb52d627cd36a4f479b0f69b0d5f1606cc599b1b,3,6,6,12,4,2014-12-08 17:44:25,2014-12-08 17:44:25
bb52d627cd36a4f479b0f69b0d5f1606cc599b1b...d316211810fd9034d3f0243de0ce1310ba102fb0,8,179,94,273,40,2014-12-08 18:39:53,2014-12-08 18:29:02
b681740fad234030674c2452133eec02b05f4664...33d74d045964fdf17147645eb42c19fe25da6260,3,9,10,19,3,2012-10-02 14:56:56,2012-10-02 14:53:29
33d74d045964fdf17147645eb42c19fe25da6260...ecb9683e6093f4026c8bf3eaeb6db2034087806b,3,10,9,19,3,2012-10-02 16:49:36,2012-10-02 16:49:09
ecb9683e6093f4026c8bf3eaeb6db2034087806b...61bee74f23765977dfb74c6c132be4cff48cb832,3,8,4,12,4,2012-10-02 17:52:53,2012-10-02 17:52:53
61bee74f23765977dfb74c6c132be4cff48cb832...110f7dbe53e03b72b64194eda69e864d9652ae00,3,6,6,12,5,2012-10-02 19:15:09,2012-10-02 19:12:38
110f7dbe53e03b72b64194eda69e864d9652ae00...d2d4d6292ec211807bd84fd52cf3ca8c7015c6b5,3,16,13,29,9,2012-10-02 22:58:37,2012-10-02 22:58:37
d2d4d6292ec211807bd84fd52cf3ca8c7015c6b5...768685693ee2f70090b3433eed5b60ab55df4e8b,3,5,5,10,3,2012-10-03 08:23:48,2012-10-03 08:23:48
b9e35eb5ff2bba840c4ff46abd2fde20b6b4ee49...b6bc8c9ee9e2a1b2dd8a4ce35c49aa76b796d533,6,8,6,14,7,2013-03-21 23:52:26,2013-03-21 23:52:26
b6bc8c9ee9e2a1b2dd8a4ce35c49aa76b796d533...bcf70c96c93858710c5218b931f82b3edd988181,1,30,0,30,2,2013-03-22 00:01:16,2013-03-21 23:59:50
bcf70c96c93858710c5218b931f82b3edd988181...91d35b4205d4ef150c61c415b7379404bced7267,7,71,13,84,12,2013-03-22 22:38:56,2013-03-22 22:38:56
a82fa305bcd66449b118624143400e56837dc8cd...d0441e61705fafc3b0e264f59c7b9598a277aa3e,8,57,28,85,20,2013-03-12 01:06:05,2013-03-12 01:01:35
d0441e61705fafc3b0e264f59c7b9598a277aa3e...86e8f88c3fa33ff6862a030283bb2a70217cc5a5,6,1354,1377,2731,52,2013-03-13 04:01:49,2013-03-13 04:01:49
86e8f88c3fa33ff6862a030283bb2a70217cc5a5...48e449ba941d7d8072c830a25c0aa75c2cdc7a68,9,25,9,34,11,2013-03-13 04:31:15,2013-03-13 04:31:15
48e449ba941d7d8072c830a25c0aa75c2cdc7a68...83d72a21e3b882029dd91eecd6aafcaf6e23381f,53,514,376,890,88,2013-03-13 05:01:56,2013-03-13 05:01:56
83d72a21e3b882029dd91eecd6aafcaf6e23381f...d7394ecd9781509e7193f3057bb9eaf406520ef9,47,1144,1024,2168,134,2013-03-13 05:26:15,2013-03-13 05:26:15
d7394ecd9781509e7193f3057bb9eaf406520ef9...0682c18070b9467c106896949a9b08fc92547179,48,193,98,291,65,2013-03-13 06:57:44,2013-03-13 06:57:44
0682c18070b9467c106896949a9b08fc92547179...05e491629becca0597d10ebf0d6fe68214d0474e,202,7776,7542,15318,794,2013-03-13 08:56:00,2013-03-13 08:56:00
05e491629becca0597d10ebf0d6fe68214d0474e...d392331412b2207462d89d0a9c37e0cd48f9d9ec,3,3,3,6,3,2013-03-13 08:59:36,2013-03-13 08:59:36
d392331412b2207462d89d0a9c37e0cd48f9d9ec...ada94766f33346790398823f90d78140ce827667,1,2,6,8,1,2013-03-13 09:01:49,2013-03-13 09:01:49
ada94766f33346790398823f90d78140ce827667...ecd77dc8d4ede67caa575f9d2f1c89133cafc9c0,3,0,97,97,3,2013-03-13 09:03:00,2013-03-13 09:03:00
ecd77dc8d4ede67caa575f9d2f1c89133cafc9c0...58dc604177aecd05c6a3439b11dab4904df3d858,90,0,0,0,0,2013-03-13 09:08:02,2013-03-13 09:08:02
58dc604177aecd05c6a3439b11dab4904df3d858...9d1925012dfa66d4e7249b6f75293d7fac8497f0,6,96,11,107,10,2013-03-13 12:15:17,2013-03-12 18:55:39
9d1925012dfa66d4e7249b6f75293d7fac8497f0...6b04c1f76fdebf0370a4ac5b8d4a5a7b3614ff36,3,7,7,14,3,2013-03-13 15:53:00,2013-03-13 15:53:00
8a0fe7f2d206c817c1ecb61b64dc6d6ac3573fbe...e4ff1138077d3458c7fbfd7efebef79a41c3ba7a,3,32,5,37,3,2014-12-08 19:57:19,2014-12-08 19:55:47
e4ff1138077d3458c7fbfd7efebef79a41c3ba7a...ee0e2d7ad6bc3ff3eaf7e07fdd14e1b305895084,3,8,8,16,4,2014-12-09 17:39:27,2014-12-09 17:39:27
768685693ee2f70090b3433eed5b60ab55df4e8b...10fa451d8c34c0a19b2df09be9bc919200c91aa7,3,82,20,102,24,2012-10-03 20:52:27,2012-10-03 20:49:50
61069acf4a8c7ba57d411d8be260791f9d91f3ad...f1fd63f094b05b420ed03596960a63366a7d27d5,3,9,8,17,3,2013-05-18 17:22:46,2013-05-18 17:22:46
f1fd63f094b05b420ed03596960a63366a7d27d5...73702d335e81147a3c1d3215093324270f24baa3,7,22,19,41,10,2013-05-18 17:58:44,2013-05-18 17:58:44
73702d335e81147a3c1d3215093324270f24baa3...b54a8c997c203a51eb3b85634044771ea8362ffc,1,1,1,2,1,2013-05-18 17:59:26,2013-05-18 17:59:26
91d35b4205d4ef150c61c415b7379404bced7267...f598ed5bcd829590a1b619b2a56b87d43c792a96,3,5,5,10,3,2013-03-24 23:44:28,2013-03-24 23:44:28
6b04c1f76fdebf0370a4ac5b8d4a5a7b3614ff36...29d60556d5bf2325e242049b43997dd6962456b3,1,1,1,2,1,2013-03-13 17:47:58,2013-03-13 17:47:58
6b04c1f76fdebf0370a4ac5b8d4a5a7b3614ff36...d93f45ee82b2274cfbdcdfae81ef4e423e6053b8,6,188,47,235,34,2013-03-13 17:47:52,2013-03-13 17:26:15
4a4c3cea1a50ee24e2be1e5a0fd2d350e38c4735...4e4709ce47d5c9406290dc2a467cef08002fc9b7,8,53,22,75,11,2014-12-30 17:03:54,2014-12-30 17:02:12
4a4c3cea1a50ee24e2be1e5a0fd2d350e38c4735...207bde3307778c813d4cd979366139b27680a513,1,99,127,226,9,2014-12-23 18:35:56,2014-12-23 18:35:56
207bde3307778c813d4cd979366139b27680a513...85590cac8ad0883a58ec4d7fcd3c0ea80905e09c,4,168,148,316,22,2014-12-23 19:07:12,2014-12-23 19:07:12
85590cac8ad0883a58ec4d7fcd3c0ea80905e09c...5d785968cd7c82f5bca172753de0468a19fd2fb8,7,434,439,873,69,2014-12-23 19:23:20,2014-12-23 19:23:20
5d785968cd7c82f5bca172753de0468a19fd2fb8...9b6c1f566fb09fab434dde1f58d193f30277c924,3,78,16,94,6,2014-12-23 19:51:06,2014-12-23 19:51:06
4a4c3cea1a50ee24e2be1e5a0fd2d350e38c4735...2c852adb420b77b430f51aee1cbccfc1c9f3b408,3,27,12,39,6,2014-12-22 22:17:18,2014-12-22 22:17:18
4a4c3cea1a50ee24e2be1e5a0fd2d350e38c4735...0169236b406238d4215e9fb1a6d61726647e98b4,1,16,0,16,1,2014-12-11 10:29:38,2014-12-11 10:29:38
4a4c3cea1a50ee24e2be1e5a0fd2d350e38c4735...24fb691f0a568a1f6cb42063e7a794665fe8cadf,1,0,3,3,1,2014-12-09 23:17:44,2014-12-09 23:17:44
3b527ffb1e5700e296977724b728b6632027baaa...427c02c3a8ac866770c850b0d63f3b66c84f7eff,3,19,10,29,6,2012-10-04 10:15:28,2012-10-04 09:49:15
e1bbecde2c58888c91ddd0a453c1e0467692467e...f2cce5f57d98186a1563a99a3132bda470c7bc2c,1,21,0,21,1,2013-03-25 08:51:16,2013-03-25 08:51:16
f2cce5f57d98186a1563a99a3132bda470c7bc2c...18105839c59c24cf52caaad58ec304b0a9cc0df0,1,3,0,3,2,2013-03-25 10:29:37,2013-03-25 10:29:37
61a1651d182a978805d330ce02a74c6dd59bf65d...840c112b3cbdea43e5b1925b7d171208e1465b23,8,28,28,56,9,2013-03-13 18:46:32,2013-03-13 18:46:32
840c112b3cbdea43e5b1925b7d171208e1465b23...e64b622063c7fa5255365902c033dc70caecc569,1,1,1,2,1,2013-03-13 18:50:05,2013-03-13 18:50:05
e64b622063c7fa5255365902c033dc70caecc569...a2a914382699c11992db9b0a6d084e359430d82b,6,56,58,114,7,2013-03-13 20:06:33,2013-03-13 20:06:33
a2a914382699c11992db9b0a6d084e359430d82b...fd5ee5de64338f55e95cacddd80a8c86633be526,42,103,102,205,21,2013-03-13 20:13:09,2013-03-13 20:13:09
fd5ee5de64338f55e95cacddd80a8c86633be526...5c4282f51a264b158d347479a1c5bad366d7e1cd,16,52,50,102,18,2013-03-13 20:58:41,2013-03-13 20:58:41
5c4282f51a264b158d347479a1c5bad366d7e1cd...fe0d6f3ea6e74770fde379481496e904c5b2c9ec,24,831,877,1708,204,2013-03-14 02:10:53,2013-03-14 02:10:53
fe0d6f3ea6e74770fde379481496e904c5b2c9ec...04fe8f8e4b70c3bc8a1161ec7274e2c745671f29,4,180,192,372,78,2013-03-14 02:13:38,2013-03-14 02:13:38
04fe8f8e4b70c3bc8a1161ec7274e2c745671f29...3442685b36740b99c3ad03a74a330bf060f65b0f,4,69,83,152,26,2013-03-14 02:16:59,2013-03-14 02:16:59
3442685b36740b99c3ad03a74a330bf060f65b0f...608902c90779f2d3e53dce105c09f5da53e1461a,88,3603,3511,7114,937,2013-03-14 06:21:23,2013-03-14 06:21:23
608902c90779f2d3e53dce105c09f5da53e1461a...fd1b42ca37eeec87ca37c1b389c5bed2f4f70e1e,1,1,1,2,1,2013-03-14 06:32:17,2013-03-14 06:32:17
fd1b42ca37eeec87ca37c1b389c5bed2f4f70e1e...5627ecdb9a357d0182ade3ec0816dd0393470441,1,8,1,9,4,2013-03-14 15:16:52,2013-03-14 15:16:52
5627ecdb9a357d0182ade3ec0816dd0393470441...e65d455ac64b83253c4da6beeb3cc948472ed2a4,1,10,9,19,8,2013-03-14 15:42:29,2013-03-14 15:42:29
e65d455ac64b83253c4da6beeb3cc948472ed2a4...0f2b61ae939c0783c16a828930b0b4633215d33b,10,44,56,100,32,2013-03-14 15:46:45,2013-03-14 15:46:45
0f2b61ae939c0783c16a828930b0b4633215d33b...f37405d1b83b89e17d2b8e89f741787471d4907e,21,767,763,1530,200,2013-03-14 16:00:13,2013-03-14 16:00:13
f37405d1b83b89e17d2b8e89f741787471d4907e...97f034a44dfcb66162f8e02b034b8a5ad0d3fb7f,4,180,176,356,74,2013-03-14 16:06:31,2013-03-14 16:06:31
97f034a44dfcb66162f8e02b034b8a5ad0d3fb7f...2831f6c7c4dae8fcddbfaad7e7db9c22282fe854,4,52,46,98,28,2013-03-14 16:09:50,2013-03-14 16:09:50
2831f6c7c4dae8fcddbfaad7e7db9c22282fe854...8e9db961f9ed56fd90d258ee414f849e5e51667a,2,46,57,103,22,2013-03-14 16:16:05,2013-03-14 16:16:05
8e9db961f9ed56fd90d258ee414f849e5e51667a...af25181df804d5ead583b77564714ce91241eff5,2,45,48,93,24,2013-03-14 16:17:39,2013-03-14 16:17:39
af25181df804d5ead583b77564714ce91241eff5...ae9d4a402a7cb097f20cac7ca2d0c6b57a33d8ee,4,388,388,776,35,2013-03-14 16:19:27,2013-03-14 16:19:27
ae9d4a402a7cb097f20cac7ca2d0c6b57a33d8ee...480bfb6c51674281ad6887c81380015c8912f421,26,537,605,1142,267,2013-03-14 16:41:29,2013-03-14 16:41:29
480bfb6c51674281ad6887c81380015c8912f421...1ff5f504a99c8d834a4db4f1b3eca4e2cedeb773,3,72,71,143,40,2013-03-14 16:43:53,2013-03-14 16:43:53
1ff5f504a99c8d834a4db4f1b3eca4e2cedeb773...697db5217a532596c91cebee11a632624536b8fc,25,1004,877,1881,86,2013-03-14 17:18:11,2013-03-14 17:18:11
697db5217a532596c91cebee11a632624536b8fc...dd971666a60f0018786f9c278dc0042ed724df00,46,2716,2392,5108,73,2013-03-14 17:25:23,2013-03-14 17:03:10
dd971666a60f0018786f9c278dc0042ed724df00...a6fa0c4f6b82e75fa8660867f749e6627c271b3b,10,192,195,387,83,2013-03-14 17:35:04,2013-03-14 17:34:50
a6fa0c4f6b82e75fa8660867f749e6627c271b3b...e1842fccacc19972bc36f3048aca36597f3dd819,14,197,203,400,114,2013-03-14 17:52:01,2013-03-14 17:52:01
e1842fccacc19972bc36f3048aca36597f3dd819...36c59cd2338ff29bbe18383fa58cef2fe859718b,1,18,8,26,2,2013-03-14 17:58:17,2013-03-14 17:58:17
36c59cd2338ff29bbe18383fa58cef2fe859718b...4c3469d3361a3f60f63198be490f5eefedbc46d7,26,523,740,1263,328,2013-03-14 19:36:21,2013-03-14 19:36:21
4c3469d3361a3f60f63198be490f5eefedbc46d7...ecbf93d922ae168ca915cc463ab859d457245333,21,188,270,458,116,2013-03-14 19:58:16,2013-03-14 19:58:16
ecbf93d922ae168ca915cc463ab859d457245333...68be0ac8c83ae3c9a5295c1db9651e33ccc7b714,170,170,174,344,169,2013-03-14 20:00:04,2013-03-14 19:59:54
68be0ac8c83ae3c9a5295c1db9651e33ccc7b714...bd09d37e6c96c95c81bff908df4b7725f32e1237,25,606,630,1236,82,2013-03-14 20:29:24,2013-03-14 20:29:24
bd09d37e6c96c95c81bff908df4b7725f32e1237...a4fed02b8c5bfcadbc4ec83c61b94845e0650cfe,21,114,132,246,64,2013-03-14 20:59:18,2013-03-14 20:59:18
a4fed02b8c5bfcadbc4ec83c61b94845e0650cfe...05e9f190e3c73dbe8d7b091b314244091575bdb0,5,22,14,36,7,2013-03-14 21:11:40,2013-03-14 21:11:40
05e9f190e3c73dbe8d7b091b314244091575bdb0...7fac83395f1bed28bab972f74ac601aaacea6cee,2,125,125,250,6,2013-03-14 21:12:47,2013-03-14 21:12:47
7fac83395f1bed28bab972f74ac601aaacea6cee...1ac0fa09a96e252ee1f0def5018b7c0f3e6686c4,1,2,0,2,1,2013-03-14 21:28:25,2013-03-14 21:28:25
1ac0fa09a96e252ee1f0def5018b7c0f3e6686c4...133011f60838deac7130759c8d73c06c5816b4e2,3,3,3,6,3,2013-03-14 21:32:13,2013-03-14 21:32:13
133011f60838deac7130759c8d73c06c5816b4e2...7306ad091a84ae885dc5f235de307f42b530e739,3,17,5,22,5,2013-03-14 21:35:33,2013-03-14 11:44:45
7306ad091a84ae885dc5f235de307f42b530e739...2b3abf606fce4a876337fd74bc1d6526fa9ad48c,1,5,5,10,1,2013-03-14 21:49:08,2013-03-14 21:49:08
2b3abf606fce4a876337fd74bc1d6526fa9ad48c...0d7c6c55e71d43f9d8286bfdd9ffd5372c51411b,31,193,192,385,169,2013-03-14 22:14:12,2013-03-14 22:14:12
0d7c6c55e71d43f9d8286bfdd9ffd5372c51411b...232f05024a1d6987a3fa42674e02866f51bbecac,5,5,5,10,5,2013-03-14 22:30:24,2013-03-14 22:30:24
232f05024a1d6987a3fa42674e02866f51bbecac...d476dffdef59b35f259b6e9f63c531ea0616e557,2,3,3,6,3,2013-03-14 22:43:18,2013-03-14 22:43:18
d476dffdef59b35f259b6e9f63c531ea0616e557...d081b0d25561ee38e666d56c5aa4142245e17f68,3,4,4,8,3,2013-03-15 15:01:47,2013-03-15 15:01:47
d081b0d25561ee38e666d56c5aa4142245e17f68...ba7bbe61df6ce5d858c781eeac294fd785d2daee,4,10,12,22,6,2013-03-15 15:27:24,2013-03-15 15:27:24
ba7bbe61df6ce5d858c781eeac294fd785d2daee...537e9e234aa57612e67ac10f3fa092f740cda3de,1,60,0,60,1,2013-03-15 16:55:53,2013-03-15 16:55:53
537e9e234aa57612e67ac10f3fa092f740cda3de...78a30bae0a278e9cb9d766b3dcc590470f3c044d,3,58,56,114,4,2013-03-15 17:09:55,2013-03-15 17:09:55
78a30bae0a278e9cb9d766b3dcc590470f3c044d...fa6ef52de9bb05a095cbc9804d45a88f8b6bb0a6,6,99,19,118,19,2013-03-15 23:33:21,2013-03-15 23:30:20
fa6ef52de9bb05a095cbc9804d45a88f8b6bb0a6...c696b8c846b419250867548facabd4485b7a1a9b,1,3,1,4,1,2013-03-16 00:15:07,2013-03-16 00:15:07
c696b8c846b419250867548facabd4485b7a1a9b...627b55189ef1f90bfa15ebc4f7f2cee418fb80de,4,36,18,54,12,2013-03-16 00:15:20,2013-03-16 00:15:20
627b55189ef1f90bfa15ebc4f7f2cee418fb80de...d8903ef00ba263065eb847616fb8dca1644b7661,3,10,8,18,6,2013-03-16 00:18:26,2013-03-16 00:18:26
d8903ef00ba263065eb847616fb8dca1644b7661...fa514dd08c9a6ac11e177da6051a76efe291d5ea,3,8,5,13,4,2013-03-16 15:49:48,2013-03-16 15:49:48
fa514dd08c9a6ac11e177da6051a76efe291d5ea...f054723dfcba89be8ee472d3563490b771c3cb1f,2,4,1,5,2,2013-03-16 19:44:34,2013-03-16 19:44:34
f054723dfcba89be8ee472d3563490b771c3cb1f...6d62cc20604887e176e72ca41a9187642f8204f6,1,4,4,8,4,2013-03-19 10:54:40,2013-03-19 10:54:40
6d62cc20604887e176e72ca41a9187642f8204f6...788f8cd958be570758578f81c41cc18aad9615dc,7,2546,2560,5106,232,2013-03-19 11:35:49,2013-03-19 10:33:56
788f8cd958be570758578f81c41cc18aad9615dc...7c7366155f66c57af64afeca62e8da2495f546ec,4,280,180,460,41,2013-03-19 11:35:51,2013-03-19 10:53:08
7c7366155f66c57af64afeca62e8da2495f546ec...7643e227143971aef66db35252bdfc34aa95e3ad,4,19,7,26,7,2013-03-19 15:11:03,2013-03-19 15:10:29
7643e227143971aef66db35252bdfc34aa95e3ad...8fb6d1d17e71936bbe59fdcdf323804ce1b22c3d,3,37,37,74,21,2013-03-19 15:17:00,2013-03-19 15:17:00
8fb6d1d17e71936bbe59fdcdf323804ce1b22c3d...0509426a245564774bbad0fc94398254e239db72,1,6,6,12,6,2013-03-19 15:19:29,2013-03-19 15:19:29
0509426a245564774bbad0fc94398254e239db72...90d7762b36df2ed726ac856d0d14dfbbb4a60fff,1,2,2,4,1,2013-03-19 15:21:06,2013-03-19 15:21:06
90d7762b36df2ed726ac856d0d14dfbbb4a60fff...49de139846b09edca7c15dcb0d13e5d5ae267655,1,5,3,8,3,2013-03-19 15:26:02,2013-03-19 15:26:02
49de139846b09edca7c15dcb0d13e5d5ae267655...510e0de769e1f68b25200a8273e4fd8c87c7d9b5,1,9,7,16,4,2013-03-19 15:30:37,2013-03-19 15:30:37
510e0de769e1f68b25200a8273e4fd8c87c7d9b5...ccfeadcf3c166c82f329dcf857577dcd15668f06,1,22,20,42,11,2013-03-19 15:44:00,2013-03-19 15:44:00
ccfeadcf3c166c82f329dcf857577dcd15668f06...d7fceea3432ad9e69cd5506c6f401896223b8630,1,3,1,4,1,2013-03-19 15:50:07,2013-03-19 15:50:07
d7fceea3432ad9e69cd5506c6f401896223b8630...184c0ffea90401ecb4fb7b12f4caf437659bdbe3,1,3,3,6,2,2013-03-19 15:53:53,2013-03-19 15:53:53
184c0ffea90401ecb4fb7b12f4caf437659bdbe3...68b17eeaadda74b89c8e9e637790e3e29984b7ac,1,1,2,3,1,2013-03-19 15:54:57,2013-03-19 15:54:57
68b17eeaadda74b89c8e9e637790e3e29984b7ac...2f1c62deeada9ff10102d3d250a8f15bf4a90b7a,3,48,46,94,22,2013-03-19 15:56:56,2013-03-19 15:56:24
2f1c62deeada9ff10102d3d250a8f15bf4a90b7a...112ec6fac86d9a506a463f3d6c4e70f6d0fd9646,4,24,19,43,14,2013-03-19 16:02:09,2013-03-19 16:02:09
112ec6fac86d9a506a463f3d6c4e70f6d0fd9646...15ec3e8d90277120e7ae429878c2fcdbbef9f77c,4,33,32,65,21,2013-03-19 16:13:11,2013-03-19 16:13:11
15ec3e8d90277120e7ae429878c2fcdbbef9f77c...88ef15719fe23f46083eb5697255f9ab0022080a,3,8,6,14,5,2013-03-19 16:15:09,2013-03-19 16:14:43
88ef15719fe23f46083eb5697255f9ab0022080a...90498e0e49e79ab9842b3da2b8113e3a456610d4,3,40,26,66,8,2013-03-19 16:25:28,2013-03-19 16:25:28
90498e0e49e79ab9842b3da2b8113e3a456610d4...1ce0475344e02e1ff0b10ae2e05c9b31b161c25c,3,14,15,29,9,2013-03-19 16:30:45,2013-03-19 16:30:45
1ce0475344e02e1ff0b10ae2e05c9b31b161c25c...c4caa95b20768ebf79131afec4a51a81fecc4fcd,3,60,46,106,10,2013-03-19 16:39:39,2013-03-19 16:39:39
c4caa95b20768ebf79131afec4a51a81fecc4fcd...cf5615518957fa8bff9b5f64daf8bcf45fd91dfe,3,4,4,8,5,2013-03-19 16:43:05,2013-03-19 16:43:05
cf5615518957fa8bff9b5f64daf8bcf45fd91dfe...fd40dc2774edfbd6565137f76985f01591cef25f,4,305,199,504,20,2013-03-19 17:19:21,2013-03-19 17:19:21
fd40dc2774edfbd6565137f76985f01591cef25f...8b2975dbefad216cc9c647a96ec08608dc109f36,2,2,2,4,2,2013-03-20 09:12:09,2013-03-20 09:12:09
4e4709ce47d5c9406290dc2a467cef08002fc9b7...4c6b47ff932ddd5a0d3e72c8105e4b2826dc8b1b,1,16,0,16,1,2015-01-14 08:12:48,2015-01-14 08:12:48
4c6b47ff932ddd5a0d3e72c8105e4b2826dc8b1b...c258e05f9853ca089a8843623a7edf792e64ceb9,1,4,4,8,1,2015-01-15 10:10:52,2015-01-15 10:10:52
4e4709ce47d5c9406290dc2a467cef08002fc9b7...ca0b7cb5e893618b62f8708080fd3e490bfe3865,1,3,1,4,2,2015-01-13 00:18:09,2015-01-13 00:17:08
4e4709ce47d5c9406290dc2a467cef08002fc9b7...743276d0c23e798eacf9535bfba76e5e6b93a83c,4,12,4,16,4,2014-12-31 00:05:29,2014-12-31 00:05:29
ffc1fe9494ff1eb251f405e78e6546b3017651fa...5040473a9fd9c9b19abe5d6a638f08dcce3d90df,3,6,6,12,3,2015-02-07 20:00:21,2015-02-07 19:58:56
c4deefbeaa3a8f3482ddd9b2f06a4af1df1122d7...d58bbdd6eac75d33fec7aa07422fed151e97bfb7,4,19,4,23,5,2012-10-05 23:03:53,2012-10-05 23:02:12
d58bbdd6eac75d33fec7aa07422fed151e97bfb7...78815b6783afe3b6c6970b1c555722ea4964dce1,4,190,60,250,7,2012-10-05 23:54:21,2012-10-05 23:54:21
78815b6783afe3b6c6970b1c555722ea4964dce1...d10868bb69b40fa964599833f68c10ad8d92a7c2,4,29,28,57,8,2012-10-06 00:05:41,2012-10-06 00:05:41
18105839c59c24cf52caaad58ec304b0a9cc0df0...636412927fcfa61ccff81f632e20986779889066,1,1,0,1,1,2013-04-02 16:00:45,2013-04-02 16:00:45
18105839c59c24cf52caaad58ec304b0a9cc0df0...a829aa260cbde73dc3d749a7290d3d7551fe6a0e,4,47,6,53,8,2013-04-02 14:58:44,2013-04-02 14:58:44
a829aa260cbde73dc3d749a7290d3d7551fe6a0e...f676389b9867b88c976d9c41cd1291a0750801a7,4,28,25,53,9,2013-04-02 16:16:50,2013-04-02 16:16:50
f676389b9867b88c976d9c41cd1291a0750801a7...c9844a6ca420f58100287b2927a5a6cdbd9044ed,3,4,13,17,3,2013-04-02 17:21:29,2013-04-02 17:21:29
18105839c59c24cf52caaad58ec304b0a9cc0df0...359546c80c2a07edd8b526b2956091eb35119767,10,150,57,207,25,2013-03-31 16:46:07,2013-03-31 16:46:07
359546c80c2a07edd8b526b2956091eb35119767...6c0c0c2bf48011ab55358bc9bed34bab0ef5c43c,5,53,53,106,24,2013-03-31 16:48:10,2013-03-31 16:48:10
18105839c59c24cf52caaad58ec304b0a9cc0df0...636c3dbb6a66fc48d387a56f756e67ca5d81a2b7,3,18,13,31,4,2013-03-30 00:23:57,2013-03-30 00:23:57
18105839c59c24cf52caaad58ec304b0a9cc0df0...608ef120e0e25b4abddd0ce30f388a425d8ae027,1,7,1,8,1,2013-03-27 06:49:52,2013-03-27 06:45:50
18105839c59c24cf52caaad58ec304b0a9cc0df0...2f82165d5ffcee2f2701967ba707b76f693a004e,2,17,0,17,3,2013-03-26 19:50:54,2013-03-26 19:50:54
2f82165d5ffcee2f2701967ba707b76f693a004e...0500aaea43c7fbe55a6ad0532b1c27642229cc74,2,3,3,6,3,2013-03-26 20:01:05,2013-03-26 20:01:05
0500aaea43c7fbe55a6ad0532b1c27642229cc74...fdf5f937979e1f5ebe54ebf5cd9f95dba16d509d,2,4,4,8,3,2013-03-26 22:11:06,2013-03-26 22:11:06
ca0b7cb5e893618b62f8708080fd3e490bfe3865...9c3df31216aa28d8252b216b558cbb5907480b5b,22,261,201,462,78,2015-02-07 06:41:51,2015-02-07 06:30:25
9c3df31216aa28d8252b216b558cbb5907480b5b...b1da610dbf4ccf06008ddef6a48516f06d92b825,3,7,7,14,3,2015-02-07 13:47:33,2015-02-07 13:47:33
b1da610dbf4ccf06008ddef6a48516f06d92b825...73c3d8cfcbab4331350c1805f774edb21572a114,3,3,3,6,3,2015-02-07 16:10:12,2015-02-07 16:08:10
73c3d8cfcbab4331350c1805f774edb21572a114...2b9b4513691d83879868acc929569e20d0b8fc7e,1,1,1,2,1,2015-02-07 16:13:36,2015-02-07 16:13:36
ca0b7cb5e893618b62f8708080fd3e490bfe3865...f10946b90e1fc245a5a7cbdb2b08214fc58e40c9,5,15,1,16,5,2015-02-06 00:16:33,2015-02-06 00:16:33
f10946b90e1fc245a5a7cbdb2b08214fc58e40c9...82a0f01137eda0838678a66879259adaef7bcc19,2,8,6,14,2,2015-02-06 00:17:20,2015-02-06 00:17:20
ca0b7cb5e893618b62f8708080fd3e490bfe3865...a8734737f482a9491d87930726104f0e7a4e8950,1,1,1,2,1,2015-02-05 16:34:11,2015-02-05 16:34:11
ca0b7cb5e893618b62f8708080fd3e490bfe3865...64383b786e13b6217ef3563fabcbae0a882cc4a5,3,7,5,12,3,2015-01-28 12:18:38,2015-01-28 12:18:38
aa8605bf578c7f909f69d7fcc29a2bc20aaaaa9b...1fad2e0cf7fba217eba0eadf3cae17c15090f1dd,5,5,15,20,6,2015-02-08 02:48:24,2015-02-08 02:48:24
37a9152b35a6186afeec0cd6221a93c2cc59283f...bec7098a662060b37a3cbb40a2b94a46b4e16671,2,6,2,8,2,2013-04-03 17:41:46,2013-04-03 14:29:14
37a9152b35a6186afeec0cd6221a93c2cc59283f...87dd8a5dfadea35dc14d86abccbec2ee143746f5,2,12,0,12,2,2013-04-03 04:51:29,2013-04-02 16:02:09
45c3b4bc7bbed63cf10a7e77509ceb887566c737...80a1dd6f879a2577dd812a85a76c1bb5c6e7f3e2,5,22,30,52,10,2013-04-07 02:27:55,2013-04-07 02:27:55
8a415b439fcedc69f4f9a2b3169dc4568a95840d...ea284ebf6027b8ed038858fce2694c7af46130c0,1,7,1,8,1,2013-04-03 17:54:52,2013-04-03 17:54:52
de0429f12e2b0aada4048bf1828f34f3c492e4dd...4b6bd05a3256adae42b4e0ed68839ff9f317ba1a,1,3,0,3,1,2015-02-07 16:21:51,2015-02-07 16:21:51
36fd5340cbc90fcb24c053df8976ed266ee3aae9...d971d1fa3323a24556488a6caa6a7a3d05253a4a,3,5,5,10,4,2015-02-07 16:33:21,2015-02-07 16:33:21
08026fb632acd236fe56165efa5a3b0a90c911d8...11ba3b0c4f8b39b148977094b4f2e8af78edd8b1,5,28,47,75,7,2015-01-31 13:42:16,2015-01-31 13:42:16
11ba3b0c4f8b39b148977094b4f2e8af78edd8b1...ac40a67d3202d4354cec305c971ecd483056433c,1,1,1,2,1,2015-01-31 14:15:45,2015-01-31 14:15:45
ac40a67d3202d4354cec305c971ecd483056433c...20aa5321a170d34373ba21d03f167c644223acec,3,1,3,4,3,2015-01-31 14:16:52,2015-01-31 14:16:52
20aa5321a170d34373ba21d03f167c644223acec...31c6997e08530cf04383b3b02dd090111cd6413e,1,13,0,13,1,2015-01-31 14:47:32,2015-01-31 14:47:32
7edaa2a2437168266cf5525bc00ed204b27c71f2...e3e8138e193ddd56d3873edb31d84f128427b503,1,1,1,2,1,2015-02-08 18:20:33,2015-02-08 18:20:33
e3e8138e193ddd56d3873edb31d84f128427b503...bc3571f77f29a22023f895967821cd1aae98ad20,1,5,0,5,1,2015-02-08 18:27:47,2015-02-08 18:27:47
bc3571f77f29a22023f895967821cd1aae98ad20...dcdcd6b7b8cee6f86320790aa05cc52bf87cee62,1,1,1,2,1,2015-02-08 19:29:21,2015-02-08 19:29:21
dcdcd6b7b8cee6f86320790aa05cc52bf87cee62...df3fbeaa5660be7ed560b8dc9e359d3a3918b774,1,1,1,2,1,2015-02-08 19:29:34,2015-02-08 19:29:34
df3fbeaa5660be7ed560b8dc9e359d3a3918b774...a40a611d6b9fc4ff3815ca830d86b6c00d130995,12,95,14,109,17,2015-02-10 16:33:30,2015-02-10 16:33:30
a40a611d6b9fc4ff3815ca830d86b6c00d130995...14233b140f1e1e8b6319edb7b0cbe7a55f01e4f1,1,5,1,6,2,2015-02-10 16:36:27,2015-02-10 16:36:27
14233b140f1e1e8b6319edb7b0cbe7a55f01e4f1...0aa17c772b4d30231312b91b4f5b8d4230379b16,1,1,1,2,1,2015-02-10 16:41:56,2015-02-10 16:41:56
d729f7c968d346c239f67683ef396d8631199d25...144a2e9cbffd26ec21ea856b0a561b9e47f14b1d,3,7,5,12,3,2013-04-03 17:46:15,2013-04-03 17:46:15
43d09afd1ac78f0776eb6bbdc78e3fd1278d567f...32e77ed975d4813449dead05cf9bd285389a79c2,2,2,2,4,2,2013-04-11 15:10:08,2013-04-11 14:20:30
32e77ed975d4813449dead05cf9bd285389a79c2...18a25be11a146450f2d3c2b8035dcb726acf2ade,1,1,1,2,1,2013-04-11 15:10:08,2013-04-11 14:26:06
ea284ebf6027b8ed038858fce2694c7af46130c0...ab7af35db970d14ec569b572b78e504c73d663fc,4,12,6,18,7,2013-04-05 03:50:51,2013-04-05 03:49:57
ae8320940991945de6bbfce33440fb89304f70d1...34633ae1d41b00ee3ebbb6f2ef89610baf47e155,4,21,4,25,4,2013-05-30 19:04:35,2013-05-30 19:04:35
0aa17c772b4d30231312b91b4f5b8d4230379b16...12340e4c0e5b87bf689670cc36fbd78550c4f9af,1,1,1,2,1,2015-02-11 07:00:17,2015-02-11 07:00:17
b45595ef4b942f9975998ad0cf64f4b7abf92161...9f25c5f55efba145fb3e47ef7cf5f3c99d42ed58,1,1,1,2,1,2013-04-11 17:20:44,2013-04-11 17:20:44
d976c80449bd420216237df7021abdd330b0438e...f0398675b3e36c8e87089ab66194cf297f55a010,5,13,13,26,7,2013-05-30 19:18:38,2013-05-30 19:18:38
9f25c5f55efba145fb3e47ef7cf5f3c99d42ed58...8e5b974f87d53d8885dbb2e2ec0db4ac3f7e1327,6,17,71,88,13,2013-04-25 18:48:02,2013-04-25 18:48:02
8e5b974f87d53d8885dbb2e2ec0db4ac3f7e1327...d8c14b9c2a0c147a66e041966c21caea9ce8c06e,1,1,1,2,1,2013-04-25 19:33:06,2013-04-25 19:33:06
9f25c5f55efba145fb3e47ef7cf5f3c99d42ed58...47d7cade203f4f2d066c898a7fe3461b1ca3a06e,4,56,18,74,13,2013-04-20 19:50:36,2013-04-20 19:50:36
9f25c5f55efba145fb3e47ef7cf5f3c99d42ed58...b1091b9c50cf81bbc52ca109ec2f1c2c6d631282,4,22,16,38,6,2013-04-19 21:57:41,2013-04-19 21:57:41
9f25c5f55efba145fb3e47ef7cf5f3c99d42ed58...34897cc1b2b06d2014ad1690687804a15d298d9e,6,80,16,96,20,2013-04-19 21:01:36,2013-04-19 21:01:36
34897cc1b2b06d2014ad1690687804a15d298d9e...cff5edd2fe123cd471ddc3d1a6d2a6b495bbde61,3,20,19,39,9,2013-04-19 21:06:41,2013-04-19 21:06:41
9f25c5f55efba145fb3e47ef7cf5f3c99d42ed58...d498fd53b6da03560d4836757cb16ecbb48b7f75,3,9,20,29,5,2013-04-19 17:36:10,2013-04-19 17:36:10
9f25c5f55efba145fb3e47ef7cf5f3c99d42ed58...ff5364d7dbd1aca4fff3ae30cdd3e9037786c97d,12,171,32,203,21,2013-04-19 17:26:39,2013-04-19 17:20:21
9f25c5f55efba145fb3e47ef7cf5f3c99d42ed58...468dcbcb6165aa4c3e1d0a96759d5bcff601cf04,1,11,1,12,5,2013-04-15 14:52:57,2013-04-15 14:52:57
468dcbcb6165aa4c3e1d0a96759d5bcff601cf04...12f1b8ad15da70c461c21c7c7868ab55f765355c,1,2,2,4,2,2013-04-17 11:18:18,2013-04-17 11:18:18
12f1b8ad15da70c461c21c7c7868ab55f765355c...e69ff105eeec09ac39bc5aef78e48f5576e14fda,1,7,6,13,4,2013-04-17 14:34:19,2013-04-17 14:34:19
e69ff105eeec09ac39bc5aef78e48f5576e14fda...ea2a48a2481748c5978190061ba45daf9ec23335,1,7,0,7,1,2013-04-17 14:47:30,2013-04-17 14:47:30
ea2a48a2481748c5978190061ba45daf9ec23335...ff7aace418b4116918869248e62292bf90bbccbe,1,3,8,11,4,2013-04-17 16:55:10,2013-04-17 16:55:10
ff7aace418b4116918869248e62292bf90bbccbe...d479282ab6270a3fb0570c2374001b71c4383276,1,5,0,5,1,2013-04-17 16:56:37,2013-04-17 16:56:37
d479282ab6270a3fb0570c2374001b71c4383276...7a070feccb53db78657102fa7157bb3ab6f55506,1,1,0,1,1,2013-04-18 03:12:19,2013-04-18 03:12:19
7a070feccb53db78657102fa7157bb3ab6f55506...c4dd577819c31081fded8c26815169fc28c25d7c,1,12,0,12,1,2013-04-18 03:28:07,2013-04-18 03:28:07
37f3d8da563b2026b23b2dc2d0479a3759f9583f...1221458a735e668e71ec9e848c27d7faa65b3450,6,72,3,75,7,2013-05-30 19:26:24,2013-05-30 19:26:24
1221458a735e668e71ec9e848c27d7faa65b3450...c26475a205c1809194fd7d91cbe69d17b9a43dba,4,55,25,80,16,2013-05-30 21:23:50,2013-05-30 21:23:50
c26475a205c1809194fd7d91cbe69d17b9a43dba...deb6c3e2f370ddd04a4374a3d0de3a7dfcc61c92,3,17,6,23,3,2013-05-30 21:48:46,2013-05-30 21:48:08
d8c14b9c2a0c147a66e041966c21caea9ce8c06e...2dc9043d2e3d5b4bd6d2f87bcf662436d30b29fa,4,41,38,79,19,2013-04-30 22:51:16,2013-04-19 21:06:41
2dc9043d2e3d5b4bd6d2f87bcf662436d30b29fa...7add1117cf25ec0461b86f168d5fac4553271de7,1,2,2,4,2,2013-04-30 22:52:32,2013-04-30 22:52:32
d8c14b9c2a0c147a66e041966c21caea9ce8c06e...8b29fd10d0fa332318b2405e002ae6e3d41568a1,3,27,43,70,21,2013-04-30 22:22:02,2013-04-30 22:17:22
8b29fd10d0fa332318b2405e002ae6e3d41568a1...f76f56445179acd4a0415a83da4fee4de0afff0e,2,11,7,18,7,2013-04-30 22:30:56,2013-04-30 22:30:56
d8c14b9c2a0c147a66e041966c21caea9ce8c06e...b96e4e3363257bc319dd3793486a625bd0ad2c23,5,17,7,24,6,2013-04-30 21:12:02,2013-04-30 21:12:02
b96e4e3363257bc319dd3793486a625bd0ad2c23...9120507d4783313dbb62f77c2f7c9fe10f0cfeb1,5,55,29,84,13,2013-04-30 21:49:33,2013-04-30 21:46:32
7e5ccd8b36f1dc2c4e06c4ff202062df75bb574f...9a2fb5817efb414a7945a45429d11845954b91af,4,18,8,26,6,2013-06-01 16:44:04,2013-06-01 16:44:04
9a2fb5817efb414a7945a45429d11845954b91af...915ad7f4c1666a29725bea8686f71890cc46b9b1,3,9,7,16,3,2013-06-01 17:11:46,2013-06-01 17:11:46
915ad7f4c1666a29725bea8686f71890cc46b9b1...492215ad42e4b23bb713c012c449fa262007ec88,10,291,191,482,72,2013-06-02 09:52:43,2013-01-15 22:50:42
492215ad42e4b23bb713c012c449fa262007ec88...abda353ae66922f3bddea906935e4e7fb0e46926,1,1,1,2,1,2013-06-03 20:23:41,2013-06-03 20:23:41
abda353ae66922f3bddea906935e4e7fb0e46926...81a0a521af6e22058090d4fc1cd6db9700dd8530,3,3,11,14,3,2013-06-03 20:28:46,2013-06-03 20:28:46
1d0409e9038eddd6e884c93b2bcdfb66d369d127...0c7d1864f28a3cc5305cd629730ed051c3418670,4,14,4,18,6,2013-04-30 23:09:40,2013-04-30 23:09:40
81a0a521af6e22058090d4fc1cd6db9700dd8530...590d8030a0056cea6941046f5c629049bb44921d,3,3,3,6,3,2013-06-04 18:33:15,2013-06-04 18:33:15
81a0a521af6e22058090d4fc1cd6db9700dd8530...3952ae4683616f7a2e0be4c11229185ad40ade1f,2,165,0,165,2,2013-06-04 01:13:28,2013-06-04 01:13:28
0c7d1864f28a3cc5305cd629730ed051c3418670...22b744b7e60122bee5abb82642ecb4feefa873d0,6,18,13,31,10,2013-05-07 18:47:44,2013-05-04 23:48:59
0c7d1864f28a3cc5305cd629730ed051c3418670...e1beaab051c441c2a5ca8649e2e4f119c8126ae9,7,486,111,597,38,2013-05-05 10:33:15,2013-03-21 21:47:12
0c7d1864f28a3cc5305cd629730ed051c3418670...3eae02e3e64a1867ac9c0a8db14dd8db44eba4f2,5,51,3,54,5,2013-05-04 11:34:23,2013-05-04 11:31:43
0c7d1864f28a3cc5305cd629730ed051c3418670...3ac09d2a17655df09e538a634fcbd79826b0f13d,3,9,5,14,3,2013-05-01 17:57:16,2013-05-01 17:23:56
46f5f47b0a501c55756d51990b34a7bf3efe9985...745873fac2a17941b664baccb2fcc020ffe06a27,1,1,1,2,1,2013-06-08 15:08:25,2013-06-08 15:08:25
745873fac2a17941b664baccb2fcc020ffe06a27...be2c8e74815c7926ffe9642c6a16abc2832e547a,3,34,32,66,11,2013-06-08 16:12:35,2013-06-08 16:12:35
be2c8e74815c7926ffe9642c6a16abc2832e547a...f86be427817061f8663bbd433dca85238ca0446f,8,524,111,635,37,2013-06-08 18:03:16,2013-06-08 17:57:22
f86be427817061f8663bbd433dca85238ca0446f...fff9123f26e5dbe06d76008ca40b41974fd5f838,4,167,42,209,43,2013-06-08 19:06:31,2012-08-13 10:51:29
fff9123f26e5dbe06d76008ca40b41974fd5f838...fe684e0cd6778c4ccd80220fb81d08df49eb5115,1,0,2,2,2,2013-06-08 19:53:37,2013-06-08 19:53:37
fe684e0cd6778c4ccd80220fb81d08df49eb5115...864e0da1472e41bfcc0a8a936ba575a010f44c79,8,124,22,146,22,2013-06-11 09:18:25,2013-06-11 09:18:25
864e0da1472e41bfcc0a8a936ba575a010f44c79...1d650775847f77473aa5662e86636b428641d8b2,6,43,50,93,19,2013-06-11 19:19:20,2013-06-11 19:19:20
1d650775847f77473aa5662e86636b428641d8b2...9eb41ace5ebc535bde47af06c31e7d0a83e51ae8,3,10,13,23,3,2013-06-11 19:22:18,2013-06-11 19:22:18
9eb41ace5ebc535bde47af06c31e7d0a83e51ae8...8f13959260a0b1f940aa7c5805827dec82c8ff23,3,7,7,14,3,2013-06-11 22:33:43,2013-06-11 22:33:43
8f13959260a0b1f940aa7c5805827dec82c8ff23...788855b4a4141fab9554513976dcc50004c76489,3,18,18,36,12,2013-06-11 22:59:55,2013-06-11 22:59:55
22b744b7e60122bee5abb82642ecb4feefa873d0...36ab0dc25af292363254cd0f1fff37a61c8e3873,6,84,62,146,40,2013-05-13 22:11:59,2013-05-13 22:11:59
22b744b7e60122bee5abb82642ecb4feefa873d0...67dce478dabaabf0f291556d51803b0c3ab1fae6,1,2,4,6,3,2013-05-08 09:44:56,2013-05-08 09:44:22
788855b4a4141fab9554513976dcc50004c76489...a8952189ad0d16adb9f567b28d173535294603d6,4,45,30,75,19,2013-06-12 20:22:48,2013-06-12 20:19:20
788855b4a4141fab9554513976dcc50004c76489...53cd4d46b43b0190310f2b8c9e9625eafebb91ef,10,77,34,111,32,2013-06-12 17:20:37,2013-05-31 22:13:50
67dce478dabaabf0f291556d51803b0c3ab1fae6...756ff5c77ad9dd6473ef66f671851b4e94676cad,4,34,28,62,16,2013-05-15 22:48:13,2013-05-15 22:48:13
67dce478dabaabf0f291556d51803b0c3ab1fae6...f69040c9d2b21491e33a9676a68ce20d97787ab4,1,2,2,4,2,2013-05-08 10:50:45,2013-05-08 10:39:28
5adac77b7598cd44c13171eccc476be1e49f8a0a...9e66a85366b43e936d8c9705bec0a2e3f220521f,6,41,37,78,8,2013-06-12 23:40:19,2013-06-12 23:40:19
9e66a85366b43e936d8c9705bec0a2e3f220521f...60576ba3961f1de83fa27cf22bbcc4e8dfa2bd3e,7,87,77,164,17,2013-06-13 21:00:03,2013-06-13 21:00:03
60576ba3961f1de83fa27cf22bbcc4e8dfa2bd3e...239d794b590a375556f4c72bbafb936ac4ce3b36,4,17,13,30,11,2013-06-13 22:19:51,2013-06-13 22:19:51
239d794b590a375556f4c72bbafb936ac4ce3b36...f6108db93b46754dc82b8c005966adbf58b5feec,2,16,0,16,2,2013-06-13 22:23:39,2013-06-13 22:23:39
3fefb4a48ea09242d8ea3f275a25e698f107ab80...d1d71e168904d00a8201fb4052561f3087733c2c,5,5,5,10,5,2013-05-15 23:11:34,2013-05-15 23:11:34
84f4a62c019b4f591383ccce6a6582da1a384f9a...aad1b18865f8c73c4267c7505435070f42fa6c40,11,45,17,62,29,2013-06-18 17:27:27,2013-06-18 17:20:11
aad1b18865f8c73c4267c7505435070f42fa6c40...538108b0fc17bda33003251bc39baf2ef79dd9a0,5,13,13,26,13,2013-06-18 17:33:01,2013-06-18 17:33:01
538108b0fc17bda33003251bc39baf2ef79dd9a0...0edad18326c7204550ff4cb9f8715598b618341a,4,11,9,20,4,2013-06-18 22:59:16,2013-06-18 22:59:16
0edad18326c7204550ff4cb9f8715598b618341a...301b6d3b420c5c5c9b4afb58092eedd14285325b,5,8,13,21,9,2013-06-18 23:16:47,2013-06-18 23:16:47
84f4a62c019b4f591383ccce6a6582da1a384f9a...5a6cd73f5c284426e08af6429b40460e6ba374f5,3,3,3,6,3,2013-06-14 18:37:18,2013-06-14 18:37:18
84f4a62c019b4f591383ccce6a6582da1a384f9a...85d156c3f7196ef4b251b85431c7178cbd51f855,4,8,5,13,5,2013-06-14 09:10:00,2013-06-14 09:10:00
84f4a62c019b4f591383ccce6a6582da1a384f9a...95812fde45c648ca53bcdab98156fdca535605df,3,25,6,31,11,2013-06-13 22:57:36,2013-06-07 20:54:11
95812fde45c648ca53bcdab98156fdca535605df...065029b13c676c977479e61b3853b44898a3fa46,1,5,5,10,2,2013-06-19 17:50:26,2013-06-19 17:50:26
d1d71e168904d00a8201fb4052561f3087733c2c...88fc68cf8bffc6dd7b245ed39bc410852694ecc9,5,6,5,11,6,2013-05-20 23:08:32,2013-05-20 23:08:32
88fc68cf8bffc6dd7b245ed39bc410852694ecc9...7524cafa156efd908d487d3a1bb1e316d880cf8b,5,31,7,38,12,2013-05-21 17:01:02,2013-05-21 17:01:02
7524cafa156efd908d487d3a1bb1e316d880cf8b...7981ca5c468950df13c7589dfec2def538c3d979,5,1,21,22,11,2013-05-22 01:58:52,2013-05-22 01:58:52
7981ca5c468950df13c7589dfec2def538c3d979...f1077c8d5d680e376f95abe1782ad2946b25c24b,4,4,4,8,4,2013-05-22 02:36:27,2013-05-22 02:36:27
f1077c8d5d680e376f95abe1782ad2946b25c24b...b880858b61cdd976193bc15a1c700526e5e5f04a,1,6,7,13,3,2013-05-24 23:36:09,2013-05-24 23:35:49
b880858b61cdd976193bc15a1c700526e5e5f04a...d7364020770df94f7da56dfea8f536e6080075cc,1,2,3,5,3,2013-05-25 00:08:39,2013-05-25 00:08:39
d7364020770df94f7da56dfea8f536e6080075cc...2e277897f97194241f223f3197ae54eb1f904a84,3,30,4,34,4,2013-05-25 00:30:13,2013-05-25 00:30:13
d1d71e168904d00a8201fb4052561f3087733c2c...b7f5f30570079fa78dc2bd44b40b7622d713adff,4,15,15,30,12,2013-05-20 17:26:27,2013-05-20 17:26:27
d1d71e168904d00a8201fb4052561f3087733c2c...e8fcad0cfbe2a16ac3cd5e998809a3050091ddbb,4,108,120,228,24,2013-05-19 18:38:22,2013-05-19 18:38:22
e8fcad0cfbe2a16ac3cd5e998809a3050091ddbb...c0215ba2cc9c4ae40e8db08f96d115999b4f9262,3,24,24,48,13,2013-05-19 18:46:10,2013-05-19 18:46:10
c0215ba2cc9c4ae40e8db08f96d115999b4f9262...3599bcf22ef738dac8d36cc1d1d1096ba6726fa3,3,5,5,10,4,2013-05-19 19:58:50,2013-05-19 19:58:50
3599bcf22ef738dac8d36cc1d1d1096ba6726fa3...5de39fbdadafbed170df43f3bb1e17b4cb68b9c6,3,5,8,13,3,2013-05-19 20:04:38,2013-05-19 20:04:38
5de39fbdadafbed170df43f3bb1e17b4cb68b9c6...2fabd78e8f723380d25e7a2a179a39d33054de13,4,22,18,40,13,2013-05-19 23:15:52,2013-05-19 23:13:32
2fabd78e8f723380d25e7a2a179a39d33054de13...e15ac2d6b213a113ffe33d1b1dbbb99410d218df,4,5,5,10,5,2013-05-19 23:28:29,2013-05-19 23:28:29
e15ac2d6b213a113ffe33d1b1dbbb99410d218df...63e8d2b0dd29b1c79a9a7dde434e46123abb4c1f,3,79,62,141,5,2013-05-20 04:59:38,2013-05-20 04:59:38
63e8d2b0dd29b1c79a9a7dde434e46123abb4c1f...1b912192cdc74c6272115058d7db07fd9de1ccc6,3,18,3,21,3,2013-05-20 05:02:51,2013-05-20 05:02:51
1b912192cdc74c6272115058d7db07fd9de1ccc6...5d517dc2dab7612ea6659e3ff31f43299bb9624b,1,2,1,3,1,2013-05-20 07:46:56,2013-05-20 07:46:13
5d517dc2dab7612ea6659e3ff31f43299bb9624b...ac84e7ed632ecbe79e2cd8b5e1a5ebb5a14eaad2,3,5,5,10,4,2013-05-20 12:09:47,2013-05-20 12:05:32
ac84e7ed632ecbe79e2cd8b5e1a5ebb5a14eaad2...1bdc29928dc3ad40fd096ec916709420d783bfa1,4,17,17,34,7,2013-05-20 12:15:44,2013-05-20 12:15:25
1bdc29928dc3ad40fd096ec916709420d783bfa1...af35ec07ff6c0f0a12f67910eb031eb4eafaa430,5,16,14,30,9,2013-05-20 12:23:59,2013-05-20 12:23:59
af35ec07ff6c0f0a12f67910eb031eb4eafaa430...4663d05a3f6d57058c1f0eebba60e10c7b88e646,1,4,9,13,3,2013-05-20 12:30:01,2013-05-20 12:30:01
4663d05a3f6d57058c1f0eebba60e10c7b88e646...5e609b946f71f161617e243d0bf112cf024887f6,1,1,0,1,1,2013-05-20 16:39:50,2013-05-20 16:39:50
5e609b946f71f161617e243d0bf112cf024887f6...61c67b9cb240be37ef37e88e1744e8c6c13e7851,4,38,20,58,14,2013-05-20 16:46:03,2013-05-20 16:45:41
61c67b9cb240be37ef37e88e1744e8c6c13e7851...3f9cebba45321106fddddae0c56a64409d9d2662,4,34,25,59,20,2013-05-20 17:03:10,2013-05-20 17:03:10
d1d71e168904d00a8201fb4052561f3087733c2c...076e53129eac9a7e80738932691956b8a2e232f3,2,3,3,6,2,2013-05-18 09:02:18,2013-05-18 09:02:18
076e53129eac9a7e80738932691956b8a2e232f3...1e5a4d352fa076db29dc6835d11d7372c710aabc,1,4,1,5,1,2013-05-18 09:08:16,2013-05-18 09:08:16
d1d71e168904d00a8201fb4052561f3087733c2c...29fa1d87305f18622821944990a74e7eb4133216,1,1,0,1,1,2013-05-17 03:39:20,2013-05-17 03:39:20
1177d1d84811b5d8fc3daaa23ff94999cf0ddbcd...6293ffb596f27a2603800658fae589006b4ad686,8,64,86,150,40,2013-06-25 23:46:13,2013-06-25 23:46:13
6293ffb596f27a2603800658fae589006b4ad686...aa75127ff6553c99ef7115e14b4b87c0e3b850b0,4,27,30,57,9,2013-06-25 23:53:02,2013-06-25 23:53:02
1177d1d84811b5d8fc3daaa23ff94999cf0ddbcd...aa18d822587e92940c977dddef55b661429cfc6e,1,19,0,19,1,2013-06-24 21:28:54,2013-06-24 21:28:54
aa18d822587e92940c977dddef55b661429cfc6e...995c70cf6f8a63260ce9ce8765859b72bf547394,1,46,1,47,3,2013-06-24 22:35:06,2013-06-24 22:35:06
995c70cf6f8a63260ce9ce8765859b72bf547394...40f52157108fff6e7d46fe79b7c9ddcc478cca24,1,0,2,2,1,2013-06-24 22:37:28,2013-06-24 22:37:28
1177d1d84811b5d8fc3daaa23ff94999cf0ddbcd...6b3c198d112bf5c75bf620bec3c19788f24d6aee,3,5,5,10,3,2013-06-21 15:24:29,2013-06-21 15:24:29
6b3c198d112bf5c75bf620bec3c19788f24d6aee...6d650d0e9c1f8a8d936268d18db8f623bfb89606,3,3,3,6,3,2013-06-21 15:44:08,2013-06-21 15:44:08
6d650d0e9c1f8a8d936268d18db8f623bfb89606...34544e3215e377630a92d80e5a18e05582919760,3,7,7,14,5,2013-06-21 15:51:53,2013-06-21 15:51:53
34544e3215e377630a92d80e5a18e05582919760...3f8097d3b22f87bae04438e2e0e2a57b52b68f8e,3,12,10,22,6,2013-06-25 09:20:17,2013-06-25 09:00:37
3f8097d3b22f87bae04438e2e0e2a57b52b68f8e...bbb74f7d72aa1d1cadc7cb61ba9a38fe23978993,3,27,45,72,13,2013-06-25 14:59:21,2013-06-25 14:59:21
bbb74f7d72aa1d1cadc7cb61ba9a38fe23978993...30552f4dc9ad598bd79e400c256c0c271ea4b963,1,1,1,2,1,2013-06-25 15:34:30,2013-06-25 15:34:30
1177d1d84811b5d8fc3daaa23ff94999cf0ddbcd...f3bfabcd3dd9f6b8e98f8fbcd4adcda5603099fb,3,7,5,12,3,2013-06-20 02:03:29,2013-06-20 02:03:29
f3bfabcd3dd9f6b8e98f8fbcd4adcda5603099fb...0b83ad6315a2ecbea3aa2928a679c5a7b2aa9820,4,86,1,87,4,2013-06-20 15:52:00,2013-06-20 15:52:00
1bc5905cae6552a8ddccc047f2af244d2b8b0067...05ae3baef6c3b4604fad5d7edb5d39ffd2d3c887,2,36,13,49,8,2013-05-28 22:44:38,2013-05-28 22:44:38
05ae3baef6c3b4604fad5d7edb5d39ffd2d3c887...76c958a7b4ddbec99297ebb7c2231cdea834ce73,5,30,83,113,12,2013-05-28 22:51:36,2013-05-28 22:51:36
ab3149e92a5a75c18c80b77e391931dfc2afe370...cf4c17ad6c8637f1e9bdbe50bba41990c69b5fc1,3,10,19,29,11,2013-05-20 17:40:20,2013-05-20 17:40:20
cf4c17ad6c8637f1e9bdbe50bba41990c69b5fc1...eb384180d0e25278e20cfe35d574cc376dfdaf62,7,25,16,41,16,2013-05-20 20:36:44,2013-05-20 20:36:44
d524fe5843148bc97d63a5a2684bf8e7b7c4445e...47b39c4d0381ab2f1d84fd361a7880a5b416b723,5,5,5,10,5,2013-06-26 00:07:20,2013-06-26 00:07:20
47b39c4d0381ab2f1d84fd361a7880a5b416b723...1042550bd045a9bfe0a3143d43218402b751967d,3,13,6,19,4,2013-06-26 07:53:26,2013-06-26 07:53:26
5b8322aa18d442684d2ff208a4f731b9b1f0f629...91fb8594006d2014be9273da392e313c787f2570,2,14,25,39,2,2013-06-27 16:46:35,2013-06-27 16:46:35
91fb8594006d2014be9273da392e313c787f2570...8a9c125b1f96967726690a21be4a6966865b8055,1,0,0,0,0,2013-06-27 16:47:33,2013-06-27 16:47:33
8a9c125b1f96967726690a21be4a6966865b8055...2236488f2224e47e63ee23ee79f2c2a881259877,5,46,20,66,7,2013-06-27 18:32:08,2013-06-27 18:32:08
eb384180d0e25278e20cfe35d574cc376dfdaf62...662ff0269677eed34bad15a0280692b90a651563,4,14,4,18,5,2013-05-28 22:42:29,2013-05-20 19:21:59
eb384180d0e25278e20cfe35d574cc376dfdaf62...2e1b96a8e21f5b9bdaa221c80066f5b9d2c79817,4,55,29,84,16,2013-05-28 20:31:23,2013-05-28 20:29:21
2e1b96a8e21f5b9bdaa221c80066f5b9d2c79817...a694b96a3c4cf1a6fe43e9fb3cca55ae74ee0ced,3,23,23,46,6,2013-05-28 20:50:04,2013-05-28 20:50:04
a694b96a3c4cf1a6fe43e9fb3cca55ae74ee0ced...414133b8f6f3fd1ca5806267b1a980c576e19cf0,3,41,58,99,20,2013-05-28 20:50:41,2013-05-28 20:50:41
414133b8f6f3fd1ca5806267b1a980c576e19cf0...00cfa946d00c640edc44ae409ab2d2c912064ff4,3,0,18,18,3,2013-05-28 20:57:26,2013-05-28 20:57:26
00cfa946d00c640edc44ae409ab2d2c912064ff4...496af7e8f7c02e4847babc0a52c5aaf26fa50157,3,3,3,6,3,2013-05-28 20:58:39,2013-05-28 20:58:39
496af7e8f7c02e4847babc0a52c5aaf26fa50157...d9659b6794fa1985c756d2a7d8ee73174e54ee08,3,21,35,56,8,2013-05-28 21:10:17,2013-05-28 21:10:17
d9659b6794fa1985c756d2a7d8ee73174e54ee08...9975ff541792fe8843e40976e98ef02e9833295d,3,5,6,11,3,2013-05-28 21:15:15,2013-05-28 21:15:15
9975ff541792fe8843e40976e98ef02e9833295d...ac011e35fc45bcaefc63d10b60061c34c55b4c52,2,8,8,16,2,2013-05-28 21:17:20,2013-05-28 21:17:20
eb384180d0e25278e20cfe35d574cc376dfdaf62...47266d0435c641c433a04dec28cf3ad8ab7ef407,1,5,2,7,1,2013-05-28 08:04:26,2013-05-28 08:04:26
47266d0435c641c433a04dec28cf3ad8ab7ef407...c36134cd15b782a033e94f46438b769add96d6d2,1,2,2,4,2,2013-05-28 08:10:50,2013-05-28 08:10:50
c36134cd15b782a033e94f46438b769add96d6d2...398b283275a15867ac0d8b58de16bf1b82ddbbde,1,17,0,17,1,2013-05-28 23:23:53,2013-05-28 23:23:53
eb384180d0e25278e20cfe35d574cc376dfdaf62...a5ae46b8022021ae9e0ef8459af98e9f30b46f5f,3,28,5,33,7,2013-05-26 04:54:51,2013-05-26 04:54:51
eb384180d0e25278e20cfe35d574cc376dfdaf62...9d7e9f07e912f8cdc3a2c4432857f10c448de3d2,3,7,7,14,3,2013-05-24 18:01:21,2013-05-24 17:59:50
9d7e9f07e912f8cdc3a2c4432857f10c448de3d2...29252d53a14e6676c9c2cdbbc99da6133a47350b,2,35,1,36,2,2013-05-24 19:37:58,2013-05-24 19:37:58
eb384180d0e25278e20cfe35d574cc376dfdaf62...64f300141d257494b9fdb37ae8edcf2debb8c7ba,4,42,10,52,5,2013-05-23 00:02:51,2013-05-22 23:59:45
2236488f2224e47e63ee23ee79f2c2a881259877...e05b1e769bc46426a5c5ad61e14ce00853208c91,1,2,0,2,1,2013-06-29 16:03:09,2013-06-29 16:03:09
2236488f2224e47e63ee23ee79f2c2a881259877...efce7dd7bbd8ab1b4d3ef3aaeb04445d3346d561,1,10,0,10,1,2013-06-29 04:58:25,2013-06-29 04:58:25
efce7dd7bbd8ab1b4d3ef3aaeb04445d3346d561...6baa166f01a66beaf823d3d5ab30df785c61f17f,2,37,3,40,4,2013-06-29 06:13:44,2013-06-29 06:01:06
2236488f2224e47e63ee23ee79f2c2a881259877...a8f2ac2aa451d8a2bdf41ed78a65aeeb3e0d1adf,6,122,134,256,16,2013-06-28 22:35:19,2013-06-28 22:35:19
a8f2ac2aa451d8a2bdf41ed78a65aeeb3e0d1adf...afede9f189a2ae9f4361d6f1e8dc675d24925020,8,8,8,16,8,2013-06-29 17:26:38,2013-06-29 17:26:38
2236488f2224e47e63ee23ee79f2c2a881259877...f6a63543f99f10d8960febdce35ffdd6da037e29,3,13,7,20,6,2013-06-27 19:58:36,2013-06-27 19:58:15
f6a63543f99f10d8960febdce35ffdd6da037e29...673c630ee01d1709322d75c94c3b37ec6cc20b03,1,1,1,2,1,2013-06-27 20:28:52,2013-06-27 20:28:52
673c630ee01d1709322d75c94c3b37ec6cc20b03...5596e4fbc3dd02a32344ecfec3fbd2b6aa7eb226,2,67,11,78,17,2013-06-27 20:29:38,2013-06-27 20:29:38
5596e4fbc3dd02a32344ecfec3fbd2b6aa7eb226...fdd6c62050fef105c81d3e6007727581884dc272,9,168,145,313,36,2013-06-28 15:31:16,2013-06-28 15:29:16
e15ac86caa3fa88d82cc6460ea88e42529447e08...8a964987d336730d610c183677199cd46cd26af9,4,95,74,169,14,2013-05-30 17:36:04,2013-01-30 19:15:37
e15ac86caa3fa88d82cc6460ea88e42529447e08...77aedd59a9da69f3f32720c73909102be50ca369,4,30,9,39,8,2013-05-30 17:12:43,2012-12-14 15:21:51
77aedd59a9da69f3f32720c73909102be50ca369...a53c8512e3e66c66170a1703f04f0bde73bbfe75,4,46,26,72,13,2013-05-30 17:14:03,2013-05-02 14:13:41
e15ac86caa3fa88d82cc6460ea88e42529447e08...735af6ea53176f7639ef2caaabd5c36d8438ed11,3,1,3,4,3,2013-05-30 17:03:57,2013-05-30 17:03:57
e15ac86caa3fa88d82cc6460ea88e42529447e08...736cad7fbc16669efdd067c43b2fb0979f15d056,5,767,714,1481,92,2013-05-29 18:59:26,2013-05-29 18:48:42
736cad7fbc16669efdd067c43b2fb0979f15d056...00d3f44ebdbdd00e69a842c2144a2e613f12c86e,1,11,0,11,1,2013-05-29 20:13:53,2013-05-29 20:13:53
00d3f44ebdbdd00e69a842c2144a2e613f12c86e...c7507b60133d2701028e5ffcbe456c7114ceec7a,4,44,56,100,29,2013-05-29 21:37:46,2013-05-29 21:37:46
c7507b60133d2701028e5ffcbe456c7114ceec7a...73fb7632485ad43ad6463bb8cc57c02bcbe417a7,4,14,10,24,8,2013-05-29 21:57:30,2013-05-29 21:57:30
e15ac86caa3fa88d82cc6460ea88e42529447e08...201b540d93f2ff1acc32119a4abe33fb4bf448be,2,6,6,12,2,2013-05-29 15:24:16,2013-05-29 15:21:26
e15ac86caa3fa88d82cc6460ea88e42529447e08...8dce4f0b88506d8bad305975591596ca2ad6df62,4,12,10,22,5,2013-05-29 00:08:30,2013-05-29 00:08:15
e15ac86caa3fa88d82cc6460ea88e42529447e08...14b17b3329aadd116383b2b920743d7fb20fed62,4,74,36,110,9,2013-05-28 23:49:18,2013-05-28 23:48:03
e15ac86caa3fa88d82cc6460ea88e42529447e08...3847172c6f1199acfb94715064eaf027298c4958,3,3,3,6,3,2013-05-28 23:43:21,2013-05-28 23:43:21
93b8e9d4c839869b6e3e94d8abeda4847c922763...30f65f90c1e04cf527b631d9a63aaa458ced55c8,3,17,21,38,11,2013-05-29 17:52:21,2013-05-29 17:52:21
30f65f90c1e04cf527b631d9a63aaa458ced55c8...7617cfa717fe6963ce9061ef31b5ee823fcc3fb0,3,8,11,19,5,2013-05-29 17:55:20,2013-05-29 17:55:20
539a9da57532622550786c5f4037d32dafe332f1...e31c0fb2901f805fb4d1459c2a41da4706d8a708,3,8,8,16,7,2013-06-29 16:24:41,2013-06-29 16:24:41
e31c0fb2901f805fb4d1459c2a41da4706d8a708...822e0af79af5a8fbc20fc0347fac2090719351bd,1,2,1,3,2,2013-06-30 00:47:17,2013-06-30 00:47:17
822e0af79af5a8fbc20fc0347fac2090719351bd...fc60a61284bd3fd9326019256c5dc98acf2bc515,1,1,4,5,1,2013-07-01 15:48:49,2013-07-01 15:48:49
822e0af79af5a8fbc20fc0347fac2090719351bd...bef1ccb94ada61807f4e423a6ed2168cfebaf821,8,48,66,114,21,2013-06-30 17:47:10,2013-06-30 17:33:17
bef1ccb94ada61807f4e423a6ed2168cfebaf821...a27d2d36001d3c3830193365047c925d741ac1a3,1,6,0,6,1,2013-06-30 17:50:57,2013-06-30 17:50:57
822e0af79af5a8fbc20fc0347fac2090719351bd...e0ba8027b6991e8d0b80bd1839201fa3116fd475,4,36,9,45,9,2013-06-30 17:02:58,2013-06-30 17:02:58
822e0af79af5a8fbc20fc0347fac2090719351bd...83c882419773967e90449bc55bbbdea5e6034a64,3,22,8,30,9,2013-06-30 16:53:33,2013-06-30 16:53:33
fc60a61284bd3fd9326019256c5dc98acf2bc515...d1f8082a5a000c21612e5b34565e570f3628e254,10,52,25,77,22,2013-07-02 16:07:38,2013-07-02 16:07:38
d1f8082a5a000c21612e5b34565e570f3628e254...51d4d0ac7d1947bdd1ca4e134bb676df52fe3b91,1,22,0,22,1,2013-07-02 17:22:18,2013-07-02 17:22:18
51d4d0ac7d1947bdd1ca4e134bb676df52fe3b91...2f4c228b65e801d32499c233cfc67260dae9fca5,1,3,7,10,1,2013-07-02 17:23:30,2013-07-02 17:23:10
2f4c228b65e801d32499c233cfc67260dae9fca5...99f6e657698dd9b9ca09b941f3c5b95b2569cd32,2,20,2,22,3,2013-07-02 17:28:23,2013-07-02 17:28:23
99f6e657698dd9b9ca09b941f3c5b95b2569cd32...6fa6e04ab61c605dce5c62e66f23d7db30756bd2,4,10,4,14,6,2013-07-03 04:09:53,2013-07-03 04:09:53
fc60a61284bd3fd9326019256c5dc98acf2bc515...580577badb1ee0ef9c2735f7f27a1b0188aaf77c,1,18,6,24,1,2013-07-01 18:06:43,2013-07-01 18:05:15
747c523e0204b02d794e75b92dae5c58b3e639e9...ce6526cfe3b70a8555bbb7b2f235af9c916d34a0,21,261,170,431,102,2013-07-05 18:18:06,2013-07-03 16:52:28
747c523e0204b02d794e75b92dae5c58b3e639e9...b745b32525c01263a1aebc89e0000d07c06f3c24,4,91,56,147,41,2013-07-05 17:00:29,2013-07-05 17:00:29
b745b32525c01263a1aebc89e0000d07c06f3c24...581878945db152ab139bd28eb3cf51b86fd59098,5,51,12,63,8,2013-07-05 17:32:37,2013-07-05 17:32:37
747c523e0204b02d794e75b92dae5c58b3e639e9...c859340ed16a65176808396bcb376334a45a3a99,4,12,13,25,11,2013-07-04 17:35:30,2013-07-04 17:35:30
747c523e0204b02d794e75b92dae5c58b3e639e9...14307a00ee781896ab5e0f99306957aa55e1202e,4,12,14,26,5,2013-07-04 17:15:34,2013-07-04 17:14:18
747c523e0204b02d794e75b92dae5c58b3e639e9...68809d3dd3b8aabb560520307d079686d93096bc,8,51,23,74,19,2013-07-03 17:09:54,2013-06-28 22:15:09
747c523e0204b02d794e75b92dae5c58b3e639e9...af88c355cd4c217cb8508d2529381b0d6e2fa490,3,11,21,32,5,2013-07-03 17:03:21,2013-07-02 00:49:18
af88c355cd4c217cb8508d2529381b0d6e2fa490...c6bad2fb6cc6d4ae499870da208b6b8b0275961f,1,2,2,4,2,2013-07-03 17:05:14,2013-07-03 17:05:14
08d791f69dc1a802c31307b51453a5629a4258eb...1c18bcdc585a4c0e235adb36ba6874a5c0d95317,6,6,6,12,6,2013-08-13 21:19:07,2013-08-13 21:19:07
1c18bcdc585a4c0e235adb36ba6874a5c0d95317...123646a82c09f928c49e700a9a08249b5169aaca,4,32,22,54,11,2013-08-13 21:37:08,2013-08-13 21:37:08
123646a82c09f928c49e700a9a08249b5169aaca...dddb50116578dbee7bc3c0b1e299730bdd95d2ca,3,3,2,5,3,2013-08-14 16:58:28,2013-08-14 16:58:28
dddb50116578dbee7bc3c0b1e299730bdd95d2ca...24f9f2cd6910d71a73344a487cd21545d2abe529,3,56,44,100,16,2013-08-14 20:08:10,2013-08-14 20:08:10
24f9f2cd6910d71a73344a487cd21545d2abe529...de30d65811666633a6cfa2a699b8110ca0ed75cc,3,6,3,9,3,2013-08-14 20:38:21,2013-08-14 20:38:21
de30d65811666633a6cfa2a699b8110ca0ed75cc...f5fc30632363b090189b487ab8000413bbd14910,4,26,23,49,17,2013-08-15 00:19:58,2013-08-15 00:19:58
f5fc30632363b090189b487ab8000413bbd14910...079db13a7c51597078832099939d478117526a48,3,121,54,175,35,2013-08-15 00:30:08,2013-08-14 22:50:31
079db13a7c51597078832099939d478117526a48...48a4871c992d1a79a41fbc171f142a0be966861e,6,138,43,181,27,2013-08-15 03:07:14,2013-08-15 03:07:14
48a4871c992d1a79a41fbc171f142a0be966861e...a83d89d777e052c493737275cbf8e8bc0b5c2cc4,3,8,3,11,7,2013-08-15 03:47:49,2013-08-15 03:47:49
a83d89d777e052c493737275cbf8e8bc0b5c2cc4...5ea3de2bb117b74159b81111883b3dbc01f0c1ae,3,62,55,117,39,2013-08-15 03:52:57,2013-08-15 03:52:57
5ea3de2bb117b74159b81111883b3dbc01f0c1ae...806db97c5feb11521a17b5fa390513111a75b839,3,5,5,10,5,2013-08-15 03:55:29,2013-08-15 03:55:29
806db97c5feb11521a17b5fa390513111a75b839...f030c61d56baa5041509a82b69864ba7172689da,6,42,24,66,21,2013-08-15 16:22:10,2013-08-15 16:22:10
f030c61d56baa5041509a82b69864ba7172689da...181656196c60462f2242295aaaffa7b99c0b9d96,3,11,12,23,7,2013-08-15 16:30:01,2013-08-15 16:27:52
181656196c60462f2242295aaaffa7b99c0b9d96...1c88fc2fc5da7f8ea5e46f91b6c9d10990bdd1e5,6,30,28,58,13,2013-08-15 17:03:30,2013-08-15 17:03:30
1c88fc2fc5da7f8ea5e46f91b6c9d10990bdd1e5...36e5526feb45227f9778682b110f52c620c4527b,3,10,10,20,9,2013-08-15 19:17:45,2013-08-15 19:09:33
36e5526feb45227f9778682b110f52c620c4527b...508ae65eec9075057c326a8701f8822faba02be4,7,97,82,179,20,2013-08-15 21:59:05,2013-08-15 21:55:40
508ae65eec9075057c326a8701f8822faba02be4...ac9f51fa534f12de7bb9487fb89edcb8edfa3951,10,108,112,220,23,2013-08-16 17:28:11,2013-08-16 17:25:07
ac9f51fa534f12de7bb9487fb89edcb8edfa3951...b196e401c86b872fcef0e9c69d3f648fd98ebf0f,4,15,14,29,12,2013-08-16 18:34:51,2013-08-16 18:34:51
b196e401c86b872fcef0e9c69d3f648fd98ebf0f...1e0faba5c4dd3c8f1937bd6ba833a143dd9081bf,1,85,135,220,39,2013-08-16 22:13:31,2013-08-16 22:13:31
1e0faba5c4dd3c8f1937bd6ba833a143dd9081bf...8d9d2b7c306e28b412e6edd0ddbcb9b17e0d9919,9,188,118,306,20,2013-08-19 17:55:39,2013-08-19 17:50:09
8d9d2b7c306e28b412e6edd0ddbcb9b17e0d9919...0c205254da35eceeed80ec62985aa792d4308a5d,5,43,5,48,5,2013-08-19 18:06:53,2013-08-19 18:06:53
0c205254da35eceeed80ec62985aa792d4308a5d...53ce4bb6fcbbf18bf62bb354d4b038637c1a3464,3,9,9,18,3,2013-08-19 18:13:10,2013-08-19 18:13:10
53ce4bb6fcbbf18bf62bb354d4b038637c1a3464...403a0dde499e9c800c04b0e38c8a1f692c776f93,4,65,95,160,14,2013-08-21 18:53:16,2013-08-21 18:47:41
403a0dde499e9c800c04b0e38c8a1f692c776f93...e6551e5703f09261f1b5521c3fcf84dcdce700f2,3,6,10,16,4,2013-08-21 18:57:51,2013-08-21 18:57:51
e6551e5703f09261f1b5521c3fcf84dcdce700f2...7f8c03e49ba050139f2d7d6fd2a83cab2ca38514,16,203,199,402,100,2013-08-21 19:08:37,2013-08-21 19:08:37
7f8c03e49ba050139f2d7d6fd2a83cab2ca38514...762f984dfb36f9a272eb9b7be24bfb252d88099e,1,8,8,16,6,2013-08-21 19:16:21,2013-08-21 19:16:21
762f984dfb36f9a272eb9b7be24bfb252d88099e...cc4a1d0f8b928bfc0fc995f9a99479fc26eb056b,4,138,21,159,13,2013-08-22 03:59:43,2013-08-22 03:59:43
cc4a1d0f8b928bfc0fc995f9a99479fc26eb056b...fa2892ea47b6dd571966787e900fe50b431c2434,3,3,3,6,3,2013-08-22 04:05:22,2013-08-22 04:05:22
fa2892ea47b6dd571966787e900fe50b431c2434...f59fc64a20d57fe08be9fb6e53ab0022f6f6c732,6,6,6,12,6,2013-08-22 04:08:52,2013-08-22 04:08:52
df18a153cf5a2881d337bc734ab9e4f753b8177c...d3488d6ef048632fe1fcbe6c2782f7cc90e22592,6,6,6,12,6,2013-07-05 18:20:20,2013-07-05 18:20:20
d3488d6ef048632fe1fcbe6c2782f7cc90e22592...b49861d387e82aa6c5483f20c0b85e4ee22d33ea,3,22,7,29,4,2013-07-05 22:34:17,2013-07-05 22:34:17
b49861d387e82aa6c5483f20c0b85e4ee22d33ea...d49321d2e3af3549199796ee03b857d13ab90e11,1,1,1,2,1,2013-07-05 22:39:56,2013-07-05 22:39:56
5fd964bda115d35299846adda0814b1659d0e6f4...2e17b5d6d3f8b93c05058b9be215fded8a1d8b0e,1,0,1,1,1,2013-07-11 04:48:37,2013-07-11 04:48:37
2e17b5d6d3f8b93c05058b9be215fded8a1d8b0e...f2cacbca7f7a04c4243098633ba9470a6fcdf3f3,1,0,1,1,1,2013-07-11 04:49:44,2013-07-11 04:49:44
5fd964bda115d35299846adda0814b1659d0e6f4...88ae6c6a659582ad48fee4c8c6eb010aa04d4271,3,10,9,19,6,2013-07-10 16:02:10,2013-07-10 16:02:10
88ae6c6a659582ad48fee4c8c6eb010aa04d4271...ba87620cc09e630677fe6b5b4c420e558a609ad0,3,91,86,177,18,2013-07-10 17:04:21,2013-07-10 17:04:21
ba87620cc09e630677fe6b5b4c420e558a609ad0...6ef0eda53f4f70fc8c0b38a5b1b1f1505bcbf22e,4,127,110,237,35,2013-07-10 18:03:08,2013-07-10 17:47:06
6ef0eda53f4f70fc8c0b38a5b1b1f1505bcbf22e...ba1a41137ab48c7cb99d101370e08dd6249c490a,6,33,29,62,21,2013-07-11 01:07:22,2013-07-11 01:05:38
5fd964bda115d35299846adda0814b1659d0e6f4...78a587aa17ee3d5ab67fde66eeb503e63408ae55,9,51,54,105,33,2013-07-09 18:47:30,2013-07-09 18:47:30
5fd964bda115d35299846adda0814b1659d0e6f4...7832e5987443ea54fb07be2883408610d77a6fa7,3,22,16,38,13,2013-07-06 21:52:59,2013-07-06 21:52:59
7832e5987443ea54fb07be2883408610d77a6fa7...d96316159dbab4cf04423d916b6b7019f58ad8ae,2,12,12,24,11,2013-07-06 21:55:44,2013-07-06 21:55:44
f59fc64a20d57fe08be9fb6e53ab0022f6f6c732...23a2d7d1f303a4d1cd8e1515ae9757825dc95598,3,4,4,8,3,2013-08-23 21:15:30,2013-08-23 21:15:30
f59fc64a20d57fe08be9fb6e53ab0022f6f6c732...8f4d0ac3ac35eec7e2edca78a940466caf642c31,4,12,5,17,6,2013-08-23 17:51:59,2013-08-23 17:51:59
8f4d0ac3ac35eec7e2edca78a940466caf642c31...bc75ddbe38e532fd937558da676205180c5d2eff,1,1,1,2,1,2013-08-23 18:59:42,2013-08-23 18:59:42
bc75ddbe38e532fd937558da676205180c5d2eff...7b63274795fddefd828c8d6b7837fec0625499b7,3,4,4,8,3,2013-08-23 20:09:32,2013-08-23 20:09:32
f59fc64a20d57fe08be9fb6e53ab0022f6f6c732...14b6231e45a297d1306e0eb79c65628c43c1b0d4,3,39,22,61,12,2013-08-22 22:55:57,2013-08-22 22:55:57
14b6231e45a297d1306e0eb79c65628c43c1b0d4...cc74ee022b7ebfcbf94d3dc3415e3c92cb349be8,3,28,27,55,15,2013-08-22 23:49:57,2013-08-22 23:49:57
f59fc64a20d57fe08be9fb6e53ab0022f6f6c732...d89ba560d8de6dbd6bf1dd0cc3215e3614956791,2,7,3,10,4,2013-08-22 08:19:41,2013-08-22 08:19:41
f2cacbca7f7a04c4243098633ba9470a6fcdf3f3...4162116088948f23f6233dee26fb72bf3d570a3c,3,58,96,154,24,2013-07-11 20:14:18,2013-07-11 19:55:34
4162116088948f23f6233dee26fb72bf3d570a3c...595547389b59f537c675b0d2664fa505ee944bca,4,32,8,40,6,2013-07-11 20:48:46,2013-07-11 20:48:46
595547389b59f537c675b0d2664fa505ee944bca...5aba2e6864a5ffa9669b64e57167ef0334877188,3,13,13,26,8,2013-07-11 22:19:33,2013-07-11 22:19:33
a18c8a23fb960b604fc5cd8cadd046e30e0ae994...e4259453f6a59a02d81bed76325520496881f0a3,6,6,6,12,6,2014-01-09 23:36:18,2014-01-09 23:36:18
64eca0ae47610ff6c9efc0692d993ce11e5036aa...354f54dd32e306d817b0096d771269d17aaf991b,6,6,6,12,6,2013-08-23 21:18:53,2013-08-23 21:18:53
354f54dd32e306d817b0096d771269d17aaf991b...fc5a5864148fa995969aaf8347e48b82e4b3de5e,11,39,39,78,13,2013-08-27 05:39:58,2013-08-27 05:39:58
7d813c96e1cf7ab45f2e94d427f11afb2003bb41...f281e7c2964b698bbcd5510cca96bca2b6c93ee3,3,4,2,6,3,2013-07-12 00:21:38,2013-07-12 00:21:38
f281e7c2964b698bbcd5510cca96bca2b6c93ee3...95bc9f412b445010dbe9df048eda7c025d662fd1,8,35,10,45,12,2013-07-12 16:38:35,2013-07-12 16:38:35
fc5a5864148fa995969aaf8347e48b82e4b3de5e...8dc4ed81af778aada8f564cce85b383eca3bc0f5,3,7,15,22,3,2013-09-05 17:31:39,2013-09-05 17:31:39
8dc4ed81af778aada8f564cce85b383eca3bc0f5...d512a78d8586a6ee4bbe94737904fff05110ad61,3,5,14,19,7,2013-09-05 17:52:56,2013-09-05 17:52:56
fc5a5864148fa995969aaf8347e48b82e4b3de5e...4b3795e195133b5144ab944244bbc93a37f92d06,3,48,23,71,15,2013-08-30 22:10:48,2013-08-30 22:10:48
4b3795e195133b5144ab944244bbc93a37f92d06...340b1675b458681703406187309be296c9889a3c,3,13,5,18,3,2013-08-30 23:51:35,2013-08-30 23:30:26
340b1675b458681703406187309be296c9889a3c...abc9dbb07f43939e987d22e5ad1e09971e3fd37e,3,4,11,15,3,2013-08-31 00:09:24,2013-08-31 00:09:24
abc9dbb07f43939e987d22e5ad1e09971e3fd37e...36b8a0b1ff00ef550d97330ad519b019f8389d40,3,9,9,18,5,2013-08-31 00:29:59,2013-08-31 00:29:59
36b8a0b1ff00ef550d97330ad519b019f8389d40...85e738eac2c6e50e32cd9c8c3be07a1906a067ab,2,6,6,12,2,2013-08-31 10:10:10,2013-08-31 10:10:10
85e738eac2c6e50e32cd9c8c3be07a1906a067ab...ce12faee3bf5d4900cef1a0ff5471f8961a6c8f7,3,20,13,33,6,2013-08-31 14:10:00,2013-08-31 14:10:00
ce12faee3bf5d4900cef1a0ff5471f8961a6c8f7...637fa991629de13eba4b9e35aedda25ca0aa1cf3,3,3,3,6,3,2013-08-31 15:34:03,2013-08-31 15:34:03
fc5a5864148fa995969aaf8347e48b82e4b3de5e...7e2cf5adfc248ae4a36b1a98cfcdfb14ae6f8ca8,5,39,14,53,13,2013-08-28 09:05:30,2013-08-28 09:01:22
7e2cf5adfc248ae4a36b1a98cfcdfb14ae6f8ca8...39cb7e6df620b2b36c201e81d73f0896f3d85ba4,3,13,6,19,6,2013-09-05 05:37:25,2013-09-05 05:37:25
95bc9f412b445010dbe9df048eda7c025d662fd1...9be1fa235551261af05d738866a1881dab3c7d79,4,350,341,691,17,2013-07-19 02:47:51,2013-07-12 22:04:43
9be1fa235551261af05d738866a1881dab3c7d79...8c5558a6bad01dd58c22bd9f459dab83b81af41c,17,99,127,226,66,2013-07-19 03:08:56,2013-07-19 02:53:21
95bc9f412b445010dbe9df048eda7c025d662fd1...940d38d3aeb70d38e36359c27ec3ebd64a4a4288,4,14,18,32,6,2013-07-19 00:56:25,2013-07-19 00:56:25
95bc9f412b445010dbe9df048eda7c025d662fd1...2a4277ddad390449b725facead781ee55424a8a1,3,6,3,9,4,2013-07-18 19:07:41,2013-07-18 19:07:41
2a4277ddad390449b725facead781ee55424a8a1...e89b2783b6c26c32b0119a64a4d193740e7c8d26,3,15,20,35,14,2013-07-18 20:25:38,2013-07-18 20:25:38
95bc9f412b445010dbe9df048eda7c025d662fd1...be2bee767a21e4f4c84f34662fea5521e26e2a01,4,51,47,98,18,2013-07-18 17:07:14,2013-07-18 17:07:14
95bc9f412b445010dbe9df048eda7c025d662fd1...2bd0ad9a6425f9c5227198d5d6d1fecaedf4baf4,3,3,3,6,3,2013-07-16 17:48:46,2013-07-16 17:48:46
ba170a50541857ebb22d5351f38722f9acc15e17...45502ac0ec6bd6a1bb43cf0cfddaf3e6c1674fa1,2,3,3,6,3,2014-01-10 00:44:43,2014-01-10 00:44:43
45502ac0ec6bd6a1bb43cf0cfddaf3e6c1674fa1...5c6cc73906fcc778c070e1745281e33f7b792219,4,9,10,19,5,2014-01-10 05:40:47,2014-01-10 05:40:47
5c6cc73906fcc778c070e1745281e33f7b792219...f41170a2687b942447a080abfc52bcb0e37f5ca9,4,4,4,8,4,2014-01-10 17:52:03,2014-01-10 17:52:03
f41170a2687b942447a080abfc52bcb0e37f5ca9...ceee009ae1a04a57f0a252764cac0f66bd439f0d,1,1,1,2,1,2014-01-10 22:18:17,2014-01-10 22:18:17
ceee009ae1a04a57f0a252764cac0f66bd439f0d...657effbeea1d1dd1260893f545361c9599019782,9,32,44,76,17,2014-01-13 19:42:04,2014-01-13 19:39:15
a83ff054c93d172482be15ef35a87d07be92f43a...5f8056c1e4f41339c3d4d862545d7e21bf4d0e46,3,3,3,6,5,2013-09-05 18:53:01,2013-09-05 18:53:01
268af88a2aa981ba532ea0dab2a013897ac7fe67...dddef328ed7ef566ac7a6ed5f6f75d78289b603e,3,5,4,9,3,2013-07-19 03:30:09,2013-07-19 03:30:09
657effbeea1d1dd1260893f545361c9599019782...441e8a4f4dd286f10a4572a8cfda10aea69fdd1c,1,1,1,2,1,2014-01-15 22:34:25,2014-01-15 22:34:25
657effbeea1d1dd1260893f545361c9599019782...11466b24f244167a5664d03b8a701454b32898f4,1,20,0,20,1,2014-01-14 23:02:33,2014-01-14 23:02:33
11466b24f244167a5664d03b8a701454b32898f4...0238cacef4b672b17852b78eefdadec196c0abee,1,1,2,3,1,2014-01-14 23:15:26,2014-01-14 23:15:26
0238cacef4b672b17852b78eefdadec196c0abee...613824b5d29adff4bd74b4ac8d92d820efb121df,1,1,1,2,1,2014-01-15 07:14:28,2014-01-15 07:14:28
5f8056c1e4f41339c3d4d862545d7e21bf4d0e46...90d06cf08d18c46b0e1f0f51222d43888f6049e8,4,11,3,14,5,2013-09-19 03:36:54,2013-09-19 03:35:27
5f8056c1e4f41339c3d4d862545d7e21bf4d0e46...06e2077ff84a1db94b8e0d9274d4e5bfad82cd5d,4,5,5,10,4,2013-09-19 03:12:45,2013-09-19 03:06:37
5f8056c1e4f41339c3d4d862545d7e21bf4d0e46...eff0a11615ba84c42fe021939007f6b3c629486c,4,44,19,63,13,2013-09-16 23:09:47,2013-09-16 21:30:20
5f8056c1e4f41339c3d4d862545d7e21bf4d0e46...25630484b8f895737e8a781ffe3fb850ace8ef8b,3,1,4,5,3,2013-09-05 21:24:46,2013-09-05 20:31:03
dddef328ed7ef566ac7a6ed5f6f75d78289b603e...c247e1626118de41b3d40e2a711354f76e004343,1,10,0,10,1,2013-07-31 17:40:07,2013-07-31 17:40:07
dddef328ed7ef566ac7a6ed5f6f75d78289b603e...ab68440f2e84570171e6e7af7c859431d874b3a8,1,2,2,4,1,2013-07-29 20:27:08,2013-07-29 20:27:08
dddef328ed7ef566ac7a6ed5f6f75d78289b603e...fe5b68d096c9388f9bf7a5359aaef78a8049d363,1,3,2,5,2,2013-07-29 20:25:05,2013-07-29 20:25:05
dddef328ed7ef566ac7a6ed5f6f75d78289b603e...6d20d95c913ad6644511bfb603cc52bade5f9c9d,3,8,6,14,5,2013-07-29 17:24:53,2013-07-28 20:46:17
dddef328ed7ef566ac7a6ed5f6f75d78289b603e...4a7e69772a43bc478a3e6337ff85fdb21e8b3ead,1,1,1,2,1,2013-07-24 18:58:58,2013-07-24 18:58:58
4a7e69772a43bc478a3e6337ff85fdb21e8b3ead...48f27ae5cf38797d5de004bba8e7a8306c5cb932,1,1,1,2,1,2013-07-24 19:01:18,2013-07-24 19:01:18
48f27ae5cf38797d5de004bba8e7a8306c5cb932...1bec3a67b04cf244a504cb0b1585b0a57c893831,1,3,4,7,1,2013-07-24 20:51:35,2013-07-24 20:51:35
1bec3a67b04cf244a504cb0b1585b0a57c893831...1240174396963799208e734efdf8cf2cc2e80fb3,1,1,1,2,1,2013-07-24 20:59:28,2013-07-24 20:59:28
1240174396963799208e734efdf8cf2cc2e80fb3...5cb34b8f5f90f39d1ca3487b3a313170ce07b9ea,1,2,2,4,1,2013-07-24 21:04:52,2013-07-24 21:04:52
5cb34b8f5f90f39d1ca3487b3a313170ce07b9ea...0befad2225d5a31cd7fbf19f6b3b31ab2473f9af,1,1,1,2,1,2013-07-24 21:39:27,2013-07-24 21:39:27
dddef328ed7ef566ac7a6ed5f6f75d78289b603e...0015231c076457e1c3dfb3927adc8f1af8b25e04,4,19,11,30,4,2013-07-24 18:13:12,2013-07-24 18:11:45
dddef328ed7ef566ac7a6ed5f6f75d78289b603e...2fd0227a67a1f9b361da22debf0109544e6000be,3,6,5,11,5,2013-07-23 18:52:51,2013-07-23 18:52:51
2fd0227a67a1f9b361da22debf0109544e6000be...120fb558a6da5e7dd09da69d9101ea774744bc7a,3,70,49,119,16,2013-07-23 22:23:38,2013-07-23 22:23:38
120fb558a6da5e7dd09da69d9101ea774744bc7a...993017ff2297e9dd12283582cd915a6d6be92906,3,13,9,22,9,2013-07-31 20:28:41,2013-07-31 20:28:41
993017ff2297e9dd12283582cd915a6d6be92906...a85b05e8039aac4a08d065014c8a84e36cffedbf,3,29,24,53,18,2013-07-31 21:31:22,2013-07-31 21:31:22
a85b05e8039aac4a08d065014c8a84e36cffedbf...43f439e34f67f1a6ba0cd09d0ae96c70000f6f40,3,3,3,6,3,2013-07-31 21:39:01,2013-07-31 21:39:01
dddef328ed7ef566ac7a6ed5f6f75d78289b603e...c14858be790686422acb6623556265ee1f0f542f,4,16,5,21,4,2013-07-21 16:55:17,2013-07-21 16:55:17
c14858be790686422acb6623556265ee1f0f542f...4b839b655d3c013b98043b22df2bb1a59e4f18ae,3,3,3,6,3,2013-07-22 11:55:24,2013-07-22 11:55:24
441e8a4f4dd286f10a4572a8cfda10aea69fdd1c...8f771f58b99abf5fb6efd90c33de8a9c814ae6cc,2,33,2,35,3,2014-01-23 23:50:29,2014-01-23 23:50:29
13293dfde07674c82b12cb0f6f06383efbe134d7...4e4257f076f5c4f658ae97d2d11bde45fcb0f044,1,1,0,1,1,2014-01-21 02:51:51,2014-01-21 02:51:51
9ca071eee7db9720b41f860c626c11351462f488...113032bc977ec1d196280597b060e17083bda90d,4,61,28,89,9,2013-09-21 17:37:15,2013-09-21 17:31:07
c247e1626118de41b3d40e2a711354f76e004343...9192c11ba967ceee105cc6ff3cd1596ca6864fc4,2,7,7,14,4,2013-07-31 18:00:11,2013-07-31 18:00:11
46472b1d67aa6c2eaf4d932dc8468d5a2df2fe4f...23904ccb7087cdd50058e1f37ca346d18d20d796,4,5,5,10,5,2013-08-01 14:30:31,2013-08-01 14:30:31
23904ccb7087cdd50058e1f37ca346d18d20d796...b32286cea7110cdf72c45606d93d42b98ba4e550,3,3,3,6,3,2013-08-01 14:31:53,2013-08-01 14:31:35
b32286cea7110cdf72c45606d93d42b98ba4e550...4530a2e5263e03508779eceff9aea335648e8fe1,3,3,4,7,3,2013-08-01 14:33:51,2013-08-01 14:33:51
9f59f949f3dd91d9776b966fdc59e103f24fc862...8e8fcbe6eb4bc188ca01aa8446141f60a07f6a0f,2,36,6,42,9,2013-08-10 03:32:19,2013-08-10 03:32:19
8e8fcbe6eb4bc188ca01aa8446141f60a07f6a0f...774a081c0d6f66280211dcc52370c5bbbfcc0dfa,1,9,9,18,7,2013-08-10 03:52:03,2013-08-10 03:52:03
b3d9f5e63b62974acd4ce5848e4da3e241cca649...fee2a08eda2b18fefbae47b8f80875133dc7eac7,1,4,2,6,3,2014-02-11 19:33:51,2014-02-11 19:33:51
fee2a08eda2b18fefbae47b8f80875133dc7eac7...d42e8c7bc56259735b5affed8bde8b48c63567b4,1,5,0,5,2,2014-02-12 02:29:15,2014-02-12 02:29:15
b3d9f5e63b62974acd4ce5848e4da3e241cca649...92c831befe1c0d8f66fc51c9d16d6950b394a49b,1,1,1,2,1,2014-02-03 10:04:15,2014-02-03 10:04:15
7bb322f645de4766b3ea8acc6f65470330a9d035...58325a94191485b34272b86290ad98c21474ea15,3,7,7,14,7,2013-09-25 04:22:16,2013-09-25 04:21:10
58325a94191485b34272b86290ad98c21474ea15...863f618e4d445e5294026a25d01faec5edd1fd8b,3,3,3,6,3,2013-09-25 04:31:08,2013-09-25 04:31:08
7bb322f645de4766b3ea8acc6f65470330a9d035...31ea7dc0f1ff553c446d91591826ec2731fadff1,6,56,36,92,26,2013-09-24 19:39:33,2013-09-24 19:03:05
31ea7dc0f1ff553c446d91591826ec2731fadff1...9b8792c13d2a53f34069c95427ad7be3f58a2370,4,21,24,45,11,2013-09-25 18:15:32,2013-09-25 18:15:32
9b8792c13d2a53f34069c95427ad7be3f58a2370...db39176f24ca9ceb0d4ab897e87f5c8ba6104a2c,5,17,31,48,16,2013-09-25 18:24:28,2013-09-25 18:24:28
db39176f24ca9ceb0d4ab897e87f5c8ba6104a2c...88862d37c2f904be9eb13358ab1b9d25a20292c6,3,3,5,8,3,2013-09-25 18:39:46,2013-09-25 18:39:46
88862d37c2f904be9eb13358ab1b9d25a20292c6...876e764429bb4c1201b055d8cf7d5d353ed6226c,16,53,49,102,45,2013-09-25 18:43:53,2013-09-25 18:43:53
876e764429bb4c1201b055d8cf7d5d353ed6226c...68582505d9c2f2d40b35d099f75a34308d05a831,2,2,3,5,2,2013-09-25 18:44:50,2013-09-25 18:44:50
68582505d9c2f2d40b35d099f75a34308d05a831...0bf3fc1721e6aab8e76172e9131a46797525b642,3,7,7,14,7,2013-09-25 19:00:50,2013-09-25 19:00:50
7bb322f645de4766b3ea8acc6f65470330a9d035...b89c2d979bfdd543cce69698f3d588db1791af2c,5,74,28,102,25,2013-09-24 18:03:23,2013-09-24 17:49:46
b89c2d979bfdd543cce69698f3d588db1791af2c...ba48daa1e44b17d1597d381af8956864d6a5e826,3,23,19,42,5,2013-09-24 19:08:33,2013-09-24 19:08:33
23ee2c08a66bebca5373a2c034fd8f7858409645...41bfffe63ee47b3cd7b0ae7a2ef292e4819f3f12,3,3,3,6,3,2013-08-12 15:17:45,2013-08-12 15:17:45
23ee2c08a66bebca5373a2c034fd8f7858409645...bd0ce6cab8a2b0d2aaffc7ce21a873fc514eb8ed,4,64,161,225,26,2013-08-10 16:53:00,2013-06-29 17:12:34
bd0ce6cab8a2b0d2aaffc7ce21a873fc514eb8ed...3007e88970903bb381ffd9be2f9a6eb876b09e94,4,155,68,223,32,2013-08-10 17:33:02,2013-08-10 17:23:24
23ee2c08a66bebca5373a2c034fd8f7858409645...c7461b0de365dd8b75dfb83825557f2e124481ad,3,66,21,87,30,2013-08-10 04:09:43,2013-08-10 04:09:43
23ee2c08a66bebca5373a2c034fd8f7858409645...84793153d5f1b24c808fef283eddba36c2906630,4,38,2,40,4,2013-08-05 17:44:59,2013-08-05 17:44:59
84793153d5f1b24c808fef283eddba36c2906630...1462c5f6df9e277b8ecc9d27c9d434209a9c8132,3,3,5,8,3,2013-08-05 17:47:22,2013-08-05 17:47:22
23ee2c08a66bebca5373a2c034fd8f7858409645...7169511d5ba758cce42d57e585bc25029a012e7e,6,37,19,56,8,2013-08-02 22:03:24,2013-08-02 22:03:24
5c3d51c51579654960fd07f7673f47ce06ce2d83...0cb6cd9283bc8601aee42e397d4cce40adb08925,5,29,9,38,11,2014-02-18 16:38:48,2014-02-18 16:38:48
2c93d9c1924461708876781cdc96f139b205c33d...b641eb58b387a1e9804ba6ff35ae70ab494c2b09,3,6,6,12,4,2013-10-09 14:57:55,2013-10-09 14:57:55
2c93d9c1924461708876781cdc96f139b205c33d...f24f39b9670750c9fe7cf39f88851680d1a84a0e,1,2,0,2,1,2013-10-09 14:42:04,2013-10-09 14:42:04
f24f39b9670750c9fe7cf39f88851680d1a84a0e...9955196213b34e2562fffdeedcea3673b19719d8,1,10,0,10,1,2013-10-09 19:28:58,2013-10-09 16:09:48
9955196213b34e2562fffdeedcea3673b19719d8...f3e1925281523c8a8b93d9d694fb9367494a0f11,1,24,4,28,1,2013-10-09 19:30:28,2013-10-09 19:30:28
f3e1925281523c8a8b93d9d694fb9367494a0f11...bf932d061938bf0a80cab7b7c39fc346331fa923,2,25,21,46,2,2013-10-16 23:18:46,2013-10-16 23:10:20
bf932d061938bf0a80cab7b7c39fc346331fa923...3eb988fccdc031372f782762b7e6b6e1ea5ea35a,2,15,18,33,3,2013-10-17 00:12:08,2013-10-17 00:12:08
3eb988fccdc031372f782762b7e6b6e1ea5ea35a...4fa78bb0275c411b751032f7127bb72ef5f07bbf,2,9,5,14,3,2013-10-17 00:32:04,2013-10-17 00:32:04
2c93d9c1924461708876781cdc96f139b205c33d...0136ff9a39cb2f47532f4abf2999980d0d04309e,3,3,3,6,3,2013-10-07 22:27:41,2013-10-07 22:27:41
2c93d9c1924461708876781cdc96f139b205c33d...5c1bf0e35854dc18b4150eadaa102cf884268b1d,2,1515,0,1515,2,2013-10-05 21:09:52,2013-09-22 16:58:03
5c1bf0e35854dc18b4150eadaa102cf884268b1d...04bbf9f31848ee2ba9b84dcc0921d8bb2d8e8b60,6,965,953,1918,63,2013-10-05 21:10:26,2013-09-23 00:15:14
04bbf9f31848ee2ba9b84dcc0921d8bb2d8e8b60...e6740d16ad9d245d3fce3884b0d5532e14e80038,14,1321,2248,3569,77,2013-10-05 21:13:24,2013-09-23 05:22:20
e6740d16ad9d245d3fce3884b0d5532e14e80038...54990ad4f01a81c5ddb30d31dcccbdd0ad80fa7b,8,30,40,70,21,2013-10-05 21:13:51,2013-09-23 05:29:39
54990ad4f01a81c5ddb30d31dcccbdd0ad80fa7b...fa90206afdaa0a4742559e88378cfbeecd069c79,11,129,147,276,66,2013-10-05 21:14:10,2013-09-23 05:43:11
fa90206afdaa0a4742559e88378cfbeecd069c79...0b5625ca3b9de2a9f2227215ea3b2ad2f1f8af06,6,61,61,122,32,2013-10-05 21:14:22,2013-09-23 05:46:04
0b5625ca3b9de2a9f2227215ea3b2ad2f1f8af06...57d7c67de76b89468050848633d5b61cf3f104ef,8,447,449,896,88,2013-10-05 21:14:29,2013-09-23 06:24:52
57d7c67de76b89468050848633d5b61cf3f104ef...2ce71eaaf75bbd112e9c2d1b68d06576260c82b0,8,343,343,686,40,2013-10-05 21:14:42,2013-09-23 06:30:08
2ce71eaaf75bbd112e9c2d1b68d06576260c82b0...0531968e343f5b915c74143fa4d721aecf7c2fc2,2,10,10,20,8,2013-10-05 21:14:42,2013-09-23 06:32:42
0531968e343f5b915c74143fa4d721aecf7c2fc2...d8fe51732a1558681af4c7ae3111d77ba6cb0155,7,57,58,115,18,2013-10-05 21:14:48,2013-09-23 06:36:31
d8fe51732a1558681af4c7ae3111d77ba6cb0155...57b8379b69f68e12dc4a17fe31d6c3a21044052b,5,84,90,174,40,2013-10-05 21:14:53,2013-09-23 06:39:45
57b8379b69f68e12dc4a17fe31d6c3a21044052b...e4bb8f988dfb59745c39c8ff4f3ceacb74add003,3,34,34,68,24,2013-10-05 21:14:53,2013-09-23 06:46:25
e4bb8f988dfb59745c39c8ff4f3ceacb74add003...28d2d39cd84b2b514586bea515648bf8e450283b,5,16,16,32,12,2013-10-05 21:14:59,2013-09-23 06:48:56
28d2d39cd84b2b514586bea515648bf8e450283b...7ba007f5dda58af8c2a786114781bcbe28dad9b7,24,103,95,198,71,2013-10-05 21:18:31,2013-09-23 06:53:49
7ba007f5dda58af8c2a786114781bcbe28dad9b7...326bb317c430c8b19a9337985bc2280c937d9772,1,0,27,27,1,2013-10-05 21:18:31,2013-09-23 06:56:20
326bb317c430c8b19a9337985bc2280c937d9772...3283e24ed1d9c3d624481ed6b0d207b2cbe1b7da,3,3,3,6,3,2013-10-05 21:18:39,2013-09-23 06:56:37
3283e24ed1d9c3d624481ed6b0d207b2cbe1b7da...3c8808a842c21e539251502074d1b9df887865cc,4,5,9,14,5,2013-10-05 21:18:48,2013-09-23 07:06:38
3c8808a842c21e539251502074d1b9df887865cc...2377f7ccc4417e2b83134511fe90de92fbc54d77,5,91,86,177,49,2013-10-05 21:18:54,2013-09-23 07:27:02
2377f7ccc4417e2b83134511fe90de92fbc54d77...29a6fdadd2afb4362d01636c2c8b96ec6502e58b,3,15,15,30,3,2013-10-05 21:18:55,2013-09-23 07:30:13
29a6fdadd2afb4362d01636c2c8b96ec6502e58b...683d5fb526d7706794d671c6190b139c91ff753b,3,3,5,8,3,2013-10-05 21:19:00,2013-09-23 07:50:06
683d5fb526d7706794d671c6190b139c91ff753b...60a59fd5b9d51fb2db37e197afadc2906c863439,4,15,22,37,11,2013-10-05 21:19:06,2013-09-23 08:02:21
60a59fd5b9d51fb2db37e197afadc2906c863439...4b35157c7741d4e632b15d263dc4b447279d13db,5,119,177,296,15,2013-10-05 21:19:12,2013-09-23 16:02:20
4b35157c7741d4e632b15d263dc4b447279d13db...0a4d734b7811493597207b818043cea5fcc08626,3,3,3,6,3,2013-10-05 21:19:19,2013-09-23 16:40:07
0a4d734b7811493597207b818043cea5fcc08626...1cb4a1a7b52f9e6c9a6bc1b6eeecb866f345a6bf,7,60,59,119,37,2013-10-05 21:19:28,2013-09-23 16:47:45
1cb4a1a7b52f9e6c9a6bc1b6eeecb866f345a6bf...57e79a4489986a08810fae5f3cafb9bf5303a063,4,11,11,22,11,2013-10-05 21:19:28,2013-09-23 16:54:09
57e79a4489986a08810fae5f3cafb9bf5303a063...87b663c2827f801fba863745954ac1d9911426c6,3,3,3,6,3,2013-10-05 21:19:33,2013-09-23 18:36:37
87b663c2827f801fba863745954ac1d9911426c6...23ebbb04cd066c3ea4015f3a7a2550b953cd8b66,3,6,6,12,4,2013-10-05 21:19:38,2013-09-24 17:51:24
23ebbb04cd066c3ea4015f3a7a2550b953cd8b66...83950eca4da7ca37095c043222e049ea2a2dc5d2,3,11,14,25,9,2013-10-05 21:19:44,2013-09-24 17:58:59
83950eca4da7ca37095c043222e049ea2a2dc5d2...66ad0d2f6afa319ba437ec86ca026789981476f6,3,10,27,37,5,2013-10-05 21:19:49,2013-09-24 18:01:53
66ad0d2f6afa319ba437ec86ca026789981476f6...6f47f19d813f479ad9d4dddeb36488b19be54e06,3,20,16,36,6,2013-10-05 21:19:54,2013-09-24 18:05:14
6f47f19d813f479ad9d4dddeb36488b19be54e06...e01e43e3a97b18f771c53fc110c22acff7015777,3,13,18,31,9,2013-10-05 21:20:00,2013-09-24 18:07:51
e01e43e3a97b18f771c53fc110c22acff7015777...e405e1073e39f24106e85a872664de01e892c39f,3,5,5,10,3,2013-10-05 21:20:05,2013-09-24 18:10:09
e405e1073e39f24106e85a872664de01e892c39f...fc73f2e43c802e0c01d24b616624a89959e07800,1,24,0,24,1,2013-10-05 21:20:05,2013-09-24 20:22:13
fc73f2e43c802e0c01d24b616624a89959e07800...5bc83c30adebf145033fe6aa2ad588be2865defb,11,215,153,368,90,2013-10-05 21:20:19,2013-09-24 20:58:32
5bc83c30adebf145033fe6aa2ad588be2865defb...4f51b3f37feaa696ec0aabce6a80221b6093549e,4,45,27,72,17,2013-10-05 21:20:25,2013-10-03 04:04:00
4f51b3f37feaa696ec0aabce6a80221b6093549e...ebf9a94ac7e936a2ab8da2d49b111ee48282850b,3,50,7,57,5,2013-10-05 21:20:32,2013-10-05 18:15:43
ebf9a94ac7e936a2ab8da2d49b111ee48282850b...859d0c38186879054828e1b4a6be4c89c2da862d,3,15,9,24,11,2013-10-05 21:20:41,2013-10-05 20:05:13
859d0c38186879054828e1b4a6be4c89c2da862d...7910a7adbb9a62d0f4afb13b976fd995c0ab8122,3,7,3,10,5,2013-10-05 21:20:46,2013-10-05 20:17:21
7910a7adbb9a62d0f4afb13b976fd995c0ab8122...c23a3b481e98e01a57a2e913ab9ffbb5848d1c1d,3,3,3,6,3,2013-10-05 21:20:51,2013-10-05 20:28:15
c23a3b481e98e01a57a2e913ab9ffbb5848d1c1d...78ceaabbd86b2f32b629f62660fabed8ad950505,3,3,7,10,5,2013-10-05 21:20:55,2013-10-05 20:43:38
78ceaabbd86b2f32b629f62660fabed8ad950505...7a7d627f5b72b54e75d610a60231d69d7b3ce39b,3,5,11,16,8,2013-10-05 21:20:59,2013-10-05 20:47:23
7a7d627f5b72b54e75d610a60231d69d7b3ce39b...5a54a90f44b6193ce287414dc1d480588b1f0160,3,3,3,6,3,2013-10-05 21:21:04,2013-10-05 20:50:13
5a54a90f44b6193ce287414dc1d480588b1f0160...8c443d9aeec99a44d98184a26d3d9810956c04bb,3,4,4,8,4,2013-10-05 21:39:31,2013-10-05 21:39:31
8c443d9aeec99a44d98184a26d3d9810956c04bb...ee2476b09cb7c9af4c97f81ffc898dee6bf8a4bd,3,18,6,24,3,2013-10-05 21:59:03,2013-10-05 21:59:03
ee2476b09cb7c9af4c97f81ffc898dee6bf8a4bd...cf66cccb19922c40df0fcf38acec3dd3e6768df8,1,9,9,18,7,2013-10-05 22:32:36,2013-10-05 22:26:47
cf66cccb19922c40df0fcf38acec3dd3e6768df8...9e13eff5fdca6e213a15a30c46e7b8c6ba28161f,3,65,66,131,9,2013-10-07 16:00:34,2013-10-07 16:00:34
9e13eff5fdca6e213a15a30c46e7b8c6ba28161f...dc8a61595f375c45abb2c9a01eeea2fdbe1fc554,3,6,9,15,7,2013-10-07 16:06:01,2013-10-07 16:06:01
2c93d9c1924461708876781cdc96f139b205c33d...c9e0b679485c54aa55f75c0758975600965da0e8,3,16,23,39,10,2013-10-05 17:31:24,2013-10-05 17:31:24
2c93d9c1924461708876781cdc96f139b205c33d...b0659e0ce28d08faf88cd9c4086bf9d2022ac85d,8,259,184,443,44,2013-10-03 15:57:54,2013-10-03 14:46:22
b0659e0ce28d08faf88cd9c4086bf9d2022ac85d...b5b05d5c11f0916f4120c9b8cb791c606dbaddc0,3,10,9,19,9,2013-10-03 16:20:44,2013-10-03 16:20:44
b5b05d5c11f0916f4120c9b8cb791c606dbaddc0...3ef3ae46172a6ac0dffdec6aa07e24562cd93c01,3,53,61,114,19,2013-10-03 18:34:18,2013-10-03 18:34:18
3ef3ae46172a6ac0dffdec6aa07e24562cd93c01...d23919fe82fcaab224c143fd72f518f6862f185c,4,5,5,10,5,2013-10-03 20:08:48,2013-10-03 20:08:48
2c93d9c1924461708876781cdc96f139b205c33d...cc5d006739e3dcef669158eadf94afd9481179ff,4,62,5,67,6,2013-10-02 09:49:30,2013-10-02 09:48:34
328cd9f17f27fa1df7d6d58269ed1bb0b85b93e4...c6f9932035449a7efe942b55aa57a0eccf6b4fe7,3,6,6,12,4,2013-09-26 21:38:01,2013-09-26 21:38:01
a76aed5852a30a860176d3094bd0fc0ffa413ced...9eb878ec7d3e4e2044b29ccba325821a3d70f495,8,34,39,73,29,2013-09-26 15:51:35,2013-09-26 14:52:02
9eb878ec7d3e4e2044b29ccba325821a3d70f495...d2ad436fed9f2238b27f7978ef72efed76f12ed1,4,30,35,65,14,2013-09-26 21:08:16,2013-09-26 21:08:16
41bfffe63ee47b3cd7b0ae7a2ef292e4819f3f12...0e42a9af17ff2b2b38b2b98d60b156ceae869a2b,5,95,63,158,18,2013-08-16 11:58:26,2013-04-19 19:17:45
0e42a9af17ff2b2b38b2b98d60b156ceae869a2b...8cad72018c3ea80b2803543359e166aac8f259c3,3,3,3,6,3,2013-08-16 11:58:26,2013-05-08 10:01:36
8cad72018c3ea80b2803543359e166aac8f259c3...9ce9ac484af5ea7d652fa748150e395878f27537,6,96,19,115,17,2013-08-16 11:58:41,2013-05-08 15:41:01
9ce9ac484af5ea7d652fa748150e395878f27537...2045a756e911550d74d34a7d8cac6b801fa14225,1,48,8,56,8,2013-08-16 11:58:41,2013-05-08 15:57:00
2045a756e911550d74d34a7d8cac6b801fa14225...99ec34ac829a44af39058728f3869ef7a8b82d43,4,16,7,23,6,2013-08-16 11:58:45,2013-05-08 16:30:45
41bfffe63ee47b3cd7b0ae7a2ef292e4819f3f12...e7e6c3a6168c8997ae4c6125282372696a5be50c,7,75,22,97,8,2013-08-12 23:33:20,2013-08-09 19:34:41
e7e6c3a6168c8997ae4c6125282372696a5be50c...76d52a239644436dc11e031f5fdc56e030356181,3,44,34,78,16,2013-08-12 23:34:03,2013-08-11 07:13:24
76d52a239644436dc11e031f5fdc56e030356181...3a11f933cad65f51d2fca3b7b9aad9c76e3458f8,3,66,6,72,11,2013-08-12 23:34:19,2013-08-12 21:37:24
3a11f933cad65f51d2fca3b7b9aad9c76e3458f8...1a54808d8f04d733b231f1acae5c9ce150af545d,3,6,10,16,6,2013-08-12 23:35:17,2013-08-12 23:32:40
1a54808d8f04d733b231f1acae5c9ce150af545d...7bf2524be324f57ca30de46a115d3e65d91a08df,3,5,1,6,3,2013-08-12 23:39:23,2013-08-12 23:39:23
7bf2524be324f57ca30de46a115d3e65d91a08df...f18298b8ae5a277a02e2d231b292e67968ba9f6a,3,14,9,23,7,2013-08-12 23:47:39,2013-08-12 23:47:39
f18298b8ae5a277a02e2d231b292e67968ba9f6a...9732e0c93e81b4111181b94229cd94d21f9d6061,3,4,14,18,6,2013-08-12 23:50:08,2013-08-12 23:50:08
9732e0c93e81b4111181b94229cd94d21f9d6061...fb4f262440207e17a26789d72511753e34633dc6,3,10,14,24,7,2013-08-13 00:08:58,2013-08-13 00:08:58
fb4f262440207e17a26789d72511753e34633dc6...e7a1ff72a8a6df437e6e9a4f65fb3c5e67488c77,3,25,11,36,16,2013-08-13 17:07:51,2013-08-13 17:07:51
e7a1ff72a8a6df437e6e9a4f65fb3c5e67488c77...f1e796a99f3fdf628233285e355c6b1a09e0289a,4,142,103,245,58,2013-08-13 18:00:38,2013-08-13 18:00:38
04fa5dd3856de768b43b4aac9e34c112f1227a17...bef5de751097c490332b5425415c59e71c8e480e,4,16,12,28,8,2014-02-27 00:29:52,2014-02-27 00:22:40
04fa5dd3856de768b43b4aac9e34c112f1227a17...480bb42754f6c13db726f962b2e692573eb8d96a,3,7,3,10,3,2014-02-26 19:20:03,2014-02-26 19:20:03
480bb42754f6c13db726f962b2e692573eb8d96a...02cca0b69cddeb8a32a6e75c30f69fe788a88c0f,4,9,9,18,6,2014-02-26 19:28:20,2014-02-26 19:28:20
af6a4e027e188ebc5f1b4490d3c12de2fc43cbee...e3c3e5487c12293ee2be3bd05d684caa659c349b,7,184,256,440,42,2013-10-11 00:19:13,2013-10-11 00:19:13
e3c3e5487c12293ee2be3bd05d684caa659c349b...39bc3710c9da86cf0a836da4e91ea18a0bb22899,3,11,3186,3197,3,2013-10-11 03:49:09,2013-10-11 03:49:09
39bc3710c9da86cf0a836da4e91ea18a0bb22899...23fd3d48925973836e744757f47f82f867dec5a2,2,10,0,10,2,2013-10-11 03:51:20,2013-10-11 03:51:20
23fd3d48925973836e744757f47f82f867dec5a2...bfcdc045a53fb5f184236c7e3b687b62327beea8,2,2,2,4,2,2013-10-11 03:53:19,2013-10-11 03:53:19
8c1a7059691c0b93680aba6f08ffa6fe29bb4e7f...097a3a07ba2a1a875dbd9c5dfff31fcada4c970c,6,6,6,12,6,2013-10-09 15:10:05,2013-10-09 15:10:05
097a3a07ba2a1a875dbd9c5dfff31fcada4c970c...cc00e6610021fb998ad019408ced7301f95d3f99,2,24,16,40,16,2013-10-09 15:13:22,2013-10-09 15:13:22
cc00e6610021fb998ad019408ced7301f95d3f99...ec2eadb1fe42d4fd306de497999172472e3f9daa,4,55,11,66,4,2013-10-09 15:41:42,2013-10-09 15:37:37
ec2eadb1fe42d4fd306de497999172472e3f9daa...07e47a5be908ae2f0c96c2e731c663db8f5b5ffa,3,4,3,7,4,2013-10-09 15:43:03,2013-10-09 15:43:03
07e47a5be908ae2f0c96c2e731c663db8f5b5ffa...ab53db6ec76115a64ea9ab35a465a0181516d501,3,19,16,35,5,2013-10-09 16:07:16,2013-10-09 16:07:16
ab53db6ec76115a64ea9ab35a465a0181516d501...017e64074f7da8c2e3364977bf878c45e2b1f37a,4,43,32,75,18,2013-10-09 21:43:35,2013-10-09 21:43:35
017e64074f7da8c2e3364977bf878c45e2b1f37a...b093c2d3d3b836294141fd94bef80226c42e0528,4,25,27,52,10,2013-10-09 23:46:23,2013-10-09 23:46:23
b093c2d3d3b836294141fd94bef80226c42e0528...aa2a9164353e3aeb5bb6a1f471d83bbf8eb2ab86,3,7,12,19,8,2013-10-09 23:53:12,2013-10-09 23:53:12
aa2a9164353e3aeb5bb6a1f471d83bbf8eb2ab86...8ed6883362d9f8663b53c97ed27f13b96c572cd6,3,3,3,6,3,2013-10-10 04:22:44,2013-10-10 04:22:44
8ed6883362d9f8663b53c97ed27f13b96c572cd6...3aaa7285574aff7e03a297977277215c94f6faa6,1,5,7,12,1,2013-10-10 05:11:07,2013-10-10 05:11:07
3aaa7285574aff7e03a297977277215c94f6faa6...1a7fb59bd25cf4a9091ef32c82fe25658e81a7cb,3,26,27,53,10,2013-10-10 15:26:30,2013-10-10 15:26:30
1a7fb59bd25cf4a9091ef32c82fe25658e81a7cb...cde0176ed22b0a020156a613f3ad01d150da2bdc,5,60,60,120,37,2013-10-10 15:36:59,2013-10-10 15:36:59
cde0176ed22b0a020156a613f3ad01d150da2bdc...0103e25850b3b1faedf581efd010416f300470d2,4,30,29,59,16,2013-10-10 15:44:29,2013-10-10 15:44:29
dd62c56d596548f1ca9e39e5388ef3c2adbc313d...d03648090cdb20457b5709dc7bfc88d692c13573,3,45,29,74,5,2013-10-17 16:11:22,2013-10-17 16:11:22
a4bd16705e2a054f570310d6a8adac663923ab92...a120375e56259b9b3c4869582fa71b776e5d1e99,1,1,1,2,1,2014-03-09 18:14:50,2014-03-09 18:14:50
a4bd16705e2a054f570310d6a8adac663923ab92...3a0d42a8762d6de979720cfb943383a55e2f9929,7,68,52,120,19,2014-03-04 16:26:28,2014-03-04 16:19:02
3a0d42a8762d6de979720cfb943383a55e2f9929...4adf73bf3832c4cdf26e692feaf4b3f3bcb77513,12,123,128,251,28,2014-03-04 16:38:07,2014-03-04 16:38:07
4adf73bf3832c4cdf26e692feaf4b3f3bcb77513...5cc801c4ff821cec353c809daab2fdeb2a398c92,12,24,50,74,26,2014-03-04 16:50:46,2014-03-04 16:50:46
5cc801c4ff821cec353c809daab2fdeb2a398c92...51a9408b4c84929a1429559187c46449a706a231,17,136,173,309,24,2014-03-04 17:12:33,2014-03-04 17:12:33
51a9408b4c84929a1429559187c46449a706a231...aef873286d4a6627751f15d081979aeef217caee,4,12,15,27,9,2014-03-04 17:20:45,2014-03-04 17:20:45
a4bd16705e2a054f570310d6a8adac663923ab92...78ffbfa008975c4fbe168b0eedab3c87efc7b2eb,3,3,5,8,3,2014-02-27 22:48:48,2014-02-27 22:48:48
bfcdc045a53fb5f184236c7e3b687b62327beea8...4b36e850dc46853b5b2fd40b2752c5a164e0ceb5,3,18,16,34,5,2013-10-11 18:41:02,2013-10-11 18:40:10
4b36e850dc46853b5b2fd40b2752c5a164e0ceb5...6fd46253a3cd7689611f8053b23535fcf3f23bc4,3,10,4,14,3,2013-10-12 04:06:01,2013-10-12 04:06:01
bfcdc045a53fb5f184236c7e3b687b62327beea8...2a7d873b3fadc4c808b2724db9b0663aa476583b,22,299,287,586,42,2013-10-11 15:12:03,2013-10-11 15:11:04
2a7d873b3fadc4c808b2724db9b0663aa476583b...378d7eee3e08815755fefd08126e3f9620e5e29f,2,7,2,9,2,2013-10-12 04:24:28,2013-10-12 04:24:28
bfcdc045a53fb5f184236c7e3b687b62327beea8...7b4a772f49caa04aa4f68c4dfa8242065b19a673,4,17,5,22,4,2013-10-11 10:41:55,2013-10-11 10:41:55
7b4a772f49caa04aa4f68c4dfa8242065b19a673...c8a7d3d5be14f525a8dff17aeb5253237ee6cd3e,3,5,7,12,7,2013-10-12 04:21:26,2013-10-12 04:21:26
bfcdc045a53fb5f184236c7e3b687b62327beea8...e7c76cc28461ac4bba3f2f2cfb2159ceea9dca63,7,256,184,440,42,2013-10-11 03:53:25,2013-10-11 00:30:47
e7c76cc28461ac4bba3f2f2cfb2159ceea9dca63...78c3726938c0afbf61037d213cdce6dfef61a29c,5,33,18,51,17,2013-10-11 08:30:56,2013-10-11 08:16:57
a120375e56259b9b3c4869582fa71b776e5d1e99...eb404805a6bc91c8ebaf05511631445e62262cc5,1,16,0,16,1,2014-03-13 13:30:06,2014-03-13 13:30:06
ed54503fc7781d8bfe9e9fe125b76b9bbb5ac05c...91506b31eab565e632b7e6a3014bda766ce60efb,3,20,15,35,9,2013-10-25 21:53:47,2013-10-25 21:53:47
ed54503fc7781d8bfe9e9fe125b76b9bbb5ac05c...855061dc98b1460b8278bd6bf9193ed428ff3742,4,63,35,98,8,2013-10-15 21:43:09,2013-10-15 21:43:09
855061dc98b1460b8278bd6bf9193ed428ff3742...9c1cd931500052bfe13824b2a6110cd7e6ccb8a0,3,73,55,128,7,2013-10-16 15:47:09,2013-10-16 15:47:09
9c1cd931500052bfe13824b2a6110cd7e6ccb8a0...1dd2f402c9face560a27188379df9dcaa3cfbf03,6,84,84,168,11,2013-10-16 16:13:43,2013-10-16 16:13:43
17b4acf410dea7553ec460dffbfc5e4b1fa36dd7...cc64f19b947dd16718b5a8046a54190d0cd3e4bf,2,136,0,136,2,2014-03-17 13:11:34,2014-03-17 13:11:34
87acef2e6f989292ce3cd82210212bed3acf2807...249c01e0ba55a493458a879ba880b6d691e574c3,2,2,2,4,2,2013-11-11 21:06:20,2013-11-11 21:06:20
87acef2e6f989292ce3cd82210212bed3acf2807...85712855b76782e9df24c77881a558e0f808ecac,2,2,2,4,2,2013-11-04 19:41:48,2013-11-04 19:41:48
85712855b76782e9df24c77881a558e0f808ecac...748c28186e8f7e7078f314a7b6b4a99f2dd23e21,2,4,4,8,4,2013-11-04 20:03:23,2013-11-04 20:03:23
e4d5da3dc7cf3d0bde8e0afc945b8e7be04a2392...a2fae346b01bcbd7f9de3d779d494889b3b9ea96,1,12,12,24,3,2014-03-22 04:50:22,2014-03-22 04:50:22
e4d5da3dc7cf3d0bde8e0afc945b8e7be04a2392...260d144ba29b0417ba0243a00c66a90f3ee02956,2,17,1,18,2,2014-03-20 14:20:55,2014-03-20 14:20:55
260d144ba29b0417ba0243a00c66a90f3ee02956...8e1ec1e74ba68c0bb68ccd0257a37064e03d7b50,2,2,2,4,2,2014-03-20 14:24:57,2014-03-20 14:24:57
e4d5da3dc7cf3d0bde8e0afc945b8e7be04a2392...01b35e9539ab64db8d28cad61f81aa0cbd296ab9,3,3,1,4,3,2014-03-19 16:58:41,2014-03-19 16:58:41
01b35e9539ab64db8d28cad61f81aa0cbd296ab9...1d1622569b64f7a57b4c753f4487ef1c68cdb7a6,5,100,63,163,27,2014-03-19 21:00:58,2014-03-19 21:00:58
1d1622569b64f7a57b4c753f4487ef1c68cdb7a6...1ce09c9b9308cdceeb75c838c8951a6b35a43008,4,17,13,30,8,2014-03-19 21:42:12,2014-03-19 21:42:12
1ce09c9b9308cdceeb75c838c8951a6b35a43008...71327d2667d16c891c0e318da3a8d37cb0fede72,3,7,39,46,5,2014-03-20 18:31:20,2014-03-20 18:31:20
71327d2667d16c891c0e318da3a8d37cb0fede72...015c20be6162e97c5de0e06af30a79b75fec78ea,4,102,102,204,64,2014-03-23 21:10:55,2014-03-23 21:10:55
249c01e0ba55a493458a879ba880b6d691e574c3...f2347b4ea1e25f18ff1864576d8e0180e823ba38,1,25,0,25,1,2013-11-18 22:08:13,2013-11-18 22:08:13
249c01e0ba55a493458a879ba880b6d691e574c3...d12b3529f15ed6776659f37e0f5c455efcf1df95,1,5,5,10,5,2013-11-18 15:49:31,2013-11-18 15:35:44
249c01e0ba55a493458a879ba880b6d691e574c3...f2525e9ba5b3ea2e668df944853dc1c5732c2910,1,5,0,5,1,2013-11-15 10:43:23,2013-11-15 10:43:23
8e1ec1e74ba68c0bb68ccd0257a37064e03d7b50...17e1f967304f75637405133a4d97cca7b6c31c54,2,136,0,136,2,2014-03-21 21:04:36,2014-03-21 21:04:36
d12b3529f15ed6776659f37e0f5c455efcf1df95...764365425f9c7800d98298349df96e2d4848928d,1,49,80,129,9,2013-11-18 15:55:42,2013-11-18 15:35:29
d12b3529f15ed6776659f37e0f5c455efcf1df95...36d8060d8dd8084bf19e8ec3d0b87f01e7304b08,1,49,80,129,9,2013-11-18 15:50:23,2013-11-18 15:35:29
f2525e9ba5b3ea2e668df944853dc1c5732c2910...242e3518d32c13249b787f7001901b6762dd5013,1,8,1,9,2,2013-11-25 12:26:45,2013-11-25 12:26:45
adeaf20195dc45dfb80cc44dc4a93efd551ec839...3c7cc81b6233289263525b581d635ad9f8d9dd37,8,173,32,205,24,2014-03-24 05:51:07,2014-03-06 17:58:37
3c7cc81b6233289263525b581d635ad9f8d9dd37...90b6c0b913c5c19bec496054b2bcf2a75ce98244,4,14,14,28,9,2014-03-24 05:51:07,2014-03-07 04:17:03
90b6c0b913c5c19bec496054b2bcf2a75ce98244...947c609050dcc7e16198e832d5ba6db7349a6fa2,4,8,7,15,5,2014-03-24 05:51:26,2014-03-17 04:05:12
947c609050dcc7e16198e832d5ba6db7349a6fa2...ee23f941412cd45410dabb023bd6c113a6f8bb2e,3,3,1,4,3,2014-03-24 05:51:47,2014-03-19 16:58:41
ee23f941412cd45410dabb023bd6c113a6f8bb2e...387249155f757a0aff7a57a1a3a4a608dbe7e5ac,5,100,63,163,27,2014-03-24 05:52:06,2014-03-19 21:00:58
387249155f757a0aff7a57a1a3a4a608dbe7e5ac...467f1490c9da046b64f2069641e021c522b27190,4,17,13,30,8,2014-03-24 05:52:13,2014-03-19 21:42:12
467f1490c9da046b64f2069641e021c522b27190...2b148070553c9493cae01d4960d283ec5bdf957f,3,7,39,46,5,2014-03-24 05:52:19,2014-03-20 18:31:20
2b148070553c9493cae01d4960d283ec5bdf957f...defe5bc848f88b7497766061210d34f359456b87,3,10,3,13,3,2014-03-24 05:52:25,2014-03-23 00:17:04
defe5bc848f88b7497766061210d34f359456b87...336f3afc8cff431fe2a240a437999135253e6d9e,3,7,7,14,3,2014-03-24 05:52:31,2013-07-09 19:17:31
336f3afc8cff431fe2a240a437999135253e6d9e...086de835b228e51befd48dc24a47768b8a946072,3,3,5,8,3,2014-03-24 05:52:42,2013-07-09 21:15:23
086de835b228e51befd48dc24a47768b8a946072...d9768e527d2c009cc5d0f8b57ebf560a4e9fa5aa,1,12,12,24,4,2014-03-24 05:52:42,2014-02-04 19:50:09
d9768e527d2c009cc5d0f8b57ebf560a4e9fa5aa...e03b6454294e1c0bbe3125f787df56c468658d4e,3,23,25,48,5,2014-03-24 05:52:46,2014-02-27 22:48:48
e03b6454294e1c0bbe3125f787df56c468658d4e...f9e00b1d3590aeb295607fc9e5498f99c975aedc,4,98,98,196,64,2014-03-24 05:52:50,2014-03-23 21:10:55
f9e00b1d3590aeb295607fc9e5498f99c975aedc...d6ca25e87daf2849b6494051ccab0bd289264088,4,5,3,8,4,2014-03-24 05:52:50,2014-03-23 21:37:40
d6ca25e87daf2849b6494051ccab0bd289264088...91531cf7ffed5d474ba70f584176d1d93b2377e9,4,52,11,63,6,2014-03-24 05:52:54,2014-03-24 04:37:34
91531cf7ffed5d474ba70f584176d1d93b2377e9...621558c28f0c31c84fe62596ced30212d4c41d46,6,42,37,79,18,2014-03-24 05:52:59,2014-03-24 05:09:53
621558c28f0c31c84fe62596ced30212d4c41d46...fe797df41eb2dc3af237146c4097d64123927040,4,11,10,21,6,2014-03-24 05:53:03,2014-03-24 05:29:17
fe797df41eb2dc3af237146c4097d64123927040...28538c40d209b8db8cbd4abbbf5c323aa362ccf4,4,8,6,14,4,2014-03-24 05:53:07,2014-03-24 05:37:49
28538c40d209b8db8cbd4abbbf5c323aa362ccf4...b86e4e4ae146bf807c966785ac86f6b967359ca2,4,5,1,6,5,2014-03-24 05:53:07,2014-03-24 05:42:28
b86e4e4ae146bf807c966785ac86f6b967359ca2...abbe1c75c16c3e9cb08b1d0872f4a19890d3bb58,4,12,3,15,4,2014-03-24 05:53:07,2014-03-24 05:46:33
abbe1c75c16c3e9cb08b1d0872f4a19890d3bb58...d3bbf394afd0ce0b2721275fa224f5315c1af0a0,3,27,33,60,8,2014-03-24 05:57:35,2014-03-24 05:57:35
d3bbf394afd0ce0b2721275fa224f5315c1af0a0...994235b3f992573d230e6518cdfa2031b0ab56e4,1,5,5,10,1,2014-03-24 16:02:48,2014-03-24 16:02:48
70a16b58b0b567688843b801a9b352273c7d8ead...32e73ca18ad01d9d6e92930a478f5e254f5d23b9,4,4,4,8,4,2013-11-19 17:16:05,2013-11-17 17:11:37
70a16b58b0b567688843b801a9b352273c7d8ead...11a4a6ef68d3666ab35e05006e3d5f596c326950,3,22,11,33,5,2013-11-19 17:15:42,2013-11-09 09:53:19
11a4a6ef68d3666ab35e05006e3d5f596c326950...dfdcb3934425b2136da788ca62b0724b90f32184,3,22,34,56,9,2013-11-19 17:15:42,2013-11-19 17:12:09
8c5ea716005eb914295da9c4cdb6b8bfa7b7a660...c2f2d43f2da2b9afef033d31b2e8bd745a2fb2ec,1,3,5,8,3,2013-11-19 02:39:57,2013-11-19 02:39:57
c2f2d43f2da2b9afef033d31b2e8bd745a2fb2ec...59bdea2e945763fde8bcd60065ce5381e9bf10d6,1,4,2,6,3,2013-11-19 02:40:46,2013-11-19 02:40:46
59bdea2e945763fde8bcd60065ce5381e9bf10d6...5f134738c1ab5f1989073e4de4e0c161ef6a8506,1,6,0,6,1,2013-11-19 02:47:48,2013-11-19 02:47:48
5f134738c1ab5f1989073e4de4e0c161ef6a8506...07f5351fdc237dfd16188b2640e4135971aa89a3,1,5,4,9,3,2013-11-19 02:54:16,2013-11-19 02:54:16
07f5351fdc237dfd16188b2640e4135971aa89a3...6571cb92421362a0aee48680b7aa6c6e35b2116f,2,27,72,99,5,2013-11-19 02:54:32,2013-11-19 02:54:32
4e9cbcb32b79c0542d81dc21fe10cc93bcb69a7a...97d9cb30a833a5b9f1e790f7a71063c43c9539e5,1,3,3,6,3,2013-12-05 08:05:38,2013-12-05 08:05:38
4e9cbcb32b79c0542d81dc21fe10cc93bcb69a7a...c5e2d3d843e2a5f294fb3dc86051364b305e0ea8,3,16,4,20,5,2013-12-04 18:00:18,2013-12-04 18:00:18
696c6d8461847b16335b47db4d68cb3d26447f90...b2c4c9a5bb074dc13cfc26296094b5e5e620098e,1,2,0,2,1,2013-11-20 20:59:08,2013-11-20 20:59:08
b2c4c9a5bb074dc13cfc26296094b5e5e620098e...525cbbfee88d5203abb7b19592046431079c3d81,1,1,1,2,1,2013-11-20 23:25:24,2013-11-20 23:25:24
fa55eead411a3c1b01703cb1ddfd59ccc0b23124...4adb0c24f5967ed221863fcebcd9a071fa4e9a71,4,75,133,208,18,2014-04-06 04:41:03,2014-04-06 04:29:31
4adb0c24f5967ed221863fcebcd9a071fa4e9a71...500538afe26dab09dcaff53368ebac4057f37c1f,4,9,8,17,4,2014-04-06 04:50:33,2014-04-06 04:50:33
500538afe26dab09dcaff53368ebac4057f37c1f...8b32c70d79ffbd286f2716228c8629e62f67ba4b,1,41,0,41,1,2014-04-06 05:05:11,2014-04-06 05:05:11
8b32c70d79ffbd286f2716228c8629e62f67ba4b...253631cbe890567a3624b97ebc30c5344f9a6a77,1,7,17,24,2,2014-04-06 05:24:21,2014-04-06 05:24:21
fa55eead411a3c1b01703cb1ddfd59ccc0b23124...a264d55e1507c2f9fdcbfc75bfeae937a2b085ff,4,29,16,45,14,2014-04-04 13:29:23,2014-04-04 13:29:23
fa55eead411a3c1b01703cb1ddfd59ccc0b23124...40551b770162ba8e002a5f05e5cc1a73b55b572c,1,56,0,56,1,2014-04-02 17:28:44,2014-04-02 17:28:44
40551b770162ba8e002a5f05e5cc1a73b55b572c...7d638022d137b49feb4a2cd7b9bf37e57e2f5605,1,1,1,2,1,2014-04-02 17:30:06,2014-04-02 17:30:06
fa55eead411a3c1b01703cb1ddfd59ccc0b23124...4757f0f1fcb5b260b8c45221d11fe505839d9de0,3,76,2,78,5,2014-04-02 03:34:15,2014-04-02 03:34:15
4757f0f1fcb5b260b8c45221d11fe505839d9de0...cde8be4bfc7c0f2d86e30a5c6733e9398a0d8f11,3,61,41,102,9,2014-04-02 03:57:34,2014-04-02 03:57:34
cde8be4bfc7c0f2d86e30a5c6733e9398a0d8f11...b1284d48e5558e34ff4c7d99bacea61d2b805884,3,22,13,35,9,2014-04-02 15:45:24,2014-04-02 15:43:54
b1284d48e5558e34ff4c7d99bacea61d2b805884...e0f9e15ade998ec348bcb6f28ed59a064ac9f05a,3,3,3,6,3,2014-04-02 15:52:13,2014-04-02 15:52:13
e0f9e15ade998ec348bcb6f28ed59a064ac9f05a...08e6fed14f77f91b590f6e9ff33f0446b85540d1,3,3,3,6,3,2014-04-10 13:55:37,2014-04-10 13:55:37
08e6fed14f77f91b590f6e9ff33f0446b85540d1...ad4444d494c9b251b6730f558bdbeefb5812e910,3,92,91,183,14,2014-05-05 03:39:15,2014-05-05 03:39:15
fa55eead411a3c1b01703cb1ddfd59ccc0b23124...fdef5d5722b692c2ea174f811bfd373b49f013c4,4,23,23,46,18,2014-03-27 21:36:46,2014-03-27 21:19:59
fdef5d5722b692c2ea174f811bfd373b49f013c4...3dbdf87974dc2588c29db0533a8500ccddb25daa,16,565,53,618,56,2014-03-27 21:37:10,2013-05-16 08:06:49
fa55eead411a3c1b01703cb1ddfd59ccc0b23124...f2c2c428db625f45206388e9506890b28c095538,4,22,17,39,9,2014-03-26 18:56:41,2014-03-26 18:24:41
f2c2c428db625f45206388e9506890b28c095538...8ca065d7722e69ab24a004c386fe05588c1f458f,3,10,10,20,3,2014-03-26 20:14:42,2014-03-26 20:14:42
9ade1b443a5024244120774333d8846211931a1b...317740be1b9170b6cd2bed970e6f37753bca81ff,1,18,0,18,1,2013-11-23 11:04:37,2013-11-23 11:04:37
317740be1b9170b6cd2bed970e6f37753bca81ff...fb584cfa8fb8d082072c514b6467cc2b883b0f13,1,7,7,14,3,2013-11-23 11:11:59,2013-11-23 11:11:59
fb584cfa8fb8d082072c514b6467cc2b883b0f13...cd40989995f242ec323e16960803cf521ca31587,1,2,0,2,1,2013-11-23 11:13:05,2013-11-23 11:13:05
cd40989995f242ec323e16960803cf521ca31587...e57b50edfa79c708e3a330db8325e0027643740e,1,0,2,2,1,2013-11-23 11:15:04,2013-11-23 11:15:04
e57b50edfa79c708e3a330db8325e0027643740e...e4af0902244876ebe32126bf70daed8133eb7c38,1,21,17,38,11,2013-12-04 13:03:12,2013-12-04 13:03:12
e4af0902244876ebe32126bf70daed8133eb7c38...bfce5d5d11a30615b132be071ff320c46ce13417,5,49,42,91,19,2013-12-04 13:40:56,2013-12-04 13:40:56
bfce5d5d11a30615b132be071ff320c46ce13417...19789b6821aeaa4917bead0c5a24a384eac58539,1,1,1,2,1,2013-12-04 13:41:34,2013-12-04 13:41:34
f46d8d2422e210d35e2bc416db6e035dc3be1699...0a12e31fe2b95920e2bde82ea92c9fc8ee3fbbe9,4,28,9,37,8,2013-12-13 23:57:10,2013-12-13 23:57:10
525cbbfee88d5203abb7b19592046431079c3d81...65ec4c7e326936a1df2d5f731c9563da75a709d4,7,11,11,22,10,2013-11-30 01:04:42,2013-11-30 01:04:42
525cbbfee88d5203abb7b19592046431079c3d81...0722f4006c2429fa389b745141ba5d0fb86f83f3,1,147,11,158,7,2013-11-23 09:11:35,2013-11-23 09:11:35
0722f4006c2429fa389b745141ba5d0fb86f83f3...a493c91d337340a71a1193923f78d486656434fd,1,7,6,13,4,2013-11-23 09:15:16,2013-11-23 09:15:16
a493c91d337340a71a1193923f78d486656434fd...336e31740cb5697d67653fe00f1c4b214f49d398,1,29,71,100,13,2013-11-23 09:29:50,2013-11-23 09:29:50
336e31740cb5697d67653fe00f1c4b214f49d398...0dd467f297b2411bc59d8172ae727006baf9de2b,1,0,2,2,1,2013-11-23 13:01:13,2013-11-23 13:01:13
0dd467f297b2411bc59d8172ae727006baf9de2b...c43a1c37a186f8c67bc02cb3fbe856c4901cf14a,2,16,8,24,5,2013-11-24 02:02:42,2013-11-24 02:02:42
c43a1c37a186f8c67bc02cb3fbe856c4901cf14a...26ef15248747fa2bab0d69bdf7a9f1373ab6b130,1,9,2,11,5,2013-11-24 02:03:07,2013-11-24 02:03:07
26ef15248747fa2bab0d69bdf7a9f1373ab6b130...eee58b81a813efeeed284f4b92fa241a35e39de7,1,6,6,12,5,2013-11-24 02:14:12,2013-11-24 02:14:12
eee58b81a813efeeed284f4b92fa241a35e39de7...cdbb9b78384e9a7cfae8f26630cad322afd0d339,1,15,16,31,9,2013-11-24 02:49:32,2013-11-24 02:49:32
92c9d9d87aa920c67ad21067d692ae6b9f6608e0...00d7183a3ad188fec33659c95a4a485f6cc2c02f,6,11,9,20,7,2014-04-10 23:43:16,2014-04-10 23:43:16
92c9d9d87aa920c67ad21067d692ae6b9f6608e0...624f21c94e59946fe52b3612df14b5670216fe10,1,23,23,46,1,2014-04-10 21:34:40,2014-04-10 21:34:40
92c9d9d87aa920c67ad21067d692ae6b9f6608e0...4c9f77d2574dfeb42a4db95e1cc6cf50fe80eaf0,4,9,10,19,5,2014-04-08 15:03:44,2014-04-08 15:03:44
840a2d1f16fc1c3fd022b83ff52f7ef20259cc1b...250905535e3ef0079ba888c892fcb4c1ae22c08b,1,5,0,5,1,2013-12-16 01:06:47,2013-12-16 00:55:59
250905535e3ef0079ba888c892fcb4c1ae22c08b...6e6cf4eef02079981722cf19ba7c3e138a75afeb,1,6,0,6,1,2013-12-16 01:06:57,2013-12-16 01:06:57
6e6cf4eef02079981722cf19ba7c3e138a75afeb...d5b18a658913e56fae0a13bea928c09adbad0649,3,7,8,15,4,2013-12-16 17:22:34,2013-12-16 17:22:34
65ec4c7e326936a1df2d5f731c9563da75a709d4...47be4003e3b9038a784d1ca0a7fcf5c905065fba,4,54,32,86,9,2013-12-03 20:04:03,2013-12-03 20:04:03
47be4003e3b9038a784d1ca0a7fcf5c905065fba...126035895fd3dd13451f7fc22bceea55c0cda76a,5,42,37,79,13,2013-12-12 23:36:35,2013-12-12 23:36:35
126035895fd3dd13451f7fc22bceea55c0cda76a...8b67f00b6bc623808ac9c969095ce411cc9f0d4b,5,47,59,106,11,2013-12-13 22:00:23,2013-12-13 22:00:23
e44ae3c0ca5584ca1e985088a68bbc1634409803...aee121427df6a4e72054c573ac1861c151daa015,2,37,50,87,11,2014-01-09 23:25:16,2014-01-09 23:25:16
624f21c94e59946fe52b3612df14b5670216fe10...c0e84e2ca0ddeef7ba018d40dfceac61abd54b3b,4,11,15,26,12,2014-04-11 13:09:10,2014-04-11 13:02:34
3234f47ad38f430b5165d3a242ed1d57a1c0b189...99ff885b960309f03ca5142ada3fcfe1a56f8604,12,41,28,69,19,2014-01-09 21:54:49,2014-01-09 21:54:49
99ff885b960309f03ca5142ada3fcfe1a56f8604...d7f2ce3a9ab4920def12fc561a7c948255257429,1,3,1,4,4,2014-01-09 22:03:03,2014-01-09 22:03:03
3234f47ad38f430b5165d3a242ed1d57a1c0b189...ee72c8f22620e3bf9ab0977532661ce01f6b5241,6,30,5,35,11,2014-01-09 19:21:14,2014-01-09 19:21:14
3234f47ad38f430b5165d3a242ed1d57a1c0b189...8349aa171cb8fd6147256a9fcb3def89df0afc39,24,1095,1082,2177,34,2014-01-08 21:10:00,2013-11-29 17:09:51
8349aa171cb8fd6147256a9fcb3def89df0afc39...e93f69c340d1f19be7514145c642eef4bd97fc83,15,775,774,1549,78,2014-01-08 22:21:24,2014-01-08 22:21:24
e93f69c340d1f19be7514145c642eef4bd97fc83...77cd399de399efac0685cae0fdc2411705a2e6a2,3,14,13,27,8,2014-01-08 22:29:44,2014-01-08 22:29:44
77cd399de399efac0685cae0fdc2411705a2e6a2...f152a9e67170274f58a0e65192eeedc1b8b36274,1,16,0,16,1,2014-01-08 22:45:44,2014-01-08 22:45:44
f152a9e67170274f58a0e65192eeedc1b8b36274...d158235430731cd010e4faf027f6d82e1bbe0b23,9,113,120,233,24,2014-01-08 23:00:32,2014-01-08 23:00:32
d158235430731cd010e4faf027f6d82e1bbe0b23...02241efab073e73665cd0bbd784a110f4376dea9,5,74,66,140,13,2014-01-08 23:30:21,2014-01-08 23:30:21
02241efab073e73665cd0bbd784a110f4376dea9...4c2917d30cb803bbce792cbfe4b4f346fe68910f,1,26,0,26,1,2014-01-08 23:47:10,2014-01-08 23:47:10
3234f47ad38f430b5165d3a242ed1d57a1c0b189...fc153902a638f8ff8a88e937682663a5bedd8dda,6,117,25,142,11,2014-01-08 21:04:51,2013-12-03 16:50:06
fc153902a638f8ff8a88e937682663a5bedd8dda...c3c2bd67b616f3a4e1b56807d4217a51d8c93cbd,2,78,26,104,5,2014-01-08 21:04:51,2013-12-03 16:59:45
c3c2bd67b616f3a4e1b56807d4217a51d8c93cbd...af76f540982e84cc73e39fff6b261121e26452c6,1,3,3,6,2,2014-01-08 21:04:51,2013-12-03 17:01:41
af76f540982e84cc73e39fff6b261121e26452c6...997471e945f3271829a8f66cf5391e7f53eddbe9,4,72,87,159,13,2014-01-08 21:05:13,2014-01-08 21:04:12
aee121427df6a4e72054c573ac1861c151daa015...8f919c4fe74348cdeb995d88c21673bc957c55c1,2,10,5,15,6,2014-01-10 00:37:18,2014-01-10 00:37:18
49ba8afebb2ae813ab66dc2f48f533aa7f333c3c...082c9593e2e7341671eccc4516d1ebd2e421a274,3,270,259,529,34,2014-05-18 03:32:59,2014-05-18 03:32:59
082c9593e2e7341671eccc4516d1ebd2e421a274...9d0bbefa942ba0e1663505024f06e86645c16bab,4,258,229,487,53,2014-05-18 05:25:28,2014-05-18 05:25:28
9d0bbefa942ba0e1663505024f06e86645c16bab...b567b5d1064bd494bf6f94e75717f0f994a06094,7,283,291,574,29,2014-05-18 06:27:01,2014-05-18 05:25:28
b567b5d1064bd494bf6f94e75717f0f994a06094...ea7b43e8d7e1a2379dd89d54ed5c49a6bfa41991,4,119,116,235,57,2014-05-18 15:17:13,2014-05-18 15:10:02
ea7b43e8d7e1a2379dd89d54ed5c49a6bfa41991...1896136dfebf48a135c4dff4bfcc9146f248f8c2,4,38,74,112,9,2014-05-18 22:08:16,2014-05-18 22:08:16
49ba8afebb2ae813ab66dc2f48f533aa7f333c3c...e159b8118663d3739622145cd49c13487268df26,1,1,1,2,1,2014-05-13 21:21:37,2014-05-13 21:21:37
49ba8afebb2ae813ab66dc2f48f533aa7f333c3c...0f03bdd5993b4eac3ad20a745a66b7b731ddd1dc,4,49,7,56,6,2014-05-10 16:37:23,2014-05-10 16:25:53
49ba8afebb2ae813ab66dc2f48f533aa7f333c3c...6e3ce486f8c1bdc3e10000d2921623c32449d5ef,4,49,24,73,10,2014-04-23 09:11:43,2014-04-23 09:11:43
49ba8afebb2ae813ab66dc2f48f533aa7f333c3c...31d0712f1ea3d1c986a3993f6ca837c97aa6d745,3,15,6,21,7,2014-04-22 19:13:58,2014-04-22 19:13:58
4c2917d30cb803bbce792cbfe4b4f346fe68910f...da785c66ee6e81428187727fd232382280dc2015,7,32,55,87,19,2014-01-09 18:50:11,2014-01-09 18:50:11
da785c66ee6e81428187727fd232382280dc2015...8b1e0ea9fec70b0c68498f12a797f69d8baeb884,3,132,1,133,3,2014-01-09 19:07:32,2014-01-09 19:07:32
f9ec9907a93b23277f4a17c804a5ed6a39bcf37f...6dd366a307838ce81a5433d79773edad6ba06823,2,136,0,136,2,2014-05-19 04:36:35,2014-05-15 05:49:56
61c568f8185d3b1eebf525cca9aafcca0bedf296...58af519423751c8f8a7b661c885a4f5df83b0a89,4,32,11,43,4,2014-05-19 18:03:33,2014-05-19 17:37:01
58af519423751c8f8a7b661c885a4f5df83b0a89...6b48969618e7ecea5ce279f1b8ba9555f91b5678,2,2,6,8,2,2014-05-19 18:25:22,2014-05-19 18:25:22
db8d30584d970ef5a0a9b3f57ea4462816e80872...3b93d27b131b0c41591d39bd31cb80e69c569673,3,32,19,51,5,2014-06-30 13:32:54,2014-06-30 13:32:54
3b93d27b131b0c41591d39bd31cb80e69c569673...269b34fd8963a78ad7a45aeb657234640d93ba26,3,26,1,27,4,2014-06-30 17:03:12,2014-06-30 17:03:12
db8d30584d970ef5a0a9b3f57ea4462816e80872...54ca304673db6cf1c8701cea451aa1d2537ebdb0,4,12,3,15,4,2014-06-30 10:42:01,2014-06-30 10:41:19
db8d30584d970ef5a0a9b3f57ea4462816e80872...086b5fc57845105db8adc393c74cbbbce588d30d,3,39,7,46,5,2014-06-27 16:19:42,2014-06-27 16:19:42
db8d30584d970ef5a0a9b3f57ea4462816e80872...35584baa1743a831a018118801d2d14f817e4d57,8,87,144,231,59,2014-06-24 23:43:37,2014-06-24 23:43:37
db8d30584d970ef5a0a9b3f57ea4462816e80872...7f2d63e3c2394716833e7dd2f367d083884c6823,1,2,2,4,2,2014-06-24 14:21:49,2014-06-24 14:21:49
db8d30584d970ef5a0a9b3f57ea4462816e80872...8990151f5a6a5ca0e3f1688dbe1ce76533898b03,6,84,19,103,26,2014-06-12 17:48:56,2014-06-12 17:33:52
8990151f5a6a5ca0e3f1688dbe1ce76533898b03...41d67b956d1e22d6abb5c81db17ae70a88870819,4,19,19,38,15,2014-06-23 09:56:17,2014-06-23 09:56:17
41d67b956d1e22d6abb5c81db17ae70a88870819...650a9a922fbc48be440f718d31c077ee737cf892,4,54,28,82,10,2014-06-23 10:17:03,2014-06-23 10:12:16
db8d30584d970ef5a0a9b3f57ea4462816e80872...2a7f582e54652b1ab16dbafd6bc5d5b8aa679b82,3,79,5,84,5,2014-06-06 17:02:08,2014-06-06 17:02:08
2a7f582e54652b1ab16dbafd6bc5d5b8aa679b82...f8da7ce83e69c6e791875f8fa4bf0941ab24cb35,4,43,26,69,10,2014-06-07 23:20:17,2014-06-07 23:17:39
f8da7ce83e69c6e791875f8fa4bf0941ab24cb35...1652ba8acfcf2a58b35e725a31fcc56c2f9d3004,3,29,13,42,4,2014-06-07 23:31:42,2014-06-07 23:31:42
1652ba8acfcf2a58b35e725a31fcc56c2f9d3004...435a8e61456043dd0addf4437e0b3db29f792081,3,6,10,16,7,2014-06-08 03:42:03,2014-06-08 03:42:03
435a8e61456043dd0addf4437e0b3db29f792081...19e009938c2c762399d1e9d09023ec7170cf9951,3,5,7,12,3,2014-06-08 10:05:34,2014-06-08 10:05:34
db8d30584d970ef5a0a9b3f57ea4462816e80872...6cc03db0de3777f034dc910a7cae2cbecb0ed099,4,108,13,121,10,2014-05-30 16:00:01,2014-05-30 16:00:01
db8d30584d970ef5a0a9b3f57ea4462816e80872...59db6aa4965981b1fcdbd7363fa55d2f61914002,1,1,1,2,1,2014-05-28 09:29:56,2014-05-28 09:29:56
59db6aa4965981b1fcdbd7363fa55d2f61914002...60633083841b83a4ed6afa1122c3286106191339,2,2,2,4,2,2014-06-30 17:12:58,2014-06-30 17:12:58
db8d30584d970ef5a0a9b3f57ea4462816e80872...30dcc0e9a358c70c017e1c02759a090adc471b84,2,7,0,7,2,2014-05-22 10:31:22,2014-05-22 10:31:22
974a62fc8261e78a6071b8989a96e1c9f8c75473...4dc91785c3729c351c7bffc5f79605a0ce264705,3,12,23,35,15,2014-07-07 04:39:11,2014-07-07 04:36:25
974a62fc8261e78a6071b8989a96e1c9f8c75473...f98db95219e16254baf415ea836966fa8c91ed17,1,16,0,16,1,2014-07-01 10:01:40,2014-07-01 10:01:40
1d4c3f3b19122c087f2e1a2811f1daa65b2ed2f3...3fb2608e5ffdc2b151f0c6fa11ab0cfa86d247af,4,10,10,20,4,2014-11-14 21:13:49,2014-11-14 21:12:01
44f4985c6c42407d0df119beda4c63cb2e86f4e3...80e9f3c814fbd0985ec39eae88d92cbc2729afb2,6,6,6,12,6,2014-11-14 20:55:22,2014-11-14 20:55:22
4f1a5b24fb80bbc32129e081da9e7316248b91fd...64f0156a7a19f70f66fcec4122373f033641c843,1,1,1,2,1,2014-07-12 05:56:12,2014-07-12 05:56:12
a30a79ae0a8b9ce9a677fa0beda0e03eca1d94fa...a394493007b8e13ec168cf34528ffca3bf521900,2,8,1,9,2,2014-07-17 05:25:27,2014-06-19 19:04:05
a394493007b8e13ec168cf34528ffca3bf521900...f5c380b8fb126c4ba04323496efabbee1d4a5271,3,4,4,8,4,2014-07-17 05:25:48,2014-07-17 05:25:23
48ad44fdeef32b518c6271bb99a9aed376c1a1d6...a10b22654c9275da1050e1513bbd834646c0bde3,1,1,0,1,1,2014-08-05 18:17:34,2014-08-05 18:17:34
48ad44fdeef32b518c6271bb99a9aed376c1a1d6...f7d39bac48663a9dc110d29c815aea59195a38a9,3,18,7,25,5,2014-07-29 17:20:08,2014-07-29 13:15:18
a10b22654c9275da1050e1513bbd834646c0bde3...a35000b74492b1e46bd3db136cebc4a3b7844676,4,8,4,12,5,2014-10-03 21:05:25,2014-10-03 21:05:25
a10b22654c9275da1050e1513bbd834646c0bde3...b5ddd2b07ba9a7fafada38b1fafa7b5850347e75,5,11,11,22,9,2014-10-02 11:28:44,2014-10-02 11:28:44
a10b22654c9275da1050e1513bbd834646c0bde3...08353a40bc71ad7daccd9f944d6a40f31d22fa25,4,7,5,12,7,2014-09-29 23:07:18,2014-09-29 23:01:41
a10b22654c9275da1050e1513bbd834646c0bde3...7eac7db9a218fc4deaba628ed883d4c77db190f4,17,699,1983,2682,107,2014-09-15 22:24:28,2014-09-15 22:24:28
7eac7db9a218fc4deaba628ed883d4c77db190f4...61c5a254ddfd11e344c96a83f33f1de3343542e6,3,6,2,8,3,2014-09-15 22:28:10,2014-09-15 22:28:10
61c5a254ddfd11e344c96a83f33f1de3343542e6...a3f2adab7f85e2a0c82288ead88c1e484c9e3ea3,4,49,2,51,4,2014-09-15 22:43:13,2014-09-15 22:43:13
a3f2adab7f85e2a0c82288ead88c1e484c9e3ea3...109f9351a236f5c31d7ff2442dfa662a5ac26c22,4,22,22,44,6,2014-09-16 17:22:44,2014-09-16 17:22:44
109f9351a236f5c31d7ff2442dfa662a5ac26c22...1fce7e399ad53f82ffe1d077c7bee4c14ee58ed7,1,3,0,3,1,2014-09-16 17:24:05,2014-09-16 17:23:58
1fce7e399ad53f82ffe1d077c7bee4c14ee58ed7...55f6949cabcbf2f17e4b3b5ec7905621c120a972,3,95,4,99,3,2014-09-16 23:56:57,2014-09-16 23:56:57
55f6949cabcbf2f17e4b3b5ec7905621c120a972...ff238b86d942c4af6508b6e597ee72ce5e78c714,10,441,323,764,19,2014-09-17 00:06:56,2014-09-17 00:06:56
ff238b86d942c4af6508b6e597ee72ce5e78c714...0008bcaafef79ee66b486057d63a0b321f1c3a86,3,38,6,44,5,2014-09-17 00:19:17,2014-09-17 00:19:17
0008bcaafef79ee66b486057d63a0b321f1c3a86...ec6ee5dbfacf8d2445c6bb00bdf654071ca21a6a,8,419,300,719,56,2014-09-17 20:01:38,2014-09-17 20:01:38
ec6ee5dbfacf8d2445c6bb00bdf654071ca21a6a...51c5dcdb40d713650a1564fd45e3217e88d70d19,6,72,11,83,11,2014-09-18 02:40:29,2014-09-18 02:40:29
51c5dcdb40d713650a1564fd45e3217e88d70d19...f178fe89c28aeebfaf7c3a6ceedfb23d9add3df3,3,21,5,26,3,2014-09-18 17:29:23,2014-09-18 17:29:23
f178fe89c28aeebfaf7c3a6ceedfb23d9add3df3...0cf24f63d510002a4865b891c443258660505444,6,181,61,242,19,2014-09-18 21:06:46,2014-09-18 21:06:46
0cf24f63d510002a4865b891c443258660505444...cba0d58118637ec39e39dfb44b626231c8412faf,3,27,5,32,3,2014-09-18 21:09:40,2014-09-18 21:09:40
cba0d58118637ec39e39dfb44b626231c8412faf...a3ca2ced0698c504c3fc775992f79436a1a22f40,8,298,66,364,12,2014-09-25 17:51:11,2014-09-25 17:51:11
a3ca2ced0698c504c3fc775992f79436a1a22f40...ee4c7db07d607ac4bef0261e8fd55363c0009a98,4,114,5,119,4,2014-09-26 21:15:31,2014-09-26 21:15:31
ee4c7db07d607ac4bef0261e8fd55363c0009a98...d336107d445213481ce5f560952c334af608a7c9,4,30,22,52,9,2014-10-12 23:10:48,2014-10-12 23:10:48
a10b22654c9275da1050e1513bbd834646c0bde3...61e469388a9869a79ec4571787e295049e930486,3,7,3,10,5,2014-09-10 11:00:54,2014-09-10 11:00:54
61e469388a9869a79ec4571787e295049e930486...6b61f60e26e68fcf21ec26cff98934707e0c2371,3,5,4,9,5,2014-10-08 15:03:32,2014-10-08 15:03:32
a10b22654c9275da1050e1513bbd834646c0bde3...613245149b9261ccc19870d58874f0fc60d21c76,4,28,18,46,15,2014-09-08 05:18:13,2014-09-08 05:15:22
a10b22654c9275da1050e1513bbd834646c0bde3...b53486a1323d3372ceb0394ef381d24e89f1678a,1,16,0,16,1,2014-08-28 15:18:56,2014-08-28 15:18:56
b53486a1323d3372ceb0394ef381d24e89f1678a...f2c29d6b04bab66c419f0ac7f13d18a1c6f4a803,1,16,0,16,1,2014-08-28 16:21:18,2014-08-28 16:21:18
a10b22654c9275da1050e1513bbd834646c0bde3...7fd123f868d0720fd285d0073503367fd78caf8b,4,15,19,34,12,2014-08-15 21:32:48,2014-08-15 21:32:48
7fd123f868d0720fd285d0073503367fd78caf8b...44f575205c4cde066dbf7382c15624a87790e344,3,12,6,18,9,2014-08-15 21:34:21,2014-08-15 21:34:21
a10b22654c9275da1050e1513bbd834646c0bde3...80e593a39e0c8e049839c81aaf7ef6edf6a56bc7,1,16,0,16,1,2014-08-13 05:50:36,2014-08-13 05:50:36
a10b22654c9275da1050e1513bbd834646c0bde3...b99b2b80b01a4c972b7d9b855fff7d83eec9939b,1,16,0,16,1,2014-08-12 09:47:18,2014-08-12 09:47:18
b99b2b80b01a4c972b7d9b855fff7d83eec9939b...bb77211ddbcee41703a1b8af5f6b87f5c9784dbf,1,1,1,2,1,2014-08-25 15:55:58,2014-08-25 15:55:58
a10b22654c9275da1050e1513bbd834646c0bde3...519f258ff478af0ae058b440f8503853a57bafd9,14,80,80,160,71,2014-08-06 16:55:22,2014-08-06 16:32:49
a10b22654c9275da1050e1513bbd834646c0bde3...03e74cbe72364f6f7d554620d6b480382d6cecf2,11,49,58,107,17,2014-08-05 19:55:48,2014-07-18 16:26:37
9b747deb237fd3b5728fe495729b74afff993d08...ac7fb154fa7f7a6b0bab3927c1d9927522f260ec,6,6,6,12,6,2014-10-08 15:09:42,2014-10-08 15:09:42
ac7fb154fa7f7a6b0bab3927c1d9927522f260ec...9b953bde43c869d23870a407dec9f6414c9c2cb1,1,3,0,3,1,2014-10-08 15:45:31,2014-10-08 15:45:31
5c568759963d8344eb7b0fe187ead6ed2ad32406...66038b39675d725417791e2ac3b8d25926e40be5,1,1,1,2,1,2014-10-10 17:05:20,2014-10-10 17:05:20
66038b39675d725417791e2ac3b8d25926e40be5...d962ff9229e00a2dbc52c04fa617372c90dd7b9a,1,16,0,16,1,2014-10-10 17:10:45,2014-07-29 18:05:08
d962ff9229e00a2dbc52c04fa617372c90dd7b9a...1fc660a6b69d85fff27b6c552daf4cd3ec4260f3,1,16,0,16,1,2014-10-10 17:10:45,2014-07-29 19:32:58
dd371b0178b42442fac7bed8e109bb4130662041...d9e141a154c545e32949328df2ee30960e3e18e0,1,1,1,2,1,2014-10-10 17:04:25,2014-10-10 17:04:25
9b953bde43c869d23870a407dec9f6414c9c2cb1...f38ed05731e143cebd022024f94ea564210e5f43,3,8,8,16,7,2014-10-09 19:16:04,2014-10-09 19:16:04
9b953bde43c869d23870a407dec9f6414c9c2cb1...2e56709361c5bfa7ebfd3e3568fb490d55ee2a0e,3,22,9,31,7,2014-10-09 14:14:29,2014-08-07 13:44:56
2e56709361c5bfa7ebfd3e3568fb490d55ee2a0e...5ad5ddde19148f7e374a6d74552e97b48c7da669,3,19,32,51,12,2014-10-09 16:10:51,2014-10-09 16:10:51
5ad5ddde19148f7e374a6d74552e97b48c7da669...c3ac0e9eb02f017fa1063888d9e13171202963e4,3,7,5,12,5,2014-10-09 16:13:04,2014-10-09 16:13:04
9b953bde43c869d23870a407dec9f6414c9c2cb1...edc17c988a4999b95b3e244897ae2ae9691f71ea,3,10,5,15,6,2014-10-09 13:49:17,2014-10-03 20:05:59
1fc660a6b69d85fff27b6c552daf4cd3ec4260f3...cd21deaf800d6fb5f31512cde608793a2ecfc973,3,36,97,133,8,2014-10-17 04:40:06,2014-10-17 04:40:06
1fc660a6b69d85fff27b6c552daf4cd3ec4260f3...dd1e9165c9c4a7a108d9ec8a0fec81a70c90004e,4,11,5,16,6,2014-10-16 08:16:21,2014-10-16 08:16:02
dd1e9165c9c4a7a108d9ec8a0fec81a70c90004e...4e5deb09aaf6e6aa776aa9c045951b955e0b39b9,4,29,8,37,4,2014-10-16 08:44:25,2014-10-16 08:40:35
4e5deb09aaf6e6aa776aa9c045951b955e0b39b9...d3ed04db686f58bf238b3780197193bc5ae955af,4,15,5,20,6,2014-10-16 23:14:57,2014-10-16 23:14:57
d3ed04db686f58bf238b3780197193bc5ae955af...eaed66d4b6cd03634ca2ced2006ba0b7fea75d31,10,58,20,78,20,2014-10-17 04:17:40,2014-10-17 04:10:41
1fc660a6b69d85fff27b6c552daf4cd3ec4260f3...b943746b7ee1caf522a4a6db14cc20e62e9181eb,4,113,111,224,34,2014-10-14 18:06:31,2014-10-14 18:06:31
b943746b7ee1caf522a4a6db14cc20e62e9181eb...594c2d24aa3b7e3c3fd661c1684c765a0185e6eb,5,24942,8779,33721,452,2014-10-16 17:06:17,2014-10-16 17:06:17
1fc660a6b69d85fff27b6c552daf4cd3ec4260f3...9a3de7d775e4ebfa3b57800e70ce254e7061f70c,6,135,54,189,35,2014-10-14 17:13:12,2014-10-14 17:09:07
9a3de7d775e4ebfa3b57800e70ce254e7061f70c...067de6dfea111f0fd66cc2a69da90a2c92542baa,3,5,5,10,5,2014-10-14 17:15:10,2014-10-14 17:15:10
067de6dfea111f0fd66cc2a69da90a2c92542baa...4222a629838906171e3d4b9c7aa03c56b73cf2d6,1,33,0,33,1,2014-10-14 17:15:38,2014-10-14 17:15:38
4222a629838906171e3d4b9c7aa03c56b73cf2d6...85e4c50b67fc366fee2d738611775189a4faf2e4,3,12,15,27,12,2014-10-14 17:20:43,2014-10-14 17:20:43
85e4c50b67fc366fee2d738611775189a4faf2e4...9bcc57c7ab66efe489d9dd07e53323e07683e389,4,58,101,159,33,2014-10-15 16:53:45,2014-10-15 16:53:45
9bcc57c7ab66efe489d9dd07e53323e07683e389...4c14f5ff6a944ef70a12fa054787c07f8176a1ad,4,219,75,294,34,2014-10-15 17:20:56,2014-10-15 17:20:56
1fc660a6b69d85fff27b6c552daf4cd3ec4260f3...acfbdd4946af8cd1accb049483fe04cea2f8942e,4,51,19,70,13,2014-10-14 01:20:40,2014-10-14 01:17:59
1fc660a6b69d85fff27b6c552daf4cd3ec4260f3...b6b80f7270aa166ac078278f919aee322e985df7,7,262,260,522,73,2014-10-13 21:34:12,2014-10-13 21:32:08
1fc660a6b69d85fff27b6c552daf4cd3ec4260f3...04e167c837676320cb483b05c7c55eb031ad1747,1,16,0,16,1,2014-10-13 20:07:14,2014-10-13 20:07:14
04e167c837676320cb483b05c7c55eb031ad1747...3d8797b94f4aa60ea39253aa9d32779fd5b40c32,1,1,1,2,1,2014-10-22 22:55:54,2014-10-22 22:55:54
f38ed05731e143cebd022024f94ea564210e5f43...f8514d3a51e71faf9513a32f64e7e1ca7da20796,1,0,7,7,1,2014-10-10 16:35:51,2014-10-10 16:35:51
f8514d3a51e71faf9513a32f64e7e1ca7da20796...0a412f620e6ac3a040334947434a29d6ca7ad884,2,26,9,35,6,2014-10-10 16:46:55,2014-10-10 16:46:55
f38ed05731e143cebd022024f94ea564210e5f43...35e26d58b7b86f97849c0d3d4b67d358e850d851,5,31,3,34,5,2014-10-10 16:21:20,2014-10-10 16:21:20
f38ed05731e143cebd022024f94ea564210e5f43...d21da02fd20b2833a69e3e76eb9ec87fe8144086,3,6,4,10,5,2014-10-10 10:04:30,2014-10-10 10:01:40
f38ed05731e143cebd022024f94ea564210e5f43...a4429fa0412578c5361d859a487256f09fbe4386,7,26,26,52,19,2014-10-10 09:40:59,2014-10-10 09:09:57
a4429fa0412578c5361d859a487256f09fbe4386...1531870f0c83c0c15c3ad77884568790481a610c,4,19,13,32,8,2014-10-10 16:53:19,2014-10-10 16:53:19
1531870f0c83c0c15c3ad77884568790481a610c...205be78ed3f9c7ff5889bc6b4a5431ab55883999,1,3,0,3,1,2014-10-10 17:31:25,2014-10-10 17:31:25
205be78ed3f9c7ff5889bc6b4a5431ab55883999...9592f9b8fd2797655c8490b5c4171e5800f75223,4,13,19,32,8,2014-10-10 17:59:49,2014-10-10 17:59:49
9592f9b8fd2797655c8490b5c4171e5800f75223...037063c41cc2fc57cb2d225ea8ef2330b9d02d0e,3,5,5,10,5,2014-10-10 18:12:44,2014-10-10 18:09:27
f38ed05731e143cebd022024f94ea564210e5f43...28c65bb9ba231aeb2694cdd68e7eaec9f8dbd3bb,4,71,23,94,27,2014-10-10 08:41:24,2014-08-28 11:16:06
ad7e17d4a968701d8b884dedfeb92d5efb3ce66d...57e07f92115fe45fb800e0d0e4fe99e09fd3c5f0,2,8,10,18,9,2014-10-17 06:15:57,2014-10-17 06:15:57
57e07f92115fe45fb800e0d0e4fe99e09fd3c5f0...74aaf245d0b4584186e261af785d6301541915ab,3,17,17,34,10,2014-10-17 06:20:36,2014-10-17 06:20:36
74aaf245d0b4584186e261af785d6301541915ab...1398d4d8a3517e8a9d33939abad6b1a4706d11e3,1,1,5,6,2,2014-10-17 06:22:56,2014-10-17 06:22:56
1398d4d8a3517e8a9d33939abad6b1a4706d11e3...9364923ee2b35ec2eb80ffc4bdac12a7930097fc,6,6,6,12,6,2014-10-17 12:01:43,2014-10-17 12:01:43
09f43b1b4f7a3594fb54007ec09cd62127119080...d9f6288c24f6eceefbad6dc665fd6ecf2f37838f,4,36,133,169,31,2014-10-17 05:07:48,2014-10-17 05:07:48
d9f6288c24f6eceefbad6dc665fd6ecf2f37838f...a7cb015ce8e1997ac0fdf5481cfffd4ada08f501,5,93,158,251,31,2014-10-17 05:16:51,2014-10-17 05:16:51
a7cb015ce8e1997ac0fdf5481cfffd4ada08f501...a64f6df7b20f5ef75bf769f7c014a2741cc27a30,4,6,4,10,5,2014-10-17 05:24:52,2014-10-17 05:24:52
9364923ee2b35ec2eb80ffc4bdac12a7930097fc...2d48c8a61dd4bdeb2fa4768915b9600c68690fb6,3,4,4,8,4,2014-11-13 10:13:24,2014-11-13 10:13:24
9364923ee2b35ec2eb80ffc4bdac12a7930097fc...e221ab0a41f43ceaed5cbe6d01a6e8d3e7bc24dc,3,3,3,6,3,2014-11-03 22:06:33,2014-11-03 22:06:33
9364923ee2b35ec2eb80ffc4bdac12a7930097fc...9bb8561d4e1dd8ee12d0ae48405c57f35db7b6af,4,37,10,47,6,2014-10-24 18:30:54,2014-10-24 18:25:41
9364923ee2b35ec2eb80ffc4bdac12a7930097fc...6467340af91f1e9c57e3a2636fcc95ba488369e0,3,3,3,6,3,2014-10-23 22:08:17,2014-10-23 22:08:17
9364923ee2b35ec2eb80ffc4bdac12a7930097fc...688fd6d9d8b537e335d3a3eadf29b560e454eef3,7,35,17,52,17,2014-10-23 21:04:11,2014-10-18 10:36:03
9364923ee2b35ec2eb80ffc4bdac12a7930097fc...0e5a8c172ee5222ccd765219c84d915adaa875ee,2,2,2,4,2,2014-10-23 17:05:38,2014-10-23 17:05:38
9364923ee2b35ec2eb80ffc4bdac12a7930097fc...0022fcb34c91cd96efa6fc0eb26ee085957f0b26,16,126,107,233,82,2014-10-23 17:02:09,2014-10-23 16:56:09
9364923ee2b35ec2eb80ffc4bdac12a7930097fc...89f1e65cea0f8628a85253e12c967feef9a21bbe,1,1,0,1,1,2014-10-21 12:43:31,2014-10-21 12:43:31
89f1e65cea0f8628a85253e12c967feef9a21bbe...ac5885b1ccda4ec45985d5017f30a8742b29a060,2,14,14,28,3,2014-10-21 13:21:25,2014-10-21 13:21:25
d6598447cc972385fc34ca10f542fc53ad174183...135a84abaed028a686276fb715d20b1d7be17f78,4,14,8,22,6,2014-11-14 18:59:33,2014-11-14 18:53:32
d6598447cc972385fc34ca10f542fc53ad174183...f82dd6fb414a15bca4f9c39c7c9442295ddea416,1,2,2,4,1,2014-11-13 17:31:46,2014-11-13 17:30:21
f82dd6fb414a15bca4f9c39c7c9442295ddea416...595088cf1e546b6215a2ff1f00cde26dbaacd273,2,2,6,8,4,2014-12-06 21:21:04,2014-12-06 21:21:02
f82dd6fb414a15bca4f9c39c7c9442295ddea416...050890adc7e4b7f9768fee3892381303687ba80e,8,161,0,161,8,2014-11-29 12:12:44,2014-11-25 07:41:28
050890adc7e4b7f9768fee3892381303687ba80e...57f72bb51c42f73eda3f1d9ae1635e317baa699e,2,30,81,111,14,2014-11-29 22:39:59,2014-11-29 22:39:59
57f72bb51c42f73eda3f1d9ae1635e317baa699e...0b99802b49ee2b45c47c6eeff2a28b6c5b055ec7,5,8,69,77,8,2014-11-30 10:05:18,2014-11-30 10:05:18
0b99802b49ee2b45c47c6eeff2a28b6c5b055ec7...60421eed9d8522aa1b8681783e6a515eba6ef64a,2,3,4,7,2,2014-12-19 06:25:49,2014-12-19 06:25:49
