id,files,locs added,locs removed,locs total,hunks,commit time,author time
4b825dc642cb6eb9a060e54bf8d69288fbee4904...d6ded0e91bcdd2a8f7a221f6a5552a33fe545359,0,0,0,0,0,2005-07-13 16:56:05,2005-07-13 16:56:05
d6ded0e91bcdd2a8f7a221f6a5552a33fe545359...07ffc7d605cc96557db28a9e35da69bc0719611b,7,1885,0,1885,5,2005-07-13 01:25:57,2005-07-13 01:25:57
07ffc7d605cc96557db28a9e35da69bc0719611b...ed114e15106192b22ebb78ef5bf5bce72b419d13,114,13851,0,13851,85,2005-07-13 01:25:57,2005-07-13 01:25:57
ed114e15106192b22ebb78ef5bf5bce72b419d13...1cb1d9cd078adea3060742a768ef71f5bafb7f07,7,0,0,0,0,2005-07-13 18:54:07,2005-07-13 18:54:07
1cb1d9cd078adea3060742a768ef71f5bafb7f07...ce079538c66d826be5f0c4260ab4405b7abcbed7,4,78,0,78,4,2005-07-13 19:08:56,2005-07-13 19:08:56
ce079538c66d826be5f0c4260ab4405b7abcbed7...3c0ee70e7c6b9e40cef611061f7756c80691ee76,1,6,2,8,1,2005-07-13 20:59:56,2005-07-13 20:59:56
3c0ee70e7c6b9e40cef611061f7756c80691ee76...2fb6c3b845967f8c22baeedf4038c3e488746d26,1,3,0,3,1,2005-07-14 01:32:23,2005-07-14 01:32:23
2fb6c3b845967f8c22baeedf4038c3e488746d26...2e4322123f61160470ef7c879470a364f5f968e7,8,15,15,30,14,2005-07-14 03:17:09,2005-07-14 03:17:09
2e4322123f61160470ef7c879470a364f5f968e7...d3abdd8731962ce40c8d3220ca496e2c5399d02d,1,3,2,5,1,2005-07-14 04:03:11,2005-07-14 04:03:11
d3abdd8731962ce40c8d3220ca496e2c5399d02d...8c098891e29985a49a4069349ea56990d9a2c30b,1,54,105,159,27,2005-07-14 04:27:55,2005-07-14 04:27:55
8c098891e29985a49a4069349ea56990d9a2c30b...ef739404d33e8ea24f106e386575eaf1128a2d14,1,0,48,48,1,2005-07-14 18:08:56,2005-07-14 18:08:56
ef739404d33e8ea24f106e386575eaf1128a2d14...0bc849ff89bc7cbc4e9133df297de3542240a21a,13,2,1,3,2,2005-07-14 18:20:03,2005-07-14 18:20:03
0bc849ff89bc7cbc4e9133df297de3542240a21a...f98724e57ae739b3a5677684d61d72899307c302,1,1,1,2,1,2005-07-14 18:32:59,2005-07-14 18:32:59
f98724e57ae739b3a5677684d61d72899307c302...d9d6345e3ff1ac1638a3682310116715d6d3e120,1,9,9,18,1,2005-07-14 18:34:52,2005-07-14 18:34:52
d9d6345e3ff1ac1638a3682310116715d6d3e120...fda1f68492146e5d50c2a80d4ca7a365592df93e,1,1,1,2,1,2005-07-14 18:37:10,2005-07-14 18:37:10
fda1f68492146e5d50c2a80d4ca7a365592df93e...26c6566215ebc9407f3c40643ff907ac5084f3c1,1,82,48,130,29,2005-07-14 19:25:13,2005-07-14 19:25:13
26c6566215ebc9407f3c40643ff907ac5084f3c1...5fc13947fcd6c3f3569ce8b643030a645b108037,1,4,3,7,3,2005-07-14 21:04:21,2005-07-14 21:04:21
5fc13947fcd6c3f3569ce8b643030a645b108037...f19dbab514d1f53f31fabaaed55cf0e7ca525382,4,862,1044,1906,72,2005-07-15 00:42:28,2005-07-15 00:42:28
f19dbab514d1f53f31fabaaed55cf0e7ca525382...0bbb48ccc57529fd5b8f0ec6c904f2562da90b12,1,6,8,14,5,2005-07-15 00:48:28,2005-07-15 00:48:28
0bbb48ccc57529fd5b8f0ec6c904f2562da90b12...35d41699a93811efde5e450c75c51402934135f3,2,6,6,12,6,2005-07-15 00:53:18,2005-07-15 00:53:18
35d41699a93811efde5e450c75c51402934135f3...6708086eddf5049fb61f3339097069b5df3059f3,1,3,3,6,3,2005-07-15 00:54:49,2005-07-15 00:54:49
6708086eddf5049fb61f3339097069b5df3059f3...f7d619e4b952edf07790258f59b2b2622c85f4eb,2,0,0,0,0,2005-07-15 15:14:04,2005-07-15 15:14:04
f7d619e4b952edf07790258f59b2b2622c85f4eb...0f40f3b757f51c5d1e006364291f89cc754b81bf,2,312,3,315,4,2005-07-15 15:31:20,2005-07-15 15:31:20
0f40f3b757f51c5d1e006364291f89cc754b81bf...80b4e33f1a6633825ddeb284e28653ba28848841,2,191,10,201,9,2005-07-15 15:57:46,2005-07-15 15:57:46
80b4e33f1a6633825ddeb284e28653ba28848841...ce73f33a115e6028bef65c9c9b6c312afd51c2e7,1,28,17,45,17,2005-07-15 16:19:53,2005-07-15 16:19:53
ce73f33a115e6028bef65c9c9b6c312afd51c2e7...88ee7bb134190196d0bab17ef9daa4298b80c8f5,1,1,1,2,1,2005-07-15 16:29:26,2005-07-15 16:29:26
88ee7bb134190196d0bab17ef9daa4298b80c8f5...eb9c9ab4d04c03bfe4d5108f7452cca572f68c56,1,3,5,8,3,2005-07-15 16:47:19,2005-07-15 16:47:19
eb9c9ab4d04c03bfe4d5108f7452cca572f68c56...a051772b85624632771c65b41ad42df452978d94,2,5,5,10,4,2005-07-15 16:52:08,2005-07-15 16:52:08
a051772b85624632771c65b41ad42df452978d94...960644ab08431ad5b608ee6bc2adaaf068c2a7be,1,139,0,139,1,2005-07-15 17:05:43,2005-07-15 17:05:43
960644ab08431ad5b608ee6bc2adaaf068c2a7be...f4c581158d489aba88f3cbb2c61dd44949ea0038,15,40,34,74,29,2005-07-15 17:09:01,2005-07-15 17:09:01
f4c581158d489aba88f3cbb2c61dd44949ea0038...7b47dcd7734fc8d3d4c96bc15f21833716ca82eb,1,8,2,10,2,2005-07-15 17:59:30,2005-07-15 17:59:30
7b47dcd7734fc8d3d4c96bc15f21833716ca82eb...dc2933f73b4a970d6b37241b6f185bbbacd1bb69,2,19,3,22,3,2005-07-15 18:40:21,2005-07-15 18:40:21
dc2933f73b4a970d6b37241b6f185bbbacd1bb69...c8cae5bed9cb719a5825e3e0d5523429aa967476,1,4,38,42,4,2005-07-15 19:18:09,2005-07-15 19:18:09
c8cae5bed9cb719a5825e3e0d5523429aa967476...b1ccec3d3de026d8c9e63e73cd737947f8c80485,1,1,1,2,1,2005-07-15 19:38:35,2005-07-15 19:38:35
b1ccec3d3de026d8c9e63e73cd737947f8c80485...1380de538aa3806d4cb76195b273b98ccd1ab3ac,1,1,1,2,1,2005-07-15 19:38:37,2005-07-15 19:38:37
1380de538aa3806d4cb76195b273b98ccd1ab3ac...64c0ae520451df075d40e4c38511237a2db01eae,1,6,1,7,2,2005-07-15 19:41:54,2005-07-15 19:41:54
64c0ae520451df075d40e4c38511237a2db01eae...8acc6048e8fe17e1ba7e9df30aace2ef84d68276,1,2,3,5,3,2005-07-15 19:44:52,2005-07-15 19:44:52
8acc6048e8fe17e1ba7e9df30aace2ef84d68276...775f433988445fe5caa622593f58be14506e3143,2,15,11,26,2,2005-07-15 19:49:10,2005-07-15 19:49:10
775f433988445fe5caa622593f58be14506e3143...05c5dabb8f6a42e37cb2e78c3ac00e787d29eea4,1,164,0,164,1,2005-07-15 19:50:29,2005-07-15 19:50:29
05c5dabb8f6a42e37cb2e78c3ac00e787d29eea4...604cd7fe14026da97f73fdb47dc48429b001290a,3,223,27,250,14,2005-07-15 20:37:03,2005-07-15 20:37:03
604cd7fe14026da97f73fdb47dc48429b001290a...41c99f35dba0a12c6bbb49ddcaa5fabf90ca6a0f,2,3,2,5,3,2005-07-15 20:46:05,2005-07-15 20:46:05
41c99f35dba0a12c6bbb49ddcaa5fabf90ca6a0f...c1c308468e5a35b1dc0b136b47b44b16b643652e,1,1,0,1,1,2005-07-15 20:53:17,2005-07-15 20:53:17
c1c308468e5a35b1dc0b136b47b44b16b643652e...4c4f1354185f50317984ae309a34daeba7aef823,1,75,0,75,1,2005-07-15 21:17:52,2005-07-15 21:17:52
4c4f1354185f50317984ae309a34daeba7aef823...0d2b5e33cd7ca3a3f806321aa5d5893901d49352,1,30,0,30,1,2005-07-15 21:21:18,2005-07-15 21:21:18
0d2b5e33cd7ca3a3f806321aa5d5893901d49352...8d1623e68bfbc19e18247ef0a4efef9446fcb761,1,4,3,7,3,2005-07-15 21:26:43,2005-07-15 21:26:43
8d1623e68bfbc19e18247ef0a4efef9446fcb761...6b68559c9a85ebdad896f54986beda90f02ed5d2,1,56,54,110,26,2005-07-15 21:44:19,2005-07-15 21:44:19
6b68559c9a85ebdad896f54986beda90f02ed5d2...7fcae93850491dece803eebebc531a0d6654c377,1,1,1,2,1,2005-07-15 21:46:44,2005-07-15 21:46:44
7fcae93850491dece803eebebc531a0d6654c377...246402a2339175daf83057a3d6c97c03e44004ef,1,32,4,36,4,2005-07-15 21:51:05,2005-07-15 21:51:05
246402a2339175daf83057a3d6c97c03e44004ef...835240cf04b0c00eb02e026a9d39d3cd8ff0b4be,1,2,0,2,2,2005-07-15 21:52:16,2005-07-15 21:52:16
835240cf04b0c00eb02e026a9d39d3cd8ff0b4be...158b54380e1b320023970b0f324ccc1a5c62aa5a,1,1,1,2,1,2005-07-15 21:53:20,2005-07-15 21:53:20
158b54380e1b320023970b0f324ccc1a5c62aa5a...7aed83c85437f26c62175c99a30a2bf56992f505,1,1,1,2,1,2005-07-15 22:14:15,2005-07-15 22:14:15
7aed83c85437f26c62175c99a30a2bf56992f505...d75fde94a736a4df6a068289d2204c4cd0497613,1,2,0,2,1,2005-07-15 22:24:51,2005-07-15 22:24:51
d75fde94a736a4df6a068289d2204c4cd0497613...8718675469fd3dce5213be65346c56c24fa3e701,1,1,1,2,1,2005-07-15 22:29:10,2005-07-15 22:29:10
8718675469fd3dce5213be65346c56c24fa3e701...5c7b04122a0411df41d7abd52e54b4080357ea80,1,3,2,5,2,2005-07-15 22:32:37,2005-07-15 22:32:37
5c7b04122a0411df41d7abd52e54b4080357ea80...fd5b0fa55cb68a1cb1749d80cef5112234e9a6fa,1,5,0,5,1,2005-07-15 22:35:17,2005-07-15 22:35:17
fd5b0fa55cb68a1cb1749d80cef5112234e9a6fa...03f72b629d09c962a9b0056cdf9940fb4382ced6,2,3,1,4,2,2005-07-15 22:36:26,2005-07-15 22:36:26
03f72b629d09c962a9b0056cdf9940fb4382ced6...3eaa0cf1263a67291e04c2362b64bf725f38d0bb,1,6,0,6,2,2005-07-15 22:43:30,2005-07-15 22:43:30
3eaa0cf1263a67291e04c2362b64bf725f38d0bb...97daa07bfe57a4f6e217d64d64cd1d99892b566a,1,2,1,3,1,2005-07-15 22:44:39,2005-07-15 22:44:39
97daa07bfe57a4f6e217d64d64cd1d99892b566a...8c61d243df8f954b914f2a28bf5a956f13ddee28,1,1,1,2,1,2005-07-15 22:45:03,2005-07-15 22:45:03
8c61d243df8f954b914f2a28bf5a956f13ddee28...0a35fce98ac118bcc8269e0cc330956399f38bd2,1,1,12,13,2,2005-07-15 23:41:39,2005-07-15 23:41:39
0a35fce98ac118bcc8269e0cc330956399f38bd2...dc5f2506d1f8a196459e72ffa871877a40902b53,1,1,0,1,1,2005-07-15 23:43:17,2005-07-15 23:43:17
dc5f2506d1f8a196459e72ffa871877a40902b53...8d0610d054e3f75f4343aab0bbaf64209a030711,1,3,0,3,1,2005-07-15 23:48:54,2005-07-15 23:48:54
8d0610d054e3f75f4343aab0bbaf64209a030711...07c8a965b675ae7b3047c60f2f156a8840de6c8b,1,24,24,48,23,2005-07-16 02:40:24,2005-07-16 02:40:24
07c8a965b675ae7b3047c60f2f156a8840de6c8b...40b8afaf324ee70bc753f74d6b450b3cbb7371ee,1,5,0,5,1,2005-07-16 03:12:07,2005-07-16 03:12:07
40b8afaf324ee70bc753f74d6b450b3cbb7371ee...52f5c949e9b50ae3b0034d67f2d385219588aaf1,20,634,0,634,20,2005-07-16 03:46:17,2005-07-16 03:46:17
52f5c949e9b50ae3b0034d67f2d385219588aaf1...d095db81f5167a4e40c6eb60eb9557152c781cb6,2,3,0,3,2,2005-07-16 03:48:36,2005-07-16 03:48:36
d095db81f5167a4e40c6eb60eb9557152c781cb6...635220c5cca60d512da5f41f99da54b4a4acca3b,20,0,0,0,0,2005-07-16 04:02:41,2005-07-16 04:02:41
635220c5cca60d512da5f41f99da54b4a4acca3b...c0daa77ea642d62a1742f520e3208db6a531b61c,1,11,0,11,3,2005-07-16 04:07:06,2005-07-16 04:07:06
c0daa77ea642d62a1742f520e3208db6a531b61c...dd5320d1d56ca7603747dd68871e72eee99d9e67,53,2175,0,2175,17,2005-07-16 04:27:41,2005-07-16 04:27:41
dd5320d1d56ca7603747dd68871e72eee99d9e67...d30ffb4db6a687171fb000877e9d0d9654165742,1,368,0,368,1,2005-07-16 04:55:40,2005-07-16 04:55:40
d30ffb4db6a687171fb000877e9d0d9654165742...a5a3eca7571126496f31286b91524106d5757c28,1,30,24,54,18,2005-07-16 05:19:28,2005-07-16 05:19:28
a5a3eca7571126496f31286b91524106d5757c28...e327294ade76c6b042543b455b647639db6b5093,1,0,0,0,0,2005-07-16 05:20:04,2005-07-16 05:20:04
e327294ade76c6b042543b455b647639db6b5093...451cdae8aef13dbafcdd5a02c5d16aa1d38a4d49,1,6,2,8,2,2005-07-16 05:34:17,2005-07-16 05:34:17
451cdae8aef13dbafcdd5a02c5d16aa1d38a4d49...2b40dee38dee47a58ce2da61002bf9e42bf20761,1,9,1,10,10,2005-07-16 05:44:50,2005-07-16 05:44:50
2b40dee38dee47a58ce2da61002bf9e42bf20761...fca9ba3f8cd556e49ad4f2f375a2dd3bf3730a93,1,0,0,0,0,2005-07-16 06:00:19,2005-07-16 06:00:19
fca9ba3f8cd556e49ad4f2f375a2dd3bf3730a93...edba7a435f983ec52d61af0384c5c8e89bb8b495,1,3,3,6,1,2005-07-16 14:41:31,2005-07-16 14:41:31
edba7a435f983ec52d61af0384c5c8e89bb8b495...b4168db4afdc534d06f2bb022f334994facbfedf,1,4,0,4,1,2005-07-16 16:01:34,2005-07-16 16:01:34
b4168db4afdc534d06f2bb022f334994facbfedf...f69ce6c2b322db37785d747e03cdafdf78939ab0,1,13,8,21,2,2005-07-16 16:07:04,2005-07-16 16:07:04
f69ce6c2b322db37785d747e03cdafdf78939ab0...90494777388b53e124c1cc2d00202affae786117,1,2,2,4,2,2005-07-16 16:10:04,2005-07-16 16:10:04
90494777388b53e124c1cc2d00202affae786117...470db1208d5f6983afeaa4c60a89e7498d80144c,1,10,4,14,3,2005-07-16 16:25:19,2005-07-16 16:25:19
470db1208d5f6983afeaa4c60a89e7498d80144c...68baafc1100ceae5c8073975f8561e101a4ec1a4,5,40,11,51,15,2005-07-16 16:38:28,2005-07-16 16:38:28
68baafc1100ceae5c8073975f8561e101a4ec1a4...361be49fe7cd944606c71b772c9407a732848b60,1,4,1,5,1,2005-07-16 16:55:11,2005-07-16 16:55:11
361be49fe7cd944606c71b772c9407a732848b60...5721396426cecd9fb172aa1acd27e54da7c67c8c,1,1,1,2,1,2005-07-16 16:56:27,2005-07-16 16:56:27
5721396426cecd9fb172aa1acd27e54da7c67c8c...fca1ef1d15650d6c2d5b9a35597f057004729ea4,2,86,8,94,6,2005-07-16 17:01:38,2005-07-16 17:01:38
fca1ef1d15650d6c2d5b9a35597f057004729ea4...058c526ef9995fa54d64f5e6362c9f93a935fbb0,2,24,7,31,8,2005-07-16 17:13:20,2005-07-16 17:13:20
058c526ef9995fa54d64f5e6362c9f93a935fbb0...caef61945ded51a7a3955e3089cc071de99b8942,1,3,2,5,2,2005-07-16 21:10:25,2005-07-16 21:10:25
caef61945ded51a7a3955e3089cc071de99b8942...31cd933263ed31e9059de7d6e3f8fa2c52e7e273,1,24,24,48,17,2005-07-16 21:16:40,2005-07-16 21:16:40
31cd933263ed31e9059de7d6e3f8fa2c52e7e273...87b7703bd354dbeba6ccca9093a06db49fd66555,1,1,1,2,1,2005-07-16 21:17:58,2005-07-16 21:17:58
87b7703bd354dbeba6ccca9093a06db49fd66555...8cb4eeeafea867d6434c216a0b900711e634de46,1,1,1,2,1,2005-07-16 21:21:02,2005-07-16 21:21:02
8cb4eeeafea867d6434c216a0b900711e634de46...6aa49f26759089ffd2f9d0952c12c670e3e3094a,4,62,61,123,33,2005-07-16 22:03:37,2005-07-16 22:03:37
6aa49f26759089ffd2f9d0952c12c670e3e3094a...e6a39617e584b7f942b7b5c028bc54dab1888579,2,0,0,0,0,2005-07-16 22:07:20,2005-07-16 22:07:20
e6a39617e584b7f942b7b5c028bc54dab1888579...980b3ce696b52c73064193dcd9b9f63ae067b56a,1,0,0,0,0,2005-07-16 22:07:47,2005-07-16 22:07:47
980b3ce696b52c73064193dcd9b9f63ae067b56a...60bdadb9a3464a7f1f322655dc32d6a33d754be7,2,6,5,11,4,2005-07-16 22:12:24,2005-07-16 22:12:24
60bdadb9a3464a7f1f322655dc32d6a33d754be7...b9ec05d4c03d111fb2846645fc12a9bb0d361388,1,15,13,28,9,2005-07-16 22:19:10,2005-07-16 22:19:10
b9ec05d4c03d111fb2846645fc12a9bb0d361388...1e0fb3b7a3250a96869d598526be285e6f2a4fcd,1,3,1,4,1,2005-07-16 22:21:50,2005-07-16 22:21:50
1e0fb3b7a3250a96869d598526be285e6f2a4fcd...820e12dac6ab8ee7fa46a2b27da3575b094bf2bb,1,1,1,2,1,2005-07-16 22:44:37,2005-07-16 22:44:37
820e12dac6ab8ee7fa46a2b27da3575b094bf2bb...a22f823e0034bf607b841bd704cfd4d2cc6621a1,5,14,1,15,4,2005-07-16 22:58:29,2005-07-16 22:58:29
a22f823e0034bf607b841bd704cfd4d2cc6621a1...d9e5a4ea5bee99cb3b3d24722e51c56021dd4545,1,0,1,1,1,2005-07-16 23:00:04,2005-07-16 23:00:04
d9e5a4ea5bee99cb3b3d24722e51c56021dd4545...a2a7fd0b824c76a6c599b731ca6505873d4195dd,1,1,1,2,1,2005-07-16 23:34:07,2005-07-16 23:34:07
a2a7fd0b824c76a6c599b731ca6505873d4195dd...cfcf3ca1e3fc116388e9f95064acc0cf2233a93f,2,52,0,52,2,2005-07-16 23:38:12,2005-07-16 23:38:12
cfcf3ca1e3fc116388e9f95064acc0cf2233a93f...82f04688014ff309e1744d76f0cc09ad69fc8db8,1,6,3,9,3,2005-07-16 23:58:49,2005-07-16 23:58:49
82f04688014ff309e1744d76f0cc09ad69fc8db8...c012d6ccf1b4d4b73c0e2633d14e70fe8f04d252,1,258,0,258,1,2005-07-17 00:54:15,2005-07-17 00:54:15
c012d6ccf1b4d4b73c0e2633d14e70fe8f04d252...f926982800cd32fc136e4f60719e8ef5c03ae217,1,11,9,20,2,2005-07-17 01:00:25,2005-07-17 01:00:25
f926982800cd32fc136e4f60719e8ef5c03ae217...2b681e9203a8e7adc1f7b789a6060aa9e37ebea4,1,8,8,16,4,2005-07-17 02:21:54,2005-07-17 02:21:54
2b681e9203a8e7adc1f7b789a6060aa9e37ebea4...364f3704b0cce0d147336ae2d9328ea95e152b63,1,22,2,24,1,2005-07-17 02:43:18,2005-07-17 02:43:18
364f3704b0cce0d147336ae2d9328ea95e152b63...4211bcb43767b66e65599f7f3e38cdb52cd44243,1,3,1,4,1,2005-07-17 02:46:04,2005-07-17 02:46:04
4211bcb43767b66e65599f7f3e38cdb52cd44243...81215d79330507b26291d3347279b9c718da9fac,1,7,2,9,2,2005-07-17 02:59:31,2005-07-17 02:59:31
81215d79330507b26291d3347279b9c718da9fac...d0e5eab6572b54ddb7c52d8afea1c3786e95ab2f,3,0,0,0,0,2005-07-17 03:58:08,2005-07-17 03:58:08
d0e5eab6572b54ddb7c52d8afea1c3786e95ab2f...5e309eb6e4e140590fb4567b138325bbab7eca71,1,371,358,729,181,2005-07-17 04:20:57,2005-07-17 04:20:57
5e309eb6e4e140590fb4567b138325bbab7eca71...af86b4e4b1a8a22dc8458bb0874ce2754ea85a6d,1,88,2,90,1,2005-07-17 05:21:19,2005-07-17 05:21:19
af86b4e4b1a8a22dc8458bb0874ce2754ea85a6d...5162e4745fca4b0d67da8ad6fe60f6a675b4a1e0,1,1,1,2,1,2005-07-17 05:22:48,2005-07-17 05:22:48
5162e4745fca4b0d67da8ad6fe60f6a675b4a1e0...081f2f8c8d0a8902f04dfcca3a83cd7eb7779bff,1,89,0,89,1,2005-07-17 05:52:07,2005-07-17 05:52:07
081f2f8c8d0a8902f04dfcca3a83cd7eb7779bff...069bd054fd4413a47f2f9ace620b01cbfa33ecba,1,2,2,4,2,2005-07-17 05:53:34,2005-07-17 05:53:34
069bd054fd4413a47f2f9ace620b01cbfa33ecba...7ade7678196347224789a46c77b17df7f3f3ccb4,1,2,2,4,2,2005-07-17 05:54:43,2005-07-17 05:54:43
7ade7678196347224789a46c77b17df7f3f3ccb4...c9cc6f87f9fb77a3d12db1b5640ac465f80418c3,2,75,18,93,4,2005-07-17 06:11:33,2005-07-17 06:11:33
c9cc6f87f9fb77a3d12db1b5640ac465f80418c3...a1ef6aa10b302d77855172dba62918becc6a758c,1,2,2,4,1,2005-07-17 06:12:58,2005-07-17 06:12:58
a1ef6aa10b302d77855172dba62918becc6a758c...0b62adddb241df9eb4d4e525e1952059615a5ebd,1,5,0,5,1,2005-07-17 06:30:31,2005-07-17 06:30:31
0b62adddb241df9eb4d4e525e1952059615a5ebd...136d78b86ed421126eb604e39527a5b90ec94974,1,163,163,326,155,2005-07-17 15:15:26,2005-07-17 15:15:26
136d78b86ed421126eb604e39527a5b90ec94974...7e951c92f327db7193e58881ad08dbd3b07ba55f,1,6,2,8,2,2005-07-17 15:23:34,2005-07-17 15:23:34
7e951c92f327db7193e58881ad08dbd3b07ba55f...aef751972c426707ea6e1aee28a5ea8c94141fd0,1,1,1,2,1,2005-07-17 15:35:22,2005-07-17 15:35:22
aef751972c426707ea6e1aee28a5ea8c94141fd0...ad8e55db9b0856573bfe740c350bfb39c7ca388e,3,15,2,17,5,2005-07-17 15:53:56,2005-07-17 15:53:56
ad8e55db9b0856573bfe740c350bfb39c7ca388e...7718319cbd5ebc5daa42f9b9edb98fb3c784d4db,2,4,4,8,4,2005-07-17 15:58:53,2005-07-17 15:58:53
7718319cbd5ebc5daa42f9b9edb98fb3c784d4db...f87473e12dfe0beef028ae37b7eb453131050337,2,4,4,8,4,2005-07-17 15:59:37,2005-07-17 15:59:37
f87473e12dfe0beef028ae37b7eb453131050337...fe3373c7941e847eb247c6292b5ae37eeeb3188e,1,1,1,2,1,2005-07-17 15:59:59,2005-07-17 15:59:59
fe3373c7941e847eb247c6292b5ae37eeeb3188e...35c16cba2cafab083ae7858aebb777e5d722d835,36,0,0,0,0,2005-07-17 16:11:13,2005-07-17 16:11:13
35c16cba2cafab083ae7858aebb777e5d722d835...1680686e3aac30c947adde410b1fa6f30d86c581,1,1,1,2,1,2005-07-17 16:14:29,2005-07-17 16:14:29
1680686e3aac30c947adde410b1fa6f30d86c581...9629e40f354850c01c7bca9a5d006b22e18868f1,2,42,42,84,25,2005-07-17 16:26:46,2005-07-17 16:26:46
9629e40f354850c01c7bca9a5d006b22e18868f1...729fc547efe639043461aaf1d369a467400df7cb,1,3,0,3,1,2005-07-17 17:05:01,2005-07-17 17:05:01
729fc547efe639043461aaf1d369a467400df7cb...6ae4def03b600a515f5715c3842d618d2fa1e84b,2,2,0,2,2,2005-07-17 17:22:17,2005-07-17 17:22:17
6ae4def03b600a515f5715c3842d618d2fa1e84b...58df4ce6364643732c6b2d9ab2d4a0254f5e1a89,1,2,6,8,1,2005-07-17 17:27:34,2005-07-17 17:27:34
58df4ce6364643732c6b2d9ab2d4a0254f5e1a89...35e81ce5af17268773e5f4fc48bc8452c89cc552,1,5,2,7,1,2005-07-17 17:44:57,2005-07-17 17:44:57
35e81ce5af17268773e5f4fc48bc8452c89cc552...272b2175578c0ede4359fb10c96831b4aea95933,4,10,1,11,4,2005-07-17 18:23:34,2005-07-17 18:23:34
272b2175578c0ede4359fb10c96831b4aea95933...d4ddc06021a6c39665949111d9e9e9b2c4675ae6,1,5,1,6,1,2005-07-17 20:03:24,2005-07-17 20:03:24
d4ddc06021a6c39665949111d9e9e9b2c4675ae6...b1c543d0910a79f4de93464fa684416c9441f7ce,4,27,3,30,8,2005-07-17 20:16:06,2005-07-17 20:16:06
b1c543d0910a79f4de93464fa684416c9441f7ce...683755118f8cbb0a31cd974b1e857984dde86b85,1,2,1,3,1,2005-07-18 02:38:44,2005-07-18 02:38:44
683755118f8cbb0a31cd974b1e857984dde86b85...dd85d8da104091ffcc85415f0b292b4695049c72,1,3,1,4,2,2005-07-18 02:48:52,2005-07-18 02:48:52
dd85d8da104091ffcc85415f0b292b4695049c72...f3a43a2dd4b111fdf330c023478d586b3f015546,1,2,6,8,3,2005-07-18 03:13:02,2005-07-18 03:13:02
f3a43a2dd4b111fdf330c023478d586b3f015546...ac2a7c116dcc0591c5cb55f75b687ef9e8be632e,1,5,5,10,3,2005-07-18 05:52:06,2005-07-18 05:52:06
ac2a7c116dcc0591c5cb55f75b687ef9e8be632e...246c1f88d9d2634267b28e9de3fd05d1ddcbfa26,1,0,4,4,1,2005-07-18 06:01:39,2005-07-18 06:01:39
246c1f88d9d2634267b28e9de3fd05d1ddcbfa26...feeeda969c68757a26e769e7c6bbd2c7e5d58f8b,3,35,46,81,6,2005-07-18 06:05:18,2005-07-18 06:05:18
feeeda969c68757a26e769e7c6bbd2c7e5d58f8b...4e094e26e6ada89a2810eb1ff335f22ef6a5ca5d,2,8,8,16,8,2005-07-18 06:10:00,2005-07-18 06:10:00
4e094e26e6ada89a2810eb1ff335f22ef6a5ca5d...ca3d89b70f30598d8e3a8438fcf4a0050963a21e,6,530,279,809,8,2005-07-18 06:30:26,2005-07-18 06:30:26
ca3d89b70f30598d8e3a8438fcf4a0050963a21e...86d9ae269d969f71e44234493f9af529253391c0,1,1,1,2,1,2005-07-18 06:34:34,2005-07-18 06:34:34
86d9ae269d969f71e44234493f9af529253391c0...78206fd08c72a37a9ca1379e5c689edb59511efb,1,1,1,2,1,2005-07-18 13:53:45,2005-07-18 13:53:45
78206fd08c72a37a9ca1379e5c689edb59511efb...fe8ca41e6302f2588f3757fbb3fb50a62cf113ab,1,6,0,6,2,2005-07-18 13:57:25,2005-07-18 13:57:25
fe8ca41e6302f2588f3757fbb3fb50a62cf113ab...fbfa3d603ec12bf3789df558e9fd2f9e7bd0eb0f,1,2,0,2,1,2005-07-18 14:03:56,2005-07-18 14:03:56
fbfa3d603ec12bf3789df558e9fd2f9e7bd0eb0f...b68c478aa5d890e76aae6e2f695220505618c8e0,3,617,0,617,4,2005-07-18 15:25:58,2005-07-18 15:25:58
b68c478aa5d890e76aae6e2f695220505618c8e0...912253371d58a27427719d50aa5cf140153f78df,2,13,11,24,3,2005-07-18 17:23:04,2005-07-18 17:23:04
912253371d58a27427719d50aa5cf140153f78df...32e9209dd9928b813d1b8c52627d77c46c097184,1,1,1,2,1,2005-07-18 18:10:41,2005-07-18 18:10:41
32e9209dd9928b813d1b8c52627d77c46c097184...0944653673db90cce1f5fa972d0a8134dca19a75,1,7,4,11,3,2005-07-18 18:47:55,2005-07-18 18:47:55
0944653673db90cce1f5fa972d0a8134dca19a75...8fd94405b51298e84fea604f339b8147df583270,1,88,0,88,1,2005-07-18 19:07:37,2005-07-18 19:07:37
8fd94405b51298e84fea604f339b8147df583270...cf4c164e9f76b7be2ea6257d223b76d4625f70c6,1,2,2,4,2,2005-07-18 20:14:05,2005-07-18 20:14:05
cf4c164e9f76b7be2ea6257d223b76d4625f70c6...12c04fbf293f49f007176660a2b1fb4e279eedee,1,5,1,6,3,2005-07-18 20:35:51,2005-07-18 20:35:51
12c04fbf293f49f007176660a2b1fb4e279eedee...a7237aaface05fc332a19475bcc27df056eaca9a,2,2,2,4,2,2005-07-18 20:43:57,2005-07-18 20:43:57
a7237aaface05fc332a19475bcc27df056eaca9a...34f749e506b6e0748809ba71e877082cf5eedd21,1,14,13,27,11,2005-07-18 20:53:02,2005-07-18 20:53:02
34f749e506b6e0748809ba71e877082cf5eedd21...a7506973af918e177d102328c6db52bc9e0f43b4,56,48,3,51,4,2005-07-18 22:35:04,2005-07-18 22:35:04
a7506973af918e177d102328c6db52bc9e0f43b4...62cc287b2b6466e877b2f46d9e0825fb294f542e,1,7,4,11,3,2005-07-18 22:49:04,2005-07-18 22:49:04
62cc287b2b6466e877b2f46d9e0825fb294f542e...b55b29c891b6b6b692d3e39f49875163a21e896e,3,66,95,161,26,2005-07-18 23:14:48,2005-07-18 23:14:48
b55b29c891b6b6b692d3e39f49875163a21e896e...00f54d6cf69fbe9a3970c038c2a67ee8c8307bca,1,3,0,3,1,2005-07-18 23:22:07,2005-07-18 23:22:07
00f54d6cf69fbe9a3970c038c2a67ee8c8307bca...8f4fa5a4e7435876a99383bffafb7a09ba6667e1,1,12,3,15,4,2005-07-19 02:13:20,2005-07-19 02:13:20
8f4fa5a4e7435876a99383bffafb7a09ba6667e1...2363af5782deab47d1f3bfab629d986191a27502,1,4,5,9,2,2005-07-19 02:22:11,2005-07-19 02:22:11
2363af5782deab47d1f3bfab629d986191a27502...73ea27ccb0ff4cacb3bc492496d9529aebed2970,1,4,4,8,1,2005-07-19 03:06:28,2005-07-19 03:06:28
73ea27ccb0ff4cacb3bc492496d9529aebed2970...3ab579138375bd41bd8fca1126b68aecb68b9951,1,4,4,8,2,2005-07-19 04:30:23,2005-07-19 04:30:23
3ab579138375bd41bd8fca1126b68aecb68b9951...7d553c0650a1dad73c98cf8cd9b8d13eb0633e56,1,5,1,6,1,2005-07-19 04:40:57,2005-07-19 04:40:57
7d553c0650a1dad73c98cf8cd9b8d13eb0633e56...1f4379bcd4374b699f0645d95113a40e194e2d7b,2,418,11,429,3,2005-07-19 05:43:07,2005-07-19 05:43:07
1f4379bcd4374b699f0645d95113a40e194e2d7b...fc85642ed538464154d0e8e294ab99c3b14d0590,1,1,1,2,1,2005-07-19 05:45:31,2005-07-19 05:45:31
fc85642ed538464154d0e8e294ab99c3b14d0590...b20bb2fc2663e0c5aa654cd8db74ced8d2733cae,1,1,1,2,1,2005-07-19 05:50:33,2005-07-19 05:50:33
b20bb2fc2663e0c5aa654cd8db74ced8d2733cae...6fdb7c98e820912b387da05f4a4d9643afd9c3d8,1,5,5,10,1,2005-07-19 05:52:06,2005-07-19 05:52:06
6fdb7c98e820912b387da05f4a4d9643afd9c3d8...09e825c7466b87e2a974a07453156d1cd6fc70e5,1,1,1,2,1,2005-07-19 05:52:54,2005-07-19 05:52:54
09e825c7466b87e2a974a07453156d1cd6fc70e5...851b14deca6eda4d4b6312f8ed10f65c14115c9c,1,4,2,6,2,2005-07-19 05:55:42,2005-07-19 05:55:42
851b14deca6eda4d4b6312f8ed10f65c14115c9c...1062b1e042b1c920c73ae12384086027521e3b8a,1,1,1,2,1,2005-07-19 05:58:19,2005-07-19 05:58:19
1062b1e042b1c920c73ae12384086027521e3b8a...bec9009d8399c5a33508ba226f3839cd8b305484,1,4,2,6,2,2005-07-19 14:41:08,2005-07-19 14:41:08
bec9009d8399c5a33508ba226f3839cd8b305484...7fa76265ad1c040812f7973d102dfacd3a72bf6e,1,4,4,8,4,2005-07-19 14:44:27,2005-07-19 14:44:27
7fa76265ad1c040812f7973d102dfacd3a72bf6e...b430d4c54f9a505ff451fa7dae4b74da76ebb1c7,1,1,1,2,1,2005-07-19 14:47:41,2005-07-19 14:47:41
b430d4c54f9a505ff451fa7dae4b74da76ebb1c7...b617884ced62482603603d8c1929c70051b44426,1,1,1,2,1,2005-07-19 15:23:22,2005-07-19 15:23:22
b617884ced62482603603d8c1929c70051b44426...57970663831908e8f1e8bb787b04ac923d123e41,3,28,16,44,10,2005-07-19 15:24:03,2005-07-19 15:24:03
57970663831908e8f1e8bb787b04ac923d123e41...3e09a1fc1c7cd44a3c7b74ef0573018d01c484d2,1,2,2,4,1,2005-07-19 15:24:27,2005-07-19 15:24:27
3e09a1fc1c7cd44a3c7b74ef0573018d01c484d2...0bb0ad8d435cc4eb3f7d9481ead7085e12e0a088,1,4,4,8,1,2005-07-19 15:31:05,2005-07-19 15:31:05
0bb0ad8d435cc4eb3f7d9481ead7085e12e0a088...b68f26e42dbfe95783d63662963721bb030172e0,1,14,2,16,5,2005-07-19 15:39:15,2005-07-19 15:39:15
b68f26e42dbfe95783d63662963721bb030172e0...e243d8287442a65d8c620f5c4f3033aa7d6bbd82,1,37,37,74,1,2005-07-19 15:44:04,2005-07-19 15:44:04
e243d8287442a65d8c620f5c4f3033aa7d6bbd82...df66763406cc76e8d0c65b3a857c891c21c25f49,5,59,49,108,31,2005-07-19 17:20:37,2005-07-19 17:20:37
df66763406cc76e8d0c65b3a857c891c21c25f49...e29afe7974c169f0028c71b6c33a793bc5f7464d,1,8,1,9,2,2005-07-19 17:58:01,2005-07-19 17:58:01
e29afe7974c169f0028c71b6c33a793bc5f7464d...258afd8fae2bf34ca40525c38b9fc28fb2465d79,1,1,1,2,1,2005-07-19 18:34:25,2005-07-19 18:34:25
258afd8fae2bf34ca40525c38b9fc28fb2465d79...5874952a8e799783c16e87e427fc13272f581843,1,8,1,9,2,2005-07-19 19:04:12,2005-07-19 19:04:12
5874952a8e799783c16e87e427fc13272f581843...307f3a95c7c0466f8b821395b611d3253ae4c79c,1,1,1,2,1,2005-07-19 19:13:33,2005-07-19 19:13:33
307f3a95c7c0466f8b821395b611d3253ae4c79c...3ad2a774a7b9224c1cd4890b9d99c6871c414372,1,41,0,41,1,2005-07-19 19:55:18,2005-07-19 19:55:18
3ad2a774a7b9224c1cd4890b9d99c6871c414372...c9f90060a5ff716630d393046bb3348dc5f50c0e,1,20,0,20,1,2005-07-19 19:55:31,2005-07-19 19:55:31
c9f90060a5ff716630d393046bb3348dc5f50c0e...c97d93ed56b55b63686e7d39dd39086169d2ea0a,1,3,0,3,1,2005-07-19 19:58:19,2005-07-19 19:58:19
c97d93ed56b55b63686e7d39dd39086169d2ea0a...21f152e9e59d9e0278d5b4b114781b64e4259f30,1,1,1,2,1,2005-07-19 20:01:49,2005-07-19 20:01:49
21f152e9e59d9e0278d5b4b114781b64e4259f30...1dfc375e35d44d68b84eb3ae6e7c1fd04c920eee,1,23,4,27,4,2005-07-19 20:05:52,2005-07-19 20:05:52
1dfc375e35d44d68b84eb3ae6e7c1fd04c920eee...3148adf91d5fc6e8d2c0939b0f8bbe3240de2df3,1,4,0,4,1,2005-07-19 20:08:17,2005-07-19 20:08:17
3148adf91d5fc6e8d2c0939b0f8bbe3240de2df3...12321ea962128e2c051cb996d7936288f95d1c8f,1,12,0,12,2,2005-07-19 20:20:38,2005-07-19 20:20:38
12321ea962128e2c051cb996d7936288f95d1c8f...b0e1a1dda8c020cd6ebe07640fd5929cd5ee3345,1,96,57,153,30,2005-07-19 20:49:07,2005-07-19 20:49:07
b0e1a1dda8c020cd6ebe07640fd5929cd5ee3345...9581c9ed96a841c90f780b8d3f0c455640e9418f,1,3,2,5,1,2005-07-19 20:51:00,2005-07-19 20:51:00
9581c9ed96a841c90f780b8d3f0c455640e9418f...76633e54999e048afc04ffe24af496ce600c668d,1,1,1,2,1,2005-07-19 20:58:16,2005-07-19 20:58:16
76633e54999e048afc04ffe24af496ce600c668d...3fc5294d2eb0628091953055caf70f0b0e75fa23,1,1,1,2,1,2005-07-19 21:32:58,2005-07-19 21:32:58
3fc5294d2eb0628091953055caf70f0b0e75fa23...43538e78eb98966838168b9d9d84d5f6313e9277,2,2,2,4,2,2005-07-19 21:39:52,2005-07-19 21:39:52
43538e78eb98966838168b9d9d84d5f6313e9277...897d24b220a9615f036ffed663926851a7ec5e64,6,32,21,53,18,2005-07-20 00:37:45,2005-07-20 00:37:45
897d24b220a9615f036ffed663926851a7ec5e64...49fbe711ccfe302c00ce7b1e5d71848699482899,1,1,0,1,1,2005-07-20 00:43:39,2005-07-20 00:43:39
49fbe711ccfe302c00ce7b1e5d71848699482899...20820f2e85e6e4937e76f83c37b04e3eeda76308,1,5,1,6,1,2005-07-20 00:47:10,2005-07-20 00:47:10
20820f2e85e6e4937e76f83c37b04e3eeda76308...d384870307a7612fe6eb340aeabcdc543b61390e,1,3,3,6,3,2005-07-20 00:50:37,2005-07-20 00:50:37
d384870307a7612fe6eb340aeabcdc543b61390e...526f6af782350bbc3913470a6736c0f7f44548d0,1,1,2,3,1,2005-07-20 00:57:38,2005-07-20 00:57:38
526f6af782350bbc3913470a6736c0f7f44548d0...a88119369329c63cc53d9a309db19a867b81f91f,1,31,35,66,15,2005-07-20 01:16:51,2005-07-20 01:16:51
a88119369329c63cc53d9a309db19a867b81f91f...039d121227313306a5cbd5805fba63e1e62996e1,1,17,0,17,1,2005-07-20 01:34:08,2005-07-20 01:34:08
039d121227313306a5cbd5805fba63e1e62996e1...584cab7bc5125be488c8f755b5c3ce50cf5a5c6f,3,27,25,52,8,2005-07-20 05:46:00,2005-07-20 05:46:00
584cab7bc5125be488c8f755b5c3ce50cf5a5c6f...45c334dd8bf9945e745a68b1199c2e536a3274d3,1,8,5,13,6,2005-07-20 06:05:32,2005-07-20 06:05:32
45c334dd8bf9945e745a68b1199c2e536a3274d3...2012f7df63a6c087792b7afa7e9cb1d26731005e,1,3,1,4,2,2005-07-20 06:08:39,2005-07-20 06:08:39
2012f7df63a6c087792b7afa7e9cb1d26731005e...e215ed36092807a558fcfa29492d7246ce6158ed,2,4,4,8,4,2005-07-20 06:13:06,2005-07-20 06:13:06
e215ed36092807a558fcfa29492d7246ce6158ed...1fc28dea117e710b9c16b6c53e49049fa6d764c5,2,419,415,834,6,2005-07-20 15:00:34,2005-07-20 15:00:34
1fc28dea117e710b9c16b6c53e49049fa6d764c5...890bd5b0d24a0f1dba6eab639c3b1e731424b006,1,50,18,68,13,2005-07-20 17:07:30,2005-07-20 17:07:30
890bd5b0d24a0f1dba6eab639c3b1e731424b006...067f56d93de6232179ce2651281c67256ab28023,1,1,1,2,1,2005-07-20 17:09:39,2005-07-20 17:09:39
067f56d93de6232179ce2651281c67256ab28023...1b8c4c455682e6fcc747ae2dfc0133862dd0d1a3,1,1,1,2,1,2005-07-20 17:12:12,2005-07-20 17:12:12
1b8c4c455682e6fcc747ae2dfc0133862dd0d1a3...ec31445c527a22a736cc769d35791f3fea9b477b,4,90,61,151,33,2005-07-20 17:42:36,2005-07-20 17:42:36
ec31445c527a22a736cc769d35791f3fea9b477b...e5a8c38fa1d9dae0bebc6b4671997b0f16e60913,2,20,17,37,3,2005-07-20 20:10:35,2005-07-20 20:10:35
e5a8c38fa1d9dae0bebc6b4671997b0f16e60913...99a75541fdf5e83f228db8e9c06e10226dae65c5,1,1,1,2,1,2005-07-20 20:12:29,2005-07-20 20:12:29
99a75541fdf5e83f228db8e9c06e10226dae65c5...47cc60d94b6f96ae939b7325be793d8a2cf8f31d,1,3,3,6,3,2005-07-20 20:35:53,2005-07-20 20:35:53
47cc60d94b6f96ae939b7325be793d8a2cf8f31d...10ace9a124014333fd0a74ba1645ad0c23dee38b,1,3,2,5,1,2005-07-20 21:01:47,2005-07-20 21:01:47
10ace9a124014333fd0a74ba1645ad0c23dee38b...65bed3241d2e5546841f2c370449d67426022a27,1,5,0,5,1,2005-07-20 21:24:03,2005-07-20 21:24:03
65bed3241d2e5546841f2c370449d67426022a27...d9656947db8f4c89546031cd49fe198bcef7a7cd,1,1,1,2,1,2005-07-20 21:41:43,2005-07-20 21:41:43
d9656947db8f4c89546031cd49fe198bcef7a7cd...895d23267115412ab7344ce7668adb1efa7f8e00,2,7,7,14,5,2005-07-20 21:56:12,2005-07-20 21:56:12
895d23267115412ab7344ce7668adb1efa7f8e00...bc5359f754f7afe6b4aa1eb4972c32a508b7fb55,2,23,5,28,5,2005-07-20 22:55:01,2005-07-20 22:55:01
bc5359f754f7afe6b4aa1eb4972c32a508b7fb55...903920a3d23f33abc7574cb9fcca17cb87f7e59a,1,2,0,2,1,2005-07-21 01:33:13,2005-07-21 01:33:13
903920a3d23f33abc7574cb9fcca17cb87f7e59a...b2cb66bfbca65b6b52cbfb9ef2cb71af774e0d80,2,19,2,21,2,2005-07-21 01:37:28,2005-07-21 01:37:28
b2cb66bfbca65b6b52cbfb9ef2cb71af774e0d80...0500321a4be08ac2a1b27ac15c4194986610a39a,1,28,0,28,1,2005-07-21 01:48:59,2005-07-21 01:48:59
0500321a4be08ac2a1b27ac15c4194986610a39a...d330be016927bacf5fcad337138741311ac7270e,3,59,26,85,8,2005-07-21 02:17:45,2005-07-21 02:17:45
d330be016927bacf5fcad337138741311ac7270e...8d144dadd8b60a7ce803ebcb235718f06e2d5986,2,2,2,4,2,2005-07-21 02:20:40,2005-07-21 02:20:40
8d144dadd8b60a7ce803ebcb235718f06e2d5986...03c436bf61747892af12c87c15b3548d83d53bec,1,8,5,13,5,2005-07-21 03:19:30,2005-07-21 03:19:30
03c436bf61747892af12c87c15b3548d83d53bec...304b08e3254f7c46999d1204ce9968c00ad088eb,1,3,0,3,2,2005-07-21 03:24:28,2005-07-21 03:24:28
304b08e3254f7c46999d1204ce9968c00ad088eb...c21f6ecee24c6587bb8ddddc878aad3fd29b40a7,6,24,41,65,14,2005-07-21 03:46:16,2005-07-21 03:46:16
c21f6ecee24c6587bb8ddddc878aad3fd29b40a7...9566a61a22e1da30fb8abfef4b25d83d0c465be9,2,72,19,91,4,2005-07-21 04:08:54,2005-07-21 04:08:54
9566a61a22e1da30fb8abfef4b25d83d0c465be9...e1d21e5bcfc492333069db055c6b4ea59065875f,1,26,0,26,1,2005-07-21 04:10:47,2005-07-21 04:10:47
e1d21e5bcfc492333069db055c6b4ea59065875f...6b514f1aab919fe847095f0f02c33b08d2023a0b,1,1,1,2,1,2005-07-21 13:53:33,2005-07-21 13:53:33
6b514f1aab919fe847095f0f02c33b08d2023a0b...907ae72e81b2908a86fc520af897eeb432e03d58,1,3,3,6,2,2005-07-21 13:57:42,2005-07-21 13:57:42
907ae72e81b2908a86fc520af897eeb432e03d58...ccffb199464e9b982f2972a29d5ecb35cf53f586,1,1,1,2,1,2005-07-21 14:01:17,2005-07-21 14:01:17
ccffb199464e9b982f2972a29d5ecb35cf53f586...4cb985df1638241c40c48b3637d6663652f12fcf,1,29,5,34,3,2005-07-21 14:11:25,2005-07-21 14:11:25
4cb985df1638241c40c48b3637d6663652f12fcf...841b42624365e573b5da8d020931bdb93e7ebc47,1,2,2,4,1,2005-07-21 15:01:31,2005-07-21 15:01:31
841b42624365e573b5da8d020931bdb93e7ebc47...3ff931848e1c9261021db35eac9381c5c40c55d4,1,16,16,32,5,2005-07-21 15:06:49,2005-07-21 15:06:49
3ff931848e1c9261021db35eac9381c5c40c55d4...8aa16458126f48a474a0f17b225abb822e11790e,2,6,11,17,3,2005-07-21 15:36:43,2005-07-21 15:36:43
8aa16458126f48a474a0f17b225abb822e11790e...52d761cc7a2296e75f4e97e1c0e501f2623fe08c,1,25,0,25,1,2005-07-21 15:40:33,2005-07-21 15:40:33
52d761cc7a2296e75f4e97e1c0e501f2623fe08c...78cff1837aed5fccb35e378bd2dd27a3d09a7a00,2,25,21,46,3,2005-07-21 15:48:20,2005-07-21 15:48:20
78cff1837aed5fccb35e378bd2dd27a3d09a7a00...7af62f48e33c5e392b6978607e312f4e033f1de4,1,19,4,23,1,2005-07-21 17:37:36,2005-07-21 17:37:36
7af62f48e33c5e392b6978607e312f4e033f1de4...8a285ec790ab0ec4e19c730d17725183490ad81f,1,1,1,2,1,2005-07-21 17:38:28,2005-07-21 17:38:28
8a285ec790ab0ec4e19c730d17725183490ad81f...2dfea67e341903a1e63f93010f1a007b085696b0,1,1,1,2,1,2005-07-21 17:39:11,2005-07-21 17:39:11
2dfea67e341903a1e63f93010f1a007b085696b0...6bb7c50143c99e22251d7525500a2f2a6ef6ac00,1,40,35,75,4,2005-07-21 17:59:05,2005-07-21 17:59:05
6bb7c50143c99e22251d7525500a2f2a6ef6ac00...df6feb54f2e962d2ecaab370514f764317de1acf,1,16,11,27,2,2005-07-21 18:03:25,2005-07-21 18:03:25
df6feb54f2e962d2ecaab370514f764317de1acf...96d69c5b5faa07c3be471b9a9c849b40a305e5f4,1,6,2,8,3,2005-07-21 18:12:29,2005-07-21 18:12:29
96d69c5b5faa07c3be471b9a9c849b40a305e5f4...18749c00602edeafd0b10da807ec55767fd6a6c8,3,12,3,15,4,2005-07-21 19:05:10,2005-07-21 19:05:10
18749c00602edeafd0b10da807ec55767fd6a6c8...8b58f8b3ae51910b4399209e729ffb9fee394f83,1,1,1,2,1,2005-07-21 19:19:01,2005-07-21 19:19:01
8b58f8b3ae51910b4399209e729ffb9fee394f83...f8e5df6d7ebdd5dd48ee56645fc008928b478358,1,7,5,12,3,2005-07-21 19:42:51,2005-07-21 19:42:51
f8e5df6d7ebdd5dd48ee56645fc008928b478358...9c3c0bed334ce5db7156128d5639182bb4170315,1,2,3,5,1,2005-07-21 19:45:36,2005-07-21 19:45:36
9c3c0bed334ce5db7156128d5639182bb4170315...dbfb35b54225b7f3cf188ea6dba143a589924a0f,3,1,9,10,2,2005-07-22 00:49:53,2005-07-22 00:49:53
dbfb35b54225b7f3cf188ea6dba143a589924a0f...e320a0936e4c846e7332bcacc533dda19dad6783,4,205,44,249,8,2005-07-22 03:15:43,2005-07-22 03:15:43
e320a0936e4c846e7332bcacc533dda19dad6783...a1f479e080314b1ea957d4eedb7b091184ae0f55,2,6,6,12,2,2005-07-22 04:18:03,2005-07-22 04:18:03
a1f479e080314b1ea957d4eedb7b091184ae0f55...2d3def9fa29422b2acd2380d84c1d4c0c2e1b331,1,1,2,3,2,2005-07-22 04:40:37,2005-07-22 04:40:37
2d3def9fa29422b2acd2380d84c1d4c0c2e1b331...05bdb8d64b7f539b7c6ffcd5d7c4ef9b3406c657,1,2,2,4,1,2005-07-22 05:11:37,2005-07-22 05:11:37
05bdb8d64b7f539b7c6ffcd5d7c4ef9b3406c657...8b3c05afa55f963d6e966707737cbc639f697239,7,93,56,149,48,2005-07-22 13:02:27,2005-07-22 13:02:27
8b3c05afa55f963d6e966707737cbc639f697239...837a64565b2494d3cac6909b070cb29c567b786c,1,2,2,4,2,2005-07-22 13:03:50,2005-07-22 13:03:50
837a64565b2494d3cac6909b070cb29c567b786c...8ef422d070ecd19ab285282430b174513736aa9d,5,75,0,75,5,2005-07-22 15:02:40,2005-07-22 15:02:40
8ef422d070ecd19ab285282430b174513736aa9d...f1f952761e6c20ec59a58c377a68c3a3c357773c,1,1,1,2,1,2005-07-22 16:40:36,2005-07-22 16:40:36
f1f952761e6c20ec59a58c377a68c3a3c357773c...79026a6e224250612c76ecf8cfa33c519983e70e,1,2,2,4,2,2005-07-22 17:58:56,2005-07-22 17:58:56
79026a6e224250612c76ecf8cfa33c519983e70e...d573cb021e69854d947dd988b6c9e492a688a377,1,11,1,12,2,2005-07-22 18:12:05,2005-07-22 18:12:05
d573cb021e69854d947dd988b6c9e492a688a377...c97efb6799168c8903fc1181ecada7fe9932dd1f,3,121,232,353,7,2005-07-22 18:34:38,2005-07-22 18:34:38
c97efb6799168c8903fc1181ecada7fe9932dd1f...c2a5c49ac279f1e0e2cdbec3de0d957893b9c839,3,21,22,43,14,2005-07-22 18:45:22,2005-07-22 18:45:22
c2a5c49ac279f1e0e2cdbec3de0d957893b9c839...0bbe1f4425db3a20d88ad64161170a6227cd8909,1,1,1,2,1,2005-07-22 21:56:50,2005-07-22 21:56:50
0bbe1f4425db3a20d88ad64161170a6227cd8909...4ab1e196c44903f89d123a6055d3330100bfbc1c,1,1,1,2,1,2005-07-23 15:47:06,2005-07-23 15:47:06
4ab1e196c44903f89d123a6055d3330100bfbc1c...768c17eda0310b99daa75e05e7e1e00bb82fbc15,1,1,1,2,1,2005-07-23 15:49:26,2005-07-23 15:49:26
768c17eda0310b99daa75e05e7e1e00bb82fbc15...8bd30b01e401e7ed8ef87bf42bec2614e8d96570,2,490,0,490,4,2005-07-24 19:02:22,2005-07-24 19:02:22
8bd30b01e401e7ed8ef87bf42bec2614e8d96570...371144f13401d8742876b77f5407011eb50f93d8,4,508,8,516,10,2005-07-24 22:21:09,2005-07-24 22:21:09
371144f13401d8742876b77f5407011eb50f93d8...1c947e50c92803e0a54fe7df7d32b5bd40ea54b6,1,17,17,34,5,2005-07-25 16:46:52,2005-07-25 16:46:52
1c947e50c92803e0a54fe7df7d32b5bd40ea54b6...f6c4395329ea05a84e58d2f603fcf72b2b0604c7,2,318,305,623,153,2005-07-25 17:18:39,2005-07-25 17:18:39
f6c4395329ea05a84e58d2f603fcf72b2b0604c7...6c43b0e06c09b7311aeba850a9e5ca3596f62e96,3,60,30,90,20,2005-07-25 21:53:00,2005-07-25 21:53:00
6c43b0e06c09b7311aeba850a9e5ca3596f62e96...5498dbe519ea5e629d1a1818aa9d17946f51d326,2,47,21,68,10,2005-07-25 22:07:04,2005-07-25 22:07:04
5498dbe519ea5e629d1a1818aa9d17946f51d326...12ffae6df4da6e8114649c493751c133c36bc313,1,1,1,2,1,2005-07-25 22:15:07,2005-07-25 22:15:07
12ffae6df4da6e8114649c493751c133c36bc313...a6ed088c62cc788c25e3fa8ef88e314a89db8fce,1,1,1,2,1,2005-07-25 22:16:30,2005-07-25 22:16:30
a6ed088c62cc788c25e3fa8ef88e314a89db8fce...48441f467f32fb36b20b45c88948bd19454df263,1,1,1,2,1,2005-07-25 22:17:47,2005-07-25 22:17:47
48441f467f32fb36b20b45c88948bd19454df263...7d574e8f7647a1ac8e2613c4be9c45adf4b5fc0e,2,47,52,99,16,2005-07-26 03:48:41,2005-07-26 03:48:41
7d574e8f7647a1ac8e2613c4be9c45adf4b5fc0e...1484f2e2255da321b4810cd06da527b57774e18a,1,1,1,2,1,2005-07-26 14:26:15,2005-07-26 14:26:15
1484f2e2255da321b4810cd06da527b57774e18a...e207378ad36caf0cb322bb264b569e0d915963f4,1,7,3,10,1,2005-07-26 14:37:00,2005-07-26 14:37:00
e207378ad36caf0cb322bb264b569e0d915963f4...f14c98e44c388e7171977b9be8d70dd3176d7919,1,2,2,4,2,2005-07-26 14:41:13,2005-07-26 14:41:13
f14c98e44c388e7171977b9be8d70dd3176d7919...786c750c40417a59449f1c5595fcc6b370ca7d4f,14,68,42,110,41,2005-07-26 16:11:43,2005-07-26 16:11:43
786c750c40417a59449f1c5595fcc6b370ca7d4f...63009faa141273726d124863053e3b5ab298c4f5,1,1,0,1,1,2005-07-26 16:26:48,2005-07-26 16:26:48
63009faa141273726d124863053e3b5ab298c4f5...284948b9cf275b792369405747c1e112a0b94a48,2,6,2,8,3,2005-07-26 16:53:58,2005-07-26 16:53:58
284948b9cf275b792369405747c1e112a0b94a48...ba3db4ca38fc81f066e74bb77d54ef277d74d756,1,1,4,5,2,2005-07-26 17:42:37,2005-07-26 17:42:37
ba3db4ca38fc81f066e74bb77d54ef277d74d756...8a86e7713f26f6e91a9a25615073321b9dd842eb,1,12,0,12,2,2005-07-26 17:49:49,2005-07-26 17:49:49
8a86e7713f26f6e91a9a25615073321b9dd842eb...5a3da949fa6825fd4f66becc3930272ea9432f69,1,2,2,4,2,2005-07-26 18:38:44,2005-07-26 18:38:44
5a3da949fa6825fd4f66becc3930272ea9432f69...aeff2cb530fb2a0234bac4fb31aa650d4395f55a,1,2,2,4,1,2005-07-26 22:15:51,2005-07-26 22:15:51
aeff2cb530fb2a0234bac4fb31aa650d4395f55a...b23c63bcfeb870c46889fbf1d36874017c358c90,1,14,3,17,1,2005-07-26 22:38:54,2005-07-26 22:38:54
b23c63bcfeb870c46889fbf1d36874017c358c90...3c0c0e7317ebc5bb43faf8cdf24ca495ff154e91,1,1,1,2,2,2005-07-26 22:43:27,2005-07-26 22:43:27
3c0c0e7317ebc5bb43faf8cdf24ca495ff154e91...fe91881e35db30dc61185c38cc0ab5c6a642e82f,1,4,2,6,2,2005-07-26 22:48:04,2005-07-26 22:48:04
fe91881e35db30dc61185c38cc0ab5c6a642e82f...6a12d65b97f7fea91783aa0157759c5ca41dbde6,1,3,1,4,2,2005-07-26 22:52:18,2005-07-26 22:52:18
6a12d65b97f7fea91783aa0157759c5ca41dbde6...18e420da02d5734fec41876a5f5e91cf1de8ca48,4,8,0,8,4,2005-07-26 22:54:59,2005-07-26 22:54:59
18e420da02d5734fec41876a5f5e91cf1de8ca48...f188d5930d2af0d0a987266b511a3b5ff2048c9e,1,3,2,5,1,2005-07-26 22:58:39,2005-07-26 22:58:39
f188d5930d2af0d0a987266b511a3b5ff2048c9e...d8ef66b17d5361c2c56b3ae04af82f3a619b69e6,1,3,21,24,2,2005-07-26 23:04:50,2005-07-26 23:04:50
d8ef66b17d5361c2c56b3ae04af82f3a619b69e6...d52db2d879a4ab7b9318c71a22efe83ab462ddc8,1,2,2,4,2,2005-07-26 23:18:08,2005-07-26 23:18:08
d52db2d879a4ab7b9318c71a22efe83ab462ddc8...9b983831752d61b340bc67b0be5d2c8c5dbfcb18,1,3,0,3,1,2005-07-26 23:24:55,2005-07-26 23:24:55
9b983831752d61b340bc67b0be5d2c8c5dbfcb18...1d2ab3606848fb062554a53f33b24d8ce9adbd75,1,2,2,4,2,2005-07-27 19:20:29,2005-07-27 19:20:29
1d2ab3606848fb062554a53f33b24d8ce9adbd75...f5b605ab1b0074ea8bdda0063bd9fad77a76ab45,1,4,3,7,3,2005-07-28 14:59:50,2005-07-28 14:59:50
f5b605ab1b0074ea8bdda0063bd9fad77a76ab45...cf9efea2407bfab31cc930f665babe0fcb6ca5ff,1,0,1,1,1,2005-07-28 15:01:10,2005-07-28 15:01:10
cf9efea2407bfab31cc930f665babe0fcb6ca5ff...cae7ebe19f3b517ed463fff031973bd412ffa6a3,1,8,5,13,4,2005-07-28 18:21:46,2005-07-28 18:21:46
cae7ebe19f3b517ed463fff031973bd412ffa6a3...daf8467b37f7aaae0b463b40a2c9d98f1f53c556,10,3169,0,3169,9,2005-07-29 15:15:40,2005-07-29 15:15:40
daf8467b37f7aaae0b463b40a2c9d98f1f53c556...d4a9a4f83a4e4d94b7357666ee99eec0d3ef5486,9,52,66,118,37,2005-07-29 15:25:31,2005-07-29 15:25:31
d4a9a4f83a4e4d94b7357666ee99eec0d3ef5486...85d2b12bdff63a5c4b269b290904dd499f92a40f,3,112,1,113,3,2005-07-29 16:20:39,2005-07-29 16:20:39
85d2b12bdff63a5c4b269b290904dd499f92a40f...9e64035796cb887391fcc968d74cb1317ab62794,1,8,7,15,7,2005-07-29 16:32:47,2005-07-29 16:32:47
9e64035796cb887391fcc968d74cb1317ab62794...f6e75ab3cfbb4e806d00aa332ec9b149f6699556,1,38,31,69,3,2005-07-29 19:22:50,2005-07-29 19:22:50
f6e75ab3cfbb4e806d00aa332ec9b149f6699556...a47794c82488c1cf307ee92aff0e5607e03ae0fc,1,2,2,4,2,2005-07-29 20:25:02,2005-07-29 20:25:02
a47794c82488c1cf307ee92aff0e5607e03ae0fc...645111894657f12f0acc8be1f56676a461d81b6d,1,5,0,5,1,2005-07-29 20:29:59,2005-07-29 20:29:59
645111894657f12f0acc8be1f56676a461d81b6d...33d5006cc7436363a01acbf3e2181ea317794939,2,72,1,73,2,2005-07-29 20:30:10,2005-07-29 20:30:10
33d5006cc7436363a01acbf3e2181ea317794939...5bfab1e1b200cfd732e91ea1106d4d9c363a14fe,1,2,0,2,1,2005-07-29 20:43:04,2005-07-29 20:43:04
5bfab1e1b200cfd732e91ea1106d4d9c363a14fe...017b8753a63d141e1ba5cbed5e7a609a7e1a4bab,1,11,8,19,4,2005-07-29 21:10:09,2005-07-29 21:10:09
017b8753a63d141e1ba5cbed5e7a609a7e1a4bab...47ce61533a5364c6d45803a696d86cbcb1ed2b33,1,10,2,12,1,2005-07-29 21:40:09,2005-07-29 21:40:09
47ce61533a5364c6d45803a696d86cbcb1ed2b33...5002b44f2872f87785d34eee6f2cc9e7d410a797,3,82,11,93,7,2005-07-29 22:35:54,2005-07-29 22:35:54
5002b44f2872f87785d34eee6f2cc9e7d410a797...b3e8b20b3eb6af376e57036275bf326349ca6190,1,2,2,4,2,2005-07-29 22:51:25,2005-07-29 22:51:25
b3e8b20b3eb6af376e57036275bf326349ca6190...7b6c472167cb8e0f66286c75e76f4f326e5caa56,1,1,0,1,1,2005-07-29 23:15:50,2005-07-29 23:15:50
7b6c472167cb8e0f66286c75e76f4f326e5caa56...b7643d009eea7547b7f65b20c27369bb223290fd,1,16,0,16,2,2005-07-29 23:41:05,2005-07-29 23:41:05
b7643d009eea7547b7f65b20c27369bb223290fd...716d00a31431add73bea0204cb5374947f71be87,1,1,1,2,1,2005-07-29 23:42:15,2005-07-29 23:42:15
716d00a31431add73bea0204cb5374947f71be87...8b36eb11d392b0ef2d448a7295e2de11086c47a8,1,3,0,3,1,2005-07-30 18:56:36,2005-07-30 18:56:36
8b36eb11d392b0ef2d448a7295e2de11086c47a8...04544c97b92b2de485c6de6675eb387fafb758c7,2,64,1,65,2,2005-07-31 00:20:56,2005-07-31 00:20:56
04544c97b92b2de485c6de6675eb387fafb758c7...2f0411569420e633f0ca3e662a8d4406afce0f91,4,106,4,110,4,2005-07-31 01:23:47,2005-07-31 01:23:47
2f0411569420e633f0ca3e662a8d4406afce0f91...af95567c1425975353567acba8af6f14a8802276,1,4,2,6,1,2005-08-01 14:41:01,2005-08-01 14:41:01
af95567c1425975353567acba8af6f14a8802276...3aa33edeef66ae468eb10dd6b3d35e7053156c45,1,2,2,4,2,2005-08-01 15:31:50,2005-08-01 15:31:50
3aa33edeef66ae468eb10dd6b3d35e7053156c45...1a8fc57bf6e4b86fe047d04fea2efe50296634d0,2,52,1,53,4,2005-08-01 15:32:42,2005-08-01 15:32:42
1a8fc57bf6e4b86fe047d04fea2efe50296634d0...b307fb09bb615361ee296d0c1f8d1a7c4809f6dd,5,62,15,77,10,2005-08-01 16:26:39,2005-08-01 16:26:39
b307fb09bb615361ee296d0c1f8d1a7c4809f6dd...a4438d74f666e1f5b9e8e0c13463ec5e62a1e11f,1,2,0,2,1,2005-08-01 18:57:37,2005-08-01 18:57:37
a4438d74f666e1f5b9e8e0c13463ec5e62a1e11f...7c738177dc061db656f79c7965a67ec269d6cc53,1,1,1,2,1,2005-08-01 18:59:35,2005-08-01 18:59:35
7c738177dc061db656f79c7965a67ec269d6cc53...d62f31228b3f9bffde707124d28d755239b78fd0,1,7,0,7,2,2005-08-01 19:02:55,2005-08-01 19:02:55
d62f31228b3f9bffde707124d28d755239b78fd0...8483f0aa047d4bff51e994e06e2ecf0365749830,1,1,1,2,1,2005-08-01 19:03:33,2005-08-01 19:03:33
8483f0aa047d4bff51e994e06e2ecf0365749830...440a2a97e9a8420ddf6186d4e948662bb3015e7d,9,313,930,1243,10,2005-08-01 19:09:07,2005-08-01 19:09:07
440a2a97e9a8420ddf6186d4e948662bb3015e7d...c73f4cd48697b7680fa95acb47f74720a1dce68f,1,0,82,82,1,2005-08-01 19:42:36,2005-08-01 19:42:36
c73f4cd48697b7680fa95acb47f74720a1dce68f...77faac0cb7719bc84aa5653a6179a6e7c0bf4bf9,1,1,1,2,1,2005-08-01 20:01:18,2005-08-01 20:01:18
77faac0cb7719bc84aa5653a6179a6e7c0bf4bf9...006e9e789baabdf3c5077e2ab39747f217ddf659,1,1,1,2,1,2005-08-01 20:07:31,2005-08-01 20:07:31
006e9e789baabdf3c5077e2ab39747f217ddf659...e0c3dd3318f6f4895554521c6bf69676635b1937,8,712,710,1422,44,2005-08-01 21:29:52,2005-08-01 21:29:52
e0c3dd3318f6f4895554521c6bf69676635b1937...a9331211c8566480e4367ee58770f62d0ac7366b,1,3,3,6,2,2005-08-01 21:32:45,2005-08-01 21:32:45
a9331211c8566480e4367ee58770f62d0ac7366b...6656806f42f6c97264a65b2bbc9ba2cfb746bca3,1,0,1,1,1,2005-08-01 21:35:55,2005-08-01 21:35:55
6656806f42f6c97264a65b2bbc9ba2cfb746bca3...6950f4f8ddc1388576e8b0bf23f8ef952c3bf0e3,1,1,1,2,1,2005-08-01 21:37:16,2005-08-01 21:37:16
6950f4f8ddc1388576e8b0bf23f8ef952c3bf0e3...e73c734336be21dcba127ef322435edf81c5adbc,1,11,0,11,1,2005-08-01 21:40:13,2005-08-01 21:40:13
e73c734336be21dcba127ef322435edf81c5adbc...1510ca1a80f811d6e681a880d7e49d413ce8afb4,1,14,3,17,4,2005-08-01 21:49:57,2005-08-01 21:49:57
1510ca1a80f811d6e681a880d7e49d413ce8afb4...d9401b78f11b47c5daa95a4fa60925b3fed50203,6,104,7,111,18,2005-08-02 17:08:24,2005-08-02 17:08:24
d9401b78f11b47c5daa95a4fa60925b3fed50203...2e83364965d2684f0361cbc37617e0cab0fcc104,1,1,2,3,2,2005-08-02 17:45:53,2005-08-02 17:45:53
2e83364965d2684f0361cbc37617e0cab0fcc104...b3b27d25932b994e1d1834479d2b79bb1284c6ba,1,0,1,1,1,2005-08-02 17:48:33,2005-08-02 17:48:33
b3b27d25932b994e1d1834479d2b79bb1284c6ba...623863d0a4e0c850196a863c646a2fe3ef178791,2,31,29,60,12,2005-08-02 17:49:49,2005-08-02 17:49:49
623863d0a4e0c850196a863c646a2fe3ef178791...51aba5deafd276663064f0796b25d5e512a07336,2,25,25,50,15,2005-08-02 17:56:22,2005-08-02 17:56:22
51aba5deafd276663064f0796b25d5e512a07336...72e32b31f23415af8cc7a400f072c70f6b4bc6cc,1,9,1,10,5,2005-08-02 18:00:13,2005-08-02 18:00:13
72e32b31f23415af8cc7a400f072c70f6b4bc6cc...ffc3edd79ee4abc7a22ea07f0660322f50306334,1,3,1,4,1,2005-08-02 18:47:46,2005-08-02 18:47:46
ffc3edd79ee4abc7a22ea07f0660322f50306334...ce0d0cd9e2cd5ac9850d825f28db39b1e123ac1e,7,55,55,110,33,2005-08-02 19:59:51,2005-08-02 19:59:51
ce0d0cd9e2cd5ac9850d825f28db39b1e123ac1e...49c670871634e78d588cba21f84b094479f2aa4f,3,44,0,44,3,2005-08-02 20:29:27,2005-08-02 20:29:27
49c670871634e78d588cba21f84b094479f2aa4f...3af4730419132ce91841b5a16d620bb7c3bc0818,1,8,7,15,3,2005-08-02 20:33:02,2005-08-02 20:33:02
3af4730419132ce91841b5a16d620bb7c3bc0818...c0451036ac3823de742fecfc48234775e1cfd333,1,2,0,2,1,2005-08-02 20:38:55,2005-08-02 20:38:55
c0451036ac3823de742fecfc48234775e1cfd333...f4e4ae96cb69d616af6f7009512cdcd2cb7c1e39,6,55,9,64,10,2005-08-02 22:33:39,2005-08-02 22:33:39
f4e4ae96cb69d616af6f7009512cdcd2cb7c1e39...7dc07ed937efff91c0be098c0ae6b91cd363c1dd,1,1,1,2,1,2005-08-04 02:35:26,2005-08-04 02:35:26
7dc07ed937efff91c0be098c0ae6b91cd363c1dd...808e50986b0c117541b563cec055dba2937ed453,1,7,1,8,1,2005-08-04 03:32:56,2005-08-04 03:32:56
808e50986b0c117541b563cec055dba2937ed453...cfbf261709ffde0419a8aa75319e2f4ae4c29619,1,6,1,7,1,2005-08-04 03:49:24,2005-08-04 03:49:24
cfbf261709ffde0419a8aa75319e2f4ae4c29619...3f2df5e7aa95e6cc78864a5cc452bb0c1d925a3e,1,13,0,13,1,2005-08-04 14:42:01,2005-08-04 14:42:01
3f2df5e7aa95e6cc78864a5cc452bb0c1d925a3e...a8ecb56106736580270fc9f2bb1dc2d34c764cd7,1,7,6,13,6,2005-08-04 14:48:48,2005-08-04 14:48:48
a8ecb56106736580270fc9f2bb1dc2d34c764cd7...dae5863058cc53278bd830be8e89492f62e46117,1,3,0,3,1,2005-08-04 14:51:46,2005-08-04 14:51:46
dae5863058cc53278bd830be8e89492f62e46117...2315ccc4998087463310b1dc2cd3fed21685b5fd,1,24,1,25,1,2005-08-04 14:57:20,2005-08-04 14:57:20
2315ccc4998087463310b1dc2cd3fed21685b5fd...0c6019295a86140fd231bccabc987496f23393eb,1,8,14,22,5,2005-08-04 15:05:15,2005-08-04 15:05:15
0c6019295a86140fd231bccabc987496f23393eb...63eecadfc66a1b52abda9921598750ea27095456,1,3,5,8,2,2005-08-04 15:05:55,2005-08-04 15:05:55
63eecadfc66a1b52abda9921598750ea27095456...502755878d5d4d197793880945823dade7b90674,1,11,0,11,1,2005-08-04 15:12:11,2005-08-04 15:12:11
502755878d5d4d197793880945823dade7b90674...f5b22bf4310d68ca18cf8c9052cb1c8fe09235f9,1,3,3,6,3,2005-08-04 19:00:20,2005-08-04 19:00:20
f5b22bf4310d68ca18cf8c9052cb1c8fe09235f9...05d074670a069465d2e4fad2ff1e716f59a61bed,1,8,0,8,2,2005-08-05 14:33:29,2005-08-05 14:33:29
05d074670a069465d2e4fad2ff1e716f59a61bed...432e19034ae4e35bf6fc510fa632a0a58c9ff58e,1,1,1,2,1,2005-08-05 14:38:22,2005-08-05 14:38:22
432e19034ae4e35bf6fc510fa632a0a58c9ff58e...0b9330b08584b283ddff342807aa65c1bd1adc45,1,2,2,4,2,2005-08-05 15:05:16,2005-08-05 15:05:16
0b9330b08584b283ddff342807aa65c1bd1adc45...888cf1f889785cc6746a9a1a9019f3e2a7218eb1,1,1,1,2,1,2005-08-05 15:41:58,2005-08-05 15:41:58
888cf1f889785cc6746a9a1a9019f3e2a7218eb1...a55598cbdd5e8ab58bb58e2178ccbe155526d735,3,38,52,90,21,2005-08-05 20:50:19,2005-08-05 20:50:19
a55598cbdd5e8ab58bb58e2178ccbe155526d735...b6a1105768772e4687b8cf6342b2393426ef10d6,1,3,3,6,2,2005-08-05 21:24:24,2005-08-05 21:24:24
b6a1105768772e4687b8cf6342b2393426ef10d6...c5179609847733c4babcc32312686d9fabf37315,2,2,2,4,2,2005-08-05 22:15:14,2005-08-05 22:15:14
c5179609847733c4babcc32312686d9fabf37315...59c3ebc6dddab2a52b5c4079fb78871b35b5dcaa,2,40,11,51,7,2005-08-05 22:22:41,2005-08-05 22:22:41
59c3ebc6dddab2a52b5c4079fb78871b35b5dcaa...a537a4efa1de8333c07817189b6de2711da89ff0,4,4,11,15,3,2005-08-05 22:43:35,2005-08-05 22:43:35
a537a4efa1de8333c07817189b6de2711da89ff0...9d8dd8610d643d68267d4e654fbe2f3317e5e9b7,1,2,2,4,1,2005-08-05 22:44:16,2005-08-05 22:44:16
9d8dd8610d643d68267d4e654fbe2f3317e5e9b7...8a9806096fb36c2cd9df623c8d5d0fbc29a08b0d,1,1,1,2,1,2005-08-06 20:39:43,2005-08-06 20:39:43
8a9806096fb36c2cd9df623c8d5d0fbc29a08b0d...5bb56520a5ad39396c7dd66e480040a701ede100,1,1,1,2,1,2005-08-06 20:51:06,2005-08-06 20:51:06
5bb56520a5ad39396c7dd66e480040a701ede100...67bb1bc7017b0ed275845edecdd65c35e8ec2ad8,1,3,0,3,1,2005-08-07 01:00:58,2005-08-07 01:00:58
67bb1bc7017b0ed275845edecdd65c35e8ec2ad8...4003f9f4829c855cbe8e38c5267836299eeab6f9,1,3,3,6,1,2005-08-07 01:02:48,2005-08-07 01:02:48
4003f9f4829c855cbe8e38c5267836299eeab6f9...03bd1d7ff9bae80694c09b57ca5737cce68b756b,1,23,26,49,8,2005-08-08 15:47:57,2005-08-08 15:47:57
03bd1d7ff9bae80694c09b57ca5737cce68b756b...b7e5121684afa36739c1aa9bbb96401645dbc417,2,57,0,57,2,2005-08-08 18:29:02,2005-08-08 18:29:02
b7e5121684afa36739c1aa9bbb96401645dbc417...a90e9f43db394565502c040502d8a4421767ba0b,2,7,1,8,3,2005-08-08 18:30:07,2005-08-08 18:30:07
a90e9f43db394565502c040502d8a4421767ba0b...b7e226d8b8ebce1081ff74c0fff7406390fa2402,2,13,12,25,9,2005-08-08 19:45:57,2005-08-08 19:45:57
b7e226d8b8ebce1081ff74c0fff7406390fa2402...1cc4531f0b734003444193d0a6f7ece365d731c8,2,253,11,264,3,2005-08-08 21:02:28,2005-08-08 21:02:28
1cc4531f0b734003444193d0a6f7ece365d731c8...ee52eba85acaea54d9be798654f8d55f1d979812,1,4,4,8,4,2005-08-08 21:04:32,2005-08-08 21:04:32
ee52eba85acaea54d9be798654f8d55f1d979812...b108360407af17b2220b1144e9fb10a961175ba7,1,1,1,2,1,2005-08-09 00:43:33,2005-08-09 00:43:33
b108360407af17b2220b1144e9fb10a961175ba7...d87ca56c63a8965dfb8b45b517c2bfd8aab8d5f9,1,1,1,2,1,2005-08-09 14:33:30,2005-08-09 14:33:30
d87ca56c63a8965dfb8b45b517c2bfd8aab8d5f9...e79eb09f2169ba9497283ab1a9e31c49e857fa93,1,0,5,5,1,2005-08-09 15:34:20,2005-08-09 15:34:20
e79eb09f2169ba9497283ab1a9e31c49e857fa93...4f00611f747b566cb7586f02462e57829424f077,6,31,25,56,19,2005-08-09 21:08:00,2005-08-09 21:08:00
4f00611f747b566cb7586f02462e57829424f077...32fe8e3863a39c10826225b6938233fb31a83f0a,1,4,4,8,4,2005-08-09 21:42:27,2005-08-09 21:42:27
32fe8e3863a39c10826225b6938233fb31a83f0a...217c74678935cce1fd3a814aab8f654afa454d91,1,110,101,211,39,2005-08-09 22:39:25,2005-08-09 22:39:25
217c74678935cce1fd3a814aab8f654afa454d91...b888113f49733cd49adb4dc411b133ec093c182b,1,1,2,3,1,2005-08-09 22:43:34,2005-08-09 22:43:34
b888113f49733cd49adb4dc411b133ec093c182b...741109f44056a0c55aaaf7a2747926a7b1b648b6,1,6,0,6,1,2005-08-09 22:53:43,2005-08-09 22:53:43
741109f44056a0c55aaaf7a2747926a7b1b648b6...270234d1895d81698fda140caa43629ad77504e0,1,7,0,7,1,2005-08-09 22:56:43,2005-08-09 22:56:43
270234d1895d81698fda140caa43629ad77504e0...fd579f24d79ac70f8339f1544f2c3707cf468800,1,8,3,11,2,2005-08-09 23:51:55,2005-08-09 23:51:55
fd579f24d79ac70f8339f1544f2c3707cf468800...991832d0c4dc211a4346256b62c44942894b495d,2,12,2,14,3,2005-08-10 00:21:41,2005-08-10 00:21:41
991832d0c4dc211a4346256b62c44942894b495d...e2426e68e6aee3cff0683bf1cc6f029bdebec523,1,36,99,135,8,2005-08-10 00:37:56,2005-08-10 00:37:56
e2426e68e6aee3cff0683bf1cc6f029bdebec523...65f7e142e4fc9672591d4a4c8dbb065fb335d20f,1,0,95,95,1,2005-08-10 00:40:08,2005-08-10 00:40:08
65f7e142e4fc9672591d4a4c8dbb065fb335d20f...5144a60efce7bc69ea91873c3ac9906c575decb8,2,1,17,18,3,2005-08-10 00:44:48,2005-08-10 00:44:48
5144a60efce7bc69ea91873c3ac9906c575decb8...d8f5cad47e417c3c16e133324b76fce71474ad7d,2,4,4,8,4,2005-08-10 01:01:54,2005-08-10 01:01:54
d8f5cad47e417c3c16e133324b76fce71474ad7d...9a6e8142b8eaae7f92c7dc7c4135fd4d169cfbd5,1,25,27,52,27,2005-08-10 01:14:50,2005-08-10 01:14:50
9a6e8142b8eaae7f92c7dc7c4135fd4d169cfbd5...0d060ba547e5cfd722e673637d61bac550cc5b00,1,1,1,2,1,2005-08-10 01:27:13,2005-08-10 01:27:13
0d060ba547e5cfd722e673637d61bac550cc5b00...258e6bc33034b755a6c94cfa22b6ee44b1494501,2,9,9,18,9,2005-08-10 03:12:37,2005-08-10 03:12:37
258e6bc33034b755a6c94cfa22b6ee44b1494501...6d234fae8ce1f1312db3b9662e2f8fb147e58d8b,2,10,9,19,5,2005-08-10 03:44:51,2005-08-10 03:44:51
6d234fae8ce1f1312db3b9662e2f8fb147e58d8b...8a209c232c2334986b59b4caf56d08bdb79a269a,1,1,1,2,1,2005-08-10 03:46:11,2005-08-10 03:46:11
8a209c232c2334986b59b4caf56d08bdb79a269a...5b812ae02cfa1e80e959f0bf31e7f82138094bb5,2,9,10,19,5,2005-08-10 03:50:46,2005-08-10 03:50:46
5b812ae02cfa1e80e959f0bf31e7f82138094bb5...0660203afe66fbc663a4e0af93ec74cd61e2c712,2,29,1,30,2,2005-08-10 03:52:41,2005-08-10 03:52:41
0660203afe66fbc663a4e0af93ec74cd61e2c712...024e68e260a70281d6f07e3a562e24140d3ecc2f,1,5,1,6,2,2005-08-10 04:45:10,2005-08-10 04:45:10
024e68e260a70281d6f07e3a562e24140d3ecc2f...7bac5520690b8df041e705862096a969f76975fc,1,1,2,3,2,2005-08-10 04:48:47,2005-08-10 04:48:47
7bac5520690b8df041e705862096a969f76975fc...63e1f3d39c0ef19b022675da2b138a3ba4cb0119,1,24,2,26,3,2005-08-10 05:04:27,2005-08-10 05:04:27
63e1f3d39c0ef19b022675da2b138a3ba4cb0119...4622e0ff82f82be424439cc218182a4f18c3e17c,2,42,41,83,8,2005-08-10 05:08:27,2005-08-10 05:08:27
4622e0ff82f82be424439cc218182a4f18c3e17c...151bf05850e1a5449c741aecdaafae544c6bcccf,1,6,0,6,3,2005-08-10 15:36:16,2005-08-10 15:36:16
151bf05850e1a5449c741aecdaafae544c6bcccf...254f31819bb47eb23ea4f163154a55e80e2478a9,1,3,3,6,3,2005-08-10 15:40:14,2005-08-10 15:40:14
254f31819bb47eb23ea4f163154a55e80e2478a9...3a1ae2164b79506b58cacec15a1afa9b28f0349a,1,11,0,11,2,2005-08-10 18:00:52,2005-08-10 18:00:52
3a1ae2164b79506b58cacec15a1afa9b28f0349a...f65350b197e7d61c2d049118cb8ebfea467839ab,2,2,1,3,2,2005-08-10 18:10:38,2005-08-10 18:10:38
f65350b197e7d61c2d049118cb8ebfea467839ab...8e2d2753903dd0c9e2c5dd5b8fc61e0c613161a5,4,91,0,91,2,2005-08-10 18:31:33,2005-08-10 18:31:33
8e2d2753903dd0c9e2c5dd5b8fc61e0c613161a5...b3ae12fa4ac3192b732be76f26ff707b60639bd1,1,2,2,4,2,2005-08-10 18:46:11,2005-08-10 18:46:11
b3ae12fa4ac3192b732be76f26ff707b60639bd1...199938649e36389750eef6f097bae46977e796f5,5,9,7,16,7,2005-08-10 19:32:38,2005-08-10 19:32:38
199938649e36389750eef6f097bae46977e796f5...46d8bbab3d078a99167fc841e152bb9a2cf464fb,1,1,0,1,1,2005-08-10 20:16:15,2005-08-10 20:16:15
46d8bbab3d078a99167fc841e152bb9a2cf464fb...055f1d0de6086640fd0f2c3b0fd577f12acb8d78,1,146,0,146,1,2005-08-10 20:24:51,2005-08-10 20:24:51
055f1d0de6086640fd0f2c3b0fd577f12acb8d78...066722db046eb95920d7b4929a11723af35191ab,1,21,1,22,2,2005-08-10 20:29:55,2005-08-10 20:29:55
066722db046eb95920d7b4929a11723af35191ab...78387d5e34eb06687fc20ecbd4b88350baf1d6e3,1,1,1,2,1,2005-08-10 20:30:30,2005-08-10 20:30:30
78387d5e34eb06687fc20ecbd4b88350baf1d6e3...9c2d890eecc6e01de7a9bcc70f4b3282438d506f,1,5,0,5,1,2005-08-10 20:38:00,2005-08-10 20:38:00
9c2d890eecc6e01de7a9bcc70f4b3282438d506f...7bb1a2bbbafe28a5e00f498e5418b584b7a7654a,1,3,0,3,1,2005-08-10 21:02:07,2005-08-10 21:02:07
7bb1a2bbbafe28a5e00f498e5418b584b7a7654a...77d20bedd408e95f1d96a166669f644e919a57cc,1,1,0,1,1,2005-08-10 21:20:45,2005-08-10 21:20:45
77d20bedd408e95f1d96a166669f644e919a57cc...bdcea2e6ca383fc6364be63bbf8359ddcd0145a3,2,2,1,3,2,2005-08-10 21:46:40,2005-08-10 21:46:40
bdcea2e6ca383fc6364be63bbf8359ddcd0145a3...fcfb8edc153a3357529a86aff70ceb273859d7ca,2,20,5,25,9,2005-08-10 22:12:05,2005-08-10 22:12:05
fcfb8edc153a3357529a86aff70ceb273859d7ca...e67882721d8ae9546575c68c4d3c42dcfa3f8e04,1,7,9,16,4,2005-08-10 22:20:18,2005-08-10 22:20:18
e67882721d8ae9546575c68c4d3c42dcfa3f8e04...aed151d3d86aca55370c659fc2888f34698a4fde,1,25,10,35,6,2005-08-11 16:01:09,2005-08-11 16:01:09
aed151d3d86aca55370c659fc2888f34698a4fde...8dac184adc40b716f59c77abb079679d085cb75a,1,4,4,8,3,2005-08-11 16:05:25,2005-08-11 16:05:25
8dac184adc40b716f59c77abb079679d085cb75a...6f4e6b4bcbdb79e8aceac1af9ac66088d66c51b0,1,46,24,70,13,2005-08-11 18:32:19,2005-08-11 18:32:19
6f4e6b4bcbdb79e8aceac1af9ac66088d66c51b0...8ebe5db684ac7e97836dabbce091c41a8b2e12fd,1,4,0,4,2,2005-08-11 19:00:56,2005-08-11 19:00:56
8ebe5db684ac7e97836dabbce091c41a8b2e12fd...8d8da826dbf1a702f8b11c3942bf8134c4f0f165,4,92,5,97,8,2005-08-11 19:34:34,2005-08-11 19:34:34
8d8da826dbf1a702f8b11c3942bf8134c4f0f165...43f3b984e845c8f9be13afd541e336a00d70018e,1,0,1,1,1,2005-08-12 03:59:38,2005-08-12 03:59:38
43f3b984e845c8f9be13afd541e336a00d70018e...199aa88ffb35b8d285a1ac2759f6fbfa1a2420e0,3,47,47,94,3,2005-08-12 04:16:29,2005-08-12 04:16:29
199aa88ffb35b8d285a1ac2759f6fbfa1a2420e0...b149fc367178d90b757e8711a218e0ca54c1c88f,1,3,3,6,3,2005-08-12 14:19:34,2005-08-12 14:19:34
b149fc367178d90b757e8711a218e0ca54c1c88f...54f93895a8938ef3d76370f6bf57997cf34a1d93,1,3,1,4,1,2005-08-14 01:09:51,2005-08-14 01:09:51
54f93895a8938ef3d76370f6bf57997cf34a1d93...a9b43edde24e6bb2caa82864d9b8d865b2fea113,1,3,1,4,2,2005-08-14 23:59:29,2005-08-14 23:59:29
a9b43edde24e6bb2caa82864d9b8d865b2fea113...bf108187a2a1d36bf7b0a61575b331386043507e,1,1,3,4,2,2005-08-15 00:50:31,2005-08-15 00:50:31
bf108187a2a1d36bf7b0a61575b331386043507e...2c3067b5e5c7f4a818337760c029267d8658eb0a,1,14,14,28,13,2005-08-15 00:53:18,2005-08-15 00:53:18
2c3067b5e5c7f4a818337760c029267d8658eb0a...bc00059b2fcc4e59c2bef59700a8a78a3e014948,1,8,0,8,2,2005-08-15 01:03:39,2005-08-15 01:03:39
bc00059b2fcc4e59c2bef59700a8a78a3e014948...1e479ba90dab2885abaa8eba9170400b1caa6f0e,1,1,1,2,1,2005-08-15 01:24:16,2005-08-15 01:24:16
1e479ba90dab2885abaa8eba9170400b1caa6f0e...1303933fd904359fce1b45d67ccc3d59244ef388,1,2,2,4,1,2005-08-15 04:08:28,2005-08-15 04:08:28
1303933fd904359fce1b45d67ccc3d59244ef388...025b16178f45e31f055e5616752b25c874eeae02,1,12,9,21,1,2005-08-15 04:15:59,2005-08-15 04:15:59
025b16178f45e31f055e5616752b25c874eeae02...e004d2a0f78d4a09f32586b6d15028fc5957cd13,1,4,1,5,1,2005-08-15 04:19:16,2005-08-15 04:19:16
e004d2a0f78d4a09f32586b6d15028fc5957cd13...4a7159865e766cf586ada6f3f73fb5f7504354b8,1,1,0,1,1,2005-08-15 04:44:19,2005-08-15 04:44:19
4a7159865e766cf586ada6f3f73fb5f7504354b8...8f9e5b6b3ba7165ddac717690d9710b49a4a5a6a,2,59,4,63,6,2005-08-15 05:05:52,2005-08-15 05:05:52
8f9e5b6b3ba7165ddac717690d9710b49a4a5a6a...91c71d36e621ddb3c7826db527290ca9e140e086,1,0,2,2,1,2005-08-15 14:48:07,2005-08-15 14:48:07
91c71d36e621ddb3c7826db527290ca9e140e086...db127b79835cb971639e0185073e5d7756fb9d9a,2,9,0,9,3,2005-08-15 15:24:56,2005-08-15 15:24:56
db127b79835cb971639e0185073e5d7756fb9d9a...b5ed20434e5faa739f7bc753319986dd9dfac7f7,1,11,0,11,1,2005-08-15 15:43:59,2005-08-15 15:43:59
b5ed20434e5faa739f7bc753319986dd9dfac7f7...27986994eea82645fb99ad1a373b7d99110eb3c0,1,14,6,20,2,2005-08-15 16:00:28,2005-08-15 16:00:28
27986994eea82645fb99ad1a373b7d99110eb3c0...56071754eafd264ccfeef7d0742c7482baed4dae,1,2,2,4,1,2005-08-15 16:15:26,2005-08-15 16:15:26
56071754eafd264ccfeef7d0742c7482baed4dae...7cfddb3c43ba5b006b0e0082dfc77abeb846a15a,1,7,0,7,1,2005-08-15 19:00:50,2005-08-15 19:00:50
7cfddb3c43ba5b006b0e0082dfc77abeb846a15a...c727729183bdf773df9b7ebe725fb7a57e7508a2,1,1,1,2,1,2005-08-15 20:03:34,2005-08-15 20:03:34
c727729183bdf773df9b7ebe725fb7a57e7508a2...d22e88898fdd4d60d481e17f726d5b134ddc1daf,2,6,6,12,4,2005-08-15 22:47:41,2005-08-15 22:47:41
d22e88898fdd4d60d481e17f726d5b134ddc1daf...071037ff80119656f46400cb0c2a1453e80c37f1,1,5,0,5,1,2005-08-16 00:41:42,2005-08-16 00:41:42
071037ff80119656f46400cb0c2a1453e80c37f1...00da60e932967b691d61b3d6af5365c9e1619b62,1,0,3,3,1,2005-08-16 00:47:53,2005-08-16 00:47:53
00da60e932967b691d61b3d6af5365c9e1619b62...935daf062612f4acd4e9dc143239bf29c5553bc0,1,1,1,2,1,2005-08-16 16:57:20,2005-08-16 16:57:20
935daf062612f4acd4e9dc143239bf29c5553bc0...7d374ad5973ff5b14e996a38e078c7d46646ae5d,3,58,13,71,15,2005-08-16 18:08:37,2005-08-16 18:08:37
7d374ad5973ff5b14e996a38e078c7d46646ae5d...f21ff30b104ef1eedcfebd230a98fef4b6cc7ebd,1,7,5,12,3,2005-08-16 18:28:00,2005-08-16 18:28:00
f21ff30b104ef1eedcfebd230a98fef4b6cc7ebd...07889c13a63eeb3e8a73f1e02a21227def3ae548,13,179,152,331,38,2005-08-16 22:54:05,2005-08-16 22:54:05
07889c13a63eeb3e8a73f1e02a21227def3ae548...72109f4e35776c31d5e75174accabfe451abdade,1,1,0,1,1,2005-08-16 23:02:06,2005-08-16 23:02:06
72109f4e35776c31d5e75174accabfe451abdade...659ab9846e81d95bb75dbb3c00147324bf0d6541,1,1,1,2,1,2005-08-16 23:15:13,2005-08-16 23:15:13
659ab9846e81d95bb75dbb3c00147324bf0d6541...7d022cd48fd4e193108c1b4785d3bdc2fe0e22e8,1,1,1,2,1,2005-08-16 23:16:55,2005-08-16 23:16:55
7d022cd48fd4e193108c1b4785d3bdc2fe0e22e8...a5797248525126362266794ddffb28b6299c80f5,1,1,1,2,1,2005-08-17 02:05:53,2005-08-17 02:05:53
a5797248525126362266794ddffb28b6299c80f5...21c4526557fb50b9b62f32065c7d3952ea35c5df,1,155,0,155,1,2005-08-17 04:00:02,2005-08-17 04:00:02
21c4526557fb50b9b62f32065c7d3952ea35c5df...99d8bb34fe034161c9f6ca7587a0f8b87a2f1236,1,12,0,12,1,2005-08-17 04:05:42,2005-08-17 04:05:42
99d8bb34fe034161c9f6ca7587a0f8b87a2f1236...5f37a627daf6e6d88fde2219034a5c0188aaff8a,1,1,0,1,1,2005-08-17 14:27:30,2005-08-17 14:27:30
5f37a627daf6e6d88fde2219034a5c0188aaff8a...81c46499443310284c01879177a8acfd3ad25b12,1,2,2,4,2,2005-08-17 15:01:12,2005-08-17 15:01:12
81c46499443310284c01879177a8acfd3ad25b12...8acb6c836ba0ca84f8ee40a7b8ac5c49e76f6d66,1,1,1,2,1,2005-08-17 19:48:40,2005-08-17 19:48:40
8acb6c836ba0ca84f8ee40a7b8ac5c49e76f6d66...b1d9682a380484950b92f7fa37acd2b6f212578f,1,6,0,6,2,2005-08-17 22:04:53,2005-08-17 22:04:53
b1d9682a380484950b92f7fa37acd2b6f212578f...f5ab1320ed3acbbc8b8bc358a46f5ae1380deff9,1,1,1,2,1,2005-08-17 22:46:43,2005-08-17 22:46:43
f5ab1320ed3acbbc8b8bc358a46f5ae1380deff9...8a939224fa5df92f38532c76901975b9e765a1e9,1,9,1,10,2,2005-08-18 00:14:15,2005-08-18 00:14:15
8a939224fa5df92f38532c76901975b9e765a1e9...28d41fe2701a6d6912b655b86cf2a461d81e7ae9,1,1,1,2,1,2005-08-18 00:15:39,2005-08-18 00:15:39
28d41fe2701a6d6912b655b86cf2a461d81e7ae9...94960d5635c98a51a4c8ef239374605e05aa0c67,2,95,1,96,2,2005-08-18 04:12:01,2005-08-18 04:12:01
94960d5635c98a51a4c8ef239374605e05aa0c67...1dccbcdcc1f2690cc0cf7715f31cd0cb4d260309,1,4,2,6,1,2005-08-18 04:13:48,2005-08-18 04:13:48
1dccbcdcc1f2690cc0cf7715f31cd0cb4d260309...cb022650e7c0899f226e31eebb36ea0c33449295,1,5,0,5,1,2005-08-18 04:50:09,2005-08-18 04:50:09
cb022650e7c0899f226e31eebb36ea0c33449295...2972e8b5d5d1cc223e81e4fceef819333bbeb075,1,3,0,3,1,2005-08-18 16:45:15,2005-08-18 16:45:15
2972e8b5d5d1cc223e81e4fceef819333bbeb075...a9c36d8db52736b6634b5f3e7711a9105d5c0fbd,1,6,9,15,10,2005-08-18 22:27:27,2005-08-18 22:27:27
a9c36d8db52736b6634b5f3e7711a9105d5c0fbd...8d6c276328b43ab0351cbfae9bcfcacfa9fdd47d,1,3,2,5,2,2005-08-19 14:59:09,2005-08-19 14:59:09
8d6c276328b43ab0351cbfae9bcfcacfa9fdd47d...00c6acaaf30adfb77dd38bf2064ed33d314258d9,4,30,11,41,12,2005-08-19 21:23:56,2005-08-19 21:23:56
00c6acaaf30adfb77dd38bf2064ed33d314258d9...9180112f021d0a2a16e29565ece4f137a1a99823,1,8,0,8,1,2005-08-19 21:35:02,2005-08-19 21:35:02
9180112f021d0a2a16e29565ece4f137a1a99823...e5e1ea602d9393a29400098dc40d0f9de846fdd1,5,21,3,24,6,2005-08-19 21:51:14,2005-08-19 21:51:14
e5e1ea602d9393a29400098dc40d0f9de846fdd1...33f2304ea91379a85db5f53ccf235846dde3630d,1,2,2,4,1,2005-08-21 18:25:36,2005-08-21 18:25:36
33f2304ea91379a85db5f53ccf235846dde3630d...297731c65727cd2844e0fafd6cfb9e906455cd27,1,3,2,5,1,2005-08-21 18:26:56,2005-08-21 18:26:56
297731c65727cd2844e0fafd6cfb9e906455cd27...601a892ea0ae833d0b00bbd66edeb33ecd2fcb91,1,2,0,2,1,2005-08-21 18:28:04,2005-08-21 18:28:04
601a892ea0ae833d0b00bbd66edeb33ecd2fcb91...928832d6e03c8e1b86c9fcf2b4819c0625c920d0,2,1,4,5,2,2005-08-22 19:19:54,2005-08-22 19:19:54
928832d6e03c8e1b86c9fcf2b4819c0625c920d0...fffe1d1472232ae6baaff446b0aec580a5567c7d,1,1,1,2,1,2005-08-23 14:31:08,2005-08-23 14:31:08
fffe1d1472232ae6baaff446b0aec580a5567c7d...9fb3f7fa932c9214f2b5114e9950529371f93023,1,1,1,2,1,2005-08-23 20:17:36,2005-08-23 20:17:36
9fb3f7fa932c9214f2b5114e9950529371f93023...aec0a73d73324820c767758afd250fc21a2896ef,1,2,2,4,2,2005-08-25 00:50:01,2005-08-25 00:50:01
aec0a73d73324820c767758afd250fc21a2896ef...25264c86048d442a4885dfebae94510e2fa0c1e4,36,957,721,1678,271,2005-08-25 22:51:30,2005-08-25 22:51:30
25264c86048d442a4885dfebae94510e2fa0c1e4...939e2bccd536c69681946901348bf35c909aad9f,1,12,9,21,5,2005-08-26 04:06:18,2005-08-26 04:06:18
939e2bccd536c69681946901348bf35c909aad9f...3db068f7fa974ad9c5838967ab7c238061ece93d,1,13,7,20,4,2005-08-26 05:32:30,2005-08-26 05:32:30
3db068f7fa974ad9c5838967ab7c238061ece93d...1aaa3358b9ec00e45fb21f2c2026301b8927c9fc,1,1,1,2,1,2005-08-26 05:34:37,2005-08-26 05:34:37
1aaa3358b9ec00e45fb21f2c2026301b8927c9fc...286698e8e5e08f3d74ee188ab2640564971069ce,1,0,3,3,1,2005-08-26 05:37:26,2005-08-26 05:37:26
286698e8e5e08f3d74ee188ab2640564971069ce...75b5372a8fe4662946ed88b6abfc65b572314c75,1,2,1,3,1,2005-08-26 05:39:23,2005-08-26 05:39:23
75b5372a8fe4662946ed88b6abfc65b572314c75...b8e1be6f46bb83f298f4b1d8b800fdd834016549,1,519,321,840,104,2005-08-26 18:29:11,2005-08-26 18:29:11
b8e1be6f46bb83f298f4b1d8b800fdd834016549...9138dc700804437d89cbc5b6ea79aa32cb0edc0b,1,4,4,8,4,2005-08-26 18:35:44,2005-08-26 18:35:44
9138dc700804437d89cbc5b6ea79aa32cb0edc0b...c0fef161c107bf67b43b768b83f28f46b8f7e3b3,1,2,2,4,2,2005-08-26 18:36:20,2005-08-26 18:36:20
c0fef161c107bf67b43b768b83f28f46b8f7e3b3...f6f3b1f97b0374d49c916360ef7351615780d17e,1,1,1,2,1,2005-08-26 18:36:57,2005-08-26 18:36:57
f6f3b1f97b0374d49c916360ef7351615780d17e...879222786a6e04021a69afe557745d3c2a28bef2,1,76,0,76,1,2005-08-26 19:02:07,2005-08-26 19:02:07
879222786a6e04021a69afe557745d3c2a28bef2...09b5266d641d3cdb63948c87f48fcacb702fbf43,1,2,2,4,2,2005-08-26 19:07:39,2005-08-26 19:07:39
09b5266d641d3cdb63948c87f48fcacb702fbf43...10204da32653eedee0e94e1baeeaaed96dc8b954,1,2,2,4,1,2005-08-26 19:08:42,2005-08-26 19:08:42
10204da32653eedee0e94e1baeeaaed96dc8b954...25d8441d724f64a99f43f29dddb104b879336eda,1,2,2,4,1,2005-08-26 19:10:07,2005-08-26 19:10:07
25d8441d724f64a99f43f29dddb104b879336eda...df3564dace7838d517714c6af3ceeeb11266839e,1,1,1,2,1,2005-08-26 19:11:54,2005-08-26 19:11:54
df3564dace7838d517714c6af3ceeeb11266839e...b77114caaa4842749e4779146e22c22a41880f13,1,1,2,3,3,2005-08-26 21:12:06,2005-08-26 21:12:06
b77114caaa4842749e4779146e22c22a41880f13...25aef18d8358e7a89e99caf0c6b91f7179b6572b,1,2,2,4,2,2005-08-29 15:35:04,2005-08-29 15:35:04
25aef18d8358e7a89e99caf0c6b91f7179b6572b...2ce78063fa07ee3ebbae6eb5c00cc251b89da66f,1,5,1,6,1,2005-08-29 16:44:40,2005-08-29 16:44:40
2ce78063fa07ee3ebbae6eb5c00cc251b89da66f...299c3cdd8c5c83a2936cf84dc9d6745db9b39454,2,2,2,4,2,2005-08-29 16:49:18,2005-08-29 16:49:18
299c3cdd8c5c83a2936cf84dc9d6745db9b39454...bcce1d901f115e84f654319338dba6a65674e6c0,1,2,2,4,1,2005-08-29 20:33:14,2005-08-29 20:33:14
bcce1d901f115e84f654319338dba6a65674e6c0...d80ac5ac2517d02f9af87d8c8ea46bc376c51bc5,2,86,45,131,37,2005-08-29 21:11:41,2005-08-29 21:11:41
d80ac5ac2517d02f9af87d8c8ea46bc376c51bc5...c6e4b232c275b2f0da5d3f88d4ca708319eead0c,1,1,1,2,1,2005-08-29 21:48:32,2005-08-29 21:48:32
c6e4b232c275b2f0da5d3f88d4ca708319eead0c...02ebeec0dc719bdbbe2ecfa1fe6655a6289fc931,1,13,0,13,2,2005-08-29 21:58:21,2005-08-29 21:58:21
02ebeec0dc719bdbbe2ecfa1fe6655a6289fc931...e1f0accaf6ca331fd9b1bcca2faedd47033ff95e,1,2,2,4,2,2005-08-30 17:03:15,2005-08-30 17:03:15
e1f0accaf6ca331fd9b1bcca2faedd47033ff95e...5569c75eb632d104e9b86a785752edb44cada85a,1,41,39,80,33,2005-08-30 21:33:12,2005-08-30 21:33:12
5569c75eb632d104e9b86a785752edb44cada85a...abe7fb8173326567463d21257db73647d4a7b365,1,1,1,2,1,2005-08-31 16:22:07,2005-08-31 16:22:07
abe7fb8173326567463d21257db73647d4a7b365...cb6aa1035bf900e9f124e91c0521f7081ba105e3,4,5,5,10,5,2005-08-31 16:27:59,2005-08-31 16:27:59
cb6aa1035bf900e9f124e91c0521f7081ba105e3...9635ac07a5ee9a1ff54ebcfb08b48622356b0326,1,5,4,9,3,2005-08-31 16:45:10,2005-08-31 16:45:10
9635ac07a5ee9a1ff54ebcfb08b48622356b0326...dbc4adeedab14039ea739ecf9072303c08a83c7a,1,1,1,2,1,2005-08-31 16:47:06,2005-08-31 16:47:06
dbc4adeedab14039ea739ecf9072303c08a83c7a...354421f77ded724d257ed5136122a5965ea9599d,1,5,11,16,5,2005-08-31 17:06:07,2005-08-31 17:06:07
354421f77ded724d257ed5136122a5965ea9599d...072a89ace2d228bcf945ca1a3966be984d0b2531,1,160,0,160,1,2005-08-31 20:24:50,2005-08-31 20:24:50
072a89ace2d228bcf945ca1a3966be984d0b2531...d74373924d053af52946aed2eda2bf0934d56f31,1,16,16,32,6,2005-08-31 20:55:16,2005-08-31 20:55:16
d74373924d053af52946aed2eda2bf0934d56f31...005e70387cad0adec94af84227a5964bb988e76d,1,3,0,3,1,2005-09-01 02:12:53,2005-09-01 02:12:53
005e70387cad0adec94af84227a5964bb988e76d...def5d10ffc57a2764ec4260c145a19ddec698a23,2,34,24,58,4,2005-09-01 02:18:04,2005-09-01 02:18:04
def5d10ffc57a2764ec4260c145a19ddec698a23...2577581808fc691e0114ce460efd28a9b9e1c1ff,1,11,13,24,8,2005-09-01 02:21:08,2005-09-01 02:21:08
2577581808fc691e0114ce460efd28a9b9e1c1ff...887f6331d43c1b4c3cfbc1dc492dad7c04f99bf9,1,1,1,2,1,2005-09-01 02:22:46,2005-09-01 02:22:46
887f6331d43c1b4c3cfbc1dc492dad7c04f99bf9...e07fee6511ae64db6af5b40f769c7b58bac9311d,1,2,0,2,1,2005-09-01 03:06:47,2005-09-01 03:06:47
e07fee6511ae64db6af5b40f769c7b58bac9311d...af8b7ffa8e8d797925694691873afb96a77cc6f2,1,8,8,16,4,2005-09-01 05:01:47,2005-09-01 05:01:47
af8b7ffa8e8d797925694691873afb96a77cc6f2...b483f66efefca1029d6ac8b9836f9db844ced05f,1,312,0,312,1,2005-09-01 05:10:30,2005-09-01 05:10:30
b483f66efefca1029d6ac8b9836f9db844ced05f...8da42a8b68698b57931f8c5db1247f47d70da009,1,3,5,8,3,2005-09-01 05:12:25,2005-09-01 05:12:25
8da42a8b68698b57931f8c5db1247f47d70da009...8c83f2ab300c82e7856da3bf6bcdaf087f89e80d,1,17,0,17,1,2005-09-01 21:48:15,2005-09-01 21:48:15
8c83f2ab300c82e7856da3bf6bcdaf087f89e80d...f4547bfbfddfc3145591debf5ab19c5c0abbfa33,1,5,0,5,1,2005-09-01 21:51:01,2005-09-01 21:51:01
f4547bfbfddfc3145591debf5ab19c5c0abbfa33...cd435ff796258ce58dfdcb09caa2ae6cd02903e9,1,6,0,6,1,2005-09-01 21:59:39,2005-09-01 21:59:39
cd435ff796258ce58dfdcb09caa2ae6cd02903e9...29c50bc0d41cb5d2b6e36f0f7347b7c0f5c56645,1,3,1,4,1,2005-09-01 22:58:58,2005-09-01 22:58:58
29c50bc0d41cb5d2b6e36f0f7347b7c0f5c56645...582e6a1010d006199ad24cc523343d2057b34014,1,39,39,78,33,2005-09-01 23:09:48,2005-09-01 23:09:48
582e6a1010d006199ad24cc523343d2057b34014...324f717c5e7e2e62963e6a3e4f57d3099bfdeaef,1,6,5,11,5,2005-09-02 16:34:14,2005-09-02 16:34:14
324f717c5e7e2e62963e6a3e4f57d3099bfdeaef...9f125641687698c5ec69991222a7126202b2a91b,1,4,1,5,3,2005-09-02 17:41:40,2005-09-02 17:41:40
9f125641687698c5ec69991222a7126202b2a91b...4e2f910ff1d343c994fed6847ae0030f18e9843b,1,5,0,5,2,2005-09-02 17:48:18,2005-09-02 17:48:18
4e2f910ff1d343c994fed6847ae0030f18e9843b...5d7c8a0c4fa9d8ffc60d064a67c069eea9064761,1,4,2,6,2,2005-09-02 17:59:43,2005-09-02 17:59:43
5d7c8a0c4fa9d8ffc60d064a67c069eea9064761...d31699f2278ddd35cea3caf68cc83820413adf04,1,6,6,12,2,2005-09-02 18:14:44,2005-09-02 18:14:44
d31699f2278ddd35cea3caf68cc83820413adf04...fe66d3b83b8fe99584aeedaba4b9fd59c456b1f9,1,1,1,2,1,2005-09-02 18:23:42,2005-09-02 18:23:42
fe66d3b83b8fe99584aeedaba4b9fd59c456b1f9...59b204526ee03e936876365f1c8b5d856c5b8770,2,34,34,68,31,2005-09-02 18:26:16,2005-09-02 18:26:16
59b204526ee03e936876365f1c8b5d856c5b8770...24006427d9ee735d4fb8eaccd4c594662f2665e4,1,3,3,6,3,2005-09-02 18:28:26,2005-09-02 18:28:26
24006427d9ee735d4fb8eaccd4c594662f2665e4...3aa1276bff404a32bd54312d2d7bf5cdcfd8f71c,1,18,4,22,6,2005-09-02 18:38:23,2005-09-02 18:38:23
3aa1276bff404a32bd54312d2d7bf5cdcfd8f71c...33570454e3ab8db5d12abbfdad4563c1a8207660,1,1,1,2,1,2005-09-02 18:42:36,2005-09-02 18:42:36
33570454e3ab8db5d12abbfdad4563c1a8207660...64d3da63ae87c0f2fb4e7a723bdfbc091bdeb7b4,1,17,17,34,11,2005-09-02 18:51:14,2005-09-02 18:51:14
64d3da63ae87c0f2fb4e7a723bdfbc091bdeb7b4...92918b5ed74940c3cd64864473e0414ca9e134c9,1,9,9,18,9,2005-09-02 19:05:51,2005-09-02 19:05:51
92918b5ed74940c3cd64864473e0414ca9e134c9...5bdf1da730368a16beaa077d91457ff625f06bc4,3,29,11,40,10,2005-09-02 19:39:47,2005-09-02 19:39:47
5bdf1da730368a16beaa077d91457ff625f06bc4...95e8688d7f8c9393d0e1112b52e22e713f5fa25f,1,5,0,5,1,2005-09-02 20:37:24,2005-09-02 20:37:24
95e8688d7f8c9393d0e1112b52e22e713f5fa25f...ccbea84834a9f530c2019671787188599d2e148b,5,12,2,14,6,2005-09-02 20:46:00,2005-09-02 20:46:00
ccbea84834a9f530c2019671787188599d2e148b...6d92319838dd4fc9c96b569312702840d326d800,1,4,1,5,3,2005-09-02 21:22:49,2005-09-02 21:22:49
6d92319838dd4fc9c96b569312702840d326d800...5c22b8b4b78a9d99505495aa0abe7ffa91f6d108,1,2,0,2,1,2005-09-02 22:50:53,2005-09-02 22:50:53
5c22b8b4b78a9d99505495aa0abe7ffa91f6d108...66d4db7b098e157bb1c9ecc82000c90f9d2571a8,1,11,8,19,5,2005-09-02 22:54:12,2005-09-02 22:54:12
66d4db7b098e157bb1c9ecc82000c90f9d2571a8...1a010f8b29a145d6491afff70d2838ca0ccb66ce,1,1,0,1,1,2005-09-04 18:19:27,2005-09-04 18:19:27
1a010f8b29a145d6491afff70d2838ca0ccb66ce...fc9d457686b3af85bf94522c4cf4593d2aa711a7,1,1,0,1,1,2005-09-04 18:20:57,2005-09-04 18:20:57
fc9d457686b3af85bf94522c4cf4593d2aa711a7...65bab4b824650548a29c775641431845c06f8a6f,1,1,1,2,1,2005-09-04 18:24:23,2005-09-04 18:24:23
65bab4b824650548a29c775641431845c06f8a6f...e5a801590a062afaafa393bfc544c4441fea4362,1,2,0,2,1,2005-09-05 15:04:20,2005-09-05 15:04:20
e5a801590a062afaafa393bfc544c4441fea4362...096ad32c845f850278b942d087e607dc4311b5f9,2,279,4,283,3,2005-09-05 23:38:46,2005-09-05 23:38:46
096ad32c845f850278b942d087e607dc4311b5f9...e131e400e00d668a169a65427566e65725437d73,1,7,3,10,3,2005-09-06 00:01:44,2005-09-06 00:01:44
e131e400e00d668a169a65427566e65725437d73...f9f0ea93081e8afd2d2d5edc67b6a5b81aed197f,1,355,0,355,4,2005-09-06 02:30:23,2005-09-06 02:30:23
f9f0ea93081e8afd2d2d5edc67b6a5b81aed197f...adae680c737eedbf0edd073c886ea42052ea7d02,1,10,9,19,8,2005-09-06 02:35:51,2005-09-06 02:35:51
adae680c737eedbf0edd073c886ea42052ea7d02...276731d625f15ba8a1bb4abd30d64bff10f6b9eb,1,9,6,15,2,2005-09-06 02:37:39,2005-09-06 02:37:39
276731d625f15ba8a1bb4abd30d64bff10f6b9eb...cadb6a008d16720b0e7192ec698c3a43496f4984,1,85,11,96,9,2005-09-06 03:05:50,2005-09-06 03:05:50
cadb6a008d16720b0e7192ec698c3a43496f4984...4ea3dd5dbdcb49aa9c78140ab6730aa235d9e6f0,1,3,2,5,2,2005-09-06 03:07:38,2005-09-06 03:07:38
4ea3dd5dbdcb49aa9c78140ab6730aa235d9e6f0...1087ee3d5e4da4658e79e9f701f72c50c5bf36f9,1,2,2,4,2,2005-09-06 12:37:54,2005-09-06 12:37:54
1087ee3d5e4da4658e79e9f701f72c50c5bf36f9...93010c75f2b6889387107285f28230b483d0527d,1,2,2,4,1,2005-09-06 21:30:45,2005-09-06 21:30:45
93010c75f2b6889387107285f28230b483d0527d...f46402bc90e85f610d8ed564b35651e8244337b3,1,10,6,16,4,2005-09-06 22:14:40,2005-09-06 22:14:40
f46402bc90e85f610d8ed564b35651e8244337b3...e01ef9ddd88a982150cb5eb203bb0b9c2e47c243,1,1,1,2,1,2005-09-11 15:12:30,2005-09-11 15:12:30
e01ef9ddd88a982150cb5eb203bb0b9c2e47c243...095305cb44e669c9e732eb7c90264795408bb4b8,2,5,1,6,3,2005-09-11 15:18:04,2005-09-11 15:18:04
095305cb44e669c9e732eb7c90264795408bb4b8...63e512f25fdcd74221ee018f2ccce4999d650e2a,1,1,1,2,1,2005-09-11 15:20:05,2005-09-11 15:20:05
63e512f25fdcd74221ee018f2ccce4999d650e2a...6e034a831aea204b39f4863eddfbc223a638fb76,1,39,0,39,5,2005-09-13 03:21:44,2005-09-13 03:21:44
6e034a831aea204b39f4863eddfbc223a638fb76...99e0f7a93275b8384085d3b2b397415e2064b4d7,2,0,32,32,3,2005-09-13 03:28:34,2005-09-13 03:28:34
99e0f7a93275b8384085d3b2b397415e2064b4d7...84560c7f8457643ccd6e9121994ee54780e28cef,1,4,4,8,2,2005-09-13 03:31:34,2005-09-13 03:31:34
84560c7f8457643ccd6e9121994ee54780e28cef...adaf046591c087adb3ca31cd8ea901ed525918df,2,5,5,10,2,2005-09-13 03:48:06,2005-09-13 03:48:06
adaf046591c087adb3ca31cd8ea901ed525918df...f55f98f989ac0e4394d8ed0b2527bd1e5eda4149,2,4,3,7,3,2005-09-14 01:24:36,2005-09-14 01:24:36
f55f98f989ac0e4394d8ed0b2527bd1e5eda4149...9a24228a3e2e39a078ee32969716f8a51a1d7f26,1,4,1,5,3,2005-09-14 17:39:47,2005-09-14 17:39:47
9a24228a3e2e39a078ee32969716f8a51a1d7f26...1874f26d2229deec85b851261b64f26fb969fe0f,1,10,8,18,3,2005-09-14 19:07:29,2005-09-14 19:07:29
1874f26d2229deec85b851261b64f26fb969fe0f...526de4987a36d10312edeb5f342d8868928e475e,1,5,1,6,2,2005-09-15 16:54:46,2005-09-15 16:54:46
526de4987a36d10312edeb5f342d8868928e475e...1e910f94d23e2b4dc2ae818c0fe23acec9f014aa,1,2,1,3,1,2005-09-17 23:06:16,2005-09-17 23:06:16
1e910f94d23e2b4dc2ae818c0fe23acec9f014aa...bcc2873c7009793d12ffd2f381149ac1b284b3e6,1,1,1,2,1,2005-09-17 23:08:24,2005-09-17 23:08:24
bcc2873c7009793d12ffd2f381149ac1b284b3e6...09bd9d3ef6f1b843a58859698c2d8587461d5de6,1,42,28,70,14,2005-09-19 01:18:04,2005-09-19 01:18:04
09bd9d3ef6f1b843a58859698c2d8587461d5de6...e7982bb5b0f53203d627e5a3d4955f6e711f3fa3,1,5,3,8,2,2005-09-19 01:23:03,2005-09-19 01:23:03
e7982bb5b0f53203d627e5a3d4955f6e711f3fa3...473306a6589697d2c977373207254d89dea2133f,1,13,0,13,2,2005-09-20 01:12:24,2005-09-20 01:12:24
473306a6589697d2c977373207254d89dea2133f...1d65ba62dbfb9e6f13bccbf03bf9444c6c6d6481,1,10,2,12,2,2005-09-20 02:37:39,2005-09-20 02:37:39
1d65ba62dbfb9e6f13bccbf03bf9444c6c6d6481...7dfb86724dabcc64e2bb805f9992599a89d17a6e,1,14,2,16,1,2005-09-20 02:48:25,2005-09-20 02:48:25
7dfb86724dabcc64e2bb805f9992599a89d17a6e...fe01b4d9390f63beb5319e11d4c606c1e98b4b6a,1,6,5,11,1,2005-09-20 03:05:37,2005-09-20 03:05:37
fe01b4d9390f63beb5319e11d4c606c1e98b4b6a...aa865f360561a812dd673a5f27bfe29b0f6edfd6,1,17,0,17,1,2005-09-20 03:18:05,2005-09-20 03:18:05
aa865f360561a812dd673a5f27bfe29b0f6edfd6...88a65ddd7fd88f5f48e998ad92e3949dd5ba15ec,1,10,0,10,1,2005-09-20 03:24:01,2005-09-20 03:24:01
88a65ddd7fd88f5f48e998ad92e3949dd5ba15ec...bb87b2163c7661f64778b00ca7c52b4ba8011a43,1,7,5,12,6,2005-09-20 03:46:11,2005-09-20 03:46:11
bb87b2163c7661f64778b00ca7c52b4ba8011a43...63994a980131e15f08383fb441b26d259bd73f7f,1,9,0,9,2,2005-09-21 17:24:33,2005-09-21 17:24:33
63994a980131e15f08383fb441b26d259bd73f7f...0505000533c7a92a970f1dddbc45813d8826e292,1,5,3,8,3,2005-09-21 18:18:04,2005-09-21 18:18:04
0505000533c7a92a970f1dddbc45813d8826e292...a6946dac54380483126bb00807ea2974142f6605,1,3,3,6,2,2005-09-21 21:41:37,2005-09-21 21:41:37
a6946dac54380483126bb00807ea2974142f6605...48f0820337f5673dbcd629f30a05968356a594e6,1,8,18,26,6,2005-09-22 05:13:15,2005-09-22 05:13:15
48f0820337f5673dbcd629f30a05968356a594e6...aec3e32c7bc2a25402425f43eb054cdd25dee746,1,5,11,16,6,2005-09-22 05:18:23,2005-09-22 05:18:23
aec3e32c7bc2a25402425f43eb054cdd25dee746...4175aec30fbc32622de25f3f8b65bc25842d1f89,1,24,55,79,13,2005-09-22 05:23:41,2005-09-22 05:23:41
4175aec30fbc32622de25f3f8b65bc25842d1f89...a269a2058a3e66b5c0d1a08eb2c81d31b4222327,3,16,51,67,22,2005-09-22 05:32:47,2005-09-22 05:32:47
a269a2058a3e66b5c0d1a08eb2c81d31b4222327...f5a78ae0094447684bebc3ed37e57a0b0cc6ddb9,1,1,0,1,1,2005-09-22 13:53:52,2005-09-22 13:53:52
f5a78ae0094447684bebc3ed37e57a0b0cc6ddb9...17418cd982aa3759ee6fbb0049eec8242faba301,1,14,0,14,1,2005-09-22 14:51:57,2005-09-22 14:51:57
17418cd982aa3759ee6fbb0049eec8242faba301...62f036d67dacf8955946c4cccf7e2d30fa0616ea,2,19,10,29,3,2005-09-22 14:57:05,2005-09-22 14:57:05
62f036d67dacf8955946c4cccf7e2d30fa0616ea...a7efb3939fe2aa454a4f416706bcce6c99f3caed,6,30,30,60,30,2005-09-22 22:26:56,2005-09-22 22:26:56
a7efb3939fe2aa454a4f416706bcce6c99f3caed...1a5ada01010a7b9472c46d46f5c6d2ddcdcb1226,1,3,13,16,1,2005-09-23 00:12:24,2005-09-23 00:12:24
1a5ada01010a7b9472c46d46f5c6d2ddcdcb1226...8df0df620f294289bfd3789db29822cac4b9a741,1,0,1,1,1,2005-09-23 00:21:35,2005-09-23 00:21:35
8df0df620f294289bfd3789db29822cac4b9a741...3dc1ede8718056cf107abf06f6f213cbe23374c8,2,10,0,10,2,2005-09-23 01:17:39,2005-09-23 01:17:39
3dc1ede8718056cf107abf06f6f213cbe23374c8...39a907a051617d97a9724512791a4d9a53ee2f10,4,13,1,14,7,2005-09-23 01:28:44,2005-09-23 01:28:44
39a907a051617d97a9724512791a4d9a53ee2f10...36fc73a45bc857f0ed1c1a5c6f8e61017709e73e,3,12,9,21,9,2005-09-23 01:50:01,2005-09-23 01:50:01
36fc73a45bc857f0ed1c1a5c6f8e61017709e73e...3d426607a8e04f79fb4ee4393e92c4838539bd23,2,19,0,19,3,2005-09-23 02:02:15,2005-09-23 02:02:15
3d426607a8e04f79fb4ee4393e92c4838539bd23...9562cbbc493735a1535844a7a10951f55da67bb8,1,4,2,6,2,2005-09-23 13:24:52,2005-09-23 13:24:52
9562cbbc493735a1535844a7a10951f55da67bb8...58641f806804757e0e4f07d3e71681ee5f50cb4f,1,16,2,18,4,2005-09-23 21:40:04,2005-09-23 21:40:04
58641f806804757e0e4f07d3e71681ee5f50cb4f...a089b8f620a5d6b6aa44a3556e2a7a121ac2427d,1,8,19,27,7,2005-09-23 21:52:01,2005-09-23 21:52:01
a089b8f620a5d6b6aa44a3556e2a7a121ac2427d...3b49ecea63f2c9e6fd5b5b4b06e55b57008c6e49,1,3,6,9,3,2005-09-23 21:53:53,2005-09-23 21:53:53
3b49ecea63f2c9e6fd5b5b4b06e55b57008c6e49...a39e6c91b1e2d158b9fb3481b4b239e2346d43ae,1,3,7,10,3,2005-09-23 21:59:17,2005-09-23 21:59:17
a39e6c91b1e2d158b9fb3481b4b239e2346d43ae...3dcdce4d63e155d79a7ece80b14c5ab4358c98a9,1,6,1,7,2,2005-09-23 22:09:42,2005-09-23 22:09:42
3dcdce4d63e155d79a7ece80b14c5ab4358c98a9...b7528320b64f3e818f798daa7235f7b5721d4ac2,3,62,40,102,14,2005-09-23 22:50:05,2005-09-23 22:50:05
b7528320b64f3e818f798daa7235f7b5721d4ac2...eb3b1cfb81c231ee9f696883972e31ccd9f2e087,1,1,1,2,1,2005-09-23 22:51:08,2005-09-23 22:51:08
eb3b1cfb81c231ee9f696883972e31ccd9f2e087...109a915775f1ae5a2045007fcfac2b1b7e480d53,1,1,1,2,1,2005-09-24 17:37:30,2005-09-24 17:37:30
109a915775f1ae5a2045007fcfac2b1b7e480d53...2e8e256fe84ba9ea46eb75ee85f45af5bd296b2a,1,2,0,2,1,2005-09-24 17:39:20,2005-09-24 17:39:20
2e8e256fe84ba9ea46eb75ee85f45af5bd296b2a...c05cce5c527225ea27ebaff1f5a94878e1e9b6f8,3,27,11,38,7,2005-09-25 18:29:59,2005-09-25 18:29:59
c05cce5c527225ea27ebaff1f5a94878e1e9b6f8...572ac3e7dfadec6434527ebbdccef97de1cc191c,1,86,0,86,1,2005-09-25 18:45:01,2005-09-25 18:45:01
572ac3e7dfadec6434527ebbdccef97de1cc191c...530cdb5a8dd8a1083b15719459c2425b71bace94,2,61,22,83,4,2005-09-25 19:08:44,2005-09-25 19:08:44
530cdb5a8dd8a1083b15719459c2425b71bace94...26c4356e015d7087ed9f5393421623224cb055b2,1,5,0,5,1,2005-09-25 20:01:30,2005-09-25 20:01:30
26c4356e015d7087ed9f5393421623224cb055b2...272eab5cd8ebafc68af3bca65f4f0d217c49ce53,2,230,11,241,10,2005-09-25 20:01:35,2005-09-25 20:01:35
272eab5cd8ebafc68af3bca65f4f0d217c49ce53...68c074200807a967b71aa798d7908d0b9c06b3c7,1,10,0,10,2,2005-09-25 20:36:05,2005-09-25 20:36:05
68c074200807a967b71aa798d7908d0b9c06b3c7...c2e42e1c5c11b45b8136aff36065cb879d12862c,1,243,14,257,9,2005-09-25 21:47:31,2005-09-25 21:47:31
c2e42e1c5c11b45b8136aff36065cb879d12862c...9e03747ebb1ca650c4c547641ed42a08d7de4368,1,9,9,18,9,2005-09-25 21:53:06,2005-09-25 21:53:06
9e03747ebb1ca650c4c547641ed42a08d7de4368...f053130f678668b95e9b71f38fb179fe60c09b84,1,9,9,18,9,2005-09-25 21:54:51,2005-09-25 21:54:51
f053130f678668b95e9b71f38fb179fe60c09b84...6b4095ad10fc4a422b5243b353f45b8fc44562b3,1,2,2,4,1,2005-09-25 21:57:32,2005-09-25 21:57:32
6b4095ad10fc4a422b5243b353f45b8fc44562b3...0fa1aa8711a6e1f3653e98943f2847366c0ac556,5,139,6,145,12,2005-09-25 22:03:30,2005-09-25 22:03:30
0fa1aa8711a6e1f3653e98943f2847366c0ac556...9b68dbf95e10dd9af547176578e0e066aef8bdc5,1,2,1,3,1,2005-09-25 22:27:23,2005-09-25 22:27:23
9b68dbf95e10dd9af547176578e0e066aef8bdc5...a978dbe779e3677fb65ee3361315806d5a5449b2,1,1,1,2,1,2005-09-26 02:36:53,2005-09-26 02:36:53
a978dbe779e3677fb65ee3361315806d5a5449b2...871ffbe7ee30fae603cbde984ac5975ad5516aa1,2,11,10,21,9,2005-09-26 03:14:37,2005-09-26 03:14:37
871ffbe7ee30fae603cbde984ac5975ad5516aa1...fa8662a13f0826a2f7eb4fb727307ad45c3e0175,1,12,0,12,2,2005-09-26 05:00:29,2005-09-26 05:00:29
fa8662a13f0826a2f7eb4fb727307ad45c3e0175...60bb739d9ef6a94cb83d769c4696ea9838f2dbcb,1,1,1,2,1,2005-09-26 05:03:40,2005-09-26 05:03:40
60bb739d9ef6a94cb83d769c4696ea9838f2dbcb...c44fd057fa3a1e36aac09a08accb7840c583abaf,1,9,7,16,4,2005-09-26 05:12:22,2005-09-26 05:12:22
c44fd057fa3a1e36aac09a08accb7840c583abaf...adce221d92c12f7603ede272dbc45fc97579039e,1,22,11,33,6,2005-09-26 12:38:41,2005-09-26 12:38:41
adce221d92c12f7603ede272dbc45fc97579039e...2a072999cade3a0ce8ae3b4bf09cf0d6cb06f257,1,1,1,2,1,2005-09-26 13:38:49,2005-09-26 13:38:49
2a072999cade3a0ce8ae3b4bf09cf0d6cb06f257...9b721531399d57886ba2e86db1296b481145776d,1,1,0,1,1,2005-09-26 16:30:14,2005-09-26 16:30:14
9b721531399d57886ba2e86db1296b481145776d...d86624877de7b7db91c2966dd9bfa6ef8721b29e,1,1,1,2,1,2005-09-27 03:34:58,2005-09-27 03:34:58
d86624877de7b7db91c2966dd9bfa6ef8721b29e...7f4067100cd6767f37b8f50c553dacbd738b8771,1,2,2,4,1,2005-09-27 03:38:15,2005-09-27 03:38:15
7f4067100cd6767f37b8f50c553dacbd738b8771...c084005d5822baa6c4e6250df57ae4f5f7cd2876,2,28,12,40,6,2005-09-27 04:24:19,2005-09-27 04:24:19
c084005d5822baa6c4e6250df57ae4f5f7cd2876...787ff70e9d031cda6f34c3fe70e300ec2c18c656,1,3,3,6,2,2005-09-27 04:25:08,2005-09-27 04:25:08
787ff70e9d031cda6f34c3fe70e300ec2c18c656...cac99144fd7fb38f485be9fb049d380bc6415f9d,1,1,1,2,1,2005-09-27 04:28:18,2005-09-27 04:28:18
cac99144fd7fb38f485be9fb049d380bc6415f9d...2d1303bd68ee42e5c8014e2b479fc0f11cb8c08d,2,7,3,10,4,2005-09-27 16:32:21,2005-09-27 16:32:21
2d1303bd68ee42e5c8014e2b479fc0f11cb8c08d...8b67f5f829a998c860e107173584dcc4346d1225,2,15,0,15,2,2005-09-27 16:33:25,2005-09-27 16:33:25
8b67f5f829a998c860e107173584dcc4346d1225...cd34c163cc862113da5b27bf9f5ff452f538fb2c,2,7,4,11,3,2005-09-27 16:34:10,2005-09-27 16:34:10
cd34c163cc862113da5b27bf9f5ff452f538fb2c...c1a16d54b0fce2ffe89eab9a69e689f87a4c1ddc,5,10,7,17,9,2005-09-28 23:08:47,2005-09-28 23:08:47
c1a16d54b0fce2ffe89eab9a69e689f87a4c1ddc...26021249a4e188d855732d800d94f049488e672b,1,1,1,2,1,2005-09-29 03:19:14,2005-09-29 03:19:14
26021249a4e188d855732d800d94f049488e672b...8a7189f38f08c515e7302a484d7af0c215e92973,2,31,17,48,6,2005-09-29 04:22:09,2005-09-29 04:22:09
8a7189f38f08c515e7302a484d7af0c215e92973...808b3f4b9180dbcd4a8a84323b44a58b9bcdbd4a,1,5,3,8,4,2005-09-29 13:02:34,2005-09-29 13:02:34
808b3f4b9180dbcd4a8a84323b44a58b9bcdbd4a...152d4373053b3148a401bf8a320dfa76b60cca86,1,7,2,9,2,2005-09-29 13:26:49,2005-09-29 13:26:49
152d4373053b3148a401bf8a320dfa76b60cca86...22f27949bd24f17972eb8e01e151e199ded22264,1,4,0,4,1,2005-09-29 13:29:12,2005-09-29 13:29:12
22f27949bd24f17972eb8e01e151e199ded22264...38649f4c3f49d7c69f99eab7ba286cf457f10b29,1,1,1,2,1,2005-09-29 14:59:49,2005-09-29 14:59:49
38649f4c3f49d7c69f99eab7ba286cf457f10b29...2aadb6ef8c285ddce92db88e4647b8c5caaf2fe5,1,1,0,1,1,2005-09-29 15:04:02,2005-09-29 15:04:02
2aadb6ef8c285ddce92db88e4647b8c5caaf2fe5...277cc05462ef9f3728d9696788b68e401e53fe4c,1,3,2,5,2,2005-09-29 15:06:53,2005-09-29 15:06:53
277cc05462ef9f3728d9696788b68e401e53fe4c...3dd1d28c7fd172f8aefeca1831c89ba2d85ee48f,1,2,2,4,1,2005-09-29 19:56:17,2005-09-29 19:56:17
3dd1d28c7fd172f8aefeca1831c89ba2d85ee48f...2425907eacc8e315703404fd34faf242f5cc405b,1,1,1,2,1,2005-09-29 22:34:17,2005-09-29 22:34:17
2425907eacc8e315703404fd34faf242f5cc405b...bab70003fe61846c83cf49ed9112ffeeac0da106,1,3,3,6,3,2005-09-29 22:36:48,2005-09-29 22:36:48
bab70003fe61846c83cf49ed9112ffeeac0da106...022a03ab32e85407109f2eda68b8725679c2f040,3,21,12,33,10,2005-09-29 23:16:29,2005-09-29 23:16:29
022a03ab32e85407109f2eda68b8725679c2f040...151b44c89a6c53bc5e312fd84afeedffb23a0e94,1,12,1,13,1,2005-09-29 23:23:11,2005-09-29 23:23:11
151b44c89a6c53bc5e312fd84afeedffb23a0e94...27b1f69d79787af2c2db35b4d2a96784a59d39a7,3,15,0,15,4,2005-09-29 23:34:29,2005-09-29 23:34:29
27b1f69d79787af2c2db35b4d2a96784a59d39a7...998fc72c0d10afb6df3c58aa965540a4e23af431,1,10,16,26,5,2005-09-29 23:43:03,2005-09-29 23:43:03
998fc72c0d10afb6df3c58aa965540a4e23af431...1838c763070b5e060787d71a8b4d3819fd4871e6,1,23,2,25,2,2005-09-30 13:49:43,2005-09-30 13:49:43
1838c763070b5e060787d71a8b4d3819fd4871e6...6b2226bab8688b520dba56c778d20644e778f3d7,1,6,1,7,4,2005-09-30 13:58:30,2005-09-30 13:58:30
6b2226bab8688b520dba56c778d20644e778f3d7...5595fe2aa6863df838f246d7aea8f15c8160f76d,1,2,2,4,1,2005-09-30 16:38:03,2005-09-30 16:38:03
5595fe2aa6863df838f246d7aea8f15c8160f76d...acde573821ebd99a5b7df05e16f6a4d906d4870e,1,1,1,2,1,2005-09-30 16:39:05,2005-09-30 16:39:05
acde573821ebd99a5b7df05e16f6a4d906d4870e...7cc9526b2ea1ae17f54dbd0731a33ed2b7608dbc,1,6,6,12,6,2005-09-30 16:40:15,2005-09-30 16:40:15
7cc9526b2ea1ae17f54dbd0731a33ed2b7608dbc...a0595851b66b23b3e0c3252227d2babeeb708f8e,1,90,0,90,1,2005-09-30 22:02:51,2005-09-30 22:02:51
a0595851b66b23b3e0c3252227d2babeeb708f8e...53581d6d8da64a6a898d575af5af2182fea7c594,1,2,2,4,2,2005-09-30 22:05:44,2005-09-30 22:05:44
53581d6d8da64a6a898d575af5af2182fea7c594...da715287171bcbfd3068f0711e7b4eb95f827b6d,1,1,1,2,1,2005-09-30 22:07:19,2005-09-30 22:07:19
da715287171bcbfd3068f0711e7b4eb95f827b6d...6f07f717c0b3cb2a849fd3533abbdc943d41e76b,1,1,1,2,1,2005-10-04 13:34:59,2005-10-04 13:34:59
6f07f717c0b3cb2a849fd3533abbdc943d41e76b...78b8fcc235f4c6f89a5baa7811665e9dbcc95820,1,1,1,2,1,2005-10-04 15:17:22,2005-10-04 15:17:22
78b8fcc235f4c6f89a5baa7811665e9dbcc95820...837afc5a29d506b363d782f0fb306acf34ee2bf3,1,1,1,2,1,2005-10-04 18:05:37,2005-10-04 18:05:37
837afc5a29d506b363d782f0fb306acf34ee2bf3...16f9b08611ddc5512e16d9fcb6ce405f2962d319,1,5,0,5,2,2005-10-05 22:47:36,2005-10-05 22:47:36
16f9b08611ddc5512e16d9fcb6ce405f2962d319...c3fa47edb85fa0b3d77a3ca864990d6b5dba3ff0,2,19,18,37,5,2005-10-05 23:36:17,2005-10-05 23:36:17
c3fa47edb85fa0b3d77a3ca864990d6b5dba3ff0...8dda2aeaa39667de4dd97d50469ad6dd1075e917,1,23,10,33,1,2005-10-06 01:41:54,2005-10-06 01:41:54
8dda2aeaa39667de4dd97d50469ad6dd1075e917...261ab166cef09497ab2204442e74246758341135,1,1,1,2,1,2005-10-06 01:51:30,2005-10-06 01:51:30
261ab166cef09497ab2204442e74246758341135...ab9aacd4db5d1e69ff2c78bae69fcabe5252d395,9,22,16,38,16,2005-10-06 02:27:08,2005-10-06 02:27:08
ab9aacd4db5d1e69ff2c78bae69fcabe5252d395...cb628c0cb7c03f94ab2aee5b60128132ca79d742,1,6,6,12,5,2005-10-06 14:30:35,2005-10-06 14:30:35
cb628c0cb7c03f94ab2aee5b60128132ca79d742...9fe02e6b65bf6adb9f2bcb07e19e3bfbb5f918af,1,4,1,5,1,2005-10-06 14:43:07,2005-10-06 14:43:07
9fe02e6b65bf6adb9f2bcb07e19e3bfbb5f918af...485042b74d1ee3abb2f2ab4b4d814f2b9bcdad2c,1,8,5,13,3,2005-10-06 15:52:30,2005-10-06 15:52:30
485042b74d1ee3abb2f2ab4b4d814f2b9bcdad2c...c8930e3af441c68973e96b0afc0361357365bb0d,2,14,0,14,3,2005-10-06 17:22:23,2005-10-06 17:22:23
c8930e3af441c68973e96b0afc0361357365bb0d...eaa8db131ddc06b0ed0d8c618979ad9467a0e37e,1,5,2,7,1,2005-10-06 17:27:13,2005-10-06 17:27:13
eaa8db131ddc06b0ed0d8c618979ad9467a0e37e...9f7e2f38dd1c4f2d0b453fc40f65545cbe90de63,1,3,3,6,3,2005-10-06 17:29:59,2005-10-06 17:29:59
9f7e2f38dd1c4f2d0b453fc40f65545cbe90de63...d93c68ab5fbd7a426845c4f51ae1588f7d928b84,1,3,2,5,1,2005-10-07 23:39:06,2005-10-07 23:39:06
d93c68ab5fbd7a426845c4f51ae1588f7d928b84...6beab20722c5c4171541ebf10530f8f9949aa04e,1,1,1,2,1,2005-10-08 20:23:11,2005-10-08 20:23:11
6beab20722c5c4171541ebf10530f8f9949aa04e...b63abf037943741db7c1958537ebe3233ed6d6ee,1,2,2,4,2,2005-10-08 20:56:34,2005-10-08 20:56:34
b63abf037943741db7c1958537ebe3233ed6d6ee...a933432a708e77437706051f9e80b05fdf602aee,1,27,1,28,2,2005-10-08 21:00:25,2005-10-08 21:00:25
a933432a708e77437706051f9e80b05fdf602aee...71564b4349422d70af41cd3ea89d4667c9bf5086,1,22,0,22,1,2005-10-08 21:44:37,2005-10-08 21:44:37
71564b4349422d70af41cd3ea89d4667c9bf5086...8aa98af6bbebae4a6df2953716f07c6601f44259,1,155,0,155,1,2005-10-08 23:19:21,2005-10-08 23:19:21
8aa98af6bbebae4a6df2953716f07c6601f44259...a5a89b5a432df1f8c9003dd3b3b8b93675746da3,2,39,38,77,3,2005-10-09 00:37:56,2005-10-09 00:37:56
a5a89b5a432df1f8c9003dd3b3b8b93675746da3...d65526d6886067a8ef368e5b02fce80e1e4c4903,9,297,153,450,42,2005-10-09 00:55:08,2005-10-09 00:55:08
d65526d6886067a8ef368e5b02fce80e1e4c4903...b6fd05e4452a709b5c7dc2fc961041d8d6a461d3,1,3,0,3,2,2005-10-09 01:02:19,2005-10-09 01:02:19
b6fd05e4452a709b5c7dc2fc961041d8d6a461d3...df794701d07206132c12b21d685793d1ec261cc5,1,1,1,2,1,2005-10-09 01:02:30,2005-10-09 01:02:30
df794701d07206132c12b21d685793d1ec261cc5...fd4ddb179f4188cc7d2f4d855d4a52301f6e1acf,1,1,1,2,1,2005-10-09 01:03:04,2005-10-09 01:03:04
fd4ddb179f4188cc7d2f4d855d4a52301f6e1acf...22bbdc633cc987a4875ec86088489b3e0b0a4cea,1,59,45,104,15,2005-10-09 01:08:58,2005-10-09 01:08:58
22bbdc633cc987a4875ec86088489b3e0b0a4cea...f258a8fce28ca65f2cfb3798b36f262c65639190,1,4,0,4,1,2005-10-10 13:51:58,2005-10-10 13:51:58
f258a8fce28ca65f2cfb3798b36f262c65639190...b4e2d12b1f3f7da728c78de4b790040a0080a2d7,2,34,40,74,26,2005-10-10 13:56:39,2005-10-10 13:56:39
b4e2d12b1f3f7da728c78de4b790040a0080a2d7...474cfe56d4a9563f5acf5846f718e480752d4ff3,1,10,8,18,6,2005-10-10 14:00:20,2005-10-10 14:00:20
474cfe56d4a9563f5acf5846f718e480752d4ff3...29ff2bb4cbc7ffa3193ba0cec48308cf0f4c1295,1,4,0,4,1,2005-10-10 20:14:56,2005-10-10 20:14:56
29ff2bb4cbc7ffa3193ba0cec48308cf0f4c1295...705a2c31c1989f4ecdb086efed0e60a1448ac70d,1,1,0,1,1,2005-10-10 20:18:47,2005-10-10 20:18:47
705a2c31c1989f4ecdb086efed0e60a1448ac70d...eb4f16e666ae3d7c29b5bcae737ce755d5003a26,1,3,2,5,2,2005-10-10 20:18:56,2005-10-10 20:18:56
eb4f16e666ae3d7c29b5bcae737ce755d5003a26...b8f70f8c94b5e7915f7a6b87b5327375d1d2b790,2,4,0,4,2,2005-10-10 20:23:53,2005-10-10 20:23:53
b8f70f8c94b5e7915f7a6b87b5327375d1d2b790...5f5db2c236a2ba8cad85e58c8b0686ddafe70b0a,1,2,1,3,2,2005-10-10 21:49:31,2005-10-10 21:49:31
5f5db2c236a2ba8cad85e58c8b0686ddafe70b0a...fef8adefe173e809c582a6611b6eb58577e0c9f0,1,5,5,10,5,2005-10-10 22:23:44,2005-10-10 22:23:44
fef8adefe173e809c582a6611b6eb58577e0c9f0...179017afb57a1b0432ef769819f61a4b98997a25,1,2,2,4,1,2005-10-11 18:32:48,2005-10-11 18:32:48
179017afb57a1b0432ef769819f61a4b98997a25...9fdacc7a66e7db8ba7db351540c16f0a2fd631e7,1,3,0,3,1,2005-10-12 03:52:05,2005-10-12 03:52:05
9fdacc7a66e7db8ba7db351540c16f0a2fd631e7...5f9fe6d403dcee757778fb2c800e7866cca4b185,6,68,0,68,6,2005-10-12 04:14:21,2005-10-12 04:14:21
5f9fe6d403dcee757778fb2c800e7866cca4b185...eb5d802cc2e48f7c035e0f33a84d9fef8e58bad9,1,1,0,1,1,2005-10-12 04:17:06,2005-10-12 04:17:06
eb5d802cc2e48f7c035e0f33a84d9fef8e58bad9...84a30e709677deea2f4b2ce6661329d76b73e9b0,1,4,8,12,3,2005-10-12 13:25:24,2005-10-12 13:25:24
277cc05462ef9f3728d9696788b68e401e53fe4c...404147c3852f35fdbaa096065ed143d28f8a8a74,0,0,0,0,0,2005-09-29 15:28:48,2005-09-29 15:28:48
404147c3852f35fdbaa096065ed143d28f8a8a74...d0ba57ee90e633f5d43a630a3b0739949ea1bdd0,15,1209,98,1307,92,2005-09-30 12:16:43,2005-09-30 12:16:43
d0ba57ee90e633f5d43a630a3b0739949ea1bdd0...eb07d939383f26a19e89ecb740cbebdd415df102,11,99,50,149,32,2005-09-30 13:39:24,2005-09-30 13:39:24
eb07d939383f26a19e89ecb740cbebdd415df102...e6c080db2bdbeb102f65e57bbedb0aed362e4756,4,31,21,52,12,2005-09-30 17:17:50,2005-09-30 17:17:50
e6c080db2bdbeb102f65e57bbedb0aed362e4756...3afc81d44e39d7afdc76d7521ee78463047f574d,5,38,12,50,14,2005-09-30 17:26:00,2005-09-30 17:26:00
3afc81d44e39d7afdc76d7521ee78463047f574d...cfe2e95529253eb23145aeb7621e2fa1b140e320,4,126,31,157,14,2005-10-02 17:55:03,2005-10-02 17:55:03
cfe2e95529253eb23145aeb7621e2fa1b140e320...1c9cf486510db0f14e8dc1fc15bfa8d4a6a10481,1,4,5,9,2,2005-10-02 18:08:01,2005-10-02 18:08:01
1c9cf486510db0f14e8dc1fc15bfa8d4a6a10481...555502e208656b2a6cb8aa4cf11acdf5a0374285,10,237,125,362,39,2005-10-04 16:35:39,2005-10-04 16:35:39
555502e208656b2a6cb8aa4cf11acdf5a0374285...e3f3d4e86f984e747b18012b4587e48c27005a76,5,197,139,336,31,2005-10-05 21:41:41,2005-10-05 21:41:41
e3f3d4e86f984e747b18012b4587e48c27005a76...0b8ce51ce658159d2e5286c0d311c33cb01617ec,2,2,2,4,2,2005-10-06 00:06:47,2005-10-06 00:06:47
0b8ce51ce658159d2e5286c0d311c33cb01617ec...f9e1deb8b3a55eb9debf55d57d49a37ab0859630,12,76,51,127,30,2005-10-06 14:49:22,2005-10-06 14:49:22
f9e1deb8b3a55eb9debf55d57d49a37ab0859630...c7d7e4cb78aec43e23603993d7a119fb99598ab9,7,96,40,136,38,2005-10-07 01:13:32,2005-10-07 01:13:32
c7d7e4cb78aec43e23603993d7a119fb99598ab9...6e90c35b639bd79371a9812eba076d8df02f7e17,1,1,1,2,1,2005-10-07 01:20:28,2005-10-07 01:20:28
6e90c35b639bd79371a9812eba076d8df02f7e17...5923c63c8db3b3ac70511deb58cc6c6bc1f8226d,8,190,125,315,41,2005-10-08 14:28:21,2005-10-08 14:28:21
5923c63c8db3b3ac70511deb58cc6c6bc1f8226d...0442a5440aabf8f8b0568f4900589a6b105a0cb1,4,24,5,29,8,2005-10-08 14:37:05,2005-10-08 14:37:05
0442a5440aabf8f8b0568f4900589a6b105a0cb1...f114e652e3cc445013961c0db97903814ef0b2c5,2,28,26,54,8,2005-10-09 14:40:10,2005-10-09 14:40:10
f114e652e3cc445013961c0db97903814ef0b2c5...b335fab55e15424ef0c1318630d1ea7d2a4f6182,2,5,3,8,5,2005-10-10 13:12:53,2005-10-10 13:12:53
b335fab55e15424ef0c1318630d1ea7d2a4f6182...0f338b8c2e88641a9507ae30b6bfe1b8d48ebc2e,16,558,193,751,63,2005-10-10 13:21:30,2005-10-10 13:21:30
0f338b8c2e88641a9507ae30b6bfe1b8d48ebc2e...d41ffe4ee4f7c449f10095aaa7db5ea60b1c4884,21,225,164,389,89,2005-10-13 18:28:44,2005-10-13 18:28:44
d41ffe4ee4f7c449f10095aaa7db5ea60b1c4884...a122c04d47cc75638653d422046602d9dd5a0702,12,489,165,654,93,2005-10-14 15:25:09,2005-10-14 15:25:09
a122c04d47cc75638653d422046602d9dd5a0702...e15c4832f58cb95cd7865e69868cc97278084586,1,5,8,13,2,2005-10-14 20:00:17,2005-10-14 20:00:17
e15c4832f58cb95cd7865e69868cc97278084586...930f8ee99ffd61a11fd6f17871854fb19bd9fe90,25,483,425,908,120,2005-10-14 23:53:03,2005-10-14 23:53:03
930f8ee99ffd61a11fd6f17871854fb19bd9fe90...1384ed5644c4889a1e289afddbd19ebec36a452a,1,213,164,377,1,2005-10-14 23:55:42,2005-10-14 23:55:42
1384ed5644c4889a1e289afddbd19ebec36a452a...e84be6ffa32b84bb3b7f66cb0fddfe97444ec1d0,9,249,34,283,25,2005-10-15 23:10:35,2005-10-15 23:10:35
e84be6ffa32b84bb3b7f66cb0fddfe97444ec1d0...afda16b5abea0e1c279d0d09bc5bdcc9e964e3a0,2,1,12,13,5,2005-10-15 23:12:27,2005-10-15 23:12:27
afda16b5abea0e1c279d0d09bc5bdcc9e964e3a0...27d4bb9460a1b372fe7f0190c21a6680d4e046f4,4,19,25,44,20,2005-10-16 02:00:24,2005-10-16 02:00:24
27d4bb9460a1b372fe7f0190c21a6680d4e046f4...692d1332f964cb8d7db9d911208938df6c2389fe,5,31,31,62,13,2005-10-17 14:26:41,2005-10-17 14:26:41
692d1332f964cb8d7db9d911208938df6c2389fe...baa196bc384f3b2e5be1098d5007268fb02de87d,13,640,50,690,23,2005-10-17 19:03:16,2005-10-17 19:03:16
baa196bc384f3b2e5be1098d5007268fb02de87d...33edae21df041d60ec6af3d1cd77797e0b98f2fa,2,5,7,12,6,2005-10-18 00:04:11,2005-10-18 00:04:11
33edae21df041d60ec6af3d1cd77797e0b98f2fa...913d792878337ae8435732d0b00467fb93b6bb99,9,150,33,183,35,2005-10-18 12:39:07,2005-10-18 12:39:07
913d792878337ae8435732d0b00467fb93b6bb99...1819b38ae37a907226b893dc270fe0023b23f440,4,31,24,55,21,2005-10-18 15:58:54,2005-10-18 15:58:54
1819b38ae37a907226b893dc270fe0023b23f440...16d966a16316e8f28a1eba8d7ab015aeac46244b,3,8,4,12,4,2005-10-18 16:02:53,2005-10-18 16:02:53
16d966a16316e8f28a1eba8d7ab015aeac46244b...8694d4b7b83870ed86db9d58acdc79c8f57c651f,4,132,26,158,34,2005-10-19 00:19:47,2005-10-19 00:19:47
8694d4b7b83870ed86db9d58acdc79c8f57c651f...8fb86e60a1f01cd80238a37ca0e44c96b7aea900,1,25,0,25,1,2005-10-19 09:22:50,2005-10-19 09:22:50
277cc05462ef9f3728d9696788b68e401e53fe4c...8813e4102056ef8c789ea3b6e56ba047ec1810d7,0,0,0,0,0,2005-09-29 15:27:57,2005-09-29 15:27:57
8813e4102056ef8c789ea3b6e56ba047ec1810d7...5b59bb5c8f2dff9e2839d6e8ecd137eb93ea26f1,1,0,1,1,1,2005-09-29 15:44:46,2005-09-29 15:44:46
5b59bb5c8f2dff9e2839d6e8ecd137eb93ea26f1...a60b2050c643314996434117892136fba8adb487,1,1,0,1,1,2005-09-29 16:58:54,2005-09-29 16:58:54
a60b2050c643314996434117892136fba8adb487...98d74306099d73a4e6765bf677207b240f82dd16,11,412,7,419,17,2005-09-29 17:01:05,2005-09-29 17:01:05
98d74306099d73a4e6765bf677207b240f82dd16...5354de5ddd0d1f936fbb6c59abb08f64d396a47c,1,1,1,2,1,2005-09-29 17:19:11,2005-09-29 17:19:11
5354de5ddd0d1f936fbb6c59abb08f64d396a47c...2c8a8c3c467bbc3bffb81c9fbd9a8d629901905e,1,20,4,24,9,2005-09-29 21:07:35,2005-09-29 21:07:35
2c8a8c3c467bbc3bffb81c9fbd9a8d629901905e...e3b2fbf6adf5c03dd99e3f3e15fe15eac239d125,16,279,57,336,58,2005-09-29 21:23:41,2005-09-29 21:23:41
e3b2fbf6adf5c03dd99e3f3e15fe15eac239d125...828ca2572dc772dcb0efe46fcb99ad762d7ade5b,1,1,1,2,1,2005-09-29 22:39:15,2005-09-29 22:39:15
828ca2572dc772dcb0efe46fcb99ad762d7ade5b...f913e4d8c94a69794527a7c2b556a4dfd9e831d9,1,10,0,10,1,2005-09-30 08:49:11,2005-09-30 08:49:11
f913e4d8c94a69794527a7c2b556a4dfd9e831d9...80e450ee2dff44db06f076f163e29b3119481134,1,1,1,2,1,2005-09-30 08:53:35,2005-09-30 08:53:35
80e450ee2dff44db06f076f163e29b3119481134...96e37129ba5f11bf71540a1e3c41013d740154be,1,2,0,2,1,2005-09-30 15:53:36,2005-09-30 15:53:36
96e37129ba5f11bf71540a1e3c41013d740154be...64a6eaeb63a582cb6f9090c078fe29fb0660dd57,1,245,0,245,1,2005-09-30 20:10:38,2005-09-30 20:10:38
64a6eaeb63a582cb6f9090c078fe29fb0660dd57...3049adf4859319a19e6a0f72eb172a13b71aaf06,1,8,0,8,1,2005-09-30 20:13:41,2005-09-30 20:13:41
3049adf4859319a19e6a0f72eb172a13b71aaf06...4eb73a35848bb31e84ee6ae002224ba5023968b4,3,61,11,72,9,2005-10-01 12:47:22,2005-10-01 12:47:22
4eb73a35848bb31e84ee6ae002224ba5023968b4...26bc142f8727e694aae79c690a0549d28b0bb2d9,1,11,1,12,3,2005-10-01 12:56:12,2005-10-01 12:56:12
26bc142f8727e694aae79c690a0549d28b0bb2d9...2c6e366f0ae5cb8167f992adb7d43c0f95fc4018,2,12,3,15,3,2005-10-01 13:05:57,2005-10-01 13:05:57
2c6e366f0ae5cb8167f992adb7d43c0f95fc4018...59052e48db56626a77d3bef0ea747c2fb12ee90a,1,9,2,11,1,2005-10-01 13:28:59,2005-10-01 13:28:59
59052e48db56626a77d3bef0ea747c2fb12ee90a...280747f7571ac042c63f5575365f369a2106afed,1,1,1,2,1,2005-10-01 15:45:07,2005-10-01 15:45:07
280747f7571ac042c63f5575365f369a2106afed...ae3c26df6250ba4a2bd0bbd27f499eb211df9f15,3,66,4,70,8,2005-10-01 16:24:21,2005-10-01 16:24:21
ae3c26df6250ba4a2bd0bbd27f499eb211df9f15...009694db63b8c3d30dc4f07110169c4bf48a3de6,2,4,1,5,2,2005-10-01 16:35:20,2005-10-01 16:35:20
009694db63b8c3d30dc4f07110169c4bf48a3de6...bd9cb4c9f45ab6b26359cacc2dc6a44ec58f21ff,1,1,1,2,1,2005-10-01 16:45:16,2005-10-01 16:45:16
bd9cb4c9f45ab6b26359cacc2dc6a44ec58f21ff...0649365f43fb71332e3f492f635dc8daa7b0bc8a,16,69,63,132,58,2005-10-01 16:47:15,2005-10-01 16:47:15
0649365f43fb71332e3f492f635dc8daa7b0bc8a...6dec4793963a457b0653d300cfa8bf326ce30fa4,3,44,6,50,15,2005-10-01 17:33:40,2005-10-01 17:33:40
6dec4793963a457b0653d300cfa8bf326ce30fa4...ed3f73674b4c0670c81917b7f0d66e83010e5c60,2,307,0,307,1,2005-10-02 18:35:32,2005-10-02 18:35:32
ed3f73674b4c0670c81917b7f0d66e83010e5c60...4196ff0b174926edae60277f5a844f2463e08162,5,327,1,328,7,2005-10-03 10:15:11,2005-10-03 10:15:11
4196ff0b174926edae60277f5a844f2463e08162...5e24a67952de6bee42152569f160b103bb7ae227,1,2,2,4,1,2005-10-03 12:20:18,2005-10-03 12:20:18
5e24a67952de6bee42152569f160b103bb7ae227...8c2b8aaee676131e6cbf6cb9e50393638db6c451,1,45,9,54,4,2005-10-03 12:33:50,2005-10-03 12:33:50
8c2b8aaee676131e6cbf6cb9e50393638db6c451...6e2b74d65e84938fdc05f2de40bcfe15efadc693,18,183,38,221,40,2005-10-04 19:34:43,2005-10-04 19:34:43
6e2b74d65e84938fdc05f2de40bcfe15efadc693...ce1e5ca769506381b518deb5ab6e39dff533fd2d,2,307,0,307,1,2005-10-04 20:10:36,2005-10-04 20:10:36
ce1e5ca769506381b518deb5ab6e39dff533fd2d...a3899f2226202ee89319e60b39d98195d7f4051d,1,2,2,4,2,2005-10-05 10:34:54,2005-10-05 10:34:54
a3899f2226202ee89319e60b39d98195d7f4051d...05f9ed45881ab4c35363dd23c3f96d649d0723a5,2,136,159,295,83,2005-10-05 12:14:02,2005-10-05 12:14:02
05f9ed45881ab4c35363dd23c3f96d649d0723a5...04a66b6e55e77c60c8860c2122fb2036438d4c4f,4,308,3,311,4,2005-10-05 13:38:56,2005-10-05 13:38:56
04a66b6e55e77c60c8860c2122fb2036438d4c4f...cb09e10eb2634243f25ae61e439a71ca47d98884,12,70,45,115,25,2005-10-06 10:04:07,2005-10-06 10:04:07
cb09e10eb2634243f25ae61e439a71ca47d98884...b70beda0430fc142874999e52b451865284cd52a,2,7,6,13,4,2005-10-06 10:07:45,2005-10-06 10:07:45
b70beda0430fc142874999e52b451865284cd52a...9fb343a443ecc949309de9abd795a65b5d0a9b39,2,103,113,216,37,2005-10-07 23:18:29,2005-10-07 23:18:29
9fb343a443ecc949309de9abd795a65b5d0a9b39...2442ceaa3f57093a48bca86a28c36230f8a10010,1,2,1,3,1,2005-10-07 23:20:24,2005-10-07 23:20:24
2442ceaa3f57093a48bca86a28c36230f8a10010...4fc6d40d00586610ffabc8bf18b8e62fa12ed9bf,2,96,85,181,57,2005-10-08 00:01:25,2005-10-08 00:01:25
4fc6d40d00586610ffabc8bf18b8e62fa12ed9bf...eb7ebb777cc0f285a2df8e357c30cd49af446e13,21,596,207,803,77,2005-10-09 10:47:06,2005-10-09 10:47:06
eb7ebb777cc0f285a2df8e357c30cd49af446e13...3f5bb5fa5394ac20586160f78d02687b66f8342e,1,5,0,5,2,2005-10-09 10:57:05,2005-10-09 10:57:05
3f5bb5fa5394ac20586160f78d02687b66f8342e...588b2cb161f867895d5646f34cd5b56dca0bcf02,1,43,6,49,7,2005-10-11 09:20:31,2005-10-11 09:20:31
588b2cb161f867895d5646f34cd5b56dca0bcf02...c0eb10e4fbf1c762a69f7f9d1267e3fd16c55546,1,1,1,2,1,2005-10-11 09:21:13,2005-10-11 09:21:13
c0eb10e4fbf1c762a69f7f9d1267e3fd16c55546...51a691c9c0878ae1c61ea2bf428132d3ec086cb6,1,1,0,1,1,2005-10-11 09:23:53,2005-10-11 09:23:53
51a691c9c0878ae1c61ea2bf428132d3ec086cb6...22a87715721daa3797bafeac2f17db5b0746796e,1,1,1,2,1,2005-10-11 09:59:14,2005-10-11 09:59:14
22a87715721daa3797bafeac2f17db5b0746796e...f882f3eea9c25faf7c47757e67cdb998e2a09f87,1,16,0,16,1,2005-10-11 12:12:13,2005-10-11 12:12:13
f882f3eea9c25faf7c47757e67cdb998e2a09f87...0cd2968973427d83f7fef4fe120eaae824423f3e,1,11,0,11,2,2005-10-11 12:20:37,2005-10-11 12:20:37
0cd2968973427d83f7fef4fe120eaae824423f3e...0b0c3237080baeb53307e038c4d7786d985090f6,1,2,1,3,2,2005-10-11 12:24:16,2005-10-11 12:24:16
0b0c3237080baeb53307e038c4d7786d985090f6...50f348a92f6953c4eeb0d98f7311124e72527016,1,6,0,6,1,2005-10-11 13:23:01,2005-10-11 13:23:01
50f348a92f6953c4eeb0d98f7311124e72527016...6f88c4f9ecf3837d4f1bb8dcd0c437bc2bdca09d,1,13,11,24,3,2005-10-11 13:38:24,2005-10-11 13:38:24
6f88c4f9ecf3837d4f1bb8dcd0c437bc2bdca09d...9e1640c55f8957b1827f70cc28c6ee20bbcfb8b8,1,1,1,2,1,2005-10-11 13:44:51,2005-10-11 13:44:51
9e1640c55f8957b1827f70cc28c6ee20bbcfb8b8...d606cf7e38a1e6f73eef8119a2f538f9de760593,1,10,0,10,1,2005-10-11 14:19:28,2005-10-11 14:19:28
d606cf7e38a1e6f73eef8119a2f538f9de760593...ef9207b66149efb48f10910e18166f40aa298014,1,3,1,4,2,2005-10-11 14:22:28,2005-10-11 14:22:28
ef9207b66149efb48f10910e18166f40aa298014...7ed40733355b5ea1c7138f36508ccf8e73617398,1,5,0,5,1,2005-10-11 18:26:32,2005-10-11 18:26:32
7ed40733355b5ea1c7138f36508ccf8e73617398...d79cfec906daf449c0fa22bb9a8d3dd205567fde,3,283,0,283,1,2005-10-11 20:04:05,2005-10-11 20:04:05
d79cfec906daf449c0fa22bb9a8d3dd205567fde...d442731eb2af671d93550426cf061713a50468d2,9,69,58,127,47,2005-10-11 20:24:45,2005-10-11 20:24:45
d442731eb2af671d93550426cf061713a50468d2...176c4545f626f74d34cb441c5f254d09dd63eb91,4,19,11,30,5,2005-10-12 11:48:27,2005-10-12 11:48:27
176c4545f626f74d34cb441c5f254d09dd63eb91...18d0c31d51d52ca4515e3a16b20c75c3de229995,1,2,2,4,2,2005-10-12 14:55:03,2005-10-12 14:55:03
18d0c31d51d52ca4515e3a16b20c75c3de229995...b34e844c2f8c694b03b3ab5879f413bcd9c10781,3,49,27,76,13,2005-10-12 15:33:22,2005-10-12 15:33:22
b34e844c2f8c694b03b3ab5879f413bcd9c10781...b61aee47fc632730ac4cbfccdc6961e743be5dc1,1,1,1,2,1,2005-10-13 14:49:48,2005-10-13 14:49:48
84a30e709677deea2f4b2ce6661329d76b73e9b0...5e5fe5b5a2abe9fe680085ae1aa89a765ae276cd,1,243,0,243,1,2005-10-14 03:28:03,2005-10-14 03:28:03
5e5fe5b5a2abe9fe680085ae1aa89a765ae276cd...cdfbdfb1b23be17ac2aac00a10db8874b54fd7e2,1,4,4,8,1,2005-10-14 03:32:34,2005-10-14 03:32:34
cdfbdfb1b23be17ac2aac00a10db8874b54fd7e2...d5bbe395c216f3b71ea1ab4a0d820df9a229d5b1,1,2,1,3,1,2005-10-14 03:33:54,2005-10-14 03:33:54
d5bbe395c216f3b71ea1ab4a0d820df9a229d5b1...f2088d456c4ca394f59d179e990c6e611e92ff5f,4,17,5,22,6,2005-10-14 03:43:01,2005-10-14 03:43:01
f2088d456c4ca394f59d179e990c6e611e92ff5f...ed1c9b20466324b085fb055b28c515ea3443e2a9,2,50,40,90,41,2005-10-14 03:48:27,2005-10-14 03:48:27
ed1c9b20466324b085fb055b28c515ea3443e2a9...fdcc9da59c92dae4d17b0c0e71d4cc666ba759f5,1,3,3,6,1,2005-10-14 14:05:46,2005-10-14 14:05:46
fdcc9da59c92dae4d17b0c0e71d4cc666ba759f5...42f8a069aa55a6edce316a1164800965c200ad65,1,1,1,2,1,2005-10-14 14:06:49,2005-10-14 14:06:49
42f8a069aa55a6edce316a1164800965c200ad65...f2b8e85360ddc115ee2ed6ed781be260c0110150,1,2,2,4,2,2005-10-14 15:02:44,2005-10-14 15:02:44
f2b8e85360ddc115ee2ed6ed781be260c0110150...2db3d9c7ccf5e43713592cec4832fdbe4bc4b40f,1,1,1,2,1,2005-10-14 15:04:21,2005-10-14 15:04:21
2db3d9c7ccf5e43713592cec4832fdbe4bc4b40f...b773bf45c3011dc95617dcbec9584c8d139c27cc,1,1,0,1,1,2005-10-14 18:37:16,2005-10-14 18:37:16
b773bf45c3011dc95617dcbec9584c8d139c27cc...f71f8546283dbdf698c7578f8f9154045c84f9e7,21,355,374,729,114,2005-10-14 20:10:13,2005-10-14 20:10:13
f71f8546283dbdf698c7578f8f9154045c84f9e7...083b4f9001f3968138c4d0c34ab741cf7be97f43,1,1,0,1,1,2005-10-14 20:12:16,2005-10-14 20:12:16
c93fa6e39b5e664484e457517b1e0934e873b501...34ab88b046783111db7b07329651d9a9b961e3a3,1,10,10,20,10,2005-10-20 11:56:34,2005-10-20 11:56:34
083b4f9001f3968138c4d0c34ab741cf7be97f43...7aefff78335c45edb8dd66aeebadad934fd062ca,4,79,2,81,6,2005-10-14 22:22:12,2005-10-14 22:22:12
7aefff78335c45edb8dd66aeebadad934fd062ca...6ee014725e18bd28af019fc5d8aca0a4e9a47935,1,6,3,9,4,2005-10-14 22:28:38,2005-10-14 22:28:38
6ee014725e18bd28af019fc5d8aca0a4e9a47935...f575a4edaadcf3941d44ed502d8a13337e922e9a,1,2,2,4,2,2005-10-14 22:29:13,2005-10-14 22:29:13
f575a4edaadcf3941d44ed502d8a13337e922e9a...67e6252a1ecd6587693b2756bf4bf27c0b89c3e6,1,213,164,377,1,2005-10-14 22:38:59,2005-10-14 22:38:59
67e6252a1ecd6587693b2756bf4bf27c0b89c3e6...8254a7a7db483e3d252d7cc34f5d254e98cfa066,1,2,1,3,1,2005-10-15 00:54:42,2005-10-15 00:54:42
8254a7a7db483e3d252d7cc34f5d254e98cfa066...24154b216682dfef7ff647a5c2f698b89ba429a6,3,160,7,167,3,2005-10-15 01:37:16,2005-10-15 01:37:16
24154b216682dfef7ff647a5c2f698b89ba429a6...a2e26150b77cd2cdad4cc9de120a87a6370c6dd5,3,36,3,39,6,2005-10-15 02:20:35,2005-10-15 02:20:35
b0ad6b878ee222c54ad4e00c9406a04f73e4b963...5d74e282a4bc4bea196c3dff19f7274617c219bd,12,39,143,182,46,2005-10-20 15:55:45,2005-10-20 15:55:45
5d74e282a4bc4bea196c3dff19f7274617c219bd...bd47a9799794b13cfd2daf3bfb24a4587ae8f700,11,144,174,318,77,2005-10-20 19:07:15,2005-10-20 19:07:15
bd47a9799794b13cfd2daf3bfb24a4587ae8f700...c40fd89b1a388fbe6faee695ad8a8a764c308adf,8,84,54,138,26,2005-10-20 23:27:27,2005-10-20 23:27:27
cde24debb7c91b7ace343f215e0cb8585470fdaa...e02e1e4f49873e6cfb45725dd082e8060f1be5df,1,4,8,12,2,2005-10-14 23:47:35,2005-10-14 23:47:35
e02e1e4f49873e6cfb45725dd082e8060f1be5df...a6a0d1ddcc058f1261b191a5972474c64aaf462e,3,119,1,120,4,2005-10-16 16:10:48,2005-10-16 16:10:48
a6a0d1ddcc058f1261b191a5972474c64aaf462e...6807c4bd4d209e055bd05e0518a5c86493b16bb3,1,17,0,17,1,2005-10-16 16:15:58,2005-10-16 16:15:58
a2e26150b77cd2cdad4cc9de120a87a6370c6dd5...f1ecfe991d32f42202a6ed3ce61a234982286c5b,1,1,1,2,1,2005-10-16 19:42:16,2005-10-16 19:42:16
f1ecfe991d32f42202a6ed3ce61a234982286c5b...f808d1bb8c75f7272373992f4da72126a2c685f7,1,0,34,34,1,2005-10-16 20:52:11,2005-10-16 20:52:11
f808d1bb8c75f7272373992f4da72126a2c685f7...dc3f6e41137a6b138d777b1449790753e825d5d2,1,4,4,8,4,2005-10-17 01:53:22,2005-10-17 01:53:22
dc3f6e41137a6b138d777b1449790753e825d5d2...e8fda9091af809259cc9a63cc51717bf513ca199,1,1,1,2,1,2005-10-17 02:18:28,2005-10-17 02:18:28
e8fda9091af809259cc9a63cc51717bf513ca199...b9736c5c633fe0bd2e1aeda2b9e0a99257175e33,1,6,0,6,1,2005-10-17 02:31:35,2005-10-17 02:31:35
b9736c5c633fe0bd2e1aeda2b9e0a99257175e33...57b4f231fdc24dcb41a503c3314442ff5250a830,3,36,0,36,3,2005-10-17 02:37:50,2005-10-17 02:37:50
57b4f231fdc24dcb41a503c3314442ff5250a830...3df39deede8eba5a005ae8c487cd6320b04dc83c,1,47,2,49,2,2005-10-17 03:00:18,2005-10-17 03:00:18
3df39deede8eba5a005ae8c487cd6320b04dc83c...8b7ebca68a04c7f88dbb61e5cc43835b761e8d76,1,1,1,2,1,2005-10-17 04:36:51,2005-10-17 04:36:51
8b7ebca68a04c7f88dbb61e5cc43835b761e8d76...6bec753867485da2b11f5b36cee0b96f795c91c3,1,517,0,517,1,2005-10-17 04:53:03,2005-10-17 04:53:03
6bec753867485da2b11f5b36cee0b96f795c91c3...c686424ed9ba71ddfc6655741c8781b071f08881,1,9,5,14,6,2005-10-17 04:59:06,2005-10-17 04:59:06
ed124dc0adddcd40154719403340f1871c641437...fcb0aeb5647448902130cb5c3029ac25ee638ee7,3,8,3,11,4,2005-10-17 07:22:22,2005-10-17 07:22:22
c686424ed9ba71ddfc6655741c8781b071f08881...b223d0fd87b5580709f11c86c8eb3d5fb2142183,1,5,0,5,1,2005-10-17 13:05:55,2005-10-17 13:05:55
b223d0fd87b5580709f11c86c8eb3d5fb2142183...0bb68cd0725988bd7302da293ffdb2fa9e1b2750,1,1,1,2,1,2005-10-17 13:20:59,2005-10-17 13:20:59
0bb68cd0725988bd7302da293ffdb2fa9e1b2750...383704ac844323375e743b555f6a64d6daf6d14d,1,7,3,10,3,2005-10-17 13:24:29,2005-10-17 13:24:29
383704ac844323375e743b555f6a64d6daf6d14d...63a3c72e19758995c7933be0644b33ff6a5d9837,1,7,0,7,1,2005-10-17 14:26:20,2005-10-17 14:26:20
e8fc1fc97c156035df3e027b1461a1ccad8e96c9...6233af6633f17990ccbd0f2d2cee34faf3f359c6,1,5,2,7,2,2005-10-17 12:40:26,2005-10-17 12:40:26
6233af6633f17990ccbd0f2d2cee34faf3f359c6...49739a8f8421151bf0974bdbf11675a98020f2c7,1,50,49,99,49,2005-10-17 13:16:13,2005-10-17 13:16:13
49739a8f8421151bf0974bdbf11675a98020f2c7...3c68633d579e82a9248bac80043611d66ee9b073,2,24,70,94,11,2005-10-17 13:54:52,2005-10-17 13:54:52
3c68633d579e82a9248bac80043611d66ee9b073...f3723ce84b44812c7feddd594679ab98f708411f,1,53,39,92,12,2005-10-17 14:37:26,2005-10-17 14:37:26
f3723ce84b44812c7feddd594679ab98f708411f...e1e47e485e03e9c36680cba82dc0c405c2bc0ce5,15,2403,724,3127,273,2005-10-17 14:39:00,2005-10-17 14:39:00
e1e47e485e03e9c36680cba82dc0c405c2bc0ce5...714a32aa49ad41b1a6ad03e219c2e849aab8b83b,1,3,0,3,2,2005-10-17 15:41:05,2005-10-17 15:41:05
63a3c72e19758995c7933be0644b33ff6a5d9837...91bd6eed062774cff93e4ffca0bdfcda2b4b0899,1,4,4,8,3,2005-10-17 18:08:55,2005-10-17 18:08:55
91bd6eed062774cff93e4ffca0bdfcda2b4b0899...72442152d231ec5cb0ce07b3a6a7aa6d2a350525,2,36,115,151,38,2005-10-17 20:22:12,2005-10-17 20:22:12
72442152d231ec5cb0ce07b3a6a7aa6d2a350525...91c67bcd45facfc55abc8e7afcfc4af2732bac7f,3,100,0,100,1,2005-10-18 04:21:07,2005-10-18 04:21:07
91c67bcd45facfc55abc8e7afcfc4af2732bac7f...1dc6d4b26506fe3d8c5e72aa958b8e82ea9975be,1,3,3,6,2,2005-10-18 04:36:28,2005-10-18 04:36:28
1dc6d4b26506fe3d8c5e72aa958b8e82ea9975be...aed1930133ad4e7970c8a7909283a59fb2e3fef2,3,11,11,22,3,2005-10-18 04:40:47,2005-10-18 04:40:47
aed1930133ad4e7970c8a7909283a59fb2e3fef2...1cde1e8e59153863c8d5ed9d5987025d13f2f389,1,0,1,1,1,2005-10-18 04:42:02,2005-10-18 04:42:02
1cde1e8e59153863c8d5ed9d5987025d13f2f389...055056bc31ead5eca56805af0b2abd52d7f4c6a8,1,0,0,0,0,2005-10-18 04:44:24,2005-10-18 04:44:24
055056bc31ead5eca56805af0b2abd52d7f4c6a8...14bb88a5fc08ed160fd63a919eabd1810779af52,0,0,0,0,0,2005-10-18 04:50:36,2005-10-18 04:50:36
14bb88a5fc08ed160fd63a919eabd1810779af52...b4fd513f9f48f4658258ccae31ecf2e58d550d8b,2,6,6,12,2,2005-10-18 04:58:34,2005-10-18 04:58:34
b4fd513f9f48f4658258ccae31ecf2e58d550d8b...530f8d12b72ae1c7279ec441c3482b408c030f78,1,0,0,0,0,2005-10-18 04:59:26,2005-10-18 04:59:26
530f8d12b72ae1c7279ec441c3482b408c030f78...15fb988dbc9f25e9e04eeb098370476c0bee1363,2,12,0,12,12,2005-10-18 05:12:45,2005-10-18 05:12:45
15fb988dbc9f25e9e04eeb098370476c0bee1363...c2ffd62d89f191f615cf3d187a59590d9e10dacd,1,5,4,9,4,2005-10-18 05:18:50,2005-10-18 05:18:50
c2ffd62d89f191f615cf3d187a59590d9e10dacd...d5f32aa008bf12affa134d8f1d872fbd35bf2b69,1,7,0,7,7,2005-10-18 05:23:07,2005-10-18 05:23:07
5e5f77f59bf7b4a6148b48297a4c5ff42db51fcc...938b46d72f4834e28e215d869de3e8f12909d425,1,3,7,10,2,2005-10-30 14:21:26,2005-10-30 14:21:26
938b46d72f4834e28e215d869de3e8f12909d425...ce8f990a0d811926e13751ef548d54c5b8b95574,13,61,45,106,43,2005-10-31 00:35:14,2005-10-31 00:35:14
7a0e8a24921a28cff20ba77bd4022cd573557d83...29bd2caee61cfe293299c4e663699c27d7632f6d,15,1788,357,2145,152,2005-10-17 18:55:46,2005-10-17 18:55:46
29bd2caee61cfe293299c4e663699c27d7632f6d...2070258460a566e9f4c1afb62e185b5c4e0c26d7,4,37,22,59,20,2005-10-17 19:33:30,2005-10-17 19:33:30
2070258460a566e9f4c1afb62e185b5c4e0c26d7...a26e6a4d75062fef392440ec80e9331be5fbf12b,1,19,3,22,3,2005-10-17 19:34:12,2005-10-17 19:34:12
a26e6a4d75062fef392440ec80e9331be5fbf12b...c63aae3cff0b8fec03c0b4c31d43830863ee5772,1,4,1,5,1,2005-10-17 19:45:56,2005-10-17 19:45:56
c63aae3cff0b8fec03c0b4c31d43830863ee5772...52e336d3d032ea841b372f3454184af1b0b59c9c,1,1,1,2,1,2005-10-17 22:33:08,2005-10-17 22:33:08
52e336d3d032ea841b372f3454184af1b0b59c9c...6179bb6448d1e9768a2510cfe6c14e89ce10221d,2,797,0,797,1,2005-10-17 23:09:33,2005-10-17 23:09:33
d5f32aa008bf12affa134d8f1d872fbd35bf2b69...b890e37adaea63be240f930bf6b7b5d4c9ab1395,1,3,0,3,1,2005-10-18 13:59:58,2005-10-18 13:59:58
b890e37adaea63be240f930bf6b7b5d4c9ab1395...8863e5dd116faa25ce68c1733ac123199fbff2c5,1,1,2,3,1,2005-10-18 14:02:46,2005-10-18 14:02:46
8863e5dd116faa25ce68c1733ac123199fbff2c5...1f227df92bc492a7b7a071292e332f8e7308bf1f,1,2,0,2,1,2005-10-18 14:33:32,2005-10-18 14:33:32
1f227df92bc492a7b7a071292e332f8e7308bf1f...1bb40e75c7051f4e3cad60e7ddb5c683529e88c2,1,1,1,2,1,2005-10-18 15:41:45,2005-10-18 15:41:45
1bb40e75c7051f4e3cad60e7ddb5c683529e88c2...30d7e6282801607575f5c0ca8273272cff1c8aea,1,1,1,2,1,2005-10-18 15:59:06,2005-10-18 15:59:06
30d7e6282801607575f5c0ca8273272cff1c8aea...0dc843b3c62fe92227672c6b777bdd4250b54c3b,2,49,0,49,2,2005-10-18 22:55:23,2005-10-18 22:55:23
0dc843b3c62fe92227672c6b777bdd4250b54c3b...fd3d579179581b1fa460e13115471d58fec0c8f6,1,0,0,0,0,2005-10-18 23:15:47,2005-10-18 23:15:47
fd3d579179581b1fa460e13115471d58fec0c8f6...f07e5d4f5df5ca9ca3366d7ecc4b01c490c13198,101,142,377,519,97,2005-10-19 01:09:05,2005-10-19 01:09:05
f07e5d4f5df5ca9ca3366d7ecc4b01c490c13198...079752fe8865ea68e25a9c2199fce3305d6aea66,1,1,1,2,1,2005-10-19 01:16:57,2005-10-19 01:16:57
079752fe8865ea68e25a9c2199fce3305d6aea66...d7a69df1b6501c5540bdfad669313003b028a0ce,1,1,1,2,1,2005-10-19 01:17:13,2005-10-19 01:17:13
d7a69df1b6501c5540bdfad669313003b028a0ce...c548955d29a31a4b7baaf94f3dee2d258b34f22f,1,1,1,2,1,2005-10-19 01:18:53,2005-10-19 01:18:53
c548955d29a31a4b7baaf94f3dee2d258b34f22f...d8632868f969c4913fdc1b3b2362eef6b0a69561,0,0,0,0,0,2005-10-19 01:22:18,2005-10-19 01:22:18
d8632868f969c4913fdc1b3b2362eef6b0a69561...ed2f2419a1a49e1cc3e1279ae922babafcd0395a,1,1,1,2,1,2005-10-19 13:44:55,2005-10-19 13:44:55
ff6d527f3eefd105c2cb65c7e098e543fddb5cfb...18f43e542117f089f0688076836423a2ece091ca,5,102,8,110,7,2005-11-01 15:11:28,2005-11-01 15:11:28
f99782e48eafbda4a25e1b2d7aeda59260e9e02b...f77dd9f81f30927a327fcc32c6220831d2a51a50,3,775,0,775,2,2005-10-18 13:06:42,2005-10-18 13:06:42
f77dd9f81f30927a327fcc32c6220831d2a51a50...c1d84946406e00d8cd6e27988a25023590fbaa79,2,831,0,831,1,2005-10-18 17:29:55,2005-10-18 17:29:55
c1d84946406e00d8cd6e27988a25023590fbaa79...2c723003e0657d6dd5172cfccb76a34a77fe4771,2,10,1,11,4,2005-10-18 17:50:08,2005-10-18 17:50:08
2c723003e0657d6dd5172cfccb76a34a77fe4771...040462f61b6b9e37e46ffe6f5ce86a614a89ec4b,2,2,2,4,2,2005-10-18 18:53:52,2005-10-18 18:53:52
040462f61b6b9e37e46ffe6f5ce86a614a89ec4b...6a25843fb15ef6bc9a2cf4e71925088712b5ac24,1,5,1,6,1,2005-10-19 14:53:07,2005-10-19 14:53:07
ed2f2419a1a49e1cc3e1279ae922babafcd0395a...56022ea3140192d0f96f3481758fe8b27979a835,1,9,0,9,1,2005-10-19 16:03:24,2005-10-19 16:03:24
56022ea3140192d0f96f3481758fe8b27979a835...9de01b157fb509a0dbe5e6cda093e377e243c634,1,0,2,2,1,2005-10-19 16:10:31,2005-10-19 16:10:31
9de01b157fb509a0dbe5e6cda093e377e243c634...989fcce02a1020da98fc1ca958d5709d67a26b56,1,10,10,20,10,2005-10-19 16:29:20,2005-10-19 16:29:20
204443cf4cb442ed1789e4379140a3af83448112...0f9d7018a02eeab5466371d3b3441e03e3476893,5,29,28,57,22,2005-11-01 15:49:13,2005-11-01 15:49:13
0f9d7018a02eeab5466371d3b3441e03e3476893...13c27a87d614ccc918d2a29a7682c921eb33522b,7,162,135,297,31,2005-11-02 15:14:02,2005-11-02 15:14:02
989fcce02a1020da98fc1ca958d5709d67a26b56...bf5dce64de411929dd63c87fad6186d26dd9b360,1,1,1,2,1,2005-10-20 04:03:41,2005-10-20 04:03:41
bf5dce64de411929dd63c87fad6186d26dd9b360...539e53ccf1b9da4acd095a4aeca4ab6ccc441543,4,13,9,22,7,2005-10-20 04:20:52,2005-10-20 04:20:52
539e53ccf1b9da4acd095a4aeca4ab6ccc441543...4c327b9c864f72be0d99f0b42c3d8e3134f27d4b,2,153,163,316,36,2005-10-20 05:30:11,2005-10-20 05:30:11
4c327b9c864f72be0d99f0b42c3d8e3134f27d4b...81fd300a4e6375c14843d3b5ac0911a15d92ca1a,1,1,0,1,1,2005-10-20 05:31:54,2005-10-20 05:31:54
81fd300a4e6375c14843d3b5ac0911a15d92ca1a...62db7c5c94f4ded89aa0d123cc40b1641504fa9b,1,2,1,3,1,2005-10-20 05:32:49,2005-10-20 05:32:49
62db7c5c94f4ded89aa0d123cc40b1641504fa9b...e4c844ffa0362b3f87a0b189c6f985cd7a26a271,1,5,5,10,1,2005-10-20 05:35:33,2005-10-20 05:35:33
b291d5a4fe9fdf7a6a594bf42c0381c58e3d572e...b964f470deeffc746d77264f9fcc5cd7101f710a,1,1,1,2,2,2005-11-02 23:42:16,2005-11-02 23:42:16
b964f470deeffc746d77264f9fcc5cd7101f710a...3cc2dc152a76df57972baeb7176faee598c4bcb5,3,6,4,10,5,2005-11-04 12:29:55,2005-11-04 12:29:55
1114589e0d76ec20f2b29a70128a58cbcd4dc10f...dba9cf9fd0642359262aa0bdf3b103c771859711,2,831,831,1662,1,2005-10-19 18:07:50,2005-10-19 18:07:50
dba9cf9fd0642359262aa0bdf3b103c771859711...e1cae1e090a8677d7a46b2a03d8d634dfb69e51a,1,9,7,16,4,2005-10-19 18:18:03,2005-10-19 18:18:03
e1cae1e090a8677d7a46b2a03d8d634dfb69e51a...6ec8d14619ef9c523dec0d21b6eb8fd10a5f60a2,19,3162,3148,6310,162,2005-10-19 18:22:12,2005-10-19 18:22:12
6ec8d14619ef9c523dec0d21b6eb8fd10a5f60a2...72dcdd4de14b3516bf082bebe5e6f36fd1a36b7c,3,88,87,175,31,2005-10-19 23:55:37,2005-10-19 23:55:37
72dcdd4de14b3516bf082bebe5e6f36fd1a36b7c...f29aab544772134cf23660614e36cbfd4bb7815c,1,1,1,2,1,2005-10-19 23:59:05,2005-10-19 23:59:05
f29aab544772134cf23660614e36cbfd4bb7815c...0ab4ae9349d63f6d40b40709417fa02ffb12f2a9,1,7,24,31,6,2005-10-20 07:36:44,2005-10-20 07:36:44
e4c844ffa0362b3f87a0b189c6f985cd7a26a271...a102942d7aaf964fc4995a30eb62a042dbb5cc73,1,1,1,2,1,2005-10-20 13:13:55,2005-10-20 13:13:55
a102942d7aaf964fc4995a30eb62a042dbb5cc73...d8b83674940282c082bb3d2fce3f19bfd1589988,2,16,8,24,7,2005-10-20 13:16:46,2005-10-20 13:16:46
d8b83674940282c082bb3d2fce3f19bfd1589988...169f9d2bd3b8940a0de7cc63c765d5d21eced800,1,8,1,9,1,2005-10-20 13:22:20,2005-10-20 13:22:20
fdaad9ea2737cec1d6ad1462310b5564b960c58a...33640b247a8d1d40f1f08bb82c975f3161068b7f,2,19,2,21,2,2005-11-04 13:37:10,2005-11-04 13:37:10
33640b247a8d1d40f1f08bb82c975f3161068b7f...27ef7cef10a2f21fd412b59dc92088da50e716c1,1,1,1,2,1,2005-11-04 13:39:10,2005-11-04 13:39:10
27ef7cef10a2f21fd412b59dc92088da50e716c1...0be2945a1425f8a09c98ec760da2edbe441a9f8e,1,2,6,8,2,2005-11-04 13:58:12,2005-11-04 13:58:12
0be2945a1425f8a09c98ec760da2edbe441a9f8e...d0ee6afcba72007ca8884bcdaccd0c8b1035284b,1,1,1,2,1,2005-11-04 14:11:13,2005-11-04 14:11:13
d0ee6afcba72007ca8884bcdaccd0c8b1035284b...5ef1cef1586d2fdb0ebf22bb4c7304cc6c00ab3d,4,143,117,260,34,2005-11-04 14:25:54,2005-11-04 14:25:54
5ef1cef1586d2fdb0ebf22bb4c7304cc6c00ab3d...741a13e1dd7c256352b2ceb1e1e5189b44858533,7,310,75,385,41,2005-11-04 15:28:10,2005-11-04 15:28:10
741a13e1dd7c256352b2ceb1e1e5189b44858533...d545100ddbe878a59d175f9d8ecafc8973ef197c,3,7,8,15,7,2005-11-04 15:55:08,2005-11-04 15:55:08
169f9d2bd3b8940a0de7cc63c765d5d21eced800...3e7ea41bbb30499701a86ddfad0331333e7d89ee,1,5,0,5,1,2005-10-20 21:58:01,2005-10-20 21:58:01
3e7ea41bbb30499701a86ddfad0331333e7d89ee...81cbf27a13725f202743f02f2776d5613e2bf221,1,1,1,2,1,2005-10-20 22:58:33,2005-10-20 22:58:33
81cbf27a13725f202743f02f2776d5613e2bf221...cc3635d62fa414ea7e4a263f0ae8e141b62fa8b6,1,12,2,14,2,2005-10-20 23:16:45,2005-10-20 23:16:45
e5912b96f3d7c285319a49da32e230a537c6e576...ef9ce5e60087b02f851c52af4b683279e24be6ff,24,4392,1627,6019,447,2005-11-04 17:24:13,2005-11-04 17:24:13
ef9ce5e60087b02f851c52af4b683279e24be6ff...f2b392f654061fa9be355d9f721d10000b264376,2,242,217,459,230,2005-11-05 00:25:15,2005-11-05 00:25:15
174c8a0295c7e3f4782b5a0769de92e3f94bc801...4bab93a5fd50187d70b7b0427b8e910f5b355832,4,249,101,350,63,2005-10-23 11:45:35,2005-10-23 11:45:35
4bab93a5fd50187d70b7b0427b8e910f5b355832...916dd813f970689309e001a929306ea46b3f7e4c,18,1823,703,2526,441,2005-10-23 11:46:11,2005-10-23 11:46:11
916dd813f970689309e001a929306ea46b3f7e4c...ad1abc35b6a898d9cf16c09202233699bfe54a1f,12,46,10,56,19,2005-10-23 11:54:50,2005-10-23 11:54:50
ad1abc35b6a898d9cf16c09202233699bfe54a1f...773df6ca3991f1db74e7b4df3d47e2fad6a4d0c3,10,975,975,1950,1,2005-10-23 15:32:29,2005-10-23 15:32:29
773df6ca3991f1db74e7b4df3d47e2fad6a4d0c3...c8f9ab1ec1e18e2f82de865b7f12e3625f362d17,2,180,153,333,164,2005-10-23 21:33:48,2005-10-23 21:33:48
c8f9ab1ec1e18e2f82de865b7f12e3625f362d17...56f73b45cc7b5d8fdf3717c065819918fb3290fb,19,999,999,1998,21,2005-10-23 21:48:37,2005-10-23 21:48:37
56f73b45cc7b5d8fdf3717c065819918fb3290fb...75ac32d5a4ddcf5e332ac2f517c991c36cbf9eb3,19,46,9,55,19,2005-10-23 22:02:55,2005-10-23 22:02:55
75ac32d5a4ddcf5e332ac2f517c991c36cbf9eb3...26962549d92c02e7b74c8eb8d1fbc73626e30d1d,2,969,0,969,1,2005-10-23 22:03:26,2005-10-23 22:03:26
26962549d92c02e7b74c8eb8d1fbc73626e30d1d...e8d46cb8f12302c55be9b5dfac96eec61caa72fd,2,7,11,18,8,2005-10-23 22:13:41,2005-10-23 22:13:41
e8d46cb8f12302c55be9b5dfac96eec61caa72fd...de42aef09c4641b17fd10d8e7aeb825b9174095d,1,5,2,7,2,2005-10-27 22:34:06,2005-10-27 22:34:06
de42aef09c4641b17fd10d8e7aeb825b9174095d...ec56b7241d592b6dc7fdaec6c342e8b3f148a443,2,726,700,1426,212,2005-10-27 23:01:02,2005-10-27 23:01:02
ec56b7241d592b6dc7fdaec6c342e8b3f148a443...30b857649d477336451ff68cef1cb8b024fd5b6d,1,0,19,19,1,2005-10-27 23:03:13,2005-10-27 23:03:13
30b857649d477336451ff68cef1cb8b024fd5b6d...e744018edc77f2dec5f23461158194c273490050,2,888,0,888,1,2005-10-31 00:02:40,2005-10-31 00:02:40
cc3635d62fa414ea7e4a263f0ae8e141b62fa8b6...4f47ef85f8907f7b75ae12ff2c7ff4d4b3a3c26d,1,13,6,19,5,2005-10-22 00:04:55,2005-10-22 00:04:55
4f47ef85f8907f7b75ae12ff2c7ff4d4b3a3c26d...d412dbf46b03e45daa5e1e966f2529e3a2096b25,1,282,0,282,1,2005-10-22 00:12:56,2005-10-22 00:12:56
d412dbf46b03e45daa5e1e966f2529e3a2096b25...411625a76101fd96f32159a3408f6735bdfd0af5,1,12,6,18,10,2005-10-22 00:18:39,2005-10-22 00:18:39
411625a76101fd96f32159a3408f6735bdfd0af5...f82e64c6b2ade3e70553b3ec2743dfaa7456ddb3,2,7,2,9,4,2005-10-22 21:18:53,2005-10-22 21:18:53
f82e64c6b2ade3e70553b3ec2743dfaa7456ddb3...17f62269c2168549b76ee6204a1423a6e6f4e5f5,5,175,18,193,19,2005-10-22 21:37:59,2005-10-22 21:37:59
5abf214ea6c0539eb40a7358c40cec395a27fb22...fd871041bbafb0676ba051812cba2289530129dc,1,1,1,2,1,2005-11-08 16:27:53,2005-11-08 16:27:53
fd871041bbafb0676ba051812cba2289530129dc...24cdaa77fabf46dade40e47c0192c61d6c0a78ee,6,93,67,160,25,2005-11-08 21:46:21,2005-11-08 21:46:21
24cdaa77fabf46dade40e47c0192c61d6c0a78ee...29cce749fa9f6c044475f5b21e9b13e8f14ff74a,3,47,25,72,12,2005-11-08 23:31:47,2005-11-08 23:31:47
29cce749fa9f6c044475f5b21e9b13e8f14ff74a...b93bab5ca1aee6e608904c97c8f70206b2bcde5e,3,4,8,12,7,2005-11-09 11:39:57,2005-11-09 11:39:57
63651e8a81335466d21f99e9757bedfa415c3aec...9480908bfa9783cd0868fcca416ed0db4c656792,2,72,146,218,38,2005-10-31 21:37:21,2005-10-31 21:37:21
9480908bfa9783cd0868fcca416ed0db4c656792...ca3dbaacbb764739e3c8f5ed3a1df38d34dc4311,1,0,2,2,2,2005-11-01 18:50:32,2005-11-01 18:50:32
ca3dbaacbb764739e3c8f5ed3a1df38d34dc4311...5c8399469cbb4e227f444508eb5f46997a0789ae,2,213,259,472,177,2005-11-02 14:45:32,2005-11-02 14:45:32
5c8399469cbb4e227f444508eb5f46997a0789ae...13fcef45f76188c389258385d26cb3b34ee3e639,4,77,19,96,9,2005-11-02 17:46:07,2005-11-02 17:46:07
13fcef45f76188c389258385d26cb3b34ee3e639...a7bd5a2141533732e3b9602816e2f52e8f2230a6,2,31,24,55,5,2005-11-02 17:48:49,2005-11-02 17:48:49
a7bd5a2141533732e3b9602816e2f52e8f2230a6...1c4a48134afcf7e49685b97cd7b65af5c058db75,2,980,980,1960,1,2005-11-02 23:41:08,2005-11-02 23:41:08
1c4a48134afcf7e49685b97cd7b65af5c058db75...e2b7527f79e7106b7d5910072b8e4500a658000d,1,352,319,671,42,2005-11-03 06:52:53,2005-11-03 06:52:53
e2b7527f79e7106b7d5910072b8e4500a658000d...9af59f4ba864ce67147814db22712ccbfdc8569c,1,2,2,4,1,2005-11-03 06:54:10,2005-11-03 06:54:10
9af59f4ba864ce67147814db22712ccbfdc8569c...76c591dbe5504e4cfcd321641ffb081579c19d32,1,4,3,7,3,2005-11-03 07:53:22,2005-11-03 07:53:22
76c591dbe5504e4cfcd321641ffb081579c19d32...df1e0ef61bbf95a86ea1a1dfedccd7b5517cf6f7,2,28,28,56,29,2005-11-03 07:54:45,2005-11-03 07:54:45
df1e0ef61bbf95a86ea1a1dfedccd7b5517cf6f7...b60d7ff98582798723fe64da12089d93e92bab85,20,558,184,742,147,2005-11-03 11:25:18,2005-11-03 11:25:18
b60d7ff98582798723fe64da12089d93e92bab85...c9194cdf9052ecb5942020bdbda9e4100f228324,22,2706,2418,5124,695,2005-11-03 11:26:42,2005-11-03 11:26:42
c9194cdf9052ecb5942020bdbda9e4100f228324...ed05d90232c6fde902b4c8fe9878d9c347a84da5,1,34,29,63,12,2005-11-03 12:01:16,2005-11-03 12:01:16
ed05d90232c6fde902b4c8fe9878d9c347a84da5...1470bb0b2391028e00ea1eb95eca7c90e12b004c,3,33,133,166,21,2005-11-03 16:07:43,2005-11-03 16:07:43
1470bb0b2391028e00ea1eb95eca7c90e12b004c...11e6a880111f60b9d037a4f1f53b7b68d1da552f,2,16,1,17,5,2005-11-03 16:50:41,2005-11-03 16:50:41
11e6a880111f60b9d037a4f1f53b7b68d1da552f...9e724c25236b1e00a36a146e66b5deaa43d2af96,2,19,1,20,5,2005-11-03 17:10:16,2005-11-03 17:10:16
17f62269c2168549b76ee6204a1423a6e6f4e5f5...43ad69e24e556c26cdefd96f84a8d06e086ff854,1,12,9,21,4,2005-10-23 22:42:44,2005-10-23 22:42:44
43ad69e24e556c26cdefd96f84a8d06e086ff854...c604de5a5db2cff33ad78ad8565fcb9b05e405f6,2,23,1,24,3,2005-10-23 22:43:24,2005-10-23 22:43:24
c604de5a5db2cff33ad78ad8565fcb9b05e405f6...d4abd6fb5265d711056a4350745a870ef39c5439,1,3,2,5,2,2005-10-23 22:43:54,2005-10-23 22:43:54
d4abd6fb5265d711056a4350745a870ef39c5439...e0d2793b7b6363196599d67316c1dac8c6c725e7,2,27,7,34,3,2005-10-25 01:44:14,2005-10-25 01:44:14
e0d2793b7b6363196599d67316c1dac8c6c725e7...1ed99862c6215ddcd22b3e7797415afd8d49b8e0,1,4,4,8,2,2005-10-25 01:47:34,2005-10-25 01:47:34
1ed99862c6215ddcd22b3e7797415afd8d49b8e0...5c3d1ec163ecbb6209965d1ea32fe4d380dcc9c6,1,3,0,3,1,2005-10-25 01:51:57,2005-10-25 01:51:57
5c3d1ec163ecbb6209965d1ea32fe4d380dcc9c6...3ad82eff77ed2d30d74413a7b7cff006bbd8beb2,1,2,0,2,1,2005-10-25 02:01:10,2005-10-25 02:01:10
3ad82eff77ed2d30d74413a7b7cff006bbd8beb2...d310b108f451d3203b69956953e4c0f2eb55c291,1,1,1,2,2,2005-10-25 02:02:58,2005-10-25 02:02:58
d310b108f451d3203b69956953e4c0f2eb55c291...c3377c1eae8c330e86999ce2b58dc8e7339f40cb,1,22,9,31,7,2005-10-26 14:01:53,2005-10-26 14:01:53
c3377c1eae8c330e86999ce2b58dc8e7339f40cb...e7c870c36ea6f567e7834ce0e74ea0257c8631b7,1,28,2,30,3,2005-10-28 01:30:30,2005-10-28 01:30:30
e7c870c36ea6f567e7834ce0e74ea0257c8631b7...c6f375fd1124562cde131c9785e7d7f6771ef7f2,1,1,1,2,1,2005-10-28 03:41:39,2005-10-28 03:41:39
c6f375fd1124562cde131c9785e7d7f6771ef7f2...b5a6ff5bdd70b5d35db473b3519866537fec0088,1,1,1,2,1,2005-10-28 03:45:51,2005-10-28 03:45:51
b5a6ff5bdd70b5d35db473b3519866537fec0088...67d490a61dc5ee42b972f6c64bf589fbfc8db83f,1,2,2,4,2,2005-10-28 03:48:33,2005-10-28 03:48:33
67d490a61dc5ee42b972f6c64bf589fbfc8db83f...f12e3243326a2b6b0d09206b373b34e028eab25c,3,90,2,92,6,2005-10-29 17:00:20,2005-10-29 17:00:20
f12e3243326a2b6b0d09206b373b34e028eab25c...2822f71d08f3a94a3e26bb80fa1dbcef7bf2f1db,2,7,3,10,3,2005-10-29 17:05:19,2005-10-29 17:05:19
2822f71d08f3a94a3e26bb80fa1dbcef7bf2f1db...7e0719efa6b579270601692f1125f88dd1e0002c,1,4,7,11,3,2005-10-29 17:10:51,2005-10-29 17:10:51
1906f568cde8ffed6c61078a21eec2043f7f705c...8c782b63596ad4352667b3eaa8422d34ca32cd2b,5,103,77,180,41,2005-11-09 19:47:39,2005-11-09 19:47:39
7e0719efa6b579270601692f1125f88dd1e0002c...fb55717a09fb7f92c76d1af23b2717b7a0610d03,1,8,0,8,1,2005-10-30 14:35:44,2005-10-30 14:35:44
fb55717a09fb7f92c76d1af23b2717b7a0610d03...cbe24263692641af8908da21d1a2d333100a468a,2,57,33,90,13,2005-10-31 03:14:57,2005-10-31 03:14:57
cbe24263692641af8908da21d1a2d333100a468a...546e368d0b0a0d74b13a756fa67e162709af22e8,1,6,7,13,3,2005-10-31 03:17:39,2005-10-31 03:17:39
546e368d0b0a0d74b13a756fa67e162709af22e8...3226127aa29c498921f7a7e4209de229d253d21f,1,16,0,16,2,2005-11-01 00:40:32,2005-11-01 00:40:32
3226127aa29c498921f7a7e4209de229d253d21f...41d5cff745c26eab9a0b6ff29d2addfef7c5303a,1,3,0,3,1,2005-11-01 00:49:52,2005-11-01 00:49:52
41d5cff745c26eab9a0b6ff29d2addfef7c5303a...390666ac2bf8223bede4f78a97836051bc9f9526,3,7,4,11,6,2005-11-01 01:02:07,2005-11-01 01:02:07
390666ac2bf8223bede4f78a97836051bc9f9526...7136eb8f3a052afef29e343679e84e93d7e9e0a3,2,10,11,21,4,2005-11-01 01:08:13,2005-11-01 01:08:13
7136eb8f3a052afef29e343679e84e93d7e9e0a3...cee6faf43ed92c5b276ca4d2e1754a72fbc00ce1,1,10,3,13,3,2005-11-01 01:11:36,2005-11-01 01:11:36
cee6faf43ed92c5b276ca4d2e1754a72fbc00ce1...c65332d409cf477d4b55f1ff3bacbdea4a0afaff,1,1,6,7,2,2005-11-01 01:28:42,2005-11-01 01:28:42
c65332d409cf477d4b55f1ff3bacbdea4a0afaff...23bb8c4a4b5e785cd4992689c529f2d9a86898b2,5,20,0,20,5,2005-11-01 01:32:54,2005-11-01 01:32:54
dbaf9c6f8d4c17013238958a9b2f3f8d7bcbb665...3865e76ee79d0d9b69c82cbb88c65b29be8abd0e,4,36,27,63,17,2005-11-11 00:11:15,2005-11-11 00:11:15
23bb8c4a4b5e785cd4992689c529f2d9a86898b2...27efe14c54f3711fcb21cd2d5187be21c94b9117,1,42,0,42,2,2005-11-02 14:26:55,2005-11-02 14:26:55
27efe14c54f3711fcb21cd2d5187be21c94b9117...91a283583cf17b9241bd1b9882783a8aedba4d8e,1,4,1,5,1,2005-11-02 19:01:27,2005-11-02 19:01:27
91a283583cf17b9241bd1b9882783a8aedba4d8e...b5df9c308f169cdeaa9bf4490ed925cf95d0243a,1,4,0,4,1,2005-11-02 20:31:12,2005-11-02 20:31:12
b5df9c308f169cdeaa9bf4490ed925cf95d0243a...2d5c6ec2566ad13d4b2a6cd596b6c6c4dac74151,1,14,11,25,1,2005-11-02 21:53:32,2005-11-02 21:53:32
2d5c6ec2566ad13d4b2a6cd596b6c6c4dac74151...f29205fc7be8ad1777f3d73f6061a460e8bc07cb,1,0,1,1,1,2005-11-02 21:55:21,2005-11-02 21:55:21
f29205fc7be8ad1777f3d73f6061a460e8bc07cb...cb45fd0ae20597306cd1f877efc99d9bd7cbee98,1,2,0,2,2,2005-11-02 22:28:08,2005-11-02 22:28:08
cb45fd0ae20597306cd1f877efc99d9bd7cbee98...5cf8f684237ab5addaf3549b2347c3adf107c0a7,60,12449,186,12635,200,2005-11-04 04:59:46,2005-11-04 04:59:46
5bba260dcc02409d85db0e843eab7e1c0e8a5ac1...fc16ea49f93c21fd8a88f5f1d6fc3e5ec9a64f97,1,0,1,1,1,2005-11-11 21:33:41,2005-11-11 21:33:41
fc16ea49f93c21fd8a88f5f1d6fc3e5ec9a64f97...9b56eca28e17e53809cc9fbda44baa86fff6c598,17,262,604,866,116,2005-11-11 21:36:23,2005-11-11 21:36:23
9b56eca28e17e53809cc9fbda44baa86fff6c598...a7aeb4ed3c62628d78cdedab550a0a1cf686a0b1,1,1,1,2,1,2005-11-11 21:45:58,2005-11-11 21:45:58
a7aeb4ed3c62628d78cdedab550a0a1cf686a0b1...ceff32b78c30b6326e70e806651e632ca2e35ef9,1,1,0,1,1,2005-11-11 21:55:27,2005-11-11 21:55:27
ceff32b78c30b6326e70e806651e632ca2e35ef9...675d6bd999a7c355a577a4ddfd537e4acfb8b5af,1,2,2,4,2,2005-11-11 23:38:06,2005-11-11 23:38:06
5cf8f684237ab5addaf3549b2347c3adf107c0a7...d35d1f15814c2cf520e2c71a7f483673d0b422a5,1,1,1,2,1,2005-11-04 14:48:57,2005-11-04 14:48:57
d35d1f15814c2cf520e2c71a7f483673d0b422a5...9f92a2b92ba9145ca573c40113d571375367e5bd,12,1306,1307,2613,303,2005-11-04 14:53:24,2005-11-04 14:53:24
9f92a2b92ba9145ca573c40113d571375367e5bd...0ac931f38c414797e98febf83cc36f1e070a71b6,11,0,0,0,0,2005-11-04 14:56:12,2005-11-04 14:56:12
0ac931f38c414797e98febf83cc36f1e070a71b6...9d188cf3bb7b97b4610b368b8f71a9db8e11a4b5,25,1073,44,1117,57,2005-11-04 15:30:15,2005-11-04 15:30:15
a7faf16467008b5134e0e9c97bb70bf6e6fb7e5a...6816964a48436d894ab85ce5274306bd466d1298,2,0,1,1,1,2005-11-11 23:53:28,2005-11-11 23:53:28
6816964a48436d894ab85ce5274306bd466d1298...32b0981dc106f1447b5d0a233fc07e1f4d556e1d,1,1,1,2,1,2005-11-12 01:10:46,2005-11-12 01:10:46
32b0981dc106f1447b5d0a233fc07e1f4d556e1d...d0f4c1e4cdf32bfbb366208f34b2309dab850aff,1,1,1,2,1,2005-11-12 01:39:41,2005-11-12 01:39:41
9d188cf3bb7b97b4610b368b8f71a9db8e11a4b5...a734759fa09755d7465115d400298858c9d07210,3,2,2,4,2,2005-11-04 16:09:38,2005-11-04 16:09:38
a734759fa09755d7465115d400298858c9d07210...c55bb7ee4037077dc0b8fee1971711c991b88303,2,6,6,12,6,2005-11-04 16:40:35,2005-11-04 16:40:35
c55bb7ee4037077dc0b8fee1971711c991b88303...6e7620baf0ca3dc5101f28ffc7eb66d1faa6960b,1,305,200,505,63,2005-11-05 04:22:25,2005-11-05 04:22:25
6e7620baf0ca3dc5101f28ffc7eb66d1faa6960b...6dbc781a2a20dceb5de9f3ed0e98e2c7ff2c0689,1,0,0,0,0,2005-11-05 04:23:10,2005-11-05 04:23:10
6dbc781a2a20dceb5de9f3ed0e98e2c7ff2c0689...058818397674f773db48d82be4af72a590b8334b,1,2,2,4,2,2005-11-05 04:24:19,2005-11-05 04:24:19
058818397674f773db48d82be4af72a590b8334b...e859854d0aa88508cd83f63145c0667434683e6f,1,27,15,42,13,2005-11-05 04:40:07,2005-11-05 04:40:07
e859854d0aa88508cd83f63145c0667434683e6f...8ee33da58558fd2da918f4e9e55556f07831cd93,1,1,1,2,1,2005-11-05 17:59:16,2005-11-05 17:59:16
8ee33da58558fd2da918f4e9e55556f07831cd93...181ee4ae3175f2c7dfd89dd3418dfe81cc135a51,2,16,12,28,3,2005-11-05 18:14:17,2005-11-05 18:14:17
181ee4ae3175f2c7dfd89dd3418dfe81cc135a51...24f666656f482d567827f148a024b3c59fb5e4f0,1,3,6,9,2,2005-11-06 17:55:39,2005-11-06 17:55:39
24f666656f482d567827f148a024b3c59fb5e4f0...f6ce403140995adfec8492bf31a98edbe1f15b1b,1,8,8,16,5,2005-11-06 21:54:37,2005-11-06 21:54:37
f6ce403140995adfec8492bf31a98edbe1f15b1b...d5368d341c65a9b0606193f06bb017e51eb71d00,1,55,83,138,43,2005-11-06 21:55:39,2005-11-06 21:55:39
d5368d341c65a9b0606193f06bb017e51eb71d00...7e28ba0b4cba9f9b7faed1862364a36fc964109e,1,4,5,9,3,2005-11-06 21:55:57,2005-11-06 21:55:57
7e28ba0b4cba9f9b7faed1862364a36fc964109e...b14a50bb35baae5cb058190bd1b5c38eef74ad82,1,1,1,2,1,2005-11-06 22:02:40,2005-11-06 22:02:40
b14a50bb35baae5cb058190bd1b5c38eef74ad82...e19c9ccfcbd5b240c170df4b39a04af118d26e52,4,59,93,152,32,2005-11-06 22:22:02,2005-11-06 22:22:02
e19c9ccfcbd5b240c170df4b39a04af118d26e52...557aa1572ce6b6e5428021c937fdef298dea700e,1,8,4,12,3,2005-11-06 22:28:05,2005-11-06 22:28:05
557aa1572ce6b6e5428021c937fdef298dea700e...6d1b5b3b1a7111dcd975dc0cb925fbb499e9292a,1,2,2,4,2,2005-11-06 22:30:01,2005-11-06 22:30:01
6d1b5b3b1a7111dcd975dc0cb925fbb499e9292a...611015d858ced31ed593936ab6f2ef436c5c9bd5,2,85,156,241,50,2005-11-06 22:32:19,2005-11-06 22:32:19
611015d858ced31ed593936ab6f2ef436c5c9bd5...4947ae42b83373c0076bd21ff8c31c4b861de884,2,195,280,475,68,2005-11-06 22:34:16,2005-11-06 22:34:16
4947ae42b83373c0076bd21ff8c31c4b861de884...029257874572c23455c66d2a9289df930c25c515,1,1,1,2,1,2005-11-06 22:46:56,2005-11-06 22:46:56
029257874572c23455c66d2a9289df930c25c515...911a6dfe04df57a1f33b533eb71e9624f1ed5f14,1,4,1,5,1,2005-11-06 22:53:07,2005-11-06 22:53:07
911a6dfe04df57a1f33b533eb71e9624f1ed5f14...a218cf57988e2b6bea59734ea84ddf8a59df14f1,2,3,2,5,2,2005-11-06 22:59:18,2005-11-06 22:59:18
a218cf57988e2b6bea59734ea84ddf8a59df14f1...1b626e40839d24f2e7cd09ca7a4d5bd440ca49e7,1,7,0,7,1,2005-11-06 23:02:54,2005-11-06 23:02:54
1b626e40839d24f2e7cd09ca7a4d5bd440ca49e7...af4bef19add46f4673ac4c648c8805808ed65eec,1,8,0,8,1,2005-11-06 23:08:29,2005-11-06 23:08:29
af4bef19add46f4673ac4c648c8805808ed65eec...5defabca111fd56011395e81cf250c3c58143589,1,8,8,16,2,2005-11-06 23:16:24,2005-11-06 23:16:24
5defabca111fd56011395e81cf250c3c58143589...92241e21b80efd0884730fb908c79eb45a847eac,1,575,442,1017,123,2005-11-06 23:30:06,2005-11-06 23:30:06
92241e21b80efd0884730fb908c79eb45a847eac...aa89487fd0cd72857cf95fd5fdd66833ba960b55,1,34,34,68,16,2005-11-06 23:32:22,2005-11-06 23:32:22
aa89487fd0cd72857cf95fd5fdd66833ba960b55...eb590d894da8b34e7afc82445b48c15274c9a781,1,8,8,16,4,2005-11-06 23:33:23,2005-11-06 23:33:23
eb590d894da8b34e7afc82445b48c15274c9a781...bd0d8a779e90ae2f8c01fbf26133d13760903552,1,58,58,116,1,2005-11-06 23:36:28,2005-11-06 23:36:28
bd0d8a779e90ae2f8c01fbf26133d13760903552...72547994c12bd77b804e7e9a03c94ca80988cc44,1,20,20,40,12,2005-11-06 23:37:20,2005-11-06 23:37:20
72547994c12bd77b804e7e9a03c94ca80988cc44...d4df074d418ce61b9fca3df7ce887e7a5f54b01f,3,58,5,63,7,2005-11-06 23:49:03,2005-11-06 23:49:03
d4df074d418ce61b9fca3df7ce887e7a5f54b01f...371f63c210ffd015cdaddba2dc5463f78051be4e,2,3,7,10,4,2005-11-06 23:53:13,2005-11-06 23:53:13
371f63c210ffd015cdaddba2dc5463f78051be4e...c6fd835137b95b754912c16062f4a1904fb3ab7e,1,1,0,1,1,2005-11-06 23:57:56,2005-11-06 23:57:56
c6fd835137b95b754912c16062f4a1904fb3ab7e...de5ea0d87947cb813ed0696c949e3567c2924efb,15,2441,1246,3687,1074,2005-11-07 03:42:38,2005-11-07 03:42:38
de5ea0d87947cb813ed0696c949e3567c2924efb...c767e0f4fedabf050a8968b3b2cb68f0183683d7,1,4,0,4,1,2005-11-07 04:25:29,2005-11-07 04:25:29
c767e0f4fedabf050a8968b3b2cb68f0183683d7...290040f7fea4875bc7fbe43c3c05dca5d9debdd0,1,21,3,24,3,2005-11-07 14:21:31,2005-11-07 14:21:31
290040f7fea4875bc7fbe43c3c05dca5d9debdd0...e205b96825df26a53229dea6fdd9ad70d9531888,1,1,1,2,1,2005-11-07 14:24:13,2005-11-07 14:24:13
e205b96825df26a53229dea6fdd9ad70d9531888...c6ef1e0588f157fac91c441453780202fa1e4f1a,1,1,1,2,1,2005-11-07 14:26:40,2005-11-07 14:26:40
c6ef1e0588f157fac91c441453780202fa1e4f1a...54c3367a6301f7f7978727aee92edbdc98b80dee,2,23,2,25,3,2005-11-07 14:39:13,2005-11-07 14:39:13
54c3367a6301f7f7978727aee92edbdc98b80dee...c7b28cf7e62ed8a5ddd0be269b449f8d0efd6e0c,1,26,8,34,5,2005-11-07 14:47:29,2005-11-07 14:47:29
1d421ab9c4e75c185ff2f07116fa3432fddbd721...907feaacc72efbc87fc0d96aa3221e8f688f888a,1,9,8,17,5,2005-11-14 00:04:29,2005-11-14 00:04:29
c7b28cf7e62ed8a5ddd0be269b449f8d0efd6e0c...8b71b9b87001b80df71262c505812bf285210874,1,193,5,198,9,2005-11-08 18:45:03,2005-11-08 18:45:03
8b71b9b87001b80df71262c505812bf285210874...3aa236e10d43506a3739663a7a1d150908008a1d,1,2,2,4,1,2005-11-09 00:40:47,2005-11-09 00:40:47
3aa236e10d43506a3739663a7a1d150908008a1d...4345866965d44a532ddb7de82b59f9cbf396b051,2,90,7,97,7,2005-11-09 00:50:01,2005-11-09 00:50:01
4345866965d44a532ddb7de82b59f9cbf396b051...0639a874edd829c7bcbbbe115af35e4073e75202,15,963,0,963,1,2005-11-09 08:24:49,2005-11-09 08:24:49
0639a874edd829c7bcbbbe115af35e4073e75202...87bf29f3b7469d6233bbea9f2443e0200085531f,2,983,0,983,1,2005-11-09 08:35:22,2005-11-09 08:35:22
87bf29f3b7469d6233bbea9f2443e0200085531f...ce0876bcc40e3495e64593ee5e584ff7bdde05b3,1,3,1,4,4,2005-11-09 10:25:02,2005-11-09 10:25:02
ce0876bcc40e3495e64593ee5e584ff7bdde05b3...571d94fd3a1eb8b13e2113ff65f2f0c9ea53c32c,30,2759,2617,5376,1001,2005-11-09 10:27:41,2005-11-09 10:27:41
571d94fd3a1eb8b13e2113ff65f2f0c9ea53c32c...ed99b33b07a848282c33d3978d9a04e9f30f825f,2,3,3,6,3,2005-11-09 10:32:46,2005-11-09 10:32:46
ed99b33b07a848282c33d3978d9a04e9f30f825f...0496c113e014401ddc4114d58f2a89997295e601,2,1,1,2,1,2005-11-09 10:34:30,2005-11-09 10:34:30
5ad7d29b6745125c1166dccf2a3d4b722a1b5efa...a8db7b8bd0dd15c73e1c904bfcb3c5b64592482c,3,1,1,2,1,2005-11-14 14:13:25,2005-11-14 14:13:25
0496c113e014401ddc4114d58f2a89997295e601...1847c9ef64e673837812ba22ec75015a262a3db0,1,5,1,6,1,2005-11-09 17:39:18,2005-11-09 17:39:18
1847c9ef64e673837812ba22ec75015a262a3db0...0b1d24c54d1ab5efba05ae9d8e0e997c3c1b5b61,1,4,4,8,3,2005-11-09 17:49:57,2005-11-09 17:49:57
0b1d24c54d1ab5efba05ae9d8e0e997c3c1b5b61...f85cd32dbda85b6683b6b8a0882f7bc88fb3d060,1,5,0,5,1,2005-11-09 18:07:06,2005-11-09 18:07:06
f85cd32dbda85b6683b6b8a0882f7bc88fb3d060...31d18380f9dd7b66dfd89857f116a4995990e315,1,1,1,2,1,2005-11-09 18:29:58,2005-11-09 18:29:58
35d90bfdc7efc070279d912b6c3d458eec14ab60...b12aa73bb67e8a634dbff394757f24c104078c8c,39,6609,3647,10256,1118,2005-11-15 12:37:44,2005-11-15 12:37:44
b12aa73bb67e8a634dbff394757f24c104078c8c...69006c37217ea268b31b809dea64f429936d27d8,39,1220,136,1356,119,2005-11-15 13:18:26,2005-11-15 13:18:26
69006c37217ea268b31b809dea64f429936d27d8...11a4288a082b41c370e652909b52026d285cd584,6,13,10,23,8,2005-11-15 15:10:11,2005-11-15 15:10:11
11a4288a082b41c370e652909b52026d285cd584...6d1b10a2eb045651db403f9af5b07c6280d87ec6,36,108,108,216,90,2005-11-15 16:20:21,2005-11-15 16:20:21
6d1b10a2eb045651db403f9af5b07c6280d87ec6...09974c0a0c1bf2ac647487c42ea945ba45667c9b,38,1466,247,1713,83,2005-11-15 16:36:25,2005-11-15 16:36:25
09974c0a0c1bf2ac647487c42ea945ba45667c9b...650f92c03b6d8b91b77a0773e1a26649bdb725fe,4,279,48,327,32,2005-11-15 16:57:18,2005-11-15 16:57:18
650f92c03b6d8b91b77a0773e1a26649bdb725fe...8635e86f54fc8ea74d46883b514f3f95f3880692,1,2,0,2,2,2005-11-16 00:07:54,2005-11-16 00:07:54
31d18380f9dd7b66dfd89857f116a4995990e315...ba87f474dc1883aff039c5fbd659bd70e749ee71,1,4,2,6,3,2005-11-09 20:36:23,2005-11-09 20:36:23
ba87f474dc1883aff039c5fbd659bd70e749ee71...2a149e29b862a153263169c991584784d01e6e2f,1,1,3,4,1,2005-11-09 20:41:18,2005-11-09 20:41:18
2a149e29b862a153263169c991584784d01e6e2f...133e9e9639413ca5a115a2fd8a7218e4065c345e,2,54,1,55,2,2005-11-09 21:56:05,2005-11-09 21:56:05
133e9e9639413ca5a115a2fd8a7218e4065c345e...95cc5772c34742c45f7fc5d98d9bb593a658398b,1,17,14,31,11,2005-11-09 22:40:02,2005-11-09 22:40:02
95cc5772c34742c45f7fc5d98d9bb593a658398b...aae50fcce00ca37cf655e364faf7bbc78ea52f0b,1,1,1,2,1,2005-11-09 23:04:26,2005-11-09 23:04:26
aae50fcce00ca37cf655e364faf7bbc78ea52f0b...2ef937d0fdd607900f67ecc932309d87167ba89a,5,94,77,171,71,2005-11-09 23:37:41,2005-11-09 23:37:41
2ef937d0fdd607900f67ecc932309d87167ba89a...68397a3654caa4fd347b718cbd1b2abb08b6a7b7,1,21,2,23,4,2005-11-09 23:50:32,2005-11-09 23:50:32
68397a3654caa4fd347b718cbd1b2abb08b6a7b7...28bce49e59a4dac2ef0fdb14af4ff5b09c5efc95,1,26,7,33,11,2005-11-10 00:03:53,2005-11-10 00:03:53
2bbfb4b81572e1088b7f2ec443cdb3bb41f4fa57...476dcf047c7080186a83ca297c04980350f08327,2,0,0,0,0,2005-11-16 12:16:26,2005-11-16 12:16:26
476dcf047c7080186a83ca297c04980350f08327...e7aed52f2bf48d12050f7c63e4b22166dcdc1fb2,1,1,1,2,1,2005-11-16 16:49:24,2005-11-16 16:49:24
28bce49e59a4dac2ef0fdb14af4ff5b09c5efc95...e3e37ed1202f58e4d5e172ecd15af5ab8eda3492,3,44,16,60,14,2005-11-10 05:36:41,2005-11-10 05:36:41
e3e37ed1202f58e4d5e172ecd15af5ab8eda3492...2188f1928689662e8953a5c0546dec6eee79caac,31,316,255,571,271,2005-11-10 11:50:24,2005-11-10 11:50:24
2188f1928689662e8953a5c0546dec6eee79caac...45cb72877803ea7c9ff52ee42b6a9f9755a5af86,2,987,0,987,1,2005-11-10 11:51:05,2005-11-10 11:51:05
45cb72877803ea7c9ff52ee42b6a9f9755a5af86...8613b7436700520a37c8e4488ff4d7139af17899,1,1,1,2,1,2005-11-10 16:37:45,2005-11-10 16:37:45
ef7a5d7346ad9708c457a320a07d43e2a63466d9...9d0d4051088e2e6aedaf4173702440551fc5a978,2,69,91,160,52,2005-11-18 11:53:51,2005-11-18 11:53:51
9d0d4051088e2e6aedaf4173702440551fc5a978...cf906253667b94447725d2585d994ba6530d5aa1,39,5662,1038,6700,895,2005-11-18 14:40:55,2005-11-18 14:40:55
8613b7436700520a37c8e4488ff4d7139af17899...394eafb840ae2fe0dd2ebde42d32b8b937e706ec,1,2,1,3,1,2005-11-11 00:25:03,2005-11-11 00:25:03
394eafb840ae2fe0dd2ebde42d32b8b937e706ec...d38e882695f7cbeed645346281eaa9b651619a48,1,2,1,3,1,2005-11-11 01:14:02,2005-11-11 01:14:02
d38e882695f7cbeed645346281eaa9b651619a48...57d2a0f62c0b95e79e1262d4331b3e2c71e6ced6,1,13,0,13,1,2005-11-11 02:52:16,2005-11-11 02:52:16
57d2a0f62c0b95e79e1262d4331b3e2c71e6ced6...d0a0a545383a1a1f1b5cba30034d779079ceec5d,1,11,0,11,1,2005-11-11 03:25:52,2005-11-11 03:25:52
d0a0a545383a1a1f1b5cba30034d779079ceec5d...a11a1d5e1690fb334758fc2dbaa5478aecc8ab63,1,9,0,9,1,2005-11-11 03:50:21,2005-11-11 03:50:21
a11a1d5e1690fb334758fc2dbaa5478aecc8ab63...1b035c35d9bb288589d813393e635bc9546c914b,21,310,123,433,40,2005-11-11 04:45:05,2005-11-11 04:45:05
1b035c35d9bb288589d813393e635bc9546c914b...e0ae394e64869ceedf9781ebd4003b9b50cfb1d2,1,2,2,4,1,2005-11-11 05:13:57,2005-11-11 05:13:57
e0ae394e64869ceedf9781ebd4003b9b50cfb1d2...1fccca25d5806c0a3cd8ec9ce545bd80719e8220,6,197,287,484,97,2005-11-11 08:06:21,2005-11-11 08:06:21
3da16d2d25199428b157455748dc90c34f6b27ea...4c58f10711d336b6fa9a9ac34065006152f6e190,4,447,670,1117,258,2005-11-18 20:18:15,2005-11-18 20:18:15
4c58f10711d336b6fa9a9ac34065006152f6e190...7b874cf4ef2889b97a98106b12bbd703546f41d4,5,23,166,189,19,2005-11-18 22:06:17,2005-11-18 22:06:17
7b874cf4ef2889b97a98106b12bbd703546f41d4...2256261ec5355fa8ce2164d1145f21b6572b4ad8,2,145,2,147,2,2005-11-19 00:30:33,2005-11-19 00:30:33
2256261ec5355fa8ce2164d1145f21b6572b4ad8...8a5327945fbdf33c2578c1392dda77a01941d119,5,5,6,11,7,2005-11-19 05:17:50,2005-11-19 05:17:50
8a5327945fbdf33c2578c1392dda77a01941d119...df8d7b90774a2368d210db60df7ee69f24752d05,39,925,627,1552,337,2005-11-19 09:41:02,2005-11-19 09:41:02
df8d7b90774a2368d210db60df7ee69f24752d05...a44191565fa11c52a04929a743477806716dda71,2,259,259,518,41,2005-11-19 16:39:29,2005-11-19 16:39:29
a44191565fa11c52a04929a743477806716dda71...58f4007b556a5fbabed8c718e402b3eeecca6434,1,1,1,2,1,2005-11-19 23:21:57,2005-11-19 23:21:57
58f4007b556a5fbabed8c718e402b3eeecca6434...1e945cb8fa3bbff3a605adda75c018264ba3571e,5,76,104,180,12,2005-11-20 15:38:14,2005-11-20 15:38:14
1fccca25d5806c0a3cd8ec9ce545bd80719e8220...a3a1fcddc5f5292e53b919e11ed656f1c53b46a8,1,118,0,118,1,2005-11-11 14:51:33,2005-11-11 14:51:33
a3a1fcddc5f5292e53b919e11ed656f1c53b46a8...16a3822460455a87a539423b16a6e3990404fd6d,1,1,1,2,1,2005-11-11 14:53:15,2005-11-11 14:53:15
16a3822460455a87a539423b16a6e3990404fd6d...c62b427b122030cb18df96b1f1017b7aa4b97641,1,2,1,3,2,2005-11-11 14:54:27,2005-11-11 14:54:27
c62b427b122030cb18df96b1f1017b7aa4b97641...cb222e4d4e5f3ebe4ba6773c8e39bc5702f4af57,1,1,1,2,1,2005-11-11 16:42:41,2005-11-11 16:42:41
cb222e4d4e5f3ebe4ba6773c8e39bc5702f4af57...632b63ad76efafff2f602de9c5a4464faa37d51b,1,7,1,8,3,2005-11-11 17:15:24,2005-11-11 17:15:24
a89ade71337e14367ac869b4d0f9578a6d5a0250...47ad6ae1fe3ce1a7319bda0ba279e24e6670ebaf,3,6,45,51,6,2005-11-20 19:12:23,2005-11-20 19:12:23
632b63ad76efafff2f602de9c5a4464faa37d51b...565a19470204bddde62a17537666eb6e3c9be852,1,3,2,5,1,2005-11-11 19:11:11,2005-11-11 19:11:11
565a19470204bddde62a17537666eb6e3c9be852...e780c7112738a06b2d3f1382d9e605f21feeaf74,2,990,1010,2000,1,2005-11-11 20:09:38,2005-11-11 20:09:38
e780c7112738a06b2d3f1382d9e605f21feeaf74...f1a02133029d3a6f1226f11cce2c20e51277007d,1,26,0,26,1,2005-11-11 21:35:41,2005-11-11 21:35:41
f1a02133029d3a6f1226f11cce2c20e51277007d...bf33198f437ec0c7d6484be78bc884503e2d2793,32,2606,2410,5016,180,2005-11-11 22:10:35,2005-11-11 22:10:35
bf33198f437ec0c7d6484be78bc884503e2d2793...1873c95b3134688e9e724caa6d3ce664160dd47c,2,4,1,5,2,2005-11-11 22:56:18,2005-11-11 22:56:18
1873c95b3134688e9e724caa6d3ce664160dd47c...6004fe9573e053faf3fc44bd895cc08c6e848267,1,8,8,16,2,2005-11-11 23:34:08,2005-11-11 23:34:08
2b1c07d216c250f2d26be5f66a4b77fe9b885579...2f7893c26ffae52379e4de2db10ea8aefa496d3e,2,297,377,674,242,2005-11-20 19:49:41,2005-11-20 19:49:41
2f7893c26ffae52379e4de2db10ea8aefa496d3e...c250d98781d9b82f0c0ec4598769ee0a346fc16c,3,8,20,28,8,2005-11-20 22:12:26,2005-11-20 22:12:26
6004fe9573e053faf3fc44bd895cc08c6e848267...da33b656ce59cec3c2b3a5748ac2ecdff96fde5b,2,16,0,16,2,2005-11-12 00:09:20,2005-11-12 00:09:20
da33b656ce59cec3c2b3a5748ac2ecdff96fde5b...d47c0a55a26af9e170a3455bbb873132e05658bc,1,1,1,2,1,2005-11-12 01:16:14,2005-11-12 01:16:14
d47c0a55a26af9e170a3455bbb873132e05658bc...e8ae3567393443934d896579dd6d1dfc92bddb95,1,10,0,10,1,2005-11-12 03:24:32,2005-11-12 03:24:32
e8ae3567393443934d896579dd6d1dfc92bddb95...944de9e9e638bc239b03f67f459ad4abe4673e48,8,822,303,1125,18,2005-11-12 03:44:53,2005-11-12 03:44:53
944de9e9e638bc239b03f67f459ad4abe4673e48...10214bdac008b15b6c46836281ee28d3ec6ae075,1,16,12,28,5,2005-11-12 03:48:14,2005-11-12 03:48:14
10214bdac008b15b6c46836281ee28d3ec6ae075...782edb393bc75c7d9947e76160137fffb151897d,1,1,1,2,1,2005-11-12 03:48:53,2005-11-12 03:48:53
782edb393bc75c7d9947e76160137fffb151897d...91f1b087598777563f0b99d060f121d802eeacb1,1,17,15,32,12,2005-11-12 04:00:35,2005-11-12 04:00:35
e66c99a3561cfdb99caeb18cff1d0c6009df90b0...2a8fa1534b84594d5c2577d9b4ef6ba9ae86dd48,1,1,1,2,1,2005-11-22 04:58:08,2005-11-22 04:58:08
2a8fa1534b84594d5c2577d9b4ef6ba9ae86dd48...aa2d958e1d2179ea01ed921e55db9a616223069c,1,3,2,5,2,2005-11-22 05:00:53,2005-11-22 05:00:53
aa2d958e1d2179ea01ed921e55db9a616223069c...2e98eaea6ea1731ba90cbb3e4c6aaca60a1ce9b4,2,4,4,8,4,2005-11-22 21:06:31,2005-11-22 21:06:31
91f1b087598777563f0b99d060f121d802eeacb1...a70c04d83ba029dd09adb6b0df8fb18292591b74,1,2,2,4,2,2005-11-12 18:15:26,2005-11-12 18:15:26
a70c04d83ba029dd09adb6b0df8fb18292591b74...b2e05910edd1d077bd40f1353883031ddb5a255a,1,0,6,6,1,2005-11-12 18:17:22,2005-11-12 18:17:22
b2e05910edd1d077bd40f1353883031ddb5a255a...1bf6dd7e0e0738b3d4c6c818124f8ecfa3a99936,2,3,1,4,3,2005-11-12 18:32:12,2005-11-12 18:32:12
1bf6dd7e0e0738b3d4c6c818124f8ecfa3a99936...0a74c68eeebb827736f2370dc67d0d72619025f2,1,5,1,6,1,2005-11-12 20:25:47,2005-11-12 20:25:47
0a74c68eeebb827736f2370dc67d0d72619025f2...9da6eb5c267449f25de93f3dcefcb10c76fb7523,4,191,182,373,59,2005-11-12 20:57:20,2005-11-12 20:57:20
9da6eb5c267449f25de93f3dcefcb10c76fb7523...5f39a6a240e4c23a4d8f6a05e10eb64d3a08f05e,1,26,19,45,7,2005-11-12 21:27:46,2005-11-12 21:27:46
5f39a6a240e4c23a4d8f6a05e10eb64d3a08f05e...33accf560d9a8a318a34fc6a38c038f2d86165ff,1,12,0,12,1,2005-11-12 21:33:46,2005-11-12 21:33:46
33accf560d9a8a318a34fc6a38c038f2d86165ff...f3d1f395592a9f8dc143c471dbdc111b5247a03e,1,10,0,10,1,2005-11-12 21:36:38,2005-11-12 21:36:38
f3d1f395592a9f8dc143c471dbdc111b5247a03e...367ce0ce923d4efe114f65300d2f4668cf7fbd4d,1,7,0,7,1,2005-11-12 21:45:01,2005-11-12 21:45:01
367ce0ce923d4efe114f65300d2f4668cf7fbd4d...f3319e45e4aaceb9caaa5c5fe2a96fc6eac39884,34,426,199,625,88,2005-11-12 22:08:54,2005-11-12 22:08:54
f3319e45e4aaceb9caaa5c5fe2a96fc6eac39884...f7d2e9ea9f0d9bba38553f21cfe3f1a821916374,3,38,14,52,5,2005-11-13 00:19:16,2005-11-13 00:19:16
f7d2e9ea9f0d9bba38553f21cfe3f1a821916374...23c9e2aec9d7d5374e64f0c4bd70727c99b0eec2,1,3,3,6,1,2005-11-13 00:22:39,2005-11-13 00:22:39
23c9e2aec9d7d5374e64f0c4bd70727c99b0eec2...46083845d4125ea6c7da66b81cd8bdd9ec6ac067,1,6,6,12,4,2005-11-13 04:43:07,2005-11-13 04:43:07
46083845d4125ea6c7da66b81cd8bdd9ec6ac067...29bdbc3dbffed238546b1ea1163a95139d50236f,1,15,0,15,1,2005-11-13 04:48:52,2005-11-13 04:48:52
29bdbc3dbffed238546b1ea1163a95139d50236f...3273c981f8d370ce6ccc6cbd8a20fea4f9d64de0,5,20,21,41,9,2005-11-13 05:11:41,2005-11-13 05:11:41
3273c981f8d370ce6ccc6cbd8a20fea4f9d64de0...b40952b0a106a035b21505e41d936c54b2ce73cf,1,1,1,2,1,2005-11-13 16:14:14,2005-11-13 16:14:14
b40952b0a106a035b21505e41d936c54b2ce73cf...c9b3aa399c1c271e0e9739298582f231e9a1f3ac,2,1010,0,1010,1,2005-11-13 17:59:51,2005-11-13 17:59:51
c9b3aa399c1c271e0e9739298582f231e9a1f3ac...0bff994e256c344dbe489971e350824330c22f6d,35,1490,1422,2912,434,2005-11-13 18:02:55,2005-11-13 18:02:55
0bff994e256c344dbe489971e350824330c22f6d...fdf2738f0efe108152fb5812fb04d0ae79f39ca8,35,236,169,405,185,2005-11-13 19:38:31,2005-11-13 19:38:31
fdf2738f0efe108152fb5812fb04d0ae79f39ca8...e70be1181444a8a364feeaf27a79dcc8effc3171,1,17,2,19,3,2005-11-13 22:59:51,2005-11-13 22:59:51
e70be1181444a8a364feeaf27a79dcc8effc3171...27eaf5a8917db785606831d0def7f09cadba3e8d,1,1,1,2,1,2005-11-13 23:10:27,2005-11-13 23:10:27
27eaf5a8917db785606831d0def7f09cadba3e8d...8a0137446f27374795962bfa351e98929e15d40f,1,2,0,2,2,2005-11-13 23:18:22,2005-11-13 23:18:22
8a0137446f27374795962bfa351e98929e15d40f...6e40d8c29f2b6ed926cf764f5c9cdce07bc9a069,2,3,0,3,2,2005-11-13 23:33:05,2005-11-13 23:33:05
927e5d63b9de93104dc000267fd1bf7a1e061600...3d9eabdbe15d3a4ecef9bb68424f8c72a43b5911,38,2026,2073,4099,811,2005-11-22 23:02:48,2005-11-22 23:02:48
3d9eabdbe15d3a4ecef9bb68424f8c72a43b5911...df06056a17c96627cad9436826e7580784e6f3ae,1,2,0,2,1,2005-11-22 23:18:47,2005-11-22 23:18:47
df06056a17c96627cad9436826e7580784e6f3ae...ea1d8471c22a259b0bdff1b9fec3e65252e76558,1,1,1,2,1,2005-11-23 15:48:16,2005-11-23 15:48:16
ea1d8471c22a259b0bdff1b9fec3e65252e76558...855d9909c6afa94cafb128c0cf9ffd7a06339e77,1,2,2,4,3,2005-11-23 16:18:17,2005-11-23 16:18:17
855d9909c6afa94cafb128c0cf9ffd7a06339e77...c18d99735e3c8531a06eeee2beca131238dc073c,5,54,53,107,46,2005-11-23 19:05:55,2005-11-23 19:05:55
c18d99735e3c8531a06eeee2beca131238dc073c...c8719b7765bb38282bc39c1e42b5de8ea40bd825,1,64,70,134,21,2005-11-23 19:37:17,2005-11-23 19:37:17
c8719b7765bb38282bc39c1e42b5de8ea40bd825...fbae051559b5465ddd4a959dbd72d8178d05c577,1,4,2,6,3,2005-11-23 21:33:19,2005-11-23 21:33:19
fbae051559b5465ddd4a959dbd72d8178d05c577...9a47071c389151f069842214eb8f3c81b14b52ab,1,16,173,189,4,2005-11-23 21:47:53,2005-11-23 21:47:53
6e40d8c29f2b6ed926cf764f5c9cdce07bc9a069...f6bf41e59ac032c253e3b4e1b267010c6d456a26,9,295,116,411,82,2005-11-14 01:44:35,2005-11-14 01:44:35
f6bf41e59ac032c253e3b4e1b267010c6d456a26...33b7ef290ee0b4a5dbbb4f58b352f63e1b9ed2e8,1,1,1,2,1,2005-11-14 04:16:09,2005-11-14 04:16:09
33b7ef290ee0b4a5dbbb4f58b352f63e1b9ed2e8...7b315b47aa09611ff293fd6cfaf21b86f7045a2b,1,5,2,7,3,2005-11-14 04:28:31,2005-11-14 04:28:31
7b315b47aa09611ff293fd6cfaf21b86f7045a2b...7626cb058107ac1ecb0795162e4c9fc4f92356dd,4,28,6,34,9,2005-11-14 04:59:20,2005-11-14 04:59:20
7626cb058107ac1ecb0795162e4c9fc4f92356dd...74865663bbaddf4d2d8cd5472e2f137ebe0ec347,3,123,3,126,9,2005-11-14 05:15:40,2005-11-14 05:15:40
74865663bbaddf4d2d8cd5472e2f137ebe0ec347...4decd32b0ebd1275abda421874ada9daa166a0c1,2,1013,0,1013,1,2005-11-14 13:28:42,2005-11-14 13:28:42
4decd32b0ebd1275abda421874ada9daa166a0c1...5319f285a669c0012f07a37352dd6addd4da5509,1,2,2,4,2,2005-11-14 13:29:38,2005-11-14 13:29:38
5319f285a669c0012f07a37352dd6addd4da5509...1775ee7d089c8e3131ca426af194453d7fd1829d,4,97,274,371,51,2005-11-14 15:34:47,2005-11-14 15:34:47
1775ee7d089c8e3131ca426af194453d7fd1829d...0710243ea12f9f88189197703d4c2e9e2e9fe741,2,446,26,472,8,2005-11-14 17:44:50,2005-11-14 17:44:50
0710243ea12f9f88189197703d4c2e9e2e9fe741...065dd334de34940a7703b09bbbd4567b55d10598,1,1,0,1,1,2005-11-14 18:50:13,2005-11-14 18:50:13
f7d3e8a20d75d2b9db77b4400e0ac1bc7cee39d4...95ab189dceb95df7ea15e97890ad274b95baf5a7,1,0,1,1,1,2005-11-23 23:26:25,2005-11-23 23:26:25
065dd334de34940a7703b09bbbd4567b55d10598...d0ec43298a4c55917a9ef1830bb7fe2877bef7c3,1,1,1,2,1,2005-11-15 05:52:25,2005-11-15 05:52:25
d0ec43298a4c55917a9ef1830bb7fe2877bef7c3...a411d68a10fdc43c4318b8edd9a67f052488b9e3,1,10,0,10,1,2005-11-15 07:34:18,2005-11-15 07:34:18
a411d68a10fdc43c4318b8edd9a67f052488b9e3...ed92d36825f6d812bb9e5f801f49b26ae9567364,1,1,1,2,1,2005-11-15 07:36:09,2005-11-15 07:36:09
ed92d36825f6d812bb9e5f801f49b26ae9567364...705a568854a56840e0cf064f110559f6ef10a9c1,1,17,0,17,1,2005-11-15 13:51:31,2005-11-15 13:51:31
705a568854a56840e0cf064f110559f6ef10a9c1...d6aa904487527d468a6b8bc097028d7af9a668e6,1,15,2,17,4,2005-11-15 14:35:24,2005-11-15 14:35:24
d6aa904487527d468a6b8bc097028d7af9a668e6...2c61aff52339ad1dc65f70a8c79b5f0b48266c21,1,3,0,3,1,2005-11-15 14:43:56,2005-11-15 14:43:56
2c61aff52339ad1dc65f70a8c79b5f0b48266c21...dcb5bc32e0a475a514d3fdec8699c5fbe564b7ee,1,9,0,9,1,2005-11-15 16:55:26,2005-11-15 16:55:26
dcb5bc32e0a475a514d3fdec8699c5fbe564b7ee...400cf5658da46fc748e64a7570a6df0dd21cbff2,2,65,9,74,5,2005-11-15 17:19:33,2005-11-15 17:19:33
400cf5658da46fc748e64a7570a6df0dd21cbff2...29be17533acb7efc5c395192d41948d16e3ddc52,39,1557,374,1931,347,2005-11-15 18:37:41,2005-11-15 18:37:41
29be17533acb7efc5c395192d41948d16e3ddc52...9b3b25029183821c41985f3d6f4112e9e4da0346,1,1,0,1,1,2005-11-15 18:40:10,2005-11-15 18:40:10
9b3b25029183821c41985f3d6f4112e9e4da0346...14695dc02ad62fa4cf4692b22df46e3332f42e67,2,31,36,67,22,2005-11-15 20:08:46,2005-11-15 20:08:46
14695dc02ad62fa4cf4692b22df46e3332f42e67...991039dd1e1f89dc1d20c35cdd216abb110a3bee,1,1,0,1,1,2005-11-15 23:28:43,2005-11-15 23:28:43
d953d9ba5b77e46af33169fef3c8383f424db337...942d02a8854d5c47dd902f4fed852d089327845c,1,0,8,8,1,2005-11-24 03:27:28,2005-11-24 03:27:28
942d02a8854d5c47dd902f4fed852d089327845c...7ee9f5c7c56f89b803b83a3b735890abe749cc7d,1,2,2,4,2,2005-11-24 03:35:06,2005-11-24 03:35:06
7ee9f5c7c56f89b803b83a3b735890abe749cc7d...fa0436809c85966101a52e42873e08c4ae00c188,1,2,2,4,2,2005-11-24 03:40:04,2005-11-24 03:40:04
fa0436809c85966101a52e42873e08c4ae00c188...ab45bbbb020e60d691f1f6d421726f17990abfe7,1,1,2,3,1,2005-11-24 03:41:49,2005-11-24 03:41:49
ab45bbbb020e60d691f1f6d421726f17990abfe7...82c071539bec37f94d49e15e6d956925d3af6cbf,1,1,1,2,1,2005-11-24 03:42:59,2005-11-24 03:42:59
82c071539bec37f94d49e15e6d956925d3af6cbf...7da863576fc72caa0545fad738fd6537a5896346,12,75,85,160,45,2005-11-24 04:24:29,2005-11-24 04:24:29
7da863576fc72caa0545fad738fd6537a5896346...95564bb8829bc7e09089a3c38c0ff0760ac596bc,1,95,95,190,1,2005-11-24 04:32:15,2005-11-24 04:32:15
95564bb8829bc7e09089a3c38c0ff0760ac596bc...03d9d060c9cd68c5437ca0d9328dae14034fe776,2,82,98,180,63,2005-11-24 04:58:46,2005-11-24 04:58:46
991039dd1e1f89dc1d20c35cdd216abb110a3bee...2d49f70b0d2fb566ffbc3d7bc78b057c6f84b13f,1,12,11,23,7,2005-11-16 00:25:48,2005-11-16 00:25:48
2d49f70b0d2fb566ffbc3d7bc78b057c6f84b13f...a469d821a12fc337d534cb9d499942296c1bd126,1,9,1,10,2,2005-11-16 00:33:50,2005-11-16 00:33:50
a469d821a12fc337d534cb9d499942296c1bd126...464e84257d1e61468bc6ddd3cc5ed0343ec6b047,5,33,28,61,19,2005-11-16 02:00:23,2005-11-16 02:00:23
464e84257d1e61468bc6ddd3cc5ed0343ec6b047...3301999387d3c004cdf30fefb434e84f12fba2d2,1,5,1,6,2,2005-11-16 02:57:03,2005-11-16 02:57:03
3301999387d3c004cdf30fefb434e84f12fba2d2...b2424a391a42a01b32b5fd9a337f93092d842ac8,1,22,2,24,2,2005-11-16 02:57:38,2005-11-16 02:57:38
b2424a391a42a01b32b5fd9a337f93092d842ac8...93519513a14e1c4990786bd0c5d6eb8e18e75d09,1,6,2,8,3,2005-11-16 02:59:22,2005-11-16 02:59:22
93519513a14e1c4990786bd0c5d6eb8e18e75d09...6b870c136bc87cb7b284301ee9eb0560cf16f66d,1,2,2,4,1,2005-11-16 03:09:50,2005-11-16 03:09:50
6b870c136bc87cb7b284301ee9eb0560cf16f66d...17d54d1d9ef6d0f07b5527f54761785988d5fcf9,1,1,1,2,1,2005-11-16 03:37:01,2005-11-16 03:37:01
32ca04e59eb73b2a7dc52a4734b9e0a1b47c8c4a...88fb208912824009393092109bc046f22b90af75,1,59,63,122,43,2005-11-25 01:46:07,2005-11-25 01:46:07
88fb208912824009393092109bc046f22b90af75...5c607732565d666ff0ac150e1a45ffcbf0749102,1,34,43,77,32,2005-11-25 01:51:19,2005-11-25 01:51:19
5c607732565d666ff0ac150e1a45ffcbf0749102...b413132dd5dad3c3768b6b409ac51d2c7175051a,1,0,1,1,1,2005-11-25 01:53:23,2005-11-25 01:53:23
b413132dd5dad3c3768b6b409ac51d2c7175051a...3b0f82ab8b1a502e4480126c9fe2f09052abbec7,1,23,27,50,22,2005-11-25 02:02:53,2005-11-25 02:02:53
3b0f82ab8b1a502e4480126c9fe2f09052abbec7...a7f2b39b1089b08ce956c7dfd1776b7ed7a65ad4,1,1,0,1,1,2005-11-25 02:19:49,2005-11-25 02:19:49
a7f2b39b1089b08ce956c7dfd1776b7ed7a65ad4...a67a1d53b450ec95efe00fbfb71be1ea8a927b3d,1,7,8,15,4,2005-11-25 02:26:08,2005-11-25 02:26:08
a67a1d53b450ec95efe00fbfb71be1ea8a927b3d...efd3304e572360df1ab7c04fd6069c5afb1f7306,1,1,1,2,1,2005-11-25 02:29:34,2005-11-25 02:29:34
efd3304e572360df1ab7c04fd6069c5afb1f7306...8f5f9153f68c57cdb434d3993af1a5d2105fc574,1,4,4,8,3,2005-11-25 02:52:55,2005-11-25 02:52:55
8f5f9153f68c57cdb434d3993af1a5d2105fc574...5edaf7838e64ea679f11a0f2b8855faa9333850e,5,18,41,59,23,2005-11-25 03:03:17,2005-11-25 03:03:17
5edaf7838e64ea679f11a0f2b8855faa9333850e...8be7d7e544a981862248651fd207186156869875,1,63,56,119,35,2005-11-25 03:18:11,2005-11-25 03:18:11
8be7d7e544a981862248651fd207186156869875...12dec8023d7ba0fdd305f5feeb53871c706b3e2a,2,172,180,352,88,2005-11-25 04:37:46,2005-11-25 04:37:46
12dec8023d7ba0fdd305f5feeb53871c706b3e2a...851df276ef2c491f16116ef91c73f8d9adf56e5d,3,99,1,100,3,2005-11-25 04:43:39,2005-11-25 04:43:39
17d54d1d9ef6d0f07b5527f54761785988d5fcf9...674c0b353ceaace921eb3d1b5b0293b35a41ad2e,1,12,5,17,2,2005-11-16 05:35:59,2005-11-16 05:35:59
674c0b353ceaace921eb3d1b5b0293b35a41ad2e...eda3e2c99a80a94e4bfbb30f13c931523a63746f,1,1,1,2,1,2005-11-16 12:13:28,2005-11-16 12:13:28
17d54d1d9ef6d0f07b5527f54761785988d5fcf9...2609cb37a516f65f5e7e925d2f4feb82ce3af9ad,0,0,0,0,0,2005-11-16 05:35:00,2005-11-16 05:35:00
2609cb37a516f65f5e7e925d2f4feb82ce3af9ad...021e0c6b88c900b262176861140054b969b3e85e,0,0,0,0,0,2006-08-16 05:43:27,2006-08-16 05:43:27
021e0c6b88c900b262176861140054b969b3e85e...6eefa521be3c658dc0b38f8d62d52e9801e198ab,1,8,1,9,1,2006-08-16 06:29:22,2006-08-16 06:29:22
6eefa521be3c658dc0b38f8d62d52e9801e198ab...b2f1f380b31a029c7f2882ff1ebeb6f044a02381,1,3,4,7,2,2006-09-05 16:04:23,2006-09-05 16:04:23
b2f1f380b31a029c7f2882ff1ebeb6f044a02381...4f5fb9f5dbf67401d2820252532179d7a4f5ac00,1,35,24,59,14,2006-09-05 16:36:44,2006-09-05 16:36:44
4f5fb9f5dbf67401d2820252532179d7a4f5ac00...56075c08c3bcd42a03b173aaed48af238393be12,2,3,5,8,4,2007-01-02 19:47:10,2007-01-02 19:47:10
56075c08c3bcd42a03b173aaed48af238393be12...78217bfc3a22edac3986bd11035b9bff3c186bc9,1,33,0,33,2,2007-01-24 19:55:43,2007-01-24 19:55:43
78217bfc3a22edac3986bd11035b9bff3c186bc9...eb97c80010dc50d42cf3af7fe8aeaff22beb5b64,1,2,2,4,2,2007-01-30 19:04:57,2007-01-30 19:04:57
eda3e2c99a80a94e4bfbb30f13c931523a63746f...6c83f8ed9282d18323e0d1fa8754f235ef256d27,6,471,582,1053,267,2005-11-16 18:28:42,2005-11-16 18:28:42
6c83f8ed9282d18323e0d1fa8754f235ef256d27...6be021076394e1bfd7b11e13f0392e8f52f8c04c,2,8,12,20,10,2005-11-16 23:22:27,2005-11-16 23:22:27
6be021076394e1bfd7b11e13f0392e8f52f8c04c...b1603563a3514eeab29780b0f4e5a54d70a7e4ff,1,23,23,46,20,2005-11-17 03:10:03,2005-11-17 03:10:03
b1603563a3514eeab29780b0f4e5a54d70a7e4ff...bb505a87ac473250dbff48ac8390013461aa7f1b,1,10,8,18,10,2005-11-17 14:19:33,2005-11-17 14:19:33
bb505a87ac473250dbff48ac8390013461aa7f1b...56e40c5884e17f037ddbe7091d42fe6f8e602814,1,6,1,7,2,2005-11-17 15:00:23,2005-11-17 15:00:23
56e40c5884e17f037ddbe7091d42fe6f8e602814...33ffa72e40390255df361bfb5f1cee40dc3de508,2,5,4,9,3,2005-11-17 15:26:50,2005-11-17 15:26:50
33ffa72e40390255df361bfb5f1cee40dc3de508...3bbc2bd09153b84f20aa04b4b28784515a0a429d,1,6,5,11,4,2005-11-17 15:27:19,2005-11-17 15:27:19
3bbc2bd09153b84f20aa04b4b28784515a0a429d...3478fb51d6a1b7f27d2a6696c0e4b1f8b79fd9a8,1,7,1,8,5,2005-11-17 15:55:04,2005-11-17 15:55:04
3478fb51d6a1b7f27d2a6696c0e4b1f8b79fd9a8...90639553844e74a404e19039afed06bc85cad563,2,30,27,57,26,2005-11-17 16:00:01,2005-11-17 16:00:01
90639553844e74a404e19039afed06bc85cad563...1da036040c3edbde3af116d38d4fb7067156239a,1,48,0,48,1,2005-11-18 16:20:26,2005-11-18 16:20:26
1da036040c3edbde3af116d38d4fb7067156239a...a81d16dadaaf872e969e9e68fa9a04152053ebeb,2,21,16,37,19,2005-11-18 20:11:50,2005-11-18 20:11:50
a81d16dadaaf872e969e9e68fa9a04152053ebeb...cdbc94dbd27bacfcf758e76526c57db3f6001d1e,1,0,1,1,1,2005-11-18 21:42:45,2005-11-18 21:42:45
cdbc94dbd27bacfcf758e76526c57db3f6001d1e...f125fb0afc2e00612701f825c8456acdcb53e55b,3,253,40,293,22,2005-11-19 18:20:30,2005-11-19 18:20:30
f125fb0afc2e00612701f825c8456acdcb53e55b...c5068ff4acb44cd2d30794618b972e7c045290be,1,3,1,4,2,2005-11-19 18:28:08,2005-11-19 18:28:08
c5068ff4acb44cd2d30794618b972e7c045290be...34560e0776e9ca090298df3fea2344743d5664cb,1,1,1,2,1,2005-11-19 20:20:13,2005-11-19 20:20:13
34560e0776e9ca090298df3fea2344743d5664cb...72d8e07de42639fb653f62ff5a135d42b818b7b2,1,5,1,6,1,2005-11-20 04:53:28,2005-11-20 04:53:28
72d8e07de42639fb653f62ff5a135d42b818b7b2...09f32294e8a6b9f65bca44c252f78a904e9c3515,1,3,0,3,2,2005-11-20 04:55:57,2005-11-20 04:55:57
09f32294e8a6b9f65bca44c252f78a904e9c3515...b5feff39632e744bd63db7064b0056717a57288e,1,2,2,4,2,2005-11-20 05:17:15,2005-11-20 05:17:15
b5feff39632e744bd63db7064b0056717a57288e...85c50d4fdfb4011068932f4f26fbd5a7d77caf25,1,1,1,2,1,2005-11-20 05:17:55,2005-11-20 05:17:55
85c50d4fdfb4011068932f4f26fbd5a7d77caf25...58f95c3a6a16b44749fc05fe1747ebf12467a496,1,1,1,2,1,2005-11-20 16:20:24,2005-11-20 16:20:24
58f95c3a6a16b44749fc05fe1747ebf12467a496...cd01d6d3817fb01f3f1f021abd45abd49dfa019e,1,15,6,21,4,2005-11-20 16:35:44,2005-11-20 16:35:44
cd01d6d3817fb01f3f1f021abd45abd49dfa019e...3895a825a9696b58db1a0a2f6f30b1b023d58050,4,55,6,61,8,2005-11-20 17:16:13,2005-11-20 17:16:13
3895a825a9696b58db1a0a2f6f30b1b023d58050...16493e135c21bd45e0f5961d687421176cd4c4cc,1,6,3,9,2,2005-11-20 17:18:25,2005-11-20 17:18:25
16493e135c21bd45e0f5961d687421176cd4c4cc...2bb18eddbe6f5ea4e46da330a25a2918b1ca6dc5,1,33,0,33,2,2005-11-20 17:33:40,2005-11-20 17:33:40
2bb18eddbe6f5ea4e46da330a25a2918b1ca6dc5...c472b1471d662b3a3f35641b83086622eae3c10e,1,10,2,12,2,2005-11-20 17:35:29,2005-11-20 17:35:29
c472b1471d662b3a3f35641b83086622eae3c10e...b4bb345b94f7f6415d3a3aa258dbe46478fcfff5,1,1,2,3,1,2005-11-20 17:36:16,2005-11-20 17:36:16
b4bb345b94f7f6415d3a3aa258dbe46478fcfff5...887ed3ad2c2d021209d41244fc4234cb168f4ba0,1,1,1,2,1,2005-11-20 22:17:00,2005-11-20 22:17:00
887ed3ad2c2d021209d41244fc4234cb168f4ba0...6f249c856b0723b5b7f30b36f50889e19d12c825,1,8,2,10,3,2005-11-20 22:18:41,2005-11-20 22:18:41
6f249c856b0723b5b7f30b36f50889e19d12c825...928318faf960acac81ee0ab788facd61cd4efd6a,1,5,0,5,1,2005-11-20 22:28:57,2005-11-20 22:28:57
928318faf960acac81ee0ab788facd61cd4efd6a...9347f748b007b5551abfc0110e410d17baf6eade,1,2,1,3,2,2005-11-20 22:40:46,2005-11-20 22:40:46
9347f748b007b5551abfc0110e410d17baf6eade...d778326c52701579281f633c8115d9c836e09d58,5,7,4,11,5,2005-11-20 22:41:41,2005-11-20 22:41:41
d778326c52701579281f633c8115d9c836e09d58...fc0200857b4cb595395e4320272abd77c85c89be,1,2,2,4,2,2005-11-20 23:48:36,2005-11-20 23:48:36
fc0200857b4cb595395e4320272abd77c85c89be...acdd24f5266490a5193272a9d30a76a75466cc2a,1,9,0,9,1,2005-11-20 23:49:35,2005-11-20 23:49:35
acdd24f5266490a5193272a9d30a76a75466cc2a...de770472b146d6e01f507726cbf40d1c3ecb2cde,1,1,1,2,1,2005-11-21 00:05:18,2005-11-21 00:05:18
de770472b146d6e01f507726cbf40d1c3ecb2cde...b96f6059f01c9ff5247eae617a38119e914501bf,1,5,2,7,1,2005-11-21 00:27:48,2005-11-21 00:27:48
b96f6059f01c9ff5247eae617a38119e914501bf...7a80b2cc985a40eac6deb8e4e6ec050a8274bc47,2,3,10,13,4,2005-11-21 01:39:18,2005-11-21 01:39:18
7a80b2cc985a40eac6deb8e4e6ec050a8274bc47...270377cb37e3bbe5f2432cdab94fe955ace099ea,1,11,0,11,1,2005-11-21 01:45:15,2005-11-21 01:45:15
270377cb37e3bbe5f2432cdab94fe955ace099ea...db94402ea69fb3ba14288441cd28938c568586f5,1,15,0,15,1,2005-11-21 02:33:46,2005-11-21 02:33:46
db94402ea69fb3ba14288441cd28938c568586f5...10ca90a2fd4a6e22d034e33e736ea2a2b21967c9,1,3,0,3,1,2005-11-21 02:34:05,2005-11-21 02:34:05
10ca90a2fd4a6e22d034e33e736ea2a2b21967c9...f1a8869339a4d6d004028c1234aaf706e420b5dd,5,56,53,109,6,2005-11-21 02:46:15,2005-11-21 02:46:15
f1a8869339a4d6d004028c1234aaf706e420b5dd...a49fa746cdc056f0b660f47fbc55aa43fcd54bcc,2,56,13,69,8,2005-11-21 03:33:22,2005-11-21 03:33:22
a49fa746cdc056f0b660f47fbc55aa43fcd54bcc...e4e28d907aee9f0e3977e2c6237406d7746c5719,2,12,3,15,5,2005-11-21 10:41:54,2005-11-21 10:41:54
e4e28d907aee9f0e3977e2c6237406d7746c5719...7b201f6e520d5fb757925e776aee128c6e1c9749,1,1,1,2,1,2005-11-21 11:09:36,2005-11-21 11:09:36
7b201f6e520d5fb757925e776aee128c6e1c9749...a87d43f809c7614a749e9ef6af1c45ff4e075c0c,1,10,8,18,5,2005-11-21 11:10:19,2005-11-21 11:10:19
a87d43f809c7614a749e9ef6af1c45ff4e075c0c...b4d379d5e1dfbd00486defadcd4a404c315d5e9a,1,1,1,2,1,2005-11-21 13:06:51,2005-11-21 13:06:51
b4d379d5e1dfbd00486defadcd4a404c315d5e9a...6c127e3883d12f18f23b9db35ab441ba46d6487b,2,148,146,294,59,2005-11-21 22:34:24,2005-11-21 22:34:24
6c127e3883d12f18f23b9db35ab441ba46d6487b...b6ddc9d3c16a028defca175781592325ae1796c8,1,1,1,2,1,2005-11-22 03:39:39,2005-11-22 03:39:39
b6ddc9d3c16a028defca175781592325ae1796c8...912ddb16bca464eb9fc0d1e170fcee6406a7319c,1,1,0,1,1,2005-11-22 04:42:26,2005-11-22 04:42:26
912ddb16bca464eb9fc0d1e170fcee6406a7319c...3ae9542c2473e557566cc065156c6b1054ce3894,1,6,2,8,1,2005-11-22 04:44:21,2005-11-22 04:44:21
3ae9542c2473e557566cc065156c6b1054ce3894...24b98280a5db1b9609d01efd9be963837e9689c1,1,1,1,2,1,2005-11-22 04:45:12,2005-11-22 04:45:12
24b98280a5db1b9609d01efd9be963837e9689c1...7911173ccc44432251fc88fc513771f64d6b9f1a,1,1,1,2,1,2005-11-22 05:04:56,2005-11-22 05:04:56
7911173ccc44432251fc88fc513771f64d6b9f1a...8a2d9fc2f4e43bcadf480eb01534f79d3b8a4729,1,2,2,4,2,2005-11-22 05:11:14,2005-11-22 05:11:14
8a2d9fc2f4e43bcadf480eb01534f79d3b8a4729...1ba8bd114a487350bd47283fa067bbb80e6a66aa,1,8,5,13,1,2005-11-22 05:19:11,2005-11-22 05:19:11
1ba8bd114a487350bd47283fa067bbb80e6a66aa...bedf10a98dfe46dda39e8a20530f7476e7df90ff,3,86,1,87,7,2005-11-22 05:44:04,2005-11-22 05:44:04
bedf10a98dfe46dda39e8a20530f7476e7df90ff...57981fb2fa525f66746fdb1ecfacf66e9b425375,1,4,4,8,4,2005-11-22 05:47:51,2005-11-22 05:47:51
57981fb2fa525f66746fdb1ecfacf66e9b425375...ceecf0f7def73c79fed70b46e815dc0315b04fb5,1,2,2,4,2,2005-11-22 14:22:02,2005-11-22 14:22:02
ceecf0f7def73c79fed70b46e815dc0315b04fb5...2bb84b9c2c84a23f4011f456a74a51863b6ff8e6,1,1,1,2,1,2005-11-22 14:23:07,2005-11-22 14:23:07
2bb84b9c2c84a23f4011f456a74a51863b6ff8e6...e1b2e48a3eabad7c888ba966e4098667604595f5,1,2,2,4,2,2005-11-22 14:24:07,2005-11-22 14:24:07
e1b2e48a3eabad7c888ba966e4098667604595f5...5b662cdd863908b138e896d888a96e65d70b06cb,1,66,0,66,1,2005-11-22 19:21:51,2005-11-22 19:21:51
5b662cdd863908b138e896d888a96e65d70b06cb...b58c8205584640ca746e9cad242e6735c665c981,1,4,1,5,1,2005-11-22 19:41:09,2005-11-22 19:41:09
b58c8205584640ca746e9cad242e6735c665c981...1663623fadf80dc64a6f89826decfa2cd04a158a,1,1,1,2,1,2005-11-22 19:41:43,2005-11-22 19:41:43
1663623fadf80dc64a6f89826decfa2cd04a158a...edad9cd687086a65368a2a543c5f5e037ccfa124,2,4,4,8,4,2005-11-22 21:01:34,2005-11-22 21:01:34
edad9cd687086a65368a2a543c5f5e037ccfa124...cf84ba3b81ddafd785010893aea096576ba77042,39,2126,1358,3484,1076,2005-11-22 21:45:54,2005-11-22 21:45:54
cf84ba3b81ddafd785010893aea096576ba77042...55089cc02d728679d637ce45c1738d59e04bf88a,2,95,98,193,12,2005-11-22 22:53:02,2005-11-22 22:53:02
55089cc02d728679d637ce45c1738d59e04bf88a...d215cbd63ab4325cb632b7d570ae6827a0f139d3,4,77,62,139,46,2005-11-23 15:42:09,2005-11-23 15:42:09
d215cbd63ab4325cb632b7d570ae6827a0f139d3...6d6d90ce3350c52861e9ead920b5edee319a55c8,1,6,1,7,1,2005-11-23 16:14:24,2005-11-23 16:14:24
6d6d90ce3350c52861e9ead920b5edee319a55c8...6303141fbb1567becd4ba3e35bf347f65e22174b,1,24,24,48,2,2005-11-23 17:02:38,2005-11-23 17:02:38
6303141fbb1567becd4ba3e35bf347f65e22174b...8dc25efea8968b139e10ea8bfd7d5b21a49e8f93,38,5028,78,5106,66,2005-11-23 17:14:54,2005-11-23 17:14:54
8dc25efea8968b139e10ea8bfd7d5b21a49e8f93...0e1ae73ad7695d588083be5ac9b4bea791e994a4,2,83,14,97,12,2005-11-23 17:27:47,2005-11-23 17:27:47
0e1ae73ad7695d588083be5ac9b4bea791e994a4...87e0c2a712c9c63af81d571d0e163150575e769a,38,1398,111,1509,73,2005-11-23 17:31:52,2005-11-23 17:31:52
87e0c2a712c9c63af81d571d0e163150575e769a...fce688cc743bd77c8e415c5a7a409b5fe211e6f7,1,3,1,4,2,2005-11-23 21:13:00,2005-11-23 21:13:00
fce688cc743bd77c8e415c5a7a409b5fe211e6f7...08a494c40d33552133fbbe40116d9315c8b9560c,1,6,2,8,2,2005-11-23 21:44:48,2005-11-23 21:44:48
08a494c40d33552133fbbe40116d9315c8b9560c...cfc5786d03f3dc190f3ed1606edc3a196f16915e,1,1,0,1,1,2005-11-23 21:56:21,2005-11-23 21:56:21
cfc5786d03f3dc190f3ed1606edc3a196f16915e...5d863f1fbd26537a8bca2920bc591279d15fbdf1,10,455,240,695,61,2005-11-23 23:10:17,2005-11-23 23:10:17
5d863f1fbd26537a8bca2920bc591279d15fbdf1...21f2d842fafcc710598151d69649be67ca09adb1,1,4,2,6,4,2005-11-23 23:12:24,2005-11-23 23:12:24
21f2d842fafcc710598151d69649be67ca09adb1...39eac9bdff25078b89845d94706523fdeec0a213,1,5,5,10,3,2005-11-23 23:15:52,2005-11-23 23:15:52
39eac9bdff25078b89845d94706523fdeec0a213...140f4a69134da5524a987d2e3bd6f567911c4145,1,17,0,17,1,2005-11-23 23:29:25,2005-11-23 23:29:25
140f4a69134da5524a987d2e3bd6f567911c4145...eab4a2259657ec1193b3ea2fcdcdf3a4371397d8,1,5,4,9,2,2005-11-24 00:06:36,2005-11-24 00:06:36
eab4a2259657ec1193b3ea2fcdcdf3a4371397d8...28fd32318fda234c7788a7a6ec2049f0fbb066d7,1,2,2,4,3,2005-11-24 03:32:26,2005-11-24 03:32:26
28fd32318fda234c7788a7a6ec2049f0fbb066d7...f286461e2aed0bab1edcd8d7f42bbfcfeac74930,1,1,1,2,1,2005-11-24 05:20:27,2005-11-24 05:20:27
f286461e2aed0bab1edcd8d7f42bbfcfeac74930...834e7d348261214cead805087a0d0e03623159db,1,1,1,2,1,2005-11-24 18:30:31,2005-11-24 18:30:31
834e7d348261214cead805087a0d0e03623159db...c616d869ed72d429503003afbae9cc71343502c2,4,211,207,418,134,2005-11-24 18:31:49,2005-11-24 18:31:49
c616d869ed72d429503003afbae9cc71343502c2...22746d32a50792247330ea026e0d0ac2a0c2f933,3,12,6,18,6,2005-11-24 21:14:42,2005-11-24 21:14:42
22746d32a50792247330ea026e0d0ac2a0c2f933...d9228251562f4f37cd76da4404874483718c7728,1,43,4,47,6,2005-11-24 21:15:51,2005-11-24 21:15:51
d9228251562f4f37cd76da4404874483718c7728...827ebe53686d4fce3b37241969b717df2e864f3d,1,92,92,184,1,2005-11-24 21:26:04,2005-11-24 21:26:04
827ebe53686d4fce3b37241969b717df2e864f3d...18c7ed74e4fbdde9cb839a4031b8683053d97952,1,1,1,2,1,2005-11-24 22:41:05,2005-11-24 22:41:05
18c7ed74e4fbdde9cb839a4031b8683053d97952...f0fbd43a57b8a391915099e49c1ed3e3089331c9,1,2,3,5,2,2005-11-24 22:57:04,2005-11-24 22:57:04
f0fbd43a57b8a391915099e49c1ed3e3089331c9...798e6d5663e6505350bf32e1eca52b1428029c6c,1,1,1,2,1,2005-11-24 23:10:24,2005-11-24 23:10:24
798e6d5663e6505350bf32e1eca52b1428029c6c...73766b1f8890a90013dc16560aa7329bdfe734a3,1,1,0,1,1,2005-11-24 23:31:33,2005-11-24 23:31:33
73766b1f8890a90013dc16560aa7329bdfe734a3...eff2a1fde278e9fb5577728550cd1650e4e65c42,1,2,2,4,2,2005-11-24 23:35:28,2005-11-24 23:35:28
eff2a1fde278e9fb5577728550cd1650e4e65c42...ca683d8ca54b7579eefba8ef52ccd35b04a66b63,1,6,7,13,6,2005-11-25 00:04:06,2005-11-25 00:04:06
ca683d8ca54b7579eefba8ef52ccd35b04a66b63...84eb80bbd79af35293797fd77766513b28c8a7da,1,1,1,2,1,2005-11-25 00:20:13,2005-11-25 00:20:13
84eb80bbd79af35293797fd77766513b28c8a7da...c5e5c0fc3573f050d2db08517f88db2e16379455,1,67,0,67,1,2005-11-25 00:54:40,2005-11-25 00:54:40
c5e5c0fc3573f050d2db08517f88db2e16379455...16da4e69c40d5926087c87c6084c375860c108f6,1,8,16,24,2,2005-11-25 01:00:52,2005-11-25 01:00:52
16da4e69c40d5926087c87c6084c375860c108f6...f57e22495fb336b864c9af81bbea5e16687da086,1,7,22,29,18,2005-11-25 01:03:58,2005-11-25 01:03:58
f57e22495fb336b864c9af81bbea5e16687da086...473eabc4471df57e9bd534999a26d50aa42482c5,1,2,1,3,1,2005-11-25 01:54:17,2005-11-25 01:54:17
473eabc4471df57e9bd534999a26d50aa42482c5...baba996254ecfe0ba2fa49e5d8b6b177b20869fe,1,5,6,11,5,2005-11-25 02:18:37,2005-11-25 02:18:37
baba996254ecfe0ba2fa49e5d8b6b177b20869fe...c60e323e5d320bfdefaf89592feb681b32b384fa,1,12,4,16,4,2005-11-25 02:26:08,2005-11-25 02:26:08
c60e323e5d320bfdefaf89592feb681b32b384fa...9898c4ae02e455896c6e53a10891dc1b3a334a80,1,13,11,24,12,2005-11-25 02:32:37,2005-11-25 02:32:37
9898c4ae02e455896c6e53a10891dc1b3a334a80...807b406859653f1737865276a2bb796ab3809453,1,12,11,23,8,2005-11-25 02:37:57,2005-11-25 02:37:57
807b406859653f1737865276a2bb796ab3809453...fe15c01a1797bfdcc456196b9a556b98089e3cff,1,1,1,2,1,2005-11-25 03:15:09,2005-11-25 03:15:09
fe15c01a1797bfdcc456196b9a556b98089e3cff...3ddf250f91dd3fd03aba235fca3294fdd651bea5,1,96,0,96,1,2005-11-25 04:25:50,2005-11-25 04:25:50
3ddf250f91dd3fd03aba235fca3294fdd651bea5...69f884090056b6a0ac24591d10c9ca1a41d3280d,2,2,0,2,2,2005-11-25 04:27:50,2005-11-25 04:27:50
69f884090056b6a0ac24591d10c9ca1a41d3280d...4fe5c9b7ee09dc25921918a6dbb7605edb374bc9,1,1,1,2,1,2005-11-25 15:00:14,2005-11-25 15:00:14
4fe5c9b7ee09dc25921918a6dbb7605edb374bc9...9dda4abee1225db7a7b195b84c915fdd141a7260,30,2062,1125,3187,217,2005-11-25 21:20:09,2005-11-25 21:20:09
9dda4abee1225db7a7b195b84c915fdd141a7260...f0fceb773d100b46f0ef8b69d681c2deda15252c,38,8725,1971,10696,1089,2005-11-25 21:20:38,2005-11-25 21:20:38
f0fceb773d100b46f0ef8b69d681c2deda15252c...733e5265fe79dad220a527ebd5d023318b2c6a67,38,2679,2695,5374,1210,2005-11-25 23:25:59,2005-11-25 23:25:59
733e5265fe79dad220a527ebd5d023318b2c6a67...5ad144b29e161508faea55085dc1b4037150fc8b,1,13,0,13,1,2005-11-26 03:17:52,2005-11-26 03:17:52
5ad144b29e161508faea55085dc1b4037150fc8b...37a0c110e2982360033510894b09df2394fac985,1,1,1,2,1,2005-11-26 06:42:28,2005-11-26 06:42:28
37a0c110e2982360033510894b09df2394fac985...d058a8a104e01d76bd68443787a47a3b58a9913a,1,1,1,2,1,2005-11-26 07:02:59,2005-11-26 07:02:59
d058a8a104e01d76bd68443787a47a3b58a9913a...8128f440ee74dd72f9204f657f6180a128dc8eaf,3,29,7,36,9,2005-11-26 07:20:07,2005-11-26 07:20:07
8128f440ee74dd72f9204f657f6180a128dc8eaf...46c49a859a07dfcf61e749ed9bded48dbf343c00,6,715,1129,1844,577,2005-11-26 17:04:35,2005-11-26 17:04:35
46c49a859a07dfcf61e749ed9bded48dbf343c00...5676d5b068909a699e798575e8a6a4492ff27af8,2,3,1,4,2,2005-11-26 18:41:29,2005-11-26 18:41:29
5676d5b068909a699e798575e8a6a4492ff27af8...3ede006fc98f7e96ae9fb997872f78635576d5f8,33,785,586,1371,216,2005-11-26 22:46:31,2005-11-26 22:46:31
3ede006fc98f7e96ae9fb997872f78635576d5f8...ac91a22ec2d98675d5700acd602d68fd04b3fd86,1,1,1,2,1,2005-11-26 23:07:09,2005-11-26 23:07:09
ac91a22ec2d98675d5700acd602d68fd04b3fd86...adef71d2c4656fe4bd08a93428897048e72dae97,1,1,1,2,1,2005-11-26 23:10:09,2005-11-26 23:10:09
adef71d2c4656fe4bd08a93428897048e72dae97...c83fa9439146d48fbe316ca977e9fba6e23c7bff,1,1,1,2,1,2005-11-26 23:11:19,2005-11-26 23:11:19
c83fa9439146d48fbe316ca977e9fba6e23c7bff...53330a9274a395cd5397fa4a751299c55e4b1e4e,1,1,1,2,1,2005-11-27 00:01:11,2005-11-27 00:01:11
53330a9274a395cd5397fa4a751299c55e4b1e4e...0e9081e6de2b5b7af1eef2aecd788d5b7438841d,1,1,2,3,1,2005-11-27 00:26:16,2005-11-27 00:26:16
0e9081e6de2b5b7af1eef2aecd788d5b7438841d...fc102791d8585c28040589e10d864550338919fd,1,1,1,2,1,2005-11-27 01:55:55,2005-11-27 01:55:55
fc102791d8585c28040589e10d864550338919fd...515ae9c1289d9bbe447e0dad196e8c35d9724804,1,2,3,5,3,2005-11-27 07:28:51,2005-11-27 07:28:51
515ae9c1289d9bbe447e0dad196e8c35d9724804...a2527ebe7798345e450432776b2b912d02320f2a,1,9,0,9,1,2005-11-27 13:53:35,2005-11-27 13:53:35
a2527ebe7798345e450432776b2b912d02320f2a...0cb2a0036957b36f3378f73979346238ce490f10,1,1,0,1,1,2005-11-27 14:07:04,2005-11-27 14:07:04
0cb2a0036957b36f3378f73979346238ce490f10...501b06c7b497008272ce15e47224cca982d529f2,1,29,17,46,8,2005-11-27 14:35:18,2005-11-27 14:35:18
501b06c7b497008272ce15e47224cca982d529f2...c0700db1a32d069fd84e9267e0664144b2af20db,1,81,0,81,1,2005-11-27 14:42:21,2005-11-27 14:42:21
c0700db1a32d069fd84e9267e0664144b2af20db...5e0be518f8c9dee930f755d55ef4c7e8db6d6974,1,5,0,5,1,2005-11-27 14:49:57,2005-11-27 14:49:57
5e0be518f8c9dee930f755d55ef4c7e8db6d6974...c8e98f4cdddaf4ca82a0c02581d036d6ddf1a614,1,1,1,2,1,2005-11-27 14:52:12,2005-11-27 14:52:12
c8e98f4cdddaf4ca82a0c02581d036d6ddf1a614...ed97929b91c899fd880460e228d7c2622213980b,1,39,0,39,2,2005-11-27 15:28:19,2005-11-27 15:28:19
ed97929b91c899fd880460e228d7c2622213980b...f1641be02de1efec5bc8766a64a011bf4b79f974,1,1,1,2,1,2005-11-27 15:32:18,2005-11-27 15:32:18
f1641be02de1efec5bc8766a64a011bf4b79f974...5c49a1e39131e50f2b769e336d0a8e1eb1455714,2,142,240,382,77,2005-11-27 15:43:14,2005-11-27 15:43:14
5c49a1e39131e50f2b769e336d0a8e1eb1455714...2564f34c2b0a9ef70bf7079ff157a6d2c90fe3d8,1,1,1,2,1,2005-11-27 16:10:49,2005-11-27 16:10:49
2564f34c2b0a9ef70bf7079ff157a6d2c90fe3d8...2fb95f1de699fbc3c39ac83dbf5fabb63af96642,2,9,12,21,4,2005-11-27 16:43:56,2005-11-27 16:43:56
2fb95f1de699fbc3c39ac83dbf5fabb63af96642...f237936a8709fcfa0bfa9c0c4e3891d49f0e7cd7,2,64,82,146,19,2005-11-27 17:14:11,2005-11-27 17:14:11
f237936a8709fcfa0bfa9c0c4e3891d49f0e7cd7...2e7e19e0f2571a0514b7201c80fdd3bc4c648dbd,3,30,30,60,24,2005-11-27 17:20:43,2005-11-27 17:20:43
2e7e19e0f2571a0514b7201c80fdd3bc4c648dbd...7ff2c879c33b7088d5d458e32cfcc639a1475196,2,325,441,766,193,2005-11-27 18:17:16,2005-11-27 18:17:16
7ff2c879c33b7088d5d458e32cfcc639a1475196...1bd85787ecacc587073d64bb7a922e0aad7a604e,1,13,12,25,3,2005-11-27 19:28:38,2005-11-27 19:28:38
1bd85787ecacc587073d64bb7a922e0aad7a604e...3cf5d034dbee58ed862fa00a9b148bede61c4657,1,1,1,2,1,2005-11-27 19:38:07,2005-11-27 19:38:07
3cf5d034dbee58ed862fa00a9b148bede61c4657...4cdaf74cec3ef1192b5bd71b56d0ec11810f8fdf,1,1,1,2,2,2005-11-27 20:22:42,2005-11-27 20:22:42
4cdaf74cec3ef1192b5bd71b56d0ec11810f8fdf...6a36699818e9c90edc0acfdb026522dcf913ba58,2,9,10,19,4,2005-11-27 20:25:56,2005-11-27 20:25:56
6a36699818e9c90edc0acfdb026522dcf913ba58...8c3b41c3e90f6462c7f2142243c7e3e62169683f,1,0,3,3,1,2005-11-27 21:37:41,2005-11-27 21:37:41
8c3b41c3e90f6462c7f2142243c7e3e62169683f...cc3660c07da01965870c3183e740f0694fcf0809,4,20,11,31,10,2005-11-27 22:08:51,2005-11-27 22:08:51
cc3660c07da01965870c3183e740f0694fcf0809...f1eff69a4f89905e9b36a83b1825a3a2c4454899,2,74,14,88,10,2005-11-27 23:03:56,2005-11-27 23:03:56
f1eff69a4f89905e9b36a83b1825a3a2c4454899...7548bfba642a865a9dd05957d0e520c75c9e881f,1,1,1,2,1,2005-11-27 23:16:26,2005-11-27 23:16:26
7548bfba642a865a9dd05957d0e520c75c9e881f...5de6fe1b2d5afb0a210f3aa52fd21ad3e4f8a8f8,1,1,0,1,1,2005-11-27 23:43:35,2005-11-27 23:43:35
5de6fe1b2d5afb0a210f3aa52fd21ad3e4f8a8f8...e85b071e47a8b25d47d7dfbb3b006030a1d09d87,3,31,11,42,11,2005-11-28 02:57:38,2005-11-28 02:57:38
e85b071e47a8b25d47d7dfbb3b006030a1d09d87...bcc02c982f8cf0a49e3927c4adda2aaa1072bc6a,39,2259,1543,3802,1192,2005-11-28 10:29:41,2005-11-28 10:29:41
bcc02c982f8cf0a49e3927c4adda2aaa1072bc6a...79e710b4df92b4b3384c6d0eb741d7064cee9bdc,2,137,240,377,76,2005-11-28 11:06:21,2005-11-28 11:06:21
79e710b4df92b4b3384c6d0eb741d7064cee9bdc...133839b0337177816fc40c9a9abd4151f51b6030,1,7,3,10,1,2005-11-28 14:23:02,2005-11-28 14:23:02
133839b0337177816fc40c9a9abd4151f51b6030...496e777da974e6496a9e0f896825e314f72d59b6,1,3,3,6,3,2005-11-28 14:26:04,2005-11-28 14:26:04
496e777da974e6496a9e0f896825e314f72d59b6...2e09e145c0d5e806fa490b1bd2b198837f7965ff,1,2,2,4,2,2005-11-28 14:28:21,2005-11-28 14:28:21
2e09e145c0d5e806fa490b1bd2b198837f7965ff...1ee5982b2c2d353c74e73a84d80638a94035a45c,1,304,0,304,1,2005-11-28 15:30:21,2005-11-28 15:30:21
1ee5982b2c2d353c74e73a84d80638a94035a45c...9e3efbecf801b90ce73009d86fea03d5c1788f37,1,4,0,4,1,2005-11-28 20:48:08,2005-11-28 20:48:08
9e3efbecf801b90ce73009d86fea03d5c1788f37...e9193a79fd180057848af3165ad9cf15921d4406,1,74,54,128,47,2005-11-29 00:24:34,2005-11-29 00:24:34
e9193a79fd180057848af3165ad9cf15921d4406...539e5af17cce18b1e09f485f4acf5c5a2a6a6279,1,12,3,15,4,2005-11-29 01:04:28,2005-11-29 01:04:28
539e5af17cce18b1e09f485f4acf5c5a2a6a6279...de7a336486f83dd9c01b8c2fd3feb014da7f5a49,8,32,8,40,10,2005-11-29 02:05:32,2005-11-29 02:05:32
de7a336486f83dd9c01b8c2fd3feb014da7f5a49...1ce5ef6166d07f3858308eea44a9821c12b9cc66,2,7,3,10,2,2005-11-29 05:22:51,2005-11-29 05:22:51
1ce5ef6166d07f3858308eea44a9821c12b9cc66...467d82c16cdfd1b0ef0c78c431f47f5ea31d78f2,1,1,1,2,1,2005-11-29 05:50:07,2005-11-29 05:50:07
467d82c16cdfd1b0ef0c78c431f47f5ea31d78f2...5a54455ac8585920b4ded4b7191c6496e46fc2d7,1,2,2,4,2,2005-11-29 05:50:31,2005-11-29 05:50:31
5a54455ac8585920b4ded4b7191c6496e46fc2d7...29d1598cce7f3b2abd8b2de1df0f9160523d693b,1,2,0,2,1,2005-11-29 05:53:05,2005-11-29 05:53:05
29d1598cce7f3b2abd8b2de1df0f9160523d693b...2af63d3aab0b8f6fa18077aa62b931928864595b,1,6,7,13,6,2005-11-29 05:54:56,2005-11-29 05:54:56
2af63d3aab0b8f6fa18077aa62b931928864595b...3373447fba5e2d51d5fb2ef70519a9abc2ca7f65,1,3,3,6,3,2005-11-29 14:43:07,2005-11-29 14:43:07
3373447fba5e2d51d5fb2ef70519a9abc2ca7f65...568a9264528d45b9fa2136a98f7b766c5e10152b,1,2,2,4,1,2005-11-29 15:30:06,2005-11-29 15:30:06
568a9264528d45b9fa2136a98f7b766c5e10152b...397fc995cd9de1097259521925682d4e87b54d39,1,1,0,1,1,2005-11-29 17:03:16,2005-11-29 17:03:16
397fc995cd9de1097259521925682d4e87b54d39...c336c8c6b93da48c6b17873193ccbc9a2b028659,1,1,0,1,1,2005-11-29 17:06:35,2005-11-29 17:06:35
c336c8c6b93da48c6b17873193ccbc9a2b028659...e1b107b19299bf06e8c9ea4115fe0e89263d4a4c,1,1,1,2,1,2005-11-29 17:09:43,2005-11-29 17:09:43
e1b107b19299bf06e8c9ea4115fe0e89263d4a4c...ae76186a4f86c1e5a687f58bfa54166a0dde6a93,2,105,0,105,2,2005-11-29 18:26:07,2005-11-29 18:26:07
ae76186a4f86c1e5a687f58bfa54166a0dde6a93...289119563e5622ee42368177f7e97a1861a66aac,1,1,1,2,1,2005-11-29 18:27:35,2005-11-29 18:27:35
289119563e5622ee42368177f7e97a1861a66aac...e2e98aff6a58a497f66a473b3fad9ed99e4cb755,1,3,2,5,3,2005-11-30 00:08:56,2005-11-30 00:08:56
e2e98aff6a58a497f66a473b3fad9ed99e4cb755...674ac13ca6cf99a902d75e2fad5748570b0aa913,2,9,2,11,4,2005-11-30 00:19:15,2005-11-30 00:19:15
674ac13ca6cf99a902d75e2fad5748570b0aa913...5066fe528c0797af2d6d12ab49d39c7735e9b05f,1,0,0,0,0,2005-11-30 01:09:47,2005-11-30 01:09:47
5066fe528c0797af2d6d12ab49d39c7735e9b05f...3cb20c45c73c003e4f8417ea44bf8c7d9ec6bd27,4,57,56,113,15,2005-11-30 01:14:23,2005-11-30 01:14:23
3cb20c45c73c003e4f8417ea44bf8c7d9ec6bd27...804154b9e00e1789cdfed97f3619a146a1da1d5d,1,5,5,10,4,2005-11-30 02:35:06,2005-11-30 02:35:06
804154b9e00e1789cdfed97f3619a146a1da1d5d...0ecdad8593356086ccb9365323e0718337bb2b18,1,6,4,10,2,2005-11-30 02:36:26,2005-11-30 02:36:26
0ecdad8593356086ccb9365323e0718337bb2b18...991bb6124206a503545f5963e5048af45b1751eb,6,515,119,634,48,2005-11-30 04:08:46,2005-11-30 04:08:46
991bb6124206a503545f5963e5048af45b1751eb...d89f0411392692d4b69f613d053a2affe30acec6,1,1,1,2,1,2005-11-30 04:13:21,2005-11-30 04:13:21
d89f0411392692d4b69f613d053a2affe30acec6...1f611288c655c548bd58d4a7861bb829ebf598c9,1,1,1,2,1,2005-11-30 04:15:36,2005-11-30 04:15:36
1f611288c655c548bd58d4a7861bb829ebf598c9...837435a08aaf35696e3adb4ece2229638f82da48,1,1,1,2,1,2005-11-30 05:34:51,2005-11-30 05:34:51
837435a08aaf35696e3adb4ece2229638f82da48...9541d7a7c70df6be8c8673789437c717b884e039,5,182,8,190,9,2005-11-30 06:14:05,2005-11-30 06:14:05
9541d7a7c70df6be8c8673789437c717b884e039...0c5cf18e1d6bc8d24b724e9fc779f4ecf8ca46d1,1,1,0,1,1,2005-11-30 20:02:45,2005-11-30 20:02:45
0c5cf18e1d6bc8d24b724e9fc779f4ecf8ca46d1...bf0f6ec3b490fb0a9a44881f7151b3afb4ab4733,2,20,8,28,6,2005-11-30 22:03:50,2005-11-30 22:03:50
bf0f6ec3b490fb0a9a44881f7151b3afb4ab4733...c28daf228948a04d15f30e5861a659eb8171f73f,3,14,3,17,5,2005-12-01 03:06:30,2005-12-01 03:06:30
c28daf228948a04d15f30e5861a659eb8171f73f...e0f0532305a132b1c13b87d57f3b26c1d5f2be16,1,3,3,6,1,2005-12-01 05:28:05,2005-12-01 05:28:05
e0f0532305a132b1c13b87d57f3b26c1d5f2be16...9e2eccc1ab06e831f586e002915c00d90206b59b,1,7,0,7,1,2005-12-01 05:46:18,2005-12-01 05:46:18
9e2eccc1ab06e831f586e002915c00d90206b59b...9abc0120035be34f56c57f7d6d5989798f693d45,1,10,7,17,2,2005-12-01 06:01:13,2005-12-01 06:01:13
9abc0120035be34f56c57f7d6d5989798f693d45...fa9cbe5ea01cbb82efdb2780c8381189b294f39c,2,100,1,101,2,2005-12-01 06:01:46,2005-12-01 06:01:46
fa9cbe5ea01cbb82efdb2780c8381189b294f39c...a58dc0dbbdb4d482d26650f4a72ffb08ef1184cf,1,3,7,10,1,2005-12-01 06:02:45,2005-12-01 06:02:45
a58dc0dbbdb4d482d26650f4a72ffb08ef1184cf...38b8d180917ec4eaf3f12618d9114e08e3fad586,1,3,0,3,1,2005-12-01 06:09:36,2005-12-01 06:09:36
38b8d180917ec4eaf3f12618d9114e08e3fad586...9ede371c85a97406eecb19974ab01163839636a0,3,46,5,51,4,2005-12-01 06:32:25,2005-12-01 06:32:25
9ede371c85a97406eecb19974ab01163839636a0...3bf29d21847ae4d32f7a1d6ec2f205ef3a58efc1,2,31,27,58,24,2005-12-01 06:36:47,2005-12-01 06:36:47
3bf29d21847ae4d32f7a1d6ec2f205ef3a58efc1...e7e991e86b9f4a3e4e89bcbc08dec32606538250,1,3,2,5,1,2005-12-01 06:39:39,2005-12-01 06:39:39
e7e991e86b9f4a3e4e89bcbc08dec32606538250...15ea158c967089e2ff0bd3efd3839f51b281f50e,16,25,30,55,35,2005-12-01 06:52:16,2005-12-01 06:52:16
15ea158c967089e2ff0bd3efd3839f51b281f50e...b5288e732c7a0c26034fa7a630939578551f6638,2,6,4,10,5,2005-12-01 07:03:23,2005-12-01 07:03:23
b5288e732c7a0c26034fa7a630939578551f6638...f920559cdac5d5ab745b3bed8b92f3391bcf5a0e,6,878,927,1805,776,2005-12-01 10:40:07,2005-12-01 10:40:07
f920559cdac5d5ab745b3bed8b92f3391bcf5a0e...c75b1e2b8269291d79324a360cd42c4e2bb04aa0,2,226,187,413,61,2005-12-01 14:57:54,2005-12-01 14:57:54
c75b1e2b8269291d79324a360cd42c4e2bb04aa0...2863e09f2e4a6376ffb6142e51cb5e8e24cfa75d,1,1,1,2,1,2005-12-01 20:27:34,2005-12-01 20:27:34
2863e09f2e4a6376ffb6142e51cb5e8e24cfa75d...027c47b9b4f88f83ec06a968e3c9264e6f878f74,2,6,3,9,3,2005-12-02 20:58:35,2005-12-02 20:58:35
027c47b9b4f88f83ec06a968e3c9264e6f878f74...90ff261fbc4b80841bde7a5b7aeaf26fb794f904,1,3,3,6,3,2005-12-03 19:04:31,2005-12-03 19:04:31
90ff261fbc4b80841bde7a5b7aeaf26fb794f904...946bd1e370148efe6ae2da493f000373fa6a35a7,1,3,3,6,3,2005-12-03 22:53:33,2005-12-03 22:53:33
946bd1e370148efe6ae2da493f000373fa6a35a7...5917fdcf2d07e54e7d83076b26e22bcadf65eb54,4,243,15,258,12,2005-12-04 12:06:16,2005-12-04 12:06:16
5917fdcf2d07e54e7d83076b26e22bcadf65eb54...a841530a13cdd409828dcfc9ccd10711b1f46997,10,246,79,325,71,2005-12-04 12:30:14,2005-12-04 12:30:14
a841530a13cdd409828dcfc9ccd10711b1f46997...eaed1a7ddba136f07a5128cae96f6e667f4cb21b,1,1,0,1,1,2005-12-04 12:57:46,2005-12-04 12:57:46
eaed1a7ddba136f07a5128cae96f6e667f4cb21b...f33cc0163de71816393246c37fd2fd178271a876,1,97,7,104,3,2005-12-04 13:08:37,2005-12-04 13:08:37
f33cc0163de71816393246c37fd2fd178271a876...77e8f50633923cddbf23e1a8815fa53d2439304d,2,62,0,62,1,2005-12-04 13:47:13,2005-12-04 13:47:13
77e8f50633923cddbf23e1a8815fa53d2439304d...4ef077c593de06e94694db9d65b6545ba43885d7,7,90,3,93,8,2005-12-04 13:48:50,2005-12-04 13:48:50
4ef077c593de06e94694db9d65b6545ba43885d7...7dbff908b57f0f1ba30185c6b480fd6f41b3d64a,38,2429,1465,3894,1080,2005-12-04 13:53:26,2005-12-04 13:53:26
7dbff908b57f0f1ba30185c6b480fd6f41b3d64a...4ed3d57184169541f0ba55549759769020827bf8,1,45,39,84,1,2005-12-04 14:04:56,2005-12-04 14:04:56
4ed3d57184169541f0ba55549759769020827bf8...4040b99b5c1330fc80990f11edb3a23815b64304,2,107,160,267,63,2005-12-04 14:12:12,2005-12-04 14:12:12
4040b99b5c1330fc80990f11edb3a23815b64304...2565d41fb51a82e3a966049eb1f7af7d4837ec6b,4,1089,1108,2197,244,2005-12-04 15:25:19,2005-12-04 15:25:19
2565d41fb51a82e3a966049eb1f7af7d4837ec6b...9cdcef97e11e96a62a801e2a1fb7e051f5252b20,11,59,7,66,11,2005-12-04 16:24:42,2005-12-04 16:24:42
9cdcef97e11e96a62a801e2a1fb7e051f5252b20...e19edfbea0801e5217e2b1c97317008975b0f3b2,1,1,1,2,1,2005-12-04 18:12:16,2005-12-04 18:12:16
e19edfbea0801e5217e2b1c97317008975b0f3b2...c464e57da93ffd62261317abfb7a36ec23ddab64,6,42,72,114,8,2005-12-04 18:54:44,2005-12-04 18:54:44
c464e57da93ffd62261317abfb7a36ec23ddab64...91bd17eb852110f37033a0153f1b025ef738b79b,4,211,164,375,162,2005-12-04 19:33:37,2005-12-04 19:33:37
91bd17eb852110f37033a0153f1b025ef738b79b...36c5ea7b065058daf0fef719e31a822497e6b3a2,1,48,40,88,12,2005-12-04 19:50:12,2005-12-04 19:50:12
36c5ea7b065058daf0fef719e31a822497e6b3a2...74d69af4e9113dc34528871ea353136b2d538f9b,2,3,3,6,3,2005-12-04 20:53:16,2005-12-04 20:53:16
74d69af4e9113dc34528871ea353136b2d538f9b...027f2a378a836d828347f3d295cae4f83a9cad71,1,6,0,6,1,2005-12-05 03:34:35,2005-12-05 03:34:35
027f2a378a836d828347f3d295cae4f83a9cad71...65c1a9f1c95670425334af0750ada2ae878d33fc,1,4,0,4,1,2005-12-05 03:37:23,2005-12-05 03:37:23
65c1a9f1c95670425334af0750ada2ae878d33fc...3cd7755ec6b421c8ac4ef8903be9781ba015b3ab,1,4,0,4,2,2005-12-05 03:39:18,2005-12-05 03:39:18
3cd7755ec6b421c8ac4ef8903be9781ba015b3ab...79be9b2e7d5e369a6bdb6f807d87529434731fb9,1,6,3,9,3,2005-12-05 15:25:55,2005-12-05 15:25:55
79be9b2e7d5e369a6bdb6f807d87529434731fb9...9aa12357792791c8529a32046362029e5f677a6e,4,202,224,426,74,2005-12-05 16:28:29,2005-12-05 16:28:29
9aa12357792791c8529a32046362029e5f677a6e...00203265209f081baab391213280917cd1f160e6,1,2,2,4,2,2005-12-05 17:40:19,2005-12-05 17:40:19
00203265209f081baab391213280917cd1f160e6...54618dc0fe7338d7fea7a893ef1b418780b045ad,1,5,2,7,2,2005-12-06 04:55:33,2005-12-06 04:55:33
54618dc0fe7338d7fea7a893ef1b418780b045ad...85c369001b750909e616470cb853ceb2301fd71a,1,21,11,32,5,2005-12-06 05:04:56,2005-12-06 05:04:56
85c369001b750909e616470cb853ceb2301fd71a...6d210ef40341b26aa2881fbb82ef7a7cdd54a3df,2,155,150,305,6,2005-12-06 05:17:52,2005-12-06 05:17:52
6d210ef40341b26aa2881fbb82ef7a7cdd54a3df...50cac9d276471abc330efdba5d101c78d44928bc,1,15,15,30,15,2005-12-06 05:35:07,2005-12-06 05:35:07
50cac9d276471abc330efdba5d101c78d44928bc...17108bc1903efa5e3e10f709f98746bc1031b220,1,1,1,2,1,2005-12-06 05:38:56,2005-12-06 05:38:56
17108bc1903efa5e3e10f709f98746bc1031b220...28263d66755343b164604667e16e0da3ff9c6f1a,2,31,0,31,2,2005-12-06 05:53:31,2005-12-06 05:53:31
28263d66755343b164604667e16e0da3ff9c6f1a...7119514fedfd97c2245d3b351bef2c2223d28ed3,2,72,0,72,1,2005-12-06 16:49:55,2005-12-06 16:49:55
7119514fedfd97c2245d3b351bef2c2223d28ed3...f9941eca030c646dd450e432f7bb0b3ed4966bc1,2,163,164,327,42,2005-12-06 17:59:52,2005-12-06 17:59:52
f9941eca030c646dd450e432f7bb0b3ed4966bc1...631d127bd265bdacdce46ccc6dffa08f88736f78,17,69,18,87,28,2005-12-06 20:30:20,2005-12-06 20:30:20
631d127bd265bdacdce46ccc6dffa08f88736f78...48b67fe4bbf6911b0b91cc73eff091f46e565c38,1,17,10,27,3,2005-12-06 20:30:56,2005-12-06 20:30:56
48b67fe4bbf6911b0b91cc73eff091f46e565c38...cef2ffd7e1f209f0955948143a5cc981b5af4f9f,2,2,2,4,2,2005-12-06 23:18:12,2005-12-06 23:18:12
cef2ffd7e1f209f0955948143a5cc981b5af4f9f...4ed33777beee2f01bdc7e6093f8f80175bf35cb2,2,9,7,16,8,2005-12-07 05:04:07,2005-12-07 05:04:07
4ed33777beee2f01bdc7e6093f8f80175bf35cb2...7106c68e598e0f2ad2036249122222f1adb3b2d1,1,6,4,10,2,2005-12-07 05:11:19,2005-12-07 05:11:19
7106c68e598e0f2ad2036249122222f1adb3b2d1...374a6eaa4c7cb412d908960b193d162ad5b00060,1,1,1,2,1,2005-12-07 05:13:18,2005-12-07 05:13:18
374a6eaa4c7cb412d908960b193d162ad5b00060...668e8b3df933b7ed979c23d48233d59be595f734,1,88,36,124,11,2005-12-07 06:02:09,2005-12-07 06:02:09
668e8b3df933b7ed979c23d48233d59be595f734...9832abf6b49af4dcefc1926461d456cc5051a81e,1,1,1,2,1,2005-12-07 23:36:31,2005-12-07 23:36:31
9832abf6b49af4dcefc1926461d456cc5051a81e...6e13e6556822d7716c94263ffc31251559fb8b04,2,9,9,18,9,2005-12-08 08:44:58,2005-12-08 08:44:58
6e13e6556822d7716c94263ffc31251559fb8b04...4aedb7386a897577a6362fcb0de0f6a8943d3085,4,110,20,130,22,2005-12-08 15:15:10,2005-12-08 15:15:10
4aedb7386a897577a6362fcb0de0f6a8943d3085...36f1aef5ff05270462afcc54caddf82f7c4dbbfa,1,5,5,10,3,2005-12-09 01:46:14,2005-12-09 01:46:14
36f1aef5ff05270462afcc54caddf82f7c4dbbfa...8da17bacf337117b1912fe12ce591a25a7e56021,1,19,0,19,1,2005-12-09 01:53:30,2005-12-09 01:53:30
8da17bacf337117b1912fe12ce591a25a7e56021...b625153b49bf09c36caf9e4a75b0125092d8da56,1,4,8,12,1,2005-12-09 01:55:53,2005-12-09 01:55:53
b625153b49bf09c36caf9e4a75b0125092d8da56...cecd2951879b31e32210218776f8459e4f90c07a,1,1,1,2,1,2005-12-09 02:15:23,2005-12-09 02:15:23
cecd2951879b31e32210218776f8459e4f90c07a...9e2b463bafa54f14764c6deef9e182d15c1f7df4,1,3,3,6,3,2005-12-09 02:15:54,2005-12-09 02:15:54
9e2b463bafa54f14764c6deef9e182d15c1f7df4...dc2daff31f672a0129b0ed75e47cd4b1f8656aeb,1,3,3,6,1,2005-12-09 02:16:17,2005-12-09 02:16:17
dc2daff31f672a0129b0ed75e47cd4b1f8656aeb...58220b17d64e761b2d7195417688f90a5724fb44,1,9,5,14,2,2005-12-09 02:25:17,2005-12-09 02:25:17
58220b17d64e761b2d7195417688f90a5724fb44...661613e52969c63a5c2fcca79e30d5b23bc9e100,1,1,1,2,1,2005-12-09 02:29:56,2005-12-09 02:29:56
661613e52969c63a5c2fcca79e30d5b23bc9e100...99f0f414d5ff74aa24355ad4d4cff5a4110e51df,2,4,1,5,3,2005-12-09 02:32:59,2005-12-09 02:32:59
99f0f414d5ff74aa24355ad4d4cff5a4110e51df...d06a12406bb921ce58e9dd37989a8b584640a1d3,2,2,0,2,2,2005-12-09 02:35:38,2005-12-09 02:35:38
d06a12406bb921ce58e9dd37989a8b584640a1d3...f6b90c8c2a8f1b3cea7bf9addbb041d3f1667511,2,5,4,9,5,2005-12-09 02:52:27,2005-12-09 02:52:27
f6b90c8c2a8f1b3cea7bf9addbb041d3f1667511...a8b3d67b7a1b54c12b5b0e07b3d47e0fbed9cf9e,1,1,1,2,1,2005-12-09 03:00:57,2005-12-09 03:00:57
a8b3d67b7a1b54c12b5b0e07b3d47e0fbed9cf9e...5fe45cb0f851ea083c1e25664ded93432a62ab05,2,9,6,15,4,2005-12-09 03:08:51,2005-12-09 03:08:51
5fe45cb0f851ea083c1e25664ded93432a62ab05...7d0bcc57275c6e80cc9bdac8cf0e8c8c00e58659,1,1,1,2,1,2005-12-09 03:30:07,2005-12-09 03:30:07
7d0bcc57275c6e80cc9bdac8cf0e8c8c00e58659...06a2dc42b2aad23550e378b6a4dd65bd930133a3,1,2,2,4,1,2005-12-09 03:32:45,2005-12-09 03:32:45
06a2dc42b2aad23550e378b6a4dd65bd930133a3...e6745d34202d02bc48b2c9f133f389cf8a4cddb3,3,5,9,14,5,2005-12-09 03:39:31,2005-12-09 03:39:31
e6745d34202d02bc48b2c9f133f389cf8a4cddb3...4e7006856d76e11b68233e7a846df0ae4d10170c,2,2,2,4,2,2005-12-09 03:40:27,2005-12-09 03:40:27
4e7006856d76e11b68233e7a846df0ae4d10170c...63cf85b64d3cb84e151f1994a6116c17deaefb33,3,24,18,42,2,2005-12-09 04:29:20,2005-12-09 04:29:20
63cf85b64d3cb84e151f1994a6116c17deaefb33...634209ce8e98bbe76e71962da58279f7b0daaf36,41,2146,1874,4020,787,2005-12-09 10:46:44,2005-12-09 10:46:44
634209ce8e98bbe76e71962da58279f7b0daaf36...81365bb9ef1d36a4c2df5bd2e6df5bf2115f4f1f,18,256,9,265,17,2005-12-09 10:48:42,2005-12-09 10:48:42
81365bb9ef1d36a4c2df5bd2e6df5bf2115f4f1f...f60d4eec38f731135a07fa9a892d7ebdb2046e20,2,7,7,14,7,2005-12-09 23:54:51,2005-12-09 23:54:51
f60d4eec38f731135a07fa9a892d7ebdb2046e20...800cac7e3180858bcd3c2ecf467c4d2497a0eea4,2,8,7,15,8,2005-12-10 05:32:05,2005-12-10 05:32:05
800cac7e3180858bcd3c2ecf467c4d2497a0eea4...043215d9b1c2d074045935b5abbecfae497018cf,2,128,180,308,80,2005-12-10 09:32:51,2005-12-10 09:32:51
043215d9b1c2d074045935b5abbecfae497018cf...7163a012b2c3978cb9eb148544c772ea5abecaa5,1,0,0,0,0,2005-12-12 16:49:55,2005-12-12 16:49:55
7163a012b2c3978cb9eb148544c772ea5abecaa5...26c8aabd1ba49648d91a7aca73e19b4068b48b2f,1,0,0,0,0,2005-12-12 16:50:20,2005-12-12 16:50:20
26c8aabd1ba49648d91a7aca73e19b4068b48b2f...5c5bdddede5dd7498ab9fb23fc7dd8549ebb44ad,1,0,44,44,1,2005-12-14 04:55:32,2005-12-14 04:55:32
5c5bdddede5dd7498ab9fb23fc7dd8549ebb44ad...9fe3ac132222343d058975f81a9a3c810a63cc20,4,59,59,118,55,2005-12-14 16:21:44,2005-12-14 16:21:44
9fe3ac132222343d058975f81a9a3c810a63cc20...328836208cd64826ebfe5bbca03ba43521664c85,39,3060,2911,5971,619,2005-12-14 16:30:40,2005-12-14 16:30:40
328836208cd64826ebfe5bbca03ba43521664c85...e6256ac6149c22e3903011ea5dddfbc301489f84,1,0,0,0,0,2005-12-15 00:33:52,2005-12-15 00:33:52
e6256ac6149c22e3903011ea5dddfbc301489f84...bf49a1a8f4f50eba9132f190fb5e90df0557cd7b,1,0,0,0,0,2005-12-15 00:34:54,2005-12-15 00:34:54
bf49a1a8f4f50eba9132f190fb5e90df0557cd7b...2b50cb8c120d5f4add098fea8ea6fe49ed67dacf,1,1,0,1,1,2005-12-15 03:23:37,2005-12-15 03:23:37
2b50cb8c120d5f4add098fea8ea6fe49ed67dacf...3c4c6e0f965f4523089c4700c4d2219902c803f0,1,6,3,9,4,2005-12-15 15:56:26,2005-12-15 15:56:26
3c4c6e0f965f4523089c4700c4d2219902c803f0...6c6feb482a39644e9b367616f61f033624221018,1,1,1,2,1,2005-12-15 20:18:04,2005-12-15 20:18:04
6c6feb482a39644e9b367616f61f033624221018...0c6653cf0397423b089b9c0b68c659889316ae00,1,12,0,12,1,2005-12-15 23:44:33,2005-12-15 23:44:33
0c6653cf0397423b089b9c0b68c659889316ae00...5cbbd364c3db2b72b8b0698d5321ce23a435c1d2,3,14,13,27,13,2005-12-16 04:54:18,2005-12-16 04:54:18
5cbbd364c3db2b72b8b0698d5321ce23a435c1d2...f2e538281175af1618bae6f2312faa0fd6dde7d9,1,1,1,2,1,2005-12-16 04:55:52,2005-12-16 04:55:52
f2e538281175af1618bae6f2312faa0fd6dde7d9...551897b13446426a2533dafdbd2ea2bc4f96b1e5,1,9,6,15,5,2005-12-16 04:59:35,2005-12-16 04:59:35
551897b13446426a2533dafdbd2ea2bc4f96b1e5...676830165ad168de513bf19e12027e0f71b02a3c,3,3,3,6,3,2005-12-16 05:13:25,2005-12-16 05:13:25
676830165ad168de513bf19e12027e0f71b02a3c...e296de5500dd95cff52e70e0c4229134e0e49f7e,2,22,2,24,3,2005-12-16 05:33:24,2005-12-16 05:33:24
e296de5500dd95cff52e70e0c4229134e0e49f7e...3235f0298ae1c92f625c76922e66b9a0ad5aa3b1,1,2,1,3,2,2005-12-17 19:32:15,2005-12-17 19:32:15
3235f0298ae1c92f625c76922e66b9a0ad5aa3b1...787dea30c1f2081e6f831b4b33036644fa93d2a6,39,2861,2692,5553,419,2005-12-17 21:27:54,2005-12-17 21:27:54
787dea30c1f2081e6f831b4b33036644fa93d2a6...e0acc619e8bdd85d8f37659f77273253df3721bf,2,138,242,380,78,2005-12-18 18:16:00,2005-12-18 18:16:00
e0acc619e8bdd85d8f37659f77273253df3721bf...3a11722860b2dee7ea559588cd41a4f4dc613179,1,1,1,2,1,2005-12-19 03:31:08,2005-12-19 03:31:08
3a11722860b2dee7ea559588cd41a4f4dc613179...0359a18dfd6676956a3406c6dbd2623a6030b43f,4,114,4,118,5,2005-12-19 08:24:21,2005-12-19 08:24:21
0359a18dfd6676956a3406c6dbd2623a6030b43f...bf5e5163c5a4632815d574ec6dc332cc3f44852a,2,186,46,232,108,2005-12-19 21:29:24,2005-12-19 21:29:24
bf5e5163c5a4632815d574ec6dc332cc3f44852a...36a7d90ab2a8785fbe74b1aa7cf3d58f3d4b279e,2,13,13,26,13,2005-12-20 10:44:43,2005-12-20 10:44:43
36a7d90ab2a8785fbe74b1aa7cf3d58f3d4b279e...909cf0822f090ef71fb26bd89cb000f98b5ba9fe,2,2,2,4,2,2005-12-20 15:53:01,2005-12-20 15:53:01
909cf0822f090ef71fb26bd89cb000f98b5ba9fe...f16033ed91c15056a124b5d970c720f47e8dd82f,1,3,3,6,2,2005-12-20 22:24:45,2005-12-20 22:24:45
f16033ed91c15056a124b5d970c720f47e8dd82f...d971b31695f6f1f1be86d97935119061bf167862,1,3,2,5,1,2005-12-21 03:37:31,2005-12-21 03:37:31
d971b31695f6f1f1be86d97935119061bf167862...7ce1d7d0986bbf2cd7a9570b227708d1c7697968,1,18,0,18,1,2005-12-21 05:43:58,2005-12-21 05:43:58
7ce1d7d0986bbf2cd7a9570b227708d1c7697968...c4b543ff4619f4a643ff5b8df341f525e73b586b,1,10,3,13,2,2005-12-21 05:47:17,2005-12-21 05:47:17
c4b543ff4619f4a643ff5b8df341f525e73b586b...197aae8d98c4f63a8ed6cda04dfe886459b6de15,1,4,2,6,1,2005-12-21 05:47:37,2005-12-21 05:47:37
197aae8d98c4f63a8ed6cda04dfe886459b6de15...02e301053d60096555ba6de8abfb668673850f18,2,112,0,112,1,2005-12-21 14:59:05,2005-12-21 14:59:05
02e301053d60096555ba6de8abfb668673850f18...d9269055c941bd864049207441d7955ec65760fe,1,1,1,2,1,2005-12-22 15:10:01,2005-12-22 15:10:01
d9269055c941bd864049207441d7955ec65760fe...49fd163a95074c07a23f2ccf9e23aebf5bee0bb2,9,212,86,298,53,2005-12-24 04:39:59,2005-12-24 04:39:59
49fd163a95074c07a23f2ccf9e23aebf5bee0bb2...b28e5e413332ac2becb9f475367783b94db889fc,1,58,0,58,1,2005-12-24 04:41:10,2005-12-24 04:41:10
b28e5e413332ac2becb9f475367783b94db889fc...a180f638bbacb7fc9109307ca4a3e3770eabbcea,1,1,1,2,1,2005-12-24 16:27:53,2005-12-24 16:27:53
a180f638bbacb7fc9109307ca4a3e3770eabbcea...2a6e1ed930fa584d747b6c914f1a39cf05b6b631,2,110,0,110,1,2005-12-25 00:37:25,2005-12-25 00:37:25
2a6e1ed930fa584d747b6c914f1a39cf05b6b631...3e771e6f9a5bd3ed64fdfb4e97dd874d1f6ccbec,40,973,746,1719,608,2005-12-26 11:52:42,2005-12-26 11:52:42
3e771e6f9a5bd3ed64fdfb4e97dd874d1f6ccbec...50a297c7cd97235d22c1f8baca8046e0dc0ae678,2,110,0,110,1,2005-12-26 18:00:42,2005-12-26 18:00:42
50a297c7cd97235d22c1f8baca8046e0dc0ae678...8efd0dc06d048caef851bae7fe2b16ca3aeaa13e,2,236,193,429,199,2005-12-26 18:01:15,2005-12-26 18:01:15
8efd0dc06d048caef851bae7fe2b16ca3aeaa13e...37f068ce558340ce959d4ec21f56c839e8e26959,4,1883,0,1883,2,2005-12-27 18:47:23,2005-12-27 18:47:23
37f068ce558340ce959d4ec21f56c839e8e26959...0891e7bec50a7d76c95e6098b1b71ae014b64272,1,110,0,110,1,2005-12-27 22:52:06,2005-12-27 22:52:06
0891e7bec50a7d76c95e6098b1b71ae014b64272...de72616ac09b1d3b1da32e53ea02809e9bde5428,1,6,0,6,3,2005-12-27 22:57:45,2005-12-27 22:57:45
de72616ac09b1d3b1da32e53ea02809e9bde5428...bf5125734ebb9148eb455c05dbc872876f91e2b8,1,5,1,6,1,2005-12-28 19:18:48,2005-12-28 19:18:48
bf5125734ebb9148eb455c05dbc872876f91e2b8...e08e19604f7399e1f0918404331dace80d45a719,3,1777,0,1777,3,2005-12-28 22:58:41,2005-12-28 22:58:41
e08e19604f7399e1f0918404331dace80d45a719...7337fe490025fe16c7e3c8eceafd7981496ac1e7,42,2779,2591,5370,758,2005-12-28 23:02:09,2005-12-28 23:02:09
7337fe490025fe16c7e3c8eceafd7981496ac1e7...5cff7360cb202e1be049f181e11dab22b1e88d0c,1,3,0,3,1,2005-12-28 23:11:07,2005-12-28 23:11:07
5cff7360cb202e1be049f181e11dab22b1e88d0c...5f47ce0b4ca1bc1c60e3beaff52d9f6d3747e5a1,1,0,5,5,1,2005-12-28 23:14:09,2005-12-28 23:14:09
5f47ce0b4ca1bc1c60e3beaff52d9f6d3747e5a1...632914f1887ecc3e0a2499a7ba257e1575c7b74e,2,7,1,8,6,2005-12-28 23:32:56,2005-12-28 23:32:56
632914f1887ecc3e0a2499a7ba257e1575c7b74e...f7f812cd7087625266f69596fb914a919bc798ae,2,6,0,6,2,2005-12-29 19:17:32,2005-12-29 19:17:32
f7f812cd7087625266f69596fb914a919bc798ae...8b5c2192e8698f777102cf56bdbed2170df09cc0,2,46,1,47,3,2005-12-29 20:33:56,2005-12-29 20:33:56
8b5c2192e8698f777102cf56bdbed2170df09cc0...528b4ebd8dba246525859f7a5882f61614b88343,2,13,9,22,5,2005-12-29 22:12:54,2005-12-29 22:12:54
528b4ebd8dba246525859f7a5882f61614b88343...25aacbb9f13d1b52fcf1b5d158713005026b9a86,2,1839,0,1839,1,2005-12-29 23:45:18,2005-12-29 23:45:18
25aacbb9f13d1b52fcf1b5d158713005026b9a86...c62369361bc5e4b61544b262e4371e7e35286e25,2,6,2,8,2,2005-12-31 01:46:04,2005-12-31 01:46:04
c62369361bc5e4b61544b262e4371e7e35286e25...4596b1bbfdebcc367b51182b4c3e1bbaa6ba5631,1,1,0,1,1,2005-12-31 04:03:40,2005-12-31 04:03:40
4596b1bbfdebcc367b51182b4c3e1bbaa6ba5631...53aef92bf89f2d655a125d94a0e24203e76af1d6,4,325,5,330,7,2006-01-01 18:37:33,2006-01-01 18:37:33
53aef92bf89f2d655a125d94a0e24203e76af1d6...49874d54a2d73f0117b7bb07eea2cf6096b7dd29,1,3,3,6,3,2006-01-01 18:43:09,2006-01-01 18:43:09
49874d54a2d73f0117b7bb07eea2cf6096b7dd29...2bd833d4624a30f1412d3b8abc031e559f49117f,1,1,1,2,1,2006-01-02 18:22:43,2006-01-02 18:22:43
2bd833d4624a30f1412d3b8abc031e559f49117f...839bcfe33059e43c382bdc5204cd08fa185a0bd6,2,3,3,6,3,2006-01-03 22:29:56,2006-01-03 22:29:56
839bcfe33059e43c382bdc5204cd08fa185a0bd6...6cca806943790a586a059bd2dacdf5d54e5f601d,2,38,5,43,4,2006-01-03 23:41:31,2006-01-03 23:41:31
6cca806943790a586a059bd2dacdf5d54e5f601d...3234a932b2054e30604d29f93e65180fa7c3fc05,5,26,13,39,12,2006-01-03 23:57:14,2006-01-03 23:57:14
3234a932b2054e30604d29f93e65180fa7c3fc05...b0ad54ec0b579a448f240bc631f6d9bdfc536000,2,150,148,298,21,2006-01-04 11:59:46,2006-01-04 11:59:46
b0ad54ec0b579a448f240bc631f6d9bdfc536000...1714e797966a893e50c87d1bab10e71c1501d473,2,4,4,8,4,2006-01-04 17:09:26,2006-01-04 17:09:26
1714e797966a893e50c87d1bab10e71c1501d473...d3b85e30d3f36a494aca6e74a278d85800d03c85,2,115,171,286,67,2006-01-05 12:05:15,2006-01-05 12:05:15
d3b85e30d3f36a494aca6e74a278d85800d03c85...7332b13239072aa8bb8936d02732b5d7ccfffe08,1,1,1,2,1,2006-01-05 14:09:22,2006-01-05 14:09:22
7332b13239072aa8bb8936d02732b5d7ccfffe08...170c3be4b3019cb9b1476d923bc8ddd5e84c1ebd,1,1,1,2,1,2006-01-05 16:28:25,2006-01-05 16:28:25
170c3be4b3019cb9b1476d923bc8ddd5e84c1ebd...7104000e52ee5f94f56f344faaa069a1909351c6,1,5,5,10,4,2006-01-06 17:03:12,2006-01-06 17:03:12
7104000e52ee5f94f56f344faaa069a1909351c6...bbfc645337610b4c974c4f5a225958367b4d294c,3,6,1,7,3,2006-01-06 20:43:14,2006-01-06 20:43:14
bbfc645337610b4c974c4f5a225958367b4d294c...2bffee2e6c3744705acf05710150b73afb315bf9,1,4,0,4,1,2006-01-07 10:21:51,2006-01-07 10:21:51
2bffee2e6c3744705acf05710150b73afb315bf9...8d307fb8f7ce38c565ffb8061217ff6f3fd69b21,1,1,1,2,1,2006-01-07 11:07:52,2006-01-07 11:07:52
8d307fb8f7ce38c565ffb8061217ff6f3fd69b21...491a152c11e61f5fbb693c44944d83f7fdae3e45,2,1,1,2,1,2006-01-08 01:06:49,2006-01-08 01:06:49
491a152c11e61f5fbb693c44944d83f7fdae3e45...0c548516bc951cbbd3f153a8e5c7b6a2108962c0,2,2,1,3,2,2006-01-08 05:10:51,2006-01-08 05:10:51
0c548516bc951cbbd3f153a8e5c7b6a2108962c0...05c9a3b13f29719664336c2c4208d640aa6fb7c8,1,44,17,61,11,2006-01-08 06:24:17,2006-01-08 06:24:17
05c9a3b13f29719664336c2c4208d640aa6fb7c8...e3ba51397a5092fb693893cefe5887481b4381c3,1,20,3,23,2,2006-01-08 06:30:56,2006-01-08 06:30:56
e3ba51397a5092fb693893cefe5887481b4381c3...6719511497126b82a5025e04fbe1252934b7ccc9,1,1,1,2,1,2006-01-08 06:31:24,2006-01-08 06:31:24
6719511497126b82a5025e04fbe1252934b7ccc9...682a137209242070ab04f1d04b2cd8dbf420af25,1,3,3,6,1,2006-01-08 06:32:52,2006-01-08 06:32:52
682a137209242070ab04f1d04b2cd8dbf420af25...0b6b89f222daa29e4fd9b78ab147fd70c83dfb16,1,5,5,10,1,2006-01-08 06:34:06,2006-01-08 06:34:06
0b6b89f222daa29e4fd9b78ab147fd70c83dfb16...bfd5ce8c4108fa7b27f73bc0d5ca3b4d92ea65cd,1,5,5,10,1,2006-01-08 18:08:22,2006-01-08 18:08:22
bfd5ce8c4108fa7b27f73bc0d5ca3b4d92ea65cd...928e0a180ecd6819e2b812eebaef4a48f5fe3f12,4,29,29,58,30,2006-01-08 18:53:39,2006-01-08 18:53:39
928e0a180ecd6819e2b812eebaef4a48f5fe3f12...f02861fa930b8b18cd2d51801e67ac2c482ed31a,1,1,1,2,1,2006-01-08 23:41:33,2006-01-08 23:41:33
f02861fa930b8b18cd2d51801e67ac2c482ed31a...6af37477bd8c3e6ac545d1461c5d2b5d63c2ffbd,2,2,2,4,2,2006-01-09 00:51:48,2006-01-09 00:51:48
6af37477bd8c3e6ac545d1461c5d2b5d63c2ffbd...7d0bf5f2dcf34c7a28925e28fce67f44183dd77d,2,9,4,13,5,2006-01-09 00:54:35,2006-01-09 00:54:35
7d0bf5f2dcf34c7a28925e28fce67f44183dd77d...9f0deae2494f9e5e5d7a55b7fa46ef53c1ca34d7,1,1,1,2,1,2006-01-09 01:33:59,2006-01-09 01:33:59
9f0deae2494f9e5e5d7a55b7fa46ef53c1ca34d7...11bcc7969d43db596cbbad51db220d1f264fbac3,2,6,2,8,3,2006-01-09 01:55:37,2006-01-09 01:55:37
11bcc7969d43db596cbbad51db220d1f264fbac3...326136e8a53c91dbd519eb440ac6b8a1dbec47c7,2,2,1,3,2,2006-01-09 02:04:21,2006-01-09 02:04:21
326136e8a53c91dbd519eb440ac6b8a1dbec47c7...a5005c29be0199ab9249812476743acfe7720968,1,1,0,1,1,2006-01-09 02:06:00,2006-01-09 02:06:00
a5005c29be0199ab9249812476743acfe7720968...580a8eb42f3b998637fe629f8e40ddd822b6cfcf,1,1,1,2,1,2006-01-09 02:08:29,2006-01-09 02:08:29
580a8eb42f3b998637fe629f8e40ddd822b6cfcf...7573756e18b813a3aa388ff031e3167aa4665c15,1,1,1,2,1,2006-01-09 05:11:13,2006-01-09 05:11:13
7573756e18b813a3aa388ff031e3167aa4665c15...786e5477b70e34a502d1b0dd8fbf59926699e480,12,21,58,79,24,2006-01-11 00:11:29,2006-01-11 00:11:29
786e5477b70e34a502d1b0dd8fbf59926699e480...9080d5ad748e0f528d8fd6af7dca5eb19c14b879,1,0,0,0,0,2006-01-11 00:14:25,2006-01-11 00:14:25
9080d5ad748e0f528d8fd6af7dca5eb19c14b879...b94d78772f58da7610f714a32e55e96a1d09bea7,1,8,1,9,3,2006-01-11 01:57:22,2006-01-11 01:57:22
b94d78772f58da7610f714a32e55e96a1d09bea7...5de00f785f1cd83b0e480ffdebeca5977a3fa953,5,232,156,388,80,2006-01-11 02:06:27,2006-01-11 02:06:27
5de00f785f1cd83b0e480ffdebeca5977a3fa953...6e5c7d3899d981ec3e0a0d49977cd1a58ebc702f,1,1,1,2,1,2006-01-11 04:56:24,2006-01-11 04:56:24
6e5c7d3899d981ec3e0a0d49977cd1a58ebc702f...d062e6278dc1715d1d2f26badd46dd627bba10e3,1,1,0,1,1,2006-01-11 05:54:13,2006-01-11 05:54:13
d062e6278dc1715d1d2f26badd46dd627bba10e3...ef60a399b37e3e5415874af77eda0f86ddf580b9,1,33,1,34,2,2006-01-11 05:54:27,2006-01-11 05:54:27
ef60a399b37e3e5415874af77eda0f86ddf580b9...961b6bdfaa88efebb9e01769625dac3bbb41f042,1,5,2,7,3,2006-01-11 05:55:00,2006-01-11 05:55:00
961b6bdfaa88efebb9e01769625dac3bbb41f042...a44499542704f09479e37b8635d98487a4ca486d,1,5,1,6,2,2006-01-11 05:57:28,2006-01-11 05:57:28
a44499542704f09479e37b8635d98487a4ca486d...e9727a857bdf436c44410dd72a27b4f22fc6df03,1,1,1,2,1,2006-01-11 14:46:38,2006-01-11 14:46:38
e9727a857bdf436c44410dd72a27b4f22fc6df03...df82f24cc9d4cbad4c179945c8d7fec592f2230b,1,3,3,6,3,2006-01-11 15:30:21,2006-01-11 15:30:21
df82f24cc9d4cbad4c179945c8d7fec592f2230b...2e997f9a63d4d69ea419e0bdae1df500df874861,1,3,3,6,1,2006-01-11 15:56:15,2006-01-11 15:56:15
2e997f9a63d4d69ea419e0bdae1df500df874861...16efb3320316817085f18908889bcf8de4e652f1,1,5,0,5,1,2006-01-11 17:48:41,2006-01-11 17:48:41
16efb3320316817085f18908889bcf8de4e652f1...353d7e33cb5dcc69003ef0390d209cc2bbfa1ebe,1,0,1,1,1,2006-01-11 20:50:04,2006-01-11 20:50:04
353d7e33cb5dcc69003ef0390d209cc2bbfa1ebe...51a699dea91eefb1e95939a93599330336b73228,1,2,2,4,2,2006-01-12 02:35:14,2006-01-12 02:35:14
51a699dea91eefb1e95939a93599330336b73228...b125cafbfc715f808b8af6125a1c1dddc7079963,1,8,4,12,1,2006-01-12 03:02:19,2006-01-12 03:02:19
b125cafbfc715f808b8af6125a1c1dddc7079963...6a0ba52223334491532dd8f878192f29d36c3e3d,1,0,22,22,1,2006-01-12 04:41:23,2006-01-12 04:41:23
6a0ba52223334491532dd8f878192f29d36c3e3d...6ad31914185928ba5f108311acfdb889a285f393,1,10,0,10,1,2006-01-12 04:41:40,2006-01-12 04:41:40
6ad31914185928ba5f108311acfdb889a285f393...1929d8e8f3da1fb5279574be688ed7182b72c4d9,1,2,1,3,1,2006-01-12 04:43:29,2006-01-12 04:43:29
1929d8e8f3da1fb5279574be688ed7182b72c4d9...0041e84d67fd2ff1f4e6af06444e5ccf9c1b7dbb,1,8,1,9,1,2006-01-12 05:41:52,2006-01-12 05:41:52
0041e84d67fd2ff1f4e6af06444e5ccf9c1b7dbb...11f8bd9d9af76ac2e514fde200266a158f73272d,5,5,5,10,5,2006-01-12 17:35:57,2006-01-12 17:35:57
11f8bd9d9af76ac2e514fde200266a158f73272d...51f4e95cb70b94a28969d30cb6036a4a25a75503,1,1,1,2,1,2006-01-12 19:01:58,2006-01-12 19:01:58
51f4e95cb70b94a28969d30cb6036a4a25a75503...5e6d6fafae96fa55d754e88cc4cf814b75c32c13,2,31,6,37,4,2006-01-12 20:56:10,2006-01-12 20:56:10
5e6d6fafae96fa55d754e88cc4cf814b75c32c13...a6404e24ecc179b434aba30feb21ef76a5294fff,45,937,679,1616,396,2006-01-12 22:08:00,2006-01-12 22:08:00
a6404e24ecc179b434aba30feb21ef76a5294fff...47e79cec0c5ae2eb224282c3add5ce49911f9f3e,1,1,1,2,1,2006-01-13 10:40:09,2006-01-13 10:40:09
47e79cec0c5ae2eb224282c3add5ce49911f9f3e...46517e0a570d05f68d633d1b9ea681fee5b5d49e,2,2,2,4,2,2006-01-13 14:48:06,2006-01-13 14:48:06
46517e0a570d05f68d633d1b9ea681fee5b5d49e...46120b86e3034be921397b2ad35ab130d0f361fb,1,1,1,2,1,2006-01-13 15:01:16,2006-01-13 15:01:16
46120b86e3034be921397b2ad35ab130d0f361fb...19abf041bf5c25cccca396f16919e42b51253098,1,2,1,3,1,2006-01-13 20:42:11,2006-01-13 20:42:11
19abf041bf5c25cccca396f16919e42b51253098...e4e2877b248c2b165950709571ccb29a0a0d4910,1,1,1,2,1,2006-01-13 20:57:30,2006-01-13 20:57:30
e4e2877b248c2b165950709571ccb29a0a0d4910...d701987fd2761ef36ef03fdb4be7fa7acd50350c,1,1,1,2,1,2006-01-15 00:17:25,2006-01-15 00:17:25
d701987fd2761ef36ef03fdb4be7fa7acd50350c...e702ec158fe580b8a3c218bb2466616a04a1060f,1,4,0,4,2,2006-01-15 00:37:59,2006-01-15 00:37:59
e702ec158fe580b8a3c218bb2466616a04a1060f...39639cfd22386856e4ee3cc9fe5e75c30bec066b,3,13,2,15,3,2006-01-15 00:48:23,2006-01-15 00:48:23
39639cfd22386856e4ee3cc9fe5e75c30bec066b...e260037e168152b17e4f46685ccce301fe3f5c99,1,2,0,2,1,2006-01-15 01:15:44,2006-01-15 01:15:44
e260037e168152b17e4f46685ccce301fe3f5c99...0eaee6f5d4976f3b0146d512c43d2f9a19f39021,4,51,0,51,5,2006-01-15 01:51:30,2006-01-15 01:51:30
0eaee6f5d4976f3b0146d512c43d2f9a19f39021...e449e5c805841c35590feee1a661dffa9bbe5b4b,2,6,5,11,4,2006-01-15 05:18:17,2006-01-15 05:18:17
e449e5c805841c35590feee1a661dffa9bbe5b4b...2667ead8850cb767c798149f781449c5b37d7367,2,6,4,10,2,2006-01-15 05:48:13,2006-01-15 05:48:13
2667ead8850cb767c798149f781449c5b37d7367...6e50a2ef5d7530ffe29c069cc5ff5613cb5f3045,1,1,0,1,1,2006-01-15 05:54:47,2006-01-15 05:54:47
6e50a2ef5d7530ffe29c069cc5ff5613cb5f3045...ceb558c277876c506e8ee45f98f5029667896c9c,2,3,2,5,3,2006-01-15 06:01:35,2006-01-15 06:01:35
ceb558c277876c506e8ee45f98f5029667896c9c...60e3d1352dc7330a39f92c81668f70efa29c2f94,1,1,1,2,1,2006-01-15 06:07:43,2006-01-15 06:07:43
60e3d1352dc7330a39f92c81668f70efa29c2f94...e0af20fb0f172bad3c99e643f8b17d1870c4d512,1,1,1,2,1,2006-01-15 06:10:02,2006-01-15 06:10:02
e0af20fb0f172bad3c99e643f8b17d1870c4d512...44e6ce655291ea3bd5ff47c09754ef0fb998f36f,2,10,8,18,2,2006-01-15 06:18:03,2006-01-15 06:18:03
44e6ce655291ea3bd5ff47c09754ef0fb998f36f...d862908b67aa1414748423ad6b9332902329a67d,1,1,1,2,1,2006-01-15 06:22:24,2006-01-15 06:22:24
d862908b67aa1414748423ad6b9332902329a67d...09da1666090b12cd1a4d716ba417c96133b0fa3b,2,9,9,18,9,2006-01-15 06:28:41,2006-01-15 06:28:41
09da1666090b12cd1a4d716ba417c96133b0fa3b...9bee9a8cf1c91ba72c5b762924a4667a84d2ab98,2,8,6,14,7,2006-01-15 19:37:58,2006-01-15 19:37:58
9bee9a8cf1c91ba72c5b762924a4667a84d2ab98...946b1a5cd2139c026809c5277ad27e0a9227f77c,4,149,255,404,92,2006-01-15 19:39:49,2006-01-15 19:39:49
946b1a5cd2139c026809c5277ad27e0a9227f77c...017aa34ddb0e10f545c641097cd7de524f9f90e9,1,19,0,19,1,2006-01-15 22:58:35,2006-01-15 22:58:35
017aa34ddb0e10f545c641097cd7de524f9f90e9...c4ab08a7a52be0ec99a0a5c5753f5959204d003a,1,1,0,1,1,2006-01-16 18:49:24,2006-01-16 18:49:24
c4ab08a7a52be0ec99a0a5c5753f5959204d003a...d5a5f0f79007fdb2302cf86d2bb97739964f0a03,1,7,1,8,3,2006-01-16 18:54:41,2006-01-16 18:54:41
d5a5f0f79007fdb2302cf86d2bb97739964f0a03...f1f2005c05061030711b6cf3a9418d1e5223907a,1,25,0,25,1,2006-01-16 18:59:43,2006-01-16 18:59:43
f1f2005c05061030711b6cf3a9418d1e5223907a...6f3f25e733b2ba9670ed9035934acc65a971231b,2,4,4,8,4,2006-01-16 21:44:10,2006-01-16 21:44:10
6f3f25e733b2ba9670ed9035934acc65a971231b...8654a91e12e988b7be575364e3a791f2b4052fc1,1,10,6,16,3,2006-01-17 17:56:33,2006-01-17 17:56:33
8654a91e12e988b7be575364e3a791f2b4052fc1...8f54a225a564e138c73a07c750e2d5a16c77de4d,1,2,2,4,1,2006-01-17 17:59:31,2006-01-17 17:59:31
8f54a225a564e138c73a07c750e2d5a16c77de4d...3b98bdc240a743fa6f366beafe358604ec26c154,1,18,0,18,1,2006-01-18 13:01:43,2006-01-18 13:01:43
3b98bdc240a743fa6f366beafe358604ec26c154...2e0fc1ff9548def7d31a4cf386ef200cd61178d7,1,1,1,2,1,2006-01-18 16:46:30,2006-01-18 16:46:30
2e0fc1ff9548def7d31a4cf386ef200cd61178d7...ce40c4a9e2b32e8c9233e788f594ebf03cc9a7f0,3,158,150,308,18,2006-01-19 00:54:15,2006-01-19 00:54:15
ce40c4a9e2b32e8c9233e788f594ebf03cc9a7f0...c12c225a66df0c48bc00cc4b418c383d5516e668,5,17,20,37,11,2006-01-19 01:06:12,2006-01-19 01:06:12
c12c225a66df0c48bc00cc4b418c383d5516e668...78c8be92186d1af38c148073936b56c7b0835fd7,1,13,13,26,5,2006-01-19 01:08:42,2006-01-19 01:08:42
78c8be92186d1af38c148073936b56c7b0835fd7...bfaff07990c1a69b253f11f636bd049836626e6b,1,2,7,9,1,2006-01-19 03:25:12,2006-01-19 03:25:12
bfaff07990c1a69b253f11f636bd049836626e6b...2483ed749bc0969b38ddf27a84c01ad6af628647,3,1,17,18,17,2006-01-19 03:29:45,2006-01-19 03:29:45
2483ed749bc0969b38ddf27a84c01ad6af628647...5355ec999292b17fc2788ddb3603d0d8a71a6a1e,1,5,0,5,1,2006-01-20 20:23:57,2006-01-20 20:23:57
5355ec999292b17fc2788ddb3603d0d8a71a6a1e...01e514f5106a2b49a9ff35d315b33ab9a9b77d9a,1,3,0,3,1,2006-01-20 20:33:40,2006-01-20 20:33:40
01e514f5106a2b49a9ff35d315b33ab9a9b77d9a...09ef4c6fa9105e9304f6d1ba62b8843cd90e8c1a,1,1,0,1,1,2006-01-20 22:19:04,2006-01-20 22:19:04
09ef4c6fa9105e9304f6d1ba62b8843cd90e8c1a...a07b704d8b5385a90603ecbe0178d80485fd8b84,1,14,0,14,1,2006-01-21 22:29:55,2006-01-21 22:29:55
a07b704d8b5385a90603ecbe0178d80485fd8b84...683c757c54bd6c5f35f43c5737b766a2c1885742,3,9,12,21,7,2006-01-23 22:53:50,2006-01-23 22:53:50
683c757c54bd6c5f35f43c5737b766a2c1885742...7ce571ef015705a8e19994f68dd71d0a32f95390,1,16,0,16,1,2006-01-23 23:16:39,2006-01-23 23:16:39
7ce571ef015705a8e19994f68dd71d0a32f95390...14ea5bfef5f10fccd20cc3dc70b39f55673b0ebd,1,13,0,13,1,2006-01-23 23:22:45,2006-01-23 23:22:45
14ea5bfef5f10fccd20cc3dc70b39f55673b0ebd...395b188423abe4da34457eacd7ce6eb34a24874f,1,2,2,4,1,2006-01-24 20:00:08,2006-01-24 20:00:08
395b188423abe4da34457eacd7ce6eb34a24874f...21305d50b70eab5c1310346331629be0d7af2edd,1,8,0,8,1,2006-01-24 21:42:38,2006-01-24 21:42:38
21305d50b70eab5c1310346331629be0d7af2edd...23d2be171447bef6f0b30686ffe5324b646d3fb6,1,1,1,2,1,2006-01-27 15:45:10,2006-01-27 15:45:10
23d2be171447bef6f0b30686ffe5324b646d3fb6...e35655081f105c727d6d57db75ae1b99aa22b60d,2,4,4,8,4,2006-01-27 15:49:50,2006-01-27 15:49:50
e35655081f105c727d6d57db75ae1b99aa22b60d...1dc65cb6ab158fae3ccae55512a4f49ec3654758,3,14,0,14,3,2006-01-27 15:55:04,2006-01-27 15:55:04
1dc65cb6ab158fae3ccae55512a4f49ec3654758...e15567bf58aa3331099eaefad6464aa38fdf6f20,1,1,1,2,1,2006-01-27 16:05:00,2006-01-27 16:05:00
e15567bf58aa3331099eaefad6464aa38fdf6f20...e0e5e1e43d8bd6a1446b778ee8e3582131d2224d,1,3,0,3,1,2006-01-27 16:33:26,2006-01-27 16:33:26
e0e5e1e43d8bd6a1446b778ee8e3582131d2224d...ee350b09dd7890ddc58bd86c5972549e11285324,4,426,425,851,263,2006-01-27 22:23:42,2006-01-27 22:23:42
ee350b09dd7890ddc58bd86c5972549e11285324...b4af15e66cd8e07ee2ac619c2a8816218ec9b687,1,1,4,5,1,2006-01-30 04:13:00,2006-01-30 04:13:00
b4af15e66cd8e07ee2ac619c2a8816218ec9b687...4fd2b3eab9f7a10df78034a3e25f3ac7f73d8189,1,14,0,14,1,2006-01-30 22:04:17,2006-01-30 22:04:17
4fd2b3eab9f7a10df78034a3e25f3ac7f73d8189...233708fb683ae2c1cf3e4c00edc2e4842d99a42d,3,23,29,52,12,2006-01-30 22:54:10,2006-01-30 22:54:10
233708fb683ae2c1cf3e4c00edc2e4842d99a42d...41fac5f9efc278bc37264e85f464601063b7eae8,1,12,0,12,1,2006-01-31 21:38:02,2006-01-31 21:38:02
41fac5f9efc278bc37264e85f464601063b7eae8...97897665088cc02b9a7b4cc5461b7842e759d004,1,3,2,5,1,2006-02-02 04:50:16,2006-02-02 04:50:16
97897665088cc02b9a7b4cc5461b7842e759d004...2549b3197033668d4ba40245e888e8f4eea80380,1,23,17,40,2,2006-02-02 05:07:12,2006-02-02 05:07:12
2549b3197033668d4ba40245e888e8f4eea80380...7a132e275441ba475a9bea988869fb8a8568d513,1,1,1,2,1,2006-02-02 05:13:39,2006-02-02 05:13:39
7a132e275441ba475a9bea988869fb8a8568d513...2ddc9504c3c1309e2c9e3c5a6849f92166437f39,1,3,3,6,1,2006-02-02 05:15:32,2006-02-02 05:15:32
2ddc9504c3c1309e2c9e3c5a6849f92166437f39...1d6a56dae26acdecd7410b5670b6d3b4701b3179,47,2464,1188,3652,553,2006-02-02 10:25:15,2006-02-02 10:25:15
1d6a56dae26acdecd7410b5670b6d3b4701b3179...fa80e70e13edca4e6a9c3203ab1ce2266365b2b6,2,164,169,333,33,2006-02-02 11:52:35,2006-02-02 11:52:35
fa80e70e13edca4e6a9c3203ab1ce2266365b2b6...aae4f9701cca4ec73895c128a323d38c7e52bdad,1,4,3,7,3,2006-02-02 15:00:34,2006-02-02 15:00:34
aae4f9701cca4ec73895c128a323d38c7e52bdad...8626c0f59468889782ca5f95a519aed9b229d6bd,2,4,4,8,3,2006-02-02 17:09:26,2006-02-02 17:09:26
8626c0f59468889782ca5f95a519aed9b229d6bd...bd41a51942c191d8a58536518f2e1d08456976af,1,11,10,21,8,2006-02-02 17:35:00,2006-02-02 17:35:00
bd41a51942c191d8a58536518f2e1d08456976af...567e4e441131434c855f9232553ae939962def99,4,23,0,23,4,2006-02-03 15:18:20,2006-02-03 15:18:20
567e4e441131434c855f9232553ae939962def99...ee484f1c483d103a56b3d4cf43d929eaa890811b,1,1,0,1,1,2006-02-03 15:38:14,2006-02-03 15:38:14
ee484f1c483d103a56b3d4cf43d929eaa890811b...9423c4e4a886b373243811e08a40a031ae484772,3,50,16,66,11,2006-02-04 20:08:30,2006-02-04 20:08:30
9423c4e4a886b373243811e08a40a031ae484772...c59901a4679faff44844bffdf877dc859fd1351a,1,2,3,5,3,2006-02-04 20:18:18,2006-02-04 20:18:18
c59901a4679faff44844bffdf877dc859fd1351a...ba8f23424bc6ea885a129cc08f9702976e2bb0ea,4,1378,1378,2756,315,2006-02-06 16:01:50,2006-02-06 16:01:50
ba8f23424bc6ea885a129cc08f9702976e2bb0ea...e0c915ec39c646f9444eebf37abca015d7a48865,5,50,15,65,12,2006-02-09 00:31:51,2006-02-09 00:31:51
e0c915ec39c646f9444eebf37abca015d7a48865...5c0380b6ede3b8e1d18e8abe40451ba9632202bf,1,15,0,15,1,2006-02-10 15:27:36,2006-02-10 15:27:36
5c0380b6ede3b8e1d18e8abe40451ba9632202bf...93980706bf114d11efc3513adf1936e0b507c74a,1,1,1,2,1,2006-02-10 15:28:31,2006-02-10 15:28:31
93980706bf114d11efc3513adf1936e0b507c74a...d8b4d29004d518459a74c5b588d3455da2871e42,1,1,1,2,1,2006-02-10 15:38:54,2006-02-10 15:38:54
d8b4d29004d518459a74c5b588d3455da2871e42...bf16befc433ff9e1764db0fa57ef05b507eee0e0,3,13,0,13,3,2006-02-10 21:33:07,2006-02-10 21:33:07
bf16befc433ff9e1764db0fa57ef05b507eee0e0...906e5dac0d4a8ec66bb28fbe3d954df6245b6b18,1,1,1,2,1,2006-02-10 21:43:45,2006-02-10 21:43:45
906e5dac0d4a8ec66bb28fbe3d954df6245b6b18...f732217c0a80d055976497a9c07c330db0ae76bb,1,6,1,7,1,2006-02-13 15:33:25,2006-02-13 15:33:25
f732217c0a80d055976497a9c07c330db0ae76bb...c1dded685d5c2588f688fe45524b8d51e766075b,1,10,0,10,1,2006-02-16 03:55:48,2006-02-16 03:55:48
c1dded685d5c2588f688fe45524b8d51e766075b...e9a1e9fed66ba0424b7afa2c13b6ab62ea79efee,1,28,5,33,2,2006-02-16 16:00:32,2006-02-16 16:00:32
e9a1e9fed66ba0424b7afa2c13b6ab62ea79efee...b9b02f91fa4b744ac187c250f219457d29d66ab9,1,7,7,14,1,2006-02-16 16:01:59,2006-02-16 16:01:59
b9b02f91fa4b744ac187c250f219457d29d66ab9...186b5ccb34fba183a0cb9898020c555698bd355e,1,5,1,6,1,2006-02-17 17:25:01,2006-02-17 17:25:01
186b5ccb34fba183a0cb9898020c555698bd355e...af33a72fb55b6d5e1b27d18aafa7b74e7446c2c6,1,1,1,2,1,2006-02-17 17:45:44,2006-02-17 17:45:44
af33a72fb55b6d5e1b27d18aafa7b74e7446c2c6...15f57d8c55d74e41e8102ccad27fcc7d73a67771,1,1,1,2,1,2006-02-17 17:55:41,2006-02-17 17:55:41
15f57d8c55d74e41e8102ccad27fcc7d73a67771...b3f99ec9fefaaac1d9bbd7c99d09226623cb57e5,1,3,3,6,3,2006-02-17 17:56:46,2006-02-17 17:56:46
b3f99ec9fefaaac1d9bbd7c99d09226623cb57e5...6b694097dc22569f1b86feec20a1ff30a2b14b26,2,15,2,17,3,2006-02-17 18:03:54,2006-02-17 18:03:54
6b694097dc22569f1b86feec20a1ff30a2b14b26...97eb38b21dfa2750f50b3a933adaf19661345dab,7,12,7,19,7,2006-02-17 18:15:07,2006-02-17 18:15:07
97eb38b21dfa2750f50b3a933adaf19661345dab...e9c3efe7f389884c343f56ddd2cd17cba039333b,2,1,5,6,3,2006-02-17 18:18:03,2006-02-17 18:18:03
e9c3efe7f389884c343f56ddd2cd17cba039333b...c14e6929528512b7201654d630983f2c219ebc46,1,1,1,2,1,2006-02-17 18:20:15,2006-02-17 18:20:15
c14e6929528512b7201654d630983f2c219ebc46...a10e8153f324ef58714269e99ec0882b68b832ca,2,10,1,11,3,2006-02-17 18:33:09,2006-02-17 18:33:09
a10e8153f324ef58714269e99ec0882b68b832ca...165a4e7809497311b573f6d10e4f309fe6e79f4f,1,4,4,8,3,2006-02-18 16:22:31,2006-02-18 16:22:31
165a4e7809497311b573f6d10e4f309fe6e79f4f...193ae3800f2070b7a8d36fcbf884a1cbee575745,1,62,0,62,2,2006-02-18 16:43:17,2006-02-18 16:43:17
193ae3800f2070b7a8d36fcbf884a1cbee575745...e5a0960c267a6daca9cddafe63770932ea8c55c3,1,1,1,2,1,2006-02-18 16:44:20,2006-02-18 16:44:20
e5a0960c267a6daca9cddafe63770932ea8c55c3...d2522e31b992aaf2707692a8a4b9778780540f34,1,2,1,3,2,2006-02-18 16:45:36,2006-02-18 16:45:36
d2522e31b992aaf2707692a8a4b9778780540f34...e029c9f7f8765b895ef2893cdf7fabe6dc5e9806,1,1,1,2,1,2006-02-18 20:08:20,2006-02-18 20:08:20
e029c9f7f8765b895ef2893cdf7fabe6dc5e9806...73ddfd8bd2b0703573072809aa977d5ca335d101,2,11,4,15,6,2006-02-18 20:13:46,2006-02-18 20:13:46
73ddfd8bd2b0703573072809aa977d5ca335d101...25b149a2a510df359f8fb485f32523d926b0150c,2,3,5,8,4,2006-02-18 20:18:45,2006-02-18 20:18:45
25b149a2a510df359f8fb485f32523d926b0150c...bb8500449b8da7a11dbf8422f9b10d943281bb62,2,11,2,13,3,2006-02-18 20:34:14,2006-02-18 20:34:14
bb8500449b8da7a11dbf8422f9b10d943281bb62...40809bdee4288ceb94bd969065ed7db875ce4b81,1,1,1,2,1,2006-02-18 20:44:09,2006-02-18 20:44:09
40809bdee4288ceb94bd969065ed7db875ce4b81...b46128225d348db97cf54cc0e5cfe91780dbb386,1,0,1,1,1,2006-02-18 20:55:59,2006-02-18 20:55:59
b46128225d348db97cf54cc0e5cfe91780dbb386...ac97cf54af32a1bf4426e613909f0a9af3e02c94,8,51,13,64,16,2006-02-18 21:26:28,2006-02-18 21:26:28
ac97cf54af32a1bf4426e613909f0a9af3e02c94...27b41fd9ded886cd44dbc0b27c6b622a743cbc28,1,6,1,7,1,2006-02-18 21:28:19,2006-02-18 21:28:19
27b41fd9ded886cd44dbc0b27c6b622a743cbc28...5710c6e2db54173b12a5f2789a07c89ae3eda68b,2,3,3,6,3,2006-02-18 21:57:38,2006-02-18 21:57:38
5710c6e2db54173b12a5f2789a07c89ae3eda68b...64153ef4d5ecd838c61eaa785e79856469afa83b,2,29,2,31,2,2006-02-18 22:04:52,2006-02-18 22:04:52
64153ef4d5ecd838c61eaa785e79856469afa83b...4d1bb30480b74f83a144d46fdce626b818304a46,1,1,1,2,1,2006-02-18 22:06:42,2006-02-18 22:06:42
4d1bb30480b74f83a144d46fdce626b818304a46...72a83f872c81918b9640eb804f9004fa24b1847c,3,3,3,6,3,2006-02-18 22:21:31,2006-02-18 22:21:31
72a83f872c81918b9640eb804f9004fa24b1847c...cf528aa420344ceb6ed72f517002f0cf5fbd2111,1,2,2,4,2,2006-02-18 22:36:16,2006-02-18 22:36:16
cf528aa420344ceb6ed72f517002f0cf5fbd2111...53ca15cd78cdcb881b31cc417f8709c10fafaadd,1,4,0,4,1,2006-02-18 23:04:09,2006-02-18 23:04:09
53ca15cd78cdcb881b31cc417f8709c10fafaadd...2c443df341984b1fc8c6801e39129180588309a0,3,4,8,12,3,2006-02-18 23:41:17,2006-02-18 23:41:17
2c443df341984b1fc8c6801e39129180588309a0...c72afb811b851aa382043051c50bfb7b4b31845a,1,2,2,4,1,2006-02-18 23:48:11,2006-02-18 23:48:11
c72afb811b851aa382043051c50bfb7b4b31845a...f86004a4d3f642463a6faac72a72b61e975d9f29,3,8,4,12,3,2006-02-20 04:36:17,2006-02-20 04:36:17
f86004a4d3f642463a6faac72a72b61e975d9f29...760badab9830702661822b72e54b68afc71d7f8b,2,1737,0,1737,1,2006-02-21 13:12:23,2006-02-21 13:12:23
760badab9830702661822b72e54b68afc71d7f8b...0bf0b6d896f3d551116b5719ac494c67981fc387,1,1,2,3,1,2006-02-22 17:13:08,2006-02-22 17:13:08
0bf0b6d896f3d551116b5719ac494c67981fc387...1320fd543d978c7f6f8376e352141656193403b1,1,8,0,8,1,2006-02-22 17:40:30,2006-02-22 17:40:30
1320fd543d978c7f6f8376e352141656193403b1...a5fad0eb37fd78ce4cdc26dd6bf2510c5ccc5fc9,2,2,2,4,2,2006-02-23 19:05:40,2006-02-23 19:05:40
a5fad0eb37fd78ce4cdc26dd6bf2510c5ccc5fc9...9a74e89ef06433e53e6926a07d42c30d22840682,2,8,1,9,3,2006-02-23 20:27:03,2006-02-23 20:27:03
9a74e89ef06433e53e6926a07d42c30d22840682...c5073320a77058206f9b4b79420586531764aa26,10,438,502,940,9,2006-02-24 06:07:01,2006-02-24 06:07:01
c5073320a77058206f9b4b79420586531764aa26...c2b60ce1368395d812742f2e67a526c40397c244,1,4,0,4,2,2006-02-24 06:09:35,2006-02-24 06:09:35
c2b60ce1368395d812742f2e67a526c40397c244...f8915c0676a97c9e4830bee433551c5f74ff0136,1,0,4,4,1,2006-02-25 17:09:54,2006-02-25 17:09:54
f8915c0676a97c9e4830bee433551c5f74ff0136...79633b280c7ba614b1b54a234e46d7cc35b36c42,1,1,0,1,1,2006-02-25 17:14:49,2006-02-25 17:14:49
79633b280c7ba614b1b54a234e46d7cc35b36c42...de66a3a7dac08554a8cb76e480d242ca0bfd0d54,1,0,1,1,1,2006-02-25 17:18:27,2006-02-25 17:18:27
de66a3a7dac08554a8cb76e480d242ca0bfd0d54...250281361d1341bd9b9481a16f16acc49a8f142a,4,4,3,7,4,2006-02-25 17:24:17,2006-02-25 17:24:17
250281361d1341bd9b9481a16f16acc49a8f142a...3723f8379887a3f47d70ca1e8b743154d62beac0,1,13,5,18,2,2006-02-27 18:42:25,2006-02-27 18:42:25
3723f8379887a3f47d70ca1e8b743154d62beac0...0df9fb8f9abdb0fbc1ba8b249ae9b71cc06af8e2,2,11,1,12,3,2006-02-27 18:52:54,2006-02-27 18:52:54
0df9fb8f9abdb0fbc1ba8b249ae9b71cc06af8e2...eeb848bdbd9213c0efc656a3dbbade54d1908c85,1,1,1,2,1,2006-02-27 19:13:41,2006-02-27 19:13:41
eeb848bdbd9213c0efc656a3dbbade54d1908c85...b830fa7e7896bc7e13254740b12ec5ab7eed82cf,2,5,0,5,2,2006-02-27 21:05:50,2006-02-27 21:05:50
b830fa7e7896bc7e13254740b12ec5ab7eed82cf...92c04cb7c67ab2f6505938f5f4db687b1ac20721,1,1,1,2,1,2006-02-27 21:37:11,2006-02-27 21:37:11
92c04cb7c67ab2f6505938f5f4db687b1ac20721...47f040d2eb6e2cc91b4e482225b4109b92e949bf,1,3,3,6,3,2006-02-27 22:23:24,2006-02-27 22:23:24
47f040d2eb6e2cc91b4e482225b4109b92e949bf...da310cff674aa3d91f7e54772faf828a46071812,1,8,8,16,4,2006-02-27 23:34:39,2006-02-27 23:34:39
da310cff674aa3d91f7e54772faf828a46071812...f15a983d88328f87b35390b827e3a747c6bf181b,1,4,1,5,1,2006-02-27 23:45:17,2006-02-27 23:45:17
f15a983d88328f87b35390b827e3a747c6bf181b...074299db83c065993cadfb96dcccaf5d3080e4c7,1,69,37,106,7,2006-02-28 15:52:57,2006-02-28 15:52:57
074299db83c065993cadfb96dcccaf5d3080e4c7...4a608b48c5b5c8d760f978ad6b18f242a3d3874b,1,12,2,14,4,2006-03-01 02:49:43,2006-03-01 02:49:43
4a608b48c5b5c8d760f978ad6b18f242a3d3874b...3daf7bde2e150c623b80a3a0518196121bd4ea36,4,41,33,74,17,2006-03-01 02:53:00,2006-03-01 02:53:00
3daf7bde2e150c623b80a3a0518196121bd4ea36...85f084de39d03df2152661bb3b070623c88daeca,1,9,0,9,1,2006-03-01 03:12:24,2006-03-01 03:12:24
85f084de39d03df2152661bb3b070623c88daeca...ace140662b2c49d1a544e62d4cd230945d56b62d,1,3,0,3,1,2006-03-01 03:17:24,2006-03-01 03:17:24
ace140662b2c49d1a544e62d4cd230945d56b62d...6330e286c3b739f9e6e2210d6568865cf08cf3e1,5,64,19,83,27,2006-03-01 03:37:57,2006-03-01 03:37:57
6330e286c3b739f9e6e2210d6568865cf08cf3e1...6d9f4e4ef65b6f8678bb3e8a40b784b4819aa97a,1,4,4,8,3,2006-03-01 03:51:55,2006-03-01 03:51:55
6d9f4e4ef65b6f8678bb3e8a40b784b4819aa97a...517b4a93e5f1d37a20e6b9de62eda97ff937e84f,4,529,520,1049,384,2006-03-01 16:54:59,2006-03-01 16:54:59
517b4a93e5f1d37a20e6b9de62eda97ff937e84f...e72a6b194d87fe28314b7fcea690b8c75f16343f,1,0,1,1,1,2006-03-02 05:07:22,2006-03-02 05:07:22
e72a6b194d87fe28314b7fcea690b8c75f16343f...e4b48a8b92c4a1da3904257b40c010682d8a6852,2,2,2,4,2,2006-03-02 05:53:58,2006-03-02 05:53:58
e4b48a8b92c4a1da3904257b40c010682d8a6852...cffd184daf070e5a1ce03d77cab55e0adebb90f8,2,20,20,40,20,2006-03-02 13:51:43,2006-03-02 13:51:43
cffd184daf070e5a1ce03d77cab55e0adebb90f8...5beb39b896d581940ad3681229e87575aa83174d,2,48,7,55,6,2006-03-03 04:53:04,2006-03-03 04:53:04
5beb39b896d581940ad3681229e87575aa83174d...20af3fdd91ea84729e0df4047cabe207dcab906c,1,1,1,2,1,2006-03-10 03:26:31,2006-03-10 03:26:31
20af3fdd91ea84729e0df4047cabe207dcab906c...b6fb43460b658726a6093701fa47012c3f202752,1,1,1,2,1,2006-03-16 02:57:30,2006-03-16 02:57:30
b6fb43460b658726a6093701fa47012c3f202752...a05e05a7f0e9c9c8f1e82e1a637994f14a1ef3b9,1,1,1,2,1,2006-03-16 02:58:25,2006-03-16 02:58:25
a05e05a7f0e9c9c8f1e82e1a637994f14a1ef3b9...426e7223fb7bf1639a3b331ed3818922fafe820c,1,1,1,2,2,2006-03-17 17:21:26,2006-03-17 17:21:26
426e7223fb7bf1639a3b331ed3818922fafe820c...33c4e307f24e4af52430550fd9e444d9add13201,1,2,3,5,2,2006-03-19 23:41:59,2006-03-19 23:41:59
33c4e307f24e4af52430550fd9e444d9add13201...401b83f172d6f2b0da6c67282bd1d93159c61204,1,2,2,4,2,2006-03-20 01:04:09,2006-03-20 01:04:09
401b83f172d6f2b0da6c67282bd1d93159c61204...f21b75a2809cb707dd05835311a714e46a9e4935,5,1866,83,1949,79,2006-03-20 10:35:14,2006-03-20 10:35:14
f21b75a2809cb707dd05835311a714e46a9e4935...732210320a02c11dfa3c41ab133e30b2de1878d4,4,1827,19,1846,22,2006-03-20 10:38:41,2006-03-20 10:38:41
732210320a02c11dfa3c41ab133e30b2de1878d4...ae224efd5460bd926f5468b1b07e0efd38a31842,1,16,15,31,1,2006-03-21 15:32:57,2006-03-21 15:32:57
ae224efd5460bd926f5468b1b07e0efd38a31842...e67f1a680d8780b52c2a1020c37b51c5455b0d4b,1,1,1,2,1,2006-03-21 20:04:24,2006-03-21 20:04:24
e67f1a680d8780b52c2a1020c37b51c5455b0d4b...fe24eca81aee4c75365101430940d2fbb5979bc6,5,56,12,68,18,2006-03-22 19:47:15,2006-03-22 19:47:15
fe24eca81aee4c75365101430940d2fbb5979bc6...5e06181be72001a241b518cbe7c6f5ce6abecb5f,1,5,0,5,2,2006-03-22 23:06:22,2006-03-22 23:06:22
5e06181be72001a241b518cbe7c6f5ce6abecb5f...8b4dc349b6e81cf7dce9d6952f92734022f44874,1,1,1,2,1,2006-03-24 02:28:47,2006-03-24 02:28:47
8b4dc349b6e81cf7dce9d6952f92734022f44874...332c4bd695f6257fa917c02b35f6a9b75cd08341,1,0,1,1,1,2006-03-24 19:13:21,2006-03-24 19:13:21
332c4bd695f6257fa917c02b35f6a9b75cd08341...9494d4b7c2b1beeced1f3a2c981b1f9bc23a9787,1,2,2,4,1,2006-03-27 20:13:59,2006-03-27 20:13:59
9494d4b7c2b1beeced1f3a2c981b1f9bc23a9787...0907a2781b6e00a2fdf601304380f0519fb78d7f,1,3,3,6,1,2006-03-28 16:30:39,2006-03-28 16:30:39
0907a2781b6e00a2fdf601304380f0519fb78d7f...82df62b545cff6dbd901ab3ed429d2a323765625,1,1,1,2,1,2006-03-28 16:32:24,2006-03-28 16:32:24
82df62b545cff6dbd901ab3ed429d2a323765625...1edef8ede964e5dff962b8c9a52e65717dc81fe6,1,12,1,13,1,2006-03-28 16:51:17,2006-03-28 16:51:17
1edef8ede964e5dff962b8c9a52e65717dc81fe6...3ff5b993d361b4a0c8903022d7e894b99696657d,2,31,19,50,8,2006-03-28 17:31:04,2006-03-28 17:31:04
3ff5b993d361b4a0c8903022d7e894b99696657d...67cbb5c248706bc101a6f3b9d65643423b5df1f8,4,43,5,48,6,2006-03-28 17:39:53,2006-03-28 17:39:53
67cbb5c248706bc101a6f3b9d65643423b5df1f8...1d64709080f20230bc9805599d4c14d8330f9ac0,1,237,0,237,1,2006-03-28 17:40:19,2006-03-28 17:40:19
1d64709080f20230bc9805599d4c14d8330f9ac0...b353103cb6a09640c308c5c621ead6e87c231ba7,1,1,1,2,1,2006-03-28 17:46:53,2006-03-28 17:46:53
b353103cb6a09640c308c5c621ead6e87c231ba7...66e04858eb8b5624da1b0e2797ec3aad90410e90,1,10,16,26,4,2006-03-28 21:37:59,2006-03-28 21:37:59
66e04858eb8b5624da1b0e2797ec3aad90410e90...341d1eb022a694a185651af514e65856fed17938,1,1,1,2,1,2006-03-28 21:39:15,2006-03-28 21:39:15
341d1eb022a694a185651af514e65856fed17938...b1599e56b80bbddc314b9e00a315481d8e3b542a,1,2,2,4,2,2006-03-30 04:43:55,2006-03-30 04:43:55
b1599e56b80bbddc314b9e00a315481d8e3b542a...3d8094f8980fc7b689e7563857ff10c44ee5437d,5,1714,3,1717,6,2006-04-06 09:52:06,2006-04-06 09:52:06
3d8094f8980fc7b689e7563857ff10c44ee5437d...158aeb7b97c8b45928f25d922c8f1b1331c08ed8,7,1946,15,1961,19,2006-04-06 09:58:05,2006-04-06 09:58:05
158aeb7b97c8b45928f25d922c8f1b1331c08ed8...b0a60c186ee2a5564b5fa897b994e4ff2b7ad5b2,1,2,2,4,1,2006-04-06 14:20:11,2006-04-06 14:20:11
b0a60c186ee2a5564b5fa897b994e4ff2b7ad5b2...bc4638d722c0e48cfd6bc4d8084b41445f987004,7,43,21,64,16,2006-04-09 23:54:34,2006-04-09 23:54:34
bc4638d722c0e48cfd6bc4d8084b41445f987004...3bb340271ceb5ac398a2386f64f7e903571bc8ac,1,3,3,6,2,2006-04-10 00:01:59,2006-04-10 00:01:59
3bb340271ceb5ac398a2386f64f7e903571bc8ac...bb2a38ceccaaf0f2259ebbba6372a483459d77ac,1,1,1,2,1,2006-04-10 00:12:56,2006-04-10 00:12:56
bb2a38ceccaaf0f2259ebbba6372a483459d77ac...0162a3b54fe5424b0daf60abdb870c4f00d977df,1,1,2,3,1,2006-04-10 00:32:42,2006-04-10 00:32:42
0162a3b54fe5424b0daf60abdb870c4f00d977df...e3e271ff921ba333f03dafe0306b57c59eb9d7e2,5,11,11,22,11,2006-04-10 03:32:38,2006-04-10 03:32:38
e3e271ff921ba333f03dafe0306b57c59eb9d7e2...b8d8aca5fd810cd5906d382e5d2c6d04ed63dffb,6,23,23,46,23,2006-04-10 03:34:47,2006-04-10 03:34:47
b8d8aca5fd810cd5906d382e5d2c6d04ed63dffb...b9e40b14bc6966504da43b8637a83ad1491a877b,4,7,7,14,7,2006-04-10 03:35:56,2006-04-10 03:35:56
b9e40b14bc6966504da43b8637a83ad1491a877b...30c72faa9caeb58409c39c84ef538151c4b34041,2,7,7,14,7,2006-04-10 11:55:52,2006-04-10 11:55:52
30c72faa9caeb58409c39c84ef538151c4b34041...f2aa710f134b2d15cf30df18720f0fc47c14d65b,1,3,0,3,1,2006-04-11 02:59:48,2006-04-11 02:59:48
f2aa710f134b2d15cf30df18720f0fc47c14d65b...cd7dbd8f00b49b5c58838e21a3675d05f86b8ac4,1,7,9,16,7,2006-04-11 03:19:57,2006-04-11 03:19:57
cd7dbd8f00b49b5c58838e21a3675d05f86b8ac4...8d70ed4b25d65df8fe9f2a783f9f2a87bc7aaea1,3,15,1,16,4,2006-04-11 03:23:03,2006-04-11 03:23:03
8d70ed4b25d65df8fe9f2a783f9f2a87bc7aaea1...51a6d81d72114adc3987d33451c5422eb27bf59a,1,7,4,11,5,2006-04-11 03:29:01,2006-04-11 03:29:01
51a6d81d72114adc3987d33451c5422eb27bf59a...8ac114c01777f34f670f2552f3dc4a15b65d45a4,1,0,1,1,1,2006-04-11 03:30:10,2006-04-11 03:30:10
8ac114c01777f34f670f2552f3dc4a15b65d45a4...a0485f5c4f4602f93115e147f780df2811a8380a,1,2,2,4,2,2006-04-11 03:33:19,2006-04-11 03:33:19
a0485f5c4f4602f93115e147f780df2811a8380a...63e7f205952f6759774fc1e3caaaa28a56ae9da8,1,15,6,21,7,2006-04-11 13:43:29,2006-04-11 13:43:29
63e7f205952f6759774fc1e3caaaa28a56ae9da8...c862e43f7fb56b6cf1569c7a27c941eb16ab1c29,1,1,1,2,1,2006-04-12 03:29:41,2006-04-12 03:29:41
c862e43f7fb56b6cf1569c7a27c941eb16ab1c29...853ee34191b6d49bf19743b4ed4feb779ff66f1a,1,3,1,4,2,2006-04-12 03:31:03,2006-04-12 03:31:03
853ee34191b6d49bf19743b4ed4feb779ff66f1a...00b3891524643d0febd2f54a01021c46c103a520,9,11,11,22,11,2006-04-12 13:35:31,2006-04-12 13:35:31
00b3891524643d0febd2f54a01021c46c103a520...4bcdb15091b21e09a92fe73e26d5ef5cc84bff80,1,13,1,14,1,2006-04-13 01:45:15,2006-04-13 01:45:15
4bcdb15091b21e09a92fe73e26d5ef5cc84bff80...0bf620f199536dde61bdb042b99ccb19d87f9615,1,3,0,3,1,2006-04-13 01:46:08,2006-04-13 01:46:08
0bf620f199536dde61bdb042b99ccb19d87f9615...d4c38fa8f7c2d5cb000aa815f27c4b72729b9721,2,112,99,211,92,2006-04-13 11:16:28,2006-04-13 11:16:28
d4c38fa8f7c2d5cb000aa815f27c4b72729b9721...5bb59acfde756c49ff2fac83711cf6d3d225ece5,1,1,1,2,1,2006-04-13 13:16:05,2006-04-13 13:16:05
5bb59acfde756c49ff2fac83711cf6d3d225ece5...40fee1b8f0aa5cab8d2e864465c0488cf8102c64,1,1,1,2,1,2006-04-14 14:17:56,2006-04-14 14:17:56
40fee1b8f0aa5cab8d2e864465c0488cf8102c64...0e40fb14d5c4e9e4559fe11fa031e2ea17b0c3e1,1,4,0,4,2,2006-04-21 16:59:14,2006-04-21 16:59:14
0e40fb14d5c4e9e4559fe11fa031e2ea17b0c3e1...645aaba7116449102dcd7059223097b79e32d4e5,1,1,1,2,1,2006-04-24 01:21:29,2006-04-24 01:21:29
645aaba7116449102dcd7059223097b79e32d4e5...d5dbeaa9be359a4c794885c2e9f1b5a7e5e51fb8,1,0,15,15,1,2006-04-27 22:10:44,2006-04-27 22:10:44
63cf85b64d3cb84e151f1994a6116c17deaefb33...f0dd6b86e11bd0c4c061c1ff1b97436cfa2879bb,0,0,0,0,0,2005-12-09 04:53:58,2005-12-09 04:53:58
f0dd6b86e11bd0c4c061c1ff1b97436cfa2879bb...fb0638a349e554f9a932242777e7a6c10823a1d5,1,136,136,272,11,2005-12-10 05:36:47,2005-12-10 05:36:47
fb0638a349e554f9a932242777e7a6c10823a1d5...69b82e1ca1947687d4a31b2d01d70bd1e2d79889,59,2245,1777,4022,744,2005-12-10 22:19:05,2005-12-10 22:19:05
69b82e1ca1947687d4a31b2d01d70bd1e2d79889...c1be782510a2c6ddca9fdc69f3d26a26f5ff3fbf,21,186,186,372,184,2005-12-11 22:10:02,2005-12-11 22:10:02
c1be782510a2c6ddca9fdc69f3d26a26f5ff3fbf...577ac01250812df71def28d8992ac742e0ae6f34,2,40,1,41,2,2005-12-11 22:22:49,2005-12-11 22:22:49
577ac01250812df71def28d8992ac742e0ae6f34...5f420e14a94ccc0ddb19f678dbb4ce9b58af6d64,1,14,2,16,3,2005-12-11 22:57:14,2005-12-11 22:57:14
5f420e14a94ccc0ddb19f678dbb4ce9b58af6d64...1926ff4b31ff441176e47a01452f063ef50a2d8b,1,319,348,667,12,2005-12-12 01:32:32,2005-12-12 01:32:32
1926ff4b31ff441176e47a01452f063ef50a2d8b...99431aae664a245cc8365571b19e35db063a9fda,1,2,2,4,2,2005-12-12 01:54:02,2005-12-12 01:54:02
99431aae664a245cc8365571b19e35db063a9fda...795ac34f3b7f09853d886afd7c114b688273d1cc,6,87,91,178,48,2005-12-12 02:40:29,2005-12-12 02:40:29
795ac34f3b7f09853d886afd7c114b688273d1cc...c60ac8f480de3e73b89142bf5c060e9d600a5b6b,1,63,70,133,4,2005-12-12 02:56:36,2005-12-12 02:56:36
c60ac8f480de3e73b89142bf5c060e9d600a5b6b...141a5382d88029264920be77a543628419bfca58,2,5,5,10,5,2005-12-12 03:01:57,2005-12-12 03:01:57
141a5382d88029264920be77a543628419bfca58...24cf93457881f185f539d95b4d802c790552bb81,1,5,20,25,6,2005-12-12 03:35:17,2005-12-12 03:35:17
24cf93457881f185f539d95b4d802c790552bb81...82920f423dc3dac3ca60247efb609ae37a82a1c7,1,5,5,10,5,2005-12-12 03:47:34,2005-12-12 03:47:34
82920f423dc3dac3ca60247efb609ae37a82a1c7...030965023732eab0d7e47eb71f05b93cea6fed59,1,1,1,2,1,2005-12-12 03:56:42,2005-12-12 03:56:42
030965023732eab0d7e47eb71f05b93cea6fed59...9b1dd366651f4a8bcdcf2d0a7d578e90dc4db07c,43,0,5,5,1,2005-12-12 04:07:46,2005-12-12 04:07:46
9b1dd366651f4a8bcdcf2d0a7d578e90dc4db07c...750963bfc8c880008c5e4bc77b31e86000002638,1,0,0,0,0,2005-12-12 04:13:59,2005-12-12 04:13:59
750963bfc8c880008c5e4bc77b31e86000002638...683e075a01398cfde4da8a215091e67aade116fc,2,10,9,19,8,2005-12-12 05:40:09,2005-12-12 05:40:09
683e075a01398cfde4da8a215091e67aade116fc...c6cdd4d7f69201698bca5914708303f6c15de2f7,1,2,1,3,1,2005-12-12 05:42:22,2005-12-12 05:42:22
c6cdd4d7f69201698bca5914708303f6c15de2f7...17c2c4362a23bdcaefe216b255a62cbc1a74aaad,2,0,1,1,1,2005-12-12 05:51:32,2005-12-12 05:51:32
17c2c4362a23bdcaefe216b255a62cbc1a74aaad...d0c3aee64caba901aa339138b6de0a976e77ce2c,1,1,1,2,1,2005-12-13 16:17:33,2005-12-13 16:17:33
d0c3aee64caba901aa339138b6de0a976e77ce2c...0438b6848b097ea9ee2dc6eb761c0b49f5775644,1,3,1,4,1,2005-12-13 16:19:40,2005-12-13 16:19:40
0438b6848b097ea9ee2dc6eb761c0b49f5775644...257f7090efab39eaa6aa42641892ebee19db981d,2,18,1,19,3,2005-12-13 16:44:54,2005-12-13 16:44:54
257f7090efab39eaa6aa42641892ebee19db981d...76852e5da14223a95ae817097f3c2df622cfff5d,1,7,6,13,6,2005-12-13 19:48:01,2005-12-13 19:48:01
76852e5da14223a95ae817097f3c2df622cfff5d...d68487e8da7149318881a7ae3ca2bf55f79f435b,1,46,23,69,3,2005-12-14 03:25:04,2005-12-14 03:25:04
d68487e8da7149318881a7ae3ca2bf55f79f435b...bac086ba43358c043ae8fea52d30be80323d829a,2,20,0,20,1,2005-12-14 03:29:58,2005-12-14 03:29:58
bac086ba43358c043ae8fea52d30be80323d829a...8d4f9f73c873471a9ad7c3764790ad7911e19ac3,1,7,1,8,1,2005-12-14 03:36:20,2005-12-14 03:36:20
8d4f9f73c873471a9ad7c3764790ad7911e19ac3...710d865b9d5af1ae1cc5fede02b3a038babef054,1,3,2,5,2,2005-12-14 03:50:46,2005-12-14 03:50:46
710d865b9d5af1ae1cc5fede02b3a038babef054...4cb3e7279c963a62d1cd09f263b037ae54109f8a,1,221,324,545,9,2005-12-14 03:52:29,2005-12-14 03:52:29
4cb3e7279c963a62d1cd09f263b037ae54109f8a...6493164e9147440fc9d3d0d4dcd3cc3111956e5c,1,0,25,25,2,2005-12-14 03:54:11,2005-12-14 03:54:11
6493164e9147440fc9d3d0d4dcd3cc3111956e5c...81bd41f23e92a1f2607429afcf8ac46b01b9f3ae,1,1,39,40,7,2005-12-14 04:03:39,2005-12-14 04:03:39
81bd41f23e92a1f2607429afcf8ac46b01b9f3ae...e8db0b01d250d280d4583922f0b50cbe6296fd94,1,2,24,26,5,2005-12-14 04:19:54,2005-12-14 04:19:54
e8db0b01d250d280d4583922f0b50cbe6296fd94...464b638d9046b2eacea5bfdd570b08aea9663c35,3,1,13,14,8,2005-12-14 04:25:46,2005-12-14 04:25:46
464b638d9046b2eacea5bfdd570b08aea9663c35...746946375ba04f2dc79a6a546c250214552fc249,1,6,9,15,5,2005-12-14 04:27:52,2005-12-14 04:27:52
746946375ba04f2dc79a6a546c250214552fc249...0e5b7d88f2f978b403f9c64a492ebc923686dd44,1,95,95,190,1,2005-12-14 04:30:33,2005-12-14 04:30:33
0e5b7d88f2f978b403f9c64a492ebc923686dd44...16f354236a1b32ed77b483ca5b78522756652b4a,1,1,1,2,1,2005-12-14 04:47:09,2005-12-14 04:47:09
16f354236a1b32ed77b483ca5b78522756652b4a...55933c86e7898cdba4cc471f418cf001bf540b85,1,0,44,44,1,2005-12-14 04:55:15,2005-12-14 04:55:15
55933c86e7898cdba4cc471f418cf001bf540b85...d0fabc0499df1dbba31ba3d5de603d6eb43b484d,39,338,331,669,176,2005-12-14 05:02:51,2005-12-14 05:02:51
d0fabc0499df1dbba31ba3d5de603d6eb43b484d...6928f1849375ce9bb6ea76c82f73099a806e7dc5,13,140,141,281,12,2005-12-14 05:21:44,2005-12-14 05:21:44
6928f1849375ce9bb6ea76c82f73099a806e7dc5...1036a4ae10b68953a17b9dbefa0562fd996dd073,4,0,0,0,0,2005-12-14 05:22:25,2005-12-14 05:22:25
1036a4ae10b68953a17b9dbefa0562fd996dd073...e1bcf1f3114448c8a8f808661aec1e1dfee1ec57,1,0,0,0,0,2005-12-14 05:33:25,2005-12-14 05:33:25
e1bcf1f3114448c8a8f808661aec1e1dfee1ec57...295f00d099473bb00e5b5773291b87c72e143524,2,19,42,61,2,2005-12-14 05:37:28,2005-12-14 05:37:28
295f00d099473bb00e5b5773291b87c72e143524...394ad9aa7fff1f50edf77850898b6800028955eb,9,144,135,279,22,2005-12-14 05:51:47,2005-12-14 05:51:47
394ad9aa7fff1f50edf77850898b6800028955eb...aecff3e2459e0038b7c66fed975b28a6d2829a65,15,356,371,727,170,2005-12-14 06:24:32,2005-12-14 06:24:32
aecff3e2459e0038b7c66fed975b28a6d2829a65...9f6f675e7bb59f618a4940d51c3df7865516c611,5,16,15,31,12,2005-12-14 06:30:14,2005-12-14 06:30:14
9f6f675e7bb59f618a4940d51c3df7865516c611...7be28246ed449ebbcc1f2dcccac9ff91cfd30635,2,0,1,1,1,2005-12-14 06:40:22,2005-12-14 06:40:22
7be28246ed449ebbcc1f2dcccac9ff91cfd30635...31e500d750990121b6a88367719010816bf91101,2,0,1,1,1,2005-12-14 06:40:39,2005-12-14 06:40:39
31e500d750990121b6a88367719010816bf91101...a5489c964e293874b832269028eb112daaefeb7f,1,1,1,2,1,2005-12-14 06:41:10,2005-12-14 06:41:10
a5489c964e293874b832269028eb112daaefeb7f...9027ed6ea635547f73d54f958ec5beed344fa7ee,6,20,21,41,16,2005-12-14 07:02:42,2005-12-14 07:02:42
9027ed6ea635547f73d54f958ec5beed344fa7ee...ebcc0dad23a60e4c8a7894004f168fc40bc119f6,2,0,171,171,1,2005-12-14 18:03:33,2005-12-14 18:03:33
ebcc0dad23a60e4c8a7894004f168fc40bc119f6...af96c19be27941d8e9160f4351d69b9c80c46f52,2,86,0,86,1,2005-12-14 18:41:48,2005-12-14 18:41:48
af96c19be27941d8e9160f4351d69b9c80c46f52...e18d87f84e1b6ce23c411b26aa060ae020244f8c,3,45,20,65,19,2005-12-14 18:49:48,2005-12-14 18:49:48
e18d87f84e1b6ce23c411b26aa060ae020244f8c...47a0ec00f2c564420cd249a1fbff77613e03723f,5,73,67,140,22,2005-12-14 19:07:41,2005-12-14 19:07:41
47a0ec00f2c564420cd249a1fbff77613e03723f...ecc57b0b077bf682787feba06a26a38240d174a3,3,4,4,8,4,2005-12-14 19:12:47,2005-12-14 19:12:47
ecc57b0b077bf682787feba06a26a38240d174a3...765abe8f7076d749d4dc763b35cb1023379a63c3,3,88,63,151,16,2005-12-14 21:30:49,2005-12-14 21:30:49
765abe8f7076d749d4dc763b35cb1023379a63c3...96afbcff435ca4a92801c6341cd6e44f6ad2ac88,2,4,11,15,8,2005-12-14 21:50:37,2005-12-14 21:50:37
96afbcff435ca4a92801c6341cd6e44f6ad2ac88...24c21870826d6619f9a494e7e27c7146f48d64b1,1,20,12,32,11,2005-12-14 22:48:15,2005-12-14 22:48:15
24c21870826d6619f9a494e7e27c7146f48d64b1...2961e0cc584d6e4f5b292b973cef063b7ecd3d9a,1,1,1,2,1,2005-12-14 23:37:21,2005-12-14 23:37:21
2961e0cc584d6e4f5b292b973cef063b7ecd3d9a...2e9a29c307e368c52f606f912a8a00a2fda957d4,1,2,10,12,9,2005-12-14 23:38:31,2005-12-14 23:38:31
2e9a29c307e368c52f606f912a8a00a2fda957d4...13edf04d6c1d3606580eb2ebe700a93198fea4d8,1,1,2,3,1,2005-12-15 00:01:51,2005-12-15 00:01:51
13edf04d6c1d3606580eb2ebe700a93198fea4d8...dac14ee6a45ad3ff9d8cd9293dd159ea1f322b4c,1,3,2,5,2,2005-12-15 00:03:41,2005-12-15 00:03:41
dac14ee6a45ad3ff9d8cd9293dd159ea1f322b4c...867fdd508427570b01ff5046f49667b310cbb720,1,1,1,2,1,2005-12-15 00:12:51,2005-12-15 00:12:51
867fdd508427570b01ff5046f49667b310cbb720...8f696be3b7991e3f98992e13666af4b1a656c1d7,1,6,6,12,4,2005-12-15 00:13:09,2005-12-15 00:13:09
8f696be3b7991e3f98992e13666af4b1a656c1d7...bdb1776a8f60b2998e9e623093987fb6cb520f32,3,9,9,18,7,2005-12-15 00:33:33,2005-12-15 00:33:33
bdb1776a8f60b2998e9e623093987fb6cb520f32...a57b462757fe76679937b6fb35c6f42d912c2f4b,1,0,0,0,0,2005-12-15 00:34:40,2005-12-15 00:34:40
a57b462757fe76679937b6fb35c6f42d912c2f4b...9701daeb7257a576a380ba3579e41b7c5c78b9d9,3,22,20,42,11,2005-12-15 00:47:30,2005-12-15 00:47:30
9701daeb7257a576a380ba3579e41b7c5c78b9d9...036611724ec1b1de018b2f45870d6277caf0ba8d,10,166,164,330,70,2005-12-15 00:53:34,2005-12-15 00:53:34
036611724ec1b1de018b2f45870d6277caf0ba8d...eaeb1acebcf122064bb50b3af4fc1541d1fbd3d5,2,0,1,1,1,2005-12-15 00:55:22,2005-12-15 00:55:22
eaeb1acebcf122064bb50b3af4fc1541d1fbd3d5...a56ba15f73e01b4c24d452a76697b0e973f779cb,2,6,6,12,6,2005-12-15 01:00:22,2005-12-15 01:00:22
a56ba15f73e01b4c24d452a76697b0e973f779cb...2478533c82296c9531b2b5e4ba14043b32c82999,1,2,2,4,1,2005-12-15 01:01:23,2005-12-15 01:01:23
2478533c82296c9531b2b5e4ba14043b32c82999...f34d4fad4b00ad3691301dc871e05ba011403019,2,7,7,14,7,2005-12-15 01:04:23,2005-12-15 01:04:23
f34d4fad4b00ad3691301dc871e05ba011403019...00d434999e71ca2e03635a57fea627af57b34b84,2,0,1,1,1,2005-12-15 01:21:55,2005-12-15 01:21:55
00d434999e71ca2e03635a57fea627af57b34b84...3e294964e9e9d705b6fd2e2be258495937a9c20d,1,0,0,0,0,2005-12-15 01:22:59,2005-12-15 01:22:59
3e294964e9e9d705b6fd2e2be258495937a9c20d...bc1cef4e7b4f5601cc5e2f8543ffb19a3b41a45f,42,3114,2964,6078,668,2005-12-15 03:27:45,2005-12-15 03:27:45
bc1cef4e7b4f5601cc5e2f8543ffb19a3b41a45f...8b857e8044056d627c13885e3100b7d2e9e42503,6,186,51,237,33,2005-12-15 23:26:04,2005-12-15 23:26:04
8b857e8044056d627c13885e3100b7d2e9e42503...263dff0121609d6ebab54b6cc51bee0daeba7183,1,377,212,589,17,2005-12-16 00:01:19,2005-12-16 00:01:19
263dff0121609d6ebab54b6cc51bee0daeba7183...12deb1d793179238939027d76dbff41cd5e51e4d,2,2,2,4,2,2005-12-16 00:07:26,2005-12-16 00:07:26
12deb1d793179238939027d76dbff41cd5e51e4d...e4fb3982a1c50f723bb5f9da55567f26cae351e2,1,9,1,10,4,2005-12-16 01:19:59,2005-12-16 01:19:59
e4fb3982a1c50f723bb5f9da55567f26cae351e2...58f61e03731a3f948e931cd1c1749c250114dc4b,4,40,18,58,13,2005-12-16 01:58:03,2005-12-16 01:58:03
58f61e03731a3f948e931cd1c1749c250114dc4b...7e8b3e7d5e2a96482e090a9c2e6eb8965398f47e,1,4,0,4,1,2005-12-16 02:04:32,2005-12-16 02:04:32
7e8b3e7d5e2a96482e090a9c2e6eb8965398f47e...f6aa8baf5230dc13403cb899471cf6a64cc5e500,1,6,2,8,2,2005-12-16 02:05:12,2005-12-16 02:05:12
f6aa8baf5230dc13403cb899471cf6a64cc5e500...a01eab5049070498788e735bbd0b9175c93332a2,6,319,473,792,36,2005-12-16 02:16:59,2005-12-16 02:16:59
a01eab5049070498788e735bbd0b9175c93332a2...b5be4a4fcce3ffee950935f763657f6d8902f7d7,8,43,24,67,25,2005-12-16 05:05:10,2005-12-16 05:05:10
b5be4a4fcce3ffee950935f763657f6d8902f7d7...b32aca5d8cbf999eedc3e9947d5d8392b13ad2ed,3,8,3,11,6,2005-12-16 05:16:48,2005-12-16 05:16:48
b32aca5d8cbf999eedc3e9947d5d8392b13ad2ed...71f55b68b1947e28b1f233625c83ca8b6d11318d,5,31,8,39,11,2005-12-16 12:07:27,2005-12-16 12:07:27
71f55b68b1947e28b1f233625c83ca8b6d11318d...f013d39c90dd427f7926cf1928a4dc9a9b6b48d3,2,2,2,4,2,2005-12-16 12:12:50,2005-12-16 12:12:50
f013d39c90dd427f7926cf1928a4dc9a9b6b48d3...9394d004db68dcc12ea72030574626c438283eb2,3,373,381,754,7,2005-12-16 12:28:24,2005-12-16 12:28:24
9394d004db68dcc12ea72030574626c438283eb2...e5b3fd474b8dc786ef6bbeb9fc6e59a589192f51,2,267,259,526,8,2005-12-16 12:44:48,2005-12-16 12:44:48
e5b3fd474b8dc786ef6bbeb9fc6e59a589192f51...350e8a3523c34b214b5b1a959353d16a2194caf1,3,251,240,491,6,2005-12-16 13:00:13,2005-12-16 13:00:13
350e8a3523c34b214b5b1a959353d16a2194caf1...6f0861b2561e22f823e62cf9582024c648fb3706,9,934,919,1853,22,2005-12-16 13:49:52,2005-12-16 13:49:52
6f0861b2561e22f823e62cf9582024c648fb3706...7aeeae67eead6cc46c8804c37ad77a7db97b0873,2,35,25,60,10,2005-12-16 15:14:12,2005-12-16 15:14:12
7aeeae67eead6cc46c8804c37ad77a7db97b0873...ecebbb200f7890465e6a2ff13f4f3658066c9137,1,2,2,4,2,2005-12-16 15:24:57,2005-12-16 15:24:57
ecebbb200f7890465e6a2ff13f4f3658066c9137...c86bfac264ca78f7df619c539db2505d895aae25,6,27,14,41,12,2005-12-16 15:51:08,2005-12-16 15:51:08
c86bfac264ca78f7df619c539db2505d895aae25...43b41a75658764bd2ec187bea922f82acbe2d156,8,323,291,614,27,2005-12-16 16:53:27,2005-12-16 16:53:27
43b41a75658764bd2ec187bea922f82acbe2d156...f4dfb99f45bb5f0259a3d9460bb24ddde2c72010,5,122,87,209,38,2005-12-16 19:52:06,2005-12-16 19:52:06
f4dfb99f45bb5f0259a3d9460bb24ddde2c72010...356de17636da7fbdecf68a6f6493cede9345c08b,2,1,4,5,3,2005-12-16 20:24:09,2005-12-16 20:24:09
356de17636da7fbdecf68a6f6493cede9345c08b...b90ad58b96ce72d6e414413dc917b96518a250aa,3,55,6,61,7,2005-12-16 21:32:16,2005-12-16 21:32:16
b90ad58b96ce72d6e414413dc917b96518a250aa...a226ac76020d83a6770102e809c8d2166067ce44,1,3,2,5,2,2005-12-16 22:02:27,2005-12-16 22:02:27
a226ac76020d83a6770102e809c8d2166067ce44...1fbf03112f315634bb3949869cd555e71526609b,2,32,0,32,1,2005-12-16 22:15:07,2005-12-16 22:15:07
1fbf03112f315634bb3949869cd555e71526609b...491d0f0d4bae67a4a4ecbb4515507ca525f97dd6,1,12,14,26,9,2005-12-16 22:36:14,2005-12-16 22:36:14
491d0f0d4bae67a4a4ecbb4515507ca525f97dd6...ef4c387c94094abc9726b47d9fd6590dc40d3c2e,1,19,9,28,11,2005-12-16 23:05:35,2005-12-16 23:05:35
ef4c387c94094abc9726b47d9fd6590dc40d3c2e...e230de4eada5e39841fde1d64706909f3123be6d,1,86,34,120,9,2005-12-16 23:09:10,2005-12-16 23:09:10
e230de4eada5e39841fde1d64706909f3123be6d...9e4a9de0d59b3d947dd386561b723164f838b4d0,1,4,0,4,1,2005-12-16 23:23:07,2005-12-16 23:23:07
9e4a9de0d59b3d947dd386561b723164f838b4d0...f93f58423af2c60ca5b1e8060c80f07e65ce6535,1,1,2,3,2,2005-12-16 23:26:02,2005-12-16 23:26:02
f93f58423af2c60ca5b1e8060c80f07e65ce6535...97bcca5d29b5702e1e5f208f87875d404d2745f8,1,1,0,1,1,2005-12-16 23:26:19,2005-12-16 23:26:19
97bcca5d29b5702e1e5f208f87875d404d2745f8...28023a0adcc570d609168913e4344f713ad5a85a,2,40,41,81,34,2005-12-16 23:34:44,2005-12-16 23:34:44
28023a0adcc570d609168913e4344f713ad5a85a...2a8e8fc75ff26b0ff473c15b4027f697349f07d1,3,64,55,119,25,2005-12-17 02:10:33,2005-12-17 02:10:33
2a8e8fc75ff26b0ff473c15b4027f697349f07d1...4e25fec9f4bcdd13137889a40323fd4a452c36b5,6,749,0,749,6,2005-12-17 02:11:48,2005-12-17 02:11:48
4e25fec9f4bcdd13137889a40323fd4a452c36b5...dbd3869610fef4de75b09837e4ae1a62f440a980,8,82,25,107,29,2005-12-17 03:59:35,2005-12-17 03:59:35
dbd3869610fef4de75b09837e4ae1a62f440a980...bb874b690af8cbc3048e40a8be79703ecb2fc99b,3,119,80,199,56,2005-12-17 15:39:22,2005-12-17 15:39:22
bb874b690af8cbc3048e40a8be79703ecb2fc99b...06332287a8801a22cc5ef88310cc8967a2a89b21,4,60,65,125,53,2005-12-17 19:35:04,2005-12-17 19:35:04
06332287a8801a22cc5ef88310cc8967a2a89b21...4f609faf3f0529655f747ca4aee86c5ae783b845,4,66,20,86,20,2005-12-17 22:31:55,2005-12-17 22:31:55
4f609faf3f0529655f747ca4aee86c5ae783b845...39c6f4fb88c2ed86bf4578c17e01646ff525ffdd,7,53,36,89,27,2005-12-18 00:59:11,2005-12-18 00:59:11
39c6f4fb88c2ed86bf4578c17e01646ff525ffdd...fb66b3733733759f764a7d8ad6099b3c3cd34ccb,1,7,0,7,1,2005-12-18 09:43:53,2005-12-18 09:43:53
fb66b3733733759f764a7d8ad6099b3c3cd34ccb...938f339c82f5edee8fc178e8ae2a4b772451f620,8,28,13,41,15,2005-12-18 19:32:40,2005-12-18 19:32:40
938f339c82f5edee8fc178e8ae2a4b772451f620...10df9db788b1624938c1add0fb77ec0aaa5b09b2,2,7,19,26,12,2005-12-18 20:11:10,2005-12-18 20:11:10
10df9db788b1624938c1add0fb77ec0aaa5b09b2...fc27500389d4376309e782d3e6aa5b6e7031c959,5,67,104,171,70,2005-12-18 20:36:41,2005-12-18 20:36:41
fc27500389d4376309e782d3e6aa5b6e7031c959...5907e9337fcacd5bfe0bd65dc93378a00a86900c,2,43,56,99,45,2005-12-18 20:41:47,2005-12-18 20:41:47
5907e9337fcacd5bfe0bd65dc93378a00a86900c...743b02825eda581e01667bb4f4802436c070b67a,2,70,76,146,17,2005-12-18 21:07:17,2005-12-18 21:07:17
743b02825eda581e01667bb4f4802436c070b67a...3a2c18ac53891ccfebb218d6d0b1b873c498b630,2,3,4,7,3,2005-12-19 03:28:01,2005-12-19 03:28:01
3a2c18ac53891ccfebb218d6d0b1b873c498b630...aea4dfb46d2a3d117dbcda85d3bf4cf23507d69e,1,1,1,2,1,2005-12-19 03:28:43,2005-12-19 03:28:43
aea4dfb46d2a3d117dbcda85d3bf4cf23507d69e...2fb5430f3ade1fcf5e22a435461cb293bc6ed62c,39,2963,2898,5861,481,2005-12-19 03:30:18,2005-12-19 03:30:18
2fb5430f3ade1fcf5e22a435461cb293bc6ed62c...50b5f9da63e729c55c4a8579b2d57202223b7815,4,10,9,19,10,2005-12-19 03:51:43,2005-12-19 03:51:43
50b5f9da63e729c55c4a8579b2d57202223b7815...55d49ed5762faaec9945f2ce4c2c99ef7b24dae5,2,57,0,57,1,2005-12-19 05:42:08,2005-12-19 05:42:08
55d49ed5762faaec9945f2ce4c2c99ef7b24dae5...d42511dba610fb1d8851d1ef2e2c3158ce954f22,12,703,665,1368,21,2005-12-19 12:50:33,2005-12-19 12:50:33
d42511dba610fb1d8851d1ef2e2c3158ce954f22...79b57ab50bb7233e59c47b93b41b603e12b13c6b,1,4,4,8,4,2005-12-19 12:55:48,2005-12-19 12:55:48
79b57ab50bb7233e59c47b93b41b603e12b13c6b...d828a40cb8a30819f56b0797d51aebdc4f27c53c,2,16,15,31,15,2005-12-19 14:32:08,2005-12-19 14:32:08
d828a40cb8a30819f56b0797d51aebdc4f27c53c...f58e704341d254e1cf24e4c8707436ec41b5ca83,1,7,9,16,7,2005-12-19 14:37:03,2005-12-19 14:37:03
f58e704341d254e1cf24e4c8707436ec41b5ca83...3f5f87517948bf32f3bc109a1acf7198b4a57c4f,1,4,5,9,5,2005-12-19 14:49:24,2005-12-19 14:49:24
3f5f87517948bf32f3bc109a1acf7198b4a57c4f...ce2c1bae4877e926967588709ebb97ad703907cd,1,1,0,1,1,2005-12-19 14:52:24,2005-12-19 14:52:24
ce2c1bae4877e926967588709ebb97ad703907cd...c5eed6b3035f003f551d9eb25002effa55a54899,1,9,9,18,9,2005-12-20 16:22:53,2005-12-20 16:22:53
c5eed6b3035f003f551d9eb25002effa55a54899...5d630bcc6045f10e9fce733c4ad33f09294604df,1,35,3,38,3,2005-12-20 17:23:22,2005-12-20 17:23:22
5d630bcc6045f10e9fce733c4ad33f09294604df...5eddd9612d308c5243d3688f9bced7f7b7068016,1,35,36,71,34,2005-12-20 17:23:55,2005-12-20 17:23:55
5eddd9612d308c5243d3688f9bced7f7b7068016...050351c339fae5f0b497875a831c35d07f338cd1,2,4,5,9,5,2005-12-20 22:17:25,2005-12-20 22:17:25
050351c339fae5f0b497875a831c35d07f338cd1...f7c5321964172b72fbfcbc28cccebf7769980ea4,3,17,27,44,8,2005-12-20 22:48:18,2005-12-20 22:48:18
f7c5321964172b72fbfcbc28cccebf7769980ea4...3ee086f80d785d6242292e0b4f3a289cbaec75a1,1,21,20,41,5,2005-12-20 23:52:18,2005-12-20 23:52:18
3ee086f80d785d6242292e0b4f3a289cbaec75a1...d316f6a8cd22285bf0239c22550906b526e45ced,4,10,17,27,7,2005-12-21 00:12:45,2005-12-21 00:12:45
d316f6a8cd22285bf0239c22550906b526e45ced...fe524625edcd585c7ac7f93838cc2025e21c0e8b,1,7,13,20,3,2005-12-21 00:28:36,2005-12-21 00:28:36
fe524625edcd585c7ac7f93838cc2025e21c0e8b...29fe9598e032452a09ace9fa1e6aeb8fb8886321,22,48,48,96,47,2005-12-21 02:42:27,2005-12-21 02:42:27
29fe9598e032452a09ace9fa1e6aeb8fb8886321...f7e66f038d91bfba2ed2aa947d93bfdb5ac88dc1,9,316,66,382,128,2005-12-21 02:49:44,2005-12-21 02:49:44
f7e66f038d91bfba2ed2aa947d93bfdb5ac88dc1...aa9fa3408deb0b9976c64af21d33688f2e84e577,1,9,16,25,6,2005-12-21 02:56:08,2005-12-21 02:56:08
aa9fa3408deb0b9976c64af21d33688f2e84e577...2d4acdc2784c7a6e65294b04a0e2fb3762947735,5,21,12,33,5,2005-12-21 02:58:20,2005-12-21 02:58:20
2d4acdc2784c7a6e65294b04a0e2fb3762947735...7b7d1e8939a8a56df853d27bd8ef842d85434a31,1,3,2,5,1,2005-12-21 03:39:27,2005-12-21 03:39:27
7b7d1e8939a8a56df853d27bd8ef842d85434a31...79ad41be037d4198202005a60ede347198403910,8,173,113,286,33,2005-12-22 15:07:36,2005-12-22 15:07:36
79ad41be037d4198202005a60ede347198403910...a422575d4b9d38aea35da264666dce1add8bec77,8,254,200,454,53,2005-12-22 19:23:34,2005-12-22 19:23:34
a422575d4b9d38aea35da264666dce1add8bec77...df361223205482d793846f4f2875377a76aea328,2,160,132,292,18,2005-12-23 00:02:47,2005-12-23 00:02:47
df361223205482d793846f4f2875377a76aea328...1e36a28d6765d7ddaee0c879ba0b68bc01f64d58,4,53,57,110,21,2005-12-23 01:31:37,2005-12-23 01:31:37
1e36a28d6765d7ddaee0c879ba0b68bc01f64d58...c017d60d15e31dee86a7d154838b353a765ca3a1,6,110,103,213,31,2005-12-23 11:49:54,2005-12-23 11:49:54
c017d60d15e31dee86a7d154838b353a765ca3a1...4d3374c6528ea0f83ffd425b2cb790163069ca27,4,16,5,21,8,2005-12-23 13:40:09,2005-12-23 13:40:09
4d3374c6528ea0f83ffd425b2cb790163069ca27...4bf7d2c81ca20a8a59ea5f064791d9ad866ace56,5,169,107,276,36,2005-12-23 18:02:20,2005-12-23 18:02:20
4bf7d2c81ca20a8a59ea5f064791d9ad866ace56...5c0fe75d448a15455ad8a1013a9099af5559380c,15,415,92,507,60,2005-12-24 04:51:17,2005-12-24 04:51:17
5c0fe75d448a15455ad8a1013a9099af5559380c...2466d9b0f1af014e8915fc4badfd5970f314c819,4,240,262,502,34,2005-12-24 17:54:37,2005-12-24 17:54:37
2466d9b0f1af014e8915fc4badfd5970f314c819...dc5eb659fa64cd3c045cdf02d480a0c49c804fca,3,125,43,168,29,2005-12-26 16:16:11,2005-12-26 16:16:11
dc5eb659fa64cd3c045cdf02d480a0c49c804fca...d382abc8757c4629c314e1ed8854fd06da68e821,3,105,59,164,34,2005-12-29 19:11:00,2005-12-29 19:11:00
d382abc8757c4629c314e1ed8854fd06da68e821...b343704398a81ad96fb9af8e7f9da68c6645f5da,60,5548,1080,6628,993,2005-12-29 19:22:02,2005-12-29 19:22:02
b343704398a81ad96fb9af8e7f9da68c6645f5da...8fae40894ab811aff9f5880d34a07df3bf0ae249,2,46,1,47,3,2005-12-29 20:43:51,2005-12-29 20:43:51
8fae40894ab811aff9f5880d34a07df3bf0ae249...85ef615c42969d92789cd6fc4dada23379618a68,5,137,60,197,21,2005-12-29 21:42:39,2005-12-29 21:42:39
85ef615c42969d92789cd6fc4dada23379618a68...a22a7ff4d09fc481e6e96b3d78d28c297695ca25,3,70,72,142,66,2005-12-30 15:49:20,2005-12-30 15:49:20
a22a7ff4d09fc481e6e96b3d78d28c297695ca25...9d5272d61d33f1027c60699c9886f5da6b5dde29,2,8,8,16,7,2005-12-30 15:51:53,2005-12-30 15:51:53
9d5272d61d33f1027c60699c9886f5da6b5dde29...b72373a7fdb45d26f2833b33f33329390039ba28,3,67,5,72,9,2005-12-30 16:38:26,2005-12-30 16:38:26
b72373a7fdb45d26f2833b33f33329390039ba28...189cb2800fbc8b26af89b1316f05e64d629e1bae,5,45,2,47,4,2005-12-30 23:21:02,2005-12-30 23:21:02
189cb2800fbc8b26af89b1316f05e64d629e1bae...892189357644dbe2223e9a15d5cb3de7015ce392,1,2,5,7,1,2005-12-30 23:22:07,2005-12-30 23:22:07
892189357644dbe2223e9a15d5cb3de7015ce392...c3aa63565005951d2168d1c757f1d76a38a3ebff,1,1,1,2,1,2005-12-30 23:26:46,2005-12-30 23:26:46
c3aa63565005951d2168d1c757f1d76a38a3ebff...76bc09a09ae7dafb5218cecfc21906a9d214a553,1,1,1,2,1,2005-12-30 23:42:57,2005-12-30 23:42:57
76bc09a09ae7dafb5218cecfc21906a9d214a553...029efcd089784289365ec1a85c70b66a8682cc95,5,34,20,54,18,2005-12-31 00:08:49,2005-12-31 00:08:49
029efcd089784289365ec1a85c70b66a8682cc95...d6944788131413bfdc965477f029c8cdf8f84b9f,7,1859,11,1870,9,2005-12-31 04:11:01,2005-12-31 04:11:01
d6944788131413bfdc965477f029c8cdf8f84b9f...1db708d4d76850a02aeeb9dafe36beac641ac7dd,16,543,175,718,48,2006-01-04 17:06:16,2006-01-04 17:06:16
1db708d4d76850a02aeeb9dafe36beac641ac7dd...8d1dbddd75b403fea10b786315015daa7b09d62c,1,9,0,9,1,2006-01-05 14:55:22,2006-01-05 14:55:22
8d1dbddd75b403fea10b786315015daa7b09d62c...776275633222bb6c3ca1fa5166a73bd37602ddfe,1,0,8,8,6,2006-01-05 15:01:25,2006-01-05 15:01:25
776275633222bb6c3ca1fa5166a73bd37602ddfe...d14c5133882433fedec3abc76d35478c99acdf59,1,1,3,4,2,2006-01-05 15:59:17,2006-01-05 15:59:17
d14c5133882433fedec3abc76d35478c99acdf59...078a1cfd3d3ea0be7c80fb7e2a1c4b1ddd23c516,4,117,173,290,69,2006-01-05 16:30:22,2006-01-05 16:30:22
078a1cfd3d3ea0be7c80fb7e2a1c4b1ddd23c516...9033ba7d3634eb469616a4b05f69415774052ace,3,19,22,41,18,2006-01-05 17:28:53,2006-01-05 17:28:53
9033ba7d3634eb469616a4b05f69415774052ace...1885443c8239e09b06330096e15704c0d2779a87,2,14,11,25,12,2006-01-05 21:12:42,2006-01-05 21:12:42
1885443c8239e09b06330096e15704c0d2779a87...38025617313e8a0bfec769466afc21f4a953bc8d,5,22,23,45,18,2006-01-05 21:42:04,2006-01-05 21:42:04
38025617313e8a0bfec769466afc21f4a953bc8d...d975a9267601152cd11055c8a3515bd83c09f6fe,1,1,0,1,1,2006-01-05 21:42:54,2006-01-05 21:42:54
d975a9267601152cd11055c8a3515bd83c09f6fe...f89510c60ca8b6c9a1302174acc7c7daaf8edfdb,1,4,6,10,3,2006-01-05 22:10:41,2006-01-05 22:10:41
f89510c60ca8b6c9a1302174acc7c7daaf8edfdb...d33099252a479059bcaa5282416c24b875e07201,1,1,30,31,4,2006-01-06 19:53:55,2006-01-06 19:53:55
d33099252a479059bcaa5282416c24b875e07201...bb8fb814a68b3db0a79d55003992238dc96f2dd8,4,13,11,24,9,2006-01-06 20:49:38,2006-01-06 20:49:38
bb8fb814a68b3db0a79d55003992238dc96f2dd8...170c4261fbfc99b8c8cdb05b75e40c6e5006e7c3,2,63,0,63,1,2006-01-06 21:04:07,2006-01-06 21:04:07
170c4261fbfc99b8c8cdb05b75e40c6e5006e7c3...617f63a0f696d6d5db240bd4fb696b92563b852f,2,1,60,61,2,2006-01-06 21:06:22,2006-01-06 21:06:22
617f63a0f696d6d5db240bd4fb696b92563b852f...c93965bbefc9d6bceb49f85dd3214ae7544d4b37,1,4,9,13,3,2006-01-06 21:07:15,2006-01-06 21:07:15
c93965bbefc9d6bceb49f85dd3214ae7544d4b37...84b7590ba6e566186bba975e57b0686dd53927ca,9,175,124,299,57,2006-01-06 22:06:22,2006-01-06 22:06:22
84b7590ba6e566186bba975e57b0686dd53927ca...037a6ede40d8bedd01f536a2848e5c07efac112e,1,1,53,54,1,2006-01-06 22:06:50,2006-01-06 22:06:50
037a6ede40d8bedd01f536a2848e5c07efac112e...548ee3795bb4262fe1ec3f47cb450f4c96379994,1,1,1,2,1,2006-01-06 22:10:35,2006-01-06 22:10:35
548ee3795bb4262fe1ec3f47cb450f4c96379994...4e713af1336f80c8ccf21992dca3a8d881f327c5,2,23,0,23,1,2006-01-06 22:18:19,2006-01-06 22:18:19
4e713af1336f80c8ccf21992dca3a8d881f327c5...c4076a43142ede8f1f8d6a0d6be9859bfd0c6f25,1,7,7,14,3,2006-01-06 22:18:50,2006-01-06 22:18:50
c4076a43142ede8f1f8d6a0d6be9859bfd0c6f25...33451f2172674f01c618bfc4e0bd409909f43b35,6,16,29,45,7,2006-01-06 22:29:01,2006-01-06 22:29:01
33451f2172674f01c618bfc4e0bd409909f43b35...1091c18c3999266a1baa329911ffee856b32eca9,2,32,10,42,5,2006-01-06 22:45:00,2006-01-06 22:45:00
1091c18c3999266a1baa329911ffee856b32eca9...62ee6fac3ba556ae632b8c2700bce8d36d6a5b98,1,222,0,222,1,2006-01-06 23:37:54,2006-01-06 23:37:54
62ee6fac3ba556ae632b8c2700bce8d36d6a5b98...4d6ab8b3080924531f07ff35385b781fdbf36804,8,14,234,248,13,2006-01-06 23:42:07,2006-01-06 23:42:07
4d6ab8b3080924531f07ff35385b781fdbf36804...fbb47dbd9d22f85edcf403caad46e2e7c9f03fb0,1,10,7,17,8,2006-01-06 23:43:20,2006-01-06 23:43:20
fbb47dbd9d22f85edcf403caad46e2e7c9f03fb0...d22d53caf06e7b76bbdc2b772bb316dfdc236be0,1,2,1,3,2,2006-01-06 23:51:31,2006-01-06 23:51:31
d22d53caf06e7b76bbdc2b772bb316dfdc236be0...b23b39342bbfc784bc1f160e2c6fdc2f849486ec,6,8,3,11,5,2006-01-08 05:56:45,2006-01-08 05:56:45
b23b39342bbfc784bc1f160e2c6fdc2f849486ec...2bc39d88e60ab9b9fa8e0b31e1af107c24cecfa6,1,12,8,20,1,2006-01-08 06:04:44,2006-01-08 06:04:44
2bc39d88e60ab9b9fa8e0b31e1af107c24cecfa6...f998c7bcc6d6b42b98bc3ca8e65b70b023bd3bea,7,335,174,509,25,2006-01-08 06:16:05,2006-01-08 06:16:05
f998c7bcc6d6b42b98bc3ca8e65b70b023bd3bea...ea35b35a14f686e13e5484b4f0a2ca0fab8f51d2,1,1,0,1,1,2006-01-08 13:17:36,2006-01-08 13:17:36
ea35b35a14f686e13e5484b4f0a2ca0fab8f51d2...8c07571a1588108c297cb8a556b260dac0c34328,1,6,5,11,5,2006-01-08 15:10:08,2006-01-08 15:10:08
8c07571a1588108c297cb8a556b260dac0c34328...1b0ccdce177572f19cd4cf3bfd62fb9823c4a259,10,83,89,172,19,2006-01-08 15:56:51,2006-01-08 15:56:51
1b0ccdce177572f19cd4cf3bfd62fb9823c4a259...ca4aaca109859769fddd22df47f6b9f950a44642,3,4,4,8,3,2006-01-08 18:28:38,2006-01-08 18:28:38
ca4aaca109859769fddd22df47f6b9f950a44642...2b8f54fa33b98d914bd3a8d8f4c66f8004335452,1,1,1,2,1,2006-01-09 00:33:13,2006-01-09 00:33:13
2b8f54fa33b98d914bd3a8d8f4c66f8004335452...49fa5cbf1f8699b06a61f604eb14bf17310228ad,1,1,1,2,1,2006-01-09 00:40:41,2006-01-09 00:40:41
49fa5cbf1f8699b06a61f604eb14bf17310228ad...5df59f478e1b4fbeaec8e797856012eeb1500102,12,108,59,167,51,2006-01-09 00:55:23,2006-01-09 00:55:23
5df59f478e1b4fbeaec8e797856012eeb1500102...aa2da5f4debef9ea0ff00be4a93dc9b9edc5e115,1,1,0,1,1,2006-01-09 01:25:10,2006-01-09 01:25:10
aa2da5f4debef9ea0ff00be4a93dc9b9edc5e115...1994ebb811bd5f8f648e700dd8cce0781b07e426,1,1,1,2,1,2006-01-09 01:38:19,2006-01-09 01:38:19
1994ebb811bd5f8f648e700dd8cce0781b07e426...8b1662a185d2c8b61b312e96c6269097c4b5ecbc,1,13,4,17,5,2006-01-09 01:48:02,2006-01-09 01:48:02
8b1662a185d2c8b61b312e96c6269097c4b5ecbc...e9a13940d3f45e7b6696fad396356701a85ccf94,2,6,2,8,3,2006-01-09 01:57:26,2006-01-09 01:57:26
e9a13940d3f45e7b6696fad396356701a85ccf94...dde6963869ba4a72b100daedd66470e080f99b75,5,135,41,176,35,2006-01-09 11:01:38,2006-01-09 11:01:38
dde6963869ba4a72b100daedd66470e080f99b75...0389e6261b4b5b07a993470146b3c59ff478e56a,3,28,17,45,7,2006-01-09 14:34:17,2006-01-09 14:34:17
0389e6261b4b5b07a993470146b3c59ff478e56a...24f8e94563010623438c5aacc577f00d3042e1e4,2,41,0,41,1,2006-01-09 18:07:01,2006-01-09 18:07:01
24f8e94563010623438c5aacc577f00d3042e1e4...6cdb3c57d812984c4d1d762b680b319dd45e1bf4,6,8,8,16,8,2006-01-09 18:20:06,2006-01-09 18:20:06
6cdb3c57d812984c4d1d762b680b319dd45e1bf4...e65f2266239bc63d313a81522e82fe66ea15aeda,1,12,7,19,5,2006-01-09 18:23:30,2006-01-09 18:23:30
e65f2266239bc63d313a81522e82fe66ea15aeda...af1f95bc3131f6aad60926eaeaa1b85a41f24f84,1,4,0,4,1,2006-01-09 18:29:34,2006-01-09 18:29:34
af1f95bc3131f6aad60926eaeaa1b85a41f24f84...78abbaff9b1c151a77c8410bb691490457e8376a,1,1,1,2,1,2006-01-09 18:31:39,2006-01-09 18:31:39
78abbaff9b1c151a77c8410bb691490457e8376a...945cae9aae5f74c4d734389ba2a2539bda137f7c,1,0,43,43,1,2006-01-09 18:33:14,2006-01-09 18:33:14
945cae9aae5f74c4d734389ba2a2539bda137f7c...f5bca3255365c35f2d14554cb55a7123f7441a97,1,2,2,4,2,2006-01-09 20:28:05,2006-01-09 20:28:05
f5bca3255365c35f2d14554cb55a7123f7441a97...67a3f9d0c518efe9cef8110ae23efdd7675b5730,1,7,7,14,4,2006-01-09 20:39:45,2006-01-09 20:39:45
67a3f9d0c518efe9cef8110ae23efdd7675b5730...3215cc769b2f3a829904d618fbea8cce3871a63b,1,2,2,4,1,2006-01-09 21:00:39,2006-01-09 21:00:39
3215cc769b2f3a829904d618fbea8cce3871a63b...8f42a9246580dc11e8c1975eb364816495ba488c,1,2,1,3,1,2006-01-09 22:15:46,2006-01-09 22:15:46
8f42a9246580dc11e8c1975eb364816495ba488c...8013f76a40270283f9d3c04160ac9b8a72ffe2be,22,267,219,486,113,2006-01-11 05:07:38,2006-01-11 05:07:38
8013f76a40270283f9d3c04160ac9b8a72ffe2be...36566e0ab1b9bae3985d0f7559a152716aa2789b,30,57,55,112,53,2006-01-11 21:45:38,2006-01-11 21:45:38
36566e0ab1b9bae3985d0f7559a152716aa2789b...7e3abb4c3550bce885a7244d057982fd4bdfd1a0,1,1,1,2,1,2006-01-11 21:46:32,2006-01-11 21:46:32
7e3abb4c3550bce885a7244d057982fd4bdfd1a0...1c989f59d4ec2c4926a809c82a2cc9e8128b03d3,6,11,11,22,11,2006-01-11 21:46:50,2006-01-11 21:46:50
1c989f59d4ec2c4926a809c82a2cc9e8128b03d3...7ff20316f01fa8447840c1d0119a8bb4398de129,19,33,28,61,24,2006-01-11 21:57:59,2006-01-11 21:57:59
7ff20316f01fa8447840c1d0119a8bb4398de129...c4b139eabd33613f928395c168aeee05a645ad5d,2,3,4,7,4,2006-01-11 21:58:40,2006-01-11 21:58:40
c4b139eabd33613f928395c168aeee05a645ad5d...5aa3c38b1b6d6a55dd898c0936b867a5419476f9,1,0,95,95,1,2006-01-11 22:03:02,2006-01-11 22:03:02
5aa3c38b1b6d6a55dd898c0936b867a5419476f9...02f03e7b93e4c470a107be277be0640893a7998c,1,1,1,2,1,2006-01-11 22:15:07,2006-01-11 22:15:07
02f03e7b93e4c470a107be277be0640893a7998c...0e66c7adec18944494b3aff3372d24abb3786194,1,0,1,1,1,2006-01-11 23:47:32,2006-01-11 23:47:32
0e66c7adec18944494b3aff3372d24abb3786194...6fb7423bb025c7043af06f5bcd2714b26c80a0a6,4,87,104,191,88,2006-01-13 03:24:07,2006-01-13 03:24:07
6fb7423bb025c7043af06f5bcd2714b26c80a0a6...df36b25d65d5fd5bffb113b805fcbce2a20ec6c6,1,4,5,9,3,2006-01-13 03:34:55,2006-01-13 03:34:55
df36b25d65d5fd5bffb113b805fcbce2a20ec6c6...b2e4952f0240c657f628f11489c70c5240f4adb9,3,1,1,2,1,2006-01-13 03:42:26,2006-01-13 03:42:26
b2e4952f0240c657f628f11489c70c5240f4adb9...41511cc3bdde3ec304134f1e82210c8b4d4872f3,4,4,4,8,4,2006-01-13 03:53:45,2006-01-13 03:53:45
41511cc3bdde3ec304134f1e82210c8b4d4872f3...5e57f795b5a27bca6aa8c3c9c26f14c516199e58,1,1,0,1,1,2006-01-13 04:14:05,2006-01-13 04:14:05
5e57f795b5a27bca6aa8c3c9c26f14c516199e58...22260f968c00753e1b5a748506f90e40c4b52a53,2,2,2,4,2,2006-01-13 04:21:55,2006-01-13 04:21:55
22260f968c00753e1b5a748506f90e40c4b52a53...a9297c7a5d5db146961dcc55d250a4ec8d860f4c,3,12,27,39,12,2006-01-13 04:26:28,2006-01-13 04:26:28
a9297c7a5d5db146961dcc55d250a4ec8d860f4c...e31e75c736f9d90fbaf805b0e9889651157b8367,2,9,9,18,3,2006-01-13 04:54:25,2006-01-13 04:54:25
e31e75c736f9d90fbaf805b0e9889651157b8367...b6954b5ffccaca7d0c99c1d6c918e9b6b389c56b,1,125,36,161,5,2006-01-13 17:22:44,2006-01-13 17:22:44
b6954b5ffccaca7d0c99c1d6c918e9b6b389c56b...96116f60b4a763eaaaa76fcbeda28ef027f20630,36,2678,101,2779,112,2006-01-13 17:35:02,2006-01-13 17:35:02
96116f60b4a763eaaaa76fcbeda28ef027f20630...7f354d91de72a48d0c5ebf77593ea7069ecfe052,9,0,2558,2558,8,2006-01-13 17:36:03,2006-01-13 17:36:03
7f354d91de72a48d0c5ebf77593ea7069ecfe052...fe02b0e99860612c9dc11e5e23592b966410984f,3,4,4,8,3,2006-01-13 17:36:53,2006-01-13 17:36:53
fe02b0e99860612c9dc11e5e23592b966410984f...58c97d988476b5f1204ebba42f97466259f1820b,3,21,21,42,21,2006-01-13 17:37:10,2006-01-13 17:37:10
58c97d988476b5f1204ebba42f97466259f1820b...5a54e18f9be7fac894b394336bb7ad86dce4c3ee,4,10,10,20,10,2006-01-13 17:46:02,2006-01-13 17:46:02
5a54e18f9be7fac894b394336bb7ad86dce4c3ee...042d1df0e74d2434a5dd2c40e766240d26d9b206,23,164,156,320,68,2006-01-13 18:26:57,2006-01-13 18:26:57
042d1df0e74d2434a5dd2c40e766240d26d9b206...9a9e2730bc9c5a5dbf087db7e5a24e8300bb7ea9,6,27,27,54,26,2006-01-13 18:27:40,2006-01-13 18:27:40
9a9e2730bc9c5a5dbf087db7e5a24e8300bb7ea9...e1575ace03772d8107b9a227cebfe1106c325ca6,4,65,80,145,76,2006-01-13 21:37:22,2006-01-13 21:37:22
e1575ace03772d8107b9a227cebfe1106c325ca6...c50968fa0e468d5c581d66d6f8728192f54fe605,1,3,3,6,2,2006-01-13 21:39:03,2006-01-13 21:39:03
c50968fa0e468d5c581d66d6f8728192f54fe605...aba6d189d30dd2f9dd16d1597bca6425309fa4cd,14,89,85,174,82,2006-01-13 22:55:05,2006-01-13 22:55:05
aba6d189d30dd2f9dd16d1597bca6425309fa4cd...9ab24d493935a5d13d142bdf7c1973567f64c1ab,1,17,16,33,13,2006-01-13 22:55:40,2006-01-13 22:55:40
9ab24d493935a5d13d142bdf7c1973567f64c1ab...90baed7dd5257df0dd2a0a0cfa4210ddc02d0303,1,2,1,3,2,2006-01-13 22:57:20,2006-01-13 22:57:20
90baed7dd5257df0dd2a0a0cfa4210ddc02d0303...1edaa09f25ba5d548a3ae1d84a4694e9fe439969,2,3,3,6,2,2006-01-14 19:32:47,2006-01-14 19:32:47
1edaa09f25ba5d548a3ae1d84a4694e9fe439969...3d293b51447c0ad9abb4ada7acf5ff81e94e72d0,1,2,2,4,2,2006-01-15 00:04:24,2006-01-15 00:04:24
3d293b51447c0ad9abb4ada7acf5ff81e94e72d0...0b5043832b1cb11aa81e70246bbe12e8e44cbd7a,70,1066,738,1804,433,2006-01-15 00:14:41,2006-01-15 00:14:41
0b5043832b1cb11aa81e70246bbe12e8e44cbd7a...08f032f6b5e4e0ef6fcec59c687055e38cbe7561,5,22,7,29,9,2006-01-15 00:53:19,2006-01-15 00:53:19
08f032f6b5e4e0ef6fcec59c687055e38cbe7561...2cfb709ac29cc3999ce11a92c73476f3808a17cf,5,53,0,53,6,2006-01-15 01:54:32,2006-01-15 01:54:32
2cfb709ac29cc3999ce11a92c73476f3808a17cf...974316939a0dc86feaab7c8c40ce03ccca1f98dc,5,13,9,22,7,2006-01-15 05:55:48,2006-01-15 05:55:48
974316939a0dc86feaab7c8c40ce03ccca1f98dc...6e664fe071dd26fa8089ee6a8795a694eab7355a,2,3,2,5,3,2006-01-15 06:04:29,2006-01-15 06:04:29
6e664fe071dd26fa8089ee6a8795a694eab7355a...34c587e81e28dcd3cb0df1c98c25ac64ae17b4ff,2,2,2,4,2,2006-01-15 06:11:14,2006-01-15 06:11:14
34c587e81e28dcd3cb0df1c98c25ac64ae17b4ff...c86d34a935519aa59b3c04b0845f6c8a6ef80fbd,2,10,8,18,2,2006-01-15 06:18:15,2006-01-15 06:18:15
c86d34a935519aa59b3c04b0845f6c8a6ef80fbd...06309ba8fe5318ec5695019bc0659db324184715,1,1,1,2,1,2006-01-15 06:22:58,2006-01-15 06:22:58
06309ba8fe5318ec5695019bc0659db324184715...f15ce2d82018f19130d2d9d350a4f910351b6eab,3,10,10,20,10,2006-01-15 06:30:21,2006-01-15 06:30:21
f15ce2d82018f19130d2d9d350a4f910351b6eab...e12eaa7e41d2445ba9816f9d3bf8b568c2039a88,1,2,2,4,1,2006-01-16 14:49:36,2006-01-16 14:49:36
e12eaa7e41d2445ba9816f9d3bf8b568c2039a88...c2b68f5c26205eab39564111f5157cbd3cf5ecd5,2,9,9,18,8,2006-01-16 14:54:15,2006-01-16 14:54:15
c2b68f5c26205eab39564111f5157cbd3cf5ecd5...aad6c20978f497abe36bb8bba4a15fefe0c5bc84,1,4,4,8,4,2006-01-16 14:55:34,2006-01-16 14:55:34
aad6c20978f497abe36bb8bba4a15fefe0c5bc84...42350ba71a1b27a040db8345872d0618623465c1,1,2,2,4,2,2006-01-16 14:58:24,2006-01-16 14:58:24
42350ba71a1b27a040db8345872d0618623465c1...bae1f6815b36e08b7c4ee64aeb6fd6bde9b2de12,1,2,2,4,1,2006-01-16 14:59:40,2006-01-16 14:59:40
bae1f6815b36e08b7c4ee64aeb6fd6bde9b2de12...22012296bd07d3dcba116743381fbe57658cabdd,1,4,4,8,3,2006-01-16 15:00:42,2006-01-16 15:00:42
22012296bd07d3dcba116743381fbe57658cabdd...91f21f06416a30a9aebfce8a3d7199ec0f77a5b3,1,4,4,8,4,2006-01-16 15:01:26,2006-01-16 15:01:26
91f21f06416a30a9aebfce8a3d7199ec0f77a5b3...f53492df565ad91e18973a57fb940258bc21982d,1,2,2,4,1,2006-01-16 15:02:02,2006-01-16 15:02:02
f53492df565ad91e18973a57fb940258bc21982d...0aca6e1d1d12f3e7f466ff1dcaddaccf85478c0a,1,2,2,4,2,2006-01-16 15:02:57,2006-01-16 15:02:57
0aca6e1d1d12f3e7f466ff1dcaddaccf85478c0a...abeb5681b46b649c29880a7a7c5823bfa670c56e,2,4,4,8,4,2006-01-16 15:04:06,2006-01-16 15:04:06
abeb5681b46b649c29880a7a7c5823bfa670c56e...596ee7e14b5f2f0ce175188498ebecc003c45aff,2,11,13,24,11,2006-01-16 15:07:24,2006-01-16 15:07:24
596ee7e14b5f2f0ce175188498ebecc003c45aff...c1fbb8682c276d2e86c50cea1bbdf62779550985,8,36,37,73,36,2006-01-16 15:15:42,2006-01-16 15:15:42
c1fbb8682c276d2e86c50cea1bbdf62779550985...cdef2c15dfa6fcfab5703215564d6de5fbe59ed8,5,37,37,74,21,2006-01-16 15:19:18,2006-01-16 15:19:18
cdef2c15dfa6fcfab5703215564d6de5fbe59ed8...179beccfead660513cd3f2a8f4554d78187746df,1,2,2,4,1,2006-01-16 15:20:38,2006-01-16 15:20:38
179beccfead660513cd3f2a8f4554d78187746df...02ea6a4074481de81286af4b191768a65395f383,1,5,5,10,5,2006-01-16 15:22:01,2006-01-16 15:22:01
02ea6a4074481de81286af4b191768a65395f383...ba787be1af4fe3d86fc5cb7055aea73d9cea4565,1,2,2,4,1,2006-01-16 15:22:40,2006-01-16 15:22:40
ba787be1af4fe3d86fc5cb7055aea73d9cea4565...c5e944a7e273e40723a0240e41c413ea971329f5,1,2,2,4,1,2006-01-16 15:23:15,2006-01-16 15:23:15
c5e944a7e273e40723a0240e41c413ea971329f5...e3ecd5eeb40a233eb954b34518f862e44faffa84,1,4,4,8,4,2006-01-16 15:24:06,2006-01-16 15:24:06
e3ecd5eeb40a233eb954b34518f862e44faffa84...307b95b45bdcfaf8f6188d2d7855053cb682fe6a,1,4,4,8,2,2006-01-16 15:24:37,2006-01-16 15:24:37
307b95b45bdcfaf8f6188d2d7855053cb682fe6a...679b8f0d0698a3d7fb34b6d6ea1c0a68df7152eb,1,5,7,12,5,2006-01-16 15:26:10,2006-01-16 15:26:10
679b8f0d0698a3d7fb34b6d6ea1c0a68df7152eb...41e36aba9569d295f2fe77245bb5f88141687166,1,6,6,12,5,2006-01-16 15:27:30,2006-01-16 15:27:30
41e36aba9569d295f2fe77245bb5f88141687166...2221cdabff9f3d802b5321fb580b35d648d65c9e,9,25,26,51,25,2006-01-16 15:34:03,2006-01-16 15:34:03
2221cdabff9f3d802b5321fb580b35d648d65c9e...d6bf53760b4e39248e1e2f622a569be7484545ea,8,183,262,445,103,2006-01-16 18:56:44,2006-01-16 18:56:44
d6bf53760b4e39248e1e2f622a569be7484545ea...b02bb933fd6a60f9634fbb436242fec8980937bf,1,25,0,25,1,2006-01-16 19:00:24,2006-01-16 19:00:24
b02bb933fd6a60f9634fbb436242fec8980937bf...f2370573bc5138c86776de27d848c731ff1f754c,2,4,4,8,4,2006-01-16 21:45:27,2006-01-16 21:45:27
f2370573bc5138c86776de27d848c731ff1f754c...1eacb0f6ed09614f21a6836102f9ba07b27afa32,7,15,28,43,20,2006-01-16 23:11:12,2006-01-16 23:11:12
1eacb0f6ed09614f21a6836102f9ba07b27afa32...90ff521e4edc371da00ca04e587505746ff97e90,1,2,5,7,2,2006-01-16 23:27:59,2006-01-16 23:27:59
90ff521e4edc371da00ca04e587505746ff97e90...2a04bb9b583a4c4fa7ce455c0bbd2ebc51bbbac2,1,5,5,10,3,2006-01-16 23:35:09,2006-01-16 23:35:09
2a04bb9b583a4c4fa7ce455c0bbd2ebc51bbbac2...ae4f89436f140361c9f6c5ef1cfa7875df8991f5,1,5,4,9,3,2006-01-16 23:44:06,2006-01-16 23:44:06
ae4f89436f140361c9f6c5ef1cfa7875df8991f5...fd44a02a1ade59fd39c54635dfa7c9f5082ffbda,2,1,2,3,2,2006-01-16 23:44:16,2006-01-16 23:44:16
fd44a02a1ade59fd39c54635dfa7c9f5082ffbda...40d478226301f4e5e13dd38bc0d4d81957afceb8,1,3,5,8,3,2006-01-16 23:52:20,2006-01-16 23:52:20
40d478226301f4e5e13dd38bc0d4d81957afceb8...ad0b474a8b0ff663eec107cccd3ce639c465af61,1,0,1,1,1,2006-01-17 00:03:15,2006-01-17 00:03:15
ad0b474a8b0ff663eec107cccd3ce639c465af61...a0433627a002570aaf130d68d702308e7d43cc3d,1,4,4,8,2,2006-01-17 00:06:47,2006-01-17 00:06:47
a0433627a002570aaf130d68d702308e7d43cc3d...8816af671441c0d1f42d5411a543c66a632397eb,1,1,1,2,1,2006-01-17 00:44:06,2006-01-17 00:44:06
8816af671441c0d1f42d5411a543c66a632397eb...c7fc2bfb68393846797f47c634470a6392f010de,1,3,3,6,3,2006-01-17 05:21:23,2006-01-17 05:21:23
c7fc2bfb68393846797f47c634470a6392f010de...5dda10f2ef67f85d7a716141d1b88b5a19cebdd2,1,1,2,3,1,2006-01-17 05:27:02,2006-01-17 05:27:02
5dda10f2ef67f85d7a716141d1b88b5a19cebdd2...d9780b7bd569e066d7fa8b5dc87c4fec26e0900b,1,1,7,8,2,2006-01-17 05:30:16,2006-01-17 05:30:16
d9780b7bd569e066d7fa8b5dc87c4fec26e0900b...00f93bc7bb47b626691a096e4bbc908c597a31ca,3,39,9,48,13,2006-01-17 12:06:16,2006-01-17 12:06:16
00f93bc7bb47b626691a096e4bbc908c597a31ca...c983ab3e16cf74516fbb622037c9c3557f3afba0,2,4,2,6,2,2006-01-17 12:47:12,2006-01-17 12:47:12
c983ab3e16cf74516fbb622037c9c3557f3afba0...464271a273d3090138671484b6fdaf455ea4f45d,3,76,80,156,5,2006-01-17 14:19:10,2006-01-17 14:19:10
464271a273d3090138671484b6fdaf455ea4f45d...05c3097f0f1647fa136d0ac2785d191ada617ced,4,19,62,81,20,2006-01-17 17:23:18,2006-01-17 17:23:18
05c3097f0f1647fa136d0ac2785d191ada617ced...f1cf65c7bc4e9f7e57ba6d3eb9fb0dc4d5e12569,1,1,1,2,1,2006-01-17 17:45:40,2006-01-17 17:45:40
f1cf65c7bc4e9f7e57ba6d3eb9fb0dc4d5e12569...6074e49daa664a4cfef83d08b591c3a22537ecc6,1,10,6,16,3,2006-01-17 17:57:27,2006-01-17 17:57:27
6074e49daa664a4cfef83d08b591c3a22537ecc6...51d2de6a56aaf573cce814960c62e11c741bc677,1,6,13,19,5,2006-01-17 19:18:24,2006-01-17 19:18:24
51d2de6a56aaf573cce814960c62e11c741bc677...6e8d06572a6b193b4ac0023482b3355a6f1f462b,2,1,32,33,6,2006-01-17 19:27:27,2006-01-17 19:27:27
6e8d06572a6b193b4ac0023482b3355a6f1f462b...5c970704fe2d7c46b150087e718d4ab3678d2718,5,27,27,54,26,2006-01-17 20:00:30,2006-01-17 20:00:30
5c970704fe2d7c46b150087e718d4ab3678d2718...c85e3d4a2ab293ade98209b20fa2b3afc2e65aaa,1,24,2,26,6,2006-01-17 21:55:07,2006-01-17 21:55:07
c85e3d4a2ab293ade98209b20fa2b3afc2e65aaa...7592ca69afdc6f82667fb62d26db154d07d3d43a,1,38,48,86,10,2006-01-17 22:01:14,2006-01-17 22:01:14
7592ca69afdc6f82667fb62d26db154d07d3d43a...795e6cbcf2dba659330577d7a1550d66f134065c,6,14,39,53,24,2006-01-17 22:24:39,2006-01-17 22:24:39
795e6cbcf2dba659330577d7a1550d66f134065c...c4e2e4e881dd5520d6c5cea2ee4d441f60f5ccae,15,468,505,973,29,2006-01-17 22:57:50,2006-01-17 22:57:50
c4e2e4e881dd5520d6c5cea2ee4d441f60f5ccae...a4e14b451cf980745243e79ea98e2a33f62ce856,1,6,6,12,6,2006-01-17 23:05:22,2006-01-17 23:05:22
a4e14b451cf980745243e79ea98e2a33f62ce856...c2d468095da55be47da8f1ffb951603c240d740a,1,8,20,28,3,2006-01-18 01:52:28,2006-01-18 01:52:28
c2d468095da55be47da8f1ffb951603c240d740a...186c09d96f301ef9430e301fc76f3358cdf9a088,2,19,1,20,4,2006-01-18 13:16:58,2006-01-18 13:16:58
186c09d96f301ef9430e301fc76f3358cdf9a088...5f2ffee66e4480a695d3a718a5c9922371e6c731,1,16,0,16,1,2006-01-18 13:25:13,2006-01-18 13:25:13
5f2ffee66e4480a695d3a718a5c9922371e6c731...471bae17fad0d4864035c8dcd18a5ee6e705c510,13,12,12,24,12,2006-01-18 19:02:35,2006-01-18 19:02:35
471bae17fad0d4864035c8dcd18a5ee6e705c510...9f4d2d5d27d5c0863f9899d603cdb0f4ccca8bf8,3,4,4,8,4,2006-01-18 19:03:19,2006-01-18 19:03:19
9f4d2d5d27d5c0863f9899d603cdb0f4ccca8bf8...f1a33994f42e7be5178cb71411448d3c263b5cb4,1,2,4,6,4,2006-01-19 00:32:47,2006-01-19 00:32:47
f1a33994f42e7be5178cb71411448d3c263b5cb4...41e788c17aa6a62a9d01722ff8498040cc0a7f35,1,2,6,8,3,2006-01-19 00:40:56,2006-01-19 00:40:56
41e788c17aa6a62a9d01722ff8498040cc0a7f35...85951a64b8303bb6d108dfc98e27851e0b865ff3,1,15,17,32,3,2006-01-19 00:43:22,2006-01-19 00:43:22
85951a64b8303bb6d108dfc98e27851e0b865ff3...a4ead45cb25681466a771360dddc7c59ad8f3116,1,3,3,6,3,2006-01-19 00:44:56,2006-01-19 00:44:56
a4ead45cb25681466a771360dddc7c59ad8f3116...58605bcfe3ed23653ebad0dbe344f7eece6ebb26,5,177,151,328,20,2006-01-19 00:55:18,2006-01-19 00:55:18
58605bcfe3ed23653ebad0dbe344f7eece6ebb26...233254d63455b05dbfb9aa2ce81b83d7d1ae2586,6,30,33,63,16,2006-01-19 01:09:28,2006-01-19 01:09:28
233254d63455b05dbfb9aa2ce81b83d7d1ae2586...8a140005ff904fa683fcaa7d287305dd90996f84,1,1,5,6,2,2006-01-19 02:29:40,2006-01-19 02:29:40
8a140005ff904fa683fcaa7d287305dd90996f84...71e2df77d3cf6b82c8cba1c810195158bfd5d716,5,239,303,542,28,2006-01-19 03:06:01,2006-01-19 03:06:01
71e2df77d3cf6b82c8cba1c810195158bfd5d716...06d23144bc4fb45468540e62ab1464a79782376c,4,5,21,26,4,2006-01-19 03:12:40,2006-01-19 03:12:40
06d23144bc4fb45468540e62ab1464a79782376c...aa4039a4c52f3955f02d127978279d386ceb7fcb,2,2,2,4,2,2006-01-19 03:21:29,2006-01-19 03:21:29
aa4039a4c52f3955f02d127978279d386ceb7fcb...6a91c0d55819cb1032186f8a019ca42d6f9643e5,1,3,4,7,4,2006-01-19 03:22:09,2006-01-19 03:22:09
6a91c0d55819cb1032186f8a019ca42d6f9643e5...df6c666fe3d3b9959c2276d46e3455f543aa752f,1,2,7,9,1,2006-01-19 03:25:50,2006-01-19 03:25:50
df6c666fe3d3b9959c2276d46e3455f543aa752f...5954baf5e9669addb803c0de61853427b82426ee,2,0,16,16,16,2006-01-19 03:30:53,2006-01-19 03:30:53
5954baf5e9669addb803c0de61853427b82426ee...a1b6457313b950986bb9747624704b2863d12256,1,0,7,7,1,2006-01-19 03:33:30,2006-01-19 03:33:30
a1b6457313b950986bb9747624704b2863d12256...cf0406d5ea2fbc10ffbd64bb85e61a74d19b76a0,1,3,6,9,3,2006-01-19 03:42:18,2006-01-19 03:42:18
cf0406d5ea2fbc10ffbd64bb85e61a74d19b76a0...12463932d33d593d8bd9bb33aec98f705ced34bc,1,1,2,3,2,2006-01-19 04:02:55,2006-01-19 04:02:55
12463932d33d593d8bd9bb33aec98f705ced34bc...32cf0aabd14be1e1978caf1e88643f4e99b7724b,1,1,1,2,1,2006-01-19 16:52:30,2006-01-19 16:52:30
32cf0aabd14be1e1978caf1e88643f4e99b7724b...ee1a1eb5192cd840c60b707e3a1421c33ddc8132,1,1,1,2,1,2006-01-19 20:52:30,2006-01-19 20:52:30
ee1a1eb5192cd840c60b707e3a1421c33ddc8132...de5ea1d18c24a3d5c550d3e6fe3d65e8eaf5a914,1,3,3,6,3,2006-01-20 17:43:14,2006-01-20 17:43:14
de5ea1d18c24a3d5c550d3e6fe3d65e8eaf5a914...f71f56785d980dfd58178fda11041bdeeec17301,1,1,7,8,1,2006-01-21 03:23:58,2006-01-21 03:23:58
f71f56785d980dfd58178fda11041bdeeec17301...6ce5f51c55875e6613fa055b5c00a233eb9533f7,3,9,0,9,3,2006-01-21 03:30:35,2006-01-21 03:30:35
6ce5f51c55875e6613fa055b5c00a233eb9533f7...39fec03db68ed174ebf26c95a9f891cd86d34b36,1,3,6,9,3,2006-01-21 04:01:00,2006-01-21 04:01:00
39fec03db68ed174ebf26c95a9f891cd86d34b36...4f6f777bc7eaf706d5190420c854b9f7a3d850c5,2,12,20,32,12,2006-01-21 04:06:26,2006-01-21 04:06:26
4f6f777bc7eaf706d5190420c854b9f7a3d850c5...d6629224c389a7b50a4239ea75f550fef9ec47d8,1,1,1,2,1,2006-01-21 04:10:27,2006-01-21 04:10:27
d6629224c389a7b50a4239ea75f550fef9ec47d8...cdb7a5109843144a636ca718831038dc1eea7f0c,1,3,3,6,3,2006-01-21 04:10:46,2006-01-21 04:10:46
cdb7a5109843144a636ca718831038dc1eea7f0c...861960f311ad096b8fb8af4f244d95292dbef0a5,3,8,11,19,9,2006-01-21 04:21:54,2006-01-21 04:21:54
861960f311ad096b8fb8af4f244d95292dbef0a5...fe70b4966145754638bf62c823b156e32363151c,1,1,1,2,1,2006-01-21 04:23:00,2006-01-21 04:23:00
fe70b4966145754638bf62c823b156e32363151c...4e78c1b3891bee0495ae41b2980f6d9d59a4c115,2,2,2,4,3,2006-01-21 04:28:23,2006-01-21 04:28:23
4e78c1b3891bee0495ae41b2980f6d9d59a4c115...f99dd1d542dc50e9c723ab2129cfddb2695a3acc,1,1,1,2,1,2006-01-21 04:34:36,2006-01-21 04:34:36
f99dd1d542dc50e9c723ab2129cfddb2695a3acc...92d2b01a447a6946fd14ea4304008f871227a83e,2,3,3,6,4,2006-01-21 04:36:35,2006-01-21 04:36:35
92d2b01a447a6946fd14ea4304008f871227a83e...05c01c71a4f6c811b803fbcc18a4b79c4e418b2c,2,23,34,57,14,2006-01-21 05:15:29,2006-01-21 05:15:29
05c01c71a4f6c811b803fbcc18a4b79c4e418b2c...2348f8fcef38569ae4ca16a3f8765406d6052ccb,2,7,7,14,6,2006-01-21 05:23:16,2006-01-21 05:23:16
2348f8fcef38569ae4ca16a3f8765406d6052ccb...f664a284e7968138a82a2321ef770ea4248c54d9,1,1,1,2,1,2006-01-21 05:37:25,2006-01-21 05:37:25
f664a284e7968138a82a2321ef770ea4248c54d9...6505ae5c2fc2a704305a80bfa9c757c23b0725b0,4,71,92,163,18,2006-01-21 05:54:36,2006-01-21 05:54:36
6505ae5c2fc2a704305a80bfa9c757c23b0725b0...8e1e0adfc79f5956007423437ed6651b072e09f5,1,23,25,48,7,2006-01-21 06:04:21,2006-01-21 06:04:21
8e1e0adfc79f5956007423437ed6651b072e09f5...43d6bef62b2b73bb26f0da85fe3b8cede8afa166,3,17,41,58,15,2006-01-21 06:23:16,2006-01-21 06:23:16
43d6bef62b2b73bb26f0da85fe3b8cede8afa166...387f453db548bba421bb3ad37a22ba473c949842,1,5,4,9,2,2006-01-21 06:40:52,2006-01-21 06:40:52
387f453db548bba421bb3ad37a22ba473c949842...882c7c188507134d4778a4632dd4caa9db7459b3,1,3,3,6,3,2006-01-21 21:20:12,2006-01-21 21:20:12
882c7c188507134d4778a4632dd4caa9db7459b3...b4a454f956e7c73839a8491c58e6386da3e4e1a5,3,32,24,56,15,2006-01-21 22:41:56,2006-01-21 22:41:56
b4a454f956e7c73839a8491c58e6386da3e4e1a5...107f097a987fce5ad9bbd8670ba3e16af2b18358,1,2,2,4,1,2006-01-21 22:45:06,2006-01-21 22:45:06
107f097a987fce5ad9bbd8670ba3e16af2b18358...6d9b4f443c4a82fd5a5662e43ccdc3f1ffcbb7ed,1,6,6,12,5,2006-01-22 05:53:36,2006-01-22 05:53:36
6d9b4f443c4a82fd5a5662e43ccdc3f1ffcbb7ed...6eb3c1418f720c9c723c0b735c8cb3671bf5961f,1,4,4,8,3,2006-01-22 06:00:27,2006-01-22 06:00:27
6eb3c1418f720c9c723c0b735c8cb3671bf5961f...d6b154a8885e8e826c238a6ec309979350dd4940,4,251,493,744,39,2006-01-22 06:38:54,2006-01-22 06:38:54
d6b154a8885e8e826c238a6ec309979350dd4940...63b158ecb4af6f1fcaf2f734309c71e306dfe9a6,1,23,24,47,3,2006-01-22 06:44:05,2006-01-22 06:44:05
63b158ecb4af6f1fcaf2f734309c71e306dfe9a6...17ece1adb8ad7c69ce610b4a55cf49edf194b157,2,1,17,18,3,2006-01-22 06:51:35,2006-01-22 06:51:35
17ece1adb8ad7c69ce610b4a55cf49edf194b157...25e1e1392f1a571ce05d690d0dd01a9c7b674389,7,166,178,344,30,2006-01-23 02:29:34,2006-01-23 02:29:34
25e1e1392f1a571ce05d690d0dd01a9c7b674389...69120fa9d3788438df9673ce107a752cb34a31a8,2,7,7,14,5,2006-01-23 02:34:07,2006-01-23 02:34:07
69120fa9d3788438df9673ce107a752cb34a31a8...fcdc826e2cba418b13dcd992ea60f5bb2599a6b3,2,0,4,4,2,2006-01-23 02:36:11,2006-01-23 02:36:11
fcdc826e2cba418b13dcd992ea60f5bb2599a6b3...766ee9aeb24adb4cdb7e5cbed24125336f895202,2,1,4,5,2,2006-01-23 02:37:01,2006-01-23 02:37:01
766ee9aeb24adb4cdb7e5cbed24125336f895202...75c4013a21978bea08cf947b8f96aac0553d69d0,5,5,6,11,6,2006-01-23 02:41:01,2006-01-23 02:41:01
75c4013a21978bea08cf947b8f96aac0553d69d0...e8b570c3c6a745cdc215af228274b7c35d217517,9,25,29,54,28,2006-01-23 02:50:15,2006-01-23 02:50:15
e8b570c3c6a745cdc215af228274b7c35d217517...8ec8a8720e8091fece3d28155d5e02ce3c148771,1,1,4,5,2,2006-01-23 03:06:39,2006-01-23 03:06:39
8ec8a8720e8091fece3d28155d5e02ce3c148771...d78533535f91ae9fbcb5314e334663d1b0ecac17,1,2,2,4,1,2006-01-23 03:08:10,2006-01-23 03:08:10
d78533535f91ae9fbcb5314e334663d1b0ecac17...c8c7f071906a49d7b3e2be61b1d06e8adaa7bda7,3,5,12,17,6,2006-01-23 04:35:02,2006-01-23 04:35:02
c8c7f071906a49d7b3e2be61b1d06e8adaa7bda7...ff474dffabc4baa781e8b10d9c53fec4342c233a,2,1,6,7,3,2006-01-23 04:36:08,2006-01-23 04:36:08
ff474dffabc4baa781e8b10d9c53fec4342c233a...8708245d965e50695e8910ef46f52198674dc627,1,0,15,15,2,2006-01-23 04:37:24,2006-01-23 04:37:24
8708245d965e50695e8910ef46f52198674dc627...b7891c560ce4a63a64dae63ebca3522e0a5bf8e3,1,1,0,1,1,2006-01-23 23:01:22,2006-01-23 23:01:22
b7891c560ce4a63a64dae63ebca3522e0a5bf8e3...7d23d1e7985e0df92758e6cc6cb9a983de921c7e,5,51,10,61,9,2006-01-24 00:49:16,2006-01-24 00:49:16
7d23d1e7985e0df92758e6cc6cb9a983de921c7e...650d26d32ea7f44e8b11f3105bc4de6201fdbc46,2,0,6,6,1,2006-01-25 04:01:18,2006-01-25 04:01:18
650d26d32ea7f44e8b11f3105bc4de6201fdbc46...faf9ff6316fd575f9c03f5a6766766eb00b325aa,6,16,17,33,17,2006-01-25 21:51:13,2006-01-25 21:51:13
faf9ff6316fd575f9c03f5a6766766eb00b325aa...1833c53b2166ea98dcf743817fc35a99bd96bc14,5,17,16,33,12,2006-01-26 04:12:16,2006-01-26 04:12:16
1833c53b2166ea98dcf743817fc35a99bd96bc14...e86547759336dfffdf194f9443a3776c30148e60,1,2,2,4,2,2006-01-26 16:36:03,2006-01-26 16:36:03
e86547759336dfffdf194f9443a3776c30148e60...6cfea0d5b935ae3b487f508892a2585f422f2035,3,6,6,12,5,2006-01-26 17:12:32,2006-01-26 17:12:32
6cfea0d5b935ae3b487f508892a2585f422f2035...9308377fda5da5d85c5b86f9eb6bab672f2cea85,1,26,16,42,5,2006-01-26 21:22:43,2006-01-26 21:22:43
9308377fda5da5d85c5b86f9eb6bab672f2cea85...bacdf2ddad93ef8d807dc6680f00e6f649d7f91f,1,1,1,2,1,2006-01-27 15:41:26,2006-01-27 15:41:26
bacdf2ddad93ef8d807dc6680f00e6f649d7f91f...6dddef9b9171e4b37a2704fd355444240824ce18,1,2,3,5,1,2006-01-27 16:08:54,2006-01-27 16:08:54
6dddef9b9171e4b37a2704fd355444240824ce18...1af3a398688ecfdff7002cba2e897b285e863d3b,10,34,9,43,13,2006-01-27 16:35:25,2006-01-27 16:35:25
1af3a398688ecfdff7002cba2e897b285e863d3b...a35f7c6e1533cf4fbb145508b1cfa7be78259d6b,1,1,1,2,1,2006-01-27 21:29:29,2006-01-27 21:29:29
a35f7c6e1533cf4fbb145508b1cfa7be78259d6b...a6139af6450144d99e990833be766356ede125e6,1,6,0,6,2,2006-01-27 23:42:45,2006-01-27 23:42:45
a6139af6450144d99e990833be766356ede125e6...b22ebaf466fe7a0d056eb7ef96299e18b72db7ea,4,51,19,70,9,2006-01-28 00:12:26,2006-01-28 00:12:26
b22ebaf466fe7a0d056eb7ef96299e18b72db7ea...322336c382577f130249ee92fd006d505b5a9c39,1,2,1,3,1,2006-01-28 00:14:28,2006-01-28 00:14:28
322336c382577f130249ee92fd006d505b5a9c39...90a49140a5d78142f0125fdd1018fdc66114255b,1,33,24,57,6,2006-01-28 02:08:32,2006-01-28 02:08:32
90a49140a5d78142f0125fdd1018fdc66114255b...ce71979e533c5c46432e7ed8a2c2322a7c733ca4,2,8,4,12,4,2006-01-28 17:06:05,2006-01-28 17:06:05
ce71979e533c5c46432e7ed8a2c2322a7c733ca4...feee6d8805b8f6f955406ddec834ff577826065f,2,37,3,40,4,2006-01-28 17:58:44,2006-01-28 17:58:44
feee6d8805b8f6f955406ddec834ff577826065f...b266091a2a9b90e182c1887b94c983ef6b8731b8,1,14,5,19,5,2006-01-28 18:45:04,2006-01-28 18:45:04
b266091a2a9b90e182c1887b94c983ef6b8731b8...7e0ba90442d362a140957a37ad62457235c1ff54,1,28,1,29,2,2006-01-28 19:27:51,2006-01-28 19:27:51
7e0ba90442d362a140957a37ad62457235c1ff54...3127e3befb6552c6d38a4286cbec855acff4eae1,1,1,1,2,1,2006-01-28 19:41:29,2006-01-28 19:41:29
3127e3befb6552c6d38a4286cbec855acff4eae1...02eeb8dd1495c2cc0505d4c667ae9fa216f5d92e,3,372,28,400,19,2006-01-29 00:22:10,2006-01-29 00:22:10
02eeb8dd1495c2cc0505d4c667ae9fa216f5d92e...2fd362f2d7905c743723704a08d3322c3fab6da3,3,98,66,164,41,2006-01-29 00:23:52,2006-01-29 00:23:52
2fd362f2d7905c743723704a08d3322c3fab6da3...4d7e3c43c51c739d639b6f43805f8f57558a2800,1,2,2,4,2,2006-01-29 00:34:49,2006-01-29 00:34:49
4d7e3c43c51c739d639b6f43805f8f57558a2800...a33aa41fbf0f7b8e6d0806635cc21315b1fefc6e,1,2,1,3,2,2006-01-29 00:59:37,2006-01-29 00:59:37
a33aa41fbf0f7b8e6d0806635cc21315b1fefc6e...d580b42d459017ff333dbee12fd22d515b6b9a41,2,14,17,31,7,2006-01-29 01:09:10,2006-01-29 01:09:10
d580b42d459017ff333dbee12fd22d515b6b9a41...5bac096399adfb9586fd25a715bd4ffb86b8b9f2,3,34,38,72,8,2006-01-29 01:38:48,2006-01-29 01:38:48
5bac096399adfb9586fd25a715bd4ffb86b8b9f2...83f88704897d387db43516f7271c239fe8ed7549,2,37,43,80,37,2006-01-29 02:02:58,2006-01-29 02:02:58
83f88704897d387db43516f7271c239fe8ed7549...2be3eefdffb0a8320dc3e11526e99470d4e076f7,16,204,209,413,177,2006-01-30 00:38:23,2006-01-30 00:38:23
2be3eefdffb0a8320dc3e11526e99470d4e076f7...06842af5abea0b9fbc421ade657cdf563bb4c075,2,2,85,87,8,2006-01-30 00:46:47,2006-01-30 00:46:47
06842af5abea0b9fbc421ade657cdf563bb4c075...502225ef869a42a40fd74db16ed46acbacdae51c,3,210,408,618,40,2006-01-30 02:07:10,2006-01-30 02:07:10
502225ef869a42a40fd74db16ed46acbacdae51c...880c17638152358d91f3ade97f51a87ce73d9ba5,1,1,4,5,2,2006-01-30 02:09:25,2006-01-30 02:09:25
880c17638152358d91f3ade97f51a87ce73d9ba5...f925d89d11d4e59c39a040bda0fe21cd1c99f7fb,1,3,0,3,1,2006-01-30 02:11:21,2006-01-30 02:11:21
f925d89d11d4e59c39a040bda0fe21cd1c99f7fb...50e17688b0721d44445dcf41281840431131f0a9,1,2,0,2,1,2006-01-30 02:19:45,2006-01-30 02:19:45
50e17688b0721d44445dcf41281840431131f0a9...d53837b8bb90fd85d5a250a386bacd6da456940d,1,5,2,7,3,2006-01-30 02:23:56,2006-01-30 02:23:56
d53837b8bb90fd85d5a250a386bacd6da456940d...d1d3925bebe195f34038f139c35aecce907c2908,1,1,0,1,1,2006-01-30 02:51:47,2006-01-30 02:51:47
d1d3925bebe195f34038f139c35aecce907c2908...43179e41ae21e0e314f541c460e10831a870fab3,1,15,8,23,5,2006-01-30 02:57:04,2006-01-30 02:57:04
43179e41ae21e0e314f541c460e10831a870fab3...f771586debb84c11ee864355631470929d2b345a,2,29,58,87,4,2006-01-30 03:17:19,2006-01-30 03:17:19
f771586debb84c11ee864355631470929d2b345a...9708aa51c0d90a60c9b71aa0c0f80208c95be477,1,15,24,39,3,2006-01-30 03:33:40,2006-01-30 03:33:40
9708aa51c0d90a60c9b71aa0c0f80208c95be477...85ff60d06a98f401fb9c59ef3fc9163c2ad06c87,1,3,3,6,2,2006-01-30 03:36:25,2006-01-30 03:36:25
85ff60d06a98f401fb9c59ef3fc9163c2ad06c87...a71574a47658cdeb3c4868d33f4070a9a2f4ce6f,1,4,8,12,4,2006-01-30 03:40:06,2006-01-30 03:40:06
a71574a47658cdeb3c4868d33f4070a9a2f4ce6f...abd2bdba14108c55ccbece67c7759e5c6f383ced,1,1,1,2,1,2006-01-30 03:41:18,2006-01-30 03:41:18
abd2bdba14108c55ccbece67c7759e5c6f383ced...e4112922f7f5edda46625e72018d9fda41dc30a7,1,8,4,12,4,2006-01-30 03:51:10,2006-01-30 03:51:10
e4112922f7f5edda46625e72018d9fda41dc30a7...7ff623755a03cfbc87f9763659498a820ecfc3be,1,1,1,2,1,2006-01-30 03:51:55,2006-01-30 03:51:55
7ff623755a03cfbc87f9763659498a820ecfc3be...4d3763123a1dda43ad509a3caf0a089f7bdff1e6,1,2,2,4,1,2006-01-30 04:01:58,2006-01-30 04:01:58
4d3763123a1dda43ad509a3caf0a089f7bdff1e6...b3e9732effed2cfa0cc4fa67e739bac726e3dbcf,1,2,2,4,2,2006-01-30 04:04:12,2006-01-30 04:04:12
b3e9732effed2cfa0cc4fa67e739bac726e3dbcf...cf276407ea0f3960f3d265691c14f64c9700101b,1,6,6,12,3,2006-01-30 04:05:53,2006-01-30 04:05:53
cf276407ea0f3960f3d265691c14f64c9700101b...97e7ff7c2704a1796374569be1c4f6046f00a477,4,91,75,166,35,2006-01-30 04:36:41,2006-01-30 04:36:41
97e7ff7c2704a1796374569be1c4f6046f00a477...93399167b6dd8aee30019c1603fe0fa2c6b10d21,2,30,40,70,10,2006-01-30 05:20:36,2006-01-30 05:20:36
93399167b6dd8aee30019c1603fe0fa2c6b10d21...f0d3b56d76c97eeaa5aed59a59cc3a325c5ae9e9,1,6,6,12,4,2006-01-30 05:21:11,2006-01-30 05:21:11
f0d3b56d76c97eeaa5aed59a59cc3a325c5ae9e9...913ed883979fc7938e43e74af8432593c7dcd56a,1,3,3,6,1,2006-01-30 05:26:31,2006-01-30 05:26:31
913ed883979fc7938e43e74af8432593c7dcd56a...e49a09731bfd2bab46b8f019c23ce96f70c0ad71,3,27,33,60,6,2006-01-30 05:38:02,2006-01-30 05:38:02
e49a09731bfd2bab46b8f019c23ce96f70c0ad71...13cea53bb28ce694ac963ff7d64ed6085db53bbb,2,13,0,13,3,2006-01-30 05:54:12,2006-01-30 05:54:12
13cea53bb28ce694ac963ff7d64ed6085db53bbb...08e3bc8dd80d3c2d761dcdc0f99614379d5cba10,1,2,1,3,1,2006-01-30 05:57:30,2006-01-30 05:57:30
08e3bc8dd80d3c2d761dcdc0f99614379d5cba10...104fcb2447dacf23f91c8bc510cdbcaefefa83da,1,2,2,4,2,2006-01-30 06:00:50,2006-01-30 06:00:50
104fcb2447dacf23f91c8bc510cdbcaefefa83da...c0529945b4adb71eb93b173be91541a9f6b33fe1,2,3,3,6,3,2006-01-30 06:07:57,2006-01-30 06:07:57
c0529945b4adb71eb93b173be91541a9f6b33fe1...030f8d6af122ab412254fb22a3cec7432321f6bc,1,1,1,2,1,2006-01-30 18:00:53,2006-01-30 18:00:53
030f8d6af122ab412254fb22a3cec7432321f6bc...cf376353a652a966a56e4bf5d52d0f1069f3f332,5,440,425,865,264,2006-01-30 22:06:18,2006-01-30 22:06:18
cf376353a652a966a56e4bf5d52d0f1069f3f332...ad211a7cc3bdd6a2644bb0ad9f4e5ca6aee92c03,1,28,30,58,7,2006-01-30 22:23:21,2006-01-30 22:23:21
ad211a7cc3bdd6a2644bb0ad9f4e5ca6aee92c03...b349e42aac0cb42773d62dbc2d264e80cf6dcfba,8,20,20,40,20,2006-01-30 22:44:05,2006-01-30 22:44:05
b349e42aac0cb42773d62dbc2d264e80cf6dcfba...a91705496130e00954753f776a3f22c386b80872,1,16,16,32,15,2006-01-30 22:50:38,2006-01-30 22:50:38
a91705496130e00954753f776a3f22c386b80872...836478fa74eb0a16e8aefa2cdd076990707d2b2e,2,13,13,26,8,2006-01-30 23:40:54,2006-01-30 23:40:54
836478fa74eb0a16e8aefa2cdd076990707d2b2e...a6cf387d6bf286f6cddc1923168f6266e4fabfac,2,17,9,26,6,2006-01-31 00:02:11,2006-01-31 00:02:11
a6cf387d6bf286f6cddc1923168f6266e4fabfac...9fa5c43d5b84a2e5b3b6e98682435bdae39c8823,18,120,124,244,119,2006-01-31 01:08:02,2006-01-31 01:08:02
9fa5c43d5b84a2e5b3b6e98682435bdae39c8823...5b34ff236a5e96913b6e26b0f47a179f64d5daae,2,45,9,54,6,2006-01-31 01:13:10,2006-01-31 01:13:10
5b34ff236a5e96913b6e26b0f47a179f64d5daae...34bf9e8d31d8448ff159bcab60014d9b7acbbc71,2,5,1,6,2,2006-01-31 01:50:16,2006-01-31 01:50:16
34bf9e8d31d8448ff159bcab60014d9b7acbbc71...b72d8da3b270bd03efe34686b6cc1fcb212ce188,1,8,6,14,7,2006-01-31 02:04:45,2006-01-31 02:04:45
b72d8da3b270bd03efe34686b6cc1fcb212ce188...2983bd89891f080c298a510ad55a74fbb5158602,1,28,25,53,17,2006-01-31 02:06:42,2006-01-31 02:06:42
2983bd89891f080c298a510ad55a74fbb5158602...e51fcf8ec3f4d3f68c4cb03f3dcf598c1a06cd4d,4,113,61,174,23,2006-01-31 02:21:31,2006-01-31 02:21:31
e51fcf8ec3f4d3f68c4cb03f3dcf598c1a06cd4d...758f1366c2765c303444c0fb56cd62858ddb9483,1,5,1,6,1,2006-01-31 02:22:54,2006-01-31 02:22:54
758f1366c2765c303444c0fb56cd62858ddb9483...8aeeec0b35521e788ccdbe480b87155e4a15c4d5,1,3,3,6,2,2006-01-31 02:27:18,2006-01-31 02:27:18
8aeeec0b35521e788ccdbe480b87155e4a15c4d5...1a53632306d435beead75e23e5d370a07d4931cc,1,1,1,2,1,2006-01-31 02:29:31,2006-01-31 02:29:31
1a53632306d435beead75e23e5d370a07d4931cc...5c3789c9088c973e1e7f523779e4fbf481f44867,2,23,15,38,16,2006-01-31 21:54:28,2006-01-31 21:54:28
5c3789c9088c973e1e7f523779e4fbf481f44867...a37d862dedd0c042d29ae1c3fa29cb660cd52760,1,1,1,2,1,2006-01-31 22:02:20,2006-01-31 22:02:20
a37d862dedd0c042d29ae1c3fa29cb660cd52760...cef5e5421da7be31094ea41eedea7a8dd1ba92ec,1,7,2,9,3,2006-01-31 22:26:53,2006-01-31 22:26:53
cef5e5421da7be31094ea41eedea7a8dd1ba92ec...ac67992c7956a663a40516e55dc6f8b7180bd2a0,1,5,4,9,2,2006-01-31 23:10:43,2006-01-31 23:10:43
ac67992c7956a663a40516e55dc6f8b7180bd2a0...5bf57ef71cf3213a425d793cc86482c359f77874,1,9,9,18,7,2006-01-31 23:22:23,2006-01-31 23:22:23
5bf57ef71cf3213a425d793cc86482c359f77874...671da7036fccda504880ebee12c6e7f6410de21a,2,2,2,4,2,2006-01-31 23:28:47,2006-01-31 23:28:47
671da7036fccda504880ebee12c6e7f6410de21a...a06b44bdc45c3acf6281d28724ae1d04ad868120,19,32,33,65,30,2006-01-31 23:42:58,2006-01-31 23:42:58
a06b44bdc45c3acf6281d28724ae1d04ad868120...b01b9e3a8751ed23f8e975bbc67065652a79291e,1,17,29,46,8,2006-02-01 03:35:59,2006-02-01 03:35:59
b01b9e3a8751ed23f8e975bbc67065652a79291e...2cdd5b1b37c53a359919d3d1cb4fdf5d02221966,2,111,116,227,33,2006-02-01 04:58:42,2006-02-01 04:58:42
2cdd5b1b37c53a359919d3d1cb4fdf5d02221966...8df94de53b6561d66095949d4d177608d33ed75f,1,57,5,62,7,2006-02-01 13:21:16,2006-02-01 13:21:16
8df94de53b6561d66095949d4d177608d33ed75f...9dc4aa97ff6d7fd52ca3958b18311cc062effd91,1,1,1,2,1,2006-02-01 18:43:23,2006-02-01 18:43:23
9dc4aa97ff6d7fd52ca3958b18311cc062effd91...c6db2578dead5d3d61ae444c1715fc22c3b973e5,1,4,4,8,3,2006-02-01 18:47:12,2006-02-01 18:47:12
c6db2578dead5d3d61ae444c1715fc22c3b973e5...171c1a5a06418653d9f7100dfc2bdff8c0feebc2,1,4,4,8,4,2006-02-02 03:17:13,2006-02-02 03:17:13
171c1a5a06418653d9f7100dfc2bdff8c0feebc2...52b2dd620f23f2c93230e03e113fbd4fb679394d,2,2,2,4,2,2006-02-02 03:18:09,2006-02-02 03:18:09
52b2dd620f23f2c93230e03e113fbd4fb679394d...a9db2c18c0b30c0145b9ce406fcc0acb9635f02b,1,2,2,4,2,2006-02-02 03:19:12,2006-02-02 03:19:12
a9db2c18c0b30c0145b9ce406fcc0acb9635f02b...b78f2a982761167768fe51a006ec0c104058556e,1,8,8,16,8,2006-02-02 03:20:37,2006-02-02 03:20:37
b78f2a982761167768fe51a006ec0c104058556e...124944e5ededdfab22d37ca7f102ff29c44ad112,1,5,1,6,1,2006-02-02 04:38:45,2006-02-02 04:38:45
124944e5ededdfab22d37ca7f102ff29c44ad112...77816bc850bb108d4b800022066a993f139d7c47,1,7,1,8,1,2006-02-02 04:43:37,2006-02-02 04:43:37
77816bc850bb108d4b800022066a993f139d7c47...58bf60ec3d8ac6ae542b0f70dcafcb28ec777682,1,12,0,12,2,2006-02-02 04:46:56,2006-02-02 04:46:56
58bf60ec3d8ac6ae542b0f70dcafcb28ec777682...35a3103283b60a83e8f6518b17b9a8f8fd3104b3,3,35,12,47,10,2006-02-02 05:01:10,2006-02-02 05:01:10
35a3103283b60a83e8f6518b17b9a8f8fd3104b3...fd7c0a1a7cce9796901f32bed5a840918ae6edfe,1,23,17,40,2,2006-02-02 05:11:21,2006-02-02 05:11:21
fd7c0a1a7cce9796901f32bed5a840918ae6edfe...1308017f62ed00114aa331860ed4eadd7ce2a252,1,1,1,2,1,2006-02-02 14:53:12,2006-02-02 14:53:12
1308017f62ed00114aa331860ed4eadd7ce2a252...5366beeb703c846da5316bbfd40e67bbf5fcb2e2,1,6,8,14,2,2006-02-03 13:03:51,2006-02-03 13:03:51
5366beeb703c846da5316bbfd40e67bbf5fcb2e2...4d724b4d904befd5bd0caaebb57380dd3a5e9cdf,1,1,1,2,1,2006-02-03 13:28:29,2006-02-03 13:28:29
4d724b4d904befd5bd0caaebb57380dd3a5e9cdf...3310377501da4f72f77c5e916de5d098dc34697d,1,1,1,2,1,2006-02-03 15:04:38,2006-02-03 15:04:38
3310377501da4f72f77c5e916de5d098dc34697d...fe94847e2caf7ba0451b1dfba2d60ff0e164209a,1,2,2,4,2,2006-02-03 17:23:24,2006-02-03 17:23:24
fe94847e2caf7ba0451b1dfba2d60ff0e164209a...ce0c6887d6bf150516fd9ee012df5522d8998e62,1,45,46,91,4,2006-02-03 19:11:04,2006-02-03 19:11:04
ce0c6887d6bf150516fd9ee012df5522d8998e62...b9c2b3e83fefdc96be4a381586cf7984ad8d6a75,1,8,14,22,5,2006-02-03 20:01:58,2006-02-03 20:01:58
b9c2b3e83fefdc96be4a381586cf7984ad8d6a75...6fa54ec9fd81a83b792f50b53b0660f1861fefa9,2,8,13,21,8,2006-02-03 20:03:04,2006-02-03 20:03:04
6fa54ec9fd81a83b792f50b53b0660f1861fefa9...5f646ff4868e39b6ce8566a9702f7f8a9e6d6070,1,2,2,4,1,2006-02-03 20:29:45,2006-02-03 20:29:45
5f646ff4868e39b6ce8566a9702f7f8a9e6d6070...f59ca4e96c558c95eccb7d412826f27fb4554fc2,1,1,5,6,2,2006-02-03 20:32:19,2006-02-03 20:32:19
f59ca4e96c558c95eccb7d412826f27fb4554fc2...2ff5e5e765f6d5489d2ad27af10fccaf98a9d640,2,50,22,72,5,2006-02-03 20:36:50,2006-02-03 20:36:50
2ff5e5e765f6d5489d2ad27af10fccaf98a9d640...3c1bdb0d90c82a9c0abf77b20573d63a592b08ad,1,3,3,6,3,2006-02-03 20:42:44,2006-02-03 20:42:44
3c1bdb0d90c82a9c0abf77b20573d63a592b08ad...c060e85c8d1e2b7a6bcad3ae969acc5366151c34,1,0,6,6,1,2006-02-03 22:18:51,2006-02-03 22:18:51
c060e85c8d1e2b7a6bcad3ae969acc5366151c34...bd5b9412b33128857dcadcb226da17691d8a17ff,1,1,4,5,1,2006-02-03 22:29:15,2006-02-03 22:29:15
bd5b9412b33128857dcadcb226da17691d8a17ff...36c66d7d396f3d2816d92519940e54d306ca9188,1,1,1,2,1,2006-02-03 22:31:56,2006-02-03 22:31:56
36c66d7d396f3d2816d92519940e54d306ca9188...e456bbb7526869432c9274995734cd3825ec6875,2,25,31,56,7,2006-02-03 22:47:57,2006-02-03 22:47:57
e456bbb7526869432c9274995734cd3825ec6875...23748415d34879e0ae2e2582a096c64c2607b243,1,5,6,11,3,2006-02-03 23:24:20,2006-02-03 23:24:20
23748415d34879e0ae2e2582a096c64c2607b243...c9814b838fefbddca2ede1a42bb901d0edd32f4b,1,14,19,33,7,2006-02-03 23:26:16,2006-02-03 23:26:16
c9814b838fefbddca2ede1a42bb901d0edd32f4b...15d99ff525080e7f8ae10866eb88352c74428f17,2,27,44,71,8,2006-02-03 23:26:58,2006-02-03 23:26:58
15d99ff525080e7f8ae10866eb88352c74428f17...a624c77cc116c8c20e96e030a739d4f372d711ab,1,4,12,16,5,2006-02-03 23:30:12,2006-02-03 23:30:12
a624c77cc116c8c20e96e030a739d4f372d711ab...eee4f00bfbaf05d08d194276115ed7a24434ee9a,1,3,1,4,1,2006-02-03 23:30:56,2006-02-03 23:30:56
eee4f00bfbaf05d08d194276115ed7a24434ee9a...5bd6d2b949c91d3182ccbac11c3b8d4dcbe940fc,1,2,3,5,1,2006-02-03 23:42:46,2006-02-03 23:42:46
5bd6d2b949c91d3182ccbac11c3b8d4dcbe940fc...ee05e42a36258081636c7c9d564abe62244bf1d9,1,8,4,12,2,2006-02-03 23:47:36,2006-02-03 23:47:36
ee05e42a36258081636c7c9d564abe62244bf1d9...cbc144b375841507646d0850725b8add5a06382d,4,56,30,86,20,2006-02-04 00:07:03,2006-02-04 00:07:03
cbc144b375841507646d0850725b8add5a06382d...3c73a0e8d68a5a970973bd3a5691610b023e7741,1,0,2,2,2,2006-02-04 00:12:05,2006-02-04 00:12:05
3c73a0e8d68a5a970973bd3a5691610b023e7741...6becd68eef1ef168d497db49575149257dd057fb,1,1,1,2,1,2006-02-04 00:26:56,2006-02-04 00:26:56
6becd68eef1ef168d497db49575149257dd057fb...98ff9555f8e5635fac14bf8cb4f9499e33af4ac7,1,0,9,9,1,2006-02-04 00:27:22,2006-02-04 00:27:22
98ff9555f8e5635fac14bf8cb4f9499e33af4ac7...9881e049d0f2fe8cb175c0f1b0c47c9ba64cffaa,1,1,1,2,1,2006-02-04 00:27:45,2006-02-04 00:27:45
9881e049d0f2fe8cb175c0f1b0c47c9ba64cffaa...635dcd9c2fa03aa5237649261f93e612f2099165,1,2,1,3,1,2006-02-04 00:59:02,2006-02-04 00:59:02
635dcd9c2fa03aa5237649261f93e612f2099165...e99c0d6a00284e1f81a44571e0b7ecf43252b1da,1,1,1,2,1,2006-02-04 13:34:06,2006-02-04 13:34:06
e99c0d6a00284e1f81a44571e0b7ecf43252b1da...6aff90c1bab96163db06b75a4fdefa47714ed585,1,57,0,57,1,2006-02-04 18:28:12,2006-02-04 18:28:12
6aff90c1bab96163db06b75a4fdefa47714ed585...c2e2893460bd90d3f453ad2295a02eb5cc0a1bde,2,12,10,22,7,2006-02-04 19:31:39,2006-02-04 19:31:39
c2e2893460bd90d3f453ad2295a02eb5cc0a1bde...9661076827bcbc3960824c67ac90bee524a57f86,1,3,1,4,2,2006-02-04 19:38:34,2006-02-04 19:38:34
9661076827bcbc3960824c67ac90bee524a57f86...1f174e8d241610b45aa04bd1d5a1b6aa240d6385,1,2,2,4,2,2006-02-04 19:40:51,2006-02-04 19:40:51
1f174e8d241610b45aa04bd1d5a1b6aa240d6385...00752157e47eb57b23b078563cf5c5dad0541c11,58,2691,1363,4054,594,2006-02-04 20:19:12,2006-02-04 20:19:12
00752157e47eb57b23b078563cf5c5dad0541c11...fae0dde7bb1f4d4aee85fed8d2906c6c5fb13042,1,14,15,29,14,2006-02-04 21:24:15,2006-02-04 21:24:15
fae0dde7bb1f4d4aee85fed8d2906c6c5fb13042...fa80e9fcb7c875b93117d78c8df3cd369a3ab21d,1,2,1,3,2,2006-02-04 22:47:05,2006-02-04 22:47:05
fa80e9fcb7c875b93117d78c8df3cd369a3ab21d...14cf7ea9d249828e7bd82905ad1386758ac1e406,1,52,21,73,4,2006-02-04 23:09:50,2006-02-04 23:09:50
14cf7ea9d249828e7bd82905ad1386758ac1e406...adc562d42d0da270096f3d5910b85e107d048bdf,3,19,8,27,4,2006-02-04 23:13:07,2006-02-04 23:13:07
adc562d42d0da270096f3d5910b85e107d048bdf...6a90f49fe50193461689b6bd1cf3e7c5863051d8,6,14,16,30,13,2006-02-05 00:03:12,2006-02-05 00:03:12
6a90f49fe50193461689b6bd1cf3e7c5863051d8...96c66c7fdb1935ce8997910765fb30e50274f32a,1,1,1,2,2,2006-02-05 06:24:35,2006-02-05 06:24:35
96c66c7fdb1935ce8997910765fb30e50274f32a...e8017bb5c02a4d31b10b5667e9af2f69a22a94fa,2,56,0,56,1,2006-02-06 11:21:02,2006-02-06 11:21:02
e8017bb5c02a4d31b10b5667e9af2f69a22a94fa...a19915e7ea74fd2146eb0eced69858e421cb86ea,1,1,2,3,1,2006-02-06 12:47:25,2006-02-06 12:47:25
a19915e7ea74fd2146eb0eced69858e421cb86ea...1969c9f88b1b51987b63b1b04917d37194747181,1,1,1,2,1,2006-02-06 19:42:14,2006-02-06 19:42:14
1969c9f88b1b51987b63b1b04917d37194747181...a91ebaa2c32340218c2b78309f1b97c7638f1991,1,43,5,48,8,2006-02-06 21:02:33,2006-02-06 21:02:33
a91ebaa2c32340218c2b78309f1b97c7638f1991...d03b2de326a9d433d90aeab326f58d2d8e5262b2,1,16,3,19,5,2006-02-06 22:16:15,2006-02-06 22:16:15
d03b2de326a9d433d90aeab326f58d2d8e5262b2...28b16af6ca6facff384e8281d10208abcbcc1de9,1,1,1,2,1,2006-02-06 22:17:28,2006-02-06 22:17:28
28b16af6ca6facff384e8281d10208abcbcc1de9...e28addd70b5d6a780ebc142e133dfb97ab3d9233,1,27,1,28,5,2006-02-06 22:27:51,2006-02-06 22:27:51
e28addd70b5d6a780ebc142e133dfb97ab3d9233...ab6a97cb4a9d16c31d320615caa043330da97e3b,1,1,1,2,1,2006-02-07 00:51:42,2006-02-07 00:51:42
ab6a97cb4a9d16c31d320615caa043330da97e3b...e69b09a033424f07343ad253ecfee497fb7c405d,2,8,2,10,3,2006-02-07 18:47:32,2006-02-07 18:47:32
e69b09a033424f07343ad253ecfee497fb7c405d...7662520667fc822ba84db9f821ba7319b4f060fa,1,20,8,28,4,2006-02-07 22:40:11,2006-02-07 22:40:11
7662520667fc822ba84db9f821ba7319b4f060fa...b19eef14ed0442d9e47bfc333c5048563833a85b,1,0,2,2,1,2006-02-07 22:44:41,2006-02-07 22:44:41
b19eef14ed0442d9e47bfc333c5048563833a85b...61caa886138557c088b22f9f1f29a3eb0f455f96,1,1,1,2,1,2006-02-07 23:19:33,2006-02-07 23:19:33
61caa886138557c088b22f9f1f29a3eb0f455f96...9d809f2c3b8b6a6e5a5aa361e1c6c2b4bc9c000d,1,1,2,3,1,2006-02-08 23:57:07,2006-02-08 23:57:07
9d809f2c3b8b6a6e5a5aa361e1c6c2b4bc9c000d...27ec1bc29d0bda84e7673dcd7d8d09dbb31997b8,10,1427,1393,2820,327,2006-02-10 05:10:38,2006-02-10 05:10:38
27ec1bc29d0bda84e7673dcd7d8d09dbb31997b8...021b38a52c1e0e8e995fd6d2cc117e88bb636d26,2,2,1,3,2,2006-02-10 05:12:43,2006-02-10 05:12:43
021b38a52c1e0e8e995fd6d2cc117e88bb636d26...d43d498ba2188df1083f301bfe0380fa88bc4ed9,5,29,1,30,5,2006-02-10 21:35:29,2006-02-10 21:35:29
d43d498ba2188df1083f301bfe0380fa88bc4ed9...111dadafb010bea881c8de3801be6ed0664dfd0f,1,1,1,2,1,2006-02-11 03:15:36,2006-02-11 03:15:36
111dadafb010bea881c8de3801be6ed0664dfd0f...70e75036a87bd77b176ec82d4fbff3bb799aed80,1,24,30,54,20,2006-02-11 05:22:25,2006-02-11 05:22:25
70e75036a87bd77b176ec82d4fbff3bb799aed80...c9839b85e566087655973b4e8b91678bebd6d85f,1,1,1,2,1,2006-02-11 11:08:05,2006-02-11 11:08:05
c9839b85e566087655973b4e8b91678bebd6d85f...a1d9de4dc78e476d7f616c78f0347f501169d9df,6,167,128,295,46,2006-02-14 09:51:27,2006-02-14 09:51:27
a1d9de4dc78e476d7f616c78f0347f501169d9df...0604002cedcae907fa8a5e63766f76994cba538b,1,15,16,31,14,2006-02-15 16:19:18,2006-02-15 16:19:18
0604002cedcae907fa8a5e63766f76994cba538b...6e8203a06c6515d681e25db80f48eaa4bb52eb90,4,83,20,103,10,2006-02-16 14:07:23,2006-02-16 14:07:23
6e8203a06c6515d681e25db80f48eaa4bb52eb90...48320913ac79ae25b8dd32eb534bfb8c8b1e1ac9,5,155,57,212,18,2006-02-17 12:46:03,2006-02-17 12:46:03
48320913ac79ae25b8dd32eb534bfb8c8b1e1ac9...ad24403e8b4d2059d2e9f12565740c55326923a0,2,4,4,8,2,2006-02-17 12:56:48,2006-02-17 12:56:48
ad24403e8b4d2059d2e9f12565740c55326923a0...37942803b0f36d5ef6b2258915f8595ea8bdf992,1,2,2,4,3,2006-02-17 17:20:48,2006-02-17 17:20:48
37942803b0f36d5ef6b2258915f8595ea8bdf992...7e70c7daccfa775e23ba2a8deec4f8b9dcc24c60,1,3,3,6,3,2006-02-17 17:27:06,2006-02-17 17:27:06
7e70c7daccfa775e23ba2a8deec4f8b9dcc24c60...5927af7465f84a85b5dc4993afada3c8ab599ed5,1,1,1,2,1,2006-02-17 17:31:48,2006-02-17 17:31:48
5927af7465f84a85b5dc4993afada3c8ab599ed5...a4c6730aa195cc82b718bb88f2ea463b0f4ac557,4,46,4,50,5,2006-02-17 17:48:21,2006-02-17 17:48:21
a4c6730aa195cc82b718bb88f2ea463b0f4ac557...d1a91e311afaa796145b0729446127854597e14f,4,19,6,25,7,2006-02-17 18:06:45,2006-02-17 18:06:45
d1a91e311afaa796145b0729446127854597e14f...f0c493f02f78370916d7f70b3f1b705921035b4e,10,28,14,42,16,2006-02-17 19:42:11,2006-02-17 19:42:11
f0c493f02f78370916d7f70b3f1b705921035b4e...2dbd56795e213365dd241b7376bb2dc7d6665ebb,1,1,1,2,1,2006-02-17 20:16:42,2006-02-17 20:16:42
2dbd56795e213365dd241b7376bb2dc7d6665ebb...01732d4f724596e59d8916dd583773d068f01c89,1,2,2,4,1,2006-02-18 17:44:31,2006-02-18 17:44:31
01732d4f724596e59d8916dd583773d068f01c89...4cb8cca158dc3ce58ff1a383fa3f663d418c68ef,7,81,15,96,18,2006-02-18 20:24:24,2006-02-18 20:24:24
4cb8cca158dc3ce58ff1a383fa3f663d418c68ef...6589992a38846dc3741f8aa934d5401c45bef98c,2,4,4,8,3,2006-02-18 20:29:12,2006-02-18 20:29:12
6589992a38846dc3741f8aa934d5401c45bef98c...77a0a9498fdfdb73a896123aad17f4bace3ee9e3,3,16,8,24,9,2006-02-18 20:56:18,2006-02-18 20:56:18
77a0a9498fdfdb73a896123aad17f4bace3ee9e3...f594bc4445798cfa455a85291e2a8975eeb4f6dc,8,83,14,97,18,2006-02-18 22:14:05,2006-02-18 22:14:05
f594bc4445798cfa455a85291e2a8975eeb4f6dc...35f0dabdca98353bff9cb5e8b0ecae802fde80c2,1,13,18,31,3,2006-02-18 22:47:03,2006-02-18 22:47:03
35f0dabdca98353bff9cb5e8b0ecae802fde80c2...9cb04f5fae94e6ff8fbe6305de2337def818b73f,1,3,3,6,3,2006-02-18 22:51:08,2006-02-18 22:51:08
9cb04f5fae94e6ff8fbe6305de2337def818b73f...6c9e2bc3f18f3fd12cdcc768969362e1a8f66966,5,9,5,14,6,2006-02-18 23:06:03,2006-02-18 23:06:03
6c9e2bc3f18f3fd12cdcc768969362e1a8f66966...bc5583f432b4ad01f8ad44824c66f9b8cc6361dc,4,6,10,16,4,2006-02-18 23:51:00,2006-02-18 23:51:00
bc5583f432b4ad01f8ad44824c66f9b8cc6361dc...96649cc3298151ef09ff1fd198f8f9d45e5e0a94,4,57,38,95,26,2006-02-19 08:24:21,2006-02-19 08:24:21
96649cc3298151ef09ff1fd198f8f9d45e5e0a94...b7307544152e8fe2985baafc2a76ea5b325d2ba6,2,11,6,17,6,2006-02-19 08:35:40,2006-02-19 08:35:40
b7307544152e8fe2985baafc2a76ea5b325d2ba6...f9d95dc4ad6aa8e38571f2ea8b8265e5c1a8b1e1,1,38,38,76,19,2006-02-19 08:49:59,2006-02-19 08:49:59
f9d95dc4ad6aa8e38571f2ea8b8265e5c1a8b1e1...29971e675ffed5510dedaa8c3a7557958c5737ef,1,20,14,34,16,2006-02-22 13:14:44,2006-02-22 13:14:44
29971e675ffed5510dedaa8c3a7557958c5737ef...0a3985868a893b9045577e3f291b8f2c6faa4335,7,1754,6,1760,6,2006-02-23 17:38:00,2006-02-23 17:38:00
0a3985868a893b9045577e3f291b8f2c6faa4335...ae660f62d3fd6a2e0542d34c7c6b11b79bf50b0e,1,1,1,2,1,2006-02-23 17:38:42,2006-02-23 17:38:42
ae660f62d3fd6a2e0542d34c7c6b11b79bf50b0e...ce18ec917cf30d2c8b86755e50cf245d3fa0b8d7,1,2,3,5,2,2006-02-23 19:11:48,2006-02-23 19:11:48
ce18ec917cf30d2c8b86755e50cf245d3fa0b8d7...208ea7bacba1d04abe263918e95530d1e0d527da,1,1,1,2,1,2006-02-23 19:14:05,2006-02-23 19:14:05
208ea7bacba1d04abe263918e95530d1e0d527da...f252b11a9c9c078bf552b38edf91c786283ba8a8,2,14,11,25,9,2006-02-23 20:10:41,2006-02-23 20:10:41
f252b11a9c9c078bf552b38edf91c786283ba8a8...2fbf2d5f428bbf197deabd7222be1bb3e2164c36,1,1,0,1,1,2006-02-23 21:18:14,2006-02-23 21:18:14
2fbf2d5f428bbf197deabd7222be1bb3e2164c36...891c3c993bfe5aac61524ebee03824c8e9c91bf4,4,27,14,41,10,2006-02-24 06:06:20,2006-02-24 06:06:20
891c3c993bfe5aac61524ebee03824c8e9c91bf4...64cb7da1508086781c51c85488e8e6fff9bb72a0,2,92,0,92,1,2006-02-24 10:15:27,2006-02-24 10:15:27
64cb7da1508086781c51c85488e8e6fff9bb72a0...492d2146da4359182ee0bd721c1217980ae545fe,3,29,12,41,10,2006-02-24 10:25:02,2006-02-24 10:25:02
492d2146da4359182ee0bd721c1217980ae545fe...4f6d2a1d088ae724d4261cefcd1bc273d95ab573,1,17,0,17,3,2006-02-24 10:28:46,2006-02-24 10:28:46
4f6d2a1d088ae724d4261cefcd1bc273d95ab573...4708aee3116695ee385def25e596f2559e43742c,2,117,10,127,11,2006-02-24 10:36:04,2006-02-24 10:36:04
4708aee3116695ee385def25e596f2559e43742c...86a6ce8983291b99af97efaa61f733f0f5078c5d,1,0,8,8,1,2006-02-24 10:42:32,2006-02-24 10:42:32
86a6ce8983291b99af97efaa61f733f0f5078c5d...773c176c6f055a0316c614df5d4a26633ec8e7b9,1,3,3,6,3,2006-02-24 23:26:47,2006-02-24 23:26:47
773c176c6f055a0316c614df5d4a26633ec8e7b9...39e4e8ce5a47313a4c21f5d040762c6fa3d83980,1,0,28,28,2,2006-02-24 23:35:58,2006-02-24 23:35:58
39e4e8ce5a47313a4c21f5d040762c6fa3d83980...65dc8f000baa35ec4518e5a6ff41a1b0d714561c,2,17,18,35,11,2006-02-25 04:46:06,2006-02-25 04:46:06
65dc8f000baa35ec4518e5a6ff41a1b0d714561c...cab51971acf59bbf997d291f641f05b83078f327,14,451,504,955,15,2006-02-25 05:53:55,2006-02-25 05:53:55
cab51971acf59bbf997d291f641f05b83078f327...52f84c0f63fc2b7783721f2b27e6c0d5f0b584ce,2,6,7,13,4,2006-02-25 17:37:58,2006-02-25 17:37:58
52f84c0f63fc2b7783721f2b27e6c0d5f0b584ce...863bd3d36aac3d7e6456e79f7eaa338214705c6c,1,3,1,4,3,2006-02-25 19:35:30,2006-02-25 19:35:30
863bd3d36aac3d7e6456e79f7eaa338214705c6c...3ddc1b51f581ad7645a8d592e455fbc63317660e,2,9,4,13,7,2006-02-25 19:38:51,2006-02-25 19:38:51
3ddc1b51f581ad7645a8d592e455fbc63317660e...76cfd74542ca3cb83141e977d6c10be2a2f2391f,1,16,1,17,3,2006-02-25 19:45:16,2006-02-25 19:45:16
76cfd74542ca3cb83141e977d6c10be2a2f2391f...e13ae5a645d9074e10d5e02cc18735403faccc99,1,2,3,5,1,2006-02-25 19:54:32,2006-02-25 19:54:32
e13ae5a645d9074e10d5e02cc18735403faccc99...5f4fe3d02d6e9615984740c6c8d6ddffeb444ebf,1,109,6,115,5,2006-02-25 22:56:34,2006-02-25 22:56:34
5f4fe3d02d6e9615984740c6c8d6ddffeb444ebf...336bb0cd601af0a9a9d99ed99bafdb6f59ec2122,1,0,76,76,2,2006-02-25 22:58:10,2006-02-25 22:58:10
336bb0cd601af0a9a9d99ed99bafdb6f59ec2122...0b84370782bf5fdfa0f7a200f66e59fb72eb70a8,1,3,35,38,2,2006-02-25 23:01:47,2006-02-25 23:01:47
0b84370782bf5fdfa0f7a200f66e59fb72eb70a8...e4ea91a0b5982936beec4960edcf43a2d235a3e8,1,1,10,11,2,2006-02-25 23:06:09,2006-02-25 23:06:09
e4ea91a0b5982936beec4960edcf43a2d235a3e8...e7c83b691ba17d65610a24fdb8bee806909d78af,1,1,2,3,2,2006-02-25 23:15:00,2006-02-25 23:15:00
e7c83b691ba17d65610a24fdb8bee806909d78af...67a3d5207e810c098eea22ded5d819fb897e9fcf,1,16,23,39,17,2006-02-27 05:15:29,2006-02-27 05:15:29
67a3d5207e810c098eea22ded5d819fb897e9fcf...fd10c3ae1e501020c40909e16e264f146f2e39f4,1,0,1,1,1,2006-02-27 05:15:46,2006-02-27 05:15:46
fd10c3ae1e501020c40909e16e264f146f2e39f4...42dec1ef7598a418747637dd37319b81c5a6367f,2,8,8,16,8,2006-02-27 05:16:24,2006-02-27 05:16:24
42dec1ef7598a418747637dd37319b81c5a6367f...b00a5997209792db1b79e9c862d41b749772dec2,1,7,1,8,2,2006-02-27 05:17:08,2006-02-27 05:17:08
b00a5997209792db1b79e9c862d41b749772dec2...e6962ff1a50e5a9213c8de753a7eaaa42283b225,1,29,14,43,5,2006-02-27 05:18:18,2006-02-27 05:18:18
e6962ff1a50e5a9213c8de753a7eaaa42283b225...1b55e492eff85a65c96b84a5bfa42978a291392b,2,16,16,32,7,2006-02-27 05:19:25,2006-02-27 05:19:25
1b55e492eff85a65c96b84a5bfa42978a291392b...841a12f98db100212cdf0d0b30be585d133c28ac,7,106,81,187,36,2006-02-27 14:23:52,2006-02-27 14:23:52
841a12f98db100212cdf0d0b30be585d133c28ac...f0e185c762ebc8d10d9414169ed8a20359065416,3,50,2,52,2,2006-02-27 17:33:23,2006-02-27 17:33:23
f0e185c762ebc8d10d9414169ed8a20359065416...dac1a68645798fa48c165f350ee87f2e76a26e38,2,24,37,61,17,2006-02-27 17:58:28,2006-02-27 17:58:28
dac1a68645798fa48c165f350ee87f2e76a26e38...16387552c18c9c49d0a8ec16e5fd5c1be4147025,1,1,1,2,1,2006-02-27 18:29:31,2006-02-27 18:29:31
16387552c18c9c49d0a8ec16e5fd5c1be4147025...e9e18209cd1103ed119336d92f951d3dd170ad2e,1,10,4,14,4,2006-02-27 21:03:19,2006-02-27 21:03:19
e9e18209cd1103ed119336d92f951d3dd170ad2e...bc8547aa9dc4710c8fee5d5ee93b395abdb9ff62,1,41,1,42,5,2006-02-27 21:36:52,2006-02-27 21:36:52
bc8547aa9dc4710c8fee5d5ee93b395abdb9ff62...05bc38b2b4162164af34c8be9f04b5d7deadc06b,6,34,11,45,10,2006-02-27 22:30:34,2006-02-27 22:30:34
05bc38b2b4162164af34c8be9f04b5d7deadc06b...9cdd49c1e0cbe8621d162190c43284548e4b0002,7,28,6,34,10,2006-02-27 22:51:36,2006-02-27 22:51:36
9cdd49c1e0cbe8621d162190c43284548e4b0002...50f1717525cfa3690e1cdf15869608f7a2bf2884,1,13,0,13,1,2006-02-27 23:03:35,2006-02-27 23:03:35
50f1717525cfa3690e1cdf15869608f7a2bf2884...f0117e5c7eaff52fb214e50a7bc71fbc6e1d0cbb,1,1,0,1,1,2006-02-27 23:13:45,2006-02-27 23:13:45
f0117e5c7eaff52fb214e50a7bc71fbc6e1d0cbb...735e8a56bdb16a04fec2d55399368d1e862e244a,2,0,34,34,4,2006-02-27 23:26:49,2006-02-27 23:26:49
735e8a56bdb16a04fec2d55399368d1e862e244a...ae19fb4c61526c41610f8219bd1eb480de1fb48c,2,12,9,21,5,2006-02-28 00:13:06,2006-02-28 00:13:06
ae19fb4c61526c41610f8219bd1eb480de1fb48c...d0b4cc4681c2f5206eb8e0349ee9d6ce6a6b464b,1,1,1,2,1,2006-02-28 00:23:09,2006-02-28 00:23:09
d0b4cc4681c2f5206eb8e0349ee9d6ce6a6b464b...64330d7355c2a43d9d759726ed2152ea035d1804,1,1,1,2,1,2006-02-28 00:25:25,2006-02-28 00:25:25
64330d7355c2a43d9d759726ed2152ea035d1804...36bfffccc482a6ffcd78b171df7b8d77debefe8a,3,26,3,29,6,2006-02-28 00:46:07,2006-02-28 00:46:07
36bfffccc482a6ffcd78b171df7b8d77debefe8a...04b22e5002571abd00d1fc5bef8bc635025c8919,2,12,0,12,3,2006-02-28 00:50:06,2006-02-28 00:50:06
04b22e5002571abd00d1fc5bef8bc635025c8919...f9ed0eded9b5b5c5ea1b2ae3df84329dc8d05354,1,13,3,16,1,2006-02-28 01:01:01,2006-02-28 01:01:01
f9ed0eded9b5b5c5ea1b2ae3df84329dc8d05354...a6a6c4117b6aa856abf099f357431e0d6684799e,3,63,0,63,4,2006-02-28 10:12:45,2006-02-28 10:12:45
a6a6c4117b6aa856abf099f357431e0d6684799e...f64c581497b6816e3219bb5fcee8c8835ad704ce,2,31,4,35,6,2006-02-28 11:36:20,2006-02-28 11:36:20
f64c581497b6816e3219bb5fcee8c8835ad704ce...a83c0775457ef4d4f261d47741440740cc9dd5ea,1,2,2,4,2,2006-02-28 11:41:44,2006-02-28 11:41:44
a83c0775457ef4d4f261d47741440740cc9dd5ea...4b0acfc20255919a74671f052802ef2f277c8030,3,48,20,68,20,2006-02-28 14:02:20,2006-02-28 14:02:20
4b0acfc20255919a74671f052802ef2f277c8030...bd5a98c93f0537c8b8ef688d3301b14a0d0092ce,1,1,1,2,1,2006-02-28 14:15:37,2006-02-28 14:15:37
bd5a98c93f0537c8b8ef688d3301b14a0d0092ce...d26558ebf3e7ec5c2f94e8644620259b6d172287,1,3,0,3,1,2006-02-28 14:17:59,2006-02-28 14:17:59
d26558ebf3e7ec5c2f94e8644620259b6d172287...10d7f00b38b3a2315a886e7eec91edb896690659,1,11,11,22,11,2006-02-28 14:22:33,2006-02-28 14:22:33
10d7f00b38b3a2315a886e7eec91edb896690659...18d1b8177dba31e051e5406c011ebcb8d5f4acae,1,1,1,2,1,2006-02-28 14:23:53,2006-02-28 14:23:53
18d1b8177dba31e051e5406c011ebcb8d5f4acae...a3aa5452508e6d4260bd517f31e7cd6611ab3d58,1,4,5,9,2,2006-02-28 14:27:00,2006-02-28 14:27:00
a3aa5452508e6d4260bd517f31e7cd6611ab3d58...a86b6287deb78de7936177ea86177e2ee0e9c8f3,1,2,3,5,1,2006-02-28 15:02:03,2006-02-28 15:02:03
a86b6287deb78de7936177ea86177e2ee0e9c8f3...2f27df2784134aa5799f08926ec4a27eb52ba26e,1,0,8,8,1,2006-02-28 18:10:21,2006-02-28 18:10:21
2f27df2784134aa5799f08926ec4a27eb52ba26e...53ac6f9782802e2438b4f58acbcf3da0924ff53f,1,1,1,2,1,2006-02-28 19:27:42,2006-02-28 19:27:42
53ac6f9782802e2438b4f58acbcf3da0924ff53f...e8cfcf28e669695dbb16faba55b5ec0fac0caf42,7,125,72,197,29,2006-03-01 03:21:51,2006-03-01 03:21:51
e8cfcf28e669695dbb16faba55b5ec0fac0caf42...b2dd439085fb300a4ce0d921a268d22f5b696486,1,8,3,11,2,2006-03-01 03:26:08,2006-03-01 03:26:08
b2dd439085fb300a4ce0d921a268d22f5b696486...7901c93328fe9c91df17dfcede8e7a3eb9530d37,6,70,23,93,30,2006-03-01 03:57:57,2006-03-01 03:57:57
7901c93328fe9c91df17dfcede8e7a3eb9530d37...2a65b0038157d00b704ad3f643319bd5955b0fd9,20,551,45,596,50,2006-03-01 17:08:33,2006-03-01 17:08:33
2a65b0038157d00b704ad3f643319bd5955b0fd9...3ecacdb5fa74c4e874ee6ec780949366e8604cc8,1,4,1,5,2,2006-03-01 18:24:35,2006-03-01 18:24:35
3ecacdb5fa74c4e874ee6ec780949366e8604cc8...c6ab599431714de2f88a54c0c31d633a76a70372,2,59,0,59,1,2006-03-01 20:27:58,2006-03-01 20:27:58
c6ab599431714de2f88a54c0c31d633a76a70372...7e11865b844a872f211a61a15b0984df77bc508e,1,151,176,327,31,2006-03-02 00:02:20,2006-03-02 00:02:20
7e11865b844a872f211a61a15b0984df77bc508e...27bb553ba0cf026a811a4c28adc7e97d6339f95c,5,38,1,39,8,2006-03-02 00:28:40,2006-03-02 00:28:40
27bb553ba0cf026a811a4c28adc7e97d6339f95c...8c8afa22c01e1f26342acd40184b78d8c322db3e,3,47,52,99,37,2006-03-02 01:37:06,2006-03-02 01:37:06
8c8afa22c01e1f26342acd40184b78d8c322db3e...25391d5e98081679af925849753ea4b41df5fde0,1,2,1,3,1,2006-03-02 04:20:22,2006-03-02 04:20:22
25391d5e98081679af925849753ea4b41df5fde0...910986dde2e7914f8d1d9baa6fa986c0904bb62c,1,7,13,20,8,2006-03-02 04:47:06,2006-03-02 04:47:06
910986dde2e7914f8d1d9baa6fa986c0904bb62c...a93fbfd616a03ad29afed063fe2763df78b04874,5,1,35,36,5,2006-03-02 04:50:43,2006-03-02 04:50:43
a93fbfd616a03ad29afed063fe2763df78b04874...6dd46ebc5064be0d7b94aa86ecdb774926e1d318,1,2,2,4,2,2006-03-02 05:01:04,2006-03-02 05:01:04
6dd46ebc5064be0d7b94aa86ecdb774926e1d318...2695d52f504f0389cdb25d098aad859599a2e6fe,2,5,4,9,5,2006-03-02 05:04:21,2006-03-02 05:04:21
2695d52f504f0389cdb25d098aad859599a2e6fe...bfbd1a9434a895bc4d489d86ebecaa333d9daad5,5,529,521,1050,385,2006-03-02 05:09:10,2006-03-02 05:09:10
bfbd1a9434a895bc4d489d86ebecaa333d9daad5...5e6d82a83c1daa67a99c5a0ef175a7e63c877761,1,4,8,12,4,2006-03-02 05:45:19,2006-03-02 05:45:19
5e6d82a83c1daa67a99c5a0ef175a7e63c877761...fd3de3e29ed0298d94e075d6af14f81be03e0178,1,9,9,18,9,2006-03-02 10:05:09,2006-03-02 10:05:09
fd3de3e29ed0298d94e075d6af14f81be03e0178...85f7fba723777d105345bb4d01c7a3e23cc3a270,2,10,8,18,4,2006-03-02 14:34:37,2006-03-02 14:34:37
85f7fba723777d105345bb4d01c7a3e23cc3a270...650b042001638ae1d0c06f2c2af0ce708789d1b8,3,3,3,6,3,2006-03-02 15:49:30,2006-03-02 15:49:30
650b042001638ae1d0c06f2c2af0ce708789d1b8...eb4c05e0316014afb190344f7629249420ba347c,1,38,38,76,1,2006-03-03 10:14:53,2006-03-03 10:14:53
eb4c05e0316014afb190344f7629249420ba347c...cb0a57fc8b429c1d3c2146984b795b8e31f32b34,1,1,1,2,1,2006-03-03 10:20:35,2006-03-03 10:20:35
cb0a57fc8b429c1d3c2146984b795b8e31f32b34...4456e2c26c004af4ab90dd45577d50b2ec76a69c,1,50,71,121,12,2006-03-03 21:12:37,2006-03-03 21:12:37
4456e2c26c004af4ab90dd45577d50b2ec76a69c...242e652fe7c07b32af8a8c53f2998a8d732da9b5,1,3,5,8,1,2006-03-03 22:42:16,2006-03-03 22:42:16
242e652fe7c07b32af8a8c53f2998a8d732da9b5...809f9e9925ca20209512ffbc0527feec4b24c279,1,20,6,26,6,2006-03-03 22:48:47,2006-03-03 22:48:47
809f9e9925ca20209512ffbc0527feec4b24c279...397139f32cc580c1c8e998b929e0f39d80e79d7a,1,40,20,60,9,2006-03-03 23:07:35,2006-03-03 23:07:35
397139f32cc580c1c8e998b929e0f39d80e79d7a...3cf23a5c36bdf59c9510ef8a30399473bfd69d40,1,10,3,13,4,2006-03-03 23:13:38,2006-03-03 23:13:38
3cf23a5c36bdf59c9510ef8a30399473bfd69d40...f1c36bc4b3513ac6b327af37b7d1e06c38af3ecc,1,9,0,9,1,2006-03-03 23:41:02,2006-03-03 23:41:02
f1c36bc4b3513ac6b327af37b7d1e06c38af3ecc...ecd7f948dcc25222d9711254354d0f9292683566,2,93,11,104,13,2006-03-04 00:19:59,2006-03-04 00:19:59
ecd7f948dcc25222d9711254354d0f9292683566...3a1cc653221a184a665927c6c7e2f9fb2f7a0cd7,1,2,1,3,2,2006-03-04 00:53:52,2006-03-04 00:53:52
3a1cc653221a184a665927c6c7e2f9fb2f7a0cd7...fdd1e3682fd4898332f13717663e63fe1ad89dda,3,16,24,40,11,2006-03-04 12:13:41,2006-03-04 12:13:41
fdd1e3682fd4898332f13717663e63fe1ad89dda...6e827057413ca63c21cd12650e617bb0cf22aa6e,1,42,30,72,5,2006-03-04 23:40:15,2006-03-04 23:40:15
6e827057413ca63c21cd12650e617bb0cf22aa6e...15f52f0c5b4226875523e881f18ad9cddbdc2a66,1,2,2,4,2,2006-03-06 19:32:49,2006-03-06 19:32:49
15f52f0c5b4226875523e881f18ad9cddbdc2a66...043175c3fb797201a79953608c9675131b4d4657,4,28,33,61,8,2006-03-06 22:30:18,2006-03-06 22:30:18
043175c3fb797201a79953608c9675131b4d4657...9a253189391d7165409d413be85053f5272295ab,1,1,1,2,1,2006-03-06 23:20:29,2006-03-06 23:20:29
9a253189391d7165409d413be85053f5272295ab...f5dd6b9a459478cb5ac58e840dd05253b9ba7a58,1,1,1,2,1,2006-03-07 01:43:31,2006-03-07 01:43:31
f5dd6b9a459478cb5ac58e840dd05253b9ba7a58...bc851653b7bd48ad44d165924ce3aad8b99bc98c,3,2,2,4,2,2006-03-07 01:47:43,2006-03-07 01:47:43
bc851653b7bd48ad44d165924ce3aad8b99bc98c...dc63d91c568e476e1bd966f849cea5705bdca1fe,5,48,47,95,5,2006-03-07 01:53:20,2006-03-07 01:53:20
dc63d91c568e476e1bd966f849cea5705bdca1fe...345463ad8eb9ac0bd06a47a1aab84c00a4c71d71,2,0,0,0,0,2006-03-07 01:55:28,2006-03-07 01:55:28
345463ad8eb9ac0bd06a47a1aab84c00a4c71d71...0ec5a547c949e9b52209717108c4e2ac475238e4,7,8,8,16,6,2006-03-07 02:06:28,2006-03-07 02:06:28
0ec5a547c949e9b52209717108c4e2ac475238e4...cad2fa4e8b923539db96dcea60ee5af1edf26015,4,8,8,16,8,2006-03-07 02:11:54,2006-03-07 02:11:54
cad2fa4e8b923539db96dcea60ee5af1edf26015...3a88988f9a58f1d13949de456859a1147e1818f6,8,110,113,223,12,2006-03-07 02:47:11,2006-03-07 02:47:11
3a88988f9a58f1d13949de456859a1147e1818f6...b1e6e88495903cc8cb10c7c83fd2068ebf5ad2ae,1,1,1,2,1,2006-03-07 11:32:08,2006-03-07 11:32:08
b1e6e88495903cc8cb10c7c83fd2068ebf5ad2ae...3d64e7e63fe41915a5a2916b4ca066a84d355ca7,1,16,14,30,2,2006-03-07 17:57:15,2006-03-07 17:57:15
3d64e7e63fe41915a5a2916b4ca066a84d355ca7...4e292dabc0969ce36ffaa5ebf39fb1b041cd676b,1,15,15,30,3,2006-03-07 18:50:56,2006-03-07 18:50:56
4e292dabc0969ce36ffaa5ebf39fb1b041cd676b...738d9af1e8e38b0289b7dfa7c8a5413f5d0e20d1,8,178,114,292,39,2006-03-08 17:53:55,2006-03-08 17:53:55
738d9af1e8e38b0289b7dfa7c8a5413f5d0e20d1...875d21581895647b47d39b2033b7086703d0a608,1,3,3,6,3,2006-03-08 19:10:43,2006-03-08 19:10:43
875d21581895647b47d39b2033b7086703d0a608...a8efa342834319b3eb468e4f574a8a8ba740a58f,2,27,0,27,1,2006-03-08 20:08:05,2006-03-08 20:08:05
a8efa342834319b3eb468e4f574a8a8ba740a58f...7df29c013eb04273a56cd04116a846a9fe7a18d7,1,1,1,2,1,2006-03-08 20:54:03,2006-03-08 20:54:03
7df29c013eb04273a56cd04116a846a9fe7a18d7...4b0fcefbc28694876f7fffc14a5584f84f898a21,2,16,2,18,4,2006-03-08 20:59:00,2006-03-08 20:59:00
4b0fcefbc28694876f7fffc14a5584f84f898a21...7ec0ebc022e0eaf70d417729a084af80b258bcd9,1,15,0,15,1,2006-03-08 21:05:10,2006-03-08 21:05:10
7ec0ebc022e0eaf70d417729a084af80b258bcd9...9460c54e2285d9f5fbddbe071c5b8de844a63f96,1,2,0,2,2,2006-03-10 00:20:24,2006-03-10 00:20:24
9460c54e2285d9f5fbddbe071c5b8de844a63f96...a5bd0543f10dca603f384c075a528997cc2f84c6,4,68,11,79,12,2006-03-12 03:58:11,2006-03-12 03:58:11
a5bd0543f10dca603f384c075a528997cc2f84c6...7a0b04fdc3abb8ff4db7ffc81d4a0201f682a82a,3,12,14,26,7,2006-03-12 04:10:57,2006-03-12 04:10:57
7a0b04fdc3abb8ff4db7ffc81d4a0201f682a82a...8addbfa0d2a64dd0eb970571a0038368cffe6a26,1,2,1,3,2,2006-03-12 22:41:04,2006-03-12 22:41:04
8addbfa0d2a64dd0eb970571a0038368cffe6a26...e695567d1078a343a5ba51b6de9d1d374ea30c20,1,1,1,2,1,2006-03-12 23:00:00,2006-03-12 23:00:00
e695567d1078a343a5ba51b6de9d1d374ea30c20...0d9ab72feac981598518f88eda335096ff47f0f8,1,21,19,40,19,2006-03-13 00:20:57,2006-03-13 00:20:57
0d9ab72feac981598518f88eda335096ff47f0f8...0690229a3b73919000396374b12f9b568f1fba66,2,2,2,4,2,2006-03-13 00:39:43,2006-03-13 00:39:43
0690229a3b73919000396374b12f9b568f1fba66...ba273d88acb22a1b6160b7cbc883d0a0a9e376a6,1,1,1,2,1,2006-03-13 00:41:49,2006-03-13 00:41:49
ba273d88acb22a1b6160b7cbc883d0a0a9e376a6...ce41a3e736f78b26ae57e524613dfc12569bc08d,1,9,0,9,2,2006-03-13 01:08:04,2006-03-13 01:08:04
ce41a3e736f78b26ae57e524613dfc12569bc08d...bbc62cdccc6e0e630c3a4675399f3f42dd568995,4,268,7,275,20,2006-03-13 01:33:45,2006-03-13 01:33:45
bbc62cdccc6e0e630c3a4675399f3f42dd568995...4ddf1b3dc7d90278198d6fdc4305846d63e9df7c,1,1,1,2,1,2006-03-13 21:24:25,2006-03-13 21:24:25
4ddf1b3dc7d90278198d6fdc4305846d63e9df7c...bcacb8843ee6fb7bc14ea1a20b161fcebf45041a,1,2,0,2,1,2006-03-13 22:10:59,2006-03-13 22:10:59
bcacb8843ee6fb7bc14ea1a20b161fcebf45041a...ff48a48b6a516867f3a158a6faed21b8cf702700,8,75,35,110,31,2006-03-16 03:02:51,2006-03-16 03:02:51
ff48a48b6a516867f3a158a6faed21b8cf702700...fde2cb50ac2785401f7247daccb105fb78b3a2ca,1,2,2,4,1,2006-03-17 04:55:34,2006-03-17 04:55:34
fde2cb50ac2785401f7247daccb105fb78b3a2ca...fd00f02ce03f09c4ea76a0a6ff3770ca406d7814,2,3,3,6,2,2006-03-17 05:04:14,2006-03-17 05:04:14
fd00f02ce03f09c4ea76a0a6ff3770ca406d7814...404421895a5a25cc8a3e0b5eec4337a5339a4ea0,3,107,84,191,56,2006-03-17 05:43:37,2006-03-17 05:43:37
404421895a5a25cc8a3e0b5eec4337a5339a4ea0...cb828b5494e20cf52b14887a73e483d8e111fd6b,1,31,9,40,8,2006-03-18 00:24:12,2006-03-18 00:24:12
cb828b5494e20cf52b14887a73e483d8e111fd6b...9f248bf394fb815d97311b9dc2e4c3698b3440a9,1,2,2,4,2,2006-03-18 23:04:43,2006-03-18 23:04:43
9f248bf394fb815d97311b9dc2e4c3698b3440a9...52a96c16863b1a10ee4af87fd969c10f1b5b6ae7,2,3,3,6,4,2006-03-19 23:45:00,2006-03-19 23:45:00
52a96c16863b1a10ee4af87fd969c10f1b5b6ae7...4f2752c333a8de579a8914abc5580824a0edd969,1,2,2,4,2,2006-03-20 01:05:16,2006-03-20 01:05:16
4f2752c333a8de579a8914abc5580824a0edd969...3c7e06e10326f2639e397873aa777140f16a4df1,1,1,1,2,1,2006-03-20 13:48:26,2006-03-20 13:48:26
3c7e06e10326f2639e397873aa777140f16a4df1...8d238ce5368b5bce1fb31959c455110993d4fb85,1,1,1,2,1,2006-03-20 17:56:37,2006-03-20 17:56:37
8d238ce5368b5bce1fb31959c455110993d4fb85...7f722a6425f8eff16eb3dbd227fa2dd453abdec1,1,10,5,15,4,2006-03-20 19:58:37,2006-03-20 19:58:37
7f722a6425f8eff16eb3dbd227fa2dd453abdec1...4927c2cf1ec18e1fdabd22cb2d700b53f8cf9d5a,1,2,2,4,1,2006-03-20 23:05:57,2006-03-20 23:05:57
4927c2cf1ec18e1fdabd22cb2d700b53f8cf9d5a...c0f3555eef0ebf877111bfb2de65b95f0c5a6b7b,1,2,1,3,2,2006-03-21 18:31:31,2006-03-21 18:31:31
c0f3555eef0ebf877111bfb2de65b95f0c5a6b7b...3da050e44e14505cd4a9990d1e6d40e0b3b65b20,1,1,1,2,1,2006-03-22 00:56:48,2006-03-22 00:56:48
3da050e44e14505cd4a9990d1e6d40e0b3b65b20...e134da8a1ae694372710f61ee7df29338e4d0168,1,1,1,2,1,2006-03-22 19:05:43,2006-03-22 19:05:43
e134da8a1ae694372710f61ee7df29338e4d0168...17a4401f4c2d71a82a8420e62029945a2f570bcd,11,3759,123,3882,114,2006-03-22 22:35:14,2006-03-22 22:35:14
17a4401f4c2d71a82a8420e62029945a2f570bcd...cb5e2764be48ef22398e51a6956e21995297df83,6,171,194,365,19,2006-03-23 00:55:30,2006-03-23 00:55:30
cb5e2764be48ef22398e51a6956e21995297df83...0cfe7fe53e820331363d8583a74b5399c74a0c2e,1,2,2,4,2,2006-03-24 00:29:47,2006-03-24 00:29:47
0cfe7fe53e820331363d8583a74b5399c74a0c2e...90d5426adc0e9967b093cb5002ea7fcddde0b9a8,2,46,15,61,11,2006-03-24 16:13:57,2006-03-24 16:13:57
90d5426adc0e9967b093cb5002ea7fcddde0b9a8...dc0fe82957fb476dcf5bb71f9fc0d44c8126339b,1,1,1,2,1,2006-03-24 16:29:22,2006-03-24 16:29:22
dc0fe82957fb476dcf5bb71f9fc0d44c8126339b...b9f4a027b47c5a4d4f6be09a3d4c9831555f4b6e,5,14,2,16,7,2006-03-24 19:05:46,2006-03-24 19:05:46
b9f4a027b47c5a4d4f6be09a3d4c9831555f4b6e...f95dd12050777a176d92ae9c260e2a17957fe6d7,1,0,2,2,1,2006-03-24 19:10:10,2006-03-24 19:10:10
f95dd12050777a176d92ae9c260e2a17957fe6d7...69c76d7e08a62b0f6ce3112a4a368462138512c9,2,6,1,7,3,2006-03-24 19:15:57,2006-03-24 19:15:57
69c76d7e08a62b0f6ce3112a4a368462138512c9...e433f4797b13c568deec7816020a49fccf652f76,1,2,2,4,2,2006-03-24 21:52:39,2006-03-24 21:52:39
e433f4797b13c568deec7816020a49fccf652f76...7335a12b48974dac328865dc52ff0f4a636506c6,1,15,11,26,5,2006-03-24 22:20:41,2006-03-24 22:20:41
7335a12b48974dac328865dc52ff0f4a636506c6...339a320226fd6443bb8d64bcec26050fd22eaa40,1,9,1,10,2,2006-03-24 23:09:48,2006-03-24 23:09:48
339a320226fd6443bb8d64bcec26050fd22eaa40...9474b37bdf6675b275b154432283cf2ef6235215,2,2,1,3,2,2006-03-25 20:40:00,2006-03-25 20:40:00
9474b37bdf6675b275b154432283cf2ef6235215...2e6bd70a17be6456aea7edc583cf6640998ae17c,2,31,4,35,5,2006-03-26 01:37:06,2006-03-26 01:37:06
2e6bd70a17be6456aea7edc583cf6640998ae17c...20e5b9f7e3b28b11ffb7f513d06b399e0c9a85ed,1,3,3,6,1,2006-03-26 02:22:41,2006-03-26 02:22:41
20e5b9f7e3b28b11ffb7f513d06b399e0c9a85ed...24da07329d9f964f7b58566e2a5893ef6a566b7a,1,25,25,50,23,2006-03-26 22:29:17,2006-03-26 22:29:17
24da07329d9f964f7b58566e2a5893ef6a566b7a...01babca674026a089850d6fd0397164c1f7b5768,1,1,1,2,1,2006-03-27 10:08:34,2006-03-27 10:08:34
01babca674026a089850d6fd0397164c1f7b5768...dd8b60bd17e9b93fb9c60ebe03f34d2bf0237419,1,0,19,19,1,2006-03-27 19:15:36,2006-03-27 19:15:36
dd8b60bd17e9b93fb9c60ebe03f34d2bf0237419...1200356c1cbbb0b69d9082e584488fba03b6d4cb,1,8,11,19,3,2006-03-27 23:04:41,2006-03-27 23:04:41
1200356c1cbbb0b69d9082e584488fba03b6d4cb...652a05777e40c825cade289001dd74aa500c8ad6,1,7,4,11,5,2006-03-27 23:20:59,2006-03-27 23:20:59
652a05777e40c825cade289001dd74aa500c8ad6...02b3ed3a1c0ea729aa31ede954710b7a6510d1f6,5,16,17,33,12,2006-03-28 17:25:53,2006-03-28 17:25:53
02b3ed3a1c0ea729aa31ede954710b7a6510d1f6...ff3810c5ae610882380f9a5a002817121ed4dd35,1,1,1,2,1,2006-03-28 17:27:23,2006-03-28 17:27:23
ff3810c5ae610882380f9a5a002817121ed4dd35...15b5f4ded23217983d937442ebe0ec197d09846f,2,31,19,50,8,2006-03-28 17:29:56,2006-03-28 17:29:56
15b5f4ded23217983d937442ebe0ec197d09846f...5fc71e4453ae6702a2e1b156350a38fb0e284d07,5,280,5,285,7,2006-03-28 17:42:29,2006-03-28 17:42:29
5fc71e4453ae6702a2e1b156350a38fb0e284d07...afeda3d7bde115eb4df93c9b05006ab9b023a22e,1,1,1,2,1,2006-03-28 17:47:53,2006-03-28 17:47:53
afeda3d7bde115eb4df93c9b05006ab9b023a22e...639fe6a87a5eabe9bd20ea4c117fc6b365a6e654,1,2,2,4,2,2006-03-28 18:29:15,2006-03-28 18:29:15
639fe6a87a5eabe9bd20ea4c117fc6b365a6e654...493f8b9e5bc71de20b71b456966647dd46912d59,2,194,63,257,42,2006-03-28 21:31:36,2006-03-28 21:31:36
493f8b9e5bc71de20b71b456966647dd46912d59...5372618b3c439097840897db01d1882bee60b3a9,1,0,25,25,1,2006-03-28 21:33:08,2006-03-28 21:33:08
5372618b3c439097840897db01d1882bee60b3a9...e7a47635a227b11b48594dd39e85a30272aaa1b9,2,11,17,28,5,2006-03-28 21:40:34,2006-03-28 21:40:34
e7a47635a227b11b48594dd39e85a30272aaa1b9...02b3f4489dbbbffc16cd43efaf917d688326f8d2,1,15,25,40,3,2006-03-28 23:47:45,2006-03-28 23:47:45
02b3f4489dbbbffc16cd43efaf917d688326f8d2...b13ff1762e80a7cd0995a3c19094851206261335,1,3,5,8,4,2006-03-28 23:59:38,2006-03-28 23:59:38
b13ff1762e80a7cd0995a3c19094851206261335...72f6ce935aa519550c5f3ab38f5b539ef5987a13,1,0,1,1,1,2006-03-29 02:55:30,2006-03-29 02:55:30
72f6ce935aa519550c5f3ab38f5b539ef5987a13...fec6bb5d5ccf7c502d9c98cb9629887a3588e9a9,1,2,0,2,1,2006-03-29 06:17:25,2006-03-29 06:17:25
fec6bb5d5ccf7c502d9c98cb9629887a3588e9a9...07131c390db60022373dbb9544e1288035f39530,1,1,1,2,1,2006-03-29 16:05:56,2006-03-29 16:05:56
07131c390db60022373dbb9544e1288035f39530...344cc981f68ddc5c550f5709127ba8b8a82dbef1,1,2,2,4,2,2006-03-30 03:30:45,2006-03-30 03:30:45
344cc981f68ddc5c550f5709127ba8b8a82dbef1...5072df1ac4014e6c1452843f777b9076d429af2b,1,2,2,4,2,2006-03-30 03:33:26,2006-03-30 03:33:26
5072df1ac4014e6c1452843f777b9076d429af2b...d4a6375fba108b2319f2dbad474c8bfc3b6adb5b,1,10,4,14,2,2006-03-30 13:12:11,2006-03-30 13:12:11
d4a6375fba108b2319f2dbad474c8bfc3b6adb5b...9db4a5e5ed474376571379b8748c5af313dd4ea6,3,18,3,21,7,2006-03-30 21:40:36,2006-03-30 21:40:36
9db4a5e5ed474376571379b8748c5af313dd4ea6...835dc7e8638d7ae266fdce06343a7fe4a6a1213f,1,0,1,1,1,2006-03-30 22:25:54,2006-03-30 22:25:54
835dc7e8638d7ae266fdce06343a7fe4a6a1213f...8102d1262e9b51663dc911882a39717cb496b0ab,3,12,4,16,5,2006-03-30 23:03:19,2006-03-30 23:03:19
8102d1262e9b51663dc911882a39717cb496b0ab...4d76b4df25d0270d3b9885a2c8fa2efcbf58a024,3,21,3,24,5,2006-03-30 23:29:21,2006-03-30 23:29:21
4d76b4df25d0270d3b9885a2c8fa2efcbf58a024...859e652d36ae3e6f72adf00c11ebbf2f2284fa01,1,4,4,8,4,2006-03-31 18:09:45,2006-03-31 18:09:45
859e652d36ae3e6f72adf00c11ebbf2f2284fa01...0d6f2f87072f75e9ca8bacc2dfd9e64f245a809a,1,7,2,9,3,2006-04-01 03:14:35,2006-04-01 03:14:35
0d6f2f87072f75e9ca8bacc2dfd9e64f245a809a...2eb2bad2e1afa284c03874174892c3ebd9c92f2c,1,131,163,294,7,2006-04-01 18:02:13,2006-04-01 18:02:13
2eb2bad2e1afa284c03874174892c3ebd9c92f2c...c5beee9500fc590d591d436f56daa4384ed0081b,1,2,2,4,2,2006-04-03 23:54:57,2006-04-03 23:54:57
c5beee9500fc590d591d436f56daa4384ed0081b...1764a4dac170ef95bbb0e6272c75f9cfa8bad229,1,22,11,33,1,2006-04-04 00:13:51,2006-04-04 00:13:51
1764a4dac170ef95bbb0e6272c75f9cfa8bad229...f8b3f9391b2421107a8575c35e8a2a21f75adfeb,7,19,20,39,8,2006-04-04 12:26:29,2006-04-04 12:26:29
f8b3f9391b2421107a8575c35e8a2a21f75adfeb...f7e00af2c3f5ec096222ab900cb55d7a9355a644,1,28,24,52,13,2006-04-04 12:28:17,2006-04-04 12:28:17
f7e00af2c3f5ec096222ab900cb55d7a9355a644...df26d4bcc4cb23d412c0605b14e4a15209ebe54a,1,20,18,38,13,2006-04-04 19:40:00,2006-04-04 19:40:00
df26d4bcc4cb23d412c0605b14e4a15209ebe54a...cc6ab74c36fed067c0b28bd81c9db3e0979d2383,1,1,1,2,1,2006-04-05 07:35:47,2006-04-05 07:35:47
cc6ab74c36fed067c0b28bd81c9db3e0979d2383...158691e884d39ba433816c0cf810d68e8d9d4318,2,66,0,66,1,2006-04-05 11:46:30,2006-04-05 11:46:30
158691e884d39ba433816c0cf810d68e8d9d4318...fcea8ed02177ed9f9ff9a41021dd89210cdad4d3,1,1,1,2,1,2006-04-05 12:00:38,2006-04-05 12:00:38
fcea8ed02177ed9f9ff9a41021dd89210cdad4d3...3825cb0a7d2a686aa24d7c3bd2208c2ece0a3e87,1,1,1,2,1,2006-04-05 15:21:36,2006-04-05 15:21:36
3825cb0a7d2a686aa24d7c3bd2208c2ece0a3e87...537f01c1624f5624eb83546dd74d6a39a0c3f212,1,34,17,51,4,2006-04-05 17:14:09,2006-04-05 17:14:09
537f01c1624f5624eb83546dd74d6a39a0c3f212...924d9e2f6ac8d195160633f7413f9bd1e24836d3,2,44,51,95,36,2006-04-05 17:26:08,2006-04-05 17:26:08
924d9e2f6ac8d195160633f7413f9bd1e24836d3...b00a6c29f92f2de3d19940592200864d7c4bde42,1,4,2,6,2,2006-04-05 17:35:18,2006-04-05 17:35:18
b00a6c29f92f2de3d19940592200864d7c4bde42...291e309d8d1fbd6169dd84b3a1bb7971d4568701,1,0,2,2,1,2006-04-05 17:36:12,2006-04-05 17:36:12
291e309d8d1fbd6169dd84b3a1bb7971d4568701...2aef97f2cf3923ab9e301d92610655f510693817,2,7,4,11,5,2006-04-05 17:40:46,2006-04-05 17:40:46
2aef97f2cf3923ab9e301d92610655f510693817...09d88c5489c41903d95fc2353fd95dc01964b030,1,1,1,2,1,2006-04-05 18:37:50,2006-04-05 18:37:50
09d88c5489c41903d95fc2353fd95dc01964b030...7b0df619d441cc6c80c5672748220621716d7e52,7,257,257,514,21,2006-04-05 21:46:51,2006-04-05 21:46:51
7b0df619d441cc6c80c5672748220621716d7e52...a30f87160f07aba6b7be448e0e52684b5d5ad6a5,10,37,31,68,15,2006-04-06 17:06:10,2006-04-06 17:06:10
a30f87160f07aba6b7be448e0e52684b5d5ad6a5...4b3bf0ac3c3a8984fd4589ce74571b1b431c4803,2,15,0,15,2,2006-04-06 17:07:47,2006-04-06 17:07:47
4b3bf0ac3c3a8984fd4589ce74571b1b431c4803...4a211a410c56310e7b15ced0a7b0aee0f46239f2,1,1,1,2,1,2006-04-06 17:09:17,2006-04-06 17:09:17
4a211a410c56310e7b15ced0a7b0aee0f46239f2...c069623008fb4fd34f68ac9c954af66d7019ec6d,1,1,1,2,1,2006-04-06 17:17:39,2006-04-06 17:17:39
c069623008fb4fd34f68ac9c954af66d7019ec6d...a45930b05c1f878ac60c93b9d494d2d378ba7a11,3,5,5,10,6,2006-04-07 15:38:38,2006-04-07 15:38:38
a45930b05c1f878ac60c93b9d494d2d378ba7a11...8657fdd11e552af4545766be950cf4f47f884e5d,1,2,2,4,2,2006-04-07 16:31:54,2006-04-07 16:31:54
8657fdd11e552af4545766be950cf4f47f884e5d...218035c3e19942209bd535c6f92cd0ef9435b105,1,2,2,4,2,2006-04-08 03:35:37,2006-04-08 03:35:37
218035c3e19942209bd535c6f92cd0ef9435b105...d1083f15fbdf073d768677f683a1e3b5136e3e41,4,102,92,194,45,2006-04-08 08:33:52,2006-04-08 08:33:52
d1083f15fbdf073d768677f683a1e3b5136e3e41...f576187df6c110505e9fc1202279c9146a3fc25f,1,26,26,52,7,2006-04-08 08:39:34,2006-04-08 08:39:34
f576187df6c110505e9fc1202279c9146a3fc25f...09a8f137f54b9cd253b364dbb39356bd740aafbe,1,3,1,4,1,2006-04-09 09:20:05,2006-04-09 09:20:05
09a8f137f54b9cd253b364dbb39356bd740aafbe...c229739f2f7fa049d54f291a805f5a40a9b6a88e,1,1,1,2,1,2006-04-09 09:24:12,2006-04-09 09:24:12
c229739f2f7fa049d54f291a805f5a40a9b6a88e...25b712819d6f629ecc6be36cf34456d02bc5d43e,7,817,741,1558,7,2006-04-09 22:59:25,2006-04-09 22:59:25
25b712819d6f629ecc6be36cf34456d02bc5d43e...90ed9fc91759125cef5b531cb77d6a66208bc1ff,1,17,18,35,9,2006-04-09 23:17:00,2006-04-09 23:17:00
90ed9fc91759125cef5b531cb77d6a66208bc1ff...ea624b1583a2f8d5ee47ee0df885b54ef8fa35f7,10,3659,17,3676,22,2006-04-09 23:18:42,2006-04-09 23:18:42
ea624b1583a2f8d5ee47ee0df885b54ef8fa35f7...cf307b77dde5760f16dfb2ef3cf0c24c9e89704b,7,43,21,64,16,2006-04-10 00:05:05,2006-04-10 00:05:05
cf307b77dde5760f16dfb2ef3cf0c24c9e89704b...8d9ebc6609b1bbd1e0be4440811c03f98097edc2,1,1,1,2,1,2006-04-10 00:13:09,2006-04-10 00:13:09
8d9ebc6609b1bbd1e0be4440811c03f98097edc2...74be99501473433d6e43024d2d8d3fc0bbeb9fc3,3,9,10,19,4,2006-04-10 00:24:48,2006-04-10 00:24:48
74be99501473433d6e43024d2d8d3fc0bbeb9fc3...985da9307b3a7eecc396302a894c87342a975958,1,1,2,3,1,2006-04-10 02:13:37,2006-04-10 02:13:37
985da9307b3a7eecc396302a894c87342a975958...1345cd0c17ad6906af1dde505198552cf10c7c7d,1,0,1,1,1,2006-04-10 03:26:40,2006-04-10 03:26:40
1345cd0c17ad6906af1dde505198552cf10c7c7d...a1aba10865b754e867b94ed082a41e67fa8c019e,8,30,30,60,30,2006-04-10 03:41:15,2006-04-10 03:41:15
a1aba10865b754e867b94ed082a41e67fa8c019e...491f0e1c109846abe73fd1edeab133b331d71eb8,1,5,0,5,5,2006-04-10 11:58:38,2006-04-10 11:58:38
491f0e1c109846abe73fd1edeab133b331d71eb8...2fade6acacc61da549990e35f36f41e305e1ca7e,1,3,3,6,2,2006-04-10 19:00:06,2006-04-10 19:00:06
2fade6acacc61da549990e35f36f41e305e1ca7e...8792dceb74cdac4c2fc4379e995f5eafc2aa77bd,2,3,8,11,5,2006-04-11 01:26:24,2006-04-11 01:26:24
8792dceb74cdac4c2fc4379e995f5eafc2aa77bd...16ddb218418565d51393910f24c5d23b29d0ca16,1,3,4,7,1,2006-04-11 02:36:40,2006-04-11 02:36:40
16ddb218418565d51393910f24c5d23b29d0ca16...180efa66ea13fe1b176e6acc4a602df23b62ff46,1,4,4,8,2,2006-04-11 02:38:03,2006-04-11 02:38:03
180efa66ea13fe1b176e6acc4a602df23b62ff46...0a7300476995e17c9560d04ddbe463ee39a10b04,1,4,1,5,1,2006-04-11 02:47:37,2006-04-11 02:47:37
0a7300476995e17c9560d04ddbe463ee39a10b04...356c2e78262ca601993835b9d1e3f8e17e833659,1,1,1,2,1,2006-04-11 02:49:51,2006-04-11 02:49:51
356c2e78262ca601993835b9d1e3f8e17e833659...4b37f265adc10a39960f049095976170590d015c,1,9,12,21,7,2006-04-11 03:04:10,2006-04-11 03:04:10
4b37f265adc10a39960f049095976170590d015c...59f47eaf1f8c498b20c9cf908377350d747fcfb8,2,9,0,9,2,2006-04-11 03:10:12,2006-04-11 03:10:12
59f47eaf1f8c498b20c9cf908377350d747fcfb8...308548f0dde38025b0aa6f9b4b3dc90b41ddbd42,2,3,4,7,2,2006-04-11 03:15:22,2006-04-11 03:15:22
308548f0dde38025b0aa6f9b4b3dc90b41ddbd42...5cb59bee2ff546c31d3752e3959b1a7ccafccb05,6,25,8,33,12,2006-04-11 03:24:28,2006-04-11 03:24:28
5cb59bee2ff546c31d3752e3959b1a7ccafccb05...a3f8ab3368cbeaf2e865e88d46280ec668efb3cf,1,7,5,12,6,2006-04-11 03:31:15,2006-04-11 03:31:15
a3f8ab3368cbeaf2e865e88d46280ec668efb3cf...d6863bede64caee22d059341c9aa092e8661f0a8,3,53,2,55,7,2006-04-11 03:53:31,2006-04-11 03:53:31
d6863bede64caee22d059341c9aa092e8661f0a8...551536a82c29cc9ce27335b1368e1418c4060dad,1,7,5,12,4,2006-04-11 04:55:06,2006-04-11 04:55:06
551536a82c29cc9ce27335b1368e1418c4060dad...1735b0cf699f8e8993b3bc06f4b1c983ba20fd5c,1,1,0,1,1,2006-04-11 05:55:15,2006-04-11 05:55:15
1735b0cf699f8e8993b3bc06f4b1c983ba20fd5c...737a317a232252512b7fda9d61cb39d0e3ebf8e8,1,4,3,7,2,2006-04-11 12:39:59,2006-04-11 12:39:59
737a317a232252512b7fda9d61cb39d0e3ebf8e8...15e368eed6242a7ef35d7ae1c74f9c272b997aaf,2,17,8,25,9,2006-04-11 13:45:15,2006-04-11 13:45:15
15e368eed6242a7ef35d7ae1c74f9c272b997aaf...3efbb1fdf278382af7e4bec1ac86cbbde282a361,1,1,1,2,1,2006-04-11 15:18:20,2006-04-11 15:18:20
3efbb1fdf278382af7e4bec1ac86cbbde282a361...24541dcb73e1b28645ec6642e950b457118d8f60,2,8,9,17,4,2006-04-11 18:28:34,2006-04-11 18:28:34
24541dcb73e1b28645ec6642e950b457118d8f60...4b3272fae8cb352b05f615453e366dadbbdbd71f,1,239,196,435,87,2006-04-12 00:28:07,2006-04-12 00:28:07
4b3272fae8cb352b05f615453e366dadbbdbd71f...13e0d03b13c42c112a5a8bb4a730b592275d6a94,2,4,2,6,3,2006-04-12 03:33:48,2006-04-12 03:33:48
13e0d03b13c42c112a5a8bb4a730b592275d6a94...0244a836cdbb96993ede83ec05970a45e1f4776a,1,2,2,4,2,2006-04-12 03:37:30,2006-04-12 03:37:30
0244a836cdbb96993ede83ec05970a45e1f4776a...597fc781cdedff1fe43b0996fd4b4a3dd1336279,1,1,1,2,1,2006-04-12 04:01:49,2006-04-12 04:01:49
597fc781cdedff1fe43b0996fd4b4a3dd1336279...6d953207aeb581cb596bd11144f2f145a886f270,1,1,1,2,1,2006-04-12 13:00:29,2006-04-12 13:00:29
6d953207aeb581cb596bd11144f2f145a886f270...af0056201e4484adaf7d91b8a061db1ec3e8f41d,2,5,6,11,4,2006-04-12 13:19:45,2006-04-12 13:19:45
af0056201e4484adaf7d91b8a061db1ec3e8f41d...873b12b94dd2ea8a29ed1c23baad16ae5227d54c,9,11,11,22,11,2006-04-12 13:39:34,2006-04-12 13:39:34
873b12b94dd2ea8a29ed1c23baad16ae5227d54c...93d95b3b10b4904e8efec7d58232e61562533262,2,47,1,48,5,2006-04-13 01:52:12,2006-04-13 01:52:12
93d95b3b10b4904e8efec7d58232e61562533262...47333f6d1e3086aa0fb7d0bddb888bea8fb76526,1,7,0,7,1,2006-04-13 03:46:21,2006-04-13 03:46:21
47333f6d1e3086aa0fb7d0bddb888bea8fb76526...b59d57e4d23698351d367c8f42d79ed2bc7c295a,8,65,2,67,12,2006-04-13 04:35:00,2006-04-13 04:35:00
b59d57e4d23698351d367c8f42d79ed2bc7c295a...ffa0218401c465d9a5623f6e8e584e4669d5354b,4,129,101,230,94,2006-04-13 13:17:05,2006-04-13 13:17:05
ffa0218401c465d9a5623f6e8e584e4669d5354b...d6ba2d477c8db8f209bcd82b7600bd78d7696843,2,303,269,572,62,2006-04-13 23:52:35,2006-04-13 23:52:35
d6ba2d477c8db8f209bcd82b7600bd78d7696843...39d42d48618efbb5e5176a8b65b635a84bed45a5,4,89,83,172,60,2006-04-15 15:56:12,2006-04-15 15:56:12
39d42d48618efbb5e5176a8b65b635a84bed45a5...6442fd27bcf116d62ba5108436a28a3ed4df95e5,50,124,140,264,105,2006-04-15 16:46:54,2006-04-15 16:46:54
6442fd27bcf116d62ba5108436a28a3ed4df95e5...d40781952b1f47cc9d854d025d95e5dcbebb19e3,4,29,29,58,27,2006-04-15 20:12:19,2006-04-15 20:12:19
d40781952b1f47cc9d854d025d95e5dcbebb19e3...fe0d508a6af1f2b051d7b478cc4cc29d706956b9,1,1,1,2,1,2006-04-15 20:13:44,2006-04-15 20:13:44
fe0d508a6af1f2b051d7b478cc4cc29d706956b9...231a6edb7d05e118625727306c36962eb9ad0400,1,7,7,14,6,2006-04-15 20:14:51,2006-04-15 20:14:51
231a6edb7d05e118625727306c36962eb9ad0400...b5c5e4dde496140a345da282099d5a37dfe6cee6,1,1,1,2,1,2006-04-15 20:19:40,2006-04-15 20:19:40
b5c5e4dde496140a345da282099d5a37dfe6cee6...fe907f1abc0b0e81b00bed1b07b11457a37201e3,8,99,0,99,6,2006-04-17 03:19:31,2006-04-17 03:19:31
fe907f1abc0b0e81b00bed1b07b11457a37201e3...cf55b5bbaf3e99c48cea68bd4a896a691c647ddc,1,340,190,530,45,2006-04-17 06:43:41,2006-04-17 06:43:41
cf55b5bbaf3e99c48cea68bd4a896a691c647ddc...8f41483c2792b7288aa3530c015369ec5f9026ed,2,9,9,18,7,2006-04-17 07:02:18,2006-04-17 07:02:18
8f41483c2792b7288aa3530c015369ec5f9026ed...ccc46a0f2fa14eb34f18aae57f71251180cdd548,1,228,164,392,72,2006-04-17 12:47:49,2006-04-17 12:47:49
ccc46a0f2fa14eb34f18aae57f71251180cdd548...8117acaca11c072ad1793b99f0dd9a441eaae957,1,6,3,9,3,2006-04-17 14:05:40,2006-04-17 14:05:40
8117acaca11c072ad1793b99f0dd9a441eaae957...32aa5c977d7dd73b7f7bd5fe06d83a044db76751,1,1,1,2,1,2006-04-17 20:55:20,2006-04-17 20:55:20
32aa5c977d7dd73b7f7bd5fe06d83a044db76751...ef3c0e06e178272d49639b4dc5b6ff280955f192,3,14,21,35,12,2006-04-17 21:02:32,2006-04-17 21:02:32
ef3c0e06e178272d49639b4dc5b6ff280955f192...61122231008ead3dca6058de6a43267294b944cf,1,1,1,2,1,2006-04-17 23:13:48,2006-04-17 23:13:48
61122231008ead3dca6058de6a43267294b944cf...4b3048d8a9ddc023dfb59df20ba5668e43666216,4,61,42,103,30,2006-04-18 13:41:21,2006-04-18 13:41:21
4b3048d8a9ddc023dfb59df20ba5668e43666216...5f7e3144fc732b4b5acf808c15eee5086c48b26b,2,3,2,5,3,2006-04-18 19:42:19,2006-04-18 19:42:19
5f7e3144fc732b4b5acf808c15eee5086c48b26b...0eb9819fa5013eb260aa316a5485d5c3f27fcb1f,1,1,1,2,1,2006-04-20 19:47:20,2006-04-20 19:47:20
0eb9819fa5013eb260aa316a5485d5c3f27fcb1f...7d196979b693af099747953bf00323d789a5bbca,2,2,1,3,2,2006-04-20 22:10:11,2006-04-20 22:10:11
7d196979b693af099747953bf00323d789a5bbca...d8ae61b59a1f12005688694bd175d06f65ab515f,1,1,1,2,1,2006-04-20 22:10:57,2006-04-20 22:10:57
d8ae61b59a1f12005688694bd175d06f65ab515f...9d2992b1c87435094b8c4733e100e760fbd04b15,1,6,8,14,4,2006-04-21 14:58:10,2006-04-21 14:58:10
9d2992b1c87435094b8c4733e100e760fbd04b15...0121e4cc949e503a695a685cd51fb626cc998864,1,4,1,5,1,2006-04-21 17:04:02,2006-04-21 17:04:02
0121e4cc949e503a695a685cd51fb626cc998864...c3b7f4b0a9df9ade5d7a11fe07b554579d0d9f73,4,8,8,16,8,2006-04-21 19:01:17,2006-04-21 19:01:17
c3b7f4b0a9df9ade5d7a11fe07b554579d0d9f73...dbf2463cd62002919671e12325f02b2c8b741196,6,46,60,106,38,2006-04-21 21:02:01,2006-04-21 21:02:01
dbf2463cd62002919671e12325f02b2c8b741196...965cdefad0a5578a964e4e5d9e8c9ffd2b256cbd,1,5,9,14,1,2006-04-21 21:09:19,2006-04-21 21:09:19
965cdefad0a5578a964e4e5d9e8c9ffd2b256cbd...85f4b13804fd9a4a0ba0c58e687f51a8a79a9fb3,1,4,4,8,3,2006-04-21 21:54:15,2006-04-21 21:54:15
85f4b13804fd9a4a0ba0c58e687f51a8a79a9fb3...9bd6bef487d7719353fc026b87e403e8d9cf0f3b,1,11,6,17,7,2006-04-23 05:20:31,2006-04-23 05:20:31
9bd6bef487d7719353fc026b87e403e8d9cf0f3b...43395b0993d8af90b35dd4329c1770e2ca748efb,1,4,0,4,2,2006-04-23 05:21:00,2006-04-23 05:21:00
43395b0993d8af90b35dd4329c1770e2ca748efb...e55924b833b77e98d24768749409cf2705f61180,1,3,3,6,3,2006-04-23 21:16:26,2006-04-23 21:16:26
e55924b833b77e98d24768749409cf2705f61180...5a2b52c9e8007edc483a4e94988c58106a6d2b4b,1,1,1,2,1,2006-04-23 21:21:51,2006-04-23 21:21:51
5a2b52c9e8007edc483a4e94988c58106a6d2b4b...1e72a7f672c687f6e37cec7d1fda67f97a806c85,1,3,3,6,3,2006-04-23 21:23:44,2006-04-23 21:23:44
1e72a7f672c687f6e37cec7d1fda67f97a806c85...45be99d4868aec0504ecf989a97462b556ebdf86,1,7,0,7,4,2006-04-23 21:27:33,2006-04-23 21:27:33
45be99d4868aec0504ecf989a97462b556ebdf86...c551eac5e4ad99fb864f3e1efcb84cf456b812f6,1,1,1,2,1,2006-04-23 21:30:04,2006-04-23 21:30:04
c551eac5e4ad99fb864f3e1efcb84cf456b812f6...121c9c96924615022857121225a3019f1fba8365,6,14,1,15,6,2006-04-23 21:45:36,2006-04-23 21:45:36
121c9c96924615022857121225a3019f1fba8365...8b37669742c3e13549ab414d061006a75a192ae7,1,7,7,14,5,2006-04-23 21:49:07,2006-04-23 21:49:07
8b37669742c3e13549ab414d061006a75a192ae7...dee1af5d8ba80054daeb8b0ad7b89dcf78f22a84,1,3,0,3,1,2006-04-23 21:59:49,2006-04-23 21:59:49
dee1af5d8ba80054daeb8b0ad7b89dcf78f22a84...08c28d989736b0659185e0f793ffc659ffa222e4,2,12,12,24,2,2006-04-23 22:10:50,2006-04-23 22:10:50
08c28d989736b0659185e0f793ffc659ffa222e4...2f7c4d5ca940a05364a0e67afe5c0d10e7308972,2,12,1,13,3,2006-04-23 22:18:53,2006-04-23 22:18:53
2f7c4d5ca940a05364a0e67afe5c0d10e7308972...213b6a6905ad86f05a2217005b6c140660d3ff5f,1,1,1,2,1,2006-04-23 22:20:43,2006-04-23 22:20:43
213b6a6905ad86f05a2217005b6c140660d3ff5f...980a522f9f5ba4774ebeef3fffb8722c481f9da2,2,3,2,5,2,2006-04-23 22:23:46,2006-04-23 22:23:46
980a522f9f5ba4774ebeef3fffb8722c481f9da2...2d5d40a7f10d327a10c14221a45bee95cd15ec75,1,3,0,3,1,2006-04-23 22:51:33,2006-04-23 22:51:33
2d5d40a7f10d327a10c14221a45bee95cd15ec75...9b8332f7df6261c50ad5b32e8a49bc307027a285,1,1,1,2,1,2006-04-23 23:09:27,2006-04-23 23:09:27
9b8332f7df6261c50ad5b32e8a49bc307027a285...24b8ffe10c972a2af97fe56fefc1f51cea3591b4,1,149,150,299,87,2006-04-23 23:22:42,2006-04-23 23:22:42
24b8ffe10c972a2af97fe56fefc1f51cea3591b4...923c1d304b0fc03d320f1e8023aa1545dbedb467,2,106,0,106,2,2006-04-23 23:52:40,2006-04-23 23:52:40
923c1d304b0fc03d320f1e8023aa1545dbedb467...0f89743539b2129bab5bbaa719ea5be00d05c294,2,76,0,76,10,2006-04-24 00:18:57,2006-04-24 00:18:57
0f89743539b2129bab5bbaa719ea5be00d05c294...489d5bae5c5e53891c71796427e205625c8afe74,9,84,136,220,42,2006-04-24 00:29:31,2006-04-24 00:29:31
489d5bae5c5e53891c71796427e205625c8afe74...5d7c1fe714d947ccb3a5c75e9c29c210067847a1,2,22,22,44,14,2006-04-24 01:13:44,2006-04-24 01:13:44
5d7c1fe714d947ccb3a5c75e9c29c210067847a1...2fb5a9b7fec32fd2c5e228bd6dadb9ad26f31980,1,11,0,11,3,2006-04-25 02:22:16,2006-04-25 02:22:16
2fb5a9b7fec32fd2c5e228bd6dadb9ad26f31980...1529aef3ff14a688348b29ad07dd7fd8653b4522,1,558,362,920,35,2006-04-26 15:38:30,2006-04-26 15:38:30
1529aef3ff14a688348b29ad07dd7fd8653b4522...57607c82267e609915780155cac163f80c98155f,1,515,216,731,80,2006-04-27 05:14:03,2006-04-27 05:14:03
57607c82267e609915780155cac163f80c98155f...1e9ab533d83f5c976513be790ed7f5d26e6e0108,1,109,71,180,29,2006-04-27 05:51:56,2006-04-27 05:51:56
1e9ab533d83f5c976513be790ed7f5d26e6e0108...dd184fb06ef67dad381182cbbdfc4f18902e48e6,1,1,1,2,1,2006-04-27 18:11:39,2006-04-27 18:11:39
dd184fb06ef67dad381182cbbdfc4f18902e48e6...ad8faa7e94f7dca522e2419c3a1c8c1503461745,1,6,5,11,1,2006-04-27 22:10:08,2006-04-27 22:10:08
ad8faa7e94f7dca522e2419c3a1c8c1503461745...62cb0be63b58782d90e74029056ce0fee5a8b9c7,1,1,1,2,1,2006-04-27 22:11:35,2006-04-27 22:11:35
62cb0be63b58782d90e74029056ce0fee5a8b9c7...2a9ed3addfcd92fb2fdceb825f03fae6cbb7f426,1,52,44,96,31,2006-04-27 22:12:05,2006-04-27 22:12:05
2a9ed3addfcd92fb2fdceb825f03fae6cbb7f426...58c3b4849c97cb80927fc55c3d4980c05bc44c99,2,1,16,17,2,2006-04-27 22:12:51,2006-04-27 22:12:51
58c3b4849c97cb80927fc55c3d4980c05bc44c99...97ef69178f4c981e5ef267d978f0bb23707b8176,1,90,59,149,30,2006-04-28 03:32:01,2006-04-28 03:32:01
97ef69178f4c981e5ef267d978f0bb23707b8176...c32bd868c6dfc7428f4b1c268d581ed4b9981171,1,254,104,358,35,2006-04-28 03:39:27,2006-04-28 03:39:27
c32bd868c6dfc7428f4b1c268d581ed4b9981171...04f3bcfd4d55d9d28b884db08d9bd8f48fcf6792,1,19,3,22,5,2006-04-28 03:54:24,2006-04-28 03:54:24
04f3bcfd4d55d9d28b884db08d9bd8f48fcf6792...5cc2464e7744ac03b6d6cf12550dbe4d8e535bea,1,73,46,119,33,2006-04-28 04:15:11,2006-04-28 04:15:11
5cc2464e7744ac03b6d6cf12550dbe4d8e535bea...c73d0dc46bb678da58f70159618ef8ad62d4a655,1,16,14,30,10,2006-04-28 04:19:50,2006-04-28 04:19:50
c73d0dc46bb678da58f70159618ef8ad62d4a655...6aa8c422127d342e556fe4b6c1c637a1d30693a1,1,92,58,150,26,2006-04-28 04:47:12,2006-04-28 04:47:12
6aa8c422127d342e556fe4b6c1c637a1d30693a1...9327788e25c48ef27498e615c48d5c42288858a7,1,1,1,2,1,2006-04-28 04:54:32,2006-04-28 04:54:32
9327788e25c48ef27498e615c48d5c42288858a7...3db13442a14e66899323cf7d0a733fb190085c1b,1,17,16,33,8,2006-04-28 04:54:51,2006-04-28 04:54:51
3db13442a14e66899323cf7d0a733fb190085c1b...0c813dffc36a189b79b03f42999dfcf50769c7b4,1,23,24,47,15,2006-04-28 05:00:42,2006-04-28 05:00:42
0c813dffc36a189b79b03f42999dfcf50769c7b4...84987b8a6411d153f818834c5ac4cb08f94449fd,1,8,9,17,8,2006-04-28 05:05:56,2006-04-28 05:05:56
84987b8a6411d153f818834c5ac4cb08f94449fd...d4c1b55cb205c7353ac78fc0352c654c70d99edb,1,24,25,49,4,2006-04-28 17:59:37,2006-04-28 17:59:37
d4c1b55cb205c7353ac78fc0352c654c70d99edb...fb8c2306db64f84f77a4fbf76c29d0109467d9a9,1,1,1,2,1,2006-04-28 19:40:22,2006-04-28 19:40:22
fb8c2306db64f84f77a4fbf76c29d0109467d9a9...84fd6a9f872efba6e0c7440dca705a497bd8e618,1,2,2,4,1,2006-04-28 19:45:12,2006-04-28 19:45:12
84fd6a9f872efba6e0c7440dca705a497bd8e618...a5afa8af63755ac948a4d9ebcb736c008d6bc81c,1,2,2,4,1,2006-04-28 19:47:46,2006-04-28 19:47:46
a5afa8af63755ac948a4d9ebcb736c008d6bc81c...6ec3a4d9ee8f63deb6934a2e75c8bcd56b65b30f,14,56,56,112,31,2006-04-28 20:56:58,2006-04-28 20:56:58
6ec3a4d9ee8f63deb6934a2e75c8bcd56b65b30f...1809f6e256622d9813d8af9a338d9ba10d8cf531,1,15,11,26,2,2006-04-28 23:13:29,2006-04-28 23:13:29
1809f6e256622d9813d8af9a338d9ba10d8cf531...c632b7a69d1bc4cd8d882cb4269a3c4f43a2c8b6,1,1,1,2,1,2006-04-29 01:05:04,2006-04-29 01:05:04
c632b7a69d1bc4cd8d882cb4269a3c4f43a2c8b6...f4eb6b118ab28a06f2a313f151b98c48baf66926,1,1,1,2,1,2006-04-29 01:06:06,2006-04-29 01:06:06
f4eb6b118ab28a06f2a313f151b98c48baf66926...b4e85c7d1c7dcff1deda70f09ff21a6f99d34da7,2,6,5,11,2,2006-04-29 01:08:24,2006-04-29 01:08:24
b4e85c7d1c7dcff1deda70f09ff21a6f99d34da7...07b42f223470083df70134d3dfb3507b20bff768,3,10,10,20,7,2006-04-29 01:10:16,2006-04-29 01:10:16
07b42f223470083df70134d3dfb3507b20bff768...f3d1c706488a2374f177a0e3c3d041c9fba2953f,1,151,8,159,9,2006-04-29 01:13:30,2006-04-29 01:13:30
f3d1c706488a2374f177a0e3c3d041c9fba2953f...a5350de40e6e982c2f96196dc063ff389a75e0e1,1,10,7,17,5,2006-04-29 01:14:56,2006-04-29 01:14:56
a5350de40e6e982c2f96196dc063ff389a75e0e1...372e0325a4d3158e1e909096cf8a58571b597cf7,1,2,2,4,2,2006-04-29 01:18:20,2006-04-29 01:18:20
372e0325a4d3158e1e909096cf8a58571b597cf7...d835131954708905667dcc9b4d955a28765e95e7,1,3,3,6,1,2006-04-29 01:23:05,2006-04-29 01:23:05
d835131954708905667dcc9b4d955a28765e95e7...674fc71d97db83997863a41a2055a42f12b654a2,1,6,31,37,4,2006-04-29 01:50:35,2006-04-29 01:50:35
674fc71d97db83997863a41a2055a42f12b654a2...fd70055334116f2c0689ba41238df37e393a3701,1,10,1,11,3,2006-04-29 01:54:26,2006-04-29 01:54:26
fd70055334116f2c0689ba41238df37e393a3701...1a3450ce76a8b61374a13932d1f8942904aacc4b,1,9,9,18,7,2006-04-29 01:55:59,2006-04-29 01:55:59
1a3450ce76a8b61374a13932d1f8942904aacc4b...0d2a34683dc6fe9a7dac7e52c51a4d9f716bb79e,1,4,4,8,4,2006-04-29 01:57:51,2006-04-29 01:57:51
0d2a34683dc6fe9a7dac7e52c51a4d9f716bb79e...a5bae83575b2410227b3344891a9f7c7c9fcdbc1,1,6,7,13,4,2006-04-29 01:59:25,2006-04-29 01:59:25
a5bae83575b2410227b3344891a9f7c7c9fcdbc1...8c3c027e414c081bef469feb73f4d3e842f06b49,1,28,6,34,8,2006-04-29 02:11:02,2006-04-29 02:11:02
8c3c027e414c081bef469feb73f4d3e842f06b49...bacbec8600d87ef2a28ab2fda447b94f5cef6960,1,104,99,203,41,2006-04-29 02:53:35,2006-04-29 02:53:35
bacbec8600d87ef2a28ab2fda447b94f5cef6960...ecd3d2e8c790a711e4fd4d073bc1a784f37db5b1,1,15,10,25,6,2006-04-29 02:57:58,2006-04-29 02:57:58
ecd3d2e8c790a711e4fd4d073bc1a784f37db5b1...71468fad80e1a7676c403bd1fc961e405c08914c,1,10,8,18,8,2006-04-29 03:02:10,2006-04-29 03:02:10
71468fad80e1a7676c403bd1fc961e405c08914c...7543588860906b754afb9d064f0f3e72a9ee337b,1,8,8,16,5,2006-04-29 03:04:00,2006-04-29 03:04:00
7543588860906b754afb9d064f0f3e72a9ee337b...bad6db26ff42e048e31c10dc85d7acf5147380f9,1,2,2,4,2,2006-04-29 17:10:29,2006-04-29 17:10:29
bad6db26ff42e048e31c10dc85d7acf5147380f9...bca30b81ef475c6617c2dea89034470ef9c08c3f,1,30,27,57,14,2006-04-29 18:52:53,2006-04-29 18:52:53
bca30b81ef475c6617c2dea89034470ef9c08c3f...716cd0c451675c094be18e8e342e5b108a3cb435,1,59,56,115,21,2006-04-29 18:53:03,2006-04-29 18:53:03
716cd0c451675c094be18e8e342e5b108a3cb435...5917d90e3027572231d15dba44badfd1d2be9073,1,58,53,111,27,2006-04-29 19:13:06,2006-04-29 19:13:06
5917d90e3027572231d15dba44badfd1d2be9073...a8572b18a9a2bb2b73950ce078f7c3aae9e8e5af,3,17,17,34,14,2006-04-30 03:42:53,2006-04-30 03:42:53
a8572b18a9a2bb2b73950ce078f7c3aae9e8e5af...b3ca785986e16b55645de0f86ab4f9ebf0a508f5,1,2,4,6,4,2006-05-01 03:22:27,2006-05-01 03:22:27
b3ca785986e16b55645de0f86ab4f9ebf0a508f5...5737801a146c6fa24e2b7f47dbcb812085146f7a,1,797,300,1097,91,2006-05-01 03:30:49,2006-05-01 03:30:49
5737801a146c6fa24e2b7f47dbcb812085146f7a...a1f47af81a560b6878c3d2e234b77e83e54c1a18,1,26,17,43,13,2006-05-01 03:39:59,2006-05-01 03:39:59
a1f47af81a560b6878c3d2e234b77e83e54c1a18...1a02e9d5c38ff05262bff4d25dff3892704e4b46,1,550,380,930,172,2006-05-01 04:22:37,2006-05-01 04:22:37
1a02e9d5c38ff05262bff4d25dff3892704e4b46...3b0e5d8d2950803c5503dae3af7565987a36f983,5,29,36,65,6,2006-05-01 15:02:39,2006-05-01 15:02:39
3b0e5d8d2950803c5503dae3af7565987a36f983...eeac3a174fa2720e6b23b793317f5033a271836b,1,1,1,2,1,2006-05-01 15:04:31,2006-05-01 15:04:31
eeac3a174fa2720e6b23b793317f5033a271836b...c0f399395214f08141f319c5b5f0330c50d2c995,1,36,17,53,3,2006-05-01 19:04:30,2006-05-01 19:04:30
c0f399395214f08141f319c5b5f0330c50d2c995...6ed8497f41f2919d4a62efe9b01c9dc034634090,1,1,1,2,1,2006-05-01 23:27:46,2006-05-01 23:27:46
6ed8497f41f2919d4a62efe9b01c9dc034634090...fecc815f3f67a25439cc1b5662e3254224cd1309,1,4,2,6,2,2006-05-01 23:29:59,2006-05-01 23:29:59
fecc815f3f67a25439cc1b5662e3254224cd1309...d2fcbcf9d76d5bb8a661ee73dae976c74183098b,1,3,2,5,2,2006-05-02 00:06:43,2006-05-02 00:06:43
d5dbeaa9be359a4c794885c2e9f1b5a7e5e51fb8...f69cf70ed813a8cd7e1f963a14ae39103e8d5265,366,17800,11166,28966,2350,2006-05-02 01:31:56,2006-05-02 01:31:56
f69cf70ed813a8cd7e1f963a14ae39103e8d5265...aa84e3a0df5d4b798b8b7715fbea293c0b934aa4,1,25,33,58,14,2006-05-02 01:55:25,2006-05-02 01:55:25
aa84e3a0df5d4b798b8b7715fbea293c0b934aa4...95cad003928df7131d0ba293944ad3464c466c14,1,1,1,2,1,2006-05-02 01:56:43,2006-05-02 01:56:43
95cad003928df7131d0ba293944ad3464c466c14...75824ba82d1db864cd598e6d9388101ec113a1ef,3,4,4,8,4,2006-05-02 01:59:39,2006-05-02 01:59:39
75824ba82d1db864cd598e6d9388101ec113a1ef...a4b2c109324bcab4297ddb074eeda7173b14db66,1,1,1,2,1,2006-05-02 02:01:19,2006-05-02 02:01:19
a4b2c109324bcab4297ddb074eeda7173b14db66...7ee211e45d27889011c941da4339cc5cc752be6d,1,1,1,2,1,2006-05-02 13:18:43,2006-05-02 13:18:43
7ee211e45d27889011c941da4339cc5cc752be6d...cc4196a407095b803f0325513c58520ebbff82bb,1,6,6,12,6,2006-05-02 18:44:22,2006-05-02 18:44:22
cc4196a407095b803f0325513c58520ebbff82bb...aba95b718cff6a4690a9bcadedd2dbff7439c4a2,1,31,0,31,1,2006-05-02 19:22:33,2006-05-02 19:22:33
aba95b718cff6a4690a9bcadedd2dbff7439c4a2...69d6bd7af380d47edee2c7bdf02fef41e183acd1,2,5,4,9,2,2006-05-02 19:51:41,2006-05-02 19:51:41
69d6bd7af380d47edee2c7bdf02fef41e183acd1...aa3712bef038b94787c77ce80e0f401392c84f70,1,2,2,4,2,2006-05-03 02:18:10,2006-05-03 02:18:10
aa3712bef038b94787c77ce80e0f401392c84f70...c62a014049257ada0d47c296eef2c14f51e49646,1,0,10,10,1,2006-05-03 04:19:59,2006-05-03 04:19:59
c62a014049257ada0d47c296eef2c14f51e49646...227d48af1cf77947caf0ca384e62ac04afa51259,1,250,174,424,65,2006-05-03 06:22:08,2006-05-03 06:22:08
227d48af1cf77947caf0ca384e62ac04afa51259...bc038daf14f6a03f5a4f7bb7708b5eea0abbcbbd,1,1,1,2,1,2006-05-03 13:35:02,2006-05-03 13:35:02
bc038daf14f6a03f5a4f7bb7708b5eea0abbcbbd...3ec68658ec65055efb82b8f1f66fe932aed3f47e,1,2,3,5,1,2006-05-03 13:50:32,2006-05-03 13:50:32
3ec68658ec65055efb82b8f1f66fe932aed3f47e...ceecba2973d0ff965936425ab0c9e09a4d50e537,1,8,8,16,8,2006-05-03 19:23:44,2006-05-03 19:23:44
ceecba2973d0ff965936425ab0c9e09a4d50e537...fc7b5fa0aefc53bf709a23d08f0a01693ab50b7c,1,2,2,4,2,2006-05-03 20:01:11,2006-05-03 20:01:11
fc7b5fa0aefc53bf709a23d08f0a01693ab50b7c...332726981fc0b3ec7e533db0fab35583bf2ee34c,1,24,8,32,3,2006-05-03 21:21:25,2006-05-03 21:21:25
332726981fc0b3ec7e533db0fab35583bf2ee34c...c6750acfe323c6934e4e8a8306a8449a43901cb8,1,0,8,8,1,2006-05-04 02:45:00,2006-05-04 02:45:00
c6750acfe323c6934e4e8a8306a8449a43901cb8...2b551dec408dae44f3e9a75a3e7fe2128cc4bd52,1,2,2,4,2,2006-05-04 04:09:23,2006-05-04 04:09:23
2b551dec408dae44f3e9a75a3e7fe2128cc4bd52...1f57fcac988a57b90ac0008d82127ba5539b82ea,1,2,5,7,4,2006-05-04 04:59:22,2006-05-04 04:59:22
1f57fcac988a57b90ac0008d82127ba5539b82ea...08fc16705fec15ab9b8b19333a07536aa8e4fe1d,1,311,197,508,77,2006-05-04 04:59:45,2006-05-04 04:59:45
08fc16705fec15ab9b8b19333a07536aa8e4fe1d...223a708278053a7ac40b09af8fdcdc694ca69dda,1,7,0,7,1,2006-05-04 14:17:56,2006-05-04 14:17:56
223a708278053a7ac40b09af8fdcdc694ca69dda...583dcdcede2453fd7ff4e4f26222f9e75b46bb8d,1,0,4,4,1,2006-05-04 17:09:18,2006-05-04 17:09:18
583dcdcede2453fd7ff4e4f26222f9e75b46bb8d...a79cbb5fe818eb50de8ba618509594c03cada702,1,1,1,2,1,2006-05-04 19:35:30,2006-05-04 19:35:30
a79cbb5fe818eb50de8ba618509594c03cada702...a8ccdd0fcd631e8e928ef20547e1fe3e313dc607,1,232,137,369,46,2006-05-05 01:56:29,2006-05-05 01:56:29
a8ccdd0fcd631e8e928ef20547e1fe3e313dc607...be552664ba1b2275d4ca84ab530d595830d22d4c,1,1,0,1,1,2006-05-05 02:36:08,2006-05-05 02:36:08
be552664ba1b2275d4ca84ab530d595830d22d4c...9fec605d8d0dff835c9e6bddfc4919a1c3470fa5,2,2,0,2,2,2006-05-05 02:38:32,2006-05-05 02:38:32
9fec605d8d0dff835c9e6bddfc4919a1c3470fa5...9a0873f77aab3ec88d0c1fdfc5dc47e21db49a26,1,8,8,16,7,2006-05-05 02:45:13,2006-05-05 02:45:13
9a0873f77aab3ec88d0c1fdfc5dc47e21db49a26...00ea535d949cc880395d86d7c6eeeec26ab8498a,1,34,7,41,2,2006-05-05 02:56:15,2006-05-05 02:56:15
00ea535d949cc880395d86d7c6eeeec26ab8498a...adf6126c81785856c917b42051e821798cc5f8d8,1,2,0,2,1,2006-05-05 02:57:19,2006-05-05 02:57:19
adf6126c81785856c917b42051e821798cc5f8d8...775c06a959bfd1e156810b632604abf845f11be8,2,4,1,5,2,2006-05-05 02:59:58,2006-05-05 02:59:58
775c06a959bfd1e156810b632604abf845f11be8...f2ef28fd5cd092b43f6dd33e127c20e66ea74fb8,1,2,2,4,1,2006-05-05 03:02:11,2006-05-05 03:02:11
f2ef28fd5cd092b43f6dd33e127c20e66ea74fb8...f94f0555bcf98e8b05874dfa3c804393ff4b91f4,2,20,1,21,4,2006-05-05 03:08:29,2006-05-05 03:08:29
f94f0555bcf98e8b05874dfa3c804393ff4b91f4...427a54b4a369b160f9d0ce76fdd72bb3cd89f142,1,9,0,9,1,2006-05-05 03:17:51,2006-05-05 03:17:51
427a54b4a369b160f9d0ce76fdd72bb3cd89f142...503a27d2123d33cac701d04f848e2b18a6c030c8,1,1,1,2,2,2006-05-05 03:19:16,2006-05-05 03:19:16
503a27d2123d33cac701d04f848e2b18a6c030c8...b301640a1b96cff9a567204abacff3784c343574,1,1,1,2,1,2006-05-05 03:24:42,2006-05-05 03:24:42
b301640a1b96cff9a567204abacff3784c343574...cca0e7346d314220e489c156d6a552a75244fbd4,1,2,2,4,1,2006-05-05 04:08:14,2006-05-05 04:08:14
cca0e7346d314220e489c156d6a552a75244fbd4...87416a9c3ca50fe7c9a8a34625714253bda25ac8,1,3,1,4,2,2006-05-05 04:27:16,2006-05-05 04:27:16
87416a9c3ca50fe7c9a8a34625714253bda25ac8...4f15f10048ab40f939d8229967820f321c082d28,0,0,0,0,0,2006-05-05 04:41:22,2006-05-05 04:41:22
4f15f10048ab40f939d8229967820f321c082d28...a0872543a7d1cbcb4576ef3d41ef413edf89e3c1,1,1,1,2,1,2006-05-05 12:52:15,2006-05-05 12:52:15
a0872543a7d1cbcb4576ef3d41ef413edf89e3c1...3f932e31dc4f1c4146ed42f7dc8ca7154b06481a,1,17,17,34,1,2006-05-05 18:31:16,2006-05-05 18:31:16
3f932e31dc4f1c4146ed42f7dc8ca7154b06481a...f57e34e99038bf0834638e6690d04d3ca59cde81,8,39,8,47,10,2006-05-06 00:26:24,2006-05-06 00:26:24
f57e34e99038bf0834638e6690d04d3ca59cde81...eb4bbbb6f3346f49b25930ef6a32ce0a7b1ae3ec,1,6,2,8,2,2006-05-06 03:27:49,2006-05-06 03:27:49
eb4bbbb6f3346f49b25930ef6a32ce0a7b1ae3ec...058ab898b0bd22ad6c9af106400a20fa9ee74b53,1,2,1,3,2,2006-05-06 03:29:22,2006-05-06 03:29:22
058ab898b0bd22ad6c9af106400a20fa9ee74b53...0c31254376c93eb90753bc3bb974296c6d5e19c5,1,16,13,29,8,2006-05-06 03:31:26,2006-05-06 03:31:26
0c31254376c93eb90753bc3bb974296c6d5e19c5...4bc4aa2fa6d9fd6eabc8f03f888c9ae88a2d1cbe,1,1,1,2,1,2006-05-06 03:32:01,2006-05-06 03:32:01
4bc4aa2fa6d9fd6eabc8f03f888c9ae88a2d1cbe...862328a98f63febb501a6ebb5d09c2db0574b53d,1,11,4,15,2,2006-05-06 03:44:14,2006-05-06 03:44:14
862328a98f63febb501a6ebb5d09c2db0574b53d...0b73811e26e3c06e6ce8c2f1df7d1c97673dd08a,1,5,2,7,2,2006-05-06 12:15:19,2006-05-06 12:15:19
0b73811e26e3c06e6ce8c2f1df7d1c97673dd08a...71f45686137dc45717f41e145b260d960c4bb2e5,1,1,1,2,1,2006-05-06 18:35:51,2006-05-06 18:35:51
71f45686137dc45717f41e145b260d960c4bb2e5...0727df90f0c301c98b560766ea869802ec3802fc,5,6,6,12,6,2006-05-06 18:36:32,2006-05-06 18:36:32
0727df90f0c301c98b560766ea869802ec3802fc...7a62bac56ea484adb21f49ee88a322d1e08f74ba,3,10,7,17,4,2006-05-06 18:46:53,2006-05-06 18:46:53
7a62bac56ea484adb21f49ee88a322d1e08f74ba...d09ae12632cb8e3f4a82e4e4a0e368d636176f3c,1,0,5,5,1,2006-05-06 18:47:28,2006-05-06 18:47:28
d09ae12632cb8e3f4a82e4e4a0e368d636176f3c...df668ee7825dc32d309c539bef13681541294451,1,1,0,1,1,2006-05-06 18:56:03,2006-05-06 18:56:03
df668ee7825dc32d309c539bef13681541294451...3c72a46f621d04189b48aba678e45fe3d23df5cb,1,4,4,8,3,2006-05-06 22:55:30,2006-05-06 22:55:30
3c72a46f621d04189b48aba678e45fe3d23df5cb...be0032f5bafb58bc055ef21910e197aa6547a96b,1,0,9,9,1,2006-05-06 23:16:43,2006-05-06 23:16:43
be0032f5bafb58bc055ef21910e197aa6547a96b...885dd85b5f7f35cf3266c6552d77f5577bb66828,1,13,12,25,1,2006-05-06 23:18:22,2006-05-06 23:18:22
d5dbeaa9be359a4c794885c2e9f1b5a7e5e51fb8...9a2f6a542a2e47d54c73852527caf3621fd90486,0,0,0,0,0,2006-05-02 01:09:45,2006-05-02 01:09:45
9a2f6a542a2e47d54c73852527caf3621fd90486...5623203d155e27d2ed59ebcc2ca4a9f976a82334,0,0,0,0,0,2006-08-13 00:58:37,2006-08-13 00:58:37
5623203d155e27d2ed59ebcc2ca4a9f976a82334...06a3c04c876776ec0dc212d55546d3f934f083b2,1,9,1,10,2,2006-08-13 01:38:55,2006-08-13 01:38:55
06a3c04c876776ec0dc212d55546d3f934f083b2...b70c86c36d2c8ebaa70d9de41e5fa23036580c07,1,1,1,2,1,2006-08-13 01:39:33,2006-08-13 01:39:33
b70c86c36d2c8ebaa70d9de41e5fa23036580c07...0d60669146a41e888f18560dcbae0bd333e8d074,1,0,2,2,1,2006-08-13 02:59:41,2006-08-13 02:59:41
0d60669146a41e888f18560dcbae0bd333e8d074...d31e39173c29537e6a1613278c93634c18a3206e,1,8,1,9,1,2006-08-16 06:28:59,2006-08-16 06:28:59
d31e39173c29537e6a1613278c93634c18a3206e...db2e70a74ba8ca17b520cde2025e5356fadca33c,1,3,4,7,2,2006-09-05 16:03:02,2006-09-05 16:03:02
db2e70a74ba8ca17b520cde2025e5356fadca33c...4b973479217fcbb223b43a4a22ace8f241500d80,1,35,31,66,14,2006-09-05 16:35:20,2006-09-05 16:35:20
4b973479217fcbb223b43a4a22ace8f241500d80...e35be34c21b2c121c04bbc369e8e577325f05ee2,1,5,5,10,4,2006-09-05 16:36:09,2006-09-05 16:36:09
e35be34c21b2c121c04bbc369e8e577325f05ee2...b45710875178e99852210677ac0940c50f810044,1,12,2,14,2,2006-10-25 20:25:54,2006-10-25 20:25:54
b45710875178e99852210677ac0940c50f810044...c08f81ff5eff5036e1e68aef370b31085d86c8dd,1,1,1,2,1,2006-10-27 19:17:38,2006-10-27 19:17:38
c08f81ff5eff5036e1e68aef370b31085d86c8dd...3720a12a2adcb3f1283ea34c53f7b1e5094dc871,1,1,1,2,1,2006-10-27 19:19:28,2006-10-27 19:19:28
3720a12a2adcb3f1283ea34c53f7b1e5094dc871...1fcef7a07e3fd074f5763daf35a17e415e9fa863,1,6,6,12,2,2006-11-24 18:16:36,2006-11-24 18:16:36
1fcef7a07e3fd074f5763daf35a17e415e9fa863...2823775114d4e27262e2b1e33e91a994b25a1402,1,23,2,25,2,2006-11-24 18:24:34,2006-11-24 18:24:34
2823775114d4e27262e2b1e33e91a994b25a1402...f93190551794303bae40eb266b1af7b353186931,1,24,3,27,1,2006-11-24 18:24:49,2006-11-24 18:24:49
f93190551794303bae40eb266b1af7b353186931...d0672a7344ea2eba53073f597f6adbed9023a279,1,33,0,33,2,2007-01-24 19:57:41,2007-01-24 19:57:41
d0672a7344ea2eba53073f597f6adbed9023a279...02ca9fd1ded3f4d50be7166033af7a676e042625,1,2,2,4,2,2007-01-30 19:06:08,2007-01-30 19:06:08
02ca9fd1ded3f4d50be7166033af7a676e042625...8a0fa758398768f28d73856275651719d00fe991,1,2,2,4,2,2007-03-07 17:03:43,2007-03-07 17:03:43
8a0fa758398768f28d73856275651719d00fe991...f46f052e059624f7f2ac057f1a2840236d46b189,1,1,1,2,1,2007-03-09 17:42:47,2007-03-09 17:42:47
f46f052e059624f7f2ac057f1a2840236d46b189...18cf40006c53e3263e2f9af6cb55c1ee5eef7deb,1,1,1,2,1,2007-03-09 22:43:44,2007-03-09 22:43:44
18cf40006c53e3263e2f9af6cb55c1ee5eef7deb...d8b1717266acf316b42075b2ce023348dc3de151,1,2,2,4,1,2007-03-12 15:46:36,2007-03-12 15:46:36
d8b1717266acf316b42075b2ce023348dc3de151...32b733ccbd35bd48003621cb2c86ef442e44ad3f,1,1,1,2,1,2007-03-12 17:12:10,2007-03-12 17:12:10
32b733ccbd35bd48003621cb2c86ef442e44ad3f...f63faca4c64d07b0c48ca87b1a93c0eee2f375ca,1,1,1,2,1,2007-04-05 18:36:04,2007-04-05 18:36:04
f63faca4c64d07b0c48ca87b1a93c0eee2f375ca...1680e8709cc9bea62ffa93d57fba29636f29ea74,1,46,23,69,23,2007-06-21 16:38:51,2007-06-21 16:38:51
1680e8709cc9bea62ffa93d57fba29636f29ea74...17e98808c190d1dae03f09d9fd544f698662d3e9,1,11,2,13,2,2007-06-21 16:46:23,2007-06-21 16:46:23
17e98808c190d1dae03f09d9fd544f698662d3e9...e6f09afa7871e7d1b813e126841220515193c9e2,1,8,0,8,1,2007-07-11 17:41:58,2007-07-11 17:41:58
e6f09afa7871e7d1b813e126841220515193c9e2...0417b0f17b9203fafcd90636fa65d0af8af10f81,1,0,8,8,1,2007-07-11 17:47:06,2007-07-11 17:47:06
0417b0f17b9203fafcd90636fa65d0af8af10f81...d797b34bf806fd8e1525e3931dd2545355877886,1,1,4,5,1,2007-09-17 19:00:39,2007-09-17 19:00:39
d797b34bf806fd8e1525e3931dd2545355877886...56c074f565522c2a9d5e798020553605064a1eed,1,6,0,6,3,2007-10-08 20:53:23,2007-10-08 20:53:23
56c074f565522c2a9d5e798020553605064a1eed...9cd09e756262a1b758bbd86f73e6c631e55e9073,1,5,3,8,4,2007-10-10 15:51:38,2007-10-10 15:51:38
9cd09e756262a1b758bbd86f73e6c631e55e9073...613cfabdd07276318d56a27678ef03b04d99b16e,1,3,0,3,2,2007-10-12 18:47:11,2007-10-12 18:47:11
613cfabdd07276318d56a27678ef03b04d99b16e...8bc36e726c9e8c75c681d3ad232df8e882aaac81,2,71,44,115,8,2007-10-26 19:52:04,2007-10-26 19:52:04
8bc36e726c9e8c75c681d3ad232df8e882aaac81...2c03839d79c6990bd5a9ae3c0f0d8bba28c1c857,1,3,4,7,2,2008-02-25 18:02:13,2008-02-25 18:02:13
2c03839d79c6990bd5a9ae3c0f0d8bba28c1c857...6e657e2c404a96e744748209e896d8a69c15fdf2,1,2,1,3,2,2008-05-14 04:07:42,2008-05-14 04:07:42
6e657e2c404a96e744748209e896d8a69c15fdf2...f6c56d473f173ad09e973eed55428b34c4a667f0,1,1,1,2,1,2008-05-14 04:16:31,2008-05-14 04:16:31
f6c56d473f173ad09e973eed55428b34c4a667f0...44debfeaa4473bd28872c735dd3d9afde6886752,2,3,40,43,8,2008-09-02 21:10:00,2008-09-02 21:10:00
44debfeaa4473bd28872c735dd3d9afde6886752...30d4c16ade9218e0166791a78be511510936c078,2,2,2,4,2,2008-09-02 21:18:07,2008-09-02 21:18:07
30d4c16ade9218e0166791a78be511510936c078...7d3b4093118c19d65909e53a008fe372891ae4da,1,1,1,2,1,2008-10-12 05:01:01,2008-10-12 05:01:01
7d3b4093118c19d65909e53a008fe372891ae4da...aa5133500b0bd279db47928ec3bd5fd8bade3d44,1,43,8,51,6,2008-12-19 20:11:18,2008-12-19 20:11:18
885dd85b5f7f35cf3266c6552d77f5577bb66828...8e441e9c5a792e225be683fd0ec8cdfb709ce91a,1,2,2,4,1,2006-05-08 20:39:52,2006-05-08 20:39:52
8e441e9c5a792e225be683fd0ec8cdfb709ce91a...f0141f1c1c17bad4e1fd9bb922c92d23f97ad4b2,1,9,6,15,5,2006-05-08 21:59:37,2006-05-08 21:59:37
f0141f1c1c17bad4e1fd9bb922c92d23f97ad4b2...8eecb95ec8824f8e6ce89fa7a96e094db906a0f5,4,162,0,162,3,2006-05-08 23:03:08,2006-05-08 23:03:08
8eecb95ec8824f8e6ce89fa7a96e094db906a0f5...4b69ef637a4b621b162a6ec05751cf5f30643fb1,5,12,8,20,10,2006-05-09 15:21:28,2006-05-09 15:21:28
4b69ef637a4b621b162a6ec05751cf5f30643fb1...ad181e21c28b4af836ed5ac3267094e527504cdd,1,1,1,2,1,2006-05-09 15:29:53,2006-05-09 15:29:53
ad181e21c28b4af836ed5ac3267094e527504cdd...6341b43dfb6f1f22b2f321a6bf1b7f7b43ed945b,1,2,2,4,2,2006-05-09 15:31:03,2006-05-09 15:31:03
6341b43dfb6f1f22b2f321a6bf1b7f7b43ed945b...c63372f3c4186fabeb61081db5421204008fd98c,1,1,1,2,1,2006-05-09 15:36:14,2006-05-09 15:36:14
c63372f3c4186fabeb61081db5421204008fd98c...05fd735afe721c43b5096f7d0d7367b3653431c2,1,1,1,2,1,2006-05-09 15:45:09,2006-05-09 15:45:09
05fd735afe721c43b5096f7d0d7367b3653431c2...0627ad320c6383b4be00ac9b18df46c9a1617b81,1,2,2,4,2,2006-05-09 16:04:03,2006-05-09 16:04:03
0627ad320c6383b4be00ac9b18df46c9a1617b81...9cec2928eda907b76f3ed47896b5b2ecac43801f,4,150,260,410,89,2006-05-09 16:13:14,2006-05-09 16:13:14
9cec2928eda907b76f3ed47896b5b2ecac43801f...9869a8ed31defbc943f928a93a3b5930a0033038,4,2063,1969,4032,2,2006-05-09 16:15:35,2006-05-09 16:15:35
9869a8ed31defbc943f928a93a3b5930a0033038...2ad386f3b3bb92255c7f4ffb387681bd82f874b5,2,12,12,24,11,2006-05-09 16:16:54,2006-05-09 16:16:54
2ad386f3b3bb92255c7f4ffb387681bd82f874b5...f1ed2af2bd595b3661eb75bb6db996da567e80b5,1,1,1,2,1,2006-05-09 16:17:35,2006-05-09 16:17:35
f1ed2af2bd595b3661eb75bb6db996da567e80b5...6917a9b49a73b2736b06d712ccc25f913046c15d,4,1483,1349,2832,340,2006-05-09 16:19:14,2006-05-09 16:19:14
6917a9b49a73b2736b06d712ccc25f913046c15d...3248a28b2088a728d63a0514df8a37835cd2b676,2,13,13,26,12,2006-05-09 16:21:37,2006-05-09 16:21:37
3248a28b2088a728d63a0514df8a37835cd2b676...887131c749d92eb87bee93cff950ea4fec484dc4,1,3,3,6,3,2006-05-09 21:32:56,2006-05-09 21:32:56
887131c749d92eb87bee93cff950ea4fec484dc4...de3edb74c58b1d2db6e65c7eeb185e96f9880b1f,1,4,1,5,1,2006-05-10 16:10:07,2006-05-10 16:10:07
de3edb74c58b1d2db6e65c7eeb185e96f9880b1f...412db6c929ea8a66ded466bc879159b7de1452b0,1,1,1,2,1,2006-05-11 14:38:27,2006-05-11 14:38:27
412db6c929ea8a66ded466bc879159b7de1452b0...83a99bc28b7b5a46a9bd3d9e52d2d84e94e9f7e4,1,1,1,2,1,2006-05-11 14:41:43,2006-05-11 14:41:43
83a99bc28b7b5a46a9bd3d9e52d2d84e94e9f7e4...edce4128e14042c28886bb9ab12d92bf83c5b704,1,1,1,2,1,2006-05-11 17:51:30,2006-05-11 17:51:30
edce4128e14042c28886bb9ab12d92bf83c5b704...4116403a55fd816220703a8ae9f3ed592131ba5a,1,5,2,7,2,2006-05-11 21:51:24,2006-05-11 21:51:24
4116403a55fd816220703a8ae9f3ed592131ba5a...c4274795391488afca2bf75e6eda32ab22906637,2,2,2,4,2,2006-05-11 21:52:23,2006-05-11 21:52:23
c4274795391488afca2bf75e6eda32ab22906637...c26553c4f91a2a0ac1ca8d173888c414fc9cecda,1,1,1,2,1,2006-05-11 21:55:53,2006-05-11 21:55:53
c26553c4f91a2a0ac1ca8d173888c414fc9cecda...5c0e4f3908d7782939b4a16af3d3be9f07d5504b,1,16,8,24,5,2006-05-11 22:32:47,2006-05-11 22:32:47
5c0e4f3908d7782939b4a16af3d3be9f07d5504b...aa11b3ea503ba1e6247e1629aa13f2752f32e3a9,2,11,1,12,4,2006-05-13 17:18:42,2006-05-13 17:18:42
aa11b3ea503ba1e6247e1629aa13f2752f32e3a9...1006d6eb06e202a5060d7346973a3dbc3bd0ec53,3,19,1,20,3,2006-05-14 23:49:29,2006-05-14 23:49:29
1006d6eb06e202a5060d7346973a3dbc3bd0ec53...785ada1bc8889072d29023a503486a01ca8b3028,1,1,1,2,1,2006-05-15 00:15:20,2006-05-15 00:15:20
785ada1bc8889072d29023a503486a01ca8b3028...fe257d49da9a789ec9217e05b4e321ccd360650e,1,1,1,2,1,2006-05-15 04:01:23,2006-05-15 04:01:23
fe257d49da9a789ec9217e05b4e321ccd360650e...51f6a9442c21d6288ccca9b8d9ebaf2f6ecd5b9d,3,4,3,7,4,2006-05-15 04:20:04,2006-05-15 04:20:04
51f6a9442c21d6288ccca9b8d9ebaf2f6ecd5b9d...55c9e98d86e717a3da832fc309947d70a68ffdb0,2,15,1,16,2,2006-05-15 04:24:48,2006-05-15 04:24:48
55c9e98d86e717a3da832fc309947d70a68ffdb0...d16215f6df78896587ba5e7b82040d772d72230a,1,1,1,2,1,2006-05-15 11:28:37,2006-05-15 11:28:37
d16215f6df78896587ba5e7b82040d772d72230a...34b798cb42263ca57a1e773441fa1f09716d50bc,4,8,8,16,8,2006-05-15 11:33:17,2006-05-15 11:33:17
34b798cb42263ca57a1e773441fa1f09716d50bc...3cef18cb51204c75bb4eefa4d309c7d6ec065f74,2,2,1,3,2,2006-05-15 18:50:54,2006-05-15 18:50:54
3cef18cb51204c75bb4eefa4d309c7d6ec065f74...d9c4af6b37b5c1d6e3afa4db35f4d60af5107c38,1,78,0,78,5,2006-05-16 04:05:55,2006-05-16 04:05:55
d9c4af6b37b5c1d6e3afa4db35f4d60af5107c38...ca197739d9e586e65af023791ebabf1ea6057cd1,3,40,1,41,6,2006-05-16 07:35:20,2006-05-16 07:35:20
ca197739d9e586e65af023791ebabf1ea6057cd1...25816ea383c1cfcf0b8fde2ce9aefecbe2fc1923,1,2,2,4,1,2006-05-16 07:38:23,2006-05-16 07:38:23
25816ea383c1cfcf0b8fde2ce9aefecbe2fc1923...d2ba1c3cca88916f262f063613b1388a7a58f5f3,5,1919,0,1919,3,2006-05-16 07:41:39,2006-05-16 07:41:39
d2ba1c3cca88916f262f063613b1388a7a58f5f3...be66d0a5abdb94d15098c69a224e7656ee7f8115,4,472,456,928,305,2006-05-16 07:43:39,2006-05-16 07:43:39
be66d0a5abdb94d15098c69a224e7656ee7f8115...947de22e3e6e00c40cf91c281706297b449aed99,2,557,480,1037,221,2006-05-16 07:48:17,2006-05-16 07:48:17
947de22e3e6e00c40cf91c281706297b449aed99...3f627e8efaffa6c52355696e43a9f9df9f452688,2,1,1,2,1,2006-05-16 08:02:21,2006-05-16 08:02:21
3f627e8efaffa6c52355696e43a9f9df9f452688...a8455bba92aba0ea661a75d913b392fb1f5993ee,56,21735,17677,39412,6389,2006-05-16 08:07:45,2006-05-16 08:07:45
a8455bba92aba0ea661a75d913b392fb1f5993ee...47d18514b07fa59ea8b092eb319f6fd60a502ec7,2,13,1,14,2,2006-05-16 20:28:50,2006-05-16 20:28:50
47d18514b07fa59ea8b092eb319f6fd60a502ec7...aa6b13c96bb76f1603adf9fcf512ac842d478f32,1,1,0,1,1,2006-05-16 20:41:37,2006-05-16 20:41:37
aa6b13c96bb76f1603adf9fcf512ac842d478f32...27612d8b7d9263d883b83331883c7bbe862122e0,3,6,5,11,3,2006-05-16 20:45:20,2006-05-16 20:45:20
27612d8b7d9263d883b83331883c7bbe862122e0...c643e12faf85478149386768d278c44936aa99a3,8,213,20,233,20,2006-05-16 21:28:06,2006-05-16 21:28:06
c643e12faf85478149386768d278c44936aa99a3...88ca662e7562d7dc27b06ffb8291cde160d4ece7,5,128,0,128,4,2006-05-16 23:27:07,2006-05-16 23:27:07
88ca662e7562d7dc27b06ffb8291cde160d4ece7...268462d686959d8219c1a828ee6850293d45ab67,1,2,0,2,1,2006-05-17 02:02:26,2006-05-17 02:02:26
268462d686959d8219c1a828ee6850293d45ab67...93201c89b4ff6e984b7bbfd51d4814263f293b2d,1,11,3,14,2,2006-05-17 02:39:52,2006-05-17 02:39:52
93201c89b4ff6e984b7bbfd51d4814263f293b2d...eb707d8c4380b0423232dc8462f5b215fbfa2286,1,88,44,132,11,2006-05-17 04:01:00,2006-05-17 04:01:00
eb707d8c4380b0423232dc8462f5b215fbfa2286...390231d4068a550ef8188807c6e7e7b2f0fb1521,1,7,0,7,1,2006-05-17 06:57:22,2006-05-17 06:57:22
390231d4068a550ef8188807c6e7e7b2f0fb1521...bccc0fb5e6d52d568cb8b8f551dd5c9aef425f90,2,158,249,407,139,2006-05-17 08:13:17,2006-05-17 08:13:17
bccc0fb5e6d52d568cb8b8f551dd5c9aef425f90...0ed64fe3298d4f72e90c7f5fa00c805c8f24f58c,2,92,10,102,6,2006-05-18 03:36:58,2006-05-18 03:36:58
0ed64fe3298d4f72e90c7f5fa00c805c8f24f58c...9c07d20cd427aecf227cece5a51b8ca67aadb69e,2,66,190,256,104,2006-05-18 10:59:29,2006-05-18 10:59:29
9c07d20cd427aecf227cece5a51b8ca67aadb69e...98d6eac81c91c5852b4a84e412bcabc14f5b25c2,2,1154,1154,2308,220,2006-05-18 11:00:35,2006-05-18 11:00:35
98d6eac81c91c5852b4a84e412bcabc14f5b25c2...ce6f058bbb79e9b9eae198b066c6db6eb0683a21,1,16,16,32,13,2006-05-18 12:41:24,2006-05-18 12:41:24
ce6f058bbb79e9b9eae198b066c6db6eb0683a21...20416b2972ed0303a0ab47514bd58e842dbee487,2,7,4,11,3,2006-05-18 15:17:42,2006-05-18 15:17:42
20416b2972ed0303a0ab47514bd58e842dbee487...5a8ed6f7f6932c554c7942874392b92755ef7400,1,3,3,6,1,2006-05-18 18:03:27,2006-05-18 18:03:27
5a8ed6f7f6932c554c7942874392b92755ef7400...e6ee9714983c7245747213a2a1d127070745c0ad,1,15,13,28,4,2006-05-18 18:25:49,2006-05-18 18:25:49
e6ee9714983c7245747213a2a1d127070745c0ad...026d8c6f0827164c58ea0284966ae46e4c1c279d,1,158,0,158,1,2006-05-19 02:02:34,2006-05-19 02:02:34
026d8c6f0827164c58ea0284966ae46e4c1c279d...21dd8e272b50c6aba1a08e14ab232b10dcb6e8db,2,29,0,29,3,2006-05-19 03:37:50,2006-05-19 03:37:50
21dd8e272b50c6aba1a08e14ab232b10dcb6e8db...8632f8ac4ab427557a58300e243ccdb84859652a,1,11,0,11,1,2006-05-19 03:47:59,2006-05-19 03:47:59
8632f8ac4ab427557a58300e243ccdb84859652a...87709d3fa57114270accbd29370b1c3f27442300,1,15,0,15,1,2006-05-19 04:12:16,2006-05-19 04:12:16
87709d3fa57114270accbd29370b1c3f27442300...d5c9e194036d44785eda0c621725a2862e8aa6fe,2,49,37,86,8,2006-05-19 05:07:33,2006-05-19 05:07:33
d5c9e194036d44785eda0c621725a2862e8aa6fe...816b65f260e98b1b65ab171a807d0c9bad7328f1,1,3,0,3,1,2006-05-19 07:40:06,2006-05-19 07:40:06
816b65f260e98b1b65ab171a807d0c9bad7328f1...e57e06d40bc68c5eb182035d1c90e8f6184b374d,1,3,3,6,3,2006-05-19 09:41:40,2006-05-19 09:41:40
e57e06d40bc68c5eb182035d1c90e8f6184b374d...35869c53ef4e78d79ced4b6a3d003a127fa5fdf1,1,6,2,8,1,2006-05-20 03:35:25,2006-05-20 03:35:25
35869c53ef4e78d79ced4b6a3d003a127fa5fdf1...690f9ad8f091d5f5da97c12f8871aa7e1ade8307,1,21,56,77,13,2006-05-21 12:44:58,2006-05-21 12:44:58
690f9ad8f091d5f5da97c12f8871aa7e1ade8307...2c5e9fcf7369aa84c43cea5d67c9b76d92836fee,1,10,0,10,1,2006-05-21 20:20:47,2006-05-21 20:20:47
2c5e9fcf7369aa84c43cea5d67c9b76d92836fee...d9aaa1ca86b5af482993abbef00aad73211659fc,1,1,1,2,1,2006-05-22 02:02:23,2006-05-22 02:02:23
d9aaa1ca86b5af482993abbef00aad73211659fc...dd55b5e98ac7517f8a06b8f0d69c2a2d0fe2e1b2,1,1,0,1,1,2006-05-22 02:17:06,2006-05-22 02:17:06
dd55b5e98ac7517f8a06b8f0d69c2a2d0fe2e1b2...75df13278caaceedd444c43c970c7d000f19b855,1,21,0,21,2,2006-05-22 02:24:32,2006-05-22 02:24:32
75df13278caaceedd444c43c970c7d000f19b855...be57a7fd1a743672fb4bd682950674aa6823190d,2,55,1,56,3,2006-05-22 02:46:55,2006-05-22 02:46:55
be57a7fd1a743672fb4bd682950674aa6823190d...0fc2a2c1a891a9729f99b550bca6334e97c0dce3,2,34,1,35,2,2006-05-22 03:01:02,2006-05-22 03:01:02
0fc2a2c1a891a9729f99b550bca6334e97c0dce3...cd54ba5696f1819a12bfbd26c1a26276846e6fcb,1,31,10,41,4,2006-05-22 03:14:33,2006-05-22 03:14:33
cd54ba5696f1819a12bfbd26c1a26276846e6fcb...d31f190239e9236cbfdd0900a89cff68b606e764,1,1,1,2,1,2006-05-22 04:47:14,2006-05-22 04:47:14
d31f190239e9236cbfdd0900a89cff68b606e764...e3839f32e5c3c9492c0a29b3af4da28f38a3ccda,4,267,2,269,5,2006-05-22 04:48:44,2006-05-22 04:48:44
e3839f32e5c3c9492c0a29b3af4da28f38a3ccda...a9039dc6b3a01f9af225f699a7da930d99ecdcea,1,11,0,11,1,2006-05-22 04:59:22,2006-05-22 04:59:22
a9039dc6b3a01f9af225f699a7da930d99ecdcea...ddd37b20f14e25848031ed424ad5d84dc4e9480a,1,12,12,24,3,2006-05-22 05:04:40,2006-05-22 05:04:40
ddd37b20f14e25848031ed424ad5d84dc4e9480a...4cb7a2753f774fa5e1b4df747c16d917d6c4c57c,1,20,5,25,4,2006-05-22 05:17:25,2006-05-22 05:17:25
4cb7a2753f774fa5e1b4df747c16d917d6c4c57c...610cffe80e1d6e1f603ce50d248de22c41c871fa,1,50,0,50,1,2006-05-22 05:22:45,2006-05-22 05:22:45
610cffe80e1d6e1f603ce50d248de22c41c871fa...e3ac3bc074b0fe56af856adb41d8220cfe376fbb,1,5,0,5,1,2006-05-22 05:22:58,2006-05-22 05:22:58
e3ac3bc074b0fe56af856adb41d8220cfe376fbb...f953c8afb6b4a5f675655dae60c820598543cff8,1,1,1,2,1,2006-05-22 05:38:20,2006-05-22 05:38:20
f953c8afb6b4a5f675655dae60c820598543cff8...8fbf9714c321b8a4a1a2c76d1d60c2487acc2413,1,2,2,4,1,2006-05-23 01:34:06,2006-05-23 01:34:06
8fbf9714c321b8a4a1a2c76d1d60c2487acc2413...9a4c39bb82582fe492d652d61b44449bd688f11d,1,1,1,2,1,2006-05-23 14:20:51,2006-05-23 14:20:51
9a4c39bb82582fe492d652d61b44449bd688f11d...23269289bee44cb9c9dcaa1512a3e49539f936f6,1,1,1,2,2,2006-05-23 19:34:43,2006-05-23 19:34:43
23269289bee44cb9c9dcaa1512a3e49539f936f6...a666b987835e99c55f51cd2feaf287111cbfcd86,3,8,3,11,4,2006-05-23 19:55:30,2006-05-23 19:55:30
a666b987835e99c55f51cd2feaf287111cbfcd86...4b448482866a889b0fc7a8399f019085a4bc27a3,2,57,122,179,122,2006-05-24 14:05:58,2006-05-24 14:05:58
4b448482866a889b0fc7a8399f019085a4bc27a3...a49f5f026e8de461caa1ec09054d745cbf8ee303,2,1,1,2,1,2006-05-24 14:13:44,2006-05-24 14:13:44
a49f5f026e8de461caa1ec09054d745cbf8ee303...b6c9a908c8c33678765f9219c14822a520123160,4,346,380,726,350,2006-05-24 14:16:53,2006-05-24 14:16:53
b6c9a908c8c33678765f9219c14822a520123160...6306e7f6ea76c263816c02a8e78a75e4b9c691c7,2,25,51,76,51,2006-05-24 14:18:09,2006-05-24 14:18:09
6306e7f6ea76c263816c02a8e78a75e4b9c691c7...31037f83e3525e44b629d76226945f5c1ef79fa4,2,187,328,515,144,2006-05-24 14:19:13,2006-05-24 14:19:13
31037f83e3525e44b629d76226945f5c1ef79fa4...b6b64737fc8ee30585be8ea49614cf0c01b32398,5,2140,0,2140,3,2006-05-24 14:22:05,2006-05-24 14:22:05
b6b64737fc8ee30585be8ea49614cf0c01b32398...9c9a2d8b0976f210a9f010fcafd83db9b4a4ce06,1,2,0,2,2,2006-05-24 14:30:08,2006-05-24 14:30:08
9c9a2d8b0976f210a9f010fcafd83db9b4a4ce06...b631a502506f90aecd19b37489839a2fde11b137,1,2,2,4,2,2006-05-25 05:09:25,2006-05-25 05:09:25
b631a502506f90aecd19b37489839a2fde11b137...14392b032de5f3893b996b6b62c8f51462bd3971,1,52,67,119,14,2006-05-25 05:29:27,2006-05-25 05:29:27
14392b032de5f3893b996b6b62c8f51462bd3971...be25b661b1b2179273b886ec45d4b449a9997a8d,7,23,23,46,8,2006-05-26 04:05:02,2006-05-26 04:05:02
be25b661b1b2179273b886ec45d4b449a9997a8d...7f2ca03c0e1b888d6906ea016c0d1d504a88e2cb,1,2,2,4,2,2006-05-26 04:06:46,2006-05-26 04:06:46
7f2ca03c0e1b888d6906ea016c0d1d504a88e2cb...d4f69f8fe91917d2895e15a4346b26125ffd37dd,1,1,0,1,1,2006-05-26 04:14:41,2006-05-26 04:14:41
d4f69f8fe91917d2895e15a4346b26125ffd37dd...fd16f1468a0c5825bdd631e9a223601d65f429fb,1,9,15,24,4,2006-05-26 04:21:36,2006-05-26 04:21:36
fd16f1468a0c5825bdd631e9a223601d65f429fb...f375b54503a15360e1b1c08a0ad09c5862bd2083,1,2,1,3,2,2006-05-26 04:40:48,2006-05-26 04:40:48
f375b54503a15360e1b1c08a0ad09c5862bd2083...0fd9eef86f56b8dfe219bb0a45f6e5ff8bb75226,2,12,1,13,3,2006-05-26 05:20:21,2006-05-26 05:20:21
0fd9eef86f56b8dfe219bb0a45f6e5ff8bb75226...cac7675f247da325cb862a312804fe64845d1155,5,210,0,210,4,2006-05-26 05:37:21,2006-05-26 05:37:21
cac7675f247da325cb862a312804fe64845d1155...33f805975506fea21e0b1e366ce7e2fddf9319e7,2,98,98,196,91,2006-05-26 11:14:09,2006-05-26 11:14:09
33f805975506fea21e0b1e366ce7e2fddf9319e7...674719bc8bc98c7001cb4fdef0ec09b7357b2087,4,1562,1561,3123,387,2006-05-26 11:16:58,2006-05-26 11:16:58
674719bc8bc98c7001cb4fdef0ec09b7357b2087...a537b8e515220986bff97cf5a97138c4eb2e8fa1,1,9,15,24,2,2006-05-26 16:30:42,2006-05-26 16:30:42
a537b8e515220986bff97cf5a97138c4eb2e8fa1...374d02e5983e2cb48a538fd10d51e4fdc05c204d,1,2,0,2,1,2006-05-26 17:30:40,2006-05-26 17:30:40
374d02e5983e2cb48a538fd10d51e4fdc05c204d...b63157c616104d19a92a7b9793693c73e4d047c5,1,1,1,2,1,2006-05-26 17:54:19,2006-05-26 17:54:19
b63157c616104d19a92a7b9793693c73e4d047c5...0c8ac0972c9b1a5af95d40334b83cf5f31d56331,2,13,0,13,2,2006-05-26 18:41:03,2006-05-26 18:41:03
0c8ac0972c9b1a5af95d40334b83cf5f31d56331...8e9833f26199b99180877d043bf4e944b99af39b,6,30,6,36,6,2006-05-26 18:58:46,2006-05-26 18:58:46
8e9833f26199b99180877d043bf4e944b99af39b...dc378e8ca7fd099ebf6fda37503db172d445c6d4,1,5,2,7,1,2006-05-26 19:02:23,2006-05-26 19:02:23
dc378e8ca7fd099ebf6fda37503db172d445c6d4...c21acb6aeb80caab77166c55567da7fe86fbb0e5,1,9,3,12,1,2006-05-26 19:28:55,2006-05-26 19:28:55
c21acb6aeb80caab77166c55567da7fe86fbb0e5...c3baf4668f655758b5251c048f740c5489104380,1,12,1,13,2,2006-05-26 21:28:12,2006-05-26 21:28:12
c3baf4668f655758b5251c048f740c5489104380...60c3e55b1f7c87ef9fa7c5ffdaf6e8dba5ab7043,2,17,6,23,8,2006-05-26 23:41:43,2006-05-26 23:41:43
60c3e55b1f7c87ef9fa7c5ffdaf6e8dba5ab7043...e9c8a9e136cf94168e8242013f93198eb903b16e,1,6,1,7,1,2006-05-29 11:02:32,2006-05-29 11:02:32
e9c8a9e136cf94168e8242013f93198eb903b16e...33a0aa6c73232842268abe0aa879ea25a1005411,2,1,1,2,1,2006-05-29 12:16:34,2006-05-29 12:16:34
33a0aa6c73232842268abe0aa879ea25a1005411...ea325adae287fcb255bdf2212d63291e155e48c7,2,195,199,394,181,2006-05-29 12:18:12,2006-05-29 12:18:12
ea325adae287fcb255bdf2212d63291e155e48c7...037f8d580407ecf346041a4cbc7f7bf9492378a4,2,17,11,28,9,2006-05-29 17:08:58,2006-05-29 17:08:58
037f8d580407ecf346041a4cbc7f7bf9492378a4...d3b1a9ba3923848e35152f5826e6967a85be9468,1,2,2,4,1,2006-05-30 01:11:27,2006-05-30 01:11:27
d3b1a9ba3923848e35152f5826e6967a85be9468...d7e929a85d9dcca8e55d946c0bdbab960521aa68,1,1,1,2,1,2006-05-30 01:12:52,2006-05-30 01:12:52
d7e929a85d9dcca8e55d946c0bdbab960521aa68...c86946f000d4620faaef7162bfe6c73f13ae4085,1,1,1,2,1,2006-05-30 02:47:33,2006-05-30 02:47:33
c86946f000d4620faaef7162bfe6c73f13ae4085...85ba40f4e24410cf22f7aa2f73e9ca73bf5f5c5c,1,1,1,2,1,2006-05-31 01:59:16,2006-05-31 01:59:16
85ba40f4e24410cf22f7aa2f73e9ca73bf5f5c5c...2f513e0f0e95d8f146385803743c7128dbc9b885,2,14,2,16,3,2006-05-31 02:09:07,2006-05-31 02:09:07
2f513e0f0e95d8f146385803743c7128dbc9b885...6b1e7bddc1316bd0d14e61652b1b431b0c04bc7d,1,1,1,2,1,2006-05-31 02:16:49,2006-05-31 02:16:49
6b1e7bddc1316bd0d14e61652b1b431b0c04bc7d...4a57ef858870faaadfcbc30cd8af4520fe7c9d51,1,2,2,4,2,2006-05-31 12:34:05,2006-05-31 12:34:05
4a57ef858870faaadfcbc30cd8af4520fe7c9d51...eb74800b31b145f2580006f25282c78f54cf490f,1,2,2,4,1,2006-05-31 12:36:01,2006-05-31 12:36:01
eb74800b31b145f2580006f25282c78f54cf490f...3c4e261931dbf9758c8e1ddab59376137d613fcb,1,1,1,2,1,2006-05-31 14:26:44,2006-05-31 14:26:44
3c4e261931dbf9758c8e1ddab59376137d613fcb...a0de8b3b21f1590c1eaad966f50136f1b4247de6,1,2,2,4,1,2006-05-31 14:29:11,2006-05-31 14:29:11
a0de8b3b21f1590c1eaad966f50136f1b4247de6...192c726ee63badb428ddc579d9bd006c90b8b895,1,2,2,4,2,2006-05-31 14:37:57,2006-05-31 14:37:57
192c726ee63badb428ddc579d9bd006c90b8b895...45518a052b5d014502d960911d1fda779b6fb90f,1,5,1,6,2,2006-05-31 14:52:33,2006-05-31 14:52:33
45518a052b5d014502d960911d1fda779b6fb90f...8623bd126ddf85344aaf5aedd933e90b32c71148,1,6,1,7,1,2006-05-31 14:53:23,2006-05-31 14:53:23
8623bd126ddf85344aaf5aedd933e90b32c71148...7098389fae47ecc791809f21d60193f2c5449a7b,1,1,1,2,1,2006-05-31 14:58:20,2006-05-31 14:58:20
7098389fae47ecc791809f21d60193f2c5449a7b...903023665223bca3e63aa0da4ef6c16adff47950,3,44,16,60,24,2006-05-31 15:08:06,2006-05-31 15:08:06
903023665223bca3e63aa0da4ef6c16adff47950...ea59344d725adc5c94a0ab2c1986c6a033329ad9,2,2,2,4,2,2006-05-31 15:10:01,2006-05-31 15:10:01
ea59344d725adc5c94a0ab2c1986c6a033329ad9...2543d0ae9373eeea9eebce3d48df930b3220a506,2,21,1,22,4,2006-05-31 15:25:23,2006-05-31 15:25:23
2543d0ae9373eeea9eebce3d48df930b3220a506...1bf991abb32c3fab1a1d81d3087d7f6e16a54559,1,4,1,5,1,2006-05-31 18:08:28,2006-05-31 18:08:28
1bf991abb32c3fab1a1d81d3087d7f6e16a54559...3daae59aab8d573ddec0c66a47c12a8baac7dd49,5,26,12,38,15,2006-05-31 18:45:17,2006-05-31 18:45:17
3daae59aab8d573ddec0c66a47c12a8baac7dd49...a846155118747d6cdebaa92326eac1b08118e8ff,5,19,18,37,13,2006-05-31 19:10:43,2006-05-31 19:10:43
a846155118747d6cdebaa92326eac1b08118e8ff...02fcfe621664488eab69d90158f65adef292e84a,6,33,30,63,25,2006-05-31 19:23:07,2006-05-31 19:23:07
02fcfe621664488eab69d90158f65adef292e84a...f10af2de24e2ed4df4173c25a11e94207b4a3847,1,2,2,4,1,2006-06-01 02:10:44,2006-06-01 02:10:44
f10af2de24e2ed4df4173c25a11e94207b4a3847...a2fceea1e36a10e45a99f27f8595a6f7f0ca04cf,1,1,1,2,1,2006-06-01 03:33:34,2006-06-01 03:33:34
a2fceea1e36a10e45a99f27f8595a6f7f0ca04cf...50994249756bbb5f91ca1a80e69440bf3a60fcde,1,1,2,3,1,2006-06-01 03:35:23,2006-06-01 03:35:23
50994249756bbb5f91ca1a80e69440bf3a60fcde...350c36077664154b1a4d86d670b33c72d7591d98,1,2,6,8,2,2006-06-01 03:37:59,2006-06-01 03:37:59
350c36077664154b1a4d86d670b33c72d7591d98...5c5d60aa635fe90537e137c20d7619c03c30f12e,1,4,0,4,1,2006-06-01 03:57:07,2006-06-01 03:57:07
5c5d60aa635fe90537e137c20d7619c03c30f12e...5077f9ceafa650cc2af7be6de55769f45eb7939e,2,33,1,34,7,2006-06-01 04:21:26,2006-06-01 04:21:26
5077f9ceafa650cc2af7be6de55769f45eb7939e...cb9cb2045b6c92166f27239cd94f725afdcd63d7,2,29,0,29,2,2006-06-01 04:29:39,2006-06-01 04:29:39
cb9cb2045b6c92166f27239cd94f725afdcd63d7...8ac9bb7ddf4896f26906dd8e17a62f22fa5eed41,1,6,6,12,6,2006-06-01 04:30:39,2006-06-01 04:30:39
8ac9bb7ddf4896f26906dd8e17a62f22fa5eed41...1ffa1a9bc8153417f11c43e348f371aacdf21b1c,1,4,0,4,1,2006-06-01 04:35:44,2006-06-01 04:35:44
1ffa1a9bc8153417f11c43e348f371aacdf21b1c...a371eb3c9004d1a88b27a50822c594d2af10dfce,1,6,2,8,2,2006-06-01 04:37:47,2006-06-01 04:37:47
a371eb3c9004d1a88b27a50822c594d2af10dfce...b4be0d2487532766a8709c0333e63ecbee96427d,1,2,2,4,3,2006-06-01 04:47:56,2006-06-01 04:47:56
b4be0d2487532766a8709c0333e63ecbee96427d...56131d0fb9a1a99577c3866ac63fa0cb8c779cbd,2,8,2,10,2,2006-06-01 04:57:10,2006-06-01 04:57:10
56131d0fb9a1a99577c3866ac63fa0cb8c779cbd...8cd32bddab2cd902fe2522de344839aaa55f2b23,1,1,1,2,1,2006-06-01 15:01:22,2006-06-01 15:01:22
8cd32bddab2cd902fe2522de344839aaa55f2b23...fa9722489b792cf05e43e3a09309faaeb9109660,3,19,20,39,15,2006-06-01 16:27:41,2006-06-01 16:27:41
fa9722489b792cf05e43e3a09309faaeb9109660...dbcd2fe985498889e1206f54c196f00879e79dae,2,16,4,20,4,2006-06-01 20:47:34,2006-06-01 20:47:34
dbcd2fe985498889e1206f54c196f00879e79dae...26b61aa8131c2bce21be22aa4d00720d6c1326ad,4,40,2,42,7,2006-06-01 22:25:06,2006-06-01 22:25:06
26b61aa8131c2bce21be22aa4d00720d6c1326ad...9ac29dd784c8bff4ac96ed44d38f35ab9c2b0069,1,0,0,0,0,2006-06-02 03:17:29,2006-06-02 03:17:29
9ac29dd784c8bff4ac96ed44d38f35ab9c2b0069...8b38cff1b05372d4bcef3800944326f02e9b94bd,1,3,3,6,2,2006-06-02 03:32:46,2006-06-02 03:32:46
8b38cff1b05372d4bcef3800944326f02e9b94bd...fe4139de318c7887ad465b6a8ea5e5ac13c1bce6,1,1,0,1,1,2006-06-02 03:56:51,2006-06-02 03:56:51
fe4139de318c7887ad465b6a8ea5e5ac13c1bce6...1717b94fc85430a1b0b8626d9b932fda58563e50,1,20,0,20,1,2006-06-02 04:04:04,2006-06-02 04:04:04
1717b94fc85430a1b0b8626d9b932fda58563e50...ab2fb1634f22d655ca38bd9ae7db9de3d1a629a3,3,66,6,72,9,2006-06-02 04:20:32,2006-06-02 04:20:32
ab2fb1634f22d655ca38bd9ae7db9de3d1a629a3...927d4fb1e1c781a819019deac23daea3189b6214,1,9,7,16,9,2006-06-02 04:26:07,2006-06-02 04:26:07
927d4fb1e1c781a819019deac23daea3189b6214...bd5b35069b6f3670b095587b18ac5507def7ff2d,1,31,18,49,4,2006-06-02 04:38:16,2006-06-02 04:38:16
bd5b35069b6f3670b095587b18ac5507def7ff2d...16a07fe95b7bc23c8dddd7ffbf85a150a2a57d9d,1,5,1,6,2,2006-06-02 04:42:10,2006-06-02 04:42:10
16a07fe95b7bc23c8dddd7ffbf85a150a2a57d9d...12254540c7d0d20ca355e1231d893817df4a9947,1,6,0,6,1,2006-06-02 04:54:28,2006-06-02 04:54:28
12254540c7d0d20ca355e1231d893817df4a9947...5f2b40d4c9b3df5b6e338293ae8144ffcbbf0dd2,1,1,1,2,1,2006-06-02 04:57:44,2006-06-02 04:57:44
5f2b40d4c9b3df5b6e338293ae8144ffcbbf0dd2...c18dc3d7598c61ce6f51467132f0eff3246b25b0,1,5,0,5,1,2006-06-02 05:06:36,2006-06-02 05:06:36
c18dc3d7598c61ce6f51467132f0eff3246b25b0...b82ac716d0dc692f1e323c6625954ddec90c50f9,1,5,1,6,1,2006-06-02 05:40:31,2006-06-02 05:40:31
b82ac716d0dc692f1e323c6625954ddec90c50f9...cdee1fc9da0e96acf895d49c88fed392a6da568a,2,66,67,133,51,2006-06-02 10:56:34,2006-06-02 10:56:34
cdee1fc9da0e96acf895d49c88fed392a6da568a...cfc546fde6acfe86b650c53a59157bd94cf0c501,2,5,3,8,3,2006-06-02 15:17:10,2006-06-02 15:17:10
cfc546fde6acfe86b650c53a59157bd94cf0c501...06edf11a0382b008ae0de40a481feb0843b93805,1,4,4,8,2,2006-06-02 15:33:30,2006-06-02 15:33:30
06edf11a0382b008ae0de40a481feb0843b93805...688cd557086dcd7b497775765899559575de33a2,1,5,2,7,3,2006-06-02 17:53:00,2006-06-02 17:53:00
688cd557086dcd7b497775765899559575de33a2...674773bb9094d2f2658311a121cca3c809534618,1,8,8,16,1,2006-06-02 18:06:41,2006-06-02 18:06:41
674773bb9094d2f2658311a121cca3c809534618...88d215f7021ff085cc1420236a721a286e548ce4,1,3,1,4,1,2006-06-02 19:04:09,2006-06-02 19:04:09
88d215f7021ff085cc1420236a721a286e548ce4...9b86db9bf2407f408468566b3f48a8444cb66f83,11,92,44,136,56,2006-06-03 13:37:34,2006-06-03 13:37:34
9b86db9bf2407f408468566b3f48a8444cb66f83...fc2a02f9666a2cd610443fc2107560b9832a017a,2,27,5,32,4,2006-06-03 22:06:48,2006-06-03 22:06:48
fc2a02f9666a2cd610443fc2107560b9832a017a...142e59b462e71fe4a253c8a3d7856ab900f5c4b2,2,5,5,10,5,2006-06-03 22:14:04,2006-06-03 22:14:04
142e59b462e71fe4a253c8a3d7856ab900f5c4b2...168429d5977592e8e5aaa8f740191711b1cbe054,10,31,1,32,10,2006-06-03 23:28:24,2006-06-03 23:28:24
168429d5977592e8e5aaa8f740191711b1cbe054...55e453a09c071cd34962d5b809121aa17241aaae,1,7,0,7,2,2006-06-03 23:45:49,2006-06-03 23:45:49
55e453a09c071cd34962d5b809121aa17241aaae...a5b7c298164e3c1547988c734d6155c17f57b1d7,28,341,336,677,326,2006-06-04 00:23:51,2006-06-04 00:23:51
a5b7c298164e3c1547988c734d6155c17f57b1d7...fb537e177d7d304d6642ee6005258a82584a8032,5,125,0,125,3,2006-06-04 00:58:39,2006-06-04 00:58:39
fb537e177d7d304d6642ee6005258a82584a8032...b8fd9a44e5a00ec1a3e857cd20442ec2572335d0,2,34,6,40,5,2006-06-04 01:03:48,2006-06-04 01:03:48
b8fd9a44e5a00ec1a3e857cd20442ec2572335d0...b5adf70c6ce21e81c565e35fabe56829bb1ef725,1,1,1,2,1,2006-06-04 18:49:37,2006-06-04 18:49:37
b5adf70c6ce21e81c565e35fabe56829bb1ef725...066dac168d621f074a3e5296482107c5c18972a7,1,2,2,4,2,2006-06-05 00:21:12,2006-06-05 00:21:12
066dac168d621f074a3e5296482107c5c18972a7...643c7b23a99ef51ff485373478113e4a6c0e4969,1,2,1,3,2,2006-06-05 00:46:18,2006-06-05 00:46:18
643c7b23a99ef51ff485373478113e4a6c0e4969...55b6559b0e4a611f52814ef3c2c7e5329dbb4aff,1,9,5,14,5,2006-06-05 15:20:47,2006-06-05 15:20:47
55b6559b0e4a611f52814ef3c2c7e5329dbb4aff...42a34423f264bf752c84f52849067c74282112eb,1,1,1,2,1,2006-06-05 15:25:12,2006-06-05 15:25:12
42a34423f264bf752c84f52849067c74282112eb...6cd012574587f657b543a15a203958beb9a6967e,1,1,1,2,1,2006-06-05 16:27:05,2006-06-05 16:27:05
6cd012574587f657b543a15a203958beb9a6967e...afe55af1e7dc1ff38544c56cc6ddfb18436934d2,1,1,1,2,1,2006-06-05 16:28:09,2006-06-05 16:28:09
afe55af1e7dc1ff38544c56cc6ddfb18436934d2...6dfea737f627cb8c06b8feac0905136c3e55bae6,2,21,14,35,12,2006-06-06 05:16:05,2006-06-06 05:16:05
6dfea737f627cb8c06b8feac0905136c3e55bae6...0909c97e607967be1f12c65a2b49ab0be7c0ef9b,1,1,0,1,1,2006-06-06 12:20:45,2006-06-06 12:20:45
0909c97e607967be1f12c65a2b49ab0be7c0ef9b...86d585a0a167f15e0176ea36fe9f99fc1d85a200,1,0,1,1,1,2006-06-06 12:30:26,2006-06-06 12:30:26
86d585a0a167f15e0176ea36fe9f99fc1d85a200...05b1a70daba43667a87c23d236bb83691da0cbbf,2,2,2,4,2,2006-06-06 15:13:16,2006-06-06 15:13:16
05b1a70daba43667a87c23d236bb83691da0cbbf...7e88ec527107bd2c9023d48bcf177636eebc7e7a,6,24,3,27,8,2006-06-06 15:22:53,2006-06-06 15:22:53
7e88ec527107bd2c9023d48bcf177636eebc7e7a...b3a6348bc24de6dc7168e6c00f2d2d440b1fe748,5,119,0,119,4,2006-06-07 00:09:29,2006-06-07 00:09:29
b3a6348bc24de6dc7168e6c00f2d2d440b1fe748...448becefdf1e84f143720a01fd1e61869ffe4e5f,1,3,2,5,3,2006-06-07 02:38:37,2006-06-07 02:38:37
448becefdf1e84f143720a01fd1e61869ffe4e5f...f3f002b1610ac51044e1e6dff5b7ff8f00b9f4dd,2,10,3,13,3,2006-06-07 02:46:08,2006-06-07 02:46:08
f3f002b1610ac51044e1e6dff5b7ff8f00b9f4dd...1926428a55f6709fc66c302b0a69b1ec04db705c,1,1,0,1,1,2006-06-07 02:47:53,2006-06-07 02:47:53
1926428a55f6709fc66c302b0a69b1ec04db705c...d028f891c9d4df997904cd3b09cbc50829136ebe,1,14,3,17,3,2006-06-07 03:10:28,2006-06-07 03:10:28
d028f891c9d4df997904cd3b09cbc50829136ebe...3db34ce73e97c4996f6e3e3d1ddef261667ae9a9,3,5,3,8,5,2006-06-07 03:17:58,2006-06-07 03:17:58
3db34ce73e97c4996f6e3e3d1ddef261667ae9a9...b78b1b98fff1d7059d7c6b9698857942ac42a4fb,1,3,3,6,3,2006-06-07 04:12:39,2006-06-07 04:12:39
b78b1b98fff1d7059d7c6b9698857942ac42a4fb...0b92bd11dbd77f2774e6aade7eba6be2176c87f5,1,0,4,4,1,2006-06-07 04:15:18,2006-06-07 04:15:18
0b92bd11dbd77f2774e6aade7eba6be2176c87f5...22da62f2391b88b524e33f79956db998b9522fb5,1,2,0,2,1,2006-06-07 04:22:42,2006-06-07 04:22:42
22da62f2391b88b524e33f79956db998b9522fb5...a1c9c525330ae489c5ad124818ea42097b0d3b73,1,10,0,10,1,2006-06-07 06:08:23,2006-06-07 06:08:23
a1c9c525330ae489c5ad124818ea42097b0d3b73...ff4636716c31d3d8af61d42a10d25bb86c740e17,1,1,0,1,1,2006-06-07 06:09:43,2006-06-07 06:09:43
ff4636716c31d3d8af61d42a10d25bb86c740e17...58ab678d354a04bcbf0a568f1950a4f41efbae12,1,1,1,2,1,2006-06-07 09:19:43,2006-06-07 09:19:43
58ab678d354a04bcbf0a568f1950a4f41efbae12...89920e058fcb673ff82ae67a41566216895c8bd3,3,23,5,28,2,2006-06-08 00:13:52,2006-06-08 00:13:52
89920e058fcb673ff82ae67a41566216895c8bd3...64ebd1da15341b0295ce3f8719fb76e94e85b968,1,18,1,19,2,2006-06-08 01:52:59,2006-06-08 01:52:59
64ebd1da15341b0295ce3f8719fb76e94e85b968...14c159d21d89d32b23639dd15d0884c21597c4fa,1,2,2,4,1,2006-06-08 03:03:19,2006-06-08 03:03:19
14c159d21d89d32b23639dd15d0884c21597c4fa...e5cd46d6d1ecf9a388d5b2b9e33f815803fcd1c4,3,132,28,160,20,2006-06-08 03:33:21,2006-06-08 03:33:21
e5cd46d6d1ecf9a388d5b2b9e33f815803fcd1c4...3aa6b0556f74b823673bc854c3c8be92d8fbabf0,1,2,0,2,1,2006-06-08 03:47:18,2006-06-08 03:47:18
3aa6b0556f74b823673bc854c3c8be92d8fbabf0...a88e0ec5c682e455a1b71837b9bb40ed4ace5ae2,1,3,2,5,3,2006-06-08 04:08:17,2006-06-08 04:08:17
a88e0ec5c682e455a1b71837b9bb40ed4ace5ae2...0f0560a9ac7827e54966d6460ab6c016626c78c2,1,11,3,14,4,2006-06-08 04:26:23,2006-06-08 04:26:23
0f0560a9ac7827e54966d6460ab6c016626c78c2...5edd1335b2ae3530bab124b8e9cfb6928a975088,3,23,16,39,11,2006-06-08 04:29:10,2006-06-08 04:29:10
5edd1335b2ae3530bab124b8e9cfb6928a975088...2abfd5dd586c4f6fb619de561b2194687021e256,33,63,64,127,63,2006-06-08 05:00:13,2006-06-08 05:00:13
2abfd5dd586c4f6fb619de561b2194687021e256...29f55c8dbb298bcaa5af0b3949cd1a1c39620b8d,2,5,5,10,5,2006-06-08 05:04:10,2006-06-08 05:04:10
29f55c8dbb298bcaa5af0b3949cd1a1c39620b8d...7e2b888a2d3e745dea551285fac6e88e409fe18d,7,24,0,24,7,2006-06-08 15:14:06,2006-06-08 15:14:06
7e2b888a2d3e745dea551285fac6e88e409fe18d...4fc6e517061a0c766bd7b00411d15fb1bdc6e856,1,4,0,4,1,2006-06-08 15:15:27,2006-06-08 15:15:27
4fc6e517061a0c766bd7b00411d15fb1bdc6e856...bff39bfb8cbc43bbeb78897c76583ab942927a0a,1,6,0,6,3,2006-06-11 00:33:44,2006-06-11 00:33:44
bff39bfb8cbc43bbeb78897c76583ab942927a0a...686c5a2f884b0b5f318a6dd6b6ba7d09ff0180f3,2,5,2,7,4,2006-06-12 12:49:14,2006-06-12 12:49:14
686c5a2f884b0b5f318a6dd6b6ba7d09ff0180f3...395cc62c7815f9bdf75b3c63f876299f16337931,2,611,607,1218,141,2006-06-12 14:45:28,2006-06-12 14:45:28
395cc62c7815f9bdf75b3c63f876299f16337931...ece252ed0fa5a9b6416616e205fa1d216b688815,2,3,3,6,3,2006-06-12 14:49:05,2006-06-12 14:49:05
ece252ed0fa5a9b6416616e205fa1d216b688815...4fcb72d30619cf5f61754d6604635e611fdf43a8,7,89,18,107,9,2006-06-12 14:52:51,2006-06-12 14:52:51
4fcb72d30619cf5f61754d6604635e611fdf43a8...15437d7a8847e459ceca4d607667e16ef796dfb0,1,3,1,4,3,2006-06-12 16:20:05,2006-06-12 16:20:05
15437d7a8847e459ceca4d607667e16ef796dfb0...efcb5912e467ab14435a417412754a234e436f73,1,2,0,2,1,2006-06-13 21:47:40,2006-06-13 21:47:40
efcb5912e467ab14435a417412754a234e436f73...93974e00d35a4bb14a4322009dfcdf6a987cca83,1,1,1,2,1,2006-06-13 23:18:15,2006-06-13 23:18:15
93974e00d35a4bb14a4322009dfcdf6a987cca83...97fedcc03175f6ced6c46145be930aad4977c54f,3,16,14,30,6,2006-06-14 03:31:34,2006-06-14 03:31:34
97fedcc03175f6ced6c46145be930aad4977c54f...ed1dcbf3e7313ea4bb779210f09cf3e4c7e7956f,1,9,9,18,2,2006-06-14 03:34:52,2006-06-14 03:34:52
ed1dcbf3e7313ea4bb779210f09cf3e4c7e7956f...d5377fc813a69d6f5ff9ec4ad198a973e8b4541b,1,6,0,6,1,2006-06-14 11:44:56,2006-06-14 11:44:56
d5377fc813a69d6f5ff9ec4ad198a973e8b4541b...7bd31115f87d6b4f69407b3cc70054a71295f131,0,0,0,0,0,2006-06-14 12:24:41,2006-06-14 12:24:41
7bd31115f87d6b4f69407b3cc70054a71295f131...8938d5eeb32bd246aacab22ddbd0484165de7a94,1,1,1,2,1,2006-06-14 14:56:19,2006-06-14 14:56:19
8938d5eeb32bd246aacab22ddbd0484165de7a94...28e643743f595abfab3ae8f0c40363b709defb86,2,3,2,5,2,2006-06-15 11:28:28,2006-06-15 11:28:28
28e643743f595abfab3ae8f0c40363b709defb86...062bae3bb3d6ff410a0e903543a51c1d22ae17f0,1,6,2,8,2,2006-06-15 14:05:33,2006-06-15 14:05:33
062bae3bb3d6ff410a0e903543a51c1d22ae17f0...cc56d65c6e0de167101ae0de4416c3e3e92bbef5,1,6,8,14,4,2006-06-16 13:37:26,2006-06-16 13:37:26
cc56d65c6e0de167101ae0de4416c3e3e92bbef5...174e334d929abf5669e8256bfa12cf61be51fc51,1,10,4,14,4,2006-06-16 18:58:45,2006-06-16 18:58:45
174e334d929abf5669e8256bfa12cf61be51fc51...bca5327b21eb2e3ee18292cbe532d6d0071201d8,5,395,24,419,5,2006-06-16 19:18:30,2006-06-16 19:18:30
bca5327b21eb2e3ee18292cbe532d6d0071201d8...72307a6eee51ae65e0cbd8c6d746a21e526b5cac,1,1,1,2,1,2006-06-16 19:35:57,2006-06-16 19:35:57
72307a6eee51ae65e0cbd8c6d746a21e526b5cac...d599052a159454e33c44d9786f36189285d6c8ca,2,42,19,61,16,2006-06-16 19:42:06,2006-06-16 19:42:06
d599052a159454e33c44d9786f36189285d6c8ca...4540a85ddabd9303955b88f5f727a7ede6161253,1,4,9,13,3,2006-06-17 02:32:50,2006-06-17 02:32:50
4540a85ddabd9303955b88f5f727a7ede6161253...75a8a32f8629b47135890ac6ecda061a616d1cfc,4,15,2,17,6,2006-06-18 04:12:55,2006-06-18 04:12:55
75a8a32f8629b47135890ac6ecda061a616d1cfc...b7d5bc6eccaf7d8839f3cd3fb4466b37d80dd0c6,1,5,2,7,2,2006-06-18 17:29:59,2006-06-18 17:29:59
b7d5bc6eccaf7d8839f3cd3fb4466b37d80dd0c6...c8f1d0a84e4f107bf4a9f470bfc183f972d507a9,1,1,1,2,1,2006-06-18 17:32:15,2006-06-18 17:32:15
c8f1d0a84e4f107bf4a9f470bfc183f972d507a9...c256dcd04bb0edcab93b99cee62b29df1cd6b046,1,1,1,2,1,2006-06-18 17:33:02,2006-06-18 17:33:02
c256dcd04bb0edcab93b99cee62b29df1cd6b046...c0ea3284d705a5d66c8aff372a5e33b15dce56e7,1,3,0,3,1,2006-06-19 01:09:00,2006-06-19 01:09:00
c0ea3284d705a5d66c8aff372a5e33b15dce56e7...a93b1f7ac34c61ae4aa64423e9e46dc5d5349434,3,40,0,40,5,2006-06-19 01:38:06,2006-06-19 01:38:06
a93b1f7ac34c61ae4aa64423e9e46dc5d5349434...214d88ce86e6257437bf2702ea6ef60e0ae23fad,2,10,0,10,2,2006-06-19 02:04:37,2006-06-19 02:04:37
214d88ce86e6257437bf2702ea6ef60e0ae23fad...1fc3b3229a9b137f05a0a49bdc726f8c91317174,2,18,0,18,4,2006-06-19 02:34:32,2006-06-19 02:34:32
1fc3b3229a9b137f05a0a49bdc726f8c91317174...271083cf7c63155ae7221e63e6d198acbbe802e5,1,2,1,3,2,2006-06-19 12:30:43,2006-06-19 12:30:43
271083cf7c63155ae7221e63e6d198acbbe802e5...c6dc7089a126ba59e712051a49af8d8c26653d3d,1,13,0,13,1,2006-06-19 12:35:38,2006-06-19 12:35:38
c6dc7089a126ba59e712051a49af8d8c26653d3d...2da4c4111ea359ee79ccfdf39167116f232ef8cb,2,24,2,26,2,2006-06-19 12:50:53,2006-06-19 12:50:53
2da4c4111ea359ee79ccfdf39167116f232ef8cb...3213f84e59e39b1c246c2c9bebed5637a98f5bc6,4,1555,1471,3026,435,2006-06-19 13:45:04,2006-06-19 13:45:04
3213f84e59e39b1c246c2c9bebed5637a98f5bc6...9496c2be8308ec1be84c5ac400bc1c8eaf1e1743,2,164,135,299,151,2006-06-19 13:45:58,2006-06-19 13:45:58
9496c2be8308ec1be84c5ac400bc1c8eaf1e1743...1a1b1aa5db12a68ef89952700ecab954470fb684,2,29,47,76,46,2006-06-19 13:48:11,2006-06-19 13:48:11
1a1b1aa5db12a68ef89952700ecab954470fb684...ed6d7285dd4c5fa61fd6aea07fb3d372feb3fa6b,1,7,7,14,6,2006-06-19 20:19:01,2006-06-19 20:19:01
ed6d7285dd4c5fa61fd6aea07fb3d372feb3fa6b...a8a133cc6cf4c3a5a2deb9d8989ba09b09ace736,2,4,2,6,3,2006-06-20 02:17:14,2006-06-20 02:17:14
a8a133cc6cf4c3a5a2deb9d8989ba09b09ace736...5bd6b322a946243c302b4c8d6264c38a74faa433,1,33,10,43,7,2006-06-20 02:52:15,2006-06-20 02:52:15
5bd6b322a946243c302b4c8d6264c38a74faa433...b10149b08a69076993d6de6aa14037bd3a643ee4,1,1,1,2,1,2006-06-20 02:57:19,2006-06-20 02:57:19
b10149b08a69076993d6de6aa14037bd3a643ee4...15cbc67ea2e41deed5ad103f922438fe21401431,1,1,1,2,1,2006-06-20 03:03:43,2006-06-20 03:03:43
15cbc67ea2e41deed5ad103f922438fe21401431...496d65154626e674d4a3a5aea167a44b764ab0d2,1,1,1,2,1,2006-06-20 03:06:14,2006-06-20 03:06:14
496d65154626e674d4a3a5aea167a44b764ab0d2...551a0272e62133606d34952c309290c3e48c8a61,2,2,1,3,2,2006-06-20 03:08:48,2006-06-20 03:08:48
551a0272e62133606d34952c309290c3e48c8a61...a09682fd6376159f81de9d6dc8c86ebd4e0b6513,1,6,6,12,5,2006-06-20 03:17:57,2006-06-20 03:17:57
a09682fd6376159f81de9d6dc8c86ebd4e0b6513...136752ca9a87be908f9ec1e398bbd56b0c75222c,4,22,2,24,8,2006-06-20 03:48:31,2006-06-20 03:48:31
136752ca9a87be908f9ec1e398bbd56b0c75222c...6b730e1e92eb85beb3d3f7401ee5dce50895d758,1,2,0,2,1,2006-06-20 03:58:16,2006-06-20 03:58:16
6b730e1e92eb85beb3d3f7401ee5dce50895d758...7aec348677543de53552738e5dcbfd7cd496c58d,1,5,3,8,4,2006-06-20 04:06:16,2006-06-20 04:06:16
7aec348677543de53552738e5dcbfd7cd496c58d...b2e5c4ef025326e88ae240f429adc58260b3a5bf,2,35,3,38,8,2006-06-20 04:07:32,2006-06-20 04:07:32
b2e5c4ef025326e88ae240f429adc58260b3a5bf...f2aab5b913adf65728ded560e217acea3ae2d1f9,1,2,2,4,2,2006-06-20 04:12:27,2006-06-20 04:12:27
f2aab5b913adf65728ded560e217acea3ae2d1f9...f67b629ada21a8357027ce86dfbdb52dd1065f6b,1,2,2,4,2,2006-06-20 04:14:10,2006-06-20 04:14:10
f67b629ada21a8357027ce86dfbdb52dd1065f6b...b93de6a2cb064de3ae74e7dc01a5ec5d7ff900f6,1,1,1,2,1,2006-06-20 04:16:11,2006-06-20 04:16:11
b93de6a2cb064de3ae74e7dc01a5ec5d7ff900f6...37addba352b3443c30e6d6d862afe73e158839ca,7,10,11,21,10,2006-06-20 04:34:13,2006-06-20 04:34:13
37addba352b3443c30e6d6d862afe73e158839ca...fb1c01b1038cbba421aaaf5b53da5bb507cc9b48,1,3,5,8,1,2006-06-20 04:44:27,2006-06-20 04:44:27
fb1c01b1038cbba421aaaf5b53da5bb507cc9b48...a4b11826a73e50e3d7d7dfa5d086e409be2b05dc,1,5,10,15,1,2006-06-20 04:47:07,2006-06-20 04:47:07
a4b11826a73e50e3d7d7dfa5d086e409be2b05dc...32228d2031ac661305f219641cc1fc336cee1c2e,4,212,0,212,6,2006-06-20 05:24:19,2006-06-20 05:24:19
32228d2031ac661305f219641cc1fc336cee1c2e...76448d0c4bc820400cce544cf78427f9c1349f19,1,262,0,262,1,2006-06-20 05:25:02,2006-06-20 05:25:02
76448d0c4bc820400cce544cf78427f9c1349f19...a513fcb455c31e574821e966cd199efca52edd6d,4,54,9,63,12,2006-06-20 05:29:19,2006-06-20 05:29:19
a513fcb455c31e574821e966cd199efca52edd6d...3e97535907baa7b57c9bf322871ef6243e2045a9,5,28,4,32,4,2006-06-20 07:12:45,2006-06-20 07:12:45
3e97535907baa7b57c9bf322871ef6243e2045a9...92571b0d48e30e958f4c3fed43bf035894c09390,2,5,9,14,3,2006-06-20 08:00:44,2006-06-20 08:00:44
92571b0d48e30e958f4c3fed43bf035894c09390...dc4f726df934cbafc966faacc400072857f3b006,1,3,3,6,3,2006-06-20 14:07:48,2006-06-20 14:07:48
dc4f726df934cbafc966faacc400072857f3b006...5f471618318d0d02479dcc357a77fa90c15588d2,1,1,0,1,1,2006-06-20 14:11:59,2006-06-20 14:11:59
5f471618318d0d02479dcc357a77fa90c15588d2...0e92f706025606e27fb4a7fd593914b172f84c76,1,6,6,12,5,2006-06-20 14:27:44,2006-06-20 14:27:44
0e92f706025606e27fb4a7fd593914b172f84c76...ba22f55aa2766cb6a0b58c0e1be6164a48adcb02,1,10,2,12,2,2006-06-21 03:39:47,2006-06-21 03:39:47
ba22f55aa2766cb6a0b58c0e1be6164a48adcb02...b70a68777709ecca75963cc03f273ee013a3eb3a,1,1,1,2,1,2006-06-21 04:13:48,2006-06-21 04:13:48
b70a68777709ecca75963cc03f273ee013a3eb3a...c4fa8a158aa3ca0623c867ae67afc47b92277ed6,1,13,0,13,1,2006-06-21 04:49:12,2006-06-21 04:49:12
c4fa8a158aa3ca0623c867ae67afc47b92277ed6...239adf83d33c47ea6dd961904d79962cd7e5a65c,4,60,4,64,10,2006-06-21 06:56:08,2006-06-21 06:56:08
239adf83d33c47ea6dd961904d79962cd7e5a65c...ae1234f2a2e6956fe26ca80743e296cff84e08d5,2,7,2,9,5,2006-06-21 11:11:03,2006-06-21 11:11:03
ae1234f2a2e6956fe26ca80743e296cff84e08d5...3465a4f6f495715b56985948dd717ae42b9a5de5,1,16,2,18,6,2006-06-21 11:15:01,2006-06-21 11:15:01
3465a4f6f495715b56985948dd717ae42b9a5de5...68cfd446a3f3fd82cee85a1567ffbe7a8d1e3139,1,4,4,8,4,2006-06-21 12:11:00,2006-06-21 12:11:00
68cfd446a3f3fd82cee85a1567ffbe7a8d1e3139...a159f660fef417d3f165e72678db8e3b90153006,1,0,13,13,1,2006-06-21 14:42:52,2006-06-21 14:42:52
a159f660fef417d3f165e72678db8e3b90153006...a490d6b4f69fc8f43a89d18b091bd3e97b145de6,2,4,3,7,3,2006-06-21 23:06:24,2006-06-21 23:06:24
a490d6b4f69fc8f43a89d18b091bd3e97b145de6...d8acac975ad42af05c320c4c7ccb2bfcdf1330d4,1,1,1,2,1,2006-06-22 04:56:35,2006-06-22 04:56:35
d8acac975ad42af05c320c4c7ccb2bfcdf1330d4...10229c4a1e8532e31310a6e2a74fe12ed2b3b26b,1,2,2,4,2,2006-06-22 16:28:40,2006-06-22 16:28:40
10229c4a1e8532e31310a6e2a74fe12ed2b3b26b...bc2d8cdbc6d923dedc153949fb3a97e0cdd0c43d,1,16,12,28,2,2006-06-22 18:44:06,2006-06-22 18:44:06
bc2d8cdbc6d923dedc153949fb3a97e0cdd0c43d...0d4b5b9b4a203b98676d800544bbd877a5208bd6,6,82,20,102,15,2006-06-23 04:37:00,2006-06-23 04:37:00
0d4b5b9b4a203b98676d800544bbd877a5208bd6...6cbdbffc80fde098ed491dc2aea4d1f3105b3ad6,1,3,0,3,2,2006-06-23 07:43:33,2006-06-23 07:43:33
6cbdbffc80fde098ed491dc2aea4d1f3105b3ad6...dc473309ef15e88a41845a52485eb6d38f819637,2,29,3,32,5,2006-06-23 08:16:36,2006-06-23 08:16:36
885dd85b5f7f35cf3266c6552d77f5577bb66828...9315633d085e046dfa5a4ce35c1f3b56bab3d485,0,0,0,0,0,2006-05-08 18:08:21,2006-05-08 18:08:21
9315633d085e046dfa5a4ce35c1f3b56bab3d485...078e2f8d73bdf88d345ae90e505d6cf97dc42b68,1,15,8,23,2,2006-05-10 04:20:53,2006-05-10 04:20:53
078e2f8d73bdf88d345ae90e505d6cf97dc42b68...0990cce75473e377bc64b9e2fdb7746ded17ddef,1,51,0,51,1,2006-05-10 04:25:39,2006-05-10 04:25:39
0990cce75473e377bc64b9e2fdb7746ded17ddef...0cd180cf76faf5f2c2cd41ad0992fc4a9daf42b9,1,69,0,69,2,2006-05-10 04:28:51,2006-05-10 04:28:51
0cd180cf76faf5f2c2cd41ad0992fc4a9daf42b9...63ffc57e5837182e383521dbf9d50915923dc33f,1,6,0,6,1,2006-05-10 04:29:21,2006-05-10 04:29:21
63ffc57e5837182e383521dbf9d50915923dc33f...cfdfb1088b59b06e79c1b9684cb3197ab270dee6,1,2,6,8,1,2006-05-10 04:30:09,2006-05-10 04:30:09
cfdfb1088b59b06e79c1b9684cb3197ab270dee6...c9136c0bffbf85802925ca891b0f0db8f5a4a5a6,2,10,13,23,7,2006-05-10 04:30:25,2006-05-10 04:30:25
c9136c0bffbf85802925ca891b0f0db8f5a4a5a6...89c6a07a5ff548fa90879e46cdb11c02e2cc0e20,1,9,7,16,3,2006-05-10 04:30:38,2006-05-10 04:30:38
89c6a07a5ff548fa90879e46cdb11c02e2cc0e20...c386867d7424c4987ee1280dc7c88f5a8903405c,1,2,2,4,2,2006-05-10 04:30:47,2006-05-10 04:30:47
c386867d7424c4987ee1280dc7c88f5a8903405c...4aeb7b02107bdc2842e9e9c82b4f2369cb3ca2bf,1,0,2,2,1,2006-05-10 04:31:12,2006-05-10 04:31:12
4aeb7b02107bdc2842e9e9c82b4f2369cb3ca2bf...b15b11f5b79a4bfce73e82ea7cdb0b3a0652c9cc,33,3984,3639,7623,486,2006-05-10 04:39:34,2006-05-10 04:39:34
b15b11f5b79a4bfce73e82ea7cdb0b3a0652c9cc...a6866d69509d7f2d2a38f98b017a1f5aea868fce,1,10,68,78,3,2006-05-10 04:49:54,2006-05-10 04:49:54
a6866d69509d7f2d2a38f98b017a1f5aea868fce...863c16a16b56c31c948dbfde659f2645ae0d6fd5,1,68,10,78,3,2006-05-16 16:23:49,2006-05-16 16:23:49
863c16a16b56c31c948dbfde659f2645ae0d6fd5...93937ed38a828e0f252fb25614516593ec7b9ab0,1,8,7,15,2,2006-05-16 16:27:36,2006-05-16 16:27:36
93937ed38a828e0f252fb25614516593ec7b9ab0...e1184016a29b90694e3624d646b35b9d4aa4756e,91,24081,17824,41905,6583,2006-05-16 20:39:14,2006-05-16 20:39:14
e1184016a29b90694e3624d646b35b9d4aa4756e...64d292e3feeeed336f117d1c40a3b3693c0e89b0,2,38,36,74,4,2006-05-16 21:04:50,2006-05-16 21:04:50
64d292e3feeeed336f117d1c40a3b3693c0e89b0...63df9c1da6b090ab03a9bb892807914da9e71a17,4,7,5,12,4,2006-05-16 21:07:14,2006-05-16 21:07:14
63df9c1da6b090ab03a9bb892807914da9e71a17...d659956cf5e9dbe1b22e7eae7f7e75d186caa226,1,30,32,62,2,2006-05-16 21:18:37,2006-05-16 21:18:37
d659956cf5e9dbe1b22e7eae7f7e75d186caa226...681763a29c9d82858a214a6898e807be0c835c47,36,2660,1723,4383,550,2006-05-22 15:19:32,2006-05-22 15:19:32
681763a29c9d82858a214a6898e807be0c835c47...aeb807989f711c61b75c42241eea4c942becf19a,60,4837,2689,7526,1223,2006-05-28 21:27:07,2006-05-28 21:27:07
aeb807989f711c61b75c42241eea4c942becf19a...0c341d780ebcde0e81c81eda07e2db3aaa92549b,56,582,362,944,345,2006-06-02 03:51:30,2006-06-02 03:51:30
0c341d780ebcde0e81c81eda07e2db3aaa92549b...e976ed1f7910fad03704f88853c5c5b36cbab134,78,908,519,1427,506,2006-06-06 01:21:49,2006-06-06 01:21:49
e976ed1f7910fad03704f88853c5c5b36cbab134...adf4b9311d5d64a2bdd58da50271c121ea22e397,101,3590,2516,6106,1011,2006-06-19 15:23:57,2006-06-19 15:23:57
dc473309ef15e88a41845a52485eb6d38f819637...23c24fc08bd05a4b9371df7837b8819f29142ac5,3,25,9,34,8,2006-06-25 04:24:15,2006-06-25 04:24:15
23c24fc08bd05a4b9371df7837b8819f29142ac5...fd702fe03422dd7a0d84eeac5c990c5cc46470bd,1,12,0,12,2,2006-06-25 14:49:34,2006-06-25 14:49:34
fd702fe03422dd7a0d84eeac5c990c5cc46470bd...2837455878c58803095ea1413928b9aa8027e4ad,2,7,5,12,4,2006-06-26 00:48:12,2006-06-26 00:48:12
2837455878c58803095ea1413928b9aa8027e4ad...2211eddb362b79cc58cb289207ff4a4bec46b81c,1,51,19,70,11,2006-06-26 01:18:56,2006-06-26 01:18:56
2211eddb362b79cc58cb289207ff4a4bec46b81c...25ffce4c835e9c739347ac95bba621e46ad2f31b,1,2,2,4,2,2006-06-26 03:02:42,2006-06-26 03:02:42
25ffce4c835e9c739347ac95bba621e46ad2f31b...db366b4a78f3f42ea19232e4c3b27f19e3ebe0c0,1,2,2,4,1,2006-06-26 09:01:07,2006-06-26 09:01:07
db366b4a78f3f42ea19232e4c3b27f19e3ebe0c0...b5a8169f8e8ef37fddd978f61ad1590b31969393,1,107,0,107,1,2006-06-26 12:22:04,2006-06-26 12:22:04
b5a8169f8e8ef37fddd978f61ad1590b31969393...e19112b47c468773b005b746518e08a80c09c341,4,242,160,402,151,2006-06-26 12:24:22,2006-06-26 12:24:22
e19112b47c468773b005b746518e08a80c09c341...b410464a00b088c640e63c758451070abdf9a63c,1,38,37,75,17,2006-06-26 12:30:29,2006-06-26 12:30:29
b410464a00b088c640e63c758451070abdf9a63c...cb73fed1ac4b4db06dbe85adf078b3d227f0c5d9,3,14,9,23,9,2006-06-26 12:43:21,2006-06-26 12:43:21
cb73fed1ac4b4db06dbe85adf078b3d227f0c5d9...d2b952377cd996dff1525564512a5f7bf4d3ef40,1,10,0,10,1,2006-06-26 12:48:47,2006-06-26 12:48:47
d2b952377cd996dff1525564512a5f7bf4d3ef40...919df8b8c7b268105260a8d08d4308dc3cd34a25,2,6,3,9,3,2006-06-26 16:20:58,2006-06-26 16:20:58
919df8b8c7b268105260a8d08d4308dc3cd34a25...6dc719312df548dd5766b79b1e4c947c54285b93,1,14,2,16,5,2006-06-26 23:01:46,2006-06-26 23:01:46
6dc719312df548dd5766b79b1e4c947c54285b93...e923ed2a83a08ba2db7347e5d467f26949fa4877,2,23,7,30,10,2006-06-26 23:19:03,2006-06-26 23:19:03
e923ed2a83a08ba2db7347e5d467f26949fa4877...2adbe11678030a019c1e279501e688acae3f85ce,3,109,52,161,22,2006-06-27 15:21:43,2006-06-27 15:21:43
2adbe11678030a019c1e279501e688acae3f85ce...48562965b900bd8d4ba5f6fef4b635af844b5cee,4,37,2,39,5,2006-06-27 20:36:25,2006-06-27 20:36:25
48562965b900bd8d4ba5f6fef4b635af844b5cee...5d7af7b1a9a62cf2d98f8dd8bb6f8ce49b886316,1,1,1,2,1,2006-06-28 01:08:04,2006-06-28 01:08:04
5d7af7b1a9a62cf2d98f8dd8bb6f8ce49b886316...54e5b9aa21736859d7d8899cbeda9fe91aee6e4f,1,4,4,8,1,2006-06-28 01:16:32,2006-06-28 01:16:32
54e5b9aa21736859d7d8899cbeda9fe91aee6e4f...d6c95e93a7a6b31e68789dc586b2cfa446cf8c50,1,10,3,13,3,2006-06-28 01:53:30,2006-06-28 01:53:30
d6c95e93a7a6b31e68789dc586b2cfa446cf8c50...414bc24e81014239cc71f0b04e85622050068e9d,2,5,1,6,2,2006-06-28 11:37:17,2006-06-28 11:37:17
414bc24e81014239cc71f0b04e85622050068e9d...4ea7a11659b8a0ab07b0d2e847975f7324664f10,6,632,0,632,5,2006-06-28 16:00:37,2006-06-28 16:00:37
4ea7a11659b8a0ab07b0d2e847975f7324664f10...aab3a418ac9293bb4abd7670f65d930cb0426d58,10,231,48,279,23,2006-06-28 16:37:02,2006-06-28 16:37:02
aab3a418ac9293bb4abd7670f65d930cb0426d58...f44e7acb17738cb222a0d8390eac480488241d15,5,864,0,864,5,2006-06-28 20:59:49,2006-06-28 20:59:49
f44e7acb17738cb222a0d8390eac480488241d15...07687c516e3bee371af992f907ef64c7cfb5bc60,1,1,1,2,1,2006-06-29 03:57:01,2006-06-29 03:57:01
07687c516e3bee371af992f907ef64c7cfb5bc60...963d88a8097180403fd6a5345d47ca6d9c2c8146,1,43,24,67,7,2006-06-29 03:57:19,2006-06-29 03:57:19
963d88a8097180403fd6a5345d47ca6d9c2c8146...c9032ab07f3694f3ae7da9b0017b764248ce28c9,7,211,12,223,13,2006-06-29 16:42:49,2006-06-29 16:42:49
c9032ab07f3694f3ae7da9b0017b764248ce28c9...0d14498ee00fb505f919410a0513452817ffced9,1,4,1,5,1,2006-06-30 18:57:23,2006-06-30 18:57:23
0d14498ee00fb505f919410a0513452817ffced9...127a3f002d1dd0e27ac978fb17bd21aedca000ce,1,2,2,4,2,2006-06-30 19:13:00,2006-06-30 19:13:00
127a3f002d1dd0e27ac978fb17bd21aedca000ce...2673aa366a3def5ba7afc26badf6c194b515b3bf,1,1,1,2,1,2006-06-30 19:21:02,2006-06-30 19:21:02
2673aa366a3def5ba7afc26badf6c194b515b3bf...0ad8863692ca2eb6071fa53bc3db8fcc5513e009,1,2,1,3,1,2006-06-30 20:19:05,2006-06-30 20:19:05
0ad8863692ca2eb6071fa53bc3db8fcc5513e009...c81d69354ab44e9b12807af9d544d77149b8ea73,6,139,14,153,21,2006-07-01 01:14:41,2006-07-01 01:14:41
c81d69354ab44e9b12807af9d544d77149b8ea73...4a324ba7acd2660538a81b1fb423de89ff515665,5,44,3,47,10,2006-07-01 03:09:14,2006-07-01 03:09:14
4a324ba7acd2660538a81b1fb423de89ff515665...cd7b54aab0c087ba6efd4a86ae0ecb6ed55d7e4b,2,23,2,25,6,2006-07-01 03:14:33,2006-07-01 03:14:33
cd7b54aab0c087ba6efd4a86ae0ecb6ed55d7e4b...31eb140b5a38844114b1647d62c2496cef740a84,1,22,50,72,6,2006-07-01 03:17:18,2006-07-01 03:17:18
31eb140b5a38844114b1647d62c2496cef740a84...ec23edfc7fd9a7d56e13a861a833cac93a9a7036,1,21,24,45,11,2006-07-01 03:21:32,2006-07-01 03:21:32
ec23edfc7fd9a7d56e13a861a833cac93a9a7036...bd6a758e5ca377f700715f8b9531f4753ff56552,1,2,0,2,1,2006-07-01 03:25:48,2006-07-01 03:25:48
bd6a758e5ca377f700715f8b9531f4753ff56552...e37bb07bc6804b852adb6846b59f555b918b6684,1,11,6,17,6,2006-07-01 03:31:14,2006-07-01 03:31:14
e37bb07bc6804b852adb6846b59f555b918b6684...cc26eb49a87cd4e6c335a4748eb46f05b0c84c54,1,1,1,2,1,2006-07-01 03:51:03,2006-07-01 03:51:03
cc26eb49a87cd4e6c335a4748eb46f05b0c84c54...08cac47ba0739d8346495a491d0d288f50a4186d,2,2,3,5,3,2006-07-01 05:41:48,2006-07-01 05:41:48
08cac47ba0739d8346495a491d0d288f50a4186d...b3debd80ed02a0f6e4c055ca4e0989655831fece,1,38,35,73,13,2006-07-02 15:24:49,2006-07-02 15:24:49
b3debd80ed02a0f6e4c055ca4e0989655831fece...37aeabe71f0dd96b7d8cce99487f2a42a7d733be,1,98,39,137,14,2006-07-03 02:12:24,2006-07-03 02:12:24
37aeabe71f0dd96b7d8cce99487f2a42a7d733be...435e8910ae2ecbf49b585c0caf4994b3a78acdb0,1,4,4,8,4,2006-07-03 02:12:59,2006-07-03 02:12:59
435e8910ae2ecbf49b585c0caf4994b3a78acdb0...86b340656c343d507ad5004790e0caa98236aef5,4,76,108,184,106,2006-07-03 16:05:54,2006-07-03 16:05:54
86b340656c343d507ad5004790e0caa98236aef5...009f224e5799ffd963ce325fd1c1181bfab3dc14,2,2,2,4,2,2006-07-03 16:07:37,2006-07-03 16:07:37
009f224e5799ffd963ce325fd1c1181bfab3dc14...6b383afd39ee2e493a308cb5c70dfa880d27edf6,4,32,16,48,17,2006-07-04 03:21:44,2006-07-04 03:21:44
6b383afd39ee2e493a308cb5c70dfa880d27edf6...4d29cae46769745f41283b7f9746326ebdd04338,1,5,1,6,1,2006-07-04 03:44:56,2006-07-04 03:44:56
4d29cae46769745f41283b7f9746326ebdd04338...a25fe3b65e39ff6f59ac545d7934461be6c13612,1,1,1,2,1,2006-07-04 03:57:07,2006-07-04 03:57:07
a25fe3b65e39ff6f59ac545d7934461be6c13612...ec4a143a407169f6a7b6d79695db6a641b242f9b,6,74,40,114,13,2006-07-04 03:58:45,2006-07-04 03:58:45
ec4a143a407169f6a7b6d79695db6a641b242f9b...b9d9351e852bae532620f174a13a1cd966886b04,3,65,6,71,7,2006-07-04 06:18:39,2006-07-04 06:18:39
b9d9351e852bae532620f174a13a1cd966886b04...5ac919b71169772768eb3ac3c5506c8c31644e73,1,5,8,13,3,2006-07-04 06:31:26,2006-07-04 06:31:26
5ac919b71169772768eb3ac3c5506c8c31644e73...4a30eff1ff3be7dec76f6abeb2dcea0eac823319,1,4,4,8,1,2006-07-04 06:44:01,2006-07-04 06:44:01
4a30eff1ff3be7dec76f6abeb2dcea0eac823319...a778c9de4773d7a9d53b86b3aa4bc54bfbc40b8d,3,15,0,15,2,2006-07-04 10:48:07,2006-07-04 10:48:07
a778c9de4773d7a9d53b86b3aa4bc54bfbc40b8d...5404e6e93bd46abb1b55bebfe23f2cdbeb373c93,1,4,1,5,1,2006-07-05 05:11:20,2006-07-05 05:11:20
5404e6e93bd46abb1b55bebfe23f2cdbeb373c93...c2556874d4d3e2631b082f567d28cc1d1e1dfee1,1,13,10,23,2,2006-07-05 07:09:53,2006-07-05 07:09:53
c2556874d4d3e2631b082f567d28cc1d1e1dfee1...e8ef80c1301a4a20ef3f41b980d42242639c8527,1,5,4,9,3,2006-07-05 10:12:58,2006-07-05 10:12:58
e8ef80c1301a4a20ef3f41b980d42242639c8527...c63dcdda372d4d8a37abd39432deb62b8d4b1d23,1,5,0,5,1,2006-07-06 13:25:12,2006-07-06 13:25:12
c63dcdda372d4d8a37abd39432deb62b8d4b1d23...930929e2b9f371061d00dfb8b6db215174c89cf2,1,1,1,2,1,2006-07-06 14:23:37,2006-07-06 14:23:37
930929e2b9f371061d00dfb8b6db215174c89cf2...16c5cec9c149830be605354d910890a9b4a90b49,1,1,1,2,1,2006-07-07 03:56:15,2006-07-07 03:56:15
16c5cec9c149830be605354d910890a9b4a90b49...4b11b43d0b2eac4e346d597360982103bae2b698,2,6,2,8,4,2006-07-07 03:57:50,2006-07-07 03:57:50
4b11b43d0b2eac4e346d597360982103bae2b698...84dda1990f95e9cd99258ba19f8c0edfd5efb402,1,1,1,2,1,2006-07-07 04:00:44,2006-07-07 04:00:44
84dda1990f95e9cd99258ba19f8c0edfd5efb402...49e5f5450d732a5d08c21c7e712e1728c6e635ce,3,46,6,52,5,2006-07-07 04:06:00,2006-07-07 04:06:00
49e5f5450d732a5d08c21c7e712e1728c6e635ce...de9630c60e944a075b164a1d11ba4853a12b1760,1,4,1,5,1,2006-07-07 04:07:41,2006-07-07 04:07:41
de9630c60e944a075b164a1d11ba4853a12b1760...83c6fff22acfe3a7994105b798403f6a16208cfc,2,2,1,3,2,2006-07-07 04:11:10,2006-07-07 04:11:10
83c6fff22acfe3a7994105b798403f6a16208cfc...df4331f3e99572e1816576ae1563b452af67ce3a,1,2,2,4,2,2006-07-07 22:20:07,2006-07-07 22:20:07
df4331f3e99572e1816576ae1563b452af67ce3a...5f33157f6293afddff8bc0e68d3b06e7bf538a74,1,12,8,20,4,2006-07-07 22:25:32,2006-07-07 22:25:32
5f33157f6293afddff8bc0e68d3b06e7bf538a74...1c3689ccd524857e7d799f21ec90ee8aaa55f96e,1,1,1,2,1,2006-07-07 22:29:02,2006-07-07 22:29:02
1c3689ccd524857e7d799f21ec90ee8aaa55f96e...8daddd4faed9f79d86137836b67cd5aad3fa0704,1,4,0,4,1,2006-07-07 22:39:43,2006-07-07 22:39:43
8daddd4faed9f79d86137836b67cd5aad3fa0704...18eb7ecb13ea4f661d3820a8e89c6abdb8b3e419,1,1,1,2,1,2006-07-08 13:58:33,2006-07-08 13:58:33
18eb7ecb13ea4f661d3820a8e89c6abdb8b3e419...2eb492ba6010b71b81119c5bbf1763ce9ff984d3,1,1,1,2,1,2006-07-08 14:14:28,2006-07-08 14:14:28
2eb492ba6010b71b81119c5bbf1763ce9ff984d3...78c91dd7df8384cee620f6e7075891c829d7bc35,1,2,1,3,2,2006-07-08 14:17:45,2006-07-08 14:17:45
78c91dd7df8384cee620f6e7075891c829d7bc35...88189399b18282ea16135ed7572f06c57476227c,1,21,10,31,8,2006-07-09 03:51:37,2006-07-09 03:51:37
88189399b18282ea16135ed7572f06c57476227c...c431ade5f5a98fca990a3996be7f7707a31df858,1,11,5,16,1,2006-07-09 03:53:11,2006-07-09 03:53:11
c431ade5f5a98fca990a3996be7f7707a31df858...9a588aa4b4f2717fa0c6eb4f200cf50b721d3d58,1,1,1,2,1,2006-07-09 22:35:08,2006-07-09 22:35:08
9a588aa4b4f2717fa0c6eb4f200cf50b721d3d58...b98972e1c90f75634894b1f1d6c3b1f0c512bcea,1,1,1,2,1,2006-07-10 02:32:54,2006-07-10 02:32:54
b98972e1c90f75634894b1f1d6c3b1f0c512bcea...5ce4a56a7cde90afe3214d7f2ebde1cce1e22215,1,2,2,4,1,2006-07-10 04:08:45,2006-07-10 04:08:45
5ce4a56a7cde90afe3214d7f2ebde1cce1e22215...c1847294b8c1b97993a945d43e50c56c0486ceed,5,45,2,47,6,2006-07-10 04:16:26,2006-07-10 04:16:26
c1847294b8c1b97993a945d43e50c56c0486ceed...927d87d73207c0fbc6200386407787c2dd205c98,2,23,22,45,11,2006-07-10 10:48:08,2006-07-10 10:48:08
927d87d73207c0fbc6200386407787c2dd205c98...9af47730da64a975bdcc8578fd5f5ddb965bdfce,1,1,1,2,1,2006-07-10 10:50:04,2006-07-10 10:50:04
9af47730da64a975bdcc8578fd5f5ddb965bdfce...8c399ba5b655b2fdce242b5a5f702a8b55e15c86,6,2101,1,2102,4,2006-07-10 14:14:00,2006-07-10 14:14:00
8c399ba5b655b2fdce242b5a5f702a8b55e15c86...4295dd9195d108ebb88e00340747b6239151ce13,1,2,1,3,1,2006-07-10 14:14:32,2006-07-10 14:14:32
4295dd9195d108ebb88e00340747b6239151ce13...4872e16d1c16b6336260de8a3aff6ac4d240ff83,1,5,3,8,1,2006-07-10 14:22:04,2006-07-10 14:22:04
4872e16d1c16b6336260de8a3aff6ac4d240ff83...b4b9edc5e55f32356928ce10defa92c8e1dab4f4,1,13,17,30,13,2006-07-11 02:32:53,2006-07-11 02:32:53
b4b9edc5e55f32356928ce10defa92c8e1dab4f4...93b21610b9decbda74b848a249f739534400f919,2,47,1,48,3,2006-07-11 02:49:56,2006-07-11 02:49:56
93b21610b9decbda74b848a249f739534400f919...1805bbb6cd477e0556123f645849d02d5c407a35,1,2,1,3,2,2006-07-11 03:09:14,2006-07-11 03:09:14
1805bbb6cd477e0556123f645849d02d5c407a35...79b7fc17a1c1293c0ee8b1570594ec8ad3b93320,1,7,8,15,9,2006-07-11 03:20:11,2006-07-11 03:20:11
79b7fc17a1c1293c0ee8b1570594ec8ad3b93320...c262e1967090419a9c53ab3bafce15837180feb9,1,29,38,67,19,2006-07-11 03:21:59,2006-07-11 03:21:59
c262e1967090419a9c53ab3bafce15837180feb9...a17a9d1474b050317841c2a7cb6e207ee1aea922,1,10,15,25,4,2006-07-11 03:27:10,2006-07-11 03:27:10
a17a9d1474b050317841c2a7cb6e207ee1aea922...9a0e56dbb56bc1f995931aa500ed9f8338a6afb1,1,0,2,2,1,2006-07-11 03:27:29,2006-07-11 03:27:29
9a0e56dbb56bc1f995931aa500ed9f8338a6afb1...98597be7865230909c25d765bdc667b6985d226a,1,4,4,8,4,2006-07-11 03:29:12,2006-07-11 03:29:12
98597be7865230909c25d765bdc667b6985d226a...cfcd4a5875ae3368b6c2f88299d8c8c85dba0c55,1,5,5,10,4,2006-07-11 03:35:17,2006-07-11 03:35:17
cfcd4a5875ae3368b6c2f88299d8c8c85dba0c55...33f47ae30a57d408ce6ead782517ff96fc5afe2a,1,8,11,19,5,2006-07-11 04:11:40,2006-07-11 04:11:40
33f47ae30a57d408ce6ead782517ff96fc5afe2a...f3a586a557cee431ea2839ef0c1efc2a53e28c3d,1,1,1,2,1,2006-07-11 14:03:24,2006-07-11 14:03:24
f3a586a557cee431ea2839ef0c1efc2a53e28c3d...78adbd9434df03a28acc929f0b00f253dd634833,1,1,0,1,1,2006-07-11 14:08:42,2006-07-11 14:08:42
dc473309ef15e88a41845a52485eb6d38f819637...71b57627ad8862eee7b1874e7f681fba68af2fc9,0,0,0,0,0,2006-06-23 19:18:36,2006-06-23 19:18:36
71b57627ad8862eee7b1874e7f681fba68af2fc9...bf629e5a4d1a51f938c84d35d768830158ad5ebd,3,77,0,77,2,2006-06-28 03:57:40,2006-06-28 03:57:40
bf629e5a4d1a51f938c84d35d768830158ad5ebd...dc59c670b8cbe055ff3565f8d5a2f600c5ab1ba8,207,9956,2437,12393,1195,2006-11-06 21:11:49,2006-11-06 21:11:49
dc59c670b8cbe055ff3565f8d5a2f600c5ab1ba8...2f163ffe9aca6a9527163435f4514d79908aa456,6,78,79,157,21,2006-11-06 21:25:29,2006-11-06 21:25:29
2f163ffe9aca6a9527163435f4514d79908aa456...d04abf372ce1fcf53323783fca1c21a9d01378df,270,14086,4488,18574,2707,2006-11-06 21:48:37,2006-11-06 21:48:37
d04abf372ce1fcf53323783fca1c21a9d01378df...b69fce82b1c42d88157f45c8f5bd020468920a60,2,72,0,72,1,2006-11-06 21:55:28,2006-11-06 21:55:28
b69fce82b1c42d88157f45c8f5bd020468920a60...24e22ce8268e95ded7522466a459f6dac7640846,3,79,68,147,4,2006-11-06 23:13:30,2006-11-06 23:13:30
24e22ce8268e95ded7522466a459f6dac7640846...948ce7fe033883b18f4bd5f7cab53f21c5f2874f,2,82,4,86,5,2006-11-08 23:53:19,2006-11-08 23:53:19
948ce7fe033883b18f4bd5f7cab53f21c5f2874f...f5569e9a744952b276654c360567abb49236ae54,1,1,1,2,1,2006-11-08 23:55:18,2006-11-08 23:55:18
f5569e9a744952b276654c360567abb49236ae54...16e873e32b73c286ebdd4fd0050dc9229f2809a8,2,66,2,68,3,2006-11-09 16:45:11,2006-11-09 16:45:11
16e873e32b73c286ebdd4fd0050dc9229f2809a8...889bf502818df7cbf8332a330703ff97dce01f2d,37,327,112,439,95,2006-11-10 15:42:40,2006-11-10 15:42:40
889bf502818df7cbf8332a330703ff97dce01f2d...3afdd8850485c9119b50a5a736d3aa16b7b912fe,28,944,473,1417,418,2006-11-25 22:37:50,2006-11-25 22:37:50
3afdd8850485c9119b50a5a736d3aa16b7b912fe...4542f21fc1b82dd0faa7be634640d2173339cb1e,13,1042,144,1186,121,2006-11-30 22:39:19,2006-11-30 22:39:19
4542f21fc1b82dd0faa7be634640d2173339cb1e...d87c354b65da2b1a3602bbd462f9b694e4519b8d,20,488,112,600,90,2006-12-07 23:15:08,2006-12-07 23:15:08
d87c354b65da2b1a3602bbd462f9b694e4519b8d...a8ba8485de47326a2862c57315f56d8854424129,47,2920,1450,4370,351,2006-12-29 00:25:26,2006-12-29 00:25:26
a8ba8485de47326a2862c57315f56d8854424129...26415279ca2371bdb43922c60496e34684ee90d6,4,40,22,62,19,2006-12-29 03:15:37,2006-12-29 03:15:37
26415279ca2371bdb43922c60496e34684ee90d6...37f18fb7053166e82d9c8a3a6d5bd2fcf2f07357,0,0,0,0,0,2009-09-11 21:19:08,2009-09-11 21:19:08
dc473309ef15e88a41845a52485eb6d38f819637...11848506657d82fd57560301eb0432a339e4844d,0,0,0,0,0,2006-06-23 19:17:02,2006-06-23 19:17:02
11848506657d82fd57560301eb0432a339e4844d...54b6e969571576e9ec616df8b074f744009b35cc,20,654,299,953,243,2006-06-28 17:00:52,2006-06-28 17:00:52
54b6e969571576e9ec616df8b074f744009b35cc...da5b0586d359390e2102703707afae65befe7f6d,25,920,59,979,40,2006-06-28 17:07:26,2006-06-28 17:07:26
da5b0586d359390e2102703707afae65befe7f6d...f19713f56f50fbe04290ca46ebe7b51f999e9d0f,6,158,46,204,14,2006-06-28 18:35:43,2006-06-28 18:35:43
f19713f56f50fbe04290ca46ebe7b51f999e9d0f...966df94e7543d43e3aca759b9416f97e00f53132,1,1,5,6,1,2006-06-28 18:41:07,2006-06-28 18:41:07
966df94e7543d43e3aca759b9416f97e00f53132...68cc8a11314aa8bd2cea98ea1e18ea1222a5c01c,1,116,0,116,1,2006-06-28 19:26:33,2006-06-28 19:26:33
68cc8a11314aa8bd2cea98ea1e18ea1222a5c01c...9bae64fa768cd3e02e0a19229c459fdea33f3a56,1,58,13,71,14,2006-06-28 21:38:04,2006-06-28 21:38:04
9bae64fa768cd3e02e0a19229c459fdea33f3a56...75b64abaa7cc1818aec9c29c28d93e226ec3b1cb,5,138,22,160,41,2006-06-28 22:21:45,2006-06-28 22:21:45
75b64abaa7cc1818aec9c29c28d93e226ec3b1cb...a50d895f289cee37b5ae53f1bee33fbdea5a0fa3,2,120,58,178,12,2006-06-29 22:00:25,2006-06-29 22:00:25
a50d895f289cee37b5ae53f1bee33fbdea5a0fa3...3d8ebb3bec77948d3b7ca1a58160d897ed8dbc46,1,3,0,3,1,2006-06-30 18:00:58,2006-06-30 18:00:58
3d8ebb3bec77948d3b7ca1a58160d897ed8dbc46...763e087de19d37d93172442bc6f29fe1e0e7a430,1,3,3,6,2,2006-06-30 18:02:01,2006-06-30 18:02:01
763e087de19d37d93172442bc6f29fe1e0e7a430...4190c9e16f59a944625829015b53bf023ee44520,4,145,207,352,14,2006-06-30 18:03:56,2006-06-30 18:03:56
4190c9e16f59a944625829015b53bf023ee44520...1c6199dc8778bc35e55d9c081ca4110448b18f0d,32,1485,175,1660,106,2006-07-03 14:23:39,2006-07-03 14:23:39
1c6199dc8778bc35e55d9c081ca4110448b18f0d...2f44c9f24f18472b375ee32118ad41ed1ab8a72f,10,334,0,334,10,2006-07-03 16:53:50,2006-07-03 16:53:50
2f44c9f24f18472b375ee32118ad41ed1ab8a72f...a206863cf6e5b8ecfca5cfe13ce32d885d7b55b7,1,16,7,23,9,2006-07-03 16:58:31,2006-07-03 16:58:31
a206863cf6e5b8ecfca5cfe13ce32d885d7b55b7...8f1d2bc98a8575302f28cb297cc29646175b31e7,1,13,14,27,3,2006-07-03 20:47:33,2006-07-03 20:47:33
8f1d2bc98a8575302f28cb297cc29646175b31e7...d2d269ea15d409ba0ddc1032d8b0d9443d820375,1,30,5,35,4,2006-07-03 20:49:50,2006-07-03 20:49:50
d2d269ea15d409ba0ddc1032d8b0d9443d820375...54d611d2a2e65419983fa1d63cc435dddd04acb3,5,15,0,15,5,2006-07-03 20:53:36,2006-07-03 20:53:36
54d611d2a2e65419983fa1d63cc435dddd04acb3...f194f74aa62727e4624b3e6e1e06fdbeebc4f3b5,2,169,2,171,4,2006-07-03 20:56:24,2006-07-03 20:56:24
f194f74aa62727e4624b3e6e1e06fdbeebc4f3b5...062733a946b360eead2355ab9c1a21ea14c22e5f,2,23,8,31,4,2006-07-03 20:57:52,2006-07-03 20:57:52
062733a946b360eead2355ab9c1a21ea14c22e5f...05086e535371231fa3520f2a8110b2b7826cecb8,1,115,0,115,3,2006-07-06 21:45:52,2006-07-06 21:45:52
05086e535371231fa3520f2a8110b2b7826cecb8...f043b395ba88e2fa53de71f3c267f6dcd948d181,1,4,0,4,2,2006-07-07 20:45:31,2006-07-07 20:45:31
f043b395ba88e2fa53de71f3c267f6dcd948d181...0d9dee02bbd9297ea9ad1187654e5b2db733e677,1,23,11,34,11,2006-07-07 21:25:49,2006-07-07 21:25:49
0d9dee02bbd9297ea9ad1187654e5b2db733e677...774026e5c57e983828777adbcb51c94bafd06bc9,1,12,2,14,4,2006-07-07 21:27:27,2006-07-07 21:27:27
774026e5c57e983828777adbcb51c94bafd06bc9...bbc82d0c73369650f01d97a9387972d6df153171,1,34,9,43,6,2006-07-07 21:28:47,2006-07-07 21:28:47
bbc82d0c73369650f01d97a9387972d6df153171...c1087076b4fb1165a0f8ebda73ca892cebcf9c26,1,75,33,108,11,2006-07-07 21:30:03,2006-07-07 21:30:03
c1087076b4fb1165a0f8ebda73ca892cebcf9c26...60947322a582e4bc3f07622024ef7e2d470b0d68,3,26,18,44,19,2006-07-07 21:31:16,2006-07-07 21:31:16
60947322a582e4bc3f07622024ef7e2d470b0d68...ef1a9eeb64b24a49769b107a9361643bd7e7a688,42,406,227,633,189,2006-07-09 17:11:34,2006-07-09 17:11:34
ef1a9eeb64b24a49769b107a9361643bd7e7a688...541f4e9671eef6d361b517d26158f4e154374025,1,5,11,16,3,2006-07-10 19:27:40,2006-07-10 19:27:40
541f4e9671eef6d361b517d26158f4e154374025...7ac06ee5bee55e6f1df2ab87d0fd2978edc1b7a6,1,31,20,51,7,2006-07-10 19:36:16,2006-07-10 19:36:16
7ac06ee5bee55e6f1df2ab87d0fd2978edc1b7a6...47d20cb5cfb8c4b68a926694154a59f7bc88c0f1,2,11,10,21,7,2006-07-10 19:40:32,2006-07-10 19:40:32
47d20cb5cfb8c4b68a926694154a59f7bc88c0f1...3e562344abd75f655d7ad17ac65db81f4fd4125e,1,1,142,143,3,2006-07-10 20:02:15,2006-07-10 20:02:15
3e562344abd75f655d7ad17ac65db81f4fd4125e...c0132e88f6cdb6dbaa843e9075ae97419b8709d9,3,143,48,191,23,2006-07-11 03:16:28,2006-07-11 03:16:28
c0132e88f6cdb6dbaa843e9075ae97419b8709d9...97d1f60d7729f37a516514e0d80c716f45e53b41,1,154,39,193,24,2006-07-11 20:37:07,2006-07-11 20:37:07
97d1f60d7729f37a516514e0d80c716f45e53b41...49ce784805b9db3cc7523f2c391cc67f934dddca,2,6,6,12,6,2006-07-11 20:38:27,2006-07-11 20:38:27
49ce784805b9db3cc7523f2c391cc67f934dddca...541ac3b990903056afaecd30ca013c39775fd9c5,47,2403,191,2594,145,2006-07-16 23:11:33,2006-07-16 23:11:33
541ac3b990903056afaecd30ca013c39775fd9c5...d96e3c93a59ce773ff5e85256ff8d91b421d5d0a,1,85,8,93,9,2006-07-19 02:28:24,2006-07-19 02:28:24
d96e3c93a59ce773ff5e85256ff8d91b421d5d0a...22afa65b4b83baa9e9ee1980f96d37ddb5d0adb2,1,23,0,23,1,2006-07-19 02:28:58,2006-07-19 02:28:58
22afa65b4b83baa9e9ee1980f96d37ddb5d0adb2...e0486bd7a7c7b94fc33d51ce013ae1fc02e4dc6f,1,1,13,14,3,2006-07-19 02:31:44,2006-07-19 02:31:44
e0486bd7a7c7b94fc33d51ce013ae1fc02e4dc6f...62306542eebf4b982f552281ec7f2878c15bea64,1,43,41,84,19,2006-07-19 02:32:40,2006-07-19 02:32:40
62306542eebf4b982f552281ec7f2878c15bea64...8b77fe319585a371a9bf87a6177f918a2c88fbfd,1,5,7,12,5,2006-07-19 02:36:45,2006-07-19 02:36:45
8b77fe319585a371a9bf87a6177f918a2c88fbfd...ed4e198d110c37f587db755e64f18390060980c1,1,29,30,59,18,2006-07-19 02:38:31,2006-07-19 02:38:31
ed4e198d110c37f587db755e64f18390060980c1...a5caa0ab27bc5a72b4080888c3f295ee7c9b719a,1,7,0,7,1,2006-07-19 02:41:56,2006-07-19 02:41:56
a5caa0ab27bc5a72b4080888c3f295ee7c9b719a...f51a9fa30c7a4978887483bb4d5780d920cc4e9c,1,20,36,56,18,2006-07-19 02:43:38,2006-07-19 02:43:38
f51a9fa30c7a4978887483bb4d5780d920cc4e9c...6b63e852fcd96a05949f7a758dd8405d5bf85482,1,27,21,48,14,2006-07-19 02:46:18,2006-07-19 02:46:18
6b63e852fcd96a05949f7a758dd8405d5bf85482...b8d27f0bcfc80a0ef1e93bf7a3e4e01b3c7e2100,1,5,5,10,4,2006-07-19 14:30:00,2006-07-19 14:30:00
b8d27f0bcfc80a0ef1e93bf7a3e4e01b3c7e2100...f350bcf05843a854e59f77ca56d2ac77bb4aca4b,1,23,14,37,13,2006-07-19 14:39:18,2006-07-19 14:39:18
f350bcf05843a854e59f77ca56d2ac77bb4aca4b...32356827b42cba5adfd197e8bc2cdba440e02a05,1,10,0,10,3,2006-07-19 14:57:42,2006-07-19 14:57:42
32356827b42cba5adfd197e8bc2cdba440e02a05...c5d0e1ac5611458866b9622bc07834c87fb967a6,1,16,15,31,7,2006-07-19 14:58:46,2006-07-19 14:58:46
c5d0e1ac5611458866b9622bc07834c87fb967a6...89ec26a585cd838d03ca7f868bb89a6cc10163f1,1,4,2,6,3,2006-07-19 16:38:57,2006-07-19 16:38:57
89ec26a585cd838d03ca7f868bb89a6cc10163f1...cf48f3cc82771d52630eefe7d6648310d4e9dbaa,1,12,7,19,7,2006-07-19 16:40:16,2006-07-19 16:40:16
cf48f3cc82771d52630eefe7d6648310d4e9dbaa...72b4c4c14a057f27f2bd5b404434d6ee78d0d86f,1,8,3,11,3,2006-07-19 18:09:32,2006-07-19 18:09:32
72b4c4c14a057f27f2bd5b404434d6ee78d0d86f...439b814afc028eeafb1d1466e4cd812d1aa5eef5,1,24,4,28,8,2006-07-19 18:10:19,2006-07-19 18:10:19
439b814afc028eeafb1d1466e4cd812d1aa5eef5...5b6017edbfb6db1ab6971e4f6fd80c9a97dc522f,1,74,0,74,1,2006-07-19 18:56:31,2006-07-19 18:56:31
5b6017edbfb6db1ab6971e4f6fd80c9a97dc522f...d67abd93077f49a6df2d4263fb3350361054aa81,1,3,73,76,4,2006-07-19 18:57:26,2006-07-19 18:57:26
d67abd93077f49a6df2d4263fb3350361054aa81...9b84da453e3525734c38b7608e38b408b34a3b21,1,0,2,2,1,2006-07-19 18:58:03,2006-07-19 18:58:03
9b84da453e3525734c38b7608e38b408b34a3b21...58b24acdf440dff54fb060ddcd1a27f936ff2305,1,2,2,4,2,2006-07-19 18:58:41,2006-07-19 18:58:41
58b24acdf440dff54fb060ddcd1a27f936ff2305...c705f3a5732d2d28a7d264152fc74ed9ace267fd,1,42,80,122,15,2006-07-19 18:59:50,2006-07-19 18:59:50
c705f3a5732d2d28a7d264152fc74ed9ace267fd...b8cc6302a6c904335e37c3435ab6995622f8013c,1,4,5,9,4,2006-07-19 22:21:37,2006-07-19 22:21:37
b8cc6302a6c904335e37c3435ab6995622f8013c...a6064b22cf3c2b475abad8f0a96dc39f8a0d49b5,1,115,0,115,1,2006-07-19 22:22:31,2006-07-19 22:22:31
a6064b22cf3c2b475abad8f0a96dc39f8a0d49b5...e2385e3c535cc7f48200d8d0bd3fea61eafcb98e,1,16,8,24,7,2006-07-20 15:27:49,2006-07-20 15:27:49
e2385e3c535cc7f48200d8d0bd3fea61eafcb98e...422aadfe2aea988927888b970fcce4e8ce492fac,6,7,10,17,10,2006-07-21 18:15:02,2006-07-21 18:15:02
422aadfe2aea988927888b970fcce4e8ce492fac...e655cc3cc3825775ddee2a33f4ef0960e8f65eaa,1,104,106,210,24,2006-07-21 21:59:17,2006-07-21 21:59:17
e655cc3cc3825775ddee2a33f4ef0960e8f65eaa...bbe357f34ee6a2bd77209dbaf7af2c37970f42e1,1,287,0,287,1,2006-07-21 21:59:54,2006-07-21 21:59:54
bbe357f34ee6a2bd77209dbaf7af2c37970f42e1...88c64cc0830f2bcd6dc11a23ff8611e915473ba1,1,30,1,31,8,2006-07-21 22:00:25,2006-07-21 22:00:25
88c64cc0830f2bcd6dc11a23ff8611e915473ba1...d345b89bc67b67867a4cc9608a972b7ffa6e0903,1,0,2,2,1,2006-07-21 22:05:38,2006-07-21 22:05:38
d345b89bc67b67867a4cc9608a972b7ffa6e0903...438c23a6c6eb71b73272a9b98392af654b76c82c,90,3161,989,4150,225,2006-07-23 03:31:52,2006-07-23 03:31:52
438c23a6c6eb71b73272a9b98392af654b76c82c...5b964baa1479b844678a0564efbc1e1435b565d3,1,0,1,1,1,2006-07-23 03:33:48,2006-07-23 03:33:48
5b964baa1479b844678a0564efbc1e1435b565d3...94ccedf364ff91a11fdbdc722c2e33857a84a72d,2,49,40,89,14,2006-07-23 04:01:15,2006-07-23 04:01:15
94ccedf364ff91a11fdbdc722c2e33857a84a72d...14f8c838271305dc00ffacbfcfaba7c32d47aa0b,1,6,8,14,7,2006-07-23 04:05:30,2006-07-23 04:05:30
14f8c838271305dc00ffacbfcfaba7c32d47aa0b...6c65e612b4907be5bc202d326599d8119a9db3ff,1,41,0,41,1,2006-07-25 00:45:43,2006-07-25 00:45:43
6c65e612b4907be5bc202d326599d8119a9db3ff...6bd4b275afd21a6b4059364593697f954f49798c,1,2,2,4,1,2006-07-25 00:46:49,2006-07-25 00:46:49
6bd4b275afd21a6b4059364593697f954f49798c...3cc04ec6963aa2597383d397ab428cbae42d1dd6,1,19,22,41,2,2006-07-25 00:47:55,2006-07-25 00:47:55
3cc04ec6963aa2597383d397ab428cbae42d1dd6...57208f639233ae83bd83c9ac02239be3086aad04,1,6,1,7,1,2006-07-25 18:34:14,2006-07-25 18:34:14
57208f639233ae83bd83c9ac02239be3086aad04...f4a776eee7f308adf5c843914bb10e0285966641,1,7,4,11,4,2006-07-25 18:37:05,2006-07-25 18:37:05
f4a776eee7f308adf5c843914bb10e0285966641...e550c1eed4cb23ee89e9a60ac22188fe9191aa13,1,0,4,4,1,2006-07-25 18:49:18,2006-07-25 18:49:18
e550c1eed4cb23ee89e9a60ac22188fe9191aa13...7062c656c300c267cff22440afa30063c3b8789b,41,908,531,1439,276,2006-07-31 18:19:15,2006-07-31 18:19:15
7062c656c300c267cff22440afa30063c3b8789b...08c420718200bcb0dcc5237f678d45d10173e81e,1,163,0,163,1,2006-08-01 22:21:11,2006-08-01 22:21:11
08c420718200bcb0dcc5237f678d45d10173e81e...238c6ecd5b10c6c76b8b1db03dcb746bcfe366af,20,227,51,278,36,2006-08-04 23:27:18,2006-08-04 23:27:18
238c6ecd5b10c6c76b8b1db03dcb746bcfe366af...bec235deefbca44d1a9f3b95e453d946b1359135,37,393,97,490,93,2006-08-14 01:03:32,2006-08-14 01:03:32
bec235deefbca44d1a9f3b95e453d946b1359135...f4a52d16b50d7a29d75de01109110ed7e474be78,17,293,282,575,112,2006-08-20 16:11:02,2006-08-20 16:11:02
f4a52d16b50d7a29d75de01109110ed7e474be78...d82245be55544450b025a1926611902d82bc8ffb,6,28,12,40,19,2006-08-22 16:46:32,2006-08-22 16:46:32
d82245be55544450b025a1926611902d82bc8ffb...f67b8c6698e9347ed2bc358447da9e9d227d7336,1,1,1,2,1,2006-08-23 02:42:15,2006-08-23 02:42:15
f67b8c6698e9347ed2bc358447da9e9d227d7336...ac28f828a8c39f6e70e8dcae95f81d303a47a4a5,5,43,14,57,10,2006-08-27 16:20:02,2006-08-27 16:20:02
ac28f828a8c39f6e70e8dcae95f81d303a47a4a5...88b4149df6f55b9ee1f387572405d3902606ca9d,6,3049,0,3049,5,2006-08-27 16:20:50,2006-08-27 16:20:50
88b4149df6f55b9ee1f387572405d3902606ca9d...8c6c4454df9a76e99c625186bcc27f339bde8abf,6,16,10,26,13,2006-08-27 16:23:57,2006-08-27 16:23:57
8c6c4454df9a76e99c625186bcc27f339bde8abf...25ecf21fec30737f66060009b02859ae0ef6c966,5,61,13,74,20,2006-08-27 16:36:27,2006-08-27 16:36:27
25ecf21fec30737f66060009b02859ae0ef6c966...be589f70345b6f50349e705195bcb0a007335e60,2,60,73,133,18,2006-08-27 19:40:49,2006-08-27 19:40:49
be589f70345b6f50349e705195bcb0a007335e60...5a58772a1ee470e2890d3c716ce4918555100a55,1,10,16,26,2,2006-08-27 20:45:32,2006-08-27 20:45:32
5a58772a1ee470e2890d3c716ce4918555100a55...b17f250907351923f39f8a50b87a35b26d2ca307,122,2425,4498,6923,235,2006-09-04 02:20:26,2006-09-04 02:20:26
b17f250907351923f39f8a50b87a35b26d2ca307...ae3896cb74d4bc42acaf6fade0d2a57e28045b2a,3,13,3,16,6,2006-09-08 14:11:52,2006-09-08 14:11:52
ae3896cb74d4bc42acaf6fade0d2a57e28045b2a...84f7a2133c4d553a234165bb8cbfaf70681bb028,34,610,157,767,123,2006-09-08 16:35:39,2006-09-08 16:35:39
84f7a2133c4d553a234165bb8cbfaf70681bb028...b87d360a07003e7e0cc17ed5e3c373196a834505,22,2974,664,3638,610,2006-09-14 02:50:59,2006-09-14 02:50:59
b87d360a07003e7e0cc17ed5e3c373196a834505...eb1357bf48a65c9fe49b3d23df91e6ff2307e684,5,8,41,49,7,2006-09-14 03:14:39,2006-09-14 03:14:39
eb1357bf48a65c9fe49b3d23df91e6ff2307e684...432070d0fbf20b800e667012fd220ae26e3f579f,1,2,2,4,1,2006-09-14 03:40:45,2006-09-14 03:40:45
432070d0fbf20b800e667012fd220ae26e3f579f...b92f683f2dee195cc23c7aa13e973fecd6ab35a7,9,97,77,174,37,2006-09-14 20:18:24,2006-09-14 20:18:24
b92f683f2dee195cc23c7aa13e973fecd6ab35a7...c01d2f4e6a77b7b96a57d43e4c7cfc4c4865f056,1,0,3,3,1,2006-09-14 20:43:30,2006-09-14 20:43:30
c01d2f4e6a77b7b96a57d43e4c7cfc4c4865f056...ecb5b81e0d3f0a50f33dcf1d4adfb11d34608a2c,2,6,7,13,5,2006-09-15 02:24:38,2006-09-15 02:24:38
ecb5b81e0d3f0a50f33dcf1d4adfb11d34608a2c...27bcc64ac57356ddd08643f4bfb7e43effafc281,3,88,49,137,32,2006-09-17 19:12:04,2006-09-17 19:12:04
27bcc64ac57356ddd08643f4bfb7e43effafc281...0c128ffb2430b8577651cfc6751efcfbd7824f82,1,2,2,4,2,2006-11-19 14:20:21,2006-11-19 14:20:21
0c128ffb2430b8577651cfc6751efcfbd7824f82...e789a8b0f7c94d11d916b2262bd094f2487160aa,1,1,1,2,1,2006-11-27 16:50:00,2006-11-27 16:50:00
e789a8b0f7c94d11d916b2262bd094f2487160aa...025be905d9859bf03cb903bfd2477ae0570cc819,1,2,2,4,1,2006-11-27 17:17:08,2006-11-27 17:17:08
025be905d9859bf03cb903bfd2477ae0570cc819...91d6569b479096b2e13262a9c1cc120f13eec603,1,14,5,19,7,2006-11-28 03:45:50,2006-11-28 03:45:50
91d6569b479096b2e13262a9c1cc120f13eec603...7e6d1365ba3c912b0582e291a5ae7d345f64abe3,1,2,2,4,1,2006-11-28 03:56:40,2006-11-28 03:56:40
7e6d1365ba3c912b0582e291a5ae7d345f64abe3...e4e6bf0712fdd774e73bea7aadf799656544b513,6,12,6,18,6,2006-11-28 15:48:39,2006-11-28 15:48:39
e4e6bf0712fdd774e73bea7aadf799656544b513...c000f6a48061839d064143be45d2453b5cf97311,2,4,2,6,2,2006-11-29 19:45:22,2006-11-29 19:45:22
c000f6a48061839d064143be45d2453b5cf97311...f6d48b5d02acc7cd8d71ffe895fbf41c7c9ae2b7,4,15,8,23,9,2006-11-29 19:51:54,2006-11-29 19:51:54
f6d48b5d02acc7cd8d71ffe895fbf41c7c9ae2b7...71012a4be3830b1040815243ebb7c0d48dbd8e57,37,311,102,413,100,2006-11-29 20:02:43,2006-11-29 20:02:43
71012a4be3830b1040815243ebb7c0d48dbd8e57...08fe1b64afbb237e4e6c74bf22be80f2b7f3977e,1,1,0,1,1,2006-11-29 20:10:10,2006-11-29 20:10:10
08fe1b64afbb237e4e6c74bf22be80f2b7f3977e...9a01534370a272e59f2bb64251d1f46218a32516,20,3204,867,4071,773,2006-11-29 20:11:43,2006-11-29 20:11:43
9a01534370a272e59f2bb64251d1f46218a32516...f8217026f9618adb65ab2d517025e87b98ed2fbe,33,172,106,278,94,2006-11-29 20:16:50,2006-11-29 20:16:50
f8217026f9618adb65ab2d517025e87b98ed2fbe...261fb45ba8ce5ad7c9a0a73c286077c779364b8d,22,184,74,258,75,2006-12-04 18:04:55,2006-12-04 18:04:55
261fb45ba8ce5ad7c9a0a73c286077c779364b8d...e07dae7b77abc39d3e5d99dece5d43a5b99890f4,20,105,96,201,52,2006-12-04 18:16:40,2006-12-04 18:16:40
e07dae7b77abc39d3e5d99dece5d43a5b99890f4...66c638925845c8dc9f44a65fad4058af2b8d05b0,1,22,10,32,6,2006-12-04 19:22:35,2006-12-04 19:22:35
66c638925845c8dc9f44a65fad4058af2b8d05b0...2a58209ff2b7c47245c9d12985ac7581e97988d1,8,1003,522,1525,444,2006-12-04 19:28:11,2006-12-04 19:28:11
2a58209ff2b7c47245c9d12985ac7581e97988d1...040f2272e0aec724a36e7abda445b61ee065a8f1,53,3152,1915,5067,679,2006-12-04 19:58:49,2006-12-04 19:58:49
040f2272e0aec724a36e7abda445b61ee065a8f1...b7a897eebbd4797c58b004eda7c6a30f9971eac2,33,1068,289,1357,271,2006-12-04 20:29:44,2006-12-04 20:29:44
b7a897eebbd4797c58b004eda7c6a30f9971eac2...478ebadec7fa9045b2f1ea2027919339572007f2,34,336,104,440,83,2006-12-04 20:52:14,2006-12-04 20:52:14
478ebadec7fa9045b2f1ea2027919339572007f2...0162eac9e2cd317476dd4086c36caf138c96f6bc,31,959,480,1439,431,2006-12-04 21:01:18,2006-12-04 21:01:18
0162eac9e2cd317476dd4086c36caf138c96f6bc...55d7f6519c8d13a685cff3f9873b5784fc511a87,17,1058,158,1216,125,2006-12-04 21:12:29,2006-12-04 21:12:29
55d7f6519c8d13a685cff3f9873b5784fc511a87...694f44f600335c30189cbcee73c4d133881c54d2,19,600,156,756,124,2006-12-10 15:43:51,2006-12-10 15:43:51
694f44f600335c30189cbcee73c4d133881c54d2...c6b46b1f6f1c3ecdeac4e3323ff942e0c41e90fd,0,0,0,0,0,2009-09-11 21:23:21,2009-09-11 21:23:21
78adbd9434df03a28acc929f0b00f253dd634833...085b74406f4fb57368fdbdbc4e78b94e90186dba,1,3,2,5,2,2006-07-11 19:08:24,2006-07-11 19:08:24
085b74406f4fb57368fdbdbc4e78b94e90186dba...e88a9cc9a40f2c37ac12e9fb9a706264cf28445e,1,16,0,16,2,2006-07-12 07:40:28,2006-07-12 07:40:28
e88a9cc9a40f2c37ac12e9fb9a706264cf28445e...36e4e5a93856f53abfa747b2b7696550758f04fe,1,13,13,26,2,2006-07-13 03:52:41,2006-07-13 03:52:41
36e4e5a93856f53abfa747b2b7696550758f04fe...0a2e8daaafe3bf164e9082175bec1961ada30a4c,1,8,8,16,6,2006-07-13 21:31:53,2006-07-13 21:31:53
0a2e8daaafe3bf164e9082175bec1961ada30a4c...2175c99825517a40c549f8a355659385dc955c45,1,2,2,4,2,2006-07-14 00:49:18,2006-07-14 00:49:18
2175c99825517a40c549f8a355659385dc955c45...cb19acf6fba10bcdc54f1f486f8985ecc9281826,1,1,1,2,1,2006-07-14 00:56:03,2006-07-14 00:56:03
cb19acf6fba10bcdc54f1f486f8985ecc9281826...49bb884d0b48a589098b7f139e91f196cad0d6f6,1,1,1,2,1,2006-07-14 01:00:09,2006-07-14 01:00:09
49bb884d0b48a589098b7f139e91f196cad0d6f6...24fa22883ab7bfa1db3e8456bf4e469d152cc16b,1,1,1,2,1,2006-07-14 01:03:01,2006-07-14 01:03:01
24fa22883ab7bfa1db3e8456bf4e469d152cc16b...04e83a05177a5103f83aa8883e90c773db089a55,1,1,1,2,1,2006-07-14 01:17:17,2006-07-14 01:17:17
04e83a05177a5103f83aa8883e90c773db089a55...dba1f95e126060edd52d682339e9a811a916719b,1,8,0,8,1,2006-07-14 02:55:42,2006-07-14 02:55:42
dba1f95e126060edd52d682339e9a811a916719b...50448de634e49051ccb1c4c79a648814ebe4241a,1,11,4,15,5,2006-07-14 02:57:10,2006-07-14 02:57:10
50448de634e49051ccb1c4c79a648814ebe4241a...bd13190499e8967a956b649761097ccb593141c1,1,1,1,2,1,2006-07-14 03:09:02,2006-07-14 03:09:02
bd13190499e8967a956b649761097ccb593141c1...9bea530c33e3a236ccf115a41396bb167e7e7593,1,2,2,4,1,2006-07-14 05:26:55,2006-07-14 05:26:55
9bea530c33e3a236ccf115a41396bb167e7e7593...8c705f02a9fa7c912eb5beb907f767936d36c68c,1,10,5,15,4,2006-07-14 05:43:26,2006-07-14 05:43:26
8c705f02a9fa7c912eb5beb907f767936d36c68c...1725db5a35d9f64c0bed693ef529e77947d448f9,12,21,21,42,19,2006-07-14 11:04:33,2006-07-14 11:04:33
1725db5a35d9f64c0bed693ef529e77947d448f9...ebc6f90d4445e31724e35c23dbf6d9a1953466bd,3,10,10,20,10,2006-07-14 11:48:25,2006-07-14 11:48:25
ebc6f90d4445e31724e35c23dbf6d9a1953466bd...6d104115d1e1e57acd4e9105bca6bdb8b5983230,3,3,3,6,3,2006-07-15 01:07:13,2006-07-15 01:07:13
6d104115d1e1e57acd4e9105bca6bdb8b5983230...f8a277bc7f67d13fa41eb8569af9fe7446885ed0,1,1,1,2,1,2006-07-15 11:47:09,2006-07-15 11:47:09
f8a277bc7f67d13fa41eb8569af9fe7446885ed0...4537cf3dd40a80f5ad410a62c5a052bf31e68a76,1,10,7,17,5,2006-07-15 12:32:14,2006-07-15 12:32:14
4537cf3dd40a80f5ad410a62c5a052bf31e68a76...6870edf2a0c60b72b4d0c3873e0efd2087d87579,1,3,3,6,2,2006-07-17 14:16:17,2006-07-17 14:16:17
6870edf2a0c60b72b4d0c3873e0efd2087d87579...e26f288823458c2d728766250f39c21ab9786b78,1,8,0,8,1,2006-07-17 14:58:39,2006-07-17 14:58:39
e26f288823458c2d728766250f39c21ab9786b78...c6cbfb3d7c4280ebc058f136c333d7f4db098b69,1,18,0,18,1,2006-07-17 14:59:41,2006-07-17 14:59:41
c6cbfb3d7c4280ebc058f136c333d7f4db098b69...533594d1a5a943ef80360762d5c5d021975a9bde,1,2,2,4,2,2006-07-19 01:35:58,2006-07-19 01:35:58
533594d1a5a943ef80360762d5c5d021975a9bde...51705f60b1b561b3e44d1ff3d02bc12d7af26d9f,12,46,33,79,32,2006-07-19 02:09:26,2006-07-19 02:09:26
51705f60b1b561b3e44d1ff3d02bc12d7af26d9f...e6e663371bda04751352bcba134b144cde21945a,1,2,0,2,1,2006-07-19 02:28:35,2006-07-19 02:28:35
e6e663371bda04751352bcba134b144cde21945a...59bf8dd3108fc1124d0bd843f7146595a0b0228f,1,2,2,4,1,2006-07-19 04:17:24,2006-07-19 04:17:24
59bf8dd3108fc1124d0bd843f7146595a0b0228f...ab4ffe5d78c9eb9cab1a15828dddf3c5f010ad2a,1,2,2,4,1,2006-07-19 05:50:33,2006-07-19 05:50:33
ab4ffe5d78c9eb9cab1a15828dddf3c5f010ad2a...0016547e9b29db789c416fab74f39561db4e75ef,1,8,2,10,3,2006-07-19 10:14:43,2006-07-19 10:14:43
0016547e9b29db789c416fab74f39561db4e75ef...271093d3b31cbee9e8042a43675e76507d4501e0,1,4,0,4,1,2006-07-19 12:09:53,2006-07-19 12:09:53
271093d3b31cbee9e8042a43675e76507d4501e0...466b90c788bbeb37f717555260701db0001db41b,1,2,2,4,2,2006-07-19 12:32:32,2006-07-19 12:32:32
466b90c788bbeb37f717555260701db0001db41b...c072c8dcd32fb683d8ed4503b8b2d8dfeca17f25,1,1,0,1,1,2006-07-19 12:48:30,2006-07-19 12:48:30
c072c8dcd32fb683d8ed4503b8b2d8dfeca17f25...740a8d20f182bfa5d8f53fe625d7ebafc4ba4bb9,1,13,3,16,3,2006-07-20 03:32:24,2006-07-20 03:32:24
740a8d20f182bfa5d8f53fe625d7ebafc4ba4bb9...9b6d1efe774b6aaf1974fdedc84b8e0c6925bb4c,1,1,1,2,1,2006-07-20 05:04:45,2006-07-20 05:04:45
9b6d1efe774b6aaf1974fdedc84b8e0c6925bb4c...2a8a32c44902ab13d68c36e010331d9b6c969fbf,3,28,2,30,6,2006-07-20 15:37:12,2006-07-20 15:37:12
2a8a32c44902ab13d68c36e010331d9b6c969fbf...3e95ef5374dd3d468d6cb27a1ce6fd42334abb0d,1,1,1,2,1,2006-07-20 15:37:51,2006-07-20 15:37:51
3e95ef5374dd3d468d6cb27a1ce6fd42334abb0d...6ab20c547563a67d16779a921acd195167d454ea,2,7,7,14,3,2006-07-20 15:45:16,2006-07-20 15:45:16
6ab20c547563a67d16779a921acd195167d454ea...a0a7378c50275ba865b34e6dbf6a15c1cc30aae2,1,1,1,2,1,2006-07-20 15:48:07,2006-07-20 15:48:07
a0a7378c50275ba865b34e6dbf6a15c1cc30aae2...aa8b34cb922fd7e88e6b20061e9fba69719dfe26,1,1,1,2,1,2006-07-20 16:06:02,2006-07-20 16:06:02
aa8b34cb922fd7e88e6b20061e9fba69719dfe26...be2524182b55a78cb73fa56836bd70de05d6d4e0,1,1,1,2,1,2006-07-20 20:13:35,2006-07-20 20:13:35
be2524182b55a78cb73fa56836bd70de05d6d4e0...c4679bb83fcae7a3cd47d1d54d2a741e75e4abbd,1,2,2,4,2,2006-07-20 20:16:03,2006-07-20 20:16:03
c4679bb83fcae7a3cd47d1d54d2a741e75e4abbd...c19ef69c5c9435bd3c559f32e34d56ae76c645ac,1,8,2,10,1,2006-07-20 20:26:10,2006-07-20 20:26:10
c19ef69c5c9435bd3c559f32e34d56ae76c645ac...b26331d6ee5e85336d35c826c2f266061f664811,1,1,1,2,1,2006-07-20 20:31:59,2006-07-20 20:31:59
b26331d6ee5e85336d35c826c2f266061f664811...edf68bede57e216a3fc112310a5a18ee3e016edf,1,53,58,111,36,2006-07-21 03:55:07,2006-07-21 03:55:07
edf68bede57e216a3fc112310a5a18ee3e016edf...bb1cb76dfbd9cdbe820e1f117fec007269528b2a,1,1,1,2,1,2006-07-21 03:56:06,2006-07-21 03:56:06
bb1cb76dfbd9cdbe820e1f117fec007269528b2a...27c49b69b83a036cef1d19c6eb80b93cb2275b39,1,1,1,2,1,2006-07-21 14:41:38,2006-07-21 14:41:38
27c49b69b83a036cef1d19c6eb80b93cb2275b39...f3e3869e09f164e5680dfc49b9a06c4cd14e0a8c,3,2112,0,2112,2,2006-07-21 14:47:14,2006-07-21 14:47:14
f3e3869e09f164e5680dfc49b9a06c4cd14e0a8c...a93855c5bdb2cf3b675d9e147ae83c7673e5f831,1,1,0,1,1,2006-07-21 14:48:31,2006-07-21 14:48:31
a93855c5bdb2cf3b675d9e147ae83c7673e5f831...8bdd19beea3002d8b99cbaaab9624dca8f7a8694,1,1,1,2,1,2006-07-21 15:57:50,2006-07-21 15:57:50
8bdd19beea3002d8b99cbaaab9624dca8f7a8694...e9a236d86c82133ab1959e4ea4760ebe6f73bd8e,7,29,15,44,15,2006-07-21 16:20:22,2006-07-21 16:20:22
e9a236d86c82133ab1959e4ea4760ebe6f73bd8e...17d0bd151265eb284c93350a3ede632b2b23b835,25,9,35,44,29,2006-07-21 17:11:13,2006-07-21 17:11:13
17d0bd151265eb284c93350a3ede632b2b23b835...5c5ca53b703dd81b693ddf43c5f51590002dd78b,1,1,1,2,1,2006-07-21 19:12:51,2006-07-21 19:12:51
5c5ca53b703dd81b693ddf43c5f51590002dd78b...a926046ba633ac38d3306b6bc10677a670929786,18,12,28,40,23,2006-07-21 20:39:17,2006-07-21 20:39:17
a926046ba633ac38d3306b6bc10677a670929786...1687b025dc2a03e9ef111b8fd3db63fce48b77b7,18,808,810,1618,70,2006-07-21 20:48:17,2006-07-21 20:48:17
1687b025dc2a03e9ef111b8fd3db63fce48b77b7...dd19218f4e89d5525f9834348bc6f94410c60862,1,3,1,4,2,2006-07-22 02:47:17,2006-07-22 02:47:17
dd19218f4e89d5525f9834348bc6f94410c60862...20831e0d2f0a1b294ed0b52b92c6e1b34dc49026,1,1,1,2,1,2006-07-22 06:13:49,2006-07-22 06:13:49
20831e0d2f0a1b294ed0b52b92c6e1b34dc49026...564d5565193224a1e2404c55bb4c63d5dcab8bcf,1,2,3,5,1,2006-07-23 23:14:36,2006-07-23 23:14:36
564d5565193224a1e2404c55bb4c63d5dcab8bcf...6d050ff07a548d5de524f89012b2743242f339fc,1,16,30,46,7,2006-07-23 23:16:54,2006-07-23 23:16:54
6d050ff07a548d5de524f89012b2743242f339fc...571ee77dfecbc3516bfaec434584064d3a4e50c8,1,1,1,2,1,2006-07-24 01:51:15,2006-07-24 01:51:15
571ee77dfecbc3516bfaec434584064d3a4e50c8...45076bf8718b6be17c766dd552a0fb08a1247113,1,1,1,2,1,2006-07-24 02:25:41,2006-07-24 02:25:41
45076bf8718b6be17c766dd552a0fb08a1247113...ed80500a302d6a79178eca0d33f6142f2cab7895,1,9,4,13,1,2006-07-24 02:28:09,2006-07-24 02:28:09
ed80500a302d6a79178eca0d33f6142f2cab7895...d43e6fc97ac139dc412d559facbfc4806536cedd,1,18,1,19,2,2006-07-24 02:39:50,2006-07-24 02:39:50
d43e6fc97ac139dc412d559facbfc4806536cedd...91bf6e5765529bb7f0606a5b378f87a035baaeda,1,4,0,4,1,2006-07-24 02:41:44,2006-07-24 02:41:44
91bf6e5765529bb7f0606a5b378f87a035baaeda...0991cd004c53895b5d34d03f6c3cbc9cbe43dc74,1,2,2,4,1,2006-07-24 02:43:09,2006-07-24 02:43:09
0991cd004c53895b5d34d03f6c3cbc9cbe43dc74...e5c40514fb6b19b06872fba72237a7f44e64303f,1,1,1,2,1,2006-07-24 02:52:52,2006-07-24 02:52:52
e5c40514fb6b19b06872fba72237a7f44e64303f...3d02de27138b420825156f0631a32cdcda2d91aa,1,16,0,16,1,2006-07-25 07:30:22,2006-07-25 07:30:22
3d02de27138b420825156f0631a32cdcda2d91aa...065b9aed676e6cdcd9cc2c572811d758d64060bf,1,1,1,2,1,2006-07-25 18:53:27,2006-07-25 18:53:27
065b9aed676e6cdcd9cc2c572811d758d64060bf...22b63bb5be66ed9fb3a52d24e0fb54bb97497b24,1,1,1,2,1,2006-07-25 18:54:13,2006-07-25 18:54:13
22b63bb5be66ed9fb3a52d24e0fb54bb97497b24...e427d5bc159e67b6d8e802fd88d5b8a55b13defe,1,1,1,2,1,2006-07-26 00:15:01,2006-07-26 00:15:01
e427d5bc159e67b6d8e802fd88d5b8a55b13defe...f65cede3137fd59cc3ba8de952c217d8c613bf8f,1,2,1,3,1,2006-07-26 21:30:14,2006-07-26 21:30:14
f65cede3137fd59cc3ba8de952c217d8c613bf8f...eb254114076ffc1dd458607fdd5ef24995f3f994,1,4,0,4,1,2006-07-27 00:46:32,2006-07-27 00:46:32
eb254114076ffc1dd458607fdd5ef24995f3f994...c37a6fa17a29b2b3c1a53ebb59b9dbc4416b265f,1,2,2,4,2,2006-07-27 16:16:17,2006-07-27 16:16:17
c37a6fa17a29b2b3c1a53ebb59b9dbc4416b265f...ecdd6ae6de2a004541efbe8a1e27849c4a8ee965,2,80,25,105,28,2006-07-27 16:36:02,2006-07-27 16:36:02
ecdd6ae6de2a004541efbe8a1e27849c4a8ee965...e433e07a8d50e71c885bcbb58933efd3a992bcc4,1,3,0,3,1,2006-07-27 16:38:32,2006-07-27 16:38:32
e433e07a8d50e71c885bcbb58933efd3a992bcc4...16bdaa7acb69e3b48cdd483445ab1c884df072ad,1,18,0,18,1,2006-07-27 16:55:26,2006-07-27 16:55:26
16bdaa7acb69e3b48cdd483445ab1c884df072ad...aaa3cc0ea3a450deda16da5ab235e6ec9d6e16f9,1,5,5,10,5,2006-07-27 17:03:35,2006-07-27 17:03:35
aaa3cc0ea3a450deda16da5ab235e6ec9d6e16f9...c7fa1fa56f97eaeedbe4ecff9510243452091168,1,3,0,3,1,2006-07-27 17:41:28,2006-07-27 17:41:28
c7fa1fa56f97eaeedbe4ecff9510243452091168...2a0af00524fc16f3f223b8117268e9ffcf41e06c,2,6,5,11,5,2006-07-27 17:48:35,2006-07-27 17:48:35
2a0af00524fc16f3f223b8117268e9ffcf41e06c...6537401ca45dcaeb8eb285bcf451e403f538eb93,1,117,0,117,1,2006-07-27 18:12:53,2006-07-27 18:12:53
6537401ca45dcaeb8eb285bcf451e403f538eb93...847b1ed54ec9da078a2524a3791057f024839eee,3,19,6,25,4,2006-07-27 23:23:55,2006-07-27 23:23:55
847b1ed54ec9da078a2524a3791057f024839eee...09912cce7068c27c21a6bbc4077d76faf1a698d1,1,30,0,30,1,2006-07-27 23:59:35,2006-07-27 23:59:35
09912cce7068c27c21a6bbc4077d76faf1a698d1...a55fa029f765fb824d6227a4d3bf6e7fbcd1c260,2,6,4,10,4,2006-07-28 00:13:10,2006-07-28 00:13:10
a55fa029f765fb824d6227a4d3bf6e7fbcd1c260...9345c85e973ab61e3fa4f8ea211693a9fca9c1af,1,12,3,15,4,2006-07-28 02:06:20,2006-07-28 02:06:20
9345c85e973ab61e3fa4f8ea211693a9fca9c1af...e3bb4011817d8d0a39a96a503eb455436d86d22e,1,17,2,19,2,2006-07-28 02:07:43,2006-07-28 02:07:43
e3bb4011817d8d0a39a96a503eb455436d86d22e...36ee8f5ad2f61bc8bf4e7d76d7569a762df15077,1,2,2,4,2,2006-07-28 02:08:17,2006-07-28 02:08:17
36ee8f5ad2f61bc8bf4e7d76d7569a762df15077...3770dbde3ccfbe9150d8c18cacc1e353cc9a46b1,1,47,0,47,1,2006-07-28 02:08:36,2006-07-28 02:08:36
3770dbde3ccfbe9150d8c18cacc1e353cc9a46b1...1707f79b74b32ad20ee36e03818688ee4dc02d21,1,12,0,12,1,2006-07-28 02:09:38,2006-07-28 02:09:38
1707f79b74b32ad20ee36e03818688ee4dc02d21...8753a072f700abcc2f2626982b04c9ab53fb8977,1,6,5,11,3,2006-07-28 02:25:46,2006-07-28 02:25:46
8753a072f700abcc2f2626982b04c9ab53fb8977...e5b51925aca6e6a868eea24f084318185d0bb52d,1,14,7,21,6,2006-07-28 02:30:36,2006-07-28 02:30:36
e5b51925aca6e6a868eea24f084318185d0bb52d...2ef762f8f49f2e229d10856d976c78a657a22088,1,3,3,6,2,2006-07-28 02:42:44,2006-07-28 02:42:44
2ef762f8f49f2e229d10856d976c78a657a22088...0444f5644a4a358bd3981f8a56af9077d4ad6bb8,1,10,0,10,1,2006-07-28 16:25:36,2006-07-28 16:25:36
0444f5644a4a358bd3981f8a56af9077d4ad6bb8...0fb270a0dc8d00546f2526b0ce16f6929f8210c6,1,1,0,1,1,2006-07-28 20:48:26,2006-07-28 20:48:26
0fb270a0dc8d00546f2526b0ce16f6929f8210c6...954050c196f7692cb88118f4947d49056ccfcba9,1,0,1,1,1,2006-07-28 21:24:19,2006-07-28 21:24:19
954050c196f7692cb88118f4947d49056ccfcba9...9852ef8ff4434c9bc524a7c5ae816ad97478dc09,1,113,0,113,1,2006-07-28 21:38:24,2006-07-28 21:38:24
9852ef8ff4434c9bc524a7c5ae816ad97478dc09...f121772de9fee71efa41c3f5cc7d64db63cca52d,1,0,15,15,1,2006-07-28 21:44:42,2006-07-28 21:44:42
f121772de9fee71efa41c3f5cc7d64db63cca52d...1cf552dcec0e8d1b4d5c27a900a9e28f34c12b40,2,2,2,4,2,2006-07-28 21:53:54,2006-07-28 21:53:54
1cf552dcec0e8d1b4d5c27a900a9e28f34c12b40...1bf811e28dc33c1877fd45308f5736614778c226,1,8,0,8,1,2006-07-28 22:13:34,2006-07-28 22:13:34
1bf811e28dc33c1877fd45308f5736614778c226...3ad00f3acff9cfe824b11d5fc0281f2142560509,1,3,11,14,2,2006-07-28 22:22:03,2006-07-28 22:22:03
3ad00f3acff9cfe824b11d5fc0281f2142560509...2cb629e05dbc5d1e9a19128470ed94a738fa9baa,1,4,0,4,2,2006-07-28 22:24:05,2006-07-28 22:24:05
2cb629e05dbc5d1e9a19128470ed94a738fa9baa...a369151091ffa854043f10e065304af30e823ff4,1,5,0,5,1,2006-07-29 00:31:33,2006-07-29 00:31:33
a369151091ffa854043f10e065304af30e823ff4...4aefe9ad456101c51b5b42a4e908a366e52e5bb0,1,8,3,11,4,2006-07-29 18:41:09,2006-07-29 18:41:09
4aefe9ad456101c51b5b42a4e908a366e52e5bb0...1a3b11261069490c534fd7487503ddc526680244,1,7,1,8,3,2006-07-29 18:41:56,2006-07-29 18:41:56
78adbd9434df03a28acc929f0b00f253dd634833...96d4d698e132a71e1773d0f4a1134921aa774358,0,0,0,0,0,2006-07-11 14:46:42,2006-07-11 14:46:42
96d4d698e132a71e1773d0f4a1134921aa774358...ffac8356ddcc4349ae902e9ba945fdb761a16a46,9,614,100,714,83,2006-08-22 16:16:38,2006-08-22 16:16:38
ffac8356ddcc4349ae902e9ba945fdb761a16a46...450889c9a6f7da3c2fce77a0ccf4c4cea9e29710,31,324,0,324,25,2006-08-22 16:46:02,2006-08-22 16:46:02
450889c9a6f7da3c2fce77a0ccf4c4cea9e29710...42851d90dadbf62f5d342ce5c4f496ba1eeba987,314,16336,5807,22143,3027,2006-10-26 19:09:51,2006-10-26 19:09:51
42851d90dadbf62f5d342ce5c4f496ba1eeba987...365f4b869800469ba786919f11422c73b3ec9fbb,606,98349,29269,127618,11042,2007-07-20 20:49:49,2007-07-20 20:49:49
365f4b869800469ba786919f11422c73b3ec9fbb...dac5af33de86877535f38eee0a8e11629cbbb5bc,9,489,3,492,15,2007-07-20 20:58:33,2007-07-20 20:58:33
dac5af33de86877535f38eee0a8e11629cbbb5bc...05fb38769683497892718fe176d0416cbb3a26e6,1,262,0,262,1,2007-07-20 21:42:47,2007-07-20 21:42:47
05fb38769683497892718fe176d0416cbb3a26e6...993ac8db975aa3544a9f01921dc40b7f3d70d72e,1,9,6,15,7,2007-07-30 17:10:05,2007-07-30 17:10:05
993ac8db975aa3544a9f01921dc40b7f3d70d72e...6dab0824be1ff85eca8e22609ff4adcbdfa86c73,5,95,4,99,5,2007-07-30 20:05:02,2007-07-30 20:05:02
6dab0824be1ff85eca8e22609ff4adcbdfa86c73...0e049f1b8c2efdbca95f233b8f24c3381a943d0c,1,123,22,145,36,2007-07-31 16:36:13,2007-07-31 16:36:13
0e049f1b8c2efdbca95f233b8f24c3381a943d0c...4629092d792a38ad493361490252b77576262f53,1,28,1,29,2,2007-07-31 17:37:11,2007-07-31 17:37:11
4629092d792a38ad493361490252b77576262f53...0b4c2c7ab1b32d5fa1befd86207d8ead52d6e4f7,6,72,5,77,17,2007-08-01 17:51:59,2007-08-01 17:51:59
0b4c2c7ab1b32d5fa1befd86207d8ead52d6e4f7...38c1cd721dc78b17088257caff78f668315d9b25,11,135,37,172,29,2007-08-02 03:28:52,2007-08-02 03:28:52
38c1cd721dc78b17088257caff78f668315d9b25...fd77e425091fdeaf321ca7658534c2f906074084,6,137,60,197,42,2007-08-02 21:17:23,2007-08-02 21:17:23
fd77e425091fdeaf321ca7658534c2f906074084...0f5a5a0594597dd10afe187e0ae8cecf11f5848b,42,580,158,738,117,2007-08-02 21:51:32,2007-08-02 21:51:32
0f5a5a0594597dd10afe187e0ae8cecf11f5848b...c05d52cdfe8955e9fb501497087367cd4daafbf6,2,161,150,311,10,2007-08-03 16:48:51,2007-08-03 16:48:51
c05d52cdfe8955e9fb501497087367cd4daafbf6...ba056e68c85235dab92150ca1d7297ffeef6822a,1,0,20,20,1,2007-08-03 17:08:45,2007-08-03 17:08:45
ba056e68c85235dab92150ca1d7297ffeef6822a...ce1c58421a5cccfc92f2b5427b0c9a66af24a9f3,2,82,0,82,2,2007-08-03 19:48:04,2007-08-03 19:48:04
ce1c58421a5cccfc92f2b5427b0c9a66af24a9f3...c383135d2d686b4341b29d0a5ae7cd1c98d36212,3,135,7,142,10,2007-08-03 20:49:19,2007-08-03 20:49:19
c383135d2d686b4341b29d0a5ae7cd1c98d36212...6aad6a8a48b38f32ca77f758ea5bdc9eb187d96a,1,8,0,8,1,2007-08-03 21:18:09,2007-08-03 21:18:09
6aad6a8a48b38f32ca77f758ea5bdc9eb187d96a...db79faa3285361e6f6778bfc003edd8844196f7e,6,62,14,76,24,2007-08-03 22:38:44,2007-08-03 22:38:44
db79faa3285361e6f6778bfc003edd8844196f7e...0af6ed0c4853e11086e277ba352d27db4c466c89,3,218,31,249,25,2007-08-06 14:19:27,2007-08-06 14:19:27
0af6ed0c4853e11086e277ba352d27db4c466c89...5aa017255827b2c06bd9a5f7f069828ef625da18,111,1067,486,1553,387,2007-08-06 16:50:17,2007-08-06 16:50:17
5aa017255827b2c06bd9a5f7f069828ef625da18...4da80e4df33134929bbd46772e077099c4bc6d98,0,0,0,0,0,2009-09-11 21:26:12,2009-09-11 21:26:12
78adbd9434df03a28acc929f0b00f253dd634833...247b4ba5acb45a620882c44d915db162f3037ad7,0,0,0,0,0,2006-07-11 14:46:16,2006-07-11 14:46:16
247b4ba5acb45a620882c44d915db162f3037ad7...1ce3fe5a96303ef77223871bd643cb70780d5c94,16,245,0,245,8,2006-07-15 00:17:34,2006-07-15 00:17:34
1ce3fe5a96303ef77223871bd643cb70780d5c94...1e9d6303f0df2d839026a794db93d95ce8b192e9,1,75,27,102,17,2006-07-22 10:16:42,2006-07-22 10:16:42
1e9d6303f0df2d839026a794db93d95ce8b192e9...1e2fbc3de84228ae27be0b00e4f6008649f26e3a,1,5,27,32,3,2006-07-22 10:19:05,2006-07-22 10:19:05
1e2fbc3de84228ae27be0b00e4f6008649f26e3a...097ed460236a2ab46530cca4bae37e779ad85602,2,7,4,11,5,2006-07-22 10:24:27,2006-07-22 10:24:27
097ed460236a2ab46530cca4bae37e779ad85602...c1be99e0887634843c8a72ff30c61ef4de64528b,2,0,0,0,0,2006-07-22 10:26:26,2006-07-22 10:26:26
c1be99e0887634843c8a72ff30c61ef4de64528b...b0a11fcdc5846d8480f085978dd33c113abe8449,114,3288,1074,4362,306,2006-07-22 12:11:40,2006-07-22 12:11:40
b0a11fcdc5846d8480f085978dd33c113abe8449...4d8da74cdfa8055e6af1289492b0ea1def101e72,1,36,47,83,10,2006-07-26 10:52:08,2006-07-26 10:52:08
4d8da74cdfa8055e6af1289492b0ea1def101e72...456786ef3d450825a2b0e519976560a0e31a5d6a,1,2,2,4,2,2006-07-26 11:25:11,2006-07-26 11:25:11
456786ef3d450825a2b0e519976560a0e31a5d6a...96367f65c96f9307e5abc34b2f0e7dcd6116afb4,1,39,23,62,17,2006-08-02 14:56:58,2006-08-02 14:56:58
96367f65c96f9307e5abc34b2f0e7dcd6116afb4...a760bd73fdb33e35e4a937ab14317fd439d25753,1,5,3,8,4,2006-08-02 14:59:08,2006-08-02 14:59:08
a760bd73fdb33e35e4a937ab14317fd439d25753...98120e36c38a79bae40de714034da225c4e14b02,48,1029,580,1609,303,2006-08-03 08:18:24,2006-08-03 08:18:24
98120e36c38a79bae40de714034da225c4e14b02...b1f4974bef28b3c28089accda60506f67af80462,1,24,13,37,12,2006-08-14 00:10:10,2006-08-14 00:10:10
b1f4974bef28b3c28089accda60506f67af80462...ca86ceec83044fbfd76d1559b6d2a7da35019c10,43,492,103,595,105,2006-08-14 00:32:07,2006-08-14 00:32:07
ca86ceec83044fbfd76d1559b6d2a7da35019c10...402f00a893ca54611c610c99a2555dc5a7dbe947,1,53,14,67,10,2006-08-14 23:28:23,2006-08-14 23:28:23
402f00a893ca54611c610c99a2555dc5a7dbe947...a064d0848b0467b320bba7d73ecdbf0cb077daf6,2,2,2,4,2,2006-08-16 12:52:35,2006-08-16 12:52:35
a064d0848b0467b320bba7d73ecdbf0cb077daf6...fd837f02354e730a425e5992309f6230f2be75b5,1,8,37,45,4,2006-08-16 12:57:20,2006-08-16 12:57:20
fd837f02354e730a425e5992309f6230f2be75b5...c0f5d22187be8a35befd52f2cc55326c1c71f8e9,1,34,16,50,17,2006-08-17 18:28:41,2006-08-17 18:28:41
c0f5d22187be8a35befd52f2cc55326c1c71f8e9...3ca484cbb7964509de3ff85b6ea59172cffb1562,2,0,39,39,1,2006-08-20 21:34:45,2006-08-20 21:34:45
3ca484cbb7964509de3ff85b6ea59172cffb1562...f32226ada30e5c95a366dfd4f2db6799f1af2c08,1,60,46,106,11,2006-08-21 21:38:15,2006-08-21 21:38:15
f32226ada30e5c95a366dfd4f2db6799f1af2c08...e6b7a2d454731ed73ef7a572620cde2d3b67231a,1,12,10,22,7,2006-08-21 21:40:35,2006-08-21 21:40:35
e6b7a2d454731ed73ef7a572620cde2d3b67231a...56642885be405e166e58d704f80f47b7165f50d7,1,48,1,49,3,2006-08-21 21:41:36,2006-08-21 21:41:36
56642885be405e166e58d704f80f47b7165f50d7...cd54edf08409537dcdf4f53007797b6561c011ac,1,13,4,17,3,2006-08-21 22:30:05,2006-08-21 22:30:05
cd54edf08409537dcdf4f53007797b6561c011ac...19ed25e2e6ad9724b85e83ece5c69e23a0f95a2f,22,310,294,604,123,2006-08-21 22:31:45,2006-08-21 22:31:45
19ed25e2e6ad9724b85e83ece5c69e23a0f95a2f...dbdbf1735e16036657e9b0c8fd124a8d043b2a05,1,2,2,4,2,2006-09-17 09:16:35,2006-09-17 09:16:35
dbdbf1735e16036657e9b0c8fd124a8d043b2a05...a2ea7775a3d2e42f07f26e1a0b533e3d53cb4115,2,2,2,4,2,2006-09-17 09:19:50,2006-09-17 09:19:50
a2ea7775a3d2e42f07f26e1a0b533e3d53cb4115...00271631894a5aafb26444604b22eb964fd7e59b,28,0,0,0,0,2007-03-14 01:39:29,2007-03-14 01:39:29
00271631894a5aafb26444604b22eb964fd7e59b...1ec80a0368114665720f205b6b8264d449fefddd,28,0,0,0,0,2007-03-14 23:32:28,2007-03-14 23:32:28
1ec80a0368114665720f205b6b8264d449fefddd...c76225007dd815700de64b058a5555d8e2ca59d5,0,0,0,0,0,2007-03-15 00:38:16,2007-03-15 00:38:16
c76225007dd815700de64b058a5555d8e2ca59d5...374735c9eff0c375f5aef9431c529d0cdbbfebe8,421,49035,14837,63872,6317,2007-03-15 03:25:47,2007-03-15 03:25:47
374735c9eff0c375f5aef9431c529d0cdbbfebe8...730869d19c42f7f301c4bc5bdc1f34709a8127be,1,2,0,2,2,2007-03-15 15:51:51,2007-03-15 15:51:51
730869d19c42f7f301c4bc5bdc1f34709a8127be...702dadfa595177ace679c480f87918e405bc8f85,3,28,8,36,7,2007-03-15 15:59:49,2007-03-15 15:59:49
702dadfa595177ace679c480f87918e405bc8f85...33fe6b5496a3d8cc1a46c7f9f67fe02b597e3b7c,0,0,0,0,0,2007-03-15 16:01:35,2007-03-15 16:01:35
33fe6b5496a3d8cc1a46c7f9f67fe02b597e3b7c...abc893adad45ac33778eac540f31676df6a6c5a0,3,0,0,0,0,2007-03-15 16:10:20,2007-03-15 16:10:20
abc893adad45ac33778eac540f31676df6a6c5a0...bc57c169356685f80e0f2551c22dcaa6615195ec,1,1,1,2,1,2007-03-15 16:16:26,2007-03-15 16:16:26
bc57c169356685f80e0f2551c22dcaa6615195ec...1829afdba672deaf194fff00b056a16b067c48c5,1,3,2,5,2,2007-03-23 23:55:53,2007-03-23 23:55:53
1829afdba672deaf194fff00b056a16b067c48c5...994b52661a5a0160163e9faf6a39c1e77e9113cf,2,8,3,11,7,2007-03-23 23:57:22,2007-03-23 23:57:22
994b52661a5a0160163e9faf6a39c1e77e9113cf...77518506b5011b0fdd10606e014b300eb55e3215,79,5783,2294,8077,983,2007-03-24 00:24:29,2007-03-24 00:24:29
77518506b5011b0fdd10606e014b300eb55e3215...8661608a84c790fb534856344349170f50386c72,50,3775,1732,5507,635,2007-03-30 11:49:28,2007-03-30 11:49:28
78adbd9434df03a28acc929f0b00f253dd634833...53fed0e76941f90a43a9803ab5b394461c0f32a8,0,0,0,0,0,2006-07-11 14:45:54,2006-07-11 14:45:54
53fed0e76941f90a43a9803ab5b394461c0f32a8...71dad9e3057f088a6baa97fcec088f55455f5476,1,58,0,58,3,2006-07-24 23:28:04,2006-07-24 23:28:04
71dad9e3057f088a6baa97fcec088f55455f5476...8e48efbbd09685f04856bf448d37c4b7a84e8548,2,7,1,8,3,2006-07-24 23:29:35,2006-07-24 23:29:35
8e48efbbd09685f04856bf448d37c4b7a84e8548...75c6dc967d4f27a8361d8cf77a1ea279ba9fa3b1,127,3601,1158,4759,371,2006-07-27 22:38:02,2006-07-27 22:38:02
75c6dc967d4f27a8361d8cf77a1ea279ba9fa3b1...340718bd3a4f56a257dd4285da178751d9cf84d2,9,562,1,563,11,2006-07-29 16:00:23,2006-07-29 16:00:23
340718bd3a4f56a257dd4285da178751d9cf84d2...68072fa75c56c040b18c2fc43e96acc3f734fa67,3,20,12,32,10,2006-07-29 18:27:50,2006-07-29 18:27:50
68072fa75c56c040b18c2fc43e96acc3f734fa67...aba82ef36bbed5d7f5cdd23d48a8ed2805607d24,6,35,29,64,27,2006-08-02 15:47:11,2006-08-02 15:47:11
aba82ef36bbed5d7f5cdd23d48a8ed2805607d24...18c889d8fb554d99c16d0f25ed96f28922eeb7f3,1,54,1,55,3,2006-08-06 19:44:58,2006-08-06 19:44:58
18c889d8fb554d99c16d0f25ed96f28922eeb7f3...e8ea76b4c7285d641d7b6c298ac9c0ce282c8bc9,1,12,6,18,8,2006-08-07 17:28:16,2006-08-07 17:28:16
e8ea76b4c7285d641d7b6c298ac9c0ce282c8bc9...1eb8c617116f7ce04176cd979a3cf737cecac6df,0,0,0,0,0,2006-08-07 17:29:13,2006-08-07 17:29:13
1eb8c617116f7ce04176cd979a3cf737cecac6df...b68a6ae7016ec7868eea5f9f4793ae781cb235e2,2,149,0,149,1,2006-08-07 17:29:32,2006-08-07 17:29:32
b68a6ae7016ec7868eea5f9f4793ae781cb235e2...759f426f245fba8f6a9273219103009fdbd7dd0c,2,9,6,15,7,2006-08-07 17:30:27,2006-08-07 17:30:27
759f426f245fba8f6a9273219103009fdbd7dd0c...2176184dc3f6ddd121c951f232cd833738d76bfc,6,355,187,542,27,2006-08-09 01:22:35,2006-08-09 01:22:35
2176184dc3f6ddd121c951f232cd833738d76bfc...ea345fa7f4fa0c264505981d0c0ee1e16b11ab71,67,30591,0,30591,36,2006-08-09 01:26:53,2006-08-09 01:26:53
ea345fa7f4fa0c264505981d0c0ee1e16b11ab71...98bb076a49f61b21d91bcef0e0d1ef2fc716fc52,3,255,252,507,8,2006-08-11 13:57:28,2006-08-11 13:57:28
98bb076a49f61b21d91bcef0e0d1ef2fc716fc52...e46e6f6a3f28fc8152ec9734bdfe0203821cef05,2,0,259,259,2,2006-08-11 14:05:39,2006-08-11 14:05:39
e46e6f6a3f28fc8152ec9734bdfe0203821cef05...03e1b7f82136bf149adc9ee2ff629258c268f4e8,67,0,30591,30591,36,2006-08-11 14:07:47,2006-08-11 14:07:47
03e1b7f82136bf149adc9ee2ff629258c268f4e8...4f0118995c43fd3cb5f79ffcbaf10b1115d8e434,2,43,43,86,11,2006-08-13 21:36:38,2006-08-13 21:36:38
4f0118995c43fd3cb5f79ffcbaf10b1115d8e434...4cfd3203a67cd6e1fccccab5c85da5551814d2ee,65,1355,857,2212,424,2006-08-14 18:52:03,2006-08-14 18:52:03
4cfd3203a67cd6e1fccccab5c85da5551814d2ee...dc3c4db1141b1c38c2a7a40b14924f6a0a1ac565,1,3,1,4,2,2006-08-14 18:52:53,2006-08-14 18:52:53
dc3c4db1141b1c38c2a7a40b14924f6a0a1ac565...77eda0234e59ad009b5922d770e8b10a4125e80e,2,4,5,9,6,2006-08-14 23:19:52,2006-08-14 23:19:52
77eda0234e59ad009b5922d770e8b10a4125e80e...8cd0dbdfce540366d885861151fcadaca54983c7,1,2,2,4,2,2006-08-14 23:21:10,2006-08-14 23:21:10
8cd0dbdfce540366d885861151fcadaca54983c7...82501149907393d818766af4004c4a307aa28ef8,2,90,0,90,1,2006-08-15 00:13:16,2006-08-15 00:13:16
82501149907393d818766af4004c4a307aa28ef8...7c986521cf37b7384e7f2f3cee8bae4b1e4f624b,2,12,1,13,3,2006-08-18 14:06:02,2006-08-18 14:06:02
7c986521cf37b7384e7f2f3cee8bae4b1e4f624b...f180bb6ab3181eab8096188e39871c15e908550a,1,34,8,42,5,2006-08-18 14:23:57,2006-08-18 14:23:57
f180bb6ab3181eab8096188e39871c15e908550a...da50848a71e12cac7260e9a529ab15b8b8cd6ed0,1,11,7,18,4,2006-08-19 16:26:11,2006-08-19 16:26:11
da50848a71e12cac7260e9a529ab15b8b8cd6ed0...9f115aa7eaa1da5903b6a7af6a7547234710aebf,6,144,36,180,34,2006-08-19 16:27:56,2006-08-19 16:27:56
9f115aa7eaa1da5903b6a7af6a7547234710aebf...b5cbbf58c03d79b912a076658f3ae0997fcb1dbe,5,92,39,131,33,2006-08-19 17:53:48,2006-08-19 17:53:48
b5cbbf58c03d79b912a076658f3ae0997fcb1dbe...741df7b44c0ac0f4ff5d2a38a080f5614f06a597,5,71,11,82,8,2006-08-19 18:21:01,2006-08-19 18:21:01
741df7b44c0ac0f4ff5d2a38a080f5614f06a597...23cb1f0eb645ae8ebf3565d28dfb155ad701a1e3,2,2,3,5,3,2006-08-19 19:45:41,2006-08-19 19:45:41
23cb1f0eb645ae8ebf3565d28dfb155ad701a1e3...6bed9e0b2c5e2152df454bc5f1a865eb46c427da,2,8,10,18,7,2006-08-20 00:13:46,2006-08-20 00:13:46
6bed9e0b2c5e2152df454bc5f1a865eb46c427da...722d0dbf4281d06d51d85cfbe82e74e669e843c6,2,9,3,12,6,2006-08-20 18:00:07,2006-08-20 18:00:07
722d0dbf4281d06d51d85cfbe82e74e669e843c6...19ece7470d3529d87e9a1c237cc5e1cfdc0456f5,6,59,89,148,26,2006-08-20 18:02:58,2006-08-20 18:02:58
19ece7470d3529d87e9a1c237cc5e1cfdc0456f5...e1caee2b287513db0a349d701b3643fb9a32168f,1,103,1,104,2,2006-08-20 20:52:58,2006-08-20 20:52:58
e1caee2b287513db0a349d701b3643fb9a32168f...8a38dfaa83d613982dbc844ac91dc49bbe7f7227,2,23,13,36,8,2006-08-20 20:54:37,2006-08-20 20:54:37
8a38dfaa83d613982dbc844ac91dc49bbe7f7227...736febadc53f571a00c81f74981a4e77bd4bfac6,5,17,12,29,10,2006-08-20 22:17:01,2006-08-20 22:17:01
736febadc53f571a00c81f74981a4e77bd4bfac6...98fc1a220f0e9743cce8a5599dedbff3f5436180,3,5,2,7,5,2006-08-20 22:23:42,2006-08-20 22:23:42
98fc1a220f0e9743cce8a5599dedbff3f5436180...455842e07e44c63f45850e7471b1f19826af6235,6,25,20,45,12,2006-08-20 22:46:38,2006-08-20 22:46:38
455842e07e44c63f45850e7471b1f19826af6235...49c1c2fdd3a4b997aa009faf85a9ae6665fa4e00,15,142,22,164,25,2006-08-20 22:49:48,2006-08-20 22:49:48
49c1c2fdd3a4b997aa009faf85a9ae6665fa4e00...84771a606ae864808554f5765783485deed8ae95,3,10,4,14,6,2006-08-21 01:16:26,2006-08-21 01:16:26
84771a606ae864808554f5765783485deed8ae95...7b2e3798f428536b5c56c863f0eef85c54224d51,2,18,14,32,15,2006-08-24 16:07:30,2006-08-24 16:07:30
7b2e3798f428536b5c56c863f0eef85c54224d51...5d37e5cd4c42e5dd831f927fd94329cb5c613d83,1,3,1,4,3,2006-08-24 16:08:13,2006-08-24 16:08:13
5d37e5cd4c42e5dd831f927fd94329cb5c613d83...bd64483da63c3790446107b3f7151768dc1f6e65,1,1,3,4,3,2006-08-25 10:50:46,2006-08-25 10:50:46
bd64483da63c3790446107b3f7151768dc1f6e65...61d6f592c9c6240537bf4f4c3844f563f7fb68e6,92,1471,1171,2642,162,2006-08-28 13:06:03,2006-08-28 13:06:03
61d6f592c9c6240537bf4f4c3844f563f7fb68e6...64be2e2881fe39857fc70478198b86cc13b0ec24,3,26,10,36,4,2006-08-28 19:53:26,2006-08-28 19:53:26
64be2e2881fe39857fc70478198b86cc13b0ec24...325762a1e925e642a8c5ecca0b19216668bfebf9,1,1,1,2,1,2006-08-29 13:49:45,2006-08-29 13:49:45
325762a1e925e642a8c5ecca0b19216668bfebf9...ea2a514f5cdbc15f8c26e91f827339d3eb36d12a,1,4,1,5,2,2006-08-30 19:14:09,2006-08-30 19:14:09
ea2a514f5cdbc15f8c26e91f827339d3eb36d12a...aef05822d03fe0fb32be44d6bae27ee1e329d52a,1,4,4,8,2,2006-09-04 16:59:09,2006-09-04 16:59:09
aef05822d03fe0fb32be44d6bae27ee1e329d52a...5c13ad5ea2d65cd705c6362ef4194b45725177f8,1,4,4,8,4,2006-09-07 01:28:37,2006-09-07 01:28:37
5c13ad5ea2d65cd705c6362ef4194b45725177f8...e12c2f83e0109a8e78954c8a176aa42b28ea96dc,51,1469,169,1638,154,2006-09-07 01:36:27,2006-09-07 01:36:27
e12c2f83e0109a8e78954c8a176aa42b28ea96dc...00972e69b6143e7cafd34661366cfe8e8975470b,3,11,8,19,9,2006-09-12 15:04:29,2006-09-12 15:04:29
00972e69b6143e7cafd34661366cfe8e8975470b...43260cfbf2d9f42f66ad60110152fc9cece27908,1,9,6,15,1,2006-09-12 15:55:49,2006-09-12 15:55:49
43260cfbf2d9f42f66ad60110152fc9cece27908...a2fbd5f14cb8a8238b2812776cb2a3c7477286f2,1,2,1,3,1,2006-09-15 19:01:37,2006-09-15 19:01:37
a2fbd5f14cb8a8238b2812776cb2a3c7477286f2...20ca1751dc8bbd01dd08ed33744298828a519ac1,2,3,2,5,2,2006-09-17 18:32:27,2006-09-17 18:32:27
20ca1751dc8bbd01dd08ed33744298828a519ac1...aa6725cb07049fa2dd6da1a8f7923ae74a851d96,1,5,2,7,2,2006-09-18 14:21:47,2006-09-18 14:21:47
aa6725cb07049fa2dd6da1a8f7923ae74a851d96...13d039ddabc79113bb319a668a8283097de4d165,1,1,1,2,1,2006-09-23 17:35:37,2006-09-23 17:35:37
13d039ddabc79113bb319a668a8283097de4d165...5ea24f0c141a90f1e9a61ca7a8397cc28566623f,61,3354,810,4164,742,2006-09-23 18:18:58,2006-09-23 18:18:58
5ea24f0c141a90f1e9a61ca7a8397cc28566623f...ea249260dc5bd6ae29e6c80e7212948f4997c79b,1,1,1,2,1,2006-09-25 21:06:35,2006-09-25 21:06:35
ea249260dc5bd6ae29e6c80e7212948f4997c79b...655bee8b288ae2893da05a4f750c2899c81b47ea,4,69,4,73,13,2006-10-03 13:19:19,2006-10-03 13:19:19
655bee8b288ae2893da05a4f750c2899c81b47ea...46f6dc7e4ea3d3b69c525499569f3818efbb81fd,2,18,0,18,5,2006-10-03 18:11:02,2006-10-03 18:11:02
46f6dc7e4ea3d3b69c525499569f3818efbb81fd...3f60a8e98d90c1fce40017a2e01b0b4643d91bd6,1,5,2,7,3,2006-10-04 01:57:00,2006-10-04 01:57:00
3f60a8e98d90c1fce40017a2e01b0b4643d91bd6...f6fa1032968d8baaf2a30f8478793e8592c72c72,92,5402,2040,7442,1530,2006-10-27 02:11:46,2006-10-27 02:11:46
f6fa1032968d8baaf2a30f8478793e8592c72c72...47fca880e3d7bd19744b6c77ebb4667225308a7b,1,1,1,2,1,2006-11-24 04:13:11,2006-11-24 04:13:11
47fca880e3d7bd19744b6c77ebb4667225308a7b...1b54fc3abace9b5a9752c2d950222c487b960899,87,3022,637,3659,587,2006-11-24 04:17:58,2006-11-24 04:17:58
1b54fc3abace9b5a9752c2d950222c487b960899...6fab0ffcadf513eb6ce1122b7203457ad4e29181,7,141,205,346,109,2006-11-25 05:18:33,2006-11-25 05:18:33
6fab0ffcadf513eb6ce1122b7203457ad4e29181...c4673e4fb68237f96652d7372bec0283c5446c27,1,1,1,2,1,2006-11-25 05:22:22,2006-11-25 05:22:22
c4673e4fb68237f96652d7372bec0283c5446c27...0cf7bc439129c66df8d64601e885f83b256b4f25,64,4055,1534,5589,404,2006-12-27 02:49:28,2006-12-27 02:49:28
0cf7bc439129c66df8d64601e885f83b256b4f25...ae22b6d403dcf25098c77f0dfcf59ae58b186461,467,72034,20156,92190,8275,2007-06-17 22:18:54,2007-06-17 22:18:54
ae22b6d403dcf25098c77f0dfcf59ae58b186461...66ada24678c595bad17eaca91448aae05b2176cd,0,0,0,0,0,2009-09-11 21:25:01,2009-09-11 21:25:01
1a3b11261069490c534fd7487503ddc526680244...0b353abe67fed89d654ef61a0615762daf2c5d4d,0,0,0,0,0,2006-07-30 00:36:48,2006-07-30 00:36:48
0b353abe67fed89d654ef61a0615762daf2c5d4d...69fb4babc38530df758ac91e6dccdf45665f6740,0,0,0,0,0,2007-01-20 01:45:08,2007-01-20 01:45:08
69fb4babc38530df758ac91e6dccdf45665f6740...a132d411c6986418ee6c0edc331080aa792fee6e,1,11,1,12,1,2007-01-20 02:02:07,2007-01-20 02:02:07
a132d411c6986418ee6c0edc331080aa792fee6e...e89f0a65581f82a5740bfe989136cea75d09cd67,1,3,6,9,3,2007-01-20 02:05:02,2007-01-20 02:05:02
e89f0a65581f82a5740bfe989136cea75d09cd67...154b64dcf8f80f9f970aac034f3aa4a705500008,1,1,1,2,1,2007-01-20 02:09:13,2007-01-20 02:09:13
154b64dcf8f80f9f970aac034f3aa4a705500008...027afbcb002b286f55ca924b768658078b461e1e,1,3,1,4,1,2007-01-20 03:56:19,2007-01-20 03:56:19
027afbcb002b286f55ca924b768658078b461e1e...3080f4a36f066212e844f7dfa98a94a6621c8254,1,25,4,29,3,2007-01-21 08:23:16,2007-01-21 08:23:16
3080f4a36f066212e844f7dfa98a94a6621c8254...4fa6c90110203c17d33273edc90134e1d9fc29b7,1,1,1,2,1,2007-01-21 09:15:35,2007-01-21 09:15:35
4fa6c90110203c17d33273edc90134e1d9fc29b7...b0ea21299b3e694a761405a050123661793f677e,1,1,1,2,1,2007-01-21 09:37:40,2007-01-21 09:37:40
b0ea21299b3e694a761405a050123661793f677e...3fc271871faf8e1b64a0828279f4722636c5123b,2,49,13,62,7,2007-02-10 05:48:20,2007-02-10 05:48:20
3fc271871faf8e1b64a0828279f4722636c5123b...412ed22502e11c50dbfee854627594f0e7e2c234,4,79,48,127,12,2007-10-26 19:52:16,2007-10-26 19:52:16
412ed22502e11c50dbfee854627594f0e7e2c234...50ce7fb57d79e8940ccf6e2781f2f01df029b5c5,1,2,1,3,2,2008-05-14 04:07:15,2008-05-14 04:07:15
50ce7fb57d79e8940ccf6e2781f2f01df029b5c5...156e3653bded607f10c4b1d418d388b2be849d71,2,2,2,4,2,2008-05-14 04:16:04,2008-05-14 04:16:04
156e3653bded607f10c4b1d418d388b2be849d71...aee48854a164382c655acb9f18b3c06c3d238e81,2,3,40,43,8,2008-09-02 21:10:00,2008-09-02 21:10:00
aee48854a164382c655acb9f18b3c06c3d238e81...f4afec9893d6af6532963b7396ce017aace313f2,2,2,2,4,2,2008-09-02 21:18:44,2008-09-02 21:18:44
1a3b11261069490c534fd7487503ddc526680244...9e957485bd99f0c4de457201f621fab7b63ad784,2,8,4,12,5,2006-07-29 21:04:41,2006-07-29 21:04:41
9e957485bd99f0c4de457201f621fab7b63ad784...7b0c3d4a11f62bc685b5468e00d8642ef737b10a,1,1,1,2,1,2006-07-30 00:59:59,2006-07-30 00:59:59
7b0c3d4a11f62bc685b5468e00d8642ef737b10a...22e8fb11db33f675623cd722e0b5010786ab1e0c,1,1,1,2,1,2006-07-30 05:07:06,2006-07-30 05:07:06
22e8fb11db33f675623cd722e0b5010786ab1e0c...c4652993a26268ef4908c72336db18c779037f12,1,1,31,32,1,2006-07-30 17:41:55,2006-07-30 17:41:55
c4652993a26268ef4908c72336db18c779037f12...1e330b6267bf3e6442c12aaa6ec110840291d11e,1,5,1,6,1,2006-07-31 03:54:51,2006-07-31 03:54:51
1e330b6267bf3e6442c12aaa6ec110840291d11e...f832f5f98d630002fc1dc5f51c198550fe3f4f8d,1,1,1,2,1,2006-07-31 10:36:30,2006-07-31 10:36:30
f832f5f98d630002fc1dc5f51c198550fe3f4f8d...f6fbdf575a4aba0f94e6309571569eb48159f98e,2,273,367,640,176,2006-07-31 12:49:51,2006-07-31 12:49:51
f6fbdf575a4aba0f94e6309571569eb48159f98e...2e598fb5718123a98d23638450496ec5a9e54205,1,3,3,6,2,2006-07-31 14:59:53,2006-07-31 14:59:53
2e598fb5718123a98d23638450496ec5a9e54205...77f1b8a50d10ca9e393a7cb0d94c662be20e272a,1,5,1,6,1,2006-07-31 21:31:35,2006-07-31 21:31:35
77f1b8a50d10ca9e393a7cb0d94c662be20e272a...97aa9b28437aecb867c82b12d9970b030262822e,1,41,25,66,8,2006-08-01 00:19:04,2006-08-01 00:19:04
97aa9b28437aecb867c82b12d9970b030262822e...0f977e974c071dbcf8235765be3fbbcde5e9b4e0,1,5,5,10,3,2006-08-01 02:23:24,2006-08-01 02:23:24
0f977e974c071dbcf8235765be3fbbcde5e9b4e0...1a428ec9b8efd24b0ced665d348160a9fd396c42,4,52,5,57,7,2006-08-01 02:57:08,2006-08-01 02:57:08
1a428ec9b8efd24b0ced665d348160a9fd396c42...97e820ab3a71c65a39d8ce2539735dc9c73b5cec,1,1,1,2,1,2006-08-01 04:05:25,2006-08-01 04:05:25
97e820ab3a71c65a39d8ce2539735dc9c73b5cec...ad39bb1620a962597e8ed6c6d956e01a33fc654a,1,5,2,7,1,2006-08-01 14:20:01,2006-08-01 14:20:01
ad39bb1620a962597e8ed6c6d956e01a33fc654a...6ea0a13a16c364b21c9ef23c2efede35baabd4a1,1,5,2,7,2,2006-08-01 20:48:26,2006-08-01 20:48:26
6ea0a13a16c364b21c9ef23c2efede35baabd4a1...d03bc7771693a96a3075ba8c10364bb40585b386,1,1,1,2,1,2006-08-01 21:15:41,2006-08-01 21:15:41
d03bc7771693a96a3075ba8c10364bb40585b386...a7f8984e6e6be2ded5a03f758f28a85ce43187ac,1,3,0,3,1,2006-08-01 21:45:57,2006-08-01 21:45:57
a7f8984e6e6be2ded5a03f758f28a85ce43187ac...fa5e0562dcdf438ca7c1285b6d69f6c31bf0c676,1,3,7,10,2,2006-08-01 21:46:51,2006-08-01 21:46:51
fa5e0562dcdf438ca7c1285b6d69f6c31bf0c676...350a4a459298469f6f9fcaca8781e88452a97351,2,7,0,7,2,2006-08-02 15:05:51,2006-08-02 15:05:51
350a4a459298469f6f9fcaca8781e88452a97351...9c8c39be1ec5ed058914f2385bcf12de0126ac82,1,1,1,2,1,2006-08-02 15:07:46,2006-08-02 15:07:46
9c8c39be1ec5ed058914f2385bcf12de0126ac82...fd5d923c6bb3c22eb265dd45466dedea7d85d0dc,4,92,0,92,4,2006-08-04 04:18:12,2006-08-04 04:18:12
fd5d923c6bb3c22eb265dd45466dedea7d85d0dc...69de69d86a2d4ee81b7f3754ce8535cd7cc2d858,1,3,6,9,2,2006-08-04 04:20:34,2006-08-04 04:20:34
69de69d86a2d4ee81b7f3754ce8535cd7cc2d858...243912b255c5ccffd08527955da489e217aac062,2,2,1,3,2,2006-08-04 14:28:10,2006-08-04 14:28:10
243912b255c5ccffd08527955da489e217aac062...9fd211d073475e08288346040412575f577d85f9,1,1,0,1,1,2006-08-05 01:45:26,2006-08-05 01:45:26
9fd211d073475e08288346040412575f577d85f9...320c10cb19f126e25ec84d7f69945f3aa10d17e4,1,2,1,3,2,2006-08-05 01:48:33,2006-08-05 01:48:33
320c10cb19f126e25ec84d7f69945f3aa10d17e4...0c8c42af7f5a5bb27b57d93192b77fa657d4d57f,1,1,1,2,1,2006-08-05 01:49:26,2006-08-05 01:49:26
0c8c42af7f5a5bb27b57d93192b77fa657d4d57f...27bf70dcb95997d8274af4d5006e3a6f9a1de040,1,7,1,8,2,2006-08-06 02:29:38,2006-08-06 02:29:38
27bf70dcb95997d8274af4d5006e3a6f9a1de040...ae83871580c27ffaf876228cc66bb546a7c75db2,1,2,1,3,2,2006-08-06 10:35:25,2006-08-06 10:35:25
ae83871580c27ffaf876228cc66bb546a7c75db2...19c48c900572fb18beb928ff9210a00e6dfb62ed,1,0,4,4,1,2006-08-07 14:41:57,2006-08-07 14:41:57
19c48c900572fb18beb928ff9210a00e6dfb62ed...284bf1cf7d099fb75afa56a7d7a8952e093d612f,1,7,0,7,1,2006-08-08 15:03:01,2006-08-08 15:03:01
284bf1cf7d099fb75afa56a7d7a8952e093d612f...d9d44d718b5aa2c8e5e227c9df51cda56c1101be,1,2,2,4,2,2006-08-08 21:17:59,2006-08-08 21:17:59
d9d44d718b5aa2c8e5e227c9df51cda56c1101be...5ca28474f9e554170fd96a2b2ddd4fa1305807ce,1,11,5,16,6,2006-08-09 07:16:35,2006-08-09 07:16:35
5ca28474f9e554170fd96a2b2ddd4fa1305807ce...7a22a5194ccf81cc94ad03daf7f399f0b307430f,1,1,1,2,1,2006-08-09 11:22:14,2006-08-09 11:22:14
7a22a5194ccf81cc94ad03daf7f399f0b307430f...2c370e1a08d3d7bac17d8cfe8c909466d0cf2782,1,1,1,2,1,2006-08-09 14:40:29,2006-08-09 14:40:29
2c370e1a08d3d7bac17d8cfe8c909466d0cf2782...925c711cf75072526ced0ae8f18d561dca612092,2,15,8,23,5,2006-08-09 15:40:24,2006-08-09 15:40:24
925c711cf75072526ced0ae8f18d561dca612092...ffb6ecc335bb42b16d864ad6df139716c31029c2,1,1,1,2,1,2006-08-10 03:44:11,2006-08-10 03:44:11
ffb6ecc335bb42b16d864ad6df139716c31029c2...cba451c94035ebf6174a283d5b1442dd4b995953,1,1,1,2,1,2006-08-10 03:48:34,2006-08-10 03:48:34
cba451c94035ebf6174a283d5b1442dd4b995953...a6a402a7db45ea7d2bb8521b989de573c4f72fee,2,8,5,13,2,2006-08-10 03:55:03,2006-08-10 03:55:03
a6a402a7db45ea7d2bb8521b989de573c4f72fee...caa51f4444338aaf92409ab45b1cbe885389eb2f,2,5,0,5,2,2006-08-10 16:58:26,2006-08-10 16:58:26
caa51f4444338aaf92409ab45b1cbe885389eb2f...01983c8fc3f96b914b639e2e35b2435c729336eb,1,4,4,8,2,2006-08-11 02:22:42,2006-08-11 02:22:42
01983c8fc3f96b914b639e2e35b2435c729336eb...3e22c8ff527cacb37e8a0e6a8864f6f459f74684,1,17,17,34,17,2006-08-11 05:07:07,2006-08-11 05:07:07
3e22c8ff527cacb37e8a0e6a8864f6f459f74684...23964a7b9a57892c3916ddf6722f74a76072f6e3,3,13,3,16,6,2006-08-11 05:20:31,2006-08-11 05:20:31
23964a7b9a57892c3916ddf6722f74a76072f6e3...4805675f9d9fbce05428cabe3251f37764360824,1,1,1,2,1,2006-08-11 05:31:08,2006-08-11 05:31:08
4805675f9d9fbce05428cabe3251f37764360824...0b71ffacab025e82f58dfe40d4d8d22540f67471,2,78,17,95,12,2006-08-11 07:01:29,2006-08-11 07:01:29
0b71ffacab025e82f58dfe40d4d8d22540f67471...e5bf574678e7224bb7252e69adc0695a76e35c36,1,1,3,4,1,2006-08-11 15:32:35,2006-08-11 15:32:35
e5bf574678e7224bb7252e69adc0695a76e35c36...a8705cec47b164d8e0a3b809d4be442647c56cc2,1,4,3,7,4,2006-08-11 19:17:46,2006-08-11 19:17:46
a8705cec47b164d8e0a3b809d4be442647c56cc2...49c67053db9e8ff3d3de4f51b8bb7ce0949ad0b7,1,140,0,140,1,2006-08-11 20:25:21,2006-08-11 20:25:21
49c67053db9e8ff3d3de4f51b8bb7ce0949ad0b7...2e6aa7a57818f1c2b7f17253430c38a8d67f9171,1,8,0,8,1,2006-08-11 20:31:43,2006-08-11 20:31:43
2e6aa7a57818f1c2b7f17253430c38a8d67f9171...6f8e9be24a0c7208ebd6a3c72ec622ca02d6fc09,1,2,2,4,2,2006-08-11 22:04:42,2006-08-11 22:04:42
6f8e9be24a0c7208ebd6a3c72ec622ca02d6fc09...74f5d2b9b0c37e4ccbd5f303c4ab3d6400a95c59,2,5,2,7,3,2006-08-12 05:09:12,2006-08-12 05:09:12
74f5d2b9b0c37e4ccbd5f303c4ab3d6400a95c59...9ce32731274b288d254198aa027fd5316135dfdd,1,0,1,1,1,2006-08-12 05:10:51,2006-08-12 05:10:51
9ce32731274b288d254198aa027fd5316135dfdd...9cd0c333d6c0d9fd70dfb36c240749189bc19acd,2,5,0,5,2,2006-08-12 05:15:25,2006-08-12 05:15:25
9cd0c333d6c0d9fd70dfb36c240749189bc19acd...54ea309a1d0d10b1ff67aba582c1eaf4a1784d02,1,1,1,2,1,2006-08-12 05:18:25,2006-08-12 05:18:25
54ea309a1d0d10b1ff67aba582c1eaf4a1784d02...aa587cd9772216aa304a7a1fbb064fbf77e6742c,1,11,10,21,5,2006-08-12 05:31:31,2006-08-12 05:31:31
aa587cd9772216aa304a7a1fbb064fbf77e6742c...9354cfb6ce0232564dfbbccb33ccdfe2cc4dba43,1,1,1,2,1,2006-08-12 05:42:48,2006-08-12 05:42:48
9354cfb6ce0232564dfbbccb33ccdfe2cc4dba43...20070d9117d8014aefe69539f976951009b59bd9,1,8,1,9,1,2006-08-12 05:55:28,2006-08-12 05:55:28
20070d9117d8014aefe69539f976951009b59bd9...45be33a6327bccae60319982254ee62f65bea11e,4,26,1,27,4,2006-08-12 06:02:28,2006-08-12 06:02:28
45be33a6327bccae60319982254ee62f65bea11e...3e51dac933a29e543f3470320c34112593a3c99a,1,1,0,1,1,2006-08-12 17:42:02,2006-08-12 17:42:02
3e51dac933a29e543f3470320c34112593a3c99a...0f000b7ae5b257451fbe3d266fba902ee27ba54e,1,1,1,2,1,2006-08-13 01:49:11,2006-08-13 01:49:11
0f000b7ae5b257451fbe3d266fba902ee27ba54e...f13e70fae54e6d847f1600152701ef6eb04ffb82,1,1,1,2,1,2006-08-13 03:45:43,2006-08-13 03:45:43
f13e70fae54e6d847f1600152701ef6eb04ffb82...d07c2e91117ec80464195db63e7a0030d178b05f,2,151,260,411,87,2006-08-14 15:18:21,2006-08-14 15:18:21
d07c2e91117ec80464195db63e7a0030d178b05f...f98f702f2bca9dc460d4ee50b66f808d7efca43d,1,8,0,8,1,2006-08-14 23:07:43,2006-08-14 23:07:43
f98f702f2bca9dc460d4ee50b66f808d7efca43d...7c79f2affa978c2b3a9f523eed3793fd872f686c,1,1,1,2,1,2006-08-16 04:27:42,2006-08-16 04:27:42
7c79f2affa978c2b3a9f523eed3793fd872f686c...518d406e53a7417385a1a2e10bb5110b67d28fac,1,8,1,9,1,2006-08-16 06:28:13,2006-08-16 06:28:13
518d406e53a7417385a1a2e10bb5110b67d28fac...7fe6fd75ba12b1219e2f4846c7dd3972577bd4f5,1,7,3,10,2,2006-08-17 00:02:51,2006-08-17 00:02:51
7fe6fd75ba12b1219e2f4846c7dd3972577bd4f5...445f6920960a6786fa6a2d34a9ec16526e51f817,1,2,2,4,2,2006-08-17 00:37:49,2006-08-17 00:37:49
445f6920960a6786fa6a2d34a9ec16526e51f817...eefe35c7fa88bffefdb0429cc315748e8ab85f11,1,1,0,1,1,2006-08-17 23:05:42,2006-08-17 23:05:42
eefe35c7fa88bffefdb0429cc315748e8ab85f11...efa19ae8a78d555e826dc7bbbfa1c20c3475e498,3,52,6,58,6,2006-08-18 02:48:34,2006-08-18 02:48:34
efa19ae8a78d555e826dc7bbbfa1c20c3475e498...8f065bba6b262fe7b1bfde15e70bcbc7e4602a48,2,41,1,42,3,2006-08-18 03:12:36,2006-08-18 03:12:36
8f065bba6b262fe7b1bfde15e70bcbc7e4602a48...d592ca487ae4be5b7fdc22e6022bb766eeafab39,1,3,0,3,1,2006-08-18 03:31:13,2006-08-18 03:31:13
d592ca487ae4be5b7fdc22e6022bb766eeafab39...d4a2fbb6a2f43a9eb9a9fc66c738a031f655c914,1,4,1,5,1,2006-08-18 03:33:37,2006-08-18 03:33:37
d4a2fbb6a2f43a9eb9a9fc66c738a031f655c914...8b8f4520554e12eda69d38dce19e3782b416906b,1,1,1,2,1,2006-08-18 03:37:01,2006-08-18 03:37:01
8b8f4520554e12eda69d38dce19e3782b416906b...0a9a59f4d13abbbc0919199a255daf16b2ebc84b,1,4,3,7,1,2006-08-18 03:40:47,2006-08-18 03:40:47
0a9a59f4d13abbbc0919199a255daf16b2ebc84b...53348672c9da15d29fd19ab3b1977e819fd9c614,1,4,0,4,1,2006-08-18 03:42:28,2006-08-18 03:42:28
53348672c9da15d29fd19ab3b1977e819fd9c614...e7a91d3e0666a0b2a7a518325eff623e46e345b3,1,3,2,5,2,2006-08-18 03:43:55,2006-08-18 03:43:55
e7a91d3e0666a0b2a7a518325eff623e46e345b3...eef88a6d2cf404894b5b3f1bcb4c986ddcf03a91,1,1,1,2,1,2006-08-18 15:10:08,2006-08-18 15:10:08
eef88a6d2cf404894b5b3f1bcb4c986ddcf03a91...df20bf52b09c03da675abe60149e9f95c34a2026,1,5,5,10,2,2006-08-18 19:10:46,2006-08-18 19:10:46
df20bf52b09c03da675abe60149e9f95c34a2026...64cf4b95a67e6f9911ab67e971c7d57fced9522b,1,4,2,6,2,2006-08-18 21:39:29,2006-08-18 21:39:29
64cf4b95a67e6f9911ab67e971c7d57fced9522b...128151ebc875ac20f1423bb535c893884ba363f6,1,1,1,2,1,2006-08-20 05:32:20,2006-08-20 05:32:20
8661608a84c790fb534856344349170f50386c72...4fff0369ac00f12814c64c8b8c31dd17d388c9cf,0,0,0,0,0,2009-09-11 19:39:26,2009-09-11 19:39:26
128151ebc875ac20f1423bb535c893884ba363f6...ff5e01db5d580a288d051ffd0ac5f3033f41dc90,1,9,6,15,3,2006-08-21 17:40:54,2006-08-21 17:40:54
ff5e01db5d580a288d051ffd0ac5f3033f41dc90...cccbe23006d880ef1ccee64c855f15747e4589dc,1,1,1,2,1,2006-08-21 17:43:34,2006-08-21 17:43:34
cccbe23006d880ef1ccee64c855f15747e4589dc...dbaf1219d56aa085a6585066b83f2606844c6883,1,5,3,8,5,2006-08-21 18:27:33,2006-08-21 18:27:33
dbaf1219d56aa085a6585066b83f2606844c6883...513ae3a3f40aba03a589a1eb49f84ccab8dab852,1,1,1,2,1,2006-08-22 04:53:43,2006-08-22 04:53:43
513ae3a3f40aba03a589a1eb49f84ccab8dab852...295429d1c3010d4e93415b65e5e7f3d0479e2e59,1,11,0,11,8,2006-08-22 04:55:50,2006-08-22 04:55:50
295429d1c3010d4e93415b65e5e7f3d0479e2e59...5ddd0e0498dceaea17f97ad8bc37abd9182bc37c,1,1,1,2,1,2006-08-22 04:58:16,2006-08-22 04:58:16
5ddd0e0498dceaea17f97ad8bc37abd9182bc37c...3cfc8bb5d9ac06811ea8815c6a3a4b31817216e1,1,1,1,2,1,2006-08-22 17:45:21,2006-08-22 17:45:21
3cfc8bb5d9ac06811ea8815c6a3a4b31817216e1...34609438bbaf7881b610948eda791fa928ccec36,1,4,1,5,2,2006-08-23 02:05:05,2006-08-23 02:05:05
34609438bbaf7881b610948eda791fa928ccec36...2836624ba44ffc3d4d88794f59599f249ae87442,1,16,3,19,3,2006-08-23 15:40:41,2006-08-23 15:40:41
2836624ba44ffc3d4d88794f59599f249ae87442...0a770a0d92a0716091f73575fb45b98547a3e859,1,21,8,29,3,2006-08-23 23:15:09,2006-08-23 23:15:09
0a770a0d92a0716091f73575fb45b98547a3e859...1a1fb70c9f7c6c286a424710e2a496e79b4b6484,1,1,1,2,1,2006-08-24 03:37:34,2006-08-24 03:37:34
1a1fb70c9f7c6c286a424710e2a496e79b4b6484...7dce86ce0220ffb9f3f579cbd1e881e988764c9d,6,3049,0,3049,5,2006-08-27 12:24:59,2006-08-27 12:24:59
7dce86ce0220ffb9f3f579cbd1e881e988764c9d...89fa97b8374131614698bbab1544f9bdafdb66bd,7,17,10,27,14,2006-08-27 12:35:07,2006-08-27 12:35:07
89fa97b8374131614698bbab1544f9bdafdb66bd...77ab11be452d2da50925d5d2e3eed1b96ba7eca0,5,61,13,74,20,2006-08-27 12:46:39,2006-08-27 12:46:39
77ab11be452d2da50925d5d2e3eed1b96ba7eca0...97b9ad73b4889ffebb3da2239b472bbfd1600177,70,949,3791,4740,104,2006-08-27 13:59:47,2006-08-27 13:59:47
97b9ad73b4889ffebb3da2239b472bbfd1600177...2c2653db9fe3afdd73495ae90930898c589f4869,7,10,17,27,14,2006-08-27 18:10:32,2006-08-27 18:10:32
2c2653db9fe3afdd73495ae90930898c589f4869...33637e3b039e53be13af511eb83fcd8c12fd7459,1,11,5,16,1,2006-08-28 16:41:26,2006-08-28 16:41:26
33637e3b039e53be13af511eb83fcd8c12fd7459...e7424f0619361873da7a62af0a58a6ba5785f8fa,1,1,1,2,1,2006-08-28 18:39:30,2006-08-28 18:39:30
e7424f0619361873da7a62af0a58a6ba5785f8fa...a547ef0d6200a85fea4ad40cdf1a38e702daa920,1,4,1,5,1,2006-08-28 18:43:58,2006-08-28 18:43:58
a547ef0d6200a85fea4ad40cdf1a38e702daa920...56264160a2c8fbbe4e36d7c3f804115b8f2e66a2,1,5,5,10,5,2006-08-28 18:59:54,2006-08-28 18:59:54
56264160a2c8fbbe4e36d7c3f804115b8f2e66a2...0e577430e9c0b0848774227932050db037ae4e75,1,1,4,5,2,2006-08-28 20:00:47,2006-08-28 20:00:47
0e577430e9c0b0848774227932050db037ae4e75...f89b9c8654bb386cfcc29cccab7766c4be376fce,1,2,1,3,1,2006-08-28 20:44:35,2006-08-28 20:44:35
f89b9c8654bb386cfcc29cccab7766c4be376fce...ff4f24958dca02c4e5fabb8b24c16752bfc0c886,2,199,0,199,2,2006-08-29 18:04:09,2006-08-29 18:04:09
128151ebc875ac20f1423bb535c893884ba363f6...682aed446b16c1dd6c12d727849a715033878b34,0,0,0,0,0,2006-08-21 16:29:37,2006-08-21 16:29:37
682aed446b16c1dd6c12d727849a715033878b34...91790e27cd00b88b0891cb815a36d21813246c5d,10,567,0,567,9,2006-08-21 19:02:19,2006-08-21 19:02:19
91790e27cd00b88b0891cb815a36d21813246c5d...842340d453c3535d52a9f341aa57ed35f20e321a,1,2,0,2,1,2006-08-22 05:04:01,2006-08-22 05:04:01
842340d453c3535d52a9f341aa57ed35f20e321a...33a31efc2108e8aa4868d6f8774ca48f933b23ca,0,0,0,0,0,2009-09-11 21:27:33,2009-09-11 21:27:33
ff4f24958dca02c4e5fabb8b24c16752bfc0c886...a619b2b8715f775f0090a3f47f0d327620b9ed65,1,1,5,6,1,2006-08-30 00:54:08,2006-08-30 00:54:08
a619b2b8715f775f0090a3f47f0d327620b9ed65...a4bd32770c5bc51bfdc7e45fa5d3438c06ea6cd3,1,1,1,2,1,2006-08-30 16:39:18,2006-08-30 16:39:18
a4bd32770c5bc51bfdc7e45fa5d3438c06ea6cd3...fe5462e57a84f126d6e0274bb8ef9df60927345e,1,4,4,8,2,2006-08-31 03:16:08,2006-08-31 03:16:08
fe5462e57a84f126d6e0274bb8ef9df60927345e...401b15d853a954c3a7c3c7d43fca0211b2252872,1,1,1,2,1,2006-08-31 03:45:08,2006-08-31 03:45:08
401b15d853a954c3a7c3c7d43fca0211b2252872...5e69536f7c0c5cac925560cabd277b6a59a8d0ef,1,10,7,17,2,2006-08-31 03:50:59,2006-08-31 03:50:59
5e69536f7c0c5cac925560cabd277b6a59a8d0ef...452847a6591596313b29b8cf290216047980ea30,1,11,0,11,2,2006-08-31 04:08:25,2006-08-31 04:08:25
452847a6591596313b29b8cf290216047980ea30...22303d6c7dfbcaa90ea2f6d2792c43b9b510e1f0,1,29,25,54,24,2006-08-31 04:11:46,2006-08-31 04:11:46
22303d6c7dfbcaa90ea2f6d2792c43b9b510e1f0...d9883e1dec9c80c49749f798890ae5a3efd781f0,1,13,0,13,1,2006-08-31 04:31:54,2006-08-31 04:31:54
d9883e1dec9c80c49749f798890ae5a3efd781f0...fc2d5f461f398bf048e8b821142019ddba9a677d,5,171,31,202,28,2006-08-31 14:29:47,2006-08-31 14:29:47
fc2d5f461f398bf048e8b821142019ddba9a677d...d39b5cae6864bafc9a0a07d8b239af1946d93ea1,1,2,2,4,2,2006-08-31 21:32:50,2006-08-31 21:32:50
d39b5cae6864bafc9a0a07d8b239af1946d93ea1...93b1f9ad6eb96d7ca9e09739bc0484a6f8212e51,1,5,1,6,1,2006-08-31 21:35:36,2006-08-31 21:35:36
93b1f9ad6eb96d7ca9e09739bc0484a6f8212e51...1d8db5ad89740e7e1783c964cf74148db1ac5876,2,18,11,29,2,2006-08-31 21:51:19,2006-08-31 21:51:19
1d8db5ad89740e7e1783c964cf74148db1ac5876...0a7f218b53c12a8d3143c22e3bcbd16032b185bc,1,3,0,3,1,2006-08-31 22:01:47,2006-08-31 22:01:47
0a7f218b53c12a8d3143c22e3bcbd16032b185bc...44dabecf6e4a009ff1a34ba12032ba07476baad2,6,458,0,458,6,2006-08-31 23:13:59,2006-08-31 23:13:59
44dabecf6e4a009ff1a34ba12032ba07476baad2...cea1fcc0d152384e28550d28934254754cf4fad7,1,3,3,6,3,2006-08-31 23:16:25,2006-08-31 23:16:25
cea1fcc0d152384e28550d28934254754cf4fad7...fe9a21b243d5763d7b8d58fb17925d3928704da9,1,2,0,2,1,2006-08-31 23:17:37,2006-08-31 23:17:37
fe9a21b243d5763d7b8d58fb17925d3928704da9...0a11c82b04c7afd6971f959326e092517a55e9a8,1,9,0,9,1,2006-08-31 23:19:53,2006-08-31 23:19:53
0a11c82b04c7afd6971f959326e092517a55e9a8...a30653ac54833e80ad56150a875fb046d86217dc,2,8,8,16,5,2006-08-31 23:31:25,2006-08-31 23:31:25
a30653ac54833e80ad56150a875fb046d86217dc...60ebb616a91a6993a42492dab043024a2ca38030,5,14,14,28,11,2006-08-31 23:44:26,2006-08-31 23:44:26
60ebb616a91a6993a42492dab043024a2ca38030...d78e2ae3557feb1c9374cc56f6c130b13a7ef789,5,39,12,51,12,2006-09-01 13:33:26,2006-09-01 13:33:26
d78e2ae3557feb1c9374cc56f6c130b13a7ef789...d043200077244cfcc2b204dbb173d5d494d16f60,10,78,31,109,33,2006-09-02 09:26:24,2006-09-02 09:26:24
d043200077244cfcc2b204dbb173d5d494d16f60...826b9ff5e58ca7c16ef161258d2b5a8522effc6b,10,198,2,200,16,2006-09-02 09:34:40,2006-09-02 09:34:40
826b9ff5e58ca7c16ef161258d2b5a8522effc6b...46d7defb7de856b434bac77231c2ac708a3bc218,1,0,2,2,2,2006-09-02 09:40:59,2006-09-02 09:40:59
46d7defb7de856b434bac77231c2ac708a3bc218...5a1d560fb370a2f7dfd2477022e028106aa15de6,2,3,3,6,3,2006-09-02 18:10:00,2006-09-02 18:10:00
5a1d560fb370a2f7dfd2477022e028106aa15de6...8192a808bdb70752fc30a329a282e9c3e95850a8,2,179,25,204,19,2006-09-03 02:44:15,2006-09-03 02:44:15
8192a808bdb70752fc30a329a282e9c3e95850a8...3a919dbe2e3e2e433b476f87a6625fb17a808180,1,6,9,15,7,2006-09-04 13:05:51,2006-09-04 13:05:51
3a919dbe2e3e2e433b476f87a6625fb17a808180...cfe77946d70361c338a431bf661bb19e3870eab2,5,62,26,88,21,2006-09-04 14:02:11,2006-09-04 14:02:11
cfe77946d70361c338a431bf661bb19e3870eab2...f0362aa3005ce1b3f10e6d003f57c6dc8a89f9ff,1,23,27,50,9,2006-09-04 14:22:30,2006-09-04 14:22:30
f0362aa3005ce1b3f10e6d003f57c6dc8a89f9ff...8f79523b6292c8039c05a4c5530ce3bd3b31c934,1,1,1,2,1,2006-09-04 23:40:28,2006-09-04 23:40:28
8f79523b6292c8039c05a4c5530ce3bd3b31c934...b7a352d78fdd6608e770992b787a560e2e79438e,2,4,4,8,4,2006-09-04 23:49:14,2006-09-04 23:49:14
b7a352d78fdd6608e770992b787a560e2e79438e...8e52384b6c3d66ec2f256983c675af5f95983e72,1,1,1,2,1,2006-09-04 23:56:09,2006-09-04 23:56:09
8e52384b6c3d66ec2f256983c675af5f95983e72...cba5557c7a547d7e0f947b91610223643e85c572,1,1,1,2,1,2006-09-05 00:19:50,2006-09-05 00:19:50
cba5557c7a547d7e0f947b91610223643e85c572...7bd946258e36718a78fed2e5fd8dca35b4dfc9ad,1,1,1,2,1,2006-09-05 00:20:53,2006-09-05 00:20:53
7bd946258e36718a78fed2e5fd8dca35b4dfc9ad...6417d6c7c3e439253b0188a61e5bcd0dd5063bc4,1,8,8,16,8,2006-09-05 00:26:14,2006-09-05 00:26:14
6417d6c7c3e439253b0188a61e5bcd0dd5063bc4...6f87b17a0d0da75767d0bbf05d52f787e897c599,2,8,4,12,3,2006-09-05 13:32:08,2006-09-05 13:32:08
6f87b17a0d0da75767d0bbf05d52f787e897c599...6152b325aa696a54041606332bdcaf6b163d129e,1,3,17,20,1,2006-09-05 16:12:36,2006-09-05 16:12:36
6152b325aa696a54041606332bdcaf6b163d129e...29ba3e337bd9c95d059eeae55a3743b675c21150,1,2,2,4,2,2006-09-07 04:21:11,2006-09-07 04:21:11
29ba3e337bd9c95d059eeae55a3743b675c21150...5a9839c547ba1c2cfb7eb160120b5deb97cda5ed,3,59,24,83,10,2006-09-07 13:29:56,2006-09-07 13:29:56
5a9839c547ba1c2cfb7eb160120b5deb97cda5ed...8aa6a94e1a6a457b3a62377ff68b64421cc4596f,1,2,2,4,2,2006-09-07 18:26:00,2006-09-07 18:26:00
8aa6a94e1a6a457b3a62377ff68b64421cc4596f...e9b19df3ee04b9ea0e9a11012f956e9907579f5d,1,4,0,4,3,2006-09-08 05:38:38,2006-09-08 05:38:38
e9b19df3ee04b9ea0e9a11012f956e9907579f5d...5b34781f2808963c003642aa05c3ea25fe1c9fe3,1,12,10,22,9,2006-09-08 13:10:57,2006-09-08 13:10:57
5b34781f2808963c003642aa05c3ea25fe1c9fe3...36added124f73203f0d64a1a5b0f6e4bede35d85,1,17,4,21,1,2006-09-09 14:58:46,2006-09-09 14:58:46
36added124f73203f0d64a1a5b0f6e4bede35d85...a08322fbc2b8a5a2c46e98ece7e55a9de379083d,2,342,206,548,162,2006-09-11 14:46:20,2006-09-11 14:46:20
a08322fbc2b8a5a2c46e98ece7e55a9de379083d...fc937bd464b6fae096d444f0e139376bc8b04cc9,4,132,152,284,146,2006-09-11 14:48:28,2006-09-11 14:48:28
fc937bd464b6fae096d444f0e139376bc8b04cc9...86a848e7ccda3ea2764299507bc9d2b659edb790,2,47,49,96,52,2006-09-11 14:49:46,2006-09-11 14:49:46
86a848e7ccda3ea2764299507bc9d2b659edb790...45ce6c3d82ad429ce617be4a9b4e48e413dc6e34,2,274,232,506,232,2006-09-11 14:50:52,2006-09-11 14:50:52
45ce6c3d82ad429ce617be4a9b4e48e413dc6e34...2535c91c5b63eb588dd2aea5151ba0b20629947a,5,2142,0,2142,3,2006-09-11 14:53:36,2006-09-11 14:53:36
2535c91c5b63eb588dd2aea5151ba0b20629947a...521c6a2652126be05acae83bb812ac3aec3ed93a,1,1,1,2,1,2006-09-11 18:31:46,2006-09-11 18:31:46
521c6a2652126be05acae83bb812ac3aec3ed93a...9b5807a3fe03439a69e65c3596be874d6941a7fc,1,8,8,16,1,2006-09-11 18:32:45,2006-09-11 18:32:45
9b5807a3fe03439a69e65c3596be874d6941a7fc...69375bf9c92a05aa10fe2a40e1db17d906cf62d8,1,0,1,1,1,2006-09-11 18:38:20,2006-09-11 18:38:20
69375bf9c92a05aa10fe2a40e1db17d906cf62d8...eaaebf5752fb046ed03e2cbea0a16f17770e6251,1,1,0,1,1,2006-09-11 18:39:11,2006-09-11 18:39:11
eaaebf5752fb046ed03e2cbea0a16f17770e6251...ecf6a3511228eb901b8d69243fc6d6d6d9e89f6b,2,2,0,2,2,2006-09-11 18:41:05,2006-09-11 18:41:05
ecf6a3511228eb901b8d69243fc6d6d6d9e89f6b...086992c7390432b375c3aa49ff396941fc724a02,1,5,5,10,5,2006-09-11 18:42:56,2006-09-11 18:42:56
086992c7390432b375c3aa49ff396941fc724a02...3c5782287efc197eccf556cf6915fc0d8b3e02bd,1,3,6,9,3,2006-09-12 17:30:47,2006-09-12 17:30:47
3c5782287efc197eccf556cf6915fc0d8b3e02bd...45399b4b13928e7616d4d1b2e8859d6ef9a865c7,1,5,5,10,2,2006-09-14 13:31:50,2006-09-14 13:31:50
45399b4b13928e7616d4d1b2e8859d6ef9a865c7...927ec3fe7b446079d169ce684f833800bc117b74,2,4,3,7,4,2006-09-14 15:37:11,2006-09-14 15:37:11
927ec3fe7b446079d169ce684f833800bc117b74...a5f4a0255da078c3b5758adb3dbe33c5476544c3,1,6,0,6,3,2006-09-15 09:30:35,2006-09-15 09:30:35
a5f4a0255da078c3b5758adb3dbe33c5476544c3...d411a9a777721eae732d4ca1de8ec7dfcd30a98c,1,22,13,35,3,2006-09-21 11:19:34,2006-09-21 11:19:34
d411a9a777721eae732d4ca1de8ec7dfcd30a98c...d85ee1c01ef044fd2a150ba5ddbc82d0cb040875,1,11,6,17,4,2006-09-21 11:41:18,2006-09-21 11:41:18
d85ee1c01ef044fd2a150ba5ddbc82d0cb040875...d296e5e565fff0d5b8ff9ed766919cf55904b79a,2,8,3,11,5,2006-09-21 13:09:00,2006-09-21 13:09:00
d296e5e565fff0d5b8ff9ed766919cf55904b79a...e947fb2111c575b6005c9a291c25d85a959e8b1f,3,5,4,9,4,2006-09-21 13:30:01,2006-09-21 13:30:01
e947fb2111c575b6005c9a291c25d85a959e8b1f...31d764cadfa52e851db9eccb0e84b567ff4c0579,1,2,2,4,1,2006-09-21 13:35:34,2006-09-21 13:35:34
31d764cadfa52e851db9eccb0e84b567ff4c0579...f28f2994134fe6719f3186a0584cfc6dd0bffb52,1,2,2,4,2,2006-09-21 13:38:13,2006-09-21 13:38:13
f28f2994134fe6719f3186a0584cfc6dd0bffb52...8971760ab540de6415c6cea2f6cb457b23bc2341,1,1,1,2,1,2006-09-21 13:45:24,2006-09-21 13:45:24
8971760ab540de6415c6cea2f6cb457b23bc2341...3efd4dcd2d03c235a1b28d382466440a33c271f9,1,2,1,3,2,2006-09-22 01:28:47,2006-09-22 01:28:47
3efd4dcd2d03c235a1b28d382466440a33c271f9...6be701eba172a2ca71aaff0f9efe5796b30ca066,2,30,0,30,3,2006-09-22 01:44:28,2006-09-22 01:44:28
6be701eba172a2ca71aaff0f9efe5796b30ca066...c430eb8273d2f5887ec87f1adf29f0543a010fc5,1,2,2,4,2,2006-09-22 01:49:11,2006-09-22 01:49:11
c430eb8273d2f5887ec87f1adf29f0543a010fc5...3cf67a9920bc00703921a3961455df44ea168dd5,2,4,1,5,2,2006-09-22 01:54:10,2006-09-22 01:54:10
3cf67a9920bc00703921a3961455df44ea168dd5...4b5f0e2c87ba95a1e1340403d9bc737c27a0648d,1,5,1,6,3,2006-09-22 02:22:58,2006-09-22 02:22:58
4b5f0e2c87ba95a1e1340403d9bc737c27a0648d...4f63ce5b4a625c15718c676f5efb78e0ffa282f5,1,4,2,6,2,2006-09-22 02:36:50,2006-09-22 02:36:50
4f63ce5b4a625c15718c676f5efb78e0ffa282f5...b46a093c4598385b3bc7fb5803ebe7bb0677fdd4,3,11,2,13,4,2006-09-22 02:48:19,2006-09-22 02:48:19
b46a093c4598385b3bc7fb5803ebe7bb0677fdd4...8feee92045294e7d5baa0bd493b20ac5ddaa3385,1,1,4,5,1,2006-09-22 03:10:49,2006-09-22 03:10:49
8feee92045294e7d5baa0bd493b20ac5ddaa3385...0fee26935dc5ceae35d19e0c85321df4013d3701,3,9,6,15,5,2006-09-22 03:17:28,2006-09-22 03:17:28
0fee26935dc5ceae35d19e0c85321df4013d3701...084d618519b20e12526a9de54ba8ed62ea7959ac,1,1,1,2,1,2006-09-22 03:26:13,2006-09-22 03:26:13
084d618519b20e12526a9de54ba8ed62ea7959ac...14be60c4cb68ccd3062fc241ff2b9947fb010b98,2,5,3,8,3,2006-09-22 03:42:31,2006-09-22 03:42:31
14be60c4cb68ccd3062fc241ff2b9947fb010b98...9e05fc1598a676246bfbbd4113a5bcf9d3796642,1,18,13,31,4,2006-09-22 12:01:15,2006-09-22 12:01:15
9e05fc1598a676246bfbbd4113a5bcf9d3796642...dc39762fde7c9a20f3bcf2025ca2cb46e5c73433,1,2,1,3,1,2006-09-22 12:22:32,2006-09-22 12:22:32
dc39762fde7c9a20f3bcf2025ca2cb46e5c73433...c3d7aad6d0911bb84120d7c8d41923c895784b21,3,24,16,40,10,2006-09-22 12:32:00,2006-09-22 12:32:00
c3d7aad6d0911bb84120d7c8d41923c895784b21...4ca66711b5438bcab6309e9e331eeb1bd9e2b63d,1,27,0,27,1,2006-09-22 12:46:35,2006-09-22 12:46:35
4ca66711b5438bcab6309e9e331eeb1bd9e2b63d...f88d58285bd4303e54d6a2c6c821343786c9ac65,1,1,1,2,1,2006-09-22 12:53:51,2006-09-22 12:53:51
f88d58285bd4303e54d6a2c6c821343786c9ac65...96bc9ec79d12420a765ba210a9d8313c05b13d39,2,3,0,3,2,2006-09-22 13:10:46,2006-09-22 13:10:46
96bc9ec79d12420a765ba210a9d8313c05b13d39...d8b84cac9170d26b8a7033c2c7ff7a6620ac81b6,3,17,1,18,3,2006-09-22 13:26:07,2006-09-22 13:26:07
d8b84cac9170d26b8a7033c2c7ff7a6620ac81b6...aa30761d518281adbb215a2bd76357e3653a72e6,1,1,1,2,1,2006-09-22 13:33:43,2006-09-22 13:33:43
aa30761d518281adbb215a2bd76357e3653a72e6...26954aa3d094e2e77005f39742934e7d14f09164,1,0,1,1,1,2006-09-22 13:46:11,2006-09-22 13:46:11
26954aa3d094e2e77005f39742934e7d14f09164...93597d051d9ef8bcdf0ff6b9859406b73ab4f52c,1,5,1,6,4,2006-09-23 08:35:10,2006-09-23 08:35:10
93597d051d9ef8bcdf0ff6b9859406b73ab4f52c...670e8ab7040b3cb1f04d72a76b2c1fc9a4b3f457,2,4,1,5,2,2006-09-23 08:41:09,2006-09-23 08:41:09
670e8ab7040b3cb1f04d72a76b2c1fc9a4b3f457...bd4c22be0b7c75ef8b6a1e623fdc2626f05ea194,3,7,0,7,3,2006-09-23 09:49:58,2006-09-23 09:49:58
bd4c22be0b7c75ef8b6a1e623fdc2626f05ea194...e8b572b912deee1c2cec493782b1172fccd75f90,1,3,1,4,2,2006-09-23 10:02:16,2006-09-23 10:02:16
e8b572b912deee1c2cec493782b1172fccd75f90...6cdd341dab3e634f5b969547a0d55d04a430e044,1,4,1,5,3,2006-09-23 11:13:43,2006-09-23 11:13:43
6cdd341dab3e634f5b969547a0d55d04a430e044...539438a2312b53211cddfee897b1dd398b360c99,1,4,1,5,1,2006-09-23 12:06:38,2006-09-23 12:06:38
539438a2312b53211cddfee897b1dd398b360c99...00734bca7ed94e36d62dfb306b8b9b48df74e766,1,7,0,7,1,2006-09-23 12:11:37,2006-09-23 12:11:37
00734bca7ed94e36d62dfb306b8b9b48df74e766...6a12d767d43bbd649b4c2e31521c69ca74b12726,2,26,1,27,4,2006-09-23 12:41:19,2006-09-23 12:41:19
6a12d767d43bbd649b4c2e31521c69ca74b12726...12273fa947ec7c58b4d5e830aaa8e6538e1674b1,2,1,26,27,4,2006-09-23 13:04:37,2006-09-23 13:04:37
12273fa947ec7c58b4d5e830aaa8e6538e1674b1...28fad23a3f11bdd4d8e0961344df1c6a5983fc3c,2,26,1,27,4,2006-09-23 13:53:02,2006-09-23 13:53:02
28fad23a3f11bdd4d8e0961344df1c6a5983fc3c...35a13d4b6b001b476a36f49808631ac6f8762742,1,3,0,3,1,2006-09-23 13:55:04,2006-09-23 13:55:04
35a13d4b6b001b476a36f49808631ac6f8762742...ff47dc6ba0c100c849486fec7e9a2a4374c5a935,3,16,8,24,9,2006-09-24 08:17:47,2006-09-24 08:17:47
ff47dc6ba0c100c849486fec7e9a2a4374c5a935...14993ece48fc6f03de02f23b3cc0d51d32b28229,1,16,2,18,2,2006-09-24 08:22:52,2006-09-24 08:22:52
14993ece48fc6f03de02f23b3cc0d51d32b28229...8f7ab8efed0edbca69e117c67e2b33a5fbd18fbe,1,1,1,2,1,2006-09-24 10:30:15,2006-09-24 10:30:15
8f7ab8efed0edbca69e117c67e2b33a5fbd18fbe...b05e5501a455a86e577e70617ca0f376041568c9,1,1,2,3,2,2006-09-24 11:44:04,2006-09-24 11:44:04
b05e5501a455a86e577e70617ca0f376041568c9...a6a4e9b2441d1f70d345596528fe39f09ae96874,2,23,1,24,5,2006-09-24 12:09:32,2006-09-24 12:09:32
a6a4e9b2441d1f70d345596528fe39f09ae96874...e0cec60a143cedaf99c781bad284ec3d794a956b,1,2,2,4,2,2006-09-24 12:16:15,2006-09-24 12:16:15
e0cec60a143cedaf99c781bad284ec3d794a956b...e2664759e6f3c6436f536d5193279472312d2c90,1,1,0,1,1,2006-09-24 12:22:59,2006-09-24 12:22:59
e2664759e6f3c6436f536d5193279472312d2c90...b4e5a96ccc6aeb0cc4761865d3ea3221d3665e72,1,10,2,12,3,2006-09-25 01:53:34,2006-09-25 01:53:34
b4e5a96ccc6aeb0cc4761865d3ea3221d3665e72...5b490bba93d03edc58f0903d5ebb75f7b0f44784,2,6,2,8,3,2006-09-25 02:33:28,2006-09-25 02:33:28
5b490bba93d03edc58f0903d5ebb75f7b0f44784...f1c63992f77cd764239a09a6abe26a2781b34388,2,38,4,42,4,2006-09-25 07:25:12,2006-09-25 07:25:12
f1c63992f77cd764239a09a6abe26a2781b34388...6dacb3d10b4a29cca54e2f0196b24f471a10ceb9,2,2,1,3,2,2006-09-25 07:36:46,2006-09-25 07:36:46
6dacb3d10b4a29cca54e2f0196b24f471a10ceb9...9194038121e0ce0edf643ea94178d9ab060d084e,3,1899,0,1899,2,2006-09-25 13:30:16,2006-09-25 13:30:16
9194038121e0ce0edf643ea94178d9ab060d084e...845cc95caa707ee366b04551a69046bd8de6aeff,2,445,227,672,206,2006-09-25 13:38:09,2006-09-25 13:38:09
845cc95caa707ee366b04551a69046bd8de6aeff...fda8593f4ebda3f05c41f7697f3b830c55e57954,2,458,236,694,211,2006-09-25 13:47:32,2006-09-25 13:47:32
fda8593f4ebda3f05c41f7697f3b830c55e57954...f6ec6d24ab0d11b8ce3cdc0fbe6bfab5cee6407e,2,319,389,708,332,2006-09-25 13:48:41,2006-09-25 13:48:41
f6ec6d24ab0d11b8ce3cdc0fbe6bfab5cee6407e...0c41869e6ccf779e19032dede71a627c4370b68a,4,22,10,32,6,2006-09-25 13:49:01,2006-09-25 13:49:01
0c41869e6ccf779e19032dede71a627c4370b68a...0d24c93b346e06b95e74efb25b30279bfd15b3ac,4,15,17,32,14,2006-09-25 13:50:26,2006-09-25 13:50:26
0d24c93b346e06b95e74efb25b30279bfd15b3ac...182b5c5b5c4a2703e0713dbcc59e2964b0dd3ac8,1,3,3,6,3,2006-09-25 13:53:41,2006-09-25 13:53:41
182b5c5b5c4a2703e0713dbcc59e2964b0dd3ac8...a64cb2e4a60e5505bd48f20914eacad05a2341e2,2,38,11,49,17,2006-09-25 13:57:36,2006-09-25 13:57:36
a64cb2e4a60e5505bd48f20914eacad05a2341e2...175337605d087971306f69928d5db582aa4ece86,1,4,2,6,2,2006-09-25 14:06:14,2006-09-25 14:06:14
175337605d087971306f69928d5db582aa4ece86...205cb040d4158948433aa85535dfcbacccbada01,1,0,2,2,2,2006-09-25 14:17:51,2006-09-25 14:17:51
205cb040d4158948433aa85535dfcbacccbada01...40aa0ca875c10b868f23cecf67d66fcb5f6523de,1,3,3,6,3,2006-09-25 17:22:59,2006-09-25 17:22:59
40aa0ca875c10b868f23cecf67d66fcb5f6523de...33a9a8f21ae6a752f64498eb08d737ece089ff5a,1,2,2,4,2,2006-09-25 17:25:39,2006-09-25 17:25:39
33a9a8f21ae6a752f64498eb08d737ece089ff5a...227626dcd092051ffb29417c3bbe2d8321794cab,2,23,13,36,7,2006-09-25 17:33:17,2006-09-25 17:33:17
227626dcd092051ffb29417c3bbe2d8321794cab...61a1a1864d6e5aff91b87a57e76765000f910daa,1,1,1,2,1,2006-09-25 17:34:54,2006-09-25 17:34:54
61a1a1864d6e5aff91b87a57e76765000f910daa...321a59a36a545cc90000e1661ba0ed145585eea9,3,8,5,13,3,2006-09-25 17:38:35,2006-09-25 17:38:35
321a59a36a545cc90000e1661ba0ed145585eea9...a0b78df2bb75ca17e25f9a86796444000982d2b2,1,8,9,17,6,2006-09-25 17:42:19,2006-09-25 17:42:19
a0b78df2bb75ca17e25f9a86796444000982d2b2...8920f65acd68830ed93d0cce3ee0e33d76e8bec8,1,1,1,2,1,2006-09-25 17:43:13,2006-09-25 17:43:13
8920f65acd68830ed93d0cce3ee0e33d76e8bec8...f32318be98534504528efddcc99c8d2f8cf338bf,1,11,11,22,11,2006-09-25 17:44:07,2006-09-25 17:44:07
f32318be98534504528efddcc99c8d2f8cf338bf...7cfe56524bbe5233ba3a680a01e8a842f12207f7,3,6,6,12,3,2006-09-25 17:50:36,2006-09-25 17:50:36
7cfe56524bbe5233ba3a680a01e8a842f12207f7...83613ad6ded78d20404077452e46dea69888485b,1,1,1,2,1,2006-09-25 19:56:00,2006-09-25 19:56:00
83613ad6ded78d20404077452e46dea69888485b...83501405c25b85abde529fa7e205a00100211e5c,1,2,2,4,1,2006-09-26 00:36:04,2006-09-26 00:36:04
83501405c25b85abde529fa7e205a00100211e5c...1fc62f0fd6499605340d8608b7f0ae59bb88245d,1,1,1,2,1,2006-09-26 01:57:26,2006-09-26 01:57:26
1fc62f0fd6499605340d8608b7f0ae59bb88245d...4ed82677be94e98f0c3164db8bfdc7d520411526,3,16,1,17,4,2006-09-26 02:58:36,2006-09-26 02:58:36
4ed82677be94e98f0c3164db8bfdc7d520411526...9b034d27462b6d24668663c01ea8d3c98e0f4b3c,1,3,2,5,3,2006-09-26 03:42:27,2006-09-26 03:42:27
9b034d27462b6d24668663c01ea8d3c98e0f4b3c...789f30258a8dbeedf9eed3c29fd81aea0b8dee1f,1,1,1,2,1,2006-09-26 03:46:33,2006-09-26 03:46:33
789f30258a8dbeedf9eed3c29fd81aea0b8dee1f...11416e4a54425e4ea91a509fe25d94afb27a1e83,1,3,3,6,3,2006-09-26 04:11:30,2006-09-26 04:11:30
11416e4a54425e4ea91a509fe25d94afb27a1e83...be053df69341e98ef46c6ec3429d8f0812aab9f0,1,2,1,3,2,2006-09-26 04:37:10,2006-09-26 04:37:10
be053df69341e98ef46c6ec3429d8f0812aab9f0...a27f12f3884de8c51b7f8bf6fd669d38f449360c,2,41,1,42,4,2006-09-26 06:33:32,2006-09-26 06:33:32
a27f12f3884de8c51b7f8bf6fd669d38f449360c...9c0568e21ef8acde73e43cd899cf2a74967489b2,3,6,1,7,4,2006-09-26 07:26:07,2006-09-26 07:26:07
9c0568e21ef8acde73e43cd899cf2a74967489b2...e149c8bb8742adb4a93c8bb39c7fd69320abaf7b,1,1,1,2,1,2006-09-26 10:08:03,2006-09-26 10:08:03
e149c8bb8742adb4a93c8bb39c7fd69320abaf7b...5371ee1743dcfc6322dafeb292618c0405c00510,2,2,1,3,2,2006-09-26 10:19:40,2006-09-26 10:19:40
5371ee1743dcfc6322dafeb292618c0405c00510...4e76727fec2fa898314b4525a39ce995692f2a78,3,21,1,22,7,2006-09-26 10:46:34,2006-09-26 10:46:34
4e76727fec2fa898314b4525a39ce995692f2a78...876a3ed602a740e816ebd48868f4bc5ff75f52b6,1,1,1,2,1,2006-09-26 11:58:56,2006-09-26 11:58:56
876a3ed602a740e816ebd48868f4bc5ff75f52b6...ae0bea8d50f0070a7c1c377fb239bcd6926fbf82,1,1,1,2,1,2006-09-26 12:49:49,2006-09-26 12:49:49
ae0bea8d50f0070a7c1c377fb239bcd6926fbf82...0d19b2eaaefead036cc71564d90cffe5e3c45df7,1,3,0,3,1,2006-09-26 12:53:15,2006-09-26 12:53:15
0d19b2eaaefead036cc71564d90cffe5e3c45df7...cb829267b83d4bc5db0e7c93fc5c78feea2a6c25,1,1,1,2,1,2006-09-26 12:55:44,2006-09-26 12:55:44
cb829267b83d4bc5db0e7c93fc5c78feea2a6c25...1f8cc30f5f525ac53134b7d24cb8afeb7bcd0538,1,7,6,13,4,2006-09-26 13:08:16,2006-09-26 13:08:16
1f8cc30f5f525ac53134b7d24cb8afeb7bcd0538...f5b1da196019a18a311acdcfbe831a64d32256e2,1,1,0,1,1,2006-09-26 13:23:12,2006-09-26 13:23:12
f5b1da196019a18a311acdcfbe831a64d32256e2...875e7cb8154dc7ae4151f23b48a81113cde7a203,1,23,19,42,6,2006-09-26 13:38:19,2006-09-26 13:38:19
875e7cb8154dc7ae4151f23b48a81113cde7a203...6b4eb8bb70683bae99ec0cf758b633a4330bfa49,1,0,1,1,1,2006-09-26 13:59:10,2006-09-26 13:59:10
6b4eb8bb70683bae99ec0cf758b633a4330bfa49...2170110df90409a4299f833a84a1a47a9f505e16,1,1,0,1,1,2006-09-26 15:28:07,2006-09-26 15:28:07
2170110df90409a4299f833a84a1a47a9f505e16...5e218888225950b5fa5dcdb6acc634cbf6e09d10,1,12,0,12,1,2006-09-26 15:38:44,2006-09-26 15:38:44
5e218888225950b5fa5dcdb6acc634cbf6e09d10...b019331f44ef2f2137534b1f759d1c51730d1597,1,1,1,2,1,2006-09-26 16:00:52,2006-09-26 16:00:52
b019331f44ef2f2137534b1f759d1c51730d1597...38d80f8894d1b9978c21f8d214872f4c559a51dd,3,1,20,21,6,2006-09-26 16:11:13,2006-09-26 16:11:13
38d80f8894d1b9978c21f8d214872f4c559a51dd...a07aafe007cd83e4e4afb26d47f865608bd7ee65,1,0,1,1,1,2006-09-26 16:14:06,2006-09-26 16:14:06
a07aafe007cd83e4e4afb26d47f865608bd7ee65...96f0b7bd213d0de63095914559e4d1a1eceab840,2,3,5,8,3,2006-09-26 16:27:24,2006-09-26 16:27:24
96f0b7bd213d0de63095914559e4d1a1eceab840...8b216eb8656bfd83b34243189293f6433fdc2b80,1,7,1,8,3,2006-09-26 18:49:28,2006-09-26 18:49:28
8b216eb8656bfd83b34243189293f6433fdc2b80...ad144467808bf63a5712e668bebc66d5c39f4946,1,12,0,12,1,2006-09-26 21:57:46,2006-09-26 21:57:46
ad144467808bf63a5712e668bebc66d5c39f4946...6068f3e4cbbd985b0dc309030ec9f8d3c1cf7a96,3,27,1,28,7,2006-09-27 02:42:31,2006-09-27 02:42:31
6068f3e4cbbd985b0dc309030ec9f8d3c1cf7a96...a834f213bd5cf0cf794adbee67be5a614af6c219,1,1,1,2,1,2006-09-27 02:47:19,2006-09-27 02:47:19
a834f213bd5cf0cf794adbee67be5a614af6c219...0cc18151706d4f85e47b0171c63a63f51e0adcce,1,1,1,2,1,2006-09-27 02:50:46,2006-09-27 02:50:46
0cc18151706d4f85e47b0171c63a63f51e0adcce...15e7805ae4e5a1ae30ec240a3e1ad6b8a4e32269,4,34,34,68,32,2006-09-28 01:56:02,2006-09-28 01:56:02
15e7805ae4e5a1ae30ec240a3e1ad6b8a4e32269...beeb719c12f537b60a262e9f4f4e1f8dbc7c607d,1,13,16,29,2,2006-09-28 02:07:00,2006-09-28 02:07:00
beeb719c12f537b60a262e9f4f4e1f8dbc7c607d...f638234932e4346f29dfbaeabf58bb1e4d2ff117,4,0,21,21,4,2006-09-28 02:31:05,2006-09-28 02:31:05
f638234932e4346f29dfbaeabf58bb1e4d2ff117...f22cd4ec05f924725af2b634ab206bc99fbe543d,1,3,9,12,1,2006-09-28 02:34:48,2006-09-28 02:34:48
f22cd4ec05f924725af2b634ab206bc99fbe543d...c0127f015bc8ba78ac616e97f803b19f6027bb12,1,4,13,17,3,2006-09-28 02:37:41,2006-09-28 02:37:41
c0127f015bc8ba78ac616e97f803b19f6027bb12...db6688a454497758e17773db96cbde78a9f1e1eb,1,5,0,5,1,2006-09-28 11:20:48,2006-09-28 11:20:48
db6688a454497758e17773db96cbde78a9f1e1eb...555ac9ca0696529d1f4ebe9fe2b52b5d2c7dcba7,1,1,1,2,1,2006-09-28 11:38:19,2006-09-28 11:38:19
555ac9ca0696529d1f4ebe9fe2b52b5d2c7dcba7...7d5f6fe0f4895e46646430109efcb3d3b8005050,1,1,1,2,1,2006-09-28 20:39:37,2006-09-28 20:39:37
7d5f6fe0f4895e46646430109efcb3d3b8005050...fa8a1d252a4e928e5bed2cf7002e38943d80f753,8,12,12,24,12,2006-09-29 02:30:42,2006-09-29 02:30:42
fa8a1d252a4e928e5bed2cf7002e38943d80f753...14fb13da7ef3137a6b166c77724c3d790795e212,2,3,3,6,2,2006-09-29 13:37:58,2006-09-29 13:37:58
14fb13da7ef3137a6b166c77724c3d790795e212...fa4bb1b0933ac5b1b266269d20f1a40808f822ab,3,20,6,26,9,2006-09-30 01:21:03,2006-09-30 01:21:03
fa4bb1b0933ac5b1b266269d20f1a40808f822ab...6afa40ea00b20aa02d45d2bafee43fc56cd0df7c,1,1,1,2,1,2006-09-30 01:22:30,2006-09-30 01:22:30
6afa40ea00b20aa02d45d2bafee43fc56cd0df7c...bf6257f1ee6ec5a385af204a5342ca3cba67b127,1,2,2,4,2,2006-10-03 09:53:12,2006-10-03 09:53:12
bf6257f1ee6ec5a385af204a5342ca3cba67b127...b5a712240823f84e76172b729393123e9ac2f38d,1,12,6,18,7,2006-10-03 10:01:50,2006-10-03 10:01:50
b5a712240823f84e76172b729393123e9ac2f38d...67eabb9299925c0c84bb1b350512c73d170317e5,1,9,8,17,7,2006-10-03 12:57:05,2006-10-03 12:57:05
67eabb9299925c0c84bb1b350512c73d170317e5...d886e71f2bfed64cbfddebde1d8d24aa04034937,1,19,12,31,4,2006-10-03 13:05:10,2006-10-03 13:05:10
d886e71f2bfed64cbfddebde1d8d24aa04034937...b08a8dbb6569b0dac5d14320f3d7eee863d6fcc9,1,11,9,20,10,2006-10-03 13:23:49,2006-10-03 13:23:49
b08a8dbb6569b0dac5d14320f3d7eee863d6fcc9...f5087775b365906adeb25b66d1a6b8f1034c9e67,1,19,0,19,1,2006-10-03 13:46:11,2006-10-03 13:46:11
f5087775b365906adeb25b66d1a6b8f1034c9e67...8f91717c82f46021b8be38ab4f026352eb159fac,1,3,3,6,3,2006-10-03 13:58:33,2006-10-03 13:58:33
8f91717c82f46021b8be38ab4f026352eb159fac...afd9b8771140a706337c988e7c383a310bc751ab,1,1,1,2,1,2006-10-09 05:55:04,2006-10-09 05:55:04
afd9b8771140a706337c988e7c383a310bc751ab...aaa3411a0ab940c46a9e19e6eea5907dc86557fa,1,2,1,3,1,2006-10-09 23:24:48,2006-10-09 23:24:48
aaa3411a0ab940c46a9e19e6eea5907dc86557fa...69396ea8168ff7cddf8a24a48905f615e1dff9e6,2,462,270,732,207,2006-10-10 11:51:45,2006-10-10 11:51:45
69396ea8168ff7cddf8a24a48905f615e1dff9e6...f83e439efac6a390d36e4da467db142eeb1003cc,4,517,248,765,233,2006-10-10 11:53:12,2006-10-10 11:53:12
f83e439efac6a390d36e4da467db142eeb1003cc...73a6eb8ed08da2342baa7f4b4ed9b6743b5fb241,1,15,0,15,1,2006-10-13 14:26:08,2006-10-13 14:26:08
73a6eb8ed08da2342baa7f4b4ed9b6743b5fb241...fbbbf8b9a14ebd5752529009523729e7d87989e8,4,99,29,128,9,2006-10-14 02:48:05,2006-10-14 02:48:05
fbbbf8b9a14ebd5752529009523729e7d87989e8...44078d23a477a0bb09b8791dd3de00ca73c526c0,1,13,8,21,7,2006-10-14 17:04:25,2006-10-14 17:04:25
44078d23a477a0bb09b8791dd3de00ca73c526c0...0107d5957192cf9c3f6d138ba114cdff7889bb56,4,1835,1415,3250,460,2006-10-16 16:22:15,2006-10-16 16:22:15
0107d5957192cf9c3f6d138ba114cdff7889bb56...0d240504cafb5e7f8754a799b108901141368a2e,1,1,0,1,1,2006-10-16 16:23:28,2006-10-16 16:23:28
0d240504cafb5e7f8754a799b108901141368a2e...1d424817cb68d501775e71f3c22cab1662a00c24,3,31,244,275,6,2006-10-16 21:50:46,2006-10-16 21:50:46
1d424817cb68d501775e71f3c22cab1662a00c24...4e99600d658031ba7554111b506471ee889747bb,1,26,8,34,7,2006-10-16 22:38:18,2006-10-16 22:38:18
4e99600d658031ba7554111b506471ee889747bb...c3c090ab134c542f3e329d63b44b3dee5b9a3169,1,1,1,2,1,2006-10-17 00:45:46,2006-10-17 00:45:46
c3c090ab134c542f3e329d63b44b3dee5b9a3169...ef111a4434685e2d089cf0854938f6b309192b4c,1,1,0,1,1,2006-10-19 15:57:07,2006-10-19 15:57:07
ef111a4434685e2d089cf0854938f6b309192b4c...6cd6d9b85f6834c152bf073f96b4bb34377a3a86,1,2,1,3,1,2006-10-19 21:55:08,2006-10-19 21:55:08
6cd6d9b85f6834c152bf073f96b4bb34377a3a86...3f4179464f04348167ff1033eaf353fab47297db,1,14,0,14,1,2006-10-23 07:39:19,2006-10-23 07:39:19
3f4179464f04348167ff1033eaf353fab47297db...31ff83e3ce853519ae9c836d654f3fbaf39c9dd7,1,1,1,2,1,2006-10-23 07:42:04,2006-10-23 07:42:04
31ff83e3ce853519ae9c836d654f3fbaf39c9dd7...86404743d53bb6c53779879e10dc95e6e41f06fa,2,10,10,20,10,2006-10-23 07:46:22,2006-10-23 07:46:22
86404743d53bb6c53779879e10dc95e6e41f06fa...28ff6ecbda950f774adb5c10e444db935c70646f,1,3,3,6,3,2006-10-23 07:51:29,2006-10-23 07:51:29
28ff6ecbda950f774adb5c10e444db935c70646f...c60853e2880c2344d4b61ecb8240264160f01784,1,1,1,2,1,2006-10-23 07:55:16,2006-10-23 07:55:16
c60853e2880c2344d4b61ecb8240264160f01784...025980be53b424a036d940baca773a0bdd74e712,1,1,1,2,1,2006-10-23 07:59:30,2006-10-23 07:59:30
025980be53b424a036d940baca773a0bdd74e712...c65cd1be99d493b28d6ca48c27d69fed9ca80ecc,1,1,3,4,1,2006-10-23 23:53:24,2006-10-23 23:53:24
c65cd1be99d493b28d6ca48c27d69fed9ca80ecc...8a8472d3003c101160022845e93aad65bf47df29,1,1,1,2,1,2006-10-24 16:07:39,2006-10-24 16:07:39
8a8472d3003c101160022845e93aad65bf47df29...7988a4858357bb39b14af36ba0b5b5ad7d89989d,1,7,7,14,5,2006-10-24 16:23:05,2006-10-24 16:23:05
7988a4858357bb39b14af36ba0b5b5ad7d89989d...b0a8a75fc3fb90b2f8ba862e5c8f7ef1215433bf,1,1,1,2,1,2006-10-24 16:35:04,2006-10-24 16:35:04
b0a8a75fc3fb90b2f8ba862e5c8f7ef1215433bf...3f9ebe6cc5b7e1bc57d16853eb3e27795e3fea01,1,2,2,4,1,2006-10-24 16:37:51,2006-10-24 16:37:51
3f9ebe6cc5b7e1bc57d16853eb3e27795e3fea01...cacbedee277b9b03fe65282db201617cbaad38b2,1,1,1,2,1,2006-10-24 16:38:48,2006-10-24 16:38:48
cacbedee277b9b03fe65282db201617cbaad38b2...179d410a7acbb93a6d089a2184b09fead4b263ec,1,11,2,13,3,2006-10-24 16:42:03,2006-10-24 16:42:03
179d410a7acbb93a6d089a2184b09fead4b263ec...1c4ac051ce30dc96998a131ae95cbbab92595f42,1,1,0,1,1,2006-10-24 16:46:46,2006-10-24 16:46:46
1c4ac051ce30dc96998a131ae95cbbab92595f42...185a5f661448643ff5bfb9b8079b078c29d39fc3,1,1,1,2,1,2006-10-24 16:49:19,2006-10-24 16:49:19
185a5f661448643ff5bfb9b8079b078c29d39fc3...9c4918e16d5432e0333fb2f0281a992dcc6919b9,1,1,1,2,1,2006-10-24 16:54:32,2006-10-24 16:54:32
9c4918e16d5432e0333fb2f0281a992dcc6919b9...41d903bdbafe77282faddfad1888904524f77dca,1,4,4,8,1,2006-10-24 16:56:25,2006-10-24 16:56:25
41d903bdbafe77282faddfad1888904524f77dca...6b384e828d72b518a40e9d555e3c107bd5288b45,1,1,1,2,1,2006-10-24 17:00:03,2006-10-24 17:00:03
6b384e828d72b518a40e9d555e3c107bd5288b45...fa49edc7bdeb77d621c607ec08a5203357ea6859,1,2,2,4,2,2006-10-24 20:45:28,2006-10-24 20:45:28
fa49edc7bdeb77d621c607ec08a5203357ea6859...60b46d72ac81dc5a54b4eaa8ccf1159f83666aa9,5,52,13,65,18,2006-10-24 21:30:38,2006-10-24 21:30:38
60b46d72ac81dc5a54b4eaa8ccf1159f83666aa9...3536f891087a98dbb7b449b30e109e9ba5a4e2e1,1,6,4,10,5,2006-10-24 22:21:55,2006-10-24 22:21:55
3536f891087a98dbb7b449b30e109e9ba5a4e2e1...6fa3498d9f0a02f37aa602eaca1da6334076bd0e,1,2,1,3,1,2006-10-25 02:55:51,2006-10-25 02:55:51
6fa3498d9f0a02f37aa602eaca1da6334076bd0e...94386f61097a2c7e79de42bb08e77bcea1e8e268,2,73,115,188,98,2006-10-25 16:05:07,2006-10-25 16:05:07
94386f61097a2c7e79de42bb08e77bcea1e8e268...ed27ff9aa99ab4f55311a0fc4417665c53eac2aa,1,1,1,2,1,2006-10-25 21:56:17,2006-10-25 21:56:17
ed27ff9aa99ab4f55311a0fc4417665c53eac2aa...48234a0925fcba67a72d3cfc31fbf66cca3f2e33,4,12,2,14,7,2006-10-27 01:58:13,2006-10-27 01:58:13
48234a0925fcba67a72d3cfc31fbf66cca3f2e33...8211eb23e4940c046e0d42a65b8d6632d1330c62,1,5,0,5,1,2006-10-27 02:03:15,2006-10-27 02:03:15
8211eb23e4940c046e0d42a65b8d6632d1330c62...4baeadb9a2e3b65f91cd33a415a8e9d4fd8ff9dc,2,6,1,7,3,2006-10-27 02:19:32,2006-10-27 02:19:32
4baeadb9a2e3b65f91cd33a415a8e9d4fd8ff9dc...4d596a1f6443eaf5d18d70a18aaac25030c7fc81,1,869,0,869,1,2006-10-28 19:02:26,2006-10-28 19:02:26
4d596a1f6443eaf5d18d70a18aaac25030c7fc81...88a2f53b858fedf46ceb84a9fe09558b31038eb7,8,869,843,1712,8,2006-10-28 20:34:37,2006-10-28 20:34:37
88a2f53b858fedf46ceb84a9fe09558b31038eb7...bcba29fcd63de3678b1abe36826e93d993e57171,1,2,2,4,2,2006-10-28 20:59:23,2006-10-28 20:59:23
bcba29fcd63de3678b1abe36826e93d993e57171...a043715d7489283779820a2135125284a7d49537,1,2,2,4,2,2006-10-30 13:44:41,2006-10-30 13:44:41
a043715d7489283779820a2135125284a7d49537...cb93c0d0dae843d8d99afc3470e79a6920b746e6,1,1,1,2,1,2006-10-30 13:49:45,2006-10-30 13:49:45
cb93c0d0dae843d8d99afc3470e79a6920b746e6...5ec32a1c2d863760aff4c30befc18faf849af34f,1,1,1,2,1,2006-10-30 13:54:28,2006-10-30 13:54:28
5ec32a1c2d863760aff4c30befc18faf849af34f...6d1335c0584c5a3b834915d00362427e4607755e,3,17,3,20,5,2006-10-30 14:30:43,2006-10-30 14:30:43
6d1335c0584c5a3b834915d00362427e4607755e...41d11a685f6563c175902fad6e39a55c01c49a0b,17,31,31,62,29,2006-10-30 20:50:27,2006-10-30 20:50:27
41d11a685f6563c175902fad6e39a55c01c49a0b...149933075a5d5983e0dd591811e341fb1eb2026b,1,2,2,4,2,2006-10-30 20:52:02,2006-10-30 20:52:02
149933075a5d5983e0dd591811e341fb1eb2026b...97dd47a8ed230564335ecc0327d542544498ea4c,1,2,1,3,1,2006-10-30 20:57:35,2006-10-30 20:57:35
97dd47a8ed230564335ecc0327d542544498ea4c...7bff9cc368e8052fc0ded2f01105545683390efe,1,4,0,4,3,2006-10-31 12:27:55,2006-10-31 12:27:55
7bff9cc368e8052fc0ded2f01105545683390efe...c58fe999a1858308b677fb0b65b88b79028228d4,1,24,1,25,2,2006-11-01 23:52:43,2006-11-01 23:52:43
c58fe999a1858308b677fb0b65b88b79028228d4...c0eab791df84293ac5249784f39874ef44bbe4a6,1,46,3,49,6,2006-11-01 23:53:37,2006-11-01 23:53:37
c0eab791df84293ac5249784f39874ef44bbe4a6...964ccd10233dd03067f1b91b4312071f390fb452,1,209,0,209,3,2006-11-01 23:54:17,2006-11-01 23:54:17
964ccd10233dd03067f1b91b4312071f390fb452...36786d28f55e307e0acc6f1c0f432368bde44426,2,134,3,137,6,2006-11-02 01:06:12,2006-11-02 01:06:12
36786d28f55e307e0acc6f1c0f432368bde44426...6645d1fe48868814e4c73056b68be5c3861ed2d0,3,155,2,157,7,2006-11-02 03:16:12,2006-11-02 03:16:12
6645d1fe48868814e4c73056b68be5c3861ed2d0...7f71ae1b8dcbd2c74f53e479577f165e178df93c,1,11,2,13,3,2006-11-02 14:24:31,2006-11-02 14:24:31
7f71ae1b8dcbd2c74f53e479577f165e178df93c...7b78fd6f5d07904accdde8a878d0d6a3ebcaed56,1,1,1,2,1,2006-11-02 14:30:11,2006-11-02 14:30:11
7b78fd6f5d07904accdde8a878d0d6a3ebcaed56...4bead6e99f380d9788dd14ef1dab4b60a6ccdd9e,0,0,0,0,0,2006-11-02 14:42:13,2006-11-02 14:42:13
4bead6e99f380d9788dd14ef1dab4b60a6ccdd9e...77bdaa76dfdcb03ba482e8516d05a570fe100730,2,1,18,19,2,2006-11-03 02:14:46,2006-11-03 02:14:46
77bdaa76dfdcb03ba482e8516d05a570fe100730...88029f770010b96bb4a50de038a125be3104d09d,4,97,96,193,90,2006-11-03 13:18:07,2006-11-03 13:18:07
ff4f24958dca02c4e5fabb8b24c16752bfc0c886...083ebb346844ece29d81bacdd5ec6574feae3896,0,0,0,0,0,2006-08-29 21:37:20,2006-08-29 21:37:20
083ebb346844ece29d81bacdd5ec6574feae3896...70e05817910d5fe757a3a235252ef7c12e058676,45,1274,169,1443,162,2006-09-05 15:51:14,2006-09-05 15:51:14
70e05817910d5fe757a3a235252ef7c12e058676...8afc419b123f315d724cbefdbc4c07f0982627a9,32,3068,724,3792,643,2006-09-20 08:40:46,2006-09-20 08:40:46
8afc419b123f315d724cbefdbc4c07f0982627a9...1bb4fa2cb66269b1eff3b7d73f8c7864c0622368,60,3583,999,4582,896,2006-09-25 15:39:20,2006-09-25 15:39:20
1bb4fa2cb66269b1eff3b7d73f8c7864c0622368...0b059aa4eadc1d95ceca3a32821b65a9fb2a53e8,69,3427,2482,5909,1130,2006-10-24 07:49:37,2006-10-24 07:49:37
0b059aa4eadc1d95ceca3a32821b65a9fb2a53e8...dadfca08c0db567ce33284aaa8eb388cf667a836,78,2352,422,2774,383,2006-11-08 04:50:01,2006-11-08 04:50:01
dadfca08c0db567ce33284aaa8eb388cf667a836...122426e7453ed638a0c5be7e8b925adcddea3889,52,2420,661,3081,539,2006-12-08 15:10:09,2006-12-08 15:10:09
122426e7453ed638a0c5be7e8b925adcddea3889...fe361e678a46dc4c717c79c2f12b3ba32293b81a,120,5899,1898,7797,714,2007-01-31 23:43:09,2007-01-31 23:43:09
fe361e678a46dc4c717c79c2f12b3ba32293b81a...31ddfab1c5239bbe089d375d941a1ac1fb981453,0,0,0,0,0,2009-09-11 21:28:11,2009-09-11 21:28:11
88029f770010b96bb4a50de038a125be3104d09d...46b0713315020d63fa8ce7c4ea14d99daf256e47,4,387,162,549,157,2006-11-04 20:49:59,2006-11-04 20:49:59
46b0713315020d63fa8ce7c4ea14d99daf256e47...b6a17893308a5bced876f042fb67fb8358e24949,1,1,1,2,1,2006-11-06 22:51:00,2006-11-06 22:51:00
b6a17893308a5bced876f042fb67fb8358e24949...644af2213d4e3be19626a604ab2d315ec19f426c,1,7,2,9,1,2006-11-06 22:56:23,2006-11-06 22:56:23
644af2213d4e3be19626a604ab2d315ec19f426c...09d40c508a54e79dc324f62410fac7f34526a1f7,1,14,4,18,4,2006-11-07 01:54:34,2006-11-07 01:54:34
09d40c508a54e79dc324f62410fac7f34526a1f7...726756bdd5dc0aaf8ece224a044d11e27b5083da,1,1,1,2,2,2006-11-07 01:59:46,2006-11-07 01:59:46
726756bdd5dc0aaf8ece224a044d11e27b5083da...0fd9f6ec6bd4d98c22ca4791e90e7f3697804a48,1,8,4,12,2,2006-11-07 02:01:16,2006-11-07 02:01:16
0fd9f6ec6bd4d98c22ca4791e90e7f3697804a48...212cb21baad2fb0f6e47a382a467feded6d356b0,1,1,1,2,2,2006-11-07 02:04:06,2006-11-07 02:04:06
212cb21baad2fb0f6e47a382a467feded6d356b0...4d59730fad1fe882ad957b7ad463398329d2c8ea,3,30,7,37,8,2006-11-07 02:20:08,2006-11-07 02:20:08
4d59730fad1fe882ad957b7ad463398329d2c8ea...a4d86a7fb09e19779ea87ef0c29d0a85abade260,1,1,1,2,1,2006-11-07 02:25:49,2006-11-07 02:25:49
a4d86a7fb09e19779ea87ef0c29d0a85abade260...a888249770cec8be42d33b51ef455826851688ee,1,20,2,22,5,2006-11-07 02:32:33,2006-11-07 02:32:33
a888249770cec8be42d33b51ef455826851688ee...4cb22473278df29c998a75fb1646dc821c75e0cc,1,5,2,7,1,2006-11-07 04:13:06,2006-11-07 04:13:06
4cb22473278df29c998a75fb1646dc821c75e0cc...3a0733e12c2b0a03f80ff828f49f2cf6a258c138,2,41,0,41,2,2006-11-07 04:29:07,2006-11-07 04:29:07
3a0733e12c2b0a03f80ff828f49f2cf6a258c138...dabf0366044e053e5577c096b19d1d7d2bebfe9a,1,2,0,2,1,2006-11-07 04:31:35,2006-11-07 04:31:35
dabf0366044e053e5577c096b19d1d7d2bebfe9a...d4d1a22730eecd207d0e656161d24a52284112bf,2,51,37,88,15,2006-11-07 04:44:27,2006-11-07 04:44:27
d4d1a22730eecd207d0e656161d24a52284112bf...e39a8e947e5209533657405568992213e87bd532,1,7,3,10,4,2006-11-07 04:50:13,2006-11-07 04:50:13
e39a8e947e5209533657405568992213e87bd532...febe05b9eff84ab1d1ec2af61f6cd8337422731a,1,1,1,2,1,2006-11-07 04:56:50,2006-11-07 04:56:50
febe05b9eff84ab1d1ec2af61f6cd8337422731a...92151b2d283ee46dfaf35ec93c41ffabce58e850,1,5,1,6,1,2006-11-07 04:58:10,2006-11-07 04:58:10
92151b2d283ee46dfaf35ec93c41ffabce58e850...86143f7599e964cf3dc8ad3a88294d443a8138ff,1,1,1,2,1,2006-11-07 05:00:19,2006-11-07 05:00:19
86143f7599e964cf3dc8ad3a88294d443a8138ff...a1199d8528e2f51d333ea044a8b000665e2f7d7b,1,5,1,6,1,2006-11-07 05:01:35,2006-11-07 05:01:35
a1199d8528e2f51d333ea044a8b000665e2f7d7b...afb23664304a6423a9c7c326343faeae7ef0e035,1,4,1,5,1,2006-11-07 05:05:16,2006-11-07 05:05:16
afb23664304a6423a9c7c326343faeae7ef0e035...fef89a01c542701d73072ed22651f3be29ef1507,10,37,14,51,22,2006-11-07 05:17:38,2006-11-07 05:17:38
fef89a01c542701d73072ed22651f3be29ef1507...a14dba5eeda3ecd51cc9299878a757df174285a4,1,1,1,2,1,2006-11-07 05:20:00,2006-11-07 05:20:00
a14dba5eeda3ecd51cc9299878a757df174285a4...b1b4e8e7c43bb0ee93646493fcf2df4884c14030,3,74,25,99,11,2006-11-07 05:36:51,2006-11-07 05:36:51
b1b4e8e7c43bb0ee93646493fcf2df4884c14030...6f164ad4856a1a5431b3b3e19ab6dbafe692a52d,1,4,0,4,2,2006-11-07 15:32:18,2006-11-07 15:32:18
6f164ad4856a1a5431b3b3e19ab6dbafe692a52d...a84404c190f1d3e9d507faf8031c98517c4c4466,6,15,17,32,12,2006-11-07 19:07:27,2006-11-07 19:07:27
a84404c190f1d3e9d507faf8031c98517c4c4466...fdb3b738a8c4b5643ad3209520211b402dca95a2,1,3,3,6,3,2006-11-07 23:42:27,2006-11-07 23:42:27
fdb3b738a8c4b5643ad3209520211b402dca95a2...4b4efced54ecef304348545001f44cad27ad06e6,1,7,1,8,2,2006-11-10 03:28:58,2006-11-10 03:28:58
4b4efced54ecef304348545001f44cad27ad06e6...8fd2252e2bd2795ed6c97dbb41cf808c2a4fdbc0,1,1,1,2,1,2006-11-10 03:29:50,2006-11-10 03:29:50
8fd2252e2bd2795ed6c97dbb41cf808c2a4fdbc0...7cce717f348d3c7487b1dbf82b9f1f3a802ab82e,1,1,1,2,1,2006-11-10 03:30:00,2006-11-10 03:30:00
7cce717f348d3c7487b1dbf82b9f1f3a802ab82e...6a53c8a2dd3b818ed4426c6de05a58ba1e1cdd0d,1,1,1,2,1,2006-11-10 03:39:00,2006-11-10 03:39:00
6a53c8a2dd3b818ed4426c6de05a58ba1e1cdd0d...5d8c6cf65124a9fee4d2e28daf2563625a79781f,1,1,1,2,1,2006-11-10 15:28:32,2006-11-10 15:28:32
5d8c6cf65124a9fee4d2e28daf2563625a79781f...83c40fb92230c6c8d6977ad5fc05eb7ac5faba6b,1,1,1,2,1,2006-11-10 17:42:47,2006-11-10 17:42:47
83c40fb92230c6c8d6977ad5fc05eb7ac5faba6b...ab6fd7328ff835cfe969524d778d363440ca8d97,1,1,1,2,1,2006-11-13 05:02:45,2006-11-13 05:02:45
ab6fd7328ff835cfe969524d778d363440ca8d97...5163120587c103e70b1cb145d1c7b01383c9d2cb,4,245,128,373,125,2006-11-15 17:15:28,2006-11-15 17:15:28
5163120587c103e70b1cb145d1c7b01383c9d2cb...e0b83b69294331494bb5aeac6130b8ca819449bc,4,171,121,292,111,2006-11-15 17:23:18,2006-11-15 17:23:18
e0b83b69294331494bb5aeac6130b8ca819449bc...cdec3d85e2ab688a3683e574ad4590d78f261417,2,121,101,222,97,2006-11-15 17:30:02,2006-11-15 17:30:02
cdec3d85e2ab688a3683e574ad4590d78f261417...5a597d3bbb5c868ed6b48555f3b4f708dc7b032f,1,19,23,42,9,2006-11-15 20:16:04,2006-11-15 20:16:04
5a597d3bbb5c868ed6b48555f3b4f708dc7b032f...522f6740700f8bafae2845272e21da0074283809,2,155,4,159,4,2006-11-15 22:08:22,2006-11-15 22:08:22
522f6740700f8bafae2845272e21da0074283809...c4070e86c8067cbd615b6f1eb4f30098bd684da5,2,74,1,75,5,2006-11-15 23:09:10,2006-11-15 23:09:10
c4070e86c8067cbd615b6f1eb4f30098bd684da5...05420093ae9024aa94c773de6d6055ec2465d38b,1,16,2,18,1,2006-11-15 23:17:00,2006-11-15 23:17:00
05420093ae9024aa94c773de6d6055ec2465d38b...75516392b8bc93ae80a9faeb58d8d9cb5298be9d,2,8,42,50,38,2006-11-16 01:16:33,2006-11-16 01:16:33
75516392b8bc93ae80a9faeb58d8d9cb5298be9d...6dd4e6d046b9c4b60efb9b85f974b2acd049d791,4,51,33,84,24,2006-11-16 06:45:29,2006-11-16 06:45:29
6dd4e6d046b9c4b60efb9b85f974b2acd049d791...820d940355da7ac50c49140ec95242085fab04e6,1,1,1,2,1,2006-11-16 06:47:08,2006-11-16 06:47:08
820d940355da7ac50c49140ec95242085fab04e6...d2180a6bf3a72bad67bf4897b0ce2d94a6214fc4,3,14,5,19,5,2006-11-20 16:23:48,2006-11-20 16:23:48
d2180a6bf3a72bad67bf4897b0ce2d94a6214fc4...f759dac2c98372c8b27e2a18b942e653941b708d,3,12,11,23,7,2006-11-20 16:32:40,2006-11-20 16:32:40
f759dac2c98372c8b27e2a18b942e653941b708d...5bafb499e7647bb0829d566538c1c8d621bdee0f,1,1,0,1,1,2006-11-22 20:31:09,2006-11-22 20:31:09
5bafb499e7647bb0829d566538c1c8d621bdee0f...23e21df9ca9d9605f076fa395fa6f1547958305f,1,1,1,2,1,2006-11-23 04:34:45,2006-11-23 04:34:45
23e21df9ca9d9605f076fa395fa6f1547958305f...a2e227f2fa9e50f848a541040633acea0ab1c931,1,2,1,3,1,2006-11-23 17:06:11,2006-11-23 17:06:11
a2e227f2fa9e50f848a541040633acea0ab1c931...5836b140fabbf24c05dea3a8862e65b281ded3ad,1,33,0,33,1,2006-11-23 17:16:15,2006-11-23 17:16:15
5836b140fabbf24c05dea3a8862e65b281ded3ad...3abf8e42b550445d94683e5d9c0f7b12557ddf1f,2,20,1,21,5,2006-11-23 17:40:33,2006-11-23 17:40:33
3abf8e42b550445d94683e5d9c0f7b12557ddf1f...9884211a1a072b34391389b5d8e7fc515ac414d5,1,1,1,2,1,2006-11-23 17:48:06,2006-11-23 17:48:06
9884211a1a072b34391389b5d8e7fc515ac414d5...6b7cd79e8383a78d32da00ffd2669fa2673d90ca,1,1,1,2,1,2006-11-25 05:20:14,2006-11-25 05:20:14
6b7cd79e8383a78d32da00ffd2669fa2673d90ca...8379785e79c6d92baa02f5705009d38f1601c1e1,2,14,12,26,2,2006-11-25 06:33:59,2006-11-25 06:33:59
8379785e79c6d92baa02f5705009d38f1601c1e1...95d19384c06d3e6d5e71774d4a63a967b9f25331,1,2,11,13,3,2006-11-26 02:38:04,2006-11-26 02:38:04
95d19384c06d3e6d5e71774d4a63a967b9f25331...4a14f2e23350aaf33de7f830b644a47a06100a1b,2,33,10,43,10,2006-11-26 18:44:58,2006-11-26 18:44:58
4a14f2e23350aaf33de7f830b644a47a06100a1b...e71fb7c7f27f4ecdc96b00f59e2a70a389c350a3,1,5,2,7,1,2006-11-26 23:52:12,2006-11-26 23:52:12
e71fb7c7f27f4ecdc96b00f59e2a70a389c350a3...72d23e532e5d5635fc52b32631cd6074f26300f1,0,0,0,0,0,2006-11-26 23:59:07,2006-11-26 23:59:07
72d23e532e5d5635fc52b32631cd6074f26300f1...44bcc4e546d4e55eca5815c4d96bd40f526adbba,0,0,0,0,0,2006-11-27 00:01:59,2006-11-27 00:01:59
44bcc4e546d4e55eca5815c4d96bd40f526adbba...d1757daf0fa264fa2fb3a8d41848d74b228c4c22,1,1,1,2,1,2006-11-27 00:08:46,2006-11-27 00:08:46
d1757daf0fa264fa2fb3a8d41848d74b228c4c22...2e4ff8ee0c0319a5c67c3fc4c4430e56562dfa53,2,19,3,22,4,2006-11-27 00:23:17,2006-11-27 00:23:17
2e4ff8ee0c0319a5c67c3fc4c4430e56562dfa53...684cf3c6fe74c03bfdc7bab6ed0cd0c90a495c4a,1,1,1,2,1,2006-11-27 00:38:09,2006-11-27 00:38:09
684cf3c6fe74c03bfdc7bab6ed0cd0c90a495c4a...56ad38a826451c8380c66c074512565d55e7ac53,2,240,9,249,20,2006-11-27 00:49:26,2006-11-27 00:49:26
56ad38a826451c8380c66c074512565d55e7ac53...a08ed9d165e04a43650740701b1c3737134d7271,1,7,3,10,2,2006-11-27 01:12:55,2006-11-27 01:12:55
a08ed9d165e04a43650740701b1c3737134d7271...48b36bb4a418e8a453eaec1c15e4a48c184e5328,1,0,5,5,1,2006-11-27 01:49:26,2006-11-27 01:49:26
48b36bb4a418e8a453eaec1c15e4a48c184e5328...682e435c5f334bc0211b12f05398fe79e4e72713,2,21,20,41,21,2006-11-27 01:55:24,2006-11-27 01:55:24
682e435c5f334bc0211b12f05398fe79e4e72713...126e0ec0c3096ae5c631b00b29ff9e9f01ca15c2,2,126,49,175,22,2006-11-27 03:49:19,2006-11-27 03:49:19
126e0ec0c3096ae5c631b00b29ff9e9f01ca15c2...6d36d97cb8d0c982d7481e7d439c9848ded46a77,1,6,2,8,3,2006-11-27 04:23:20,2006-11-27 04:23:20
6d36d97cb8d0c982d7481e7d439c9848ded46a77...49236b95e904dbf8560cfb64eb4f5c430ec8f30a,2,75,2,77,4,2006-11-27 04:49:26,2006-11-27 04:49:26
49236b95e904dbf8560cfb64eb4f5c430ec8f30a...190c987e631efeebfab5892aef9a980963cfab7e,2,24,23,47,19,2006-11-27 04:56:33,2006-11-27 04:56:33
190c987e631efeebfab5892aef9a980963cfab7e...7c1cc5fb25929f2bdbce2c2a7c55cdb4374680c0,1,1,1,2,1,2006-11-27 05:02:21,2006-11-27 05:02:21
7c1cc5fb25929f2bdbce2c2a7c55cdb4374680c0...9c44d8b60b21ac2c5b05473ef88380037d926435,1,1,1,2,1,2006-11-27 23:38:49,2006-11-27 23:38:49
9c44d8b60b21ac2c5b05473ef88380037d926435...e1d23323b631436eaae78bb5e4676d83c97d7a6c,1,5,1,6,1,2006-11-28 22:58:10,2006-11-28 22:58:10
e1d23323b631436eaae78bb5e4676d83c97d7a6c...3d89f26b0890325870e35142e59f800f5ee68de2,1,7,7,14,6,2006-11-28 23:14:18,2006-11-28 23:14:18
3d89f26b0890325870e35142e59f800f5ee68de2...bb45c394a6d65d3aa1bd1adfd9417a2e4ded532b,2,81,16,97,13,2006-11-29 00:49:27,2006-11-29 00:49:27
bb45c394a6d65d3aa1bd1adfd9417a2e4ded532b...fe4af48ec8fd16acffa8c148b5c2308d6137f386,3,72,6,78,11,2006-11-29 01:40:27,2006-11-29 01:40:27
fe4af48ec8fd16acffa8c148b5c2308d6137f386...8aae90c0e5ff45fbcb6c380f8d952e87e7506ab8,2,129,3,132,3,2006-11-29 03:02:26,2006-11-29 03:02:26
8aae90c0e5ff45fbcb6c380f8d952e87e7506ab8...4db61fb406afb8447fb8dfe4808ccb426b824064,1,2,2,4,2,2006-11-29 03:14:03,2006-11-29 03:14:03
4db61fb406afb8447fb8dfe4808ccb426b824064...e6babbfe5f35dd972c185ff194c285df9e2e4a06,1,1,0,1,1,2006-11-29 03:18:56,2006-11-29 03:18:56
e6babbfe5f35dd972c185ff194c285df9e2e4a06...a1cd3c9f522760057ea3e9007d2b07ed340d745f,2,2,1,3,2,2006-11-29 16:44:10,2006-11-29 16:44:10
a1cd3c9f522760057ea3e9007d2b07ed340d745f...4a3ad338d67c2412fb4c0f7b44b7a5651a7ec1a6,3,57,2,59,6,2006-11-29 17:00:34,2006-11-29 17:00:34
4a3ad338d67c2412fb4c0f7b44b7a5651a7ec1a6...61c93842f483511f763054ddd16d4c2d39ef1819,2,11,1,12,3,2006-11-29 21:48:58,2006-11-29 21:48:58
61c93842f483511f763054ddd16d4c2d39ef1819...d506b90163feb4780d358c657804db446bc60780,1,1,1,2,1,2006-11-29 22:51:24,2006-11-29 22:51:24
d506b90163feb4780d358c657804db446bc60780...4dca65cdfc1e206fac323bd8afae9ae1fccc9dac,2,15,3,18,6,2006-11-30 03:58:25,2006-11-30 03:58:25
4dca65cdfc1e206fac323bd8afae9ae1fccc9dac...e130031fd2e1fa6946e56c73efab0c3ac67ebaea,3,74,8,82,6,2006-11-30 17:07:40,2006-11-30 17:07:40
e130031fd2e1fa6946e56c73efab0c3ac67ebaea...89d1270e51e0a04f162f6ba9ff955859f17d1bae,1,35,0,35,3,2006-11-30 17:48:54,2006-11-30 17:48:54
89d1270e51e0a04f162f6ba9ff955859f17d1bae...468993d13e53a5bdeb9ae387a3b064a762006a2d,2,104,66,170,27,2006-11-30 22:06:08,2006-11-30 22:06:08
468993d13e53a5bdeb9ae387a3b064a762006a2d...8925843d7ea7fd83f128264ce513bec0ea9aa3e9,1,1,1,2,1,2006-12-01 07:07:18,2006-12-01 07:07:18
8925843d7ea7fd83f128264ce513bec0ea9aa3e9...460ccfc04547decb2ebaf6cbf6a067b44a439ec4,1,13,13,26,11,2006-12-05 18:48:49,2006-12-05 18:48:49
460ccfc04547decb2ebaf6cbf6a067b44a439ec4...be217bce53f4449708e20e2b71d9c8c4bf5b81eb,2,19,5,24,8,2006-12-05 19:48:46,2006-12-05 19:48:46
be217bce53f4449708e20e2b71d9c8c4bf5b81eb...a794acbd7a50076d060e8867fcc2c9a5ff611805,1,1,1,2,1,2006-12-05 19:55:51,2006-12-05 19:55:51
a794acbd7a50076d060e8867fcc2c9a5ff611805...6c0219cf72dc8525284bde509cfac95d546f9783,3,22,13,35,13,2006-12-05 20:08:27,2006-12-05 20:08:27
6c0219cf72dc8525284bde509cfac95d546f9783...311fadeee016177d6f85d3988ad4bb9dc675349e,5,228,0,228,4,2006-12-05 20:51:25,2006-12-05 20:51:25
311fadeee016177d6f85d3988ad4bb9dc675349e...c7345f4e0f9ab47536c354dedf501c2b2f3f00e7,1,1,1,2,1,2006-12-06 06:23:59,2006-12-06 06:23:59
c7345f4e0f9ab47536c354dedf501c2b2f3f00e7...e6d19257bac486583aec5ba502eccd1f8ae8d9f5,1,16,15,31,16,2006-12-06 06:37:32,2006-12-06 06:37:32
e6d19257bac486583aec5ba502eccd1f8ae8d9f5...e5de9997e6aecd56066ef7c40016ecf8741a4eb7,1,1,1,2,1,2006-12-06 06:43:46,2006-12-06 06:43:46
e5de9997e6aecd56066ef7c40016ecf8741a4eb7...625ae4ef9353977cf2d738893e8f98f2a78be2bc,1,70,0,70,1,2006-12-06 17:36:48,2006-12-06 17:36:48
625ae4ef9353977cf2d738893e8f98f2a78be2bc...939ee97d4df4589a59d6c6614e86fa3285b456a2,1,1,1,2,1,2006-12-07 00:02:02,2006-12-07 00:02:02
939ee97d4df4589a59d6c6614e86fa3285b456a2...b6a7afd4bd481100d52b2bfee8b433b47e0b60bf,1,2,0,2,1,2006-12-07 03:04:22,2006-12-07 03:04:22
b6a7afd4bd481100d52b2bfee8b433b47e0b60bf...9a02d668c1066a313f973ca80b204fce9eb1a252,1,7,6,13,4,2006-12-07 04:59:36,2006-12-07 04:59:36
9a02d668c1066a313f973ca80b204fce9eb1a252...558e07a9bc8b234a3392948a9d95798bd8a156e6,1,1,4,5,1,2006-12-07 05:19:01,2006-12-07 05:19:01
558e07a9bc8b234a3392948a9d95798bd8a156e6...12e9a84429b2719b00f4eb17d5b80d2c8f19812c,2,18,17,35,15,2006-12-07 05:35:39,2006-12-07 05:35:39
12e9a84429b2719b00f4eb17d5b80d2c8f19812c...88f1dd31b7054b905768e1e7121fc3c14e9c5343,1,2,2,4,2,2006-12-07 05:45:22,2006-12-07 05:45:22
88f1dd31b7054b905768e1e7121fc3c14e9c5343...300f26defffcfa7b474823b3272c378f6a8af043,2,26,9,35,8,2006-12-07 06:06:58,2006-12-07 06:06:58
300f26defffcfa7b474823b3272c378f6a8af043...3d1ceab1aa894d522af614b1a2f6f77e4b4571a6,1,1,1,2,1,2006-12-07 06:10:31,2006-12-07 06:10:31
3d1ceab1aa894d522af614b1a2f6f77e4b4571a6...44add112e554d9eb5a66ad4b118501a0cac9ffc1,2,16,12,28,8,2006-12-07 06:17:06,2006-12-07 06:17:06
44add112e554d9eb5a66ad4b118501a0cac9ffc1...7e269bd390c9c4963bdce6522a8fafe6a618a5b1,2,72,7,79,12,2006-12-07 06:34:37,2006-12-07 06:34:37
7e269bd390c9c4963bdce6522a8fafe6a618a5b1...b4a67359a34c77e2e40f1ab8e30b96278a063007,1,22,58,80,7,2006-12-07 06:59:07,2006-12-07 06:59:07
b4a67359a34c77e2e40f1ab8e30b96278a063007...201704be3d04fe8acf0779b129eff09e35681f97,1,7,7,14,6,2006-12-07 15:09:24,2006-12-07 15:09:24
201704be3d04fe8acf0779b129eff09e35681f97...545ebf4395f24438c6ddc847f0794bfc83c6e934,1,1,1,2,1,2006-12-07 15:14:35,2006-12-07 15:14:35
545ebf4395f24438c6ddc847f0794bfc83c6e934...c50d333c23a3c53d05623ce15df79e624c57f37c,1,6,10,16,4,2006-12-07 15:49:05,2006-12-07 15:49:05
c50d333c23a3c53d05623ce15df79e624c57f37c...5f36d9d562a7f78befbb045d529081995ba3097a,1,9,2,11,4,2006-12-07 16:19:37,2006-12-07 16:19:37
5f36d9d562a7f78befbb045d529081995ba3097a...4e72dc86ff30b2e551b0891ac6dbf23f032a4bf8,2,9,1,10,2,2006-12-08 05:54:14,2006-12-08 05:54:14
4e72dc86ff30b2e551b0891ac6dbf23f032a4bf8...f10a9105774d95376008d9b91dfe55ba11f0971d,2,59,14,73,19,2006-12-08 18:54:53,2006-12-08 18:54:53
f10a9105774d95376008d9b91dfe55ba11f0971d...d93021eb10b1ff8c49a4f4746789c22589886260,3,50,35,85,25,2006-12-08 20:06:12,2006-12-08 20:06:12
d93021eb10b1ff8c49a4f4746789c22589886260...08ba8e841bde2f1b963a54e6a7b88281e2b7de7c,1,51,2,53,3,2006-12-11 00:44:02,2006-12-11 00:44:02
08ba8e841bde2f1b963a54e6a7b88281e2b7de7c...5c8d789efee7278432cd58f467360274de23bf5d,1,18,18,36,6,2006-12-11 01:24:33,2006-12-11 01:24:33
5c8d789efee7278432cd58f467360274de23bf5d...05588b379748888161dbc4486ec076eb3c53b66a,2,93,93,186,72,2006-12-11 02:38:18,2006-12-11 02:38:18
05588b379748888161dbc4486ec076eb3c53b66a...5467c34b0bad006ae49265d2ca417e9807ec2a8d,1,214,7,221,6,2006-12-11 03:03:54,2006-12-11 03:03:54
5467c34b0bad006ae49265d2ca417e9807ec2a8d...faaec9c28f15695c47660a6b2bf99483fc3bccd1,2,98,3,101,6,2006-12-12 05:55:39,2006-12-12 05:55:39
faaec9c28f15695c47660a6b2bf99483fc3bccd1...49f6d06c2f25467b844d01c206e218550ac1a4bb,1,4,1,5,2,2006-12-13 06:07:15,2006-12-13 06:07:15
49f6d06c2f25467b844d01c206e218550ac1a4bb...4add4e4272a05a8c9773f8a450d1f15b4fdf4b63,3,27,1,28,6,2006-12-13 06:26:04,2006-12-13 06:26:04
4add4e4272a05a8c9773f8a450d1f15b4fdf4b63...6733c3980444a793c115a43ed6602b45fc615983,2,62,62,124,25,2006-12-13 06:44:57,2006-12-13 06:44:57
6733c3980444a793c115a43ed6602b45fc615983...10edce12fc05fb31610f1ee4a372cd7c0b388533,1,21,21,42,6,2006-12-13 06:48:57,2006-12-13 06:48:57
10edce12fc05fb31610f1ee4a372cd7c0b388533...d8a21981b70770e536236acfbc4c87f48b587661,2,44,12,56,10,2006-12-13 23:03:19,2006-12-13 23:03:19
d8a21981b70770e536236acfbc4c87f48b587661...472a0d379e40bd8dd920210b1f95a2169c91ffca,1,9,0,9,1,2006-12-13 23:13:01,2006-12-13 23:13:01
472a0d379e40bd8dd920210b1f95a2169c91ffca...ad7d92ddf9817ffce326320b3b12f6a135d3ff1e,1,1,1,2,1,2006-12-14 04:09:18,2006-12-14 04:09:18
ad7d92ddf9817ffce326320b3b12f6a135d3ff1e...fc11b97e97517fb70d36afd221cfaf702b4664e0,2,67,0,67,3,2006-12-14 20:35:32,2006-12-14 20:35:32
fc11b97e97517fb70d36afd221cfaf702b4664e0...74a74f3766f4209cf07bea52877d5465490cf816,1,58,16,74,11,2006-12-14 21:02:30,2006-12-14 21:02:30
74a74f3766f4209cf07bea52877d5465490cf816...0a7d8b18ff844edad75ac3b21fb89e479db4705a,1,14,4,18,2,2006-12-15 05:35:19,2006-12-15 05:35:19
0a7d8b18ff844edad75ac3b21fb89e479db4705a...6001974e4501d7d8a7fcdfb11776bfb81d024754,4,61,5,66,6,2006-12-15 05:46:11,2006-12-15 05:46:11
6001974e4501d7d8a7fcdfb11776bfb81d024754...cfb1c5feffae0856b896e7e06553465dfcc41b41,1,22,17,39,16,2006-12-15 06:06:52,2006-12-15 06:06:52
cfb1c5feffae0856b896e7e06553465dfcc41b41...06a5370e6afbee124d1761d5b08cd7aa8378ade4,2,2,2,4,2,2006-12-15 15:56:42,2006-12-15 15:56:42
06a5370e6afbee124d1761d5b08cd7aa8378ade4...706fcec16409c68d6989724379ba89f1658522b0,14,1128,108,1236,97,2006-12-15 18:00:50,2006-12-15 18:00:50
706fcec16409c68d6989724379ba89f1658522b0...1147a57d209f02efc98fef0e96b6cd683e5102ae,1,10,5,15,3,2006-12-15 18:07:20,2006-12-15 18:07:20
1147a57d209f02efc98fef0e96b6cd683e5102ae...1c4ed6126baa8856056867b1db09b52066627fe8,1,2,2,4,3,2006-12-15 18:15:55,2006-12-15 18:15:55
1c4ed6126baa8856056867b1db09b52066627fe8...35f7e33b4a4965920b86b27c0010d97fe05e4973,2,34,9,43,15,2006-12-15 18:32:42,2006-12-15 18:32:42
35f7e33b4a4965920b86b27c0010d97fe05e4973...5efb9272e2490bd27d448447e8a750cbcfd3e7ae,1,21,10,31,2,2006-12-15 19:05:57,2006-12-15 19:05:57
5efb9272e2490bd27d448447e8a750cbcfd3e7ae...5cb093b033da3e4548142c2079431a4ac388532f,3,15,4,19,6,2006-12-15 21:22:13,2006-12-15 21:22:13
5cb093b033da3e4548142c2079431a4ac388532f...a23e67bf4b0a3dc1e95bcff43ea92b3e7d987383,1,1,1,2,1,2006-12-15 22:32:16,2006-12-15 22:32:16
a23e67bf4b0a3dc1e95bcff43ea92b3e7d987383...4f5170bffe8ca6ce8da0f68c4834066b0c766b43,2,67,1,68,5,2006-12-15 22:33:24,2006-12-15 22:33:24
4f5170bffe8ca6ce8da0f68c4834066b0c766b43...26489d4e2aa2a5d06b228643dfc232c05bb47872,2,16,1,17,3,2006-12-15 23:07:41,2006-12-15 23:07:41
26489d4e2aa2a5d06b228643dfc232c05bb47872...546297be27839f4ed3d627ff8fde04ee41d1667d,2,75,1,76,4,2006-12-15 23:18:47,2006-12-15 23:18:47
546297be27839f4ed3d627ff8fde04ee41d1667d...e76e2aaffb407086544b015a81c33e6e5bb3558f,2,3,1,4,2,2006-12-17 05:11:48,2006-12-17 05:11:48
e76e2aaffb407086544b015a81c33e6e5bb3558f...a0ef6f691551b3f1bf5db6535488c36e01da9819,2,18,4,22,4,2006-12-17 05:12:53,2006-12-17 05:12:53
a0ef6f691551b3f1bf5db6535488c36e01da9819...94edd4b81fdbba1b15f86e9327d24c80c9df7e50,2,4,3,7,2,2006-12-17 14:17:11,2006-12-17 14:17:11
94edd4b81fdbba1b15f86e9327d24c80c9df7e50...bce9f65c61df98e6d902bb203d1248c7926217d5,1,1,0,1,1,2006-12-17 14:21:56,2006-12-17 14:21:56
bce9f65c61df98e6d902bb203d1248c7926217d5...cd394a246aa32e5ce15b0643203b7bfdeb703eb6,2,10,0,10,2,2006-12-17 19:04:03,2006-12-17 19:04:03
cd394a246aa32e5ce15b0643203b7bfdeb703eb6...8103b7dfadb8d13cd64eab31e47b9a216f678152,1,19,18,37,12,2006-12-18 03:59:45,2006-12-18 03:59:45
8103b7dfadb8d13cd64eab31e47b9a216f678152...d9ce900e13077d47f8ca43064e904a38f7f1787e,1,1,1,2,1,2006-12-18 15:37:52,2006-12-18 15:37:52
d9ce900e13077d47f8ca43064e904a38f7f1787e...3f4d6a2ddae34bc436377c3307f2d2063f9de309,1,2,2,4,2,2006-12-18 16:16:12,2006-12-18 16:16:12
3f4d6a2ddae34bc436377c3307f2d2063f9de309...3a54d0cd5b2868771bdeabd17998d72084e0338e,1,9,6,15,7,2006-12-19 03:38:38,2006-12-19 03:38:38
3a54d0cd5b2868771bdeabd17998d72084e0338e...b3d1ce68ea0a2a99f5b1f106f3fdabc565577c6c,1,2,2,4,2,2006-12-19 04:37:03,2006-12-19 04:37:03
b3d1ce68ea0a2a99f5b1f106f3fdabc565577c6c...069a8858baa6a6b687e67312ffdbcdfc55cee4b7,3,8,1,9,5,2006-12-20 05:00:36,2006-12-20 05:00:36
069a8858baa6a6b687e67312ffdbcdfc55cee4b7...2d6095ea5e0d7c7cd8be16b02d17b5018642e3c2,2,4,6,10,4,2006-12-20 09:59:03,2006-12-20 09:59:03
2d6095ea5e0d7c7cd8be16b02d17b5018642e3c2...e859f108f160ede64d07d248e60a70233b4b4132,2,33,19,52,2,2006-12-20 13:57:17,2006-12-20 13:57:17
e859f108f160ede64d07d248e60a70233b4b4132...64a2718f6c7d0c434478b8a09a142d925a0741b3,1,18,10,28,2,2006-12-20 14:06:27,2006-12-20 14:06:27
64a2718f6c7d0c434478b8a09a142d925a0741b3...f6fd5827aa14c26a96a91727b900135bd24aced1,1,1,1008,1009,1,2006-12-22 01:44:34,2006-12-22 01:44:34
f6fd5827aa14c26a96a91727b900135bd24aced1...3d9b12b2d893fb36a0e965519e7e9b4ed7e28c13,2,8,6,14,4,2006-12-24 03:36:49,2006-12-24 03:36:49
3d9b12b2d893fb36a0e965519e7e9b4ed7e28c13...86870e758709bd5c9e9fb357d641f0cefd983db0,3,195,0,195,3,2006-12-24 20:22:38,2006-12-24 20:22:38
86870e758709bd5c9e9fb357d641f0cefd983db0...a5d3e0c3ef8975bfc8ab5bd4c13c27edab43b86b,1,4,1,5,1,2006-12-26 14:40:33,2006-12-26 14:40:33
a5d3e0c3ef8975bfc8ab5bd4c13c27edab43b86b...247fdc19ad256c7599f043aa49d3125d3a1f4356,2,23,0,23,2,2006-12-26 22:56:53,2006-12-26 22:56:53
247fdc19ad256c7599f043aa49d3125d3a1f4356...30c2bffe17c46a1f599b3e5cf0bfcfd164f203fc,2,11,21,32,5,2006-12-26 23:16:16,2006-12-26 23:16:16
30c2bffe17c46a1f599b3e5cf0bfcfd164f203fc...d0fcef9db0f53ef84535694f4fbcb135f0648e24,2,33,2,35,3,2006-12-26 23:33:20,2006-12-26 23:33:20
d0fcef9db0f53ef84535694f4fbcb135f0648e24...b5cd7d469d580133bd135b2d0f8ad41d342f6e07,2,61,6,67,10,2006-12-26 23:46:10,2006-12-26 23:46:10
b5cd7d469d580133bd135b2d0f8ad41d342f6e07...550781d9ab07302ec886e677bc628e78459fa267,1,0,2,2,2,2006-12-27 04:23:40,2006-12-27 04:23:40
550781d9ab07302ec886e677bc628e78459fa267...252606c711c644d427edf1a5a079d1029f1c6621,1,33,0,33,2,2006-12-27 05:14:02,2006-12-27 05:14:02
252606c711c644d427edf1a5a079d1029f1c6621...99723ac65a5471a619fc1a668391ee818cc1437d,1,8,4,12,3,2006-12-27 05:14:34,2006-12-27 05:14:34
99723ac65a5471a619fc1a668391ee818cc1437d...d853278253b5efa60a691ae9b83fb6352d2a91f0,2,17,0,17,4,2006-12-27 05:15:22,2006-12-27 05:15:22
d853278253b5efa60a691ae9b83fb6352d2a91f0...6a75c8a52ef01c680677c13cefb08a9ccbe38562,2,24,2,26,6,2006-12-27 05:23:21,2006-12-27 05:23:21
6a75c8a52ef01c680677c13cefb08a9ccbe38562...016d75cc7fab107e8116211b5091d781a3bf0d24,1,3,0,3,1,2006-12-27 05:27:47,2006-12-27 05:27:47
016d75cc7fab107e8116211b5091d781a3bf0d24...2cb0fe71a2131a4b9e61b6da98888051bfad58b1,3,87,26,113,22,2006-12-28 00:01:52,2006-12-28 00:01:52
2cb0fe71a2131a4b9e61b6da98888051bfad58b1...71ce11f617cc56024300b4fa968af345329c8ecd,4,59,30,89,21,2006-12-28 01:16:29,2006-12-28 01:16:29
71ce11f617cc56024300b4fa968af345329c8ecd...f974b1bb5af7fe21de71f223a43ee1c0cdcf8f8f,1,1,1,2,1,2006-12-28 02:20:29,2006-12-28 02:20:29
f974b1bb5af7fe21de71f223a43ee1c0cdcf8f8f...34dce706ee9ac30d950d95e1647aadbed2a70921,2,8,0,8,2,2006-12-28 02:27:14,2006-12-28 02:27:14
34dce706ee9ac30d950d95e1647aadbed2a70921...bcb7a31b2c6ca26906298725cc830bbfb0c4b383,2,54,6,60,7,2006-12-28 02:34:53,2006-12-28 02:34:53
bcb7a31b2c6ca26906298725cc830bbfb0c4b383...d681b084c30c2cfcf012d42f1a211ea5d719f3c8,1,1,1,2,1,2006-12-29 19:01:29,2006-12-29 19:01:29
d681b084c30c2cfcf012d42f1a211ea5d719f3c8...b9eb64949200aba47cad7dfb58be12e2554aff9c,1,36,4,40,4,2006-12-29 19:32:28,2006-12-29 19:32:28
b9eb64949200aba47cad7dfb58be12e2554aff9c...3dbaf60b865e98b84f0cbd8c104715774cdc1cf5,1,8,4,12,4,2006-12-29 19:42:56,2006-12-29 19:42:56
3dbaf60b865e98b84f0cbd8c104715774cdc1cf5...0919920bc0cf981da471717ce7000cfc9dabb077,1,1,0,1,1,2006-12-30 00:06:28,2006-12-30 00:06:28
0919920bc0cf981da471717ce7000cfc9dabb077...b9fdf9abb841f1eda11fb4d8094372dbbbeb58cb,2,31,2,33,6,2006-12-30 00:12:02,2006-12-30 00:12:02
b9fdf9abb841f1eda11fb4d8094372dbbbeb58cb...08f3969d5eb0e87094fe44a877634251285fed59,1,4,0,4,1,2006-12-30 00:39:41,2006-12-30 00:39:41
08f3969d5eb0e87094fe44a877634251285fed59...5a01f848cab3acecf7be93848d935537b8dcfb0e,1,9,1,10,2,2006-12-30 06:14:39,2006-12-30 06:14:39
5a01f848cab3acecf7be93848d935537b8dcfb0e...911f0cdf180a714314d968113844a32d94581829,1,8,1,9,2,2006-12-30 06:17:21,2006-12-30 06:17:21
911f0cdf180a714314d968113844a32d94581829...3abf868211b1c9bd77eaf3b55abdb74b4668f3b6,0,0,0,0,0,2006-12-30 06:25:49,2006-12-30 06:25:49
3abf868211b1c9bd77eaf3b55abdb74b4668f3b6...71802073283847f5582df4eea1e4fdb5b37eca4f,5,105,3,108,8,2006-12-30 07:16:25,2006-12-30 07:16:25
71802073283847f5582df4eea1e4fdb5b37eca4f...f21cbb40b2521da1195d1a2aa5910281efb32b7f,2,6,3,9,2,2006-12-30 07:21:01,2006-12-30 07:21:01
f21cbb40b2521da1195d1a2aa5910281efb32b7f...fcdbb929183eacc18cfe9ab8af498aa120fc24b0,1,17,0,17,1,2006-12-30 07:30:00,2006-12-30 07:30:00
fcdbb929183eacc18cfe9ab8af498aa120fc24b0...d04a2e792c91016f1290754ff01af5f67917fcf1,1,2,2,4,1,2006-12-30 07:48:11,2006-12-30 07:48:11
d04a2e792c91016f1290754ff01af5f67917fcf1...8701cde8db92832dfbef9fffa4be3a974a25adea,1,2,0,2,1,2007-01-02 20:39:30,2007-01-02 20:39:30
8701cde8db92832dfbef9fffa4be3a974a25adea...eecd90f5c236eae02adc6a79c897035322b78746,1,3,3,6,5,2007-01-03 03:58:11,2007-01-03 03:58:11
eecd90f5c236eae02adc6a79c897035322b78746...9e0c5d1ecdd5b57b8e044230b09d7903835e6116,3,338,0,338,2,2007-01-03 04:14:17,2007-01-03 04:14:17
9e0c5d1ecdd5b57b8e044230b09d7903835e6116...c3f891210a05a9593e3df4cb04dfda7442af2065,4,65,8,73,9,2007-01-03 05:29:34,2007-01-03 05:29:34
c3f891210a05a9593e3df4cb04dfda7442af2065...e1c6e987d07efb3ee9471e63541f9561b461ea44,5,139,4,143,7,2007-01-03 14:16:58,2007-01-03 14:16:58
e1c6e987d07efb3ee9471e63541f9561b461ea44...3d38e5d8406eba16615ccdda32c346676e26f1ff,1,1,1,2,1,2007-01-03 14:29:21,2007-01-03 14:29:21
3d38e5d8406eba16615ccdda32c346676e26f1ff...da9affa8f820d8d3043379a8707511ecaaf11cf0,2,75,9,84,8,2007-01-03 22:37:05,2007-01-03 22:37:05
da9affa8f820d8d3043379a8707511ecaaf11cf0...023b863251d205ea66096e515e36e9f5dc204487,1,6,72,78,6,2007-01-03 22:38:51,2007-01-03 22:38:51
023b863251d205ea66096e515e36e9f5dc204487...295f4c9fadfda790215921616b90ad5143aef771,1,4,3,7,1,2007-01-03 22:40:06,2007-01-03 22:40:06
295f4c9fadfda790215921616b90ad5143aef771...ddb9b7d57a1da6b8715a62376cbb8605e6b2351b,2,24,1,25,2,2007-01-04 04:00:16,2007-01-04 04:00:16
ddb9b7d57a1da6b8715a62376cbb8605e6b2351b...b1f6b376c0593171f2782472574384b121e65de0,2,13,5,18,7,2007-01-04 06:25:53,2007-01-04 06:25:53
b1f6b376c0593171f2782472574384b121e65de0...61ede43202aef10306dc70fa300f269bd3f4fe7f,1,47,1,48,2,2007-01-04 06:52:50,2007-01-04 06:52:50
61ede43202aef10306dc70fa300f269bd3f4fe7f...02f690f73838f59cb622031751fd75b82f728b2f,2,12,6,18,8,2007-01-05 00:04:38,2007-01-05 00:04:38
02f690f73838f59cb622031751fd75b82f728b2f...13184efb0f0b38426f635b9880d0a83dd120deea,1,152,22,174,10,2007-01-05 00:13:36,2007-01-05 00:13:36
13184efb0f0b38426f635b9880d0a83dd120deea...84b673e9b1e17b27c3003ca4cc14c90cda8274b3,1,319,104,423,23,2007-01-05 05:21:39,2007-01-05 05:21:39
84b673e9b1e17b27c3003ca4cc14c90cda8274b3...9d29892f5636cd2e938b70d9562f4ce55c9cba20,1,1,1,2,1,2007-01-05 05:22:36,2007-01-05 05:22:36
9d29892f5636cd2e938b70d9562f4ce55c9cba20...8a8d05a318343ce40f20b76d4e8629f1fa306d79,1,1,1,2,1,2007-01-05 12:32:55,2007-01-05 12:32:55
8a8d05a318343ce40f20b76d4e8629f1fa306d79...9cb85eb370dba6d4c73fabf68d913f37e46724e4,1,5,5,10,4,2007-01-05 20:14:26,2007-01-05 20:14:26
9cb85eb370dba6d4c73fabf68d913f37e46724e4...6ee9aeb0d6d086f0e5e54667a3405f75fb1196f7,1,5,0,5,1,2007-01-05 22:15:46,2007-01-05 22:15:46
6ee9aeb0d6d086f0e5e54667a3405f75fb1196f7...3b4d6b4dc1afd0bc7d7b589051d2379a0535840b,1,1,1,2,1,2007-01-06 00:08:55,2007-01-06 00:08:55
3b4d6b4dc1afd0bc7d7b589051d2379a0535840b...0421b2597f35e421245c689ac8f1c7f1a455dd6b,1,9,6,15,4,2007-01-08 18:06:22,2007-01-08 18:06:22
0421b2597f35e421245c689ac8f1c7f1a455dd6b...f6390e8983dd364053078cc80361cb369b667690,6,6,7,13,9,2007-01-08 20:28:31,2007-01-08 20:28:31
f6390e8983dd364053078cc80361cb369b667690...54b8277ffb4cad90fb65ca4edf69d8279b8df898,1,1,1,2,1,2007-01-09 03:37:22,2007-01-09 03:37:22
54b8277ffb4cad90fb65ca4edf69d8279b8df898...2e148d70647bfab640ab395fc98ba9492d061dad,3,105,2,107,5,2007-01-09 04:39:44,2007-01-09 04:39:44
2e148d70647bfab640ab395fc98ba9492d061dad...fb60a6ff0acc84417ced061e83bb170fff351b59,4,31,5,36,9,2007-01-09 05:12:25,2007-01-09 05:12:25
fb60a6ff0acc84417ced061e83bb170fff351b59...d08112a6a76891033d705bec9422f95bd1f391d6,2,28,27,55,20,2007-01-09 05:22:48,2007-01-09 05:22:48
d08112a6a76891033d705bec9422f95bd1f391d6...78b89ff11841c727a4738e7cbfacfb59ad9964fb,2,51,22,73,9,2007-01-09 05:49:47,2007-01-09 05:49:47
78b89ff11841c727a4738e7cbfacfb59ad9964fb...3f6fd5dfd126aca52be1d9c4e7d6678084b41a8b,1,2,2,4,2,2007-01-10 19:55:44,2007-01-10 19:55:44
3f6fd5dfd126aca52be1d9c4e7d6678084b41a8b...2144a2c23ff84a9c9025a07e13cad6986c000955,1,1,1,2,1,2007-01-10 22:34:37,2007-01-10 22:34:37
2144a2c23ff84a9c9025a07e13cad6986c000955...f6a7002ef16b3c7ca62c0b44013d9274c0842094,2,4,4,8,4,2007-01-10 22:46:06,2007-01-10 22:46:06
f6a7002ef16b3c7ca62c0b44013d9274c0842094...fa38ce720767c65847290a497599338a9659d9ca,2,8,3,11,4,2007-01-10 23:25:29,2007-01-10 23:25:29
fa38ce720767c65847290a497599338a9659d9ca...963ccd7cb4c923a70dfcf4b321fa74a099c69948,2,11,4,15,9,2007-01-10 23:34:37,2007-01-10 23:34:37
963ccd7cb4c923a70dfcf4b321fa74a099c69948...73d62743e9cc27f09a5e30bcf7b0dbe64d6108de,2,29,0,29,2,2007-01-11 00:04:27,2007-01-11 00:04:27
73d62743e9cc27f09a5e30bcf7b0dbe64d6108de...b118b28bac483133d08eeee5ebc791eb527249c6,1,10,4,14,2,2007-01-12 15:15:05,2007-01-12 15:15:05
b118b28bac483133d08eeee5ebc791eb527249c6...c1b11091e7f7859b66cc1d72fbce712c22c2ad0a,1,3,3,6,2,2007-01-12 15:16:55,2007-01-12 15:16:55
c1b11091e7f7859b66cc1d72fbce712c22c2ad0a...43193c18213de725f0f957ab21518baad7d9bdd6,2,29,3,32,5,2007-01-12 19:40:06,2007-01-12 19:40:06
43193c18213de725f0f957ab21518baad7d9bdd6...663ef14f02e459d116bcf0e562ba8526c7d49fcf,1,40,0,40,1,2007-01-13 04:43:34,2007-01-13 04:43:34
663ef14f02e459d116bcf0e562ba8526c7d49fcf...a0137c41f3b9b95d48f42ddd0fb48703a88a8c94,2,21,2,23,4,2007-01-13 04:51:57,2007-01-13 04:51:57
a0137c41f3b9b95d48f42ddd0fb48703a88a8c94...6b31f95516e3a65f93a9ab6491c6e3b2b54ae620,2,6,4,10,4,2007-01-13 05:08:07,2007-01-13 05:08:07
6b31f95516e3a65f93a9ab6491c6e3b2b54ae620...f2a3deb0871c6cdbe04e1e0b36f4984c7c825bac,2,7,0,7,2,2007-01-13 05:19:15,2007-01-13 05:19:15
88029f770010b96bb4a50de038a125be3104d09d...98fb26101cbc4ed27c1522790f182710d687bf20,0,0,0,0,0,2006-11-04 17:59:07,2006-11-04 17:59:07
98fb26101cbc4ed27c1522790f182710d687bf20...5e8d740caaa35a05711d15a37b166faddb255b43,7,177,31,208,36,2006-11-04 18:07:10,2006-11-04 18:07:10
5e8d740caaa35a05711d15a37b166faddb255b43...f70998c1b847940076a425df2f4503e432c0293d,1,13,13,26,6,2006-11-04 18:38:39,2006-11-04 18:38:39
f70998c1b847940076a425df2f4503e432c0293d...3504a58b91f8bf93ab2295d35aa97da68e057c8b,1,2,11,13,2,2006-11-04 18:47:59,2006-11-04 18:47:59
3504a58b91f8bf93ab2295d35aa97da68e057c8b...1f8e225d6676fc5180a5863fab168e00e51ba293,1,24,24,48,1,2006-11-04 20:06:23,2006-11-04 20:06:23
1f8e225d6676fc5180a5863fab168e00e51ba293...28c88718769521990a7418750925a94ef94fbf36,1,1,1,2,1,2006-11-04 20:12:23,2006-11-04 20:12:23
28c88718769521990a7418750925a94ef94fbf36...23246ebd0975f55319148e7ddcbad6e43b2842ba,7,0,0,0,0,2006-11-04 20:14:39,2006-11-04 20:14:39
23246ebd0975f55319148e7ddcbad6e43b2842ba...6ab11188d5714a0330bb9ad5011fd5dfbbf1ff54,1,11,0,11,2,2006-11-04 20:18:55,2006-11-04 20:18:55
6ab11188d5714a0330bb9ad5011fd5dfbbf1ff54...c7b4311864dfa91e03306afb7d8c2f31536b161e,1,1,1,2,1,2006-11-04 20:24:01,2006-11-04 20:24:01
c7b4311864dfa91e03306afb7d8c2f31536b161e...5da24765c99b5492c2d8709ae817c64947b28444,1,13,13,26,5,2006-11-04 20:39:19,2006-11-04 20:39:19
5da24765c99b5492c2d8709ae817c64947b28444...a642b4ada22a697b7c2715e818f0ffad1b40f247,6,18,0,18,6,2006-11-04 20:41:11,2006-11-04 20:41:11
a642b4ada22a697b7c2715e818f0ffad1b40f247...b543ef9bf1dd4950f348d902b50ab4a5b7af2380,1,22,27,49,9,2006-11-04 20:43:43,2006-11-04 20:43:43
b543ef9bf1dd4950f348d902b50ab4a5b7af2380...4d8a0482c6560fe062cdc8fb757a14bf942eb348,1,1,1,2,1,2006-11-04 20:47:07,2006-11-04 20:47:07
4d8a0482c6560fe062cdc8fb757a14bf942eb348...e5007b39421b5222dba9cad42bfcdd38f3b70720,1,1,1,2,1,2006-11-04 20:52:08,2006-11-04 20:52:08
e5007b39421b5222dba9cad42bfcdd38f3b70720...36d057c9024d457eed3175b19ca159d15b57fe34,1,1,1,2,1,2006-11-04 21:00:58,2006-11-04 21:00:58
36d057c9024d457eed3175b19ca159d15b57fe34...86b15c609c6e91a351abed7de657dad61ae52e30,7,7,0,7,7,2006-11-04 21:02:27,2006-11-04 21:02:27
86b15c609c6e91a351abed7de657dad61ae52e30...3db5a64a6c0fabb60ca04cddc37c11a84498d376,1,2,2,4,1,2006-11-04 21:03:10,2006-11-04 21:03:10
3db5a64a6c0fabb60ca04cddc37c11a84498d376...7a8965a3a180bc5db7421299fcd6ab92df6d017b,1,2,1,3,2,2006-11-04 21:05:35,2006-11-04 21:05:35
7a8965a3a180bc5db7421299fcd6ab92df6d017b...83f930332b7300486464e22dde0e698014f1c89c,1,11,1,12,3,2006-11-04 21:16:23,2006-11-04 21:16:23
83f930332b7300486464e22dde0e698014f1c89c...2141ee605fd1269ab187764c8dc53eabd8eea2f5,1,0,3,3,1,2006-11-04 21:18:20,2006-11-04 21:18:20
2141ee605fd1269ab187764c8dc53eabd8eea2f5...db70944e655222877739641e7749997f748dd083,1,1,1,2,1,2006-11-04 21:19:06,2006-11-04 21:19:06
db70944e655222877739641e7749997f748dd083...c36159c6d9e6d8009e24fc6d545982932b5e79e0,1,6,2,8,2,2006-11-04 21:20:15,2006-11-04 21:20:15
c36159c6d9e6d8009e24fc6d545982932b5e79e0...c5a75d206956bdf291cf0e5f0eb40a77b9d1316a,1,1,0,1,1,2006-11-04 21:28:47,2006-11-04 21:28:47
c5a75d206956bdf291cf0e5f0eb40a77b9d1316a...e715476a9f128bffa8b82b840ac4e2ab69b2ad78,1,14,6,20,8,2006-11-04 21:42:37,2006-11-04 21:42:37
e715476a9f128bffa8b82b840ac4e2ab69b2ad78...39fd198ddd8d0e6915dc713eeac5fef6f40b74ed,1,3,4,7,2,2006-11-04 22:19:44,2006-11-04 22:19:44
39fd198ddd8d0e6915dc713eeac5fef6f40b74ed...6131a839da6f15cf89b7b31efbd6c5adaf84738c,1,95,0,95,1,2006-11-04 22:38:49,2006-11-04 22:38:49
6131a839da6f15cf89b7b31efbd6c5adaf84738c...fcf3cd39ebdb039bc10b95dcbfc5203c9cb65fbf,1,3,3,6,3,2006-11-04 22:42:33,2006-11-04 22:42:33
fcf3cd39ebdb039bc10b95dcbfc5203c9cb65fbf...675f0df471545465891e608d9a493511869cab8a,1,2,0,2,1,2006-11-04 22:48:00,2006-11-04 22:48:00
675f0df471545465891e608d9a493511869cab8a...a7a47017b901a9ffbb19ff84ed4c1e9fb8c818c1,1,1,0,1,1,2006-11-04 22:49:57,2006-11-04 22:49:57
a7a47017b901a9ffbb19ff84ed4c1e9fb8c818c1...731e2e60cdf378b43ad0c5b76008e14482c6484d,1,2,0,2,2,2006-11-04 22:51:28,2006-11-04 22:51:28
731e2e60cdf378b43ad0c5b76008e14482c6484d...e93ca9f6bde577b18a9137b79a93765dd8f2304c,1,11,8,19,8,2006-11-04 22:53:18,2006-11-04 22:53:18
e93ca9f6bde577b18a9137b79a93765dd8f2304c...6c0c0bd331aa39f131343fbc205e69763c26eaf7,1,1,1,2,1,2006-11-04 22:54:31,2006-11-04 22:54:31
6c0c0bd331aa39f131343fbc205e69763c26eaf7...2651cf0c7cb1f6cd636dda05730a94ce7b8ea9e3,1,32,28,60,12,2006-11-04 23:19:03,2006-11-04 23:19:03
2651cf0c7cb1f6cd636dda05730a94ce7b8ea9e3...3e1197f82e4c0ba3c4f7a899d8f60a9ea731504f,1,11,3,14,1,2006-11-04 23:29:35,2006-11-04 23:29:35
3e1197f82e4c0ba3c4f7a899d8f60a9ea731504f...b93cd82297109efe2765dd03e8402fdc2c0cc156,2,20,1,21,4,2006-11-04 23:30:27,2006-11-04 23:30:27
b93cd82297109efe2765dd03e8402fdc2c0cc156...b8431e359b0b2d69cc028d1db4fcc620b4f21856,1,16,16,32,12,2006-11-04 23:34:18,2006-11-04 23:34:18
b8431e359b0b2d69cc028d1db4fcc620b4f21856...c4e56c225aac7ac602ab7a58387a5e8c169919c7,1,2,1,3,1,2006-11-04 23:38:39,2006-11-04 23:38:39
c4e56c225aac7ac602ab7a58387a5e8c169919c7...1898c6baa74e25deb8607570cd69e9bc0dbe2ee1,1,3,2,5,3,2006-11-04 23:42:31,2006-11-04 23:42:31
1898c6baa74e25deb8607570cd69e9bc0dbe2ee1...955424507b6b3160a83c5745f4b2f6f6c52192eb,1,38,3,41,3,2006-11-04 23:44:18,2006-11-04 23:44:18
955424507b6b3160a83c5745f4b2f6f6c52192eb...05024929cf720e03361be6b998a2acb7ec8453d9,1,17,21,38,15,2006-11-04 23:50:02,2006-11-04 23:50:02
05024929cf720e03361be6b998a2acb7ec8453d9...f412ebde1c147b43ed6df51ebe5bf15fdf46cd06,1,1,1,2,1,2006-11-04 23:53:08,2006-11-04 23:53:08
f412ebde1c147b43ed6df51ebe5bf15fdf46cd06...8b1f56d06be5bc94b43d429924bb497022ecafcb,1,48,2,50,3,2006-11-04 23:54:12,2006-11-04 23:54:12
8b1f56d06be5bc94b43d429924bb497022ecafcb...a12bdeb4453a1e50b759d10c3942a1d93253573b,1,19,16,35,6,2006-11-05 00:13:09,2006-11-05 00:13:09
a12bdeb4453a1e50b759d10c3942a1d93253573b...125cd04d2bea4887c485dc0d75c71b55098e19bf,1,4,2,6,3,2006-11-05 00:15:04,2006-11-05 00:15:04
125cd04d2bea4887c485dc0d75c71b55098e19bf...58f0b44c74ca3a340f715cadc9f3ffe88ce47108,1,4,2,6,3,2006-11-05 00:22:01,2006-11-05 00:22:01
58f0b44c74ca3a340f715cadc9f3ffe88ce47108...abd5b14d6fa88780730e5a82af4d121905f74fc7,1,4,2,6,3,2006-11-05 00:26:17,2006-11-05 00:26:17
abd5b14d6fa88780730e5a82af4d121905f74fc7...86b9b25fb381593069906874175cc8382ff4f9c0,1,1,1,2,1,2006-11-05 00:28:01,2006-11-05 00:28:01
86b9b25fb381593069906874175cc8382ff4f9c0...e72e04010253b7b24c241cdca35afaf5cb026279,1,2,2,4,2,2006-11-05 00:30:43,2006-11-05 00:30:43
e72e04010253b7b24c241cdca35afaf5cb026279...6267678653bb9f81bdc2705fc33192291dc50fea,1,1,1,2,1,2006-11-05 00:59:57,2006-11-05 00:59:57
6267678653bb9f81bdc2705fc33192291dc50fea...2245b599a71c7c6da5c5709d7d36f71082342a66,1,4,0,4,2,2006-11-05 01:02:13,2006-11-05 01:02:13
2245b599a71c7c6da5c5709d7d36f71082342a66...93bfe7f18e4ccb2c13d5ed14a0a71c5f0c94dd63,1,4,1,5,1,2006-11-05 01:22:06,2006-11-05 01:22:06
93bfe7f18e4ccb2c13d5ed14a0a71c5f0c94dd63...48507721aa383de5763dd435d03d0b2dadcc7c2c,1,1,1,2,1,2006-11-05 01:23:14,2006-11-05 01:23:14
48507721aa383de5763dd435d03d0b2dadcc7c2c...20a30ff32ced85ce1bb09abf792af5efc5fed89d,1,16,15,31,1,2006-11-05 01:28:59,2006-11-05 01:28:59
20a30ff32ced85ce1bb09abf792af5efc5fed89d...afcb877128ee5db84b002c66ac640c14e9ea3e08,4,23,24,47,19,2006-11-05 04:53:47,2006-11-05 04:53:47
afcb877128ee5db84b002c66ac640c14e9ea3e08...f2b6570db165ec5cf317f24082fd96629f11b5d4,1,1,1,2,1,2006-11-05 07:46:30,2006-11-05 07:46:30
f2b6570db165ec5cf317f24082fd96629f11b5d4...9acae362cf03ebb951a3b8ad3fd70c19b1990836,2,122,58,180,10,2006-11-05 18:01:25,2006-11-05 18:01:25
9acae362cf03ebb951a3b8ad3fd70c19b1990836...53222ce9a1a5e56b07286ab317392f41b9c792f1,2,51,23,74,12,2006-11-06 07:38:57,2006-11-06 07:38:57
53222ce9a1a5e56b07286ab317392f41b9c792f1...b47c350b56ec5a168641a6b330786fee95229eee,1,19,2,21,1,2006-11-06 16:22:02,2006-11-06 16:22:02
b47c350b56ec5a168641a6b330786fee95229eee...2ef60b546bbd40556e86ca63f4df8c43e246a9fe,7,125,106,231,38,2006-11-10 17:16:45,2006-11-10 17:16:45
2ef60b546bbd40556e86ca63f4df8c43e246a9fe...19773e0d709d4818f59e3e191300c8ed9ea6128e,41,718,275,993,254,2006-11-13 00:25:50,2006-11-13 00:25:50
19773e0d709d4818f59e3e191300c8ed9ea6128e...525f81d091514d286debbf02c8efb678c8ffbcb8,5,84,73,157,46,2006-11-16 16:25:59,2006-11-16 16:25:59
525f81d091514d286debbf02c8efb678c8ffbcb8...cd2866a36482f2679388df0dadbdd98c91529fe0,2,9,13,22,8,2006-11-16 18:11:06,2006-11-16 18:11:06
cd2866a36482f2679388df0dadbdd98c91529fe0...fb3a93975fe07c6589fa371971b873ab268689ef,2,8,5,13,6,2006-11-16 19:11:32,2006-11-16 19:11:32
fb3a93975fe07c6589fa371971b873ab268689ef...e146dd75d94a944009d4a1639906b7ae424be448,1,11,2,13,4,2006-11-16 21:30:37,2006-11-16 21:30:37
e146dd75d94a944009d4a1639906b7ae424be448...1b0d6b942c39bf0f5105be2d47e6e844e43a2659,8,108,74,182,38,2006-11-17 06:20:35,2006-11-17 06:20:35
1b0d6b942c39bf0f5105be2d47e6e844e43a2659...8154294a0fb0134a13676642d13e525901d6bc97,16,847,442,1289,394,2006-11-17 06:47:43,2006-11-17 06:47:43
8154294a0fb0134a13676642d13e525901d6bc97...677aa10cdf376286f694edb2263d269dbd3269c5,8,9,7,16,8,2006-11-17 06:58:45,2006-11-17 06:58:45
677aa10cdf376286f694edb2263d269dbd3269c5...174463e62c732b33842e454f9763c5b066fc5af4,3,17,10,27,3,2006-11-17 19:06:22,2006-11-17 19:06:22
174463e62c732b33842e454f9763c5b066fc5af4...93d83df61195ea598bc0a2a5cdce1df8e88fcb6d,56,3472,437,3909,350,2006-12-15 18:32:47,2006-12-15 18:32:47
93d83df61195ea598bc0a2a5cdce1df8e88fcb6d...f4aa4933226a78d04cdbfda9119e64212a80e5b7,2,7,37,44,5,2006-12-18 17:36:01,2006-12-18 17:36:01
f4aa4933226a78d04cdbfda9119e64212a80e5b7...58ba520f32821140c96725b1f68ff31d64751844,29,950,1172,2122,131,2006-12-28 17:17:52,2006-12-28 17:17:52
58ba520f32821140c96725b1f68ff31d64751844...68aaa5df72ba3002f822e97f986e049d8a86613c,1,10,0,10,1,2007-01-03 19:17:58,2007-01-03 19:17:58
68aaa5df72ba3002f822e97f986e049d8a86613c...499bfc1f4a8dd6eb99f1c171bd8ef1c252fad0c5,1,215,55,270,25,2007-01-03 20:23:07,2007-01-03 20:23:07
499bfc1f4a8dd6eb99f1c171bd8ef1c252fad0c5...92b7851424069336f76112932682c77a6a1e3cb9,28,776,37,813,58,2007-01-03 20:46:26,2007-01-03 20:46:26
92b7851424069336f76112932682c77a6a1e3cb9...e17f75551491f5b864c1fc8a97c21d0b2bbf0bcd,78,2388,591,2979,459,2007-02-02 17:35:55,2007-02-02 17:35:55
e17f75551491f5b864c1fc8a97c21d0b2bbf0bcd...0b7dd14d1f87e2ecef7aacc39fe4189667ed4fdf,190,26043,8226,34269,3278,2007-03-09 17:43:46,2007-03-09 17:43:46
0b7dd14d1f87e2ecef7aacc39fe4189667ed4fdf...ebe27acd14c4353e5a3b94eb9d9c678ea142d794,2,41,8,49,4,2007-03-13 15:33:37,2007-03-13 15:33:37
ebe27acd14c4353e5a3b94eb9d9c678ea142d794...429a542cece57e837387c5d3978677fbf4ce52f3,4,415,2,417,4,2007-03-13 15:37:13,2007-03-13 15:37:13
429a542cece57e837387c5d3978677fbf4ce52f3...ca343fc0ac546822839e5737c30c887dd59176b3,25,2231,1596,3827,496,2007-03-13 15:40:41,2007-03-13 15:40:41
ca343fc0ac546822839e5737c30c887dd59176b3...09005281ac54effa58befb9fe8aba2327f2a8136,1,2,2,4,1,2007-03-14 19:58:17,2007-03-14 19:58:17
09005281ac54effa58befb9fe8aba2327f2a8136...e1d2422cfd2dc36ab92db7c63342e856fc6b9e10,5,45,27,72,16,2007-03-14 20:37:03,2007-03-14 20:37:03
e1d2422cfd2dc36ab92db7c63342e856fc6b9e10...1c6eeb2ddab133e1a7dccd36a0cd80a5f4b6b75c,1,3,0,3,2,2007-03-14 20:43:43,2007-03-14 20:43:43
1c6eeb2ddab133e1a7dccd36a0cd80a5f4b6b75c...871f497e670a488378b79676116f57ae7a464e8e,16,420,260,680,26,2007-03-14 21:34:23,2007-03-14 21:34:23
871f497e670a488378b79676116f57ae7a464e8e...385f99433bc9fd69bb8ce05e9a47e39496945ba6,9,5,9,14,9,2007-03-14 23:04:08,2007-03-14 23:04:08
385f99433bc9fd69bb8ce05e9a47e39496945ba6...945c4ddf2474c7b1732619c205b074d4ccc0ad95,2,21,19,40,8,2007-03-16 04:58:36,2007-03-16 04:58:36
945c4ddf2474c7b1732619c205b074d4ccc0ad95...881c07cf2e212e04b2a8be47f444c6da56b5f382,7,16,12,28,12,2007-03-16 06:34:03,2007-03-16 06:34:03
881c07cf2e212e04b2a8be47f444c6da56b5f382...815837c8af6cb917dabbb3638b2ccf182263866d,20,170,105,275,68,2007-03-20 16:21:17,2007-03-20 16:21:17
815837c8af6cb917dabbb3638b2ccf182263866d...c62feba2a34dfc3a5fc54d2c8aab77920a633a63,7,21,1,22,8,2007-03-20 20:11:04,2007-03-20 20:11:04
c62feba2a34dfc3a5fc54d2c8aab77920a633a63...1bb9c6ffb4550ceb300f262d357168fc6b158dfa,1,1,2,3,2,2007-03-21 22:27:24,2007-03-21 22:27:24
1bb9c6ffb4550ceb300f262d357168fc6b158dfa...2c300b1dc62318e4f621da6ef898d1f380e895df,1,8,1,9,2,2007-03-21 22:28:48,2007-03-21 22:28:48
2c300b1dc62318e4f621da6ef898d1f380e895df...4a4417787ba2d9bb90f70e441380f868198f860a,2,7,7,14,5,2007-03-22 17:10:16,2007-03-22 17:10:16
4a4417787ba2d9bb90f70e441380f868198f860a...c4eb6bf708497d621e5bc0f731f26c800dee1d02,36,5305,2078,7383,852,2007-03-22 17:42:25,2007-03-22 17:42:25
c4eb6bf708497d621e5bc0f731f26c800dee1d02...05189a61e9d3619576ab0fd163136850ab1142c5,1,5,2,7,3,2007-03-28 20:55:46,2007-03-28 20:55:46
05189a61e9d3619576ab0fd163136850ab1142c5...d2c03a37798adf1975d96c12e927bed75db7feed,17,342,15,357,17,2007-03-28 21:28:59,2007-03-28 21:28:59
d2c03a37798adf1975d96c12e927bed75db7feed...1f3fc7bc9f8fca6b19b4b88852e5fce5f3dcf347,28,672,127,799,76,2007-03-28 21:30:05,2007-03-28 21:30:05
1f3fc7bc9f8fca6b19b4b88852e5fce5f3dcf347...9649bfd4f9d1c77df030f407e9d4c3849c0b5ffe,3,21,18,39,8,2007-03-28 22:20:22,2007-03-28 22:20:22
9649bfd4f9d1c77df030f407e9d4c3849c0b5ffe...61c3c5bc7faef211dd7b8c8d71da46728d27d53a,2,11,15,26,4,2007-03-29 21:33:36,2007-03-29 21:33:36
61c3c5bc7faef211dd7b8c8d71da46728d27d53a...1c3fccabd049924d0de25a59d1540680e4bc0096,7,110,9,119,13,2007-03-29 22:13:04,2007-03-29 22:13:04
1c3fccabd049924d0de25a59d1540680e4bc0096...b86d69f52920adf8e065bf6952ab6b3814211d4e,1,6,5,11,2,2007-03-30 16:54:17,2007-03-30 16:54:17
b86d69f52920adf8e065bf6952ab6b3814211d4e...a3053273c8a5d450a0cd73ee8deebc277d8c4170,65,4372,2466,6838,663,2007-04-02 15:36:31,2007-04-02 15:36:31
a3053273c8a5d450a0cd73ee8deebc277d8c4170...5bcf13b607ea92c34d13cbb52f70c1e6b76ce5cd,7,7,1,8,7,2007-04-03 21:59:56,2007-04-03 21:59:56
5bcf13b607ea92c34d13cbb52f70c1e6b76ce5cd...a9b2c0686d98f78ca365a04057699a44f7711914,32,4264,2816,7080,845,2007-04-05 16:17:35,2007-04-05 16:17:35
a9b2c0686d98f78ca365a04057699a44f7711914...8ceeb6d8cb5933ae518b2c75338decd2fc1bc97b,58,7042,2885,9927,1030,2007-04-09 23:39:40,2007-04-09 23:39:40
8ceeb6d8cb5933ae518b2c75338decd2fc1bc97b...0b57189aa27862f2b0a09f7e62e9a3a70ddcb328,1,1,4,5,1,2007-04-10 21:41:34,2007-04-10 21:41:34
0b57189aa27862f2b0a09f7e62e9a3a70ddcb328...f44429224a874dac9028f56d6803d1f1dc1b382f,1,28,2,30,1,2007-04-10 23:41:54,2007-04-10 23:41:54
f44429224a874dac9028f56d6803d1f1dc1b382f...be1357a4968f58f0c2f3c27e15f0b256525447ea,1,29,32,61,6,2007-04-11 17:30:16,2007-04-11 17:30:16
be1357a4968f58f0c2f3c27e15f0b256525447ea...8062ebbb188896a7ebdb5791cda769f54cce6fd3,1,1,1,2,1,2007-04-12 17:53:21,2007-04-12 17:53:21
8062ebbb188896a7ebdb5791cda769f54cce6fd3...ed9c870e45f3dd53e43f786d9a303ac1ae2a9f03,1,1,1,2,1,2007-04-12 21:05:21,2007-04-12 21:05:21
ed9c870e45f3dd53e43f786d9a303ac1ae2a9f03...572987627583cf9bfeb8acec7e3ee34f9c5db867,1,29,10,39,3,2007-04-12 23:36:22,2007-04-12 23:36:22
572987627583cf9bfeb8acec7e3ee34f9c5db867...8051e715b94186cdf16d356bfe82b506af4e74eb,4,32,4,36,6,2007-04-12 23:39:58,2007-04-12 23:39:58
8051e715b94186cdf16d356bfe82b506af4e74eb...48c0460605d64576a66c601e59ae5bca8853447f,1,7,6,13,3,2007-04-13 17:50:19,2007-04-13 17:50:19
48c0460605d64576a66c601e59ae5bca8853447f...531235c3bf9fdaaad9cd1a4026c0f0d70c15be94,1,7,2,9,3,2007-04-13 20:40:22,2007-04-13 20:40:22
531235c3bf9fdaaad9cd1a4026c0f0d70c15be94...9699399eee4e7690da074123d12852dad8ae6d9b,2,72,43,115,11,2007-04-16 22:31:55,2007-04-16 22:31:55
9699399eee4e7690da074123d12852dad8ae6d9b...e2a3b9e1bdff6a43f8525319ebfeff6949aa796f,29,940,15,955,40,2007-04-16 23:24:58,2007-04-16 23:24:58
e2a3b9e1bdff6a43f8525319ebfeff6949aa796f...ab622a35bd75dbaaa712e77b35ee0fdaefabc8a0,8,147,9,156,17,2007-04-17 15:57:16,2007-04-17 15:57:16
ab622a35bd75dbaaa712e77b35ee0fdaefabc8a0...1d90cbd758d268b05a32c14ff3054b75e436e0e7,1,2,7,9,1,2007-04-17 16:56:13,2007-04-17 16:56:13
1d90cbd758d268b05a32c14ff3054b75e436e0e7...99b7f9c1855f82d92fe686f246c4c1241fee1de1,3,20,20,40,8,2007-04-17 19:19:38,2007-04-17 19:19:38
99b7f9c1855f82d92fe686f246c4c1241fee1de1...e558b9aac4e935320c828416d6bb2aae3ed88f36,9,36,7,43,20,2007-04-17 23:22:49,2007-04-17 23:22:49
e558b9aac4e935320c828416d6bb2aae3ed88f36...b38a73e01a4873ef70f7b7b4c9536be0defbbd2d,2,7,7,14,6,2007-04-18 16:14:32,2007-04-18 16:14:32
b38a73e01a4873ef70f7b7b4c9536be0defbbd2d...e076f10cb55b1d7353a40ae31136d5bbf1fad111,4,4,4,8,4,2007-04-18 22:37:22,2007-04-18 22:37:22
e076f10cb55b1d7353a40ae31136d5bbf1fad111...04af379c706e2515d0937c2b338219ddfde09c16,7,36,25,61,22,2007-04-18 22:40:53,2007-04-18 22:40:53
04af379c706e2515d0937c2b338219ddfde09c16...0e53925f7d800647c0eca77cf76c0ac7848c2781,2,5,2,7,2,2007-04-18 23:23:50,2007-04-18 23:23:50
0e53925f7d800647c0eca77cf76c0ac7848c2781...1d3cc72d3ef010396a4c90a6737f841aafdbd3c2,1,1,0,1,1,2007-04-18 23:26:37,2007-04-18 23:26:37
1d3cc72d3ef010396a4c90a6737f841aafdbd3c2...3f549ca61d347d7513d4d6bf4ffb4aecedf2336c,1,4,8,12,2,2007-04-19 17:56:53,2007-04-19 17:56:53
3f549ca61d347d7513d4d6bf4ffb4aecedf2336c...31b1e3aa0436b0debd67013269211391cb435d8b,3,7,3,10,5,2007-04-19 18:56:51,2007-04-19 18:56:51
31b1e3aa0436b0debd67013269211391cb435d8b...7495b05b1251074bbe3bad296e5e1895bc2af010,1,1,1,2,1,2007-04-19 19:58:54,2007-04-19 19:58:54
7495b05b1251074bbe3bad296e5e1895bc2af010...943189a45d5fcca992621a9f5a39847fd65656d2,1,4,4,8,2,2007-04-19 20:59:23,2007-04-19 20:59:23
943189a45d5fcca992621a9f5a39847fd65656d2...1ad6a8f5c1509d20fcebcb45f40410c23baae493,1,1,8,9,2,2007-04-19 21:03:56,2007-04-19 21:03:56
1ad6a8f5c1509d20fcebcb45f40410c23baae493...557a0d407c9479d61c20ba9f323b7f4d5c17a2b5,3,12,12,24,9,2007-04-19 21:17:29,2007-04-19 21:17:29
557a0d407c9479d61c20ba9f323b7f4d5c17a2b5...4230f0c936dab3eb5eabdf96e3a2f24d4213a326,4,66,1,67,4,2007-04-20 17:31:42,2007-04-20 17:31:42
4230f0c936dab3eb5eabdf96e3a2f24d4213a326...172d4ba33b2fdf014bc0c966c64de89e5e6de59f,24,2070,1440,3510,418,2007-04-20 17:42:30,2007-04-20 17:42:30
172d4ba33b2fdf014bc0c966c64de89e5e6de59f...62ba18d7506693592e45fff47eb81be467818de5,10,64,34,98,28,2007-04-23 16:16:27,2007-04-23 16:16:27
62ba18d7506693592e45fff47eb81be467818de5...61bef9bbfd20c252851df4f813db39a825c64b52,51,2790,2276,5066,792,2007-04-25 18:20:25,2007-04-25 18:20:25
61bef9bbfd20c252851df4f813db39a825c64b52...d0213969c226aa95d22b0f7ebf4bffef6fb20c48,53,828,119,947,125,2007-04-26 20:45:53,2007-04-26 20:45:53
d0213969c226aa95d22b0f7ebf4bffef6fb20c48...3b479bfc563d3b3d768640ff5963947c56ee042b,16,294,191,485,154,2007-04-27 20:21:28,2007-04-27 20:21:28
3b479bfc563d3b3d768640ff5963947c56ee042b...5a7802586d117a75f91df04c032fd249808a877d,11,1447,821,2268,556,2007-04-30 15:32:29,2007-04-30 15:32:29
5a7802586d117a75f91df04c032fd249808a877d...90740c93e6aae5f1e676dc09777c4ba88cee5633,14,233,46,279,17,2007-05-01 15:33:10,2007-05-01 15:33:10
90740c93e6aae5f1e676dc09777c4ba88cee5633...750d2e8c3c5296a4ac9d85c5e797c76394a84769,2,10,5,15,4,2007-05-02 16:30:00,2007-05-02 16:30:00
750d2e8c3c5296a4ac9d85c5e797c76394a84769...32683de27c1b219af1aef5945e1976fdc66b746c,8,259,55,314,23,2007-05-03 19:26:47,2007-05-03 19:26:47
32683de27c1b219af1aef5945e1976fdc66b746c...0f22c6a7c8a089e2381a058b4c472cf92699950e,1,1,1,2,1,2007-05-04 17:03:20,2007-05-04 17:03:20
0f22c6a7c8a089e2381a058b4c472cf92699950e...a275d3da8ed8cea8c2c92fc15151f43fb56b42ce,16,450,167,617,82,2007-05-07 15:50:55,2007-05-07 15:50:55
a275d3da8ed8cea8c2c92fc15151f43fb56b42ce...7f13278f8619b1155fa51276bb63afa9997610da,27,271,81,352,82,2007-05-08 17:46:05,2007-05-08 17:46:05
7f13278f8619b1155fa51276bb63afa9997610da...e5ded41f315cafbc64c2f2d7d6a4d20ce5c3615d,11,5880,3450,9330,1008,2007-05-09 15:28:16,2007-05-09 15:28:16
e5ded41f315cafbc64c2f2d7d6a4d20ce5c3615d...12702bc683273b84624aa8353513ff4962a37d35,11,229,44,273,26,2007-05-10 15:51:59,2007-05-10 15:51:59
12702bc683273b84624aa8353513ff4962a37d35...bcc26d8eeae483814ad80c80a0336311b17de8bf,9,97,79,176,14,2007-05-11 16:03:48,2007-05-11 16:03:48
bcc26d8eeae483814ad80c80a0336311b17de8bf...c53378eb4b66742df4d8bcb4b9135e4fda343498,25,3604,99,3703,87,2007-05-14 15:58:54,2007-05-14 15:58:54
c53378eb4b66742df4d8bcb4b9135e4fda343498...151426692ec35035247bc3cd2447b536b4ef4236,9,115,112,227,80,2007-05-15 16:03:18,2007-05-15 16:03:18
151426692ec35035247bc3cd2447b536b4ef4236...f948bb371e44c50e3c1b585f10f485eafcbae602,1,1,1,2,1,2007-05-15 17:09:48,2007-05-15 17:09:48
f948bb371e44c50e3c1b585f10f485eafcbae602...41921a4e7381c99918780fef5f4f81e4d4b86693,2,9,8,17,3,2007-05-15 22:45:52,2007-05-15 22:45:52
41921a4e7381c99918780fef5f4f81e4d4b86693...786782edc5300421b5f86de9d687c931dd21d14b,3,38,26,64,17,2007-05-16 16:30:51,2007-05-16 16:30:51
786782edc5300421b5f86de9d687c931dd21d14b...8ccc894e17d3352c686cabd0f770ca86ff3ac1cf,1,7,10,17,5,2007-05-16 16:48:36,2007-05-16 16:48:36
8ccc894e17d3352c686cabd0f770ca86ff3ac1cf...a3c5889d93832d5a79994be53a228ff700e38a78,1,1,1,2,1,2007-05-16 16:52:40,2007-05-16 16:52:40
a3c5889d93832d5a79994be53a228ff700e38a78...d541f7a642dc1839fd4dd2e5119b64923e9692d1,1,40,23,63,25,2007-05-16 17:51:38,2007-05-16 17:51:38
d541f7a642dc1839fd4dd2e5119b64923e9692d1...74e29250427c7e6f901ffdbb721f69516ba2f3f0,1,1,1,2,1,2007-05-16 21:48:07,2007-05-16 21:48:07
74e29250427c7e6f901ffdbb721f69516ba2f3f0...310ae7eccc09e0a488a81f690876018ca39f34a8,7,110,29,139,21,2007-05-17 15:14:09,2007-05-17 15:14:09
310ae7eccc09e0a488a81f690876018ca39f34a8...e7cf3ed9890c03c31ea51f1b3c01cc741c2b26d5,1,18,1,19,4,2007-05-17 16:06:01,2007-05-17 16:06:01
e7cf3ed9890c03c31ea51f1b3c01cc741c2b26d5...97ccb9304ef578057640645013f5fb7eeafa246f,58,8501,2627,11128,908,2007-05-21 16:50:14,2007-05-21 16:50:14
97ccb9304ef578057640645013f5fb7eeafa246f...12b5df62dd8670c9dae2f77c7f7312e558a65104,2,12,8,20,9,2007-05-21 21:37:52,2007-05-21 21:37:52
12b5df62dd8670c9dae2f77c7f7312e558a65104...179a8c44bbe5deb80bd9ae2bc2ff65e3d0a71c03,4,14,27,41,9,2007-05-22 17:21:08,2007-05-22 17:21:08
179a8c44bbe5deb80bd9ae2bc2ff65e3d0a71c03...e9dcb067c16b79d0a76eface636f454ff3c32e37,1,1,1,2,1,2007-05-24 15:06:56,2007-05-24 15:06:56
e9dcb067c16b79d0a76eface636f454ff3c32e37...a82d071b484b6a3b429f5ed1c635a6f0e46f9636,31,2336,2048,4384,629,2007-05-30 16:57:27,2007-05-30 16:57:27
a82d071b484b6a3b429f5ed1c635a6f0e46f9636...a62ee775ef53a8e98911dc0e42587753f541d254,5,12,5,17,8,2007-05-31 16:09:49,2007-05-31 16:09:49
a62ee775ef53a8e98911dc0e42587753f541d254...bc8d41974dfd8097e6296c9706883306d8dd013a,1,2,2,4,2,2007-05-31 18:55:16,2007-05-31 18:55:16
bc8d41974dfd8097e6296c9706883306d8dd013a...959343fc7e7f1b5c2e58a7890c848c172ad1fbbe,2,39,5,44,7,2007-06-01 00:22:18,2007-06-01 00:22:18
959343fc7e7f1b5c2e58a7890c848c172ad1fbbe...4365d6d086efaf8e8fe2a060be869c3313a356b5,1,0,2,2,1,2007-06-01 18:22:05,2007-06-01 18:22:05
4365d6d086efaf8e8fe2a060be869c3313a356b5...fe8c54a62a43b08b10ba343603d2b80e54d320b9,20,117,33,150,30,2007-06-04 16:12:35,2007-06-04 16:12:35
fe8c54a62a43b08b10ba343603d2b80e54d320b9...61aaccf46df3926f488f68df7748051bbc3131b8,2,8,7,15,7,2007-06-04 21:10:33,2007-06-04 21:10:33
61aaccf46df3926f488f68df7748051bbc3131b8...63a51477dcdb3280a9188bb1de2c54e881be6bfa,2,0,0,0,0,2007-06-04 21:14:26,2007-06-04 21:14:26
63a51477dcdb3280a9188bb1de2c54e881be6bfa...bff357b7ce30f8820b312d72742ea71965250a54,1,21,2,23,6,2007-06-04 21:23:18,2007-06-04 21:23:18
bff357b7ce30f8820b312d72742ea71965250a54...2e7702c7454672830c3493a12d0efb3520919a7a,1,1,1,2,1,2007-06-04 21:32:45,2007-06-04 21:32:45
2e7702c7454672830c3493a12d0efb3520919a7a...0248dfd3757e485bf80dcd1befb90e7a283fbb7f,1,1,1,2,1,2007-06-05 01:05:44,2007-06-05 01:05:44
0248dfd3757e485bf80dcd1befb90e7a283fbb7f...5e8eef19dc78baeaed7d324e1767e8bf2b2bc387,1,1,0,1,1,2007-06-06 20:48:52,2007-06-06 20:48:52
5e8eef19dc78baeaed7d324e1767e8bf2b2bc387...0f36cbec13a2a6792036b16a7596ad024592309c,23,496,85,581,77,2007-06-11 15:53:42,2007-06-11 15:53:42
0f36cbec13a2a6792036b16a7596ad024592309c...1f09aa1e7b4079e22d1dfcde0f7d4e571389d8b5,2,3,6,9,3,2007-06-12 17:56:00,2007-06-12 17:56:00
1f09aa1e7b4079e22d1dfcde0f7d4e571389d8b5...750549569ea8d911db0397bd034406d5ce35d923,32,1734,909,2643,455,2007-06-18 16:43:17,2007-06-18 16:43:17
750549569ea8d911db0397bd034406d5ce35d923...829b25833a8e8ee6ce1fecdcd0733ededebe065b,10,54,42,96,22,2007-06-21 21:36:35,2007-06-21 21:36:35
829b25833a8e8ee6ce1fecdcd0733ededebe065b...0cb8e31823b2e9f05c4ae868c19f5f38e78a5f2e,21,162,284,446,128,2007-06-22 16:56:04,2007-06-22 16:56:04
f2a3deb0871c6cdbe04e1e0b36f4984c7c825bac...2926fb238dbb2123239f415022ca50c85c7de8ba,1,61,15,76,2,2007-01-17 20:07:49,2007-01-17 20:07:49
2926fb238dbb2123239f415022ca50c85c7de8ba...e7546eb27589ae3cec5874d046ef8bcd02af5d95,1,15,15,30,10,2007-01-17 21:35:22,2007-01-17 21:35:22
e7546eb27589ae3cec5874d046ef8bcd02af5d95...8a3fe9d93787f5263668dcc26c1b58d48ae1dc9d,1,4,4,8,2,2007-01-19 03:16:54,2007-01-19 03:16:54
8a3fe9d93787f5263668dcc26c1b58d48ae1dc9d...bc52fdc44657723f633a1753d45f045298a92d44,1,3,3,6,3,2007-01-19 03:18:36,2007-01-19 03:18:36
bc52fdc44657723f633a1753d45f045298a92d44...51a21bcbc36a1190dd5ec5462120bd049336801d,1,1,1,2,1,2007-01-19 17:21:04,2007-01-19 17:21:04
51a21bcbc36a1190dd5ec5462120bd049336801d...5e8c1a6c47ac35d4704b48fad1d72443a0c8100c,1,19,19,38,19,2007-01-20 17:25:42,2007-01-20 17:25:42
5e8c1a6c47ac35d4704b48fad1d72443a0c8100c...230b746f6cc037f5eedfada35cb7a250f7f54992,1,9,9,18,7,2007-01-20 17:31:45,2007-01-20 17:31:45
230b746f6cc037f5eedfada35cb7a250f7f54992...8f8b77bb5526bc54f5b66f6702848fc940ab8e18,1,1,1,2,1,2007-01-20 17:34:35,2007-01-20 17:34:35
8f8b77bb5526bc54f5b66f6702848fc940ab8e18...a154d94e456af97a05a6d630bd8ec7193d67684b,2,15,3,18,5,2007-01-20 20:31:17,2007-01-20 20:31:17
a154d94e456af97a05a6d630bd8ec7193d67684b...93eebd95cb59f4c54779db1dc8c2c166a36400fa,3,8,7,15,4,2007-01-20 20:33:23,2007-01-20 20:33:23
93eebd95cb59f4c54779db1dc8c2c166a36400fa...c770803f72bf6f0c7dc773ab41b674c6532ae756,1,5,1,6,2,2007-01-21 00:06:55,2007-01-21 00:06:55
c770803f72bf6f0c7dc773ab41b674c6532ae756...f073318668a40aab280a5e367e725e08538c52e3,2,38,1,39,2,2007-01-21 01:10:55,2007-01-21 01:10:55
f073318668a40aab280a5e367e725e08538c52e3...76f6dd42cc3c763d9f64c2c8f74f244613ae771b,2,25,1,26,3,2007-01-21 01:29:01,2007-01-21 01:29:01
76f6dd42cc3c763d9f64c2c8f74f244613ae771b...af377b13e18147cc54ce9677c947ad4f5025208e,1,13,4,17,6,2007-01-22 06:10:47,2007-01-22 06:10:47
af377b13e18147cc54ce9677c947ad4f5025208e...2e042f33e319bb5c4ea48b24f2520df29d30a886,2,55,30,85,16,2007-01-22 06:32:14,2007-01-22 06:32:14
2e042f33e319bb5c4ea48b24f2520df29d30a886...9afddbe42247b14f98ab4eb8697c3df0ad984ed2,1,4,1,5,1,2007-01-23 02:01:20,2007-01-23 02:01:20
9afddbe42247b14f98ab4eb8697c3df0ad984ed2...31bdd8d720c6a18c295513cf5af215993c11c82a,1,1,2,3,1,2007-01-23 02:02:35,2007-01-23 02:02:35
31bdd8d720c6a18c295513cf5af215993c11c82a...13280259a8f3ce8c462dc4b484efc922d60666de,4,97,16,113,14,2007-01-23 02:11:08,2007-01-23 02:11:08
13280259a8f3ce8c462dc4b484efc922d60666de...9ad98054db2dd2a636e3b7f0a2fb28b09738500c,1,2,2,4,2,2007-01-23 02:11:33,2007-01-23 02:11:33
9ad98054db2dd2a636e3b7f0a2fb28b09738500c...29331105697974667c05db52ce0be8d41bf892a7,1,17,17,34,7,2007-01-23 02:13:25,2007-01-23 02:13:25
29331105697974667c05db52ce0be8d41bf892a7...7d1b483d076d71f6beccbac0d94a4c8ac20374a8,1,6,6,12,5,2007-01-23 02:15:36,2007-01-23 02:15:36
7d1b483d076d71f6beccbac0d94a4c8ac20374a8...2633035261d38f6d2109e1d06776844f6ab259ea,1,1,1,2,1,2007-01-23 02:24:17,2007-01-23 02:24:17
2633035261d38f6d2109e1d06776844f6ab259ea...5b96692894a979742fc72b64a7b400959e4b164a,1,5,0,5,1,2007-01-23 02:30:55,2007-01-23 02:30:55
5b96692894a979742fc72b64a7b400959e4b164a...8a6c337f2a62c1f4af305f21229ee19a0ccb9c88,3,236,2,238,8,2007-01-23 20:23:07,2007-01-23 20:23:07
8a6c337f2a62c1f4af305f21229ee19a0ccb9c88...85fe1079968209e380141c67fe7ef5048d28584b,1,1,1,2,1,2007-01-24 03:30:32,2007-01-24 03:30:32
85fe1079968209e380141c67fe7ef5048d28584b...788f8f74540b87f79fbfbe44a4b2f00502d66d8a,3,132,3,135,9,2007-01-24 05:23:19,2007-01-24 05:23:19
788f8f74540b87f79fbfbe44a4b2f00502d66d8a...8e54c4978472c559f8a6a5efc00e3e48525629a4,37,200,200,400,130,2007-01-24 20:08:47,2007-01-24 20:08:47
8e54c4978472c559f8a6a5efc00e3e48525629a4...1b0b3febe132a6c887c8caf7911546a5540f73f5,1,0,1,1,1,2007-01-24 20:11:54,2007-01-24 20:11:54
1b0b3febe132a6c887c8caf7911546a5540f73f5...81c839014d85161e851cc8c1d408055adcd94021,1,3,1,4,1,2007-01-25 00:43:44,2007-01-25 00:43:44
81c839014d85161e851cc8c1d408055adcd94021...9d9435588505a9e4c46af6a774ef5fb3dadf53db,1,2,1,3,2,2007-01-25 00:47:44,2007-01-25 00:47:44
9d9435588505a9e4c46af6a774ef5fb3dadf53db...de60cf04d0120b6ea05e674bdda483ee79760b9b,1,2,2,4,2,2007-01-25 00:52:05,2007-01-25 00:52:05
de60cf04d0120b6ea05e674bdda483ee79760b9b...dfee6b328eec9ff1e4f24b5ad16982ac11211153,1,3,1,4,2,2007-01-25 00:53:30,2007-01-25 00:53:30
dfee6b328eec9ff1e4f24b5ad16982ac11211153...12ad69c0b4dc3f5ab89a3ccf330d3815e9811134,2,48,13,61,8,2007-01-25 11:24:17,2007-01-25 11:24:17
12ad69c0b4dc3f5ab89a3ccf330d3815e9811134...54feaca70f77b39093fe417dcd89eb7c74930e2e,3,81,21,102,18,2007-01-25 13:47:55,2007-01-25 13:47:55
54feaca70f77b39093fe417dcd89eb7c74930e2e...db8525cc01e52a423c2d4508c68614299948a11d,2,22,1,23,3,2007-01-27 13:42:51,2007-01-27 13:42:51
db8525cc01e52a423c2d4508c68614299948a11d...982a9443e173d46015e8262bab7ddfd42fa116b2,2,24,2,26,3,2007-01-27 21:30:26,2007-01-27 21:30:26
982a9443e173d46015e8262bab7ddfd42fa116b2...c0e01416b68e482172ef23cc507f163b873c192a,2,17,2,19,3,2007-01-27 21:41:32,2007-01-27 21:41:32
c0e01416b68e482172ef23cc507f163b873c192a...c93686c6987df97880cb0edc5535c6d5cbec9e6d,3,34,5,39,9,2007-01-27 22:06:56,2007-01-27 22:06:56
c93686c6987df97880cb0edc5535c6d5cbec9e6d...546f16d3232f4efc93c7eef0d88079f67d1d7d3d,1,22,0,22,1,2007-01-27 22:16:16,2007-01-27 22:16:16
546f16d3232f4efc93c7eef0d88079f67d1d7d3d...83768bf067e84187780fbc749295d23bc048939b,2,49,5,54,4,2007-01-28 04:56:54,2007-01-28 04:56:54
83768bf067e84187780fbc749295d23bc048939b...cf75fcc8321b822cb4758d167f1fade56a60ad4f,4,107,36,143,27,2007-01-28 22:10:04,2007-01-28 22:10:04
cf75fcc8321b822cb4758d167f1fade56a60ad4f...829e4c70f8953600cad8cb6120552f072473fb6d,3,18,18,36,18,2007-01-28 22:36:02,2007-01-28 22:36:02
829e4c70f8953600cad8cb6120552f072473fb6d...a031cadf4e946921b2897b00dea45389dff6fe85,1,1,1,2,1,2007-01-29 00:25:14,2007-01-29 00:25:14
a031cadf4e946921b2897b00dea45389dff6fe85...d28a63cc008c2b62d1e82ecb5ff5a2d92e6a43ec,2,24,8,32,8,2007-01-29 16:09:25,2007-01-29 16:09:25
d28a63cc008c2b62d1e82ecb5ff5a2d92e6a43ec...5aea495ac3a000a7b72fa3202e05ff35676e0e4e,1,1,1,2,1,2007-01-29 16:12:17,2007-01-29 16:12:17
5aea495ac3a000a7b72fa3202e05ff35676e0e4e...1e3d035fcc1811b6b8028655784e19caaedc281f,1,1,1,2,2,2007-01-29 16:48:31,2007-01-29 16:48:31
1e3d035fcc1811b6b8028655784e19caaedc281f...695302ce9214405e166ef559bdd8abb5fceaa020,6,156,40,196,36,2007-01-30 22:34:15,2007-01-30 22:34:15
695302ce9214405e166ef559bdd8abb5fceaa020...795de3a67ca7208e7628dffdf6723c81f71353e0,1,4,5,9,5,2007-02-04 00:54:30,2007-02-04 00:54:30
795de3a67ca7208e7628dffdf6723c81f71353e0...04c4a031ba61abb88996f785d188b25113fb62dd,1,1,1,2,1,2007-02-05 21:26:57,2007-02-05 21:26:57
04c4a031ba61abb88996f785d188b25113fb62dd...b5f91761152685f8c7f6bed9dca3d0742532dffc,1,8,2,10,3,2007-02-06 13:59:24,2007-02-06 13:59:24
b5f91761152685f8c7f6bed9dca3d0742532dffc...f28558348b37fdf14ee2a26578794be55cd5049c,1,0,1,1,1,2007-02-06 14:09:05,2007-02-06 14:09:05
f28558348b37fdf14ee2a26578794be55cd5049c...4ccdf127d07afe88ef5367f7b4b4b0040e3618dc,1,5,4,9,5,2007-02-07 22:56:53,2007-02-07 22:56:53
4ccdf127d07afe88ef5367f7b4b4b0040e3618dc...9ba27afce09cb5f19f429844bd699f5042eb2108,5,68,10,78,9,2007-02-09 13:47:36,2007-02-09 13:47:36
9ba27afce09cb5f19f429844bd699f5042eb2108...9b129b8f3f7ba7e1bed065fed7f016429bd56499,1,1,1,2,1,2007-02-09 22:01:13,2007-02-09 22:01:13
9b129b8f3f7ba7e1bed065fed7f016429bd56499...ea7b3fd1485ff2d9864dbec123072743222c23f9,2,4,3,7,4,2007-02-09 22:09:07,2007-02-09 22:09:07
ea7b3fd1485ff2d9864dbec123072743222c23f9...2a14daffb0571af26438a7c838ef897a1113cc7a,1,1,1,2,1,2007-02-10 00:55:33,2007-02-10 00:55:33
2a14daffb0571af26438a7c838ef897a1113cc7a...5a0b72a6eb41a66af14d6256fa382380399eabfb,3,90,0,90,4,2007-02-10 02:51:27,2007-02-10 02:51:27
5a0b72a6eb41a66af14d6256fa382380399eabfb...f0a3f5fc1a90e99ad8c315f057bc5bd49cc31306,1,1,1,2,1,2007-02-10 03:39:14,2007-02-10 03:39:14
f0a3f5fc1a90e99ad8c315f057bc5bd49cc31306...e57ce6b15714c3697bec8a911443aca6cf1172d2,2,19,2,21,2,2007-02-10 03:39:56,2007-02-10 03:39:56
e57ce6b15714c3697bec8a911443aca6cf1172d2...45e0a522bbd3d2a947e5a77f767b8836c9327985,1,1,1,2,1,2007-02-10 03:42:24,2007-02-10 03:42:24
45e0a522bbd3d2a947e5a77f767b8836c9327985...ae36e6303df82656a8bdee4501b50d20537a9c53,1,1,1,2,1,2007-02-10 03:56:21,2007-02-10 03:56:21
ae36e6303df82656a8bdee4501b50d20537a9c53...766e339666b77225fca09c7124b863aa81e56e56,1,11,4,15,7,2007-02-10 04:01:19,2007-02-10 04:01:19
766e339666b77225fca09c7124b863aa81e56e56...1aa1c4672cf7213f1073a5ab5f7c1ac8bc78d19f,1,10,0,10,1,2007-02-10 05:22:12,2007-02-10 05:22:12
1aa1c4672cf7213f1073a5ab5f7c1ac8bc78d19f...007f17d63e05d8422ec63eab75d6a97fd3175be9,2,19,17,36,9,2007-02-10 05:38:38,2007-02-10 05:38:38
007f17d63e05d8422ec63eab75d6a97fd3175be9...fefcbbfe3719eaf0b493eabaab591c0b7bc35d9e,2,65,0,65,2,2007-02-10 08:29:34,2007-02-10 08:29:34
fefcbbfe3719eaf0b493eabaab591c0b7bc35d9e...937f3190baabb5c98398b391bcf8250bbb738da5,4,51,5,56,15,2007-02-10 08:36:39,2007-02-10 08:36:39
937f3190baabb5c98398b391bcf8250bbb738da5...d8deb0c61cdcd99ed2cede8d65d4fd30458f4dbc,2,26,0,26,3,2007-02-10 08:55:18,2007-02-10 08:55:18
d8deb0c61cdcd99ed2cede8d65d4fd30458f4dbc...4d75c7aa6ef7a477697fbe06658d8bd5ab2d0250,1,3,0,3,1,2007-02-10 09:02:00,2007-02-10 09:02:00
4d75c7aa6ef7a477697fbe06658d8bd5ab2d0250...23272de5dbc9429180e309883ffd021026bd4921,1,5,1,6,1,2007-02-10 09:07:54,2007-02-10 09:07:54
23272de5dbc9429180e309883ffd021026bd4921...f9cdde0cb41851e9d1eb70bd108debb75f267585,7,48,4,52,12,2007-02-11 00:23:31,2007-02-11 00:23:31
f9cdde0cb41851e9d1eb70bd108debb75f267585...83692401380f41106c5a87a7f41c510a92d5392c,1,1,1,2,1,2007-02-11 04:38:44,2007-02-11 04:38:44
83692401380f41106c5a87a7f41c510a92d5392c...b767b5831d4bdd1cff04474278ea43e24c20274c,1,3,2,5,2,2007-02-11 04:39:23,2007-02-11 04:39:23
b767b5831d4bdd1cff04474278ea43e24c20274c...0e924c70b1ec5cae635a99d9fe7e279698dc5cd0,20,33,21,54,30,2007-02-11 06:20:52,2007-02-11 06:20:52
0e924c70b1ec5cae635a99d9fe7e279698dc5cd0...6c4757729b6dbf2fb824865ba84f776656c8040c,20,21,33,54,30,2007-02-11 23:50:35,2007-02-11 23:50:35
6c4757729b6dbf2fb824865ba84f776656c8040c...80e58b3211ae54754b734a409d5b944117d7963d,4,13,2,15,5,2007-02-12 00:10:09,2007-02-12 00:10:09
80e58b3211ae54754b734a409d5b944117d7963d...d123588184dfecc286e8e06e16dc0383f435c051,2,25,2,27,4,2007-02-12 00:16:17,2007-02-12 00:16:17
d123588184dfecc286e8e06e16dc0383f435c051...a0c354ee4ed02bb3f958dfb029d29b76e6637952,3,21,1,22,3,2007-02-12 00:22:22,2007-02-12 00:22:22
a0c354ee4ed02bb3f958dfb029d29b76e6637952...22587230977e862a7e87723d538b5b5e48800494,4,27,5,32,6,2007-02-12 00:33:24,2007-02-12 00:33:24
22587230977e862a7e87723d538b5b5e48800494...38f9d8dac66cead8dffe18eb4f4a7db6ceff105b,1,1,1,2,1,2007-02-12 17:10:09,2007-02-12 17:10:09
38f9d8dac66cead8dffe18eb4f4a7db6ceff105b...b9677848f5ae707e52ce96c067878707015c45cd,2,10,5,15,2,2007-02-12 17:13:08,2007-02-12 17:13:08
b9677848f5ae707e52ce96c067878707015c45cd...58ae80b5ea66c0723571e233bd22d02403ba7fa7,1,1,1,2,1,2007-02-13 02:54:17,2007-02-13 02:54:17
58ae80b5ea66c0723571e233bd22d02403ba7fa7...0fabbf8ce849dd744d085bae073add038d574e2f,6,131,0,131,7,2007-02-13 04:24:58,2007-02-13 04:24:58
0fabbf8ce849dd744d085bae073add038d574e2f...ffa0d274625d21e6c4c7fa146413ce951b669b72,1,4,4,8,8,2007-02-13 05:02:47,2007-02-13 05:02:47
ffa0d274625d21e6c4c7fa146413ce951b669b72...a4ddecd15c1ea38a7827426f73ddd997786d42cd,2,4,0,4,2,2007-02-13 05:50:55,2007-02-13 05:50:55
a4ddecd15c1ea38a7827426f73ddd997786d42cd...ba9649f966e7bf9c1f0cea7fac2bb991beb600b5,2,6,0,6,2,2007-02-13 06:06:09,2007-02-13 06:06:09
ba9649f966e7bf9c1f0cea7fac2bb991beb600b5...f41e2b78377f84d8fd65317c77f355aec4dbe468,1,1,1,2,1,2007-02-13 06:07:55,2007-02-13 06:07:55
f41e2b78377f84d8fd65317c77f355aec4dbe468...5bed563edfa6c824723bc4c5d78d965202fe967e,1,16,16,32,7,2007-02-13 06:13:06,2007-02-13 06:13:06
5bed563edfa6c824723bc4c5d78d965202fe967e...ff46f0fbcf601be73a7f0866986aa96abac79e8e,2,6,2,8,4,2007-02-13 06:27:28,2007-02-13 06:27:28
ff46f0fbcf601be73a7f0866986aa96abac79e8e...7ac5a6e27da9bd6a10da068f8980ba023d323a0d,1,1,1,2,1,2007-02-13 06:29:35,2007-02-13 06:29:35
7ac5a6e27da9bd6a10da068f8980ba023d323a0d...c61d7e195f2fb3bebbd124ff814af3a8c2e59c1f,1,5,5,10,4,2007-02-13 15:44:04,2007-02-13 15:44:04
c61d7e195f2fb3bebbd124ff814af3a8c2e59c1f...9efa60dafbfa9f23423c6babb8de56e028f24c49,2,39,1,40,3,2007-02-13 18:04:47,2007-02-13 18:04:47
9efa60dafbfa9f23423c6babb8de56e028f24c49...4c4209b14449554382b541d709749340f9b1a7ae,3,29,17,46,18,2007-02-14 06:32:32,2007-02-14 06:32:32
4c4209b14449554382b541d709749340f9b1a7ae...05182053088d3c30fad3fe5cc81db7a12412ae2b,3,93,1,94,4,2007-02-14 23:44:46,2007-02-14 23:44:46
05182053088d3c30fad3fe5cc81db7a12412ae2b...26058b98a6af92caf31d6f4e17d02b61c80458d1,1,59,58,117,38,2007-02-14 23:45:45,2007-02-14 23:45:45
26058b98a6af92caf31d6f4e17d02b61c80458d1...6ab41bef135706c0755e17adf806653d28609115,1,4,3,7,1,2007-02-14 23:49:58,2007-02-14 23:49:58
6ab41bef135706c0755e17adf806653d28609115...d9953d6095fe5658c4841ed892da593fb2101daa,5,2445,0,2445,3,2007-02-14 23:50:26,2007-02-14 23:50:26
d9953d6095fe5658c4841ed892da593fb2101daa...4717291d0dc733d2817a56500bf683bdb3c73555,6,2492,0,2492,4,2007-02-14 23:56:29,2007-02-14 23:56:29
4717291d0dc733d2817a56500bf683bdb3c73555...1026e6b672414a96539dd55f1232adbe8b321cfb,1,1,0,1,1,2007-02-14 23:57:36,2007-02-14 23:57:36
1026e6b672414a96539dd55f1232adbe8b321cfb...132510be5ec849beeb21ee4569e75fb383187b1d,2,537,241,778,215,2007-02-15 00:00:09,2007-02-15 00:00:09
132510be5ec849beeb21ee4569e75fb383187b1d...278e224d67e1f557e8653e6391470fd0ddcca922,5,2505,0,2505,3,2007-02-15 00:07:07,2007-02-15 00:07:07
278e224d67e1f557e8653e6391470fd0ddcca922...ebf619302935c329e6ae3f802a4c0ada33ee9c95,2,0,0,0,0,2007-02-15 00:13:46,2007-02-15 00:13:46
ebf619302935c329e6ae3f802a4c0ada33ee9c95...8642d2cbab9c4d751e5db0fa8db80f106a36927d,2,201,341,542,167,2007-02-15 00:15:13,2007-02-15 00:15:13
8642d2cbab9c4d751e5db0fa8db80f106a36927d...460f500004a2efafba0f148f620a36e01219fee0,2,1602,1634,3236,465,2007-02-15 00:17:59,2007-02-15 00:17:59
460f500004a2efafba0f148f620a36e01219fee0...c53f01a57c26296cf6c2040e578ad8c03cb45bbc,2,4,4,8,4,2007-02-15 00:19:44,2007-02-15 00:19:44
c53f01a57c26296cf6c2040e578ad8c03cb45bbc...174cef7361eb1b42cb990a6bcb98de493e90e8a3,2,9,0,9,1,2007-02-15 00:21:32,2007-02-15 00:21:32
174cef7361eb1b42cb990a6bcb98de493e90e8a3...2ec2bf698938c81ef8703699bb85eb5d32997631,2,78,5,83,4,2007-02-15 03:37:25,2007-02-15 03:37:25
2ec2bf698938c81ef8703699bb85eb5d32997631...41078ce1465112ceab03638b2893863b2223be2f,1,1,0,1,1,2007-02-15 03:46:43,2007-02-15 03:46:43
41078ce1465112ceab03638b2893863b2223be2f...6245816dd90b8b0b9b8739f1fc292547a1a55639,2,18,1,19,3,2007-02-15 04:03:47,2007-02-15 04:03:47
6245816dd90b8b0b9b8739f1fc292547a1a55639...a13a47e447c925ad39f0c3a4bd5c2cddfc74d3d3,2,27,1,28,2,2007-02-15 04:13:02,2007-02-15 04:13:02
a13a47e447c925ad39f0c3a4bd5c2cddfc74d3d3...b93614ada658087cbc90403ee8f36d7f8c947dfe,3,25,0,25,3,2007-02-15 05:05:43,2007-02-15 05:05:43
b93614ada658087cbc90403ee8f36d7f8c947dfe...27b28616b405578d81fb8e6a4efdc73459c81a2b,5,10,1,11,2,2007-02-15 05:53:44,2007-02-15 05:53:44
27b28616b405578d81fb8e6a4efdc73459c81a2b...1ce1442d95730e7b4e0d54f971aaeb6cf744f04c,3,245,1,246,4,2007-02-15 06:18:27,2007-02-15 06:18:27
1ce1442d95730e7b4e0d54f971aaeb6cf744f04c...c96d1555897997676eb7699b8a1752e57a7b1e57,1,1,1,2,1,2007-02-15 20:55:37,2007-02-15 20:55:37
c96d1555897997676eb7699b8a1752e57a7b1e57...1d5e974a4f2e116a1530c24e6df54449b8ef3c98,3,63,0,63,2,2007-02-15 21:26:43,2007-02-15 21:26:43
1d5e974a4f2e116a1530c24e6df54449b8ef3c98...4a85a75fb0e3185dc77362c16e80219dac168c05,2,3,1,4,2,2007-02-15 22:43:43,2007-02-15 22:43:43
4a85a75fb0e3185dc77362c16e80219dac168c05...d6d51c9546a8734683c75bddc2cab93e05247f1e,5,60,21,81,17,2007-02-17 00:23:09,2007-02-17 00:23:09
d6d51c9546a8734683c75bddc2cab93e05247f1e...c5cd06e505d666eb2b15398cc2cf03618688f62b,2,1,1,2,1,2007-02-17 01:24:10,2007-02-17 01:24:10
c5cd06e505d666eb2b15398cc2cf03618688f62b...6034d3c70fdc60d45e3667b4d03127bed7e8b418,2,253,155,408,142,2007-02-17 01:27:55,2007-02-17 01:27:55
6034d3c70fdc60d45e3667b4d03127bed7e8b418...440d318d86946a4faf98400099939fbab37674cc,2,1,1,2,1,2007-02-17 01:29:34,2007-02-17 01:29:34
440d318d86946a4faf98400099939fbab37674cc...892202b3195a9903dd7328acf9f2920719000be2,1,5,0,5,1,2007-02-17 01:38:03,2007-02-17 01:38:03
892202b3195a9903dd7328acf9f2920719000be2...369d9ffa3d513aa5f8fb847c2025ac305ee23ffe,1,74,0,74,1,2007-02-17 04:59:49,2007-02-17 04:59:49
369d9ffa3d513aa5f8fb847c2025ac305ee23ffe...ed3d787edaecdaaece247d7b0f09b9ed6fe3be84,1,24,5,29,1,2007-02-17 05:51:45,2007-02-17 05:51:45
ed3d787edaecdaaece247d7b0f09b9ed6fe3be84...f5ede9c5c8bb2ebef362b374330c6d1200e6706b,1,12,1,13,1,2007-02-17 06:01:17,2007-02-17 06:01:17
f5ede9c5c8bb2ebef362b374330c6d1200e6706b...795d832a017dafa745c5d8edf5082939987ecb09,1,1,1,2,1,2007-02-17 06:14:23,2007-02-17 06:14:23
795d832a017dafa745c5d8edf5082939987ecb09...fa159c8de94d40c0ee7b57727c8245c5c2e5be11,1,68,27,95,13,2007-02-18 04:42:15,2007-02-18 04:42:15
fa159c8de94d40c0ee7b57727c8245c5c2e5be11...2fe64761809e636dc4efadde305c0b9509c30ca9,1,15,16,31,7,2007-02-18 04:44:17,2007-02-18 04:44:17
2fe64761809e636dc4efadde305c0b9509c30ca9...895633a80d04ba95b2efdb3e32ddf560c0693339,2,5,2,7,4,2007-02-18 08:02:00,2007-02-18 08:02:00
895633a80d04ba95b2efdb3e32ddf560c0693339...fb509ee8d3c67efd28beef2df463b62ef883c17a,3,4,2,6,5,2007-02-18 08:07:18,2007-02-18 08:07:18
fb509ee8d3c67efd28beef2df463b62ef883c17a...babc0793e3dcfcc976ae44df4c67c7eed627655c,1,4,4,8,2,2007-02-19 04:18:46,2007-02-19 04:18:46
babc0793e3dcfcc976ae44df4c67c7eed627655c...7cb7541971b2e080d1288e24e5705d296b11a021,2,8,1,9,2,2007-02-19 23:43:14,2007-02-19 23:43:14
7cb7541971b2e080d1288e24e5705d296b11a021...b8fa80bd0020eee186e5288e3fd2552695093025,2,14,1,15,2,2007-02-19 23:54:55,2007-02-19 23:54:55
b8fa80bd0020eee186e5288e3fd2552695093025...907241e299a4ed9077bbeb6fbfdccce738a8e2a8,3,142,4,146,6,2007-02-20 00:30:22,2007-02-20 00:30:22
907241e299a4ed9077bbeb6fbfdccce738a8e2a8...e56934b9b903535ace50f46d892dab4225b67f61,3,124,8,132,11,2007-02-20 02:42:07,2007-02-20 02:42:07
e56934b9b903535ace50f46d892dab4225b67f61...bdfbcb2cd51643d2d866eda8820b62521901a007,2,13,2,15,6,2007-02-20 02:59:16,2007-02-20 02:59:16
bdfbcb2cd51643d2d866eda8820b62521901a007...a52cc033749d288aa117f480959e43e7c8b8f031,3,16,2,18,4,2007-02-20 03:05:09,2007-02-20 03:05:09
a52cc033749d288aa117f480959e43e7c8b8f031...97256bc39cb07b60afd08f799d31282b0813469a,1,1,1,2,1,2007-02-20 23:38:06,2007-02-20 23:38:06
97256bc39cb07b60afd08f799d31282b0813469a...5bec651a61ac9ba2831850104060833b37403399,1,13,0,13,1,2007-02-21 03:47:03,2007-02-21 03:47:03
5bec651a61ac9ba2831850104060833b37403399...ee96c7eb2dea86e5bdaf93f7afa91b6f0128dd72,2,153,28,181,20,2007-02-21 05:14:28,2007-02-21 05:14:28
ee96c7eb2dea86e5bdaf93f7afa91b6f0128dd72...e8f165f1f09a1578ce805e0a44117663aa172f71,1,5,1,6,1,2007-02-21 05:18:34,2007-02-21 05:18:34
e8f165f1f09a1578ce805e0a44117663aa172f71...08e406d146904988c8dac366a6007b7291b9642a,2,88,0,88,4,2007-02-21 05:54:09,2007-02-21 05:54:09
08e406d146904988c8dac366a6007b7291b9642a...ec2eb4d18fcfde5572eef311ddbe8a64c213ed2f,1,0,4,4,1,2007-02-21 05:55:12,2007-02-21 05:55:12
ec2eb4d18fcfde5572eef311ddbe8a64c213ed2f...abc949f58401f339e82328710e037e05acdbbae2,2,22,0,22,3,2007-02-21 05:59:46,2007-02-21 05:59:46
abc949f58401f339e82328710e037e05acdbbae2...1266766da4a30460a92659c270fea0904ce43c51,1,1,1,2,1,2007-02-22 11:17:50,2007-02-22 11:17:50
1266766da4a30460a92659c270fea0904ce43c51...36512d5d734feee53b7787dbdf2d671f158ebaae,4,129,13,142,34,2007-02-23 18:02:51,2007-02-23 18:02:51
36512d5d734feee53b7787dbdf2d671f158ebaae...a01f852d2ea4776a598bd184004433c9a51bceb2,1,4,2,6,3,2007-02-23 20:50:53,2007-02-23 20:50:53
a01f852d2ea4776a598bd184004433c9a51bceb2...ee5415e3ddcbd0f85b21c2cafe4c8af3be377054,1,1,1,2,1,2007-02-23 20:55:21,2007-02-23 20:55:21
ee5415e3ddcbd0f85b21c2cafe4c8af3be377054...16bd0aa99161c4f9646f1546e47b6ac5f9a1e3c2,1,11,1,12,1,2007-02-23 20:58:28,2007-02-23 20:58:28
16bd0aa99161c4f9646f1546e47b6ac5f9a1e3c2...e7aab3a474bf4f26a84323bbfff92bf340087e2f,2,6,10,16,7,2007-02-23 23:05:16,2007-02-23 23:05:16
e7aab3a474bf4f26a84323bbfff92bf340087e2f...f2aa1b93e09202707453d26f0648cd9aaf57e4ec,1,2,2,4,1,2007-02-23 23:05:25,2007-02-23 23:05:25
f2a3deb0871c6cdbe04e1e0b36f4984c7c825bac...84b37e3841da4aaa3b6d126ecb951c261b3590fb,0,0,0,0,0,2007-01-16 17:01:55,2007-01-16 17:01:55
84b37e3841da4aaa3b6d126ecb951c261b3590fb...b2f01031987b3e6625409c195b248c3f22b64083,0,0,0,0,0,2009-09-11 21:26:49,2009-09-11 21:26:49
f2a3deb0871c6cdbe04e1e0b36f4984c7c825bac...815a0843bc50189776cc569aefb21c27a5c3ddcd,0,0,0,0,0,2007-01-14 18:42:33,2007-01-14 18:42:33
815a0843bc50189776cc569aefb21c27a5c3ddcd...32c367253a0b92933939abdd9a88535971de4155,2,40,6,46,2,2007-01-14 20:00:11,2007-01-14 20:00:11
32c367253a0b92933939abdd9a88535971de4155...7859dee662c9fafcba1cea5cb35832a1733f9e18,1,6,0,6,6,2007-01-14 20:03:28,2007-01-14 20:03:28
7859dee662c9fafcba1cea5cb35832a1733f9e18...b3cce4326b43b759ba551d88cd626ebe752c5ef1,1,1,0,1,1,2007-01-14 20:04:56,2007-01-14 20:04:56
b3cce4326b43b759ba551d88cd626ebe752c5ef1...980b7a9927d2a49963ce43657556463ed7681074,1,3,3,6,3,2007-01-14 20:08:20,2007-01-14 20:08:20
980b7a9927d2a49963ce43657556463ed7681074...fdae6a83bb673fe2b4c1e72d6c4651b830c18523,1,21,24,45,4,2007-01-14 20:13:41,2007-01-14 20:13:41
fdae6a83bb673fe2b4c1e72d6c4651b830c18523...621e64035e0002b3456d4a255d40c5a284a94495,1,25,30,55,3,2007-01-14 20:19:32,2007-01-14 20:19:32
621e64035e0002b3456d4a255d40c5a284a94495...414f34d9e81b1b68f4149ccfbef37e6f3d005560,1,32,39,71,3,2007-01-14 20:23:34,2007-01-14 20:23:34
414f34d9e81b1b68f4149ccfbef37e6f3d005560...774362dc31b1ea1058483e4c35b11736c724ea75,1,93,100,193,2,2007-01-14 20:32:58,2007-01-14 20:32:58
774362dc31b1ea1058483e4c35b11736c724ea75...a8281149032f81510812dd67e4fad210df68511c,1,73,78,151,4,2007-01-14 20:36:08,2007-01-14 20:36:08
a8281149032f81510812dd67e4fad210df68511c...4dfb224d7ec6931104e11ecc6ee1a56e20907839,1,27,5,32,7,2007-01-14 20:49:23,2007-01-14 20:49:23
4dfb224d7ec6931104e11ecc6ee1a56e20907839...40256823fd06a4a94e3c6983e3ed61131105cb3a,1,2,0,2,1,2007-01-14 21:50:00,2007-01-14 21:50:00
40256823fd06a4a94e3c6983e3ed61131105cb3a...28990ef07b3f67fc8db18ba345e2d47a80d74475,2,352,328,680,11,2007-01-15 01:53:11,2007-01-15 01:53:11
28990ef07b3f67fc8db18ba345e2d47a80d74475...ede911b5a2c889de0f6b464870c9bcb47ed00668,1,1,1,2,1,2007-01-15 23:46:31,2007-01-15 23:46:31
ede911b5a2c889de0f6b464870c9bcb47ed00668...560a1ba9a0e4994db09922faf7c9c49e20f19fa5,5,23,11,34,14,2007-01-16 00:09:53,2007-01-16 00:09:53
560a1ba9a0e4994db09922faf7c9c49e20f19fa5...dbacd7de2df866c46eaf8a070bf9348101a82ef5,1,1,1,2,1,2007-01-16 00:12:02,2007-01-16 00:12:02
dbacd7de2df866c46eaf8a070bf9348101a82ef5...f5441534e35be85cf789f2c18cf04259731e9bf3,5,12,13,25,13,2007-01-16 00:21:01,2007-01-16 00:21:01
f5441534e35be85cf789f2c18cf04259731e9bf3...b4609104133b5a867954f14fabd4b3301617fb0c,6,11,10,21,12,2007-01-16 00:27:04,2007-01-16 00:27:04
b4609104133b5a867954f14fabd4b3301617fb0c...dcbfd3fa83fdb5d2ab41022f440746fc21ddc84d,6,12,10,22,11,2007-01-16 00:31:40,2007-01-16 00:31:40
dcbfd3fa83fdb5d2ab41022f440746fc21ddc84d...7ffbc9d22c62e70aff4c7c1ddcd0abebc5e6d92b,4,6,5,11,5,2007-01-16 00:35:25,2007-01-16 00:35:25
7ffbc9d22c62e70aff4c7c1ddcd0abebc5e6d92b...c9e4b372909f19e6b70c20f39ce704f99a7f659a,5,9,8,17,10,2007-01-16 00:48:46,2007-01-16 00:48:46
c9e4b372909f19e6b70c20f39ce704f99a7f659a...93e024365df41bab5036156415eed3c2046240bd,4,7,6,13,8,2007-01-16 00:51:22,2007-01-16 00:51:22
93e024365df41bab5036156415eed3c2046240bd...f72a100b531f680cf5595412c82827d81f8b2c29,4,8,7,15,9,2007-01-16 00:54:58,2007-01-16 00:54:58
f72a100b531f680cf5595412c82827d81f8b2c29...052363fb8b2532d4137858aff9073d6cdce8baee,4,3,4,7,5,2007-01-16 00:57:56,2007-01-16 00:57:56
052363fb8b2532d4137858aff9073d6cdce8baee...a2b25f721691d98f0ee23e4e65e9797499eddfe1,5,5,4,9,6,2007-01-16 01:05:25,2007-01-16 01:05:25
a2b25f721691d98f0ee23e4e65e9797499eddfe1...626e6d4eb98602488a9f4826a22638dfc8d3915c,3,4,5,9,4,2007-01-17 01:44:00,2007-01-17 01:44:00
626e6d4eb98602488a9f4826a22638dfc8d3915c...08328ea847365ba450eb44de12f24de2bde8c202,1,1,1,2,1,2007-01-17 01:45:01,2007-01-17 01:45:01
08328ea847365ba450eb44de12f24de2bde8c202...4fc14c6f7a04bb3f5b147fff6f840efb1b2f04e8,4,10,11,21,11,2007-01-17 02:13:06,2007-01-17 02:13:06
4fc14c6f7a04bb3f5b147fff6f840efb1b2f04e8...d41320d2e5e7457396ebb0016d822d49ffc1424a,8,108,131,239,23,2007-01-17 05:39:29,2007-01-17 05:39:29
d41320d2e5e7457396ebb0016d822d49ffc1424a...2957fedd40d629d31266e20da15cc591fdd3fac0,1,2,5,7,3,2007-01-17 17:13:19,2007-01-17 17:13:19
2957fedd40d629d31266e20da15cc591fdd3fac0...84c5094769a37e5e005dc45c29f6256f19c18523,1,7,8,15,2,2007-01-17 18:23:39,2007-01-17 18:23:39
84c5094769a37e5e005dc45c29f6256f19c18523...2ec4ef212c070744bf87dde8aef1d894f079aaf2,2,66,20,86,9,2007-01-19 03:25:15,2007-01-19 03:25:15
2ec4ef212c070744bf87dde8aef1d894f079aaf2...5a000ea8a919b73ffea766468acae95b1cdb6ec2,7,25,10,35,35,2007-01-19 03:38:13,2007-01-19 03:38:13
5a000ea8a919b73ffea766468acae95b1cdb6ec2...f9019a7a7bcfc5dbc8f718fa243f1edcc26e03e8,1,2,2,4,2,2007-01-19 03:43:09,2007-01-19 03:43:09
f9019a7a7bcfc5dbc8f718fa243f1edcc26e03e8...2ea6cdbd9db1ad5216fcc9b5d33034a981e2142d,3,12,12,24,3,2007-01-19 03:51:41,2007-01-19 03:51:41
2ea6cdbd9db1ad5216fcc9b5d33034a981e2142d...13da9d7d2fd689564e9f14773e710b081db5a6f0,2,3,2,5,3,2007-01-19 05:10:51,2007-01-19 05:10:51
13da9d7d2fd689564e9f14773e710b081db5a6f0...eaf6d5161172af8b9304df36e5666124bc7d2973,1,5,6,11,1,2007-01-19 05:13:37,2007-01-19 05:13:37
eaf6d5161172af8b9304df36e5666124bc7d2973...7227d41f4823efef8c51992cd1cbd51e7fca5f11,1,8,9,17,6,2007-01-19 05:33:08,2007-01-19 05:33:08
7227d41f4823efef8c51992cd1cbd51e7fca5f11...53f94937f00d43f8a4d78437d88c99e4e7e51cf5,1,33,0,33,2,2007-01-19 05:59:28,2007-01-19 05:59:28
53f94937f00d43f8a4d78437d88c99e4e7e51cf5...846394d2e2b41e0dd041ead98ed4832e0b0ee62a,1,4,4,8,2,2007-01-20 06:25:13,2007-01-20 06:25:13
846394d2e2b41e0dd041ead98ed4832e0b0ee62a...5b5930f0df72fbb55fc569cb523217a3b6916762,4,9,9,18,7,2007-01-20 06:32:08,2007-01-20 06:32:08
5b5930f0df72fbb55fc569cb523217a3b6916762...23b628d731b69b1cbdddc16417e109bdfe9497e1,7,51,38,89,33,2007-01-20 20:34:35,2007-01-20 20:34:35
23b628d731b69b1cbdddc16417e109bdfe9497e1...9c5e28e1e8c7bdd86a0fef58e8772552af6203e0,4,123,128,251,37,2007-01-20 21:16:31,2007-01-20 21:16:31
9c5e28e1e8c7bdd86a0fef58e8772552af6203e0...4e98d69be62723f00c52639a044c11b37b8d2dd3,1,5,1,6,2,2007-01-21 00:07:41,2007-01-21 00:07:41
4e98d69be62723f00c52639a044c11b37b8d2dd3...1fc252e087909de5ded3b579860ff6a06c844dfa,6,8,6,14,8,2007-01-21 00:20:18,2007-01-21 00:20:18
1fc252e087909de5ded3b579860ff6a06c844dfa...dd2f22faad2e46a3b5c6004afda4ea2c68e13a9c,2,0,31,31,4,2007-01-21 00:23:14,2007-01-21 00:23:14
dd2f22faad2e46a3b5c6004afda4ea2c68e13a9c...9fb548fdcd7af8fdbfca233a4d6938a724521e36,1,1,1,2,1,2007-01-21 00:33:58,2007-01-21 00:33:58
9fb548fdcd7af8fdbfca233a4d6938a724521e36...549985bcba3474f497114d5eec803edcd18b342f,2,62,1,63,3,2007-01-21 05:14:50,2007-01-21 05:14:50
549985bcba3474f497114d5eec803edcd18b342f...7895fa70eb733a12f0c8f8d114f0c2efc112515f,1,0,81,81,1,2007-01-21 05:35:04,2007-01-21 05:35:04
7895fa70eb733a12f0c8f8d114f0c2efc112515f...259f083c24b4af2532821c76d3b3cb959be29fc9,4,35,97,132,9,2007-01-21 06:44:04,2007-01-21 06:44:04
259f083c24b4af2532821c76d3b3cb959be29fc9...c93d1932fec26fb4f13ee0259628307f46fff41d,1,13,4,17,6,2007-01-22 06:12:24,2007-01-22 06:12:24
c93d1932fec26fb4f13ee0259628307f46fff41d...b98f9d0089efd74755f3a866defb7833a30422e4,2,55,30,85,16,2007-01-22 06:33:04,2007-01-22 06:33:04
b98f9d0089efd74755f3a866defb7833a30422e4...8c4c07b5d0f56c2f9359923606305141cf9be99c,3,43,12,55,6,2007-01-22 06:48:10,2007-01-22 06:48:10
8c4c07b5d0f56c2f9359923606305141cf9be99c...a670fccf79217405e34155319e03d1ed1e2e1390,10,133,45,178,32,2007-01-23 04:31:02,2007-01-23 04:31:02
a670fccf79217405e34155319e03d1ed1e2e1390...1707fb0d78577c7001fce0b939f2c3038ce136f5,1,1,1,2,1,2007-01-23 16:46:40,2007-01-23 16:46:40
1707fb0d78577c7001fce0b939f2c3038ce136f5...89f1f7bf2424e3ee1cee9057168f0f99400b5652,3,236,2,238,8,2007-01-23 20:24:20,2007-01-23 20:24:20
89f1f7bf2424e3ee1cee9057168f0f99400b5652...18ad7d6f8f17596cbefa11ac956cd24d5c269dd5,3,23,8,31,6,2007-01-23 20:26:35,2007-01-23 20:26:35
18ad7d6f8f17596cbefa11ac956cd24d5c269dd5...6cf4059eada7e681f35dc4b6d09e067298f2a9e9,1,6,0,6,1,2007-01-23 20:33:19,2007-01-23 20:33:19
6cf4059eada7e681f35dc4b6d09e067298f2a9e9...03dd1cedf61383f25b623c157459e4ffcc037822,1,0,1,1,1,2007-01-23 20:33:27,2007-01-23 20:33:27
03dd1cedf61383f25b623c157459e4ffcc037822...4e1e6722982ab0afc529e7324365bde8ce8477b6,1,2,2,4,2,2007-01-23 20:54:26,2007-01-23 20:54:26
4e1e6722982ab0afc529e7324365bde8ce8477b6...50fd13ca73655f17ed9a5ca3e335e7f4a688317f,1,1,1,2,1,2007-01-24 03:53:04,2007-01-24 03:53:04
50fd13ca73655f17ed9a5ca3e335e7f4a688317f...2301f9a89b21fe749215979bfbc664e39670b479,2,33,3,36,6,2007-01-24 05:24:07,2007-01-24 05:24:07
2301f9a89b21fe749215979bfbc664e39670b479...7d3ae27cacc341c468f0df0b03ea8ff83a3787f5,1,99,0,99,3,2007-01-24 05:25:02,2007-01-24 05:25:02
7d3ae27cacc341c468f0df0b03ea8ff83a3787f5...9df7ad46e769c57672ae172569b3e4682daac525,1,5,0,5,1,2007-01-24 05:26:48,2007-01-24 05:26:48
9df7ad46e769c57672ae172569b3e4682daac525...119d7b5674a87ee23e40a9cad7e6d23e0c1dca72,2,0,3,3,2,2007-01-24 05:38:29,2007-01-24 05:38:29
119d7b5674a87ee23e40a9cad7e6d23e0c1dca72...cb57d82cdee6bd6bcc4fadb835bbb506daf0d479,4,46,15,61,9,2007-01-24 17:18:21,2007-01-24 17:18:21
cb57d82cdee6bd6bcc4fadb835bbb506daf0d479...668671561dab5efa68f575997bf9d655174ee686,1,7,5,12,4,2007-01-24 17:58:20,2007-01-24 17:58:20
668671561dab5efa68f575997bf9d655174ee686...75a3617d7941ca9484bccab09221dcc51762701a,40,210,206,416,138,2007-01-25 02:15:39,2007-01-25 02:15:39
75a3617d7941ca9484bccab09221dcc51762701a...12ad69dbaafa0f3cac89c0703b97dd15fc27f5ef,1,1,1,2,1,2007-01-25 04:20:49,2007-01-25 04:20:49
12ad69dbaafa0f3cac89c0703b97dd15fc27f5ef...39e63513a8e74716d8fd98c23b6301e824c8e042,7,91,107,198,53,2007-01-25 18:05:10,2007-01-25 18:05:10
39e63513a8e74716d8fd98c23b6301e824c8e042...f2d2c64b978e2a509032248eef07aead48328bfa,1,0,1,1,1,2007-01-25 18:52:17,2007-01-25 18:52:17
f2d2c64b978e2a509032248eef07aead48328bfa...e7c6bd9da2eaa2c6915c83fb6c7b4e6e6bd53a52,5,129,34,163,26,2007-01-26 23:27:26,2007-01-26 23:27:26
e7c6bd9da2eaa2c6915c83fb6c7b4e6e6bd53a52...4d829c2e0e2589080096354f7d2e4e8c4fb7657c,2,22,1,23,3,2007-01-27 21:16:07,2007-01-27 21:16:07
4d829c2e0e2589080096354f7d2e4e8c4fb7657c...8b837ba33dcaa6497ed9a7ffe7466dddb3af0e73,7,253,50,303,46,2007-01-28 22:26:25,2007-01-28 22:26:25
8b837ba33dcaa6497ed9a7ffe7466dddb3af0e73...5d6745301e02aba86dfa4f6e61ada4eb3f44fe1d,3,18,18,36,18,2007-01-28 22:36:34,2007-01-28 22:36:34
5d6745301e02aba86dfa4f6e61ada4eb3f44fe1d...54d2c5442562e30b2d293de6d0fd12f5d75f8b87,3,4,3,7,3,2007-01-28 22:42:23,2007-01-28 22:42:23
54d2c5442562e30b2d293de6d0fd12f5d75f8b87...126c6cef5227ae91c2c3ea92eba220735e1bc411,5,31,18,49,13,2007-01-29 01:03:55,2007-01-29 01:03:55
126c6cef5227ae91c2c3ea92eba220735e1bc411...e6cd7fcacc37ad276dac75a24de8882c42bc8639,1,0,17,17,1,2007-01-29 01:27:57,2007-01-29 01:27:57
e6cd7fcacc37ad276dac75a24de8882c42bc8639...5b47d3b42aa8a5851839f26c003cc1bfdf6539be,4,26,10,36,10,2007-01-29 16:12:36,2007-01-29 16:12:36
5b47d3b42aa8a5851839f26c003cc1bfdf6539be...92e335549329919f978221b3ddced2814abde607,7,157,41,198,38,2007-02-02 20:06:20,2007-02-02 20:06:20
92e335549329919f978221b3ddced2814abde607...af908e2e8de7d2de216cdd6634520823e9041214,5,12,14,26,12,2007-02-02 20:37:10,2007-02-02 20:37:10
af908e2e8de7d2de216cdd6634520823e9041214...649423e81c07c1db654c24f6779068e1e9823002,42,672,67,739,113,2007-02-13 16:15:10,2007-02-13 16:15:10
649423e81c07c1db654c24f6779068e1e9823002...67e0248806e8adc03ddd81e9543f77b540ed1673,55,11134,2505,13639,1120,2007-02-20 00:41:14,2007-02-20 00:41:14
67e0248806e8adc03ddd81e9543f77b540ed1673...8f1fb6da3a2eaae0e8c2351266900c1ae9d36403,14,548,35,583,73,2007-02-25 05:50:24,2007-02-25 05:50:24
8f1fb6da3a2eaae0e8c2351266900c1ae9d36403...ced8ae18773d79f29ab1b44eab75f8381c9554e7,1,79,63,142,7,2007-02-25 06:38:24,2007-02-25 06:38:24
ced8ae18773d79f29ab1b44eab75f8381c9554e7...43829a95d3e5740250794a0b4400fd813e724a2e,3,0,69,69,5,2007-02-25 06:57:14,2007-02-25 06:57:14
43829a95d3e5740250794a0b4400fd813e724a2e...8a70334640b31229d53e982bd59d951fe15aecbc,12,116,20,136,28,2007-02-25 20:01:08,2007-02-25 20:01:08
8a70334640b31229d53e982bd59d951fe15aecbc...1bedf002a4273180857af63a1c85afd909d83c79,2,45,0,45,2,2007-02-25 20:14:38,2007-02-25 20:14:38
1bedf002a4273180857af63a1c85afd909d83c79...064e97dccb0009d15cbd4342c545e8314becaaf9,1,18,9,27,5,2007-02-25 20:27:41,2007-02-25 20:27:41
064e97dccb0009d15cbd4342c545e8314becaaf9...9c2f1ad89c0911ddebc730cebe9921d1fb5411d7,1,27,10,37,9,2007-02-25 20:35:32,2007-02-25 20:35:32
9c2f1ad89c0911ddebc730cebe9921d1fb5411d7...d353537f392ab6f6f95072ea05d2803f88aefd6a,2,20,2,22,3,2007-02-25 20:40:10,2007-02-25 20:40:10
d353537f392ab6f6f95072ea05d2803f88aefd6a...77bdc858451dda6e513272dcebdd49e676efc76f,5,19,13,32,4,2007-02-25 21:46:14,2007-02-25 21:46:14
77bdc858451dda6e513272dcebdd49e676efc76f...a9fafd521f13c62eec78c27414262deda62993d3,1,2,2,4,2,2007-02-25 22:01:20,2007-02-25 22:01:20
a9fafd521f13c62eec78c27414262deda62993d3...6df023007781e96fa1cfa8dfce0040cc9d7da871,69,6219,2829,9048,1317,2007-02-26 20:17:26,2007-02-26 20:17:26
6df023007781e96fa1cfa8dfce0040cc9d7da871...5e34ce97df3563883f1c0035e2150f90fe78ed30,8,329,13,342,16,2007-02-27 00:01:43,2007-02-27 00:01:43
5e34ce97df3563883f1c0035e2150f90fe78ed30...ff3423ca4cab29887f547189eaa1cf90a1988a6d,18,145,86,231,66,2007-02-28 05:09:20,2007-02-28 05:09:20
ff3423ca4cab29887f547189eaa1cf90a1988a6d...95e10baff25edfa08c8a75da4cb1aa7bb1f68d59,3,153,82,235,8,2007-02-28 05:59:05,2007-02-28 05:59:05
95e10baff25edfa08c8a75da4cb1aa7bb1f68d59...1f8d36bb5a39b09454e487d972b729f356f564f5,1,12,0,12,2,2007-02-28 06:04:46,2007-02-28 06:04:46
1f8d36bb5a39b09454e487d972b729f356f564f5...48c28437baf488df8b97aecfdbb93eadbda06027,0,0,0,0,0,2007-02-28 22:32:18,2007-02-28 22:32:18
48c28437baf488df8b97aecfdbb93eadbda06027...07b4925118e4f09f19f9243eaa990cb870d59425,0,0,0,0,0,2007-02-28 23:04:42,2007-02-28 23:04:42
07b4925118e4f09f19f9243eaa990cb870d59425...811163d24e66d9c1ab9dbb6f69aa368d35a13df8,0,0,0,0,0,2007-02-28 23:47:39,2007-02-28 23:47:39
811163d24e66d9c1ab9dbb6f69aa368d35a13df8...b0bbdc744d17565ae957ed9cad685c2dc47a3d84,19,2167,1606,3773,476,2007-03-01 00:07:42,2007-03-01 00:07:42
b0bbdc744d17565ae957ed9cad685c2dc47a3d84...508848805701ae11273dc814a7012ad608318ef1,80,8140,3272,11412,1130,2007-03-16 16:09:29,2007-03-16 16:09:29
508848805701ae11273dc814a7012ad608318ef1...25c15b17a86fa95b5374b9ef6366450b28a28b7a,1,2,2,4,2,2007-03-25 18:07:00,2007-03-25 18:07:00
25c15b17a86fa95b5374b9ef6366450b28a28b7a...132cf258cbdce8bac1d7a3d713c3927f43ead1ed,80,6270,2212,8482,943,2007-03-25 21:49:00,2007-03-25 21:49:00
132cf258cbdce8bac1d7a3d713c3927f43ead1ed...e2b49c379a56730b73d79ec05d6edc790ba08cc9,3,324,0,324,3,2007-03-28 04:31:06,2007-03-28 04:31:06
e2b49c379a56730b73d79ec05d6edc790ba08cc9...94aeccf18eca83ce8c983695059d56f66127a0fd,106,8878,5243,14121,1547,2007-04-06 04:39:24,2007-04-06 04:39:24
94aeccf18eca83ce8c983695059d56f66127a0fd...d7ed268dc5ab977f3c90b303ae6e8eb19f1662f4,1,7,0,7,1,2007-04-07 02:26:45,2007-04-07 02:26:45
d7ed268dc5ab977f3c90b303ae6e8eb19f1662f4...361b646b9edc26a4eb6a17b0e85ffc6d5f8bd2c1,1,65,4,69,10,2007-04-07 02:28:17,2007-04-07 02:28:17
361b646b9edc26a4eb6a17b0e85ffc6d5f8bd2c1...e03e0214789bedcbfdda1dd6b6bf07b1e1b9ba0b,1,5,13,18,5,2007-04-07 02:28:48,2007-04-07 02:28:48
e03e0214789bedcbfdda1dd6b6bf07b1e1b9ba0b...98a0aec0d05d654693a2ecfe849886e4f25e9fdc,1,5,2,7,2,2007-04-07 02:29:20,2007-04-07 02:29:20
98a0aec0d05d654693a2ecfe849886e4f25e9fdc...1df79c511533eb8000ae618778dd00ca632d916c,1,5,0,5,5,2007-04-07 04:22:33,2007-04-07 04:22:33
1df79c511533eb8000ae618778dd00ca632d916c...1cf0a2d7924a2ddf222ebdc63f824dab60f8f489,1,26,17,43,3,2007-04-07 04:33:45,2007-04-07 04:33:45
1cf0a2d7924a2ddf222ebdc63f824dab60f8f489...54950e5dad347ce49ff98647258bdb66b59fc307,1,38,22,60,8,2007-04-07 04:36:02,2007-04-07 04:36:02
54950e5dad347ce49ff98647258bdb66b59fc307...d6d173f8e1fab286522abf7764fcfeb1e87ef380,1,17,7,24,3,2007-04-07 04:36:58,2007-04-07 04:36:58
d6d173f8e1fab286522abf7764fcfeb1e87ef380...9cbaed5efc17cdcd3382a8e8127c44e22e2f79ab,1,12,4,16,2,2007-04-07 04:38:09,2007-04-07 04:38:09
9cbaed5efc17cdcd3382a8e8127c44e22e2f79ab...c1f84583de0993cba8f6a66008b59744e0ddc967,1,13,3,16,3,2007-04-07 04:39:05,2007-04-07 04:39:05
c1f84583de0993cba8f6a66008b59744e0ddc967...203f93a7aa9fbe04fa660c262ed2e730de437faf,3,530,266,796,15,2007-04-07 05:56:42,2007-04-07 05:56:42
203f93a7aa9fbe04fa660c262ed2e730de437faf...9963ce79b9560b6109ef917944fb30e6336435c5,16,242,53,295,41,2007-04-09 01:33:23,2007-04-09 01:33:23
9963ce79b9560b6109ef917944fb30e6336435c5...e8b2a8649fe73b8076574efa43e4e31a45d40406,1,8,1,9,4,2007-04-28 15:09:41,2007-04-28 15:09:41
e8b2a8649fe73b8076574efa43e4e31a45d40406...4938c8ea6db6f23ebb0883b8a092985344508b25,1,4,0,4,1,2007-04-28 15:45:36,2007-04-28 15:45:36
4938c8ea6db6f23ebb0883b8a092985344508b25...415e84ad53e0d0d8f7df87784c1893489bdbe0b8,217,20826,9743,30569,3797,2007-05-12 02:36:05,2007-05-12 02:36:05
415e84ad53e0d0d8f7df87784c1893489bdbe0b8...433659139596a75eab03940ea2029970de6ee287,28,3694,186,3880,166,2007-05-15 03:37:41,2007-05-15 03:37:41
433659139596a75eab03940ea2029970de6ee287...c2cdd2d4b43e65d0b7e900fd5e12f6abd4e1e29c,30,2970,1113,4083,480,2007-05-20 20:59:24,2007-05-20 20:59:24
c2cdd2d4b43e65d0b7e900fd5e12f6abd4e1e29c...3eab964332c221910641d7e8a493d287ef18faf3,3,84,74,158,24,2007-05-24 03:38:26,2007-05-24 03:38:26
3eab964332c221910641d7e8a493d287ef18faf3...659d99b7afda730180e80ea4d68a7d505b21ba86,41,5721,1625,7346,498,2007-05-24 04:00:19,2007-05-24 04:00:19
659d99b7afda730180e80ea4d68a7d505b21ba86...d34639b09bf85dfb1b6f9a4b59f8ccbc3117230b,52,2533,2092,4625,678,2007-06-07 21:49:06,2007-06-07 21:49:06
d34639b09bf85dfb1b6f9a4b59f8ccbc3117230b...fe5194ecfd8ad5ad27c6bddc10fa8c6837d290f6,1,19,6,25,3,2007-06-07 22:12:58,2007-06-07 22:12:58
fe5194ecfd8ad5ad27c6bddc10fa8c6837d290f6...ec622fc2a9e51f62c1b61027037b9dd9f1930966,8,366,15,381,34,2007-06-15 03:40:45,2007-06-15 03:40:45
ec622fc2a9e51f62c1b61027037b9dd9f1930966...d304ccad8c24e29b7328019b81e93f792af482d0,24,465,79,544,76,2007-06-15 04:02:33,2007-06-15 04:02:33
d304ccad8c24e29b7328019b81e93f792af482d0...5ffaf83ced81aef987772193e5d5c85047dec3a6,1,2,1,3,1,2007-06-15 04:48:07,2007-06-15 04:48:07
5ffaf83ced81aef987772193e5d5c85047dec3a6...c58ff68881376a58d1285e7cfd7de3e53766626a,1,5,5,10,3,2007-06-15 04:58:04,2007-06-15 04:58:04
c58ff68881376a58d1285e7cfd7de3e53766626a...a8687b5dc4c5e462b8740d574a25ab01c283cf4a,1,1,0,1,1,2007-06-15 15:34:39,2007-06-15 15:34:39
a8687b5dc4c5e462b8740d574a25ab01c283cf4a...7eb538fd46aafca50af9e67b34d89a4ffd668538,2,115,111,226,14,2007-06-20 06:09:33,2007-06-20 06:09:33
7eb538fd46aafca50af9e67b34d89a4ffd668538...d8411ca54d5bd0e58a53d220e510eeaf7730c92d,1,2,1,3,2,2007-06-20 06:11:28,2007-06-20 06:11:28
d8411ca54d5bd0e58a53d220e510eeaf7730c92d...7a981380def046f753ff70a7c25efcd781ff6ac6,2,1,1,2,1,2007-07-01 00:52:21,2007-07-01 00:52:21
7a981380def046f753ff70a7c25efcd781ff6ac6...6f4e933fcc78da11ec43214efd3472192030eced,105,13218,4572,17790,2091,2007-07-01 01:17:51,2007-07-01 01:17:51
6f4e933fcc78da11ec43214efd3472192030eced...49d25eec2cf8daf29243d6f0c765666453984dc8,1,4,1,5,2,2007-07-01 02:06:07,2007-07-01 02:06:07
49d25eec2cf8daf29243d6f0c765666453984dc8...761c02288ade1225026a770b30e6d78d02a4c578,1,1,1,2,1,2007-07-01 03:51:31,2007-07-01 03:51:31
761c02288ade1225026a770b30e6d78d02a4c578...bc80d9cfd8b88a3438840d4d4f3492155812811e,1,2,2,4,2,2007-07-01 04:34:39,2007-07-01 04:34:39
bc80d9cfd8b88a3438840d4d4f3492155812811e...3bdc14818f265ab0f26ddc93c1a3a9ce450e0c09,1,1,1,2,1,2007-07-01 04:42:46,2007-07-01 04:42:46
3bdc14818f265ab0f26ddc93c1a3a9ce450e0c09...836d2e759102d9a8db389dc2a07a9223a69d377d,1,4,4,8,4,2007-07-01 04:44:39,2007-07-01 04:44:39
836d2e759102d9a8db389dc2a07a9223a69d377d...7c10d695278f080c020585c2dd2089c3f0dcceff,4,25,15,40,11,2007-07-03 05:45:00,2007-07-03 05:45:00
7c10d695278f080c020585c2dd2089c3f0dcceff...48fc9e23425fab1ccf97b669050c1de359281ba2,1,2,2,4,2,2007-07-03 05:55:20,2007-07-03 05:55:20
48fc9e23425fab1ccf97b669050c1de359281ba2...160dac766c2cc5fd9bb71d5e97c5939c31bd7e35,1,2,2,4,2,2007-07-03 15:15:39,2007-07-03 15:15:39
160dac766c2cc5fd9bb71d5e97c5939c31bd7e35...7ed1a919681b5b028c3f6eef1a862ff91b66feb2,10,99,53,152,34,2007-07-03 16:03:51,2007-07-03 16:03:51
7ed1a919681b5b028c3f6eef1a862ff91b66feb2...1e747f98af99a23c5aff7b460d5b845c3a9e2013,205,7793,4596,12389,2075,2007-07-07 13:23:57,2007-07-07 13:23:57
1e747f98af99a23c5aff7b460d5b845c3a9e2013...a704a382924eb6d2936e5ac4521acacd485984fe,1,1,0,1,1,2007-07-07 13:57:58,2007-07-07 13:57:58
a704a382924eb6d2936e5ac4521acacd485984fe...83861364dd31063d8ff9169514c5f90a0c224482,221,10511,7479,17990,3286,2007-08-07 13:43:49,2007-08-07 13:43:49
83861364dd31063d8ff9169514c5f90a0c224482...571b1b8c11625b375e7268270b4fdf7dd021c7e1,0,0,0,0,0,2007-08-07 14:13:16,2007-08-07 14:13:16
571b1b8c11625b375e7268270b4fdf7dd021c7e1...4cc0d9375e742c68d1e1fe1ff77dfa8607c7985a,1,6,12,18,4,2007-08-07 15:17:35,2007-08-07 15:17:35
4cc0d9375e742c68d1e1fe1ff77dfa8607c7985a...0f92ac52cbf81fb2ac01755c558e2e6ad54700e8,4,16,11,27,12,2007-08-09 14:47:49,2007-08-09 14:47:49
0f92ac52cbf81fb2ac01755c558e2e6ad54700e8...fcec755f01cfaba2a85bfc9511876debbce98631,112,12241,6380,18621,1720,2007-08-17 15:05:54,2007-08-17 15:05:54
fcec755f01cfaba2a85bfc9511876debbce98631...28e350301f5b8f1c5d384241df5e1fc68d48c98b,1,47,44,91,5,2007-08-18 01:19:25,2007-08-18 01:19:25
28e350301f5b8f1c5d384241df5e1fc68d48c98b...549198b714ba0b032904639af0c388e739261fe6,10,866,45,911,42,2007-08-18 05:42:56,2007-08-18 05:42:56
549198b714ba0b032904639af0c388e739261fe6...0ae4e102dc60de49d8f1457373458082f6639086,2,2,1,3,2,2007-08-18 06:35:28,2007-08-18 06:35:28
0ae4e102dc60de49d8f1457373458082f6639086...c49f2d21ea055ae3c9b66cfd62a9f527a2f6d3b5,76,2338,1862,4200,322,2007-08-20 05:00:52,2007-08-20 05:00:52
c49f2d21ea055ae3c9b66cfd62a9f527a2f6d3b5...88987ed0ac6c29b78e2321e6f6687cb1385510fc,3,106,99,205,44,2007-08-20 13:24:10,2007-08-20 13:24:10
88987ed0ac6c29b78e2321e6f6687cb1385510fc...4a2abd003dbd620020863e8758dac2eadc84e32c,2,5,3,8,5,2007-08-24 11:39:20,2007-08-24 11:39:20
4a2abd003dbd620020863e8758dac2eadc84e32c...68b7bbb2624eedc9107a3246b1d7c11b12709605,3,102,98,200,10,2007-08-24 12:54:00,2007-08-24 12:54:00
68b7bbb2624eedc9107a3246b1d7c11b12709605...5303028b32fd5c8b8febc9907a70b637ce020e39,1,18,2,20,5,2007-08-24 13:16:01,2007-08-24 13:16:01
5303028b32fd5c8b8febc9907a70b637ce020e39...a29582a1d994f3294bee0156cba328f8e19685ee,1,2,2,4,2,2007-08-24 13:38:10,2007-08-24 13:38:10
a29582a1d994f3294bee0156cba328f8e19685ee...a6784e6821b284c2f9e7b0def4fdb8cbe1b832fd,1,3,3,6,3,2007-08-24 14:27:07,2007-08-24 14:27:07
a6784e6821b284c2f9e7b0def4fdb8cbe1b832fd...22e160945a38f82c7e30f7137b3fcac9dd778fba,24,304,89,393,65,2007-08-25 23:31:05,2007-08-25 23:31:05
22e160945a38f82c7e30f7137b3fcac9dd778fba...20219e9fb6d996a0a62db914f81bec04fbe92c8b,1,7,5,12,4,2007-08-25 23:34:42,2007-08-25 23:34:42
20219e9fb6d996a0a62db914f81bec04fbe92c8b...2a45bdf9acc7bd057ece6ad9367a335437726fd9,1,2,3,5,2,2007-08-30 05:33:45,2007-08-30 05:33:45
2a45bdf9acc7bd057ece6ad9367a335437726fd9...7405446b2e7ab27a40d768edbc928f66f9da5652,5,10,9,19,9,2007-08-31 05:43:21,2007-08-31 05:43:21
7405446b2e7ab27a40d768edbc928f66f9da5652...2db132ebb75f3b1c64d4415de23bd0781055d534,1,7,3,10,3,2007-08-31 05:53:47,2007-08-31 05:53:47
2db132ebb75f3b1c64d4415de23bd0781055d534...bd01c6ee5703f8efec06f65374c7961458de6ea6,1,3,2,5,3,2007-09-02 20:06:22,2007-09-02 20:06:22
bd01c6ee5703f8efec06f65374c7961458de6ea6...976acdc7743180993dc8257f5d256206857e8160,28,431,176,607,97,2007-09-05 20:01:24,2007-09-05 20:01:24
976acdc7743180993dc8257f5d256206857e8160...ff2a2884a15ddd23d7414497341905c56023abac,2,7,1,8,3,2007-09-07 02:32:03,2007-09-07 02:32:03
ff2a2884a15ddd23d7414497341905c56023abac...f06b35376e2d6d5bc1baa8c76f940ab40b4b530c,1,1,1,2,1,2007-09-07 02:39:18,2007-09-07 02:39:18
f06b35376e2d6d5bc1baa8c76f940ab40b4b530c...6aba7b25d9fc5258343a5a2fba134ad230f27908,1,1,0,1,1,2007-09-07 02:43:02,2007-09-07 02:43:02
6aba7b25d9fc5258343a5a2fba134ad230f27908...016f84ba34793bf5ee0c29f3f4daf54f152d7348,1,0,2,2,2,2007-09-07 02:45:32,2007-09-07 02:45:32
016f84ba34793bf5ee0c29f3f4daf54f152d7348...a3ecc33ed2a5eabd5cb4534555364f3f0d9ca931,1,1,1,2,1,2007-09-07 03:11:31,2007-09-07 03:11:31
a3ecc33ed2a5eabd5cb4534555364f3f0d9ca931...d9fb3fed869322298518e6d662b3ae56f2054788,4,118,95,213,37,2007-09-09 19:10:52,2007-09-09 19:10:52
d9fb3fed869322298518e6d662b3ae56f2054788...4ccc5ff3e19ce6bb7e1f1cc278a44bc8daee9d85,2,2,19,21,2,2007-09-09 19:12:43,2007-09-09 19:12:43
4ccc5ff3e19ce6bb7e1f1cc278a44bc8daee9d85...c05527dd609c26e4788df7eebb003c82033199e7,2,5,3,8,4,2007-09-09 19:15:01,2007-09-09 19:15:01
c05527dd609c26e4788df7eebb003c82033199e7...b5aa61a325136d6484ccbfc8a0efd98e8aaa964a,3,94,76,170,34,2007-09-10 00:27:48,2007-09-10 00:27:48
b5aa61a325136d6484ccbfc8a0efd98e8aaa964a...52578a1d1d06195bf0d4700ba44247833290ffef,27,504,263,767,160,2007-09-10 02:29:42,2007-09-10 02:29:42
52578a1d1d06195bf0d4700ba44247833290ffef...f892464d58c4029e71f4ee0b4df08a724004d4eb,6,80,66,146,33,2007-09-11 11:46:34,2007-09-11 11:46:34
f892464d58c4029e71f4ee0b4df08a724004d4eb...4046a617935c1fa1e25d998b706af54f8ef92eef,3,4,4,8,4,2007-09-12 01:22:13,2007-09-12 01:22:13
4046a617935c1fa1e25d998b706af54f8ef92eef...35be27874b6a77471bd039b57a8d2004ab545d20,1,16,6,22,3,2007-09-12 01:29:41,2007-09-12 01:29:41
35be27874b6a77471bd039b57a8d2004ab545d20...3d85b2748d7a267e1cc6f11f37a2c5e74e0cc38c,2,2,1,3,2,2007-09-12 01:30:50,2007-09-12 01:30:50
3d85b2748d7a267e1cc6f11f37a2c5e74e0cc38c...addbe83dccd234f66a120c8abfef6d1e921cf7c3,1,48,19,67,11,2007-09-12 01:34:25,2007-09-12 01:34:25
addbe83dccd234f66a120c8abfef6d1e921cf7c3...dc63fc7b4b33fe762c5c574baa7685306e4433c4,1,1,1,2,1,2007-09-12 01:36:16,2007-09-12 01:36:16
dc63fc7b4b33fe762c5c574baa7685306e4433c4...dae251584e0334854a664663337925b79cb7a88f,1,3,2,5,2,2007-09-12 01:37:39,2007-09-12 01:37:39
dae251584e0334854a664663337925b79cb7a88f...fa717906688d544478581d17e6d521b2fd29815d,1,1,0,1,1,2007-09-12 02:23:59,2007-09-12 02:23:59
fa717906688d544478581d17e6d521b2fd29815d...76473864b55c33b27651d79efa174c8db8318cbb,2,91,0,91,1,2007-09-12 02:44:27,2007-09-12 02:44:27
76473864b55c33b27651d79efa174c8db8318cbb...8bc950bcf580b936aea644097719493564468695,3,8,9,17,6,2007-09-12 03:13:30,2007-09-12 03:13:30
8bc950bcf580b936aea644097719493564468695...1ca016a08457e2211352f447f85e13871b041238,8,129,162,291,9,2007-09-13 08:36:04,2007-09-13 08:36:04
1ca016a08457e2211352f447f85e13871b041238...94f2ab53edfcb0350a11382b3928c63ac2d9fb90,1,0,2,2,2,2007-09-13 18:00:23,2007-09-13 18:00:23
94f2ab53edfcb0350a11382b3928c63ac2d9fb90...29153bd5b6787cc1a4268f480c2bbc6f7195fd37,1,1,1,2,1,2007-09-13 18:06:01,2007-09-13 18:06:01
29153bd5b6787cc1a4268f480c2bbc6f7195fd37...d5ed482d6008c1e5826ab7426e87313e224b4f02,2,3,3,6,3,2007-09-14 04:00:12,2007-09-14 04:00:12
d5ed482d6008c1e5826ab7426e87313e224b4f02...337f19828f1d3dc480464409ff0bdc1190abc1ac,1,4,0,4,1,2007-09-14 19:28:14,2007-09-14 19:28:14
337f19828f1d3dc480464409ff0bdc1190abc1ac...276c941d08ba891940954d3c43c63b5b760e17a0,1,1,1,2,1,2007-09-14 19:30:03,2007-09-14 19:30:03
276c941d08ba891940954d3c43c63b5b760e17a0...64b9123b7a3a154d7d5f730048ae1de7b430e0a5,2,15,15,30,10,2007-09-14 21:13:07,2007-09-14 21:13:07
64b9123b7a3a154d7d5f730048ae1de7b430e0a5...5ec5814bf97844db349b0e418668cc4c3edfbea4,3,40,1,41,2,2007-09-14 22:20:54,2007-09-14 22:20:54
5ec5814bf97844db349b0e418668cc4c3edfbea4...cead4bada947f163e928e5f41cedb5e22defb743,2,12,4,16,3,2007-09-14 22:41:09,2007-09-14 22:41:09
cead4bada947f163e928e5f41cedb5e22defb743...b28be9b04d2898187a7692d6da7330dbbe448f56,1,1,1,2,1,2007-09-14 23:03:34,2007-09-14 23:03:34
b28be9b04d2898187a7692d6da7330dbbe448f56...f68769e1c6c5cf1ac5d3a338380c352d922febda,3,74,11,85,11,2007-09-15 18:13:50,2007-09-15 18:13:50
f68769e1c6c5cf1ac5d3a338380c352d922febda...ccd8fb0d8587d4c2723632e482e470ccd5067e24,1,4,0,4,1,2007-09-15 18:38:27,2007-09-15 18:38:27
ccd8fb0d8587d4c2723632e482e470ccd5067e24...c3fe6d805a35b5b55f53f9a97189c0746d847f52,4,35,7,42,8,2007-09-15 18:53:31,2007-09-15 18:53:31
c3fe6d805a35b5b55f53f9a97189c0746d847f52...1413f02d847f5c75e22a96f07596a96fb22e8480,1,1,0,1,1,2007-09-15 18:55:27,2007-09-15 18:55:27
1413f02d847f5c75e22a96f07596a96fb22e8480...84fd07f097aac62ff1ede0b81757e4be8182ec24,3,1,334,335,2,2007-09-15 19:37:12,2007-09-15 19:37:12
84fd07f097aac62ff1ede0b81757e4be8182ec24...aff1c2aa96df00da61d0335c05bc592bffd29e32,1,3,3,6,3,2007-09-15 19:48:08,2007-09-15 19:48:08
aff1c2aa96df00da61d0335c05bc592bffd29e32...0f0f6a79576e55e52cbf724b5b496b6d9936109d,3,14,12,26,13,2007-09-15 19:56:59,2007-09-15 19:56:59
0f0f6a79576e55e52cbf724b5b496b6d9936109d...3534c4cf39453654130f3b3feb89dd8edafad1b5,3,12,14,26,13,2007-09-15 19:58:54,2007-09-15 19:58:54
3534c4cf39453654130f3b3feb89dd8edafad1b5...709f801877b490f1a1c916b29fef4a21f23ac733,1,2,2,4,1,2007-09-15 19:59:52,2007-09-15 19:59:52
709f801877b490f1a1c916b29fef4a21f23ac733...96e60ff79cb8642ef22b0817bf2e45ab1fe2b329,2,12,10,22,12,2007-09-15 20:01:25,2007-09-15 20:01:25
96e60ff79cb8642ef22b0817bf2e45ab1fe2b329...a922c20902f3ecf52fcb9f1b10bc89613d6d3a77,1,12,0,12,1,2007-09-15 20:05:25,2007-09-15 20:05:25
a922c20902f3ecf52fcb9f1b10bc89613d6d3a77...e51a819595cbb5f2b142a995d766820c1e1fa661,1,2,2,4,2,2007-09-15 20:23:38,2007-09-15 20:23:38
e51a819595cbb5f2b142a995d766820c1e1fa661...0b1febe2480b6507621cf7bc6d727b0514a53ea1,1,55,2,57,1,2007-09-15 20:28:26,2007-09-15 20:28:26
0b1febe2480b6507621cf7bc6d727b0514a53ea1...b2669113821eeb8b3cd654bbf5ab33053894b923,1,31,8,39,9,2007-09-15 20:53:19,2007-09-15 20:53:19
b2669113821eeb8b3cd654bbf5ab33053894b923...019e3c61e4390b0e5ad981256d6426e24083626a,191,25506,10809,36315,3550,2007-09-15 22:25:52,2007-09-15 22:25:52
019e3c61e4390b0e5ad981256d6426e24083626a...0de9a6490577432b9d6204097ac22f57d9c60981,58,1106,173,1279,123,2007-09-17 15:49:03,2007-09-17 15:49:03
0de9a6490577432b9d6204097ac22f57d9c60981...b94ae3b783b97e5bd5c10aa88da70e746d7d313c,1,0,3,3,3,2007-09-17 15:58:07,2007-09-17 15:58:07
b94ae3b783b97e5bd5c10aa88da70e746d7d313c...cb5dc33ce5a87caff9d6a4a7d770a2737db397ec,1,6,0,6,2,2007-09-24 23:23:54,2007-09-24 23:23:54
cb5dc33ce5a87caff9d6a4a7d770a2737db397ec...afb8f0a61969dff6450cd296be5eac2a5693ecd9,0,0,0,0,0,2007-09-24 23:34:32,2007-09-24 23:34:32
afb8f0a61969dff6450cd296be5eac2a5693ecd9...609eaf130d2d9eac109aefa59bfced32b67b9eb1,86,7203,6411,13614,200,2007-09-25 00:08:38,2007-09-25 00:08:38
609eaf130d2d9eac109aefa59bfced32b67b9eb1...9687447e3139d0f80619900c4f08d763ca8b0aa2,2,14,5,19,5,2007-09-25 01:51:22,2007-09-25 01:51:22
9687447e3139d0f80619900c4f08d763ca8b0aa2...b40f9b63bb6900689e6052052f620d6447ec63e5,2,111,24,135,21,2007-09-25 02:42:26,2007-09-25 02:42:26
b40f9b63bb6900689e6052052f620d6447ec63e5...d5da0a5a23fdbcbab46e4965053fc3f9c12f95dd,1,3,3,6,1,2007-09-25 02:51:32,2007-09-25 02:51:32
d5da0a5a23fdbcbab46e4965053fc3f9c12f95dd...f8d672ad2b22aecb2d416d6c1edfa524f4298a79,1,0,1,1,1,2007-09-25 16:06:35,2007-09-25 16:06:35
f8d672ad2b22aecb2d416d6c1edfa524f4298a79...a83d1e9ceb103090e6aa2b0b1319d372a9b91270,1,4,0,4,1,2007-09-26 04:36:33,2007-09-26 04:36:33
a83d1e9ceb103090e6aa2b0b1319d372a9b91270...cc1d4c06c53c703eb77b3a9e9ed2c55ca2017cec,3,22,0,22,3,2007-10-06 22:21:49,2007-10-06 22:21:49
cc1d4c06c53c703eb77b3a9e9ed2c55ca2017cec...4e3eb6ed5f9b7b74b47b33439dde7995e08d5933,1,0,2,2,1,2007-10-06 22:31:31,2007-10-06 22:31:31
4e3eb6ed5f9b7b74b47b33439dde7995e08d5933...6104f6bd856a36e41352d3b90e7a550ef276daab,27,290,122,412,81,2007-10-06 22:34:48,2007-10-06 22:34:48
6104f6bd856a36e41352d3b90e7a550ef276daab...534d059e9545bf24e458121799b20ad9ff8b7247,2,27,32,59,8,2007-10-10 02:48:26,2007-10-10 02:48:26
534d059e9545bf24e458121799b20ad9ff8b7247...7c70956810a02ca2dc2627ae3c7a8369a817aa41,1,24,15,39,5,2007-10-13 06:54:14,2007-10-13 06:54:14
7c70956810a02ca2dc2627ae3c7a8369a817aa41...11b6e1eeb788e8679a6d6d42944471aa3998819d,1,0,2,2,1,2007-10-13 07:28:18,2007-10-13 07:28:18
11b6e1eeb788e8679a6d6d42944471aa3998819d...1746760500a3232e7752626fc33deda7f6b74862,99,12093,9397,21490,2950,2007-10-26 20:21:10,2007-10-26 20:21:10
1746760500a3232e7752626fc33deda7f6b74862...94954862d5e6c03b66aaa9775e44fa1d0c05e20f,3,422,0,422,3,2007-10-26 20:35:16,2007-10-26 20:35:16
94954862d5e6c03b66aaa9775e44fa1d0c05e20f...99e8171a610389e295a83b6f69b4e4d442984a2f,1,1,1,2,1,2007-11-06 02:38:12,2007-11-06 02:38:12
99e8171a610389e295a83b6f69b4e4d442984a2f...6f15904669f884de75dbd4cc2b2e03880d81a9a8,3,285,31,316,16,2007-11-06 21:53:15,2007-11-06 21:53:15
6f15904669f884de75dbd4cc2b2e03880d81a9a8...e29358827d1a384bac2f4590e113fc681796080a,46,1774,473,2247,317,2007-11-06 22:25:59,2007-11-06 22:25:59
e29358827d1a384bac2f4590e113fc681796080a...8b3d65e517f3127ff8929ba4caaea32937fb776b,1,1,1,2,1,2007-11-07 06:36:24,2007-11-07 06:36:24
8b3d65e517f3127ff8929ba4caaea32937fb776b...4d52c80dd1b4c6aef9407b268ae720eeffd4d962,29,3686,2181,5867,851,2007-11-30 04:32:25,2007-11-30 04:32:25
4d52c80dd1b4c6aef9407b268ae720eeffd4d962...c82b2becf2bffe8ad18827b80a6c12433f799660,1,1,1,2,1,2007-11-30 05:07:28,2007-11-30 05:07:28
c82b2becf2bffe8ad18827b80a6c12433f799660...f88babafc58eafece72d3f2f7444336c69196808,50,1184,310,1494,292,2007-11-30 05:50:44,2007-11-30 05:50:44
f88babafc58eafece72d3f2f7444336c69196808...c81b01e060ad80a5c4df579a96ff737df2d336b3,94,6836,3922,10758,1548,2007-11-30 06:23:24,2007-11-30 06:23:24
c81b01e060ad80a5c4df579a96ff737df2d336b3...17dbd788b3c94ee286eba9318d4071fa386c78a6,1,2,2,4,2,2007-11-30 17:53:34,2007-11-30 17:53:34
17dbd788b3c94ee286eba9318d4071fa386c78a6...fcb30a11d8c289632c271d1c4b9993d7ee4c2b9b,6,51,11,62,13,2007-11-30 20:55:26,2007-11-30 20:55:26
fcb30a11d8c289632c271d1c4b9993d7ee4c2b9b...d0c49bfc60ce1f33f1bb1908482a0ee4e99d6525,4,15,12,27,11,2007-11-30 23:48:35,2007-11-30 23:48:35
d0c49bfc60ce1f33f1bb1908482a0ee4e99d6525...31e9b26d45f3cf262914a2c1f34fdb78c8161a81,1,1,1,2,1,2007-12-01 16:39:28,2007-12-01 16:39:28
31e9b26d45f3cf262914a2c1f34fdb78c8161a81...b897adb8a43a46c84c9f00874ad38e3c00be7583,3,15,13,28,9,2007-12-01 18:25:51,2007-12-01 18:25:51
b897adb8a43a46c84c9f00874ad38e3c00be7583...2d98a8391834421fba7dfb09be501524b70f9fc2,1,1,0,1,1,2007-12-01 19:33:49,2007-12-01 19:33:49
2d98a8391834421fba7dfb09be501524b70f9fc2...8e2dfebc7233f6e47786e20314ee684afd0a0fa1,3,37,31,68,7,2007-12-01 20:51:53,2007-12-01 20:51:53
8e2dfebc7233f6e47786e20314ee684afd0a0fa1...42bd0c6ebac19d16e983bd8bf17970feab8ce229,2,64,76,140,2,2007-12-01 20:57:15,2007-12-01 20:57:15
42bd0c6ebac19d16e983bd8bf17970feab8ce229...e4910ce5b720a0535837327c5ee7a0255c819d56,1,3,2,5,3,2007-12-02 18:13:59,2007-12-02 18:13:59
e4910ce5b720a0535837327c5ee7a0255c819d56...b15703d32205b91b1978013612321b8f1f5bf3ae,3,53,3,56,9,2007-12-02 18:14:11,2007-12-02 18:14:11
b15703d32205b91b1978013612321b8f1f5bf3ae...081d0ed8892e6a3e647b9a5a7ab83cb305034fdb,2,22,48,70,19,2007-12-02 18:22:36,2007-12-02 18:22:36
081d0ed8892e6a3e647b9a5a7ab83cb305034fdb...f0a54c02406730a51298dd14cd5bb212d7ee8e94,1,4,4,8,4,2007-12-02 18:32:23,2007-12-02 18:32:23
f0a54c02406730a51298dd14cd5bb212d7ee8e94...d326b6f6032b5248912ce48edeaa57266b22538e,1,1,1,2,1,2007-12-02 18:35:55,2007-12-02 18:35:55
d326b6f6032b5248912ce48edeaa57266b22538e...22aa9db4a22d848011775af7007d3c1f8772e056,1,3,4,7,3,2007-12-02 18:40:34,2007-12-02 18:40:34
22aa9db4a22d848011775af7007d3c1f8772e056...c68f751f8c376a1dbcb51760e3b475392af7adba,96,3161,1238,4399,315,2007-12-03 17:37:33,2007-12-03 17:37:33
c68f751f8c376a1dbcb51760e3b475392af7adba...3f494f18231a369677104d408af775520823228a,2,12,7,19,7,2007-12-06 05:00:37,2007-12-06 05:00:37
3f494f18231a369677104d408af775520823228a...f4c7a0dcb66d21987837ba6d4b4f192b15d39816,96,1609,976,2585,694,2007-12-19 05:20:55,2007-12-19 05:20:55
f4c7a0dcb66d21987837ba6d4b4f192b15d39816...c79babb4887404fccaf0e28b58651cfe2052f218,1,1,2,3,2,2008-01-02 05:26:41,2008-01-02 05:26:41
c79babb4887404fccaf0e28b58651cfe2052f218...c080e441f347ad252be5e2d4dc56e9f43fce88cc,1,2,0,2,1,2008-01-02 05:30:34,2008-01-02 05:30:34
c080e441f347ad252be5e2d4dc56e9f43fce88cc...daa467d79ec7b40e376294eabc51222a67690181,49,5292,2773,8065,1321,2008-01-17 18:12:24,2008-01-17 18:12:24
daa467d79ec7b40e376294eabc51222a67690181...7c1242a7a3a62bc63715bc47400827d4cf3c5e05,84,22763,10164,32927,3704,2008-02-15 17:05:48,2008-02-15 17:05:48
7c1242a7a3a62bc63715bc47400827d4cf3c5e05...397199c577fdf6b4a890a6d4c4e5eb010000a109,1,0,3,3,1,2008-02-17 03:21:37,2008-02-17 03:21:37
397199c577fdf6b4a890a6d4c4e5eb010000a109...3d61eb4dae02998eed6a2d9194906959a0b91bec,2,13,5,18,6,2008-02-29 05:41:32,2008-02-29 05:41:32
3d61eb4dae02998eed6a2d9194906959a0b91bec...ea78533a288ecb2174ba83dff7654f06793dd8b9,1,3,3,6,1,2008-02-29 06:25:04,2008-02-29 06:25:04
ea78533a288ecb2174ba83dff7654f06793dd8b9...61b9c8fe005d6d2a5a907b4402ce09b4b8153dad,1,3,1,4,3,2008-02-29 21:39:13,2008-02-29 21:39:13
61b9c8fe005d6d2a5a907b4402ce09b4b8153dad...ba2d0feb72c5df4f72b92a3ccf39436f6fbdaee3,10,417,161,578,57,2008-03-03 20:37:41,2008-03-03 20:37:41
ba2d0feb72c5df4f72b92a3ccf39436f6fbdaee3...a88c887631d551aca6176cd31b8a97a15fad8665,1,0,1,1,1,2008-03-04 00:18:31,2008-03-04 00:18:31
a88c887631d551aca6176cd31b8a97a15fad8665...fb3994bdfc296701ed156adbba9e898e17fa1c03,1,1,3,4,1,2008-03-05 03:56:20,2008-03-05 03:56:20
fb3994bdfc296701ed156adbba9e898e17fa1c03...dac6f2d37b3b1447cd1aced0567be3b361551dfb,1,6,8,14,2,2008-03-05 04:09:35,2008-03-05 04:09:35
dac6f2d37b3b1447cd1aced0567be3b361551dfb...ac4f5efc4f8dbbb85b43c17e605cf699e89e0dff,1,1,1,2,1,2008-03-10 17:50:30,2008-03-10 17:50:30
ac4f5efc4f8dbbb85b43c17e605cf699e89e0dff...9d4db678f4f979e5bc1ae0a1cd3e4e86b72760e7,2,3,2,5,2,2008-03-10 18:08:30,2008-03-10 18:08:30
9d4db678f4f979e5bc1ae0a1cd3e4e86b72760e7...997f281a03f3b76d492f2e4d0ab8f0ccee155c7a,1,1,0,1,1,2008-03-11 19:43:05,2008-03-11 19:43:05
997f281a03f3b76d492f2e4d0ab8f0ccee155c7a...304642769c5e0e704d0204bc241574c8c491cdf5,1,1,1,2,1,2008-03-11 22:02:11,2008-03-11 22:02:11
304642769c5e0e704d0204bc241574c8c491cdf5...bfc5660c472ac2e52cc4fdec78315c87b01357de,92,11903,3267,15170,1640,2008-03-13 06:14:26,2008-03-13 06:14:26
bfc5660c472ac2e52cc4fdec78315c87b01357de...40d55238b86ce88d6fa392c931ad3726dd5c66eb,5,81,54,135,6,2008-03-17 15:43:04,2008-03-17 15:43:04
40d55238b86ce88d6fa392c931ad3726dd5c66eb...93c45b570427b0a0f875a6f551d229f20e2ac5ee,11,626,507,1133,162,2008-03-17 17:55:16,2008-03-17 17:55:16
93c45b570427b0a0f875a6f551d229f20e2ac5ee...e9982047655485d3d38691e5074deff7d3a4d659,2,3,3,6,3,2008-03-17 19:01:36,2008-03-17 19:01:36
e9982047655485d3d38691e5074deff7d3a4d659...46783a0db8af24dda09ab5b2988d018fd0e57b65,1,2,0,2,2,2008-03-17 19:21:12,2008-03-17 19:21:12
46783a0db8af24dda09ab5b2988d018fd0e57b65...c323623361ba7c62c78413e43e1c8e745863013a,3,35,91,126,33,2008-03-17 23:51:23,2008-03-17 23:51:23
c323623361ba7c62c78413e43e1c8e745863013a...7aa851c05d80ef75581975939ff5c48b87bcae08,1,5,0,5,1,2008-03-18 00:50:15,2008-03-18 00:50:15
7aa851c05d80ef75581975939ff5c48b87bcae08...1d46d20038a8473fc2e75f832c770f17d558d0fc,261,6656,3437,10093,1575,2008-03-22 19:20:19,2008-03-22 19:20:19
1d46d20038a8473fc2e75f832c770f17d558d0fc...937c6e1054d6d561b585abe1040a401dac3941ce,3,28,14,42,14,2008-03-24 23:46:24,2008-03-24 23:46:24
937c6e1054d6d561b585abe1040a401dac3941ce...8cbcc7152b307b39bfd45a6b3e695bc5ab87b300,2,21,0,21,3,2008-03-27 02:55:45,2008-03-27 02:55:45
8cbcc7152b307b39bfd45a6b3e695bc5ab87b300...10f86fd1eecc405ced4d6e97e10b0f5306b83253,3,29,3,32,3,2008-03-27 04:20:21,2008-03-27 04:20:21
10f86fd1eecc405ced4d6e97e10b0f5306b83253...1ed686986b72d31f88028d81b44af461e02b2d6b,2,2,2,4,2,2008-03-27 05:23:41,2008-03-27 05:23:41
1ed686986b72d31f88028d81b44af461e02b2d6b...7822a0639fd029e98e0d6a9d4f2c182f719f8d81,33,1126,720,1846,408,2008-03-29 07:40:20,2008-03-29 07:40:20
7822a0639fd029e98e0d6a9d4f2c182f719f8d81...e7e5fecbe0908ef70196b0a77848ae492d4c01f0,2,2,1,3,2,2008-03-29 19:29:57,2008-03-29 19:29:57
e7e5fecbe0908ef70196b0a77848ae492d4c01f0...b2b6fb6b0704b8c788479c92f34bdababcb25054,1,52,0,52,1,2008-03-30 23:54:44,2008-03-30 23:54:44
b2b6fb6b0704b8c788479c92f34bdababcb25054...613c391461cec08786c6ecfdfb287c740d47b1e4,3,27,8,35,5,2008-03-30 23:54:55,2008-03-30 23:54:55
613c391461cec08786c6ecfdfb287c740d47b1e4...2b28a32ab6db730faafb09ae7226b0a6358b5c6e,1,0,52,52,1,2008-03-30 23:57:28,2008-03-30 23:57:28
2b28a32ab6db730faafb09ae7226b0a6358b5c6e...85471641f1c56a4fc5eaf9cc0e00ead64e447f59,1,1,1,2,1,2008-03-31 15:37:09,2008-03-31 15:37:09
85471641f1c56a4fc5eaf9cc0e00ead64e447f59...de072d889d1372ef3474ec44dc953cb4af501e06,1,2,0,2,1,2008-03-31 21:04:54,2008-03-31 21:04:54
de072d889d1372ef3474ec44dc953cb4af501e06...04932c6f1649672a6d09fa8eff4ef99e6af8aaac,1,1,1,2,1,2008-04-16 19:48:14,2008-04-16 19:48:14
04932c6f1649672a6d09fa8eff4ef99e6af8aaac...0f5ffbf23ea85117b04bee0a5fae721ff18e55c1,29,9805,4812,14617,1951,2008-04-18 23:53:24,2008-04-18 23:53:24
0f5ffbf23ea85117b04bee0a5fae721ff18e55c1...7b7f4bdee251459760184e879be8faeca719ab01,1,9,9,18,5,2008-04-23 16:02:25,2008-04-23 16:02:25
7b7f4bdee251459760184e879be8faeca719ab01...3f76c2a3612be39e0363fc5c59fc99a036449234,1,1,1,2,1,2008-04-23 16:31:48,2008-04-23 16:31:48
3f76c2a3612be39e0363fc5c59fc99a036449234...be9f09539caf4b9822426eb19bde9dfbc8e19550,69,9662,3387,13049,945,2008-04-27 11:49:03,2008-04-27 11:49:03
be9f09539caf4b9822426eb19bde9dfbc8e19550...be4e86943e51a610aeac6482b22f7a93b1299776,1,5,1,6,2,2008-04-27 15:31:55,2008-04-27 15:31:55
be4e86943e51a610aeac6482b22f7a93b1299776...678b9a6f5a0dfdf571e6dc66ade5521314047deb,1,1,1,2,1,2008-04-27 22:37:50,2008-04-27 22:37:50
678b9a6f5a0dfdf571e6dc66ade5521314047deb...738e6d986ba41ec5ef9ba5a600a333916f2e763d,8,45,48,93,26,2008-04-28 04:28:59,2008-04-28 04:28:59
738e6d986ba41ec5ef9ba5a600a333916f2e763d...886005078d66bd779ad3d6434d5699fbc17cfed1,9,134,13,147,20,2008-04-28 14:43:46,2008-04-28 14:43:46
886005078d66bd779ad3d6434d5699fbc17cfed1...0ce76a92f37ffd718fed98296c0cd2cecfaa6993,2,8,0,8,2,2008-04-29 01:09:53,2008-04-29 01:09:53
0ce76a92f37ffd718fed98296c0cd2cecfaa6993...c9c714f0f89170ab43b9bb6e5c0ea1f3183301de,1,15,0,15,1,2008-04-29 04:16:04,2008-04-29 04:16:04
c9c714f0f89170ab43b9bb6e5c0ea1f3183301de...95dcdf473ed08f03040334d716c4e60c2a41e57c,2,29,0,29,2,2008-04-29 04:31:59,2008-04-29 04:31:59
95dcdf473ed08f03040334d716c4e60c2a41e57c...abb7a7ff0fa9440d833434a52328f56ab0c425e3,4,80,35,115,18,2008-04-29 05:45:46,2008-04-29 05:45:46
abb7a7ff0fa9440d833434a52328f56ab0c425e3...2bd053631a5ae7bf6ebf35bdbcb20fff3577206f,1,3,2,5,2,2008-04-29 17:05:36,2008-04-29 17:05:36
2bd053631a5ae7bf6ebf35bdbcb20fff3577206f...6b6778ac46fcedf5643a62b4e962df16b862ba91,2,40,0,40,3,2008-05-05 17:28:34,2008-05-05 17:28:34
6b6778ac46fcedf5643a62b4e962df16b862ba91...be31882eee70529b8a85ecefbeb20f7ecc0f1fd1,2,25,0,25,3,2008-05-05 17:31:23,2008-05-05 17:31:23
be31882eee70529b8a85ecefbeb20f7ecc0f1fd1...f793f27df0695d5ff82f947694546b6e5ae6263a,2,14,5,19,4,2008-05-05 18:08:07,2008-05-05 18:08:07
f793f27df0695d5ff82f947694546b6e5ae6263a...d121e4a4460d872a5f8e276206b5f4036ca6db28,1,4,0,4,4,2008-05-05 18:50:03,2008-05-05 18:50:03
d121e4a4460d872a5f8e276206b5f4036ca6db28...c04de46b3cda62fe574bd70c32f675960b0bd083,1,5,0,5,1,2008-05-05 19:05:59,2008-05-05 19:05:59
c04de46b3cda62fe574bd70c32f675960b0bd083...7c5fe053c6d254714f12bfa88782dcdb1d1b21c0,1,1,1,2,1,2008-05-10 13:36:17,2008-05-10 13:36:17
7c5fe053c6d254714f12bfa88782dcdb1d1b21c0...f98757509eafe72bc5508f3a56a8b5ba60f39f86,1,1,0,1,1,2008-05-13 14:38:31,2008-05-13 14:38:31
f98757509eafe72bc5508f3a56a8b5ba60f39f86...4e5681caf38d984c31224ac73fe25ca7f89d8ac6,1,8,2,10,4,2008-05-13 14:50:44,2008-05-13 14:50:44
4e5681caf38d984c31224ac73fe25ca7f89d8ac6...13ae9e484d6dbd1ab0affee07922a5337591fa5f,8,51,41,92,15,2008-05-14 05:48:44,2008-05-14 05:48:44
13ae9e484d6dbd1ab0affee07922a5337591fa5f...bdea65e84a44f799260211c0fcf9eedba97e540e,8,609,561,1170,532,2008-05-22 13:51:03,2008-05-22 13:51:03
bdea65e84a44f799260211c0fcf9eedba97e540e...b67ed020c22c244ec652cd605bc10aaab300d14f,1,1,1,2,1,2008-05-29 12:28:40,2008-05-29 12:28:40
b67ed020c22c244ec652cd605bc10aaab300d14f...0836745c8e850b0bec2df743ff7648ff4cea588e,1,2,2,4,2,2008-05-29 22:16:52,2008-05-29 22:16:52
0836745c8e850b0bec2df743ff7648ff4cea588e...453d560a945d207013b163228de5ed9a7316a772,41,764,374,1138,354,2008-06-07 17:10:16,2008-06-07 17:10:16
453d560a945d207013b163228de5ed9a7316a772...65ef8d4da78c94a8b1da5ac058f1b85b942f58ae,1,2,1,3,2,2008-06-07 22:31:25,2008-06-07 22:31:25
65ef8d4da78c94a8b1da5ac058f1b85b942f58ae...7b2ae6e624d2c4a16e9e262f08225371891a738d,1,2,0,2,1,2008-06-07 23:04:43,2008-06-07 23:04:43
7b2ae6e624d2c4a16e9e262f08225371891a738d...bb75091bf46d9921ecdd89155866e929cc70a38e,6,306,0,306,5,2008-06-07 23:09:09,2008-06-07 23:09:09
bb75091bf46d9921ecdd89155866e929cc70a38e...3b92ced51856e740cd6fb3d3e5bb8ea932bd276e,5,49,13,62,11,2008-06-10 03:54:05,2008-06-10 03:54:05
3b92ced51856e740cd6fb3d3e5bb8ea932bd276e...4530a408c40647c195f27f81da1315e98e956f96,36,886,144,1030,90,2008-06-10 04:03:09,2008-06-10 04:03:09
4530a408c40647c195f27f81da1315e98e956f96...1fd3db4ab0d603878104877960de496773d12ad2,4,21,24,45,20,2008-06-10 04:15:06,2008-06-10 04:15:06
1fd3db4ab0d603878104877960de496773d12ad2...c6b53bec1071e1cd66ea8231a0b6e008494ec074,2,403,0,403,2,2008-06-10 04:40:13,2008-06-10 04:40:13
c6b53bec1071e1cd66ea8231a0b6e008494ec074...07b82590d8de46ece98f94d511fdc57163e76c8c,1,1,0,1,1,2008-06-10 04:45:19,2008-06-10 04:45:19
07b82590d8de46ece98f94d511fdc57163e76c8c...c63faa1f49bfa6bb6d3c933195713f060469bbfe,1,6,1,7,3,2008-06-10 04:59:12,2008-06-10 04:59:12
c63faa1f49bfa6bb6d3c933195713f060469bbfe...0f3f082ed520fb1627379526220553a013fbc867,2,3,1,4,3,2008-06-10 05:01:17,2008-06-10 05:01:17
0f3f082ed520fb1627379526220553a013fbc867...98d30caedb4bbc36b0ea1e3d812b4abb5732467e,2,2,0,2,2,2008-06-10 15:17:32,2008-06-10 15:17:32
98d30caedb4bbc36b0ea1e3d812b4abb5732467e...be810670ff9805d2d7f8e3260015db2123f0c5a9,2,16,2,18,3,2008-06-10 16:05:09,2008-06-10 16:05:09
be810670ff9805d2d7f8e3260015db2123f0c5a9...edf396da59d44efebe6d5d7242bda30de4b1afeb,3,14,14,28,13,2008-06-10 19:58:25,2008-06-10 19:58:25
edf396da59d44efebe6d5d7242bda30de4b1afeb...530670e27f338923c0199dc274f2ecf71af5d762,7,170,26,196,46,2008-06-11 03:58:01,2008-06-11 03:58:01
530670e27f338923c0199dc274f2ecf71af5d762...c55c758531e1a431c966a5fc4022483fcaf11a76,2,387,456,843,6,2008-06-11 18:01:14,2008-06-11 18:01:14
c55c758531e1a431c966a5fc4022483fcaf11a76...d1bc198e00d7b268b905158e092e3911bb9140f4,1,113,0,113,2,2008-06-11 20:28:37,2008-06-11 20:28:37
d1bc198e00d7b268b905158e092e3911bb9140f4...4a6965b3087901b88df813d5696962155311f4dd,1,6,2,8,3,2008-06-11 20:35:34,2008-06-11 20:35:34
4a6965b3087901b88df813d5696962155311f4dd...f914b0a71b8059166208175f994f61e4984eab1d,10,157,47,204,28,2008-06-12 20:13:27,2008-06-12 20:13:27
f914b0a71b8059166208175f994f61e4984eab1d...a33bd6b594b67126b70235a1bc1ab2ba95805d5e,5,70,32,102,25,2008-06-12 20:58:56,2008-06-12 20:58:56
a33bd6b594b67126b70235a1bc1ab2ba95805d5e...f33bdf7e9cbe48d51966abb72cbda0e8b865bdb9,1,3,2,5,1,2008-06-12 21:50:13,2008-06-12 21:50:13
f33bdf7e9cbe48d51966abb72cbda0e8b865bdb9...725293d51ad6f5dbefb59fa9adfd76d09e1526c6,10,131,34,165,30,2008-06-13 15:42:43,2008-06-13 15:42:43
725293d51ad6f5dbefb59fa9adfd76d09e1526c6...faae7c0faf859edb9b60a1a45669b9127efa3f37,3,29,9,38,10,2008-06-13 17:26:30,2008-06-13 17:26:30
faae7c0faf859edb9b60a1a45669b9127efa3f37...e8cd4084b7903cf6b5d96dbf292ec15ac40b2e58,8,16,14,30,17,2008-06-15 18:21:11,2008-06-15 18:21:11
e8cd4084b7903cf6b5d96dbf292ec15ac40b2e58...c6a26037e3722e794d94248e89bd397ed2cbbd75,1,2,0,2,2,2008-06-15 18:42:15,2008-06-15 18:42:15
c6a26037e3722e794d94248e89bd397ed2cbbd75...10c7129eb09750ec4045c7d41bb3f3ae0dfb483a,2,4,0,4,2,2008-06-15 18:53:30,2008-06-15 18:53:30
10c7129eb09750ec4045c7d41bb3f3ae0dfb483a...032e092ecf3df1101d19eb1aacb7b1a5e5ee7e85,1,3,3,6,2,2008-06-16 15:41:20,2008-06-16 15:41:20
032e092ecf3df1101d19eb1aacb7b1a5e5ee7e85...d0af06bad873de63bc44933e0a9bd29d3809910d,1,3,3,6,2,2008-06-16 15:46:36,2008-06-16 15:46:36
d0af06bad873de63bc44933e0a9bd29d3809910d...a253ec3743a434077e339f6d1abb347b8e219e26,49,5019,408,5427,320,2008-06-16 20:36:34,2008-06-16 20:36:34
a253ec3743a434077e339f6d1abb347b8e219e26...dfe06aac0c96d20829b27fdce8bb7d212df81c8b,1,1,1,2,1,2008-06-16 21:32:53,2008-06-16 21:32:53
dfe06aac0c96d20829b27fdce8bb7d212df81c8b...608af1f9d7cb51dfbf89264e7df9e014313f3d06,1,2,1,3,2,2008-06-16 22:39:35,2008-06-16 22:39:35
608af1f9d7cb51dfbf89264e7df9e014313f3d06...236a9dbd3c1785ffa926766c2826c6a12143d4f9,1,53,56,109,22,2008-06-17 22:00:48,2008-06-17 22:00:48
236a9dbd3c1785ffa926766c2826c6a12143d4f9...de2f3900cf3c7e15b7cfe8150f65a16bbc3fab6c,2,40,12,52,4,2008-06-17 22:45:59,2008-06-17 22:45:59
de2f3900cf3c7e15b7cfe8150f65a16bbc3fab6c...86a946a1a6be09e3d857f981313661565df3a449,5,41,14,55,16,2008-06-18 09:00:11,2008-06-18 09:00:11
86a946a1a6be09e3d857f981313661565df3a449...308cef40680050f2617400bb729a9e9a1fc0835a,2,29,2,31,4,2008-06-18 19:05:16,2008-06-18 19:05:16
308cef40680050f2617400bb729a9e9a1fc0835a...d5899f17e920420c183e7379a6405033064ec785,70,4948,1322,6270,1257,2008-06-19 16:04:52,2008-06-19 16:04:52
d5899f17e920420c183e7379a6405033064ec785...abe84c8648b9d5eb5a77093cf61d7a79c4f1baf4,1,0,1,1,1,2008-06-19 16:21:21,2008-06-19 16:21:21
abe84c8648b9d5eb5a77093cf61d7a79c4f1baf4...c929440fcd001b97b805f2229fb85deae3f86e05,1,1,1,2,1,2008-06-20 07:40:45,2008-06-20 07:40:45
c929440fcd001b97b805f2229fb85deae3f86e05...420f19aa353ee6568c93f34dfe2e6eef24bc528d,26,1029,927,1956,532,2008-06-23 21:05:02,2008-06-23 21:05:02
420f19aa353ee6568c93f34dfe2e6eef24bc528d...0ad37188cf999ff0db1b0b09a82eaf86e7e30c9b,1,2,2,4,2,2008-06-24 15:41:14,2008-06-24 15:41:14
0ad37188cf999ff0db1b0b09a82eaf86e7e30c9b...48c706a43a12d4e03fb62fdc6e938b1b0cf0bb33,1,1,1,2,1,2008-06-24 17:29:17,2008-06-24 17:29:17
48c706a43a12d4e03fb62fdc6e938b1b0cf0bb33...cf438282aa76ebf7a05dda55febbeca34be64db8,1,4,3,7,3,2008-06-24 18:11:05,2008-06-24 18:11:05
cf438282aa76ebf7a05dda55febbeca34be64db8...56584a66523b6811c03eb47d26389746965b2535,6,0,192,192,13,2008-06-24 19:44:31,2008-06-24 19:44:31
56584a66523b6811c03eb47d26389746965b2535...1acafa098956f7cbedcd9130130367a5bbd564ab,1,5,0,5,5,2008-06-24 20:35:14,2008-06-24 20:35:14
1acafa098956f7cbedcd9130130367a5bbd564ab...f15845c573f019fc7f6d7404add122f9b7c52dc4,1,0,1,1,1,2008-06-26 15:23:51,2008-06-26 15:23:51
f15845c573f019fc7f6d7404add122f9b7c52dc4...c8da0874c78ed4c6e1ad08cc78228799a333f76c,30,589,327,916,250,2008-06-26 15:42:33,2008-06-26 15:42:33
c8da0874c78ed4c6e1ad08cc78228799a333f76c...c349ba4cfc2d137da393bddbda6e78fdb98c9c81,3,71,18,89,15,2008-06-26 16:53:53,2008-06-26 16:53:53
c349ba4cfc2d137da393bddbda6e78fdb98c9c81...829fd5a9670a581309797f56bfc7e5140550e873,60,4333,1979,6312,676,2008-06-30 15:38:16,2008-06-30 15:38:16
829fd5a9670a581309797f56bfc7e5140550e873...595e9191f519af9b1c0c4b657fd3923c0997938c,1,6,4,10,3,2008-06-30 17:38:13,2008-06-30 17:38:13
595e9191f519af9b1c0c4b657fd3923c0997938c...0e8710d5900a75b9a4a1caebb82c939896e99cff,42,2319,157,2476,113,2008-07-01 15:49:08,2008-07-01 15:49:08
0e8710d5900a75b9a4a1caebb82c939896e99cff...2e5cc7413fdf0ee3cee92d855cf9b75999c8d79a,1,4,1,5,1,2008-07-02 08:32:14,2008-07-02 08:32:14
2e5cc7413fdf0ee3cee92d855cf9b75999c8d79a...f918f9180f38451e3924fa04da453bb81a9dc6ed,2,15,0,15,3,2008-07-02 08:32:55,2008-07-02 08:32:55
f918f9180f38451e3924fa04da453bb81a9dc6ed...7dd2666bd07736056932cfaca5e2ab809d68247b,10,127,61,188,44,2008-07-03 15:24:08,2008-07-03 15:24:08
7dd2666bd07736056932cfaca5e2ab809d68247b...058a190a792fd1ffc5b0f9c522ce805ea58d655b,1,2,1,3,1,2008-07-03 23:15:17,2008-07-03 23:15:17
058a190a792fd1ffc5b0f9c522ce805ea58d655b...8c8513281e9ed29840a082c05482a87d33f59f96,33,559,503,1062,105,2008-07-06 15:23:24,2008-07-06 15:23:24
8c8513281e9ed29840a082c05482a87d33f59f96...21974955c4fb3df6ee9308d27c180df47dc3a660,1,2,2,4,1,2008-07-06 15:28:05,2008-07-06 15:28:05
21974955c4fb3df6ee9308d27c180df47dc3a660...84541cd244638b44ca7f0f1076427470f4128a44,1,8,7,15,5,2008-07-07 00:31:29,2008-07-07 00:31:29
84541cd244638b44ca7f0f1076427470f4128a44...2e72445fce44d95914921448af846ff7a2f70167,2,22,0,22,4,2008-07-09 16:01:33,2008-07-09 16:01:33
2e72445fce44d95914921448af846ff7a2f70167...d9a2441c482a8b35da3e1cecc18b830d90015c6f,1,19,0,19,1,2008-07-09 18:09:38,2008-07-09 18:09:38
d9a2441c482a8b35da3e1cecc18b830d90015c6f...7d45454e55d9eca6afb725d8869aad3946c9b65c,1,9,9,18,3,2008-07-09 18:29:47,2008-07-09 18:29:47
7d45454e55d9eca6afb725d8869aad3946c9b65c...b46dc92ad36f25ea593ab4cbd3e963d6540920c1,1,2,1,3,1,2008-07-09 18:59:42,2008-07-09 18:59:42
b46dc92ad36f25ea593ab4cbd3e963d6540920c1...4772550a3cfac7792903dc0e4ed2629199a260c4,2,16,2,18,5,2008-07-10 20:24:46,2008-07-10 20:24:46
4772550a3cfac7792903dc0e4ed2629199a260c4...9cbd07b681050ab37dc0a36f43d483e99c0a06ce,1,1,1,2,1,2008-07-10 20:28:12,2008-07-10 20:28:12
9cbd07b681050ab37dc0a36f43d483e99c0a06ce...60c060c4762f55418da5628bbe6525e7820e9c61,38,1341,306,1647,205,2008-07-10 20:47:18,2008-07-10 20:47:18
60c060c4762f55418da5628bbe6525e7820e9c61...f3cda0b77afb2a6e22520b4c9f1c6d111add6ac9,1,0,5,5,5,2008-07-13 17:26:43,2008-07-13 17:26:43
f3cda0b77afb2a6e22520b4c9f1c6d111add6ac9...2624f4ea563e8139c7f19a20d9b723d39b1e6ac1,34,504,241,745,236,2008-07-14 05:04:57,2008-07-14 05:04:57
2624f4ea563e8139c7f19a20d9b723d39b1e6ac1...641711dd9d55dc3972d60f9a3dfbb39ba8902b73,1,14,14,28,13,2008-07-15 04:37:43,2008-07-15 04:37:43
641711dd9d55dc3972d60f9a3dfbb39ba8902b73...85eb8b3fd308d0f9791e78e1ba9210087d87ca0e,1,12,15,27,15,2008-07-15 04:37:57,2008-07-15 04:37:57
85eb8b3fd308d0f9791e78e1ba9210087d87ca0e...affc9b9b3b5bb5e92f38193ad731707af43b99c8,1,2,16,18,3,2008-07-15 04:38:10,2008-07-15 04:38:10
affc9b9b3b5bb5e92f38193ad731707af43b99c8...a2c7bfc1bee48b2aed9124c1a5a59a72274c73f7,4,828,66,894,10,2008-07-15 21:43:21,2008-07-15 21:43:21
a2c7bfc1bee48b2aed9124c1a5a59a72274c73f7...55744e997f92f24608910eecf60509603ec87fec,3,57,1,58,7,2008-07-15 22:41:17,2008-07-15 22:41:17
55744e997f92f24608910eecf60509603ec87fec...5317864e5fda896e777cfd001ec40a3c924b853a,2,15,0,15,4,2008-07-16 01:02:57,2008-07-16 01:02:57
5317864e5fda896e777cfd001ec40a3c924b853a...83afd39b1aa0e4235a8490ebc7219f97c35a0106,4,11,6,17,4,2008-07-16 02:01:18,2008-07-16 02:01:18
83afd39b1aa0e4235a8490ebc7219f97c35a0106...885ade77846f720c553e449947a2148f58e85577,2,5,12,17,4,2008-07-16 03:42:42,2008-07-16 03:42:42
885ade77846f720c553e449947a2148f58e85577...584c41aff77bdee0d2e20c6741b7698d3be524f5,9,33,17,50,23,2008-07-16 13:53:39,2008-07-16 13:53:39
584c41aff77bdee0d2e20c6741b7698d3be524f5...075a2fd938a95a77a5a63567bfad596b303765bf,8,102,40,142,16,2008-07-16 19:21:15,2008-07-16 19:21:15
075a2fd938a95a77a5a63567bfad596b303765bf...c546b55a9898861b8aed20d5c0ba6da16f7b22dd,1,0,4,4,1,2008-07-16 19:22:44,2008-07-16 19:22:44
c546b55a9898861b8aed20d5c0ba6da16f7b22dd...dce7cfee16094cb1dd060fb4d90ab73f62069317,6,254,185,439,20,2008-07-16 21:12:43,2008-07-16 21:12:43
dce7cfee16094cb1dd060fb4d90ab73f62069317...81b185319c86d4770af88a6781cbbfcd1def7ab5,2,15,4,19,5,2008-07-17 16:11:49,2008-07-17 16:11:49
81b185319c86d4770af88a6781cbbfcd1def7ab5...1eed9b076c28f3cd1720743cfff5a31fcb5aef5d,2,75,5,80,8,2008-07-17 16:48:27,2008-07-17 16:48:27
1eed9b076c28f3cd1720743cfff5a31fcb5aef5d...91880138897886f04b8ea186582a86c1c0417b51,4,41,23,64,8,2008-07-17 20:12:21,2008-07-17 20:12:21
91880138897886f04b8ea186582a86c1c0417b51...b2231a28e888946aa14619ad785e5dc7cf8504ba,15,173,30,203,31,2008-07-18 15:47:10,2008-07-18 15:47:10
b2231a28e888946aa14619ad785e5dc7cf8504ba...dd5197f081b6f0cac77721f24563b05005a686fb,11,8,362,370,11,2008-07-18 19:00:37,2008-07-18 19:00:37
dd5197f081b6f0cac77721f24563b05005a686fb...efc84a8a6348c9932a8a1bd14e7a30ba272df648,7,51,65,116,7,2008-07-18 20:23:02,2008-07-18 20:23:02
efc84a8a6348c9932a8a1bd14e7a30ba272df648...66893002f306cd35d0ddbd840a16d927acbac3ec,14,535,167,702,72,2008-07-18 21:42:08,2008-07-18 21:42:08
66893002f306cd35d0ddbd840a16d927acbac3ec...aaff207f81b716f1807a7184bab95ebfb36062db,3,7,3,10,6,2008-07-18 22:37:13,2008-07-18 22:37:13
aaff207f81b716f1807a7184bab95ebfb36062db...2c48a0b69db2d7171f70da238fce6947591d65f9,1,0,1,1,1,2008-07-18 22:38:27,2008-07-18 22:38:27
2c48a0b69db2d7171f70da238fce6947591d65f9...15497eee00cc4c1712796bec74236c41d94604bc,1,82,81,163,29,2008-07-18 22:55:31,2008-07-18 22:55:31
15497eee00cc4c1712796bec74236c41d94604bc...ca1281330a727bfd98a3902f906b27afbbaad703,3,6,9,15,4,2008-07-18 23:01:28,2008-07-18 23:01:28
ca1281330a727bfd98a3902f906b27afbbaad703...deedd01ca3e66f022899c6f5009526a00b709107,1,1,1,2,1,2008-07-18 23:02:33,2008-07-18 23:02:33
deedd01ca3e66f022899c6f5009526a00b709107...42ea7a5ce8aece67d16c6610a49560c1493d4653,1,2,2,4,2,2008-07-18 23:06:59,2008-07-18 23:06:59
f2aa1b93e09202707453d26f0648cd9aaf57e4ec...8546521d9bf76e831c9379c4204fb7497101a7a7,1,3,2,5,2,2007-02-25 15:55:31,2007-02-25 15:55:31
8546521d9bf76e831c9379c4204fb7497101a7a7...a0157da26f143c2b78e98837d1ef5501beaba776,3,52,0,52,1,2007-02-25 16:09:30,2007-02-25 16:09:30
a0157da26f143c2b78e98837d1ef5501beaba776...5c17b42772f4786ac05e34cf5567994bc8d43c17,1,2,2,4,2,2007-02-25 16:11:46,2007-02-25 16:11:46
5c17b42772f4786ac05e34cf5567994bc8d43c17...dcdaa4ac3cd909570b56b1561ad3f22ff390a92f,2,8,2,10,6,2007-02-25 16:18:46,2007-02-25 16:18:46
dcdaa4ac3cd909570b56b1561ad3f22ff390a92f...3468fd01a9a66193aed61f4ddbab09a473d45d17,2,18,5,23,8,2007-02-25 16:29:09,2007-02-25 16:29:09
3468fd01a9a66193aed61f4ddbab09a473d45d17...0a2155e5b3bf44f44b1a274a269c07af0bd58f33,1,22,4,26,1,2007-02-25 16:33:39,2007-02-25 16:33:39
0a2155e5b3bf44f44b1a274a269c07af0bd58f33...5b66c74b32ad973b4b715f07ce50be203401b82b,1,1,1,2,1,2007-02-25 16:37:31,2007-02-25 16:37:31
5b66c74b32ad973b4b715f07ce50be203401b82b...cef22390862a2ad9ecdfbe3fabc74fbd81160b39,2,10,4,14,7,2007-02-25 17:16:38,2007-02-25 17:16:38
cef22390862a2ad9ecdfbe3fabc74fbd81160b39...81bb3d9e7441f1d51acbea8e2771355614f981d3,1,8,0,8,1,2007-02-25 17:18:17,2007-02-25 17:18:17
81bb3d9e7441f1d51acbea8e2771355614f981d3...25895623ffe23c8a64117666606e8a79735f9804,1,0,8,8,1,2007-02-25 19:51:33,2007-02-25 19:51:33
25895623ffe23c8a64117666606e8a79735f9804...6871a455e2f2362806b7424f1afb44b46e551bb4,1,2,2,4,2,2007-02-25 22:31:31,2007-02-25 22:31:31
6871a455e2f2362806b7424f1afb44b46e551bb4...357e26baf62e951ef7c6e7e0b840a98d6f77d517,7,317,60,377,19,2007-02-26 03:17:04,2007-02-26 03:17:04
357e26baf62e951ef7c6e7e0b840a98d6f77d517...907e4f840e7e6f75a9f23314882a2fcbc2ac0e8e,3,112,107,219,53,2007-02-26 03:44:36,2007-02-26 03:44:36
907e4f840e7e6f75a9f23314882a2fcbc2ac0e8e...530409369f97fb2c0180482d4b60bd84e1a60e6c,1,3,3,6,3,2007-02-26 04:37:52,2007-02-26 04:37:52
530409369f97fb2c0180482d4b60bd84e1a60e6c...b7fa37f9b24a745c55c20e1767b98a647b25dadb,2,14,0,14,3,2007-02-26 04:53:44,2007-02-26 04:53:44
b7fa37f9b24a745c55c20e1767b98a647b25dadb...6bd07383c0b06790c209de365e8e17ae125f490b,2,8,0,8,3,2007-02-26 05:07:12,2007-02-26 05:07:12
6bd07383c0b06790c209de365e8e17ae125f490b...ffb62e0c02ddcac1e7da6eaa5319a4ef72c13394,1,1,1,2,1,2007-02-26 05:07:54,2007-02-26 05:07:54
ffb62e0c02ddcac1e7da6eaa5319a4ef72c13394...d7d73c9facf41a2f01721270600d5fec75024d82,1,6,0,6,1,2007-02-26 05:15:52,2007-02-26 05:15:52
d7d73c9facf41a2f01721270600d5fec75024d82...3d164ab04f02cd574428950649760bea52288d9f,1,3,0,3,1,2007-02-26 05:16:52,2007-02-26 05:16:52
3d164ab04f02cd574428950649760bea52288d9f...abf79841fe6cce5f1f66f915815ed98ecca44e64,3,53,17,70,8,2007-02-26 05:37:24,2007-02-26 05:37:24
abf79841fe6cce5f1f66f915815ed98ecca44e64...90acc8ff7e1b27b5c2f7cd5a2440d94d5fa22445,1,61,30,91,7,2007-02-26 06:16:19,2007-02-26 06:16:19
90acc8ff7e1b27b5c2f7cd5a2440d94d5fa22445...670ea04e4799962bc03b532065804242fb6a90b0,1,17,14,31,7,2007-02-26 06:21:24,2007-02-26 06:21:24
670ea04e4799962bc03b532065804242fb6a90b0...e7d468ef319994ece875673e3b60e6d7554656c6,3,135,131,266,113,2007-02-26 08:18:58,2007-02-26 08:18:58
e7d468ef319994ece875673e3b60e6d7554656c6...b1fbfb3f61ecac9acdd7122c20fb53dc70335c09,5,2650,0,2650,3,2007-02-26 08:23:33,2007-02-26 08:23:33
b1fbfb3f61ecac9acdd7122c20fb53dc70335c09...91ad769d926f6ecae4e2a7eae3ef3e524975ec38,4,283,425,708,246,2007-02-26 08:26:58,2007-02-26 08:26:58
91ad769d926f6ecae4e2a7eae3ef3e524975ec38...5316a95dea7d29fc8deb9bf81402891615e7e4e8,5,114,122,236,120,2007-02-26 08:30:14,2007-02-26 08:30:14
5316a95dea7d29fc8deb9bf81402891615e7e4e8...24eae6d6bbd6423242d73b8947371a49fa73f70a,4,79,130,209,83,2007-02-26 08:32:59,2007-02-26 08:32:59
24eae6d6bbd6423242d73b8947371a49fa73f70a...b3a67b26f590a8a02b275e60472088c1fdcb8b00,4,335,199,534,155,2007-02-26 08:35:48,2007-02-26 08:35:48
b3a67b26f590a8a02b275e60472088c1fdcb8b00...14f04b3d3b8808b6d5b1b32cb42f9aa54c4ab525,3,64,63,127,60,2007-02-26 08:48:46,2007-02-26 08:48:46
14f04b3d3b8808b6d5b1b32cb42f9aa54c4ab525...83da190e4053e87ebdeb6b3507b57ec3e2ee0059,2,1918,1587,3505,438,2007-02-26 08:54:26,2007-02-26 08:54:26
83da190e4053e87ebdeb6b3507b57ec3e2ee0059...c27ba0b2097267796bc97daea81ee62dd10554ff,2,3,2,5,2,2007-02-26 09:06:23,2007-02-26 09:06:23
c27ba0b2097267796bc97daea81ee62dd10554ff...f313e07b6e0914130b613c3491b2b019ca003dc7,4,22,6,28,9,2007-02-26 12:52:01,2007-02-26 12:52:01
f313e07b6e0914130b613c3491b2b019ca003dc7...a30e3fca48be23c856cda778ec3f0e0eec75fd91,7,68,14,82,14,2007-02-26 17:17:11,2007-02-26 17:17:11
a30e3fca48be23c856cda778ec3f0e0eec75fd91...51f39d59bd42375e6ded28c2b6538e053d78b626,11,60,28,88,21,2007-02-26 17:33:27,2007-02-26 17:33:27
51f39d59bd42375e6ded28c2b6538e053d78b626...9da791aa6b31d0eee1c24e53aa5daa9150189004,1,1,1,2,1,2007-02-26 17:38:55,2007-02-26 17:38:55
9da791aa6b31d0eee1c24e53aa5daa9150189004...9368f67b2b5050bac46c420182ee37e1138af347,1,2,2,4,2,2007-02-26 17:43:41,2007-02-26 17:43:41
9368f67b2b5050bac46c420182ee37e1138af347...18ecf9dc85394799932640b9607e74cbb1c32406,1,1,1,2,1,2007-02-26 17:50:21,2007-02-26 17:50:21
18ecf9dc85394799932640b9607e74cbb1c32406...2cd6db682f1964e4249b747ebbf1519a8e47efd1,1,2,2,4,2,2007-02-26 18:50:55,2007-02-26 18:50:55
2cd6db682f1964e4249b747ebbf1519a8e47efd1...cb1ff2af35bd983dadabfbfbc882c326bd22bab5,1,1,1,2,1,2007-02-26 18:52:15,2007-02-26 18:52:15
cb1ff2af35bd983dadabfbfbc882c326bd22bab5...f3cc581f3ae591adf0d2dcf201a3d08e5cddef46,1,6,3,9,1,2007-02-26 19:12:31,2007-02-26 19:12:31
f3cc581f3ae591adf0d2dcf201a3d08e5cddef46...b9522d0a521a7684aaf3aae2d7a9d0aaab5b3974,1,7,0,7,1,2007-02-26 20:51:21,2007-02-26 20:51:21
b9522d0a521a7684aaf3aae2d7a9d0aaab5b3974...e7fb31624a4803c579f78a63a8407bbc037915d7,1,30,4,34,5,2007-02-26 21:18:31,2007-02-26 21:18:31
e7fb31624a4803c579f78a63a8407bbc037915d7...702273d77b8dce3d16af60c958756c6e501be401,1,10,0,10,1,2007-02-26 21:22:21,2007-02-26 21:22:21
702273d77b8dce3d16af60c958756c6e501be401...36a514f818d19063f26335bf6002eba3027cca6f,1,1,1,2,1,2007-02-26 21:25:21,2007-02-26 21:25:21
36a514f818d19063f26335bf6002eba3027cca6f...7b2c6984cd6da65222cf192fbbbb99f43766f79c,1,30,19,49,11,2007-02-26 21:33:04,2007-02-26 21:33:04
7b2c6984cd6da65222cf192fbbbb99f43766f79c...3e9c41d03bd531110114ee3a5075f3d9eac56b8a,1,14,0,14,1,2007-02-26 21:36:14,2007-02-26 21:36:14
3e9c41d03bd531110114ee3a5075f3d9eac56b8a...9f1bf4659bf4b109c71afae7980d6341a2426500,1,7,3,10,2,2007-02-26 21:39:09,2007-02-26 21:39:09
9f1bf4659bf4b109c71afae7980d6341a2426500...96604fdf8f34a9e51d1f61a8c81ba5ef843b5ee9,1,7,0,7,1,2007-02-26 21:40:15,2007-02-26 21:40:15
96604fdf8f34a9e51d1f61a8c81ba5ef843b5ee9...b21fd1e45114a5dcb62668b8d5cccd71094bee28,1,3,4,7,1,2007-02-26 21:52:22,2007-02-26 21:52:22
b21fd1e45114a5dcb62668b8d5cccd71094bee28...b581d732227c9d347c4046a66879d8c4c9c6cec5,1,151,0,151,2,2007-02-26 22:19:03,2007-02-26 22:19:03
b581d732227c9d347c4046a66879d8c4c9c6cec5...516aa4436c7e51ba6b6d28893a29a1310eafed36,1,3,1,4,1,2007-02-26 22:34:56,2007-02-26 22:34:56
516aa4436c7e51ba6b6d28893a29a1310eafed36...a8ed2b4d583fd489cb38c02e79e7596ec60458ff,2,89,4,93,3,2007-02-26 23:23:01,2007-02-26 23:23:01
a8ed2b4d583fd489cb38c02e79e7596ec60458ff...8930f3d02771d9852ee46a0a561ef9ce3636f719,2,2,2,4,2,2007-02-27 00:02:40,2007-02-27 00:02:40
8930f3d02771d9852ee46a0a561ef9ce3636f719...21860fe23ae4b7923c5c92f75a79f272cc6ab103,2,0,25,25,2,2007-02-27 00:15:11,2007-02-27 00:15:11
21860fe23ae4b7923c5c92f75a79f272cc6ab103...ee9deca37193d24efe33760abd86310cd26f041d,1,4,4,8,1,2007-02-27 00:16:40,2007-02-27 00:16:40
ee9deca37193d24efe33760abd86310cd26f041d...b497bba1b5808e046c3a56fb65a63f5fa1c0a563,2,10,10,20,10,2007-02-27 01:23:53,2007-02-27 01:23:53
b497bba1b5808e046c3a56fb65a63f5fa1c0a563...6dfd32d4e84d9db1506298dea1822093ed6e153f,2,28,43,71,42,2007-02-27 01:25:54,2007-02-27 01:25:54
6dfd32d4e84d9db1506298dea1822093ed6e153f...a419079347676ab4fccd264a5e9c555a2603b9bb,1,9,0,9,1,2007-02-27 03:48:49,2007-02-27 03:48:49
a419079347676ab4fccd264a5e9c555a2603b9bb...b97636944df970ef5d0e6bc0f691ba4011d2af3d,1,15,0,15,1,2007-02-27 04:27:47,2007-02-27 04:27:47
b97636944df970ef5d0e6bc0f691ba4011d2af3d...9c2c03a9749abccc80f845ee1ff8cd8b7c28b0bc,1,7,0,7,1,2007-02-27 20:11:26,2007-02-27 20:11:26
9c2c03a9749abccc80f845ee1ff8cd8b7c28b0bc...19e0bf1d4463c24f901951a7d8ab4a1d54b1ac9d,2,29,2,31,3,2007-02-27 20:25:27,2007-02-27 20:25:27
19e0bf1d4463c24f901951a7d8ab4a1d54b1ac9d...6ca7930dd4c874ba304f4ce6c934aca8c9777edd,4,41,0,41,3,2007-02-28 00:35:50,2007-02-28 00:35:50
6ca7930dd4c874ba304f4ce6c934aca8c9777edd...9c67c1dd8d6d19872af041b7d79c0c688b19b416,5,1925,1585,3510,447,2007-02-28 09:32:44,2007-02-28 09:32:44
9c67c1dd8d6d19872af041b7d79c0c688b19b416...4477f50f0b346f6c5f177a4bad99041a9b903842,4,193,10,203,13,2007-02-28 15:24:05,2007-02-28 15:24:05
4477f50f0b346f6c5f177a4bad99041a9b903842...0e683f6da4165367383db136583a34c3dec99d12,1,23,1,24,4,2007-02-28 15:39:53,2007-02-28 15:39:53
0e683f6da4165367383db136583a34c3dec99d12...28ad156f10408471f06238738a877f3f7ee41744,3,8,1,9,4,2007-02-28 16:18:55,2007-02-28 16:18:55
28ad156f10408471f06238738a877f3f7ee41744...37c66a0999b45c30e847012ae2e707663dd8cd66,2,4,4,8,3,2007-02-28 19:28:30,2007-02-28 19:28:30
37c66a0999b45c30e847012ae2e707663dd8cd66...a81a6e9abef2302a6bfc3d2bf0c47013bfc87bb3,1,3,1,4,2,2007-02-28 19:42:29,2007-02-28 19:42:29
a81a6e9abef2302a6bfc3d2bf0c47013bfc87bb3...7b0e321c557edaa2e08da1d4a8746eb8cbd5b283,1,1,1,2,1,2007-02-28 22:01:52,2007-02-28 22:01:52
7b0e321c557edaa2e08da1d4a8746eb8cbd5b283...633f0856d29f5baa1d6dda3f439406efc1e8482c,1,1,1,2,1,2007-02-28 22:11:45,2007-02-28 22:11:45
633f0856d29f5baa1d6dda3f439406efc1e8482c...77be30246982b21e21a8674f64c4d5d05638a5f4,1,2,2,4,2,2007-02-28 22:22:03,2007-02-28 22:22:03
77be30246982b21e21a8674f64c4d5d05638a5f4...4eb7e298b63eb2012b6e2959e5535103bf40e903,1,8,1,9,1,2007-03-01 00:02:04,2007-03-01 00:02:04
4eb7e298b63eb2012b6e2959e5535103bf40e903...f54777406d9b0a1643db49baa20367e27bef4b2e,2,32,27,59,23,2007-03-01 09:08:24,2007-03-01 09:08:24
f54777406d9b0a1643db49baa20367e27bef4b2e...f2582eb972303978a5fa115825a646a230624116,27,887,86,973,72,2007-03-01 13:11:08,2007-03-01 13:11:08
f2582eb972303978a5fa115825a646a230624116...a72f908924290f85d5e73baee5ebc88049893bdf,2,2,2,4,2,2007-03-01 17:54:35,2007-03-01 17:54:35
a72f908924290f85d5e73baee5ebc88049893bdf...790b5858194d66f3fe1c2bb8d266408469049166,2,19,4,23,6,2007-03-02 02:28:44,2007-03-02 02:28:44
790b5858194d66f3fe1c2bb8d266408469049166...dd99bc7d0226ff76903e9c2a62210b4614addc5a,2,2,2,4,2,2007-03-02 05:15:27,2007-03-02 05:15:27
dd99bc7d0226ff76903e9c2a62210b4614addc5a...ac09ff9f96fbf98801f6d747add5d5cb1586feed,1,1,1,2,1,2007-03-02 08:36:54,2007-03-02 08:36:54
ac09ff9f96fbf98801f6d747add5d5cb1586feed...d181aa0e94f5f22c0584206248d63780c7565a68,1,1,1,2,1,2007-03-02 08:59:21,2007-03-02 08:59:21
d181aa0e94f5f22c0584206248d63780c7565a68...aa55e98b87c7f78d60edc51d8aa5662b61899e37,1,2,1,3,2,2007-03-05 19:55:29,2007-03-05 19:55:29
aa55e98b87c7f78d60edc51d8aa5662b61899e37...f309bde7f62bdc0d467921e8dd92513bd5726df0,1,1,0,1,1,2007-03-06 01:12:46,2007-03-06 01:12:46
f309bde7f62bdc0d467921e8dd92513bd5726df0...f57bef27e79dcceefe5f65d8cae1f2f89573f48d,5,1929,1459,3388,436,2007-03-06 01:59:27,2007-03-06 01:59:27
f57bef27e79dcceefe5f65d8cae1f2f89573f48d...c836f848c667c4aad775d315d77a95ffb9c2af48,2,21,21,42,21,2007-03-06 02:01:48,2007-03-06 02:01:48
c836f848c667c4aad775d315d77a95ffb9c2af48...55c70238ed0e58091b5c6c24e2d39655acb4dcca,1,1,1,2,2,2007-03-07 12:05:25,2007-03-07 12:05:25
55c70238ed0e58091b5c6c24e2d39655acb4dcca...6af3409d98ce2a025b69666cd503d85e2f081e8d,1,6,5,11,2,2007-03-07 12:15:40,2007-03-07 12:15:40
6af3409d98ce2a025b69666cd503d85e2f081e8d...98b2e0a035fefa777cfda5a48283cd014703a505,1,5,2,7,2,2007-03-07 12:23:01,2007-03-07 12:23:01
98b2e0a035fefa777cfda5a48283cd014703a505...43809de79db2dfd3f967f4c95bca98f8f6c75fb5,2,27,6,33,5,2007-03-08 03:21:35,2007-03-08 03:21:35
43809de79db2dfd3f967f4c95bca98f8f6c75fb5...a89b51b033737173b771a43eac18d4d83b799104,1,1,1,2,1,2007-03-08 03:34:05,2007-03-08 03:34:05
a89b51b033737173b771a43eac18d4d83b799104...acc9a95b6354d7c15797627d2ab3d11f687f1620,1,2,1,3,2,2007-03-08 03:41:04,2007-03-08 03:41:04
acc9a95b6354d7c15797627d2ab3d11f687f1620...f5f4b807e43d701220f9eb7b32ee8406b85dc006,4,45,45,90,43,2007-03-08 08:22:11,2007-03-08 08:22:11
f5f4b807e43d701220f9eb7b32ee8406b85dc006...c651b08f3981cb9c1e4631563675730a3577e0a9,2,6,1,7,6,2007-03-08 08:46:59,2007-03-08 08:46:59
c651b08f3981cb9c1e4631563675730a3577e0a9...449ea76bf3539b04a9d3ebd7df441a801c0b63fb,1,3,3,6,3,2007-03-08 08:50:33,2007-03-08 08:50:33
449ea76bf3539b04a9d3ebd7df441a801c0b63fb...cdc79b71cb9d8ccd49542a728d8d4fc609f6f41c,1,30,1,31,2,2007-03-08 08:56:34,2007-03-08 08:56:34
cdc79b71cb9d8ccd49542a728d8d4fc609f6f41c...4823a531d15e60e1594cfc0c0d80653211d98409,2,2,2,4,1,2007-03-08 08:59:12,2007-03-08 08:59:12
4823a531d15e60e1594cfc0c0d80653211d98409...7d8687ea35bb588fabf7f756c70e86bc78831108,1,30,1,31,1,2007-03-08 09:28:45,2007-03-08 09:28:45
7d8687ea35bb588fabf7f756c70e86bc78831108...fb1ff06d32ee30e26b5dc88cd53cf3ffe8d67972,1,10,12,22,5,2007-03-08 20:43:09,2007-03-08 20:43:09
fb1ff06d32ee30e26b5dc88cd53cf3ffe8d67972...20a240cf5137cf3ca1468b55ef44aeef47a50312,6,2218,0,2218,4,2007-03-09 04:42:30,2007-03-09 04:42:30
20a240cf5137cf3ca1468b55ef44aeef47a50312...fcd119bfb18b20e81457f845b826733eee9c0cd0,1,15,2,17,5,2007-03-09 04:59:58,2007-03-09 04:59:58
fcd119bfb18b20e81457f845b826733eee9c0cd0...22178d692a651be21fa9347502babe1bd17aabf2,2,9,0,9,2,2007-03-09 05:34:42,2007-03-09 05:34:42
22178d692a651be21fa9347502babe1bd17aabf2...b6eee020079cc60ef169ef043049d967ea4737b9,1,5,3,8,1,2007-03-09 05:47:39,2007-03-09 05:47:39
b6eee020079cc60ef169ef043049d967ea4737b9...82485694719a19faccdd90f61ac84bf8076b48c2,2,18,5,23,4,2007-03-09 06:12:15,2007-03-09 06:12:15
82485694719a19faccdd90f61ac84bf8076b48c2...cc8d656569cd907a92b8b292e3a6627d5f9a5290,7,19,12,31,13,2007-03-09 07:55:40,2007-03-09 07:55:40
cc8d656569cd907a92b8b292e3a6627d5f9a5290...ab64b383177f8e554c876d7c8574df6169ecc515,2,9,4,13,5,2007-03-09 09:32:39,2007-03-09 09:32:39
ab64b383177f8e554c876d7c8574df6169ecc515...aa3661842791bcba85a4eded07c40d02a722f6eb,1,1,1,2,1,2007-03-09 17:11:51,2007-03-09 17:11:51
aa3661842791bcba85a4eded07c40d02a722f6eb...90f7616d5db0024a9183cfb995cbf675b17d4481,1,1,1,2,1,2007-03-09 22:44:49,2007-03-09 22:44:49
90f7616d5db0024a9183cfb995cbf675b17d4481...e833595bc836f2c26c5acee54b8d083be07c6858,2,7,2,9,3,2007-03-10 07:37:08,2007-03-10 07:37:08
e833595bc836f2c26c5acee54b8d083be07c6858...659aa8f01a085bba673c5ecdbd6902cb3bff35f9,1,9,8,17,1,2007-03-10 08:11:28,2007-03-10 08:11:28
659aa8f01a085bba673c5ecdbd6902cb3bff35f9...ee1ca89dd40442232a21adb06eda793795eec18d,1,31,20,51,8,2007-03-10 11:37:11,2007-03-10 11:37:11
ee1ca89dd40442232a21adb06eda793795eec18d...2cf448152eaff0a5fbcf078ccf5a62f7a91ef3e1,1,7,6,13,5,2007-03-11 10:15:35,2007-03-11 10:15:35
2cf448152eaff0a5fbcf078ccf5a62f7a91ef3e1...5c2e83eef59c9591d1b5c65e5f265fc80271f283,1,2,1,3,1,2007-03-11 10:37:33,2007-03-11 10:37:33
5c2e83eef59c9591d1b5c65e5f265fc80271f283...a5e9f508ce1ba6afe90fe8da3b453c780b1a7342,2,11,0,11,2,2007-03-11 16:06:08,2007-03-11 16:06:08
a5e9f508ce1ba6afe90fe8da3b453c780b1a7342...b1eea1af4041989e40b9102d05e836c97f223409,5,1817,1312,3129,401,2007-03-12 08:35:15,2007-03-12 08:35:15
b1eea1af4041989e40b9102d05e836c97f223409...0cdf42ca572ee86168ed7fd09fa8259bcc53083a,2,2022,1522,3544,435,2007-03-12 08:39:17,2007-03-12 08:39:17
0cdf42ca572ee86168ed7fd09fa8259bcc53083a...173c76d038f650aceb3b12c7cae1594da24a32d4,1,1304,1804,3108,385,2007-03-12 08:43:07,2007-03-12 08:43:07
173c76d038f650aceb3b12c7cae1594da24a32d4...2a488f3cd412ad899ce32f3603cbc02db8f6c187,1,10,0,10,1,2007-03-12 09:02:18,2007-03-12 09:02:18
2a488f3cd412ad899ce32f3603cbc02db8f6c187...e5fa609ba71583efeb25b7167c7e55708e3d8189,2,4,3,7,4,2007-03-12 09:21:22,2007-03-12 09:21:22
e5fa609ba71583efeb25b7167c7e55708e3d8189...adbd80ae7fcfef612a70a9e2b2c12b800530c9fc,1,8,7,15,1,2007-03-12 10:52:21,2007-03-12 10:52:21
adbd80ae7fcfef612a70a9e2b2c12b800530c9fc...db03c7fa1d7e351fc40e92dd9e08904a9ff842f4,1,11,0,11,1,2007-03-12 12:23:53,2007-03-12 12:23:53
db03c7fa1d7e351fc40e92dd9e08904a9ff842f4...5295f54b3cf30d7cf11bffe9ca66230c205291cc,1,21,0,21,1,2007-03-12 12:40:03,2007-03-12 12:40:03
5295f54b3cf30d7cf11bffe9ca66230c205291cc...9f0c545addb02a91719adec336200a991599280f,2,43,0,43,2,2007-03-12 14:01:44,2007-03-12 14:01:44
9f0c545addb02a91719adec336200a991599280f...9afc51bbcb28f89a621553176af191f5db548732,2,3,3,6,3,2007-03-13 00:29:21,2007-03-13 00:29:21
9afc51bbcb28f89a621553176af191f5db548732...e4e74f7e1d9f8fd7babaa9e0e37298b5f241a2c9,1,1,1,2,1,2007-03-13 00:33:15,2007-03-13 00:33:15
e4e74f7e1d9f8fd7babaa9e0e37298b5f241a2c9...400ee0266149309ccf1d36886c4a8a0524f14efc,1,7,0,7,1,2007-03-13 00:35:47,2007-03-13 00:35:47
400ee0266149309ccf1d36886c4a8a0524f14efc...375c3edf6edc0bb9f3e726f67c70fa524556713b,3,26,20,46,16,2007-03-13 00:59:34,2007-03-13 00:59:34
375c3edf6edc0bb9f3e726f67c70fa524556713b...7ccf9978adab5c0846b13f804f1bab25436e2564,3,413,0,413,2,2007-03-13 01:03:05,2007-03-13 01:03:05
7ccf9978adab5c0846b13f804f1bab25436e2564...f9c4ce51235aac4862cfe2dfaaf6836acaea1c3d,5,210,45,255,14,2007-03-14 12:08:19,2007-03-14 12:08:19
f9c4ce51235aac4862cfe2dfaaf6836acaea1c3d...2a8da0a502a12d110c23bce0ac23bc96c847ee55,1,9,0,9,6,2007-03-15 07:44:44,2007-03-15 07:44:44
2a8da0a502a12d110c23bce0ac23bc96c847ee55...3eb89eaa25979e0a89966e5c089188acd9f4cd76,1,2,2,4,2,2007-03-15 07:48:36,2007-03-15 07:48:36
3eb89eaa25979e0a89966e5c089188acd9f4cd76...5d60faf33d7ad1067a892965e256021f9f737cd9,1,1,1,2,1,2007-03-16 15:02:21,2007-03-16 15:02:21
5d60faf33d7ad1067a892965e256021f9f737cd9...64fae18505f96970d7df9722f0a67ee429dc3fa0,1,1,1,2,1,2007-03-16 15:05:14,2007-03-16 15:05:14
64fae18505f96970d7df9722f0a67ee429dc3fa0...c3f91bb2b15df954a4855a2e35c4f8cfcd337175,1,1,1,2,1,2007-03-16 15:10:48,2007-03-16 15:10:48
c3f91bb2b15df954a4855a2e35c4f8cfcd337175...0a0151b831ba7ac3d9110517151ec5864604f853,1,7,7,14,3,2007-03-16 15:13:31,2007-03-16 15:13:31
0a0151b831ba7ac3d9110517151ec5864604f853...b14ff2f94d6a3b1d78cbe2ee664a1e0330c5d060,1,3,2,5,1,2007-03-16 15:17:20,2007-03-16 15:17:20
b14ff2f94d6a3b1d78cbe2ee664a1e0330c5d060...515337fa3b7279cfca3f4ce39a738efb6aab7586,1,4,4,8,4,2007-03-16 15:20:37,2007-03-16 15:20:37
515337fa3b7279cfca3f4ce39a738efb6aab7586...cecd520671eb37785847c4573cade2a98c93c661,1,7,7,14,1,2007-03-16 15:23:28,2007-03-16 15:23:28
cecd520671eb37785847c4573cade2a98c93c661...f765aa4e4475d7c3df20beb1c6e0f1ef5c4edc27,1,61,61,122,30,2007-03-16 15:42:58,2007-03-16 15:42:58
f765aa4e4475d7c3df20beb1c6e0f1ef5c4edc27...cb624b137772fbfbfd3882df4d632734259a1565,1,8,2,10,1,2007-03-18 19:16:47,2007-03-18 19:16:47
cb624b137772fbfbfd3882df4d632734259a1565...83bed03a5990ba90cd99c6b2ceedcaf3199626e2,6,52,12,64,13,2007-03-19 11:57:53,2007-03-19 11:57:53
83bed03a5990ba90cd99c6b2ceedcaf3199626e2...b8eec54041040eccbd4d6d1077257b65cdb85708,2,7,1,8,2,2007-03-20 11:07:52,2007-03-20 11:07:52
b8eec54041040eccbd4d6d1077257b65cdb85708...55a67ae3f0432a86e7b6009416a850a7f747ddd7,1,1,1,2,1,2007-03-20 11:09:40,2007-03-20 11:09:40
55a67ae3f0432a86e7b6009416a850a7f747ddd7...6cc0eda1cb665e680ae29307a72c7cea1926cb52,1,2,2,4,2,2007-03-20 16:48:41,2007-03-20 16:48:41
6cc0eda1cb665e680ae29307a72c7cea1926cb52...61d6249c2bf6c57684a3b77c6cec8601e7a26b44,2,3,3,6,3,2007-03-20 16:54:05,2007-03-20 16:54:05
61d6249c2bf6c57684a3b77c6cec8601e7a26b44...9fb40185fefd5e952c08177f4d3de53e6112b17e,1,3,3,6,3,2007-03-20 23:27:16,2007-03-20 23:27:16
9fb40185fefd5e952c08177f4d3de53e6112b17e...1f9711ffb02f89da445251366d3827f39b05da11,1,2,0,2,1,2007-03-20 23:32:39,2007-03-20 23:32:39
1f9711ffb02f89da445251366d3827f39b05da11...ceab87732c31736e746d5e774f5e3364ffa1722e,2,32,32,64,32,2007-03-20 23:37:21,2007-03-20 23:37:21
ceab87732c31736e746d5e774f5e3364ffa1722e...ebd3bc0c55b9c3ef570698e7ad78bb9e2f500ae7,1,112,0,112,1,2007-03-20 23:39:10,2007-03-20 23:39:10
ebd3bc0c55b9c3ef570698e7ad78bb9e2f500ae7...4752c0aa774b18bc213167508b1c1b029be28258,1,0,0,0,0,2007-03-20 23:41:04,2007-03-20 23:41:04
4752c0aa774b18bc213167508b1c1b029be28258...4e4222b2c1259fcba388c3201f34b8f35233a572,2,1707,1446,3153,464,2007-03-20 23:42:08,2007-03-20 23:42:08
4e4222b2c1259fcba388c3201f34b8f35233a572...038aa4f74acc391835aceeafe70ae09a625c6106,4,718,581,1299,323,2007-03-20 23:50:14,2007-03-20 23:50:14
038aa4f74acc391835aceeafe70ae09a625c6106...f708bd69c9dca4e2e94c3a7781d6773b2c11dacc,6,2235,0,2235,4,2007-03-20 23:57:24,2007-03-20 23:57:24
f708bd69c9dca4e2e94c3a7781d6773b2c11dacc...dcc8442390f3ebb7130ec8e6fd235855f2510203,6,373,1,374,5,2007-03-21 03:27:03,2007-03-21 03:27:03
dcc8442390f3ebb7130ec8e6fd235855f2510203...3f3f51d942cc8f3b4fd7c7aab8bf4cbc9747b713,1,1,1,2,1,2007-03-21 20:44:15,2007-03-21 20:44:15
3f3f51d942cc8f3b4fd7c7aab8bf4cbc9747b713...29aa31d8f5dd10ed30e539bebc17735e3b4ae89c,2,24,2,26,3,2007-03-22 02:20:33,2007-03-22 02:20:33
29aa31d8f5dd10ed30e539bebc17735e3b4ae89c...858ac0580228a4ee8ae8a8cbeb1887ae824d2ef1,1,2,0,2,1,2007-03-22 03:00:12,2007-03-22 03:00:12
858ac0580228a4ee8ae8a8cbeb1887ae824d2ef1...635fedcfa8570006830595a4083ca0c8981bed55,1,10,6,16,3,2007-03-22 03:52:17,2007-03-22 03:52:17
635fedcfa8570006830595a4083ca0c8981bed55...f157bcefcac9b921658c6782d4a64c173a203f12,4,80,1,81,6,2007-03-22 10:23:52,2007-03-22 10:23:52
f157bcefcac9b921658c6782d4a64c173a203f12...e63ff1d8ceded127565087d4c197f79b6a31d413,1,2,1,3,1,2007-03-22 12:54:23,2007-03-22 12:54:23
e63ff1d8ceded127565087d4c197f79b6a31d413...2efd343a7cf05d92427d49d85ecf883f9e23d6c9,1,224,0,224,1,2007-03-22 22:16:53,2007-03-22 22:16:53
2efd343a7cf05d92427d49d85ecf883f9e23d6c9...6a7a15586009d2b81d907ef792cdf6cd955931dd,1,6,0,6,1,2007-03-23 02:07:56,2007-03-23 02:07:56
6a7a15586009d2b81d907ef792cdf6cd955931dd...e21a4c8d016e48fb9935e250fe8908c666fb1bbd,1,8,2,10,4,2007-03-23 02:51:09,2007-03-23 02:51:09
e21a4c8d016e48fb9935e250fe8908c666fb1bbd...da8e722a63ec83350bd8e76fd2cae5742bd1fc22,1,96,62,158,22,2007-03-23 06:25:54,2007-03-23 06:25:54
da8e722a63ec83350bd8e76fd2cae5742bd1fc22...af1aa1baea3b24e594bb18bf8eadef7acee10b21,1,6,0,6,1,2007-03-23 14:01:14,2007-03-23 14:01:14
af1aa1baea3b24e594bb18bf8eadef7acee10b21...189e7dd8023b75640c959bd1dbc0d664f0e283cd,15,15,15,30,15,2007-03-23 20:17:04,2007-03-23 20:17:04
189e7dd8023b75640c959bd1dbc0d664f0e283cd...609a42ee06067022e6352822b3c675df29c32029,1,1,1,2,1,2007-03-23 20:18:58,2007-03-23 20:18:58
609a42ee06067022e6352822b3c675df29c32029...c858dfa217e34f4549f3373fd4dbfbb705f37be6,1,107,107,214,2,2007-03-23 20:39:59,2007-03-23 20:39:59
c858dfa217e34f4549f3373fd4dbfbb705f37be6...0cf10f0c28720d5955081ac468d0069eb0bd4457,1,1,1,2,1,2007-03-23 20:41:19,2007-03-23 20:41:19
0cf10f0c28720d5955081ac468d0069eb0bd4457...05e248e5cdfa5b127aae5556dd1f215d8d1fc7d4,1,3,3,6,3,2007-03-23 20:42:32,2007-03-23 20:42:32
05e248e5cdfa5b127aae5556dd1f215d8d1fc7d4...a3d427138d0699b07f74ad8ccdc3ac71e437d4eb,1,1,1,2,1,2007-03-23 20:43:10,2007-03-23 20:43:10
a3d427138d0699b07f74ad8ccdc3ac71e437d4eb...7155d7100c693d71997f68715de1dc3ff7d453c3,1,2,2,4,1,2007-03-23 20:43:44,2007-03-23 20:43:44
7155d7100c693d71997f68715de1dc3ff7d453c3...1c13d05043db3308ed7f0ea210cada9ccc6327e0,12,16,84,100,37,2007-03-23 20:45:30,2007-03-23 20:45:30
1c13d05043db3308ed7f0ea210cada9ccc6327e0...76c9258c0ca6302cfc9763c6be89ab438c56cda6,1,1,1,2,1,2007-03-23 21:02:25,2007-03-23 21:02:25
f2aa1b93e09202707453d26f0648cd9aaf57e4ec...8a1e199cdc86fcee75232790a861473040c2b116,0,0,0,0,0,2007-02-25 05:49:16,2007-02-25 05:49:16
8a1e199cdc86fcee75232790a861473040c2b116...d60c44319459ea6aeb7d2c77d2efd8b4b4683296,0,0,0,0,0,2007-02-25 06:10:35,2007-02-25 06:10:35
d60c44319459ea6aeb7d2c77d2efd8b4b4683296...5514d8731955466dad0cdaf395ddd4da1c101274,124,11716,6001,17717,2345,2007-03-06 14:21:30,2007-03-06 14:21:30
5514d8731955466dad0cdaf395ddd4da1c101274...5edcbdc826b4d87cdb9ba28b4467b3806bdcdb52,11,155,5,160,14,2007-03-07 23:09:33,2007-03-07 23:09:33
5edcbdc826b4d87cdb9ba28b4467b3806bdcdb52...68309c8a338ea796cd31044c65c3f05c4b2660cd,1,3,0,3,1,2007-03-07 23:22:37,2007-03-07 23:22:37
68309c8a338ea796cd31044c65c3f05c4b2660cd...8b279b63bef5c1348cc27c50633fc2d5ef09d7c1,4,351,71,422,4,2007-03-23 16:32:00,2007-03-23 16:32:00
8b279b63bef5c1348cc27c50633fc2d5ef09d7c1...fa3ed6e1341f7c8b468e2267b3fafddeb58cdac2,99,10957,3825,14782,1497,2007-03-23 16:35:57,2007-03-23 16:35:57
fa3ed6e1341f7c8b468e2267b3fafddeb58cdac2...631f30f7c8a830100cfe27770acf0b2289f2cdc0,4,12,0,12,1,2007-03-23 17:45:19,2007-03-23 17:45:19
631f30f7c8a830100cfe27770acf0b2289f2cdc0...8fe241352728ee157afd81b3210582c0e3c6f2bb,1,53,35,88,15,2007-03-23 17:47:48,2007-03-23 17:47:48
8fe241352728ee157afd81b3210582c0e3c6f2bb...177a49ae5e79ddbbce39425e7ecf3d4b1d65815b,3,49,22,71,23,2007-03-29 16:51:20,2007-03-29 16:51:20
177a49ae5e79ddbbce39425e7ecf3d4b1d65815b...2f15f72c89d8324a452fe632a39a4c2e97b956cf,15,15,15,30,15,2007-03-29 16:56:56,2007-03-29 16:56:56
2f15f72c89d8324a452fe632a39a4c2e97b956cf...1a657ecf52af05feda7c387048f845b1d12d1aa7,14,124,192,316,40,2007-03-29 16:58:58,2007-03-29 16:58:58
1a657ecf52af05feda7c387048f845b1d12d1aa7...b6359772b12d5d931b286e1112670d664fb5a46a,1,19,0,19,1,2007-03-31 21:14:22,2007-03-31 21:14:22
b6359772b12d5d931b286e1112670d664fb5a46a...0bf63559189f1ed3314958ca554c9fa1e2780827,1,12,0,12,1,2007-03-31 21:18:05,2007-03-31 21:18:05
0bf63559189f1ed3314958ca554c9fa1e2780827...8ef0b01e721f47fc1a9489dec6d0a54010defa1d,6,59,38,97,26,2007-03-31 21:25:29,2007-03-31 21:25:29
8ef0b01e721f47fc1a9489dec6d0a54010defa1d...fdbbd652bc2c1bfabead349ce1c8d978e116a9b8,1,67,0,67,1,2007-04-11 21:11:48,2007-04-11 21:11:48
fdbbd652bc2c1bfabead349ce1c8d978e116a9b8...39f9d48e4e60a1d82a16f831f3c6153ac21f9148,10,1082,14,1096,15,2007-04-16 03:43:53,2007-04-16 03:43:53
39f9d48e4e60a1d82a16f831f3c6153ac21f9148...522400d8ef6e1557984da13da793f20f94233f7a,2,55,26,81,17,2007-04-18 00:13:25,2007-04-18 00:13:25
522400d8ef6e1557984da13da793f20f94233f7a...e30720a2dcb1e5b1b0be1baae4698a7270e04309,3,47,29,76,21,2007-04-19 12:49:40,2007-04-19 12:49:40
e30720a2dcb1e5b1b0be1baae4698a7270e04309...58aa35e7a598ddec0badd789fd57b7706fa31c71,1,3,3,6,3,2007-05-01 04:04:50,2007-05-01 04:04:50
58aa35e7a598ddec0badd789fd57b7706fa31c71...f84bb1b18f1502844c3e3b52cdb17f19bdc891b6,3,75,63,138,13,2007-05-25 01:29:10,2007-05-25 01:29:10
f84bb1b18f1502844c3e3b52cdb17f19bdc891b6...3a618c7824bca3707e0a8aaf48089251019d7fe9,1,4,0,4,1,2007-05-29 14:12:37,2007-05-29 14:12:37
3a618c7824bca3707e0a8aaf48089251019d7fe9...38ff3cff4535c4e54bb7e5c5744011b26532ddd4,3,86,30,116,25,2007-05-31 23:29:16,2007-05-31 23:29:16
38ff3cff4535c4e54bb7e5c5744011b26532ddd4...b962a44a4d4bb6944c786d3b09277c5746c5755e,27,1674,31,1705,35,2007-06-01 01:15:35,2007-06-01 01:15:35
b962a44a4d4bb6944c786d3b09277c5746c5755e...6538a26a4728e26328ad97163cf094ec92800a45,3,39,20,59,22,2007-06-09 19:55:42,2007-06-09 19:55:42
6538a26a4728e26328ad97163cf094ec92800a45...b0b7bbced7f14e56e72c1b7a674c1f571182aea3,3,55,51,106,28,2007-06-15 03:49:25,2007-06-15 03:49:25
b0b7bbced7f14e56e72c1b7a674c1f571182aea3...48c9f87e1f3ba9523d79c09f52c0ccc6221f08bf,14,500,78,578,74,2007-06-15 06:02:04,2007-06-15 06:02:04
48c9f87e1f3ba9523d79c09f52c0ccc6221f08bf...bdcc95e5cce2754d78055f86d561ba2be92ba854,350,45367,18779,64146,7101,2007-06-18 16:48:27,2007-06-18 16:48:27
bdcc95e5cce2754d78055f86d561ba2be92ba854...c953f188dde3211af31b7eb1a9e83536ef4c6d02,2,4,4,8,2,2007-06-22 01:25:09,2007-06-22 01:25:09
c953f188dde3211af31b7eb1a9e83536ef4c6d02...8648cf78cd42fddf7279477e44c09da4c1937617,5,160,9,169,14,2007-06-25 01:29:01,2007-06-25 01:29:01
8648cf78cd42fddf7279477e44c09da4c1937617...b0a56a9919d2304fa08b71373b53fdfb5ca72de9,2,267,0,267,2,2007-06-25 03:20:26,2007-06-25 03:20:26
b0a56a9919d2304fa08b71373b53fdfb5ca72de9...fc779fe55aec84994e7e761c743716ba03484bcc,91,10223,3758,13981,1524,2007-06-25 19:33:37,2007-06-25 19:33:37
fc779fe55aec84994e7e761c743716ba03484bcc...bea0a500daf95c6d225ca38a0aaa69fab3872f2a,1,4,0,4,2,2007-06-25 23:53:43,2007-06-25 23:53:43
bea0a500daf95c6d225ca38a0aaa69fab3872f2a...7d915d5589c4aa9327b80f0e107e2231f5daf630,42,1762,382,2144,393,2007-07-01 19:40:39,2007-07-01 19:40:39
7d915d5589c4aa9327b80f0e107e2231f5daf630...858ae54a111f55b8d07e9cb53bf480c48f28bede,2,5,5,10,5,2007-07-02 15:45:46,2007-07-02 15:45:46
858ae54a111f55b8d07e9cb53bf480c48f28bede...44069054d72ec5037a4032e890ba31b2f147f065,6,41,18,59,19,2007-07-02 23:47:40,2007-07-02 23:47:40
44069054d72ec5037a4032e890ba31b2f147f065...a183dd8225380ddcc2f742e4b232426203682a8a,1,2,1,3,2,2007-07-04 06:52:40,2007-07-04 06:52:40
a183dd8225380ddcc2f742e4b232426203682a8a...a925a3afe29922c0817fb9e4ae9bef7dc24b1cac,4,61,15,76,8,2007-07-04 06:55:32,2007-07-04 06:55:32
a925a3afe29922c0817fb9e4ae9bef7dc24b1cac...f34300e57a96d54cd9ee1b648e3d466ca9654971,1,1,1,2,1,2007-07-04 08:30:03,2007-07-04 08:30:03
f34300e57a96d54cd9ee1b648e3d466ca9654971...5f7c6f758b212957df15cf7e197681f59dca3858,3,35,7,42,12,2007-07-04 15:27:01,2007-07-04 15:27:01
5f7c6f758b212957df15cf7e197681f59dca3858...f7a23a103a3014794c39da4d466cd3abacf60894,1,5,7,12,3,2007-07-08 07:06:53,2007-07-08 07:06:53
f7a23a103a3014794c39da4d466cd3abacf60894...d92f68f14bee7ea2f7f772e132734238b26258b3,1,72,20,92,17,2007-07-08 07:07:36,2007-07-08 07:07:36
d92f68f14bee7ea2f7f772e132734238b26258b3...c31d20858d8025d105748ef38c015d5371df97e7,4,544,74,618,6,2007-07-08 08:56:29,2007-07-08 08:56:29
c31d20858d8025d105748ef38c015d5371df97e7...342dbc6738d5a7bccb7f1d2c7b6d9c2fbbc9496d,8,906,467,1373,128,2007-07-09 06:16:06,2007-07-09 06:16:06
342dbc6738d5a7bccb7f1d2c7b6d9c2fbbc9496d...382632a26e0b4446d45f8a43bb0bc01dbc05d798,6,31,344,375,20,2007-07-12 06:05:42,2007-07-12 06:05:42
382632a26e0b4446d45f8a43bb0bc01dbc05d798...5292d448065a88f1ac3d86e29962f095c3343162,2,347,0,347,2,2007-07-12 06:10:14,2007-07-12 06:10:14
5292d448065a88f1ac3d86e29962f095c3343162...abccccc09519a10b4a860d8ddb47d29c73d4abcc,5,54,9,63,12,2007-07-12 06:47:40,2007-07-12 06:47:40
abccccc09519a10b4a860d8ddb47d29c73d4abcc...8162e3543c6164edb21127bf2eaccaecda8d6385,1,2,2,4,2,2007-07-12 12:26:40,2007-07-12 12:26:40
8162e3543c6164edb21127bf2eaccaecda8d6385...e9224451864d39c2ba2b2b82070bbafa61563fe1,9,582,185,767,138,2007-07-21 17:39:09,2007-07-21 17:39:09
e9224451864d39c2ba2b2b82070bbafa61563fe1...265bb46dd9e625ff98d069312e4a1d9d36e524a0,1,18,7,25,3,2007-07-22 04:54:29,2007-07-22 04:54:29
265bb46dd9e625ff98d069312e4a1d9d36e524a0...0be7b58460f6a9367c6158c7be39de3d3e9d24c1,14,140,116,256,37,2007-07-22 05:13:22,2007-07-22 05:13:22
0be7b58460f6a9367c6158c7be39de3d3e9d24c1...8f644283ee8e5ffc5693b1409f7753429e665fbc,5,107,0,107,7,2007-07-23 08:47:40,2007-07-23 08:47:40
8f644283ee8e5ffc5693b1409f7753429e665fbc...179a2c45c3381249cb5daa4b888df7cfa4b4c12c,2,14,13,27,11,2007-07-24 03:20:42,2007-07-24 03:20:42
179a2c45c3381249cb5daa4b888df7cfa4b4c12c...add0689d5674538b351a535051c8508c9999f850,2,9,8,17,6,2007-07-24 23:53:35,2007-07-24 23:53:35
add0689d5674538b351a535051c8508c9999f850...6be9797bee1a7eb5789a9951716ee72c9d7edccd,3,17,5,22,6,2007-07-26 01:44:09,2007-07-26 01:44:09
6be9797bee1a7eb5789a9951716ee72c9d7edccd...1c2a08d2d7d7a0e4207c126dc2e292b2b5c2c80e,5,44,17,61,22,2007-07-26 01:55:37,2007-07-26 01:55:37
1c2a08d2d7d7a0e4207c126dc2e292b2b5c2c80e...df45fba3ea521770d4f0d7dbe35eb8736aec1835,3,192,0,192,3,2007-07-26 02:00:38,2007-07-26 02:00:38
df45fba3ea521770d4f0d7dbe35eb8736aec1835...3754b13bec37afab712c52ab15e56fae5a25bac4,3,64,15,79,14,2007-07-26 02:18:26,2007-07-26 02:18:26
3754b13bec37afab712c52ab15e56fae5a25bac4...a2c4f2f61e525af4b46f07110a3dbf439c479b55,6,168,10,178,12,2007-07-26 02:27:17,2007-07-26 02:27:17
a2c4f2f61e525af4b46f07110a3dbf439c479b55...357ef5d97508d1f5b36b9a0f400a5cf712160aed,1,31,5,36,5,2007-07-28 18:51:47,2007-07-28 18:51:47
357ef5d97508d1f5b36b9a0f400a5cf712160aed...68f9a8ee8e9066b315454efb34724801617f162b,8,91,15,106,18,2007-07-28 18:59:44,2007-07-28 18:59:44
68f9a8ee8e9066b315454efb34724801617f162b...7a98b6128e27f35d86f6271521648a03347dc170,2,4,0,4,2,2007-07-29 19:22:51,2007-07-29 19:22:51
7a98b6128e27f35d86f6271521648a03347dc170...ffcc38ebe819fe8f46dd4a0941d202fcde5adb1d,10,305,198,503,16,2007-07-29 19:58:24,2007-07-29 19:58:24
ffcc38ebe819fe8f46dd4a0941d202fcde5adb1d...056f87ab28b327b82508792bbac1e70270885812,7,275,105,380,74,2007-08-02 05:31:10,2007-08-02 05:31:10
056f87ab28b327b82508792bbac1e70270885812...5f4ffb369fd82c8f64082566d816ec3ae2339e79,4,20,13,33,11,2007-08-04 00:27:59,2007-08-04 00:27:59
5f4ffb369fd82c8f64082566d816ec3ae2339e79...e982954602e9a56a53c6bdc2fa2dc7f1e2957110,6,69,23,92,16,2007-08-06 01:13:49,2007-08-06 01:13:49
e982954602e9a56a53c6bdc2fa2dc7f1e2957110...d2ca3b8b8fef57d9bfada833548578b852c5efb2,6,135,25,160,26,2007-08-06 01:27:22,2007-08-06 01:27:22
d2ca3b8b8fef57d9bfada833548578b852c5efb2...fc1dbe70fe69021a182cc6fb5a7db35eddf60529,4,23,7,30,6,2007-08-09 03:07:02,2007-08-09 03:07:02
fc1dbe70fe69021a182cc6fb5a7db35eddf60529...dcf2f144d119e7a043d4b6f0ff245baff6ef6629,8,348,80,428,52,2007-08-13 01:33:26,2007-08-13 01:33:26
dcf2f144d119e7a043d4b6f0ff245baff6ef6629...a7297a255f4bb86f608ea251e00253d18c31d9d4,3,90,23,113,16,2007-08-21 03:24:22,2007-08-21 03:24:22
a7297a255f4bb86f608ea251e00253d18c31d9d4...2052b508eb92c62fc0678efd4936c5ec1e0e735b,405,29150,16402,45552,6311,2007-08-26 01:10:53,2007-08-26 01:10:53
2052b508eb92c62fc0678efd4936c5ec1e0e735b...cb64f5375cc1884226cad05b671e8660214a4a92,22,227,79,306,48,2007-08-26 17:47:34,2007-08-26 17:47:34
cb64f5375cc1884226cad05b671e8660214a4a92...f4203ef757e8bd077b6c77345cc984a4074debe3,9,670,372,1042,167,2007-08-30 01:38:44,2007-08-30 01:38:44
f4203ef757e8bd077b6c77345cc984a4074debe3...85ea9507595f93505d0b921f9bdcaf7408126f68,3,39,24,63,23,2007-08-30 12:58:04,2007-08-30 12:58:04
85ea9507595f93505d0b921f9bdcaf7408126f68...ceac9c9645e12d426edd6cb2e5c11f2cb5048337,3,45,33,78,7,2007-09-07 04:52:02,2007-09-07 04:52:02
ceac9c9645e12d426edd6cb2e5c11f2cb5048337...b74f5ef66f019eaf5e2d4ce206064b30c41f6a75,11,372,23,395,17,2007-09-12 13:04:33,2007-09-12 13:04:33
b74f5ef66f019eaf5e2d4ce206064b30c41f6a75...bda33e69ccfc4997ee1e4aa8b16cbbf2240b4ef6,1,1,1,2,1,2007-09-13 01:09:33,2007-09-13 01:09:33
bda33e69ccfc4997ee1e4aa8b16cbbf2240b4ef6...7c79d21eb420742ca9a9b0f62c3a3b1fdf8cb400,1,19,7,26,6,2007-09-14 14:02:38,2007-09-14 14:02:38
7c79d21eb420742ca9a9b0f62c3a3b1fdf8cb400...e0a665e1213b1124f1c58dbfe048e38d8d89b061,2,4,2,6,4,2007-09-14 22:36:51,2007-09-14 22:36:51
e0a665e1213b1124f1c58dbfe048e38d8d89b061...57135b1cb79214e7a9b4e090de740534c34aa774,1,8,5,13,3,2007-09-14 22:40:13,2007-09-14 22:40:13
57135b1cb79214e7a9b4e090de740534c34aa774...d1d5cf7aa266cc04592e5f122563ae6315870050,1,17,8,25,2,2007-09-14 22:46:41,2007-09-14 22:46:41
d1d5cf7aa266cc04592e5f122563ae6315870050...483a807c063e24f09ecf5ce74d1e241f4c81368c,2,9,2,11,3,2007-09-14 22:56:43,2007-09-14 22:56:43
483a807c063e24f09ecf5ce74d1e241f4c81368c...101446dbda1c047cdac245ee753be83240f47ed4,4,65,10,75,10,2007-09-15 18:56:35,2007-09-15 18:56:35
101446dbda1c047cdac245ee753be83240f47ed4...9c1714234a8695a8c0838f2e5f650da043a52892,1,11,2,13,3,2007-09-15 19:19:11,2007-09-15 19:19:11
9c1714234a8695a8c0838f2e5f650da043a52892...16305693c48f1dd3388c9eb0c1d90bdc5b4ddd2c,3,289,2,291,3,2007-09-17 12:09:54,2007-09-17 12:09:54
16305693c48f1dd3388c9eb0c1d90bdc5b4ddd2c...69452d623794bc9ef160c33c5e9b02180ca4848d,1,0,1,1,1,2007-09-20 02:31:10,2007-09-20 02:31:10
69452d623794bc9ef160c33c5e9b02180ca4848d...7376474260a967e7ad88ee5bf554b4a28e3e7feb,305,33276,16732,50008,3989,2007-09-20 13:02:11,2007-09-20 13:02:11
7376474260a967e7ad88ee5bf554b4a28e3e7feb...e95fda3e2673494b6f39365d291fc09d1e6eb561,2,2,2,4,2,2007-09-20 13:13:18,2007-09-20 13:13:18
e95fda3e2673494b6f39365d291fc09d1e6eb561...07963be5df75230d60976353f81a36398e2ea1e5,4,65,48,113,26,2007-09-24 20:28:23,2007-09-24 20:28:23
07963be5df75230d60976353f81a36398e2ea1e5...102532660224f962b142a178db9dc0fc3c59492e,2,23,27,50,11,2007-09-24 20:29:27,2007-09-24 20:29:27
102532660224f962b142a178db9dc0fc3c59492e...65b4cb2cca6e0ab9f6c4bb0c086e9adfa0301436,2,19,5,24,6,2007-09-24 22:18:00,2007-09-24 22:18:00
65b4cb2cca6e0ab9f6c4bb0c086e9adfa0301436...ea0ae54756d505b9280f379633cbfa2708ed7fce,2,11,7,18,7,2007-09-25 03:55:29,2007-09-25 03:55:29
ea0ae54756d505b9280f379633cbfa2708ed7fce...d0a4c6634f05d1583c10f3fb556c8c654a79fdeb,1,46,23,69,10,2007-09-25 04:25:04,2007-09-25 04:25:04
d0a4c6634f05d1583c10f3fb556c8c654a79fdeb...e8358686215c34427d7ae0962fc5e1c70b413e82,3,56,30,86,4,2007-09-25 06:14:01,2007-09-25 06:14:01
e8358686215c34427d7ae0962fc5e1c70b413e82...cfb807a1fb964f42207bce08ff11ee13617b0251,3,50,57,107,23,2007-09-27 16:42:20,2007-09-27 16:42:20
cfb807a1fb964f42207bce08ff11ee13617b0251...9eb115e304148324e66fa76448515d6fc58df9ee,14,311,136,447,93,2007-09-29 14:02:41,2007-09-29 14:02:41
9eb115e304148324e66fa76448515d6fc58df9ee...53a0514e2bfcf2fa595f4267c84f4acffd6cc520,1,1,1,2,1,2007-09-30 02:30:06,2007-09-30 02:30:06
53a0514e2bfcf2fa595f4267c84f4acffd6cc520...867a74495f33b0434c796ef94efdb3093fe101db,6,82,57,139,44,2007-09-30 04:19:31,2007-09-30 04:19:31
867a74495f33b0434c796ef94efdb3093fe101db...091ba8c2eaeeb7281bd51134b7530de49ae37a8d,3,19,13,32,5,2007-09-30 15:16:22,2007-09-30 15:16:22
091ba8c2eaeeb7281bd51134b7530de49ae37a8d...41709bf315b828e1e919a22ccebb5d54e3ba5c04,5,142,48,190,30,2007-09-30 17:44:13,2007-09-30 17:44:13
41709bf315b828e1e919a22ccebb5d54e3ba5c04...acbc76689444ac62b84cf88529b6792e9ae0595b,35,593,156,749,107,2007-10-01 03:58:05,2007-10-01 03:58:05
acbc76689444ac62b84cf88529b6792e9ae0595b...ad3e9e99a2c6bd640571bb1d6f2e92d74e255188,3,69,19,88,10,2007-10-07 04:21:31,2007-10-07 04:21:31
ad3e9e99a2c6bd640571bb1d6f2e92d74e255188...ddc9361d93235602b97bd2fbf4dfbb31684161fd,3,103,40,143,20,2007-10-07 20:29:59,2007-10-07 20:29:59
ddc9361d93235602b97bd2fbf4dfbb31684161fd...5d7fd63423e631773880265fab82749189932c0a,4,84,2,86,7,2007-10-07 22:42:26,2007-10-07 22:42:26
5d7fd63423e631773880265fab82749189932c0a...b6c8bba5b6b72ce7693f671d2f4bdb1a3a3f4737,12,251,199,450,42,2007-10-08 18:18:17,2007-10-08 18:18:17
b6c8bba5b6b72ce7693f671d2f4bdb1a3a3f4737...c049672a74673293e98104c223f034d5f5e08133,15,219,144,363,61,2007-10-14 20:13:11,2007-10-14 20:13:11
c049672a74673293e98104c223f034d5f5e08133...189335acaaae0fcf111cf566e1dc225e1697e44a,1,0,1,1,1,2007-10-14 20:48:33,2007-10-14 20:48:33
189335acaaae0fcf111cf566e1dc225e1697e44a...ba9fa9844c7996bf1362b9769c2c2fecf760a039,24,595,75,670,73,2007-10-16 06:41:16,2007-10-16 06:41:16
ba9fa9844c7996bf1362b9769c2c2fecf760a039...58fc7897653b0a64658b3ece5d0ff429b4636130,33,214,152,366,91,2007-10-16 16:54:23,2007-10-16 16:54:23
58fc7897653b0a64658b3ece5d0ff429b4636130...712df76528535dfb820848d23806bfac76e4f771,15,378,7,385,22,2007-10-19 00:34:29,2007-10-19 00:34:29
712df76528535dfb820848d23806bfac76e4f771...aed1db82663c421e350b27a4836b4b9591fd8f5f,2,39,11,50,8,2007-10-21 04:27:22,2007-10-21 04:27:22
aed1db82663c421e350b27a4836b4b9591fd8f5f...f66ee9d0065838a0f6c9c76203a775a78446cdf7,7,38,13,51,14,2007-10-22 23:37:26,2007-10-22 23:37:26
f66ee9d0065838a0f6c9c76203a775a78446cdf7...4ffbddf92d89c3b31cef90043721184a501cd454,93,12447,9360,21807,2933,2007-10-26 20:47:20,2007-10-26 20:47:20
4ffbddf92d89c3b31cef90043721184a501cd454...2694fffcc0b8695d91c6b9d4167140721b47c5c5,8,64,24,88,21,2007-11-04 00:48:10,2007-11-04 00:48:10
2694fffcc0b8695d91c6b9d4167140721b47c5c5...1c7ad200c7dc9c8719ba756b09ea9432154f470b,16,806,1039,1845,209,2007-11-06 00:39:36,2007-11-06 00:39:36
1c7ad200c7dc9c8719ba756b09ea9432154f470b...f66821deaef713a5db11a5b162a615945feb6f88,117,6650,2964,9614,1457,2007-11-14 19:13:37,2007-11-14 19:13:37
f66821deaef713a5db11a5b162a615945feb6f88...ef32f913a0849e06c81302c323d51080c4a9e88e,20,1225,616,1841,282,2007-11-17 21:38:36,2007-11-17 21:38:36
ef32f913a0849e06c81302c323d51080c4a9e88e...e88ce426b6133a11df92390806fcde2612a64e99,15,545,274,819,52,2007-11-17 21:57:12,2007-11-17 21:57:12
e88ce426b6133a11df92390806fcde2612a64e99...20a1c654f0c124195d34851d9c65d8806107f0e1,2,134,5,139,4,2007-11-17 22:04:05,2007-11-17 22:04:05
20a1c654f0c124195d34851d9c65d8806107f0e1...f23597cdd75f4aa48d4ec1a7fcb543b3e1c1feca,6,32,23,55,16,2007-11-20 15:10:20,2007-11-20 15:10:20
f23597cdd75f4aa48d4ec1a7fcb543b3e1c1feca...85ce45bc441e4ace2fba83bc2d2432e22ec9da94,6,41,15,56,7,2007-11-20 15:13:55,2007-11-20 15:13:55
85ce45bc441e4ace2fba83bc2d2432e22ec9da94...23384af79b2f43f08e8395d0a84a57c2a98df392,96,6852,3937,10789,1559,2007-12-01 22:12:44,2007-12-01 22:12:44
23384af79b2f43f08e8395d0a84a57c2a98df392...facc725d212962259d2557e6e02b51a741bf58c9,8,30,44,74,24,2007-12-03 06:27:16,2007-12-03 06:27:16
facc725d212962259d2557e6e02b51a741bf58c9...1c45c6f753a9e33f0f2f1306578acb0f030c6f2a,5,47,4,51,7,2007-12-03 08:16:09,2007-12-03 08:16:09
1c45c6f753a9e33f0f2f1306578acb0f030c6f2a...d2fd4f0dc6d4b84c5af0be032a387594349211cd,2,153,32,185,36,2007-12-03 18:15:57,2007-12-03 18:15:57
d2fd4f0dc6d4b84c5af0be032a387594349211cd...cc0cc9fa088b4fb61226a4b2443921fe329e8f2c,2,39,5,44,6,2007-12-04 15:09:06,2007-12-04 15:09:06
cc0cc9fa088b4fb61226a4b2443921fe329e8f2c...fae19f8cedf14c946febd10513bfbaf9377eaf64,26,785,268,1053,156,2007-12-04 17:44:37,2007-12-04 17:44:37
fae19f8cedf14c946febd10513bfbaf9377eaf64...6349985e70411445589bb420dba54e0853f8ff75,4,11,13,24,11,2007-12-11 16:18:48,2007-12-11 16:18:48
6349985e70411445589bb420dba54e0853f8ff75...40a7292a8dbd94db481e3aed9177dfe8bad788a4,1,4,4,8,3,2007-12-13 03:08:06,2007-12-13 03:08:06
40a7292a8dbd94db481e3aed9177dfe8bad788a4...9270d47d80a4ffa09659d26ae71559c20384ffed,4,336,155,491,48,2007-12-14 21:42:37,2007-12-14 21:42:37
9270d47d80a4ffa09659d26ae71559c20384ffed...5799c2e048ff829300af88ae839de20e1763ee1d,11,253,214,467,77,2007-12-15 00:30:48,2007-12-15 00:30:48
5799c2e048ff829300af88ae839de20e1763ee1d...34560a01daee3c42a7c5ec462f38a485cccf4df7,111,3823,1644,5467,589,2007-12-15 01:38:43,2007-12-15 01:38:43
34560a01daee3c42a7c5ec462f38a485cccf4df7...24617b16679005d206e09cc507ed7e056ce574d1,2,9,13,22,5,2007-12-21 21:36:54,2007-12-21 21:36:54
24617b16679005d206e09cc507ed7e056ce574d1...31111857cb0aebcda101f4213688358d13ed96e2,8,166,81,247,82,2007-12-25 21:27:56,2007-12-25 21:27:56
31111857cb0aebcda101f4213688358d13ed96e2...387e6cca92bfc4286d9a4a3290d1077f9eefba31,2,10,8,18,5,2007-12-27 21:44:33,2007-12-27 21:44:33
387e6cca92bfc4286d9a4a3290d1077f9eefba31...ef0f46f1d0b9e41c811d3d6b833f1652ad46aec3,6,153,8,161,14,2007-12-29 07:48:08,2007-12-29 07:48:08
ef0f46f1d0b9e41c811d3d6b833f1652ad46aec3...7e322b5908bf5ec255c90c615d1b45b358ecee5f,75,1073,688,1761,429,2008-01-02 16:57:53,2008-01-02 16:57:53
7e322b5908bf5ec255c90c615d1b45b358ecee5f...b11172e4e72299d34c27eff635ad034f84a0cdb6,7,286,213,499,67,2008-01-03 19:02:18,2008-01-03 19:02:18
b11172e4e72299d34c27eff635ad034f84a0cdb6...1d5e689af2fa541cab83ed7f777f247b32623b6d,3,31,29,60,11,2008-01-04 06:41:13,2008-01-04 06:41:13
1d5e689af2fa541cab83ed7f777f247b32623b6d...298074d5b86e6669b9e43abc77c26ee5be21ead2,3,6,5,11,3,2008-01-06 22:20:39,2008-01-06 22:20:39
298074d5b86e6669b9e43abc77c26ee5be21ead2...5655cf1b2a7b12117de21abb3a5f77d6ffe9a050,2,26,3,29,4,2008-01-09 19:42:23,2008-01-09 19:42:23
5655cf1b2a7b12117de21abb3a5f77d6ffe9a050...730b1f6d7a51c6605961de708c0674687424ad77,2,228,130,358,30,2008-01-10 17:11:02,2008-01-10 17:11:02
730b1f6d7a51c6605961de708c0674687424ad77...3dd6b422ca658eaeddbf499513fb8b0a52b7f41d,1,10,2,12,4,2008-01-18 15:52:37,2008-01-18 15:52:37
3dd6b422ca658eaeddbf499513fb8b0a52b7f41d...8da13e60c2b0df68f41897e1fca21ae370a49318,1,19,4,23,5,2008-01-18 16:38:51,2008-01-18 16:38:51
8da13e60c2b0df68f41897e1fca21ae370a49318...feebe394298d0c2881e903690d0dbeac6b619278,1,3,1,4,2,2008-01-18 16:49:51,2008-01-18 16:49:51
feebe394298d0c2881e903690d0dbeac6b619278...398eca3fb2ac84304b179fabd2f0960228c59b09,7,94,21,115,25,2008-01-22 01:22:27,2008-01-22 01:22:27
398eca3fb2ac84304b179fabd2f0960228c59b09...00292ad02ebf9ff1cb09d586c2452b3a716fd601,46,5205,2596,7801,1296,2008-01-28 15:35:46,2008-01-28 15:35:46
00292ad02ebf9ff1cb09d586c2452b3a716fd601...06f2ddeb51517c6754ccd5a69d00f5b29cd899c3,1,0,2,2,2,2008-01-28 16:31:41,2008-01-28 16:31:41
06f2ddeb51517c6754ccd5a69d00f5b29cd899c3...ead0dad73514f706fdd7943eb7a5690e86fa8eaf,1,6,4,10,2,2008-02-08 14:42:37,2008-02-08 14:42:37
ead0dad73514f706fdd7943eb7a5690e86fa8eaf...c703452841473f3e87fa37612f8ad668d404f59a,2,26,5,31,4,2008-02-08 17:36:43,2008-02-08 17:36:43
c703452841473f3e87fa37612f8ad668d404f59a...40e0a964ea0eab8353a338d5527988f09a0d6e51,2,26,15,41,10,2008-02-08 19:10:00,2008-02-08 19:10:00
40e0a964ea0eab8353a338d5527988f09a0d6e51...d06e33a54d93c35584c348b286b6fea4ffdd3868,61,18097,10062,28159,3627,2008-02-08 20:57:56,2008-02-08 20:57:56
d06e33a54d93c35584c348b286b6fea4ffdd3868...21a019681c4ef2cfe486beb5d43ba068b3247d24,23,461,428,889,139,2008-02-11 02:25:01,2008-02-11 02:25:01
21a019681c4ef2cfe486beb5d43ba068b3247d24...d88c9ac6449c272d8df0023fc0736b9794c43fed,5,74,26,100,23,2008-02-13 00:38:36,2008-02-13 00:38:36
d88c9ac6449c272d8df0023fc0736b9794c43fed...6a692e8031f02880b7773c408a831879b22af574,4,62,8,70,13,2008-02-14 16:05:44,2008-02-14 16:05:44
6a692e8031f02880b7773c408a831879b22af574...ccf9baca863ad56c042fa551a9adece437af2901,6,152,70,222,44,2008-02-14 16:33:16,2008-02-14 16:33:16
ccf9baca863ad56c042fa551a9adece437af2901...bdab7abe2c57b6cd3fd1a94c76e7c79cbaf36157,2,2,2,4,2,2008-02-18 03:03:25,2008-02-18 03:03:25
bdab7abe2c57b6cd3fd1a94c76e7c79cbaf36157...6fef560d979d91d1abd1777246162e5f805b08b3,5,52,23,75,23,2008-02-20 21:15:43,2008-02-20 21:15:43
6fef560d979d91d1abd1777246162e5f805b08b3...0b52413cc926446f238fd781b4def6804f64d231,4,189,1,190,2,2008-02-28 21:06:27,2008-02-28 21:06:27
0b52413cc926446f238fd781b4def6804f64d231...22e016ff6c18a35a450519b94de63033f83e6b4f,76,9569,237,9806,173,2008-02-28 21:24:51,2008-02-28 21:24:51
22e016ff6c18a35a450519b94de63033f83e6b4f...ae0e5835107ff6aa5fe5f4b44fadf318d843462a,5,200,54,254,36,2008-03-10 20:45:51,2008-03-10 20:45:51
ae0e5835107ff6aa5fe5f4b44fadf318d843462a...34df2c0da9a7c91b9bc9355b6d64c5005143703b,1,18,13,31,11,2008-03-10 21:13:52,2008-03-10 21:13:52
34df2c0da9a7c91b9bc9355b6d64c5005143703b...b0a895f9e891bb1fc653724691e6d85612de2708,234,11646,5795,17441,2798,2008-03-18 04:05:09,2008-03-18 04:05:09
b0a895f9e891bb1fc653724691e6d85612de2708...2efc34dc5e65da792700af6594c537104cbee9dc,60,2256,1123,3379,539,2008-03-23 17:18:58,2008-03-23 17:18:58
2efc34dc5e65da792700af6594c537104cbee9dc...f273b371a4c0e46fcdc97c68f459f8da0b777ca7,1,3,1,4,3,2008-03-30 21:45:39,2008-03-30 21:45:39
f273b371a4c0e46fcdc97c68f459f8da0b777ca7...282bccfbc17d22f52b213d21cae07d2c9f0d0b08,1,2,0,2,1,2008-04-01 22:40:32,2008-04-01 22:40:32
282bccfbc17d22f52b213d21cae07d2c9f0d0b08...17baee878918a0b9cc7fab49ebdf010e1d557630,2,24,0,24,2,2008-04-04 12:32:58,2008-04-04 12:32:58
17baee878918a0b9cc7fab49ebdf010e1d557630...4a636ec3a375107d490a72a4f05c5c16b69d9d8e,3,25,34,59,9,2008-04-04 12:57:19,2008-04-04 12:57:19
4a636ec3a375107d490a72a4f05c5c16b69d9d8e...147bd6ac363d6111b932a9de1ec8a20e2c8dc363,2,68,12,80,12,2008-04-07 20:15:04,2008-04-07 20:15:04
147bd6ac363d6111b932a9de1ec8a20e2c8dc363...b0291347db0397ae429564b9e89ded2f0fcc5b36,48,10697,5280,15977,2142,2008-04-07 20:29:36,2008-04-07 20:29:36
b0291347db0397ae429564b9e89ded2f0fcc5b36...55ea575548ffc382fb4885da5a6a6fa331945259,3,21,15,36,7,2008-04-07 21:43:36,2008-04-07 21:43:36
55ea575548ffc382fb4885da5a6a6fa331945259...e1d84dd4fb3b53905e8bbc92a8233b9b65b7a0bd,6,23,29,52,8,2008-04-07 22:20:58,2008-04-07 22:20:58
e1d84dd4fb3b53905e8bbc92a8233b9b65b7a0bd...f49c770b2dc40a4e23c6fe5f3ced62ba80a8502c,2,21,3,24,5,2008-04-22 18:14:29,2008-04-22 18:14:29
f49c770b2dc40a4e23c6fe5f3ced62ba80a8502c...1731135661d374f1ac6ea0b1c067f4e3060374bc,14,234,251,485,220,2008-04-22 18:27:02,2008-04-22 18:27:02
1731135661d374f1ac6ea0b1c067f4e3060374bc...115d4170ae2c7ceed0ada45afbd64b15eda7b2bd,3,27,9,36,8,2008-04-24 23:01:04,2008-04-24 23:01:04
115d4170ae2c7ceed0ada45afbd64b15eda7b2bd...c03a030fd3c74c8a03fa3fdfca08aec0ee6baa1e,1,20,12,32,4,2008-04-25 23:52:41,2008-04-25 23:52:41
c03a030fd3c74c8a03fa3fdfca08aec0ee6baa1e...5456919782e5cd0b885dd383d57e187a06148307,2,28,12,40,6,2008-04-26 00:36:15,2008-04-26 00:36:15
5456919782e5cd0b885dd383d57e187a06148307...e973fea91c4e5924f1d0d709b9c8f0d069380709,74,9904,3945,13849,1006,2008-04-27 17:17:04,2008-04-27 17:17:04
e973fea91c4e5924f1d0d709b9c8f0d069380709...a125a1c9b646368702bb14f26c1a6b09cff3e5a0,1,3,2,5,2,2008-04-27 17:41:42,2008-04-27 17:41:42
a125a1c9b646368702bb14f26c1a6b09cff3e5a0...e5b52f90f0ca2b3b3490c22d869f8c2afc14a526,12,119,46,165,34,2008-04-28 14:08:46,2008-04-28 14:08:46
e5b52f90f0ca2b3b3490c22d869f8c2afc14a526...5922dabea0e622af3f33d17566363a74ff533cd1,8,98,38,136,16,2008-05-01 00:32:50,2008-05-01 00:32:50
5922dabea0e622af3f33d17566363a74ff533cd1...57c700d550343a00494d288e4582ccaaa6b0964e,10,410,172,582,34,2008-05-01 18:17:50,2008-05-01 18:17:50
57c700d550343a00494d288e4582ccaaa6b0964e...579c9d45679dd8f6e9d83cfd75d09fae0595dedf,1,6,3,9,1,2008-05-02 18:38:06,2008-05-02 18:38:06
579c9d45679dd8f6e9d83cfd75d09fae0595dedf...c3f48762fceea5cf3049c12035acc9a2211a0d5c,2,5,5,10,3,2008-05-10 16:18:22,2008-05-10 16:18:22
c3f48762fceea5cf3049c12035acc9a2211a0d5c...5fd838c4dc8111877c668c72f464366f6852a4ad,9,611,561,1172,533,2008-05-18 18:27:22,2008-05-18 18:27:22
5fd838c4dc8111877c668c72f464366f6852a4ad...09ee2359cff52c46f197fc02edb7690bd13e1c47,3,62,0,62,4,2008-05-22 21:52:03,2008-05-22 21:52:03
09ee2359cff52c46f197fc02edb7690bd13e1c47...462d731423d56d6b4a3960fd03d740255bf5a140,3,138,45,183,22,2008-06-04 17:21:54,2008-06-04 17:21:54
462d731423d56d6b4a3960fd03d740255bf5a140...acfc49ed4e3c1920b0fd71a7124e688eb2002a1b,1,7,3,10,1,2008-06-04 17:24:08,2008-06-04 17:24:08
acfc49ed4e3c1920b0fd71a7124e688eb2002a1b...b4a687b18921a975b18b194d124844c80f5d8f39,1,5,4,9,3,2008-06-04 17:25:55,2008-06-04 17:25:55
b4a687b18921a975b18b194d124844c80f5d8f39...a245b72d67376a7c287ff419773c9e3fb2bcf4ed,23,467,318,785,302,2008-06-04 17:37:02,2008-06-04 17:37:02
a245b72d67376a7c287ff419773c9e3fb2bcf4ed...eb30cad66ab1d5ff6a56425ecdf7efd0ade6d750,1,34,11,45,9,2008-06-15 17:28:21,2008-06-15 17:28:21
eb30cad66ab1d5ff6a56425ecdf7efd0ade6d750...4ec80c4333b618fc1ef2a02c7b8ca8719792f25f,27,1366,543,1909,195,2008-06-15 19:48:57,2008-06-15 19:48:57
4ec80c4333b618fc1ef2a02c7b8ca8719792f25f...842dae0ed59cc7566cf35090093222ea3a61ec79,68,1563,441,2004,346,2008-06-16 00:34:17,2008-06-16 00:34:17
842dae0ed59cc7566cf35090093222ea3a61ec79...6fdd9254e68f64d83a8e5a02db1a9b45bb3b93ba,3,22,4,26,8,2008-06-16 16:39:36,2008-06-16 16:39:36
6fdd9254e68f64d83a8e5a02db1a9b45bb3b93ba...2eeb84bd55796affde0e94bd5d1276e973178f8e,2,18,10,28,4,2008-06-16 16:58:12,2008-06-16 16:58:12
2eeb84bd55796affde0e94bd5d1276e973178f8e...6b12a135d62137c5c3e8da6dcc36b16f66b81225,4,21,5,26,5,2008-06-19 06:00:13,2008-06-19 06:00:13
6b12a135d62137c5c3e8da6dcc36b16f66b81225...f83b8efefdf83beec6dfd871ea1b88c7a35c892a,3,140,3,143,5,2008-06-19 20:01:29,2008-06-19 20:01:29
f83b8efefdf83beec6dfd871ea1b88c7a35c892a...9fcc6c305a562b2e622049d4ce8b6148a2c617ca,2,2,1,3,2,2008-06-26 14:31:03,2008-06-26 14:31:03
9fcc6c305a562b2e622049d4ce8b6148a2c617ca...aef8a8305d2190b00386b8b1603deb03a2949f5b,130,11114,2651,13765,2109,2008-06-26 15:11:55,2008-06-26 15:11:55
aef8a8305d2190b00386b8b1603deb03a2949f5b...bc3d6b49089ef0ea7d174eb383b1019b6a4a061a,104,6948,2230,9178,890,2008-07-04 20:16:22,2008-07-04 20:16:22
bc3d6b49089ef0ea7d174eb383b1019b6a4a061a...597b07117af5e2d2aa69ddf254f9082e6fe2d608,1,12,29,41,4,2008-07-05 15:40:55,2008-07-05 15:40:55
597b07117af5e2d2aa69ddf254f9082e6fe2d608...ccd5f52ee7fd5383752ab78ec469039c22100cbe,3,19,9,28,8,2008-07-05 16:59:51,2008-07-05 16:59:51
ccd5f52ee7fd5383752ab78ec469039c22100cbe...822a1259f6d81392035e6698e6386b9639e14eec,4,158,20,178,24,2008-07-05 22:10:33,2008-07-05 22:10:33
822a1259f6d81392035e6698e6386b9639e14eec...6d77419deb5914370822433ec01bec8b561e7620,2,4,4,8,4,2008-07-08 18:46:09,2008-07-08 18:46:09
6d77419deb5914370822433ec01bec8b561e7620...314d19db6640cf66aad9bea34b3ee4b862f70e25,1,1,1,2,1,2008-07-10 20:33:59,2008-07-10 20:33:59
314d19db6640cf66aad9bea34b3ee4b862f70e25...5bf3565a263533e37b2e1217e8d447cb7e02f5b4,82,2259,939,3198,455,2008-07-13 14:31:09,2008-07-13 14:31:09
5bf3565a263533e37b2e1217e8d447cb7e02f5b4...149e731c3c5a2cc96b7d3c72070401df6c2a238e,207,9422,3597,13019,634,2008-07-19 13:30:47,2008-07-19 13:30:47
149e731c3c5a2cc96b7d3c72070401df6c2a238e...2995f4e50947df269efc785fc1136e6e9db5e415,13,512,1,513,13,2008-07-19 14:17:24,2008-07-19 14:17:24
2995f4e50947df269efc785fc1136e6e9db5e415...fff69c18c185906fd41389f50b463b3dc57a09b3,6,0,11,11,6,2008-07-20 01:48:23,2008-07-20 01:48:23
fff69c18c185906fd41389f50b463b3dc57a09b3...7011fc6d3cb2c5aec499b3023546c25fd3002d22,3,57,42,99,19,2008-07-20 21:30:46,2008-07-20 21:30:46
7011fc6d3cb2c5aec499b3023546c25fd3002d22...825d6edd69404de29c6fb8be568176f03b0c982c,17,174,75,249,42,2008-07-22 01:10:59,2008-07-22 01:10:59
825d6edd69404de29c6fb8be568176f03b0c982c...bfe714f014d54f1f9bd67166b530006f740a820e,2,10,2,12,4,2008-07-22 02:43:47,2008-07-22 02:43:47
bfe714f014d54f1f9bd67166b530006f740a820e...b33e7099811b3723c0c77c633e79f0a36eba3c96,2,4,38,42,3,2008-07-23 22:24:16,2008-07-23 22:24:16
b33e7099811b3723c0c77c633e79f0a36eba3c96...25cfbd6d665b7ac7504766f0b0900f6affdd4533,1,3,3,6,3,2008-07-26 01:03:24,2008-07-26 01:03:24
25cfbd6d665b7ac7504766f0b0900f6affdd4533...2135e10739e28dc518a54a5a4ce5358d7e714bd2,1,0,21,21,1,2008-07-29 22:02:58,2008-07-29 22:02:58
2135e10739e28dc518a54a5a4ce5358d7e714bd2...45b73c9a4685809236f84046cc7ffd32a50db958,2,25,6,31,5,2008-07-30 17:46:02,2008-07-30 17:46:02
45b73c9a4685809236f84046cc7ffd32a50db958...aa239e3e5405933af6a29dac3cf587b59a099927,269,20937,13781,34718,5536,2008-08-05 17:15:33,2008-08-05 17:15:33
76c9258c0ca6302cfc9763c6be89ab438c56cda6...334499d6f3d51f313fdeecbd87a18bdd3b8c6a01,1,4,4,8,4,2007-03-23 21:16:32,2007-03-23 21:16:32
334499d6f3d51f313fdeecbd87a18bdd3b8c6a01...ae7568b9c6ed790dca6a3c24c489fb15442e2be4,1,0,8,8,2,2007-03-23 21:18:08,2007-03-23 21:18:08
ae7568b9c6ed790dca6a3c24c489fb15442e2be4...6481cf43f98d3fdc45a3c5a1f2f366b88417d4cb,2,3,3,6,2,2007-03-25 18:05:01,2007-03-25 18:05:01
6481cf43f98d3fdc45a3c5a1f2f366b88417d4cb...bd8c2fead83ee5e88cb2aa5f851ca493d455fa24,1,1,1,2,1,2007-03-25 18:09:43,2007-03-25 18:09:43
bd8c2fead83ee5e88cb2aa5f851ca493d455fa24...5d079ee2149616c5c4861b76255e6b7d71c5ab1b,1,10,0,10,1,2007-03-25 21:06:12,2007-03-25 21:06:12
5d079ee2149616c5c4861b76255e6b7d71c5ab1b...955f4db6f4e2047ef610230d22799171c335f1c0,5,378,0,378,4,2007-03-25 21:10:36,2007-03-25 21:10:36
955f4db6f4e2047ef610230d22799171c335f1c0...e2c04e8cf292e679a13fb802949b9fb608900247,1,108,109,217,2,2007-03-25 21:22:07,2007-03-25 21:22:07
e2c04e8cf292e679a13fb802949b9fb608900247...f2861dad432c7f3a21c5e76f6955ada35ace6128,4,192,0,192,3,2007-03-25 21:26:44,2007-03-25 21:26:44
f2861dad432c7f3a21c5e76f6955ada35ace6128...796b2304f306ff32527fc384c9be0ba783b2df05,1,1,1,2,1,2007-03-25 21:28:59,2007-03-25 21:28:59
796b2304f306ff32527fc384c9be0ba783b2df05...293d6cf284407b156b6c2d86f1220ca1eea36f42,1,1,1,2,1,2007-03-25 23:22:04,2007-03-25 23:22:04
293d6cf284407b156b6c2d86f1220ca1eea36f42...9c10a2f1184ee92ed9dcce6f54e114082c357bfa,1,2,2,4,2,2007-03-25 23:22:37,2007-03-25 23:22:37
9c10a2f1184ee92ed9dcce6f54e114082c357bfa...a5bb14ed2e3e1a26a4f7312582cf3e350bdd3985,2,18,6,24,3,2007-03-25 23:29:31,2007-03-25 23:29:31
a5bb14ed2e3e1a26a4f7312582cf3e350bdd3985...8a0b3ed35b646455f69578cb1131ca58e5420532,2,16,7,23,2,2007-03-25 23:31:40,2007-03-25 23:31:40
8a0b3ed35b646455f69578cb1131ca58e5420532...750ea554c12b34f7b68653488f345f4066191e08,1,16,8,24,3,2007-03-27 11:11:03,2007-03-27 11:11:03
750ea554c12b34f7b68653488f345f4066191e08...d6fd9fb22bdbc6939fbe97c6e0571b8002d014c6,3,57,0,57,4,2007-03-27 17:25:56,2007-03-27 17:25:56
d6fd9fb22bdbc6939fbe97c6e0571b8002d014c6...45f9217cbd480725b0ce9d4028ee4fab7af21f11,1,5,4,9,3,2007-03-27 17:30:57,2007-03-27 17:30:57
45f9217cbd480725b0ce9d4028ee4fab7af21f11...932928a1e2f48cacc94c0052626bcf6971ac3523,1,2,2,4,2,2007-03-27 19:02:32,2007-03-27 19:02:32
932928a1e2f48cacc94c0052626bcf6971ac3523...9a2a9a9fe8eb93ecf1cb6ef64c0fd90be2a05216,1,19,5,24,4,2007-03-27 22:18:52,2007-03-27 22:18:52
9a2a9a9fe8eb93ecf1cb6ef64c0fd90be2a05216...e2937ef6a097aeac7f56c5cf0081beda5df43a31,1,3,2,5,3,2007-03-27 22:30:59,2007-03-27 22:30:59
e2937ef6a097aeac7f56c5cf0081beda5df43a31...302d183a2f843b6379bd5a936f180d4c5b71a46f,1,26,26,52,24,2007-03-27 22:35:22,2007-03-27 22:35:22
302d183a2f843b6379bd5a936f180d4c5b71a46f...f6d370c3a4bd15063b6e75cc71f5cea0f6121c33,2,7,16,23,2,2007-03-28 15:38:49,2007-03-28 15:38:49
f6d370c3a4bd15063b6e75cc71f5cea0f6121c33...cbf3940b0379419d9e42d4518367c3fd1a0bac91,0,0,0,0,0,2007-03-29 10:53:17,2007-03-29 10:53:17
cbf3940b0379419d9e42d4518367c3fd1a0bac91...4a6c7e75c2de668a09a3c7c0afc72a4549c4123d,1,1,1,2,1,2007-03-29 10:55:48,2007-03-29 10:55:48
4a6c7e75c2de668a09a3c7c0afc72a4549c4123d...4dab533f7eb85d638d96d2a435bfd7eaa34dd784,1,11,5,16,5,2007-03-29 11:05:44,2007-03-29 11:05:44
4dab533f7eb85d638d96d2a435bfd7eaa34dd784...1f0b1afbfe2e40fe63da7b4f6a9621660ee1f4a0,1,5,0,5,1,2007-03-29 11:13:20,2007-03-29 11:13:20
1f0b1afbfe2e40fe63da7b4f6a9621660ee1f4a0...5f68a26ff4eceaa46a6963184bb80d136d207828,2,89,0,89,3,2007-03-29 11:43:24,2007-03-29 11:43:24
5f68a26ff4eceaa46a6963184bb80d136d207828...aebd5f94a22814228966faca91cf1926a14c832a,1,1,1,2,1,2007-03-29 11:46:26,2007-03-29 11:46:26
aebd5f94a22814228966faca91cf1926a14c832a...c1a73d80da65694319d803160b5e400e11318213,2,3,2,5,2,2007-03-29 11:59:31,2007-03-29 11:59:31
c1a73d80da65694319d803160b5e400e11318213...587abaa95cbf598c6cb7d115994350bffe05d613,1,1,1,2,1,2007-03-29 22:28:13,2007-03-29 22:28:13
587abaa95cbf598c6cb7d115994350bffe05d613...d22e39c10da2990cac9fe5223bc3e5cdff00e800,8,198,107,305,19,2007-03-30 01:50:06,2007-03-30 01:50:06
d22e39c10da2990cac9fe5223bc3e5cdff00e800...97e65d1c9d834b05d565f61175c1c7cdf36b62b9,1,1,0,1,1,2007-03-30 01:50:46,2007-03-30 01:50:46
97e65d1c9d834b05d565f61175c1c7cdf36b62b9...93cbd0844d11c0e4100b24191fe0e61aa1f7b41d,2,16,8,24,9,2007-03-30 04:48:35,2007-03-30 04:48:35
93cbd0844d11c0e4100b24191fe0e61aa1f7b41d...72235e5a95ba7fd6fae749d2f28f710373f91986,2,1555,1443,2998,345,2007-03-30 04:51:18,2007-03-30 04:51:18
72235e5a95ba7fd6fae749d2f28f710373f91986...6f19ce883232aa8bb6515f1e77a2351b32eec024,2,66,66,132,65,2007-03-30 04:53:36,2007-03-30 04:53:36
6f19ce883232aa8bb6515f1e77a2351b32eec024...efd95dfedddb9b3a3e058b21ddd36398048e3ba4,5,171,0,171,4,2007-03-30 05:45:17,2007-03-30 05:45:17
efd95dfedddb9b3a3e058b21ddd36398048e3ba4...e824bcb1bd7c83bd2bd20cb0251af9f0bc6db894,4,435,123,558,115,2007-03-30 05:51:42,2007-03-30 05:51:42
e824bcb1bd7c83bd2bd20cb0251af9f0bc6db894...179b5b8422dcf4178376456c4c61ac3f2f46ee45,1,2,1,3,1,2007-03-30 06:16:41,2007-03-30 06:16:41
179b5b8422dcf4178376456c4c61ac3f2f46ee45...3c6609ac0cbf367f2c9f166c0001d4d18a7e9ca2,1,16,15,31,15,2007-03-30 06:46:36,2007-03-30 06:46:36
3c6609ac0cbf367f2c9f166c0001d4d18a7e9ca2...6a643b03d7af5777c0729ee62d35a080158fc8af,1,3,0,3,1,2007-03-30 06:48:19,2007-03-30 06:48:19
6a643b03d7af5777c0729ee62d35a080158fc8af...51c7dadc4c7344cabe24b3120522d02fb6cd987e,5,501,0,501,4,2007-03-30 10:04:22,2007-03-30 10:04:22
51c7dadc4c7344cabe24b3120522d02fb6cd987e...63a629bb8dd55a7976d7a71a93966f5e0c05ca5c,2,70,1,71,4,2007-03-30 10:18:15,2007-03-30 10:18:15
63a629bb8dd55a7976d7a71a93966f5e0c05ca5c...5e739219de63328c13e14d60732ced4f28c033b9,5,23,4,27,5,2007-03-30 11:57:50,2007-03-30 11:57:50
5e739219de63328c13e14d60732ced4f28c033b9...df119b778654613f4a2fba0bfe8c4c011423866f,1,2,2,4,1,2007-03-30 12:00:38,2007-03-30 12:00:38
df119b778654613f4a2fba0bfe8c4c011423866f...7be1f44053e3b099637cee625852f273bf8cad21,1,1,1,2,1,2007-03-31 02:23:34,2007-03-31 02:23:34
7be1f44053e3b099637cee625852f273bf8cad21...79312f7a4e06e08ec69c15d832013ed30bb6d1ad,5,193,0,193,4,2007-03-31 09:05:54,2007-03-31 09:05:54
79312f7a4e06e08ec69c15d832013ed30bb6d1ad...64073e4752824de21131cfac2fcec35dc6c67579,4,108,0,108,3,2007-03-31 09:14:37,2007-03-31 09:14:37
64073e4752824de21131cfac2fcec35dc6c67579...5787603c8b9753b5afa6739ee4654105eb877657,1,18,0,18,1,2007-03-31 09:18:20,2007-03-31 09:18:20
5787603c8b9753b5afa6739ee4654105eb877657...1ccdcbf765f146040f8cb2130b4b20fc8cd5ff90,1,13,0,13,1,2007-03-31 09:40:27,2007-03-31 09:40:27
1ccdcbf765f146040f8cb2130b4b20fc8cd5ff90...6a5deb6bc0ca6260b2af374583737c3c63a3037b,1,3,2,5,2,2007-03-31 09:47:32,2007-03-31 09:47:32
6a5deb6bc0ca6260b2af374583737c3c63a3037b...d7cf8eb406bd3e7c6cf2c09a103935b219b261e5,1,28,4,32,3,2007-03-31 11:35:06,2007-03-31 11:35:06
d7cf8eb406bd3e7c6cf2c09a103935b219b261e5...04c155fd06484058d5677f61f6931f7f5da0922f,1,4,2,6,1,2007-03-31 11:45:24,2007-03-31 11:45:24
04c155fd06484058d5677f61f6931f7f5da0922f...1109e722aaf1c9100bcb4ea0c3e23b5fd4c8c8de,2,15,1,16,2,2007-03-31 12:02:37,2007-03-31 12:02:37
1109e722aaf1c9100bcb4ea0c3e23b5fd4c8c8de...9191fa1f644481d2e9a0495f9585f9bf1e83d87e,4,9,9,18,7,2007-04-01 01:09:21,2007-04-01 01:09:21
9191fa1f644481d2e9a0495f9585f9bf1e83d87e...f271e0896bb74dd06a10d8de3221ce34c8e4d9dc,1,4,4,8,1,2007-04-01 01:25:01,2007-04-01 01:25:01
f271e0896bb74dd06a10d8de3221ce34c8e4d9dc...b11454dc3d3e844ddda11db5ed363af726340855,2,850,839,1689,4,2007-04-01 04:40:36,2007-04-01 04:40:36
b11454dc3d3e844ddda11db5ed363af726340855...a599f1234eb7e511aa2c0766873750ad70390aaf,1,4,2,6,3,2007-04-01 05:00:44,2007-04-01 05:00:44
a599f1234eb7e511aa2c0766873750ad70390aaf...4552175d44576934f23edb63093c4747d3c2426d,1,10,9,19,1,2007-04-01 05:05:59,2007-04-01 05:05:59
4552175d44576934f23edb63093c4747d3c2426d...99fbb7b62b61b3e4beef99f46132567082adbea9,1,4,0,4,1,2007-04-01 05:18:47,2007-04-01 05:18:47
99fbb7b62b61b3e4beef99f46132567082adbea9...da1d001ce1105fb3f34c07fa75018e8137e3ece5,1,8,10,18,8,2007-04-01 05:22:14,2007-04-01 05:22:14
da1d001ce1105fb3f34c07fa75018e8137e3ece5...018ece8dc8d564b18d35b7bcd468eaf619fa1385,1,3,3,6,1,2007-04-01 05:23:08,2007-04-01 05:23:08
018ece8dc8d564b18d35b7bcd468eaf619fa1385...4e31a17e9e4781d84149940e2084a7e1060919f0,1,2,1,3,1,2007-04-01 05:25:03,2007-04-01 05:25:03
4e31a17e9e4781d84149940e2084a7e1060919f0...c60587b5a7692807c2d0f1970d45e2bde724233d,3,19,1,20,4,2007-04-01 05:26:26,2007-04-01 05:26:26
c60587b5a7692807c2d0f1970d45e2bde724233d...78b86d7eeb74273f559ccbddca067b16c5b80c96,1,1,1,2,1,2007-04-01 05:32:44,2007-04-01 05:32:44
78b86d7eeb74273f559ccbddca067b16c5b80c96...96bf5e853c42770772dcc3fc1fba5fcf85733a11,1,2,1,3,1,2007-04-01 05:42:48,2007-04-01 05:42:48
96bf5e853c42770772dcc3fc1fba5fcf85733a11...72dfcab0d43bd26166605d26dd89d33d6f033676,4,34,13,47,9,2007-04-01 06:00:45,2007-04-01 06:00:45
72dfcab0d43bd26166605d26dd89d33d6f033676...9b6a518e1748c6ef66450c9e75007e1e5ce3f98e,2,13,10,23,4,2007-04-01 06:40:01,2007-04-01 06:40:01
9b6a518e1748c6ef66450c9e75007e1e5ce3f98e...9a6261a83705dcbad59b07cad7529127aa79509f,1,2,2,4,1,2007-04-01 06:42:35,2007-04-01 06:42:35
9a6261a83705dcbad59b07cad7529127aa79509f...a071609a7019500e31fcb71e5eb0acb37d9673ba,1,5,4,9,1,2007-04-01 06:44:17,2007-04-01 06:44:17
a071609a7019500e31fcb71e5eb0acb37d9673ba...d882656ea34119b2c371cc4adbe0aac180651cde,5,83,17,100,15,2007-04-01 07:25:20,2007-04-01 07:25:20
d882656ea34119b2c371cc4adbe0aac180651cde...70c4a88e8286d8495faedf6295cb16101e4cc96c,1,17,8,25,10,2007-04-01 07:30:27,2007-04-01 07:30:27
70c4a88e8286d8495faedf6295cb16101e4cc96c...b6f085aa432eb0cf31e6cc61616e0ee812c693ae,1,1,1,2,1,2007-04-01 07:36:06,2007-04-01 07:36:06
b6f085aa432eb0cf31e6cc61616e0ee812c693ae...4a3db287f1c86f7e66408432b381190bc9d0557d,2,27,0,27,4,2007-04-02 10:53:05,2007-04-02 10:53:05
4a3db287f1c86f7e66408432b381190bc9d0557d...286e676231c0de9eff97d23c1132c833d346a887,2,92,11,103,6,2007-04-02 10:58:43,2007-04-02 10:58:43
286e676231c0de9eff97d23c1132c833d346a887...9107ab6e1d9b6b42fbd3729fd58ba97e86bc0e38,1,4,1,5,2,2007-04-03 03:08:56,2007-04-03 03:08:56
9107ab6e1d9b6b42fbd3729fd58ba97e86bc0e38...44ba9aa6747de919b71a603b9b971927a00eb585,2,12,12,24,12,2007-04-03 03:13:21,2007-04-03 03:13:21
44ba9aa6747de919b71a603b9b971927a00eb585...b6264d04528f7f83400b659a1a421cbe021c267b,1,3,1,4,1,2007-04-03 03:45:47,2007-04-03 03:45:47
b6264d04528f7f83400b659a1a421cbe021c267b...a5938f350ca65fdfbe22050c1a04ba8a99e87854,2,54,0,54,3,2007-04-03 03:56:17,2007-04-03 03:56:17
a5938f350ca65fdfbe22050c1a04ba8a99e87854...abe6c5d6ae20a3fd29e30ca73df3a54c8177a69c,3,2180,1535,3715,420,2007-04-03 04:42:40,2007-04-03 04:42:40
abe6c5d6ae20a3fd29e30ca73df3a54c8177a69c...b9d077c10d0ded84ee91ac375eafb24e1658237d,4,39,16,55,14,2007-04-03 12:28:19,2007-04-03 12:28:19
b9d077c10d0ded84ee91ac375eafb24e1658237d...a3f32ead5dc23b3a1d8e9063ae7554e781fbc780,1,1,1,2,1,2007-04-03 12:30:13,2007-04-03 12:30:13
a3f32ead5dc23b3a1d8e9063ae7554e781fbc780...bb53a0e264d1571b279ec935df71ee8136fd20e2,1,1,1,2,1,2007-04-03 16:05:03,2007-04-03 16:05:03
bb53a0e264d1571b279ec935df71ee8136fd20e2...87471549b3f13ce44968655fba4e19cdbc235c77,1,2,2,4,2,2007-04-03 21:57:15,2007-04-03 21:57:15
87471549b3f13ce44968655fba4e19cdbc235c77...f791a598a8e207a6f362ea75b9474f7739b518c7,3,6,8,14,7,2007-04-03 22:33:28,2007-04-03 22:33:28
f791a598a8e207a6f362ea75b9474f7739b518c7...1bddac37b69152d919a3af29f2844ae3e34c7237,10,41,40,81,15,2007-04-04 06:34:19,2007-04-04 06:34:19
1bddac37b69152d919a3af29f2844ae3e34c7237...5212911b1991aa749d828b31177dce99237068ed,2,14,8,22,9,2007-04-04 06:43:28,2007-04-04 06:43:28
5212911b1991aa749d828b31177dce99237068ed...7a0441b712609999b1d45884d8113c8f98c956ab,5,63,0,63,4,2007-04-04 06:45:29,2007-04-04 06:45:29
7a0441b712609999b1d45884d8113c8f98c956ab...33a3220fa14775680e86cd8ecad5177f8b8e193c,0,0,0,0,0,2007-04-04 06:54:32,2007-04-04 06:54:32
33a3220fa14775680e86cd8ecad5177f8b8e193c...5f2c513f9cfb7c4e20f3c970c602649e64de541d,2,77,0,77,3,2007-04-04 11:40:08,2007-04-04 11:40:08
5f2c513f9cfb7c4e20f3c970c602649e64de541d...56d56e5bac2923382fd10036dbe045412390362d,1,4,0,4,1,2007-04-04 13:25:53,2007-04-04 13:25:53
56d56e5bac2923382fd10036dbe045412390362d...f529a1f12ea4f96f1d3de1458f77bcfdf4229879,2,14,5,19,5,2007-04-04 13:52:35,2007-04-04 13:52:35
f529a1f12ea4f96f1d3de1458f77bcfdf4229879...bc65445e8d311093d2b2142f81d1554b55bfe822,1,2,3,5,3,2007-04-04 13:57:14,2007-04-04 13:57:14
bc65445e8d311093d2b2142f81d1554b55bfe822...5f7b0dfb1128b494f3c80fd63d9f16f44007d7d9,2,2,2,4,2,2007-04-04 15:15:51,2007-04-04 15:15:51
5f7b0dfb1128b494f3c80fd63d9f16f44007d7d9...084bb7420f9cb18991e51ae7b534b30ebc2ce83c,2,64,61,125,50,2007-04-05 01:55:55,2007-04-05 01:55:55
084bb7420f9cb18991e51ae7b534b30ebc2ce83c...367db24b79d28d206950029718f98fe4ece318c8,1,1724,1176,2900,350,2007-04-05 01:57:09,2007-04-05 01:57:09
367db24b79d28d206950029718f98fe4ece318c8...e725280cb17cd7301f403232ffda7f0f438edd5a,1,0,0,0,0,2007-04-05 01:57:51,2007-04-05 01:57:51
e725280cb17cd7301f403232ffda7f0f438edd5a...b30c505d0d796f5d104dbf97372e99389dfbec38,1,1,1,2,1,2007-04-05 03:13:17,2007-04-05 03:13:17
b30c505d0d796f5d104dbf97372e99389dfbec38...8424ea39f81bb23d4386db442dbac4f7630555a2,1,14,1,15,2,2007-04-05 03:22:49,2007-04-05 03:22:49
8424ea39f81bb23d4386db442dbac4f7630555a2...e57d1bdddadf714e41ec026e2dde9ab1cb329813,1,1,1,2,1,2007-04-05 03:25:30,2007-04-05 03:25:30
e57d1bdddadf714e41ec026e2dde9ab1cb329813...73c40c5999d6945ada3e1da3c7ec693d977bffea,1,1,1,2,1,2007-04-05 14:52:33,2007-04-05 14:52:33
73c40c5999d6945ada3e1da3c7ec693d977bffea...e339a41222590eace1bafff7e3d3fafe0929c3d0,1,2,2,4,2,2007-04-05 15:34:32,2007-04-05 15:34:32
e339a41222590eace1bafff7e3d3fafe0929c3d0...dabd96646cf04f0b4dc346f90baf8199e225f128,14,121,26,147,18,2007-04-06 02:25:58,2007-04-06 02:25:58
dabd96646cf04f0b4dc346f90baf8199e225f128...07f599ca5ce7291d2d474d376d9cffe8fc6f8138,1,4,4,8,2,2007-04-06 02:27:18,2007-04-06 02:27:18
07f599ca5ce7291d2d474d376d9cffe8fc6f8138...e3308e19767ac1345c6c39459641c9a90677604b,2,27,35,62,10,2007-04-06 04:24:06,2007-04-06 04:24:06
e3308e19767ac1345c6c39459641c9a90677604b...c7f6cd02436fce1cf47eb0fa4b00fbc9b5ebece6,1,5,0,5,5,2007-04-07 04:21:31,2007-04-07 04:21:31
76c9258c0ca6302cfc9763c6be89ab438c56cda6...c48165765e46dcfff4a98d70d5a25087dfd3276f,0,0,0,0,0,2007-03-23 21:02:44,2007-03-23 21:02:44
c48165765e46dcfff4a98d70d5a25087dfd3276f...6c1c7c9e4f4d47a05f7281d976545d928a1722f2,0,0,0,0,0,2007-10-26 18:43:33,2007-10-26 18:43:33
6c1c7c9e4f4d47a05f7281d976545d928a1722f2...7dd2dd08a79e388732ce00e2b5514f15bd6d0f6f,5,92,55,147,16,2007-10-26 19:52:29,2007-10-26 19:52:29
7dd2dd08a79e388732ce00e2b5514f15bd6d0f6f...7791e5c050cebf86d868c5dab7092185b125fdc9,1,2,1,3,2,2008-05-14 04:06:46,2008-05-14 04:06:46
7791e5c050cebf86d868c5dab7092185b125fdc9...3ca5a055a7578e07ba5f892fefaba23876e9afca,3,3,3,6,3,2008-05-14 04:15:22,2008-05-14 04:15:22
3ca5a055a7578e07ba5f892fefaba23876e9afca...7e0972bded362bc4b851c109df2c8a6548481a8e,2,3,40,43,8,2008-09-02 21:10:00,2008-09-02 21:10:00
7e0972bded362bc4b851c109df2c8a6548481a8e...1232a467653ea07f7cc2078f4a04906a34240a67,2,2,2,4,2,2008-09-02 21:19:42,2008-09-02 21:19:42
1232a467653ea07f7cc2078f4a04906a34240a67...da85d76fd6ca846f3b0ff414e042ddb5e62e2e69,5,95,8,103,8,2009-07-29 02:57:43,2009-07-29 02:57:43
da85d76fd6ca846f3b0ff414e042ddb5e62e2e69...40598612d184968722c7b1abda183dbd4cb758c2,2,5,4,9,3,2009-07-29 03:30:13,2009-07-29 03:30:13
40598612d184968722c7b1abda183dbd4cb758c2...9cc89c97b9fd238254b11054583b5ec80f6a2fd9,1,28,0,28,1,2009-08-11 13:06:32,2009-08-11 13:06:32
9cc89c97b9fd238254b11054583b5ec80f6a2fd9...c60c89a76e2541cace57edcb3ca47ebb74d216d5,1,1,1,2,1,2009-08-12 08:32:49,2009-08-12 08:32:49
c60c89a76e2541cace57edcb3ca47ebb74d216d5...c4c00358ee30bbe8b7ae460f873935251b2de079,3,3,3,6,3,2009-08-19 23:42:22,2009-08-19 23:42:22
c4c00358ee30bbe8b7ae460f873935251b2de079...c939b2a1cb22b5035b1ccf90ee7686f334e6049d,1,1,1,2,1,2009-08-19 23:54:28,2009-08-19 23:54:28
c7f6cd02436fce1cf47eb0fa4b00fbc9b5ebece6...1245b5c01ed4e9716ceda1e14e1167a70093a3b5,5,6,6,12,6,2007-04-08 11:21:00,2007-04-08 11:21:00
1245b5c01ed4e9716ceda1e14e1167a70093a3b5...8fafee4de034cd00ac4dc62848708ded44aa830b,5,191,0,191,4,2007-04-08 13:22:48,2007-04-08 13:22:48
8fafee4de034cd00ac4dc62848708ded44aa830b...1c12cb0f76cfc482280e65928a698419ad4a882a,1,2,2,4,1,2007-04-09 01:04:19,2007-04-09 01:04:19
1c12cb0f76cfc482280e65928a698419ad4a882a...7fd887b2d791f9f80f11db6b8bbb7b5fb73f53b2,1,2,3,5,3,2007-04-09 01:05:21,2007-04-09 01:05:21
7fd887b2d791f9f80f11db6b8bbb7b5fb73f53b2...0498eb30cbd8acd0ecd7175393a713e6ceab681d,1,2,2,4,2,2007-04-09 01:06:09,2007-04-09 01:06:09
0498eb30cbd8acd0ecd7175393a713e6ceab681d...0e0a1dc0b717d3354e6bada48a7ea127248a3d7c,1,2,1,3,2,2007-04-09 01:10:26,2007-04-09 01:10:26
0e0a1dc0b717d3354e6bada48a7ea127248a3d7c...769300078887eeab71219fb0d1e9bff696159757,1,13,21,34,6,2007-04-09 01:13:49,2007-04-09 01:13:49
769300078887eeab71219fb0d1e9bff696159757...e34e43364144127b8dcede61c3b5e12abb174e9a,3,24,18,42,17,2007-04-09 01:22:45,2007-04-09 01:22:45
e34e43364144127b8dcede61c3b5e12abb174e9a...099022c6aac4d6879810456ab515813ff63cdedd,1,36,32,68,18,2007-04-09 01:44:26,2007-04-09 01:44:26
099022c6aac4d6879810456ab515813ff63cdedd...a698afe3922811e61bfe8f729d6425ba8ef37812,1,3,3,6,3,2007-04-09 01:47:15,2007-04-09 01:47:15
a698afe3922811e61bfe8f729d6425ba8ef37812...421be9fb2a4dd1f13023adb33a79f1bdd595d9bc,1,36,20,56,9,2007-04-09 02:07:04,2007-04-09 02:07:04
421be9fb2a4dd1f13023adb33a79f1bdd595d9bc...03d3d9f923967bb3003de164130f37de76a297e2,1,3,5,8,2,2007-04-09 02:24:13,2007-04-09 02:24:13
03d3d9f923967bb3003de164130f37de76a297e2...bebf06611f57dcdaf4128247ba51e6ca87065656,1,6,8,14,5,2007-04-09 02:38:07,2007-04-09 02:38:07
bebf06611f57dcdaf4128247ba51e6ca87065656...c80c3922b32b0a907a66ace59d1b61af926f6ec2,1,1,1,2,1,2007-04-09 06:16:44,2007-04-09 06:16:44
c80c3922b32b0a907a66ace59d1b61af926f6ec2...bee9b9378a4384e68495da58cfcc5ed8a9561b76,2,3,3,6,3,2007-04-09 11:27:12,2007-04-09 11:27:12
bee9b9378a4384e68495da58cfcc5ed8a9561b76...66356056a5f904772a8625fa70b6a74f81f22b46,6,2855,0,2855,4,2007-04-09 11:58:25,2007-04-09 11:58:25
66356056a5f904772a8625fa70b6a74f81f22b46...4b4d1af6602670fd5e12bc72f4ddc632f020626c,3,13,12,25,13,2007-04-09 12:03:15,2007-04-09 12:03:15
4b4d1af6602670fd5e12bc72f4ddc632f020626c...f5d4731a001c391f43396b9fbe182f5a217044c3,5,1651,1078,2729,405,2007-04-09 12:08:04,2007-04-09 12:08:04
f5d4731a001c391f43396b9fbe182f5a217044c3...1c7a264a96da509c74692ba0bc07111f14ee2ff8,1,4,1,5,2,2007-04-09 12:11:19,2007-04-09 12:11:19
1c7a264a96da509c74692ba0bc07111f14ee2ff8...dd7bb06f124a410c2a6f97a003aa45df58d55029,1,1,1,2,1,2007-04-09 12:13:06,2007-04-09 12:13:06
dd7bb06f124a410c2a6f97a003aa45df58d55029...e4671d158c4e419e13a59273225be4853598c614,1,2,2,4,1,2007-04-09 12:16:46,2007-04-09 12:16:46
e4671d158c4e419e13a59273225be4853598c614...db8ca449817491f9f11cecee864e910aeb19c7d5,1,1,0,1,1,2007-04-09 12:25:31,2007-04-09 12:25:31
db8ca449817491f9f11cecee864e910aeb19c7d5...37201540276bc0cd25310d4bd3aec83c91effa91,1,14,0,14,2,2007-04-09 12:35:05,2007-04-09 12:35:05
37201540276bc0cd25310d4bd3aec83c91effa91...936a46cc89dda9971ef1b8099cb260e98dbf50a7,2,6,3,9,4,2007-04-09 13:11:39,2007-04-09 13:11:39
936a46cc89dda9971ef1b8099cb260e98dbf50a7...17fac1b09bd693d9d113dfe4aac6b58743d59e76,2,1993,1558,3551,475,2007-04-09 13:18:23,2007-04-09 13:18:23
17fac1b09bd693d9d113dfe4aac6b58743d59e76...bbeb62c9af5939b92a18da31e2faafb726bc6b05,4,8,35,43,5,2007-04-09 13:28:09,2007-04-09 13:28:09
bbeb62c9af5939b92a18da31e2faafb726bc6b05...4ee7a7be95060746393b05cbe8b622fef21f56cd,1,11,11,22,9,2007-04-09 15:35:19,2007-04-09 15:35:19
4ee7a7be95060746393b05cbe8b622fef21f56cd...13641ae92ffd1b9a1d3f24c0116e832903b82bf6,1,0,1,1,1,2007-04-09 15:36:34,2007-04-09 15:36:34
13641ae92ffd1b9a1d3f24c0116e832903b82bf6...a02e13c7da653c83b44ab021d06a1d3bd139ef53,1,16,13,29,4,2007-04-09 15:48:08,2007-04-09 15:48:08
a02e13c7da653c83b44ab021d06a1d3bd139ef53...4326de3fc1871741d9cdd4baeb81576cfb7ce398,1,4,3,7,2,2007-04-09 20:57:07,2007-04-09 20:57:07
4326de3fc1871741d9cdd4baeb81576cfb7ce398...66d8530b62efdd8a8a6cc26f2000835ba411a100,0,0,0,0,0,2007-04-10 01:55:48,2007-04-10 01:55:48
66d8530b62efdd8a8a6cc26f2000835ba411a100...cbb83f967f18c40c0322746a71a0cc00c5f0c2df,1,2,1,3,2,2007-04-10 03:29:53,2007-04-10 03:29:53
cbb83f967f18c40c0322746a71a0cc00c5f0c2df...247bed848fb116dc83d3c587754f76fe418f517d,1,1,1,2,1,2007-04-10 21:11:08,2007-04-10 21:11:08
247bed848fb116dc83d3c587754f76fe418f517d...49ae68925c410de4678f25548847dd635de4ab08,1,2,2,4,2,2007-04-12 11:12:45,2007-04-12 11:12:45
49ae68925c410de4678f25548847dd635de4ab08...ebfa5b0406fab270fc955b95b8f4aa5eaf280e8e,1,27,0,27,1,2007-04-12 13:59:09,2007-04-12 13:59:09
ebfa5b0406fab270fc955b95b8f4aa5eaf280e8e...e9e728c2122c760eff6b3838bba6b3e5db6a1aae,3,4,4,8,4,2007-04-13 01:01:57,2007-04-13 01:01:57
e9e728c2122c760eff6b3838bba6b3e5db6a1aae...73269ec8bc0db720e405f6366a9dd3f20d757128,1,12,12,24,11,2007-04-13 01:19:44,2007-04-13 01:19:44
73269ec8bc0db720e405f6366a9dd3f20d757128...d46a826840cc41b5f6fef27397660b7912095327,1,2,0,2,2,2007-04-16 11:11:16,2007-04-16 11:11:16
d46a826840cc41b5f6fef27397660b7912095327...83c4c531205ba0b38e4e4fce4274168302c6d0aa,1,8,0,8,1,2007-04-16 11:26:07,2007-04-16 11:26:07
83c4c531205ba0b38e4e4fce4274168302c6d0aa...30fb62d71af0186c98c7d5208a72609f74943092,24,913,0,913,23,2007-04-16 21:56:10,2007-04-16 21:56:10
30fb62d71af0186c98c7d5208a72609f74943092...3b55c34704d7ec98a85bee348d515fff740e11b9,1,2,0,2,1,2007-04-16 22:00:29,2007-04-16 22:00:29
3b55c34704d7ec98a85bee348d515fff740e11b9...968a0627d94ea425eda4d053871fcfe8aef14f26,1,4,1,5,2,2007-04-17 00:40:11,2007-04-17 00:40:11
968a0627d94ea425eda4d053871fcfe8aef14f26...c64f7f065a13876901fffa6249667e865d33fd9a,1,4,3,7,4,2007-04-17 07:08:42,2007-04-17 07:08:42
c64f7f065a13876901fffa6249667e865d33fd9a...c5f08954d50150c1dc121e78d9ab6ef68bb15180,3,11,4,15,5,2007-04-17 11:11:26,2007-04-17 11:11:26
c5f08954d50150c1dc121e78d9ab6ef68bb15180...e9b66ce1d3b6964fb05874c3f86541b54c1f1adf,4,129,2,131,7,2007-04-17 13:37:45,2007-04-17 13:37:45
e9b66ce1d3b6964fb05874c3f86541b54c1f1adf...06031a8f2e7c9a1ed0a09b4ab151558a75462578,1,1,0,1,1,2007-04-18 18:18:56,2007-04-18 18:18:56
06031a8f2e7c9a1ed0a09b4ab151558a75462578...52d689abeb2ab9d7eb4fedb418b7c0a5ef3bd548,3,108,0,108,2,2007-04-20 09:04:51,2007-04-20 09:04:51
52d689abeb2ab9d7eb4fedb418b7c0a5ef3bd548...43973c93b798111855019bd4c3a3f4fd55dbe6ba,2,1929,1410,3339,388,2007-04-20 09:06:55,2007-04-20 09:06:55
43973c93b798111855019bd4c3a3f4fd55dbe6ba...6f78709985af62f63e1e5ecd90dad67790a08f6f,10,12,12,24,12,2007-04-20 09:15:30,2007-04-20 09:15:30
6f78709985af62f63e1e5ecd90dad67790a08f6f...b786cc1017617b8e47bb5aea5c3b9f8794ad3d32,6,9,9,18,9,2007-04-20 09:22:01,2007-04-20 09:22:01
b786cc1017617b8e47bb5aea5c3b9f8794ad3d32...fe24ddbfcb269e182d6d03adb6fd1bff38395f25,1,0,4,4,1,2007-04-20 09:59:44,2007-04-20 09:59:44
fe24ddbfcb269e182d6d03adb6fd1bff38395f25...eb107e1ae95e180b07ac19915d2e50527d203d87,2,2,1,3,2,2007-04-20 10:05:39,2007-04-20 10:05:39
eb107e1ae95e180b07ac19915d2e50527d203d87...9f180a1bc5e6e40c2b97b72ab15395f375861386,1,3,1,4,2,2007-04-20 11:24:53,2007-04-20 11:24:53
9f180a1bc5e6e40c2b97b72ab15395f375861386...24118edf2109afa5cda17145f84db2d0f806289a,1,6,3,9,1,2007-04-20 13:33:09,2007-04-20 13:33:09
24118edf2109afa5cda17145f84db2d0f806289a...e19ccdad56ebcc8acf76ac2fe427af388c231dde,1,1,0,1,1,2007-04-20 14:53:21,2007-04-20 14:53:21
e19ccdad56ebcc8acf76ac2fe427af388c231dde...539a7ab993b000c6417018776d62de523eda7787,2,5,2,7,3,2007-04-21 04:13:52,2007-04-21 04:13:52
539a7ab993b000c6417018776d62de523eda7787...8ffb8001b485437c66aeb647ff84048feaa3d1d6,1,6,4,10,3,2007-04-21 04:18:15,2007-04-21 04:18:15
8ffb8001b485437c66aeb647ff84048feaa3d1d6...c2b19865254102e56d6d7fa4e288077cbfcbdfcb,1,1,1,2,1,2007-04-21 04:21:45,2007-04-21 04:21:45
c2b19865254102e56d6d7fa4e288077cbfcbdfcb...43cd7bb110bb7d012f37fe93767168e99821d86d,2,34,15,49,9,2007-04-21 04:37:31,2007-04-21 04:37:31
43cd7bb110bb7d012f37fe93767168e99821d86d...2a512a4e83499b38fa04aa20f742afe95dbd7c3a,3,6,1,7,3,2007-04-21 04:44:30,2007-04-21 04:44:30
2a512a4e83499b38fa04aa20f742afe95dbd7c3a...15d5c3decb79c8a1af7131b8e53d12181c790e2f,2,5,4,9,3,2007-04-21 05:43:32,2007-04-21 05:43:32
15d5c3decb79c8a1af7131b8e53d12181c790e2f...254e087e31a38c7dc2cf91c062e62addcf409570,1,1,1,2,1,2007-04-23 01:55:45,2007-04-23 01:55:45
254e087e31a38c7dc2cf91c062e62addcf409570...00cb6a1ba81711c6fc361a3fc0498685bf3953e8,2,6,6,12,5,2007-04-23 05:51:29,2007-04-23 05:51:29
00cb6a1ba81711c6fc361a3fc0498685bf3953e8...53eddd4a0f8786e23f511a653d8d7ffa947ad8db,1,1,0,1,1,2007-04-23 21:24:41,2007-04-23 21:24:41
53eddd4a0f8786e23f511a653d8d7ffa947ad8db...39aa40d108c4680f9efbb148bfa52801ccc10ff3,15,22,22,44,21,2007-04-24 05:58:03,2007-04-24 05:58:03
39aa40d108c4680f9efbb148bfa52801ccc10ff3...56b8914eb968ad49d3a15a98cec65fec849e1227,2,41,4,45,8,2007-04-24 12:53:29,2007-04-24 12:53:29
56b8914eb968ad49d3a15a98cec65fec849e1227...939f678e6542949e3befd83437d58860b9abac34,1,16,7,23,4,2007-04-25 06:38:23,2007-04-25 06:38:23
939f678e6542949e3befd83437d58860b9abac34...76005c917f96422d4818cb88651f4c8220cf2ad5,1,3,3,6,3,2007-04-25 07:05:31,2007-04-25 07:05:31
76005c917f96422d4818cb88651f4c8220cf2ad5...535535a45e0a5a0d730b217cec1cba75ce18a948,3,14,15,29,11,2007-04-25 07:25:22,2007-04-25 07:25:22
535535a45e0a5a0d730b217cec1cba75ce18a948...aca569804e661725ed38d2bc0a2ccfd165e4bad0,2,9,0,9,2,2007-04-25 07:30:54,2007-04-25 07:30:54
aca569804e661725ed38d2bc0a2ccfd165e4bad0...6c812e91436f3819087b49ad49c77e8f1acb84c0,2,780,455,1235,207,2007-04-25 08:17:41,2007-04-25 08:17:41
6c812e91436f3819087b49ad49c77e8f1acb84c0...d744a660c4e1872370e40f77eb7a9e8d106aa73b,2,5,4,9,4,2007-04-25 08:32:31,2007-04-25 08:32:31
d744a660c4e1872370e40f77eb7a9e8d106aa73b...5dfe74f221f2e7c5dc7e5722bb322336c605c7b5,8,65,20,85,25,2007-04-25 08:49:57,2007-04-25 08:49:57
5dfe74f221f2e7c5dc7e5722bb322336c605c7b5...2a7d9ef23fff757d5aa8052c165cc189819e5ee2,3,12,3,15,3,2007-04-25 09:34:29,2007-04-25 09:34:29
2a7d9ef23fff757d5aa8052c165cc189819e5ee2...74bab891783a6f85d7b8f8c5908bde046622654e,2,3,2,5,3,2007-04-25 09:44:06,2007-04-25 09:44:06
74bab891783a6f85d7b8f8c5908bde046622654e...e23ababb523a006dfb7ade8b304397ac5a4537f2,2,11,8,19,7,2007-04-25 10:12:05,2007-04-25 10:12:05
e23ababb523a006dfb7ade8b304397ac5a4537f2...b3e0b59def4b6125f5a946d6a87b9b8997da7826,10,13,1,14,11,2007-04-25 10:18:56,2007-04-25 10:18:56
b3e0b59def4b6125f5a946d6a87b9b8997da7826...aa1b182da33c6ea4f79c28abd5cc1b7c1733ce25,2,2,1,3,2,2007-04-25 10:29:39,2007-04-25 10:29:39
aa1b182da33c6ea4f79c28abd5cc1b7c1733ce25...37e4842661c22532a2f253963c01f29ba971aca7,2,1793,1731,3524,480,2007-04-25 12:04:50,2007-04-25 12:04:50
37e4842661c22532a2f253963c01f29ba971aca7...a738f3a4ff01c54d05a214cf8771f93f29152c1e,4,330,0,330,3,2007-04-26 08:43:25,2007-04-26 08:43:25
a738f3a4ff01c54d05a214cf8771f93f29152c1e...decc230d19bd49228dd941dedfdd3f38af4eea10,1,2,2,4,2,2007-04-26 10:27:21,2007-04-26 10:27:21
decc230d19bd49228dd941dedfdd3f38af4eea10...21d9387ceaefbb011536f4a7e71f73fbf4ff97e0,1,2,2,4,1,2007-04-26 10:29:55,2007-04-26 10:29:55
21d9387ceaefbb011536f4a7e71f73fbf4ff97e0...f85f1d077a11a4999f2b2a0c8f955fa3e74ea722,2,12,3,15,2,2007-04-26 11:17:19,2007-04-26 11:17:19
f85f1d077a11a4999f2b2a0c8f955fa3e74ea722...ed60b8645f36b32949b9ed30a8323b49417f7bef,4,142,0,142,3,2007-04-26 12:41:34,2007-04-26 12:41:34
ed60b8645f36b32949b9ed30a8323b49417f7bef...b24c860fa21790bfe04f5afc7c8bcccb70902f83,3,91,2,93,4,2007-04-26 12:46:04,2007-04-26 12:46:04
b24c860fa21790bfe04f5afc7c8bcccb70902f83...6c02565e4fb92c4cc3bfb45bcc89eb9aa299efdc,3,117,2,119,5,2007-04-26 13:11:07,2007-04-26 13:11:07
6c02565e4fb92c4cc3bfb45bcc89eb9aa299efdc...439cb4047fb583d08149f28e2ce66a8edfe0efa7,37,112,92,204,99,2007-04-26 13:30:48,2007-04-26 13:30:48
439cb4047fb583d08149f28e2ce66a8edfe0efa7...6c18ba8c910451a1c579a6a62a46d63be2b4e8af,1,10,1,11,4,2007-04-26 13:48:31,2007-04-26 13:48:31
6c18ba8c910451a1c579a6a62a46d63be2b4e8af...2944320ebafdef292eea524789c6d3021c12569f,1,16,10,26,4,2007-04-26 14:51:50,2007-04-26 14:51:50
2944320ebafdef292eea524789c6d3021c12569f...bf89e4b15113cb14840948d922602b1ab553f68f,1,2,1,3,1,2007-04-26 14:52:40,2007-04-26 14:52:40
bf89e4b15113cb14840948d922602b1ab553f68f...af6ed6c91ded72d7b35f7120f3581fd8100d308b,1,1,5,6,6,2007-04-26 14:55:18,2007-04-26 14:55:18
af6ed6c91ded72d7b35f7120f3581fd8100d308b...38d8e84248cec58ba63a0997a7fe875c06a2faa4,1,6,6,12,2,2007-04-26 14:58:18,2007-04-26 14:58:18
38d8e84248cec58ba63a0997a7fe875c06a2faa4...4bce3c17ec8ca896e376dc85e02e0288117bcf2a,1,1,10,11,4,2007-04-26 14:58:38,2007-04-26 14:58:38
4bce3c17ec8ca896e376dc85e02e0288117bcf2a...143270856b388ee34556caeb41df293b68ef8b55,1,2,1,3,2,2007-04-26 14:59:27,2007-04-26 14:59:27
143270856b388ee34556caeb41df293b68ef8b55...51e867a2e53a7f227e4deb7a760fe879c9910f6d,2,9,9,18,9,2007-04-26 15:05:47,2007-04-26 15:05:47
51e867a2e53a7f227e4deb7a760fe879c9910f6d...81a712762f54f95a4db12a53cf75af5ff8440140,2,3,0,3,2,2007-04-27 10:55:47,2007-04-27 10:55:47
81a712762f54f95a4db12a53cf75af5ff8440140...6fe5235cea1f21ef3f2efba0ebcb0906ad74e0aa,1,24,23,47,18,2007-04-27 11:01:45,2007-04-27 11:01:45
6fe5235cea1f21ef3f2efba0ebcb0906ad74e0aa...54f11ee63c619b9348dbbb3b4493157442ddf6d8,2,40,19,59,7,2007-04-27 12:16:22,2007-04-27 12:16:22
54f11ee63c619b9348dbbb3b4493157442ddf6d8...f30ca6636b8c30e634d2a4d3af9f0c777d43a9b1,1,1,1,2,1,2007-04-27 12:27:19,2007-04-27 12:27:19
f30ca6636b8c30e634d2a4d3af9f0c777d43a9b1...fb30e774f91fb91372b0a5a3e707fbbd1996da83,2,3,0,3,2,2007-04-27 12:45:08,2007-04-27 12:45:08
fb30e774f91fb91372b0a5a3e707fbbd1996da83...7894336a2555519ba59f3b8c1813f2577639a85b,1,1,1,2,2,2007-04-27 12:46:41,2007-04-27 12:46:41
7894336a2555519ba59f3b8c1813f2577639a85b...592f1280f6f152ba2f7a9e31993ba04faa425c2c,1,54,0,54,1,2007-04-27 12:50:24,2007-04-27 12:50:24
592f1280f6f152ba2f7a9e31993ba04faa425c2c...14fac203e8cb541a759306b7d40f22e112e1b72e,2,3,3,6,3,2007-04-27 13:44:58,2007-04-27 13:44:58
14fac203e8cb541a759306b7d40f22e112e1b72e...33ce76978639b6d279c11a1b5e27af6114fc5935,5,109,132,241,108,2007-04-27 13:53:47,2007-04-27 13:53:47
33ce76978639b6d279c11a1b5e27af6114fc5935...1c2fdf1ebda1c216fb97337eac48e98ca022be06,2,15,4,19,4,2007-04-27 14:25:05,2007-04-27 14:25:05
1c2fdf1ebda1c216fb97337eac48e98ca022be06...8a4a8023d61cb31093db7b511e58ea3502e47cb6,2,29,1,30,2,2007-04-27 14:27:07,2007-04-27 14:27:07
8a4a8023d61cb31093db7b511e58ea3502e47cb6...ec577d88eaf4093725fb78e50be7756f27b5d5d0,2,13,8,21,5,2007-04-27 15:06:45,2007-04-27 15:06:45
ec577d88eaf4093725fb78e50be7756f27b5d5d0...812c261006da23fe10eeddac7c50a935a4182e1f,2,5,5,10,2,2007-04-28 04:08:31,2007-04-28 04:08:31
812c261006da23fe10eeddac7c50a935a4182e1f...4ac69165f822a42bbcba45698a15c1c403cc4305,1,1,1,2,1,2007-04-28 04:45:38,2007-04-28 04:45:38
4ac69165f822a42bbcba45698a15c1c403cc4305...c675ee76126c349f9410635815eb76c2e5c47582,1,1,1,2,1,2007-04-28 13:31:44,2007-04-28 13:31:44
c675ee76126c349f9410635815eb76c2e5c47582...b09bdd2ae8177325f414cf4ec116e8c8e17cd4c0,2,31,31,62,28,2007-04-28 13:55:24,2007-04-28 13:55:24
b09bdd2ae8177325f414cf4ec116e8c8e17cd4c0...d9cc22b3e3b66f468c0df0d84ce54521ded79836,2,41,2,43,9,2007-04-28 14:18:03,2007-04-28 14:18:03
d9cc22b3e3b66f468c0df0d84ce54521ded79836...fe0f2388417088dd98762c888e1da94aca3d759d,1,4,4,8,3,2007-04-28 14:23:41,2007-04-28 14:23:41
fe0f2388417088dd98762c888e1da94aca3d759d...372f43a574a8c329500cf9fecc235810e95bc646,1,5,5,10,1,2007-04-28 14:32:16,2007-04-28 14:32:16
372f43a574a8c329500cf9fecc235810e95bc646...2f61bff0b776cf7112bb34876cde766f56634796,2,1355,770,2125,509,2007-04-28 16:37:02,2007-04-28 16:37:02
2f61bff0b776cf7112bb34876cde766f56634796...d9f1a0aaeff741f47ea78da9932e3a1ef7db2b2f,1,1,1,2,1,2007-04-28 16:41:44,2007-04-28 16:41:44
d9f1a0aaeff741f47ea78da9932e3a1ef7db2b2f...1cae38c7311d4a9862582b228170a51eed1a02f8,1,3,1,4,1,2007-04-29 09:41:46,2007-04-29 09:41:46
1cae38c7311d4a9862582b228170a51eed1a02f8...94cb93edcaa441975082b793bc89927dd182ec26,1,11,38,49,1,2007-05-01 02:13:34,2007-05-01 02:13:34
94cb93edcaa441975082b793bc89927dd182ec26...157ade371be84154f2ce465793531c72d82ecada,2,7,0,7,2,2007-05-01 02:35:15,2007-05-01 02:35:15
157ade371be84154f2ce465793531c72d82ecada...acde998521e859f6bc7c8d2047d2bfbe2bca15ed,1,1,0,1,1,2007-05-01 02:44:24,2007-05-01 02:44:24
acde998521e859f6bc7c8d2047d2bfbe2bca15ed...0b2f9e89cdca3f4e05c160537119a7e7f390c187,5,195,0,195,4,2007-05-01 03:10:10,2007-05-01 03:10:10
0b2f9e89cdca3f4e05c160537119a7e7f390c187...d943f5ae927cfa99d5fe70e70350c8b4df3e3269,6,19,8,27,9,2007-05-01 03:21:54,2007-05-01 03:21:54
d943f5ae927cfa99d5fe70e70350c8b4df3e3269...0b265e6a2b7a3c94874e39122ac2d59258488d69,1,1,1,2,1,2007-05-02 20:24:36,2007-05-02 20:24:36
0b265e6a2b7a3c94874e39122ac2d59258488d69...4b41fb4ba98f836f5ec4bb5dcf6cfc414eecd7aa,1,3,5,8,2,2007-05-02 20:27:37,2007-05-02 20:27:37
4b41fb4ba98f836f5ec4bb5dcf6cfc414eecd7aa...d82860ec073b7ecbc8c9c863f972f2dd1bc956e5,1,3,3,6,3,2007-05-02 20:31:15,2007-05-02 20:31:15
d82860ec073b7ecbc8c9c863f972f2dd1bc956e5...1f88c7fc67ff982e681f44db6f67e95f4fd8f690,1,1,1,2,1,2007-05-02 22:10:12,2007-05-02 22:10:12
1f88c7fc67ff982e681f44db6f67e95f4fd8f690...95d7cb27d04bca14f98bbfc9b990488cb913df2c,2,203,44,247,11,2007-05-03 11:35:11,2007-05-03 11:35:11
95d7cb27d04bca14f98bbfc9b990488cb913df2c...befbd82d85816882436f86912637cda0de332369,1,2,1,3,2,2007-05-03 11:50:43,2007-05-03 11:50:43
befbd82d85816882436f86912637cda0de332369...21a2ca6a2121bc96edef4212f7ce79e8bb0a8062,1,5,0,5,2,2007-05-03 12:08:31,2007-05-03 12:08:31
21a2ca6a2121bc96edef4212f7ce79e8bb0a8062...7a84ad93e69faf7a14342ebb4da1f6be265f1fe0,4,25,10,35,7,2007-05-03 13:35:02,2007-05-03 13:35:02
7a84ad93e69faf7a14342ebb4da1f6be265f1fe0...bc6535b5998900191ca8cc8f9755631c4cf1b7f7,1,1,1,2,1,2007-05-03 13:53:42,2007-05-03 13:53:42
bc6535b5998900191ca8cc8f9755631c4cf1b7f7...5ff1d96a523f681b15f679ba771d6c3e2e8e8c49,2,53,31,84,14,2007-05-03 14:38:45,2007-05-03 14:38:45
5ff1d96a523f681b15f679ba771d6c3e2e8e8c49...e986e8aba4d301c2be2b3a2607ee57e7de2fb494,2,4,0,4,2,2007-05-03 17:52:38,2007-05-03 17:52:38
e986e8aba4d301c2be2b3a2607ee57e7de2fb494...a0ef3ba2f7e815b4f3617f6e2827f66c13de3194,3,81,18,99,17,2007-05-05 03:03:33,2007-05-05 03:03:33
a0ef3ba2f7e815b4f3617f6e2827f66c13de3194...36b164d838c3de168defe9f1ebc02ea1abc790be,3,76,64,140,18,2007-05-05 15:16:15,2007-05-05 15:16:15
36b164d838c3de168defe9f1ebc02ea1abc790be...3d52993b46070cf3d34c91cd107511918de9d8e0,1,66,56,122,29,2007-05-06 03:59:37,2007-05-06 03:59:37
3d52993b46070cf3d34c91cd107511918de9d8e0...1889db475db596c201c1f57523792f6a0babdf12,6,8,8,16,8,2007-05-06 04:12:08,2007-05-06 04:12:08
1889db475db596c201c1f57523792f6a0babdf12...64adc413770c4762da5db697c4a332ac749cf4f3,1,42,36,78,10,2007-05-06 04:23:12,2007-05-06 04:23:12
64adc413770c4762da5db697c4a332ac749cf4f3...f073797f4ca8d3e2736d99f76674e43640399c0d,8,208,16,224,18,2007-05-07 12:34:18,2007-05-07 12:34:18
f073797f4ca8d3e2736d99f76674e43640399c0d...c2a13da823002b1d1d2dfba2a7c2e676e83f4c86,1,3,3,6,2,2007-05-08 02:25:02,2007-05-08 02:25:02
c2a13da823002b1d1d2dfba2a7c2e676e83f4c86...a374bf9d509ddb4b47320990ac18e707f66be13b,1,0,2,2,1,2007-05-08 02:27:30,2007-05-08 02:27:30
a374bf9d509ddb4b47320990ac18e707f66be13b...00d2fb7e70580d742e37992d4bd83d58aa0018d8,1,5,4,9,1,2007-05-08 02:33:10,2007-05-08 02:33:10
00d2fb7e70580d742e37992d4bd83d58aa0018d8...ce0084fbfc2bfaa1e69feb6e2ab81b0844e88757,1,1,1,2,1,2007-05-08 02:48:38,2007-05-08 02:48:38
ce0084fbfc2bfaa1e69feb6e2ab81b0844e88757...abff821f142c4bca2f5a33f990384ba1a415af6c,2,8,8,16,7,2007-05-08 02:50:41,2007-05-08 02:50:41
abff821f142c4bca2f5a33f990384ba1a415af6c...93e2f246fdb3ac1b1c1b0e4c4f18961343199047,1,1,1,2,2,2007-05-08 02:56:18,2007-05-08 02:56:18
93e2f246fdb3ac1b1c1b0e4c4f18961343199047...aaf228de9a413663dd788dec2a8bf709c5929eb9,1,1,0,1,1,2007-05-08 02:57:18,2007-05-08 02:57:18
aaf228de9a413663dd788dec2a8bf709c5929eb9...4fddf43b811f76613b03f9d6c1de5bfc44a901e7,1,1,1,2,1,2007-05-08 03:07:58,2007-05-08 03:07:58
4fddf43b811f76613b03f9d6c1de5bfc44a901e7...77ec8ae811f0f9d6a55c570ee7c02c52e6e7bc8d,2,2,1,3,2,2007-05-08 03:20:49,2007-05-08 03:20:49
77ec8ae811f0f9d6a55c570ee7c02c52e6e7bc8d...faa31732caa17d942b05fd4e25c49bb0589ce76f,4,33,10,43,14,2007-05-08 03:36:16,2007-05-08 03:36:16
faa31732caa17d942b05fd4e25c49bb0589ce76f...b72c7d0517f2aaf7dadcad94116ba8aefea3e61a,1,4,0,4,1,2007-05-08 03:42:19,2007-05-08 03:42:19
b72c7d0517f2aaf7dadcad94116ba8aefea3e61a...af846c0b8b53aac731a39d11bfe5dac48d9da9c0,1,15,15,30,6,2007-05-08 03:45:33,2007-05-08 03:45:33
af846c0b8b53aac731a39d11bfe5dac48d9da9c0...d1b0d34dc67941ce7c285c29d3f4031954c20283,2,7,3,10,2,2007-05-08 03:56:44,2007-05-08 03:56:44
d1b0d34dc67941ce7c285c29d3f4031954c20283...0839a0046a09bc80a9cfe02dcc462cb9e4dc2521,2,8,0,8,2,2007-05-08 04:13:46,2007-05-08 04:13:46
0839a0046a09bc80a9cfe02dcc462cb9e4dc2521...1c53661bd14cbb19138bd7f9dbc03074c58d63c2,6,13,12,25,14,2007-05-08 10:59:35,2007-05-08 10:59:35
1c53661bd14cbb19138bd7f9dbc03074c58d63c2...469314e7bcad7390362804b73d74b1ff1ba6396b,6,169,19,188,26,2007-05-08 11:19:34,2007-05-08 11:19:34
469314e7bcad7390362804b73d74b1ff1ba6396b...dabae55913a671e45ee120881289cdbd14ca45c1,3,1919,928,2847,302,2007-05-09 13:32:20,2007-05-09 13:32:20
dabae55913a671e45ee120881289cdbd14ca45c1...c95a48b802264e3978642182c4a648fc984df58d,4,1898,999,2897,290,2007-05-09 13:36:22,2007-05-09 13:36:22
c95a48b802264e3978642182c4a648fc984df58d...606f387f4942ccb76a79eecd5b9c946f6455e219,4,2063,1523,3586,416,2007-05-09 13:41:48,2007-05-09 13:41:48
606f387f4942ccb76a79eecd5b9c946f6455e219...5c68ab6e2902b3cf67456d080c5314d3696d43e8,5,59,20,79,16,2007-05-10 11:27:59,2007-05-10 11:27:59
5c68ab6e2902b3cf67456d080c5314d3696d43e8...c7db4beb624cbae2a303cf928b9ba0721c70fc75,1,6,3,9,1,2007-05-10 12:07:34,2007-05-10 12:07:34
c7db4beb624cbae2a303cf928b9ba0721c70fc75...70902908c728264f65df40f0aec8474cd7d672c8,8,152,12,164,7,2007-05-10 13:46:15,2007-05-10 13:46:15
70902908c728264f65df40f0aec8474cd7d672c8...244a5d0006cc831e35e87d2586bb3b6e9ec5926f,1,13,10,23,3,2007-05-10 13:48:18,2007-05-10 13:48:18
244a5d0006cc831e35e87d2586bb3b6e9ec5926f...8562216c40e1a68b40eb9929daf125ae82cca035,4,2,2,4,2,2007-05-11 08:18:41,2007-05-11 08:18:41
8562216c40e1a68b40eb9929daf125ae82cca035...f9982c5c08f02699dddf097986a6b3bed54bf5a5,2,15,0,15,3,2007-05-11 08:22:06,2007-05-11 08:22:06
f9982c5c08f02699dddf097986a6b3bed54bf5a5...de5f67f17e9ab3f6a860ad93d6c1fbc2c0c7f3b2,1,3,3,6,3,2007-05-11 08:50:54,2007-05-11 08:50:54
de5f67f17e9ab3f6a860ad93d6c1fbc2c0c7f3b2...ee227a850761138ff7bfb46c04ebec78a568ec9e,1,66,66,132,1,2007-05-11 09:13:37,2007-05-11 09:13:37
ee227a850761138ff7bfb46c04ebec78a568ec9e...7c0ef82752bd24dcce8113312b539a637b760061,1,5,2,7,1,2007-05-11 09:44:13,2007-05-11 09:44:13
7c0ef82752bd24dcce8113312b539a637b760061...5a803f5ebd9825c9e3b5845aa70bb0ce61384cfa,1,8,8,16,5,2007-05-11 09:51:07,2007-05-11 09:51:07
5a803f5ebd9825c9e3b5845aa70bb0ce61384cfa...1bb3ed72644c68ae3cac9ee26cf522bff837a59d,1,246,0,246,1,2007-05-12 04:19:21,2007-05-12 04:19:21
1bb3ed72644c68ae3cac9ee26cf522bff837a59d...ca5e12b4eef9969ea19ded25d970fa0b300a0519,1,0,246,246,1,2007-05-12 12:22:50,2007-05-12 12:22:50
ca5e12b4eef9969ea19ded25d970fa0b300a0519...6aa5091d58d4f9ad18601b56d39d0de5af094f52,3,210,22,232,16,2007-05-12 14:42:46,2007-05-12 14:42:46
6aa5091d58d4f9ad18601b56d39d0de5af094f52...fd171634818df9c143db42b9fa4c68151e9fd283,2,4,4,8,4,2007-05-12 15:21:33,2007-05-12 15:21:33
fd171634818df9c143db42b9fa4c68151e9fd283...2af00ca29a9c95aa19c2b69c679be4a18f4a6c89,1,10,9,19,9,2007-05-12 15:35:11,2007-05-12 15:35:11
2af00ca29a9c95aa19c2b69c679be4a18f4a6c89...330cc98c7381f44b3d1fbf81a3988515bc61d120,1,1,1,2,1,2007-05-12 15:38:24,2007-05-12 15:38:24
330cc98c7381f44b3d1fbf81a3988515bc61d120...2345029d0d607ebeea7e7a6e1bff6c09eaaff4a8,3,61,0,61,3,2007-05-12 15:50:32,2007-05-12 15:50:32
2345029d0d607ebeea7e7a6e1bff6c09eaaff4a8...3780a4532c260b1609de378e40298f241f404a7e,1,1,1,2,1,2007-05-12 16:05:51,2007-05-12 16:05:51
3780a4532c260b1609de378e40298f241f404a7e...c7d7b6da3cf388320ff1c817d80cce3b76ea5e08,1,13,12,25,8,2007-05-12 16:53:27,2007-05-12 16:53:27
c7d7b6da3cf388320ff1c817d80cce3b76ea5e08...6500f3fefacc65f8e3167f80a498ea296b3e6ba2,1,238,95,333,36,2007-05-12 17:02:44,2007-05-12 17:02:44
6500f3fefacc65f8e3167f80a498ea296b3e6ba2...1130f5e6b79588944ee3f72ff9fd698c7b97c9db,1,3,2,5,2,2007-05-12 17:11:19,2007-05-12 17:11:19
1130f5e6b79588944ee3f72ff9fd698c7b97c9db...d3627997218173245bc2dac61abb5254eae269c5,1,0,1,1,1,2007-05-13 08:19:11,2007-05-13 08:19:11
d3627997218173245bc2dac61abb5254eae269c5...3d86329f822f07b5208d61bb39fc3ee70b53814b,1,17,15,32,4,2007-05-14 02:20:12,2007-05-14 02:20:12
3d86329f822f07b5208d61bb39fc3ee70b53814b...edc014b255946b5965ccebe03ae8ac3b1c7c6323,1,3,3,6,1,2007-05-14 02:21:28,2007-05-14 02:21:28
edc014b255946b5965ccebe03ae8ac3b1c7c6323...2c86d5728476ba791139e5cef6d0b39c9d83b9f5,2,59,6,65,9,2007-05-14 02:57:42,2007-05-14 02:57:42
2c86d5728476ba791139e5cef6d0b39c9d83b9f5...cc1d02a5aa49ebe25c284d0c5263e03cc74e6334,1,1,1,2,1,2007-05-14 03:02:55,2007-05-14 03:02:55
cc1d02a5aa49ebe25c284d0c5263e03cc74e6334...a386aa7cc28dde3afd5460919fea3ae24ca092a2,1,1,1,2,1,2007-05-14 03:27:07,2007-05-14 03:27:07
a386aa7cc28dde3afd5460919fea3ae24ca092a2...0810919694e26ce5e21d9ca56b2fbe944bfb88a6,1,5,1,6,1,2007-05-14 03:29:13,2007-05-14 03:29:13
0810919694e26ce5e21d9ca56b2fbe944bfb88a6...70703a6b71a4263594c450c9f24052deb1eefc08,1,217,8,225,8,2007-05-14 05:32:35,2007-05-14 05:32:35
70703a6b71a4263594c450c9f24052deb1eefc08...5152b55b386c3cbaa099450b478a6fd637826ff7,6,2778,0,2778,4,2007-05-14 08:12:03,2007-05-14 08:12:03
5152b55b386c3cbaa099450b478a6fd637826ff7...c89dc9cfa0c8f59da93de05bb41c923f9397595e,2,30,2,32,4,2007-05-14 11:07:14,2007-05-14 11:07:14
c89dc9cfa0c8f59da93de05bb41c923f9397595e...f15036ae6de5b2a4a6640aeabab16076217e9ea2,3,18,4,22,4,2007-05-14 14:02:36,2007-05-14 14:02:36
f15036ae6de5b2a4a6640aeabab16076217e9ea2...c38a93e4d9f5ab31b22616c5573bba67946be493,5,34,12,46,8,2007-05-14 14:14:49,2007-05-14 14:14:49
c38a93e4d9f5ab31b22616c5573bba67946be493...9350945963a144f8ea2c25d95f3fc7d1e6fd4493,2,11,11,22,5,2007-05-14 14:21:00,2007-05-14 14:21:00
9350945963a144f8ea2c25d95f3fc7d1e6fd4493...41fbd35613a12d068d0d62ecc6b96ddb07609b2b,1,7,6,13,1,2007-05-14 14:24:30,2007-05-14 14:24:30
41fbd35613a12d068d0d62ecc6b96ddb07609b2b...b996e214c0494ec685103c8e1899325d9b36cf0f,7,81,78,159,71,2007-05-14 16:24:51,2007-05-14 16:24:51
b996e214c0494ec685103c8e1899325d9b36cf0f...a10e73ac3029de6fffef451594232499f4087cd2,2,34,34,68,9,2007-05-15 11:39:00,2007-05-15 11:39:00
a10e73ac3029de6fffef451594232499f4087cd2...7969c1bb655d24f98e8653d9008c90c6b0280673,2,13,1,14,2,2007-05-15 18:03:00,2007-05-15 18:03:00
7969c1bb655d24f98e8653d9008c90c6b0280673...72e824ad149ef97da5d11b6788aa13002a3f7a33,1,1,1,2,1,2007-05-15 19:06:52,2007-05-15 19:06:52
72e824ad149ef97da5d11b6788aa13002a3f7a33...6f44cffc770adffa293bcba7fe252ab8c0827dca,1,25,25,50,15,2007-05-15 19:35:53,2007-05-15 19:35:53
6f44cffc770adffa293bcba7fe252ab8c0827dca...4868af8a57f9b0e72310a9ca05d23da415f6d29b,6,32,24,56,18,2007-05-16 21:20:35,2007-05-16 21:20:35
4868af8a57f9b0e72310a9ca05d23da415f6d29b...e168f79365c52410f4eb4bbbbcc2e9a60fa6a682,1,78,5,83,3,2007-05-16 21:34:43,2007-05-16 21:34:43
e168f79365c52410f4eb4bbbbcc2e9a60fa6a682...b723a3e9dd5acaa97480512e8243d078936b9afb,1,4,4,8,2,2007-05-16 21:36:31,2007-05-16 21:36:31
b723a3e9dd5acaa97480512e8243d078936b9afb...60acd7c71cf12b4d8a568f086e570c0db9e53b6c,1,1,1,2,1,2007-05-18 16:40:27,2007-05-18 16:40:27
60acd7c71cf12b4d8a568f086e570c0db9e53b6c...cef77fcf19d7153feb6265ba98b4b831834f0d04,1,2,2,4,1,2007-05-19 04:17:54,2007-05-19 04:17:54
cef77fcf19d7153feb6265ba98b4b831834f0d04...5967e63bd878e2310ef892e59cfed49921c3b1d1,3,2006,886,2892,296,2007-05-19 17:57:43,2007-05-19 17:57:43
5967e63bd878e2310ef892e59cfed49921c3b1d1...ce9aca58235903926c9aa314a26d36ccf62d9680,3,631,123,754,119,2007-05-19 17:59:42,2007-05-19 17:59:42
ce9aca58235903926c9aa314a26d36ccf62d9680...9ed4217a57efc498e60bb3a2a10c57acc1ee6962,2,5,2,7,3,2007-05-19 18:34:00,2007-05-19 18:34:00
9ed4217a57efc498e60bb3a2a10c57acc1ee6962...5ab9c3ac82aacd0c82f258d5156d4edd81599812,1,1,1,2,1,2007-05-19 18:35:42,2007-05-19 18:35:42
5ab9c3ac82aacd0c82f258d5156d4edd81599812...534c0d8442e9646c10e746b45c48b8092c105d35,2,17,3,20,2,2007-05-19 18:49:35,2007-05-19 18:49:35
534c0d8442e9646c10e746b45c48b8092c105d35...7e975bb636289d9115373de8b9d6f99e26f9558b,1,1,1,2,1,2007-05-19 18:51:37,2007-05-19 18:51:37
7e975bb636289d9115373de8b9d6f99e26f9558b...d8db013eea14e69222810deea9a7e290b99966b4,1,1,1,2,1,2007-05-19 18:54:35,2007-05-19 18:54:35
d8db013eea14e69222810deea9a7e290b99966b4...0f424f50849930f92ab37638cfa1e34caac09877,1,109,0,109,5,2007-05-19 19:13:39,2007-05-19 19:13:39
0f424f50849930f92ab37638cfa1e34caac09877...d43522b077bb0c8070aba1821fe029b196cb93b8,1,6,3,9,5,2007-05-20 02:18:22,2007-05-20 02:18:22
d43522b077bb0c8070aba1821fe029b196cb93b8...c9aa4c71ac316e94beb97307502ae2acf8ef6aed,3,27,4,31,7,2007-05-20 03:51:21,2007-05-20 03:51:21
c9aa4c71ac316e94beb97307502ae2acf8ef6aed...edc0fcdf7cf383e0d76ac727689c2b07530b6bfe,3,0,0,0,0,2007-05-20 04:08:14,2007-05-20 04:08:14
edc0fcdf7cf383e0d76ac727689c2b07530b6bfe...1bf43df33dda231daab66451a7efcbc6c68304ae,1,52,73,125,20,2007-05-20 20:39:32,2007-05-20 20:39:32
1bf43df33dda231daab66451a7efcbc6c68304ae...744d06528e593f57ad85399210a386f221a828d9,1,5,0,5,1,2007-05-20 20:43:51,2007-05-20 20:43:51
744d06528e593f57ad85399210a386f221a828d9...03966f077b8f87d6a59366dedc80fcf1f935e2d3,1,2,2,4,2,2007-05-20 20:47:18,2007-05-20 20:47:18
03966f077b8f87d6a59366dedc80fcf1f935e2d3...92c35a0617836b09aef3b6909579ee368004969b,33,3579,108,3687,106,2007-05-21 01:29:58,2007-05-21 01:29:58
92c35a0617836b09aef3b6909579ee368004969b...e71240d60f0f13f2336be045e27284f93bc884eb,1,1,1,2,1,2007-05-21 03:48:52,2007-05-21 03:48:52
e71240d60f0f13f2336be045e27284f93bc884eb...20ba237a30b7a4bb7c2d244a633300b1ae82876f,2,27,24,51,26,2007-05-21 03:51:37,2007-05-21 03:51:37
20ba237a30b7a4bb7c2d244a633300b1ae82876f...fd21702b2ef8e3a9313bc7d36db7f3a46993017f,4,2106,1492,3598,358,2007-05-21 03:55:24,2007-05-21 03:55:24
fd21702b2ef8e3a9313bc7d36db7f3a46993017f...4c5311614471869dc7e820978c77a7d9c3b36afc,2,22,0,22,2,2007-05-21 04:03:53,2007-05-21 04:03:53
4c5311614471869dc7e820978c77a7d9c3b36afc...35cc9d9b0998021ac0e46382f0ca6b4092b9b644,1,11,2,13,4,2007-05-21 20:45:33,2007-05-21 20:45:33
35cc9d9b0998021ac0e46382f0ca6b4092b9b644...d15809c3cd6a4dee45af556b4d3c883628068fe9,1,0,23,23,2,2007-05-21 23:26:36,2007-05-21 23:26:36
d15809c3cd6a4dee45af556b4d3c883628068fe9...9eada8ad62c18b93b306756f872256f4eddbf900,1,0,1,1,1,2007-05-22 04:31:19,2007-05-22 04:31:19
9eada8ad62c18b93b306756f872256f4eddbf900...1e70426619ea512e6792a5b5adf6740fa8fb1cc6,1,4,2,6,3,2007-05-22 16:56:53,2007-05-22 16:56:53
1e70426619ea512e6792a5b5adf6740fa8fb1cc6...dfdf7bdc5e0c11143b3f11ddfa3dc755013ccbfb,1,1,1,2,1,2007-05-24 12:28:53,2007-05-24 12:28:53
dfdf7bdc5e0c11143b3f11ddfa3dc755013ccbfb...198127a0f272e1af60c2e00befe80c96cf498a7f,1,3,1,4,2,2007-05-26 08:47:15,2007-05-26 08:47:15
198127a0f272e1af60c2e00befe80c96cf498a7f...1c42c7cade2cfe970dad844d00d7f5b9fa3e5205,1,9,8,17,7,2007-05-26 08:53:22,2007-05-26 08:53:22
1c42c7cade2cfe970dad844d00d7f5b9fa3e5205...a901b44c15d024a7a15ccbff5d167118427b924c,1,4,6,10,5,2007-05-26 09:02:17,2007-05-26 09:02:17
a901b44c15d024a7a15ccbff5d167118427b924c...8d3b587012886cf7b96f6a7c594688b5043e0897,4,2034,1998,4032,561,2007-05-26 09:05:11,2007-05-26 09:05:11
8d3b587012886cf7b96f6a7c594688b5043e0897...611585665a49d182b1b9be3521398cac3121ade7,2,2,2,4,1,2007-05-26 09:07:06,2007-05-26 09:07:06
611585665a49d182b1b9be3521398cac3121ade7...c0c953469715e004da307fdca04e740ea4c2f3d3,1,4,2,6,1,2007-05-26 09:17:38,2007-05-26 09:17:38
c0c953469715e004da307fdca04e740ea4c2f3d3...c1efc3cd9fdf4cfd3b7e5d50fd86a0419c21872e,1,2,2,4,2,2007-05-26 09:22:55,2007-05-26 09:22:55
c1efc3cd9fdf4cfd3b7e5d50fd86a0419c21872e...aae36cfc8e8ad50c6ee3001fbf4f87f5de3b9a46,1,5,4,9,3,2007-05-26 09:43:32,2007-05-26 09:43:32
aae36cfc8e8ad50c6ee3001fbf4f87f5de3b9a46...193a83ca509acfb3db4694809461a1476f6530bb,1,19,0,19,1,2007-05-26 09:47:47,2007-05-26 09:47:47
193a83ca509acfb3db4694809461a1476f6530bb...30d4e9424d6d1719261ef72258feaa2b498c65b0,1,1,1,2,1,2007-05-26 09:48:50,2007-05-26 09:48:50
30d4e9424d6d1719261ef72258feaa2b498c65b0...3c948d45d2866d834a765023e1a3c1bca8ef5697,1,2,1,3,1,2007-05-26 09:53:16,2007-05-26 09:53:16
3c948d45d2866d834a765023e1a3c1bca8ef5697...12771614db6e82a9f6eeb836d963a4c0c1f74f82,2,3,0,3,2,2007-05-26 10:36:36,2007-05-26 10:36:36
12771614db6e82a9f6eeb836d963a4c0c1f74f82...ee2dfe7e463b98f77bd54729c2d34726a2a3f2ea,1,2,2,4,2,2007-05-27 04:37:46,2007-05-27 04:37:46
ee2dfe7e463b98f77bd54729c2d34726a2a3f2ea...451cbfe8943edeadda6f0de78c03c90cb8f9d7f6,1,7,1,8,2,2007-05-27 10:44:42,2007-05-27 10:44:42
451cbfe8943edeadda6f0de78c03c90cb8f9d7f6...d66b56f53be3a5c42468be1441688da927357703,1,6,2,8,2,2007-05-27 11:09:52,2007-05-27 11:09:52
d66b56f53be3a5c42468be1441688da927357703...43dd1c647dca51542539593736ada636fdc5738b,1,5,0,5,1,2007-05-27 11:33:57,2007-05-27 11:33:57
43dd1c647dca51542539593736ada636fdc5738b...a4e3581dfc8e16970014d1ecf5b9d6af7e4f46f4,1,34,0,34,1,2007-05-27 12:05:59,2007-05-27 12:05:59
a4e3581dfc8e16970014d1ecf5b9d6af7e4f46f4...b0b5023313eae66c0ed3642cff1a4abae1d7da69,1,37,0,37,2,2007-05-27 12:45:14,2007-05-27 12:45:14
b0b5023313eae66c0ed3642cff1a4abae1d7da69...5785763833130953aaf261baacc90825dec08d98,1,12,0,12,3,2007-05-27 13:01:21,2007-05-27 13:01:21
5785763833130953aaf261baacc90825dec08d98...13db259fe0e4cf6fde35b45369f192db7257c423,1,3,2,5,2,2007-05-27 13:11:30,2007-05-27 13:11:30
13db259fe0e4cf6fde35b45369f192db7257c423...47c94244e4067eba2197ea68b101e55e77b3436f,1,4,0,4,2,2007-05-27 13:19:37,2007-05-27 13:19:37
47c94244e4067eba2197ea68b101e55e77b3436f...67abbb6ea00fc6c8cdc0a0e1c5b25a874ceaa769,1,1,1,2,1,2007-05-27 13:20:48,2007-05-27 13:20:48
67abbb6ea00fc6c8cdc0a0e1c5b25a874ceaa769...5bb8c8488285cdaa0563ca5e9930bdf52f004f55,1,20,3,23,5,2007-05-27 13:41:10,2007-05-27 13:41:10
5bb8c8488285cdaa0563ca5e9930bdf52f004f55...ac2772bd5c9a6c6db01d0161cb8a4a9e8902637f,1,1,1,2,1,2007-05-27 14:09:57,2007-05-27 14:09:57
ac2772bd5c9a6c6db01d0161cb8a4a9e8902637f...3ae89e6abd8616c3f182748d927c77eeb2c15b3b,1,3,1,4,1,2007-05-28 01:22:42,2007-05-28 01:22:42
3ae89e6abd8616c3f182748d927c77eeb2c15b3b...c84ff156c190d7e425da1abef56f09127fd7e9db,4,18,2,20,4,2007-05-28 05:41:32,2007-05-28 05:41:32
c84ff156c190d7e425da1abef56f09127fd7e9db...d9f6470f2dd452280b5dd1108510f3f5dba0cb9c,4,21,2,23,5,2007-05-29 11:09:24,2007-05-29 11:09:24
d9f6470f2dd452280b5dd1108510f3f5dba0cb9c...0c4385bb02a839147bebe8d3ac25a35a17528a04,4,77,9,86,12,2007-05-29 12:42:08,2007-05-29 12:42:08
0c4385bb02a839147bebe8d3ac25a35a17528a04...f2aaa3d1d16a6b7f789db054f9636a7ac33184fc,1,1,1,2,1,2007-05-29 18:15:24,2007-05-29 18:15:24
f2aaa3d1d16a6b7f789db054f9636a7ac33184fc...bf2e62aa3c1244c46cc99b255c8e4186a278da28,2,38,3,41,5,2007-05-31 02:22:41,2007-05-31 02:22:41
bf2e62aa3c1244c46cc99b255c8e4186a278da28...8d3026bd9412a85f9e915aadf27745b0ec317e6e,1,1,1,2,1,2007-05-31 04:30:40,2007-05-31 04:30:40
8d3026bd9412a85f9e915aadf27745b0ec317e6e...0e7a49fa1ee8a54fedf0bde8ac3f06e86127110a,3,9,2,11,5,2007-05-31 13:18:12,2007-05-31 13:18:12
0e7a49fa1ee8a54fedf0bde8ac3f06e86127110a...603d5cc05a742ec25bd1863954afac58c6679580,1,2,2,4,2,2007-05-31 15:32:37,2007-05-31 15:32:37
603d5cc05a742ec25bd1863954afac58c6679580...9a40cfda16b8177a8db4d602ef440092d57533a7,1,1,1,2,1,2007-06-01 01:44:47,2007-06-01 01:44:47
9a40cfda16b8177a8db4d602ef440092d57533a7...eb29552b205bd8cbd8ec59adead1205839c3db4a,2,8,6,14,3,2007-06-01 09:35:29,2007-06-01 09:35:29
eb29552b205bd8cbd8ec59adead1205839c3db4a...a3b6e4e7d339ee2f1740962f42e182e025ce6615,1,2,2,4,1,2007-06-01 09:38:32,2007-06-01 09:38:32
a3b6e4e7d339ee2f1740962f42e182e025ce6615...250b84dd0e30ae916e2f033790098281dff0b9e2,2,6,5,11,3,2007-06-01 09:46:56,2007-06-01 09:46:56
250b84dd0e30ae916e2f033790098281dff0b9e2...dcc090e4572959e11aa9ce0edf99785ac882d083,1,3,2,5,1,2007-06-01 10:00:00,2007-06-01 10:00:00
dcc090e4572959e11aa9ce0edf99785ac882d083...2dd753fa889d4868a52c465beb8a48a0bca761eb,1,4,3,7,1,2007-06-01 10:11:43,2007-06-01 10:11:43
2dd753fa889d4868a52c465beb8a48a0bca761eb...9b9411584340f2efcf24e28548be446de4bd9f29,1,3,0,3,1,2007-06-01 10:37:39,2007-06-01 10:37:39
9b9411584340f2efcf24e28548be446de4bd9f29...63a1304f544e2af5b81c3e1bf67441478c23ee39,1,1,1,2,1,2007-06-01 11:47:54,2007-06-01 11:47:54
63a1304f544e2af5b81c3e1bf67441478c23ee39...8728e0f35398e05bba9956b5b85f7cc3fbf33143,1,6,3,9,3,2007-06-01 11:58:17,2007-06-01 11:58:17
8728e0f35398e05bba9956b5b85f7cc3fbf33143...ea07351799ea71084c1279ad9f5dab1f81362c4b,6,73,0,73,10,2007-06-01 13:39:08,2007-06-01 13:39:08
ea07351799ea71084c1279ad9f5dab1f81362c4b...4cda993213fce2b4567ba31f2dc6a116445ce664,1,4,1,5,2,2007-06-01 16:30:38,2007-06-01 16:30:38
4cda993213fce2b4567ba31f2dc6a116445ce664...956056f7b522c6c9aea491e4624def499f2e85b7,1,3,3,6,3,2007-06-01 16:59:56,2007-06-01 16:59:56
956056f7b522c6c9aea491e4624def499f2e85b7...007ca57374e9a3bdaff28ee2d4f623203003f55d,1,1,1,2,1,2007-06-01 17:03:14,2007-06-01 17:03:14
007ca57374e9a3bdaff28ee2d4f623203003f55d...a97c22bfa3e3e243b4999ff249b82fc81f0343b2,1,1,1,2,1,2007-06-01 17:04:36,2007-06-01 17:04:36
a97c22bfa3e3e243b4999ff249b82fc81f0343b2...80dfe69ddf2818d82da0eeac62e9d0500d47367f,1,5,7,12,1,2007-06-01 17:06:06,2007-06-01 17:06:06
80dfe69ddf2818d82da0eeac62e9d0500d47367f...4d9ab5435c4c073ae1bbc69c7108bdcceb507cab,1,2,3,5,2,2007-06-01 17:09:54,2007-06-01 17:09:54
4d9ab5435c4c073ae1bbc69c7108bdcceb507cab...7de9f79969973c888fb7f21f2e4c9d17c155b153,1,1,1,2,1,2007-06-02 07:55:41,2007-06-02 07:55:41
7de9f79969973c888fb7f21f2e4c9d17c155b153...5ec6ffd6ce1261cc54b685abd1b79ee814a1b224,1,1,1,2,1,2007-06-02 08:00:11,2007-06-02 08:00:11
5ec6ffd6ce1261cc54b685abd1b79ee814a1b224...7747c42503baf6bdf33be81e3e9ea18616b3d0fe,1,2,2,4,1,2007-06-07 17:46:55,2007-06-07 17:46:55
7747c42503baf6bdf33be81e3e9ea18616b3d0fe...e9a3e2faf064fe3a3312d5d1b7dc762318a5fc6f,1,7,2,9,3,2007-06-07 17:50:53,2007-06-07 17:50:53
e9a3e2faf064fe3a3312d5d1b7dc762318a5fc6f...43a06c9a9a02ab76b6d7a00ba522b85dc29a1140,1,1,1,2,1,2007-06-07 18:01:17,2007-06-07 18:01:17
43a06c9a9a02ab76b6d7a00ba522b85dc29a1140...6434de96b708756f27b2c70cfedcb20efb802c4b,1,10,2,12,2,2007-06-07 18:03:21,2007-06-07 18:03:21
6434de96b708756f27b2c70cfedcb20efb802c4b...908b72f76d9f4d4a9555f39669a95f3bdb0764c0,1,10,8,18,2,2007-06-07 18:12:12,2007-06-07 18:12:12
908b72f76d9f4d4a9555f39669a95f3bdb0764c0...f6491bf98402a8896ee1d3f5c7912e588b57a7b8,1,6,3,9,1,2007-06-07 18:18:44,2007-06-07 18:18:44
f6491bf98402a8896ee1d3f5c7912e588b57a7b8...21acccbca25948ba04be05a5d2750d88ffa2fa37,1,9,0,9,1,2007-06-07 18:24:27,2007-06-07 18:24:27
21acccbca25948ba04be05a5d2750d88ffa2fa37...ceba11abf56a66e5698c34e2c3e514cdb0b6d447,1,1,1,2,1,2007-06-07 21:40:56,2007-06-07 21:40:56
ceba11abf56a66e5698c34e2c3e514cdb0b6d447...8494ffc730838d2e1c93462ab8af6280510257f6,1,1,1,2,1,2007-06-07 21:41:41,2007-06-07 21:41:41
8494ffc730838d2e1c93462ab8af6280510257f6...83fe33e2774b9ae59007f39ef61abce73e09c54f,1,51,11,62,8,2007-06-07 22:28:06,2007-06-07 22:28:06
83fe33e2774b9ae59007f39ef61abce73e09c54f...16269c4d0a5d2e61c7555fec438440abee9be9f5,3,74,18,92,14,2007-06-08 11:58:03,2007-06-08 11:58:03
16269c4d0a5d2e61c7555fec438440abee9be9f5...4a1dfe4240f6891bf4f0907b973d3e1575cd7abc,2,2,1,3,2,2007-06-10 01:47:02,2007-06-10 01:47:02
4a1dfe4240f6891bf4f0907b973d3e1575cd7abc...6fc10f50b0c9b877fffcad4893056cb91fa66b4f,1,1,1,2,1,2007-06-10 01:52:56,2007-06-10 01:52:56
6fc10f50b0c9b877fffcad4893056cb91fa66b4f...130c7eee8058847083ad58f1f9abdcf51e879032,4,14,10,24,7,2007-06-10 02:00:46,2007-06-10 02:00:46
130c7eee8058847083ad58f1f9abdcf51e879032...1b02534ac343bc3b4b1a7703affe27f209a72bda,1,1,1,2,1,2007-06-10 02:13:58,2007-06-10 02:13:58
1b02534ac343bc3b4b1a7703affe27f209a72bda...a33fb695e37c921d2bc0ffe3b011ad830f4bea56,2,10,8,18,9,2007-06-10 03:06:34,2007-06-10 03:06:34
a33fb695e37c921d2bc0ffe3b011ad830f4bea56...03ecc00f6ea756d4659b4cacab3eb6e7405e49e0,1,9,5,14,2,2007-06-10 03:11:10,2007-06-10 03:11:10
03ecc00f6ea756d4659b4cacab3eb6e7405e49e0...86fd59cfa51fb703c9553d15717f5ef34b181dde,3,19,8,27,15,2007-06-10 03:31:26,2007-06-10 03:31:26
86fd59cfa51fb703c9553d15717f5ef34b181dde...ca6e4f345e61ce613d9a394caf7c714a50e9c94e,2,12,1,13,4,2007-06-10 04:02:29,2007-06-10 04:02:29
ca6e4f345e61ce613d9a394caf7c714a50e9c94e...b91226027e0719b2763c06965d9889387717691e,2,167,0,167,2,2007-06-10 06:33:31,2007-06-10 06:33:31
b91226027e0719b2763c06965d9889387717691e...484527f7802d78964d5646cc5fad833bfd7c4b6e,1,3,3,6,2,2007-06-11 11:14:05,2007-06-11 11:14:05
484527f7802d78964d5646cc5fad833bfd7c4b6e...04f5bd4378acccc73fa6fb01e9e1798ae5815b9d,1,5,0,5,1,2007-06-11 11:19:43,2007-06-11 11:19:43
04f5bd4378acccc73fa6fb01e9e1798ae5815b9d...5c346840bb8f980d7879492a841d29d00486e41e,1,83,0,83,2,2007-06-11 11:49:25,2007-06-11 11:49:25
5c346840bb8f980d7879492a841d29d00486e41e...a4d773b5801b91553ffe097840d770d2ea2b8b23,1,2,5,7,2,2007-06-11 20:03:07,2007-06-11 20:03:07
a4d773b5801b91553ffe097840d770d2ea2b8b23...9bc8941f678ed5619c522e65de91be33bf7534a7,1,1,1,2,1,2007-06-12 00:31:55,2007-06-12 00:31:55
9bc8941f678ed5619c522e65de91be33bf7534a7...1e57d6ccf0c0d005926b8620f34ecf69189eb2e9,1,2,2,4,2,2007-06-13 02:22:26,2007-06-13 02:22:26
1e57d6ccf0c0d005926b8620f34ecf69189eb2e9...88632cd7f9242079df33da737ab63c9e5da35b2e,1,1,1,2,1,2007-06-15 00:07:03,2007-06-15 00:07:03
88632cd7f9242079df33da737ab63c9e5da35b2e...4a61c2f9120fcf8effe5bf6d049f776d9f5a92a3,2,4,3,7,4,2007-06-15 00:22:16,2007-06-15 00:22:16
4a61c2f9120fcf8effe5bf6d049f776d9f5a92a3...762e677d26c53b73f0485012df140d3313ea964f,1,2,3,5,1,2007-06-15 00:26:30,2007-06-15 00:26:30
762e677d26c53b73f0485012df140d3313ea964f...44dd91ec6d39525e52b78f7fff6de8531b980f5f,1,5,0,5,2,2007-06-15 01:53:40,2007-06-15 01:53:40
44dd91ec6d39525e52b78f7fff6de8531b980f5f...bccb8897e6ab0fe8d2e5b9bcb725ac28b1c8e566,21,284,161,445,128,2007-06-17 07:11:37,2007-06-17 07:11:37
bccb8897e6ab0fe8d2e5b9bcb725ac28b1c8e566...9b397ee50d3ba3c29c754ad54b9181b4f300ea6f,1,6,2,8,2,2007-06-17 07:21:09,2007-06-17 07:21:09
9b397ee50d3ba3c29c754ad54b9181b4f300ea6f...2a34fbe043d5c4ba789e866a912646aea1bb807c,2,28,10,38,5,2007-06-17 07:33:18,2007-06-17 07:33:18
2a34fbe043d5c4ba789e866a912646aea1bb807c...cc0c7fa6cd8c88e670122e380370a559c1bed0be,3,1400,721,2121,310,2007-06-17 08:11:38,2007-06-17 08:11:38
cc0c7fa6cd8c88e670122e380370a559c1bed0be...b0fa08b9e0cc0d975515a0d84c932280da50e75e,1,0,4,4,2,2007-06-17 09:46:04,2007-06-17 09:46:04
b0fa08b9e0cc0d975515a0d84c932280da50e75e...b6b1ab22b59e2797ec74611aac820dc5bc25a9df,1,2,2,4,1,2007-06-18 10:02:58,2007-06-18 10:02:58
b6b1ab22b59e2797ec74611aac820dc5bc25a9df...18619a11eebc4139ec98ba254bcb760365d34db1,1,21,21,42,2,2007-06-19 20:04:54,2007-06-19 20:04:54
18619a11eebc4139ec98ba254bcb760365d34db1...13216e12ddb2ecef4921b884abf8be157b537a45,1,1,1,2,1,2007-06-20 06:01:16,2007-06-20 06:01:16
13216e12ddb2ecef4921b884abf8be157b537a45...a65c458b99400607f2d7151f935be8379fc5b804,1,4,2,6,1,2007-06-20 06:03:51,2007-06-20 06:03:51
a65c458b99400607f2d7151f935be8379fc5b804...c6cac4a78e529cbeecdeb1f300ae9732d12c3dc9,1,1,1,2,1,2007-06-20 06:07:06,2007-06-20 06:07:06
c6cac4a78e529cbeecdeb1f300ae9732d12c3dc9...bb5734ee30f149f173d510e308b05e29f1448888,1,1,1,2,2,2007-06-20 06:08:47,2007-06-20 06:08:47
bb5734ee30f149f173d510e308b05e29f1448888...11a8084d4f77842b476de3687319ca243663d7df,1,6,1,7,1,2007-06-20 06:12:43,2007-06-20 06:12:43
11a8084d4f77842b476de3687319ca243663d7df...903c561294b299b8f0aa20b4dd4c45a4313d2ba3,1,1,0,1,1,2007-06-20 06:13:24,2007-06-20 06:13:24
903c561294b299b8f0aa20b4dd4c45a4313d2ba3...761c0a49e48fcf1ac6eb335693e0a2cea0a9e247,2,5,1,6,3,2007-06-20 06:16:56,2007-06-20 06:16:56
761c0a49e48fcf1ac6eb335693e0a2cea0a9e247...024c3daa11c8c16cf577d4e1faec329daa9d27ef,1,11,11,22,7,2007-06-20 06:23:15,2007-06-20 06:23:15
024c3daa11c8c16cf577d4e1faec329daa9d27ef...7c3fa24fadb67a4cfd44a47ddf4c17baffcc3717,1,1,1,2,1,2007-06-20 19:38:19,2007-06-20 19:38:19
7c3fa24fadb67a4cfd44a47ddf4c17baffcc3717...042d7e44fa5effd901cf1828d8f6f2058113cbc7,1,1,1,2,1,2007-06-20 19:39:24,2007-06-20 19:39:24
042d7e44fa5effd901cf1828d8f6f2058113cbc7...dbebf54d6c189a4ccd157d1ee3640b2292d6225e,1,1,1,2,1,2007-06-21 16:05:23,2007-06-21 16:05:23
dbebf54d6c189a4ccd157d1ee3640b2292d6225e...880e3cfaa6040bb745ecfdbd91be0234cdb87278,21,162,284,446,128,2007-06-22 07:15:04,2007-06-22 07:15:04
880e3cfaa6040bb745ecfdbd91be0234cdb87278...284c6ba44b2285904f4ad4ad90d0c123b888c906,3,23,9,32,6,2007-06-23 03:10:32,2007-06-23 03:10:32
284c6ba44b2285904f4ad4ad90d0c123b888c906...08aa5c585b511cfaf97ced38f2b5f7fb96492203,8,34,20,54,15,2007-06-23 03:18:22,2007-06-23 03:18:22
08aa5c585b511cfaf97ced38f2b5f7fb96492203...dfea6bdfa5f629679960115f26498fb4a378d75b,2,29,5,34,5,2007-06-23 03:32:59,2007-06-23 03:32:59
dfea6bdfa5f629679960115f26498fb4a378d75b...5f5f1d913bbe25dd9a33a2759144160e1473c12a,2,53,30,83,10,2007-06-23 05:40:28,2007-06-23 05:40:28
5f5f1d913bbe25dd9a33a2759144160e1473c12a...fc20eeec47f1bf7b178a0432fa74f54a452b62ce,3,12,6,18,3,2007-06-23 06:02:17,2007-06-23 06:02:17
fc20eeec47f1bf7b178a0432fa74f54a452b62ce...553a20075e6991e7a60baee51ea68c8adc520d9a,2,5,5,10,5,2007-06-23 06:19:26,2007-06-23 06:19:26
553a20075e6991e7a60baee51ea68c8adc520d9a...ac64e91a0cadc57f4bc5cd5d66955832320ca7a1,28,1239,172,1411,184,2007-06-23 14:16:00,2007-06-23 14:16:00
ac64e91a0cadc57f4bc5cd5d66955832320ca7a1...6b88d4abd08b05a24a7ff13f6a51579c48118747,1,15,9,24,3,2007-06-24 09:38:30,2007-06-24 09:38:30
6b88d4abd08b05a24a7ff13f6a51579c48118747...36eeb9924accf9e418c998ead37fa7bd4c09c4c9,5,2340,1409,3749,340,2007-06-24 11:48:41,2007-06-24 11:48:41
36eeb9924accf9e418c998ead37fa7bd4c09c4c9...73d4e193ed5cc757f6b46868f9fbdcd2d3e2302d,3,2257,1216,3473,342,2007-06-24 11:56:42,2007-06-24 11:56:42
73d4e193ed5cc757f6b46868f9fbdcd2d3e2302d...786fab6d842c91e711a2fde2cd5947e91888e983,6,2974,0,2974,4,2007-06-24 12:16:06,2007-06-24 12:16:06
786fab6d842c91e711a2fde2cd5947e91888e983...962fe473216aa54258e05157b295113657b7cb24,3,835,394,1229,297,2007-06-24 12:19:14,2007-06-24 12:19:14
962fe473216aa54258e05157b295113657b7cb24...02bf47d831bc73f1a73599582eb2e998fe14f116,5,52,23,75,29,2007-06-24 12:22:25,2007-06-24 12:22:25
02bf47d831bc73f1a73599582eb2e998fe14f116...a56a8dacf3b0bc54f6133a2037c2c452152c1653,1,1,1,2,1,2007-06-24 12:38:11,2007-06-24 12:38:11
a56a8dacf3b0bc54f6133a2037c2c452152c1653...14161dba6b8ef496b77561eecca8cbd59323931e,1,1,1,2,1,2007-06-25 03:08:00,2007-06-25 03:08:00
14161dba6b8ef496b77561eecca8cbd59323931e...a5802b35ddc599f8425b1759148ca2ebc5f32837,3,19,6,25,5,2007-06-25 04:34:34,2007-06-25 04:34:34
a5802b35ddc599f8425b1759148ca2ebc5f32837...17145eef4c4807f0ae385f48cf5cd3655a482154,1,0,1,1,1,2007-06-25 16:10:33,2007-06-25 16:10:33
17145eef4c4807f0ae385f48cf5cd3655a482154...85f6f15263d9835a68f92dbece999190dea6f848,5,6,5,11,6,2007-06-25 16:11:32,2007-06-25 16:11:32
85f6f15263d9835a68f92dbece999190dea6f848...b8b9c95dcadbba3227606a7a7be41eab1370e8a4,1,1,1,2,1,2007-06-25 16:19:36,2007-06-25 16:19:36
b8b9c95dcadbba3227606a7a7be41eab1370e8a4...20e00560d64410dc1cafb6ffdc224f26a772d29e,4,129,137,266,127,2007-06-25 16:26:25,2007-06-25 16:26:25
20e00560d64410dc1cafb6ffdc224f26a772d29e...621db31c3af6df9c5e3394698e87496e828baad9,1,3,1,4,2,2007-06-26 12:53:33,2007-06-26 12:53:33
621db31c3af6df9c5e3394698e87496e828baad9...fedcabea9ec31bbff2a8c4f7e21fc214dde9a9a8,1,1,1,2,1,2007-06-26 12:58:42,2007-06-26 12:58:42
fedcabea9ec31bbff2a8c4f7e21fc214dde9a9a8...4ac1de31cd02248b8847f7c119e205bf6e34559e,1,1,0,1,1,2007-06-26 12:59:49,2007-06-26 12:59:49
4ac1de31cd02248b8847f7c119e205bf6e34559e...551a36131eff28d51b524b0cd1185a1fdde05be4,2,551,209,760,205,2007-06-26 13:05:03,2007-06-26 13:05:03
551a36131eff28d51b524b0cd1185a1fdde05be4...2d082a34dc61a832710d98a933858fd2c0059644,2,122,11,133,18,2007-06-27 09:44:55,2007-06-27 09:44:55
2d082a34dc61a832710d98a933858fd2c0059644...719a90391d1d78194f18219dd434e662465c424d,2,62,7,69,10,2007-06-27 12:18:05,2007-06-27 12:18:05
719a90391d1d78194f18219dd434e662465c424d...bcb088b558df207905af2db5c5691b4148f9a1c8,1,0,2,2,1,2007-06-27 12:19:21,2007-06-27 12:19:21
bcb088b558df207905af2db5c5691b4148f9a1c8...987f8aa257540aa310cd029f9b6c914700095ede,2,33,11,44,7,2007-06-27 12:41:37,2007-06-27 12:41:37
987f8aa257540aa310cd029f9b6c914700095ede...d605611bc533266e0e7a1358611f165f8160ffb1,1,0,3,3,1,2007-06-27 12:43:28,2007-06-27 12:43:28
d605611bc533266e0e7a1358611f165f8160ffb1...26659f2782c919a640e33e4566ffe61712f4ea24,1,1,1,2,1,2007-06-27 12:44:29,2007-06-27 12:44:29
26659f2782c919a640e33e4566ffe61712f4ea24...eeb4ffc2c1b9baaf9f8e87d14e24b1679f98f7b7,1,3,1,4,2,2007-06-27 12:54:15,2007-06-27 12:54:15
eeb4ffc2c1b9baaf9f8e87d14e24b1679f98f7b7...7dc8b1a1a8a8e2771f37568a125fd51a3283b043,1,3,1,4,2,2007-06-27 13:02:38,2007-06-27 13:02:38
7dc8b1a1a8a8e2771f37568a125fd51a3283b043...24512a74befc6282a1d299cab452ee9463cc2baa,10,170,2,172,15,2007-06-27 18:58:10,2007-06-27 18:58:10
24512a74befc6282a1d299cab452ee9463cc2baa...a9807db5528637c86f3912b919d13223b6346bf2,1,6,2,8,3,2007-06-27 19:16:05,2007-06-27 19:16:05
a9807db5528637c86f3912b919d13223b6346bf2...4a892f4d869bc47ebd91558a5180ecdbbeefaefa,1,5,0,5,2,2007-06-28 02:52:54,2007-06-28 02:52:54
4a892f4d869bc47ebd91558a5180ecdbbeefaefa...88f2fdf94df734cdc0f9384fb39d9493ddfca46b,3,106,117,223,117,2007-06-28 06:56:00,2007-06-28 06:56:00
88f2fdf94df734cdc0f9384fb39d9493ddfca46b...4fdbd7e3a269756aeafc53f0b3c3e6b20c3cdcd0,10,590,0,590,5,2007-06-28 07:41:44,2007-06-28 07:41:44
4fdbd7e3a269756aeafc53f0b3c3e6b20c3cdcd0...8cea4c7c5e4fff7d5dc3adebf33f353d0cab6048,1,11,6,17,3,2007-06-30 20:58:36,2007-06-30 20:58:36
8cea4c7c5e4fff7d5dc3adebf33f353d0cab6048...918738919e5cac320798c585a8b2bdc2a581b7f0,1,6,6,12,6,2007-06-30 21:03:41,2007-06-30 21:03:41
918738919e5cac320798c585a8b2bdc2a581b7f0...b67a2feebf69a20bd31543e4a954e2979972db7f,1,16,15,31,3,2007-06-30 21:06:47,2007-06-30 21:06:47
b67a2feebf69a20bd31543e4a954e2979972db7f...23a50aa491fdc80c2542de453794de64e193a5b9,1,5,5,10,4,2007-06-30 21:20:25,2007-06-30 21:20:25
23a50aa491fdc80c2542de453794de64e193a5b9...353110075b5b8613dafe86260b6c3ac7744847fb,1,49,0,49,1,2007-06-30 21:20:44,2007-06-30 21:20:44
353110075b5b8613dafe86260b6c3ac7744847fb...6e1385b86258076cb1417cac99869e25d2bd98b9,1,6,0,6,2,2007-06-30 21:24:56,2007-06-30 21:24:56
6e1385b86258076cb1417cac99869e25d2bd98b9...64f20046f1d8c2c61f1c72eff99cc46c4dea3a43,1,13,7,20,7,2007-06-30 21:25:10,2007-06-30 21:25:10
64f20046f1d8c2c61f1c72eff99cc46c4dea3a43...cf4e74a56dadd3d7b2cd0d543c622fbb6a71796a,1,1,1,2,1,2007-06-30 21:26:42,2007-06-30 21:26:42
cf4e74a56dadd3d7b2cd0d543c622fbb6a71796a...b60442f32a1fa5398c01b9b85a1cdef5512fc1a4,1,3,0,3,1,2007-06-30 21:28:13,2007-06-30 21:28:13
b60442f32a1fa5398c01b9b85a1cdef5512fc1a4...3336bd5c3df4e2837bfdfdbd6cd50e185134fc11,1,6,5,11,5,2007-06-30 21:29:42,2007-06-30 21:29:42
3336bd5c3df4e2837bfdfdbd6cd50e185134fc11...510e545776468ee0d546c1d57ca668a53d261ca6,8,12,12,24,10,2007-07-01 01:00:23,2007-07-01 01:00:23
510e545776468ee0d546c1d57ca668a53d261ca6...acf0ff02e78105c67d2a66c7c898f572ae84fdc0,2,32,15,47,7,2007-07-01 04:24:20,2007-07-01 04:24:20
acf0ff02e78105c67d2a66c7c898f572ae84fdc0...3a892122f2347cc2999857bda1139d084a8e7dce,1,29,26,55,15,2007-07-01 04:47:46,2007-07-01 04:47:46
3a892122f2347cc2999857bda1139d084a8e7dce...1b1379a182a055a696152fcc0620f9ec4c590c6d,1,10,9,19,3,2007-07-01 06:32:34,2007-07-01 06:32:34
1b1379a182a055a696152fcc0620f9ec4c590c6d...179f478ffe8ff31c753df9cc0f83f0f9eb4557de,1,1,1,2,1,2007-07-03 12:24:46,2007-07-03 12:24:46
179f478ffe8ff31c753df9cc0f83f0f9eb4557de...f9a592d99d3ed689ed757ba2a18007e277c7db1d,2,17,0,17,3,2007-07-03 15:02:40,2007-07-03 15:02:40
f9a592d99d3ed689ed757ba2a18007e277c7db1d...ee7fe94d45150fad2c90a16ae23034a8bba98efd,2,7,0,7,3,2007-07-03 15:09:05,2007-07-03 15:09:05
ee7fe94d45150fad2c90a16ae23034a8bba98efd...c7b49792f4de416c903965ff5d029a566b8d7ef8,1,3,2,5,2,2007-07-03 15:11:49,2007-07-03 15:11:49
c7b49792f4de416c903965ff5d029a566b8d7ef8...107dd8938568ba5e47c732366698a7668040ffa1,1,2,1,3,2,2007-07-03 19:20:56,2007-07-03 19:20:56
107dd8938568ba5e47c732366698a7668040ffa1...3d6785fb8e9d45d2a0e1e1dea0d7472550198724,1,1,1,2,1,2007-07-03 19:21:33,2007-07-03 19:21:33
3d6785fb8e9d45d2a0e1e1dea0d7472550198724...4c958b15b250866b70ded7d82aa532f1e57f96ae,2,23,23,46,16,2007-07-03 19:26:34,2007-07-03 19:26:34
4c958b15b250866b70ded7d82aa532f1e57f96ae...953badbea5a04159adbfa970f5805c0232b6a401,193,3000,1598,4598,1291,2007-07-04 12:11:04,2007-07-04 12:11:04
953badbea5a04159adbfa970f5805c0232b6a401...f0250b64f6e5bd0409725c801ff1c26023dbe5e9,1,4,5,9,3,2007-07-04 12:25:43,2007-07-04 12:25:43
f0250b64f6e5bd0409725c801ff1c26023dbe5e9...fbd938180209b99caee4de8bcf02240bef64d449,2,16,8,24,5,2007-07-04 12:31:19,2007-07-04 12:31:19
fbd938180209b99caee4de8bcf02240bef64d449...e7427cb22f21a520b117b84b02e44fbaf628ce3e,1,5,2,7,3,2007-07-04 12:48:12,2007-07-04 12:48:12
e7427cb22f21a520b117b84b02e44fbaf628ce3e...7c35eee103df3b6f971ef77aa8394c898bf77687,1,1,3,4,1,2007-07-05 01:25:05,2007-07-05 01:25:05
7c35eee103df3b6f971ef77aa8394c898bf77687...72f45dfe22128f0c47af528c7d52682ea6df4d54,3,5,4,9,5,2007-07-05 03:25:11,2007-07-05 03:25:11
72f45dfe22128f0c47af528c7d52682ea6df4d54...d2c45bacd25eaacbcb0e2970d22edd4580cc4f25,3,2184,1503,3687,402,2007-07-05 03:29:18,2007-07-05 03:29:18
d2c45bacd25eaacbcb0e2970d22edd4580cc4f25...d0b627acc2e9553b09cab3435258bcef044728ae,1,6,0,6,1,2007-07-05 10:27:22,2007-07-05 10:27:22
d0b627acc2e9553b09cab3435258bcef044728ae...79e914e4967adc3030be7044f502e37bbb4ba88e,2,10,0,10,3,2007-07-05 11:08:40,2007-07-05 11:08:40
79e914e4967adc3030be7044f502e37bbb4ba88e...05de38151239b0a89f5aaec6808bbc5318cee5d1,1,24,1,25,3,2007-07-05 11:10:27,2007-07-05 11:10:27
05de38151239b0a89f5aaec6808bbc5318cee5d1...71cb907131755e34591371ea631104215648ec98,1,1,1,2,1,2007-07-05 12:54:42,2007-07-05 12:54:42
71cb907131755e34591371ea631104215648ec98...0816f380d2f576b95300f0d405aef0372b64be03,1,3,3,6,3,2007-07-06 04:04:42,2007-07-06 04:04:42
0816f380d2f576b95300f0d405aef0372b64be03...8f96bd2c723448ebf9dca28808942b6599d818c3,1,1,1,2,1,2007-07-06 06:53:27,2007-07-06 06:53:27
8f96bd2c723448ebf9dca28808942b6599d818c3...671fb8aa53163aafcf26912b4490c467ed65afae,1,16,4,20,5,2007-07-06 08:04:04,2007-07-06 08:04:04
671fb8aa53163aafcf26912b4490c467ed65afae...d91fb7079b8d5fa6b5f03982e2ae12b63ed5c8b5,5,2526,1476,4002,355,2007-07-06 08:35:25,2007-07-06 08:35:25
d91fb7079b8d5fa6b5f03982e2ae12b63ed5c8b5...3198b645169714af33af651b7d13c3f26a62c103,1,2,2,4,2,2007-07-06 10:21:14,2007-07-06 10:21:14
3198b645169714af33af651b7d13c3f26a62c103...347704d2df12f83ef0bd7f0b54766c5b90cc90ad,1,4,1,5,3,2007-07-07 02:16:23,2007-07-07 02:16:23
347704d2df12f83ef0bd7f0b54766c5b90cc90ad...fad72477151b7f77d7098cc3721aeaee47e735b6,3,6,4,10,6,2007-07-07 17:15:54,2007-07-07 17:15:54
fad72477151b7f77d7098cc3721aeaee47e735b6...8c85ddf306e6d707e4bd521e7708509a3fb29bf1,4,13,10,23,10,2007-07-07 18:24:27,2007-07-07 18:24:27
8c85ddf306e6d707e4bd521e7708509a3fb29bf1...4c011e6f36039344a917133979c247ed9ad67b00,1,4,3,7,2,2007-07-07 18:39:23,2007-07-07 18:39:23
4c011e6f36039344a917133979c247ed9ad67b00...b6812f2d9d1bea3bdc9c5f9a747c5c71c764fa0f,2,20,20,40,8,2007-07-08 00:39:32,2007-07-08 00:39:32
b6812f2d9d1bea3bdc9c5f9a747c5c71c764fa0f...5a32b3ac2c99a1f3e033dd3af1b20e309ccea8ad,1,5,3,8,2,2007-07-08 11:22:53,2007-07-08 11:22:53
5a32b3ac2c99a1f3e033dd3af1b20e309ccea8ad...0be6d32c24bd70e45c2faa8d332b4de31d457646,4,11,11,22,6,2007-07-10 02:34:42,2007-07-10 02:34:42
0be6d32c24bd70e45c2faa8d332b4de31d457646...541c9ff797f37e34cc2056b4ed483be8e192559c,1,15,15,30,9,2007-07-10 02:45:11,2007-07-10 02:45:11
541c9ff797f37e34cc2056b4ed483be8e192559c...0927ab92b20b9852dc1cef6c81453e2ee95bd01b,1,1,1,2,1,2007-07-10 03:26:26,2007-07-10 03:26:26
0927ab92b20b9852dc1cef6c81453e2ee95bd01b...cc1a4f031c5cefa15bb06986254e696ad5734fbb,1,2,1,3,1,2007-07-10 12:02:06,2007-07-10 12:02:06
cc1a4f031c5cefa15bb06986254e696ad5734fbb...87d8976faee7b07a30ce1bd844b2b6178c3a3328,2,3,3,6,3,2007-07-10 12:03:36,2007-07-10 12:03:36
87d8976faee7b07a30ce1bd844b2b6178c3a3328...86640f33c1f290a64452ce700e6f3da1ba618bdf,3,32,3,35,7,2007-07-10 12:33:55,2007-07-10 12:33:55
86640f33c1f290a64452ce700e6f3da1ba618bdf...8d9982c5a572358f0f3fc3402766ce9e3a06d90c,1,3,4,7,2,2007-07-11 06:55:12,2007-07-11 06:55:12
8d9982c5a572358f0f3fc3402766ce9e3a06d90c...047b35cf3bbfc1a6c57662578343d518af1a03a2,2,658,419,1077,384,2007-07-11 07:00:27,2007-07-11 07:00:27
047b35cf3bbfc1a6c57662578343d518af1a03a2...12621d1949047a50364f229c3240a0c3a437e9a0,2,321,300,621,272,2007-07-11 07:12:50,2007-07-11 07:12:50
12621d1949047a50364f229c3240a0c3a437e9a0...74fe707e0491a967fe5fb36e28e8f14c1163442b,1,16,1,17,3,2007-07-12 00:33:44,2007-07-12 00:33:44
74fe707e0491a967fe5fb36e28e8f14c1163442b...0c5d001531f81a8a6ea25d07eccf06f5a8087e2a,1,11,7,18,7,2007-07-12 04:43:29,2007-07-12 04:43:29
0c5d001531f81a8a6ea25d07eccf06f5a8087e2a...8c4cc3235239d4d9d39a6294443a9cce0a7a7a81,1,3,3,6,2,2007-07-12 04:44:45,2007-07-12 04:44:45
8c4cc3235239d4d9d39a6294443a9cce0a7a7a81...06fc225ae6e00ed47f02eef7f6699e61cc76430e,1,6,1,7,1,2007-07-12 05:23:47,2007-07-12 05:23:47
06fc225ae6e00ed47f02eef7f6699e61cc76430e...dcd5750d7ac6692428e431010772f1941406d576,2,35,0,35,2,2007-07-12 05:28:04,2007-07-12 05:28:04
dcd5750d7ac6692428e431010772f1941406d576...090aa5210ebd5ce3c79db95d3f04c95ed346f42a,3,25,7,32,10,2007-07-12 05:29:32,2007-07-12 05:29:32
090aa5210ebd5ce3c79db95d3f04c95ed346f42a...2d6d20def70dacf4ea783e5a0c8a72266e603bb7,5,55,14,69,17,2007-07-12 07:45:35,2007-07-12 07:45:35
2d6d20def70dacf4ea783e5a0c8a72266e603bb7...7a198f51050adb2f626a5ef422a3bfab7a2305e3,1,2,1,3,1,2007-07-12 11:24:16,2007-07-12 11:24:16
7a198f51050adb2f626a5ef422a3bfab7a2305e3...81d313c9b147dbacb00ecab81a7d8ab08937d26b,2,5,4,9,2,2007-07-12 11:27:38,2007-07-12 11:27:38
81d313c9b147dbacb00ecab81a7d8ab08937d26b...16551036660c1bbb5606cc143d67bb6f97ec4b80,1,6,5,11,3,2007-07-12 12:33:24,2007-07-12 12:33:24
16551036660c1bbb5606cc143d67bb6f97ec4b80...f3e71048c3e6b3c932586e3ec45a55986f90f63c,4,45,2,47,6,2007-07-12 12:44:05,2007-07-12 12:44:05
f3e71048c3e6b3c932586e3ec45a55986f90f63c...119c6005a616db20585950e915d91b4f40615707,1,2,2,4,1,2007-07-12 12:48:27,2007-07-12 12:48:27
119c6005a616db20585950e915d91b4f40615707...7df9e7da5bc8a1665c8eaea8eaf9137139069350,1,1,1,2,1,2007-07-12 12:50:02,2007-07-12 12:50:02
7df9e7da5bc8a1665c8eaea8eaf9137139069350...6cf7a4ac6574ebed3465215c42360ea1f8e42c70,1,13,0,13,1,2007-07-12 12:55:28,2007-07-12 12:55:28
6cf7a4ac6574ebed3465215c42360ea1f8e42c70...ab368c9c751c75d63d32894906d03c8052db6cc6,1,2,2,4,2,2007-07-12 13:23:11,2007-07-12 13:23:11
ab368c9c751c75d63d32894906d03c8052db6cc6...7f5797e640761c64f5622b858bf56a40a9151738,1,2,2,4,1,2007-07-12 13:32:00,2007-07-12 13:32:00
7f5797e640761c64f5622b858bf56a40a9151738...a5de16fbe4adbdf960683cbdebea4d4e9db2983d,1,1,4,5,1,2007-07-12 13:37:59,2007-07-12 13:37:59
a5de16fbe4adbdf960683cbdebea4d4e9db2983d...1345f3c5213e8aac5eb2bd99a22891e450d00465,1,8,0,8,1,2007-07-12 13:41:27,2007-07-12 13:41:27
1345f3c5213e8aac5eb2bd99a22891e450d00465...34655a3e7816d6a8e5da6b3fd613b49b454a4691,3,4,5,9,5,2007-07-12 13:55:19,2007-07-12 13:55:19
34655a3e7816d6a8e5da6b3fd613b49b454a4691...4d9e29ea867a9b62683d93a99f1d0d382e89e4d2,1,6,6,12,1,2007-07-12 14:00:13,2007-07-12 14:00:13
4d9e29ea867a9b62683d93a99f1d0d382e89e4d2...53a06763c51f91b5fc5d1639793207f2d0136ea5,1,2,2,4,1,2007-07-12 14:05:16,2007-07-12 14:05:16
53a06763c51f91b5fc5d1639793207f2d0136ea5...0f10867519938b88332d2e43803ec15874e8400f,1,5,2,7,2,2007-07-12 14:11:41,2007-07-12 14:11:41
0f10867519938b88332d2e43803ec15874e8400f...3990efff692892250f96900be93d7b3aa2eaa194,1,1,1,2,1,2007-07-12 14:21:51,2007-07-12 14:21:51
3990efff692892250f96900be93d7b3aa2eaa194...b9232cd955496b69444ca458fa2ba45ab9e25c34,1,16,12,28,8,2007-07-12 14:41:32,2007-07-12 14:41:32
b9232cd955496b69444ca458fa2ba45ab9e25c34...b8d0dc73c762bedc0a36bb380cded62a7b3ea162,3,27,2,29,4,2007-07-12 15:26:37,2007-07-12 15:26:37
b8d0dc73c762bedc0a36bb380cded62a7b3ea162...6335317a423c9533a13d741c673fc45d1f052121,1,2,0,2,1,2007-07-13 05:03:33,2007-07-13 05:03:33
6335317a423c9533a13d741c673fc45d1f052121...54a71805aac3f2dd9c093074f8ff50102a14c5af,1,2,2,4,1,2007-07-13 08:52:07,2007-07-13 08:52:07
54a71805aac3f2dd9c093074f8ff50102a14c5af...92f54aff7a1ea4128906337dcd570a7b897f8976,3,27,15,42,9,2007-07-13 09:09:59,2007-07-13 09:09:59
92f54aff7a1ea4128906337dcd570a7b897f8976...53e3f76d6ec5c450ab2d711368e0dd72bc39dfec,1,6,0,6,2,2007-07-13 09:14:51,2007-07-13 09:14:51
53e3f76d6ec5c450ab2d711368e0dd72bc39dfec...e27a7ef360af84f319b32007be369819044bd05c,1,1,1,2,1,2007-07-13 10:56:30,2007-07-13 10:56:30
e27a7ef360af84f319b32007be369819044bd05c...0145e71cebccb4729e00a31b04db5591614d04d0,1,3,3,6,3,2007-07-13 11:05:01,2007-07-13 11:05:01
0145e71cebccb4729e00a31b04db5591614d04d0...e4bcfc272c4ae6fa5c5b5ffa6fef06fa0cdfd4be,1,3,11,14,5,2007-07-13 12:03:20,2007-07-13 12:03:20
e4bcfc272c4ae6fa5c5b5ffa6fef06fa0cdfd4be...3eb1071b3d3ab21bf98c1b92d5aa0a41c67de13e,1,1,2,3,2,2007-07-13 13:15:35,2007-07-13 13:15:35
3eb1071b3d3ab21bf98c1b92d5aa0a41c67de13e...40bb32b5a47c4aa94434d884ff0fca54337657f1,3,25,24,49,21,2007-07-13 14:13:35,2007-07-13 14:13:35
40bb32b5a47c4aa94434d884ff0fca54337657f1...20193b4d6d82205721420eb5fb18f871b0c76d76,1,1,0,1,1,2007-07-13 14:14:47,2007-07-13 14:14:47
20193b4d6d82205721420eb5fb18f871b0c76d76...50a3cea8b6e74c1af6ebf443231a18cae3b6d797,1,1,1,2,1,2007-07-13 14:33:46,2007-07-13 14:33:46
50a3cea8b6e74c1af6ebf443231a18cae3b6d797...92ee77077300529fded493aa34a64c8516abca18,1,5,4,9,1,2007-07-13 14:40:39,2007-07-13 14:40:39
92ee77077300529fded493aa34a64c8516abca18...193e6db4577adef8ac5654c73a633b69ed823f1b,1,2,5,7,1,2007-07-13 20:36:01,2007-07-13 20:36:01
193e6db4577adef8ac5654c73a633b69ed823f1b...9fa91e0ab3656055d882a1a063abfec6fdd85eae,1,7,0,7,1,2007-07-13 21:20:07,2007-07-13 21:20:07
9fa91e0ab3656055d882a1a063abfec6fdd85eae...d48a39650f006b9cac4fc0802462780c8f10667e,1,13,0,13,1,2007-07-14 05:27:22,2007-07-14 05:27:22
d48a39650f006b9cac4fc0802462780c8f10667e...501448e3f2d9f66a559e5c64fb0d325c95cff82e,2,0,2,2,2,2007-07-14 12:48:24,2007-07-14 12:48:24
501448e3f2d9f66a559e5c64fb0d325c95cff82e...f2a45f9b3883f974d2b48eb05612ff4e9b9b2946,1,4,2,6,2,2007-07-14 13:14:28,2007-07-14 13:14:28
f2a45f9b3883f974d2b48eb05612ff4e9b9b2946...b8eee39e7873c888f0335bf0af6c4011550499a8,1,2,2,4,2,2007-07-14 13:39:41,2007-07-14 13:39:41
b8eee39e7873c888f0335bf0af6c4011550499a8...a9a04ca8f67811f3e59b9ae17ae9d639311bf6e9,1,3,2,5,3,2007-07-14 14:47:14,2007-07-14 14:47:14
a9a04ca8f67811f3e59b9ae17ae9d639311bf6e9...f9d27b5d0be082d5a67404512067858530ec9e80,1,1,2,3,2,2007-07-14 14:50:35,2007-07-14 14:50:35
f9d27b5d0be082d5a67404512067858530ec9e80...0f869d1124064308ae9a122ace6f3dcf0c08d3e0,1,12,9,21,3,2007-07-14 16:58:54,2007-07-14 16:58:54
0f869d1124064308ae9a122ace6f3dcf0c08d3e0...55de110627727631783a63bb9702bc0c14ccdf9b,1,1,1,2,1,2007-07-14 17:04:30,2007-07-14 17:04:30
55de110627727631783a63bb9702bc0c14ccdf9b...eff675b91eac5cf1fbfc730184bb582ce8175693,1,63,14,77,7,2007-07-15 04:41:59,2007-07-15 04:41:59
eff675b91eac5cf1fbfc730184bb582ce8175693...b68f188628dd7e54706cd98d4aa0a36a12adfafa,4,117,1,118,3,2007-07-15 05:03:28,2007-07-15 05:03:28
b68f188628dd7e54706cd98d4aa0a36a12adfafa...208352e5d753ebc11c407a22dd0629f8f9b61592,1,1,1,2,1,2007-07-15 05:11:06,2007-07-15 05:11:06
208352e5d753ebc11c407a22dd0629f8f9b61592...ae7f04caab1b4f2a2b509b036499e4e042caaac6,3,21,10,31,9,2007-07-15 06:24:54,2007-07-15 06:24:54
ae7f04caab1b4f2a2b509b036499e4e042caaac6...a41c03345e0ff0975b4e12e3ff41eef280a4fa1e,1,3,2,5,2,2007-07-15 06:29:45,2007-07-15 06:29:45
a41c03345e0ff0975b4e12e3ff41eef280a4fa1e...7eade9a5bbafa890074747de0feeacc6c61c7aaa,4,1808,1809,3617,554,2007-07-15 09:39:13,2007-07-15 09:39:13
7eade9a5bbafa890074747de0feeacc6c61c7aaa...1a3ff79f80136ab11b310ad86640b7b0c9d74611,4,2172,2113,4285,629,2007-07-15 09:46:42,2007-07-15 09:46:42
1a3ff79f80136ab11b310ad86640b7b0c9d74611...5fbc5890149167d0e3bc925f6c33126bab3fc69b,4,15,15,30,14,2007-07-15 10:08:05,2007-07-15 10:08:05
5fbc5890149167d0e3bc925f6c33126bab3fc69b...0dbc0ab338e10f1aa594eb962fb30e2047559536,1,8,3,11,3,2007-07-15 10:10:44,2007-07-15 10:10:44
0dbc0ab338e10f1aa594eb962fb30e2047559536...2a500b3551a5ab565592f575d27d946c837d2d6b,1,24,20,44,8,2007-07-15 19:34:21,2007-07-15 19:34:21
2a500b3551a5ab565592f575d27d946c837d2d6b...0d9f21bb75d6df732d1022ac8928cc181419d202,1,72,22,94,10,2007-07-15 21:16:32,2007-07-15 21:16:32
0d9f21bb75d6df732d1022ac8928cc181419d202...d5129eee59571fd4dc52f3d77b1a73dc8436ba9a,1,1,0,1,1,2007-07-16 03:48:03,2007-07-16 03:48:03
d5129eee59571fd4dc52f3d77b1a73dc8436ba9a...5dd9a2ab38a79457ba9c21f07ca855727f9568a3,5,28,15,43,14,2007-07-16 03:50:22,2007-07-16 03:50:22
5dd9a2ab38a79457ba9c21f07ca855727f9568a3...41a6e41777a9d02cfcbfed534ebf4199158c7030,1,2,0,2,1,2007-07-16 04:45:45,2007-07-16 04:45:45
41a6e41777a9d02cfcbfed534ebf4199158c7030...58096c4bcc25ed4047866dbb333f4ae9f819944d,2,2068,1310,3378,372,2007-07-16 04:47:52,2007-07-16 04:47:52
58096c4bcc25ed4047866dbb333f4ae9f819944d...29891add3d23892f7dd1221d47f15d7455b5926b,2,3,0,3,3,2007-07-16 04:54:49,2007-07-16 04:54:49
29891add3d23892f7dd1221d47f15d7455b5926b...f6ced03321f7b6c72bbca6d317639ef954bf8283,1,0,1,1,1,2007-07-16 05:00:18,2007-07-16 05:00:18
f6ced03321f7b6c72bbca6d317639ef954bf8283...7aac81d28038dce5f1a250caa63cf5a86692be1c,1,22,21,43,12,2007-07-16 05:28:13,2007-07-16 05:28:13
7aac81d28038dce5f1a250caa63cf5a86692be1c...2679bc0304574edf5ded0c72889fb2e4d8cac911,3,36,19,55,15,2007-07-16 09:36:10,2007-07-16 09:36:10
2679bc0304574edf5ded0c72889fb2e4d8cac911...9a1c21809ed48b0d06c1e2395bf6a7c7b900f96a,1,9,5,14,3,2007-07-16 13:47:43,2007-07-16 13:47:43
9a1c21809ed48b0d06c1e2395bf6a7c7b900f96a...62f207caef9590b7a0e3268246307caeecd84d57,1,1,1,2,1,2007-07-16 22:29:09,2007-07-16 22:29:09
62f207caef9590b7a0e3268246307caeecd84d57...c92ce31d6042eee7372d38f09042d0667842b83d,1,1,1,2,1,2007-07-17 04:22:11,2007-07-17 04:22:11
c92ce31d6042eee7372d38f09042d0667842b83d...23404cdec46a4898bb287c92c4903f54ab8bfcdd,1,2,1,3,2,2007-07-17 10:25:43,2007-07-17 10:25:43
23404cdec46a4898bb287c92c4903f54ab8bfcdd...9ff1060391201b6b8e9452ad98b1a66ac21527c7,3,704,680,1384,481,2007-07-19 09:23:45,2007-07-19 09:23:45
9ff1060391201b6b8e9452ad98b1a66ac21527c7...f5ef3bec6868cc4e04f2a7816821a44ec104c923,5,171,0,171,4,2007-07-19 09:24:36,2007-07-19 09:24:36
f5ef3bec6868cc4e04f2a7816821a44ec104c923...ac2b9f2a3fd2a6c8dd3f87a6302b7d3f2ef73a0a,10,137,44,181,31,2007-07-20 06:28:56,2007-07-20 06:28:56
ac2b9f2a3fd2a6c8dd3f87a6302b7d3f2ef73a0a...0827f4ac7e7e5b310e0aa7accdbb7dfef9a37132,1,28,25,53,1,2007-07-20 06:34:26,2007-07-20 06:34:26
0827f4ac7e7e5b310e0aa7accdbb7dfef9a37132...3fef1f4c8d779ab40a13f13a1829a98e48e58c9c,3,30,2,32,6,2007-07-20 12:07:58,2007-07-20 12:07:58
3fef1f4c8d779ab40a13f13a1829a98e48e58c9c...73bec372ee88cf89dce0de3d667b1f7d8291e5fa,1,1,1,2,1,2007-07-20 12:15:02,2007-07-20 12:15:02
73bec372ee88cf89dce0de3d667b1f7d8291e5fa...9922a04bb6a9587aee197c6d0e87de9e5bd7e240,3,57,21,78,5,2007-07-20 13:57:49,2007-07-20 13:57:49
9922a04bb6a9587aee197c6d0e87de9e5bd7e240...bdc5a3eb51f42946ef6d56333edaff16caeecb34,1,2,0,2,1,2007-07-20 14:07:54,2007-07-20 14:07:54
bdc5a3eb51f42946ef6d56333edaff16caeecb34...56394220d5d4ae443dfc0fb55f677099696a55bf,4,44,9,53,7,2007-07-20 14:32:20,2007-07-20 14:32:20
56394220d5d4ae443dfc0fb55f677099696a55bf...f7ef0a92da23168f8ece5339bd32f67b7ee5ff1a,1,1,1,2,1,2007-07-20 14:42:57,2007-07-20 14:42:57
f7ef0a92da23168f8ece5339bd32f67b7ee5ff1a...07dd6b2895c413c24936895da586dcb88bbc0f57,1,1,1,2,1,2007-07-20 15:40:54,2007-07-20 15:40:54
07dd6b2895c413c24936895da586dcb88bbc0f57...910bbe8f1fab2d8c9be22d056ec811d2a1085a91,1,38,0,38,1,2007-07-20 21:24:30,2007-07-20 21:24:30
910bbe8f1fab2d8c9be22d056ec811d2a1085a91...7cc2bf2f030940f0acd7b6ad0c56f2d60122fb34,2,3,2,5,2,2007-07-21 03:30:38,2007-07-21 03:30:38
7cc2bf2f030940f0acd7b6ad0c56f2d60122fb34...ef080e44d054fbabfe47ce51edd1fed78c9e60f4,1,1,1,2,1,2007-07-21 04:36:28,2007-07-21 04:36:28
ef080e44d054fbabfe47ce51edd1fed78c9e60f4...6a4f164a6fde5665dcc7377bbda4faef89dee614,1,12,1,13,2,2007-07-21 05:15:19,2007-07-21 05:15:19
6a4f164a6fde5665dcc7377bbda4faef89dee614...f2303b6f7aa744f8edf4ecf28b7c88db222386f8,4,19,5,24,5,2007-07-21 05:17:20,2007-07-21 05:17:20
f2303b6f7aa744f8edf4ecf28b7c88db222386f8...bac6a2f88ecb27ba8a02d81b0b64cbd2f19445d4,1,0,4,4,1,2007-07-22 02:18:36,2007-07-22 02:18:36
bac6a2f88ecb27ba8a02d81b0b64cbd2f19445d4...d95e91b380a72cc2011ee48c7875517984e723c2,1,26,3,29,4,2007-07-22 03:09:24,2007-07-22 03:09:24
d95e91b380a72cc2011ee48c7875517984e723c2...63cc023eea4faa0af570b548375666e48af15904,1,2,2,4,2,2007-07-22 03:12:50,2007-07-22 03:12:50
63cc023eea4faa0af570b548375666e48af15904...cae92ae615b8622c25266463e392ef913066ea21,4,60,23,83,18,2007-07-22 03:41:11,2007-07-22 03:41:11
cae92ae615b8622c25266463e392ef913066ea21...7a16a1d81af3922f7f2166b900da20e3df5bed02,1,1,1,2,1,2007-07-22 03:45:03,2007-07-22 03:45:03
7a16a1d81af3922f7f2166b900da20e3df5bed02...304381616f89745c2b52ba793e5b23184c4788bb,4,93,9,102,12,2007-07-23 04:45:01,2007-07-23 04:45:01
304381616f89745c2b52ba793e5b23184c4788bb...1b7fe09660e640bd3cdbf55d340b702d951dd22e,4,24,11,35,13,2007-07-23 12:14:32,2007-07-23 12:14:32
1b7fe09660e640bd3cdbf55d340b702d951dd22e...3b78695a641d8a8bd47f8432219ff3662ca224f1,1,9,4,13,4,2007-07-23 13:52:59,2007-07-23 13:52:59
3b78695a641d8a8bd47f8432219ff3662ca224f1...da6b3865ae096dadedc4827bbc316fe76e519802,1,6,6,12,6,2007-07-25 03:12:31,2007-07-25 03:12:31
da6b3865ae096dadedc4827bbc316fe76e519802...6b7c33286a42d3f5432932240074359ef3108f98,1,3,3,6,1,2007-07-25 03:15:05,2007-07-25 03:15:05
6b7c33286a42d3f5432932240074359ef3108f98...b263e1704ca813f38f36ce973a7c0b26e41a18b6,1,2,2,4,1,2007-07-25 03:18:17,2007-07-25 03:18:17
b263e1704ca813f38f36ce973a7c0b26e41a18b6...29078eaeca628810d11ae4c5959ab4c5762ef49d,9,14,12,26,13,2007-07-26 05:01:53,2007-07-26 05:01:53
29078eaeca628810d11ae4c5959ab4c5762ef49d...812583ce3b49ec871ded8d281a80ac6809f8df44,1,16,0,16,1,2007-07-26 17:16:34,2007-07-26 17:16:34
812583ce3b49ec871ded8d281a80ac6809f8df44...386a4c610c3db14b713d1840baae54372cf0c63e,1,4,0,4,1,2007-07-26 22:59:34,2007-07-26 22:59:34
386a4c610c3db14b713d1840baae54372cf0c63e...8831f3ee2c7541de2263d90350d1642ef2c5ede4,1,16,8,24,3,2007-07-27 21:53:02,2007-07-27 21:53:02
8831f3ee2c7541de2263d90350d1642ef2c5ede4...5b8d2c9f0df1dbfadafeea6420fc5fc175e00376,1,17,9,26,6,2007-07-27 22:07:42,2007-07-27 22:07:42
5b8d2c9f0df1dbfadafeea6420fc5fc175e00376...650cea9170313d9a2197d4050f6dcabaaeaa3b20,4,119,57,176,23,2007-07-28 04:02:52,2007-07-28 04:02:52
650cea9170313d9a2197d4050f6dcabaaeaa3b20...5b898f3f94398aff93b698ecb90213c93269978f,1,5,2,7,5,2007-07-28 07:27:53,2007-07-28 07:27:53
5b898f3f94398aff93b698ecb90213c93269978f...fd2b99b5f122911b895987329507ee419a159a2c,3,51,6,57,8,2007-07-28 18:30:40,2007-07-28 18:30:40
fd2b99b5f122911b895987329507ee419a159a2c...d76e5320772686dfc120fe0e32cc816504bf7fb5,1,13,12,25,6,2007-07-29 18:21:16,2007-07-29 18:21:16
d76e5320772686dfc120fe0e32cc816504bf7fb5...f27774ee0ab4b2537909d642c23ea6ae6ea8d166,4,20,1,21,2,2007-07-30 17:25:35,2007-07-30 17:25:35
f27774ee0ab4b2537909d642c23ea6ae6ea8d166...cdbd5751d3c9579bac7054b45edae11de27171ff,3,52,20,72,12,2007-08-01 05:41:32,2007-08-01 05:41:32
cdbd5751d3c9579bac7054b45edae11de27171ff...9a54c8f2d4c89161a9ba90b42f885bc733f0cce6,1,1,1,2,1,2007-08-01 05:52:18,2007-08-01 05:52:18
9a54c8f2d4c89161a9ba90b42f885bc733f0cce6...b54de860108c89ae9b3428b696d377b202f091d6,7,11,7,18,9,2007-08-04 03:19:14,2007-08-04 03:19:14
b54de860108c89ae9b3428b696d377b202f091d6...8a4a3f77072361f75cceee07a80a7a20beefeba4,1,1,1,2,1,2007-08-04 03:36:58,2007-08-04 03:36:58
8a4a3f77072361f75cceee07a80a7a20beefeba4...ac027df2539858b8dfcb7fe6b3da19b2573f147c,4,4,4,8,4,2007-08-04 03:39:24,2007-08-04 03:39:24
ac027df2539858b8dfcb7fe6b3da19b2573f147c...919205ef856e6226ab210405c48a26a516a6fb50,1,1,1,2,1,2007-08-04 14:41:49,2007-08-04 14:41:49
919205ef856e6226ab210405c48a26a516a6fb50...d018b92bbecbed5b8f44e9b2ee3fb15f500e2555,1,1,1,2,1,2007-08-04 14:52:13,2007-08-04 14:52:13
d018b92bbecbed5b8f44e9b2ee3fb15f500e2555...eba5703fee221bc2ace9fcd2b6873d7e1cdf6753,2,4,3,7,2,2007-08-05 04:39:52,2007-08-05 04:39:52
eba5703fee221bc2ace9fcd2b6873d7e1cdf6753...973f44aa4c953baf6bf56b8e5c474f5306452809,2,6,6,12,6,2007-08-05 04:42:26,2007-08-05 04:42:26
973f44aa4c953baf6bf56b8e5c474f5306452809...212ee65be782240554749f25bbd3772240d56fff,88,647,407,1054,299,2007-08-05 05:14:46,2007-08-05 05:14:46
212ee65be782240554749f25bbd3772240d56fff...f96e933534501fd98f84cc53bcac62beaa72dbf2,3,64,6,70,4,2007-08-05 07:39:36,2007-08-05 07:39:36
f96e933534501fd98f84cc53bcac62beaa72dbf2...1474a5fd2c11a70890340e193b8801951f804ba5,1,3,0,3,2,2007-08-06 04:36:43,2007-08-06 04:36:43
1474a5fd2c11a70890340e193b8801951f804ba5...89d4a5659401959d976baa807c8a1fc7fa92851f,1,17,9,26,5,2007-08-06 04:52:14,2007-08-06 04:52:14
89d4a5659401959d976baa807c8a1fc7fa92851f...e301d8992cb1897cc93d84fc5d78a4c0769f5a8c,2,8,2,10,5,2007-08-06 05:04:27,2007-08-06 05:04:27
e301d8992cb1897cc93d84fc5d78a4c0769f5a8c...56a75a2a4e5b473a68536d2b669b428c4f90f662,1,0,1,1,1,2007-08-06 05:06:15,2007-08-06 05:06:15
56a75a2a4e5b473a68536d2b669b428c4f90f662...3c733bb6900595abaa71f69d3315ebc80e1105e9,1,1,1,2,1,2007-08-06 05:07:38,2007-08-06 05:07:38
3c733bb6900595abaa71f69d3315ebc80e1105e9...89977a6e16e89d25097dc82d6f3ae9c51a0470af,1,1,1,2,1,2007-08-06 05:13:06,2007-08-06 05:13:06
89977a6e16e89d25097dc82d6f3ae9c51a0470af...9a090b2c1f953d9f8ede4bd71747204cf153098e,1,4,4,8,4,2007-08-06 05:16:35,2007-08-06 05:16:35
9a090b2c1f953d9f8ede4bd71747204cf153098e...b304ebb906af5c51f9bb832244e8b5ffddcd2966,1,1,1,2,1,2007-08-06 05:27:58,2007-08-06 05:27:58
b304ebb906af5c51f9bb832244e8b5ffddcd2966...3517550dacaed6933c390d2d1f7e78c67c04aec4,1,22,9,31,5,2007-08-06 05:28:45,2007-08-06 05:28:45
3517550dacaed6933c390d2d1f7e78c67c04aec4...d4623df4638823d4454a1fea4702801fbfb36df6,1,6,0,6,1,2007-08-06 05:33:18,2007-08-06 05:33:18
d4623df4638823d4454a1fea4702801fbfb36df6...3e2fa60df2d46fc9216f3456e59ed5a4905ae072,1,1,1,2,1,2007-08-06 05:34:45,2007-08-06 05:34:45
3e2fa60df2d46fc9216f3456e59ed5a4905ae072...e471f42ba10120b898a7aa589c4216f9c4230401,1,0,3,3,1,2007-08-06 05:37:17,2007-08-06 05:37:17
e471f42ba10120b898a7aa589c4216f9c4230401...fbd1a6277e9cc04a953a242c45d216685afbf873,9,266,27,293,38,2007-08-06 13:58:56,2007-08-06 13:58:56
fbd1a6277e9cc04a953a242c45d216685afbf873...16cf24393f36e188abd62f242ab88ae23536f0d1,1,6,0,6,3,2007-08-06 14:17:10,2007-08-06 14:17:10
16cf24393f36e188abd62f242ab88ae23536f0d1...3ed49976111ce87b7d0a5a2890093659469940a0,1,1,1,2,1,2007-08-06 20:27:04,2007-08-06 20:27:04
3ed49976111ce87b7d0a5a2890093659469940a0...404bf3b1886aab17dc5f982ad9d093bcd5e13576,1,3,3,6,2,2007-08-07 02:18:36,2007-08-07 02:18:36
404bf3b1886aab17dc5f982ad9d093bcd5e13576...f1edb8c2b304aad9e31f1488a97a28ba56b1a709,6,27,29,56,20,2007-08-07 02:33:11,2007-08-07 02:33:11
f1edb8c2b304aad9e31f1488a97a28ba56b1a709...a49fd110552a2b7b2af0eb9f33ac9c2adf036e75,1,1,1,2,1,2007-08-07 11:20:15,2007-08-07 11:20:15
a49fd110552a2b7b2af0eb9f33ac9c2adf036e75...9170744304d1306dac6026b41c49ff3bfd23abc2,0,0,0,0,0,2007-08-07 12:45:45,2007-08-07 12:45:45
9170744304d1306dac6026b41c49ff3bfd23abc2...049212e95079d612b37b6fb9f3fba8616f5f7a7b,2,14,1,15,2,2007-08-08 21:09:55,2007-08-08 21:09:55
049212e95079d612b37b6fb9f3fba8616f5f7a7b...31ba14761e6b06d9ef3a73ffee1f7ef0e4325db4,2,7,1,8,3,2007-08-11 05:23:19,2007-08-11 05:23:19
31ba14761e6b06d9ef3a73ffee1f7ef0e4325db4...97e22f3d1861f02acafba6170316a40f4831c8a5,2,1,1,2,1,2007-08-11 05:46:17,2007-08-11 05:46:17
97e22f3d1861f02acafba6170316a40f4831c8a5...a819988ec150955b9cbd0546b61500597b2699d4,2,227,228,455,126,2007-08-11 05:47:13,2007-08-11 05:47:13
a819988ec150955b9cbd0546b61500597b2699d4...200686ba4a6b8f4a8f1005572316a746265edde8,3,3,2,5,3,2007-08-11 05:47:44,2007-08-11 05:47:44
200686ba4a6b8f4a8f1005572316a746265edde8...dd56de08515262e316e2da5be998f4516e78d999,2,2,2,4,2,2007-08-11 05:48:16,2007-08-11 05:48:16
dd56de08515262e316e2da5be998f4516e78d999...e3f569989ab600e0a5d3ffb903c1f2bddb1695ed,2,1909,1554,3463,429,2007-08-11 06:28:34,2007-08-11 06:28:34
e3f569989ab600e0a5d3ffb903c1f2bddb1695ed...ea1544e9388a6d569fd76d1e389af0bd02cbe9be,1,1,1,2,1,2007-08-11 06:28:51,2007-08-11 06:28:51
ea1544e9388a6d569fd76d1e389af0bd02cbe9be...1e6ff907d5ae727d98c0a1e9017c1c5185992fe8,2,699,323,1022,289,2007-08-11 06:54:58,2007-08-11 06:54:58
1e6ff907d5ae727d98c0a1e9017c1c5185992fe8...8b128dddd14791b18f37a142e3c428fe08a42908,1,5,4,9,4,2007-08-11 07:01:46,2007-08-11 07:01:46
8b128dddd14791b18f37a142e3c428fe08a42908...6fd2c25addcf49f989ced81060b40533d9f6e9ed,0,0,0,0,0,2007-08-11 07:14:01,2007-08-11 07:14:01
6fd2c25addcf49f989ced81060b40533d9f6e9ed...0afbca9c60206d5005243cb961ff813f2cd6dbf3,2,21,5,26,6,2007-08-11 09:37:42,2007-08-11 09:37:42
0afbca9c60206d5005243cb961ff813f2cd6dbf3...df1f76ac02389434530b9bb5c4ced20999e23735,1,8,0,8,1,2007-08-11 09:47:38,2007-08-11 09:47:38
df1f76ac02389434530b9bb5c4ced20999e23735...9864c9d8bf4db3f92a1cddf1ea598bb972948fc1,1,2,0,2,1,2007-08-11 09:47:52,2007-08-11 09:47:52
9864c9d8bf4db3f92a1cddf1ea598bb972948fc1...9309a8d6c3d11133270a891e799b3990e4fa5152,4,135,0,135,4,2007-08-11 10:04:19,2007-08-11 10:04:19
9309a8d6c3d11133270a891e799b3990e4fa5152...9d7dc0c4bfdc7f1638acd68744a2883dd3d3d73d,4,12,5,17,6,2007-08-11 10:50:39,2007-08-11 10:50:39
9d7dc0c4bfdc7f1638acd68744a2883dd3d3d73d...537b16ca97fd3a433a3ce514d8a5659688431cd4,2,3,2,5,3,2007-08-11 10:51:02,2007-08-11 10:51:02
537b16ca97fd3a433a3ce514d8a5659688431cd4...aca2761faf6c821ade5584ac165f846fb84e0e32,1,0,2,2,1,2007-08-11 11:05:59,2007-08-11 11:05:59
aca2761faf6c821ade5584ac165f846fb84e0e32...1d4a0054e3f425259448bd23e62d2b8ca7d4b66b,1,3,3,6,3,2007-08-11 11:06:14,2007-08-11 11:06:14
1d4a0054e3f425259448bd23e62d2b8ca7d4b66b...01906de5c2877186187cce102429803764892a40,1,1,1,2,1,2007-08-11 11:11:16,2007-08-11 11:11:16
01906de5c2877186187cce102429803764892a40...35ce8a2a8af101329a9ea7f0b20fdca21cf20a87,1,5,0,5,2,2007-08-11 12:09:52,2007-08-11 12:09:52
35ce8a2a8af101329a9ea7f0b20fdca21cf20a87...1777e74d2a53f2b36a3106563c629f85133fbace,1,2,1,3,1,2007-08-11 12:10:07,2007-08-11 12:10:07
1777e74d2a53f2b36a3106563c629f85133fbace...20e3ae5222405d0ec72704a38e80235f725728ee,2,22,0,22,3,2007-08-11 12:10:23,2007-08-11 12:10:23
20e3ae5222405d0ec72704a38e80235f725728ee...e5fb29140b8bc27909552e83b6b7ef3b36c80f12,4,3,4,7,3,2007-08-12 01:19:54,2007-08-12 01:19:54
e5fb29140b8bc27909552e83b6b7ef3b36c80f12...3c64870a2cb66d4dd4186b359aa28e44711a6af3,4,2211,1609,3820,556,2007-08-12 01:25:18,2007-08-12 01:25:18
3c64870a2cb66d4dd4186b359aa28e44711a6af3...9236d16b8013e3c71f57d43136be3b9640c56ee3,1,1,1,2,1,2007-08-12 02:14:52,2007-08-12 02:14:52
9236d16b8013e3c71f57d43136be3b9640c56ee3...36be3febef28ac45404b59dd59aa6d9f0185acae,2,24,1,25,2,2007-08-12 02:15:35,2007-08-12 02:15:35
36be3febef28ac45404b59dd59aa6d9f0185acae...d1bef5990502030d44280e26c0082b561efd782a,1,2,1,3,1,2007-08-12 03:01:37,2007-08-12 03:01:37
d1bef5990502030d44280e26c0082b561efd782a...babf25c11cc1183899c9c86113483d2fdc76f854,1,1,1,2,1,2007-08-12 03:07:34,2007-08-12 03:07:34
babf25c11cc1183899c9c86113483d2fdc76f854...285cc6f101d13ccbf9e6d268402b76e840dfccfc,1,17,0,17,4,2007-08-12 03:23:53,2007-08-12 03:23:53
285cc6f101d13ccbf9e6d268402b76e840dfccfc...9ee6326cb6a47dcc9b4a318da38a214e2c687bae,1,1,1,2,1,2007-08-12 03:26:35,2007-08-12 03:26:35
9ee6326cb6a47dcc9b4a318da38a214e2c687bae...f128c7bbb787be670a1a827c5bf810d0ea78ce20,1,1,1,2,1,2007-08-12 03:27:57,2007-08-12 03:27:57
f128c7bbb787be670a1a827c5bf810d0ea78ce20...cc42b2fde8e982b7157ebdf8843677c7d9d6206e,1,1,1,2,1,2007-08-12 03:29:07,2007-08-12 03:29:07
cc42b2fde8e982b7157ebdf8843677c7d9d6206e...dd0f5d92844e56d1ee39775be75de44c195d3e8c,1,1,0,1,1,2007-08-12 03:59:09,2007-08-12 03:59:09
dd0f5d92844e56d1ee39775be75de44c195d3e8c...3d012a18cec7edeb19f7fb579dc47dfae00a99bb,1,151,1,152,2,2007-08-12 06:25:05,2007-08-12 06:25:05
3d012a18cec7edeb19f7fb579dc47dfae00a99bb...6d31e431c3bb09cf386c0fbef169a5307e689775,2,9,1,10,4,2007-08-12 10:24:05,2007-08-12 10:24:05
6d31e431c3bb09cf386c0fbef169a5307e689775...a564adb8e1eaa90c52b683ae64d0570291257c2b,1,6,0,6,1,2007-08-12 10:24:21,2007-08-12 10:24:21
a564adb8e1eaa90c52b683ae64d0570291257c2b...534671a46fd0b2c0340e592f254b8772993fff19,1,4,2,6,2,2007-08-12 10:29:59,2007-08-12 10:29:59
534671a46fd0b2c0340e592f254b8772993fff19...84bc65e13757d8cae2d4f92133d09c10fa4a249c,1,3,3,6,2,2007-08-12 10:37:56,2007-08-12 10:37:56
84bc65e13757d8cae2d4f92133d09c10fa4a249c...9aa81c54014701e496807208c3ee041203c326d1,1,7,0,7,1,2007-08-12 10:47:10,2007-08-12 10:47:10
9aa81c54014701e496807208c3ee041203c326d1...78dfdd5648d0fc6060e03a2edbe738779d132684,1,3,1,4,1,2007-08-12 12:01:31,2007-08-12 12:01:31
78dfdd5648d0fc6060e03a2edbe738779d132684...3757f30c99838783402b54d1cfd41958d1493aad,4,26,3,29,6,2007-08-12 12:02:08,2007-08-12 12:02:08
3757f30c99838783402b54d1cfd41958d1493aad...c050b6a25acff020fd60f2f528eb019615e00203,2,11,0,11,2,2007-08-12 12:29:25,2007-08-12 12:29:25
c050b6a25acff020fd60f2f528eb019615e00203...f6e86c42860b8c690ea2d0f43c8827845ba65dfd,1,23,23,46,1,2007-08-12 12:49:01,2007-08-12 12:49:01
f6e86c42860b8c690ea2d0f43c8827845ba65dfd...56e28b4e8fd923b8e84ceaaf8d0560175ec97c46,5,10,9,19,10,2007-08-12 12:59:41,2007-08-12 12:59:41
56e28b4e8fd923b8e84ceaaf8d0560175ec97c46...0e7299e10ad527824953be217803f61526919d4b,1,2,0,2,2,2007-08-12 13:10:45,2007-08-12 13:10:45
0e7299e10ad527824953be217803f61526919d4b...d3b9a99d883eaca33d0718a35da233e559c3a501,0,0,0,0,0,2007-08-13 00:32:25,2007-08-13 00:32:25
d3b9a99d883eaca33d0718a35da233e559c3a501...478926ffdee790bc609418746b8cd72321795eb2,6,3402,0,3402,4,2007-08-13 01:17:19,2007-08-13 01:17:19
478926ffdee790bc609418746b8cd72321795eb2...947ca5123e2e88a2226ed3b39711706d5d609e32,1,2,2,4,2,2007-08-13 21:42:37,2007-08-13 21:42:37
947ca5123e2e88a2226ed3b39711706d5d609e32...08c47803bba2e452499d265ceb08ef3904741323,1,1,1,2,1,2007-08-14 03:26:42,2007-08-14 03:26:42
08c47803bba2e452499d265ceb08ef3904741323...9b99a60cfa6a431a44cfb87c6b6417b3e1578511,1,4,4,8,3,2007-08-14 21:44:39,2007-08-14 21:44:39
9b99a60cfa6a431a44cfb87c6b6417b3e1578511...6aae9b2aa413b16e77e864ac69aa616aa7e2d969,2,12,3,15,4,2007-08-14 22:08:11,2007-08-14 22:08:11
6aae9b2aa413b16e77e864ac69aa616aa7e2d969...b38375ee4c4f2910e4885c6e3ea6b2a64704715b,1,1,1,2,1,2007-08-14 22:26:34,2007-08-14 22:26:34
b38375ee4c4f2910e4885c6e3ea6b2a64704715b...69cf1bb4606047efcc03699d4a8a07bb5298b672,1,0,1,1,1,2007-08-14 22:30:42,2007-08-14 22:30:42
69cf1bb4606047efcc03699d4a8a07bb5298b672...543ab12c111d2ba9dd5d319a464a8f7b062c9b33,1,2,2,4,2,2007-08-15 00:19:53,2007-08-15 00:19:53
543ab12c111d2ba9dd5d319a464a8f7b062c9b33...1ba9012d873ad2372ee39cf1afe64f366ecefb65,1,659,409,1068,116,2007-08-15 05:24:18,2007-08-15 05:24:18
1ba9012d873ad2372ee39cf1afe64f366ecefb65...3bfda4fa621a771d0d6c16e5db605226fa2a546a,1,50,50,100,15,2007-08-15 05:28:29,2007-08-15 05:28:29
3bfda4fa621a771d0d6c16e5db605226fa2a546a...4f62b0a19381f80944f5358ccfb4f54a13c5bb69,1,2,2,4,2,2007-08-15 05:30:23,2007-08-15 05:30:23
4f62b0a19381f80944f5358ccfb4f54a13c5bb69...ba29b7a97b5ebb6e7e5d78829d9f5b315fb03208,1,1,0,1,1,2007-08-15 11:25:22,2007-08-15 11:25:22
ba29b7a97b5ebb6e7e5d78829d9f5b315fb03208...4bf3680dfadec3de5c3d4c4381a7c2960ea96afe,1,2,0,2,1,2007-08-15 11:29:58,2007-08-15 11:29:58
4bf3680dfadec3de5c3d4c4381a7c2960ea96afe...f0ca553a68c7956805406c4432fe398763b564f9,2,2021,2009,4030,523,2007-08-15 11:48:56,2007-08-15 11:48:56
f0ca553a68c7956805406c4432fe398763b564f9...ce151bb8e413a344627e29d3c1599ff06da672f2,3,4,2,6,4,2007-08-15 12:09:32,2007-08-15 12:09:32
ce151bb8e413a344627e29d3c1599ff06da672f2...3835d8afec026e5dc3ad16c8b8e44071cb7ddc04,1,24,0,24,1,2007-08-15 12:25:21,2007-08-15 12:25:21
3835d8afec026e5dc3ad16c8b8e44071cb7ddc04...7f06e44f9959fd8c0db58162d4bd5feb383db8f1,1,1,1,2,1,2007-08-15 12:29:15,2007-08-15 12:29:15
7f06e44f9959fd8c0db58162d4bd5feb383db8f1...01adbb55e6698b512ff202bc5fc81f9565e4003b,39,1972,1771,3743,72,2007-08-16 06:06:55,2007-08-16 06:06:55
01adbb55e6698b512ff202bc5fc81f9565e4003b...f4d4936abf61200d4f1a7164fce3466a52547c6d,1,1,0,1,1,2007-08-16 10:54:28,2007-08-16 10:54:28
f4d4936abf61200d4f1a7164fce3466a52547c6d...d5e695cd89a01420f210382fbfdb4f7978d37e36,1,1,0,1,1,2007-08-16 11:06:49,2007-08-16 11:06:49
d5e695cd89a01420f210382fbfdb4f7978d37e36...296d8d4553c389fb32d1ee594fb835b123645794,1,2,2,4,1,2007-08-16 13:41:42,2007-08-16 13:41:42
296d8d4553c389fb32d1ee594fb835b123645794...c568792e81c7a09e3160548e7b8dcb89e9a5fa99,1,6,4,10,2,2007-08-16 14:09:41,2007-08-16 14:09:41
c568792e81c7a09e3160548e7b8dcb89e9a5fa99...83f5f700b0a3ac885042a7f1e68f4e7616d1485e,13,119,82,201,44,2007-08-16 14:34:01,2007-08-16 14:34:01
83f5f700b0a3ac885042a7f1e68f4e7616d1485e...dc44e50e5d879e1280cd74c35de9073d9c5502c1,1,1,1,2,1,2007-08-16 15:12:37,2007-08-16 15:12:37
dc44e50e5d879e1280cd74c35de9073d9c5502c1...c5505c4c8ee29f2b8f8fa174bcc9b046f975a3fd,1,1,0,1,1,2007-08-16 15:14:21,2007-08-16 15:14:21
c5505c4c8ee29f2b8f8fa174bcc9b046f975a3fd...3e20e7cc41d6b4028b785fc9e0c93a9319fe546e,1,1,1,2,1,2007-08-16 17:47:30,2007-08-16 17:47:30
3e20e7cc41d6b4028b785fc9e0c93a9319fe546e...e8cae6f96dce803f05a2f696ab968698f1389712,3,5,9,14,8,2007-08-16 19:14:09,2007-08-16 19:14:09
e8cae6f96dce803f05a2f696ab968698f1389712...b6c3ff366ef1f59f196de48e20c3f8791da4ef91,1,1,1,2,1,2007-08-16 19:27:58,2007-08-16 19:27:58
b6c3ff366ef1f59f196de48e20c3f8791da4ef91...89ebb6177df63d17de069dfc9304e83d9b829848,1,1,1,2,1,2007-08-16 19:34:25,2007-08-16 19:34:25
89ebb6177df63d17de069dfc9304e83d9b829848...49c438fd219c8bc1ee1a32b98ef3777abeb289f6,2,9,0,9,3,2007-08-16 22:46:00,2007-08-16 22:46:00
49c438fd219c8bc1ee1a32b98ef3777abeb289f6...a5400cf87321ec482185c11b9625dbc15c3f6f2f,1,3,0,3,2,2007-08-16 22:48:32,2007-08-16 22:48:32
a5400cf87321ec482185c11b9625dbc15c3f6f2f...9c55bbdef7f1717aa17f7ca17cb2396522426310,2,67,1,68,3,2007-08-16 23:05:00,2007-08-16 23:05:00
9c55bbdef7f1717aa17f7ca17cb2396522426310...0b7f5def7fed7c3579604dfe34027c2927d6eace,2,2,2,4,2,2007-08-17 00:11:56,2007-08-17 00:11:56
0b7f5def7fed7c3579604dfe34027c2927d6eace...fc041a3c1c13bfa9a240cb2785acd25517379c0e,1,6,0,6,3,2007-08-17 12:29:08,2007-08-17 12:29:08
fc041a3c1c13bfa9a240cb2785acd25517379c0e...55c0b35acf6aad2c5287d196bed6eadb0cc50486,1,1,1,2,1,2007-08-17 14:02:40,2007-08-17 14:02:40
55c0b35acf6aad2c5287d196bed6eadb0cc50486...8dff1cd91dcef967c2bbcf23b4a32458c0e0f83f,4,42,3,45,7,2007-08-17 14:20:25,2007-08-17 14:20:25
8dff1cd91dcef967c2bbcf23b4a32458c0e0f83f...103fe15efce26cf42437cbf4d6115f630da1c24b,1,1,0,1,1,2007-08-17 14:42:25,2007-08-17 14:42:25
103fe15efce26cf42437cbf4d6115f630da1c24b...3219a60167b6d5670a6df0d2f5b9944951245322,2,184,108,292,7,2007-08-17 17:23:15,2007-08-17 17:23:15
3219a60167b6d5670a6df0d2f5b9944951245322...a89e401648512f960d71505a5aa9a32a088eb0ef,1,2,2,4,2,2007-08-17 22:56:36,2007-08-17 22:56:36
a89e401648512f960d71505a5aa9a32a088eb0ef...7969c1ba05ef342725083d060b038a8a874e69e6,2,7,7,14,7,2007-08-18 04:16:04,2007-08-18 04:16:04
7969c1ba05ef342725083d060b038a8a874e69e6...6ad0a0188741f80c6dafef3aec62c3b2c46b7812,1,45,7,52,5,2007-08-18 04:51:51,2007-08-18 04:51:51
6ad0a0188741f80c6dafef3aec62c3b2c46b7812...7fc5a3b2d256d6e87fb7fcfeba5a885aa1a45e67,1,1,1,2,1,2007-08-18 04:54:08,2007-08-18 04:54:08
7fc5a3b2d256d6e87fb7fcfeba5a885aa1a45e67...d743ccbc4b2e27a52cffa4a6c0e4b30a1eeb1651,1,29,0,29,1,2007-08-18 05:10:31,2007-08-18 05:10:31
d743ccbc4b2e27a52cffa4a6c0e4b30a1eeb1651...3b9b87792ab470041c6a2ae5094c8ae236e5d167,4,9,9,18,7,2007-08-18 05:43:38,2007-08-18 05:43:38
3b9b87792ab470041c6a2ae5094c8ae236e5d167...3b421398d03323704d089bb1904a3630bba3a95d,0,0,0,0,0,2007-08-18 05:56:22,2007-08-18 05:56:22
3b421398d03323704d089bb1904a3630bba3a95d...04c77db2c3c179b4d768c8809540768a81291457,2,7,74,81,6,2007-08-18 05:58:59,2007-08-18 05:58:59
04c77db2c3c179b4d768c8809540768a81291457...24081d995962d14388bf98c1c572603ffd1beeb6,1,2,2,4,2,2007-08-18 06:13:15,2007-08-18 06:13:15
24081d995962d14388bf98c1c572603ffd1beeb6...8b115c7fb84449cbb9ecb4b543ee3f1265290910,1,2,2,4,1,2007-08-18 06:52:05,2007-08-18 06:52:05
8b115c7fb84449cbb9ecb4b543ee3f1265290910...6ed780d7964a526d332bbd5eedd233347231bf59,1,1,1,2,1,2007-08-18 07:40:59,2007-08-18 07:40:59
6ed780d7964a526d332bbd5eedd233347231bf59...390e91db51ee48645a84117bfdcafce2744b5181,1,3,1,4,1,2007-08-19 03:23:31,2007-08-19 03:23:31
390e91db51ee48645a84117bfdcafce2744b5181...a901af5f580617a4ddce66ef249e90749de9acd0,1,1,1,2,1,2007-08-19 05:40:47,2007-08-19 05:40:47
a901af5f580617a4ddce66ef249e90749de9acd0...90c177f18e9fa57b3239cc3c3e4a0fa10f6a087a,6,550,1,551,6,2007-08-19 07:38:39,2007-08-19 07:38:39
90c177f18e9fa57b3239cc3c3e4a0fa10f6a087a...cfd5b184fba4f51a6756fecaf4ec4272f3e23bfc,1,5,0,5,2,2007-08-19 08:50:51,2007-08-19 08:50:51
cfd5b184fba4f51a6756fecaf4ec4272f3e23bfc...79801f504ff3de4cdde3e101f2c5a3a2bfdd6037,1,6,0,6,1,2007-08-19 10:14:58,2007-08-19 10:14:58
79801f504ff3de4cdde3e101f2c5a3a2bfdd6037...0a2337c9e35cfc628cae5feb0e5a43980e19c3fe,1,5,3,8,3,2007-08-19 10:15:11,2007-08-19 10:15:11
0a2337c9e35cfc628cae5feb0e5a43980e19c3fe...5832ca5b7f0a818f597752a587be43045b856068,0,0,0,0,0,2007-08-19 10:16:57,2007-08-19 10:16:57
5832ca5b7f0a818f597752a587be43045b856068...4d42dc3846d134f402c4fb1670bc655ee3737ee2,2,4,3,7,2,2007-08-19 10:24:35,2007-08-19 10:24:35
4d42dc3846d134f402c4fb1670bc655ee3737ee2...e0c1ca7ef0e883eb33c2d1ab34f1ab8ae9e67266,5,163,0,163,5,2007-08-19 11:59:20,2007-08-19 11:59:20
e0c1ca7ef0e883eb33c2d1ab34f1ab8ae9e67266...7e8efcd4d9cd98f0f22be40249959b81c91fed00,3,40,11,51,17,2007-08-19 12:37:00,2007-08-19 12:37:00
7e8efcd4d9cd98f0f22be40249959b81c91fed00...3c89a32e5294eabe0d484c929c2fbc71c7938733,2,7,2,9,4,2007-08-19 14:06:54,2007-08-19 14:06:54
3c89a32e5294eabe0d484c929c2fbc71c7938733...d1892edc9fa9a2b4e443afb0d389c43f2ef65d50,1,8,0,8,2,2007-08-19 15:08:21,2007-08-19 15:08:21
d1892edc9fa9a2b4e443afb0d389c43f2ef65d50...0a49719e7a2c225b122551c74134ae2abf561da7,1,8,5,13,3,2007-08-19 15:08:48,2007-08-19 15:08:48
0a49719e7a2c225b122551c74134ae2abf561da7...8d97f15b966d1679849e8b1de7806b0476362f17,17,48,25,73,29,2007-08-19 17:01:54,2007-08-19 17:01:54
8d97f15b966d1679849e8b1de7806b0476362f17...77a9b0cb1d0da2a4c9cee60c2d305661b49d17da,1,3,3,6,1,2007-08-19 21:02:36,2007-08-19 21:02:36
77a9b0cb1d0da2a4c9cee60c2d305661b49d17da...7c41b19c8a11e4ce46608f25e097118ddb1b3f5e,8,76,221,297,43,2007-08-19 21:30:57,2007-08-19 21:30:57
7c41b19c8a11e4ce46608f25e097118ddb1b3f5e...38b5d7f23d8f7a39646a9b298f10941a70585031,10,85,47,132,34,2007-08-19 22:29:57,2007-08-19 22:29:57
38b5d7f23d8f7a39646a9b298f10941a70585031...aab04a4c2f880645783f05ef9a87eef14966503a,10,30,43,73,17,2007-08-19 22:40:06,2007-08-19 22:40:06
aab04a4c2f880645783f05ef9a87eef14966503a...5f51f0524a8cd941ea757a0339978f3589193cbb,10,67,67,134,19,2007-08-19 22:47:43,2007-08-19 22:47:43
5f51f0524a8cd941ea757a0339978f3589193cbb...29f67dce9efd048b915d70f905ee1c9d2bda5de9,10,13,26,39,12,2007-08-19 22:55:05,2007-08-19 22:55:05
29f67dce9efd048b915d70f905ee1c9d2bda5de9...ed8e392f771b415fc5b5c95a770d6a3b4f59530a,1,3,0,3,1,2007-08-19 22:57:08,2007-08-19 22:57:08
ed8e392f771b415fc5b5c95a770d6a3b4f59530a...8e84d35d38d429fb00a35fd4f770ade39d7772ec,10,25,28,53,19,2007-08-19 23:03:38,2007-08-19 23:03:38
8e84d35d38d429fb00a35fd4f770ade39d7772ec...23a736dca9b2a631e841a9daff067558206e7965,10,16,23,39,13,2007-08-19 23:07:34,2007-08-19 23:07:34
23a736dca9b2a631e841a9daff067558206e7965...5a6426448f9813ef9abe17d59eb99e278f9461ee,10,15,23,38,12,2007-08-19 23:13:06,2007-08-19 23:13:06
5a6426448f9813ef9abe17d59eb99e278f9461ee...5ce050a5f5beab38e89b1e6a9c8b1c946252cd7f,10,28,28,56,14,2007-08-19 23:18:43,2007-08-19 23:18:43
5ce050a5f5beab38e89b1e6a9c8b1c946252cd7f...d3e69c3a47dd9fc7c36414c029d9919b84b0b822,10,30,44,74,13,2007-08-19 23:24:59,2007-08-19 23:24:59
d3e69c3a47dd9fc7c36414c029d9919b84b0b822...e4b7e369ddc511dac78e1bf735e927c5fe0afe68,11,18,31,49,18,2007-08-19 23:53:39,2007-08-19 23:53:39
e4b7e369ddc511dac78e1bf735e927c5fe0afe68...aaf87602272c768d4d50d5e9a27f06f4b19164dd,10,11,23,34,11,2007-08-19 23:59:06,2007-08-19 23:59:06
aaf87602272c768d4d50d5e9a27f06f4b19164dd...c44fb66551bf2f628648440ebc2010ad1135d9ac,10,21,25,46,16,2007-08-20 00:04:20,2007-08-20 00:04:20
c44fb66551bf2f628648440ebc2010ad1135d9ac...aaed6e04eceef98e9ec433e86b80486ada2a668b,10,197,230,427,16,2007-08-20 00:15:53,2007-08-20 00:15:53
aaed6e04eceef98e9ec433e86b80486ada2a668b...147e99a08a4c5983f8b031917ace99e5a4827033,11,89,103,192,15,2007-08-20 00:21:10,2007-08-20 00:21:10
147e99a08a4c5983f8b031917ace99e5a4827033...13061bf20bc467c5655c2dfa280dc226a00effcd,10,12,25,37,11,2007-08-20 00:24:03,2007-08-20 00:24:03
13061bf20bc467c5655c2dfa280dc226a00effcd...d4f218bd91d08ed79fcc67c10f4e1cfc6b221784,4,19,12,31,11,2007-08-20 00:30:19,2007-08-20 00:30:19
d4f218bd91d08ed79fcc67c10f4e1cfc6b221784...221f99ed5831b71b7ddb810ec8808a884773ef04,23,224,187,411,149,2007-08-20 01:03:33,2007-08-20 01:03:33
221f99ed5831b71b7ddb810ec8808a884773ef04...1b4cfd4fea151da70a77c9ca6197276110aa8c31,10,4,18,22,10,2007-08-20 01:13:12,2007-08-20 01:13:12
1b4cfd4fea151da70a77c9ca6197276110aa8c31...ba49e7be08e340db9c0e570619388e9e2ea69509,9,0,17,17,9,2007-08-20 01:14:03,2007-08-20 01:14:03
ba49e7be08e340db9c0e570619388e9e2ea69509...a6a5e3cf326849da55483cc041d8b69589183976,9,0,23,23,9,2007-08-20 01:14:53,2007-08-20 01:14:53
a6a5e3cf326849da55483cc041d8b69589183976...c2c3e930963d1a4786bd31451f091b04e2ecc35b,2,0,12,12,2,2007-08-20 01:15:32,2007-08-20 01:15:32
c2c3e930963d1a4786bd31451f091b04e2ecc35b...f4b397087cd0261ce1f8c35c2014e1121f5f0f5f,3,117,217,334,9,2007-08-20 01:26:46,2007-08-20 01:26:46
f4b397087cd0261ce1f8c35c2014e1121f5f0f5f...4f8225051246fb4c1560bbba77a4ead18bc22828,1,1,1,2,1,2007-08-20 01:30:11,2007-08-20 01:30:11
4f8225051246fb4c1560bbba77a4ead18bc22828...1a8f9b2b97d2549fe28c2d9090fece3f29f029fa,12,69,91,160,48,2007-08-20 02:20:33,2007-08-20 02:20:33
1a8f9b2b97d2549fe28c2d9090fece3f29f029fa...6d8e6090e598bcfafa7caffdee37e191d1ee7f4a,6,9,9,18,9,2007-08-20 02:28:40,2007-08-20 02:28:40
6d8e6090e598bcfafa7caffdee37e191d1ee7f4a...e13ea3c70dc1a217d4e88e0a66f4311167f156c3,3,251,243,494,6,2007-08-20 02:39:05,2007-08-20 02:39:05
e13ea3c70dc1a217d4e88e0a66f4311167f156c3...4c5248f98f0460018aff635abd955867980bf3bc,3,16,11,27,4,2007-08-20 03:03:40,2007-08-20 03:03:40
4c5248f98f0460018aff635abd955867980bf3bc...b105a528828377757e3c654bcd3221406409ab25,3,17,7,24,5,2007-08-20 03:08:32,2007-08-20 03:08:32
b105a528828377757e3c654bcd3221406409ab25...e267bec83af02d0e871b82719f17afe867c52dda,1,1,1,2,1,2007-08-20 03:10:20,2007-08-20 03:10:20
e267bec83af02d0e871b82719f17afe867c52dda...f0decc18cf91f7b6666b6cdbe7864300b41ba1ad,1,1,1,2,1,2007-08-20 03:13:03,2007-08-20 03:13:03
f0decc18cf91f7b6666b6cdbe7864300b41ba1ad...b3912d360991f0e34beb9f584a21c0c532f822ac,2,5,20,25,17,2007-08-20 03:16:55,2007-08-20 03:16:55
b3912d360991f0e34beb9f584a21c0c532f822ac...14db37319bd2a73b796d4b1a078fa7f162fc25e8,9,116,124,240,19,2007-08-20 03:26:55,2007-08-20 03:26:55
14db37319bd2a73b796d4b1a078fa7f162fc25e8...b367ec2244995c8efe1057671e0180d23664725f,7,14,16,30,14,2007-08-20 03:32:06,2007-08-20 03:32:06
b367ec2244995c8efe1057671e0180d23664725f...14b5e074ba7a57a5421d5b7217141c63c9c481d5,4,70,3,73,9,2007-08-20 08:50:08,2007-08-20 08:50:08
14b5e074ba7a57a5421d5b7217141c63c9c481d5...46ec6b34021d35116cbe8afee74f0e55eb8de00e,1,1,1,2,2,2007-08-20 14:15:23,2007-08-20 14:15:23
46ec6b34021d35116cbe8afee74f0e55eb8de00e...c06524bc2d132e80cb4602e5b8bffc6f3378b5d4,2,57,20,77,16,2007-08-20 14:15:40,2007-08-20 14:15:40
c06524bc2d132e80cb4602e5b8bffc6f3378b5d4...a3a07af91060363e21cad1621820cae5f2bf9524,1,1,1,2,1,2007-08-21 02:35:01,2007-08-21 02:35:01
a3a07af91060363e21cad1621820cae5f2bf9524...a1e26b0105a7f6afc5d950556caf7f44ff35c9cf,3,36,1,37,3,2007-08-21 03:08:02,2007-08-21 03:08:02
a1e26b0105a7f6afc5d950556caf7f44ff35c9cf...377fe7ce77f99a0b79431aa5417ba262f464f58b,1,1,1,2,1,2007-08-21 17:06:06,2007-08-21 17:06:06
377fe7ce77f99a0b79431aa5417ba262f464f58b...22ae4eda8ec5d26f8a562838bc2db3e7314cfe0f,0,0,0,0,0,2007-08-23 11:33:26,2007-08-23 11:33:26
22ae4eda8ec5d26f8a562838bc2db3e7314cfe0f...3a4b139636e755db36d8bb7f4c1180ad9da84aab,0,0,0,0,0,2007-08-23 23:10:53,2007-08-23 23:10:53
3a4b139636e755db36d8bb7f4c1180ad9da84aab...4652c96de1843e8176837e7c3f56b925301fa30c,1,8,2,10,3,2007-08-24 03:53:04,2007-08-24 03:53:04
4652c96de1843e8176837e7c3f56b925301fa30c...de64e0d57076882e6bafd414424e1cf889e319fb,1,2,2,4,2,2007-08-25 11:17:33,2007-08-25 11:17:33
de64e0d57076882e6bafd414424e1cf889e319fb...6d387d3d1bc481b47f6be4e4294bb87cc8b75c9f,1,5,5,10,3,2007-08-25 18:27:57,2007-08-25 18:27:57
6d387d3d1bc481b47f6be4e4294bb87cc8b75c9f...b3103feead9c726d56cae09be92c2104f5a057e7,1,1,1,2,1,2007-08-25 18:29:26,2007-08-25 18:29:26
b3103feead9c726d56cae09be92c2104f5a057e7...375c88d2bcb98e80b38b0ad3b6e7116b80c13064,2,2,1,3,2,2007-08-25 18:34:28,2007-08-25 18:34:28
375c88d2bcb98e80b38b0ad3b6e7116b80c13064...62329dca05dc0354438d08c609bcee0616c027d2,1,0,4,4,1,2007-08-25 18:37:43,2007-08-25 18:37:43
62329dca05dc0354438d08c609bcee0616c027d2...ce207949f3eeaf11884272518acc807481313c14,1,33,0,33,2,2007-08-25 18:43:32,2007-08-25 18:43:32
ce207949f3eeaf11884272518acc807481313c14...eb2ce98b29294f92437f84580b9edc4111717ea4,1,1,1,2,1,2007-08-25 18:48:32,2007-08-25 18:48:32
eb2ce98b29294f92437f84580b9edc4111717ea4...f8e26f5c2c9d263bf7b420abeb50164d6a76a760,1,5,4,9,1,2007-08-25 18:51:32,2007-08-25 18:51:32
f8e26f5c2c9d263bf7b420abeb50164d6a76a760...861b28f37e790e13dfae45da5042588f0ab57b1a,1,7,21,28,2,2007-08-25 18:56:43,2007-08-25 18:56:43
861b28f37e790e13dfae45da5042588f0ab57b1a...b189e266ef1a4f8c3fba39e44e053ec42fc52098,1,15,5,20,3,2007-08-25 18:58:36,2007-08-25 18:58:36
b189e266ef1a4f8c3fba39e44e053ec42fc52098...de2881f9f22bfe621fe3c00fd1fdb7c0a905df0f,1,0,1,1,1,2007-08-25 18:59:59,2007-08-25 18:59:59
de2881f9f22bfe621fe3c00fd1fdb7c0a905df0f...8b8a36c7d05f747685cd62e62776141029fef1dd,3,12,9,21,4,2007-08-25 19:24:47,2007-08-25 19:24:47
8b8a36c7d05f747685cd62e62776141029fef1dd...132605d889db8767a40243259066b8450428714c,4,50,9,59,12,2007-08-25 19:32:30,2007-08-25 19:32:30
132605d889db8767a40243259066b8450428714c...70740d6eca8c4b439a95d17ef41e2229b2b8f399,1,7,5,12,4,2007-08-25 23:33:58,2007-08-25 23:33:58
70740d6eca8c4b439a95d17ef41e2229b2b8f399...32c729be10271173a71c1505ae658da332995b04,1,3,0,3,1,2007-08-25 23:56:33,2007-08-25 23:56:33
32c729be10271173a71c1505ae658da332995b04...1a1a58c9f89f7b34fec05d426472b134d3e44096,3,85,11,96,8,2007-08-26 01:11:20,2007-08-26 01:11:20
1a1a58c9f89f7b34fec05d426472b134d3e44096...4ea2afa4d5fe78cf0667263b259c1fec3993ab4e,1,1,1,2,1,2007-08-26 01:16:19,2007-08-26 01:16:19
4ea2afa4d5fe78cf0667263b259c1fec3993ab4e...44e620972dbea7e11c255fff70fc8eeb08c99d12,3,5,3,8,4,2007-08-27 00:30:37,2007-08-27 00:30:37
44e620972dbea7e11c255fff70fc8eeb08c99d12...258af283fc398ff99c2de9386b494eb1910e2d74,1,16,5,21,3,2007-08-28 13:03:22,2007-08-28 13:03:22
258af283fc398ff99c2de9386b494eb1910e2d74...33ab65dd1e004ebc8fb4d85d8c2ded2187b7c961,1,1,1,2,1,2007-08-31 04:30:20,2007-08-31 04:30:20
33ab65dd1e004ebc8fb4d85d8c2ded2187b7c961...d09d1428f885ce4686dfe6fc20b091f3b8e66de7,3,12,6,18,6,2007-08-31 04:35:03,2007-08-31 04:35:03
d09d1428f885ce4686dfe6fc20b091f3b8e66de7...5ad08583e166b63fff12fc87fa84528e946ac6ad,5,41,12,53,11,2007-08-31 11:37:28,2007-08-31 11:37:28
5ad08583e166b63fff12fc87fa84528e946ac6ad...8ae1a78e47cfab6d9b4b9d64541517927cfcb7ed,1,1,1,2,1,2007-09-02 17:05:13,2007-09-02 17:05:13
8ae1a78e47cfab6d9b4b9d64541517927cfcb7ed...a18b744aa67a93f297be96cd69f8ea0e185de835,1,1,1,2,1,2007-09-02 17:06:26,2007-09-02 17:06:26
a18b744aa67a93f297be96cd69f8ea0e185de835...a07c1c5aa6fe2111d4676ceecfead19710bacf02,1,2,1,3,1,2007-09-02 17:09:27,2007-09-02 17:09:27
a07c1c5aa6fe2111d4676ceecfead19710bacf02...41576fea7180e681a3006195d40a364bc8f78505,1,5,1,6,1,2007-09-02 20:04:44,2007-09-02 20:04:44
41576fea7180e681a3006195d40a364bc8f78505...8e3507cd3ee7d77ce279420b8e9a627da7a62966,1,1,1,2,1,2007-09-03 06:16:47,2007-09-03 06:16:47
8e3507cd3ee7d77ce279420b8e9a627da7a62966...afc6985267609d7782ec01817b051267fef48cd1,1,1,1,2,1,2007-09-03 06:18:48,2007-09-03 06:18:48
afc6985267609d7782ec01817b051267fef48cd1...3bf4ef0c77f80e2ed7fab298679ab0c5f28bc900,7,57,14,71,13,2007-09-03 11:21:40,2007-09-03 11:21:40
3bf4ef0c77f80e2ed7fab298679ab0c5f28bc900...853f9c7db9f506de20228eb74d9d34abeba10dbf,1,1,1,2,1,2007-09-03 13:13:10,2007-09-03 13:13:10
853f9c7db9f506de20228eb74d9d34abeba10dbf...bce7de96477086f98f8cde8aef41a15e6e17b8af,2,31,30,61,8,2007-09-03 23:14:51,2007-09-03 23:14:51
bce7de96477086f98f8cde8aef41a15e6e17b8af...d1d4d018bf170dca2758f59e8063d171f40889f5,1,20,0,20,1,2007-09-03 23:41:24,2007-09-03 23:41:24
d1d4d018bf170dca2758f59e8063d171f40889f5...1da7b5cde720337026f5c3650be5d26d9d326949,1,21,0,21,1,2007-09-04 00:48:19,2007-09-04 00:48:19
1da7b5cde720337026f5c3650be5d26d9d326949...53372fcb07191941cb021bd1545933115407e6c2,2,86,61,147,32,2007-09-04 00:50:06,2007-09-04 00:50:06
53372fcb07191941cb021bd1545933115407e6c2...2292ebb47f2f1337567dc72d50306c2398c04785,1,1,1,2,1,2007-09-04 00:53:59,2007-09-04 00:53:59
2292ebb47f2f1337567dc72d50306c2398c04785...4e476b44afec10181114b6f1e06df74f4435e202,1,22,22,44,14,2007-09-04 00:54:40,2007-09-04 00:54:40
4e476b44afec10181114b6f1e06df74f4435e202...f25b8cdbcdc99812299e9081cd3b03ddc08dcf74,2,99,22,121,8,2007-09-04 12:59:49,2007-09-04 12:59:49
f25b8cdbcdc99812299e9081cd3b03ddc08dcf74...9515b953f8ebaf239247416dd4c638c287f171c6,1,24,11,35,3,2007-09-04 13:09:59,2007-09-04 13:09:59
9515b953f8ebaf239247416dd4c638c287f171c6...faaf2dad362e83a07779cecf5951b0f7e800803b,1,5,3,8,1,2007-09-04 22:44:35,2007-09-04 22:44:35
faaf2dad362e83a07779cecf5951b0f7e800803b...e4342b7d28d3b0c470954f60a02340b472abe7c0,2,22,99,121,8,2007-09-05 14:01:31,2007-09-05 14:01:31
e4342b7d28d3b0c470954f60a02340b472abe7c0...da5ce52061be41c1c6882224ce8201b6d35f43b8,1,1,1,2,1,2007-09-07 04:09:59,2007-09-07 04:09:59
da5ce52061be41c1c6882224ce8201b6d35f43b8...be39adeb288a4d0aa9973ac4e435232509a6d4ee,1,3,1,4,2,2007-09-07 04:11:20,2007-09-07 04:11:20
be39adeb288a4d0aa9973ac4e435232509a6d4ee...41b3a45fc569e0e7f5b8ee5b254ad8c1bb05ffb5,3,34,24,58,33,2007-09-08 05:09:39,2007-09-08 05:09:39
41b3a45fc569e0e7f5b8ee5b254ad8c1bb05ffb5...ef088d5f36f69af30cce2262a7a1814d41ca2bd4,1,11,8,19,5,2007-09-08 05:11:17,2007-09-08 05:11:17
ef088d5f36f69af30cce2262a7a1814d41ca2bd4...7e57576ff7fcad814c7a86de12d933a219106f8f,3,27,2,29,3,2007-09-08 19:24:46,2007-09-08 19:24:46
7e57576ff7fcad814c7a86de12d933a219106f8f...b0e173ae3ff466f980846691a4be9f7c55a7405b,2,12,11,23,9,2007-09-08 19:26:15,2007-09-08 19:26:15
b0e173ae3ff466f980846691a4be9f7c55a7405b...a047f6a8fe5e2686aaac226ae535682591896d9c,1,2,2,4,2,2007-09-08 19:30:16,2007-09-08 19:30:16
a047f6a8fe5e2686aaac226ae535682591896d9c...9b07806aa107232b56fec16428bd27488d49f1ad,1,9,0,9,1,2007-09-09 17:18:36,2007-09-09 17:18:36
9b07806aa107232b56fec16428bd27488d49f1ad...6f0bc3d02b2ff34fa256f214915ce4967b91e09e,1,1,1,2,1,2007-09-09 17:21:36,2007-09-09 17:21:36
6f0bc3d02b2ff34fa256f214915ce4967b91e09e...71504127fd26e67ec46d7f21d76138918b87d45f,15,389,211,600,102,2007-09-09 21:57:59,2007-09-09 21:57:59
71504127fd26e67ec46d7f21d76138918b87d45f...c8539731103e97ad0e86dbff118302b2d7a812f6,1,10,2,12,1,2007-09-09 22:00:30,2007-09-09 22:00:30
c8539731103e97ad0e86dbff118302b2d7a812f6...84f618249402e8fd5673efbe2604e2b3f17b35a0,1,1,1,2,1,2007-09-09 22:01:33,2007-09-09 22:01:33
84f618249402e8fd5673efbe2604e2b3f17b35a0...5e19019bcac39421adf6e0ee8cc3b3fd2cc1ff08,1,5,0,5,1,2007-09-09 22:10:47,2007-09-09 22:10:47
5e19019bcac39421adf6e0ee8cc3b3fd2cc1ff08...3a3669e01038c86b2a351275d1b1101e84bfba8f,1,1,1,2,1,2007-09-09 22:48:25,2007-09-09 22:48:25
3a3669e01038c86b2a351275d1b1101e84bfba8f...3b6f032850d4e8fb37da74fe524c89c7a2f8f28f,1,1,1,2,1,2007-09-10 02:07:57,2007-09-10 02:07:57
3b6f032850d4e8fb37da74fe524c89c7a2f8f28f...b82a44d2706a08ddf848960f8b777f47db66f376,1,40,0,40,1,2007-09-10 03:42:33,2007-09-10 03:42:33
b82a44d2706a08ddf848960f8b777f47db66f376...49e4e4f9ce1ed5198385353ab5a88693f9ab17c3,1,4,4,8,3,2007-09-10 03:46:06,2007-09-10 03:46:06
49e4e4f9ce1ed5198385353ab5a88693f9ab17c3...4453f65c78762a1e72d87d6a02453f36b2c3ebf7,1,1,3,4,1,2007-09-10 03:46:43,2007-09-10 03:46:43
4453f65c78762a1e72d87d6a02453f36b2c3ebf7...f15a5c7abb55b37ec2928e7afb38df0081e68226,1,3,3,6,3,2007-09-10 04:33:24,2007-09-10 04:33:24
f15a5c7abb55b37ec2928e7afb38df0081e68226...12146f34fd029e26dad7eea73dbb91b93c37f227,1,1,5,6,1,2007-09-10 07:00:46,2007-09-10 07:00:46
12146f34fd029e26dad7eea73dbb91b93c37f227...c554858f6b8394655e5cea4031e6b1ba1f08ba52,2,5,6,11,3,2007-09-11 02:49:07,2007-09-11 02:49:07
c554858f6b8394655e5cea4031e6b1ba1f08ba52...a247c726c2e6df7e7e561edd5cace7f00b76cbfd,2,13,13,26,11,2007-09-11 03:46:35,2007-09-11 03:46:35
a247c726c2e6df7e7e561edd5cace7f00b76cbfd...aacb0cf055cf916fa15702879955ce0ae8a38727,1,0,14,14,1,2007-09-11 04:21:32,2007-09-11 04:21:32
aacb0cf055cf916fa15702879955ce0ae8a38727...a291952a7d324e1675ed0ee1f82bb2c4b4b2a5eb,2,35,35,70,25,2007-09-11 04:24:35,2007-09-11 04:24:35
a291952a7d324e1675ed0ee1f82bb2c4b4b2a5eb...a77a02359d8edb1bd880b47cd483b593ab276a66,1,1,1,2,1,2007-09-11 04:25:55,2007-09-11 04:25:55
a77a02359d8edb1bd880b47cd483b593ab276a66...2554ea352e37b5d1da57392ee19a681b00c87154,1,1,1,2,1,2007-09-11 04:27:06,2007-09-11 04:27:06
2554ea352e37b5d1da57392ee19a681b00c87154...2cf419d9ed1d9ed188413df5113161486ca8f746,1,1,6,7,2,2007-09-11 04:37:23,2007-09-11 04:37:23
2cf419d9ed1d9ed188413df5113161486ca8f746...7115465afa549955ec446638e0d73b597e6ffd20,2,6,2,8,2,2007-09-11 13:13:35,2007-09-11 13:13:35
7115465afa549955ec446638e0d73b597e6ffd20...db01d1d0a8b1d584b025164988de8003c2d29d1c,1,4,1,5,2,2007-09-11 13:36:09,2007-09-11 13:36:09
db01d1d0a8b1d584b025164988de8003c2d29d1c...50497e3867564e68050d326b22dc41fe82d79dc0,3,5,8,13,5,2007-09-11 14:04:40,2007-09-11 14:04:40
50497e3867564e68050d326b22dc41fe82d79dc0...db6093641ca58d06baa4a729f6fbcff99cb2ca60,1,1,1,2,1,2007-09-12 13:11:51,2007-09-12 13:11:51
db6093641ca58d06baa4a729f6fbcff99cb2ca60...ced74d582a10c11e0d774b4dbd260e90db013da5,1,55,0,55,1,2007-09-12 14:38:47,2007-09-12 14:38:47
c7f6cd02436fce1cf47eb0fa4b00fbc9b5ebece6...c2f7fccb62ae2fc491bf7edd15e22fee4823745e,0,0,0,0,0,2007-04-07 05:15:27,2007-04-07 05:15:27
c2f7fccb62ae2fc491bf7edd15e22fee4823745e...232b7ac519255b95ac0b121c59fb475cdbabbc04,0,0,0,0,0,2007-04-09 04:24:03,2007-04-09 04:24:03
232b7ac519255b95ac0b121c59fb475cdbabbc04...b493b7e3cf09eb0df5c460e8ca7b6a934e40e43c,21,308,117,425,78,2007-04-09 10:33:57,2007-04-09 10:33:57
b493b7e3cf09eb0df5c460e8ca7b6a934e40e43c...e5adc5a42797a7afe078320d3050a300b11f8405,1,3,6,9,3,2007-04-09 11:05:50,2007-04-09 11:05:50
e5adc5a42797a7afe078320d3050a300b11f8405...349bf5a355ff7ebffb3403a68437e2c524d8b7c7,21,326,121,447,78,2007-04-09 11:09:17,2007-04-09 11:09:17
349bf5a355ff7ebffb3403a68437e2c524d8b7c7...5860a5a4bef779f1f1bb0c9f85b1943c8a973724,87,9810,4197,14007,1422,2007-04-21 06:18:25,2007-04-21 06:18:25
5860a5a4bef779f1f1bb0c9f85b1943c8a973724...dadbe3c7370dbfd55b3cd42265e395efb76604b7,3,68,26,94,21,2007-04-21 14:16:21,2007-04-21 14:16:21
dadbe3c7370dbfd55b3cd42265e395efb76604b7...b30e5b54346abacdd91b8ef7ec439c00f34a5ad6,11,353,367,720,253,2007-04-21 14:34:43,2007-04-21 14:34:43
b30e5b54346abacdd91b8ef7ec439c00f34a5ad6...9470a6c5bb52ac1c55d438bb8a86b92760e4ed26,2,21,2,23,6,2007-04-22 03:13:00,2007-04-22 03:13:00
9470a6c5bb52ac1c55d438bb8a86b92760e4ed26...03b46fc8d0223bc884ff9f7728405367eae7e2fc,6,17,6,23,8,2007-04-22 04:21:04,2007-04-22 04:21:04
03b46fc8d0223bc884ff9f7728405367eae7e2fc...dfe20bb91a03be12322c2fe785709a78fbc50680,5,13,13,26,9,2007-04-22 04:55:42,2007-04-22 04:55:42
dfe20bb91a03be12322c2fe785709a78fbc50680...dfc553625dc13e95df5d90cc11c33e359d59fb11,56,3126,2282,5408,800,2007-04-26 09:53:45,2007-04-26 09:53:45
dfc553625dc13e95df5d90cc11c33e359d59fb11...0da72ff885ee4e21214e477f883497e30ddee404,7,114,114,228,113,2007-04-26 09:58:44,2007-04-26 09:58:44
0da72ff885ee4e21214e477f883497e30ddee404...511b2591b70b1ef4eaaa629c13d5d284fabb5f4b,1,1,1,2,1,2007-04-26 10:17:01,2007-04-26 10:17:01
511b2591b70b1ef4eaaa629c13d5d284fabb5f4b...ee0bc3b6c8e34d4785cf3fc9aec78161df2b1d19,2,79,68,147,35,2007-04-26 13:18:54,2007-04-26 13:18:54
ee0bc3b6c8e34d4785cf3fc9aec78161df2b1d19...080cebaf69891f4b2b575a1e9fd7ceb4d2170623,1,2,5,7,2,2007-04-27 08:29:08,2007-04-27 08:29:08
080cebaf69891f4b2b575a1e9fd7ceb4d2170623...63d95548a76a47c88c9a06197057e0715b83393e,62,872,351,1223,319,2007-04-28 16:49:21,2007-04-28 16:49:21
63d95548a76a47c88c9a06197057e0715b83393e...dcc8577969aeef3726e38efb28dbce459ff3a9ba,27,1931,890,2821,567,2007-05-05 09:53:50,2007-05-05 09:53:50
dcc8577969aeef3726e38efb28dbce459ff3a9ba...ce4722a52aa6825f9a22b8ce158657e918d29446,2,106,43,149,48,2007-05-11 06:03:40,2007-05-11 06:03:40
ce4722a52aa6825f9a22b8ce158657e918d29446...a7a756e27ee0dc8b6b2178fd4cdb03ae4179612c,53,6725,3699,10424,1172,2007-05-11 07:28:33,2007-05-11 07:28:33
a7a756e27ee0dc8b6b2178fd4cdb03ae4179612c...56db7a6078d4f35f4d2624d717963b43cacf6cc9,1,1,1,2,1,2007-05-11 14:29:25,2007-05-11 14:29:25
56db7a6078d4f35f4d2624d717963b43cacf6cc9...7225efba5006256915ca5e56889e2a35bc10a26a,2,12,0,12,2,2007-05-11 14:49:43,2007-05-11 14:49:43
7225efba5006256915ca5e56889e2a35bc10a26a...5e9aead902c57d3c00d661695697314d352dee0e,2,14,2,16,3,2007-05-12 05:29:10,2007-05-12 05:29:10
5e9aead902c57d3c00d661695697314d352dee0e...a8e5db536edcf7cb1978d1897468a3f162077b6b,1,4,29,33,4,2007-05-12 06:32:23,2007-05-12 06:32:23
a8e5db536edcf7cb1978d1897468a3f162077b6b...7c45aad6735b98106a5167532674c5182164c816,2,14,8,22,9,2007-05-12 06:54:41,2007-05-12 06:54:41
7c45aad6735b98106a5167532674c5182164c816...1026402499840f980e6a9f0c4cd9e92962ba1b10,5,50,44,94,43,2007-05-12 10:34:34,2007-05-12 10:34:34
1026402499840f980e6a9f0c4cd9e92962ba1b10...994714d8cc68701abb5190c1fd9d8c3015744797,6,42,28,70,33,2007-05-12 15:07:17,2007-05-12 15:07:17
994714d8cc68701abb5190c1fd9d8c3015744797...50ef85f6e234085bef0f2f7c7828e08886d43cbb,1,4,0,4,1,2007-05-12 15:31:52,2007-05-12 15:31:52
50ef85f6e234085bef0f2f7c7828e08886d43cbb...bc044651aaed9eedbc195414a71bde4e375a7c73,1,2,1,3,2,2007-05-12 15:40:46,2007-05-12 15:40:46
bc044651aaed9eedbc195414a71bde4e375a7c73...28f66bb097799f34a6ead02fe4ecafa493cee06b,21,544,131,675,57,2007-05-13 06:23:30,2007-05-13 06:23:30
28f66bb097799f34a6ead02fe4ecafa493cee06b...6c99a60e0d8b457720227540846982cee1bb7c45,5,17,15,32,13,2007-05-14 07:04:31,2007-05-14 07:04:31
6c99a60e0d8b457720227540846982cee1bb7c45...e1593cca3fc6c12453c49d1eca03897544835746,5,299,32,331,24,2007-05-14 07:16:27,2007-05-14 07:16:27
e1593cca3fc6c12453c49d1eca03897544835746...9de774aad8bf3c91488c8925c31f71acbc2c3fb4,1,3,3,6,3,2007-05-14 10:18:29,2007-05-14 10:18:29
9de774aad8bf3c91488c8925c31f71acbc2c3fb4...2aa9d45c019202b0ad5d165f4cf49dc8c170dfae,2,13,2,15,4,2007-05-14 10:48:24,2007-05-14 10:48:24
2aa9d45c019202b0ad5d165f4cf49dc8c170dfae...a4adfd780a9200dff527489b23383b89a8c2edab,33,127,128,255,81,2007-05-14 11:24:37,2007-05-14 11:24:37
a4adfd780a9200dff527489b23383b89a8c2edab...3916cfbaff3b0b41d977a5efb6a9d9b41b067d90,17,62,54,116,59,2007-05-14 11:56:20,2007-05-14 11:56:20
3916cfbaff3b0b41d977a5efb6a9d9b41b067d90...fbfefbf83d1396db1ea4095b2b64e1841689b364,4,16,5,21,6,2007-05-14 16:06:27,2007-05-14 16:06:27
fbfefbf83d1396db1ea4095b2b64e1841689b364...4c34343e178d9c46e7f037ecd34463905f69b9cb,1,6,0,6,2,2007-05-14 18:39:03,2007-05-14 18:39:03
4c34343e178d9c46e7f037ecd34463905f69b9cb...03b86ea12dc7f0caf805b7fc0871413b7a2c57da,1,5,0,5,2,2007-05-14 19:04:06,2007-05-14 19:04:06
03b86ea12dc7f0caf805b7fc0871413b7a2c57da...36c508d1ed64695f864df70cd5d4d37b0c9e7a01,6,31,12,43,15,2007-05-14 19:05:16,2007-05-14 19:05:16
36c508d1ed64695f864df70cd5d4d37b0c9e7a01...57ced2560683f7af0c99971dfaaf9c70fca78506,20,2931,85,3016,92,2007-05-14 19:42:13,2007-05-14 19:42:13
57ced2560683f7af0c99971dfaaf9c70fca78506...cd3d40ec9134a007b376d00a157edc0f275b5648,1,17,15,32,13,2007-05-14 21:50:38,2007-05-14 21:50:38
cd3d40ec9134a007b376d00a157edc0f275b5648...19ad4a47ba660e5861a3a72f7b156a0653590370,1,6,1,7,2,2007-05-14 21:58:01,2007-05-14 21:58:01
19ad4a47ba660e5861a3a72f7b156a0653590370...0e4c3838abc640fa64f061d2df242277501a4a34,1,11,6,17,4,2007-05-15 16:13:37,2007-05-15 16:13:37
0e4c3838abc640fa64f061d2df242277501a4a34...9d001fa7f957f686d61b82dbf0d60c34ba0dd092,6,103,102,205,87,2007-05-15 16:14:55,2007-05-15 16:14:55
9d001fa7f957f686d61b82dbf0d60c34ba0dd092...267dcdb1e6b8573343f67c1f2cfe2548ae8b002b,2,9,6,15,6,2007-05-15 18:11:15,2007-05-15 18:11:15
267dcdb1e6b8573343f67c1f2cfe2548ae8b002b...abf514053b5097d3071a8a282cadbb4bbb73fe87,6,18,15,33,13,2007-05-16 12:50:27,2007-05-16 12:50:27
abf514053b5097d3071a8a282cadbb4bbb73fe87...0e2043deefc517baed2e58b591e1c24275dc63d7,2,6,5,11,6,2007-05-16 12:51:18,2007-05-16 12:51:18
0e2043deefc517baed2e58b591e1c24275dc63d7...1ca5bc0f0c8cf054658ef55419dc9ac0b774bcdf,2,5,4,9,5,2007-05-16 13:24:18,2007-05-16 13:24:18
1ca5bc0f0c8cf054658ef55419dc9ac0b774bcdf...095d3ca8eb328ddea96744090f21c1d0cfb1c571,1,5,4,9,3,2007-05-16 14:45:58,2007-05-16 14:45:58
095d3ca8eb328ddea96744090f21c1d0cfb1c571...2cebf777e3827c4325f8e4d8e3f2d55f21b603a5,1,2,1,3,2,2007-05-16 22:22:53,2007-05-16 22:22:53
2cebf777e3827c4325f8e4d8e3f2d55f21b603a5...d5946c5946091599c8fc2bcb2c528d22a79102a5,1,2,1,3,2,2007-05-16 22:23:36,2007-05-16 22:23:36
d5946c5946091599c8fc2bcb2c528d22a79102a5...abba09c6d2264e8151128cb429dee33693f8218a,1,6,5,11,6,2007-05-16 22:30:54,2007-05-16 22:30:54
abba09c6d2264e8151128cb429dee33693f8218a...1ad97d0634dda512f294d5116a1dba91789b8817,1,7,1,8,2,2007-05-16 22:41:35,2007-05-16 22:41:35
1ad97d0634dda512f294d5116a1dba91789b8817...4a7727e46ebe1bd5ca5db92e62459eec1137fa04,14,70,64,134,49,2007-05-16 23:10:31,2007-05-16 23:10:31
4a7727e46ebe1bd5ca5db92e62459eec1137fa04...e4cd34cbeeb66e7d6f9b5665d10d4faadba1eedd,1,7,7,14,7,2007-05-16 23:11:49,2007-05-16 23:11:49
e4cd34cbeeb66e7d6f9b5665d10d4faadba1eedd...5b4e2637f916c2831684e1933cfd2d2f01cb6d9e,2,3,2,5,2,2007-05-17 01:19:03,2007-05-17 01:19:03
5b4e2637f916c2831684e1933cfd2d2f01cb6d9e...a8404e66fd1f04334a3a4488c63976762974bd4c,8,80,40,120,37,2007-05-17 01:24:58,2007-05-17 01:24:58
a8404e66fd1f04334a3a4488c63976762974bd4c...52b0051523cb6608bf401aff9a42bc88567606cc,4,11,10,21,9,2007-05-17 16:55:38,2007-05-17 16:55:38
52b0051523cb6608bf401aff9a42bc88567606cc...c0b451fcfa516aa24ec4126171ed39c624e12ca7,3,36,15,51,16,2007-05-17 18:19:40,2007-05-17 18:19:40
c0b451fcfa516aa24ec4126171ed39c624e12ca7...60424589264285e3127f892ab6bfc38de2c0e4a8,12,182,89,271,47,2007-05-17 18:35:22,2007-05-17 18:35:22
60424589264285e3127f892ab6bfc38de2c0e4a8...e10da2610987eccfd1b33c59f3fbfb0e2628026b,3,68,48,116,35,2007-05-17 20:27:12,2007-05-17 20:27:12
e10da2610987eccfd1b33c59f3fbfb0e2628026b...68a0f4f51b209c9daa2dc6ff31690c273979282c,1,23,4,27,5,2007-05-18 18:23:34,2007-05-18 18:23:34
68a0f4f51b209c9daa2dc6ff31690c273979282c...3d74a68a5108b49ccca20482d1fde88e4f3cbdfd,3,13,4,17,6,2007-05-19 00:17:23,2007-05-19 00:17:23
3d74a68a5108b49ccca20482d1fde88e4f3cbdfd...695a21ae7fc1d401c556988394dc672bd40a8384,3,4,4,8,4,2007-05-19 00:19:17,2007-05-19 00:19:17
695a21ae7fc1d401c556988394dc672bd40a8384...f1091ec619195a610f8b2df49cf647110ca0890e,1,5,41,46,7,2007-05-19 17:05:02,2007-05-19 17:05:02
f1091ec619195a610f8b2df49cf647110ca0890e...6f23be4ee9f0b333a7ee2faf0d5fc78f7c70b86e,58,8513,2627,11140,914,2007-05-21 23:24:06,2007-05-21 23:24:06
6f23be4ee9f0b333a7ee2faf0d5fc78f7c70b86e...c2c585f0f0785b71d2efbe6de8b95ff994e59601,1,6,4,10,5,2007-05-22 00:46:08,2007-05-22 00:46:08
c2c585f0f0785b71d2efbe6de8b95ff994e59601...dd52eed2fb8dd93f08f12731330fa30126f800da,17,128,82,210,72,2007-05-22 08:06:57,2007-05-22 08:06:57
dd52eed2fb8dd93f08f12731330fa30126f800da...1c56e2d6d3809315818b5e65f46860229685b462,1,1,1,2,1,2007-05-22 08:22:54,2007-05-22 08:22:54
1c56e2d6d3809315818b5e65f46860229685b462...0fc057c486f9e4ae122a1a53bca9e4f055c11004,1,2,1,3,2,2007-05-22 08:28:06,2007-05-22 08:28:06
0fc057c486f9e4ae122a1a53bca9e4f055c11004...d72f630fdb68feaa8db2052f508cedecf1603eb9,2,12,0,12,2,2007-05-22 08:50:47,2007-05-22 08:50:47
d72f630fdb68feaa8db2052f508cedecf1603eb9...b25f6e9526ba3ccbdbe3c4f0d78813e9412a7acf,8,84,29,113,47,2007-05-23 03:46:57,2007-05-23 03:46:57
b25f6e9526ba3ccbdbe3c4f0d78813e9412a7acf...9c44751c082a55d108bc05f075b34d523532404d,1,0,2,2,1,2007-05-24 00:48:36,2007-05-24 00:48:36
9c44751c082a55d108bc05f075b34d523532404d...19d71a21dfca4bec5a716162355107247530cc10,3,6,57,63,21,2007-05-24 01:01:32,2007-05-24 01:01:32
19d71a21dfca4bec5a716162355107247530cc10...3989feed0c79544aba298e4c9ce77d7562268557,1,6,1,7,1,2007-05-24 01:25:51,2007-05-24 01:25:51
3989feed0c79544aba298e4c9ce77d7562268557...fbce6f6bdc9b2c2f71bf4324d9b3c0b92aee12cb,1,6,6,12,3,2007-05-24 02:20:34,2007-05-24 02:20:34
fbce6f6bdc9b2c2f71bf4324d9b3c0b92aee12cb...31d5d550901d2fe30679bb2ef6302af2c3df1372,1,2,1,3,2,2007-05-24 06:24:30,2007-05-24 06:24:30
31d5d550901d2fe30679bb2ef6302af2c3df1372...a09cb2a9e57b7a8239a3197601427ec89f207910,2,32,2,34,4,2007-05-24 06:44:54,2007-05-24 06:44:54
a09cb2a9e57b7a8239a3197601427ec89f207910...dceac0a3847d606a12beadbe29b345e842028701,1,2,0,2,1,2007-05-24 09:13:13,2007-05-24 09:13:13
dceac0a3847d606a12beadbe29b345e842028701...9ce95c677551aaa2a3570fd02ff7d3b8449cf24b,1,328,0,328,1,2007-05-24 09:15:31,2007-05-24 09:15:31
9ce95c677551aaa2a3570fd02ff7d3b8449cf24b...c830b6cfef7f0514fafcc05f39dacb719b71d09f,3,25,24,49,24,2007-05-24 12:04:44,2007-05-24 12:04:44
c830b6cfef7f0514fafcc05f39dacb719b71d09f...b579a3cc64acf864264de55882281fd2b4291259,2,22,22,44,21,2007-05-24 12:20:23,2007-05-24 12:20:23
b579a3cc64acf864264de55882281fd2b4291259...5a396c8b1dd31e4ff28583865cccb668a48af682,1,6,5,11,2,2007-05-24 13:08:18,2007-05-24 13:08:18
5a396c8b1dd31e4ff28583865cccb668a48af682...78b75b9065bcb3e4a016e5a8a3cdd671b7742b63,4,5,27,32,7,2007-05-25 03:02:12,2007-05-25 03:02:12
78b75b9065bcb3e4a016e5a8a3cdd671b7742b63...7b51097847f5ec549f24be603d89d748b40c0fc9,7,49,28,77,12,2007-05-25 07:25:34,2007-05-25 07:25:34
7b51097847f5ec549f24be603d89d748b40c0fc9...545173ed4ed8a34b83cfbe852bdbd6da5ba27ce0,1,4,0,4,1,2007-05-25 07:31:03,2007-05-25 07:31:03
545173ed4ed8a34b83cfbe852bdbd6da5ba27ce0...c98f0b14c42b3d49772f3ddf3c5974da79d8ad0e,2,95,3,98,7,2007-05-25 09:16:34,2007-05-25 09:16:34
c98f0b14c42b3d49772f3ddf3c5974da79d8ad0e...29d2094b29ccbc09f49772ca7dd773aca5114a9b,1,7,7,14,7,2007-05-25 09:30:43,2007-05-25 09:30:43
29d2094b29ccbc09f49772ca7dd773aca5114a9b...7ba850af3ba4ac7dbe3d67a2360079bce0bf0eb3,4,30,8,38,10,2007-05-25 09:48:02,2007-05-25 09:48:02
7ba850af3ba4ac7dbe3d67a2360079bce0bf0eb3...d5280e72d39638bb43d7c94b8bd097408d19f8f5,1,4,4,8,3,2007-05-25 10:36:14,2007-05-25 10:36:14
d5280e72d39638bb43d7c94b8bd097408d19f8f5...e4cb94415efde78e5a57d170e50e5af3a40fd5fd,1,11,1,12,2,2007-05-26 06:39:10,2007-05-26 06:39:10
e4cb94415efde78e5a57d170e50e5af3a40fd5fd...087bf45d9379a0a898861712854d9bf48a886b40,1,14,9,23,2,2007-05-26 06:55:09,2007-05-26 06:55:09
087bf45d9379a0a898861712854d9bf48a886b40...1e8d1c808bf027be1c26329dc8695daa44cea293,4,21,3,24,6,2007-05-28 11:04:13,2007-05-28 11:04:13
1e8d1c808bf027be1c26329dc8695daa44cea293...c6694dcdee914914cfee9050f062caacbbd3a922,1,1,1,2,1,2007-05-28 11:54:05,2007-05-28 11:54:05
c6694dcdee914914cfee9050f062caacbbd3a922...7bb9a8e3ae432cff280d0df0458461ee512998f7,1,1,1,2,1,2007-05-28 11:56:09,2007-05-28 11:56:09
7bb9a8e3ae432cff280d0df0458461ee512998f7...4d31b5297bc7866febdbc4a0875878202c6bacd0,3,13,6,19,7,2007-05-28 13:02:16,2007-05-28 13:02:16
4d31b5297bc7866febdbc4a0875878202c6bacd0...443d5b43efbf78d01f952ae73bbd00534a71eb07,1,1,1,2,1,2007-05-28 13:08:19,2007-05-28 13:08:19
443d5b43efbf78d01f952ae73bbd00534a71eb07...d879bce16648ce7a4ae4df8f36a9c2c5cf5b7f81,1,1,1,2,1,2007-05-28 13:49:15,2007-05-28 13:49:15
d879bce16648ce7a4ae4df8f36a9c2c5cf5b7f81...fa1a0532d35ee5ff342c19821ad290ad48771aa4,1,2,2,4,2,2007-05-29 10:20:10,2007-05-29 10:20:10
fa1a0532d35ee5ff342c19821ad290ad48771aa4...ddae2ecfe42a4135850a435e1eefc79dfecaa062,31,2336,2048,4384,629,2007-05-29 13:09:48,2007-05-29 13:09:48
ddae2ecfe42a4135850a435e1eefc79dfecaa062...8d1ce1fd334e29e676957d49182f4c47d7e9db79,46,182,135,317,98,2007-05-31 04:25:40,2007-05-31 04:25:40
8d1ce1fd334e29e676957d49182f4c47d7e9db79...790d9ecf6706a82835151052b12c953021dcd90a,1,4,0,4,2,2007-05-31 09:03:29,2007-05-31 09:03:29
790d9ecf6706a82835151052b12c953021dcd90a...8b3781cc68e618ff50fb89a0b85a312981acbe75,1,26,20,46,9,2007-05-31 09:04:55,2007-05-31 09:04:55
8b3781cc68e618ff50fb89a0b85a312981acbe75...797c1d2a858bce0ae728c7bb2274e5b9a5b2423e,1,4,4,8,4,2007-05-31 09:51:39,2007-05-31 09:51:39
797c1d2a858bce0ae728c7bb2274e5b9a5b2423e...7a30b4e03ae8848792bd114741bc2fb175d280a4,8,52,10,62,15,2007-06-01 06:19:01,2007-06-01 06:19:01
7a30b4e03ae8848792bd114741bc2fb175d280a4...554f4e7aa8a3ffe65cac3b6698906c06e7db4fe6,9,54,29,83,32,2007-06-01 07:30:40,2007-06-01 07:30:40
554f4e7aa8a3ffe65cac3b6698906c06e7db4fe6...bb97eea9ec88978ecd5dca0a17d9b3ba344f9152,19,116,32,148,29,2007-06-03 04:45:23,2007-06-03 04:45:23
bb97eea9ec88978ecd5dca0a17d9b3ba344f9152...fa689ae9c6eca0e7c68994713ce1f8fedbeb7b6e,5,30,3,33,5,2007-06-03 05:35:06,2007-06-03 05:35:06
fa689ae9c6eca0e7c68994713ce1f8fedbeb7b6e...8d30cdc2672175c77319756b42b12103e1efd350,1,4,1,5,1,2007-06-04 07:48:51,2007-06-04 07:48:51
8d30cdc2672175c77319756b42b12103e1efd350...b792044d34171888938dfac833ee4263745c1eef,9,170,47,217,33,2007-06-09 14:08:14,2007-06-09 14:08:14
b792044d34171888938dfac833ee4263745c1eef...b43ecd823c64df62ddd74763bb1491448e9216ca,1,1,1,2,1,2007-06-09 14:30:24,2007-06-09 14:30:24
b43ecd823c64df62ddd74763bb1491448e9216ca...322c3e14546cde4ff2656666b7b5088f3bcb5c26,1,3,3,6,2,2007-06-09 14:34:14,2007-06-09 14:34:14
322c3e14546cde4ff2656666b7b5088f3bcb5c26...75d29fa448a8b99f7ca1b4859f20fb57ea15f695,1,2,2,4,2,2007-06-09 14:44:27,2007-06-09 14:44:27
75d29fa448a8b99f7ca1b4859f20fb57ea15f695...0b4122d1387e3c793661c0828278a021364691d4,3,10,10,20,7,2007-06-11 14:30:53,2007-06-11 14:30:53
0b4122d1387e3c793661c0828278a021364691d4...748ea65a6180293c356faa3ff0e754cb1d678d14,18,326,38,364,48,2007-06-11 14:51:26,2007-06-11 14:51:26
748ea65a6180293c356faa3ff0e754cb1d678d14...d3980231ff8cc04d1f17e3d440606b111230b36d,6,54,53,107,30,2007-06-11 20:02:08,2007-06-11 20:02:08
d3980231ff8cc04d1f17e3d440606b111230b36d...d2080dd694b31d235f16efe748a997ebfdb5b394,1,1,1,2,1,2007-06-17 00:53:25,2007-06-17 00:53:25
d2080dd694b31d235f16efe748a997ebfdb5b394...1bfcfe615c65565da5009a205aecff394217717c,2,4,3,7,4,2007-06-17 01:23:49,2007-06-17 01:23:49
1bfcfe615c65565da5009a205aecff394217717c...2126d41aba06b50a288cc6a516d4531ced998822,8,15,23,38,15,2007-06-17 10:25:48,2007-06-17 10:25:48
2126d41aba06b50a288cc6a516d4531ced998822...f4387422f0a556fb2469500fb9d408306bead02c,2,29,1,30,3,2007-06-18 02:23:24,2007-06-18 02:23:24
f4387422f0a556fb2469500fb9d408306bead02c...0ced8b0bb211fca38669293b15316930e0d648fd,78,11372,4073,15445,1584,2007-06-25 12:47:19,2007-06-25 12:47:19
0ced8b0bb211fca38669293b15316930e0d648fd...9c5994743c16fba36ead6811973e99e1e742dd8a,1,2,1,3,2,2007-06-25 12:56:52,2007-06-25 12:56:52
9c5994743c16fba36ead6811973e99e1e742dd8a...daaa3a1dde1d400d57206b258ae62282521461c3,2,4,1,5,2,2007-06-25 13:11:10,2007-06-25 13:11:10
daaa3a1dde1d400d57206b258ae62282521461c3...03ec6423c4850b141730333be4898858e0d45068,1,8,2,10,4,2007-06-25 13:46:01,2007-06-25 13:46:01
03ec6423c4850b141730333be4898858e0d45068...dbb785c0b4da1103368cc2d1e368d91063117ec6,2,4,60,64,6,2007-06-25 14:40:08,2007-06-25 14:40:08
dbb785c0b4da1103368cc2d1e368d91063117ec6...b89d409bf7ed7f9d6248c1ec188e241bdf5d4aa2,1,1,1,2,1,2007-06-26 13:55:28,2007-06-26 13:55:28
b89d409bf7ed7f9d6248c1ec188e241bdf5d4aa2...a61d4ebd5f4b49b296063eae603faa3c456d26e5,50,1899,527,2426,528,2007-07-01 05:55:01,2007-07-01 05:55:01
a61d4ebd5f4b49b296063eae603faa3c456d26e5...5eb53a6397bcd58563abe1a2bd9bd65b74349b7a,1,20,9,29,3,2007-07-01 06:27:07,2007-07-01 06:27:07
5eb53a6397bcd58563abe1a2bd9bd65b74349b7a...9bf4bacf1346d9f8e3ffff85ece5d52c1d24b902,2,54,20,74,14,2007-07-02 07:43:36,2007-07-02 07:43:36
9bf4bacf1346d9f8e3ffff85ece5d52c1d24b902...fc8bdc1af48d4c4e5468669af1fd89dfa2092658,3,18,9,27,5,2007-07-02 12:24:58,2007-07-02 12:24:58
fc8bdc1af48d4c4e5468669af1fd89dfa2092658...c62d6eea19a1e3737ceb2af7f2f75fe727c51906,1,2,0,2,1,2007-07-03 12:35:24,2007-07-03 12:35:24
c62d6eea19a1e3737ceb2af7f2f75fe727c51906...1feda14c8e14eb4d716d725a58add6dbbb04bd5f,8,195,191,386,59,2007-07-03 18:29:56,2007-07-03 18:29:56
1feda14c8e14eb4d716d725a58add6dbbb04bd5f...c4b260a4b6303bea20d7f511fa832a1c122c02c0,7,52,26,78,26,2007-07-04 06:02:00,2007-07-04 06:02:00
c4b260a4b6303bea20d7f511fa832a1c122c02c0...9b89357747c200f19681d50a30a954451a09d27d,1,1,1,2,1,2007-07-04 06:05:45,2007-07-04 06:05:45
9b89357747c200f19681d50a30a954451a09d27d...0084147c4bce4472b3f2ae321a7757fe2b7f1d27,1,2,0,2,1,2007-07-04 06:50:23,2007-07-04 06:50:23
0084147c4bce4472b3f2ae321a7757fe2b7f1d27...216fae2352871e04e8edd44045c63bf5379ab229,1,2,3,5,1,2007-07-04 08:36:05,2007-07-04 08:36:05
216fae2352871e04e8edd44045c63bf5379ab229...5664a678b29ab04cad425c15b2792f4519f43928,3,105,4,109,6,2007-07-04 09:28:29,2007-07-04 09:28:29
ced74d582a10c11e0d774b4dbd260e90db013da5...863ee0ef899d93cb7da65510e7059dd99fcbe79f,1,1,1,2,1,2007-09-13 14:37:22,2007-09-13 14:37:22
863ee0ef899d93cb7da65510e7059dd99fcbe79f...ed5a91f42896a3f05b8995096d5e1d9fd65ba428,1,1,1,2,1,2007-09-13 14:38:25,2007-09-13 14:38:25
ed5a91f42896a3f05b8995096d5e1d9fd65ba428...a31bbda980b07fd54123ef44f8df1f0621c3677b,1,3,0,3,1,2007-09-13 14:40:08,2007-09-13 14:40:08
a31bbda980b07fd54123ef44f8df1f0621c3677b...28d27a77e8f5d80844c7b7ca54b1e1731ec8b3e0,1,1,1,2,1,2007-09-13 14:41:38,2007-09-13 14:41:38
28d27a77e8f5d80844c7b7ca54b1e1731ec8b3e0...196ec225c5c9e035cab278078ea3dabfb9f2159a,2,2,2,4,2,2007-09-13 19:27:50,2007-09-13 19:27:50
196ec225c5c9e035cab278078ea3dabfb9f2159a...ce04b033230e3cc2293b67c1d590319aad6fd640,3,2245,1397,3642,445,2007-09-13 19:28:24,2007-09-13 19:28:24
ce04b033230e3cc2293b67c1d590319aad6fd640...6e7ad62a78bf64fd11615d91975af1660cacb8f9,2,163,69,232,70,2007-09-13 19:38:24,2007-09-13 19:38:24
6e7ad62a78bf64fd11615d91975af1660cacb8f9...fab3d388d275b40865607e6e2bf580a077becc12,5,3077,1599,4676,437,2007-09-13 19:39:10,2007-09-13 19:39:10
fab3d388d275b40865607e6e2bf580a077becc12...2190c97ef5f822bc69ed4272dd9b614ffd9f0893,2,863,378,1241,345,2007-09-13 19:39:50,2007-09-13 19:39:50
2190c97ef5f822bc69ed4272dd9b614ffd9f0893...972e77f7e87fadc7d252d96b8b046a6dde6d8074,6,2618,0,2618,4,2007-09-13 19:51:26,2007-09-13 19:51:26
972e77f7e87fadc7d252d96b8b046a6dde6d8074...5724e3335456a98650b93f06d7ceb33ccca5c870,2,6,0,6,1,2007-09-13 19:51:53,2007-09-13 19:51:53
5724e3335456a98650b93f06d7ceb33ccca5c870...c42fd0766735f8f565a9761b57d2e265430aeda0,4,2101,1494,3595,456,2007-09-13 19:52:26,2007-09-13 19:52:26
c42fd0766735f8f565a9761b57d2e265430aeda0...3ac39749b1cbb33eacd2780127f53e6d66f074aa,3,6,5,11,6,2007-09-13 19:52:59,2007-09-13 19:52:59
3ac39749b1cbb33eacd2780127f53e6d66f074aa...da7495cfa51ff2eb0f07d6812e22f9029d388fab,2,2,2,4,2,2007-09-13 21:54:48,2007-09-13 21:54:48
da7495cfa51ff2eb0f07d6812e22f9029d388fab...a9fd677cb3167afbe0b27bf1a8fe5a16eaad5908,5,177,1,178,4,2007-09-13 22:16:59,2007-09-13 22:16:59
a9fd677cb3167afbe0b27bf1a8fe5a16eaad5908...e1cb961a9b7d6440cad468148ebcffc841ac81a3,1,2,1,3,2,2007-09-13 22:35:18,2007-09-13 22:35:18
e1cb961a9b7d6440cad468148ebcffc841ac81a3...a7d0ad67dcd6e47d4905331187def49271ad8084,2,6,1,7,3,2007-09-13 22:42:30,2007-09-13 22:42:30
a7d0ad67dcd6e47d4905331187def49271ad8084...ce249d4366a800ebc033cefb8beb33b9b0dba051,3,54,4,58,7,2007-09-13 23:09:40,2007-09-13 23:09:40
ce249d4366a800ebc033cefb8beb33b9b0dba051...1b0e58811841858a6108ea7188625d3bd0d41ace,1,19,13,32,4,2007-09-13 23:30:26,2007-09-13 23:30:26
1b0e58811841858a6108ea7188625d3bd0d41ace...4fd2b0ca77c135e39b52bd8081067b9365f9fb9f,1,3,0,3,1,2007-09-14 00:52:39,2007-09-14 00:52:39
4fd2b0ca77c135e39b52bd8081067b9365f9fb9f...cb9db449380d80f1e5856e64fd7cde15da63a315,4,431,0,431,3,2007-09-14 00:58:57,2007-09-14 00:58:57
cb9db449380d80f1e5856e64fd7cde15da63a315...87e77ffca0a7df59ff9407ef30a2baa90f1d872d,4,26,1,27,8,2007-09-14 01:01:02,2007-09-14 01:01:02
87e77ffca0a7df59ff9407ef30a2baa90f1d872d...1e94ef85bf3ea6f0195314ed0d7f2fb051c33ef3,1,5,3,8,3,2007-09-14 01:21:34,2007-09-14 01:21:34
1e94ef85bf3ea6f0195314ed0d7f2fb051c33ef3...62fe5cf138b406a2e478bd5a26b1227d1190e186,2,12,0,12,2,2007-09-14 01:45:26,2007-09-14 01:45:26
62fe5cf138b406a2e478bd5a26b1227d1190e186...d14c756b5e30c73fcb973905b67f091169d33595,2,31,16,47,5,2007-09-14 01:52:10,2007-09-14 01:52:10
d14c756b5e30c73fcb973905b67f091169d33595...0b1f4e3c7beb6f205515f11f443aa8ae99e07656,2,35,0,35,3,2007-09-14 02:01:11,2007-09-14 02:01:11
0b1f4e3c7beb6f205515f11f443aa8ae99e07656...8b0eaba0ee66e2ec6307ae9e34cf8610614d67a6,2,12,8,20,2,2007-09-14 02:05:45,2007-09-14 02:05:45
8b0eaba0ee66e2ec6307ae9e34cf8610614d67a6...a2ce7669d902cf32eeac9307b804b78ed4150fe5,2,16,6,22,4,2007-09-14 02:11:24,2007-09-14 02:11:24
a2ce7669d902cf32eeac9307b804b78ed4150fe5...09145d2e5f1445d59d0c121394b78ec5ed196056,17,63,48,111,36,2007-09-14 02:49:21,2007-09-14 02:49:21
09145d2e5f1445d59d0c121394b78ec5ed196056...da0fef756c0e47e549cba1edc1f3900973e2b70a,1,1,0,1,1,2007-09-14 02:54:12,2007-09-14 02:54:12
da0fef756c0e47e549cba1edc1f3900973e2b70a...813c48e6eb146a06d40b4d11efebee1d1493665d,1,3,0,3,1,2007-09-14 03:17:46,2007-09-14 03:17:46
813c48e6eb146a06d40b4d11efebee1d1493665d...70e5dce3651de6f5494233802a5de609182045df,3,16,1,17,8,2007-09-14 03:29:39,2007-09-14 03:29:39
70e5dce3651de6f5494233802a5de609182045df...2bec822ff345ed68047d618f707bb2765fad7e5f,2,10,3,13,5,2007-09-14 03:54:28,2007-09-14 03:54:28
2bec822ff345ed68047d618f707bb2765fad7e5f...e86d35879fa7b111d271dfab393a7691b90fca6c,1,9,5,14,3,2007-09-14 04:04:51,2007-09-14 04:04:51
e86d35879fa7b111d271dfab393a7691b90fca6c...6767849212f8229c12d4daa6be45a24f417bce03,1,2,2,4,1,2007-09-14 04:12:02,2007-09-14 04:12:02
6767849212f8229c12d4daa6be45a24f417bce03...4d25f8655b90b74235e9f1e5c3ba156a34c3b581,1,9,6,15,2,2007-09-14 04:15:55,2007-09-14 04:15:55
4d25f8655b90b74235e9f1e5c3ba156a34c3b581...e336722fd1c396cf964e987432fbfcb7f4706379,1,7,3,10,2,2007-09-14 04:24:58,2007-09-14 04:24:58
e336722fd1c396cf964e987432fbfcb7f4706379...dc785104b8ffb33c57f5e17209743516c1bd88ae,1,3,0,3,1,2007-09-14 04:55:09,2007-09-14 04:55:09
dc785104b8ffb33c57f5e17209743516c1bd88ae...e70d7e60640e280f8d410d41c1f9cb6195483c4e,5,55,9,64,11,2007-09-14 05:28:00,2007-09-14 05:28:00
e70d7e60640e280f8d410d41c1f9cb6195483c4e...30b24a6ccece2131aa2fd931ac157cda5a2bb1b6,1,1,62,63,3,2007-09-14 05:33:39,2007-09-14 05:33:39
30b24a6ccece2131aa2fd931ac157cda5a2bb1b6...300e19effca99319991d5ca0323bfc9a869a0515,1,9,2,11,2,2007-09-14 05:39:42,2007-09-14 05:39:42
300e19effca99319991d5ca0323bfc9a869a0515...1b745be5a1c16d6f807113013ff6234e74f1b6ec,1,1,1,2,1,2007-09-14 05:39:59,2007-09-14 05:39:59
1b745be5a1c16d6f807113013ff6234e74f1b6ec...2083c53afce6403d5822e80b4c5dc0b0555708c8,0,0,0,0,0,2007-09-14 05:56:47,2007-09-14 05:56:47
2083c53afce6403d5822e80b4c5dc0b0555708c8...eabb57f6f089bbd3c528eddc93ad61829afb5d7a,2,9,9,18,9,2007-09-14 06:05:54,2007-09-14 06:05:54
eabb57f6f089bbd3c528eddc93ad61829afb5d7a...3f030a747267b0d73fb3cf5e0dff0bdae40e9653,1,0,11,11,1,2007-09-14 06:09:15,2007-09-14 06:09:15
3f030a747267b0d73fb3cf5e0dff0bdae40e9653...134bf3a26bc9ac39ca736c13381034d470014170,1,62,1,63,3,2007-09-14 06:21:25,2007-09-14 06:21:25
134bf3a26bc9ac39ca736c13381034d470014170...3358e2fec701fc7523e126433c87428e7a540b5f,1,14,2,16,5,2007-09-14 06:43:46,2007-09-14 06:43:46
3358e2fec701fc7523e126433c87428e7a540b5f...20ecbbd9e749f7abd0a7ffcc61b01cb874846817,2,12,8,20,4,2007-09-14 07:02:55,2007-09-14 07:02:55
20ecbbd9e749f7abd0a7ffcc61b01cb874846817...0863a634f3ddcbb6b20f6033844d70d28947f1ab,1,2,1,3,2,2007-09-14 07:12:47,2007-09-14 07:12:47
0863a634f3ddcbb6b20f6033844d70d28947f1ab...63dd4f53220fa7a1962d69f1ea17ab03438bfd2a,2,18,8,26,2,2007-09-14 07:18:27,2007-09-14 07:18:27
63dd4f53220fa7a1962d69f1ea17ab03438bfd2a...5188a18dbed4182a602b540e7ce47eb781b0c704,2,48,8,56,10,2007-09-14 07:19:38,2007-09-14 07:19:38
5188a18dbed4182a602b540e7ce47eb781b0c704...99d12c5d7054529fa8a87148cc17ca4f639b620c,1,13,7,20,3,2007-09-14 07:33:45,2007-09-14 07:33:45
99d12c5d7054529fa8a87148cc17ca4f639b620c...518bc15b218d1fc971757b6d72decc2576cd9b53,1,43,18,61,14,2007-09-14 08:04:07,2007-09-14 08:04:07
518bc15b218d1fc971757b6d72decc2576cd9b53...bc216120126be2e792b1e9cf215a4f62b1dfc07c,1,2,2,4,1,2007-09-14 08:29:51,2007-09-14 08:29:51
bc216120126be2e792b1e9cf215a4f62b1dfc07c...36396fb4307af9764b2f8c53f8f0fcb926be249e,2,43,1,44,4,2007-09-14 08:37:09,2007-09-14 08:37:09
36396fb4307af9764b2f8c53f8f0fcb926be249e...c040f1cc926dfe899eeffef4c3f24551f5d8b3b0,1,1,0,1,1,2007-09-14 08:37:23,2007-09-14 08:37:23
c040f1cc926dfe899eeffef4c3f24551f5d8b3b0...fa5e935af02eed26d8e607ed55e3ba3500811601,1,1,1,2,1,2007-09-14 08:49:02,2007-09-14 08:49:02
fa5e935af02eed26d8e607ed55e3ba3500811601...ea3e89cb1d32f1fc6cafa656a4d6d9863f2fefc5,4,14,2,16,4,2007-09-14 09:55:17,2007-09-14 09:55:17
ea3e89cb1d32f1fc6cafa656a4d6d9863f2fefc5...0f03d9b6cb92ca2720d9ea472931e922f1d1ba37,1,1,1,2,1,2007-09-14 10:11:02,2007-09-14 10:11:02
0f03d9b6cb92ca2720d9ea472931e922f1d1ba37...ced90f4b810c8d7213bf5bd1bee1756f459fda1e,2,1,1,2,1,2007-09-14 12:39:03,2007-09-14 12:39:03
ced90f4b810c8d7213bf5bd1bee1756f459fda1e...b7df72083958122194740fdb5a9f7d4714114e37,1,0,3,3,3,2007-09-14 12:48:10,2007-09-14 12:48:10
b7df72083958122194740fdb5a9f7d4714114e37...595bf6b691c8ee3738d84f5cf15670ec6c3a01a6,1,6,4,10,1,2007-09-14 13:56:36,2007-09-14 13:56:36
595bf6b691c8ee3738d84f5cf15670ec6c3a01a6...7ed3196536518498c99524e3ef40e36e5236da60,1,2,0,2,1,2007-09-14 15:21:30,2007-09-14 15:21:30
7ed3196536518498c99524e3ef40e36e5236da60...f7e1047b088a38e380325ef1f20b64d68573f4b1,1,18,14,32,6,2007-09-14 15:33:42,2007-09-14 15:33:42
f7e1047b088a38e380325ef1f20b64d68573f4b1...4b9148ac19b2778c5f54220830f52957536e52db,1,13,11,24,7,2007-09-14 16:40:42,2007-09-14 16:40:42
4b9148ac19b2778c5f54220830f52957536e52db...f36e96cc9c6c1e99fb55cfc6940f04fa9a7c86ff,1,7,0,7,1,2007-09-14 16:44:53,2007-09-14 16:44:53
f36e96cc9c6c1e99fb55cfc6940f04fa9a7c86ff...42f4f44356044ee57b7efd32a423c01e2b9454bc,2,7,1,8,2,2007-09-14 16:48:47,2007-09-14 16:48:47
42f4f44356044ee57b7efd32a423c01e2b9454bc...933cda3749865b0c776a21b39076c500ddcbe12f,1,9,1,10,2,2007-09-14 17:17:37,2007-09-14 17:17:37
933cda3749865b0c776a21b39076c500ddcbe12f...93f60163e87036dac3dbfbbe09bdd7c7c195dd67,6,20,10,30,11,2007-09-14 18:12:36,2007-09-14 18:12:36
93f60163e87036dac3dbfbbe09bdd7c7c195dd67...9f83beb372be120d747519033a8c00b6a3b7ac00,1,1,1,2,1,2007-09-14 18:25:22,2007-09-14 18:25:22
9f83beb372be120d747519033a8c00b6a3b7ac00...55d34c6cb37fd7459634849a232ed225d90e4583,1,1,0,1,1,2007-09-14 18:26:05,2007-09-14 18:26:05
55d34c6cb37fd7459634849a232ed225d90e4583...a6b1d65e33d3ff44fd81f6497e812f89f9c3d9e0,2,8,0,8,3,2007-09-14 18:26:07,2007-09-14 18:26:07
a6b1d65e33d3ff44fd81f6497e812f89f9c3d9e0...c998feb3bb97cfd8f7ca00aeb6a0fa61f4815f07,1,2,1,3,2,2007-09-14 18:29:34,2007-09-14 18:29:34
c998feb3bb97cfd8f7ca00aeb6a0fa61f4815f07...eea935a7f410b6ebda562d3d24d72f2b3fdda4b9,3,8,2,10,5,2007-09-14 18:36:04,2007-09-14 18:36:04
eea935a7f410b6ebda562d3d24d72f2b3fdda4b9...74b816ae9c9573984f734cdc9e5c2a7005a9b718,1,25,0,25,2,2007-09-14 18:59:20,2007-09-14 18:59:20
74b816ae9c9573984f734cdc9e5c2a7005a9b718...7e4da4e66dce7ebb30dbaf4db4426e45b0ca27ea,2,219,0,219,2,2007-09-14 19:02:05,2007-09-14 19:02:05
7e4da4e66dce7ebb30dbaf4db4426e45b0ca27ea...725716b5f5de01e374c9015d02baf25029a0f3c7,3,169,0,169,2,2007-09-14 19:08:19,2007-09-14 19:08:19
725716b5f5de01e374c9015d02baf25029a0f3c7...fe78237a220ad841d806dd9ee53961e7c1d3c7b2,2,30,6,36,5,2007-09-14 19:17:15,2007-09-14 19:17:15
fe78237a220ad841d806dd9ee53961e7c1d3c7b2...0d52d2b2f90ea12c2ca721a46052b0c17bae3b47,2,6,3,9,2,2007-09-14 19:22:43,2007-09-14 19:22:43
0d52d2b2f90ea12c2ca721a46052b0c17bae3b47...55d6aebfecb527d64f50e608bb51cb5ea81f4c62,6,58,10,68,15,2007-09-14 19:25:37,2007-09-14 19:25:37
55d6aebfecb527d64f50e608bb51cb5ea81f4c62...525af7d5804852d4de0f2676990d19ff9dae969f,3,196,0,196,2,2007-09-14 19:28:26,2007-09-14 19:28:26
525af7d5804852d4de0f2676990d19ff9dae969f...1ea702dd2323c71791855b351283066f507d4d8c,1,1,1,2,1,2007-09-14 19:49:51,2007-09-14 19:49:51
1ea702dd2323c71791855b351283066f507d4d8c...ad077ccbc03f11c3db3951aab110ec98c5907729,6,29,13,42,11,2007-09-14 19:55:24,2007-09-14 19:55:24
ad077ccbc03f11c3db3951aab110ec98c5907729...3da4c0ab9292e8e3378b7314174f0bbcc4e692d1,1,5,9,14,5,2007-09-14 20:34:29,2007-09-14 20:34:29
3da4c0ab9292e8e3378b7314174f0bbcc4e692d1...9cccf59db53e4b793e6932a01acb1b990fa87257,2,17,0,17,3,2007-09-14 20:36:53,2007-09-14 20:36:53
9cccf59db53e4b793e6932a01acb1b990fa87257...66e45411017a4526670ba2c4e465c3ca45d55602,1,13,0,13,1,2007-09-14 21:04:45,2007-09-14 21:04:45
66e45411017a4526670ba2c4e465c3ca45d55602...e259b8712ad87d1a398d46c593fa81a824041e5d,1,41,0,41,1,2007-09-14 21:09:38,2007-09-14 21:09:38
e259b8712ad87d1a398d46c593fa81a824041e5d...aff47aa5ed8febc80aacb9e9e723ce5ef9a74066,1,2,1,3,1,2007-09-14 21:30:13,2007-09-14 21:30:13
aff47aa5ed8febc80aacb9e9e723ce5ef9a74066...f180d95903d298e7fed54d777e781a9271e469d7,2,32,20,52,4,2007-09-14 21:32:25,2007-09-14 21:32:25
f180d95903d298e7fed54d777e781a9271e469d7...06f4c38b55f82333b195630b30c3a54a044174af,1,1,1,2,1,2007-09-14 21:36:39,2007-09-14 21:36:39
06f4c38b55f82333b195630b30c3a54a044174af...5a5d8a90b54e88e561b4e1e3c65c67b9307244c2,2,29,0,29,1,2007-09-14 21:38:45,2007-09-14 21:38:45
5a5d8a90b54e88e561b4e1e3c65c67b9307244c2...4100eab823202a26a7b8227d9b2d1a8c7811c1d7,2,3,1,4,2,2007-09-14 21:41:48,2007-09-14 21:41:48
4100eab823202a26a7b8227d9b2d1a8c7811c1d7...b5224693222a96a42e446e737f40fe9c8a48cf07,1,2,2,4,2,2007-09-14 21:42:26,2007-09-14 21:42:26
b5224693222a96a42e446e737f40fe9c8a48cf07...cadc6e8c9fab8c56d50e8bb3e92519e0caca03b7,2,14,4,18,4,2007-09-14 21:46:38,2007-09-14 21:46:38
cadc6e8c9fab8c56d50e8bb3e92519e0caca03b7...8cf9a6d64bd8f246dc1e0b800bf67c689cfeac5c,1,10,0,10,1,2007-09-14 21:48:50,2007-09-14 21:48:50
8cf9a6d64bd8f246dc1e0b800bf67c689cfeac5c...dd799591fc9f6ab0d988e0dc82f47276bdab6b2a,1,6,6,12,6,2007-09-14 21:53:13,2007-09-14 21:53:13
dd799591fc9f6ab0d988e0dc82f47276bdab6b2a...ddd3d7c71fb25e3685f17b6a231addf143e2741b,1,2,2,4,2,2007-09-14 21:53:15,2007-09-14 21:53:15
ddd3d7c71fb25e3685f17b6a231addf143e2741b...4f70820dc19c157ea0abc14a2b96ffbb1eccf47e,1,1,1,2,1,2007-09-14 21:58:17,2007-09-14 21:58:17
4f70820dc19c157ea0abc14a2b96ffbb1eccf47e...59964c2c3fba3a59d43e7514e1478cca46852595,2,5,1,6,2,2007-09-14 22:03:47,2007-09-14 22:03:47
59964c2c3fba3a59d43e7514e1478cca46852595...dfdbf9ec1e50ac0416297503b05322cdd2f5234a,1,5,3,8,3,2007-09-14 22:05:58,2007-09-14 22:05:58
dfdbf9ec1e50ac0416297503b05322cdd2f5234a...17cd87a264d8719e82773ace080df25bad88cbef,1,12,6,18,4,2007-09-14 22:07:54,2007-09-14 22:07:54
17cd87a264d8719e82773ace080df25bad88cbef...27d027782cc1a99ad22105a39d3bab17ef871cf3,1,13,0,13,2,2007-09-14 22:16:14,2007-09-14 22:16:14
27d027782cc1a99ad22105a39d3bab17ef871cf3...eb11615baa96bc53226d99819d6ac59b7154f9ab,1,4,1,5,1,2007-09-14 22:29:37,2007-09-14 22:29:37
eb11615baa96bc53226d99819d6ac59b7154f9ab...71796410ba8e292a39610a4435f7693ca37b4289,1,111,9,120,8,2007-09-14 22:33:06,2007-09-14 22:33:06
71796410ba8e292a39610a4435f7693ca37b4289...ca9388cdaf905e12560c751ca55f8237303e4494,4,10,4,14,4,2007-09-14 22:33:56,2007-09-14 22:33:56
ca9388cdaf905e12560c751ca55f8237303e4494...03652c7f2b3a71d814fba818d3991b309c9cb888,3,30,16,46,22,2007-09-14 22:36:15,2007-09-14 22:36:15
03652c7f2b3a71d814fba818d3991b309c9cb888...e74880ed22889bf935ff10b4c257b8d677adebda,1,1,2,3,1,2007-09-14 22:49:01,2007-09-14 22:49:01
e74880ed22889bf935ff10b4c257b8d677adebda...5af2af3e332760bdeec9357cca09707f98854525,1,1,5,6,1,2007-09-14 22:54:58,2007-09-14 22:54:58
5af2af3e332760bdeec9357cca09707f98854525...4c0ac53ff899bb9931d8c518fd1a643aca584f49,1,1,0,1,1,2007-09-14 23:02:39,2007-09-14 23:02:39
4c0ac53ff899bb9931d8c518fd1a643aca584f49...6c16d84a0bd830b0d5f9455f43b42c8f4a483b80,1,2,2,4,2,2007-09-14 23:09:05,2007-09-14 23:09:05
6c16d84a0bd830b0d5f9455f43b42c8f4a483b80...92e55fe8b1ff5ed8867d9fe09b789cf493050623,4,101,44,145,4,2007-09-14 23:15:40,2007-09-14 23:15:40
92e55fe8b1ff5ed8867d9fe09b789cf493050623...8c5214d9b4f53e540f061b10193e04fbb0acfd07,1,1,1,2,1,2007-09-14 23:23:55,2007-09-14 23:23:55
8c5214d9b4f53e540f061b10193e04fbb0acfd07...ad821b645968d905556b5d7811acec4af754a62b,1,7,1,8,2,2007-09-15 00:08:08,2007-09-15 00:08:08
ad821b645968d905556b5d7811acec4af754a62b...c74ebab686021f3439634b658afb5130b71677e8,1,5,5,10,5,2007-09-15 00:19:22,2007-09-15 00:19:22
c74ebab686021f3439634b658afb5130b71677e8...ce53de47a2702f9b09ff9363929057736660567b,1,1,1,2,1,2007-09-15 01:02:45,2007-09-15 01:02:45
ce53de47a2702f9b09ff9363929057736660567b...cf3c94b26dc76ee5493c206d64f5095b994afd63,2,31,0,31,3,2007-09-15 02:37:07,2007-09-15 02:37:07
cf3c94b26dc76ee5493c206d64f5095b994afd63...e35321b5c301c64c24b0bdc7e82abfcb7da9ecc6,2,2234,1755,3989,435,2007-09-15 04:14:24,2007-09-15 04:14:24
e35321b5c301c64c24b0bdc7e82abfcb7da9ecc6...036e4575df1dcb93ea6e660b418a6fdd7935f543,2,2222,2279,4501,498,2007-09-15 04:14:56,2007-09-15 04:14:56
036e4575df1dcb93ea6e660b418a6fdd7935f543...bdba94d78f4b3faa3ae393ea0fcd29d254a4d6e8,1,2,3,5,1,2007-09-15 04:30:15,2007-09-15 04:30:15
bdba94d78f4b3faa3ae393ea0fcd29d254a4d6e8...5ce8a389332f289bd99e95978154c790f35f2405,6,3561,0,3561,4,2007-09-15 04:43:48,2007-09-15 04:43:48
5ce8a389332f289bd99e95978154c790f35f2405...042d87b98c641514964497a26acf790a1f42880b,1,0,1,1,1,2007-09-15 04:52:48,2007-09-15 04:52:48
042d87b98c641514964497a26acf790a1f42880b...4ed5eafe878778f6f15d9ea8aa84b2aed1bb2ecd,1,1,1,2,1,2007-09-15 04:53:35,2007-09-15 04:53:35
4ed5eafe878778f6f15d9ea8aa84b2aed1bb2ecd...435ff875f5becd659c484378bad3883199341075,2,2873,1330,4203,401,2007-09-15 04:54:17,2007-09-15 04:54:17
435ff875f5becd659c484378bad3883199341075...a6048960424fb20b7f0b70b8181b8cf8f1b7d316,2,19,6,25,3,2007-09-15 04:58:41,2007-09-15 04:58:41
a6048960424fb20b7f0b70b8181b8cf8f1b7d316...16906ea79388e16e57995ab8d93856515d3b42c2,1,1,1,2,1,2007-09-15 05:00:21,2007-09-15 05:00:21
16906ea79388e16e57995ab8d93856515d3b42c2...5c3905cf48813d63764f3049e79aa2d668b53be1,1,1,1,2,1,2007-09-15 05:01:58,2007-09-15 05:01:58
5c3905cf48813d63764f3049e79aa2d668b53be1...604504896c4290f1bfa45448bc6c4f553df0a801,1,2,0,2,1,2007-09-15 05:14:16,2007-09-15 05:14:16
604504896c4290f1bfa45448bc6c4f553df0a801...314536190b3561f6b3768e26cf36291898bb7b4c,3,54,9,63,11,2007-09-15 05:32:29,2007-09-15 05:32:29
314536190b3561f6b3768e26cf36291898bb7b4c...072dfaa1ddfe86e73dc6900745d98a220d555128,0,0,0,0,0,2007-09-15 05:37:35,2007-09-15 05:37:35
072dfaa1ddfe86e73dc6900745d98a220d555128...c59903101a6fbef18c18682b4fdea8d997bc7d4f,1,6,5,11,6,2007-09-15 05:50:45,2007-09-15 05:50:45
c59903101a6fbef18c18682b4fdea8d997bc7d4f...671a8359e8a2c869264e913ace1a0e03be193d13,1,1,1,2,1,2007-09-15 08:05:32,2007-09-15 08:05:32
671a8359e8a2c869264e913ace1a0e03be193d13...84e824fbbf7b1c90e0d6191e8e69577cfce0664b,5,33,34,67,14,2007-09-15 08:29:56,2007-09-15 08:29:56
84e824fbbf7b1c90e0d6191e8e69577cfce0664b...1baae32e16e8eee5bc239bfea8674651b765a41f,4,89,1,90,4,2007-09-15 09:14:51,2007-09-15 09:14:51
1baae32e16e8eee5bc239bfea8674651b765a41f...cd8959c82ace7105d47a082cc7c4a07f61f94f60,2,11,2,13,3,2007-09-15 09:51:41,2007-09-15 09:51:41
cd8959c82ace7105d47a082cc7c4a07f61f94f60...8a17181b58c616522a4e773cf5a1f9ce768bf685,1,6,0,6,1,2007-09-15 09:51:57,2007-09-15 09:51:57
8a17181b58c616522a4e773cf5a1f9ce768bf685...32ed883861ecded14e51dd8b72d097bc37572c6c,1,4,4,8,3,2007-09-15 10:11:26,2007-09-15 10:11:26
32ed883861ecded14e51dd8b72d097bc37572c6c...f0cd172cd0bccc519a6ecdf41b6a10b46ccffbcf,5,53,0,53,6,2007-09-15 10:12:05,2007-09-15 10:12:05
f0cd172cd0bccc519a6ecdf41b6a10b46ccffbcf...c96c57afadbab2b3f79e231be64b3576d21313ff,1,1,0,1,1,2007-09-15 10:17:50,2007-09-15 10:17:50
c96c57afadbab2b3f79e231be64b3576d21313ff...b984505d1367da35d38ae3c2a81a610d8657300a,2,10,4,14,2,2007-09-15 10:36:14,2007-09-15 10:36:14
b984505d1367da35d38ae3c2a81a610d8657300a...39814eeb54ca37abbc0c6111504aa7d17984a5f7,2,13,0,13,3,2007-09-15 10:57:03,2007-09-15 10:57:03
39814eeb54ca37abbc0c6111504aa7d17984a5f7...7a6abfdd3bca22b7cffbaaa91b872f28be7c12e6,1,1,2,3,2,2007-09-15 11:06:32,2007-09-15 11:06:32
7a6abfdd3bca22b7cffbaaa91b872f28be7c12e6...b361947745971eac1f875271cf084c0516496264,1,2,1,3,2,2007-09-15 11:12:54,2007-09-15 11:12:54
b361947745971eac1f875271cf084c0516496264...09060e9bc8377303f16a7226189e28b915313dc2,1,5,5,10,2,2007-09-15 11:13:21,2007-09-15 11:13:21
09060e9bc8377303f16a7226189e28b915313dc2...ff25059ffb751bb50e363ef53f79a1e4382705bc,1,4,1,5,1,2007-09-15 11:19:35,2007-09-15 11:19:35
ff25059ffb751bb50e363ef53f79a1e4382705bc...7ca1a04633a7516df3610ff97a83d8850219622d,1,7,3,10,2,2007-09-15 11:19:50,2007-09-15 11:19:50
7ca1a04633a7516df3610ff97a83d8850219622d...885db3cb793ac1a7c269a67b5739dfc4dbe6214d,2,16,2,18,5,2007-09-15 11:45:19,2007-09-15 11:45:19
885db3cb793ac1a7c269a67b5739dfc4dbe6214d...b2f92dfcc511d5bb03e9bd81e073ee7a4e37e7d0,3,96,0,96,2,2007-09-15 12:20:35,2007-09-15 12:20:35
b2f92dfcc511d5bb03e9bd81e073ee7a4e37e7d0...e582777eaebfb2f8b1716be757eea8399caae10f,0,0,0,0,0,2007-09-15 12:31:33,2007-09-15 12:31:33
e582777eaebfb2f8b1716be757eea8399caae10f...9d18227a56a2b23d065dcf73c119ec3273ed2318,1,4,0,4,1,2007-09-15 14:03:07,2007-09-15 14:03:07
9d18227a56a2b23d065dcf73c119ec3273ed2318...8e970f4835074d887c7f65b53c9dbb067f953e64,1,3,3,6,2,2007-09-15 14:46:41,2007-09-15 14:46:41
8e970f4835074d887c7f65b53c9dbb067f953e64...7c27f3e7baeb5393aeb06c476fdb52ea3a7cdc65,3,23,13,36,11,2007-09-15 15:06:32,2007-09-15 15:06:32
7c27f3e7baeb5393aeb06c476fdb52ea3a7cdc65...951ecbf7e6fd1abdf0857b2ab51aacf240b01fe5,1,6,6,12,4,2007-09-15 15:17:18,2007-09-15 15:17:18
951ecbf7e6fd1abdf0857b2ab51aacf240b01fe5...d30badc0eccbb05b54a5cb4c9fc146d6b4ba6010,2,2,1,3,2,2007-09-15 15:57:17,2007-09-15 15:57:17
d30badc0eccbb05b54a5cb4c9fc146d6b4ba6010...1788b0c96fe2afdd8b14ab1ca06f27ce4f31ba8d,1,4,4,8,4,2007-09-15 16:18:44,2007-09-15 16:18:44
1788b0c96fe2afdd8b14ab1ca06f27ce4f31ba8d...e461646b94d79cc72f76979a60b86ec83900ae6e,2,4,3,7,3,2007-09-15 16:19:10,2007-09-15 16:19:10
e461646b94d79cc72f76979a60b86ec83900ae6e...8d3d5a37b440c8b813d20d611ed957e997e94671,1,1,1,2,1,2007-09-15 16:34:41,2007-09-15 16:34:41
8d3d5a37b440c8b813d20d611ed957e997e94671...7b172de6fa4aa6da82211bae05a9388b0d96e12a,1,3,0,3,1,2007-09-15 17:30:23,2007-09-15 17:30:23
7b172de6fa4aa6da82211bae05a9388b0d96e12a...b7e90a0abd59e55f1ba2ef5686bc0fe2da903149,1,68,68,136,15,2007-09-15 17:32:53,2007-09-15 17:32:53
b7e90a0abd59e55f1ba2ef5686bc0fe2da903149...061ed82b22679113d65a69b0a41ba22d3ae618d3,1,25,4,29,1,2007-09-15 17:44:14,2007-09-15 17:44:14
061ed82b22679113d65a69b0a41ba22d3ae618d3...4b610f42d36a39cd975122ab46f85323844c2c72,5,23,20,43,11,2007-09-15 17:46:03,2007-09-15 17:46:03
4b610f42d36a39cd975122ab46f85323844c2c72...bf3c1cf7bf0c44cb6f8efe0e86e9bb7ec28f54d6,1,3,3,6,2,2007-09-15 17:48:59,2007-09-15 17:48:59
bf3c1cf7bf0c44cb6f8efe0e86e9bb7ec28f54d6...4f87e34315eef2d6f799afa32d99e4ee8d6c6cc5,2,2,2,4,2,2007-09-15 17:56:36,2007-09-15 17:56:36
4f87e34315eef2d6f799afa32d99e4ee8d6c6cc5...388182b62299e063f843b0157e510a4021f7acfd,4,23,3,26,8,2007-09-15 18:01:29,2007-09-15 18:01:29
388182b62299e063f843b0157e510a4021f7acfd...84fc132044179cfd2a190ba387ccea58fc63e146,1,1,0,1,1,2007-09-15 18:11:43,2007-09-15 18:11:43
84fc132044179cfd2a190ba387ccea58fc63e146...e90eb41a4a1814ce3524fd46d97b1c32e537b9ea,1,258,0,258,1,2007-09-15 18:29:09,2007-09-15 18:29:09
e90eb41a4a1814ce3524fd46d97b1c32e537b9ea...fb288d95574fddad38763beebbdbe918a2639d4d,1,17,0,17,1,2007-09-15 18:31:50,2007-09-15 18:31:50
fb288d95574fddad38763beebbdbe918a2639d4d...0639474d01cc0457dd1ac43d3dae47d9329dc103,1,2,1,3,1,2007-09-15 18:33:03,2007-09-15 18:33:03
0639474d01cc0457dd1ac43d3dae47d9329dc103...40702fe2f0506b2bcf376df1066d6c606314f51a,1,4,0,4,1,2007-09-15 18:36:31,2007-09-15 18:36:31
40702fe2f0506b2bcf376df1066d6c606314f51a...d3c2dd30d606565fc43a78f4209f269e72515b54,1,32,0,32,1,2007-09-15 18:39:44,2007-09-15 18:39:44
d3c2dd30d606565fc43a78f4209f269e72515b54...41e622e17056a4acc7f14df9535aa34938c6c75d,1,9,0,9,1,2007-09-15 18:43:49,2007-09-15 18:43:49
41e622e17056a4acc7f14df9535aa34938c6c75d...fc478a0fe83bac8c7dd7c6112aaea373e2c3f533,1,44,1,45,3,2007-09-15 18:52:29,2007-09-15 18:52:29
fc478a0fe83bac8c7dd7c6112aaea373e2c3f533...8a48d490a1569017d8be8079c34a1506da24d07d,1,1,1,2,1,2007-09-15 18:54:31,2007-09-15 18:54:31
8a48d490a1569017d8be8079c34a1506da24d07d...201a6cc192b5484e74a16fb599d9ddfb9e6fb048,1,1,1,2,1,2007-09-15 18:56:18,2007-09-15 18:56:18
201a6cc192b5484e74a16fb599d9ddfb9e6fb048...07447a0f562c62f020f00ba1d5248c5de4c264ca,2,46,20,66,7,2007-09-15 19:25:20,2007-09-15 19:25:20
07447a0f562c62f020f00ba1d5248c5de4c264ca...bcfaa7351455e76047604c737d9b3f3ae97fb736,1,35,18,53,5,2007-09-15 19:45:33,2007-09-15 19:45:33
bcfaa7351455e76047604c737d9b3f3ae97fb736...bb94a48f884e1f18c376c3fd518582a8b7ba0dba,1,3,1,4,1,2007-09-15 19:55:48,2007-09-15 19:55:48
bb94a48f884e1f18c376c3fd518582a8b7ba0dba...e6460e41348e5113761d5fd831d1179741ce2e9e,1,1,3,4,1,2007-09-15 20:00:14,2007-09-15 20:00:14
e6460e41348e5113761d5fd831d1179741ce2e9e...bcf7e9a9fe037eff4d5dea0cdd8c35104590e1a8,13,467,120,587,44,2007-09-15 21:29:14,2007-09-15 21:29:14
bcf7e9a9fe037eff4d5dea0cdd8c35104590e1a8...c3a489d8178a953fcc25bea6fd8a571fdb543978,1,4,7,11,3,2007-09-15 21:44:05,2007-09-15 21:44:05
c3a489d8178a953fcc25bea6fd8a571fdb543978...c079d52fe741126a817a92eb152bc12bf95c69b0,1,1,1,2,1,2007-09-15 22:36:43,2007-09-15 22:36:43
c079d52fe741126a817a92eb152bc12bf95c69b0...b448593432089eef7a795a7f91dc4f55c7407aeb,1,17,16,33,10,2007-09-15 22:36:53,2007-09-15 22:36:53
b448593432089eef7a795a7f91dc4f55c7407aeb...1de4bf0b66d5c59f3b46767f9506ee2a78b64540,1,4,3,7,2,2007-09-15 22:39:51,2007-09-15 22:39:51
1de4bf0b66d5c59f3b46767f9506ee2a78b64540...e2409750f8a551d3094e44f9795d94188a45c606,4,30,0,30,4,2007-09-16 01:57:25,2007-09-16 01:57:25
e2409750f8a551d3094e44f9795d94188a45c606...d0f4e52abfecf38239d399c04223b7ce00aba962,1,2,2,4,2,2007-09-16 02:01:06,2007-09-16 02:01:06
d0f4e52abfecf38239d399c04223b7ce00aba962...ae75958820e344357ea716fcdbd5e56f06a00b24,1,7,6,13,2,2007-09-16 02:03:46,2007-09-16 02:03:46
ae75958820e344357ea716fcdbd5e56f06a00b24...8ccf2028c20054151b20248b9dc525bf78618fbc,2,30,12,42,7,2007-09-16 03:17:48,2007-09-16 03:17:48
8ccf2028c20054151b20248b9dc525bf78618fbc...ec7d80b9dd6182735545433665d9af46605264d2,2,21,0,21,5,2007-09-16 03:27:38,2007-09-16 03:27:38
ec7d80b9dd6182735545433665d9af46605264d2...23f95c9dfa5ffd4ea5a11cf8797d03486d0eb6f5,1,1,1,2,1,2007-09-16 03:57:33,2007-09-16 03:57:33
23f95c9dfa5ffd4ea5a11cf8797d03486d0eb6f5...748e55b1daa1260964d9ec29f50e01b4b4c0f5d8,4,58,4,62,6,2007-09-16 04:38:20,2007-09-16 04:38:20
748e55b1daa1260964d9ec29f50e01b4b4c0f5d8...14754fa6d4112d7c707c3d9eac1a321c55278ff0,1,8,1,9,4,2007-09-16 10:04:03,2007-09-16 10:04:03
14754fa6d4112d7c707c3d9eac1a321c55278ff0...7a6e9f763377eb7cba4bad4912f8c5049a5d7c9d,1,13,3,16,4,2007-09-16 10:04:26,2007-09-16 10:04:26
7a6e9f763377eb7cba4bad4912f8c5049a5d7c9d...e988aa39894f0ac8ac30cb3a35d785f087dc0dfd,1,2,2,4,1,2007-09-16 10:49:27,2007-09-16 10:49:27
e988aa39894f0ac8ac30cb3a35d785f087dc0dfd...c694587ebbf7a45d3e6f91f5bfc4e81001c03d97,1,11,3,14,3,2007-09-16 11:27:40,2007-09-16 11:27:40
c694587ebbf7a45d3e6f91f5bfc4e81001c03d97...c012b8964e596423b68f4ec4b1b57253cf0ae7b0,4,79,2,81,6,2007-09-16 11:38:32,2007-09-16 11:38:32
c012b8964e596423b68f4ec4b1b57253cf0ae7b0...68884a571ffa49a93898f0368f64638c31623fb7,1,2,2,4,1,2007-09-16 11:59:56,2007-09-16 11:59:56
68884a571ffa49a93898f0368f64638c31623fb7...1ef4f5eac64507eb2c0ba5b8babe0229f2803117,1,5,2,7,1,2007-09-16 12:10:28,2007-09-16 12:10:28
1ef4f5eac64507eb2c0ba5b8babe0229f2803117...e9656180eadf44fd507f89ffe02fbb628eaccca1,1,1,1,2,1,2007-09-16 12:14:48,2007-09-16 12:14:48
e9656180eadf44fd507f89ffe02fbb628eaccca1...da903a3be427a72040810f5684012b8ce5dec11d,1,1,1,2,1,2007-09-16 15:56:19,2007-09-16 15:56:19
da903a3be427a72040810f5684012b8ce5dec11d...cb02d3437680bbebb969afa725dde773fc58a78b,1,1,1,2,1,2007-09-16 15:57:15,2007-09-16 15:57:15
cb02d3437680bbebb969afa725dde773fc58a78b...4541a4d3a98c390d9306d49fad0357569a3a7e2d,1,3,3,6,2,2007-09-16 16:01:25,2007-09-16 16:01:25
4541a4d3a98c390d9306d49fad0357569a3a7e2d...0f4fb9755cb91389a500629da0fe1739afbc2a20,1,3,2,5,1,2007-09-16 16:54:16,2007-09-16 16:54:16
0f4fb9755cb91389a500629da0fe1739afbc2a20...771481695f0e53556824bdd64662efea87d55f32,2,2,1,3,2,2007-09-16 20:11:14,2007-09-16 20:11:14
771481695f0e53556824bdd64662efea87d55f32...66203fc9ee7499bc331123678c7280873dd912f9,5,115,4,119,10,2007-09-17 04:50:12,2007-09-17 04:50:12
66203fc9ee7499bc331123678c7280873dd912f9...d9335b30b6662a2b64cd90690336dadeed7cb110,0,0,0,0,0,2007-09-17 04:52:46,2007-09-17 04:52:46
d9335b30b6662a2b64cd90690336dadeed7cb110...2e755299908dd9dd890da7e5fae000aba312ebb6,1,3,1,4,1,2007-09-17 04:54:53,2007-09-17 04:54:53
2e755299908dd9dd890da7e5fae000aba312ebb6...1571e9c32b9f944e273e06bd458acd081c9f0a14,18,240,0,240,14,2007-09-17 14:48:33,2007-09-17 14:48:33
1571e9c32b9f944e273e06bd458acd081c9f0a14...466871ec1b40f4e68bbe693cfdeacef4eec4370c,9,126,10,136,18,2007-09-19 13:26:56,2007-09-19 13:26:56
466871ec1b40f4e68bbe693cfdeacef4eec4370c...f857e37776569422043875b396dfc67acea80ce8,7,198,40,238,17,2007-09-19 16:50:30,2007-09-19 16:50:30
f857e37776569422043875b396dfc67acea80ce8...5c55cc83a78e1ae9604e3c90dee8d434059025e2,1,3,3,6,3,2007-09-19 20:54:46,2007-09-19 20:54:46
5c55cc83a78e1ae9604e3c90dee8d434059025e2...d022e2581d444bb17f8236bc83d33c003f75888e,1,1,1,2,1,2007-09-19 23:32:53,2007-09-19 23:32:53
d022e2581d444bb17f8236bc83d33c003f75888e...980fa8b827485616c597a39ec975735c412fd59d,13,94,24,118,26,2007-09-19 23:33:57,2007-09-19 23:33:57
980fa8b827485616c597a39ec975735c412fd59d...35fa1f4d8eba76e9acccdd7c3bc52dafbae3b16c,27,6328,6178,12506,30,2007-09-19 23:40:47,2007-09-19 23:40:47
35fa1f4d8eba76e9acccdd7c3bc52dafbae3b16c...7768fe3505d08cc15c276edd0b0c0c53e7e6c649,1,0,0,0,0,2007-09-20 00:24:42,2007-09-20 00:24:42
7768fe3505d08cc15c276edd0b0c0c53e7e6c649...31a07e8cf9383d0563b2e417edc0113b15cddb54,1,9,14,23,4,2007-09-20 01:48:47,2007-09-20 01:48:47
31a07e8cf9383d0563b2e417edc0113b15cddb54...4704412bb345ce3f83e6694f97ab8eaa061fef31,1,1,1,2,1,2007-09-20 01:56:02,2007-09-20 01:56:02
4704412bb345ce3f83e6694f97ab8eaa061fef31...6306400102cbb99b4b9434712574c8eb06e6ad23,1,1,1,2,1,2007-09-20 02:02:21,2007-09-20 02:02:21
6306400102cbb99b4b9434712574c8eb06e6ad23...24588afe6d9f104bb0256136bafcf1d985e93eaf,1,1,1,2,1,2007-09-20 02:02:54,2007-09-20 02:02:54
24588afe6d9f104bb0256136bafcf1d985e93eaf...3db846cdb5ac8606ed66a8dce55f0644f6c1cce3,1,7,2,9,2,2007-09-20 02:19:48,2007-09-20 02:19:48
3db846cdb5ac8606ed66a8dce55f0644f6c1cce3...79dead9a2486ca7dbb4b90ec93fdc841d1d597c0,1,7,9,16,9,2007-09-20 04:35:03,2007-09-20 04:35:03
79dead9a2486ca7dbb4b90ec93fdc841d1d597c0...df84e5b1386b11cb013b3179f509c25be319fd7e,0,0,0,0,0,2007-09-20 05:55:31,2007-09-20 05:55:31
df84e5b1386b11cb013b3179f509c25be319fd7e...0dbd71a6a2e6c76efbe4f4168f311107657b9a15,0,0,0,0,0,2007-09-20 06:53:17,2007-09-20 06:53:17
0dbd71a6a2e6c76efbe4f4168f311107657b9a15...04a110836d5949aadbb7809264ecc60e7051ee98,18,8,18,26,18,2007-09-20 06:59:13,2007-09-20 06:59:13
04a110836d5949aadbb7809264ecc60e7051ee98...bf6effdfafc06e03f285e24c7fb9c44e2798b096,1,3,1,4,2,2007-09-20 07:13:32,2007-09-20 07:13:32
bf6effdfafc06e03f285e24c7fb9c44e2798b096...2fea878213ede5bd4603f7cd18afa5f81516e82c,1,8,8,16,6,2007-09-20 07:19:10,2007-09-20 07:19:10
2fea878213ede5bd4603f7cd18afa5f81516e82c...484189ff9ca4b682a113a6d8bfd76848a52b71f6,1,3,3,6,3,2007-09-20 15:51:19,2007-09-20 15:51:19
484189ff9ca4b682a113a6d8bfd76848a52b71f6...5ae6fafad7b2de9d5df042a6e07e41d746b4b59b,1,3,4,7,1,2007-09-20 17:03:14,2007-09-20 17:03:14
5ae6fafad7b2de9d5df042a6e07e41d746b4b59b...75e462099baad442570009e376d5304b864797bc,1,1,1,2,1,2007-09-20 23:56:54,2007-09-20 23:56:54
75e462099baad442570009e376d5304b864797bc...2570954a9aa8ae8ad1edb6927f80b5952dfe5674,8,169,75,244,47,2007-09-21 04:00:32,2007-09-21 04:00:32
2570954a9aa8ae8ad1edb6927f80b5952dfe5674...302eeaf1904a2f3852b223a563617d4999b4e9ae,8,203,40,243,19,2007-09-21 16:19:20,2007-09-21 16:19:20
302eeaf1904a2f3852b223a563617d4999b4e9ae...626a3415870a5606ac7c4989c1661a8e46ddb852,1,6,3,9,2,2007-09-21 16:52:32,2007-09-21 16:52:32
626a3415870a5606ac7c4989c1661a8e46ddb852...901c3708fb8a2e51bddd37358f8e536282a8c266,1,14,2,16,3,2007-09-21 17:52:36,2007-09-21 17:52:36
901c3708fb8a2e51bddd37358f8e536282a8c266...87d71277b8e43f7042b82aed9d4b4c77cf1ec68f,1,1,1,2,1,2007-09-21 17:54:15,2007-09-21 17:54:15
87d71277b8e43f7042b82aed9d4b4c77cf1ec68f...872f06d770413d771e11791dda84abb15c987884,1,1,1,2,1,2007-09-22 00:27:07,2007-09-22 00:27:07
872f06d770413d771e11791dda84abb15c987884...694323ec743b7beff9abb464bdd622599525f973,1,1,1,2,1,2007-09-22 04:58:26,2007-09-22 04:58:26
694323ec743b7beff9abb464bdd622599525f973...f2101abacff1069303d2afa204106e049c633654,2,14,3,17,6,2007-09-22 13:21:54,2007-09-22 13:21:54
f2101abacff1069303d2afa204106e049c633654...2d1d7e453c03f4585e8fed803d31deaeef3c2ee0,1,5,5,10,3,2007-09-22 15:14:41,2007-09-22 15:14:41
2d1d7e453c03f4585e8fed803d31deaeef3c2ee0...484ef94587bde66aa249b08053a746e56e437aae,1,1,1,2,2,2007-09-23 04:56:19,2007-09-23 04:56:19
484ef94587bde66aa249b08053a746e56e437aae...4d30be23dcfc185ff56fb4bbf8ef77f5f47ade53,1,16,5,21,1,2007-09-23 05:59:12,2007-09-23 05:59:12
4d30be23dcfc185ff56fb4bbf8ef77f5f47ade53...4edecaeae95ac02339f51d84dbe0dd414c7c3d61,1,6,1,7,2,2007-09-23 06:18:49,2007-09-23 06:18:49
4edecaeae95ac02339f51d84dbe0dd414c7c3d61...960c1263b60b4341a1a0ddf192ab1102a94d20af,2,3,3,6,4,2007-09-24 18:27:42,2007-09-24 18:27:42
960c1263b60b4341a1a0ddf192ab1102a94d20af...e8c9e3a853954d7eae76243eeb8ab67fb8fdea40,1,8,1,9,2,2007-09-25 23:16:11,2007-09-25 23:16:11
e8c9e3a853954d7eae76243eeb8ab67fb8fdea40...f4bb24658bfbcf9dcf9fdda08ddf0e611ee22f8d,1,2,1,3,1,2007-09-27 16:57:55,2007-09-27 16:57:55
f4bb24658bfbcf9dcf9fdda08ddf0e611ee22f8d...1f42d1c9a5b1b506a86278916dbf570033da6101,1,0,1,1,1,2007-09-27 17:00:07,2007-09-27 17:00:07
1f42d1c9a5b1b506a86278916dbf570033da6101...39d61439e08699d9c589af952568e3599cb51bda,1,7,6,13,2,2007-09-27 17:01:34,2007-09-27 17:01:34
39d61439e08699d9c589af952568e3599cb51bda...4b4ecb6d668567ddbc9b88abac01d8ef21a56741,1,1,1,2,1,2007-09-28 03:07:36,2007-09-28 03:07:36
4b4ecb6d668567ddbc9b88abac01d8ef21a56741...e70ecc93ff3bc610ab976774786cfd22a15c80ef,1,115,0,115,1,2007-09-28 19:25:50,2007-09-28 19:25:50
e70ecc93ff3bc610ab976774786cfd22a15c80ef...632a424db77f8e194443307a8fdc5857db7bd63d,1,2,0,2,2,2007-09-28 19:35:50,2007-09-28 19:35:50
632a424db77f8e194443307a8fdc5857db7bd63d...2dd882885b8d72941a706048c59fec3f84d7377f,2,8,0,8,2,2007-09-28 22:30:59,2007-09-28 22:30:59
2dd882885b8d72941a706048c59fec3f84d7377f...964f0c16ad3c62bcae755b9b6b025bb1b69e1231,2,5,4,9,5,2007-09-28 22:34:27,2007-09-28 22:34:27
964f0c16ad3c62bcae755b9b6b025bb1b69e1231...d95c0fd0177998f69156cc218a18301110adcb61,1,5,0,5,1,2007-09-30 04:11:29,2007-09-30 04:11:29
d95c0fd0177998f69156cc218a18301110adcb61...dad9bae58520f717a411c456fa38729d4385a56e,1,3,3,6,1,2007-10-02 15:26:39,2007-10-02 15:26:39
dad9bae58520f717a411c456fa38729d4385a56e...e79e2df47b6f98fc0670a6972440212fdb226ce6,2,30,29,59,24,2007-10-03 00:45:08,2007-10-03 00:45:08
e79e2df47b6f98fc0670a6972440212fdb226ce6...10466470c0b950b6571abf96b52c0a8254a05ed7,1,49,46,95,6,2007-10-03 01:41:04,2007-10-03 01:41:04
10466470c0b950b6571abf96b52c0a8254a05ed7...fa546d797e4b7c627c91ec3740b0f104aa30549d,4,17,12,29,8,2007-10-03 01:57:02,2007-10-03 01:57:02
fa546d797e4b7c627c91ec3740b0f104aa30549d...291b81b4e3b869928b1b65dd892542b0ef3c7510,2,3,2,5,2,2007-10-03 03:19:14,2007-10-03 03:19:14
291b81b4e3b869928b1b65dd892542b0ef3c7510...2a63414ccd9b31b7dc6353786824aefe3ef1873e,1,1,1,2,1,2007-10-03 22:12:22,2007-10-03 22:12:22
2a63414ccd9b31b7dc6353786824aefe3ef1873e...4d8b51f60c78b79186b53b9c55aa7169062603b9,1,3,2,5,1,2007-10-03 22:21:43,2007-10-03 22:21:43
4d8b51f60c78b79186b53b9c55aa7169062603b9...b1cc3318c7ac740784b556e16bae594bc20010f4,1,8,0,8,3,2007-10-04 01:12:00,2007-10-04 01:12:00
b1cc3318c7ac740784b556e16bae594bc20010f4...3c18331adc1fc45c9fec59991c1689cf751790e8,1,5,5,10,8,2007-10-04 01:20:27,2007-10-04 01:20:27
3c18331adc1fc45c9fec59991c1689cf751790e8...4d8561a8a8f802f6874979d72eb7facbe20b5f09,1,2,2,4,2,2007-10-04 01:54:58,2007-10-04 01:54:58
4d8561a8a8f802f6874979d72eb7facbe20b5f09...185848a526f94cadf06060410dec0f8260c110f9,4,15,3,18,4,2007-10-04 01:55:51,2007-10-04 01:55:51
185848a526f94cadf06060410dec0f8260c110f9...0397e63a1980145cab60c87b9c37c1f36ca616bf,1,2,2,4,2,2007-10-04 22:50:06,2007-10-04 22:50:06
0397e63a1980145cab60c87b9c37c1f36ca616bf...d79f684f9d198ee647b0f4e67b5c0e9469900002,1,2,2,4,2,2007-10-06 02:19:15,2007-10-06 02:19:15
d79f684f9d198ee647b0f4e67b5c0e9469900002...d2952d47cea1b56949af2c89005b88613c48c625,2,2,2,4,2,2007-10-06 02:23:59,2007-10-06 02:23:59
d2952d47cea1b56949af2c89005b88613c48c625...a0102fccfd65c4259077a7ad899c166d46a5a23a,1,6,3,9,2,2007-10-07 16:35:22,2007-10-07 16:35:22
a0102fccfd65c4259077a7ad899c166d46a5a23a...7ab381972e84b8870b301b3511cea203aeb3a01a,1,1,1,2,1,2007-10-07 16:35:27,2007-10-07 16:35:27
7ab381972e84b8870b301b3511cea203aeb3a01a...381453da91343488433629728c172a55a077be1e,1,16,14,30,3,2007-10-07 16:35:32,2007-10-07 16:35:32
381453da91343488433629728c172a55a077be1e...b053177555dc3f716f3ee3c4f0057a082254afb3,1,2,2,4,1,2007-10-10 02:20:32,2007-10-10 02:20:32
b053177555dc3f716f3ee3c4f0057a082254afb3...8ae74eae556120d3be3d04dcbeabba3619c8cca3,2,2,2,4,2,2007-10-13 02:57:57,2007-10-13 02:57:57
8ae74eae556120d3be3d04dcbeabba3619c8cca3...928e68192c4bf1eecc2439b8c81f6f72c4f900dd,1,6,4,10,4,2007-10-13 15:59:54,2007-10-13 15:59:54
928e68192c4bf1eecc2439b8c81f6f72c4f900dd...300dcd6cae24595e1c1f1c3df040b5eea91b6bd6,1,4,5,9,3,2007-10-13 16:02:54,2007-10-13 16:02:54
300dcd6cae24595e1c1f1c3df040b5eea91b6bd6...c142094ffbd7a79dbb68d54487a1d6380f20d73d,1,11,0,11,1,2007-10-13 16:38:19,2007-10-13 16:38:19
c142094ffbd7a79dbb68d54487a1d6380f20d73d...1a07957f7e64f34d009e09b61871d55c06cdd2cf,1,2,2,4,2,2007-10-13 16:40:20,2007-10-13 16:40:20
1a07957f7e64f34d009e09b61871d55c06cdd2cf...fd292d340eb545a086205aec4d5067c0ba7769ac,1,0,3,3,3,2007-10-13 18:33:03,2007-10-13 18:33:03
fd292d340eb545a086205aec4d5067c0ba7769ac...5f9821a5d012f8627330aba3f565fe5d69d18c86,2,2,2,4,2,2007-10-13 18:45:49,2007-10-13 18:45:49
5f9821a5d012f8627330aba3f565fe5d69d18c86...a3d015fad09e0376484b0e7c4b00f07243ee3af6,1,9,3,12,2,2007-10-14 04:10:02,2007-10-14 04:10:02
a3d015fad09e0376484b0e7c4b00f07243ee3af6...78d557bf024db83f41c9650c58700efd24172821,2,12,1,13,2,2007-10-14 04:17:02,2007-10-14 04:17:02
78d557bf024db83f41c9650c58700efd24172821...73f495158c967316e9aeb5849111fceb99d60372,1,1,1,2,1,2007-10-14 05:53:56,2007-10-14 05:53:56
73f495158c967316e9aeb5849111fceb99d60372...088cb3c2f3dbef628b1ff5e1b66d216c946d61c7,2,88,69,157,59,2007-10-19 01:26:09,2007-10-19 01:26:09
088cb3c2f3dbef628b1ff5e1b66d216c946d61c7...409ba6038dcb5ff40323a1a76e20c2157e6288fd,1,2,2,4,2,2007-10-19 01:42:21,2007-10-19 01:42:21
409ba6038dcb5ff40323a1a76e20c2157e6288fd...433cbba51230ddd65f9a832f694c4580a544bd2d,1,9,0,9,1,2007-10-19 03:18:15,2007-10-19 03:18:15
433cbba51230ddd65f9a832f694c4580a544bd2d...a1723aba3bf56a5551d04d1e5728d6f2fc7fd0c0,1,1,1,2,1,2007-10-19 03:20:15,2007-10-19 03:20:15
a1723aba3bf56a5551d04d1e5728d6f2fc7fd0c0...5c8b26df151117c2d0db8ad73681599cb79864bb,1,17,0,17,1,2007-10-19 04:47:07,2007-10-19 04:47:07
5c8b26df151117c2d0db8ad73681599cb79864bb...40f1c923e2524733b545d381b2044df8956bf00f,1,5,9,14,3,2007-10-19 05:07:47,2007-10-19 05:07:47
40f1c923e2524733b545d381b2044df8956bf00f...3375ed112873055ac705ed020ccd7adb8a5b211c,1,3,1,4,2,2007-10-19 06:53:30,2007-10-19 06:53:30
3375ed112873055ac705ed020ccd7adb8a5b211c...50b824d2b1190156fd3d4b00291c297d94da07e4,1,1,1,2,1,2007-10-19 15:43:45,2007-10-19 15:43:45
50b824d2b1190156fd3d4b00291c297d94da07e4...ad91f6889daa1744ad422f5e73f2494212c1b7e8,1,9,7,16,5,2007-10-20 03:21:51,2007-10-20 03:21:51
ad91f6889daa1744ad422f5e73f2494212c1b7e8...b6ec8d3a9ef9315a947535bf99f5e92ae40ce99e,1,3,3,6,3,2007-10-20 03:32:21,2007-10-20 03:32:21
b6ec8d3a9ef9315a947535bf99f5e92ae40ce99e...c4cdb214a6a597bfd6fae6f855303b199b3d208d,1,4,3,7,2,2007-10-20 03:45:48,2007-10-20 03:45:48
c4cdb214a6a597bfd6fae6f855303b199b3d208d...3e3a7e02583bb2087bfff1b358a7a0bf40b55220,1,1,1,2,1,2007-10-20 03:53:44,2007-10-20 03:53:44
3e3a7e02583bb2087bfff1b358a7a0bf40b55220...3ea87fb9c09fa5ff659308721afe6cb1e717ddf9,1,11,11,22,10,2007-10-20 04:16:40,2007-10-20 04:16:40
3ea87fb9c09fa5ff659308721afe6cb1e717ddf9...dc9def7859497e0d18f04f3bf43f4a3d55f1b287,2,10,2,12,4,2007-10-20 04:42:30,2007-10-20 04:42:30
dc9def7859497e0d18f04f3bf43f4a3d55f1b287...da4ec5083db4c6228adc5ddba503701bd03d6582,2,2769,2237,5006,630,2007-10-20 04:42:52,2007-10-20 04:42:52
da4ec5083db4c6228adc5ddba503701bd03d6582...21b40ed59c4b37b0dca9b04d7f1dc5c9ff6e89c9,4,2619,2073,4692,606,2007-10-20 04:43:20,2007-10-20 04:43:20
21b40ed59c4b37b0dca9b04d7f1dc5c9ff6e89c9...1a1a39738a532bf1e9ab6c603b4dc2c3ec9fd999,2,131,131,262,124,2007-10-20 04:43:41,2007-10-20 04:43:41
1a1a39738a532bf1e9ab6c603b4dc2c3ec9fd999...e172e7be57af5ecdddf7c80361eed27d4658a9cd,3,24,11,35,8,2007-10-20 05:13:56,2007-10-20 05:13:56
e172e7be57af5ecdddf7c80361eed27d4658a9cd...706659d2bb6af350903a5b5ee9d1e09f95f6a9a3,1,10,6,16,7,2007-10-20 05:58:48,2007-10-20 05:58:48
706659d2bb6af350903a5b5ee9d1e09f95f6a9a3...aa320700d2d94612e8a1fd4cc42fc74dbce6c58b,1,2,0,2,1,2007-10-20 06:30:44,2007-10-20 06:30:44
aa320700d2d94612e8a1fd4cc42fc74dbce6c58b...570e8936d9aaf217ef61d9b46fb9f5361f013c28,1,3,2,5,1,2007-10-20 06:50:16,2007-10-20 06:50:16
570e8936d9aaf217ef61d9b46fb9f5361f013c28...e60c26d5bb9960866700eccd3392711e523a90e6,1,2,7,9,1,2007-10-20 07:01:12,2007-10-20 07:01:12
e60c26d5bb9960866700eccd3392711e523a90e6...f34935c37fd110100e22a4af6793a56aa64a21a6,2,24,15,39,7,2007-10-20 07:42:34,2007-10-20 07:42:34
f34935c37fd110100e22a4af6793a56aa64a21a6...a0fdd7c7dd263cc0718d0e54597f9da414fd775c,1,2,2,4,2,2007-10-20 07:53:54,2007-10-20 07:53:54
a0fdd7c7dd263cc0718d0e54597f9da414fd775c...cb38521487832999ac2ec147ab5dc96a96bc25ab,1,18,12,30,5,2007-10-20 08:15:42,2007-10-20 08:15:42
cb38521487832999ac2ec147ab5dc96a96bc25ab...5ef7c4c525c1e493c3feaf89606a5c1b36acdfc3,1,6,4,10,4,2007-10-20 08:31:05,2007-10-20 08:31:05
5ef7c4c525c1e493c3feaf89606a5c1b36acdfc3...bece0317724cc5ab436e493e62b99e7d4e3de5ec,2,6,1,7,3,2007-10-20 08:38:59,2007-10-20 08:38:59
bece0317724cc5ab436e493e62b99e7d4e3de5ec...aac5555f2fb333d958e838274fd18cf3ac89d914,7,600,0,600,7,2007-10-20 09:16:54,2007-10-20 09:16:54
aac5555f2fb333d958e838274fd18cf3ac89d914...8db11840d3ded74275af0a76855d05ece5e6641a,2,105,19,124,8,2007-10-20 09:24:19,2007-10-20 09:24:19
8db11840d3ded74275af0a76855d05ece5e6641a...4362d154fb91595c83308e2f5d6d03d11862f8b1,2,4,2,6,3,2007-10-20 09:27:12,2007-10-20 09:27:12
4362d154fb91595c83308e2f5d6d03d11862f8b1...4c0d8d882d1796b08c51eb6930de1327311a0f1d,2,24,0,24,3,2007-10-20 10:12:59,2007-10-20 10:12:59
4c0d8d882d1796b08c51eb6930de1327311a0f1d...2f17153c0271b5bd421a3975e1b21c98b7912355,1,4,1,5,1,2007-10-20 10:37:32,2007-10-20 10:37:32
2f17153c0271b5bd421a3975e1b21c98b7912355...233d76cf2587f9b95e34cdf0e5c7a50aa99b416a,1,5,0,5,2,2007-10-20 10:41:56,2007-10-20 10:41:56
233d76cf2587f9b95e34cdf0e5c7a50aa99b416a...c858efe912603a0fc0d391bfcf0354f784071ad1,1,8,0,8,1,2007-10-20 10:47:57,2007-10-20 10:47:57
c858efe912603a0fc0d391bfcf0354f784071ad1...22ee68961a2bf44c6a395b7c746e6bdfceebf8f3,1,27,10,37,7,2007-10-20 11:05:15,2007-10-20 11:05:15
22ee68961a2bf44c6a395b7c746e6bdfceebf8f3...e38d54e19a219efedb1b466d77d917bdbb3445f6,2,13,0,13,2,2007-10-20 12:21:07,2007-10-20 12:21:07
e38d54e19a219efedb1b466d77d917bdbb3445f6...3742e35df34f4a3b31423f0e2676bb873cf45a8e,1,19,7,26,7,2007-10-20 12:21:16,2007-10-20 12:21:16
3742e35df34f4a3b31423f0e2676bb873cf45a8e...cc6139ab50d07b4c61cf8302ebb16d764a995d9a,1,6,2,8,3,2007-10-20 12:29:56,2007-10-20 12:29:56
cc6139ab50d07b4c61cf8302ebb16d764a995d9a...d1efe9b2f754e8eb0c152429afc05adf9fef20d6,1,6,4,10,3,2007-10-20 12:35:10,2007-10-20 12:35:10
d1efe9b2f754e8eb0c152429afc05adf9fef20d6...b7687fae2d04c3cee88b0c707f9f2c2176e3f515,1,1,1,2,1,2007-10-20 13:01:09,2007-10-20 13:01:09
b7687fae2d04c3cee88b0c707f9f2c2176e3f515...f20b254cccfecccaf81df8851790a0e033245d47,2,41,11,52,9,2007-10-20 13:01:40,2007-10-20 13:01:40
f20b254cccfecccaf81df8851790a0e033245d47...18e1f56a418290d358c5338b2d97d91256f6df5f,2,49,1,50,3,2007-10-20 13:40:20,2007-10-20 13:40:20
18e1f56a418290d358c5338b2d97d91256f6df5f...8a3cf46e6021e9e9b5640c3f79625564527aa165,4,27,2,29,10,2007-10-20 14:54:38,2007-10-20 14:54:38
8a3cf46e6021e9e9b5640c3f79625564527aa165...b678601df302307f0e1fed9b5354765a3b238481,3,16,2,18,4,2007-10-20 15:01:31,2007-10-20 15:01:31
b678601df302307f0e1fed9b5354765a3b238481...714c09b8bdba069d2de49c5cf58f500497711f85,9,74,2,76,12,2007-10-20 15:16:34,2007-10-20 15:16:34
714c09b8bdba069d2de49c5cf58f500497711f85...df644cbab9d1874903bceb853f08da7a9ec56a7a,4,5146,4550,9696,1278,2007-10-20 15:36:05,2007-10-20 15:36:05
df644cbab9d1874903bceb853f08da7a9ec56a7a...4c3586582d37b7badfafab0deb630f114d0dd449,1,7,4,11,4,2007-10-21 12:12:45,2007-10-21 12:12:45
4c3586582d37b7badfafab0deb630f114d0dd449...d79c6a0125a6d37d5aea63e6ef1d7821d2cf206c,2,9,5,14,4,2007-10-21 12:24:37,2007-10-21 12:24:37
d79c6a0125a6d37d5aea63e6ef1d7821d2cf206c...f5831b03c908d9d4bf59f0a0cef4e3db221367ca,1,6,0,6,1,2007-10-21 14:50:20,2007-10-21 14:50:20
f5831b03c908d9d4bf59f0a0cef4e3db221367ca...1671fc48ab9f1c73ef04a10f0eb9e1f8452cd004,4,43,5,48,12,2007-10-21 14:50:47,2007-10-21 14:50:47
1671fc48ab9f1c73ef04a10f0eb9e1f8452cd004...c64a6c98c49ab8f45ee50daa2cfefccf96dd3716,1,0,1,1,1,2007-10-21 14:57:05,2007-10-21 14:57:05
c64a6c98c49ab8f45ee50daa2cfefccf96dd3716...6fbf653aa5aa15867e03a5c60bda599d5c99123c,3,101,0,101,3,2007-10-21 15:48:40,2007-10-21 15:48:40
6fbf653aa5aa15867e03a5c60bda599d5c99123c...5f51964be2907f001d78e3daf06de5eb853f66de,1,1,1,2,1,2007-10-21 16:20:02,2007-10-21 16:20:02
5f51964be2907f001d78e3daf06de5eb853f66de...7ca708140a723b42d915d98d9f9c633a77460089,5,7,33,40,9,2007-10-21 17:14:25,2007-10-21 17:14:25
7ca708140a723b42d915d98d9f9c633a77460089...3ec6568e64d14b6293e7e1b8df0987430ad20905,2,7,1,8,6,2007-10-21 17:26:32,2007-10-21 17:26:32
3ec6568e64d14b6293e7e1b8df0987430ad20905...a1496b054a2b5182387053952980415543276f8f,1,3,2,5,1,2007-10-21 17:51:06,2007-10-21 17:51:06
a1496b054a2b5182387053952980415543276f8f...fcbde3cbe5bcfcb88825f28629709b60035d9c9f,1,4,5,9,3,2007-10-21 18:15:01,2007-10-21 18:15:01
fcbde3cbe5bcfcb88825f28629709b60035d9c9f...2adcb3f250860172032f7762695e78f99415fa61,1,74,1,75,3,2007-10-21 18:26:24,2007-10-21 18:26:24
2adcb3f250860172032f7762695e78f99415fa61...bab4fdc9fd1be47575f440816b4dfc422947d368,1,7,9,16,2,2007-10-21 18:35:31,2007-10-21 18:35:31
bab4fdc9fd1be47575f440816b4dfc422947d368...0a4e4d5993f8d76d63c61c414b732b621b559556,1,2,2,4,1,2007-10-21 19:10:10,2007-10-21 19:10:10
0a4e4d5993f8d76d63c61c414b732b621b559556...ef454b8a14aa3ca1503c2230f44d71b9a5164670,1,4,5,9,3,2007-10-21 19:19:32,2007-10-21 19:19:32
ef454b8a14aa3ca1503c2230f44d71b9a5164670...8e87587e89db8014300f0927799ea025fee53d15,2,6,2,8,5,2007-10-21 21:53:18,2007-10-21 21:53:18
8e87587e89db8014300f0927799ea025fee53d15...0ffeb3a42fb2a72356a1059d6d773ad521972e5e,1,2,1,3,1,2007-10-21 22:06:52,2007-10-21 22:06:52
0ffeb3a42fb2a72356a1059d6d773ad521972e5e...375a6d78cb476f865fe5cccbf3277af7afb4d719,1,3,1,4,1,2007-10-21 23:52:08,2007-10-21 23:52:08
375a6d78cb476f865fe5cccbf3277af7afb4d719...dbd1cb9083db8a0206a4b951813f4c8291afa824,2,32,0,32,3,2007-10-22 00:52:54,2007-10-22 00:52:54
dbd1cb9083db8a0206a4b951813f4c8291afa824...003b3c1a17e2ae54fe24b7f534469f8b661e2727,2,7,2,9,2,2007-10-22 13:13:12,2007-10-22 13:13:12
003b3c1a17e2ae54fe24b7f534469f8b661e2727...2c22f08657a494733b487877c8a97810cff1ef16,1,4,4,8,4,2007-10-22 22:04:00,2007-10-22 22:04:00
2c22f08657a494733b487877c8a97810cff1ef16...17301f2fa01b410d87c32b228962ca216f15bacf,1,57,57,114,1,2007-10-23 13:12:04,2007-10-23 13:12:04
17301f2fa01b410d87c32b228962ca216f15bacf...c599de2ac63033fd6d027b34f1230ee574118ddb,3,33,15,48,9,2007-10-23 19:00:31,2007-10-23 19:00:31
c599de2ac63033fd6d027b34f1230ee574118ddb...cb6ecfe9d6216d18d6176223600557f901302a9c,1,10,7,17,5,2007-10-23 19:11:15,2007-10-23 19:11:15
cb6ecfe9d6216d18d6176223600557f901302a9c...842a771e0527c36a9bcb3984057bb30903e71af3,2,78,44,122,11,2007-10-26 19:52:42,2007-10-26 19:52:42
842a771e0527c36a9bcb3984057bb30903e71af3...a14256aade963929743aa09e0834f5fc4072f772,1,57,0,57,1,2007-10-26 20:08:56,2007-10-26 20:08:56
a14256aade963929743aa09e0834f5fc4072f772...471616aae9541d22e2fe77280cccb1515958db4e,2,1,1,2,1,2007-10-27 04:26:44,2007-10-27 04:26:44
471616aae9541d22e2fe77280cccb1515958db4e...212aa32e2a27469f542a9298c5ba0c2c04e5b7ff,1,1,1,2,1,2007-10-27 04:34:50,2007-10-27 04:34:50
212aa32e2a27469f542a9298c5ba0c2c04e5b7ff...91556cf22e3056695a478cd6888f54bc1bab2841,1,1,1,2,1,2007-10-27 06:23:05,2007-10-27 06:23:05
91556cf22e3056695a478cd6888f54bc1bab2841...1580630fbdda9923c33425372099391d318dd925,1,0,1,1,1,2007-10-27 06:23:19,2007-10-27 06:23:19
1580630fbdda9923c33425372099391d318dd925...2dfad61fcc2b52ce158fedba93aef95a31b946c2,1,2,0,2,1,2007-10-27 16:03:24,2007-10-27 16:03:24
2dfad61fcc2b52ce158fedba93aef95a31b946c2...62c574e765f149f6152c3092e1c6e511e24cb465,1,4,5,9,2,2007-10-27 16:05:59,2007-10-27 16:05:59
62c574e765f149f6152c3092e1c6e511e24cb465...1a3bca2b847d97542f61884d09c7fd3fcad8486d,1,8,4,12,5,2007-10-27 16:09:52,2007-10-27 16:09:52
1a3bca2b847d97542f61884d09c7fd3fcad8486d...6e44f4dee85021671f72dede9ca4ed4c3bd20dee,1,12,16,28,5,2007-10-28 03:38:08,2007-10-28 03:38:08
6e44f4dee85021671f72dede9ca4ed4c3bd20dee...ee49e934d96db3492e69fdce0a3096ef9b0ec8e0,0,0,0,0,0,2007-10-28 05:39:08,2007-10-28 05:39:08
ee49e934d96db3492e69fdce0a3096ef9b0ec8e0...26ea06b0ab423348e40652dd9e3f530a08b93582,7,534,55,589,88,2007-10-28 05:40:26,2007-10-28 05:40:26
26ea06b0ab423348e40652dd9e3f530a08b93582...d453eda38852b1fb4f10a03a467abae8ca4ae927,1,14,10,24,10,2007-10-28 22:32:25,2007-10-28 22:32:25
d453eda38852b1fb4f10a03a467abae8ca4ae927...48ce8456cbbfe9588701756a9456d97dffe88b15,1,49,29,78,25,2007-10-29 23:52:17,2007-10-29 23:52:17
48ce8456cbbfe9588701756a9456d97dffe88b15...a7a6a1b75d985d1c9c65d935761066238e0ca9fd,1,7,5,12,3,2007-10-29 23:55:08,2007-10-29 23:55:08
a7a6a1b75d985d1c9c65d935761066238e0ca9fd...ff2cb8832557899d0ffa5e266662f8836f058318,1,1,1,2,1,2007-10-30 22:35:15,2007-10-30 22:35:15
ff2cb8832557899d0ffa5e266662f8836f058318...b237537e001493acd9fdf34576c2e0b13dfacd43,1,1,1,2,1,2007-10-30 22:50:42,2007-10-30 22:50:42
b237537e001493acd9fdf34576c2e0b13dfacd43...9a30ed5cd5e5a3c8a3b80b7b4d698533aa9cab0d,1,1,1,2,1,2007-10-30 22:57:46,2007-10-30 22:57:46
9a30ed5cd5e5a3c8a3b80b7b4d698533aa9cab0d...0709c2304684c0f1a2e85e5220ae16a232175113,1,0,1,1,1,2007-10-30 23:00:57,2007-10-30 23:00:57
0709c2304684c0f1a2e85e5220ae16a232175113...39f28512b9d2776c5bd716a334999e28fd2ac731,1,6,4,10,3,2007-10-31 01:46:32,2007-10-31 01:46:32
39f28512b9d2776c5bd716a334999e28fd2ac731...8c442f21dc7079a880eb626d20b84fc090563dff,7,51,21,72,21,2007-10-31 03:59:40,2007-10-31 03:59:40
8c442f21dc7079a880eb626d20b84fc090563dff...5997cb8ad491f250bb0ab6de8f4867af7492aadb,1,0,1,1,1,2007-10-31 04:04:07,2007-10-31 04:04:07
5997cb8ad491f250bb0ab6de8f4867af7492aadb...2a48fc5007b9fc04f6483ddf022d504bd11e0826,1,4,5,9,3,2007-11-03 02:04:59,2007-11-03 02:04:59
2a48fc5007b9fc04f6483ddf022d504bd11e0826...0e59bf42cf7641cc044ad875587459ce7e0b5325,2,2,2,4,2,2007-11-04 01:14:58,2007-11-04 01:14:58
0e59bf42cf7641cc044ad875587459ce7e0b5325...4e8864a882201e8ff99085ad0e53171fc028c9c2,2,172,144,316,115,2007-11-04 02:05:56,2007-11-04 02:05:56
4e8864a882201e8ff99085ad0e53171fc028c9c2...2184248c056a6d341ad815f1145406eb99ddbf40,1,36,34,70,20,2007-11-04 02:08:02,2007-11-04 02:08:02
2184248c056a6d341ad815f1145406eb99ddbf40...99697d9becf5321bf17fac787e778c9bb7931a47,1,20,4,24,1,2007-11-04 02:08:04,2007-11-04 02:08:04
99697d9becf5321bf17fac787e778c9bb7931a47...77a846bab0704549360d10e794e4c522de116cbf,1,2,1,3,2,2007-11-04 02:08:15,2007-11-04 02:08:15
77a846bab0704549360d10e794e4c522de116cbf...75efa2811d5d1300095301cd5b3fdbbce4ae4fdc,1,22,5,27,4,2007-11-04 02:08:24,2007-11-04 02:08:24
75efa2811d5d1300095301cd5b3fdbbce4ae4fdc...72b7a33929dd6f61ad8d62152ac800d5501778da,1,22,13,35,2,2007-11-04 02:27:17,2007-11-04 02:27:17
72b7a33929dd6f61ad8d62152ac800d5501778da...a5eb61cd9f378049940d0bef6c83404516094ffc,1,4,0,4,1,2007-11-04 02:32:02,2007-11-04 02:32:02
a5eb61cd9f378049940d0bef6c83404516094ffc...6f7fd897bcc20ef5a3b96a3caf01d805d631d3e4,1,33,19,52,1,2007-11-04 02:48:44,2007-11-04 02:48:44
6f7fd897bcc20ef5a3b96a3caf01d805d631d3e4...3f1ce2e60280ef42c8864e65485e4572d7740e8d,1,21,7,28,3,2007-11-04 03:37:04,2007-11-04 03:37:04
3f1ce2e60280ef42c8864e65485e4572d7740e8d...595e75e8dd5db5982574d5d3222054186ba190d8,4,49,17,66,10,2007-11-04 05:05:24,2007-11-04 05:05:24
595e75e8dd5db5982574d5d3222054186ba190d8...ea100b607acbca31e813118d84c5c6c48fda1ae0,5,162,0,162,4,2007-11-05 13:59:42,2007-11-05 13:59:42
ea100b607acbca31e813118d84c5c6c48fda1ae0...8216abe74889cc867a4cf89e6708f37cec6b2e72,2,572,104,676,3,2007-11-05 13:59:52,2007-11-05 13:59:52
8216abe74889cc867a4cf89e6708f37cec6b2e72...8eeb9feab071caf5ad568ce292d32a2ebf540f62,4,119,14,133,8,2007-11-07 22:45:07,2007-11-07 22:45:07
8eeb9feab071caf5ad568ce292d32a2ebf540f62...8c9b65429a4eef317febf8cdf6c3d1c7cce7ec90,1,1,0,1,1,2007-11-09 15:27:49,2007-11-09 15:27:49
8c9b65429a4eef317febf8cdf6c3d1c7cce7ec90...1eecc5a47e650e842231e5082c8f1f5a79a40afb,1,2,2,4,2,2007-11-09 19:35:56,2007-11-09 19:35:56
1eecc5a47e650e842231e5082c8f1f5a79a40afb...30848dfe34bb027c40ae1902623bd2fb675f6424,2,56,49,105,45,2007-11-11 03:54:21,2007-11-11 03:54:21
30848dfe34bb027c40ae1902623bd2fb675f6424...3ee3d6b5f3f3b20c509ae1516354914c5e52f773,8,85,53,138,36,2007-11-11 03:55:44,2007-11-11 03:55:44
3ee3d6b5f3f3b20c509ae1516354914c5e52f773...5a8af0738fe48cc645a1f7ebcda3c88b60d1315f,5,43,42,85,41,2007-11-11 04:38:19,2007-11-11 04:38:19
5a8af0738fe48cc645a1f7ebcda3c88b60d1315f...da23c7bcfeb119be18b5707ee95628f559fb0598,3,2136,1419,3555,391,2007-11-11 04:38:53,2007-11-11 04:38:53
da23c7bcfeb119be18b5707ee95628f559fb0598...eec71cfc6d870cab3207e79719db3c3b6c73388c,2,730,277,1007,153,2007-11-11 04:39:35,2007-11-11 04:39:35
eec71cfc6d870cab3207e79719db3c3b6c73388c...33206720f0c762a2311438f24eab8981acb4a5a2,2,464,302,766,160,2007-11-11 04:40:06,2007-11-11 04:40:06
33206720f0c762a2311438f24eab8981acb4a5a2...af256a02f9d72c0c0ecf03a9814d8cb9ebdc5e0c,1,1,1,2,1,2007-11-11 04:44:11,2007-11-11 04:44:11
af256a02f9d72c0c0ecf03a9814d8cb9ebdc5e0c...a4907be38ecc9f6caf3d2a787a7046af3f8b9ceb,2,9,20,29,9,2007-11-11 04:44:20,2007-11-11 04:44:20
a4907be38ecc9f6caf3d2a787a7046af3f8b9ceb...5e8be6978e0881698f88ba6a23ed7e8fa9928c06,1,3,5,8,2,2007-11-12 03:12:47,2007-11-12 03:12:47
5e8be6978e0881698f88ba6a23ed7e8fa9928c06...babfe78494028415b0e5f74ec2ca9b66506e8d34,2,43,3,46,9,2007-11-13 14:36:29,2007-11-13 14:36:29
babfe78494028415b0e5f74ec2ca9b66506e8d34...356662cf74c99fac90afb0f5e6aac8d2d573e62a,53,1202,322,1524,303,2007-11-14 12:58:53,2007-11-14 12:58:53
356662cf74c99fac90afb0f5e6aac8d2d573e62a...bdb0b903c2885a3f4b7f0282b8ba04267a1fc29e,3,16,11,27,13,2007-11-14 21:07:27,2007-11-14 21:07:27
bdb0b903c2885a3f4b7f0282b8ba04267a1fc29e...3322521cd6b827f91e776691475e5c2dce4078dd,1,7,0,7,1,2007-11-14 21:30:18,2007-11-14 21:30:18
3322521cd6b827f91e776691475e5c2dce4078dd...b58c55fc8063f31ca1eb141dd4b3b19f4be1dcb9,1,1,1,2,1,2007-11-14 22:58:24,2007-11-14 22:58:24
b58c55fc8063f31ca1eb141dd4b3b19f4be1dcb9...a5e960db4870fbad715e1bbe0b235ccd86ad201f,2,3045,2050,5095,622,2007-11-15 09:17:53,2007-11-15 09:17:53
a5e960db4870fbad715e1bbe0b235ccd86ad201f...84c1e785512438cb23161c0b10ec228c8dd846b4,1,5,5,10,5,2007-11-15 09:21:36,2007-11-15 09:21:36
84c1e785512438cb23161c0b10ec228c8dd846b4...d0f3c4386e3040dae320f346038d9820729fd1de,1,1,2,3,1,2007-11-15 09:26:57,2007-11-15 09:26:57
d0f3c4386e3040dae320f346038d9820729fd1de...0b0ef3f0c573e831a4902120b8407c5b4b7daf69,2,14,4,18,7,2007-11-17 04:04:12,2007-11-17 04:04:12
0b0ef3f0c573e831a4902120b8407c5b4b7daf69...0928fa5566bac9404a5a0d1810c2c00ffa81c59f,4,39,13,52,11,2007-11-17 12:11:26,2007-11-17 12:11:26
0928fa5566bac9404a5a0d1810c2c00ffa81c59f...64c0bf86775c5706355c9d3870345b8cff2c63f4,3,28,7,35,6,2007-11-17 12:11:54,2007-11-17 12:11:54
64c0bf86775c5706355c9d3870345b8cff2c63f4...adcec0885d847896e2f51dc739a34755d3a7ddb6,2,26,15,41,15,2007-11-17 12:12:18,2007-11-17 12:12:18
adcec0885d847896e2f51dc739a34755d3a7ddb6...4585b4d6c23cfad0366480fc1bb03edc34ebe428,2,20,4,24,5,2007-11-17 12:12:40,2007-11-17 12:12:40
4585b4d6c23cfad0366480fc1bb03edc34ebe428...4bd75e8712be56a1ff24109bc708471deb18ddb5,1,4,4,8,1,2007-11-17 12:18:09,2007-11-17 12:18:09
4bd75e8712be56a1ff24109bc708471deb18ddb5...ce73298e26b903080ae1b7e67a1a9d1ec0c5108a,1,0,2,2,2,2007-11-17 12:58:06,2007-11-17 12:58:06
ce73298e26b903080ae1b7e67a1a9d1ec0c5108a...5f8cfe99f3d508cfd7f3eecf50d41a3ac7e7442a,2,3,3,6,3,2007-11-18 03:36:03,2007-11-18 03:36:03
5f8cfe99f3d508cfd7f3eecf50d41a3ac7e7442a...38d972b9ecb01fdb863c686de0b958389bc20220,2,17,4,21,3,2007-11-18 06:51:20,2007-11-18 06:51:20
38d972b9ecb01fdb863c686de0b958389bc20220...86ca11dd6d94cc624d3e20f887a8de39350b3665,1,101,54,155,3,2007-11-18 07:19:11,2007-11-18 07:19:11
86ca11dd6d94cc624d3e20f887a8de39350b3665...b2b6fc8e3c78671c8b6af2709358c3213c84d119,3,69,13,82,13,2007-11-18 20:25:23,2007-11-18 20:25:23
b2b6fc8e3c78671c8b6af2709358c3213c84d119...7d8ac660262ada993d4014527344354b46d684ab,0,0,0,0,0,2007-11-19 03:01:20,2007-11-19 03:01:20
7d8ac660262ada993d4014527344354b46d684ab...34cc21983ce0124a94d01120431f35ac0653c60f,2,31,5,36,6,2007-11-19 03:12:19,2007-11-19 03:12:19
34cc21983ce0124a94d01120431f35ac0653c60f...5870ffd4b04c9a65ea34e1e6c794cb21b6715126,1,11,7,18,4,2007-11-19 03:41:46,2007-11-19 03:41:46
5870ffd4b04c9a65ea34e1e6c794cb21b6715126...66576c285a66fe5bbdb3f99cdc95f2989aea81f1,1,12,7,19,3,2007-11-19 04:00:41,2007-11-19 04:00:41
66576c285a66fe5bbdb3f99cdc95f2989aea81f1...42c5a91388832b001321f2eb46c939eadc117b08,1,2,2,4,2,2007-11-19 04:07:03,2007-11-19 04:07:03
42c5a91388832b001321f2eb46c939eadc117b08...331d4bba9792676bdbe00c5d0066ca6c167ff4ec,1,1,1,2,1,2007-11-19 04:36:09,2007-11-19 04:36:09
331d4bba9792676bdbe00c5d0066ca6c167ff4ec...1607acee4020212166848363098008e60246e8f9,4,8,8,16,5,2007-11-19 05:59:58,2007-11-19 05:59:58
1607acee4020212166848363098008e60246e8f9...6522e0697a84a7628decbc86e2954b5cd430d0c0,2,3,2,5,2,2007-11-19 06:10:23,2007-11-19 06:10:23
6522e0697a84a7628decbc86e2954b5cd430d0c0...b1d40295bc9a176973903a242a35caeb987b4bfc,1,2,0,2,1,2007-11-20 01:37:01,2007-11-20 01:37:01
b1d40295bc9a176973903a242a35caeb987b4bfc...116b9d06cc492f1dcc78fce4926799a771555cfd,1,6,6,12,5,2007-11-20 01:37:16,2007-11-20 01:37:16
116b9d06cc492f1dcc78fce4926799a771555cfd...ab69710de4abde6bbfa382cdb7ab27e5082b6a5d,1,1,1,2,1,2007-11-20 01:37:34,2007-11-20 01:37:34
ab69710de4abde6bbfa382cdb7ab27e5082b6a5d...2e9e36e29744ca638ca34799d79a6eb638a2d822,2,7,0,7,2,2007-11-20 01:37:57,2007-11-20 01:37:57
2e9e36e29744ca638ca34799d79a6eb638a2d822...900811f4013ec0663e439dbdabf5f0ea266cf501,1,6,1,7,3,2007-11-21 19:54:58,2007-11-21 19:54:58
900811f4013ec0663e439dbdabf5f0ea266cf501...dab8503146d68163a98ca395b65a9576ac65a18d,1,3,3,6,1,2007-11-23 10:51:17,2007-11-23 10:51:17
dab8503146d68163a98ca395b65a9576ac65a18d...8df3d2b467ec19b146ec3702a63fed3f4d088bee,1,10,10,20,7,2007-11-25 18:07:57,2007-11-25 18:07:57
8df3d2b467ec19b146ec3702a63fed3f4d088bee...303d22b0d29eff19c9a68eb98a50ef336eaaeb2d,1,20,19,39,19,2007-11-25 18:10:45,2007-11-25 18:10:45
303d22b0d29eff19c9a68eb98a50ef336eaaeb2d...891cc5df92cb0fc765d3f9e5413170001d97f470,1,1,1,2,1,2007-11-25 18:11:44,2007-11-25 18:11:44
891cc5df92cb0fc765d3f9e5413170001d97f470...c7181ec0ff14fb1515f009114b6d99f8374a819e,1,8,2,10,2,2007-11-25 18:14:18,2007-11-25 18:14:18
c7181ec0ff14fb1515f009114b6d99f8374a819e...5903b0bdcdf160d668a5c0e534b1a51feb71dc57,1,12,0,12,4,2007-11-25 18:16:40,2007-11-25 18:16:40
5903b0bdcdf160d668a5c0e534b1a51feb71dc57...183a457f5a149d7a732a5dd46c7d3f1b77f3a127,1,2,2,4,2,2007-11-25 20:29:26,2007-11-25 20:29:26
183a457f5a149d7a732a5dd46c7d3f1b77f3a127...f110da91dbfa2c9db7e6ef2082b4eb28a7741737,2,15,3,18,3,2007-11-26 02:39:48,2007-11-26 02:39:48
f110da91dbfa2c9db7e6ef2082b4eb28a7741737...6b626800f8b282fe025f0cbe23f70ac6fb7f7aab,1,27,22,49,8,2007-11-26 12:32:57,2007-11-26 12:32:57
6b626800f8b282fe025f0cbe23f70ac6fb7f7aab...8f70eb5b5017df5b14a1e006cdde04c02464899e,2,145,155,300,138,2007-11-28 16:13:09,2007-11-28 16:13:09
8f70eb5b5017df5b14a1e006cdde04c02464899e...2d0d6620e617bbfa16fd411730a9f4d37b30f856,1,1,1,2,1,2007-11-28 17:58:10,2007-11-28 17:58:10
2d0d6620e617bbfa16fd411730a9f4d37b30f856...dc716112a746916b1ac9ffb092684acd8819572a,1,2,0,2,1,2007-11-28 20:03:28,2007-11-28 20:03:28
dc716112a746916b1ac9ffb092684acd8819572a...1c87a7bb58c24f0ba1b89a9e5776eb24116caa08,2,55,6,61,12,2007-11-28 20:19:54,2007-11-28 20:19:54
1c87a7bb58c24f0ba1b89a9e5776eb24116caa08...5a5a71edcdbb2062dd5480ebb05e8098dc49d3cc,1,2,1,3,2,2007-11-28 20:19:58,2007-11-28 20:19:58
5a5a71edcdbb2062dd5480ebb05e8098dc49d3cc...9130765ff9823055654207149c051eb2fe7c7165,2,8,2,10,3,2007-11-28 21:04:05,2007-11-28 21:04:05
9130765ff9823055654207149c051eb2fe7c7165...d698f319e4c04d18aaa39b466540827916c0197b,1,0,1,1,1,2007-11-28 21:26:11,2007-11-28 21:26:11
d698f319e4c04d18aaa39b466540827916c0197b...45ab2567a683b6ebb0eb40b16d87010fe50279ea,1,1,0,1,1,2007-11-28 21:55:00,2007-11-28 21:55:00
45ab2567a683b6ebb0eb40b16d87010fe50279ea...b1df3609615e6c5e7b2fca848e777f09c636f9cc,1,0,1,1,1,2007-11-28 21:55:59,2007-11-28 21:55:59
b1df3609615e6c5e7b2fca848e777f09c636f9cc...3c272792d6207147c23d93baa282c0e2e5a4f874,3,24,3,27,5,2007-11-29 01:44:30,2007-11-29 01:44:30
3c272792d6207147c23d93baa282c0e2e5a4f874...b6002d4af6330fd828db10afb450bfb7d5f8d628,3,11,1,12,3,2007-11-29 15:47:47,2007-11-29 15:47:47
b6002d4af6330fd828db10afb450bfb7d5f8d628...a4ea8d4e939295178b593ebeaf15269b658e8a6a,1,2,2,4,1,2007-11-29 16:32:09,2007-11-29 16:32:09
a4ea8d4e939295178b593ebeaf15269b658e8a6a...d0f5a58fbd73e1a9ccef405e16ac070787e98fd4,4,88,6,94,7,2007-11-29 16:32:18,2007-11-29 16:32:18
d0f5a58fbd73e1a9ccef405e16ac070787e98fd4...7df77917426d42690d5eb5581cca41ee9e5ec493,3,106,0,106,3,2007-11-29 16:32:23,2007-11-29 16:32:23
7df77917426d42690d5eb5581cca41ee9e5ec493...0171f007613d42cf26eb2742cfe73ea82fd4b43d,3,4,4,8,4,2007-11-29 16:32:29,2007-11-29 16:32:29
0171f007613d42cf26eb2742cfe73ea82fd4b43d...f2f6e70b08b1142055e33e75f58cfe7fbb5d868f,3,53,6,59,8,2007-11-29 16:57:18,2007-11-29 16:57:18
f2f6e70b08b1142055e33e75f58cfe7fbb5d868f...5cd153b7c8a44d84642743c1b5b3d4287c8912b8,1,12,5,17,1,2007-11-29 16:57:20,2007-11-29 16:57:20
5cd153b7c8a44d84642743c1b5b3d4287c8912b8...6044ce9898c0f56090ce2f6b4e0c1ecc1d6a7f94,4,2625,1493,4118,604,2007-11-29 16:59:35,2007-11-29 16:59:35
6044ce9898c0f56090ce2f6b4e0c1ecc1d6a7f94...8d29fabe31107b627be01be7350a72b33573ba9d,1,6,2,8,1,2007-11-29 17:29:54,2007-11-29 17:29:54
8d29fabe31107b627be01be7350a72b33573ba9d...d94ed44c5df7313bce825d17a8f3e7dff9451365,2,25,0,25,2,2007-11-29 17:30:01,2007-11-29 17:30:01
d94ed44c5df7313bce825d17a8f3e7dff9451365...f86e54e3b0520fa954e1cabbf67752ef9b99c78f,1,13,2,15,4,2007-11-29 17:41:35,2007-11-29 17:41:35
f86e54e3b0520fa954e1cabbf67752ef9b99c78f...c3a867228b34799c9d31f3da3660673fce2d48d0,2,18,5,23,6,2007-11-29 18:15:31,2007-11-29 18:15:31
c3a867228b34799c9d31f3da3660673fce2d48d0...e2b03bd0c26277b203e38fca935e85f0cd039812,7,8,8,16,8,2007-11-29 18:15:38,2007-11-29 18:15:38
e2b03bd0c26277b203e38fca935e85f0cd039812...4cbc8c62cf0f1e5408425c355cde7b021eb4a31e,3,7,0,7,3,2007-11-29 18:15:46,2007-11-29 18:15:46
4cbc8c62cf0f1e5408425c355cde7b021eb4a31e...7a166f1a1c126bea547ad00387ff134ee4743b1c,3,22,4,26,5,2007-11-29 19:22:03,2007-11-29 19:22:03
7a166f1a1c126bea547ad00387ff134ee4743b1c...29892d02fa9c9ab3e48a18a143408abc3c88716e,2,6,2,8,3,2007-11-29 19:30:38,2007-11-29 19:30:38
29892d02fa9c9ab3e48a18a143408abc3c88716e...0cae3d55b6ed529d3dd514efebf6765705eb1c23,1,3,3,6,1,2007-11-29 19:30:42,2007-11-29 19:30:42
0cae3d55b6ed529d3dd514efebf6765705eb1c23...260f9c51127702afcb1d2c669e0ec1855bdea58c,2,12,2,14,3,2007-11-29 19:30:49,2007-11-29 19:30:49
260f9c51127702afcb1d2c669e0ec1855bdea58c...f3c15225fc58ae45c6aa71eb5174ff66f3f5e974,2,11,1,12,3,2007-11-29 19:39:46,2007-11-29 19:39:46
f3c15225fc58ae45c6aa71eb5174ff66f3f5e974...8f97d962389c52f95c3d5956c3ef754f2d39ea60,1,4,4,8,1,2007-11-29 20:09:48,2007-11-29 20:09:48
8f97d962389c52f95c3d5956c3ef754f2d39ea60...caa0523cb8afc19fbbe193b8488eed810dc35829,4,64,7,71,5,2007-11-29 20:09:54,2007-11-29 20:09:54
caa0523cb8afc19fbbe193b8488eed810dc35829...5d1d054e150bace05b8826d990d71c46834eef87,2,3,1,4,2,2007-11-29 20:10:00,2007-11-29 20:10:00
5d1d054e150bace05b8826d990d71c46834eef87...e0bff4906337e5707971bd6e2cea7bbbbc0f125e,1,1,1,2,1,2007-11-29 21:10:11,2007-11-29 21:10:11
e0bff4906337e5707971bd6e2cea7bbbbc0f125e...efc1ff2004b533f3c2eac95499c19ee00b81d25d,1,40,30,70,21,2007-11-30 05:03:32,2007-11-30 05:03:32
efc1ff2004b533f3c2eac95499c19ee00b81d25d...53a5fa9928a2134fe5fa4855aeddecbd71c10d23,1,2,2,4,1,2007-11-30 05:08:26,2007-11-30 05:08:26
53a5fa9928a2134fe5fa4855aeddecbd71c10d23...71dd90b25d26e4d85b3b05fc4167eec154fffd7d,1,1,1,2,1,2007-11-30 05:09:49,2007-11-30 05:09:49
71dd90b25d26e4d85b3b05fc4167eec154fffd7d...14eaaafef86d5acb5bf9162cb47a33fc7a976351,1,6,7,13,2,2007-11-30 05:13:05,2007-11-30 05:13:05
14eaaafef86d5acb5bf9162cb47a33fc7a976351...7628381eb8f4f4555c2a6a70c10d5ff706940ddf,1,1,1,2,1,2007-11-30 05:14:09,2007-11-30 05:14:09
7628381eb8f4f4555c2a6a70c10d5ff706940ddf...e0e084e01775aca946d83d1eefa6e25aaf3ee42e,1,1,3,4,3,2007-11-30 05:16:51,2007-11-30 05:16:51
e0e084e01775aca946d83d1eefa6e25aaf3ee42e...bfa742b6ea876efd430579599106f6dea5524cd4,1,5,3,8,1,2007-11-30 05:18:57,2007-11-30 05:18:57
bfa742b6ea876efd430579599106f6dea5524cd4...a1476fbca2ca404543ee1734702a532a5ea6a71f,1,6,7,13,2,2007-11-30 05:20:27,2007-11-30 05:20:27
a1476fbca2ca404543ee1734702a532a5ea6a71f...85acb388ee4d5ce04ac305d1589c0ab84a99015c,1,6,4,10,1,2007-11-30 05:22:35,2007-11-30 05:22:35
85acb388ee4d5ce04ac305d1589c0ab84a99015c...7ea174ef146157c363b667f18eee5dc920404b23,1,3,3,6,3,2007-11-30 05:27:49,2007-11-30 05:27:49
7ea174ef146157c363b667f18eee5dc920404b23...9e762f44078803f07f43b95cf8bdb0c1893cf7fa,2,9,10,19,8,2007-11-30 05:30:43,2007-11-30 05:30:43
9e762f44078803f07f43b95cf8bdb0c1893cf7fa...275cffaab162d49db5cad52abb9b67473378be07,1,6,6,12,4,2007-11-30 05:34:04,2007-11-30 05:34:04
275cffaab162d49db5cad52abb9b67473378be07...8de4ed9c8cae403bc59588cac9a258e5573b4842,2,8,4,12,4,2007-11-30 15:32:01,2007-11-30 15:32:01
8de4ed9c8cae403bc59588cac9a258e5573b4842...4262765649014b58b6e07c1934f970aa7da9e5d6,1,6,7,13,6,2007-11-30 18:28:19,2007-11-30 18:28:19
4262765649014b58b6e07c1934f970aa7da9e5d6...f27365e5bd01c8832ca04c64606a7f03d78305b4,1,1,1,2,1,2007-11-30 19:59:13,2007-11-30 19:59:13
f27365e5bd01c8832ca04c64606a7f03d78305b4...394807866de4b9841ec67e0c28e53d49964629ce,1,8,14,22,2,2007-12-01 16:50:48,2007-12-01 16:50:48
394807866de4b9841ec67e0c28e53d49964629ce...e7bc0f10ace2e62b53f9fdf764107aabfd53e617,1,6,4,10,4,2007-12-01 16:52:49,2007-12-01 16:52:49
e7bc0f10ace2e62b53f9fdf764107aabfd53e617...a73588aa58156460b75fde0d083443028e5f100e,2,3,8,11,3,2007-12-01 16:58:52,2007-12-01 16:58:52
a73588aa58156460b75fde0d083443028e5f100e...aa8febb3f1c1f6fbc95158ae182eec6ed0f5defe,1,30,11,41,4,2007-12-01 17:07:32,2007-12-01 17:07:32
aa8febb3f1c1f6fbc95158ae182eec6ed0f5defe...14da40f54527b35479e290460365c20780646cbb,1,1,1,2,1,2007-12-01 17:10:12,2007-12-01 17:10:12
14da40f54527b35479e290460365c20780646cbb...56b1b7d30b4342488ffe05fa5d8464562586af2b,1,5,3,8,1,2007-12-01 17:20:19,2007-12-01 17:20:19
56b1b7d30b4342488ffe05fa5d8464562586af2b...0aa26dacac75a71d0b2beb46ab1bd73fc4c341ed,1,11,0,11,1,2007-12-01 17:27:44,2007-12-01 17:27:44
0aa26dacac75a71d0b2beb46ab1bd73fc4c341ed...b3b8a2e9b3acfedc095760a79bd04c553050cf8f,2,141,130,271,42,2007-12-01 17:29:45,2007-12-01 17:29:45
b3b8a2e9b3acfedc095760a79bd04c553050cf8f...887c8ad5659dc34d41d187fa55564745f9283bed,1,2,3,5,3,2007-12-01 17:33:14,2007-12-01 17:33:14
887c8ad5659dc34d41d187fa55564745f9283bed...5f49d67427fec2502e70ec80f44d6b3763ffb5a8,1,11,7,18,1,2007-12-01 17:44:59,2007-12-01 17:44:59
5f49d67427fec2502e70ec80f44d6b3763ffb5a8...32e0852fa09c34fd509ddd50e78ad97d8dc0d628,1,9,4,13,2,2007-12-01 18:10:10,2007-12-01 18:10:10
32e0852fa09c34fd509ddd50e78ad97d8dc0d628...cf21274b1aa0990d9e6613cc65be53611e46a55b,1,0,34,34,1,2007-12-01 18:10:14,2007-12-01 18:10:14
cf21274b1aa0990d9e6613cc65be53611e46a55b...4a3084f3fca7732ab6ac9a5dea9006b413e7489a,2,272,209,481,19,2007-12-01 18:38:12,2007-12-01 18:38:12
4a3084f3fca7732ab6ac9a5dea9006b413e7489a...c750f01b48ac9d541067dd86a2ab31e1141639cc,1,2,1,3,1,2007-12-01 18:50:43,2007-12-01 18:50:43
c750f01b48ac9d541067dd86a2ab31e1141639cc...c5a4541f102014dadc5ac23e902933289abb1fe7,1,3,3,6,3,2007-12-01 19:22:05,2007-12-01 19:22:05
c5a4541f102014dadc5ac23e902933289abb1fe7...bbc3a955573c8e53dcc6d314ed1bd364a49d31b5,6,31,4,35,6,2007-12-01 19:23:49,2007-12-01 19:23:49
bbc3a955573c8e53dcc6d314ed1bd364a49d31b5...5e06c129c6c4e615c6ef10b930aa825ce978adb7,1,8,6,14,2,2007-12-01 19:26:51,2007-12-01 19:26:51
5e06c129c6c4e615c6ef10b930aa825ce978adb7...0e464d5d5c354883134f739a5511e688a5cb1ec5,1,8,6,14,2,2007-12-01 19:31:53,2007-12-01 19:31:53
0e464d5d5c354883134f739a5511e688a5cb1ec5...1087dc31fb1ef5b921d12619b9e7aba209b1643f,1,11,0,11,1,2007-12-01 19:52:53,2007-12-01 19:52:53
1087dc31fb1ef5b921d12619b9e7aba209b1643f...f3d5372340a2baea9f29bcec93d2163fff3461a0,1,3,2,5,1,2007-12-01 20:08:45,2007-12-01 20:08:45
f3d5372340a2baea9f29bcec93d2163fff3461a0...b2dbbd5bbc85d270dccea3af2aab3b551d174164,1,0,3,3,1,2007-12-01 20:08:45,2007-12-01 20:08:45
b2dbbd5bbc85d270dccea3af2aab3b551d174164...7fbe014197e38d81398cf94f77501cd9940b9239,1,9,5,14,2,2007-12-01 20:11:55,2007-12-01 20:11:55
7fbe014197e38d81398cf94f77501cd9940b9239...b063bbc83862cc7cb83ccad44e9f284af2efea89,1,5,5,10,1,2007-12-01 20:12:44,2007-12-01 20:12:44
b063bbc83862cc7cb83ccad44e9f284af2efea89...6875fd6389dc1f61191749a234e04e069e54dd1f,2,53,1,54,4,2007-12-01 20:45:05,2007-12-01 20:45:05
6875fd6389dc1f61191749a234e04e069e54dd1f...a72324bf7f001f163aa75b73d7eb3e7601c29b60,5,6,6,12,6,2007-12-01 21:18:45,2007-12-01 21:18:45
a72324bf7f001f163aa75b73d7eb3e7601c29b60...b3db18817a4034f0af0219b3436c1ceccf61789d,1,1,2,3,1,2007-12-01 21:58:51,2007-12-01 21:58:51
b3db18817a4034f0af0219b3436c1ceccf61789d...348f2cbfc15c3d80ecc35981d1bd980e06435774,2,7,0,7,3,2007-12-01 22:26:24,2007-12-01 22:26:24
348f2cbfc15c3d80ecc35981d1bd980e06435774...90eb819e97963453dde1226aefe3d2fe330165ca,1,1,0,1,1,2007-12-01 22:33:20,2007-12-01 22:33:20
90eb819e97963453dde1226aefe3d2fe330165ca...c804bde5f7f8460521b09f9fb2b958c4988f93c2,1,2,0,2,2,2007-12-01 22:35:35,2007-12-01 22:35:35
c804bde5f7f8460521b09f9fb2b958c4988f93c2...b6a6f665cc369d19c471c99d26b3b74524e03a21,1,25,25,50,25,2007-12-01 22:36:45,2007-12-01 22:36:45
b6a6f665cc369d19c471c99d26b3b74524e03a21...13aa1970d44ab282fb2f1da763e558c84e0ca906,2,49,23,72,8,2007-12-02 00:00:36,2007-12-02 00:00:36
13aa1970d44ab282fb2f1da763e558c84e0ca906...b1769ca9191c65eb6d7e7bb6f798737200ba2ba2,2,8,6,14,6,2007-12-02 00:26:50,2007-12-02 00:26:50
b1769ca9191c65eb6d7e7bb6f798737200ba2ba2...f6a3b499b8b98adba0fdf3a104d7c06e0473d4d4,6,91,88,179,19,2007-12-02 00:35:14,2007-12-02 00:35:14
f6a3b499b8b98adba0fdf3a104d7c06e0473d4d4...075cfa72ba97e20c6e15776904dd3a61401219f6,1,0,2,2,2,2007-12-02 01:44:58,2007-12-02 01:44:58
075cfa72ba97e20c6e15776904dd3a61401219f6...892b04bf2165bab4875e38691c42131fff40b8ef,1,4,4,8,4,2007-12-02 01:45:59,2007-12-02 01:45:59
892b04bf2165bab4875e38691c42131fff40b8ef...1921554b2bca5de7efe9e52c25a9d16c1cef22f4,1,1,1,2,1,2007-12-02 01:47:42,2007-12-02 01:47:42
1921554b2bca5de7efe9e52c25a9d16c1cef22f4...c882d7c99c94a7806eceb032b79b67a82e590f21,3,10,8,18,8,2007-12-02 02:22:19,2007-12-02 02:22:19
c882d7c99c94a7806eceb032b79b67a82e590f21...0c1ba467aebce501ac7ff6d91e7ccd5bfeb36e8e,1,4,0,4,1,2007-12-02 04:54:34,2007-12-02 04:54:34
0c1ba467aebce501ac7ff6d91e7ccd5bfeb36e8e...04a20c0226117f186e1486ce09dd536cbe4bde6d,1,3,1,4,2,2007-12-02 15:03:36,2007-12-02 15:03:36
04a20c0226117f186e1486ce09dd536cbe4bde6d...fc4129abbbff3981ed70b7203cf8aeef811242aa,1,3,2,5,1,2007-12-02 15:17:14,2007-12-02 15:17:14
fc4129abbbff3981ed70b7203cf8aeef811242aa...f610269006255b7df0ea9dc511381cb781d84123,1,2,3,5,1,2007-12-02 15:17:21,2007-12-02 15:17:21
f610269006255b7df0ea9dc511381cb781d84123...49da9ab57e61e8b6d14ea72b5256555cb5c41cb5,3,15,0,15,3,2007-12-02 15:27:29,2007-12-02 15:27:29
49da9ab57e61e8b6d14ea72b5256555cb5c41cb5...81832f594d7b0d3b671bf12878a77f7a34fb2f04,4,9,9,18,8,2007-12-02 15:27:44,2007-12-02 15:27:44
81832f594d7b0d3b671bf12878a77f7a34fb2f04...9075ac4b76f9e52e09fd2946f8f485b3ce6acf42,3,4,4,8,4,2007-12-02 15:43:35,2007-12-02 15:43:35
9075ac4b76f9e52e09fd2946f8f485b3ce6acf42...4ac8ba18559ab352e06a553df5ef49244b72413c,1,29,2,31,2,2007-12-02 15:49:10,2007-12-02 15:49:10
4ac8ba18559ab352e06a553df5ef49244b72413c...5e5768ae83f3950720921f25a473b39890528661,3,20,6,26,10,2007-12-02 18:10:07,2007-12-02 18:10:07
5e5768ae83f3950720921f25a473b39890528661...805c364fcf52f69498e15ddd8960baa3e4bc6d34,6,13,6,19,7,2007-12-02 18:21:07,2007-12-02 18:21:07
805c364fcf52f69498e15ddd8960baa3e4bc6d34...61947f0635bdf5a4043caa2562e085058b2d19a8,5,112,0,112,5,2007-12-02 18:43:01,2007-12-02 18:43:01
61947f0635bdf5a4043caa2562e085058b2d19a8...51dc4ecf943d1dcc044ed956925760f9d480f56c,5,1060,560,1620,40,2007-12-02 19:29:54,2007-12-02 19:29:54
51dc4ecf943d1dcc044ed956925760f9d480f56c...2e62b84accc25b5ced9641850736ab66fc6092c7,3,24,10,34,8,2007-12-02 20:17:10,2007-12-02 20:17:10
2e62b84accc25b5ced9641850736ab66fc6092c7...d25d6b3f86b3a53306ab144596dbe8e5d96aa112,1,8,0,8,3,2007-12-02 20:41:27,2007-12-02 20:41:27
d25d6b3f86b3a53306ab144596dbe8e5d96aa112...2881007ad469900e9b7178a58a052f29cb6c6849,3,59,0,59,2,2007-12-02 20:41:30,2007-12-02 20:41:30
2881007ad469900e9b7178a58a052f29cb6c6849...ab75953bbbca8819d859067be8e3e114546be269,1,1,1,2,1,2007-12-02 20:43:38,2007-12-02 20:43:38
ab75953bbbca8819d859067be8e3e114546be269...cb350d72abdaf02a4816ba65be1c5827bf14916e,1,654,0,654,1,2007-12-02 20:57:53,2007-12-02 20:57:53
cb350d72abdaf02a4816ba65be1c5827bf14916e...953e69524646e6a27dfecea72b51e069a0ecb68b,1,8,1,9,2,2007-12-02 21:01:17,2007-12-02 21:01:17
953e69524646e6a27dfecea72b51e069a0ecb68b...d38cb0b2535efa7b210132dd6c01d4ec5d1d9d4d,1,11,0,11,2,2007-12-02 21:03:53,2007-12-02 21:03:53
d38cb0b2535efa7b210132dd6c01d4ec5d1d9d4d...1f629bff993d1d1d75b335ebc669dd9d3a081cc1,7,162,20,182,13,2007-12-02 23:25:55,2007-12-02 23:25:55
1f629bff993d1d1d75b335ebc669dd9d3a081cc1...a88ca126fcfe579a38f3e94a7668b626f0e468c3,1,2,0,2,1,2007-12-02 23:26:01,2007-12-02 23:26:01
a88ca126fcfe579a38f3e94a7668b626f0e468c3...67373009e053aca469f857be99158564fc9b42f0,3,25,2,27,6,2007-12-02 23:57:22,2007-12-02 23:57:22
67373009e053aca469f857be99158564fc9b42f0...c7de28c64c837752d8c69995b3609061e7a7732d,3,115,1,116,4,2007-12-03 00:35:31,2007-12-03 00:35:31
c7de28c64c837752d8c69995b3609061e7a7732d...bd400a368da2441fe52659ce94e4a095b90aa69d,1,1,1,2,1,2007-12-03 00:41:42,2007-12-03 00:41:42
bd400a368da2441fe52659ce94e4a095b90aa69d...ed747637502767578d01fb971b279316f27a354f,1,1,1,2,1,2007-12-03 16:18:23,2007-12-03 16:18:23
ed747637502767578d01fb971b279316f27a354f...dca16b283d75229528593c8499669e80fbd46e08,1,19,25,44,12,2007-12-04 05:46:46,2007-12-04 05:46:46
dca16b283d75229528593c8499669e80fbd46e08...0c8f8f27fb28343b958fd3f12ebd17060854c420,1,16,22,38,7,2007-12-04 05:53:33,2007-12-04 05:53:33
0c8f8f27fb28343b958fd3f12ebd17060854c420...72a5c03dee783d20817d54bb7ee9566b1ea66296,1,8,10,18,7,2007-12-04 05:56:30,2007-12-04 05:56:30
72a5c03dee783d20817d54bb7ee9566b1ea66296...3c654625f130cfa254eeff6c7093e5cb9dc3119f,1,5,3,8,3,2007-12-04 05:58:43,2007-12-04 05:58:43
3c654625f130cfa254eeff6c7093e5cb9dc3119f...b34b1a89b22b972f299f22264c2781fdeb619aef,2,7,7,14,4,2007-12-04 06:01:00,2007-12-04 06:01:00
b34b1a89b22b972f299f22264c2781fdeb619aef...31a17467eb7ac586ea403489cf0070f6277a8632,1,2,2,4,1,2007-12-04 06:02:56,2007-12-04 06:02:56
31a17467eb7ac586ea403489cf0070f6277a8632...ece222ade5bc08c77cec7e81d2e8f46b5b9201bb,1,4,4,8,3,2007-12-04 06:05:28,2007-12-04 06:05:28
ece222ade5bc08c77cec7e81d2e8f46b5b9201bb...140e60e540a9508685d98a852b1fd44d83dd08c7,1,6,8,14,1,2007-12-04 06:07:44,2007-12-04 06:07:44
140e60e540a9508685d98a852b1fd44d83dd08c7...166aa3ec46e8c14dcd0e16fdcb24947ecbb402b2,1,4,3,7,1,2007-12-04 06:10:51,2007-12-04 06:10:51
166aa3ec46e8c14dcd0e16fdcb24947ecbb402b2...e5e75b0c52f7b3d342008f10fca4a5881eac380d,3,11,8,19,6,2007-12-04 06:13:56,2007-12-04 06:13:56
e5e75b0c52f7b3d342008f10fca4a5881eac380d...5d7a18bd2e1f5b15f1d9deb03b6ea55f466767c9,1,1,1,2,1,2007-12-04 06:14:45,2007-12-04 06:14:45
5d7a18bd2e1f5b15f1d9deb03b6ea55f466767c9...803b95c6a4756ca06756e7a554553d0c25d8034a,1,3,3,6,2,2007-12-04 06:16:28,2007-12-04 06:16:28
803b95c6a4756ca06756e7a554553d0c25d8034a...2863b2862743b74bba0c7e6e39d318fec59c615d,1,13,13,26,7,2007-12-04 06:39:05,2007-12-04 06:39:05
2863b2862743b74bba0c7e6e39d318fec59c615d...3911ee093139016feea7d71535414d6e8a6b4bdd,1,3,3,6,3,2007-12-04 06:52:13,2007-12-04 06:52:13
3911ee093139016feea7d71535414d6e8a6b4bdd...91ca6f2e7e2b48eb1b674d3ae248ff1c10ea61ab,1,3,3,6,3,2007-12-04 17:14:32,2007-12-04 17:14:32
91ca6f2e7e2b48eb1b674d3ae248ff1c10ea61ab...acfff050ecd9764943bc4444ee09b8b26df38168,2,125,43,168,18,2007-12-04 18:03:56,2007-12-04 18:03:56
acfff050ecd9764943bc4444ee09b8b26df38168...76dd53ac08a1541aa4b28c8cf28772f491066b3c,1,1,1,2,1,2007-12-04 19:17:25,2007-12-04 19:17:25
76dd53ac08a1541aa4b28c8cf28772f491066b3c...602b7bca7aa0b94bb38ba16735635959e04d91ab,1,11,2,13,3,2007-12-04 20:24:22,2007-12-04 20:24:22
602b7bca7aa0b94bb38ba16735635959e04d91ab...35921e570b22d09ef86d2c189c1901d4835752c5,1,8,0,8,2,2007-12-04 20:29:43,2007-12-04 20:29:43
35921e570b22d09ef86d2c189c1901d4835752c5...76b73ce72515678faff06b05dd585136fb0f5bf1,2,39,1,40,2,2007-12-04 20:31:34,2007-12-04 20:31:34
76b73ce72515678faff06b05dd585136fb0f5bf1...b65fce659502ac5e211d13fbd5435e1ff6c703d2,3,48,2,50,6,2007-12-04 21:08:29,2007-12-04 21:08:29
b65fce659502ac5e211d13fbd5435e1ff6c703d2...5684bdc3a4c6d7f8551ff18d8c7cdbd4294175c8,1,14,0,14,2,2007-12-04 21:35:28,2007-12-04 21:35:28
5684bdc3a4c6d7f8551ff18d8c7cdbd4294175c8...86c417077d44b4b59afda8629a53f48f78850b50,1,1,1,2,1,2007-12-04 22:20:07,2007-12-04 22:20:07
86c417077d44b4b59afda8629a53f48f78850b50...01ca12277401d5bc0b42d67cd6bf2292f7e1ec95,1,1,1,2,1,2007-12-05 09:28:56,2007-12-05 09:28:56
01ca12277401d5bc0b42d67cd6bf2292f7e1ec95...25f548a85224bb770241c4bc0a8ace7044bc0ee5,1,1,0,1,1,2007-12-05 13:16:25,2007-12-05 13:16:25
25f548a85224bb770241c4bc0a8ace7044bc0ee5...5ed205bc8a7940f3908b1db2cec32cfcabe47388,2,38,34,72,33,2007-12-09 07:12:07,2007-12-09 07:12:07
5ed205bc8a7940f3908b1db2cec32cfcabe47388...b3c01b389ccc715a91c0866316261ea72507ede5,1,4,0,4,1,2007-12-09 08:10:09,2007-12-09 08:10:09
b3c01b389ccc715a91c0866316261ea72507ede5...90093e7965d279b24b20711ce0d0af7d63bfe549,1,2,2,4,1,2007-12-09 10:18:56,2007-12-09 10:18:56
90093e7965d279b24b20711ce0d0af7d63bfe549...f425cb8caabdd6af6d787c9f7e3f87f0856287ad,1,31,28,59,8,2007-12-11 01:20:25,2007-12-11 01:20:25
f425cb8caabdd6af6d787c9f7e3f87f0856287ad...ed5eca598e6e0fced2262dafa052d5db1661d83a,2,29,0,29,5,2007-12-11 02:22:40,2007-12-11 02:22:40
ed5eca598e6e0fced2262dafa052d5db1661d83a...5adfae3062158d8329ee81b08fccf15adae2b762,2,198,194,392,140,2007-12-11 02:44:23,2007-12-11 02:44:23
5adfae3062158d8329ee81b08fccf15adae2b762...8540731dc43ca96ec6ef331a9e5c2ba7ff16ff71,1,1,1,2,1,2007-12-11 04:44:48,2007-12-11 04:44:48
8540731dc43ca96ec6ef331a9e5c2ba7ff16ff71...c39d6e89f1c87a14b77fe29fda06fff74b249b3e,1,5,0,5,2,2007-12-11 05:22:11,2007-12-11 05:22:11
c39d6e89f1c87a14b77fe29fda06fff74b249b3e...3e360fc96300f84bd18476d06560983c8db9e9d4,1,6,3,9,4,2007-12-11 05:38:34,2007-12-11 05:38:34
3e360fc96300f84bd18476d06560983c8db9e9d4...58b2374b688749847a9781025b611e19054ea1f6,1,2,2,4,2,2007-12-11 05:39:54,2007-12-11 05:39:54
58b2374b688749847a9781025b611e19054ea1f6...a944613b3a71bd5a4749a75119775271b4b009cc,1,11,11,22,11,2007-12-11 05:49:11,2007-12-11 05:49:11
a944613b3a71bd5a4749a75119775271b4b009cc...a4478ee9c6acf0e50fa37265e2af20b9da856ba1,2,13,1,14,4,2007-12-11 06:37:07,2007-12-11 06:37:07
a4478ee9c6acf0e50fa37265e2af20b9da856ba1...f9410dc40d7a5a6ecbe42ea2ce8328fb3d22e89d,1,21,21,42,3,2007-12-11 06:55:25,2007-12-11 06:55:25
f9410dc40d7a5a6ecbe42ea2ce8328fb3d22e89d...e415eff0ead50882525129b0d5fd8ca95f1d30a7,3,48,40,88,31,2007-12-13 02:48:04,2007-12-13 02:48:04
e415eff0ead50882525129b0d5fd8ca95f1d30a7...4c59ca602063f5de88595dfb18b0f83bc7bba0f7,2,12,6,18,4,2007-12-13 03:14:31,2007-12-13 03:14:31
4c59ca602063f5de88595dfb18b0f83bc7bba0f7...6754be48ec942c3c287f4cca9e6809c999a7dfeb,1,3,0,3,2,2007-12-17 06:02:35,2007-12-17 06:02:35
6754be48ec942c3c287f4cca9e6809c999a7dfeb...fc413b8f611677e51ea8c24e3b56a3716652a619,7,24,5,29,12,2007-12-17 06:53:15,2007-12-17 06:53:15
fc413b8f611677e51ea8c24e3b56a3716652a619...5d6f91e415d66251f70ac55960741429b560d204,4,6,6,12,4,2007-12-17 06:59:01,2007-12-17 06:59:01
5d6f91e415d66251f70ac55960741429b560d204...54457043ad1ec518f6ef83b3b5484f44528b1156,1,2,2,4,1,2007-12-17 07:01:17,2007-12-17 07:01:17
54457043ad1ec518f6ef83b3b5484f44528b1156...4d7aa81a70cefc88dfdceec6c8d6fcc28f4bc791,1,5,1,6,1,2007-12-17 07:39:24,2007-12-17 07:39:24
4d7aa81a70cefc88dfdceec6c8d6fcc28f4bc791...1fcb4e4bcdb99b44561b7b70c1563e059daadbd2,23,375,217,592,173,2007-12-17 08:05:27,2007-12-17 08:05:27
1fcb4e4bcdb99b44561b7b70c1563e059daadbd2...03f1eb23e5c39e130744f885d480b2aa70d93088,2,48,1,49,4,2007-12-17 08:05:51,2007-12-17 08:05:51
03f1eb23e5c39e130744f885d480b2aa70d93088...4a25cf5d95d29f77160c56b723da5b8ce3a8d8a3,1,3,1,4,1,2007-12-17 08:50:19,2007-12-17 08:50:19
4a25cf5d95d29f77160c56b723da5b8ce3a8d8a3...8ecff6b91c9cb8fac466552e36cfbdb3d5145148,1,27,21,48,6,2007-12-17 08:50:32,2007-12-17 08:50:32
8ecff6b91c9cb8fac466552e36cfbdb3d5145148...14ed0efec9d497a2e64723b41429aa62fac78b89,2,42,11,53,6,2007-12-17 08:50:50,2007-12-17 08:50:50
14ed0efec9d497a2e64723b41429aa62fac78b89...06482d4aa48d614f872043b6a6475d44cbdf2cb6,2,15,1,16,3,2007-12-17 08:58:29,2007-12-17 08:58:29
06482d4aa48d614f872043b6a6475d44cbdf2cb6...3edf2ebd9488bd57ceee9985b3ee7729e8a0f002,2,8,1,9,2,2007-12-17 09:09:08,2007-12-17 09:09:08
3edf2ebd9488bd57ceee9985b3ee7729e8a0f002...402ca0b77bddc93e226c87c2fc6f1b9dd63aa818,1,7,0,7,2,2007-12-17 09:14:59,2007-12-17 09:14:59
402ca0b77bddc93e226c87c2fc6f1b9dd63aa818...931764ddb5d05b6bb2ca44abc1ed3111b7bb3849,1,3,0,3,3,2007-12-17 10:31:20,2007-12-17 10:31:20
931764ddb5d05b6bb2ca44abc1ed3111b7bb3849...9229c34163982320db6f9ee4473964699893d79f,1,9,4,13,5,2007-12-17 10:35:53,2007-12-17 10:35:53
9229c34163982320db6f9ee4473964699893d79f...fbf49dfceed2958da3d6edcbe6119284bf95894e,3,10,2,12,6,2007-12-17 11:09:32,2007-12-17 11:09:32
fbf49dfceed2958da3d6edcbe6119284bf95894e...b53fac80525ef656dddaa0e88ade258df6f4a8b8,1,2,3,5,3,2007-12-17 11:09:56,2007-12-17 11:09:56
b53fac80525ef656dddaa0e88ade258df6f4a8b8...24cb41b8c7c547fa8cff6a6dabe91a9feb7cb082,1,1,1,2,1,2007-12-17 11:11:34,2007-12-17 11:11:34
24cb41b8c7c547fa8cff6a6dabe91a9feb7cb082...b279b75c876e819034e6c56f3bf3b0c4b9843636,4,23,5,28,6,2007-12-17 11:46:48,2007-12-17 11:46:48
b279b75c876e819034e6c56f3bf3b0c4b9843636...ec72071615f31a81ad171e184ec5327f81a94286,1,7,7,14,5,2007-12-17 11:59:53,2007-12-17 11:59:53
ec72071615f31a81ad171e184ec5327f81a94286...133aa5eb4bae0c274a3f695dec3afc7b16a1fd83,1,12,0,12,1,2007-12-17 12:50:06,2007-12-17 12:50:06
133aa5eb4bae0c274a3f695dec3afc7b16a1fd83...fde7e1c861fd794a5c3f3330a9bc4f75e14de668,1,1,1,2,1,2007-12-19 03:29:16,2007-12-19 03:29:16
fde7e1c861fd794a5c3f3330a9bc4f75e14de668...ac3885c4339674c0070ba52d1fb6ea7a3b69e17a,1,3,1,4,1,2007-12-19 03:31:26,2007-12-19 03:31:26
ac3885c4339674c0070ba52d1fb6ea7a3b69e17a...81b9b7fb5591ab831f3d87505198f3355ee2c078,2,9,2,11,3,2007-12-19 03:39:21,2007-12-19 03:39:21
81b9b7fb5591ab831f3d87505198f3355ee2c078...0b7894423d595ea200f47a7572b36d058f48ca9b,1,4,6,10,2,2007-12-19 03:40:39,2007-12-19 03:40:39
0b7894423d595ea200f47a7572b36d058f48ca9b...48a5898f2462f0d8cd76326b86836f258eb3d0b2,1,95,109,204,57,2007-12-19 03:52:13,2007-12-19 03:52:13
48a5898f2462f0d8cd76326b86836f258eb3d0b2...76f3856039e9b386b4b5652252e912218310a8e8,1,9,8,17,3,2007-12-19 03:55:10,2007-12-19 03:55:10
76f3856039e9b386b4b5652252e912218310a8e8...36a748787d6b1b8f2496b535a72f5731c9710852,1,3,2,5,2,2007-12-19 03:58:53,2007-12-19 03:58:53
36a748787d6b1b8f2496b535a72f5731c9710852...6e94b560440bfda3d14b91665a9f5a8e10b26009,1,3,2,5,1,2007-12-19 04:09:19,2007-12-19 04:09:19
6e94b560440bfda3d14b91665a9f5a8e10b26009...367867845f443583045326a098af5781e2099817,2,6,4,10,4,2007-12-19 04:20:02,2007-12-19 04:20:02
367867845f443583045326a098af5781e2099817...aec96649f0c107c16721d4c56267f0acc990d58f,3,37,39,76,36,2007-12-19 04:27:18,2007-12-19 04:27:18
aec96649f0c107c16721d4c56267f0acc990d58f...a35ca605d62d1b97eb595dcaa27b0904a0fe2182,2,43,14,57,12,2007-12-19 04:43:47,2007-12-19 04:43:47
a35ca605d62d1b97eb595dcaa27b0904a0fe2182...c506f4574a8df61c687ebadab5e0d34da086f586,1,8,2,10,1,2007-12-19 04:51:35,2007-12-19 04:51:35
c506f4574a8df61c687ebadab5e0d34da086f586...d1b5a0bde593f80968079cd9d1c971d92a53353e,2,17,9,26,5,2007-12-19 06:11:55,2007-12-19 06:11:55
d1b5a0bde593f80968079cd9d1c971d92a53353e...72d279a29fdbbbab905072336c4d54a64b25195d,1,8,4,12,4,2007-12-20 23:06:30,2007-12-20 23:06:30
72d279a29fdbbbab905072336c4d54a64b25195d...0a348bb2692ce793cf28c50643bcf484d63e8560,1,1,1,2,1,2007-12-21 03:16:03,2007-12-21 03:16:03
0a348bb2692ce793cf28c50643bcf484d63e8560...c5d3a925c7285df4133cdb028f3a4bf44fd01e59,1,6,0,6,1,2007-12-21 18:49:07,2007-12-21 18:49:07
c5d3a925c7285df4133cdb028f3a4bf44fd01e59...6557dc954b2d45b6e78104755b2c59347e4a05cc,2,99,93,192,7,2007-12-22 19:10:03,2007-12-22 19:10:03
6557dc954b2d45b6e78104755b2c59347e4a05cc...6bcf1f066166ec43afe9a26c8c91bc0e75b68e2e,1,1,1,2,1,2007-12-22 19:12:58,2007-12-22 19:12:58
6bcf1f066166ec43afe9a26c8c91bc0e75b68e2e...98d3da6389ba3003bc235df82d9b11adb8d30c8c,1,23,23,46,22,2007-12-22 19:16:39,2007-12-22 19:16:39
98d3da6389ba3003bc235df82d9b11adb8d30c8c...eb95a50cd699d25b4694ae012ff31a92ee2d1049,1,0,2,2,1,2007-12-22 19:20:02,2007-12-22 19:20:02
eb95a50cd699d25b4694ae012ff31a92ee2d1049...36a06edcdff0a0a57f94d94cf9d4574dde147264,1,7,16,23,2,2007-12-22 19:28:21,2007-12-22 19:28:21
36a06edcdff0a0a57f94d94cf9d4574dde147264...55ae4e00a704eb2969f4e8a04728945a0ce87acc,1,3,4,7,4,2007-12-22 19:30:13,2007-12-22 19:30:13
55ae4e00a704eb2969f4e8a04728945a0ce87acc...abffdf594044df56fa035700d60f900835aa266e,1,2,4,6,4,2007-12-22 19:32:54,2007-12-22 19:32:54
abffdf594044df56fa035700d60f900835aa266e...e7b338d10e9a301773f4068b38e907c366d53e83,1,8,11,19,7,2007-12-22 19:38:48,2007-12-22 19:38:48
e7b338d10e9a301773f4068b38e907c366d53e83...bd0897baa76562f5ee7b5b620eda082f65f46fbd,1,1,1,2,1,2007-12-23 22:53:30,2007-12-23 22:53:30
bd0897baa76562f5ee7b5b620eda082f65f46fbd...293f0f2360f568896c1788335c055b1582d19f9a,2,15,12,27,3,2008-01-02 05:01:03,2008-01-02 05:01:03
293f0f2360f568896c1788335c055b1582d19f9a...8abd63f450c68dcf249a82387cc4c9248eb0171d,1,3,3,6,3,2008-01-02 05:01:54,2008-01-02 05:01:54
8abd63f450c68dcf249a82387cc4c9248eb0171d...8bb07998ca7bd607fb88f5ff5169d761e9bf0a2f,1,2,2,4,1,2008-01-02 05:08:25,2008-01-02 05:08:25
8bb07998ca7bd607fb88f5ff5169d761e9bf0a2f...aa728422bc2b9fe81e89c421d2199ba01eacf8b1,1,11,0,11,1,2008-01-02 05:13:46,2008-01-02 05:13:46
aa728422bc2b9fe81e89c421d2199ba01eacf8b1...f6336737a014b665b4c62bc89b01b7658824517c,3,6,6,12,6,2008-01-02 05:23:21,2008-01-02 05:23:21
f6336737a014b665b4c62bc89b01b7658824517c...1264bcf8b01086e3a39efe70632d60ff10db82b2,1,7,17,24,3,2008-01-02 05:29:10,2008-01-02 05:29:10
1264bcf8b01086e3a39efe70632d60ff10db82b2...5496c50b62da5c9b96ebc0de46db1f3b8a4d52e1,1,16,16,32,1,2008-01-02 08:39:03,2008-01-02 08:39:03
5496c50b62da5c9b96ebc0de46db1f3b8a4d52e1...d6d1188ed0e04009bcd33aa954cf0b2827641433,2,13,14,27,11,2008-01-03 02:14:29,2008-01-03 02:14:29
d6d1188ed0e04009bcd33aa954cf0b2827641433...4ab27ab11941501dfe960fe859f75dfed3934947,1,1,1,2,1,2008-01-04 20:26:13,2008-01-04 20:26:13
4ab27ab11941501dfe960fe859f75dfed3934947...6929c0d4d1d3b4611db0f8852772e1c2b87f8245,2,32,1,33,3,2008-01-04 22:51:22,2008-01-04 22:51:22
6929c0d4d1d3b4611db0f8852772e1c2b87f8245...3d52ce730f72437645da3107fac8d29b3408ae61,2,9,17,26,5,2008-01-05 00:03:12,2008-01-05 00:03:12
3d52ce730f72437645da3107fac8d29b3408ae61...1f6bc7ffa774ee7f00ed58f62477be64c1e0451e,1,1,1,2,1,2008-01-06 03:53:04,2008-01-06 03:53:04
1f6bc7ffa774ee7f00ed58f62477be64c1e0451e...a7da12d32090e887b72093b7e8f2870a8d7cf3a7,3,17,0,17,4,2008-01-06 03:53:33,2008-01-06 03:53:33
a7da12d32090e887b72093b7e8f2870a8d7cf3a7...d1793f177475929cc3b48b09513b832f418491ae,1,1,1,2,1,2008-01-06 03:55:23,2008-01-06 03:55:23
d1793f177475929cc3b48b09513b832f418491ae...70fe1ef2628329ad54953fe3bc34589e07fc2e2d,1,1,1,2,1,2008-01-06 07:23:21,2008-01-06 07:23:21
70fe1ef2628329ad54953fe3bc34589e07fc2e2d...041e24dbde48a38e539f85c378842849f7dc00a1,2,20,16,36,17,2008-01-06 12:53:09,2008-01-06 12:53:09
041e24dbde48a38e539f85c378842849f7dc00a1...8775c1793045598d80f7985daef42d8301e8dfc4,1,1,1,2,1,2008-01-06 22:09:16,2008-01-06 22:09:16
8775c1793045598d80f7985daef42d8301e8dfc4...421b03af2c33081b5f00c596253f08445185bed6,1,2,0,2,1,2008-01-09 06:52:42,2008-01-09 06:52:42
421b03af2c33081b5f00c596253f08445185bed6...f0b14067db8f9745a5081e45eb7eaa124a9cc98b,1,2,2,4,2,2008-01-09 07:19:56,2008-01-09 07:19:56
f0b14067db8f9745a5081e45eb7eaa124a9cc98b...3760e7a1e0bd6b784ad9330ad292c2c1d3c15a88,1,1,1,2,1,2008-01-09 07:32:05,2008-01-09 07:32:05
3760e7a1e0bd6b784ad9330ad292c2c1d3c15a88...2599ae8fef43a6536917c01f98601329e2530186,4,32,35,67,31,2008-01-09 11:41:35,2008-01-09 11:41:35
2599ae8fef43a6536917c01f98601329e2530186...c2a5f919091312df1e1ea9b180d725d4539f551b,2,501,80,581,64,2008-01-09 11:42:02,2008-01-09 11:42:02
c2a5f919091312df1e1ea9b180d725d4539f551b...b253eab14ab172af24f0a5eec4b2dbdf288bb6cb,2,1299,444,1743,352,2008-01-09 11:42:28,2008-01-09 11:42:28
b253eab14ab172af24f0a5eec4b2dbdf288bb6cb...b690a9970f3489e51823c0a29e8013cd403458dc,4,2998,1935,4933,734,2008-01-09 11:42:58,2008-01-09 11:42:58
b690a9970f3489e51823c0a29e8013cd403458dc...9d18adde00531bf3b6b3c66466a30aa7bd3af32f,1,1,1,2,1,2008-01-13 02:14:21,2008-01-13 02:14:21
9d18adde00531bf3b6b3c66466a30aa7bd3af32f...4ee22e480eb3923131cafa738b35400a14210d98,1,1,1,2,1,2008-01-13 02:19:06,2008-01-13 02:19:06
4ee22e480eb3923131cafa738b35400a14210d98...ff0ccc611f2775ad4a777d470f71b0c74d9de43d,1,10,10,20,5,2008-01-13 03:38:22,2008-01-13 03:38:22
ff0ccc611f2775ad4a777d470f71b0c74d9de43d...38fe6bf0faa535956dcfc0bfe244a324ab6b1ee3,1,1,1,2,1,2008-01-13 03:50:57,2008-01-13 03:50:57
38fe6bf0faa535956dcfc0bfe244a324ab6b1ee3...298d76aed44894ad4a40e8745ec7bf88430be635,1,4,1,5,2,2008-01-13 04:03:36,2008-01-13 04:03:36
298d76aed44894ad4a40e8745ec7bf88430be635...7cbbada662092778aec38c47b30cd708dda31d9f,1,2,2,4,1,2008-01-13 18:50:59,2008-01-13 18:50:59
7cbbada662092778aec38c47b30cd708dda31d9f...93c8e94bd6b004ae7a97502e664e6a530958ed9a,1,1,1,2,1,2008-01-13 19:07:14,2008-01-13 19:07:14
93c8e94bd6b004ae7a97502e664e6a530958ed9a...fd20365b277bf48dbdbd82afa1346eadb96d9574,5,128,10,138,17,2008-01-17 18:03:21,2008-01-17 18:03:21
fd20365b277bf48dbdbd82afa1346eadb96d9574...12efef06357544ee81a3731899f528e9b867792a,1,6,1,7,1,2008-01-18 13:37:40,2008-01-18 13:37:40
12efef06357544ee81a3731899f528e9b867792a...755278253ee792fc8a7589081261c6f0a66e1423,3,83,7,90,9,2008-01-18 15:53:19,2008-01-18 15:53:19
755278253ee792fc8a7589081261c6f0a66e1423...80f5cafbc4c4d284d641310818f8144907498494,1,1,1,2,1,2008-01-28 02:15:00,2008-01-28 02:15:00
80f5cafbc4c4d284d641310818f8144907498494...f780ce61765558110bbfe2adc2b73803e1f76b41,1,1,1,2,1,2008-01-28 02:30:53,2008-01-28 02:30:53
f780ce61765558110bbfe2adc2b73803e1f76b41...fab753580608fb57800125c720f6b8fd1b8f4f1a,1,1,1,2,1,2008-01-28 02:51:40,2008-01-28 02:51:40
fab753580608fb57800125c720f6b8fd1b8f4f1a...b24ad9a06b3954a23da1f38a5811c1714742ba3b,1,1,1,2,1,2008-01-28 02:56:35,2008-01-28 02:56:35
b24ad9a06b3954a23da1f38a5811c1714742ba3b...3fd5b5d6a8a7caf284a7ca0d351b17d651b93955,1,11,2,13,3,2008-01-28 03:12:28,2008-01-28 03:12:28
3fd5b5d6a8a7caf284a7ca0d351b17d651b93955...ff707f502ca45924986af08bbd2397d78c6b43ce,1,3,3,6,3,2008-01-28 03:53:50,2008-01-28 03:53:50
ff707f502ca45924986af08bbd2397d78c6b43ce...332e68d550e152ba762da7da09e6717e1c20a31a,1,22,5,27,22,2008-01-28 05:27:39,2008-01-28 05:27:39
332e68d550e152ba762da7da09e6717e1c20a31a...2e43934aedab56ae5885ba11a37248921e5a51f7,1,1,1,2,1,2008-01-28 05:29:09,2008-01-28 05:29:09
2e43934aedab56ae5885ba11a37248921e5a51f7...a01ebb4a5095f69f8e4884598012e1667b13d0cf,2,2,2,4,2,2008-01-28 05:36:44,2008-01-28 05:36:44
a01ebb4a5095f69f8e4884598012e1667b13d0cf...9fcaf3504c8cdb8f211dba251ee0c1a6066509d7,1,1,1,2,1,2008-01-28 05:40:57,2008-01-28 05:40:57
9fcaf3504c8cdb8f211dba251ee0c1a6066509d7...d72ce4f20c0fca12c2c70b130fdb63da57da28ab,1,1,1,2,1,2008-01-31 22:31:38,2008-01-31 22:31:38
d72ce4f20c0fca12c2c70b130fdb63da57da28ab...28353a682dcd37ebbf6de886fa0f0e4719c53166,1,2,1,3,1,2008-01-31 22:33:50,2008-01-31 22:33:50
28353a682dcd37ebbf6de886fa0f0e4719c53166...d3d5861ac29f094b865580fbd31c324a2013bf94,1,14,1,15,3,2008-01-31 22:49:14,2008-01-31 22:49:14
d3d5861ac29f094b865580fbd31c324a2013bf94...0e81ad4e668a160e4782da0c41f229ec88288550,1,0,2,2,1,2008-01-31 22:51:22,2008-01-31 22:51:22
0e81ad4e668a160e4782da0c41f229ec88288550...cc7c6f3e46777c8d57a857eefb40a58c31556fc6,2,36,4,40,18,2008-02-01 17:32:29,2008-02-01 17:32:29
cc7c6f3e46777c8d57a857eefb40a58c31556fc6...e715ead55f4eb05a8cffe525f67f2a5a034f7217,1,1,1,2,1,2008-02-03 01:17:59,2008-02-03 01:17:59
e715ead55f4eb05a8cffe525f67f2a5a034f7217...e5f7ed87d4473edde8c28a073fdd670ceb020e30,1,2,0,2,1,2008-02-03 01:24:22,2008-02-03 01:24:22
e5f7ed87d4473edde8c28a073fdd670ceb020e30...046d943148e82c4f2a9a164b6bfceb8c7dda2608,1,2,2,4,2,2008-02-03 01:24:40,2008-02-03 01:24:40
046d943148e82c4f2a9a164b6bfceb8c7dda2608...f45dab306114756b4ad4a81d409af27ce02e9dee,1,2,2,4,2,2008-02-03 01:37:29,2008-02-03 01:37:29
f45dab306114756b4ad4a81d409af27ce02e9dee...6183e0cb207e1c0dc3e3e563917a75b09077abef,1,8,0,8,1,2008-02-03 01:49:34,2008-02-03 01:49:34
6183e0cb207e1c0dc3e3e563917a75b09077abef...d18a114f8667d0dd0c9d9051ee106c4f17fdc3c9,1,1,1,2,1,2008-02-03 01:49:55,2008-02-03 01:49:55
d18a114f8667d0dd0c9d9051ee106c4f17fdc3c9...f467c8cbc133bd4300961226ccced499fb8a485e,1,1,1,2,1,2008-02-03 01:52:45,2008-02-03 01:52:45
f467c8cbc133bd4300961226ccced499fb8a485e...2542b94fb214847af0a4e1eca84558debbf32ee2,2,18,4,22,4,2008-02-03 02:02:41,2008-02-03 02:02:41
2542b94fb214847af0a4e1eca84558debbf32ee2...8ce7d4740e88fe38a290aa12257204065393b5ba,1,5,3,8,1,2008-02-03 02:11:58,2008-02-03 02:11:58
8ce7d4740e88fe38a290aa12257204065393b5ba...8b29767f3f9d144a3e5cc8506db5acb25aa2d542,1,1,1,2,1,2008-02-03 02:21:51,2008-02-03 02:21:51
8b29767f3f9d144a3e5cc8506db5acb25aa2d542...787acefc73ab458896cd646b0540ea9354ddee41,1,6,0,6,1,2008-02-03 02:24:56,2008-02-03 02:24:56
787acefc73ab458896cd646b0540ea9354ddee41...8926a10fea3f6877b7593cb72c416748f1811905,1,1,1,2,1,2008-02-03 03:23:10,2008-02-03 03:23:10
8926a10fea3f6877b7593cb72c416748f1811905...3815ff7ec5c9cf5e38f10673f6d2cd124e8c3fb4,1,1,1,2,1,2008-02-03 04:06:13,2008-02-03 04:06:13
3815ff7ec5c9cf5e38f10673f6d2cd124e8c3fb4...050b8a436a3016b0211333be3b5ecf7a098fc4bf,2,5,4,9,4,2008-02-03 04:06:35,2008-02-03 04:06:35
050b8a436a3016b0211333be3b5ecf7a098fc4bf...f8c72fbaf40fc856f741db26893653efe8ee4840,2,3209,2270,5479,703,2008-02-03 04:10:01,2008-02-03 04:10:01
f8c72fbaf40fc856f741db26893653efe8ee4840...c8163cc454a09fc9d9bca74c98acc12047efdf6f,3,3641,1415,5056,459,2008-02-03 04:16:02,2008-02-03 04:16:02
c8163cc454a09fc9d9bca74c98acc12047efdf6f...01e4033b1e65369271a6aa32da91f0bb463c5b96,4,362,519,881,231,2008-02-03 04:18:40,2008-02-03 04:18:40
01e4033b1e65369271a6aa32da91f0bb463c5b96...09c755904e50e6b442a00a9a7f87d0eb1f22d9f1,4,2489,1728,4217,688,2008-02-03 04:22:11,2008-02-03 04:22:11
09c755904e50e6b442a00a9a7f87d0eb1f22d9f1...64c4973b0c4ea0f3b49c5b12ca2707de618027ed,2,28,0,28,1,2008-02-03 04:26:00,2008-02-03 04:26:00
64c4973b0c4ea0f3b49c5b12ca2707de618027ed...570b9854e6907a9668aae404f1647e8565efe32f,3,2991,1608,4599,568,2008-02-03 04:29:38,2008-02-03 04:29:38
570b9854e6907a9668aae404f1647e8565efe32f...4378f190550947a7f2254f0ddace7443a4a3cc25,5,3354,1970,5324,497,2008-02-03 04:32:32,2008-02-03 04:32:32
4378f190550947a7f2254f0ddace7443a4a3cc25...5a0d7223f55fd062f0613df52b717009bcd2368d,2,1063,265,1328,225,2008-02-03 04:36:49,2008-02-03 04:36:49
5a0d7223f55fd062f0613df52b717009bcd2368d...c03b5c10917bca31bca0c09d0feb1790fd7c82dd,2,19,6,25,7,2008-02-03 04:44:00,2008-02-03 04:44:00
c03b5c10917bca31bca0c09d0feb1790fd7c82dd...25c4ab99e3b6f00407c0745a8377a0af93d5f4b6,1,1,1,2,1,2008-02-03 07:39:10,2008-02-03 07:39:10
25c4ab99e3b6f00407c0745a8377a0af93d5f4b6...0c4ea9b922206219c73a0de18620b79f2b24b5e1,2,23,14,37,6,2008-02-03 08:54:26,2008-02-03 08:54:26
0c4ea9b922206219c73a0de18620b79f2b24b5e1...5f477760ac02ad94a41f4a2373ed9ed9948a0ac3,1,6,6,12,1,2008-02-04 01:40:53,2008-02-04 01:40:53
5f477760ac02ad94a41f4a2373ed9ed9948a0ac3...66747182131de06b787d19c164f30fcfc0c625ce,1,7,2,9,2,2008-02-04 01:48:53,2008-02-04 01:48:53
66747182131de06b787d19c164f30fcfc0c625ce...10015fae4de33dd5dfd38a3a14a9ddd4cb8442bf,1,10,3,13,3,2008-02-04 02:31:53,2008-02-04 02:31:53
10015fae4de33dd5dfd38a3a14a9ddd4cb8442bf...12ed18935b3119ea2ffa560cff59040eeb659c82,1,1,1,2,1,2008-02-04 02:33:38,2008-02-04 02:33:38
12ed18935b3119ea2ffa560cff59040eeb659c82...b9e088ae14141ccb6a5aaf7952868a6e15e1a6c7,2,14,0,14,4,2008-02-04 04:52:37,2008-02-04 04:52:37
b9e088ae14141ccb6a5aaf7952868a6e15e1a6c7...0cdd65aa2835ca5bbaecc33c79aa2dcf759e2476,1,1,1,2,1,2008-02-04 04:57:56,2008-02-04 04:57:56
0cdd65aa2835ca5bbaecc33c79aa2dcf759e2476...00f96de5d65ef5a2dfbc62ab5d2b369b5a7392cf,2,17,12,29,4,2008-02-05 23:41:48,2008-02-05 23:41:48
00f96de5d65ef5a2dfbc62ab5d2b369b5a7392cf...fc1889ad63de5dd5847341ca93855ed56e323ade,6,7,0,7,7,2008-02-05 23:56:08,2008-02-05 23:56:08
fc1889ad63de5dd5847341ca93855ed56e323ade...0a3c8f03e064e3c0502e9df64ad06764204c4b4a,3,59,9,68,10,2008-02-06 01:04:30,2008-02-06 01:04:30
0a3c8f03e064e3c0502e9df64ad06764204c4b4a...2bb9e0a734cdce87a2fdc832db1ac7768589c46d,2,667,178,845,162,2008-02-08 10:34:43,2008-02-08 10:34:43
2bb9e0a734cdce87a2fdc832db1ac7768589c46d...5480a1eecfe384799740666d52090e9960ee833c,1,33,36,69,4,2008-02-08 12:01:23,2008-02-08 12:01:23
5480a1eecfe384799740666d52090e9960ee833c...9c80d77d7d70ef88421c16ceb52c0eee3ca16000,1,1,1,2,1,2008-02-12 00:48:37,2008-02-12 00:48:37
9c80d77d7d70ef88421c16ceb52c0eee3ca16000...4415f45366f115ff8085ffed05f7034e020d37eb,1,1,1,2,1,2008-02-12 01:01:27,2008-02-12 01:01:27
4415f45366f115ff8085ffed05f7034e020d37eb...ad23fff759ed95dc9bb864913b2f3057d95e89af,3,3,3,6,3,2008-02-13 23:17:55,2008-02-13 23:17:55
ad23fff759ed95dc9bb864913b2f3057d95e89af...7d2a8f0e18ec60e685302905403f33db4f65ce4d,1,1,1,2,1,2008-02-13 23:28:58,2008-02-13 23:28:58
7d2a8f0e18ec60e685302905403f33db4f65ce4d...7d7119897c3d2367f7d68d34240820b1ddf6927a,1,22,0,22,1,2008-02-14 04:54:03,2008-02-14 04:54:03
7d7119897c3d2367f7d68d34240820b1ddf6927a...5078010a31ea32a6fd2e9c4fce5354b8f838b163,1,2,2,4,2,2008-02-14 05:26:52,2008-02-14 05:26:52
5078010a31ea32a6fd2e9c4fce5354b8f838b163...37962ecea79cb9d296645a5324cd91818fed65b3,4,116,59,175,13,2008-02-14 12:56:49,2008-02-14 12:56:49
37962ecea79cb9d296645a5324cd91818fed65b3...1159791cd5b706f01e282d6773a17b66b7cdac9f,4,53,51,104,20,2008-02-14 17:38:05,2008-02-14 17:38:05
1159791cd5b706f01e282d6773a17b66b7cdac9f...16928a79e6c6e8b496a999ee3a1e92dbf655c5aa,1,3,1,4,1,2008-02-15 06:40:23,2008-02-15 06:40:23
16928a79e6c6e8b496a999ee3a1e92dbf655c5aa...c3b642187e7122f0277517815c5ffa297efc7944,1,2,2,4,1,2008-02-15 09:42:50,2008-02-15 09:42:50
c3b642187e7122f0277517815c5ffa297efc7944...87ca6ae4cc20de1cc01fb5e159b0763604e61162,6,4367,0,4367,4,2008-02-15 11:29:27,2008-02-15 11:29:27
87ca6ae4cc20de1cc01fb5e159b0763604e61162...d9a3c1b9fcab47d233fee4c86bfd68fa9ce25f22,3,10,10,20,8,2008-02-15 11:38:53,2008-02-15 11:38:53
d9a3c1b9fcab47d233fee4c86bfd68fa9ce25f22...b893eb4d7a8f11daf0931bc3c66ebd3937c707f4,1,11,0,11,5,2008-02-15 15:17:48,2008-02-15 15:17:48
b893eb4d7a8f11daf0931bc3c66ebd3937c707f4...8b3f36029fba65e41403b890d92024e962d68fcf,6,26,22,48,15,2008-02-16 05:15:09,2008-02-16 05:15:09
8b3f36029fba65e41403b890d92024e962d68fcf...d69f3ccfdbf4034f76a313a91a78948b46fac553,1,1,1,2,1,2008-02-18 23:08:28,2008-02-18 23:08:28
d69f3ccfdbf4034f76a313a91a78948b46fac553...e7b2ad8020aef2941eb477632c4a453e7150202a,2,3,1,4,2,2008-02-18 23:08:51,2008-02-18 23:08:51
e7b2ad8020aef2941eb477632c4a453e7150202a...3eec925f73621eba3f5db4f2c1da22271915d8b2,3,5,4,9,4,2008-02-18 23:43:12,2008-02-18 23:43:12
3eec925f73621eba3f5db4f2c1da22271915d8b2...f1a24be01cbd7d268d90c3fdf65a08fe1407f440,18,41,69,110,21,2008-02-19 00:08:08,2008-02-19 00:08:08
f1a24be01cbd7d268d90c3fdf65a08fe1407f440...343fa35a2cd4bb22457eb9031fa23c751c13f09d,2,14,0,14,3,2008-02-19 01:59:34,2008-02-19 01:59:34
343fa35a2cd4bb22457eb9031fa23c751c13f09d...6a796690e67e73f98e92538273e7d2840f23c2b8,1,60,12,72,24,2008-02-19 02:58:41,2008-02-19 02:58:41
6a796690e67e73f98e92538273e7d2840f23c2b8...68e43660d837938fcd8fb86c3b9b9d324eaa86a5,6,4489,0,4489,4,2008-02-19 03:38:16,2008-02-19 03:38:16
68e43660d837938fcd8fb86c3b9b9d324eaa86a5...99b200dac7e416d3a05c332cd8a03da54a7a7285,1,1,1,2,1,2008-02-19 03:40:24,2008-02-19 03:40:24
99b200dac7e416d3a05c332cd8a03da54a7a7285...dd2afd7105aa3df55a3f7f949ff31a441ed30c54,1,4,7,11,2,2008-02-21 20:50:07,2008-02-21 20:50:07
dd2afd7105aa3df55a3f7f949ff31a441ed30c54...54546f23f09a989ee3c1c3e629eac98706b6262e,2,10,0,10,2,2008-02-21 21:27:44,2008-02-21 21:27:44
54546f23f09a989ee3c1c3e629eac98706b6262e...c1f45c326c4bdeb8821844f6ee4bfd2817ab6a63,4,45,7,52,12,2008-02-22 12:50:10,2008-02-22 12:50:10
c1f45c326c4bdeb8821844f6ee4bfd2817ab6a63...32402773f10160a5cf3252a325c98f5e74fb7ceb,2,31,1,32,2,2008-02-23 08:36:41,2008-02-23 08:36:41
32402773f10160a5cf3252a325c98f5e74fb7ceb...6482f1f8877638493810d2740c56e1b62519c8bd,2,13,0,13,3,2008-02-23 09:15:35,2008-02-23 09:15:35
6482f1f8877638493810d2740c56e1b62519c8bd...5ca0b9203b6f852b65f454e1b20bf3d478561b64,10,218,14,232,24,2008-02-25 06:02:35,2008-02-25 06:02:35
5ca0b9203b6f852b65f454e1b20bf3d478561b64...aad8342aa43cb9fba8d4989f844df41333719738,1,5,5,10,3,2008-02-25 19:38:09,2008-02-25 19:38:09
aad8342aa43cb9fba8d4989f844df41333719738...297a12c2d16c66e7b8573be12c33cebe7d16bb86,1,0,0,0,0,2008-02-26 20:23:10,2008-02-26 20:23:10
297a12c2d16c66e7b8573be12c33cebe7d16bb86...df5fef33c965ba324563c4a8a1faec82ccfbe98c,2,61,21,82,8,2008-02-26 21:13:16,2008-02-26 21:13:16
df5fef33c965ba324563c4a8a1faec82ccfbe98c...00f051985933abd32c545f54487de571df813c67,1,11,3,14,1,2008-02-26 21:18:34,2008-02-26 21:18:34
00f051985933abd32c545f54487de571df813c67...f7fbc289ad7e13436f17939046cd1adfe438b126,2,0,13,13,3,2008-02-26 22:17:45,2008-02-26 22:17:45
f7fbc289ad7e13436f17939046cd1adfe438b126...a9b4efc82b23383038fed6da6ba97242aece27c1,2,13,0,13,3,2008-02-26 23:12:47,2008-02-26 23:12:47
a9b4efc82b23383038fed6da6ba97242aece27c1...9780247a4c21f36f67ee636482399e306154f0bc,1,2,2,4,2,2008-02-27 07:58:00,2008-02-27 07:58:00
9780247a4c21f36f67ee636482399e306154f0bc...03ebd159a0471350e7d799e89740f2d7a2d419e8,1,2,1,3,1,2008-02-28 01:52:59,2008-02-28 01:52:59
03ebd159a0471350e7d799e89740f2d7a2d419e8...16d57cd85f476673f7738b616f387857c9f4c1b1,2,240,96,336,216,2008-02-29 16:45:36,2008-02-29 16:45:36
16d57cd85f476673f7738b616f387857c9f4c1b1...6c51ce488ba8e19492601706b827c2ee78d03e30,4,3544,1569,5113,459,2008-02-29 16:46:04,2008-02-29 16:46:04
6c51ce488ba8e19492601706b827c2ee78d03e30...d5d2072bbfc38015a93d6e13136c3f1dbf125d87,1,4,4,8,2,2008-02-29 17:00:35,2008-02-29 17:00:35
d5d2072bbfc38015a93d6e13136c3f1dbf125d87...2dbb08e5dc7fe97d912855de530713a4ff7e42c0,1,5,1,6,1,2008-02-29 17:13:20,2008-02-29 17:13:20
2dbb08e5dc7fe97d912855de530713a4ff7e42c0...efed04b6346b5eab4e01af66f9928275521ac30b,5,18,7,25,8,2008-02-29 18:38:44,2008-02-29 18:38:44
efed04b6346b5eab4e01af66f9928275521ac30b...931b9f310854e30a814cb3073c67007e709f6e5f,1,2,2,4,2,2008-02-29 19:05:52,2008-02-29 19:05:52
931b9f310854e30a814cb3073c67007e709f6e5f...8746f058c4caa7e62e859718fb6d5daec53f207c,2,353,400,753,392,2008-02-29 20:23:48,2008-02-29 20:23:48
8746f058c4caa7e62e859718fb6d5daec53f207c...9fa82a6aa90531cb7b894031abf859610306f396,2,2,3,5,3,2008-03-02 10:50:36,2008-03-02 10:50:36
9fa82a6aa90531cb7b894031abf859610306f396...7f24ee5b33fd3a4805cdd1a9f4b478995e03a1db,2,1,1,2,1,2008-03-04 11:30:36,2008-03-04 11:30:36
7f24ee5b33fd3a4805cdd1a9f4b478995e03a1db...6bc499f03c42e37a462f645fffab8712d471825f,1,1,1,2,1,2008-03-06 00:54:14,2008-03-06 00:54:14
6bc499f03c42e37a462f645fffab8712d471825f...c3d873fc3ec6b5fee73dda0bc56eb1285a8bc23a,1,4,0,4,1,2008-03-06 17:10:04,2008-03-06 17:10:04
c3d873fc3ec6b5fee73dda0bc56eb1285a8bc23a...7092bcee6e399fec5fc143a0e014a103099d6660,2,2510,997,3507,554,2008-03-07 13:14:59,2008-03-07 13:14:59
7092bcee6e399fec5fc143a0e014a103099d6660...1e2852a15dd120ff542a4805d8dceed82fb56ba7,1,6,4,10,1,2008-03-07 13:53:49,2008-03-07 13:53:49
1e2852a15dd120ff542a4805d8dceed82fb56ba7...d73c70d1ed34b53c21909f9d772a12bf85504601,4,42,3,45,5,2008-03-08 03:06:30,2008-03-08 03:06:30
d73c70d1ed34b53c21909f9d772a12bf85504601...a75e58be589c4dcccb7359e47fe307c2007458f4,1,1,1,2,1,2008-03-08 03:09:29,2008-03-08 03:09:29
a75e58be589c4dcccb7359e47fe307c2007458f4...7fbebae8c8797fa7452466055b53c42d6b123811,1,14,2,16,2,2008-03-08 03:12:27,2008-03-08 03:12:27
7fbebae8c8797fa7452466055b53c42d6b123811...444b7b28495621ff77c2e9539413bd93696c848f,1,4,3,7,1,2008-03-08 03:19:52,2008-03-08 03:19:52
444b7b28495621ff77c2e9539413bd93696c848f...4d6f0f26508eea4a16adc4de613777b82701fd31,1,11,5,16,2,2008-03-08 03:31:42,2008-03-08 03:31:42
4d6f0f26508eea4a16adc4de613777b82701fd31...5b762ca8e7e3e85ba35738f0919ed48d5e23e69c,1,25,21,46,20,2008-03-08 03:46:33,2008-03-08 03:46:33
5b762ca8e7e3e85ba35738f0919ed48d5e23e69c...dcdd9b3c637968ee377a852178e23706b301b0f1,1,14,15,29,12,2008-03-08 03:55:47,2008-03-08 03:55:47
dcdd9b3c637968ee377a852178e23706b301b0f1...4487be66efbd9e78804f59e4b6f0cf5d977c7d6b,1,1,1,2,1,2008-03-08 14:41:13,2008-03-08 14:41:13
4487be66efbd9e78804f59e4b6f0cf5d977c7d6b...1f0de0312e0899aa1d45ad3d95c1d477b070cec7,1,3,0,3,2,2008-03-09 19:40:31,2008-03-09 19:40:31
1f0de0312e0899aa1d45ad3d95c1d477b070cec7...e3e2fb3ff097f9a1fb3c279f34509bd87ca29d82,1,1,1,2,1,2008-03-09 19:41:21,2008-03-09 19:41:21
e3e2fb3ff097f9a1fb3c279f34509bd87ca29d82...a128ce785fe8678a806538b8cfb1078d943afe73,1,3,3,6,2,2008-03-09 21:59:09,2008-03-09 21:59:09
a128ce785fe8678a806538b8cfb1078d943afe73...50bf56767531e1f29e000d039237ad1149d46bad,3,5,0,5,3,2008-03-10 22:18:50,2008-03-10 22:18:50
50bf56767531e1f29e000d039237ad1149d46bad...42712048d363532469cbeff1b0b6a1734c5be5fe,2,90,12,102,9,2008-03-10 23:32:28,2008-03-10 23:32:28
42712048d363532469cbeff1b0b6a1734c5be5fe...866d7fa961702353443edbaaeb253b823c77f6a7,1,24,24,48,7,2008-03-11 06:40:50,2008-03-11 06:40:50
866d7fa961702353443edbaaeb253b823c77f6a7...a74299fb61bae1753c385c35c6b3a349507c103c,1,1,1,2,1,2008-03-11 06:49:36,2008-03-11 06:49:36
a74299fb61bae1753c385c35c6b3a349507c103c...cb4a018c35c0b4e3d8ad98d7664bfd309ec7c82c,1,1,1,2,1,2008-03-11 23:09:44,2008-03-11 23:09:44
cb4a018c35c0b4e3d8ad98d7664bfd309ec7c82c...54d5b9ec87b9a4e6da7bd9fec99ce0ba2f9fb44a,1,19,6,25,5,2008-03-12 00:09:13,2008-03-12 00:09:13
54d5b9ec87b9a4e6da7bd9fec99ce0ba2f9fb44a...79abd052e73b985c144c9aa0832a141aa3ff445f,1,12,12,24,11,2008-03-12 06:42:09,2008-03-12 06:42:09
79abd052e73b985c144c9aa0832a141aa3ff445f...48d7a6fb300a8ccf0aab081c4205278b0cc5ccf3,1,235,0,235,1,2008-03-13 20:12:53,2008-03-13 20:12:53
48d7a6fb300a8ccf0aab081c4205278b0cc5ccf3...b448b678e88f532de1a607871881b2339c7d1ee5,1,4,4,8,1,2008-03-13 20:23:06,2008-03-13 20:23:06
b448b678e88f532de1a607871881b2339c7d1ee5...2b8c2c49e796c06f0e3a4836936bcabb748b8211,2,7,5,12,5,2008-03-13 20:26:08,2008-03-13 20:26:08
2b8c2c49e796c06f0e3a4836936bcabb748b8211...af5f07897cf6938b0a83ece681564745cdb0f5e3,1,2,0,2,1,2008-03-14 00:07:01,2008-03-14 00:07:01
af5f07897cf6938b0a83ece681564745cdb0f5e3...dd69bdcf946eac3740b8947eb2d412d53371a5a9,1,1,1,2,1,2008-03-14 18:17:08,2008-03-14 18:17:08
dd69bdcf946eac3740b8947eb2d412d53371a5a9...23c2b998a541ecece15dd4b0e40805092db56876,2,233,282,515,281,2008-03-16 15:58:11,2008-03-16 15:58:11
23c2b998a541ecece15dd4b0e40805092db56876...31027a869225df8465f9e2cf3bd506e4cb7fb2a1,2,41,41,82,40,2008-03-16 19:11:09,2008-03-16 19:11:09
31027a869225df8465f9e2cf3bd506e4cb7fb2a1...8defa8fd2739c908f667c94fb489d299e190fc5b,3,3453,2141,5594,575,2008-03-17 13:45:08,2008-03-17 13:45:08
8defa8fd2739c908f667c94fb489d299e190fc5b...30bdabb2b0d01e1f89af18028ab1605db734bd4b,2,12,3,15,3,2008-03-17 13:49:04,2008-03-17 13:49:04
30bdabb2b0d01e1f89af18028ab1605db734bd4b...50ecd7537909915bc5faed644817a58c0a1f765e,2,9,3,12,5,2008-03-17 14:05:43,2008-03-17 14:05:43
50ecd7537909915bc5faed644817a58c0a1f765e...732074541a17cde1d6d634007949d8a8c83cdc1a,2,6,0,6,2,2008-03-17 14:15:15,2008-03-17 14:15:15
732074541a17cde1d6d634007949d8a8c83cdc1a...b5adaec4c23e3fa8ab52da1c10eb52f775d02209,2,5,2,7,2,2008-03-17 14:21:09,2008-03-17 14:21:09
b5adaec4c23e3fa8ab52da1c10eb52f775d02209...e461e737d3843735a316e815cd0afe1b88433e88,1,5,2,7,2,2008-03-17 14:55:30,2008-03-17 14:55:30
e461e737d3843735a316e815cd0afe1b88433e88...b1dbff729fa11be2a02461e5fec9ba0eb1c2ffe6,1,10,0,10,2,2008-03-17 15:53:01,2008-03-17 15:53:01
b1dbff729fa11be2a02461e5fec9ba0eb1c2ffe6...fac84c0bf4ca1481e7bf5b4dd43adf22d95dd150,1,6,5,11,1,2008-03-17 16:03:46,2008-03-17 16:03:46
fac84c0bf4ca1481e7bf5b4dd43adf22d95dd150...642f42bf71848edfa8b5bea2cb58f638e046a86b,1,295,0,295,1,2008-03-17 16:53:20,2008-03-17 16:53:20
642f42bf71848edfa8b5bea2cb58f638e046a86b...d0aa7c820b8e654bdf23382a08ba26d3e58a0a4b,1,11,11,22,3,2008-03-17 16:56:05,2008-03-17 16:56:05
d0aa7c820b8e654bdf23382a08ba26d3e58a0a4b...ba3d5272b5dc818dd7dfa589ea3fdf79cc4252a7,1,9,0,9,1,2008-03-17 17:26:02,2008-03-17 17:26:02
ba3d5272b5dc818dd7dfa589ea3fdf79cc4252a7...5794111afadf73ceedd1c26bc4e7d56953b60ed9,1,5,1,6,2,2008-03-17 17:29:10,2008-03-17 17:29:10
5794111afadf73ceedd1c26bc4e7d56953b60ed9...d0032458a26bdd51729ce6ce372ec2c8094a96b6,6,35,2,37,7,2008-03-17 17:47:34,2008-03-17 17:47:34
d0032458a26bdd51729ce6ce372ec2c8094a96b6...3c504b0f5c059b406e8b838659e39ad3247753e5,186,100,112,212,117,2008-03-17 18:23:00,2008-03-17 18:23:00
3c504b0f5c059b406e8b838659e39ad3247753e5...4f5f8735e31267d07f8f4e4854bd16149f3de833,1,6,1,7,2,2008-03-17 19:31:42,2008-03-17 19:31:42
4f5f8735e31267d07f8f4e4854bd16149f3de833...8e14a4e6d7718cb1c1866453bc6b404df0c938b4,2,214,3,217,33,2008-03-18 00:14:41,2008-03-18 00:14:41
8e14a4e6d7718cb1c1866453bc6b404df0c938b4...17155d38459d46b84d7945f6fb382199ac1961fb,2,3,2,5,3,2008-03-18 00:17:59,2008-03-18 00:17:59
17155d38459d46b84d7945f6fb382199ac1961fb...e5342282cc93f6178ed23eff19f5eda76dcd07c8,1,81,75,156,49,2008-03-18 04:21:08,2008-03-18 04:21:08
e5342282cc93f6178ed23eff19f5eda76dcd07c8...1b331f6c1eadc55e6efe014ec5f5b91df83961ff,1,9,6,15,2,2008-03-18 14:08:40,2008-03-18 14:08:40
1b331f6c1eadc55e6efe014ec5f5b91df83961ff...4b9497c3f13d9fb410d552cfceaa98eafb2ffa10,1,2,2,4,2,2008-03-18 14:08:56,2008-03-18 14:08:56
4b9497c3f13d9fb410d552cfceaa98eafb2ffa10...ec0bbc15a82cb1cf394a1296024b8e0b35d70728,2,21,9,30,11,2008-03-18 14:20:43,2008-03-18 14:20:43
ec0bbc15a82cb1cf394a1296024b8e0b35d70728...73328bf8ec2777dacf4f4f3b23c286181b8a6e13,1,6,1,7,2,2008-03-18 14:34:48,2008-03-18 14:34:48
73328bf8ec2777dacf4f4f3b23c286181b8a6e13...5b8974c7b3cbde2d63ddda8f3bddfa2637af5bb9,1,4,6,10,5,2008-03-18 14:35:05,2008-03-18 14:35:05
5b8974c7b3cbde2d63ddda8f3bddfa2637af5bb9...9b52f35f35d67d6b4db2206d34320545dc4dd17d,3,315,315,630,3,2008-03-18 14:54:39,2008-03-18 14:54:39
9b52f35f35d67d6b4db2206d34320545dc4dd17d...f0dec08c3a40434310cfbe0748eb9587c7279500,2,11,5,16,4,2008-03-18 15:40:27,2008-03-18 15:40:27
f0dec08c3a40434310cfbe0748eb9587c7279500...a752a3d41973dfae6c03d927f030e5975e836e6b,2,14,2,16,5,2008-03-18 15:53:46,2008-03-18 15:53:46
a752a3d41973dfae6c03d927f030e5975e836e6b...75617ef69f7b0fa491ce1d3cb5d4a8d478203ad1,1,27,0,27,1,2008-03-18 18:20:45,2008-03-18 18:20:45
75617ef69f7b0fa491ce1d3cb5d4a8d478203ad1...df225aee18176e9997d102185bc490a52b31e2fc,1,5,3,8,4,2008-03-18 18:41:52,2008-03-18 18:41:52
df225aee18176e9997d102185bc490a52b31e2fc...57ddcdb0c858e772ed741e25b8e303cb7a55472b,1,3,3,6,3,2008-03-18 19:02:24,2008-03-18 19:02:24
57ddcdb0c858e772ed741e25b8e303cb7a55472b...ebf3cdea733c82e2e104cd1417c57a52c54b26e0,1,2,2,4,1,2008-03-18 19:13:41,2008-03-18 19:13:41
ebf3cdea733c82e2e104cd1417c57a52c54b26e0...41d101e9ce10ab08051db47500f24a701b6882e9,1,9,8,17,1,2008-03-18 19:55:21,2008-03-18 19:55:21
41d101e9ce10ab08051db47500f24a701b6882e9...cc083724c1c06c3b490affe47b76f5ef34ef136f,3,18,4,22,3,2008-03-18 20:58:39,2008-03-18 20:58:39
cc083724c1c06c3b490affe47b76f5ef34ef136f...855bc7b09d5f511fe7eb71e2f35cd0154451e357,1,10,0,10,1,2008-03-18 21:13:12,2008-03-18 21:13:12
855bc7b09d5f511fe7eb71e2f35cd0154451e357...d67208f5bea85d731c8171070381cd80173dffd4,2,313,86,399,32,2008-03-18 21:13:48,2008-03-18 21:13:48
d67208f5bea85d731c8171070381cd80173dffd4...08d4910d697d4fb8a199797e0938b0da653d3c3e,1,27,23,50,8,2008-03-18 21:40:45,2008-03-18 21:40:45
08d4910d697d4fb8a199797e0938b0da653d3c3e...6c2a78b26653739fe688dbf4d97b27aab1ebeca7,1,4,0,4,1,2008-03-18 21:53:39,2008-03-18 21:53:39
6c2a78b26653739fe688dbf4d97b27aab1ebeca7...6c06f8f10f76595bd91fa802a5b9d3039a330af7,1,15,2,17,2,2008-03-18 21:58:31,2008-03-18 21:58:31
6c06f8f10f76595bd91fa802a5b9d3039a330af7...c016352229ad0072e1bd0c6a05800fa75db852e8,1,2,2,4,2,2008-03-18 22:21:04,2008-03-18 22:21:04
c016352229ad0072e1bd0c6a05800fa75db852e8...edb3381c7a938e0a20cc09cb68f40cd40da778d3,1,133,0,133,1,2008-03-18 22:36:14,2008-03-18 22:36:14
edb3381c7a938e0a20cc09cb68f40cd40da778d3...33d7fbd82dff80dc20380d107b4478761e4047a3,1,5,2,7,1,2008-03-18 22:36:30,2008-03-18 22:36:30
33d7fbd82dff80dc20380d107b4478761e4047a3...d3093358e6c9ccc79d69952c416288cfda9963bf,2,557,390,947,256,2008-03-18 22:59:00,2008-03-18 22:59:00
d3093358e6c9ccc79d69952c416288cfda9963bf...39b1f1dd80ca32f7dbc13a10a02f1f94ebe25cdf,1,14,0,14,1,2008-03-18 23:18:52,2008-03-18 23:18:52
39b1f1dd80ca32f7dbc13a10a02f1f94ebe25cdf...7d74376aabc64952264c12798ba9dcf868e195f0,1,6,0,6,1,2008-03-18 23:38:59,2008-03-18 23:38:59
7d74376aabc64952264c12798ba9dcf868e195f0...32933d27b23f4cf0a142f797e2fda8af2434a1e4,2,2,1,3,2,2008-03-19 04:04:19,2008-03-19 04:04:19
32933d27b23f4cf0a142f797e2fda8af2434a1e4...6035af82d4c7905c619bccdee030bdfc1721ad0c,1,7,2,9,1,2008-03-19 15:10:31,2008-03-19 15:10:31
6035af82d4c7905c619bccdee030bdfc1721ad0c...bc1f67a6de45fe2ebfdf69ba449295066f365419,7,179,84,263,42,2008-03-19 19:11:51,2008-03-19 19:11:51
bc1f67a6de45fe2ebfdf69ba449295066f365419...4457ba002d64d4a991b0561c5be69a8c61b2b828,5,104,5,109,10,2008-03-19 22:29:11,2008-03-19 22:29:11
4457ba002d64d4a991b0561c5be69a8c61b2b828...bb2e395af77661de650fa8d6d7cd593768c94e30,1,4,3,7,3,2008-03-19 22:34:40,2008-03-19 22:34:40
bb2e395af77661de650fa8d6d7cd593768c94e30...94269654d17e2feab50fda6d8241427eb3a4c4ab,1,1,0,1,1,2008-03-19 22:44:56,2008-03-19 22:44:56
94269654d17e2feab50fda6d8241427eb3a4c4ab...649cdf907d5d23290caf3cc7e34426c39dfa4159,3,57,21,78,12,2008-03-19 23:10:45,2008-03-19 23:10:45
649cdf907d5d23290caf3cc7e34426c39dfa4159...6417f5247b98d5457d5b62c313cd8e1edeaa5e63,5,42,0,42,4,2008-03-20 06:35:53,2008-03-20 06:35:53
6417f5247b98d5457d5b62c313cd8e1edeaa5e63...9e47cc2e518cf14a55845b65007fabe8a6b00da7,3,8,6,14,3,2008-03-20 06:43:58,2008-03-20 06:43:58
9e47cc2e518cf14a55845b65007fabe8a6b00da7...597f9d61050ee15df807bda6a7d9a0ff5def9774,5,47,6,53,11,2008-03-20 06:50:54,2008-03-20 06:50:54
597f9d61050ee15df807bda6a7d9a0ff5def9774...b3b8422363dd450d1ff1a376ab1f74cf2e22ce1b,3,33,1,34,3,2008-03-20 06:56:23,2008-03-20 06:56:23
b3b8422363dd450d1ff1a376ab1f74cf2e22ce1b...f8578d7f19efc5d1b0e5961fa6e6a7868b27132a,1,0,0,0,0,2008-03-20 06:56:46,2008-03-20 06:56:46
f8578d7f19efc5d1b0e5961fa6e6a7868b27132a...c01e6b852ab652e9ba3f7d3ac43cd5d20802a215,1,6,0,6,3,2008-03-20 07:01:26,2008-03-20 07:01:26
c01e6b852ab652e9ba3f7d3ac43cd5d20802a215...c0537a961fcf412ff284a838e4394fc537c14dcf,3,21,0,21,3,2008-03-20 07:16:16,2008-03-20 07:16:16
c0537a961fcf412ff284a838e4394fc537c14dcf...463a03d7e304a08fbe9af85de241746d5f242391,1,10,10,20,10,2008-03-20 07:19:53,2008-03-20 07:19:53
463a03d7e304a08fbe9af85de241746d5f242391...516102dc756bdfbb0d71185067d0ec1ab91adef3,1,4,1,5,1,2008-03-20 07:36:33,2008-03-20 07:36:33
516102dc756bdfbb0d71185067d0ec1ab91adef3...675db84f2303650140f867b31dbac9b7edf71eb3,2,75,2,77,6,2008-03-20 07:44:46,2008-03-20 07:44:46
675db84f2303650140f867b31dbac9b7edf71eb3...8f9e7035a9c998540e68129cf4fd383bc64a66df,1,2,2,4,2,2008-03-20 12:44:34,2008-03-20 12:44:34
8f9e7035a9c998540e68129cf4fd383bc64a66df...1e23ad0b655369161449120d78d01db402708ee4,1,0,2,2,1,2008-03-21 20:35:39,2008-03-21 20:35:39
1e23ad0b655369161449120d78d01db402708ee4...c364b6b3616d3f0840d6e7bd86787d53ac04c6c8,1,4,1,5,1,2008-03-21 21:08:39,2008-03-21 21:08:39
c364b6b3616d3f0840d6e7bd86787d53ac04c6c8...6e2c677ef95e720692cf34c310110a9e698d3b07,1,4,3,7,2,2008-03-21 21:39:50,2008-03-21 21:39:50
6e2c677ef95e720692cf34c310110a9e698d3b07...f3b48a21fb62c5baf46aa600493acf26308d0b14,1,38,32,70,20,2008-03-21 21:52:34,2008-03-21 21:52:34
f3b48a21fb62c5baf46aa600493acf26308d0b14...0fea1348d6ade374a91f8328d630dd442c1bc7c9,1,2,2,4,1,2008-03-23 05:45:59,2008-03-23 05:45:59
0fea1348d6ade374a91f8328d630dd442c1bc7c9...99150048ac1158e3978c2854bdb07bd4f2fce9fe,1,1,1,2,1,2008-03-23 10:14:32,2008-03-23 10:14:32
99150048ac1158e3978c2854bdb07bd4f2fce9fe...622a6447f90b967a0b500057f6292e5f83b86332,1,15,5,20,6,2008-03-24 13:10:48,2008-03-24 13:10:48
622a6447f90b967a0b500057f6292e5f83b86332...eb6a6c46199bb8c9b5931d1ed7103677f78b2dbd,1,12,1,13,2,2008-03-24 13:27:19,2008-03-24 13:27:19
eb6a6c46199bb8c9b5931d1ed7103677f78b2dbd...a9a70bfe555676226b075003805f4517ac1bac9a,1,39,16,55,7,2008-03-24 13:35:27,2008-03-24 13:35:27
a9a70bfe555676226b075003805f4517ac1bac9a...89e7b673d836b6aa1a9586c1319c86ba7b7ea262,1,2,1,3,1,2008-03-24 14:02:44,2008-03-24 14:02:44
89e7b673d836b6aa1a9586c1319c86ba7b7ea262...23912ebbe25e2ef9526164da74e79eb9a7a24d69,1,17,0,17,2,2008-03-24 14:19:12,2008-03-24 14:19:12
23912ebbe25e2ef9526164da74e79eb9a7a24d69...0e552e5cd619ab61e597b1fc6d725b29ef7bfc56,8,25,26,51,15,2008-03-25 04:42:21,2008-03-25 04:42:21
0e552e5cd619ab61e597b1fc6d725b29ef7bfc56...3d779efbe53f0abf88938f0c7963bd3b3639e46a,1,2,2,4,2,2008-03-25 05:13:08,2008-03-25 05:13:08
3d779efbe53f0abf88938f0c7963bd3b3639e46a...054c2e4af390c083a33c5a19093efd47def780de,2,10,10,20,9,2008-03-25 05:20:55,2008-03-25 05:20:55
054c2e4af390c083a33c5a19093efd47def780de...c30a050e41efa4c1194e78c33edad22e59d25ac4,8,2,157,159,7,2008-03-26 08:25:48,2008-03-26 08:25:48
c30a050e41efa4c1194e78c33edad22e59d25ac4...d5cb46f4129bb5e69e6b3b35f23187c803cab67a,1,1,1,2,1,2008-03-27 14:15:00,2008-03-27 14:15:00
d5cb46f4129bb5e69e6b3b35f23187c803cab67a...7dd4be581beadd8d0ec751054e0f72ef36aef5cf,3,328,0,328,3,2008-03-27 15:03:52,2008-03-27 15:03:52
7dd4be581beadd8d0ec751054e0f72ef36aef5cf...95665c403bc74fdba34142a479b67e4a726a26fa,1,1,1,2,1,2008-03-27 15:05:40,2008-03-27 15:05:40
95665c403bc74fdba34142a479b67e4a726a26fa...5d6510e285045065553b6f8b4b11e15ad55545a1,0,0,0,0,0,2008-03-27 15:11:10,2008-03-27 15:11:10
5d6510e285045065553b6f8b4b11e15ad55545a1...905b246dad0bf5fe7959de661a39dde4bfcda02a,1,1,1,2,1,2008-03-27 15:13:05,2008-03-27 15:13:05
905b246dad0bf5fe7959de661a39dde4bfcda02a...4c3fcbc4bc901db6f3b92a33bccd45fe069f9617,1,1,1,2,1,2008-03-27 15:14:57,2008-03-27 15:14:57
4c3fcbc4bc901db6f3b92a33bccd45fe069f9617...bd3c955bd51dbe0b0d2b4a6f4c7c1e936a43203d,1,7,1,8,2,2008-03-27 22:07:40,2008-03-27 22:07:40
bd3c955bd51dbe0b0d2b4a6f4c7c1e936a43203d...c88ab319954e4e3d454e37aacb982d67ab0575cf,4,577,407,984,264,2008-03-29 00:43:57,2008-03-29 00:43:57
c88ab319954e4e3d454e37aacb982d67ab0575cf...ff1e505a15c46cca378792c14ec7b245c3d62473,2,121,125,246,119,2008-03-29 00:45:25,2008-03-29 00:45:25
ff1e505a15c46cca378792c14ec7b245c3d62473...165772f37e4cbbc42e95404d6da69d70ed836806,1,1,1,2,1,2008-03-29 15:26:58,2008-03-29 15:26:58
165772f37e4cbbc42e95404d6da69d70ed836806...a3747f23be69d607fdaa4fbc757341c4673ecd1f,1,6,7,13,4,2008-03-29 15:48:13,2008-03-29 15:48:13
a3747f23be69d607fdaa4fbc757341c4673ecd1f...0c222b9533fa44fe7783e8673656ba1854ab5e02,1,1,1,2,1,2008-03-29 15:54:43,2008-03-29 15:54:43
0c222b9533fa44fe7783e8673656ba1854ab5e02...3a662052ecd4ec7099a264b9aad5498f4b8953ad,1,3,0,3,3,2008-03-29 16:42:39,2008-03-29 16:42:39
3a662052ecd4ec7099a264b9aad5498f4b8953ad...51c8828d0c096cb7a82a2cb6f1558750eb84e20c,2,162,141,303,139,2008-03-29 20:06:03,2008-03-29 20:06:03
51c8828d0c096cb7a82a2cb6f1558750eb84e20c...a9ce132657a338fab2326d0de98008f87f85f8fd,4,1200,555,1755,361,2008-03-30 00:07:59,2008-03-30 00:07:59
a9ce132657a338fab2326d0de98008f87f85f8fd...b8110ed537408ef78027f70c242885c7a955e1bb,1,12,8,20,3,2008-03-30 04:21:50,2008-03-30 04:21:50
b8110ed537408ef78027f70c242885c7a955e1bb...502f0c18b040a0f9aba45a32d4a4155926342651,1,5,6,11,1,2008-03-30 04:23:54,2008-03-30 04:23:54
502f0c18b040a0f9aba45a32d4a4155926342651...38d30e96914c28d116a5a93a1d6a90e3a6a00135,1,11,10,21,1,2008-03-30 13:35:12,2008-03-30 13:35:12
38d30e96914c28d116a5a93a1d6a90e3a6a00135...659a14bf9a0d25ed0936f8ec0de289095a0c83cd,2,37,38,75,35,2008-04-04 00:43:27,2008-04-04 00:43:27
659a14bf9a0d25ed0936f8ec0de289095a0c83cd...42ba4281667fe0acebb4181abcf00ad39e72ef4a,4,3629,1945,5574,574,2008-04-05 02:50:01,2008-04-05 02:50:01
42ba4281667fe0acebb4181abcf00ad39e72ef4a...435d1d33cd399ec37e137dae9191c87476b29b73,2,4506,1850,6356,607,2008-04-05 02:53:10,2008-04-05 02:53:10
435d1d33cd399ec37e137dae9191c87476b29b73...7fbea577e6c4de249c17727e635b2ccfc1804ad6,3,18,17,35,17,2008-04-05 02:59:41,2008-04-05 02:59:41
7fbea577e6c4de249c17727e635b2ccfc1804ad6...25c0908ffdc9af2d73f8055c175e30ca82e1b981,1,3,2,5,1,2008-04-08 06:28:50,2008-04-08 06:28:50
25c0908ffdc9af2d73f8055c175e30ca82e1b981...1972f0522ab07f88eea526d2f8e1e19dbfa06dab,1,1,1,2,1,2008-04-08 06:35:37,2008-04-08 06:35:37
1972f0522ab07f88eea526d2f8e1e19dbfa06dab...bd3a1c006775c86be1472dac0b50d5bdcc9591ec,1,1,1,2,1,2008-04-10 00:26:12,2008-04-10 00:26:12
bd3a1c006775c86be1472dac0b50d5bdcc9591ec...aad5e791ea424ed72f03cb6ba1bb12fc1ab9f54c,1,1,0,1,1,2008-04-10 04:05:37,2008-04-10 04:05:37
aad5e791ea424ed72f03cb6ba1bb12fc1ab9f54c...15a39f7fe5eb99916f5be319632db15f5a81ade9,1,6,6,12,2,2008-04-10 17:44:40,2008-04-10 17:44:40
15a39f7fe5eb99916f5be319632db15f5a81ade9...939d9e1be60019df912e7f45ee3474b8ae0cdc52,2,128,129,257,124,2008-04-13 01:35:53,2008-04-13 01:35:53
939d9e1be60019df912e7f45ee3474b8ae0cdc52...6dfe245f02d62ade0aa1135893e0f074de4e8eb1,1,4,4,8,4,2008-04-13 01:50:29,2008-04-13 01:50:29
6dfe245f02d62ade0aa1135893e0f074de4e8eb1...35afdedbed6345a3b078ebea0a105718109d7fda,1,9,1,10,3,2008-04-13 02:04:10,2008-04-13 02:04:10
35afdedbed6345a3b078ebea0a105718109d7fda...83fe38d74cc73b2d77a6e7f6a730d965d0bc43e2,2,10,13,23,12,2008-04-13 18:57:34,2008-04-13 18:57:34
83fe38d74cc73b2d77a6e7f6a730d965d0bc43e2...52945a95158dabdb8b381991fe9c1a3b218b9b52,2,36,33,69,29,2008-04-14 19:52:18,2008-04-14 19:52:18
52945a95158dabdb8b381991fe9c1a3b218b9b52...ea87c0df5c0f2f1e7db6bbb2fc61141cec62e4f5,1,8,5,13,4,2008-04-15 01:13:52,2008-04-15 01:13:52
ea87c0df5c0f2f1e7db6bbb2fc61141cec62e4f5...8453a1750f4ba2925bcccd775def0d8d255d6b99,1,7,1,8,1,2008-04-15 02:00:15,2008-04-15 02:00:15
8453a1750f4ba2925bcccd775def0d8d255d6b99...d15e290cb1d0fcec20c79d499873e4360d515f5d,1,0,0,0,0,2008-04-15 02:07:49,2008-04-15 02:07:49
d15e290cb1d0fcec20c79d499873e4360d515f5d...6032f6f1ed0debd5e07cd31682a11da26f82b5a9,1,24,59,83,40,2008-04-18 10:37:00,2008-04-18 10:37:00
6032f6f1ed0debd5e07cd31682a11da26f82b5a9...5adf26ee54b71bcf79c4060a477d294ae83148d0,2,170,160,330,143,2008-04-25 13:16:15,2008-04-25 13:16:15
5adf26ee54b71bcf79c4060a477d294ae83148d0...15a39660373723b43c816a435f4aac99f64dd440,2,15,5,20,5,2008-04-26 12:42:00,2008-04-26 12:42:00
15a39660373723b43c816a435f4aac99f64dd440...138cecd89250d3a4b945f1420b06071ab9cabdee,5,3754,1487,5241,415,2008-04-26 12:46:57,2008-04-26 12:46:57
138cecd89250d3a4b945f1420b06071ab9cabdee...2945a057c3e7752d2a30ac7e4bb07be9fdccb10e,1,6,2,8,2,2008-04-26 13:25:30,2008-04-26 13:25:30
2945a057c3e7752d2a30ac7e4bb07be9fdccb10e...c91a30f00fd182faf8ca5c03cd7dbcf8b735b458,2,1,1,2,1,2008-04-27 01:09:11,2008-04-27 01:09:11
c91a30f00fd182faf8ca5c03cd7dbcf8b735b458...9c52d56f6f8a9cdafb231adf9f4110473099c9b5,57,5722,1744,7466,379,2008-04-27 02:50:16,2008-04-27 02:50:16
9c52d56f6f8a9cdafb231adf9f4110473099c9b5...d0c49e7b779b37569f564abb1675cb764ab65c04,1,1,1,2,1,2008-04-27 11:44:11,2008-04-27 11:44:11
d0c49e7b779b37569f564abb1675cb764ab65c04...f0bc9426b408dbcae3a0f9782cddcbb43fb9f457,2,8,8,16,8,2008-04-27 11:55:47,2008-04-27 11:55:47
f0bc9426b408dbcae3a0f9782cddcbb43fb9f457...9c53847ef43a67fafb1eff8e941a8ea75141c6d0,1,15,2,17,3,2008-04-28 00:03:01,2008-04-28 00:03:01
9c53847ef43a67fafb1eff8e941a8ea75141c6d0...d649d0f5f887f31fb44ae886ec93280d64cfc658,1,1,0,1,1,2008-04-28 00:20:40,2008-04-28 00:20:40
d649d0f5f887f31fb44ae886ec93280d64cfc658...a209115969b634086de9e25cebc496be5387a735,1,1,0,1,1,2008-04-28 00:58:21,2008-04-28 00:58:21
a209115969b634086de9e25cebc496be5387a735...81edb50cacedc19a91201469044fdb3f7b34ccbf,1,1,1,2,1,2008-04-28 00:58:42,2008-04-28 00:58:42
81edb50cacedc19a91201469044fdb3f7b34ccbf...6d986360183101c26c51adee4229bc038e63e441,1,13,13,26,9,2008-04-28 00:59:09,2008-04-28 00:59:09
6d986360183101c26c51adee4229bc038e63e441...356dfd5308aeace4c2f46405debbbac37890e0bb,2,5,1,6,2,2008-04-28 02:27:19,2008-04-28 02:27:19
356dfd5308aeace4c2f46405debbbac37890e0bb...a1e4b15f15d7807ddd35c0172b738a6e399235f6,1,2,17,19,2,2008-04-28 02:40:57,2008-04-28 02:40:57
a1e4b15f15d7807ddd35c0172b738a6e399235f6...e07a457c0054fa20dcbbf5bf41bc07191bdaa895,2,30,6,36,5,2008-04-28 04:29:06,2008-04-28 04:29:06
e07a457c0054fa20dcbbf5bf41bc07191bdaa895...1bb8260084e6a44308d4707c3568a4daa143dacd,1,4,0,4,2,2008-04-28 07:07:17,2008-04-28 07:07:17
1bb8260084e6a44308d4707c3568a4daa143dacd...ff6e529502976b24906dd59636c3795218c6d708,1,24,0,24,2,2008-04-28 11:51:16,2008-04-28 11:51:16
ff6e529502976b24906dd59636c3795218c6d708...ba010ec1c04c4832d42b088b092df0969afdb7e6,4,23,3,26,7,2008-04-28 11:51:52,2008-04-28 11:51:52
ba010ec1c04c4832d42b088b092df0969afdb7e6...db80f57c6efb23304eb9fb7899b078a85836f850,1,0,3,3,1,2008-04-28 12:09:23,2008-04-28 12:09:23
db80f57c6efb23304eb9fb7899b078a85836f850...a97f690e5dbfe9c8d1034a94373da0bedd681814,3,53,1,54,4,2008-04-28 14:14:41,2008-04-28 14:14:41
a97f690e5dbfe9c8d1034a94373da0bedd681814...13a6fd61c6b234cedf0ceebc7a66cce45c1006af,1,4,4,8,3,2008-04-28 17:31:08,2008-04-28 17:31:08
13a6fd61c6b234cedf0ceebc7a66cce45c1006af...14d6ee2dc956d06fc1014e1b3c1f1410d553157d,2,14,1,15,2,2008-04-28 21:15:05,2008-04-28 21:15:05
14d6ee2dc956d06fc1014e1b3c1f1410d553157d...2061b3f3ca959cc847790ba4b4ee3b23ca31aa52,2,2,28,30,3,2008-04-29 01:19:42,2008-04-29 01:19:42
2061b3f3ca959cc847790ba4b4ee3b23ca31aa52...db6bab5cb385e53570ec768892d6882708d8feb4,1,3,3,6,2,2008-04-29 20:55:10,2008-04-29 20:55:10
db6bab5cb385e53570ec768892d6882708d8feb4...1dee30919855790484d0e5ecbce9bafe4ea0b355,1,22,1,23,2,2008-04-30 00:03:45,2008-04-30 00:03:45
1dee30919855790484d0e5ecbce9bafe4ea0b355...3c4d353016a2720fe8dee2847c00179765325475,1,4,4,8,2,2008-05-05 16:04:50,2008-05-05 16:04:50
3c4d353016a2720fe8dee2847c00179765325475...4880ba3ce1860f84f2ce602566654c34924b4a73,0,0,0,0,0,2008-05-08 12:51:50,2008-05-08 12:51:50
4880ba3ce1860f84f2ce602566654c34924b4a73...41635d2176f7a950498b020f335232ad9f734279,1,1,1,2,1,2008-05-10 13:19:19,2008-05-10 13:19:19
41635d2176f7a950498b020f335232ad9f734279...d78e61e8bb93ec9fc93071eefb3b449201e786ea,1,2,0,2,1,2008-05-13 14:56:47,2008-05-13 14:56:47
d78e61e8bb93ec9fc93071eefb3b449201e786ea...96f03717728e949dbe21139d6be2754ec75fdc59,2,58,54,112,38,2008-05-14 09:21:37,2008-05-14 09:21:37
96f03717728e949dbe21139d6be2754ec75fdc59...7e4718f8d5d511efdbb17e99f37e97f5b91bfd6c,1,7,1,8,1,2008-05-15 22:10:53,2008-05-15 22:10:53
7e4718f8d5d511efdbb17e99f37e97f5b91bfd6c...6f76b9f58d3b34d71f31d088dc629d3337aef24e,1,6,11,17,2,2008-05-16 22:53:39,2008-05-16 22:53:39
6f76b9f58d3b34d71f31d088dc629d3337aef24e...8c9fceebb1c682401779956a787d73710feb5e6d,3,18,1,19,3,2008-05-16 23:24:36,2008-05-16 23:24:36
8c9fceebb1c682401779956a787d73710feb5e6d...2411a92fad7f18970cee4db9ce1858a8af4ba59d,1,1,1,2,1,2008-05-17 00:05:13,2008-05-17 00:05:13
2411a92fad7f18970cee4db9ce1858a8af4ba59d...875967ed3c62af66f890924524c52d7549c0f3db,2,527,501,1028,489,2008-05-18 17:18:40,2008-05-18 17:18:40
875967ed3c62af66f890924524c52d7549c0f3db...5b33adeafcabcc28dc6cab28ea80d0bc5fe445f4,1,4,3,7,1,2008-05-22 17:34:02,2008-05-22 17:34:02
5b33adeafcabcc28dc6cab28ea80d0bc5fe445f4...23e474510aeb36274dc9af1ddac6f4a2e02ef495,1,3,4,7,1,2008-05-22 19:24:25,2008-05-22 19:24:25
23e474510aeb36274dc9af1ddac6f4a2e02ef495...331768681f623da6737da5e7345b749d6f360272,1,1,1,2,1,2008-05-24 05:15:21,2008-05-24 05:15:21
331768681f623da6737da5e7345b749d6f360272...94781ad517526975de0d97ace8772c1b096e1eb3,1,1,1,2,1,2008-05-26 07:22:36,2008-05-26 07:22:36
94781ad517526975de0d97ace8772c1b096e1eb3...9191a1e74663f07a98b1a6fa46aa777f23703993,1,54,55,109,51,2008-05-26 08:33:54,2008-05-26 08:33:54
9191a1e74663f07a98b1a6fa46aa777f23703993...b7a67bd3d56a2d3ed2248250891458fc16d4739f,2,1,1,2,1,2008-05-26 08:36:46,2008-05-26 08:36:46
b7a67bd3d56a2d3ed2248250891458fc16d4739f...b0c5a432312d87aa3b79f7e28153d2ec3993120b,2,93,87,180,82,2008-05-26 08:40:41,2008-05-26 08:40:41
b0c5a432312d87aa3b79f7e28153d2ec3993120b...c853296ce0427a59cf8131e229c234b2b83de2f8,1,153,140,293,129,2008-05-26 09:16:17,2008-05-26 09:16:17
c853296ce0427a59cf8131e229c234b2b83de2f8...4d79a9588a6fcd14509218ab73d0ffcdc74a4be2,1,0,0,0,0,2008-05-26 09:17:18,2008-05-26 09:17:18
4d79a9588a6fcd14509218ab73d0ffcdc74a4be2...bd73eaf952b65b17580498fee846e8fddace68db,1,11,0,11,1,2008-05-28 20:31:03,2008-05-28 20:31:03
bd73eaf952b65b17580498fee846e8fddace68db...b2b7a0c1ccb30bc194ceaf2c8f3b4a2cda353378,1,1,1,2,1,2008-05-29 11:41:46,2008-05-29 11:41:46
b2b7a0c1ccb30bc194ceaf2c8f3b4a2cda353378...55d5f7ecf4a5deff75d9dd6f565583e4cb16fcd2,1,1,1,2,1,2008-05-29 11:42:55,2008-05-29 11:42:55
55d5f7ecf4a5deff75d9dd6f565583e4cb16fcd2...8a0b8d93b2aa88c0d5bd70a2637ebb05c04fcca8,1,7,3,10,4,2008-05-29 11:50:50,2008-05-29 11:50:50
8a0b8d93b2aa88c0d5bd70a2637ebb05c04fcca8...6b39dd6977031c2ea9fed26ebfc5ea90b570c3cb,1,6,1,7,1,2008-05-29 11:56:32,2008-05-29 11:56:32
6b39dd6977031c2ea9fed26ebfc5ea90b570c3cb...812d8d40bd27a65e7bb7d2538576a96070363572,1,2,2,4,2,2008-05-29 12:02:11,2008-05-29 12:02:11
812d8d40bd27a65e7bb7d2538576a96070363572...5837a45bd94ac06c7e2036b89701e579a2fe9faf,2,17,1,18,3,2008-05-29 12:17:03,2008-05-29 12:17:03
5837a45bd94ac06c7e2036b89701e579a2fe9faf...f696c175d855be16ecb6acadee75044db0677f7a,1,3,2,5,2,2008-05-29 12:40:25,2008-05-29 12:40:25
f696c175d855be16ecb6acadee75044db0677f7a...d4d5f4ce2f3fc27d7680c0d2a920774873232fde,1,1,1,2,1,2008-05-29 12:42:26,2008-05-29 12:42:26
d4d5f4ce2f3fc27d7680c0d2a920774873232fde...d53e8f1285247a2a9579f30982086cc495c1098d,4,96,4,100,6,2008-05-29 13:11:23,2008-05-29 13:11:23
d53e8f1285247a2a9579f30982086cc495c1098d...08d468db92f39dc819dcb4da243b6c58d4bd550e,1,4,0,4,2,2008-05-30 23:24:23,2008-05-30 23:24:23
08d468db92f39dc819dcb4da243b6c58d4bd550e...3de70a10c0668ad7f2f1da335ab515faea90b5fb,2,12,13,25,11,2008-05-31 01:01:17,2008-05-31 01:01:17
3de70a10c0668ad7f2f1da335ab515faea90b5fb...d78f86a2204e610cb0cd1e2762500b3be88be184,2,4,5,9,5,2008-06-02 16:53:43,2008-06-02 16:53:43
d78f86a2204e610cb0cd1e2762500b3be88be184...1452d46240609ff39dacf9ea2f759ed600c2f09f,4,118,16,134,11,2008-06-05 00:39:32,2008-06-05 00:39:32
1452d46240609ff39dacf9ea2f759ed600c2f09f...ed1c21171c78c719d4218c222d5c68bf1dbcccec,4,20,15,35,4,2008-06-06 11:47:47,2008-06-06 11:47:47
ed1c21171c78c719d4218c222d5c68bf1dbcccec...d234e92740ed6c144f222f15afe33c49fb49d7b7,1,7,2,9,2,2008-06-06 12:55:38,2008-06-06 12:55:38
d234e92740ed6c144f222f15afe33c49fb49d7b7...46cd8bb5b6c937969ca281f124307013454f5c15,2,8,1,9,4,2008-06-06 13:39:42,2008-06-06 13:39:42
46cd8bb5b6c937969ca281f124307013454f5c15...08401959d86a48413f05b55c2af4b37fb7bf3279,4,29,6,35,7,2008-06-06 13:50:02,2008-06-06 13:50:02
08401959d86a48413f05b55c2af4b37fb7bf3279...cf8abd1bf2b33188a14961da3a63e8853d53261a,1,1,1,2,1,2008-06-06 13:51:09,2008-06-06 13:51:09
cf8abd1bf2b33188a14961da3a63e8853d53261a...0433ffa6f62522bb841d3a8a3ffdb9b041cafb66,1,4,4,8,4,2008-06-06 13:58:42,2008-06-06 13:58:42
0433ffa6f62522bb841d3a8a3ffdb9b041cafb66...0586239660892f4a9fc4301a9c913241c457c876,1,13,9,22,8,2008-06-06 14:09:20,2008-06-06 14:09:20
0586239660892f4a9fc4301a9c913241c457c876...5b9d907ae877ed539208c25d9adf610b16fa15ee,1,3,0,3,2,2008-06-06 15:27:21,2008-06-06 15:27:21
5b9d907ae877ed539208c25d9adf610b16fa15ee...8a7bbc3c3426beacdb4286960fb1a731a7d88d25,7,95,3,98,11,2008-06-07 06:25:59,2008-06-07 06:25:59
8a7bbc3c3426beacdb4286960fb1a731a7d88d25...50de13343b9daa9da30b9111dab2e15d8f24465d,1,6,2,8,1,2008-06-07 20:01:18,2008-06-07 20:01:18
50de13343b9daa9da30b9111dab2e15d8f24465d...8d4f79a799136edf8190c357e3e0497d7db3ad77,8,221,12,233,24,2008-06-07 20:28:06,2008-06-07 20:28:06
8d4f79a799136edf8190c357e3e0497d7db3ad77...5675ae4443ae07325c97c70e4f951e1d6b06c2d3,7,172,99,271,11,2008-06-08 05:31:16,2008-06-08 05:31:16
5675ae4443ae07325c97c70e4f951e1d6b06c2d3...102394b79db9fcbd6dec32a795e0d9d0a90afd11,1,1,1,2,1,2008-06-08 05:38:13,2008-06-08 05:38:13
102394b79db9fcbd6dec32a795e0d9d0a90afd11...8df7ac93a10335d1a1e7a123585c6f0950ef66a5,1,82,4,86,5,2008-06-08 05:53:22,2008-06-08 05:53:22
8df7ac93a10335d1a1e7a123585c6f0950ef66a5...87c2423d34c631690078efff318f572b0a0e0c1c,1,21,0,21,1,2008-06-08 07:23:05,2008-06-08 07:23:05
87c2423d34c631690078efff318f572b0a0e0c1c...8198bfeceee39975e2cc6cfa884c59656f07a20e,1,20,21,41,2,2008-06-08 07:24:00,2008-06-08 07:24:00
8198bfeceee39975e2cc6cfa884c59656f07a20e...511e01d9787e4936788644a5f9aeb0c84eaa6ea4,5,60,7,67,13,2008-06-08 08:21:18,2008-06-08 08:21:18
511e01d9787e4936788644a5f9aeb0c84eaa6ea4...8398ea660373e00c8119c6a5a310c04ea7f0e680,1,1,1,2,1,2008-06-08 08:45:14,2008-06-08 08:45:14
8398ea660373e00c8119c6a5a310c04ea7f0e680...31d9dc07aa6d8c424bc84821d529cf3356e04a71,3,67,4,71,7,2008-06-08 18:13:46,2008-06-08 18:13:46
31d9dc07aa6d8c424bc84821d529cf3356e04a71...b0ebcfe15af4626f5ec54336800692130adae0c3,3,4,2,6,3,2008-06-08 18:18:01,2008-06-08 18:18:01
b0ebcfe15af4626f5ec54336800692130adae0c3...1426c2451756572fccaf264ed2b752553b1c7933,1,5,0,5,1,2008-06-08 18:38:36,2008-06-08 18:38:36
1426c2451756572fccaf264ed2b752553b1c7933...12716794dbcf2e1bf7a07bd18dfc0ae24be4e6f8,9,233,14,247,22,2008-06-09 14:03:35,2008-06-09 14:03:35
12716794dbcf2e1bf7a07bd18dfc0ae24be4e6f8...b5f92938abd64f5577eea9f80925d71bc7968c09,2,11,0,11,3,2008-06-09 16:17:54,2008-06-09 16:17:54
b5f92938abd64f5577eea9f80925d71bc7968c09...88a6fa5a073f2f11423aa6de7d644a1d427330ae,1,19,14,33,12,2008-06-10 02:52:16,2008-06-10 02:52:16
88a6fa5a073f2f11423aa6de7d644a1d427330ae...5e202f5acf36f33e1b530514ff205536fe1fd62f,1,16,16,32,2,2008-06-11 04:34:03,2008-06-11 04:34:03
5e202f5acf36f33e1b530514ff205536fe1fd62f...9c50495464db24eaad30984519ab9e31b5ffb044,2,25,4,29,4,2008-06-11 14:01:35,2008-06-11 14:01:35
9c50495464db24eaad30984519ab9e31b5ffb044...daab1f06810318cae41d20e7f1ce4aaaeb0349a9,5,50,48,98,24,2008-06-12 03:36:48,2008-06-12 03:36:48
daab1f06810318cae41d20e7f1ce4aaaeb0349a9...a08b2dd328f99c8a309bff535dab7372260144aa,2,6,5,11,3,2008-06-12 03:37:13,2008-06-12 03:37:13
a08b2dd328f99c8a309bff535dab7372260144aa...0fd41d63e2ace4f873c3d2830cc51c37b3c043de,1,12,12,24,4,2008-06-12 03:56:41,2008-06-12 03:56:41
0fd41d63e2ace4f873c3d2830cc51c37b3c043de...5309e18cbfc85823d1c58e389fd122fff6e17eea,2,9,1,10,2,2008-06-12 04:13:16,2008-06-12 04:13:16
5309e18cbfc85823d1c58e389fd122fff6e17eea...acf888b4bafff0d6f92ef16d9ac4f904c3286e32,1,10,1,11,1,2008-06-12 04:22:02,2008-06-12 04:22:02
acf888b4bafff0d6f92ef16d9ac4f904c3286e32...ac5b9f585735d49ac61e80cca7d977325c799beb,1,2,2,4,1,2008-06-12 04:23:14,2008-06-12 04:23:14
ac5b9f585735d49ac61e80cca7d977325c799beb...b9113ca81f553489001882ba95daa415d3652e81,2,17,0,17,2,2008-06-12 13:19:37,2008-06-12 13:19:37
b9113ca81f553489001882ba95daa415d3652e81...1c47b21f52e6797b4da3de079d4d15fcb967f747,1,4,4,8,1,2008-06-13 00:08:50,2008-06-13 00:08:50
1c47b21f52e6797b4da3de079d4d15fcb967f747...363e46b22cf4d81820df0e6deb4329231cb33add,1,83,21,104,13,2008-06-14 13:44:49,2008-06-14 13:44:49
363e46b22cf4d81820df0e6deb4329231cb33add...42668dcc7993b1fcd2b2ad66fd1d28174e63e8cc,1,31,6,37,2,2008-06-14 14:19:28,2008-06-14 14:19:28
42668dcc7993b1fcd2b2ad66fd1d28174e63e8cc...d1b5902dacdf1f2ebb1bf094bb1775a031070fd7,2,173,186,359,164,2008-06-14 21:38:24,2008-06-14 21:38:24
d1b5902dacdf1f2ebb1bf094bb1775a031070fd7...0b8fafc7f13601235d4bc9bf735ac8dafcc0b04a,1,2,3,5,4,2008-06-15 04:49:29,2008-06-15 04:49:29
0b8fafc7f13601235d4bc9bf735ac8dafcc0b04a...57311b5998900da5a320b9fde7605c834bc0db15,2,9,1,10,2,2008-06-15 06:24:41,2008-06-15 06:24:41
57311b5998900da5a320b9fde7605c834bc0db15...06315375ce5c6477b7498026177b7e715372a7d1,5,30,16,46,20,2008-06-16 03:15:04,2008-06-16 03:15:04
06315375ce5c6477b7498026177b7e715372a7d1...9e8a5969e78b6719fedd74683c3083247593519d,1,1,7,8,1,2008-06-16 03:22:44,2008-06-16 03:22:44
9e8a5969e78b6719fedd74683c3083247593519d...fa1cc23df339729af8c66bc42ee0ce717630f77e,1,0,1,1,1,2008-06-16 03:26:15,2008-06-16 03:26:15
fa1cc23df339729af8c66bc42ee0ce717630f77e...95fae791206b20a807d94a55b7bd154b0721e401,1,1,1,2,1,2008-06-16 03:32:02,2008-06-16 03:32:02
95fae791206b20a807d94a55b7bd154b0721e401...167409e24ee946aa2b06b88d3dfbe2327989831c,1,4,3,7,3,2008-06-16 03:35:50,2008-06-16 03:35:50
167409e24ee946aa2b06b88d3dfbe2327989831c...1b92483ae5e4ebd93ba8616fb1b7cb55fc63868b,1,4,8,12,2,2008-06-16 03:37:57,2008-06-16 03:37:57
1b92483ae5e4ebd93ba8616fb1b7cb55fc63868b...fbeec87b62b7286fd31bde5e7756c1ba9b918109,1,1,1,2,1,2008-06-16 03:38:43,2008-06-16 03:38:43
fbeec87b62b7286fd31bde5e7756c1ba9b918109...16482911fde4e99777b0e439def6294234b78ef6,1,1,2,3,1,2008-06-16 03:41:03,2008-06-16 03:41:03
16482911fde4e99777b0e439def6294234b78ef6...cc64abfc1d655cb662205e3085978d9f6edbd5a3,2,3,1,4,2,2008-06-16 03:47:38,2008-06-16 03:47:38
cc64abfc1d655cb662205e3085978d9f6edbd5a3...a0a06d1a89465e7800686eec905e4c6f16911684,2,16,9,25,7,2008-06-16 03:56:48,2008-06-16 03:56:48
a0a06d1a89465e7800686eec905e4c6f16911684...ee882b6abd83089f24f7329b97f5c551b6a2f2cb,1,5,2,7,2,2008-06-16 04:00:08,2008-06-16 04:00:08
ee882b6abd83089f24f7329b97f5c551b6a2f2cb...d339b2b65e07bd9161f040065e685f8ab8952cd2,1,2,2,4,2,2008-06-16 04:01:33,2008-06-16 04:01:33
d339b2b65e07bd9161f040065e685f8ab8952cd2...96b1d0f966df66d1ed2eb750ff2e9b466061fb09,1,2,2,4,1,2008-06-16 04:03:25,2008-06-16 04:03:25
96b1d0f966df66d1ed2eb750ff2e9b466061fb09...3859314d4ac781cbe712d9bc7152c02a9396f9a2,1,1,1,2,1,2008-06-16 04:04:24,2008-06-16 04:04:24
3859314d4ac781cbe712d9bc7152c02a9396f9a2...260d3be69f992cdff40cb68d9673e2ff15600864,1,1,1,2,1,2008-06-16 04:06:50,2008-06-16 04:06:50
260d3be69f992cdff40cb68d9673e2ff15600864...4094d03e290c25c52024302f8e470055170064f0,1,2,0,2,1,2008-06-16 04:09:44,2008-06-16 04:09:44
4094d03e290c25c52024302f8e470055170064f0...02bbd9a9b28de27748e0663e63a68ac66024bd73,2,2,2,4,2,2008-06-16 04:13:04,2008-06-16 04:13:04
02bbd9a9b28de27748e0663e63a68ac66024bd73...e073861332addfa7fd5577083dfaa6ab1c64ae6b,2,2,1,3,2,2008-06-16 04:16:21,2008-06-16 04:16:21
e073861332addfa7fd5577083dfaa6ab1c64ae6b...dd8adb304af0171233dc5d25336e2e0d1910602b,2,54,55,109,49,2008-06-16 08:05:42,2008-06-16 08:05:42
dd8adb304af0171233dc5d25336e2e0d1910602b...6564daa597ff7b327edc0c594ef35723924ef842,1,1,1,2,1,2008-06-16 12:38:58,2008-06-16 12:38:58
6564daa597ff7b327edc0c594ef35723924ef842...2606230616ba359650b7113701c1a301c2098fdf,1,0,0,0,0,2008-06-16 17:47:58,2008-06-16 17:47:58
2606230616ba359650b7113701c1a301c2098fdf...813c8fdb6da04295e2001f0fbfb5c144bf732182,4,4455,0,4455,2,2008-06-16 17:59:59,2008-06-16 17:59:59
813c8fdb6da04295e2001f0fbfb5c144bf732182...2cd9aadacfe0ff18901eda243c74daba4a8d227d,4,15,15,30,14,2008-06-17 09:37:25,2008-06-17 09:37:25
2cd9aadacfe0ff18901eda243c74daba4a8d227d...8a861942cd696fb9fd83a6c91537b142893c20a9,2,933,500,1433,447,2008-06-17 10:54:48,2008-06-17 10:54:48
8a861942cd696fb9fd83a6c91537b142893c20a9...e4fc3278905238cfd18e6cf0737bd1d3f131f120,1,1,1,2,1,2008-06-17 11:19:08,2008-06-17 11:19:08
e4fc3278905238cfd18e6cf0737bd1d3f131f120...b3653db4f0dd7eb3d786853e940178bc6d04114f,1,2,4,6,2,2008-06-17 11:22:03,2008-06-17 11:22:03
b3653db4f0dd7eb3d786853e940178bc6d04114f...c6f277f9726ecd5e1dc8b3e19aececa44cad853f,1,4,1,5,1,2008-06-17 13:37:31,2008-06-17 13:37:31
c6f277f9726ecd5e1dc8b3e19aececa44cad853f...cd0f7b9a399a8d23759232d0d2250eb2d4cefadf,1,14,0,14,1,2008-06-17 13:47:17,2008-06-17 13:47:17
cd0f7b9a399a8d23759232d0d2250eb2d4cefadf...6d242ccc63da5e0b687b2d391a264f10b4dbb17a,1,30,0,30,1,2008-06-17 13:56:10,2008-06-17 13:56:10
6d242ccc63da5e0b687b2d391a264f10b4dbb17a...e829e9ff8f41ee94ca12c1cbbc0c7aaf45706aec,1,1,1,2,1,2008-06-17 13:58:19,2008-06-17 13:58:19
e829e9ff8f41ee94ca12c1cbbc0c7aaf45706aec...04df7022634cb9729cb0e9e86f6da244f24dd0b5,2,3,3,6,2,2008-06-17 14:53:24,2008-06-17 14:53:24
04df7022634cb9729cb0e9e86f6da244f24dd0b5...f410de010d344b0d2101307cfd0e6d85330f9db6,1,3,3,6,2,2008-06-17 15:46:59,2008-06-17 15:46:59
f410de010d344b0d2101307cfd0e6d85330f9db6...f0c750d0182b147409c675bae31e007373eb551f,2,623,614,1237,611,2008-06-17 21:43:53,2008-06-17 21:43:53
f0c750d0182b147409c675bae31e007373eb551f...0694c75e2da6f8b96020e85147d0c3b49b702e6a,2,0,0,0,0,2008-06-18 09:12:39,2008-06-18 09:12:39
0694c75e2da6f8b96020e85147d0c3b49b702e6a...dc7f21daf73d2aae66c3bb8a043a59cbace6e602,2,79,0,79,2,2008-06-18 12:07:46,2008-06-18 12:07:46
dc7f21daf73d2aae66c3bb8a043a59cbace6e602...4317ba5799e2deae6059bebcb3d86e24d62e8e02,2,16,6,22,3,2008-06-18 12:59:39,2008-06-18 12:59:39
4317ba5799e2deae6059bebcb3d86e24d62e8e02...e146e508da283db93cea9fb3d91b78db9e47976f,21,55,55,110,48,2008-06-18 13:10:05,2008-06-18 13:10:05
e146e508da283db93cea9fb3d91b78db9e47976f...f9b9052c551cf2fbd2524de760492330f83e4388,1,8,2,10,4,2008-06-18 13:17:23,2008-06-18 13:17:23
f9b9052c551cf2fbd2524de760492330f83e4388...c5f7caba72063e0f9496b3a8de00c27fe061516a,1,0,0,0,0,2008-06-18 13:27:20,2008-06-18 13:27:20
c5f7caba72063e0f9496b3a8de00c27fe061516a...2b62e945b09ef56e5a28389ad049deec1c347cec,2,4,2,6,3,2008-06-18 16:13:14,2008-06-18 16:13:14
2b62e945b09ef56e5a28389ad049deec1c347cec...1a75b5a03caf5924b40801b34d7f3f6011ecac29,5,33,24,57,13,2008-06-18 16:33:04,2008-06-18 16:33:04
1a75b5a03caf5924b40801b34d7f3f6011ecac29...12f8d59193dc80024478d8045d12e1d2ace9e4a8,4,2984,0,2984,2,2008-06-18 20:38:35,2008-06-18 20:38:35
12f8d59193dc80024478d8045d12e1d2ace9e4a8...7e0664bfd8a44daae871bb3b000fd6cef430be52,2,48,48,96,48,2008-06-18 20:47:07,2008-06-18 20:47:07
7e0664bfd8a44daae871bb3b000fd6cef430be52...8cb4895c68a6920369323f082fc1a0658967c385,1,1,0,1,1,2008-06-18 20:51:22,2008-06-18 20:51:22
8cb4895c68a6920369323f082fc1a0658967c385...7ecd4867a5b72e6566046161079401a34705d97d,1,1,0,1,1,2008-06-18 20:53:55,2008-06-18 20:53:55
7ecd4867a5b72e6566046161079401a34705d97d...d943c19428624a14f9d1b5103d8a4541ede2a8af,2,33,33,66,33,2008-06-19 07:53:24,2008-06-19 07:53:24
d943c19428624a14f9d1b5103d8a4541ede2a8af...5da67a084ad6a814c867c3c374f7e869dffac29e,2,22,1,23,2,2008-06-19 12:05:39,2008-06-19 12:05:39
5da67a084ad6a814c867c3c374f7e869dffac29e...a7f6faaa818d91aa9baaf1db99974cb1209c8ee6,1,7,2,9,1,2008-06-19 12:13:43,2008-06-19 12:13:43
a7f6faaa818d91aa9baaf1db99974cb1209c8ee6...090aeee39979c279564c4673a1af2a6b15ce001e,2,19,2,21,5,2008-06-19 13:24:39,2008-06-19 13:24:39
090aeee39979c279564c4673a1af2a6b15ce001e...e726065d5d19bab23078c416513bc8cf9f40d20b,1,4,0,4,2,2008-06-19 13:32:39,2008-06-19 13:32:39
e726065d5d19bab23078c416513bc8cf9f40d20b...5d09d8769d7eb7fd8dffdf5c0705e25173c59006,8,8,8,16,8,2008-06-19 14:38:56,2008-06-19 14:38:56
5d09d8769d7eb7fd8dffdf5c0705e25173c59006...e637f4723225d630e6066a04558a3549c83f8a5a,1,12,5,17,2,2008-06-19 21:15:33,2008-06-19 21:15:33
e637f4723225d630e6066a04558a3549c83f8a5a...6123f8455c045a21f8e6523b0cd2d0bda94d92f6,2,162,154,316,106,2008-06-20 11:04:29,2008-06-20 11:04:29
6123f8455c045a21f8e6523b0cd2d0bda94d92f6...9cf3048b0801aeefd5b5a78ad407b234265d1ffa,1,2,2,4,1,2008-06-20 12:10:13,2008-06-20 12:10:13
9cf3048b0801aeefd5b5a78ad407b234265d1ffa...ddcf51a0ba21ac967406239cd0434dae490964ab,1,17,7,24,2,2008-06-20 15:34:51,2008-06-20 15:34:51
ddcf51a0ba21ac967406239cd0434dae490964ab...5efb9652d74a08bfdbb788cfa31f01da0cdee04c,1,2,1,3,1,2008-06-20 17:18:58,2008-06-20 17:18:58
5efb9652d74a08bfdbb788cfa31f01da0cdee04c...fad8e8f7c2f1bfd563119404092b01cb402b1982,4,90,2,92,5,2008-06-20 17:43:12,2008-06-20 17:43:12
fad8e8f7c2f1bfd563119404092b01cb402b1982...d9c3e0a36af2c127b6f9193c842f588532d75d21,1,1,1,2,1,2008-06-21 04:43:05,2008-06-21 04:43:05
d9c3e0a36af2c127b6f9193c842f588532d75d21...5e4e04befbdfe67cd703d4d5023576aeeb2fb603,1,20,0,20,1,2008-06-21 05:20:42,2008-06-21 05:20:42
5e4e04befbdfe67cd703d4d5023576aeeb2fb603...5fc7dd7d28813b30e78c7a1e9f2606159e6e0760,1,1,1,2,1,2008-06-21 05:26:12,2008-06-21 05:26:12
5fc7dd7d28813b30e78c7a1e9f2606159e6e0760...17bc2820bbc95e01d8365a8fc6fcb497852e5f23,1,1,1,2,1,2008-06-21 16:37:44,2008-06-21 16:37:44
17bc2820bbc95e01d8365a8fc6fcb497852e5f23...7c621535a2b7a7cc58ed3658ab1f5a74d03abca3,3,110,5,115,8,2008-06-21 20:55:17,2008-06-21 20:55:17
7c621535a2b7a7cc58ed3658ab1f5a74d03abca3...b1851cca3ee1494cc020f1676e2029ef138250da,3,207,35,242,25,2008-06-21 20:57:05,2008-06-21 20:57:05
b1851cca3ee1494cc020f1676e2029ef138250da...b83fcacfcc42f4288712d3ffe59c87b847936f61,1,1,0,1,1,2008-06-22 06:34:17,2008-06-22 06:34:17
b83fcacfcc42f4288712d3ffe59c87b847936f61...1fc0077a95aff89fde16a8496884d2ca2c4de7c9,2,22,0,22,2,2008-06-22 06:50:25,2008-06-22 06:50:25
1fc0077a95aff89fde16a8496884d2ca2c4de7c9...5db4d602152c14bb4b25011d9a881f7fa1639152,6,30,17,47,19,2008-06-23 05:08:07,2008-06-23 05:08:07
5db4d602152c14bb4b25011d9a881f7fa1639152...c8d39f15cbbd22cdfbeb877024df2b5afd5334d3,4,2,90,92,5,2008-06-23 12:17:57,2008-06-23 12:17:57
c8d39f15cbbd22cdfbeb877024df2b5afd5334d3...3ce81068b842c3bcc98146de081fc52527cf9ad3,1,1,1,2,1,2008-06-23 12:42:09,2008-06-23 12:42:09
3ce81068b842c3bcc98146de081fc52527cf9ad3...dce557b9e7ad41dce171167b3679c5c67fdbcde3,1,7,0,7,1,2008-06-23 12:57:11,2008-06-23 12:57:11
dce557b9e7ad41dce171167b3679c5c67fdbcde3...89624bf67f009a2ed9a72fec051953766f4632d2,4,450,713,1163,371,2008-06-23 19:48:16,2008-06-23 19:48:16
89624bf67f009a2ed9a72fec051953766f4632d2...af46df583f108ec6d216af53a10cd64ff104d0ed,1,117,109,226,105,2008-06-24 05:46:44,2008-06-24 05:46:44
af46df583f108ec6d216af53a10cd64ff104d0ed...922f62c29e94da72771676114bb63cac42a75951,1,0,0,0,0,2008-06-24 05:47:51,2008-06-24 05:47:51
922f62c29e94da72771676114bb63cac42a75951...87a704cf50d4ac122b89a02f5a68f11ad5026524,1,2,2,4,1,2008-06-25 12:09:18,2008-06-25 12:09:18
87a704cf50d4ac122b89a02f5a68f11ad5026524...b8f7b39ccc414e56a99111005146b5f2d7f1d5b0,2,7,2,9,4,2008-06-25 13:38:06,2008-06-25 13:38:06
b8f7b39ccc414e56a99111005146b5f2d7f1d5b0...183442864837386df1f24d9cd0b39a3671ef3b04,2,15,2,17,7,2008-06-26 01:01:21,2008-06-26 01:01:21
183442864837386df1f24d9cd0b39a3671ef3b04...588eeb356c7a88138fac53c3caeb705e16aa562c,2,57,13,70,7,2008-06-26 01:02:11,2008-06-26 01:02:11
588eeb356c7a88138fac53c3caeb705e16aa562c...002dbd16b4453fc9c89533002ab17189a8122e70,1,9,9,18,7,2008-06-26 02:20:45,2008-06-26 02:20:45
002dbd16b4453fc9c89533002ab17189a8122e70...915001ad0bd61600781d58ead798c8cae6e5cd25,4,45,8,53,11,2008-06-26 03:11:32,2008-06-26 03:11:32
915001ad0bd61600781d58ead798c8cae6e5cd25...5dabaf30b6219d5f0365fe159d15c540b34055a3,1,8,0,8,1,2008-06-26 03:16:55,2008-06-26 03:16:55
5dabaf30b6219d5f0365fe159d15c540b34055a3...31ee551057598ec1c23610756750ad3b1fff94fe,3,45,46,91,27,2008-06-26 03:59:15,2008-06-26 03:59:15
31ee551057598ec1c23610756750ad3b1fff94fe...8089eec6cf9df08dcca97209c05fd79dee5f2af9,1,1,1,2,1,2008-06-26 04:03:44,2008-06-26 04:03:44
8089eec6cf9df08dcca97209c05fd79dee5f2af9...2b926d42226a4c46823c5cda00a115583447ac05,2,0,2,2,2,2008-06-26 04:05:48,2008-06-26 04:05:48
2b926d42226a4c46823c5cda00a115583447ac05...54f7da3a27b12d35373e384ca4b1b27fa3bd1482,1,4,1,5,1,2008-06-26 04:09:29,2008-06-26 04:09:29
54f7da3a27b12d35373e384ca4b1b27fa3bd1482...fbef599f60acb2b5511bf2cbbeb7861b4c7de974,1,7,6,13,4,2008-06-26 04:11:53,2008-06-26 04:11:53
fbef599f60acb2b5511bf2cbbeb7861b4c7de974...345a0967568cf138c8d4b889ced8047f9c716b64,1,13,13,26,11,2008-06-26 04:22:12,2008-06-26 04:22:12
345a0967568cf138c8d4b889ced8047f9c716b64...65437a95e146a90d74686eb4414f1a210cbac0fe,2,13,12,25,3,2008-06-26 04:25:40,2008-06-26 04:25:40
65437a95e146a90d74686eb4414f1a210cbac0fe...dbde7fc8b0932a169b8319dc597433aef1cb9520,2,6,4,10,6,2008-06-26 04:30:06,2008-06-26 04:30:06
dbde7fc8b0932a169b8319dc597433aef1cb9520...5ee4a099f1554a60ecb6a525e33044c38a1206fe,1,1,1,2,1,2008-06-26 04:33:18,2008-06-26 04:33:18
5ee4a099f1554a60ecb6a525e33044c38a1206fe...74f0408fa2e8e41969a381150f6d78d0cdf3f363,3,54,34,88,14,2008-06-26 04:54:10,2008-06-26 04:54:10
74f0408fa2e8e41969a381150f6d78d0cdf3f363...b7fea9409618ac23485a1048f4435f6afbc11739,2,29,29,58,10,2008-06-26 05:07:13,2008-06-26 05:07:13
b7fea9409618ac23485a1048f4435f6afbc11739...9ef491b0281e74ec975c536b06521fcb9e7a0b88,1,6,8,14,6,2008-06-26 05:16:19,2008-06-26 05:16:19
9ef491b0281e74ec975c536b06521fcb9e7a0b88...82d09948aef719d564a4f1535b590c7a006df6f5,1,1,1,2,1,2008-06-26 05:21:29,2008-06-26 05:21:29
82d09948aef719d564a4f1535b590c7a006df6f5...2c08986f44a52e3bbd5cb1fb9fd6b2b5a80941e3,1,4,2,6,1,2008-06-26 05:24:32,2008-06-26 05:24:32
2c08986f44a52e3bbd5cb1fb9fd6b2b5a80941e3...e41df5adccef0e32d4b8b877ec83e9dd271c1ccf,2,24,8,32,3,2008-06-26 05:34:26,2008-06-26 05:34:26
e41df5adccef0e32d4b8b877ec83e9dd271c1ccf...ba015e0a79f6e51a2253fb0b95c9a68acb2d6090,2,11,1,12,3,2008-06-26 06:50:22,2008-06-26 06:50:22
ba015e0a79f6e51a2253fb0b95c9a68acb2d6090...d2ce1df08fcf7b17897e9576028d19bbd2fdfa93,3,49,6,55,6,2008-06-26 07:04:18,2008-06-26 07:04:18
d2ce1df08fcf7b17897e9576028d19bbd2fdfa93...279fc8599b72d56729871f241d6e91dc2d409158,3,24,8,32,8,2008-06-26 07:51:19,2008-06-26 07:51:19
279fc8599b72d56729871f241d6e91dc2d409158...0e692fda9ca57909216e68a998f2752885c23725,2,20,4,24,4,2008-06-26 10:50:25,2008-06-26 10:50:25
0e692fda9ca57909216e68a998f2752885c23725...9e23c3c5d9d796540356906399365c651e07f084,2,20,0,20,4,2008-06-26 11:42:12,2008-06-26 11:42:12
9e23c3c5d9d796540356906399365c651e07f084...36cb438373a264872e588ab615d8c22798ce0410,1,3,1,4,1,2008-06-26 13:25:59,2008-06-26 13:25:59
36cb438373a264872e588ab615d8c22798ce0410...c237ef625ca97b0e4ccbc08febadf41b7c875645,1,1,1,2,1,2008-06-26 17:44:54,2008-06-26 17:44:54
c237ef625ca97b0e4ccbc08febadf41b7c875645...ade4a1246c5e65ed544a990a720cf1c953ec604b,4,40,24,64,20,2008-06-27 03:27:20,2008-06-27 03:27:20
ade4a1246c5e65ed544a990a720cf1c953ec604b...8aec66f144d51bc176ea01431eef23c0c40ed6d1,1,0,1,1,1,2008-06-27 03:48:11,2008-06-27 03:48:11
8aec66f144d51bc176ea01431eef23c0c40ed6d1...40d2b419ab9ed9b221091722eebc78289d76d949,2,2,2,4,2,2008-06-27 21:47:58,2008-06-27 21:47:58
40d2b419ab9ed9b221091722eebc78289d76d949...be6ff148c18f7e60802ea4e1b14bb5a0ee169a95,2,2,2,4,2,2008-06-28 10:55:26,2008-06-28 10:55:26
be6ff148c18f7e60802ea4e1b14bb5a0ee169a95...d800c0b031aea81ee6f3a7c28ef88c05494e4eea,2,20,15,35,8,2008-06-29 02:35:08,2008-06-29 02:35:08
d800c0b031aea81ee6f3a7c28ef88c05494e4eea...bb2182453b49157fb6fba4de6d3c53a09f73d74b,6,217,12,229,35,2008-06-29 02:36:18,2008-06-29 02:36:18
bb2182453b49157fb6fba4de6d3c53a09f73d74b...6d79ecc8b1f6c54c755c4c9cd1e9da11d533db96,1,22,7,29,4,2008-06-29 03:01:46,2008-06-29 03:01:46
6d79ecc8b1f6c54c755c4c9cd1e9da11d533db96...b67164fb59a3f29e8a6d25f63317a26c48436e48,1,33,62,95,7,2008-06-29 03:07:45,2008-06-29 03:07:45
b67164fb59a3f29e8a6d25f63317a26c48436e48...a8fa3fd81fee316144986328f3df1e811015f1d9,3,68,7,75,8,2008-06-29 09:39:32,2008-06-29 09:39:32
a8fa3fd81fee316144986328f3df1e811015f1d9...5326cd293ef39408c325d592afdb87cb432007bd,3,22,6,28,6,2008-06-29 09:40:17,2008-06-29 09:40:17
5326cd293ef39408c325d592afdb87cb432007bd...2c1d6a80b34c3f38f474f1c56631a11957153bd2,1,0,1,1,1,2008-06-29 09:40:48,2008-06-29 09:40:48
2c1d6a80b34c3f38f474f1c56631a11957153bd2...493163963633e9746a1eaf84bc39c574e4432eb2,2,37,0,37,2,2008-06-29 09:41:35,2008-06-29 09:41:35
493163963633e9746a1eaf84bc39c574e4432eb2...c17e3265852722d572614b96b8bda1105ee8352e,2,19,13,32,12,2008-06-29 10:35:35,2008-06-29 10:35:35
c17e3265852722d572614b96b8bda1105ee8352e...050d0a1b75add2240760c4ba09f1fdd6e9a677f0,2,20,0,20,3,2008-06-29 11:15:48,2008-06-29 11:15:48
050d0a1b75add2240760c4ba09f1fdd6e9a677f0...18d89cc1f759bc926a2fa7a613c46d46fe3ca81f,2,4,2,6,2,2008-06-29 11:50:04,2008-06-29 11:50:04
18d89cc1f759bc926a2fa7a613c46d46fe3ca81f...f62e5a1fba0c711706264d6b2ce2f5cd6b2c5073,1,3,1,4,2,2008-06-29 23:47:31,2008-06-29 23:47:31
f62e5a1fba0c711706264d6b2ce2f5cd6b2c5073...b0bc8b9dfd6069e53cd73c1d3411f995a05f0a5a,3,22,5,27,8,2008-06-30 00:38:14,2008-06-30 00:38:14
b0bc8b9dfd6069e53cd73c1d3411f995a05f0a5a...f9df4d1435fd3382fdcc06f75c1c8d62bfe78ec6,8,14,15,29,14,2008-06-30 04:46:59,2008-06-30 04:46:59
f9df4d1435fd3382fdcc06f75c1c8d62bfe78ec6...5da47e43c7cb051991a3248311248cf6ba7ff27d,4,95,4,99,3,2008-06-30 06:24:21,2008-06-30 06:24:21
5da47e43c7cb051991a3248311248cf6ba7ff27d...6d5c868e86297a7591fe6e42e48805abc8607474,1,1,1,2,1,2008-06-30 06:42:50,2008-06-30 06:42:50
6d5c868e86297a7591fe6e42e48805abc8607474...94beaa6ebbad080786a60944086a7bb95451c8ad,1,2,2,4,2,2008-06-30 07:03:58,2008-06-30 07:03:58
94beaa6ebbad080786a60944086a7bb95451c8ad...44ca5f46c9ca1a6eeeaa4f6fd30d0a3ea7a719bf,1,0,9,9,1,2008-06-30 07:10:03,2008-06-30 07:10:03
44ca5f46c9ca1a6eeeaa4f6fd30d0a3ea7a719bf...1a2005dfed5234f33c44de0e89b53d042c714d94,1,1,1,2,1,2008-06-30 07:17:18,2008-06-30 07:17:18
1a2005dfed5234f33c44de0e89b53d042c714d94...a254f125ffa0246549728403a28b01656766965e,2,3336,1738,5074,492,2008-06-30 08:02:46,2008-06-30 08:02:46
a254f125ffa0246549728403a28b01656766965e...52cc11c4e24be0a108d3f778ed546985fc608535,2,19,3,22,3,2008-06-30 10:07:06,2008-06-30 10:07:06
52cc11c4e24be0a108d3f778ed546985fc608535...8e816c8304051eb45e5fae05d8fab0254a6259ec,3,8,2,10,3,2008-06-30 10:25:35,2008-06-30 10:25:35
8e816c8304051eb45e5fae05d8fab0254a6259ec...abcf1cb36d0bf22d5f2efa4dd85183a0341b33f8,2,16,6,22,5,2008-06-30 10:44:56,2008-06-30 10:44:56
abcf1cb36d0bf22d5f2efa4dd85183a0341b33f8...ca5918e8ff3da9b30243fa3b5cc273766ccf3008,3,10,4,14,8,2008-06-30 11:22:41,2008-06-30 11:22:41
ca5918e8ff3da9b30243fa3b5cc273766ccf3008...5f7bb13f272952df2d38afe1706ac7dc2d6ca6a1,1,3,0,3,1,2008-06-30 11:32:50,2008-06-30 11:32:50
5f7bb13f272952df2d38afe1706ac7dc2d6ca6a1...52b6857f93805f37cf69769d9d9d8242001c8ec9,1,4,1,5,1,2008-06-30 11:56:52,2008-06-30 11:56:52
52b6857f93805f37cf69769d9d9d8242001c8ec9...9eaa05912c4cbda40a8a8b1085338552507d1599,3,116,0,116,4,2008-06-30 12:18:29,2008-06-30 12:18:29
9eaa05912c4cbda40a8a8b1085338552507d1599...61898d86276d236388c66a8f629ff6c3cfe04800,1,5,3,8,2,2008-06-30 12:25:03,2008-06-30 12:25:03
61898d86276d236388c66a8f629ff6c3cfe04800...415bd694f9de8252e8d47bdf3df73cc62ca97728,5,81,5,86,11,2008-06-30 12:34:29,2008-06-30 12:34:29
415bd694f9de8252e8d47bdf3df73cc62ca97728...339df5ce446afb1bac8356453a890f89d0220fd6,1,2,2,4,4,2008-06-30 12:52:46,2008-06-30 12:52:46
339df5ce446afb1bac8356453a890f89d0220fd6...4b93eed185c52a422bea3e73fe215db7c2746595,2,7,2,9,3,2008-06-30 13:05:47,2008-06-30 13:05:47
4b93eed185c52a422bea3e73fe215db7c2746595...8cb128e57c08de54e8947a00f0d17fd02bff90df,3,91,2,93,4,2008-06-30 13:11:12,2008-06-30 13:11:12
8cb128e57c08de54e8947a00f0d17fd02bff90df...a75de3f3429654271ab63fddab1a8b13440a00de,1,2,2,4,2,2008-07-01 02:17:24,2008-07-01 02:17:24
a75de3f3429654271ab63fddab1a8b13440a00de...4fd359253d6538c6c418d23153ddb57cb1a48d17,1,1,1,2,1,2008-07-01 10:12:50,2008-07-01 10:12:50
4fd359253d6538c6c418d23153ddb57cb1a48d17...ef76102e899b5dcfbfb2db97ce066f1dee6c0032,2,25,0,25,2,2008-07-01 12:25:59,2008-07-01 12:25:59
ef76102e899b5dcfbfb2db97ce066f1dee6c0032...d725cc9734272f867d41f7236235c28b3931a1b2,38,2291,154,2445,108,2008-07-01 15:10:51,2008-07-01 15:10:51
d725cc9734272f867d41f7236235c28b3931a1b2...b0a38160cae71f42717805350fbcf50d0d5ade21,1,1,1,2,1,2008-07-01 16:37:28,2008-07-01 16:37:28
b0a38160cae71f42717805350fbcf50d0d5ade21...9fc4c0aaa4ee145c917a0ece6e6828596e00cce1,1,15,5,20,2,2008-07-01 18:47:46,2008-07-01 18:47:46
9fc4c0aaa4ee145c917a0ece6e6828596e00cce1...bcb1c6dc7167039e715b3399bcc46cbeb5f2d8d1,1,2,2,4,1,2008-07-01 18:49:01,2008-07-01 18:49:01
bcb1c6dc7167039e715b3399bcc46cbeb5f2d8d1...54d50ef5c890242a8516346ea9ab97092c3fa8c1,2,27,1,28,2,2008-07-02 04:31:28,2008-07-02 04:31:28
54d50ef5c890242a8516346ea9ab97092c3fa8c1...7e210f68a9d2b4f7ebce5fdb2afdb517c18fc5aa,1,37,26,63,24,2008-07-02 04:34:05,2008-07-02 04:34:05
7e210f68a9d2b4f7ebce5fdb2afdb517c18fc5aa...f5c1bb1cad5d06935ed07bbeace64be36643f512,1,10,6,16,1,2008-07-02 04:48:58,2008-07-02 04:48:58
f5c1bb1cad5d06935ed07bbeace64be36643f512...73dfef8771b77ba867d667b2271bb9ee4bec8349,1,15,8,23,6,2008-07-02 05:00:09,2008-07-02 05:00:09
73dfef8771b77ba867d667b2271bb9ee4bec8349...56e1cdc8bc7e5dfeb17178635df2de1e42f790ff,1,4,1,5,1,2008-07-02 05:05:50,2008-07-02 05:05:50
56e1cdc8bc7e5dfeb17178635df2de1e42f790ff...f7903f747912b01c723d02022371979665f25cf3,1,5,5,10,3,2008-07-02 16:59:17,2008-07-02 16:59:17
f7903f747912b01c723d02022371979665f25cf3...45404bea1833b2626c72d383020ab9cd067af321,1,3,3,6,3,2008-07-02 20:34:29,2008-07-02 20:34:29
45404bea1833b2626c72d383020ab9cd067af321...aa63190d0b2c85b45bc042b80d2c7a41a4bbcbdd,2,6,1,7,2,2008-07-02 21:39:05,2008-07-02 21:39:05
aa63190d0b2c85b45bc042b80d2c7a41a4bbcbdd...1bfe99440958535a5e6563267c5bcafe68cfe424,1,1,1,2,1,2008-07-03 06:04:17,2008-07-03 06:04:17
1bfe99440958535a5e6563267c5bcafe68cfe424...ee837ad46adab138cc46a764e632028f41059298,1,6,4,10,6,2008-07-03 18:42:47,2008-07-03 18:42:47
ee837ad46adab138cc46a764e632028f41059298...0650bab4928521dea79613fb5ff1144ad0141acb,1,1,1,2,1,2008-07-03 19:02:43,2008-07-03 19:02:43
0650bab4928521dea79613fb5ff1144ad0141acb...3b6487130ae2b8f3bbd4c18a44403ccdedd24f05,1,6,5,11,4,2008-07-03 19:21:54,2008-07-03 19:21:54
3b6487130ae2b8f3bbd4c18a44403ccdedd24f05...6dd2b5468fa275d53aa60fdcaff8c28bdc5e9c25,4,84,51,135,28,2008-07-04 06:42:58,2008-07-04 06:42:58
6dd2b5468fa275d53aa60fdcaff8c28bdc5e9c25...58a68723b3389ec0d92f9372e213e6fc5d868708,1,2,2,4,2,2008-07-05 02:14:34,2008-07-05 02:14:34
58a68723b3389ec0d92f9372e213e6fc5d868708...31b61d57d593f6b10fcf055b529e086a72f647ff,1,2,2,4,2,2008-07-05 02:34:37,2008-07-05 02:34:37
31b61d57d593f6b10fcf055b529e086a72f647ff...c71686489b70223dddeba760785217ef63804b44,1,3,2,5,2,2008-07-06 04:08:13,2008-07-06 04:08:13
c71686489b70223dddeba760785217ef63804b44...bff075973a84387f2f25c223a7d9fa8ce09d104a,1,3,6,9,2,2008-07-06 05:25:55,2008-07-06 05:25:55
bff075973a84387f2f25c223a7d9fa8ce09d104a...3cfa3cbd0747c36095541177da71214289ae6aa3,16,418,381,799,42,2008-07-06 06:39:44,2008-07-06 06:39:44
3cfa3cbd0747c36095541177da71214289ae6aa3...e2740dd400e202d9e1f60413b8abac27f7d57933,1,10,4,14,3,2008-07-06 11:00:58,2008-07-06 11:00:58
e2740dd400e202d9e1f60413b8abac27f7d57933...0d0cbfd56ee468a50910d2e0686a0f28029992ba,3,8,10,18,5,2008-07-06 11:55:30,2008-07-06 11:55:30
0d0cbfd56ee468a50910d2e0686a0f28029992ba...075098f9fd06c42faaba01ec8f855f4d4e99dae6,1,6,5,11,4,2008-07-06 12:29:40,2008-07-06 12:29:40
075098f9fd06c42faaba01ec8f855f4d4e99dae6...25f2cfb7cbce2ea1e7547a55b01d16896039c44b,2,14,4,18,4,2008-07-06 12:55:24,2008-07-06 12:55:24
25f2cfb7cbce2ea1e7547a55b01d16896039c44b...c88e55b4fed5c0e82dc5c4505963e5bae48eb493,1,33,6,39,8,2008-07-06 14:16:43,2008-07-06 14:16:43
c88e55b4fed5c0e82dc5c4505963e5bae48eb493...c2f753a8bae369e39234ea50b23c228fee3de70c,1,123,0,123,1,2008-07-06 14:17:07,2008-07-06 14:17:07
c2f753a8bae369e39234ea50b23c228fee3de70c...5deb4fcbb9be89f0a1fb8056c379bb4339aa5f43,2,6,156,162,9,2008-07-06 14:20:30,2008-07-06 14:20:30
5deb4fcbb9be89f0a1fb8056c379bb4339aa5f43...6048389391f61aedf00b168d2d3ccf7a0d55d039,4,0,29,29,4,2008-07-06 14:26:37,2008-07-06 14:26:37
6048389391f61aedf00b168d2d3ccf7a0d55d039...8975bba742151a6a3164d5c7df7d793f12a7c5c1,2,57,2,59,2,2008-07-07 01:45:19,2008-07-07 01:45:19
8975bba742151a6a3164d5c7df7d793f12a7c5c1...72544950e198c08ac49ba9d878ea7440313b13a7,2,10,0,10,2,2008-07-07 01:57:05,2008-07-07 01:57:05
72544950e198c08ac49ba9d878ea7440313b13a7...9dabd1f8ff7760f28bd1dcfa8b83ae6b1c0b79aa,5,72,24,96,10,2008-07-07 22:06:32,2008-07-07 22:06:32
9dabd1f8ff7760f28bd1dcfa8b83ae6b1c0b79aa...a28b75b0ba9650ae3bd46e38d12d95d48f5c5664,12,165,153,318,78,2008-07-07 23:16:00,2008-07-07 23:16:00
a28b75b0ba9650ae3bd46e38d12d95d48f5c5664...c83e9abb34bca78e9d6d451614d00f816674e5a8,1,1,0,1,1,2008-07-07 23:36:35,2008-07-07 23:36:35
c83e9abb34bca78e9d6d451614d00f816674e5a8...f804e7f03810f5495445a2960d1ea7c6d0635328,1,9,1,10,2,2008-07-07 23:36:45,2008-07-07 23:36:45
f804e7f03810f5495445a2960d1ea7c6d0635328...33666ef829615b98937b739ecca8adf413d1418c,1,1,1,2,1,2008-07-07 23:36:53,2008-07-07 23:36:53
33666ef829615b98937b739ecca8adf413d1418c...b0d380376c110d13c27b8dd3320175b050eed74f,1,2,2,4,2,2008-07-08 01:49:50,2008-07-08 01:49:50
b0d380376c110d13c27b8dd3320175b050eed74f...f19284b85aed37fd4008c56f1aa7a36517305e54,1,2,0,2,2,2008-07-08 01:56:01,2008-07-08 01:56:01
f19284b85aed37fd4008c56f1aa7a36517305e54...4406d283e13819b04556df21044089b7d119edb0,4,13,19,32,6,2008-07-08 02:08:33,2008-07-08 02:08:33
4406d283e13819b04556df21044089b7d119edb0...cb70c9953795484451fe26094578285d4b39d5e5,1,4,5,9,3,2008-07-08 02:11:09,2008-07-08 02:11:09
cb70c9953795484451fe26094578285d4b39d5e5...a724fff300671ffa78f08158d7e11281cd0a4fd1,2,26,5,31,7,2008-07-08 02:20:48,2008-07-08 02:20:48
a724fff300671ffa78f08158d7e11281cd0a4fd1...a616b9217408d57650fbb5a3d9e211d9a7f8ac6d,1,8,8,16,8,2008-07-08 05:28:37,2008-07-08 05:28:37
a616b9217408d57650fbb5a3d9e211d9a7f8ac6d...409ed9468fad37a43e453fa1b93ba9e3893a1371,2,2,2,4,2,2008-07-08 05:29:23,2008-07-08 05:29:23
409ed9468fad37a43e453fa1b93ba9e3893a1371...96a47da015407bb7c57d0d10aef6574309769cc4,2,104,84,188,76,2008-07-08 21:53:38,2008-07-08 21:53:38
96a47da015407bb7c57d0d10aef6574309769cc4...9376d4ed5bd175eff87788ccf11e761fdef42b8b,9,862,0,862,6,2008-07-10 12:12:41,2008-07-10 12:12:41
9376d4ed5bd175eff87788ccf11e761fdef42b8b...e18fccc62e6463c9247892bce7fd5ce125b526ac,1,4,0,4,2,2008-07-10 13:53:45,2008-07-10 13:53:45
e18fccc62e6463c9247892bce7fd5ce125b526ac...1e00458521b81bc86883ce938ea689b799bfd928,1,1,1,2,1,2008-07-11 07:34:11,2008-07-11 07:34:11
1e00458521b81bc86883ce938ea689b799bfd928...7936c0b9173d5bde02bfb2dd8722733d4c821daf,2,9,4,13,5,2008-07-11 09:00:35,2008-07-11 09:00:35
7936c0b9173d5bde02bfb2dd8722733d4c821daf...88c17b582194d34e0a96864b7e3153f6de2dd0e1,1,12,0,12,1,2008-07-11 10:03:04,2008-07-11 10:03:04
88c17b582194d34e0a96864b7e3153f6de2dd0e1...2b193f6100c571d4b5bc87815c7569179db27030,2,9,5,14,5,2008-07-11 12:43:27,2008-07-11 12:43:27
2b193f6100c571d4b5bc87815c7569179db27030...c742afb3b2e1ff2cd3febbaefec17036b170ab89,1,0,1,1,1,2008-07-11 12:44:04,2008-07-11 12:44:04
c742afb3b2e1ff2cd3febbaefec17036b170ab89...4516233f9ef3048735f85703f8dc515160e79de4,1,39,39,78,38,2008-07-11 13:04:17,2008-07-11 13:04:17
4516233f9ef3048735f85703f8dc515160e79de4...8e0b6bdcd5b8f9f63a5f370970c71164d25946a7,3,128,4,132,9,2008-07-11 13:18:19,2008-07-11 13:18:19
8e0b6bdcd5b8f9f63a5f370970c71164d25946a7...bbb384366f6ab86411756ce7b459a2f15d825e08,1,5,2,7,2,2008-07-11 14:06:59,2008-07-11 14:06:59
bbb384366f6ab86411756ce7b459a2f15d825e08...e31945a2ada75096883cea3f577dae509fd5c05d,1,2,2,4,2,2008-07-11 14:29:47,2008-07-11 14:29:47
e31945a2ada75096883cea3f577dae509fd5c05d...b038abe1fe0c5abc2f503eb8e464087349766c1c,1,4,3,7,2,2008-07-11 15:08:09,2008-07-11 15:08:09
b038abe1fe0c5abc2f503eb8e464087349766c1c...4aa6c5725137dc47e3baf4d9df94352e529fa3f4,4,18,3,21,5,2008-07-12 06:16:42,2008-07-12 06:16:42
4aa6c5725137dc47e3baf4d9df94352e529fa3f4...52d985fac370f22883c5bcf63e405aeadc6d1b6c,1,1,1,2,1,2008-07-12 11:01:57,2008-07-12 11:01:57
52d985fac370f22883c5bcf63e405aeadc6d1b6c...4dbaf2c9523155a010a58b2184c1eb1a058f8bf6,2,129,130,259,126,2008-07-12 18:55:58,2008-07-12 18:55:58
4dbaf2c9523155a010a58b2184c1eb1a058f8bf6...f5bf3d9e9951724cf91d7f027985bcf48fdea965,2,8,0,8,2,2008-07-12 19:00:38,2008-07-12 19:00:38
f5bf3d9e9951724cf91d7f027985bcf48fdea965...8e852a92ecb6432084ffdca333a7de80e5c6014d,1,1,1,2,1,2008-07-12 20:43:03,2008-07-12 20:43:03
8e852a92ecb6432084ffdca333a7de80e5c6014d...c121ff4046263b37862f9aed5a6d7463794abb81,1,24,33,57,5,2008-07-12 20:43:15,2008-07-12 20:43:15
c121ff4046263b37862f9aed5a6d7463794abb81...5f73e2c4fa5f40f528d4d1d6999697e7f3f5248f,1,4,1,5,3,2008-07-12 20:43:28,2008-07-12 20:43:28
5f73e2c4fa5f40f528d4d1d6999697e7f3f5248f...e63f8bf65571d07c02725a4c86036be11e949916,1,2,0,2,1,2008-07-12 20:43:38,2008-07-12 20:43:38
e63f8bf65571d07c02725a4c86036be11e949916...476d5f2c0d6e3141fa7429a904efb5721493bbdf,2,2,2,4,2,2008-07-12 20:43:52,2008-07-12 20:43:52
476d5f2c0d6e3141fa7429a904efb5721493bbdf...185ba8f7e4faafdc1cafb6d6559015c96345f209,1,1,1,2,1,2008-07-12 20:44:05,2008-07-12 20:44:05
185ba8f7e4faafdc1cafb6d6559015c96345f209...e47d8e7fb17c31a6ef5524957c8f8634ed6a64f5,1,5,0,5,1,2008-07-12 23:25:22,2008-07-12 23:25:22
e47d8e7fb17c31a6ef5524957c8f8634ed6a64f5...1bb880956175addecc345d8f0c25b7f8e46bb370,1,5,0,5,2,2008-07-13 01:17:23,2008-07-13 01:17:23
1bb880956175addecc345d8f0c25b7f8e46bb370...dee7de0c23f4c2103054c4a46d3bceac837b00a8,1,5,6,11,4,2008-07-13 01:22:31,2008-07-13 01:22:31
dee7de0c23f4c2103054c4a46d3bceac837b00a8...502e9a5ab48d33f4901fb0d022a3fb20c3959bdc,1,1,1,2,1,2008-07-13 08:45:17,2008-07-13 08:45:17
502e9a5ab48d33f4901fb0d022a3fb20c3959bdc...32b8c3e1c015902b72ef7caade5c35a10e80fb1a,13,80,2,82,15,2008-07-13 08:48:18,2008-07-13 08:48:18
32b8c3e1c015902b72ef7caade5c35a10e80fb1a...be6ca58d43d11b9b980d3fae199f89c51b8695fa,1,5,3,8,2,2008-07-13 08:57:30,2008-07-13 08:57:30
be6ca58d43d11b9b980d3fae199f89c51b8695fa...bba79ce4b41aed9cf024a1b41a359ccf38731b01,1,5,0,5,1,2008-07-13 11:47:09,2008-07-13 11:47:09
bba79ce4b41aed9cf024a1b41a359ccf38731b01...b4cc77c73d56d5e16ddd1bb3dac69b129fc85eb3,1,4,1,5,2,2008-07-13 12:16:11,2008-07-13 12:16:11
b4cc77c73d56d5e16ddd1bb3dac69b129fc85eb3...e867c5a0cc29977e926a836079061bf6a817f9af,1,1,1,2,1,2008-07-14 04:57:01,2008-07-14 04:57:01
e867c5a0cc29977e926a836079061bf6a817f9af...3b37c8151a06a2bebd51007db30ad436811b82c8,4,26,4,30,8,2008-07-15 18:47:32,2008-07-15 18:47:32
3b37c8151a06a2bebd51007db30ad436811b82c8...e7e4b8b0f774b119bc1c46a62a97e51d7c8a35e3,1,198,165,363,10,2008-07-15 18:47:49,2008-07-15 18:47:49
e7e4b8b0f774b119bc1c46a62a97e51d7c8a35e3...57bb10e6c46253d29eaee61b36ad442bc64d5c59,1,30,16,46,2,2008-07-15 19:17:49,2008-07-15 19:17:49
57bb10e6c46253d29eaee61b36ad442bc64d5c59...52fdedba48fc99876ab562bee2c29052953f8430,2,11,4,15,3,2008-07-16 23:17:29,2008-07-16 23:17:29
52fdedba48fc99876ab562bee2c29052953f8430...431206a2523c2d4ceddd710b3075567eea9b2176,1,25,17,42,3,2008-07-16 23:55:10,2008-07-16 23:55:10
431206a2523c2d4ceddd710b3075567eea9b2176...1107e6b47978cef0a511ed2ed247921d19d36803,1,4,1,5,1,2008-07-17 13:24:05,2008-07-17 13:24:05
1107e6b47978cef0a511ed2ed247921d19d36803...c4d0cfe1eeff3bfec364ba59d23aaff8be093267,1,1,1,2,1,2008-07-17 13:29:35,2008-07-17 13:29:35
c4d0cfe1eeff3bfec364ba59d23aaff8be093267...f6fafc02c8ba60b950bbe6be3b3ba729038dbb0a,1,11,3,14,1,2008-07-18 03:45:30,2008-07-18 03:45:30
f6fafc02c8ba60b950bbe6be3b3ba729038dbb0a...df2b19cc17666fe36a8153c3de45b20ffe3334ab,9,162,19,181,24,2008-07-18 03:47:27,2008-07-18 03:47:27
df2b19cc17666fe36a8153c3de45b20ffe3334ab...d261c1d000cfe05c6f3e290ca6b993606aed7f63,6,0,8,8,6,2008-07-18 04:34:47,2008-07-18 04:34:47
d261c1d000cfe05c6f3e290ca6b993606aed7f63...c681f4070c2095eae9635d13233e8d5fad5240f1,10,8,362,370,11,2008-07-18 17:38:53,2008-07-18 17:38:53
c681f4070c2095eae9635d13233e8d5fad5240f1...cd80ce7a3d7040e15f567a315850a744619c0d96,2,0,0,0,0,2008-07-18 17:39:31,2008-07-18 17:39:31
cd80ce7a3d7040e15f567a315850a744619c0d96...7997133a3dbf67edcb5a7588c1c049d181a4e61a,14,535,167,702,72,2008-07-18 19:45:00,2008-07-18 19:45:00
7997133a3dbf67edcb5a7588c1c049d181a4e61a...13643a7f5ded088b870b878712f0f4f39f213e52,2,3,9,12,3,2008-07-18 21:45:25,2008-07-18 21:45:25
13643a7f5ded088b870b878712f0f4f39f213e52...436ef181f33397a8c55fd3b626065a31cbc8d844,1,3,0,3,1,2008-07-18 22:36:31,2008-07-18 22:36:31
436ef181f33397a8c55fd3b626065a31cbc8d844...5f6b08fc6b7cb90b00b78db3d167b6e043baf643,1,2,2,4,2,2008-07-18 23:02:06,2008-07-18 23:02:06
5f6b08fc6b7cb90b00b78db3d167b6e043baf643...1442ebe1298c9347ce90e042a5adc146de57d2b2,0,0,0,0,0,2008-07-18 23:25:06,2008-07-18 23:25:06
1442ebe1298c9347ce90e042a5adc146de57d2b2...5735e161a211a6f3e335e68e97f4edc1d42612c1,1,1,1,2,1,2008-07-18 23:46:10,2008-07-18 23:46:10
5735e161a211a6f3e335e68e97f4edc1d42612c1...dc375fb0f3b7fbae740e8cfcd791b8bccb8a4e66,1,1,1,2,1,2008-07-18 23:52:18,2008-07-18 23:52:18
dc375fb0f3b7fbae740e8cfcd791b8bccb8a4e66...a19ed8aea395e8e07164ff7d85bd7dff2f24edca,121,8050,2680,10730,403,2008-07-18 23:54:34,2008-07-18 23:54:34
a19ed8aea395e8e07164ff7d85bd7dff2f24edca...88ae2d44e009ce6b03772a8af63d86405ab4595c,1,1,1,2,1,2008-07-19 00:07:47,2008-07-19 00:07:47
88ae2d44e009ce6b03772a8af63d86405ab4595c...39af2738fd64ba7f4c4af0783590e2b2b7b88460,1,1,1,2,1,2008-07-19 01:07:17,2008-07-19 01:07:17
39af2738fd64ba7f4c4af0783590e2b2b7b88460...46786b4193e04d398532bbfc3dcf63c03c1793cb,60,133,128,261,78,2008-07-19 01:22:26,2008-07-19 01:22:26
46786b4193e04d398532bbfc3dcf63c03c1793cb...d70df568e6375fffb0c8d0640b005c6254d9d8fa,0,0,0,0,0,2008-07-19 01:25:28,2008-07-19 01:25:28
d70df568e6375fffb0c8d0640b005c6254d9d8fa...56df66baa06b93bb1d603dc6b95fcfe5ed0be964,0,0,0,0,0,2008-07-19 02:13:39,2008-07-19 02:13:39
56df66baa06b93bb1d603dc6b95fcfe5ed0be964...69ac815a4112be4dce21b5f1e38a8a1a8f9db0ba,1,0,4,4,4,2008-07-19 02:26:58,2008-07-19 02:26:58
69ac815a4112be4dce21b5f1e38a8a1a8f9db0ba...825622d912aa8e87ddcda1af65edef9bb765e389,3,44,0,44,3,2008-07-19 02:38:41,2008-07-19 02:38:41
825622d912aa8e87ddcda1af65edef9bb765e389...b5b0febc4cd5ad51aeb1ef7b37aaca6a7632519d,1,5,0,5,1,2008-07-19 02:46:12,2008-07-19 02:46:12
b5b0febc4cd5ad51aeb1ef7b37aaca6a7632519d...649463dd348abd6d0cab890e2372e88fc452128e,8,204,40,244,26,2008-07-19 07:53:02,2008-07-19 07:53:02
649463dd348abd6d0cab890e2372e88fc452128e...c819252bf5e590b9bf66eb71d42938bb1ade2072,1,3,3,6,2,2008-07-19 11:27:55,2008-07-19 11:27:55
c819252bf5e590b9bf66eb71d42938bb1ade2072...0cffff024bde801620a1fae6ffe9f8e02be6f0ca,4,196,12,208,6,2008-07-19 14:46:55,2008-07-19 14:46:55
0cffff024bde801620a1fae6ffe9f8e02be6f0ca...dce4db49a750cdde81d406d8e005df08dc7ecd6e,0,0,0,0,0,2008-07-19 15:05:00,2008-07-19 15:05:00
dce4db49a750cdde81d406d8e005df08dc7ecd6e...4729e3836eb48a39bc58b0daeaa71d6d9ea1349d,2,4,10,14,5,2008-07-19 15:37:28,2008-07-19 15:37:28
4729e3836eb48a39bc58b0daeaa71d6d9ea1349d...67eeb72e2681496d33a8fb0e44090a5107737e0a,1,2,2,4,2,2008-07-19 15:51:48,2008-07-19 15:51:48
67eeb72e2681496d33a8fb0e44090a5107737e0a...c09351aec63f004f89befa4752b386f2a2a3a63c,1,4,2,6,2,2008-07-19 18:05:22,2008-07-19 18:05:22
c09351aec63f004f89befa4752b386f2a2a3a63c...a1037869716796a1075a964112aa380d86ed485f,2,26,6,32,8,2008-07-19 18:35:11,2008-07-19 18:35:11
a1037869716796a1075a964112aa380d86ed485f...344383284cf1a51fa646bc8926014f78ba512a56,3,26,0,26,6,2008-07-19 18:47:59,2008-07-19 18:47:59
344383284cf1a51fa646bc8926014f78ba512a56...795b6a12714d8e2ce43c9316dd9d1af8223bf659,1,8,5,13,3,2008-07-19 18:49:49,2008-07-19 18:49:49
795b6a12714d8e2ce43c9316dd9d1af8223bf659...8ac9cbee2f9fc2a6df8c52872011bacf223a952f,6,477,0,477,8,2008-07-19 19:22:44,2008-07-19 19:22:44
8ac9cbee2f9fc2a6df8c52872011bacf223a952f...e8dd3855c1d10154dd147f0b4585185609f61153,2,180,166,346,159,2008-07-19 19:26:47,2008-07-19 19:26:47
e8dd3855c1d10154dd147f0b4585185609f61153...b653cdcfb2558f8b3023711bd90f97192d6406fd,6,45,9,54,16,2008-07-19 19:32:01,2008-07-19 19:32:01
b653cdcfb2558f8b3023711bd90f97192d6406fd...99bbaa0090a605cfb80c9f1d7b1f86cb6b9e06f8,1,6,5,11,1,2008-07-19 19:32:12,2008-07-19 19:32:12
99bbaa0090a605cfb80c9f1d7b1f86cb6b9e06f8...ff68e85b8e6a8b35e1a5cce0e5dbeb585e70710f,2,13,12,25,2,2008-07-19 19:32:18,2008-07-19 19:32:18
ff68e85b8e6a8b35e1a5cce0e5dbeb585e70710f...be367501633889fdd66f4a56e646868e4ba78f4a,2,1739,1731,3470,549,2008-07-19 19:32:29,2008-07-19 19:32:29
be367501633889fdd66f4a56e646868e4ba78f4a...189c704ae64691ab6bbb8ffb3adee73ffd4105fe,8,21,59,80,18,2008-07-19 19:37:55,2008-07-19 19:37:55
189c704ae64691ab6bbb8ffb3adee73ffd4105fe...be922f1ba52d85823540d6f1941b63efc46d7349,2,606,509,1115,271,2008-07-19 19:54:09,2008-07-19 19:54:09
be922f1ba52d85823540d6f1941b63efc46d7349...a4619944dc02faa9fe0aacf6763b0cb60f620a11,2,50,105,155,59,2008-07-19 20:02:46,2008-07-19 20:02:46
a4619944dc02faa9fe0aacf6763b0cb60f620a11...5141b67a193a4e460460827f4d6859a31319aba5,2,5,25,30,7,2008-07-19 22:26:32,2008-07-19 22:26:32
5141b67a193a4e460460827f4d6859a31319aba5...e942636fbef8c8a7f799ac798597b99f003a038d,1,12,0,12,2,2008-07-19 22:26:46,2008-07-19 22:26:46
e942636fbef8c8a7f799ac798597b99f003a038d...44c329e1d3330ed4adfc8e60af08d1c550cdec6e,2,721,651,1372,414,2008-07-19 22:45:28,2008-07-19 22:45:28
44c329e1d3330ed4adfc8e60af08d1c550cdec6e...55ebc2b594243063afd315311b590bef04d7b61b,1,4,6,10,2,2008-07-19 22:50:06,2008-07-19 22:50:06
55ebc2b594243063afd315311b590bef04d7b61b...2f49d180711ffaac7080d473b2ef86d911015e53,2,22,14,36,6,2008-07-20 05:46:41,2008-07-20 05:46:41
2f49d180711ffaac7080d473b2ef86d911015e53...b58de151397c3a85002430c34b0dd1b400cede23,1,17,1,18,6,2008-07-20 06:32:54,2008-07-20 06:32:54
b58de151397c3a85002430c34b0dd1b400cede23...6db9fd0116406fcd29ae63efb344f76b73c73ec8,1,4,4,8,4,2008-07-20 08:47:10,2008-07-20 08:47:10
6db9fd0116406fcd29ae63efb344f76b73c73ec8...6c4c60b14abaea8b277fc20d66cbb47c0b8e1a80,1,0,3,3,1,2008-07-20 11:37:20,2008-07-20 11:37:20
6c4c60b14abaea8b277fc20d66cbb47c0b8e1a80...d911a64ce8bdb10e7704262837473215fcdb9cbe,3,61,7,68,7,2008-07-20 12:44:41,2008-07-20 12:44:41
d911a64ce8bdb10e7704262837473215fcdb9cbe...a53a1ba5419422e8611caefbab13bd4db8c53bc3,1,3,3,6,3,2008-07-20 18:05:11,2008-07-20 18:05:11
a53a1ba5419422e8611caefbab13bd4db8c53bc3...effa2993427cd49c40acc3982f658c0d4f78c4b5,1,3,0,3,1,2008-07-20 18:09:27,2008-07-20 18:09:27
effa2993427cd49c40acc3982f658c0d4f78c4b5...c2ee295f502295ac8b53d6d31ad492e831d3519c,1,7,5,12,5,2008-07-20 18:20:54,2008-07-20 18:20:54
c2ee295f502295ac8b53d6d31ad492e831d3519c...ee90b7cf9a166bbe2f7c5622e6ec080759e818ab,1,1,1,2,1,2008-07-20 21:12:36,2008-07-20 21:12:36
ee90b7cf9a166bbe2f7c5622e6ec080759e818ab...80ac41e2f789ab656867c88d3aa1b23118fada38,1,1,1,2,1,2008-07-21 03:50:40,2008-07-21 03:50:40
80ac41e2f789ab656867c88d3aa1b23118fada38...ca7ee4be17b9b3d80559de00c7bcbcafb188d4f1,1,3,0,3,1,2008-07-21 04:09:29,2008-07-21 04:09:29
ca7ee4be17b9b3d80559de00c7bcbcafb188d4f1...bfcecbffd37a68b5fffe81954c17aedeacb1ba22,13,170,27,197,35,2008-07-21 07:57:10,2008-07-21 07:57:10
bfcecbffd37a68b5fffe81954c17aedeacb1ba22...4016d5264ab049c33c845c5337ce2a3e50754268,3,10,2,12,3,2008-07-21 11:52:11,2008-07-21 11:52:11
4016d5264ab049c33c845c5337ce2a3e50754268...970611827b0012a40fc0723daadc666224134afa,3,45,1,46,3,2008-07-21 15:41:21,2008-07-21 15:41:21
970611827b0012a40fc0723daadc666224134afa...4f1cbaa93e2684f900fb350267a6092ea8c2bd95,2,11,15,26,2,2008-07-21 16:01:05,2008-07-21 16:01:05
4f1cbaa93e2684f900fb350267a6092ea8c2bd95...f28474547be843055474f0ecd05850eaed3c6d3a,2,21,0,21,4,2008-07-21 16:30:32,2008-07-21 16:30:32
f28474547be843055474f0ecd05850eaed3c6d3a...24aa08f486d7fa7fbfc91b35dd41aadeb0c900da,16,3169,3168,6337,139,2008-07-21 16:38:54,2008-07-21 16:38:54
24aa08f486d7fa7fbfc91b35dd41aadeb0c900da...4dd242bdeb6cd6f722e8728b8c5cdd662c3ec98a,1,2,2,4,1,2008-07-21 16:50:04,2008-07-21 16:50:04
4dd242bdeb6cd6f722e8728b8c5cdd662c3ec98a...ce3bdc86d4310765ad470305d986b4b0ed778a6c,5,20,20,40,19,2008-07-21 16:56:52,2008-07-21 16:56:52
ce3bdc86d4310765ad470305d986b4b0ed778a6c...8b1684e676979fbdc7907f8694def963d54a0f43,1,1,1,2,1,2008-07-21 16:57:50,2008-07-21 16:57:50
8b1684e676979fbdc7907f8694def963d54a0f43...f2c31535a0fdf42b00d2947bbb90cd1b955d89a7,2,7,50,57,6,2008-07-21 17:00:59,2008-07-21 17:00:59
f2c31535a0fdf42b00d2947bbb90cd1b955d89a7...882ffc05695777f3b4800a1ec1729dd4a683ccce,1,1,1,2,1,2008-07-21 17:04:59,2008-07-21 17:04:59
882ffc05695777f3b4800a1ec1729dd4a683ccce...f3ec0c18b170074dadb8d21375b1f080b18dc54e,1,3,5,8,4,2008-07-21 17:10:27,2008-07-21 17:10:27
f3ec0c18b170074dadb8d21375b1f080b18dc54e...ba6d7e1baee2992324b2b24c0b3bd6692e61ae92,1,25,1,26,3,2008-07-21 17:10:33,2008-07-21 17:10:33
ba6d7e1baee2992324b2b24c0b3bd6692e61ae92...3a2686a70d89f0ad4307ee835072d65ce1c0f310,1,2,1,3,2,2008-07-21 17:12:15,2008-07-21 17:12:15
3a2686a70d89f0ad4307ee835072d65ce1c0f310...fb516083324f581b5a100cb3abb74301c4847312,2,2,14,16,3,2008-07-21 17:13:41,2008-07-21 17:13:41
fb516083324f581b5a100cb3abb74301c4847312...384a721e1cd02b9c47f0d797ec8865e518aee84f,1,21,10,31,8,2008-07-21 17:28:21,2008-07-21 17:28:21
384a721e1cd02b9c47f0d797ec8865e518aee84f...1ef86fdf2bdc569582a99986b77c57209311e72d,1,0,1,1,1,2008-07-21 17:39:22,2008-07-21 17:39:22
1ef86fdf2bdc569582a99986b77c57209311e72d...c236874c48fff6509027ee08135eaf3171023917,2,12,1,13,2,2008-07-21 22:13:56,2008-07-21 22:13:56
c236874c48fff6509027ee08135eaf3171023917...863f4eb1d7cf96013207986c7f848defde16210d,4,24,0,24,5,2008-07-22 01:10:06,2008-07-22 01:10:06
863f4eb1d7cf96013207986c7f848defde16210d...d3f4de9c1866d2ac5396687200715364a0b20267,1,1,1,2,1,2008-07-22 01:15:43,2008-07-22 01:15:43
d3f4de9c1866d2ac5396687200715364a0b20267...2ba74aeb89882dbca44ca6f215113224718d982b,1,159,0,159,1,2008-07-22 01:27:16,2008-07-22 01:27:16
2ba74aeb89882dbca44ca6f215113224718d982b...cee642bcb88b21c67174fb99aacec1ff1982d21d,1,12,12,24,12,2008-07-22 02:02:40,2008-07-22 02:02:40
cee642bcb88b21c67174fb99aacec1ff1982d21d...459a7965dd8b2abbaa1740b68996c275d2c2f981,1,28,24,52,18,2008-07-22 02:33:16,2008-07-22 02:33:16
459a7965dd8b2abbaa1740b68996c275d2c2f981...46c7941de36fe82f5797bfee84109d048e2daf90,1,8,8,16,4,2008-07-22 02:51:59,2008-07-22 02:51:59
46c7941de36fe82f5797bfee84109d048e2daf90...ca98003390cd7f0132c7134accf419f957195192,1,4,4,8,1,2008-07-22 02:57:14,2008-07-22 02:57:14
ca98003390cd7f0132c7134accf419f957195192...bfcecfee91f7a6c051c0e7c324c8311608a712b5,12,27,27,54,26,2008-07-22 03:01:21,2008-07-22 03:01:21
bfcecfee91f7a6c051c0e7c324c8311608a712b5...8bc442e7715f56cf108a35025493af90687e33ee,2,10,1,11,3,2008-07-22 03:05:40,2008-07-22 03:05:40
8bc442e7715f56cf108a35025493af90687e33ee...cf2a05952eb35f1532e0127e8e871c9c153afac7,1,3,12,15,2,2008-07-22 03:10:05,2008-07-22 03:10:05
cf2a05952eb35f1532e0127e8e871c9c153afac7...29f0e8182f49e2927ae46e748d09d0672d4fc127,34,30,61,91,56,2008-07-22 03:24:09,2008-07-22 03:24:09
29f0e8182f49e2927ae46e748d09d0672d4fc127...0894ddb2bbb706ca8b9918df42dfd8a3fa4dbc69,3,2,16,18,8,2008-07-22 03:26:25,2008-07-22 03:26:25
0894ddb2bbb706ca8b9918df42dfd8a3fa4dbc69...f5328f4c38ca7c3c648cee741a7d882738ffee13,1,1,1,2,1,2008-07-22 03:31:05,2008-07-22 03:31:05
f5328f4c38ca7c3c648cee741a7d882738ffee13...c51d000c37ce87ee6c9162d639768d6134719ff4,1,1,1,2,1,2008-07-22 03:44:48,2008-07-22 03:44:48
c51d000c37ce87ee6c9162d639768d6134719ff4...6ef47cfe5fe728bcc0290543eccd87e63c11d6a1,1,2,0,2,1,2008-07-22 04:49:32,2008-07-22 04:49:32
6ef47cfe5fe728bcc0290543eccd87e63c11d6a1...0e9587fd6b180d0a752ae77d3adb5e7966cb65b4,1,8,10,18,2,2008-07-22 05:15:40,2008-07-22 05:15:40
0e9587fd6b180d0a752ae77d3adb5e7966cb65b4...83e97ecf885676f29170ee036ca210d28dfe19fb,2,8,2,10,2,2008-07-22 07:37:09,2008-07-22 07:37:09
83e97ecf885676f29170ee036ca210d28dfe19fb...8745beccb10f60864910b7941d7d0c99a5db30ed,2,11,0,11,2,2008-07-22 08:23:20,2008-07-22 08:23:20
8745beccb10f60864910b7941d7d0c99a5db30ed...d1ea8b2842a9d1fd54c799e9f374d6b53931942e,1,2,2,4,1,2008-07-22 18:56:50,2008-07-22 18:56:50
d1ea8b2842a9d1fd54c799e9f374d6b53931942e...c5a76a366970dc1305bb638ed6bd070d0a86376c,3,16,5,21,7,2008-07-22 19:48:36,2008-07-22 19:48:36
c5a76a366970dc1305bb638ed6bd070d0a86376c...437945146db3c72c9ec54b8497ede8ecc8cd0d45,1,1,1,2,1,2008-07-23 03:00:50,2008-07-23 03:00:50
437945146db3c72c9ec54b8497ede8ecc8cd0d45...62d9e278d7230f035b3521492c28dd8c1f66147a,1,8,2,10,3,2008-07-23 03:25:41,2008-07-23 03:25:41
62d9e278d7230f035b3521492c28dd8c1f66147a...9d8f41baac6b3ca56c7732a2f93e15cda494a1ea,4,9,35,44,31,2008-07-23 04:28:52,2008-07-23 04:28:52
9d8f41baac6b3ca56c7732a2f93e15cda494a1ea...681e7bbd255ec4237e3e5594c331e6b5ff9e03cb,1,0,6,6,1,2008-07-23 04:41:53,2008-07-23 04:41:53
681e7bbd255ec4237e3e5594c331e6b5ff9e03cb...3912403550e31ddb3a002789dd2fe3379a4e006e,2,12,2,14,3,2008-07-23 04:46:31,2008-07-23 04:46:31
3912403550e31ddb3a002789dd2fe3379a4e006e...a7b556ca044b2d51d25d566a7ce6410111cf50e1,2,40,9,49,6,2008-07-23 06:12:15,2008-07-23 06:12:15
a7b556ca044b2d51d25d566a7ce6410111cf50e1...508016c0f4ea035af9f46d87af6c0ed40171acf0,2,0,0,0,0,2008-07-23 14:15:03,2008-07-23 14:15:03
508016c0f4ea035af9f46d87af6c0ed40171acf0...7b3cf13d3249d4e4bcf152e27631ea7ec4a55412,3,86,7,93,5,2008-07-23 18:58:06,2008-07-23 18:58:06
7b3cf13d3249d4e4bcf152e27631ea7ec4a55412...4e723f95715c771bc75b92ef50544e95ee01dfca,1,2,2,4,1,2008-07-23 22:30:25,2008-07-23 22:30:25
4e723f95715c771bc75b92ef50544e95ee01dfca...9237466beebda25efd8602124324926e98ada8fb,1,1,1,2,1,2008-07-23 22:39:41,2008-07-23 22:39:41
9237466beebda25efd8602124324926e98ada8fb...466ddfa798b7d6ef20e24b4f7889777119e4a306,2,883,967,1850,460,2008-07-24 11:37:45,2008-07-24 11:37:45
466ddfa798b7d6ef20e24b4f7889777119e4a306...f5801e5fd13152709e2dd90c4fcceccdbfc8b2a5,2,554,493,1047,267,2008-07-24 12:34:49,2008-07-24 12:34:49
f5801e5fd13152709e2dd90c4fcceccdbfc8b2a5...96d141dfdac5b9913277e2b5d47b412c85453169,1,5,4,9,5,2008-07-24 20:11:37,2008-07-24 20:11:37
96d141dfdac5b9913277e2b5d47b412c85453169...dd5194ad7e484d89b67df544721e67057d7ef3e7,2,124,99,223,94,2008-07-25 06:13:38,2008-07-25 06:13:38
dd5194ad7e484d89b67df544721e67057d7ef3e7...ecdd071794ddbc71844778a5587f33296fa2da09,1,1,1,2,1,2008-07-25 11:21:21,2008-07-25 11:21:21
ecdd071794ddbc71844778a5587f33296fa2da09...3898af2f51ed810cb9a1873aacede28851a83449,1,1,1,2,1,2008-07-25 11:32:06,2008-07-25 11:32:06
3898af2f51ed810cb9a1873aacede28851a83449...3992683ea349e2843a710e79c1c69ac2d80bb1ac,1,2,2,4,2,2008-07-25 14:44:56,2008-07-25 14:44:56
3992683ea349e2843a710e79c1c69ac2d80bb1ac...7c0cf545efbad0c609b9d539c85e532e5c115cd3,2,10,2,12,2,2008-07-25 14:47:35,2008-07-25 14:47:35
7c0cf545efbad0c609b9d539c85e532e5c115cd3...7c33cc7f5ef4597b55dde561c1752db4d0feaca1,3,33,7,40,8,2008-07-25 18:51:32,2008-07-25 18:51:32
7c33cc7f5ef4597b55dde561c1752db4d0feaca1...a1fda7e1b05c85191fbbafb16081c428862fba57,1,2,2,4,2,2008-07-26 00:26:51,2008-07-26 00:26:51
a1fda7e1b05c85191fbbafb16081c428862fba57...cdc6415fdf21c1b5f40ab84ffdea7a4b128744c2,1,1,1,2,1,2008-07-26 01:12:46,2008-07-26 01:12:46
cdc6415fdf21c1b5f40ab84ffdea7a4b128744c2...453a5bcd975e5f82f61121dac27af374cc011d1e,1,1,1,2,1,2008-07-26 03:01:33,2008-07-26 03:01:33
453a5bcd975e5f82f61121dac27af374cc011d1e...f8713ee243d364c5afaf496caed24df90e82dd00,2,1,1,2,1,2008-07-26 03:05:40,2008-07-26 03:05:40
f8713ee243d364c5afaf496caed24df90e82dd00...4ec2b8904bdaec4b757c7e6822fd170be87f5493,1,4,4,8,2,2008-07-26 03:08:53,2008-07-26 03:08:53
4ec2b8904bdaec4b757c7e6822fd170be87f5493...b149e3d9e7fce426e0ee5db5e7f1988b9f2d147c,1,1,1,2,1,2008-07-26 03:31:22,2008-07-26 03:31:22
b149e3d9e7fce426e0ee5db5e7f1988b9f2d147c...f49c5c23f96f11a993036fa10c81b4287327d7ec,2,11,3,14,5,2008-07-26 03:37:25,2008-07-26 03:37:25
f49c5c23f96f11a993036fa10c81b4287327d7ec...6f16b5bad2f714b88639ebb90d30fd6cef686cfc,2,12,1,13,3,2008-07-26 03:58:31,2008-07-26 03:58:31
6f16b5bad2f714b88639ebb90d30fd6cef686cfc...fe240b18f61a74acf627f0747a6bc0098772ba0f,1,0,4,4,2,2008-07-26 04:10:40,2008-07-26 04:10:40
fe240b18f61a74acf627f0747a6bc0098772ba0f...319a31464d5d60dad11cab804fd9d9c709e4c0bb,1,1,1,2,1,2008-07-26 04:10:52,2008-07-26 04:10:52
319a31464d5d60dad11cab804fd9d9c709e4c0bb...a26ba33111a41d87eaea23b4ba2ae48be4e08b18,6,126,0,126,8,2008-07-26 04:25:42,2008-07-26 04:25:42
a26ba33111a41d87eaea23b4ba2ae48be4e08b18...badde8a7e5090347feea0b39221dbdea428582b8,4,38,9,47,12,2008-07-26 05:07:16,2008-07-26 05:07:16
badde8a7e5090347feea0b39221dbdea428582b8...108b604b51948a3aa8a5c789887a97eb417d3cb5,2,26,13,39,15,2008-07-26 05:18:39,2008-07-26 05:18:39
108b604b51948a3aa8a5c789887a97eb417d3cb5...66612ef52996f06be3e94fff0b1ef015d462581d,1,1,1,2,1,2008-07-26 05:27:59,2008-07-26 05:27:59
66612ef52996f06be3e94fff0b1ef015d462581d...eca3c7d3d6c05a13c788c980f49a6077f960a709,1,4,1,5,2,2008-07-26 14:49:39,2008-07-26 14:49:39
eca3c7d3d6c05a13c788c980f49a6077f960a709...8099bc536bbd5d216f0ca781d9ff1c303917430b,1,4,4,8,4,2008-07-26 15:06:42,2008-07-26 15:06:42
8099bc536bbd5d216f0ca781d9ff1c303917430b...03373f1e24e3bdfef149de5e0478a39f38f1434d,1,1,1,2,1,2008-07-26 17:08:53,2008-07-26 17:08:53
03373f1e24e3bdfef149de5e0478a39f38f1434d...f763ff4d02b5c99bdb1ebaf63967a24d8e8447ac,2,35,35,70,35,2008-07-26 22:02:07,2008-07-26 22:02:07
f763ff4d02b5c99bdb1ebaf63967a24d8e8447ac...e29aece743df644cdaa7d8506c6491ac9c1db061,3,43,16,59,11,2008-07-26 22:09:43,2008-07-26 22:09:43
e29aece743df644cdaa7d8506c6491ac9c1db061...103d484807050c00d02641aa04670cea8d0e68a4,3,74,15,89,18,2008-07-26 22:48:51,2008-07-26 22:48:51
103d484807050c00d02641aa04670cea8d0e68a4...aee55ce5249fdc822d6bd4ec5238a3154a217dcb,1,3,3,6,4,2008-07-27 01:18:18,2008-07-27 01:18:18
aee55ce5249fdc822d6bd4ec5238a3154a217dcb...f48855178daf8f924338f8df322353797ce30081,2,14,10,24,4,2008-07-27 01:18:23,2008-07-27 01:18:23
f48855178daf8f924338f8df322353797ce30081...ccab4b041bded4af529ca2ede4dffab0d95fb5f2,1,20,16,36,7,2008-07-27 03:32:44,2008-07-27 03:32:44
ccab4b041bded4af529ca2ede4dffab0d95fb5f2...3cbe73692eb5bdd45227c5957f7bc1801974722b,3,32,1,33,4,2008-07-27 04:18:52,2008-07-27 04:18:52
3cbe73692eb5bdd45227c5957f7bc1801974722b...0e629b01c0470d46be367ff394bbe345d53a9883,0,0,0,0,0,2008-07-27 07:01:28,2008-07-27 07:01:28
0e629b01c0470d46be367ff394bbe345d53a9883...661f62be3c5f810fddd3b33bcbdfe33a3077a66d,3,73,4,77,9,2008-07-27 07:22:39,2008-07-27 07:22:39
661f62be3c5f810fddd3b33bcbdfe33a3077a66d...830b750131d2ac4c5e896cc4594ffd22db26b53e,0,0,0,0,0,2008-07-27 07:24:14,2008-07-27 07:24:14
830b750131d2ac4c5e896cc4594ffd22db26b53e...12eba9efc1eadcca4dcb55fdf0035a8893322062,1,0,4,4,4,2008-07-27 13:55:35,2008-07-27 13:55:35
12eba9efc1eadcca4dcb55fdf0035a8893322062...020f965087e82a7e4e9aede9542365206f3ca162,1,2,2,4,2,2008-07-27 17:24:35,2008-07-27 17:24:35
020f965087e82a7e4e9aede9542365206f3ca162...4774c8d6739da02a7890f1ff80a87b6ca87821a7,1,2,2,4,1,2008-07-27 17:25:37,2008-07-27 17:25:37
4774c8d6739da02a7890f1ff80a87b6ca87821a7...4fee39c63ce781e7af827feeabcc911080d81edc,2,32,6,38,9,2008-07-27 18:16:17,2008-07-27 18:16:17
4fee39c63ce781e7af827feeabcc911080d81edc...ce15b389c188205b3117c044a71c5d163e913948,1,68,68,136,68,2008-07-27 18:25:06,2008-07-27 18:25:06
ce15b389c188205b3117c044a71c5d163e913948...633ed5c4c957ca2cd9adc281f7133bf639bd4f19,1,9,5,14,1,2008-07-27 18:27:56,2008-07-27 18:27:56
633ed5c4c957ca2cd9adc281f7133bf639bd4f19...b1c0dc5a017f2464d5d77878b192beea9e278c53,4,7,7,14,7,2008-07-27 18:34:21,2008-07-27 18:34:21
b1c0dc5a017f2464d5d77878b192beea9e278c53...156b21a339d555d56b1b4bc7f3e16a9002f745c3,1,18,18,36,18,2008-07-27 18:36:08,2008-07-27 18:36:08
156b21a339d555d56b1b4bc7f3e16a9002f745c3...2c6d1e8ebc2d5d8cb62473dcb35f3c783aab6b95,1,9,5,14,2,2008-07-27 18:38:56,2008-07-27 18:38:56
2c6d1e8ebc2d5d8cb62473dcb35f3c783aab6b95...82a85fdbaec57955c264ef016e6958456d8fdf4e,4,59,3,62,8,2008-07-27 18:54:56,2008-07-27 18:54:56
82a85fdbaec57955c264ef016e6958456d8fdf4e...66d5018dd121f8e20db38992a571487f36215a66,1,1,1,2,1,2008-07-27 19:05:54,2008-07-27 19:05:54
66d5018dd121f8e20db38992a571487f36215a66...b790f34542f67989991ac88893a131597708efa0,2,700,580,1280,330,2008-07-27 19:38:35,2008-07-27 19:38:35
b790f34542f67989991ac88893a131597708efa0...dc7581da2aae8bcc47254573c7dc240823a65eab,2,1,1,2,1,2008-07-27 19:41:22,2008-07-27 19:41:22
dc7581da2aae8bcc47254573c7dc240823a65eab...03ef8ac11434df01f168aae987f1d11be52fa994,1,81,38,119,35,2008-07-27 20:02:20,2008-07-27 20:02:20
03ef8ac11434df01f168aae987f1d11be52fa994...7b89abaf4883e21a8d80f7c2dca78ec2c84e0973,1,0,0,0,0,2008-07-27 20:03:35,2008-07-27 20:03:35
7b89abaf4883e21a8d80f7c2dca78ec2c84e0973...7d1c147bb4cb5d0b89b3e5d331d13660b3fe6ea5,1,2,2,4,1,2008-07-27 22:09:12,2008-07-27 22:09:12
7d1c147bb4cb5d0b89b3e5d331d13660b3fe6ea5...6a287ed946e117d9daf757b9aff52087c93ad2ac,3,34,23,57,9,2008-07-27 22:51:49,2008-07-27 22:51:49
6a287ed946e117d9daf757b9aff52087c93ad2ac...9a5301ccbc08d5e4f78ae6a8a39330196cdd5f66,3,37,22,59,6,2008-07-27 23:01:55,2008-07-27 23:01:55
9a5301ccbc08d5e4f78ae6a8a39330196cdd5f66...fdff91ac2dc91f25d2162ca83e5027ecd733884e,1,3,4,7,2,2008-07-27 23:23:49,2008-07-27 23:23:49
fdff91ac2dc91f25d2162ca83e5027ecd733884e...de9e2ae5bb81a4c227e48bc0199fd3734ccba95c,1,1,1,2,1,2008-07-27 23:27:16,2008-07-27 23:27:16
de9e2ae5bb81a4c227e48bc0199fd3734ccba95c...d57ce3d6a9e4533e1814cbf39194e99b91b30f4e,7,367,112,479,87,2008-07-27 23:38:28,2008-07-27 23:38:28
d57ce3d6a9e4533e1814cbf39194e99b91b30f4e...4b6766cd6b54f436980181fc4ab9ce0d67bb6321,2,7,6,13,2,2008-07-27 23:51:07,2008-07-27 23:51:07
4b6766cd6b54f436980181fc4ab9ce0d67bb6321...eca5aacec81ba6d0f3f2d8c62ded3bc8e3433b20,3,23,34,57,9,2008-07-28 00:08:17,2008-07-28 00:08:17
eca5aacec81ba6d0f3f2d8c62ded3bc8e3433b20...55ba38f9d26347a68fd25c32ea62d8265f96a176,3,39,25,64,9,2008-07-28 00:45:04,2008-07-28 00:45:04
55ba38f9d26347a68fd25c32ea62d8265f96a176...19c7db005823efc2da73ca3bcb37ee15451589c8,2,18,2,20,5,2008-07-28 01:32:46,2008-07-28 01:32:46
19c7db005823efc2da73ca3bcb37ee15451589c8...96cf3656c48f6c42714a70b4546bc42f7b904185,4,167,5,172,7,2008-07-28 05:30:35,2008-07-28 05:30:35
96cf3656c48f6c42714a70b4546bc42f7b904185...7bc728c826aa83338c5566f7f9e919de62f73390,1,3,3,6,3,2008-07-28 20:35:39,2008-07-28 20:35:39
7bc728c826aa83338c5566f7f9e919de62f73390...b3b71a0922334c70bbc646a4873010f808196671,11,318,135,453,61,2008-07-29 05:09:29,2008-07-29 05:09:29
b3b71a0922334c70bbc646a4873010f808196671...af7773f2800961c7a9628a3f8997e2e7ed81a7dd,1,2,1,3,1,2008-07-29 05:17:47,2008-07-29 05:17:47
af7773f2800961c7a9628a3f8997e2e7ed81a7dd...548ac722079c1d2c71dac4c5b366425e35d00def,3,14,6,20,7,2008-07-29 05:53:44,2008-07-29 05:53:44
548ac722079c1d2c71dac4c5b366425e35d00def...b6fe483bf5783a72fdfbe55463b9490496da1fa3,1,33,0,33,3,2008-07-29 06:02:47,2008-07-29 06:02:47
b6fe483bf5783a72fdfbe55463b9490496da1fa3...f752f692386faf328c5e091d71d50024ac5b09d0,1,3,2,5,2,2008-07-29 06:05:15,2008-07-29 06:05:15
f752f692386faf328c5e091d71d50024ac5b09d0...174641b9b35022b80ea1d1a917a9d95b37a551d7,13,957,43,1000,42,2008-07-29 12:41:08,2008-07-29 12:41:08
174641b9b35022b80ea1d1a917a9d95b37a551d7...bf777442fa35efe7b980ca5880eb606795af7b43,1,1,1,2,1,2008-07-29 13:32:47,2008-07-29 13:32:47
bf777442fa35efe7b980ca5880eb606795af7b43...b69b15fe02c47a754ab117dd4b5957eabe05c1ca,1,1,1,2,1,2008-07-29 18:31:27,2008-07-29 18:31:27
b69b15fe02c47a754ab117dd4b5957eabe05c1ca...a14fc40041b28dd4aa07bd1ffca8a0189ac5fb5f,1,1,1,2,1,2008-07-29 21:43:07,2008-07-29 21:43:07
a14fc40041b28dd4aa07bd1ffca8a0189ac5fb5f...ab07a9b19ffdb19196c167469bd54c3fcb2110a2,1,22,0,22,1,2008-07-29 23:09:54,2008-07-29 23:09:54
ab07a9b19ffdb19196c167469bd54c3fcb2110a2...1ba2d6888f78ddd280d5882cd31e7253ef143cbc,1,1,1,2,1,2008-07-30 00:18:31,2008-07-30 00:18:31
1ba2d6888f78ddd280d5882cd31e7253ef143cbc...281f2b74bf19161a0dc5791a07d239ce6a27ed2f,2,16,5,21,7,2008-07-30 00:18:49,2008-07-30 00:18:49
281f2b74bf19161a0dc5791a07d239ce6a27ed2f...726a24c609110f5d99f4104692b6e1e2181687f9,1,11,11,22,11,2008-07-30 00:52:01,2008-07-30 00:52:01
726a24c609110f5d99f4104692b6e1e2181687f9...464a9c8ca482f4a96c9da66e791bd3fb646ffbd2,1,33,10,43,9,2008-07-30 01:29:31,2008-07-30 01:29:31
464a9c8ca482f4a96c9da66e791bd3fb646ffbd2...b7e74e5e56fd203ab979d8fddf3aa16f03db2e38,1,2,2,4,2,2008-07-30 03:16:39,2008-07-30 03:16:39
b7e74e5e56fd203ab979d8fddf3aa16f03db2e38...ea45a932d3f438a9f2ce6f59c545b299e425d5e6,1,3,3,6,2,2008-07-30 03:19:31,2008-07-30 03:19:31
ea45a932d3f438a9f2ce6f59c545b299e425d5e6...74dde43989517076fe7387665dbf0aec52e6d006,1,4,1,5,1,2008-07-30 05:50:24,2008-07-30 05:50:24
74dde43989517076fe7387665dbf0aec52e6d006...0dc11a0c1d92fc9c3d93056f0e307126ea13e9b2,1,4,1,5,1,2008-07-30 09:29:51,2008-07-30 09:29:51
0dc11a0c1d92fc9c3d93056f0e307126ea13e9b2...4454bde3c1cfc083915fd3311733b47fe77ac0ae,1,3,3,6,3,2008-07-30 10:08:12,2008-07-30 10:08:12
4454bde3c1cfc083915fd3311733b47fe77ac0ae...56bbe0aa462130c29af35e732f56b381644895cb,3,9,14,23,5,2008-07-30 10:40:37,2008-07-30 10:40:37
56bbe0aa462130c29af35e732f56b381644895cb...a98d12b1b28db77978be6edc132b279357e25011,1,1,1,2,1,2008-07-30 11:11:44,2008-07-30 11:11:44
a98d12b1b28db77978be6edc132b279357e25011...f7d123a731e62af9a792623812bef632f3142547,1,17,9,26,2,2008-07-30 11:41:04,2008-07-30 11:41:04
f7d123a731e62af9a792623812bef632f3142547...8880fdd9ee7cd551ba10d34d80fa6092494c47ec,1,3,3,6,1,2008-07-30 12:37:38,2008-07-30 12:37:38
8880fdd9ee7cd551ba10d34d80fa6092494c47ec...004ff03a8eec02c9656544bb9881d6edaeda961c,1,0,5,5,2,2008-07-30 21:55:47,2008-07-30 21:55:47
004ff03a8eec02c9656544bb9881d6edaeda961c...7a87f5aeaba09fb96d7f3c5dfd620fd2cd7989de,1,1,1,2,1,2008-07-31 07:53:55,2008-07-31 07:53:55
7a87f5aeaba09fb96d7f3c5dfd620fd2cd7989de...9ea8184da83954b47221dfdcae5928626b7a9f02,1,30,10,40,9,2008-07-31 08:32:19,2008-07-31 08:32:19
9ea8184da83954b47221dfdcae5928626b7a9f02...99e34c184692c98489f3d3f6ca257d0e87f0e7ab,1,1,1,2,1,2008-07-31 09:08:55,2008-07-31 09:08:55
99e34c184692c98489f3d3f6ca257d0e87f0e7ab...f423dde34aa0e97dd6ae3a79d4b8f7e4991fb0a2,1,4,1,5,2,2008-07-31 09:24:16,2008-07-31 09:24:16
f423dde34aa0e97dd6ae3a79d4b8f7e4991fb0a2...9a56fe765e75e99a34cc39c82f282be68544b706,1,1,1,2,1,2008-07-31 13:28:51,2008-07-31 13:28:51
9a56fe765e75e99a34cc39c82f282be68544b706...fcd837cd0f9b2c706bc49af509628778d442bb3f,16,399,68,467,43,2008-07-31 20:47:53,2008-07-31 20:47:53
fcd837cd0f9b2c706bc49af509628778d442bb3f...af22db8f08cf7b11ade0aa801f15043d3f40be69,2,1472,1230,2702,885,2008-07-31 21:12:14,2008-07-31 21:12:14
af22db8f08cf7b11ade0aa801f15043d3f40be69...b0d1612c9e44523752277b33cf24c8bc7ca8c374,4,3918,1319,5237,423,2008-07-31 21:18:30,2008-07-31 21:18:30
b0d1612c9e44523752277b33cf24c8bc7ca8c374...83f0d54d41a23ae856376942e1ece8fd8d6efa34,1,9,2,11,2,2008-08-01 00:27:40,2008-08-01 00:27:40
83f0d54d41a23ae856376942e1ece8fd8d6efa34...c1f5da90a5596a238017b242e698d14d6e71e796,1,1,1,2,1,2008-08-01 02:23:46,2008-08-01 02:23:46
c1f5da90a5596a238017b242e698d14d6e71e796...74927cd87eaf9bd2fe8fd8d23180f46a3c5d9fa7,1,11,3,14,1,2008-08-01 04:38:55,2008-08-01 04:38:55
74927cd87eaf9bd2fe8fd8d23180f46a3c5d9fa7...c623cc30bebb8a29b1ab9ee33a3c3ff54f389e8b,2,699,544,1243,287,2008-08-01 12:31:12,2008-08-01 12:31:12
c623cc30bebb8a29b1ab9ee33a3c3ff54f389e8b...8fe07d1e636486c831d5a667952b67e8b6e13bea,1,2,2,4,1,2008-08-01 14:44:38,2008-08-01 14:44:38
8fe07d1e636486c831d5a667952b67e8b6e13bea...27d59729166e6d3a9de860c221aa435249294706,2,56,1,57,4,2008-08-01 15:54:53,2008-08-01 15:54:53
27d59729166e6d3a9de860c221aa435249294706...079e5bf1ec7a37497d41d79daa074ac9107bb3ec,2,5,1,6,3,2008-08-01 16:13:12,2008-08-01 16:13:12
079e5bf1ec7a37497d41d79daa074ac9107bb3ec...64f5ab67a57f7373cee2cc675ae03d74e878b645,1,7,7,14,1,2008-08-01 16:18:24,2008-08-01 16:18:24
64f5ab67a57f7373cee2cc675ae03d74e878b645...be17a801f6053fe8ef6250cc1a25f80db6956698,2,24,1,25,4,2008-08-01 18:55:43,2008-08-01 18:55:43
be17a801f6053fe8ef6250cc1a25f80db6956698...525e1e379af20e53819b3b34b27380eb27ca0ac8,1,5,2,7,3,2008-08-01 19:10:55,2008-08-01 19:10:55
525e1e379af20e53819b3b34b27380eb27ca0ac8...e7508a456ea97ec513507149280ab36cde271738,1,20,0,20,1,2008-08-01 19:29:37,2008-08-01 19:29:37
e7508a456ea97ec513507149280ab36cde271738...2904c1d4b33fb4612291db9d46fff56842854e58,1,19,1,20,2,2008-08-01 19:47:26,2008-08-01 19:47:26
2904c1d4b33fb4612291db9d46fff56842854e58...4c0234215ec38f9fb7ce95cdc49d89cf10a87b50,1,1,1,2,1,2008-08-01 20:00:30,2008-08-01 20:00:30
4c0234215ec38f9fb7ce95cdc49d89cf10a87b50...61b335700ca89bbabc25fecd0df476dcae9a4309,1,10,4,14,3,2008-08-01 20:12:18,2008-08-01 20:12:18
61b335700ca89bbabc25fecd0df476dcae9a4309...af35fb1fbb48e6125b313ad35238cd06fa3ce7b5,2,17,2,19,3,2008-08-01 20:35:40,2008-08-01 20:35:40
af35fb1fbb48e6125b313ad35238cd06fa3ce7b5...8dff194e9b22e05c4146798c7b00bbf48af80213,1,8,8,16,5,2008-08-01 21:18:17,2008-08-01 21:18:17
8dff194e9b22e05c4146798c7b00bbf48af80213...ff486b9fba1eaffdf204c4b0ee8babf0d3627725,1,2,0,2,1,2008-08-01 21:37:38,2008-08-01 21:37:38
ff486b9fba1eaffdf204c4b0ee8babf0d3627725...9d3c921857145b2ab4d3b0c25ca75c23e397dbdc,1,91,0,91,1,2008-08-01 22:46:09,2008-08-01 22:46:09
9d3c921857145b2ab4d3b0c25ca75c23e397dbdc...85af2641125dfdd141f744f37be616499108ace9,1,2,5,7,3,2008-08-01 22:46:15,2008-08-01 22:46:15
85af2641125dfdd141f744f37be616499108ace9...b5c5e8b4c06823fc3a14268a6e106e3fb6807813,1,0,91,91,1,2008-08-01 22:47:45,2008-08-01 22:47:45
b5c5e8b4c06823fc3a14268a6e106e3fb6807813...2db4b134809e162a6aa142300a1df14638eeae94,4,83,18,101,19,2008-08-01 23:16:59,2008-08-01 23:16:59
2db4b134809e162a6aa142300a1df14638eeae94...e608433ee76080a18f177f6e18a11de624d3f03d,1,4,2,6,2,2008-08-01 23:29:25,2008-08-01 23:29:25
e608433ee76080a18f177f6e18a11de624d3f03d...c4ba628231296c2b9d70e15240877abf6d63032a,1,1,0,1,1,2008-08-01 23:31:20,2008-08-01 23:31:20
c4ba628231296c2b9d70e15240877abf6d63032a...d7dc2d39857ccc1fce62f11c355cd1c5696bc08c,1,1,1,2,1,2008-08-02 00:33:21,2008-08-02 00:33:21
d7dc2d39857ccc1fce62f11c355cd1c5696bc08c...a500ade891c5f2b3e5f7502b6fb121bc733dd0b5,1,2,9,11,3,2008-08-02 00:40:05,2008-08-02 00:40:05
a500ade891c5f2b3e5f7502b6fb121bc733dd0b5...cbbd54d5cda576f0d604ef519b078fdc585d4f5a,2,42,38,80,10,2008-08-02 04:48:14,2008-08-02 04:48:14
cbbd54d5cda576f0d604ef519b078fdc585d4f5a...351a3ca15494f5061c9656830d2d614ac30dc693,17,10,464,474,23,2008-08-02 04:56:11,2008-08-02 04:56:11
351a3ca15494f5061c9656830d2d614ac30dc693...8a58f2216cb2897db53ad166d71393fef1181c1a,1,20,17,37,15,2008-08-02 05:29:17,2008-08-02 05:29:17
8a58f2216cb2897db53ad166d71393fef1181c1a...c85c8f88914cdba05813cc5768377841340bd09d,17,137,116,253,106,2008-08-02 05:56:57,2008-08-02 05:56:57
c85c8f88914cdba05813cc5768377841340bd09d...2a7f7e1b97f45e8a5b0b38cf430a2062d59f62b5,1,0,5,5,5,2008-08-02 06:04:09,2008-08-02 06:04:09
2a7f7e1b97f45e8a5b0b38cf430a2062d59f62b5...52b877eef08f5c8e22765e2e0954c5a472ea71f3,1,80,34,114,18,2008-08-03 01:33:43,2008-08-03 01:33:43
52b877eef08f5c8e22765e2e0954c5a472ea71f3...1b1b8d097100f88c537a589cac678c657048a417,1,689,534,1223,234,2008-08-03 02:47:10,2008-08-03 02:47:10
1b1b8d097100f88c537a589cac678c657048a417...cd3def1e4e3233a22098433a5efeaf371d3a2f89,1,2,35,37,1,2008-08-03 02:52:46,2008-08-03 02:52:46
cd3def1e4e3233a22098433a5efeaf371d3a2f89...3d918f41f50f1f1f756adbc77ed9575d6b475166,1,10,0,10,1,2008-08-03 03:03:46,2008-08-03 03:03:46
3d918f41f50f1f1f756adbc77ed9575d6b475166...06885f37be28567a8a0f980300d2c424a7f8a91b,1,0,1,1,1,2008-08-03 17:26:50,2008-08-03 17:26:50
06885f37be28567a8a0f980300d2c424a7f8a91b...cca261325abe49d02b4d9d7c3e8df559a2988120,1,0,1,1,1,2008-08-03 18:51:18,2008-08-03 18:51:18
cca261325abe49d02b4d9d7c3e8df559a2988120...71b2e01ec29f972482fad5ef6638c7a2d9495697,1,71,71,142,47,2008-08-03 19:04:32,2008-08-03 19:04:32
71b2e01ec29f972482fad5ef6638c7a2d9495697...daa6b38f352447a5afed3184f4ffffd0d6b1f1de,8,68,23,91,7,2008-08-03 19:55:26,2008-08-03 19:55:26
daa6b38f352447a5afed3184f4ffffd0d6b1f1de...d4b8da2745203cf6969aedafb6d5e63b4b34815b,1,0,7,7,1,2008-08-03 21:01:25,2008-08-03 21:01:25
d4b8da2745203cf6969aedafb6d5e63b4b34815b...56d901edccc09603c2c0012a793f45dfba0ab3cd,1,9,8,17,5,2008-08-03 21:02:59,2008-08-03 21:02:59
56d901edccc09603c2c0012a793f45dfba0ab3cd...d0cdc188918c8235f63ff857b26aaea34984f23b,1,228,117,345,109,2008-08-04 10:01:21,2008-08-04 10:01:21
d0cdc188918c8235f63ff857b26aaea34984f23b...c622059f2daf496234a8086a4945f7c49e125126,2,50,105,155,64,2008-08-04 10:14:20,2008-08-04 10:14:20
c622059f2daf496234a8086a4945f7c49e125126...bf65fd0a8050891cf4155eef8dbbe3d364699748,1,1,1,2,1,2008-08-04 12:11:04,2008-08-04 12:11:04
bf65fd0a8050891cf4155eef8dbbe3d364699748...ac6952089061e3e160cd6ae4487840593ac95575,1,32,0,32,2,2008-08-04 19:29:33,2008-08-04 19:29:33
ac6952089061e3e160cd6ae4487840593ac95575...40cd41095538cbd52609f49c43e5deabc4508a9f,1,7,7,14,4,2008-08-04 19:37:47,2008-08-04 19:37:47
40cd41095538cbd52609f49c43e5deabc4508a9f...8be1a43093d12186d61ad8d1683509aaedcef2f9,1,5,0,5,1,2008-08-04 19:51:06,2008-08-04 19:51:06
8be1a43093d12186d61ad8d1683509aaedcef2f9...c768bc6f25a470f4b555f0f808e9a3b6b1f37066,2,6,8,14,3,2008-08-05 14:16:13,2008-08-05 14:16:13
c768bc6f25a470f4b555f0f808e9a3b6b1f37066...593810a5014ecaa28215839fb42f03df44a069d0,3,33,4,37,5,2008-08-05 16:13:28,2008-08-05 16:13:28
593810a5014ecaa28215839fb42f03df44a069d0...9b4ff7c1ad924de6f633f7c4f4b091b0fad8e7da,1,3,1,4,1,2008-08-05 16:14:23,2008-08-05 16:14:23
9b4ff7c1ad924de6f633f7c4f4b091b0fad8e7da...8e24b3761084618fa259f6499b1a9110d19a28c2,1,18,18,36,18,2008-08-05 16:36:20,2008-08-05 16:36:20
8e24b3761084618fa259f6499b1a9110d19a28c2...34008aaeb0fc62d782735ff62c745a658888521e,4,44,6,50,9,2008-08-05 17:38:49,2008-08-05 17:38:49
34008aaeb0fc62d782735ff62c745a658888521e...98d8acf33fb923b7c8f1694c15033ca86e655100,2,13,3,16,4,2008-08-05 17:43:05,2008-08-05 17:43:05
98d8acf33fb923b7c8f1694c15033ca86e655100...d0f57e7c7385a112cb9e19d314352fc5ed5b0747,1,3,1,4,2,2008-08-05 17:45:31,2008-08-05 17:45:31
d0f57e7c7385a112cb9e19d314352fc5ed5b0747...79e68c225b926302ebb29c808dda8afa49856f5c,163,14939,0,14939,135,2008-08-05 18:13:06,2008-08-05 18:13:06
79e68c225b926302ebb29c808dda8afa49856f5c...1f6d33586c75131fbb31bb5ea619036fd1ae0e37,1,1,1,2,1,2008-08-05 21:15:26,2008-08-05 21:15:26
1f6d33586c75131fbb31bb5ea619036fd1ae0e37...9f6ab8104c72d4b8f56ecc8280606cae959ae126,1,4,3,7,1,2008-08-05 23:52:03,2008-08-05 23:52:03
9f6ab8104c72d4b8f56ecc8280606cae959ae126...d06b474251c979c512a966a7fb41cd8a06487c14,1,12,12,24,2,2008-08-05 23:53:52,2008-08-05 23:53:52
d06b474251c979c512a966a7fb41cd8a06487c14...34a3bd52255a2253696b74b2d76133aace839fd2,33,369,837,1206,163,2008-08-06 15:32:46,2008-08-06 15:32:46
34a3bd52255a2253696b74b2d76133aace839fd2...b00e82fe2c0a907ce983b071ece07d261301db7e,3,219,216,435,5,2008-08-06 21:40:00,2008-08-06 21:40:00
b00e82fe2c0a907ce983b071ece07d261301db7e...c396992c7d1a3ce4d1075f71c77a61a7f65b8c63,3,67,64,131,40,2008-08-07 01:14:10,2008-08-07 01:14:10
c396992c7d1a3ce4d1075f71c77a61a7f65b8c63...7b4b1309d92feab417e48d391482f81e6ba683ee,1,1,1,2,1,2008-08-07 21:18:43,2008-08-07 21:18:43
7b4b1309d92feab417e48d391482f81e6ba683ee...196b2827759da3c80617418cbcdcb51f2d8ce1bc,2,147,0,147,4,2008-08-08 12:27:40,2008-08-08 12:27:40
196b2827759da3c80617418cbcdcb51f2d8ce1bc...9dfad9925718288bb81dbd6a50001767b6cc123d,2,23,6,29,7,2008-08-08 13:40:11,2008-08-08 13:40:11
9dfad9925718288bb81dbd6a50001767b6cc123d...567b9f2e28b36a8aff64833734a4fbb242798dee,1,2,2,4,2,2008-08-08 14:24:25,2008-08-08 14:24:25
567b9f2e28b36a8aff64833734a4fbb242798dee...44e407b7c6fbcd85307c6723ccd6fdd34946f821,2,7,7,14,6,2008-08-08 15:34:02,2008-08-08 15:34:02
44e407b7c6fbcd85307c6723ccd6fdd34946f821...90b6e1438fe95c915334ceb57c34f2fa19b91002,1,3,3,6,1,2008-08-08 15:40:31,2008-08-08 15:40:31
90b6e1438fe95c915334ceb57c34f2fa19b91002...169b8894868555345a6fbaa885d7034e8dd1a16e,1,6,6,12,5,2008-08-08 16:00:26,2008-08-08 16:00:26
169b8894868555345a6fbaa885d7034e8dd1a16e...afa98dba98e3ba7ccf77ec9ec41eb12b162ab76f,1,3,3,6,4,2008-08-08 16:03:49,2008-08-08 16:03:49
afa98dba98e3ba7ccf77ec9ec41eb12b162ab76f...3735f276603b0c040f3f8aaca64f151397d2cb9b,4,82,6,88,12,2008-08-08 16:41:55,2008-08-08 16:41:55
3735f276603b0c040f3f8aaca64f151397d2cb9b...be4390f834fa5061c0e3f9dde5b811f34fc1b2c4,1,46,21,67,6,2008-08-08 17:54:35,2008-08-08 17:54:35
be4390f834fa5061c0e3f9dde5b811f34fc1b2c4...ab8965c428ed4390c006c3375ba30595008fa525,3,63,56,119,54,2008-08-08 18:07:33,2008-08-08 18:07:33
ab8965c428ed4390c006c3375ba30595008fa525...34028f3ef3265f7af8ee550c3fee0f925e7b57ae,1,1,1,2,1,2008-08-08 18:33:02,2008-08-08 18:33:02
34028f3ef3265f7af8ee550c3fee0f925e7b57ae...176fabcc6fde81856f606b5ec44594f2a825a645,1,17,5,22,3,2008-08-08 18:48:18,2008-08-08 18:48:18
176fabcc6fde81856f606b5ec44594f2a825a645...5fb95990865beeb272691b445f9f1b47a469b55b,1,1,2,3,1,2008-08-08 18:51:34,2008-08-08 18:51:34
5fb95990865beeb272691b445f9f1b47a469b55b...5d199ba90113c47caf142e79151315ba2dc02b4b,6,58,16,74,14,2008-08-08 19:54:34,2008-08-08 19:54:34
5d199ba90113c47caf142e79151315ba2dc02b4b...6d4b14378639ea1e836f26f7ae1950368bc09260,1,1,1,2,1,2008-08-08 20:02:10,2008-08-08 20:02:10
6d4b14378639ea1e836f26f7ae1950368bc09260...32d5c39016f7f14dfc19142d78d944d92eb9cd70,2,12,0,12,2,2008-08-08 20:09:53,2008-08-08 20:09:53
32d5c39016f7f14dfc19142d78d944d92eb9cd70...c49eac7d4f64c374d19aa81f2c813a4b20e4cad7,3,8,8,16,8,2008-08-08 20:27:48,2008-08-08 20:27:48
c49eac7d4f64c374d19aa81f2c813a4b20e4cad7...7899568e01fc9c68afe995fa71de915dd9fcdd76,33,1586,458,2044,106,2008-08-08 20:59:02,2008-08-08 20:59:02
7899568e01fc9c68afe995fa71de915dd9fcdd76...660b9095577f53eab27bbfeec7c452bc0047a278,1,1,1,2,1,2008-08-08 21:19:59,2008-08-08 21:19:59
660b9095577f53eab27bbfeec7c452bc0047a278...19bbc74e46ddac5c5f5803182600bd44d310b24f,1,1,1,2,1,2008-08-08 21:24:02,2008-08-08 21:24:02
19bbc74e46ddac5c5f5803182600bd44d310b24f...1c9ca83db2a73e8eb920fb50a2f1ee9a8228bcbf,1,20,8,28,4,2008-08-08 21:27:03,2008-08-08 21:27:03
1c9ca83db2a73e8eb920fb50a2f1ee9a8228bcbf...84afcf5a02ea1b6c59b992c2557b5e07f211e217,1,1,1,2,1,2008-08-08 21:33:55,2008-08-08 21:33:55
84afcf5a02ea1b6c59b992c2557b5e07f211e217...6f6024751c26ef054fec23f05746640bb0fcc5d1,1,2,2,4,2,2008-08-08 21:57:25,2008-08-08 21:57:25
6f6024751c26ef054fec23f05746640bb0fcc5d1...2e01d59887b424e2b1674919cb7b31de6151f84f,1,141,0,141,1,2008-08-08 22:00:25,2008-08-08 22:00:25
2e01d59887b424e2b1674919cb7b31de6151f84f...438b816e41d5ebc684785a47390580a485a08ba3,1,1,1,2,1,2008-08-08 22:04:34,2008-08-08 22:04:34
438b816e41d5ebc684785a47390580a485a08ba3...097a19c3bfd50096b78b64e7dac7e95a5a7902c9,1,1,1,2,1,2008-08-08 22:05:36,2008-08-08 22:05:36
097a19c3bfd50096b78b64e7dac7e95a5a7902c9...b30ee21dc122c22d08e19e5a95d510688f105fa5,1,30,8,38,5,2008-08-08 22:36:17,2008-08-08 22:36:17
b30ee21dc122c22d08e19e5a95d510688f105fa5...618509335136478b547a5e719f3b66409edeebc2,1,1,1,2,1,2008-08-08 23:06:28,2008-08-08 23:06:28
618509335136478b547a5e719f3b66409edeebc2...6a06db0491e4f0fac989dd7e633226e1b927274e,1,1,1,2,1,2008-08-09 14:17:54,2008-08-09 14:17:54
6a06db0491e4f0fac989dd7e633226e1b927274e...750f5c8d464f79a5b502cf67b42e59196dc92742,2,2,2,4,2,2008-08-09 14:18:09,2008-08-09 14:18:09
750f5c8d464f79a5b502cf67b42e59196dc92742...99594011a219b455096814d74eb265508934dbb5,1,2,2,4,2,2008-08-09 14:40:51,2008-08-09 14:40:51
99594011a219b455096814d74eb265508934dbb5...e8f18643cf51d9ef22868d32060c8645b269d328,1,2,1,3,1,2008-08-09 15:04:45,2008-08-09 15:04:45
e8f18643cf51d9ef22868d32060c8645b269d328...752659037686026e85c2da52c756d4bfec8c4d13,2,144,71,215,27,2008-08-09 15:07:45,2008-08-09 15:07:45
752659037686026e85c2da52c756d4bfec8c4d13...88639e9b2ade62a0818e5446fbc205bf8ace4025,1,2,1,3,1,2008-08-09 15:11:11,2008-08-09 15:11:11
88639e9b2ade62a0818e5446fbc205bf8ace4025...be5350f2d5faaa737fd05baacf907910ca2e9f09,1,3,2,5,2,2008-08-09 15:16:47,2008-08-09 15:16:47
be5350f2d5faaa737fd05baacf907910ca2e9f09...69d8ff31ac89eea5aba926f335538a81092e470b,1,4,0,4,1,2008-08-09 15:38:44,2008-08-09 15:38:44
69d8ff31ac89eea5aba926f335538a81092e470b...88baf06c3d7334e39273c22bffa2f80db4d71d58,10,0,0,0,0,2008-08-09 15:53:50,2008-08-09 15:53:50
88baf06c3d7334e39273c22bffa2f80db4d71d58...6ba64896622213ce44ace2c605e4eaafed1e9fc5,1,118,46,164,17,2008-08-09 16:45:15,2008-08-09 16:45:15
6ba64896622213ce44ace2c605e4eaafed1e9fc5...f53e4d80b488d0e673182bb7565c97f081833f68,1,18,7,25,6,2008-08-09 17:12:48,2008-08-09 17:12:48
f53e4d80b488d0e673182bb7565c97f081833f68...dc14b29fb3e25299736dfb7dcac0c7e6c5b6126d,6,115,12,127,18,2008-08-09 17:19:23,2008-08-09 17:19:23
dc14b29fb3e25299736dfb7dcac0c7e6c5b6126d...c763f261731dffb71498af507987f9e5a3c7904c,3,8,2,10,8,2008-08-09 17:19:44,2008-08-09 17:19:44
c763f261731dffb71498af507987f9e5a3c7904c...342f9f0efbaf0ebf944f2a90956a3dcda59df1b5,1,0,3,3,1,2008-08-09 17:20:01,2008-08-09 17:20:01
342f9f0efbaf0ebf944f2a90956a3dcda59df1b5...400a6b23cf07b83b97f515cf23ee9ab5853f38bc,3,847,662,1509,409,2008-08-09 17:20:21,2008-08-09 17:20:21
400a6b23cf07b83b97f515cf23ee9ab5853f38bc...4747347385fa5c3a1e948a892fd5e60fb8f53bed,6,132,5,137,11,2008-08-09 17:35:19,2008-08-09 17:35:19
4747347385fa5c3a1e948a892fd5e60fb8f53bed...50e6928c5bcf03b7f18f26d3d9af50295a7bc46f,1,2,2,4,2,2008-08-09 18:06:51,2008-08-09 18:06:51
50e6928c5bcf03b7f18f26d3d9af50295a7bc46f...65be56816fc173f823566728ab78b72d061bb466,4,227,109,336,37,2008-08-09 20:52:40,2008-08-09 20:52:40
65be56816fc173f823566728ab78b72d061bb466...89a8990a7663946cb80e696e595cbfbe553cac97,2,22,22,44,6,2008-08-09 23:40:57,2008-08-09 23:40:57
89a8990a7663946cb80e696e595cbfbe553cac97...b5b129567e476f89faf3897da3481a29ca99d041,1,1,0,1,1,2008-08-09 23:56:34,2008-08-09 23:56:34
b5b129567e476f89faf3897da3481a29ca99d041...049d490875e8bcbc5977d4d63acff432a7ec824e,1,7,0,7,1,2008-08-09 23:59:01,2008-08-09 23:59:01
049d490875e8bcbc5977d4d63acff432a7ec824e...38dc472796eb4560d6408f4f2fd94298738794d1,2,4,1,5,3,2008-08-10 01:07:40,2008-08-10 01:07:40
38dc472796eb4560d6408f4f2fd94298738794d1...f6670e1341c6b01c5b24b9274aac05d026e536c5,8,20,9,29,12,2008-08-10 03:52:21,2008-08-10 03:52:21
f6670e1341c6b01c5b24b9274aac05d026e536c5...02cc59187be963b6c1ede084a7c9912ea6a1a338,5,199,11,210,11,2008-08-10 04:03:01,2008-08-10 04:03:01
02cc59187be963b6c1ede084a7c9912ea6a1a338...baac791c4b3482b7d5a4e8506bf03a61d411e563,1,6,6,12,7,2008-08-10 04:22:21,2008-08-10 04:22:21
baac791c4b3482b7d5a4e8506bf03a61d411e563...7610983bb24acd946865348a834163016cd8a513,1,1,1,2,1,2008-08-10 08:19:21,2008-08-10 08:19:21
7610983bb24acd946865348a834163016cd8a513...ec7d8b7c6147397fd689ee9538801bd0df59d73a,3,70,69,139,34,2008-08-10 08:42:49,2008-08-10 08:42:49
ec7d8b7c6147397fd689ee9538801bd0df59d73a...a7d3c9276770f6c47fd3511c2c5e292e1a439532,3,46,46,92,10,2008-08-10 09:43:48,2008-08-10 09:43:48
a7d3c9276770f6c47fd3511c2c5e292e1a439532...2e0859140300e0f8944d593900d14cfb3552ac84,1,2,2,4,2,2008-08-10 10:19:21,2008-08-10 10:19:21
2e0859140300e0f8944d593900d14cfb3552ac84...4ecc5f490a5c8a72dfab7b1fd00bdcfe782557ea,1,1,1,2,1,2008-08-10 12:29:47,2008-08-10 12:29:47
4ecc5f490a5c8a72dfab7b1fd00bdcfe782557ea...2845e43505067fb1cca2bca29a0cc817da034c0d,1,2,2,4,2,2008-08-10 12:41:42,2008-08-10 12:41:42
2845e43505067fb1cca2bca29a0cc817da034c0d...eb778986debb23b2dd292f7b6e764d5ea77a2219,2,7,7,14,7,2008-08-10 13:05:18,2008-08-10 13:05:18
eb778986debb23b2dd292f7b6e764d5ea77a2219...56f1f1fa9e9536667028ce637723bf45e319e7e3,4,294,282,576,150,2008-08-10 14:39:54,2008-08-10 14:39:54
56f1f1fa9e9536667028ce637723bf45e319e7e3...5b27c3604191eb5c69197abbb98904c643ff457c,2,10,7,17,4,2008-08-10 17:36:12,2008-08-10 17:36:12
5b27c3604191eb5c69197abbb98904c643ff457c...94e8f4fb358fe39a67456f23f92eacd6f83e302d,1,1,1,2,1,2008-08-10 18:17:20,2008-08-10 18:17:20
94e8f4fb358fe39a67456f23f92eacd6f83e302d...ef48a3e69c02438db32f20531f5c679e8315d528,17,81,821,902,80,2008-08-10 21:10:47,2008-08-10 21:10:47
ef48a3e69c02438db32f20531f5c679e8315d528...00bebaf0d1e6024c7a24a6132bf648c623290bfd,2,16,4,20,6,2008-08-11 04:28:33,2008-08-11 04:28:33
00bebaf0d1e6024c7a24a6132bf648c623290bfd...0b01d50076b7f512394b1cb581030ea736dbbc90,1,1,1,2,1,2008-08-11 04:30:30,2008-08-11 04:30:30
0b01d50076b7f512394b1cb581030ea736dbbc90...dd842ad34d1199093b7498514cd274279eb1e1ca,2,38,33,71,19,2008-08-11 04:31:55,2008-08-11 04:31:55
dd842ad34d1199093b7498514cd274279eb1e1ca...cec69eb70d1e2f84dc5a7fb172da88a79b0f5063,2,1,36,37,4,2008-08-11 04:33:27,2008-08-11 04:33:27
cec69eb70d1e2f84dc5a7fb172da88a79b0f5063...9dc4ba875f21d5690f6ad5995123a67a3c44bafe,43,1521,1416,2937,211,2008-08-11 12:11:25,2008-08-11 12:11:25
9dc4ba875f21d5690f6ad5995123a67a3c44bafe...3958c36319d5724d3478e1d8664a5aee4322c386,1,1,1,2,1,2008-08-11 13:11:25,2008-08-11 13:11:25
3958c36319d5724d3478e1d8664a5aee4322c386...4e5aa1b141af98beda9a32f42e55bc7426d4586b,0,0,0,0,0,2008-08-11 13:15:34,2008-08-11 13:15:34
4e5aa1b141af98beda9a32f42e55bc7426d4586b...12c7918a450db9ddc9538f9fd71d0aa9c7495588,1,16,16,32,14,2008-08-11 13:52:09,2008-08-11 13:52:09
12c7918a450db9ddc9538f9fd71d0aa9c7495588...222e7983bd2756159018e7f97c24225b338f06a7,1,2,1,3,2,2008-08-11 14:01:34,2008-08-11 14:01:34
222e7983bd2756159018e7f97c24225b338f06a7...97fd752fe73d644bc83ad4535c6f4b219c5e7bc7,5,0,0,0,0,2008-08-11 14:16:09,2008-08-11 14:16:09
97fd752fe73d644bc83ad4535c6f4b219c5e7bc7...f09f14d0ae42366606a20ab8b1570c7f4e22dc49,1,6,3,9,3,2008-08-11 15:13:00,2008-08-11 15:13:00
f09f14d0ae42366606a20ab8b1570c7f4e22dc49...5d837afe239d49f075912292c4ab6a05a7a8dcdc,2,11,1,12,2,2008-08-11 15:24:44,2008-08-11 15:24:44
5d837afe239d49f075912292c4ab6a05a7a8dcdc...c17c8ddecc5902e3069ab5fc607933463debc538,2,30,25,55,11,2008-08-11 15:24:46,2008-08-11 15:24:46
c17c8ddecc5902e3069ab5fc607933463debc538...ab1a442a01eb3ee1ca210cd689c9b578d31d7366,1,1,1,2,1,2008-08-11 15:54:42,2008-08-11 15:54:42
ab1a442a01eb3ee1ca210cd689c9b578d31d7366...58cd4902a71a3695dd6c21dc957f59c333db364c,4,92,30,122,10,2008-08-11 16:51:18,2008-08-11 16:51:18
58cd4902a71a3695dd6c21dc957f59c333db364c...8ad96b4d29da98d47df010d864bbab7e8f83a045,2,23,26,49,13,2008-08-11 17:20:47,2008-08-11 17:20:47
8ad96b4d29da98d47df010d864bbab7e8f83a045...161390390639bc6166a0d5f1e0f4c66952737a0b,2,2,3,5,3,2008-08-11 17:54:44,2008-08-11 17:54:44
161390390639bc6166a0d5f1e0f4c66952737a0b...efaa891b1f17a3224bb910047c0da4e0e2a1b255,1,6,1,7,1,2008-08-11 19:13:57,2008-08-11 19:13:57
efaa891b1f17a3224bb910047c0da4e0e2a1b255...899ca54fe2a289bee4dfbed9f5ef6fc9024def72,6,85,17,102,13,2008-08-11 20:49:19,2008-08-11 20:49:19
899ca54fe2a289bee4dfbed9f5ef6fc9024def72...942e5246accda3d953b4634a010402ef5786c2e0,5,350,145,495,31,2008-08-11 22:22:26,2008-08-11 22:22:26
942e5246accda3d953b4634a010402ef5786c2e0...54c313af601b07d8fbf2a7a3f24524bf6bd4ed8d,1,7,0,7,2,2008-08-11 23:40:34,2008-08-11 23:40:34
54c313af601b07d8fbf2a7a3f24524bf6bd4ed8d...e73bf2bdd9a6342e8bf10c78ca94415e02cb8838,1,6,0,6,1,2008-08-12 02:15:00,2008-08-12 02:15:00
e73bf2bdd9a6342e8bf10c78ca94415e02cb8838...220993bcc52e78520d8e6cc8aa022608eac10b2a,7,98,22,120,25,2008-08-12 05:34:56,2008-08-12 05:34:56
220993bcc52e78520d8e6cc8aa022608eac10b2a...3eb80748087004608ead65834a766d257e9edfc9,2,14,2,16,7,2008-08-12 05:59:43,2008-08-12 05:59:43
3eb80748087004608ead65834a766d257e9edfc9...97da73a98cfe5e5545b7d997e6078c8571115a76,2,1,1,2,1,2008-08-12 06:29:01,2008-08-12 06:29:01
97da73a98cfe5e5545b7d997e6078c8571115a76...6bebb23318c5a2195a89a7154118cfc5ea19bba7,3,32,0,32,5,2008-08-12 06:31:29,2008-08-12 06:31:29
6bebb23318c5a2195a89a7154118cfc5ea19bba7...ca71eacdf431c341a799c424328db835a949891e,1,10,3,13,4,2008-08-12 07:52:17,2008-08-12 07:52:17
ca71eacdf431c341a799c424328db835a949891e...6294fc7179011847d8a9f906cf4939ebf9852265,3,15,8,23,4,2008-08-12 07:52:33,2008-08-12 07:52:33
6294fc7179011847d8a9f906cf4939ebf9852265...dd970bfbfd3bd9a4954ae3bc0879842198903742,1,0,102,102,1,2008-08-12 11:51:07,2008-08-12 11:51:07
dd970bfbfd3bd9a4954ae3bc0879842198903742...63ea57642dd980ff07627964efd445986bc9fe58,5,201,9,210,13,2008-08-12 12:58:33,2008-08-12 12:58:33
63ea57642dd980ff07627964efd445986bc9fe58...d7503c5a7a8e239dd5d32e1df803a113f8049263,0,0,0,0,0,2008-08-12 13:01:17,2008-08-12 13:01:17
d7503c5a7a8e239dd5d32e1df803a113f8049263...05ef002048d88b8c2bcf643694ab9349c818b464,1,7,1,8,2,2008-08-12 13:39:46,2008-08-12 13:39:46
05ef002048d88b8c2bcf643694ab9349c818b464...c4d07d4d5026316c7ff46edd894e585e7406e1a9,1,1,1,2,1,2008-08-12 13:41:40,2008-08-12 13:41:40
c4d07d4d5026316c7ff46edd894e585e7406e1a9...1697f4e49f782f6d793911ba7d24da6e0dac485e,19,65,60,125,32,2008-08-12 14:15:38,2008-08-12 14:15:38
1697f4e49f782f6d793911ba7d24da6e0dac485e...ec2ee4fc62212f9c58cfa28884c1d894fa15b23d,1,1,1,2,1,2008-08-12 14:19:32,2008-08-12 14:19:32
ec2ee4fc62212f9c58cfa28884c1d894fa15b23d...e42748dbf5dcf2d67fe48cc10d0594d03604dd0a,1,1,1,2,1,2008-08-12 15:07:48,2008-08-12 15:07:48
e42748dbf5dcf2d67fe48cc10d0594d03604dd0a...bb5a35cc5424090b4e759aa3c91fee2027359dc4,1,28,25,53,23,2008-08-12 16:06:55,2008-08-12 16:06:55
bb5a35cc5424090b4e759aa3c91fee2027359dc4...a14f41f34543bc81c10b4660500dd8ee22aee1b3,1,9,3,12,2,2008-08-12 16:28:52,2008-08-12 16:28:52
a14f41f34543bc81c10b4660500dd8ee22aee1b3...ca020a5edd5ba3e6f1d1eb4d2a0d9c622011ab2f,1,24,22,46,20,2008-08-12 18:49:44,2008-08-12 18:49:44
ca020a5edd5ba3e6f1d1eb4d2a0d9c622011ab2f...d05c7253084ea73dfd734099455f3d8964d4cf25,2,19,5,24,5,2008-08-12 22:12:14,2008-08-12 22:12:14
d05c7253084ea73dfd734099455f3d8964d4cf25...3d1795d87a74e2ab5f2bee5bb71a856a809be4f7,1,2,2,4,2,2008-08-12 23:22:26,2008-08-12 23:22:26
3d1795d87a74e2ab5f2bee5bb71a856a809be4f7...bfac0b738595962bb43f76e9d59cfbea85ca37db,1,6,0,6,4,2008-08-12 23:29:09,2008-08-12 23:29:09
bfac0b738595962bb43f76e9d59cfbea85ca37db...bb308054529ad01c079bdaedfb41a85eb5ae97a9,1,4,3,7,4,2008-08-12 23:31:31,2008-08-12 23:31:31
bb308054529ad01c079bdaedfb41a85eb5ae97a9...cb1368bbc6d487a60986891edbe8cada3778ada3,1,4,5,9,1,2008-08-12 23:34:45,2008-08-12 23:34:45
cb1368bbc6d487a60986891edbe8cada3778ada3...4edbb8b2caadd8bfb794846e231de18c7ec5b115,1,21,10,31,6,2008-08-13 14:36:40,2008-08-13 14:36:40
4edbb8b2caadd8bfb794846e231de18c7ec5b115...9c4379d1a6a5e82581a12e9c9749ab2bda12738a,2,4,0,4,1,2008-08-13 18:19:09,2008-08-13 18:19:09
9c4379d1a6a5e82581a12e9c9749ab2bda12738a...029ec918b1c6caf620d210842f426e6f9dbc2905,2,17,10,27,4,2008-08-13 18:21:37,2008-08-13 18:21:37
029ec918b1c6caf620d210842f426e6f9dbc2905...81fba12daa7ef0260e1ac83a1b5e550ab53e26af,2,1125,948,2073,586,2008-08-13 18:31:28,2008-08-13 18:31:28
81fba12daa7ef0260e1ac83a1b5e550ab53e26af...af7b6475ca6ab12df6b91beae1bb5b1c29a5782b,4,111,36,147,21,2008-08-14 03:57:18,2008-08-14 03:57:18
af7b6475ca6ab12df6b91beae1bb5b1c29a5782b...31ec68c5d939ee63852709163750a0516aaa2619,3,16,2,18,4,2008-08-14 03:57:30,2008-08-14 03:57:30
31ec68c5d939ee63852709163750a0516aaa2619...5e8efa9a6032f9c4278199ab354c3ff742387263,6,69,5,74,10,2008-08-14 03:57:46,2008-08-14 03:57:46
5e8efa9a6032f9c4278199ab354c3ff742387263...97a7dab2b19b87652bc15c5db4cb06cd7011fe4d,3,21,11,32,6,2008-08-14 03:58:00,2008-08-14 03:58:00
97a7dab2b19b87652bc15c5db4cb06cd7011fe4d...9d83444f16c7e289881dca132c5f4f3f8e58d05c,1,4,1,5,2,2008-08-14 03:58:09,2008-08-14 03:58:09
9d83444f16c7e289881dca132c5f4f3f8e58d05c...4adf048a5165d0b6c01310b2a80d68b97a2fa610,2,31,32,63,25,2008-08-14 04:29:02,2008-08-14 04:29:02
4adf048a5165d0b6c01310b2a80d68b97a2fa610...2da6628519be25c3eeb2a4d20edc29a30d9546e1,1,3,3,6,3,2008-08-14 13:54:22,2008-08-14 13:54:22
2da6628519be25c3eeb2a4d20edc29a30d9546e1...29a9c34c655de418a945aa02295425081d52a024,1,11,90,101,7,2008-08-14 14:43:29,2008-08-14 14:43:29
29a9c34c655de418a945aa02295425081d52a024...788de6b5fdef05c1f321868db964ffe31949fbac,5,4,231,235,7,2008-08-14 15:37:43,2008-08-14 15:37:43
788de6b5fdef05c1f321868db964ffe31949fbac...f9301fa8f42b0a4619cc8c1b4d9e3e9628b6b2d2,1,0,4,4,1,2008-08-14 15:41:38,2008-08-14 15:41:38
f9301fa8f42b0a4619cc8c1b4d9e3e9628b6b2d2...9b66eae75f037c5f22eb94b33a8328015d0ec9c2,4,92,92,184,92,2008-08-14 16:45:08,2008-08-14 16:45:08
9b66eae75f037c5f22eb94b33a8328015d0ec9c2...9e423b51e325c9226e2f744bfa52336a626bf63a,5,23,6,29,9,2008-08-14 19:43:08,2008-08-14 19:43:08
9e423b51e325c9226e2f744bfa52336a626bf63a...b2ec6473c09bcad88194cfb52252c44ed7e960aa,3,100,39,139,14,2008-08-14 20:12:19,2008-08-14 20:12:19
b2ec6473c09bcad88194cfb52252c44ed7e960aa...dd0e5fd992986211bdb52b2cdfbd1e232788a20b,1,4,2,6,3,2008-08-14 20:51:40,2008-08-14 20:51:40
dd0e5fd992986211bdb52b2cdfbd1e232788a20b...21029678078b8f69ff438ea9ed5a9a9359b05b2e,2,3,2,5,2,2008-08-14 21:03:44,2008-08-14 21:03:44
21029678078b8f69ff438ea9ed5a9a9359b05b2e...fcc42c1bf7277279bd576cd335f45b998251610f,1,1,1,2,1,2008-08-15 01:33:18,2008-08-15 01:33:18
fcc42c1bf7277279bd576cd335f45b998251610f...59ce2aaeb668a156ed4b99cf7f065299cef31029,1,1,1,2,1,2008-08-15 02:26:50,2008-08-15 02:26:50
59ce2aaeb668a156ed4b99cf7f065299cef31029...9223f063c8c175b1a7c2e1739389c6db36392e82,1,3,0,3,1,2008-08-15 03:36:18,2008-08-15 03:36:18
9223f063c8c175b1a7c2e1739389c6db36392e82...3dc745918b24307324ecdc739032270a4969924f,1,159,0,159,1,2008-08-15 03:56:48,2008-08-15 03:56:48
3dc745918b24307324ecdc739032270a4969924f...c3af31c84dfb4233fe1f6ac56f9c07294602db26,1,1,1,2,1,2008-08-15 03:58:35,2008-08-15 03:58:35
c3af31c84dfb4233fe1f6ac56f9c07294602db26...002ab38636c4c62ae9e54685267fdcda5728dcde,1,1,1,2,1,2008-08-15 03:59:32,2008-08-15 03:59:32
002ab38636c4c62ae9e54685267fdcda5728dcde...5f373b380b981b80309352bf9d080e748deef3b8,1,1,1,2,1,2008-08-15 03:59:46,2008-08-15 03:59:46
5f373b380b981b80309352bf9d080e748deef3b8...8683468007966d79f8839b485541eb3f090ac1c4,1,1,1,2,1,2008-08-15 04:14:26,2008-08-15 04:14:26
8683468007966d79f8839b485541eb3f090ac1c4...1691c22821edf906da95e6c4d261b5a05c5c181d,1,1,1,2,1,2008-08-15 07:35:47,2008-08-15 07:35:47
1691c22821edf906da95e6c4d261b5a05c5c181d...7eb44e32dc451f4ba3cad780f7e68d148f8ee661,1,5,1,6,2,2008-08-15 07:55:41,2008-08-15 07:55:41
7eb44e32dc451f4ba3cad780f7e68d148f8ee661...ece6e166e2a53b931d2dad04dab555d2b346a364,1,2,2,4,1,2008-08-15 08:48:06,2008-08-15 08:48:06
ece6e166e2a53b931d2dad04dab555d2b346a364...e149bee93ef45675e9ef88e6926041fc9c898c45,1,1,1,2,1,2008-08-15 11:50:22,2008-08-15 11:50:22
e149bee93ef45675e9ef88e6926041fc9c898c45...b92b1791e9332f39905d5d35a74fc6d0f6fbc170,1,1,1,2,1,2008-08-15 11:52:18,2008-08-15 11:52:18
b92b1791e9332f39905d5d35a74fc6d0f6fbc170...188f131813d9ac37600d6b10804428ca1005290b,1,1,1,2,1,2008-08-15 11:53:20,2008-08-15 11:53:20
188f131813d9ac37600d6b10804428ca1005290b...0c115f12d742429ca32b4bcce787873eda4ffccc,1,24,7,31,6,2008-08-15 11:53:49,2008-08-15 11:53:49
0c115f12d742429ca32b4bcce787873eda4ffccc...d8bfabe98d31299bfa24f71af47377495f360dae,1,9,0,9,1,2008-08-15 12:02:24,2008-08-15 12:02:24
d8bfabe98d31299bfa24f71af47377495f360dae...50b548d01b348768c6d9a2a7629103dec5952c66,4,46,2,48,4,2008-08-15 12:08:29,2008-08-15 12:08:29
50b548d01b348768c6d9a2a7629103dec5952c66...57aa1fd351d73feee947837d5dce5cfcb07af48e,1,3,3,6,1,2008-08-15 12:12:29,2008-08-15 12:12:29
57aa1fd351d73feee947837d5dce5cfcb07af48e...6564bfec85616869b933994a2eda3be87f661db2,1,6,2,8,1,2008-08-15 12:16:10,2008-08-15 12:16:10
6564bfec85616869b933994a2eda3be87f661db2...6eb0dea21cab7885b713578955c9d3849f7eb1d3,4,687,491,1178,246,2008-08-15 12:42:57,2008-08-15 12:42:57
6eb0dea21cab7885b713578955c9d3849f7eb1d3...06ea872b20e466127451c0d7b12587a72cd2f523,1,11,2,13,3,2008-08-15 13:16:16,2008-08-15 13:16:16
06ea872b20e466127451c0d7b12587a72cd2f523...a44439e880b75b57c26d4a907b83a4433268e4b4,1,3,3,6,2,2008-08-15 13:44:43,2008-08-15 13:44:43
a44439e880b75b57c26d4a907b83a4433268e4b4...01dd602150342e0c74ea4af47060e9bd92037e29,1,5,4,9,3,2008-08-15 14:17:24,2008-08-15 14:17:24
01dd602150342e0c74ea4af47060e9bd92037e29...4881a4ffb04bf8a63a604525976ea555772fe38d,1,4,4,8,4,2008-08-15 14:58:47,2008-08-15 14:58:47
4881a4ffb04bf8a63a604525976ea555772fe38d...93462f95167db14e17df2abeafc1abb1203f34ac,1,0,12,12,1,2008-08-15 14:58:59,2008-08-15 14:58:59
93462f95167db14e17df2abeafc1abb1203f34ac...0d48087a53c84eb109f6c85472530899dfc94fc8,4,11,1,12,4,2008-08-15 14:59:11,2008-08-15 14:59:11
0d48087a53c84eb109f6c85472530899dfc94fc8...90c67e0f55800ec3ffbb05c5e90c28ccfa9234d4,1,1,1,2,1,2008-08-15 16:38:41,2008-08-15 16:38:41
90c67e0f55800ec3ffbb05c5e90c28ccfa9234d4...415bf3efb3bac1f14efc77d5bdea7a4fddef03de,1,2,0,2,2,2008-08-15 17:10:14,2008-08-15 17:10:14
415bf3efb3bac1f14efc77d5bdea7a4fddef03de...f586c0b039170f0351832d8c57cce3bf7f4772fb,1,1,2,3,2,2008-08-15 17:36:33,2008-08-15 17:36:33
f586c0b039170f0351832d8c57cce3bf7f4772fb...d7467a0bfcc540821193c6cadd6d59a0eac1141e,4,37,15,52,5,2008-08-15 17:38:39,2008-08-15 17:38:39
d7467a0bfcc540821193c6cadd6d59a0eac1141e...3bb50169d9db125d818dde89428de5d4bfc030f1,1,1,7,8,7,2008-08-15 17:42:13,2008-08-15 17:42:13
3bb50169d9db125d818dde89428de5d4bfc030f1...c0d862d63882317c8e2e91f7138b6e533294762a,1,10,10,20,7,2008-08-15 17:47:03,2008-08-15 17:47:03
c0d862d63882317c8e2e91f7138b6e533294762a...417a4d66df25510afc20243678358c52d77287f7,2,2,2,4,2,2008-08-15 19:15:20,2008-08-15 19:15:20
417a4d66df25510afc20243678358c52d77287f7...4cfa5afcc7dd83499b9a5b277566f6f78593a35b,2,346,272,618,160,2008-08-15 19:33:49,2008-08-15 19:33:49
4cfa5afcc7dd83499b9a5b277566f6f78593a35b...9d1ec0b5ec98188e88c8087ca3fd94302cb9d778,1,1,1,2,1,2008-08-15 19:51:45,2008-08-15 19:51:45
9d1ec0b5ec98188e88c8087ca3fd94302cb9d778...727133109cfb37d73da38d760198eb300125ddb0,2,42,5,47,4,2008-08-15 20:09:47,2008-08-15 20:09:47
727133109cfb37d73da38d760198eb300125ddb0...0ca738363afafacf1a82c978b2a2d1e00d9495a8,1,2,0,2,1,2008-08-15 20:33:45,2008-08-15 20:33:45
0ca738363afafacf1a82c978b2a2d1e00d9495a8...6d863fef8a992ef28b081e9fa6043e4a9799e965,2,14,5,19,4,2008-08-15 21:08:11,2008-08-15 21:08:11
6d863fef8a992ef28b081e9fa6043e4a9799e965...6a71c768bc3f3eef34f9fe12cc7a2fa0f1cc05ab,1,1,1,2,1,2008-08-15 21:14:22,2008-08-15 21:14:22
6a71c768bc3f3eef34f9fe12cc7a2fa0f1cc05ab...8edb4f97c749bc21846f058d2bf4137893bce481,1,11,3,14,2,2008-08-15 21:37:34,2008-08-15 21:37:34
8edb4f97c749bc21846f058d2bf4137893bce481...f67fb604ea4cebe2dcc2b3bc8d017bdae546a7a5,1,20,7,27,4,2008-08-15 21:57:36,2008-08-15 21:57:36
f67fb604ea4cebe2dcc2b3bc8d017bdae546a7a5...3b45a40c54993a36e2e56448326553e46a1b40d7,1,12,12,24,12,2008-08-15 22:13:50,2008-08-15 22:13:50
3b45a40c54993a36e2e56448326553e46a1b40d7...ddc156bca2519dfb60974f49d085826d0a778f77,2,11,1,12,2,2008-08-15 23:29:55,2008-08-15 23:29:55
ddc156bca2519dfb60974f49d085826d0a778f77...2b82a3bcfc757c2bdafca6c5d9930201deed00cf,2,10,0,10,2,2008-08-16 02:17:55,2008-08-16 02:17:55
2b82a3bcfc757c2bdafca6c5d9930201deed00cf...fc2c03b55cf0a52ba4236f75acb08146283a1062,1,13,20,33,9,2008-08-16 02:29:10,2008-08-16 02:29:10
fc2c03b55cf0a52ba4236f75acb08146283a1062...0345fec71bb8f9ff9ff460a63e5cc0640cc06a76,1,0,2,2,1,2008-08-16 04:11:38,2008-08-16 04:11:38
0345fec71bb8f9ff9ff460a63e5cc0640cc06a76...7299b397527c8774824f28db28a95803f1895583,1,1,2,3,1,2008-08-16 04:48:57,2008-08-16 04:48:57
7299b397527c8774824f28db28a95803f1895583...eab705f6234e035b676fb02a70a9a3812d23351d,1,1,1,2,1,2008-08-16 04:51:21,2008-08-16 04:51:21
eab705f6234e035b676fb02a70a9a3812d23351d...77c949289e8cc93df47997c44b8710217996cf63,1,11,4,15,5,2008-08-16 05:03:40,2008-08-16 05:03:40
77c949289e8cc93df47997c44b8710217996cf63...cbcc4159342288f6866f2006c30dd16740703049,2,4,2,6,3,2008-08-16 07:00:30,2008-08-16 07:00:30
cbcc4159342288f6866f2006c30dd16740703049...ceb8fc56af635445cf985eeb60e14a8763dd56cb,1,9,0,9,1,2008-08-16 10:17:46,2008-08-16 10:17:46
ceb8fc56af635445cf985eeb60e14a8763dd56cb...3afa4a462691b537b38222c9869c997a0ff04a21,1,2,1,3,2,2008-08-16 12:33:36,2008-08-16 12:33:36
3afa4a462691b537b38222c9869c997a0ff04a21...df284da44f9f4d1f7e225a4ffa5b3a0c2efdec02,1,1,1,2,1,2008-08-16 14:35:17,2008-08-16 14:35:17
df284da44f9f4d1f7e225a4ffa5b3a0c2efdec02...6bcb4935f290ed4caee9cbb0e99c3870d2cb5103,1,4,2,6,1,2008-08-16 14:41:28,2008-08-16 14:41:28
6bcb4935f290ed4caee9cbb0e99c3870d2cb5103...54f9a987137d649899cfc65c87eb8baf8308dc09,2,5,0,5,5,2008-08-16 15:54:36,2008-08-16 15:54:36
54f9a987137d649899cfc65c87eb8baf8308dc09...844089de076e357f6b62d75099a5bd21bf7c94e5,1,4,1,5,1,2008-08-16 15:58:30,2008-08-16 15:58:30
844089de076e357f6b62d75099a5bd21bf7c94e5...4dece4fba1d8357cf9e4887486d6768e4dc49ca6,2,434,299,733,181,2008-08-16 17:22:02,2008-08-16 17:22:02
4dece4fba1d8357cf9e4887486d6768e4dc49ca6...c127f0117d75220e346625cd8a009fb6a317ece1,2,7,1,8,2,2008-08-16 20:40:00,2008-08-16 20:40:00
c127f0117d75220e346625cd8a009fb6a317ece1...a2be52fd2a27b5a39744939c906cd57507aa8f10,9,333,11,344,21,2008-08-16 20:40:47,2008-08-16 20:40:47
a2be52fd2a27b5a39744939c906cd57507aa8f10...a949f9ec7d8bdd348f628c2d579f4cc633c56e56,3,108,0,108,3,2008-08-16 20:59:06,2008-08-16 20:59:06
a949f9ec7d8bdd348f628c2d579f4cc633c56e56...7c6071861e6402be75dd6bcfe155a16799e01eba,1,7,8,15,2,2008-08-16 22:25:20,2008-08-16 22:25:20
7c6071861e6402be75dd6bcfe155a16799e01eba...f505bd6e415fc771c920b19432dd10941a743097,1,10,0,10,1,2008-08-16 22:44:42,2008-08-16 22:44:42
f505bd6e415fc771c920b19432dd10941a743097...2d2396a3841d56243e9caab39fdb57dead17f5c4,2,12,0,12,3,2008-08-16 23:35:58,2008-08-16 23:35:58
2d2396a3841d56243e9caab39fdb57dead17f5c4...260510453f25c0ab00254a9efdd7bea35ecdcee6,1,2,4,6,1,2008-08-17 00:07:06,2008-08-17 00:07:06
260510453f25c0ab00254a9efdd7bea35ecdcee6...15f8b4cde07199bc6d14402b0a4b417d20a227e5,1,1,1,2,1,2008-08-17 04:27:36,2008-08-17 04:27:36
15f8b4cde07199bc6d14402b0a4b417d20a227e5...219304019bff8360d802fa658757594fbc1a4155,1,8,7,15,1,2008-08-17 05:16:16,2008-08-17 05:16:16
219304019bff8360d802fa658757594fbc1a4155...4ecdbc52afe00ef996b25a5066519d0a700ef25a,1,0,2,2,1,2008-08-17 05:19:40,2008-08-17 05:19:40
4ecdbc52afe00ef996b25a5066519d0a700ef25a...a80a5ae46f0a34d73c381f425ba3aa68709ae03b,1,1,0,1,1,2008-08-17 05:43:34,2008-08-17 05:43:34
a80a5ae46f0a34d73c381f425ba3aa68709ae03b...98be84154942789e498d8717c8d25f378ca456b1,1,4,1,5,1,2008-08-17 17:32:31,2008-08-17 17:32:31
98be84154942789e498d8717c8d25f378ca456b1...c92b424e5766c0d5b883b59ea3329d84e54b3c9a,1,3,3,6,3,2008-08-17 17:35:33,2008-08-17 17:35:33
c92b424e5766c0d5b883b59ea3329d84e54b3c9a...2c4b13cbe7477a7f94f11fa23e39033b005a3b88,3,60,16,76,13,2008-08-17 20:07:59,2008-08-17 20:07:59
2c4b13cbe7477a7f94f11fa23e39033b005a3b88...e3ea9ddef56fc8b7122209fec0fcca1ecd609092,1,8,0,8,1,2008-08-17 20:18:52,2008-08-17 20:18:52
e3ea9ddef56fc8b7122209fec0fcca1ecd609092...b25d759bed2d72982cf12f59c38dc3438e330da1,1,34,37,71,19,2008-08-17 21:09:28,2008-08-17 21:09:28
b25d759bed2d72982cf12f59c38dc3438e330da1...556fbc78a636d2be5c66a4393361476a6de091bc,2,15,1,16,3,2008-08-17 22:38:36,2008-08-17 22:38:36
556fbc78a636d2be5c66a4393361476a6de091bc...e6780acaf2c85a0aaf9f717a811eee46cf4475b9,2,395,395,790,387,2008-08-17 22:46:51,2008-08-17 22:46:51
e6780acaf2c85a0aaf9f717a811eee46cf4475b9...aeb7639951944c3a4cceb1d9598fa19dc8aaa5ea,1,1,1,2,1,2008-08-18 02:59:25,2008-08-18 02:59:25
aeb7639951944c3a4cceb1d9598fa19dc8aaa5ea...ee7a5cdd7d98c36f37e99ae40bd97d67dd091f32,1,1,1,2,1,2008-08-18 13:52:26,2008-08-18 13:52:26
ee7a5cdd7d98c36f37e99ae40bd97d67dd091f32...62aafd8e3001b502bf7ee15ada53c6d440524a5d,3,161,154,315,11,2008-08-18 15:49:58,2008-08-18 15:49:58
62aafd8e3001b502bf7ee15ada53c6d440524a5d...463b325cb6bf1b5bb9867b299a1b4760d7e3bbb5,2,99,61,160,18,2008-08-18 15:58:29,2008-08-18 15:58:29
463b325cb6bf1b5bb9867b299a1b4760d7e3bbb5...c1e44b92f38bca37042324e2b52e54e10d8a73cd,4,550,498,1048,380,2008-08-18 23:32:51,2008-08-18 23:32:51
c1e44b92f38bca37042324e2b52e54e10d8a73cd...7fecbe42a8094a312e55a81f1b1a44077d7b533e,2,218,215,433,115,2008-08-19 02:42:29,2008-08-19 02:42:29
7fecbe42a8094a312e55a81f1b1a44077d7b533e...da9b5b11587270d0ec603d8aebe0801bc199317d,4,78,70,148,63,2008-08-19 05:39:25,2008-08-19 05:39:25
da9b5b11587270d0ec603d8aebe0801bc199317d...32c68603252b6736e215c9dddf6b8c3b24b9650b,2,241,178,419,186,2008-08-19 13:35:35,2008-08-19 13:35:35
32c68603252b6736e215c9dddf6b8c3b24b9650b...40ba2ecea1f7fece4ca7cbdcac935d40da84bcc8,5,3876,1302,5178,432,2008-08-19 13:46:19,2008-08-19 13:46:19
40ba2ecea1f7fece4ca7cbdcac935d40da84bcc8...a0c3677eee544a304382a03df054aea75bda53c9,2,353,289,642,173,2008-08-19 13:47:53,2008-08-19 13:47:53
a0c3677eee544a304382a03df054aea75bda53c9...c0727ad43d5c985f06d19356df05ddada8db9953,4,3251,2185,5436,669,2008-08-19 13:51:12,2008-08-19 13:51:12
c0727ad43d5c985f06d19356df05ddada8db9953...f748fa27629b8824d30866e4687bb91c264dfb65,3,22,5,27,8,2008-08-19 14:17:24,2008-08-19 14:17:24
f748fa27629b8824d30866e4687bb91c264dfb65...ba937e55aeb1328458f1e16f9bca4137512a6fec,1,1,1,2,1,2008-08-19 20:27:41,2008-08-19 20:27:41
ba937e55aeb1328458f1e16f9bca4137512a6fec...e7769c36e9a95312879e74c2dd32695d3165037b,1,3,1,4,1,2008-08-19 20:35:56,2008-08-19 20:35:56
e7769c36e9a95312879e74c2dd32695d3165037b...db76b1e89dc621f9a926cd391326cc1e9f1325db,1,38,54,92,2,2008-08-19 23:04:34,2008-08-19 23:04:34
db76b1e89dc621f9a926cd391326cc1e9f1325db...cae5e6e6a5e806a03e4092369872298d6d54b363,4,2885,974,3859,504,2008-08-20 07:34:05,2008-08-20 07:34:05
cae5e6e6a5e806a03e4092369872298d6d54b363...144e1fdbba8b62615c07d1ccee07fd6fbe6728ff,2,24,51,75,25,2008-08-20 08:30:50,2008-08-20 08:30:50
144e1fdbba8b62615c07d1ccee07fd6fbe6728ff...32ed714b5b238d302fe40c8088d691dc5da1dae5,4,3377,1870,5247,649,2008-08-20 12:17:57,2008-08-20 12:17:57
32ed714b5b238d302fe40c8088d691dc5da1dae5...5608dfabc3572ddc4050321472b34524223f492d,1,1,1,2,1,2008-08-20 15:56:07,2008-08-20 15:56:07
5608dfabc3572ddc4050321472b34524223f492d...e94d29350446df6a87e0fd2b867a47e06295ae98,3,27,15,42,6,2008-08-20 18:50:06,2008-08-20 18:50:06
e94d29350446df6a87e0fd2b867a47e06295ae98...eb85af18652f4096b6abbad8915a554b4d51865e,1,1,0,1,1,2008-08-20 21:12:45,2008-08-20 21:12:45
eb85af18652f4096b6abbad8915a554b4d51865e...b9407b26dff47232d57133d93593a1a50eee1cc5,4,31,11,42,6,2008-08-20 22:38:15,2008-08-20 22:38:15
b9407b26dff47232d57133d93593a1a50eee1cc5...1e1f7c58bc90b583525e3b139c2fed6de362c332,2,3,3,6,3,2008-08-21 01:32:18,2008-08-21 01:32:18
1e1f7c58bc90b583525e3b139c2fed6de362c332...d05d724165413c923de9094e3ecf5dd652f6c0c5,2,2,2,4,2,2008-08-21 01:40:22,2008-08-21 01:40:22
d05d724165413c923de9094e3ecf5dd652f6c0c5...2f7d62439153b97033960141518b6b8cf1512756,3,821,663,1484,360,2008-08-21 07:28:21,2008-08-21 07:28:21
2f7d62439153b97033960141518b6b8cf1512756...c8c159cbbad71deb4d13d6b4e10d4f38817ebdc4,3,48,4,52,5,2008-08-21 13:54:53,2008-08-21 13:54:53
c8c159cbbad71deb4d13d6b4e10d4f38817ebdc4...f2477b6450afb99b5c34c54cfd121ddfbabc904e,2,41,15,56,7,2008-08-21 13:55:21,2008-08-21 13:55:21
f2477b6450afb99b5c34c54cfd121ddfbabc904e...2b7ef577c391bb89dc7e0f09bfceb618e8b16955,1,0,2,2,2,2008-08-21 14:45:51,2008-08-21 14:45:51
2b7ef577c391bb89dc7e0f09bfceb618e8b16955...5d2e4752d28702c41ac6fe6be916015486916b64,2,1124,1079,2203,770,2008-08-21 15:08:41,2008-08-21 15:08:41
5d2e4752d28702c41ac6fe6be916015486916b64...462ee405fb646ee40d07e4d055b308bd1a835644,2,3,3,6,3,2008-08-21 15:13:52,2008-08-21 15:13:52
462ee405fb646ee40d07e4d055b308bd1a835644...e054295fed6a19a4e68fb50e71e0e57305a6770d,3,35,1,36,6,2008-08-22 13:59:41,2008-08-22 13:59:41
e054295fed6a19a4e68fb50e71e0e57305a6770d...343c25501608910d326734118547e86c5e72848a,1,13,13,26,4,2008-08-22 14:07:50,2008-08-22 14:07:50
343c25501608910d326734118547e86c5e72848a...0d3dd8b68b59da2efea25713df4b825c5c3d20f5,2,13,13,26,4,2008-08-22 14:18:53,2008-08-22 14:18:53
0d3dd8b68b59da2efea25713df4b825c5c3d20f5...640e930dc151f62d096d881eea31dc4f74cf53a7,1,1,1,2,1,2008-08-22 17:36:02,2008-08-22 17:36:02
640e930dc151f62d096d881eea31dc4f74cf53a7...1b8b9686fa8b1ad6ee7f1b47cd3cfd59ab85049e,3,29,2,31,5,2008-08-22 19:27:26,2008-08-22 19:27:26
1b8b9686fa8b1ad6ee7f1b47cd3cfd59ab85049e...6e36ce142951b846e30fcac2e823162f2eeb1bd5,1,38,29,67,8,2008-08-22 20:26:20,2008-08-22 20:26:20
6e36ce142951b846e30fcac2e823162f2eeb1bd5...d4d7bc175ddd0b698e394a202f8ab6ae572d63d3,4,80,43,123,26,2008-08-22 22:00:28,2008-08-22 22:00:28
d4d7bc175ddd0b698e394a202f8ab6ae572d63d3...ab26efc95286fa3e7e52f5f9ec232055bcd2cbb7,2,17,7,24,8,2008-08-23 03:26:01,2008-08-23 03:26:01
ab26efc95286fa3e7e52f5f9ec232055bcd2cbb7...77c78201b802c407361641a76208fc11af16b68d,9,66,3,69,14,2008-08-23 04:00:15,2008-08-23 04:00:15
77c78201b802c407361641a76208fc11af16b68d...264771f1b60c048d70fc439535392092b0403f93,1,1,0,1,1,2008-08-23 04:14:23,2008-08-23 04:14:23
264771f1b60c048d70fc439535392092b0403f93...a64dc39fb7c6787c83ea2e807c5bf2f94ad5909d,5,101,61,162,18,2008-08-23 04:46:33,2008-08-23 04:46:33
a64dc39fb7c6787c83ea2e807c5bf2f94ad5909d...5061970b76194d6a170d80ffab18260f138951c4,3,11,3,14,4,2008-08-23 04:59:25,2008-08-23 04:59:25
5061970b76194d6a170d80ffab18260f138951c4...324befc477757961d28c89013151d51bf413f0db,1,1,1,2,1,2008-08-23 05:04:59,2008-08-23 05:04:59
324befc477757961d28c89013151d51bf413f0db...58c579b0056bbc8e50cdc2436929fc9703bfcab5,1,1,1,2,1,2008-08-23 05:05:21,2008-08-23 05:05:21
58c579b0056bbc8e50cdc2436929fc9703bfcab5...a0e87b771bc0ee1b1f307099e605ee415f1c9dbd,1,3,3,6,1,2008-08-23 07:06:30,2008-08-23 07:06:30
a0e87b771bc0ee1b1f307099e605ee415f1c9dbd...46da8ac9e5415ef88527cfaf49da5e4212b7cdd1,3,26,4,30,5,2008-08-23 12:52:04,2008-08-23 12:52:04
46da8ac9e5415ef88527cfaf49da5e4212b7cdd1...b35acb3ee97c8ee0d89b7fedb10168056857ab20,1,1,1,2,1,2008-08-23 13:14:10,2008-08-23 13:14:10
b35acb3ee97c8ee0d89b7fedb10168056857ab20...0f869f905e7d3a335ea9090fa079baf4b5883ec7,2,14,0,14,4,2008-08-23 13:31:28,2008-08-23 13:31:28
0f869f905e7d3a335ea9090fa079baf4b5883ec7...a9ee1d4e28f4e6509dd910982b5504bc6a3554cc,2,5,1,6,4,2008-08-23 14:12:58,2008-08-23 14:12:58
a9ee1d4e28f4e6509dd910982b5504bc6a3554cc...358ba07166aba0e9a8ec23d927b414ad41e0f9de,1,1,1,2,1,2008-08-23 14:23:50,2008-08-23 14:23:50
358ba07166aba0e9a8ec23d927b414ad41e0f9de...67402a6fb50e44a916bacae5c98364f012e77bd3,3,4,26,30,5,2008-08-23 15:03:40,2008-08-23 15:03:40
67402a6fb50e44a916bacae5c98364f012e77bd3...0511435a33d04491387ed50f7724b947fba11362,1,2,1,3,2,2008-08-23 16:27:12,2008-08-23 16:27:12
0511435a33d04491387ed50f7724b947fba11362...943c28a4c661a76115012dbe1db3e98d7395f1f7,2,15,5,20,7,2008-08-23 16:56:41,2008-08-23 16:56:41
943c28a4c661a76115012dbe1db3e98d7395f1f7...3dd69a965b467a3085079a3628b18310a10f0261,2,4,3,7,4,2008-08-23 17:26:00,2008-08-23 17:26:00
3dd69a965b467a3085079a3628b18310a10f0261...646f2f6101cda3e20908928de44739dfff596b0f,2,12,1,13,4,2008-08-23 17:28:12,2008-08-23 17:28:12
646f2f6101cda3e20908928de44739dfff596b0f...8a3ef1f8bce338b2ca255177b4ba6d020fd05bca,3,32,3,35,7,2008-08-23 17:33:09,2008-08-23 17:33:09
8a3ef1f8bce338b2ca255177b4ba6d020fd05bca...eaa64cd889587f4d459ab0bb62c96c04d362d0eb,1,1,1,2,1,2008-08-23 17:36:42,2008-08-23 17:36:42
eaa64cd889587f4d459ab0bb62c96c04d362d0eb...a9f0ae706a8dc035543ac64a1e87e9621a35fa00,3,82,44,126,16,2008-08-23 17:56:02,2008-08-23 17:56:02
a9f0ae706a8dc035543ac64a1e87e9621a35fa00...64ca36bf0832d9d72fc26293f3aebed7d8b24a52,1,1,1,2,1,2008-08-23 18:01:16,2008-08-23 18:01:16
64ca36bf0832d9d72fc26293f3aebed7d8b24a52...77bf14d5817d6b8bcea26607fb52b57d0908ffac,1,4,1,5,1,2008-08-23 18:08:28,2008-08-23 18:08:28
77bf14d5817d6b8bcea26607fb52b57d0908ffac...cc95b44547eb3eb92dafb7e81516dfb756ad3c59,1,3,3,6,3,2008-08-23 18:20:19,2008-08-23 18:20:19
cc95b44547eb3eb92dafb7e81516dfb756ad3c59...abb1c508cc95d5cf55e8ab63d6bafe17ac095f95,5,92,10,102,16,2008-08-23 18:20:49,2008-08-23 18:20:49
abb1c508cc95d5cf55e8ab63d6bafe17ac095f95...1ec12576f32ba086c101753efefaa2d1d19ffe65,2,1043,861,1904,555,2008-08-23 18:28:52,2008-08-23 18:28:52
1ec12576f32ba086c101753efefaa2d1d19ffe65...aba518f0f8a20d343a0e2592fdbc7b97ee54006f,1,6,3,9,2,2008-08-23 18:34:32,2008-08-23 18:34:32
aba518f0f8a20d343a0e2592fdbc7b97ee54006f...7eb4b30d6f10f6cdaf6e27e8d50f13c77fd9ac84,2,74,63,137,59,2008-08-23 18:54:43,2008-08-23 18:54:43
7eb4b30d6f10f6cdaf6e27e8d50f13c77fd9ac84...c83a96d2981aa9cecccbc798624c979e21222821,3,3,2,5,4,2008-08-23 19:07:49,2008-08-23 19:07:49
c83a96d2981aa9cecccbc798624c979e21222821...712bb0dde7d935d4a7703635c821ea63f60997c7,14,376,68,444,20,2008-08-23 19:22:23,2008-08-23 19:22:23
712bb0dde7d935d4a7703635c821ea63f60997c7...aa78a05e693e26308c6ad98242709b2e4ed8367d,1,4,3,7,4,2008-08-23 21:45:36,2008-08-23 21:45:36
aa78a05e693e26308c6ad98242709b2e4ed8367d...b3688e81943d6d059d3f3c95095498a5aab84852,1,2,2,4,2,2008-08-23 22:10:45,2008-08-23 22:10:45
b3688e81943d6d059d3f3c95095498a5aab84852...97cb07c3a10ff0e584a260a7ee1001614691eb1d,188,19944,17090,37034,1356,2008-08-23 22:25:40,2008-08-23 22:25:40
97cb07c3a10ff0e584a260a7ee1001614691eb1d...213f294638d353a8763e78e7426ddbea32f0453c,1,2,1,3,2,2008-08-23 22:59:04,2008-08-23 22:59:04
213f294638d353a8763e78e7426ddbea32f0453c...74b3173fba89b30415f5e247e2ff2f33a7185fbe,1,0,4,4,2,2008-08-24 05:06:17,2008-08-24 05:06:17
74b3173fba89b30415f5e247e2ff2f33a7185fbe...27b0077a4800ed88ff057e9ad8b35ac7f3c8b908,4,36,3,39,8,2008-08-24 06:34:18,2008-08-24 06:34:18
27b0077a4800ed88ff057e9ad8b35ac7f3c8b908...96d12748a957e8e78641a2c92c91ca2b261a4209,1,1,0,1,1,2008-08-24 06:46:53,2008-08-24 06:46:53
96d12748a957e8e78641a2c92c91ca2b261a4209...829a5c1352e4cc6a3a3fd6ff9f69f11bd2df2bd4,1,2,2,4,1,2008-08-24 07:22:30,2008-08-24 07:22:30
829a5c1352e4cc6a3a3fd6ff9f69f11bd2df2bd4...87170c72f9703dc1019fcf19ec68dae43002d651,1,1,1,2,1,2008-08-24 07:45:35,2008-08-24 07:45:35
87170c72f9703dc1019fcf19ec68dae43002d651...6447582b85711c4c6f1f8dc8e36d0dbc57cceff0,1,13,0,13,13,2008-08-24 08:04:06,2008-08-24 08:04:06
6447582b85711c4c6f1f8dc8e36d0dbc57cceff0...e822fd703bead9c753257da9722ea00e444395d5,1,8,0,8,1,2008-08-24 08:09:27,2008-08-24 08:09:27
e822fd703bead9c753257da9722ea00e444395d5...11e43883d55a17e39791f961aff952ef9e2c3ec5,4,35,3,38,7,2008-08-24 08:12:13,2008-08-24 08:12:13
11e43883d55a17e39791f961aff952ef9e2c3ec5...57b9061d1285bafe0c6bcfca4dcbfdfb5715b91c,0,0,0,0,0,2008-08-24 08:17:35,2008-08-24 08:17:35
57b9061d1285bafe0c6bcfca4dcbfdfb5715b91c...78c2c95ed3209c2f0d1ad2c920a580a71bf9807b,1,1,1,2,1,2008-08-24 08:51:33,2008-08-24 08:51:33
78c2c95ed3209c2f0d1ad2c920a580a71bf9807b...27371e3286ae723fb96dfa990eee197454350163,1,3,3,6,1,2008-08-24 09:01:50,2008-08-24 09:01:50
27371e3286ae723fb96dfa990eee197454350163...ac858a2a610994b1999a4dcbf34443285ad45b34,1,9,2,11,2,2008-08-24 09:19:18,2008-08-24 09:19:18
ac858a2a610994b1999a4dcbf34443285ad45b34...1ab16c7302a137075800048c310d6880f63a4210,1,1,1,2,1,2008-08-24 09:25:19,2008-08-24 09:25:19
1ab16c7302a137075800048c310d6880f63a4210...fbf09ee11dc4a7bc03018cad3331d573798f4c94,1,4,0,4,1,2008-08-24 17:54:51,2008-08-24 17:54:51
fbf09ee11dc4a7bc03018cad3331d573798f4c94...6b5a607606a0589b9571634f82e8d5bbba0e1dfc,1,17,3,20,7,2008-08-24 20:16:56,2008-08-24 20:16:56
6b5a607606a0589b9571634f82e8d5bbba0e1dfc...072083f26155f1e61d859fdd2701d9718192cf77,1,1,1,2,1,2008-08-24 22:45:35,2008-08-24 22:45:35
072083f26155f1e61d859fdd2701d9718192cf77...d6e5632969b95a3f99f95ef7d0f94178a923a5e9,1,2,1,3,2,2008-08-25 00:11:23,2008-08-25 00:11:23
d6e5632969b95a3f99f95ef7d0f94178a923a5e9...6d6fb392b4732fa4ff77e918c06ffcd92e753d9b,2,32,26,58,24,2008-08-25 00:32:32,2008-08-25 00:32:32
6d6fb392b4732fa4ff77e918c06ffcd92e753d9b...d535edb9da92f7de0c2ae35456b5b751db8e4d46,2,20,5,25,6,2008-08-25 03:17:06,2008-08-25 03:17:06
d535edb9da92f7de0c2ae35456b5b751db8e4d46...05e8c3ecd3a01ce0574040857a02bac04097b36f,1,2,2,4,2,2008-08-25 03:26:37,2008-08-25 03:26:37
05e8c3ecd3a01ce0574040857a02bac04097b36f...82a1d5471cba138d90b5bb99d8313486af06d56a,4,70,3,73,10,2008-08-25 03:51:25,2008-08-25 03:51:25
82a1d5471cba138d90b5bb99d8313486af06d56a...de977c851429974f90ba907332c1d8699b88b4da,1,7,3,10,3,2008-08-25 03:55:47,2008-08-25 03:55:47
de977c851429974f90ba907332c1d8699b88b4da...d62cfce213e9393407846477a1a599f847be8603,1,1,1,2,1,2008-08-25 03:59:28,2008-08-25 03:59:28
d62cfce213e9393407846477a1a599f847be8603...62b39322f30fc274de033441d652a0c6714f93d7,3,12,2,14,6,2008-08-25 04:00:15,2008-08-25 04:00:15
62b39322f30fc274de033441d652a0c6714f93d7...29d216021375446223a36901ab0ec60b6e3eadf9,2,6,3,9,5,2008-08-25 04:13:27,2008-08-25 04:13:27
29d216021375446223a36901ab0ec60b6e3eadf9...c46bb219bfd5cab84e20fc9e87238093d36ecf52,2,5,1,6,3,2008-08-25 04:52:55,2008-08-25 04:52:55
c46bb219bfd5cab84e20fc9e87238093d36ecf52...78bdff1adc3afc8c6d192557d62bbcf313ab620c,2,177,166,343,151,2008-08-25 07:13:42,2008-08-25 07:13:42
78bdff1adc3afc8c6d192557d62bbcf313ab620c...06d49768bd6974a455e6dd46e9526a093721897e,4,27,5,32,6,2008-08-25 12:31:10,2008-08-25 12:31:10
06d49768bd6974a455e6dd46e9526a093721897e...3df72660560730393fc958700d2a3ab975c4b361,3,20,12,32,7,2008-08-25 12:56:06,2008-08-25 12:56:06
3df72660560730393fc958700d2a3ab975c4b361...e206eabc68c6dbb018195291afd5722fe7493200,2,0,2,2,2,2008-08-25 12:57:24,2008-08-25 12:57:24
e206eabc68c6dbb018195291afd5722fe7493200...60d5f0db3c304ca8c10deaa24cddee20592b8656,1,3,1,4,1,2008-08-25 12:58:18,2008-08-25 12:58:18
60d5f0db3c304ca8c10deaa24cddee20592b8656...964769871db61335dc567e6e9f77dae9afdc2b0d,1,1,0,1,1,2008-08-25 15:29:39,2008-08-25 15:29:39
964769871db61335dc567e6e9f77dae9afdc2b0d...97bc872755dd05d2ca38f873d3986e7832f21c91,1,32,30,62,17,2008-08-25 15:51:13,2008-08-25 15:51:13
97bc872755dd05d2ca38f873d3986e7832f21c91...e3df35478d5066972b0ef8ef5bb44acf5b0fb982,5,0,0,0,0,2008-08-25 16:24:41,2008-08-25 16:24:41
e3df35478d5066972b0ef8ef5bb44acf5b0fb982...15ed0d65b0d036629dade79114093845daaa6f52,2,33,15,48,15,2008-08-25 16:55:57,2008-08-25 16:55:57
15ed0d65b0d036629dade79114093845daaa6f52...9a1e4cedde309ad8bf5f35f28fb722da86fdd090,1,1,1,2,1,2008-08-25 16:56:59,2008-08-25 16:56:59
9a1e4cedde309ad8bf5f35f28fb722da86fdd090...78d13fb1c226b7f2d28ebbda7b91c86e8559512d,3,19,1,20,4,2008-08-25 17:10:20,2008-08-25 17:10:20
78d13fb1c226b7f2d28ebbda7b91c86e8559512d...1aa48898085ea16915877cc139e238a74e3f554b,1,14,2,16,2,2008-08-25 17:20:28,2008-08-25 17:20:28
1aa48898085ea16915877cc139e238a74e3f554b...0a6314f249f02d928bf5cf29def470e180898e0d,2,25,5,30,3,2008-08-25 18:24:05,2008-08-25 18:24:05
0a6314f249f02d928bf5cf29def470e180898e0d...ab7eabfcd1bdc51c15bf66e39ad389add4fc676d,1,2,2,4,2,2008-08-25 18:32:26,2008-08-25 18:32:26
ab7eabfcd1bdc51c15bf66e39ad389add4fc676d...7e06b69a3d1e1cdfef625bdf96f97ca5eb0eed74,5,2,54,56,6,2008-08-25 18:53:18,2008-08-25 18:53:18
7e06b69a3d1e1cdfef625bdf96f97ca5eb0eed74...cbd574881c48e095b118031c850367f86b597a2e,2,6,1,7,3,2008-08-25 19:09:44,2008-08-25 19:09:44
cbd574881c48e095b118031c850367f86b597a2e...744d8821100c74633026a908d3f6a842b32e8c4a,2,0,6,6,6,2008-08-25 19:11:41,2008-08-25 19:11:41
744d8821100c74633026a908d3f6a842b32e8c4a...f964a6e4723df9bbf9d22f0fbde3222f513b00e2,1,11,9,20,6,2008-08-25 19:28:41,2008-08-25 19:28:41
f964a6e4723df9bbf9d22f0fbde3222f513b00e2...a16988450531aeae9c70e7035311426a91f6d5b9,2,2,2,4,2,2008-08-25 19:28:57,2008-08-25 19:28:57
a16988450531aeae9c70e7035311426a91f6d5b9...018057d8d1f7dcf5390783c7b32201a12ff276df,1,2,3,5,1,2008-08-25 19:29:10,2008-08-25 19:29:10
018057d8d1f7dcf5390783c7b32201a12ff276df...834ce902c2cf094366944acb99958696c2891f17,1,2,2,4,1,2008-08-25 19:29:13,2008-08-25 19:29:13
834ce902c2cf094366944acb99958696c2891f17...853f4d29b8021e9d919fe69e757ab1baeb6fc3ae,2,9,1,10,3,2008-08-25 19:56:14,2008-08-25 19:56:14
853f4d29b8021e9d919fe69e757ab1baeb6fc3ae...b46e736c9ae2d16e4743e783d03954b1424bbf2b,1,1,1,2,1,2008-08-25 20:47:42,2008-08-25 20:47:42
b46e736c9ae2d16e4743e783d03954b1424bbf2b...cba91997a24f3cb154c7c51029c6dd91471f8800,49,2409,1147,3556,133,2008-08-25 22:14:22,2008-08-25 22:14:22
cba91997a24f3cb154c7c51029c6dd91471f8800...6abe0460c8cbfa3901c55912b386d53541d94abb,1,3,3,6,2,2008-08-25 22:34:27,2008-08-25 22:34:27
6abe0460c8cbfa3901c55912b386d53541d94abb...3deff41a32637f22aa393d5b10bdc43f5911d95e,2,57,9,66,12,2008-08-25 22:43:25,2008-08-25 22:43:25
3deff41a32637f22aa393d5b10bdc43f5911d95e...ddb3cdd514588bfae7a44ee6b1a12857e8833cf1,1,2,2,4,2,2008-08-25 22:47:07,2008-08-25 22:47:07
ddb3cdd514588bfae7a44ee6b1a12857e8833cf1...6a5cc9e7f67a1083bb9de89356b85e5982026538,1,1,1,2,1,2008-08-25 22:53:44,2008-08-25 22:53:44
6a5cc9e7f67a1083bb9de89356b85e5982026538...4df380ff01a367b252c01aeb667e23674f9a5884,1,4,3,7,4,2008-08-25 22:55:24,2008-08-25 22:55:24
4df380ff01a367b252c01aeb667e23674f9a5884...d5f1d6f937ea1649fce97c99b07f82b55cec1e01,1,3,2,5,3,2008-08-25 23:56:39,2008-08-25 23:56:39
d5f1d6f937ea1649fce97c99b07f82b55cec1e01...b47c25ef91f606219c827888f15fbb067f409165,1,1,5,6,1,2008-08-26 00:09:29,2008-08-26 00:09:29
b47c25ef91f606219c827888f15fbb067f409165...8a88379b2a32ec704b7fe6bde4c87eff8d2b1335,1,20,9,29,7,2008-08-26 00:34:34,2008-08-26 00:34:34
8a88379b2a32ec704b7fe6bde4c87eff8d2b1335...5485e0d97f86b04bd257e391986b62b1cff1c90a,2,11,5,16,4,2008-08-26 00:46:30,2008-08-26 00:46:30
5485e0d97f86b04bd257e391986b62b1cff1c90a...b2c2c3a2edf1ca3b1a10f53c0323022df92d32af,1,192,182,374,67,2008-08-26 00:52:55,2008-08-26 00:52:55
b2c2c3a2edf1ca3b1a10f53c0323022df92d32af...f2b389b354165cceb578aa3b13bec88f0e44c654,3,81,10,91,4,2008-08-26 01:59:25,2008-08-26 01:59:25
f2b389b354165cceb578aa3b13bec88f0e44c654...948a833eb7fd9be0bc2d585c92a407f036ef42b2,1,4,1,5,2,2008-08-26 02:42:39,2008-08-26 02:42:39
948a833eb7fd9be0bc2d585c92a407f036ef42b2...15ed5e61c959d1d6e290b566653e81adc9f3b930,1,6,6,12,1,2008-08-26 03:22:44,2008-08-26 03:22:44
15ed5e61c959d1d6e290b566653e81adc9f3b930...b016ea0aceb852ad9aac0257706ffc915058084f,3,37,37,74,33,2008-08-26 04:55:56,2008-08-26 04:55:56
b016ea0aceb852ad9aac0257706ffc915058084f...47ed499a5db8d7c41d6139fa9d797538b92f5cd5,1,4,6,10,2,2008-08-26 06:43:04,2008-08-26 06:43:04
47ed499a5db8d7c41d6139fa9d797538b92f5cd5...ccb37ce74cae13115a65b4cb73db156d40131765,2,13,6,19,7,2008-08-26 06:58:43,2008-08-26 06:58:43
ccb37ce74cae13115a65b4cb73db156d40131765...af83b650be6668e30a017941048302f17100ad03,1,12,2,14,2,2008-08-26 07:11:14,2008-08-26 07:11:14
af83b650be6668e30a017941048302f17100ad03...73afcee6ed18d49e49ed831258f77f674e438b3b,1,2,2,4,2,2008-08-26 07:36:39,2008-08-26 07:36:39
73afcee6ed18d49e49ed831258f77f674e438b3b...fcf059d539d9065a09979bba81dcb7107e41f085,1,6,6,12,7,2008-08-26 07:43:59,2008-08-26 07:43:59
fcf059d539d9065a09979bba81dcb7107e41f085...8c4a525871df19163d5bfdf5939eff33b544c2e2,2,19,12,31,4,2008-08-26 07:56:32,2008-08-26 07:56:32
8c4a525871df19163d5bfdf5939eff33b544c2e2...61957df17f5555409f689c29b8d75bef9f998c21,1,3,0,3,3,2008-08-26 07:56:39,2008-08-26 07:56:39
61957df17f5555409f689c29b8d75bef9f998c21...3111d7f60b67d5aefa4d891d1d9a86ba56d7607c,6,53,20,73,14,2008-08-26 08:08:55,2008-08-26 08:08:55
3111d7f60b67d5aefa4d891d1d9a86ba56d7607c...4f711eb5e3875a738262009a46f013c46b3dbc25,1,5,1,6,3,2008-08-26 08:58:07,2008-08-26 08:58:07
4f711eb5e3875a738262009a46f013c46b3dbc25...c5c61b261ed495f0ce3ecd646dce6af4dfbe39b7,1,2,2,4,2,2008-08-26 15:23:02,2008-08-26 15:23:02
c5c61b261ed495f0ce3ecd646dce6af4dfbe39b7...30de7331d4f5be03116c681609bf2f7f5ee2354e,5,103,0,103,6,2008-08-26 15:52:21,2008-08-26 15:52:21
30de7331d4f5be03116c681609bf2f7f5ee2354e...a516ebdff1b33aacf6c1a9c9773906a5f6570e43,1,23,2,25,5,2008-08-26 16:18:20,2008-08-26 16:18:20
a516ebdff1b33aacf6c1a9c9773906a5f6570e43...c849fcc66de766c467926305fbc0f371eae20a80,1,0,1,1,1,2008-08-26 16:55:37,2008-08-26 16:55:37
c849fcc66de766c467926305fbc0f371eae20a80...05a4439581f1c2deb485b3f6796ff26045f4c567,1,1,1,2,1,2008-08-26 17:44:04,2008-08-26 17:44:04
05a4439581f1c2deb485b3f6796ff26045f4c567...5a72589d7acb3abdd62e95bd30eba5ac038861a2,3,5,2,7,4,2008-08-26 18:07:36,2008-08-26 18:07:36
5a72589d7acb3abdd62e95bd30eba5ac038861a2...5dd68fa74ae6f3f401649c73e0f450b35d291d9c,2,3,3,6,3,2008-08-26 18:15:19,2008-08-26 18:15:19
5dd68fa74ae6f3f401649c73e0f450b35d291d9c...c6a2bd9b962af1cdf46f964589e6023046cfa8ec,1,19,1,20,2,2008-08-26 18:53:51,2008-08-26 18:53:51
c6a2bd9b962af1cdf46f964589e6023046cfa8ec...378f5ddb5acb919525002fd92ff249f103ea8f31,5,41,17,58,12,2008-08-26 18:53:52,2008-08-26 18:53:52
378f5ddb5acb919525002fd92ff249f103ea8f31...6f29ad31b5e030caf9a950cbec744089204f2cd3,6,563,2,565,8,2008-08-26 19:04:52,2008-08-26 19:04:52
6f29ad31b5e030caf9a950cbec744089204f2cd3...c5cc26ff99182f4487b7cf898ba41cd460fa6b77,2,30,11,41,15,2008-08-26 19:23:59,2008-08-26 19:23:59
c5cc26ff99182f4487b7cf898ba41cd460fa6b77...471533fb93176cc0f37b421d48800eb0b38ea385,1,1,0,1,1,2008-08-26 19:38:19,2008-08-26 19:38:19
471533fb93176cc0f37b421d48800eb0b38ea385...e3fad41859794a604446b8059c90b442cf344987,1,10,1,11,1,2008-08-26 19:38:27,2008-08-26 19:38:27
e3fad41859794a604446b8059c90b442cf344987...91ca961ba6f160e2a8b93684802c515e77887608,2,163,347,510,104,2008-08-26 19:56:19,2008-08-26 19:56:19
91ca961ba6f160e2a8b93684802c515e77887608...52c3c3a349e1be36133bde48792611847697940f,1,4,4,8,2,2008-08-26 19:59:54,2008-08-26 19:59:54
52c3c3a349e1be36133bde48792611847697940f...a0329d0ae30c41cf03a541bf0236dc81c4098feb,1,3,1,4,1,2008-08-26 20:08:02,2008-08-26 20:08:02
a0329d0ae30c41cf03a541bf0236dc81c4098feb...6056ab1beed04f53013ee83fc82303b5c42c9fbd,4,73,32,105,15,2008-08-26 20:19:12,2008-08-26 20:19:12
6056ab1beed04f53013ee83fc82303b5c42c9fbd...8f5234d801ebd2e8b526d4c75c94c89ea21eb440,2,45,3,48,4,2008-08-26 20:44:20,2008-08-26 20:44:20
8f5234d801ebd2e8b526d4c75c94c89ea21eb440...384c48e456611ff995f7928b87098716a8e6fbe4,1,4,4,8,4,2008-08-26 20:51:45,2008-08-26 20:51:45
384c48e456611ff995f7928b87098716a8e6fbe4...5f396193fb12d556cb70c702cddd28e295a5ed20,1,1,3,4,1,2008-08-26 21:30:15,2008-08-26 21:30:15
5f396193fb12d556cb70c702cddd28e295a5ed20...1fc8f84f58d53033cd74afb9b26ca60dd18a055c,3,8,2,10,4,2008-08-26 21:32:17,2008-08-26 21:32:17
1fc8f84f58d53033cd74afb9b26ca60dd18a055c...05133baaaa9729487c0ce3d7edf02fff4df61169,1,0,1,1,1,2008-08-26 21:33:18,2008-08-26 21:33:18
05133baaaa9729487c0ce3d7edf02fff4df61169...70966cb9c7ed97f76be6781e502d08f58a4a0847,2,44,3,47,4,2008-08-26 21:33:56,2008-08-26 21:33:56
70966cb9c7ed97f76be6781e502d08f58a4a0847...255bf69e09b4b6315851bbcf2ff6977aa1aac75e,2,134,159,293,121,2008-08-26 23:06:24,2008-08-26 23:06:24
255bf69e09b4b6315851bbcf2ff6977aa1aac75e...8226b8c9576107c281d15040b17fa696cdaf87c6,1,4,0,4,1,2008-08-26 23:06:30,2008-08-26 23:06:30
8226b8c9576107c281d15040b17fa696cdaf87c6...3b993b29954addeba4a0ddbb58aeeeeeaa87c5cf,1,1,1,2,1,2008-08-27 05:10:20,2008-08-27 05:10:20
3b993b29954addeba4a0ddbb58aeeeeeaa87c5cf...6e51f051124ca88ae0ffb6168e1e30d61d712237,1,17,14,31,4,2008-08-27 05:22:25,2008-08-27 05:22:25
6e51f051124ca88ae0ffb6168e1e30d61d712237...d70c8907cd3b83cff2127b6a4af9cae438be8b24,3,45,15,60,21,2008-08-27 05:22:33,2008-08-27 05:22:33
d70c8907cd3b83cff2127b6a4af9cae438be8b24...900178d79594898f1d924c69800d48b6232bc41f,1,5,0,5,1,2008-08-27 05:44:26,2008-08-27 05:44:26
900178d79594898f1d924c69800d48b6232bc41f...4091e6525d030d274787d112c997c6bfd6e1c74a,1,15,0,15,15,2008-08-27 05:56:57,2008-08-27 05:56:57
4091e6525d030d274787d112c997c6bfd6e1c74a...5577b96ae4cbbae42fe4c76be1f75b6054b74498,1,4,2,6,2,2008-08-27 05:57:10,2008-08-27 05:57:10
5577b96ae4cbbae42fe4c76be1f75b6054b74498...9de848cec9eea167f0d29097897b66abc03ea918,2,20,2,22,19,2008-08-27 05:57:27,2008-08-27 05:57:27
9de848cec9eea167f0d29097897b66abc03ea918...157dbe2fffc4a385bbc635d3ba8adad9be947a17,1,1,1,2,1,2008-08-27 06:02:13,2008-08-27 06:02:13
157dbe2fffc4a385bbc635d3ba8adad9be947a17...c305471610e8da8589b8b7b20a1a2b6c0dcbc3d9,2,6,3,9,3,2008-08-27 07:04:58,2008-08-27 07:04:58
c305471610e8da8589b8b7b20a1a2b6c0dcbc3d9...a1575766604205b3bddf0f05d13ad698c78a7582,4,317,331,648,82,2008-08-27 07:16:57,2008-08-27 07:16:57
a1575766604205b3bddf0f05d13ad698c78a7582...c2ba59fc1da5287d6286e2c2aca4083d5bafe056,35,158,3468,3626,148,2008-08-27 07:19:44,2008-08-27 07:19:44
c2ba59fc1da5287d6286e2c2aca4083d5bafe056...ec8848dad50a4687a8bc3ba7270bf08dbf5ac25a,1,2,1,3,1,2008-08-27 07:27:09,2008-08-27 07:27:09
ec8848dad50a4687a8bc3ba7270bf08dbf5ac25a...7e9a22aae7a363a60d6aa2a27a06b1fd01d6ac13,1,1,1,2,2,2008-08-27 08:05:59,2008-08-27 08:05:59
7e9a22aae7a363a60d6aa2a27a06b1fd01d6ac13...b80db03ca728c70f2018bdaf745fa389dea5410e,4,341,847,1188,211,2008-08-27 08:51:35,2008-08-27 08:51:35
b80db03ca728c70f2018bdaf745fa389dea5410e...ee28560997e324203333b891e488b2d2d7c9511d,1,7,1,8,2,2008-08-27 08:58:51,2008-08-27 08:58:51
ee28560997e324203333b891e488b2d2d7c9511d...ba6f7e4223ce8b120814ed56387a33405c9e1fd7,0,0,0,0,0,2008-08-27 11:01:04,2008-08-27 11:01:04
ba6f7e4223ce8b120814ed56387a33405c9e1fd7...236ceea87f2329ef1517ae82ead48eb519b87b8a,2,123,1,124,3,2008-08-27 11:49:42,2008-08-27 11:49:42
236ceea87f2329ef1517ae82ead48eb519b87b8a...a20cf7f9744c4b36799010d4605e8996031acb47,1,3,3,6,1,2008-08-27 11:50:02,2008-08-27 11:50:02
a20cf7f9744c4b36799010d4605e8996031acb47...c91cdbddcb6e9e67584a59ebe1f8dcb66dfc5477,1,1,1,2,1,2008-08-27 12:18:02,2008-08-27 12:18:02
c91cdbddcb6e9e67584a59ebe1f8dcb66dfc5477...35f4bdc7a097f8bfdd8e6450452c051dd76d35ca,2,1304,1225,2529,275,2008-08-27 13:15:28,2008-08-27 13:15:28
35f4bdc7a097f8bfdd8e6450452c051dd76d35ca...453e9ae4acd90397269f474755825e1deb77242d,2,1199,1038,2237,253,2008-08-27 13:38:04,2008-08-27 13:38:04
453e9ae4acd90397269f474755825e1deb77242d...4848d4cbe6a7aecaf0d1761b80e94475ab5f040c,2,3,5,8,1,2008-08-27 13:41:34,2008-08-27 13:41:34
4848d4cbe6a7aecaf0d1761b80e94475ab5f040c...d441a758de854ed05b495f613a9baa47e098b4d5,1,2,2,4,2,2008-08-27 15:39:00,2008-08-27 15:39:00
d441a758de854ed05b495f613a9baa47e098b4d5...e704559e567c46d46fe9268147e1a4a2cf83f4a2,1,29,0,29,1,2008-08-27 16:44:52,2008-08-27 16:44:52
e704559e567c46d46fe9268147e1a4a2cf83f4a2...2e9a8801d050c1e441ce4632ce8c6adb9eb51f40,2,19,1,20,2,2008-08-27 19:52:27,2008-08-27 19:52:27
2e9a8801d050c1e441ce4632ce8c6adb9eb51f40...887f778794d23968b9060e35d11065577e12cebe,1,9,9,18,9,2008-08-27 19:59:29,2008-08-27 19:59:29
887f778794d23968b9060e35d11065577e12cebe...615ed200060ef6571099886cebb7503078a9bfdf,1,14,13,27,9,2008-08-27 20:29:45,2008-08-27 20:29:45
615ed200060ef6571099886cebb7503078a9bfdf...40e5cde1c55d4e096fb039daef674f1754cacd5c,1,1,1,2,1,2008-08-27 20:29:58,2008-08-27 20:29:58
40e5cde1c55d4e096fb039daef674f1754cacd5c...c33aeaa082b2f821db0b87afbd01f5e0144b9aa4,2,11,1,12,4,2008-08-27 20:53:02,2008-08-27 20:53:02
c33aeaa082b2f821db0b87afbd01f5e0144b9aa4...8943a857a7bcf8aae9edc0eb09719e36f7b9e78c,2,12,1,13,2,2008-08-27 21:18:45,2008-08-27 21:18:45
8943a857a7bcf8aae9edc0eb09719e36f7b9e78c...52672f2b942767e861c65dfbaa3058dc1f1a8303,2,23,0,23,2,2008-08-27 21:30:47,2008-08-27 21:30:47
52672f2b942767e861c65dfbaa3058dc1f1a8303...f58217cc02fe6779a69bdf092ce6095bb368401c,1,8,4,12,2,2008-08-27 21:44:14,2008-08-27 21:44:14
f58217cc02fe6779a69bdf092ce6095bb368401c...ff420b43647dd7f149f000efd2c7eb077f6ba5cf,5,89,15,104,13,2008-08-27 22:21:14,2008-08-27 22:21:14
ff420b43647dd7f149f000efd2c7eb077f6ba5cf...1106c558b1e8d141185f0b3667e374c735c8aaeb,1,2,1,3,2,2008-08-27 22:51:24,2008-08-27 22:51:24
1106c558b1e8d141185f0b3667e374c735c8aaeb...08024e95035bb039db0cc281f9046998c7d68c0d,1,1,1,2,1,2008-08-27 22:55:10,2008-08-27 22:55:10
08024e95035bb039db0cc281f9046998c7d68c0d...1abfb1df19d7a5722a190cb9988e27fc729bb788,2,5,5,10,4,2008-08-27 23:05:25,2008-08-27 23:05:25
1abfb1df19d7a5722a190cb9988e27fc729bb788...4cd03ef5d985a76236d47c4fd9c041531722e6c0,3,35,15,50,15,2008-08-28 05:00:23,2008-08-28 05:00:23
4cd03ef5d985a76236d47c4fd9c041531722e6c0...f749b84824fc11f2f57d5b0036a07ead13fd1a99,2,690,955,1645,209,2008-08-28 05:16:48,2008-08-28 05:16:48
f749b84824fc11f2f57d5b0036a07ead13fd1a99...71dda1918408a5b15d27c5b2cd28fddcd747449d,4,19,1,20,4,2008-08-28 05:42:05,2008-08-28 05:42:05
71dda1918408a5b15d27c5b2cd28fddcd747449d...59607bb1c197d394edb54e0db04618cf5b31cefb,2,84,38,122,31,2008-08-28 06:00:08,2008-08-28 06:00:08
59607bb1c197d394edb54e0db04618cf5b31cefb...21672c26bf4604e57de4b2a64ec92ef8de53b834,2,8,10,18,2,2008-08-28 06:49:00,2008-08-28 06:49:00
21672c26bf4604e57de4b2a64ec92ef8de53b834...a0dd9ecdd8145f07dfdd804b9a80b4e59d964bd3,2,2980,2089,5069,522,2008-08-28 07:18:28,2008-08-28 07:18:28
a0dd9ecdd8145f07dfdd804b9a80b4e59d964bd3...f1ab8b4342cb04974f43b0d583e1a22ef75213ab,1,1,1,2,1,2008-08-28 11:27:17,2008-08-28 11:27:17
f1ab8b4342cb04974f43b0d583e1a22ef75213ab...34428218365c65644ca89896b287ef922921febc,1,0,2,2,1,2008-08-28 11:29:00,2008-08-28 11:29:00
34428218365c65644ca89896b287ef922921febc...ab28e72f31f29c522f1afbabe9800e344226ff95,1,9,1,10,1,2008-08-28 11:39:27,2008-08-28 11:39:27
ab28e72f31f29c522f1afbabe9800e344226ff95...545cd6d6f08fbd7b206fe75e89a8cb539aff0db6,1,2,2,4,2,2008-08-28 11:43:54,2008-08-28 11:43:54
545cd6d6f08fbd7b206fe75e89a8cb539aff0db6...369b4270fa0dc796f8553ac66998c3dbbffbd332,1,1,1,2,1,2008-08-28 11:46:34,2008-08-28 11:46:34
369b4270fa0dc796f8553ac66998c3dbbffbd332...229f2c1ca0967efe6e1de5632f98c62afea5a584,1,1,1,2,1,2008-08-28 11:52:50,2008-08-28 11:52:50
229f2c1ca0967efe6e1de5632f98c62afea5a584...3f13fa398c33d5370dc383bb3609bb7811ae6c8b,1,1,1,2,1,2008-08-28 12:22:33,2008-08-28 12:22:33
3f13fa398c33d5370dc383bb3609bb7811ae6c8b...71615dbc7079f365f509478bf2e5e46f3a9d1bfa,1,1,1,2,1,2008-08-28 12:49:11,2008-08-28 12:49:11
71615dbc7079f365f509478bf2e5e46f3a9d1bfa...5c43a0a43f6cf42de21066b789c19208cac2ea36,2,11,11,22,11,2008-08-28 13:40:20,2008-08-28 13:40:20
5c43a0a43f6cf42de21066b789c19208cac2ea36...f53596d59f60c171e49fa640b46435aee08f3031,1,6,4,10,4,2008-08-28 13:44:50,2008-08-28 13:44:50
f53596d59f60c171e49fa640b46435aee08f3031...938f7ea9132d4982bed68fc9f189cea437b8601e,2,849,1198,2047,305,2008-08-28 13:57:37,2008-08-28 13:57:37
938f7ea9132d4982bed68fc9f189cea437b8601e...b99cc935ebedf52111507ca92641ffde73a3d9ae,2,26,1,27,2,2008-08-28 15:06:18,2008-08-28 15:06:18
b99cc935ebedf52111507ca92641ffde73a3d9ae...b31568aed34d8728c153ba4e722b7018f2667351,3,44,1,45,2,2008-08-28 15:43:04,2008-08-28 15:43:04
b31568aed34d8728c153ba4e722b7018f2667351...1a40498da41f2547bec2a3b78db621651ff675d6,1,0,20,20,1,2008-08-28 16:05:09,2008-08-28 16:05:09
1a40498da41f2547bec2a3b78db621651ff675d6...3d577febc72e019436be5e06b3ebb4356fb0cc05,1,1,6,7,1,2008-08-28 16:14:13,2008-08-28 16:14:13
3d577febc72e019436be5e06b3ebb4356fb0cc05...fc1fbf614fb52f383eb7fde88db31d9253dc6fa9,1,0,1,1,1,2008-08-28 16:15:44,2008-08-28 16:15:44
fc1fbf614fb52f383eb7fde88db31d9253dc6fa9...fc6649092aae5667ee6ed9b16ed81ebbe41a7bf4,1,2,2,4,1,2008-08-28 16:18:32,2008-08-28 16:18:32
fc6649092aae5667ee6ed9b16ed81ebbe41a7bf4...2e7a87c53c0d010f72f7f71c570f2c1e00ec92bd,1,1,1,2,1,2008-08-28 16:27:19,2008-08-28 16:27:19
2e7a87c53c0d010f72f7f71c570f2c1e00ec92bd...82179ccbbb69dfc3c2d2822683809c4a2beb9021,1,1,1,2,1,2008-08-28 16:31:50,2008-08-28 16:31:50
82179ccbbb69dfc3c2d2822683809c4a2beb9021...79348d4018fd05efdcd3581b235160db4f483f7d,1,1,3,4,1,2008-08-28 16:33:11,2008-08-28 16:33:11
79348d4018fd05efdcd3581b235160db4f483f7d...c181734fa1ceab9d917a313a0567c9a71c2c4b0b,3,25,5,30,8,2008-08-28 17:18:05,2008-08-28 17:18:05
c181734fa1ceab9d917a313a0567c9a71c2c4b0b...10244d1c040d4662e0c93ccdc9e0238d33f85ece,4,304,803,1107,183,2008-08-28 17:26:16,2008-08-28 17:26:16
10244d1c040d4662e0c93ccdc9e0238d33f85ece...a46d3ebfccdd47dd8c915125d0ba5f29b88ffe08,2,12,6,18,6,2008-08-28 19:05:14,2008-08-28 19:05:14
a46d3ebfccdd47dd8c915125d0ba5f29b88ffe08...65c0846c4561130eda98d6f98d7778453960e94a,5,12,11,23,9,2008-08-28 19:28:17,2008-08-28 19:28:17
65c0846c4561130eda98d6f98d7778453960e94a...f96b1249cedc2c2b5303b626ea33911e6bbc6d7b,1,0,2,2,1,2008-08-28 19:28:31,2008-08-28 19:28:31
f96b1249cedc2c2b5303b626ea33911e6bbc6d7b...195420259a5286cbeface8ef7d0570e5e8d651e0,1,2,2,4,2,2008-08-28 19:28:45,2008-08-28 19:28:45
195420259a5286cbeface8ef7d0570e5e8d651e0...9f59fc5560ae4ae1d6b73996393caae2314fd414,2,5,1,6,2,2008-08-28 19:38:56,2008-08-28 19:38:56
9f59fc5560ae4ae1d6b73996393caae2314fd414...7b653025679a6bed643a792b1ac04abc2d1c3095,1,1,1,2,1,2008-08-28 19:46:33,2008-08-28 19:46:33
7b653025679a6bed643a792b1ac04abc2d1c3095...9348c118dae5d6672069802af522825a5cd3b4a3,4,681,781,1462,172,2008-08-28 19:54:43,2008-08-28 19:54:43
9348c118dae5d6672069802af522825a5cd3b4a3...0c66bac4f3d6464f315353aea3de928c8bb5459f,3,5,4,9,5,2008-08-28 20:17:31,2008-08-28 20:17:31
0c66bac4f3d6464f315353aea3de928c8bb5459f...503fda43fa534517585953660ca13b98d19c8e10,1,1,1,2,1,2008-08-28 20:20:40,2008-08-28 20:20:40
503fda43fa534517585953660ca13b98d19c8e10...fe8e00ae06f618ba001d8b0fea34d7846602bdc6,1,4,2,6,1,2008-08-28 20:48:59,2008-08-28 20:48:59
fe8e00ae06f618ba001d8b0fea34d7846602bdc6...a41ca9c9e284628c81f0a9b5a652a03ddbdd7521,4,55,1,56,5,2008-08-28 20:58:10,2008-08-28 20:58:10
a41ca9c9e284628c81f0a9b5a652a03ddbdd7521...8d8236385f278410e38bd53538e7c53c377c4a38,2,374,448,822,90,2008-08-28 21:02:05,2008-08-28 21:02:05
8d8236385f278410e38bd53538e7c53c377c4a38...fc2978cc45f0fe6d596e7043dc41f4a0b56613bb,1,1,1,2,1,2008-08-28 21:23:21,2008-08-28 21:23:21
fc2978cc45f0fe6d596e7043dc41f4a0b56613bb...52914fbf5ae237d7c903f5236e7eed833680367c,1,15,0,15,1,2008-08-28 21:39:17,2008-08-28 21:39:17
52914fbf5ae237d7c903f5236e7eed833680367c...e3b178ede3f9879c0f27d31cb6b2db08dfec89f0,2,80,56,136,47,2008-08-28 22:58:19,2008-08-28 22:58:19
e3b178ede3f9879c0f27d31cb6b2db08dfec89f0...6e841ca7670dac5be34ecfdcad5af2b6a50d6017,2,73,49,122,45,2008-08-28 22:59:23,2008-08-28 22:59:23
6e841ca7670dac5be34ecfdcad5af2b6a50d6017...02f86a1c7c240b80c486269e3b16131a7b44d637,2,41,8,49,11,2008-08-29 01:44:11,2008-08-29 01:44:11
02f86a1c7c240b80c486269e3b16131a7b44d637...d22ee35ee9193e17e31125b722ac5bb9b3ac7d82,1,6,1,7,2,2008-08-29 01:44:15,2008-08-29 01:44:15
d22ee35ee9193e17e31125b722ac5bb9b3ac7d82...a1d2f6ef0cfd48c9999edfd8b24766257f58d2d5,1,9,3,12,4,2008-08-29 02:40:50,2008-08-29 02:40:50
a1d2f6ef0cfd48c9999edfd8b24766257f58d2d5...54f41e3507bee76b5e1556b25ddbb57c47c8b84b,2,44,0,44,3,2008-08-29 02:40:56,2008-08-29 02:40:56
54f41e3507bee76b5e1556b25ddbb57c47c8b84b...90279aeaf07222dd7388956bfd465d30365087a5,1,43,1,44,2,2008-08-29 04:30:07,2008-08-29 04:30:07
90279aeaf07222dd7388956bfd465d30365087a5...e66b0ae57698614cc8ec238abc5dc65da63e676e,2,304,798,1102,179,2008-08-29 04:30:19,2008-08-29 04:30:19
e66b0ae57698614cc8ec238abc5dc65da63e676e...2dba41056fab71c4b0a111df77b8a51c1a4ca993,1,119,6,125,6,2008-08-29 05:04:26,2008-08-29 05:04:26
2dba41056fab71c4b0a111df77b8a51c1a4ca993...6ebbf7ac96b29bb9d2d3b4de07991a17d199161b,1,2,2,4,2,2008-08-29 05:15:49,2008-08-29 05:15:49
6ebbf7ac96b29bb9d2d3b4de07991a17d199161b...7f055554e0732bfbf771a58fde16e9f55ab50da2,2,148,685,833,109,2008-08-29 06:53:02,2008-08-29 06:53:02
7f055554e0732bfbf771a58fde16e9f55ab50da2...b5da9e8b2df6d001cfed5cec171011336f15b281,1,1,1,2,1,2008-08-29 15:45:23,2008-08-29 15:45:23
b5da9e8b2df6d001cfed5cec171011336f15b281...89ccbabbfc0964886076fb3ef768a6e57d88e512,1,4,1,5,1,2008-08-29 16:07:19,2008-08-29 16:07:19
89ccbabbfc0964886076fb3ef768a6e57d88e512...21928f2ba01c5411c57720eec82f7ad8658ed733,2,19,1,20,2,2008-08-29 16:09:29,2008-08-29 16:09:29
21928f2ba01c5411c57720eec82f7ad8658ed733...15416a90163d03e8b2253a1a52d3480c79744b9f,2,5,1,6,2,2008-08-29 16:13:17,2008-08-29 16:13:17
15416a90163d03e8b2253a1a52d3480c79744b9f...d95466b7a0ea5151047e95a23e51f6ff7b659349,2,58,37,95,39,2008-08-29 16:28:52,2008-08-29 16:28:52
d95466b7a0ea5151047e95a23e51f6ff7b659349...8cfecbd748f4b1ed6e3663ec0cc5bb37339439ae,1,1,2,3,2,2008-08-29 16:31:00,2008-08-29 16:31:00
8cfecbd748f4b1ed6e3663ec0cc5bb37339439ae...ddf7d7ab0257c6a6dc9ea141cba4b437431a85d1,1,10,5,15,2,2008-08-29 16:32:44,2008-08-29 16:32:44
ddf7d7ab0257c6a6dc9ea141cba4b437431a85d1...cd0b65bcf79dc61481d94a415a1598bb510d21c9,2,28,3,31,4,2008-08-29 16:46:46,2008-08-29 16:46:46
cd0b65bcf79dc61481d94a415a1598bb510d21c9...6a8dcafb575c3b0147223c04e7ccae553c0c9a49,2,15,2,17,2,2008-08-29 16:49:19,2008-08-29 16:49:19
6a8dcafb575c3b0147223c04e7ccae553c0c9a49...c113133daddacb7abde8e5e6514d0d7871d9f1d6,1,42,40,82,1,2008-08-29 17:02:06,2008-08-29 17:02:06
c113133daddacb7abde8e5e6514d0d7871d9f1d6...3717e3bba331af184a411a3781483aba8a11987a,2,8,41,49,11,2008-08-29 17:32:21,2008-08-29 17:32:21
3717e3bba331af184a411a3781483aba8a11987a...d57d490b76943afabf6df0159817d7a5756c0742,2,34,2,36,4,2008-08-29 17:41:40,2008-08-29 17:41:40
d57d490b76943afabf6df0159817d7a5756c0742...39986669c1711277fc2b66188cf9dc527644af36,1,1,0,1,1,2008-08-29 17:44:05,2008-08-29 17:44:05
39986669c1711277fc2b66188cf9dc527644af36...0e9ba0af36c1c817aae080947cf5728298256044,2,1041,1453,2494,362,2008-08-29 17:48:28,2008-08-29 17:48:28
0e9ba0af36c1c817aae080947cf5728298256044...8f0bdb14680f656c8352072e2668fb27a95c61ae,4,3753,1484,5237,383,2008-08-29 17:49:05,2008-08-29 17:49:05
8f0bdb14680f656c8352072e2668fb27a95c61ae...f2fd577bd5812e17696ed3342cf2c8d2ce2652c0,5,3453,2135,5588,655,2008-08-29 17:49:22,2008-08-29 17:49:22
f2fd577bd5812e17696ed3342cf2c8d2ce2652c0...ef7f61a35e7dfac0a6c00898f47f2255e0713508,2,3733,1851,5584,537,2008-08-29 18:09:10,2008-08-29 18:09:10
ef7f61a35e7dfac0a6c00898f47f2255e0713508...71076ae299500df32a5b416c65099fde80657040,1,1,1,2,1,2008-08-29 18:12:31,2008-08-29 18:12:31
71076ae299500df32a5b416c65099fde80657040...2ca8cf36280d427ca396f14029f22421539a1fce,1,1,12,13,2,2008-08-29 19:15:34,2008-08-29 19:15:34
2ca8cf36280d427ca396f14029f22421539a1fce...c068bc184c3c78b7bc9a1c5d43cc78c92bc41999,3,67,12,79,12,2008-08-29 19:28:03,2008-08-29 19:28:03
c068bc184c3c78b7bc9a1c5d43cc78c92bc41999...0871ff2c9c0745b203776467b9d6319adb7214fd,2,37,11,48,2,2008-08-29 19:28:53,2008-08-29 19:28:53
0871ff2c9c0745b203776467b9d6319adb7214fd...21adbd6738ba1489bbf38e08c2da808334e845e9,1,17,20,37,19,2008-08-29 19:29:16,2008-08-29 19:29:16
21adbd6738ba1489bbf38e08c2da808334e845e9...5c31c68560b6de7765293fe5f740ab77437e1fdf,1,1,1,2,1,2008-08-29 19:50:22,2008-08-29 19:50:22
5c31c68560b6de7765293fe5f740ab77437e1fdf...ae953a8c4e87172a3dfd37df3f5f6890ce9b00a7,1,1,0,1,1,2008-08-29 20:00:55,2008-08-29 20:00:55
ae953a8c4e87172a3dfd37df3f5f6890ce9b00a7...f04123f4dfbbf862e397b6e8c7a96aa5cd39ac1d,3,66,1,67,3,2008-08-29 21:24:00,2008-08-29 21:24:00
f04123f4dfbbf862e397b6e8c7a96aa5cd39ac1d...f3e088d2d98acfaaae59c09503a96d4e9c5b259a,4,788,1247,2035,648,2008-08-29 21:41:50,2008-08-29 21:41:50
f3e088d2d98acfaaae59c09503a96d4e9c5b259a...38362a12762d94e326a70fa5d1cce9ff2c80c0c5,1,1,1,2,1,2008-08-29 21:48:40,2008-08-29 21:48:40
38362a12762d94e326a70fa5d1cce9ff2c80c0c5...51836756d01ab8fb4d98d913c01b61d91962a806,2,7,1,8,2,2008-08-29 22:29:38,2008-08-29 22:29:38
51836756d01ab8fb4d98d913c01b61d91962a806...fb041b162096173b2a058dfa7dbc4a4639ceb324,2,430,293,723,175,2008-08-29 22:34:05,2008-08-29 22:34:05
fb041b162096173b2a058dfa7dbc4a4639ceb324...b2dd9c6fa12d7d24dbf97c1a3832c2bb9824c2b7,2,11,10,21,9,2008-08-29 22:37:22,2008-08-29 22:37:22
b2dd9c6fa12d7d24dbf97c1a3832c2bb9824c2b7...4184d6348ea6a016b9b835995dcaf93a8d0f5f82,1,2,2,4,2,2008-08-29 22:51:01,2008-08-29 22:51:01
4184d6348ea6a016b9b835995dcaf93a8d0f5f82...cc971910a94a8714f83cc6d23b9a6b87eed9a9a2,1,2,2,4,2,2008-08-29 23:03:12,2008-08-29 23:03:12
cc971910a94a8714f83cc6d23b9a6b87eed9a9a2...c60e22c073a46e4701a16ed473966a3d108841ba,2,126,90,216,82,2008-08-30 03:12:58,2008-08-30 03:12:58
c60e22c073a46e4701a16ed473966a3d108841ba...fd0cc45828e11e5e8936817e7a76c6bd5a8d0460,2,13,2,15,3,2008-08-30 04:52:56,2008-08-30 04:52:56
fd0cc45828e11e5e8936817e7a76c6bd5a8d0460...c0b53b3dcc817aa6522b4477f009e7c3bb83ae2e,2,2,3,5,2,2008-08-30 05:09:03,2008-08-30 05:09:03
c0b53b3dcc817aa6522b4477f009e7c3bb83ae2e...3a7fc0c7979d53119a7478ef4f614415710b51d7,1,14,1,15,2,2008-08-30 05:29:19,2008-08-30 05:29:19
3a7fc0c7979d53119a7478ef4f614415710b51d7...2c1166e66d422c66a9f73d7825c21986daddf7f6,1,1,1,2,1,2008-08-30 05:30:44,2008-08-30 05:30:44
2c1166e66d422c66a9f73d7825c21986daddf7f6...3fc6b10a0ecd047ae30447bc32b4bc9360e47e86,1,2,2,4,2,2008-08-30 05:32:28,2008-08-30 05:32:28
3fc6b10a0ecd047ae30447bc32b4bc9360e47e86...8af2831f5b1d155608d78614525a051fec315ebb,1,1,1,2,1,2008-08-30 05:34:04,2008-08-30 05:34:04
8af2831f5b1d155608d78614525a051fec315ebb...ac418c979f67101977be30c88fd540461e344cff,1,1,1,2,1,2008-08-30 05:35:18,2008-08-30 05:35:18
ac418c979f67101977be30c88fd540461e344cff...5f3a182357fd2e26db328498212a7f45529cec8f,1,2,1,3,2,2008-08-30 05:38:07,2008-08-30 05:38:07
5f3a182357fd2e26db328498212a7f45529cec8f...b02d2aba1cefc144a28e8c1c3e50de00d33d00f6,1,2,2,4,2,2008-08-30 05:39:34,2008-08-30 05:39:34
b02d2aba1cefc144a28e8c1c3e50de00d33d00f6...0a11c13acfc0700bfd435bac76fe2c8c5643779a,1,1,1,2,1,2008-08-30 06:02:14,2008-08-30 06:02:14
0a11c13acfc0700bfd435bac76fe2c8c5643779a...d73c9a5671b9ccc96b3d5e31a95902bd2288d091,1,6,0,6,1,2008-08-30 08:59:37,2008-08-30 08:59:37
d73c9a5671b9ccc96b3d5e31a95902bd2288d091...e47f5731beaa3d9d47b5350df9eeeb5d1750abef,2,116,82,198,76,2008-08-30 17:51:48,2008-08-30 17:51:48
e47f5731beaa3d9d47b5350df9eeeb5d1750abef...b08ee75dc15bd35478848db3f983d4c0856e7bbb,6,200,173,373,161,2008-08-30 17:52:11,2008-08-30 17:52:11
b08ee75dc15bd35478848db3f983d4c0856e7bbb...a90320032e4a531b1005bf74de9e927cadf67c39,4,1106,1270,2376,640,2008-08-30 17:52:31,2008-08-30 17:52:31
a90320032e4a531b1005bf74de9e927cadf67c39...395cd3b42c537f3701772df66930b88aceb917d7,1,29,56,85,24,2008-08-30 17:54:58,2008-08-30 17:54:58
395cd3b42c537f3701772df66930b88aceb917d7...ddaa3016e29e6813e2ea5b0c3b6c021a4976adba,4,47,47,94,40,2008-08-30 19:10:07,2008-08-30 19:10:07
ddaa3016e29e6813e2ea5b0c3b6c021a4976adba...f2d7ee759a8f17c70e8a924b6da30f86feee50ae,3,8,8,16,4,2008-08-30 19:25:40,2008-08-30 19:25:40
f2d7ee759a8f17c70e8a924b6da30f86feee50ae...7c65a316060f88a8604d51c7bc20945fae476c1a,1,1,0,1,1,2008-08-30 19:26:56,2008-08-30 19:26:56
7c65a316060f88a8604d51c7bc20945fae476c1a...15644cb255f673c07d9bafc3595edaaa4cdc3a90,6,94,10,104,14,2008-08-30 19:56:14,2008-08-30 19:56:14
15644cb255f673c07d9bafc3595edaaa4cdc3a90...1729d92f71694caad39d9ed3a31e1e287104e16f,1,8,0,8,3,2008-08-30 20:17:58,2008-08-30 20:17:58
1729d92f71694caad39d9ed3a31e1e287104e16f...eebc7caa6380096f5a8402db9a6e4a324585551b,2,56,15,71,6,2008-08-30 20:50:41,2008-08-30 20:50:41
eebc7caa6380096f5a8402db9a6e4a324585551b...ae72e25b354f6cc185eeb42a81ac79b83c5a636c,3,22,3,25,5,2008-08-30 21:30:02,2008-08-30 21:30:02
ae72e25b354f6cc185eeb42a81ac79b83c5a636c...a40a32e52acdd4225d24622f8b93e239c0b79785,2,350,912,1262,213,2008-08-30 22:24:24,2008-08-30 22:24:24
a40a32e52acdd4225d24622f8b93e239c0b79785...5e26fceb83150838ab9120075aac4c346ba82917,1,2,2,4,2,2008-08-31 07:54:31,2008-08-31 07:54:31
5e26fceb83150838ab9120075aac4c346ba82917...6ba55eee30de948f46f39afda2638f7504d63dd9,3,9,40,49,8,2008-08-31 08:55:08,2008-08-31 08:55:08
6ba55eee30de948f46f39afda2638f7504d63dd9...f2c80f93d96f0d35eba4297fd60a79eef6528738,1,8,7,15,2,2008-08-31 09:03:18,2008-08-31 09:03:18
f2c80f93d96f0d35eba4297fd60a79eef6528738...27f9b96fa0b57857cb660e56c66e3ede5dee8c18,5,176,19,195,21,2008-08-31 09:49:55,2008-08-31 09:49:55
27f9b96fa0b57857cb660e56c66e3ede5dee8c18...78ca7a6c073e07f311e37b45d8dfe7fce7465e06,3,285,6,291,6,2008-08-31 10:13:32,2008-08-31 10:13:32
78ca7a6c073e07f311e37b45d8dfe7fce7465e06...ce24a1f81d83f6d253798f717357686cb0a26571,1,6,4,10,1,2008-08-31 10:23:36,2008-08-31 10:23:36
ce24a1f81d83f6d253798f717357686cb0a26571...84ef4a9b1decce8e319359a018eef46a9556b630,3,9,1,10,4,2008-08-31 10:37:44,2008-08-31 10:37:44
84ef4a9b1decce8e319359a018eef46a9556b630...a63a83e5d88cd1696d1c40e89f254f69116c6800,8,482,115,597,23,2008-08-31 11:11:20,2008-08-31 11:11:20
a63a83e5d88cd1696d1c40e89f254f69116c6800...24bacb19dea298943f54155f911df380c73f9ea2,2,11,1,12,2,2008-08-31 11:39:06,2008-08-31 11:39:06
24bacb19dea298943f54155f911df380c73f9ea2...30c7ce90c5b518696859fc667aa2996d0e7a43e4,2,2,1,3,2,2008-08-31 17:13:29,2008-08-31 17:13:29
30c7ce90c5b518696859fc667aa2996d0e7a43e4...e1ea7014ad0a0f17c339fb1c1cc3e269ce87e31c,4,20,1,21,4,2008-08-31 17:20:40,2008-08-31 17:20:40
e1ea7014ad0a0f17c339fb1c1cc3e269ce87e31c...d05ebdb6491669faaf21d91633974d385129a951,2,11,4,15,4,2008-08-31 17:20:43,2008-08-31 17:20:43
d05ebdb6491669faaf21d91633974d385129a951...ec525e37199803a90ba39b9ab4c7acbe9abaf9b7,2,75,520,595,69,2008-08-31 17:27:12,2008-08-31 17:27:12
ec525e37199803a90ba39b9ab4c7acbe9abaf9b7...6390155f5c619d708b3dab877388c65ca65d5bcb,3,6,0,6,3,2008-08-31 17:29:49,2008-08-31 17:29:49
6390155f5c619d708b3dab877388c65ca65d5bcb...8f56d6d0178d916196550ae499bc7ee68b2144a1,1,0,0,0,0,2008-08-31 17:38:54,2008-08-31 17:38:54
8f56d6d0178d916196550ae499bc7ee68b2144a1...79968f986738f5fa23973d91a931f19f59bef269,1,22,16,38,15,2008-08-31 18:21:06,2008-08-31 18:21:06
79968f986738f5fa23973d91a931f19f59bef269...86316f0be6837e3359b63e48e518b4f7d5b4d78d,2,19,1,20,2,2008-08-31 18:28:06,2008-08-31 18:28:06
86316f0be6837e3359b63e48e518b4f7d5b4d78d...3e71a684b35066285034f05efed5bb83dc1cf644,2,348,800,1148,205,2008-08-31 19:43:49,2008-08-31 19:43:49
3e71a684b35066285034f05efed5bb83dc1cf644...4ae746b574a84e30a8be4f207c9f386fa09c03f9,3,103,0,103,5,2008-08-31 20:10:50,2008-08-31 20:10:50
4ae746b574a84e30a8be4f207c9f386fa09c03f9...3b6395370480f44f180c6287e70ea569cd20f0d4,2,36,1,37,4,2008-08-31 20:11:11,2008-08-31 20:11:11
3b6395370480f44f180c6287e70ea569cd20f0d4...8b11341a9a706f2a239d9e4eec1c093b4e93fecb,1,6,6,12,1,2008-08-31 20:11:28,2008-08-31 20:11:28
8b11341a9a706f2a239d9e4eec1c093b4e93fecb...4f5b0a321d0151cfdb06f31a679b118c29a2f713,1,8,3,11,1,2008-08-31 20:30:55,2008-08-31 20:30:55
4f5b0a321d0151cfdb06f31a679b118c29a2f713...d5119969012aa69b9b4ef345c7e0beb7d890509d,2,30,7,37,4,2008-08-31 21:14:46,2008-08-31 21:14:46
d5119969012aa69b9b4ef345c7e0beb7d890509d...ab13303ea44c51f09ccd26ddaee485ddf9c9b1d4,1,2,0,2,1,2008-08-31 21:24:33,2008-08-31 21:24:33
ab13303ea44c51f09ccd26ddaee485ddf9c9b1d4...7838493b9efa4ef17111599ed6bfaa05ed70645c,3,23,18,41,14,2008-08-31 22:47:25,2008-08-31 22:47:25
7838493b9efa4ef17111599ed6bfaa05ed70645c...653d21aa6e43177830681a0b24660c8c8d81eed5,4,1526,1361,2887,409,2008-08-31 23:27:34,2008-08-31 23:27:34
653d21aa6e43177830681a0b24660c8c8d81eed5...97ba591d87ec39bc461a1305e4dd318b7fb5231c,4,1135,1365,2500,545,2008-08-31 23:53:58,2008-08-31 23:53:58
97ba591d87ec39bc461a1305e4dd318b7fb5231c...8c2d788a681f6b4a737d016fd1c288ab31f4e02d,2,1142,978,2120,643,2008-08-31 23:59:36,2008-08-31 23:59:36
8c2d788a681f6b4a737d016fd1c288ab31f4e02d...032d6549671f9b981c163b1a9c19b9db72adfa3e,5,2678,2351,5029,681,2008-09-01 00:13:42,2008-09-01 00:13:42
032d6549671f9b981c163b1a9c19b9db72adfa3e...4480645ac3b4d3b72ee2880c774f849965d555d4,4,34,2,36,7,2008-09-01 00:49:03,2008-09-01 00:49:03
4480645ac3b4d3b72ee2880c774f849965d555d4...2d7feda05c45f38a04a6ee7ec93842cfea7aff43,3,97,1,98,3,2008-09-01 02:43:55,2008-09-01 02:43:55
2d7feda05c45f38a04a6ee7ec93842cfea7aff43...84e0264feec81e3d88bce4e760c10d8c7b404073,4,109,109,218,101,2008-09-01 05:21:43,2008-09-01 05:21:43
84e0264feec81e3d88bce4e760c10d8c7b404073...e3525b19aa9d89c700d0a8d37fd0a74d5be26cf1,4,129,111,240,103,2008-09-01 06:12:51,2008-09-01 06:12:51
e3525b19aa9d89c700d0a8d37fd0a74d5be26cf1...94da2b811810ae1dd93d3e6883d19e89085eee69,2,109,108,217,98,2008-09-01 07:52:17,2008-09-01 07:52:17
94da2b811810ae1dd93d3e6883d19e89085eee69...b085ccce6cc26a16d24e7f6a4649a39fc3237570,3,76,28,104,15,2008-09-01 09:32:41,2008-09-01 09:32:41
b085ccce6cc26a16d24e7f6a4649a39fc3237570...f88fb967bd5069034a6d6bdd26129a6dd1953185,1,3,10,13,10,2008-09-01 09:35:07,2008-09-01 09:35:07
f88fb967bd5069034a6d6bdd26129a6dd1953185...c176cf71ba81cf017c623d015a32bc265c1c6df6,2,123,103,226,97,2008-09-01 09:38:02,2008-09-01 09:38:02
c176cf71ba81cf017c623d015a32bc265c1c6df6...7b70bf9ea60310e1157b19a52339daa4cc0a81da,2,3,5,8,3,2008-09-01 09:40:57,2008-09-01 09:40:57
7b70bf9ea60310e1157b19a52339daa4cc0a81da...82e2f9bb984236de70aec842003b2442853139e9,1,4,2,6,2,2008-09-01 09:42:15,2008-09-01 09:42:15
82e2f9bb984236de70aec842003b2442853139e9...a72eae0be7644fdfb75e28ad82c07d2db80210b4,4,5,5,10,5,2008-09-01 09:45:30,2008-09-01 09:45:30
a72eae0be7644fdfb75e28ad82c07d2db80210b4...823263429ff63701c843aa35edfff1cc7ede3910,0,0,0,0,0,2008-09-01 11:34:22,2008-09-01 11:34:22
823263429ff63701c843aa35edfff1cc7ede3910...f55b834c2f49a2e07e38a5c8ec7e88a8237ab98e,3,26,1,27,4,2008-09-01 12:07:26,2008-09-01 12:07:26
f55b834c2f49a2e07e38a5c8ec7e88a8237ab98e...36ece38c07b636fbb211120d6566bb5572c3f5e0,2,659,1245,1904,708,2008-09-01 13:15:14,2008-09-01 13:15:14
36ece38c07b636fbb211120d6566bb5572c3f5e0...733765a0626aa552d5b9b4bd42fbf9fc74f9f4aa,2,356,842,1198,223,2008-09-01 13:21:15,2008-09-01 13:21:15
733765a0626aa552d5b9b4bd42fbf9fc74f9f4aa...587d3d7f79eff20468d71f56bdf22195d41b58e3,4,254,356,610,139,2008-09-01 13:23:10,2008-09-01 13:23:10
587d3d7f79eff20468d71f56bdf22195d41b58e3...3686fc189ad0867785edd8bae3061ccb5c45553d,2,2,2,4,1,2008-09-01 13:28:22,2008-09-01 13:28:22
3686fc189ad0867785edd8bae3061ccb5c45553d...429c87fef81f12fa0b6e3e8cf20ae06c67ca7e4d,1,7,0,7,1,2008-09-01 17:22:34,2008-09-01 17:22:34
429c87fef81f12fa0b6e3e8cf20ae06c67ca7e4d...a3196dac481410cf6fa7796cfe3b179df2d6a935,2,4,2,6,4,2008-09-01 17:23:09,2008-09-01 17:23:09
a3196dac481410cf6fa7796cfe3b179df2d6a935...15206298edfd988922654293e1c4cc91cd687044,1,0,7,7,1,2008-09-01 17:38:59,2008-09-01 17:38:59
15206298edfd988922654293e1c4cc91cd687044...e545058ba94f5f5736a5db82e6ba5883d8071485,2,25,2,27,5,2008-09-01 17:48:39,2008-09-01 17:48:39
e545058ba94f5f5736a5db82e6ba5883d8071485...cf7a078774dbcfa0fa2e286fd7907e15478d55d3,1,3,2,5,2,2008-09-01 17:56:22,2008-09-01 17:56:22
cf7a078774dbcfa0fa2e286fd7907e15478d55d3...5f31e9bd33269484689d5d5f078a979f71edcade,1,1,1,2,1,2008-09-01 18:45:49,2008-09-01 18:45:49
5f31e9bd33269484689d5d5f078a979f71edcade...ea05e61b2b8c0c9e5e10faa3f738b09b5f59adf1,5,229,11,240,17,2008-09-01 19:08:08,2008-09-01 19:08:08
ea05e61b2b8c0c9e5e10faa3f738b09b5f59adf1...d7e9bb0571a51e4c26e525c8539c510418f670d3,2,17,5,22,4,2008-09-01 19:20:03,2008-09-01 19:20:03
d7e9bb0571a51e4c26e525c8539c510418f670d3...7ecdf47bd03c81fcea896fea4644c05aa28a0e57,1,2,0,2,1,2008-09-01 19:35:03,2008-09-01 19:35:03
7ecdf47bd03c81fcea896fea4644c05aa28a0e57...c887d71e761bb2cd7c1ed7c12977938c4cc6cd09,1,3,0,3,1,2008-09-01 19:37:48,2008-09-01 19:37:48
c887d71e761bb2cd7c1ed7c12977938c4cc6cd09...9b7dc6a3d615cf5d1dddc9724c1567f6df555838,2,40,34,74,35,2008-09-01 19:41:50,2008-09-01 19:41:50
9b7dc6a3d615cf5d1dddc9724c1567f6df555838...d2f420ec8a9c49f1a9bd3a779ca84a2cd387934c,1,1,1,2,1,2008-09-01 19:58:41,2008-09-01 19:58:41
d2f420ec8a9c49f1a9bd3a779ca84a2cd387934c...7239429851712ac2fc4d4657e5f2477cd2c45994,2,42,39,81,38,2008-09-01 20:17:00,2008-09-01 20:17:00
7239429851712ac2fc4d4657e5f2477cd2c45994...89633c3077e116ef2fd7f157eef3ffcdc3b14c7f,1,1,1,2,2,2008-09-01 20:25:16,2008-09-01 20:25:16
89633c3077e116ef2fd7f157eef3ffcdc3b14c7f...b4d3f4e00420aee5167036d43752445b0959477d,2,174,153,327,120,2008-09-01 20:45:34,2008-09-01 20:45:34
b4d3f4e00420aee5167036d43752445b0959477d...d5cc16b47154e3788db5d38a39de70aef557eebb,2,43,1,44,3,2008-09-01 21:04:01,2008-09-01 21:04:01
d5cc16b47154e3788db5d38a39de70aef557eebb...ca7db155aa32d659c5fc0fc01a50e844af798845,1,1,1,2,1,2008-09-01 21:16:17,2008-09-01 21:16:17
ca7db155aa32d659c5fc0fc01a50e844af798845...7c7ad041b358a9819b3bd9f93d4834df4a5b5d57,6,149,22,171,31,2008-09-01 21:28:32,2008-09-01 21:28:32
7c7ad041b358a9819b3bd9f93d4834df4a5b5d57...2487e3ae37864eb41c532c46ef7e3189ec910ca2,1,1,1,2,1,2008-09-01 21:33:15,2008-09-01 21:33:15
2487e3ae37864eb41c532c46ef7e3189ec910ca2...4f225d44ce3be03db2c36786f76c80d5bc449f3b,2,95,89,184,87,2008-09-01 22:05:18,2008-09-01 22:05:18
4f225d44ce3be03db2c36786f76c80d5bc449f3b...3a18002bbd3b08fb3ee40d681bdda1a39eb0ad9c,14,53,48,101,27,2008-09-01 22:15:35,2008-09-01 22:15:35
3a18002bbd3b08fb3ee40d681bdda1a39eb0ad9c...d86a702d37784c6f4b91f65c1a795b47144e5598,1,2,2,4,2,2008-09-01 22:22:12,2008-09-01 22:22:12
d86a702d37784c6f4b91f65c1a795b47144e5598...fc4948d5747c9e64d0b51f481ebcb76f4c433deb,1,10,10,20,5,2008-09-01 22:28:18,2008-09-01 22:28:18
fc4948d5747c9e64d0b51f481ebcb76f4c433deb...dcb0e8f959148331cde89def02ce28be3b248039,1,6,4,10,2,2008-09-01 22:32:40,2008-09-01 22:32:40
dcb0e8f959148331cde89def02ce28be3b248039...ce47d4ab830bb96fe9325b9ccd077619116fd548,7,108,27,135,33,2008-09-01 22:43:38,2008-09-01 22:43:38
ce47d4ab830bb96fe9325b9ccd077619116fd548...eefec151d1443dfadaf0ef24f7422d4f22f52b43,1,2,0,2,2,2008-09-01 22:59:43,2008-09-01 22:59:43
eefec151d1443dfadaf0ef24f7422d4f22f52b43...a9465a75de3d233df1a5e03b35835590369b1a30,3,3,0,3,3,2008-09-01 23:03:03,2008-09-01 23:03:03
a9465a75de3d233df1a5e03b35835590369b1a30...502fc3ae56fe5ba6f45547d1b4369aa16239f2d8,1,2,2,4,2,2008-09-01 23:06:39,2008-09-01 23:06:39
502fc3ae56fe5ba6f45547d1b4369aa16239f2d8...6211527fa289f9de589b8f0bd7e17dedc93cfbf5,1,4,0,4,1,2008-09-01 23:18:42,2008-09-01 23:18:42
6211527fa289f9de589b8f0bd7e17dedc93cfbf5...a47bffad177f11c79850c53bc5289ca5a4688c04,1,1,1,2,1,2008-09-01 23:57:55,2008-09-01 23:57:55
a47bffad177f11c79850c53bc5289ca5a4688c04...1b615ac46dc496f97b14feaa0bd3e664bc3b4120,1,2,1,3,1,2008-09-02 00:20:10,2008-09-02 00:20:10
1b615ac46dc496f97b14feaa0bd3e664bc3b4120...c7a10b677d51d5f76491011702e08588c9c63777,2,5,8,13,2,2008-09-02 00:26:28,2008-09-02 00:26:28
c7a10b677d51d5f76491011702e08588c9c63777...3cdfb47e9315672cdf06443b32feb62e1f0c0d42,1,1,1,2,1,2008-09-02 00:50:19,2008-09-02 00:50:19
3cdfb47e9315672cdf06443b32feb62e1f0c0d42...12f625990392d49018d0397a7c7bf55286f9b212,3,49,8,57,10,2008-09-02 02:16:41,2008-09-02 02:16:41
12f625990392d49018d0397a7c7bf55286f9b212...ffd47e7383cb93e674bbfc48b29b963d8f4fc934,4,249,243,492,123,2008-09-02 02:35:29,2008-09-02 02:35:29
ffd47e7383cb93e674bbfc48b29b963d8f4fc934...0ac2e3dd83e03630eac2505d9601c2774cac2abc,4,227,260,487,138,2008-09-02 02:35:40,2008-09-02 02:35:40
0ac2e3dd83e03630eac2505d9601c2774cac2abc...1a9ed22d0657fa5dc6b20002c77478206eead0a5,2,67,61,128,62,2008-09-02 02:41:45,2008-09-02 02:41:45
1a9ed22d0657fa5dc6b20002c77478206eead0a5...91e646aa747fa15be065c89e488b3dbd0d34d11e,2,77,65,142,67,2008-09-02 02:41:55,2008-09-02 02:41:55
91e646aa747fa15be065c89e488b3dbd0d34d11e...51195f75dcb240fa8e9712e097779ca4ba18dbf9,4,2736,882,3618,526,2008-09-02 02:45:54,2008-09-02 02:45:54
51195f75dcb240fa8e9712e097779ca4ba18dbf9...c57c495a194ab388c5bb1ecb2eef1d95bdf17bb1,2,142,136,278,126,2008-09-02 02:47:55,2008-09-02 02:47:55
c57c495a194ab388c5bb1ecb2eef1d95bdf17bb1...4aa07149165fc212558b51c8f7ec38c49e1f9a0c,2,106,100,206,96,2008-09-02 02:49:04,2008-09-02 02:49:04
4aa07149165fc212558b51c8f7ec38c49e1f9a0c...54e02cc92be7f89ee625307b03904dfa93fceab4,2,100,94,194,93,2008-09-02 02:50:23,2008-09-02 02:50:23
54e02cc92be7f89ee625307b03904dfa93fceab4...63c9b7bf06f37268ae1dcb3e90232adce9441085,1,3,2,5,3,2008-09-02 03:04:28,2008-09-02 03:04:28
63c9b7bf06f37268ae1dcb3e90232adce9441085...c435975cc779a4549591a1c2b32e91f409c33757,1,9,9,18,9,2008-09-02 03:07:26,2008-09-02 03:07:26
c435975cc779a4549591a1c2b32e91f409c33757...64a94691277db17e87614f125d8da78a9995076b,47,303,232,535,166,2008-09-02 03:40:42,2008-09-02 03:40:42
64a94691277db17e87614f125d8da78a9995076b...67e141a7cdf971703ee24aeae80e3e5161d1c6a4,4,74,71,145,69,2008-09-02 05:27:35,2008-09-02 05:27:35
67e141a7cdf971703ee24aeae80e3e5161d1c6a4...0cd5caa6a853bc12d6b09aba08e9d70f1d59c667,2,24,10,34,6,2008-09-02 06:10:14,2008-09-02 06:10:14
0cd5caa6a853bc12d6b09aba08e9d70f1d59c667...e0a7a9225eeb275458594fc08f65b5081916d9fb,4,101,95,196,94,2008-09-02 06:49:06,2008-09-02 06:49:06
e0a7a9225eeb275458594fc08f65b5081916d9fb...3b7c57587cbe42b7b831a87361a1069cf0406d1f,2,147,145,292,131,2008-09-02 07:45:45,2008-09-02 07:45:45
3b7c57587cbe42b7b831a87361a1069cf0406d1f...e276ad010929cd3ba96456f4eff215eb25a3056c,2,101,96,197,94,2008-09-02 07:46:19,2008-09-02 07:46:19
e276ad010929cd3ba96456f4eff215eb25a3056c...cf5087fdb2333810ef1d1a5051e13a3d0d4c50aa,4,118,115,233,113,2008-09-02 08:35:22,2008-09-02 08:35:22
cf5087fdb2333810ef1d1a5051e13a3d0d4c50aa...f31425e8e23621fd4329c7377c9e220f526a1c49,6,211,9,220,12,2008-09-02 09:04:54,2008-09-02 09:04:54
f31425e8e23621fd4329c7377c9e220f526a1c49...2a14acb5f4d6c1797c4af6f943fcc3723ddec426,2,3224,1644,4868,483,2008-09-02 10:19:07,2008-09-02 10:19:07
2a14acb5f4d6c1797c4af6f943fcc3723ddec426...5c32fe7fad5c52fb5b62dc97503aed516bb9c668,1,46,39,85,11,2008-09-02 13:52:07,2008-09-02 13:52:07
5c32fe7fad5c52fb5b62dc97503aed516bb9c668...98e1cc92f47cbda977a923b9ba8d980bc01cd749,2,20,2,22,3,2008-09-02 14:20:11,2008-09-02 14:20:11
98e1cc92f47cbda977a923b9ba8d980bc01cd749...79d2ee3b6d405674a2a49f0884312a8cdc82d809,4,42,8,50,10,2008-09-02 15:26:00,2008-09-02 15:26:00
79d2ee3b6d405674a2a49f0884312a8cdc82d809...1156db790a27975108cb78cd49f0ee549a7da739,4,715,2,717,6,2008-09-02 16:27:47,2008-09-02 16:27:47
1156db790a27975108cb78cd49f0ee549a7da739...23f012dbfad47849ef6c8d9bf3181eb29cacb3e9,11,31,47,78,25,2008-09-02 16:42:13,2008-09-02 16:42:13
23f012dbfad47849ef6c8d9bf3181eb29cacb3e9...b1f5ed00cbe1d538d3ffba0a9677330f2bca480f,1,98,0,98,1,2008-09-02 16:47:45,2008-09-02 16:47:45
b1f5ed00cbe1d538d3ffba0a9677330f2bca480f...24d7b498499bc09b0aa13015569044d7d8c97cf1,2,4,2,6,2,2008-09-02 16:52:42,2008-09-02 16:52:42
24d7b498499bc09b0aa13015569044d7d8c97cf1...326b26656aa3770be99da88dd76e7eb9c73d1dc5,1,3,3,6,2,2008-09-02 17:13:39,2008-09-02 17:13:39
326b26656aa3770be99da88dd76e7eb9c73d1dc5...c1de41f4d29d15616075ffd474e3aba7adcfc64f,4,54,1,55,8,2008-09-02 17:26:24,2008-09-02 17:26:24
c1de41f4d29d15616075ffd474e3aba7adcfc64f...bc768e2b471b707bfbb234c21066a4b0cbbe9258,3,108,103,211,40,2008-09-02 17:33:51,2008-09-02 17:33:51
bc768e2b471b707bfbb234c21066a4b0cbbe9258...7163fe4d96f7241b9435e91598261f473c098a3a,1,23,0,23,1,2008-09-02 17:57:02,2008-09-02 17:57:02
7163fe4d96f7241b9435e91598261f473c098a3a...a658d45a6c11798cd7d848d2d7aacde18ca173c0,1,52,8,60,6,2008-09-02 17:57:18,2008-09-02 17:57:18
a658d45a6c11798cd7d848d2d7aacde18ca173c0...e00aa16e24c55ed52d97a3adb31ce8d93ceb739e,1,8,2,10,4,2008-09-02 18:38:55,2008-09-02 18:38:55
e00aa16e24c55ed52d97a3adb31ce8d93ceb739e...58e3ef76dbe3eaa4df8416f3516c9e7dc9a1c5ff,3,133,67,200,12,2008-09-02 18:45:33,2008-09-02 18:45:33
58e3ef76dbe3eaa4df8416f3516c9e7dc9a1c5ff...577640bd04117573805d8b9ffa4670b999714db4,1,8,1,9,1,2008-09-02 18:57:10,2008-09-02 18:57:10
577640bd04117573805d8b9ffa4670b999714db4...5ff51f6bb3042a70c2167de7399ef7a62614d50f,1,2,2,4,1,2008-09-02 19:04:33,2008-09-02 19:04:33
5ff51f6bb3042a70c2167de7399ef7a62614d50f...6656642d363471c1c35bf7c1a989f1a0d46c60b3,1,1,1,2,1,2008-09-02 19:08:31,2008-09-02 19:08:31
6656642d363471c1c35bf7c1a989f1a0d46c60b3...e997a1c3df8d41f8f7a9063869469656fa04b98e,1,187,4,191,5,2008-09-02 19:19:20,2008-09-02 19:19:20
e997a1c3df8d41f8f7a9063869469656fa04b98e...7a9b55ddc4d49775a696d1d34629ebbad2499fa3,4,7,7,14,9,2008-09-02 19:25:27,2008-09-02 19:25:27
7a9b55ddc4d49775a696d1d34629ebbad2499fa3...f6a3652eb23b54948d3386231fb9781031092eb0,2,6,6,12,4,2008-09-02 19:33:56,2008-09-02 19:33:56
f6a3652eb23b54948d3386231fb9781031092eb0...0a7e454fa280fb57061ab542d743fcecb4bdd451,1,1,1,2,1,2008-09-02 19:34:20,2008-09-02 19:34:20
0a7e454fa280fb57061ab542d743fcecb4bdd451...b13276b1ffab0abdf73aca5681fbe7dca0bf3663,1,1,1,2,1,2008-09-02 19:45:06,2008-09-02 19:45:06
b13276b1ffab0abdf73aca5681fbe7dca0bf3663...ecb5f4c6930b08fd91faa1c112eb210d8ca04902,1,11,0,11,1,2008-09-02 19:49:23,2008-09-02 19:49:23
ecb5f4c6930b08fd91faa1c112eb210d8ca04902...0e5faf225c5cd1acf2ab653c74f5b161470403b9,4,19,112,131,33,2008-09-02 21:10:00,2008-09-02 21:10:00
0e5faf225c5cd1acf2ab653c74f5b161470403b9...85ebb91846fd5bb1a766d1bed905d6f60667274c,4,80,28,108,23,2008-09-03 00:09:33,2008-09-03 00:09:33
85ebb91846fd5bb1a766d1bed905d6f60667274c...c71a2d68974ef8d800d848d20622d73fb431ce37,1,2,0,2,2,2008-09-03 00:09:38,2008-09-03 00:09:38
c71a2d68974ef8d800d848d20622d73fb431ce37...c30494b61624455d778baad2828eb25abefa37ee,1,2,1,3,3,2008-09-03 00:09:45,2008-09-03 00:09:45
c30494b61624455d778baad2828eb25abefa37ee...d8b56ecbf6156485858999f923982d036e9f00e8,1,4,1,5,1,2008-09-03 00:09:52,2008-09-03 00:09:52
d8b56ecbf6156485858999f923982d036e9f00e8...67813c65e19399d26a5efe7cec81a7081806012b,1,1,1,2,1,2008-09-03 00:20:17,2008-09-03 00:20:17
67813c65e19399d26a5efe7cec81a7081806012b...a04c6b13219f9fb6ffb1bd1d3c53e5b54de4d2b7,2,85,89,174,80,2008-09-03 01:17:42,2008-09-03 01:17:42
a04c6b13219f9fb6ffb1bd1d3c53e5b54de4d2b7...146f2aa667176d0ebbe828b5917ac38bc23661a1,4,41,45,86,37,2008-09-03 02:37:43,2008-09-03 02:37:43
146f2aa667176d0ebbe828b5917ac38bc23661a1...7515ae1fe090a4b14a23da2a70c2da0f66146b85,2,49,53,102,45,2008-09-03 02:39:13,2008-09-03 02:39:13
7515ae1fe090a4b14a23da2a70c2da0f66146b85...b019a880734b10f38c4dd53d0a77562142f32f19,2,1561,1366,2927,439,2008-09-03 02:39:25,2008-09-03 02:39:25
b019a880734b10f38c4dd53d0a77562142f32f19...4ff1819e28f80d4d0678cf8ec89a21ba43e3bd18,4,48,52,100,43,2008-09-03 02:41:29,2008-09-03 02:41:29
4ff1819e28f80d4d0678cf8ec89a21ba43e3bd18...f5c80ba9394bdd631604dc91b6654a9dd3bbcf64,2,84,87,171,81,2008-09-03 02:42:52,2008-09-03 02:42:52
f5c80ba9394bdd631604dc91b6654a9dd3bbcf64...735337c771d7a89f89cddb45d90c5bdfca1ee883,2,386,871,1257,264,2008-09-03 02:44:54,2008-09-03 02:44:54
735337c771d7a89f89cddb45d90c5bdfca1ee883...d2ca6fd54eace38b8ecee8341ad88b1f9284b37f,2,2,4,6,2,2008-09-03 02:49:06,2008-09-03 02:49:06
d2ca6fd54eace38b8ecee8341ad88b1f9284b37f...61cc4a1eeefe734e258c968293529ab070d4d76a,2,10,1,11,2,2008-09-03 03:48:25,2008-09-03 03:48:25
61cc4a1eeefe734e258c968293529ab070d4d76a...8a54b1b01bcbb780c763e705e860fdd13c935f89,3,22,22,44,22,2008-09-03 03:53:20,2008-09-03 03:53:20
8a54b1b01bcbb780c763e705e860fdd13c935f89...4431b9df6c4d423c10a6d75b199ec08e3e5e6c8c,2,112,114,226,83,2008-09-03 03:53:31,2008-09-03 03:53:31
4431b9df6c4d423c10a6d75b199ec08e3e5e6c8c...2b06802f69370e0ab0126b5a849bc53e7a63219b,2,38,42,80,34,2008-09-03 03:56:54,2008-09-03 03:56:54
2b06802f69370e0ab0126b5a849bc53e7a63219b...1d1bfd24f8dd26d3a6bf892611f3e58d45f4c1c3,2,38,42,80,34,2008-09-03 03:57:05,2008-09-03 03:57:05
1d1bfd24f8dd26d3a6bf892611f3e58d45f4c1c3...42393ff604cca9aa20daae56ea3fef21548c1551,3,5,2,7,4,2008-09-03 04:22:39,2008-09-03 04:22:39
42393ff604cca9aa20daae56ea3fef21548c1551...87da9cd7594f9b95270087d24d816a51eaecf4a3,1,1,1,2,1,2008-09-03 04:40:52,2008-09-03 04:40:52
87da9cd7594f9b95270087d24d816a51eaecf4a3...a92d511a17e2ff2069d96649775569383d983e59,1,1,1,2,1,2008-09-03 04:42:49,2008-09-03 04:42:49
a92d511a17e2ff2069d96649775569383d983e59...aea34087ef45b49945159101b77a161c4aa91ec7,1,1,1,2,1,2008-09-03 04:43:57,2008-09-03 04:43:57
aea34087ef45b49945159101b77a161c4aa91ec7...43f901e581c7ab5707038eaff0bc90c59cc29be1,4,1317,1137,2454,471,2008-09-03 05:42:08,2008-09-03 05:42:08
43f901e581c7ab5707038eaff0bc90c59cc29be1...780f239fa7f8223c6e1513243584dda87d1acc3a,2,18,7,25,8,2008-09-03 05:53:50,2008-09-03 05:53:50
780f239fa7f8223c6e1513243584dda87d1acc3a...fd78e89d1e36d954960bf97998254c2a3c5f4d56,3,40,44,84,36,2008-09-03 06:14:01,2008-09-03 06:14:01
fd78e89d1e36d954960bf97998254c2a3c5f4d56...fd1d986bb115db44ddd242ca1f7f73c604b60b18,2,23,0,23,2,2008-09-03 06:14:13,2008-09-03 06:14:13
fd1d986bb115db44ddd242ca1f7f73c604b60b18...1794446b28981a6c6418eb05445fcc44990e43a9,1,1,1,2,1,2008-09-03 06:22:28,2008-09-03 06:22:28
1794446b28981a6c6418eb05445fcc44990e43a9...57d874b207c0f68f76eec03b364f54e6becadb10,2,142,137,279,125,2008-09-03 07:11:31,2008-09-03 07:11:31
57d874b207c0f68f76eec03b364f54e6becadb10...4b38af152d391ab626911edc00c2939b5af219b5,2,22,18,40,13,2008-09-03 07:22:07,2008-09-03 07:22:07
4b38af152d391ab626911edc00c2939b5af219b5...d1bfa02320fb26738b9949955bca94f2773ee08d,2,52,52,104,36,2008-09-03 07:25:29,2008-09-03 07:25:29
d1bfa02320fb26738b9949955bca94f2773ee08d...7b3843ca7e75ff5918ef28f7babebacde2466cb0,2,86,88,174,82,2008-09-03 08:18:54,2008-09-03 08:18:54
7b3843ca7e75ff5918ef28f7babebacde2466cb0...20147a33c7a81ddf6953b17648a9659bbced703c,2,84,88,172,80,2008-09-03 08:52:59,2008-09-03 08:52:59
20147a33c7a81ddf6953b17648a9659bbced703c...116e17414b2bdde4aa39177becda52065079a68b,2,46,50,96,42,2008-09-03 11:35:57,2008-09-03 11:35:57
116e17414b2bdde4aa39177becda52065079a68b...58c58cf1caed680383dc3f1c8937eac90c4fa004,2,5,5,10,5,2008-09-03 11:40:37,2008-09-03 11:40:37
58c58cf1caed680383dc3f1c8937eac90c4fa004...574fe75984080e17ef6d42b217ca87097a417de8,2,56,56,112,47,2008-09-03 11:41:03,2008-09-03 11:41:03
574fe75984080e17ef6d42b217ca87097a417de8...760aaae7498d81a4cabccacb5aacee28aa08d6af,4,3226,2139,5365,630,2008-09-03 11:41:33,2008-09-03 11:41:33
760aaae7498d81a4cabccacb5aacee28aa08d6af...bb5e3a3b6d221edfb7bc0fdbf79898fc56762974,2,49,53,102,45,2008-09-03 11:45:53,2008-09-03 11:45:53
bb5e3a3b6d221edfb7bc0fdbf79898fc56762974...eea68d9ff45edffd386c00dd089f1f72b7e8076f,2,2,2,4,2,2008-09-03 12:52:51,2008-09-03 12:52:51
eea68d9ff45edffd386c00dd089f1f72b7e8076f...c164305d7cf3379adcccacdb4ed36a73600a3d1a,2,7,16,23,16,2008-09-03 13:40:14,2008-09-03 13:40:14
c164305d7cf3379adcccacdb4ed36a73600a3d1a...cd5a00b4e495ec05f56fae1cb6f944c758ba6185,1,2,2,4,2,2008-09-03 15:35:58,2008-09-03 15:35:58
cd5a00b4e495ec05f56fae1cb6f944c758ba6185...b0b73b3e0ee98a43c924ae2b1957234fa7971e55,1,1,1,2,1,2008-09-03 16:17:54,2008-09-03 16:17:54
b0b73b3e0ee98a43c924ae2b1957234fa7971e55...399abd7fe874e4c85ae50196d099712ff401f11e,1,1,1,2,1,2008-09-03 17:53:45,2008-09-03 17:53:45
399abd7fe874e4c85ae50196d099712ff401f11e...7bc5db3a8809e4a929cd7ae858d60572cf104637,1,3,3,6,3,2008-09-03 17:59:09,2008-09-03 17:59:09
7bc5db3a8809e4a929cd7ae858d60572cf104637...9a89d1eb9f0b651a5ead0c9d41817c6bce6e8c1a,2,27,27,54,26,2008-09-03 18:05:43,2008-09-03 18:05:43
9a89d1eb9f0b651a5ead0c9d41817c6bce6e8c1a...d88688014f7fca77fb18530d36dd77e10b4bcb82,2,23,3,26,7,2008-09-03 18:38:43,2008-09-03 18:38:43
d88688014f7fca77fb18530d36dd77e10b4bcb82...e1f1bda3c7e5e97ee4b703a06c9c764a80c3ddd8,1,1,1,2,1,2008-09-03 18:44:19,2008-09-03 18:44:19
e1f1bda3c7e5e97ee4b703a06c9c764a80c3ddd8...422ba9d2ae20358c48f29e50f49dffbc04cc2824,2,293,346,639,303,2008-09-03 18:47:22,2008-09-03 18:47:22
422ba9d2ae20358c48f29e50f49dffbc04cc2824...a1e9b98c541c4434ae83a8e445a5be066e20a960,1,2,0,2,1,2008-09-03 19:51:20,2008-09-03 19:51:20
a1e9b98c541c4434ae83a8e445a5be066e20a960...9d5e77d26db2afad52777321d7d650d911df5a34,4,208,83,291,4,2008-09-03 19:58:21,2008-09-03 19:58:21
9d5e77d26db2afad52777321d7d650d911df5a34...e62ab770540f4610fdd2d921f4d6d90c0aa46050,2,22,9,31,9,2008-09-03 19:58:34,2008-09-03 19:58:34
e62ab770540f4610fdd2d921f4d6d90c0aa46050...db29f06409fbc2e46f8ebf071563b23537d82604,3,3456,1999,5455,581,2008-09-03 20:05:15,2008-09-03 20:05:15
db29f06409fbc2e46f8ebf071563b23537d82604...c5d56be36565cc05189ffa5ad966eac690e67b8b,1,1,1,2,1,2008-09-03 20:14:57,2008-09-03 20:14:57
c5d56be36565cc05189ffa5ad966eac690e67b8b...d302be429bb22a47d26fd7744012fdf7176648ee,1,2,2,4,2,2008-09-03 20:21:31,2008-09-03 20:21:31
d302be429bb22a47d26fd7744012fdf7176648ee...5697f87914406b070d47bab45e0137337a0fb746,1,16,18,34,6,2008-09-03 20:23:18,2008-09-03 20:23:18
5697f87914406b070d47bab45e0137337a0fb746...62fc1553433b6b962ebf40d08f85a252de728af9,1,12,2,14,2,2008-09-03 20:27:54,2008-09-03 20:27:54
62fc1553433b6b962ebf40d08f85a252de728af9...26dd79c8aaea3a29bf64572090c26637f2f7f4b2,1,9,1,10,2,2008-09-03 20:30:52,2008-09-03 20:30:52
26dd79c8aaea3a29bf64572090c26637f2f7f4b2...dd75469d4feeb7e253dfb0bdefd46d4e017d15db,1,2,0,2,1,2008-09-03 20:35:31,2008-09-03 20:35:31
dd75469d4feeb7e253dfb0bdefd46d4e017d15db...8df158048c95b4ffe6258906ec5b52c458a796d1,1,2,2,4,2,2008-09-03 20:41:21,2008-09-03 20:41:21
8df158048c95b4ffe6258906ec5b52c458a796d1...ee28ee9311bb6e6d74d5c6cdaef7d7a20b6b6efe,2,106,68,174,40,2008-09-03 20:52:20,2008-09-03 20:52:20
ee28ee9311bb6e6d74d5c6cdaef7d7a20b6b6efe...7b0b992a87201c2913fe8478e2116d66a76558cc,5,23,16,39,9,2008-09-03 20:55:04,2008-09-03 20:55:04
7b0b992a87201c2913fe8478e2116d66a76558cc...d6f94676cbcf8d6e51cabd12ca4045148ad9d216,1,5,4,9,1,2008-09-03 20:56:26,2008-09-03 20:56:26
d6f94676cbcf8d6e51cabd12ca4045148ad9d216...cdffe90c8acef1524b2df450c2bf43a7a2e12fc8,1,0,2,2,1,2008-09-03 20:57:46,2008-09-03 20:57:46
cdffe90c8acef1524b2df450c2bf43a7a2e12fc8...d7e37b661c33c563a0cbca892697c62b52312223,1,34,0,34,1,2008-09-03 21:10:42,2008-09-03 21:10:42
d7e37b661c33c563a0cbca892697c62b52312223...559c0da7c141488e5d7c6bc0ef54f27dca53ca42,1,2,0,2,1,2008-09-03 21:16:05,2008-09-03 21:16:05
559c0da7c141488e5d7c6bc0ef54f27dca53ca42...00dcd49ffbb9583c533a10682efc4346a62e8d08,1,1,2,3,2,2008-09-03 21:21:24,2008-09-03 21:21:24
00dcd49ffbb9583c533a10682efc4346a62e8d08...c19d2dd8f7653fa9bf0f372ab847c25bb51af2e7,1,3,3,6,1,2008-09-03 21:22:49,2008-09-03 21:22:49
c19d2dd8f7653fa9bf0f372ab847c25bb51af2e7...9d407fb5e8d79e6392dd86aba0e0219fa45429b3,4,58,61,119,53,2008-09-03 21:29:14,2008-09-03 21:29:14
9d407fb5e8d79e6392dd86aba0e0219fa45429b3...7c2e2d2b5e58d47a26de6487cbe77b4d5ace6614,1,8,14,22,2,2008-09-03 21:47:57,2008-09-03 21:47:57
7c2e2d2b5e58d47a26de6487cbe77b4d5ace6614...c949665678cb6fcdd92bcc2d256a5f85c9606d44,4,3564,2025,5589,684,2008-09-03 22:22:37,2008-09-03 22:22:37
c949665678cb6fcdd92bcc2d256a5f85c9606d44...75528786a9dcbba5c8df3f21f59ad1e01f1e9027,1,7,1,8,1,2008-09-03 22:45:33,2008-09-03 22:45:33
75528786a9dcbba5c8df3f21f59ad1e01f1e9027...96a417f91dfdc93d35e53db068346b2e189510df,1,3,3,6,2,2008-09-03 22:46:39,2008-09-03 22:46:39
96a417f91dfdc93d35e53db068346b2e189510df...58fad7f9fdf7ae15d0ac7393b813a3df57760b81,2,35,4,39,4,2008-09-03 23:10:07,2008-09-03 23:10:07
58fad7f9fdf7ae15d0ac7393b813a3df57760b81...42ef6557a9b88cfc277eb79ddb980e1c62add144,1,1,1,2,1,2008-09-03 23:38:45,2008-09-03 23:38:45
42ef6557a9b88cfc277eb79ddb980e1c62add144...ca422fd89b9a5a8ef23a334f4f9f53d259da2aaa,1,1,1,2,1,2008-09-04 05:26:09,2008-09-04 05:26:09
ca422fd89b9a5a8ef23a334f4f9f53d259da2aaa...36b120c23aac4d08f8b17c19be166de359115c78,1,3,3,6,3,2008-09-04 07:29:27,2008-09-04 07:29:27
36b120c23aac4d08f8b17c19be166de359115c78...32398491743dffb00eb90d0167bf962dd48e144e,1,1,2,3,1,2008-09-04 09:50:45,2008-09-04 09:50:45
32398491743dffb00eb90d0167bf962dd48e144e...1b396223276948339382c9d7ca84e8e0ceafd281,1,4,4,8,2,2008-09-04 16:41:59,2008-09-04 16:41:59
1b396223276948339382c9d7ca84e8e0ceafd281...6008485b807d2ca2d15a11f9ebd4175a1fdf4199,1,76,63,139,46,2008-09-05 00:48:34,2008-09-05 00:48:34
6008485b807d2ca2d15a11f9ebd4175a1fdf4199...a5bf0af67c52e372d506bc47d8954ae084cea2a2,1,1,1,2,1,2008-09-05 14:07:17,2008-09-05 14:07:17
a5bf0af67c52e372d506bc47d8954ae084cea2a2...04682244e7e39e7d39150c67c03145b7f5202b62,1,1,1,2,1,2008-09-05 14:43:16,2008-09-05 14:43:16
04682244e7e39e7d39150c67c03145b7f5202b62...7982519477beda16b1e836909bb16fa14db5d407,1,13,2,15,2,2008-09-05 15:39:58,2008-09-05 15:39:58
7982519477beda16b1e836909bb16fa14db5d407...698dbb63e0b9daa97fe52ec9b6c1acd04ec1225b,1,1,1,2,1,2008-09-05 17:40:30,2008-09-05 17:40:30
698dbb63e0b9daa97fe52ec9b6c1acd04ec1225b...bae9feb486bab390d0aa664511a84136a412b758,1,1,1,2,1,2008-09-06 00:07:14,2008-09-06 00:07:14
bae9feb486bab390d0aa664511a84136a412b758...5f83e0488af7ad9d56584834f9e1fea772fdeea5,1,1,1,2,1,2008-09-06 00:09:17,2008-09-06 00:09:17
5f83e0488af7ad9d56584834f9e1fea772fdeea5...83dd70fddb99d1622d817c8a7d8ed80f9b7462dd,1,1,1,2,1,2008-09-06 16:49:31,2008-09-06 16:49:31
83dd70fddb99d1622d817c8a7d8ed80f9b7462dd...a0875bcc898b41208d20f07c2095193e9ad5298d,1,25,28,53,17,2008-09-06 16:51:24,2008-09-06 16:51:24
a0875bcc898b41208d20f07c2095193e9ad5298d...c402e3b9771948d6b55058ccf21e2c87ef4c0e5b,1,3,3,6,2,2008-09-06 16:54:25,2008-09-06 16:54:25
c402e3b9771948d6b55058ccf21e2c87ef4c0e5b...756fa95bd2abda3547bf98f42dac042da8cecacd,1,1,1,2,1,2008-09-06 23:44:42,2008-09-06 23:44:42
756fa95bd2abda3547bf98f42dac042da8cecacd...e97ec4d142b7a20dc1d29a7f04b076d8b61fa380,1,1,1,2,1,2008-09-07 06:18:59,2008-09-07 06:18:59
e97ec4d142b7a20dc1d29a7f04b076d8b61fa380...165b55828a1fb2d9d9dff4e4b98b0c912556473e,1,2,2,4,2,2008-09-07 18:46:11,2008-09-07 18:46:11
165b55828a1fb2d9d9dff4e4b98b0c912556473e...acf2600a4c1b3d6cd4b1a4166ea62d784d246442,1,11,11,22,7,2008-09-07 19:15:41,2008-09-07 19:15:41
acf2600a4c1b3d6cd4b1a4166ea62d784d246442...571f4639a9a1476782c8c9725da3041a848c764c,1,6,8,14,2,2008-09-07 22:55:31,2008-09-07 22:55:31
571f4639a9a1476782c8c9725da3041a848c764c...908f0a66e362c84355328efa302e70a2fc8c7e7f,1,4,4,8,2,2008-09-07 22:56:03,2008-09-07 22:56:03
908f0a66e362c84355328efa302e70a2fc8c7e7f...a5e0c5b182c1f3df113d2ceccb323b3f267ef536,1,5,2,7,4,2008-09-07 23:08:01,2008-09-07 23:08:01
a5e0c5b182c1f3df113d2ceccb323b3f267ef536...6bdb7b95299717f5137291e09aad420f7f80f2de,34,82,81,163,79,2008-09-08 05:19:28,2008-09-08 05:19:28
6bdb7b95299717f5137291e09aad420f7f80f2de...1bfed070c32173e69be6272b274506c1bd56d413,3,5,15,20,8,2008-09-08 05:45:17,2008-09-08 05:45:17
1bfed070c32173e69be6272b274506c1bd56d413...834a041e67b61f84b095c0796ed085f4c4785b0a,1,1,1,2,1,2008-09-09 01:43:17,2008-09-09 01:43:17
834a041e67b61f84b095c0796ed085f4c4785b0a...74f386dba274e319eb9e76cfb6f5d38e602104d9,13,78,40,118,30,2008-09-09 01:54:20,2008-09-09 01:54:20
74f386dba274e319eb9e76cfb6f5d38e602104d9...8f78d7f9402f28daadb485f582eabb7bc0bdc527,1,1,1,2,1,2008-09-09 01:56:01,2008-09-09 01:56:01
8f78d7f9402f28daadb485f582eabb7bc0bdc527...42a878cfeadf00f036a6110941550505d4d007af,5,21,9,30,12,2008-09-09 02:13:58,2008-09-09 02:13:58
42a878cfeadf00f036a6110941550505d4d007af...640f198111fc1e770700a938c43e6df2eff300ca,1,10,2,12,2,2008-09-09 02:18:06,2008-09-09 02:18:06
640f198111fc1e770700a938c43e6df2eff300ca...646c12f0d40e98cac14a03118e10077a6fe87ea2,1,0,16,16,2,2008-09-09 02:33:14,2008-09-09 02:33:14
646c12f0d40e98cac14a03118e10077a6fe87ea2...ff22efef5dc8229ca272a2010efd3f183e7f18ce,4,3504,1494,4998,445,2008-09-09 16:07:06,2008-09-09 16:07:06
ff22efef5dc8229ca272a2010efd3f183e7f18ce...2dd4b949f5e7cbeda14dbaff343442aac31e9668,1,1,1,2,1,2008-09-09 19:09:05,2008-09-09 19:09:05
2dd4b949f5e7cbeda14dbaff343442aac31e9668...152b9ba7173e74fae11c770be40656cc70188514,3,42,13,55,10,2008-09-09 19:19:51,2008-09-09 19:19:51
152b9ba7173e74fae11c770be40656cc70188514...568b8637bfecc74906282f26fcfef16a0cb0d156,1,1,1,2,1,2008-09-09 19:53:57,2008-09-09 19:53:57
568b8637bfecc74906282f26fcfef16a0cb0d156...1aa8449fb718875289fff179845503dd8c9684ce,1,6,7,13,1,2008-09-10 03:57:52,2008-09-10 03:57:52
1aa8449fb718875289fff179845503dd8c9684ce...8be80c23808338b233bbeb316c9f3d2bd1485b1d,1,48,48,96,44,2008-09-10 04:04:57,2008-09-10 04:04:57
8be80c23808338b233bbeb316c9f3d2bd1485b1d...78cb60ab071ac443ef9a4ce84094463e50a85d19,1,25,25,50,24,2008-09-10 04:53:44,2008-09-10 04:53:44
78cb60ab071ac443ef9a4ce84094463e50a85d19...665f9342d3aab05581e055b4c286661f087cab11,1,26,27,53,13,2008-09-10 05:04:24,2008-09-10 05:04:24
665f9342d3aab05581e055b4c286661f087cab11...5cc93500e88794342adcc738fd4d7bb6f40330c6,6,17,17,34,14,2008-09-10 05:14:59,2008-09-10 05:14:59
5cc93500e88794342adcc738fd4d7bb6f40330c6...40cb11a55495c187bfd713b6e85dda72f076346b,3,81,68,149,6,2008-09-10 05:56:34,2008-09-10 05:56:34
40cb11a55495c187bfd713b6e85dda72f076346b...32db67e6f9c739b265f2860ffda42092bfa6b594,1,4,9,13,4,2008-09-10 06:06:04,2008-09-10 06:06:04
32db67e6f9c739b265f2860ffda42092bfa6b594...33c29736bb7b91c6888f2363bd6384885015e001,1,1,1,2,1,2008-09-10 15:09:53,2008-09-10 15:09:53
33c29736bb7b91c6888f2363bd6384885015e001...0cd7fbec5637b50c304abef3c842ac72382ca32a,1,1,1,2,1,2008-09-10 23:03:07,2008-09-10 23:03:07
0cd7fbec5637b50c304abef3c842ac72382ca32a...f17f2bfd1fa1ac6f797c1d0aec1ac12b3bd7b051,1,34,4,38,4,2008-09-11 00:24:02,2008-09-11 00:24:02
f17f2bfd1fa1ac6f797c1d0aec1ac12b3bd7b051...11fd9f2d849c5ab75f0b57cc57ae5035d6e438d8,1,1,1,2,1,2008-09-11 00:30:31,2008-09-11 00:30:31
11fd9f2d849c5ab75f0b57cc57ae5035d6e438d8...e47cc781d844eea72e677d1d212b2dfd1b0c9225,2,36,0,36,3,2008-09-11 02:00:27,2008-09-11 02:00:27
e47cc781d844eea72e677d1d212b2dfd1b0c9225...cfcfc456e909df9f9184d3dd7a5eaca0d0cdbd18,1,1,1,2,1,2008-09-11 02:02:06,2008-09-11 02:02:06
cfcfc456e909df9f9184d3dd7a5eaca0d0cdbd18...b0da050b830ac902f16cc5f6891ea64ed9ae1457,1,5,4,9,1,2008-09-11 02:32:59,2008-09-11 02:32:59
b0da050b830ac902f16cc5f6891ea64ed9ae1457...1c78bf4b985c58b19552f5060829b71c3df72344,2,5,2,7,3,2008-09-11 02:43:32,2008-09-11 02:43:32
1c78bf4b985c58b19552f5060829b71c3df72344...bc5cddc5c575d32dcfea239c1463bb0b0fc1ee09,1,5,5,10,2,2008-09-11 02:57:31,2008-09-11 02:57:31
bc5cddc5c575d32dcfea239c1463bb0b0fc1ee09...868748e196fb1772a2fe35706b61dfab6a0eeee1,1,1,1,2,1,2008-09-11 02:59:11,2008-09-11 02:59:11
868748e196fb1772a2fe35706b61dfab6a0eeee1...8c6f5c6f0517d9eea2f91cc58ab9841dc945b476,1,14,12,26,10,2008-09-11 03:28:49,2008-09-11 03:28:49
8c6f5c6f0517d9eea2f91cc58ab9841dc945b476...1b58b77f0d4b23d2be7c96af34636677ddb45a85,2,30,30,60,26,2008-09-11 03:32:28,2008-09-11 03:32:28
1b58b77f0d4b23d2be7c96af34636677ddb45a85...1a2296267d034c6cf4dbac6709d9c9f77787bbcf,1,1,1,2,1,2008-09-12 15:52:39,2008-09-12 15:52:39
1a2296267d034c6cf4dbac6709d9c9f77787bbcf...9ee0b0d384f86e31600772340383f2f2f7ca8611,1,7,2,9,2,2008-09-12 16:52:28,2008-09-12 16:52:28
9ee0b0d384f86e31600772340383f2f2f7ca8611...2d8d69f9ae0e396d79d42f7eccb6b882a86a602f,1,1,1,2,1,2008-09-12 16:56:09,2008-09-12 16:56:09
2d8d69f9ae0e396d79d42f7eccb6b882a86a602f...5a4feb9ec2c901ba2504a2daf74ab1272fc07b48,1,1,1,2,1,2008-09-14 06:49:28,2008-09-14 06:49:28
5a4feb9ec2c901ba2504a2daf74ab1272fc07b48...24d3129edda155405e9665565e56d1783390f61d,1,17,17,34,3,2008-09-14 07:04:40,2008-09-14 07:04:40
24d3129edda155405e9665565e56d1783390f61d...bc75e912a414832da903f7b839df20652184af07,1,1,1,2,1,2008-09-14 07:52:45,2008-09-14 07:52:45
bc75e912a414832da903f7b839df20652184af07...a8d2810be56f3c69ad884d04aa589622e7ec6117,1,1,1,2,1,2008-09-14 08:15:22,2008-09-14 08:15:22
a8d2810be56f3c69ad884d04aa589622e7ec6117...7931da87ecbce863f5c70b8b6ab4e9fc826fefef,1,2,2,4,1,2008-09-14 08:28:55,2008-09-14 08:28:55
7931da87ecbce863f5c70b8b6ab4e9fc826fefef...7ab3285f64322346a763a231ddabb934102b6b50,1,3,3,6,1,2008-09-14 08:36:58,2008-09-14 08:36:58
7ab3285f64322346a763a231ddabb934102b6b50...e600d00b44348d860d2847c4697ad9b21e1824d2,1,14,0,14,1,2008-09-14 08:58:16,2008-09-14 08:58:16
e600d00b44348d860d2847c4697ad9b21e1824d2...83d2cb79cbad6083bb3b88e782c2490e159e89d1,1,2,2,4,2,2008-09-14 09:34:31,2008-09-14 09:34:31
83d2cb79cbad6083bb3b88e782c2490e159e89d1...ea0fe604d86bc36c98836d52455c04c40b161c61,1,2,2,4,1,2008-09-14 09:39:04,2008-09-14 09:39:04
ea0fe604d86bc36c98836d52455c04c40b161c61...c9f0dd1ed6277ca234af61f62bef0f86697a6cea,1,1,0,1,1,2008-09-14 10:32:04,2008-09-14 10:32:04
c9f0dd1ed6277ca234af61f62bef0f86697a6cea...47091ab5b5fd6efcbeb338b903e8ba7394c3ac14,1,2,2,4,2,2008-09-14 12:59:39,2008-09-14 12:59:39
47091ab5b5fd6efcbeb338b903e8ba7394c3ac14...e820b54401043b6167a1b5ed0aee637974e7b041,1,1,1,2,1,2008-09-14 13:10:36,2008-09-14 13:10:36
e820b54401043b6167a1b5ed0aee637974e7b041...7ac86d17c8d1d39269a4064e9fc2e96c2fd125da,1,38,0,38,1,2008-09-14 23:55:09,2008-09-14 23:55:09
7ac86d17c8d1d39269a4064e9fc2e96c2fd125da...5389c0d2afebcee36bdef23a61788eef29374e78,1,10,0,10,1,2008-09-15 00:07:13,2008-09-15 00:07:13
5389c0d2afebcee36bdef23a61788eef29374e78...6fcdcbd456cc2eb832e956414eccb993216f44ab,1,9,7,16,3,2008-09-15 00:13:25,2008-09-15 00:13:25
6fcdcbd456cc2eb832e956414eccb993216f44ab...7617e73c8cfe99601645ce487781ecc86f8c6536,1,31,0,31,1,2008-09-15 09:30:05,2008-09-15 09:30:05
7617e73c8cfe99601645ce487781ecc86f8c6536...b8ba0154b8b22199f8e52f7033d3fdc3cd720474,1,6,6,12,6,2008-09-15 12:14:31,2008-09-15 12:14:31
b8ba0154b8b22199f8e52f7033d3fdc3cd720474...fe3a560768b59b97ab47d91501c625a0edd50e7c,2,5,0,5,2,2008-09-15 15:44:59,2008-09-15 15:44:59
fe3a560768b59b97ab47d91501c625a0edd50e7c...b04faa3511b95195fd360e9873d668f9f4c36485,1,1,1,2,1,2008-09-15 17:25:17,2008-09-15 17:25:17
b04faa3511b95195fd360e9873d668f9f4c36485...96becf2458c1180ba3249614bcd758a79b12ee36,1,9,6,15,4,2008-09-15 18:06:02,2008-09-15 18:06:02
96becf2458c1180ba3249614bcd758a79b12ee36...b79cb53d766993a8a424fbd164bc1302ce18e767,1,2,1,3,2,2008-09-16 00:25:21,2008-09-16 00:25:21
b79cb53d766993a8a424fbd164bc1302ce18e767...f09f744f81bbe1894ba1ad6fb5f883bb294eca18,1,2,2,4,2,2008-09-16 00:40:10,2008-09-16 00:40:10
f09f744f81bbe1894ba1ad6fb5f883bb294eca18...fdd3cb4930b0e4386ac63b98f7e1b81670eedfaa,1,28,26,54,19,2008-09-16 05:22:08,2008-09-16 05:22:08
fdd3cb4930b0e4386ac63b98f7e1b81670eedfaa...3b0bf9805d99dc03823a687aa8037bdb54c5da54,1,1,1,2,1,2008-09-16 05:30:48,2008-09-16 05:30:48
3b0bf9805d99dc03823a687aa8037bdb54c5da54...772639c692eb513af514116b3a1ef09574315b6b,2,8,8,16,5,2008-09-16 05:31:00,2008-09-16 05:31:00
772639c692eb513af514116b3a1ef09574315b6b...883aa6b9c8070d6946435c5f9783a49511830367,1,7,2,9,1,2008-09-16 05:39:49,2008-09-16 05:39:49
883aa6b9c8070d6946435c5f9783a49511830367...1fcf33095fcdafe985cfbb45780e094e0aeb2374,2,12,40,52,7,2008-09-16 05:42:11,2008-09-16 05:42:11
1fcf33095fcdafe985cfbb45780e094e0aeb2374...af23d8d3b38270f58404c002942bcc200f1855bf,1,2,2,4,2,2008-09-16 05:50:03,2008-09-16 05:50:03
af23d8d3b38270f58404c002942bcc200f1855bf...8efeaea9dda9e3869e02b39e57ee1d194fb32352,1,1,1,2,1,2008-09-16 05:52:29,2008-09-16 05:52:29
8efeaea9dda9e3869e02b39e57ee1d194fb32352...78999f24ee3a43109706f3b82bc13acfd4e0e29e,1,1,1,2,1,2008-09-16 05:58:53,2008-09-16 05:58:53
78999f24ee3a43109706f3b82bc13acfd4e0e29e...2ccc716e7ba2fcfc47d001647fbb5503cb699ef6,1,1,1,2,1,2008-09-16 06:01:47,2008-09-16 06:01:47
2ccc716e7ba2fcfc47d001647fbb5503cb699ef6...78fd5db4c5421441040a071961130978141a4e39,1,1,1,2,1,2008-09-16 06:05:53,2008-09-16 06:05:53
78fd5db4c5421441040a071961130978141a4e39...8ec8e1a5e8990680e4e54e15bb3ff825d6704eec,8,9,9,18,9,2008-09-16 06:15:26,2008-09-16 06:15:26
8ec8e1a5e8990680e4e54e15bb3ff825d6704eec...c1bed3771554c23cf9922e163677278c946518a9,1,3,0,3,1,2008-09-17 04:52:25,2008-09-17 04:52:25
c1bed3771554c23cf9922e163677278c946518a9...660180df30df430a9ca1e5f1f0916fb349aeaf2e,1,1,1,2,1,2008-09-17 04:56:04,2008-09-17 04:56:04
660180df30df430a9ca1e5f1f0916fb349aeaf2e...26a9ac491cb77642d31cc7e7ab7418593b1979e7,1,11,9,20,5,2008-09-17 05:12:53,2008-09-17 05:12:53
26a9ac491cb77642d31cc7e7ab7418593b1979e7...7a80a9fa7de4a9e466e66fb4d2b3242e5da67334,1,8,6,14,2,2008-09-17 05:18:41,2008-09-17 05:18:41
7a80a9fa7de4a9e466e66fb4d2b3242e5da67334...cc7b0f986a8ef897fba258d03d0a43f3e1c5799e,1,18,7,25,2,2008-09-17 05:42:12,2008-09-17 05:42:12
cc7b0f986a8ef897fba258d03d0a43f3e1c5799e...47684a1f94cf0100286fae8ce42f1ad6abb1f332,2,1214,1195,2409,338,2008-09-17 06:41:29,2008-09-17 06:41:29
47684a1f94cf0100286fae8ce42f1ad6abb1f332...4dcaea8e37867db49efa2c25ddc6449e8f0c8f23,4,1315,1347,2662,728,2008-09-17 06:50:07,2008-09-17 06:50:07
4dcaea8e37867db49efa2c25ddc6449e8f0c8f23...b0753878e503d9ad17aebaf3647a5d831ac3745c,2,387,888,1275,234,2008-09-17 06:50:56,2008-09-17 06:50:56
b0753878e503d9ad17aebaf3647a5d831ac3745c...168c7768895edf9d0cc23838b11539ed508f2a6c,2,81,81,162,81,2008-09-17 06:59:24,2008-09-17 06:59:24
168c7768895edf9d0cc23838b11539ed508f2a6c...e99cd487691f5518e7dcd4207319b2402e9f1024,1,4,3,7,3,2008-09-17 07:23:17,2008-09-17 07:23:17
e99cd487691f5518e7dcd4207319b2402e9f1024...11e29c887ac7b6e9b8e35bd1963c64b1e088e4cd,1,1,1,2,2,2008-09-17 07:59:05,2008-09-17 07:59:05
11e29c887ac7b6e9b8e35bd1963c64b1e088e4cd...a10fcbdb8b36e12fb839c7e760f047568877e9da,1,4,2,6,1,2008-09-17 08:10:55,2008-09-17 08:10:55
a10fcbdb8b36e12fb839c7e760f047568877e9da...0aff292bcfacf23d5721dec6dcce9e64889740cb,1,1,1,2,1,2008-09-17 08:59:55,2008-09-17 08:59:55
0aff292bcfacf23d5721dec6dcce9e64889740cb...36f8b8d6875cf6e5290afa736a8750e0e8c65129,1,4,0,4,1,2008-09-17 09:02:25,2008-09-17 09:02:25
36f8b8d6875cf6e5290afa736a8750e0e8c65129...a27ff1c8ae5caebfc8578e3725d6af60f3742336,1,2,1,3,2,2008-09-17 09:32:36,2008-09-17 09:32:36
a27ff1c8ae5caebfc8578e3725d6af60f3742336...eeb230aa1c105a224fbc2ee03a1b9c5319594252,1,2,2,4,1,2008-09-17 11:32:11,2008-09-17 11:32:11
eeb230aa1c105a224fbc2ee03a1b9c5319594252...9931c9e1321e3290b065bc0f5ec8353b1bcb71f3,2,21,0,21,2,2008-09-18 07:16:08,2008-09-18 07:16:08
9931c9e1321e3290b065bc0f5ec8353b1bcb71f3...7976817a592ff5c5f2313decab5d9a58e1efc8ec,1,1,1,2,1,2008-09-18 15:46:20,2008-09-18 15:46:20
7976817a592ff5c5f2313decab5d9a58e1efc8ec...7faa23d69c9462777892b9127dccaacb8f984376,1,3,3,6,1,2008-09-18 15:57:47,2008-09-18 15:57:47
7faa23d69c9462777892b9127dccaacb8f984376...060919afa165a9ad208ba0aace54756891bf0718,1,1,1,2,1,2008-09-18 17:10:16,2008-09-18 17:10:16
060919afa165a9ad208ba0aace54756891bf0718...de9acabf12460e65f8ec816df0700ef7a3c42be0,3,292,64,356,11,2008-09-19 19:44:10,2008-09-19 19:44:10
de9acabf12460e65f8ec816df0700ef7a3c42be0...af68a0ccd80e61991c03eee75fecc120041309b2,1,1,0,1,1,2008-09-19 19:45:54,2008-09-19 19:45:54
af68a0ccd80e61991c03eee75fecc120041309b2...936b8ea11b698eee66e9bd54a468721ab3fc81a5,1,4,4,8,1,2008-09-20 22:33:24,2008-09-20 22:33:24
936b8ea11b698eee66e9bd54a468721ab3fc81a5...1b733aa10d5991da224b57250bc57fe5fe505953,1,1,1,2,1,2008-09-21 07:43:58,2008-09-21 07:43:58
1b733aa10d5991da224b57250bc57fe5fe505953...0ededc611fd9c98812652f4853a0eebf96942da3,2,2,2,4,2,2008-09-21 16:15:09,2008-09-21 16:15:09
0ededc611fd9c98812652f4853a0eebf96942da3...fd366a85315dfc836e73f9cdee3e7309281dfd3e,2,2,7,9,2,2008-09-21 16:57:26,2008-09-21 16:57:26
fd366a85315dfc836e73f9cdee3e7309281dfd3e...922aba3def68e57c405a0e50d353a790af85b00a,2,6,0,6,2,2008-09-22 00:31:22,2008-09-22 00:31:22
922aba3def68e57c405a0e50d353a790af85b00a...5563362c4c86d1c519bfa4732fed050c232e366a,1,186,7,193,21,2008-09-22 06:03:24,2008-09-22 06:03:24
5563362c4c86d1c519bfa4732fed050c232e366a...54f962c0bf3cf4802ee2c94194bcdb4bd4728106,2,13,0,13,2,2008-09-22 11:07:35,2008-09-22 11:07:35
54f962c0bf3cf4802ee2c94194bcdb4bd4728106...48d41cf78eb480f8190801e18d529057f14a4760,1,2,1,3,1,2008-09-22 11:10:39,2008-09-22 11:10:39
48d41cf78eb480f8190801e18d529057f14a4760...edabc4aca1d5f8ff081bbc0c94ad8eb6bcad28e9,1,1,1,2,1,2008-09-27 03:25:42,2008-09-27 03:25:42
edabc4aca1d5f8ff081bbc0c94ad8eb6bcad28e9...6c7cf34d691ffe9ac2c9a7be8d2838b205ace757,4,13,2,15,5,2008-09-27 05:57:10,2008-09-27 05:57:10
6c7cf34d691ffe9ac2c9a7be8d2838b205ace757...15b0158e393544bd215688f257ab03604cd07950,4,45,19,64,9,2008-09-27 06:14:11,2008-09-27 06:14:11
15b0158e393544bd215688f257ab03604cd07950...cc72e64e19f57954f86e866d245aff9c52bde642,1,2,2,4,2,2008-09-28 02:50:09,2008-09-28 02:50:09
cc72e64e19f57954f86e866d245aff9c52bde642...788e6c081ba21fb75bc00195a82cb212542f7135,1,1,1,2,1,2008-09-28 02:55:56,2008-09-28 02:55:56
788e6c081ba21fb75bc00195a82cb212542f7135...4eb26b1659dbb3034c85df34758992b1b5601f73,1,34,0,34,2,2008-09-28 03:08:30,2008-09-28 03:08:30
4eb26b1659dbb3034c85df34758992b1b5601f73...baa960209f4f946d333987fbabcf13d26abfeb89,2,10,1,11,6,2008-09-28 04:36:10,2008-09-28 04:36:10
baa960209f4f946d333987fbabcf13d26abfeb89...e625920a47c1985c39065fd1a36d6ba5ea1903dc,2,21,21,42,21,2008-09-28 10:34:51,2008-09-28 10:34:51
e625920a47c1985c39065fd1a36d6ba5ea1903dc...e9f647e11f9ee77dea71f9302904474c13ff3b5a,1,2,2,4,2,2008-09-29 04:09:39,2008-09-29 04:09:39
ced74d582a10c11e0d774b4dbd260e90db013da5...e178be41cf968f1700751d29d8b385c39bfd70f1,0,0,0,0,0,2007-09-13 02:34:32,2007-09-13 02:34:32
e178be41cf968f1700751d29d8b385c39bfd70f1...2d07a19c19625685e54ebc9ae94003dbe1584a8b,1,192,0,192,1,2007-09-13 02:47:29,2007-09-13 02:47:29
2d07a19c19625685e54ebc9ae94003dbe1584a8b...4751fd9ba7dd761430be4b00b88221c6d2240f90,1,5,0,5,1,2007-09-13 02:48:06,2007-09-13 02:48:06
4751fd9ba7dd761430be4b00b88221c6d2240f90...b791612779f22dc3eb33243767aeec1610d08d36,1,118,0,118,1,2007-09-13 02:48:46,2007-09-13 02:48:46
b791612779f22dc3eb33243767aeec1610d08d36...a7a517f329361280170e0544139ceb3641432390,8,1372,779,2151,66,2007-09-13 02:50:14,2007-09-13 02:50:14
a7a517f329361280170e0544139ceb3641432390...cc9d51942492a161757cf2ad24c809921267dcf3,1,0,0,0,0,2007-09-13 02:56:31,2007-09-13 02:56:31
cc9d51942492a161757cf2ad24c809921267dcf3...a7d01ec9b4b7a41d5e61498993949b1285db4e45,1,9,4,13,3,2007-09-13 03:11:44,2007-09-13 03:11:44
a7d01ec9b4b7a41d5e61498993949b1285db4e45...bb77006adefae2db3fae0213779fc30254c1b98f,1,3,3,6,3,2007-09-13 03:17:46,2007-09-13 03:17:46
bb77006adefae2db3fae0213779fc30254c1b98f...184a6435cd3e1945823ccb9e7692f3c6e3875411,3,10,3,13,4,2007-09-13 03:54:47,2007-09-13 03:54:47
184a6435cd3e1945823ccb9e7692f3c6e3875411...ff3f6df54c40aa76c2ef23d54d7f4b3c462538cf,6,70,25,95,23,2007-09-13 06:33:41,2007-09-13 06:33:41
ff3f6df54c40aa76c2ef23d54d7f4b3c462538cf...a882e6076b24dc420ed9b19cb7c8bb1f8720655c,9,2253,1402,3655,451,2007-09-15 21:15:56,2007-09-15 21:15:56
a882e6076b24dc420ed9b19cb7c8bb1f8720655c...c8f6e485b8b7329418ca030421b9bde4ec164854,29,9015,3549,12564,1327,2007-09-15 21:18:17,2007-09-15 21:18:17
c8f6e485b8b7329418ca030421b9bde4ec164854...fb6a0c8ffa1cd74c63aaf4b011665e5952d449e7,37,717,100,817,81,2007-09-15 21:21:37,2007-09-15 21:21:37
fb6a0c8ffa1cd74c63aaf4b011665e5952d449e7...bf6a46d8ad11d49990a3878166cce2af2fc6c4fe,30,347,111,458,97,2007-09-15 21:34:09,2007-09-15 21:34:09
bf6a46d8ad11d49990a3878166cce2af2fc6c4fe...d29c457ad108ddc52e990b582b36cacc5eb0bb68,12,58,24,82,25,2007-09-15 21:35:33,2007-09-15 21:35:33
d29c457ad108ddc52e990b582b36cacc5eb0bb68...ea9cd5421382c047e2cc140bd6736b54ba660793,2,7,0,7,3,2007-09-15 21:39:05,2007-09-15 21:39:05
ea9cd5421382c047e2cc140bd6736b54ba660793...5ce2e6c2c827cf877f73bf0e42e6afb7e6a71ccf,36,883,67,950,65,2007-09-15 21:42:51,2007-09-15 21:42:51
5ce2e6c2c827cf877f73bf0e42e6afb7e6a71ccf...7325fbf4ff20f9b0f21d3a1aba1abaca78a765d7,29,347,116,463,78,2007-09-15 21:46:18,2007-09-15 21:46:18
7325fbf4ff20f9b0f21d3a1aba1abaca78a765d7...ca33d307dee3cf68cc9cd2ccfae00c7ff23ea890,71,11539,5567,17106,1480,2007-09-15 21:57:25,2007-09-15 21:57:25
ca33d307dee3cf68cc9cd2ccfae00c7ff23ea890...28a4aa6f49b11881d43a585f118a3d0537ba9084,23,917,166,1083,67,2007-09-15 22:00:35,2007-09-15 22:00:35
28a4aa6f49b11881d43a585f118a3d0537ba9084...94c320d8a982ce30f6dd4e7556f2696229b761c7,96,7303,6228,13531,166,2007-09-20 01:55:53,2007-09-20 01:55:53
94c320d8a982ce30f6dd4e7556f2696229b761c7...7ebf3068c16d29c0288a317dac45166a8bc4c23c,75,790,325,1115,215,2007-10-08 16:10:39,2007-10-08 16:10:39
7ebf3068c16d29c0288a317dac45166a8bc4c23c...dfe7e4e9252ce51615f8c668e6664423ad0accb4,1,1,4,5,3,2007-10-14 02:11:47,2007-10-14 02:11:47
dfe7e4e9252ce51615f8c668e6664423ad0accb4...bcdedbbf088f1d1228a50bce31dc1536a6c24e4b,1,1,0,1,1,2007-10-14 02:12:03,2007-10-14 02:12:03
bcdedbbf088f1d1228a50bce31dc1536a6c24e4b...988b3bbdcb52c4e20551fc8936369a7f176f48bc,4,165,106,271,35,2007-10-14 02:12:40,2007-10-14 02:12:40
988b3bbdcb52c4e20551fc8936369a7f176f48bc...72f9b7d4e84cf288e86255d2f61a4343e2a65026,2,10,7,17,8,2007-10-14 02:13:04,2007-10-14 02:13:04
72f9b7d4e84cf288e86255d2f61a4343e2a65026...e9f1f5046147fc0d1a9f3a24bfa6607ef0742e80,1,5,0,5,1,2007-10-14 02:13:13,2007-10-14 02:13:13
e9f1f5046147fc0d1a9f3a24bfa6607ef0742e80...b47231ee3e164855590b231d6092e54938d6ae53,6,33,35,68,26,2007-10-14 02:13:51,2007-10-14 02:13:51
b47231ee3e164855590b231d6092e54938d6ae53...2c4013e74fcd5f7ba0865448d6ac39ba65463752,2,12,13,25,10,2007-10-14 02:14:15,2007-10-14 02:14:15
2c4013e74fcd5f7ba0865448d6ac39ba65463752...8926b431eda3a7b031e10beb6963bf2d26e4039b,1,1,8,9,3,2007-10-14 02:14:29,2007-10-14 02:14:29
8926b431eda3a7b031e10beb6963bf2d26e4039b...142e400c5cbff91ba70d3636a4429a48131a2edd,2,21,12,33,12,2007-10-14 02:14:53,2007-10-14 02:14:53
142e400c5cbff91ba70d3636a4429a48131a2edd...fdb3209062b47eea52d5d59e99733950990af345,1,4,3,7,3,2007-10-14 02:15:03,2007-10-14 02:15:03
fdb3209062b47eea52d5d59e99733950990af345...425e4662a42e8ab324bcd056c1b0f16751692b3d,2,44,19,63,18,2007-10-14 02:15:28,2007-10-14 02:15:28
425e4662a42e8ab324bcd056c1b0f16751692b3d...240ecf0811b6ab53d0a2914dc92c5b1cd3b01551,2,15,17,32,5,2007-10-14 02:15:52,2007-10-14 02:15:52
240ecf0811b6ab53d0a2914dc92c5b1cd3b01551...cae24af822cabba1ca35bf95150220f7aa8aca24,1,11,9,20,4,2007-10-14 02:16:08,2007-10-14 02:16:08
cae24af822cabba1ca35bf95150220f7aa8aca24...0ebb752e89b312436b424065da05f2b1f8e22a22,4,129,56,185,30,2007-10-14 02:16:38,2007-10-14 02:16:38
0ebb752e89b312436b424065da05f2b1f8e22a22...90f2893aea6dc943c3dca88bec3c5195fb79fa03,2,17,6,23,8,2007-10-14 02:16:57,2007-10-14 02:16:57
90f2893aea6dc943c3dca88bec3c5195fb79fa03...bd2dfdf98956bfdc0d0879f68b5e4718adc5dc96,1,12,5,17,5,2007-10-14 02:17:12,2007-10-14 02:17:12
bd2dfdf98956bfdc0d0879f68b5e4718adc5dc96...ccc3a4766d1e4e8604db0925478ec351bc7f1e77,1,1,1,2,1,2007-10-14 03:45:34,2007-10-14 03:45:34
ccc3a4766d1e4e8604db0925478ec351bc7f1e77...d219428b7cdea1e7b55e4508f85ba4daa32cb66d,3,0,55,55,3,2007-10-14 03:45:53,2007-10-14 03:45:53
d219428b7cdea1e7b55e4508f85ba4daa32cb66d...91e8062ff5911a3a00e0c567b30e3c473d5a65d7,1,0,7,7,2,2007-10-14 03:46:07,2007-10-14 03:46:07
91e8062ff5911a3a00e0c567b30e3c473d5a65d7...93b4199912f2638a5119c498b086fab304d569ae,1,8,0,8,2,2007-10-14 03:46:20,2007-10-14 03:46:20
93b4199912f2638a5119c498b086fab304d569ae...6678de130c9539d2103b5c72561c0869f0d838d7,2,9,1,10,2,2007-10-14 03:46:44,2007-10-14 03:46:44
6678de130c9539d2103b5c72561c0869f0d838d7...a1d160e2ea22cb010b276cfc2a085f9cd3d81b22,4,234,50,284,51,2007-10-14 22:38:54,2007-10-14 22:38:54
a1d160e2ea22cb010b276cfc2a085f9cd3d81b22...201c15dcb62543ea66ff66858be088340ed50221,3,24,11,35,7,2007-10-15 00:29:27,2007-10-15 00:29:27
201c15dcb62543ea66ff66858be088340ed50221...05ebc901fef3e8982db320d269357bf9096f3ead,3,8,2,10,3,2007-10-15 00:29:55,2007-10-15 00:29:55
05ebc901fef3e8982db320d269357bf9096f3ead...e4d1a9aabb915a23c77454a33d7f784e2f32f552,1,40,5,45,4,2007-10-15 00:30:05,2007-10-15 00:30:05
e4d1a9aabb915a23c77454a33d7f784e2f32f552...e9364c06d6be32dc37e09620105e970472587d87,1,4,0,4,1,2007-10-15 00:48:40,2007-10-15 00:48:40
e9364c06d6be32dc37e09620105e970472587d87...4c4341f01289e66f084d295236274a2e4556ae0d,2,29,8,37,14,2007-10-15 01:20:10,2007-10-15 01:20:10
4c4341f01289e66f084d295236274a2e4556ae0d...70d5e32e13426372d3d98bb7664d8a69975ed885,3,53,5,58,5,2007-10-15 02:54:30,2007-10-15 02:54:30
70d5e32e13426372d3d98bb7664d8a69975ed885...f74464da52e28c513ee008022ce70717672e346e,2,4,1,5,4,2007-10-15 03:31:37,2007-10-15 03:31:37
f74464da52e28c513ee008022ce70717672e346e...a3b22d9db07ab21bda752f765b0a4414c73dee57,3,27,4,31,6,2007-10-15 03:32:11,2007-10-15 03:32:11
a3b22d9db07ab21bda752f765b0a4414c73dee57...44d51dae687e1edadec96fd8152ed369b34171e2,1,4,0,4,1,2007-10-15 03:47:10,2007-10-15 03:47:10
44d51dae687e1edadec96fd8152ed369b34171e2...3429fc0ff23e33a0090abbe68b1a286fcf230788,1,11,3,14,3,2007-10-15 03:58:20,2007-10-15 03:58:20
3429fc0ff23e33a0090abbe68b1a286fcf230788...8c10e0d00e944b7c699530f0aeb98de64dc8316a,3,24,3,27,5,2007-10-15 05:51:19,2007-10-15 05:51:19
8c10e0d00e944b7c699530f0aeb98de64dc8316a...91b1369709eb5d5602ce03432a5a342771d95c92,1,1,1,2,1,2007-10-15 06:51:37,2007-10-15 06:51:37
91b1369709eb5d5602ce03432a5a342771d95c92...1e1230c41c428c3909b52720e381cac18942e90e,2,3,3,6,4,2007-10-15 23:01:18,2007-10-15 23:01:18
1e1230c41c428c3909b52720e381cac18942e90e...5e1a54a3a8285912fed02b2121b53d13fa1061fd,93,12314,9313,21627,2921,2007-10-23 12:51:22,2007-10-23 12:51:22
5e1a54a3a8285912fed02b2121b53d13fa1061fd...3940277792a33774bb17c622cdd753deb3ee17c6,2,8,0,8,2,2007-10-23 13:34:03,2007-10-23 13:34:03
3940277792a33774bb17c622cdd753deb3ee17c6...abcb70e5245095628c4a00816138af9382e306fd,3,23,0,23,3,2007-10-23 13:49:07,2007-10-23 13:49:07
abcb70e5245095628c4a00816138af9382e306fd...f951d97d9937370a602753f0d530e5b2bbdac69d,4,51,16,67,11,2007-10-24 04:22:23,2007-10-24 04:22:23
f951d97d9937370a602753f0d530e5b2bbdac69d...f189280eb39b20a8cfdb6b9416df1176e107550d,15,207,95,302,42,2007-11-03 02:15:27,2007-11-03 02:15:27
f189280eb39b20a8cfdb6b9416df1176e107550d...44df4e390fc9e037a3ab2775ffd695c80831f0ee,13,128,72,200,64,2007-11-03 02:16:27,2007-11-03 02:16:27
44df4e390fc9e037a3ab2775ffd695c80831f0ee...3d07f94d68ae7ef69c336c36ee119ef49c1e6028,105,9249,4913,14162,1980,2007-11-18 05:48:24,2007-11-18 05:48:24
3d07f94d68ae7ef69c336c36ee119ef49c1e6028...5d85a5147b55cbe7940df2321e73c48ca265f649,5,167,109,276,66,2007-11-18 12:07:25,2007-11-18 12:07:25
5d85a5147b55cbe7940df2321e73c48ca265f649...a97abcffc27c5026041afccb1d76f7e4e4b1df69,34,902,337,1239,257,2007-11-28 21:51:17,2007-11-28 21:51:17
a97abcffc27c5026041afccb1d76f7e4e4b1df69...b43a0180322b42925c4c27b5ccdf2e876309c53b,12,360,296,656,93,2007-11-29 04:56:09,2007-11-29 04:56:09
b43a0180322b42925c4c27b5ccdf2e876309c53b...dfe05d94b853073e2762250e1b4cd64ce9ef1df0,47,3127,1561,4688,683,2007-11-29 20:38:41,2007-11-29 20:38:41
dfe05d94b853073e2762250e1b4cd64ce9ef1df0...bef4ca2bacfefd22fdf35b9c86d3ab714c67330f,2,9,2,11,3,2007-11-29 22:07:58,2007-11-29 22:07:58
bef4ca2bacfefd22fdf35b9c86d3ab714c67330f...648a3d87a331674b3e566d8e47ea5ae8422437aa,3,9,7,16,3,2007-11-29 22:08:04,2007-11-29 22:08:04
648a3d87a331674b3e566d8e47ea5ae8422437aa...a2418176fd22f1e4af0377c70c5b2d8955b71afe,4,25,17,42,8,2007-11-30 02:29:25,2007-11-30 02:29:25
a2418176fd22f1e4af0377c70c5b2d8955b71afe...79653a414857e4f93918051843afbc1f7c9a7f99,3,28,3,31,4,2007-11-30 04:44:32,2007-11-30 04:44:32
79653a414857e4f93918051843afbc1f7c9a7f99...07ddd56872e70e76e13eb0b118c7b6503d5d821f,106,3264,1328,4592,374,2007-12-03 02:59:56,2007-12-03 02:59:56
07ddd56872e70e76e13eb0b118c7b6503d5d821f...2c5373c325d00b035e7055bc469793fcbc3132f0,1,8,8,16,7,2007-12-03 03:00:03,2007-12-03 03:00:03
2c5373c325d00b035e7055bc469793fcbc3132f0...7b9732a4a46aae6bf294b1869d58f21909ea91cc,1,9,1,10,2,2007-12-03 03:31:18,2007-12-03 03:31:18
7b9732a4a46aae6bf294b1869d58f21909ea91cc...4ea96c04688a017c846b9c01ab68b8df6be866a9,1,4,1,5,1,2007-12-03 03:31:26,2007-12-03 03:31:26
4ea96c04688a017c846b9c01ab68b8df6be866a9...cc0078494e6a28c7c27f53748d6b16fafe0ca8fd,3,39,39,78,30,2007-12-03 21:10:41,2007-12-03 21:10:41
cc0078494e6a28c7c27f53748d6b16fafe0ca8fd...57a4b882aeddc6f171d25808c8510bd09c410eff,2,38,1,39,6,2007-12-03 21:10:51,2007-12-03 21:10:51
57a4b882aeddc6f171d25808c8510bd09c410eff...8e6126fbc2ebbda6d14a888dbe16cfe3b64339bf,1,7,1,8,3,2007-12-03 21:10:55,2007-12-03 21:10:55
8e6126fbc2ebbda6d14a888dbe16cfe3b64339bf...0d7b6884df5efc6c9eafc8a81f39ccfb8bc931f5,1,4,0,4,1,2007-12-03 21:23:15,2007-12-03 21:23:15
0d7b6884df5efc6c9eafc8a81f39ccfb8bc931f5...3dce17ddc4a891856a0831f5f26716675d7a3bab,6,9,3,12,6,2007-12-05 09:40:16,2007-12-05 09:40:16
3dce17ddc4a891856a0831f5f26716675d7a3bab...3064a211bfcaac4ba0dda1ae21b10a5b766e3152,4,143,22,165,21,2007-12-09 06:24:17,2007-12-09 06:24:17
3064a211bfcaac4ba0dda1ae21b10a5b766e3152...13d3162aaf7fce11c06d447f397e32b7648ae199,1,32,0,32,4,2007-12-09 08:01:26,2007-12-09 08:01:26
13d3162aaf7fce11c06d447f397e32b7648ae199...97091940b1efbc6018133e9f77402c2983fa702f,97,1617,977,2594,694,2007-12-19 05:08:37,2007-12-19 05:08:37
97091940b1efbc6018133e9f77402c2983fa702f...519178154be44da2ece9ee9609a0217008616454,3,16,2,18,4,2007-12-19 10:57:54,2007-12-19 10:57:54
519178154be44da2ece9ee9609a0217008616454...18adbb636320e038627947ec9a91ddd2e64c4447,2,42,31,73,25,2007-12-19 10:58:26,2007-12-19 10:58:26
18adbb636320e038627947ec9a91ddd2e64c4447...470ddafe9792fc58502993a16d9a0d3d2ed044d9,3,35,12,47,15,2007-12-19 12:23:59,2007-12-19 12:23:59
470ddafe9792fc58502993a16d9a0d3d2ed044d9...4dc766c9e1912dd0858c8ef80197fe2a3bb1ec92,1,2,1,3,1,2007-12-19 13:06:16,2007-12-19 13:06:16
4dc766c9e1912dd0858c8ef80197fe2a3bb1ec92...7292cc8d60f9e993c26755456468cfd4cd8eb03e,3,3,23,26,5,2007-12-19 13:06:45,2007-12-19 13:06:45
7292cc8d60f9e993c26755456468cfd4cd8eb03e...f47cfe12ae7354eb1bbcc9fe0c58f84778501ff4,1,7,2,9,1,2007-12-19 13:43:16,2007-12-19 13:43:16
f47cfe12ae7354eb1bbcc9fe0c58f84778501ff4...e247b364472bd48cd067baa6231c14b500298a4e,4,47,26,73,12,2007-12-22 11:16:04,2007-12-22 11:16:04
e247b364472bd48cd067baa6231c14b500298a4e...b824d803cef720fcf39ee19c54a14da811ea1c3d,1,16,0,16,2,2007-12-22 11:16:21,2007-12-22 11:16:21
b824d803cef720fcf39ee19c54a14da811ea1c3d...83cb2218bc73707f2c15a40caef97e375c4f1175,25,301,247,548,106,2008-01-09 06:08:40,2008-01-09 06:08:40
83cb2218bc73707f2c15a40caef97e375c4f1175...98abf27535a7e0d2d481bd59fb73a48433772d8c,28,5065,2525,7590,1216,2008-01-26 13:23:25,2008-01-26 13:23:25
98abf27535a7e0d2d481bd59fb73a48433772d8c...dd2251a653f45406a720203c35e40adac5411b5a,2,85,7,92,9,2008-01-26 13:23:54,2008-01-26 13:23:54
dd2251a653f45406a720203c35e40adac5411b5a...e016a4f987efc6c43ea6c80540456cdd161b2434,1,14,11,25,13,2008-01-27 11:17:33,2008-01-27 11:17:33
e016a4f987efc6c43ea6c80540456cdd161b2434...911e65ada72d6faeecd156d285ac661058aa0f35,2,16,9,25,9,2008-01-28 14:27:16,2008-01-28 14:27:16
911e65ada72d6faeecd156d285ac661058aa0f35...de94d0cb9381bcab02b7be0de1d8ac577bcfab92,5,134,14,148,11,2008-01-28 14:27:53,2008-01-28 14:27:53
de94d0cb9381bcab02b7be0de1d8ac577bcfab92...3c490660c5a61cdf3a71e690d4bfc1a7dfa51955,1,1,1,2,1,2008-01-28 16:08:06,2008-01-28 16:08:06
3c490660c5a61cdf3a71e690d4bfc1a7dfa51955...a214c6b86a029d2f9aa873fbc93e4e2542be978d,2,32,2,34,5,2008-01-28 16:08:34,2008-01-28 16:08:34
a214c6b86a029d2f9aa873fbc93e4e2542be978d...f99247cc1bd3106200c3d4d08897b81097815ea6,9,259,87,346,41,2008-01-29 15:44:21,2008-01-29 15:44:21
f99247cc1bd3106200c3d4d08897b81097815ea6...a4343209db3473b09aecc707cea522455c8218cc,1,1,1,2,1,2008-01-29 15:49:43,2008-01-29 15:49:43
a4343209db3473b09aecc707cea522455c8218cc...0a9b7519582bc358be10bb374bfbdfe237e09578,57,17370,9857,27227,3479,2008-02-04 05:45:17,2008-02-04 05:45:17
0a9b7519582bc358be10bb374bfbdfe237e09578...5df5551d076e40ddf8f31205116f70c5e75ca240,3,50,27,77,12,2008-02-04 12:02:36,2008-02-04 12:02:36
5df5551d076e40ddf8f31205116f70c5e75ca240...04a55d663fdcf91a73a7a31d81a54518e6355f74,1,1,1,2,1,2008-02-04 12:05:01,2008-02-04 12:05:01
04a55d663fdcf91a73a7a31d81a54518e6355f74...c23436be59b4a5c3b399a8849812594bd396e419,1,4,11,15,5,2008-02-06 04:10:58,2008-02-06 04:10:58
c23436be59b4a5c3b399a8849812594bd396e419...0a07dac8805c451df5b4e8da2705849aea15ac01,1,5,8,13,3,2008-02-08 04:21:21,2008-02-08 04:21:21
0a07dac8805c451df5b4e8da2705849aea15ac01...755bb2a3f2c7e59f2b7cb7daacb65acad79c7e19,1,14,2,16,2,2008-02-08 04:21:39,2008-02-08 04:21:39
755bb2a3f2c7e59f2b7cb7daacb65acad79c7e19...55cd02567099767ff9e48a8be24157db6a934ba0,1,1,1,2,1,2008-02-08 04:22:00,2008-02-08 04:22:00
55cd02567099767ff9e48a8be24157db6a934ba0...accc20d799b4a1e584688d2a5b9db555058ab7a9,5,131,169,300,41,2008-02-08 09:49:17,2008-02-08 09:49:17
accc20d799b4a1e584688d2a5b9db555058ab7a9...748e1bdf42a17da7ede351f997018762c681457b,12,766,223,989,183,2008-02-08 12:23:34,2008-02-08 12:23:34
748e1bdf42a17da7ede351f997018762c681457b...770d587314fb0275f0570b05ee5bc746c2b2c685,2,17,12,29,4,2008-02-16 06:56:10,2008-02-16 06:56:10
770d587314fb0275f0570b05ee5bc746c2b2c685...2d0588548e52c78e5213d262a5c4e5df1da3450e,25,4554,89,4643,54,2008-02-16 06:57:52,2008-02-16 06:57:52
2d0588548e52c78e5213d262a5c4e5df1da3450e...da6570bf082620205737c82cd7deb7185daaf538,10,607,138,745,80,2008-02-17 18:47:57,2008-02-17 18:47:57
da6570bf082620205737c82cd7deb7185daaf538...3dd28bd566f5c6b665da4729c51abe98a36caccb,33,4614,88,4702,60,2008-02-20 01:59:59,2008-02-20 01:59:59
3dd28bd566f5c6b665da4729c51abe98a36caccb...ca123b0760de38b4df50ca321927a365d2d1c796,2,28,14,42,7,2008-02-20 02:00:20,2008-02-20 02:00:20
ca123b0760de38b4df50ca321927a365d2d1c796...0c20e88e65b8c2b1d097510ee2d7cfe6b2cf9b97,4,136,15,151,19,2008-02-22 01:05:05,2008-02-22 01:05:05
0c20e88e65b8c2b1d097510ee2d7cfe6b2cf9b97...b7be3d63e36ee79db51dcabf0f210349e4d6f715,5,86,39,125,15,2008-02-22 04:58:28,2008-02-22 04:58:28
b7be3d63e36ee79db51dcabf0f210349e4d6f715...83e00a237158f7961b06abd31c2ed867f1831c3f,2,12,3,15,6,2008-02-22 04:58:53,2008-02-22 04:58:53
83e00a237158f7961b06abd31c2ed867f1831c3f...e2b3c50cf0445ff6d9c4c707f59ce64038d0fbb0,1,12,8,20,4,2008-02-22 05:46:46,2008-02-22 05:46:46
e2b3c50cf0445ff6d9c4c707f59ce64038d0fbb0...e2f524ca09bacef4545b56dc3f136655fa0b912c,3,10,2,12,3,2008-02-23 00:23:57,2008-02-23 00:23:57
e2f524ca09bacef4545b56dc3f136655fa0b912c...7355fa6b728357a3e7257fbe1175d68a0d7e2ec1,8,38,6,44,9,2008-02-23 01:34:49,2008-02-23 01:34:49
7355fa6b728357a3e7257fbe1175d68a0d7e2ec1...6ad9c684aa23c62710047f94b8febc681cc30282,6,56,11,67,14,2008-02-23 01:35:34,2008-02-23 01:35:34
6ad9c684aa23c62710047f94b8febc681cc30282...cbd6da3540e1116e6d049c2affd9f6894f427ace,4,73,0,73,5,2008-02-23 03:36:38,2008-02-23 03:36:38
cbd6da3540e1116e6d049c2affd9f6894f427ace...bdeba9ab94e8bd4012111cbde9e3606867f123cb,11,103,15,118,21,2008-02-23 09:26:11,2008-02-23 09:26:11
bdeba9ab94e8bd4012111cbde9e3606867f123cb...3691613093a5fbf450fbd98ad33c851f49d32257,1,3,1,4,2,2008-02-25 06:17:16,2008-02-25 06:17:16
3691613093a5fbf450fbd98ad33c851f49d32257...fc4c0f7b39ab62ec4da2aebf179f2ae06d49b312,1,1,6,7,3,2008-02-27 00:43:40,2008-02-27 00:43:40
fc4c0f7b39ab62ec4da2aebf179f2ae06d49b312...014373b459e0925ad757a56d9b4f049bc4f776fc,11,27,20,47,23,2008-02-27 00:44:44,2008-02-27 00:44:44
014373b459e0925ad757a56d9b4f049bc4f776fc...231e735c07db00dbb6f20f4459cd9da93af4c201,5,328,312,640,11,2008-02-27 02:15:41,2008-02-27 02:15:41
231e735c07db00dbb6f20f4459cd9da93af4c201...64315b9eec185858a02006822dfe0389026be932,2,3,17,20,6,2008-02-27 02:47:14,2008-02-27 02:47:14
64315b9eec185858a02006822dfe0389026be932...c8afb75d53a0fc1a4c8be408b0963076b1925536,1,1,1,2,1,2008-02-27 02:47:32,2008-02-27 02:47:32
c8afb75d53a0fc1a4c8be408b0963076b1925536...0588dee34cde61f408e06766d95c2a3a882883bd,4,45,45,90,26,2008-02-28 02:49:31,2008-02-28 02:49:31
0588dee34cde61f408e06766d95c2a3a882883bd...33a0862215edeaa7848e625cd0b0777fb4885de1,5,119,27,146,26,2008-02-28 12:57:10,2008-02-28 12:57:10
33a0862215edeaa7848e625cd0b0777fb4885de1...a9008f89283d62f9c424e8d7a0f4bb589c2a7963,1,8,3,11,2,2008-02-28 13:21:33,2008-02-28 13:21:33
a9008f89283d62f9c424e8d7a0f4bb589c2a7963...7c54780497aafc0749fa3f9e8d77f80e1f7b7d83,2,6,0,6,2,2008-02-28 13:31:11,2008-02-28 13:31:11
7c54780497aafc0749fa3f9e8d77f80e1f7b7d83...2f2908d7b5f5e4179c6ae185e3969fd66050ad23,18,300,47,347,40,2008-02-28 15:48:19,2008-02-28 15:48:19
2f2908d7b5f5e4179c6ae185e3969fd66050ad23...fa11a6a128886860d969c1b0315893948c062425,2,10,1,11,3,2008-02-28 17:53:00,2008-02-28 17:53:00
fa11a6a128886860d969c1b0315893948c062425...2f8f588df1f200f14d8c93414aad1411d0624315,3,179,23,202,17,2008-02-29 15:53:25,2008-02-29 15:53:25
2f8f588df1f200f14d8c93414aad1411d0624315...22ecacda1b850c75910967e94a393777ea07df13,1,2,1,3,2,2008-02-29 15:58:39,2008-02-29 15:58:39
22ecacda1b850c75910967e94a393777ea07df13...d4d528e9b05a2b0e8f6899adaa463a426feb4b91,1,3,15,18,2,2008-03-03 16:36:28,2008-03-03 16:36:28
d4d528e9b05a2b0e8f6899adaa463a426feb4b91...f2f933450f342058badce379b51b17eea81ad4de,4,88,29,117,27,2008-03-11 01:15:15,2008-03-11 01:15:15
f2f933450f342058badce379b51b17eea81ad4de...df8e3e65127252d31417856054d7a2fe3b41fb00,2,4,2,6,2,2008-03-11 02:48:39,2008-03-11 02:48:39
df8e3e65127252d31417856054d7a2fe3b41fb00...62bdb6eae8e62e7390f26daa261f75e5cca3b8e7,37,6902,3150,10052,1699,2008-03-11 03:15:07,2008-03-11 03:15:07
62bdb6eae8e62e7390f26daa261f75e5cca3b8e7...619576002d538094dde7293d970bc4698ecdbef5,3,18,2,20,3,2008-03-11 05:21:50,2008-03-11 05:21:50
619576002d538094dde7293d970bc4698ecdbef5...3176bebffd7a7e3ba131da2d1b3f9776e159f0a8,5,32,50,82,19,2008-03-11 05:36:10,2008-03-11 05:36:10
3176bebffd7a7e3ba131da2d1b3f9776e159f0a8...f3ed30f377051c3fef3d184241ed5271fbe61854,2,8,3,11,4,2008-03-11 08:23:51,2008-03-11 08:23:51
f3ed30f377051c3fef3d184241ed5271fbe61854...428450b7a90d92239b170160e5926f83085fa476,6,56,37,93,20,2008-03-12 12:41:58,2008-03-12 12:41:58
428450b7a90d92239b170160e5926f83085fa476...c8b33b824b4532e0f81abeb095764b0e3ea3c2e1,2,53,37,90,12,2008-03-12 14:52:12,2008-03-12 14:52:12
c8b33b824b4532e0f81abeb095764b0e3ea3c2e1...9f0fb3dcc9d24ec1f5abb83dfb58b6da5a6d4baa,2,8,0,8,2,2008-03-13 00:36:57,2008-03-13 00:36:57
9f0fb3dcc9d24ec1f5abb83dfb58b6da5a6d4baa...53634d4cdd45a0623cfb7b4a16c34ca7a6c9c223,1,3,1,4,1,2008-03-13 10:46:54,2008-03-13 10:46:54
53634d4cdd45a0623cfb7b4a16c34ca7a6c9c223...d91479a287fcda93415569bbf872df15bc6cdbf8,3,24,16,40,10,2008-03-13 11:48:25,2008-03-13 11:48:25
d91479a287fcda93415569bbf872df15bc6cdbf8...cf2da4689a569c9b436e2f4a1c2c0b2295c821c6,2,54,25,79,8,2008-03-14 11:45:52,2008-03-14 11:45:52
cf2da4689a569c9b436e2f4a1c2c0b2295c821c6...59ac04a54dde3a489f7948b6e6d6170d74aa80c8,2,43,9,52,12,2008-03-14 11:46:26,2008-03-14 11:46:26
59ac04a54dde3a489f7948b6e6d6170d74aa80c8...2f45deb72cf815cf78d5221a284918a5ef13e351,1,0,8,8,1,2008-03-14 11:49:31,2008-03-14 11:49:31
2f45deb72cf815cf78d5221a284918a5ef13e351...a81813fb4aec2e25850780c3846ad9743bf460ed,4,15,3,18,6,2008-03-15 01:59:06,2008-03-15 01:59:06
a81813fb4aec2e25850780c3846ad9743bf460ed...d08ec8122899697fcbc7aa2868d9b1baadb24e2b,3,6,8,14,5,2008-03-15 02:25:46,2008-03-15 02:25:46
d08ec8122899697fcbc7aa2868d9b1baadb24e2b...7534ef1f7e86a301a2dd788855095262d2925832,1,19,3,22,4,2008-03-15 09:12:44,2008-03-15 09:12:44
7534ef1f7e86a301a2dd788855095262d2925832...93baa3e4170ea40be967d48560ffca55395be07b,6,112,93,205,53,2008-03-15 09:13:22,2008-03-15 09:13:22
93baa3e4170ea40be967d48560ffca55395be07b...ade818fd7db2be2d3cb2d6e26b6cc1e06dae6865,1,6,6,12,2,2008-03-15 14:15:43,2008-03-15 14:15:43
ade818fd7db2be2d3cb2d6e26b6cc1e06dae6865...b102bf28b96826747f37cadc07a14e81899a0944,3,16,18,34,6,2008-03-15 14:16:05,2008-03-15 14:16:05
b102bf28b96826747f37cadc07a14e81899a0944...0c84766c58c0f153c0defc6d0c3a5a56dc2a271e,1,1,1,2,1,2008-03-16 01:20:51,2008-03-16 01:20:51
0c84766c58c0f153c0defc6d0c3a5a56dc2a271e...50a1880100acf022516634d782606735c82dfb47,1,1,1,2,1,2008-03-16 16:17:57,2008-03-16 16:17:57
50a1880100acf022516634d782606735c82dfb47...067d380e9879b03fc015dd087558c91c260c0e70,6,67,84,151,43,2008-03-16 16:18:39,2008-03-16 16:18:39
067d380e9879b03fc015dd087558c91c260c0e70...133111e40b3afe20e80e5f12e3b064ba080c318d,3,111,120,231,65,2008-03-17 13:32:11,2008-03-17 13:32:11
133111e40b3afe20e80e5f12e3b064ba080c318d...6df9e25b618b603fb903f9e6c74e675aa2490305,215,4781,2676,7457,1113,2008-03-18 05:45:37,2008-03-18 05:45:37
6df9e25b618b603fb903f9e6c74e675aa2490305...6b974720a916dd014a5aff22bbd2349e47d6ec6c,1,1,1,2,1,2008-03-18 06:14:56,2008-03-18 06:14:56
6b974720a916dd014a5aff22bbd2349e47d6ec6c...98b5667a06bcf47c8103bc4b1a502e3d00f3c3c6,4,5,1,6,4,2008-03-18 06:15:29,2008-03-18 06:15:29
98b5667a06bcf47c8103bc4b1a502e3d00f3c3c6...8b52e8e40e100f02f09138947fee706c00c3ccbc,1,1,3,4,2,2008-03-18 10:21:12,2008-03-18 10:21:12
8b52e8e40e100f02f09138947fee706c00c3ccbc...670be13986b74f252d479ee2b7f74da8655273f6,4,22,20,42,9,2008-03-18 10:21:50,2008-03-18 10:21:50
670be13986b74f252d479ee2b7f74da8655273f6...67cc3cec90c02201a27816552ed78b9ef7519927,1,2,2,4,1,2008-03-18 10:33:37,2008-03-18 10:33:37
67cc3cec90c02201a27816552ed78b9ef7519927...bec21f0e2b5ab44565066cdab25ec6746d96efcc,1,14,1,15,1,2008-03-18 12:46:40,2008-03-18 12:46:40
bec21f0e2b5ab44565066cdab25ec6746d96efcc...150b7ac7702195aa2d322566197be43829a6d64d,1,6,1,7,3,2008-03-18 13:53:22,2008-03-18 13:53:22
150b7ac7702195aa2d322566197be43829a6d64d...c0856978583af7aab22f08b97974a02e17cb5aad,1,1,1,2,1,2008-03-18 21:10:04,2008-03-18 21:10:04
c0856978583af7aab22f08b97974a02e17cb5aad...d20996b58dfde66d80d6728a70480c7e5caf7d48,3,83,13,96,11,2008-03-19 11:02:22,2008-03-19 11:02:22
d20996b58dfde66d80d6728a70480c7e5caf7d48...9ee77a75011a384332e52e44c527e1acea2ce1aa,1,34,16,50,17,2008-03-19 14:24:23,2008-03-19 14:24:23
9ee77a75011a384332e52e44c527e1acea2ce1aa...22bb040b60c868b77c956333ccbd3c07eb342487,1,65,186,251,5,2008-03-19 15:46:20,2008-03-19 15:46:20
22bb040b60c868b77c956333ccbd3c07eb342487...cdeebb33f57dc2e5f4d0f60fd7f4a7fee6b02cb7,1,1,1,2,1,2008-03-20 06:17:51,2008-03-20 06:17:51
cdeebb33f57dc2e5f4d0f60fd7f4a7fee6b02cb7...e2dfad15f14f4da61ec7bcfc5cab2b083fd7ec63,2,24,7,31,7,2008-03-20 16:10:51,2008-03-20 16:10:51
e2dfad15f14f4da61ec7bcfc5cab2b083fd7ec63...04da22633fcda983cb9ee69e63b2ebe99301b717,4,76,58,134,34,2008-03-20 19:16:04,2008-03-20 19:16:04
04da22633fcda983cb9ee69e63b2ebe99301b717...334279f8dd3abd98aa527a1658cb3ff5c3973ec7,58,2126,1006,3132,462,2008-03-20 19:56:44,2008-03-20 19:56:44
334279f8dd3abd98aa527a1658cb3ff5c3973ec7...e401ff8ff83d2435428d4ac9a89b5dfc3e67d616,1,17,0,17,4,2008-03-21 10:59:25,2008-03-21 10:59:25
e401ff8ff83d2435428d4ac9a89b5dfc3e67d616...7388d016805c6b5416aca224b0964a8a63fa0a3f,3,8,7,15,5,2008-03-21 11:42:00,2008-03-21 11:42:00
7388d016805c6b5416aca224b0964a8a63fa0a3f...9512ebba44307cb4562f85ea433e757af678230a,1,7,4,11,1,2008-03-21 13:53:37,2008-03-21 13:53:37
9512ebba44307cb4562f85ea433e757af678230a...0187f53f09db562faf573179f1c149718552a3d9,1,8,2,10,2,2008-03-21 16:06:41,2008-03-21 16:06:41
0187f53f09db562faf573179f1c149718552a3d9...570c12aeb8812753c61a9d5f247f09822bda91d2,1,1,1,2,1,2008-03-21 16:09:41,2008-03-21 16:09:41
570c12aeb8812753c61a9d5f247f09822bda91d2...70913a2c4358de7341525ab0e913fafd213022c2,1,8,8,16,2,2008-04-01 00:25:32,2008-04-01 00:25:32
70913a2c4358de7341525ab0e913fafd213022c2...4efe9675c5fd5a030737d957b3588184f06117fe,43,2559,1479,4038,942,2008-04-01 00:28:15,2008-04-01 00:28:15
4efe9675c5fd5a030737d957b3588184f06117fe...cfb706385b6225e9bcc028b1f8eb5aec462fc161,16,8340,3991,12331,1367,2008-04-13 03:04:11,2008-04-13 03:04:11
cfb706385b6225e9bcc028b1f8eb5aec462fc161...ed23f00a0007116a695adadc53d642ab90823823,2,8,1,9,2,2008-04-13 03:22:38,2008-04-13 03:22:38
ed23f00a0007116a695adadc53d642ab90823823...01b7a16ef0e3b11c7a2cbee5ec4a73251664d1c5,2,8,2,10,3,2008-04-13 04:42:08,2008-04-13 04:42:08
01b7a16ef0e3b11c7a2cbee5ec4a73251664d1c5...81b30438271b1dbac38ca1a2fe40f1e4dcb09293,1,7,7,14,1,2008-04-13 04:49:41,2008-04-13 04:49:41
81b30438271b1dbac38ca1a2fe40f1e4dcb09293...c934beea01b62ae0daa3ee09f1bad3fac835b019,2,8,2,10,2,2008-04-15 04:52:39,2008-04-15 04:52:39
c934beea01b62ae0daa3ee09f1bad3fac835b019...1add6fb36638f064f817d91ff5fb5222555b410c,2,7,7,14,4,2008-04-16 02:58:00,2008-04-16 02:58:00
1add6fb36638f064f817d91ff5fb5222555b410c...f2b64c0c4e6e004e56ce2404b280052fafc11d67,3,137,117,254,8,2008-04-16 02:58:26,2008-04-16 02:58:26
f2b64c0c4e6e004e56ce2404b280052fafc11d67...96d643548e7c161590b66ef893eafde5f7f35bcc,1,1,1,2,1,2008-04-16 02:58:45,2008-04-16 02:58:45
96d643548e7c161590b66ef893eafde5f7f35bcc...36bbebc739de00f768e2011afb8fe3b9ab15331f,2,13,2,15,4,2008-04-16 04:32:56,2008-04-16 04:32:56
36bbebc739de00f768e2011afb8fe3b9ab15331f...a14135e14fa79fe55dcb56cfeb102d07be166dde,5,58,49,107,44,2008-04-16 04:59:55,2008-04-16 04:59:55
a14135e14fa79fe55dcb56cfeb102d07be166dde...b114fecfe4ac817d780205a21424610ea600907b,2,10,6,16,4,2008-04-16 08:09:18,2008-04-16 08:09:18
b114fecfe4ac817d780205a21424610ea600907b...2b426635aaed0edf921a726dd95ef50a8dab9beb,2,47,3,50,6,2008-04-16 08:09:46,2008-04-16 08:09:46
2b426635aaed0edf921a726dd95ef50a8dab9beb...fcfa8b204a6c6dcd5ca688336cfe0477c43e73e9,1,0,2,2,1,2008-04-16 08:18:03,2008-04-16 08:18:03
fcfa8b204a6c6dcd5ca688336cfe0477c43e73e9...d4956cb42784770b319e5fdadd69add792c864a9,4,47,22,69,14,2008-04-20 08:47:21,2008-04-20 08:47:21
d4956cb42784770b319e5fdadd69add792c864a9...c43a3d78b1a7c65b903922679c76a499e484dea5,1,2,2,4,3,2008-04-20 08:47:41,2008-04-20 08:47:41
c43a3d78b1a7c65b903922679c76a499e484dea5...88488e5aa570f4ee552a2ce1399bd27f115b4546,2,2,2,4,2,2008-04-22 18:09:55,2008-04-22 18:09:55
88488e5aa570f4ee552a2ce1399bd27f115b4546...0a66eabc8ab9d11e131101c861a781810067c09e,1,1,1,2,1,2008-04-22 18:10:12,2008-04-22 18:10:12
0a66eabc8ab9d11e131101c861a781810067c09e...5a9a208b7a72a1ce6b73ac4bbc93b8468da1b891,1,16,3,19,3,2008-04-23 07:30:30,2008-04-23 07:30:30
5a9a208b7a72a1ce6b73ac4bbc93b8468da1b891...382d31a981a6682484e2f8346b939429588cb562,2,11,4,15,3,2008-04-23 07:30:59,2008-04-23 07:30:59
382d31a981a6682484e2f8346b939429588cb562...42260ef73762e17aaab72f1dd306c9c7a5f24640,1,11,4,15,9,2008-04-23 09:26:14,2008-04-23 09:26:14
42260ef73762e17aaab72f1dd306c9c7a5f24640...42dc3b9ba247ea035e2d2855917592bdda5f5812,2,17,2,19,4,2008-04-23 09:53:22,2008-04-23 09:53:22
42dc3b9ba247ea035e2d2855917592bdda5f5812...19d6bc7acd68f5e93e1ffe9f45b8e8b9021c2151,2,15,4,19,4,2008-04-23 10:43:42,2008-04-23 10:43:42
19d6bc7acd68f5e93e1ffe9f45b8e8b9021c2151...27b0a4c4e7cb491b24c802f00e06ae0c6b3cc57d,1,0,4,4,1,2008-04-23 12:34:13,2008-04-23 12:34:13
27b0a4c4e7cb491b24c802f00e06ae0c6b3cc57d...9d6f0f9e1085d963d96168efaf07315613cb8cc0,4,21,21,42,20,2008-04-24 11:11:30,2008-04-24 11:11:30
9d6f0f9e1085d963d96168efaf07315613cb8cc0...675815d6a1ab6297692e6f9274674b8c8f52fd01,1,4,0,4,1,2008-04-24 11:21:49,2008-04-24 11:21:49
675815d6a1ab6297692e6f9274674b8c8f52fd01...28b1c9c1c95fe6193e234f85f51ec593cac3b861,1,22,1,23,2,2008-04-24 11:41:29,2008-04-24 11:41:29
28b1c9c1c95fe6193e234f85f51ec593cac3b861...dd0c5855e9dc0c88f99c004db544c34eb67cf499,2,4,7,11,5,2008-04-24 12:15:46,2008-04-24 12:15:46
dd0c5855e9dc0c88f99c004db544c34eb67cf499...8a4e1de8b0573ce4330f7690fe5e9d786265e237,4,73,20,93,22,2008-04-24 16:07:07,2008-04-24 16:07:07
8a4e1de8b0573ce4330f7690fe5e9d786265e237...6657d476d03fbc5cd1d9a64922f2a8b7c97ddf05,2,44,13,57,14,2008-04-25 06:54:35,2008-04-25 06:54:35
6657d476d03fbc5cd1d9a64922f2a8b7c97ddf05...bb9261197996464edc6398d194ec4e0b00d1c555,1,13,8,21,3,2008-04-25 15:01:40,2008-04-25 15:01:40
bb9261197996464edc6398d194ec4e0b00d1c555...fcc3648b60c64b8242ddddb84d636e3a6248aee5,1,1,1,2,1,2008-04-25 15:01:59,2008-04-25 15:01:59
fcc3648b60c64b8242ddddb84d636e3a6248aee5...05e4d51f0d1924efec47c39215d6baf682688fe7,3,14,35,49,12,2008-04-25 15:02:25,2008-04-25 15:02:25
05e4d51f0d1924efec47c39215d6baf682688fe7...caa150e45e67780da7b7f772df43239cf503696e,2,42,24,66,20,2008-04-25 17:08:28,2008-04-25 17:08:28
caa150e45e67780da7b7f772df43239cf503696e...d7ac1330c50f7fd7fe06e55c7470e406d201b946,1,1,1,2,1,2008-04-26 02:41:58,2008-04-26 02:41:58
d7ac1330c50f7fd7fe06e55c7470e406d201b946...67bfd15c47d16cd0b63c66f421854e3353fe9351,1,29,24,53,15,2008-04-26 04:03:26,2008-04-26 04:03:26
67bfd15c47d16cd0b63c66f421854e3353fe9351...dd432cc94177f84e984b30f08ce473a8951ad8f7,1,3,3,6,3,2008-04-26 05:06:21,2008-04-26 05:06:21
dd432cc94177f84e984b30f08ce473a8951ad8f7...bb132aa3951c3d3582be608d9bb7af5a707bf6e6,2,7,2,9,4,2008-04-26 09:06:56,2008-04-26 09:06:56
bb132aa3951c3d3582be608d9bb7af5a707bf6e6...3933aff6ccc05510deacd429b0c0d3cd8c909009,2,21,3,24,15,2008-04-26 11:20:42,2008-04-26 11:20:42
3933aff6ccc05510deacd429b0c0d3cd8c909009...0b30bed861680f28396c9bd94c05ad5f1f4c3394,1,46,40,86,3,2008-04-26 11:21:02,2008-04-26 11:21:02
0b30bed861680f28396c9bd94c05ad5f1f4c3394...177f7d51647f4d6be6b840c32a4abbf460ed03be,2,58,29,87,5,2008-04-26 16:41:51,2008-04-26 16:41:51
177f7d51647f4d6be6b840c32a4abbf460ed03be...4a5c5c78f2ecd4ed8859cd5ac773ff3a01bccf96,1,2,2,4,2,2008-04-27 00:29:58,2008-04-27 00:29:58
e9f647e11f9ee77dea71f9302904474c13ff3b5a...ba592950689a06893c77bc97040770f89dd5a317,1,3,2,5,1,2008-09-30 03:58:09,2008-09-30 03:58:09
ba592950689a06893c77bc97040770f89dd5a317...37ee86b7ee63e057db0a5b868be7f799d8a4d40e,4,28,6,34,4,2008-09-30 05:52:35,2008-09-30 05:52:35
37ee86b7ee63e057db0a5b868be7f799d8a4d40e...97087962b1272b41b5797830d9fff829d32fd6de,1,39,14,53,7,2008-09-30 17:45:58,2008-09-30 17:45:58
97087962b1272b41b5797830d9fff829d32fd6de...8e608c2155a4a466f1a4bf87df05c4e4ebd90c1c,1,15,7,22,2,2008-09-30 17:50:44,2008-09-30 17:50:44
8e608c2155a4a466f1a4bf87df05c4e4ebd90c1c...73c0db8e421bcb1621a5be59e5cf0fd0421e12d9,1,0,8,8,1,2008-09-30 22:29:58,2008-09-30 22:29:58
73c0db8e421bcb1621a5be59e5cf0fd0421e12d9...2d3712f930916c5f45ef3a4d68a56e0add2a621c,1,3,5,8,1,2008-10-01 01:22:41,2008-10-01 01:22:41
2d3712f930916c5f45ef3a4d68a56e0add2a621c...8d98e70e42fcec39a78b45b7652880634e38bf88,10,43,118,161,34,2008-10-02 12:57:13,2008-10-02 12:57:13
8d98e70e42fcec39a78b45b7652880634e38bf88...a8557557118d453e51ead4d7685f863c4c4ef5c9,1,17,17,34,16,2008-10-04 01:16:30,2008-10-04 01:16:30
a8557557118d453e51ead4d7685f863c4c4ef5c9...d343aa3022b3f18c89b06766b87bf71dda730afd,1,2,2,4,2,2008-10-05 04:59:55,2008-10-05 04:59:55
d343aa3022b3f18c89b06766b87bf71dda730afd...cf34d1f6870b0651c52f50a670f31f33201cd7a3,2,0,53,53,2,2008-10-05 05:04:56,2008-10-05 05:04:56
cf34d1f6870b0651c52f50a670f31f33201cd7a3...18f13aeeab7ab667df0d9c2ae556fd2f4fce3ad4,1,2,3,5,2,2008-10-05 05:05:32,2008-10-05 05:05:32
18f13aeeab7ab667df0d9c2ae556fd2f4fce3ad4...16d0a615c49830624c026b27607e46fc329ef4f4,5,14,14,28,11,2008-10-05 05:06:26,2008-10-05 05:06:26
16d0a615c49830624c026b27607e46fc329ef4f4...227a93b64f582d62087ecbb19d281b9c6e5a2dcf,2,20,3,23,4,2008-10-05 05:07:32,2008-10-05 05:07:32
227a93b64f582d62087ecbb19d281b9c6e5a2dcf...85240897695b39e40e36127f8b26c7d0f066c16a,12,56,49,105,43,2008-10-05 05:09:21,2008-10-05 05:09:21
85240897695b39e40e36127f8b26c7d0f066c16a...645029accbf8c061e87f71271a77993a0467142a,1,1,1,2,1,2008-10-05 05:09:59,2008-10-05 05:09:59
645029accbf8c061e87f71271a77993a0467142a...cff78c60acb36382df6e21db2161ca43510062fe,1,3,5,8,3,2008-10-05 05:10:35,2008-10-05 05:10:35
cff78c60acb36382df6e21db2161ca43510062fe...7cec38b0762622541ddf3904e6363362cb3fba23,2,5,3,8,3,2008-10-05 05:59:04,2008-10-05 05:59:04
7cec38b0762622541ddf3904e6363362cb3fba23...d3c60936451592f1c1849a16b6d325e2f5619917,1,1,1,2,1,2008-10-05 06:17:29,2008-10-05 06:17:29
d3c60936451592f1c1849a16b6d325e2f5619917...93aec4e44aac10ed205f89ec822f425812014196,1,1,1,2,1,2008-10-05 06:18:08,2008-10-05 06:18:08
93aec4e44aac10ed205f89ec822f425812014196...514fba5b920aa1aceef0d1f5d0b7c10d9f315c06,1,2,2,4,1,2008-10-05 06:18:41,2008-10-05 06:18:41
514fba5b920aa1aceef0d1f5d0b7c10d9f315c06...e466d2ea53b43b453625808794b72afdc9be9816,1,4,4,8,1,2008-10-05 06:19:06,2008-10-05 06:19:06
e466d2ea53b43b453625808794b72afdc9be9816...7e4d2778e61234cbd6698dafeb31d426cb83f992,1,1,0,1,1,2008-10-05 06:38:59,2008-10-05 06:38:59
7e4d2778e61234cbd6698dafeb31d426cb83f992...5cd7af58c933a093aa17515d099d45bc9347d2c8,1,6,1,7,2,2008-10-05 06:39:26,2008-10-05 06:39:26
5cd7af58c933a093aa17515d099d45bc9347d2c8...0995b63b77903297bc41b31f4762fd76563af248,1,6,2,8,2,2008-10-05 06:56:15,2008-10-05 06:56:15
0995b63b77903297bc41b31f4762fd76563af248...e1b7211083f6b1b8a4bc5c9f391c416b2ab5b7ab,1,0,1,1,1,2008-10-05 08:51:14,2008-10-05 08:51:14
e1b7211083f6b1b8a4bc5c9f391c416b2ab5b7ab...806ea3a1dede8d51df11c2bd9c2f23be95ea6e00,1,3,2,5,2,2008-10-05 08:58:17,2008-10-05 08:58:17
806ea3a1dede8d51df11c2bd9c2f23be95ea6e00...2f188334d359c444d7f134fbde3751f75b212cf9,1,6,0,6,3,2008-10-05 11:39:58,2008-10-05 11:39:58
2f188334d359c444d7f134fbde3751f75b212cf9...40904d0404a6d6a34b6f35e7c33be702326e042a,1,2,1,3,1,2008-10-05 11:55:52,2008-10-05 11:55:52
40904d0404a6d6a34b6f35e7c33be702326e042a...2f0be0faae2f10b6ae8c049e8469ab8404f9c7bf,1,1,0,1,1,2008-10-05 12:07:10,2008-10-05 12:07:10
2f0be0faae2f10b6ae8c049e8469ab8404f9c7bf...b131462d76d028ef8b0aaebdfcf3e63370e57c49,1,16,0,16,1,2008-10-05 16:03:58,2008-10-05 16:03:58
b131462d76d028ef8b0aaebdfcf3e63370e57c49...5d3b222a598931840d4743d3170944f2c1f54719,2,27,0,27,3,2008-10-06 01:36:35,2008-10-06 01:36:35
5d3b222a598931840d4743d3170944f2c1f54719...e2b02eae10131de034a2fa23bf1b00b546b86026,2,179,73,252,47,2008-10-06 04:19:11,2008-10-06 04:19:11
e2b02eae10131de034a2fa23bf1b00b546b86026...c58c1f43cf4f35088f815692a5410261e21dfc47,1,5,3,8,2,2008-10-06 04:54:14,2008-10-06 04:54:14
c58c1f43cf4f35088f815692a5410261e21dfc47...fb62bcc69e82797782b70288d11789155e4169a5,1,9,18,27,4,2008-10-06 05:14:17,2008-10-06 05:14:17
fb62bcc69e82797782b70288d11789155e4169a5...8fb1459b5294fb9327b241fffec8576c5aa3fc7e,4,52,20,72,12,2008-10-06 06:34:54,2008-10-06 06:34:54
8fb1459b5294fb9327b241fffec8576c5aa3fc7e...a011a494570dbe66db11e5a9bbb901d8b3e27be7,1,4,3,7,2,2008-10-06 08:27:24,2008-10-06 08:27:24
a011a494570dbe66db11e5a9bbb901d8b3e27be7...e0a09b7dacea4c8ecdca94decc3ec54bdf336743,1,4,4,8,2,2008-10-06 08:28:18,2008-10-06 08:28:18
e0a09b7dacea4c8ecdca94decc3ec54bdf336743...8cbf5d102c43dc27d8728e019a607ca866b73dec,1,16,2,18,3,2008-10-06 08:29:05,2008-10-06 08:29:05
8cbf5d102c43dc27d8728e019a607ca866b73dec...cddece2db12c28e4f87f7c4d1819461f573d157f,1,34,0,34,2,2008-10-06 08:30:02,2008-10-06 08:30:02
cddece2db12c28e4f87f7c4d1819461f573d157f...fa63f1642d3899324a6d051e964ce4b878170ff9,1,14,0,14,1,2008-10-06 08:31:32,2008-10-06 08:31:32
fa63f1642d3899324a6d051e964ce4b878170ff9...452ba4a8f743e9b553661f53231f224eb441c64e,1,20,1,21,1,2008-10-06 08:32:35,2008-10-06 08:32:35
452ba4a8f743e9b553661f53231f224eb441c64e...870a6ec20c3a912ed7bb9a86fd68fd93b026e48e,2,12,8,20,4,2008-10-06 11:18:30,2008-10-06 11:18:30
870a6ec20c3a912ed7bb9a86fd68fd93b026e48e...49c61ab1ab062ca40a51127c2a644d653db4f6d7,1,9,2,11,1,2008-10-06 11:20:15,2008-10-06 11:20:15
49c61ab1ab062ca40a51127c2a644d653db4f6d7...a928c563e901362e55bdf732ca4276550316ce4d,1,208,12,220,12,2008-10-06 11:21:11,2008-10-06 11:21:11
a928c563e901362e55bdf732ca4276550316ce4d...30b568226f86f268628ac40890a8fa40c4db0b97,2,63,23,86,6,2008-10-07 08:22:50,2008-10-07 08:22:50
30b568226f86f268628ac40890a8fa40c4db0b97...cd8eeaacf53677044eb8022220ef5939a91228ae,6,138,1,139,6,2008-10-07 09:23:40,2008-10-07 09:23:40
cd8eeaacf53677044eb8022220ef5939a91228ae...2ae36375fc48fae0024ffbd3e7f6bdd0604ca4fc,1,4,2,6,2,2008-10-07 10:39:16,2008-10-07 10:39:16
2ae36375fc48fae0024ffbd3e7f6bdd0604ca4fc...777aaf03330be83beb4af869d83ab3823a330ba8,1,1,0,1,1,2008-10-07 11:48:11,2008-10-07 11:48:11
777aaf03330be83beb4af869d83ab3823a330ba8...08c3ad0cd0621ed956697279496afba14a957e2f,1,4,0,4,1,2008-10-07 11:49:50,2008-10-07 11:49:50
08c3ad0cd0621ed956697279496afba14a957e2f...72f387d3448a211b571c4938561b2c3ce6fb5d70,2,84,26,110,27,2008-10-07 11:51:14,2008-10-07 11:51:14
72f387d3448a211b571c4938561b2c3ce6fb5d70...70b6c4c015b66626e65006f081cfe348f5726500,2,16,2,18,2,2008-10-07 12:20:01,2008-10-07 12:20:01
70b6c4c015b66626e65006f081cfe348f5726500...ce770aaecd1f3677c501ab41e5adbed8db44f109,1,8,0,8,1,2008-10-08 08:36:41,2008-10-08 08:36:41
ce770aaecd1f3677c501ab41e5adbed8db44f109...268ef594ace36e82043b2f9b6eaa18531cd24b2f,2,4,2,6,3,2008-10-08 08:37:35,2008-10-08 08:37:35
268ef594ace36e82043b2f9b6eaa18531cd24b2f...44f228fd61e5f45dbdfa465291319dfd5dd66393,2,8,2,10,3,2008-10-08 08:38:33,2008-10-08 08:38:33
44f228fd61e5f45dbdfa465291319dfd5dd66393...559aca7d78cd6f0c24260ba9197579b2c9c53bd2,2,7,1,8,2,2008-10-08 09:45:27,2008-10-08 09:45:27
559aca7d78cd6f0c24260ba9197579b2c9c53bd2...7e7a370e20b57c0a4906aa82a4763119342823cc,3,57,15,72,15,2008-10-08 10:09:44,2008-10-08 10:09:44
7e7a370e20b57c0a4906aa82a4763119342823cc...05d695908c6c89f36431ac53eb2d41a307b8cf1a,4,99,21,120,16,2008-10-08 14:47:01,2008-10-08 14:47:01
05d695908c6c89f36431ac53eb2d41a307b8cf1a...27d4f5b84cde458e0ebb1f5c1e02bccf988db7cf,1,3,2,5,5,2008-10-09 09:00:19,2008-10-09 09:00:19
27d4f5b84cde458e0ebb1f5c1e02bccf988db7cf...0b7b74432a19b31107f333ce7fc1ff6ca4a6ed76,1,3,3,6,1,2008-10-09 09:19:47,2008-10-09 09:19:47
0b7b74432a19b31107f333ce7fc1ff6ca4a6ed76...ede4f94621e1e12d219fa90d718e618a9d21bc06,1,1,1,2,1,2008-10-09 09:30:54,2008-10-09 09:30:54
ede4f94621e1e12d219fa90d718e618a9d21bc06...227a5a4ee62acb6afbd77d1bbcf1d534d8a05c49,1,1,1,2,1,2008-10-09 23:35:34,2008-10-09 23:35:34
227a5a4ee62acb6afbd77d1bbcf1d534d8a05c49...9a72913edd10dbf2214397b20c3f5f501afd506b,2,17,35,52,5,2008-10-10 17:15:58,2008-10-10 17:15:58
9a72913edd10dbf2214397b20c3f5f501afd506b...c1851350687eb8aed5fd51db37c2eca35b2167cd,1,5,4,9,5,2008-10-10 20:09:51,2008-10-10 20:09:51
c1851350687eb8aed5fd51db37c2eca35b2167cd...b21ea0a8363203087e5bcb3004735db0d4143490,2,68,40,108,19,2008-10-10 21:41:12,2008-10-10 21:41:12
b21ea0a8363203087e5bcb3004735db0d4143490...d7c829c98ebb709a7c7bc263c6c195d8155ee7fb,3,34,14,48,14,2008-10-10 22:13:16,2008-10-10 22:13:16
d7c829c98ebb709a7c7bc263c6c195d8155ee7fb...51d101b57355b0c593f07094c20f949e5107ebd0,1,6,1,7,2,2008-10-13 19:38:18,2008-10-13 19:38:18
51d101b57355b0c593f07094c20f949e5107ebd0...9feebb10f91cb7faf00b6a83ea5a7d03f739e421,1,4,3,7,1,2008-10-17 22:43:36,2008-10-17 22:43:36
9feebb10f91cb7faf00b6a83ea5a7d03f739e421...934025e58d03be49e9fe8bdd54c99d73373137ea,1,3,2,5,2,2008-10-18 00:00:20,2008-10-18 00:00:20
934025e58d03be49e9fe8bdd54c99d73373137ea...a14b98e207bd2987a99e3e816be17e773fd0341f,1,2,3,5,3,2008-10-21 04:32:02,2008-10-21 04:32:02
a14b98e207bd2987a99e3e816be17e773fd0341f...49ef21d9ea3070aba863af83b22d1ff6dba69f45,2,44,13,57,7,2008-10-21 14:04:24,2008-10-21 14:04:24
49ef21d9ea3070aba863af83b22d1ff6dba69f45...ae43d11838c783797805774a76cd15ff6ea565ba,4,52,4,56,7,2008-10-21 19:03:21,2008-10-21 19:03:21
ae43d11838c783797805774a76cd15ff6ea565ba...5e5af8a8aae3c860f2b9463b2a5df713fc53d6d0,4,16,2,18,5,2008-10-21 20:25:45,2008-10-21 20:25:45
5e5af8a8aae3c860f2b9463b2a5df713fc53d6d0...30241385d538a9d6abb89ff9f74dfd5a424c7a87,2,18,10,28,3,2008-10-22 23:09:35,2008-10-22 23:09:35
30241385d538a9d6abb89ff9f74dfd5a424c7a87...62c3a7a6254b2038b0fe13e9c9f779bb2ca95c3c,1,1,1,2,1,2008-10-24 04:37:51,2008-10-24 04:37:51
62c3a7a6254b2038b0fe13e9c9f779bb2ca95c3c...e3aa9a28288737a75f05f2174b4105d01e52af96,3,38,1,39,6,2008-10-24 04:38:43,2008-10-24 04:38:43
e3aa9a28288737a75f05f2174b4105d01e52af96...9319dc496c5f8d215a293fff5fb974e48e68454d,2,27,7,34,4,2008-10-24 06:09:47,2008-10-24 06:09:47
9319dc496c5f8d215a293fff5fb974e48e68454d...3b5d975ff67cfeebc4ec8f49b7a851aa3b7401e9,1,6,5,11,1,2008-10-24 06:24:04,2008-10-24 06:24:04
3b5d975ff67cfeebc4ec8f49b7a851aa3b7401e9...92a6c1429162d132a00c8b06efc960ba1d2dcc3e,2,7,7,14,5,2008-10-24 07:14:30,2008-10-24 07:14:30
92a6c1429162d132a00c8b06efc960ba1d2dcc3e...9900c87161279de20760f53b45076d0f216632a2,1,38,3,41,3,2008-10-24 07:15:07,2008-10-24 07:15:07
9900c87161279de20760f53b45076d0f216632a2...032b7bc45e606767bdb129be52eb5cccc716d907,1,6,4,10,2,2008-10-24 07:15:52,2008-10-24 07:15:52
032b7bc45e606767bdb129be52eb5cccc716d907...1dafebaed1aaa81f1ba038e17c98e76d281d7378,1,1,1,2,1,2008-10-24 07:16:23,2008-10-24 07:16:23
1dafebaed1aaa81f1ba038e17c98e76d281d7378...3bdde9ef9a8fb507d4beabcd60fdaf132820cbf0,5,1950,1475,3425,672,2008-10-24 07:35:31,2008-10-24 07:35:31
3bdde9ef9a8fb507d4beabcd60fdaf132820cbf0...2f87035aac839b6b90950cd3cf64c6b712bb905b,2,1,1,2,1,2008-10-24 07:36:47,2008-10-24 07:36:47
2f87035aac839b6b90950cd3cf64c6b712bb905b...cbe11c1982b5519171a8caae6f99629899dc929b,2,21,5,26,3,2008-10-24 09:24:42,2008-10-24 09:24:42
cbe11c1982b5519171a8caae6f99629899dc929b...c57fe6c3ece9f47778d7e00533b7d278e3e516f1,1,5,1,6,1,2008-10-24 09:25:32,2008-10-24 09:25:32
c57fe6c3ece9f47778d7e00533b7d278e3e516f1...03fcf19fd2043fe096d8ac63abb3fd7e533b639a,1,2,1,3,1,2008-10-24 09:26:09,2008-10-24 09:26:09
03fcf19fd2043fe096d8ac63abb3fd7e533b639a...3dfbaae32b2e87fd1f47b569f973fb3f76602137,2,31,3,34,5,2008-10-24 09:36:22,2008-10-24 09:36:22
3dfbaae32b2e87fd1f47b569f973fb3f76602137...03070a9955775017d2e313a851c435bc85041ced,2,10,1,11,3,2008-10-24 19:14:24,2008-10-24 19:14:24
03070a9955775017d2e313a851c435bc85041ced...3784c7fac63eb9bbff7fe4b43da933a2607507fd,1,3,0,3,1,2008-10-25 19:16:45,2008-10-25 19:16:45
3784c7fac63eb9bbff7fe4b43da933a2607507fd...2d40c75acf1c3247139a1248e5f7ba4e5211ccee,1,4,4,8,2,2008-10-26 03:09:29,2008-10-26 03:09:29
2d40c75acf1c3247139a1248e5f7ba4e5211ccee...0503442d2caf3e26f732e7b87b524e922d293788,1,2,2,4,1,2008-10-26 03:10:13,2008-10-26 03:10:13
0503442d2caf3e26f732e7b87b524e922d293788...cbeea831074009a58a2d790ec1da96f53c2201cf,1,1,1,2,1,2008-10-26 18:01:15,2008-10-26 18:01:15
cbeea831074009a58a2d790ec1da96f53c2201cf...0b6d214f481e5412da0edb6c940db86e520b04c3,3,26,3,29,4,2008-10-26 22:24:21,2008-10-26 22:24:21
0b6d214f481e5412da0edb6c940db86e520b04c3...243dea4cd642ab007093b9b9ab9daa35af01d0aa,1,1,1,2,1,2008-10-28 00:39:23,2008-10-28 00:39:23
243dea4cd642ab007093b9b9ab9daa35af01d0aa...34acd39e5d4dc1dd30ce75d512a9e7ffc0320a6b,1,0,2,2,1,2008-10-28 16:19:14,2008-10-28 16:19:14
34acd39e5d4dc1dd30ce75d512a9e7ffc0320a6b...202693460096c1d5f4a614dd4facc5af1a9599de,3,11,1,12,3,2008-10-28 19:00:49,2008-10-28 19:00:49
202693460096c1d5f4a614dd4facc5af1a9599de...524a44e20b42995ba67db8aadc781a9270117b59,2,30,1,31,3,2008-10-28 20:01:03,2008-10-28 20:01:03
524a44e20b42995ba67db8aadc781a9270117b59...fe54f06a61ff55bcf7e233e7e11d633bae0cf36f,2,215,109,324,79,2008-10-30 07:08:21,2008-10-30 07:08:21
fe54f06a61ff55bcf7e233e7e11d633bae0cf36f...0ea15f5650bc83483fc4ac18b379ae4add373573,5,129,26,155,22,2008-10-31 22:07:05,2008-10-31 22:07:05
0ea15f5650bc83483fc4ac18b379ae4add373573...3028e85222f12bf64a1b3bad34f88e432b3f971f,9,2024,402,2426,50,2008-10-31 22:19:21,2008-10-31 22:19:21
3028e85222f12bf64a1b3bad34f88e432b3f971f...50535505a9fe0b247a675b02515c9f12cc3b5e6e,4,11,18,29,13,2008-10-31 23:01:38,2008-10-31 23:01:38
50535505a9fe0b247a675b02515c9f12cc3b5e6e...6b82c386f617fd2f0f92e3991d2d5f77ba572cd0,2,25,21,46,8,2008-10-31 23:44:24,2008-10-31 23:44:24
6b82c386f617fd2f0f92e3991d2d5f77ba572cd0...ac0808f70b9a0286519f53863066bc71876c2abd,4,743,747,1490,5,2008-10-31 23:52:31,2008-10-31 23:52:31
ac0808f70b9a0286519f53863066bc71876c2abd...6df10c5deae59d521fe0b2a94b5d9a81ae92d6de,2,210,71,281,72,2008-11-01 13:00:09,2008-11-01 13:00:09
6df10c5deae59d521fe0b2a94b5d9a81ae92d6de...c8e68fabbc646aec728b9af044618a16e6c0b456,2,1,235,236,2,2008-11-01 13:08:17,2008-11-01 13:08:17
c8e68fabbc646aec728b9af044618a16e6c0b456...8955a085a5b2cb9dd4a41c22fbb90c527e5b55f2,1,1,1,2,1,2008-11-01 18:04:36,2008-11-01 18:04:36
8955a085a5b2cb9dd4a41c22fbb90c527e5b55f2...d4f4ab853532c0b541e640eb2e3f5ec17f0b9dd6,10,11,11,22,11,2008-11-01 19:02:09,2008-11-01 19:02:09
d4f4ab853532c0b541e640eb2e3f5ec17f0b9dd6...021b40a84cb0e9f50517ab182e24a6cd469e2a97,1,2,2,4,2,2008-11-01 19:20:00,2008-11-01 19:20:00
021b40a84cb0e9f50517ab182e24a6cd469e2a97...dd9fd8056175094ea372cf728c504c27368a8ac1,1,1,1,2,1,2008-11-01 19:45:03,2008-11-01 19:45:03
dd9fd8056175094ea372cf728c504c27368a8ac1...2efa5f80d62bed093f7fcce15779bb9c6f438073,1,1,1,2,1,2008-11-01 20:14:36,2008-11-01 20:14:36
2efa5f80d62bed093f7fcce15779bb9c6f438073...74cd0789e1240bff9dd9fdc37c3e743df784ac6c,0,0,0,0,0,2008-11-01 20:33:52,2008-11-01 20:33:52
74cd0789e1240bff9dd9fdc37c3e743df784ac6c...1f69b11ef534bef2a837870cd59cd9cd658aec3d,1,1,1,2,1,2008-11-01 20:51:54,2008-11-01 20:51:54
1f69b11ef534bef2a837870cd59cd9cd658aec3d...83af0b8ff355698a3aa436bad851156c9619f7ee,2,22,0,22,2,2008-11-01 22:25:41,2008-11-01 22:25:41
83af0b8ff355698a3aa436bad851156c9619f7ee...8a5f2ee912cb29191f35618a05ee90a3df636ae3,1,1,1,2,1,2008-11-02 04:17:59,2008-11-02 04:17:59
8a5f2ee912cb29191f35618a05ee90a3df636ae3...c4835830235574886f9bd2b54ace5406bea2d931,11,23,21,44,17,2008-11-02 20:43:20,2008-11-02 20:43:20
c4835830235574886f9bd2b54ace5406bea2d931...834ca580fcde54948894812aa6120fbec747d052,1,1,1,2,1,2008-11-02 21:38:44,2008-11-02 21:38:44
834ca580fcde54948894812aa6120fbec747d052...1515b13d1a83a713d7a2fffb661a1251b483ed37,3,27,2,29,8,2008-11-04 19:48:35,2008-11-04 19:48:35
1515b13d1a83a713d7a2fffb661a1251b483ed37...b401d44a9f51161f3b42ebc3f70f8c1fd0b5b782,3,43,20,63,22,2008-11-05 17:51:11,2008-11-05 17:51:11
b401d44a9f51161f3b42ebc3f70f8c1fd0b5b782...e600364f7ddc77c45339bee5527f2e3898e7b126,1,14,4,18,4,2008-11-05 18:15:48,2008-11-05 18:15:48
e600364f7ddc77c45339bee5527f2e3898e7b126...21fa51724822b4aa89bc1e110c2ce9b8477f9e64,2,32,2,34,4,2008-11-05 19:47:44,2008-11-05 19:47:44
21fa51724822b4aa89bc1e110c2ce9b8477f9e64...916d61d8de0476bbd17d234e4c5f1b0b74c34e53,4,422,150,572,146,2008-11-06 08:55:39,2008-11-06 08:55:39
916d61d8de0476bbd17d234e4c5f1b0b74c34e53...432cf20fd13451ab79f24b1425a83566f2c2c063,2,179,48,227,43,2008-11-06 09:16:11,2008-11-06 09:16:11
432cf20fd13451ab79f24b1425a83566f2c2c063...e972589f994421b430a81ed378c968158c5b8f3a,2,1,1,2,1,2008-11-06 09:21:06,2008-11-06 09:21:06
e972589f994421b430a81ed378c968158c5b8f3a...73b458232ef552afce2c767bb8d278421d02a27c,4,218,83,301,83,2008-11-06 09:32:57,2008-11-06 09:32:57
73b458232ef552afce2c767bb8d278421d02a27c...8ae06470df683086c83db2c5e1177448fc49521f,2,210,72,282,73,2008-11-06 09:43:32,2008-11-06 09:43:32
8ae06470df683086c83db2c5e1177448fc49521f...82c89d0c262b7aed24866eaf0c0e33cb013f6813,2,11,11,22,11,2008-11-06 09:43:56,2008-11-06 09:43:56
82c89d0c262b7aed24866eaf0c0e33cb013f6813...fb8a7702a022e5d85398838ab1a0a797519ac9cc,1,6,6,12,6,2008-11-06 10:24:24,2008-11-06 10:24:24
fb8a7702a022e5d85398838ab1a0a797519ac9cc...b2d2c570b7a8936f60645175c48bfae5eb2481fa,2,25,18,43,10,2008-11-06 11:19:13,2008-11-06 11:19:13
b2d2c570b7a8936f60645175c48bfae5eb2481fa...7e03244f03f99ddc64bdf00234125d6ceea78f35,1,1,0,1,1,2008-11-06 11:21:06,2008-11-06 11:21:06
7e03244f03f99ddc64bdf00234125d6ceea78f35...e40bd61ef7cf96934eaafa4175f82de964967174,1,1,1,2,1,2008-11-06 14:32:33,2008-11-06 14:32:33
e40bd61ef7cf96934eaafa4175f82de964967174...04354e1afcd5d4b4813282c4849017b89f66aa24,1,2,2,4,2,2008-11-06 16:44:42,2008-11-06 16:44:42
04354e1afcd5d4b4813282c4849017b89f66aa24...bcd63cbfb0590a2e2bed3e4beab3f467279ad3db,5,28,13,41,15,2008-11-06 19:49:24,2008-11-06 19:49:24
bcd63cbfb0590a2e2bed3e4beab3f467279ad3db...cadbf66635e32099146a0c08373199d183e50f82,2,12,7,19,8,2008-11-06 21:36:01,2008-11-06 21:36:01
cadbf66635e32099146a0c08373199d183e50f82...b81bc22ad241d2ff72344885a44eb61f0cf9a99c,2,63,15,78,17,2008-11-08 01:44:46,2008-11-08 01:44:46
b81bc22ad241d2ff72344885a44eb61f0cf9a99c...c367e2869eaa28598aab7aa7ea2e76b596fe09b2,2,13,1,14,2,2008-11-09 18:51:28,2008-11-09 18:51:28
c367e2869eaa28598aab7aa7ea2e76b596fe09b2...c672e44ea9132d5b89f2156cfb01c4226c298943,1,2,2,4,1,2008-11-09 19:01:34,2008-11-09 19:01:34
c672e44ea9132d5b89f2156cfb01c4226c298943...b4b705bee1277892668d5261b9d1a08dbe93a9de,5,4272,2,4274,6,2008-11-10 10:13:23,2008-11-10 10:13:23
b4b705bee1277892668d5261b9d1a08dbe93a9de...ec8435cefd34c296bac01cba2a8da501e585b783,2,13,8,21,9,2008-11-10 10:23:44,2008-11-10 10:23:44
ec8435cefd34c296bac01cba2a8da501e585b783...b69182fcc3c60d7621849fb0b35a1eb510a42803,3,3,4,7,3,2008-11-10 10:24:51,2008-11-10 10:24:51
b69182fcc3c60d7621849fb0b35a1eb510a42803...7760ae754a8e88374af906b87babd6afd48677d6,2,224,90,314,75,2008-11-10 10:31:21,2008-11-10 10:31:21
7760ae754a8e88374af906b87babd6afd48677d6...6ed91234e39370ba979df09686a301f014573508,2,4,4,8,4,2008-11-10 17:13:41,2008-11-10 17:13:41
6ed91234e39370ba979df09686a301f014573508...8cdc53a265cfbf72ae87aa607a95f4a7eb9a3ac3,2,4,1,5,3,2008-11-10 19:42:55,2008-11-10 19:42:55
8cdc53a265cfbf72ae87aa607a95f4a7eb9a3ac3...d82aaef8446c4188a27ba4347b75f0dffaa42f0a,2,13,12,25,6,2008-11-10 19:52:53,2008-11-10 19:52:53
d82aaef8446c4188a27ba4347b75f0dffaa42f0a...ad4e1a7a72136b5a6364b60ccf8a3e3ae387814a,1,9,0,9,1,2008-11-10 20:01:51,2008-11-10 20:01:51
ad4e1a7a72136b5a6364b60ccf8a3e3ae387814a...675a4a1067123fe87512dff4c458e4a08eb7c86d,1,1,1,2,1,2008-11-11 02:57:02,2008-11-11 02:57:02
675a4a1067123fe87512dff4c458e4a08eb7c86d...1142dd430fd3786904d1a1e9a761d873e4765f08,5,24,6,30,6,2008-11-11 17:21:43,2008-11-11 17:21:43
1142dd430fd3786904d1a1e9a761d873e4765f08...cb6a5886f6ccc0272288dba0f8b4c15a81100bf3,2,16,2,18,3,2008-11-12 00:35:24,2008-11-12 00:35:24
cb6a5886f6ccc0272288dba0f8b4c15a81100bf3...ecc1ed4ce1faa0b052ddd31487d24a4f9f9ea37a,1,12,7,19,10,2008-11-12 11:19:37,2008-11-12 11:19:37
ecc1ed4ce1faa0b052ddd31487d24a4f9f9ea37a...a53ccc82978362aab07e4ccafb63a15fd6070e60,1,2,0,2,2,2008-11-12 11:20:32,2008-11-12 11:20:32
a53ccc82978362aab07e4ccafb63a15fd6070e60...95d8c0619a961ebf55208bebe5cc686b8247655f,5,113,16,129,24,2008-11-12 11:22:05,2008-11-12 11:22:05
95d8c0619a961ebf55208bebe5cc686b8247655f...e32299e0bc709ffa1bacdc7ffdfaeb101df671d2,1,1,1,2,1,2008-11-12 11:48:57,2008-11-12 11:48:57
e32299e0bc709ffa1bacdc7ffdfaeb101df671d2...c7078ff0a272ab81412b08561ae49fae27f20d3e,1,20,5,25,5,2008-11-12 16:23:04,2008-11-12 16:23:04
c7078ff0a272ab81412b08561ae49fae27f20d3e...6d6aa2e0814fbc1180bcd1332bb1d2a0a25f06a4,2,22,17,39,17,2008-11-12 23:28:33,2008-11-12 23:28:33
6d6aa2e0814fbc1180bcd1332bb1d2a0a25f06a4...0f973fcdf103fe8ba3c0bbe07436b503cae7dd9a,2,24,15,39,16,2008-11-13 18:12:29,2008-11-13 18:12:29
0f973fcdf103fe8ba3c0bbe07436b503cae7dd9a...5c4fcbb19b3254442b702ce1153b639a2338194b,2,24,15,39,16,2008-11-13 18:13:13,2008-11-13 18:13:13
5c4fcbb19b3254442b702ce1153b639a2338194b...dfa90aec1bed28f581b0f0471dc95860bb166cc9,2,26,4,30,6,2008-11-13 19:03:42,2008-11-13 19:03:42
dfa90aec1bed28f581b0f0471dc95860bb166cc9...f751d5b71348b4f86fcc81877d6b28d89ad03186,8,140,3,143,11,2008-11-13 19:03:44,2008-11-13 19:03:44
f751d5b71348b4f86fcc81877d6b28d89ad03186...72751c732fce75de945b57bae981306dfc878be1,2,212,74,286,74,2008-11-13 20:19:07,2008-11-13 20:19:07
72751c732fce75de945b57bae981306dfc878be1...8d28a4c853aa6b34123228967f258ebb424294f4,2,12,2,14,3,2008-11-13 23:43:25,2008-11-13 23:43:25
8d28a4c853aa6b34123228967f258ebb424294f4...43b03ba57d48f4fbaa682cda8b111da316dbefd3,1,7,24,31,3,2008-11-14 00:54:16,2008-11-14 00:54:16
43b03ba57d48f4fbaa682cda8b111da316dbefd3...577f09f9f4dc1662a9a0e3273054c98b1a4c9f13,2,29,20,49,21,2008-11-14 02:33:01,2008-11-14 02:33:01
577f09f9f4dc1662a9a0e3273054c98b1a4c9f13...e31ed8f2b1871ec58a814e12bb1f87402fd147ac,5,4239,1,4240,4,2008-11-14 07:11:34,2008-11-14 07:11:34
e31ed8f2b1871ec58a814e12bb1f87402fd147ac...85ef4eb578f063746dcc100253cca042a763e155,2,231,86,317,87,2008-11-14 07:12:28,2008-11-14 07:12:28
85ef4eb578f063746dcc100253cca042a763e155...23657aaf16d38d98b1f5ba8b99762f16c49e113d,2,42,27,69,27,2008-11-14 07:15:15,2008-11-14 07:15:15
23657aaf16d38d98b1f5ba8b99762f16c49e113d...a0d4749920fa87182dcf70ae979367295546f731,1,1,1,2,1,2008-11-14 07:38:27,2008-11-14 07:38:27
a0d4749920fa87182dcf70ae979367295546f731...40976e08623aa362a783c142426a2103eb731e3f,1,2,2,4,2,2008-11-14 07:38:55,2008-11-14 07:38:55
40976e08623aa362a783c142426a2103eb731e3f...599852d04db750c62f9b8e5370e35ef71acfd5b6,1,2,2,4,2,2008-11-14 07:49:51,2008-11-14 07:49:51
599852d04db750c62f9b8e5370e35ef71acfd5b6...26fabdb218c464286ff14ca2dda70e62a1b0a654,1,2,2,4,1,2008-11-14 08:01:01,2008-11-14 08:01:01
26fabdb218c464286ff14ca2dda70e62a1b0a654...64b56447f36dc45ceb56ba7af84259f7004ae4bc,1,5,3,8,2,2008-11-14 08:02:46,2008-11-14 08:02:46
64b56447f36dc45ceb56ba7af84259f7004ae4bc...02e67bba4742e5024c843cb96da618b8e5fdf5da,2,8,12,20,3,2008-11-14 14:47:46,2008-11-14 14:47:46
02e67bba4742e5024c843cb96da618b8e5fdf5da...bca14cd3c8685f0c8d6a24583e3de33f94f8910b,1,3,9,12,2,2008-11-14 15:37:59,2008-11-14 15:37:59
bca14cd3c8685f0c8d6a24583e3de33f94f8910b...0349d83289f0d88069eccfead78b71da8e158d41,2,24,18,42,13,2008-11-15 01:16:20,2008-11-15 01:16:20
0349d83289f0d88069eccfead78b71da8e158d41...f63929dbe2f27733806d7f69d223682c4a72b450,2,16,1,17,4,2008-11-15 02:20:00,2008-11-15 02:20:00
f63929dbe2f27733806d7f69d223682c4a72b450...ec8150e78a71c49c8e69ee29cd72879c3a1daa49,1,1,0,1,1,2008-11-15 02:49:15,2008-11-15 02:49:15
ec8150e78a71c49c8e69ee29cd72879c3a1daa49...f5532f711986721eec9bf8238b9c7d57c95bf0cd,2,73,0,73,2,2008-11-15 05:21:37,2008-11-15 05:21:37
f5532f711986721eec9bf8238b9c7d57c95bf0cd...1d375e14723dc1f33e4d057ab812b03f2bd9bf02,1,0,4,4,1,2008-11-15 05:36:30,2008-11-15 05:36:30
1d375e14723dc1f33e4d057ab812b03f2bd9bf02...06f89325e152f1d7084f6d200d6879ffa940fd44,1,1,1,2,1,2008-11-15 05:39:06,2008-11-15 05:39:06
06f89325e152f1d7084f6d200d6879ffa940fd44...644ad9073f1e488fa0cc8dd9fa6d59c6bd504da9,11,30,61,91,18,2008-11-15 05:51:25,2008-11-15 05:51:25
644ad9073f1e488fa0cc8dd9fa6d59c6bd504da9...2246d526b18acd2c4c22e9dea2ca338fb71233ed,1,2,3,5,1,2008-11-15 05:57:39,2008-11-15 05:57:39
2246d526b18acd2c4c22e9dea2ca338fb71233ed...902df97f369f86b670d2254c9a54d05fd400069a,9,8,13,21,10,2008-11-16 00:08:48,2008-11-16 00:08:48
902df97f369f86b670d2254c9a54d05fd400069a...21e86f2af2d3b609108e33b7a7e6d98d9ab97b3f,1,1,1,2,1,2008-11-16 00:09:39,2008-11-16 00:09:39
21e86f2af2d3b609108e33b7a7e6d98d9ab97b3f...98ec741a03221e2b2a4c465e04ddede0795185af,1,12,12,24,6,2008-11-16 08:20:25,2008-11-16 08:20:25
98ec741a03221e2b2a4c465e04ddede0795185af...9d0bacebd2d0fc2b3581dac9acdc631338387921,2,15,3,18,5,2008-11-16 08:48:24,2008-11-16 08:48:24
9d0bacebd2d0fc2b3581dac9acdc631338387921...1418da7ee417dfc85cb2ebd034b95d21fe2ea015,2,15,12,27,10,2008-11-16 08:50:06,2008-11-16 08:50:06
1418da7ee417dfc85cb2ebd034b95d21fe2ea015...3e267a695e75469cbc2b759a085cf1ccb1181325,1,1,1,2,1,2008-11-16 09:27:16,2008-11-16 09:27:16
3e267a695e75469cbc2b759a085cf1ccb1181325...a573f4c029227e5319e966278e5e3cffe76e1224,1,5,5,10,3,2008-11-16 09:35:30,2008-11-16 09:35:30
a573f4c029227e5319e966278e5e3cffe76e1224...bcb4693e1d53c7a216804072649dd801628e4fa8,1,6,0,6,1,2008-11-16 16:27:36,2008-11-16 16:27:36
bcb4693e1d53c7a216804072649dd801628e4fa8...8e350d036ce6e12b2c2e9229c6b00d4da7823ffb,2,17,1,18,3,2008-11-16 18:58:43,2008-11-16 18:58:43
8e350d036ce6e12b2c2e9229c6b00d4da7823ffb...a70f15b8f19155101bf4769fe88b5d815e7d9249,1,4,0,4,3,2008-11-17 02:58:30,2008-11-17 02:58:30
a70f15b8f19155101bf4769fe88b5d815e7d9249...eb90cdf849c51e5153ad88e5820b4f29cb559d5c,1,2,0,2,1,2008-11-17 18:08:42,2008-11-17 18:08:42
eb90cdf849c51e5153ad88e5820b4f29cb559d5c...3dbe65e162bc5c71199b7828841593914a3c1575,2,4,0,4,4,2008-11-17 18:18:54,2008-11-17 18:18:54
3dbe65e162bc5c71199b7828841593914a3c1575...708df97f204961663277cfca8df476ec8972f68f,2,0,4,4,4,2008-11-17 18:42:48,2008-11-17 18:42:48
708df97f204961663277cfca8df476ec8972f68f...e37e57f44a3c933946a6488e03713569ffccc753,1,5,5,10,1,2008-11-18 06:35:05,2008-11-18 06:35:05
e37e57f44a3c933946a6488e03713569ffccc753...0cfcc72f88ab5425b9e58d13f6f8bfd4e0d93c4f,2,2,2,4,2,2008-11-18 07:32:38,2008-11-18 07:32:38
0cfcc72f88ab5425b9e58d13f6f8bfd4e0d93c4f...56c06c835c8bfa6400f102861bb93d71566cd3f6,1,53,122,175,22,2008-11-18 07:33:35,2008-11-18 07:33:35
56c06c835c8bfa6400f102861bb93d71566cd3f6...08c57a583655c821e424fc6ab5fb5fbbf2525e91,2,96,82,178,79,2008-11-18 22:50:34,2008-11-18 22:50:34
08c57a583655c821e424fc6ab5fb5fbbf2525e91...5759f28947e5a840a6a38ece295b611af51824a8,2,54,0,54,2,2008-11-19 05:21:58,2008-11-19 05:21:58
5759f28947e5a840a6a38ece295b611af51824a8...e5437af89ab725468eacfb0425dff8f981016ec9,1,2,2,4,1,2008-11-19 05:26:31,2008-11-19 05:26:31
e5437af89ab725468eacfb0425dff8f981016ec9...3ba235a348dd00f10cdc85652fb841bc15caca35,1,1,1,2,1,2008-11-20 19:01:40,2008-11-20 19:01:40
3ba235a348dd00f10cdc85652fb841bc15caca35...e7430816bc77da8e10d6aee689acece46080e8eb,2,79,65,144,67,2008-11-20 23:07:50,2008-11-20 23:07:50
e7430816bc77da8e10d6aee689acece46080e8eb...150a598d0cdeb1c2f2b82ade18dfc415c6cc9b36,2,1,1,2,1,2008-11-21 11:47:30,2008-11-21 11:47:30
150a598d0cdeb1c2f2b82ade18dfc415c6cc9b36...2967106274622123f92b9b1a99212871d111c0a0,1,1,1,2,1,2008-11-21 12:00:51,2008-11-21 12:00:51
2967106274622123f92b9b1a99212871d111c0a0...380e31ddb7cbc56d738dd78f176d03e1c94c27a5,1,4,3,7,4,2008-11-21 14:52:58,2008-11-21 14:52:58
380e31ddb7cbc56d738dd78f176d03e1c94c27a5...a5172c3e1f03e4c7f3d52d654381342a6995dfbc,1,1,1,2,1,2008-11-21 16:25:05,2008-11-21 16:25:05
a5172c3e1f03e4c7f3d52d654381342a6995dfbc...966f652464d30b31b84d031fe7971e19362638ab,1,1,1,2,1,2008-11-21 16:54:10,2008-11-21 16:54:10
966f652464d30b31b84d031fe7971e19362638ab...5372508fdf4a853adbe54623bf85b440a552f1e8,1,4,2,6,1,2008-11-21 17:41:08,2008-11-21 17:41:08
5372508fdf4a853adbe54623bf85b440a552f1e8...3ac16c0fdd3e5996694f5aa192fdc0bce4204b83,1,0,5,5,1,2008-11-21 17:47:47,2008-11-21 17:47:47
3ac16c0fdd3e5996694f5aa192fdc0bce4204b83...436a808ce2df380fc9d4e2b5e601ac8ac2f61320,2,54,46,100,47,2008-11-23 20:10:30,2008-11-23 20:10:30
436a808ce2df380fc9d4e2b5e601ac8ac2f61320...089ab18c025917f38a2e3731ae4024d4810df1ec,7,133,60,193,17,2008-11-24 20:42:09,2008-11-24 20:42:09
089ab18c025917f38a2e3731ae4024d4810df1ec...f4879af2df1ecc92e924a3ff15b84e3cd448dbbf,1,14,1,15,4,2008-11-24 21:13:33,2008-11-24 21:13:33
f4879af2df1ecc92e924a3ff15b84e3cd448dbbf...136c4f85490e058e9072206252807c831965a867,1,4,4,8,4,2008-11-24 22:01:24,2008-11-24 22:01:24
136c4f85490e058e9072206252807c831965a867...4aa97f5c18f1242d4ef33931cf7567f997f24a6f,3,75,5,80,10,2008-11-24 22:01:48,2008-11-24 22:01:48
4aa97f5c18f1242d4ef33931cf7567f997f24a6f...714490ba5170a9181210a8bfce45147fb936d6c1,1,2,2,4,2,2008-11-24 22:33:18,2008-11-24 22:33:18
714490ba5170a9181210a8bfce45147fb936d6c1...bd2b0059beeaf3cf4eddac38364e039bc91410fe,2,8,8,16,4,2008-11-24 22:33:32,2008-11-24 22:33:32
bd2b0059beeaf3cf4eddac38364e039bc91410fe...8559fc6b35a5e7ffe3f52fe5ca19590a56ac18ab,1,2,2,4,2,2008-11-26 21:21:43,2008-11-26 21:21:43
8559fc6b35a5e7ffe3f52fe5ca19590a56ac18ab...8e68fc6cd1e2d9620f267c1dd6d9c73650c14b5e,1,2,2,4,2,2008-11-29 11:51:41,2008-11-29 11:51:41
8e68fc6cd1e2d9620f267c1dd6d9c73650c14b5e...153b5a4a3aee057445b255ea387cd93dac2e5786,1,8,1,9,3,2008-12-01 02:20:59,2008-12-01 02:20:59
153b5a4a3aee057445b255ea387cd93dac2e5786...81c8b3c69668ca17d36a7d4e737572b4f9aadfd9,1,6,4,10,2,2008-12-01 02:21:33,2008-12-01 02:21:33
81c8b3c69668ca17d36a7d4e737572b4f9aadfd9...f7a64b341acb1a77e53a91b5298a3117abbfd1ea,1,2,1,3,1,2008-12-02 04:07:43,2008-12-02 04:07:43
f7a64b341acb1a77e53a91b5298a3117abbfd1ea...87fc7efda5c0aaacca5a5f1a2e7e46e2b5489029,1,14,0,14,2,2008-12-02 05:58:15,2008-12-02 05:58:15
87fc7efda5c0aaacca5a5f1a2e7e46e2b5489029...5834b1837faf6d1711f40d948c0ca81a1d4899c7,3,102,2,104,3,2008-12-02 13:23:29,2008-12-02 13:23:29
5834b1837faf6d1711f40d948c0ca81a1d4899c7...9a4f1760fdf9d131e3fc0cca2935b7a57ba30f88,0,0,0,0,0,2008-12-02 13:27:30,2008-12-02 13:27:30
9a4f1760fdf9d131e3fc0cca2935b7a57ba30f88...485316017a34623bb883f57bc72417e84722912b,2,4,2,6,3,2008-12-02 16:58:06,2008-12-02 16:58:06
485316017a34623bb883f57bc72417e84722912b...4637a77ff8fedd67b3aaa98042d89e03465a82d6,2,10,1,11,3,2008-12-02 18:40:40,2008-12-02 18:40:40
4637a77ff8fedd67b3aaa98042d89e03465a82d6...5ef0c03ae9aca99289737ba6d88a371ad95cf432,1,5,5,10,5,2008-12-02 22:09:51,2008-12-02 22:09:51
5ef0c03ae9aca99289737ba6d88a371ad95cf432...f7242bb778d63e09aebaf5318244a886f123a1e0,2,65,0,65,2,2008-12-02 22:40:00,2008-12-02 22:40:00
f7242bb778d63e09aebaf5318244a886f123a1e0...01ec6d00853481deeb712a4b0819e1a2c2ed985f,1,49,7,56,9,2008-12-02 23:00:06,2008-12-02 23:00:06
01ec6d00853481deeb712a4b0819e1a2c2ed985f...c0f9e85fbe616a38255cd568fc5f2f0a870586ea,2,41,21,62,9,2008-12-03 00:31:31,2008-12-03 00:31:31
c0f9e85fbe616a38255cd568fc5f2f0a870586ea...9eedc7bd0b21c936a30f000ba876dbcf5c0bed50,3,76,9,85,11,2008-12-03 00:34:18,2008-12-03 00:34:18
9eedc7bd0b21c936a30f000ba876dbcf5c0bed50...9ec9936413a906e71ce79d1ce7d26df865891a95,1,6,0,6,2,2008-12-03 00:44:12,2008-12-03 00:44:12
9ec9936413a906e71ce79d1ce7d26df865891a95...1302fe9a35f94b37a39c2fd4c09c45f942f94de8,1,4,3,7,2,2008-12-03 05:49:37,2008-12-03 05:49:37
1302fe9a35f94b37a39c2fd4c09c45f942f94de8...94f4348728c03ca0e1aca0da619020c313985821,1,6,6,12,1,2008-12-03 05:50:11,2008-12-03 05:50:11
94f4348728c03ca0e1aca0da619020c313985821...4bdbd1401d4001fef2f6a4ba960da24700e19157,1,1,1,2,1,2008-12-03 05:50:46,2008-12-03 05:50:46
4bdbd1401d4001fef2f6a4ba960da24700e19157...9c33d74f1dbc71dc295f11c1be2f1146a487e611,1,7,2,9,2,2008-12-03 13:23:23,2008-12-03 13:23:23
9c33d74f1dbc71dc295f11c1be2f1146a487e611...a44d0aace33f08f3fb0a0eb7bd45a32d8366940e,1,2,2,4,2,2008-12-03 15:45:19,2008-12-03 15:45:19
a44d0aace33f08f3fb0a0eb7bd45a32d8366940e...d192236a3dcb5ed953db19cf37604e3054a2dc0f,1,2,0,2,1,2008-12-03 15:47:19,2008-12-03 15:47:19
d192236a3dcb5ed953db19cf37604e3054a2dc0f...5d7c57f681fdfab0d4884f3c908a97a2dbf08326,1,5,5,10,5,2008-12-04 05:37:37,2008-12-04 05:37:37
5d7c57f681fdfab0d4884f3c908a97a2dbf08326...dfef20a7806073dab547eeb1c5e700c4bd0e1634,1,2,2,4,2,2008-12-04 19:33:28,2008-12-04 19:33:28
dfef20a7806073dab547eeb1c5e700c4bd0e1634...bfab9d62ee815baac34b1872676ad26af91c7d94,3,77,1,78,4,2008-12-05 04:22:00,2008-12-05 04:22:00
bfab9d62ee815baac34b1872676ad26af91c7d94...8370e7ca876f305c88863aa84f624b01d6add04e,1,1,1,2,1,2008-12-06 00:38:48,2008-12-06 00:38:48
8370e7ca876f305c88863aa84f624b01d6add04e...4058429708da7380385a28959ba10a51cda7f05a,3,16,2,18,4,2008-12-06 01:52:14,2008-12-06 01:52:14
4058429708da7380385a28959ba10a51cda7f05a...a552bd2da7e68da80892745297356ccf851bf105,5,4304,1498,5802,466,2008-12-07 03:11:34,2008-12-07 03:11:34
a552bd2da7e68da80892745297356ccf851bf105...8a03a2e834b75c28d51db3913d0ff3cbadd3a953,3,312,139,451,135,2008-12-07 03:12:23,2008-12-07 03:12:23
8a03a2e834b75c28d51db3913d0ff3cbadd3a953...84cc0084733b08e5df0b65069c3fc07184c5f7e9,1,1,1,2,1,2008-12-07 03:41:23,2008-12-07 03:41:23
84cc0084733b08e5df0b65069c3fc07184c5f7e9...04ff1aff12b2603c055d50daa4649754eb995e0a,1,7,0,7,1,2008-12-07 03:41:54,2008-12-07 03:41:54
04ff1aff12b2603c055d50daa4649754eb995e0a...89ada943ee727df7c97302ae2167364391f3e96f,1,4,4,8,4,2008-12-07 03:42:25,2008-12-07 03:42:25
89ada943ee727df7c97302ae2167364391f3e96f...d1102d63e67ba62577f1ddf6fd65ac5f927872e6,1,1,1,2,1,2008-12-07 03:54:45,2008-12-07 03:54:45
d1102d63e67ba62577f1ddf6fd65ac5f927872e6...e8707e068d5e4374204b813ca26bd4150eef7023,1,6,6,12,3,2008-12-07 04:00:08,2008-12-07 04:00:08
e8707e068d5e4374204b813ca26bd4150eef7023...d4f0ae42a2ed4894b3eccb613df0d75e582330a6,2,19,1,20,3,2008-12-07 05:48:01,2008-12-07 05:48:01
d4f0ae42a2ed4894b3eccb613df0d75e582330a6...33c0f0de676ae8fd2c406beebb2f113aeb95fee7,2,54,21,75,14,2008-12-08 02:39:51,2008-12-08 02:39:51
33c0f0de676ae8fd2c406beebb2f113aeb95fee7...352efd189328cca8ff5ab2af2b65522ec44fa889,2,13,12,25,5,2008-12-08 04:07:42,2008-12-08 04:07:42
352efd189328cca8ff5ab2af2b65522ec44fa889...e9b90d98998da48d4ac18aabe135fa4200547be5,1,18,10,28,3,2008-12-08 04:15:19,2008-12-08 04:15:19
e9b90d98998da48d4ac18aabe135fa4200547be5...b76d7c1decb04cdb7ec363cd589f273952ab789a,4,31,5,36,9,2008-12-08 04:53:34,2008-12-08 04:53:34
b76d7c1decb04cdb7ec363cd589f273952ab789a...ff3e1a7d40c783e9df3d38f327548d3ad2edcfab,1,14,14,28,11,2008-12-08 05:27:04,2008-12-08 05:27:04
ff3e1a7d40c783e9df3d38f327548d3ad2edcfab...235600c3c340990e8d6d1b1baee3b749b1e7291a,1,3,1,4,2,2008-12-08 05:35:20,2008-12-08 05:35:20
235600c3c340990e8d6d1b1baee3b749b1e7291a...fa7aa7255ca990b2f13e615f023a958e54cb17d0,1,1,1,2,1,2008-12-08 05:41:28,2008-12-08 05:41:28
fa7aa7255ca990b2f13e615f023a958e54cb17d0...d662ef554015a3508ff8100c73b370728156a02c,3,12,7,19,3,2008-12-08 08:15:37,2008-12-08 08:15:37
d662ef554015a3508ff8100c73b370728156a02c...662e12b45ce1cafa3806d8e8dd45638996e91bd7,1,2,1,3,1,2008-12-08 08:16:26,2008-12-08 08:16:26
662e12b45ce1cafa3806d8e8dd45638996e91bd7...6590c0bcf5cc85c551706586fc8cab88965a986a,1,16,1,17,4,2008-12-08 14:29:06,2008-12-08 14:29:06
6590c0bcf5cc85c551706586fc8cab88965a986a...bde736cc5acd1b55a0ec10f0955b03ee225b1f10,1,1,1,2,1,2008-12-08 14:50:06,2008-12-08 14:50:06
bde736cc5acd1b55a0ec10f0955b03ee225b1f10...453d452653bcfff8c29a112e0529d4a1c17c97e3,1,4,3,7,1,2008-12-08 17:15:56,2008-12-08 17:15:56
453d452653bcfff8c29a112e0529d4a1c17c97e3...15bd6499403132fad93963253f6c679b20e0e00f,1,9,9,18,6,2008-12-08 18:36:22,2008-12-08 18:36:22
15bd6499403132fad93963253f6c679b20e0e00f...6553ddc5b41e3225b61739dfd44bb63849d49ac3,1,111,8,119,6,2008-12-09 00:31:17,2008-12-09 00:31:17
6553ddc5b41e3225b61739dfd44bb63849d49ac3...c006ef574699160af67d6695b88406336ccb5d8b,1,73,77,150,40,2008-12-09 04:17:14,2008-12-09 04:17:14
c006ef574699160af67d6695b88406336ccb5d8b...5e9c5de78a8b0c0e1700f655febfd317f4ca33ee,1,12,5,17,4,2008-12-09 06:49:40,2008-12-09 06:49:40
5e9c5de78a8b0c0e1700f655febfd317f4ca33ee...5570b0766d6b20732a5fd6112246ed8b27fdfc8c,2,5,2,7,2,2008-12-09 07:03:52,2008-12-09 07:03:52
5570b0766d6b20732a5fd6112246ed8b27fdfc8c...d29b7a14c5e67b9f287f44e1e5a3a8164a09665f,1,2,2,4,2,2008-12-09 07:13:49,2008-12-09 07:13:49
d29b7a14c5e67b9f287f44e1e5a3a8164a09665f...731f6be26240fc7b2ecd8e2f60818070427f75fb,1,1,1,2,1,2008-12-09 07:15:35,2008-12-09 07:15:35
731f6be26240fc7b2ecd8e2f60818070427f75fb...80da07e4b93bfbaf4dbadfd72fb58aa233fa0096,1,3,0,3,1,2008-12-09 07:32:28,2008-12-09 07:32:28
80da07e4b93bfbaf4dbadfd72fb58aa233fa0096...b4364e099e7e61abeaf8efc09a1641fb37ea0d8f,1,12,1,13,2,2008-12-09 07:33:08,2008-12-09 07:33:08
b4364e099e7e61abeaf8efc09a1641fb37ea0d8f...adfad3c19340d1a97c0d8c16a563b81b3f87faca,2,37,11,48,2,2008-12-09 22:39:58,2008-12-09 22:39:58
adfad3c19340d1a97c0d8c16a563b81b3f87faca...626f72733dac8f144f59acdda43e220910c575fa,1,2,1,3,1,2008-12-09 22:48:23,2008-12-09 22:48:23
626f72733dac8f144f59acdda43e220910c575fa...280236eacd7a4bae1775d587581be418128f7a3f,1,4,1,5,1,2008-12-09 23:05:55,2008-12-09 23:05:55
280236eacd7a4bae1775d587581be418128f7a3f...7030ab9a72ea590b359c22644e45edaf05dd8b5c,1,3,2,5,1,2008-12-10 01:52:08,2008-12-10 01:52:08
7030ab9a72ea590b359c22644e45edaf05dd8b5c...a1cbeb9afbbf0f16e1ffa1891575fbc2c3edae74,4,36,0,36,5,2008-12-10 05:19:27,2008-12-10 05:19:27
a1cbeb9afbbf0f16e1ffa1891575fbc2c3edae74...bb6d5dc69b05884529cf166a62030230cae1607a,1,0,3,3,1,2008-12-11 07:06:25,2008-12-11 07:06:25
bb6d5dc69b05884529cf166a62030230cae1607a...f1f1d366c8378b5f919ee591e733dbcabea359ba,2,0,3,3,2,2008-12-11 07:31:41,2008-12-11 07:31:41
f1f1d366c8378b5f919ee591e733dbcabea359ba...5257fd222541cb8bd37a7c33d9fea0267374d387,1,78,57,135,23,2008-12-11 20:12:00,2008-12-11 20:12:00
5257fd222541cb8bd37a7c33d9fea0267374d387...4bede45816e577983b9df0d1ebce2c0a4c4283c7,1,0,4,4,1,2008-12-14 19:31:26,2008-12-14 19:31:26
4bede45816e577983b9df0d1ebce2c0a4c4283c7...b96b4509811d097a1217c065141f36be27f79823,3,19,4,23,5,2008-12-16 04:52:55,2008-12-16 04:52:55
b96b4509811d097a1217c065141f36be27f79823...fddc0c589e03c1e5eb581aaa947a39720163d7d5,1,7,2,9,6,2008-12-16 06:42:19,2008-12-16 06:42:19
fddc0c589e03c1e5eb581aaa947a39720163d7d5...b58a260c56c5d05d71ac1073bc05eda8eca0ea5f,3,52,12,64,7,2008-12-16 06:43:18,2008-12-16 06:43:18
b58a260c56c5d05d71ac1073bc05eda8eca0ea5f...5f78eff9095e5563fe287910e91ffd8267e03ef3,1,2,0,2,2,2008-12-16 14:28:22,2008-12-16 14:28:22
5f78eff9095e5563fe287910e91ffd8267e03ef3...10894da8a840a6d7d99add4bf372215b8a600f06,4,105,1,106,6,2008-12-16 15:04:47,2008-12-16 15:04:47
10894da8a840a6d7d99add4bf372215b8a600f06...986e162c5d0a0eb45e21bd3e3d6350a4c7d7af52,3,86,11,97,12,2008-12-16 17:42:18,2008-12-16 17:42:18
986e162c5d0a0eb45e21bd3e3d6350a4c7d7af52...dc4c95cdbf6b297ea214ea8583fd92caea05e3fb,1,1,1,2,1,2008-12-17 01:47:08,2008-12-17 01:47:08
dc4c95cdbf6b297ea214ea8583fd92caea05e3fb...04ed4234690c43f6cd294f1cfb8a978e13378903,1,1,1,2,1,2008-12-21 04:17:46,2008-12-21 04:17:46
04ed4234690c43f6cd294f1cfb8a978e13378903...ca33f07e2c555c16b60ae287ffa994c7a3d6c1c9,2,43,2,45,5,2008-12-21 04:56:32,2008-12-21 04:56:32
ca33f07e2c555c16b60ae287ffa994c7a3d6c1c9...9d13b6ec28dbe7f060f97436fb379935637ddc44,1,2,2,4,2,2008-12-22 04:18:00,2008-12-22 04:18:00
9d13b6ec28dbe7f060f97436fb379935637ddc44...d66e63f2dc2a5fab29c93e3ca2850a67e30e18f8,1,1,1,2,1,2008-12-22 23:21:32,2008-12-22 23:21:32
d66e63f2dc2a5fab29c93e3ca2850a67e30e18f8...c56535295466e201e330c5d36f04542636f0f6bb,2,9,5,14,6,2008-12-23 00:01:09,2008-12-23 00:01:09
c56535295466e201e330c5d36f04542636f0f6bb...bcae5fc1b38b2182df8e6390e195d8d497406f6b,1,2,2,4,2,2008-12-23 00:13:15,2008-12-23 00:13:15
bcae5fc1b38b2182df8e6390e195d8d497406f6b...05737128de79ec1935ba7df31f9c34258e869b3c,1,2,3,5,3,2008-12-23 04:13:14,2008-12-23 04:13:14
05737128de79ec1935ba7df31f9c34258e869b3c...7bf9626adb51563b1db3c1761b6a7a9da17b8bb5,1,2,2,4,1,2008-12-23 05:20:49,2008-12-23 05:20:49
7bf9626adb51563b1db3c1761b6a7a9da17b8bb5...f0d44e44bd4161d279ea9b6a9c99af79cf17b913,1,11,9,20,8,2008-12-23 05:50:51,2008-12-23 05:50:51
f0d44e44bd4161d279ea9b6a9c99af79cf17b913...9af56803f53a4e41bb826d4e293ef8650ad9f13a,5,51,1,52,7,2008-12-23 18:25:24,2008-12-23 18:25:24
9af56803f53a4e41bb826d4e293ef8650ad9f13a...62362c61757acfd68201ad737db98108a0146151,1,6,0,6,1,2008-12-25 06:04:11,2008-12-25 06:04:11
62362c61757acfd68201ad737db98108a0146151...be2697209bdffa8807140a01f43bee024c5a2bfd,1,9,5,14,5,2008-12-25 06:17:42,2008-12-25 06:17:42
be2697209bdffa8807140a01f43bee024c5a2bfd...89dc5b894a7c7ac1633f0c270ac249f302bccd1d,1,15,0,15,1,2008-12-25 06:19:14,2008-12-25 06:19:14
89dc5b894a7c7ac1633f0c270ac249f302bccd1d...d39540af92b124992e495bd3cbc1449b2a027173,2,2,2,4,2,2008-12-26 16:02:45,2008-12-26 16:02:45
d39540af92b124992e495bd3cbc1449b2a027173...50cd258a24275f2de2b45fb702d8e217a6d0a843,4,18,9,27,13,2008-12-26 20:04:11,2008-12-26 20:04:11
50cd258a24275f2de2b45fb702d8e217a6d0a843...a754165a919ad12cc62723d81f4df6e046ad18cb,5,5,5,10,5,2008-12-27 00:01:11,2008-12-27 00:01:11
a754165a919ad12cc62723d81f4df6e046ad18cb...3cd1e80ae4c4ed1fdd6728bd4fb501ba6219fafa,1,2,2,4,2,2009-01-03 01:37:51,2009-01-03 01:37:51
3cd1e80ae4c4ed1fdd6728bd4fb501ba6219fafa...096a9ecc5cc1e94f3a36c6f3fae967d6d5f1c749,5,19,4,23,9,2009-01-03 04:43:58,2009-01-03 04:43:58
096a9ecc5cc1e94f3a36c6f3fae967d6d5f1c749...1fc26b8d4e7e498f69c1585e3b067c599b74e316,1,1,1,2,1,2009-01-03 04:52:07,2009-01-03 04:52:07
1fc26b8d4e7e498f69c1585e3b067c599b74e316...ff4b844cb44c01f80c00df1d5e33754c9c829719,1,29,27,56,27,2009-01-03 05:04:12,2009-01-03 05:04:12
ff4b844cb44c01f80c00df1d5e33754c9c829719...062a94ef45e71f525de1c9095aeb3f376feb8232,4,101,77,178,25,2009-01-05 11:47:14,2009-01-05 11:47:14
062a94ef45e71f525de1c9095aeb3f376feb8232...f747b61c20cb2ab9bcbca2b272f3fba80cf39ac6,4,59,7,66,7,2009-01-05 11:47:48,2009-01-05 11:47:48
f747b61c20cb2ab9bcbca2b272f3fba80cf39ac6...391736e73749dc71a37fda94409ac8fa26738097,1,8,6,14,4,2009-01-05 22:16:12,2009-01-05 22:16:12
391736e73749dc71a37fda94409ac8fa26738097...0c08368116112e43334a05c7e33738d7e75e7bc0,1,3,3,6,2,2009-01-06 01:56:13,2009-01-06 01:56:13
0c08368116112e43334a05c7e33738d7e75e7bc0...3b489b77429aacd05a66c2158edc4f21209aecb9,2,47,2,49,5,2009-01-06 03:34:47,2009-01-06 03:34:47
3b489b77429aacd05a66c2158edc4f21209aecb9...a9c2f033cdbef3e53f6d48bb5aadb89ed761e579,6,710,700,1410,137,2009-01-06 05:13:02,2009-01-06 05:13:02
a9c2f033cdbef3e53f6d48bb5aadb89ed761e579...e77c4cca26050ee599dfdd78c600b10b0d0b74ec,1,23,0,23,1,2009-01-06 05:27:39,2009-01-06 05:27:39
e77c4cca26050ee599dfdd78c600b10b0d0b74ec...bde7e79fb3a98c6ec0f86e1d4bb088e390c00355,2,5,4,9,2,2009-01-06 18:22:07,2009-01-06 18:22:07
bde7e79fb3a98c6ec0f86e1d4bb088e390c00355...300752bd6c0bfdf3bdf85e61fed318f4e587b16a,1,6,6,12,9,2009-01-07 20:21:19,2009-01-07 20:21:19
300752bd6c0bfdf3bdf85e61fed318f4e587b16a...c20019a91d7d553606f45d21c513f277fb98deb4,2,17,20,37,3,2009-01-08 05:12:14,2009-01-08 05:12:14
c20019a91d7d553606f45d21c513f277fb98deb4...d00c013cc8477de9a75e4b4f5806034549e5a5e1,1,3,1,4,2,2009-01-08 05:15:41,2009-01-08 05:15:41
d00c013cc8477de9a75e4b4f5806034549e5a5e1...d068ad0c01be9bb085c86a4e0c4dd047a85ce18d,3,17,0,17,4,2009-01-08 05:16:21,2009-01-08 05:16:21
d068ad0c01be9bb085c86a4e0c4dd047a85ce18d...c5bdfab9ae17953645812dc1ffc7f0b50354b7c5,3,20,1,21,4,2009-01-08 05:49:03,2009-01-08 05:49:03
c5bdfab9ae17953645812dc1ffc7f0b50354b7c5...67c1c516abef2f27b241c5dcd121df58ffaa6e6f,4,261,113,374,113,2009-01-08 10:12:48,2009-01-08 10:12:48
67c1c516abef2f27b241c5dcd121df58ffaa6e6f...95b0c2569d22ce440399559afc1e65ca221e824f,2,545,354,899,251,2009-01-08 10:32:55,2009-01-08 10:32:55
95b0c2569d22ce440399559afc1e65ca221e824f...73e5823f61a62c74f78bc16e37d05b674fcdc99f,2,1,1,2,1,2009-01-08 10:33:36,2009-01-08 10:33:36
73e5823f61a62c74f78bc16e37d05b674fcdc99f...0e59fbbd8591c12c7f156a8bea2905c4e44202c5,2,23,19,42,19,2009-01-09 09:57:53,2009-01-09 09:57:53
0e59fbbd8591c12c7f156a8bea2905c4e44202c5...d32c2908464465d6eda5e69da95a1c6269031def,2,11,2,13,3,2009-01-09 12:41:07,2009-01-09 12:41:07
d32c2908464465d6eda5e69da95a1c6269031def...299e1e814fa7c5f8033872213b8876fc12fcd7be,4,109,17,126,6,2009-01-10 22:18:14,2009-01-10 22:18:14
299e1e814fa7c5f8033872213b8876fc12fcd7be...c01098e9cbd572eb2af97b938a7149e187561009,3,21,4,25,8,2009-01-10 22:54:20,2009-01-10 22:54:20
c01098e9cbd572eb2af97b938a7149e187561009...11d382c6c449a86be794546a27afef63027d1a90,1,9,9,18,5,2009-01-11 05:47:06,2009-01-11 05:47:06
11d382c6c449a86be794546a27afef63027d1a90...4035ea3538cbcada11cb73680189c11e789064a9,9,4,10,14,10,2009-01-12 17:27:41,2009-01-12 17:27:41
4035ea3538cbcada11cb73680189c11e789064a9...3990d00f20a8557d6b7f5ee2a2146e7f1de9b55c,1,1,1,2,1,2009-01-12 17:29:01,2009-01-12 17:29:01
3990d00f20a8557d6b7f5ee2a2146e7f1de9b55c...ffeb1d0465acea0f4c5f3702f2cebd5cfdde796d,1,1,1,2,1,2009-01-12 17:31:40,2009-01-12 17:31:40
ffeb1d0465acea0f4c5f3702f2cebd5cfdde796d...6c4e5f0f0e9469d7e56d824d2b153cd25fb443ee,3,20,12,32,11,2009-01-13 02:08:26,2009-01-13 02:08:26
6c4e5f0f0e9469d7e56d824d2b153cd25fb443ee...1f84630c87f8032b0167e6db41acaf50ab710879,10,484,257,741,147,2009-01-14 20:22:25,2009-01-14 20:22:25
1f84630c87f8032b0167e6db41acaf50ab710879...50a293a0c31e7325ebd520338f9c8881f951d8a7,1,1,1,2,1,2009-01-15 06:37:01,2009-01-15 06:37:01
50a293a0c31e7325ebd520338f9c8881f951d8a7...cc4e4d9aee0b3ebfb45bee01aec79edc9e144c78,30,2361,329,2690,169,2009-01-15 11:06:34,2009-01-15 11:06:34
cc4e4d9aee0b3ebfb45bee01aec79edc9e144c78...1a87e01f211618e42ee5e0bb30c0fa3dedb3fdda,1,5,3,8,3,2009-01-15 12:13:17,2009-01-15 12:13:17
1a87e01f211618e42ee5e0bb30c0fa3dedb3fdda...79fa78cc803e53c65df7a595e96abdab2338150f,1,1,1,2,1,2009-01-15 12:35:41,2009-01-15 12:35:41
79fa78cc803e53c65df7a595e96abdab2338150f...3937de4e242527896faa10651abaedc29c829e68,1,0,1,1,1,2009-01-15 12:44:45,2009-01-15 12:44:45
3937de4e242527896faa10651abaedc29c829e68...14d15093bcf2b37b76d9dda7edc680ba3dc4d49e,1,1,1,2,1,2009-01-15 14:07:53,2009-01-15 14:07:53
14d15093bcf2b37b76d9dda7edc680ba3dc4d49e...91e25f9ef8a00dcc4af83329ac2f07a08be9a2b6,1,3,1,4,1,2009-01-15 15:11:28,2009-01-15 15:11:28
91e25f9ef8a00dcc4af83329ac2f07a08be9a2b6...f671a5c961d5a129e3c26857d6ca4895acf70b71,7,115,51,166,26,2009-01-15 19:35:04,2009-01-15 19:35:04
f671a5c961d5a129e3c26857d6ca4895acf70b71...f60d0f597a05f92cd20d0cd2bd79a582143696c8,1,1,0,1,1,2009-01-15 19:50:29,2009-01-15 19:50:29
f60d0f597a05f92cd20d0cd2bd79a582143696c8...acfe5cc880fe6d11f1c7e0b259be9a885d5d8e66,2,46,3,49,7,2009-01-15 20:39:09,2009-01-15 20:39:09
acfe5cc880fe6d11f1c7e0b259be9a885d5d8e66...d55b361ac4dc0fb291855ada46054565ab33636e,1,1,1,2,1,2009-01-15 22:26:00,2009-01-15 22:26:00
d55b361ac4dc0fb291855ada46054565ab33636e...bf710bd005688e0d6615ec758124b0f914741b51,1,3,3,6,3,2009-01-15 22:33:55,2009-01-15 22:33:55
bf710bd005688e0d6615ec758124b0f914741b51...b3dd0b5dccc7f9c230fd0b78cbf60483b010bc3e,1,2,2,4,2,2009-01-15 23:15:32,2009-01-15 23:15:32
b3dd0b5dccc7f9c230fd0b78cbf60483b010bc3e...f9f9d703cfef64766ab5a3d7cb5d79298367f621,1,1,1,2,1,2009-01-16 00:02:35,2009-01-16 00:02:35
f9f9d703cfef64766ab5a3d7cb5d79298367f621...344f16e2205a4959ba65d975716a38db77d2061e,11,251,51,302,50,2009-01-16 02:30:22,2009-01-16 02:30:22
344f16e2205a4959ba65d975716a38db77d2061e...14b3f03015081a679a6b5efaf5ea925344ce14c0,1,3,2,5,2,2009-01-16 08:59:02,2009-01-16 08:59:02
14b3f03015081a679a6b5efaf5ea925344ce14c0...d579e716fef9f06f04861815cf949630d8633271,3,46,0,46,4,2009-01-16 10:59:43,2009-01-16 10:59:43
d579e716fef9f06f04861815cf949630d8633271...f212b24b6469b66424354bf970f3051df180b88d,8,369,83,452,23,2009-01-16 15:32:31,2009-01-16 15:32:31
f212b24b6469b66424354bf970f3051df180b88d...1c1425130d04d0045b299beffce3363b819cf393,1,4,1,5,1,2009-01-16 16:51:01,2009-01-16 16:51:01
1c1425130d04d0045b299beffce3363b819cf393...547649f9627c9414aeda29600348ba3430644075,1,1,0,1,1,2009-01-16 20:05:39,2009-01-16 20:05:39
547649f9627c9414aeda29600348ba3430644075...b120c74032c1131e46e4073db1298cf92c4e34c3,2,32,32,64,31,2009-01-16 21:18:21,2009-01-16 21:18:21
b120c74032c1131e46e4073db1298cf92c4e34c3...79138a61065bf0c789d9f3f34c55de2e26fda422,1,6,1,7,3,2009-01-16 21:31:58,2009-01-16 21:31:58
79138a61065bf0c789d9f3f34c55de2e26fda422...6332ad4804a040ec6a4869e69d484c7336a5cad1,3,46,7,53,12,2009-01-16 21:48:37,2009-01-16 21:48:37
6332ad4804a040ec6a4869e69d484c7336a5cad1...b41a45f8e5fa87673d984663d39531292fd8a100,2,49,12,61,11,2009-01-16 22:23:58,2009-01-16 22:23:58
b41a45f8e5fa87673d984663d39531292fd8a100...3c87c22b3c227ab9e4b98f19cd8d08174128f793,1,8,0,8,1,2009-01-17 22:04:40,2009-01-17 22:04:40
3c87c22b3c227ab9e4b98f19cd8d08174128f793...81dfd1f5f037019a227a767877b2124311cff738,1,2,2,4,2,2009-01-17 22:15:07,2009-01-17 22:15:07
81dfd1f5f037019a227a767877b2124311cff738...dd2e1356f014a9869ea3baef1f7efb9f94bf696c,1,8,2,10,4,2009-01-18 20:54:42,2009-01-18 20:54:42
dd2e1356f014a9869ea3baef1f7efb9f94bf696c...9c6efb2eeaca11c7e65ce3b63a09f2d1e0b247c3,2,8,0,8,3,2009-01-19 12:46:54,2009-01-19 12:46:54
9c6efb2eeaca11c7e65ce3b63a09f2d1e0b247c3...795c229ae940b9bc543aacdf6dd0a30ffcc62b3c,2,18,1,19,3,2009-01-19 19:37:31,2009-01-19 19:37:31
795c229ae940b9bc543aacdf6dd0a30ffcc62b3c...728108883a64db4f045827640adc62c09f5b6a8c,1,1,1,2,1,2009-01-19 20:49:12,2009-01-19 20:49:12
728108883a64db4f045827640adc62c09f5b6a8c...39516803f1e504db5d8a731e8fd3367bb9c016cc,2,6,2,8,3,2009-01-20 12:23:48,2009-01-20 12:23:48
39516803f1e504db5d8a731e8fd3367bb9c016cc...ef22bb7b3397932758bad0dc706723693ce85cb3,1,2,2,4,1,2009-01-23 04:53:18,2009-01-23 04:53:18
ef22bb7b3397932758bad0dc706723693ce85cb3...ed3d2735a2eb5d279e2098e14437eb9e445498c6,2,18,1,19,2,2009-01-23 07:07:51,2009-01-23 07:07:51
ed3d2735a2eb5d279e2098e14437eb9e445498c6...0e15932be392ab56fa0087f9c13b234af7749e2e,5,35,3,38,8,2009-01-23 11:03:48,2009-01-23 11:03:48
0e15932be392ab56fa0087f9c13b234af7749e2e...f5ed27cf1f26a678869d91cbbfca24dc53e603e5,1,1,0,1,1,2009-01-23 11:12:06,2009-01-23 11:12:06
f5ed27cf1f26a678869d91cbbfca24dc53e603e5...15b1675af988d2918b142e8a0c2ab6fcf50e4649,2,24,5,29,11,2009-01-24 06:53:54,2009-01-24 06:53:54
15b1675af988d2918b142e8a0c2ab6fcf50e4649...ff78aef93b3b741e79176bbf96bf0918b44e3338,1,78,4,82,1,2009-01-24 12:07:26,2009-01-24 12:07:26
ff78aef93b3b741e79176bbf96bf0918b44e3338...08dd4176edc1019d9168608b55fe777512c641cb,2,4,3,7,2,2009-01-24 14:16:25,2009-01-24 14:16:25
08dd4176edc1019d9168608b55fe777512c641cb...cf37e4624a967f936ecbb5a4eefc9d38ed9d7892,16,586,48,634,49,2009-01-29 10:46:36,2009-01-29 10:46:36
cf37e4624a967f936ecbb5a4eefc9d38ed9d7892...9a03c21a18574de08fe6628f26bc0e032b79d436,1,26,0,26,1,2009-01-29 12:31:11,2009-01-29 12:31:11
9a03c21a18574de08fe6628f26bc0e032b79d436...b197fa7ece51a0327c3763588c3d8ecdde8fd863,1,1,1,2,1,2009-01-29 20:21:43,2009-01-29 20:21:43
b197fa7ece51a0327c3763588c3d8ecdde8fd863...bd40c32f6c2069d4fb71bf014e6fc99f1baed50b,1,2,2,4,1,2009-01-30 20:02:42,2009-01-30 20:02:42
bd40c32f6c2069d4fb71bf014e6fc99f1baed50b...c08e0ef649b68a5dc17fb2f6662c753356a2a16f,1,8,8,16,4,2009-01-30 20:15:41,2009-01-30 20:15:41
c08e0ef649b68a5dc17fb2f6662c753356a2a16f...d982edff4b6b3c2349e4d3b7293b747beeab936a,1,12,6,18,2,2009-02-01 17:49:33,2009-02-01 17:49:33
d982edff4b6b3c2349e4d3b7293b747beeab936a...2b8e768b2205793db0f0db4709b9b4674f14ada6,1,35,24,59,17,2009-02-01 18:22:57,2009-02-01 18:22:57
2b8e768b2205793db0f0db4709b9b4674f14ada6...65ad2132abd4c56f38c43b0ba9a23ed716733728,4,42,2,44,4,2009-02-02 12:03:31,2009-02-02 12:03:31
65ad2132abd4c56f38c43b0ba9a23ed716733728...8f410a577befddeff8639410a7a85d8e6d1c86e7,3,8,3,11,3,2009-02-02 13:43:18,2009-02-02 13:43:18
8f410a577befddeff8639410a7a85d8e6d1c86e7...a008b5c9abae582ca31578ff7d6842d0d6b00e27,1,2,2,4,1,2009-02-03 03:13:13,2009-02-03 03:13:13
a008b5c9abae582ca31578ff7d6842d0d6b00e27...ecadf675690c2cc9375e9af70ebd1528841eae76,5,37,21,58,33,2009-02-03 11:07:21,2009-02-03 11:07:21
ecadf675690c2cc9375e9af70ebd1528841eae76...81ae2afdec8a81b94bacf02a1242277e0b4caceb,2,34,1,35,3,2009-02-03 14:02:09,2009-02-03 14:02:09
81ae2afdec8a81b94bacf02a1242277e0b4caceb...e3d64c6fca04dc8df1b6fdb8809d4d15d7f27740,1,3,3,6,1,2009-02-03 22:08:57,2009-02-03 22:08:57
e3d64c6fca04dc8df1b6fdb8809d4d15d7f27740...fffade663365ee50f32a0c3b05915fba15a5fe3b,1,1,0,1,1,2009-02-03 23:13:02,2009-02-03 23:13:02
fffade663365ee50f32a0c3b05915fba15a5fe3b...9a2e33810789017dfb2cbe46afa01f3f45357757,3,67,21,88,17,2009-02-07 17:47:02,2009-02-07 17:47:02
9a2e33810789017dfb2cbe46afa01f3f45357757...95ed07e888cfe36fd7138b15ac7cb157194c0b1c,1,2,2,4,1,2009-02-07 18:06:32,2009-02-07 18:06:32
95ed07e888cfe36fd7138b15ac7cb157194c0b1c...0326574d0ecf2eeded92d66855822dd2e602297f,2,12,12,24,7,2009-02-07 19:32:37,2009-02-07 19:32:37
0326574d0ecf2eeded92d66855822dd2e602297f...addd3df3bd39730cd82c52d9726c9b7dbf1bdb8f,10,68,15,83,16,2009-02-08 05:08:06,2009-02-08 05:08:06
addd3df3bd39730cd82c52d9726c9b7dbf1bdb8f...d4a3a4b0ca7888ed98e03348af062b0d31d779aa,2,10,2,12,4,2009-02-08 11:14:07,2009-02-08 11:14:07
d4a3a4b0ca7888ed98e03348af062b0d31d779aa...f0a7470e405cb237e8b5676fd10f1ea482787baf,2,4,7,11,3,2009-02-08 11:14:56,2009-02-08 11:14:56
f0a7470e405cb237e8b5676fd10f1ea482787baf...e9af96de1edac106ad30994865a0ee2233bed984,1,2,1,3,1,2009-02-11 00:15:23,2009-02-11 00:15:23
e9af96de1edac106ad30994865a0ee2233bed984...e5cd43e5884ec5860cb7f421b6f84eda93e70b3b,3,20,3,23,8,2009-02-11 20:13:17,2009-02-11 20:13:17
e5cd43e5884ec5860cb7f421b6f84eda93e70b3b...e4e964510c917dc668929e9cb6eb0fe0f6d4a576,1,12,1,13,3,2009-02-12 02:54:39,2009-02-12 02:54:39
e4e964510c917dc668929e9cb6eb0fe0f6d4a576...739ae2b04bb8c932db7e3bb5a436f036bdf3252b,2,108,100,208,98,2009-02-13 10:57:06,2009-02-13 10:57:06
739ae2b04bb8c932db7e3bb5a436f036bdf3252b...5ff216b40f0ed8da45c626ec98e9b99d60cbb8fd,2,108,103,211,99,2009-02-13 10:57:31,2009-02-13 10:57:31
5ff216b40f0ed8da45c626ec98e9b99d60cbb8fd...bfbd62752a1ecd289c3833b5ada4d5082888358c,2,6,6,12,6,2009-02-13 11:04:19,2009-02-13 11:04:19
bfbd62752a1ecd289c3833b5ada4d5082888358c...f76cb41251818f9e30c05b672645667776bcc92e,2,61,61,122,21,2009-02-15 05:46:00,2009-02-15 05:46:00
f76cb41251818f9e30c05b672645667776bcc92e...88837875f245672a5e8671a1d144c78d3e102450,2,224,181,405,78,2009-02-16 05:10:31,2009-02-16 05:10:31
88837875f245672a5e8671a1d144c78d3e102450...58ea6d45618cb8b5bd4306c395d7bb8860f9a842,3,111,19,130,18,2009-02-16 12:28:37,2009-02-16 12:28:37
58ea6d45618cb8b5bd4306c395d7bb8860f9a842...fb64ea78968714929a75514ecd55fb5af1093697,3,28,14,42,10,2009-02-16 12:29:31,2009-02-16 12:29:31
fb64ea78968714929a75514ecd55fb5af1093697...2b1bb716ff7552bf9f98653c172a573c380e4798,2,5,1,6,2,2009-02-16 12:38:11,2009-02-16 12:38:11
2b1bb716ff7552bf9f98653c172a573c380e4798...11bfe7236609dad4c88d8352f64ed7a2888da936,2,16,0,16,2,2009-02-16 17:30:12,2009-02-16 17:30:12
11bfe7236609dad4c88d8352f64ed7a2888da936...ecc55503f40e375b957aa9dfaf8db34e8f348f63,4,105,29,134,23,2009-02-16 18:34:28,2009-02-16 18:34:28
ecc55503f40e375b957aa9dfaf8db34e8f348f63...8ada8d7c0391572d0b1f0408394d041e59d19be4,2,8,1,9,2,2009-02-16 20:47:39,2009-02-16 20:47:39
8ada8d7c0391572d0b1f0408394d041e59d19be4...fd28d04c39f83672f674aa2d83557db36a70b4b5,1,7,4,11,2,2009-02-16 21:03:09,2009-02-16 21:03:09
fd28d04c39f83672f674aa2d83557db36a70b4b5...e83f81de8c6ec5497488ae7787fd2e392c9ea704,1,2,2,4,2,2009-02-17 10:17:29,2009-02-17 10:17:29
e83f81de8c6ec5497488ae7787fd2e392c9ea704...fc02370ceed1cceb039e1318d0bb00c699f97b01,1,1,1,2,1,2009-02-17 23:33:30,2009-02-17 23:33:30
fc02370ceed1cceb039e1318d0bb00c699f97b01...322a6a9d1dffee284bb9ea1b309e64f7fa7411b5,1,3,3,6,2,2009-02-19 22:45:48,2009-02-19 22:45:48
322a6a9d1dffee284bb9ea1b309e64f7fa7411b5...cd0611bd83ecc404bf250a24062aa5071a072353,1,2,1,3,2,2009-02-21 07:19:12,2009-02-21 07:19:12
cd0611bd83ecc404bf250a24062aa5071a072353...68d15e94d2d3c97e363a6fcfeb13e48c31dfccbb,1,2,1,3,1,2009-02-21 08:40:07,2009-02-21 08:40:07
68d15e94d2d3c97e363a6fcfeb13e48c31dfccbb...8ed6a62a3c419bc9b2aa384fe408f30c326d99af,1,1,1,2,1,2009-02-21 08:41:04,2009-02-21 08:41:04
8ed6a62a3c419bc9b2aa384fe408f30c326d99af...641853331d97138cf32c97d5a0187fc5e0491125,1,1,1,2,1,2009-02-21 08:43:35,2009-02-21 08:43:35
641853331d97138cf32c97d5a0187fc5e0491125...28448a53a9d4cf17306789cd9980162795c644ed,2,3,0,3,2,2009-02-21 08:45:47,2009-02-21 08:45:47
28448a53a9d4cf17306789cd9980162795c644ed...82427354059cc5363968905ccca6e818f62ae7a6,1,0,3,3,3,2009-02-21 10:10:13,2009-02-21 10:10:13
82427354059cc5363968905ccca6e818f62ae7a6...bd658cb814f527dc9302bd413e44f2d4cac36be4,1,2,2,4,2,2009-02-22 06:06:29,2009-02-22 06:06:29
bd658cb814f527dc9302bd413e44f2d4cac36be4...16d67a11ac69ed4ce5df5334fa2bf5cbc0768df9,1,1,1,2,1,2009-02-22 06:06:56,2009-02-22 06:06:56
16d67a11ac69ed4ce5df5334fa2bf5cbc0768df9...b77bf5291a7bd79c9a298b306f9ee0759375ece6,1,17,16,33,17,2009-02-22 06:07:21,2009-02-22 06:07:21
b77bf5291a7bd79c9a298b306f9ee0759375ece6...b1d487e0f86e9796ea49286dd22a163179cc3e1c,1,24,24,48,22,2009-02-22 06:07:47,2009-02-22 06:07:47
b1d487e0f86e9796ea49286dd22a163179cc3e1c...f1e8d24e0c3d6aafaf2550eb19e58158a7339fd7,1,47,47,94,40,2009-02-22 06:08:13,2009-02-22 06:08:13
f1e8d24e0c3d6aafaf2550eb19e58158a7339fd7...39dd44570c2b66ed2b251f507f8b189524bb2f9d,1,2,2,4,2,2009-02-22 06:08:37,2009-02-22 06:08:37
39dd44570c2b66ed2b251f507f8b189524bb2f9d...7b9fe15a9f60690c52a66784fc8d93d448f3bca0,1,2,2,4,2,2009-02-22 06:09:03,2009-02-22 06:09:03
7b9fe15a9f60690c52a66784fc8d93d448f3bca0...af346081e393e402bc53fbb5466228e58f2c4b9f,1,5,5,10,4,2009-02-22 06:09:28,2009-02-22 06:09:28
af346081e393e402bc53fbb5466228e58f2c4b9f...a50a188a626a699dd205e05ab4caaa7963773132,1,37,37,74,33,2009-02-22 06:09:54,2009-02-22 06:09:54
a50a188a626a699dd205e05ab4caaa7963773132...0c2a5ebe97c598be4e74f7d9ca6eff2e9af21b63,2,11,0,11,2,2009-02-22 06:10:29,2009-02-22 06:10:29
0c2a5ebe97c598be4e74f7d9ca6eff2e9af21b63...b2a437765193131d649aad87de1dea60ffc34a72,6,313,0,313,8,2009-02-22 07:51:57,2009-02-22 07:51:57
b2a437765193131d649aad87de1dea60ffc34a72...85691576649121ff3aaef2bc609282fae0683de4,1,1,1,2,1,2009-02-22 08:05:40,2009-02-22 08:05:40
85691576649121ff3aaef2bc609282fae0683de4...5f7c6a8d29e9353ffa1793e45de57274d4409767,1,29,27,56,24,2009-02-22 08:34:51,2009-02-22 08:34:51
5f7c6a8d29e9353ffa1793e45de57274d4409767...13d3d9d93f5e3c2175d1085b546e5a8a05f6a826,1,3,2,5,3,2009-02-22 10:13:37,2009-02-22 10:13:37
13d3d9d93f5e3c2175d1085b546e5a8a05f6a826...4bd24474c02a6f3c70e8111ac262fabf2fc5f454,2,6,1,7,2,2009-02-23 04:30:38,2009-02-23 04:30:38
4bd24474c02a6f3c70e8111ac262fabf2fc5f454...542709d0d1796326dd1edacf32fc1198cfad2869,7,102,32,134,28,2009-02-23 14:47:59,2009-02-23 14:47:59
542709d0d1796326dd1edacf32fc1198cfad2869...7d4a954836069d740d24101078cfadb4580533c2,1,31,8,39,4,2009-02-23 22:16:00,2009-02-23 22:16:00
7d4a954836069d740d24101078cfadb4580533c2...63d85a684ac713b74a8ea5fee3757139229e45a5,12,333,29,362,28,2009-02-23 22:16:26,2009-02-23 22:16:26
63d85a684ac713b74a8ea5fee3757139229e45a5...1aac357d344645f31320ee832b2c2e7be41c9ba0,1,10,1,11,2,2009-02-23 22:46:32,2009-02-23 22:46:32
1aac357d344645f31320ee832b2c2e7be41c9ba0...4cf1327aa4bc765ba3ed9df32f48bef5e936ebef,2,11,14,25,5,2009-02-24 01:10:26,2009-02-24 01:10:26
4cf1327aa4bc765ba3ed9df32f48bef5e936ebef...f3a95d2d14c031bff8fd59406f81d3205cfedd03,1,160,0,160,1,2009-02-24 01:42:45,2009-02-24 01:42:45
f3a95d2d14c031bff8fd59406f81d3205cfedd03...4251c6020ce8d62046875660e079f4a761afa9a4,2,2,1,3,2,2009-02-24 01:46:29,2009-02-24 01:46:29
4251c6020ce8d62046875660e079f4a761afa9a4...17bb750b080b6064b3240b767dd60e40cf69c591,2,120,117,237,24,2009-02-24 02:21:09,2009-02-24 02:21:09
17bb750b080b6064b3240b767dd60e40cf69c591...1b9bbb546a78e5f0e995104c75685ceeeca1b761,1,12,0,12,1,2009-02-24 02:28:16,2009-02-24 02:28:16
1b9bbb546a78e5f0e995104c75685ceeeca1b761...28605a9c2665505c85561b4f33483cfd81718898,1,4,2,6,1,2009-02-24 02:31:09,2009-02-24 02:31:09
28605a9c2665505c85561b4f33483cfd81718898...7d03ca9e86e366c2c369101621d011eb6ee8b2c2,5,47,13,60,13,2009-02-24 11:15:31,2009-02-24 11:15:31
7d03ca9e86e366c2c369101621d011eb6ee8b2c2...5f9ac288563ea6e8c9d25a7f7eeb1d437df28a8c,2,7,1,8,2,2009-02-24 17:24:08,2009-02-24 17:24:08
5f9ac288563ea6e8c9d25a7f7eeb1d437df28a8c...86a048b4e0dd07d56fafe5d294d5e12b5277a41b,1,2,2,4,2,2009-02-24 22:51:14,2009-02-24 22:51:14
86a048b4e0dd07d56fafe5d294d5e12b5277a41b...8ffe8981f6944219dabae16e900a5eb00c809316,2,24,10,34,11,2009-02-25 23:56:00,2009-02-25 23:56:00
8ffe8981f6944219dabae16e900a5eb00c809316...1306079a024ac7109487d2a560ceda3f842a4572,2,30,0,30,2,2009-02-26 17:11:28,2009-02-26 17:11:28
1306079a024ac7109487d2a560ceda3f842a4572...0dd4ec654f4b22854df841d9ea8f463fdbdf99c3,2,22,3,25,4,2009-02-27 04:57:33,2009-02-27 04:57:33
0dd4ec654f4b22854df841d9ea8f463fdbdf99c3...e20f09c2d047d782b4b471b2e8cf4a910b338db6,1,7,1,8,2,2009-02-27 05:14:11,2009-02-27 05:14:11
e20f09c2d047d782b4b471b2e8cf4a910b338db6...e735fe7160d786efeb2e8bea595174c1a68409a2,7,299,77,376,48,2009-02-27 13:14:59,2009-02-27 13:14:59
e735fe7160d786efeb2e8bea595174c1a68409a2...75a396bc649ebfca6dd6c75f49e926fe31aeb5c1,5,301,283,584,247,2009-02-28 01:17:21,2009-02-28 01:17:21
75a396bc649ebfca6dd6c75f49e926fe31aeb5c1...4ad77254b4ca5a2c7e6663d5a77c26b6802886f4,4,416,631,1047,312,2009-02-28 01:29:00,2009-02-28 01:29:00
4ad77254b4ca5a2c7e6663d5a77c26b6802886f4...415ffa8df56d72bf6f114abc8fdae11d459e768d,2,35,3,38,4,2009-02-28 02:59:40,2009-02-28 02:59:40
415ffa8df56d72bf6f114abc8fdae11d459e768d...beb20057a30a96b74dfc309c2add47148103ba63,3,19,11,30,4,2009-02-28 04:46:38,2009-02-28 04:46:38
beb20057a30a96b74dfc309c2add47148103ba63...b337884fcf6b2c1934d380dd99bbe485d3b88f3a,1,5,3,8,4,2009-02-28 04:51:13,2009-02-28 04:51:13
b337884fcf6b2c1934d380dd99bbe485d3b88f3a...db2a95f6f58f5593dbcee8dcf51f3e9d71449708,4,113,16,129,18,2009-02-28 05:35:22,2009-02-28 05:35:22
db2a95f6f58f5593dbcee8dcf51f3e9d71449708...5fcd75ce141b43059c722ff1f92e671d9e1a1997,2,13,7,20,2,2009-02-28 06:03:18,2009-02-28 06:03:18
5fcd75ce141b43059c722ff1f92e671d9e1a1997...bbea457fbb523f7cae5cff52ac8227c0abf33340,2,9,3,12,4,2009-03-01 01:24:03,2009-03-01 01:24:03
bbea457fbb523f7cae5cff52ac8227c0abf33340...c6a404d1e977cae75345594bf264ca103e1a1d33,3,13,5,18,4,2009-03-01 01:56:59,2009-03-01 01:56:59
c6a404d1e977cae75345594bf264ca103e1a1d33...3242df16e4e53afc58657cd7e01d0ba807e96288,3,12,9,21,7,2009-03-01 04:12:30,2009-03-01 04:12:30
3242df16e4e53afc58657cd7e01d0ba807e96288...152d51787802ef6d00297dc070bd2c95d2c2fa17,1,1,1,2,1,2009-03-01 06:54:38,2009-03-01 06:54:38
152d51787802ef6d00297dc070bd2c95d2c2fa17...238477f90cb667cbe2656d46ece275ffad6fb216,1,2,1,3,1,2009-03-01 07:12:38,2009-03-01 07:12:38
238477f90cb667cbe2656d46ece275ffad6fb216...70911bf98d5df4125c86a6c9e21e1df635979f81,1,6,1,7,1,2009-03-01 07:18:57,2009-03-01 07:18:57
70911bf98d5df4125c86a6c9e21e1df635979f81...d77236960a5d3792bf9514fb7834d2813f531054,2,6,1,7,2,2009-03-01 07:32:41,2009-03-01 07:32:41
d77236960a5d3792bf9514fb7834d2813f531054...b740706707aed9f057a2f8badc31bc87997c6142,2,15,5,20,6,2009-03-01 08:13:38,2009-03-01 08:13:38
b740706707aed9f057a2f8badc31bc87997c6142...2c338d7570b4ad37e863cf080782f8ec46c7ffe0,2,199,118,317,114,2009-03-01 14:23:40,2009-03-01 14:23:40
2c338d7570b4ad37e863cf080782f8ec46c7ffe0...79f6cce291a3b8ffb6d1526710c695cce380c81b,1,1,1,2,1,2009-03-02 00:26:55,2009-03-02 00:26:55
79f6cce291a3b8ffb6d1526710c695cce380c81b...e2cb2725eb144ddb549555498ff09d01144dc110,5,473,365,838,319,2009-03-02 00:33:37,2009-03-02 00:33:37
e2cb2725eb144ddb549555498ff09d01144dc110...8f28a84a9816812fc98b3f593c6f3f2537475dd9,1,6,3,9,4,2009-03-02 03:15:27,2009-03-02 03:15:27
8f28a84a9816812fc98b3f593c6f3f2537475dd9...ec710220dd347ed362a0a535d6a848e906d102e9,1,1,1,2,1,2009-03-02 04:17:00,2009-03-02 04:17:00
ec710220dd347ed362a0a535d6a848e906d102e9...cf3071242a289e20526ade81021b1f895fde706d,3,44,29,73,9,2009-03-02 04:48:22,2009-03-02 04:48:22
cf3071242a289e20526ade81021b1f895fde706d...a08267bf6ad365f523c5c3c71ba995a3251f3a9e,1,22,8,30,10,2009-03-02 04:48:47,2009-03-02 04:48:47
a08267bf6ad365f523c5c3c71ba995a3251f3a9e...a605a8fe085f207092f2e330cf1e738d58c75f70,1,1,1,2,1,2009-03-02 05:46:04,2009-03-02 05:46:04
a605a8fe085f207092f2e330cf1e738d58c75f70...851461aa72cc94e7000c3c7713e1d9fb130e0fda,2,9,6,15,2,2009-03-02 06:08:02,2009-03-02 06:08:02
851461aa72cc94e7000c3c7713e1d9fb130e0fda...dfddf129f07a859f52f04497f6254b675a345f8d,3,28,1,29,5,2009-03-02 08:16:33,2009-03-02 08:16:33
dfddf129f07a859f52f04497f6254b675a345f8d...00d89f80a52342e3a40ae298155df5b7d1fae7ad,1,1,1,2,1,2009-03-02 08:24:14,2009-03-02 08:24:14
00d89f80a52342e3a40ae298155df5b7d1fae7ad...d79655bdc9756bed4acdf4f9ae87a4a2a6bad8a1,2,149,77,226,72,2009-03-02 08:49:47,2009-03-02 08:49:47
d79655bdc9756bed4acdf4f9ae87a4a2a6bad8a1...5e8ddd59e231201d80780ab164f288d114857dee,1,3,2,5,1,2009-03-03 01:40:47,2009-03-03 01:40:47
5e8ddd59e231201d80780ab164f288d114857dee...fdca9e55e805a22fa1c9467f6958d28361f3932f,1,1,1,2,1,2009-03-03 02:45:15,2009-03-03 02:45:15
fdca9e55e805a22fa1c9467f6958d28361f3932f...7b55da05011bafe90f66925b8c29caf566e06510,1,2,2,4,2,2009-03-03 02:48:02,2009-03-03 02:48:02
7b55da05011bafe90f66925b8c29caf566e06510...9b8c712ca714d218e1ab7414237058d1d0f189ac,5,184,78,262,24,2009-03-03 22:10:15,2009-03-03 22:10:15
9b8c712ca714d218e1ab7414237058d1d0f189ac...f5063914b3de442d73c6cade5acb33a47fbcfd72,1,3,2,5,3,2009-03-04 04:53:15,2009-03-04 04:53:15
f5063914b3de442d73c6cade5acb33a47fbcfd72...c7a1a9f3807c07b42952293e8bd03275a6651442,2,4,4,8,4,2009-03-04 04:56:20,2009-03-04 04:56:20
c7a1a9f3807c07b42952293e8bd03275a6651442...14c8e5227af756a5dea207d8255bc3b3c941340c,1,8,3,11,3,2009-03-04 05:33:23,2009-03-04 05:33:23
14c8e5227af756a5dea207d8255bc3b3c941340c...0e93f60c7f6de821e31424b0e7c26586155a7a1a,3,79,32,111,17,2009-03-04 05:34:01,2009-03-04 05:34:01
0e93f60c7f6de821e31424b0e7c26586155a7a1a...dfd7a6c7811c49371838f593387ae6db7bb7ef30,3,38,4,42,10,2009-03-04 07:20:08,2009-03-04 07:20:08
dfd7a6c7811c49371838f593387ae6db7bb7ef30...f9c8eeb31133d3bf55ae167168fcb2d90ce4d12a,2,25,2,27,3,2009-03-04 07:21:14,2009-03-04 07:21:14
f9c8eeb31133d3bf55ae167168fcb2d90ce4d12a...7197a4dcb7de7085e04f1b4edfb31eacb7dd885c,2,41,10,51,5,2009-03-04 10:39:29,2009-03-04 10:39:29
7197a4dcb7de7085e04f1b4edfb31eacb7dd885c...ad6ce1e6f99a6427a4c01a175d72f21cd28f816a,2,9,8,17,2,2009-03-05 20:21:22,2009-03-05 20:21:22
ad6ce1e6f99a6427a4c01a175d72f21cd28f816a...68f81c873d16c3068638dea1bddddf0c62fb6ded,1,1,0,1,1,2009-03-06 02:01:20,2009-03-06 02:01:20
68f81c873d16c3068638dea1bddddf0c62fb6ded...923f78f5046bd35f5063aa06c1cfeff013317636,4,80,20,100,13,2009-03-06 02:02:09,2009-03-06 02:02:09
923f78f5046bd35f5063aa06c1cfeff013317636...b5d4a8ae1b63c35113ee225a15e819adb944b6a1,2,10,6,16,6,2009-03-06 02:36:56,2009-03-06 02:36:56
b5d4a8ae1b63c35113ee225a15e819adb944b6a1...53da1e47942f22a56e761d786ba89d05ca55a224,2,19,7,26,5,2009-03-06 04:51:05,2009-03-06 04:51:05
53da1e47942f22a56e761d786ba89d05ca55a224...f1ada99997de72fdd3f765ffa11fa4d1d9f438f9,22,516,373,889,241,2009-03-07 23:02:48,2009-03-07 23:02:48
f1ada99997de72fdd3f765ffa11fa4d1d9f438f9...cd99c62e2de8701ffd940d86da8e41798c10007d,2,27,0,27,3,2009-03-08 03:32:16,2009-03-08 03:32:16
cd99c62e2de8701ffd940d86da8e41798c10007d...e8a817d499ac67ef936d47457916db1d6eba8582,1,1,1,2,1,2009-03-08 04:31:05,2009-03-08 04:31:05
e8a817d499ac67ef936d47457916db1d6eba8582...d8fdf4d7acc8c154a5cb2af51e09ececc57586d1,1,2,2,4,2,2009-03-08 09:31:30,2009-03-08 09:31:30
d8fdf4d7acc8c154a5cb2af51e09ececc57586d1...242fc605209375425f25cdf591089d7804835606,8,25,1,26,6,2009-03-08 09:39:48,2009-03-08 09:39:48
242fc605209375425f25cdf591089d7804835606...d01c17e81d5aa988f21d257a0e247b9ae44b819f,1,4,2,6,2,2009-03-08 09:58:40,2009-03-08 09:58:40
d01c17e81d5aa988f21d257a0e247b9ae44b819f...6e415a5f90dc89e83b0e926f973c629b56642a9c,2,9,0,9,2,2009-03-08 09:59:17,2009-03-08 09:59:17
6e415a5f90dc89e83b0e926f973c629b56642a9c...392f81cba91310a93409c7b83a507c69736a19d2,1,5,2,7,1,2009-03-08 09:59:43,2009-03-08 09:59:43
392f81cba91310a93409c7b83a507c69736a19d2...cee31735f768322e2239857195cdb36e1fecc850,1,7,2,9,4,2009-03-08 18:34:24,2009-03-08 18:34:24
cee31735f768322e2239857195cdb36e1fecc850...35f934f5a7d9eb79a69f33de84854aa9a506b912,8,73,37,110,43,2009-03-09 00:03:03,2009-03-09 00:03:03
35f934f5a7d9eb79a69f33de84854aa9a506b912...fedea84f3ce4d58d4fb2d5d15f142443da760f32,1,5,5,10,5,2009-03-09 01:36:53,2009-03-09 01:36:53
fedea84f3ce4d58d4fb2d5d15f142443da760f32...059765fa6c273af584ad255eb1395dea6f0e2307,2,33,0,33,4,2009-03-09 01:37:17,2009-03-09 01:37:17
059765fa6c273af584ad255eb1395dea6f0e2307...98710a5a2853594f5bad161f9a3bedd27171bb89,2,5,5,10,5,2009-03-09 03:33:54,2009-03-09 03:33:54
98710a5a2853594f5bad161f9a3bedd27171bb89...b4dd4d4bb7db6533e13be1455ccdc52c3d50cac3,9,166,2,168,17,2009-03-09 03:35:02,2009-03-09 03:35:02
b4dd4d4bb7db6533e13be1455ccdc52c3d50cac3...a7ff8b79fffe8e3b6366916086d10522eb601d7e,2,8,8,16,8,2009-03-09 16:33:52,2009-03-09 16:33:52
a7ff8b79fffe8e3b6366916086d10522eb601d7e...d45e24a1f849e1f244b58565223765c95156fef1,8,152,53,205,21,2009-03-09 19:22:24,2009-03-09 19:22:24
d45e24a1f849e1f244b58565223765c95156fef1...ec9c03ce0bef5ecd40179e813f2ae6b87f3be8c4,1,3,0,3,2,2009-03-10 05:23:42,2009-03-10 05:23:42
ec9c03ce0bef5ecd40179e813f2ae6b87f3be8c4...0516c5d9214372810dcf7d02f3a0f2705bb25a86,3,30,2,32,6,2009-03-10 05:24:19,2009-03-10 05:24:19
0516c5d9214372810dcf7d02f3a0f2705bb25a86...d0fff8ccd4d61a848314ada5b386652606d44f00,1,16,7,23,5,2009-03-10 05:51:06,2009-03-10 05:51:06
d0fff8ccd4d61a848314ada5b386652606d44f00...3c8568a7dcb38aaa5aceec4f20c3ec3f0217a50d,8,228,52,280,66,2009-03-10 11:19:26,2009-03-10 11:19:26
3c8568a7dcb38aaa5aceec4f20c3ec3f0217a50d...326c5813b9d7a36f95993d34c04c45bf386570b1,1,1,2,3,1,2009-03-10 11:21:46,2009-03-10 11:21:46
326c5813b9d7a36f95993d34c04c45bf386570b1...6aa5aacc86a918abd00b2110cc58565193306dd8,4,132,55,187,39,2009-03-10 18:03:35,2009-03-10 18:03:35
6aa5aacc86a918abd00b2110cc58565193306dd8...a4f1e48ddbc464ed0ccb9c305db721845db91d6b,1,11,0,11,3,2009-03-10 18:37:22,2009-03-10 18:37:22
a4f1e48ddbc464ed0ccb9c305db721845db91d6b...7daf0b94070ab29419825156ec68bca813e3c09f,1,2,2,4,1,2009-03-10 22:48:42,2009-03-10 22:48:42
7daf0b94070ab29419825156ec68bca813e3c09f...315145f7ca682f8361d956e985f533a7fb421cde,12,115,92,207,47,2009-03-11 03:39:34,2009-03-11 03:39:34
315145f7ca682f8361d956e985f533a7fb421cde...6c6edb9d043db0d0c753b8c9be98d01444188f25,1,3,0,3,3,2009-03-11 04:56:13,2009-03-11 04:56:13
6c6edb9d043db0d0c753b8c9be98d01444188f25...0543f33bbcc48e7dd8d977b77b0377c1928fcacb,2,7,3,10,2,2009-03-11 05:48:26,2009-03-11 05:48:26
0543f33bbcc48e7dd8d977b77b0377c1928fcacb...5fb66670367501cab7c50bdf81e2600b840162ee,8,220,56,276,28,2009-03-11 07:06:50,2009-03-11 07:06:50
5fb66670367501cab7c50bdf81e2600b840162ee...1d8e6eae34974fd9c60e15884d155dd4bc4dfdc0,1,2,2,4,1,2009-03-11 11:03:36,2009-03-11 11:03:36
1d8e6eae34974fd9c60e15884d155dd4bc4dfdc0...638dbc3e8320652ba3bd759e0ac1d28590402096,6,239,41,280,39,2009-03-11 13:27:03,2009-03-11 13:27:03
638dbc3e8320652ba3bd759e0ac1d28590402096...90a3c34b358b58367ed5d2354ba42de9e49daacc,1,4,4,8,2,2009-03-11 21:14:18,2009-03-11 21:14:18
90a3c34b358b58367ed5d2354ba42de9e49daacc...d4677d4bfbf73110a436037199b6938ce5ea167f,1,13,26,39,8,2009-03-12 05:30:51,2009-03-12 05:30:51
d4677d4bfbf73110a436037199b6938ce5ea167f...c663e8fbd73ad3ad2f4bd1cdb473b77963c2e352,1,6,3,9,1,2009-03-12 05:31:34,2009-03-12 05:31:34
c663e8fbd73ad3ad2f4bd1cdb473b77963c2e352...a1529090698c589b64ab3ed0f0ba62cd72617f5b,1,9,0,9,1,2009-03-12 05:32:00,2009-03-12 05:32:00
a1529090698c589b64ab3ed0f0ba62cd72617f5b...6483fdf1fadf5f577fc7eef07bb4ec5c920e44f8,1,6,1,7,3,2009-03-12 07:27:47,2009-03-12 07:27:47
6483fdf1fadf5f577fc7eef07bb4ec5c920e44f8...fb729cf1d999423721342c3dc6dfb58d48ed5389,2,6,3,9,4,2009-03-12 07:28:22,2009-03-12 07:28:22
fb729cf1d999423721342c3dc6dfb58d48ed5389...bd6fc4848e9cb234b0f24e52536f24a853be5b91,1,1,1,2,1,2009-03-12 07:57:35,2009-03-12 07:57:35
bd6fc4848e9cb234b0f24e52536f24a853be5b91...5eccc596525c396941cec8e985ebf7fa418e2026,1,3,5,8,3,2009-03-12 08:52:42,2009-03-12 08:52:42
5eccc596525c396941cec8e985ebf7fa418e2026...6d17020c1a1bd94e107defc698adc445084d01d6,2,75,73,148,18,2009-03-12 11:52:55,2009-03-12 11:52:55
6d17020c1a1bd94e107defc698adc445084d01d6...c3dc837950966013ca5a4a235e85ed85595f7161,4,45,11,56,12,2009-03-12 23:41:27,2009-03-12 23:41:27
c3dc837950966013ca5a4a235e85ed85595f7161...d8744cca265243386977e4fbea671a72e6550ac7,1,26,24,50,3,2009-03-13 04:41:45,2009-03-13 04:41:45
d8744cca265243386977e4fbea671a72e6550ac7...a21770e9147198ac8f6dcf03033e3f48a004a89c,1,2,1,3,1,2009-03-13 04:45:11,2009-03-13 04:45:11
a21770e9147198ac8f6dcf03033e3f48a004a89c...6309b40bc2a6c93506cef5ae0043743fb172acc1,1,4,2,6,4,2009-03-13 16:57:26,2009-03-13 16:57:26
6309b40bc2a6c93506cef5ae0043743fb172acc1...f7256582990652c3a18fb784eb7360c47f9fb154,1,1,1,2,1,2009-03-13 17:20:52,2009-03-13 17:20:52
f7256582990652c3a18fb784eb7360c47f9fb154...0ae95f80b4030b6ad716838f45da45b9c34e612a,2,11,0,11,4,2009-03-13 19:57:00,2009-03-13 19:57:00
0ae95f80b4030b6ad716838f45da45b9c34e612a...83c1572cc47283b97c78a4b695788bcb755ca358,3,14,1,15,3,2009-03-13 21:04:48,2009-03-13 21:04:48
83c1572cc47283b97c78a4b695788bcb755ca358...84ce18fc9bbb8a7debd8904f746ae8c57844d291,2,9,1,10,3,2009-03-14 04:32:52,2009-03-14 04:32:52
84ce18fc9bbb8a7debd8904f746ae8c57844d291...f87575fbe515754f716e9dff84d90a6e28257156,1,0,0,0,0,2009-03-14 05:18:02,2009-03-14 05:18:02
f87575fbe515754f716e9dff84d90a6e28257156...957c721594deb9a6e91a83a7e1ff37502ec1bb97,1,202,117,319,60,2009-03-14 22:51:05,2009-03-14 22:51:05
957c721594deb9a6e91a83a7e1ff37502ec1bb97...7d9b29a56ddc1a793a02d55743c372a8256b97aa,4,65,2,67,6,2009-03-15 03:41:33,2009-03-15 03:41:33
7d9b29a56ddc1a793a02d55743c372a8256b97aa...292f503845401868ae9bf02b9bb1c38f35774c2c,1,114,9,123,6,2009-03-15 03:42:08,2009-03-15 03:42:08
292f503845401868ae9bf02b9bb1c38f35774c2c...24b9c65d3fd9b6fdff9397a03eb4ec9e6f1687c1,1,49,1,50,2,2009-03-15 03:42:31,2009-03-15 03:42:31
24b9c65d3fd9b6fdff9397a03eb4ec9e6f1687c1...7be4b9a4c005639f03fcd096c3a53fffcb7f210c,3,65,14,79,15,2009-03-15 05:05:26,2009-03-15 05:05:26
7be4b9a4c005639f03fcd096c3a53fffcb7f210c...b994387d8d9ff3b19d3ab04d3b4ac69d5dd68ea2,11,457,13,470,23,2009-03-15 05:54:28,2009-03-15 05:54:28
b994387d8d9ff3b19d3ab04d3b4ac69d5dd68ea2...0597dea4d0cbf20a4b815f586ba1babccda93e2e,1,4,4,8,1,2009-03-15 11:21:41,2009-03-15 11:21:41
0597dea4d0cbf20a4b815f586ba1babccda93e2e...536ccd1134d747bc22cf80c42c332e533146a9fe,1,8,6,14,3,2009-03-16 00:34:58,2009-03-16 00:34:58
536ccd1134d747bc22cf80c42c332e533146a9fe...cf7a3fa7f06814a7a22198fb9f84f6b9c0f09461,2,14,1,15,2,2009-03-17 10:30:17,2009-03-17 10:30:17
cf7a3fa7f06814a7a22198fb9f84f6b9c0f09461...25e1c39bc35fdc013627fa29c8c6cf24fc705fe1,1,1,1,2,1,2009-03-17 10:40:04,2009-03-17 10:40:04
25e1c39bc35fdc013627fa29c8c6cf24fc705fe1...f66853bccae312e3d7f37048e5baaccabc86d18e,1,1,1,2,1,2009-03-17 19:23:23,2009-03-17 19:23:23
f66853bccae312e3d7f37048e5baaccabc86d18e...a7d1c73ad9eca3010768153e3e71453dbe32267a,1,3,2,5,2,2009-03-17 20:40:01,2009-03-17 20:40:01
a7d1c73ad9eca3010768153e3e71453dbe32267a...7bc0878922d9d93ab8f4ef8a5c5ba7a1c671279f,10,317,34,351,27,2009-03-17 20:51:47,2009-03-17 20:51:47
7bc0878922d9d93ab8f4ef8a5c5ba7a1c671279f...324eba99cbfb257de7e2cb377f550a31a84fa673,6,4,5,9,7,2009-03-18 00:59:40,2009-03-18 00:59:40
324eba99cbfb257de7e2cb377f550a31a84fa673...4a88785e38db53187e585cdfab78abc8166a8a8a,1,17,8,25,5,2009-03-18 03:03:24,2009-03-18 03:03:24
4a88785e38db53187e585cdfab78abc8166a8a8a...4a67fee785d4d71203031fc46c0aafa15c1437a1,1,117,114,231,110,2009-03-18 09:19:24,2009-03-18 09:19:24
4a67fee785d4d71203031fc46c0aafa15c1437a1...c0b6e23eb31b5129db526ff46ba1d459765691b6,2,51,42,93,42,2009-03-18 09:36:45,2009-03-18 09:36:45
c0b6e23eb31b5129db526ff46ba1d459765691b6...61a2708c4108939795c70cf124d5696275d6c255,10,488,95,583,36,2009-03-18 09:47:08,2009-03-18 09:47:08
61a2708c4108939795c70cf124d5696275d6c255...ee2f04d79e5bca55637b9bb3301618738a4e342a,7,58,5,63,12,2009-03-18 10:46:55,2009-03-18 10:46:55
ee2f04d79e5bca55637b9bb3301618738a4e342a...c485e236bd7e5ea40c64b2fe54d85dbb15b2fd39,32,128,71,199,81,2009-03-18 16:55:59,2009-03-18 16:55:59
c485e236bd7e5ea40c64b2fe54d85dbb15b2fd39...96d5d434fac940aff854c939bef74394fe2c586e,2,46,0,46,2,2009-03-19 09:04:19,2009-03-19 09:04:19
96d5d434fac940aff854c939bef74394fe2c586e...29050ef999e1931efb6c62471c7e07d2ea5e96ea,10,685,111,796,38,2009-03-19 09:06:04,2009-03-19 09:06:04
29050ef999e1931efb6c62471c7e07d2ea5e96ea...014b96150916a2f275b4f82871ef56f35269e8b0,1,1,1,2,1,2009-03-19 09:43:45,2009-03-19 09:43:45
014b96150916a2f275b4f82871ef56f35269e8b0...466198c4d95183c9ef8a41025945da24dfcbbd00,1,13,0,13,2,2009-03-19 22:46:28,2009-03-19 22:46:28
466198c4d95183c9ef8a41025945da24dfcbbd00...729c974e64ef26d2b6eacce50ba324124b13d461,1,1,1,2,1,2009-03-19 22:46:49,2009-03-19 22:46:49
729c974e64ef26d2b6eacce50ba324124b13d461...2d287247308ea5e40214f4564b91b633959902a9,4,46,35,81,13,2009-03-19 23:14:20,2009-03-19 23:14:20
2d287247308ea5e40214f4564b91b633959902a9...4e7a4eda3d442f44f778bddb5668ba1e4947559f,2,6,4,10,4,2009-03-19 23:28:16,2009-03-19 23:28:16
4e7a4eda3d442f44f778bddb5668ba1e4947559f...19290ed05142372914731a916e14df7c1d02e0d9,1,2,2,4,1,2009-03-20 00:51:54,2009-03-20 00:51:54
19290ed05142372914731a916e14df7c1d02e0d9...380f6be5b87b9e6cd95897d19fe9b6b0276f9f3d,1,1,1,2,1,2009-03-20 00:56:56,2009-03-20 00:56:56
380f6be5b87b9e6cd95897d19fe9b6b0276f9f3d...e3139cc0757919795a8cdd24a110419d725b86ea,1,1,1,2,1,2009-03-20 00:58:35,2009-03-20 00:58:35
e3139cc0757919795a8cdd24a110419d725b86ea...255cb391d16238d07ca530e3e2d41c897858231d,2,5,2,7,3,2009-03-20 01:37:11,2009-03-20 01:37:11
255cb391d16238d07ca530e3e2d41c897858231d...420a35b9b752f5030c1c01616f41601812250aad,1,2,2,4,2,2009-03-20 01:37:34,2009-03-20 01:37:34
420a35b9b752f5030c1c01616f41601812250aad...85733c5d51911c7e1f41b8b98d73007e22eec763,1,1,1,2,1,2009-03-20 01:43:35,2009-03-20 01:43:35
85733c5d51911c7e1f41b8b98d73007e22eec763...9eb061b2c02a3f1c78c9d323498dffb97a713c32,1,12,8,20,4,2009-03-20 02:10:47,2009-03-20 02:10:47
9eb061b2c02a3f1c78c9d323498dffb97a713c32...44b0f68f44c4e5ca6f2b9da294dab1db531abc6e,1,5,5,10,5,2009-03-20 02:50:48,2009-03-20 02:50:48
44b0f68f44c4e5ca6f2b9da294dab1db531abc6e...fa89fdcd6b4a4ab4887740c0d0f4a73297a5b060,3,87,21,108,10,2009-03-20 03:57:12,2009-03-20 03:57:12
fa89fdcd6b4a4ab4887740c0d0f4a73297a5b060...6e3b129f158cfb6de991854c36cdc44cd3434bb1,1,8,7,15,5,2009-03-20 03:57:21,2009-03-20 03:57:21
6e3b129f158cfb6de991854c36cdc44cd3434bb1...4eadcf45d4d3951cd674caebeee9c62712bef781,1,18,10,28,5,2009-03-20 23:15:27,2009-03-20 23:15:27
4eadcf45d4d3951cd674caebeee9c62712bef781...d7e81275242a8439768367059701baa00a9be996,3,160,15,175,13,2009-03-21 13:09:13,2009-03-21 13:09:13
d7e81275242a8439768367059701baa00a9be996...e923b545a49fecad4451772a7670eb44cf6585cc,1,0,2,2,2,2009-03-21 13:45:15,2009-03-21 13:45:15
e923b545a49fecad4451772a7670eb44cf6585cc...231a7e04194ad886b615122583ae7444d6a35443,4,143,75,218,11,2009-03-21 13:45:31,2009-03-21 13:45:31
231a7e04194ad886b615122583ae7444d6a35443...e389234201b3799b1037536ad1e9cb0496628721,1,18,16,34,16,2009-03-21 15:26:56,2009-03-21 15:26:56
e389234201b3799b1037536ad1e9cb0496628721...10923b42b33dc6b756d06b235c135bc40a35435a,2,3,3,6,3,2009-03-21 15:28:51,2009-03-21 15:28:51
10923b42b33dc6b756d06b235c135bc40a35435a...5ac154e06568b9815e85b32f144ab4ee10190a61,3,54,7,61,3,2009-03-22 01:45:22,2009-03-22 01:45:22
5ac154e06568b9815e85b32f144ab4ee10190a61...b203db6ec850fee9ad8f2e2c8873be986325572b,10,388,4,392,17,2009-03-22 07:58:29,2009-03-22 07:58:29
b203db6ec850fee9ad8f2e2c8873be986325572b...14b160957e2965669e241f4640dd42a0fc412ec4,8,177,17,194,24,2009-03-22 16:13:06,2009-03-22 16:13:06
14b160957e2965669e241f4640dd42a0fc412ec4...3bb68004ff600930e181c190d06d79254f5a1b9c,2,9,1,10,2,2009-03-22 23:16:03,2009-03-22 23:16:03
3bb68004ff600930e181c190d06d79254f5a1b9c...f5c07f89e3f69672f94d1863e6559c78a40d1688,1,2,3,5,2,2009-03-23 09:19:45,2009-03-23 09:19:45
f5c07f89e3f69672f94d1863e6559c78a40d1688...a6f429e37e7fe9cf8801c8fbce4c40af7e0cec0c,5,152,66,218,28,2009-03-23 09:40:25,2009-03-23 09:40:25
a6f429e37e7fe9cf8801c8fbce4c40af7e0cec0c...7db24dd2b080f727cd9753161e88faa308514aad,2,33,31,64,21,2009-03-23 09:42:51,2009-03-23 09:42:51
7db24dd2b080f727cd9753161e88faa308514aad...4e2533436ef08ce81516e4cfd47ccbb1dddac5f8,1,1,7,8,1,2009-03-23 16:37:25,2009-03-23 16:37:25
4e2533436ef08ce81516e4cfd47ccbb1dddac5f8...44f3080226888eb709cc6e027321647964ebe64e,26,881,108,989,135,2009-03-23 20:22:56,2009-03-23 20:22:56
44f3080226888eb709cc6e027321647964ebe64e...f0560dfdb2adaa44fc739941a2a784c558ae6427,9,545,1,546,9,2009-03-23 21:07:02,2009-03-23 21:07:02
f0560dfdb2adaa44fc739941a2a784c558ae6427...f22418a6becb80770e83eab0fc38190a73f89ed3,1,235,0,235,1,2009-03-23 21:22:31,2009-03-23 21:22:31
f22418a6becb80770e83eab0fc38190a73f89ed3...9797d51efe4038637318fc7399a8501be0e563d9,1,1,1,2,1,2009-03-23 22:00:13,2009-03-23 22:00:13
9797d51efe4038637318fc7399a8501be0e563d9...64ddff1b11290397bd10a81427840e2383da149d,1,9,1,10,2,2009-03-23 22:01:16,2009-03-23 22:01:16
64ddff1b11290397bd10a81427840e2383da149d...20f7e514930d108e4abb7f1af6f21edc00206030,5,38,45,83,16,2009-03-23 23:02:46,2009-03-23 23:02:46
20f7e514930d108e4abb7f1af6f21edc00206030...cdc8c61bc3b7ba3e9b7316ae7ab1a65756ef79a2,3,4,6,10,4,2009-03-23 23:20:40,2009-03-23 23:20:40
cdc8c61bc3b7ba3e9b7316ae7ab1a65756ef79a2...4246c832b6f8166b7ea06f55ab54a7c23307f49a,6,217,1,218,6,2009-03-23 23:25:03,2009-03-23 23:25:03
4246c832b6f8166b7ea06f55ab54a7c23307f49a...66e1670efae34d721e374788e4c3f8b5fe5fa481,28,2590,1224,3814,127,2009-03-24 00:12:21,2009-03-24 00:12:21
66e1670efae34d721e374788e4c3f8b5fe5fa481...da986b7b912013160631cdc3db16e38979c7f0ec,1,1,1,2,1,2009-03-24 00:24:32,2009-03-24 00:24:32
da986b7b912013160631cdc3db16e38979c7f0ec...2fb7f5ea2b488ec9b97e1cc1f8e1554d681c6f9b,1,1,1,2,1,2009-03-24 00:26:12,2009-03-24 00:26:12
2fb7f5ea2b488ec9b97e1cc1f8e1554d681c6f9b...e5a8d9e810a00898345e15f1af5c4099e746c7a0,5,166,64,230,27,2009-03-24 03:01:46,2009-03-24 03:01:46
e5a8d9e810a00898345e15f1af5c4099e746c7a0...c5aa6fa71067b001c1d549b33ac4e2b409a70c75,1,2,2,4,1,2009-03-24 03:11:38,2009-03-24 03:11:38
c5aa6fa71067b001c1d549b33ac4e2b409a70c75...fd46f673bd83d8ed26ed54075439236e65f2d015,3,52,5,57,12,2009-03-24 03:59:38,2009-03-24 03:59:38
fd46f673bd83d8ed26ed54075439236e65f2d015...91ebe9acaebff65cdf2b8bab0828bb9badff5179,1,7,12,19,3,2009-03-24 04:26:56,2009-03-24 04:26:56
91ebe9acaebff65cdf2b8bab0828bb9badff5179...37f25d4c0cde5afa0e8178b424b5b80eff44de02,1,2,1,3,1,2009-03-24 07:05:57,2009-03-24 07:05:57
37f25d4c0cde5afa0e8178b424b5b80eff44de02...2dfdc2b01b9bdfe8fcff2706fef678b2186a6cdf,1,13,13,26,10,2009-03-24 08:22:23,2009-03-24 08:22:23
2dfdc2b01b9bdfe8fcff2706fef678b2186a6cdf...cc2d0c30000ea2e965640f3a67b3fecd15578905,2,172,118,290,104,2009-03-24 08:50:40,2009-03-24 08:50:40
cc2d0c30000ea2e965640f3a67b3fecd15578905...214c79219e99fb008eb9b3d1323259da4c845145,1,0,9,9,1,2009-03-24 11:35:48,2009-03-24 11:35:48
214c79219e99fb008eb9b3d1323259da4c845145...6cd8e0f608583d13290d48bc348e5fe7c298878a,1,8,2,10,2,2009-03-24 11:36:58,2009-03-24 11:36:58
6cd8e0f608583d13290d48bc348e5fe7c298878a...af997a1625af66e0c40073873bf70ed34e5fee3e,1,2,2,4,1,2009-03-24 11:37:48,2009-03-24 11:37:48
af997a1625af66e0c40073873bf70ed34e5fee3e...d379ebdabb7e8d0d87b8d0deef4ec18501752ece,1,6,6,12,5,2009-03-24 11:38:53,2009-03-24 11:38:53
d379ebdabb7e8d0d87b8d0deef4ec18501752ece...01757192e670c298169150d1030c011741af9444,1,2,2,4,1,2009-03-24 11:40:12,2009-03-24 11:40:12
01757192e670c298169150d1030c011741af9444...c4eb2883bc4226ae7e20a2f5f0420fb98517ec64,1,9,7,16,8,2009-03-24 11:41:37,2009-03-24 11:41:37
c4eb2883bc4226ae7e20a2f5f0420fb98517ec64...f55aba59d0bc0579e2d5ac4c7d1882496878876b,1,1,1,2,1,2009-03-24 11:42:34,2009-03-24 11:42:34
f55aba59d0bc0579e2d5ac4c7d1882496878876b...2aa8890136744facce3ced59c40574fbe3d9c6c0,1,1,1,2,1,2009-03-24 11:43:52,2009-03-24 11:43:52
2aa8890136744facce3ced59c40574fbe3d9c6c0...539bebab3f338af74de9e0caa4e0f94abcc7b31b,1,5,5,10,3,2009-03-24 11:44:51,2009-03-24 11:44:51
539bebab3f338af74de9e0caa4e0f94abcc7b31b...cce822c0f59ec7a3ee21273c4ba4310b685ccecc,2,5,6,11,4,2009-03-24 11:46:18,2009-03-24 11:46:18
cce822c0f59ec7a3ee21273c4ba4310b685ccecc...e89a9a84bc69b5be76eec103ce258d460b08059d,2,295,163,458,144,2009-03-24 12:31:43,2009-03-24 12:31:43
e89a9a84bc69b5be76eec103ce258d460b08059d...6485d9bb4301a20ce5f029b595ea6feba28d2aef,2,293,164,457,145,2009-03-24 12:32:08,2009-03-24 12:32:08
6485d9bb4301a20ce5f029b595ea6feba28d2aef...7f63d0009f762c6ce1c665df3674be2fcd3ef7fa,1,4,3,7,2,2009-03-25 01:31:57,2009-03-25 01:31:57
7f63d0009f762c6ce1c665df3674be2fcd3ef7fa...2c6c60cec613246bff5cb0be831969c20417b53c,5,32,6,38,12,2009-03-25 03:45:56,2009-03-25 03:45:56
2c6c60cec613246bff5cb0be831969c20417b53c...6671b8b1cd388ccb16a734e9147f0c73638ebf48,1,8,0,8,1,2009-03-25 04:41:40,2009-03-25 04:41:40
6671b8b1cd388ccb16a734e9147f0c73638ebf48...68288219cd17dd3b69f1214b7ed6b8e5eb43e4e0,2,5,15,20,5,2009-03-25 08:28:57,2009-03-25 08:28:57
68288219cd17dd3b69f1214b7ed6b8e5eb43e4e0...6fa30faa797fd826b6c91aedd13a430430f11d35,2,53,0,53,2,2009-03-25 09:05:38,2009-03-25 09:05:38
6fa30faa797fd826b6c91aedd13a430430f11d35...0b9a855bed58825624b9a517efd94aa0f5af347d,7,342,543,885,9,2009-03-26 02:07:11,2009-03-26 02:07:11
0b9a855bed58825624b9a517efd94aa0f5af347d...faf16098516613c7e1f67d48ad7d1d927a0203af,1,4,0,4,1,2009-03-27 19:48:02,2009-03-27 19:48:02
faf16098516613c7e1f67d48ad7d1d927a0203af...f0b7cc4a2331884c29fd431c8bc76c13d9d82d46,6,203,35,238,36,2009-03-28 16:36:48,2009-03-28 16:36:48
f0b7cc4a2331884c29fd431c8bc76c13d9d82d46...69977d2045ba98918182d1229fc73acae62a2e8e,3,26,8,34,11,2009-03-29 18:52:38,2009-03-29 18:52:38
69977d2045ba98918182d1229fc73acae62a2e8e...937ded3369d454aa4c5d7b605331270ed9460ea8,2,330,197,527,180,2009-03-29 21:25:21,2009-03-29 21:25:21
937ded3369d454aa4c5d7b605331270ed9460ea8...c0ee4c5cac528310ad2807bed7f3e10d63fc87ba,1,14,4,18,7,2009-03-29 23:05:51,2009-03-29 23:05:51
c0ee4c5cac528310ad2807bed7f3e10d63fc87ba...da3b38cdda036425d0aae1051d4bb60af671694e,7,35,5,40,16,2009-03-29 23:15:58,2009-03-29 23:15:58
da3b38cdda036425d0aae1051d4bb60af671694e...4a9b1f7a36af624ec0e400eaba5a800b64ae8f4e,1,7,5,12,3,2009-03-29 23:33:01,2009-03-29 23:33:01
4a9b1f7a36af624ec0e400eaba5a800b64ae8f4e...39ff4c9e4e8d6b1759b9d6a7199111de007ef355,0,0,0,0,0,2009-03-29 23:35:09,2009-03-29 23:35:09
39ff4c9e4e8d6b1759b9d6a7199111de007ef355...9b00b87cf2b8a02fdb2595cd0e9bd37d1f7ab32e,1,17,18,35,3,2009-03-30 03:03:37,2009-03-30 03:03:37
9b00b87cf2b8a02fdb2595cd0e9bd37d1f7ab32e...d02ee6bd7b2e47e735bbb951606ec4d66bf9d243,1,0,3,3,1,2009-03-30 03:11:12,2009-03-30 03:11:12
d02ee6bd7b2e47e735bbb951606ec4d66bf9d243...1e082c3873df9d59fa30ed9bd68cd1188fbff854,1,2,12,14,1,2009-03-30 03:32:40,2009-03-30 03:32:40
1e082c3873df9d59fa30ed9bd68cd1188fbff854...9face54bb7e8e906a5097b0f1215f59f91181f28,4,203,73,276,42,2009-03-30 15:58:52,2009-03-30 15:58:52
9face54bb7e8e906a5097b0f1215f59f91181f28...a6d7b418dec429bd6d4830ce65ad2b40df6a25e6,1,2,1,3,1,2009-03-30 16:05:57,2009-03-30 16:05:57
a6d7b418dec429bd6d4830ce65ad2b40df6a25e6...432f7f624ac4b6b5fab9a10ae450e71d1f8ecf64,2,31,5,36,5,2009-03-30 16:46:27,2009-03-30 16:46:27
432f7f624ac4b6b5fab9a10ae450e71d1f8ecf64...a61c0b7949f90fa43cac9ee5b35a8dc825dd49ea,1,15,14,29,4,2009-03-30 17:07:43,2009-03-30 17:07:43
a61c0b7949f90fa43cac9ee5b35a8dc825dd49ea...867e71501c3273ba4a0b3ac13847cd895f0da663,47,594,409,1003,228,2009-03-30 17:15:49,2009-03-30 17:15:49
867e71501c3273ba4a0b3ac13847cd895f0da663...8ed6b2b1d137cc7c9f2a4eed0711ca61a49b1a2e,1,15,11,26,6,2009-03-30 18:30:44,2009-03-30 18:30:44
8ed6b2b1d137cc7c9f2a4eed0711ca61a49b1a2e...1e214534e7c62dd14aaaae0c15d978af5c42a051,1,1,1,2,1,2009-03-30 18:40:59,2009-03-30 18:40:59
1e214534e7c62dd14aaaae0c15d978af5c42a051...27314a8934368dfb1ca73bf73f4d99eff791bcdf,1,3,3,6,2,2009-03-30 19:00:33,2009-03-30 19:00:33
27314a8934368dfb1ca73bf73f4d99eff791bcdf...78cbc3acfa6d8ccbb8414ac04e477922822c8e50,1,9,2,11,2,2009-03-30 19:31:50,2009-03-30 19:31:50
78cbc3acfa6d8ccbb8414ac04e477922822c8e50...08056572e89a9ac1c958ef7d47efe576c76116da,2,46,5,51,5,2009-03-30 19:36:19,2009-03-30 19:36:19
08056572e89a9ac1c958ef7d47efe576c76116da...ef933f164350d8dffa422eeb9014ab60d3025f03,1,18,15,33,5,2009-03-30 19:54:27,2009-03-30 19:54:27
ef933f164350d8dffa422eeb9014ab60d3025f03...9ac3905f013da7d9df997698c6d09c327b0f4dae,1,1,1,2,2,2009-03-30 20:15:01,2009-03-30 20:15:01
9ac3905f013da7d9df997698c6d09c327b0f4dae...86c5142461a9467ff5f1b186c6841866055b7bd9,2,10,2,12,4,2009-03-30 20:30:28,2009-03-30 20:30:28
86c5142461a9467ff5f1b186c6841866055b7bd9...1f8c4ce60940deaf124eedc112fd9b5c1b317a4e,1,1,3,4,2,2009-03-30 20:59:33,2009-03-30 20:59:33
1f8c4ce60940deaf124eedc112fd9b5c1b317a4e...3e7f5131a57f1606afb59ea4d86cac7a6005b969,2,15,3,18,6,2009-03-30 21:32:34,2009-03-30 21:32:34
3e7f5131a57f1606afb59ea4d86cac7a6005b969...3989a7ae1116aa7a4d961269aa2ae6a686308ef1,2,14,0,14,4,2009-03-30 22:00:07,2009-03-30 22:00:07
3989a7ae1116aa7a4d961269aa2ae6a686308ef1...5ff1703f41b219af92c2eb604609fc0ee03416c4,1,6,6,12,5,2009-03-30 22:10:36,2009-03-30 22:10:36
5ff1703f41b219af92c2eb604609fc0ee03416c4...8eca2df3a4db70ed7d721312d789a92274aee397,7,433,6,439,12,2009-03-30 22:15:41,2009-03-30 22:15:41
8eca2df3a4db70ed7d721312d789a92274aee397...657eefbf2551bc322c5d5cd8ea64ebe245964aed,1,7,4,11,3,2009-03-30 22:37:59,2009-03-30 22:37:59
657eefbf2551bc322c5d5cd8ea64ebe245964aed...02e56530c561e624bd2bee94a5d2ac0fabdfaa54,2,4,2,6,2,2009-03-30 22:38:19,2009-03-30 22:38:19
02e56530c561e624bd2bee94a5d2ac0fabdfaa54...c8ad87c2dcae02dee537dd51b4661c6411163453,1,2,2,4,2,2009-03-30 22:39:13,2009-03-30 22:39:13
c8ad87c2dcae02dee537dd51b4661c6411163453...6ce25d3be9804ca199b65110d10240559293a917,4,20,0,20,6,2009-03-30 22:41:49,2009-03-30 22:41:49
6ce25d3be9804ca199b65110d10240559293a917...fea6c73538148a7362a9cdd85bbc4732ddb4204d,5,28,2,30,8,2009-03-30 22:52:16,2009-03-30 22:52:16
fea6c73538148a7362a9cdd85bbc4732ddb4204d...13ea4a913386d8374b6df82c49d4c3c895b926ba,3,12,3,15,4,2009-03-30 22:52:48,2009-03-30 22:52:48
13ea4a913386d8374b6df82c49d4c3c895b926ba...a1e7723c790258c994517eee9dd373d49506d8e9,1,32,10,42,8,2009-03-30 22:54:24,2009-03-30 22:54:24
a1e7723c790258c994517eee9dd373d49506d8e9...843a9541eccbf2269a0b5de1e9888ae956bc953e,1,1,0,1,1,2009-03-30 22:54:40,2009-03-30 22:54:40
843a9541eccbf2269a0b5de1e9888ae956bc953e...5c321780c27b35a67c759f5062383786f98332fa,2,7,0,7,3,2009-03-30 23:00:36,2009-03-30 23:00:36
5c321780c27b35a67c759f5062383786f98332fa...4e035a03b653889dac1bc20b0bb67890f2969ec7,1,1,0,1,1,2009-03-30 23:00:55,2009-03-30 23:00:55
4e035a03b653889dac1bc20b0bb67890f2969ec7...4378af21b6e363e0499165c7440f34923c73194f,3,26,3,29,6,2009-03-30 23:16:34,2009-03-30 23:16:34
4378af21b6e363e0499165c7440f34923c73194f...5c9d54344c61e72894054661d14bcc09f65b6786,1,0,3,3,1,2009-03-30 23:30:33,2009-03-30 23:30:33
5c9d54344c61e72894054661d14bcc09f65b6786...62353e8fe74b37d60841696846f985e45e8b03bf,3,37,1,38,4,2009-03-31 00:03:34,2009-03-31 00:03:34
62353e8fe74b37d60841696846f985e45e8b03bf...9ae873fcd83221a17d41f31f2ac32e37f439ae7b,3,21,2,23,4,2009-03-31 05:14:13,2009-03-31 05:14:13
9ae873fcd83221a17d41f31f2ac32e37f439ae7b...184ea1c91f06d31d0e1d34b2c27c08b01d2d5033,3,41,9,50,10,2009-03-31 06:30:07,2009-03-31 06:30:07
184ea1c91f06d31d0e1d34b2c27c08b01d2d5033...7372ea159aa192757cc5383e6857c29ca2fc53c6,11,41,44,85,26,2009-03-31 07:01:01,2009-03-31 07:01:01
7372ea159aa192757cc5383e6857c29ca2fc53c6...7805afffd704f7d21e21a4186ad98a1a30f7cc71,1,2,1,3,3,2009-03-31 07:23:50,2009-03-31 07:23:50
7805afffd704f7d21e21a4186ad98a1a30f7cc71...a018eb45aca3c8f9f157625e68938d5ab7a68a32,2,75,61,136,60,2009-03-31 07:54:48,2009-03-31 07:54:48
a018eb45aca3c8f9f157625e68938d5ab7a68a32...78b5c65844a53a72bda6efad5aac33dbf90a929c,1,1,1,2,1,2009-03-31 13:04:28,2009-03-31 13:04:28
78b5c65844a53a72bda6efad5aac33dbf90a929c...4a73b603d04baf31ada2809746947b21f9da0138,1,1,1,2,1,2009-03-31 15:33:57,2009-03-31 15:33:57
4a73b603d04baf31ada2809746947b21f9da0138...1eccb1c6aa573dad7c1849fceea8ef966ab53db4,1,1,1,2,1,2009-03-31 15:39:32,2009-03-31 15:39:32
1eccb1c6aa573dad7c1849fceea8ef966ab53db4...f2df3650d6d576c4e8186378b101da99b2f49fb7,1,2,2,4,2,2009-03-31 15:42:13,2009-03-31 15:42:13
f2df3650d6d576c4e8186378b101da99b2f49fb7...3a0950739bc0947c2ae336b54905361a73f2871d,1,1,0,1,1,2009-03-31 15:49:25,2009-03-31 15:49:25
3a0950739bc0947c2ae336b54905361a73f2871d...b4f5655c8616664216dd5c495c33edc10a147655,10,17,19,36,14,2009-03-31 16:07:07,2009-03-31 16:07:07
b4f5655c8616664216dd5c495c33edc10a147655...c823e9d7ccba303fb37ce232eb1db901ef580a2a,2,25,3,28,6,2009-03-31 16:24:12,2009-03-31 16:24:12
c823e9d7ccba303fb37ce232eb1db901ef580a2a...d8bffb39697e08e2eda79bbf4de2cd02b42acfa4,1,14,0,14,2,2009-03-31 16:34:24,2009-03-31 16:34:24
d8bffb39697e08e2eda79bbf4de2cd02b42acfa4...c89090eccb30b0aa58c31c3cd3ccd453977068f4,1,3,3,6,3,2009-03-31 16:40:25,2009-03-31 16:40:25
c89090eccb30b0aa58c31c3cd3ccd453977068f4...e87e7436e21386c4ab27301442d4318e0bf52f1a,1,1,1,2,1,2009-03-31 16:45:41,2009-03-31 16:45:41
e87e7436e21386c4ab27301442d4318e0bf52f1a...86d772bb2ae3b8e75a47d1f9e89ef0a5320a6bfc,1,1,1,2,1,2009-03-31 16:49:54,2009-03-31 16:49:54
86d772bb2ae3b8e75a47d1f9e89ef0a5320a6bfc...7af2b2dcea3aad129a25d19978345264698c256d,1,1,1,2,1,2009-03-31 16:57:46,2009-03-31 16:57:46
7af2b2dcea3aad129a25d19978345264698c256d...33e87318c046ea73ed380b135eb1bbb471d301f3,1,1,1,2,1,2009-03-31 17:00:59,2009-03-31 17:00:59
33e87318c046ea73ed380b135eb1bbb471d301f3...cc5477df890f66854275c2b3ce46e8457fe8a6b2,5,58,0,58,7,2009-03-31 17:10:06,2009-03-31 17:10:06
cc5477df890f66854275c2b3ce46e8457fe8a6b2...aea0bb68e05e57beb1690b39b4ce5da424f50a4c,1,2,2,4,2,2009-03-31 17:10:23,2009-03-31 17:10:23
aea0bb68e05e57beb1690b39b4ce5da424f50a4c...131de1cf2b91dd5743d8994b3b0efea3639de7db,1,14,1,15,1,2009-03-31 17:14:10,2009-03-31 17:14:10
131de1cf2b91dd5743d8994b3b0efea3639de7db...449a83ba2e6c3ae4df999501cc0daf0eeec51f84,1,0,3,3,1,2009-03-31 17:19:03,2009-03-31 17:19:03
449a83ba2e6c3ae4df999501cc0daf0eeec51f84...83c6f8d4e2ac59fdfe37296e5c7494d19beba914,1,3,3,6,1,2009-03-31 18:14:12,2009-03-31 18:14:12
83c6f8d4e2ac59fdfe37296e5c7494d19beba914...a68c4a85ce4f80634aaaba37553db48ba3d3d8fd,2,20,9,29,9,2009-03-31 18:17:21,2009-03-31 18:17:21
a68c4a85ce4f80634aaaba37553db48ba3d3d8fd...58298fae71f59e3c2b3be40feda57f2b19690045,3,73,11,84,6,2009-03-31 19:34:25,2009-03-31 19:34:25
58298fae71f59e3c2b3be40feda57f2b19690045...98f5f68463adae5be03f77b594626385221e3ed9,1,112,26,138,7,2009-03-31 19:43:32,2009-03-31 19:43:32
98f5f68463adae5be03f77b594626385221e3ed9...15becf23a9e4c9b230745738d2d42f6ab8f0f031,6,191,15,206,7,2009-03-31 19:55:20,2009-03-31 19:55:20
15becf23a9e4c9b230745738d2d42f6ab8f0f031...516051bfd2b537f441c46359cce7eacbf15fc4b8,24,206,48,254,43,2009-03-31 23:34:03,2009-03-31 23:34:03
516051bfd2b537f441c46359cce7eacbf15fc4b8...4a44498dcfc9f817c0e0d1039af207e0de5b149c,1,4,4,8,1,2009-03-31 23:46:37,2009-03-31 23:46:37
4a44498dcfc9f817c0e0d1039af207e0de5b149c...efd7141d70c011dd9d49c7ae5fdaa57100a6dbed,1,1,1,2,1,2009-04-01 01:29:30,2009-04-01 01:29:30
efd7141d70c011dd9d49c7ae5fdaa57100a6dbed...1f74e3382fe8704270c4dcba49f2c25a433bfcc8,2,55,40,95,11,2009-04-01 01:36:44,2009-04-01 01:36:44
1f74e3382fe8704270c4dcba49f2c25a433bfcc8...f83af07ce39573786919b1e7980f3f4e07528531,3,36,3,39,6,2009-04-01 03:11:58,2009-04-01 03:11:58
f83af07ce39573786919b1e7980f3f4e07528531...a274ad9277d0d5c92da71d82f23e78c72d2013df,1,1,1,2,1,2009-04-01 14:13:28,2009-04-01 14:13:28
a274ad9277d0d5c92da71d82f23e78c72d2013df...da0c6908e8b55af37862eb643365ac6fb83e948b,7,97,1,98,5,2009-04-01 14:13:43,2009-04-01 14:13:43
da0c6908e8b55af37862eb643365ac6fb83e948b...a2dec37c413cc1b9fd205047e15602e4bc41de1f,2,3,1,4,2,2009-04-01 14:13:59,2009-04-01 14:13:59
a2dec37c413cc1b9fd205047e15602e4bc41de1f...ee17cabba0e1f2cbb85b2044eda43108e3f4371c,6,64,4,68,8,2009-04-01 14:14:20,2009-04-01 14:14:20
ee17cabba0e1f2cbb85b2044eda43108e3f4371c...6474092e9a55af5e5096bf934e17fe6371181cf0,1,6,1,7,1,2009-04-01 14:45:39,2009-04-01 14:45:39
6474092e9a55af5e5096bf934e17fe6371181cf0...02652f359dc7463535989a1933e1e7debd16b4df,1,1,1,2,1,2009-04-01 15:28:48,2009-04-01 15:28:48
02652f359dc7463535989a1933e1e7debd16b4df...f1c64816bbee4b8fc7477b8407c6999960776291,1,3,2,5,3,2009-04-01 15:32:00,2009-04-01 15:32:00
f1c64816bbee4b8fc7477b8407c6999960776291...03de1fe5f4269f9b8ad9f61ce7810e8a73d95b4f,5,98,35,133,25,2009-04-01 16:01:50,2009-04-01 16:01:50
03de1fe5f4269f9b8ad9f61ce7810e8a73d95b4f...c398566aa2509b4c40f60c93c0ccbb67522a824a,3,17,0,17,3,2009-04-01 16:06:22,2009-04-01 16:06:22
c398566aa2509b4c40f60c93c0ccbb67522a824a...e6ad4fb901c4d3bbaff1ad01bb8cc93852c20e1e,2,43,1,44,4,2009-04-01 16:17:38,2009-04-01 16:17:38
e6ad4fb901c4d3bbaff1ad01bb8cc93852c20e1e...19b9211a3b5424e7908a288c5008bf972cc472f4,3,26,1,27,6,2009-04-01 16:37:48,2009-04-01 16:37:48
19b9211a3b5424e7908a288c5008bf972cc472f4...35a1f22bc2f7d9fcf836a7295433c6565f5949ec,1,1,1,2,1,2009-04-01 16:43:01,2009-04-01 16:43:01
35a1f22bc2f7d9fcf836a7295433c6565f5949ec...3e6f4674e2fc190c2116d77066d18f42bd3bcbae,4,69,5,74,8,2009-04-01 17:02:32,2009-04-01 17:02:32
3e6f4674e2fc190c2116d77066d18f42bd3bcbae...644e98136ad0e1d3c79b465a045440c2f77be660,1,5,2,7,1,2009-04-01 17:05:19,2009-04-01 17:05:19
644e98136ad0e1d3c79b465a045440c2f77be660...16c9df0a761732b8e3acbfa39b940ffde0b1dbf3,2,47,5,52,7,2009-04-01 18:19:32,2009-04-01 18:19:32
16c9df0a761732b8e3acbfa39b940ffde0b1dbf3...226ab592e2ef50c96cb1005eb7338552feef4735,1,1,1,2,1,2009-04-01 18:34:31,2009-04-01 18:34:31
226ab592e2ef50c96cb1005eb7338552feef4735...f03f9568aa9eb79baac6f782f9ebc69e4a6001d4,1,1,1,2,1,2009-04-01 18:44:25,2009-04-01 18:44:25
f03f9568aa9eb79baac6f782f9ebc69e4a6001d4...2a994716a1103be3a8da07a0a625cae7a1b38a13,2,9,1,10,2,2009-04-01 21:25:24,2009-04-01 21:25:24
2a994716a1103be3a8da07a0a625cae7a1b38a13...a50c6f1f24afc45124a1d4433794bfacd645851d,1,1,1,2,1,2009-04-01 21:33:22,2009-04-01 21:33:22
a50c6f1f24afc45124a1d4433794bfacd645851d...c860758a574432a2eaef72d609535d40455cbfa2,1,3,1,4,3,2009-04-01 21:37:34,2009-04-01 21:37:34
c860758a574432a2eaef72d609535d40455cbfa2...c4f7bf8312a520ecd4bfcfb3f4868e5de9ab11ae,1,2,1,3,2,2009-04-01 21:46:42,2009-04-01 21:46:42
c4f7bf8312a520ecd4bfcfb3f4868e5de9ab11ae...b2645a15fdd2143d141072b9a1d2d5ffa27d70d1,1,1,2,3,2,2009-04-01 21:58:38,2009-04-01 21:58:38
b2645a15fdd2143d141072b9a1d2d5ffa27d70d1...dc832d7753a0c65db5eca5ce0b2d046bd0d299e8,2,4,4,8,3,2009-04-01 22:16:34,2009-04-01 22:16:34
dc832d7753a0c65db5eca5ce0b2d046bd0d299e8...624caace17dbb9e22f5a4c6c08937d68cbdbb066,3,29,7,36,5,2009-04-01 22:46:46,2009-04-01 22:46:46
624caace17dbb9e22f5a4c6c08937d68cbdbb066...64e82fb648ebdd7c98fa5f1cffb1e21f1918cf4d,2,11,7,18,6,2009-04-01 23:41:36,2009-04-01 23:41:36
64e82fb648ebdd7c98fa5f1cffb1e21f1918cf4d...8f7aa84def3c13dd706aae1f5bfbcdb54b0696ee,3,60,39,99,4,2009-04-02 00:01:15,2009-04-02 00:01:15
8f7aa84def3c13dd706aae1f5bfbcdb54b0696ee...751234bfd9afa76bafa93e17b6ed8a5d99a3010f,1,7,0,7,5,2009-04-02 01:40:56,2009-04-02 01:40:56
751234bfd9afa76bafa93e17b6ed8a5d99a3010f...25130b9675e5a53926ad45d828460341679d49fe,2,18,3,21,4,2009-04-02 01:49:12,2009-04-02 01:49:12
25130b9675e5a53926ad45d828460341679d49fe...73c0556911858797e5345bda3a028a5f2658e7ea,1,1,1,2,1,2009-04-02 01:55:49,2009-04-02 01:55:49
73c0556911858797e5345bda3a028a5f2658e7ea...bb2aa792af71521c5572f8f63cc718863393dda7,1,0,2,2,1,2009-04-02 02:03:46,2009-04-02 02:03:46
bb2aa792af71521c5572f8f63cc718863393dda7...8cc506840e271cefc53a1bdd97559a7e7b8e504c,3,119,0,119,2,2009-04-02 04:32:48,2009-04-02 04:32:48
8cc506840e271cefc53a1bdd97559a7e7b8e504c...ef9bedf8153f921e3a4a6c131dd0334bfb8198e9,1,49,2,51,2,2009-04-02 05:02:39,2009-04-02 05:02:39
ef9bedf8153f921e3a4a6c131dd0334bfb8198e9...9828557731072ccc5734bed520d6efcde620dc1d,2,14,2,16,3,2009-04-02 05:20:25,2009-04-02 05:20:25
9828557731072ccc5734bed520d6efcde620dc1d...8d42902f1908c2fd5a894e082d3a8aead75d1c28,5,152,3,155,14,2009-04-02 16:50:44,2009-04-02 16:50:44
8d42902f1908c2fd5a894e082d3a8aead75d1c28...d2a8bc5b40bdceb57d2e23e75ea81ba495e6bbb5,2,14,1,15,2,2009-04-03 06:59:34,2009-04-03 06:59:34
d2a8bc5b40bdceb57d2e23e75ea81ba495e6bbb5...c6c25adf6d9f71ea11f61392f6f3d221f01e5216,50,551,262,813,116,2009-04-03 18:30:54,2009-04-03 18:30:54
c6c25adf6d9f71ea11f61392f6f3d221f01e5216...595c092a293396eab80c6da8654f6705a28c7431,4,44,3,47,5,2009-04-03 19:52:14,2009-04-03 19:52:14
595c092a293396eab80c6da8654f6705a28c7431...ffe8994014b891cb50d3ac6a27d8853698dec9c8,2,7,0,7,3,2009-04-03 20:03:46,2009-04-03 20:03:46
ffe8994014b891cb50d3ac6a27d8853698dec9c8...374b02e37439340fa9ae075b4ca32cfb13ce593c,1,4,1,5,2,2009-04-03 20:28:23,2009-04-03 20:28:23
374b02e37439340fa9ae075b4ca32cfb13ce593c...ffffdedfd16ec9e8471368afab15782adddf3452,2,23,13,36,9,2009-04-03 20:52:54,2009-04-03 20:52:54
ffffdedfd16ec9e8471368afab15782adddf3452...19d14509299c641ee44ab0755a6e0f3026e48341,1,1,1,2,1,2009-04-04 03:20:39,2009-04-04 03:20:39
19d14509299c641ee44ab0755a6e0f3026e48341...dded5f52cc1dbe0e58b64a3217e12e72da7bed23,5,64,46,110,21,2009-04-04 03:21:31,2009-04-04 03:21:31
dded5f52cc1dbe0e58b64a3217e12e72da7bed23...0a89a57ffc491f2d1ff9a19e792739f67a945be3,2,46,23,69,7,2009-04-04 05:34:23,2009-04-04 05:34:23
0a89a57ffc491f2d1ff9a19e792739f67a945be3...2b1934ff3c3f80f58cc35bdcc03ae1b0ea6eb17e,2,7,3,10,5,2009-04-04 05:35:01,2009-04-04 05:35:01
2b1934ff3c3f80f58cc35bdcc03ae1b0ea6eb17e...ff166a3cdce99e93c97a19781b17d60e67d70f99,3,21,6,27,8,2009-04-04 06:54:56,2009-04-04 06:54:56
ff166a3cdce99e93c97a19781b17d60e67d70f99...668bc4f7bef79c7177bfa5b7dabd1403e0d6fa30,4,51,14,65,12,2009-04-04 17:34:58,2009-04-04 17:34:58
668bc4f7bef79c7177bfa5b7dabd1403e0d6fa30...bb31cf37ff2bcb8432753f27c40998467d42585c,2,2,2,4,2,2009-04-04 17:51:35,2009-04-04 17:51:35
bb31cf37ff2bcb8432753f27c40998467d42585c...48e01d2b3db28be153feae7f3cecb09941a4e41b,2,56,51,107,23,2009-04-04 19:03:55,2009-04-04 19:03:55
48e01d2b3db28be153feae7f3cecb09941a4e41b...63143d5d9d4f0f4dc6a4948fca24d904e72f3d35,1,9,9,18,6,2009-04-04 19:34:52,2009-04-04 19:34:52
63143d5d9d4f0f4dc6a4948fca24d904e72f3d35...df7ffe616ad0f0bdd29aecca97462f567ee75fd8,1,9,10,19,3,2009-04-05 04:41:39,2009-04-05 04:41:39
df7ffe616ad0f0bdd29aecca97462f567ee75fd8...20b598bf3e430ac969f06c290ab69555b9604922,2,15,3,18,3,2009-04-05 17:20:38,2009-04-05 17:20:38
20b598bf3e430ac969f06c290ab69555b9604922...8da2322cad6a27647cbe2fce674d3742bb6bf88f,3,24,5,29,8,2009-04-05 17:27:26,2009-04-05 17:27:26
8da2322cad6a27647cbe2fce674d3742bb6bf88f...dd966f081a36cc3ee87f703bf81e821f3500fbb1,1,16,9,25,2,2009-04-05 17:54:02,2009-04-05 17:54:02
dd966f081a36cc3ee87f703bf81e821f3500fbb1...6d5492630d22c839142a38846aa8b7e2340427cb,1,1,1,2,1,2009-04-05 19:00:27,2009-04-05 19:00:27
6d5492630d22c839142a38846aa8b7e2340427cb...d0c897d6605a95c3e7826ee7f01ef20979977ebb,5,30,12,42,22,2009-04-05 20:59:20,2009-04-05 20:59:20
d0c897d6605a95c3e7826ee7f01ef20979977ebb...bb15cee58a43eeb0d060f8a31f9078b3406f195a,9,367,131,498,46,2009-04-06 20:23:33,2009-04-06 20:23:33
bb15cee58a43eeb0d060f8a31f9078b3406f195a...07465b635d4c3df50181bbb85bc2c3c6811822b2,1,2,2,4,2,2009-04-06 20:28:55,2009-04-06 20:28:55
07465b635d4c3df50181bbb85bc2c3c6811822b2...8415c057fb65cd3fb53bf3c1d38c00d0ab458cad,1,1,1,2,1,2009-04-06 21:11:10,2009-04-06 21:11:10
8415c057fb65cd3fb53bf3c1d38c00d0ab458cad...bb182bea1ce52613fde9b1864e0ba7b639fc1dc6,1,0,1,1,1,2009-04-06 23:39:26,2009-04-06 23:39:26
bb182bea1ce52613fde9b1864e0ba7b639fc1dc6...7f7606070bd97444cee1c130022b4b7929d3c875,1,1,1,2,1,2009-04-06 23:45:56,2009-04-06 23:45:56
7f7606070bd97444cee1c130022b4b7929d3c875...37c21ef05d678d09a1143c3699c2165d0b8fa300,2,7,6,13,5,2009-04-07 00:01:49,2009-04-07 00:01:49
37c21ef05d678d09a1143c3699c2165d0b8fa300...366710e6368fbb7530ccfae92a2b6faa40ea4bc1,5,36,2,38,9,2009-04-07 12:06:05,2009-04-07 12:06:05
366710e6368fbb7530ccfae92a2b6faa40ea4bc1...f8adf99cdb449924b2ed2ddac33744da7eeb1efc,4,11,0,11,4,2009-04-07 19:28:13,2009-04-07 19:28:13
f8adf99cdb449924b2ed2ddac33744da7eeb1efc...92a38be9c694639cad13ffdb03f492e462932db0,2,2,2,4,4,2009-04-07 19:34:21,2009-04-07 19:34:21
92a38be9c694639cad13ffdb03f492e462932db0...eef2c5f6dea6ad06f064d46292d2f21ebebaf839,1,1,1,2,1,2009-04-07 19:40:59,2009-04-07 19:40:59
eef2c5f6dea6ad06f064d46292d2f21ebebaf839...6319470f88d464204c0f62622cc3f8ff081bce0f,2,15,1,16,2,2009-04-07 19:49:07,2009-04-07 19:49:07
6319470f88d464204c0f62622cc3f8ff081bce0f...f2bdc14a95b76adca3bc35df6b83afecf0ab7ec0,2,14,7,21,8,2009-04-07 19:57:01,2009-04-07 19:57:01
f2bdc14a95b76adca3bc35df6b83afecf0ab7ec0...2ec48a1dd973afdc606630ea3e9369325bbe469c,4,31,7,38,8,2009-04-07 20:12:08,2009-04-07 20:12:08
2ec48a1dd973afdc606630ea3e9369325bbe469c...752cc49a62f5e469abaef7eacbeeb1be3ae6400a,3,3,3,6,3,2009-04-07 20:22:36,2009-04-07 20:22:36
752cc49a62f5e469abaef7eacbeeb1be3ae6400a...710dfea9132ec3ede3c7607d7f388618ed7f8bcb,1,2,1,3,2,2009-04-07 20:29:33,2009-04-07 20:29:33
710dfea9132ec3ede3c7607d7f388618ed7f8bcb...a6356cad4d23340c66af8bea569049c958b99b44,2,35,13,48,12,2009-04-07 21:18:41,2009-04-07 21:18:41
a6356cad4d23340c66af8bea569049c958b99b44...2c3c1f3ec4d87d35a8c466471b64cb39f1b097e7,4,52,8,60,8,2009-04-07 21:20:14,2009-04-07 21:20:14
2c3c1f3ec4d87d35a8c466471b64cb39f1b097e7...4f7950ac05bbb602d2cade142fafb5311c24fe9a,1,0,3,3,2,2009-04-07 21:55:39,2009-04-07 21:55:39
4f7950ac05bbb602d2cade142fafb5311c24fe9a...6d6bbb6d0571d32b10978dc36a905c8d48c3ce1c,2,13,1,14,4,2009-04-07 22:02:34,2009-04-07 22:02:34
6d6bbb6d0571d32b10978dc36a905c8d48c3ce1c...bbe37492dcc8abbbb023307e6433b9b3f03a31f1,1,22,13,35,5,2009-04-07 22:12:53,2009-04-07 22:12:53
bbe37492dcc8abbbb023307e6433b9b3f03a31f1...1dc72fe8765c1d39e42f0cca997075a489e3395c,1,3,2,5,1,2009-04-08 00:09:06,2009-04-08 00:09:06
1dc72fe8765c1d39e42f0cca997075a489e3395c...aa9a40b0d8442170cfa3a915c84d6ca687bb93d5,2,119,88,207,70,2009-04-08 08:53:31,2009-04-08 08:53:31
aa9a40b0d8442170cfa3a915c84d6ca687bb93d5...98ef7e85bdaad4b21c31b425a62b2c8bc294be48,3,53,13,66,10,2009-04-08 13:19:48,2009-04-08 13:19:48
98ef7e85bdaad4b21c31b425a62b2c8bc294be48...a64a61bf4a21f942828add0b7964f18cf777a5bb,2,21,1,22,6,2009-04-08 18:53:55,2009-04-08 18:53:55
a64a61bf4a21f942828add0b7964f18cf777a5bb...28f6b7162352a19b6f3931f46f3d26713c2712b4,1,3,1,4,1,2009-04-08 19:41:18,2009-04-08 19:41:18
28f6b7162352a19b6f3931f46f3d26713c2712b4...7d1b4295b9779788b4cbd4b7bb99240807c62aa3,2,15,10,25,3,2009-04-08 19:47:46,2009-04-08 19:47:46
7d1b4295b9779788b4cbd4b7bb99240807c62aa3...6eaf154a2e81d21d02f3597dd0e3dad01db8d07c,1,5,1,6,1,2009-04-08 19:57:27,2009-04-08 19:57:27
6eaf154a2e81d21d02f3597dd0e3dad01db8d07c...f55f2b9d74bf59d1b3ace5df5f498998eb62cb28,3,13,6,19,7,2009-04-08 20:25:56,2009-04-08 20:25:56
f55f2b9d74bf59d1b3ace5df5f498998eb62cb28...c0ad626dca67fe2e0c1dce3c5db524cfa77a9884,4,55,6,61,4,2009-04-09 15:03:31,2009-04-09 15:03:31
c0ad626dca67fe2e0c1dce3c5db524cfa77a9884...de9185094491bc4864a8864126d175035df5d6f0,3,6,2,8,5,2009-04-09 15:09:35,2009-04-09 15:09:35
de9185094491bc4864a8864126d175035df5d6f0...641c5fd3b50fa2b064c67243c41fda817513681c,4,27,4,31,8,2009-04-09 15:23:56,2009-04-09 15:23:56
641c5fd3b50fa2b064c67243c41fda817513681c...e5be4b4f3deae24f8e189dfa46dc15397441d562,1,1,0,1,1,2009-04-09 15:26:15,2009-04-09 15:26:15
e5be4b4f3deae24f8e189dfa46dc15397441d562...f6309cbf8058b77729f9ba96c26accdbb7ae5596,2,27,24,51,11,2009-04-10 01:03:44,2009-04-10 01:03:44
f6309cbf8058b77729f9ba96c26accdbb7ae5596...be4a83c4483501102afbfd786100e46ed06cc05c,6,24,4,28,7,2009-04-10 04:13:27,2009-04-10 04:13:27
be4a83c4483501102afbfd786100e46ed06cc05c...b96479052b0e145a4213076f1df6a4d676552521,4,194,152,346,127,2009-04-10 06:34:02,2009-04-10 06:34:02
b96479052b0e145a4213076f1df6a4d676552521...0884aa9b81f14cac84b4b083267c1aa693bce867,2,1,1,2,1,2009-04-10 07:26:21,2009-04-10 07:26:21
0884aa9b81f14cac84b4b083267c1aa693bce867...8cf6d2aa51534e43348b849fee9e2df24ed3290e,4,1682,1653,3335,858,2009-04-10 08:30:27,2009-04-10 08:30:27
8cf6d2aa51534e43348b849fee9e2df24ed3290e...ab28d44f50885b07ca185f003c7decc9fd797090,2,530,534,1064,527,2009-04-10 08:34:08,2009-04-10 08:34:08
ab28d44f50885b07ca185f003c7decc9fd797090...42d99b5a09e1765d423328a1b4011ddcd5ac89fb,4,383,270,653,224,2009-04-10 08:38:59,2009-04-10 08:38:59
42d99b5a09e1765d423328a1b4011ddcd5ac89fb...2e02b79cd1b750b79a4ce433d51ca1d4ac955a63,2,543,252,795,220,2009-04-10 08:48:35,2009-04-10 08:48:35
2e02b79cd1b750b79a4ce433d51ca1d4ac955a63...1b8d2175eedb6efadec3a43c7ff22736e62d264a,2,33,33,66,31,2009-04-10 09:48:28,2009-04-10 09:48:28
1b8d2175eedb6efadec3a43c7ff22736e62d264a...ec8eeb732c6990548fb6d046594a9601377c151d,3,548,237,785,220,2009-04-10 11:20:16,2009-04-10 11:20:16
ec8eeb732c6990548fb6d046594a9601377c151d...766ececa5e63bb8c3836ddf252b6dbca4b536d72,2,446,298,744,271,2009-04-10 11:28:01,2009-04-10 11:28:01
766ececa5e63bb8c3836ddf252b6dbca4b536d72...49b2fc0c2bb89b07db106b8ea575387158615bdb,2,346,201,547,179,2009-04-10 11:35:18,2009-04-10 11:35:18
49b2fc0c2bb89b07db106b8ea575387158615bdb...9faa1cd9b59a2b035d6af79079c2f5eb7d43772c,1,21,29,50,5,2009-04-10 15:50:51,2009-04-10 15:50:51
9faa1cd9b59a2b035d6af79079c2f5eb7d43772c...ec4cf1970068a5642cd01f7e4ad5dea063e2e161,1,6,6,12,2,2009-04-10 16:33:52,2009-04-10 16:33:52
ec4cf1970068a5642cd01f7e4ad5dea063e2e161...800b6cfbbeca0bd1ae47bcac1f3503a8063161ae,1,24,1,25,2,2009-04-10 16:58:29,2009-04-10 16:58:29
800b6cfbbeca0bd1ae47bcac1f3503a8063161ae...bb75efc050a985ee1f389e85a2abd504c27c8035,1,1,1,2,1,2009-04-10 16:58:47,2009-04-10 16:58:47
bb75efc050a985ee1f389e85a2abd504c27c8035...fd443959df59be304a02a4de9ad93f89fab2cc4b,1,7,1,8,2,2009-04-10 17:04:35,2009-04-10 17:04:35
fd443959df59be304a02a4de9ad93f89fab2cc4b...95f5e4a8daceb351b8e12b52489d37f1408b140b,2,14,2,16,3,2009-04-10 17:07:25,2009-04-10 17:07:25
95f5e4a8daceb351b8e12b52489d37f1408b140b...da17a314ca50ef67f454857981c92c43c55b53a3,1,1,1,2,1,2009-04-10 17:09:09,2009-04-10 17:09:09
da17a314ca50ef67f454857981c92c43c55b53a3...ae7cb577ddbea48aaed26cbbf69c77078a99e221,4,50,101,151,9,2009-04-10 18:08:37,2009-04-10 18:08:37
ae7cb577ddbea48aaed26cbbf69c77078a99e221...5e58810e2197f13dc8372bfeae66e95b908f601d,9,267,121,388,85,2009-04-10 18:32:17,2009-04-10 18:32:17
5e58810e2197f13dc8372bfeae66e95b908f601d...9e9a2b88e8d2f76cc85fcdad9bd463bf77181418,1,1,1,2,1,2009-04-10 18:42:24,2009-04-10 18:42:24
9e9a2b88e8d2f76cc85fcdad9bd463bf77181418...b366bcc962d6390ecaa462d73fca9004c9e7f44c,2,14,0,14,2,2009-04-10 18:58:32,2009-04-10 18:58:32
b366bcc962d6390ecaa462d73fca9004c9e7f44c...f1461328319ee49b35cc208b492d99d779209c2f,1,3,11,14,3,2009-04-10 19:19:19,2009-04-10 19:19:19
f1461328319ee49b35cc208b492d99d779209c2f...3524c74f0bc4d88c8c0643c97ef51970b6aef220,2,103,134,237,10,2009-04-10 19:54:14,2009-04-10 19:54:14
3524c74f0bc4d88c8c0643c97ef51970b6aef220...a34b718192b4356a5ab39ac49d0e927d8a425a9c,2,21,2,23,4,2009-04-10 19:54:31,2009-04-10 19:54:31
a34b718192b4356a5ab39ac49d0e927d8a425a9c...e07a3a278ed27b95ed7ec53b97d991fad3b33aa6,1,1,0,1,1,2009-04-11 00:06:53,2009-04-11 00:06:53
e07a3a278ed27b95ed7ec53b97d991fad3b33aa6...604c5bc52a2de713166351d4ca73b0072bd8e232,1,18,4,22,5,2009-04-11 02:12:31,2009-04-11 02:12:31
604c5bc52a2de713166351d4ca73b0072bd8e232...1a45c6acd3daf9f8f00cad143067fc1a21eed1c9,2,894,766,1660,291,2009-04-11 06:17:57,2009-04-11 06:17:57
1a45c6acd3daf9f8f00cad143067fc1a21eed1c9...d2fc8ae0e3f1a17e1e0df129431b54a9dff99638,2,1,1,2,1,2009-04-11 06:27:08,2009-04-11 06:27:08
d2fc8ae0e3f1a17e1e0df129431b54a9dff99638...3bd384aa62608ca2aebdf6d86ae1a75abb96f4bf,5,27,5,32,6,2009-04-11 07:41:59,2009-04-11 07:41:59
3bd384aa62608ca2aebdf6d86ae1a75abb96f4bf...8fecf36b68230625fd4e96be9c946af73b7c33e5,1,3,3,6,3,2009-04-11 07:51:07,2009-04-11 07:51:07
8fecf36b68230625fd4e96be9c946af73b7c33e5...8dc73e8425f0672bb7e4734902879de53c6f7125,5,67,2,69,9,2009-04-11 09:20:10,2009-04-11 09:20:10
8dc73e8425f0672bb7e4734902879de53c6f7125...f4072f5be8477fdba485d9594c0c3ce2aca1d11b,1,11,9,20,1,2009-04-11 11:32:50,2009-04-11 11:32:50
f4072f5be8477fdba485d9594c0c3ce2aca1d11b...0d2cf7bdd6ee7b404f6e0f8eebfa9e8979ba7671,1,2,2,4,1,2009-04-11 11:33:10,2009-04-11 11:33:10
0d2cf7bdd6ee7b404f6e0f8eebfa9e8979ba7671...d18f75af447bc18b062564ab163943c16d79effc,4,36,11,47,14,2009-04-11 11:41:35,2009-04-11 11:41:35
d18f75af447bc18b062564ab163943c16d79effc...b1a5db37e6631ab4a964d7f8d52dfe593f9e6c4b,3,22,9,31,8,2009-04-11 12:03:52,2009-04-11 12:03:52
b1a5db37e6631ab4a964d7f8d52dfe593f9e6c4b...0fff47c90f01c33ffdd0e8ed8c4a623693b7d4dd,2,8,0,8,2,2009-04-11 12:09:34,2009-04-11 12:09:34
0fff47c90f01c33ffdd0e8ed8c4a623693b7d4dd...e12e0e18a4a666c22e119990a495c76079110934,2,21,0,21,4,2009-04-11 13:20:51,2009-04-11 13:20:51
e12e0e18a4a666c22e119990a495c76079110934...92824e71028d40009d32fc68d459b0c2242fb7fe,3,28,8,36,13,2009-04-11 13:22:32,2009-04-11 13:22:32
92824e71028d40009d32fc68d459b0c2242fb7fe...945b89e17797dc234f9d49874170b937b02e0315,1,11,0,11,1,2009-04-11 13:45:45,2009-04-11 13:45:45
945b89e17797dc234f9d49874170b937b02e0315...4a4d3e213316ea39a0f8d596c9c0d3dfba8ce495,1,11,3,14,2,2009-04-11 15:25:15,2009-04-11 15:25:15
4a4d3e213316ea39a0f8d596c9c0d3dfba8ce495...d7870d3444eed9525863b95549be479bdca1bc89,1,1,1,2,1,2009-04-11 22:31:28,2009-04-11 22:31:28
d7870d3444eed9525863b95549be479bdca1bc89...50dbda9a3eb83c9e2e79b7d56305a1f0700f8478,1,17,0,17,1,2009-04-12 00:13:03,2009-04-12 00:13:03
50dbda9a3eb83c9e2e79b7d56305a1f0700f8478...1aa0d1b4a696c51c97a4b2294488e51354350678,1,1,1,2,1,2009-04-12 02:00:36,2009-04-12 02:00:36
1aa0d1b4a696c51c97a4b2294488e51354350678...a584a6b40f8f685f5809eb77de2c7be0b150aeda,3,7,8,15,5,2009-04-12 02:00:58,2009-04-12 02:00:58
a584a6b40f8f685f5809eb77de2c7be0b150aeda...77066516a066d69b3c396db40f3855c06f1f1f3f,1,4,1,5,2,2009-04-12 02:15:14,2009-04-12 02:15:14
77066516a066d69b3c396db40f3855c06f1f1f3f...54800be3a14911d69c658845dfc6a0f100997d47,1,3,5,8,5,2009-04-12 02:23:19,2009-04-12 02:23:19
54800be3a14911d69c658845dfc6a0f100997d47...cc10f50c192ee8d789c443e6d58dc10babc753b3,2,586,264,850,239,2009-04-12 02:40:20,2009-04-12 02:40:20
cc10f50c192ee8d789c443e6d58dc10babc753b3...794f2d121e9fd51debfabc8bdc8d6833dc61d7a4,1,5,1,6,1,2009-04-12 02:50:41,2009-04-12 02:50:41
794f2d121e9fd51debfabc8bdc8d6833dc61d7a4...87e6939372790662752e227557415d3f4e180992,5,35,7,42,12,2009-04-12 03:50:47,2009-04-12 03:50:47
87e6939372790662752e227557415d3f4e180992...499a8ac3317aa67d3bd5f84fd668304b6adcdc30,1,2,3,5,2,2009-04-12 04:14:23,2009-04-12 04:14:23
499a8ac3317aa67d3bd5f84fd668304b6adcdc30...8931d8d68872f3b0742dafe02f4ab39d610c82e3,2,6,1,7,2,2009-04-12 04:55:41,2009-04-12 04:55:41
8931d8d68872f3b0742dafe02f4ab39d610c82e3...e9814029f570bd0866dc859147bca90340bcc913,2,25,10,35,15,2009-04-12 05:32:23,2009-04-12 05:32:23
e9814029f570bd0866dc859147bca90340bcc913...91fe5d50dd44fdf4db1b61b61308bdb27e465653,1,6,2,8,5,2009-04-12 05:55:29,2009-04-12 05:55:29
91fe5d50dd44fdf4db1b61b61308bdb27e465653...ffd7b177c9eea9cfe131bc20a98448345436d67e,1,17,3,20,5,2009-04-12 07:19:56,2009-04-12 07:19:56
ffd7b177c9eea9cfe131bc20a98448345436d67e...0fec0a5d704d487755209115719ca173913a43b7,2,22,2,24,3,2009-04-13 02:59:40,2009-04-13 02:59:40
0fec0a5d704d487755209115719ca173913a43b7...fd3ee7d7867dd13a336b90873ccb8df6302f2c05,3,27,3,30,6,2009-04-13 07:07:51,2009-04-13 07:07:51
fd3ee7d7867dd13a336b90873ccb8df6302f2c05...cb43898d49ac60bf84a2eb83b331072e7651af5e,4,95,9,104,11,2009-04-13 12:35:49,2009-04-13 12:35:49
cb43898d49ac60bf84a2eb83b331072e7651af5e...6cc0c3887ca1c43650f49d16916ac0d9862ce61f,2,34,7,41,11,2009-04-13 13:23:03,2009-04-13 13:23:03
6cc0c3887ca1c43650f49d16916ac0d9862ce61f...9a9c552f6f0103d0c6555f25683f18db63f256f8,4,596,289,885,250,2009-04-13 15:16:17,2009-04-13 15:16:17
9a9c552f6f0103d0c6555f25683f18db63f256f8...bd8afb18940b3e4f711b714dd20abf1053e31e70,2,16,3,19,4,2009-04-14 19:14:32,2009-04-14 19:14:32
bd8afb18940b3e4f711b714dd20abf1053e31e70...f0d75dbe3e7f3715130921214330f088134159cb,1,1,1,2,1,2009-04-16 12:44:32,2009-04-16 12:44:32
f0d75dbe3e7f3715130921214330f088134159cb...a47153c8c1da35968af023516ee0e1ad5a89e428,1,4,4,8,1,2009-04-16 12:45:04,2009-04-16 12:45:04
a47153c8c1da35968af023516ee0e1ad5a89e428...163bf995a5aaf2ca0e36ce769d26ce9ebccd4376,1,2,2,4,2,2009-04-16 12:45:35,2009-04-16 12:45:35
163bf995a5aaf2ca0e36ce769d26ce9ebccd4376...f3c3aa232c552937672af3cb12e5af4826a97a05,1,13,0,13,1,2009-04-16 12:46:15,2009-04-16 12:46:15
f3c3aa232c552937672af3cb12e5af4826a97a05...83623d45c754dff956a3bc90ee34e35bca8a1bce,2,46,64,110,35,2009-04-16 12:46:58,2009-04-16 12:46:58
83623d45c754dff956a3bc90ee34e35bca8a1bce...e6d2b14e359035f2e19089be629983162e7573e1,1,71,32,103,5,2009-04-16 12:47:34,2009-04-16 12:47:34
e6d2b14e359035f2e19089be629983162e7573e1...565c190611aecf16e36b8d6a77d4c2b75fbdb6de,1,14,11,25,10,2009-04-16 12:48:16,2009-04-16 12:48:16
565c190611aecf16e36b8d6a77d4c2b75fbdb6de...9103a9bd6cc2b40f9af5787687b0f359d0a36061,1,2,2,4,2,2009-04-16 12:48:46,2009-04-16 12:48:46
9103a9bd6cc2b40f9af5787687b0f359d0a36061...4eaf4155f809c320e4b24e0f437ed9e1d856f9ef,2,1,2,3,2,2009-04-16 14:16:16,2009-04-16 14:16:16
4eaf4155f809c320e4b24e0f437ed9e1d856f9ef...48b459a83e40aa6dae588f114d68f54b95e860de,2,28,7,35,7,2009-04-16 14:24:27,2009-04-16 14:24:27
48b459a83e40aa6dae588f114d68f54b95e860de...6590061a005b8772baee1a94d7799bcb58d9841d,2,23,1,24,3,2009-04-16 14:25:18,2009-04-16 14:25:18
6590061a005b8772baee1a94d7799bcb58d9841d...419ed444360cd9b843253f3901a96d41b003251e,2,22,2,24,3,2009-04-16 14:26:08,2009-04-16 14:26:08
419ed444360cd9b843253f3901a96d41b003251e...ff9b9e530c0cd4c62e279da0aed11ed426da59dc,3,9,1,10,9,2009-04-16 22:25:01,2009-04-16 22:25:01
ff9b9e530c0cd4c62e279da0aed11ed426da59dc...800311964e0325545552febde0e092f93a12208f,1,6,6,12,3,2009-04-16 22:32:48,2009-04-16 22:32:48
800311964e0325545552febde0e092f93a12208f...41260fb93165a9fa18dba31b4766c8be50b430cb,3,73,43,116,7,2009-04-18 15:51:11,2009-04-18 15:51:11
41260fb93165a9fa18dba31b4766c8be50b430cb...002e3fd9e46a3914f974dbfaf546c968f8d8f5d2,2,150,5,155,14,2009-04-18 17:35:53,2009-04-18 17:35:53
002e3fd9e46a3914f974dbfaf546c968f8d8f5d2...a075422bfc433d196b2fd1e64b8c8b9dbbf32591,4,109,3,112,7,2009-04-18 20:12:53,2009-04-18 20:12:53
a075422bfc433d196b2fd1e64b8c8b9dbbf32591...1e4ad6f118007547c7e627f1d5bd11bfb2992bf9,3,80,3,83,9,2009-04-18 20:29:55,2009-04-18 20:29:55
1e4ad6f118007547c7e627f1d5bd11bfb2992bf9...ccc8e104eef01752f078bedc99ca6b756e1f048c,4,30,4,34,8,2009-04-18 21:03:29,2009-04-18 21:03:29
ccc8e104eef01752f078bedc99ca6b756e1f048c...ab562bf954ca0514765b1f135b63e28e5f8f4434,1,1,1,2,1,2009-04-18 21:04:40,2009-04-18 21:04:40
ab562bf954ca0514765b1f135b63e28e5f8f4434...b429e36749560cc481b808300c35ce12c9271bf2,2,151,113,264,90,2009-04-19 02:19:21,2009-04-19 02:19:21
b429e36749560cc481b808300c35ce12c9271bf2...dfac29a2df02b4807f356b0ac1f9a540a18b356e,2,197,166,363,143,2009-04-19 02:27:17,2009-04-19 02:27:17
dfac29a2df02b4807f356b0ac1f9a540a18b356e...722ad5777392d7541c7fe1253dd28f99e7fca615,2,2,2,4,2,2009-04-19 02:30:42,2009-04-19 02:30:42
722ad5777392d7541c7fe1253dd28f99e7fca615...9a7cbcc6d1e08448b0964d7ceda7fc5bbe715653,2,581,261,842,231,2009-04-19 02:37:44,2009-04-19 02:37:44
9a7cbcc6d1e08448b0964d7ceda7fc5bbe715653...86b6db591ce84f3d974ddfec395b547dd4f076ab,1,0,2,2,2,2009-04-19 03:06:29,2009-04-19 03:06:29
86b6db591ce84f3d974ddfec395b547dd4f076ab...5a57a7f0069b419506ef9bd00b95acf9216d5c96,1,17,1,18,4,2009-04-19 03:41:33,2009-04-19 03:41:33
5a57a7f0069b419506ef9bd00b95acf9216d5c96...aeaba06bf4976cca2d97f7a39de86a385f6af777,1,5,40,45,2,2009-04-19 22:49:15,2009-04-19 22:49:15
aeaba06bf4976cca2d97f7a39de86a385f6af777...be11bd40d417331944a2fbf6f2d7b4e2e72680cf,1,7,8,15,4,2009-04-19 23:07:24,2009-04-19 23:07:24
be11bd40d417331944a2fbf6f2d7b4e2e72680cf...bfe36750b157d744c83a6aaea1bf2cb95afdf65d,1,12,9,21,2,2009-04-19 23:31:14,2009-04-19 23:31:14
bfe36750b157d744c83a6aaea1bf2cb95afdf65d...b09f554175e581da7e60adcb12769b236b97751f,1,1,5,6,4,2009-04-21 18:09:03,2009-04-21 18:09:03
b09f554175e581da7e60adcb12769b236b97751f...037ce4318b1ea1b99a946d3a70ae2796731ecb1a,2,25,0,25,3,2009-04-21 22:35:04,2009-04-21 22:35:04
037ce4318b1ea1b99a946d3a70ae2796731ecb1a...71233bcdf3c90098531901da4e380165ed0059d4,1,1,1,2,1,2009-04-21 23:31:01,2009-04-21 23:31:01
71233bcdf3c90098531901da4e380165ed0059d4...6c15b5db6014a7dadb0c237e689bdaed4761fb16,3,74,19,93,9,2009-04-22 15:48:51,2009-04-22 15:48:51
6c15b5db6014a7dadb0c237e689bdaed4761fb16...d463580c1bbc17c6180d2f9638768769e850d8d0,1,3,0,3,3,2009-04-22 19:10:28,2009-04-22 19:10:28
d463580c1bbc17c6180d2f9638768769e850d8d0...c00e8d20641910e0fdbce9f155e39b28bb824672,3,50,0,50,4,2009-04-22 22:16:19,2009-04-22 22:16:19
c00e8d20641910e0fdbce9f155e39b28bb824672...855a58f963bb2aa8eeea14be8f22b14020266d08,1,1,1,2,1,2009-04-22 22:16:32,2009-04-22 22:16:32
855a58f963bb2aa8eeea14be8f22b14020266d08...9ea2198fd1f2d0abf55373d8175dbb03f7440576,1,7,0,7,1,2009-04-22 22:16:42,2009-04-22 22:16:42
9ea2198fd1f2d0abf55373d8175dbb03f7440576...6d1837a8bf31e23209c57155e402ad11debbf511,1,20,19,39,7,2009-04-22 22:38:14,2009-04-22 22:38:14
6d1837a8bf31e23209c57155e402ad11debbf511...d6829782d0001a08526f6b8465302865842990dc,2,1,8,9,3,2009-04-22 22:45:23,2009-04-22 22:45:23
d6829782d0001a08526f6b8465302865842990dc...44c062344f77708fd68189cbd80792daf524e5a6,4,54,16,70,8,2009-04-24 20:24:50,2009-04-24 20:24:50
44c062344f77708fd68189cbd80792daf524e5a6...8010e0c32ee9ba5a0199ee477242b00f1d6627fd,1,8,8,16,5,2009-04-24 20:34:48,2009-04-24 20:34:48
8010e0c32ee9ba5a0199ee477242b00f1d6627fd...66db0b43ad8759c1d95669847ac8153c36f2ac48,4,98,14,112,13,2009-04-25 18:24:32,2009-04-25 18:24:32
66db0b43ad8759c1d95669847ac8153c36f2ac48...1269f9a3e96ed4d0913ba97b9bcc37427f560e84,2,6,0,6,4,2009-04-26 06:01:59,2009-04-26 06:01:59
1269f9a3e96ed4d0913ba97b9bcc37427f560e84...d2c4c022516e3f6c3b7397ffc5235dfb6eda423b,2,8,3,11,3,2009-04-26 06:08:26,2009-04-26 06:08:26
d2c4c022516e3f6c3b7397ffc5235dfb6eda423b...b0516a1b4334d09c5ab762061e2502c8ccca4587,2,713,391,1104,359,2009-04-26 22:58:44,2009-04-26 22:58:44
b0516a1b4334d09c5ab762061e2502c8ccca4587...681c85f0d4423d2c0bfc314b40b3746645bfc4d3,2,60,52,112,53,2009-04-27 09:37:29,2009-04-27 09:37:29
681c85f0d4423d2c0bfc314b40b3746645bfc4d3...f7f755e982bc8e1e4bf1a7777d9a5fbf390c37e0,2,336,229,565,205,2009-04-28 09:35:04,2009-04-28 09:35:04
f7f755e982bc8e1e4bf1a7777d9a5fbf390c37e0...6312de027911104825adbb0c553b4c5bfeb96b39,2,45,16,61,18,2009-04-28 13:19:30,2009-04-28 13:19:30
6312de027911104825adbb0c553b4c5bfeb96b39...0c1d38bdf4884121e322c557e09721af85c10eb3,1,5,7,12,3,2009-04-28 13:28:57,2009-04-28 13:28:57
0c1d38bdf4884121e322c557e09721af85c10eb3...2ba9df2f41cd649b42f5d7452aa2393aa6131f32,2,22,10,32,3,2009-04-28 14:17:18,2009-04-28 14:17:18
2ba9df2f41cd649b42f5d7452aa2393aa6131f32...17958fa7a9a757c2b0abcdc3f931a010584234f1,2,135,29,164,15,2009-04-30 13:47:39,2009-04-30 13:47:39
17958fa7a9a757c2b0abcdc3f931a010584234f1...5e2d38465a661fc267676798d3aa4872e9da8265,4,83,31,114,23,2009-04-30 15:40:09,2009-04-30 15:40:09
5e2d38465a661fc267676798d3aa4872e9da8265...03047d403780ff01b682e299f876cda2b8df2d93,1,1,1,2,1,2009-04-30 20:12:24,2009-04-30 20:12:24
03047d403780ff01b682e299f876cda2b8df2d93...e43ace720cad6e0f000332e9dc4cba8af4be3bf6,4,593,276,869,241,2009-05-01 22:03:14,2009-05-01 22:03:14
e43ace720cad6e0f000332e9dc4cba8af4be3bf6...fbf5eaac9460a0f97187b80c9ac16b9aa023802e,5,122,12,134,24,2009-05-02 07:03:33,2009-05-02 07:03:33
fbf5eaac9460a0f97187b80c9ac16b9aa023802e...e85bc81651abfc417e57aadf3dd7bed137c80430,1,1,1,2,1,2009-05-02 07:39:45,2009-05-02 07:39:45
e85bc81651abfc417e57aadf3dd7bed137c80430...87d3ff731bfbedaefa8cb762c92df18e5d234978,3,55,46,101,13,2009-05-02 07:40:25,2009-05-02 07:40:25
87d3ff731bfbedaefa8cb762c92df18e5d234978...95bcb70b5624a22cfc29795ea363e4a42fce6638,1,8,8,16,6,2009-05-02 14:51:54,2009-05-02 14:51:54
95bcb70b5624a22cfc29795ea363e4a42fce6638...f6cca736a0e1a0ac19e65fb52fa224c1c0d258fd,2,31,8,39,8,2009-05-02 14:52:34,2009-05-02 14:52:34
f6cca736a0e1a0ac19e65fb52fa224c1c0d258fd...71055085a38180544d9cc6392778146bc38ed438,1,0,3,3,1,2009-05-02 16:04:44,2009-05-02 16:04:44
71055085a38180544d9cc6392778146bc38ed438...cb5e8e29f062ac92397a3ce8c5454693bf9845ab,1,1,2,3,2,2009-05-02 16:17:36,2009-05-02 16:17:36
cb5e8e29f062ac92397a3ce8c5454693bf9845ab...2c24bba934d26ee79f41961859c70935bfc4cd83,3,16,10,26,11,2009-05-03 13:37:20,2009-05-03 13:37:20
2c24bba934d26ee79f41961859c70935bfc4cd83...80a54dd23bfda4bb297f9b13f2a54c1f10664cf5,5,54,3,57,4,2009-05-03 13:38:36,2009-05-03 13:38:36
80a54dd23bfda4bb297f9b13f2a54c1f10664cf5...d7233e7c5adb8a885cb7265f58ef8a3baedbf8e7,2,33,7,40,10,2009-05-03 13:39:33,2009-05-03 13:39:33
d7233e7c5adb8a885cb7265f58ef8a3baedbf8e7...6acfa88687957f23e5dfb56fced21f39bb151389,0,0,0,0,0,2009-05-03 13:45:26,2009-05-03 13:45:26
6acfa88687957f23e5dfb56fced21f39bb151389...e91deca7798139fa85a17e949aafd380af8fce13,2,20,10,30,13,2009-05-04 07:05:44,2009-05-04 07:05:44
e91deca7798139fa85a17e949aafd380af8fce13...9d28568cb41f86a6d5381004799941d7e6654596,2,37,5,42,6,2009-05-05 11:52:03,2009-05-05 11:52:03
9d28568cb41f86a6d5381004799941d7e6654596...31c833f113caa85bcaa14673b738b4555e6be463,1,27,27,54,19,2009-05-05 22:25:35,2009-05-05 22:25:35
31c833f113caa85bcaa14673b738b4555e6be463...e2d66e7d0372524b413644d29fd90f05c72e50d4,1,1,1,2,1,2009-05-05 22:26:01,2009-05-05 22:26:01
e2d66e7d0372524b413644d29fd90f05c72e50d4...95477d7a80a7b20647a37e652d7f41b4d59b4b80,2,32,18,50,20,2009-05-06 07:37:43,2009-05-06 07:37:43
95477d7a80a7b20647a37e652d7f41b4d59b4b80...eb81d5acb3e1fee57153c0a4719e3f26ae66c5cd,3,24,5,29,7,2009-05-07 11:56:10,2009-05-07 11:56:10
eb81d5acb3e1fee57153c0a4719e3f26ae66c5cd...f259494f827b24228bbbadb1d118a09f8e6329ac,3,316,51,367,42,2009-05-07 12:17:52,2009-05-07 12:17:52
f259494f827b24228bbbadb1d118a09f8e6329ac...e5757f926156c644e92fee01a2bf05465ed13853,1,3,2,5,3,2009-05-07 12:52:02,2009-05-07 12:52:02
e5757f926156c644e92fee01a2bf05465ed13853...b5f0aff922fe963a4df0d3449d8fe55a6acd950d,4,143,4,147,5,2009-05-07 12:52:43,2009-05-07 12:52:43
b5f0aff922fe963a4df0d3449d8fe55a6acd950d...ae7d9bfad2c92ebe30ce8ca0a145eba4504312f1,2,5,2,7,4,2009-05-07 13:10:59,2009-05-07 13:10:59
ae7d9bfad2c92ebe30ce8ca0a145eba4504312f1...9e7388f88573532e16dee9c2acaffaa4afbdbe20,1,1,1,2,1,2009-05-07 13:46:16,2009-05-07 13:46:16
9e7388f88573532e16dee9c2acaffaa4afbdbe20...523da3801d07e27556b33661bc175138a9456410,2,5,7,12,4,2009-05-07 14:48:04,2009-05-07 14:48:04
523da3801d07e27556b33661bc175138a9456410...bfdb7d26aa534578dbac3c43e76d8ac3a5ad6a06,4,58,6,64,4,2009-05-07 15:39:06,2009-05-07 15:39:06
bfdb7d26aa534578dbac3c43e76d8ac3a5ad6a06...fb9ac5729d309f6ec59e4089b7ab04378cb9082a,2,17,1,18,2,2009-05-07 16:12:08,2009-05-07 16:12:08
fb9ac5729d309f6ec59e4089b7ab04378cb9082a...a59095af24bb64a025ce99de3555f2a21da7a2e8,2,4,4,8,4,2009-05-07 17:53:23,2009-05-07 17:53:23
a59095af24bb64a025ce99de3555f2a21da7a2e8...7caf21aa2ebfa5f696fde1fb7e5c11fafb2ef050,5,16,16,32,10,2009-05-07 18:06:22,2009-05-07 18:06:22
7caf21aa2ebfa5f696fde1fb7e5c11fafb2ef050...304785bf26093418eb8ba8b22924696edce3b4da,1,5,6,11,1,2009-05-08 04:44:33,2009-05-08 04:44:33
304785bf26093418eb8ba8b22924696edce3b4da...59507753c7f098e98000459b2371becf0da18ff7,2,51,12,63,8,2009-05-08 05:50:31,2009-05-08 05:50:31
59507753c7f098e98000459b2371becf0da18ff7...60cfd45107d33da6f655efe566d29190525c8f33,2,15,10,25,7,2009-05-08 09:51:05,2009-05-08 09:51:05
60cfd45107d33da6f655efe566d29190525c8f33...eaf8ec54d2f9aed4f66c1c596a8eef3bc85c879c,1,4,0,4,1,2009-05-08 09:57:47,2009-05-08 09:57:47
eaf8ec54d2f9aed4f66c1c596a8eef3bc85c879c...614d881450983fa3678761f68aaf188c38a5a228,2,28,2,30,3,2009-05-08 09:59:46,2009-05-08 09:59:46
614d881450983fa3678761f68aaf188c38a5a228...a7faf6424a8193cbf8a3a8d017461188fe9ea9c9,2,150,98,248,10,2009-05-08 10:56:51,2009-05-08 10:56:51
a7faf6424a8193cbf8a3a8d017461188fe9ea9c9...155ab07a5d40f5e0a426423cb8df3868a37a02f8,3,21,0,21,4,2009-05-08 11:15:23,2009-05-08 11:15:23
155ab07a5d40f5e0a426423cb8df3868a37a02f8...38a6c48878c4318fac404e6ee2454d78b26c098b,1,5,4,9,3,2009-05-08 11:31:36,2009-05-08 11:31:36
38a6c48878c4318fac404e6ee2454d78b26c098b...23fa913676d66ce4d32501618b1b74e8b2dca5fc,3,31,2,33,4,2009-05-08 12:53:14,2009-05-08 12:53:14
23fa913676d66ce4d32501618b1b74e8b2dca5fc...f7d01c49e95a9ed25dd75e6b3d4c063dff58e23a,1,1,1,2,1,2009-05-08 12:57:57,2009-05-08 12:57:57
f7d01c49e95a9ed25dd75e6b3d4c063dff58e23a...2af75b485db15a8494b040aa04337c052b896cca,5,64,10,74,12,2009-05-08 13:39:37,2009-05-08 13:39:37
2af75b485db15a8494b040aa04337c052b896cca...68a890e79f660484d05482902663b6168f0bd71e,7,108,140,248,50,2009-05-08 15:08:09,2009-05-08 15:08:09
68a890e79f660484d05482902663b6168f0bd71e...88f5167142f547cbb7b77432803e69a4302d15fe,2,83,56,139,58,2009-05-08 16:20:28,2009-05-08 16:20:28
88f5167142f547cbb7b77432803e69a4302d15fe...c40f715257b6268cfd96dbafa18e58cbc6602afa,3,14,2,16,5,2009-05-08 17:22:34,2009-05-08 17:22:34
c40f715257b6268cfd96dbafa18e58cbc6602afa...2c2871b7c3e99fe651796bb8c12fc3e12d83a34a,3,295,5,300,8,2009-05-09 11:40:13,2009-05-09 11:40:13
2c2871b7c3e99fe651796bb8c12fc3e12d83a34a...9e97fdf357381f257bad0c7d9ac3c7613d27ad64,1,1,0,1,1,2009-05-09 15:52:17,2009-05-09 15:52:17
9e97fdf357381f257bad0c7d9ac3c7613d27ad64...f824ecc363b9b83b0c98fd1b3f9704021894a1fb,1,1,0,1,1,2009-05-10 06:23:29,2009-05-10 06:23:29
f824ecc363b9b83b0c98fd1b3f9704021894a1fb...5663258de13975e28406233328a9e51c8bc1b768,3,34,1,35,4,2009-05-10 07:44:27,2009-05-10 07:44:27
5663258de13975e28406233328a9e51c8bc1b768...b97178f7ec311da7c885a122a2ccc1036bacf0d3,5,49,24,73,13,2009-05-10 09:22:06,2009-05-10 09:22:06
b97178f7ec311da7c885a122a2ccc1036bacf0d3...8c2db4ab0f87643765b6bffac7c524f5e2e54d65,2,28,5,33,5,2009-05-10 09:22:53,2009-05-10 09:22:53
8c2db4ab0f87643765b6bffac7c524f5e2e54d65...fe971ec66f5d42945b2583037303be31f53ea524,2,11,6,17,5,2009-05-10 21:09:38,2009-05-10 21:09:38
fe971ec66f5d42945b2583037303be31f53ea524...4f9fd449658132362c8274e1fec96df5e843cf05,2,4,4,8,4,2009-05-11 01:46:26,2009-05-11 01:46:26
4f9fd449658132362c8274e1fec96df5e843cf05...2b0903b2c4b6f5534e88d25254c6dcf02cc9d485,6,139,48,187,36,2009-05-11 09:57:19,2009-05-11 09:57:19
2b0903b2c4b6f5534e88d25254c6dcf02cc9d485...baaf29895c41cfafcd130d5a8f5ab548e5e9c308,5,177,9,186,14,2009-05-11 10:10:03,2009-05-11 10:10:03
baaf29895c41cfafcd130d5a8f5ab548e5e9c308...772f68c20e8de89a6b029a0ff498f6120912af07,1,1,0,1,1,2009-05-11 10:13:43,2009-05-11 10:13:43
772f68c20e8de89a6b029a0ff498f6120912af07...756d6f3a241fdc3fbe5fd20d5c62c8a709e25927,1,2,2,4,2,2009-05-11 11:56:46,2009-05-11 11:56:46
756d6f3a241fdc3fbe5fd20d5c62c8a709e25927...14a6f6cf9a44f0e8f088633d36cc2794c0b27e97,1,1,0,1,1,2009-05-11 16:13:29,2009-05-11 16:13:29
14a6f6cf9a44f0e8f088633d36cc2794c0b27e97...369568b8c76dc463ed6f392e2efe874cbab04690,1,2,3,5,3,2009-05-11 17:29:08,2009-05-11 17:29:08
369568b8c76dc463ed6f392e2efe874cbab04690...7b81dd4779dbd4f1d2f87f8343cc93d36c8c9e23,1,27,30,57,6,2009-05-11 20:55:40,2009-05-11 20:55:40
7b81dd4779dbd4f1d2f87f8343cc93d36c8c9e23...e7fdfa14a4da1c3a231679800ed5a8e790c72ee5,1,19,17,36,7,2009-05-12 17:23:33,2009-05-12 17:23:33
e7fdfa14a4da1c3a231679800ed5a8e790c72ee5...d08339686bc16e7a4765d909036297b8af95ea3b,1,9,0,9,1,2009-05-12 17:23:43,2009-05-12 17:23:43
d08339686bc16e7a4765d909036297b8af95ea3b...9140f97f9db83db37e0d7e6a97f45aa27ac1bd8f,1,5,0,5,1,2009-05-12 20:30:28,2009-05-12 20:30:28
9140f97f9db83db37e0d7e6a97f45aa27ac1bd8f...d20a0834ac344ee79880c353d2c40639ee3837da,2,86,12,98,10,2009-05-12 21:45:03,2009-05-12 21:45:03
d20a0834ac344ee79880c353d2c40639ee3837da...fce800f3fda6d22e90215a63d60e3567c3a48128,2,26,2,28,4,2009-05-12 21:54:58,2009-05-12 21:54:58
fce800f3fda6d22e90215a63d60e3567c3a48128...96b5b6b34c293618824d12dfb29cdd5cec1c2e7e,2,27,6,33,5,2009-05-12 22:02:38,2009-05-12 22:02:38
96b5b6b34c293618824d12dfb29cdd5cec1c2e7e...7215ffe8a43d55536ca46e37f9b5241f35f2fa5b,4,50,4,54,8,2009-05-13 14:04:29,2009-05-13 14:04:29
7215ffe8a43d55536ca46e37f9b5241f35f2fa5b...66ff7db38517065e9654dfc80020481911ef1a6d,1,1,1,2,1,2009-05-14 01:53:57,2009-05-14 01:53:57
66ff7db38517065e9654dfc80020481911ef1a6d...de642e4d3d543f79df4503079cd7cedd1e12dd7e,1,44,21,65,12,2009-05-14 02:01:17,2009-05-14 02:01:17
de642e4d3d543f79df4503079cd7cedd1e12dd7e...bc514fe87e42d78c665569ed24a8ca6dd487a1d6,1,10,0,10,1,2009-05-14 02:02:58,2009-05-14 02:02:58
bc514fe87e42d78c665569ed24a8ca6dd487a1d6...fc458dd710a4306593956590cf261eeca6311c3d,1,4,0,4,1,2009-05-14 02:13:08,2009-05-14 02:13:08
fc458dd710a4306593956590cf261eeca6311c3d...690cb616ce7ac9d0ef6278e391b52049ee759ca0,1,2,2,4,2,2009-05-14 02:17:40,2009-05-14 02:17:40
690cb616ce7ac9d0ef6278e391b52049ee759ca0...e508bfd27f34fc753ae32cc1776251e2d7f36610,2,69,64,133,2,2009-05-14 02:23:53,2009-05-14 02:23:53
e508bfd27f34fc753ae32cc1776251e2d7f36610...5bdee2556e9f6b32dee8bb25ffc9594a3cb23472,1,13,0,13,2,2009-05-14 02:35:16,2009-05-14 02:35:16
5bdee2556e9f6b32dee8bb25ffc9594a3cb23472...d987b378ceaa546d43f42588564515aadb0c9233,1,15,0,15,1,2009-05-14 02:38:27,2009-05-14 02:38:27
d987b378ceaa546d43f42588564515aadb0c9233...3da371625272edb5af43446c32cbc7027223078d,4,48,13,61,3,2009-05-14 15:09:33,2009-05-14 15:09:33
3da371625272edb5af43446c32cbc7027223078d...d246401552ee37db485220adccd7b88693564f2a,3,68,156,224,29,2009-05-14 15:20:50,2009-05-14 15:20:50
d246401552ee37db485220adccd7b88693564f2a...bcb0d124b409c68ede62f82421855a29ea5b8a39,1,3,1,4,2,2009-05-15 02:54:55,2009-05-15 02:54:55
bcb0d124b409c68ede62f82421855a29ea5b8a39...bed1418034ec20a308ac8df94ebaf97fd489ea30,1,1,1,2,1,2009-05-15 02:57:53,2009-05-15 02:57:53
bed1418034ec20a308ac8df94ebaf97fd489ea30...a00be663112bc674f71492717f7bbbb35b922e42,3,144,13,157,12,2009-05-15 12:44:51,2009-05-15 12:44:51
a00be663112bc674f71492717f7bbbb35b922e42...56f3ed7f5425746f16f4027cceb7b9059806478d,1,11,12,23,8,2009-05-15 15:01:40,2009-05-15 15:01:40
56f3ed7f5425746f16f4027cceb7b9059806478d...975ec181ead71fe80fcffe3fefbf2f7f9b8a6e0e,1,130,19,149,8,2009-05-16 06:23:06,2009-05-16 06:23:06
975ec181ead71fe80fcffe3fefbf2f7f9b8a6e0e...7ba62f2c15b4658d3280bcb588670a8b6d2b65fd,1,22,28,50,9,2009-05-17 16:12:05,2009-05-17 16:12:05
7ba62f2c15b4658d3280bcb588670a8b6d2b65fd...2cbec63f0b19bb00eebdbf874ecfabd405e25007,1,1,1,2,1,2009-05-17 16:20:11,2009-05-17 16:20:11
2cbec63f0b19bb00eebdbf874ecfabd405e25007...92e5249a677c1c60d2a13ad0203716840fc71143,1,1,1,2,1,2009-05-17 16:31:02,2009-05-17 16:31:02
92e5249a677c1c60d2a13ad0203716840fc71143...50745cc31ecd0ff76dafed2fb903d14c1b30d707,15,15,15,30,15,2009-05-17 16:45:28,2009-05-17 16:45:28
50745cc31ecd0ff76dafed2fb903d14c1b30d707...21cee79ee42c4b6827de031ad9e6d486ad9a3657,1,1,1,2,1,2009-05-17 16:57:50,2009-05-17 16:57:50
21cee79ee42c4b6827de031ad9e6d486ad9a3657...3465ac05a67f1e331a86a50e7d8ff337e3e71fa9,1,1,1,2,1,2009-05-17 17:13:33,2009-05-17 17:13:33
3465ac05a67f1e331a86a50e7d8ff337e3e71fa9...c8e071b00d9d1ce762ec405c6fdc2dc5f3a6bf8b,1,2,0,2,1,2009-05-17 17:24:59,2009-05-17 17:24:59
c8e071b00d9d1ce762ec405c6fdc2dc5f3a6bf8b...5a4ad739b772593bb31bd5fd6af07d3a4e047406,1,1,1,2,1,2009-05-17 17:36:04,2009-05-17 17:36:04
5a4ad739b772593bb31bd5fd6af07d3a4e047406...33e77db6a27a9058a265144f9b72969aba409af9,1,1,1,2,1,2009-05-17 17:43:15,2009-05-17 17:43:15
33e77db6a27a9058a265144f9b72969aba409af9...b527a59da80a276163b975a0fdc97d84e967b87e,2,5,1,6,2,2009-05-17 17:54:51,2009-05-17 17:54:51
b527a59da80a276163b975a0fdc97d84e967b87e...21c6f98076ce3034999562673b35a9792945042d,2,3,3,6,3,2009-05-17 18:04:29,2009-05-17 18:04:29
21c6f98076ce3034999562673b35a9792945042d...b2d2aba77e40522a53619c0d3fa055b6c10beef6,1,3,3,6,1,2009-05-17 18:10:10,2009-05-17 18:10:10
b2d2aba77e40522a53619c0d3fa055b6c10beef6...a6a0b29318e437de1f97329e6a5490d62fb36d3d,1,4,0,4,1,2009-05-17 18:45:25,2009-05-17 18:45:25
a6a0b29318e437de1f97329e6a5490d62fb36d3d...5a5842ccf2ff19ba8f459cd0b0930db0dde3fc23,1,1,1,2,1,2009-05-18 15:36:18,2009-05-18 15:36:18
5a5842ccf2ff19ba8f459cd0b0930db0dde3fc23...ae95edf91df4eb47c25f262a77749538b37d357e,1,5,4,9,3,2009-05-18 16:00:29,2009-05-18 16:00:29
ae95edf91df4eb47c25f262a77749538b37d357e...b9b9ca334e335a2678f0ae560a9182ca5ed1bfcf,2,17,5,22,9,2009-05-19 12:44:17,2009-05-19 12:44:17
b9b9ca334e335a2678f0ae560a9182ca5ed1bfcf...2e24596001bce6e827e31510241834ccff76979f,2,10,1,11,2,2009-05-19 13:42:38,2009-05-19 13:42:38
2e24596001bce6e827e31510241834ccff76979f...8c8625bde346d619befbdbb8a550368aa9b54b4d,3,27,5,32,5,2009-05-19 23:13:33,2009-05-19 23:13:33
8c8625bde346d619befbdbb8a550368aa9b54b4d...4567b44909347f905f8a5e1409768e9095fbe5b1,1,1,1,2,1,2009-05-20 00:19:13,2009-05-20 00:19:13
4567b44909347f905f8a5e1409768e9095fbe5b1...ca365b4113b89e269d8a2f731a288cff5be97422,2,44,20,64,19,2009-05-20 11:03:10,2009-05-20 11:03:10
ca365b4113b89e269d8a2f731a288cff5be97422...c935d7ffe37cf9376aa30cb74c6fdaffe346255f,2,126,73,199,29,2009-05-20 16:13:55,2009-05-20 16:13:55
c935d7ffe37cf9376aa30cb74c6fdaffe346255f...077a94c550330fde233407b61b98d72d8199bfe3,1,4,2,6,2,2009-05-20 20:05:14,2009-05-20 20:05:14
077a94c550330fde233407b61b98d72d8199bfe3...e258961e4f9074694ec34b08c318079e9ec195e0,1,1,2,3,1,2009-05-23 12:58:31,2009-05-23 12:58:31
e258961e4f9074694ec34b08c318079e9ec195e0...5d9983d08430ef3e2ad69771f58a446cfe452483,2,7,1,8,2,2009-05-24 06:46:02,2009-05-24 06:46:02
5d9983d08430ef3e2ad69771f58a446cfe452483...9848f888badeaa84c31e5ced99a10badb0b525e4,1,7,7,14,4,2009-05-26 05:29:28,2009-05-26 05:29:28
9848f888badeaa84c31e5ced99a10badb0b525e4...a251e0ab7eb2cbff2b8244a78bbb164503c2d659,2,0,14,14,2,2009-05-26 05:32:52,2009-05-26 05:32:52
a251e0ab7eb2cbff2b8244a78bbb164503c2d659...5e20adcdf684462261f2c51dc2a4fd30389b650d,1,6,39,45,4,2009-05-26 16:27:12,2009-05-26 16:27:12
5e20adcdf684462261f2c51dc2a4fd30389b650d...5dc30c9fd2c7cff0d511ffdcc285a4cd9f56c73a,1,3,3,6,3,2009-05-26 16:46:56,2009-05-26 16:46:56
5dc30c9fd2c7cff0d511ffdcc285a4cd9f56c73a...bdf33b37daaa7f94b7d760dd5d03f3920d220866,1,1,1,2,1,2009-05-27 16:03:51,2009-05-27 16:03:51
bdf33b37daaa7f94b7d760dd5d03f3920d220866...9b19fd7a76e8c439bfd4c178e6c35735419097a7,1,3,0,3,1,2009-05-27 16:20:11,2009-05-27 16:20:11
9b19fd7a76e8c439bfd4c178e6c35735419097a7...7638651cc32c31f6c7032041af5f5e575e23f256,1,1,1,2,1,2009-05-27 16:26:56,2009-05-27 16:26:56
e9f647e11f9ee77dea71f9302904474c13ff3b5a...fe19e9f4aff713f979bb80bd735bd8392f7f63fe,0,0,0,0,0,2008-09-29 15:40:49,2008-09-29 15:40:49
fe19e9f4aff713f979bb80bd735bd8392f7f63fe...b17453bbc97bace0ce0a875d217663c3af801677,4,28,6,34,4,2008-09-30 05:57:13,2008-09-30 05:57:13
b17453bbc97bace0ce0a875d217663c3af801677...5e272e0f1a3770f2a94210584fa5c30ba6f640b4,1,15,7,22,2,2008-09-30 17:49:26,2008-09-30 17:49:26
5e272e0f1a3770f2a94210584fa5c30ba6f640b4...f585dea14ed7a36e97913c02cf7ceac695b79d72,1,39,14,53,7,2008-09-30 22:25:41,2008-09-30 22:25:41
f585dea14ed7a36e97913c02cf7ceac695b79d72...9971852234897684a7fb1c490dddb8491ac746ab,1,0,8,8,1,2008-09-30 22:31:06,2008-09-30 22:31:06
9971852234897684a7fb1c490dddb8491ac746ab...a59c27ac5d535be60300ee3c5d3164522398d1dd,1,3,5,8,1,2008-10-01 01:23:55,2008-10-01 01:23:55
a59c27ac5d535be60300ee3c5d3164522398d1dd...b7f40091ade38099fd63671c2b1db7044eda1c3b,1,1,1,2,1,2008-10-01 17:26:40,2008-10-01 17:26:40
b7f40091ade38099fd63671c2b1db7044eda1c3b...e4bc9e1f4aba25b4c0d31dbd9814414d4b5f0928,1,2,2,4,2,2008-10-05 05:02:55,2008-10-05 05:02:55
e4bc9e1f4aba25b4c0d31dbd9814414d4b5f0928...3e2803f3e8723c121f751bb0d0c8c1d38b80b04c,2,0,53,53,2,2008-10-05 05:16:08,2008-10-05 05:16:08
3e2803f3e8723c121f751bb0d0c8c1d38b80b04c...769709e994a9d2cdb1f34750bcc6c130faffcfb8,1,2,3,5,2,2008-10-05 05:16:38,2008-10-05 05:16:38
769709e994a9d2cdb1f34750bcc6c130faffcfb8...4393fea6821b322c7806a6acf83c6e37e5ca3607,5,14,14,28,11,2008-10-05 05:17:29,2008-10-05 05:17:29
4393fea6821b322c7806a6acf83c6e37e5ca3607...389307025fcea7c183406e329c7e71d193f8c5a3,2,20,3,23,4,2008-10-05 05:18:25,2008-10-05 05:18:25
389307025fcea7c183406e329c7e71d193f8c5a3...ccc2387fd21f5a93e8467f2fbb6462c6fae195c5,12,56,49,105,43,2008-10-05 05:20:00,2008-10-05 05:20:00
ccc2387fd21f5a93e8467f2fbb6462c6fae195c5...e88b70b779def702696a294803313092df6b5ee3,1,1,1,2,1,2008-10-05 05:20:40,2008-10-05 05:20:40
e88b70b779def702696a294803313092df6b5ee3...245399becbac4e3246d09fff268f99e3b8af7839,1,3,5,8,3,2008-10-05 05:21:14,2008-10-05 05:21:14
245399becbac4e3246d09fff268f99e3b8af7839...571b159dd35b27ff1598973aaa8c52085268fdb5,2,5,3,8,3,2008-10-05 06:00:55,2008-10-05 06:00:55
571b159dd35b27ff1598973aaa8c52085268fdb5...b0be5af39c32573b3d83449e16101d4024bd47f2,1,1,1,2,1,2008-10-05 06:21:52,2008-10-05 06:21:52
b0be5af39c32573b3d83449e16101d4024bd47f2...f9e78ed612aa1c3ccf098da450e2b52c48cad305,1,1,1,2,1,2008-10-05 06:22:25,2008-10-05 06:22:25
f9e78ed612aa1c3ccf098da450e2b52c48cad305...e15bdf767e19f4fc21fa9f14cfc1f2e38dcf911b,1,2,2,4,1,2008-10-05 06:22:58,2008-10-05 06:22:58
e15bdf767e19f4fc21fa9f14cfc1f2e38dcf911b...01b6e55f200d7b59da61ecb727a29baad2c803e6,1,4,4,8,1,2008-10-05 06:23:23,2008-10-05 06:23:23
01b6e55f200d7b59da61ecb727a29baad2c803e6...2993ef3d7eb8e81d9682ee6948bdcd9ba058bc41,1,1,0,1,1,2008-10-05 06:40:47,2008-10-05 06:40:47
2993ef3d7eb8e81d9682ee6948bdcd9ba058bc41...ee9c6ae269e858ddfa318fdb49b0c7ca31676cb8,1,6,1,7,2,2008-10-05 06:41:15,2008-10-05 06:41:15
ee9c6ae269e858ddfa318fdb49b0c7ca31676cb8...9b5c2293c647967e42b320109f32f77b01d6a3aa,1,6,2,8,2,2008-10-05 07:00:58,2008-10-05 07:00:58
9b5c2293c647967e42b320109f32f77b01d6a3aa...5da08047b9ff074173e6a3dc6c9b5d5a03c89bf5,1,3,2,5,2,2008-10-05 09:00:07,2008-10-05 09:00:07
5da08047b9ff074173e6a3dc6c9b5d5a03c89bf5...89c2fba23b8cfd856972ea25d838171cc67e8ce8,1,6,0,6,3,2008-10-05 11:41:19,2008-10-05 11:41:19
89c2fba23b8cfd856972ea25d838171cc67e8ce8...9273575e6b656f26f877c921f6530fa8c41b4563,1,2,1,3,1,2008-10-05 11:57:11,2008-10-05 11:57:11
9273575e6b656f26f877c921f6530fa8c41b4563...075274203f5c4c0245c915fb974e310aa1781bd8,1,16,0,16,1,2008-10-05 16:04:55,2008-10-05 16:04:55
075274203f5c4c0245c915fb974e310aa1781bd8...48f4388c8bbd072db1e7949c7b954ca9ce989f77,2,27,0,27,3,2008-10-06 01:38:22,2008-10-06 01:38:22
48f4388c8bbd072db1e7949c7b954ca9ce989f77...c201d14269204a95c1f95299490430b2d8206341,1,5,3,8,2,2008-10-06 04:56:50,2008-10-06 04:56:50
c201d14269204a95c1f95299490430b2d8206341...b5ac7f79184ec69c37c65a8d09d16897cd708c00,4,52,20,72,12,2008-10-06 06:37:53,2008-10-06 06:37:53
b5ac7f79184ec69c37c65a8d09d16897cd708c00...6f0bcd23e666678099e62fcb5a47a0bf39ad1ffb,1,4,3,7,2,2008-10-06 08:42:45,2008-10-06 08:42:45
6f0bcd23e666678099e62fcb5a47a0bf39ad1ffb...167a131e533719806f3d4482f5be274fc0cced2e,1,4,4,8,2,2008-10-06 08:43:38,2008-10-06 08:43:38
167a131e533719806f3d4482f5be274fc0cced2e...51fb4bb0d3713a6a3c5133a6abd6745a39150c5c,1,16,2,18,3,2008-10-06 08:44:40,2008-10-06 08:44:40
51fb4bb0d3713a6a3c5133a6abd6745a39150c5c...282c38d4067d8604c37d70c1827b4244c9e53b18,1,34,0,34,2,2008-10-06 08:45:40,2008-10-06 08:45:40
282c38d4067d8604c37d70c1827b4244c9e53b18...82a01a63a64cb39b187b4f580cb1f62d0f5d2d0a,1,14,0,14,1,2008-10-06 08:46:54,2008-10-06 08:46:54
82a01a63a64cb39b187b4f580cb1f62d0f5d2d0a...f4a57bedd8c833b3fb12e646a031639db0d9e423,1,20,1,21,1,2008-10-06 08:48:17,2008-10-06 08:48:17
f4a57bedd8c833b3fb12e646a031639db0d9e423...378dadc210ae48cafd75c74ee1a7b14e83344720,2,12,8,20,4,2008-10-06 11:25:45,2008-10-06 11:25:45
378dadc210ae48cafd75c74ee1a7b14e83344720...6a30f5a2ea120d143b457a612ab9f1d1236256b6,1,9,2,11,1,2008-10-06 11:26:59,2008-10-06 11:26:59
6a30f5a2ea120d143b457a612ab9f1d1236256b6...e4b28a9b61e8b2ed0b2c4eff441a0f4772702c75,1,208,12,220,12,2008-10-06 11:28:39,2008-10-06 11:28:39
e4b28a9b61e8b2ed0b2c4eff441a0f4772702c75...e75fe1a83fc677a3039ee74a937dea7ff442a1c0,0,0,0,0,0,2008-10-06 17:49:42,2008-10-06 17:49:42
e75fe1a83fc677a3039ee74a937dea7ff442a1c0...f98243375c0e8f0a9618b7103d005ef4131288f9,0,0,0,0,0,2008-10-06 18:02:19,2008-10-06 18:02:19
f98243375c0e8f0a9618b7103d005ef4131288f9...0604225387237816ad6e581ee348531e5aa3c010,0,0,0,0,0,2008-10-06 18:21:49,2008-10-06 18:21:49
0604225387237816ad6e581ee348531e5aa3c010...66c77d03d2b7e9643a5d942591e7f77816d52fad,2,63,23,86,6,2008-10-07 08:26:31,2008-10-07 08:26:31
66c77d03d2b7e9643a5d942591e7f77816d52fad...ed48b0b37ebbb7ec5a8001b7957bb5f9e021e644,6,130,1,131,6,2008-10-07 08:47:05,2008-10-07 08:47:05
ed48b0b37ebbb7ec5a8001b7957bb5f9e021e644...fb4f82f2eabe29f9fa27612f485b3be8f497c107,6,1,130,131,6,2008-10-07 09:04:55,2008-10-07 09:04:55
fb4f82f2eabe29f9fa27612f485b3be8f497c107...3963a01697f301629f336fb88a96ca326f6697e6,1,4,2,6,2,2008-10-07 10:55:02,2008-10-07 10:55:02
3963a01697f301629f336fb88a96ca326f6697e6...8e1c848099c88dbcb9edcdd0ba1d17610b59fd87,1,1,0,1,1,2008-10-07 11:56:49,2008-10-07 11:56:49
8e1c848099c88dbcb9edcdd0ba1d17610b59fd87...4991aac216c703dd115a451f441f82fb5a5cb613,1,4,0,4,1,2008-10-07 11:58:02,2008-10-07 11:58:02
4991aac216c703dd115a451f441f82fb5a5cb613...742ff0800b57cf0657af3a6d85435cd84d2f8334,2,84,26,110,27,2008-10-07 11:58:40,2008-10-07 11:58:40
742ff0800b57cf0657af3a6d85435cd84d2f8334...b3c2cf3d1d7f800a2b4f4763ceb763c9e1b7f13c,2,16,2,18,2,2008-10-07 12:26:00,2008-10-07 12:26:00
b3c2cf3d1d7f800a2b4f4763ceb763c9e1b7f13c...318c1c32dd6e595600e217fbcf92aa879209e7d7,1,8,0,8,1,2008-10-08 08:42:39,2008-10-08 08:42:39
318c1c32dd6e595600e217fbcf92aa879209e7d7...09d84c4d40d1d9796f1d0f52bc3ea1bb93a68435,2,4,2,6,3,2008-10-08 08:43:31,2008-10-08 08:43:31
09d84c4d40d1d9796f1d0f52bc3ea1bb93a68435...4b687d01ba24f0816aa10b9c89c35ee909bb9ee5,2,8,2,10,3,2008-10-08 08:44:17,2008-10-08 08:44:17
4b687d01ba24f0816aa10b9c89c35ee909bb9ee5...a9936d0b1cc9a0f7468fed87192f60fc5a85c26a,2,7,1,8,2,2008-10-08 09:48:21,2008-10-08 09:48:21
a9936d0b1cc9a0f7468fed87192f60fc5a85c26a...ced447ee9784d2a3bbd1115ff40ae837be766009,3,57,15,72,15,2008-10-08 10:11:02,2008-10-08 10:11:02
ced447ee9784d2a3bbd1115ff40ae837be766009...aea426561af3e55f562234d70efb25517e4392f8,0,0,0,0,0,2008-10-08 14:15:39,2008-10-08 14:15:39
aea426561af3e55f562234d70efb25517e4392f8...9810648befa7c4ebe0fbebd9e8965930647fce37,4,99,21,120,16,2008-10-08 14:57:34,2008-10-08 14:57:34
9810648befa7c4ebe0fbebd9e8965930647fce37...5e9a9053d89a0125e695b54b01b9cb8223804d50,1,3,2,5,5,2008-10-09 09:01:30,2008-10-09 09:01:30
5e9a9053d89a0125e695b54b01b9cb8223804d50...f0ba276fd6192f1d0878c2be5e61eaa5ff1b5e6c,1,3,3,6,1,2008-10-09 09:21:22,2008-10-09 09:21:22
f0ba276fd6192f1d0878c2be5e61eaa5ff1b5e6c...94c210427fbff0fb00008333cb28112785fd7d0e,1,1,1,2,1,2008-10-09 09:33:35,2008-10-09 09:33:35
94c210427fbff0fb00008333cb28112785fd7d0e...194de934ffd9317080abf733eb76edb33eec8c49,1,1,1,2,1,2008-10-09 23:38:09,2008-10-09 23:38:09
194de934ffd9317080abf733eb76edb33eec8c49...a47f32449a5e93c16665926e7d3fba2c45d5a06f,1,5,4,9,5,2008-10-10 20:14:52,2008-10-10 20:14:52
a47f32449a5e93c16665926e7d3fba2c45d5a06f...4d692e6af1b1bb02c7b65d4a86415a5294898185,2,68,40,108,19,2008-10-10 21:42:26,2008-10-10 21:42:26
4d692e6af1b1bb02c7b65d4a86415a5294898185...6cfbd52138488f135329dd77cd596a0dd982fdeb,3,34,14,48,14,2008-10-10 22:14:24,2008-10-10 22:14:24
6cfbd52138488f135329dd77cd596a0dd982fdeb...909371e5e57ec340c1f9b65fb5124802bc43f5f9,2,17,35,52,5,2008-10-11 00:26:11,2008-10-11 00:26:11
909371e5e57ec340c1f9b65fb5124802bc43f5f9...743019f8fde33af4002b6bed4342edbd466172e7,0,0,0,0,0,2008-10-11 14:21:36,2008-10-11 14:21:36
743019f8fde33af4002b6bed4342edbd466172e7...4537f33487d265c78827e2f3d3b69f0074a7fda1,1,6,1,7,2,2008-10-13 19:41:48,2008-10-13 19:41:48
4537f33487d265c78827e2f3d3b69f0074a7fda1...36e90e57368a1d9474565a932dfc921a86f7a989,1,4,3,7,1,2008-10-17 22:46:08,2008-10-17 22:46:08
36e90e57368a1d9474565a932dfc921a86f7a989...3c5688d4e0fd3701a601bb4974879d93223db3fe,1,3,2,5,2,2008-10-18 00:02:26,2008-10-18 00:02:26
3c5688d4e0fd3701a601bb4974879d93223db3fe...663a2848170e97500a3ab86dc5d7413aaa93fefe,1,2,3,5,3,2008-10-21 04:45:55,2008-10-21 04:45:55
663a2848170e97500a3ab86dc5d7413aaa93fefe...bd60c52c3c17b84f97f33db87caf8f49d715040b,2,44,13,57,7,2008-10-21 14:07:36,2008-10-21 14:07:36
bd60c52c3c17b84f97f33db87caf8f49d715040b...118383c6071a55683a1789dcd6f80bf979ac83da,4,52,4,56,7,2008-10-21 19:06:44,2008-10-21 19:06:44
118383c6071a55683a1789dcd6f80bf979ac83da...d7ebda8d08f0b50e5cda216d562f14701731164b,4,16,2,18,5,2008-10-21 20:27:17,2008-10-21 20:27:17
d7ebda8d08f0b50e5cda216d562f14701731164b...74997f95def1ed655f24bdd526aed1f8912fe646,2,18,10,28,3,2008-10-22 23:14:48,2008-10-22 23:14:48
74997f95def1ed655f24bdd526aed1f8912fe646...f762dcdf65348bd39a5f56eebd4d286ef11e5c55,1,1,1,2,1,2008-10-24 04:40:51,2008-10-24 04:40:51
f762dcdf65348bd39a5f56eebd4d286ef11e5c55...43f6136f0fc8ab3494d5f325d53ac0e6335bedac,3,38,1,39,6,2008-10-24 04:41:58,2008-10-24 04:41:58
43f6136f0fc8ab3494d5f325d53ac0e6335bedac...b52e45193f25e8444d3d5eef4f83d0ee8f7a80b0,2,27,7,34,4,2008-10-24 06:11:37,2008-10-24 06:11:37
b52e45193f25e8444d3d5eef4f83d0ee8f7a80b0...6c8561249943cb11ec89cd574f1cbcef9ecb0c8a,3,1,38,39,6,2008-10-24 06:15:54,2008-10-24 06:15:54
6c8561249943cb11ec89cd574f1cbcef9ecb0c8a...73ea785d6b6a26fe16145c962fa5b9f00c428d19,2,7,7,14,5,2008-10-24 07:19:07,2008-10-24 07:19:07
73ea785d6b6a26fe16145c962fa5b9f00c428d19...568cb5d87ccdc89dc4889a9717854c680c67ed87,1,38,3,41,3,2008-10-24 07:19:45,2008-10-24 07:19:45
568cb5d87ccdc89dc4889a9717854c680c67ed87...8cf2a05d35a3f2a296393b8eb83f7db272bf3ad8,1,6,4,10,2,2008-10-24 07:20:29,2008-10-24 07:20:29
8cf2a05d35a3f2a296393b8eb83f7db272bf3ad8...8158bd9380dd1ee8aae39140d88c33f916b8b803,1,1,1,2,1,2008-10-24 07:21:04,2008-10-24 07:21:04
8158bd9380dd1ee8aae39140d88c33f916b8b803...122c1a9ac0e293a8efc3f1b0348540b02e5ad9f1,2,1,1,2,1,2008-10-24 07:46:59,2008-10-24 07:46:59
122c1a9ac0e293a8efc3f1b0348540b02e5ad9f1...8613e6c53efe40f77e03541d56f68d0f583bcbdc,2,21,5,26,3,2008-10-24 09:29:27,2008-10-24 09:29:27
8613e6c53efe40f77e03541d56f68d0f583bcbdc...13d810efe4cfc935cf27b884332db97031ba041f,1,5,1,6,1,2008-10-24 09:30:04,2008-10-24 09:30:04
13d810efe4cfc935cf27b884332db97031ba041f...0a1aafa581c211e7f970c0d9bbd0b1ae15577e57,1,2,1,3,1,2008-10-24 09:30:53,2008-10-24 09:30:53
0a1aafa581c211e7f970c0d9bbd0b1ae15577e57...74c799d21d6682eb0a0ed8fa25dc48787d5bfb86,2,31,3,34,5,2008-10-24 09:40:12,2008-10-24 09:40:12
74c799d21d6682eb0a0ed8fa25dc48787d5bfb86...71ae6cbfa46a82ae1a79f382ac31fe0c11ea8677,0,0,0,0,0,2008-10-24 16:39:28,2008-10-24 16:39:28
71ae6cbfa46a82ae1a79f382ac31fe0c11ea8677...d323ef20d3e7cb22892c45d47708c00bdf3ed3e2,1,6,5,11,1,2008-10-24 18:13:35,2008-10-24 18:13:35
d323ef20d3e7cb22892c45d47708c00bdf3ed3e2...bffc238a2f83dc0573a3592baf843d1499e373a6,2,10,1,11,3,2008-10-24 19:18:10,2008-10-24 19:18:10
bffc238a2f83dc0573a3592baf843d1499e373a6...d2f6a846683b0b9bf756834393514f3d0f8acb5b,1,4,4,8,2,2008-10-26 03:10:48,2008-10-26 03:10:48
d2f6a846683b0b9bf756834393514f3d0f8acb5b...3517f8a5ac19b4be3b7a9f2f304ee2f073b00fae,1,1,1,2,1,2008-10-26 18:12:31,2008-10-26 18:12:31
3517f8a5ac19b4be3b7a9f2f304ee2f073b00fae...e4ea2e12e1a7969c37adc969825a1160df3c95fc,3,26,3,29,4,2008-10-26 22:30:56,2008-10-26 22:30:56
e4ea2e12e1a7969c37adc969825a1160df3c95fc...9db7d53b6094032f008ebb9ee6ce2209773ed713,1,1,1,2,1,2008-10-28 00:47:49,2008-10-28 00:47:49
9db7d53b6094032f008ebb9ee6ce2209773ed713...98b1b0794c2783bd7aae8630368556f0758fa1e5,0,0,0,0,0,2008-10-28 16:25:42,2008-10-28 16:25:42
98b1b0794c2783bd7aae8630368556f0758fa1e5...a8a07c20572a97185812a0dd5f8dea491a4dcfee,1,0,2,2,1,2008-10-28 16:30:19,2008-10-28 16:30:19
a8a07c20572a97185812a0dd5f8dea491a4dcfee...84216ef05e6099235559a9a018bf4e0ad6ecff70,3,11,1,12,3,2008-10-28 19:04:59,2008-10-28 19:04:59
84216ef05e6099235559a9a018bf4e0ad6ecff70...38d9b0919bb07f4dcfcf22a9013b1a711f54ab89,2,30,1,31,3,2008-10-28 20:03:56,2008-10-28 20:03:56
38d9b0919bb07f4dcfcf22a9013b1a711f54ab89...4931612727a1e3413b61879d24b27733a189d8b0,2,187,81,268,51,2008-10-30 13:23:37,2008-10-30 13:23:37
4931612727a1e3413b61879d24b27733a189d8b0...7b80af625bb20b7bbafa2224afdc8ee431428059,5,129,26,155,22,2008-10-31 22:09:56,2008-10-31 22:09:56
7b80af625bb20b7bbafa2224afdc8ee431428059...237153045a9b192489d2e44788df44a88d045fce,2,2,1,3,2,2008-10-31 23:02:58,2008-10-31 23:02:58
237153045a9b192489d2e44788df44a88d045fce...b66e3a3d5e5533ebefbb2a455369efcf24afce6d,1,1,1,2,1,2008-10-31 23:03:43,2008-10-31 23:03:43
b66e3a3d5e5533ebefbb2a455369efcf24afce6d...662c34d8a7bc37a4e48d9b7a64018fb383d25ffd,2,179,274,453,42,2008-11-01 13:14:30,2008-11-01 13:14:30
662c34d8a7bc37a4e48d9b7a64018fb383d25ffd...3c23dc977c9fa7635d9e11fae7fd8e15a5f5fbe3,0,0,0,0,0,2008-11-01 17:02:17,2008-11-01 17:02:17
3c23dc977c9fa7635d9e11fae7fd8e15a5f5fbe3...9009cac6b9a53d448ae07cc8330457aee3498be6,0,0,0,0,0,2008-11-01 17:18:17,2008-11-01 17:18:17
9009cac6b9a53d448ae07cc8330457aee3498be6...587a2f980947a63c5410238fc49dcd1d024fb850,1,1,1,2,1,2008-11-01 18:07:47,2008-11-01 18:07:47
587a2f980947a63c5410238fc49dcd1d024fb850...d6a1e2ef7a9ebe9f0e48c43c25d1603200bcc8b1,10,11,11,22,11,2008-11-01 19:05:46,2008-11-01 19:05:46
d6a1e2ef7a9ebe9f0e48c43c25d1603200bcc8b1...fbf32bd00034bb4a4c6221030eff2cda032f1bfb,1,2,2,4,2,2008-11-01 19:21:46,2008-11-01 19:21:46
fbf32bd00034bb4a4c6221030eff2cda032f1bfb...19d164e051083d207ef68b31b8099a101578f483,1,1,1,2,1,2008-11-01 19:47:09,2008-11-01 19:47:09
19d164e051083d207ef68b31b8099a101578f483...daf875259d3840652feeec0e91b81b5d16944e46,1,1,1,2,1,2008-11-01 20:17:10,2008-11-01 20:17:10
daf875259d3840652feeec0e91b81b5d16944e46...4c0895bf8fa3392bc3c66cabab007d3dd0724c9b,4,186,55,241,51,2008-11-01 20:32:17,2008-11-01 20:32:17
4c0895bf8fa3392bc3c66cabab007d3dd0724c9b...1af32e88096bccaf33ca1974fcb2454ab612850e,0,0,0,0,0,2008-11-01 20:42:17,2008-11-01 20:42:17
1af32e88096bccaf33ca1974fcb2454ab612850e...3905b071bc7aabcf94e44c6e2b3ea074f63e7ebb,1,1,1,2,1,2008-11-01 20:55:13,2008-11-01 20:55:13
3905b071bc7aabcf94e44c6e2b3ea074f63e7ebb...da151657a0957cf5eba3ae32728b69f3412cd4a0,2,181,43,224,43,2008-11-01 21:07:02,2008-11-01 21:07:02
da151657a0957cf5eba3ae32728b69f3412cd4a0...6c069d2a71e19955b34a9c5aecc4d2075a5d430a,2,22,0,22,2,2008-11-01 22:26:44,2008-11-01 22:26:44
6c069d2a71e19955b34a9c5aecc4d2075a5d430a...f1eb098d96bd43de03e94163449d49d598f953e1,1,1,1,2,1,2008-11-02 04:23:28,2008-11-02 04:23:28
f1eb098d96bd43de03e94163449d49d598f953e1...55943c09757c32c4c5ad7bc8a275df0cbbce172e,11,23,21,44,17,2008-11-02 20:53:47,2008-11-02 20:53:47
55943c09757c32c4c5ad7bc8a275df0cbbce172e...4563060093ad6d30c76b62dce4d822f9426eaef2,0,0,0,0,0,2008-11-02 21:48:00,2008-11-02 21:48:00
4563060093ad6d30c76b62dce4d822f9426eaef2...8e4827e5068ebe26e8669ffa676b7d6764fbb00d,3,27,2,29,8,2008-11-04 19:54:28,2008-11-04 19:54:28
8e4827e5068ebe26e8669ffa676b7d6764fbb00d...dca8dbaf8605807609108988b45d865867876866,3,43,20,63,22,2008-11-05 18:06:24,2008-11-05 18:06:24
dca8dbaf8605807609108988b45d865867876866...ca5a2b09307abd05758b08a8406f59b4490957db,1,14,4,18,4,2008-11-05 18:24:55,2008-11-05 18:24:55
ca5a2b09307abd05758b08a8406f59b4490957db...8e7eddd59d896d70de733cf7dd94fe0d30744afb,2,178,41,219,41,2008-11-05 18:29:21,2008-11-05 18:29:21
8e7eddd59d896d70de733cf7dd94fe0d30744afb...dcfafea408a6eec2d35f9bc2f7aaff724ceee36f,2,32,2,34,4,2008-11-05 19:55:51,2008-11-05 19:55:51
dcfafea408a6eec2d35f9bc2f7aaff724ceee36f...9c3e9c7e65ffa9ace25c8f6a8056dafebf711efc,2,177,47,224,43,2008-11-06 08:49:03,2008-11-06 08:49:03
9c3e9c7e65ffa9ace25c8f6a8056dafebf711efc...e33c6f138257a7b21c2bbe477438a948035c6165,2,179,48,227,43,2008-11-06 09:12:31,2008-11-06 09:12:31
e33c6f138257a7b21c2bbe477438a948035c6165...65d00e5db8aa9596f3bc2f07287719ab9e14cb5c,2,1,1,2,1,2008-11-06 09:18:58,2008-11-06 09:18:58
65d00e5db8aa9596f3bc2f07287719ab9e14cb5c...19dd6c3566d994784f81d24efef56b0032d0c2cc,4,218,83,301,83,2008-11-06 09:34:01,2008-11-06 09:34:01
19dd6c3566d994784f81d24efef56b0032d0c2cc...8edcfc030ea7e810e73397e09246aaeb04c48b4c,2,210,72,282,73,2008-11-06 09:40:56,2008-11-06 09:40:56
8edcfc030ea7e810e73397e09246aaeb04c48b4c...603dcb89bb43b4b74894fa74f5c44cb1fc6dac64,2,11,11,22,11,2008-11-06 09:41:20,2008-11-06 09:41:20
603dcb89bb43b4b74894fa74f5c44cb1fc6dac64...697f73f4889f9fd2739acd470b11e364cc14a3c4,1,6,6,12,6,2008-11-06 10:48:20,2008-11-06 10:48:20
697f73f4889f9fd2739acd470b11e364cc14a3c4...6be20bf64c63180103ae92bfa6e068b8c8102b7a,3,32,24,56,16,2008-11-06 11:27:33,2008-11-06 11:27:33
6be20bf64c63180103ae92bfa6e068b8c8102b7a...1cbf9a93c68f025440ec9df10d7b03ee62e1ab6f,0,0,0,0,0,2008-11-06 14:47:54,2008-11-06 14:47:54
1cbf9a93c68f025440ec9df10d7b03ee62e1ab6f...0776ba048a144fb5bdec35dac283e185fe172653,1,1,1,2,1,2008-11-06 14:50:23,2008-11-06 14:50:23
0776ba048a144fb5bdec35dac283e185fe172653...675ee5c1373fda3b2bb4e5076b3c476308078fa6,1,2,2,4,2,2008-11-06 16:47:13,2008-11-06 16:47:13
675ee5c1373fda3b2bb4e5076b3c476308078fa6...335f4ac03d95a1873c3be7739de8fb3ba6b15a9e,5,28,13,41,15,2008-11-06 19:53:36,2008-11-06 19:53:36
335f4ac03d95a1873c3be7739de8fb3ba6b15a9e...f56df044dcd9db07c2c2840e593e0df957886816,2,12,7,19,8,2008-11-06 21:37:08,2008-11-06 21:37:08
f56df044dcd9db07c2c2840e593e0df957886816...dc0389cca04bf84dbc32ca2c9e1e6d5c3267e51a,2,63,15,78,17,2008-11-08 01:53:20,2008-11-08 01:53:20
dc0389cca04bf84dbc32ca2c9e1e6d5c3267e51a...3ced836c73583bf054709e6312a2ba674a9bc633,2,13,1,14,2,2008-11-09 18:54:12,2008-11-09 18:54:12
3ced836c73583bf054709e6312a2ba674a9bc633...a24d80f193b0a1e0da1cdcb1d183bd3763f69cad,1,2,2,4,1,2008-11-09 19:02:54,2008-11-09 19:02:54
a24d80f193b0a1e0da1cdcb1d183bd3763f69cad...e6c2f496eb9f9321a763f65927bb1ce0d802d0ed,3,18,9,27,11,2008-11-10 09:57:23,2008-11-10 09:57:23
e6c2f496eb9f9321a763f65927bb1ce0d802d0ed...6b7f2bdad29a8e7e41886175d2f9c188f1f734da,6,4271,2,4273,7,2008-11-10 10:21:50,2008-11-10 10:21:50
6b7f2bdad29a8e7e41886175d2f9c188f1f734da...24860ccbd4c95505bac7c9721c43920470c5c39a,2,13,8,21,9,2008-11-10 10:22:24,2008-11-10 10:22:24
24860ccbd4c95505bac7c9721c43920470c5c39a...df8cb5016dd423e24f6afc9c849176493db735eb,2,224,90,314,75,2008-11-10 10:37:03,2008-11-10 10:37:03
df8cb5016dd423e24f6afc9c849176493db735eb...4a3dcd7f5ee56c4bd28c2fbb27465bae039e61b9,2,4,4,8,4,2008-11-10 17:26:13,2008-11-10 17:26:13
4a3dcd7f5ee56c4bd28c2fbb27465bae039e61b9...8c31bb7ca366b6daf393e7f1b4d695837c7f5795,2,4,1,5,3,2008-11-10 19:46:13,2008-11-10 19:46:13
8c31bb7ca366b6daf393e7f1b4d695837c7f5795...21e0efcd64b7aa0ffdbb7254574644af6d7b7727,2,21,11,32,6,2008-11-10 20:04:42,2008-11-10 20:04:42
21e0efcd64b7aa0ffdbb7254574644af6d7b7727...1ea005729647808888aa823718305df8e58c9787,1,1,1,2,1,2008-11-11 03:00:27,2008-11-11 03:00:27
1ea005729647808888aa823718305df8e58c9787...11736980a4c3ee023ceec55cf47ef3e19818dcac,5,24,6,30,6,2008-11-11 17:28:43,2008-11-11 17:28:43
11736980a4c3ee023ceec55cf47ef3e19818dcac...2a1c9072fb7db5085c817912ed8df6c48ed0bb7e,2,16,2,18,3,2008-11-12 00:38:48,2008-11-12 00:38:48
2a1c9072fb7db5085c817912ed8df6c48ed0bb7e...7a1421189c9eeb9bf9377ec7cdfd698ca9748f27,0,0,0,0,0,2008-11-12 11:29:50,2008-11-12 11:29:50
7a1421189c9eeb9bf9377ec7cdfd698ca9748f27...cecbed5ac97bb5b2717a50e765fb9ac22915881c,1,8,1,9,4,2008-11-12 11:35:34,2008-11-12 11:35:34
cecbed5ac97bb5b2717a50e765fb9ac22915881c...8ec6b87c42722025648732a1f52b1bb561d844c9,1,1,1,2,1,2008-11-12 11:53:16,2008-11-12 11:53:16
8ec6b87c42722025648732a1f52b1bb561d844c9...a2e02a583052bb6061d8c55d5bbf264e85fba0e9,1,20,5,25,5,2008-11-12 16:25:36,2008-11-12 16:25:36
a2e02a583052bb6061d8c55d5bbf264e85fba0e9...7d3450ddee67268ec4282fcc54e5c8efc4d8cd05,2,22,17,39,17,2008-11-12 23:29:24,2008-11-12 23:29:24
7d3450ddee67268ec4282fcc54e5c8efc4d8cd05...fd0c24b876f318120a7f0b471fba7ada7f7b61cd,2,29,17,46,18,2008-11-13 18:07:06,2008-11-13 18:07:06
fd0c24b876f318120a7f0b471fba7ada7f7b61cd...c8dcbb038af7fc901c750853a8a2e06bcc027e87,2,28,17,45,19,2008-11-13 18:07:51,2008-11-13 18:07:51
c8dcbb038af7fc901c750853a8a2e06bcc027e87...f219136e11f56a5765b58af476c93e806b2f3ce0,8,140,3,143,11,2008-11-13 19:05:49,2008-11-13 19:05:49
f219136e11f56a5765b58af476c93e806b2f3ce0...ac832a285f3a6318fab8f55a10401c86826637e9,2,26,4,30,6,2008-11-13 19:11:08,2008-11-13 19:11:08
ac832a285f3a6318fab8f55a10401c86826637e9...4007ac09e49a8a4b8df01119c01752b759cfb7b0,2,12,2,14,3,2008-11-13 23:53:52,2008-11-13 23:53:52
4007ac09e49a8a4b8df01119c01752b759cfb7b0...aef9663625c31ecfdeb91f25eb1631ef3ed4b5dd,1,7,24,31,3,2008-11-14 00:56:12,2008-11-14 00:56:12
aef9663625c31ecfdeb91f25eb1631ef3ed4b5dd...c1fdbb0efe2d3388ebefd9decf107b4a8b353efb,2,29,20,49,21,2008-11-14 02:48:29,2008-11-14 02:48:29
c1fdbb0efe2d3388ebefd9decf107b4a8b353efb...dab02d4f84265b3ab4990dc55920dddbcc679866,2,36,21,57,22,2008-11-14 07:14:58,2008-11-14 07:14:58
dab02d4f84265b3ab4990dc55920dddbcc679866...28ad8113293c9ada2d63da111a7bceea831858f6,5,4239,1,4240,4,2008-11-14 07:22:12,2008-11-14 07:22:12
28ad8113293c9ada2d63da111a7bceea831858f6...1c6f2b9ec8ee37dfcc2c712ebe39fb9be99506f5,2,231,86,317,87,2008-11-14 07:23:10,2008-11-14 07:23:10
1c6f2b9ec8ee37dfcc2c712ebe39fb9be99506f5...68a74843d75ee8003213ddb0a3ec474fb621b909,1,1,1,2,1,2008-11-14 07:42:50,2008-11-14 07:42:50
68a74843d75ee8003213ddb0a3ec474fb621b909...539d947ad46b12c51d2de9bd8a08be6cb7866608,1,2,2,4,2,2008-11-14 07:43:26,2008-11-14 07:43:26
539d947ad46b12c51d2de9bd8a08be6cb7866608...659f982150e03b65026097a667666c4e230b7652,1,2,2,4,2,2008-11-14 07:51:16,2008-11-14 07:51:16
659f982150e03b65026097a667666c4e230b7652...1b68c6a50f3048764a2be55afbf39a3060ac66b4,1,2,2,4,1,2008-11-14 08:07:11,2008-11-14 08:07:11
1b68c6a50f3048764a2be55afbf39a3060ac66b4...51dabd28193226f448a7c2d37c95f39d55c9612b,1,5,3,8,2,2008-11-14 08:07:39,2008-11-14 08:07:39
51dabd28193226f448a7c2d37c95f39d55c9612b...dbe18ce542618b38b7e2461696b4c2d0ba776668,2,8,12,20,3,2008-11-14 14:52:55,2008-11-14 14:52:55
dbe18ce542618b38b7e2461696b4c2d0ba776668...385f2fe2b5b5589c443d5db928fda51482d59fce,1,3,9,12,2,2008-11-14 15:40:26,2008-11-14 15:40:26
385f2fe2b5b5589c443d5db928fda51482d59fce...014c56366266f4bc7775b28a265bf4a2961266d6,2,24,18,42,13,2008-11-15 01:24:53,2008-11-15 01:24:53
014c56366266f4bc7775b28a265bf4a2961266d6...781a1763d94c7e867d9ba80b3f075526510a3482,2,16,1,17,4,2008-11-15 02:21:32,2008-11-15 02:21:32
781a1763d94c7e867d9ba80b3f075526510a3482...087f8aa7819c7058bd3c2456cd406978751b3087,1,1,0,1,1,2008-11-15 02:51:10,2008-11-15 02:51:10
087f8aa7819c7058bd3c2456cd406978751b3087...0cee58d750db6adead9705dffd45cf3f32ae1806,2,73,0,73,2,2008-11-15 05:20:08,2008-11-15 05:20:08
0cee58d750db6adead9705dffd45cf3f32ae1806...a703cc9970a977a72c804187660b2cb9a7f2a83f,1,0,4,4,1,2008-11-15 05:35:52,2008-11-15 05:35:52
a703cc9970a977a72c804187660b2cb9a7f2a83f...a4782f05813063b8cb744f497f8f230637839ac8,1,1,1,2,1,2008-11-15 05:39:58,2008-11-15 05:39:58
a4782f05813063b8cb744f497f8f230637839ac8...c0feb2fad97434ffb763f55ea03fe16d797661f0,11,30,61,91,18,2008-11-15 05:56:01,2008-11-15 05:56:01
c0feb2fad97434ffb763f55ea03fe16d797661f0...9b93e49ae585207b1e16682553baee5ab128232a,1,2,3,5,1,2008-11-15 05:58:08,2008-11-15 05:58:08
9b93e49ae585207b1e16682553baee5ab128232a...08ae5910b0ecf31ed6254e245ce9b4278b6bc68d,1,1,1,2,1,2008-11-15 06:00:14,2008-11-15 06:00:14
08ae5910b0ecf31ed6254e245ce9b4278b6bc68d...13f63f051bf2f571c55070a8bd72ffee52988d59,1,1,1,2,1,2008-11-15 06:00:26,2008-11-15 06:00:26
13f63f051bf2f571c55070a8bd72ffee52988d59...137d27ada6707da49775f519ed0fb4f2252883bf,1,1,1,2,1,2008-11-15 06:28:20,2008-11-15 06:28:20
137d27ada6707da49775f519ed0fb4f2252883bf...197892ab6c0f835982eb4b5a907d5165b957d4a8,1,0,1,1,1,2008-11-15 12:31:36,2008-11-15 12:31:36
197892ab6c0f835982eb4b5a907d5165b957d4a8...d7e18567762fd33f0be8686cc948e9ea5e900d86,2,15,3,18,5,2008-11-16 08:55:10,2008-11-16 08:55:10
d7e18567762fd33f0be8686cc948e9ea5e900d86...aed11333f1dae7cd92e9171ef219a926b0e9cac6,2,15,12,27,10,2008-11-16 08:57:10,2008-11-16 08:57:10
aed11333f1dae7cd92e9171ef219a926b0e9cac6...f42df5fc3f3591d9f6bb02a37f388b0e9c1a19b4,1,5,5,10,3,2008-11-16 09:38:40,2008-11-16 09:38:40
f42df5fc3f3591d9f6bb02a37f388b0e9c1a19b4...73d32af430ca50b6de3f072aaebd53fb20878c35,1,6,0,6,1,2008-11-16 16:39:06,2008-11-16 16:39:06
73d32af430ca50b6de3f072aaebd53fb20878c35...5adf72e3ad92c724791adc78322b08d8468fe438,0,0,0,0,0,2008-11-16 19:04:51,2008-11-16 19:04:51
5adf72e3ad92c724791adc78322b08d8468fe438...bdae3cc27d673feefed0a24fa9248256b53ef85a,2,17,1,18,3,2008-11-16 19:08:53,2008-11-16 19:08:53
bdae3cc27d673feefed0a24fa9248256b53ef85a...174f35bdead160e314087ff30a650ffe02b35d3a,1,4,0,4,3,2008-11-17 03:01:07,2008-11-17 03:01:07
174f35bdead160e314087ff30a650ffe02b35d3a...ac521026db1890831c9e0cff0f547f46599e8466,1,2,0,2,1,2008-11-17 18:12:28,2008-11-17 18:12:28
ac521026db1890831c9e0cff0f547f46599e8466...0ab5dad0b3e3b4097d72683e0091ff56d09429e4,2,4,0,4,4,2008-11-17 18:22:39,2008-11-17 18:22:39
0ab5dad0b3e3b4097d72683e0091ff56d09429e4...857e3aa5483f86d1a10e0f6e52ade8199f5a895d,2,0,4,4,4,2008-11-17 18:47:01,2008-11-17 18:47:01
857e3aa5483f86d1a10e0f6e52ade8199f5a895d...cc0e00ebbe4fcf4a333215239063dc753abc5aeb,1,5,5,10,1,2008-11-18 06:37:50,2008-11-18 06:37:50
cc0e00ebbe4fcf4a333215239063dc753abc5aeb...6aff7f476859c0d9a07e7900d029846c4d70d4de,2,79,65,144,67,2008-11-18 22:25:08,2008-11-18 22:25:08
6aff7f476859c0d9a07e7900d029846c4d70d4de...371fee791bf1cee5deaff87b8393de32e9a73193,2,96,82,178,79,2008-11-18 22:29:05,2008-11-18 22:29:05
371fee791bf1cee5deaff87b8393de32e9a73193...92754ac35ecebbb972ae07d3cd65ab13ad3a405e,1,53,0,53,1,2008-11-19 05:17:58,2008-11-19 05:17:58
92754ac35ecebbb972ae07d3cd65ab13ad3a405e...f6d68380b62c32dd9c062c7d82b46503446bf3e6,1,1,0,1,1,2008-11-19 05:21:03,2008-11-19 05:21:03
f6d68380b62c32dd9c062c7d82b46503446bf3e6...9ba5b12ca396880bab12eb18a809bf9f6d5728b9,1,2,2,4,1,2008-11-19 05:23:58,2008-11-19 05:23:58
9ba5b12ca396880bab12eb18a809bf9f6d5728b9...ef784f94d8bc3c194f15cd05f36cf96699cbf6e6,1,1,1,2,1,2008-11-19 05:27:25,2008-11-19 05:27:25
ef784f94d8bc3c194f15cd05f36cf96699cbf6e6...deab35c149608c461fe0d5961a3d06829ef4600b,1,1,0,1,1,2008-11-19 05:40:16,2008-11-19 05:40:16
deab35c149608c461fe0d5961a3d06829ef4600b...76c77acc517d816c90a84711697281ea75cc8044,1,0,1,1,1,2008-11-19 06:01:22,2008-11-19 06:01:22
76c77acc517d816c90a84711697281ea75cc8044...f952314532aac581da090570ee82b27a413b7170,1,1,1,2,1,2008-11-19 06:01:45,2008-11-19 06:01:45
f952314532aac581da090570ee82b27a413b7170...5cc5451a3f198022857de1f19c736319ee6b72f7,4,58,46,104,47,2008-11-19 16:24:11,2008-11-19 16:24:11
5cc5451a3f198022857de1f19c736319ee6b72f7...0f5258684eb11f144795d5e9f49b80b6ffc09e01,1,1,1,2,1,2008-11-20 19:02:17,2008-11-20 19:02:17
0f5258684eb11f144795d5e9f49b80b6ffc09e01...d75628fbe8742b27ac1f4e7f0ae98d73bc4030a5,2,1,1,2,1,2008-11-21 11:52:52,2008-11-21 11:52:52
d75628fbe8742b27ac1f4e7f0ae98d73bc4030a5...8bcde6492ae77aec45e62205e6d133bf91c361dd,1,1,1,2,1,2008-11-21 12:08:11,2008-11-21 12:08:11
8bcde6492ae77aec45e62205e6d133bf91c361dd...3ea4dd111cb9d3356b684d7290f0f940b06c6572,0,0,0,0,0,2008-11-21 15:30:18,2008-11-21 15:30:18
3ea4dd111cb9d3356b684d7290f0f940b06c6572...33dac7afd73e70abd976ce1a68a23aab743349e5,1,4,3,7,4,2008-11-21 15:35:15,2008-11-21 15:35:15
33dac7afd73e70abd976ce1a68a23aab743349e5...7f06c373d2e5a4aff8a5fb813d6477856389c6e4,1,1,1,2,1,2008-11-21 16:26:08,2008-11-21 16:26:08
7f06c373d2e5a4aff8a5fb813d6477856389c6e4...df9254c2f3fb7e8b0366f576d452925270c323dd,1,1,1,2,1,2008-11-21 16:56:24,2008-11-21 16:56:24
df9254c2f3fb7e8b0366f576d452925270c323dd...94c0aa7d84a76b10443afbbbed9d6b1fb6d6529d,1,4,2,6,1,2008-11-21 17:42:50,2008-11-21 17:42:50
94c0aa7d84a76b10443afbbbed9d6b1fb6d6529d...f93b9ead80bd31c2e7f000993336ea1ebcf22ad1,1,0,5,5,1,2008-11-21 17:49:19,2008-11-21 17:49:19
f93b9ead80bd31c2e7f000993336ea1ebcf22ad1...1ca99e901f8ba947489dd9ed498f7c416ac64896,2,83,75,158,76,2008-11-23 20:27:54,2008-11-23 20:27:54
1ca99e901f8ba947489dd9ed498f7c416ac64896...b3f278258abca57c865dc1b6296a073f83a73a54,1,2,2,4,2,2008-11-26 21:22:07,2008-11-26 21:22:07
b3f278258abca57c865dc1b6296a073f83a73a54...19cb720df755b8ab9717b4e5693a08967ef68655,1,2,2,4,2,2008-11-29 11:55:05,2008-11-29 11:55:05
19cb720df755b8ab9717b4e5693a08967ef68655...931d96e065fd872e759b0c53cd1f38be59fdca64,1,2,1,3,1,2008-12-02 06:00:44,2008-12-02 06:00:44
931d96e065fd872e759b0c53cd1f38be59fdca64...c61ebbe2bac2f1b0a746465e84415564f03876c2,1,14,0,14,2,2008-12-02 06:01:14,2008-12-02 06:01:14
c61ebbe2bac2f1b0a746465e84415564f03876c2...af6b7cdc6332299d04d90154123afc6ac6bc5ec9,3,102,2,104,3,2008-12-02 13:34:00,2008-12-02 13:34:00
af6b7cdc6332299d04d90154123afc6ac6bc5ec9...4c7efda28ff2e382efc92cdfc83cd8d9272c6a34,2,4,2,6,3,2008-12-02 16:59:39,2008-12-02 16:59:39
4c7efda28ff2e382efc92cdfc83cd8d9272c6a34...a261602bd3e9e2e76559ce4257bf32ce95b71d54,2,10,1,11,3,2008-12-02 18:42:30,2008-12-02 18:42:30
a261602bd3e9e2e76559ce4257bf32ce95b71d54...500021a9233dee9a4bd1fc6c88a586d720905f89,1,4,3,7,2,2008-12-03 05:53:26,2008-12-03 05:53:26
500021a9233dee9a4bd1fc6c88a586d720905f89...8c6a6f3b1a3c849235615d960691bf66822d12f5,1,6,6,12,1,2008-12-03 05:53:57,2008-12-03 05:53:57
8c6a6f3b1a3c849235615d960691bf66822d12f5...c667fdd4d8dcdd83ccf56d352d17d479cdcbcfd5,1,5,5,10,5,2008-12-04 05:39:50,2008-12-04 05:39:50
c667fdd4d8dcdd83ccf56d352d17d479cdcbcfd5...c1ec41a91ab2ad03bed53f0e52f6bf88e707bc93,1,3,2,5,2,2008-12-04 19:34:23,2008-12-04 19:34:23
c1ec41a91ab2ad03bed53f0e52f6bf88e707bc93...687823640d954a8bdd4002082694e4579848a4c3,1,1,2,3,1,2008-12-04 19:34:54,2008-12-04 19:34:54
687823640d954a8bdd4002082694e4579848a4c3...cad3c019cc9a3fa903d709694454a407e65d9a19,1,1,1,2,1,2008-12-06 01:24:59,2008-12-06 01:24:59
cad3c019cc9a3fa903d709694454a407e65d9a19...35b0499905c9d8e893a86df7ce770974549295a1,3,16,2,18,4,2008-12-06 02:01:38,2008-12-06 02:01:38
35b0499905c9d8e893a86df7ce770974549295a1...1eac2453a5569b22b24133808ba3c7a5595c9bd8,5,4304,1498,5802,466,2008-12-07 03:23:33,2008-12-07 03:23:33
1eac2453a5569b22b24133808ba3c7a5595c9bd8...3653a53dbace9bbd188b99b66a3c1abbe778c723,5,1731,1730,3461,1093,2008-12-07 03:25:20,2008-12-07 03:25:20
3653a53dbace9bbd188b99b66a3c1abbe778c723...3594f322edd56eee0e68f282d8c950f1b9478765,1,1,1,2,1,2008-12-07 03:48:39,2008-12-07 03:48:39
3594f322edd56eee0e68f282d8c950f1b9478765...8479543fd767fb5181a5c6018be68875743b23b3,1,7,0,7,1,2008-12-07 03:49:06,2008-12-07 03:49:06
8479543fd767fb5181a5c6018be68875743b23b3...cb2e4e80bc9a2116a4079b875a8dd628ab89145c,1,4,4,8,4,2008-12-07 03:49:38,2008-12-07 03:49:38
cb2e4e80bc9a2116a4079b875a8dd628ab89145c...dc8673585931cb2f129e354e886b5809d4b3a9b4,1,1,1,2,1,2008-12-07 03:56:50,2008-12-07 03:56:50
dc8673585931cb2f129e354e886b5809d4b3a9b4...76cf4db4947254c65df60bfa0df85f49b6703cb2,1,6,6,12,3,2008-12-07 04:03:30,2008-12-07 04:03:30
76cf4db4947254c65df60bfa0df85f49b6703cb2...a8a4743b1d2ab84feb9f8e3a2cd5783bce9d178b,2,19,1,20,3,2008-12-07 05:50:26,2008-12-07 05:50:26
a8a4743b1d2ab84feb9f8e3a2cd5783bce9d178b...61e36bd7d1a00bcfca1c59af350ed6e64027efc7,2,54,21,75,14,2008-12-08 02:47:05,2008-12-08 02:47:05
61e36bd7d1a00bcfca1c59af350ed6e64027efc7...89f2a5892d4546671eacafc50d48f0753b659685,1,14,14,28,11,2008-12-08 05:29:43,2008-12-08 05:29:43
89f2a5892d4546671eacafc50d48f0753b659685...3c4c1adefbd0d8148845f1562d54b5dd902d65e7,1,3,1,4,2,2008-12-08 05:36:53,2008-12-08 05:36:53
3c4c1adefbd0d8148845f1562d54b5dd902d65e7...85e1d876c0ca7967452dc8e66ce4dc14b55dea85,1,1,1,2,1,2008-12-08 05:42:39,2008-12-08 05:42:39
85e1d876c0ca7967452dc8e66ce4dc14b55dea85...bffb45786297b11e6f189c302d084afca670709a,3,12,7,19,3,2008-12-08 08:23:52,2008-12-08 08:23:52
bffb45786297b11e6f189c302d084afca670709a...4dcff3e684f837d31ab1fcc6f33221d682340745,1,2,1,3,1,2008-12-08 08:24:32,2008-12-08 08:24:32
4dcff3e684f837d31ab1fcc6f33221d682340745...974135fc7e11c69badce74dc8108c9534a39c4c6,1,16,1,17,4,2008-12-08 14:34:28,2008-12-08 14:34:28
974135fc7e11c69badce74dc8108c9534a39c4c6...067361b9c577e89bbc568c43a0d2e70b519c7c2c,1,1,1,2,1,2008-12-08 14:52:39,2008-12-08 14:52:39
067361b9c577e89bbc568c43a0d2e70b519c7c2c...8c71c6607ad4034a9753a694797e11dcedc30053,0,0,0,0,0,2008-12-08 17:01:17,2008-12-08 17:01:17
8c71c6607ad4034a9753a694797e11dcedc30053...a9c5bf106c17b2785cf55f3269e719eca7a51bd4,1,4,3,7,1,2008-12-08 17:18:50,2008-12-08 17:18:50
a9c5bf106c17b2785cf55f3269e719eca7a51bd4...1a3a03c5f0d31c9ecaf30221ef688e48b6e2b6d8,1,9,9,18,6,2008-12-08 18:37:08,2008-12-08 18:37:08
1a3a03c5f0d31c9ecaf30221ef688e48b6e2b6d8...7edf9149d761aab89eaa62efa6dd128f9e795440,1,111,8,119,6,2008-12-09 00:36:25,2008-12-09 00:36:25
7edf9149d761aab89eaa62efa6dd128f9e795440...3988cb2d2717a12f274370b864ffa7c8efe0e954,1,73,77,150,40,2008-12-09 04:20:54,2008-12-09 04:20:54
3988cb2d2717a12f274370b864ffa7c8efe0e954...86115228981b1a480a3200d2a4e30c000ac08acb,1,12,5,17,4,2008-12-09 06:51:23,2008-12-09 06:51:23
86115228981b1a480a3200d2a4e30c000ac08acb...bc2cc6eb094d61f41d60d32e03b82d921d210ff2,1,2,2,4,2,2008-12-09 07:18:02,2008-12-09 07:18:02
bc2cc6eb094d61f41d60d32e03b82d921d210ff2...2e4336b659a2df713ebbd90ff8f8618c20f29369,1,1,1,2,1,2008-12-09 07:18:32,2008-12-09 07:18:32
2e4336b659a2df713ebbd90ff8f8618c20f29369...4aaa15e81269e4e44247d92f3a8759024653d6d1,1,12,1,13,2,2008-12-09 07:35:34,2008-12-09 07:35:34
4aaa15e81269e4e44247d92f3a8759024653d6d1...707d144c30382e1ad55e65b165ea37d059d97550,2,37,11,48,2,2008-12-09 22:42:10,2008-12-09 22:42:10
707d144c30382e1ad55e65b165ea37d059d97550...1a12506846eed2d370eaa41d2d6407b6771cb5a2,1,2,1,3,1,2008-12-09 22:49:16,2008-12-09 22:49:16
1a12506846eed2d370eaa41d2d6407b6771cb5a2...c9a6c06de89682386461fbf0071ba884983115f6,1,4,1,5,1,2008-12-09 23:06:45,2008-12-09 23:06:45
c9a6c06de89682386461fbf0071ba884983115f6...24a1900b3699fe883b027cfacfd7fe9ff117491f,3,9,7,16,8,2008-12-10 00:14:56,2008-12-10 00:14:56
24a1900b3699fe883b027cfacfd7fe9ff117491f...349405009f4b3127d69e4b07d2ec62ad047b41e9,1,3,2,5,1,2008-12-10 01:53:02,2008-12-10 01:53:02
349405009f4b3127d69e4b07d2ec62ad047b41e9...02b15e87d2901f5f98d4c37e428ca6ee4cebf601,0,0,0,0,0,2008-12-10 15:39:15,2008-12-10 15:39:15
02b15e87d2901f5f98d4c37e428ca6ee4cebf601...6ff50eb24c28c6dc5bb7a4f50075919544585d23,0,0,0,0,0,2008-12-10 15:50:42,2008-12-10 15:50:42
6ff50eb24c28c6dc5bb7a4f50075919544585d23...08d47a16e3e0bf8f593f4d91fa2071b2f6c9a2ef,1,4,4,8,4,2008-12-10 16:13:14,2008-12-10 16:13:14
08d47a16e3e0bf8f593f4d91fa2071b2f6c9a2ef...0efff2c032c6f7fb712a0ffdb772e38ce865d504,1,0,3,3,1,2008-12-11 07:07:03,2008-12-11 07:07:03
0efff2c032c6f7fb712a0ffdb772e38ce865d504...aca5a5258c3076f5a569cdad89ad8f38ad546aa0,1,78,57,135,23,2008-12-11 20:12:34,2008-12-11 20:12:34
aca5a5258c3076f5a569cdad89ad8f38ad546aa0...0a0aba5f5eb200f8a9ccf28c62a3db852234130f,3,19,4,23,5,2008-12-16 04:54:29,2008-12-16 04:54:29
0a0aba5f5eb200f8a9ccf28c62a3db852234130f...518c4ca2a8ce589d8524357c47aba097cd29f47f,1,7,2,9,6,2008-12-16 06:48:15,2008-12-16 06:48:15
518c4ca2a8ce589d8524357c47aba097cd29f47f...01e04e90e0f69e3b350301015f17a6cb4aa7d39a,3,52,12,64,7,2008-12-16 06:49:43,2008-12-16 06:49:43
01e04e90e0f69e3b350301015f17a6cb4aa7d39a...8cc518a96432644596dba5167bacd694bbf7ab4a,0,0,0,0,0,2008-12-16 14:26:02,2008-12-16 14:26:02
8cc518a96432644596dba5167bacd694bbf7ab4a...75ea7a434a5c5a8b2b040ad4461149430e6e03dd,1,2,0,2,2,2008-12-16 14:34:12,2008-12-16 14:34:12
75ea7a434a5c5a8b2b040ad4461149430e6e03dd...ae5c9b33d0e7b2de6202b1bf841276f0a0d3c623,4,187,8,195,10,2008-12-16 17:53:33,2008-12-16 17:53:33
ae5c9b33d0e7b2de6202b1bf841276f0a0d3c623...3c9aaaef34366431773e1fd1fab65bbee42a9c24,1,1,1,2,1,2008-12-17 01:50:11,2008-12-17 01:50:11
3c9aaaef34366431773e1fd1fab65bbee42a9c24...26554aa6b2444e1e3b1641bec773229d292c5587,1,1,1,2,1,2008-12-21 04:23:35,2008-12-21 04:23:35
26554aa6b2444e1e3b1641bec773229d292c5587...73534cd9420a27eda6c725635fa1e4a3f1f9fbac,2,43,2,45,5,2008-12-21 04:58:59,2008-12-21 04:58:59
73534cd9420a27eda6c725635fa1e4a3f1f9fbac...6dd5c855d41ce0e4153742e7dff3335ee194cc64,1,2,2,4,2,2008-12-22 04:19:41,2008-12-22 04:19:41
6dd5c855d41ce0e4153742e7dff3335ee194cc64...6c3a98ab3a559366c5de066feaf40e379bb42ef3,1,1,1,2,1,2008-12-22 23:24:34,2008-12-22 23:24:34
6c3a98ab3a559366c5de066feaf40e379bb42ef3...518e19a36305b550d29457f1da3f251a886b11e9,2,9,5,14,6,2008-12-23 00:03:19,2008-12-23 00:03:19
518e19a36305b550d29457f1da3f251a886b11e9...47de671948e4bf806a5fc14bfe51a932232705b5,1,2,2,4,2,2008-12-23 00:15:03,2008-12-23 00:15:03
47de671948e4bf806a5fc14bfe51a932232705b5...44239004db9acc392019edda692c58b64fe5f3c8,1,2,3,5,3,2008-12-23 04:14:51,2008-12-23 04:14:51
44239004db9acc392019edda692c58b64fe5f3c8...1d37663aef8790426e63d1853a50d40d2cf86cd4,1,2,2,4,1,2008-12-23 05:22:10,2008-12-23 05:22:10
1d37663aef8790426e63d1853a50d40d2cf86cd4...9841776ec3dde024c244631ae13da7c24b927f5b,1,11,9,20,8,2008-12-23 05:52:57,2008-12-23 05:52:57
9841776ec3dde024c244631ae13da7c24b927f5b...3abbb455b2141b4733ac3eb8cb52c826b15c07fd,5,51,1,52,7,2008-12-23 18:28:22,2008-12-23 18:28:22
3abbb455b2141b4733ac3eb8cb52c826b15c07fd...fd9ddb2dc10d962709f5f2de72addc702a1884b9,2,30,5,35,7,2008-12-26 06:02:44,2008-12-26 06:02:44
fd9ddb2dc10d962709f5f2de72addc702a1884b9...04ce539ad21e3faba1865625040499a3e4b7976a,2,2,2,4,2,2008-12-26 16:04:48,2008-12-26 16:04:48
04ce539ad21e3faba1865625040499a3e4b7976a...d2c9c1261a816c73b6622885d1caf770ec650180,4,18,9,27,13,2008-12-26 20:07:36,2008-12-26 20:07:36
d2c9c1261a816c73b6622885d1caf770ec650180...fadccc6494b215b5c72a1f762936ee53981dc83a,0,0,0,0,0,2008-12-30 15:22:04,2008-12-30 15:22:04
fadccc6494b215b5c72a1f762936ee53981dc83a...1f2e21ba07d42ef876451157969d2d47245b6bba,0,0,0,0,0,2008-12-30 15:27:09,2008-12-30 15:27:09
1f2e21ba07d42ef876451157969d2d47245b6bba...94b83db4995ea8b763fef607141a246cb5c52c37,1,2,2,4,2,2009-01-03 01:42:56,2009-01-03 01:42:56
94b83db4995ea8b763fef607141a246cb5c52c37...f2986d89b9fe74ebfc9d544324333c9ebde84ad5,4,18,4,22,8,2009-01-03 04:59:05,2009-01-03 04:59:05
f2986d89b9fe74ebfc9d544324333c9ebde84ad5...7982e5c5100f88314a167248dfd7d89fb9d46266,1,29,27,56,27,2009-01-03 05:06:22,2009-01-03 05:06:22
7982e5c5100f88314a167248dfd7d89fb9d46266...e8ddef57d8379f430456eee4253db612e72a63c2,1,3,3,6,2,2009-01-06 01:57:03,2009-01-06 01:57:03
e8ddef57d8379f430456eee4253db612e72a63c2...ff3320cb6dffba80058c0b88318c2f314f024497,2,47,2,49,5,2009-01-06 03:35:46,2009-01-06 03:35:46
ff3320cb6dffba80058c0b88318c2f314f024497...f6cacacbfffca4676be10b439f295207e5ee8ba7,2,5,4,9,2,2009-01-06 18:25:52,2009-01-06 18:25:52
f6cacacbfffca4676be10b439f295207e5ee8ba7...f3f251a6dea1e9387a6a47d5cea3cfcdaa168ce2,1,6,6,12,9,2009-01-07 20:23:23,2009-01-07 20:23:23
f3f251a6dea1e9387a6a47d5cea3cfcdaa168ce2...fe9cd02f383841de6a758cd2f796bb93f2cfabc1,2,17,20,37,3,2009-01-08 05:16:47,2009-01-08 05:16:47
fe9cd02f383841de6a758cd2f796bb93f2cfabc1...cc76b89c5967e77fcbb4f0772526387066822497,3,18,1,19,4,2009-01-08 05:51:15,2009-01-08 05:51:15
cc76b89c5967e77fcbb4f0772526387066822497...2842f5979a20d86ce1abdb48de8b94f6f29bf180,4,231,83,314,83,2009-01-08 10:20:58,2009-01-08 10:20:58
2842f5979a20d86ce1abdb48de8b94f6f29bf180...195a6ea7913fe436f30558ea0913a5ebe147b394,2,526,330,856,233,2009-01-08 10:38:40,2009-01-08 10:38:40
195a6ea7913fe436f30558ea0913a5ebe147b394...37260e046f438e4eb871b6b84cafbf4fcd4b92ea,2,11,2,13,3,2009-01-09 12:42:35,2009-01-09 12:42:35
37260e046f438e4eb871b6b84cafbf4fcd4b92ea...8bf4e84c85dabb82124345fd6970991c4bbc9082,3,20,12,32,11,2009-01-13 02:21:07,2009-01-13 02:21:07
8bf4e84c85dabb82124345fd6970991c4bbc9082...610aedacca739fc134cdc7f9e9cc8566e828ac10,0,0,0,0,0,2009-01-14 15:33:07,2009-01-14 15:33:07
610aedacca739fc134cdc7f9e9cc8566e828ac10...8064e088e6728f67dc48c3f61f72f53169bd02cc,0,0,0,0,0,2009-01-14 15:37:23,2009-01-14 15:37:23
8064e088e6728f67dc48c3f61f72f53169bd02cc...7dd0abc113bc131ba037e83275e3bd9530b68903,0,0,0,0,0,2009-01-14 16:02:59,2009-01-14 16:02:59
7dd0abc113bc131ba037e83275e3bd9530b68903...0cc51e8fdd7cbc08f108bfed7d701bd9cb604860,11,6,12,18,12,2009-01-14 17:00:15,2009-01-14 17:00:15
0cc51e8fdd7cbc08f108bfed7d701bd9cb604860...43c1a8770811b6f9f619cdd3146d10a46518091a,1,1,1,2,1,2009-01-15 06:38:27,2009-01-15 06:38:27
43c1a8770811b6f9f619cdd3146d10a46518091a...ad93542c8fea08e8506369aef27b1c1f84d96c3c,2,46,3,49,7,2009-01-15 20:40:40,2009-01-15 20:40:40
ad93542c8fea08e8506369aef27b1c1f84d96c3c...7cef4ecd19b83e6592a1afaedf6aff6fcb7b9e6e,1,3,2,5,2,2009-01-16 09:00:24,2009-01-16 09:00:24
7cef4ecd19b83e6592a1afaedf6aff6fcb7b9e6e...4268ef3fdcb3662e382714f3894bc90eabc37181,1,4,1,5,1,2009-01-16 16:53:12,2009-01-16 16:53:12
4268ef3fdcb3662e382714f3894bc90eabc37181...f0e35e1bbe9c5e35717482c5c5df11abfc70fd76,2,49,12,61,11,2009-01-16 22:24:45,2009-01-16 22:24:45
f0e35e1bbe9c5e35717482c5c5df11abfc70fd76...2ffeea20130c41091bd69748dca1c9c5a3dd9c8c,0,0,0,0,0,2009-01-17 22:36:07,2009-01-17 22:36:07
2ffeea20130c41091bd69748dca1c9c5a3dd9c8c...02980f1c3cf23015b64f1d2ea3476c607ac0db66,1,2,2,4,2,2009-01-17 23:06:23,2009-01-17 23:06:23
02980f1c3cf23015b64f1d2ea3476c607ac0db66...5ce4031a6156112158011604bb41141b09a3546e,1,8,2,10,4,2009-01-18 22:09:56,2009-01-18 22:09:56
5ce4031a6156112158011604bb41141b09a3546e...3e19109ab61f851683d9a6427a52b4866071fa60,2,8,0,8,3,2009-01-19 12:48:41,2009-01-19 12:48:41
3e19109ab61f851683d9a6427a52b4866071fa60...709476ae0574ee19d35640c03770377cfca6d91d,2,18,1,19,3,2009-01-19 19:43:01,2009-01-19 19:43:01
709476ae0574ee19d35640c03770377cfca6d91d...ca777ab08cbadd8fe0f36a3baf69440c5aa9fa6d,1,1,1,2,1,2009-01-19 20:50:31,2009-01-19 20:50:31
ca777ab08cbadd8fe0f36a3baf69440c5aa9fa6d...042777c83822a6249ee7042a9700c08360fa44fa,0,0,0,0,0,2009-01-23 04:57:15,2009-01-23 04:57:15
042777c83822a6249ee7042a9700c08360fa44fa...47ed900b412f119824f9de79e47d9696f6bc2d97,1,2,2,4,1,2009-01-23 05:00:09,2009-01-23 05:00:09
47ed900b412f119824f9de79e47d9696f6bc2d97...405b87c4320093b4152b1a49a2f6e80780a5fdd0,1,78,4,82,1,2009-01-24 12:12:26,2009-01-24 12:12:26
405b87c4320093b4152b1a49a2f6e80780a5fdd0...aa0023b32cdbcf07d556a0cfd44fe6160803dae7,0,0,0,0,0,2009-01-29 20:19:52,2009-01-29 20:19:52
aa0023b32cdbcf07d556a0cfd44fe6160803dae7...0f8f27f4178a6b9f9835c02a4060667cec494191,1,1,1,2,1,2009-01-29 20:25:25,2009-01-29 20:25:25
0f8f27f4178a6b9f9835c02a4060667cec494191...c3df5d96d283e2ed9cd37047e1e3f3d55bbf05b9,0,0,0,0,0,2009-01-29 23:37:58,2009-01-29 23:37:58
c3df5d96d283e2ed9cd37047e1e3f3d55bbf05b9...2dce7064f4b249c269886a68852abcf9198a7438,1,26,0,26,1,2009-01-29 23:40:57,2009-01-29 23:40:57
2dce7064f4b249c269886a68852abcf9198a7438...8a1b24cc42ffa8278af6c3eddc1515747bd14ad4,1,12,6,18,2,2009-02-01 17:52:25,2009-02-01 17:52:25
8a1b24cc42ffa8278af6c3eddc1515747bd14ad4...5d417c44b71d038b1be3174e61dc9a58159616a4,1,2,2,4,1,2009-02-03 03:15:25,2009-02-03 03:15:25
5d417c44b71d038b1be3174e61dc9a58159616a4...ebd30acd1298ba20d77c986c1cdf54b3db26402b,0,0,0,0,0,2009-02-03 14:19:51,2009-02-03 14:19:51
ebd30acd1298ba20d77c986c1cdf54b3db26402b...962f0dbd7773a871f7a6a39ad28123249ec5586b,2,34,1,35,3,2009-02-03 14:24:06,2009-02-03 14:24:06
962f0dbd7773a871f7a6a39ad28123249ec5586b...b0fd405c28cea9edb1a91416b540eed3eba0bfac,1,3,3,6,1,2009-02-03 22:10:46,2009-02-03 22:10:46
b0fd405c28cea9edb1a91416b540eed3eba0bfac...c2838753894cbed7ee73c0fa85efa6b87c605598,1,2,1,3,1,2009-02-11 00:16:44,2009-02-11 00:16:44
c2838753894cbed7ee73c0fa85efa6b87c605598...5db8dc357323c1b87c8b110f25d3dbadeaa47c4e,3,20,3,23,8,2009-02-11 20:14:24,2009-02-11 20:14:24
5db8dc357323c1b87c8b110f25d3dbadeaa47c4e...8a89cf9d181aab833c2c9883c5de90482a04525c,1,12,1,13,3,2009-02-12 02:55:32,2009-02-12 02:55:32
8a89cf9d181aab833c2c9883c5de90482a04525c...0924264cd8242b2681c1604031dce42b860c11b1,2,71,65,136,63,2009-02-13 10:58:08,2009-02-13 10:58:08
0924264cd8242b2681c1604031dce42b860c11b1...a03486e081b0fecae4879c569a5c27d7699ec41e,2,70,62,132,62,2009-02-13 10:58:40,2009-02-13 10:58:40
a03486e081b0fecae4879c569a5c27d7699ec41e...0f84cf9dfe13786505de497c7f730b84101e81dd,2,6,6,12,6,2009-02-13 11:03:16,2009-02-13 11:03:16
0f84cf9dfe13786505de497c7f730b84101e81dd...b09a197a3e43d34ea3242a63fe814470ebc89269,2,61,61,122,21,2009-02-15 05:47:30,2009-02-15 05:47:30
b09a197a3e43d34ea3242a63fe814470ebc89269...910aa0ea288e107c11c4f9973c88158d47fe2bd5,2,224,181,405,78,2009-02-16 05:14:18,2009-02-16 05:14:18
910aa0ea288e107c11c4f9973c88158d47fe2bd5...d9b5a414ca2823bcbb8008c8d19efd8ad16f0c35,1,1,0,1,1,2009-02-21 07:29:21,2009-02-21 07:29:21
d9b5a414ca2823bcbb8008c8d19efd8ad16f0c35...267122978fb4cdb00a303b816487f0e6f803d3c1,5,7,3,10,5,2009-02-21 08:54:32,2009-02-21 08:54:32
267122978fb4cdb00a303b816487f0e6f803d3c1...a21e170de7c28f978b22fed934a5711814d46086,1,2,2,4,2,2009-02-22 06:37:47,2009-02-22 06:37:47
a21e170de7c28f978b22fed934a5711814d46086...429b57d642eeadee418d8a83ad7652133ac682ed,1,1,1,2,1,2009-02-22 06:39:55,2009-02-22 06:39:55
429b57d642eeadee418d8a83ad7652133ac682ed...8519146963fadd2317bf81fface6e2620395673c,1,17,16,33,17,2009-02-22 06:41:41,2009-02-22 06:41:41
8519146963fadd2317bf81fface6e2620395673c...1bd70b4e22b89d4d99804dd7344073bb9cc3d7fc,1,24,24,48,22,2009-02-22 06:43:35,2009-02-22 06:43:35
1bd70b4e22b89d4d99804dd7344073bb9cc3d7fc...624fc2e3977d1b76c5854c3779d382206d276783,0,0,0,0,0,2009-02-22 07:01:05,2009-02-22 07:01:05
624fc2e3977d1b76c5854c3779d382206d276783...0b619104dddc8e1532b44315c9590f594ceb5575,1,2,2,4,2,2009-02-22 07:03:16,2009-02-22 07:03:16
0b619104dddc8e1532b44315c9590f594ceb5575...49216f50c620e72570a2eee522efd7076c55b528,0,0,0,0,0,2009-02-22 07:13:17,2009-02-22 07:13:17
49216f50c620e72570a2eee522efd7076c55b528...b8797aebf0fc4b2a98e5a7bdc28589d8c126e4c1,1,5,5,10,4,2009-02-22 07:15:40,2009-02-22 07:15:40
b8797aebf0fc4b2a98e5a7bdc28589d8c126e4c1...d12ee872a1d3e62ce1af47f72d6d60da61ac68f0,1,37,37,74,33,2009-02-22 07:17:23,2009-02-22 07:17:23
d12ee872a1d3e62ce1af47f72d6d60da61ac68f0...16f05e78f178d337ff0b801740e571c70d60d757,2,11,0,11,2,2009-02-22 07:19:26,2009-02-22 07:19:26
16f05e78f178d337ff0b801740e571c70d60d757...3c48d866f66fffb266989bc06ed7e5215509cb72,1,1,1,2,1,2009-02-22 08:08:17,2009-02-22 08:08:17
3c48d866f66fffb266989bc06ed7e5215509cb72...ef66773cef78ba7753ebc7c5cafd08d865fbb04c,1,22,20,42,18,2009-02-22 08:38:42,2009-02-22 08:38:42
ef66773cef78ba7753ebc7c5cafd08d865fbb04c...315fd2434c530ff4488e30e61a09c83e509ebf5a,0,0,0,0,0,2009-02-22 09:23:21,2009-02-22 09:23:21
315fd2434c530ff4488e30e61a09c83e509ebf5a...8366ef412e6f36edbdd3b28d8ed1b1f96608e12e,0,0,0,0,0,2009-02-22 10:25:45,2009-02-22 10:25:45
8366ef412e6f36edbdd3b28d8ed1b1f96608e12e...c2807db68371dd84edb8244e748cb14a8a30c6df,2,101,14,115,16,2009-02-22 11:18:19,2009-02-22 11:18:19
c2807db68371dd84edb8244e748cb14a8a30c6df...eb442961f57536127eedc6106d269592b0d37e27,1,0,3,3,3,2009-02-22 11:25:25,2009-02-22 11:25:25
eb442961f57536127eedc6106d269592b0d37e27...93b3f89c312ad0f744e8351c27bd96a57ea5f284,2,6,1,7,2,2009-02-23 04:31:29,2009-02-23 04:31:29
93b3f89c312ad0f744e8351c27bd96a57ea5f284...bd2e7a787626a4cb8a8ec9a225d6d558f557f02a,0,0,0,0,0,2009-02-24 16:58:50,2009-02-24 16:58:50
bd2e7a787626a4cb8a8ec9a225d6d558f557f02a...734376f9473693b87db0bdc30a725500db0fb181,2,8,1,9,2,2009-02-24 17:02:03,2009-02-24 17:02:03
734376f9473693b87db0bdc30a725500db0fb181...3550aa2d14998b079b250f650832919d57113f1b,1,7,4,11,2,2009-02-24 17:05:36,2009-02-24 17:05:36
3550aa2d14998b079b250f650832919d57113f1b...c9a63889f6d51159e0c029d6210f50b44e247659,2,7,1,8,2,2009-02-24 17:28:33,2009-02-24 17:28:33
c9a63889f6d51159e0c029d6210f50b44e247659...f799959008b95f0e770ab35096de5b86659a962d,2,30,0,30,2,2009-02-26 17:18:16,2009-02-26 17:18:16
f799959008b95f0e770ab35096de5b86659a962d...424d158b01a1aeb4cb2104f93a4aa4789882a192,2,22,3,25,4,2009-02-27 05:00:38,2009-02-27 05:00:38
424d158b01a1aeb4cb2104f93a4aa4789882a192...2656e6bfa92f2b38bb5439454df424c2e5f49334,0,0,0,0,0,2009-02-27 13:27:11,2009-02-27 13:27:11
2656e6bfa92f2b38bb5439454df424c2e5f49334...7fdd26c582f7fa0472322591ba1bb78d91975948,5,2059,1566,3625,755,2009-02-28 01:24:24,2009-02-28 01:24:24
7fdd26c582f7fa0472322591ba1bb78d91975948...106bd0f49ebbc0cf2d20a06082f552c71346fa0e,2,29,2,31,2,2009-02-28 03:02:52,2009-02-28 03:02:52
106bd0f49ebbc0cf2d20a06082f552c71346fa0e...9b373d078942e23b1b5564996cf22d9e361450a3,1,5,3,8,4,2009-02-28 04:52:16,2009-02-28 04:52:16
9b373d078942e23b1b5564996cf22d9e361450a3...9b5b2ee2f3f64bdd71faf7631498d0892a7dbba2,2,13,7,20,2,2009-02-28 06:05:44,2009-02-28 06:05:44
9b5b2ee2f3f64bdd71faf7631498d0892a7dbba2...283c89e4c61fa99dfdf6688a12ed3ce5a3945347,2,9,3,12,4,2009-03-01 01:35:36,2009-03-01 01:35:36
283c89e4c61fa99dfdf6688a12ed3ce5a3945347...016f12a2c27fd6006d43cc32af734dfd0ea96f98,3,21,5,26,4,2009-03-01 01:59:18,2009-03-01 01:59:18
016f12a2c27fd6006d43cc32af734dfd0ea96f98...a899f7c662a6f77b9d0768ee7d35cf01cd74ec1e,1,1,1,2,1,2009-03-01 07:19:55,2009-03-01 07:19:55
a899f7c662a6f77b9d0768ee7d35cf01cd74ec1e...3fc72ca8a819dec0da5506dce810238df86a8ae4,1,6,1,7,1,2009-03-01 07:20:19,2009-03-01 07:20:19
3fc72ca8a819dec0da5506dce810238df86a8ae4...4d2de7a3074a56b8f373d3598dc36243091a4a45,2,6,1,7,2,2009-03-01 07:33:45,2009-03-01 07:33:45
4d2de7a3074a56b8f373d3598dc36243091a4a45...ec02cf7a856dcc2ebc4ec10a35d6e87c1400b8f6,2,12,2,14,3,2009-03-01 08:15:52,2009-03-01 08:15:52
ec02cf7a856dcc2ebc4ec10a35d6e87c1400b8f6...ec5a3e7a8df618ee50bfe627c4fabf487672a628,2,86,78,164,78,2009-03-01 14:24:08,2009-03-01 14:24:08
ec5a3e7a8df618ee50bfe627c4fabf487672a628...95763538358e6a3358bf0e253093576a21c3b74a,1,6,3,9,4,2009-03-02 03:17:30,2009-03-02 03:17:30
95763538358e6a3358bf0e253093576a21c3b74a...32be118081fab4ec62412d2dcb97b7d835b8d109,3,65,36,101,18,2009-03-02 04:57:03,2009-03-02 04:57:03
32be118081fab4ec62412d2dcb97b7d835b8d109...024917783680492f67e8f94fc9104b454e98a498,1,0,2,2,1,2009-03-02 05:19:51,2009-03-02 05:19:51
024917783680492f67e8f94fc9104b454e98a498...1a5588fcebbd0b5689773eb27b9a648d8cfb2aba,1,1,1,2,1,2009-03-02 05:47:25,2009-03-02 05:47:25
1a5588fcebbd0b5689773eb27b9a648d8cfb2aba...888b154e9b22f7ecab49376b608e1028462b1891,1,1,1,2,1,2009-03-02 08:26:07,2009-03-02 08:26:07
888b154e9b22f7ecab49376b608e1028462b1891...8928a8c9f847ca65f7c3a048a8ba42f57f8baa2a,2,41,37,78,36,2009-03-02 08:53:23,2009-03-02 08:53:23
8928a8c9f847ca65f7c3a048a8ba42f57f8baa2a...f520f440e1d2c3b4df3170427ce8a86e979b4a8f,5,385,360,745,322,2009-03-02 23:17:10,2009-03-02 23:17:10
f520f440e1d2c3b4df3170427ce8a86e979b4a8f...9e6d32eddeb11cfaf9b817f105633a3f3779a80c,1,3,2,5,1,2009-03-03 01:44:26,2009-03-03 01:44:26
9e6d32eddeb11cfaf9b817f105633a3f3779a80c...dcb0884d682edac06d15e427394afc8e92844152,2,3,3,6,3,2009-03-03 02:50:23,2009-03-03 02:50:23
dcb0884d682edac06d15e427394afc8e92844152...f1c908098440bdc427d3e97840842fe9555cc9d4,3,78,32,110,16,2009-03-04 05:35:10,2009-03-04 05:35:10
f1c908098440bdc427d3e97840842fe9555cc9d4...b57d86f226ca4fded1fc8bf6300450fb6a0566c1,2,10,5,15,5,2009-03-04 05:40:22,2009-03-04 05:40:22
b57d86f226ca4fded1fc8bf6300450fb6a0566c1...dce458cde2f667d7241d4eece691c8d606e110bb,3,38,4,42,10,2009-03-04 07:23:18,2009-03-04 07:23:18
dce458cde2f667d7241d4eece691c8d606e110bb...182301c8df175524f7272b8d6c2d7a8eac1934f5,2,25,2,27,3,2009-03-04 07:24:30,2009-03-04 07:24:30
182301c8df175524f7272b8d6c2d7a8eac1934f5...79f53b4f206f82847b645e36263e3537ebbae7b1,2,41,10,51,5,2009-03-04 10:40:50,2009-03-04 10:40:50
79f53b4f206f82847b645e36263e3537ebbae7b1...de442c3ab69e4b982694591384b7114c65f16dc6,2,9,8,17,2,2009-03-05 20:22:54,2009-03-05 20:22:54
de442c3ab69e4b982694591384b7114c65f16dc6...31e059c9b3a9014e08780eb564d990788d8f1cff,3,58,14,72,8,2009-03-06 02:09:59,2009-03-06 02:09:59
31e059c9b3a9014e08780eb564d990788d8f1cff...dd5300274f81e8ea41f3ef41487179e2b1770d65,2,10,6,16,6,2009-03-06 02:38:38,2009-03-06 02:38:38
dd5300274f81e8ea41f3ef41487179e2b1770d65...84b890b66e80bcc1834c22b8b347641b2e51f455,2,19,7,26,5,2009-03-06 04:53:33,2009-03-06 04:53:33
84b890b66e80bcc1834c22b8b347641b2e51f455...fd5d0cdebbc4e6dd620809c21b97bbb822d60b6d,2,28,0,28,3,2009-03-08 03:37:47,2009-03-08 03:37:47
fd5d0cdebbc4e6dd620809c21b97bbb822d60b6d...9c5eafe7d550f8c1b2eec81c7837458411620a8b,0,0,0,0,0,2009-03-08 04:12:56,2009-03-08 04:12:56
9c5eafe7d550f8c1b2eec81c7837458411620a8b...20973954dac9acd0abe28f8de82acfca02c167f8,0,0,0,0,0,2009-03-08 04:52:07,2009-03-08 04:52:07
20973954dac9acd0abe28f8de82acfca02c167f8...8baac83f30a3f15dd4ca8c0fd06bedcfa8646314,0,0,0,0,0,2009-03-08 05:33:30,2009-03-08 05:33:30
8baac83f30a3f15dd4ca8c0fd06bedcfa8646314...34b530fce71bc9d3ef811a4dbd183334a1bfb917,1,2,2,4,2,2009-03-08 09:33:14,2009-03-08 09:33:14
34b530fce71bc9d3ef811a4dbd183334a1bfb917...7dcf651bc5ea1b8da5f6b5044b71552dcdaf73cb,8,25,1,26,6,2009-03-08 09:41:37,2009-03-08 09:41:37
7dcf651bc5ea1b8da5f6b5044b71552dcdaf73cb...244bb7e6012d0cc37557efaee90adb5c7e885306,1,4,2,6,2,2009-03-08 10:01:22,2009-03-08 10:01:22
244bb7e6012d0cc37557efaee90adb5c7e885306...055c01103de70b1f08321b1dbbcbc4da84821a79,2,9,0,9,2,2009-03-08 10:01:59,2009-03-08 10:01:59
055c01103de70b1f08321b1dbbcbc4da84821a79...b1fd7650a9f44e3a31b50e1b1393d931ceba57fe,1,5,2,7,1,2009-03-08 10:02:23,2009-03-08 10:02:23
b1fd7650a9f44e3a31b50e1b1393d931ceba57fe...6fe80b2a93bed40cd7587fe0c9af9438a2308ced,7,70,37,107,42,2009-03-09 00:07:50,2009-03-09 00:07:50
6fe80b2a93bed40cd7587fe0c9af9438a2308ced...9c770e05d448deeea6d0d9a27eb5a9f3805435c5,2,2,2,4,2,2009-03-09 16:44:50,2009-03-09 16:44:50
9c770e05d448deeea6d0d9a27eb5a9f3805435c5...c545e88b817f299c7bb04c68a392cb5d52e7109b,3,30,2,32,6,2009-03-10 05:26:40,2009-03-10 05:26:40
c545e88b817f299c7bb04c68a392cb5d52e7109b...ea350187a5dc52861d85d513c846bd1f062513be,1,16,7,23,5,2009-03-10 05:55:55,2009-03-10 05:55:55
ea350187a5dc52861d85d513c846bd1f062513be...ee0320f63400de67cb5a3363d95899bc21354172,8,226,50,276,65,2009-03-10 12:08:17,2009-03-10 12:08:17
ee0320f63400de67cb5a3363d95899bc21354172...6ab4b64bd04ea09d59c56ff9bb5384eaaafdadaa,0,0,0,0,0,2009-03-10 12:18:39,2009-03-10 12:18:39
6ab4b64bd04ea09d59c56ff9bb5384eaaafdadaa...9a5942cd6011783037e94b01ea3553a3c08dc69c,1,11,0,11,3,2009-03-10 18:38:45,2009-03-10 18:38:45
9a5942cd6011783037e94b01ea3553a3c08dc69c...75cc96bc6f89360276225df81aa6cef57c626f43,1,2,2,4,1,2009-03-10 22:50:37,2009-03-10 22:50:37
75cc96bc6f89360276225df81aa6cef57c626f43...fdde600f42a9e5ba72f7cc0b1e84571bed477e03,1,6,1,7,3,2009-03-12 07:37:08,2009-03-12 07:37:08
fdde600f42a9e5ba72f7cc0b1e84571bed477e03...a02247ff73c14a79b344faaaa865d7d57d755cb1,2,6,3,9,4,2009-03-12 07:37:37,2009-03-12 07:37:37
a02247ff73c14a79b344faaaa865d7d57d755cb1...6922925abc8b840322509f88f3a1bc2024d1843e,1,1,1,2,1,2009-03-12 08:00:46,2009-03-12 08:00:46
6922925abc8b840322509f88f3a1bc2024d1843e...0ced9f68f3d8df6d09f538101c8cf94511a199f0,2,11,0,11,4,2009-03-13 19:58:56,2009-03-13 19:58:56
0ced9f68f3d8df6d09f538101c8cf94511a199f0...0eac35ce119f108d2ffaeea745101cc3c4a85b98,3,14,1,15,3,2009-03-13 21:07:41,2009-03-13 21:07:41
0eac35ce119f108d2ffaeea745101cc3c4a85b98...97321c7645f200333bc43ac2f4a22d78dd4154ea,4,65,2,67,6,2009-03-15 03:45:32,2009-03-15 03:45:32
97321c7645f200333bc43ac2f4a22d78dd4154ea...8a0a17628b4a3f5e7ed1d8dff3186e5ece573f0a,1,114,9,123,6,2009-03-15 03:45:56,2009-03-15 03:45:56
8a0a17628b4a3f5e7ed1d8dff3186e5ece573f0a...4d6763128f6f4e46982ae841a3f9962e07507c64,1,49,1,50,2,2009-03-15 03:46:26,2009-03-15 03:46:26
4d6763128f6f4e46982ae841a3f9962e07507c64...6b850951697437126b448e5126c273a389e8a749,1,1,1,2,1,2009-03-17 20:47:47,2009-03-17 20:47:47
6b850951697437126b448e5126c273a389e8a749...75b286798f07eea7f7edca6356e7fed1202f32c1,1,3,2,5,2,2009-03-17 20:51:06,2009-03-17 20:51:06
75b286798f07eea7f7edca6356e7fed1202f32c1...39c450cc6d71e2260994594d7ef42085e83f4fdd,6,4,5,9,7,2009-03-18 01:08:34,2009-03-18 01:08:34
39c450cc6d71e2260994594d7ef42085e83f4fdd...0abd798b9bd25e5a92056c7213959ac17570381b,1,0,0,0,0,2009-03-18 12:02:25,2009-03-18 12:02:25
0abd798b9bd25e5a92056c7213959ac17570381b...f781205859484ecd5e7af040b5b52f4edaa6d019,3,158,40,198,34,2009-03-18 12:28:53,2009-03-18 12:28:53
f781205859484ecd5e7af040b5b52f4edaa6d019...083a7206e471a8f67e7ba61b5b1085fd939547af,0,0,0,0,0,2009-03-18 12:38:39,2009-03-18 12:38:39
083a7206e471a8f67e7ba61b5b1085fd939547af...ebfe7faaa3efef952d092b332b79f182ea5f45d1,3,87,21,108,10,2009-03-20 22:14:31,2009-03-20 22:14:31
ebfe7faaa3efef952d092b332b79f182ea5f45d1...7499416d0d95279e9034f4b0480287e3ce2cb4e4,1,9,1,10,2,2009-03-23 22:11:07,2009-03-23 22:11:07
7499416d0d95279e9034f4b0480287e3ce2cb4e4...2b098e64e0106463074f15b594ad36970b3f87f5,1,1,0,1,1,2009-03-23 22:14:00,2009-03-23 22:14:00
2b098e64e0106463074f15b594ad36970b3f87f5...2fba099779324dd460184849ba221d233c1a6751,3,52,5,57,12,2009-03-24 05:54:35,2009-03-24 05:54:35
2fba099779324dd460184849ba221d233c1a6751...50379f4c915958f25a9b1264af97d2ff38cdea3a,1,2,1,3,1,2009-03-24 07:14:19,2009-03-24 07:14:19
50379f4c915958f25a9b1264af97d2ff38cdea3a...d9eb87adae519425646fa7245cd35f24496c1882,1,0,9,9,1,2009-03-24 11:50:08,2009-03-24 11:50:08
d9eb87adae519425646fa7245cd35f24496c1882...177e997400aec2a0d1e9381af200f5e16fdb13d1,1,2,2,4,1,2009-03-24 11:53:30,2009-03-24 11:53:30
177e997400aec2a0d1e9381af200f5e16fdb13d1...fae6702ea1b1c752381e5c49ca3ce99a3c03feb0,1,6,6,12,5,2009-03-24 11:57:36,2009-03-24 11:57:36
fae6702ea1b1c752381e5c49ca3ce99a3c03feb0...c2e4e54eb695b895c830f636251a4318826021ba,1,2,2,4,1,2009-03-24 12:01:23,2009-03-24 12:01:23
c2e4e54eb695b895c830f636251a4318826021ba...ade3dcb4947e93752e5759c1bd6e6a26e9bfcb8e,1,1,1,2,1,2009-03-24 12:04:43,2009-03-24 12:04:43
ade3dcb4947e93752e5759c1bd6e6a26e9bfcb8e...2363f608798ba3152299abc26e5e93c1a2889226,1,1,1,2,1,2009-03-24 12:07:43,2009-03-24 12:07:43
2363f608798ba3152299abc26e5e93c1a2889226...17401448b21e5980437e24ac3f12c84e267c580f,1,5,5,10,3,2009-03-24 12:09:56,2009-03-24 12:09:56
17401448b21e5980437e24ac3f12c84e267c580f...1c670a70530099ec61e78dabae5744512189f168,2,5,6,11,4,2009-03-24 12:12:32,2009-03-24 12:12:32
1c670a70530099ec61e78dabae5744512189f168...c04a28df4c79d4912fd9d6d9683eba93f575d5cc,0,0,0,0,0,2009-03-24 12:34:41,2009-03-24 12:34:41
c04a28df4c79d4912fd9d6d9683eba93f575d5cc...69e228e8622b1bc63a98b0f6a2e72de0242cc817,0,0,0,0,0,2009-03-24 18:11:21,2009-03-24 18:11:21
69e228e8622b1bc63a98b0f6a2e72de0242cc817...c0379b9a2c0be3c8fd1ff10aeef6c08d300ee90d,0,0,0,0,0,2009-03-24 18:28:34,2009-03-24 18:28:34
c0379b9a2c0be3c8fd1ff10aeef6c08d300ee90d...fff55111b667a0da61df53c9d785d677f52e0ffe,0,0,0,0,0,2009-03-24 18:32:26,2009-03-24 18:32:26
fff55111b667a0da61df53c9d785d677f52e0ffe...dce8fdbc68941e0ee496a469d63673bbdf51fc77,2,5,5,10,5,2009-03-24 23:02:36,2009-03-24 23:02:36
dce8fdbc68941e0ee496a469d63673bbdf51fc77...2e059204018379a635a89a6ec3addc2d1e45cc49,1,8,0,8,1,2009-03-25 11:00:20,2009-03-25 11:00:20
2e059204018379a635a89a6ec3addc2d1e45cc49...cdbc225e0bf5e5d08b42ce8abe0e1f78f1d635b5,1,4,0,4,1,2009-03-27 19:52:47,2009-03-27 19:52:47
cdbc225e0bf5e5d08b42ce8abe0e1f78f1d635b5...5e0a45d73995b9c3838c3389a394ae33059e699e,2,110,100,210,98,2009-03-29 21:25:50,2009-03-29 21:25:50
5e0a45d73995b9c3838c3389a394ae33059e699e...ae5f451741ece341d1606e6e620b05020c739bb2,1,7,5,12,3,2009-03-29 23:40:04,2009-03-29 23:40:04
ae5f451741ece341d1606e6e620b05020c739bb2...8f996105ec01ee2ae717cfff6290ceb27027f2de,1,2,12,14,1,2009-03-30 03:36:35,2009-03-30 03:36:35
8f996105ec01ee2ae717cfff6290ceb27027f2de...4a5a21d10c610339ea2ed7bc1732b6e66cf296ff,1,2,1,3,1,2009-03-30 16:08:57,2009-03-30 16:08:57
4a5a21d10c610339ea2ed7bc1732b6e66cf296ff...54d6fe97e9c90c92c562ecd3278c14f177b1e5b4,2,31,5,36,5,2009-03-30 16:48:24,2009-03-30 16:48:24
54d6fe97e9c90c92c562ecd3278c14f177b1e5b4...412e1d59c97010284ce79a6d5309cf80114e434f,1,15,14,29,4,2009-03-30 17:10:24,2009-03-30 17:10:24
412e1d59c97010284ce79a6d5309cf80114e434f...46292cdc71f3151e78699bdaf0fbe52b7f59f0ce,1,15,11,26,6,2009-03-30 18:32:49,2009-03-30 18:32:49
46292cdc71f3151e78699bdaf0fbe52b7f59f0ce...46e37d20d4cafe4684aa7a38ffa72eced91e2736,1,1,1,2,1,2009-03-30 18:44:35,2009-03-30 18:44:35
46e37d20d4cafe4684aa7a38ffa72eced91e2736...387bd8f386aff72e68a7eb042bdbdc15181b50a0,1,3,3,6,2,2009-03-30 19:01:30,2009-03-30 19:01:30
387bd8f386aff72e68a7eb042bdbdc15181b50a0...10a3e41c8a3f4e4e2b51d2a152681213dec47a8b,1,9,2,11,2,2009-03-30 19:35:36,2009-03-30 19:35:36
10a3e41c8a3f4e4e2b51d2a152681213dec47a8b...ef283643651141363cdf50bded17ef9ddd729d99,1,18,15,33,5,2009-03-30 19:55:29,2009-03-30 19:55:29
ef283643651141363cdf50bded17ef9ddd729d99...daae84a8e0c292b77aabd5719d3022df72f47fc8,1,1,1,2,2,2009-03-30 20:16:43,2009-03-30 20:16:43
daae84a8e0c292b77aabd5719d3022df72f47fc8...487a7fdccee5b71f1f44acaafbaec58fa05120d5,2,10,2,12,4,2009-03-30 20:33:42,2009-03-30 20:33:42
487a7fdccee5b71f1f44acaafbaec58fa05120d5...b49e39152b9370c41775a3983b1cdda2a5e6cf37,1,1,3,4,2,2009-03-30 21:01:08,2009-03-30 21:01:08
b49e39152b9370c41775a3983b1cdda2a5e6cf37...546d764a36f2a51d004452c1bd26e76b8cfe4233,2,15,3,18,6,2009-03-30 21:35:09,2009-03-30 21:35:09
546d764a36f2a51d004452c1bd26e76b8cfe4233...3543e128df87abd31816f6914503c3b9621d0388,2,14,0,14,4,2009-03-30 22:01:40,2009-03-30 22:01:40
3543e128df87abd31816f6914503c3b9621d0388...f7e52d449a62330a5c0e41fd4858a99039e6d605,2,46,5,51,5,2009-03-30 22:03:20,2009-03-30 22:03:20
f7e52d449a62330a5c0e41fd4858a99039e6d605...f9582c8f52199aa285153f2720dd946935db2af0,1,6,6,12,5,2009-03-30 22:11:36,2009-03-30 22:11:36
f9582c8f52199aa285153f2720dd946935db2af0...86842e21f41602f4f6fbf0e61bf25bc4bc8e9256,1,1,0,1,1,2009-03-30 22:55:56,2009-03-30 22:55:56
86842e21f41602f4f6fbf0e61bf25bc4bc8e9256...22ac97b17cbc3491629f98b15cc9a699b14ebd73,5,28,2,30,8,2009-03-30 22:56:05,2009-03-30 22:56:05
22ac97b17cbc3491629f98b15cc9a699b14ebd73...9bbf94112f011276d4e25b21676cfc2b74aaaef5,3,17,9,26,9,2009-03-30 23:20:10,2009-03-30 23:20:10
9bbf94112f011276d4e25b21676cfc2b74aaaef5...9d808c14a589c9daf321a3847ab3e3d28c3c60f4,1,28,31,59,29,2009-03-30 23:33:08,2009-03-30 23:33:08
9d808c14a589c9daf321a3847ab3e3d28c3c60f4...68aa33f901561d7ace48c525ef770e03f5adb53d,6,28,31,59,18,2009-03-31 07:16:25,2009-03-31 07:16:25
68aa33f901561d7ace48c525ef770e03f5adb53d...955ec63c5e12931075ef728267874a2fa2f83688,1,2,1,3,3,2009-03-31 07:25:09,2009-03-31 07:25:09
955ec63c5e12931075ef728267874a2fa2f83688...abe640c735d1bbc10a1d8981319eda46abcdeb4d,2,79,71,150,70,2009-03-31 08:01:24,2009-03-31 08:01:24
abe640c735d1bbc10a1d8981319eda46abcdeb4d...09daf300c545698eca439975cd5c71087ff8e40a,1,1,1,2,1,2009-03-31 15:40:34,2009-03-31 15:40:34
09daf300c545698eca439975cd5c71087ff8e40a...510a16679d74b4a04df1b8552c6dc15ea2714463,1,2,2,4,2,2009-03-31 15:42:58,2009-03-31 15:42:58
510a16679d74b4a04df1b8552c6dc15ea2714463...f6524d9c1ff89b0d5d4387e0c2abdaff9a7c2995,1,1,0,1,1,2009-03-31 16:02:44,2009-03-31 16:02:44
f6524d9c1ff89b0d5d4387e0c2abdaff9a7c2995...b3b541b68ea83164aee967539e4aa44cbdb88b6e,9,16,18,34,13,2009-03-31 16:09:22,2009-03-31 16:09:22
b3b541b68ea83164aee967539e4aa44cbdb88b6e...d073efa0bb5cf7bb2fe8e76bbd2c94fb6b97c816,1,14,0,14,2,2009-03-31 16:35:35,2009-03-31 16:35:35
d073efa0bb5cf7bb2fe8e76bbd2c94fb6b97c816...5967cbb0452a1782d268805e91cd543ceda3d201,1,3,3,6,3,2009-03-31 16:41:29,2009-03-31 16:41:29
5967cbb0452a1782d268805e91cd543ceda3d201...e4e38e85c272c7d6a9a23aa120881b1a6cb76d5f,1,1,1,2,1,2009-03-31 16:46:33,2009-03-31 16:46:33
e4e38e85c272c7d6a9a23aa120881b1a6cb76d5f...24a359f078af3eb5a7dd7b151a74cb303557dd34,1,1,1,2,1,2009-03-31 16:52:47,2009-03-31 16:52:47
24a359f078af3eb5a7dd7b151a74cb303557dd34...a352bf2145cf204cad3a5b604142c6087442c817,1,1,1,2,1,2009-03-31 16:58:24,2009-03-31 16:58:24
a352bf2145cf204cad3a5b604142c6087442c817...8c776637b270caa085cd2eb09f7a44cb5e4865d5,1,1,1,2,1,2009-03-31 17:01:42,2009-03-31 17:01:42
8c776637b270caa085cd2eb09f7a44cb5e4865d5...550dd623007526c206e731b963de0ff8ce0ae253,1,14,1,15,1,2009-03-31 17:14:48,2009-03-31 17:14:48
550dd623007526c206e731b963de0ff8ce0ae253...76fd191bfd6cfc7d88bff232b9df433e4f993d37,1,3,3,6,1,2009-03-31 18:15:01,2009-03-31 18:15:01
76fd191bfd6cfc7d88bff232b9df433e4f993d37...606c5a7e7e731166164f17243aec32a498e02422,3,21,2,23,4,2009-03-31 19:34:08,2009-03-31 19:34:08
606c5a7e7e731166164f17243aec32a498e02422...93ffbd027f2ac1720408f04a8bc38d1827910ef6,0,0,0,0,0,2009-03-31 19:46:05,2009-03-31 19:46:05
93ffbd027f2ac1720408f04a8bc38d1827910ef6...c1691cc51983e38ad2928331bb40891fdebdab99,0,0,0,0,0,2009-03-31 20:03:23,2009-03-31 20:03:23
c1691cc51983e38ad2928331bb40891fdebdab99...7f90c2cc569a7959a6b03bd4a271c70fc0b2d1e3,0,0,0,0,0,2009-03-31 20:04:55,2009-03-31 20:04:55
7f90c2cc569a7959a6b03bd4a271c70fc0b2d1e3...1e0acd537b087978162750ad908e564cecf3301c,5,58,15,73,6,2009-03-31 20:30:05,2009-03-31 20:30:05
1e0acd537b087978162750ad908e564cecf3301c...00087ef006ecbebf34c67d7d15c27a61024ce0da,3,37,1,38,4,2009-03-31 20:39:54,2009-03-31 20:39:54
00087ef006ecbebf34c67d7d15c27a61024ce0da...d41cfde6863ee3b6f6797ccf2277fcf80a690fe7,0,0,0,0,0,2009-03-31 20:48:06,2009-03-31 20:48:06
d41cfde6863ee3b6f6797ccf2277fcf80a690fe7...766ff972088a991eb9c2c3cfc180364656dfb9ed,0,0,0,0,0,2009-03-31 20:49:37,2009-03-31 20:49:37
766ff972088a991eb9c2c3cfc180364656dfb9ed...fd0c4bb76ead305a0717de978a2dc52638f8697b,1,7,4,11,3,2009-03-31 21:14:39,2009-03-31 21:14:39
fd0c4bb76ead305a0717de978a2dc52638f8697b...7475092c9facfdec98c6c01a7edbdaed53e4a07a,2,4,2,6,2,2009-03-31 21:15:55,2009-03-31 21:15:55
7475092c9facfdec98c6c01a7edbdaed53e4a07a...09953968172935ac5665cf75f0de87961d1741fe,1,2,2,4,2,2009-03-31 21:40:40,2009-03-31 21:40:40
09953968172935ac5665cf75f0de87961d1741fe...67a58801623cccd55ecdd7d21f7b2dc487175c03,4,20,0,20,6,2009-03-31 21:42:47,2009-03-31 21:42:47
67a58801623cccd55ecdd7d21f7b2dc487175c03...795697dc225af79958f16610906df3a31a4b2eaa,2,7,0,7,3,2009-03-31 21:48:29,2009-03-31 21:48:29
795697dc225af79958f16610906df3a31a4b2eaa...bd4f2a1d46bba5307e5963e6cdcd9d621663d634,0,0,0,0,0,2009-03-31 21:58:14,2009-03-31 21:58:14
bd4f2a1d46bba5307e5963e6cdcd9d621663d634...d032e15079daf6194c7650f031c303e0a0923c5e,0,0,0,0,0,2009-03-31 21:59:09,2009-03-31 21:59:09
d032e15079daf6194c7650f031c303e0a0923c5e...4502a2d3ca6ec973d284a374b488d7bd63fed038,1,1,0,1,1,2009-03-31 22:00:46,2009-03-31 22:00:46
4502a2d3ca6ec973d284a374b488d7bd63fed038...4a3139d63e9df7abee2e8ac07e197427155957e1,3,41,9,50,10,2009-03-31 22:02:37,2009-03-31 22:02:37
4a3139d63e9df7abee2e8ac07e197427155957e1...377cc9c85099f1bbbd1f072b0b195287674e6b07,2,20,9,29,9,2009-03-31 22:04:15,2009-03-31 22:04:15
377cc9c85099f1bbbd1f072b0b195287674e6b07...6b937c67eae12e21d128d609fe0eceb28bb0f52a,2,72,10,82,5,2009-03-31 22:06:06,2009-03-31 22:06:06
6b937c67eae12e21d128d609fe0eceb28bb0f52a...4bf87443d48a9d2ea2055e958c397dc98ebde728,0,0,0,0,0,2009-03-31 22:07:15,2009-03-31 22:07:15
4bf87443d48a9d2ea2055e958c397dc98ebde728...e87c07ec639dea3c0bd2cf25f3e3e519c4b627c8,0,0,0,0,0,2009-03-31 22:41:43,2009-03-31 22:41:43
e87c07ec639dea3c0bd2cf25f3e3e519c4b627c8...97b22bde3c4ef46867b0190e462110f1c542e7e8,1,228,116,344,61,2009-03-31 23:54:13,2009-03-31 23:54:13
97b22bde3c4ef46867b0190e462110f1c542e7e8...a9017a1e5ab1a4092a76545b91bc834891e85d9f,24,206,48,254,43,2009-04-01 00:08:34,2009-04-01 00:08:34
a9017a1e5ab1a4092a76545b91bc834891e85d9f...dc7c952e8d224e333d28cebc73a37f00099b75e4,1,4,4,8,1,2009-04-01 00:08:48,2009-04-01 00:08:48
dc7c952e8d224e333d28cebc73a37f00099b75e4...8f6e1cdf9f04f822f1579e7691a4e83e6e0ed18e,0,0,0,0,0,2009-04-01 00:10:40,2009-04-01 00:10:40
8f6e1cdf9f04f822f1579e7691a4e83e6e0ed18e...6b2e28d96301b543040bcf55ca004f1f1c51942a,1,1,1,2,1,2009-04-01 01:34:49,2009-04-01 01:34:49
6b2e28d96301b543040bcf55ca004f1f1c51942a...f770cf5c5a5d4bd51f47f80a50ac06c4558e424f,2,102,46,148,18,2009-04-01 02:37:04,2009-04-01 02:37:04
f770cf5c5a5d4bd51f47f80a50ac06c4558e424f...53d5f27e75dd3f2b98f9277b09a1944132637130,1,4,43,47,4,2009-04-01 03:02:47,2009-04-01 03:02:47
53d5f27e75dd3f2b98f9277b09a1944132637130...906f55bf0975e6aa4eb63f4ca71e54baff200bf8,3,36,3,39,6,2009-04-01 15:07:13,2009-04-01 15:07:13
906f55bf0975e6aa4eb63f4ca71e54baff200bf8...7cbbd782e1b6c5c05be382b0c478e81a77a13013,7,102,1,103,5,2009-04-01 15:07:31,2009-04-01 15:07:31
7cbbd782e1b6c5c05be382b0c478e81a77a13013...92edfca2fb7fc0341611f290fe327200e6725450,0,0,0,0,0,2009-04-01 15:10:48,2009-04-01 15:10:48
92edfca2fb7fc0341611f290fe327200e6725450...05e3242dc5b9d66507e96c7397c50d4accc92330,0,0,0,0,0,2009-04-01 15:35:48,2009-04-01 15:35:48
05e3242dc5b9d66507e96c7397c50d4accc92330...6efe30672d51909f63f0187675cb09ceac4f135e,2,43,1,44,4,2009-04-01 16:18:25,2009-04-01 16:18:25
6efe30672d51909f63f0187675cb09ceac4f135e...34e823a699ff21c3780f2bcc52ca0cc7b50931a6,1,5,2,7,1,2009-04-01 17:06:20,2009-04-01 17:06:20
34e823a699ff21c3780f2bcc52ca0cc7b50931a6...e047110657dd3dcf87841cec0c48b01dd5cb4695,2,47,5,52,7,2009-04-01 18:20:53,2009-04-01 18:20:53
e047110657dd3dcf87841cec0c48b01dd5cb4695...d0dce0257b79cbea80098b4c043a9a5ec36d8b89,1,1,1,2,1,2009-04-01 18:46:17,2009-04-01 18:46:17
d0dce0257b79cbea80098b4c043a9a5ec36d8b89...eb24c7fd0c92559cef37f72bce44ca1157a6c3a9,5,63,4,67,7,2009-04-01 21:17:54,2009-04-01 21:17:54
eb24c7fd0c92559cef37f72bce44ca1157a6c3a9...647ff3f1ac6d66a2ec7c9f7a9e6cdaa70da3dd9f,2,9,1,10,2,2009-04-01 21:26:55,2009-04-01 21:26:55
647ff3f1ac6d66a2ec7c9f7a9e6cdaa70da3dd9f...c7a16bc6e0cf75144a644678b94cf22a99e22030,1,1,1,2,1,2009-04-01 21:35:00,2009-04-01 21:35:00
c7a16bc6e0cf75144a644678b94cf22a99e22030...f58df036bddcf41ce50e0ea217fbef2f8470e98b,2,146,0,146,2,2009-04-01 22:35:41,2009-04-01 22:35:41
f58df036bddcf41ce50e0ea217fbef2f8470e98b...a080fcd1a65c862d61c196e7785d5d9d38813a5c,3,30,8,38,5,2009-04-01 23:09:45,2009-04-01 23:09:45
a080fcd1a65c862d61c196e7785d5d9d38813a5c...ef0a5fb9ebed237c4d634543caa909f2e539d31a,0,0,0,0,0,2009-04-02 01:15:43,2009-04-02 01:15:43
ef0a5fb9ebed237c4d634543caa909f2e539d31a...c51722373b252730bef72a148ce097a48c15940b,1,7,0,7,5,2009-04-02 01:41:56,2009-04-02 01:41:56
c51722373b252730bef72a148ce097a48c15940b...33c27f2f284179178c8c759c0de454820e2cbb85,1,1,1,2,1,2009-04-02 01:57:12,2009-04-02 01:57:12
33c27f2f284179178c8c759c0de454820e2cbb85...fd7280e4f44601d7fffeedf13a96fccf5bd9fdd2,1,0,2,2,1,2009-04-02 02:04:59,2009-04-02 02:04:59
fd7280e4f44601d7fffeedf13a96fccf5bd9fdd2...38aeee4839f273b0575dbbb605303e27c3f87da8,3,119,0,119,2,2009-04-02 04:34:42,2009-04-02 04:34:42
38aeee4839f273b0575dbbb605303e27c3f87da8...4257feffe8af5f31c0e851754db802ce7a8a0912,2,14,2,16,3,2009-04-02 05:22:17,2009-04-02 05:22:17
4257feffe8af5f31c0e851754db802ce7a8a0912...faf049c49880d0c80b6e6521373bf72d96eba486,0,0,0,0,0,2009-04-02 05:28:44,2009-04-02 05:28:44
faf049c49880d0c80b6e6521373bf72d96eba486...8c253bcea11232b6188dba84e6afb16d5743d2f3,2,26,21,47,20,2009-04-02 08:35:40,2009-04-02 08:35:40
8c253bcea11232b6188dba84e6afb16d5743d2f3...597102199e70d88e9233023f13629194291aed43,50,506,257,763,110,2009-04-03 18:37:43,2009-04-03 18:37:43
597102199e70d88e9233023f13629194291aed43...9907495b3c412ece76f5e5e4c4e5df12b93caf78,4,44,3,47,5,2009-04-03 19:56:30,2009-04-03 19:56:30
9907495b3c412ece76f5e5e4c4e5df12b93caf78...fbffc2e943eba73715d1564f437ca4ee028de9d3,2,7,0,7,3,2009-04-03 20:04:39,2009-04-03 20:04:39
fbffc2e943eba73715d1564f437ca4ee028de9d3...b45cf13bed36f338517c42446f78001aa9a82f7d,1,4,1,5,2,2009-04-03 20:29:59,2009-04-03 20:29:59
b45cf13bed36f338517c42446f78001aa9a82f7d...fd8965198f541d6f2920e689cdbe13ed1ff6faa9,2,23,13,36,9,2009-04-03 20:53:50,2009-04-03 20:53:50
fd8965198f541d6f2920e689cdbe13ed1ff6faa9...f3a81cb5af8a8d7d24c5ef1039fd0cbe2e8c1686,0,0,0,0,0,2009-04-04 06:59:59,2009-04-04 06:59:59
f3a81cb5af8a8d7d24c5ef1039fd0cbe2e8c1686...3c5f7bc262050bba42b998b50d9f5082bf981665,0,0,0,0,0,2009-04-04 17:19:50,2009-04-04 17:19:50
3c5f7bc262050bba42b998b50d9f5082bf981665...055f9a0ebf50ecc02e540304f81cc2e2d95613e3,4,52,14,66,12,2009-04-04 17:42:43,2009-04-04 17:42:43
055f9a0ebf50ecc02e540304f81cc2e2d95613e3...cfe9b6f642342a9e091e6d937bed201689d781b2,2,2,2,4,2,2009-04-04 17:54:35,2009-04-04 17:54:35
cfe9b6f642342a9e091e6d937bed201689d781b2...2d20e5265a9cfcca82eee4e2a7f2afac15bd1641,1,20,15,35,16,2009-04-04 19:12:52,2009-04-04 19:12:52
2d20e5265a9cfcca82eee4e2a7f2afac15bd1641...a9931e5655bcf792d436759017dad6544e3aeed2,1,8,8,16,5,2009-04-04 19:48:26,2009-04-04 19:48:26
a9931e5655bcf792d436759017dad6544e3aeed2...50d3ebf72af0baedcc4c288dfd2d8a5a18bd6f5e,1,9,10,19,3,2009-04-05 04:48:11,2009-04-05 04:48:11
50d3ebf72af0baedcc4c288dfd2d8a5a18bd6f5e...35c30ee957156a0dc3e58b3eb2cd900d4fe965e5,2,15,3,18,3,2009-04-05 17:21:25,2009-04-05 17:21:25
35c30ee957156a0dc3e58b3eb2cd900d4fe965e5...33173e98c1c9bbf0fd7c9ad3592f85c4be505dfb,3,24,5,29,8,2009-04-05 17:28:09,2009-04-05 17:28:09
33173e98c1c9bbf0fd7c9ad3592f85c4be505dfb...734a3ac767ab5f8b752f3372e19ca2c7ada42979,1,16,9,25,2,2009-04-05 17:54:40,2009-04-05 17:54:40
734a3ac767ab5f8b752f3372e19ca2c7ada42979...520c670b9d589f16af6c9b4bf44883fb9a000bf7,1,1,1,2,1,2009-04-05 19:01:03,2009-04-05 19:01:03
520c670b9d589f16af6c9b4bf44883fb9a000bf7...bb558539ad7e3b439997d53b8521e50f7e4624e3,4,29,12,41,20,2009-04-05 21:45:07,2009-04-05 21:45:07
bb558539ad7e3b439997d53b8521e50f7e4624e3...3931829c6e2251f992b24701b893d20720f0384e,5,37,2,39,10,2009-04-07 12:15:25,2009-04-07 12:15:25
3931829c6e2251f992b24701b893d20720f0384e...ff4609b686d548b6a4050ee505d30bf96ce6245c,3,7,7,14,6,2009-04-07 19:11:20,2009-04-07 19:11:20
ff4609b686d548b6a4050ee505d30bf96ce6245c...4c7b2b8baf645d2e8f48d1162508c1025292e1cb,0,0,0,0,0,2009-04-07 19:13:15,2009-04-07 19:13:15
4c7b2b8baf645d2e8f48d1162508c1025292e1cb...a340c7f0e2995c7868ac673eddd23022ab1549ba,4,15,2,17,6,2009-04-07 19:29:34,2009-04-07 19:29:34
a340c7f0e2995c7868ac673eddd23022ab1549ba...503b3ca45984c6f5673d62c590ff639ba82820b2,2,2,2,4,4,2009-04-07 19:35:11,2009-04-07 19:35:11
503b3ca45984c6f5673d62c590ff639ba82820b2...f78c70b3b21cb28ce77b674706bb64b297ab0649,1,1,1,2,1,2009-04-07 19:41:31,2009-04-07 19:41:31
f78c70b3b21cb28ce77b674706bb64b297ab0649...0c85192ebeb374e7a7ad8e72ebecdf173d7fdcce,2,15,1,16,2,2009-04-07 19:50:42,2009-04-07 19:50:42
0c85192ebeb374e7a7ad8e72ebecdf173d7fdcce...6951cece53c6a7335f5aa2260f4f5c1d94a589da,1,1,0,1,1,2009-04-07 19:53:42,2009-04-07 19:53:42
6951cece53c6a7335f5aa2260f4f5c1d94a589da...1c2ee287c0d6ff8b8dc7e60e242ed7691298ad0d,2,14,7,21,8,2009-04-07 20:23:42,2009-04-07 20:23:42
1c2ee287c0d6ff8b8dc7e60e242ed7691298ad0d...0013403eeedae76d79b100db71b2327c6535b847,3,3,3,6,3,2009-04-07 20:23:54,2009-04-07 20:23:54
0013403eeedae76d79b100db71b2327c6535b847...8c763da4f76fe9c04734cce4325a8b0fd06617b8,1,2,1,3,2,2009-04-07 20:30:04,2009-04-07 20:30:04
8c763da4f76fe9c04734cce4325a8b0fd06617b8...866574a85442a0310fbc2bf06b6fbf1d759d1479,4,52,8,60,8,2009-04-07 21:21:17,2009-04-07 21:21:17
866574a85442a0310fbc2bf06b6fbf1d759d1479...806d898bbf7cc0f067674f4c112ab62786a3ce57,2,38,16,54,11,2009-04-07 21:33:43,2009-04-07 21:33:43
806d898bbf7cc0f067674f4c112ab62786a3ce57...4f2259f539d530a8723de0c4b96544432e9bc83b,1,22,13,35,5,2009-04-07 22:13:30,2009-04-07 22:13:30
4f2259f539d530a8723de0c4b96544432e9bc83b...3cff712c21c755ee417f72c3e9d4a85139172e49,0,0,0,0,0,2009-04-07 22:21:10,2009-04-07 22:21:10
3cff712c21c755ee417f72c3e9d4a85139172e49...5fc10e92937df953d7d3e40889f14324f1eca785,2,64,32,96,29,2009-04-08 09:02:29,2009-04-08 09:02:29
5fc10e92937df953d7d3e40889f14324f1eca785...136d8b2854908ab0e43334a5b25d46c324270db6,2,21,1,22,6,2009-04-08 18:55:06,2009-04-08 18:55:06
136d8b2854908ab0e43334a5b25d46c324270db6...e013c78ef85ad86a991757dcd23a797abb0a8fc7,1,3,1,4,1,2009-04-08 19:42:01,2009-04-08 19:42:01
e013c78ef85ad86a991757dcd23a797abb0a8fc7...3891c137d41dfe8d1b06fdf468598d1651b232f8,1,5,1,6,1,2009-04-08 19:58:24,2009-04-08 19:58:24
3891c137d41dfe8d1b06fdf468598d1651b232f8...8c3d593b0f6d8c3a60eb6f95a687ec42a77340c4,5,28,4,32,9,2009-04-09 15:28:41,2009-04-09 15:28:41
8c3d593b0f6d8c3a60eb6f95a687ec42a77340c4...6c45765681b71e91633d4447eeb4088c4989dde5,2,27,24,51,11,2009-04-10 01:13:29,2009-04-10 01:13:29
6c45765681b71e91633d4447eeb4088c4989dde5...dd7198701a38519f1844376873d783aee5b094d6,6,24,4,28,7,2009-04-10 04:49:00,2009-04-10 04:49:00
dd7198701a38519f1844376873d783aee5b094d6...2d97ab1131c2c515299a4e834fa8e1114a5de19e,4,137,97,234,88,2009-04-10 06:24:43,2009-04-10 06:24:43
2d97ab1131c2c515299a4e834fa8e1114a5de19e...9e22d3ca4a6b57951cb22989dc19d5e6c55d83df,2,1,1,2,1,2009-04-10 07:35:57,2009-04-10 07:35:57
9e22d3ca4a6b57951cb22989dc19d5e6c55d83df...167d21e6ab191440495eef1a801f47e9bf539a69,2,1305,858,2163,783,2009-04-10 08:36:56,2009-04-10 08:36:56
167d21e6ab191440495eef1a801f47e9bf539a69...4a0e683ef1e608d7a0f7ae9dceb60eb795757633,4,400,259,659,218,2009-04-10 08:42:13,2009-04-10 08:42:13
4a0e683ef1e608d7a0f7ae9dceb60eb795757633...3ae27692b2034804a0527e37a30e7de0cd000e24,2,487,182,669,166,2009-04-10 08:50:05,2009-04-10 08:50:05
3ae27692b2034804a0527e37a30e7de0cd000e24...dccb6e9c9c54b8a246aae36522397bc145e6ab0b,2,10,10,20,8,2009-04-10 09:53:58,2009-04-10 09:53:58
dccb6e9c9c54b8a246aae36522397bc145e6ab0b...4e588ee93df7f0b8e03ab59470db3b67aa12ad3f,3,546,191,737,169,2009-04-10 11:24:55,2009-04-10 11:24:55
4e588ee93df7f0b8e03ab59470db3b67aa12ad3f...fe7250db64a9ed28c673716588a6a4f5c95a7908,2,398,261,659,240,2009-04-10 11:29:56,2009-04-10 11:29:56
fe7250db64a9ed28c673716588a6a4f5c95a7908...a5e0725247ac3e337f869a36c4dad7d833f785ed,1,77,17,94,4,2009-04-10 15:53:21,2009-04-10 15:53:21
a5e0725247ac3e337f869a36c4dad7d833f785ed...53af4523297ea1df783c045410fc36ea6520c46b,1,6,6,12,2,2009-04-10 16:34:49,2009-04-10 16:34:49
53af4523297ea1df783c045410fc36ea6520c46b...ca5b624b05be5e9315cfd149afcd542b66279b4b,2,14,2,16,3,2009-04-10 17:10:44,2009-04-10 17:10:44
ca5b624b05be5e9315cfd149afcd542b66279b4b...f3eff22de7e567f31dbfda52e55c3c785103b76c,1,1,1,2,1,2009-04-10 17:10:57,2009-04-10 17:10:57
f3eff22de7e567f31dbfda52e55c3c785103b76c...1a541eebd35f7ce6da7e9074db6c66e0b0393ac5,1,1,1,2,1,2009-04-10 18:45:06,2009-04-10 18:45:06
1a541eebd35f7ce6da7e9074db6c66e0b0393ac5...7a283f790cabfbd95a51ed0fe06f274f7c49c04d,2,103,134,237,10,2009-04-10 19:56:56,2009-04-10 19:56:56
7a283f790cabfbd95a51ed0fe06f274f7c49c04d...2ab40287bc8996d2cba1edd562fbe648c880ad90,2,21,2,23,4,2009-04-10 19:57:11,2009-04-10 19:57:11
2ab40287bc8996d2cba1edd562fbe648c880ad90...06f379bd5ce264aee2f85fd0725bd044e3266fb7,2,14,0,14,2,2009-04-10 21:40:38,2009-04-10 21:40:38
06f379bd5ce264aee2f85fd0725bd044e3266fb7...b9c0ec63d3dee5bfb3dff665db7d066904c61494,0,0,0,0,0,2009-04-10 21:45:21,2009-04-10 21:45:21
b9c0ec63d3dee5bfb3dff665db7d066904c61494...b853ed4fe72e251c5232af002424f0f21a2820c0,2,1,1,2,1,2009-04-11 06:28:58,2009-04-11 06:28:58
b853ed4fe72e251c5232af002424f0f21a2820c0...c2a828c7ca645adcd1cf55761c203f3dc62bdc8c,1,3,3,6,3,2009-04-11 07:52:07,2009-04-11 07:52:07
c2a828c7ca645adcd1cf55761c203f3dc62bdc8c...b6bd5ddc3357d99f22f5181f5daecb46512650ba,5,67,2,69,9,2009-04-11 09:27:04,2009-04-11 09:27:04
b6bd5ddc3357d99f22f5181f5daecb46512650ba...f943e2e4181b6570d4d6f85b0e2dff311ae20597,4,22,6,28,9,2009-04-11 11:50:21,2009-04-11 11:50:21
f943e2e4181b6570d4d6f85b0e2dff311ae20597...13475ed646ec47d779e416efb8349393c12bcf3f,3,25,12,37,9,2009-04-11 12:07:52,2009-04-11 12:07:52
13475ed646ec47d779e416efb8349393c12bcf3f...d78ff63ec69022b3dd2826cd1b4b687617b55cac,0,0,0,0,0,2009-04-11 15:13:31,2009-04-11 15:13:31
d78ff63ec69022b3dd2826cd1b4b687617b55cac...4915d1d02f410e6c30d05c099fedfb73aaf31ce9,2,2,2,4,2,2009-04-12 02:05:43,2009-04-12 02:05:43
4915d1d02f410e6c30d05c099fedfb73aaf31ce9...6d5f811cdb97610a6886cb6afc1be0f1f5224ea7,1,4,1,5,2,2009-04-12 02:17:45,2009-04-12 02:17:45
6d5f811cdb97610a6886cb6afc1be0f1f5224ea7...95dcf56f4c28ce2f2f4ccf9943ee94c1c0145490,1,3,5,8,5,2009-04-12 02:25:18,2009-04-12 02:25:18
95dcf56f4c28ce2f2f4ccf9943ee94c1c0145490...18baad0d2fd3ede36c5982c9a5fd597edb7c6622,2,399,161,560,153,2009-04-12 02:43:13,2009-04-12 02:43:13
18baad0d2fd3ede36c5982c9a5fd597edb7c6622...6771f4e348926608a86bc5152defd90a82fa3624,5,35,6,41,11,2009-04-12 03:54:49,2009-04-12 03:54:49
6771f4e348926608a86bc5152defd90a82fa3624...a83e4cb1959edc1d5dc5ebe4e1065bbe254062a7,1,2,3,5,2,2009-04-12 04:15:45,2009-04-12 04:15:45
a83e4cb1959edc1d5dc5ebe4e1065bbe254062a7...f0c9bc5563d8a4df657ed71229dd6ffe49dfaf94,2,6,1,7,2,2009-04-12 04:57:50,2009-04-12 04:57:50
f0c9bc5563d8a4df657ed71229dd6ffe49dfaf94...1e0c34dd7fb006273ee313330dbf21bab66462d0,2,25,10,35,15,2009-04-12 05:34:07,2009-04-12 05:34:07
1e0c34dd7fb006273ee313330dbf21bab66462d0...cab85015c59028c490f6cfd3e15f5f80e3f1055d,1,6,2,8,5,2009-04-12 05:56:59,2009-04-12 05:56:59
cab85015c59028c490f6cfd3e15f5f80e3f1055d...2c6e3b30b3caaa3d3422843f0e16b0d0ae1f4b76,2,22,2,24,3,2009-04-13 03:07:59,2009-04-13 03:07:59
2c6e3b30b3caaa3d3422843f0e16b0d0ae1f4b76...6be2d903f328421e11a0da3c3321d15ceaeb1656,3,27,3,30,6,2009-04-13 07:16:44,2009-04-13 07:16:44
6be2d903f328421e11a0da3c3321d15ceaeb1656...960d3172f630b80c909ffb517356fdb3161d2d3a,4,95,9,104,11,2009-04-13 12:40:43,2009-04-13 12:40:43
960d3172f630b80c909ffb517356fdb3161d2d3a...e471bbe2099bca630650acc7f6b15c7cad5e2c3f,2,34,7,41,11,2009-04-13 13:26:31,2009-04-13 13:26:31
e471bbe2099bca630650acc7f6b15c7cad5e2c3f...b8abb9b872e2ed05c058bb0d517a5c83fe4a14aa,1,4,4,8,1,2009-04-16 13:27:46,2009-04-16 13:27:46
b8abb9b872e2ed05c058bb0d517a5c83fe4a14aa...c89bf435c21168a4a1afd24870c6457adaa9cdd9,1,13,0,13,1,2009-04-16 13:28:16,2009-04-16 13:28:16
c89bf435c21168a4a1afd24870c6457adaa9cdd9...e249b0ec4d8bb3880883927a1c732d882bcdfa48,2,32,46,78,27,2009-04-16 13:28:58,2009-04-16 13:28:58
e249b0ec4d8bb3880883927a1c732d882bcdfa48...33eca69b95bb1e7380767b51cfef068088396367,1,2,2,4,2,2009-04-16 13:29:31,2009-04-16 13:29:31
33eca69b95bb1e7380767b51cfef068088396367...5f20587fcb43cac9a65b72d44a201edf0666dd07,2,27,6,33,6,2009-04-16 14:59:37,2009-04-16 14:59:37
5f20587fcb43cac9a65b72d44a201edf0666dd07...f80769d0892b6f4cf8ae47ad8d15c7f43605555e,2,23,1,24,3,2009-04-16 15:00:20,2009-04-16 15:00:20
f80769d0892b6f4cf8ae47ad8d15c7f43605555e...5acc58360d8eee377d7c1d4c3d80ab28bc541633,0,0,0,0,0,2009-04-16 15:02:33,2009-04-16 15:02:33
5acc58360d8eee377d7c1d4c3d80ab28bc541633...c17547ac50959f7df9e2b8288bae55806c433782,1,6,6,12,3,2009-04-17 16:28:13,2009-04-17 16:28:13
c17547ac50959f7df9e2b8288bae55806c433782...2ee33cf63bba3ec26d9b4845136f48477182e7e4,3,73,43,116,7,2009-04-18 15:52:58,2009-04-18 15:52:58
2ee33cf63bba3ec26d9b4845136f48477182e7e4...681a26ca9028838a2e790824b7e40b2dff3c252b,2,150,5,155,14,2009-04-18 17:36:45,2009-04-18 17:36:45
681a26ca9028838a2e790824b7e40b2dff3c252b...01669a356ae8d10a4332c6f21590176b6bedfe0c,4,109,3,112,7,2009-04-18 20:17:17,2009-04-18 20:17:17
01669a356ae8d10a4332c6f21590176b6bedfe0c...283442a50e1acdbc101096980d0d2c656890710c,3,78,3,81,8,2009-04-18 20:34:42,2009-04-18 20:34:42
283442a50e1acdbc101096980d0d2c656890710c...f0e7dca9d1140731d673bafe5530862d7b041171,1,1,1,2,1,2009-04-18 21:06:19,2009-04-18 21:06:19
f0e7dca9d1140731d673bafe5530862d7b041171...ecb39067915093f6ff3849c57a7853600ecdd50f,2,2,2,4,2,2009-04-19 02:33:20,2009-04-19 02:33:20
ecb39067915093f6ff3849c57a7853600ecdd50f...1c925f65b3f9ca126d97e8166557dc071177913a,1,17,1,18,4,2009-04-19 03:44:06,2009-04-19 03:44:06
1c925f65b3f9ca126d97e8166557dc071177913a...dd51cf9876fb71db080aad767a386c0c3988b114,1,12,9,21,2,2009-04-20 00:11:36,2009-04-20 00:11:36
dd51cf9876fb71db080aad767a386c0c3988b114...f8738369891bdef86ce8067ccbdc053debffbfc2,0,0,0,0,0,2009-04-21 16:41:33,2009-04-21 16:41:33
f8738369891bdef86ce8067ccbdc053debffbfc2...40a7b54a00561c307b3e5d9ec694bbdbe0f8cff2,1,12,0,12,1,2009-04-21 17:48:00,2009-04-21 17:48:00
40a7b54a00561c307b3e5d9ec694bbdbe0f8cff2...a486c1e9b60f145f6ef867ea64a3c8beb750f5cf,1,17,0,17,1,2009-04-21 17:56:54,2009-04-21 17:56:54
a486c1e9b60f145f6ef867ea64a3c8beb750f5cf...9fabfedcbe4fa8809f08f45cf5f612b8bc1bc67d,1,1,5,6,4,2009-04-21 18:09:52,2009-04-21 18:09:52
9fabfedcbe4fa8809f08f45cf5f612b8bc1bc67d...65b64d5a08b1ac6d4236e35a1f2169998027e7f5,0,0,0,0,0,2009-04-21 18:34:27,2009-04-21 18:34:27
65b64d5a08b1ac6d4236e35a1f2169998027e7f5...0d17a5c7c654c1c46390c092f7898a068cf475e2,1,3,2,5,3,2009-04-21 18:36:45,2009-04-21 18:36:45
0d17a5c7c654c1c46390c092f7898a068cf475e2...7ff22ef258e464b44cbb295738e7c0776ab7909f,3,61,39,100,5,2009-04-21 18:58:32,2009-04-21 18:58:32
7ff22ef258e464b44cbb295738e7c0776ab7909f...ed5e3c3d2bf58583dcf50481b2d79f839b411b58,1,1,1,2,1,2009-04-21 20:14:42,2009-04-21 20:14:42
ed5e3c3d2bf58583dcf50481b2d79f839b411b58...f110f91a0399afad8db9b2925737074d185d20bf,5,68,34,102,16,2009-04-21 21:25:47,2009-04-21 21:25:47
f110f91a0399afad8db9b2925737074d185d20bf...725ffa57bb33c45956ec11f14eae997cf9607bc2,2,25,0,25,3,2009-04-21 22:40:49,2009-04-21 22:40:49
725ffa57bb33c45956ec11f14eae997cf9607bc2...cb92893598a31bf3af697d65e257a33f6686d6a2,1,1,1,2,1,2009-04-21 23:44:28,2009-04-21 23:44:28
cb92893598a31bf3af697d65e257a33f6686d6a2...421b22e8eed0094669f6b197ac52bace5b5f29d9,3,79,19,98,9,2009-04-22 16:14:02,2009-04-22 16:14:02
421b22e8eed0094669f6b197ac52bace5b5f29d9...c39b59e1d9ea60e752ec590e2f4e12940c35f5fe,0,0,0,0,0,2009-04-22 19:26:00,2009-04-22 19:26:00
c39b59e1d9ea60e752ec590e2f4e12940c35f5fe...2ceee52303224ee7a89885a4e676bef245469756,1,20,19,39,7,2009-04-22 22:41:18,2009-04-22 22:41:18
2ceee52303224ee7a89885a4e676bef245469756...91d063c405a8d05a366515d882bd462bf7c00107,1,1,1,2,1,2009-04-23 14:18:02,2009-04-23 14:18:02
91d063c405a8d05a366515d882bd462bf7c00107...3b3c05df72af774edd55d17f575db88786e3973e,1,18,0,18,1,2009-04-23 14:18:11,2009-04-23 14:18:11
3b3c05df72af774edd55d17f575db88786e3973e...a7bfcba5db4789ea22b7d6d2288d45e0aed5afae,4,54,13,67,8,2009-04-24 20:25:48,2009-04-24 20:25:48
a7bfcba5db4789ea22b7d6d2288d45e0aed5afae...e114ffb90a87d722493f4e80c32a2a4b5395f75b,2,178,132,310,124,2009-04-28 09:44:48,2009-04-28 09:44:48
e114ffb90a87d722493f4e80c32a2a4b5395f75b...bf10bded7aece13c95a1c3304c14bc9ba803a7b1,2,22,10,32,3,2009-04-28 14:22:39,2009-04-28 14:22:39
bf10bded7aece13c95a1c3304c14bc9ba803a7b1...655b602020fcac23c3adf1298bb895f612144fcc,0,0,0,0,0,2009-04-28 14:33:31,2009-04-28 14:33:31
655b602020fcac23c3adf1298bb895f612144fcc...23c12c9c2b75fa703ca99485c6da8246f57fa32b,2,141,35,176,20,2009-04-30 13:49:14,2009-04-30 13:49:14
23c12c9c2b75fa703ca99485c6da8246f57fa32b...3c222b1b8be7c04578e50a66578b3a31a8ce70f5,0,0,0,0,0,2009-04-30 15:44:05,2009-04-30 15:44:05
3c222b1b8be7c04578e50a66578b3a31a8ce70f5...d22290b2ce00909c2f92b6dacadfbfb0deeefd7f,5,122,12,134,24,2009-05-02 07:16:30,2009-05-02 07:16:30
d22290b2ce00909c2f92b6dacadfbfb0deeefd7f...5f730ded91dde9720e0219af8c1c7c15fe11b6f8,1,1,1,2,1,2009-05-02 07:43:55,2009-05-02 07:43:55
5f730ded91dde9720e0219af8c1c7c15fe11b6f8...6e1869c46b2213f87fd6060650fac4abb28ecd4d,3,55,46,101,13,2009-05-02 07:44:39,2009-05-02 07:44:39
6e1869c46b2213f87fd6060650fac4abb28ecd4d...c5bc8932484c68ee63d247b4cc5412ef5c21fd0f,0,0,0,0,0,2009-05-02 07:46:37,2009-05-02 07:46:37
c5bc8932484c68ee63d247b4cc5412ef5c21fd0f...5a089a5b0088149dbcebbbf9194d4acde476cb4e,1,8,8,16,6,2009-05-02 14:55:50,2009-05-02 14:55:50
5a089a5b0088149dbcebbbf9194d4acde476cb4e...6a21ada37e353a00dc694441fdc0bcf309f0cc4c,2,31,8,39,8,2009-05-02 14:56:35,2009-05-02 14:56:35
6a21ada37e353a00dc694441fdc0bcf309f0cc4c...e7555c09d834a971bfdfa50eb263db6d5288211b,0,0,0,0,0,2009-05-02 15:00:01,2009-05-02 15:00:01
e7555c09d834a971bfdfa50eb263db6d5288211b...aefb07d8654e9b2873ad62d599d53c6f027e94de,3,21,15,36,15,2009-05-03 13:46:30,2009-05-03 13:46:30
aefb07d8654e9b2873ad62d599d53c6f027e94de...f137a7391e56f35231cf66df29bff8097b5cc98d,5,54,3,57,4,2009-05-03 13:47:36,2009-05-03 13:47:36
f137a7391e56f35231cf66df29bff8097b5cc98d...0e5c80f86c8d221e57b21d658e81de554cda658f,2,33,7,40,10,2009-05-03 13:48:27,2009-05-03 13:48:27
0e5c80f86c8d221e57b21d658e81de554cda658f...c03a0a7837a75aa135d0bad36fb9e01222292e48,0,0,0,0,0,2009-05-03 13:50:09,2009-05-03 13:50:09
c03a0a7837a75aa135d0bad36fb9e01222292e48...6541739765db8bb11a1ed87cce5e6c25b1e71d9a,2,35,3,38,4,2009-05-05 12:46:50,2009-05-05 12:46:50
6541739765db8bb11a1ed87cce5e6c25b1e71d9a...fc15d690b1c33a3ead51bf420db1d67e9045e631,0,0,0,0,0,2009-05-05 22:31:15,2009-05-05 22:31:15
fc15d690b1c33a3ead51bf420db1d67e9045e631...643e914d2b769881504132a9be1cf8efbdc05bd3,1,3,2,5,3,2009-05-07 12:54:33,2009-05-07 12:54:33
643e914d2b769881504132a9be1cf8efbdc05bd3...9b724aea20047f1ad3c8c644f3b79771860a09dd,1,1,1,2,1,2009-05-07 13:48:35,2009-05-07 13:48:35
9b724aea20047f1ad3c8c644f3b79771860a09dd...67f9ad2801ce3d9da9e7739c07d81f759dbee162,4,58,6,64,4,2009-05-07 15:40:13,2009-05-07 15:40:13
67f9ad2801ce3d9da9e7739c07d81f759dbee162...b03e58b936a9541a1fb63e92ac207b51e9551e66,2,198,143,341,133,2009-05-07 17:55:31,2009-05-07 17:55:31
b03e58b936a9541a1fb63e92ac207b51e9551e66...09c2559b4193992f6ba29f033052b81c87f4f2f0,1,2,2,4,2,2009-05-07 17:55:38,2009-05-07 17:55:38
09c2559b4193992f6ba29f033052b81c87f4f2f0...6a080b199cb9432cdab795bdbaff689f2bf77ea7,2,198,151,349,136,2009-05-07 17:55:54,2009-05-07 17:55:54
6a080b199cb9432cdab795bdbaff689f2bf77ea7...899d484afb5653a171058e7683de6ea07b293462,3,9,9,18,3,2009-05-07 18:11:43,2009-05-07 18:11:43
899d484afb5653a171058e7683de6ea07b293462...1b9893f991aa87062dc483cec242356804b632bb,1,5,6,11,1,2009-05-08 04:46:30,2009-05-08 04:46:30
1b9893f991aa87062dc483cec242356804b632bb...e93b3a7b02ab3c8fb04a794458c85a5f6d7f26b1,2,51,12,63,8,2009-05-08 05:52:44,2009-05-08 05:52:44
e93b3a7b02ab3c8fb04a794458c85a5f6d7f26b1...a109a223b83fa7fc4e46795219a545a651e8f8a9,2,15,10,25,7,2009-05-08 09:56:25,2009-05-08 09:56:25
a109a223b83fa7fc4e46795219a545a651e8f8a9...7935231ef086b5649136dfbb2e49e3e413ecb344,2,150,98,248,10,2009-05-08 11:02:49,2009-05-08 11:02:49
7935231ef086b5649136dfbb2e49e3e413ecb344...864b78135a61e33e4433c95fd760d04ed8fe4c50,3,21,0,21,4,2009-05-08 11:10:23,2009-05-08 11:10:23
864b78135a61e33e4433c95fd760d04ed8fe4c50...4f383e2939d3a6d6b56e9032c926b181351bf6b8,3,0,21,21,4,2009-05-08 11:13:17,2009-05-08 11:13:17
4f383e2939d3a6d6b56e9032c926b181351bf6b8...cd4f12d116c0639b2c17b7affed9fa5c1d9b8153,1,1,1,2,1,2009-05-08 12:58:57,2009-05-08 12:58:57
cd4f12d116c0639b2c17b7affed9fa5c1d9b8153...7bcbc99b9e25aac38266aac1fbaad9323dfaf419,3,325,61,386,52,2009-05-08 16:04:59,2009-05-08 16:04:59
7bcbc99b9e25aac38266aac1fbaad9323dfaf419...41ba8e7ca6c0cd089cf196207ec136e815721399,4,145,6,151,6,2009-05-08 16:08:55,2009-05-08 16:08:55
41ba8e7ca6c0cd089cf196207ec136e815721399...8397c1fdfacc3dfffd77903e30127c05e1968ac6,2,45,42,87,34,2009-05-08 16:12:51,2009-05-08 16:12:51
8397c1fdfacc3dfffd77903e30127c05e1968ac6...1fe7eb603d40da5ebab3589073c287844b614853,2,5,7,12,4,2009-05-08 16:49:49,2009-05-08 16:49:49
1fe7eb603d40da5ebab3589073c287844b614853...cde397df318444b405d7ad55f4c64d332f1225ae,0,0,0,0,0,2009-05-09 05:31:19,2009-05-09 05:31:19
cde397df318444b405d7ad55f4c64d332f1225ae...0d930ee0e647cdc46517971a8b84a304adb1178e,3,291,2,293,5,2009-05-09 11:52:15,2009-05-09 11:52:15
0d930ee0e647cdc46517971a8b84a304adb1178e...bc07a498fe789ed5c4057d56bac6ba50d7296ed1,3,34,1,35,4,2009-05-11 00:01:40,2009-05-11 00:01:40
bc07a498fe789ed5c4057d56bac6ba50d7296ed1...1b6fac19ce0c547dd7c5051d430cf27a8e1186a5,0,0,0,0,0,2009-05-11 00:06:03,2009-05-11 00:06:03
1b6fac19ce0c547dd7c5051d430cf27a8e1186a5...9b8644407d12b5aab52853578812d4b929201c16,2,11,6,17,5,2009-05-11 01:48:06,2009-05-11 01:48:06
9b8644407d12b5aab52853578812d4b929201c16...0f98f0b2146709c7188ca4f8d3801f85c4d685ef,1,27,30,57,6,2009-05-11 20:56:38,2009-05-11 20:56:38
0f98f0b2146709c7188ca4f8d3801f85c4d685ef...da4ddabbe56c04c5f827a135c97cbe3ab30524fe,1,19,17,36,7,2009-05-12 17:25:07,2009-05-12 17:25:07
da4ddabbe56c04c5f827a135c97cbe3ab30524fe...a1d6fdafce04dd08783e4fa6938d45d31c69ee8f,1,9,0,9,1,2009-05-12 17:25:29,2009-05-12 17:25:29
a1d6fdafce04dd08783e4fa6938d45d31c69ee8f...5e20f14c8bab69c92c4f442889ff76128c5105a8,1,5,0,5,1,2009-05-12 20:32:03,2009-05-12 20:32:03
5e20f14c8bab69c92c4f442889ff76128c5105a8...08577ab0f1b716e05d728c2c7544cd7dd7fa4877,2,26,2,28,4,2009-05-12 22:03:19,2009-05-12 22:03:19
08577ab0f1b716e05d728c2c7544cd7dd7fa4877...cc96ed9ecd08a612094d2a43571cd81fb98f60a0,2,27,6,33,5,2009-05-12 22:03:32,2009-05-12 22:03:32
cc96ed9ecd08a612094d2a43571cd81fb98f60a0...17d214a9821542696b4b632b1fc70086ed2f7ecc,2,24,10,34,8,2009-05-13 14:31:39,2009-05-13 14:31:39
17d214a9821542696b4b632b1fc70086ed2f7ecc...c48285910533e5443bba3f8a03a2ac9d82856e52,4,51,5,56,9,2009-05-13 14:32:18,2009-05-13 14:32:18
c48285910533e5443bba3f8a03a2ac9d82856e52...fe42c64a41c63449325b87e3b7b8211924b63717,0,0,0,0,0,2009-05-13 14:39:48,2009-05-13 14:39:48
fe42c64a41c63449325b87e3b7b8211924b63717...3961b855e7711a5df8b3574b8481d638232371e5,0,0,0,0,0,2009-05-13 15:38:18,2009-05-13 15:38:18
3961b855e7711a5df8b3574b8481d638232371e5...9e03bf2d47a3a6a8e743a385756b62908cab6b41,0,0,0,0,0,2009-05-13 16:05:23,2009-05-13 16:05:23
9e03bf2d47a3a6a8e743a385756b62908cab6b41...cccfeaaa180ecd5ee55e8d9d4dada8515ae11f7e,1,1,0,1,1,2009-05-13 16:19:52,2009-05-13 16:19:52
cccfeaaa180ecd5ee55e8d9d4dada8515ae11f7e...68033811eecd1f1b06b39d0a335042e1ff9036a6,1,1,0,1,1,2009-05-13 17:11:18,2009-05-13 17:11:18
68033811eecd1f1b06b39d0a335042e1ff9036a6...11d08bca2bf99de7e7aefec7986a206ea5039724,4,73,3,76,7,2009-05-13 18:41:39,2009-05-13 18:41:39
11d08bca2bf99de7e7aefec7986a206ea5039724...f4fce99bc1247f333c4093f3cfa077f7acd8d541,3,14,3,17,6,2009-05-13 18:45:16,2009-05-13 18:45:16
f4fce99bc1247f333c4093f3cfa077f7acd8d541...4c79ef99c21086096aa7cf6a66be6c4d41d5678c,1,1,1,2,1,2009-05-13 18:48:35,2009-05-13 18:48:35
4c79ef99c21086096aa7cf6a66be6c4d41d5678c...86c278f2a53bf37e5d3b6f0cc20a69b759b321c4,0,0,0,0,0,2009-05-13 19:14:02,2009-05-13 19:14:02
86c278f2a53bf37e5d3b6f0cc20a69b759b321c4...bcda65e991c33a3a6e1f053e58f14187dfe1a920,1,1,1,2,1,2009-05-14 01:54:41,2009-05-14 01:54:41
bcda65e991c33a3a6e1f053e58f14187dfe1a920...cefeb13f91e1a81a373fc2f941797f4b0b0194f9,1,44,21,65,12,2009-05-14 02:01:54,2009-05-14 02:01:54
cefeb13f91e1a81a373fc2f941797f4b0b0194f9...ce369dce138dc51e4cb12dc4548ebd2c46cac015,1,10,0,10,1,2009-05-14 02:03:35,2009-05-14 02:03:35
ce369dce138dc51e4cb12dc4548ebd2c46cac015...91a17a843fc132e10173fa69d143ac6738b0f43f,1,4,0,4,1,2009-05-14 02:15:53,2009-05-14 02:15:53
91a17a843fc132e10173fa69d143ac6738b0f43f...5015860ebf7a49747738d5bab2399553ec7dbe9f,1,16,16,32,1,2009-05-14 02:28:56,2009-05-14 02:28:56
5015860ebf7a49747738d5bab2399553ec7dbe9f...c293450173ae805d73997d360a2ab5a8357ba4f8,2,68,63,131,3,2009-05-14 02:30:25,2009-05-14 02:30:25
c293450173ae805d73997d360a2ab5a8357ba4f8...7f90dc1ba235e0050e6b73fff4f61ded3b297ccf,4,48,13,61,3,2009-05-14 15:13:49,2009-05-14 15:13:49
7f90dc1ba235e0050e6b73fff4f61ded3b297ccf...55f1c3e176fdae13d96282fc0f3385000941f2e7,3,144,13,157,12,2009-05-15 13:06:57,2009-05-15 13:06:57
55f1c3e176fdae13d96282fc0f3385000941f2e7...985c939dd0031ced6a96bfbf2dc3cdeb7544fe0d,1,13,14,27,11,2009-05-15 15:06:57,2009-05-15 15:06:57
985c939dd0031ced6a96bfbf2dc3cdeb7544fe0d...f5dcd07977a00ef84fc24ba5719ea86a453b1c8c,1,105,19,124,8,2009-05-16 06:27:44,2009-05-16 06:27:44
f5dcd07977a00ef84fc24ba5719ea86a453b1c8c...e21c85c58e2d7963fb141988fd7a918bf15e62ca,0,0,0,0,0,2009-05-16 06:30:12,2009-05-16 06:30:12
e21c85c58e2d7963fb141988fd7a918bf15e62ca...a04fd1ef30824cfe24e3cf43d1593f197a270bc9,0,0,0,0,0,2009-05-16 19:01:51,2009-05-16 19:01:51
a04fd1ef30824cfe24e3cf43d1593f197a270bc9...ebd74921bbb2df485567d9325982d166ba01bb01,1,22,28,50,9,2009-05-17 16:15:16,2009-05-17 16:15:16
ebd74921bbb2df485567d9325982d166ba01bb01...e6a6ce4f070e38721d2e19a803ea2988c6c442dc,1,1,1,2,1,2009-05-17 16:22:44,2009-05-17 16:22:44
e6a6ce4f070e38721d2e19a803ea2988c6c442dc...1f5626d087358668980f944a1a59642a4a99e2d0,1,1,1,2,1,2009-05-17 16:33:00,2009-05-17 16:33:00
1f5626d087358668980f944a1a59642a4a99e2d0...02b6f16422495666038734a8e7d63d0dc3f34d4c,11,11,11,22,11,2009-05-17 16:53:38,2009-05-17 16:53:38
02b6f16422495666038734a8e7d63d0dc3f34d4c...509dfdd3a75bd8c8529d73ca04e6cfbecc82066e,1,2,0,2,1,2009-05-17 17:28:34,2009-05-17 17:28:34
509dfdd3a75bd8c8529d73ca04e6cfbecc82066e...e2189f6d247d9d0125cf8c46da9e1dd3f3b5d17e,1,1,1,2,1,2009-05-17 17:45:12,2009-05-17 17:45:12
e2189f6d247d9d0125cf8c46da9e1dd3f3b5d17e...fc24a690288e5ff79e50486fc410c9c56fafafe1,2,5,1,6,2,2009-05-17 17:57:41,2009-05-17 17:57:41
fc24a690288e5ff79e50486fc410c9c56fafafe1...d4e44699aa32a591e8e57cbb148fbaabf2deaab8,2,3,3,6,3,2009-05-17 18:06:12,2009-05-17 18:06:12
d4e44699aa32a591e8e57cbb148fbaabf2deaab8...65966cebd34b171f5156d7334dd9793906d5897c,1,3,3,6,1,2009-05-17 18:11:58,2009-05-17 18:11:58
65966cebd34b171f5156d7334dd9793906d5897c...efbe48cfcb98c7e0c15d47f40ad48058f3121198,1,4,0,4,1,2009-05-17 18:47:32,2009-05-17 18:47:32
efbe48cfcb98c7e0c15d47f40ad48058f3121198...ad2efbdd61f890a2e17d3d1391dbd90ea91626d1,1,5,4,9,3,2009-05-18 16:02:43,2009-05-18 16:02:43
ad2efbdd61f890a2e17d3d1391dbd90ea91626d1...c6f7f2f09227b61b392e56682c51baec24d07108,0,0,0,0,0,2009-05-18 16:06:04,2009-05-18 16:06:04
c6f7f2f09227b61b392e56682c51baec24d07108...593bcc155a7a23654f226fe705a66c1b30e2a6d5,2,15,3,18,7,2009-05-19 13:10:35,2009-05-19 13:10:35
593bcc155a7a23654f226fe705a66c1b30e2a6d5...cb73fe916eb241f486b1ec628a79356cbd323b0a,0,0,0,0,0,2009-05-19 15:05:22,2009-05-19 15:05:22
cb73fe916eb241f486b1ec628a79356cbd323b0a...3cd3df814da9227bd6f4d3a68271d04fd1e94c33,0,0,0,0,0,2009-05-19 23:39:35,2009-05-19 23:39:35
3cd3df814da9227bd6f4d3a68271d04fd1e94c33...e00173806361ce0756bea8a2e2efaac773f56569,1,1,1,2,1,2009-05-20 00:26:07,2009-05-20 00:26:07
e00173806361ce0756bea8a2e2efaac773f56569...10637a94cb215473a5aff3d1c7fa719a95d699ba,2,126,73,199,29,2009-05-20 16:19:24,2009-05-20 16:19:24
10637a94cb215473a5aff3d1c7fa719a95d699ba...19e2585a3859475503199ad018688678a1cb3d0f,1,4,2,6,2,2009-05-20 20:05:49,2009-05-20 20:05:49
19e2585a3859475503199ad018688678a1cb3d0f...24108801b6a41b84a69830374c2b27a87e60f86d,1,1,2,3,1,2009-05-23 13:06:26,2009-05-23 13:06:26
24108801b6a41b84a69830374c2b27a87e60f86d...82f9f74821c6ab13f02bed16eb1c2490120e83b9,2,7,1,8,2,2009-05-24 06:48:43,2009-05-24 06:48:43
82f9f74821c6ab13f02bed16eb1c2490120e83b9...f37a02ec036aefb22a2a7311af8f926c9e91571d,1,6,39,45,4,2009-05-26 16:33:10,2009-05-26 16:33:10
f37a02ec036aefb22a2a7311af8f926c9e91571d...b9db62ee605d5569d69b71b6aa3bda4447870727,1,3,3,6,3,2009-05-26 16:48:49,2009-05-26 16:48:49
b9db62ee605d5569d69b71b6aa3bda4447870727...18feaead043532b8a6de1b2e898c940e6949ec2f,1,1,1,2,1,2009-05-27 16:06:35,2009-05-27 16:06:35
18feaead043532b8a6de1b2e898c940e6949ec2f...28380f48ca0507a05b2effe5c5b7f376ba43d9c2,1,3,0,3,1,2009-05-27 16:21:49,2009-05-27 16:21:49
28380f48ca0507a05b2effe5c5b7f376ba43d9c2...e2e092cff978603211a38a0df67d50d89e957c56,1,1,1,2,1,2009-05-27 16:28:38,2009-05-27 16:28:38
e2e092cff978603211a38a0df67d50d89e957c56...0871c87b77f8e43bf3a8fd2d10b74f8a11ddfef9,2,30,30,60,26,2009-05-29 04:39:59,2009-05-29 04:39:59
0871c87b77f8e43bf3a8fd2d10b74f8a11ddfef9...53b04361026afb1874a107134f5384c3a4936c03,2,7,7,14,5,2009-05-29 05:28:40,2009-05-29 05:28:40
53b04361026afb1874a107134f5384c3a4936c03...056796b74d871bbd4935542da8c9ad2a985dee75,3,70,2,72,8,2009-06-03 13:43:05,2009-06-03 13:43:05
056796b74d871bbd4935542da8c9ad2a985dee75...a6db5f229b59fbfa191f93fc183d5b0394d30062,0,0,0,0,0,2009-06-06 08:36:13,2009-06-06 08:36:13
a6db5f229b59fbfa191f93fc183d5b0394d30062...7560497a50d4d9753ec1694d80b5d8dcd7873df4,0,0,0,0,0,2009-06-06 13:39:13,2009-06-06 13:39:13
7560497a50d4d9753ec1694d80b5d8dcd7873df4...a827ba72a123c21c5ea6b2d4297b4c971e823a58,0,0,0,0,0,2009-06-06 13:48:00,2009-06-06 13:48:00
a827ba72a123c21c5ea6b2d4297b4c971e823a58...8092c67d51668c616ad3352ad269eafe75a98fb0,3,88,7,95,6,2009-06-08 05:29:47,2009-06-08 05:29:47
8092c67d51668c616ad3352ad269eafe75a98fb0...7ee3d0cd4d5755d3d2709fae5ada9566164643e1,0,0,0,0,0,2009-06-08 14:51:44,2009-06-08 14:51:44
7ee3d0cd4d5755d3d2709fae5ada9566164643e1...0a4890466c0f262970536014a983035aea1d4cdb,0,0,0,0,0,2009-06-09 14:04:27,2009-06-09 14:04:27
0a4890466c0f262970536014a983035aea1d4cdb...383c46dc8d724db1168e786e5199597453c18c5a,1,20,10,30,6,2009-06-10 12:51:35,2009-06-10 12:51:35
383c46dc8d724db1168e786e5199597453c18c5a...922aed54658f2b7ad714f3ba685f0f696e70e499,1,13,10,23,4,2009-06-10 12:54:15,2009-06-10 12:54:15
922aed54658f2b7ad714f3ba685f0f696e70e499...a7f109d50f346b3f089d84c5747734724b7bb5a5,1,10,10,20,5,2009-06-10 12:57:06,2009-06-10 12:57:06
a7f109d50f346b3f089d84c5747734724b7bb5a5...3f28be2b65941099df0c8074cd000432dcfb9236,1,2,2,4,1,2009-06-10 13:00:28,2009-06-10 13:00:28
3f28be2b65941099df0c8074cd000432dcfb9236...ea5e5a20a9e73d412a87b05d3fc90f447ff0b0db,2,55,39,94,23,2009-06-11 02:53:32,2009-06-11 02:53:32
ea5e5a20a9e73d412a87b05d3fc90f447ff0b0db...bbe034a74f33296f228a9d19fb3dc07072a079e7,1,1,1,2,1,2009-06-11 19:06:12,2009-06-11 19:06:12
bbe034a74f33296f228a9d19fb3dc07072a079e7...b9952794c387430e7c03510ad1a0db2497f1baf2,2,109,24,133,12,2009-06-12 14:09:36,2009-06-12 14:09:36
b9952794c387430e7c03510ad1a0db2497f1baf2...1ff9ec9f126e3a4346ec2fd07038b00b37952b74,1,1,1,2,1,2009-06-12 17:19:19,2009-06-12 17:19:19
1ff9ec9f126e3a4346ec2fd07038b00b37952b74...8656fffbe0d30c35a7415f8b5928d06ff93e8cc3,3,29,12,41,4,2009-06-15 11:54:03,2009-06-15 11:54:03
8656fffbe0d30c35a7415f8b5928d06ff93e8cc3...d0a3b92e4bf21820c5c91922e32d68449f8ea4d4,2,48,3,51,6,2009-06-15 15:06:35,2009-06-15 15:06:35
d0a3b92e4bf21820c5c91922e32d68449f8ea4d4...c19d10c1807339b3395fa013f79c93ca1422d079,1,3,0,3,1,2009-06-17 13:12:28,2009-06-17 13:12:28
c19d10c1807339b3395fa013f79c93ca1422d079...e63e0bb40092f319d11e66e6b2c4936e1ab1f8f8,1,14,11,25,12,2009-06-17 13:52:05,2009-06-17 13:52:05
e63e0bb40092f319d11e66e6b2c4936e1ab1f8f8...40bcd34fab32d112645fcdaecb1b92388094287b,2,46,2,48,4,2009-06-17 13:54:43,2009-06-17 13:54:43
40bcd34fab32d112645fcdaecb1b92388094287b...9d7e51d9574025d1bcc4707a8f0ce5185762300a,4,515,65,580,10,2009-06-17 14:19:54,2009-06-17 14:19:54
9d7e51d9574025d1bcc4707a8f0ce5185762300a...a44960b083131ee44ff5376d3441950404f34321,1,1,1,2,1,2009-06-17 20:02:17,2009-06-17 20:02:17
a44960b083131ee44ff5376d3441950404f34321...7cccaaaf706f883dddd18c86d51cea52977277f6,1,1,1,2,1,2009-06-18 12:42:57,2009-06-18 12:42:57
7cccaaaf706f883dddd18c86d51cea52977277f6...4a79eaac9767f229b362472fba58feca57cf32ce,1,1,0,1,1,2009-06-18 14:12:55,2009-06-18 14:12:55
4a79eaac9767f229b362472fba58feca57cf32ce...58e4a9d9383b32e07507009df0787a41c35eab82,5,34,31,65,25,2009-06-18 14:13:50,2009-06-18 14:13:50
58e4a9d9383b32e07507009df0787a41c35eab82...9029db7b79f514a3b0757797407a9ee345ec4a98,1,26,22,48,20,2009-06-18 14:14:21,2009-06-18 14:14:21
9029db7b79f514a3b0757797407a9ee345ec4a98...7ccd095755f0d6d9187bf44563bbbe62cc475078,1,8,8,16,8,2009-06-18 14:14:52,2009-06-18 14:14:52
7ccd095755f0d6d9187bf44563bbbe62cc475078...82ffb6747f63f5e267134c56c6b5d707c5e63049,1,1,1,2,1,2009-06-18 14:15:27,2009-06-18 14:15:27
82ffb6747f63f5e267134c56c6b5d707c5e63049...c77f83ceaefb39ffac6ff8a24d7189e764458e92,1,9,6,15,2,2009-06-18 14:16:13,2009-06-18 14:16:13
c77f83ceaefb39ffac6ff8a24d7189e764458e92...5301334f156de4d8d7fbb74cc25c5e0d00eb37cb,1,1,1,2,1,2009-06-18 14:16:45,2009-06-18 14:16:45
5301334f156de4d8d7fbb74cc25c5e0d00eb37cb...7cebfa1c4945f817e492058af8f7fe15daa9aa65,1,1,1,2,1,2009-06-18 14:17:13,2009-06-18 14:17:13
7cebfa1c4945f817e492058af8f7fe15daa9aa65...91e16bdcb7b0874baffd0c4a4933c8703c5a194e,1,6,6,12,5,2009-06-18 14:17:45,2009-06-18 14:17:45
91e16bdcb7b0874baffd0c4a4933c8703c5a194e...527609ccc9030e15c906621e9d416b52a1395743,1,4,1,5,1,2009-06-18 14:18:13,2009-06-18 14:18:13
527609ccc9030e15c906621e9d416b52a1395743...0c24c3ee179e76452a7e4fd0523cc225612950e6,1,5,1,6,1,2009-06-18 14:18:43,2009-06-18 14:18:43
0c24c3ee179e76452a7e4fd0523cc225612950e6...9356e16a622a801cda872b6ae6ad86183547e724,0,0,0,0,0,2009-06-18 14:22:39,2009-06-18 14:22:39
9356e16a622a801cda872b6ae6ad86183547e724...bb0538d4d5122272ab12469778f7cacc818f504f,1,1,1,2,1,2009-06-18 15:07:22,2009-06-18 15:07:22
bb0538d4d5122272ab12469778f7cacc818f504f...c9771f0b4a645c38fa7ef1996a24890c47e197d8,2,6,1,7,3,2009-06-18 15:14:04,2009-06-18 15:14:04
c9771f0b4a645c38fa7ef1996a24890c47e197d8...75de41f9109c7d7a3aa176b51fb6b8225c71cb36,1,4,3,7,2,2009-06-19 01:38:53,2009-06-19 01:38:53
75de41f9109c7d7a3aa176b51fb6b8225c71cb36...589d96ce4a8d2ee4e4e1192ba59b575322b521ef,2,58,12,70,9,2009-06-24 14:19:44,2009-06-24 14:19:44
589d96ce4a8d2ee4e4e1192ba59b575322b521ef...e717ddc0da5e15f4c1b11ae8409fa8cfecd5b15b,1,1,1,2,1,2009-06-24 14:20:38,2009-06-24 14:20:38
e717ddc0da5e15f4c1b11ae8409fa8cfecd5b15b...60ec0bdec2e3eb4367b6a3687db3b52936353cf2,1,106,4,110,5,2009-06-24 14:21:19,2009-06-24 14:21:19
60ec0bdec2e3eb4367b6a3687db3b52936353cf2...34fbf191c14b7891a2ee74bca91cc5411b80ef6f,1,1,1,2,1,2009-06-24 14:22:11,2009-06-24 14:22:11
34fbf191c14b7891a2ee74bca91cc5411b80ef6f...b287f8a96fc30e74d85d5c04836a557611b033cc,2,18,7,25,3,2009-06-24 14:23:24,2009-06-24 14:23:24
b287f8a96fc30e74d85d5c04836a557611b033cc...7c8a6605ea13ba0f0396e1c33ac81ed4024278b6,1,11,7,18,4,2009-06-24 23:40:00,2009-06-24 23:40:00
7c8a6605ea13ba0f0396e1c33ac81ed4024278b6...cef2a6f236ecf1d18b802823d24ddb80feb40562,0,0,0,0,0,2009-06-25 05:36:29,2009-06-25 05:36:29
cef2a6f236ecf1d18b802823d24ddb80feb40562...998a3776ed3a98af94e2424ea5fbef4db843eca4,0,0,0,0,0,2009-06-25 05:52:54,2009-06-25 05:52:54
998a3776ed3a98af94e2424ea5fbef4db843eca4...8d25e8f82892347e45426b8e22f233b5696c18b9,1,7,7,14,4,2009-06-25 05:56:43,2009-06-25 05:56:43
8d25e8f82892347e45426b8e22f233b5696c18b9...74b631667bd50871a32932db483b9245a0d5636a,0,0,0,0,0,2009-06-25 06:16:38,2009-06-25 06:16:38
74b631667bd50871a32932db483b9245a0d5636a...c4e240fae3972f4848fe663a171754b0a309dddc,3,8,2,10,4,2009-06-29 14:10:53,2009-06-29 14:10:53
c4e240fae3972f4848fe663a171754b0a309dddc...1153d4bf8003485461ea8194f938ee8a77c74364,2,18,1,19,3,2009-06-29 14:23:28,2009-06-29 14:23:28
1153d4bf8003485461ea8194f938ee8a77c74364...8fd40001f5e3d50c1b7f8ead4d30af942dd3ed6c,1,1,1,2,1,2009-06-29 17:58:07,2009-06-29 17:58:07
8fd40001f5e3d50c1b7f8ead4d30af942dd3ed6c...2a7b781cfee2f81ce808a56b13df4cedaad14d8c,1,17,1,18,2,2009-06-30 18:41:12,2009-06-30 18:41:12
2a7b781cfee2f81ce808a56b13df4cedaad14d8c...c60901c031f3053cbe4e81cb8eb3e653bd3ac9aa,1,6,2,8,2,2009-07-02 14:44:28,2009-07-02 14:44:28
c60901c031f3053cbe4e81cb8eb3e653bd3ac9aa...f538e15a2cab8d2ddd2b5c6153019c31ecd6ee4d,0,0,0,0,0,2009-07-03 03:27:31,2009-07-03 03:27:31
f538e15a2cab8d2ddd2b5c6153019c31ecd6ee4d...4aca3be925e56db3c97331e3a32f9dd21df1cdc1,2,40,15,55,13,2009-07-03 06:09:57,2009-07-03 06:09:57
4aca3be925e56db3c97331e3a32f9dd21df1cdc1...9219741ee77b59227b8011243488d0a7bfee778f,2,32,9,41,11,2009-07-03 06:12:50,2009-07-03 06:12:50
9219741ee77b59227b8011243488d0a7bfee778f...45411379b4891a8d373e3232b95596f445bbab73,1,75,6,81,4,2009-07-03 06:15:48,2009-07-03 06:15:48
45411379b4891a8d373e3232b95596f445bbab73...df2011c61b85e52bb8e4c092e7e30a8b11caa770,1,2,0,2,1,2009-07-03 06:25:42,2009-07-03 06:25:42
df2011c61b85e52bb8e4c092e7e30a8b11caa770...c05f4d5a220d6dc83c5b68f3beb5fb3b49d30d29,1,1,1,2,1,2009-07-03 07:20:36,2009-07-03 07:20:36
c05f4d5a220d6dc83c5b68f3beb5fb3b49d30d29...40f24b46357ec486487c50898185ff5caa2e46e2,1,23,2,25,2,2009-07-03 07:23:37,2009-07-03 07:23:37
40f24b46357ec486487c50898185ff5caa2e46e2...7b5869e140379bb4a6525bc5e48a1dc069635d23,1,15,2,17,3,2009-07-03 07:47:05,2009-07-03 07:47:05
7b5869e140379bb4a6525bc5e48a1dc069635d23...63a7b95693d53e42607f30c7b5966913ebb83aa5,2,11,10,21,3,2009-07-03 14:16:21,2009-07-03 14:16:21
63a7b95693d53e42607f30c7b5966913ebb83aa5...f921908bc25e0161eec2c020e368f77be48fbe49,0,0,0,0,0,2009-07-03 14:19:14,2009-07-03 14:19:14
f921908bc25e0161eec2c020e368f77be48fbe49...e3cf57598e8e72fe9eaeadf3566e4d01fdfcfc3d,2,83,57,140,51,2009-07-07 13:31:32,2009-07-07 13:31:32
e3cf57598e8e72fe9eaeadf3566e4d01fdfcfc3d...18f12a3884a41ce0ba457e0834dd7a9576a1fb4a,2,83,57,140,51,2009-07-07 13:31:57,2009-07-07 13:31:57
18f12a3884a41ce0ba457e0834dd7a9576a1fb4a...aa0be5b7f0c72e58385ae29057ff471f9a231877,2,8,3,11,4,2009-07-09 02:37:20,2009-07-09 02:37:20
aa0be5b7f0c72e58385ae29057ff471f9a231877...79af110d3776549fc017d4a7145a5bb72698e9f8,5,61,14,75,7,2009-07-11 14:30:14,2009-07-11 14:30:14
79af110d3776549fc017d4a7145a5bb72698e9f8...667042a0603ec5bd5c0ec24dfb84ab43e9c0f39b,1,1,1,2,1,2009-07-11 15:45:55,2009-07-11 15:45:55
667042a0603ec5bd5c0ec24dfb84ab43e9c0f39b...7cfee7925a60e1c4dd5e8d1bec2fd16e07b23bf5,1,2,2,4,2,2009-07-11 15:48:38,2009-07-11 15:48:38
7cfee7925a60e1c4dd5e8d1bec2fd16e07b23bf5...5c2518539c42146d753f1e2cade4c0af627faeec,1,7,3,10,4,2009-07-11 16:06:59,2009-07-11 16:06:59
5c2518539c42146d753f1e2cade4c0af627faeec...558e4e94822e922cddff315ee13db5baa67b644b,1,1,1,2,1,2009-07-11 16:09:18,2009-07-11 16:09:18
558e4e94822e922cddff315ee13db5baa67b644b...c4f1970b03ab7d5267dda28977ce0696b3e6ab45,0,0,0,0,0,2009-07-11 16:11:50,2009-07-11 16:11:50
c4f1970b03ab7d5267dda28977ce0696b3e6ab45...9133e12a4cb0bc075d176eba16b3efaf395f6e91,0,0,0,0,0,2009-07-13 14:01:04,2009-07-13 14:01:04
9133e12a4cb0bc075d176eba16b3efaf395f6e91...fcbd3bcec99c1783c5ab65003e8bc53e64c867fe,1,36,13,49,12,2009-07-15 14:11:06,2009-07-15 14:11:06
fcbd3bcec99c1783c5ab65003e8bc53e64c867fe...ca3bd9ffb76da99d318d6d4182e72fa9bed36c41,1,1,1,2,1,2009-07-15 14:14:04,2009-07-15 14:14:04
ca3bd9ffb76da99d318d6d4182e72fa9bed36c41...500202337e8f07766f6e614e94dcc39590497f4f,1,22,21,43,8,2009-07-15 14:17:29,2009-07-15 14:17:29
500202337e8f07766f6e614e94dcc39590497f4f...c7289a040283a78c0c70edfd45c751aede0872ea,1,4,4,8,2,2009-07-15 14:21:19,2009-07-15 14:21:19
c7289a040283a78c0c70edfd45c751aede0872ea...1c908784e6a1b8b9a0d690b09728ed9211e5a04f,1,1,1,2,1,2009-07-15 14:24:49,2009-07-15 14:24:49
1c908784e6a1b8b9a0d690b09728ed9211e5a04f...940b8a17d44986420b4908c640b271090db98f9d,0,0,0,0,0,2009-07-15 14:28:08,2009-07-15 14:28:08
940b8a17d44986420b4908c640b271090db98f9d...ab3b5b2380120752f9892c9d0d9dea3ad945c62a,1,7,1,8,1,2009-07-16 23:49:27,2009-07-16 23:49:27
ab3b5b2380120752f9892c9d0d9dea3ad945c62a...0056d79c4ebf8633e5980c38076bcdbe521a5fb6,1,118,69,187,1,2009-07-16 23:54:04,2009-07-16 23:54:04
0056d79c4ebf8633e5980c38076bcdbe521a5fb6...393e06997d45c3c927fecc81e83d23fc386d185b,0,0,0,0,0,2009-07-17 00:08:24,2009-07-17 00:08:24
393e06997d45c3c927fecc81e83d23fc386d185b...29b53b2b1c612107bb53c46782b3cbe5ac733910,1,16,6,22,12,2009-07-17 01:01:50,2009-07-17 01:01:50
29b53b2b1c612107bb53c46782b3cbe5ac733910...dff276b9c1ce79e5c5a727970ad2951f4530e293,1,2,1,3,2,2009-07-21 02:09:06,2009-07-21 02:09:06
dff276b9c1ce79e5c5a727970ad2951f4530e293...624194a33a586d8279dae9af306f49917aa70776,1,1,1,2,1,2009-07-21 02:14:36,2009-07-21 02:14:36
624194a33a586d8279dae9af306f49917aa70776...1679202ebb7cc787c93e6100c951a00ac74fd49c,4,43,16,59,19,2009-07-21 03:04:00,2009-07-21 03:04:00
1679202ebb7cc787c93e6100c951a00ac74fd49c...6c5ca9f480f113dfbfc1c3fb3c4c88c32fe5f004,2,14,10,24,3,2009-07-21 16:50:14,2009-07-21 16:50:14
6c5ca9f480f113dfbfc1c3fb3c4c88c32fe5f004...72e2713d1a3563d147a1034e344335c1f7eac5ae,1,14,4,18,1,2009-07-21 16:51:26,2009-07-21 16:51:26
72e2713d1a3563d147a1034e344335c1f7eac5ae...77b269e875661d72ba7fc0926a5bb8d3d6d8b09d,2,17,3,20,4,2009-07-21 21:25:48,2009-07-21 21:25:48
77b269e875661d72ba7fc0926a5bb8d3d6d8b09d...e6d5d886bf25b292694c682a9ecf92ed646e75a6,2,93,59,152,56,2009-07-23 17:46:28,2009-07-23 17:46:28
e6d5d886bf25b292694c682a9ecf92ed646e75a6...10e90f9350bb5a99ee1ac1a642d37d3d7585056d,0,0,0,0,0,2009-07-24 14:11:09,2009-07-24 14:11:09
10e90f9350bb5a99ee1ac1a642d37d3d7585056d...128787d3b5b1d3e134ef42bb45fa8aeaf699ce19,1,3,4,7,2,2009-07-25 05:17:38,2009-07-25 05:17:38
128787d3b5b1d3e134ef42bb45fa8aeaf699ce19...59f0efa54b7905ba88f3c672689c9a92b8b16aad,0,0,0,0,0,2009-07-25 05:54:12,2009-07-25 05:54:12
59f0efa54b7905ba88f3c672689c9a92b8b16aad...cc5590b236e39b79f2ceb3b958add556e9beaad9,1,175,111,286,99,2009-07-26 16:58:17,2009-07-26 16:58:17
cc5590b236e39b79f2ceb3b958add556e9beaad9...67d47daf0563e0f49374ce54448327dc2b8dd4e7,4,42,39,81,40,2009-07-26 17:25:23,2009-07-26 17:25:23
67d47daf0563e0f49374ce54448327dc2b8dd4e7...f053d450e0034b9b231e7506544cb0c2dfb9c1a0,1,1,1,2,1,2009-07-27 02:06:06,2009-07-27 02:06:06
f053d450e0034b9b231e7506544cb0c2dfb9c1a0...ca530f27c974894d958540b1655358e2d28b7d4a,2,10,10,20,9,2009-07-27 09:12:14,2009-07-27 09:12:14
ca530f27c974894d958540b1655358e2d28b7d4a...892ef07ac70870ab6570071b937c44e6f9eaa836,1,2,2,4,1,2009-07-28 14:41:45,2009-07-28 14:41:45
892ef07ac70870ab6570071b937c44e6f9eaa836...e94ef54279227bcbc994e22c0c1b2e8a83309d45,0,0,0,0,0,2009-07-28 15:11:55,2009-07-28 15:11:55
e94ef54279227bcbc994e22c0c1b2e8a83309d45...f9249e4bd09752d5de735a44e9f01856da808cb1,0,0,0,0,0,2009-07-29 00:27:00,2009-07-29 00:27:00
f9249e4bd09752d5de735a44e9f01856da808cb1...df7f917b7f51ba969faa49d000ffc79572c5dcb4,5,94,7,101,8,2009-07-29 02:55:26,2009-07-29 02:55:26
df7f917b7f51ba969faa49d000ffc79572c5dcb4...b8997d66be0420c78ecc0c73efeecc1e06cbfc97,1,1,2,3,2,2009-07-29 04:11:33,2009-07-29 04:11:33
b8997d66be0420c78ecc0c73efeecc1e06cbfc97...f602e2bad4a95acc8859e2c1d573a4ec57b08ac4,2,2,1,3,2,2009-07-29 04:15:59,2009-07-29 04:15:59
f602e2bad4a95acc8859e2c1d573a4ec57b08ac4...e6aefffbdcf47a00d19afc3f14e371a2ceba8bfe,1,1,1,2,1,2009-07-29 09:33:07,2009-07-29 09:33:07
e6aefffbdcf47a00d19afc3f14e371a2ceba8bfe...dbce0a1507cd2c037a7b7d2b37afa1163529ac57,1,0,1,1,1,2009-07-31 01:38:46,2009-07-31 01:38:46
dbce0a1507cd2c037a7b7d2b37afa1163529ac57...7af2b34a5caa185bd0bdc0ce54a1f03fb9e8cf3f,1,9,7,16,3,2009-08-03 08:40:53,2009-08-03 08:40:53
7af2b34a5caa185bd0bdc0ce54a1f03fb9e8cf3f...542904ee6d54de3576ab6e072ce6df223914d973,1,13,0,13,1,2009-08-03 21:18:39,2009-08-03 21:18:39
542904ee6d54de3576ab6e072ce6df223914d973...17b7a743a192b767dc261d51391945f3652be81b,0,0,0,0,0,2009-08-13 16:48:31,2009-08-13 16:48:31
17b7a743a192b767dc261d51391945f3652be81b...6922ebadbcf6fcdafa9792f6225bea7b1976a9c8,2,2,2,4,2,2009-08-13 16:55:34,2009-08-13 16:55:34
6922ebadbcf6fcdafa9792f6225bea7b1976a9c8...b72d6cf0f64b843cd56a4e28d3fc199db5be27d9,1,1,1,2,1,2009-08-13 17:01:31,2009-08-13 17:01:31
b72d6cf0f64b843cd56a4e28d3fc199db5be27d9...a7be652b41dd00f78b891422d1a873fb0bea648c,2,322,232,554,215,2009-08-14 14:24:23,2009-08-14 14:24:23
a7be652b41dd00f78b891422d1a873fb0bea648c...0f70fd99fd7fa056a98a07c24c55399be7e04ba1,2,2,2,4,2,2009-08-14 14:31:59,2009-08-14 14:31:59
0f70fd99fd7fa056a98a07c24c55399be7e04ba1...372736b70fbbad70bd66755c65f2919cdad2e8fd,5,23,7,30,9,2009-08-21 21:43:09,2009-08-21 21:43:09
372736b70fbbad70bd66755c65f2919cdad2e8fd...2099aba1bd72f9702962ded52026b4400dc4645e,1,15,0,15,2,2009-08-29 12:44:44,2009-08-29 12:44:44
2099aba1bd72f9702962ded52026b4400dc4645e...594a28a9044120bed58671dde8a805c9e0f6c79a,2,35,2,37,4,2009-10-09 20:59:25,2009-10-09 20:59:25
594a28a9044120bed58671dde8a805c9e0f6c79a...c03090716af013147660f98152cdb21b0851f429,1,1,1,2,1,2009-10-09 21:06:47,2009-10-09 21:06:47
c03090716af013147660f98152cdb21b0851f429...b8332547b9f4cd5031286209ad0b28eaf1f9b78b,1,1,0,1,1,2009-10-09 21:07:57,2009-10-09 21:07:57
b8332547b9f4cd5031286209ad0b28eaf1f9b78b...36b3916e3fad58fa7911c08216741d94033f0790,1,1,1,2,1,2009-10-09 21:29:17,2009-10-09 21:29:17
36b3916e3fad58fa7911c08216741d94033f0790...56b80c70b692ab936e5c41764a2c24adc438be46,2,1,2,3,2,2009-10-09 22:18:16,2009-10-09 22:18:16
56b80c70b692ab936e5c41764a2c24adc438be46...504cdb085cb1446d56fde357bdd473f2869e8932,2,117,81,198,77,2009-12-16 19:22:52,2009-12-16 19:22:52
504cdb085cb1446d56fde357bdd473f2869e8932...01e5b21e3a1a78f95f275cff1475950ec31437f6,2,81,117,198,77,2009-12-22 08:27:45,2009-12-22 08:27:45
01e5b21e3a1a78f95f275cff1475950ec31437f6...18754633ef9863cadac7063e82f3239575948659,4,12,17,29,11,2009-12-26 16:36:22,2009-12-26 16:36:22
18754633ef9863cadac7063e82f3239575948659...2ad77f73b7485f8d801b231f1453515d0ab6804b,4,17,12,29,11,2009-12-27 04:10:19,2009-12-27 04:10:19
7638651cc32c31f6c7032041af5f5e575e23f256...d89ba464dde14abc3aaf6d1e02202721f5fd2b3f,8,621,152,773,27,2009-05-28 05:46:09,2009-05-28 05:46:09
d89ba464dde14abc3aaf6d1e02202721f5fd2b3f...44bf371b25f367bea9a10f9a324aa35f544f0254,2,499,275,774,252,2009-05-28 16:03:28,2009-05-28 16:03:28
44bf371b25f367bea9a10f9a324aa35f544f0254...c78554b2164b9b09fa30f93371fa6d89cf6b5e89,1,17,0,17,1,2009-05-29 04:06:09,2009-05-29 04:06:09
c78554b2164b9b09fa30f93371fa6d89cf6b5e89...bd58a3972b288aa335b87932ed3db72840215f6d,2,32,32,64,28,2009-05-29 04:35:10,2009-05-29 04:35:10
bd58a3972b288aa335b87932ed3db72840215f6d...419747d1c8363f06a143429ffe58e67f2f217b5e,3,8,8,16,6,2009-05-29 05:23:50,2009-05-29 05:23:50
419747d1c8363f06a143429ffe58e67f2f217b5e...1ed5d8fc39aa634cacb740c916d1cef682063dbb,2,11,3,14,3,2009-05-30 16:10:23,2009-05-30 16:10:23
1ed5d8fc39aa634cacb740c916d1cef682063dbb...be907bcdcbea7d95b5adefdcc9fd6c4d8cbfafe0,3,42,6,48,7,2009-06-03 04:49:16,2009-06-03 04:49:16
be907bcdcbea7d95b5adefdcc9fd6c4d8cbfafe0...2416e5fefe0e853cbfee17ae4dcb62b7055ed2d8,4,78,2,80,8,2009-06-03 13:23:19,2009-06-03 13:23:19
2416e5fefe0e853cbfee17ae4dcb62b7055ed2d8...5b40ee32e6634f686c821ffa0dd5357c8dd85302,0,0,0,0,0,2009-06-03 13:32:26,2009-06-03 13:32:26
5b40ee32e6634f686c821ffa0dd5357c8dd85302...512ee0f52889eb7f624f309cdc61fab57ab73a7b,3,118,4,122,7,2009-06-06 06:14:05,2009-06-06 06:14:05
512ee0f52889eb7f624f309cdc61fab57ab73a7b...fa43a32bcbfd7b2e7092c664251406416ef280fd,1,21,1,22,2,2009-06-06 12:16:06,2009-06-06 12:16:06
fa43a32bcbfd7b2e7092c664251406416ef280fd...151d88af4e972547c40f1e70a3cd982f202f5c86,3,45,1,46,5,2009-06-06 13:35:33,2009-06-06 13:35:33
151d88af4e972547c40f1e70a3cd982f202f5c86...708bc80ba63a5512fab3aea59e4e65c4eb380786,1,1,1,2,1,2009-06-06 13:43:44,2009-06-06 13:43:44
708bc80ba63a5512fab3aea59e4e65c4eb380786...89df572c476c3817eaf33dd9eec3aa9ad4732dcf,1,3,0,3,3,2009-06-07 18:07:53,2009-06-07 18:07:53
89df572c476c3817eaf33dd9eec3aa9ad4732dcf...6cd37e0a1ffff06517a62c1cb0009825c551e31c,3,88,7,95,6,2009-06-08 04:50:24,2009-06-08 04:50:24
6cd37e0a1ffff06517a62c1cb0009825c551e31c...81aedbd157209518a2a25ac528f29893900c1ae5,2,46,12,58,10,2009-06-08 13:04:22,2009-06-08 13:04:22
81aedbd157209518a2a25ac528f29893900c1ae5...031385e4cc3be747319458eab5ba80270a5285f9,3,26,1,27,4,2009-06-08 13:35:39,2009-06-08 13:35:39
031385e4cc3be747319458eab5ba80270a5285f9...64be8f29d5a9892047ac40d9306015ac402b1a39,1,7,4,11,4,2009-06-09 12:59:41,2009-06-09 12:59:41
64be8f29d5a9892047ac40d9306015ac402b1a39...d3bd3203f9d202ed781d204f283459df87139bc5,2,10,1,11,3,2009-06-09 13:14:40,2009-06-09 13:14:40
d3bd3203f9d202ed781d204f283459df87139bc5...74131e82eb1a1bdad1789889c38c8d96b6ab25aa,1,2,2,4,1,2009-06-10 12:44:53,2009-06-10 12:44:53
74131e82eb1a1bdad1789889c38c8d96b6ab25aa...6c36d4c4f8379433cdce150a64dad6a1f16097cd,1,20,10,30,6,2009-06-10 12:45:29,2009-06-10 12:45:29
6c36d4c4f8379433cdce150a64dad6a1f16097cd...6ad26e6acc34134752d8728bf6dc6e592883bbfa,1,13,10,23,4,2009-06-10 12:46:04,2009-06-10 12:46:04
6ad26e6acc34134752d8728bf6dc6e592883bbfa...8765615b9b365ed2ee822c1757cc00a9a2813b16,1,10,10,20,5,2009-06-10 12:46:43,2009-06-10 12:46:43
8765615b9b365ed2ee822c1757cc00a9a2813b16...4cb4086b2a16d6992fbffd2e8f15ae11b17412a7,2,55,39,94,23,2009-06-11 02:45:46,2009-06-11 02:45:46
4cb4086b2a16d6992fbffd2e8f15ae11b17412a7...a5e7d975940feda2c2d03201a1097d726448ec88,1,1,1,2,1,2009-06-11 18:59:48,2009-06-11 18:59:48
a5e7d975940feda2c2d03201a1097d726448ec88...9294121d3c4b169406f51d99a915060b175a9bfe,2,109,24,133,12,2009-06-12 13:56:40,2009-06-12 13:56:40
9294121d3c4b169406f51d99a915060b175a9bfe...694a15ef72afbd5994ca83b20c59aa7ec3d24d3d,1,1,1,2,1,2009-06-12 17:16:49,2009-06-12 17:16:49
694a15ef72afbd5994ca83b20c59aa7ec3d24d3d...c98a46c2be042620f28719824fc5d9dfffbef652,1,5,2,7,1,2009-06-14 23:03:01,2009-06-14 23:03:01
c98a46c2be042620f28719824fc5d9dfffbef652...b38cf5db5cf843bf6d7c10c93ed707688d67f8aa,3,29,12,41,4,2009-06-15 11:47:01,2009-06-15 11:47:01
b38cf5db5cf843bf6d7c10c93ed707688d67f8aa...191203b48d2cd593b9adcf99ba2c91db64c40cd1,2,48,3,51,6,2009-06-15 14:30:51,2009-06-15 14:30:51
191203b48d2cd593b9adcf99ba2c91db64c40cd1...f908eded21919cfbbbd1009c63f1cffa316ea2b2,1,3,0,3,1,2009-06-17 13:01:40,2009-06-17 13:01:40
f908eded21919cfbbbd1009c63f1cffa316ea2b2...1a7238c7309937a162d4f339a0821ec0f188ac19,1,14,11,25,12,2009-06-17 13:46:52,2009-06-17 13:46:52
1a7238c7309937a162d4f339a0821ec0f188ac19...992ded1ad1a46b5605769735d28aad22d4cb04d5,2,46,2,48,4,2009-06-17 13:47:39,2009-06-17 13:47:39
992ded1ad1a46b5605769735d28aad22d4cb04d5...6c81952b379712a5bbd4e4d73ec88a07d875b68e,4,19,69,88,10,2009-06-17 14:09:56,2009-06-17 14:09:56
6c81952b379712a5bbd4e4d73ec88a07d875b68e...ec1baddbb789f21ecaa9139765b52365d21a5d6b,1,503,0,503,1,2009-06-17 14:16:27,2009-06-17 14:16:27
ec1baddbb789f21ecaa9139765b52365d21a5d6b...80c0ee0be7755d6cdb45c0fb1541757a50851bd4,1,1,1,2,1,2009-06-17 19:59:50,2009-06-17 19:59:50
80c0ee0be7755d6cdb45c0fb1541757a50851bd4...c9d882c4b6087f2831bb3bc62b473f57904663bf,2,80,78,158,28,2009-06-17 23:57:27,2009-06-17 23:57:27
c9d882c4b6087f2831bb3bc62b473f57904663bf...15a908b4d1c890a480e2a50b0f23ad6fd259ce29,2,2,0,2,2,2009-06-18 00:16:48,2009-06-18 00:16:48
15a908b4d1c890a480e2a50b0f23ad6fd259ce29...79d2cf3c121667808bdb1514adbb98317a25ebc4,1,1,1,2,1,2009-06-18 12:41:16,2009-06-18 12:41:16
79d2cf3c121667808bdb1514adbb98317a25ebc4...bc362cc6b81386d36f078a741e38f00b67fd4f8d,1,1,0,1,1,2009-06-18 13:30:52,2009-06-18 13:30:52
bc362cc6b81386d36f078a741e38f00b67fd4f8d...457a1f9a031543e3d5d1cfb3944712fe71ebba2f,6,36,33,69,26,2009-06-18 13:32:12,2009-06-18 13:32:12
457a1f9a031543e3d5d1cfb3944712fe71ebba2f...3db96017bac70bd53697f5fe5e37362707f7490d,1,8,2,10,3,2009-06-18 13:32:48,2009-06-18 13:32:48
3db96017bac70bd53697f5fe5e37362707f7490d...7c18404a2499db964343a0b4a6e57b17c2c2b619,1,8,8,16,8,2009-06-18 13:33:18,2009-06-18 13:33:18
7c18404a2499db964343a0b4a6e57b17c2c2b619...4086167ba6376a974854c698b38627c4df822904,1,1,1,2,1,2009-06-18 13:33:52,2009-06-18 13:33:52
4086167ba6376a974854c698b38627c4df822904...d71097111ae1a5f54c8413be4b9af0c97b8904ef,1,9,6,15,2,2009-06-18 13:34:27,2009-06-18 13:34:27
d71097111ae1a5f54c8413be4b9af0c97b8904ef...97fb6cf2b3c1546d1aa08a90a38d146d2b0046ef,1,1,1,2,1,2009-06-18 13:35:06,2009-06-18 13:35:06
97fb6cf2b3c1546d1aa08a90a38d146d2b0046ef...b9d17578406553d9ac8574f90b6444f1897c7b56,1,1,1,2,1,2009-06-18 13:35:36,2009-06-18 13:35:36
b9d17578406553d9ac8574f90b6444f1897c7b56...3894ba853ddf84a5f075ad75de4d0da79b29bafa,1,6,6,12,5,2009-06-18 13:36:11,2009-06-18 13:36:11
3894ba853ddf84a5f075ad75de4d0da79b29bafa...ee8cc099c08ab4a2376758dbcf20a44e775889d8,1,4,1,5,1,2009-06-18 13:36:40,2009-06-18 13:36:40
ee8cc099c08ab4a2376758dbcf20a44e775889d8...755762e5b9990f7cba74c2af99333637ac5efa29,1,5,1,6,1,2009-06-18 13:37:10,2009-06-18 13:37:10
755762e5b9990f7cba74c2af99333637ac5efa29...b836ed46665c99228f2f4109139296f8e48551d0,1,2,4,6,2,2009-06-18 13:44:26,2009-06-18 13:44:26
b836ed46665c99228f2f4109139296f8e48551d0...8950a40ceccbdccd5ba5c3f788e5a3a3b7d0638f,1,2,2,4,2,2009-06-18 15:03:17,2009-06-18 15:03:17
8950a40ceccbdccd5ba5c3f788e5a3a3b7d0638f...cbbe60c7fc39fa8ff75554bd90104eaad6924bb1,2,6,1,7,3,2009-06-18 15:04:00,2009-06-18 15:04:00
cbbe60c7fc39fa8ff75554bd90104eaad6924bb1...b69dc5206cce20926d989c21a290c8eef13bee35,1,4,3,7,2,2009-06-19 01:36:56,2009-06-19 01:36:56
b69dc5206cce20926d989c21a290c8eef13bee35...18b29c523bdd78531810e98c02f9f2a9c3508f7b,2,58,12,70,9,2009-06-24 14:00:53,2009-06-24 14:00:53
18b29c523bdd78531810e98c02f9f2a9c3508f7b...bbd7b64e7606534716be15d31a23f2b081f018ff,1,1,1,2,1,2009-06-24 14:01:36,2009-06-24 14:01:36
bbd7b64e7606534716be15d31a23f2b081f018ff...4acf7f43e79d1781462b4035b871446dd8c58cf4,1,105,3,108,5,2009-06-24 14:02:22,2009-06-24 14:02:22
4acf7f43e79d1781462b4035b871446dd8c58cf4...78eb620c639b5bd2d91d8e02ecb61c8eb9d9a80a,1,1,1,2,1,2009-06-24 14:03:10,2009-06-24 14:03:10
78eb620c639b5bd2d91d8e02ecb61c8eb9d9a80a...970be97530e5eef5c872462e065be630c183847d,2,19,7,26,4,2009-06-24 14:04:18,2009-06-24 14:04:18
970be97530e5eef5c872462e065be630c183847d...fe2747d1e01cc07ed08dd3193693aa6206120afd,1,11,7,18,4,2009-06-24 23:33:17,2009-06-24 23:33:17
fe2747d1e01cc07ed08dd3193693aa6206120afd...e522e61a80aa9faae3fc0bcd69fd99d6b4951326,3,8,2,10,4,2009-06-29 12:29:48,2009-06-29 12:29:48
e522e61a80aa9faae3fc0bcd69fd99d6b4951326...735309341e24d53d5af41799a31aa964f424190c,2,18,1,19,4,2009-06-29 14:02:17,2009-06-29 14:02:17
735309341e24d53d5af41799a31aa964f424190c...fdcc0c774a9295f5d0fa3a1edd34e4f7e41476d5,3,9,2,11,3,2009-06-29 16:31:21,2009-06-29 16:31:21
fdcc0c774a9295f5d0fa3a1edd34e4f7e41476d5...cb9cf01ff292cc6e6b8489258d1c59a6e8631d52,5,14,15,29,8,2009-06-29 17:17:45,2009-06-29 17:17:45
cb9cf01ff292cc6e6b8489258d1c59a6e8631d52...422adffa11b57475d871ad2d1e33b04974d68f06,1,1,1,2,1,2009-06-29 17:49:01,2009-06-29 17:49:01
422adffa11b57475d871ad2d1e33b04974d68f06...923c6755c88f19ad7fc0cd74cf818037f85dfb43,1,17,1,18,2,2009-06-30 18:40:29,2009-06-30 18:40:29
7638651cc32c31f6c7032041af5f5e575e23f256...3860c69bad92e4a514b1d10426445a00f3e9239a,0,0,0,0,0,2009-05-27 18:48:49,2009-05-27 18:48:49
3860c69bad92e4a514b1d10426445a00f3e9239a...f973c57aaac3e918ac0234acbbbc86834ccfca86,28,1493,485,1978,346,2009-06-07 00:30:56,2009-06-07 00:30:56
f973c57aaac3e918ac0234acbbbc86834ccfca86...a25d53191c2ad869ba688da77d04c78a6c7b4640,14,174,41,215,18,2009-06-08 13:46:06,2009-06-08 13:46:06
a25d53191c2ad869ba688da77d04c78a6c7b4640...87cd3dfa55770e5a987d43797c013d81530083db,4,72,20,92,17,2009-07-01 23:10:57,2009-07-01 23:10:57
87cd3dfa55770e5a987d43797c013d81530083db...f5095f8cb367e51e18e084ac118d6900ab9ba735,68,1473,399,1872,251,2009-07-01 23:33:02,2009-07-01 23:33:02
f5095f8cb367e51e18e084ac118d6900ab9ba735...159765c5ee5d77edd44bf2efb17671b87ecbf38e,3,38,3,41,5,2009-07-03 00:59:39,2009-07-03 00:59:39
159765c5ee5d77edd44bf2efb17671b87ecbf38e...5b616f27c67f087b9f93f10804b175dee4c46839,7,39,77,116,26,2009-07-06 12:53:30,2009-07-06 12:53:30
5b616f27c67f087b9f93f10804b175dee4c46839...07ed7fea103ee7f507fb2e49cdd6d983fe54c7b0,8,203,45,248,44,2009-07-08 00:52:25,2009-07-08 00:52:25
07ed7fea103ee7f507fb2e49cdd6d983fe54c7b0...637aa76d072682a94c1a02965d2f92dad20bb46a,3,37,17,54,16,2009-07-09 09:22:14,2009-07-09 09:22:14
637aa76d072682a94c1a02965d2f92dad20bb46a...89ba6cde4877a54c1a6013386d107278b2a6c1de,2,45,31,76,9,2009-07-09 10:57:18,2009-07-09 10:57:18
89ba6cde4877a54c1a6013386d107278b2a6c1de...0f205b9987d6ac18105d5db05a280a16fb194371,5,68,25,93,19,2009-07-12 13:53:37,2009-07-12 13:53:37
0f205b9987d6ac18105d5db05a280a16fb194371...c52ae07453a5556ba255aa115f2a4e8f56c7fd73,5,110,32,142,23,2009-07-13 15:19:05,2009-07-13 15:19:05
c52ae07453a5556ba255aa115f2a4e8f56c7fd73...9dfe9f072bfac9f7716ff3a4eebe6171bc75b305,101,936,21,957,57,2009-08-02 23:51:07,2009-08-02 23:51:07
9dfe9f072bfac9f7716ff3a4eebe6171bc75b305...e8fc1398bf244656f966354c951d9fee6ebb8c19,1,56,12,68,14,2009-08-04 14:24:15,2009-08-04 14:24:15
e8fc1398bf244656f966354c951d9fee6ebb8c19...d05ad1420afb5c284c1d1e1669d40af69eeb4538,3,18,15,33,9,2009-08-04 14:28:03,2009-08-04 14:28:03
d05ad1420afb5c284c1d1e1669d40af69eeb4538...986bcffed2c2ab85a1cd3ebe520b7d725d921846,144,22245,10481,32726,6016,2009-08-04 14:56:04,2009-08-04 14:56:04
986bcffed2c2ab85a1cd3ebe520b7d725d921846...5816a076efb16899cdeecb13846d4f97030994ef,1,101,0,101,5,2009-08-04 16:42:26,2009-08-04 16:42:26
5816a076efb16899cdeecb13846d4f97030994ef...819ae8a2cfdcf9ce5e33c6abb76013f3448f9df8,54,215,21,236,55,2009-08-04 17:06:51,2009-08-04 17:06:51
819ae8a2cfdcf9ce5e33c6abb76013f3448f9df8...58d05494ec4ee457837f857c8929842f33097315,1,29,3,32,4,2009-08-04 17:34:49,2009-08-04 17:34:49
58d05494ec4ee457837f857c8929842f33097315...ae59f1abc9b45e2a6becabd706243efa592bc204,1,5,0,5,1,2009-08-05 11:15:01,2009-08-05 11:15:01
ae59f1abc9b45e2a6becabd706243efa592bc204...b1a54ac423fb21b425787fc27e57d123fde2c978,6,0,0,0,0,2009-08-05 14:16:28,2009-08-05 14:16:28
b1a54ac423fb21b425787fc27e57d123fde2c978...b6d352c816c214daca8af801e170ba7d37aa79ea,2,65,28,93,2,2009-08-05 14:25:13,2009-08-05 14:25:13
b6d352c816c214daca8af801e170ba7d37aa79ea...b6ceeb15958958587df8ee600c026b2251e9c4e0,2,34,31,65,7,2009-08-07 23:52:23,2009-08-07 23:52:23
b6ceeb15958958587df8ee600c026b2251e9c4e0...ac70e26bafb47f8a69aa805273724fba29ccc26f,57,209,56,265,102,2009-08-08 15:29:30,2009-08-08 15:29:30
ac70e26bafb47f8a69aa805273724fba29ccc26f...ad9f56aad62d4f5e623fa5f553e84971832a39ee,2,17,2,19,4,2009-08-10 15:23:32,2009-08-10 15:23:32
ad9f56aad62d4f5e623fa5f553e84971832a39ee...a7beb20bf02b93b3beb6d694d888c904be9bc9ea,7,65,39,104,25,2009-08-14 14:10:14,2009-08-14 14:10:14
a7beb20bf02b93b3beb6d694d888c904be9bc9ea...1d5aad87f4cd4ccffd24fffe25d6fa6be0bfbdf4,5,152,50,202,11,2009-08-16 19:57:19,2009-08-16 19:57:19
1d5aad87f4cd4ccffd24fffe25d6fa6be0bfbdf4...18e151bc3f8a85f2766d64262902a9fcad44d937,7,9,9,18,9,2009-08-16 21:45:09,2009-08-16 21:45:09
7638651cc32c31f6c7032041af5f5e575e23f256...627588833210076683d6b704358440d50471eef2,0,0,0,0,0,2009-05-27 18:48:05,2009-05-27 18:48:05
627588833210076683d6b704358440d50471eef2...82b25800cdb8be78e8cfc95cca41e01a418ecc9c,24,1308,478,1786,331,2009-06-05 20:58:34,2009-06-05 20:58:34
82b25800cdb8be78e8cfc95cca41e01a418ecc9c...d3e2863e89586fc63e6f1050ac53c8336eb230de,1,19,0,19,1,2009-06-07 07:01:22,2009-06-07 07:01:22
d3e2863e89586fc63e6f1050ac53c8336eb230de...62523016ccdcc6820a3d72471c867e62ddb3c85a,3,35,5,40,6,2009-06-07 07:05:27,2009-06-07 07:05:27
62523016ccdcc6820a3d72471c867e62ddb3c85a...e9b2fc1f29a08ebf38125c664d96842202ff920a,2,9,3,12,4,2009-06-07 10:02:33,2009-06-07 10:02:33
e9b2fc1f29a08ebf38125c664d96842202ff920a...aac3f307f1d809783cc8f164b1221fd07930cf57,5,119,1,120,5,2009-06-09 03:44:46,2009-06-09 03:44:46
aac3f307f1d809783cc8f164b1221fd07930cf57...f2e8cb719b2c067a7d0e57ce69dd9de11a019c8f,2,68,29,97,13,2009-06-09 04:57:26,2009-06-09 04:57:26
f2e8cb719b2c067a7d0e57ce69dd9de11a019c8f...59e26c75f7008dce75a1b027ba569535a8ab3c4a,1,39,15,54,8,2009-06-15 04:32:22,2009-06-15 04:32:22
59e26c75f7008dce75a1b027ba569535a8ab3c4a...fcf957d59907e844f4bf336d50a7fe79fe8f6e66,25,579,129,708,93,2009-06-15 04:34:41,2009-06-15 04:34:41
fcf957d59907e844f4bf336d50a7fe79fe8f6e66...f5bb5b5f981ef839bd0fe95c7d63485a7fa04d81,7,460,10,470,16,2009-07-01 04:00:34,2009-07-01 04:00:34
f5bb5b5f981ef839bd0fe95c7d63485a7fa04d81...d2d63014552ee05c49384976d19696372dccd764,5,55,45,100,16,2009-07-02 07:19:44,2009-07-02 07:19:44
d2d63014552ee05c49384976d19696372dccd764...2ae6ac5a6c233e7bb002db48524e5bf1df52e52b,3,91,50,141,14,2009-07-02 08:10:57,2009-07-02 08:10:57
2ae6ac5a6c233e7bb002db48524e5bf1df52e52b...e0e60ef50175f29aa165e46dd41b2f0957784970,51,1097,295,1392,172,2009-07-02 08:26:30,2009-07-02 08:26:30
e0e60ef50175f29aa165e46dd41b2f0957784970...da943bf6a86e6ec53ad7ad382b71af84285ff15b,7,354,22,376,21,2009-07-05 07:07:49,2009-07-05 07:07:49
da943bf6a86e6ec53ad7ad382b71af84285ff15b...6d84761b0c386faed3be3a380c8ee5218df6ac57,1,76,6,82,8,2009-07-05 10:49:53,2009-07-05 10:49:53
6d84761b0c386faed3be3a380c8ee5218df6ac57...242e8177bf24f051cce69f43ba8fe65e586df7cd,1,1,1,2,1,2009-07-06 03:49:45,2009-07-06 03:49:45
242e8177bf24f051cce69f43ba8fe65e586df7cd...98fc6a1b689a684ce7fb4452ca7575758d8eb38a,18,550,17,567,34,2009-08-03 23:59:05,2009-08-03 23:59:05
98fc6a1b689a684ce7fb4452ca7575758d8eb38a...ba47aebc6d88f64249faec8bad6239ae2998db89,126,21697,10466,32163,5983,2009-08-05 04:16:35,2009-08-05 04:16:35
ba47aebc6d88f64249faec8bad6239ae2998db89...00c983cfc9d55f05099326365c59ce7c91828307,9,1124,1,1125,12,2009-08-06 03:40:01,2009-08-06 03:40:01
00c983cfc9d55f05099326365c59ce7c91828307...81e8b8bbd5aecce5056e9eac22600078709a2bee,1,1,1,2,1,2009-08-06 04:27:14,2009-08-06 04:27:14
81e8b8bbd5aecce5056e9eac22600078709a2bee...f1c47d24b10b852f7c4590bfa19bbb8d1e4cc2ca,1,3,1,4,2,2009-08-07 21:26:27,2009-08-07 21:26:27
f1c47d24b10b852f7c4590bfa19bbb8d1e4cc2ca...2919305e1f3f528527f93b31f0e686a842e1c5d9,1,1,1,2,1,2009-08-09 01:18:42,2009-08-09 01:18:42
2919305e1f3f528527f93b31f0e686a842e1c5d9...c4dd344a9b4678640d71b54fec6531d209f222f4,3,114,0,114,3,2009-08-10 01:48:15,2009-08-10 01:48:15
c4dd344a9b4678640d71b54fec6531d209f222f4...ed30463b6c1a3506e6bc02c1fa01f003760a3857,1,8,3,11,2,2009-08-10 03:44:24,2009-08-10 03:44:24
ed30463b6c1a3506e6bc02c1fa01f003760a3857...687a5af25a6dd9223b6b1ac6804460e123fd6312,2,28,8,36,5,2009-08-15 13:55:32,2009-08-15 13:55:32
687a5af25a6dd9223b6b1ac6804460e123fd6312...3a99684fe2bca8a3745943aee5bd480874dc51ce,1,12,1,13,4,2009-08-16 05:55:58,2009-08-16 05:55:58
3a99684fe2bca8a3745943aee5bd480874dc51ce...379fecb829b77c29b80786d58309f17746cf3ce9,6,54,113,167,16,2009-08-17 01:08:50,2009-08-17 01:08:50
379fecb829b77c29b80786d58309f17746cf3ce9...2ea3b4e058e13aaa17f813872ac1dba0892a3c40,7,817,73,890,30,2009-12-05 00:54:45,2009-12-05 00:54:45
2ea3b4e058e13aaa17f813872ac1dba0892a3c40...60a77788be13f00684e7643c9d206d88d82d48e2,2,5,4,9,4,2009-12-05 18:13:01,2009-12-05 18:13:01
60a77788be13f00684e7643c9d206d88d82d48e2...9831258985cfee682a4f77c7bf7fc390ae35712b,1,4,6,10,3,2009-12-05 19:05:04,2009-12-05 19:05:04
9831258985cfee682a4f77c7bf7fc390ae35712b...911b0b4348d5ade5cbbe73ad3a06b67ca519b2d8,2,27,25,52,12,2009-12-21 04:46:58,2009-12-21 04:46:58
911b0b4348d5ade5cbbe73ad3a06b67ca519b2d8...c1aeb0da21cfb65f9597ba25a2c53aeae7b71342,1,0,2,2,1,2009-12-21 04:50:45,2009-12-21 04:50:45
c1aeb0da21cfb65f9597ba25a2c53aeae7b71342...7b2cdd0209df301285570b7678830c060d29c4d8,1,1,1,2,1,2009-12-22 01:28:58,2009-12-22 01:28:58
7b2cdd0209df301285570b7678830c060d29c4d8...a2015262406ba0a1f5b76d935fe80d494ca5c33d,1,2,2,4,2,2009-12-22 02:31:45,2009-12-22 02:31:45
7638651cc32c31f6c7032041af5f5e575e23f256...2b9cefcdda52f5826aac3757bbc8cd0656ac0beb,0,0,0,0,0,2009-05-27 18:47:21,2009-05-27 18:47:21
2b9cefcdda52f5826aac3757bbc8cd0656ac0beb...f36391ecf53cf179c73e88fa3bdf0990fba5f230,8,621,152,773,27,2009-06-13 03:27:25,2009-06-13 03:27:25
f36391ecf53cf179c73e88fa3bdf0990fba5f230...35f8a3cc50167a88c1bffb09604e90acffe4999b,2,499,275,774,252,2009-06-13 03:27:38,2009-06-13 03:27:38
35f8a3cc50167a88c1bffb09604e90acffe4999b...6713e1557d232a1a0291176c4249d188e8d485b9,1,17,0,17,1,2009-06-13 03:27:48,2009-06-13 03:27:48
6713e1557d232a1a0291176c4249d188e8d485b9...1acb38da062d4f1e3093dfaf7696cf40afc8f919,2,32,32,64,28,2009-06-13 03:28:00,2009-06-13 03:28:00
1acb38da062d4f1e3093dfaf7696cf40afc8f919...5fa44cc855e7d5933d52f9f9eb09826ad9690477,3,8,8,16,6,2009-06-13 03:28:14,2009-06-13 03:28:14
5fa44cc855e7d5933d52f9f9eb09826ad9690477...d8aa8ced20dfc0168f97f838fc9c9e68b6fd2517,2,11,3,14,3,2009-06-13 03:28:25,2009-06-13 03:28:25
d8aa8ced20dfc0168f97f838fc9c9e68b6fd2517...ae2dd58ab12a59dc6459f5ff685639f8268de4da,3,42,6,48,7,2009-06-13 03:28:41,2009-06-13 03:28:41
ae2dd58ab12a59dc6459f5ff685639f8268de4da...cb847aa2249d10b14ec53e419f4610e4e7d08811,4,78,2,80,8,2009-06-13 03:28:54,2009-06-13 03:28:54
cb847aa2249d10b14ec53e419f4610e4e7d08811...45e50c00d98ccc015ab7d85377a1272bb159edcb,3,118,4,122,7,2009-06-13 03:29:07,2009-06-13 03:29:07
45e50c00d98ccc015ab7d85377a1272bb159edcb...87c1b6cc23eb15567e1b03aaec30c5a6f4181239,1,21,1,22,2,2009-06-13 03:29:17,2009-06-13 03:29:17
87c1b6cc23eb15567e1b03aaec30c5a6f4181239...c85c2687206759088d0fa97f41becf4bfadafdb2,3,45,1,46,5,2009-06-13 03:29:32,2009-06-13 03:29:32
c85c2687206759088d0fa97f41becf4bfadafdb2...8b5580286e822f97cd6fa63d463654adc0c44d2f,1,1,1,2,1,2009-06-13 03:29:43,2009-06-13 03:29:43
8b5580286e822f97cd6fa63d463654adc0c44d2f...17fb7b7d5a59652fedea3f30e38a597404c1c867,1,3,0,3,3,2009-06-13 03:29:52,2009-06-13 03:29:52
17fb7b7d5a59652fedea3f30e38a597404c1c867...6ff1f9c3ff41bf186ecc7c92bd84d3e5dbb4e9dc,3,88,7,95,6,2009-06-13 03:30:05,2009-06-13 03:30:05
6ff1f9c3ff41bf186ecc7c92bd84d3e5dbb4e9dc...1015dad87d7f015f574ff0af70c3b6b1c0427651,2,46,12,58,10,2009-06-13 03:30:22,2009-06-13 03:30:22
1015dad87d7f015f574ff0af70c3b6b1c0427651...c81aa42bc70e55fd3f4d9164834b390e7b6c1747,3,26,1,27,4,2009-06-13 03:30:36,2009-06-13 03:30:36
c81aa42bc70e55fd3f4d9164834b390e7b6c1747...3d4f9ec1e608b681e1e6d2f67b550908b9744643,1,7,4,11,4,2009-06-13 03:30:47,2009-06-13 03:30:47
3d4f9ec1e608b681e1e6d2f67b550908b9744643...c43567617694e3aa456ed0165988bc2c5f880ad0,17,303,115,418,67,2009-06-16 16:27:55,2009-06-16 16:27:55
c43567617694e3aa456ed0165988bc2c5f880ad0...1896d531cb64873165195de46bb1dc5562887e5d,7,443,3,446,9,2009-06-16 16:42:46,2009-06-16 16:42:46
1896d531cb64873165195de46bb1dc5562887e5d...bab5ab348e50f563e418580df1ae98df1d5c381f,6,93,28,121,39,2009-06-17 20:42:15,2009-06-17 20:42:15
bab5ab348e50f563e418580df1ae98df1d5c381f...a86d5ddc77415a08d4a971f0abb18ef28f17cdb2,3,22,32,54,5,2009-06-18 05:01:23,2009-06-18 05:01:23
a86d5ddc77415a08d4a971f0abb18ef28f17cdb2...7acae8f4d8a8f191d46fbb16e8cb15f46644b2ca,1,1,0,1,1,2009-06-18 05:18:35,2009-06-18 05:18:35
7acae8f4d8a8f191d46fbb16e8cb15f46644b2ca...eac54911f5df8a31377fecd37b2bf34f0afef169,32,953,258,1211,140,2009-06-25 15:42:51,2009-06-25 15:42:51
eac54911f5df8a31377fecd37b2bf34f0afef169...b0680a2ba5eca445ed447cee4c785edd6b967773,2,6,5,11,4,2009-06-25 17:19:53,2009-06-25 17:19:53
b0680a2ba5eca445ed447cee4c785edd6b967773...4df7e8ed9fb77fabc05d9befcf98a6ec8558c42e,15,67,22,89,22,2009-07-01 02:04:35,2009-07-01 02:04:35
4df7e8ed9fb77fabc05d9befcf98a6ec8558c42e...2d29d6c4f83449fb4ff4d728720a15762c1653b5,12,116,12,128,10,2009-07-01 02:51:48,2009-07-01 02:51:48
2d29d6c4f83449fb4ff4d728720a15762c1653b5...33b217296e124b79563648d21545e700817a6a09,1,17,17,34,3,2009-07-02 00:28:01,2009-07-02 00:28:01
33b217296e124b79563648d21545e700817a6a09...4d46aed514339768b415fb5198f2d5f2ab69dfd9,14,363,66,429,60,2009-07-06 19:58:45,2009-07-06 19:58:45
4d46aed514339768b415fb5198f2d5f2ab69dfd9...8d979aecbeeac180a4e21922df68b9f41ba2fa50,5,116,100,216,49,2009-07-06 20:06:11,2009-07-06 20:06:11
8d979aecbeeac180a4e21922df68b9f41ba2fa50...e49fd1ff17865f541fd3346de26cf1158ab0d257,1,4,6,10,4,2009-07-09 19:53:12,2009-07-09 19:53:12
e49fd1ff17865f541fd3346de26cf1158ab0d257...9eab31193abb8fbc35ecc26b2b1a93bda7e31882,2,28,17,45,16,2009-07-09 19:53:18,2009-07-09 19:53:18
9eab31193abb8fbc35ecc26b2b1a93bda7e31882...ab67a69ec6d33b6e2bd948fbb8b68e90c804ebab,2,13,6,19,5,2009-07-10 19:02:34,2009-07-10 19:02:34
ab67a69ec6d33b6e2bd948fbb8b68e90c804ebab...c53880e2c1c040f3ef68b393c47d152a4f719579,2,7,7,14,6,2009-07-10 21:50:19,2009-07-10 21:50:19
c53880e2c1c040f3ef68b393c47d152a4f719579...bf66b536a2e5c1307b3e47d737012fd4829faf01,2,23,1,24,4,2009-07-11 02:00:34,2009-07-11 02:00:34
bf66b536a2e5c1307b3e47d737012fd4829faf01...a873df6f3765075b615e9e9c7f2b178ee90cdbcf,46,1667,747,2414,562,2009-07-17 11:33:35,2009-07-17 11:33:35
a873df6f3765075b615e9e9c7f2b178ee90cdbcf...3e5ab0b8ec6d3c7527115704eccac3938b71496e,1,12,13,25,1,2009-07-17 11:47:54,2009-07-17 11:47:54
3e5ab0b8ec6d3c7527115704eccac3938b71496e...88b1183425631002a5a8c25631b1b1fad7eb23c5,5,52,23,75,13,2009-07-17 11:48:08,2009-07-17 11:48:08
88b1183425631002a5a8c25631b1b1fad7eb23c5...aeaa921a6d3cbcf5564f5ff413518ba73c79ba10,1,4,3,7,3,2009-07-17 12:36:29,2009-07-17 12:36:29
aeaa921a6d3cbcf5564f5ff413518ba73c79ba10...b0e381929f463ca8bd22768cc2677dc21c5cb6a9,4,68,6,74,9,2009-07-17 20:00:13,2009-07-17 20:00:13
b0e381929f463ca8bd22768cc2677dc21c5cb6a9...94a94bee3b56b1a8c54065020a461dc645c4d238,5,28,22,50,8,2009-07-18 02:02:57,2009-07-18 02:02:57
94a94bee3b56b1a8c54065020a461dc645c4d238...c6322f0096d2b07091af82752130c075ce75df07,1,4,2,6,3,2009-07-21 20:46:49,2009-07-21 20:46:49
c6322f0096d2b07091af82752130c075ce75df07...9ac495af4451ece0424f8053bce1b141fe4d8d8f,6,26,12,38,10,2009-07-23 20:17:30,2009-07-23 20:17:30
9ac495af4451ece0424f8053bce1b141fe4d8d8f...b127e06ca8debe89e948fd2c05ecfb0bc0b56f06,1,1,1,2,2,2009-07-24 01:57:43,2009-07-24 01:57:43
b127e06ca8debe89e948fd2c05ecfb0bc0b56f06...4b3b9d0e46519705faaa2769ca0cd11419e4b312,65,18187,8266,26453,4488,2009-07-24 02:22:02,2009-07-24 02:22:02
4b3b9d0e46519705faaa2769ca0cd11419e4b312...be96986ce80db723d5211a1f00a61785010aa815,3,133,0,133,3,2009-07-24 17:52:57,2009-07-24 17:52:57
be96986ce80db723d5211a1f00a61785010aa815...76fdeaf7209c6ef9d0263a205a53891b1f2da8a0,2,9,6,15,4,2009-07-24 19:31:12,2009-07-24 19:31:12
76fdeaf7209c6ef9d0263a205a53891b1f2da8a0...019d20a465996f2461deac444169b99f8c20e16f,7,28,15,43,14,2009-07-24 22:18:40,2009-07-24 22:18:40
019d20a465996f2461deac444169b99f8c20e16f...edcc1c2e7e3adabe317495db9d90333df6166c8e,2,2,9,11,4,2009-07-31 01:19:12,2009-07-31 01:19:12
edcc1c2e7e3adabe317495db9d90333df6166c8e...1da736f0f9f3c2bff93fac15f87ced56df5df21e,2,18,4,22,7,2009-08-03 02:17:12,2009-08-03 02:17:12
1da736f0f9f3c2bff93fac15f87ced56df5df21e...d76879d1b3f443705afe4ee0b241903f36c2821b,34,1653,1477,3130,1002,2009-08-13 00:52:32,2009-08-13 00:52:32
d76879d1b3f443705afe4ee0b241903f36c2821b...c2d80a5acbfdbab14586d3970f88439fea7ccb04,1,13,10,23,5,2009-08-13 22:35:15,2009-08-13 22:35:15
c2d80a5acbfdbab14586d3970f88439fea7ccb04...b15984b179953e93c74f47d06761c9a5c22b0716,14,183,14,197,21,2009-08-13 22:35:28,2009-08-13 22:35:28
b15984b179953e93c74f47d06761c9a5c22b0716...bcec8b2c43bd3726fb764044a6e872168abef674,4,9,3,12,6,2009-08-13 22:57:16,2009-08-13 22:57:16
7638651cc32c31f6c7032041af5f5e575e23f256...6399b2937a2e902db1ed170fd6f022841c2b591c,0,0,0,0,0,2009-05-27 18:46:42,2009-05-27 18:46:42
6399b2937a2e902db1ed170fd6f022841c2b591c...39676e8f56312646b246a27d789397bebcd22731,32,2124,203,2327,66,2009-06-02 14:52:29,2009-06-02 14:52:29
39676e8f56312646b246a27d789397bebcd22731...295beee70b5144983f120f7376cfbf4504a771a5,2,5,5,10,3,2009-06-02 14:52:40,2009-06-02 14:52:40
295beee70b5144983f120f7376cfbf4504a771a5...f0489dffb93f82ca21251a67d85124df615f652d,10,567,318,885,290,2009-06-02 14:53:25,2009-06-02 14:53:25
f0489dffb93f82ca21251a67d85124df615f652d...f0920956122460aed64b9eb024d11385f7b20f6f,14,0,990,990,14,2009-06-02 14:57:53,2009-06-02 14:57:53
f0920956122460aed64b9eb024d11385f7b20f6f...125135430ec2a55908e10a645cf4223d512b6afc,1,50,4,54,7,2009-06-09 11:21:57,2009-06-09 11:21:57
125135430ec2a55908e10a645cf4223d512b6afc...40ad3e0c83eba715e2cd41d755c43594c4221270,1,1,1,2,1,2009-06-09 11:22:19,2009-06-09 11:22:19
40ad3e0c83eba715e2cd41d755c43594c4221270...6c082b5539812c87ee045a63c89ccb286e5bc04e,2,8,6,14,7,2009-06-09 11:22:43,2009-06-09 11:22:43
6c082b5539812c87ee045a63c89ccb286e5bc04e...1a40a4fef7904d66ef146bc3757721614ddb053e,3,22,18,40,10,2009-06-09 11:23:21,2009-06-09 11:23:21
1a40a4fef7904d66ef146bc3757721614ddb053e...07558693b3dbcf40d050db5e3e70fb2bd171bfca,2,10,3,13,9,2009-06-09 11:23:47,2009-06-09 11:23:47
07558693b3dbcf40d050db5e3e70fb2bd171bfca...d55fcc9488f44b58106856e9e9f9749089fb0890,15,348,44,392,46,2009-06-09 11:31:27,2009-06-09 11:31:27
d55fcc9488f44b58106856e9e9f9749089fb0890...45b9d983a325ccbabaedf06530608565c0c9e830,4,125,0,125,4,2009-06-09 15:52:32,2009-06-09 15:52:32
45b9d983a325ccbabaedf06530608565c0c9e830...86e7e1b82ad03eb8bb315549528da3e7416b4368,18,309,118,427,71,2009-06-16 06:08:13,2009-06-16 06:08:13
86e7e1b82ad03eb8bb315549528da3e7416b4368...9628ae6c921f6c9bc6ef8e784b35203993f7f3cd,11,264,0,264,9,2009-06-17 01:27:20,2009-06-17 01:27:20
9628ae6c921f6c9bc6ef8e784b35203993f7f3cd...2a2f711d386fdc24cf1d843432e5569fe23527bd,1,1,0,1,1,2009-06-17 01:27:25,2009-06-17 01:27:25
2a2f711d386fdc24cf1d843432e5569fe23527bd...9e685499ffd672551f74815720738722cf6eb669,1,76,5,81,2,2009-06-17 01:27:31,2009-06-17 01:27:31
9e685499ffd672551f74815720738722cf6eb669...2fd60f00163e59bcd87350598af3029f7af5b2a3,0,0,0,0,0,2009-06-17 09:28:49,2009-06-17 09:28:49
2fd60f00163e59bcd87350598af3029f7af5b2a3...e223716bd80ced8a2ca25ea4befc327f425c7203,8,612,99,711,22,2009-06-23 07:02:54,2009-06-23 07:02:54
e223716bd80ced8a2ca25ea4befc327f425c7203...7e0534bd344d6fe443ab246c9d57a8e3c950d876,1,1,0,1,1,2009-06-23 07:22:59,2009-06-23 07:22:59
7e0534bd344d6fe443ab246c9d57a8e3c950d876...a806b4a77a4740fd2d1d47558200c3f3bdb8d22b,1,1,1,2,1,2009-06-23 07:33:52,2009-06-23 07:33:52
a806b4a77a4740fd2d1d47558200c3f3bdb8d22b...b6b4a21cf59c78025d7825b483285eac2271ca1d,28,758,227,985,116,2009-06-23 07:42:31,2009-06-23 07:42:31
b6b4a21cf59c78025d7825b483285eac2271ca1d...fdedd33bd4f8fb4ac55418a89ce50e16dc5412e4,2,42,7,49,10,2009-06-23 12:55:05,2009-06-23 12:55:05
fdedd33bd4f8fb4ac55418a89ce50e16dc5412e4...2483e06bd3e9527ebc3055cbeaaa774b15b9dbbc,5,206,10,216,9,2009-06-23 19:16:31,2009-06-23 19:16:31
2483e06bd3e9527ebc3055cbeaaa774b15b9dbbc...bbcffeaabe35e3726a3f50ca4ebbd6abd96bcfbe,5,101,74,175,59,2009-06-26 09:50:32,2009-06-26 09:50:32
bbcffeaabe35e3726a3f50ca4ebbd6abd96bcfbe...2dd363fc0c608556edf852552434591a7d519bc7,5,92,75,167,27,2009-06-26 09:51:26,2009-06-26 09:51:26
2dd363fc0c608556edf852552434591a7d519bc7...a7c8169fda81f00434e6bc1a3a34f32e06054748,4,36,12,48,11,2009-06-26 09:52:22,2009-06-26 09:52:22
a7c8169fda81f00434e6bc1a3a34f32e06054748...217ba0d2397ea6f5a423dc0c02c0540a057925ca,7,195,31,226,24,2009-06-26 09:53:12,2009-06-26 09:53:12
217ba0d2397ea6f5a423dc0c02c0540a057925ca...a8817035afa3be6f184a031cf011248f494c3d9b,1,58,97,155,36,2009-06-26 11:34:05,2009-06-26 11:34:05
a8817035afa3be6f184a031cf011248f494c3d9b...8639d7e2d375fa17a32e19f5c19664d5e6313d5c,11,420,86,506,42,2009-06-30 21:56:08,2009-06-30 21:56:08
8639d7e2d375fa17a32e19f5c19664d5e6313d5c...833b2334bcddf019b125689a85c0d4f3bd6515fa,1,3,3,6,3,2009-07-01 10:39:06,2009-07-01 10:39:06
833b2334bcddf019b125689a85c0d4f3bd6515fa...b3a2f7f68831f1b4e6fa45d65177d04ac5a6b12e,4,122,3,125,14,2009-07-01 10:39:21,2009-07-01 10:39:21
b3a2f7f68831f1b4e6fa45d65177d04ac5a6b12e...614bc259544b101d24f4c34ed9a3b9ab69357f5b,2,44,6,50,7,2009-07-01 10:39:32,2009-07-01 10:39:32
614bc259544b101d24f4c34ed9a3b9ab69357f5b...1ed1ac22fee3613155f1da198c89f3d6149233fe,1,1,0,1,1,2009-07-01 10:39:40,2009-07-01 10:39:40
1ed1ac22fee3613155f1da198c89f3d6149233fe...b5ea9f6ad5ff42ee8b7c87e43388b62a2a94cbb0,3,17,57,74,8,2009-07-01 10:39:52,2009-07-01 10:39:52
b5ea9f6ad5ff42ee8b7c87e43388b62a2a94cbb0...8cd4df145f7ae244c9ff70dfc92ec9d169ef39e5,7,571,528,1099,18,2009-07-01 10:40:09,2009-07-01 10:40:09
8cd4df145f7ae244c9ff70dfc92ec9d169ef39e5...f2be59849c6e6adc654edd7ea27890c1719738cb,8,233,9,242,21,2009-07-01 14:24:25,2009-07-01 14:24:25
f2be59849c6e6adc654edd7ea27890c1719738cb...0c117384156f165d23ce3f6fc9f4aac98bee1a3c,2,18,5,23,3,2009-07-01 22:26:42,2009-07-01 22:26:42
0c117384156f165d23ce3f6fc9f4aac98bee1a3c...b1b9d34fa56676154c03e19835122fe132088e1c,2,56,64,120,16,2009-07-01 22:26:51,2009-07-01 22:26:51
b1b9d34fa56676154c03e19835122fe132088e1c...772452ccc7148a2e459148b18c96ff443a068693,3,17,15,32,5,2009-07-01 22:27:02,2009-07-01 22:27:02
7638651cc32c31f6c7032041af5f5e575e23f256...9c93f31d40d9995caaebdf575a167cab990f0552,0,0,0,0,0,2009-05-27 18:46:02,2009-05-27 18:46:02
9c93f31d40d9995caaebdf575a167cab990f0552...a2b215263596b1778054e3e8710dd6da13063f16,1,1,0,1,1,2009-06-01 15:37:41,2009-06-01 15:37:41
a2b215263596b1778054e3e8710dd6da13063f16...55e23d5efaa11b7385c9c0d117378b07cdeb7341,10,45,47,92,26,2009-06-01 15:38:11,2009-06-01 15:38:11
55e23d5efaa11b7385c9c0d117378b07cdeb7341...b59bfbd128a882778f4d96ac9a29880791f728b9,3,85,7,92,7,2009-06-01 15:38:34,2009-06-01 15:38:34
b59bfbd128a882778f4d96ac9a29880791f728b9...6152164303b6b8ac7705873fbebac72177efcb39,4,70,2,72,9,2009-06-01 15:38:58,2009-06-01 15:38:58
6152164303b6b8ac7705873fbebac72177efcb39...2f0e6d5595acbc517f9fba7dc25bda2b7899dd20,1,9,5,14,5,2009-06-01 15:39:21,2009-06-01 15:39:21
2f0e6d5595acbc517f9fba7dc25bda2b7899dd20...4d7390265373b5601d3a0a4c681a7f819baf7c4a,4,59,27,86,17,2009-06-01 15:39:46,2009-06-01 15:39:46
4d7390265373b5601d3a0a4c681a7f819baf7c4a...a094bda10a76a1284354f1212d71068660cd4d20,6,45,34,79,16,2009-06-01 15:40:18,2009-06-01 15:40:18
a094bda10a76a1284354f1212d71068660cd4d20...a6a8ae6408216250a85087cc73647e34ad6a91ea,1,1,7,8,2,2009-06-01 15:40:35,2009-06-01 15:40:35
a6a8ae6408216250a85087cc73647e34ad6a91ea...0467891c4142b31e297f68776af2db9e4a889d96,1,2,2,4,2,2009-06-01 15:40:56,2009-06-01 15:40:56
0467891c4142b31e297f68776af2db9e4a889d96...e573fb41e95d7d3f825f0d58e21bb3803e5ac0cf,1,5,5,10,3,2009-06-01 15:41:15,2009-06-01 15:41:15
e573fb41e95d7d3f825f0d58e21bb3803e5ac0cf...32916adca861f8ed2a8498fa03b23cd050661a79,4,8,7,15,7,2009-06-01 15:41:41,2009-06-01 15:41:41
32916adca861f8ed2a8498fa03b23cd050661a79...3ca1199da85b226c61faa7b5502e82058aa86c58,1,6,0,6,1,2009-06-01 15:41:56,2009-06-01 15:41:56
3ca1199da85b226c61faa7b5502e82058aa86c58...afcb3c887290fb4df73e72780f864b1ec82a2ac2,2,22,17,39,2,2009-06-01 15:42:13,2009-06-01 15:42:13
afcb3c887290fb4df73e72780f864b1ec82a2ac2...eae2b9c149662e8797744262d4f11c66822d5bca,2,19,1,20,3,2009-06-01 15:42:29,2009-06-01 15:42:29
eae2b9c149662e8797744262d4f11c66822d5bca...4449ff33a0b95ec66dd8c50d7a8c304cdcfa5534,1,15,3,18,4,2009-06-01 20:10:32,2009-06-01 20:10:32
4449ff33a0b95ec66dd8c50d7a8c304cdcfa5534...c51798f4fa484491c94e585e033ca79c8fc16867,2,162,162,324,2,2009-06-02 00:36:39,2009-06-02 00:36:39
c51798f4fa484491c94e585e033ca79c8fc16867...d484d021f20ebb079b20e85b6e249317452263fb,2,27,62,89,24,2009-06-02 00:37:00,2009-06-02 00:37:00
d484d021f20ebb079b20e85b6e249317452263fb...ea52757c1032da39fab6c11cd2b4481f37e9eeff,3,47,2,49,5,2009-06-02 00:37:23,2009-06-02 00:37:23
ea52757c1032da39fab6c11cd2b4481f37e9eeff...855423542c4360a1e1327957bbb080c6deef9c82,1,1,2,3,2,2009-06-02 00:37:38,2009-06-02 00:37:38
855423542c4360a1e1327957bbb080c6deef9c82...41bf859b67fdde731a0aa6750b18d9961c217353,1,3,1,4,2,2009-06-02 00:37:54,2009-06-02 00:37:54
41bf859b67fdde731a0aa6750b18d9961c217353...2f8f8bf531becb1c2cb767f285be685d8dbd6b24,2,27,21,48,17,2009-06-02 00:38:13,2009-06-02 00:38:13
2f8f8bf531becb1c2cb767f285be685d8dbd6b24...14f94933804c6c6f9fbaf956cce5ac12beae459a,4,40,0,40,2,2009-06-03 02:35:59,2009-06-03 02:35:59
14f94933804c6c6f9fbaf956cce5ac12beae459a...b963651223ad0875583c9eb91d365b3f0b540db1,1,7,1,8,6,2009-06-03 02:36:16,2009-06-03 02:36:16
b963651223ad0875583c9eb91d365b3f0b540db1...45af7117180284a21f64023d42e756f5eb8b8dad,2,24,10,34,8,2009-06-03 02:36:33,2009-06-03 02:36:33
45af7117180284a21f64023d42e756f5eb8b8dad...e33029cca35883f6a530531396d8e452137a8024,1,7,3,10,5,2009-06-03 02:36:49,2009-06-03 02:36:49
e33029cca35883f6a530531396d8e452137a8024...08652c8501196f2f9501791949934dc8a2641168,1,8,15,23,7,2009-06-03 02:37:04,2009-06-03 02:37:04
08652c8501196f2f9501791949934dc8a2641168...795cd55ba29cecae6e06ff1efa06051cabc81f5f,1,9,3,12,5,2009-06-03 02:37:20,2009-06-03 02:37:20
795cd55ba29cecae6e06ff1efa06051cabc81f5f...eed2445d02071b8503514ed232c47a8434c6ad12,1,3,6,9,6,2009-06-03 02:37:36,2009-06-03 02:37:36
eed2445d02071b8503514ed232c47a8434c6ad12...7506471585719ba727de0f650b45e59cfaa4f001,1,33,28,61,18,2009-06-03 02:37:51,2009-06-03 02:37:51
7506471585719ba727de0f650b45e59cfaa4f001...92934650f6cf428e7b7bf796db138c5a46370578,1,13,3,16,5,2009-06-03 02:38:06,2009-06-03 02:38:06
92934650f6cf428e7b7bf796db138c5a46370578...a9efb44c0159e0ea7a6f0040e2185d335c25f799,1,10,9,19,6,2009-06-03 02:38:23,2009-06-03 02:38:23
a9efb44c0159e0ea7a6f0040e2185d335c25f799...ef84cf85ba98ab4b3b62018a2404b67cd3daf5a4,2,14,1,15,2,2009-06-03 02:38:39,2009-06-03 02:38:39
ef84cf85ba98ab4b3b62018a2404b67cd3daf5a4...85e0c469aa5298b54d8d173bf1881b72b3f0c445,2,23,3,26,7,2009-06-03 02:39:02,2009-06-03 02:39:02
85e0c469aa5298b54d8d173bf1881b72b3f0c445...7b14625d0d9c8dc4df87c5354c856e6f5ed3ef60,24,1308,477,1785,330,2009-06-03 14:03:10,2009-06-03 14:03:10
7b14625d0d9c8dc4df87c5354c856e6f5ed3ef60...3e625f26672a0f886fbb47407d140c3ccf74fdaf,6,188,7,195,15,2009-06-08 00:54:28,2009-06-08 00:54:28
3e625f26672a0f886fbb47407d140c3ccf74fdaf...ca9cecb70280d55bff0e4422e996f40f8e1ea8ca,1,2,2,4,2,2009-06-08 00:54:45,2009-06-08 00:54:45
ca9cecb70280d55bff0e4422e996f40f8e1ea8ca...6d840d9b05f62a4eded37c6cc2da624a41d92e07,3,33,2,35,6,2009-06-08 00:55:07,2009-06-08 00:55:07
6d840d9b05f62a4eded37c6cc2da624a41d92e07...c43edf6d768f0ad001a6fea73084c04428f9721e,1,10,2,12,3,2009-06-08 00:55:27,2009-06-08 00:55:27
c43edf6d768f0ad001a6fea73084c04428f9721e...8a5e9f6939ce7e7cec8b2459fb78e1c623bbf6e8,1,1,1,2,1,2009-06-08 00:55:45,2009-06-08 00:55:45
8a5e9f6939ce7e7cec8b2459fb78e1c623bbf6e8...9dee3b26e58aec526f83c3c81a370764e8fc7bc2,1,33,2,35,4,2009-06-08 00:56:01,2009-06-08 00:56:01
9dee3b26e58aec526f83c3c81a370764e8fc7bc2...eea2bfd9416c1adc3d815591018a3bab969a17b1,1,4,0,4,1,2009-06-08 00:56:16,2009-06-08 00:56:16
eea2bfd9416c1adc3d815591018a3bab969a17b1...3772800752da3a184191958b240133490ecfd645,1,2,0,2,1,2009-06-18 00:31:18,2009-06-18 00:31:18
3772800752da3a184191958b240133490ecfd645...d707d370482e0ac80db74025b7ae1c7dac9a1b45,1,2,10,12,2,2009-06-18 00:31:37,2009-06-18 00:31:37
d707d370482e0ac80db74025b7ae1c7dac9a1b45...ae581816befd992b9e7e667d124f427d849bcfd0,3,7,5,12,5,2009-06-18 00:31:57,2009-06-18 00:31:57
ae581816befd992b9e7e667d124f427d849bcfd0...d06bca726d765678cd0046070787ab0ed6f04245,1,5,1,6,1,2009-06-18 00:58:39,2009-06-18 00:58:39
d06bca726d765678cd0046070787ab0ed6f04245...3a331970b45af217bd69b04f3b105ecbebb5bb07,3,55,21,76,16,2009-06-18 00:59:07,2009-06-18 00:59:07
3a331970b45af217bd69b04f3b105ecbebb5bb07...98e6ab0afc5ad56f4697da8925484c49c5e55657,31,1117,279,1396,144,2009-06-18 01:37:18,2009-06-18 01:37:18
98e6ab0afc5ad56f4697da8925484c49c5e55657...5ea9b7258513319291513dde105a066df1926a28,19,91,67,158,58,2009-06-21 19:24:30,2009-06-21 19:24:30
5ea9b7258513319291513dde105a066df1926a28...6306f48545f3022dbffa2469f1d35ee83df344ce,2,784,0,784,2,2009-06-21 19:24:49,2009-06-21 19:24:49
6306f48545f3022dbffa2469f1d35ee83df344ce...6c0cc3724d477da0e3beb544bd7284580e861323,1,640,0,640,160,2009-06-21 19:57:15,2009-06-21 19:57:15
6c0cc3724d477da0e3beb544bd7284580e861323...6fd54a9c0da2b42e6f7e9146b0486f6149e68732,1,165,790,955,80,2009-06-21 20:31:29,2009-06-21 20:31:29
6fd54a9c0da2b42e6f7e9146b0486f6149e68732...481fb86e139401bd454184066ee9e2dcb0015db0,1,2,2,4,2,2009-07-02 16:05:33,2009-07-02 16:05:33
481fb86e139401bd454184066ee9e2dcb0015db0...d628498c58aab0c4deafe6b9d08e6220ee093fc5,22,267,54,321,47,2009-07-02 16:07:15,2009-07-02 16:07:15
d628498c58aab0c4deafe6b9d08e6220ee093fc5...69c8d4622ec1d9327e73b4138213a71ae48e301a,22,59,40,99,60,2009-07-05 13:25:26,2009-07-05 13:25:26
69c8d4622ec1d9327e73b4138213a71ae48e301a...3bab02af8b884dd66a35e395998b7116d7eb8202,2,0,1483,1483,3,2009-07-05 13:25:52,2009-07-05 13:25:52
3bab02af8b884dd66a35e395998b7116d7eb8202...69b4f2ea2e8207b8c87cb184bf4c8b481cb623f3,2,1,1,2,1,2009-07-05 13:26:11,2009-07-05 13:26:11
69b4f2ea2e8207b8c87cb184bf4c8b481cb623f3...8424c8ae6cb817a978783ffed479c9959ef9c668,1,3,6,9,3,2009-07-05 13:26:31,2009-07-05 13:26:31
8424c8ae6cb817a978783ffed479c9959ef9c668...63f244f14413e0981c76dda8bf6f76e7b9df3d2a,3,39,3,42,5,2009-07-05 13:26:57,2009-07-05 13:26:57
63f244f14413e0981c76dda8bf6f76e7b9df3d2a...d23f541f102bc37e5ed9e78a05832335f3f3987b,3,39,17,56,10,2009-07-05 13:27:20,2009-07-05 13:27:20
d23f541f102bc37e5ed9e78a05832335f3f3987b...2dcc99e3958be44f397194dd5d22ff1b50f53e13,1,0,2,2,1,2009-07-05 13:27:38,2009-07-05 13:27:38
2dcc99e3958be44f397194dd5d22ff1b50f53e13...ce98a00987adbfc34c5155af434528e6fb3384bf,1,22,22,44,12,2009-07-05 13:28:07,2009-07-05 13:28:07
ce98a00987adbfc34c5155af434528e6fb3384bf...7464e4ec27bdff3e777ce1747e30ea8002fb472b,1,71,71,142,71,2009-07-05 13:28:23,2009-07-05 13:28:23
7464e4ec27bdff3e777ce1747e30ea8002fb472b...cb7d3f2a0e16c974f84df8b62d24a774220f7507,3,31,16,47,6,2009-07-05 13:28:41,2009-07-05 13:28:41
cb7d3f2a0e16c974f84df8b62d24a774220f7507...c1093ca87fbcb57c47aeb323edacfadead859cb2,3,54,11,65,13,2009-07-05 13:29:08,2009-07-05 13:29:08
c1093ca87fbcb57c47aeb323edacfadead859cb2...6610e857e3c56ac9c2916c5f3b79cd736c1f2299,1,9,4,13,4,2009-07-05 13:29:24,2009-07-05 13:29:24
6610e857e3c56ac9c2916c5f3b79cd736c1f2299...0e3b83c31515c041e8a43736e7dd49ffd835b052,1,13,1,14,4,2009-07-05 13:29:40,2009-07-05 13:29:40
0e3b83c31515c041e8a43736e7dd49ffd835b052...ff0eff055ea7cd28ba2856b89189d03dbe71c397,4,44,0,44,7,2009-07-05 13:30:17,2009-07-05 13:30:17
ff0eff055ea7cd28ba2856b89189d03dbe71c397...f662801023605ff6fe44416271e39839894e7962,1,1,1,2,1,2009-07-05 13:30:40,2009-07-05 13:30:40
f662801023605ff6fe44416271e39839894e7962...d0c3e19de5bf9d79f5436f8ddeccf9bea98d9306,31,1250,574,1824,489,2009-07-15 07:19:10,2009-07-15 07:19:10
d0c3e19de5bf9d79f5436f8ddeccf9bea98d9306...70cf6d86fd7c91d5bf5da3da0d76736a1ec93596,1,1,1,2,1,2009-07-19 20:55:15,2009-07-19 20:55:15
70cf6d86fd7c91d5bf5da3da0d76736a1ec93596...021ad1a02433f194ecd7776aa0522a7cf3b0d9b8,1,0,1,1,1,2009-07-19 20:55:34,2009-07-19 20:55:34
021ad1a02433f194ecd7776aa0522a7cf3b0d9b8...8d4417c75df30502f47abf6bd3582dfa2425f562,5,56,2,58,9,2009-07-19 20:55:58,2009-07-19 20:55:58
8d4417c75df30502f47abf6bd3582dfa2425f562...37ce9a503511eb612a5d17f9908cf4f6f72f9a7b,2,9,3,12,3,2009-08-05 01:22:48,2009-08-05 01:22:48
37ce9a503511eb612a5d17f9908cf4f6f72f9a7b...97db2014f8fc7574976711bbaf833c9467486998,125,20983,9901,30884,5529,2009-08-05 01:27:15,2009-08-05 01:27:15
97db2014f8fc7574976711bbaf833c9467486998...549b19af81099f3d2deb5cf15f1e55d75727d19e,1,29,21,50,1,2009-08-05 01:27:37,2009-08-05 01:27:37
549b19af81099f3d2deb5cf15f1e55d75727d19e...82c76b98cb7b978c88676222a38c59895b889645,2,28,22,50,3,2009-08-05 01:27:56,2009-08-05 01:27:56
82c76b98cb7b978c88676222a38c59895b889645...a604fc39d0ae834622103ac0559a8acddeb6105a,3,73,34,107,33,2009-08-05 01:28:21,2009-08-05 01:28:21
a604fc39d0ae834622103ac0559a8acddeb6105a...b7e064207c27fcdd1b97617c18c0d3331b34d2c8,1,29,0,29,1,2009-08-05 01:28:39,2009-08-05 01:28:39
b7e064207c27fcdd1b97617c18c0d3331b34d2c8...6960b0491524a593fea34c50809f7cdf0e60a6f7,1,76,8,84,6,2009-08-11 17:19:06,2009-08-11 17:19:06
6960b0491524a593fea34c50809f7cdf0e60a6f7...45112c21a6029b207f3ae2ce06b659bfde2697b5,1,2,2,4,1,2009-08-11 17:19:30,2009-08-11 17:19:30
45112c21a6029b207f3ae2ce06b659bfde2697b5...8c988332832c83c6ebaaab1e0142d0f1b853cbc0,1,55,42,97,7,2009-08-11 17:19:48,2009-08-11 17:19:48
8c988332832c83c6ebaaab1e0142d0f1b853cbc0...244296ffbcef59e8d3feebc6ab4f6d059e6c38ca,1,12,12,24,7,2009-08-11 17:20:10,2009-08-11 17:20:10
244296ffbcef59e8d3feebc6ab4f6d059e6c38ca...b28332cd462b3aec9fe595ae2c530cf23c949530,1,38,42,80,5,2009-08-12 16:37:20,2009-08-12 16:37:20
b28332cd462b3aec9fe595ae2c530cf23c949530...106089c18e3c15a801fc339d773f8d227228924d,5,47,7,54,9,2009-08-12 20:10:54,2009-08-12 20:10:54
106089c18e3c15a801fc339d773f8d227228924d...2799e928432ba18ca77a74a5231833ba6d0f229c,2,7,4,11,2,2009-08-12 20:11:10,2009-08-12 20:11:10
2799e928432ba18ca77a74a5231833ba6d0f229c...69fef1daef3ce5a34bd7701f0f23765da5c926e6,1,24,0,24,1,2009-08-12 20:11:30,2009-08-12 20:11:30
69fef1daef3ce5a34bd7701f0f23765da5c926e6...84c9cf16d36661f891673208ef8517881167881e,2,52,42,94,6,2009-08-15 13:33:38,2009-08-15 13:33:38
84c9cf16d36661f891673208ef8517881167881e...5ebafe3fb98ca99c7b7392087b899f1053d5cf5e,2,13,13,26,3,2009-08-15 13:33:57,2009-08-15 13:33:57
5ebafe3fb98ca99c7b7392087b899f1053d5cf5e...05524abf1beee11bb1efa1115eca345e0d96aa83,4,23,8,31,8,2009-08-15 13:34:21,2009-08-15 13:34:21
05524abf1beee11bb1efa1115eca345e0d96aa83...95784913791ef68a2c36f8b2f9bcb0dce6584a81,3,55,83,138,23,2009-08-15 13:34:42,2009-08-15 13:34:42
95784913791ef68a2c36f8b2f9bcb0dce6584a81...15fb81c3444f7965cb3717a524d9d101b923ea4f,1,25,3,28,2,2009-08-15 13:34:59,2009-08-15 13:34:59
15fb81c3444f7965cb3717a524d9d101b923ea4f...7a6a71dd0c6e04d46c0db55a46d97585e7edfe45,1,11,4,15,2,2009-08-15 13:35:16,2009-08-15 13:35:16
7a6a71dd0c6e04d46c0db55a46d97585e7edfe45...f20e7fcdd22fe3a2181071af1f8460bb6c3d32f0,2,40,5,45,8,2009-08-15 13:35:43,2009-08-15 13:35:43
f20e7fcdd22fe3a2181071af1f8460bb6c3d32f0...78d75b86e3e45ec3ca9f2ace21255922046dd509,22,344,35,379,40,2009-09-11 21:06:15,2009-09-11 21:06:15
78d75b86e3e45ec3ca9f2ace21255922046dd509...9222091de8fa2fcb4fedd74ac99b65c88d295135,16,102,39,141,30,2009-09-11 21:23:55,2009-09-11 21:23:55
9222091de8fa2fcb4fedd74ac99b65c88d295135...83a3588ff712d5fe44e9692f5cb6a1d020f3ab2f,4,16,7,23,4,2009-09-11 22:12:30,2009-09-11 22:12:30
83a3588ff712d5fe44e9692f5cb6a1d020f3ab2f...dfe495fbe8e360ee3b3cd8b29e55ee19d86fc9d2,42,553,371,924,153,2009-10-12 10:16:17,2009-10-12 10:16:17
dfe495fbe8e360ee3b3cd8b29e55ee19d86fc9d2...30ea350dabad28b0e524feabce434d446e013d6f,151,4658,1583,6241,543,2009-11-07 17:09:09,2009-11-07 17:09:09
30ea350dabad28b0e524feabce434d446e013d6f...3b895d4a9a68a841ec517b84451da496bb258b3f,78,2156,1254,3410,673,2009-12-07 01:41:26,2009-12-07 01:41:26
3b895d4a9a68a841ec517b84451da496bb258b3f...695de8cc9145e139c2b22e05aa44f5ac04da6f85,3,32,3,35,4,2009-12-13 21:39:46,2009-12-13 21:39:46
695de8cc9145e139c2b22e05aa44f5ac04da6f85...f911df19a455246198b0c8c81ab96bf2abec04f8,556,22583,9522,32105,3742,2009-12-28 16:35:23,2009-12-28 16:35:23
f911df19a455246198b0c8c81ab96bf2abec04f8...5559eb56febc5075a13beaea300e4ba803604ff2,1,1,1,2,1,2009-12-28 17:41:56,2009-12-28 17:41:56
5559eb56febc5075a13beaea300e4ba803604ff2...8c62b72c060128c66726f211e2d40434a7d6f8bf,4,0,587,587,98,2009-12-29 02:53:26,2009-12-29 02:53:26
8c62b72c060128c66726f211e2d40434a7d6f8bf...22795e154f88570e65193c65aa16c8354f13d529,1,4,161,165,3,2009-12-29 04:04:36,2009-12-29 04:04:36
22795e154f88570e65193c65aa16c8354f13d529...c3e94faa23dba7c49648bc19c643abd54da4f205,5,20,38,58,16,2009-12-29 04:04:59,2009-12-29 04:04:59
c3e94faa23dba7c49648bc19c643abd54da4f205...c4767e642a4b64cc9f1bc53177b21dbd0adb01f2,1,2,0,2,2,2009-12-29 04:05:17,2009-12-29 04:05:17
c4767e642a4b64cc9f1bc53177b21dbd0adb01f2...201d171d9d704652ab7f605873c86192020efc94,1,0,8,8,1,2009-12-29 04:05:33,2009-12-29 04:05:33
201d171d9d704652ab7f605873c86192020efc94...c2a2b51ac3009739813a7e6ba22f3c7053a30da2,6,17,18,35,17,2010-01-01 20:30:17,2010-01-01 20:30:17
c2a2b51ac3009739813a7e6ba22f3c7053a30da2...a907e15cad3ede93f8b785007bdf93205b4f431a,7,37,37,74,37,2010-01-01 21:11:57,2010-01-01 21:11:57
a907e15cad3ede93f8b785007bdf93205b4f431a...23a3c08bbbed3eb30c5ecce3cd5543c99d5ce883,1,1,1,2,1,2010-01-01 21:14:12,2010-01-01 21:14:12
23a3c08bbbed3eb30c5ecce3cd5543c99d5ce883...a7c320fea79b8750ab2a8aca84d8e8fb76d8b100,3,18,6,24,6,2010-01-04 00:22:13,2010-01-04 00:22:13
a7c320fea79b8750ab2a8aca84d8e8fb76d8b100...ffd5564a87c5c8e5d5e1e201ae3462807b955efc,85,1653,357,2010,255,2010-01-04 01:06:26,2010-01-04 01:06:26
ffd5564a87c5c8e5d5e1e201ae3462807b955efc...409efbf57c0f1dc7772fdcabc9f7c5525affcc8d,5,12,4,16,8,2010-01-04 01:06:54,2010-01-04 01:06:54
409efbf57c0f1dc7772fdcabc9f7c5525affcc8d...a3ad787308e749cb769156f95ea351e03b3d1526,1,1,1,2,1,2010-01-04 01:07:09,2010-01-04 01:07:09
a3ad787308e749cb769156f95ea351e03b3d1526...891c34ddd0b4bd5e5546a787f0cdcdc481d5d271,1,6,1,7,2,2010-01-04 01:57:36,2010-01-04 01:57:36
891c34ddd0b4bd5e5546a787f0cdcdc481d5d271...556132f75bbf87a817fde540d10606a3db7f9aec,1,0,4,4,1,2010-01-04 01:57:54,2010-01-04 01:57:54
556132f75bbf87a817fde540d10606a3db7f9aec...a54ed5ad1efc283778d8f13d1ffb3f7a1d7c2427,11,26,175,201,19,2010-01-04 02:16:36,2010-01-04 02:16:36
a54ed5ad1efc283778d8f13d1ffb3f7a1d7c2427...82c4f9d04e9f0f8776037b6caf1343074518d303,1,22,16,38,5,2010-01-04 23:34:54,2010-01-04 23:34:54
82c4f9d04e9f0f8776037b6caf1343074518d303...1f98e981060e099498e30e11b08a76ab26bae065,1,50,67,117,10,2010-01-04 23:52:03,2010-01-04 23:52:03
1f98e981060e099498e30e11b08a76ab26bae065...7ec7f38b392ecc635210e03d00bec2563a37ac26,0,0,0,0,0,2010-01-05 00:21:21,2010-01-05 00:21:21
7ec7f38b392ecc635210e03d00bec2563a37ac26...6e8d2dd4fb03e7d8c38c5679568826a1bee4cafa,0,0,0,0,0,2010-01-05 00:31:30,2010-01-05 00:31:30
6e8d2dd4fb03e7d8c38c5679568826a1bee4cafa...0b5c67a7465f354ceb531489d2124921f832db27,24,542,71,613,79,2010-01-05 00:39:42,2010-01-05 00:39:42
0b5c67a7465f354ceb531489d2124921f832db27...73d7f4671b7d77829fe648517419e0f8add29fed,1,0,0,0,0,2010-01-05 00:57:16,2010-01-05 00:57:16
73d7f4671b7d77829fe648517419e0f8add29fed...3e9035a9625c8a8a5e88361133e87ce455c4fc13,1,14,14,28,5,2010-01-05 01:21:41,2010-01-05 01:21:41
7638651cc32c31f6c7032041af5f5e575e23f256...059dac02073add5fed2864cc7d735096f4c4b6ea,0,0,0,0,0,2009-05-27 18:45:22,2009-05-27 18:45:22
059dac02073add5fed2864cc7d735096f4c4b6ea...4cd29f2520d71e93ca3a9dcd052fd11827a1c49b,17,1188,470,1658,316,2009-06-02 02:46:02,2009-06-02 02:46:02
4cd29f2520d71e93ca3a9dcd052fd11827a1c49b...bce55b1aa8ee6548aa8494683211cc16e47282ea,15,234,154,388,77,2009-06-03 01:58:33,2009-06-03 01:58:33
bce55b1aa8ee6548aa8494683211cc16e47282ea...1dc330595c47bb26c7884c2eb55009c2055160fe,18,540,262,802,106,2009-06-03 02:03:49,2009-06-03 02:03:49
1dc330595c47bb26c7884c2eb55009c2055160fe...f280c325cda1364689fefdda853173e1e05591bf,15,83,88,171,61,2009-06-03 02:06:40,2009-06-03 02:06:40
f280c325cda1364689fefdda853173e1e05591bf...9286db51456eeb727051bcbccbbbac0857c7f77b,14,110,53,163,47,2009-06-03 02:13:01,2009-06-03 02:13:01
9286db51456eeb727051bcbccbbbac0857c7f77b...15d405077e5c8bb49d423dd6c5051614fa4c74c4,6,68,44,112,40,2009-06-03 02:16:53,2009-06-03 02:16:53
15d405077e5c8bb49d423dd6c5051614fa4c74c4...f4bcbbfa8bca397850a0060225906243e7ed27f4,17,110,52,162,29,2009-06-03 02:26:16,2009-06-03 02:26:16
f4bcbbfa8bca397850a0060225906243e7ed27f4...23da5c0ac1105df44de23b2719f27e6362db93f6,29,448,350,798,225,2009-06-03 02:37:33,2009-06-03 02:37:33
23da5c0ac1105df44de23b2719f27e6362db93f6...b1f70d9e53f4256cf82594a1a44428d8e64cb23d,5,61,39,100,14,2009-06-03 03:18:48,2009-06-03 03:18:48
b1f70d9e53f4256cf82594a1a44428d8e64cb23d...2f2cfac142448085eb911422324c099364db223c,7,120,8,128,15,2009-06-03 19:13:11,2009-06-03 19:13:11
2f2cfac142448085eb911422324c099364db223c...c233618d4bd4c0ad7412c5a7ca760624b933d89b,1,2,2,4,2,2009-06-03 20:54:54,2009-06-03 20:54:54
c233618d4bd4c0ad7412c5a7ca760624b933d89b...7c797e138d34ff3427378cbf461e9f51cc4a2167,1,1,1,2,1,2009-06-03 21:02:35,2009-06-03 21:02:35
7c797e138d34ff3427378cbf461e9f51cc4a2167...dc4eaff12181352678f958e0470ff1975933ba28,1,2,1,3,1,2009-06-03 21:25:20,2009-06-03 21:25:20
dc4eaff12181352678f958e0470ff1975933ba28...96cf08295d6fc460bcf6439cf2c958f18a9b0015,1,15,15,30,15,2009-06-03 21:40:59,2009-06-03 21:40:59
96cf08295d6fc460bcf6439cf2c958f18a9b0015...fbb6fda5f6ecf1b053587fe0c07c0d9bfc6328e6,4,10,34,44,9,2009-06-04 16:13:14,2009-06-04 16:13:14
fbb6fda5f6ecf1b053587fe0c07c0d9bfc6328e6...91520ec36434f4023028485322b93fbee2f12108,3,30,8,38,9,2009-06-04 16:53:45,2009-06-04 16:53:45
91520ec36434f4023028485322b93fbee2f12108...8bbd1926811e2b4d5d77f1f8f7d89de7a7f83dab,1,2,1,3,1,2009-06-04 17:10:05,2009-06-04 17:10:05
8bbd1926811e2b4d5d77f1f8f7d89de7a7f83dab...6aca03c24d769bafc8f04100a33f7fa2371a7d04,6,185,7,192,15,2009-06-06 18:01:43,2009-06-06 18:01:43
6aca03c24d769bafc8f04100a33f7fa2371a7d04...4d6c6d05964e8ec73159768de333ce210ac08e4d,4,11,6,17,5,2009-06-06 19:38:29,2009-06-06 19:38:29
4d6c6d05964e8ec73159768de333ce210ac08e4d...fdd5ff646e82cf4fe5f041c394b909c6d677153e,2,4,5,9,3,2009-06-07 03:06:13,2009-06-07 03:06:13
fdd5ff646e82cf4fe5f041c394b909c6d677153e...110e4f68ef3b1d1e696d185dac5a5ad09658dcb2,1,25,5,30,9,2009-06-07 03:26:12,2009-06-07 03:26:12
110e4f68ef3b1d1e696d185dac5a5ad09658dcb2...f57bc92842b45ecf34cac1a3b33972840ed6f10b,1,3,0,3,3,2009-06-07 23:42:26,2009-06-07 23:42:26
f57bc92842b45ecf34cac1a3b33972840ed6f10b...1653ffb57124164ea48b2a084a8423a35164939d,5,17,12,29,9,2009-06-07 23:56:42,2009-06-07 23:56:42
1653ffb57124164ea48b2a084a8423a35164939d...33ed158dc459b17a93b84cd59ab4aa33a0d992a0,5,23,11,34,13,2009-06-08 01:14:44,2009-06-08 01:14:44
33ed158dc459b17a93b84cd59ab4aa33a0d992a0...83df1f1056408e322150924fe88378f22a1c6758,13,221,55,276,40,2009-06-10 23:30:30,2009-06-10 23:30:30
83df1f1056408e322150924fe88378f22a1c6758...f6db1dd357d22d9a376b909c169894a8bba0a49c,11,248,82,330,48,2009-06-16 01:36:05,2009-06-16 01:36:05
f6db1dd357d22d9a376b909c169894a8bba0a49c...bc3cd5d9520d6a07a77b04977c390574a25da14a,26,734,198,932,91,2009-06-18 17:03:52,2009-06-18 17:03:52
bc3cd5d9520d6a07a77b04977c390574a25da14a...f3808a02c3d9d71907ce0f5f39118cedb39c0e34,1,0,6,6,1,2009-06-18 17:05:59,2009-06-18 17:05:59
f3808a02c3d9d71907ce0f5f39118cedb39c0e34...4f461542b59d4ba6c366eab08bde783f68977ce0,3,17,3,20,4,2009-06-18 17:31:36,2009-06-18 17:31:36
4f461542b59d4ba6c366eab08bde783f68977ce0...99fdf66600973c67f634cce79a009c2139f33ee7,1,0,8,8,2,2009-06-18 23:42:00,2009-06-18 23:42:00
99fdf66600973c67f634cce79a009c2139f33ee7...64eec4a120ea7e9a280a9193d2ac11f099e7f3c9,7,11,39,50,15,2009-06-19 00:21:38,2009-06-19 00:21:38
64eec4a120ea7e9a280a9193d2ac11f099e7f3c9...903ff126b0209c5726705cb72cd0986561ee22f5,1,4,0,4,2,2009-06-19 00:29:18,2009-06-19 00:29:18
903ff126b0209c5726705cb72cd0986561ee22f5...03fbc3f25db0dc59965a674b021cd2e203531e7c,1,11,19,30,5,2009-06-19 00:35:35,2009-06-19 00:35:35
03fbc3f25db0dc59965a674b021cd2e203531e7c...b4e069fab445986bcd0c35b350b0f3e2cafeffc7,2,8,10,18,4,2009-06-19 01:09:21,2009-06-19 01:09:21
b4e069fab445986bcd0c35b350b0f3e2cafeffc7...4f199d099c1270d5ff5c7d337d70f57f471283f2,1,4,3,7,2,2009-06-19 02:18:47,2009-06-19 02:18:47
4f199d099c1270d5ff5c7d337d70f57f471283f2...61db8d6b970359b365fd8077f4a5895a0dd00aa0,2,4,5,9,3,2009-06-19 02:19:37,2009-06-19 02:19:37
61db8d6b970359b365fd8077f4a5895a0dd00aa0...50f5673c98ead853b200d9b930b5275e63838e2d,7,190,26,216,20,2009-06-26 18:03:12,2009-06-26 18:03:12
50f5673c98ead853b200d9b930b5275e63838e2d...1b183216ecb977d3ab545c9305e2e4d2cae87e30,2,48,59,107,3,2009-06-26 18:10:12,2009-06-26 18:10:12
1b183216ecb977d3ab545c9305e2e4d2cae87e30...7838fd87eb55a23e7b1d403c1d173916a5ade4f4,1,18,0,18,1,2009-06-26 18:16:18,2009-06-26 18:16:18
7838fd87eb55a23e7b1d403c1d173916a5ade4f4...2ab1840a9da39858665fdb88e7a8065f8e673219,15,67,22,89,22,2009-07-01 04:20:38,2009-07-01 04:20:38
2ab1840a9da39858665fdb88e7a8065f8e673219...04e3fc8de29a5a558e96243605f143c16cff3820,4,60,2,62,4,2009-07-01 04:37:08,2009-07-01 04:37:08
04e3fc8de29a5a558e96243605f143c16cff3820...5d462b9ec1f77bb99240e14a893eb50aa633ce78,8,65,14,79,16,2009-07-01 05:01:59,2009-07-01 05:01:59
5d462b9ec1f77bb99240e14a893eb50aa633ce78...f73cbaea672bbc2fdc1727b61516d46045039347,12,35,34,69,23,2009-07-02 02:28:12,2009-07-02 02:28:12
f73cbaea672bbc2fdc1727b61516d46045039347...94e002c6e4560a049db3be876219deb72ec2459b,20,1013,533,1546,454,2009-07-09 17:45:59,2009-07-09 17:45:59
94e002c6e4560a049db3be876219deb72ec2459b...08ab082480f1beaf8dac5cddd0948a1c26f574d8,21,312,86,398,66,2009-07-16 03:02:08,2009-07-16 03:02:08
08ab082480f1beaf8dac5cddd0948a1c26f574d8...24b66ace9d00a2194eba0548bd5e982bdac6f2be,24,694,194,888,102,2009-07-16 23:13:49,2009-07-16 23:13:49
24b66ace9d00a2194eba0548bd5e982bdac6f2be...6060ee7c77819623c145e1911d000325ed3655c5,6,22,5,27,11,2009-07-17 00:15:02,2009-07-17 00:15:02
6060ee7c77819623c145e1911d000325ed3655c5...83955447747561e6b89e84a062164d94910c6d7d,10,74,50,124,50,2009-07-17 15:57:43,2009-07-17 15:57:43
83955447747561e6b89e84a062164d94910c6d7d...0536cb98d5d93530b8dfc36bfa4edcd4c8ba59eb,6,136,124,260,103,2009-07-19 21:31:13,2009-07-19 21:31:13
0536cb98d5d93530b8dfc36bfa4edcd4c8ba59eb...502d4982c9b5ce0a916145f7e78fb702afb8b60a,5,20,12,32,13,2009-07-19 21:57:08,2009-07-19 21:57:08
502d4982c9b5ce0a916145f7e78fb702afb8b60a...ac74fa7e32e09fd9133370f20e34994ae738786f,6,30,9,39,11,2009-07-20 18:52:47,2009-07-20 18:52:47
ac74fa7e32e09fd9133370f20e34994ae738786f...1a98f6ff266395f5092bb755db06d8016ab68e92,96,20126,9574,29700,5317,2009-07-31 18:29:06,2009-07-31 18:29:06
1a98f6ff266395f5092bb755db06d8016ab68e92...7cf6fd8d61ed9ea8bc74ea02c96db041859e8c09,1,0,13,13,1,2009-07-31 18:31:55,2009-07-31 18:31:55
7cf6fd8d61ed9ea8bc74ea02c96db041859e8c09...3cd611b89ccbd9d01bd1e965fb5060dfa3879057,13,84,63,147,41,2009-08-01 05:26:02,2009-08-01 05:26:02
3cd611b89ccbd9d01bd1e965fb5060dfa3879057...3dd211ff0358279c92f469b0a0d09ae003873779,1,2,2,4,2,2009-08-02 19:37:57,2009-08-02 19:37:57
3dd211ff0358279c92f469b0a0d09ae003873779...ada3f39dca2e51965692609e3c403081bc44a260,5,51,27,78,26,2009-08-04 04:37:30,2009-08-04 04:37:30
ada3f39dca2e51965692609e3c403081bc44a260...80ef8a86d1ca11ebabe050a4d74ce7fb680f7960,3,17,13,30,14,2009-08-04 23:49:14,2009-08-04 23:49:14
80ef8a86d1ca11ebabe050a4d74ce7fb680f7960...c7af1de191b1b86708b7c14bbf7adc4eb3a13310,1,2,2,4,2,2009-08-05 00:47:07,2009-08-05 00:47:07
c7af1de191b1b86708b7c14bbf7adc4eb3a13310...1e583db0df963d8e8c16e89a5f9cc7069649ee93,1,4,1,5,1,2009-08-05 21:45:04,2009-08-05 21:45:04
1e583db0df963d8e8c16e89a5f9cc7069649ee93...e2fecde4a97c455d85c3ae20bc6344e9012830d2,1,0,13,13,1,2009-08-05 21:49:24,2009-08-05 21:49:24
e2fecde4a97c455d85c3ae20bc6344e9012830d2...8ad4ea7b042658cd47f362712e2f1f07c506c3b2,4,10,11,21,11,2009-08-06 00:27:53,2009-08-06 00:27:53
8ad4ea7b042658cd47f362712e2f1f07c506c3b2...b7b5493fc3c4e59e84e0e2c36d36e2be8c553f1b,11,61,44,105,32,2009-08-06 00:46:53,2009-08-06 00:46:53
b7b5493fc3c4e59e84e0e2c36d36e2be8c553f1b...2231e641159e4704f335811f136bba6dddc514fb,1,0,15,15,1,2009-08-06 00:48:45,2009-08-06 00:48:45
2231e641159e4704f335811f136bba6dddc514fb...2899accd269b12310d415a0c1457c0b54c0716ea,4,13,11,24,8,2009-08-09 02:39:23,2009-08-09 02:39:23
2899accd269b12310d415a0c1457c0b54c0716ea...b6ae173078e51248bd272b1f82249b5fa4ff5e56,1,0,10,10,3,2009-08-09 02:41:56,2009-08-09 02:41:56
b6ae173078e51248bd272b1f82249b5fa4ff5e56...2309288688b6f230a2b85b7455982215e4534917,1,4,4,8,3,2009-08-09 02:46:27,2009-08-09 02:46:27
2309288688b6f230a2b85b7455982215e4534917...07fc79651d1fc348533e809957286b626941a9e7,1,1,1,2,1,2009-08-09 02:48:19,2009-08-09 02:48:19
07fc79651d1fc348533e809957286b626941a9e7...5fe110e1499baa59382f3acd9af7b6248dfdd0da,1,5,5,10,1,2009-08-09 02:49:27,2009-08-09 02:49:27
5fe110e1499baa59382f3acd9af7b6248dfdd0da...50ad53dbca34328706ed72bc4572231ca5b7e8f6,2,12,1,13,3,2009-08-09 02:52:45,2009-08-09 02:52:45
50ad53dbca34328706ed72bc4572231ca5b7e8f6...fde0bfe929bdb3ac6046b270052da183a223d7d8,1,3,1,4,1,2009-08-09 02:55:45,2009-08-09 02:55:45
fde0bfe929bdb3ac6046b270052da183a223d7d8...1cbe183ff7bc85ff7baea343a57620ed35dce1da,2,10,3,13,4,2009-08-09 21:53:57,2009-08-09 21:53:57
1cbe183ff7bc85ff7baea343a57620ed35dce1da...0d62f502717fdaf1b349724e65aeb47383935865,2,14,3,17,6,2009-08-09 22:03:24,2009-08-09 22:03:24
0d62f502717fdaf1b349724e65aeb47383935865...3a43d539b47cb85dafad7144630f0bc24ce29f4d,1,7,0,7,1,2009-08-09 22:11:51,2009-08-09 22:11:51
3a43d539b47cb85dafad7144630f0bc24ce29f4d...6f983870f3c5b2d7683c20a0d2b92b1a572bc846,8,267,8,275,9,2009-08-18 05:17:59,2009-08-18 05:17:59
6f983870f3c5b2d7683c20a0d2b92b1a572bc846...2bc7422b52bc4ca3be9664699d6756ffaab1dad2,63,735,433,1168,210,2009-10-09 22:16:10,2009-10-09 22:16:10
2bc7422b52bc4ca3be9664699d6756ffaab1dad2...e9e73c4b6842c555aac0ca88e4d86670d11e7af5,198,5815,1900,7715,728,2009-11-21 06:55:11,2009-11-21 06:55:11
e9e73c4b6842c555aac0ca88e4d86670d11e7af5...4f40925785a0db114baa042f512279ef44326d26,34,1235,1223,2458,153,2009-11-21 07:03:40,2009-11-21 07:03:40
4f40925785a0db114baa042f512279ef44326d26...1fc8f9a27997d865140e62f3a37cf62fdcc7b94b,12,174,38,212,28,2009-11-23 14:25:44,2009-11-23 14:25:44
1fc8f9a27997d865140e62f3a37cf62fdcc7b94b...0c167ae0ff3f23dcb00fddfb0d8b37b49060d3c4,14,321,192,513,70,2009-11-23 16:42:38,2009-11-23 16:42:38
0c167ae0ff3f23dcb00fddfb0d8b37b49060d3c4...f2604c331da724e7842ade39d6fe0f44be99dc36,14,374,130,504,47,2009-11-23 16:42:56,2009-11-23 16:42:56
f2604c331da724e7842ade39d6fe0f44be99dc36...ba0d00ddbb604efb39eb8bbf522e21c9455228ee,3,9,8,17,8,2009-11-23 16:43:06,2009-11-23 16:43:06
ba0d00ddbb604efb39eb8bbf522e21c9455228ee...64d4c4c09f3af3bc2e8c78babe32000e8e4e4c09,3,23,5,28,8,2009-11-23 16:43:17,2009-11-23 16:43:17
64d4c4c09f3af3bc2e8c78babe32000e8e4e4c09...30d5a3c8f70c4e5fbfdc42358b9700ae5e497e4f,1,20,8,28,4,2009-11-23 16:43:25,2009-11-23 16:43:25
30d5a3c8f70c4e5fbfdc42358b9700ae5e497e4f...cec677a782d9a90dfae08be0d1db882231c5abaf,3,8,8,16,8,2009-11-23 16:43:35,2009-11-23 16:43:35
cec677a782d9a90dfae08be0d1db882231c5abaf...da909ae3a076777f40b0f51d0a1a77c58ff3fcb7,12,280,135,415,109,2009-11-23 16:43:54,2009-11-23 16:43:54
da909ae3a076777f40b0f51d0a1a77c58ff3fcb7...f0b8874479c04fed4c19c9f7950c7f091dc90f15,5,8,26,34,10,2009-11-23 16:44:05,2009-11-23 16:44:05
f0b8874479c04fed4c19c9f7950c7f091dc90f15...57923624183a8fa250d0222a14321a3340e00a05,2,11,10,21,7,2009-11-23 16:44:22,2009-11-23 16:44:22
57923624183a8fa250d0222a14321a3340e00a05...91ca0ebfd9bd0436d8c447a8f7e08f3ac5bde994,1,16,4,20,7,2009-11-23 16:44:30,2009-11-23 16:44:30
91ca0ebfd9bd0436d8c447a8f7e08f3ac5bde994...ca0698553eb4ae9539a758e5e1a14181dd230fb1,1,4,4,8,4,2009-11-23 16:44:38,2009-11-23 16:44:38
ca0698553eb4ae9539a758e5e1a14181dd230fb1...3e6ae729bc911126eaef071d4a007307e6daa289,2,130,14,144,11,2009-11-23 16:44:47,2009-11-23 16:44:47
3e6ae729bc911126eaef071d4a007307e6daa289...4e36fffab2d1b47c10bcf462d9309d40e63dabb9,55,637,434,1071,187,2009-11-23 16:45:41,2009-11-23 16:45:41
4e36fffab2d1b47c10bcf462d9309d40e63dabb9...b8c35f95f43f121373531c93bf3fcc2aea2bbf84,3,58,24,82,19,2009-11-23 16:45:51,2009-11-23 16:45:51
b8c35f95f43f121373531c93bf3fcc2aea2bbf84...1dafb9ad6cee1518a8fbc996c8fb609e790d55aa,7,5,59,64,9,2009-11-23 16:46:07,2009-11-23 16:46:07
1dafb9ad6cee1518a8fbc996c8fb609e790d55aa...e58c73041b87e64c3401022589b5de5868179a61,3,21,8,29,4,2009-11-26 07:26:05,2009-11-26 07:26:05
e58c73041b87e64c3401022589b5de5868179a61...28c2d5fde719c5446ee133cff9f59963aabbd4fc,3,17,21,38,5,2009-11-26 17:48:41,2009-11-26 17:48:41
28c2d5fde719c5446ee133cff9f59963aabbd4fc...5a5e082161cba5776381ef453856495138ec48f8,1,4,4,8,2,2009-11-26 17:48:50,2009-11-26 17:48:50
5a5e082161cba5776381ef453856495138ec48f8...0ca0ed0453665aeb6bba892a19d7760a57774915,14,279,156,435,76,2009-12-03 06:25:45,2009-12-03 06:25:45
0ca0ed0453665aeb6bba892a19d7760a57774915...fdadb7bf18c1754f52a07f09b8b351efb5ae52a9,14,624,957,1581,428,2009-12-03 06:28:26,2009-12-03 06:28:26
fdadb7bf18c1754f52a07f09b8b351efb5ae52a9...a824570484e6b4f026c2c90b391746a547f3b9ec,1,4,1,5,2,2009-12-03 20:57:33,2009-12-03 20:57:33
a824570484e6b4f026c2c90b391746a547f3b9ec...6bc1b7d8cd4e15dd7557a94c1e8a05734ee8ef0d,1,0,9,9,1,2009-12-03 20:57:53,2009-12-03 20:57:53
6bc1b7d8cd4e15dd7557a94c1e8a05734ee8ef0d...2e900d47f284afcb663b6687f9a4cca7c7e2eeb4,1,1,1,2,1,2009-12-04 00:55:38,2009-12-04 00:55:38
2e900d47f284afcb663b6687f9a4cca7c7e2eeb4...bee835fa445dfc6eca624a63fdea8db7e9a5493d,53,2286,76,2362,114,2009-12-09 17:23:16,2009-12-09 17:23:16
bee835fa445dfc6eca624a63fdea8db7e9a5493d...353e0797920fbf5170653c9a9aabe2572a5ad214,1,53,0,53,1,2009-12-12 02:09:11,2009-12-12 02:09:11
353e0797920fbf5170653c9a9aabe2572a5ad214...c88113683d6538dbc2f779ff57fd1ea20211abec,34,1239,233,1472,225,2009-12-12 02:10:28,2009-12-12 02:10:28
c88113683d6538dbc2f779ff57fd1ea20211abec...049dc42bdea8f524f9d52edd4ddc05ef0048d401,109,2734,3663,6397,579,2009-12-12 02:13:30,2009-12-12 02:13:30
049dc42bdea8f524f9d52edd4ddc05ef0048d401...2794cceb5f6cf21f2c99b90c9d1e79475f830460,53,1660,1623,3283,158,2009-12-13 22:15:08,2009-12-13 22:15:08
2794cceb5f6cf21f2c99b90c9d1e79475f830460...4e25ca00c8fe44639d1c79b7b85e535ed86b3e2c,45,1599,241,1840,138,2009-12-14 17:47:04,2009-12-14 17:47:04
4e25ca00c8fe44639d1c79b7b85e535ed86b3e2c...d5e883f2e36781fa86afc98ea657de47a35c0a57,1,18,22,40,19,2009-12-15 08:25:50,2009-12-15 08:25:50
d5e883f2e36781fa86afc98ea657de47a35c0a57...808aa3b89de27edb670fa03077488580c34d529a,2,19,8,27,3,2009-12-15 08:25:58,2009-12-15 08:25:58
808aa3b89de27edb670fa03077488580c34d529a...255608f085342a0a8c7d0ebb8a49965ce9122109,1,6,4,10,3,2009-12-15 17:57:49,2009-12-15 17:57:49
255608f085342a0a8c7d0ebb8a49965ce9122109...5afff61b027613be4b7f72df61f46406f1678cc0,5,10,9,19,5,2009-12-15 17:58:04,2009-12-15 17:58:04
5afff61b027613be4b7f72df61f46406f1678cc0...11c00d632d5b3cb2fdbece6760c8b221e3c7daff,4,32,32,64,16,2009-12-15 17:58:17,2009-12-15 17:58:17
11c00d632d5b3cb2fdbece6760c8b221e3c7daff...05b4d2f67bc3e75d2d1aada844d6031cc126e48e,18,429,193,622,109,2009-12-16 02:33:33,2009-12-16 02:33:33
05b4d2f67bc3e75d2d1aada844d6031cc126e48e...fc36471d1b9d672bb49714c36d016ac4ebb95ea8,3,32,5,37,8,2009-12-16 07:01:56,2009-12-16 07:01:56
fc36471d1b9d672bb49714c36d016ac4ebb95ea8...f9412b4d210d3f89965d399e62a18804fd759f69,19,421,281,702,164,2009-12-17 15:15:26,2009-12-17 15:15:26
f9412b4d210d3f89965d399e62a18804fd759f69...2a99b2ba5b60d48199733802e0f184418086aab5,6,221,80,301,37,2009-12-17 16:12:06,2009-12-17 16:12:06
2a99b2ba5b60d48199733802e0f184418086aab5...3c8c3bd651c91e2f732b0ba92e14357665606445,3,35,7,42,11,2009-12-17 16:12:23,2009-12-17 16:12:23
3c8c3bd651c91e2f732b0ba92e14357665606445...44f21f2374204cc8a0854b55e555197282c7404d,14,196,127,323,83,2009-12-17 16:12:43,2009-12-17 16:12:43
44f21f2374204cc8a0854b55e555197282c7404d...562c5ffb07c0595da64920024da57760f1ca050d,1,10,8,18,8,2009-12-17 16:12:51,2009-12-17 16:12:51
562c5ffb07c0595da64920024da57760f1ca050d...bdf21ccf8b5aaeb6c2bed3ce8673d7d31c627f8d,8,20,16,36,17,2009-12-17 16:13:07,2009-12-17 16:13:07
bdf21ccf8b5aaeb6c2bed3ce8673d7d31c627f8d...e4dc8be3a9963d55b4f654e31ecce80923508151,1,2,2,4,2,2009-12-17 16:13:17,2009-12-17 16:13:17
e4dc8be3a9963d55b4f654e31ecce80923508151...4eecb92fc40907e73e58c77e74cb1bd852aa22f0,2,15,12,27,13,2009-12-17 16:13:25,2009-12-17 16:13:25
4eecb92fc40907e73e58c77e74cb1bd852aa22f0...c958523121ddf69028f61d2a82357625f7a123c9,3,33,18,51,22,2009-12-17 16:13:36,2009-12-17 16:13:36
c958523121ddf69028f61d2a82357625f7a123c9...d255be26195e57301f2ed7e7670553827f5bbc3c,1,10,2,12,1,2009-12-17 16:13:42,2009-12-17 16:13:42
d255be26195e57301f2ed7e7670553827f5bbc3c...2269813616d7b5f3acd4a2a5a098362a00604937,23,202,87,289,53,2009-12-17 22:07:42,2009-12-17 22:07:42
2269813616d7b5f3acd4a2a5a098362a00604937...601db0d2df9dfdf639b2a32f7cac41a31e6329dc,24,54,48,102,38,2009-12-17 22:18:23,2009-12-17 22:18:23
601db0d2df9dfdf639b2a32f7cac41a31e6329dc...e95bc7b50de02c0f369d66f89a25a75372e4872c,13,78,50,128,39,2009-12-18 01:31:53,2009-12-18 01:31:53
e95bc7b50de02c0f369d66f89a25a75372e4872c...df2746b16cbf4f198927eaa3e3eb89e65f44d053,3,20,0,20,3,2009-12-19 01:11:33,2009-12-19 01:11:33
df2746b16cbf4f198927eaa3e3eb89e65f44d053...42c03cbeae9ba0897cd25d36eca8113954ee1b5f,19,284,15,299,30,2009-12-19 18:03:58,2009-12-19 18:03:58
42c03cbeae9ba0897cd25d36eca8113954ee1b5f...576b641c517a656fb7bd654337ed172504cc8c5f,9,628,23,651,16,2009-12-20 18:27:33,2009-12-20 18:27:33
576b641c517a656fb7bd654337ed172504cc8c5f...8da7538b18bbb7a96a32cd01d71a70ef980308d4,3,3,3,6,3,2009-12-21 02:01:24,2009-12-21 02:01:24
8da7538b18bbb7a96a32cd01d71a70ef980308d4...4424a8d3d8ec0b3e6f7e4b15a0d5fa73b3e7b63f,5,16,4,20,7,2009-12-21 02:38:38,2009-12-21 02:38:38
4424a8d3d8ec0b3e6f7e4b15a0d5fa73b3e7b63f...e4f8015112541be091e52071932508e367f62bd4,2,188,191,379,8,2009-12-21 03:39:00,2009-12-21 03:39:00
e4f8015112541be091e52071932508e367f62bd4...928e1f1f337814f3a442827a3d6370ea1ca7628c,6,39,19,58,19,2009-12-21 19:30:49,2009-12-21 19:30:49
928e1f1f337814f3a442827a3d6370ea1ca7628c...e3d8278553bf389f5503d728ed5d9d2763a30b47,1,1,0,1,1,2009-12-21 19:30:57,2009-12-21 19:30:57
e3d8278553bf389f5503d728ed5d9d2763a30b47...39f69c016e9f70ee6bb584ad1e3f33d3f5de4378,1,107,14,121,9,2009-12-21 19:31:05,2009-12-21 19:31:05
39f69c016e9f70ee6bb584ad1e3f33d3f5de4378...5cf2bede965f826a68743f36dcef16a929ef18e7,1,2,2,4,3,2009-12-21 19:31:13,2009-12-21 19:31:13
5cf2bede965f826a68743f36dcef16a929ef18e7...c3ba4c400dc1204b93024207c6594eef9ade8a58,1,0,3,3,1,2009-12-21 19:31:19,2009-12-21 19:31:19
c3ba4c400dc1204b93024207c6594eef9ade8a58...d5104b63a3f17f4739325dc13b29ce1e6a013ef1,4,30,26,56,14,2009-12-22 06:08:15,2009-12-22 06:08:15
d5104b63a3f17f4739325dc13b29ce1e6a013ef1...c3cc2198e717e84866b884f2f4370d78a9eb2b1a,2,3,3,6,3,2009-12-22 06:26:41,2009-12-22 06:26:41
c3cc2198e717e84866b884f2f4370d78a9eb2b1a...d69142033b142e692081992a40e3dcbeb8de44fd,1,4,4,8,2,2009-12-22 14:36:53,2009-12-22 14:36:53
d69142033b142e692081992a40e3dcbeb8de44fd...c770ae0e8b6ff302931de76beb233d1c8db8ddee,1,68,34,102,9,2009-12-22 14:37:01,2009-12-22 14:37:01
c770ae0e8b6ff302931de76beb233d1c8db8ddee...cac9b38b1a8d79bb962a4412e0d3649650d9e867,1,1,5,6,2,2009-12-22 14:37:09,2009-12-22 14:37:09
cac9b38b1a8d79bb962a4412e0d3649650d9e867...8a20a3e3fcf25c06626a49c275404e69f3964cef,1,18,0,18,6,2009-12-22 14:37:16,2009-12-22 14:37:16
8a20a3e3fcf25c06626a49c275404e69f3964cef...27c43c3acc1ca29ff3d380cd2b5722803648a5dd,3,2,1,3,3,2009-12-22 14:37:26,2009-12-22 14:37:26
27c43c3acc1ca29ff3d380cd2b5722803648a5dd...45b4288bb66a3cda401b45901e85b645674c3988,16,52,57,109,24,2009-12-22 14:37:40,2009-12-22 14:37:40
923c6755c88f19ad7fc0cd74cf818037f85dfb43...88da053e5ed4c0641c942471acbf67b09e488ddd,1,6,2,8,2,2009-07-02 14:02:58,2009-07-02 14:02:58
88da053e5ed4c0641c942471acbf67b09e488ddd...7ecb8b08b3a2f35aa1f3f1d979fa5a44bf2b8a8c,3,151,14,165,14,2009-07-03 03:05:17,2009-07-03 03:05:17
7ecb8b08b3a2f35aa1f3f1d979fa5a44bf2b8a8c...f5ed3f40853553f822ff397ec28c869087c2d00e,2,40,15,55,13,2009-07-03 05:40:46,2009-07-03 05:40:46
f5ed3f40853553f822ff397ec28c869087c2d00e...6ed0345092110906299379ef6f1f9bb22d6f3737,2,32,9,41,11,2009-07-03 05:41:36,2009-07-03 05:41:36
6ed0345092110906299379ef6f1f9bb22d6f3737...037b833f2e445331100b0a6e85d2e589a57d5c94,1,75,6,81,4,2009-07-03 05:42:09,2009-07-03 05:42:09
037b833f2e445331100b0a6e85d2e589a57d5c94...b73319ae7b79504887d823f780187587116e5774,1,1,1,2,1,2009-07-03 07:15:48,2009-07-03 07:15:48
b73319ae7b79504887d823f780187587116e5774...5cef76ffb727d75da9126299a2d66820c109617e,1,23,2,25,2,2009-07-03 07:16:25,2009-07-03 07:16:25
5cef76ffb727d75da9126299a2d66820c109617e...87285078f08f3889cf273c4547022b81cec5733d,1,23,6,29,9,2009-07-03 07:40:45,2009-07-03 07:40:45
87285078f08f3889cf273c4547022b81cec5733d...36954a04b7b6142c8338c6abfcffb67e1ee82aad,2,11,10,21,3,2009-07-03 14:09:04,2009-07-03 14:09:04
36954a04b7b6142c8338c6abfcffb67e1ee82aad...b96e55e811aadda25f190878d5c30d0ac745f810,1,1,1,2,1,2009-07-03 14:10:35,2009-07-03 14:10:35
b96e55e811aadda25f190878d5c30d0ac745f810...a4d8d45117ef8da0ab08cd8bf6c03f21c03118b1,2,321,228,549,193,2009-07-07 13:23:15,2009-07-07 13:23:15
a4d8d45117ef8da0ab08cd8bf6c03f21c03118b1...4532cf69dec504ad1b62c1ff48b011d46e545c8a,2,321,235,556,196,2009-07-07 13:23:40,2009-07-07 13:23:40
4532cf69dec504ad1b62c1ff48b011d46e545c8a...55968a6edd426af1f341ada1b1b954a607d9c09b,2,8,3,11,4,2009-07-09 02:00:40,2009-07-09 02:00:40
55968a6edd426af1f341ada1b1b954a607d9c09b...52bc78262172ad6e8deb3c75bd65edea68924dbc,5,61,14,75,7,2009-07-11 14:22:52,2009-07-11 14:22:52
52bc78262172ad6e8deb3c75bd65edea68924dbc...9515c008bbca1e3881ebeac90d4a5c7a0d558224,1,1,1,2,1,2009-07-11 15:36:31,2009-07-11 15:36:31
9515c008bbca1e3881ebeac90d4a5c7a0d558224...6bf55a1abf5c9e23296bf251409e989c1afcf393,1,2,2,4,2,2009-07-11 15:37:08,2009-07-11 15:37:08
6bf55a1abf5c9e23296bf251409e989c1afcf393...f36b3898ae3d46523ceb227dfc9b1db88b48c3ec,1,7,3,10,4,2009-07-11 15:37:38,2009-07-11 15:37:38
f36b3898ae3d46523ceb227dfc9b1db88b48c3ec...21248111509e94903ff6475b2cc7c87f28dae1a0,1,1,1,2,1,2009-07-11 15:38:08,2009-07-11 15:38:08
21248111509e94903ff6475b2cc7c87f28dae1a0...ebce1b9a2b588b95e56a3719b3ac71a82834965a,1,31,5,36,5,2009-07-11 15:38:47,2009-07-11 15:38:47
ebce1b9a2b588b95e56a3719b3ac71a82834965a...33ea28c2b2e62d492e99258f5eb19683119448d4,2,29,1,30,3,2009-07-11 20:34:27,2009-07-11 20:34:27
e43283d70be93eb3f07dc10dd2f33d0541cda6c9...c65044f9a017133c64d4ff1f67ca3d4221ea2a87,4,14,11,25,9,2009-07-02 04:33:21,2009-07-02 04:33:21
33ea28c2b2e62d492e99258f5eb19683119448d4...e992e57d3e66708015899efd21bb0174377baeed,3,111,17,128,16,2009-07-13 13:46:31,2009-07-13 13:46:31
e992e57d3e66708015899efd21bb0174377baeed...9c5075d1259bba80c846e3ddfd1f2e81c884c801,1,3,0,3,1,2009-07-15 02:20:51,2009-07-15 02:20:51
9c5075d1259bba80c846e3ddfd1f2e81c884c801...b1e645b6cdec97091ddfbe3e47f41879ebd5af7a,1,36,13,49,12,2009-07-15 13:52:39,2009-07-15 13:52:39
b1e645b6cdec97091ddfbe3e47f41879ebd5af7a...e114cbf3de39f07888c15d9b6e40309ad3eb267a,1,1,1,2,1,2009-07-15 13:53:29,2009-07-15 13:53:29
e114cbf3de39f07888c15d9b6e40309ad3eb267a...75514ab7bc3c20fb0b07d7caa0b5cf7b74840778,1,22,21,43,8,2009-07-15 13:54:11,2009-07-15 13:54:11
75514ab7bc3c20fb0b07d7caa0b5cf7b74840778...3c6036a5b4a5c8ef921b71c1752abcda9728afb5,1,4,4,8,2,2009-07-15 13:54:45,2009-07-15 13:54:45
3c6036a5b4a5c8ef921b71c1752abcda9728afb5...5727374d9583ded4c87626a6c48bd669d432182f,1,0,0,0,0,2009-07-15 13:55:50,2009-07-15 13:55:50
5727374d9583ded4c87626a6c48bd669d432182f...6f25903a89d1a333cc169143e3ab5e439fb376c1,1,1,1,2,1,2009-07-15 13:56:50,2009-07-15 13:56:50
6f25903a89d1a333cc169143e3ab5e439fb376c1...93d86479e377eb5a3f3fb8436a1ddcbfb9ad9b7e,1,1,1,2,1,2009-07-15 13:57:46,2009-07-15 13:57:46
93d86479e377eb5a3f3fb8436a1ddcbfb9ad9b7e...49f0a4bb5bb3ef5c22873de799570372dbc1d4e4,1,7,1,8,1,2009-07-16 16:06:53,2009-07-16 16:06:53
49f0a4bb5bb3ef5c22873de799570372dbc1d4e4...9fd19c01611e5ed1ed64bbeb462ab96499d72a6c,1,118,69,187,1,2009-07-16 16:08:18,2009-07-16 16:08:18
9fd19c01611e5ed1ed64bbeb462ab96499d72a6c...8d48eaa064c88533be5082e3f45638fbd48491d8,20,545,120,665,90,2009-07-16 16:16:13,2009-07-16 16:16:13
8d48eaa064c88533be5082e3f45638fbd48491d8...53b8809277c40f5011a16d6e27b221e2f48f7f97,2,25,5,30,11,2009-07-16 22:38:22,2009-07-16 22:38:22
53b8809277c40f5011a16d6e27b221e2f48f7f97...3469f4b819913476c197717221887f71c4a88471,1,2,2,4,1,2009-07-16 23:45:36,2009-07-16 23:45:36
3469f4b819913476c197717221887f71c4a88471...0c9d0bf7d653336c5ee7d15f23adeb098a9f5dba,1,27,17,44,20,2009-07-17 00:55:21,2009-07-17 00:55:21
0c9d0bf7d653336c5ee7d15f23adeb098a9f5dba...260cf2193651f50021b0bf50a96b8da5dab903de,2,14,10,24,3,2009-07-17 16:44:57,2009-07-17 16:44:57
260cf2193651f50021b0bf50a96b8da5dab903de...2fffe390a02ec107e6068ec2aba78248495c4477,2,87,85,172,75,2009-07-17 20:04:03,2009-07-17 20:04:03
2fffe390a02ec107e6068ec2aba78248495c4477...42ff5b3c1206553d82babce0c535ea6d6c20faa0,1,9,9,18,4,2009-07-21 01:48:59,2009-07-21 01:48:59
42ff5b3c1206553d82babce0c535ea6d6c20faa0...bc5a7c0dbd05cf02d89d0f9913856a96e0a56b09,1,2,2,4,2,2009-07-21 01:50:06,2009-07-21 01:50:06
bc5a7c0dbd05cf02d89d0f9913856a96e0a56b09...fb564015960298ab820d7fd1c7edd3e96a8a95f0,4,41,17,58,19,2009-07-21 01:51:40,2009-07-21 01:51:40
fb564015960298ab820d7fd1c7edd3e96a8a95f0...2d781aae5f3dad007c710eb9f6c6cc20a0fc0dac,1,14,4,18,1,2009-07-21 16:45:13,2009-07-21 16:45:13
2d781aae5f3dad007c710eb9f6c6cc20a0fc0dac...bbac0cc965ea90f31a365891d4e21b1bffa58f4a,2,18,3,21,3,2009-07-21 21:20:18,2009-07-21 21:20:18
2511eb2759097be51a3cf255762cbc1dca2f1c08...afa7b39d6ffa7389585cdbeec0c161a061b44961,4,356,12,368,10,2009-07-22 13:12:26,2009-07-22 13:12:26
bbac0cc965ea90f31a365891d4e21b1bffa58f4a...d33386c584bd1606bccbeee092df6292840adde5,2,118,0,118,2,2009-07-22 01:26:47,2009-07-22 01:26:47
d33386c584bd1606bccbeee092df6292840adde5...84d86c07e0a33228e913d1f9429c5aa4763c399d,1,16,22,38,2,2009-07-22 01:41:16,2009-07-22 01:41:16
bf5d010ba11d5de17acdc4f038f643f7c086342f...e9802185b450a0d94d2771f6456ee33f64bf648c,1,19,0,19,1,2009-07-22 13:17:49,2009-07-22 13:17:49
e9802185b450a0d94d2771f6456ee33f64bf648c...6d0668359fc427cc079658ce20a223185d02070a,1,0,19,19,1,2009-07-22 13:17:57,2009-07-22 13:17:57
84d86c07e0a33228e913d1f9429c5aa4763c399d...d65a8e09068d66c8e7debeb0469aedc7bf03af13,1,1,1,2,1,2009-07-22 02:09:01,2009-07-22 02:09:01
d65a8e09068d66c8e7debeb0469aedc7bf03af13...f4cb4ebd3120eadd424e7d071a84568847104c1b,1,2,2,4,2,2009-07-22 02:11:55,2009-07-22 02:11:55
f4cb4ebd3120eadd424e7d071a84568847104c1b...f1c00a232159a4517c0c7f73480d8ed52711181f,8,5499,1040,6539,630,2009-07-23 13:05:43,2009-07-23 13:05:43
f1c00a232159a4517c0c7f73480d8ed52711181f...dbdf65ccf8dc3c1ee44aa2c3e302f6803c67a68b,2,277,684,961,139,2009-07-23 13:07:33,2009-07-23 13:07:33
dbdf65ccf8dc3c1ee44aa2c3e302f6803c67a68b...bdbcb6a4bba31dbb022c568b7c00bdc6098ce3f7,2,1285,914,2199,839,2009-07-23 13:09:28,2009-07-23 13:09:28
bdbcb6a4bba31dbb022c568b7c00bdc6098ce3f7...a2bf2ebbbd4780077791a90276d2303db7243f23,3,659,306,965,267,2009-07-23 13:11:22,2009-07-23 13:11:22
a2bf2ebbbd4780077791a90276d2303db7243f23...e8789de1b42b22fafae6c0af76573f6fa7eaa954,2,111,68,179,70,2009-07-23 13:13:17,2009-07-23 13:13:17
e8789de1b42b22fafae6c0af76573f6fa7eaa954...507e07e58ee9d9c056b30532e9a1146162bb0c2b,4,3712,2130,5842,606,2009-07-23 13:15:30,2009-07-23 13:15:30
507e07e58ee9d9c056b30532e9a1146162bb0c2b...52cb164ffd9976b662f4f5e0cb287201a86d3acf,2,136,91,227,84,2009-07-23 13:17:10,2009-07-23 13:17:10
52cb164ffd9976b662f4f5e0cb287201a86d3acf...d0affb2bbd12828e2db37570234028862d61957e,2,479,255,734,226,2009-07-23 13:18:45,2009-07-23 13:18:45
d0affb2bbd12828e2db37570234028862d61957e...6e2fe421d5fa5ff71dc9cc9997baf0c4a7f86659,4,3532,1488,5020,490,2009-07-23 13:20:25,2009-07-23 13:20:25
6e2fe421d5fa5ff71dc9cc9997baf0c4a7f86659...41852f0bfe233f4a134b240a0a563eaadce82ba6,4,255,175,430,147,2009-07-23 13:22:05,2009-07-23 13:22:05
41852f0bfe233f4a134b240a0a563eaadce82ba6...1f044ed37a05a4d18b291f57b8ecf2bccac4a5df,2,187,140,327,131,2009-07-23 13:23:34,2009-07-23 13:23:34
1f044ed37a05a4d18b291f57b8ecf2bccac4a5df...90d099fc359cd55508922b790c292f1fd90190be,4,104,19,123,14,2009-07-23 13:24:52,2009-07-23 13:24:52
90d099fc359cd55508922b790c292f1fd90190be...7dc35765c74043f9e052c101d478644e5bd12a24,2,728,332,1060,288,2009-07-23 13:25:58,2009-07-23 13:25:58
7dc35765c74043f9e052c101d478644e5bd12a24...92af0734db314805f67430c33106f336a4c0ac48,2,644,276,920,252,2009-07-23 13:27:06,2009-07-23 13:27:06
92af0734db314805f67430c33106f336a4c0ac48...a135608d910d0ec2ed03651908a454aa1ba34b9a,2,93,85,178,77,2009-07-23 13:58:00,2009-07-23 13:58:00
a135608d910d0ec2ed03651908a454aa1ba34b9a...53d16b1175682f1ff97358b67190e4c935372b26,3,16,3,19,4,2009-07-23 14:31:33,2009-07-23 14:31:33
53d16b1175682f1ff97358b67190e4c935372b26...67505210f2fb312089787e2da5753297eb72d6e3,2,2,2,4,2,2009-07-23 14:32:26,2009-07-23 14:32:26
67505210f2fb312089787e2da5753297eb72d6e3...c8f4d37565622ceb4912e343df581e1aa30e8a51,2,104,99,203,86,2009-07-23 15:01:48,2009-07-23 15:01:48
c8f4d37565622ceb4912e343df581e1aa30e8a51...007bfddc1fc4977009e431cf9706408316b682af,2,135,97,232,89,2009-07-23 17:48:00,2009-07-23 17:48:00
007bfddc1fc4977009e431cf9706408316b682af...b2f72fc0405e966a5c4dbce23e84a43d80db3614,3,81,1,82,4,2009-07-24 13:38:36,2009-07-24 13:38:36
b2f72fc0405e966a5c4dbce23e84a43d80db3614...5d57edcbfc5728e1e9409c2fad7c720065a9efef,2,149,104,253,96,2009-07-24 14:18:06,2009-07-24 14:18:06
5d57edcbfc5728e1e9409c2fad7c720065a9efef...4a01812c15eac2b40d8605764be79ba2578113d5,1,3,4,7,2,2009-07-25 05:14:46,2009-07-25 05:14:46
4a01812c15eac2b40d8605764be79ba2578113d5...a69a95b2a499305f7b9c2162b09f6b4405c3b657,2,123,121,244,117,2009-07-25 05:28:42,2009-07-25 05:28:42
a69a95b2a499305f7b9c2162b09f6b4405c3b657...e3410b4ecdd6d3a00cb80ea759d490e200be1db8,2,186,143,329,131,2009-07-25 05:29:41,2009-07-25 05:29:41
e3410b4ecdd6d3a00cb80ea759d490e200be1db8...be9a8fb851966c60104a8ea2b364febbc51e8ae3,1,230,154,384,138,2009-07-26 15:49:21,2009-07-26 15:49:21
be9a8fb851966c60104a8ea2b364febbc51e8ae3...a25dde222c5f0687a004eccef09f0485ff154f0c,4,49,46,95,43,2009-07-26 16:52:22,2009-07-26 16:52:22
a25dde222c5f0687a004eccef09f0485ff154f0c...28c6aee04306531c8014358dc024bb53623799b0,4,32,58,90,28,2009-07-26 17:26:43,2009-07-26 17:26:43
28c6aee04306531c8014358dc024bb53623799b0...6644ef72c8a7002791fc6c28945d27d3c8a754be,1,1,1,2,1,2009-07-27 01:52:23,2009-07-27 01:52:23
6644ef72c8a7002791fc6c28945d27d3c8a754be...1707304bad6f9205a026e16323158bd7ea940111,4,57,26,83,21,2009-07-27 04:21:31,2009-07-27 04:21:31
1707304bad6f9205a026e16323158bd7ea940111...e00150af15f35b68d30fc1f7970384d10d1d6ff1,2,10,10,20,9,2009-07-27 09:11:41,2009-07-27 09:11:41
e00150af15f35b68d30fc1f7970384d10d1d6ff1...3412860f89a1f72257037c19c06beebc92dd7e06,3,30,7,37,9,2009-07-27 14:32:30,2009-07-27 14:32:30
3412860f89a1f72257037c19c06beebc92dd7e06...870828078337a6d218c084405d7d32de12a84982,1,2,2,4,1,2009-07-28 14:38:11,2009-07-28 14:38:11
870828078337a6d218c084405d7d32de12a84982...bbd2953a8aef6360ede1a83949cc1e719eed1cb2,2,477,662,1139,233,2009-07-28 14:39:11,2009-07-28 14:39:11
bbd2953a8aef6360ede1a83949cc1e719eed1cb2...a403a64acca618eeee196f5fcc554517f60f419b,4,210,212,422,205,2009-07-28 14:40:19,2009-07-28 14:40:19
a403a64acca618eeee196f5fcc554517f60f419b...d1cb1eb79eca6cbee8dcd5cb735f7a96370c12ec,2,20,20,40,20,2009-07-29 00:25:06,2009-07-29 00:25:06
d1cb1eb79eca6cbee8dcd5cb735f7a96370c12ec...8bee4604a1be8ca3f051fcec57296308271836be,5,94,7,101,8,2009-07-29 02:40:14,2009-07-29 02:40:14
8bee4604a1be8ca3f051fcec57296308271836be...31f2b85bcba766e7c48fd0fd6f4a702fed7bb0ff,0,0,0,0,0,2009-07-29 02:53:47,2009-07-29 02:53:47
31f2b85bcba766e7c48fd0fd6f4a702fed7bb0ff...1349c7bd62e9a2447e7689d28f83f13d046e8d05,1,1,2,3,2,2009-07-29 04:10:05,2009-07-29 04:10:05
1349c7bd62e9a2447e7689d28f83f13d046e8d05...91f18400cc0fb37659e2dbaab5484ff2081f1f30,2,457,0,457,2,2009-07-29 05:31:00,2009-07-29 05:31:00
91f18400cc0fb37659e2dbaab5484ff2081f1f30...d78cf61c992079a04892abe27c439431e4ef633b,2,20,31,51,4,2009-07-29 05:35:51,2009-07-29 05:35:51
d78cf61c992079a04892abe27c439431e4ef633b...27358368879cc7d56756f12155393d3277fc52aa,2,3,3,6,3,2009-07-29 05:51:03,2009-07-29 05:51:03
27358368879cc7d56756f12155393d3277fc52aa...542c33eec88e4ab5e74db73ac85646f99b075ba3,1,3,0,3,1,2009-07-29 05:52:06,2009-07-29 05:52:06
542c33eec88e4ab5e74db73ac85646f99b075ba3...70b3b68c06b5a3ef55e12d2a0b8dbbd07ef55c2b,1,1,1,2,1,2009-07-30 19:57:49,2009-07-30 19:57:49
70b3b68c06b5a3ef55e12d2a0b8dbbd07ef55c2b...10d7e0e4b8b0a57cd658edfc15c9e068030e0548,1,0,1,1,1,2009-07-31 01:37:48,2009-07-31 01:37:48
10d7e0e4b8b0a57cd658edfc15c9e068030e0548...7ac1d98e1cf740fd93103956104a16e1888d4996,1,9,7,16,3,2009-08-03 08:30:03,2009-08-03 08:30:03
7ac1d98e1cf740fd93103956104a16e1888d4996...cb5e5dc2bc232905c03deea6bc453a2e9a2338f1,1,1,0,1,1,2009-08-03 21:16:54,2009-08-03 21:16:54
cb5e5dc2bc232905c03deea6bc453a2e9a2338f1...34b4d1ef431eed1ef4368958516dc7659108fde1,1,2,2,4,2,2009-08-08 02:56:19,2009-08-08 02:56:19
34b4d1ef431eed1ef4368958516dc7659108fde1...e6e96d871dd76a862451fd081d77d2ed0f09eb45,1,1,1,2,1,2009-08-09 15:44:09,2009-08-09 15:44:09
e6e96d871dd76a862451fd081d77d2ed0f09eb45...c8517025af631ef905b7e3c7169383c4c8650233,2,2,2,4,2,2009-08-13 16:53:19,2009-08-13 16:53:19
c8517025af631ef905b7e3c7169383c4c8650233...b82ad10f9d20643e8c1372210cf5c279402789cc,1,1,1,2,1,2009-08-13 16:59:59,2009-08-13 16:59:59
b82ad10f9d20643e8c1372210cf5c279402789cc...ab6d6896c47e80307af8e2ed676d75a238861e1d,1,1,1,2,1,2009-08-13 17:04:42,2009-08-13 17:04:42
ab6d6896c47e80307af8e2ed676d75a238861e1d...eaf1f7d6e3a0cb700895e9986a246c03243c65b7,1,2,2,4,2,2009-08-13 17:16:29,2009-08-13 17:16:29
eaf1f7d6e3a0cb700895e9986a246c03243c65b7...5eda3a16dfa6b40907a9edfad4ed9e3d3fdaeb1c,2,260,1,261,2,2009-08-17 10:23:43,2009-08-17 10:23:43
5eda3a16dfa6b40907a9edfad4ed9e3d3fdaeb1c...150ef1adeeba3f46e0cf426c42ab1fc71a07d80b,1,4,4,8,1,2009-08-17 10:51:35,2009-08-17 10:51:35
150ef1adeeba3f46e0cf426c42ab1fc71a07d80b...e0ce9d76e1a4b74db93c106f8267339af5f9d73e,1,3,0,3,1,2009-08-20 16:05:25,2009-08-20 16:05:25
e0ce9d76e1a4b74db93c106f8267339af5f9d73e...e263cc0dc53577d525aad0546fc1bd5939dc2e0b,5,23,7,30,9,2009-08-21 21:42:39,2009-08-21 21:42:39
e263cc0dc53577d525aad0546fc1bd5939dc2e0b...dcf3be7a621f011a918453527406216a738acf68,3,23,9,32,11,2009-08-24 15:45:48,2009-08-24 15:45:48
dcf3be7a621f011a918453527406216a738acf68...bb9cc01b132dbde2461191dbb1035eaae4885051,1,15,0,15,2,2009-08-29 12:40:47,2009-08-29 12:40:47
bb9cc01b132dbde2461191dbb1035eaae4885051...4a5630fe75ac47556c7fd15adfa6a7d9c23d18c8,1,0,4,4,2,2009-09-10 09:51:27,2009-09-10 09:51:27
4a5630fe75ac47556c7fd15adfa6a7d9c23d18c8...4b82421a8503788b8a9ea517525ca3fc44de2e55,1,10,1,11,2,2009-09-10 11:08:16,2009-09-10 11:08:16
4b82421a8503788b8a9ea517525ca3fc44de2e55...95393aedc989882190d7f3f4c7afee8e4dc604d3,1,3,1,4,1,2009-09-10 15:06:04,2009-09-10 15:06:04
95393aedc989882190d7f3f4c7afee8e4dc604d3...de5e768557db107106bc3cfc6106055e6af842cb,1,2,2,4,2,2009-09-10 15:21:16,2009-09-10 15:21:16
de5e768557db107106bc3cfc6106055e6af842cb...bdde46de63bdaa5662a70982059dab54921a76c1,1,0,1,1,1,2009-09-10 15:27:44,2009-09-10 15:27:44
bdde46de63bdaa5662a70982059dab54921a76c1...976b18a494e4419075d1c18123d4da687c15b1d5,1,1,1,2,1,2009-09-10 15:36:33,2009-09-10 15:36:33
976b18a494e4419075d1c18123d4da687c15b1d5...404a82e156ead0299de1fe9e333f7ef33dcd6954,1,7,4,11,2,2009-09-10 15:41:00,2009-09-10 15:41:00
404a82e156ead0299de1fe9e333f7ef33dcd6954...1387b17026abf1fc6b3edbe8febef448a5cbc382,1,10,0,10,1,2009-09-10 15:45:15,2009-09-10 15:45:15
1387b17026abf1fc6b3edbe8febef448a5cbc382...18a67e1069fa9c415192b7ce2c14b90d0285e281,1,2,1,3,2,2009-09-10 16:12:08,2009-09-10 16:12:08
18a67e1069fa9c415192b7ce2c14b90d0285e281...49b9470dca446c5bee6518310a9739aa424edcd3,1,1,10,11,1,2009-09-10 16:17:56,2009-09-10 16:17:56
49b9470dca446c5bee6518310a9739aa424edcd3...d18dace8ebe81e856e4a1e05c9d149a6c14aea5f,1,4,2,6,3,2009-09-10 16:30:41,2009-09-10 16:30:41
d18dace8ebe81e856e4a1e05c9d149a6c14aea5f...a2b46ca5fde802616ac0ee42798c0c94206e0c0d,1,1,1,2,1,2009-09-10 16:35:23,2009-09-10 16:35:23
a2b46ca5fde802616ac0ee42798c0c94206e0c0d...84ef9dabfab371a1e0f14a846a509e045369280d,2,12,1,13,3,2009-09-10 16:50:57,2009-09-10 16:50:57
84ef9dabfab371a1e0f14a846a509e045369280d...9d1a7c203ce8f24aa1aa255ccdec3ace194012c6,1,2,1,3,1,2009-09-10 22:23:24,2009-09-10 22:23:24
9d1a7c203ce8f24aa1aa255ccdec3ace194012c6...c33355d86aaf96faba44febb02395d8d12c9cd5b,1,1,2,3,1,2009-09-10 22:49:05,2009-09-10 22:49:05
c33355d86aaf96faba44febb02395d8d12c9cd5b...49cf7f4a5108431f4bcc4ea69c40a69e9379b3b5,1,0,1,1,1,2009-09-11 09:08:07,2009-09-11 09:08:07
49cf7f4a5108431f4bcc4ea69c40a69e9379b3b5...4decf03f9ceb0162a7de757cdb3985100faf028b,2,3,2,5,3,2009-09-11 09:42:17,2009-09-11 09:42:17
4decf03f9ceb0162a7de757cdb3985100faf028b...7c53c2618d7dd9f04f309d195835e6abfc7e0e52,2,40,2,42,3,2009-09-11 10:47:40,2009-09-11 10:47:40
7c53c2618d7dd9f04f309d195835e6abfc7e0e52...8da58e51ff117ffe209cefbd3a5f008dd163bec4,1,8,8,16,5,2009-09-11 13:46:56,2009-09-11 13:46:56
8da58e51ff117ffe209cefbd3a5f008dd163bec4...a53601c6748cf98c777f156068c0290b2943287f,1,6,8,14,2,2009-09-11 21:59:29,2009-09-11 21:59:29
a53601c6748cf98c777f156068c0290b2943287f...677ddcbb04b85541f7b39b95541f5b46817ea510,3,82,130,212,6,2009-09-11 23:15:59,2009-09-11 23:15:59
677ddcbb04b85541f7b39b95541f5b46817ea510...1aef132090f5717add930e5e5da2287235b85b68,2,13,1,14,4,2009-09-12 18:35:08,2009-09-12 18:35:08
1aef132090f5717add930e5e5da2287235b85b68...d2321e37eb149fdd20c5332ac8b648b3244e0b39,2,4,3,7,3,2009-09-12 21:28:01,2009-09-12 21:28:01
d2321e37eb149fdd20c5332ac8b648b3244e0b39...15f36107473156dd58e6061ded4f0f49dff338b4,1,1,1,2,1,2009-09-12 22:32:07,2009-09-12 22:32:07
15f36107473156dd58e6061ded4f0f49dff338b4...1ed9d29db8c331f31e7bb21ccaf81aba7aa307c0,1,1,1,2,1,2009-09-12 22:41:12,2009-09-12 22:41:12
1ed9d29db8c331f31e7bb21ccaf81aba7aa307c0...fc7ef1c86c0b7345892f59f582fa268a66a24d62,1,25,25,50,24,2009-09-12 22:43:20,2009-09-12 22:43:20
fc7ef1c86c0b7345892f59f582fa268a66a24d62...94885bac7bbb74d0092163f91e79af04bbce92d6,1,1,1,2,1,2009-09-12 22:44:51,2009-09-12 22:44:51
94885bac7bbb74d0092163f91e79af04bbce92d6...94d8da31da655b2ea70d6484d9768097396bc9b9,1,1,1,2,1,2009-09-12 22:48:20,2009-09-12 22:48:20
94d8da31da655b2ea70d6484d9768097396bc9b9...baf7d3e07431a0ed47d8232d9d2597c57e947a24,1,2,2,4,2,2009-09-12 22:51:16,2009-09-12 22:51:16
baf7d3e07431a0ed47d8232d9d2597c57e947a24...b8b9411ffc71d121730fdd60bc15736bcab558db,1,24,24,48,22,2009-09-12 22:52:25,2009-09-12 22:52:25
b8b9411ffc71d121730fdd60bc15736bcab558db...77c64c69cfacec6bbccedcad9ba23cd1c666e69a,1,1,2,3,1,2009-09-12 22:57:58,2009-09-12 22:57:58
77c64c69cfacec6bbccedcad9ba23cd1c666e69a...9aef7dd9e7efc217e769247f246c1384cacc0869,1,1,1,2,1,2009-09-12 22:59:41,2009-09-12 22:59:41
9aef7dd9e7efc217e769247f246c1384cacc0869...7cbc2329098a0b179ffd0e48780561f2d4cda369,1,15,12,27,10,2009-09-12 23:06:22,2009-09-12 23:06:22
7cbc2329098a0b179ffd0e48780561f2d4cda369...423b5c1e143a37f4e68ae6c3b761cfd45b83ae5b,1,4,3,7,1,2009-09-12 23:36:00,2009-09-12 23:36:00
423b5c1e143a37f4e68ae6c3b761cfd45b83ae5b...27c68216c2e34a5660aaf8b7d6b21ecda86de23c,1,1,0,1,1,2009-09-12 23:37:19,2009-09-12 23:37:19
27c68216c2e34a5660aaf8b7d6b21ecda86de23c...ec6b9d6e63cc352052e6a4c4d36d67f6656c43b7,1,10,5,15,5,2009-09-12 23:56:45,2009-09-12 23:56:45
ec6b9d6e63cc352052e6a4c4d36d67f6656c43b7...7dfd7cb83694bdefd53fcfd30258272bd63a23e0,1,16,14,30,13,2009-09-13 00:12:26,2009-09-13 00:12:26
7dfd7cb83694bdefd53fcfd30258272bd63a23e0...8b6a2c11e4cbe257f196a0288574c45623199132,1,14,0,14,1,2009-09-13 00:17:35,2009-09-13 00:17:35
8b6a2c11e4cbe257f196a0288574c45623199132...d0c6e9cf63f2a96d0abe58d392a6085f4da85d7b,1,1,1,2,1,2009-09-13 00:25:53,2009-09-13 00:25:53
d0c6e9cf63f2a96d0abe58d392a6085f4da85d7b...0e07f80cf4cf05bbb14fa18cc0013f3cd66687f8,1,7,6,13,3,2009-09-13 01:13:40,2009-09-13 01:13:40
0e07f80cf4cf05bbb14fa18cc0013f3cd66687f8...38e78da95efbef2689c7409c53cebbd6a0f3e41a,1,29,0,29,1,2009-09-13 01:35:18,2009-09-13 01:35:18
38e78da95efbef2689c7409c53cebbd6a0f3e41a...f8077919b5b4c13f15a2e47a7fb657ac81685302,1,11,5,16,5,2009-09-13 03:01:04,2009-09-13 03:01:04
f8077919b5b4c13f15a2e47a7fb657ac81685302...7ae2f7072281096300478e5e0c16e9f3375899df,2,1,1,2,1,2009-09-13 03:09:35,2009-09-13 03:09:35
7ae2f7072281096300478e5e0c16e9f3375899df...07576072172e83f2634e52ec81aa65d07ae4604b,2,2,3,5,3,2009-09-13 04:32:55,2009-09-13 04:32:55
07576072172e83f2634e52ec81aa65d07ae4604b...85d4baae395e135bd75911af97cc816882599971,1,1,1,2,1,2009-09-13 04:40:17,2009-09-13 04:40:17
85d4baae395e135bd75911af97cc816882599971...dbd6f512eea610a2f88987403c60e610e3916a22,1,1,1,2,1,2009-09-13 06:18:16,2009-09-13 06:18:16
dbd6f512eea610a2f88987403c60e610e3916a22...62180a6b44ca8e7d79fbba337832c277e3fc552d,2,26,11,37,8,2009-09-13 17:40:46,2009-09-13 17:40:46
62180a6b44ca8e7d79fbba337832c277e3fc552d...95d5e450ec251750a87abf46364cd75d35c2528c,1,1,1,2,1,2009-09-14 22:36:20,2009-09-14 22:36:20
95d5e450ec251750a87abf46364cd75d35c2528c...f3af2d98830923ce3bb775e46ff336a159d211cb,1,4,4,8,2,2009-09-14 22:49:03,2009-09-14 22:49:03
f3af2d98830923ce3bb775e46ff336a159d211cb...d56c1ab7f07eeaae3a0fc996169be7cae6a94bf4,2,11,1,12,2,2009-09-16 12:09:47,2009-09-16 12:09:47
d56c1ab7f07eeaae3a0fc996169be7cae6a94bf4...afeafcd492eec9f9cb333c8c55502c1c50b3b151,3,156,54,210,13,2009-09-21 22:31:51,2009-09-21 22:31:51
afeafcd492eec9f9cb333c8c55502c1c50b3b151...af02f38e0234a4a095ed32bb0f5b0cbf594d423b,1,16,48,64,5,2009-09-21 22:34:45,2009-09-21 22:34:45
af02f38e0234a4a095ed32bb0f5b0cbf594d423b...724c926b823e2f0f8605e41e8d9763443975c81b,1,1,1,2,1,2009-09-22 21:20:51,2009-09-22 21:20:51
724c926b823e2f0f8605e41e8d9763443975c81b...0a7dc8d59087550c17ec5b9652fdea1a8b9b67b9,1,1,1,2,1,2009-09-22 21:21:51,2009-09-22 21:21:51
0a7dc8d59087550c17ec5b9652fdea1a8b9b67b9...4a2a0b0e21a7f6ae55d0bc70c8cabf047debc927,2,3,1,4,2,2009-09-23 23:40:12,2009-09-23 23:40:12
4a2a0b0e21a7f6ae55d0bc70c8cabf047debc927...d6c2286712c141252537fd8b2695660127b9bba7,1,6,1,7,4,2009-09-23 23:47:53,2009-09-23 23:47:53
d6c2286712c141252537fd8b2695660127b9bba7...a97648a7e03fb95b09e888e5d59d82d57fb289b7,2,11,7,18,6,2009-09-26 19:39:42,2009-09-26 19:39:42
a97648a7e03fb95b09e888e5d59d82d57fb289b7...6e3a72585a727d46ea03871f14a9a2f0f15fbf93,3,25,4,29,9,2009-09-28 21:54:54,2009-09-28 21:54:54
6e3a72585a727d46ea03871f14a9a2f0f15fbf93...055efb25308feac83f5488b5abc8f5436434fc66,1,11,0,11,1,2009-09-28 21:58:21,2009-09-28 21:58:21
055efb25308feac83f5488b5abc8f5436434fc66...ca9d0136df5206a6c988e2826fa0938449363a3d,1,5,5,10,4,2009-09-30 06:40:34,2009-09-30 06:40:34
ca9d0136df5206a6c988e2826fa0938449363a3d...175ab92d6b96f430d3a38fadac6e4cab2a34c053,1,4,6,10,2,2009-10-01 16:15:27,2009-10-01 16:15:27
175ab92d6b96f430d3a38fadac6e4cab2a34c053...8aee95ca3ef731672bef7c56a512ca2f35701864,1,1,0,1,1,2009-10-08 13:30:31,2009-10-08 13:30:31
8aee95ca3ef731672bef7c56a512ca2f35701864...9f8287a3f145fe5cbe71ef5573ea8898404727ad,2,35,2,37,4,2009-10-09 20:57:59,2009-10-09 20:57:59
9f8287a3f145fe5cbe71ef5573ea8898404727ad...c46ddbf1fc747a910702a348763d7949fba454f0,2,29,11,40,12,2009-10-12 15:32:24,2009-10-12 15:32:24
c46ddbf1fc747a910702a348763d7949fba454f0...b30cba4e2bd764cd4f1ec5c0ae1664a078ce967b,1,1,1,2,1,2009-10-12 16:53:23,2009-10-12 16:53:23
b30cba4e2bd764cd4f1ec5c0ae1664a078ce967b...f14833ee67f535d66ce48155d5424024927bfe2d,4,24,14,38,8,2009-10-14 13:38:31,2009-10-14 13:38:31
f14833ee67f535d66ce48155d5424024927bfe2d...c161bf21f0ab9f2945ae7a44e5757b071f7eb712,12,145,14,159,19,2009-10-14 18:09:13,2009-10-14 18:09:13
c161bf21f0ab9f2945ae7a44e5757b071f7eb712...a2d8acbacda353248fd191b97155cd4cf27dcd66,6,35,26,61,9,2009-10-15 14:12:34,2009-10-15 14:12:34
a2d8acbacda353248fd191b97155cd4cf27dcd66...e5ab340d17bdd7f17e40f7a4bda755e2e1881414,1,13,0,13,1,2009-10-15 20:25:20,2009-10-15 20:25:20
e5ab340d17bdd7f17e40f7a4bda755e2e1881414...69535b7b1383c6d74fac4f5a1b1a89c2c9956e23,3,51,17,68,19,2009-10-17 17:32:25,2009-10-17 17:32:25
69535b7b1383c6d74fac4f5a1b1a89c2c9956e23...5fc35c9caf73a038607c53393aff797f6e8e395a,2,23,2,25,6,2009-10-19 19:17:07,2009-10-19 19:17:07
5fc35c9caf73a038607c53393aff797f6e8e395a...cb7a3262b5be1d9093a694b1619df6c4cdff0035,2,23,5,28,5,2009-10-19 19:17:20,2009-10-19 19:17:20
cb7a3262b5be1d9093a694b1619df6c4cdff0035...22be3d7612b518268b84ce37d3b20f828efb4b6f,2,33,0,33,4,2009-10-19 21:13:22,2009-10-19 21:13:22
22be3d7612b518268b84ce37d3b20f828efb4b6f...c6e8e5d9f068210d25f501b2aae4192d1c01185c,4,39,11,50,7,2009-10-19 21:48:06,2009-10-19 21:48:06
c6e8e5d9f068210d25f501b2aae4192d1c01185c...162fade2b70d56ee5cbc3a57d1863f3c989775d6,3,109,3,112,10,2009-10-20 14:11:08,2009-10-20 14:11:08
162fade2b70d56ee5cbc3a57d1863f3c989775d6...8be1bb2268b09e5ea33ccf07d602feed8b075146,6,131,211,342,23,2009-10-23 19:22:31,2009-10-23 19:22:31
8be1bb2268b09e5ea33ccf07d602feed8b075146...7098664940567c772a45ad98f9ee936063a1102e,6,15,29,44,11,2009-10-23 19:30:23,2009-10-23 19:30:23
7098664940567c772a45ad98f9ee936063a1102e...7770c70007b3d402b5cf7f4f2cbe74aed11be98f,1,4,4,8,1,2009-10-23 19:43:58,2009-10-23 19:43:58
7770c70007b3d402b5cf7f4f2cbe74aed11be98f...fa6ca072a3278f951ec8132b2ab7f516234ca0d7,1,19,21,40,2,2009-10-23 19:52:15,2009-10-23 19:52:15
fa6ca072a3278f951ec8132b2ab7f516234ca0d7...0d1177ae99a493272b2ef6982e4adc7141f15f72,1,3,2,5,2,2009-10-23 20:47:29,2009-10-23 20:47:29
0d1177ae99a493272b2ef6982e4adc7141f15f72...9f70783b149105dfd37027504976f9526caeeae0,2,13,5,18,4,2009-10-24 00:23:47,2009-10-24 00:23:47
9f70783b149105dfd37027504976f9526caeeae0...b79702b2deec4ca3c625e5bffe46fa976c3c4e5f,6,31,28,59,16,2009-10-24 00:28:39,2009-10-24 00:28:39
b79702b2deec4ca3c625e5bffe46fa976c3c4e5f...2b2f92ae8ebd47978c132c403d8c6b617f497fb4,2,9,1,10,3,2009-10-24 00:37:01,2009-10-24 00:37:01
2b2f92ae8ebd47978c132c403d8c6b617f497fb4...c44fdf6a1ec2e9777948e193b9830679a19178eb,1,3,0,3,1,2009-10-24 10:13:24,2009-10-24 10:13:24
c44fdf6a1ec2e9777948e193b9830679a19178eb...a02a6fab66afc9462c79cc4914f4624b640165f4,2,13,7,20,2,2009-10-24 10:45:58,2009-10-24 10:45:58
a02a6fab66afc9462c79cc4914f4624b640165f4...92090253fe743830e9391095f552af0724a40ca7,1,1,1,2,1,2009-10-24 14:10:00,2009-10-24 14:10:00
92090253fe743830e9391095f552af0724a40ca7...c54b8ec2f5122ae13bcb4e1d00d8e8f6bcacf2cf,1,2,1,3,1,2009-10-25 16:32:07,2009-10-25 16:32:07
c54b8ec2f5122ae13bcb4e1d00d8e8f6bcacf2cf...e32b042d6b623e4b476dbab2523795eaa9faf379,2,122,101,223,70,2009-10-25 20:09:49,2009-10-25 20:09:49
e32b042d6b623e4b476dbab2523795eaa9faf379...d1da26141788f8b359d96c49bc596125598d23ee,2,24,1,25,3,2009-10-26 15:02:54,2009-10-26 15:02:54
d1da26141788f8b359d96c49bc596125598d23ee...8e70cef9b67433edd70935dcc30c621d1e7fc0a0,47,1427,234,1661,164,2009-10-26 23:23:07,2009-10-26 23:23:07
8e70cef9b67433edd70935dcc30c621d1e7fc0a0...7230a995ce81a7b8dd093bd03cc5ebd34106ee80,26,394,355,749,40,2009-10-27 00:36:34,2009-10-27 00:36:34
7230a995ce81a7b8dd093bd03cc5ebd34106ee80...64b4ab18b47354fbd28fa93a1bc770728c596aac,1,1,1,2,2,2009-10-27 00:43:16,2009-10-27 00:43:16
64b4ab18b47354fbd28fa93a1bc770728c596aac...c2ffe94d9a3e2857bdbd017d61ef5f42a3419bd7,1,0,4,4,1,2009-10-27 00:49:33,2009-10-27 00:49:33
c2ffe94d9a3e2857bdbd017d61ef5f42a3419bd7...2ddf1364c401d5cc80b31b43567500f9aeb9414b,1,7,0,7,3,2009-10-27 01:10:20,2009-10-27 01:10:20
2ddf1364c401d5cc80b31b43567500f9aeb9414b...f6ef3fd94197b7b427fba5a01c3daa5531deb211,1,1,1,2,1,2009-10-27 10:46:04,2009-10-27 10:46:04
f6ef3fd94197b7b427fba5a01c3daa5531deb211...f00ad4168e6c435a2f3691854d3a4a3f78192600,2,11,2,13,3,2009-10-27 12:11:56,2009-10-27 12:11:56
f00ad4168e6c435a2f3691854d3a4a3f78192600...b32a187296fa856076652bc42dbf89e36c5c6dcf,1,2,2,4,2,2009-10-27 13:13:40,2009-10-27 13:13:40
b32a187296fa856076652bc42dbf89e36c5c6dcf...d0b900e6f52e3d16d32ae42a1f80ee61b256db18,1,6,2,8,2,2009-10-27 14:04:21,2009-10-27 14:04:21
d0b900e6f52e3d16d32ae42a1f80ee61b256db18...4281bf3db058ed9ed860dd2f33a3de22d34dfa5f,3,16,1,17,3,2009-10-27 20:56:12,2009-10-27 20:56:12
4281bf3db058ed9ed860dd2f33a3de22d34dfa5f...43c2ed0eb3f9996539f03e4ad68a08534023659a,1,8,2,10,1,2009-10-27 21:27:09,2009-10-27 21:27:09
43c2ed0eb3f9996539f03e4ad68a08534023659a...905dba3694efa20de061d5350cd7de08ed0e5f46,1,9,6,15,4,2009-10-27 21:31:20,2009-10-27 21:31:20
905dba3694efa20de061d5350cd7de08ed0e5f46...9dc9770736ddf236be5ae08447bb323433fffd44,2,10,4,14,4,2009-10-27 21:52:25,2009-10-27 21:52:25
9dc9770736ddf236be5ae08447bb323433fffd44...5df19aa99e0ae5753be19d9ead887c8ad5ee54c8,1,2,0,2,1,2009-10-27 22:20:03,2009-10-27 22:20:03
5df19aa99e0ae5753be19d9ead887c8ad5ee54c8...e6f0c10e77223156d1a804609e3b14704bba0947,1,1,1,2,1,2009-10-27 22:26:54,2009-10-27 22:26:54
e6f0c10e77223156d1a804609e3b14704bba0947...7440fca145adbc3fb3ee95037a7c5d4e57683cd7,2,13,2,15,4,2009-10-28 10:01:16,2009-10-28 10:01:16
7440fca145adbc3fb3ee95037a7c5d4e57683cd7...c5c7791e91649a82346e720c86a7a1fa77eb4cd5,1,4,4,8,2,2009-10-29 14:17:39,2009-10-29 14:17:39
c5c7791e91649a82346e720c86a7a1fa77eb4cd5...96658ef2d24bd05c75aa98c5318d49f7e26549e7,4,64,3,67,7,2009-10-29 14:32:01,2009-10-29 14:32:01
96658ef2d24bd05c75aa98c5318d49f7e26549e7...5a0aab41ee4de9e465164d3fbba9336c1fefa5ec,2,5,3,8,3,2009-10-30 00:17:29,2009-10-30 00:17:29
5a0aab41ee4de9e465164d3fbba9336c1fefa5ec...120ea2a4b8ffe46b55bdad65ac1e40ede6599f09,1,2,8,10,5,2009-10-30 08:24:05,2009-10-30 08:24:05
120ea2a4b8ffe46b55bdad65ac1e40ede6599f09...8812060d77199c8710bd885f8d6d38bcb46112f0,1,1,1,2,1,2009-10-30 08:48:48,2009-10-30 08:48:48
8812060d77199c8710bd885f8d6d38bcb46112f0...8dd4a28721918ee0f42f6698b2c7403f75b25646,2,11,1,12,2,2009-10-30 09:11:56,2009-10-30 09:11:56
8dd4a28721918ee0f42f6698b2c7403f75b25646...08d521efa0de350991a3e72736b0490d747ccc05,1,17,12,29,2,2009-11-01 03:04:20,2009-11-01 03:04:20
08d521efa0de350991a3e72736b0490d747ccc05...acfa9332de6c7501110b196fb3117e1e65aaf779,1,77,84,161,5,2009-11-01 04:20:17,2009-11-01 04:20:17
acfa9332de6c7501110b196fb3117e1e65aaf779...e18af06eed4c6ad6266766810e4613e4d2700dbb,2,38,43,81,9,2009-11-01 04:53:51,2009-11-01 04:53:51
e18af06eed4c6ad6266766810e4613e4d2700dbb...ff38e0b1d1edabbb167d2e65ef23c8a2e5c6faea,1,2,2,4,2,2009-11-01 22:12:40,2009-11-01 22:12:40
ff38e0b1d1edabbb167d2e65ef23c8a2e5c6faea...d4bb582b1a11edb28ab239fe1b7c6104d24a8e73,1,5,2,7,2,2009-11-01 23:09:23,2009-11-01 23:09:23
d4bb582b1a11edb28ab239fe1b7c6104d24a8e73...1ea08b441d5517573aee6547a06b7d64e7a0d8b3,1,6,3,9,3,2009-11-01 23:48:31,2009-11-01 23:48:31
1ea08b441d5517573aee6547a06b7d64e7a0d8b3...be89c9ababd85ec25606b39b408a2ab7ee6da357,4,51,6,57,7,2009-11-02 02:17:56,2009-11-02 02:17:56
be89c9ababd85ec25606b39b408a2ab7ee6da357...5dfed1b24a0a68aab25c10ca9e69072188baa3c9,2,13,17,30,5,2009-11-02 08:26:03,2009-11-02 08:26:03
5dfed1b24a0a68aab25c10ca9e69072188baa3c9...8287c27b1895ba56c6680295ff3d202fc7a4b64e,1,6,2,8,3,2009-11-03 06:16:09,2009-11-03 06:16:09
8287c27b1895ba56c6680295ff3d202fc7a4b64e...aba5389326372be43b2a3bdcda16646fd197e807,19,1011,287,1298,79,2009-11-03 12:53:26,2009-11-03 12:53:26
aba5389326372be43b2a3bdcda16646fd197e807...585b7acaa359fc1df07269c1a4b4756bdb6703f7,20,459,246,705,99,2009-11-03 14:02:49,2009-11-03 14:02:49
585b7acaa359fc1df07269c1a4b4756bdb6703f7...53b2c3867b5720b2586f5b63978ca2835e7dfb5d,3,43,3,46,5,2009-11-03 14:40:37,2009-11-03 14:40:37
53b2c3867b5720b2586f5b63978ca2835e7dfb5d...dab3e97c1a83a4c5482f50a671cbf2fc5e16c9ee,2,62,7,69,3,2009-11-03 15:02:16,2009-11-03 15:02:16
dab3e97c1a83a4c5482f50a671cbf2fc5e16c9ee...f9ead3fe4276597e7ed69e4b2658040b21df5c76,1,1,1,2,1,2009-11-03 23:34:58,2009-11-03 23:34:58
f9ead3fe4276597e7ed69e4b2658040b21df5c76...77b602a4ab55a655a0a50dbd8fe130f0952848c4,1,4,1,5,1,2009-11-04 01:59:05,2009-11-04 01:59:05
77b602a4ab55a655a0a50dbd8fe130f0952848c4...aa0141912ec4731740ebe87708052eae6e6d0387,1,1,1,2,1,2009-11-04 05:47:32,2009-11-04 05:47:32
aa0141912ec4731740ebe87708052eae6e6d0387...0e49b397f93375d0c1a8223f5ff8830a0e68a1e3,1,1,1,2,1,2009-11-04 05:51:13,2009-11-04 05:51:13
0e49b397f93375d0c1a8223f5ff8830a0e68a1e3...b59aa81d680f14e6cf03ff1e4ecaa241a2877adc,1,1,1,2,2,2009-11-04 10:31:37,2009-11-04 10:31:37
b59aa81d680f14e6cf03ff1e4ecaa241a2877adc...dd5d7622a5d8f95c304267b1bcb0d9a8d28d6d8e,2,13,3,16,3,2009-11-04 11:24:56,2009-11-04 11:24:56
dd5d7622a5d8f95c304267b1bcb0d9a8d28d6d8e...90a9f81d377b17c0df08faac5aa0fdd412508123,1,14,11,25,1,2009-11-04 11:38:06,2009-11-04 11:38:06
90a9f81d377b17c0df08faac5aa0fdd412508123...2c609b40199f75c52ae915ad07cf36f72a8f1f6c,1,2,0,2,1,2009-11-04 15:01:41,2009-11-04 15:01:41
2c609b40199f75c52ae915ad07cf36f72a8f1f6c...77abadfa6a2bd015308602c70cecbfabedd3f08e,1,1,1,2,1,2009-11-04 15:05:49,2009-11-04 15:05:49
77abadfa6a2bd015308602c70cecbfabedd3f08e...7b63d3d3b4fcf58070ced8e7a8c766cc93a26420,6,65,1,66,7,2009-11-05 11:57:28,2009-11-05 11:57:28
7b63d3d3b4fcf58070ced8e7a8c766cc93a26420...562d5d8a28b16ab069d716b81085f5dce8934d9b,1,1,1,2,1,2009-11-08 00:51:42,2009-11-08 00:51:42
562d5d8a28b16ab069d716b81085f5dce8934d9b...f3bb5276e095ddaf6cfa5de37d8c3fa879903fdc,3,67,8,75,9,2009-11-10 01:54:35,2009-11-10 01:54:35
f3bb5276e095ddaf6cfa5de37d8c3fa879903fdc...36fe303e359bcb33a54d8a5fc8dea8b26df96c70,5,90,20,110,20,2009-11-10 03:35:25,2009-11-10 03:35:25
36fe303e359bcb33a54d8a5fc8dea8b26df96c70...ef65854a77493bc3be8056cfcf149ccc37409097,1,3,1,4,1,2009-11-10 03:51:05,2009-11-10 03:51:05
ef65854a77493bc3be8056cfcf149ccc37409097...70f9a4f6ceb1bc4a33714e3b1cfb99175e2fcf3f,2,10,0,10,2,2009-11-10 15:21:12,2009-11-10 15:21:12
70f9a4f6ceb1bc4a33714e3b1cfb99175e2fcf3f...3f8f3f8411650bd328cd4054941c18ff9da1d1f6,2,28,4,32,6,2009-11-10 17:28:20,2009-11-10 17:28:20
3f8f3f8411650bd328cd4054941c18ff9da1d1f6...632f12fba48af1edbd92c722a09a5f7602315b3f,2,33,5,38,5,2009-11-11 13:06:18,2009-11-11 13:06:18
632f12fba48af1edbd92c722a09a5f7602315b3f...c8514b570bb51347c2b3ffbc1df543ac2dfc7000,3,105,83,188,60,2009-11-12 13:58:32,2009-11-12 13:58:32
c8514b570bb51347c2b3ffbc1df543ac2dfc7000...dd045aaab5cb5c5e04c5fafc62913acccf7029b3,2,33,2,35,4,2009-11-13 12:34:41,2009-11-13 12:34:41
dd045aaab5cb5c5e04c5fafc62913acccf7029b3...0aeb1e135d88dc690e34b40cf621d5fc4d34be4a,2,16,2,18,3,2009-11-13 12:35:05,2009-11-13 12:35:05
0aeb1e135d88dc690e34b40cf621d5fc4d34be4a...04f869a80cb41a3e8c6d555cccb305fe7602753b,4,42,13,55,10,2009-11-14 19:13:33,2009-11-14 19:13:33
04f869a80cb41a3e8c6d555cccb305fe7602753b...c169f8cb174c9a8858cc8af207f98b9329f53e82,5,38,10,48,9,2009-11-14 23:25:44,2009-11-14 23:25:44
c169f8cb174c9a8858cc8af207f98b9329f53e82...6c61ca3d74ae438c34f404676470234e8213d7c2,7,155,48,203,20,2009-11-16 01:58:00,2009-11-16 01:58:00
6c61ca3d74ae438c34f404676470234e8213d7c2...32d0730b8965b272368763d75803fa0472d97177,16,395,21,416,39,2009-11-16 18:49:00,2009-11-16 18:49:00
32d0730b8965b272368763d75803fa0472d97177...cd0d7e676db60dedfc231e013aa60db516831223,1,0,17,17,1,2009-11-17 02:13:26,2009-11-17 02:13:26
cd0d7e676db60dedfc231e013aa60db516831223...bb4062d53b0caae84732c5940a97e3da1b14823f,2,31,5,36,5,2009-11-18 07:44:06,2009-11-18 07:44:06
bb4062d53b0caae84732c5940a97e3da1b14823f...2dfe3ad657f4372618ba9df8fc7e298511113dd4,6,100,0,100,2,2009-11-18 11:10:50,2009-11-18 11:10:50
2dfe3ad657f4372618ba9df8fc7e298511113dd4...468ca16319977628bdae2be527514a30b35dd6fa,1,1,1,2,1,2009-11-18 21:39:07,2009-11-18 21:39:07
468ca16319977628bdae2be527514a30b35dd6fa...7875421a03a5af3006152216215fc3a9a9b8b274,2,4,4,8,4,2009-11-19 04:35:31,2009-11-19 04:35:31
7875421a03a5af3006152216215fc3a9a9b8b274...77755aa5a03ec7295d17149590829544aba71377,2,12,2,14,3,2009-11-19 04:35:53,2009-11-19 04:35:53
77755aa5a03ec7295d17149590829544aba71377...0880fe8be46df57e0f6c9ed7b4756688173da054,1,10,10,20,8,2009-11-19 11:23:34,2009-11-19 11:23:34
0880fe8be46df57e0f6c9ed7b4756688173da054...be9376d9ad7ef6435867fdcbce2b1bf80973c8cf,2,27,13,40,3,2009-11-19 15:07:42,2009-11-19 15:07:42
be9376d9ad7ef6435867fdcbce2b1bf80973c8cf...e6b4d1014e9dd6096d6c8e312a3f82933441200f,2,14,0,14,2,2009-11-19 21:49:31,2009-11-19 21:49:31
e6b4d1014e9dd6096d6c8e312a3f82933441200f...660f9086f15c7c1f76b489ea885223b36494e7fd,2,26,12,38,6,2009-11-20 00:59:38,2009-11-20 00:59:38
660f9086f15c7c1f76b489ea885223b36494e7fd...f5fefcc8c959ed660d69da7177e5ad68efcc3feb,1,30,0,30,1,2009-11-20 14:59:44,2009-11-20 14:59:44
f5fefcc8c959ed660d69da7177e5ad68efcc3feb...cf169d9e12720558f3de5fa9cfb5aa3d925f3c57,7,142,33,175,22,2009-11-23 13:44:24,2009-11-23 13:44:24
cf169d9e12720558f3de5fa9cfb5aa3d925f3c57...1f3aa297f11af8b844873e2ae5e816977f83af85,2,207,590,797,144,2009-11-23 21:40:09,2009-11-23 21:40:09
1f3aa297f11af8b844873e2ae5e816977f83af85...6bf98c4400b5fe71e7a7bcc4dae08c5970e44f24,1,1,1,2,1,2009-11-26 11:17:53,2009-11-26 11:17:53
6bf98c4400b5fe71e7a7bcc4dae08c5970e44f24...50a2c1ec08d095982e8d460b920bdbf4809e5015,2,199,175,374,133,2009-11-30 10:44:56,2009-11-30 10:44:56
50a2c1ec08d095982e8d460b920bdbf4809e5015...97220910156edb6b7b8f99a578496b7278c280a4,2,195,174,369,132,2009-11-30 10:45:30,2009-11-30 10:45:30
97220910156edb6b7b8f99a578496b7278c280a4...ce7c61d61edc2c9f7d4c13811664bd226864bf30,7,22,17,39,18,2009-12-02 00:30:00,2009-12-02 00:30:00
ce7c61d61edc2c9f7d4c13811664bd226864bf30...20c7e646ffee266f6540c2b88bf4e9ff1e8f70de,2,22,4,26,4,2009-12-03 14:48:47,2009-12-03 14:48:47
20c7e646ffee266f6540c2b88bf4e9ff1e8f70de...2552599800cebef549e9b5d723f38da5ee48de9f,2,35,35,70,28,2009-12-03 14:55:28,2009-12-03 14:55:28
2552599800cebef549e9b5d723f38da5ee48de9f...78ad0a61a945684e1acf11111cec971d2dfa30c3,2,36,4,40,4,2009-12-03 14:58:58,2009-12-03 14:58:58
78ad0a61a945684e1acf11111cec971d2dfa30c3...86fcb25749ffe05840fd0e119d3342fe9bac00ff,1,1,1,2,1,2009-12-03 15:11:14,2009-12-03 15:11:14
86fcb25749ffe05840fd0e119d3342fe9bac00ff...85bfaf10175884ad3081e5fb32867695bf73f147,1,1,1,2,1,2009-12-09 01:34:47,2009-12-09 01:34:47
85bfaf10175884ad3081e5fb32867695bf73f147...81dd5c247366986339c9c22c058e8b0864392cd1,2,10,2,12,4,2009-12-09 03:49:25,2009-12-09 03:49:25
81dd5c247366986339c9c22c058e8b0864392cd1...bb428f3e86953d09df050b2614639f5c8a68840d,1,41,0,41,1,2009-12-09 12:47:50,2009-12-09 12:47:50
bb428f3e86953d09df050b2614639f5c8a68840d...eeb10d5f2c5375ec28b7761f9ea0fd4f1d2e4bd1,2,38,0,38,2,2009-12-09 16:07:21,2009-12-09 16:07:21
eeb10d5f2c5375ec28b7761f9ea0fd4f1d2e4bd1...25020ddb05543fff1c37d77b49bd937fd2bbb170,40,2100,29,2129,70,2009-12-09 16:57:23,2009-12-09 16:57:23
25020ddb05543fff1c37d77b49bd937fd2bbb170...2c2f5aee4d44836779fcd74c7782368914f9cfd1,7,514,93,607,35,2009-12-09 22:40:36,2009-12-09 22:40:36
2c2f5aee4d44836779fcd74c7782368914f9cfd1...9bf652dfd6a738fd841471f6abd71cba1b206d9f,10,253,98,351,29,2009-12-10 01:05:35,2009-12-10 01:05:35
9bf652dfd6a738fd841471f6abd71cba1b206d9f...5543b10608fc723e7245f5d57eaa22102e863d2a,2,7,1,8,2,2009-12-10 19:58:20,2009-12-10 19:58:20
5543b10608fc723e7245f5d57eaa22102e863d2a...dd27fe74c7546e01e32438579a8db575e8f097ce,2,74,70,144,69,2009-12-11 09:16:43,2009-12-11 09:16:43
dd27fe74c7546e01e32438579a8db575e8f097ce...7cb8892fdb2a5437240e0d66b4eb5d1857820c41,2,6,3,9,7,2009-12-12 05:25:50,2009-12-12 05:25:50
7cb8892fdb2a5437240e0d66b4eb5d1857820c41...333615accb6de0682a18bd5a512112832e01727a,1,17,16,33,15,2009-12-12 06:00:59,2009-12-12 06:00:59
333615accb6de0682a18bd5a512112832e01727a...85def09554708deca317f9f7e57adf13c5514c40,2,2,2,4,2,2009-12-12 07:13:38,2009-12-12 07:13:38
85def09554708deca317f9f7e57adf13c5514c40...2659429df46d0d79ad7a93d50d0ccdab45b55b53,1,10,8,18,2,2009-12-12 15:30:25,2009-12-12 15:30:25
2659429df46d0d79ad7a93d50d0ccdab45b55b53...f761802b228826f31af48f520a2f4b70725801f6,3,17,8,25,4,2009-12-12 17:20:32,2009-12-12 17:20:32
f761802b228826f31af48f520a2f4b70725801f6...ac8da7b36f353ffc225ee27b0aeb96f8912b9362,4,24,0,24,2,2009-12-12 17:51:51,2009-12-12 17:51:51
ac8da7b36f353ffc225ee27b0aeb96f8912b9362...9c4bd2aa33fed8ba8ba328ae487e80135ac1498f,3,14,1,15,5,2009-12-12 18:18:31,2009-12-12 18:18:31
9c4bd2aa33fed8ba8ba328ae487e80135ac1498f...85ccad4d61982fad61aee5a24d82e832b3616b63,3,0,0,0,0,2009-12-12 18:45:43,2009-12-12 18:45:43
85ccad4d61982fad61aee5a24d82e832b3616b63...92803205cbcaaee16ac0eb724c45019a9d896aac,3,116,5,121,13,2009-12-12 18:52:12,2009-12-12 18:52:12
92803205cbcaaee16ac0eb724c45019a9d896aac...783884af56b9500c5ff0a116505532dfd4aab5c7,0,0,0,0,0,2009-12-12 19:38:48,2009-12-12 19:38:48
783884af56b9500c5ff0a116505532dfd4aab5c7...0986a4d2e147926fc1ee62fb67406d0a39fbe776,9,137,40,177,51,2009-12-12 20:25:41,2009-12-12 20:25:41
0986a4d2e147926fc1ee62fb67406d0a39fbe776...627f4623b747d3d0b57c3c09677f3d9a0cc39b05,1,1,1,2,1,2009-12-12 20:52:15,2009-12-12 20:52:15
627f4623b747d3d0b57c3c09677f3d9a0cc39b05...8a59084c3a34db9b55c1ef426916f758185b9e29,3,36,1,37,5,2009-12-12 21:51:47,2009-12-12 21:51:47
8a59084c3a34db9b55c1ef426916f758185b9e29...20938b6a0a0ca1c4f83892891c897e5913b7e7ac,1,1,1,2,1,2009-12-12 22:04:04,2009-12-12 22:04:04
20938b6a0a0ca1c4f83892891c897e5913b7e7ac...d10dd3eceb45b72746c974adaf7d9040aa48dd0a,1,21,0,21,4,2009-12-13 15:16:48,2009-12-13 15:16:48
d10dd3eceb45b72746c974adaf7d9040aa48dd0a...92eec3ef9ae3eed18cef4cb7e87a85df4f06d3f0,4,45,7,52,12,2009-12-13 16:24:36,2009-12-13 16:24:36
92eec3ef9ae3eed18cef4cb7e87a85df4f06d3f0...0fe8c20a2830c62881947e8f017963c0c2142287,2,53,2,55,3,2009-12-13 17:01:22,2009-12-13 17:01:22
0fe8c20a2830c62881947e8f017963c0c2142287...4b0f9531eb252a328d1041a5e2e4daab22b7bccc,3,29,0,29,1,2009-12-13 17:08:36,2009-12-13 17:08:36
4b0f9531eb252a328d1041a5e2e4daab22b7bccc...cafb12464bf26d379c88b02b362528fd84481671,1,2,2,4,2,2009-12-13 17:20:36,2009-12-13 17:20:36
cafb12464bf26d379c88b02b362528fd84481671...6a7db77e957ab00445982484e553a65dc691604a,1,3,1,4,1,2009-12-13 17:32:16,2009-12-13 17:32:16
6a7db77e957ab00445982484e553a65dc691604a...125403ca972d4964691ee206acc6c28c0b3eab9d,2,16,1,17,2,2009-12-13 17:46:52,2009-12-13 17:46:52
125403ca972d4964691ee206acc6c28c0b3eab9d...1c5fe467bd838c8521ca7c7427d8196f08a24f80,5,51,8,59,10,2009-12-13 20:29:04,2009-12-13 20:29:04
1c5fe467bd838c8521ca7c7427d8196f08a24f80...07ba0dbaf75a72c3c3ab71ca5a80f0889ddabb72,1,23,2,25,2,2009-12-13 20:35:06,2009-12-13 20:35:06
07ba0dbaf75a72c3c3ab71ca5a80f0889ddabb72...2135befd64ce6c5c1ba765337e078a6cce7ae0f2,6,206,18,224,6,2009-12-13 21:56:18,2009-12-13 21:56:18
2135befd64ce6c5c1ba765337e078a6cce7ae0f2...bd123104272606465dd0391f0c3650388b0fb45c,2,824,1491,2315,6,2009-12-13 22:00:26,2009-12-13 22:00:26
bd123104272606465dd0391f0c3650388b0fb45c...5a235050b6ec6b7bd1cb0f42c765849d97ccd52b,2,2,2,4,2,2009-12-14 11:19:40,2009-12-14 11:19:40
5a235050b6ec6b7bd1cb0f42c765849d97ccd52b...44b9076bbed3e629230d9b77a8765e4c906036d1,23,667,194,861,83,2009-12-14 12:08:23,2009-12-14 12:08:23
44b9076bbed3e629230d9b77a8765e4c906036d1...35cc439228cd32dfa7a3ec919db01a8a5cd17d33,20,927,37,964,51,2009-12-14 12:39:20,2009-12-14 12:39:20
35cc439228cd32dfa7a3ec919db01a8a5cd17d33...7aaacb589a12e02d2a04edb5afca6c6eac83fc35,1,4,4,8,2,2009-12-14 16:01:43,2009-12-14 16:01:43
7aaacb589a12e02d2a04edb5afca6c6eac83fc35...680268a6833d5b18c08f2e1d65840f8c12d13249,3,52,2,54,4,2009-12-16 14:52:29,2009-12-16 14:52:29
680268a6833d5b18c08f2e1d65840f8c12d13249...4e81086021e76874652d7c8eb52de39ab38c43f4,1,2,2,4,2,2009-12-16 15:15:41,2009-12-16 15:15:41
4e81086021e76874652d7c8eb52de39ab38c43f4...833df0afaa953070bbb8b4df62b0d78aeedaf314,9,86,121,207,78,2009-12-16 18:13:34,2009-12-16 18:13:34
833df0afaa953070bbb8b4df62b0d78aeedaf314...c90b15e1d64d9561243f976ea42c763e0640d9fa,2,204,144,348,70,2009-12-16 19:03:51,2009-12-16 19:03:51
c90b15e1d64d9561243f976ea42c763e0640d9fa...b38e678dae65823c58cb2be2ac6e4671af524282,1,9,1,10,4,2009-12-16 21:25:00,2009-12-16 21:25:00
b38e678dae65823c58cb2be2ac6e4671af524282...c0c6e7d1031b5e8c8824ec5068ac46e48c2f67e4,1,10,5,15,2,2009-12-16 23:47:30,2009-12-16 23:47:30
c0c6e7d1031b5e8c8824ec5068ac46e48c2f67e4...fd4cc65baf7055e7815513756a3d3f6940c1d2ab,3,61,30,91,15,2009-12-17 07:27:26,2009-12-17 07:27:26
fd4cc65baf7055e7815513756a3d3f6940c1d2ab...5bd63663a9754ef783aa21402f534fe6ed45ef57,20,125,18,143,24,2009-12-17 15:10:38,2009-12-17 15:10:38
5bd63663a9754ef783aa21402f534fe6ed45ef57...fed3081cafc69f1b92945664c42bd7262dca253c,2,32,23,55,25,2009-12-17 18:21:30,2009-12-17 18:21:30
fed3081cafc69f1b92945664c42bd7262dca253c...3bd849062c57d297f3b6f7cb12e4644ce19c52f8,1,45,46,91,4,2009-12-17 21:54:37,2009-12-17 21:54:37
3bd849062c57d297f3b6f7cb12e4644ce19c52f8...574eafe4c08c4a63876e199e0f2657868c8d0718,24,48,50,98,39,2009-12-17 22:06:41,2009-12-17 22:06:41
574eafe4c08c4a63876e199e0f2657868c8d0718...f96f63056bfe5ee799b82fe808c2e84286b7a302,1,5,5,10,3,2009-12-17 23:47:45,2009-12-17 23:47:45
f96f63056bfe5ee799b82fe808c2e84286b7a302...ebb8ca1cd7c2833309c3febfb03ad9abbb074d37,1,1,1,2,1,2009-12-18 00:32:10,2009-12-18 00:32:10
ebb8ca1cd7c2833309c3febfb03ad9abbb074d37...a2ef46316c492cc2c4b2e28bbbf73db3ebc29e1e,1,13,2,15,3,2009-12-18 10:07:34,2009-12-18 10:07:34
a2ef46316c492cc2c4b2e28bbbf73db3ebc29e1e...ca2d64788d74ea86d4e462d3e58311dc651ee5e0,3,52,1,53,7,2009-12-18 10:08:05,2009-12-18 10:08:05
ca2d64788d74ea86d4e462d3e58311dc651ee5e0...f1ea26dd99415d376ab0e170bfce75fcfdeb7c01,2,54,0,54,2,2009-12-19 08:19:38,2009-12-19 08:19:38
f1ea26dd99415d376ab0e170bfce75fcfdeb7c01...01acd99947b0723f5c9643aa4d438d553c82324c,7,124,1,125,7,2009-12-19 14:27:26,2009-12-19 14:27:26
01acd99947b0723f5c9643aa4d438d553c82324c...7efd96844da89219b6fa5a9adfac4e5ff477b833,2,7,1,8,2,2009-12-19 14:50:41,2009-12-19 14:50:41
7efd96844da89219b6fa5a9adfac4e5ff477b833...e4757ec7afd54861e0c34d9b0f5edbbac4e2b860,1,2,0,2,1,2009-12-19 15:02:46,2009-12-19 15:02:46
e4757ec7afd54861e0c34d9b0f5edbbac4e2b860...25ab93457c2c294420fa50302834f3623200b690,2,26,4,30,4,2009-12-19 15:25:16,2009-12-19 15:25:16
25ab93457c2c294420fa50302834f3623200b690...20ad30713e1162b26a62920d06a4beb3f3b678d9,9,627,23,650,16,2009-12-20 02:46:58,2009-12-20 02:46:58
20ad30713e1162b26a62920d06a4beb3f3b678d9...c804179126179bdbf643160202ef01d49b627f17,1,1,1,2,1,2009-12-20 22:46:35,2009-12-20 22:46:35
c804179126179bdbf643160202ef01d49b627f17...79d6e402e3a19490f2ab2c24cbe4b416ee8926e7,2,2,2,4,2,2009-12-21 01:53:39,2009-12-21 01:53:39
79d6e402e3a19490f2ab2c24cbe4b416ee8926e7...15f42cc92a865dd0f3a39e73e9ffdd6262bde7dd,1,7,7,14,6,2009-12-22 06:00:57,2009-12-22 06:00:57
15f42cc92a865dd0f3a39e73e9ffdd6262bde7dd...3d00992d9fefdcdc3bbc3fc85c1a409350391e5c,3,23,19,42,8,2009-12-22 06:01:23,2009-12-22 06:01:23
3d00992d9fefdcdc3bbc3fc85c1a409350391e5c...7ef212af149540aa2da577a960d0d87029fd1514,1,12,0,12,1,2009-12-22 13:41:51,2009-12-22 13:41:51
7ef212af149540aa2da577a960d0d87029fd1514...ff60c5f9de3e8690d1e86f3e9e3f7248a15397c8,231,7874,5682,13556,1408,2009-12-22 15:18:51,2009-12-22 15:18:51
ff60c5f9de3e8690d1e86f3e9e3f7248a15397c8...d9568af974b8ec1443a6d8c1f440e1514e39d9e8,1,9,9,18,8,2009-12-22 15:54:34,2009-12-22 15:54:34
d9568af974b8ec1443a6d8c1f440e1514e39d9e8...5e54f6b263d981abd5aa1a46d208ee48f00f601d,1,1,1,2,1,2009-12-22 16:00:49,2009-12-22 16:00:49
5e54f6b263d981abd5aa1a46d208ee48f00f601d...0f2f08a7d78e3cff15bf98725f173f2e3382de0a,2,7,3,10,3,2009-12-22 16:10:48,2009-12-22 16:10:48
0f2f08a7d78e3cff15bf98725f173f2e3382de0a...51602128a57e8cf93f3cdb1f1370deba93f034ec,1,4,4,8,2,2009-12-22 17:16:28,2009-12-22 17:16:28
51602128a57e8cf93f3cdb1f1370deba93f034ec...a5af81f93fdf79a99d59a7cabd14ce58266d1d10,1,7,3,10,2,2009-12-22 17:32:30,2009-12-22 17:32:30
a5af81f93fdf79a99d59a7cabd14ce58266d1d10...6632739e94c6c38b4c5a86cf5c80c48ae50ac49f,1,1,1,2,1,2009-12-22 17:40:25,2009-12-22 17:40:25
6632739e94c6c38b4c5a86cf5c80c48ae50ac49f...9233d0426537615e06b78d28010d17d5a66adf44,128,2314,356,2670,153,2009-12-22 17:58:49,2009-12-22 17:58:49
9233d0426537615e06b78d28010d17d5a66adf44...bcd9482a2019158f4580c24cd50ee8bfae9b2739,13,504,162,666,89,2009-12-22 18:29:00,2009-12-22 18:29:00
bcd9482a2019158f4580c24cd50ee8bfae9b2739...cba6133380b1329ac0a5e2b767dbdf36268a1469,4,1659,1371,3030,814,2009-12-22 19:48:15,2009-12-22 19:48:15
cba6133380b1329ac0a5e2b767dbdf36268a1469...cec64b96b0508ee26f0290e017a8494639b4dc02,4,630,481,1111,248,2009-12-22 19:49:11,2009-12-22 19:49:11
cec64b96b0508ee26f0290e017a8494639b4dc02...cdf5ad4217e4220eea8c61cb231314f3cdc8d12e,3,66,47,113,9,2009-12-22 21:05:15,2009-12-22 21:05:15
cdf5ad4217e4220eea8c61cb231314f3cdc8d12e...d320deef25059d1f349c386453f228debcf4cfe7,8,669,0,669,11,2009-12-22 21:10:40,2009-12-22 21:10:40
d320deef25059d1f349c386453f228debcf4cfe7...18d754d681e9ca43e6cc8474fb8bb533222bae83,2,261,156,417,148,2009-12-23 12:07:39,2009-12-23 12:07:39
18d754d681e9ca43e6cc8474fb8bb533222bae83...e1f6b4b82ffbd44e3010d52a83a151e6f1decbfe,8,213,16,229,17,2009-12-23 20:45:08,2009-12-23 20:45:08
e1f6b4b82ffbd44e3010d52a83a151e6f1decbfe...c8f22aef237b800b73c1d4ff31bdd95feaa496eb,1,1,1,2,1,2009-12-24 03:21:13,2009-12-24 03:21:13
c8f22aef237b800b73c1d4ff31bdd95feaa496eb...efbace6b7e0ae2f3c9cc7d04d0d7a18568d26222,1,1,1,2,1,2009-12-24 05:35:43,2009-12-24 05:35:43
efbace6b7e0ae2f3c9cc7d04d0d7a18568d26222...a8155af4e95e7907af673db229ea63c6ab14bdbb,2,8,3,11,3,2009-12-24 05:57:43,2009-12-24 05:57:43
a8155af4e95e7907af673db229ea63c6ab14bdbb...7e44efb853d288ff0be37d78e179f0397c174647,1,24,10,34,3,2009-12-24 14:23:22,2009-12-24 14:23:22
7e44efb853d288ff0be37d78e179f0397c174647...b5a4aef43d03c9f8ece64332e165730dd377b033,3,283,230,513,17,2009-12-24 14:23:52,2009-12-24 14:23:52
b5a4aef43d03c9f8ece64332e165730dd377b033...7d0c196b8684a333653e051c10afdafcd89aeb05,2,1,1,2,1,2009-12-24 14:24:11,2009-12-24 14:24:11
7d0c196b8684a333653e051c10afdafcd89aeb05...474fb8c3ae9edd2c26ce5dd3e6c57db7c61976ed,2,22,15,37,11,2009-12-24 14:53:51,2009-12-24 14:53:51
474fb8c3ae9edd2c26ce5dd3e6c57db7c61976ed...9b8e90f93796b18ca43dcfbf3bfe3267157d322f,1,3,2,5,4,2009-12-24 15:07:53,2009-12-24 15:07:53
9b8e90f93796b18ca43dcfbf3bfe3267157d322f...7626f851e38916196825fde62aa504a0747839e1,1,2,2,4,2,2009-12-25 10:26:36,2009-12-25 10:26:36
7626f851e38916196825fde62aa504a0747839e1...ac6273d6750be112dcb909d2201104be5885e806,4,59,41,100,14,2009-12-25 14:37:57,2009-12-25 14:37:57
ac6273d6750be112dcb909d2201104be5885e806...b4f5e80cd1a6429a42f168142b5a3d90ce2afb26,2,73,58,131,18,2009-12-25 20:51:30,2009-12-25 20:51:30
b4f5e80cd1a6429a42f168142b5a3d90ce2afb26...6154d58cb5491b4c75d9bb912d71575bb4db5968,1,73,79,152,29,2009-12-25 21:07:11,2009-12-25 21:07:11
6154d58cb5491b4c75d9bb912d71575bb4db5968...39122c841f0105ea66ad6d39d4cc8025cf5813b3,3,15,13,28,9,2009-12-26 00:55:06,2009-12-26 00:55:06
39122c841f0105ea66ad6d39d4cc8025cf5813b3...c6fa4936b327f969cfd87517af2aa7c17980b0be,14,43,33,76,22,2009-12-26 03:44:21,2009-12-26 03:44:21
c6fa4936b327f969cfd87517af2aa7c17980b0be...66ef91d02ae43c2b4290ca98ce13d098a7953b90,1,5,5,10,5,2009-12-26 03:59:53,2009-12-26 03:59:53
66ef91d02ae43c2b4290ca98ce13d098a7953b90...adb74a8f2eaa3854ff59da30d2261a18415327cc,22,59,63,122,56,2009-12-26 06:37:26,2009-12-26 06:37:26
adb74a8f2eaa3854ff59da30d2261a18415327cc...eddb478058a4ab4d8e51c3937b6f6c60b5706e41,1,0,9,9,1,2009-12-26 06:49:54,2009-12-26 06:49:54
eddb478058a4ab4d8e51c3937b6f6c60b5706e41...dd42e4af169e4e7a3d9c1030fe86de229a862d26,4,465,306,771,180,2009-12-26 16:35:27,2009-12-26 16:35:27
dd42e4af169e4e7a3d9c1030fe86de229a862d26...adc6113515210c137ae662ef047d86975343eb24,1,36,34,70,15,2009-12-26 18:02:09,2009-12-26 18:02:09
adc6113515210c137ae662ef047d86975343eb24...f58fb383fbbcec9f7482b81388710abbf0ad0df6,1,2,2,4,1,2009-12-27 08:07:08,2009-12-27 08:07:08
f58fb383fbbcec9f7482b81388710abbf0ad0df6...1d581cda674303d5b3c1d7576d31749391f1c510,2,3,1,4,2,2009-12-27 09:06:33,2009-12-27 09:06:33
1d581cda674303d5b3c1d7576d31749391f1c510...9319f895478c60717a7cf2cf132ad7fa4440b4f8,1,4,3,7,2,2009-12-28 05:11:57,2009-12-28 05:11:57
9319f895478c60717a7cf2cf132ad7fa4440b4f8...c38d66a216a45e2352ee666eff9e1270082f906b,6,368,18,386,12,2009-12-28 06:48:47,2009-12-28 06:48:47
c38d66a216a45e2352ee666eff9e1270082f906b...5957052acb5778198ae3601ef4056883bca2c240,1,1,1,2,1,2009-12-28 13:13:04,2009-12-28 13:13:04
5957052acb5778198ae3601ef4056883bca2c240...3952d3129cbed5bdbf207c5c76e8b97e7e229279,2,27,16,43,6,2009-12-28 14:08:11,2009-12-28 14:08:11
3952d3129cbed5bdbf207c5c76e8b97e7e229279...b7cb882471150bf62639485512096c2370b05aec,1,35,12,47,2,2009-12-28 14:17:51,2009-12-28 14:17:51
b7cb882471150bf62639485512096c2370b05aec...4ab21fbf40f456fc3126e935505af47366c64372,1,4,1,5,1,2009-12-29 09:57:37,2009-12-29 09:57:37
4ab21fbf40f456fc3126e935505af47366c64372...a488589461582d60a41326cd8a6ab28b96a9e19a,2,2,4,6,3,2009-12-29 10:18:56,2009-12-29 10:18:56
a488589461582d60a41326cd8a6ab28b96a9e19a...2b9d216ffc26834968ec7600a7ae194f0b227318,1,7,2,9,2,2009-12-29 10:39:08,2009-12-29 10:39:08
2b9d216ffc26834968ec7600a7ae194f0b227318...ca64e9d85f5b08d7deddbf521100e65515edb4de,2,12,10,22,2,2009-12-29 11:18:35,2009-12-29 11:18:35
ca64e9d85f5b08d7deddbf521100e65515edb4de...dcdca8d78c8fb3749a977d1f971dec3819a3d42c,2,24,25,49,23,2009-12-30 07:58:08,2009-12-30 07:58:08
dcdca8d78c8fb3749a977d1f971dec3819a3d42c...6eb02fa9bbd6e68d57f6b5b6e7419271ca4fd0ab,4,26,3,29,6,2009-12-30 22:11:11,2009-12-30 22:11:11
6eb02fa9bbd6e68d57f6b5b6e7419271ca4fd0ab...bf33d3eb1d20157a09b4bf1f36f9c928bc1cabc7,9,120,39,159,38,2009-12-30 22:11:48,2009-12-30 22:11:48
bf33d3eb1d20157a09b4bf1f36f9c928bc1cabc7...fa0653cd1d791a8bce835e8992cbeab6fd70d0e7,4,72,18,90,18,2009-12-30 22:12:16,2009-12-30 22:12:16
fa0653cd1d791a8bce835e8992cbeab6fd70d0e7...f93657218ccd5c39f0b5f8415dd2f041238ad825,1,8,8,16,4,2009-12-30 22:12:37,2009-12-30 22:12:37
f93657218ccd5c39f0b5f8415dd2f041238ad825...57d7181caa4e89f692a71b3d0fe9c267aec6ccba,2,31,11,42,6,2009-12-30 22:12:57,2009-12-30 22:12:57
57d7181caa4e89f692a71b3d0fe9c267aec6ccba...c35868ab9b4eca17b284cb6edd79fcdad9951442,1,1,2,3,1,2009-12-31 08:03:50,2009-12-31 08:03:50
c35868ab9b4eca17b284cb6edd79fcdad9951442...9a554322139e5c65b4b40bc538ca263a922c824f,4,61,15,76,13,2009-12-31 18:48:28,2009-12-31 18:48:28
9a554322139e5c65b4b40bc538ca263a922c824f...d406a8de8a12717ef32919188f61abcf234c5144,1,1,1,2,1,2009-12-31 19:23:23,2009-12-31 19:23:23
d406a8de8a12717ef32919188f61abcf234c5144...dae4972b4d0d88f539532829cf143a98b20d0d45,1,4,2,6,1,2009-12-31 19:52:26,2009-12-31 19:52:26
dae4972b4d0d88f539532829cf143a98b20d0d45...f2d0ae93f859e31d9591f4b4b35890b320e9129c,3,20,22,42,9,2010-01-01 10:36:22,2010-01-01 10:36:22
f2d0ae93f859e31d9591f4b4b35890b320e9129c...3825bb2350d9547622a9d1201ced9743e21783ee,8,158,0,158,10,2010-01-01 21:31:47,2010-01-01 21:31:47
3825bb2350d9547622a9d1201ced9743e21783ee...82b33b1d805a5565c2d8aed21340bc56c0a12679,6,93,0,93,8,2010-01-01 21:32:24,2010-01-01 21:32:24
82b33b1d805a5565c2d8aed21340bc56c0a12679...6eb205c91447ce8237f0919e156b7d26f6ffc1cd,6,76,0,76,8,2010-01-01 21:33:00,2010-01-01 21:33:00
6eb205c91447ce8237f0919e156b7d26f6ffc1cd...4b2e6743290de5170b2ac96b46241046947f4510,2,12,1,13,2,2010-01-01 21:33:30,2010-01-01 21:33:30
4b2e6743290de5170b2ac96b46241046947f4510...1295282c0aedb8dc2e6156f6df607cfcf5832842,1,5,5,10,5,2010-01-01 21:34:12,2010-01-01 21:34:12
1295282c0aedb8dc2e6156f6df607cfcf5832842...e0dc28df5517d44dab05c01d1e8855711dab6c0a,7,524,0,524,9,2010-01-01 21:34:50,2010-01-01 21:34:50
e0dc28df5517d44dab05c01d1e8855711dab6c0a...63662ff924ccea2d19486f0b7d525c3d2341c12c,6,174,3,177,11,2010-01-01 21:35:26,2010-01-01 21:35:26
63662ff924ccea2d19486f0b7d525c3d2341c12c...d48f530b0e286888fe99303ca58772e129a63476,3,0,98,98,3,2010-01-01 21:35:47,2010-01-01 21:35:47
d48f530b0e286888fe99303ca58772e129a63476...0e883508936fc5d8e499e702a62413440fa66f0b,2,7,13,20,6,2010-01-01 21:36:08,2010-01-01 21:36:08
0e883508936fc5d8e499e702a62413440fa66f0b...20fbba7f90d27cbc3cad85caf0172a3c177474f5,4,24,12,36,20,2010-01-01 21:36:36,2010-01-01 21:36:36
20fbba7f90d27cbc3cad85caf0172a3c177474f5...6642060a0e1a93e5fa11e86b6236b0adb4f11a11,1,3,3,6,3,2010-01-01 21:36:55,2010-01-01 21:36:55
6642060a0e1a93e5fa11e86b6236b0adb4f11a11...dab87431935458203b5268093f0d766167633a95,1,16,17,33,5,2010-01-01 21:37:18,2010-01-01 21:37:18
dab87431935458203b5268093f0d766167633a95...8465f49b63b1b85603e16671e9fbe41a28971560,1,1,2,3,1,2010-01-01 21:37:36,2010-01-01 21:37:36
8465f49b63b1b85603e16671e9fbe41a28971560...17e191a123cc2593d50f2037d21ae35433c41560,1,1,1,2,1,2010-01-01 21:37:53,2010-01-01 21:37:53
17e191a123cc2593d50f2037d21ae35433c41560...18c31f608f8dec24386941c37c8bfb7cc731d227,2,2,0,2,2,2010-01-01 21:38:11,2010-01-01 21:38:11
18c31f608f8dec24386941c37c8bfb7cc731d227...855e805b4cd1ce40751ef166d36cc6f0ae2a2519,2,21,1,22,3,2010-01-01 21:38:34,2010-01-01 21:38:34
855e805b4cd1ce40751ef166d36cc6f0ae2a2519...ac371ccac8dada9f97fd66fc9780c085e7f04470,2,6,0,6,3,2010-01-01 21:38:58,2010-01-01 21:38:58
ac371ccac8dada9f97fd66fc9780c085e7f04470...d981cb4e66245bbe4c5a91e8a5d3747fcf9a6a88,4,20,1,21,10,2010-01-01 21:39:26,2010-01-01 21:39:26
d981cb4e66245bbe4c5a91e8a5d3747fcf9a6a88...2c329024cac0208d27c5be1381fa0f4351f0e0cc,1,1,1,2,1,2010-01-01 21:39:49,2010-01-01 21:39:49
2c329024cac0208d27c5be1381fa0f4351f0e0cc...f45ac2ff1872ca49295fb27c4e99fcb4c25d0af0,5,6,6,12,5,2010-01-01 21:40:19,2010-01-01 21:40:19
f45ac2ff1872ca49295fb27c4e99fcb4c25d0af0...0aa12da0003fda573d30b7b0d05c08192d80c264,2,12,2,14,5,2010-01-03 06:54:56,2010-01-03 06:54:56
0aa12da0003fda573d30b7b0d05c08192d80c264...a5fc65b46e524725f73a24405b8d2f38afedc3d4,1,13,4,17,2,2010-01-03 18:06:27,2010-01-03 18:06:27
a5fc65b46e524725f73a24405b8d2f38afedc3d4...5dd6bbd2cfa413497333b482889cbe1b1f413658,3,19,9,28,7,2010-01-03 18:52:25,2010-01-03 18:52:25
5dd6bbd2cfa413497333b482889cbe1b1f413658...28d2d3e7055b450d8ae2cf3cef5ddf421a5c8209,1,14,1,15,2,2010-01-03 19:02:55,2010-01-03 19:02:55
28d2d3e7055b450d8ae2cf3cef5ddf421a5c8209...936c99b7c745a3e104d274f6e0dabb68e3086ca0,2,196,0,196,2,2010-01-04 02:27:37,2010-01-04 02:27:37
936c99b7c745a3e104d274f6e0dabb68e3086ca0...abcf997713fe87a68c8ce7035c9e9dc2266145ea,3,74,0,74,5,2010-01-04 02:28:09,2010-01-04 02:28:09
abcf997713fe87a68c8ce7035c9e9dc2266145ea...f6c519e2b919cddc438f6ff52f2b4d7ef8248042,3,41,16,57,10,2010-01-04 02:28:34,2010-01-04 02:28:34
f6c519e2b919cddc438f6ff52f2b4d7ef8248042...b9d698e9f238348494703acac67f119de973df25,5,122,6,128,12,2010-01-04 02:29:12,2010-01-04 02:29:12
b9d698e9f238348494703acac67f119de973df25...89ded975fe1ff75b5b2456f4ee7e1256a261108e,1,3,3,6,2,2010-01-04 02:37:46,2010-01-04 02:37:46
89ded975fe1ff75b5b2456f4ee7e1256a261108e...e07560a88e2bc1f5be2aabec25eca950259f7266,6,26,25,51,23,2010-01-04 12:05:04,2010-01-04 12:05:04
e07560a88e2bc1f5be2aabec25eca950259f7266...77e27e7de73333b8610c5e8967a3681636f844b0,3,49,2,51,8,2010-01-04 12:16:09,2010-01-04 12:16:09
77e27e7de73333b8610c5e8967a3681636f844b0...48edb177edf04854999355dfdfe23fc6ee312d7b,8,19,19,38,19,2010-01-04 21:55:52,2010-01-04 21:55:52
48edb177edf04854999355dfdfe23fc6ee312d7b...b59d6212b1876644b5e404b52f925953e3667eb7,1,2,2,4,2,2010-01-04 22:47:52,2010-01-04 22:47:52
b59d6212b1876644b5e404b52f925953e3667eb7...7c3387ae3a313ae1b255c1bfdbb6f0d594a906bc,1,13,1,14,2,2010-01-04 22:48:36,2010-01-04 22:48:36
7c3387ae3a313ae1b255c1bfdbb6f0d594a906bc...4e89105d64bb9e04c409139a41e9c7aac263df4c,1,4,3,7,2,2010-01-05 02:39:02,2010-01-05 02:39:02
4e89105d64bb9e04c409139a41e9c7aac263df4c...471596fc1afcb9c6258d317c619eaf5fd394e797,63,1549,638,2187,298,2010-01-05 03:56:19,2010-01-05 03:56:19
471596fc1afcb9c6258d317c619eaf5fd394e797...777da5bc732348d2182ad0231e89b0cad1a79b5b,1,1,3,4,1,2010-01-05 04:12:09,2010-01-05 04:12:09
777da5bc732348d2182ad0231e89b0cad1a79b5b...1e81e2f5321d15a6689babe7f27f94bcee6aa4ac,1,1,3,4,1,2010-01-05 04:30:51,2010-01-05 04:30:51
1e81e2f5321d15a6689babe7f27f94bcee6aa4ac...cd7da17132d0321473be97bca0a2a91008038919,5,150,2,152,5,2010-01-05 06:18:41,2010-01-05 06:18:41
cd7da17132d0321473be97bca0a2a91008038919...5b97a7b11be355cbd9076522282432333ac8a3b9,1,1,1,2,1,2010-01-05 06:20:21,2010-01-05 06:20:21
5b97a7b11be355cbd9076522282432333ac8a3b9...4d6c66d4d8fa63005f8ca2d3fbae195922969d13,1,7,0,7,1,2010-01-05 06:35:33,2010-01-05 06:35:33
4d6c66d4d8fa63005f8ca2d3fbae195922969d13...bcef28349a52ff16c9c022b2722138ee9fe62a81,3,16,1,17,4,2010-01-05 12:06:45,2010-01-05 12:06:45
bcef28349a52ff16c9c022b2722138ee9fe62a81...33afa13af56da3231a6a3c008babeec2e470aaeb,1,1,1,2,1,2010-01-05 15:39:42,2010-01-05 15:39:42
33afa13af56da3231a6a3c008babeec2e470aaeb...afa4c5ac6062581fdb809e0615c69350c25bd917,9,61,3,64,15,2010-01-05 18:24:27,2010-01-05 18:24:27
afa4c5ac6062581fdb809e0615c69350c25bd917...84ccb97c717a47da9289f962c5a4c95db469ecb4,1,4,4,8,2,2010-01-05 23:22:11,2010-01-05 23:22:11
84ccb97c717a47da9289f962c5a4c95db469ecb4...b7e4ae49968c076ec4906c63332c46b3a7018803,2,1129,479,1608,242,2010-01-05 23:51:07,2010-01-05 23:51:07
b7e4ae49968c076ec4906c63332c46b3a7018803...d7d2bdd9e96cfc56cf02d8894cc693aa8d3a31dc,1,1,1,2,1,2010-01-06 00:55:54,2010-01-06 00:55:54
d7d2bdd9e96cfc56cf02d8894cc693aa8d3a31dc...24b631d33fe74058e21771c90339c1bd40167c27,1,11,0,11,1,2010-01-06 05:41:05,2010-01-06 05:41:05
24b631d33fe74058e21771c90339c1bd40167c27...4b0e0804625d1aee60bb58b6f8b6fc6b1246ded1,1,582,0,582,1,2010-01-06 05:54:52,2010-01-06 05:54:52
4b0e0804625d1aee60bb58b6f8b6fc6b1246ded1...a81feaee4f27b7550899b233b1f818ce0fe0ed95,1,62,62,124,2,2010-01-06 06:00:30,2010-01-06 06:00:30
a81feaee4f27b7550899b233b1f818ce0fe0ed95...588cd6908f8a74ecce974a5ad22850031b750fc7,2,3,2,5,3,2010-01-06 06:02:31,2010-01-06 06:02:31
588cd6908f8a74ecce974a5ad22850031b750fc7...1d18f324f17ea8638d12cd3a10019fb51512a20d,2,5,5,10,5,2010-01-06 08:16:07,2010-01-06 08:16:07
1d18f324f17ea8638d12cd3a10019fb51512a20d...b7fa3e8c3501fe9064a6111809dc19f7a487e30d,1,33,0,33,1,2010-01-07 11:37:49,2010-01-07 11:37:49
b7fa3e8c3501fe9064a6111809dc19f7a487e30d...47147071fede992ecb85879a9df2d42876ffc8f9,3,2,2,4,3,2010-01-07 11:38:14,2010-01-07 11:38:14
47147071fede992ecb85879a9df2d42876ffc8f9...96848352f97e8c2deb976ce4c8418c0d0aa6be5e,2,43,21,64,11,2010-01-08 00:17:33,2010-01-08 00:17:33
96848352f97e8c2deb976ce4c8418c0d0aa6be5e...0e0b18229fe3822353de6ffa7b6309fd69e6597d,1,2,2,4,2,2010-01-08 00:43:14,2010-01-08 00:43:14
0e0b18229fe3822353de6ffa7b6309fd69e6597d...4a6c746977a7c84cfd39365f43f35fce527fe97a,1,3,3,6,1,2010-01-09 17:08:52,2010-01-09 17:08:52
4a6c746977a7c84cfd39365f43f35fce527fe97a...bf2283d47df81df2960e194402175307de91230e,1,102,95,197,51,2010-01-09 17:09:20,2010-01-09 17:09:20
bf2283d47df81df2960e194402175307de91230e...50bfa46c39d05d351ae77559d54fa8cab3e4f743,1,95,95,190,65,2010-01-09 17:55:28,2010-01-09 17:55:28
50bfa46c39d05d351ae77559d54fa8cab3e4f743...d8b7772fca793aa734df603d745a42a558b3bdc3,1,11,12,23,5,2010-01-09 18:07:28,2010-01-09 18:07:28
d8b7772fca793aa734df603d745a42a558b3bdc3...6629d1e89bbeb606ac2feb92d6c5890f7dad3274,1,23,23,46,14,2010-01-09 18:18:25,2010-01-09 18:18:25
6629d1e89bbeb606ac2feb92d6c5890f7dad3274...e21d3af940ffb4e1d542ec4b910e77fc81289687,1,1,1,2,1,2010-01-09 19:08:03,2010-01-09 19:08:03
e21d3af940ffb4e1d542ec4b910e77fc81289687...161e4667df66b4c782cf6be51a8be747633e33ad,1,1,1,2,1,2010-01-09 19:09:11,2010-01-09 19:09:11
161e4667df66b4c782cf6be51a8be747633e33ad...df9adbafb71a4275ec281fb01938ab41f8e208a0,1,1,1,2,1,2010-01-09 19:09:46,2010-01-09 19:09:46
df9adbafb71a4275ec281fb01938ab41f8e208a0...88265d4a731e8b2071853d275f1bdac9465bc1f4,4,4,4,8,4,2010-01-09 19:11:41,2010-01-09 19:11:41
88265d4a731e8b2071853d275f1bdac9465bc1f4...45b5d02279162b00f4a2f54981d6e6ae18e709c1,1,1,1,2,1,2010-01-09 19:14:13,2010-01-09 19:14:13
45b5d02279162b00f4a2f54981d6e6ae18e709c1...6017907f1129afccd800caf279f02851096f90e0,1,2,2,4,2,2010-01-09 19:17:35,2010-01-09 19:17:35
6017907f1129afccd800caf279f02851096f90e0...00252d84d7143aeceac5242be55b051e8e02987f,1,1,1,2,1,2010-01-09 19:28:06,2010-01-09 19:28:06
00252d84d7143aeceac5242be55b051e8e02987f...b7236b857626660b62800f66700dc887915b96af,2,10,1,11,2,2010-01-09 20:02:41,2010-01-09 20:02:41
b7236b857626660b62800f66700dc887915b96af...1e955e01430c7fdaf0ffe7e1da0d0ca71c1c4836,3,6,3,9,3,2010-01-09 20:03:11,2010-01-09 20:03:11
1e955e01430c7fdaf0ffe7e1da0d0ca71c1c4836...bacfe3f3e8638433976bf1b12f16a8d975970884,7,112,18,130,9,2010-01-09 20:03:52,2010-01-09 20:03:52
bacfe3f3e8638433976bf1b12f16a8d975970884...73d636f74091930af82d0fb44169f9e3fd6fa45a,1,2,1,3,2,2010-01-09 20:04:14,2010-01-09 20:04:14
73d636f74091930af82d0fb44169f9e3fd6fa45a...8a109a7bc8e66548e9c47e3aa0cb5a6ea8c02e34,1,2,2,4,2,2010-01-09 20:04:33,2010-01-09 20:04:33
8a109a7bc8e66548e9c47e3aa0cb5a6ea8c02e34...933b9e8de7cfae0a271283c11cccbb9897e30a46,5,5,5,10,5,2010-01-09 20:11:01,2010-01-09 20:11:01
933b9e8de7cfae0a271283c11cccbb9897e30a46...e0c3cd4d29ccd9c1735c13b7c125b12a1a841d13,1,1,1,2,1,2010-01-09 20:57:32,2010-01-09 20:57:32
e0c3cd4d29ccd9c1735c13b7c125b12a1a841d13...058343c5e82512d32063e24968ba853f51107505,1,4,2,6,2,2010-01-09 21:07:32,2010-01-09 21:07:32
058343c5e82512d32063e24968ba853f51107505...2dd9a85819218e481f9bc6e88264c2b1ae5f25e8,2,109,1,110,3,2010-01-09 21:27:39,2010-01-09 21:27:39
2dd9a85819218e481f9bc6e88264c2b1ae5f25e8...ac1b275130e54e94fd3bd5b3a5ddc4603a247a27,4,47,3,50,4,2010-01-09 21:28:54,2010-01-09 21:28:54
ac1b275130e54e94fd3bd5b3a5ddc4603a247a27...1d61a1eb2a21b550e8e4e63fbb27cbe05ed2aa00,1,2,4,6,2,2010-01-09 21:40:05,2010-01-09 21:40:05
1d61a1eb2a21b550e8e4e63fbb27cbe05ed2aa00...18723e6e24a08579082ed308e417bc1cc52aa407,3,26,1,27,5,2010-01-09 22:05:10,2010-01-09 22:05:10
18723e6e24a08579082ed308e417bc1cc52aa407...341c85bed0676e4bcd762186139367549ffceabb,2,23,3,26,3,2010-01-09 22:14:01,2010-01-09 22:14:01
341c85bed0676e4bcd762186139367549ffceabb...4700200383f69495724cffa0c8be33f16c29409a,3,14,0,14,3,2010-01-09 22:34:13,2010-01-09 22:34:13
4700200383f69495724cffa0c8be33f16c29409a...5e83b79d260598fcdcc2014f99e6669c5b2a44f7,2,14,1,15,6,2010-01-09 22:51:03,2010-01-09 22:51:03
5e83b79d260598fcdcc2014f99e6669c5b2a44f7...73d8abf3d5d443fcf244c50da67b655eaea735a7,1,0,1,1,1,2010-01-09 22:51:21,2010-01-09 22:51:21
73d8abf3d5d443fcf244c50da67b655eaea735a7...9ec29cf1dccb2973b9bccc60942d64cfc4207861,2,21,2,23,5,2010-01-09 23:49:11,2010-01-09 23:49:11
9ec29cf1dccb2973b9bccc60942d64cfc4207861...6e756a3c105bef261e03e79600995d13496311cf,2,0,0,0,0,2010-01-10 00:07:41,2010-01-10 00:07:41
6e756a3c105bef261e03e79600995d13496311cf...a689ba95947e29094dbb7d92d2784edb5e58482c,4,138,31,169,14,2010-01-10 03:36:59,2010-01-10 03:36:59
a689ba95947e29094dbb7d92d2784edb5e58482c...b651bcb80b2046f17d8ce42fd20a1276938b52af,1,1,1,2,1,2010-01-10 16:45:31,2010-01-10 16:45:31
b651bcb80b2046f17d8ce42fd20a1276938b52af...19b72077f7519236db0f5975dad01fe4466e06b8,8,29,6,35,9,2010-01-10 16:51:13,2010-01-10 16:51:13
19b72077f7519236db0f5975dad01fe4466e06b8...1461a76fdd3540e37122131f15a58520dce438ca,6,85,0,85,6,2010-01-10 17:21:52,2010-01-10 17:21:52
1461a76fdd3540e37122131f15a58520dce438ca...6502965d171265e8ae8f1a76302e134eaad3e270,1,2,1,3,1,2010-01-10 17:22:30,2010-01-10 17:22:30
6502965d171265e8ae8f1a76302e134eaad3e270...665ac8779bf313c6d0e179c78b6c68ca59ad4548,1,2,2,4,1,2010-01-10 17:23:59,2010-01-10 17:23:59
665ac8779bf313c6d0e179c78b6c68ca59ad4548...ddd6f28cac9839ec1f98a1b591e8f8397cf77ce4,1,5,1,6,1,2010-01-10 17:25:44,2010-01-10 17:25:44
ddd6f28cac9839ec1f98a1b591e8f8397cf77ce4...a7dc2c06532586f8988d04d8f697c4ebfcabfde8,3,34,1,35,4,2010-01-10 17:28:20,2010-01-10 17:28:20
a7dc2c06532586f8988d04d8f697c4ebfcabfde8...ca6f64a43f668749c395c8c47dbb47aa175dfe25,7,69,14,83,11,2010-01-10 17:35:01,2010-01-10 17:35:01
ca6f64a43f668749c395c8c47dbb47aa175dfe25...92568d31b8d871e35e4377d58356065297c76807,1,0,2,2,1,2010-01-10 17:37:48,2010-01-10 17:37:48
92568d31b8d871e35e4377d58356065297c76807...516947fd61e3335cce114c9bbcc057ad720360a9,1,1,1,2,1,2010-01-10 17:42:23,2010-01-10 17:42:23
516947fd61e3335cce114c9bbcc057ad720360a9...9e3dbc757301a663717029fdd66e351d72e93079,2,2,2,4,2,2010-01-10 17:45:55,2010-01-10 17:45:55
9e3dbc757301a663717029fdd66e351d72e93079...978fb8639f989e6199d3992ebc3db24c6b39353d,1,4,4,8,2,2010-01-10 17:47:53,2010-01-10 17:47:53
978fb8639f989e6199d3992ebc3db24c6b39353d...0683a79d0c5582d9c7f4aa424713adbfba37bfac,2,0,0,0,0,2010-01-10 17:49:41,2010-01-10 17:49:41
0683a79d0c5582d9c7f4aa424713adbfba37bfac...cf1b6845d4cc1c34cfa975f6ba98b7fb966cb491,2,8,0,8,2,2010-01-10 17:53:19,2010-01-10 17:53:19
cf1b6845d4cc1c34cfa975f6ba98b7fb966cb491...1f400c6df0244c505d50932d99db70a0ae69f01a,1,1,1,2,1,2010-01-10 17:54:34,2010-01-10 17:54:34
1f400c6df0244c505d50932d99db70a0ae69f01a...985dcdb4b228fe4e5a535ca0ae7bb07e18c637b1,1,6,6,12,3,2010-01-10 17:55:46,2010-01-10 17:55:46
985dcdb4b228fe4e5a535ca0ae7bb07e18c637b1...7c0326bcca1d08c048db86540f9de78cbc592471,1,1,1,2,1,2010-01-10 17:56:52,2010-01-10 17:56:52
7c0326bcca1d08c048db86540f9de78cbc592471...4606e0898e47d4b3939b37f7b2d1f576f21dff4b,1,1,1,2,2,2010-01-10 17:58:41,2010-01-10 17:58:41
4606e0898e47d4b3939b37f7b2d1f576f21dff4b...692f84c4f1d831f0fbb06d349b1a91e42235eab7,1,4,4,8,3,2010-01-10 18:01:22,2010-01-10 18:01:22
692f84c4f1d831f0fbb06d349b1a91e42235eab7...91d9108f6ed6055bfb23779bb0c8e3e7d476c000,1,0,1,1,1,2010-01-10 18:03:36,2010-01-10 18:03:36
91d9108f6ed6055bfb23779bb0c8e3e7d476c000...26dc65481896d7bd1955afd29ea91f2b91892a19,1,12,2,14,1,2010-01-10 18:07:46,2010-01-10 18:07:46
26dc65481896d7bd1955afd29ea91f2b91892a19...bef891399ec278390ee148b0bb87d4c4140fc4c6,1,3,3,6,1,2010-01-10 18:09:26,2010-01-10 18:09:26
bef891399ec278390ee148b0bb87d4c4140fc4c6...5ceed0a05388079118319940acdb2abe4ee01de6,46,120,124,244,118,2010-01-10 18:36:20,2010-01-10 18:36:20
5ceed0a05388079118319940acdb2abe4ee01de6...457df03c997a85da36230c96edf7283ae554879f,1,2,2,4,1,2010-01-10 18:36:45,2010-01-10 18:36:45
457df03c997a85da36230c96edf7283ae554879f...5ce16c7e2791472bf3fac9ae969a85ec32045490,1,2,2,4,2,2010-01-10 18:38:00,2010-01-10 18:38:00
5ce16c7e2791472bf3fac9ae969a85ec32045490...7789e9c006901cdc33fcdfc98d932eb06e912b93,1,4,3,7,2,2010-01-10 18:40:24,2010-01-10 18:40:24
7789e9c006901cdc33fcdfc98d932eb06e912b93...cc25361b17fbc0d3622bb7562f90f1ac856aa363,1,5,4,9,1,2010-01-10 18:42:30,2010-01-10 18:42:30
cc25361b17fbc0d3622bb7562f90f1ac856aa363...2ef52d0ce20da72e2728fa7d7cdb129935e26ac8,2,9,0,9,2,2010-01-10 18:44:39,2010-01-10 18:44:39
2ef52d0ce20da72e2728fa7d7cdb129935e26ac8...7d9de178e724573c1326ee2c2bf4f0b8b15b6c62,2,11,11,22,5,2010-01-10 18:48:08,2010-01-10 18:48:08
7d9de178e724573c1326ee2c2bf4f0b8b15b6c62...287de02764faf1662be93b47f1bb8f738cea6d5f,1,4,0,4,1,2010-01-10 18:49:04,2010-01-10 18:49:04
287de02764faf1662be93b47f1bb8f738cea6d5f...74f88194c3f16b35dd2bc8133cc7a2f97d2f7221,1,2,2,4,1,2010-01-10 18:50:28,2010-01-10 18:50:28
74f88194c3f16b35dd2bc8133cc7a2f97d2f7221...34db1d647453171c2df73beb8ec3fd9cdd8a6447,1,1,2,3,1,2010-01-10 18:51:32,2010-01-10 18:51:32
34db1d647453171c2df73beb8ec3fd9cdd8a6447...260c5de2f948bf7bd0bb2299fe958bd3d2ec0adf,1,3,3,6,3,2010-01-10 18:53:11,2010-01-10 18:53:11
260c5de2f948bf7bd0bb2299fe958bd3d2ec0adf...5bcaa45d331b4a9201103360770261deb82f15ae,1,1,1,2,1,2010-01-10 18:55:04,2010-01-10 18:55:04
5bcaa45d331b4a9201103360770261deb82f15ae...31eb0fbe3d16418cafd907e333207431dc49cdd0,1,2,1,3,2,2010-01-10 18:56:53,2010-01-10 18:56:53
31eb0fbe3d16418cafd907e333207431dc49cdd0...06645cbda783971287cdbfac67940c1982742bee,1,14,8,22,1,2010-01-10 19:05:39,2010-01-10 19:05:39
06645cbda783971287cdbfac67940c1982742bee...9bb1fa725154e6d1d0317fa0c48d7c240ad5e2d4,3,66,18,84,12,2010-01-10 19:23:42,2010-01-10 19:23:42
9bb1fa725154e6d1d0317fa0c48d7c240ad5e2d4...b45fd3ffdf2f238e0d16e56895e09c99f2ec50b1,3,27,0,27,6,2010-01-10 19:52:17,2010-01-10 19:52:17
b45fd3ffdf2f238e0d16e56895e09c99f2ec50b1...fa4627c3cc705f2adb72bc88aa403f58e970f676,2,750,261,1011,168,2010-01-10 21:05:42,2010-01-10 21:05:42
fa4627c3cc705f2adb72bc88aa403f58e970f676...e1e4050347b5fa69290845629af94b608deb50e1,1,1,1,2,1,2010-01-10 21:28:37,2010-01-10 21:28:37
e1e4050347b5fa69290845629af94b608deb50e1...a4b0947a92df5649ed3cafc669a7b6a8cf0e50f2,1,1,2,3,1,2010-01-10 21:36:12,2010-01-10 21:36:12
a4b0947a92df5649ed3cafc669a7b6a8cf0e50f2...8b9cf79ff645db608f92143d733df24d883a26e9,2,3,3,6,3,2010-01-10 21:37:20,2010-01-10 21:37:20
8b9cf79ff645db608f92143d733df24d883a26e9...dd167aa91eff417cf30de3128bf5a83a56c0cd49,1,1,1,2,1,2010-01-10 21:51:14,2010-01-10 21:51:14
dd167aa91eff417cf30de3128bf5a83a56c0cd49...8bf71f5c8d1936e9bab1607e9c94a745db902c44,1,5,5,10,1,2010-01-10 21:56:15,2010-01-10 21:56:15
8bf71f5c8d1936e9bab1607e9c94a745db902c44...71e8d5dd87569dd52f87918cfc32d56751c43b01,1,1,1,2,1,2010-01-10 21:58:01,2010-01-10 21:58:01
71e8d5dd87569dd52f87918cfc32d56751c43b01...6c9150d8181de83f341b94059d70ad4f1c04a684,1,1,1,2,1,2010-01-11 00:54:27,2010-01-11 00:54:27
6c9150d8181de83f341b94059d70ad4f1c04a684...26279c572101ac1b277fc3947897cb8e840ea42e,2,8,9,17,8,2010-01-11 09:25:10,2010-01-11 09:25:10
26279c572101ac1b277fc3947897cb8e840ea42e...2f9853b2dc90f30317e0374396f08e3d142844d2,17,427,135,562,88,2010-01-12 02:29:45,2010-01-12 02:29:45
2f9853b2dc90f30317e0374396f08e3d142844d2...c56beed24061bf94b67be21806fa654a1e180b5f,3,78,15,93,18,2010-01-12 02:41:57,2010-01-12 02:41:57
c56beed24061bf94b67be21806fa654a1e180b5f...d83769f8dcc821a62bcd4f2e6092c2898e0e2b1a,1,2,1,3,1,2010-01-12 13:14:32,2010-01-12 13:14:32
d83769f8dcc821a62bcd4f2e6092c2898e0e2b1a...c4ad3dede18e6e279d73ffac7095e46fddb90269,1,1,1,2,1,2010-01-12 14:04:04,2010-01-12 14:04:04
c4ad3dede18e6e279d73ffac7095e46fddb90269...eb2cbb6db10c31123d6de07a9efe49c7e854cb86,1,1,1,2,1,2010-01-12 14:26:17,2010-01-12 14:26:17
eb2cbb6db10c31123d6de07a9efe49c7e854cb86...223b2721aa501a0603502d9dae499b7f21ae788f,2,31,3,34,5,2010-01-12 14:58:24,2010-01-12 14:58:24
223b2721aa501a0603502d9dae499b7f21ae788f...379ffbc1da8c97ce4e6e406173023ee3d9d5efce,1,6,2,8,1,2010-01-12 14:58:34,2010-01-12 14:58:34
379ffbc1da8c97ce4e6e406173023ee3d9d5efce...418bfa2819949c69b737bacf0fe0dec6230aee8d,1,7,0,7,1,2010-01-12 14:58:47,2010-01-12 14:58:47
418bfa2819949c69b737bacf0fe0dec6230aee8d...32e0117abb205da87a6d6251b9ce3490d4dd8bda,12,400,252,652,82,2010-01-12 18:40:54,2010-01-12 18:40:54
32e0117abb205da87a6d6251b9ce3490d4dd8bda...09b585e4bb250ab75264df129e341a7e731ef3b9,1,1,0,1,1,2010-01-12 22:03:00,2010-01-12 22:03:00
09b585e4bb250ab75264df129e341a7e731ef3b9...31f3a8c1ad3b6ec33c503241484107bf35cdadba,5,27,8,35,11,2010-01-12 23:34:03,2010-01-12 23:34:03
31f3a8c1ad3b6ec33c503241484107bf35cdadba...a2056919799e48f053fa16b65569fc1e8f57ebe1,7,75,11,86,16,2010-01-12 23:34:46,2010-01-12 23:34:46
a2056919799e48f053fa16b65569fc1e8f57ebe1...c4470e5ced090075adbef36b98b051c5a53f7a2e,5,107,92,199,25,2010-01-12 23:35:29,2010-01-12 23:35:29
c4470e5ced090075adbef36b98b051c5a53f7a2e...f4998574d3edd045ef28323b2d496eff58098f90,1,1,1,2,1,2010-01-12 23:35:54,2010-01-12 23:35:54
f4998574d3edd045ef28323b2d496eff58098f90...e752d4984aa77196335321359b4492a11ea70f8e,1,104,2,106,17,2010-01-12 23:36:19,2010-01-12 23:36:19
e752d4984aa77196335321359b4492a11ea70f8e...9614b0190fdf65df05846151c6cba3f58a1ff992,1,1,1,2,1,2010-01-12 23:36:43,2010-01-12 23:36:43
9614b0190fdf65df05846151c6cba3f58a1ff992...f56f6e94054dcafbdfc555460e3119b1ad018352,1,1,1,2,2,2010-01-12 23:37:07,2010-01-12 23:37:07
f56f6e94054dcafbdfc555460e3119b1ad018352...6afd505b5be528bc5728bc9b9acd48276be457b4,6,403,6,409,15,2010-01-13 11:07:16,2010-01-13 11:07:16
6afd505b5be528bc5728bc9b9acd48276be457b4...0ca28f3926f6845e0fd3098a9dd2a82888729839,1,1,1,2,1,2010-01-13 23:54:07,2010-01-13 23:54:07
0ca28f3926f6845e0fd3098a9dd2a82888729839...373076a3ccd87d8e4489392e16943914141ff856,1,0,1,1,1,2010-01-14 11:12:24,2010-01-14 11:12:24
373076a3ccd87d8e4489392e16943914141ff856...2b2db12032e47229a9d9af28b05a07648f3fef93,2,26,1,27,3,2010-01-14 14:55:36,2010-01-14 14:55:36
2b2db12032e47229a9d9af28b05a07648f3fef93...a2a5602b1937e94b579957c9c2823da48eb69ed9,3,17,9,26,6,2010-01-14 17:04:53,2010-01-14 17:04:53
a2a5602b1937e94b579957c9c2823da48eb69ed9...19fad1641408cd9db3053499296380e1a097cf3f,2,57,29,86,13,2010-01-14 17:43:46,2010-01-14 17:43:46
19fad1641408cd9db3053499296380e1a097cf3f...2e9518bb396c37c48a0464236b714d313b56f10f,6,293,11,304,11,2010-01-16 03:13:16,2010-01-16 03:13:16
2e9518bb396c37c48a0464236b714d313b56f10f...5bc344cecaec2bf9fb027048226a41127d49add1,1,2,1,3,2,2010-01-16 22:45:39,2010-01-16 22:45:39
5bc344cecaec2bf9fb027048226a41127d49add1...2187fa3ea4f1609849594bb23b93d477a3e4b3d3,1,2,0,2,1,2010-01-17 22:29:30,2010-01-17 22:29:30
2187fa3ea4f1609849594bb23b93d477a3e4b3d3...d033dfd894dfecd674f7afae17dc695324a14e68,2,4,0,4,2,2010-01-17 22:29:50,2010-01-17 22:29:50
d033dfd894dfecd674f7afae17dc695324a14e68...235bf7f1f7bbc85024560addb384f213fb6d0950,1,1,7,8,1,2010-01-17 22:49:27,2010-01-17 22:49:27
235bf7f1f7bbc85024560addb384f213fb6d0950...34e420184c7a4860852a0a481083335923b533d1,1,2,2,4,1,2010-01-18 13:00:22,2010-01-18 13:00:22
34e420184c7a4860852a0a481083335923b533d1...53b61d9c023a77a5718ace9b9816ce647349ea99,7,218,84,302,37,2010-01-18 15:11:01,2010-01-18 15:11:01
53b61d9c023a77a5718ace9b9816ce647349ea99...58440c0b66cd3829a41fbe0ec791680cc4934175,1,4,4,8,4,2010-01-18 20:51:29,2010-01-18 20:51:29
58440c0b66cd3829a41fbe0ec791680cc4934175...a1fbc0dc3696500cdc2391da3fbc6694a2a4841e,10,308,211,519,19,2010-01-18 21:02:47,2010-01-18 21:02:47
a1fbc0dc3696500cdc2391da3fbc6694a2a4841e...6b659270d6813029c7d482bec68c623525471f0b,2,27,48,75,10,2010-01-18 21:49:13,2010-01-18 21:49:13
6b659270d6813029c7d482bec68c623525471f0b...be26f1ace4532196b579c903ca77e1cd947a3bd4,1,7,1,8,2,2010-01-18 23:49:20,2010-01-18 23:49:20
be26f1ace4532196b579c903ca77e1cd947a3bd4...9aba6f807ebaa4aca9885142ce2d6f5e162cb8cd,2,9,6,15,5,2010-01-18 23:53:08,2010-01-18 23:53:08
9aba6f807ebaa4aca9885142ce2d6f5e162cb8cd...e2d094b8fbb67b9d2a44fc107cd2c9bb3ac91990,3,9,9,18,6,2010-01-19 01:14:02,2010-01-19 01:14:02
e2d094b8fbb67b9d2a44fc107cd2c9bb3ac91990...b3e1162ca507c87ecea70d8100d24f431a8433ae,1,26,2,28,6,2010-01-19 01:25:30,2010-01-19 01:25:30
b3e1162ca507c87ecea70d8100d24f431a8433ae...fb5f8d7b14c6613dcfa600da11ea499c8551ba11,1,4,2,6,1,2010-01-19 18:09:03,2010-01-19 18:09:03
fb5f8d7b14c6613dcfa600da11ea499c8551ba11...5cd4c3e5595128bc1a3f28f2e30bab2e4dd3b1b7,1,5,5,10,1,2010-01-19 22:19:26,2010-01-19 22:19:26
5cd4c3e5595128bc1a3f28f2e30bab2e4dd3b1b7...1af45dc7bc711cd62867712c998e95c117999d43,1,6,1,7,1,2010-01-20 12:54:19,2010-01-20 12:54:19
1af45dc7bc711cd62867712c998e95c117999d43...63c5e6621aac1cdf4d02d0b99266251cd1643c26,1,29,46,75,9,2010-01-20 14:18:13,2010-01-20 14:18:13
63c5e6621aac1cdf4d02d0b99266251cd1643c26...856a39e841080abc34e8ae3bb2b20f780c33762d,3,51,16,67,5,2010-01-21 01:40:21,2010-01-21 01:40:21
856a39e841080abc34e8ae3bb2b20f780c33762d...408d4310291cd1287f3dbc05aaeb5d205eba8751,3,73,12,85,8,2010-01-21 02:28:03,2010-01-21 02:28:03
408d4310291cd1287f3dbc05aaeb5d205eba8751...86f283d4ca995c2b6cc7531249ba33b2bb6e1a4e,1,1,1,2,1,2010-01-21 03:02:13,2010-01-21 03:02:13
86f283d4ca995c2b6cc7531249ba33b2bb6e1a4e...acc095c333213eb1d978866ae5852cefe00ce4ef,3,15,7,22,4,2010-01-21 03:26:14,2010-01-21 03:26:14
acc095c333213eb1d978866ae5852cefe00ce4ef...1b3dc8ad9a28486542f766ff93318aa6b4f5999b,15,985,311,1296,99,2010-01-22 14:30:06,2010-01-22 14:30:06
1b3dc8ad9a28486542f766ff93318aa6b4f5999b...7ca9d9306c5e5e175668af513725a16ba3b26d9d,4,198,56,254,63,2010-01-22 15:02:02,2010-01-22 15:02:02
7ca9d9306c5e5e175668af513725a16ba3b26d9d...f114fbecc2a486df7fc65f7de1b635520ef1d5ba,2,14,1,15,3,2010-01-22 15:31:14,2010-01-22 15:31:14
f114fbecc2a486df7fc65f7de1b635520ef1d5ba...5ec44450df55d53416f9e1a17e73a695c36d749b,1,1,4,5,1,2010-01-22 18:30:23,2010-01-22 18:30:23
5ec44450df55d53416f9e1a17e73a695c36d749b...c1584383fa7b83b9c00a40a1f0b367b91f2f7382,3,43,10,53,9,2010-01-22 18:39:48,2010-01-22 18:39:48
c1584383fa7b83b9c00a40a1f0b367b91f2f7382...dbad025637463c31ba9d99c47546b409b8190b4b,1,4,4,8,3,2010-01-23 04:32:34,2010-01-23 04:32:34
dbad025637463c31ba9d99c47546b409b8190b4b...4d81874f9d65ecb002d252381a1e108b85f377e4,2,20,1,21,2,2010-01-23 16:44:42,2010-01-23 16:44:42
4d81874f9d65ecb002d252381a1e108b85f377e4...3df1a16c792d038c528e5e95797680a30ee7868c,1,1,1,2,1,2010-01-23 17:07:38,2010-01-23 17:07:38
3df1a16c792d038c528e5e95797680a30ee7868c...e71b10efb7366f9e80d54960d9e77cc527a7413e,3,7,1,8,5,2010-01-23 17:26:56,2010-01-23 17:26:56
e71b10efb7366f9e80d54960d9e77cc527a7413e...088f7170779b98547d9862603387afee77b964a8,3,73,3,76,5,2010-01-23 23:13:00,2010-01-23 23:13:00
088f7170779b98547d9862603387afee77b964a8...7f944a2b6898a18201f85a90efed2700403019ea,1,11,0,11,1,2010-01-23 23:38:36,2010-01-23 23:38:36
7f944a2b6898a18201f85a90efed2700403019ea...63d072581c62eb38d4b7f1dac3d261945f357546,1,6,1,7,1,2010-01-23 23:56:04,2010-01-23 23:56:04
63d072581c62eb38d4b7f1dac3d261945f357546...e6c5599494e5408c81b046d2b7410e9e4a98a7b5,3,18,6,24,10,2010-01-24 00:04:02,2010-01-24 00:04:02
e6c5599494e5408c81b046d2b7410e9e4a98a7b5...739d5aec0f85091ff26c2b5578ab597f8d17ca7f,1,9,7,16,2,2010-01-24 00:10:30,2010-01-24 00:10:30
739d5aec0f85091ff26c2b5578ab597f8d17ca7f...6755a039eb2739a2bdaac4cd9b333e8c83b75836,4,99,11,110,13,2010-01-25 12:05:38,2010-01-25 12:05:38
6755a039eb2739a2bdaac4cd9b333e8c83b75836...14116bc53eec6cd35447fad72b0fdaae84900d7d,8,107,67,174,32,2010-01-25 12:23:30,2010-01-25 12:23:30
14116bc53eec6cd35447fad72b0fdaae84900d7d...89f81810ed65f68b22d0e0b60ba589c814fb539a,1,0,2,2,1,2010-01-25 12:29:56,2010-01-25 12:29:56
89f81810ed65f68b22d0e0b60ba589c814fb539a...65c1dfe67bb03c92adcb0013db6ba8fa3ba12940,1,2,1,3,2,2010-01-25 18:14:30,2010-01-25 18:14:30
65c1dfe67bb03c92adcb0013db6ba8fa3ba12940...9cd1d6ed8760e7b53177fc452b64e50f6d3cc1f0,1,6,6,12,2,2010-01-25 19:28:36,2010-01-25 19:28:36
9cd1d6ed8760e7b53177fc452b64e50f6d3cc1f0...12d3799dd2248a3c6e61191355ed5ac43869c691,5,73,28,101,9,2010-01-26 01:38:50,2010-01-26 01:38:50
12d3799dd2248a3c6e61191355ed5ac43869c691...df82175c17667b76ac968e059583f795b8909526,2,31,40,71,13,2010-01-26 15:01:58,2010-01-26 15:01:58
df82175c17667b76ac968e059583f795b8909526...c14937cf7a1e8c25702e89485cc2dd33aa0d3a16,19,6503,36,6539,40,2010-01-26 15:02:53,2010-01-26 15:02:53
c14937cf7a1e8c25702e89485cc2dd33aa0d3a16...f109f36a06c362f3a2f698648a9cc3917abbfccd,7,163,97,260,14,2010-01-26 15:03:23,2010-01-26 15:03:23
f109f36a06c362f3a2f698648a9cc3917abbfccd...a260980f983afce5e98f1e1a7416567293fd5927,5,29,87,116,5,2010-01-26 15:03:52,2010-01-26 15:03:52
a260980f983afce5e98f1e1a7416567293fd5927...474ce51ffd9e7f0963d666bdb429f00b04cdaee3,4,10,4,14,7,2010-01-26 17:32:11,2010-01-26 17:32:11
474ce51ffd9e7f0963d666bdb429f00b04cdaee3...f9f04a49e85641a8cdd19ef57ed63e5be31cab0f,1,9,14,23,3,2010-01-27 03:01:13,2010-01-27 03:01:13
f9f04a49e85641a8cdd19ef57ed63e5be31cab0f...25f47bbbb66c4db9cb6a0a6325d6fef1da9001bf,4,44,14,58,11,2010-01-27 03:32:30,2010-01-27 03:32:30
25f47bbbb66c4db9cb6a0a6325d6fef1da9001bf...b0d218e9e26febb35fcb91ad1c748b95674f1e59,2,30,4,34,3,2010-01-27 03:47:37,2010-01-27 03:47:37
b0d218e9e26febb35fcb91ad1c748b95674f1e59...c8873bbba76bc52ab0766f98e8537b2fa66be71c,3,62,10,72,7,2010-01-27 07:56:53,2010-01-27 07:56:53
c8873bbba76bc52ab0766f98e8537b2fa66be71c...c6ee1f6f242a6fa5336ce7a670cebae72568ef0c,1,8,3,11,1,2010-01-27 07:57:18,2010-01-27 07:57:18
c6ee1f6f242a6fa5336ce7a670cebae72568ef0c...8e8d4b5888b73e5c0b2cfc77be4c6d5898546654,9,142,10,152,18,2010-01-27 08:21:35,2010-01-27 08:21:35
8e8d4b5888b73e5c0b2cfc77be4c6d5898546654...58cd220f51d5e294cb9e67c12a6e9d08523e282f,9,306,14,320,25,2010-01-27 13:30:29,2010-01-27 13:30:29
58cd220f51d5e294cb9e67c12a6e9d08523e282f...65b6080da2ef07cc4ef7a718a6d208562b2b68d8,1,3,2,5,1,2010-01-27 14:18:50,2010-01-27 14:18:50
65b6080da2ef07cc4ef7a718a6d208562b2b68d8...14acace0291186adc46f82342c53f86288f4ec6b,1,1,1,2,1,2010-01-27 16:24:48,2010-01-27 16:24:48
14acace0291186adc46f82342c53f86288f4ec6b...9a8449afe1b6d3654799c0b99fb50cd0ad63c747,1,0,1,1,1,2010-01-27 18:55:36,2010-01-27 18:55:36
9a8449afe1b6d3654799c0b99fb50cd0ad63c747...a6a176013aef229e368408b5d45eaff1321fe156,1,2,1,3,1,2010-01-27 19:42:03,2010-01-27 19:42:03
a6a176013aef229e368408b5d45eaff1321fe156...ff6b44980a3359981808dce8b5bc8500c171aa0c,2,27,13,40,4,2010-01-27 23:09:46,2010-01-27 23:09:46
ff6b44980a3359981808dce8b5bc8500c171aa0c...8f46cdec97b5203481a56dc637a44fd0e284969d,1,6,6,12,1,2010-01-27 23:48:41,2010-01-27 23:48:41
8f46cdec97b5203481a56dc637a44fd0e284969d...3f50119868e5d533f407fc8ca56f876f7624d440,1,9,0,9,1,2010-01-28 01:26:19,2010-01-28 01:26:19
3f50119868e5d533f407fc8ca56f876f7624d440...8daec78cfde2b4a4451050472bedb12cb1706b9b,8,204,41,245,24,2010-01-28 01:47:23,2010-01-28 01:47:23
8daec78cfde2b4a4451050472bedb12cb1706b9b...85fb4a86232deaf167839f5d82bb724d2e1a2eba,2,3,3,6,3,2010-01-28 01:56:51,2010-01-28 01:56:51
85fb4a86232deaf167839f5d82bb724d2e1a2eba...250a21922d05bd621f7646c59d7d6b16f5ba4cb8,2,388,239,627,216,2010-01-28 01:57:48,2010-01-28 01:57:48
250a21922d05bd621f7646c59d7d6b16f5ba4cb8...d5801537c4bf296a25dfb41eeca7332905b4ec64,2,118,111,229,95,2010-01-28 01:58:18,2010-01-28 01:58:18
d5801537c4bf296a25dfb41eeca7332905b4ec64...b63dd54bd7b9270142953c3e172c8652aaf159cf,4,554,542,1096,272,2010-01-28 01:58:53,2010-01-28 01:58:53
b63dd54bd7b9270142953c3e172c8652aaf159cf...8d550143484ea6f6e656675810c3a4d2a1c13028,2,10,8,18,8,2010-01-28 01:59:26,2010-01-28 01:59:26
8d550143484ea6f6e656675810c3a4d2a1c13028...cca3862fada509d33f55d8095f1ded27c477439d,3,1845,5,1850,10,2010-01-28 02:00:08,2010-01-28 02:00:08
cca3862fada509d33f55d8095f1ded27c477439d...5926f94be46b2e02d9104ac29e16568aabcabd83,2,305,298,603,293,2010-01-28 02:00:45,2010-01-28 02:00:45
5926f94be46b2e02d9104ac29e16568aabcabd83...ab638181ae5e5a2de8434ff081324c9f87bb8903,3,5117,0,5117,3,2010-01-28 02:01:28,2010-01-28 02:01:28
ab638181ae5e5a2de8434ff081324c9f87bb8903...70aee5b48f3142175fa0fa016510c8484000252e,3,1,1,2,1,2010-01-28 02:16:34,2010-01-28 02:16:34
70aee5b48f3142175fa0fa016510c8484000252e...7856a759d0af09bf6295087941a4dfc5e6589d72,1,8,3,11,1,2010-01-28 03:04:24,2010-01-28 03:04:24
7856a759d0af09bf6295087941a4dfc5e6589d72...0cdd36fac857d19105e3872364147a5cebd45513,1,3,2,5,3,2010-01-28 05:55:44,2010-01-28 05:55:44
0cdd36fac857d19105e3872364147a5cebd45513...3f68d255e24b5696537572ff351a8ad9f91d1b9d,1,7,1,8,2,2010-01-28 11:30:29,2010-01-28 11:30:29
3f68d255e24b5696537572ff351a8ad9f91d1b9d...c4c27d8a04c9125cfbc5c3611557d8e5d3845b0d,17,992,492,1484,130,2010-01-28 13:46:18,2010-01-28 13:46:18
c4c27d8a04c9125cfbc5c3611557d8e5d3845b0d...33f44736480b5ef2b1804372754824044feab18b,5,5131,0,5131,3,2010-01-28 14:17:15,2010-01-28 14:17:15
33f44736480b5ef2b1804372754824044feab18b...e808fc898b8a97601a174ff14ac500eaf07bc3ae,1,1,1,2,1,2010-01-28 14:46:29,2010-01-28 14:46:29
e808fc898b8a97601a174ff14ac500eaf07bc3ae...59cccd1474ca8ac4f691685372a607277534fa8e,1,4,4,8,4,2010-01-28 19:23:54,2010-01-28 19:23:54
59cccd1474ca8ac4f691685372a607277534fa8e...1e64f57683b9a521e9bfbb42ccc294c921926b25,1,8,0,8,1,2010-01-28 22:12:18,2010-01-28 22:12:18
1e64f57683b9a521e9bfbb42ccc294c921926b25...17335180959f73c7df496f0fb885e942b68ae502,2,70,59,129,49,2010-01-29 00:05:33,2010-01-29 00:05:33
17335180959f73c7df496f0fb885e942b68ae502...5b21033847848608359836d56349db5060b26d84,7,66,3,69,13,2010-01-29 02:20:58,2010-01-29 02:20:58
5b21033847848608359836d56349db5060b26d84...72c39410c80ee842bf3de22418086d102cb2b768,3,40,7,47,10,2010-01-29 02:46:07,2010-01-29 02:46:07
72c39410c80ee842bf3de22418086d102cb2b768...47acb1d659c0c589b6c6532f8618da0bb757324c,2,62,3,65,4,2010-01-29 08:10:29,2010-01-29 08:10:29
47acb1d659c0c589b6c6532f8618da0bb757324c...11ee9746a0530ec38f523fb4de44950d9b783877,7,113,22,135,31,2010-01-29 15:45:55,2010-01-29 15:45:55
11ee9746a0530ec38f523fb4de44950d9b783877...199cd0efcac5d0923480bcf3e7ba31b91f56db4f,3,37,4,41,7,2010-01-29 17:58:22,2010-01-29 17:58:22
199cd0efcac5d0923480bcf3e7ba31b91f56db4f...901b60e7e195d23b0f66caa3ecab1299a2e15235,1,3,2,5,2,2010-01-29 17:58:55,2010-01-29 17:58:55
901b60e7e195d23b0f66caa3ecab1299a2e15235...0741fb6507420653e8cb2533c823f221f1529242,1,8,7,15,6,2010-01-29 18:07:49,2010-01-29 18:07:49
0741fb6507420653e8cb2533c823f221f1529242...33b1036f6f6b1a1bf50254db093a13f7b19a4873,1,2,2,4,2,2010-01-29 18:38:28,2010-01-29 18:38:28
33b1036f6f6b1a1bf50254db093a13f7b19a4873...9a014a3a598bb0730319d38690716c474fdb925e,1,1,1,2,1,2010-01-30 02:25:33,2010-01-30 02:25:33
9a014a3a598bb0730319d38690716c474fdb925e...ee3132078d1c81490489fd989fd5d65581eb216b,1,16,4,20,2,2010-01-31 02:30:02,2010-01-31 02:30:02
ee3132078d1c81490489fd989fd5d65581eb216b...1f305a00a0dabd352ad9ceda5a35dedef4f72eb1,1,10,6,16,2,2010-01-31 23:38:17,2010-01-31 23:38:17
1f305a00a0dabd352ad9ceda5a35dedef4f72eb1...e0dd8a930b38a5a729b52fb85d23d1ad58c35064,1,0,16,16,1,2010-02-01 11:53:14,2010-02-01 11:53:14
e0dd8a930b38a5a729b52fb85d23d1ad58c35064...84599495a0332925ceae8e7902eb4cc8bfb3e635,2,70,16,86,8,2010-02-01 13:00:00,2010-02-01 13:00:00
84599495a0332925ceae8e7902eb4cc8bfb3e635...6c36e1034a5ff729ec4cc8a10423f24b331996e5,1,1,1,2,1,2010-02-01 14:12:24,2010-02-01 14:12:24
6c36e1034a5ff729ec4cc8a10423f24b331996e5...267346678d6fe2bbccf7394bae3c380af1a3a25c,3,48,2,50,6,2010-02-01 14:12:56,2010-02-01 14:12:56
267346678d6fe2bbccf7394bae3c380af1a3a25c...be90eadfb98b7f7115a5e19e141e522aefd3f69f,1,7,1,8,2,2010-02-01 14:13:21,2010-02-01 14:13:21
be90eadfb98b7f7115a5e19e141e522aefd3f69f...f70a0882a3d916cfd59c31d6a6f4316dce104466,1,2,2,4,2,2010-02-01 14:13:47,2010-02-01 14:13:47
f70a0882a3d916cfd59c31d6a6f4316dce104466...9555f2be9dc7c5cc1aeb3f4a047550ccd9b0cb2c,12,186,88,274,121,2010-02-01 14:14:56,2010-02-01 14:14:56
9555f2be9dc7c5cc1aeb3f4a047550ccd9b0cb2c...f839736c60ce95b71f35d21df31fa8402aee34e0,2,3,4,7,2,2010-02-01 14:15:27,2010-02-01 14:15:27
f839736c60ce95b71f35d21df31fa8402aee34e0...816fced5d728a13304a9d8b41f86a440c549b2f5,2,65,0,65,2,2010-02-01 14:16:01,2010-02-01 14:16:01
816fced5d728a13304a9d8b41f86a440c549b2f5...5dad2350f797883841b694793872a1fd95ad0ee5,3,12,6,18,3,2010-02-01 14:16:44,2010-02-01 14:16:44
5dad2350f797883841b694793872a1fd95ad0ee5...a0bae6ebb8105bfe649b21b001ab0b19dce59b2c,2,6,2,8,6,2010-02-01 14:19:30,2010-02-01 14:19:30
a0bae6ebb8105bfe649b21b001ab0b19dce59b2c...fbb42c31df691e3f83236ec8d3a25318ab759e87,2,17,9,26,9,2010-02-02 00:41:28,2010-02-02 00:41:28
fbb42c31df691e3f83236ec8d3a25318ab759e87...f9a33cbfde4a174a1c405f8b93d4848ed7f9b6bc,1,0,1,1,1,2010-02-02 13:01:27,2010-02-02 13:01:27
f9a33cbfde4a174a1c405f8b93d4848ed7f9b6bc...de35bb40af6174bc5d3cb1b12584cbdb11919ca7,1,3,0,3,1,2010-02-03 00:24:05,2010-02-03 00:24:05
de35bb40af6174bc5d3cb1b12584cbdb11919ca7...8e5c116971f519a4de2cf0a2f178bf990301e38b,1,1,1,2,1,2010-02-03 00:34:49,2010-02-03 00:34:49
8e5c116971f519a4de2cf0a2f178bf990301e38b...b740534dc4c68a6b4d30eef96f4d7f70c17c9e0d,1,1,1,2,1,2010-02-03 07:31:00,2010-02-03 07:31:00
b740534dc4c68a6b4d30eef96f4d7f70c17c9e0d...96a10094e8e7095e1c818231031d7bcbf9dac95a,1,1,1,2,1,2010-02-03 18:09:11,2010-02-03 18:09:11
96a10094e8e7095e1c818231031d7bcbf9dac95a...def34da85c22fecc03bf9d640c54664231a219f6,1,6,0,6,2,2010-02-04 21:47:19,2010-02-04 21:47:19
def34da85c22fecc03bf9d640c54664231a219f6...a28bd76bb6d3fa93f31e7769559fae26df7733f6,3,6,6,12,5,2010-02-05 00:44:35,2010-02-05 00:44:35
a28bd76bb6d3fa93f31e7769559fae26df7733f6...cdeb90e345b5458b0177347c9c630262a4913a56,1,13,15,28,7,2010-02-05 00:44:56,2010-02-05 00:44:56
cdeb90e345b5458b0177347c9c630262a4913a56...8600ad4c5087bbd86467c854c0c498802690b63c,4,60,29,89,6,2010-02-05 01:43:13,2010-02-05 01:43:13
8600ad4c5087bbd86467c854c0c498802690b63c...174352991231bedc9a7e68440509f40a14292e78,1,33,1,34,1,2010-02-05 15:42:22,2010-02-05 15:42:22
174352991231bedc9a7e68440509f40a14292e78...091a631601e5fb509e732f6a4308439d42dc0d03,1,2,2,4,2,2010-02-06 03:14:47,2010-02-06 03:14:47
091a631601e5fb509e732f6a4308439d42dc0d03...7f975df129f2f664178d5f9d32c94cba70f75174,1,218,0,218,1,2010-02-06 03:37:50,2010-02-06 03:37:50
7f975df129f2f664178d5f9d32c94cba70f75174...2638c90ce23527959d9c2356166c618385e91591,1,8,5,13,1,2010-02-06 03:57:02,2010-02-06 03:57:02
2638c90ce23527959d9c2356166c618385e91591...f30f1514f3847db6e61c4ae083e599bb21456428,1,44,90,134,8,2010-02-06 05:19:15,2010-02-06 05:19:15
f30f1514f3847db6e61c4ae083e599bb21456428...d4c034d0e149746b62db3ef74556fee5dda6b1bc,1,1,0,1,1,2010-02-06 05:25:50,2010-02-06 05:25:50
d4c034d0e149746b62db3ef74556fee5dda6b1bc...8c50f9de6a116ebfeca3ae34f6994a5c8d31293e,1,1,2,3,1,2010-02-06 05:32:46,2010-02-06 05:32:46
8c50f9de6a116ebfeca3ae34f6994a5c8d31293e...8c43d2e32a7e6410210e624f5e5cfdf19769f648,1,8,7,15,1,2010-02-06 05:48:03,2010-02-06 05:48:03
8c43d2e32a7e6410210e624f5e5cfdf19769f648...ae9866663ca62af8a9fbf6c8813b90743f449045,2,3,3,6,3,2010-02-06 06:05:44,2010-02-06 06:05:44
ae9866663ca62af8a9fbf6c8813b90743f449045...d334713ea2c827064e4d9dadec998f541095dcc6,1,9,9,18,1,2010-02-06 20:48:55,2010-02-06 20:48:55
d334713ea2c827064e4d9dadec998f541095dcc6...f5ee28931d1903f852c655637d88f81ccaa24eb8,1,2,0,2,2,2010-02-07 14:41:43,2010-02-07 14:41:43
f5ee28931d1903f852c655637d88f81ccaa24eb8...fdb9f83253d867d6ef3911349ebbf30dd39b9203,1,3,3,6,2,2010-02-07 14:42:16,2010-02-07 14:42:16
fdb9f83253d867d6ef3911349ebbf30dd39b9203...edb6d753a85d8548d9735b6f253a4a5d9a749c75,1,1,1,2,1,2010-02-07 15:55:40,2010-02-07 15:55:40
edb6d753a85d8548d9735b6f253a4a5d9a749c75...4bff19463361927ff752929da1bc04e9aa1c2e72,9,115,92,207,40,2010-02-09 15:02:39,2010-02-09 15:02:39
4bff19463361927ff752929da1bc04e9aa1c2e72...eaee55e547866f966a24d7b98bea93325bee9a79,3,14,52,66,19,2010-02-09 19:37:08,2010-02-09 19:37:08
eaee55e547866f966a24d7b98bea93325bee9a79...4682d693c4ab5447619d72be5626c4bbdcb655cd,1,2,2,4,2,2010-02-09 20:05:52,2010-02-09 20:05:52
4682d693c4ab5447619d72be5626c4bbdcb655cd...8f4540b2e68d4b9143d38d8af197cb4b794821b4,3,27,4,31,7,2010-02-10 00:34:45,2010-02-10 00:34:45
8f4540b2e68d4b9143d38d8af197cb4b794821b4...225c413b08b3e034604ffbaed604a6867d7b712e,3,3,3,6,3,2010-02-10 00:49:33,2010-02-10 00:49:33
225c413b08b3e034604ffbaed604a6867d7b712e...bb6b9aa47279e78d2a17a571da1a1523e3b70c5c,3,53,3,56,8,2010-02-10 19:21:52,2010-02-10 19:21:52
bb6b9aa47279e78d2a17a571da1a1523e3b70c5c...be57541af11b7144de700978b9ea3b50f20ffd02,1,2,0,2,1,2010-02-10 23:51:09,2010-02-10 23:51:09
be57541af11b7144de700978b9ea3b50f20ffd02...75ab212d12058494eaf171acfc762206d8a62d47,2,37,3,40,6,2010-02-11 12:06:26,2010-02-11 12:06:26
75ab212d12058494eaf171acfc762206d8a62d47...4d2f489bca6b1807724f4b619d70ae8d6d1bda08,1,1,1,2,1,2010-02-11 12:10:11,2010-02-11 12:10:11
4d2f489bca6b1807724f4b619d70ae8d6d1bda08...ab828da2b91c71987ef23baee4a1613fdb330c5f,3,8,6,14,4,2010-02-11 12:21:46,2010-02-11 12:21:46
ab828da2b91c71987ef23baee4a1613fdb330c5f...02d40b93f826558c5ed299e502812ac88b7ede12,1,8,4,12,4,2010-02-11 12:26:34,2010-02-11 12:26:34
02d40b93f826558c5ed299e502812ac88b7ede12...cc40651f212404240cda0f897fc570e123e75009,1,1,1,2,1,2010-02-13 11:59:09,2010-02-13 11:59:09
cc40651f212404240cda0f897fc570e123e75009...23d3450d5e596839cb27deb20d559d0cb558d987,2,0,11,11,2,2010-02-13 12:00:10,2010-02-13 12:00:10
23d3450d5e596839cb27deb20d559d0cb558d987...79857802b8f2cd01fe469a3b2fef918d48767a92,4,24,1,25,6,2010-02-13 12:01:14,2010-02-13 12:01:14
79857802b8f2cd01fe469a3b2fef918d48767a92...b794441951f7328bbe5bcac305386862fd88f967,6,9,10,19,6,2010-02-13 12:02:11,2010-02-13 12:02:11
b794441951f7328bbe5bcac305386862fd88f967...03924929ba212368240bd7a26b14208fba965cb9,6,27,3,30,7,2010-02-13 14:02:32,2010-02-13 14:02:32
03924929ba212368240bd7a26b14208fba965cb9...0e5836dc0791127ce1b15e1063a41a52649507b7,2,7,6,13,2,2010-02-13 14:36:21,2010-02-13 14:36:21
0e5836dc0791127ce1b15e1063a41a52649507b7...e6740cb39c94bb404797e6baed7bcdf534c422ed,2,10,1,11,2,2010-02-13 14:37:17,2010-02-13 14:37:17
e6740cb39c94bb404797e6baed7bcdf534c422ed...757898162670b1a3178af3a0dc9fa2921c48702c,6,41,14,55,11,2010-02-14 18:28:28,2010-02-14 18:28:28
757898162670b1a3178af3a0dc9fa2921c48702c...1d078be448ab45f5e865f50053a23705023e3c53,2,35,15,50,11,2010-02-14 18:36:48,2010-02-14 18:36:48
1d078be448ab45f5e865f50053a23705023e3c53...3d849047949c494e10fcb6c1f85fe9b43fd4f478,1,5,1,6,2,2010-02-14 18:39:42,2010-02-14 18:39:42
3d849047949c494e10fcb6c1f85fe9b43fd4f478...db0209e2b215052f13737249462b644ee85f0249,1,1,1,2,1,2010-02-14 18:43:47,2010-02-14 18:43:47
db0209e2b215052f13737249462b644ee85f0249...76afc30229812547f0624fc681710a877fe0fde8,2,9,3,12,4,2010-02-14 20:29:42,2010-02-14 20:29:42
76afc30229812547f0624fc681710a877fe0fde8...75d4e9326f0a1e2574f0b442e19bf14a424d7bf5,1,5,2,7,2,2010-02-15 02:17:07,2010-02-15 02:17:07
75d4e9326f0a1e2574f0b442e19bf14a424d7bf5...33a225cd89553c9d379f7f5ee85fb37353541949,8,0,99,99,6,2010-02-15 17:54:13,2010-02-15 17:54:13
33a225cd89553c9d379f7f5ee85fb37353541949...9b630a08572031f657fda18dae33d9a7567d4f28,1,7,6,13,6,2010-02-16 12:12:13,2010-02-16 12:12:13
9b630a08572031f657fda18dae33d9a7567d4f28...f93f056c32f614c9a130ec66824d94ec20526cdf,12,1293,1160,2453,19,2010-02-16 12:12:53,2010-02-16 12:12:53
f93f056c32f614c9a130ec66824d94ec20526cdf...e50eefceb6be7c074c3b48bc802fb766c22d25f2,6,47,1,48,3,2010-02-16 12:13:23,2010-02-16 12:13:23
e50eefceb6be7c074c3b48bc802fb766c22d25f2...71da5f62dab825e015864fd5604be46815e24ff1,2,47,0,47,2,2010-02-16 12:13:48,2010-02-16 12:13:48
71da5f62dab825e015864fd5604be46815e24ff1...fef575a7f927fd2b080abee63a600d333c26e52d,6,83,14,97,11,2010-02-16 12:14:27,2010-02-16 12:14:27
fef575a7f927fd2b080abee63a600d333c26e52d...eb26c9686bc1f9b9b5bcd10e861fc7d055845209,5,78,10,88,17,2010-02-16 12:15:04,2010-02-16 12:15:04
eb26c9686bc1f9b9b5bcd10e861fc7d055845209...89df0432f21909b25b690dc5ebe479a025a62bd0,2,48,4,52,9,2010-02-16 12:15:41,2010-02-16 12:15:41
89df0432f21909b25b690dc5ebe479a025a62bd0...16942e178f713537ba3d341192019cfd2874d89e,2,2,29,31,5,2010-02-16 12:16:01,2010-02-16 12:16:01
16942e178f713537ba3d341192019cfd2874d89e...12d40a9fd63d1b92d7410f8fec8adc69980daee0,11,148,4,152,9,2010-02-16 12:17:17,2010-02-16 12:17:17
12d40a9fd63d1b92d7410f8fec8adc69980daee0...342517000cedefef6c0e9f92945362fef3d2e39b,2,29,0,29,4,2010-02-16 12:17:37,2010-02-16 12:17:37
342517000cedefef6c0e9f92945362fef3d2e39b...eaa17e13e849a18b0b0fb19468bd65a31b86b3b7,7,74,10,84,18,2010-02-17 18:54:02,2010-02-17 18:54:02
eaa17e13e849a18b0b0fb19468bd65a31b86b3b7...b40f21e51c488a25c2374064ab5ebbe11ed4c3bc,1,25,7,32,2,2010-02-21 23:37:01,2010-02-21 23:37:01
b40f21e51c488a25c2374064ab5ebbe11ed4c3bc...0d37cfdc05b6ebfaf79b98204ccd2eb706554ff5,1,1,1,2,1,2010-02-21 23:37:19,2010-02-21 23:37:19
0d37cfdc05b6ebfaf79b98204ccd2eb706554ff5...b2c43df84ffbfceae481125941bdaf44b944d6e9,1,1,1,2,1,2010-02-21 23:37:35,2010-02-21 23:37:35
b2c43df84ffbfceae481125941bdaf44b944d6e9...421f0195c19917c9dc566741bb00a4e463b8a0a4,2,3,3,6,2,2010-02-21 23:37:54,2010-02-21 23:37:54
421f0195c19917c9dc566741bb00a4e463b8a0a4...373be1ec1fb06974c29790d732180c395f98c28e,1,2,2,4,2,2010-02-21 23:38:11,2010-02-21 23:38:11
373be1ec1fb06974c29790d732180c395f98c28e...6cafd4b21f89523410c7d4c34740884c6a3552d8,2,13,3,16,4,2010-02-21 23:38:33,2010-02-21 23:38:33
6cafd4b21f89523410c7d4c34740884c6a3552d8...ca9f0879fe5dcd8098ca0a15dcee7288e5497951,1,1,1,2,1,2010-02-21 23:38:50,2010-02-21 23:38:50
ca9f0879fe5dcd8098ca0a15dcee7288e5497951...579e8573c84d9c919883c5c1d3c9c5fadf673eba,1,3,3,6,3,2010-02-21 23:39:08,2010-02-21 23:39:08
579e8573c84d9c919883c5c1d3c9c5fadf673eba...d2d8b793192d3ad6a87796a8b5fc7de4229c1c79,1,1,1,2,1,2010-02-21 23:39:27,2010-02-21 23:39:27
d2d8b793192d3ad6a87796a8b5fc7de4229c1c79...2e91309c55a78e52acedc225d91b3d18bbf68cda,1,2,0,2,1,2010-02-21 23:39:45,2010-02-21 23:39:45
2e91309c55a78e52acedc225d91b3d18bbf68cda...1559f64549ebcc158a5d2bece208f674fa96f537,1,1,0,1,1,2010-02-21 23:40:03,2010-02-21 23:40:03
1559f64549ebcc158a5d2bece208f674fa96f537...67d4289c2ef56022d14a038a644d020997e2d9c9,9,68,39,107,14,2010-02-21 23:40:47,2010-02-21 23:40:47
67d4289c2ef56022d14a038a644d020997e2d9c9...8d8237fa414abeda642d5063f5917ffe170609cc,1,1,1,2,1,2010-02-21 23:41:05,2010-02-21 23:41:05
8d8237fa414abeda642d5063f5917ffe170609cc...a8b975e4a95459e092a8a96fe8b1988a2827e751,7,5192,0,5192,4,2010-02-21 23:41:37,2010-02-21 23:41:37
a8b975e4a95459e092a8a96fe8b1988a2827e751...99f8cd48238290bbca057b3cc7973b6de4977370,2,1238,549,1787,309,2010-02-21 23:42:03,2010-02-21 23:42:03
99f8cd48238290bbca057b3cc7973b6de4977370...a88cbc141d544ba437545a8470282e16ddc1d3e3,2,1266,602,1868,306,2010-02-21 23:42:30,2010-02-21 23:42:30
a88cbc141d544ba437545a8470282e16ddc1d3e3...b459f5b7e3be65bbd554e03626ff255d4a68e9fc,4,72,10,82,8,2010-02-21 23:42:57,2010-02-21 23:42:57
b459f5b7e3be65bbd554e03626ff255d4a68e9fc...84f8213d74817b8d5aaf81dfa611e919d5266360,4,29,14,43,8,2010-02-21 23:43:28,2010-02-21 23:43:28
84f8213d74817b8d5aaf81dfa611e919d5266360...0d4726f5189ff2d138435fed223b91e6af167777,3,38,6,44,6,2010-02-21 23:44:05,2010-02-21 23:44:05
0d4726f5189ff2d138435fed223b91e6af167777...7f5d9ad661d65a869cd72b736250936a942d5d2b,3,56,2,58,8,2010-02-21 23:44:35,2010-02-21 23:44:35
7f5d9ad661d65a869cd72b736250936a942d5d2b...8e1a4bd6772738ff1659f3b12f9a5186c5b64385,3,128,96,224,5,2010-02-21 23:45:04,2010-02-21 23:45:04
8e1a4bd6772738ff1659f3b12f9a5186c5b64385...d5c4d5fa235e46c94acfbca2cac1839f56668df9,4,1299,625,1924,324,2010-02-21 23:45:38,2010-02-21 23:45:38
d5c4d5fa235e46c94acfbca2cac1839f56668df9...84cffa2ecea8b52508af31281c197f1edbbb6e85,1,1,1,2,1,2010-02-22 02:29:39,2010-02-22 02:29:39
84cffa2ecea8b52508af31281c197f1edbbb6e85...98101787067dd6fd9e7bf2c852bb403615cdd9e3,1,1,1,2,1,2010-02-22 02:35:47,2010-02-22 02:35:47
98101787067dd6fd9e7bf2c852bb403615cdd9e3...a9b2ac25d1760e1b8e01632544b7f503ccab8577,3,23,2,25,4,2010-02-22 05:00:36,2010-02-22 05:00:36
a9b2ac25d1760e1b8e01632544b7f503ccab8577...2fc19d8d6f369d4bd1ef8c7175c241a10e24c6f0,2,20,19,39,19,2010-02-22 12:34:52,2010-02-22 12:34:52
2fc19d8d6f369d4bd1ef8c7175c241a10e24c6f0...eb67e449dde298a35664c0daea61860ac63a1f58,2,60,5,65,12,2010-02-22 13:09:02,2010-02-22 13:09:02
eb67e449dde298a35664c0daea61860ac63a1f58...e6db084ac8fdf04ba20b5976a1cebfb77d55c97e,4,29,19,48,8,2010-02-22 14:04:13,2010-02-22 14:04:13
e6db084ac8fdf04ba20b5976a1cebfb77d55c97e...692fd7da5e5bfe1533c40f94999ea42f9b986356,2,11,3,14,5,2010-02-22 14:38:44,2010-02-22 14:38:44
692fd7da5e5bfe1533c40f94999ea42f9b986356...a3e2ddde65d17f9683eb2d5ea5e9da89d16b385c,1,0,2,2,1,2010-02-22 15:48:19,2010-02-22 15:48:19
a3e2ddde65d17f9683eb2d5ea5e9da89d16b385c...7573c4a9f7b4ab94b835595c35f4ef1154a7e408,1,11,2,13,2,2010-02-22 20:25:43,2010-02-22 20:25:43
7573c4a9f7b4ab94b835595c35f4ef1154a7e408...9b8c44c3ed60ab6d41af5fa9dad88d41d47dc45f,1,1,1,2,1,2010-02-22 20:27:58,2010-02-22 20:27:58
9b8c44c3ed60ab6d41af5fa9dad88d41d47dc45f...eb0751a4c0b2d5e248ff3babc37a4764b102e25a,2,42,3,45,7,2010-02-22 23:06:09,2010-02-22 23:06:09
eb0751a4c0b2d5e248ff3babc37a4764b102e25a...49d6a82261feda6ee1bf23bb17184e932e232172,3,39,1,40,3,2010-02-22 23:34:33,2010-02-22 23:34:33
49d6a82261feda6ee1bf23bb17184e932e232172...b3d20ade47aadce5bd02ff33ea7dc0e19cf004cb,3,38,4,42,5,2010-02-22 23:38:18,2010-02-22 23:38:18
b3d20ade47aadce5bd02ff33ea7dc0e19cf004cb...c1d795df454b9f6500d3b704e68bddd10f0e17eb,1,1,3,4,2,2010-02-22 23:42:53,2010-02-22 23:42:53
c1d795df454b9f6500d3b704e68bddd10f0e17eb...6ed7bd5609d298858c02d5d3b6357b434df06d9f,4,17,22,39,11,2010-02-23 04:39:39,2010-02-23 04:39:39
6ed7bd5609d298858c02d5d3b6357b434df06d9f...349827996b5bcf29886bd1e57bc07147d840229e,3,31,7,38,5,2010-02-23 05:17:39,2010-02-23 05:17:39
349827996b5bcf29886bd1e57bc07147d840229e...c4699b0b8a8503e552de1fe4f873685f7037b337,5,35,2,37,5,2010-02-23 05:22:12,2010-02-23 05:22:12
c4699b0b8a8503e552de1fe4f873685f7037b337...5546430304f1310e76b217bb3b6e3597d9b87359,3,6,1,7,3,2010-02-23 05:26:49,2010-02-23 05:26:49
5546430304f1310e76b217bb3b6e3597d9b87359...1d5165e3be03ffb2b886b34cf0c1377ce958d12d,4,49,2,51,7,2010-02-23 05:52:37,2010-02-23 05:52:37
1d5165e3be03ffb2b886b34cf0c1377ce958d12d...7ca3e8fecf3788d219720138be3ec80fec527ab6,2,2,6,8,2,2010-02-23 06:04:06,2010-02-23 06:04:06
7ca3e8fecf3788d219720138be3ec80fec527ab6...6b2f125b80807231e0a216c0193089f3a40f7253,1,5,27,32,2,2010-02-23 12:02:41,2010-02-23 12:02:41
6b2f125b80807231e0a216c0193089f3a40f7253...156cdcf92decdf18a87a1229ba4ef8da1e6972ab,3,21,0,21,3,2010-02-23 12:24:41,2010-02-23 12:24:41
156cdcf92decdf18a87a1229ba4ef8da1e6972ab...ea695f86688fa4beda26a08851e8c9fd5595c3d7,1,1,1,2,1,2010-02-23 12:26:50,2010-02-23 12:26:50
ea695f86688fa4beda26a08851e8c9fd5595c3d7...c646b994539c6d8a35298e06f6a4e8f3ad0c68c8,1,1,1,2,1,2010-02-23 12:33:20,2010-02-23 12:33:20
c646b994539c6d8a35298e06f6a4e8f3ad0c68c8...df5e1f7860a0237b7691eb6a58701b7f54327ed2,1,1,1,2,1,2010-02-23 13:19:24,2010-02-23 13:19:24
df5e1f7860a0237b7691eb6a58701b7f54327ed2...745b89f6e1a7e71a408c506497c4c66114cf1066,1,2,0,2,1,2010-02-23 13:19:49,2010-02-23 13:19:49
745b89f6e1a7e71a408c506497c4c66114cf1066...c306b78150501086e120f5effc8478924b364352,1,8,3,11,2,2010-02-23 13:20:27,2010-02-23 13:20:27
c306b78150501086e120f5effc8478924b364352...a555df4c065c9733e1cd459b31dbb4574501ddf7,1,9,8,17,3,2010-02-23 13:21:07,2010-02-23 13:21:07
a555df4c065c9733e1cd459b31dbb4574501ddf7...5825fb63b4934a5eb884ba8bc52f5e5f1df277b7,1,5,5,10,2,2010-02-23 13:22:05,2010-02-23 13:22:05
5825fb63b4934a5eb884ba8bc52f5e5f1df277b7...f9c8615e1fbd6490d566f179e5fc3bf18ce51268,1,1,0,1,1,2010-02-23 13:22:52,2010-02-23 13:22:52
f9c8615e1fbd6490d566f179e5fc3bf18ce51268...871a99c948bcfe7e59bf93df4bcd00cffcbf94f2,2,21,3,24,2,2010-02-23 14:17:42,2010-02-23 14:17:42
871a99c948bcfe7e59bf93df4bcd00cffcbf94f2...7aeb37d610700fe25b07d5e76b943cc3d51ab1a5,2,27,0,27,2,2010-02-23 14:48:15,2010-02-23 14:48:15
7aeb37d610700fe25b07d5e76b943cc3d51ab1a5...8da76ffeaa47547edb24f99a55f8c9e1a8986b90,2,8,1,9,3,2010-02-23 14:59:30,2010-02-23 14:59:30
8da76ffeaa47547edb24f99a55f8c9e1a8986b90...bca753e283366101991dbc1758b66fd9339ba32d,3,6,3,9,5,2010-02-23 15:00:33,2010-02-23 15:00:33
bca753e283366101991dbc1758b66fd9339ba32d...06a880f7305e589cc1d50f145fe55faeda94f9a8,1,1,1,2,1,2010-02-23 15:09:52,2010-02-23 15:09:52
06a880f7305e589cc1d50f145fe55faeda94f9a8...10b187144169b93ab913d90d218fe4cbfbf507bf,1,3,3,6,3,2010-02-23 16:09:39,2010-02-23 16:09:39
10b187144169b93ab913d90d218fe4cbfbf507bf...f2d5582c53f9b667f482842cbb3213db91d35d5e,9,95,4,99,13,2010-02-23 17:14:50,2010-02-23 17:14:50
f2d5582c53f9b667f482842cbb3213db91d35d5e...0f1769555e1d43ff83f3a715095ac28f24499c2a,1,1,1,2,1,2010-02-23 17:30:12,2010-02-23 17:30:12
0f1769555e1d43ff83f3a715095ac28f24499c2a...7352238e16110c139031b01343379596830c48a3,2,3,3,6,3,2010-02-23 18:27:51,2010-02-23 18:27:51
7352238e16110c139031b01343379596830c48a3...fd233f40d1922c6f3d9dd0e5738397bdc4aac9ef,2,15,2,17,4,2010-02-23 18:50:57,2010-02-23 18:50:57
fd233f40d1922c6f3d9dd0e5738397bdc4aac9ef...3f443363f9bd65fdb77a20693637e721696c0414,2,2,2,4,2,2010-02-23 18:56:00,2010-02-23 18:56:00
3f443363f9bd65fdb77a20693637e721696c0414...65b451ae3e3017154e352d300ae6f8152c506b06,3,19,2,21,4,2010-02-23 19:24:27,2010-02-23 19:24:27
65b451ae3e3017154e352d300ae6f8152c506b06...c05de31d75970e3d5ea9ecec37e332a0f01c0fbb,3,21,5,26,5,2010-02-23 19:39:06,2010-02-23 19:39:06
c05de31d75970e3d5ea9ecec37e332a0f01c0fbb...6ba5fb37287ab88e2039d754e89788bb864ee123,3,40,5,45,4,2010-02-23 20:02:18,2010-02-23 20:02:18
6ba5fb37287ab88e2039d754e89788bb864ee123...2164e138e32cf8b00a0e43025c64150ec1238cf8,4,121,7,128,12,2010-02-23 20:45:28,2010-02-23 20:45:28
2164e138e32cf8b00a0e43025c64150ec1238cf8...c8fa1100930e9741848160fa1fd516e2eb315018,2,37,0,37,2,2010-02-23 20:45:50,2010-02-23 20:45:50
c8fa1100930e9741848160fa1fd516e2eb315018...ea3853e8d294deebe47d7845b332bef5dbe5f03e,3,34,1,35,4,2010-02-23 20:55:42,2010-02-23 20:55:42
ea3853e8d294deebe47d7845b332bef5dbe5f03e...43b47a87d3ae075937b7dc181f8284576e5d73ac,1,3,2,5,1,2010-02-23 21:58:58,2010-02-23 21:58:58
43b47a87d3ae075937b7dc181f8284576e5d73ac...5366aa96fef0ce55fc425cf273c7debe74d99305,4,29,16,45,19,2010-02-23 22:39:22,2010-02-23 22:39:22
5366aa96fef0ce55fc425cf273c7debe74d99305...d30ff7760214186667d9344e9884e0fed248d9dd,1,1,1,2,1,2010-02-23 23:02:10,2010-02-23 23:02:10
d30ff7760214186667d9344e9884e0fed248d9dd...d47b9ec2c71868105df41e50020c9ec2eae76b62,1,1,1,2,1,2010-02-23 23:23:38,2010-02-23 23:23:38
d47b9ec2c71868105df41e50020c9ec2eae76b62...445e0a5c3e40dbcfd866b4594371b0fa49fdc223,2,24,1,25,2,2010-02-23 23:37:45,2010-02-23 23:37:45
445e0a5c3e40dbcfd866b4594371b0fa49fdc223...3349a8016f71563f7c1177a32d6ec61eab32f4d3,1,1,2,3,1,2010-02-24 13:54:53,2010-02-24 13:54:53
3349a8016f71563f7c1177a32d6ec61eab32f4d3...841210b308ae76ed8748c76f54b7d9343c8140a1,2,4,0,4,2,2010-02-24 13:55:37,2010-02-24 13:55:37
841210b308ae76ed8748c76f54b7d9343c8140a1...d7927377703bb2b99702907c448e2195f4801687,1,8,0,8,1,2010-02-24 13:56:19,2010-02-24 13:56:19
d7927377703bb2b99702907c448e2195f4801687...6f9ba54bf5f52e8a5dde06763de60331537e4386,1,10,6,16,4,2010-02-24 13:57:02,2010-02-24 13:57:02
6f9ba54bf5f52e8a5dde06763de60331537e4386...de1ff3e51d3e790193c9ce9a03e0e9396134786f,1,19,16,35,6,2010-02-24 13:57:46,2010-02-24 13:57:46
de1ff3e51d3e790193c9ce9a03e0e9396134786f...1089bda54600b55a73f09c53c9b6dcee2f197b17,3,73,8,81,7,2010-02-24 14:32:11,2010-02-24 14:32:11
1089bda54600b55a73f09c53c9b6dcee2f197b17...6237768b5132d582c3e1588213ef5cf84d9d9158,2,8,0,8,4,2010-02-24 14:49:38,2010-02-24 14:49:38
6237768b5132d582c3e1588213ef5cf84d9d9158...d76fc2c2a028ed8672c5a89ebc0f9182ef080dde,1,1,1,2,1,2010-02-24 14:50:37,2010-02-24 14:50:37
d76fc2c2a028ed8672c5a89ebc0f9182ef080dde...2f45af6f58eaf30962b0cbc75b6bb79aaf8f347e,3,45,4,49,6,2010-02-24 15:29:25,2010-02-24 15:29:25
2f45af6f58eaf30962b0cbc75b6bb79aaf8f347e...ae43f651f2bfee0da8dbad6c22eba85ba4b168f6,2,330,292,622,246,2010-02-24 15:33:14,2010-02-24 15:33:14
ae43f651f2bfee0da8dbad6c22eba85ba4b168f6...9f4bf525f887db32b7260909a0140d68910aa042,3,12,6,18,5,2010-02-24 15:54:03,2010-02-24 15:54:03
9f4bf525f887db32b7260909a0140d68910aa042...16fe73d918c8a35f7122aed858312bd3163ac454,5,48,25,73,7,2010-02-24 17:36:18,2010-02-24 17:36:18
16fe73d918c8a35f7122aed858312bd3163ac454...ff963358d7d3eb31b51f3d74581b8e17025e3859,5,117,49,166,10,2010-02-24 19:06:59,2010-02-24 19:06:59
ff963358d7d3eb31b51f3d74581b8e17025e3859...3304afa67a39df10dca432aa5297d15a1795aae6,1,4,0,4,1,2010-02-24 19:39:04,2010-02-24 19:39:04
3304afa67a39df10dca432aa5297d15a1795aae6...c8cd8b80aa90f463814e1957d26e4a11f2f94414,2,10,3,13,2,2010-02-24 20:52:14,2010-02-24 20:52:14
c8cd8b80aa90f463814e1957d26e4a11f2f94414...dc1ad69f30f48d3c27406373f62f87e93550cdc5,1,27,25,52,14,2010-02-24 21:20:02,2010-02-24 21:20:02
dc1ad69f30f48d3c27406373f62f87e93550cdc5...83e52e316225650467ebbee2d86eff7bd5b566e7,1,7,4,11,6,2010-02-24 21:58:01,2010-02-24 21:58:01
83e52e316225650467ebbee2d86eff7bd5b566e7...c736cbe81645bcb0aa608ae3588edaf01f787806,1,1,1,2,1,2010-02-24 22:11:49,2010-02-24 22:11:49
c736cbe81645bcb0aa608ae3588edaf01f787806...e488c1dc0d29f2de0d8bb31db604aa6384b7a60b,2,21,3,24,4,2010-02-25 17:18:27,2010-02-25 17:18:27
e488c1dc0d29f2de0d8bb31db604aa6384b7a60b...126ca330e230034081182ec8a4bf1f47260b6cb9,1,10,5,15,2,2010-02-26 11:26:41,2010-02-26 11:26:41
126ca330e230034081182ec8a4bf1f47260b6cb9...e12b3199d0c01694ca6b09add5e0f27cadffc8ad,10,417,143,560,30,2010-02-26 13:17:43,2010-02-26 13:17:43
e12b3199d0c01694ca6b09add5e0f27cadffc8ad...0ff624a3cb075800e6c84cf80e36b085e23cf270,1,53,0,53,1,2010-02-26 13:22:52,2010-02-26 13:22:52
0ff624a3cb075800e6c84cf80e36b085e23cf270...46cc7021a8ab60190d81e9d7e039cd84efbafb23,6,40,24,64,7,2010-02-26 15:33:27,2010-02-26 15:33:27
46cc7021a8ab60190d81e9d7e039cd84efbafb23...5670331343f7a31c7c9f4d15b8ccb09efb15a920,2,10,4,14,6,2010-02-26 16:11:25,2010-02-26 16:11:25
5670331343f7a31c7c9f4d15b8ccb09efb15a920...5787925cdbb258091c283b424498821122de6992,3,86,20,106,26,2010-02-26 17:05:52,2010-02-26 17:05:52
5787925cdbb258091c283b424498821122de6992...c9151bcba1533756fc6e540c6fb599ed037267a8,2,14,0,14,3,2010-02-26 17:06:09,2010-02-26 17:06:09
c9151bcba1533756fc6e540c6fb599ed037267a8...41c30f2fb86f32c19a61f37d890967d000ad5d90,2,5,5,10,2,2010-02-27 05:38:17,2010-02-27 05:38:17
41c30f2fb86f32c19a61f37d890967d000ad5d90...9fab1467c734a92dfec0ccae27fe841d3b4a3c33,4,17,17,34,12,2010-02-27 16:30:27,2010-02-27 16:30:27
9fab1467c734a92dfec0ccae27fe841d3b4a3c33...9f592ecced6c489c3f2feb418f9005bebc189cd6,1,3,3,6,1,2010-02-27 21:00:38,2010-02-27 21:00:38
9f592ecced6c489c3f2feb418f9005bebc189cd6...d7abb33e70cf91c983b997cbeafbea2cd0371762,1,2,1,3,1,2010-02-27 21:08:30,2010-02-27 21:08:30
d7abb33e70cf91c983b997cbeafbea2cd0371762...68f216a6925e5e0d78e499157b2c2a261bb7f24c,2,14,12,26,7,2010-02-28 12:01:18,2010-02-28 12:01:18
68f216a6925e5e0d78e499157b2c2a261bb7f24c...9e95d6f6047a43268d3138a03342ad0534c4362b,6,51,1,52,5,2010-02-28 15:18:03,2010-02-28 15:18:03
9e95d6f6047a43268d3138a03342ad0534c4362b...68dd63b984b824407f59280515fc94d853ec3b7c,1,2,2,4,1,2010-02-28 15:24:09,2010-02-28 15:24:09
68dd63b984b824407f59280515fc94d853ec3b7c...284e7e3cbdc1b0efb46f35485194d6a5f9b201dc,3,16,9,25,7,2010-03-01 10:19:01,2010-03-01 10:19:01
284e7e3cbdc1b0efb46f35485194d6a5f9b201dc...0d2a24fd4234d2c6551179b1ef4694229602ba90,5,75,33,108,29,2010-03-01 10:19:24,2010-03-01 10:19:24
0d2a24fd4234d2c6551179b1ef4694229602ba90...2dafe4ac3a8236621b4ee58bb2a17ebfeb06b900,2,10,13,23,6,2010-03-01 14:34:07,2010-03-01 14:34:07
2dafe4ac3a8236621b4ee58bb2a17ebfeb06b900...e889b69dd2028be4010dcad5688809c03ff4e2e2,1,3,3,6,3,2010-03-01 14:34:24,2010-03-01 14:34:24
e889b69dd2028be4010dcad5688809c03ff4e2e2...c6b737c243ddcd72a3359a136c31b8e8fa3f992a,1,18,0,18,9,2010-03-01 14:43:26,2010-03-01 14:43:26
c6b737c243ddcd72a3359a136c31b8e8fa3f992a...d2dffd78e6377b59d82bacfbd70ed78c4c611be5,2,45,3,48,4,2010-03-01 18:43:27,2010-03-01 18:43:27
d2dffd78e6377b59d82bacfbd70ed78c4c611be5...647651698fb84d864f911db15503f77acdd0cbf0,1,1,1,2,1,2010-03-01 18:58:54,2010-03-01 18:58:54
647651698fb84d864f911db15503f77acdd0cbf0...c8015052d935a99a5c8f96434b2d0cd16d8a4e14,5,22,12,34,10,2010-03-01 19:49:05,2010-03-01 19:49:05
c8015052d935a99a5c8f96434b2d0cd16d8a4e14...6e748b5db4ea6db78ce389f474c2fb78ee3976ed,2,65,5,70,14,2010-03-01 19:58:53,2010-03-01 19:58:53
6e748b5db4ea6db78ce389f474c2fb78ee3976ed...b3a56755d7f0761a14541bd6d86b9960bb5de202,2,11,7,18,3,2010-03-01 20:11:24,2010-03-01 20:11:24
b3a56755d7f0761a14541bd6d86b9960bb5de202...8b2662c5de3cdb0926c7e48576a01cfcb07dfef6,1,5,6,11,1,2010-03-01 20:18:52,2010-03-01 20:18:52
8b2662c5de3cdb0926c7e48576a01cfcb07dfef6...973bf6f4856ec3769398caa643ccc61dff4b19f4,3,34,6,40,4,2010-03-01 20:30:44,2010-03-01 20:30:44
973bf6f4856ec3769398caa643ccc61dff4b19f4...698410ab6fd480c4ea08a7adfb4694404ef9ba15,4,50,7,57,6,2010-03-01 23:05:35,2010-03-01 23:05:35
698410ab6fd480c4ea08a7adfb4694404ef9ba15...4c18facdf7d0f609cd7f3c72c142d7be7b14a6c9,1,11,5,16,3,2010-03-01 23:26:08,2010-03-01 23:26:08
4c18facdf7d0f609cd7f3c72c142d7be7b14a6c9...17c466a57bb6dc94a404af3fec24ef1c9f4a4e31,1,1,1,2,1,2010-03-01 23:59:22,2010-03-01 23:59:22
17c466a57bb6dc94a404af3fec24ef1c9f4a4e31...2890c2295bbd9144e30a74e7be9d11b4903a5101,3,32,1,33,4,2010-03-02 02:28:49,2010-03-02 02:28:49
2890c2295bbd9144e30a74e7be9d11b4903a5101...6d7754ba034ef9890b5b18c630c21e7252e664eb,1,2,1,3,1,2010-03-02 03:28:48,2010-03-02 03:28:48
6d7754ba034ef9890b5b18c630c21e7252e664eb...ecb56cecbddffe7f06e94a08d2d71713d85514e4,1,9,3,12,2,2010-03-02 04:04:23,2010-03-02 04:04:23
ecb56cecbddffe7f06e94a08d2d71713d85514e4...f034c79cbc4f1a235e53d4ec666885ab8e9af8d9,4,70,18,88,11,2010-03-02 07:42:51,2010-03-02 07:42:51
f034c79cbc4f1a235e53d4ec666885ab8e9af8d9...135781f46e6d07bebafb328a3b11f4102861abd7,2,139,132,271,103,2010-03-02 08:44:42,2010-03-02 08:44:42
135781f46e6d07bebafb328a3b11f4102861abd7...53eeab64e4dcbad6e859ed539df8dc5b75ecf9cf,1,1,1,2,1,2010-03-02 15:42:32,2010-03-02 15:42:32
53eeab64e4dcbad6e859ed539df8dc5b75ecf9cf...125c748cf6d59012ac6c9e6935d7692f615d0e14,3,34,5,39,6,2010-03-02 19:37:48,2010-03-02 19:37:48
125c748cf6d59012ac6c9e6935d7692f615d0e14...600aa6679ed98d132fc378dfa205f482a58cceb1,2,8,7,15,7,2010-03-02 21:58:49,2010-03-02 21:58:49
600aa6679ed98d132fc378dfa205f482a58cceb1...9a82ca0a36798d0ca33353cd933cdbc8da0f677b,2,15,1,16,2,2010-03-03 08:01:48,2010-03-03 08:01:48
9a82ca0a36798d0ca33353cd933cdbc8da0f677b...6edcd11aedc1dca4d67fdbe7478d40406dc88730,2,8,4,12,4,2010-03-03 08:17:51,2010-03-03 08:17:51
6edcd11aedc1dca4d67fdbe7478d40406dc88730...1f56ed7319a20f3508a6629d3bca83c523e9d4f3,1,6,2,8,1,2010-03-03 08:34:31,2010-03-03 08:34:31
1f56ed7319a20f3508a6629d3bca83c523e9d4f3...cdd95077a6c7ebd794dc6cfc41085f9da46f3d96,1,7,0,7,1,2010-03-03 08:43:05,2010-03-03 08:43:05
cdd95077a6c7ebd794dc6cfc41085f9da46f3d96...795e3235ffea86117848b0b3c970b86f443daec3,1,8,0,8,1,2010-03-03 08:51:46,2010-03-03 08:51:46
795e3235ffea86117848b0b3c970b86f443daec3...926bf195e007cb4f97e6ddc4bd963cb5a8d48288,1,15,0,15,1,2010-03-03 09:01:13,2010-03-03 09:01:13
926bf195e007cb4f97e6ddc4bd963cb5a8d48288...4e65d73e9ee732883400fe444f2120c9b3757b1e,1,2,0,2,1,2010-03-03 09:07:36,2010-03-03 09:07:36
4e65d73e9ee732883400fe444f2120c9b3757b1e...0a0748a7d68ae01f99de2bfbbdd8441c1a0ecad2,1,9,9,18,4,2010-03-03 13:40:52,2010-03-03 13:40:52
0a0748a7d68ae01f99de2bfbbdd8441c1a0ecad2...eb11229ba74d7918148f34851b6e0d2cfc16d681,4,12,3,15,6,2010-03-05 18:53:07,2010-03-05 18:53:07
eb11229ba74d7918148f34851b6e0d2cfc16d681...80545c3685c29854990eaf17a96fc65d428f620f,2,16,2,18,2,2010-03-05 20:17:52,2010-03-05 20:17:52
80545c3685c29854990eaf17a96fc65d428f620f...68f4d1256a535e675aa202a2ee917c02371ae70a,2,62,15,77,17,2010-03-05 21:27:58,2010-03-05 21:27:58
68f4d1256a535e675aa202a2ee917c02371ae70a...4960095e0cfe65ef09518c8c35a4157e95b872c1,1,1,1,2,1,2010-03-06 11:10:25,2010-03-06 11:10:25
4960095e0cfe65ef09518c8c35a4157e95b872c1...98aecaa999c156385d12997f05d53edd6ca90ac8,1,1,1,2,1,2010-03-06 11:11:55,2010-03-06 11:11:55
98aecaa999c156385d12997f05d53edd6ca90ac8...bb3d93f2905315e179894b225b216524658ded6d,1,11,0,11,1,2010-03-06 11:20:50,2010-03-06 11:20:50
bb3d93f2905315e179894b225b216524658ded6d...a2c4ad1dabf58130e0c97636dd401bb615f715ee,2,5,3,8,3,2010-03-06 15:50:12,2010-03-06 15:50:12
a2c4ad1dabf58130e0c97636dd401bb615f715ee...b88f969789a5d69c770c25e1af9a2f4292184a6f,3,44,15,59,10,2010-03-06 18:42:56,2010-03-06 18:42:56
b88f969789a5d69c770c25e1af9a2f4292184a6f...90616a77f0e7850ccb830d7d8533640f4dbf99db,1,0,1,1,1,2010-03-06 19:01:47,2010-03-06 19:01:47
90616a77f0e7850ccb830d7d8533640f4dbf99db...fa6c967438e8c22b63b3cc0ef71815525f15856a,2,23,0,23,2,2010-03-06 19:51:29,2010-03-06 19:51:29
fa6c967438e8c22b63b3cc0ef71815525f15856a...9a67543c3e104c5d8212a6f9c94a43dde27cdb3d,1,5,5,10,1,2010-03-07 00:51:29,2010-03-07 00:51:29
9a67543c3e104c5d8212a6f9c94a43dde27cdb3d...686dac03b7d6086730234512425f5e81baee7cbd,2,15,1,16,2,2010-03-07 01:50:58,2010-03-07 01:50:58
686dac03b7d6086730234512425f5e81baee7cbd...5beb5f73722f7807f2be4e95b2fbe4a0e5dcd232,2,55,2,57,8,2010-03-07 03:33:07,2010-03-07 03:33:07
5beb5f73722f7807f2be4e95b2fbe4a0e5dcd232...3508a86ddf86da7a6b1444f89217e45b3514c722,2,13,6,19,7,2010-03-07 07:11:22,2010-03-07 07:11:22
3508a86ddf86da7a6b1444f89217e45b3514c722...18983f0ee73c9b3708b10b90e0a37bd17a8a1729,2,29,9,38,10,2010-03-07 07:13:55,2010-03-07 07:13:55
18983f0ee73c9b3708b10b90e0a37bd17a8a1729...8b2c1a484ef45bbab362211c93b1fe1c70878715,2,126,4,130,4,2010-03-07 20:03:04,2010-03-07 20:03:04
8b2c1a484ef45bbab362211c93b1fe1c70878715...255b3a9659e8362f5fcab4143af4974dbf5f8b40,1,7,0,7,1,2010-03-07 20:11:00,2010-03-07 20:11:00
255b3a9659e8362f5fcab4143af4974dbf5f8b40...e081160706cc7ac7943752632049a6dbe420bc6f,1,19,0,19,1,2010-03-08 03:18:22,2010-03-08 03:18:22
e081160706cc7ac7943752632049a6dbe420bc6f...abd0e9628564015097ec0eac0b87fc6fab1d7b9f,1,1,0,1,1,2010-03-08 03:18:58,2010-03-08 03:18:58
abd0e9628564015097ec0eac0b87fc6fab1d7b9f...b50a35a669d3e458f714a36b0d6f48d5d7be4fd0,2,23,2,25,3,2010-03-08 03:19:26,2010-03-08 03:19:26
b50a35a669d3e458f714a36b0d6f48d5d7be4fd0...36e97e59cdba6fd7895377613a1b8c1f70bf8cdb,1,10,1,11,2,2010-03-08 03:19:57,2010-03-08 03:19:57
36e97e59cdba6fd7895377613a1b8c1f70bf8cdb...6e030e7d1e866d02867c7bc7ddbf2c2243541472,1,12,3,15,3,2010-03-08 03:20:29,2010-03-08 03:20:29
6e030e7d1e866d02867c7bc7ddbf2c2243541472...d1e37f2b396d8b86c44d834bc404a22db7d7afb2,1,35,24,59,8,2010-03-08 03:20:55,2010-03-08 03:20:55
d1e37f2b396d8b86c44d834bc404a22db7d7afb2...4376ea4085b482a735bb7b28de7a10c21e9f0651,2,1311,911,2222,442,2010-03-08 06:06:25,2010-03-08 06:06:25
4376ea4085b482a735bb7b28de7a10c21e9f0651...40c022c91e8f5176a01a23c6dac8d938b8fa3a93,2,34,34,68,34,2010-03-08 06:06:57,2010-03-08 06:06:57
40c022c91e8f5176a01a23c6dac8d938b8fa3a93...5e3a2e2f3956f358b5e82e217c20bb0b36fb0665,2,12,9,21,6,2010-03-08 12:47:16,2010-03-08 12:47:16
5e3a2e2f3956f358b5e82e217c20bb0b36fb0665...bae921dcff699b827cd423f01ed125221b32fc9a,3,16,3,19,8,2010-03-08 15:03:30,2010-03-08 15:03:30
bae921dcff699b827cd423f01ed125221b32fc9a...5a35619b5bf164761c46b796b09335c074fa039d,9,30,43,73,13,2010-03-08 15:20:29,2010-03-08 15:20:29
5a35619b5bf164761c46b796b09335c074fa039d...50e46c017e8a904725721ec45a3a214045bd688f,8,37,17,54,13,2010-03-08 17:01:21,2010-03-08 17:01:21
50e46c017e8a904725721ec45a3a214045bd688f...fa3b4a47ef1220746e394acf9077b9a8f24c8a04,1,2,0,2,1,2010-03-08 17:04:06,2010-03-08 17:04:06
fa3b4a47ef1220746e394acf9077b9a8f24c8a04...f2bc4dd0a9e4676f77d4a1c0ddb5e836750f966c,3,6,6,12,3,2010-03-08 18:32:24,2010-03-08 18:32:24
f2bc4dd0a9e4676f77d4a1c0ddb5e836750f966c...021ba30ad1d4fffada4f2d43d47a4704bcfca45e,3,25,0,25,3,2010-03-08 20:36:37,2010-03-08 20:36:37
021ba30ad1d4fffada4f2d43d47a4704bcfca45e...960af90279081e7a4121736f3f2bc67077f11b31,6,38,7,45,8,2010-03-08 23:25:37,2010-03-08 23:25:37
960af90279081e7a4121736f3f2bc67077f11b31...48cd8e856fa027e0e699e5a5ed7e3eb8f8450abb,2,20,1,21,3,2010-03-08 23:55:04,2010-03-08 23:55:04
48cd8e856fa027e0e699e5a5ed7e3eb8f8450abb...bb72aca5d4783a87bd425cae20da38b6b3405639,2,44,0,44,2,2010-03-09 00:38:53,2010-03-09 00:38:53
bb72aca5d4783a87bd425cae20da38b6b3405639...ea288f14e0066848c31f18a7fc7344c6a51a6926,1,1,1,2,1,2010-03-09 14:46:33,2010-03-09 14:46:33
ea288f14e0066848c31f18a7fc7344c6a51a6926...e316b8b981344c6f4663ddcec268e995db61202e,3,46,0,46,3,2010-03-09 22:52:04,2010-03-09 22:52:04
e316b8b981344c6f4663ddcec268e995db61202e...ff2d0ebdb8a57aa00d31c41b0556c456943f2b53,3,3,2,5,3,2010-03-10 00:58:05,2010-03-10 00:58:05
ff2d0ebdb8a57aa00d31c41b0556c456943f2b53...70037f80acff3b7d9722f817c5114e80f4c5af6d,1,8,3,11,1,2010-03-10 03:12:48,2010-03-10 03:12:48
70037f80acff3b7d9722f817c5114e80f4c5af6d...1eee40234b8366617fa3455cd7c4d16f754fe830,1,6,6,12,2,2010-03-10 03:41:41,2010-03-10 03:41:41
1eee40234b8366617fa3455cd7c4d16f754fe830...cccd106289c409c0aa82bf9e37912abbc195d3f1,1,1,0,1,1,2010-03-10 07:41:37,2010-03-10 07:41:37
cccd106289c409c0aa82bf9e37912abbc195d3f1...baa4d3b710d4011b8badcfade907b76d122c33f9,2,18,2,20,3,2010-03-10 07:42:25,2010-03-10 07:42:25
baa4d3b710d4011b8badcfade907b76d122c33f9...a0c77ada990ca1e61b37d7ecdcf533e88c11a510,4,20,3,23,8,2010-03-10 08:37:17,2010-03-10 08:37:17
a0c77ada990ca1e61b37d7ecdcf533e88c11a510...3b7545f3f844683ab45dc9261045f4100c148de7,1,0,1,1,1,2010-03-10 08:40:45,2010-03-10 08:40:45
3b7545f3f844683ab45dc9261045f4100c148de7...e5b918943dbaaf773d56815072df00fd8083cf29,2,1282,534,1816,292,2010-03-10 09:09:13,2010-03-10 09:09:13
e5b918943dbaaf773d56815072df00fd8083cf29...e5d23d8c47653ee319b6bf04d666bee567fd3427,2,64,124,188,122,2010-03-10 09:48:37,2010-03-10 09:48:37
e5d23d8c47653ee319b6bf04d666bee567fd3427...1db672f34735e0338316062e511aa17d24108524,1,4,5,9,4,2010-03-10 12:34:49,2010-03-10 12:34:49
1db672f34735e0338316062e511aa17d24108524...f74b9aec10c26e605eb696122032d8220cb1806f,1,29,29,58,11,2010-03-10 12:35:55,2010-03-10 12:35:55
f74b9aec10c26e605eb696122032d8220cb1806f...ca81ad4f9dedfb8b0935c58e9c5e2d4846a3db15,2,83,41,124,25,2010-03-10 13:13:57,2010-03-10 13:13:57
ca81ad4f9dedfb8b0935c58e9c5e2d4846a3db15...29cb5124a6cac5611618990f8361cc03b478ff9b,1,9,4,13,6,2010-03-10 13:43:23,2010-03-10 13:43:23
29cb5124a6cac5611618990f8361cc03b478ff9b...2287426ba6d363e919f900027be907db3a30181e,1,5,0,5,1,2010-03-10 14:02:59,2010-03-10 14:02:59
2287426ba6d363e919f900027be907db3a30181e...d312fa2a619633c45afd3cfdb90f325e2ecd9be9,2,35,2,37,4,2010-03-10 15:27:22,2010-03-10 15:27:22
d312fa2a619633c45afd3cfdb90f325e2ecd9be9...079457ff01d6a03b7798754e00c1050bcfca5b13,2,27,1,28,3,2010-03-10 15:44:43,2010-03-10 15:44:43
079457ff01d6a03b7798754e00c1050bcfca5b13...4c0701a5d3f2dc9ab08b53e9fa12a5c8e54af835,1,1,1,2,1,2010-03-11 09:33:49,2010-03-11 09:33:49
4c0701a5d3f2dc9ab08b53e9fa12a5c8e54af835...5c256ddeecc2963121bce93db235c57a8380030c,3,7,7,14,7,2010-03-11 09:41:29,2010-03-11 09:41:29
5c256ddeecc2963121bce93db235c57a8380030c...615eab6b0255608e2094f0ecf02c5351a1e887cc,8,35,13,48,18,2010-03-12 13:06:13,2010-03-12 13:06:13
615eab6b0255608e2094f0ecf02c5351a1e887cc...ef0be292a687f95f1081b2ff8170fd7cbd5a365f,2,26,1,27,2,2010-03-12 14:10:01,2010-03-12 14:10:01
ef0be292a687f95f1081b2ff8170fd7cbd5a365f...203d0f60481657847b9084e6a008ae781381503a,3,14,4,18,6,2010-03-12 14:36:39,2010-03-12 14:36:39
203d0f60481657847b9084e6a008ae781381503a...75c8c1de9a8080ed1c47d39797c1cd779629be75,2,32,9,41,5,2010-03-12 15:22:05,2010-03-12 15:22:05
75c8c1de9a8080ed1c47d39797c1cd779629be75...fbf00078e1bdd702f95c7b56277fe602b3bda9e1,1,9,6,15,6,2010-03-12 15:32:06,2010-03-12 15:32:06
fbf00078e1bdd702f95c7b56277fe602b3bda9e1...4120a181e9109383ab35df52dbb3621302a75a72,2,52,9,61,6,2010-03-12 15:51:00,2010-03-12 15:51:00
4120a181e9109383ab35df52dbb3621302a75a72...794690c272fd7e9ee00242980e461214fcd80fcf,2,19,15,34,8,2010-03-12 16:45:29,2010-03-12 16:45:29
794690c272fd7e9ee00242980e461214fcd80fcf...c10b227b6961dc4420d991fd4d90276499000e5c,2,10,8,18,8,2010-03-13 22:11:48,2010-03-13 22:11:48
c10b227b6961dc4420d991fd4d90276499000e5c...4dfe6190fa67ea11dd262cbd51415a4ebd4f45b2,1,2,2,4,2,2010-03-15 06:55:56,2010-03-15 06:55:56
4dfe6190fa67ea11dd262cbd51415a4ebd4f45b2...beca4b81095c7418fcb29e52a243548555127a06,4,19,19,38,9,2010-03-15 07:22:20,2010-03-15 07:22:20
beca4b81095c7418fcb29e52a243548555127a06...45a56e637ea5e356b2f276a7ddbb4335f3c39b35,1,27,9,36,2,2010-03-15 09:57:57,2010-03-15 09:57:57
45a56e637ea5e356b2f276a7ddbb4335f3c39b35...a03f675876ee29a1e8035d138d23cd08aed9c082,2,3,3,6,3,2010-03-15 12:15:44,2010-03-15 12:15:44
a03f675876ee29a1e8035d138d23cd08aed9c082...7989a78baf2c613cc3b75b923f12d178c9bbeb08,1,3,3,6,2,2010-03-15 12:16:01,2010-03-15 12:16:01
7989a78baf2c613cc3b75b923f12d178c9bbeb08...44390aeb5de635afaa48025db774fe8b2c048467,2,11,2,13,2,2010-03-15 12:16:21,2010-03-15 12:16:21
44390aeb5de635afaa48025db774fe8b2c048467...3c06e2101bbb05863a5325dc8b6fb1979384f899,2,32,3,35,7,2010-03-15 12:16:37,2010-03-15 12:16:37
3c06e2101bbb05863a5325dc8b6fb1979384f899...d8c9d21c33ce08f7e90e5996d4da9d8d25d5f8c4,1,2,0,2,1,2010-03-15 12:58:21,2010-03-15 12:58:21
d8c9d21c33ce08f7e90e5996d4da9d8d25d5f8c4...2d57300f5298c0dc88789fb24922f423e34e9149,6,171,128,299,10,2010-03-15 13:15:01,2010-03-15 13:15:01
2d57300f5298c0dc88789fb24922f423e34e9149...e89a5e06cfb627c61af449f9e58f24ce561f840b,2,22,20,42,7,2010-03-15 15:25:39,2010-03-15 15:25:39
e89a5e06cfb627c61af449f9e58f24ce561f840b...80e744945c4d6c16c820fe0671b36654ca484e43,6,121,40,161,11,2010-03-16 14:34:57,2010-03-16 14:34:57
80e744945c4d6c16c820fe0671b36654ca484e43...3c59067a4f2f7f9281bc425378555262a03c0077,1,1,1,2,1,2010-03-16 14:40:03,2010-03-16 14:40:03
3c59067a4f2f7f9281bc425378555262a03c0077...cc6e9b22864a0dd72bcc778ab3f673853ee4987d,2,6,3,9,3,2010-03-16 16:10:27,2010-03-16 16:10:27
cc6e9b22864a0dd72bcc778ab3f673853ee4987d...883329ecb3b0dc025a2885813a2d1a1624261166,3,18,1,19,3,2010-03-16 19:01:40,2010-03-16 19:01:40
883329ecb3b0dc025a2885813a2d1a1624261166...47a822207f937ccafe37c0b99ab37bf2157fb4f7,6,245,150,395,25,2010-03-16 19:32:11,2010-03-16 19:32:11
47a822207f937ccafe37c0b99ab37bf2157fb4f7...f482984af17f227fad01ee06a1b07e9381dee3aa,1,62,10,72,6,2010-03-16 20:59:15,2010-03-16 20:59:15
f482984af17f227fad01ee06a1b07e9381dee3aa...e434573ef12934d8e8f77e2e794d2968dd734ded,4,41,9,50,13,2010-03-16 22:37:45,2010-03-16 22:37:45
e434573ef12934d8e8f77e2e794d2968dd734ded...7471dab660d916ab2ebd6b943aec6c2b1145e744,3,21,6,27,7,2010-03-18 02:03:07,2010-03-18 02:03:07
7471dab660d916ab2ebd6b943aec6c2b1145e744...be8a1f612dde1bff3dcdab05c3a916f27946dd31,2,23,23,46,24,2010-03-18 13:24:11,2010-03-18 13:24:11
be8a1f612dde1bff3dcdab05c3a916f27946dd31...10de2a837f580d76a480a9e0b974cecd2d1d26cb,5,100,1,101,8,2010-03-18 15:22:15,2010-03-18 15:22:15
10de2a837f580d76a480a9e0b974cecd2d1d26cb...003fe522254e5ca8659e6bd57a870a29f5c4e0f7,1,3,3,6,3,2010-03-18 15:35:15,2010-03-18 15:35:15
003fe522254e5ca8659e6bd57a870a29f5c4e0f7...f081059b45610de00c52810da0f97642292db27a,3,54,3,57,4,2010-03-19 05:42:13,2010-03-19 05:42:13
f081059b45610de00c52810da0f97642292db27a...d58020fce8019e3a9df717e0a78a9833c85094b7,2,45,1,46,23,2010-03-20 05:04:31,2010-03-20 05:04:31
d58020fce8019e3a9df717e0a78a9833c85094b7...9f6a82fafbd84865a06e162c14b6a5d5e110babe,2,15,2,17,3,2010-03-20 10:37:57,2010-03-20 10:37:57
9f6a82fafbd84865a06e162c14b6a5d5e110babe...4f98a7c45f4ac65204f0c5e05bad5530d3dc4cc6,1,1,1,2,1,2010-03-20 12:29:17,2010-03-20 12:29:17
4f98a7c45f4ac65204f0c5e05bad5530d3dc4cc6...4528f3988689272d511b1395efc578c0b0d9e671,2,3,8,11,3,2010-03-20 14:53:17,2010-03-20 14:53:17
4528f3988689272d511b1395efc578c0b0d9e671...bfa080f402ddfc383abdbac96fa198e7f2f8ec59,4,41,16,57,20,2010-03-20 15:02:59,2010-03-20 15:02:59
bfa080f402ddfc383abdbac96fa198e7f2f8ec59...10d4094b86721da690fcb3c9bc89b7a0089dfd5c,2,24,10,34,7,2010-03-20 15:26:41,2010-03-20 15:26:41
10d4094b86721da690fcb3c9bc89b7a0089dfd5c...3a5dae5ed3ee10d7c86dc7a110f1edb60490cd99,3,12,3,15,5,2010-03-20 15:37:26,2010-03-20 15:37:26
3a5dae5ed3ee10d7c86dc7a110f1edb60490cd99...9150fb6b0cb9113ba25cf2c79c0c3cd02d7cf1a0,2,45,0,45,3,2010-03-20 17:56:22,2010-03-20 17:56:22
9150fb6b0cb9113ba25cf2c79c0c3cd02d7cf1a0...10884ec2ebee152350c661c1356519ecd21084a5,1,4,3,7,2,2010-03-20 20:01:06,2010-03-20 20:01:06
10884ec2ebee152350c661c1356519ecd21084a5...2403f581b3cd0e7528f4b60c712f460fed91e2c2,2,14,5,19,3,2010-03-20 20:27:57,2010-03-20 20:27:57
2403f581b3cd0e7528f4b60c712f460fed91e2c2...3f4fef432b10fdf69271ccb57181a43484916c7b,3,77,3,80,5,2010-03-21 01:54:00,2010-03-21 01:54:00
3f4fef432b10fdf69271ccb57181a43484916c7b...8661cb9bd38c29af35d785c98d0008323a1734b1,2,3,2,5,2,2010-03-21 13:47:50,2010-03-21 13:47:50
8661cb9bd38c29af35d785c98d0008323a1734b1...f88c2f16e84703cff225e162297a6bcedebe8910,3,18,1,19,4,2010-03-21 14:23:25,2010-03-21 14:23:25
f88c2f16e84703cff225e162297a6bcedebe8910...72ea8fc4eb79d4dfbbbf65161486c06f411ab8c6,7,45,0,45,3,2010-03-21 20:29:11,2010-03-21 20:29:11
72ea8fc4eb79d4dfbbbf65161486c06f411ab8c6...9df71371c2d70f61ae0f8916422487bb031a7164,2,54,4,58,2,2010-03-21 20:47:52,2010-03-21 20:47:52
9df71371c2d70f61ae0f8916422487bb031a7164...b2db1b24c665bb6bc0957ff3b57ffd85814919d3,1,2,2,4,2,2010-03-22 13:22:24,2010-03-22 13:22:24
b2db1b24c665bb6bc0957ff3b57ffd85814919d3...ed36a5f2cefcb5a055ec2ec0a275825226ee601a,2,12,1,13,4,2010-03-22 19:08:04,2010-03-22 19:08:04
ed36a5f2cefcb5a055ec2ec0a275825226ee601a...d18501b0edb990d29562c029337c225fb79b3b49,2,20,7,27,9,2010-03-23 13:51:11,2010-03-23 13:51:11
d18501b0edb990d29562c029337c225fb79b3b49...985e4c8dfe9d79ffc33af6dc64973c20c01f7485,2,3,3,6,3,2010-03-23 14:11:41,2010-03-23 14:11:41
985e4c8dfe9d79ffc33af6dc64973c20c01f7485...8dbd8b1c295e02a678d8c177c34bedaadd3e182a,2,15,7,22,3,2010-03-23 14:52:51,2010-03-23 14:52:51
8dbd8b1c295e02a678d8c177c34bedaadd3e182a...c62c47e638494b42b86878b84afe7682b58f8941,1,6,2,8,1,2010-03-23 18:50:53,2010-03-23 18:50:53
c62c47e638494b42b86878b84afe7682b58f8941...962defed0adab6144464337a9cad44a4323ae3de,3,5,24,29,8,2010-03-25 10:29:06,2010-03-25 10:29:06
962defed0adab6144464337a9cad44a4323ae3de...04aa8a007e467fe5fce45873999dbccd29b52b6e,1,1,1,2,1,2010-03-25 12:36:21,2010-03-25 12:36:21
04aa8a007e467fe5fce45873999dbccd29b52b6e...ef8d351cdfdbfe6dfd6763d52529e91201699006,1,2,2,4,2,2010-03-25 13:14:01,2010-03-25 13:14:01
ef8d351cdfdbfe6dfd6763d52529e91201699006...59a7ca9f18bd9d31d1b784a1de2fa3a86de0db70,1,2,3,5,1,2010-03-25 14:03:35,2010-03-25 14:03:35
59a7ca9f18bd9d31d1b784a1de2fa3a86de0db70...f13014b7e2b5f07b63e33eaeb13bd637b77ad168,1,5,0,5,1,2010-03-25 17:31:25,2010-03-25 17:31:25
f13014b7e2b5f07b63e33eaeb13bd637b77ad168...9b50ec81a388d636c5e7d40e118a5bb6388ba21d,3,26,11,37,7,2010-03-25 20:00:27,2010-03-25 20:00:27
9b50ec81a388d636c5e7d40e118a5bb6388ba21d...667ced2abcb557c1fc8feda7c4d952193b8f5768,3,23,2,25,7,2010-03-26 15:08:24,2010-03-26 15:08:24
667ced2abcb557c1fc8feda7c4d952193b8f5768...459c71e3320b17bb4e0f3188baf7ca3ff1bd2260,25,7101,5,7106,26,2010-03-26 20:14:53,2010-03-26 20:14:53
459c71e3320b17bb4e0f3188baf7ca3ff1bd2260...84de614529f2035057d2d518b7ad94febebcc807,3,15,3,18,7,2010-03-26 23:38:05,2010-03-26 23:38:05
84de614529f2035057d2d518b7ad94febebcc807...8f3d6b940446c2f253a377874275e0da875c4bee,1,0,3,3,1,2010-03-26 23:56:08,2010-03-26 23:56:08
8f3d6b940446c2f253a377874275e0da875c4bee...2881da949fb1a458c7f57fb5f59b40c4cc970e65,1,11,6,17,5,2010-03-27 00:07:31,2010-03-27 00:07:31
2881da949fb1a458c7f57fb5f59b40c4cc970e65...5256a805ff1c31e4d5112627846291e91c5dc65d,1,1,1,2,1,2010-03-27 00:14:10,2010-03-27 00:14:10
5256a805ff1c31e4d5112627846291e91c5dc65d...b31b2d4da3772463d007c9d986c4bdd1392b09e7,3,64,30,94,10,2010-03-27 15:16:27,2010-03-27 15:16:27
b31b2d4da3772463d007c9d986c4bdd1392b09e7...ad5afd6ed220ed50a2b48d7ccf9786ac0e52f807,8,49,53,102,20,2010-03-27 15:54:31,2010-03-27 15:54:31
ad5afd6ed220ed50a2b48d7ccf9786ac0e52f807...ca4c6f65ea81109cf6fbdba74da7f5027eb0c4db,7,60,19,79,21,2010-03-27 16:43:27,2010-03-27 16:43:27
ca4c6f65ea81109cf6fbdba74da7f5027eb0c4db...2a6f14b93013f9918d576b2d4f65e7cf434c788d,1,15,32,47,12,2010-03-27 21:12:56,2010-03-27 21:12:56
2a6f14b93013f9918d576b2d4f65e7cf434c788d...dae7d0ba05552b8c4cd06d2241cb53b9fe763f40,1,1,1,2,1,2010-03-27 22:21:48,2010-03-27 22:21:48
dae7d0ba05552b8c4cd06d2241cb53b9fe763f40...9df8d9c2946bf74288d410e2dc8917493b079b11,2,7,7,14,4,2010-03-27 23:03:12,2010-03-27 23:03:12
9df8d9c2946bf74288d410e2dc8917493b079b11...aba95dcc0b5370ffac3d3b701c3ca7782ee999c1,13,138,88,226,73,2010-03-27 23:03:56,2010-03-27 23:03:56
aba95dcc0b5370ffac3d3b701c3ca7782ee999c1...2a4990a5de30da3a58872395d52b6b6fcff1b7a4,2,746,582,1328,173,2010-03-27 23:04:18,2010-03-27 23:04:18
2a4990a5de30da3a58872395d52b6b6fcff1b7a4...aa538766107c8c74e16cecc3d2e6b29b28b580a0,1,1,0,1,1,2010-03-29 07:24:45,2010-03-29 07:24:45
aa538766107c8c74e16cecc3d2e6b29b28b580a0...7d2568210894d97a419676d311ef18ecc565b8ec,1,3,4,7,5,2010-03-29 08:14:57,2010-03-29 08:14:57
7d2568210894d97a419676d311ef18ecc565b8ec...87302ac00994fdb5ad1390dc5c3040175b80e9d1,2,52,16,68,16,2010-03-29 17:33:59,2010-03-29 17:33:59
87302ac00994fdb5ad1390dc5c3040175b80e9d1...85e13681b02257dac54ef65506a6f8ceebc8f858,1,2,1,3,1,2010-03-29 18:33:23,2010-03-29 18:33:23
85e13681b02257dac54ef65506a6f8ceebc8f858...85fa7d889491257590bd05d701bea908966eb6f5,1,26,10,36,10,2010-03-29 19:40:59,2010-03-29 19:40:59
85fa7d889491257590bd05d701bea908966eb6f5...381b10c2c665749789011d4aa7c16e6a42600a3b,1,8,0,8,1,2010-03-29 21:56:01,2010-03-29 21:56:01
381b10c2c665749789011d4aa7c16e6a42600a3b...7e5265785a7be403d84b3d8b2d23e295aa1f7d56,3,20,3,23,5,2010-03-29 22:20:38,2010-03-29 22:20:38
7e5265785a7be403d84b3d8b2d23e295aa1f7d56...539cfe8cb73f777a24ac2f631a518a343be03a9a,1,2,1,3,1,2010-03-30 01:13:47,2010-03-30 01:13:47
539cfe8cb73f777a24ac2f631a518a343be03a9a...273a0025448d30154626b3e962df9ad5b55d8b3b,3,170,27,197,35,2010-03-30 11:54:56,2010-03-30 11:54:56
273a0025448d30154626b3e962df9ad5b55d8b3b...dafc077e4a8d12defb3adc6c69c131f31700ba23,4,68,42,110,18,2010-03-30 12:44:30,2010-03-30 12:44:30
dafc077e4a8d12defb3adc6c69c131f31700ba23...7bdb9a90d06a955d0ad099f9b72e6c2c30cb89dc,4,54,36,90,13,2010-03-30 23:15:43,2010-03-30 23:15:43
7bdb9a90d06a955d0ad099f9b72e6c2c30cb89dc...e58c75fbdfbc2f11a1d3d6fd949f7375199c6663,2,36,1,37,5,2010-03-31 07:43:52,2010-03-31 07:43:52
e58c75fbdfbc2f11a1d3d6fd949f7375199c6663...9a8a15ecbb5016cff40f66c0d8f767c66652cabd,1,1,1,2,1,2010-03-31 11:30:42,2010-03-31 11:30:42
9a8a15ecbb5016cff40f66c0d8f767c66652cabd...a75dc3406f63ec621f2bc3f9af79152c0df92182,3,38,3,41,6,2010-03-31 12:33:10,2010-03-31 12:33:10
a75dc3406f63ec621f2bc3f9af79152c0df92182...4e5c20b78b17df25948809ca1c880551351d4d83,2,28,4,32,6,2010-03-31 13:43:22,2010-03-31 13:43:22
4e5c20b78b17df25948809ca1c880551351d4d83...2fa2cf0a092816bfd92ff5e94907f5bca8f3c365,1,1,1,2,1,2010-03-31 18:55:52,2010-03-31 18:55:52
2fa2cf0a092816bfd92ff5e94907f5bca8f3c365...271bcda04af23bd4deb9656edd59038537f301c5,4,62,2,64,6,2010-04-01 15:10:53,2010-04-01 15:10:53
271bcda04af23bd4deb9656edd59038537f301c5...db5be42c124886eab758e5f4c181db32af174e23,2,13,1,14,3,2010-04-01 15:16:26,2010-04-01 15:16:26
db5be42c124886eab758e5f4c181db32af174e23...c39ec6dccb389fbb4047e44f5247e18bb76ae598,1,1,1,2,1,2010-04-01 15:29:58,2010-04-01 15:29:58
c39ec6dccb389fbb4047e44f5247e18bb76ae598...f7cf58ac0ebf720e5c48f00e99c31cf39c4fca50,6,39,14,53,15,2010-04-01 16:48:16,2010-04-01 16:48:16
f7cf58ac0ebf720e5c48f00e99c31cf39c4fca50...7d5c7df6a943b5659831e4f38546798c7bd541c0,2,10,2,12,3,2010-04-01 16:56:55,2010-04-01 16:56:55
7d5c7df6a943b5659831e4f38546798c7bd541c0...8f8743a69ede47743e1aa6ab83295e35fcfd96cf,1,15,0,15,2,2010-04-02 14:44:16,2010-04-02 14:44:16
8f8743a69ede47743e1aa6ab83295e35fcfd96cf...5e5203c7d73684ef7d5e4ce1cb71f2b92ae19360,2,21,2,23,4,2010-04-02 15:44:48,2010-04-02 15:44:48
5e5203c7d73684ef7d5e4ce1cb71f2b92ae19360...f92d73fbd48aa22c4f0d6b155e795b65ecc6355c,3,63,1,64,3,2010-04-03 11:45:31,2010-04-03 11:45:31
f92d73fbd48aa22c4f0d6b155e795b65ecc6355c...82efb4840311d549989ccf224fa78765226f6040,6,58,12,70,16,2010-04-04 17:05:43,2010-04-04 17:05:43
82efb4840311d549989ccf224fa78765226f6040...37861cf7eb2effb86ec0ea8c824295a2da34014f,1,1,1,2,2,2010-04-04 17:06:13,2010-04-04 17:06:13
37861cf7eb2effb86ec0ea8c824295a2da34014f...4e4decaf4203421e1a31ffdf8738569de5eea86a,1,1,1,2,1,2010-04-04 17:42:23,2010-04-04 17:42:23
4e4decaf4203421e1a31ffdf8738569de5eea86a...c421a4fd92990fa830f2f645df044b0f0f1fc32a,6,19,1,20,6,2010-04-05 12:02:27,2010-04-05 12:02:27
c421a4fd92990fa830f2f645df044b0f0f1fc32a...304e017a7f76cd35706c7e767ee3b82cc52d6bfd,1,6,0,6,1,2010-04-05 12:36:36,2010-04-05 12:36:36
304e017a7f76cd35706c7e767ee3b82cc52d6bfd...653b27dcf2d65beede220566f1b5fab4fc5d6673,1,7,0,7,1,2010-04-05 12:59:17,2010-04-05 12:59:17
653b27dcf2d65beede220566f1b5fab4fc5d6673...90d112785b5caf30507ffc91b74b8f5a7725e4f6,3,18,8,26,6,2010-04-05 15:37:43,2010-04-05 15:37:43
90d112785b5caf30507ffc91b74b8f5a7725e4f6...7cc4046802c8eb0492333b6e7c4fcacdd4838c7b,1,1,1,2,1,2010-04-05 15:46:44,2010-04-05 15:46:44
7cc4046802c8eb0492333b6e7c4fcacdd4838c7b...e07570f10e0989ea23532078ab288408c34a6bc6,1,5,5,10,4,2010-04-05 15:57:00,2010-04-05 15:57:00
e07570f10e0989ea23532078ab288408c34a6bc6...671f848dd13cfa81ab9b958f121c9c93bc69a263,1,1,1,2,1,2010-04-06 10:54:59,2010-04-06 10:54:59
671f848dd13cfa81ab9b958f121c9c93bc69a263...f7814cdfe6c3b6d87bb8afdcc5c27ee2e92a6a62,1,8,9,17,1,2010-04-06 11:52:32,2010-04-06 11:52:32
f7814cdfe6c3b6d87bb8afdcc5c27ee2e92a6a62...21236fa0a2dc37126cc93eb1a8f849002000cbe6,1,6,6,12,4,2010-04-06 12:18:56,2010-04-06 12:18:56
21236fa0a2dc37126cc93eb1a8f849002000cbe6...520ce1bab3db1cce8560f5c78873fc2117785742,1,2,2,4,2,2010-04-06 14:18:32,2010-04-06 14:18:32
520ce1bab3db1cce8560f5c78873fc2117785742...97b9c7582b510e9948d8a07a8f64bd4fdc5ea22d,1,1,1,2,1,2010-04-06 14:35:36,2010-04-06 14:35:36
97b9c7582b510e9948d8a07a8f64bd4fdc5ea22d...736b751ed941899e1c46af83b09e207d97f415d7,8,123,23,146,23,2010-04-07 23:37:48,2010-04-07 23:37:48
736b751ed941899e1c46af83b09e207d97f415d7...056c940f0d723eb66fc06b43c28a743c84d54b3b,3,32,5,37,7,2010-04-09 11:07:17,2010-04-09 11:07:17
056c940f0d723eb66fc06b43c28a743c84d54b3b...e9bbdb39de3047761fa8d03d5241eccd571093ff,3,11,3,14,4,2010-04-09 12:39:08,2010-04-09 12:39:08
e9bbdb39de3047761fa8d03d5241eccd571093ff...7b47609629692241848469fabc24fa798c0ac70b,2,30,3,33,8,2010-04-09 13:08:08,2010-04-09 13:08:08
7b47609629692241848469fabc24fa798c0ac70b...040c18b17e854459c9eff39a4dbbacf6b5460f31,2,10,1,11,3,2010-04-09 13:24:13,2010-04-09 13:24:13
040c18b17e854459c9eff39a4dbbacf6b5460f31...f4eac3d87fd377466cbdcbaf147314485fec517d,5,28,22,50,17,2010-04-09 20:51:01,2010-04-09 20:51:01
f4eac3d87fd377466cbdcbaf147314485fec517d...b579350cd16601a82efd6a497fed07f086371817,3,45,11,56,12,2010-04-10 07:35:31,2010-04-10 07:35:31
b579350cd16601a82efd6a497fed07f086371817...aed032d0ac0f30e7e985f19536ac7a2cd2bc0233,1,12,2,14,4,2010-04-11 06:48:46,2010-04-11 06:48:46
aed032d0ac0f30e7e985f19536ac7a2cd2bc0233...736afb4705aa0556b1be3f635a49337a73cd6970,1,1,1,2,1,2010-04-11 06:50:53,2010-04-11 06:50:53
736afb4705aa0556b1be3f635a49337a73cd6970...f4c76fb60439de0730a9e991403668a1b46e0191,1,1,1,2,1,2010-04-11 06:58:33,2010-04-11 06:58:33
f4c76fb60439de0730a9e991403668a1b46e0191...faceca7075d72d55f0eebc586049fb634cd46129,7,29,19,48,23,2010-04-11 08:35:04,2010-04-11 08:35:04
faceca7075d72d55f0eebc586049fb634cd46129...82b8b67446f6737a22593876c8e77ff19532e2c5,1,2,1,3,1,2010-04-11 18:59:03,2010-04-11 18:59:03
82b8b67446f6737a22593876c8e77ff19532e2c5...55c31fbdefe3bc3c948599b66781e7a9a1dae2a2,4,32,2,34,8,2010-04-12 12:39:18,2010-04-12 12:39:18
55c31fbdefe3bc3c948599b66781e7a9a1dae2a2...2cebe4395e9ed345bbbe346b91842b4c97ffcfc7,2,12,1,13,2,2010-04-12 13:56:38,2010-04-12 13:56:38
2cebe4395e9ed345bbbe346b91842b4c97ffcfc7...2a752edd808921c1938fbd4ea3a07a76af9eb0f5,2,21,18,39,5,2010-04-12 14:36:48,2010-04-12 14:36:48
2a752edd808921c1938fbd4ea3a07a76af9eb0f5...217a379c3da341331dd649510bc9af2b275f0ae1,1,7,81,88,72,2010-04-12 14:59:00,2010-04-12 14:59:00
217a379c3da341331dd649510bc9af2b275f0ae1...b7b38a41b02ac2e70933ccd4e23c96fc08ebfeb1,1,345,1,346,1,2010-04-12 23:53:27,2010-04-12 23:53:27
b7b38a41b02ac2e70933ccd4e23c96fc08ebfeb1...35f41507343e1ef60bf37be9f2d46606c4a0e1a3,1,46,42,88,6,2010-04-13 02:41:37,2010-04-13 02:41:37
35f41507343e1ef60bf37be9f2d46606c4a0e1a3...1fcf747b131308c5573de23858e6116f8630ee45,14,21,15,36,17,2010-04-13 10:28:24,2010-04-13 10:28:24
1fcf747b131308c5573de23858e6116f8630ee45...c3d1267c15a77bb7bacb59e9e09eb38c32c03c2a,3,6,4,10,5,2010-04-13 10:28:44,2010-04-13 10:28:44
c3d1267c15a77bb7bacb59e9e09eb38c32c03c2a...31f7ff1518b863459820905d297ae538bd26f06c,6,19,14,33,9,2010-04-13 10:29:19,2010-04-13 10:29:19
31f7ff1518b863459820905d297ae538bd26f06c...b3390fede0286c8ff8ea2c096c7f1ba58bad6db3,2,42,3,45,4,2010-04-13 10:29:44,2010-04-13 10:29:44
b3390fede0286c8ff8ea2c096c7f1ba58bad6db3...e93f56b174b6105943b68dfc3d2b81ccdc3c364a,2,24,5,29,4,2010-04-13 15:18:10,2010-04-13 15:18:10
e93f56b174b6105943b68dfc3d2b81ccdc3c364a...d8910e95e02f3eae279691e33c0ad1a2442676a0,1,5,1,6,2,2010-04-14 18:17:44,2010-04-14 18:17:44
d8910e95e02f3eae279691e33c0ad1a2442676a0...48dd5f13a351048d40803cbb95e60ed775d980cd,10,43,5,48,10,2010-04-14 19:10:27,2010-04-14 19:10:27
48dd5f13a351048d40803cbb95e60ed775d980cd...1cec641669d8b4dc507190371e263be914cbcca8,1,1,1,2,1,2010-04-14 21:23:43,2010-04-14 21:23:43
1cec641669d8b4dc507190371e263be914cbcca8...d9aaad4e36ba2ebba13fd1c36da9eced4f7688ad,2,19,1,20,2,2010-04-15 11:19:59,2010-04-15 11:19:59
d9aaad4e36ba2ebba13fd1c36da9eced4f7688ad...2faa3acb4bb55f1830d517473c4bfb1616f92726,6,49,6,55,14,2010-04-15 12:41:08,2010-04-15 12:41:08
2faa3acb4bb55f1830d517473c4bfb1616f92726...442ee687df8eaa402f5ab8475a2b07c18188aba9,1,7,1,8,1,2010-04-15 13:01:51,2010-04-15 13:01:51
442ee687df8eaa402f5ab8475a2b07c18188aba9...07590ff4e856c597b32e185de1eb9f6b52fb0b1f,1,22,0,22,1,2010-04-15 14:34:40,2010-04-15 14:34:40
07590ff4e856c597b32e185de1eb9f6b52fb0b1f...9ac4d2fc613d76129b0e980a7310321021982a19,1,3,3,6,1,2010-04-15 14:43:40,2010-04-15 14:43:40
9ac4d2fc613d76129b0e980a7310321021982a19...29341aaffc28866e15e11109b26c6446f39cb68d,7,94,13,107,9,2010-04-15 18:44:51,2010-04-15 18:44:51
29341aaffc28866e15e11109b26c6446f39cb68d...4604e985aea1329e521c9cf72208d0cb77f18d60,1,4,4,8,2,2010-04-15 19:11:02,2010-04-15 19:11:02
4604e985aea1329e521c9cf72208d0cb77f18d60...da36e3222415fd04332a529623f88f908be8c2a6,3,53,10,63,4,2010-04-15 19:57:09,2010-04-15 19:57:09
da36e3222415fd04332a529623f88f908be8c2a6...a288f97a2a99ee238e984cf155643d4afc25a46b,1,1,0,1,1,2010-04-15 20:36:00,2010-04-15 20:36:00
a288f97a2a99ee238e984cf155643d4afc25a46b...a213599db7781c8945f161fd77e5c4b706b99853,1,9,28,37,6,2010-04-15 22:32:53,2010-04-15 22:32:53
a213599db7781c8945f161fd77e5c4b706b99853...94a968cfc60e16d3fa8180ae76dce35bc931e374,5,35,26,61,11,2010-04-16 11:11:55,2010-04-16 11:11:55
94a968cfc60e16d3fa8180ae76dce35bc931e374...2cd48bac7ee7a5c4dded039439f9b6aaf566696e,3,47,5,52,9,2010-04-16 12:29:23,2010-04-16 12:29:23
2cd48bac7ee7a5c4dded039439f9b6aaf566696e...1ad9c36fb8cba9e2687b2ebb2d69ed4ccef58885,3,39,23,62,14,2010-04-16 16:34:42,2010-04-16 16:34:42
1ad9c36fb8cba9e2687b2ebb2d69ed4ccef58885...c3dbe9d50991cd749491633787c529b101fa04be,3,19,2,21,4,2010-04-19 10:16:25,2010-04-19 10:16:25
c3dbe9d50991cd749491633787c529b101fa04be...56eb340528d392612f3229b4bd8b7416553c3b15,2,31,7,38,7,2010-04-19 11:52:56,2010-04-19 11:52:56
56eb340528d392612f3229b4bd8b7416553c3b15...ebfe9383bfbc53cb6c29e1170d99f64feb9ad010,2,17,9,26,6,2010-04-19 12:40:46,2010-04-19 12:40:46
ebfe9383bfbc53cb6c29e1170d99f64feb9ad010...fef0d25bdccbb8f01314cf3a94651d3cfe67a34e,2,47,17,64,11,2010-04-19 14:18:14,2010-04-19 14:18:14
fef0d25bdccbb8f01314cf3a94651d3cfe67a34e...ea7df233958e2fd06989f6576b206f6a4cc65435,2,9,9,18,2,2010-04-19 18:37:12,2010-04-19 18:37:12
ea7df233958e2fd06989f6576b206f6a4cc65435...424be52372616895b8d6516fde1974941de00f14,1,1,1,2,1,2010-04-20 12:20:14,2010-04-20 12:20:14
424be52372616895b8d6516fde1974941de00f14...cb906e159326b0edb8759a5e2723d76abade762f,4,20,1,21,3,2010-04-20 14:39:46,2010-04-20 14:39:46
cb906e159326b0edb8759a5e2723d76abade762f...12cc292fc1376024ea676d18d0f688906ae199a9,1,0,2,2,1,2010-04-20 15:05:05,2010-04-20 15:05:05
12cc292fc1376024ea676d18d0f688906ae199a9...829c5fdbeeb40e6bcfa5bf296363cd91f2ae445f,2,1,3,4,2,2010-04-20 20:39:22,2010-04-20 20:39:22
829c5fdbeeb40e6bcfa5bf296363cd91f2ae445f...b131561112c6e48cc73f692d022f8911ca74eb38,1,4,5,9,3,2010-04-21 11:33:39,2010-04-21 11:33:39
b131561112c6e48cc73f692d022f8911ca74eb38...e8eac3290126d94580618cb4dac44cd2a7d258d6,1,11,2,13,5,2010-04-21 12:05:15,2010-04-21 12:05:15
e8eac3290126d94580618cb4dac44cd2a7d258d6...3fb57d47bd8d4f6c1d61c9fd9564ae6c1c262027,8,64,36,100,15,2010-04-21 16:34:33,2010-04-21 16:34:33
3fb57d47bd8d4f6c1d61c9fd9564ae6c1c262027...5a3521fd071e75fc5d11bf44a59548627a9f1437,1,2,2,4,2,2010-04-21 18:07:23,2010-04-21 18:07:23
5a3521fd071e75fc5d11bf44a59548627a9f1437...b5dc7945bd7de5bc2784d69a5e82e7fc1f069de8,1,32,32,64,16,2010-04-21 19:12:39,2010-04-21 19:12:39
b5dc7945bd7de5bc2784d69a5e82e7fc1f069de8...5866875547515bd8a1f7082404414602cf112355,2,5,8,13,3,2010-04-21 23:43:35,2010-04-21 23:43:35
5866875547515bd8a1f7082404414602cf112355...d9a0fd48ba1a4ac04c917099785d35700bef6ccc,2,11,4,15,4,2010-04-23 14:25:29,2010-04-23 14:25:29
d9a0fd48ba1a4ac04c917099785d35700bef6ccc...d2fec79d7bbe6eae337107969b836a1a0b14b89b,1,22,19,41,3,2010-04-24 07:08:52,2010-04-24 07:08:52
d2fec79d7bbe6eae337107969b836a1a0b14b89b...9872badf33edf6b58f33e273d89365469d0139a7,1,4,5,9,4,2010-04-25 13:18:24,2010-04-25 13:18:24
9872badf33edf6b58f33e273d89365469d0139a7...35add3b3595061c841d8838cd3b16e9d8a6e128b,4,1367,634,2001,331,2010-04-26 13:57:03,2010-04-26 13:57:03
35add3b3595061c841d8838cd3b16e9d8a6e128b...1c937f70d64b6b569528691bea34f96e5b930d47,4,262,246,508,206,2010-04-26 13:57:29,2010-04-26 13:57:29
1c937f70d64b6b569528691bea34f96e5b930d47...215269b84fbb708a4e35d7fc6e17aa0415f19c6a,4,263,253,516,215,2010-04-26 13:57:54,2010-04-26 13:57:54
215269b84fbb708a4e35d7fc6e17aa0415f19c6a...ffe79b097905fac4be83e30ab4de3cab98fbc723,1,5,4,9,5,2010-04-27 11:51:43,2010-04-27 11:51:43
ffe79b097905fac4be83e30ab4de3cab98fbc723...2f9eef1227aa5d10c57995a5363696e8adc276b6,4,28,2,30,4,2010-04-27 12:35:49,2010-04-27 12:35:49
2f9eef1227aa5d10c57995a5363696e8adc276b6...dccc5ac0a6ae4cbdf488d297db1b41cd8e3d98f1,1,2,2,4,1,2010-04-27 14:42:55,2010-04-27 14:42:55
dccc5ac0a6ae4cbdf488d297db1b41cd8e3d98f1...b031fa2376f489406b44f0dabed18b5d318c2e83,1,18,21,39,2,2010-04-27 15:04:41,2010-04-27 15:04:41
b031fa2376f489406b44f0dabed18b5d318c2e83...dd07c235454baea0c74fa373cc07187942f3aed0,4,55,9,64,9,2010-04-27 15:05:38,2010-04-27 15:05:38
dd07c235454baea0c74fa373cc07187942f3aed0...b647e22bbd3fa377af3e55f9f8ba4a71aaf0eaa7,1,0,1,1,1,2010-04-27 15:11:44,2010-04-27 15:11:44
b647e22bbd3fa377af3e55f9f8ba4a71aaf0eaa7...2ebf7fb2b2057f36beeab095c360a7eae0ef1c7f,1,2,2,4,2,2010-04-28 03:02:53,2010-04-28 03:02:53
2ebf7fb2b2057f36beeab095c360a7eae0ef1c7f...848fbdc3e7d9402be096f8f97fb8faa3a36d4324,3,138,2,140,5,2010-04-28 04:20:35,2010-04-28 04:20:35
848fbdc3e7d9402be096f8f97fb8faa3a36d4324...cae4401a01cceb0f2a1fbf655f70c8dc8a4eba59,2,153,149,302,133,2010-04-28 10:28:05,2010-04-28 10:28:05
cae4401a01cceb0f2a1fbf655f70c8dc8a4eba59...4e0aa65d16e86cb426c49e33511bf013a47c4fbb,12,47,41,88,18,2010-04-28 11:27:38,2010-04-28 11:27:38
4e0aa65d16e86cb426c49e33511bf013a47c4fbb...9d8492c169d54b727ab387132456d4c1526cff06,2,7,1,8,4,2010-04-28 12:08:30,2010-04-28 12:08:30
9d8492c169d54b727ab387132456d4c1526cff06...5926a26e920c0543641ea1b06ee78c61c80e947d,2,88,5,93,3,2010-04-28 15:39:26,2010-04-28 15:39:26
5926a26e920c0543641ea1b06ee78c61c80e947d...6a1cf9369fceba9833f7ad8702ebef80dc98291e,2,43,3,46,6,2010-04-28 17:08:06,2010-04-28 17:08:06
6a1cf9369fceba9833f7ad8702ebef80dc98291e...60df7421f6ebc9f309ba05cbc20ca13b60411e22,1,14,0,14,1,2010-04-29 01:22:50,2010-04-29 01:22:50
60df7421f6ebc9f309ba05cbc20ca13b60411e22...0db68c81230be304aa0c581b84bc35857320aa04,1,7,7,14,1,2010-04-29 01:40:12,2010-04-29 01:40:12
0db68c81230be304aa0c581b84bc35857320aa04...df44485c40b144baac626d351c2a462988c2e577,7,5366,0,5366,4,2010-04-29 14:35:25,2010-04-29 14:35:25
df44485c40b144baac626d351c2a462988c2e577...77c13844ae9f30ecc10b54cf0b1a338039aa7cea,11,4586,6,4592,10,2010-04-29 14:36:09,2010-04-29 14:36:09
77c13844ae9f30ecc10b54cf0b1a338039aa7cea...e0ac591ed73bcafd290be854ec8001ce2481008b,4,1338,629,1967,324,2010-04-29 14:36:36,2010-04-29 14:36:36
e0ac591ed73bcafd290be854ec8001ce2481008b...5f7732d059f53a12eaa2555bc706192e0db8fbe5,4,1239,637,1876,438,2010-04-29 14:37:04,2010-04-29 14:37:04
5f7732d059f53a12eaa2555bc706192e0db8fbe5...413ae251acba11cafd643086d5cd75d1eb021d01,7,18,18,36,13,2010-04-29 14:37:39,2010-04-29 14:37:39
413ae251acba11cafd643086d5cd75d1eb021d01...8006f85f2d537bc3c764d157060bdeb7a187b14e,2,28,11,39,5,2010-04-29 14:38:02,2010-04-29 14:38:02
8006f85f2d537bc3c764d157060bdeb7a187b14e...657db6a30aab0390ee7084c5cbc6b0d2f679cbb4,1,18,12,30,2,2010-04-29 14:38:22,2010-04-29 14:38:22
657db6a30aab0390ee7084c5cbc6b0d2f679cbb4...1ff7ed2e69081eacaa6e160f99beabe35853cb02,7,5150,0,5150,4,2010-04-29 14:38:50,2010-04-29 14:38:50
1ff7ed2e69081eacaa6e160f99beabe35853cb02...4e97d7f8e4acddb2b33d0a1e8bca721ae63d7d7c,2,25,2,27,5,2010-04-30 14:07:47,2010-04-30 14:07:47
4e97d7f8e4acddb2b33d0a1e8bca721ae63d7d7c...7fa7bed911041a7ec25e9fbe82e9761a2004eda4,1,1,1,2,1,2010-04-30 14:27:29,2010-04-30 14:27:29
7fa7bed911041a7ec25e9fbe82e9761a2004eda4...21d98c5ebdf7063aca8666255b31673e6af595c8,2,11,7,18,3,2010-04-30 15:24:07,2010-04-30 15:24:07
21d98c5ebdf7063aca8666255b31673e6af595c8...8b1aebbf352cd2c7e0c3bd81b83553fe293ad56a,3,22,3,25,4,2010-04-30 16:32:48,2010-04-30 16:32:48
8b1aebbf352cd2c7e0c3bd81b83553fe293ad56a...d2b5a6c8d78e4d96c7e5a309cf2aa125db7654c3,1,1,1,2,1,2010-05-01 02:29:32,2010-05-01 02:29:32
d2b5a6c8d78e4d96c7e5a309cf2aa125db7654c3...b26aa18c5c97f4883c56bd0a17e0b9257e5acd46,2,35,0,35,2,2010-05-01 14:27:10,2010-05-01 14:27:10
b26aa18c5c97f4883c56bd0a17e0b9257e5acd46...f9e2debbcc0ac220b331bc48cb53356a253509bb,4,175,161,336,142,2010-05-02 10:26:26,2010-05-02 10:26:26
f9e2debbcc0ac220b331bc48cb53356a253509bb...a74fc359e43ea5c681cda55176e2e68116cbbeba,4,1329,956,2285,340,2010-05-02 10:26:52,2010-05-02 10:26:52
a74fc359e43ea5c681cda55176e2e68116cbbeba...b3e9150f273df45b4373b9e44b32d8d0ead5a72e,4,1303,598,1901,325,2010-05-02 10:27:17,2010-05-02 10:27:17
b3e9150f273df45b4373b9e44b32d8d0ead5a72e...28294b30b535c47f05467d78203ea479f03c79cd,2,1,1,2,1,2010-05-02 10:27:40,2010-05-02 10:27:40
28294b30b535c47f05467d78203ea479f03c79cd...cb02b92f854d08f17f93255001f0fdaf8ab8c29e,2,4,4,8,4,2010-05-02 13:25:13,2010-05-02 13:25:13
cb02b92f854d08f17f93255001f0fdaf8ab8c29e...43bf086783ca60b477b0e9e19357eebf1ecb3fd9,2,32,3,35,5,2010-05-02 19:46:31,2010-05-02 19:46:31
43bf086783ca60b477b0e9e19357eebf1ecb3fd9...bcc9db82cec4af44491e9c831ab6830e7dceed54,5,2031,844,2875,435,2010-05-02 20:04:41,2010-05-02 20:04:41
bcc9db82cec4af44491e9c831ab6830e7dceed54...cce32a9b0900210d524b80160209c3e2b5dfb156,6,149,19,168,20,2010-05-02 23:02:16,2010-05-02 23:02:16
cce32a9b0900210d524b80160209c3e2b5dfb156...22236fa9ccf1f4e1db71528e9cf7ea0ec24f40c8,1,1,1,2,1,2010-05-02 23:08:45,2010-05-02 23:08:45
22236fa9ccf1f4e1db71528e9cf7ea0ec24f40c8...b4615a762f46626f23a9951e4a1c6a68dee04c83,1,1135,495,1630,321,2010-05-03 05:56:51,2010-05-03 05:56:51
b4615a762f46626f23a9951e4a1c6a68dee04c83...02ffb6f1dd0bc7694247cd20a41233049464ae9d,2,176,294,470,235,2010-05-03 06:39:08,2010-05-03 06:39:08
02ffb6f1dd0bc7694247cd20a41233049464ae9d...7fc25715d6af20e14827c85170fff20f82ded8ab,1,6,1,7,2,2010-05-03 15:30:11,2010-05-03 15:30:11
7fc25715d6af20e14827c85170fff20f82ded8ab...4ca7c4e34de273f0deab727d57132c9d18241b0b,7,199,21,220,10,2010-05-04 06:14:47,2010-05-04 06:14:47
4ca7c4e34de273f0deab727d57132c9d18241b0b...e99b283e77855d7b3a47803c663f6299bfaf79fa,4,8,8,16,6,2010-05-04 07:23:02,2010-05-04 07:23:02
e99b283e77855d7b3a47803c663f6299bfaf79fa...89fb09eb72abb0b57da2cf05a9c4b1b4ae098e21,2,1,1,2,1,2010-05-04 08:14:12,2010-05-04 08:14:12
89fb09eb72abb0b57da2cf05a9c4b1b4ae098e21...471477ab4c51c75db7f55d9437332070dd6cb550,2,4381,1037,5418,517,2010-05-04 10:42:53,2010-05-04 10:42:53
471477ab4c51c75db7f55d9437332070dd6cb550...5f731bd94934cb390807e716e4789b93b1138113,8,2715,1236,3951,656,2010-05-04 10:44:40,2010-05-04 10:44:40
5f731bd94934cb390807e716e4789b93b1138113...74c457b4395d271b0cb21b3512d93dcab3abc651,4,2599,1223,3822,646,2010-05-04 10:45:51,2010-05-04 10:45:51
74c457b4395d271b0cb21b3512d93dcab3abc651...3acbf7ca7dca8f5731b16c6e87baa4073440036d,4,1605,1035,2640,461,2010-05-04 11:07:37,2010-05-04 11:07:37
3acbf7ca7dca8f5731b16c6e87baa4073440036d...67ac33f8a6bd74664adfcbaaaf61c93be8d3e6f8,3,206,192,398,156,2010-05-04 11:08:50,2010-05-04 11:08:50
67ac33f8a6bd74664adfcbaaaf61c93be8d3e6f8...7202eb8e3194c6d9c52780526871018205bd0858,7,5411,0,5411,4,2010-05-04 11:10:36,2010-05-04 11:10:36
7202eb8e3194c6d9c52780526871018205bd0858...5211f48ae3cc0d87a260dbf5c3ab8bdae664c4b6,59,32,3399,3431,75,2010-05-04 14:00:30,2010-05-04 14:00:30
5211f48ae3cc0d87a260dbf5c3ab8bdae664c4b6...41ccfa15d7f5ab96147e2f44ba6f24dc61611eda,1,17,42,59,5,2010-05-04 14:48:43,2010-05-04 14:48:43
41ccfa15d7f5ab96147e2f44ba6f24dc61611eda...402f8cede599950d44be9db03f3fd1e46e3dbaba,12,226,26,252,27,2010-05-04 21:43:40,2010-05-04 21:43:40
402f8cede599950d44be9db03f3fd1e46e3dbaba...7ebf10538888fc9d5c614bb76944ebe2fff275f5,1,1,1,2,1,2010-05-04 21:49:27,2010-05-04 21:49:27
7ebf10538888fc9d5c614bb76944ebe2fff275f5...9bdd17579da1523db43ddcafb0bb868197478fa2,1,1,1,2,1,2010-05-04 22:13:14,2010-05-04 22:13:14
9bdd17579da1523db43ddcafb0bb868197478fa2...db35337a1542a86d3667f5d9ac071e46ef0605f3,4,165,117,282,118,2010-05-04 22:53:00,2010-05-04 22:53:00
db35337a1542a86d3667f5d9ac071e46ef0605f3...c772ea2055c9402d418ded6e79f0a36b0f0ba8c7,1,6,6,12,4,2010-05-04 23:34:17,2010-05-04 23:34:17
c772ea2055c9402d418ded6e79f0a36b0f0ba8c7...26149d8fa5502ab4736315730be5b50b789c8293,4,568,464,1032,369,2010-05-05 01:31:20,2010-05-05 01:31:20
26149d8fa5502ab4736315730be5b50b789c8293...33d4aa8df121f1fa3019aa6663d02b547d38aa80,2,3,13,16,2,2010-05-05 16:06:39,2010-05-05 16:06:39
33d4aa8df121f1fa3019aa6663d02b547d38aa80...0f6555bce20d765212f40d12e8c2ab3d3c696da1,1,1,1,2,1,2010-05-06 01:17:29,2010-05-06 01:17:29
0f6555bce20d765212f40d12e8c2ab3d3c696da1...ec1f74a468b0a848b20424eea2bea9d878aa5d61,1,9,16,25,1,2010-05-06 01:18:31,2010-05-06 01:18:31
ec1f74a468b0a848b20424eea2bea9d878aa5d61...c21c052cf0237317f42507211cff8923b20539a0,1,1,1,2,1,2010-05-06 01:18:57,2010-05-06 01:18:57
c21c052cf0237317f42507211cff8923b20539a0...84df3554d0a3d4d3373a8ccc8b9d412982ee6728,1,1,1,2,1,2010-05-06 01:19:21,2010-05-06 01:19:21
84df3554d0a3d4d3373a8ccc8b9d412982ee6728...ee6d5521e94f8f94ad6e1e0f4eee94e2d4094350,1,3,0,3,1,2010-05-06 01:19:45,2010-05-06 01:19:45
ee6d5521e94f8f94ad6e1e0f4eee94e2d4094350...92983a3119d6af66b5b2099a0925092d520ee85a,2,11,9,20,5,2010-05-06 01:20:11,2010-05-06 01:20:11
92983a3119d6af66b5b2099a0925092d520ee85a...cfa4a62624a54b47119ec14d624526372f9d7578,1,1,1,2,1,2010-05-06 01:20:38,2010-05-06 01:20:38
cfa4a62624a54b47119ec14d624526372f9d7578...2b05231310c731facea633839fd165e9f0a2194c,1,4,0,4,1,2010-05-06 01:35:02,2010-05-06 01:35:02
2b05231310c731facea633839fd165e9f0a2194c...77dd5beda762c433f8d96401455ec355ac43b11a,1,103,0,103,1,2010-05-06 04:09:13,2010-05-06 04:09:13
77dd5beda762c433f8d96401455ec355ac43b11a...f419c9b6e211c94b1d701b791e2412ac6c1d872e,1,4,4,8,1,2010-05-06 04:22:05,2010-05-06 04:22:05
f419c9b6e211c94b1d701b791e2412ac6c1d872e...434bf737d45e56bbafbef8077b23a98d602a5d33,2,2,2,4,2,2010-05-06 04:25:33,2010-05-06 04:25:33
434bf737d45e56bbafbef8077b23a98d602a5d33...533b5c9324a0936229549338edd1e1f739a4ff1d,2,2,2,4,2,2010-05-07 00:57:17,2010-05-07 00:57:17
533b5c9324a0936229549338edd1e1f739a4ff1d...b4f82b161fded3fde2d41137feb9348474b8db4a,2,18,0,18,1,2010-05-07 18:52:59,2010-05-07 18:52:59
b4f82b161fded3fde2d41137feb9348474b8db4a...0b25cebcc6466d02044533db3c569636998231bb,2,18,0,18,1,2010-05-07 18:53:19,2010-05-07 18:53:19
0b25cebcc6466d02044533db3c569636998231bb...9fe8cad54ead41cadfb45cdc4570ab7ae2ecde3f,1,14,3,17,3,2010-05-07 18:53:37,2010-05-07 18:53:37
9fe8cad54ead41cadfb45cdc4570ab7ae2ecde3f...5b6733c303c2ecc67df0ca2db078efa280f941dc,2,18,0,18,1,2010-05-07 18:53:58,2010-05-07 18:53:58
5b6733c303c2ecc67df0ca2db078efa280f941dc...db4cd346054cdd62ccbdb093a121ffec20c3b75e,8,487,389,876,364,2010-05-07 18:54:31,2010-05-07 18:54:31
db4cd346054cdd62ccbdb093a121ffec20c3b75e...e9d5ccb9ebc26a9712ea26d5c6c187b320bb1e20,1,1,0,1,1,2010-05-08 07:29:57,2010-05-08 07:29:57
e9d5ccb9ebc26a9712ea26d5c6c187b320bb1e20...9338ad0f2ed8b6fcfae6dae04db3db8df68594f0,1,45,26,71,21,2010-05-08 07:30:53,2010-05-08 07:30:53
9338ad0f2ed8b6fcfae6dae04db3db8df68594f0...0e6ff67ba248df3aed5025b593b86b8c80766011,1,8,0,8,1,2010-05-08 07:31:18,2010-05-08 07:31:18
0e6ff67ba248df3aed5025b593b86b8c80766011...19826d991030c90c2feaa4689291bbf6ce6292fa,1,1,1,2,1,2010-05-08 07:31:43,2010-05-08 07:31:43
19826d991030c90c2feaa4689291bbf6ce6292fa...0cb2ae9123940611599566add12d438029a863f1,1,1,1,2,1,2010-05-08 07:32:08,2010-05-08 07:32:08
0cb2ae9123940611599566add12d438029a863f1...e34ca2b1e214799b2b474dcc2a5f20e80a987d8d,1,6,3,9,1,2010-05-08 07:32:31,2010-05-08 07:32:31
e34ca2b1e214799b2b474dcc2a5f20e80a987d8d...6b1a2a8e44071a2b7415b3016227d12d382f17f2,1,1,1,2,1,2010-05-08 07:41:22,2010-05-08 07:41:22
6b1a2a8e44071a2b7415b3016227d12d382f17f2...cfc05d8d688f17cdd9827b9fdbfc8770b291c109,4,1637,761,2398,400,2010-05-08 12:42:51,2010-05-08 12:42:51
cfc05d8d688f17cdd9827b9fdbfc8770b291c109...b09581394e7dd7629e71c775d1cc7160b0c26184,5,88,7,95,11,2010-05-08 14:31:20,2010-05-08 14:31:20
b09581394e7dd7629e71c775d1cc7160b0c26184...0618cb24f595b5c8698cf6f4c3a2ccd3722160f0,1,232,10,242,8,2010-05-08 21:38:00,2010-05-08 21:38:00
0618cb24f595b5c8698cf6f4c3a2ccd3722160f0...4cf4acba459c41b8b41fc731149b3b03657fe7d4,2,24,0,24,8,2010-05-08 21:38:14,2010-05-08 21:38:14
4cf4acba459c41b8b41fc731149b3b03657fe7d4...47639b641060bc0520983314e68f1dbbbe57c1cb,5,517,4,521,5,2010-05-08 21:38:27,2010-05-08 21:38:27
47639b641060bc0520983314e68f1dbbbe57c1cb...c3c06b6519b60ab6322c2d8ce34dcc186241b6fb,2,369,282,651,247,2010-05-09 03:44:31,2010-05-09 03:44:31
c3c06b6519b60ab6322c2d8ce34dcc186241b6fb...362722b2a11ef2b91bf32dac066f4e69163e01cc,5,1802,892,2694,426,2010-05-09 03:45:09,2010-05-09 03:45:09
362722b2a11ef2b91bf32dac066f4e69163e01cc...b626d6024017138c4bfd76c8116269c9773df564,1,1,1,2,1,2010-05-09 04:23:00,2010-05-09 04:23:00
b626d6024017138c4bfd76c8116269c9773df564...663d17897eb26851cd41de888af41ec824f32fa6,4,12,14,26,8,2010-05-09 04:23:43,2010-05-09 04:23:43
663d17897eb26851cd41de888af41ec824f32fa6...e7e46d1f4b08665df5a073a840b4cdc795952c7c,1,6,1,7,2,2010-05-09 04:24:21,2010-05-09 04:24:21
e7e46d1f4b08665df5a073a840b4cdc795952c7c...5a2324afb2f46e86b2e61b2ae983b09715d13891,1,29,6,35,7,2010-05-09 04:24:58,2010-05-09 04:24:58
5a2324afb2f46e86b2e61b2ae983b09715d13891...3341f39f412fac95f42cf84e1f58a925b0e32bdc,1,15,6,21,3,2010-05-09 04:25:34,2010-05-09 04:25:34
3341f39f412fac95f42cf84e1f58a925b0e32bdc...2f279ec5950a30dece20615759b28fecada55580,1,10,7,17,6,2010-05-09 04:26:09,2010-05-09 04:26:09
2f279ec5950a30dece20615759b28fecada55580...cfddc2afbb27c61ce85cd97111222a77d57037da,4,1370,614,1984,326,2010-05-09 04:48:15,2010-05-09 04:48:15
cfddc2afbb27c61ce85cd97111222a77d57037da...5b28f8a07bece31eabc23a8bdf02e33d3d349243,1,9,0,9,1,2010-05-09 04:49:11,2010-05-09 04:49:11
5b28f8a07bece31eabc23a8bdf02e33d3d349243...ccf5bb188334fe36b436562025e38abda155aacf,1,5,5,10,2,2010-05-09 04:50:00,2010-05-09 04:50:00
ccf5bb188334fe36b436562025e38abda155aacf...ec136cee250cf86f5e67aa4b6fac46c242253299,1,9,1,10,2,2010-05-09 04:50:48,2010-05-09 04:50:48
ec136cee250cf86f5e67aa4b6fac46c242253299...ed33513988370da46808c99dacb3a0d6977d9b2a,1,1,1,2,1,2010-05-09 05:12:00,2010-05-09 05:12:00
ed33513988370da46808c99dacb3a0d6977d9b2a...4a15dc450996b62596d74f8d98388c9e2f4a10c7,1,20,9,29,2,2010-05-09 05:47:35,2010-05-09 05:47:35
4a15dc450996b62596d74f8d98388c9e2f4a10c7...5802ea3bbc24a74190ca97058c7894df260ff5b1,1,3,3,6,3,2010-05-09 05:48:06,2010-05-09 05:48:06
5802ea3bbc24a74190ca97058c7894df260ff5b1...55d65d335185f98e0a12b7a0caba6586ee4c594d,1,53,3,56,25,2010-05-09 05:48:45,2010-05-09 05:48:45
55d65d335185f98e0a12b7a0caba6586ee4c594d...5a74f0c936b2b1ff3764ad7a3f9019e0d8e9a4eb,1,5,0,5,1,2010-05-09 05:49:14,2010-05-09 05:49:14
5a74f0c936b2b1ff3764ad7a3f9019e0d8e9a4eb...bae2fa6f5cfd6827c0bdd995fe72dbb6794b7f9d,1,10,2,12,1,2010-05-09 06:42:16,2010-05-09 06:42:16
bae2fa6f5cfd6827c0bdd995fe72dbb6794b7f9d...7b98fe98f4b458207085c9548ad8999a71c7a401,1,1,1,2,1,2010-05-09 06:42:42,2010-05-09 06:42:42
7b98fe98f4b458207085c9548ad8999a71c7a401...1b16a03dba7704f4e5aaaa9344f8eda8c6ff6ae7,1,33,27,60,4,2010-05-09 06:43:18,2010-05-09 06:43:18
1b16a03dba7704f4e5aaaa9344f8eda8c6ff6ae7...3057a59ec438348f9b9d33933b1443d149a3dd0d,2,4,4,8,4,2010-05-09 06:44:12,2010-05-09 06:44:12
3057a59ec438348f9b9d33933b1443d149a3dd0d...f9b75db90f606d03569edcfa71792d443d7545f4,1,14,0,14,1,2010-05-09 06:44:52,2010-05-09 06:44:52
f9b75db90f606d03569edcfa71792d443d7545f4...ced4dd2aad6b0203dbf1f477f46e347f918982af,1,10,0,10,1,2010-05-09 06:45:21,2010-05-09 06:45:21
ced4dd2aad6b0203dbf1f477f46e347f918982af...9320c866ffbfba247641f42db9954c50ad0a5c6e,1,34,7,41,2,2010-05-09 07:44:06,2010-05-09 07:44:06
9320c866ffbfba247641f42db9954c50ad0a5c6e...f6e7a3aee53bcd733df2bc3effe1b2ebb97a5342,1,5,1,6,3,2010-05-09 07:44:39,2010-05-09 07:44:39
f6e7a3aee53bcd733df2bc3effe1b2ebb97a5342...887a4370d41b1bc119ee190a936174ce2ff523c0,2,114,0,114,2,2010-05-09 07:45:05,2010-05-09 07:45:05
887a4370d41b1bc119ee190a936174ce2ff523c0...49bd7f09591935be4b4dad04642a74bec26107e6,4,603,431,1034,275,2010-05-09 13:54:42,2010-05-09 13:54:42
49bd7f09591935be4b4dad04642a74bec26107e6...c796fc7e3630fcbc273d288609ab3cdbeda602a1,2,60,13,73,10,2010-05-09 13:55:15,2010-05-09 13:55:15
c796fc7e3630fcbc273d288609ab3cdbeda602a1...b5a628bf1510a0eb502b07634a6ff45fbc8cf751,8,5329,0,5329,5,2010-05-09 18:54:22,2010-05-09 18:54:22
b5a628bf1510a0eb502b07634a6ff45fbc8cf751...5a1695edfb8458b39c9a2a0727e994422417bf1f,1,1,0,1,1,2010-05-10 00:50:02,2010-05-10 00:50:02
5a1695edfb8458b39c9a2a0727e994422417bf1f...c4292f4b3b52173795a179902fc3f1a0abb90f14,4,1415,634,2049,345,2010-05-10 11:19:32,2010-05-10 11:19:32
c4292f4b3b52173795a179902fc3f1a0abb90f14...8b540073ebd74fef9d8b493f70bfdb0f58061e16,4,142,107,249,104,2010-05-10 11:19:57,2010-05-10 11:19:57
8b540073ebd74fef9d8b493f70bfdb0f58061e16...e3a3175d45c13d68b5780a4e5d51826eafe187f3,1,1,1,2,1,2010-05-10 11:20:17,2010-05-10 11:20:17
e3a3175d45c13d68b5780a4e5d51826eafe187f3...13532eb9ea2b63bb6812ac785b8d8edac57c55ca,1,2,1,3,2,2010-05-10 11:20:36,2010-05-10 11:20:36
13532eb9ea2b63bb6812ac785b8d8edac57c55ca...d73eb089f2a776e36790f10e295f76e797c17c97,1,15,15,30,14,2010-05-10 11:35:43,2010-05-10 11:35:43
d73eb089f2a776e36790f10e295f76e797c17c97...95fea01041729bbefd08805a3fb2b861d7065f00,1,1,1,2,1,2010-05-10 11:37:45,2010-05-10 11:37:45
95fea01041729bbefd08805a3fb2b861d7065f00...b82a5b9dd0041f81e3527eea1f254f381ad9ba1a,1,9,8,17,3,2010-05-10 11:38:37,2010-05-10 11:38:37
b82a5b9dd0041f81e3527eea1f254f381ad9ba1a...34587d8a2a5fd6cfd5fbe70b4b328a65d2407e0d,2,12,6,18,10,2010-05-10 12:28:00,2010-05-10 12:28:00
34587d8a2a5fd6cfd5fbe70b4b328a65d2407e0d...819f43f4993f651eb8d9747c477690dcd512992c,1,54,12,66,5,2010-05-10 12:29:04,2010-05-10 12:29:04
819f43f4993f651eb8d9747c477690dcd512992c...861baecd844bf0b1c153be18639bb285e75ec1d7,1,2,1,3,2,2010-05-10 12:39:53,2010-05-10 12:39:53
861baecd844bf0b1c153be18639bb285e75ec1d7...df1cc366e4fe28c57086952f0677c8a224bc23d4,1,1,7,8,7,2010-05-10 12:40:54,2010-05-10 12:40:54
df1cc366e4fe28c57086952f0677c8a224bc23d4...5b588dbab6039b76a916f084c40a7779af9dd110,1,125,113,238,112,2010-05-10 12:53:02,2010-05-10 12:53:02
5b588dbab6039b76a916f084c40a7779af9dd110...d12130a72c3efa297133c85c814fb966122494ea,1,0,0,0,0,2010-05-10 12:53:51,2010-05-10 12:53:51
d12130a72c3efa297133c85c814fb966122494ea...efa495f4f0df5f82bd1f930fec78b55af7596b4d,1,1,1,2,1,2010-05-10 13:11:09,2010-05-10 13:11:09
efa495f4f0df5f82bd1f930fec78b55af7596b4d...fa2062d1db6e1507c1c87a42f26d11bd5a5845af,1,1,1,2,1,2010-05-10 13:12:53,2010-05-10 13:12:53
fa2062d1db6e1507c1c87a42f26d11bd5a5845af...b34edc76eb05a676974cc74937228556cd8ca3b2,3,4,4,8,4,2010-05-10 13:14:19,2010-05-10 13:14:19
b34edc76eb05a676974cc74937228556cd8ca3b2...b832e6130891b335cf36a78b29220f5535e56499,1,7,6,13,1,2010-05-10 13:16:08,2010-05-10 13:16:08
b832e6130891b335cf36a78b29220f5535e56499...9f230c7eeb28cc4a33f85f0e23259a275452c883,1,1,1,2,1,2010-05-10 13:17:12,2010-05-10 13:17:12
9f230c7eeb28cc4a33f85f0e23259a275452c883...a44b10dba75409ade5870d196dd424b10e88869e,1,4,3,7,1,2010-05-10 14:03:11,2010-05-10 14:03:11
a44b10dba75409ade5870d196dd424b10e88869e...fed660e425a8ff5c0e96befdd2c0b6e6e2bb335b,1,8,0,8,1,2010-05-10 14:04:16,2010-05-10 14:04:16
fed660e425a8ff5c0e96befdd2c0b6e6e2bb335b...a0cf7f4bb9e966e7d225c43fe087097ee3ebcc85,1,1,1,2,1,2010-05-10 14:05:16,2010-05-10 14:05:16
a0cf7f4bb9e966e7d225c43fe087097ee3ebcc85...bc82e20370d9f0f2e55228bd680161ad034bc2ee,1,2,4,6,2,2010-05-10 14:06:09,2010-05-10 14:06:09
bc82e20370d9f0f2e55228bd680161ad034bc2ee...101571b940123deaf3d9dc2a32381ad2fe151d71,1,11,4,15,2,2010-05-10 14:07:05,2010-05-10 14:07:05
101571b940123deaf3d9dc2a32381ad2fe151d71...6c2f14e9fd71d698f3db43f6222dd85186b9e84e,3,1336,547,1883,323,2010-05-10 17:12:36,2010-05-10 17:12:36
6c2f14e9fd71d698f3db43f6222dd85186b9e84e...adde9f4bd2494dacb5c2e5b0fd240d34593e3af8,4,1988,875,2863,567,2010-05-10 22:00:17,2010-05-10 22:00:17
adde9f4bd2494dacb5c2e5b0fd240d34593e3af8...bbbf1002cf496dbf4fbc89be69d780c80110f797,2,67,34,101,22,2010-05-10 22:00:39,2010-05-10 22:00:39
bbbf1002cf496dbf4fbc89be69d780c80110f797...8d9bef9a464d52be56fd70c6dffc6a8fefd5e4b9,4,376,315,691,292,2010-05-11 06:10:58,2010-05-11 06:10:58
8d9bef9a464d52be56fd70c6dffc6a8fefd5e4b9...f6b0f742d178d95fbd17a40869c6de453e8cfcf0,3,120,4,124,10,2010-05-11 13:06:03,2010-05-11 13:06:03
f6b0f742d178d95fbd17a40869c6de453e8cfcf0...654353977799419183525663fcb8f2d7f39f715a,2,12,12,24,11,2010-05-11 13:07:09,2010-05-11 13:07:09
654353977799419183525663fcb8f2d7f39f715a...16c64bc2b723dad2db16db0f75c416ec30f964ad,2,3,3,6,3,2010-05-11 13:40:17,2010-05-11 13:40:17
16c64bc2b723dad2db16db0f75c416ec30f964ad...b160e1c172a96a2ae3800fa7df3dcf4246b539ea,2,20,20,40,17,2010-05-11 14:12:08,2010-05-11 14:12:08
b160e1c172a96a2ae3800fa7df3dcf4246b539ea...bfa0bae9a9eb14267ccdf5aa6b142ca1b5a9c314,5,1627,972,2599,404,2010-05-11 14:43:24,2010-05-11 14:43:24
bfa0bae9a9eb14267ccdf5aa6b142ca1b5a9c314...b6f0fa586b88299a851870df9c23bce1d5cb2f90,2,114,117,231,110,2010-05-11 21:46:39,2010-05-11 21:46:39
b6f0fa586b88299a851870df9c23bce1d5cb2f90...23976fa4b53a84bb3cbc5db070fbc6a1784d5e1d,1,9,3,12,3,2010-05-12 11:00:12,2010-05-12 11:00:12
23976fa4b53a84bb3cbc5db070fbc6a1784d5e1d...b8ed8279529fecd408a3043e205aced6f7d23089,1,26,8,34,3,2010-05-12 11:07:50,2010-05-12 11:07:50
b8ed8279529fecd408a3043e205aced6f7d23089...d0d3e6792da9e716e547f23dfd44706d2bab3c8e,6,114,17,131,17,2010-05-12 11:56:42,2010-05-12 11:56:42
d0d3e6792da9e716e547f23dfd44706d2bab3c8e...0e2f2156253e18bd174cb162152b7709850a5e55,1,1,1,2,1,2010-05-12 13:24:38,2010-05-12 13:24:38
0e2f2156253e18bd174cb162152b7709850a5e55...70a8f070069bf536e753381a7cb307008a97b9ed,2,1428,668,2096,392,2010-05-12 13:29:57,2010-05-12 13:29:57
70a8f070069bf536e753381a7cb307008a97b9ed...111d361d61fd4a40281db38850e560724bd908b0,1,1,1,2,1,2010-05-12 13:34:05,2010-05-12 13:34:05
111d361d61fd4a40281db38850e560724bd908b0...8e7d2d2e6824dc69fcfef8dc6467f6d874ddc9ee,4,5,5,10,4,2010-05-12 22:53:23,2010-05-12 22:53:23
8e7d2d2e6824dc69fcfef8dc6467f6d874ddc9ee...b29b0f8cac486f6733c2b768feccd83b62a13a9c,1,3,1,4,3,2010-05-13 11:11:27,2010-05-13 11:11:27
b29b0f8cac486f6733c2b768feccd83b62a13a9c...21e84194b5bab63f60f5d9f39d4c5ba5b1bbb5d7,22,191,15,206,33,2010-05-13 13:29:31,2010-05-13 13:29:31
21e84194b5bab63f60f5d9f39d4c5ba5b1bbb5d7...b3fff855ab622619d2732b3e961a83f39a06208d,2,47,43,90,44,2010-05-13 13:42:01,2010-05-13 13:42:01
b3fff855ab622619d2732b3e961a83f39a06208d...670baf2e48d3da2d9cc41e2e801891e5ff0467fd,4,1665,583,2248,368,2010-05-13 13:42:24,2010-05-13 13:42:24
670baf2e48d3da2d9cc41e2e801891e5ff0467fd...a193f355a882f2266da2a152901cdda2a83b4076,1,7,6,13,4,2010-05-14 01:51:14,2010-05-14 01:51:14
a193f355a882f2266da2a152901cdda2a83b4076...23decc4b86ef34bb631898a38bf7fe5ac89bc35a,1,119,92,211,32,2010-05-14 06:51:42,2010-05-14 06:51:42
23decc4b86ef34bb631898a38bf7fe5ac89bc35a...01f09c945e60037998db3dd1cf1c01184b87276a,4,175,122,297,123,2010-05-14 09:13:32,2010-05-14 09:13:32
01f09c945e60037998db3dd1cf1c01184b87276a...9900917d792462237ab89b174046d1a76adf9cda,1,1,1,2,1,2010-05-14 11:27:00,2010-05-14 11:27:00
9900917d792462237ab89b174046d1a76adf9cda...bca6a7f6c0f59449214f88ff8b1d360031a19c5d,1,7,7,14,2,2010-05-14 11:41:15,2010-05-14 11:41:15
bca6a7f6c0f59449214f88ff8b1d360031a19c5d...626d2e724344e9530e9881958a56b7daa117d6d9,1,4,6,10,2,2010-05-14 11:42:59,2010-05-14 11:42:59
626d2e724344e9530e9881958a56b7daa117d6d9...fa14e3127d64c9e5995a71977220516e1181a0f5,4,497,529,1026,420,2010-05-15 00:19:01,2010-05-15 00:19:01
fa14e3127d64c9e5995a71977220516e1181a0f5...34ddcd9939568e7d19a0059647a9faaf36972083,3,3,3,6,3,2010-05-16 15:54:10,2010-05-16 15:54:10
34ddcd9939568e7d19a0059647a9faaf36972083...06ab9eeaf5b43b7020b68363a23d1aab2e844aa6,2,24,5,29,6,2010-05-16 20:48:19,2010-05-16 20:48:19
06ab9eeaf5b43b7020b68363a23d1aab2e844aa6...a17d897751c95b022988cb1667acd11b6ba276d8,4,352,378,730,365,2010-05-16 20:48:45,2010-05-16 20:48:45
a17d897751c95b022988cb1667acd11b6ba276d8...10b5f385939d9addb2b5857ee69e80c05c304ac1,1,1,1,2,1,2010-05-17 00:27:37,2010-05-17 00:27:37
10b5f385939d9addb2b5857ee69e80c05c304ac1...b496518623a2a22792f06c2a66d130133a6763ae,2,5,5,10,4,2010-05-17 13:57:15,2010-05-17 13:57:15
b496518623a2a22792f06c2a66d130133a6763ae...acd8dcd5b01f239a0d94a29b7b74310f6a603d82,1,518,427,945,14,2010-05-17 16:32:29,2010-05-17 16:32:29
acd8dcd5b01f239a0d94a29b7b74310f6a603d82...47e3cc74d9bcf7ff2ce58cca34fa6575118357af,1,69,62,131,29,2010-05-17 16:32:37,2010-05-17 16:32:37
47e3cc74d9bcf7ff2ce58cca34fa6575118357af...d88d0ec336767c8e44c7d2b59a0eb6d8cac98c6e,1,17,12,29,6,2010-05-17 16:47:16,2010-05-17 16:47:16
d88d0ec336767c8e44c7d2b59a0eb6d8cac98c6e...c40b131ed5d84d2de4442af2110c7462293858df,1,6,5,11,2,2010-05-17 16:48:32,2010-05-17 16:48:32
c40b131ed5d84d2de4442af2110c7462293858df...6276167b728256b59071781b2f40d3f48f85cbbe,2,2,2,4,2,2010-05-17 17:31:49,2010-05-17 17:31:49
6276167b728256b59071781b2f40d3f48f85cbbe...f8af1afbea65f847f0eb5549a63d2bb35dcc235b,1,1,1,2,1,2010-05-17 17:42:14,2010-05-17 17:42:14
f8af1afbea65f847f0eb5549a63d2bb35dcc235b...9444c8dd1d6c2f8c8be6754b20952f7ef6125636,1,26,0,26,2,2010-05-17 17:57:07,2010-05-17 17:57:07
9444c8dd1d6c2f8c8be6754b20952f7ef6125636...5b6c20f2c45b0a1a9cf7e52e3d84cf0594e109f0,1,1,1,2,1,2010-05-17 18:21:18,2010-05-17 18:21:18
5b6c20f2c45b0a1a9cf7e52e3d84cf0594e109f0...ffcffcb96b7068718eb6e06bb168d194f367e643,1,2,2,4,2,2010-05-17 18:51:50,2010-05-17 18:51:50
ffcffcb96b7068718eb6e06bb168d194f367e643...97560f3a071ffbad983166093cf788ff56b9998e,1,2,2,4,2,2010-05-17 22:28:44,2010-05-17 22:28:44
97560f3a071ffbad983166093cf788ff56b9998e...747e8dfe5f26bc5311e48fa43cbc10c022a1824e,1,2,2,4,1,2010-05-19 03:25:42,2010-05-19 03:25:42
747e8dfe5f26bc5311e48fa43cbc10c022a1824e...6b2fd346ad10a2b2682881e249e8e1e79cafc1a8,1,1,1,2,1,2010-05-19 12:35:02,2010-05-19 12:35:02
6b2fd346ad10a2b2682881e249e8e1e79cafc1a8...8a6cb3d969b6fd18abb952b8d0e5ccd10488a742,4,35,7,42,8,2010-05-21 08:54:15,2010-05-21 08:54:15
8a6cb3d969b6fd18abb952b8d0e5ccd10488a742...b057a8b247d14328f058b8bc89da0519516ced82,7,43,35,78,30,2010-05-21 14:07:54,2010-05-21 14:07:54
b057a8b247d14328f058b8bc89da0519516ced82...286ce85e45a7356d96f27ee83a4587e5f44c87a9,2,10,1,11,2,2010-05-21 14:08:49,2010-05-21 14:08:49
286ce85e45a7356d96f27ee83a4587e5f44c87a9...5acd9cd8bab0866120d089e5e3d563e23fa3fd9e,1,22,8,30,3,2010-05-21 14:09:25,2010-05-21 14:09:25
5acd9cd8bab0866120d089e5e3d563e23fa3fd9e...84060a1f7aff712f6fde71884c501b50c9ef3d46,1,6,3,9,4,2010-05-21 14:25:26,2010-05-21 14:25:26
84060a1f7aff712f6fde71884c501b50c9ef3d46...6b2d6e18338631367c5a61896d872dbe27d2097e,1,25,5,30,6,2010-05-22 18:42:16,2010-05-22 18:42:16
6b2d6e18338631367c5a61896d872dbe27d2097e...e6ec07dc1f9070df4dab982aa4567def924bfe01,2,7,0,7,3,2010-05-23 10:38:23,2010-05-23 10:38:23
e6ec07dc1f9070df4dab982aa4567def924bfe01...6cffb9b8804278c4a617109e65493dc782ef2f7d,2,2,2,4,2,2010-05-24 19:10:30,2010-05-24 19:10:30
8da58e51ff117ffe209cefbd3a5f008dd163bec4...d201d57ffae5505b3db51c112c90344e54fb0208,0,0,0,0,0,2009-09-11 19:05:24,2009-09-11 19:05:24
d201d57ffae5505b3db51c112c90344e54fb0208...350d7ad5a165b3f2528aef866bcbf6b6780215f0,1,1,1,2,1,2009-09-11 19:08:55,2009-09-11 19:08:55
350d7ad5a165b3f2528aef866bcbf6b6780215f0...69aed8db4bc0c776c189675a3b11e74b284494c4,1,6,8,14,2,2009-09-11 22:00:24,2009-09-11 22:00:24
69aed8db4bc0c776c189675a3b11e74b284494c4...f03a1ab1b167b731d6eb536481605669731e162a,0,0,0,0,0,2009-09-12 22:02:08,2009-09-12 22:02:08
f03a1ab1b167b731d6eb536481605669731e162a...39c53b4bf383214cf2bfa034b2ba684057d9ff25,2,4,3,7,3,2009-09-12 22:05:23,2009-09-12 22:05:23
39c53b4bf383214cf2bfa034b2ba684057d9ff25...10e3c9f1e0d4754a5fdeaa7ac8e03d8db53b29d6,1,1,1,2,1,2009-09-13 04:54:48,2009-09-13 04:54:48
10e3c9f1e0d4754a5fdeaa7ac8e03d8db53b29d6...0fc36e4f917c89e817a486036d66cbcbac611a4a,1,25,25,50,24,2009-09-13 06:30:36,2009-09-13 06:30:36
0fc36e4f917c89e817a486036d66cbcbac611a4a...1fde94041496fe5e02d5a723eaf02b3839fdd949,1,1,1,2,1,2009-09-13 06:30:50,2009-09-13 06:30:50
1fde94041496fe5e02d5a723eaf02b3839fdd949...9908d7649f552f0d92455344328665c29c5a556a,1,1,1,2,1,2009-09-13 06:31:04,2009-09-13 06:31:04
9908d7649f552f0d92455344328665c29c5a556a...753d79a479d94c9cda3ff932640969b4465480c7,1,2,2,4,2,2009-09-13 06:31:17,2009-09-13 06:31:17
753d79a479d94c9cda3ff932640969b4465480c7...9815484905060107d53c4613ded35b4faedc2c80,1,24,24,48,22,2009-09-13 06:31:26,2009-09-13 06:31:26
9815484905060107d53c4613ded35b4faedc2c80...d57f98b8e82c09a0f8c9099ef9ff8963fa5ba7b6,1,1,2,3,1,2009-09-13 06:31:40,2009-09-13 06:31:40
d57f98b8e82c09a0f8c9099ef9ff8963fa5ba7b6...6988dad10143c303e78e44eb48a0aa593a5b6da7,1,1,1,2,1,2009-09-13 06:31:50,2009-09-13 06:31:50
6988dad10143c303e78e44eb48a0aa593a5b6da7...bea1678a10509687a1f9dd1e167eac6b3bf00b05,1,15,12,27,10,2009-09-13 06:32:00,2009-09-13 06:32:00
bea1678a10509687a1f9dd1e167eac6b3bf00b05...4d8451379560ad4836619b7113655747812f36a2,1,4,3,7,1,2009-09-13 06:32:09,2009-09-13 06:32:09
4d8451379560ad4836619b7113655747812f36a2...91bbfc57df818a8b5c70c80c5b79adc044be605a,1,1,0,1,1,2009-09-13 06:32:19,2009-09-13 06:32:19
91bbfc57df818a8b5c70c80c5b79adc044be605a...5312e7b40a6b3a4c20924a91f584052aa8b550ad,1,10,5,15,5,2009-09-13 06:32:31,2009-09-13 06:32:31
5312e7b40a6b3a4c20924a91f584052aa8b550ad...b5ee4ad4ba386f70b4f56f493dbf2acab3fc36a2,1,16,14,30,13,2009-09-13 06:32:42,2009-09-13 06:32:42
b5ee4ad4ba386f70b4f56f493dbf2acab3fc36a2...e9d1a7e98a9e9cfb3ac67ae614ae3f9a560acfb3,1,14,0,14,1,2009-09-13 06:32:53,2009-09-13 06:32:53
e9d1a7e98a9e9cfb3ac67ae614ae3f9a560acfb3...ceee67fba836856247ab044df53652b2383365cc,1,1,1,2,1,2009-09-13 06:33:02,2009-09-13 06:33:02
ceee67fba836856247ab044df53652b2383365cc...05c087300c4bf3c16591d115f75a48bd97ddc888,1,7,6,13,3,2009-09-13 06:33:09,2009-09-13 06:33:09
05c087300c4bf3c16591d115f75a48bd97ddc888...2075da35251b3a98277287df721153bed9600dc0,1,29,0,29,1,2009-09-13 06:33:18,2009-09-13 06:33:18
2075da35251b3a98277287df721153bed9600dc0...d30dd3e9c913c999c3185b708df5ebb19a9c5b31,1,11,5,16,5,2009-09-13 06:33:35,2009-09-13 06:33:35
d30dd3e9c913c999c3185b708df5ebb19a9c5b31...db1768becd5585840505408758fc42d5c1b77ae8,2,1,1,2,1,2009-09-13 06:33:49,2009-09-13 06:33:49
db1768becd5585840505408758fc42d5c1b77ae8...e5b3ffcd37b5b729ee107a019f807de000c4e172,2,2,3,5,3,2009-09-13 06:34:02,2009-09-13 06:34:02
e5b3ffcd37b5b729ee107a019f807de000c4e172...0c222b61b4fd68a1ef4585ffd1f19894fda6856d,1,1,1,2,1,2009-09-13 06:34:11,2009-09-13 06:34:11
0c222b61b4fd68a1ef4585ffd1f19894fda6856d...5f68bf0182e1ca0eeb637143d468aa96c01b218b,2,13,1,14,4,2009-09-13 16:14:58,2009-09-13 16:14:58
5f68bf0182e1ca0eeb637143d468aa96c01b218b...ba925def4900e7e932c1a15836ea5358872f9403,0,0,0,0,0,2009-09-13 17:04:47,2009-09-13 17:04:47
ba925def4900e7e932c1a15836ea5358872f9403...6febb7ef1584b73d24b079463057740c98cddfb3,2,26,11,37,8,2009-09-13 17:46:44,2009-09-13 17:46:44
6febb7ef1584b73d24b079463057740c98cddfb3...a2c7fe52a8e2d938621d1f7607e3d8a7a84ebf1e,2,11,1,12,2,2009-09-16 12:12:54,2009-09-16 12:12:54
a2c7fe52a8e2d938621d1f7607e3d8a7a84ebf1e...5074a4324120659b9ff550d1abcbb43eb58cc9c1,1,1,1,2,1,2009-09-16 12:16:27,2009-09-16 12:16:27
5074a4324120659b9ff550d1abcbb43eb58cc9c1...a7dd69c07962e9a3d286a8574c93d152acf430cc,1,4,4,8,2,2009-09-16 12:19:44,2009-09-16 12:19:44
a7dd69c07962e9a3d286a8574c93d152acf430cc...f6eb522a810477c17a1acc873715f2e7b47c1690,0,0,0,0,0,2009-09-16 12:23:04,2009-09-16 12:23:04
f6eb522a810477c17a1acc873715f2e7b47c1690...880a4474977639e94f8d1670af5a985b2bd881ae,1,1,1,2,1,2009-09-22 21:21:45,2009-09-22 21:21:45
880a4474977639e94f8d1670af5a985b2bd881ae...f8c97127bb494a4b1daae04dc812a54c1917f7fc,2,3,1,4,2,2009-09-23 23:41:35,2009-09-23 23:41:35
f8c97127bb494a4b1daae04dc812a54c1917f7fc...c557ea6c120798e49104aa475d24e4570a684776,1,11,0,11,1,2009-09-28 22:04:20,2009-09-28 22:04:20
c557ea6c120798e49104aa475d24e4570a684776...17173ac65af35683b8ca077a3a855eae1625ccd9,1,1,0,1,1,2009-10-08 13:32:23,2009-10-08 13:32:23
17173ac65af35683b8ca077a3a855eae1625ccd9...e3e992e18b368fcd56aabafc1b5bf80a6e11b495,2,35,2,37,4,2009-10-09 20:59:05,2009-10-09 20:59:05
e3e992e18b368fcd56aabafc1b5bf80a6e11b495...347346159be81a603bd0b74c73f96e99edf16c52,1,1,1,2,1,2009-10-09 21:06:09,2009-10-09 21:06:09
347346159be81a603bd0b74c73f96e99edf16c52...fb5e58f82d485d2ac6e4f6c22e2844ce5f73b0a6,1,1,0,1,1,2009-10-09 21:08:21,2009-10-09 21:08:21
fb5e58f82d485d2ac6e4f6c22e2844ce5f73b0a6...8a65192562d679bc48d2fbe0798bf08175f023f5,1,1,1,2,1,2009-10-09 22:07:49,2009-10-09 22:07:49
8a65192562d679bc48d2fbe0798bf08175f023f5...68ac924bb365dbc4eb95c498ac0e23fd4031b945,2,1,2,3,2,2009-10-09 22:17:43,2009-10-09 22:17:43
68ac924bb365dbc4eb95c498ac0e23fd4031b945...66939c28b97928952d00fa907bb132c931181c48,1,1,1,2,1,2009-10-12 16:57:01,2009-10-12 16:57:01
66939c28b97928952d00fa907bb132c931181c48...ec9b6f2616a8794b9530558291001aa12e845125,4,24,14,38,8,2009-10-14 13:41:37,2009-10-14 13:41:37
ec9b6f2616a8794b9530558291001aa12e845125...e2b83db9ef5bc5be3d42b75f7a4e37631a5bf165,12,145,14,159,19,2009-10-14 18:14:19,2009-10-14 18:14:19
e2b83db9ef5bc5be3d42b75f7a4e37631a5bf165...bc3f59787fa5673623c8178cbd208e0c26ec53f5,6,35,26,61,9,2009-10-15 14:18:52,2009-10-15 14:18:52
bc3f59787fa5673623c8178cbd208e0c26ec53f5...72bc0818ddb75113df1038d31ae6076d569df573,3,51,17,68,19,2009-10-17 17:46:44,2009-10-17 17:46:44
72bc0818ddb75113df1038d31ae6076d569df573...fb8653ad0e4f4a927c82ea8009dbd3877412e4db,2,23,2,25,6,2009-10-19 19:20:52,2009-10-19 19:20:52
fb8653ad0e4f4a927c82ea8009dbd3877412e4db...bde4c6d9955b2df78aed2f7ac540b017e4de3584,2,23,5,28,5,2009-10-19 19:21:08,2009-10-19 19:21:08
bde4c6d9955b2df78aed2f7ac540b017e4de3584...c1b3808ec0387b831eb255ce0759b47b19c67542,2,33,0,33,4,2009-10-19 21:17:33,2009-10-19 21:17:33
c1b3808ec0387b831eb255ce0759b47b19c67542...aaa9ccfe141f772baa8e08a7815f975e1ab29326,3,109,3,112,10,2009-10-20 14:14:27,2009-10-20 14:14:27
aaa9ccfe141f772baa8e08a7815f975e1ab29326...b06d1be7644a6c6a48745bea193d5649e67bc3b4,1,3,2,5,2,2009-10-23 20:48:52,2009-10-23 20:48:52
b06d1be7644a6c6a48745bea193d5649e67bc3b4...84dac3aa8245b4fd4b399989c729a1775e2bbbfe,1,3,0,3,1,2009-10-24 10:17:25,2009-10-24 10:17:25
84dac3aa8245b4fd4b399989c729a1775e2bbbfe...1f0266bd18871790681eb2d0590508ea156a8c58,2,13,7,20,2,2009-10-24 11:27:59,2009-10-24 11:27:59
1f0266bd18871790681eb2d0590508ea156a8c58...0ed09c8a7308573e36dbcecb9bff3fcb3d7b02b8,1,1,1,2,1,2009-10-24 14:12:46,2009-10-24 14:12:46
0ed09c8a7308573e36dbcecb9bff3fcb3d7b02b8...bf33627c63a475d1a1e0ee1400f4dc0e6cb2f076,2,24,1,25,3,2009-10-26 15:04:32,2009-10-26 15:04:32
bf33627c63a475d1a1e0ee1400f4dc0e6cb2f076...88ec9d97cbb7c693a8ee144fa99b85fb2075a7c6,0,0,0,0,0,2009-10-26 15:15:17,2009-10-26 15:15:17
88ec9d97cbb7c693a8ee144fa99b85fb2075a7c6...d2b6f6c9489be96fc8d0995f8a44b9ce9c787b02,1,5,5,10,4,2009-10-26 15:31:47,2009-10-26 15:31:47
d2b6f6c9489be96fc8d0995f8a44b9ce9c787b02...97ee7a3baf89690ded3a13843d8f9c86fbb1e857,1,8,2,10,2,2009-10-27 00:38:28,2009-10-27 00:38:28
97ee7a3baf89690ded3a13843d8f9c86fbb1e857...1ab0b23df6bfe91c214ccae740287af3151d5a95,3,16,1,17,3,2009-10-27 20:57:13,2009-10-27 20:57:13
1ab0b23df6bfe91c214ccae740287af3151d5a95...ebe540528269edde89365cf9330f98ebcad29fea,3,26,0,26,5,2009-10-27 21:50:58,2009-10-27 21:50:58
ebe540528269edde89365cf9330f98ebcad29fea...b1151bc2b3c195a2eb5614773cbb77e1a80eec66,2,13,2,15,4,2009-10-28 10:01:38,2009-10-28 10:01:38
b1151bc2b3c195a2eb5614773cbb77e1a80eec66...72933294d2a219f65f5213ddbe366232ca7a2059,4,64,3,67,7,2009-10-29 14:36:10,2009-10-29 14:36:10
72933294d2a219f65f5213ddbe366232ca7a2059...d45096437b55697348a9da8bf859eddfddbf3c68,1,0,6,6,2,2009-10-30 08:24:45,2009-10-30 08:24:45
d45096437b55697348a9da8bf859eddfddbf3c68...a429943467b2125d29e672150002d3d6cfd7a751,1,1,1,2,1,2009-10-30 08:49:56,2009-10-30 08:49:56
a429943467b2125d29e672150002d3d6cfd7a751...53275a4775ac22934170312aa2e3c7f0b1e4c4e7,2,11,1,12,2,2009-10-30 09:12:52,2009-10-30 09:12:52
53275a4775ac22934170312aa2e3c7f0b1e4c4e7...9e02b4a0e13afa1af1c0c7aa8cbe91c7c71eb139,0,0,0,0,0,2009-10-31 14:41:51,2009-10-31 14:41:51
9e02b4a0e13afa1af1c0c7aa8cbe91c7c71eb139...fe9a45e514c93d0b4e5e3ab246e87e1bd7e4d750,1,17,12,29,2,2009-11-01 03:06:44,2009-11-01 03:06:44
fe9a45e514c93d0b4e5e3ab246e87e1bd7e4d750...801a8925fa3462a45353e4924cf11e947532fa3a,1,77,84,161,5,2009-11-01 04:21:37,2009-11-01 04:21:37
801a8925fa3462a45353e4924cf11e947532fa3a...e109de3b7e7e0d7ea8f600c21811eef867a3ffd3,2,38,43,81,9,2009-11-01 04:54:56,2009-11-01 04:54:56
e109de3b7e7e0d7ea8f600c21811eef867a3ffd3...8061665c2785a10c26f4dd770a02d89cb8c49c68,1,2,2,4,2,2009-11-01 22:16:14,2009-11-01 22:16:14
8061665c2785a10c26f4dd770a02d89cb8c49c68...13d83908a4fa15570c265d310f2ecc4295bd7411,1,5,2,7,2,2009-11-01 23:13:59,2009-11-01 23:13:59
13d83908a4fa15570c265d310f2ecc4295bd7411...e114f4403a2e0f49de10cb8bd2fde90f4693c2c1,1,6,3,9,3,2009-11-01 23:52:31,2009-11-01 23:52:31
e114f4403a2e0f49de10cb8bd2fde90f4693c2c1...30ebd268be0f960082c7d721d911d699f67dd0a9,4,51,6,57,7,2009-11-02 02:24:01,2009-11-02 02:24:01
30ebd268be0f960082c7d721d911d699f67dd0a9...e3f07d2b4c270afd4133890b155e6b032e91f438,2,13,17,30,5,2009-11-02 08:27:00,2009-11-02 08:27:00
e3f07d2b4c270afd4133890b155e6b032e91f438...a9c816c41b091888a99918ee4c4038eccd577d84,1,6,2,8,3,2009-11-03 06:18:52,2009-11-03 06:18:52
a9c816c41b091888a99918ee4c4038eccd577d84...9a38c1cdb2b04ab62d46ee3fcc709680ca5d74ed,1,4,1,5,1,2009-11-04 02:01:54,2009-11-04 02:01:54
9a38c1cdb2b04ab62d46ee3fcc709680ca5d74ed...abd4344efe6bc9b138595a7d15998a0cbce5b9cf,2,13,3,16,3,2009-11-04 11:28:56,2009-11-04 11:28:56
abd4344efe6bc9b138595a7d15998a0cbce5b9cf...6ec45f3cb487d5faf50240072bf1440ff336b506,2,33,5,38,5,2009-11-11 13:08:33,2009-11-11 13:08:33
6ec45f3cb487d5faf50240072bf1440ff336b506...7f2f6bc8631a4f6952e11a824f423f3bac760443,3,105,83,188,60,2009-11-12 13:59:35,2009-11-12 13:59:35
7f2f6bc8631a4f6952e11a824f423f3bac760443...4cba436269947df3124fa55c6c53ae170ce596c5,7,155,48,203,20,2009-11-16 01:59:54,2009-11-16 01:59:54
4cba436269947df3124fa55c6c53ae170ce596c5...47f1330be1e43711133cec7f2a52e95fd8d74d73,2,12,2,14,3,2009-11-19 04:37:26,2009-11-19 04:37:26
47f1330be1e43711133cec7f2a52e95fd8d74d73...55b6f3cf21eb6159b1ef79ad7bcfc17a21143c6f,1,10,10,20,8,2009-11-19 11:20:06,2009-11-19 11:20:06
55b6f3cf21eb6159b1ef79ad7bcfc17a21143c6f...2ea5e4c743cfe33cb355f25b6179e84cc32cdcc4,2,14,0,14,2,2009-11-19 21:56:22,2009-11-19 21:56:22
2ea5e4c743cfe33cb355f25b6179e84cc32cdcc4...fa5ff296ce8e067ca135ad9d3f62ba57df0d5194,1,30,0,30,1,2009-11-20 15:04:16,2009-11-20 15:04:16
fa5ff296ce8e067ca135ad9d3f62ba57df0d5194...b24bb6864938cdf32239e4dcfce0d89aaad8f8de,4,84,22,106,11,2009-11-23 13:52:59,2009-11-23 13:52:59
b24bb6864938cdf32239e4dcfce0d89aaad8f8de...58c19c324b9d648ee8ae2d12efd4d102ce5096d2,2,10,2,12,4,2009-12-09 04:24:05,2009-12-09 04:24:05
58c19c324b9d648ee8ae2d12efd4d102ce5096d2...79d8d683d226a34edc268bce0a3d9056d60ae8e8,2,7,1,8,2,2009-12-10 20:01:59,2009-12-10 20:01:59
79d8d683d226a34edc268bce0a3d9056d60ae8e8...927529704655e72c1d349df1d6dd1480a1fe42aa,1,17,16,33,15,2009-12-12 06:02:42,2009-12-12 06:02:42
927529704655e72c1d349df1d6dd1480a1fe42aa...17350faeae85fc931842f180e84470a1948774ac,2,2,2,4,2,2009-12-12 07:15:25,2009-12-12 07:15:25
17350faeae85fc931842f180e84470a1948774ac...cf844fde9f1c5051b96bdd8ce58a0aa773926f0b,0,0,0,0,0,2009-12-12 13:07:13,2009-12-12 13:07:13
cf844fde9f1c5051b96bdd8ce58a0aa773926f0b...512ee70527e1b0c30a4db21d10f0129e00b7d991,1,10,8,18,2,2009-12-12 15:31:14,2009-12-12 15:31:14
512ee70527e1b0c30a4db21d10f0129e00b7d991...5e6c3d24b31af8af5514c6b7ecf700ae7836eef8,3,17,8,25,4,2009-12-12 17:29:46,2009-12-12 17:29:46
5e6c3d24b31af8af5514c6b7ecf700ae7836eef8...c1a8bd6779c2ff907d2d80b98d79c8ab10d642ae,4,24,0,24,2,2009-12-12 17:53:32,2009-12-12 17:53:32
c1a8bd6779c2ff907d2d80b98d79c8ab10d642ae...8bb3763c2bb6ae53e2ce36c5f2ed3c3e4545c90f,3,14,1,15,5,2009-12-12 18:22:09,2009-12-12 18:22:09
8bb3763c2bb6ae53e2ce36c5f2ed3c3e4545c90f...d0536312864f2bc52d7dae744283dcac2a6dd002,3,0,0,0,0,2009-12-12 18:48:20,2009-12-12 18:48:20
d0536312864f2bc52d7dae744283dcac2a6dd002...7f1c309cac93b63a4f2c9620802a60a7dc065f66,0,0,0,0,0,2009-12-12 19:39:04,2009-12-12 19:39:04
7f1c309cac93b63a4f2c9620802a60a7dc065f66...fa591297533b4949a2414fbb27a9ff4b48ea482c,9,137,40,177,51,2009-12-12 20:36:31,2009-12-12 20:36:31
fa591297533b4949a2414fbb27a9ff4b48ea482c...31618e3ea43b5bc17dd2a09be3d0631d4559f641,1,1,1,2,1,2009-12-12 20:55:46,2009-12-12 20:55:46
31618e3ea43b5bc17dd2a09be3d0631d4559f641...6c91e6ecbc10b32dd2c0f3f4e68d16647e4fb38d,3,36,1,37,5,2009-12-12 22:02:55,2009-12-12 22:02:55
6c91e6ecbc10b32dd2c0f3f4e68d16647e4fb38d...08b5d95922b01af08040d1a45707a75d39c6f881,1,1,1,2,1,2009-12-12 22:08:27,2009-12-12 22:08:27
08b5d95922b01af08040d1a45707a75d39c6f881...b5ffd10547e941a8514eae23bc1dc1ee908d2ff2,1,21,0,21,4,2009-12-13 15:19:21,2009-12-13 15:19:21
b5ffd10547e941a8514eae23bc1dc1ee908d2ff2...64736fe37f366519b52d236d1432c7b1fd831b02,2,53,2,55,3,2009-12-13 17:05:17,2009-12-13 17:05:17
64736fe37f366519b52d236d1432c7b1fd831b02...fee560f4e54816a1392342cb453cc22b54a60135,6,206,18,224,6,2009-12-13 22:08:03,2009-12-13 22:08:03
fee560f4e54816a1392342cb453cc22b54a60135...eef4739deeac46a8b06fc412182007669e55a427,1,4,4,8,2,2009-12-14 16:05:28,2009-12-14 16:05:28
eef4739deeac46a8b06fc412182007669e55a427...632a0e9a8d7ba5641400d720e1677ba4776e3f5b,3,52,2,54,4,2009-12-16 14:53:42,2009-12-16 14:53:42
632a0e9a8d7ba5641400d720e1677ba4776e3f5b...45bc45eac23eba3e5a9a901e1579eb866fe2affd,1,2,2,4,2,2009-12-16 15:16:21,2009-12-16 15:16:21
45bc45eac23eba3e5a9a901e1579eb866fe2affd...f4282336b3a7a8c88de524523b6044db53ea98b2,9,86,121,207,78,2009-12-16 18:17:18,2009-12-16 18:17:18
f4282336b3a7a8c88de524523b6044db53ea98b2...3071d098dbfe2217c0c7503f12acaf2abd1e6df0,2,227,162,389,87,2009-12-16 19:41:59,2009-12-16 19:41:59
3071d098dbfe2217c0c7503f12acaf2abd1e6df0...de6497009134cfe979556f64cab8ceaabc3c774d,3,61,30,91,15,2009-12-17 07:28:26,2009-12-17 07:28:26
de6497009134cfe979556f64cab8ceaabc3c774d...de2c7d9fddc17e7eae36fe1bc11b8a64e2aca081,2,32,23,55,25,2009-12-17 18:29:05,2009-12-17 18:29:05
de2c7d9fddc17e7eae36fe1bc11b8a64e2aca081...321fe61f642aa26b638a04c25f4c27534c4c2158,24,48,53,101,39,2009-12-17 22:11:39,2009-12-17 22:11:39
321fe61f642aa26b638a04c25f4c27534c4c2158...d10f9766ad76a16e32d5d7a28b0dd675b81a218f,1,5,5,10,3,2009-12-17 23:48:40,2009-12-17 23:48:40
d10f9766ad76a16e32d5d7a28b0dd675b81a218f...281114d2095608c93a00df2fc55a72f7cd5c2fcf,2,54,0,54,2,2009-12-19 08:24:20,2009-12-19 08:24:20
281114d2095608c93a00df2fc55a72f7cd5c2fcf...c81f1da152817153dced7d9fe577c38d2ef01de6,7,124,1,125,7,2009-12-19 15:27:50,2009-12-19 15:27:50
c81f1da152817153dced7d9fe577c38d2ef01de6...b15d762d7a03477384efea992de18adc1d2500ea,2,26,4,30,4,2009-12-19 15:31:28,2009-12-19 15:31:28
b15d762d7a03477384efea992de18adc1d2500ea...7d6213e0aa70340f4e3439abd43bc98427493bd8,3,22,17,39,7,2009-12-22 11:20:43,2009-12-22 11:20:43
7d6213e0aa70340f4e3439abd43bc98427493bd8...cf49f62be369996c845e7229d1801739473acc00,1,13,2,15,3,2009-12-22 14:37:24,2009-12-22 14:37:24
cf49f62be369996c845e7229d1801739473acc00...d65af73db4a682c546606e19d36bbbfb34c71148,0,0,0,0,0,2009-12-22 14:48:19,2009-12-22 14:48:19
d65af73db4a682c546606e19d36bbbfb34c71148...d0ea8f2d4cd8a43b174aa8ea75bf511503d09ea9,1,9,9,18,8,2009-12-22 15:57:45,2009-12-22 15:57:45
d0ea8f2d4cd8a43b174aa8ea75bf511503d09ea9...24b5489354bf757d095319a0355586526bc078c9,2,118,111,229,102,2009-12-22 16:18:30,2009-12-22 16:18:30
24b5489354bf757d095319a0355586526bc078c9...859ac5be13704915ac1ab3a11092dfcb1e24e1c0,2,115,110,225,101,2009-12-22 16:18:54,2009-12-22 16:18:54
859ac5be13704915ac1ab3a11092dfcb1e24e1c0...b0d779b1dd28999b776d2b466ae3892654b3a8c1,1,41,0,41,1,2009-12-22 17:44:09,2009-12-22 17:44:09
b0d779b1dd28999b776d2b466ae3892654b3a8c1...1ab5f1cc00a76a10b6f93a98ec64695e62cc047a,1,1,1,2,1,2009-12-22 17:54:04,2009-12-22 17:54:04
1ab5f1cc00a76a10b6f93a98ec64695e62cc047a...116ff7ff35204a378f16423899a92feee01678d0,2,1,1,2,1,2009-12-24 14:29:59,2009-12-24 14:29:59
116ff7ff35204a378f16423899a92feee01678d0...94b718915d537f87d6750d5eaacd8e005c7a53e7,2,22,15,37,11,2009-12-24 15:01:47,2009-12-24 15:01:47
94b718915d537f87d6750d5eaacd8e005c7a53e7...f67cd98b3f719408f853912d533b90b1b8a65743,2,70,56,126,17,2009-12-25 20:56:52,2009-12-25 20:56:52
f67cd98b3f719408f853912d533b90b1b8a65743...a94d7e761f4a5e007d4fb089cb5c406b7153d9dd,1,73,79,152,29,2009-12-25 21:08:02,2009-12-25 21:08:02
a94d7e761f4a5e007d4fb089cb5c406b7153d9dd...81f994583c442609fc63c470f33bf8867f10c184,2,13,11,24,7,2009-12-26 00:56:40,2009-12-26 00:56:40
81f994583c442609fc63c470f33bf8867f10c184...498c31364c06beea8dc83cc63c0cd006c6b4c625,14,41,31,72,21,2009-12-26 03:47:47,2009-12-26 03:47:47
498c31364c06beea8dc83cc63c0cd006c6b4c625...ed192ea56fc9e8ffa4b0ad467a207303631f5f37,1,5,5,10,5,2009-12-26 04:00:35,2009-12-26 04:00:35
ed192ea56fc9e8ffa4b0ad467a207303631f5f37...d8ea6831f9042502dbb4f24e51fe521349bd97ad,22,54,57,111,51,2009-12-26 06:44:02,2009-12-26 06:44:02
d8ea6831f9042502dbb4f24e51fe521349bd97ad...9e94f8f06d308e443ed01c7916b0e7aa5771ed01,1,0,9,9,1,2009-12-26 06:50:28,2009-12-26 06:50:28
9e94f8f06d308e443ed01c7916b0e7aa5771ed01...4c5429d2294f95d3c530f3497db661c3e82b94f6,4,244,189,433,98,2009-12-26 16:36:00,2009-12-26 16:36:00
4c5429d2294f95d3c530f3497db661c3e82b94f6...3201e7b0b19905ccf524211234421dd50dbf469a,1,36,34,70,15,2009-12-26 18:03:02,2009-12-26 18:03:02
3201e7b0b19905ccf524211234421dd50dbf469a...90f7dfb461df5081545aadd5cbe8d3a70c5e8a2e,1,2,2,4,1,2009-12-27 08:13:37,2009-12-27 08:13:37
90f7dfb461df5081545aadd5cbe8d3a70c5e8a2e...f1fe7c00e2c5496fd6998965385834f720bb35c2,2,3,1,4,2,2009-12-27 18:13:20,2009-12-27 18:13:20
f1fe7c00e2c5496fd6998965385834f720bb35c2...58bf653a26aae6ec466761c5d5933d1a5edfa641,2,27,16,43,6,2009-12-28 14:15:34,2009-12-28 14:15:34
58bf653a26aae6ec466761c5d5933d1a5edfa641...db867be91e10ef5f5f3ee929d92dc87454651895,2,1,3,4,3,2009-12-29 10:35:59,2009-12-29 10:35:59
db867be91e10ef5f5f3ee929d92dc87454651895...30c6021f80b5b7051a77b3df508ed41bcffcb8aa,1,7,2,9,2,2009-12-29 10:41:44,2009-12-29 10:41:44
30c6021f80b5b7051a77b3df508ed41bcffcb8aa...1a3fd10a341ba6cc010768c85fec8c0d2a8e5c3b,1,1,1,2,1,2010-01-01 21:44:30,2010-01-01 21:44:30
1a3fd10a341ba6cc010768c85fec8c0d2a8e5c3b...8e6803f733d09ab10ec448abb526dd2794dca9e0,1,3,3,6,3,2010-01-01 21:44:48,2010-01-01 21:44:48
8e6803f733d09ab10ec448abb526dd2794dca9e0...618e1b1587c8447b26df0c66a53b80ca1c67aa9e,1,5,5,10,5,2010-01-01 21:45:07,2010-01-01 21:45:07
618e1b1587c8447b26df0c66a53b80ca1c67aa9e...e8b001f46f7d5dff9268cf5a800a35bb505112bf,2,12,2,14,5,2010-01-03 06:56:10,2010-01-03 06:56:10
e8b001f46f7d5dff9268cf5a800a35bb505112bf...f68607508380a176aa612c1928ee0a5acb635624,1,13,4,17,2,2010-01-03 18:07:11,2010-01-03 18:07:11
f68607508380a176aa612c1928ee0a5acb635624...07fa03dde4b027f9add2735f2c12907894631318,2,2,2,4,2,2010-01-03 18:57:15,2010-01-03 18:57:15
07fa03dde4b027f9add2735f2c12907894631318...5d75b3d5c4b9dd8fa2837f47843dd78aadb94666,1,14,1,15,2,2010-01-03 19:03:33,2010-01-03 19:03:33
5d75b3d5c4b9dd8fa2837f47843dd78aadb94666...d4f9bff7ef190fdaedaa5319718f1db265d86d56,6,17,17,34,17,2010-01-04 22:22:16,2010-01-04 22:22:16
d4f9bff7ef190fdaedaa5319718f1db265d86d56...3de16688a93d64154dea1f5517d3e9e80b97b080,3,16,1,17,4,2010-01-05 13:20:19,2010-01-05 13:20:19
3de16688a93d64154dea1f5517d3e9e80b97b080...4bbbf6cc12fded628fc5115523907be691c0d13b,2,35,19,54,10,2010-01-08 00:21:45,2010-01-08 00:21:45
4bbbf6cc12fded628fc5115523907be691c0d13b...03d57f0a82fb0997ef66adbab720a5597cbfe78c,1,2,2,4,2,2010-01-09 19:20:51,2010-01-09 19:20:51
03d57f0a82fb0997ef66adbab720a5597cbfe78c...9041b1addffba0789a0ae7048691f6220ea40b1b,1,2,2,4,1,2010-01-09 21:03:25,2010-01-09 21:03:25
9041b1addffba0789a0ae7048691f6220ea40b1b...ad6368809cd6583eda23f3aed5ccae0ae44f15b6,7,279,12,291,12,2010-01-16 03:26:02,2010-01-16 03:26:02
ad6368809cd6583eda23f3aed5ccae0ae44f15b6...a0ccd5062346939219f4fa37d3257c213d0d9780,1,0,4,4,1,2010-01-16 13:34:19,2010-01-16 13:34:19
a0ccd5062346939219f4fa37d3257c213d0d9780...0b52750887b48c038477fc80606614b4ed4a1e2c,0,0,0,0,0,2010-01-17 20:26:02,2010-01-17 20:26:02
0b52750887b48c038477fc80606614b4ed4a1e2c...2986dc7b280cda9440594519ec21b96cd35fcb81,3,0,98,98,3,2010-01-17 20:47:35,2010-01-17 20:47:35
2986dc7b280cda9440594519ec21b96cd35fcb81...fe4d3f89e4fad2b852c5f38a3daa0e03dc29ea1d,2,2,0,2,2,2010-01-17 22:08:47,2010-01-17 22:08:47
fe4d3f89e4fad2b852c5f38a3daa0e03dc29ea1d...4d409c0b3b23168848771ab7641c1aa13583fc5c,1,1,1,2,1,2010-01-17 22:09:07,2010-01-17 22:09:07
4d409c0b3b23168848771ab7641c1aa13583fc5c...3a6f58a169a15619d94490596148a78c2e71e9b4,2,10,1,11,2,2010-01-17 22:09:33,2010-01-17 22:09:33
3a6f58a169a15619d94490596148a78c2e71e9b4...7b5b1c7ecdb6f3628acf43ae51a07c19b60eb6cd,3,6,3,9,3,2010-01-17 22:09:59,2010-01-17 22:09:59
7b5b1c7ecdb6f3628acf43ae51a07c19b60eb6cd...0216255632138df9bc7761d3c7a819c1f0c53a43,1,2,1,3,2,2010-01-17 22:10:19,2010-01-17 22:10:19
0216255632138df9bc7761d3c7a819c1f0c53a43...8eaffeac8aa02e3196a520ccf9fc5be960f9b8ef,1,2,2,4,2,2010-01-17 22:10:37,2010-01-17 22:10:37
8eaffeac8aa02e3196a520ccf9fc5be960f9b8ef...889c110e51946deb27fb41857cea0f2bbaa6a6a0,2,23,3,26,3,2010-01-17 22:11:00,2010-01-17 22:11:00
889c110e51946deb27fb41857cea0f2bbaa6a6a0...dc3d26bb597070a52927201d1ec13534673fa732,3,13,0,13,3,2010-01-17 22:11:23,2010-01-17 22:11:23
dc3d26bb597070a52927201d1ec13534673fa732...0c4f8b345f04c4fe8b07f42c5f846f43ee3c05fb,1,104,2,106,17,2010-01-17 22:11:43,2010-01-17 22:11:43
0c4f8b345f04c4fe8b07f42c5f846f43ee3c05fb...d060d84bbcf7fd49197be7f2da1c2891f80e3ce9,1,1,1,2,1,2010-01-17 22:12:02,2010-01-17 22:12:02
d060d84bbcf7fd49197be7f2da1c2891f80e3ce9...b3ec5e68eb5f9675d6e7e89dc8e771b9147dc74f,2,196,0,196,2,2010-01-17 22:12:24,2010-01-17 22:12:24
b3ec5e68eb5f9675d6e7e89dc8e771b9147dc74f...abea4e6ee3e87e384fb36cbdad0f7fb0b836dd49,1,2,2,4,2,2010-01-17 22:20:10,2010-01-17 22:20:10
abea4e6ee3e87e384fb36cbdad0f7fb0b836dd49...d1e7fdea3fe3e4dd28301151ef4e83fe2a2d0a1c,2,6,1,7,2,2010-01-17 22:51:25,2010-01-17 22:51:25
d1e7fdea3fe3e4dd28301151ef4e83fe2a2d0a1c...3a417736bc28cdf2432e30e8d035de252fddd4ec,2,19,1,20,3,2010-01-17 23:10:23,2010-01-17 23:10:23
3a417736bc28cdf2432e30e8d035de252fddd4ec...d4a2d1f47c578ff3e0bdb2e5c38de5e1f86721e6,0,0,0,0,0,2010-01-18 00:00:31,2010-01-18 00:00:31
d4a2d1f47c578ff3e0bdb2e5c38de5e1f86721e6...a8e659c54fee749eb4e3496db75ae225ffb9dfb0,1,2,2,4,1,2010-01-18 13:02:07,2010-01-18 13:02:07
a8e659c54fee749eb4e3496db75ae225ffb9dfb0...46d8ae7c243127a98a7bc1b745ef84d37d82f76c,3,27,1,28,5,2010-01-19 16:55:22,2010-01-19 16:55:22
46d8ae7c243127a98a7bc1b745ef84d37d82f76c...da954e876b75be18b5635aa553af17e791971445,3,43,10,53,9,2010-01-22 19:43:14,2010-01-22 19:43:14
da954e876b75be18b5635aa553af17e791971445...a3f4402853b7beb7a89cc88a1500818f94f8d313,2,64,3,67,4,2010-01-23 23:25:41,2010-01-23 23:25:41
a3f4402853b7beb7a89cc88a1500818f94f8d313...77b25ea4da1aa0bdbc7c6a0ea63085285b66cef7,1,11,0,11,1,2010-01-23 23:58:40,2010-01-23 23:58:40
77b25ea4da1aa0bdbc7c6a0ea63085285b66cef7...19353d9c590134a3c99d9723c1de754fe6e09626,1,6,6,12,2,2010-01-25 19:30:56,2010-01-25 19:30:56
19353d9c590134a3c99d9723c1de754fe6e09626...0c9f63f626952bce599fd347801b9d36b966ed07,1,6,6,12,1,2010-01-27 23:52:15,2010-01-27 23:52:15
0c9f63f626952bce599fd347801b9d36b966ed07...11d5faae544cff1809ff52b95db20643ce74c964,2,3,3,6,3,2010-01-28 02:05:58,2010-01-28 02:05:58
11d5faae544cff1809ff52b95db20643ce74c964...85b011287e6d80c36bb1f2e978433352c85b818f,2,388,239,627,216,2010-01-28 02:06:28,2010-01-28 02:06:28
85b011287e6d80c36bb1f2e978433352c85b818f...3e4f81070252295fcd3e40469182a3f46ef25fcb,2,118,111,229,95,2010-01-28 02:06:58,2010-01-28 02:06:58
3e4f81070252295fcd3e40469182a3f46ef25fcb...c162ac07573b763b2f90921e9ecc9398d41c8c87,4,554,542,1096,272,2010-01-28 02:07:35,2010-01-28 02:07:35
c162ac07573b763b2f90921e9ecc9398d41c8c87...fa092e27465d6364dfe86bf22ceb30895e7f324f,2,10,8,18,8,2010-01-28 02:08:05,2010-01-28 02:08:05
fa092e27465d6364dfe86bf22ceb30895e7f324f...d33cab6f19be196028d315e50eef06aa042f84b8,3,1845,5,1850,10,2010-01-28 02:08:50,2010-01-28 02:08:50
d33cab6f19be196028d315e50eef06aa042f84b8...cf21fec23d3be4b810e7948562cc81c0defd1085,2,305,298,603,293,2010-01-28 02:09:24,2010-01-28 02:09:24
cf21fec23d3be4b810e7948562cc81c0defd1085...39439790954435a135b0c1c8e25a84df5c129c1a,3,5117,0,5117,3,2010-01-28 02:10:08,2010-01-28 02:10:08
39439790954435a135b0c1c8e25a84df5c129c1a...dcd58497da04f653a3ed0c5c2ca44bc757d77113,3,1,1,2,1,2010-01-28 02:17:30,2010-01-28 02:17:30
dcd58497da04f653a3ed0c5c2ca44bc757d77113...2777cd37a8ceb04e3d4b28de674f9600ff0e0b4a,1,3,3,6,3,2010-01-28 13:51:00,2010-01-28 13:51:00
2777cd37a8ceb04e3d4b28de674f9600ff0e0b4a...4a1be98aee7aba994645d943af0a31aaab6ee11e,3,74,6,80,6,2010-01-28 13:59:57,2010-01-28 13:59:57
4a1be98aee7aba994645d943af0a31aaab6ee11e...6d02f50a8ba2e5c3aa911de9d9837523693cea5e,5,5131,0,5131,3,2010-01-28 14:18:46,2010-01-28 14:18:46
6d02f50a8ba2e5c3aa911de9d9837523693cea5e...32b573d36b42b37c5ce86185074fd239128826ca,1,1,1,2,1,2010-01-28 14:47:42,2010-01-28 14:47:42
32b573d36b42b37c5ce86185074fd239128826ca...ab75fd4786563c4c178aa1164c96c826d0a88aa6,1,8,0,8,1,2010-01-28 22:14:38,2010-01-28 22:14:38
ab75fd4786563c4c178aa1164c96c826d0a88aa6...4043521f538c68f17605e37a2ceae1148d7da64a,2,30,1,31,3,2010-01-29 18:02:35,2010-01-29 18:02:35
4043521f538c68f17605e37a2ceae1148d7da64a...75146a3d7b85580244ebeda36241396290a0de15,1,7,3,10,4,2010-01-29 18:05:58,2010-01-29 18:05:58
75146a3d7b85580244ebeda36241396290a0de15...daeceafee6e7afb3bbe08a1ebd6eee589115de16,1,0,16,16,1,2010-02-01 11:53:55,2010-02-01 11:53:55
daeceafee6e7afb3bbe08a1ebd6eee589115de16...88bd40c551365c92312e79a51fc4891a0099d9fe,1,1,1,2,1,2010-02-03 18:12:35,2010-02-03 18:12:35
88bd40c551365c92312e79a51fc4891a0099d9fe...01d43168749abe027473b34002ca76b4ce3d1eaa,4,60,29,89,6,2010-02-05 01:54:22,2010-02-05 01:54:22
01d43168749abe027473b34002ca76b4ce3d1eaa...750c889a743ac09ea75b6e86ef9b34257d25019b,0,0,0,0,0,2010-02-10 17:43:05,2010-02-10 17:43:05
750c889a743ac09ea75b6e86ef9b34257d25019b...ad08f077229450df0386bcab407f5953f3869fb8,3,53,3,56,8,2010-02-10 19:24:44,2010-02-10 19:24:44
ad08f077229450df0386bcab407f5953f3869fb8...3792b2cd9f0c84f29ec4300eba7bd443452c4a25,2,36,2,38,5,2010-02-11 13:09:56,2010-02-11 13:09:56
3792b2cd9f0c84f29ec4300eba7bd443452c4a25...a9282168f5952cfb5c7008c603aed78aaff142b2,1,1,1,2,1,2010-02-11 13:10:52,2010-02-11 13:10:52
a9282168f5952cfb5c7008c603aed78aaff142b2...d4a34b5508a73c47d9e7220ee92dd7b8fb9e4262,3,8,6,14,4,2010-02-11 13:11:47,2010-02-11 13:11:47
d4a34b5508a73c47d9e7220ee92dd7b8fb9e4262...f764d7ffb1c0681448675d7ff618042e722b68f6,2,6,7,13,4,2010-02-11 13:12:38,2010-02-11 13:12:38
f764d7ffb1c0681448675d7ff618042e722b68f6...0e9f1553e1e5766559b077483ae445af11d9bb82,1,2,1,3,1,2010-02-11 13:23:11,2010-02-11 13:23:11
0e9f1553e1e5766559b077483ae445af11d9bb82...bf11ab2b212de5bfee143d6e53584434d85b32a7,4,24,1,25,6,2010-02-13 12:32:01,2010-02-13 12:32:01
bf11ab2b212de5bfee143d6e53584434d85b32a7...1d9bc59534fd765f8ae1aeb4ca039899bc2b452b,6,9,10,19,6,2010-02-13 12:32:49,2010-02-13 12:32:49
1d9bc59534fd765f8ae1aeb4ca039899bc2b452b...d751f2cade81b6a8cf325ab5dd081c015f727ef3,6,27,3,30,7,2010-02-13 14:06:13,2010-02-13 14:06:13
d751f2cade81b6a8cf325ab5dd081c015f727ef3...f30a4b368cd6a03dfbbfd2145d06f747664ece86,2,7,6,13,2,2010-02-13 14:43:33,2010-02-13 14:43:33
f30a4b368cd6a03dfbbfd2145d06f747664ece86...166405b2e4197fba7d5638ee732f2170f8647f62,2,10,1,11,2,2010-02-13 14:44:07,2010-02-13 14:44:07
166405b2e4197fba7d5638ee732f2170f8647f62...a9879b14387f4ee8439b4fc53ef55602b6a48db2,6,41,14,55,11,2010-02-14 18:33:01,2010-02-14 18:33:01
a9879b14387f4ee8439b4fc53ef55602b6a48db2...9f78e4692c6d119226cce34f2cb7c549e40862b2,1,7,1,8,2,2010-02-14 20:33:32,2010-02-14 20:33:32
9f78e4692c6d119226cce34f2cb7c549e40862b2...4384b164ccdd2d45e38cc3116f9e49c50c4268fa,1,5,2,7,2,2010-02-15 02:18:15,2010-02-15 02:18:15
4384b164ccdd2d45e38cc3116f9e49c50c4268fa...a23edb643bdbfde6be1e0a63d1a8bd2a1be13710,10,1203,1091,2294,15,2010-02-16 12:50:47,2010-02-16 12:50:47
a23edb643bdbfde6be1e0a63d1a8bd2a1be13710...a1ecd073e6815ef94a46f7fc02cccda33ba44da9,1,7,6,13,6,2010-02-16 12:51:12,2010-02-16 12:51:12
a1ecd073e6815ef94a46f7fc02cccda33ba44da9...6a3c9159338055339f64e73de39598d26e5656c8,6,47,1,48,3,2010-02-16 12:51:43,2010-02-16 12:51:43
6a3c9159338055339f64e73de39598d26e5656c8...df1ad561b124450388a696e668fa6549f2bbe446,2,29,0,29,6,2010-02-16 12:52:04,2010-02-16 12:52:04
df1ad561b124450388a696e668fa6549f2bbe446...77192eb661ffc1768d75cb3ed4f253240da8e6c0,3,28,2,30,6,2010-02-16 12:52:33,2010-02-16 12:52:33
77192eb661ffc1768d75cb3ed4f253240da8e6c0...49c116f14c3bae630ec501dbe97586cf0d968e2b,1,1,1,2,1,2010-02-22 00:42:33,2010-02-22 00:42:33
49c116f14c3bae630ec501dbe97586cf0d968e2b...71897bf300e2aad71ac66e5843942e79e0147c18,1,1,1,2,1,2010-02-22 00:42:51,2010-02-22 00:42:51
71897bf300e2aad71ac66e5843942e79e0147c18...4261efdc673c8034aa372b790e5c1c7e591d4fbc,1,3,3,6,3,2010-02-22 00:43:10,2010-02-22 00:43:10
4261efdc673c8034aa372b790e5c1c7e591d4fbc...713bac952f44bde7b80b4266eecb270ea248f10d,1,1,1,2,1,2010-02-22 00:43:29,2010-02-22 00:43:29
713bac952f44bde7b80b4266eecb270ea248f10d...4f1134898cf9c5d169a0c48131af81b71a8ba605,1,2,0,2,1,2010-02-22 00:43:47,2010-02-22 00:43:47
4f1134898cf9c5d169a0c48131af81b71a8ba605...5059de200b09782b0c44d27be5fdcff9fd8ef183,1,1,1,2,1,2010-02-22 00:44:05,2010-02-22 00:44:05
5059de200b09782b0c44d27be5fdcff9fd8ef183...9ee2d5c646bc078aa336cb0b12d6f28d6bfbb436,2,35,2,37,3,2010-02-22 00:44:27,2010-02-22 00:44:27
9ee2d5c646bc078aa336cb0b12d6f28d6bfbb436...8b415e7299aebd0c4109925d8fe366734810413a,2,18,0,18,2,2010-02-22 15:02:45,2010-02-22 15:02:45
8b415e7299aebd0c4109925d8fe366734810413a...8c4f16657fd77de0a37b5658e5f9f5bee6a5bcb9,1,0,2,2,1,2010-02-22 22:14:31,2010-02-22 22:14:31
8c4f16657fd77de0a37b5658e5f9f5bee6a5bcb9...bd79677e2999b545c27be8b2696c7f176ad78001,2,10,1,11,2,2010-02-22 23:41:29,2010-02-22 23:41:29
bd79677e2999b545c27be8b2696c7f176ad78001...16efc1a92e30e5f8a9ecc89edf0002db2425b3b4,3,38,4,42,5,2010-02-23 00:08:03,2010-02-23 00:08:03
16efc1a92e30e5f8a9ecc89edf0002db2425b3b4...6a28f581c0fec79f387fa10dddb9bdc8594a03d6,3,17,22,39,11,2010-02-23 05:59:04,2010-02-23 05:59:04
6a28f581c0fec79f387fa10dddb9bdc8594a03d6...b9d1c5d9f65d0d6f1a812b0a90b33f5106d98101,1,1,1,2,1,2010-02-23 13:29:18,2010-02-23 13:29:18
b9d1c5d9f65d0d6f1a812b0a90b33f5106d98101...7c1671b4803a4ca78540a288a14eb2ec8ba74d80,1,8,3,11,2,2010-02-23 13:29:52,2010-02-23 13:29:52
7c1671b4803a4ca78540a288a14eb2ec8ba74d80...e771d15e2d89c08d60e4d7967530e219acdc6ebd,1,7,6,13,1,2010-02-23 13:30:18,2010-02-23 13:30:18
e771d15e2d89c08d60e4d7967530e219acdc6ebd...cda48e9f0ba20ef993379001a0f94a479fbf23cb,1,1,0,1,1,2010-02-23 13:30:49,2010-02-23 13:30:49
cda48e9f0ba20ef993379001a0f94a479fbf23cb...fd0c3656907f06d860ed7bb07daa1ae2c5bf9e11,2,21,3,24,2,2010-02-23 14:20:35,2010-02-23 14:20:35
fd0c3656907f06d860ed7bb07daa1ae2c5bf9e11...c702e262ff7258773424b2842f49ae472d0c9f7b,1,1,1,2,1,2010-02-23 15:11:01,2010-02-23 15:11:01
c702e262ff7258773424b2842f49ae472d0c9f7b...d23f2249ea9ec4563ba18cf0c9de4d53d138113b,2,9,1,10,2,2010-02-23 15:12:29,2010-02-23 15:12:29
d23f2249ea9ec4563ba18cf0c9de4d53d138113b...c7117b103a5a2ae50903faf2197ebafb6cd3687a,0,0,0,0,0,2010-02-23 15:27:36,2010-02-23 15:27:36
c7117b103a5a2ae50903faf2197ebafb6cd3687a...651082267956cef3bf3dbd48c5314046c14ca01c,9,94,4,98,13,2010-02-23 17:26:20,2010-02-23 17:26:20
651082267956cef3bf3dbd48c5314046c14ca01c...a599e50b07cb9ec64ebc06a7fdb7b47ed7d762bb,1,1,1,2,1,2010-02-23 17:32:07,2010-02-23 17:32:07
a599e50b07cb9ec64ebc06a7fdb7b47ed7d762bb...ae01b0c5cb86ba68a0eeaac87b31206d9a4023bf,2,2,2,4,2,2010-02-23 18:40:07,2010-02-23 18:40:07
ae01b0c5cb86ba68a0eeaac87b31206d9a4023bf...f48cf954f80a4d4b2608da8aaef4feda0f352313,2,15,2,17,4,2010-02-23 18:53:42,2010-02-23 18:53:42
f48cf954f80a4d4b2608da8aaef4feda0f352313...a1bff5f823687ba9c3b83915e28f35e20fe5641a,2,2,2,4,2,2010-02-23 19:00:50,2010-02-23 19:00:50
a1bff5f823687ba9c3b83915e28f35e20fe5641a...860497c9b3f2f54ef71cb55b5b59dbb9f24dfccd,3,34,1,35,4,2010-02-23 21:09:27,2010-02-23 21:09:27
860497c9b3f2f54ef71cb55b5b59dbb9f24dfccd...87bb1608bdc96ee12c280e1c89932dba22ed7e59,0,0,0,0,0,2010-02-23 21:12:14,2010-02-23 21:12:14
87bb1608bdc96ee12c280e1c89932dba22ed7e59...778b7bcd19c3ac540412b6f9c5888cb9f1e28d89,1,1,1,2,1,2010-02-23 23:04:25,2010-02-23 23:04:25
778b7bcd19c3ac540412b6f9c5888cb9f1e28d89...d75e23ce9ba57af9e63a824a54249bbfb0edce99,2,24,1,25,2,2010-02-23 23:48:44,2010-02-23 23:48:44
d75e23ce9ba57af9e63a824a54249bbfb0edce99...ef7debf34bebe3a478a257b0430c6cac036b797e,1,1,2,3,1,2010-02-24 14:05:18,2010-02-24 14:05:18
ef7debf34bebe3a478a257b0430c6cac036b797e...d33fd127f8f0f7f71e1bc3e7974cebb408e44cea,2,4,0,4,2,2010-02-24 14:05:58,2010-02-24 14:05:58
d33fd127f8f0f7f71e1bc3e7974cebb408e44cea...f7b415869c20ae39180e7b783fabae911a0a0893,1,8,0,8,1,2010-02-24 14:06:51,2010-02-24 14:06:51
f7b415869c20ae39180e7b783fabae911a0a0893...fbe455e1ac7a05032aaa28a89c79d7f1cafc33b7,1,19,16,35,6,2010-02-24 14:07:25,2010-02-24 14:07:25
fbe455e1ac7a05032aaa28a89c79d7f1cafc33b7...18c800f1a389e20de45e0df0f8de3fa5303f887d,3,73,8,81,7,2010-02-24 14:42:03,2010-02-24 14:42:03
18c800f1a389e20de45e0df0f8de3fa5303f887d...c1edfcd9ae65fb27f9f8534ae1374dae40b3bbf2,2,8,0,8,4,2010-02-24 14:52:21,2010-02-24 14:52:21
c1edfcd9ae65fb27f9f8534ae1374dae40b3bbf2...770b31e2093d8a69e43f8b3f8a967ba854ccccc1,1,1,1,2,1,2010-02-24 14:52:49,2010-02-24 14:52:49
770b31e2093d8a69e43f8b3f8a967ba854ccccc1...692d122ce20c2136e796a72532e7a5f753785769,3,45,4,49,6,2010-02-24 15:40:33,2010-02-24 15:40:33
692d122ce20c2136e796a72532e7a5f753785769...07f2d19269e1c4ff3b1a2ad04ce5501434488d36,3,11,3,14,4,2010-02-24 16:06:10,2010-02-24 16:06:10
07f2d19269e1c4ff3b1a2ad04ce5501434488d36...6bf75fd3f57c2074e2612d714cb73e66194dd46a,2,10,3,13,2,2010-02-24 20:56:09,2010-02-24 20:56:09
6bf75fd3f57c2074e2612d714cb73e66194dd46a...400640257052df2291ecf11ee785d86e54a264b6,0,0,0,0,0,2010-02-24 21:16:37,2010-02-24 21:16:37
400640257052df2291ecf11ee785d86e54a264b6...49194df8c3bfccaaab88715999160a4c46ae6dbd,1,27,25,52,14,2010-02-24 21:26:11,2010-02-24 21:26:11
49194df8c3bfccaaab88715999160a4c46ae6dbd...231eb1d3ac8da25c37a748785966ce543eea9fbe,5,5,15,20,12,2010-02-24 21:59:27,2010-02-24 21:59:27
231eb1d3ac8da25c37a748785966ce543eea9fbe...b711400278ed6dadf27c193d7c5d5e435e3746d5,2,70,40,110,3,2010-02-25 17:14:37,2010-02-25 17:14:37
b711400278ed6dadf27c193d7c5d5e435e3746d5...1a377a8d0c8e5dcaa36a96c612b0ee8153d89a84,1,2,0,2,2,2010-02-25 17:20:13,2010-02-25 17:20:13
1a377a8d0c8e5dcaa36a96c612b0ee8153d89a84...f18cf31bbc9d78dc4f6bb6ac0f289ac419742420,0,0,0,0,0,2010-02-25 19:04:21,2010-02-25 19:04:21
f18cf31bbc9d78dc4f6bb6ac0f289ac419742420...5ac214b46aca9f163d1c19b63054e2721213f8c6,0,0,0,0,0,2010-02-25 20:32:47,2010-02-25 20:32:47
5ac214b46aca9f163d1c19b63054e2721213f8c6...6c031fbef7635732ebecf502520e31d519ab17b3,0,0,0,0,0,2010-02-25 23:57:27,2010-02-25 23:57:27
6c031fbef7635732ebecf502520e31d519ab17b3...6ca3154bcd14f377ba38f1199f6053ec94e59651,15,79,26,105,29,2010-02-26 05:14:36,2010-02-26 05:14:36
6ca3154bcd14f377ba38f1199f6053ec94e59651...a52f1dd95c87bca8c5edc69a487d1a5069ddd7cd,4,13,4,17,5,2010-02-26 11:12:14,2010-02-26 11:12:14
a52f1dd95c87bca8c5edc69a487d1a5069ddd7cd...3bda1f5bd3841b28a54e0e6f07b738ae3a856359,12,479,140,619,29,2010-02-26 13:43:28,2010-02-26 13:43:28
3bda1f5bd3841b28a54e0e6f07b738ae3a856359...0c2d3ff7a12916f8de06af845abd552bf43be009,3,5,8,13,3,2010-02-26 14:24:08,2010-02-26 14:24:08
0c2d3ff7a12916f8de06af845abd552bf43be009...b6bd766d88aedfb924180091bebbe990b7b64564,6,40,24,64,7,2010-02-26 15:38:50,2010-02-26 15:38:50
b6bd766d88aedfb924180091bebbe990b7b64564...94054604e484f21c95b77fbbed81e5670900a653,1,1,1,2,1,2010-02-26 15:54:37,2010-02-26 15:54:37
94054604e484f21c95b77fbbed81e5670900a653...121188e254c41641f3ee16b767ef456e87feff7f,2,10,4,14,6,2010-02-26 16:12:54,2010-02-26 16:12:54
121188e254c41641f3ee16b767ef456e87feff7f...14fbee6958e88b8bdee6bee58b7db1cc3f44903c,1,2,1,3,2,2010-02-26 16:40:37,2010-02-26 16:40:37
14fbee6958e88b8bdee6bee58b7db1cc3f44903c...b698d7762b7a6f500310c56ccb36213a3aa41a93,1,1,1,2,1,2010-02-26 16:56:39,2010-02-26 16:56:39
b698d7762b7a6f500310c56ccb36213a3aa41a93...079d9f37383d3b44bbfffcee56925d82b3d838a9,11,152,4,156,10,2010-02-26 17:00:11,2010-02-26 17:00:11
079d9f37383d3b44bbfffcee56925d82b3d838a9...7c23a5303cb5b5d01e6fb25d30676a5e95db2ecc,4,72,10,82,8,2010-02-26 17:00:42,2010-02-26 17:00:42
7c23a5303cb5b5d01e6fb25d30676a5e95db2ecc...499c7155132bf27479447d147053f619624a71ad,2,5,0,5,2,2010-02-26 17:11:58,2010-02-26 17:11:58
499c7155132bf27479447d147053f619624a71ad...aa8a98564c53cdb2cdc15d004b0a9e38ad10204f,1,2,2,4,2,2010-02-27 15:40:50,2010-02-27 15:40:50
aa8a98564c53cdb2cdc15d004b0a9e38ad10204f...e0679ef165aff483470d7ea4eea7951f3097460b,3,12,12,24,9,2010-02-27 16:37:32,2010-02-27 16:37:32
e0679ef165aff483470d7ea4eea7951f3097460b...1b2b3b0dba14bc03731752caf8879884789ed855,6,51,1,52,5,2010-02-28 15:29:14,2010-02-28 15:29:14
1b2b3b0dba14bc03731752caf8879884789ed855...4871b654b59544ba99a6ab5b9c70f9c220d954fa,1,3,3,6,3,2010-03-01 14:36:45,2010-03-01 14:36:45
4871b654b59544ba99a6ab5b9c70f9c220d954fa...f09eabfb901b3bdb4a5ec51a88259f39ab745ce3,1,6,0,6,3,2010-03-01 14:41:11,2010-03-01 14:41:11
f09eabfb901b3bdb4a5ec51a88259f39ab745ce3...5f3a53036d242e25e263a4201e8ef99ee0418471,2,45,3,48,4,2010-03-01 18:46:20,2010-03-01 18:46:20
5f3a53036d242e25e263a4201e8ef99ee0418471...6b94c64554b672cdc0ef4b812ce1c7636ce28210,2,62,4,66,12,2010-03-01 20:06:20,2010-03-01 20:06:20
6b94c64554b672cdc0ef4b812ce1c7636ce28210...7e1c67040c779765f1beb6e9be4caab26a6efd96,2,11,7,18,3,2010-03-01 20:14:18,2010-03-01 20:14:18
7e1c67040c779765f1beb6e9be4caab26a6efd96...ac72c8d1d34e3c5f12236a669291d0cbe23a146a,1,5,6,11,1,2010-03-01 20:19:53,2010-03-01 20:19:53
ac72c8d1d34e3c5f12236a669291d0cbe23a146a...34a3b7b6fd288ce2e498b20506d16db84bd7c68b,3,37,6,43,5,2010-03-01 20:32:55,2010-03-01 20:32:55
34a3b7b6fd288ce2e498b20506d16db84bd7c68b...60f4b7c4a9243e0e9d5e2a1b441548dc0cb8727d,1,11,5,16,3,2010-03-01 23:26:44,2010-03-01 23:26:44
60f4b7c4a9243e0e9d5e2a1b441548dc0cb8727d...5f70a728767236a18b8effaa120e2218b7307c9b,1,1,1,2,1,2010-03-02 00:00:08,2010-03-02 00:00:08
5f70a728767236a18b8effaa120e2218b7307c9b...08a698ed462b0e20a3a15b196152fee53e48ced9,3,32,1,33,4,2010-03-02 02:39:26,2010-03-02 02:39:26
08a698ed462b0e20a3a15b196152fee53e48ced9...69fb5c25bdabd6f693bca64bcf0dfeeb9659bddf,1,2,1,3,1,2010-03-02 03:32:49,2010-03-02 03:32:49
69fb5c25bdabd6f693bca64bcf0dfeeb9659bddf...a6225393c259f7c188c84897282838ebc224a489,1,9,3,12,2,2010-03-02 04:06:21,2010-03-02 04:06:21
a6225393c259f7c188c84897282838ebc224a489...755a0f6d96573ae5ccc2e2693e630c63c75a06ea,4,70,18,88,11,2010-03-02 07:47:41,2010-03-02 07:47:41
755a0f6d96573ae5ccc2e2693e630c63c75a06ea...cea0374cc6796c67c0f1cfa2df75cdd40c12d8dc,1,1,1,2,1,2010-03-02 17:11:02,2010-03-02 17:11:02
cea0374cc6796c67c0f1cfa2df75cdd40c12d8dc...b50b3cf75c6ac1abeaa0f19472444eb8be3b73f9,3,34,5,39,6,2010-03-02 19:41:39,2010-03-02 19:41:39
b50b3cf75c6ac1abeaa0f19472444eb8be3b73f9...c6e662cd6e84203ca0a5328035d72c6c83f9bae9,2,8,7,15,7,2010-03-02 22:02:02,2010-03-02 22:02:02
c6e662cd6e84203ca0a5328035d72c6c83f9bae9...1d12aa2cfe5bf8e9fc36baefb1f9e1bedb9d5b93,2,15,1,16,2,2010-03-03 08:03:47,2010-03-03 08:03:47
1d12aa2cfe5bf8e9fc36baefb1f9e1bedb9d5b93...faa341e61bd01fff44b3537545c3678a5f0bf48c,2,8,4,12,4,2010-03-03 08:19:23,2010-03-03 08:19:23
faa341e61bd01fff44b3537545c3678a5f0bf48c...bca50d20d3abeb9e641d9d257fd4674344ac7f28,1,6,2,8,1,2010-03-03 08:36:42,2010-03-03 08:36:42
bca50d20d3abeb9e641d9d257fd4674344ac7f28...7adae3028656cb8ea6c2c2c30a7bc747f7e26796,1,7,0,7,1,2010-03-03 08:44:22,2010-03-03 08:44:22
7adae3028656cb8ea6c2c2c30a7bc747f7e26796...36e7739d9d08cd83c9cc6be56ea33443ac26b484,1,8,0,8,1,2010-03-03 08:52:51,2010-03-03 08:52:51
36e7739d9d08cd83c9cc6be56ea33443ac26b484...1332b114cc465cc34f2d9ab1b6dc15837b49415d,1,15,0,15,1,2010-03-03 09:02:53,2010-03-03 09:02:53
1332b114cc465cc34f2d9ab1b6dc15837b49415d...cc65ac9e2b740e8e00bd5614293aa8065f8cec7e,1,4,4,8,2,2010-03-03 13:46:40,2010-03-03 13:46:40
cc65ac9e2b740e8e00bd5614293aa8065f8cec7e...1fedc0b9ebf8694036581cc4a75601c89a50c727,1,5,5,10,5,2010-03-04 01:11:37,2010-03-04 01:11:37
1fedc0b9ebf8694036581cc4a75601c89a50c727...b5a2f64cbba38cb0ff814118b0abbee05253db58,4,12,3,15,6,2010-03-05 18:58:47,2010-03-05 18:58:47
b5a2f64cbba38cb0ff814118b0abbee05253db58...215615ad58160320ae02d938c85f323cf2c92793,2,16,2,18,2,2010-03-05 20:21:28,2010-03-05 20:21:28
215615ad58160320ae02d938c85f323cf2c92793...b3c2ae9153656a7eb281350e4a8974aed53196a4,1,11,0,11,1,2010-03-06 11:21:48,2010-03-06 11:21:48
b3c2ae9153656a7eb281350e4a8974aed53196a4...daec7345845ca3349237cee9da0f00ba99f7ce76,2,63,11,74,16,2010-03-06 16:07:05,2010-03-06 16:07:05
daec7345845ca3349237cee9da0f00ba99f7ce76...55bcc8ac3013efb852d71f937f12132bc3371780,5,117,50,167,10,2010-03-06 19:17:29,2010-03-06 19:17:29
55bcc8ac3013efb852d71f937f12132bc3371780...8a8366d2faf2de41ac3072f80fd522dc273cf381,1,5,5,10,1,2010-03-07 00:52:11,2010-03-07 00:52:11
8a8366d2faf2de41ac3072f80fd522dc273cf381...e8c768910afd441aa39759de27939eee5d141219,2,15,1,16,2,2010-03-07 01:52:48,2010-03-07 01:52:48
e8c768910afd441aa39759de27939eee5d141219...72a659f8f83f1875739cf79a390917ad7a3d384c,2,54,1,55,8,2010-03-07 04:06:23,2010-03-07 04:06:23
72a659f8f83f1875739cf79a390917ad7a3d384c...24b969d28eef143f350815ace68d8e5a1a2e7775,2,13,6,19,7,2010-03-07 07:18:46,2010-03-07 07:18:46
24b969d28eef143f350815ace68d8e5a1a2e7775...90e12662b9ad8cfda78dd6a5dc834ebd0c111a75,0,0,0,0,0,2010-03-07 17:15:21,2010-03-07 17:15:21
90e12662b9ad8cfda78dd6a5dc834ebd0c111a75...b86b38f6189b947a0fa1384daf7098112fa2bbad,3,133,4,137,5,2010-03-07 20:14:34,2010-03-07 20:14:34
b86b38f6189b947a0fa1384daf7098112fa2bbad...ec6f7059564ec9bc99ff7108a2f0698fa22b7195,1,10,1,11,2,2010-03-08 03:26:24,2010-03-08 03:26:24
ec6f7059564ec9bc99ff7108a2f0698fa22b7195...fdbf6c881b0a2382a69ca137520170531b08dfee,1,12,3,15,3,2010-03-08 03:26:45,2010-03-08 03:26:45
fdbf6c881b0a2382a69ca137520170531b08dfee...1adc88f4b44b3e304029b49a0dce43cc785c346c,1,35,24,59,8,2010-03-08 03:27:12,2010-03-08 03:27:12
1adc88f4b44b3e304029b49a0dce43cc785c346c...9b2ac2ad2d7f17e65da1a3e719f3da5962923cfd,3,15,15,30,11,2010-03-08 04:37:45,2010-03-08 04:37:45
9b2ac2ad2d7f17e65da1a3e719f3da5962923cfd...6c507a5cd4e1f1752ce163023000065842764274,2,12,9,21,6,2010-03-08 12:59:50,2010-03-08 12:59:50
6c507a5cd4e1f1752ce163023000065842764274...55c71d3ed5867c2788569eea562b3a59faad4aa4,3,16,3,19,8,2010-03-08 15:13:08,2010-03-08 15:13:08
55c71d3ed5867c2788569eea562b3a59faad4aa4...9bdfe1765f7a8460f6c00e724be6456053e85736,9,30,43,73,13,2010-03-08 15:23:52,2010-03-08 15:23:52
9bdfe1765f7a8460f6c00e724be6456053e85736...758123a1f9b05cc3a5046311def90c9f2b1b3dbe,9,39,17,56,14,2010-03-08 17:11:14,2010-03-08 17:11:14
758123a1f9b05cc3a5046311def90c9f2b1b3dbe...75b10c9c15e81c57b09b7f4c70054da4bb83f703,3,6,6,12,3,2010-03-08 18:41:26,2010-03-08 18:41:26
75b10c9c15e81c57b09b7f4c70054da4bb83f703...0cac2cbc2f81d5713fb0023c690eac4a2d357b85,0,0,0,0,0,2010-03-08 20:53:51,2010-03-08 20:53:51
0cac2cbc2f81d5713fb0023c690eac4a2d357b85...f13b17ad1574bd6162ef058079c534d8e5aa2b22,2,47,1,48,3,2010-03-09 00:52:38,2010-03-09 00:52:38
f13b17ad1574bd6162ef058079c534d8e5aa2b22...89c263932378fa4b370ab28ef7658472f31643e0,2,21,1,22,3,2010-03-09 02:03:09,2010-03-09 02:03:09
89c263932378fa4b370ab28ef7658472f31643e0...0a7ec91dc3fb03502a38ea501f2b24f5730c484c,1,1,1,2,1,2010-03-09 14:49:50,2010-03-09 14:49:50
0a7ec91dc3fb03502a38ea501f2b24f5730c484c...693dcd90139a87462fc636c0b698743bfce677a0,3,47,0,47,3,2010-03-09 22:59:02,2010-03-09 22:59:02
693dcd90139a87462fc636c0b698743bfce677a0...47bdb670303e951c36d10fb122f44b3256a2153b,1,1,1,2,1,2010-03-11 09:34:18,2010-03-11 09:34:18
47bdb670303e951c36d10fb122f44b3256a2153b...0b78ce8214661e7252242070afe981535dd1ab62,1,1,1,2,1,2010-03-11 09:43:08,2010-03-11 09:43:08
0b78ce8214661e7252242070afe981535dd1ab62...705d6cce0f31140944f8c0b0d42a29a9f69cbf24,1,2,3,5,3,2010-03-11 14:14:07,2010-03-11 14:14:07
705d6cce0f31140944f8c0b0d42a29a9f69cbf24...9137c54353f3356e0f65e0218016e92c5bc9cc43,7,32,10,42,14,2010-03-12 13:31:10,2010-03-12 13:31:10
9137c54353f3356e0f65e0218016e92c5bc9cc43...1e1b57bfbe3a493d2179d499f00b0bbba49b8e2d,2,25,1,26,2,2010-03-12 14:27:31,2010-03-12 14:27:31
1e1b57bfbe3a493d2179d499f00b0bbba49b8e2d...d1b889ec98f831b8a8143f9522da522c5ef0a3f6,3,14,4,18,6,2010-03-12 14:45:56,2010-03-12 14:45:56
d1b889ec98f831b8a8143f9522da522c5ef0a3f6...3f7fcdda7143311b5237ec62fd67ae55037724b9,2,32,9,41,5,2010-03-12 15:24:28,2010-03-12 15:24:28
3f7fcdda7143311b5237ec62fd67ae55037724b9...e969c2715f5b3a7b7d66dcae5a0482de38f47106,2,52,9,61,6,2010-03-12 15:57:15,2010-03-12 15:57:15
e969c2715f5b3a7b7d66dcae5a0482de38f47106...c94de0757097061753578c72fb2abc8a5c603531,2,10,8,18,8,2010-03-13 22:15:09,2010-03-13 22:15:09
c94de0757097061753578c72fb2abc8a5c603531...7d3846a7b8e887dbc641d8055a821943639ec9e9,7,10,32,42,14,2010-03-14 00:17:37,2010-03-14 00:17:37
7d3846a7b8e887dbc641d8055a821943639ec9e9...ef92f4fdd91ec980618b35f907178655b5182ae3,1,2,2,4,2,2010-03-14 20:30:18,2010-03-14 20:30:18
ef92f4fdd91ec980618b35f907178655b5182ae3...d3ee5566b4804f40e4cf5e86e4bdb5b2c629b8a2,1,2,2,4,2,2010-03-15 06:57:07,2010-03-15 06:57:07
d3ee5566b4804f40e4cf5e86e4bdb5b2c629b8a2...c64669a6140444cd799d1b9bc826e67ae8b0d55a,4,19,19,38,9,2010-03-15 08:06:47,2010-03-15 08:06:47
c64669a6140444cd799d1b9bc826e67ae8b0d55a...322a50a3fcb8df475bd1cb84192e68cbf09fbcb3,1,27,9,36,2,2010-03-15 09:59:38,2010-03-15 09:59:38
322a50a3fcb8df475bd1cb84192e68cbf09fbcb3...9b85ef28952c66b7fc09b245a28bd6df81125114,1,2,0,2,1,2010-03-15 13:00:24,2010-03-15 13:00:24
9b85ef28952c66b7fc09b245a28bd6df81125114...e15c850f1be167fabfd80ec63b67147fedf8d57b,3,18,1,19,3,2010-03-16 19:08:49,2010-03-16 19:08:49
e15c850f1be167fabfd80ec63b67147fedf8d57b...58d72d4fee600b68f7183e31e6761d5b5065eae7,1,62,10,72,6,2010-03-16 21:03:11,2010-03-16 21:03:11
58d72d4fee600b68f7183e31e6761d5b5065eae7...16850856f560d093de3919e4264a98e8b700ba5a,4,41,9,50,13,2010-03-16 22:45:42,2010-03-16 22:45:42
16850856f560d093de3919e4264a98e8b700ba5a...9d5fb83b091e28221d9005e4a3662ccf764d7b5b,3,54,3,57,4,2010-03-19 05:43:32,2010-03-19 05:43:32
9d5fb83b091e28221d9005e4a3662ccf764d7b5b...6943950dfda48d2ca4e15f4367da24b0ead9aefd,2,45,1,46,23,2010-03-20 05:04:54,2010-03-20 05:04:54
6943950dfda48d2ca4e15f4367da24b0ead9aefd...32134986812442347a72186c2b552fd1b29f2494,1,1,1,2,1,2010-03-20 12:30:40,2010-03-20 12:30:40
32134986812442347a72186c2b552fd1b29f2494...eb1c7b033ddac99b333407ba0b964831aa5ef9c4,2,26,4,30,4,2010-03-20 15:23:10,2010-03-20 15:23:10
eb1c7b033ddac99b333407ba0b964831aa5ef9c4...4d00ac86eea3c4df7b11a9ca195ea69426e70f6a,3,11,2,13,4,2010-03-20 15:42:18,2010-03-20 15:42:18
4d00ac86eea3c4df7b11a9ca195ea69426e70f6a...8badb7587666127bf646a065ff58d84ed813c3ca,2,45,0,45,3,2010-03-20 18:04:10,2010-03-20 18:04:10
8badb7587666127bf646a065ff58d84ed813c3ca...d5336b221c4aa086d011603375306a37edd4a8ac,1,3,2,5,1,2010-03-20 20:11:38,2010-03-20 20:11:38
d5336b221c4aa086d011603375306a37edd4a8ac...df010f0a1f4cbbde1f60329201217d49ff5e43c2,2,14,5,19,3,2010-03-20 20:31:57,2010-03-20 20:31:57
df010f0a1f4cbbde1f60329201217d49ff5e43c2...3a55a2f42c95a008b11fff6ffca1b9859b95086b,8,47,1,48,4,2010-03-21 20:35:05,2010-03-21 20:35:05
3a55a2f42c95a008b11fff6ffca1b9859b95086b...740c97454167a17fbccedc6e775f3bb85904ec01,2,54,4,58,2,2010-03-21 20:54:24,2010-03-21 20:54:24
740c97454167a17fbccedc6e775f3bb85904ec01...c2267602cb253868232d1ef49f3d1ab822f7b639,1,2,2,4,2,2010-03-22 13:29:26,2010-03-22 13:29:26
c2267602cb253868232d1ef49f3d1ab822f7b639...ef41bd405e703f0881c4d6bc2c2a54146c965373,2,12,1,13,4,2010-03-22 19:16:31,2010-03-22 19:16:31
ef41bd405e703f0881c4d6bc2c2a54146c965373...752856530f94cd3579813d6474020459cc80730a,2,23,10,33,5,2010-03-23 14:08:31,2010-03-23 14:08:31
752856530f94cd3579813d6474020459cc80730a...6e60c8b7c00ff29a6434a66af7522f438e92fd58,2,6,6,12,6,2010-03-23 14:21:14,2010-03-23 14:21:14
6e60c8b7c00ff29a6434a66af7522f438e92fd58...21a1a21d0b0373e211621e3881ae03008843a034,2,15,7,22,3,2010-03-23 14:55:00,2010-03-23 14:55:00
21a1a21d0b0373e211621e3881ae03008843a034...f0ed1ce6832c1ea54c3d324911c43a25aec99c4e,1,6,2,8,1,2010-03-23 18:56:37,2010-03-23 18:56:37
f0ed1ce6832c1ea54c3d324911c43a25aec99c4e...b74e6c35570cc8272a678233fb52acd68a4bd750,1,2,2,4,2,2010-03-25 13:15:13,2010-03-25 13:15:13
b74e6c35570cc8272a678233fb52acd68a4bd750...93b5edddcec8180261178d898ae63e8262767d7c,1,2,3,5,1,2010-03-25 14:04:46,2010-03-25 14:04:46
93b5edddcec8180261178d898ae63e8262767d7c...373daf587659d2aa396f25811d5f1d03b334d6bd,1,5,0,5,1,2010-03-25 17:32:52,2010-03-25 17:32:52
373daf587659d2aa396f25811d5f1d03b334d6bd...917fb7c993374cabdde8f041bc4878d271d0ff42,3,26,11,37,7,2010-03-25 20:01:40,2010-03-25 20:01:40
917fb7c993374cabdde8f041bc4878d271d0ff42...7733895382b497771ee48754c19d2f012e475e07,3,21,0,21,4,2010-03-26 15:15:55,2010-03-26 15:15:55
7733895382b497771ee48754c19d2f012e475e07...52e2e5cc9644e3deab04517789124022573f7a70,1,0,3,3,1,2010-03-26 23:56:56,2010-03-26 23:56:56
52e2e5cc9644e3deab04517789124022573f7a70...87e40f8daa0b6070d05299cbc6414007be62993b,1,10,5,15,4,2010-03-27 00:10:44,2010-03-27 00:10:44
87e40f8daa0b6070d05299cbc6414007be62993b...5fab617f50259f0a4571d255767c74e77e05ae16,1,1,1,2,1,2010-03-27 00:14:44,2010-03-27 00:14:44
5fab617f50259f0a4571d255767c74e77e05ae16...5a6446b4437d123f1731d66bba0f3c0c9bc9d353,3,77,3,80,5,2010-03-27 12:35:59,2010-03-27 12:35:59
5a6446b4437d123f1731d66bba0f3c0c9bc9d353...434b5d5cf6ea214e7115e6a794fe509b74e5fc12,1,13,25,38,10,2010-03-27 21:17:23,2010-03-27 21:17:23
434b5d5cf6ea214e7115e6a794fe509b74e5fc12...127d46e6a59ea2c050151c4ea923dfb465746f67,1,3,1,4,1,2010-03-29 16:41:29,2010-03-29 16:41:29
127d46e6a59ea2c050151c4ea923dfb465746f67...e53de431f26787a11a3b5e590fe2172e71f53811,5,38,10,48,9,2010-03-29 16:48:38,2010-03-29 16:48:38
e53de431f26787a11a3b5e590fe2172e71f53811...ceb52612769ec7e211cc4a8909f4247107d454b3,2,52,15,67,16,2010-03-29 17:36:25,2010-03-29 17:36:25
ceb52612769ec7e211cc4a8909f4247107d454b3...08d00942d057bdf9a7a7da650657c88bc23a08e1,1,2,1,3,1,2010-03-29 18:34:09,2010-03-29 18:34:09
08d00942d057bdf9a7a7da650657c88bc23a08e1...8ef5daeb4f0e202b0a653379d8d5dedc5f11a9a9,1,8,0,8,1,2010-03-29 21:58:48,2010-03-29 21:58:48
8ef5daeb4f0e202b0a653379d8d5dedc5f11a9a9...2613872969f52815859bad9533104b47b63d6375,3,18,2,20,4,2010-03-29 22:20:51,2010-03-29 22:20:51
2613872969f52815859bad9533104b47b63d6375...64e4ffc932c78e6ccd66f20d5d74083fda3a3915,2,36,1,37,5,2010-03-31 08:08:29,2010-03-31 08:08:29
64e4ffc932c78e6ccd66f20d5d74083fda3a3915...f0fa0808ea5fc740a8264a05f55b3a61c92353a7,1,1,1,2,1,2010-03-31 11:34:32,2010-03-31 11:34:32
f0fa0808ea5fc740a8264a05f55b3a61c92353a7...7a7b9a042873a471b2ffe0518747dd64d25c634e,2,27,4,31,6,2010-03-31 13:51:20,2010-03-31 13:51:20
7a7b9a042873a471b2ffe0518747dd64d25c634e...fa114305cbf030818e1b056a7752d6bddb2e7c70,1,1,1,2,1,2010-03-31 18:58:19,2010-03-31 18:58:19
fa114305cbf030818e1b056a7752d6bddb2e7c70...33052458c579568b76a120ae7fdd0197791a8462,2,13,1,14,3,2010-04-01 15:25:54,2010-04-01 15:25:54
33052458c579568b76a120ae7fdd0197791a8462...adfeb962273a9c0f918a3078e1612c6ac95f3cd6,2,10,2,12,3,2010-04-01 16:57:23,2010-04-01 16:57:23
adfeb962273a9c0f918a3078e1612c6ac95f3cd6...ac0aea8910ec72a874ccd859a4f6449a895f4ec0,2,21,2,23,4,2010-04-02 15:52:58,2010-04-02 15:52:58
ac0aea8910ec72a874ccd859a4f6449a895f4ec0...17636ef9991f7b051b8c8032f75b62c5ab073c7c,3,63,1,64,3,2010-04-03 11:47:46,2010-04-03 11:47:46
17636ef9991f7b051b8c8032f75b62c5ab073c7c...0d6a776ccd9a6035b97389ca57fee41dd7454e01,6,59,13,72,16,2010-04-04 17:17:46,2010-04-04 17:17:46
0d6a776ccd9a6035b97389ca57fee41dd7454e01...c01735dee7dd590963c0305a2f2c904cd6cdefc2,5,18,1,19,5,2010-04-05 12:08:45,2010-04-05 12:08:45
c01735dee7dd590963c0305a2f2c904cd6cdefc2...985c764a77413208de528dded08732c505e841aa,1,6,0,6,1,2010-04-05 12:38:30,2010-04-05 12:38:30
985c764a77413208de528dded08732c505e841aa...dce7515befba38956764f51616237a819427aca6,1,7,0,7,1,2010-04-05 13:01:14,2010-04-05 13:01:14
dce7515befba38956764f51616237a819427aca6...2e8f0a8f1510a9da1af62a8fdbcbde2b33291da9,1,1,0,1,1,2010-04-05 15:45:20,2010-04-05 15:45:20
2e8f0a8f1510a9da1af62a8fdbcbde2b33291da9...b2627529e908291311a235baeff2abf16c6b33ae,1,1,1,2,1,2010-04-05 15:47:05,2010-04-05 15:47:05
b2627529e908291311a235baeff2abf16c6b33ae...cd3370c3a72bda2b7d97e2251cbf193034907c11,1,5,5,10,4,2010-04-05 16:00:31,2010-04-05 16:00:31
cd3370c3a72bda2b7d97e2251cbf193034907c11...c3bc6481af7ce8f4f0e8ecd2a8e56499b1306cf1,1,1,1,2,1,2010-04-06 11:05:18,2010-04-06 11:05:18
c3bc6481af7ce8f4f0e8ecd2a8e56499b1306cf1...c65dd489038282ff201c55ea8f3e2fd532921cc5,1,8,9,17,1,2010-04-06 11:59:37,2010-04-06 11:59:37
c65dd489038282ff201c55ea8f3e2fd532921cc5...0819c291e7284c589e5fca9cce774e3375e3b0cb,1,6,6,12,4,2010-04-06 12:22:29,2010-04-06 12:22:29
0819c291e7284c589e5fca9cce774e3375e3b0cb...b2ecfe845f407b01a00fcf5cce0a6402631f5043,1,1,1,2,1,2010-04-06 14:33:02,2010-04-06 14:33:02
b2ecfe845f407b01a00fcf5cce0a6402631f5043...bf5d71f2a7ee0565390f2e657027e58197b16c67,1,2,1,3,1,2010-04-11 19:01:02,2010-04-11 19:01:02
bf5d71f2a7ee0565390f2e657027e58197b16c67...46b9dd3048b6b3c60f7ed49580d1470f5974e96b,4,32,2,34,8,2010-04-12 12:43:39,2010-04-12 12:43:39
46b9dd3048b6b3c60f7ed49580d1470f5974e96b...6dc0499fe7d0af5a6c886cb7362a50a769939b17,2,2,1,3,2,2010-04-12 13:24:31,2010-04-12 13:24:31
6dc0499fe7d0af5a6c886cb7362a50a769939b17...a67b35a0aa2b7a947605cfabfecdf906f8ad41c4,1,6,6,12,2,2010-04-12 13:28:46,2010-04-12 13:28:46
a67b35a0aa2b7a947605cfabfecdf906f8ad41c4...38056e82d70235129dd13e8e6f7d2d0e817e9bed,2,15,1,16,3,2010-04-12 14:22:16,2010-04-12 14:22:16
38056e82d70235129dd13e8e6f7d2d0e817e9bed...f45e39ba8e19ade6b05be71b4e1ac09ea80c0af5,2,21,18,39,5,2010-04-12 14:55:45,2010-04-12 14:55:45
f45e39ba8e19ade6b05be71b4e1ac09ea80c0af5...4771790c68ac3902b9d7c15741a06f593274d7c6,0,0,0,0,0,2010-04-12 17:00:07,2010-04-12 17:00:07
4771790c68ac3902b9d7c15741a06f593274d7c6...eca89ea9be1530105e0d390ac381230184664c0a,2,8,0,8,2,2010-04-12 17:27:53,2010-04-12 17:27:53
eca89ea9be1530105e0d390ac381230184664c0a...ee2b07c7fcf0b7e67029b2f04fe18e369eecf98a,1,4,0,4,1,2010-04-12 21:11:56,2010-04-12 21:11:56
ee2b07c7fcf0b7e67029b2f04fe18e369eecf98a...cf08ea496e9d40f2f5b3677feedb59cd600fab91,2,12,2,14,4,2010-04-13 02:00:46,2010-04-13 02:00:46
cf08ea496e9d40f2f5b3677feedb59cd600fab91...65a9d73069349800fb956a19fd19948956da3208,1,46,42,88,6,2010-04-13 02:43:03,2010-04-13 02:43:03
65a9d73069349800fb956a19fd19948956da3208...ef6308db01f7b57467f62b731ce968a9fa18fc48,10,43,5,48,10,2010-04-14 19:14:23,2010-04-14 19:14:23
ef6308db01f7b57467f62b731ce968a9fa18fc48...a33c7673e46e9e2ee0d466a97b6f5685e4d48e05,1,1,1,2,1,2010-04-14 21:27:21,2010-04-14 21:27:21
a33c7673e46e9e2ee0d466a97b6f5685e4d48e05...a56b232cb5893e67365ec84736a2bc7713d833b3,1,22,0,22,1,2010-04-15 14:37:06,2010-04-15 14:37:06
a56b232cb5893e67365ec84736a2bc7713d833b3...ce8367f1c8c8c891422048d708e5be45dc749e11,7,94,13,107,9,2010-04-15 18:49:37,2010-04-15 18:49:37
ce8367f1c8c8c891422048d708e5be45dc749e11...8092d3b23faab1b4737845c9f9b30895adb0fab8,1,4,4,8,2,2010-04-15 19:14:52,2010-04-15 19:14:52
8092d3b23faab1b4737845c9f9b30895adb0fab8...231e452f968fd882c661689fbf1947f5ce8f3de2,1,5,1,6,2,2010-04-15 20:33:19,2010-04-15 20:33:19
231e452f968fd882c661689fbf1947f5ce8f3de2...534dc44dba2aa7c3da4b91812ef831afb693234c,1,10,28,38,5,2010-04-15 23:18:33,2010-04-15 23:18:33
534dc44dba2aa7c3da4b91812ef831afb693234c...e7ef1b220ea0bd67355d3672dd4b478c881527d6,5,35,26,61,11,2010-04-16 11:15:21,2010-04-16 11:15:21
e7ef1b220ea0bd67355d3672dd4b478c881527d6...f6b6e0f1d9c4440d848c71a933fbe4ecf67ce106,2,3,3,6,3,2010-04-16 15:47:06,2010-04-16 15:47:06
f6b6e0f1d9c4440d848c71a933fbe4ecf67ce106...be167b804d53ef4b14ae7e368724176168a64b6c,2,23,22,45,12,2010-04-16 16:45:59,2010-04-16 16:45:59
be167b804d53ef4b14ae7e368724176168a64b6c...f282099832d4a3ae6298311cd149851f163360e4,1,20,4,24,4,2010-04-19 11:57:04,2010-04-19 11:57:04
f282099832d4a3ae6298311cd149851f163360e4...4807b02a8323697c379b5f3779ed087e693f0d58,1,1,1,2,1,2010-04-20 12:22:10,2010-04-20 12:22:10
4807b02a8323697c379b5f3779ed087e693f0d58...2f6317f89ce5ec583bb0babd2521fb95ae2fcdbb,1,0,2,2,1,2010-04-20 15:07:14,2010-04-20 15:07:14
2f6317f89ce5ec583bb0babd2521fb95ae2fcdbb...1982c8b73e7d09bef30fbf38eef4f7e706e598ae,1,0,2,2,1,2010-04-20 20:43:17,2010-04-20 20:43:17
1982c8b73e7d09bef30fbf38eef4f7e706e598ae...0e996983d5457d56fcf9020bf87a069734985d65,1,11,2,13,5,2010-04-21 12:07:36,2010-04-21 12:07:36
0e996983d5457d56fcf9020bf87a069734985d65...af48cad39e7aac02ab5c7120b4509abd4b1941cd,2,5,8,13,3,2010-04-21 23:50:00,2010-04-21 23:50:00
af48cad39e7aac02ab5c7120b4509abd4b1941cd...c8576fa674c4a252e258042de05b3f41cdec241a,1,5,0,5,1,2010-04-22 00:00:19,2010-04-22 00:00:19
c8576fa674c4a252e258042de05b3f41cdec241a...58c1a67ff1504d9368eb55461095f3a805b97ea7,2,9,2,11,3,2010-04-23 14:30:29,2010-04-23 14:30:29
58c1a67ff1504d9368eb55461095f3a805b97ea7...5226525736bd8394591df13fa7c11c75ac850ddd,1,22,19,41,3,2010-04-24 07:10:15,2010-04-24 07:10:15
5226525736bd8394591df13fa7c11c75ac850ddd...a43464d67eee4fde5e670d5c4086bdf6e0048e06,1,4,5,9,4,2010-04-25 13:23:14,2010-04-25 13:23:14
a43464d67eee4fde5e670d5c4086bdf6e0048e06...33f097e50b83bff669643f76ab4ab3c4316d77d8,1,1,1,2,1,2010-04-27 13:40:52,2010-04-27 13:40:52
33f097e50b83bff669643f76ab4ab3c4316d77d8...5f1ecdc51ab9a55e8155fae9026783ab76c9c8c2,1,10,5,15,2,2010-04-27 15:01:54,2010-04-27 15:01:54
5f1ecdc51ab9a55e8155fae9026783ab76c9c8c2...6f4563acede94a339cd64235cce95ba224be259d,2,43,3,46,6,2010-04-28 17:15:11,2010-04-28 17:15:11
6f4563acede94a339cd64235cce95ba224be259d...2eb832a7e65b1c24904c140fa024169524d101f8,2,25,2,27,5,2010-04-30 14:12:12,2010-04-30 14:12:12
2eb832a7e65b1c24904c140fa024169524d101f8...868acb3a6c39b73389511f9d65e8849f27e63755,1,2,2,4,2,2010-04-30 14:12:36,2010-04-30 14:12:36
868acb3a6c39b73389511f9d65e8849f27e63755...fe3b75e2764caf3fe7038fc30644e01f14cfc247,3,22,3,25,4,2010-04-30 16:37:54,2010-04-30 16:37:54
fe3b75e2764caf3fe7038fc30644e01f14cfc247...ef0e10cccf7788948e7254a208b8477911e6cbb0,1,1,1,2,1,2010-05-01 02:32:45,2010-05-01 02:32:45
ef0e10cccf7788948e7254a208b8477911e6cbb0...99a512300cd4e61d86269d3b28bf5a8add5980c1,2,32,2,34,5,2010-05-02 19:48:17,2010-05-02 19:48:17
99a512300cd4e61d86269d3b28bf5a8add5980c1...9c14f2394674f5500cd0600d3ed9643a20ca54ae,1,307,251,558,215,2010-05-03 05:57:16,2010-05-03 05:57:16
9c14f2394674f5500cd0600d3ed9643a20ca54ae...0265a814492eeed7530c61ab48e09fc87ce64013,2,38,80,118,39,2010-05-03 06:42:52,2010-05-03 06:42:52
0265a814492eeed7530c61ab48e09fc87ce64013...820bcd0aa3d65c389a778d62c725b34d11fcb796,1,1,1,2,1,2010-05-03 17:14:57,2010-05-03 17:14:57
820bcd0aa3d65c389a778d62c725b34d11fcb796...5c5c25eba50c65f00fe6f9e3ad83ee5287960873,1,1,1,2,1,2010-05-03 17:45:14,2010-05-03 17:45:14
5c5c25eba50c65f00fe6f9e3ad83ee5287960873...a263d3b445072a78e140a9b5d75f793532a13ee1,0,0,0,0,0,2010-05-03 18:09:48,2010-05-03 18:09:48
a263d3b445072a78e140a9b5d75f793532a13ee1...bc9708735fd1e3f3940ebc013f37f2b1b2594910,7,199,21,220,10,2010-05-04 08:15:34,2010-05-04 08:15:34
bc9708735fd1e3f3940ebc013f37f2b1b2594910...c7fc8891b1d38f14b2fa0802d761e0b64f59c809,2,1,1,2,1,2010-05-04 08:16:06,2010-05-04 08:16:06
c7fc8891b1d38f14b2fa0802d761e0b64f59c809...e28c0edbeeef3401b1afc2166d68ba0327903ad3,1,15,15,30,15,2010-05-04 13:31:25,2010-05-04 13:31:25
e28c0edbeeef3401b1afc2166d68ba0327903ad3...125ea947df52d9a3e7a306ebefee9c6b7247f60f,1,17,42,59,5,2010-05-04 14:55:04,2010-05-04 14:55:04
125ea947df52d9a3e7a306ebefee9c6b7247f60f...1d7c4a96ab4f8adfef6adf88476c40be28196003,1,1,1,2,1,2010-05-06 01:26:13,2010-05-06 01:26:13
1d7c4a96ab4f8adfef6adf88476c40be28196003...760ed9987a2fe6c990cba8e61e328e49ae64bf4e,2,12,10,22,3,2010-05-06 01:26:39,2010-05-06 01:26:39
760ed9987a2fe6c990cba8e61e328e49ae64bf4e...d034374ea89d727b2d15d6a29618a0fdd77182b6,1,4,0,4,1,2010-05-06 01:36:42,2010-05-06 01:36:42
d034374ea89d727b2d15d6a29618a0fdd77182b6...027ba077ac19c90a7686e35ba771e297c76ff27d,2,2,2,4,2,2010-05-07 01:01:16,2010-05-07 01:01:16
027ba077ac19c90a7686e35ba771e297c76ff27d...e6167e54db106a5c833610774c7daa5c9cc5dbc8,1,8,0,8,1,2010-05-08 07:34:30,2010-05-08 07:34:30
e6167e54db106a5c833610774c7daa5c9cc5dbc8...176f1c1c4543794bd74f2c817dd4758a3b6489fc,1,1,1,2,1,2010-05-08 07:34:53,2010-05-08 07:34:53
176f1c1c4543794bd74f2c817dd4758a3b6489fc...e8e87e09b90dca37c1da064e0472e7e2cc43ad88,1,45,26,71,21,2010-05-08 15:22:52,2010-05-08 15:22:52
e8e87e09b90dca37c1da064e0472e7e2cc43ad88...d5ed0302289db2a8b64ebd29ca1081dab364d1ee,5,88,7,95,11,2010-05-08 20:31:59,2010-05-08 20:31:59
d5ed0302289db2a8b64ebd29ca1081dab364d1ee...947c8ce3b42e4da41bc58be60e37cb3bcde23027,1,1,1,2,1,2010-05-09 04:31:49,2010-05-09 04:31:49
947c8ce3b42e4da41bc58be60e37cb3bcde23027...0711e1051df11a91d3a468a6e337d950f8147182,3,3,5,8,3,2010-05-09 04:32:40,2010-05-09 04:32:40
0711e1051df11a91d3a468a6e337d950f8147182...a1421336d79e82737c359db4b18f81a962442a21,1,6,1,7,2,2010-05-09 04:33:29,2010-05-09 04:33:29
a1421336d79e82737c359db4b18f81a962442a21...e3389f9a203cf0a55936a0c9f766b5d6f7b778a8,1,15,6,21,3,2010-05-09 04:34:13,2010-05-09 04:34:13
e3389f9a203cf0a55936a0c9f766b5d6f7b778a8...95693cc6dd267bfccfdcccbd29c09516f7b049db,1,9,0,9,1,2010-05-09 05:13:13,2010-05-09 05:13:13
95693cc6dd267bfccfdcccbd29c09516f7b049db...d52996311317592e72b1bc72cb125a5f64e5fee0,1,5,5,10,2,2010-05-09 05:13:45,2010-05-09 05:13:45
d52996311317592e72b1bc72cb125a5f64e5fee0...3981355c5c770f80c1590a4d4ba152e78026e14d,1,3,3,6,3,2010-05-09 05:51:57,2010-05-09 05:51:57
3981355c5c770f80c1590a4d4ba152e78026e14d...6df4ffd4f4e6ad6aafe7dc697645de16d14cd797,1,48,2,50,23,2010-05-09 05:52:38,2010-05-09 05:52:38
6df4ffd4f4e6ad6aafe7dc697645de16d14cd797...5be6c7fc60ad9ad20b51abbea92f741f6dd5d046,1,10,2,12,1,2010-05-09 06:48:32,2010-05-09 06:48:32
5be6c7fc60ad9ad20b51abbea92f741f6dd5d046...3b9a82714cf425d4cd4325a22c98b0b2c1d8c95e,1,1,1,2,1,2010-05-09 06:49:00,2010-05-09 06:49:00
3b9a82714cf425d4cd4325a22c98b0b2c1d8c95e...814268fb548eb463839dbb892ff112c4b51db126,1,33,27,60,4,2010-05-09 06:49:32,2010-05-09 06:49:32
814268fb548eb463839dbb892ff112c4b51db126...5d751026b56140a5ea5c7da6d3552080d9ec3964,2,4,4,8,4,2010-05-09 06:50:06,2010-05-09 06:50:06
5d751026b56140a5ea5c7da6d3552080d9ec3964...2ee73c2f4e6f0822892c97998325faeeee408255,1,14,0,14,1,2010-05-09 06:50:39,2010-05-09 06:50:39
2ee73c2f4e6f0822892c97998325faeeee408255...c772e39d3467b31843270b8703958043dce0562f,1,10,0,10,1,2010-05-09 06:51:07,2010-05-09 06:51:07
c772e39d3467b31843270b8703958043dce0562f...e10f546b2190661d240f9daa6aca69f721696079,1,5,1,6,3,2010-05-09 07:46:50,2010-05-09 07:46:50
e10f546b2190661d240f9daa6aca69f721696079...9fb195fc67214fdaa39475a60a3ba96fb2a031bc,2,114,0,114,2,2010-05-09 07:47:14,2010-05-09 07:47:14
9fb195fc67214fdaa39475a60a3ba96fb2a031bc...4a97875f6bfb2a56c2cf4eb3a304eedbc0bcd571,2,62,13,75,9,2010-05-09 13:57:03,2010-05-09 13:57:03
4a97875f6bfb2a56c2cf4eb3a304eedbc0bcd571...f7215cec92a5f04e877adbbc809e6bd34c0c6968,1,1,0,1,1,2010-05-10 00:54:25,2010-05-10 00:54:25
f7215cec92a5f04e877adbbc809e6bd34c0c6968...868cf8093c63b3439e6534fe69e7050c4714770a,1,1,1,2,1,2010-05-10 11:23:59,2010-05-10 11:23:59
868cf8093c63b3439e6534fe69e7050c4714770a...8099fec855ca96728e8b90338619397851dfdd7d,1,2,1,3,2,2010-05-10 11:24:16,2010-05-10 11:24:16
8099fec855ca96728e8b90338619397851dfdd7d...b66d597cb4ea87b7437b3e84f5bc76c09f0dfad1,1,15,15,30,14,2010-05-10 11:42:41,2010-05-10 11:42:41
b66d597cb4ea87b7437b3e84f5bc76c09f0dfad1...45c409f3fd488c59077dbb0acc0fea121b048579,1,1,1,2,1,2010-05-10 11:43:34,2010-05-10 11:43:34
45c409f3fd488c59077dbb0acc0fea121b048579...0765d4b59774b5484d2be408f26a398f0144d578,1,9,8,17,3,2010-05-10 11:44:25,2010-05-10 11:44:25
0765d4b59774b5484d2be408f26a398f0144d578...6bc070ba4cc687bea93fab5b9122063c9d51d1e6,1,54,12,66,5,2010-05-10 12:34:52,2010-05-10 12:34:52
6bc070ba4cc687bea93fab5b9122063c9d51d1e6...5a43a33161d1ff0bca573f277058803ce687449b,1,2,1,3,2,2010-05-10 12:43:05,2010-05-10 12:43:05
5a43a33161d1ff0bca573f277058803ce687449b...a85837482800177b9fd760207ff0b0c590d53eff,1,1,1,2,1,2010-05-10 13:25:44,2010-05-10 13:25:44
a85837482800177b9fd760207ff0b0c590d53eff...5627b26377dff1bf53690279e6792748f33f9043,1,1,1,2,1,2010-05-10 13:26:47,2010-05-10 13:26:47
5627b26377dff1bf53690279e6792748f33f9043...b7b0ebb3adf89b7abf8a66551077b6d110700ed6,3,4,4,8,4,2010-05-10 13:27:53,2010-05-10 13:27:53
b7b0ebb3adf89b7abf8a66551077b6d110700ed6...c51284f65aa5e7c12f57d5daba8745c1c3571114,1,7,6,13,1,2010-05-10 13:28:57,2010-05-10 13:28:57
c51284f65aa5e7c12f57d5daba8745c1c3571114...9ca0a330292fd2a29f166d1b87b78ff056b414f2,1,4,3,7,1,2010-05-10 14:12:25,2010-05-10 14:12:25
9ca0a330292fd2a29f166d1b87b78ff056b414f2...61beb4549d7d09caff98c629124ca8ad6480ac51,1,8,0,8,1,2010-05-10 14:13:39,2010-05-10 14:13:39
61beb4549d7d09caff98c629124ca8ad6480ac51...45f5e0c980bd0e6387f5d4041677a027677fb785,1,1,1,2,1,2010-05-10 14:14:41,2010-05-10 14:14:41
45f5e0c980bd0e6387f5d4041677a027677fb785...a0ea98e7a0c455e44bed2b79abe5f20b106bdd34,1,2,4,6,2,2010-05-10 14:16:04,2010-05-10 14:16:04
a0ea98e7a0c455e44bed2b79abe5f20b106bdd34...08de7a32d9a8eb790bfae52e1d9295e2436b03b3,1,11,4,15,2,2010-05-10 14:17:16,2010-05-10 14:17:16
08de7a32d9a8eb790bfae52e1d9295e2436b03b3...6f2a84409e122b5a1d9ce96491b14ee05600f81a,2,20,20,40,17,2010-05-11 14:18:01,2010-05-11 14:18:01
6f2a84409e122b5a1d9ce96491b14ee05600f81a...242c7f39400388856396a2b42c3512173db25f3d,1,1,1,2,1,2010-05-12 13:27:14,2010-05-12 13:27:14
242c7f39400388856396a2b42c3512173db25f3d...87fd4583c19e4f9ce3a49d2399cf86e02801a52e,1,1,1,2,1,2010-05-12 13:36:05,2010-05-12 13:36:05
87fd4583c19e4f9ce3a49d2399cf86e02801a52e...2f8bb4ee317affa4f5d3bfbc56fb7a875a69bbd8,2,2,2,4,2,2010-05-12 23:00:57,2010-05-12 23:00:57
2f8bb4ee317affa4f5d3bfbc56fb7a875a69bbd8...c179bd5cfb1e0d255494e1d2cea970e172b0b729,20,186,13,199,31,2010-05-13 13:44:32,2010-05-13 13:44:32
c179bd5cfb1e0d255494e1d2cea970e172b0b729...f0774927e66f1738a2e264b982c3a2a0968465b0,1,7,6,13,4,2010-05-14 01:52:28,2010-05-14 01:52:28
f0774927e66f1738a2e264b982c3a2a0968465b0...4333ca52fb3978f79d7b03304b5c8195fbb57359,2,2,1,3,2,2010-05-14 05:45:12,2010-05-14 05:45:12
4333ca52fb3978f79d7b03304b5c8195fbb57359...5d6b2966af2b83ea55d3fcd443046d2d170ec3b6,2,1,2,3,2,2010-05-14 05:56:34,2010-05-14 05:56:34
5d6b2966af2b83ea55d3fcd443046d2d170ec3b6...934dc9e71212ca4e73ea9af956ef120b411dc8ef,1,4,6,10,2,2010-05-14 11:43:55,2010-05-14 11:43:55
934dc9e71212ca4e73ea9af956ef120b411dc8ef...17084839fd7e267da5729f2a27753322b9d415a0,4,49,4,53,11,2010-12-23 03:47:38,2010-12-23 03:47:38
17084839fd7e267da5729f2a27753322b9d415a0...7f8dd9cbac074389af8d8fd235bf2cb657227b9a,3,13,3,16,5,2010-12-23 03:47:58,2010-12-23 03:47:58
7f8dd9cbac074389af8d8fd235bf2cb657227b9a...334654fdf1d4f660ce9bb2a4aa65859f6441f24d,1,1,1,2,1,2010-12-23 03:51:37,2010-12-23 03:51:37
334654fdf1d4f660ce9bb2a4aa65859f6441f24d...cbbfe1132804c4c05327bd5103fc6c1057ccb93a,1,1,0,1,1,2010-12-23 04:12:42,2010-12-23 04:12:42
cbbfe1132804c4c05327bd5103fc6c1057ccb93a...703dc822565024a65aa9cd3994355577ca8a348b,3,9,1,10,4,2011-01-12 20:45:01,2011-01-12 20:45:01
703dc822565024a65aa9cd3994355577ca8a348b...274bd67c13f4e979b3982d275470f80cc53509d0,7,78,20,98,16,2011-01-28 15:32:25,2011-01-28 15:32:25
274bd67c13f4e979b3982d275470f80cc53509d0...408c5c873ce1437c7eee9544ff279ecbad7e150a,3,37,21,58,8,2011-02-09 02:07:35,2011-02-09 02:07:35
408c5c873ce1437c7eee9544ff279ecbad7e150a...570a32a047ea56265646217264b0d3dab1a14dbd,2,15,2,17,4,2011-02-09 02:14:24,2011-02-09 02:14:24
570a32a047ea56265646217264b0d3dab1a14dbd...1966786d2dde73e17f39cf340eb33fcb5d73904e,2,17,1,18,2,2011-02-09 02:48:48,2011-02-09 02:48:48
1966786d2dde73e17f39cf340eb33fcb5d73904e...24f2898b76480c626633bd0dd0c3bb7d2068e6d8,2,2,2,4,2,2011-02-09 03:06:37,2011-02-09 03:06:37
24f2898b76480c626633bd0dd0c3bb7d2068e6d8...b7a7cdc4fa972468bfb2579402aa50f498c81172,2,79,0,79,2,2011-02-10 09:30:51,2011-02-10 09:30:51
b7a7cdc4fa972468bfb2579402aa50f498c81172...99c529eec881708a725bb0e1c99392b3f6c4547d,3,54,3,57,4,2011-02-10 11:57:46,2011-02-10 11:57:46
99c529eec881708a725bb0e1c99392b3f6c4547d...840314bde48f8df47b9b6f6a32b1051b9980df30,1,6,8,14,2,2011-02-12 23:49:18,2011-02-12 23:49:18
840314bde48f8df47b9b6f6a32b1051b9980df30...12fd6e1106039269d7fe501d61951f1a1aac9fa3,3,38,3,41,5,2011-02-16 23:24:19,2011-02-16 23:24:19
12fd6e1106039269d7fe501d61951f1a1aac9fa3...8b5fc4ac009f4db6a30db717456ba6480beb2628,2,6,14,20,2,2011-02-22 11:31:54,2011-02-22 11:31:54
6cffb9b8804278c4a617109e65493dc782ef2f7d...eedf16d12b675c50d0b0bab60ba8ad2e30a9921e,1,23,48,71,14,2010-05-28 09:52:24,2010-05-28 09:52:24
eedf16d12b675c50d0b0bab60ba8ad2e30a9921e...526a4410d790f9b3923f7bac6fc4c1eff3b8fbf6,4,595,320,915,5,2010-05-28 11:15:36,2010-05-28 11:15:36
526a4410d790f9b3923f7bac6fc4c1eff3b8fbf6...adc9458541385ce71935f328fa03cb7e48b8962e,1,4,4,8,3,2010-05-28 11:46:03,2010-05-28 11:46:03
adc9458541385ce71935f328fa03cb7e48b8962e...c4e0dc6b5ea76d7f214b9e0d8ce02cc26375a798,2,10,3,13,3,2010-05-28 13:46:12,2010-05-28 13:46:12
c4e0dc6b5ea76d7f214b9e0d8ce02cc26375a798...1b04cb234847245781f71599224fe2de15a799a8,1,1,1,2,1,2010-05-28 15:03:12,2010-05-28 15:03:12
1b04cb234847245781f71599224fe2de15a799a8...8a10078a0397858a080079b77fe936ccbe677cea,1,211,477,688,2,2010-05-28 16:27:09,2010-05-28 16:27:09
8a10078a0397858a080079b77fe936ccbe677cea...3180f932369e3a6a1604c5ea98ee7063eeeaf1dd,2,17,3,20,5,2010-05-28 16:39:52,2010-05-28 16:39:52
3180f932369e3a6a1604c5ea98ee7063eeeaf1dd...2311bcbd016783d20a64b0b4d745318af0a1c0dd,2,4,3,7,2,2010-05-28 17:25:43,2010-05-28 17:25:43
2311bcbd016783d20a64b0b4d745318af0a1c0dd...887da3154ab0d7326251cd3be99bada5718146c0,1,1,1,2,1,2010-06-02 17:57:10,2010-06-02 17:57:10
887da3154ab0d7326251cd3be99bada5718146c0...3e1e04d6d009d3fe009176811aec26019f291d2e,1,1,2,3,2,2010-06-03 18:50:04,2010-06-03 18:50:04
3e1e04d6d009d3fe009176811aec26019f291d2e...5da6aeba17060fb986ae209a3f463383454b2970,5,314,255,569,25,2010-06-05 05:26:04,2010-06-05 05:26:04
5da6aeba17060fb986ae209a3f463383454b2970...45e5fb1ee224e99b612072b1a50f562856d540b6,1,8,15,23,4,2010-06-05 05:32:05,2010-06-05 05:32:05
45e5fb1ee224e99b612072b1a50f562856d540b6...289f41921e5fc95ce6bfbc380d7fa761346ac0c7,1,7,1,8,1,2010-06-05 06:37:52,2010-06-05 06:37:52
289f41921e5fc95ce6bfbc380d7fa761346ac0c7...4290b0d26a18dee187a8048c616f2ec82aa5bd47,1,2,2,4,2,2010-06-05 12:53:51,2010-06-05 12:53:51
4290b0d26a18dee187a8048c616f2ec82aa5bd47...be63b3ca548ae2093b698a27f95fe7eb296e5498,1,7,7,14,1,2010-06-05 13:07:21,2010-06-05 13:07:21
be63b3ca548ae2093b698a27f95fe7eb296e5498...1a6da249c3a9bd353928f664bc6bd3f582b5eba1,2,128,156,284,4,2010-06-07 02:11:58,2010-06-07 02:11:58
1a6da249c3a9bd353928f664bc6bd3f582b5eba1...42a751206f70ff01a72c172844365c860f092111,1,1,1,2,2,2010-06-07 03:01:06,2010-06-07 03:01:06
42a751206f70ff01a72c172844365c860f092111...454622c6f9765ea003423d9c0772d115a59f0e59,1,3,3,6,3,2010-06-07 03:08:33,2010-06-07 03:08:33
454622c6f9765ea003423d9c0772d115a59f0e59...9ebf411f26b028edfa453d3d4955d5d08d341ae1,1,2,2,4,1,2010-06-07 14:47:10,2010-06-07 14:47:10
9ebf411f26b028edfa453d3d4955d5d08d341ae1...21a690fcfeeb3fecef3baa50ac9a9f0c14260a7e,5,91,15,106,22,2010-06-07 15:47:19,2010-06-07 15:47:19
21a690fcfeeb3fecef3baa50ac9a9f0c14260a7e...ac8b7ff02133f3d9112574e3660fd5ad042bc751,2,32,4,36,5,2010-06-08 14:35:48,2010-06-08 14:35:48
ac8b7ff02133f3d9112574e3660fd5ad042bc751...2597f31ed4e9dff814809767e83209843bf9512e,5,15,91,106,22,2010-06-10 11:45:29,2010-06-10 11:45:29
2597f31ed4e9dff814809767e83209843bf9512e...ab908685fb7dea7395eb52a6eff02af04e12991e,1,19,14,33,13,2010-06-11 01:37:10,2010-06-11 01:37:10
ab908685fb7dea7395eb52a6eff02af04e12991e...fc33b8e953969182b9441d6a0ba2e9df0f882f03,1,1,1,2,1,2010-06-17 18:29:27,2010-06-17 18:29:27
fc33b8e953969182b9441d6a0ba2e9df0f882f03...308ca6d8d5547919bfbb0ead25656710cd61fbb9,1,4,4,8,4,2010-06-17 23:50:51,2010-06-17 23:50:51
308ca6d8d5547919bfbb0ead25656710cd61fbb9...90ce8b0c99516799ce813349e1f148d040cba948,1,1,1,2,1,2010-06-19 21:07:33,2010-06-19 21:07:33
6cffb9b8804278c4a617109e65493dc782ef2f7d...6c10480e99118c93c046a6e83f5e84615ed8b2e7,0,0,0,0,0,2010-05-27 09:38:59,2010-05-27 09:38:59
6c10480e99118c93c046a6e83f5e84615ed8b2e7...8bdf160e05f666c0f1c9106719bad46b407f9992,13,865,859,1724,33,2010-06-02 23:49:27,2010-06-02 23:49:27
8bdf160e05f666c0f1c9106719bad46b407f9992...e3bad40d3e4873be5f9b7103b2140ebf81361c8a,20,594,461,1055,70,2010-06-09 21:20:49,2010-06-09 21:20:49
e3bad40d3e4873be5f9b7103b2140ebf81361c8a...7289013cf18905ad2022eb21a51be91b02284a56,3,49,26,75,3,2010-06-09 22:13:03,2010-06-09 22:13:03
7289013cf18905ad2022eb21a51be91b02284a56...75302ff6355ab770a1791b55eaf4a476bcc76d99,2,1,1,2,1,2010-06-09 22:33:19,2010-06-09 22:33:19
75302ff6355ab770a1791b55eaf4a476bcc76d99...101796ce8da802e74720d47821157723b46800da,3,82,66,148,3,2010-06-10 01:46:36,2010-06-10 01:46:36
101796ce8da802e74720d47821157723b46800da...4ffeb59e86940089037ec90db7ed1aec523c4414,1,4,3,7,1,2010-06-10 03:31:29,2010-06-10 03:31:29
4ffeb59e86940089037ec90db7ed1aec523c4414...cc4703d5aeaf8059feddfe699ff8e58074a36e70,3,95,48,143,3,2010-06-11 01:17:52,2010-06-11 01:17:52
cc4703d5aeaf8059feddfe699ff8e58074a36e70...078b13e97e474787fa45e03bb6768f2ff502fe67,2,26,21,47,2,2010-06-22 02:53:14,2010-06-22 02:53:14
078b13e97e474787fa45e03bb6768f2ff502fe67...42570206db67fa4206883ef5fd935f6eda8a47f7,2,125,136,261,2,2010-06-22 02:54:18,2010-06-22 02:54:18
42570206db67fa4206883ef5fd935f6eda8a47f7...af64237c3110cc859d8bdfac0f2ba1d2f8d1f919,3,158,163,321,4,2010-06-22 02:55:06,2010-06-22 02:55:06
af64237c3110cc859d8bdfac0f2ba1d2f8d1f919...85f024c2b1d9b59d0a487f0743da8c21076064b7,2,169,165,334,2,2010-06-22 02:56:25,2010-06-22 02:56:25
85f024c2b1d9b59d0a487f0743da8c21076064b7...52a855fd37c6e9765aedf9178d9e85c3c669c0c1,2,15,15,30,2,2010-06-22 02:56:53,2010-06-22 02:56:53
52a855fd37c6e9765aedf9178d9e85c3c669c0c1...dc2fd96803dd99ac466b4c22f9bdb1294c7b3c37,3,200,105,305,3,2010-06-22 02:57:35,2010-06-22 02:57:35
dc2fd96803dd99ac466b4c22f9bdb1294c7b3c37...6f851bca15880e7aaa115edd54fe19771445d30d,2,40,38,78,2,2010-06-22 02:58:45,2010-06-22 02:58:45
6f851bca15880e7aaa115edd54fe19771445d30d...222cc77e528ac83c6af8c88deb31385b0d710cc0,0,0,0,0,0,2010-06-23 05:07:02,2010-06-23 05:07:02
222cc77e528ac83c6af8c88deb31385b0d710cc0...c8624d43cbaee8b9d434f555d99fb7859011b4c9,10,92,24,116,30,2010-06-23 05:23:15,2010-06-23 05:23:15
c8624d43cbaee8b9d434f555d99fb7859011b4c9...e09d2de9063cf6a709441c2d21c1e6d42a62b770,2,129,131,260,6,2010-06-23 10:08:19,2010-06-23 10:08:19
e09d2de9063cf6a709441c2d21c1e6d42a62b770...2ca92d49f84e26972c967488b88a2d4c32a041b2,2,50,52,102,3,2010-06-23 14:12:45,2010-06-23 14:12:45
2ca92d49f84e26972c967488b88a2d4c32a041b2...154808166afba5a3fd3532423df58cd366f2ea06,2,49,49,98,49,2010-06-30 23:34:39,2010-06-30 23:34:39
154808166afba5a3fd3532423df58cd366f2ea06...86580d042ecc12e0e34f369edee9bf9b71ade816,15,2660,3,2663,18,2010-07-02 16:30:52,2010-07-02 16:30:52
86580d042ecc12e0e34f369edee9bf9b71ade816...e87ead6d082687741d6ed6bfd9ed5130282394e7,1,0,2,2,1,2010-07-02 16:34:41,2010-07-02 16:34:41
e87ead6d082687741d6ed6bfd9ed5130282394e7...62e587418cdfc8f54b6058072497df47e6ab3abd,1,6,6,12,3,2010-07-02 17:19:17,2010-07-02 17:19:17
62e587418cdfc8f54b6058072497df47e6ab3abd...c298937c9434752aa961888e680bfb638230ec62,1,1,1,2,1,2010-07-02 17:51:12,2010-07-02 17:51:12
c298937c9434752aa961888e680bfb638230ec62...dfd3da2853e7fef61ed40f5f903f8d97085cb953,1,0,4,4,1,2010-07-02 17:53:09,2010-07-02 17:53:09
dfd3da2853e7fef61ed40f5f903f8d97085cb953...9d69c8f01d84186c5381a896afafb3d789afe9cb,1,2,4,6,2,2010-07-02 18:06:24,2010-07-02 18:06:24
9d69c8f01d84186c5381a896afafb3d789afe9cb...e0bd235ffa78e74cdeccac5dabedd66487fd124f,2,14,0,14,4,2010-07-02 19:06:53,2010-07-02 19:06:53
e0bd235ffa78e74cdeccac5dabedd66487fd124f...cee4afc267e169d9a92d65287f46deebcae98306,1,44,46,90,4,2010-07-02 19:07:56,2010-07-02 19:07:56
cee4afc267e169d9a92d65287f46deebcae98306...90fab13583224a69490b5ef67b086d7ef4d2bb14,1,1,1,2,2,2010-07-02 19:14:58,2010-07-02 19:14:58
90fab13583224a69490b5ef67b086d7ef4d2bb14...ae2c227f51b86c2644cf0ca76a1b5b6e53307e17,1,4,2,6,1,2010-07-06 23:27:34,2010-07-06 23:27:34
ae2c227f51b86c2644cf0ca76a1b5b6e53307e17...9315b44ad1db3e7b23e19a9ec52788e13fc7bd3f,14,57,38,95,27,2010-07-06 23:31:50,2010-07-06 23:31:50
9315b44ad1db3e7b23e19a9ec52788e13fc7bd3f...5875c4e01c16540547cfa7bb5c4b379f5476d990,35,444,247,691,121,2010-08-04 18:47:42,2010-08-04 18:47:42
5875c4e01c16540547cfa7bb5c4b379f5476d990...0620a1c223bc6bd7b83756376eccd68362610826,2,13,8,21,8,2010-08-05 04:23:03,2010-08-05 04:23:03
0620a1c223bc6bd7b83756376eccd68362610826...6c7baa96d84d33c8d02d8899f462255d805d695e,9,182,45,227,32,2010-08-05 04:30:44,2010-08-05 04:30:44
6c7baa96d84d33c8d02d8899f462255d805d695e...a2e30a41dd00baaa85f0162934327ff0e3dfce51,108,8195,1699,9894,824,2010-08-09 22:11:28,2010-08-09 22:11:28
a2e30a41dd00baaa85f0162934327ff0e3dfce51...6f5899c281ae3259ec9061fd03eebe827cdac4da,1,4,4,8,4,2010-08-09 22:59:55,2010-08-09 22:59:55
6f5899c281ae3259ec9061fd03eebe827cdac4da...fe09017f70f2687f972b8a4358247fd4be8090c1,2,47,42,89,2,2010-08-24 01:03:51,2010-08-24 01:03:51
6cffb9b8804278c4a617109e65493dc782ef2f7d...4e141dcaba3c7dd07b1873601893b0a4197101b8,0,0,0,0,0,2010-05-27 09:37:20,2010-05-27 09:37:20
4e141dcaba3c7dd07b1873601893b0a4197101b8...c36200709900aa8456e7604b5823bf99265903a4,1,3,5,8,1,2010-06-22 21:18:38,2010-06-22 21:18:38
c36200709900aa8456e7604b5823bf99265903a4...ff3c1c6e3ad37224ab72a1d5efc174a3c9c413d3,1,206,0,206,1,2010-06-22 21:18:55,2010-06-22 21:18:55
ff3c1c6e3ad37224ab72a1d5efc174a3c9c413d3...2b50fd810a0987475f6621e062dc956553f9d32c,1,18,19,37,2,2010-06-22 21:19:14,2010-06-22 21:19:14
2b50fd810a0987475f6621e062dc956553f9d32c...ab037f2b8df241a1ae3b31542cf1f58e2a50daf2,3,16,0,16,5,2010-06-22 21:19:39,2010-06-22 21:19:39
ab037f2b8df241a1ae3b31542cf1f58e2a50daf2...06f15e49b8a3973ff32b635a0b41bd18c2f2799e,2,39,11,50,12,2010-06-28 20:22:42,2010-06-28 20:22:42
06f15e49b8a3973ff32b635a0b41bd18c2f2799e...6f4fc6012632adc1ca2e2dab3c045e882e72d560,1,11,15,26,7,2010-06-29 14:50:25,2010-06-29 14:50:25
6f4fc6012632adc1ca2e2dab3c045e882e72d560...60c5f63d5a458fab1578e63069dad6fba8c968cc,2,6,6,12,3,2010-08-06 13:35:15,2010-08-06 13:35:15
60c5f63d5a458fab1578e63069dad6fba8c968cc...56d7859e2588b31e9083f014a894993d6d99cd2b,10,414,240,654,20,2010-08-06 13:46:02,2010-08-06 13:46:02
56d7859e2588b31e9083f014a894993d6d99cd2b...9f8478ff31298d6f77b47aafd5cd654f856798e6,3,11,29,40,8,2010-08-10 01:01:14,2010-08-10 01:01:14
9f8478ff31298d6f77b47aafd5cd654f856798e6...9cf522e6932213b75742f7be70153a27492c4424,1,7,1,8,1,2010-08-10 01:16:51,2010-08-10 01:16:51
9cf522e6932213b75742f7be70153a27492c4424...2b7bfaccf2d9b9f19595e8024620ee988d1305e7,4,34,10,44,11,2010-08-11 01:39:37,2010-08-11 01:39:37
2b7bfaccf2d9b9f19595e8024620ee988d1305e7...467441587c6450663d7da49b29c0457e2f61a790,2,41,37,78,25,2010-08-11 11:15:00,2010-08-11 11:15:00
467441587c6450663d7da49b29c0457e2f61a790...81dc5079638a27853f5c92254133c59956e5f28f,2,17,0,17,5,2010-08-11 12:26:15,2010-08-11 12:26:15
81dc5079638a27853f5c92254133c59956e5f28f...3da601b606fd2bc6da06e2749a30f1e4a8755cd3,3,101,61,162,25,2010-08-14 00:52:33,2010-08-14 00:52:33
3da601b606fd2bc6da06e2749a30f1e4a8755cd3...a357ed10be8eb7d9c0210a47e28b28c2653739ed,6,29,18,47,21,2010-08-15 18:31:48,2010-08-15 18:31:48
a357ed10be8eb7d9c0210a47e28b28c2653739ed...2f027bf5dd4b92c7fcb325a1cea2abcabcfa2c90,2,6,3,9,5,2010-08-15 22:02:04,2010-08-15 22:02:04
2f027bf5dd4b92c7fcb325a1cea2abcabcfa2c90...5e17e835a073d489d6325ea540c29a86bb18fc38,3,22,1,23,4,2010-08-16 16:29:17,2010-08-16 16:29:17
5e17e835a073d489d6325ea540c29a86bb18fc38...574424f40d26eff89a05c8e7664646a5a349514e,1,8,2,10,2,2010-09-10 22:44:44,2010-09-10 22:44:44
574424f40d26eff89a05c8e7664646a5a349514e...11a32d6011358414a3f9179319601583e4fc6b32,4,41,30,71,20,2010-09-12 05:34:58,2010-09-12 05:34:58
11a32d6011358414a3f9179319601583e4fc6b32...32733074906e220c0f9f63f22450c41e81494435,8,74,75,149,26,2010-09-12 21:16:09,2010-09-12 21:16:09
32733074906e220c0f9f63f22450c41e81494435...c9b188c4ec939abbe48dae5a371276742e64b6b8,2,40,32,72,8,2010-09-12 21:52:56,2010-09-12 21:52:56
c9b188c4ec939abbe48dae5a371276742e64b6b8...dd49269c7db008b2567f50cb03c4d3d9b321daa1,473,19779,9394,29173,4257,2010-09-13 00:04:27,2010-09-13 00:04:27
6cffb9b8804278c4a617109e65493dc782ef2f7d...9d3e6668d91af5ef442d07192b5508707d7e0a2a,0,0,0,0,0,2010-05-27 09:35:51,2010-05-27 09:35:51
9d3e6668d91af5ef442d07192b5508707d7e0a2a...a61b34b048d84b2a8af78a42a4e635371252bd3f,29,1426,1315,2741,97,2010-06-07 17:52:53,2010-06-07 17:52:53
a61b34b048d84b2a8af78a42a4e635371252bd3f...0813aa46142bf1ff77b4478d4d620a2117f70d81,9,26,10,36,13,2010-06-07 17:53:14,2010-06-07 17:53:14
0813aa46142bf1ff77b4478d4d620a2117f70d81...4c45befaad280ec3b1b330a4787564081b8fac6f,2,54,1,55,4,2010-06-07 17:53:22,2010-06-07 17:53:22
4c45befaad280ec3b1b330a4787564081b8fac6f...1f9e422b8d31303a97da950edab3678f4e42f024,4,45,1,46,8,2010-06-07 17:53:34,2010-06-07 17:53:34
1f9e422b8d31303a97da950edab3678f4e42f024...8690f66f4a92077fda8890869a2b0efde30d70f3,1,2,0,2,1,2010-06-07 20:03:43,2010-06-07 20:03:43
8690f66f4a92077fda8890869a2b0efde30d70f3...b564f6c66136633b2ec0b27c5762c5911a487b2c,3,15,15,30,3,2010-06-07 20:18:17,2010-06-07 20:18:17
b564f6c66136633b2ec0b27c5762c5911a487b2c...3507a3e629b1378a0be8dabf94917426311fe021,1,11,12,23,1,2010-06-07 20:23:38,2010-06-07 20:23:38
3507a3e629b1378a0be8dabf94917426311fe021...defc4948102b01f2048eb05d51358a22183f5790,2,32,4,36,5,2010-06-09 14:29:24,2010-06-09 14:29:24
defc4948102b01f2048eb05d51358a22183f5790...89fb7aa31044bd3d63302b82ab31e893fa0a43a6,8,75,20,95,18,2010-06-09 15:31:19,2010-06-09 15:31:19
89fb7aa31044bd3d63302b82ab31e893fa0a43a6...9142ba5c4c7a59bb6e2acd5f940b896906272584,1,5,0,5,1,2010-06-09 15:47:23,2010-06-09 15:47:23
9142ba5c4c7a59bb6e2acd5f940b896906272584...fe2bd63e376d3d783cced66bb68de5dc878fadde,4,60,0,60,4,2010-06-09 16:23:26,2010-06-09 16:23:26
fe2bd63e376d3d783cced66bb68de5dc878fadde...7ce89032b6d54072c1f622a84f479c7e50bd6f18,2,20,0,20,5,2010-06-09 19:28:20,2010-06-09 19:28:20
7ce89032b6d54072c1f622a84f479c7e50bd6f18...28499bbe36c36fecf81cb8369fcb01efdc6f7160,3,14,2,16,3,2010-06-09 19:59:44,2010-06-09 19:59:44
28499bbe36c36fecf81cb8369fcb01efdc6f7160...4f395e7527063ecc4c21f33604b81085a8289afc,6,34,105,139,35,2010-06-14 18:30:38,2010-06-14 18:30:38
4f395e7527063ecc4c21f33604b81085a8289afc...8f441f09628d3c3c8e5abe2132ad27e007fb550c,11,52,26,78,18,2010-06-14 19:15:11,2010-06-14 19:15:11
8f441f09628d3c3c8e5abe2132ad27e007fb550c...f522555392ed9e133431437dd815ba0e84bc2394,5,44,6,50,7,2010-06-14 20:09:24,2010-06-14 20:09:24
f522555392ed9e133431437dd815ba0e84bc2394...9f53dbb24653214ad6eae7a37a71558f04294f2c,2,21,1,22,4,2010-06-16 20:48:45,2010-06-16 20:48:45
9f53dbb24653214ad6eae7a37a71558f04294f2c...2804e22bfec198fbef24c9ba3fc6bde2d9ec04f0,1,1,1,2,1,2010-06-18 02:04:10,2010-06-18 02:04:10
2804e22bfec198fbef24c9ba3fc6bde2d9ec04f0...d19cba9b8cc03abe7c0007b74f79adb25754a756,3,66,9,75,10,2010-06-19 01:26:36,2010-06-19 01:26:36
d19cba9b8cc03abe7c0007b74f79adb25754a756...72c6a434038862c90e91a2087fbc38e1c48038d9,2,30,2,32,4,2010-06-19 01:36:13,2010-06-19 01:36:13
72c6a434038862c90e91a2087fbc38e1c48038d9...dd5e71829627705d68905d91fc18c3554a9c69c8,14,164,25,189,39,2010-06-21 15:49:56,2010-06-21 15:49:56
dd5e71829627705d68905d91fc18c3554a9c69c8...706b18966f7f6dcef715ca7b5230e72147cefda6,5,34,33,67,15,2010-06-21 16:11:17,2010-06-21 16:11:17
706b18966f7f6dcef715ca7b5230e72147cefda6...bf071f7c0cbd6e0eaccc404be9e73493dddeba50,2,16,19,35,8,2010-06-21 18:23:34,2010-06-21 18:23:34
bf071f7c0cbd6e0eaccc404be9e73493dddeba50...6c6dc8fd7169d43e653be3ca32e1a93a09fa2479,2,35,4,39,6,2010-06-21 18:38:24,2010-06-21 18:38:24
6c6dc8fd7169d43e653be3ca32e1a93a09fa2479...28c9044ee12414d8faf1a7e977ed0ec0745c4685,2,32,2,34,4,2010-06-21 19:14:13,2010-06-21 19:14:13
28c9044ee12414d8faf1a7e977ed0ec0745c4685...1fda238ce897e342402983e72a6226104141cc6d,3,54,6,60,8,2010-06-21 20:28:47,2010-06-21 20:28:47
1fda238ce897e342402983e72a6226104141cc6d...530434f7ba6149c3073263548c42c3afe4a3de54,2,39,4,43,3,2010-06-22 18:08:38,2010-06-22 18:08:38
530434f7ba6149c3073263548c42c3afe4a3de54...33523c9f95d47dec1a06ef2515af269e91be19b5,2,33,0,33,2,2010-06-22 18:08:47,2010-06-22 18:08:47
33523c9f95d47dec1a06ef2515af269e91be19b5...d6993c7dbb4ffef939e9061a701be2e442971d3b,2,8,4,12,4,2010-06-22 18:09:08,2010-06-22 18:09:08
d6993c7dbb4ffef939e9061a701be2e442971d3b...9a895a63782057ff9638434897b637012cd801b5,1,3,0,3,1,2010-06-22 18:09:15,2010-06-22 18:09:15
9a895a63782057ff9638434897b637012cd801b5...3efa6195411f46dcffb0ee78b9a2ce7dc1876421,2,27,0,27,2,2010-06-22 18:09:25,2010-06-22 18:09:25
3efa6195411f46dcffb0ee78b9a2ce7dc1876421...0ba2e50d9c7c0feaca44600a66ba57b4aad6af92,2,35,1,36,4,2010-06-22 23:05:44,2010-06-22 23:05:44
0ba2e50d9c7c0feaca44600a66ba57b4aad6af92...183c290b8324e256865940c20b32cbceff927e61,8,47,26,73,18,2010-07-01 01:45:44,2010-07-01 01:45:44
183c290b8324e256865940c20b32cbceff927e61...7dcb95ae9a241a896b6b55158d54b741897a1f43,3,9,8,17,6,2010-07-01 01:53:05,2010-07-01 01:53:05
7dcb95ae9a241a896b6b55158d54b741897a1f43...f70c9985c20681a00e63457c2c11b30ab9235d33,4,13,9,22,6,2010-07-01 01:57:12,2010-07-01 01:57:12
f70c9985c20681a00e63457c2c11b30ab9235d33...317010ed40da8b5e6b86d90723b2b1766129c64e,6,10,12,22,9,2010-07-13 18:35:49,2010-07-13 18:35:49
317010ed40da8b5e6b86d90723b2b1766129c64e...d83203cb07d522ead50ee046478e277f27ad1ad1,4,47,5,52,9,2010-07-13 19:17:41,2010-07-13 19:17:41
d83203cb07d522ead50ee046478e277f27ad1ad1...536a5ca51466e3de0b19351dc826710a1e159cf5,2,4,0,4,2,2010-07-13 19:33:43,2010-07-13 19:33:43
536a5ca51466e3de0b19351dc826710a1e159cf5...59089a7d1384f5697e75c55f95a10e721757e2e7,2,9,2,11,3,2010-07-17 02:20:29,2010-07-17 02:20:29
59089a7d1384f5697e75c55f95a10e721757e2e7...485bfe486148783870568ba7e47d41d8ab794069,4,27,2,29,5,2010-07-17 02:38:10,2010-07-17 02:38:10
485bfe486148783870568ba7e47d41d8ab794069...a35cbdbeafb478aeaa281c4d38821affbb47ff37,4,71,18,89,15,2010-07-19 20:36:07,2010-07-19 20:36:07
a35cbdbeafb478aeaa281c4d38821affbb47ff37...9c6e1c89c595de5b6bd3180d59faf944a3093d6d,2,8,1,9,3,2010-07-19 21:04:03,2010-07-19 21:04:03
9c6e1c89c595de5b6bd3180d59faf944a3093d6d...9944d8d5efbe514e8de1d9adcc316a61fded3b65,3,79,12,91,7,2010-07-20 19:33:32,2010-07-20 19:33:32
9944d8d5efbe514e8de1d9adcc316a61fded3b65...9b263c61f805947a06473fd5ca170e8b970aae32,1,21,0,21,1,2010-07-20 21:04:51,2010-07-20 21:04:51
9b263c61f805947a06473fd5ca170e8b970aae32...c7bd48cb9f645e5ff07d1e68b86130e3bb2b043f,6,137,4,141,14,2010-08-09 21:16:59,2010-08-09 21:16:59
c7bd48cb9f645e5ff07d1e68b86130e3bb2b043f...6001ba016a3db4701d56abc6d30868d4e5d88dbf,144,8821,1993,10814,980,2010-08-09 21:22:37,2010-08-09 21:22:37
90ce8b0c99516799ce813349e1f148d040cba948...b46639f5707c7a368de29f3b71b6dd4f811e0c85,1,1,1,2,1,2010-06-19 21:14:56,2010-06-19 21:14:56
b46639f5707c7a368de29f3b71b6dd4f811e0c85...6ab3fea11314d66b3b28b680684ad0423ed8b665,6,110,15,125,25,2010-06-21 11:48:45,2010-06-21 11:48:45
6ab3fea11314d66b3b28b680684ad0423ed8b665...0dce7b69210ed9fa60aa4eb1b4a8a571f23315c1,2,9,3,12,5,2010-06-21 12:09:25,2010-06-21 12:09:25
0dce7b69210ed9fa60aa4eb1b4a8a571f23315c1...2f2018e04d4a69c32937aa43fed1c5a10a9e878c,2,38,0,38,2,2010-06-21 12:19:32,2010-06-21 12:19:32
2f2018e04d4a69c32937aa43fed1c5a10a9e878c...5ff262e8bf83eb64cd719d8880f2db5462615f9d,2,11,1,12,2,2010-06-23 13:14:30,2010-06-23 13:14:30
5ff262e8bf83eb64cd719d8880f2db5462615f9d...096c465358a89839e43de5afe74d11d0ef6d8dea,1,2,2,4,2,2010-06-23 17:17:22,2010-06-23 17:17:22
096c465358a89839e43de5afe74d11d0ef6d8dea...7773a92c7f79bad1d699064330a2019995c7ef08,2,8,11,19,5,2010-06-23 17:34:57,2010-06-23 17:34:57
7773a92c7f79bad1d699064330a2019995c7ef08...6eafd412fcb41dc2866f6a1f27dfb4941f999aa7,1,10,8,18,6,2010-06-23 20:03:41,2010-06-23 20:03:41
6eafd412fcb41dc2866f6a1f27dfb4941f999aa7...c724ad9c7d09376c20898a5b5975f7d58222fd83,1,0,2,2,1,2010-06-24 11:10:58,2010-06-24 11:10:58
c724ad9c7d09376c20898a5b5975f7d58222fd83...f92a21daa78f4f1b34c0188d6d764a5992f94adc,1,16,2,18,2,2010-06-30 22:30:37,2010-06-30 22:30:37
f92a21daa78f4f1b34c0188d6d764a5992f94adc...2cf21d994df1cfed4d35f5f338c97edaffa4ba8a,1,3,7,10,3,2010-07-05 16:26:12,2010-07-05 16:26:12
2cf21d994df1cfed4d35f5f338c97edaffa4ba8a...910c0866f7ea6a1c923ca0290694d4f827eaab10,1,2,0,2,1,2010-07-05 16:51:29,2010-07-05 16:51:29
910c0866f7ea6a1c923ca0290694d4f827eaab10...0f34c3dbf4544438833b3f0c5fd9670e5ffcceff,2,2,2,4,2,2010-07-05 17:07:50,2010-07-05 17:07:50
0f34c3dbf4544438833b3f0c5fd9670e5ffcceff...9d0b9ad85e472dfdf6dc157e66b32e160b3c4643,2,3,3,6,3,2010-07-05 17:19:52,2010-07-05 17:19:52
9d0b9ad85e472dfdf6dc157e66b32e160b3c4643...2fce843832dabd09abe75ac5d9ba909540cdd683,1,1,1,2,1,2010-07-17 09:29:44,2010-07-17 09:29:44
2fce843832dabd09abe75ac5d9ba909540cdd683...87a60e28cc6a0127c798af9b20ac4e891f082ebc,3,17,2,19,5,2010-07-20 19:05:46,2010-07-20 19:05:46
87a60e28cc6a0127c798af9b20ac4e891f082ebc...aaa5dfbf53e20c2dd24268502455e82211250172,1,1,1,2,1,2010-07-21 15:23:18,2010-07-21 15:23:18
aaa5dfbf53e20c2dd24268502455e82211250172...fad4a93275a6a5267912c9fc88cdeee44dd5572f,18,232,58,290,36,2010-07-24 10:21:21,2010-07-24 10:21:21
fad4a93275a6a5267912c9fc88cdeee44dd5572f...cd8758ef4dd28f55858d1df65bf5d4ce07137eb1,3,48,111,159,32,2010-07-25 20:39:40,2010-07-25 20:39:40
cd8758ef4dd28f55858d1df65bf5d4ce07137eb1...bab9aab9a2cd82706e2a15044db40b9fc85afbc5,3,34,2,36,5,2010-07-30 02:42:36,2010-07-30 02:42:36
bab9aab9a2cd82706e2a15044db40b9fc85afbc5...398415fc231b51125ecc6f05afaf7e47da12390e,2,7,4,11,5,2010-07-30 02:43:01,2010-07-30 02:43:01
398415fc231b51125ecc6f05afaf7e47da12390e...f185a58025ecd48b5557a520e4dcc4de15f85c18,1,1,1,2,1,2010-07-30 02:54:47,2010-07-30 02:54:47
f185a58025ecd48b5557a520e4dcc4de15f85c18...8b73acdf4da82840eebfe2fb77e4806cf37a23c4,1,3,2,5,2,2010-07-30 02:55:20,2010-07-30 02:55:20
8b73acdf4da82840eebfe2fb77e4806cf37a23c4...de81c5513c9d1e71965c7ccb5f8e1f62e6a45da6,1,1,1,2,1,2010-07-30 03:49:58,2010-07-30 03:49:58
de81c5513c9d1e71965c7ccb5f8e1f62e6a45da6...c4e766c1002465242db01b1da539606f6673ae27,1,1,4,5,1,2010-07-30 04:06:27,2010-07-30 04:06:27
c4e766c1002465242db01b1da539606f6673ae27...88f2f0b39d051009568ba194725d4cd5cc553c6e,1,54,56,110,25,2010-07-30 04:15:16,2010-07-30 04:15:16
88f2f0b39d051009568ba194725d4cd5cc553c6e...2e3fdc63262c968ec89392a9fc9fb8b7aa0ce8be,1,11,0,11,1,2010-08-03 15:34:52,2010-08-03 15:34:52
2e3fdc63262c968ec89392a9fc9fb8b7aa0ce8be...f40922609f6d8558773ec5004a1f974425596c6b,1,20,2,22,3,2010-08-03 15:34:59,2010-08-03 15:34:59
f40922609f6d8558773ec5004a1f974425596c6b...e64cdf7129c5ff9a0229d6c3fcde00079a70a4f9,2,9,4,13,6,2010-08-03 15:42:39,2010-08-03 15:42:39
e64cdf7129c5ff9a0229d6c3fcde00079a70a4f9...81ac1735236d30d71cf0a8d73756e8df9ad8616e,1,8,2,10,2,2010-08-04 14:34:48,2010-08-04 14:34:48
81ac1735236d30d71cf0a8d73756e8df9ad8616e...099c6b8710c0751f565378250ddfdc6a6476ddab,2,5,3,8,3,2010-08-04 19:08:14,2010-08-04 19:08:14
099c6b8710c0751f565378250ddfdc6a6476ddab...1c8547bf98b792a382c2da3b788b5e9359c0c417,1,6,6,12,1,2010-08-05 01:29:59,2010-08-05 01:29:59
1c8547bf98b792a382c2da3b788b5e9359c0c417...fc374976e51881d47203807e9843b4b2b3a0674b,3,116,34,150,22,2010-08-05 02:13:32,2010-08-05 02:13:32
fc374976e51881d47203807e9843b4b2b3a0674b...aa93f8c2f0ff5f568d3f73e49b3b217b5ba3c0b8,3,55,2,57,6,2010-08-05 03:59:20,2010-08-05 03:59:20
aa93f8c2f0ff5f568d3f73e49b3b217b5ba3c0b8...e0fb90b2f3b16300426851790b0ef3e50f3d67b3,5,172,11,183,15,2010-08-05 07:09:47,2010-08-05 07:09:47
e0fb90b2f3b16300426851790b0ef3e50f3d67b3...c5e83a9e0a8f0027cb18ed2a9e3acbaa99c71e7d,1,1,1,2,1,2010-08-05 11:27:20,2010-08-05 11:27:20
c5e83a9e0a8f0027cb18ed2a9e3acbaa99c71e7d...5eece23296c481fc2f8b896b7d41e71bebe6114e,2,274,389,663,2,2010-08-05 11:49:58,2010-08-05 11:49:58
5eece23296c481fc2f8b896b7d41e71bebe6114e...25f0ff48ac9f66bf44647aa0b57ac41837966308,1,1,1,2,1,2010-08-05 12:49:48,2010-08-05 12:49:48
25f0ff48ac9f66bf44647aa0b57ac41837966308...75d018f63164a9e307c0e7604af903fbbe23c21f,3,913,9,922,9,2010-08-05 12:50:30,2010-08-05 12:50:30
75d018f63164a9e307c0e7604af903fbbe23c21f...1050d25096da7b54e25222d480c3ec5156fc074f,1,1,1,2,1,2010-08-05 13:00:09,2010-08-05 13:00:09
1050d25096da7b54e25222d480c3ec5156fc074f...d75922dad65b3f0b4ce1fcc0df02d31faffdf437,3,8,5,13,4,2010-08-05 13:18:50,2010-08-05 13:18:50
d75922dad65b3f0b4ce1fcc0df02d31faffdf437...aa4061dbc0552e3ccce75558b38c2644a4956b1b,7,5239,0,5239,4,2010-08-06 02:10:21,2010-08-06 02:10:21
aa4061dbc0552e3ccce75558b38c2644a4956b1b...75ac6c26daa2d8f4b840fe839e749bc08c01970a,1,1,1,2,1,2010-08-06 02:10:45,2010-08-06 02:10:45
75ac6c26daa2d8f4b840fe839e749bc08c01970a...69d1e71fad3046792f737b26c7da75e8f373eb44,5,27,1,28,9,2010-08-06 13:47:56,2010-08-06 13:47:56
69d1e71fad3046792f737b26c7da75e8f373eb44...d3ba8cb88b2f3939398c9c54e5aa5c6e7495e56f,5,74,49,123,30,2010-08-06 14:25:58,2010-08-06 14:25:58
d3ba8cb88b2f3939398c9c54e5aa5c6e7495e56f...f90a25551dbd10b7d57725a2abec3e11cf0e22cd,2,6,1,7,2,2010-08-06 14:34:10,2010-08-06 14:34:10
f90a25551dbd10b7d57725a2abec3e11cf0e22cd...2ab3b52d2adb0aa6d15aa94e4fc5aab9ec3554d0,3,20,4,24,8,2010-08-06 14:58:05,2010-08-06 14:58:05
2ab3b52d2adb0aa6d15aa94e4fc5aab9ec3554d0...cefee67b7d531090b21a2b4457bb36fa5557d1f3,2,15,1,16,4,2010-08-06 16:08:40,2010-08-06 16:08:40
cefee67b7d531090b21a2b4457bb36fa5557d1f3...0db9911316adc406a5966ab967e452084e3f0316,5,101,92,193,9,2010-08-06 16:18:10,2010-08-06 16:18:10
0db9911316adc406a5966ab967e452084e3f0316...9e5899f665bb37801352224e7a874a9a8ba40cd4,1,0,0,0,0,2010-08-06 16:24:29,2010-08-06 16:24:29
9e5899f665bb37801352224e7a874a9a8ba40cd4...c4b6edf3b8b647e7ef43f1ba49a310fb93468919,7,14,16,30,9,2010-08-06 16:31:44,2010-08-06 16:31:44
c4b6edf3b8b647e7ef43f1ba49a310fb93468919...6eb7cd1af49950f9128b7867a8ce886223b47d4f,2,8,0,8,3,2010-08-06 16:34:34,2010-08-06 16:34:34
6eb7cd1af49950f9128b7867a8ce886223b47d4f...0c37f8d81f483b6435cb591aa6b4759df763e9b9,4,78,6,84,11,2010-08-06 16:48:07,2010-08-06 16:48:07
0c37f8d81f483b6435cb591aa6b4759df763e9b9...9767993a245bd465d64e7bc50d5c4b72eee5b8ef,2,8,8,16,8,2010-08-06 16:54:17,2010-08-06 16:54:17
9767993a245bd465d64e7bc50d5c4b72eee5b8ef...4e1c9ec24be3562e9651409ed9e3aa7bd962cd64,4,101,89,190,86,2010-08-06 16:54:43,2010-08-06 16:54:43
4e1c9ec24be3562e9651409ed9e3aa7bd962cd64...7c03f1c97a7d4829db4d7a921d6db7471f7d3453,2,83,75,158,74,2010-08-06 16:55:44,2010-08-06 16:55:44
7c03f1c97a7d4829db4d7a921d6db7471f7d3453...917f433727b485ea3bb14bb74dcfcbcd5f789de8,2,29,1,30,5,2010-08-06 17:14:02,2010-08-06 17:14:02
917f433727b485ea3bb14bb74dcfcbcd5f789de8...550912c513fa7b995c50c3f616d73e3df91eacfe,3,18,18,36,14,2010-08-06 17:47:58,2010-08-06 17:47:58
550912c513fa7b995c50c3f616d73e3df91eacfe...998daa897f26142fe2f6885bc3cf3588f4e66d74,4,98,117,215,84,2010-08-06 19:01:18,2010-08-06 19:01:18
998daa897f26142fe2f6885bc3cf3588f4e66d74...b71f990a9cc81caa06d2573cda682ca54297b925,2,1,2,3,2,2010-08-06 19:15:58,2010-08-06 19:15:58
b71f990a9cc81caa06d2573cda682ca54297b925...10906fa75da9cacb110e4e414fa7c7ca93c188e0,1,3,3,6,3,2010-08-07 01:29:23,2010-08-07 01:29:23
10906fa75da9cacb110e4e414fa7c7ca93c188e0...9a63264b09d0fe8243d06af508e1ec31a7fd7c08,8,506,606,1112,316,2010-08-07 02:18:03,2010-08-07 02:18:03
9a63264b09d0fe8243d06af508e1ec31a7fd7c08...14fa3b7e2430e7674f0d3c8063c8e43c575a3de5,1,1,1,2,1,2010-08-07 02:42:50,2010-08-07 02:42:50
14fa3b7e2430e7674f0d3c8063c8e43c575a3de5...0331913a77b0c2b28fe4c3aa7d4c421c493f5fdd,1,72,72,144,14,2010-08-07 02:43:14,2010-08-07 02:43:14
0331913a77b0c2b28fe4c3aa7d4c421c493f5fdd...5dee1066a57fe6ed75feabb1aefe812bea4c4b23,1,1,1,2,1,2010-08-07 02:43:35,2010-08-07 02:43:35
5dee1066a57fe6ed75feabb1aefe812bea4c4b23...54e70e842eb9c0d9bd391906e94687c9f57d8719,1,2,2,4,2,2010-08-07 02:43:56,2010-08-07 02:43:56
54e70e842eb9c0d9bd391906e94687c9f57d8719...92a15532baae79fd62843e7747f2834dede4347d,1,1,1,2,1,2010-08-07 02:44:17,2010-08-07 02:44:17
92a15532baae79fd62843e7747f2834dede4347d...458e3a3ff90ffe2a76eaf0a05c9ee8639303b3b2,1,1,1,2,1,2010-08-07 02:44:38,2010-08-07 02:44:38
458e3a3ff90ffe2a76eaf0a05c9ee8639303b3b2...7e06065d8b4b725330440e785accba243748da81,7,157,22,179,28,2010-08-07 06:27:52,2010-08-07 06:27:52
7e06065d8b4b725330440e785accba243748da81...72dc12ed06ae45e49c79b8fd257e1b1589b3fad2,8,30,30,60,28,2010-08-07 06:58:14,2010-08-07 06:58:14
72dc12ed06ae45e49c79b8fd257e1b1589b3fad2...244e7b9334beb6d61814b849445a128aa0ce3c9e,1,3,0,3,1,2010-08-07 07:38:27,2010-08-07 07:38:27
244e7b9334beb6d61814b849445a128aa0ce3c9e...bafe9fdef2060f315a6b37f8eeffc1af1492c565,1,5,0,5,1,2010-08-07 07:57:15,2010-08-07 07:57:15
bafe9fdef2060f315a6b37f8eeffc1af1492c565...5d1627ff6eeecc9ace5c009cb401aa49341bc48b,1,4,2,6,1,2010-08-07 07:57:35,2010-08-07 07:57:35
5d1627ff6eeecc9ace5c009cb401aa49341bc48b...973fb63e4f4a2d07cf14cf117175cece71f0a8da,2,33,4,37,3,2010-08-07 14:17:14,2010-08-07 14:17:14
973fb63e4f4a2d07cf14cf117175cece71f0a8da...2dc2ed87e5bbf993b2189f33cc0310521dbc8801,7,33,42,75,24,2010-08-07 14:26:07,2010-08-07 14:26:07
2dc2ed87e5bbf993b2189f33cc0310521dbc8801...1a9e0f70ea82efe8cda5e96eb1351cc60419d8d6,1,2,2,4,1,2010-08-07 14:55:31,2010-08-07 14:55:31
1a9e0f70ea82efe8cda5e96eb1351cc60419d8d6...7aa7943434ec0b256242dc6444b946f7508f290b,1,4,0,4,2,2010-08-07 14:55:54,2010-08-07 14:55:54
7aa7943434ec0b256242dc6444b946f7508f290b...6ac4aba918fde4d0de8cb371d4ae72cd09fa7151,1,17,2,19,2,2010-08-07 14:56:16,2010-08-07 14:56:16
6ac4aba918fde4d0de8cb371d4ae72cd09fa7151...50e3aa03e66fb7b7b7c6f5533efd961742b81853,1,1,1,2,2,2010-08-07 14:56:38,2010-08-07 14:56:38
50e3aa03e66fb7b7b7c6f5533efd961742b81853...103f7f83eb5f46bcfa2473dadc38a19f59832565,1,13,9,22,1,2010-08-07 14:56:59,2010-08-07 14:56:59
103f7f83eb5f46bcfa2473dadc38a19f59832565...806f3b26f80c729dede7f10b463691d1f5aae13e,3,17,3,20,7,2010-08-07 14:57:24,2010-08-07 14:57:24
806f3b26f80c729dede7f10b463691d1f5aae13e...0a753297c80d11d9ee16d5b92ad1e5cccf41f30e,1,5,4,9,2,2010-08-07 14:57:44,2010-08-07 14:57:44
0a753297c80d11d9ee16d5b92ad1e5cccf41f30e...a004ac6eef3faa847f73afb9127c10269f097dd1,2,3,3,6,3,2010-08-11 12:02:40,2010-08-11 12:02:40
a004ac6eef3faa847f73afb9127c10269f097dd1...d69cdc6d706db67a0ee118d9aaab82f9e7e5dcba,1,1,1,2,1,2010-08-12 10:48:24,2010-08-12 10:48:24
d69cdc6d706db67a0ee118d9aaab82f9e7e5dcba...b3dc3a0106062bf28a28dc426885e7002a16a761,5,122,34,156,17,2010-08-14 12:05:41,2010-08-14 12:05:41
b3dc3a0106062bf28a28dc426885e7002a16a761...597e03cd741b5c732317a5384185d70520a76cde,1,18,18,36,9,2010-08-14 12:11:02,2010-08-14 12:11:02
597e03cd741b5c732317a5384185d70520a76cde...6732c9810126a211a0a8f426f1701e3fdefa3964,2,106,98,204,95,2010-08-14 12:19:19,2010-08-14 12:19:19
6732c9810126a211a0a8f426f1701e3fdefa3964...7b62523b9551f94dca2f2f073645ad4381e56fb2,2,107,99,206,97,2010-08-14 12:19:44,2010-08-14 12:19:44
7b62523b9551f94dca2f2f073645ad4381e56fb2...b61e7754caf4a073a4682dc3ce2eac07e3ef54eb,2,215,222,437,211,2010-08-14 12:32:22,2010-08-14 12:32:22
b61e7754caf4a073a4682dc3ce2eac07e3ef54eb...4835d862035b4d2bbf733bcaca67ed8c3aae47ca,4,2276,1507,3783,1166,2010-08-14 12:33:31,2010-08-14 12:33:31
4835d862035b4d2bbf733bcaca67ed8c3aae47ca...047d161164b2459434e6a17891f079f5f80d4cef,3,22,6,28,4,2010-08-14 12:45:15,2010-08-14 12:45:15
047d161164b2459434e6a17891f079f5f80d4cef...db04b24e066f7f0ff8cdc8e4407766186b397884,1,1,1,2,2,2010-08-14 12:57:16,2010-08-14 12:57:16
db04b24e066f7f0ff8cdc8e4407766186b397884...05f5217551f203711c7c00d509d8554d8829fee8,1,10,13,23,21,2010-08-14 12:57:37,2010-08-14 12:57:37
05f5217551f203711c7c00d509d8554d8829fee8...7e52bb2bc3ea6b3c32866d948268c8681c3e12b3,3,44,2,46,4,2010-08-14 13:41:56,2010-08-14 13:41:56
7e52bb2bc3ea6b3c32866d948268c8681c3e12b3...859fc020a7c5ce30784d6388858ffbc613ef6612,3,31,5,36,8,2010-08-14 14:27:35,2010-08-14 14:27:35
859fc020a7c5ce30784d6388858ffbc613ef6612...01720c979ae0114213d716d4161ec1b09642d7e8,1,10,0,10,1,2010-08-14 15:50:46,2010-08-14 15:50:46
01720c979ae0114213d716d4161ec1b09642d7e8...842ceb5fe6758b54a22594f120f8180a902fe1cc,1,10,12,22,2,2010-08-16 04:42:44,2010-08-16 04:42:44
842ceb5fe6758b54a22594f120f8180a902fe1cc...810ed2b22be663660d2ad56a43357c9a0378d7df,1,0,4,4,1,2010-08-16 06:41:48,2010-08-16 06:41:48
810ed2b22be663660d2ad56a43357c9a0378d7df...015d85aee64ed8b020c38b2ada55d8aaba0608eb,4,18,5,23,8,2010-08-17 07:07:28,2010-08-17 07:07:28
015d85aee64ed8b020c38b2ada55d8aaba0608eb...68aff2f7be6c3d3c414d540c1bc494d39530a63b,1,1,1,2,1,2010-08-18 02:42:01,2010-08-18 02:42:01
68aff2f7be6c3d3c414d540c1bc494d39530a63b...7098f8444e0f122d5d29c74bd0c41929ad66d83c,1,39,30,69,4,2010-08-18 16:31:15,2010-08-18 16:31:15
7098f8444e0f122d5d29c74bd0c41929ad66d83c...806c30cd634c1654c8050b64ff4b46dc559c9eb8,2,4,5,9,3,2010-08-18 16:34:50,2010-08-18 16:34:50
806c30cd634c1654c8050b64ff4b46dc559c9eb8...a352154e42d7bcb63994c7deefc976a989dcb0cd,1,33,26,59,11,2010-08-19 13:11:24,2010-08-19 13:11:24
a352154e42d7bcb63994c7deefc976a989dcb0cd...728effcfbdc29d7962b56d794f8911f57a9a63df,181,1222,1525,2747,1034,2010-08-19 19:27:44,2010-08-19 19:27:44
728effcfbdc29d7962b56d794f8911f57a9a63df...e0387f7abed32a90771ca22f63af64b43735501d,1,13,11,24,4,2010-08-20 07:09:58,2010-08-20 07:09:58
e0387f7abed32a90771ca22f63af64b43735501d...c2e3ba3ba0bf6cca0a35d904b334a37b225a31da,3,64,9,73,15,2010-08-20 13:57:24,2010-08-20 13:57:24
c2e3ba3ba0bf6cca0a35d904b334a37b225a31da...1bf25e9bc6df6c2ae4c0b10fb839e101471e8373,5,639,333,972,19,2010-08-20 14:28:42,2010-08-20 14:28:42
1bf25e9bc6df6c2ae4c0b10fb839e101471e8373...d33736b3ee267156cc91b6a4ebf0e2f0a1b162cc,1,11,14,25,2,2010-08-20 15:03:11,2010-08-20 15:03:11
d33736b3ee267156cc91b6a4ebf0e2f0a1b162cc...8cd5d283691e5e1005b7cdd18676ce9c6b13a857,1,1,1,2,1,2010-08-21 02:55:02,2010-08-21 02:55:02
8cd5d283691e5e1005b7cdd18676ce9c6b13a857...26b3fb1e82d409c959910d8c6f7e88e25457a267,4,28,8,36,11,2010-08-21 03:01:46,2010-08-21 03:01:46
26b3fb1e82d409c959910d8c6f7e88e25457a267...10de06b6d416fc1dbaa48d991b258bfc9dca791a,2,71,40,111,2,2010-08-23 07:04:41,2010-08-23 07:04:41
10de06b6d416fc1dbaa48d991b258bfc9dca791a...08277e88ac7ae1334dabe4b583c72a0905b8db45,1,2,0,2,1,2010-08-23 07:13:42,2010-08-23 07:13:42
08277e88ac7ae1334dabe4b583c72a0905b8db45...5d4c37af7cedfc78f0f223960e0bfd26f12eaa31,1,18,0,18,1,2010-08-23 07:43:50,2010-08-23 07:43:50
5d4c37af7cedfc78f0f223960e0bfd26f12eaa31...a323fd3c5e9d53b22efb8660e9dd0d666002dc09,11,74,29,103,22,2010-08-23 08:07:35,2010-08-23 08:07:35
a323fd3c5e9d53b22efb8660e9dd0d666002dc09...3c99d0622957366867beaccb7d5806a8b23e2a36,1,3,3,6,3,2010-08-23 08:11:24,2010-08-23 08:11:24
3c99d0622957366867beaccb7d5806a8b23e2a36...331bf8090481033a709e0aad20f75707efa02f7e,1,1,1,2,1,2010-08-23 13:50:28,2010-08-23 13:50:28
331bf8090481033a709e0aad20f75707efa02f7e...ce98a29eb704689dde6e1f7574bf5f9073234df5,1,8,8,16,8,2010-08-24 02:26:14,2010-08-24 02:26:14
ce98a29eb704689dde6e1f7574bf5f9073234df5...88e83ee4721822692f050ba179adbfa4581403b5,1,1,1,2,1,2010-08-26 11:08:12,2010-08-26 11:08:12
88e83ee4721822692f050ba179adbfa4581403b5...8ce4a1991a6a6b336a6ca6224c0d808d4b2964c7,4,51,3,54,7,2010-08-27 13:54:13,2010-08-27 13:54:13
8ce4a1991a6a6b336a6ca6224c0d808d4b2964c7...3f96a7a358895a90286c8752ebcc6b10ed426443,10,234,2,236,11,2010-08-27 13:55:11,2010-08-27 13:55:11
3f96a7a358895a90286c8752ebcc6b10ed426443...46fab8983e65955129ea24549c9341fd8c486ce0,4,61,1,62,4,2010-08-27 15:16:04,2010-08-27 15:16:04
46fab8983e65955129ea24549c9341fd8c486ce0...11dfbf2f08fc07f4c9c6e91cd8e4c331d5f81b1e,1,1,1,2,1,2010-08-27 15:16:30,2010-08-27 15:16:30
11dfbf2f08fc07f4c9c6e91cd8e4c331d5f81b1e...23e85ef25fd56de439337df28227a87080046156,3,46,35,81,6,2010-08-28 02:40:17,2010-08-28 02:40:17
23e85ef25fd56de439337df28227a87080046156...f611ffaab3be0c9a9d21b6bd404fdefb30a3e909,14,155,68,223,42,2010-08-28 02:40:57,2010-08-28 02:40:57
f611ffaab3be0c9a9d21b6bd404fdefb30a3e909...34740625ff1f8bbe667f4d71b77ef82e5548b011,1,1,1,2,1,2010-08-28 06:12:54,2010-08-28 06:12:54
34740625ff1f8bbe667f4d71b77ef82e5548b011...c00f35ae0d18f4a6d11c25f06ee7743588a5ec96,1,5,4,9,4,2010-08-28 11:23:54,2010-08-28 11:23:54
c00f35ae0d18f4a6d11c25f06ee7743588a5ec96...e1e2726957ef2c74c5e7e3461d37c7603998c1af,11,369,10,379,23,2010-08-28 11:59:14,2010-08-28 11:59:14
e1e2726957ef2c74c5e7e3461d37c7603998c1af...72a716743929afd613fb5242d2525265ec27b2c5,4,41,2,43,6,2010-08-28 12:25:54,2010-08-28 12:25:54
72a716743929afd613fb5242d2525265ec27b2c5...80dd2edabba78ba79d57460a41d12d37b5c99501,1,35,35,70,2,2010-08-28 12:28:56,2010-08-28 12:28:56
80dd2edabba78ba79d57460a41d12d37b5c99501...f4dd38757c47945af644fb782a37185e1d62de1c,2,3,2,5,2,2010-08-28 12:38:05,2010-08-28 12:38:05
f4dd38757c47945af644fb782a37185e1d62de1c...120070ed47afb9507c4cd934cbb67ed6bf5dadcb,1,5,0,5,1,2010-08-28 12:45:03,2010-08-28 12:45:03
120070ed47afb9507c4cd934cbb67ed6bf5dadcb...1b7fcf4758c8f21b63da75c6844949cb640f14a3,1,4,1,5,1,2010-08-28 13:17:50,2010-08-28 13:17:50
1b7fcf4758c8f21b63da75c6844949cb640f14a3...20fb7c78581671eb662f2286944d5f64245692f5,1,1,1,2,1,2010-08-30 10:24:18,2010-08-30 10:24:18
20fb7c78581671eb662f2286944d5f64245692f5...58c8d9233479b4cc906f3598391123df393b0b8a,1,1,1,2,1,2010-08-30 10:29:44,2010-08-30 10:29:44
58c8d9233479b4cc906f3598391123df393b0b8a...f9d051d5f0ea5853373150c689daf4f5a691ef99,1,2,2,4,2,2010-08-30 11:47:32,2010-08-30 11:47:32
f9d051d5f0ea5853373150c689daf4f5a691ef99...5deb3e5a6240b18e6fb03b7adc2656eeaa5be396,4,37,5,42,11,2010-08-30 11:58:26,2010-08-30 11:58:26
5deb3e5a6240b18e6fb03b7adc2656eeaa5be396...a5c80a28dc797211eb39a5e073e380a8a0bbb369,1,1,0,1,1,2010-08-30 12:32:26,2010-08-30 12:32:26
a5c80a28dc797211eb39a5e073e380a8a0bbb369...6909c22663ec12f95501622bba643504f63d3143,8,36,46,82,11,2010-08-30 13:21:18,2010-08-30 13:21:18
6909c22663ec12f95501622bba643504f63d3143...bb79b0177458d7dc6bf1ad3c13928edd9e5f244e,1,36,0,36,1,2010-08-30 13:21:45,2010-08-30 13:21:45
bb79b0177458d7dc6bf1ad3c13928edd9e5f244e...0de3e7a75684798fd86616571b27f488a4c06d07,3,31,8,39,13,2010-08-30 15:09:12,2010-08-30 15:09:12
0de3e7a75684798fd86616571b27f488a4c06d07...2a0f4fb5da0ed4224dabe280f7a6aefcb21f9911,2,27,3,30,7,2010-08-31 00:44:46,2010-08-31 00:44:46
2a0f4fb5da0ed4224dabe280f7a6aefcb21f9911...e8cff0b8f3920419b1031e16e2ee01851bd75e1d,2,33,8,41,17,2010-09-03 16:28:10,2010-09-03 16:28:10
e8cff0b8f3920419b1031e16e2ee01851bd75e1d...bdd13a4daaf2471c851f538a76e86010a968d24d,1,4,0,4,1,2010-09-03 18:56:12,2010-09-03 18:56:12
bdd13a4daaf2471c851f538a76e86010a968d24d...027aaca37f25d866a87a6426fa197813f75051cf,1,9,0,9,1,2010-09-03 19:00:43,2010-09-03 19:00:43
027aaca37f25d866a87a6426fa197813f75051cf...c8bcd5e5478205a5500c694c4ceef0df79627a00,1,1,1,2,1,2010-09-07 20:19:41,2010-09-07 20:19:41
c8bcd5e5478205a5500c694c4ceef0df79627a00...4f4e20be3333a656996c027a52a4a06d4a2a2480,1,2,1,3,1,2010-09-07 20:21:50,2010-09-07 20:21:50
4f4e20be3333a656996c027a52a4a06d4a2a2480...0b37d56481d453e79b322fef28313c83bb806561,2,10,2,12,4,2010-09-07 20:30:46,2010-09-07 20:30:46
0b37d56481d453e79b322fef28313c83bb806561...2422fbfc934c2fb3399c0e66c6633eaaa4d36c76,1,1,1,2,1,2010-09-07 20:43:19,2010-09-07 20:43:19
2422fbfc934c2fb3399c0e66c6633eaaa4d36c76...e5d30c700153fdd674c8a42fb601cd1e17c91911,1,7,1,8,2,2010-09-07 20:49:32,2010-09-07 20:49:32
e5d30c700153fdd674c8a42fb601cd1e17c91911...ef4b29a001247d7881af88c13cb827770a042e06,2,16,1,17,2,2010-09-07 20:55:53,2010-09-07 20:55:53
ef4b29a001247d7881af88c13cb827770a042e06...9e3b327aca75b4b34abf6b00f1fd3c2cf65c8db6,3,11,5,16,8,2010-09-09 00:34:54,2010-09-09 00:34:54
9e3b327aca75b4b34abf6b00f1fd3c2cf65c8db6...801bb146e8d4b74160c0927be184186f30194247,2,237,233,470,3,2010-09-09 23:21:16,2010-09-09 23:21:16
801bb146e8d4b74160c0927be184186f30194247...303bdc85a7a310efc28e2ee52a5e9607069bb335,2,19,1,20,2,2010-09-09 23:31:54,2010-09-09 23:31:54
303bdc85a7a310efc28e2ee52a5e9607069bb335...92b91d6e7b91a8d94b1e3b8d6d2059d57395c25d,1,1,1,2,1,2010-09-10 13:03:02,2010-09-10 13:03:02
92b91d6e7b91a8d94b1e3b8d6d2059d57395c25d...30610719d58502233d1e916eafbbbe69409a539f,3,36,3,39,5,2010-09-10 16:56:36,2010-09-10 16:56:36
30610719d58502233d1e916eafbbbe69409a539f...30ad3537184fb8db8051b91b060c50ad73b53b7e,1,13,13,26,13,2010-09-10 17:04:28,2010-09-10 17:04:28
30ad3537184fb8db8051b91b060c50ad73b53b7e...003ed01bb3c8b26fbc16c38d6e7d110cf7fd0d8c,2,3,1,4,3,2010-09-10 17:49:42,2010-09-10 17:49:42
003ed01bb3c8b26fbc16c38d6e7d110cf7fd0d8c...037b579b5ed5ba75497230a26ca93156cf0cdc5c,1,10,4,14,8,2010-09-10 17:57:42,2010-09-10 17:57:42
037b579b5ed5ba75497230a26ca93156cf0cdc5c...443cb9b6edb227211effcbc9e1534ee04a9579af,1,13,7,20,12,2010-09-10 18:09:18,2010-09-10 18:09:18
443cb9b6edb227211effcbc9e1534ee04a9579af...76249c39641e90cc26465fbce5530e4a77c6babe,2,28,7,35,7,2010-09-10 18:45:25,2010-09-10 18:45:25
76249c39641e90cc26465fbce5530e4a77c6babe...6ad4b328fa3f9eef84649f885be868316e672fa9,1,3,3,6,3,2010-09-10 19:16:43,2010-09-10 19:16:43
6ad4b328fa3f9eef84649f885be868316e672fa9...dee7ef802d386951faef012c80a2a668b1926a78,1,4,1,5,3,2010-09-10 19:21:31,2010-09-10 19:21:31
dee7ef802d386951faef012c80a2a668b1926a78...255147c97e4d71cae7ec6255720b4d265269deb2,2,22,0,22,2,2010-09-10 19:24:24,2010-09-10 19:24:24
255147c97e4d71cae7ec6255720b4d265269deb2...27265f70a18ab8fb4bfacad0cdebe170c342054c,1,6,0,6,1,2010-09-10 19:36:51,2010-09-10 19:36:51
27265f70a18ab8fb4bfacad0cdebe170c342054c...bb00b2839980145984c487410fc65fbc0c94be3d,5,55,28,83,14,2010-09-10 19:38:57,2010-09-10 19:38:57
bb00b2839980145984c487410fc65fbc0c94be3d...7543eb95e6cb6c6dd4f900e0ecdfa71fa411cdea,2,23,26,49,2,2010-09-10 20:54:01,2010-09-10 20:54:01
7543eb95e6cb6c6dd4f900e0ecdfa71fa411cdea...c5772009c12f477f062fae4bde7d5f0a51627ed4,2,4,4,8,4,2010-09-10 22:37:17,2010-09-10 22:37:17
c5772009c12f477f062fae4bde7d5f0a51627ed4...fd1e4b81d9fb58010166135622c9be415c3b1e31,3,118,8,126,10,2010-09-10 22:46:22,2010-09-10 22:46:22
fd1e4b81d9fb58010166135622c9be415c3b1e31...364583b8947dc7073445e3a8449bf021a80ca593,3,37,14,51,13,2010-09-10 22:56:56,2010-09-10 22:56:56
364583b8947dc7073445e3a8449bf021a80ca593...59129038524972fc423193d49ca6cd096189ec58,4,33,4,37,7,2010-09-10 23:30:46,2010-09-10 23:30:46
59129038524972fc423193d49ca6cd096189ec58...568b9cdf374e8c0261bc6d774cb912ad48076072,1,5,2,7,1,2010-09-10 23:56:10,2010-09-10 23:56:10
568b9cdf374e8c0261bc6d774cb912ad48076072...506d559876b80a1d9fe86b94573952be6a0b3d6d,1,11,8,19,4,2010-09-11 00:02:33,2010-09-11 00:02:33
506d559876b80a1d9fe86b94573952be6a0b3d6d...9802a73e254de90230f8c3574ec46e6761691ba7,2,4,0,4,2,2010-09-11 00:20:35,2010-09-11 00:20:35
9802a73e254de90230f8c3574ec46e6761691ba7...3444b065bae2261b66c6c757683c64f8e8fae532,2,50,1,51,4,2010-09-11 01:39:16,2010-09-11 01:39:16
3444b065bae2261b66c6c757683c64f8e8fae532...b2d2cb4a314e4d084d7d726752c93afb18c55b4e,2,16,7,23,5,2010-09-11 01:41:53,2010-09-11 01:41:53
b2d2cb4a314e4d084d7d726752c93afb18c55b4e...a56a226241f5808b2eaf1e4b5a155d35047b8a06,1,6,6,12,5,2010-09-11 02:02:20,2010-09-11 02:02:20
a56a226241f5808b2eaf1e4b5a155d35047b8a06...1efa80770382d4995c2d6e67972d8a99021ec81f,1,3,1,4,3,2010-09-11 02:28:16,2010-09-11 02:28:16
1efa80770382d4995c2d6e67972d8a99021ec81f...04f50c1f281e1864576dc6ff5f4d89b562f82b6d,4,45,17,62,12,2010-09-11 03:01:07,2010-09-11 03:01:07
04f50c1f281e1864576dc6ff5f4d89b562f82b6d...fffe0a00a383f46fdfb8de44d56f8ae2e2ee09de,5,63,2,65,9,2010-09-11 03:13:23,2010-09-11 03:13:23
fffe0a00a383f46fdfb8de44d56f8ae2e2ee09de...9e04c3b7444ba136efa03896a67e46d2e7045e28,3,16,4,20,6,2010-09-11 18:34:40,2010-09-11 18:34:40
9e04c3b7444ba136efa03896a67e46d2e7045e28...4311402216f92047a4586990f989b39d698e73a8,2,20,0,20,2,2010-09-11 21:26:19,2010-09-11 21:26:19
4311402216f92047a4586990f989b39d698e73a8...f6074506fdf303268671de94f93cbc6315da4e34,1,101,108,209,3,2010-09-12 01:40:42,2010-09-12 01:40:42
f6074506fdf303268671de94f93cbc6315da4e34...553374b55d21a0c6c477448a6ccadbf9246c9fe4,2,4,2,6,2,2010-09-12 02:07:04,2010-09-12 02:07:04
553374b55d21a0c6c477448a6ccadbf9246c9fe4...5501238bc0fcc1dc0138b20b0cafd6fe6a0d4cb7,1,1,2,3,2,2010-09-12 06:37:39,2010-09-12 06:37:39
5501238bc0fcc1dc0138b20b0cafd6fe6a0d4cb7...bfbc259de0813cd2d1c29755994de3bbf77551fe,2,71,65,136,2,2010-09-12 18:43:06,2010-09-12 18:43:06
bfbc259de0813cd2d1c29755994de3bbf77551fe...fc26da645aea2361d78cf5a5543214a240d82527,10,167,10,177,32,2010-09-12 18:45:26,2010-09-12 18:45:26
fc26da645aea2361d78cf5a5543214a240d82527...4323c228cc777e823c2d212858c333fbbc8766ad,1,1,1,2,1,2010-09-12 19:20:58,2010-09-12 19:20:58
4323c228cc777e823c2d212858c333fbbc8766ad...882cba0f69b1d2c0748b96315b34e3809aa59869,6,76,5,81,9,2010-09-12 19:27:33,2010-09-12 19:27:33
882cba0f69b1d2c0748b96315b34e3809aa59869...7bb6abed129015ad447bd78506698f34c4d8273b,4,19,19,38,5,2010-09-12 19:40:44,2010-09-12 19:40:44
7bb6abed129015ad447bd78506698f34c4d8273b...030c97b119bea450cc4e1f289a95e91aa664221c,3,39,3,42,4,2010-09-12 19:44:19,2010-09-12 19:44:19
030c97b119bea450cc4e1f289a95e91aa664221c...b7f60045fe9e662c8c53a6f7b4e2c410830d5b29,4,66,4,70,17,2010-09-12 19:58:05,2010-09-12 19:58:05
b7f60045fe9e662c8c53a6f7b4e2c410830d5b29...ca90d158d2a70e52f3b208a2e16fe8bafe878dd2,2,71,48,119,2,2010-09-12 20:02:57,2010-09-12 20:02:57
ca90d158d2a70e52f3b208a2e16fe8bafe878dd2...b26f1d4664ab76d562789d096897c0ce69faa732,2,42,23,65,3,2010-09-12 20:03:03,2010-09-12 20:03:03
b26f1d4664ab76d562789d096897c0ce69faa732...1d50f6af99679c5665a4e9996febdf527b78c46f,3,184,135,319,3,2010-09-12 20:03:12,2010-09-12 20:03:12
1d50f6af99679c5665a4e9996febdf527b78c46f...eb8b5dc2d4160b76c5a70ca732e56293d8f43729,2,138,163,301,3,2010-09-12 20:03:20,2010-09-12 20:03:20
eb8b5dc2d4160b76c5a70ca732e56293d8f43729...3fe5c6194ce9086b64b9d6a4d2c672c071b50486,2,135,165,300,2,2010-09-12 20:03:28,2010-09-12 20:03:28
3fe5c6194ce9086b64b9d6a4d2c672c071b50486...521be8cd9cc1092c242d505b8b6e1bb7911d4095,4,34,47,81,10,2010-09-12 20:03:39,2010-09-12 20:03:39
521be8cd9cc1092c242d505b8b6e1bb7911d4095...e2e1802e48b4cfc39c57b46975fc7b316a184db8,3,63,63,126,13,2010-09-12 20:03:48,2010-09-12 20:03:48
e2e1802e48b4cfc39c57b46975fc7b316a184db8...a45c687ecfd2acd490a5ac0b34595622f78b97a9,2,102,122,224,4,2010-09-12 20:03:55,2010-09-12 20:03:55
a45c687ecfd2acd490a5ac0b34595622f78b97a9...f1f86e01731b81e11a7279e42fbc8cfe158069f1,2,38,51,89,2,2010-09-12 20:04:04,2010-09-12 20:04:04
f1f86e01731b81e11a7279e42fbc8cfe158069f1...14a5e62f86d26991476e8dfb3541797d68369e5f,2,53,49,102,2,2010-09-12 20:04:12,2010-09-12 20:04:12
14a5e62f86d26991476e8dfb3541797d68369e5f...19bd2b6f028f766e68ff4a26a1bc27be77ad71be,2,80,73,153,2,2010-09-12 20:04:21,2010-09-12 20:04:21
19bd2b6f028f766e68ff4a26a1bc27be77ad71be...4d77fee299f1cc30d34396c58732faeb359d4bb3,2,52,62,114,2,2010-09-12 20:04:30,2010-09-12 20:04:30
4d77fee299f1cc30d34396c58732faeb359d4bb3...5874b11e4da1157b10bc04c9f09689b8017193d2,2,75,44,119,2,2010-09-12 20:04:38,2010-09-12 20:04:38
5874b11e4da1157b10bc04c9f09689b8017193d2...935aa4c6a1fbd35c20d14b5433fde20cab953896,3,43,37,80,7,2010-09-12 20:04:48,2010-09-12 20:04:48
935aa4c6a1fbd35c20d14b5433fde20cab953896...21e7987c4c2db100c816ec67a2159a3991011f83,2,84,49,133,2,2010-09-12 20:04:57,2010-09-12 20:04:57
21e7987c4c2db100c816ec67a2159a3991011f83...45651dcb05a863f87a440a895544736b5e8ba10a,2,16,15,31,3,2010-09-12 20:05:07,2010-09-12 20:05:07
45651dcb05a863f87a440a895544736b5e8ba10a...93cda768eed0f0c4ec9b53e5820ce94caaa463f9,2,218,105,323,2,2010-09-12 20:05:17,2010-09-12 20:05:17
93cda768eed0f0c4ec9b53e5820ce94caaa463f9...7c075440ea3fb082b9b081a3c1b20b2b62e0e4dc,2,41,0,41,2,2010-09-12 20:34:11,2010-09-12 20:34:11
7c075440ea3fb082b9b081a3c1b20b2b62e0e4dc...2d4da641a6ee6c96f38336d8dc6786c07e7b3a1f,3,55,5,60,9,2010-09-12 20:52:49,2010-09-12 20:52:49
2d4da641a6ee6c96f38336d8dc6786c07e7b3a1f...720299053a045e73f38152296311f872b48367a8,1,37,5,42,7,2010-09-12 21:53:35,2010-09-12 21:53:35
720299053a045e73f38152296311f872b48367a8...1e7b2f5a06885efe5d4436498ace4272c562f16a,1,2,2,4,2,2010-09-12 22:03:44,2010-09-12 22:03:44
1e7b2f5a06885efe5d4436498ace4272c562f16a...631bb7d0f6f4160b8d4034392f5f1e1b31490aae,1,12,0,12,1,2010-09-12 22:27:59,2010-09-12 22:27:59
631bb7d0f6f4160b8d4034392f5f1e1b31490aae...4084bc735437e7a2e2a09cff469788e036080203,5,19,4,23,8,2010-09-12 22:38:01,2010-09-12 22:38:01
4084bc735437e7a2e2a09cff469788e036080203...17a79d503302f3aad5e2439d858d6e3cbba102e4,2,7,5,12,6,2010-09-13 05:08:10,2010-09-13 05:08:10
17a79d503302f3aad5e2439d858d6e3cbba102e4...767cf13d7654b92ce398bb142a908b3e0c461564,1,2,0,2,1,2010-09-13 05:08:17,2010-09-13 05:08:17
767cf13d7654b92ce398bb142a908b3e0c461564...3d99526fc2b6b6d25d889ce206ea26c7036944b8,2,4,4,8,4,2010-09-13 05:08:21,2010-09-13 05:08:21
3d99526fc2b6b6d25d889ce206ea26c7036944b8...783656cf5ba0e38fb0bf915019e6a720d47a9baf,1,5,1,6,1,2010-09-13 05:08:24,2010-09-13 05:08:24
783656cf5ba0e38fb0bf915019e6a720d47a9baf...050aa57990a5ce7ad92c089705d328f415df097b,3,22,20,42,3,2010-09-13 05:28:01,2010-09-13 05:28:01
050aa57990a5ce7ad92c089705d328f415df097b...268123e78491318bb864eba953b0e0290f69236b,2,67,57,124,3,2010-09-13 05:28:10,2010-09-13 05:28:10
268123e78491318bb864eba953b0e0290f69236b...a60948cef21fb7148048310f92b8a7961dedc688,2,39,30,69,5,2010-09-13 05:28:18,2010-09-13 05:28:18
a60948cef21fb7148048310f92b8a7961dedc688...6948b280c77bea23df3d3471f454065b0d7be5ab,2,156,135,291,2,2010-09-13 05:28:29,2010-09-13 05:28:29
6948b280c77bea23df3d3471f454065b0d7be5ab...2055fdbe97ab421c2a732f450e76bcc5b84aa62a,2,24,20,44,2,2010-09-13 05:28:38,2010-09-13 05:28:38
2055fdbe97ab421c2a732f450e76bcc5b84aa62a...4f48f25b2959a7687cb5ffea57cd6ded00ba4649,2,167,131,298,2,2010-09-13 05:28:47,2010-09-13 05:28:47
4f48f25b2959a7687cb5ffea57cd6ded00ba4649...1080937a623227a6e961b3718ec929bd972a4367,2,49,31,80,2,2010-09-13 05:28:59,2010-09-13 05:28:59
1080937a623227a6e961b3718ec929bd972a4367...b7cd1682f5b58bf0f4bb7af3055d5a4f26fd60b2,2,49,30,79,2,2010-09-13 05:29:09,2010-09-13 05:29:09
b7cd1682f5b58bf0f4bb7af3055d5a4f26fd60b2...17c097b166ea3d16d385eed5c29ae7e2844a2f09,2,315,229,544,2,2010-09-13 05:29:21,2010-09-13 05:29:21
17c097b166ea3d16d385eed5c29ae7e2844a2f09...6302647647ea46fc66ce55271157c163fc57db15,1,2,2,4,2,2010-09-13 18:39:16,2010-09-13 18:39:16
6302647647ea46fc66ce55271157c163fc57db15...4df57fb9168f835c7964e24e94f60980a5abcda4,1,4,4,8,1,2010-09-13 21:44:21,2010-09-13 21:44:21
4df57fb9168f835c7964e24e94f60980a5abcda4...3f9054dd777a80cb6ccba0abcad8e2b43537c123,2,15,0,15,2,2010-09-13 22:31:17,2010-09-13 22:31:17
3f9054dd777a80cb6ccba0abcad8e2b43537c123...76366aab18a0308f1465feb6236bff9e2907e570,1,4,0,4,2,2010-09-13 22:47:20,2010-09-13 22:47:20
76366aab18a0308f1465feb6236bff9e2907e570...6fb4f6e2996cf442b614a073f30839419d9db030,4,32,5,37,6,2010-09-13 23:01:34,2010-09-13 23:01:34
6fb4f6e2996cf442b614a073f30839419d9db030...86031bf59d8dfb0972c064bb5e20da162e510c20,3,9,0,9,6,2010-09-13 23:09:56,2010-09-13 23:09:56
86031bf59d8dfb0972c064bb5e20da162e510c20...3c19671711a6ba54258feafb604446bcd64e6154,1,138,4,142,7,2010-09-13 23:15:06,2010-09-13 23:15:06
3c19671711a6ba54258feafb604446bcd64e6154...34a4af50be5c8a9ddf147b8c1315f8f227590e1e,7,12,11,23,9,2010-09-14 14:22:35,2010-09-14 14:22:35
34a4af50be5c8a9ddf147b8c1315f8f227590e1e...763bcf8472e61ba09cc739086bb181822501efa4,1,0,1,1,1,2010-09-14 21:40:23,2010-09-14 21:40:23
763bcf8472e61ba09cc739086bb181822501efa4...320c46999c44efdc31be9cc80d3a2d1bf5186f18,4,49,2,51,5,2010-09-16 19:53:41,2010-09-16 19:53:41
320c46999c44efdc31be9cc80d3a2d1bf5186f18...11aee35a9fb72c470364a93186823a327d6840bb,4,442,244,686,13,2010-09-19 14:04:34,2010-09-19 14:04:34
11aee35a9fb72c470364a93186823a327d6840bb...9d6eeeec39f834ad480778ba7aa4ece01c6f7aff,2,15,2,17,4,2010-09-21 19:32:22,2010-09-21 19:32:22
9d6eeeec39f834ad480778ba7aa4ece01c6f7aff...e2ff11c6a365e5c96d1157876d4bc01ed5ecb8da,2,47,42,89,2,2010-09-26 09:55:41,2010-09-26 09:55:41
e2ff11c6a365e5c96d1157876d4bc01ed5ecb8da...a686096c262b706b1367abc87436ae9dc47dbe2a,3,9,4,13,6,2010-09-26 15:10:41,2010-09-26 15:10:41
a686096c262b706b1367abc87436ae9dc47dbe2a...94096e83e9314d960599d4d4773fe4a6329bd321,2,35,1,36,3,2010-09-26 20:44:56,2010-09-26 20:44:56
94096e83e9314d960599d4d4773fe4a6329bd321...2c9f0b75fb05fdc50fdff45b9274d54384cdd983,1,4,0,4,1,2010-09-26 20:52:36,2010-09-26 20:52:36
2c9f0b75fb05fdc50fdff45b9274d54384cdd983...d8d38ec6e7b4315a1187f142bde4a7ca33edbd18,1,2,1,3,2,2010-09-26 20:55:58,2010-09-26 20:55:58
d8d38ec6e7b4315a1187f142bde4a7ca33edbd18...1df1378f9e6e71588f45624c4ddf9e5d37cc875a,11,16,20,36,14,2010-09-26 21:36:22,2010-09-26 21:36:22
1df1378f9e6e71588f45624c4ddf9e5d37cc875a...efac677add479a61778c2ac336dea98fa1d5440b,1,0,1,1,1,2010-09-26 22:59:44,2010-09-26 22:59:44
efac677add479a61778c2ac336dea98fa1d5440b...ea07fe7a3ff964bc2899a9b6e85bc86a0a4ac35b,1,1,1,2,1,2010-09-27 00:20:42,2010-09-27 00:20:42
ea07fe7a3ff964bc2899a9b6e85bc86a0a4ac35b...856a9e953bd09de178648f5d0e7e6e7a8af2e0b5,2,21,22,43,4,2010-09-27 15:11:03,2010-09-27 15:11:03
856a9e953bd09de178648f5d0e7e6e7a8af2e0b5...5ec1f0e1501e09899b1fc39088bf69d8e40d0c1b,2,39,36,75,2,2010-09-27 15:11:29,2010-09-27 15:11:29
5ec1f0e1501e09899b1fc39088bf69d8e40d0c1b...09cdfda2499e5e38b4cbf62c928a7586ee534bdf,2,54,53,107,3,2010-09-27 15:11:55,2010-09-27 15:11:55
09cdfda2499e5e38b4cbf62c928a7586ee534bdf...d11dfcf6786cb03dee0f8ee7fc63cf8e39913edd,2,232,220,452,7,2010-09-27 15:12:22,2010-09-27 15:12:22
d11dfcf6786cb03dee0f8ee7fc63cf8e39913edd...cd9aed5b2ddd6f44067cca3231bb68b825159ee8,2,39,40,79,2,2010-09-27 15:12:48,2010-09-27 15:12:48
cd9aed5b2ddd6f44067cca3231bb68b825159ee8...2d3b47183a089cf6620da90a6cb7cd1c3025a7e0,3,86,65,151,4,2010-09-27 15:13:17,2010-09-27 15:13:17
2d3b47183a089cf6620da90a6cb7cd1c3025a7e0...474bd8648b47193132debca4339b174281208da8,2,84,94,178,3,2010-09-27 15:13:43,2010-09-27 15:13:43
474bd8648b47193132debca4339b174281208da8...60e38d29ca37d3752c4d537811af5cbf6a8ab3af,1,16,28,44,3,2010-09-27 15:14:06,2010-09-27 15:14:06
60e38d29ca37d3752c4d537811af5cbf6a8ab3af...b4a8c77e7c4035f0ecc2151835bf5ceb0be2f392,1,42,44,86,1,2010-09-27 15:14:30,2010-09-27 15:14:30
b4a8c77e7c4035f0ecc2151835bf5ceb0be2f392...ba53cd30d1427dbbd564b1791ef6348db93cf37f,5,243,250,493,7,2010-09-27 15:15:04,2010-09-27 15:15:04
ba53cd30d1427dbbd564b1791ef6348db93cf37f...9abfd55a29d00397e6c5d14cc86fccc342715a09,1,98,88,186,11,2010-09-27 15:15:33,2010-09-27 15:15:33
9abfd55a29d00397e6c5d14cc86fccc342715a09...082c5d2ae3d87008e6d7091524f5a421a6010e29,1,66,51,117,2,2010-09-27 15:15:58,2010-09-27 15:15:58
082c5d2ae3d87008e6d7091524f5a421a6010e29...110c247e8b8963158ad5abc095b45a8114d62536,1,4,1,5,1,2010-09-27 15:16:20,2010-09-27 15:16:20
110c247e8b8963158ad5abc095b45a8114d62536...36ac6f1fb97fc2c8285df1168ba9867ab02b994a,1,22,14,36,3,2010-09-27 15:16:46,2010-09-27 15:16:46
36ac6f1fb97fc2c8285df1168ba9867ab02b994a...1bcde8d6b451ffdd0271b7e1c100026b8501670a,1,80,63,143,1,2010-09-27 15:17:08,2010-09-27 15:17:08
1bcde8d6b451ffdd0271b7e1c100026b8501670a...6b5a240d50e83a0aef8c74d7423cc4e5178d357f,2,78,64,142,2,2010-09-27 15:17:36,2010-09-27 15:17:36
6b5a240d50e83a0aef8c74d7423cc4e5178d357f...16bba1294b8d58f6f69b7683532f19980adc4949,2,96,75,171,3,2010-09-27 15:18:03,2010-09-27 15:18:03
16bba1294b8d58f6f69b7683532f19980adc4949...9c402f0ecc3751a746cc0aeaa24b7b8320af70f7,1,1,0,1,1,2010-09-27 15:18:21,2010-09-27 15:18:21
9c402f0ecc3751a746cc0aeaa24b7b8320af70f7...534792d05591eb2d19dc48ee89dcd2d9b5d461c0,8,83,34,117,19,2010-09-27 15:25:08,2010-09-27 15:25:08
534792d05591eb2d19dc48ee89dcd2d9b5d461c0...bf8c93f2cf4a0b020760f1ad059e9d1e053e48ad,2,42,32,74,24,2010-09-27 15:25:38,2010-09-27 15:25:38
bf8c93f2cf4a0b020760f1ad059e9d1e053e48ad...45d348fdd9c558ec8ba7a32127f29a9f61b4aba4,4,47,22,69,25,2010-09-27 15:51:20,2010-09-27 15:51:20
45d348fdd9c558ec8ba7a32127f29a9f61b4aba4...d80d2e8103a5d8a96863cebf433d61afa45e319e,2,19,9,28,15,2010-09-27 16:21:16,2010-09-27 16:21:16
d80d2e8103a5d8a96863cebf433d61afa45e319e...1637fefcb04a219a7fa0517db7d29e3cd7cb214e,1,13,2,15,3,2010-09-28 04:35:50,2010-09-28 04:35:50
1637fefcb04a219a7fa0517db7d29e3cd7cb214e...4747fe27a0bf1bfcba52f86c47c1d96a1b5c3890,1,0,2,2,1,2010-09-28 04:48:43,2010-09-28 04:48:43
4747fe27a0bf1bfcba52f86c47c1d96a1b5c3890...30228b6459ce07bbaca554dfb4f2217da29e4667,2,134,123,257,2,2010-09-28 07:05:51,2010-09-28 07:05:51
30228b6459ce07bbaca554dfb4f2217da29e4667...891bc66d55606e93f414e70cd017336d7718fc6a,2,36,42,78,4,2010-09-28 07:06:15,2010-09-28 07:06:15
891bc66d55606e93f414e70cd017336d7718fc6a...d63ee2097f4d0f0094e8e472de2236558e98a348,1,84,73,157,9,2010-09-28 07:06:37,2010-09-28 07:06:37
d63ee2097f4d0f0094e8e472de2236558e98a348...1c09aca6670321b097e1a7b83dc597f7fe4a6933,2,114,107,221,7,2010-09-28 08:16:23,2010-09-28 08:16:23
1c09aca6670321b097e1a7b83dc597f7fe4a6933...974e8076c6835ada2634ccda3ab42d1b1820b4b5,2,69,57,126,2,2010-09-28 08:16:47,2010-09-28 08:16:47
974e8076c6835ada2634ccda3ab42d1b1820b4b5...d271566a7d621e7257fe22221b20f2b88ec5659e,2,39,37,76,2,2010-09-28 08:17:12,2010-09-28 08:17:12
d271566a7d621e7257fe22221b20f2b88ec5659e...67df1a5002f4cb136403f124d3db52d6fc805eb8,2,42,34,76,2,2010-09-28 08:17:36,2010-09-28 08:17:36
67df1a5002f4cb136403f124d3db52d6fc805eb8...ec3ba39fdb9dd6b82fb790a7babff5d2c4630ad5,13,31,30,61,31,2010-09-28 08:18:12,2010-09-28 08:18:12
ec3ba39fdb9dd6b82fb790a7babff5d2c4630ad5...3610a21a4214091ff7ed988e94ecde2a8982a23a,4,190,175,365,5,2010-09-28 08:18:39,2010-09-28 08:18:39
3610a21a4214091ff7ed988e94ecde2a8982a23a...d577648732c8d55b5d426e013dcd2a10a0b47f89,1,485,601,1086,3,2010-09-28 08:19:04,2010-09-28 08:19:04
d577648732c8d55b5d426e013dcd2a10a0b47f89...375466955366a12dcb769e7644ddf2f77d3b650f,4,93,96,189,5,2010-09-28 08:19:42,2010-09-28 08:19:42
375466955366a12dcb769e7644ddf2f77d3b650f...778cfe30419b3e444e6833656deac9769407a09c,0,0,0,0,0,2010-09-28 08:36:09,2010-09-28 08:36:09
778cfe30419b3e444e6833656deac9769407a09c...75536fef1ff56894e35dad221a4215ebe3917673,1,24,26,50,8,2010-09-28 11:54:58,2010-09-28 11:54:58
75536fef1ff56894e35dad221a4215ebe3917673...d0da38410bea1e9deadad9d6d1962ea7aadb2f84,2,197,127,324,4,2010-09-28 13:41:40,2010-09-28 13:41:40
d0da38410bea1e9deadad9d6d1962ea7aadb2f84...0856c765f51173d393a875cc174e303ea1d678ba,2,314,177,491,3,2010-09-28 13:42:09,2010-09-28 13:42:09
0856c765f51173d393a875cc174e303ea1d678ba...b24a55ca7956e35de8f94a52f910dafc0865ab09,3,594,220,814,34,2010-09-28 14:52:20,2010-09-28 14:52:20
b24a55ca7956e35de8f94a52f910dafc0865ab09...e5c41c79e06266bbb99bcfbfa0c6c01d4ee418b2,1,1,1,2,1,2010-09-28 15:07:42,2010-09-28 15:07:42
e5c41c79e06266bbb99bcfbfa0c6c01d4ee418b2...e2f55fbde66a5e50a0a8982c6fe399275ad8f617,1,11,4,15,1,2010-09-29 01:20:34,2010-09-29 01:20:34
e2f55fbde66a5e50a0a8982c6fe399275ad8f617...89ea98ca5666c0d42b3ab77fcc48f9636dde88f1,1,24,0,24,1,2010-09-29 16:35:34,2010-09-29 16:35:34
89ea98ca5666c0d42b3ab77fcc48f9636dde88f1...136bf00615c3dadd697e746185f5c35258aa418a,1,76,20,96,6,2010-09-29 17:56:27,2010-09-29 17:56:27
136bf00615c3dadd697e746185f5c35258aa418a...e77f16144b91c5079c7dcaef9ec3737b6f933e16,6,21,10,31,11,2010-10-01 02:00:52,2010-10-01 02:00:52
e77f16144b91c5079c7dcaef9ec3737b6f933e16...d69c7eab041d30c1cf8a4ee8d6426d47e90254b1,4,54,0,54,5,2010-10-01 02:01:20,2010-10-01 02:01:20
d69c7eab041d30c1cf8a4ee8d6426d47e90254b1...8e301812fa6349b410db44fd4d6fe1df388635c3,1,5,11,16,3,2010-10-01 02:01:38,2010-10-01 02:01:38
8e301812fa6349b410db44fd4d6fe1df388635c3...a64e96c227b36c701a86ded75d839b1cd2442713,2,6,1,7,3,2010-10-01 02:02:01,2010-10-01 02:02:01
a64e96c227b36c701a86ded75d839b1cd2442713...392d992f8295f96632179e01e790465cc9c8d3ec,17,357,30,387,34,2010-10-01 02:02:58,2010-10-01 02:02:58
392d992f8295f96632179e01e790465cc9c8d3ec...524b6bae294fe4f5623d3db222257129c42a02a0,1,2,2,4,2,2010-10-01 02:05:45,2010-10-01 02:05:45
524b6bae294fe4f5623d3db222257129c42a02a0...113b0bde6664f131db7191bf27089b3e2d6daa3a,1,0,3,3,1,2010-10-01 02:30:45,2010-10-01 02:30:45
113b0bde6664f131db7191bf27089b3e2d6daa3a...941e11e54d175f4ffc769852e5dd376ec1ba5239,2,4,0,4,2,2010-10-01 02:31:05,2010-10-01 02:31:05
941e11e54d175f4ffc769852e5dd376ec1ba5239...57456c59a61ea3b228b346eab57358b28474ee63,1,4,4,8,2,2010-10-02 13:13:59,2010-10-02 13:13:59
57456c59a61ea3b228b346eab57358b28474ee63...96c11b29bda6dab710925827f78445d92beaa5df,1,12,8,20,4,2010-10-02 13:56:09,2010-10-02 13:56:09
96c11b29bda6dab710925827f78445d92beaa5df...667d832e901ca6bb394054109e24a2ed6cadc563,13,223,123,346,59,2010-10-04 14:20:47,2010-10-04 14:20:47
667d832e901ca6bb394054109e24a2ed6cadc563...24acca413977422681ca16b42fe9a6d763df2121,19,1292,21,1313,54,2010-10-04 15:12:39,2010-10-04 15:12:39
24acca413977422681ca16b42fe9a6d763df2121...240f68e4e5a617c9efe728e91db67823bafa8005,2,20,16,36,17,2010-10-05 00:11:41,2010-10-05 00:11:41
240f68e4e5a617c9efe728e91db67823bafa8005...9e153a31eefa2d5e35d40977be75fe489d294ebb,1,1,1,2,1,2010-10-05 01:42:20,2010-10-05 01:42:20
9e153a31eefa2d5e35d40977be75fe489d294ebb...63d960ca2516753a1032d837d008f63a4786643d,1,1,1,2,1,2010-10-05 01:44:12,2010-10-05 01:44:12
63d960ca2516753a1032d837d008f63a4786643d...57aeb542792317df13c54eab7ceac73ceeb2847d,1,2,2,4,2,2010-10-06 14:57:31,2010-10-06 14:57:31
57aeb542792317df13c54eab7ceac73ceeb2847d...fea159282b75130b5f6cf52ec92ddfa09467f3c9,10,56,19,75,30,2010-10-06 15:02:26,2010-10-06 15:02:26
fea159282b75130b5f6cf52ec92ddfa09467f3c9...43cee77fb4be6f76a120f2d97ec5a73e17381df4,1,1,1,2,1,2010-10-06 17:30:37,2010-10-06 17:30:37
43cee77fb4be6f76a120f2d97ec5a73e17381df4...d405ec9b4d609550007b3c9d7b2abbdb702dff7b,1,3,3,6,2,2010-10-06 17:32:25,2010-10-06 17:32:25
d405ec9b4d609550007b3c9d7b2abbdb702dff7b...e3b95aa7c999374344f20d08d9de486068de619e,1,1,1,2,1,2010-10-06 21:10:44,2010-10-06 21:10:44
e3b95aa7c999374344f20d08d9de486068de619e...40765f1bdd6b4fc1a21ab38c2816a2fcc45618b0,1,2,2,4,2,2010-10-06 21:19:08,2010-10-06 21:19:08
40765f1bdd6b4fc1a21ab38c2816a2fcc45618b0...47cae1a2f6008382229b985f160846a7083726b6,1,2,0,2,1,2010-10-06 22:55:06,2010-10-06 22:55:06
47cae1a2f6008382229b985f160846a7083726b6...157583f9165a267f717ef9e429b1e6e2542683fb,1,1,2,3,2,2010-10-06 22:56:52,2010-10-06 22:56:52
157583f9165a267f717ef9e429b1e6e2542683fb...edd767d2612d891a906268cf590571f541dd164f,1,1,1,2,1,2010-10-07 15:13:00,2010-10-07 15:13:00
edd767d2612d891a906268cf590571f541dd164f...bf0947a4743ce7df748f6e78a3d6e7d9e4f6cf5d,2,5,0,5,2,2010-10-07 15:50:36,2010-10-07 15:50:36
bf0947a4743ce7df748f6e78a3d6e7d9e4f6cf5d...2faa490aeb142345daf7d75a40b8c73e1099f6d8,1,1,1,2,1,2010-10-07 22:30:38,2010-10-07 22:30:38
2faa490aeb142345daf7d75a40b8c73e1099f6d8...0aa438a3dff24a4e257a1190d2ba32893dfbc54d,3,45,5,50,10,2010-10-07 23:36:02,2010-10-07 23:36:02
0aa438a3dff24a4e257a1190d2ba32893dfbc54d...43b6b32945cee07c3f85f1a696fca12fcba6ee2f,1,1,1,2,1,2010-10-07 23:48:25,2010-10-07 23:48:25
43b6b32945cee07c3f85f1a696fca12fcba6ee2f...f53491db6e1aa1f19f627b60ff2bcd2ff40b128a,2,2,0,2,2,2010-10-08 13:50:54,2010-10-08 13:50:54
f53491db6e1aa1f19f627b60ff2bcd2ff40b128a...515b4d3aa82c6a6dcc5ac749b10434bafd6b646b,1,3,1,4,2,2010-10-08 13:56:54,2010-10-08 13:56:54
515b4d3aa82c6a6dcc5ac749b10434bafd6b646b...060701a26aa931c5ebbd05905c94c5d1ada05bb3,1,4,4,8,1,2010-10-08 14:13:44,2010-10-08 14:13:44
060701a26aa931c5ebbd05905c94c5d1ada05bb3...ed32170a0487cdf045b565cc971067504b79aaf0,2,40,6,46,7,2010-10-08 14:14:05,2010-10-08 14:14:05
ed32170a0487cdf045b565cc971067504b79aaf0...4d4d68a2cd8d93ce4bc4280b47051f294b280e73,3,32,0,32,3,2010-10-08 14:48:04,2010-10-08 14:48:04
4d4d68a2cd8d93ce4bc4280b47051f294b280e73...58b704d8da2347e1db6930c80eb117dea1684d72,3,114,5,119,11,2010-10-08 15:11:59,2010-10-08 15:11:59
58b704d8da2347e1db6930c80eb117dea1684d72...70e7e082fce39547b5bcca9a2a4044b008f1df4d,1,81,78,159,6,2010-10-08 15:33:11,2010-10-08 15:33:11
70e7e082fce39547b5bcca9a2a4044b008f1df4d...480c6c6958dbb6843a7effdd943700b63761c9df,1,1,1,2,1,2010-10-08 15:33:27,2010-10-08 15:33:27
480c6c6958dbb6843a7effdd943700b63761c9df...08beb148c86a0e465c57f89958b8913b10191097,1,5,6,11,4,2010-10-08 15:36:15,2010-10-08 15:36:15
08beb148c86a0e465c57f89958b8913b10191097...98c6ff3a2bd9f3878ef78a05691af0095ef86d2f,1,3,1,4,1,2010-10-08 15:36:48,2010-10-08 15:36:48
98c6ff3a2bd9f3878ef78a05691af0095ef86d2f...127a25ac270e8f8682a9a6ab1bef18e29a326384,6,10,10,20,10,2010-10-08 15:37:16,2010-10-08 15:37:16
127a25ac270e8f8682a9a6ab1bef18e29a326384...2b87347049eb0f20e26d6b41f076aa1ee6196132,1,1,1,2,1,2010-10-08 15:37:38,2010-10-08 15:37:38
2b87347049eb0f20e26d6b41f076aa1ee6196132...68efb0b0c16f902a426078dca96fe9e7dbf4c6f3,1,9,0,9,1,2010-10-08 15:37:59,2010-10-08 15:37:59
68efb0b0c16f902a426078dca96fe9e7dbf4c6f3...ae128aa28b3acf25a57bda92a67bdfabd5471812,1,10,10,20,3,2010-10-08 15:38:21,2010-10-08 15:38:21
ae128aa28b3acf25a57bda92a67bdfabd5471812...dbf23ef273ae6c8999cdaa9b6d81e98476d753db,3,29,7,36,8,2010-10-08 16:14:10,2010-10-08 16:14:10
dbf23ef273ae6c8999cdaa9b6d81e98476d753db...bca8aed4196219a29022d39f498dcb1b5de44ebb,1,7,7,14,7,2010-10-08 18:26:12,2010-10-08 18:26:12
bca8aed4196219a29022d39f498dcb1b5de44ebb...40777cb533d153a7772cb53fbcc05c642c6fb097,1,5,5,10,1,2010-10-08 20:30:02,2010-10-08 20:30:02
40777cb533d153a7772cb53fbcc05c642c6fb097...5c015854508bf5851c8b9bf5066586b084663246,2,12,1,13,3,2010-10-08 21:05:39,2010-10-08 21:05:39
5c015854508bf5851c8b9bf5066586b084663246...cdc6b0eb98710ffb0269c265b58feedcd6eece26,1,4,4,8,1,2010-10-08 21:10:57,2010-10-08 21:10:57
cdc6b0eb98710ffb0269c265b58feedcd6eece26...52f763d935e1fc3a6a471cc0393916333a9b6eab,1,10,0,10,1,2010-10-08 22:49:46,2010-10-08 22:49:46
52f763d935e1fc3a6a471cc0393916333a9b6eab...37023bc0bc55af53e356b5dfb87808787b723edb,2,12,1,13,3,2010-10-08 22:55:46,2010-10-08 22:55:46
37023bc0bc55af53e356b5dfb87808787b723edb...0f9eb912ffa015574ebb2d1fd6a2a78664a19039,1,1,0,1,1,2010-10-08 23:32:46,2010-10-08 23:32:46
0f9eb912ffa015574ebb2d1fd6a2a78664a19039...5c5f1cfe70227d3cb40bfee063df9e1421d07254,2,63,60,123,3,2010-10-08 23:47:11,2010-10-08 23:47:11
5c5f1cfe70227d3cb40bfee063df9e1421d07254...ccc43508e3d15c683d941f96c23e1e6ebd32ea5d,4,42,4,46,6,2010-10-08 23:54:43,2010-10-08 23:54:43
ccc43508e3d15c683d941f96c23e1e6ebd32ea5d...5b155e2a879faedc8f72b3756e20a77b79a209f4,2,13,1,14,3,2010-10-09 01:47:42,2010-10-09 01:47:42
5b155e2a879faedc8f72b3756e20a77b79a209f4...fa3335fa9f5af4b1ff3991b87ebac3449ceae6b2,1,9,0,9,1,2010-10-09 02:54:48,2010-10-09 02:54:48
fa3335fa9f5af4b1ff3991b87ebac3449ceae6b2...71a4c472ab908e3cfbfaf7ad224b87a04648cf12,2,20,9,29,7,2010-10-09 03:16:22,2010-10-09 03:16:22
71a4c472ab908e3cfbfaf7ad224b87a04648cf12...8755fb15494b587436dc7a144417b45b2ea16355,5,109,88,197,22,2010-10-09 03:34:08,2010-10-09 03:34:08
8755fb15494b587436dc7a144417b45b2ea16355...8058cc2e25295f54781a73fd250c0baa897cb02b,2,0,110,110,2,2010-10-09 03:58:32,2010-10-09 03:58:32
8058cc2e25295f54781a73fd250c0baa897cb02b...816c7d1e644f72563ee4a86582bb98ea3b1922e4,1,13,1,14,2,2010-10-09 04:01:37,2010-10-09 04:01:37
816c7d1e644f72563ee4a86582bb98ea3b1922e4...b7a73cf9296a2629a45d4b303c2b9207d3c71c40,3,41,1,42,4,2010-10-09 04:50:47,2010-10-09 04:50:47
b7a73cf9296a2629a45d4b303c2b9207d3c71c40...c93f5e5d0e530203048ddb6424ef43acabe17cf1,1,18,6,24,5,2010-10-09 05:08:42,2010-10-09 05:08:42
c93f5e5d0e530203048ddb6424ef43acabe17cf1...80aa4432e64794bb67ce8dd6cd3e570841a901c3,2,2,8,10,5,2010-10-09 06:06:24,2010-10-09 06:06:24
80aa4432e64794bb67ce8dd6cd3e570841a901c3...8e78a309c6de6c2e1ee2c642140e0d9e23ac26d8,1,7,3,10,3,2010-10-09 07:27:19,2010-10-09 07:27:19
8e78a309c6de6c2e1ee2c642140e0d9e23ac26d8...307e71a734a0542020c87f4589df7a182ee29606,1,2,2,4,2,2010-10-09 07:35:46,2010-10-09 07:35:46
307e71a734a0542020c87f4589df7a182ee29606...d81faf356c53c0cf099d48551e1d3982135f2db9,4,44,46,90,34,2010-10-09 07:45:52,2010-10-09 07:45:52
d81faf356c53c0cf099d48551e1d3982135f2db9...2cadc6b10aea168a3da33313e279d56950650b39,1,1,1,2,1,2010-10-09 07:53:17,2010-10-09 07:53:17
2cadc6b10aea168a3da33313e279d56950650b39...a904e55859470944c006d87665074e3574da7b52,60,92,92,184,90,2010-10-09 08:12:50,2010-10-09 08:12:50
a904e55859470944c006d87665074e3574da7b52...cf9249746a79ccaab54196ab9ccd2a83bfc45e0e,1,10,5,15,4,2010-10-09 08:20:56,2010-10-09 08:20:56
cf9249746a79ccaab54196ab9ccd2a83bfc45e0e...6400026feb034056c0d0badcadd61804f94d8afb,1,25,0,25,1,2010-10-09 10:00:13,2010-10-09 10:00:13
6400026feb034056c0d0badcadd61804f94d8afb...05001056a861419e2dc112a0395602e5a04f979f,1,5,1,6,1,2010-10-09 10:21:55,2010-10-09 10:21:55
05001056a861419e2dc112a0395602e5a04f979f...03e7d64de48dd1622e90c6d5fc0cd6abe25f0be8,1,2,1,3,2,2010-10-09 14:36:18,2010-10-09 14:36:18
03e7d64de48dd1622e90c6d5fc0cd6abe25f0be8...18c3ea5546566e8fe1471ea87942b2864040452d,1,134,21,155,8,2010-10-09 14:44:54,2010-10-09 14:44:54
18c3ea5546566e8fe1471ea87942b2864040452d...2314fadabe00796ecb0d9ebd7a950f58a675db68,2,254,169,423,3,2010-10-09 16:26:48,2010-10-09 16:26:48
2314fadabe00796ecb0d9ebd7a950f58a675db68...560fedde4cf26eac23d393ab6a64a1ad6d8513bd,2,8,2,10,3,2010-10-09 16:45:58,2010-10-09 16:45:58
560fedde4cf26eac23d393ab6a64a1ad6d8513bd...3234c7a1237535d6928f58e3b717bc94c88fcf66,1,5,0,5,1,2010-10-09 16:51:34,2010-10-09 16:51:34
3234c7a1237535d6928f58e3b717bc94c88fcf66...1b090bd0f9442058eea0e68fd4b4038f4b87f1f0,1,0,3,3,3,2010-10-09 17:14:45,2010-10-09 17:14:45
1b090bd0f9442058eea0e68fd4b4038f4b87f1f0...ed975755d2afa24f11fe01137f49055f14d2fcd9,1,5,1,6,1,2010-10-09 17:32:20,2010-10-09 17:32:20
ed975755d2afa24f11fe01137f49055f14d2fcd9...1fe1af93a51f10be832704ec96efc8e2ba277b3e,2,19,0,19,3,2010-10-09 20:07:48,2010-10-09 20:07:48
1fe1af93a51f10be832704ec96efc8e2ba277b3e...16089ba1352cd80b33b23e1bddb4d4ea4ed5c18a,2,156,113,269,4,2010-10-09 21:55:15,2010-10-09 21:55:15
16089ba1352cd80b33b23e1bddb4d4ea4ed5c18a...b61cafb146a574893138630c4d289757c21eb86b,1,1,1,2,1,2010-10-09 22:38:51,2010-10-09 22:38:51
b61cafb146a574893138630c4d289757c21eb86b...41551a027470f0b73ba42ed0426604a605c80634,1,8,4,12,3,2010-10-09 23:04:49,2010-10-09 23:04:49
41551a027470f0b73ba42ed0426604a605c80634...f3429da6a06c43dd86fbda45c120e96986cb6daa,2,53,42,95,3,2010-10-10 01:06:42,2010-10-10 01:06:42
f3429da6a06c43dd86fbda45c120e96986cb6daa...05d438bdd94743c0c70a2d33b4f953d660ba131d,1,15,14,29,5,2010-10-10 01:06:56,2010-10-10 01:06:56
05d438bdd94743c0c70a2d33b4f953d660ba131d...d084439c415e2037a1d13b217b044fd1bf3b39cb,3,32,2,34,4,2010-10-10 01:57:56,2010-10-10 01:57:56
d084439c415e2037a1d13b217b044fd1bf3b39cb...501546df6f4cbb56ea94da073e8206804fef3040,7,76,26,102,18,2010-10-10 02:16:33,2010-10-10 02:16:33
501546df6f4cbb56ea94da073e8206804fef3040...8c962169d08eec581b272571c012d98d5de07fb7,1,1,1,2,1,2010-10-10 02:24:34,2010-10-10 02:24:34
8c962169d08eec581b272571c012d98d5de07fb7...06bad9e37ef736068e58cb51535e387fb890cdcf,1,6,0,6,1,2010-10-10 06:06:38,2010-10-10 06:06:38
06bad9e37ef736068e58cb51535e387fb890cdcf...888168003a78577290094d3c0f290fe87f18342e,1,10,5,15,2,2010-10-10 06:36:38,2010-10-10 06:36:38
888168003a78577290094d3c0f290fe87f18342e...876013dc1205335bd6396e68fb9f8953b971fb73,2,8,5,13,4,2010-10-10 07:08:35,2010-10-10 07:08:35
876013dc1205335bd6396e68fb9f8953b971fb73...ace6519fae94c83aaaee0e6ce04d3bdded1b91d5,1,6,2,8,1,2010-10-10 07:58:50,2010-10-10 07:58:50
ace6519fae94c83aaaee0e6ce04d3bdded1b91d5...2f17dd3dd0fdcecf179375af32983a952bd7dfd9,2,9,1,10,2,2010-10-10 08:04:14,2010-10-10 08:04:14
2f17dd3dd0fdcecf179375af32983a952bd7dfd9...fc4ed4fafdef788ec32f126a9326302592a88a4b,2,13,1,14,3,2010-10-10 09:35:06,2010-10-10 09:35:06
fc4ed4fafdef788ec32f126a9326302592a88a4b...941318fcee26cd2965e76191afd670c2bdd7fe82,1,38,4,42,10,2010-10-10 09:39:14,2010-10-10 09:39:14
941318fcee26cd2965e76191afd670c2bdd7fe82...c236d5e44d88c9435f55fe374a118a97886c4711,5,17,11,28,7,2010-10-10 09:57:23,2010-10-10 09:57:23
c236d5e44d88c9435f55fe374a118a97886c4711...b12c7391430400d5e4b71207b31150fdc6cb07cb,5,79,4,83,8,2010-10-10 16:38:28,2010-10-10 16:38:28
b12c7391430400d5e4b71207b31150fdc6cb07cb...791cc62d4c8f5627b5616a50ab9d91d59cd601e9,1,2,3,5,3,2010-10-10 17:54:20,2010-10-10 17:54:20
791cc62d4c8f5627b5616a50ab9d91d59cd601e9...87b748b3bbaf15ec3c38f18d682e5bc12e0f5c79,1,1,1,2,1,2010-10-10 17:56:39,2010-10-10 17:56:39
87b748b3bbaf15ec3c38f18d682e5bc12e0f5c79...2623f2b74473f38df0e52c7e8ad7dc189f5cabaa,1,1,1,2,1,2010-10-10 18:15:16,2010-10-10 18:15:16
2623f2b74473f38df0e52c7e8ad7dc189f5cabaa...20fa9ddb7183707d707a8c703b6f28b02efc80db,2,152,135,287,7,2010-10-10 18:23:39,2010-10-10 18:23:39
20fa9ddb7183707d707a8c703b6f28b02efc80db...b79daef8676df78fabb70a686374aebeccdd6db0,11,2,0,2,1,2010-10-10 22:19:01,2010-10-10 22:19:01
b79daef8676df78fabb70a686374aebeccdd6db0...548b6c7e691fc3a50072e9405d3b68d9e50ebd9f,1,3,3,6,3,2010-10-10 22:40:54,2010-10-10 22:40:54
548b6c7e691fc3a50072e9405d3b68d9e50ebd9f...5e5be2c44caaae3192a9f8ae1ce0adc0da3d8c4d,1,1,1,2,1,2010-10-11 03:39:02,2010-10-11 03:39:02
5e5be2c44caaae3192a9f8ae1ce0adc0da3d8c4d...1070c57b83efdfd4fbed09280fcdaafc6d9c1a81,36,97,145,242,66,2010-10-11 12:20:07,2010-10-11 12:20:07
1070c57b83efdfd4fbed09280fcdaafc6d9c1a81...121d2e36785dc0ce8e7d1c48883fc7b719b21afc,106,3867,1046,4913,474,2010-10-11 12:55:17,2010-10-11 12:55:17
121d2e36785dc0ce8e7d1c48883fc7b719b21afc...5e319f5194656849f1660c5d6ff2df695ed13c75,2,61,0,61,2,2010-10-11 13:18:00,2010-10-11 13:18:00
5e319f5194656849f1660c5d6ff2df695ed13c75...e0ec458360527e07ccd0c0b266b188d9872de252,6,46,18,64,19,2010-10-11 14:34:42,2010-10-11 14:34:42
e0ec458360527e07ccd0c0b266b188d9872de252...e01bce1bfb8c3f3e110494c2db722d96ebd13a84,1,343,444,787,2,2010-10-11 15:11:55,2010-10-11 15:11:55
e01bce1bfb8c3f3e110494c2db722d96ebd13a84...3879c5907454e14dd0128ef33c927580c0fe383c,2,43,24,67,6,2010-10-11 17:41:44,2010-10-11 17:41:44
3879c5907454e14dd0128ef33c927580c0fe383c...39595a9e0ea85edfea9bca7db2cf4416beb3374d,2,138,64,202,3,2010-10-11 18:17:37,2010-10-11 18:17:37
39595a9e0ea85edfea9bca7db2cf4416beb3374d...f85f79eb4aeb9cb1af5e66f457756768c50ee90f,1,3,3,6,2,2010-10-11 19:19:01,2010-10-11 19:19:01
f85f79eb4aeb9cb1af5e66f457756768c50ee90f...c4cbbb25a2cfc0c5b557e20880eff2e21cfe0714,1,3,3,6,1,2010-10-11 19:48:15,2010-10-11 19:48:15
c4cbbb25a2cfc0c5b557e20880eff2e21cfe0714...dd22150b5f87e38a5f343e36a5864ad25c84d8f1,1,3,3,6,2,2010-10-11 20:34:16,2010-10-11 20:34:16
dd22150b5f87e38a5f343e36a5864ad25c84d8f1...103a20144954b95f29e5a4124cb32cace69b0421,2,133,164,297,3,2010-10-11 20:38:12,2010-10-11 20:38:12
103a20144954b95f29e5a4124cb32cace69b0421...2ed554bd92ded3f2391dbf074396c8a63319c575,1,7,1,8,3,2010-10-11 21:57:25,2010-10-11 21:57:25
2ed554bd92ded3f2391dbf074396c8a63319c575...d7397370153b2b0766bb8e405b3c3299cc3835f8,2,22,2,24,3,2010-10-11 22:27:45,2010-10-11 22:27:45
d7397370153b2b0766bb8e405b3c3299cc3835f8...6ddfe269324ab4220b9e20ea86b6cc0197ab1fc2,7,219,0,219,8,2010-10-11 23:35:23,2010-10-11 23:35:23
6ddfe269324ab4220b9e20ea86b6cc0197ab1fc2...3e0505459bf2166a53db67387d3582707eebb2f9,1,46,43,89,3,2010-10-11 23:50:59,2010-10-11 23:50:59
3e0505459bf2166a53db67387d3582707eebb2f9...fbc1fca834e8a53aee888d9970a87ff0b623ee0f,1,1,1,2,1,2010-10-11 23:57:03,2010-10-11 23:57:03
fbc1fca834e8a53aee888d9970a87ff0b623ee0f...539af4deeceeda5c60265c9c2e107722a9ae0d28,4,45,62,107,3,2010-10-12 00:14:49,2010-10-12 00:14:49
539af4deeceeda5c60265c9c2e107722a9ae0d28...cdfbe796742a93aed1094db82450c6faefe5cf65,2,22,19,41,4,2010-10-12 00:55:05,2010-10-12 00:55:05
cdfbe796742a93aed1094db82450c6faefe5cf65...c830dbe39fe078e910291c855c97baabc74953d2,2,20,19,39,2,2010-10-12 00:55:31,2010-10-12 00:55:31
c830dbe39fe078e910291c855c97baabc74953d2...0ef3e86eef23aea0d2e82e115139d913a8c092cc,2,84,105,189,2,2010-10-12 00:55:55,2010-10-12 00:55:55
0ef3e86eef23aea0d2e82e115139d913a8c092cc...77ec3ce0c4dfdf41056a309e95a7647678436ad8,2,119,147,266,2,2010-10-12 00:56:19,2010-10-12 00:56:19
77ec3ce0c4dfdf41056a309e95a7647678436ad8...9079ecf4d6b0e140c8449ec32da60efd00807e46,1,1,1,2,1,2010-10-12 00:56:40,2010-10-12 00:56:40
9079ecf4d6b0e140c8449ec32da60efd00807e46...e509c1527af0efee017bcee76848ed9c4aad9669,9,3,14,17,12,2010-10-12 01:03:53,2010-10-12 01:03:53
e509c1527af0efee017bcee76848ed9c4aad9669...9235d24d3f087581c02bd839000172c576f96cf4,2,14,1,15,3,2010-10-12 01:48:21,2010-10-12 01:48:21
9235d24d3f087581c02bd839000172c576f96cf4...2d030707864f11c5a2e5652b40d275558eae12f7,2,54,79,133,3,2010-10-12 01:54:19,2010-10-12 01:54:19
2d030707864f11c5a2e5652b40d275558eae12f7...977d588dc26623026945a7e4ab4dbdd78869c521,2,8,2,10,2,2010-10-12 01:59:28,2010-10-12 01:59:28
977d588dc26623026945a7e4ab4dbdd78869c521...ceef628c192127d5e231613bc280d68dc0927fa3,2,29,18,47,2,2010-10-12 02:09:13,2010-10-12 02:09:13
ceef628c192127d5e231613bc280d68dc0927fa3...5506653b777d7547d21ea2d74e9588fb94314b77,13,253,181,434,60,2010-10-12 03:33:19,2010-10-12 03:33:19
5506653b777d7547d21ea2d74e9588fb94314b77...03f00bcd4240f13e6ffe5d8b6688b8a289cb6f8f,2,19,7,26,12,2010-10-12 07:15:47,2010-10-12 07:15:47
03f00bcd4240f13e6ffe5d8b6688b8a289cb6f8f...65dc51867306de485944735c94b1b39dc197ee56,1,10,0,10,1,2010-10-12 07:53:37,2010-10-12 07:53:37
65dc51867306de485944735c94b1b39dc197ee56...c7384af0614ddfc960d03c6704c53058a99f32c3,1,7,7,14,7,2010-10-12 14:06:11,2010-10-12 14:06:11
c7384af0614ddfc960d03c6704c53058a99f32c3...120aae2209a50641f51e1f6bc4fe383fb42757fb,4,14,3,17,4,2010-10-12 17:13:27,2010-10-12 17:13:27
120aae2209a50641f51e1f6bc4fe383fb42757fb...eec45e8b710b97201db106a6460fe051f8917833,4,228,116,344,20,2010-10-12 23:37:47,2010-10-12 23:37:47
eec45e8b710b97201db106a6460fe051f8917833...98dd10e62d72f176670a206c3833f98e7c613da0,1,9,7,16,2,2010-10-12 23:55:38,2010-10-12 23:55:38
98dd10e62d72f176670a206c3833f98e7c613da0...67f9663f5251131f65891121efa6475497bdd525,2,40,4,44,3,2010-10-13 00:30:02,2010-10-13 00:30:02
67f9663f5251131f65891121efa6475497bdd525...2c3b710d0aebc4e349c8f834d2eb76573b608ce9,1,1,1,2,2,2010-10-13 01:23:07,2010-10-13 01:23:07
2c3b710d0aebc4e349c8f834d2eb76573b608ce9...b7ed25a0f3c02b2326a6256243f66acaf4986530,1,3,3,6,2,2010-10-13 04:16:31,2010-10-13 04:16:31
b7ed25a0f3c02b2326a6256243f66acaf4986530...52716ddd1b0541b9cd86fd361a9f8b9894927211,2,38,1,39,3,2010-10-13 04:36:51,2010-10-13 04:36:51
52716ddd1b0541b9cd86fd361a9f8b9894927211...00a685178a6a8c1e2a3fe99ad20eb05d8533e175,3,36,3,39,5,2010-10-13 04:46:33,2010-10-13 04:46:33
00a685178a6a8c1e2a3fe99ad20eb05d8533e175...b37327caae41d9d664b59fc2cd766072771d0b93,1,1,1,2,1,2010-10-13 06:59:45,2010-10-13 06:59:45
b37327caae41d9d664b59fc2cd766072771d0b93...3321171952f188cbab92390958c6f09d6d4f11b1,1,2,2,4,2,2010-10-13 11:29:18,2010-10-13 11:29:18
3321171952f188cbab92390958c6f09d6d4f11b1...5f5a61e7804beab76b92178e48cd74cae007a8ec,1,23,0,23,1,2010-10-13 12:07:27,2010-10-13 12:07:27
5f5a61e7804beab76b92178e48cd74cae007a8ec...08d14925c9e321d7ff4e0f6c1983a74606aa1941,3,16,1,17,4,2010-10-13 23:36:16,2010-10-13 23:36:16
08d14925c9e321d7ff4e0f6c1983a74606aa1941...2bbea7555be92e5d7245ddf3a01ecd88bee906ef,2,75,67,142,2,2010-10-14 01:10:57,2010-10-14 01:10:57
2bbea7555be92e5d7245ddf3a01ecd88bee906ef...52efbf97150410af3f7430d0a972ac061f80ca44,2,54,53,107,2,2010-10-14 01:17:14,2010-10-14 01:17:14
52efbf97150410af3f7430d0a972ac061f80ca44...5bf73dd909b36a5aeff2ddbf3635e9394e08a5a7,1,3,2,5,1,2010-10-14 01:24:20,2010-10-14 01:24:20
5bf73dd909b36a5aeff2ddbf3635e9394e08a5a7...1ac4c101aeda3ad6a1a4660577be14ea3b0d2f27,2,105,130,235,2,2010-10-14 01:24:34,2010-10-14 01:24:34
1ac4c101aeda3ad6a1a4660577be14ea3b0d2f27...8d364763ed45f4298ac3395f41252e21e82f9f28,2,51,43,94,5,2010-10-14 01:40:20,2010-10-14 01:40:20
8d364763ed45f4298ac3395f41252e21e82f9f28...767cf955d25d0ab82e6b9bd4b6360a1ccef15706,1,14,0,14,2,2010-10-14 10:03:08,2010-10-14 10:03:08
767cf955d25d0ab82e6b9bd4b6360a1ccef15706...36f2f7ee7c806824b28bdf669296cc0730fe6100,2,20,1,21,2,2010-10-14 18:37:05,2010-10-14 18:37:05
36f2f7ee7c806824b28bdf669296cc0730fe6100...45c7f427ce830dd1b2f636fb9c244fda9201cadb,18,475,50,525,68,2010-10-14 20:54:30,2010-10-14 20:54:30
45c7f427ce830dd1b2f636fb9c244fda9201cadb...dfcb814a877d9c5fdf67cc0ddc8d96b4f7c1d2db,1,1,1,2,1,2010-10-15 00:41:37,2010-10-15 00:41:37
dfcb814a877d9c5fdf67cc0ddc8d96b4f7c1d2db...65b98c9b41b3b1ba43df622e91fb561ceb16c70e,1,4,4,8,4,2010-10-15 02:09:11,2010-10-15 02:09:11
65b98c9b41b3b1ba43df622e91fb561ceb16c70e...2e8bc8f9862f127b0e69766c7fc7dc92f3156d20,2,150,101,251,12,2010-10-15 02:35:51,2010-10-15 02:35:51
2e8bc8f9862f127b0e69766c7fc7dc92f3156d20...5a8e40a03fd03f3ab88fb21845dd704833f3f133,5,147,0,147,6,2010-10-15 02:58:10,2010-10-15 02:58:10
5a8e40a03fd03f3ab88fb21845dd704833f3f133...5ee1d5ee31bfacae2237818c0fe20c567a052381,1,3,3,6,2,2010-10-15 03:15:15,2010-10-15 03:15:15
5ee1d5ee31bfacae2237818c0fe20c567a052381...056659c1cf77d7760db955057c9bf1d9a7e7b20d,2,226,169,395,4,2010-10-15 06:52:35,2010-10-15 06:52:35
056659c1cf77d7760db955057c9bf1d9a7e7b20d...c20f2f2ac90b23b8b072a589c229fbbc50f0da77,1,63,72,135,5,2010-10-15 07:34:23,2010-10-15 07:34:23
c20f2f2ac90b23b8b072a589c229fbbc50f0da77...2197b56f3034a1fe6c7ba95848cedc7e41f0580c,1,17,0,17,1,2010-10-15 09:30:42,2010-10-15 09:30:42
2197b56f3034a1fe6c7ba95848cedc7e41f0580c...7f5698de1d73399e5e0b9cb0950e964c61046c30,1,5,1,6,1,2010-10-15 10:21:46,2010-10-15 10:21:46
7f5698de1d73399e5e0b9cb0950e964c61046c30...d81b3aa73945496b3061e6db7659b3c9e6ce1296,1,2,2,4,2,2010-10-15 11:11:08,2010-10-15 11:11:08
d81b3aa73945496b3061e6db7659b3c9e6ce1296...6c902c436ee3e29babe9031e55f95652f98de66c,2,4,4,8,2,2010-10-15 20:13:22,2010-10-15 20:13:22
6c902c436ee3e29babe9031e55f95652f98de66c...7408f5098ba0a40488c4201a8c9f0ae05d3b7f00,2,232,109,341,2,2010-10-16 17:00:11,2010-10-16 17:00:11
7408f5098ba0a40488c4201a8c9f0ae05d3b7f00...58e3849ec3860512b7d42ad982eae0001645f160,2,344,285,629,211,2010-10-16 20:39:56,2010-10-16 20:39:56
58e3849ec3860512b7d42ad982eae0001645f160...d931f43b7081b88ae47adf32d32ccc005c1b8e43,2,4,2,6,2,2010-10-16 20:40:17,2010-10-16 20:40:17
d931f43b7081b88ae47adf32d32ccc005c1b8e43...cd63ce077df6568a4c4420f1f28d27c93aae236f,3,8,10,18,10,2010-10-17 01:49:36,2010-10-17 01:49:36
cd63ce077df6568a4c4420f1f28d27c93aae236f...400125d718c6a005d81c7ed051a15687394c2743,2,20,3,23,5,2010-10-17 04:26:47,2010-10-17 04:26:47
400125d718c6a005d81c7ed051a15687394c2743...214dc97bf39789294304013ebcd2a5f4b49547cf,3,37,4,41,6,2010-10-17 15:17:52,2010-10-17 15:17:52
214dc97bf39789294304013ebcd2a5f4b49547cf...df2d828d6ce3383e3423a36fb15aa8d0ebbd4b35,1,9,1,10,2,2010-10-18 01:20:40,2010-10-18 01:20:40
df2d828d6ce3383e3423a36fb15aa8d0ebbd4b35...59952b6f9a35bc6fce19d3bc199c7e6c892e2c38,1,2,2,4,2,2010-10-18 04:41:22,2010-10-18 04:41:22
59952b6f9a35bc6fce19d3bc199c7e6c892e2c38...c5df329996ca4801b0d97d4a70bc1bea6b8663c4,3,50,0,50,4,2010-10-18 04:44:49,2010-10-18 04:44:49
c5df329996ca4801b0d97d4a70bc1bea6b8663c4...31560e31f9b0452b5cf9716c29eeb08238957ffa,4,99,8,107,5,2010-10-18 04:56:27,2010-10-18 04:56:27
31560e31f9b0452b5cf9716c29eeb08238957ffa...fa2159f85b62375f3a1e462f174523ea5e5b691e,6,5268,0,5268,4,2010-10-18 11:23:07,2010-10-18 11:23:07
fa2159f85b62375f3a1e462f174523ea5e5b691e...0fcb09455729113f64a9873ca40bffd009b9bc5f,55,5029,83,5112,62,2010-10-18 13:34:47,2010-10-18 13:34:47
0fcb09455729113f64a9873ca40bffd009b9bc5f...b514957850f24218d2a6112889cb70529aa2c420,1,1,1,2,1,2010-10-18 15:51:18,2010-10-18 15:51:18
b514957850f24218d2a6112889cb70529aa2c420...2a9551a415f7a83e090730898ee0f2c647e08530,1,34,32,66,25,2010-10-18 15:53:08,2010-10-18 15:53:08
2a9551a415f7a83e090730898ee0f2c647e08530...4cd18ee32d39c5e9896e528f5ef87a9c92a694c2,2,9,11,20,7,2010-10-18 15:53:31,2010-10-18 15:53:31
4cd18ee32d39c5e9896e528f5ef87a9c92a694c2...8cb4bf5ef8418c8e76dacf40cc83eb0566d5bf56,3,9,3,12,6,2010-10-18 15:53:55,2010-10-18 15:53:55
8cb4bf5ef8418c8e76dacf40cc83eb0566d5bf56...f657079c701b56e169142c8b89f9a578972cf11b,1,8,8,16,1,2010-10-18 16:01:11,2010-10-18 16:01:11
f657079c701b56e169142c8b89f9a578972cf11b...2db34d2307943491f651a8342b35c47699109385,3,5,2,7,4,2010-10-18 16:08:25,2010-10-18 16:08:25
2db34d2307943491f651a8342b35c47699109385...a6cafffbf7e7aaf269241f1283f781a9d3eddfb2,2,2,2,4,2,2010-10-18 16:35:37,2010-10-18 16:35:37
a6cafffbf7e7aaf269241f1283f781a9d3eddfb2...26e8e53cf455a74964307aa742c5a979975e33bc,1,1,1,2,1,2010-10-18 20:29:53,2010-10-18 20:29:53
26e8e53cf455a74964307aa742c5a979975e33bc...b05b8cf091dc622041550ea608cad4fc4a1ed028,1,37,33,70,20,2010-10-18 21:08:50,2010-10-18 21:08:50
b05b8cf091dc622041550ea608cad4fc4a1ed028...7083bc5824f719fd96cc9531a315ba220b3fba29,1,685,850,1535,373,2010-10-18 21:39:30,2010-10-18 21:39:30
7083bc5824f719fd96cc9531a315ba220b3fba29...c498d2f9b4d8bf5e8d6d91af8e23f59af3e34b69,1,5,5,10,3,2010-10-18 22:28:38,2010-10-18 22:28:38
c498d2f9b4d8bf5e8d6d91af8e23f59af3e34b69...cc9e5213f833d5dd30f47c1f180f5ec615ad864c,1,108,31,139,49,2010-10-18 23:09:13,2010-10-18 23:09:13
cc9e5213f833d5dd30f47c1f180f5ec615ad864c...4b828a906a2c0837e9607e8909418090cb7aee0c,1,3,3,6,3,2010-10-18 23:11:14,2010-10-18 23:11:14
4b828a906a2c0837e9607e8909418090cb7aee0c...cb33aa1cc8040ece2cc6b773e57672e7c2d818f4,2,3,3,6,3,2010-10-18 23:26:16,2010-10-18 23:26:16
cb33aa1cc8040ece2cc6b773e57672e7c2d818f4...2790cf482d5e5e428759c5e8e6e63db3c740f389,3,39,15,54,12,2010-10-18 23:58:06,2010-10-18 23:58:06
2790cf482d5e5e428759c5e8e6e63db3c740f389...7baee5b95384f19b2f579046a344d294eb5f67c6,7,27,25,52,21,2010-10-19 00:10:22,2010-10-19 00:10:22
7baee5b95384f19b2f579046a344d294eb5f67c6...e1182306fdbf629ce12edca42bddf7508e357366,3,3,3,6,3,2010-10-19 00:14:41,2010-10-19 00:14:41
e1182306fdbf629ce12edca42bddf7508e357366...3ecc84a83c7204778e3d3f7dde5e669ac63906e7,1,7,1,8,2,2010-10-19 00:26:15,2010-10-19 00:26:15
3ecc84a83c7204778e3d3f7dde5e669ac63906e7...7f9da79bac70832862d8b7bc8d4a2a849df0ce8a,1,3,2,5,2,2010-10-19 00:26:39,2010-10-19 00:26:39
7f9da79bac70832862d8b7bc8d4a2a849df0ce8a...3739f89b44ab075597f6a43627b4ab8c50563d10,1,8,0,8,1,2010-10-19 00:58:03,2010-10-19 00:58:03
3739f89b44ab075597f6a43627b4ab8c50563d10...5fadeb848cea31415490074f608bbfa086b396b1,1,1,5,6,2,2010-10-19 04:03:07,2010-10-19 04:03:07
5fadeb848cea31415490074f608bbfa086b396b1...bdaaac12545deb3624567fc5791fe46b5eed7ae4,2,1468,1094,2562,12,2010-10-19 04:07:22,2010-10-19 04:07:22
bdaaac12545deb3624567fc5791fe46b5eed7ae4...634d0a92b8bbbf6f2894cc3590cc8e9c7c38e0a7,2,372,287,659,2,2010-10-19 04:58:59,2010-10-19 04:58:59
634d0a92b8bbbf6f2894cc3590cc8e9c7c38e0a7...f6a0b7cfe31367935cd124907b54fdd0b87ce261,1,2,5,7,2,2010-10-19 07:14:38,2010-10-19 07:14:38
f6a0b7cfe31367935cd124907b54fdd0b87ce261...1a270bd1038a36b79dd12616ca3234e3f4b30ff3,1,2,4,6,2,2010-10-19 07:22:38,2010-10-19 07:22:38
1a270bd1038a36b79dd12616ca3234e3f4b30ff3...c0cb75ce6410b2be7745001f911a0505c5358d66,2,384,248,632,2,2010-10-19 12:01:47,2010-10-19 12:01:47
c0cb75ce6410b2be7745001f911a0505c5358d66...cfbba28c39e2063dbad0362c35ece2a97a9353f2,1,12,3,15,4,2010-10-19 17:27:38,2010-10-19 17:27:38
cfbba28c39e2063dbad0362c35ece2a97a9353f2...27db9378cfba804f532442d9c3fc48f8249e0d46,5,329,130,459,49,2010-10-19 19:38:15,2010-10-19 19:38:15
27db9378cfba804f532442d9c3fc48f8249e0d46...46c17654ed60ee43920406d61eae06a90d15af4d,2,52,37,89,6,2010-10-19 20:45:40,2010-10-19 20:45:40
46c17654ed60ee43920406d61eae06a90d15af4d...a014ee02888d2fcea6880bef51f143632a60aab3,5,28,13,41,14,2010-10-20 00:21:47,2010-10-20 00:21:47
a014ee02888d2fcea6880bef51f143632a60aab3...cfc19f84def07fb950ae8789ed0655eae4f66a92,54,2014,319,2333,104,2010-10-20 01:33:24,2010-10-20 01:33:24
cfc19f84def07fb950ae8789ed0655eae4f66a92...7d0d3b68d67810cd3b41c4ae5ccfd52de2e93913,1,2,2,4,1,2010-10-20 07:59:17,2010-10-20 07:59:17
7d0d3b68d67810cd3b41c4ae5ccfd52de2e93913...40a2a1c59d380e7ed3d95b6cfd287b440ff0bd3a,2,458,318,776,276,2010-10-20 09:26:53,2010-10-20 09:26:53
40a2a1c59d380e7ed3d95b6cfd287b440ff0bd3a...6be00774a4d65fc4d84c297ca6bd36c9c86fbca9,2,16,3,19,3,2010-10-20 13:07:06,2010-10-20 13:07:06
6be00774a4d65fc4d84c297ca6bd36c9c86fbca9...ec80e55cac2147e1944ed4adb9761e94bd553e5d,1,2,2,4,2,2010-10-20 17:57:37,2010-10-20 17:57:37
ec80e55cac2147e1944ed4adb9761e94bd553e5d...14b52b95d260e38392c7f2c3e0ebc34525a7aa89,1,1,2,3,1,2010-10-20 20:16:36,2010-10-20 20:16:36
14b52b95d260e38392c7f2c3e0ebc34525a7aa89...e9d6662f5e3b143cf48aaf84379aaa9a2bb57426,1,1,1,2,1,2010-10-20 21:08:06,2010-10-20 21:08:06
e9d6662f5e3b143cf48aaf84379aaa9a2bb57426...d1a632f9f9cfbb1c44d8ab782fc6779324375edb,1,5,2,7,2,2010-10-20 21:18:58,2010-10-20 21:18:58
d1a632f9f9cfbb1c44d8ab782fc6779324375edb...a28823e3643b489b563bc98e38365e43e3fb78bd,1,6,5,11,4,2010-10-20 22:14:26,2010-10-20 22:14:26
a28823e3643b489b563bc98e38365e43e3fb78bd...1c4868f4c15f41c7840129d0f04c87f65aa94367,5,31,8,39,12,2010-10-21 03:16:41,2010-10-21 03:16:41
1c4868f4c15f41c7840129d0f04c87f65aa94367...58af951c30670ea19bd2e7795daffd8f14383f71,1,7,4,11,5,2010-10-21 03:16:58,2010-10-21 03:16:58
58af951c30670ea19bd2e7795daffd8f14383f71...7f84dac3c7cdbbd073a6b8cdb07033dd4a53608e,1,1,1,2,1,2010-10-21 06:01:02,2010-10-21 06:01:02
7f84dac3c7cdbbd073a6b8cdb07033dd4a53608e...7e19641b0359c23105cc27eebd9ccb1963546f2a,1,7,1,8,3,2010-10-21 14:56:18,2010-10-21 14:56:18
7e19641b0359c23105cc27eebd9ccb1963546f2a...df0bb3c46312fe241d0b93b7969a60c01c449e7a,1,1,4,5,1,2010-10-21 14:56:33,2010-10-21 14:56:33
df0bb3c46312fe241d0b93b7969a60c01c449e7a...5864834fa5cafb4705e42356b07054f450af8cc4,2,62,3,65,6,2010-10-21 14:56:49,2010-10-21 14:56:49
5864834fa5cafb4705e42356b07054f450af8cc4...9d5d757bda5b83e9867ea695f1dd2ccde9aed1ed,1,1,1,2,2,2010-10-21 17:36:38,2010-10-21 17:36:38
9d5d757bda5b83e9867ea695f1dd2ccde9aed1ed...085e4c9112600b84cef601bc331cafae03c1b1c9,1,6,2,8,3,2010-10-21 17:37:19,2010-10-21 17:37:19
085e4c9112600b84cef601bc331cafae03c1b1c9...051bf1cf12b85b1d1df50bca10fb9cc246fb6804,2,5,1,6,3,2010-10-21 21:17:07,2010-10-21 21:17:07
051bf1cf12b85b1d1df50bca10fb9cc246fb6804...cad4feabad2a577e3ffb709679851bda74cc585e,1,1,1,2,1,2010-10-22 21:20:00,2010-10-22 21:20:00
cad4feabad2a577e3ffb709679851bda74cc585e...cfdad9ed86c8408fe69fd0a946419f9c8aa265c8,4,72,6,78,9,2010-10-23 00:01:22,2010-10-23 00:01:22
cfdad9ed86c8408fe69fd0a946419f9c8aa265c8...4674ef27813aa672e4f55cc2d0b377ed55bea78a,1,1,1,2,1,2010-10-23 09:07:15,2010-10-23 09:07:15
4674ef27813aa672e4f55cc2d0b377ed55bea78a...c1b3deedaa647034668e6c0fc0464d9d9608f152,2,53,35,88,19,2010-10-23 14:32:20,2010-10-23 14:32:20
c1b3deedaa647034668e6c0fc0464d9d9608f152...85ef6c09386ec55193dc4ca40251c7c4ca559516,2,36,0,36,3,2010-10-23 14:32:54,2010-10-23 14:32:54
85ef6c09386ec55193dc4ca40251c7c4ca559516...f9def8b873faff11d0037094b0b5845c0119ad22,1,9,9,18,9,2010-10-23 14:52:01,2010-10-23 14:52:01
f9def8b873faff11d0037094b0b5845c0119ad22...b87454980793dc4364b387f14229b231f276c08c,4,132,56,188,22,2010-10-23 16:37:51,2010-10-23 16:37:51
b87454980793dc4364b387f14229b231f276c08c...e18f8b1d22402dc9e55263360f8875e16af1ab64,1,61,42,103,20,2010-10-23 21:15:35,2010-10-23 21:15:35
e18f8b1d22402dc9e55263360f8875e16af1ab64...d37114200115163e34c6618291ea9d29938ff4a3,2,64,52,116,35,2010-10-23 22:06:01,2010-10-23 22:06:01
d37114200115163e34c6618291ea9d29938ff4a3...a200cc6d54c14bc658e3f2f428a63261e942f249,1,1,1,2,1,2010-10-23 22:14:57,2010-10-23 22:14:57
a200cc6d54c14bc658e3f2f428a63261e942f249...6737570aebb5e59db9941c5aa6f2c017298f6000,1,4,4,8,1,2010-10-23 22:24:34,2010-10-23 22:24:34
6737570aebb5e59db9941c5aa6f2c017298f6000...e4c0c377dd8b8cbc5a014719d05433db9fb3c000,1,83,5,88,12,2010-10-24 08:52:00,2010-10-24 08:52:00
e4c0c377dd8b8cbc5a014719d05433db9fb3c000...5d02b86afb8c649f54dd01dcc3d10a6d20023fdd,1,59,53,112,34,2010-10-24 09:12:40,2010-10-24 09:12:40
5d02b86afb8c649f54dd01dcc3d10a6d20023fdd...eccc42a8c79c1353e4072207b4a5259afdd50aca,1,1,1,2,1,2010-10-24 09:39:47,2010-10-24 09:39:47
eccc42a8c79c1353e4072207b4a5259afdd50aca...01e2be557bd41134e182a26bd705ff2039cef2b9,3,46,9,55,5,2010-10-24 17:25:49,2010-10-24 17:25:49
01e2be557bd41134e182a26bd705ff2039cef2b9...8a8c0ed0f9e915296fefa716628f0d9ea55cc770,1,2,2,4,2,2010-10-24 17:29:24,2010-10-24 17:29:24
8a8c0ed0f9e915296fefa716628f0d9ea55cc770...248b1dea3dbb62354261f6f77f964f651557d369,1,5,5,10,2,2010-10-25 12:48:56,2010-10-25 12:48:56
248b1dea3dbb62354261f6f77f964f651557d369...321e48f51bbc03af7315a4206f5ad6e6772f5aaf,2,271,234,505,2,2010-10-25 18:20:07,2010-10-25 18:20:07
321e48f51bbc03af7315a4206f5ad6e6772f5aaf...9facaec719f3605c50d0188f95d979a692bdf8f9,1,8,1,9,2,2010-10-25 20:50:53,2010-10-25 20:50:53
9facaec719f3605c50d0188f95d979a692bdf8f9...34f003028d2e3471820935f36abaed099f7e4cb6,1,3,0,3,1,2010-10-25 21:04:44,2010-10-25 21:04:44
34f003028d2e3471820935f36abaed099f7e4cb6...82dca6d4af8d4edb82d6b86cd140589f24ba2d25,1,1,1,2,1,2010-10-26 01:16:22,2010-10-26 01:16:22
82dca6d4af8d4edb82d6b86cd140589f24ba2d25...298f3d300e5b7d75f37ed7bcedc11a8b02e4da82,1,5,5,10,5,2010-10-26 12:32:35,2010-10-26 12:32:35
298f3d300e5b7d75f37ed7bcedc11a8b02e4da82...851f42ba277eec8081b8493d59a1506b6ce15c77,1,3,0,3,3,2010-10-26 18:09:20,2010-10-26 18:09:20
851f42ba277eec8081b8493d59a1506b6ce15c77...3761f3b166fca3313069849d12544717ebaddda5,1,3,3,6,3,2010-10-26 18:44:11,2010-10-26 18:44:11
3761f3b166fca3313069849d12544717ebaddda5...e716a71bad4e02410e2a0908d630abbee1d4c691,1,3,0,3,1,2010-10-27 07:08:15,2010-10-27 07:08:15
e716a71bad4e02410e2a0908d630abbee1d4c691...0b39bf02b94be859b418e1fbc19e50be8100c0f3,1,8,8,16,7,2010-10-27 15:12:13,2010-10-27 15:12:13
0b39bf02b94be859b418e1fbc19e50be8100c0f3...4239bb0f35d40f820e344a55338f8bbe5ae9eb98,3,133,10,143,8,2010-10-27 15:35:07,2010-10-27 15:35:07
4239bb0f35d40f820e344a55338f8bbe5ae9eb98...3d69b217901ba4ea094b7999ba931ad1c20a61e7,1,1,1,2,1,2010-10-27 20:08:20,2010-10-27 20:08:20
3d69b217901ba4ea094b7999ba931ad1c20a61e7...c6f90f00535ab55d36fe687305d4aebdad197001,2,28,5,33,6,2010-10-27 20:39:20,2010-10-27 20:39:20
c6f90f00535ab55d36fe687305d4aebdad197001...19a089ce761bd402fc1b94906b48338bb4ee1ac3,1,3,6,9,2,2010-10-27 21:47:22,2010-10-27 21:47:22
19a089ce761bd402fc1b94906b48338bb4ee1ac3...1356947fad649f2ead8cc977162661016a773263,1,5,6,11,3,2010-10-27 21:50:58,2010-10-27 21:50:58
1356947fad649f2ead8cc977162661016a773263...9962f352bf6d37bce323bc2dd280c1911c2140e5,1,1,1,2,1,2010-10-28 01:55:58,2010-10-28 01:55:58
9962f352bf6d37bce323bc2dd280c1911c2140e5...8bc2f2a0b531c9e9bf7734b05ed3d3a7e86a526e,1,4,4,8,2,2010-10-28 02:58:06,2010-10-28 02:58:06
8bc2f2a0b531c9e9bf7734b05ed3d3a7e86a526e...baa1e90d4cf029b42e028ee23d999c99751a24e7,3,25,20,45,12,2010-10-28 02:58:28,2010-10-28 02:58:28
baa1e90d4cf029b42e028ee23d999c99751a24e7...623592e0acd87a5d2be500f83bb483518057c377,1,1,1,2,1,2010-10-28 02:58:46,2010-10-28 02:58:46
623592e0acd87a5d2be500f83bb483518057c377...4c9741cba2e88b46252e08037047df34aad48c70,1,8,4,12,4,2010-10-28 02:59:04,2010-10-28 02:59:04
4c9741cba2e88b46252e08037047df34aad48c70...4d5b00b874ea8a2b781fba7fcc4b55a023b68818,1,1,1,2,1,2010-10-28 02:59:22,2010-10-28 02:59:22
4d5b00b874ea8a2b781fba7fcc4b55a023b68818...144ab8877f83017c1ff7395b78996790b3dbba02,1,0,3,3,3,2010-10-28 11:46:57,2010-10-28 11:46:57
144ab8877f83017c1ff7395b78996790b3dbba02...90ac02300e754bdc1a2658ef21737c28fc522148,5,67,20,87,20,2010-10-28 11:47:15,2010-10-28 11:47:15
90ac02300e754bdc1a2658ef21737c28fc522148...ea85d4303d9b58704ebdea5b88bbd0dbfd6ab30c,2,19,1,20,2,2010-10-28 11:56:37,2010-10-28 11:56:37
ea85d4303d9b58704ebdea5b88bbd0dbfd6ab30c...98753710a7e58ce93b41d7ff426f2ef5040f9132,1,26,0,26,1,2010-10-28 12:36:51,2010-10-28 12:36:51
98753710a7e58ce93b41d7ff426f2ef5040f9132...ded416bc7e0d69cdb63261c74a2430a81da5d3bb,2,6,5,11,2,2010-10-28 12:56:44,2010-10-28 12:56:44
ded416bc7e0d69cdb63261c74a2430a81da5d3bb...8a724802c5b3b8d4f8d51bcf276838bf0f4ba176,3,40,5,45,8,2010-10-28 12:57:04,2010-10-28 12:57:04
8a724802c5b3b8d4f8d51bcf276838bf0f4ba176...cb17f7ca2252265ab4a844e7924cb8ebab4a1a76,4,86,22,108,18,2010-10-29 01:31:15,2010-10-29 01:31:15
cb17f7ca2252265ab4a844e7924cb8ebab4a1a76...c38a174f7c3d2dc5a1adab746ca44f0afd0d966c,4,16,16,32,16,2010-10-29 04:24:53,2010-10-29 04:24:53
c38a174f7c3d2dc5a1adab746ca44f0afd0d966c...3086b55b0e96b82a7f5f7a5c488f97ff5ed76420,4,21,15,36,9,2010-10-29 07:43:56,2010-10-29 07:43:56
3086b55b0e96b82a7f5f7a5c488f97ff5ed76420...269e921756371bee6d35a967bc2ffe84d1ae39eb,5,236,95,331,22,2010-10-29 16:39:25,2010-10-29 16:39:25
269e921756371bee6d35a967bc2ffe84d1ae39eb...ccc49029b8d84cf3eaaa3593df6370329f7b14e1,10,243,27,270,36,2010-10-29 16:48:58,2010-10-29 16:48:58
ccc49029b8d84cf3eaaa3593df6370329f7b14e1...bc6d7d21023bfdd1dd73ac1ceb370fc18a4d241f,1,9,2,11,4,2010-10-30 04:24:24,2010-10-30 04:24:24
bc6d7d21023bfdd1dd73ac1ceb370fc18a4d241f...20e09ca817ecea7b20314481aa017809169f60e4,1,1,1,2,1,2010-10-30 04:28:43,2010-10-30 04:28:43
20e09ca817ecea7b20314481aa017809169f60e4...52e0bcbc62c4df5d488b18f6a8e2cba798ec0807,5,730,64,794,24,2010-10-30 07:19:04,2010-10-30 07:19:04
52e0bcbc62c4df5d488b18f6a8e2cba798ec0807...fffbbe406232fb7403ed33123cd21f9c0996f627,1,11,3,14,3,2010-10-30 13:03:37,2010-10-30 13:03:37
fffbbe406232fb7403ed33123cd21f9c0996f627...03b12ae2cf75ddd61f3cdd99054ccd9ea91f6d55,1,1,1,2,1,2010-10-30 13:04:02,2010-10-30 13:04:02
03b12ae2cf75ddd61f3cdd99054ccd9ea91f6d55...aa951eb8ea5e3986ed8b76f55f5f4741eec0e717,2,14,8,22,8,2010-10-30 23:39:53,2010-10-30 23:39:53
aa951eb8ea5e3986ed8b76f55f5f4741eec0e717...fa8f0cb2d841d8187de9d3723bd9e1104db1ace1,4,10,5,15,5,2010-10-31 00:53:58,2010-10-31 00:53:58
fa8f0cb2d841d8187de9d3723bd9e1104db1ace1...429473a5229e18980541458ff85d148163dd8a07,1,11,7,18,4,2010-10-31 02:34:01,2010-10-31 02:34:01
429473a5229e18980541458ff85d148163dd8a07...6824c9b7962a04ba03d846a8dbe2507d166672a6,2,12,1,13,2,2010-10-31 08:29:07,2010-10-31 08:29:07
6824c9b7962a04ba03d846a8dbe2507d166672a6...15b3350d30b2b34ae48a3f0f2ee0ca217d21bd3d,1,2,2,4,2,2010-10-31 16:25:29,2010-10-31 16:25:29
15b3350d30b2b34ae48a3f0f2ee0ca217d21bd3d...282e53b4995a6b908448d50f83b40a70ceaae808,1,14,9,23,5,2010-10-31 16:49:36,2010-10-31 16:49:36
282e53b4995a6b908448d50f83b40a70ceaae808...799a3057cd96670ec0bb4290549acc3721391dbe,1,1,1,2,1,2010-10-31 23:32:38,2010-10-31 23:32:38
799a3057cd96670ec0bb4290549acc3721391dbe...5c05233ffcaa2d2185aaa4b787e4a265c195f13e,4,131,26,157,32,2010-11-01 00:52:58,2010-11-01 00:52:58
5c05233ffcaa2d2185aaa4b787e4a265c195f13e...21d6fb6062efa0c81b7e951cf6605bf98a2acd96,2,4,18,22,7,2010-11-01 17:22:13,2010-11-01 17:22:13
21d6fb6062efa0c81b7e951cf6605bf98a2acd96...34e545a93847142b112083b9858f76448f356711,1,37,12,49,4,2010-11-01 20:54:39,2010-11-01 20:54:39
34e545a93847142b112083b9858f76448f356711...315ae1ce6ea6ff5d8f6f69e57d6a92719dd69fd6,6,232,327,559,81,2010-11-01 21:56:48,2010-11-01 21:56:48
315ae1ce6ea6ff5d8f6f69e57d6a92719dd69fd6...1ee4274ff13b0b6cef32cb3035376dfd7144f35c,1,8,8,16,8,2010-11-01 22:18:22,2010-11-01 22:18:22
1ee4274ff13b0b6cef32cb3035376dfd7144f35c...3d96540b80eeb6cd544a053e9076148457dbe0c4,1,2,0,2,1,2010-11-01 23:46:37,2010-11-01 23:46:37
3d96540b80eeb6cd544a053e9076148457dbe0c4...e0a1e474b6e0edc4c400af775002bbcde305fe41,2,343,272,615,2,2010-11-02 02:00:16,2010-11-02 02:00:16
e0a1e474b6e0edc4c400af775002bbcde305fe41...4a1571940565974dc9885c2559be06fb167e1f6f,2,554,408,962,2,2010-11-02 02:32:23,2010-11-02 02:32:23
4a1571940565974dc9885c2559be06fb167e1f6f...e57cd291cc7821be5b47d9837598b1d9fd2bcad3,2,543,401,944,2,2010-11-02 04:01:36,2010-11-02 04:01:36
e57cd291cc7821be5b47d9837598b1d9fd2bcad3...c10d41c821808760e0e9193b1bea57213300811e,2,1219,921,2140,2,2010-11-02 05:09:16,2010-11-02 05:09:16
c10d41c821808760e0e9193b1bea57213300811e...909c44e1aa8c216e748ef85d27ab8b686fe61d46,1,13,16,29,5,2010-11-02 05:21:48,2010-11-02 05:21:48
909c44e1aa8c216e748ef85d27ab8b686fe61d46...7dfefa74ca8e5b0d37a5d13f0fcde6e6f98de9a4,1,2,2,4,2,2010-11-02 05:27:24,2010-11-02 05:27:24
7dfefa74ca8e5b0d37a5d13f0fcde6e6f98de9a4...89219a6829d439c65f785f6603bbb91546944590,3,3,3,6,3,2010-11-02 05:31:19,2010-11-02 05:31:19
89219a6829d439c65f785f6603bbb91546944590...ed51dd5d644428a838861c58cda220a21b1523a8,1,4,2,6,1,2010-11-02 05:41:46,2010-11-02 05:41:46
ed51dd5d644428a838861c58cda220a21b1523a8...1fc7c4aee44af3d5c55d3532aa8fb5b2d9102a62,5,40,57,97,9,2010-11-02 05:55:08,2010-11-02 05:55:08
1fc7c4aee44af3d5c55d3532aa8fb5b2d9102a62...32f650cfccec3a07e6c1fd18e58284101dc83a2d,1,11,1,12,1,2010-11-02 07:38:06,2010-11-02 07:38:06
32f650cfccec3a07e6c1fd18e58284101dc83a2d...3e62e253d2dbe3cf5d79c5459fa8ca15f04824e1,1,2,2,4,2,2010-11-02 08:30:01,2010-11-02 08:30:01
3e62e253d2dbe3cf5d79c5459fa8ca15f04824e1...bb062c376ff561497f3ddef77fe456c118939872,1,12,2,14,2,2010-11-02 11:53:01,2010-11-02 11:53:01
bb062c376ff561497f3ddef77fe456c118939872...a89e02637b04b95f50087d53289e8aca8cd58007,3,55,3,58,9,2010-11-02 13:42:30,2010-11-02 13:42:30
a89e02637b04b95f50087d53289e8aca8cd58007...4ba6348a004352ba1790c043e7bc195637cb0b72,3,3,3,6,3,2010-11-02 16:19:17,2010-11-02 16:19:17
4ba6348a004352ba1790c043e7bc195637cb0b72...352deb09159b7a6c9d52077a378bf3faa071bce4,2,6,6,12,6,2010-11-02 18:30:00,2010-11-02 18:30:00
352deb09159b7a6c9d52077a378bf3faa071bce4...222c73261650201f5ce99e8dd4b1ce0d30a69eb4,4,18,5,23,8,2010-11-02 18:40:53,2010-11-02 18:40:53
222c73261650201f5ce99e8dd4b1ce0d30a69eb4...d8e311c8d17872162dcb0c43238abd432f124b72,1,2,2,4,2,2010-11-02 19:31:14,2010-11-02 19:31:14
d8e311c8d17872162dcb0c43238abd432f124b72...877033b479ed4252ed4d40714a70fcb4a85c641f,1,3,7,10,4,2010-11-04 00:01:54,2010-11-04 00:01:54
877033b479ed4252ed4d40714a70fcb4a85c641f...cabc21ca60758626ef8a5a8ff8c7f551a7e53db7,5,54,7,61,11,2010-11-04 01:29:37,2010-11-04 01:29:37
cabc21ca60758626ef8a5a8ff8c7f551a7e53db7...0659391baf60902168f738f520f75ed20d835aa1,5,129,191,320,14,2010-11-04 04:47:05,2010-11-04 04:47:05
0659391baf60902168f738f520f75ed20d835aa1...83aeb3c768173f48dc295c3194fecd705d1c05ac,13,137,4,141,18,2010-11-04 10:48:27,2010-11-04 10:48:27
83aeb3c768173f48dc295c3194fecd705d1c05ac...05db03c20609809cf79f71935064df3bbaf87f12,1,1,1,2,1,2010-11-04 10:48:45,2010-11-04 10:48:45
05db03c20609809cf79f71935064df3bbaf87f12...c906b270f5bc53d9657c5f0bdb98a3015c9f8c71,1,4,1,5,2,2010-11-04 12:03:38,2010-11-04 12:03:38
c906b270f5bc53d9657c5f0bdb98a3015c9f8c71...efc5384a325e8621cac37b2a33ce64e609c66f39,5,68,14,82,17,2010-11-04 12:08:37,2010-11-04 12:08:37
efc5384a325e8621cac37b2a33ce64e609c66f39...7d4a3991f3996344414bbbf3abda532bf5885ac3,2,2,2,4,2,2010-11-04 12:31:57,2010-11-04 12:31:57
7d4a3991f3996344414bbbf3abda532bf5885ac3...6feef0c13e92d4604f7d6ed929a832d623593397,2,10,4,14,4,2010-11-04 12:36:55,2010-11-04 12:36:55
6feef0c13e92d4604f7d6ed929a832d623593397...127506aeacc09f07e8e6b7c694423579f9663371,3,17,3,20,5,2010-11-04 14:06:24,2010-11-04 14:06:24
127506aeacc09f07e8e6b7c694423579f9663371...abaa3ed4bd0c010c30aa338713a56b5c2cb45cf7,5,121,10,131,8,2010-11-04 16:03:05,2010-11-04 16:03:05
abaa3ed4bd0c010c30aa338713a56b5c2cb45cf7...e2a0de0b935659922df8c4b03741d6ebfaed0ee0,1,12,7,19,2,2010-11-04 16:37:00,2010-11-04 16:37:00
e2a0de0b935659922df8c4b03741d6ebfaed0ee0...3d650b4913c605a72060a0671c08f1a59ca91bfd,1,1,1,2,1,2010-11-04 21:09:51,2010-11-04 21:09:51
3d650b4913c605a72060a0671c08f1a59ca91bfd...56ae68c92f18ed0409154a080b5c9354bb0c6180,1,1,1,2,1,2010-11-06 00:43:20,2010-11-06 00:43:20
56ae68c92f18ed0409154a080b5c9354bb0c6180...cf03598eecffaba335de849c9725354c020eb371,1,2,3,5,3,2010-11-06 03:26:17,2010-11-06 03:26:17
cf03598eecffaba335de849c9725354c020eb371...59d5537a6cd52aa6eff4e980087a936075c86c03,1,1,1,2,1,2010-11-06 04:30:17,2010-11-06 04:30:17
59d5537a6cd52aa6eff4e980087a936075c86c03...63046ec1eeaa186546b480da5988a0f607919377,1,9,5,14,5,2010-11-06 09:19:53,2010-11-06 09:19:53
63046ec1eeaa186546b480da5988a0f607919377...f6824840a2797ee70f5de559e27eee9b7b2207af,1,28,5,33,5,2010-11-06 10:06:30,2010-11-06 10:06:30
f6824840a2797ee70f5de559e27eee9b7b2207af...6c85a44416c1a18c2f5a773752ed403d2f23de99,1,7,2,9,3,2010-11-06 16:29:19,2010-11-06 16:29:19
6c85a44416c1a18c2f5a773752ed403d2f23de99...0b2fef5dd350c472f7d76fc4c85a47f3bd8ccc75,1,1,1,2,1,2010-11-06 16:41:53,2010-11-06 16:41:53
0b2fef5dd350c472f7d76fc4c85a47f3bd8ccc75...57f49453c75c92cb6a87bafd48b18ec4efd06255,1,7,3,10,1,2010-11-06 17:42:21,2010-11-06 17:42:21
57f49453c75c92cb6a87bafd48b18ec4efd06255...4eec036ab3dea211af209d1bd0bdac8955269aaa,2,19,0,19,2,2010-11-06 17:44:26,2010-11-06 17:44:26
4eec036ab3dea211af209d1bd0bdac8955269aaa...11b012038cb077b6d3648b49ddb754e088e39f0c,2,9,1,10,3,2010-11-06 23:30:10,2010-11-06 23:30:10
11b012038cb077b6d3648b49ddb754e088e39f0c...1a878f30b0910bce4049643740bea2c693f9a1a0,1,24,21,45,8,2010-11-07 00:56:59,2010-11-07 00:56:59
1a878f30b0910bce4049643740bea2c693f9a1a0...7f2b36050ee0c9e939d88f9ce368d1ccc2f67266,8,23,21,44,13,2010-11-07 01:42:55,2010-11-07 01:42:55
7f2b36050ee0c9e939d88f9ce368d1ccc2f67266...682f4cf9ed644492bad96bc6d2549cb2fe3d335f,7,183,55,238,11,2010-11-07 09:21:55,2010-11-07 09:21:55
682f4cf9ed644492bad96bc6d2549cb2fe3d335f...c6e64aaa66eef7bf765cba538d670de9bf711d6b,1,2,2,4,2,2010-11-07 15:21:47,2010-11-07 15:21:47
c6e64aaa66eef7bf765cba538d670de9bf711d6b...035cb99b47d8580b2619788fb08eed9cf7968590,1,4,5,9,6,2010-11-07 15:41:17,2010-11-07 15:41:17
035cb99b47d8580b2619788fb08eed9cf7968590...96cc7baf0c6bc043e32d1972f95962045a7fba2b,2,25,7,32,7,2010-11-07 16:02:22,2010-11-07 16:02:22
96cc7baf0c6bc043e32d1972f95962045a7fba2b...9c619ac48b1e4b61346b97b6838a6efb3416cd70,1,5,37,42,10,2010-11-07 20:58:46,2010-11-07 20:58:46
9c619ac48b1e4b61346b97b6838a6efb3416cd70...f90b0f6d699982c2577d34f721ad5a8ec7bdd180,1,9,7,16,5,2010-11-07 21:42:11,2010-11-07 21:42:11
f90b0f6d699982c2577d34f721ad5a8ec7bdd180...d6e33795a90fe1cfd487acf230ddef1d9a28552a,1,31,8,39,3,2010-11-07 23:02:24,2010-11-07 23:02:24
d6e33795a90fe1cfd487acf230ddef1d9a28552a...d30fe03e6bae5cc794be8c48a5867c3fb8aeceb2,3,4,7,11,4,2010-11-08 20:37:52,2010-11-08 20:37:52
d30fe03e6bae5cc794be8c48a5867c3fb8aeceb2...2380584783e5a29368c3c3df679d77d69ff89e95,1,1,1,2,1,2010-11-08 21:52:32,2010-11-08 21:52:32
2380584783e5a29368c3c3df679d77d69ff89e95...7a5c54e9b74ff612af37689425458e7857f9649f,1,1,1,2,1,2010-11-09 05:04:05,2010-11-09 05:04:05
7a5c54e9b74ff612af37689425458e7857f9649f...60ad315bc9fa9595409ad9d7d21c6a12c133ac81,1,4,4,8,3,2010-11-09 05:18:47,2010-11-09 05:18:47
60ad315bc9fa9595409ad9d7d21c6a12c133ac81...3ba3294c6b5ad413731223a9e46064a8e132acd2,1,31,0,31,1,2010-11-09 16:33:48,2010-11-09 16:33:48
3ba3294c6b5ad413731223a9e46064a8e132acd2...616b30227d901a7452810a9ffaa55eaf186dc9e1,28,874,632,1506,111,2010-11-09 16:46:42,2010-11-09 16:46:42
616b30227d901a7452810a9ffaa55eaf186dc9e1...cab434e011619f6ee9001dc62f769bb3dc88c1e9,1,0,14,14,1,2010-11-09 17:39:01,2010-11-09 17:39:01
cab434e011619f6ee9001dc62f769bb3dc88c1e9...f91b41fe338d691bc3a6a8a8fc1509c9b61e7d18,1,22,0,22,1,2010-11-11 04:36:20,2010-11-11 04:36:20
f91b41fe338d691bc3a6a8a8fc1509c9b61e7d18...4fb1825e75999e16027bda73d905d815326bec84,1,3,3,6,4,2010-11-11 05:07:32,2010-11-11 05:07:32
4fb1825e75999e16027bda73d905d815326bec84...cae746e037fa4d9d3e043413433286276282664d,1,1,1,2,1,2010-11-11 05:17:31,2010-11-11 05:17:31
cae746e037fa4d9d3e043413433286276282664d...ac25387b0516b8302dd242bd3aad679525760521,1,333,0,333,1,2010-11-11 07:02:02,2010-11-11 07:02:02
ac25387b0516b8302dd242bd3aad679525760521...185254a20576edc8dddf6474a7a64855fb15c5b7,1,57,0,57,1,2010-11-11 07:06:27,2010-11-11 07:06:27
185254a20576edc8dddf6474a7a64855fb15c5b7...264711ef7a0626ef998cafc2ed5bae635f3a4ece,1,1,1,2,1,2010-11-11 07:14:28,2010-11-11 07:14:28
264711ef7a0626ef998cafc2ed5bae635f3a4ece...c5fef1d767d5a083a7d82006da3feb754825027f,2,2,2,4,2,2010-11-11 07:15:30,2010-11-11 07:15:30
c5fef1d767d5a083a7d82006da3feb754825027f...ebaebcc4385e682a3b876cc6fd1cc895691847c1,1,1,1,2,1,2010-11-11 07:18:15,2010-11-11 07:18:15
ebaebcc4385e682a3b876cc6fd1cc895691847c1...6a403c467634fdf8bf0757e3fe645fefeec2eb8b,1,0,4,4,1,2010-11-11 07:20:31,2010-11-11 07:20:31
6a403c467634fdf8bf0757e3fe645fefeec2eb8b...0b25176ed8b4c734ddedd6a602148c29ed989869,1,1,0,1,1,2010-11-11 07:21:07,2010-11-11 07:21:07
0b25176ed8b4c734ddedd6a602148c29ed989869...75a64d7a22d0524bbd065875384ed65fd48c2bb0,1,13,14,27,4,2010-11-11 08:01:03,2010-11-11 08:01:03
75a64d7a22d0524bbd065875384ed65fd48c2bb0...b0590110c78a9490c2a633b225f08e009f7f8ee8,2,8,5,13,2,2010-11-11 08:22:58,2010-11-11 08:22:58
b0590110c78a9490c2a633b225f08e009f7f8ee8...7beca4d3e5da784297ff7163d00dcfeee9a34dd6,1,1,1,2,1,2010-11-11 15:04:37,2010-11-11 15:04:37
7beca4d3e5da784297ff7163d00dcfeee9a34dd6...02fc6276d7577dcec26be30f3805b242ff0ce8a0,10,87,25,112,23,2010-11-11 15:06:20,2010-11-11 15:06:20
02fc6276d7577dcec26be30f3805b242ff0ce8a0...34b5739216f5145ca0e6707bc4666138e2493308,1,0,0,0,0,2010-11-11 17:51:14,2010-11-11 17:51:14
34b5739216f5145ca0e6707bc4666138e2493308...76154c7fe53f90251d922111d651d9fbb4b5bda4,1,0,0,0,0,2010-11-11 17:53:25,2010-11-11 17:53:25
76154c7fe53f90251d922111d651d9fbb4b5bda4...216fdfab61f3ed82bf21a353d92dec094bd2b298,2,42,0,42,2,2010-11-11 21:43:04,2010-11-11 21:43:04
216fdfab61f3ed82bf21a353d92dec094bd2b298...8e96584f6363cba7cbbac41771a4318dde9f46dd,14,190,78,268,53,2010-11-11 21:43:49,2010-11-11 21:43:49
8e96584f6363cba7cbbac41771a4318dde9f46dd...63023e6ad99da9030ceb60ffa6ff7c952660af6d,1,4,0,4,1,2010-11-11 21:44:05,2010-11-11 21:44:05
63023e6ad99da9030ceb60ffa6ff7c952660af6d...70edd4e103832dc95c42643365d1d676c6d5ded6,6,7,25,32,8,2010-11-11 21:44:33,2010-11-11 21:44:33
70edd4e103832dc95c42643365d1d676c6d5ded6...590bde88355b1736717d1d3936ebb4be56961a8c,1,6,4,10,3,2010-11-11 23:03:53,2010-11-11 23:03:53
590bde88355b1736717d1d3936ebb4be56961a8c...ee6bec6c092da5466be563cef1ecf3bcc45199f6,4,46,15,61,9,2010-11-12 01:44:22,2010-11-12 01:44:22
ee6bec6c092da5466be563cef1ecf3bcc45199f6...b951ffbc6bba6ea96f8b633782d02b983ec21e84,1,3,3,6,3,2010-11-12 02:48:26,2010-11-12 02:48:26
b951ffbc6bba6ea96f8b633782d02b983ec21e84...dc0accb5a30722edffd6b4a4930298041f6d9d5b,2,31,36,67,3,2010-11-12 16:12:38,2010-11-12 16:12:38
dc0accb5a30722edffd6b4a4930298041f6d9d5b...bd83177c702359a14165b7058572710459b7d7eb,2,2,2,4,2,2010-11-12 16:35:40,2010-11-12 16:35:40
bd83177c702359a14165b7058572710459b7d7eb...e0e347c2d39de56c4b7be5bde459bfffed16954d,1,1,1,2,1,2010-11-12 17:51:31,2010-11-12 17:51:31
e0e347c2d39de56c4b7be5bde459bfffed16954d...87a8046f9030646adec583c34597a1f634a0d11b,2,15,2,17,4,2010-11-12 18:39:30,2010-11-12 18:39:30
87a8046f9030646adec583c34597a1f634a0d11b...9892f4c5d58857c3fbbf45394b13c7bc0fce5161,1,2,2,4,2,2010-11-12 18:48:39,2010-11-12 18:48:39
9892f4c5d58857c3fbbf45394b13c7bc0fce5161...8a7a44ffa2c1c860b80dee8c2c1d0c2442fcd4f8,2,20,8,28,4,2010-11-12 19:26:57,2010-11-12 19:26:57
8a7a44ffa2c1c860b80dee8c2c1d0c2442fcd4f8...102d230f94e2fc4e5bbe2d6b3a013b2f8bcd8415,2,428,335,763,4,2010-11-12 19:39:22,2010-11-12 19:39:22
102d230f94e2fc4e5bbe2d6b3a013b2f8bcd8415...d9ae7c6b372a005532720adc2e9b3597a87cd141,1,8,7,15,1,2010-11-13 03:55:06,2010-11-13 03:55:06
d9ae7c6b372a005532720adc2e9b3597a87cd141...1ed62706e7c2fef945c50918e912435929164ad6,3,3,3,6,3,2010-11-13 18:41:24,2010-11-13 18:41:24
1ed62706e7c2fef945c50918e912435929164ad6...e9f3899b20e067af51a869e5538a1e513ddd0702,4,122,70,192,21,2010-11-13 18:41:55,2010-11-13 18:41:55
e9f3899b20e067af51a869e5538a1e513ddd0702...3b29fe353b1ef70ab41e204c5a70ba659fb78ec3,1,101,0,101,1,2010-11-13 18:42:11,2010-11-13 18:42:11
3b29fe353b1ef70ab41e204c5a70ba659fb78ec3...109f42a981cf28c2da8a82f59536a3a732572f02,3,11,2,13,9,2010-11-13 18:42:31,2010-11-13 18:42:31
109f42a981cf28c2da8a82f59536a3a732572f02...9b7be918edb6a821af786975db645b8f8d261a2c,3,34,6,40,7,2010-11-13 18:42:56,2010-11-13 18:42:56
9b7be918edb6a821af786975db645b8f8d261a2c...ff63a5bdeca3b88751a1e54a0cbc8adbb2c682eb,2,13,0,13,6,2010-11-13 18:43:13,2010-11-13 18:43:13
ff63a5bdeca3b88751a1e54a0cbc8adbb2c682eb...2b344d262815d715be63871e5434c109f85d27d4,1,6,6,12,4,2010-11-14 14:15:58,2010-11-14 14:15:58
2b344d262815d715be63871e5434c109f85d27d4...74f46c0ae2cbd7e0ccb80d4e5bd8bedadc8c6756,2,2,2,4,2,2010-11-14 15:42:54,2010-11-14 15:42:54
74f46c0ae2cbd7e0ccb80d4e5bd8bedadc8c6756...0324151bece5ab413250ada14428e41b6b59bf0b,2,31,17,48,4,2010-11-14 22:23:46,2010-11-14 22:23:46
0324151bece5ab413250ada14428e41b6b59bf0b...b6ec268e23c5b8e90ed3c3db3e220deca6eee8cc,3,35,0,35,7,2010-11-14 23:21:39,2010-11-14 23:21:39
b6ec268e23c5b8e90ed3c3db3e220deca6eee8cc...f6363bc62849f44df655bd9a7723fc30849ee915,2,8,1,9,5,2010-11-14 23:35:16,2010-11-14 23:35:16
f6363bc62849f44df655bd9a7723fc30849ee915...e69bc74351d4110e047c6fe7feb1c28272f0603c,1,5,5,10,1,2010-11-16 02:21:07,2010-11-16 02:21:07
e69bc74351d4110e047c6fe7feb1c28272f0603c...8da8d6c586bdbd086c3d76930fe32476a8438f19,1,7,1,8,2,2010-11-16 02:33:51,2010-11-16 02:33:51
8da8d6c586bdbd086c3d76930fe32476a8438f19...8bafde1229fdebb48383449de9bcadde06451816,24,5037,5629,10666,117,2010-11-16 13:20:56,2010-11-16 13:20:56
8bafde1229fdebb48383449de9bcadde06451816...165f13dc88af5669af855b1247379af8e88b0ad6,1,5,5,10,3,2010-11-16 13:30:31,2010-11-16 13:30:31
165f13dc88af5669af855b1247379af8e88b0ad6...b9e6db4ae801190cb2db188b8d5a5f0e891a6d56,1,17,0,17,2,2010-11-16 14:00:38,2010-11-16 14:00:38
b9e6db4ae801190cb2db188b8d5a5f0e891a6d56...b84838aef4de49c9567c98bd8a8d492e177e5e4f,2,27,3,30,4,2010-11-16 14:37:00,2010-11-16 14:37:00
b84838aef4de49c9567c98bd8a8d492e177e5e4f...35dc7d60333adf622feaeb42ba551d0a4aa05f3e,2,355,256,611,3,2010-11-16 15:14:04,2010-11-16 15:14:04
35dc7d60333adf622feaeb42ba551d0a4aa05f3e...ea145923fcb38ce32dabb703576b94477dc5811b,1,4,3,7,3,2010-11-16 21:33:48,2010-11-16 21:33:48
ea145923fcb38ce32dabb703576b94477dc5811b...f3d07047834b0a4ea3bde2b46643b327a659364e,2,10,1,11,2,2010-11-16 22:09:13,2010-11-16 22:09:13
f3d07047834b0a4ea3bde2b46643b327a659364e...5844cdca38f1440a76f5f3505256e239084f0c3e,2,2,2,4,2,2010-11-16 23:48:08,2010-11-16 23:48:08
5844cdca38f1440a76f5f3505256e239084f0c3e...5b4c6fd5e457236105dd0a6f9ade0060edb8af45,1,1,1,2,1,2010-11-17 01:57:23,2010-11-17 01:57:23
5b4c6fd5e457236105dd0a6f9ade0060edb8af45...3e9d2f81c521ed8b5ec37cde1aeda91ee4f687c7,1,0,16,16,1,2010-11-17 02:25:20,2010-11-17 02:25:20
3e9d2f81c521ed8b5ec37cde1aeda91ee4f687c7...4276b5197b2acc2c15ef719b1f1308c41f704725,4,36,4,40,7,2010-11-17 02:57:14,2010-11-17 02:57:14
4276b5197b2acc2c15ef719b1f1308c41f704725...5666bca67872a628631642743375d31956f24a2f,3,29,3,32,5,2010-11-17 12:09:21,2010-11-17 12:09:21
5666bca67872a628631642743375d31956f24a2f...9b45f6cd5444423693715cc2a04d91a0de75060b,2,1088,1039,2127,5,2010-11-17 13:30:44,2010-11-17 13:30:44
9b45f6cd5444423693715cc2a04d91a0de75060b...33d8fcde8a317184a627492f008a4eab9333ed88,31,908,329,1237,143,2010-11-17 15:36:26,2010-11-17 15:36:26
33d8fcde8a317184a627492f008a4eab9333ed88...96af304747b4edd6180613bfabe98bac7c8cfdeb,1,5,0,5,1,2010-11-17 15:36:42,2010-11-17 15:36:42
96af304747b4edd6180613bfabe98bac7c8cfdeb...d7ad02ff7228417a3f4ebccc518705f26d80ce38,1,32,32,64,7,2010-11-17 15:36:58,2010-11-17 15:36:58
d7ad02ff7228417a3f4ebccc518705f26d80ce38...17b329ae08f9e3886da2baafc9e53949000480f9,9,98,12,110,18,2010-11-17 15:37:33,2010-11-17 15:37:33
17b329ae08f9e3886da2baafc9e53949000480f9...8a7a8f465bd617d18808fd1849935818193d62c0,0,0,0,0,0,2010-11-17 15:46:11,2010-11-17 15:46:11
8a7a8f465bd617d18808fd1849935818193d62c0...c0248f6f07c4e55d44182949f3d77f338d3bfebe,2,33,33,66,8,2010-11-17 16:08:28,2010-11-17 16:08:28
c0248f6f07c4e55d44182949f3d77f338d3bfebe...0eb31d3dc9435b18680f7a41bc9067685beb8344,2,34,10,44,7,2010-11-17 16:46:50,2010-11-17 16:46:50
0eb31d3dc9435b18680f7a41bc9067685beb8344...fc47f8c65af80872c5031e20260100efb4afa1e4,1,0,19,19,1,2010-11-17 17:00:40,2010-11-17 17:00:40
fc47f8c65af80872c5031e20260100efb4afa1e4...204253ed40dc6f56d666e5fb2568de1535c18fc3,2,5,0,5,2,2010-11-17 20:03:15,2010-11-17 20:03:15
204253ed40dc6f56d666e5fb2568de1535c18fc3...0aeb6c964ae3177279410a1b5efaceb14a98db7e,2,21,16,37,3,2010-11-17 20:26:20,2010-11-17 20:26:20
0aeb6c964ae3177279410a1b5efaceb14a98db7e...9b6535b894076be8358b0f0bfdea77e4a6e62a22,1,8,10,18,4,2010-11-17 20:28:33,2010-11-17 20:28:33
9b6535b894076be8358b0f0bfdea77e4a6e62a22...9712f4c7a4a9d1879fe8964f5597fbdb7f40a8a3,1,1,1,2,1,2010-11-18 01:29:25,2010-11-18 01:29:25
9712f4c7a4a9d1879fe8964f5597fbdb7f40a8a3...a205fe9378fa0048aa7f24ad921b0c31ca5a1b21,1,10,0,10,1,2010-11-18 01:29:41,2010-11-18 01:29:41
a205fe9378fa0048aa7f24ad921b0c31ca5a1b21...9cebb526f2ace9130528e8a08b7aaf2cb8e95e9a,1,1,1,2,1,2010-11-18 01:53:38,2010-11-18 01:53:38
9cebb526f2ace9130528e8a08b7aaf2cb8e95e9a...38ba3775ec86718fabdf0ba1d5baf04a0f2164a7,4,46,5,51,20,2010-11-18 22:43:46,2010-11-18 22:43:46
38ba3775ec86718fabdf0ba1d5baf04a0f2164a7...008f333bac7ceada4aca06b274a57ede1f8bc3d9,5,20,6,26,12,2010-11-18 23:29:58,2010-11-18 23:29:58
008f333bac7ceada4aca06b274a57ede1f8bc3d9...3ede430b9a94e3c2aed64d2cf898920635bdf4ae,2,152,121,273,12,2010-11-18 23:32:01,2010-11-18 23:32:01
3ede430b9a94e3c2aed64d2cf898920635bdf4ae...f777ddf3e660ece8426cb98d74b9f17bbcf60dd6,1,1,0,1,1,2010-11-19 03:42:20,2010-11-19 03:42:20
f777ddf3e660ece8426cb98d74b9f17bbcf60dd6...49d831380f81c07c35e146bd6c2911a60d87c2f0,3,17,34,51,13,2010-11-19 08:08:08,2010-11-19 08:08:08
49d831380f81c07c35e146bd6c2911a60d87c2f0...261aee26c19a0d452847611502201088c14a1c19,1,5,4,9,2,2010-11-19 14:26:01,2010-11-19 14:26:01
261aee26c19a0d452847611502201088c14a1c19...99d247f4cb0c22d19a4482a72a7a93584a5189da,12,696,87,783,91,2010-11-19 15:39:35,2010-11-19 15:39:35
99d247f4cb0c22d19a4482a72a7a93584a5189da...59c84b4391f219c1aff1d4cd12c96712445d8a4e,1,6,2,8,1,2010-11-19 16:10:23,2010-11-19 16:10:23
59c84b4391f219c1aff1d4cd12c96712445d8a4e...a3e7ee7c4037a390d6ab24932e53682d1c394191,4,85,38,123,11,2010-11-19 19:33:07,2010-11-19 19:33:07
a3e7ee7c4037a390d6ab24932e53682d1c394191...0e26f58dae5b0bace6dcadbad2def400c93cdf14,2,36,13,49,12,2010-11-19 22:45:51,2010-11-19 22:45:51
0e26f58dae5b0bace6dcadbad2def400c93cdf14...c0adc62fcc917b056cf742248ea7d355b0dc721f,1,14,1,15,2,2010-11-19 23:19:23,2010-11-19 23:19:23
c0adc62fcc917b056cf742248ea7d355b0dc721f...f60930634978e49e97112fc4253f4a5d425c9950,2,3,9,12,3,2010-11-19 23:19:56,2010-11-19 23:19:56
f60930634978e49e97112fc4253f4a5d425c9950...61a89f8e1b382510e4dc3a5ffe293c1a5d232afc,1,6,4,10,1,2010-11-20 00:05:11,2010-11-20 00:05:11
61a89f8e1b382510e4dc3a5ffe293c1a5d232afc...58eca97e71742f1b735851938c443fdab7555db9,1,3,3,6,1,2010-11-20 01:11:34,2010-11-20 01:11:34
58eca97e71742f1b735851938c443fdab7555db9...ec7c49f2534284b1d9e67141d660a174ffadb3eb,1,7,12,19,1,2010-11-20 01:37:54,2010-11-20 01:37:54
ec7c49f2534284b1d9e67141d660a174ffadb3eb...591ad8afbf7a2b32825e81866f387d4eb1938a4e,3,63,9,72,7,2010-11-20 05:10:13,2010-11-20 05:10:13
591ad8afbf7a2b32825e81866f387d4eb1938a4e...7ff5580d95f6bb40f12a0b90f51570e23b014a2d,15,424,65,489,55,2010-11-20 06:22:28,2010-11-20 06:22:28
7ff5580d95f6bb40f12a0b90f51570e23b014a2d...a56e47400f099af6b0d0d6ef588e7f286ab60ed5,3,3,4,7,3,2010-11-20 10:49:42,2010-11-20 10:49:42
a56e47400f099af6b0d0d6ef588e7f286ab60ed5...58b6c65fa93c7a30d779bb8820f6ee9314bc4628,1,1,1,2,1,2010-11-20 11:10:48,2010-11-20 11:10:48
58b6c65fa93c7a30d779bb8820f6ee9314bc4628...790f0eb7fe0c88bf39595e6b70ddf40de5843b9d,1,1,1,2,1,2010-11-20 11:16:43,2010-11-20 11:16:43
790f0eb7fe0c88bf39595e6b70ddf40de5843b9d...ece3a7c3c73f46171ef8c5f51e2b28784fe57fab,1,1,1,2,1,2010-11-20 11:33:43,2010-11-20 11:33:43
ece3a7c3c73f46171ef8c5f51e2b28784fe57fab...d4c6abcbd10da9816a834883f3bfb05fb67222bc,2,21,1,22,3,2010-11-20 20:38:52,2010-11-20 20:38:52
d4c6abcbd10da9816a834883f3bfb05fb67222bc...e364f9ca7a21b3b931a618c71c638a113cdb8a3e,1,1,1,2,1,2010-11-20 20:40:16,2010-11-20 20:40:16
e364f9ca7a21b3b931a618c71c638a113cdb8a3e...d4bb8313f73020b63204e39de6599ec355b26933,1,6,6,12,1,2010-11-20 21:00:41,2010-11-20 21:00:41
d4bb8313f73020b63204e39de6599ec355b26933...7592d685411b35b0878b88c57df80eaeff22186f,1,5,2,7,3,2010-11-20 23:54:59,2010-11-20 23:54:59
7592d685411b35b0878b88c57df80eaeff22186f...9b432cb67bfc0648862cafb49868e670583050df,4,110,14,124,21,2010-11-21 02:28:25,2010-11-21 02:28:25
9b432cb67bfc0648862cafb49868e670583050df...f6ead36969844bd28277d5b300bf29ae7b67dea8,1,1,1,2,1,2010-11-21 08:03:58,2010-11-21 08:03:58
f6ead36969844bd28277d5b300bf29ae7b67dea8...b8a78804b50b9f14030ab1c7c43816672c08242c,2,14,4,18,4,2010-11-21 10:08:28,2010-11-21 10:08:28
b8a78804b50b9f14030ab1c7c43816672c08242c...70b3ac1f07b60dd1b6888b71fe20596fa64527dc,2,35,7,42,9,2010-11-21 13:47:38,2010-11-21 13:47:38
70b3ac1f07b60dd1b6888b71fe20596fa64527dc...14abb7c52c128c1ce903d8cfb295f9324081ad39,1,2,2,4,2,2010-11-21 14:06:32,2010-11-21 14:06:32
14abb7c52c128c1ce903d8cfb295f9324081ad39...f27e6f0dd198309e0d965ca78bf1c5fd04a29f8e,1,35,18,53,5,2010-11-21 14:54:23,2010-11-21 14:54:23
f27e6f0dd198309e0d965ca78bf1c5fd04a29f8e...67742073947efe60b103b2ebd07217d2a1c67e9d,2,8,2,10,3,2010-11-21 15:08:53,2010-11-21 15:08:53
67742073947efe60b103b2ebd07217d2a1c67e9d...752bd8bf75f1bf64e5014ee65b65b173197e5f53,1,11,5,16,4,2010-11-21 17:18:26,2010-11-21 17:18:26
752bd8bf75f1bf64e5014ee65b65b173197e5f53...65b380e74ab79ee011f7556e342dd4d656b018a5,4,93,13,106,14,2010-11-21 17:27:01,2010-11-21 17:27:01
65b380e74ab79ee011f7556e342dd4d656b018a5...aee9db9b3e620aa405dae1570d40b79da029ed78,1,3,3,6,6,2010-11-21 17:34:21,2010-11-21 17:34:21
aee9db9b3e620aa405dae1570d40b79da029ed78...73cd9b61c9142a72e19dae6c6bd97244eb7a8adc,1,2,2,4,2,2010-11-21 17:48:52,2010-11-21 17:48:52
73cd9b61c9142a72e19dae6c6bd97244eb7a8adc...f5f18a38ab990910ca43448212c70938992c9787,6,39,8,47,11,2010-11-21 17:51:41,2010-11-21 17:51:41
f5f18a38ab990910ca43448212c70938992c9787...0cf1c96d062f64275c5babc7687b301f0bfa3bc6,1,0,28,28,1,2010-11-21 18:08:00,2010-11-21 18:08:00
0cf1c96d062f64275c5babc7687b301f0bfa3bc6...274aba3b9b8c48012a2d842790cb3df04dc9ae80,5,49,4,53,11,2010-11-21 19:00:40,2010-11-21 19:00:40
274aba3b9b8c48012a2d842790cb3df04dc9ae80...dc334a2ba8dbf5134d65c97fea2785c3b2294ef5,12,316,47,363,38,2010-11-21 19:29:15,2010-11-21 19:29:15
dc334a2ba8dbf5134d65c97fea2785c3b2294ef5...d8c471b840f310aaab87b5b83abfab9ab73d9f2a,1,32,33,65,14,2010-11-22 06:08:38,2010-11-22 06:08:38
d8c471b840f310aaab87b5b83abfab9ab73d9f2a...25f3eda3cc306426fdd5645e5581c08050c80c05,2,54,45,99,25,2010-11-22 06:15:02,2010-11-22 06:15:02
25f3eda3cc306426fdd5645e5581c08050c80c05...6482dec29563a7d715ba489d0781b7d82be4b043,1,2,3,5,1,2010-11-22 06:44:19,2010-11-22 06:44:19
6482dec29563a7d715ba489d0781b7d82be4b043...cbd90455a08c6ec379ec647415fc96c21ef39834,1,6,3,9,1,2010-11-22 12:13:18,2010-11-22 12:13:18
cbd90455a08c6ec379ec647415fc96c21ef39834...2596cf1652d856d207b30b193051e33cb5f0b6b4,1,9,8,17,5,2010-11-22 12:29:22,2010-11-22 12:29:22
2596cf1652d856d207b30b193051e33cb5f0b6b4...07ba3220ba30b83952f69ae00c593c5770b880ec,3,23,10,33,10,2010-11-22 18:00:01,2010-11-22 18:00:01
07ba3220ba30b83952f69ae00c593c5770b880ec...3498849532151f618ff36eea4bd315de6f500687,3,17,7,24,5,2010-11-22 21:55:29,2010-11-22 21:55:29
3498849532151f618ff36eea4bd315de6f500687...2efb4757af8c6d6a757779e68671c1455dde95b6,4,20,4,24,6,2010-11-23 01:46:48,2010-11-23 01:46:48
2efb4757af8c6d6a757779e68671c1455dde95b6...4c5bf6c76ccad386563fd590d045a57501d6714e,1,7,0,7,1,2010-11-23 02:46:55,2010-11-23 02:46:55
4c5bf6c76ccad386563fd590d045a57501d6714e...8aa2485a58ea8139e9a769d36b07db809480994a,2,31,27,58,8,2010-11-23 03:54:13,2010-11-23 03:54:13
8aa2485a58ea8139e9a769d36b07db809480994a...ff7c243b4c1dcefb504b5b636b0631edfb5a46c2,2,16,10,26,8,2010-11-23 13:54:58,2010-11-23 13:54:58
ff7c243b4c1dcefb504b5b636b0631edfb5a46c2...4c519867904918d8cdf2ded91af3e87bd1c02664,2,17,1,18,2,2010-11-24 00:36:36,2010-11-24 00:36:36
4c519867904918d8cdf2ded91af3e87bd1c02664...3abcd9d3e2116656e4d26aa18e9c21e6791027ff,1,25,16,41,8,2010-11-24 11:52:15,2010-11-24 11:52:15
3abcd9d3e2116656e4d26aa18e9c21e6791027ff...073412b411c72b1ee0aeb8cc5ae6c03828347447,1,61,46,107,2,2010-11-24 15:26:29,2010-11-24 15:26:29
073412b411c72b1ee0aeb8cc5ae6c03828347447...4a4d7bc27deb2219d534986f825f0a4fd7d55027,1,1,1,2,1,2010-11-24 19:51:31,2010-11-24 19:51:31
4a4d7bc27deb2219d534986f825f0a4fd7d55027...4ddde2f8d571adb0db269e2be6119ec4f06f0d05,1,49,13,62,6,2010-11-25 12:37:28,2010-11-25 12:37:28
4ddde2f8d571adb0db269e2be6119ec4f06f0d05...188324881c0acdba74d50d26ab672a5cfcb4e983,1,1,1,2,1,2010-11-26 02:14:57,2010-11-26 02:14:57
188324881c0acdba74d50d26ab672a5cfcb4e983...aff9ff9bf52c71790cd1f37eb0f6a426b98e8338,1,2,2,4,1,2010-11-26 02:28:07,2010-11-26 02:28:07
aff9ff9bf52c71790cd1f37eb0f6a426b98e8338...e2bcf7d5d221dbb8deced71f497797fdf8a91660,1,7,7,14,5,2010-11-26 02:56:58,2010-11-26 02:56:58
e2bcf7d5d221dbb8deced71f497797fdf8a91660...37d50ac12f1fc6f393b392a7a9ff32b49acd0e3d,1,8,1,9,2,2010-11-26 12:30:25,2010-11-26 12:30:25
37d50ac12f1fc6f393b392a7a9ff32b49acd0e3d...044d5a2432bd6539dc8eb176189e2dbf575573cf,1,1,1,2,1,2010-11-26 12:40:09,2010-11-26 12:40:09
044d5a2432bd6539dc8eb176189e2dbf575573cf...ba21814583e5e3a4fafc4f5f34a26b6acdfb7590,1,22,22,44,13,2010-11-26 13:01:56,2010-11-26 13:01:56
ba21814583e5e3a4fafc4f5f34a26b6acdfb7590...78be884ea788835ad98ad433862a82cf192c3d4f,9,150,13,163,19,2010-11-26 13:30:50,2010-11-26 13:30:50
78be884ea788835ad98ad433862a82cf192c3d4f...ab578bfe6310072a79bd1214be587354656e7ad8,7,8,8,16,7,2010-11-26 13:32:32,2010-11-26 13:32:32
ab578bfe6310072a79bd1214be587354656e7ad8...81323cb119132cf9d1aff9fd2e2af1aec3766eda,2,2,2,4,1,2010-11-26 13:32:58,2010-11-26 13:32:58
81323cb119132cf9d1aff9fd2e2af1aec3766eda...132afbf8eee837b6fe2d051f7eced4889e19de88,7,112,2,114,10,2010-11-26 13:33:27,2010-11-26 13:33:27
132afbf8eee837b6fe2d051f7eced4889e19de88...6a32e253f68b62b75d787f698ebaef461886c21c,5,82,27,109,30,2010-11-26 13:33:53,2010-11-26 13:33:53
6a32e253f68b62b75d787f698ebaef461886c21c...3cbaf3c2b66ada38bb1ca01b6404350ef5345f9e,1,12,12,24,2,2010-11-26 13:38:39,2010-11-26 13:38:39
3cbaf3c2b66ada38bb1ca01b6404350ef5345f9e...678f626c24f389b03d4bfe2c552c33e9bdcc9379,6,66,21,87,19,2010-11-26 14:24:08,2010-11-26 14:24:08
678f626c24f389b03d4bfe2c552c33e9bdcc9379...5dd1276cb86c01a67bb3bd3c432d2eafe4c186d2,1,8,7,15,5,2010-11-26 15:00:19,2010-11-26 15:00:19
5dd1276cb86c01a67bb3bd3c432d2eafe4c186d2...5fc9cbc15b78abee14f2a43478cd6c86dfe542d4,1,17,15,32,6,2010-11-26 16:53:38,2010-11-26 16:53:38
5fc9cbc15b78abee14f2a43478cd6c86dfe542d4...0be14b0b9647b1662c41e7e408072ebe19f28929,13,1053,1022,2075,21,2010-11-27 05:47:30,2010-11-27 05:47:30
0be14b0b9647b1662c41e7e408072ebe19f28929...750325505efc7f522bb303001995f9d4dc6d64d4,1,15,16,31,10,2010-11-27 12:19:21,2010-11-27 12:19:21
750325505efc7f522bb303001995f9d4dc6d64d4...fd072adf4a9926072c17def5dfa0bb5a493d5873,1,8,6,14,5,2010-11-27 12:27:43,2010-11-27 12:27:43
fd072adf4a9926072c17def5dfa0bb5a493d5873...60784363cf55a66b1e97906700d9de5f8d87916c,1,0,1,1,1,2010-11-27 12:34:14,2010-11-27 12:34:14
60784363cf55a66b1e97906700d9de5f8d87916c...d9eb31a98fc1ef3a0772fe3f6ff30b839710edd2,1,1,1,2,1,2010-11-27 18:36:41,2010-11-27 18:36:41
d9eb31a98fc1ef3a0772fe3f6ff30b839710edd2...6051a7def16f6fe8e617e70d3520513bd8ae1d73,1,2,3,5,2,2010-11-27 21:47:08,2010-11-27 21:47:08
6051a7def16f6fe8e617e70d3520513bd8ae1d73...9d3b3d11f434ef3a50402fb8a937ded61e0dbd06,2,22,22,44,21,2010-11-27 21:58:20,2010-11-27 21:58:20
9d3b3d11f434ef3a50402fb8a937ded61e0dbd06...e74edb4d53b089ec57ec4830eeba98607283a092,4,113,38,151,24,2010-11-27 22:43:33,2010-11-27 22:43:33
e74edb4d53b089ec57ec4830eeba98607283a092...d3f5f219f5f42ac3504ed626dcb92f4ee2dc3d5f,3,86,52,138,15,2010-11-28 02:50:31,2010-11-28 02:50:31
d3f5f219f5f42ac3504ed626dcb92f4ee2dc3d5f...676c28ce8c311445dd476312144eb4e273235ac5,1,4,4,8,3,2010-11-28 17:49:43,2010-11-28 17:49:43
676c28ce8c311445dd476312144eb4e273235ac5...b31a956d57d49c3f332b48c807c3bcffdb8eea9b,1,93,89,182,47,2010-11-28 18:15:40,2010-11-28 18:15:40
b31a956d57d49c3f332b48c807c3bcffdb8eea9b...7a81ac5197db7883166dca9a9fc9525e7bf3f725,1,4,2,6,2,2010-11-28 18:36:01,2010-11-28 18:36:01
7a81ac5197db7883166dca9a9fc9525e7bf3f725...22d4ecb19b378a717de41941571c55a05355b19e,1,1,1,2,1,2010-11-28 18:48:55,2010-11-28 18:48:55
22d4ecb19b378a717de41941571c55a05355b19e...2fa0fd2d0cb48f2ea49b971b8e4a06684bad8c83,1,21,8,29,9,2010-11-28 20:14:04,2010-11-28 20:14:04
2fa0fd2d0cb48f2ea49b971b8e4a06684bad8c83...08daa3df4781a886f6555f7fc5aafe2e54671e31,1,36,20,56,20,2010-11-29 00:55:04,2010-11-29 00:55:04
08daa3df4781a886f6555f7fc5aafe2e54671e31...a0b3306349ad4368b842389774bfaf9174fae119,1,34,23,57,9,2010-11-29 05:30:11,2010-11-29 05:30:11
a0b3306349ad4368b842389774bfaf9174fae119...5f63c01b50761c4dd810025ee0ef5eb4783bd013,1,25,2,27,2,2010-11-29 06:24:14,2010-11-29 06:24:14
5f63c01b50761c4dd810025ee0ef5eb4783bd013...a77fad23c255582c3a2e56ae20b50d27e6c8eac7,1,1,1,2,1,2010-11-30 12:46:22,2010-11-30 12:46:22
a77fad23c255582c3a2e56ae20b50d27e6c8eac7...e4b0a8f93c7cff2da06090726567944fcf7d04d7,1,20,0,20,3,2010-11-30 21:21:37,2010-11-30 21:21:37
e4b0a8f93c7cff2da06090726567944fcf7d04d7...0714b0f39033a51e447bc1b3b03ffee6f9228105,2,18,1,19,2,2010-11-30 21:27:26,2010-11-30 21:27:26
0714b0f39033a51e447bc1b3b03ffee6f9228105...2fa22a4b6414235a38fa646b2c6e17e49630185f,1,14,4,18,3,2010-11-30 22:14:03,2010-11-30 22:14:03
2fa22a4b6414235a38fa646b2c6e17e49630185f...4858a8d9f3621eb053dfadd9f733db8b325f0b75,1,2,3,5,2,2010-12-01 15:06:25,2010-12-01 15:06:25
4858a8d9f3621eb053dfadd9f733db8b325f0b75...21f5dc467e3e05dfcdf6e0aedce8f680c7ba7f12,2,2,2,4,2,2010-12-01 17:53:22,2010-12-01 17:53:22
21f5dc467e3e05dfcdf6e0aedce8f680c7ba7f12...cd847db17fbb578c580c54ac41dcb899ef3b9cb0,1,10,10,20,8,2010-12-01 21:35:54,2010-12-01 21:35:54
cd847db17fbb578c580c54ac41dcb899ef3b9cb0...dceaa82dec9f97ac77754dfdc737852d8171c8a2,5,60,16,76,14,2010-12-01 22:25:17,2010-12-01 22:25:17
dceaa82dec9f97ac77754dfdc737852d8171c8a2...1f68dc4ad4ddc67831c6aa047683a5b53fa33a37,2,23,1,24,3,2010-12-01 23:36:56,2010-12-01 23:36:56
1f68dc4ad4ddc67831c6aa047683a5b53fa33a37...a172ed00afb896fdf222b6a9db33995c1194b7af,1,2,0,2,1,2010-12-02 00:43:19,2010-12-02 00:43:19
a172ed00afb896fdf222b6a9db33995c1194b7af...3d5bb27945e1fc0727309c3656b7727fca3eed28,1,5,4,9,3,2010-12-02 00:43:36,2010-12-02 00:43:36
3d5bb27945e1fc0727309c3656b7727fca3eed28...07705ca12982b6a87cfd9f62723153fb94f151b2,1,91,46,137,21,2010-12-02 00:43:52,2010-12-02 00:43:52
07705ca12982b6a87cfd9f62723153fb94f151b2...cc64fb5c4b4315a4ad66e21458e27ece57266847,12,296,216,512,79,2010-12-02 00:44:35,2010-12-02 00:44:35
cc64fb5c4b4315a4ad66e21458e27ece57266847...16c21bc45a9c3b2ba0109a99c3658d1f992a3099,1,1,1,2,1,2010-12-02 00:44:55,2010-12-02 00:44:55
16c21bc45a9c3b2ba0109a99c3658d1f992a3099...7421f7269ea8013b015d69bc8c3ba24d2ab6a5df,131,222,230,452,290,2010-12-02 00:48:56,2010-12-02 00:48:56
7421f7269ea8013b015d69bc8c3ba24d2ab6a5df...fb391b8b98e9e6a3dc89cfb43892f96cf70d199c,1,2,2,4,2,2010-12-02 00:49:15,2010-12-02 00:49:15
fb391b8b98e9e6a3dc89cfb43892f96cf70d199c...0f879195a6bf2778359020e2f8afff4b6e670ca1,14,160,346,506,75,2010-12-02 05:58:21,2010-12-02 05:58:21
0f879195a6bf2778359020e2f8afff4b6e670ca1...1c9a506d21b508f208b2bcd5410ecd4b27f62560,1,2,1,3,2,2010-12-02 14:26:42,2010-12-02 14:26:42
1c9a506d21b508f208b2bcd5410ecd4b27f62560...300a5b32e651e2fae3bb0e8106389c8992aa2d8c,1,2,1,3,2,2010-12-02 14:27:03,2010-12-02 14:27:03
300a5b32e651e2fae3bb0e8106389c8992aa2d8c...bb10a5ba79ecaea7d32b62afe90e83407adf0b74,1,17,15,32,3,2010-12-02 22:37:15,2010-12-02 22:37:15
bb10a5ba79ecaea7d32b62afe90e83407adf0b74...cbf9d6e0bbc323a81449250f139944e4c0b23b2c,1,25,6,31,2,2010-12-03 00:54:39,2010-12-03 00:54:39
cbf9d6e0bbc323a81449250f139944e4c0b23b2c...5475da1c32efacab3d740bc599f19f2f33be6d2c,2,10,1,11,3,2010-12-03 18:15:54,2010-12-03 18:15:54
5475da1c32efacab3d740bc599f19f2f33be6d2c...d68598e0220908ca82cf98ba769e618404c010c8,2,11,2,13,4,2010-12-03 20:25:59,2010-12-03 20:25:59
d68598e0220908ca82cf98ba769e618404c010c8...174f222b39312f7152b0116f92bb07a15ae2160f,1,2,2,4,2,2010-12-04 00:50:49,2010-12-04 00:50:49
174f222b39312f7152b0116f92bb07a15ae2160f...f964a3b1ee9c735c780fc45dfbd0e9dae7d836f8,1,1,1,2,1,2010-12-04 04:27:05,2010-12-04 04:27:05
f964a3b1ee9c735c780fc45dfbd0e9dae7d836f8...19afc46c3367ea342b034beb8e0778ca00f9febd,2,1,1,2,1,2010-12-04 04:27:45,2010-12-04 04:27:45
19afc46c3367ea342b034beb8e0778ca00f9febd...b5754e60b4ed4fcead9fdfcf3dcdcac329662ebe,3,36,36,72,6,2010-12-04 04:28:17,2010-12-04 04:28:17
b5754e60b4ed4fcead9fdfcf3dcdcac329662ebe...34a386378ff4ac5081017691eb4eff83e30c8aa0,3,19,1,20,4,2010-12-04 04:47:59,2010-12-04 04:47:59
34a386378ff4ac5081017691eb4eff83e30c8aa0...ae7213b593b829734d00619ec7a7b45f22bdd000,9,296,6,302,12,2010-12-04 05:25:24,2010-12-04 05:25:24
ae7213b593b829734d00619ec7a7b45f22bdd000...79adb5151481dde4ff72464e15afba94e1739223,2,12,7,19,2,2010-12-04 05:35:15,2010-12-04 05:35:15
79adb5151481dde4ff72464e15afba94e1739223...52c77803d2b0852e6cf23d0c673131ce28934261,1,4,4,8,2,2010-12-04 05:59:38,2010-12-04 05:59:38
52c77803d2b0852e6cf23d0c673131ce28934261...5b8ef18dcc006c0fa53b356efbb7cf2c691463d5,2,10,3,13,3,2010-12-04 05:59:56,2010-12-04 05:59:56
5b8ef18dcc006c0fa53b356efbb7cf2c691463d5...6770c3626271569da41053c1cfd37f7128f1457f,1,13,13,26,2,2010-12-04 06:49:51,2010-12-04 06:49:51
6770c3626271569da41053c1cfd37f7128f1457f...5bc0ec4ec4b7c888a291bc81b2edd72812231d96,30,385,378,763,307,2010-12-04 07:28:12,2010-12-04 07:28:12
5bc0ec4ec4b7c888a291bc81b2edd72812231d96...ac91d5ef086f466c27e77157c67fe4f1df9b7557,2,5,1,6,3,2010-12-04 07:44:00,2010-12-04 07:44:00
ac91d5ef086f466c27e77157c67fe4f1df9b7557...324658ef265fb9a4c5cc695a4b0f560575048604,5,38,2,40,8,2010-12-04 11:20:30,2010-12-04 11:20:30
324658ef265fb9a4c5cc695a4b0f560575048604...adfd7f81729b3bd7eaff8b86546c34b2207138b3,4,10,5,15,4,2010-12-04 11:20:52,2010-12-04 11:20:52
adfd7f81729b3bd7eaff8b86546c34b2207138b3...5a7af25c7a02ef6203a82acb6cc9098bb0b3d514,1,12,0,12,1,2010-12-04 11:35:22,2010-12-04 11:35:22
5a7af25c7a02ef6203a82acb6cc9098bb0b3d514...23f69af45409a29146f215058974898baa7e2207,7,34,15,49,14,2010-12-04 17:42:54,2010-12-04 17:42:54
23f69af45409a29146f215058974898baa7e2207...76c2c30daf15c36de4d08040a4f37e35959c0a88,1,4,4,8,2,2010-12-04 20:20:54,2010-12-04 20:20:54
76c2c30daf15c36de4d08040a4f37e35959c0a88...00f36e0ebf1f7fb78309947a67bad3d8ca4d5508,1,108,108,216,37,2010-12-04 20:41:35,2010-12-04 20:41:35
00f36e0ebf1f7fb78309947a67bad3d8ca4d5508...097072aee4ff3ebee0373cb996b9ee49e35400f0,1,24,0,24,1,2010-12-04 20:58:07,2010-12-04 20:58:07
097072aee4ff3ebee0373cb996b9ee49e35400f0...111ed0195e8ff53f83b1ac74d6822111f8942727,1,37,5,42,5,2010-12-04 22:32:01,2010-12-04 22:32:01
111ed0195e8ff53f83b1ac74d6822111f8942727...b11c21d69a2d16aa104cb1313691aa5c5efc2468,3,191,13,204,9,2010-12-05 00:44:34,2010-12-05 00:44:34
b11c21d69a2d16aa104cb1313691aa5c5efc2468...d53fd71acb7a6bcce376152a794a533364655bf4,2,19,7,26,6,2010-12-05 01:03:39,2010-12-05 01:03:39
d53fd71acb7a6bcce376152a794a533364655bf4...50e3b9d02899000a67204f531d75a5cfd6353ab6,1,2,0,2,1,2010-12-05 01:23:23,2010-12-05 01:23:23
50e3b9d02899000a67204f531d75a5cfd6353ab6...23a19240da9894c9784952693d194c8894f077cf,1,1,0,1,1,2010-12-05 02:07:46,2010-12-05 02:07:46
23a19240da9894c9784952693d194c8894f077cf...ee48da24050a4f447f6ba153430c59b93a1522b3,5,59,2,61,10,2010-12-05 04:32:36,2010-12-05 04:32:36
ee48da24050a4f447f6ba153430c59b93a1522b3...4a1f2129d09658e705fbe0660275c6efccf1474a,3,95,8,103,7,2010-12-05 04:47:19,2010-12-05 04:47:19
4a1f2129d09658e705fbe0660275c6efccf1474a...01f2081bb6145c9b6d12aee9a5ec36fc7649efcf,1,625,603,1228,239,2010-12-05 04:52:31,2010-12-05 04:52:31
01f2081bb6145c9b6d12aee9a5ec36fc7649efcf...0ab50aad36f849d710a0ac053a99eb058e489e24,2,117,53,170,26,2010-12-05 06:45:34,2010-12-05 06:45:34
0ab50aad36f849d710a0ac053a99eb058e489e24...2dd594dff4f68f36b345f454738c35f01e5dd48e,3,79,65,144,29,2010-12-05 07:35:10,2010-12-05 07:35:10
2dd594dff4f68f36b345f454738c35f01e5dd48e...4800b467465cca14efa9ea5954add56572e19e0d,1,20,18,38,8,2010-12-05 16:47:39,2010-12-05 16:47:39
4800b467465cca14efa9ea5954add56572e19e0d...ffa4badbd89412e28323e89ea7980c6b5f4bc5a3,1,35,32,67,14,2010-12-05 23:52:23,2010-12-05 23:52:23
ffa4badbd89412e28323e89ea7980c6b5f4bc5a3...06850baefa4987faedd543155ad3538f103c4d9e,1,1,1,2,1,2010-12-06 00:01:52,2010-12-06 00:01:52
06850baefa4987faedd543155ad3538f103c4d9e...0f5a7e07751aa71960331ce9c33b0b114a8875d3,1,49,37,86,18,2010-12-06 01:55:16,2010-12-06 01:55:16
0f5a7e07751aa71960331ce9c33b0b114a8875d3...b407de3bc56f2676bca214a302b1ea7d64b16d6b,1,10,8,18,4,2010-12-06 11:49:31,2010-12-06 11:49:31
b407de3bc56f2676bca214a302b1ea7d64b16d6b...29c4a578af58f6da7c77830a0ff99260f2338d36,6,103,32,135,42,2010-12-06 14:21:51,2010-12-06 14:21:51
29c4a578af58f6da7c77830a0ff99260f2338d36...5fadc862007a967dcb66774a78fee7c4808c6a69,1,1,1,2,1,2010-12-06 21:54:49,2010-12-06 21:54:49
5fadc862007a967dcb66774a78fee7c4808c6a69...4a1fd44c0f19a6d5f7c90cba5c6460f9c4ebc79a,1,1,1,2,1,2010-12-06 23:07:46,2010-12-06 23:07:46
4a1fd44c0f19a6d5f7c90cba5c6460f9c4ebc79a...22fc30be5a54d1027956a9ae668eb24d401483bc,1,26,0,26,1,2010-12-06 23:08:44,2010-12-06 23:08:44
22fc30be5a54d1027956a9ae668eb24d401483bc...e0dcd7666aec15a2348bef346b4ce683ddf376b3,19,842,210,1052,95,2010-12-07 13:57:01,2010-12-07 13:57:01
e0dcd7666aec15a2348bef346b4ce683ddf376b3...061a9cad675a536e50a18650d0a1c78c54c0c670,1,2,2,4,2,2010-12-07 14:59:57,2010-12-07 14:59:57
061a9cad675a536e50a18650d0a1c78c54c0c670...68a04f2d629cf0f556a968bfeeb54eeaca7af080,1,69,57,126,22,2010-12-08 00:27:07,2010-12-08 00:27:07
68a04f2d629cf0f556a968bfeeb54eeaca7af080...3863c906ce65c56e700ae3631639b746a0a596d3,1,1,0,1,1,2010-12-08 04:03:07,2010-12-08 04:03:07
3863c906ce65c56e700ae3631639b746a0a596d3...b8c368feb254b225edacb50de13c9037cfd1ef9c,1,5,2,7,1,2010-12-08 07:56:43,2010-12-08 07:56:43
b8c368feb254b225edacb50de13c9037cfd1ef9c...2a463231248df5eacaf0d88af45d7bc4f462a88e,1,17,9,26,7,2010-12-08 18:31:57,2010-12-08 18:31:57
2a463231248df5eacaf0d88af45d7bc4f462a88e...a4898dc50b17542f48cc01bad1c4135c7a6424b3,1,1,2,3,1,2010-12-08 18:37:00,2010-12-08 18:37:00
a4898dc50b17542f48cc01bad1c4135c7a6424b3...e0d8c5fca26bbe20cc26226e794dbb0e61a3467b,3,25,13,38,10,2010-12-08 23:48:28,2010-12-08 23:48:28
e0d8c5fca26bbe20cc26226e794dbb0e61a3467b...c58d25cf8d4078ec843a4547a025f830b66b1fbc,2,6,6,12,3,2010-12-09 00:26:59,2010-12-09 00:26:59
c58d25cf8d4078ec843a4547a025f830b66b1fbc...b37d867929f41a81feb0954023471d7c50081e41,1,2,2,4,2,2010-12-09 00:47:37,2010-12-09 00:47:37
b37d867929f41a81feb0954023471d7c50081e41...ff8711a825ea9bbe98e873d7aa28ce5135528fec,4,16,9,25,8,2010-12-09 02:34:14,2010-12-09 02:34:14
ff8711a825ea9bbe98e873d7aa28ce5135528fec...2e909489d7601c59595e81e2b491dfc689abd778,2,39,40,79,14,2010-12-10 03:51:30,2010-12-10 03:51:30
2e909489d7601c59595e81e2b491dfc689abd778...f0753ef211f0349bc8f94959c1f88edbac9758db,1,7,7,14,2,2010-12-11 13:29:47,2010-12-11 13:29:47
f0753ef211f0349bc8f94959c1f88edbac9758db...82f2daaf451874a37ee3e5aa5bfd806a4a130ef5,2,8,0,8,2,2010-12-11 13:51:14,2010-12-11 13:51:14
82f2daaf451874a37ee3e5aa5bfd806a4a130ef5...9af06cbb632bc291db346ee778f83159a811803e,1,5,0,5,1,2010-12-11 15:04:25,2010-12-11 15:04:25
9af06cbb632bc291db346ee778f83159a811803e...aa05224dba4f77a9e30454245fa59db9038f597c,2,98,293,391,14,2010-12-12 04:33:38,2010-12-12 04:33:38
aa05224dba4f77a9e30454245fa59db9038f597c...575962c213c7e6b7393c9ba43ecbb11389ff7c8b,4,56,86,142,11,2010-12-12 04:33:50,2010-12-12 04:33:50
575962c213c7e6b7393c9ba43ecbb11389ff7c8b...462d3115a32ca2f2dfb28231495bc9a42e828e47,4,21,2,23,5,2010-12-12 22:53:49,2010-12-12 22:53:49
462d3115a32ca2f2dfb28231495bc9a42e828e47...6261593b998ed205b3d45833926cf75756384a13,1,7,1,8,4,2010-12-12 22:54:04,2010-12-12 22:54:04
6261593b998ed205b3d45833926cf75756384a13...88ff6567310d809abddb97adebf04d5e9403ca8a,1,2,2,4,2,2010-12-12 22:54:22,2010-12-12 22:54:22
88ff6567310d809abddb97adebf04d5e9403ca8a...2c2209b473aeec85d16ac24469383cf0e214273b,4,120,1,121,5,2010-12-12 22:54:50,2010-12-12 22:54:50
2c2209b473aeec85d16ac24469383cf0e214273b...966d3562d484ddea7f9c4d08e03c255d48e5c85e,1,13,0,13,2,2010-12-12 22:55:10,2010-12-12 22:55:10
966d3562d484ddea7f9c4d08e03c255d48e5c85e...1e7bb904df8f422686da4d3464afcce1366209d8,1,4,0,4,1,2010-12-12 22:55:33,2010-12-12 22:55:33
1e7bb904df8f422686da4d3464afcce1366209d8...b3520da9ac113ed435cb6aa135b0559780d9c530,4,97,23,120,13,2010-12-12 22:56:01,2010-12-12 22:56:01
b3520da9ac113ed435cb6aa135b0559780d9c530...d0257a1558524158379bc2bf6bef2bc2a8811840,6,92,6,98,14,2010-12-12 22:56:29,2010-12-12 22:56:29
d0257a1558524158379bc2bf6bef2bc2a8811840...8dfd3dfd4907bf1083b4ed22da78fb3c1ff8787b,2,2,2,4,2,2010-12-12 22:56:52,2010-12-12 22:56:52
8dfd3dfd4907bf1083b4ed22da78fb3c1ff8787b...dad28e8557203c8c104354cbac0349bfba5cba77,3,13,3,16,4,2010-12-12 22:57:17,2010-12-12 22:57:17
dad28e8557203c8c104354cbac0349bfba5cba77...34daa0804c768a6cdeb31d123833b66b5ad89f3c,2,19,0,19,2,2010-12-12 22:57:37,2010-12-12 22:57:37
34daa0804c768a6cdeb31d123833b66b5ad89f3c...3d35ac786800ddcea3b2cb59d04a29fb25636155,2,4,4,8,2,2010-12-12 22:57:58,2010-12-12 22:57:58
3d35ac786800ddcea3b2cb59d04a29fb25636155...a03a8adb3e46a2df78de604340e729766ae2c18a,5,30,0,30,6,2010-12-12 22:58:25,2010-12-12 22:58:25
a03a8adb3e46a2df78de604340e729766ae2c18a...d8165ce1566771960cf33e414c1a6e643fd46dea,2,24,1,25,3,2010-12-12 22:58:47,2010-12-12 22:58:47
d8165ce1566771960cf33e414c1a6e643fd46dea...867e935c51d337e656f9aefc7c475747c64596b2,1,1,0,1,1,2010-12-12 22:59:03,2010-12-12 22:59:03
867e935c51d337e656f9aefc7c475747c64596b2...674c671cae5119146a302411b3f13e706577f47f,4,351,2,353,5,2010-12-12 22:59:28,2010-12-12 22:59:28
674c671cae5119146a302411b3f13e706577f47f...1aca34cde28b576b236985df45782e0715ab9cfb,1,6,0,6,1,2010-12-12 22:59:47,2010-12-12 22:59:47
1aca34cde28b576b236985df45782e0715ab9cfb...5fa1169f33efd06bef28d1cdc6ed5a0748e9254e,62,321,0,321,124,2010-12-12 23:02:10,2010-12-12 23:02:10
5fa1169f33efd06bef28d1cdc6ed5a0748e9254e...9ab85e05e284ba407554a0b9658b156a32110b91,6,564,9,573,19,2010-12-12 23:02:45,2010-12-12 23:02:45
9ab85e05e284ba407554a0b9658b156a32110b91...47a5153da4216db4a4262047c513450a2a154d62,1,27,6,33,3,2010-12-12 23:03:03,2010-12-12 23:03:03
47a5153da4216db4a4262047c513450a2a154d62...05eb53603c69b46b70226bfdb2242732b2b169fa,2,9,4,13,4,2010-12-12 23:03:24,2010-12-12 23:03:24
05eb53603c69b46b70226bfdb2242732b2b169fa...dc8c4f087980dc746e41bebc47a53f95a0cbb0c3,1,1,1,2,1,2010-12-13 13:20:02,2010-12-13 13:20:02
dc8c4f087980dc746e41bebc47a53f95a0cbb0c3...7292af85422980df3fefcd0ce131f8a37fe466e9,3,24,3,27,6,2010-12-13 13:51:28,2010-12-13 13:51:28
7292af85422980df3fefcd0ce131f8a37fe466e9...2478f8588e4ed3164a05246f28cc02e5850dd0b8,21,433,13,446,20,2010-12-13 13:52:21,2010-12-13 13:52:21
2478f8588e4ed3164a05246f28cc02e5850dd0b8...6ec348fb41114ef4bd39c24de9ba089d44187b0c,6,57,17,74,14,2010-12-13 13:52:52,2010-12-13 13:52:52
6ec348fb41114ef4bd39c24de9ba089d44187b0c...68548c3effaddfe726bc64abd0ac88b4996bdd28,1,2,0,2,2,2010-12-13 19:37:18,2010-12-13 19:37:18
68548c3effaddfe726bc64abd0ac88b4996bdd28...5c86831ac55b7e0a23ad0feefb471fc5341e302c,1,1,1,2,1,2010-12-14 00:37:42,2010-12-14 00:37:42
5c86831ac55b7e0a23ad0feefb471fc5341e302c...f7f75879586be5195c5bcbc6de62974b1bca6dcd,2,386,385,771,230,2010-12-14 11:53:18,2010-12-14 11:53:18
f7f75879586be5195c5bcbc6de62974b1bca6dcd...c3143783ca74d049ebdde09074d08dfd548fa8fa,1,1,1,2,1,2010-12-14 23:34:47,2010-12-14 23:34:47
c3143783ca74d049ebdde09074d08dfd548fa8fa...dc2a3f828007bf031b7fea07ffa78c36024de0eb,1,2,2,4,2,2010-12-14 23:43:36,2010-12-14 23:43:36
dc2a3f828007bf031b7fea07ffa78c36024de0eb...689234890c22612ba6abdd551da3c46a5e681f1e,2,62,49,111,4,2010-12-15 14:48:19,2010-12-15 14:48:19
689234890c22612ba6abdd551da3c46a5e681f1e...87315cc22d3177251f0a015abf6c0092883e558c,4,7,7,14,5,2010-12-16 12:11:20,2010-12-16 12:11:20
87315cc22d3177251f0a015abf6c0092883e558c...99742d8d73c3cc64014b5831c84c17928628c3f9,1,1,1,2,1,2010-12-16 22:37:29,2010-12-16 22:37:29
99742d8d73c3cc64014b5831c84c17928628c3f9...3ae9117c467f9fabed8736949dee209d40293b8d,8,274,83,357,53,2010-12-18 02:50:26,2010-12-18 02:50:26
3ae9117c467f9fabed8736949dee209d40293b8d...8d10e0c3252fafead53b4f71602acee9b7c70429,1,5,0,5,1,2010-12-18 14:04:39,2010-12-18 14:04:39
8d10e0c3252fafead53b4f71602acee9b7c70429...78f0ab7eb0620e93826288ee54de309253012204,1,5,0,5,1,2010-12-18 15:37:12,2010-12-18 15:37:12
78f0ab7eb0620e93826288ee54de309253012204...152ae52a6dd89fd7ff19ec8d6ea0c78c5ecc67a8,1,2,1,3,1,2010-12-18 17:37:19,2010-12-18 17:37:19
152ae52a6dd89fd7ff19ec8d6ea0c78c5ecc67a8...c9b79c59bb102c85d6b968a126abec6ae966e814,3,41,125,166,9,2010-12-18 20:29:07,2010-12-18 20:29:07
c9b79c59bb102c85d6b968a126abec6ae966e814...b035759199cce68164402e2dc1bc2b72de6aca2d,1,72,87,159,6,2010-12-18 20:29:16,2010-12-18 20:29:16
b035759199cce68164402e2dc1bc2b72de6aca2d...0cd72cabab8d94b33b1dd3f72518ed7f12521c54,3,138,214,352,13,2010-12-18 20:29:25,2010-12-18 20:29:25
0cd72cabab8d94b33b1dd3f72518ed7f12521c54...3ed85841d1928bce2ce68b7e70c63ae8b48dd206,3,80,254,334,10,2010-12-18 20:29:44,2010-12-18 20:29:44
3ed85841d1928bce2ce68b7e70c63ae8b48dd206...7fdfec7a3c145f2bd54a12f891810a8b5cfe8d03,3,73,56,129,9,2010-12-18 20:29:54,2010-12-18 20:29:54
7fdfec7a3c145f2bd54a12f891810a8b5cfe8d03...cc8c3ebb7dda2301810e54b0599fa5b9fe01b1f2,4,67,83,150,9,2010-12-18 20:30:05,2010-12-18 20:30:05
cc8c3ebb7dda2301810e54b0599fa5b9fe01b1f2...b148aead7d54a0e5e6ebfd02c7b46bb6a396a0ec,3,173,348,521,7,2010-12-18 20:30:16,2010-12-18 20:30:16
b148aead7d54a0e5e6ebfd02c7b46bb6a396a0ec...eb4b1ab1a0397871bd0ab4c600b2f80ffb17a8d9,3,36,97,133,12,2010-12-18 20:30:28,2010-12-18 20:30:28
eb4b1ab1a0397871bd0ab4c600b2f80ffb17a8d9...6127cf13cd6d6e20172b105b231ab9561718f0ef,3,36,113,149,11,2010-12-18 20:30:38,2010-12-18 20:30:38
6127cf13cd6d6e20172b105b231ab9561718f0ef...1eee7757b79a13e386500aefbee8ab4939b9d88c,3,83,158,241,12,2010-12-18 20:30:50,2010-12-18 20:30:50
1eee7757b79a13e386500aefbee8ab4939b9d88c...55c81c36e64b74342b60af67fb8712856f504d4c,4,194,168,362,18,2010-12-18 20:31:00,2010-12-18 20:31:00
55c81c36e64b74342b60af67fb8712856f504d4c...b5ac6956a626e9a057628e6205547d070ca03f02,3,42,11,53,8,2010-12-18 20:31:10,2010-12-18 20:31:10
b5ac6956a626e9a057628e6205547d070ca03f02...6a362d368411052ca8d3f0058d82b657eae846f5,2,36,53,89,6,2010-12-18 20:31:22,2010-12-18 20:31:22
6a362d368411052ca8d3f0058d82b657eae846f5...58bc8819909ff1f867b3c7b0f6cb283e589d99c0,3,197,101,298,8,2010-12-18 20:31:37,2010-12-18 20:31:37
58bc8819909ff1f867b3c7b0f6cb283e589d99c0...f8caeefff193e4ace0db13c7213194be933584f7,4,71,63,134,12,2010-12-18 20:31:49,2010-12-18 20:31:49
f8caeefff193e4ace0db13c7213194be933584f7...6e3be3b578477dfef5f66ec40f5dc36338f28b56,3,25,58,83,9,2010-12-18 20:31:58,2010-12-18 20:31:58
6e3be3b578477dfef5f66ec40f5dc36338f28b56...79ea397b5d19357a7b17c35b67e2009b92e6c6f3,3,18,17,35,5,2010-12-18 20:32:08,2010-12-18 20:32:08
79ea397b5d19357a7b17c35b67e2009b92e6c6f3...187a11e1f14ed655c98ad94699ccfb314f6690ea,3,64,74,138,5,2010-12-18 20:32:17,2010-12-18 20:32:17
187a11e1f14ed655c98ad94699ccfb314f6690ea...f9e6ca10265ed59459932fa6eb73a7527dbd5c7c,4,467,89,556,13,2010-12-18 20:32:31,2010-12-18 20:32:31
f9e6ca10265ed59459932fa6eb73a7527dbd5c7c...8f012072afb2d4ec25cddab29cf0b9ef605bf138,3,30,104,134,9,2010-12-18 20:32:41,2010-12-18 20:32:41
8f012072afb2d4ec25cddab29cf0b9ef605bf138...d01cb6ed17647ed8af8b5c3d083fbd3ca21039df,4,148,177,325,9,2010-12-18 20:32:54,2010-12-18 20:32:54
d01cb6ed17647ed8af8b5c3d083fbd3ca21039df...023329c3c1dd1d167f4b58773f417ae2edeaabfc,3,113,28,141,10,2010-12-18 20:33:04,2010-12-18 20:33:04
023329c3c1dd1d167f4b58773f417ae2edeaabfc...4adec427044dcc7b8cd8a11a6f53157e1d4854dd,3,30,66,96,7,2010-12-18 20:33:13,2010-12-18 20:33:13
4adec427044dcc7b8cd8a11a6f53157e1d4854dd...dec7e2bf2d26e2804245a807c11c498507f38408,3,68,199,267,10,2010-12-18 20:33:23,2010-12-18 20:33:23
dec7e2bf2d26e2804245a807c11c498507f38408...f4bc738e6b67a85e87d7abb7aa15ea37d5c701c5,3,50,44,94,9,2010-12-18 20:33:32,2010-12-18 20:33:32
f4bc738e6b67a85e87d7abb7aa15ea37d5c701c5...bc27405fc563acaaef08f47662e6597e9e1751a0,5,32,45,77,13,2010-12-18 20:33:44,2010-12-18 20:33:44
bc27405fc563acaaef08f47662e6597e9e1751a0...a360240c56a47752f65146777c0f1d9055a86bc8,1,8,2,10,3,2010-12-18 23:03:23,2010-12-18 23:03:23
a360240c56a47752f65146777c0f1d9055a86bc8...fbc2f0a0a6ce9218cc0b7feba1a9d6c7205de19f,1,1,1,2,1,2010-12-19 02:00:34,2010-12-19 02:00:34
fbc2f0a0a6ce9218cc0b7feba1a9d6c7205de19f...059d9205d40243117730aba4baea1373834e57d2,1,6,0,6,1,2010-12-19 13:01:51,2010-12-19 13:01:51
059d9205d40243117730aba4baea1373834e57d2...7adffaeaf6dfa22db0b6b2a29632b9150c7ac732,5,74,16,90,20,2010-12-19 13:41:43,2010-12-19 13:41:43
7adffaeaf6dfa22db0b6b2a29632b9150c7ac732...314fabc930a1bb361ca06e9c948bb726ad8df99a,6,135,21,156,11,2010-12-19 15:00:50,2010-12-19 15:00:50
314fabc930a1bb361ca06e9c948bb726ad8df99a...877963f54122831d9d36fbc4b41f19bd51aebb46,1,1,1,2,1,2010-12-19 15:01:12,2010-12-19 15:01:12
877963f54122831d9d36fbc4b41f19bd51aebb46...416ef9aad8efb98d7794800ca377508267cd1a93,1,2,0,2,1,2010-12-19 15:01:45,2010-12-19 15:01:45
416ef9aad8efb98d7794800ca377508267cd1a93...5219bc9f84ed584eb2ad4323482d77828712b409,2,12,20,32,11,2010-12-19 15:02:13,2010-12-19 15:02:13
5219bc9f84ed584eb2ad4323482d77828712b409...6fc7d829dc7e657fff1eb6684d97e21a35623734,1,2,2,4,1,2010-12-19 19:20:25,2010-12-19 19:20:25
6fc7d829dc7e657fff1eb6684d97e21a35623734...df6ad35c56c270ea04865e43a83b1ff0f35a71f4,2,61,38,99,5,2010-12-19 23:47:24,2010-12-19 23:47:24
df6ad35c56c270ea04865e43a83b1ff0f35a71f4...c2657d892396c51448432637a855eb9ecac5363c,2,11,3,14,4,2010-12-21 01:36:09,2010-12-21 01:36:09
c2657d892396c51448432637a855eb9ecac5363c...b60d5df07266dd4cd4f63afa6986ffb2932facc2,6,109,25,134,13,2010-12-21 04:40:08,2010-12-21 04:40:08
b60d5df07266dd4cd4f63afa6986ffb2932facc2...e299ac0cae6623df3fe4c5fe26f2c1c3db8be1d6,6,25,109,134,13,2010-12-21 06:05:40,2010-12-21 06:05:40
e299ac0cae6623df3fe4c5fe26f2c1c3db8be1d6...7655cd8eac4d745d791feb4349bbbcf69e892948,3,22,3,25,5,2010-12-21 14:56:48,2010-12-21 14:56:48
7655cd8eac4d745d791feb4349bbbcf69e892948...98e1a71ceb75faa706fca237c1c91d3fa12eda0f,4,69,8,77,18,2010-12-21 14:57:29,2010-12-21 14:57:29
98e1a71ceb75faa706fca237c1c91d3fa12eda0f...b224b05304f64a34fcb13262bbffc30c1337abc7,2,10,10,20,2,2010-12-21 14:57:57,2010-12-21 14:57:57
b224b05304f64a34fcb13262bbffc30c1337abc7...75f16982d839be682b4f54d9f179caa4a86c07a5,3,8,4,12,4,2010-12-21 15:07:09,2010-12-21 15:07:09
75f16982d839be682b4f54d9f179caa4a86c07a5...3cf8502d35cdfbb4f868a848b1f38dcc275f6be1,3,18,9,27,11,2010-12-21 15:07:43,2010-12-21 15:07:43
3cf8502d35cdfbb4f868a848b1f38dcc275f6be1...673e6fc7fb243ed44841b9969d26a161c25733b3,19,744,252,996,139,2010-12-21 15:19:19,2010-12-21 15:19:19
673e6fc7fb243ed44841b9969d26a161c25733b3...d4ef8414957e8e5db43d396eeb77bac4cf654bf8,2,30,2,32,4,2010-12-21 15:26:49,2010-12-21 15:26:49
d4ef8414957e8e5db43d396eeb77bac4cf654bf8...b3d2091681d31bf2a6f8c4a1f9f1fb32393864c8,8,195,14,209,21,2010-12-21 17:18:41,2010-12-21 17:18:41
b3d2091681d31bf2a6f8c4a1f9f1fb32393864c8...5830477e467482edcdee7e9e65feed8c98dd0bc2,2,10,0,10,2,2010-12-21 17:52:17,2010-12-21 17:52:17
5830477e467482edcdee7e9e65feed8c98dd0bc2...745c255a19df498d328b908fc3df326cdf0cf638,9,156,20,176,28,2010-12-21 19:18:12,2010-12-21 19:18:12
745c255a19df498d328b908fc3df326cdf0cf638...af5ad1116cacda13f48403c5c13af55d94b36a90,4,13,22,35,13,2010-12-21 19:19:04,2010-12-21 19:19:04
af5ad1116cacda13f48403c5c13af55d94b36a90...363177ea32184f21a59eee64d199a484d7c94582,1,3,1,4,2,2010-12-21 21:32:59,2010-12-21 21:32:59
363177ea32184f21a59eee64d199a484d7c94582...d66ab474f33a0f2455583c96940a78bd06bd2218,2,29,6,35,7,2010-12-21 23:42:12,2010-12-21 23:42:12
d66ab474f33a0f2455583c96940a78bd06bd2218...b6ab88c34a99e7fc469eb4f6e0df9752f7f3100a,3,105,36,141,23,2010-12-22 00:21:35,2010-12-22 00:21:35
b6ab88c34a99e7fc469eb4f6e0df9752f7f3100a...f0cd656ee085863d3a37f1bfb8351486428b4df2,2,9,1,10,2,2010-12-22 00:44:54,2010-12-22 00:44:54
f0cd656ee085863d3a37f1bfb8351486428b4df2...b1f6a4d66fd7f987a41c1e1aaa43907d9d347ba6,11,360,4,364,23,2010-12-22 03:34:04,2010-12-22 03:34:04
b1f6a4d66fd7f987a41c1e1aaa43907d9d347ba6...6e75ee2b3289b7d7e8192c62d665cd08d3819360,1,2,0,2,1,2010-12-22 04:12:32,2010-12-22 04:12:32
6e75ee2b3289b7d7e8192c62d665cd08d3819360...0fef92f6f0d064cdce4e8722fd9fe27ed451bb9b,5,30,12,42,12,2010-12-22 04:54:10,2010-12-22 04:54:10
0fef92f6f0d064cdce4e8722fd9fe27ed451bb9b...b22415214a7bdeaf8ccd7b8b21872038ab865991,3,181,22,203,19,2010-12-22 07:52:44,2010-12-22 07:52:44
b22415214a7bdeaf8ccd7b8b21872038ab865991...355045653587114fc48011e7071337df5c94c80b,1,1,0,1,1,2010-12-22 15:54:31,2010-12-22 15:54:31
355045653587114fc48011e7071337df5c94c80b...df4cb60004db5cbbe402233138f2f0c804a46f15,2,4,2,6,2,2010-12-22 16:24:30,2010-12-22 16:24:30
df4cb60004db5cbbe402233138f2f0c804a46f15...5fddfda5593d0f8c244f640ae63a17035ade0e3e,6,175,24,199,11,2010-12-22 17:43:30,2010-12-22 17:43:30
5fddfda5593d0f8c244f640ae63a17035ade0e3e...f9fba51164f36519e9b2f7917296ddd83b86ef47,1,1,1,2,1,2010-12-22 21:49:20,2010-12-22 21:49:20
f9fba51164f36519e9b2f7917296ddd83b86ef47...f117b91b4129b769032518d2b565e33eb0810da6,2,20,6,26,8,2010-12-22 23:55:13,2010-12-22 23:55:13
f117b91b4129b769032518d2b565e33eb0810da6...5ed6e7a4d50eb5a2193133c67fd6fe8f6bbd0e5d,7,311,14,325,24,2010-12-23 02:56:31,2010-12-23 02:56:31
5ed6e7a4d50eb5a2193133c67fd6fe8f6bbd0e5d...732198ed5c2a127249970e0cd4218d093a38e9a2,4,62,4,66,10,2010-12-23 03:44:38,2010-12-23 03:44:38
732198ed5c2a127249970e0cd4218d093a38e9a2...6819be1ea17ace34ae3a5c31ab0be960e99fcb85,3,19,3,22,5,2010-12-23 03:45:08,2010-12-23 03:45:08
6819be1ea17ace34ae3a5c31ab0be960e99fcb85...95b96b1962e07bfd4b45e5624433a1200f7575ae,1,17,0,17,1,2010-12-23 04:03:28,2010-12-23 04:03:28
95b96b1962e07bfd4b45e5624433a1200f7575ae...5e2cac541200cba7f8649be71764a4ccec11e785,2,2,2,4,2,2010-12-23 04:04:20,2010-12-23 04:04:20
5e2cac541200cba7f8649be71764a4ccec11e785...5a55922baa5356d34d1c5b6c0ffee29fb7f7c66a,1,1,1,2,1,2010-12-23 04:12:04,2010-12-23 04:12:04
5a55922baa5356d34d1c5b6c0ffee29fb7f7c66a...9ad2ef338de10e2d96cb361c7f1162df2db2066c,1,6,2,8,3,2010-12-24 18:19:48,2010-12-24 18:19:48
9ad2ef338de10e2d96cb361c7f1162df2db2066c...c4b8366884c258ca2efabc9cea7cfa3af4e22f82,1,1,1,2,1,2010-12-25 20:26:32,2010-12-25 20:26:32
c4b8366884c258ca2efabc9cea7cfa3af4e22f82...8a9be7477653c0acb19e27b4e978fd32e4091e9f,1,1,1,2,1,2010-12-25 20:30:15,2010-12-25 20:30:15
8a9be7477653c0acb19e27b4e978fd32e4091e9f...00c554f89e184b2d4de828c82965e333a3c2a863,1,9,0,9,2,2010-12-25 20:46:15,2010-12-25 20:46:15
00c554f89e184b2d4de828c82965e333a3c2a863...2ea93f9327e37c686cc4333d1f483a7c97894a3c,58,49,591,640,264,2010-12-26 00:37:14,2010-12-26 00:37:14
2ea93f9327e37c686cc4333d1f483a7c97894a3c...3e00cf1f09b9fe6099f60212aaa1ad6b934f65c8,5,180,343,523,16,2010-12-26 11:44:37,2010-12-26 11:44:37
3e00cf1f09b9fe6099f60212aaa1ad6b934f65c8...4b2b2eda240785dd5146be04ce7357b870ea807a,2,5,2,7,3,2010-12-26 11:45:11,2010-12-26 11:45:11
4b2b2eda240785dd5146be04ce7357b870ea807a...38d60c394166367b9ec0782093784a0d4c2947ab,1,6,2,8,2,2010-12-26 21:50:16,2010-12-26 21:50:16
38d60c394166367b9ec0782093784a0d4c2947ab...c00c377e5402fcb658baff982cf908138974a2b5,5,118,158,276,15,2010-12-27 07:41:26,2010-12-27 07:41:26
c00c377e5402fcb658baff982cf908138974a2b5...ee5fb7d18c9e06b564e6947f63c18436a3c8b66c,5,79,1,80,5,2010-12-27 13:27:26,2010-12-27 13:27:26
ee5fb7d18c9e06b564e6947f63c18436a3c8b66c...ddfe700563ebfa7464f05d373d25247c008dddf2,1,21,0,21,1,2010-12-27 13:41:19,2010-12-27 13:41:19
ddfe700563ebfa7464f05d373d25247c008dddf2...1fab808b1fd94394d96af54caa6957663e14f06d,1,1,1,2,1,2010-12-27 23:27:18,2010-12-27 23:27:18
1fab808b1fd94394d96af54caa6957663e14f06d...5ba961e2674110d5319a33799de422cf532ace72,1,1,1,2,1,2010-12-27 23:29:49,2010-12-27 23:29:49
5ba961e2674110d5319a33799de422cf532ace72...08cec1f5088a050730a70a1eee6bb0263a4892f5,1,8,0,8,1,2010-12-27 23:46:06,2010-12-27 23:46:06
08cec1f5088a050730a70a1eee6bb0263a4892f5...264d19752e5289f00cb36bd2704917660084696f,1,1,1,2,1,2010-12-27 23:58:16,2010-12-27 23:58:16
264d19752e5289f00cb36bd2704917660084696f...75e841d534a9f85f6378b1b3a24001909e47b8b1,1,13,1,14,2,2010-12-28 00:12:49,2010-12-28 00:12:49
75e841d534a9f85f6378b1b3a24001909e47b8b1...d3d345576df003893fab6d9cd1790495935f2d0d,1,7,0,7,1,2010-12-28 01:04:43,2010-12-28 01:04:43
d3d345576df003893fab6d9cd1790495935f2d0d...4919aaee118b9fac0a809abcbb5dafa72f67bdf2,1,8,0,8,1,2010-12-28 13:35:48,2010-12-28 13:35:48
4919aaee118b9fac0a809abcbb5dafa72f67bdf2...b0ecab516f7842d53cd55f2461f24ad79fa28282,1,21,1,22,7,2010-12-28 21:10:19,2010-12-28 21:10:19
b0ecab516f7842d53cd55f2461f24ad79fa28282...5c6a9f35a9e7604cba8bad159cc7ba3f8752d15a,1,2,0,2,1,2010-12-28 21:29:34,2010-12-28 21:29:34
5c6a9f35a9e7604cba8bad159cc7ba3f8752d15a...ec539599f796fe206a4649cb23a192ca6d782d7d,2,53,0,53,2,2010-12-28 21:37:10,2010-12-28 21:37:10
ec539599f796fe206a4649cb23a192ca6d782d7d...40d1a478fd10b3e41a9361482b1f978736f5256b,1,2,1,3,1,2010-12-28 21:54:47,2010-12-28 21:54:47
40d1a478fd10b3e41a9361482b1f978736f5256b...645323155b3d3d952f9633446e6697247dfb1b88,1,28,12,40,6,2010-12-28 22:53:28,2010-12-28 22:53:28
645323155b3d3d952f9633446e6697247dfb1b88...cd977b9221229649fe1aeca15b4ed112ec7576b5,1,11,4,15,1,2010-12-28 23:24:34,2010-12-28 23:24:34
cd977b9221229649fe1aeca15b4ed112ec7576b5...7f3210efa8b4bfb34a3feebae7bb08c26f4a65a7,1,20,0,20,2,2010-12-29 00:03:02,2010-12-29 00:03:02
7f3210efa8b4bfb34a3feebae7bb08c26f4a65a7...1517659693abe5606cbf26c07de0fae163abad8d,1,2,2,4,1,2010-12-29 00:09:09,2010-12-29 00:09:09
1517659693abe5606cbf26c07de0fae163abad8d...a43c2f50c2106d868045c7858de219de9717836c,3,16,2,18,8,2010-12-29 01:18:11,2010-12-29 01:18:11
a43c2f50c2106d868045c7858de219de9717836c...ad4969e5e8986149351255ef09e388b8a627a801,1,4,2,6,1,2010-12-29 13:47:28,2010-12-29 13:47:28
ad4969e5e8986149351255ef09e388b8a627a801...ca292f125b8084ef8061d52b1930dfb43904ff06,1,3,3,6,2,2010-12-29 13:59:15,2010-12-29 13:59:15
ca292f125b8084ef8061d52b1930dfb43904ff06...aa1b537b118fbc0417b990f61bff2850ca6cad1c,1,8,0,8,1,2010-12-29 14:19:38,2010-12-29 14:19:38
aa1b537b118fbc0417b990f61bff2850ca6cad1c...ec38c88dfb7f737377297c56810cd44111270255,1,33,0,33,1,2010-12-29 15:39:12,2010-12-29 15:39:12
ec38c88dfb7f737377297c56810cd44111270255...12266059cd28db0fdc19cdd209dcf2a801817dd0,1,11,0,11,1,2010-12-29 15:47:46,2010-12-29 15:47:46
12266059cd28db0fdc19cdd209dcf2a801817dd0...25463719d365f57ba9baa3652a711cbd5b5c1ab7,1,2,4,6,2,2010-12-29 17:20:30,2010-12-29 17:20:30
25463719d365f57ba9baa3652a711cbd5b5c1ab7...4243d49700f739138e5c2e1ec9ee7af5e9a91a25,1,3,3,6,2,2010-12-29 20:05:51,2010-12-29 20:05:51
4243d49700f739138e5c2e1ec9ee7af5e9a91a25...032aac72c4ea70adcfa7b985088bf2dd9e563ad5,1,23,2,25,3,2010-12-29 20:20:53,2010-12-29 20:20:53
032aac72c4ea70adcfa7b985088bf2dd9e563ad5...9b18b46c0f15933e3437a11c0b735aee621aa8ef,1,116,115,231,55,2010-12-29 20:30:24,2010-12-29 20:30:24
9b18b46c0f15933e3437a11c0b735aee621aa8ef...8219a13092e05a85a7d5b6abf9c878f44de3444c,1,9,2,11,4,2010-12-29 21:23:21,2010-12-29 21:23:21
8219a13092e05a85a7d5b6abf9c878f44de3444c...7902a89cedfeb37713158b85c109cac830c4e68d,1,8,0,8,2,2010-12-29 21:50:40,2010-12-29 21:50:40
7902a89cedfeb37713158b85c109cac830c4e68d...946e87ded1a281c187bfa42e28a7404223770eb4,1,1,0,1,1,2010-12-30 10:55:35,2010-12-30 10:55:35
946e87ded1a281c187bfa42e28a7404223770eb4...aff5c467c19ba9afd9d95d3a60e1a7c4eb8f25a3,1,1,1,2,1,2010-12-30 13:29:57,2010-12-30 13:29:57
aff5c467c19ba9afd9d95d3a60e1a7c4eb8f25a3...f2c4c63cdccd4883d3da8cfb9ff3bcd78406210d,1,2,2,4,1,2010-12-31 13:09:20,2010-12-31 13:09:20
f2c4c63cdccd4883d3da8cfb9ff3bcd78406210d...0de63c96f2a230d8e768ea876b6eb4bc3c8f80dd,3,22,25,47,19,2010-12-31 14:22:32,2010-12-31 14:22:32
0de63c96f2a230d8e768ea876b6eb4bc3c8f80dd...d18d37ce291e8dae4c9444afa5ab59f99bd45ecc,2,24,1,25,3,2010-12-31 14:22:55,2010-12-31 14:22:55
d18d37ce291e8dae4c9444afa5ab59f99bd45ecc...6c54bb72f0b30adaf10c6d8507e7975ca83f0c04,1,19,19,38,17,2010-12-31 14:38:19,2010-12-31 14:38:19
6c54bb72f0b30adaf10c6d8507e7975ca83f0c04...5a36b43c2721d6e679ddb952c33c28609ee829e2,1,3,2,5,2,2010-12-31 15:47:46,2010-12-31 15:47:46
5a36b43c2721d6e679ddb952c33c28609ee829e2...70c8cd41009b5776caf6091e5a0b8a989204d069,2,17,11,28,5,2010-12-31 23:02:07,2010-12-31 23:02:07
70c8cd41009b5776caf6091e5a0b8a989204d069...9c950db518fa2210b4f7963ee954148aba68cfaf,1,16,7,23,5,2011-01-01 00:37:38,2011-01-01 00:37:38
9c950db518fa2210b4f7963ee954148aba68cfaf...e45d1e2dac84256d1486d72649548e876206658e,1,2,1,3,2,2011-01-02 01:31:55,2011-01-02 01:31:55
e45d1e2dac84256d1486d72649548e876206658e...be56f74f93e97118dca32d83697803e3f9f42db0,3,7,8,15,7,2011-01-02 01:32:17,2011-01-02 01:32:17
be56f74f93e97118dca32d83697803e3f9f42db0...7a89d3d503cad96689fee3028a218ff5456f73f1,3,25,5,30,8,2011-01-02 01:32:40,2011-01-02 01:32:40
7a89d3d503cad96689fee3028a218ff5456f73f1...544ab30ed71e0d78c4c061008758de29ff79e8f7,6,102,7,109,10,2011-01-02 01:33:11,2011-01-02 01:33:11
544ab30ed71e0d78c4c061008758de29ff79e8f7...0f783b7f4eac037e22875eeeb6dc85c26b2a65f4,5,57,24,81,8,2011-01-02 17:34:52,2011-01-02 17:34:52
0f783b7f4eac037e22875eeeb6dc85c26b2a65f4...2a5105ac15baf68c844aa14b68b7af63a2329fc9,1,1,1,2,1,2011-01-03 12:07:19,2011-01-03 12:07:19
2a5105ac15baf68c844aa14b68b7af63a2329fc9...a00e8d4e4204bfb730ba3eac2ee11ad83c8ec91b,10,62,14,76,15,2011-01-03 13:15:58,2011-01-03 13:15:58
a00e8d4e4204bfb730ba3eac2ee11ad83c8ec91b...dc25fa776a9d6650fcc4876748932f3d63d04b6e,2,3,3,6,3,2011-01-03 13:19:59,2011-01-03 13:19:59
dc25fa776a9d6650fcc4876748932f3d63d04b6e...07ef43082d20e6614cd96b821897bf812731daa7,7,12,12,24,12,2011-01-03 13:29:17,2011-01-03 13:29:17
07ef43082d20e6614cd96b821897bf812731daa7...d41bd3f7f288300bb34a9a47ff44fd9bab0c1df0,1,5,0,5,1,2011-01-03 13:46:28,2011-01-03 13:46:28
d41bd3f7f288300bb34a9a47ff44fd9bab0c1df0...6bd8c14be98815627e740d862b1148d0c4fb1514,3,12,3,15,6,2011-01-03 13:56:31,2011-01-03 13:56:31
6bd8c14be98815627e740d862b1148d0c4fb1514...60470e8ac2dabff507e54f073ac1284047987feb,1,49,0,49,1,2011-01-03 14:27:28,2011-01-03 14:27:28
60470e8ac2dabff507e54f073ac1284047987feb...efcaec19236464ab36414073bc378bf0afccf42f,1,5,5,10,3,2011-01-04 01:15:54,2011-01-04 01:15:54
efcaec19236464ab36414073bc378bf0afccf42f...30fbe92ebfdaa870b3f69197214366d2d4cf1eb8,1,1,0,1,1,2011-01-04 01:26:50,2011-01-04 01:26:50
30fbe92ebfdaa870b3f69197214366d2d4cf1eb8...c0dd2babb153f1c82bd38f211a32602620dce177,1,2,1,3,1,2011-01-04 04:01:37,2011-01-04 04:01:37
c0dd2babb153f1c82bd38f211a32602620dce177...39b3269fec788bebf900081d26b94eccad6d086b,1,2,1,3,1,2011-01-04 05:57:32,2011-01-04 05:57:32
39b3269fec788bebf900081d26b94eccad6d086b...465833834c3c5fcd8180122df799ee41352ec13c,4,14,21,35,13,2011-01-05 12:41:40,2011-01-05 12:41:40
465833834c3c5fcd8180122df799ee41352ec13c...84660f0f3cc56ef64018f19ab8336502dcc5a26c,1,2,2,4,2,2011-01-05 22:40:01,2011-01-05 22:40:01
84660f0f3cc56ef64018f19ab8336502dcc5a26c...a4dd476fc2d3ddc16f60141ee496f4b61b456c99,1,9,2,11,2,2011-01-05 22:40:25,2011-01-05 22:40:25
a4dd476fc2d3ddc16f60141ee496f4b61b456c99...f2ae820d8be2f771d64326c9bab118f75aaeb20c,1,1,1,2,1,2011-01-05 22:40:45,2011-01-05 22:40:45
f2ae820d8be2f771d64326c9bab118f75aaeb20c...093009bf1f37543d4917f495159c4df97b788700,1,7,1,8,2,2011-01-05 22:41:06,2011-01-05 22:41:06
093009bf1f37543d4917f495159c4df97b788700...a3894945b647c3e07acdd35af1104739a93938a2,9,62,7,69,15,2011-01-05 22:41:43,2011-01-05 22:41:43
a3894945b647c3e07acdd35af1104739a93938a2...19ab52f77fef0edb1e4101e7f8acaa093d3ca16c,3,80,51,131,23,2011-01-08 10:03:27,2011-01-08 10:03:27
19ab52f77fef0edb1e4101e7f8acaa093d3ca16c...32a344dfe297a16087765d2f4fb2e1398dc21ac8,2,18,20,38,4,2011-01-08 13:15:44,2011-01-08 13:15:44
32a344dfe297a16087765d2f4fb2e1398dc21ac8...81e05a418dc6f347d9627373288e773c477a9fe0,2,16,3,19,5,2011-01-08 13:27:30,2011-01-08 13:27:30
81e05a418dc6f347d9627373288e773c477a9fe0...d216ff9b922aa246be5d199401494946f4a37ff7,1,15,0,15,2,2011-01-08 14:37:26,2011-01-08 14:37:26
d216ff9b922aa246be5d199401494946f4a37ff7...4a9ecdb1480fae8f072368843696d635ce1c6c6d,1,1,1,2,1,2011-01-08 14:53:44,2011-01-08 14:53:44
4a9ecdb1480fae8f072368843696d635ce1c6c6d...1ad644c0f052a60903ed0b94defe0c04fca47d06,1,1,2,3,2,2011-01-08 14:55:19,2011-01-08 14:55:19
1ad644c0f052a60903ed0b94defe0c04fca47d06...614672d365d6761353dbd11a8967a254d97035b7,3,3,9,12,3,2011-01-08 15:07:45,2011-01-08 15:07:45
614672d365d6761353dbd11a8967a254d97035b7...30c8a5574a73b0916b5c606ae357d14c38abe871,1,147,151,298,41,2011-01-08 21:15:00,2011-01-08 21:15:00
30c8a5574a73b0916b5c606ae357d14c38abe871...730769d1af383c513a104fab29bdb08dcca769f0,6,121,6,127,11,2011-01-09 13:26:39,2011-01-09 13:26:39
730769d1af383c513a104fab29bdb08dcca769f0...937548bba45c6933dab774b59fded8f0055e8937,1,1,2,3,2,2011-01-10 08:15:52,2011-01-10 08:15:52
937548bba45c6933dab774b59fded8f0055e8937...ea774bf9a7620e71567b47489bdf6cea31e64afa,3,5,3,8,4,2011-01-10 13:44:35,2011-01-10 13:44:35
ea774bf9a7620e71567b47489bdf6cea31e64afa...1b90cdcf23777a53879f92ccdc0b0d453944c596,1,1,1,2,1,2011-01-11 00:29:38,2011-01-11 00:29:38
1b90cdcf23777a53879f92ccdc0b0d453944c596...29de7ee9cb78f4216faec7499044fdf65c1b2511,2,90,16,106,12,2011-01-11 01:00:50,2011-01-11 01:00:50
29de7ee9cb78f4216faec7499044fdf65c1b2511...f544d988962bb9b815d53431bfb1b8c32788a1d6,1,6,7,13,5,2011-01-12 13:39:31,2011-01-12 13:39:31
f544d988962bb9b815d53431bfb1b8c32788a1d6...1c56af676d02aa0cdb70bb3749971f1cac4afdb3,2,23,1,24,4,2011-01-12 23:30:47,2011-01-12 23:30:47
1c56af676d02aa0cdb70bb3749971f1cac4afdb3...fd12e3b2186e47653b25efccec28cee68bd20f7e,2,16,1,17,2,2011-01-13 03:02:32,2011-01-13 03:02:32
fd12e3b2186e47653b25efccec28cee68bd20f7e...e1ede214e6dd0fc988fa572d8be45231c275970c,2,56,3,59,4,2011-01-13 04:11:41,2011-01-13 04:11:41
e1ede214e6dd0fc988fa572d8be45231c275970c...80f48260630c3db98f6e0af282bc339eba999009,2,10,2,12,5,2011-01-13 13:47:03,2011-01-13 13:47:03
80f48260630c3db98f6e0af282bc339eba999009...7b8c38250ce812c67bc85f454092c74ad5b81339,3,51,30,81,12,2011-01-13 13:47:21,2011-01-13 13:47:21
7b8c38250ce812c67bc85f454092c74ad5b81339...2d352444b0354f163ac7d04fcddf84cc744a09d8,5,79,6,85,9,2011-01-13 14:51:34,2011-01-13 14:51:34
2d352444b0354f163ac7d04fcddf84cc744a09d8...8781ea6cd71de32fc9cc30c3427c682b9448fd50,1,8,0,8,2,2011-01-13 16:22:03,2011-01-13 16:22:03
8781ea6cd71de32fc9cc30c3427c682b9448fd50...1222bd6f6f7f74a5b885f8a69242011ba3bc5a93,2,41,1,42,19,2011-01-13 16:41:46,2011-01-13 16:41:46
1222bd6f6f7f74a5b885f8a69242011ba3bc5a93...a6b9dbc57c39e2746f0ec70d9c7f3d4b93e0e1a6,2,61,31,92,5,2011-01-13 21:58:11,2011-01-13 21:58:11
a6b9dbc57c39e2746f0ec70d9c7f3d4b93e0e1a6...cfcb591dd8d3f1ead78e0bdb9578852312768f97,1,6,0,6,6,2011-01-13 23:18:54,2011-01-13 23:18:54
cfcb591dd8d3f1ead78e0bdb9578852312768f97...b7ce6b03bbb23129880e7d01f845f25ec8af8c89,1,1,1,2,1,2011-01-13 23:19:10,2011-01-13 23:19:10
b7ce6b03bbb23129880e7d01f845f25ec8af8c89...7916c754aa91f83a96b2b8b3c54a2f32bdeca740,1,29,1,30,2,2011-01-14 03:43:10,2011-01-14 03:43:10
7916c754aa91f83a96b2b8b3c54a2f32bdeca740...92d43522839fd9ec945d8c018de78770bec04ee1,1,7,7,14,4,2011-01-14 05:04:14,2011-01-14 05:04:14
92d43522839fd9ec945d8c018de78770bec04ee1...faa4a98f27085e2f6e8e741fb641b084333abdca,3,6,6,12,5,2011-01-14 08:31:14,2011-01-14 08:31:14
faa4a98f27085e2f6e8e741fb641b084333abdca...ba585a2c6dbbbc918f5ceffd54eb31212bca85ef,4,35,4,39,2,2011-01-14 23:18:21,2011-01-14 23:18:21
ba585a2c6dbbbc918f5ceffd54eb31212bca85ef...0bd628d418348bbda936f10c03d5e9d910986580,1,12,2,14,3,2011-01-15 00:15:39,2011-01-15 00:15:39
0bd628d418348bbda936f10c03d5e9d910986580...8b4dffd8df93610688552e45d4752cad79ff3fcc,1,5,4,9,1,2011-01-15 00:18:15,2011-01-15 00:18:15
8b4dffd8df93610688552e45d4752cad79ff3fcc...0d70d2922731180810f53d38316df8360b20bcf0,1,8,7,15,1,2011-01-15 05:54:55,2011-01-15 05:54:55
0d70d2922731180810f53d38316df8360b20bcf0...11997218eeed02c8be7a81b87db321464839a2cf,3,474,248,722,55,2011-01-15 05:55:24,2011-01-15 05:55:24
11997218eeed02c8be7a81b87db321464839a2cf...df5c01b8c545b4e48ac48c51237566bd9200a4cf,1,1,0,1,1,2011-01-15 06:12:56,2011-01-15 06:12:56
df5c01b8c545b4e48ac48c51237566bd9200a4cf...d7fa33af78aeae8a6a6e8261c697c7a03a821595,3,83,12,95,12,2011-01-15 06:31:38,2011-01-15 06:31:38
d7fa33af78aeae8a6a6e8261c697c7a03a821595...da524c56e165579aa8b113f871bea8ad7304b765,1,2,2,4,2,2011-01-15 06:33:36,2011-01-15 06:33:36
da524c56e165579aa8b113f871bea8ad7304b765...8b4e39bc2eb35d28e602e9f59f5acdd84784e134,1,1,1,2,1,2011-01-15 18:45:49,2011-01-15 18:45:49
8b4e39bc2eb35d28e602e9f59f5acdd84784e134...6c361ecb179cb0bfa76614e0292188c548801606,1,1,1,2,1,2011-01-15 18:52:59,2011-01-15 18:52:59
6c361ecb179cb0bfa76614e0292188c548801606...645eb2b26b01520d7e98cb3c2f671e254571a090,6,75,96,171,28,2011-01-15 23:38:00,2011-01-15 23:38:00
645eb2b26b01520d7e98cb3c2f671e254571a090...1ca9e95d4e9ec5922ce6aee6c143006b6c551e48,1,22,0,22,1,2011-01-16 06:44:23,2011-01-16 06:44:23
1ca9e95d4e9ec5922ce6aee6c143006b6c551e48...b4f0921463956215c9852398df2674262ac7548e,2,29,2,31,6,2011-01-16 07:31:35,2011-01-16 07:31:35
b4f0921463956215c9852398df2674262ac7548e...ae8ff5f476973d5623675460d36a2f3c6853f6d0,2,27,4,31,5,2011-01-16 08:03:25,2011-01-16 08:03:25
ae8ff5f476973d5623675460d36a2f3c6853f6d0...4d654c92ce5565b22fd18d5d0ffc2c9efe391497,1,7,2,9,2,2011-01-16 13:56:12,2011-01-16 13:56:12
4d654c92ce5565b22fd18d5d0ffc2c9efe391497...f89f1c8acbf5f9d13d52855c49bef53360b1a6e2,6,59,11,70,10,2011-01-16 15:38:03,2011-01-16 15:38:03
f89f1c8acbf5f9d13d52855c49bef53360b1a6e2...5fd93e1c36081662c83cf817ac8370bf5f82b6fb,1,103,107,210,13,2011-01-16 19:22:36,2011-01-16 19:22:36
5fd93e1c36081662c83cf817ac8370bf5f82b6fb...1ebd6860b65288d8fbe71b7a132f78bed620044d,1,1,1,2,1,2011-01-16 21:49:01,2011-01-16 21:49:01
1ebd6860b65288d8fbe71b7a132f78bed620044d...964cf1be866e7db410d8a5b08d4d83c620a697cd,1,3,3,6,3,2011-01-17 02:37:40,2011-01-17 02:37:40
964cf1be866e7db410d8a5b08d4d83c620a697cd...fcbf881d8200f3771dd07be63e94171dd9548b92,6,83,100,183,49,2011-01-17 09:52:47,2011-01-17 09:52:47
fcbf881d8200f3771dd07be63e94171dd9548b92...3a9e2e90ac4d3685ada844c0e45099a6f654b39d,1,1,1,2,1,2011-01-17 13:15:08,2011-01-17 13:15:08
3a9e2e90ac4d3685ada844c0e45099a6f654b39d...993612c84d3c04c516486a99fa813cec1caa5488,1,10,5,15,1,2011-01-17 14:03:19,2011-01-17 14:03:19
993612c84d3c04c516486a99fa813cec1caa5488...3db76ff2d05f5470788dd71f3cbc175e167e52a1,1,4,2,6,1,2011-01-17 23:58:51,2011-01-17 23:58:51
3db76ff2d05f5470788dd71f3cbc175e167e52a1...5502fa59801c70094b6a2e789ece65aa7b31b58c,1,5,0,5,1,2011-01-18 16:42:24,2011-01-18 16:42:24
5502fa59801c70094b6a2e789ece65aa7b31b58c...b31a1b99261d05bf8a34495ee9faf4d6592b8b36,7,81,6,87,8,2011-01-18 16:43:01,2011-01-18 16:43:01
b31a1b99261d05bf8a34495ee9faf4d6592b8b36...457aaca7fa99d3630b3fabd1bedd4bbad4242f83,1,1,1,2,1,2011-01-18 23:25:38,2011-01-18 23:25:38
457aaca7fa99d3630b3fabd1bedd4bbad4242f83...a38da1ae0d6cbd6411f98e6578f0a4f50c12f6b1,1,6,5,11,4,2011-01-19 14:39:54,2011-01-19 14:39:54
a38da1ae0d6cbd6411f98e6578f0a4f50c12f6b1...d140318099e60591ba3275dba841070a2006066d,1,2,1,3,1,2011-01-19 14:41:40,2011-01-19 14:41:40
d140318099e60591ba3275dba841070a2006066d...ca64a3cb2d5c1a6c5abf040ab3810acfeb829c04,1,1,0,1,1,2011-01-19 16:36:20,2011-01-19 16:36:20
ca64a3cb2d5c1a6c5abf040ab3810acfeb829c04...621f48086e188025cff9a1a4a521439a358a8452,1,13,5,18,6,2011-01-19 20:11:56,2011-01-19 20:11:56
621f48086e188025cff9a1a4a521439a358a8452...f399f8bd719202a6cbdf22ecd9496fa44c388b47,2,3,4,7,3,2011-01-19 20:37:58,2011-01-19 20:37:58
f399f8bd719202a6cbdf22ecd9496fa44c388b47...e01cb0740496f12323260205687111a54a91e10f,3,37,17,54,7,2011-01-19 21:56:14,2011-01-19 21:56:14
e01cb0740496f12323260205687111a54a91e10f...93a4d46184bba069fc6a9aa5517802b2488032ac,10,115,27,142,25,2011-01-20 00:33:32,2011-01-20 00:33:32
93a4d46184bba069fc6a9aa5517802b2488032ac...53dac996efedf9138938ad4aa5647cb68006937c,5,26,9,35,9,2011-01-20 01:00:47,2011-01-20 01:00:47
53dac996efedf9138938ad4aa5647cb68006937c...8308ad4f0515ec1879ff4d0206e58938291e3dc9,6,69,11,80,18,2011-01-20 04:47:47,2011-01-20 04:47:47
8308ad4f0515ec1879ff4d0206e58938291e3dc9...19bfdadc430fa8d366de1b8ca821cc4c64341b67,4,20,6,26,6,2011-01-20 22:33:58,2011-01-20 22:33:58
19bfdadc430fa8d366de1b8ca821cc4c64341b67...190f6e5b45c68653f2deab025c50f6797e5d793f,4,14,1,15,4,2011-01-21 01:04:05,2011-01-21 01:04:05
190f6e5b45c68653f2deab025c50f6797e5d793f...ccfd70c7ba4852bdd849a714917165b5c5b77f30,1,32,32,64,16,2011-01-21 15:55:27,2011-01-21 15:55:27
ccfd70c7ba4852bdd849a714917165b5c5b77f30...cf179e195d5525e0233385be97a53a6c5d7c6985,1,13,3,16,6,2011-01-21 17:30:35,2011-01-21 17:30:35
cf179e195d5525e0233385be97a53a6c5d7c6985...481c6b7edaae8fc9c5faaed81f9e2db04960006c,252,58581,0,58581,126,2011-01-21 17:41:35,2011-01-21 17:41:35
481c6b7edaae8fc9c5faaed81f9e2db04960006c...26de24f694b243ce8ba5f597e39cb68cfbb291a7,126,9258,0,9258,63,2011-01-21 17:50:35,2011-01-21 17:50:35
26de24f694b243ce8ba5f597e39cb68cfbb291a7...b3ab63d66bc5a1264cfe87a0a47a4a04c8ce66f1,126,16423,0,16423,63,2011-01-21 17:59:27,2011-01-21 17:59:27
b3ab63d66bc5a1264cfe87a0a47a4a04c8ce66f1...14e76581fa6ff975c904f164e3f9b531602c1de5,126,19481,0,19481,63,2011-01-21 18:08:19,2011-01-21 18:08:19
14e76581fa6ff975c904f164e3f9b531602c1de5...32db33b3a1e728f176b97211213037b0d508deba,126,1785,0,1785,63,2011-01-21 18:15:51,2011-01-21 18:15:51
32db33b3a1e728f176b97211213037b0d508deba...3238b6866f485f49fc19651cc59a3a0cedc92a76,252,6489,0,6489,126,2011-01-21 18:31:00,2011-01-21 18:31:00
3238b6866f485f49fc19651cc59a3a0cedc92a76...f8cf6c836479e37f56397ade08445cf8016c026d,126,4290,0,4290,63,2011-01-21 18:39:05,2011-01-21 18:39:05
f8cf6c836479e37f56397ade08445cf8016c026d...7ff65caa7bacde213394011c58b6cdcbf3eb9b8b,126,6459,0,6459,63,2011-01-21 18:46:59,2011-01-21 18:46:59
7ff65caa7bacde213394011c58b6cdcbf3eb9b8b...7be43c910abbf538bba65cc8304896bdd1ba1d37,126,164493,0,164493,63,2011-01-21 18:56:32,2011-01-21 18:56:32
7be43c910abbf538bba65cc8304896bdd1ba1d37...086fa8760ccf008fdf6df9927e0c1782253ab588,126,1303,0,1303,63,2011-01-21 19:04:00,2011-01-21 19:04:00
086fa8760ccf008fdf6df9927e0c1782253ab588...48b19b0341dcfd8f061360fc7c9b961224ee7df8,126,2960,0,2960,63,2011-01-21 19:12:10,2011-01-21 19:12:10
48b19b0341dcfd8f061360fc7c9b961224ee7df8...ddb9df78a66b9bdaee5c6bc3b100570516d72151,126,2286,0,2286,63,2011-01-21 19:19:44,2011-01-21 19:19:44
ddb9df78a66b9bdaee5c6bc3b100570516d72151...e5eb5a2f7693df23e742723e8cf972c23bfba4b1,126,2034,0,2034,63,2011-01-21 19:27:26,2011-01-21 19:27:26
e5eb5a2f7693df23e742723e8cf972c23bfba4b1...de8565e1c48f1c386a7b256e1ae585cbd8ff11b2,252,26816,261008,287824,9355,2011-01-21 19:35:41,2011-01-21 19:35:41
de8565e1c48f1c386a7b256e1ae585cbd8ff11b2...5f4bc1ff234c0aabef3751052a6664acc56167fe,5,11,11,22,8,2011-01-21 19:36:26,2011-01-21 19:36:26
5f4bc1ff234c0aabef3751052a6664acc56167fe...2f34d70bf211d91ba3e22b93da88b323cf21cb23,1,82,0,82,1,2011-01-21 19:36:57,2011-01-21 19:36:57
2f34d70bf211d91ba3e22b93da88b323cf21cb23...70a2a71c9b9f1b25361a4ec096671be37e8c3a0d,1,30,19,49,8,2011-01-21 19:37:16,2011-01-21 19:37:16
70a2a71c9b9f1b25361a4ec096671be37e8c3a0d...47c653999f473b9dab9aa000fb2f3e164af437e1,126,3939,2462,6401,2144,2011-01-21 19:42:52,2011-01-21 19:42:52
47c653999f473b9dab9aa000fb2f3e164af437e1...5fcce5e10f8174f91604ea66e0ece1a8a0da80f6,1,1,1,2,1,2011-01-21 20:16:38,2011-01-21 20:16:38
5fcce5e10f8174f91604ea66e0ece1a8a0da80f6...c06d27239e09d2b6c9886108f9dd489004f67576,1,1,0,1,1,2011-01-21 20:47:56,2011-01-21 20:47:56
c06d27239e09d2b6c9886108f9dd489004f67576...eacecbe9e36fe41205061ab59d055c17849468c1,1,4,7,11,3,2011-01-21 21:00:39,2011-01-21 21:00:39
eacecbe9e36fe41205061ab59d055c17849468c1...07b92cd4894f2612a041066a69204061142de328,127,6579,3845,10424,3907,2011-01-21 22:25:50,2011-01-21 22:25:50
07b92cd4894f2612a041066a69204061142de328...a757b5b8ca64d2fe8973e2a0696a12f9d10146d5,3,8,8,16,7,2011-01-22 12:43:50,2011-01-22 12:43:50
a757b5b8ca64d2fe8973e2a0696a12f9d10146d5...578ad9b472ba18b3fcdbe263e37002233fa859a2,1,5,14,19,2,2011-01-22 16:16:42,2011-01-22 16:16:42
578ad9b472ba18b3fcdbe263e37002233fa859a2...4849ebb017362f38cf281409e227bc755cc0eca6,1,1,1,2,1,2011-01-22 23:29:11,2011-01-22 23:29:11
4849ebb017362f38cf281409e227bc755cc0eca6...fe581013b03b3dd38f4893bb5e9dc9695af25d71,4,76,16,92,22,2011-01-24 06:36:31,2011-01-24 06:36:31
fe581013b03b3dd38f4893bb5e9dc9695af25d71...10b2441381592a17beb7c02725d8cb1fd62d6e0e,3,27,3,30,3,2011-01-24 07:01:00,2011-01-24 07:01:00
10b2441381592a17beb7c02725d8cb1fd62d6e0e...d053624aa8534c984e07d4d8d2ee867de013e2ec,2,17,5,22,5,2011-01-24 08:02:40,2011-01-24 08:02:40
d053624aa8534c984e07d4d8d2ee867de013e2ec...3a6491cf56ccd8b5cdbc081034b9ab4a9dbc596b,3,36,7,43,7,2011-01-24 08:16:09,2011-01-24 08:16:09
3a6491cf56ccd8b5cdbc081034b9ab4a9dbc596b...ef3d7bda327dfc94679a802517acaba4c0a7b640,113,565,565,1130,315,2011-01-24 09:44:22,2011-01-24 09:44:22
ef3d7bda327dfc94679a802517acaba4c0a7b640...3d7afd5d2b64546cdcfd812d2cecb61795e788f0,1,5,3,8,4,2011-01-24 11:49:11,2011-01-24 11:49:11
3d7afd5d2b64546cdcfd812d2cecb61795e788f0...3f528e10d50ff7ba19a8a9e6cb2f9417a1e7f270,9,256,8,264,29,2011-01-24 14:24:35,2011-01-24 14:24:35
3f528e10d50ff7ba19a8a9e6cb2f9417a1e7f270...bafe879188f3cd268f81e426bcdf4addc2d9a10a,6,46,4,50,9,2011-01-24 14:58:05,2011-01-24 14:58:05
bafe879188f3cd268f81e426bcdf4addc2d9a10a...09a63632c5072695d3b3293a046c197ea3c3299a,4,10,26,36,11,2011-01-24 15:18:56,2011-01-24 15:18:56
09a63632c5072695d3b3293a046c197ea3c3299a...42c31f6bf036efd93c0311bc1f524b1553c20489,5,85,64,149,19,2011-01-24 20:35:46,2011-01-24 20:35:46
42c31f6bf036efd93c0311bc1f524b1553c20489...91c61c0baac6b35b2ae191dc6333c26fd567ff1e,1,42,1,43,4,2011-01-24 21:34:18,2011-01-24 21:34:18
91c61c0baac6b35b2ae191dc6333c26fd567ff1e...7c888a7aa945352193303b557cbf654957e0dd45,3,8,30,38,6,2011-01-25 01:39:39,2011-01-25 01:39:39
7c888a7aa945352193303b557cbf654957e0dd45...227c5e80dbff2b731a1cba8c4dd94c00526a3e76,8,122,14,136,12,2011-01-25 03:14:28,2011-01-25 03:14:28
227c5e80dbff2b731a1cba8c4dd94c00526a3e76...28d0a0f78840ff82d574c4827d75eda2ce6bf45a,1,1,22,23,2,2011-01-25 04:08:17,2011-01-25 04:08:17
28d0a0f78840ff82d574c4827d75eda2ce6bf45a...da771cc74c32fc9cc4760fc60047f043ef8dfcb8,3,44,5,49,4,2011-01-25 04:52:54,2011-01-25 04:52:54
da771cc74c32fc9cc4760fc60047f043ef8dfcb8...5d2ea792ecc271f08201e59268a26ff163f91634,118,0,708,708,708,2011-01-25 08:37:35,2011-01-25 08:37:35
5d2ea792ecc271f08201e59268a26ff163f91634...f81d4ba5b3deceeacbe51923f379acb7d033665f,3,43,2,45,4,2011-01-25 15:42:24,2011-01-25 15:42:24
f81d4ba5b3deceeacbe51923f379acb7d033665f...a981f5b988ad711de7ea941b15ce4b0dacbe1add,1,1,1,2,1,2011-01-26 00:37:08,2011-01-26 00:37:08
a981f5b988ad711de7ea941b15ce4b0dacbe1add...1b961e8ee39424c20b6062f56a998722c5864f39,1,0,5,5,1,2011-01-26 00:58:41,2011-01-26 00:58:41
1b961e8ee39424c20b6062f56a998722c5864f39...9a317938ef2109da5e8d9cec5ee356d413e7ff47,1,5,12,17,4,2011-01-26 03:22:16,2011-01-26 03:22:16
9a317938ef2109da5e8d9cec5ee356d413e7ff47...b4bf635cea92318e34d997cc614e7ff8233d015b,1,2,2,4,1,2011-01-26 03:23:59,2011-01-26 03:23:59
b4bf635cea92318e34d997cc614e7ff8233d015b...561af6417e1c8232904b726fb0219cc0b7c2e71d,1,2,9,11,2,2011-01-26 03:34:16,2011-01-26 03:34:16
561af6417e1c8232904b726fb0219cc0b7c2e71d...91414c4bb825c65b0ebdcfcbaf39356befdbaf92,3,15,1,16,5,2011-01-26 03:42:31,2011-01-26 03:42:31
91414c4bb825c65b0ebdcfcbaf39356befdbaf92...80287f1e8a554290faa6a0c31113a9f4eecf7b79,2,14,1,15,2,2011-01-26 03:48:15,2011-01-26 03:48:15
80287f1e8a554290faa6a0c31113a9f4eecf7b79...00e7a571c5737c69bc225ae39d3dca6d0fbfd072,3,16,16,32,4,2011-01-26 07:46:19,2011-01-26 07:46:19
00e7a571c5737c69bc225ae39d3dca6d0fbfd072...8151c0431ecdd6aa0b41d6f19d5f7a696ac59aa7,2,64,0,64,2,2011-01-26 08:10:54,2011-01-26 08:10:54
8151c0431ecdd6aa0b41d6f19d5f7a696ac59aa7...a9b4f2a40043cdf8e61dce7e623028ba33ffd6af,1,2,1,3,1,2011-01-26 08:39:30,2011-01-26 08:39:30
a9b4f2a40043cdf8e61dce7e623028ba33ffd6af...69a803a8a66104ac9f64dd39fed657dd577c9776,1,1,0,1,1,2011-01-26 14:49:50,2011-01-26 14:49:50
69a803a8a66104ac9f64dd39fed657dd577c9776...193f14d862429c27e061f0f000feddfc6e43e1d8,2,134,3,137,4,2011-01-26 15:12:18,2011-01-26 15:12:18
193f14d862429c27e061f0f000feddfc6e43e1d8...33c155679cb283b31143df9389b06133c2bfeb20,1,2,1,3,1,2011-01-26 18:20:19,2011-01-26 18:20:19
33c155679cb283b31143df9389b06133c2bfeb20...84291b7b8456b554f162b6eeaffa9b124907c1d2,5,62,5,67,9,2011-01-26 19:10:08,2011-01-26 19:10:08
84291b7b8456b554f162b6eeaffa9b124907c1d2...7505abf95dbf901af704f485eb2180b37f8c5b16,1,4,2,6,3,2011-01-27 00:00:20,2011-01-27 00:00:20
7505abf95dbf901af704f485eb2180b37f8c5b16...7c0e40534b7c2d8de9824a36824482d1067e195b,1,1,3,4,1,2011-01-27 00:00:32,2011-01-27 00:00:32
7c0e40534b7c2d8de9824a36824482d1067e195b...701204254478a03fd95a2508be7f1f47bcebae43,1,3,0,3,1,2011-01-27 02:28:17,2011-01-27 02:28:17
701204254478a03fd95a2508be7f1f47bcebae43...456b8a9d0c3c4cbff2e3d88b659c6e4e3e6c7def,1,2,0,2,1,2011-01-27 02:28:53,2011-01-27 02:28:53
456b8a9d0c3c4cbff2e3d88b659c6e4e3e6c7def...4a3ea263ef964a7fb7840544870834889f56f7e4,2,56,1,57,5,2011-01-27 02:29:17,2011-01-27 02:29:17
4a3ea263ef964a7fb7840544870834889f56f7e4...1f5309a99e94aec310c1fcd9117559356db40a65,1,4,2,6,2,2011-01-27 03:13:39,2011-01-27 03:13:39
1f5309a99e94aec310c1fcd9117559356db40a65...461f01b7a66a1d12cebf786892baccb6cee2e6c1,4,10,10,20,16,2011-01-27 03:14:20,2011-01-27 03:14:20
461f01b7a66a1d12cebf786892baccb6cee2e6c1...a5cac772b6b74ed142af6ffe2829c55f1b730d19,2,72,32,104,6,2011-01-27 03:14:49,2011-01-27 03:14:49
a5cac772b6b74ed142af6ffe2829c55f1b730d19...9acd00a72e06c9b327089f12a6160aee4182f98b,2,4,3,7,4,2011-01-27 03:15:12,2011-01-27 03:15:12
9acd00a72e06c9b327089f12a6160aee4182f98b...22eaf77f9d3541e007d3e1b6292710bb6a016dff,0,0,0,0,0,2011-01-27 14:48:37,2011-01-27 14:48:37
22eaf77f9d3541e007d3e1b6292710bb6a016dff...c24bdf044ba23f2aa09ea4637a368ea86fd1c128,7,77,21,98,17,2011-01-28 14:08:25,2011-01-28 14:08:25
c24bdf044ba23f2aa09ea4637a368ea86fd1c128...655d5afea9d1f3d5aa55efc9fe77a14b353e35a6,3,51,4,55,10,2011-01-28 14:08:42,2011-01-28 14:08:42
655d5afea9d1f3d5aa55efc9fe77a14b353e35a6...a0585e99bf7d8644a5f56aba89c451bcefe20b53,1,11,0,11,1,2011-01-28 15:47:40,2011-01-28 15:47:40
a0585e99bf7d8644a5f56aba89c451bcefe20b53...cfc40d6d0b18d18d4715a805915e3d270f538074,1,1,1,2,1,2011-01-28 21:42:11,2011-01-28 21:42:11
cfc40d6d0b18d18d4715a805915e3d270f538074...b5f0b6f71fe3b06797c8019ada8d925cc3e1228f,1,1,0,1,1,2011-01-28 21:44:45,2011-01-28 21:44:45
b5f0b6f71fe3b06797c8019ada8d925cc3e1228f...40ea1fb0d74f1adcf39a49ebe418676288540913,1,1,1,2,1,2011-01-28 22:07:43,2011-01-28 22:07:43
40ea1fb0d74f1adcf39a49ebe418676288540913...fe0a15b6c9b5780df765a9c294d81d2b741b0d56,1,11,6,17,2,2011-01-29 02:01:43,2011-01-29 02:01:43
fe0a15b6c9b5780df765a9c294d81d2b741b0d56...34288ec2f2d78d39c0d71ab479bb67f131139bc3,1,3,4,7,2,2011-01-29 08:10:20,2011-01-29 08:10:20
34288ec2f2d78d39c0d71ab479bb67f131139bc3...4392c8e67ed6009602ff72af0a786c1053d55302,1,4,2,6,3,2011-01-29 15:03:39,2011-01-29 15:03:39
4392c8e67ed6009602ff72af0a786c1053d55302...56ebab9d8596f63db38053816ec961656e49ed38,2,9,2,11,2,2011-01-30 13:10:47,2011-01-30 13:10:47
56ebab9d8596f63db38053816ec961656e49ed38...4bb1b2304d73285411f00c41efa865bd3146abd1,1,1,1,2,1,2011-01-30 13:11:45,2011-01-30 13:11:45
4bb1b2304d73285411f00c41efa865bd3146abd1...14c082646dabf61a27e7ee13c77682bf5b5c5101,1,0,1,1,1,2011-01-30 13:33:27,2011-01-30 13:33:27
14c082646dabf61a27e7ee13c77682bf5b5c5101...e3d322ede8b2c7fb52b028ab654ae7ed38e1bce4,1,10,0,10,1,2011-01-30 13:33:53,2011-01-30 13:33:53
e3d322ede8b2c7fb52b028ab654ae7ed38e1bce4...8fe42053bcec02769ae76b238d43086eb021ca89,4,139,118,257,53,2011-01-30 17:23:25,2011-01-30 17:23:25
8fe42053bcec02769ae76b238d43086eb021ca89...aaa76ca1b311f774ff7fb004329d4409888ae67f,1,7,0,7,1,2011-01-30 17:23:30,2011-01-30 17:23:30
aaa76ca1b311f774ff7fb004329d4409888ae67f...9e81e189299584f4add81583216ff1936b2c9f8d,1,1,1,2,1,2011-01-30 17:23:36,2011-01-30 17:23:36
9e81e189299584f4add81583216ff1936b2c9f8d...456534dda91caad152695457398a844244072f97,1,1,1,2,1,2011-01-30 19:09:44,2011-01-30 19:09:44
456534dda91caad152695457398a844244072f97...2d29c11117513aa6b2b8dabfb50a286928e62ca0,1,2,2,4,2,2011-01-30 20:31:39,2011-01-30 20:31:39
2d29c11117513aa6b2b8dabfb50a286928e62ca0...6361a242af3bed3f822b4c14c13624869478abaf,1,1,1,2,1,2011-01-30 23:29:25,2011-01-30 23:29:25
6361a242af3bed3f822b4c14c13624869478abaf...f3a9c719fe8cdbc06440dde63fe2011b3fa5c6ce,1,7,0,7,1,2011-01-30 23:29:31,2011-01-30 23:29:31
f3a9c719fe8cdbc06440dde63fe2011b3fa5c6ce...b8a8066ac47b50316a14b88f1e3fb236bc03576f,1,3,4,7,3,2011-01-31 18:37:28,2011-01-31 18:37:28
b8a8066ac47b50316a14b88f1e3fb236bc03576f...553adfa6d12487ea24e1a6812851cd0a6fe810a3,1,9,13,22,3,2011-01-31 20:11:19,2011-01-31 20:11:19
553adfa6d12487ea24e1a6812851cd0a6fe810a3...0bf5fbfa76544fe921d051619127748ae10237bd,2,79,59,138,27,2011-01-31 22:06:53,2011-01-31 22:06:53
0bf5fbfa76544fe921d051619127748ae10237bd...00fda7f45db2425c1dcb5d927093ede45734d841,5,54,12,66,12,2011-02-01 00:20:31,2011-02-01 00:20:31
00fda7f45db2425c1dcb5d927093ede45734d841...9a82eb6ff109e95dbb6cf26ee3d2ce1c548714bb,3,116,20,136,25,2011-02-01 14:18:07,2011-02-01 14:18:07
9a82eb6ff109e95dbb6cf26ee3d2ce1c548714bb...76fb2bb0e246884ce6dc1a48d0db55e0673de8e0,4,24,19,43,9,2011-02-01 14:28:07,2011-02-01 14:28:07
76fb2bb0e246884ce6dc1a48d0db55e0673de8e0...74d485c4ec2b754578482af98e3e8258d1575ad0,3,24,1,25,6,2011-02-01 14:42:52,2011-02-01 14:42:52
74d485c4ec2b754578482af98e3e8258d1575ad0...7aad3d3fa8a8db8eb8ea9e64134d60b2400029f0,5,37,20,57,12,2011-02-01 14:57:10,2011-02-01 14:57:10
7aad3d3fa8a8db8eb8ea9e64134d60b2400029f0...67a2bb6341caa1fbf6dce7d9dbac8800b33e9d04,1,6,6,12,4,2011-02-01 15:13:56,2011-02-01 15:13:56
67a2bb6341caa1fbf6dce7d9dbac8800b33e9d04...5cd561280844865182277ef49070e75ad5ec881e,1,104,83,187,18,2011-02-01 19:19:52,2011-02-01 19:19:52
5cd561280844865182277ef49070e75ad5ec881e...3bff7ed34c0bf29a0fada05cfaf729aaec7cea6d,1,4,5,9,4,2011-02-01 20:10:29,2011-02-01 20:10:29
3bff7ed34c0bf29a0fada05cfaf729aaec7cea6d...77030ccc1ea4e1df04540e4d4594cb0d741fa2b4,3,3,5,8,4,2011-02-01 20:39:40,2011-02-01 20:39:40
77030ccc1ea4e1df04540e4d4594cb0d741fa2b4...dc5f2607deb35022523fef17dcd8479ca812e887,4,47,27,74,14,2011-02-02 14:02:14,2011-02-02 14:02:14
dc5f2607deb35022523fef17dcd8479ca812e887...05e3bf4befc9f5876a0435f798b1b831e340bbd6,1,1,1,2,1,2011-02-02 15:24:31,2011-02-02 15:24:31
05e3bf4befc9f5876a0435f798b1b831e340bbd6...3cdd6d898efc9488f4cd6b470b7c48b6a27c284c,1,3,3,6,3,2011-02-02 20:23:13,2011-02-02 20:23:13
3cdd6d898efc9488f4cd6b470b7c48b6a27c284c...a9ebf9ec24dfc4c38e5341e91146cf2ef6f140c0,1,4,4,8,4,2011-02-02 20:39:54,2011-02-02 20:39:54
a9ebf9ec24dfc4c38e5341e91146cf2ef6f140c0...f77d81de3d08c3e441b2fdd168af51a141267493,1,19,0,19,1,2011-02-02 20:57:09,2011-02-02 20:57:09
f77d81de3d08c3e441b2fdd168af51a141267493...a158873488b06077f65fce35e9ea57658a64c872,1,1,1,2,1,2011-02-03 04:55:43,2011-02-03 04:55:43
a158873488b06077f65fce35e9ea57658a64c872...987fd511769a3e1342fe8678a0b183f2831adb60,2,16,3,19,4,2011-02-03 15:43:50,2011-02-03 15:43:50
987fd511769a3e1342fe8678a0b183f2831adb60...d44fb0557a0a9d8fab62b1e48078be498c61287a,3,51,18,69,10,2011-02-04 13:52:36,2011-02-04 13:52:36
d44fb0557a0a9d8fab62b1e48078be498c61287a...4306501da7603762fc37dd62cc8a8b87f3f42114,2,15,6,21,2,2011-02-04 14:27:43,2011-02-04 14:27:43
4306501da7603762fc37dd62cc8a8b87f3f42114...514c0b5eb48ee23f656ab433ff35f01741d2c3a0,1,3,0,3,2,2011-02-04 14:33:11,2011-02-04 14:33:11
514c0b5eb48ee23f656ab433ff35f01741d2c3a0...090ff642043a2ca7d69e475f721eab4d68f6572b,3,29,2,31,4,2011-02-04 14:43:10,2011-02-04 14:43:10
090ff642043a2ca7d69e475f721eab4d68f6572b...1a2f9ff9f90fef1ddaff76e1bb5e27e673ccbcc4,2,22,25,47,6,2011-02-04 15:45:52,2011-02-04 15:45:52
1a2f9ff9f90fef1ddaff76e1bb5e27e673ccbcc4...d8c38bd2c988a08cbb89af09f7eff2c0fade99d9,5,55,27,82,26,2011-02-04 17:10:21,2011-02-04 17:10:21
d8c38bd2c988a08cbb89af09f7eff2c0fade99d9...0ffa39f744d339756b4743d240f32430b7c35cd4,1,6,5,11,4,2011-02-04 17:37:25,2011-02-04 17:37:25
0ffa39f744d339756b4743d240f32430b7c35cd4...2d7049c4ee45e8d4820cdf8106a41a9f4a8331da,2,16,8,24,8,2011-02-04 23:46:30,2011-02-04 23:46:30
2d7049c4ee45e8d4820cdf8106a41a9f4a8331da...7a60b411305bc363ec51a096b108fa909c1b352b,3,31,21,52,21,2011-02-05 03:49:03,2011-02-05 03:49:03
7a60b411305bc363ec51a096b108fa909c1b352b...baef1cfbbc5eb61ae140ef11128e11f804a45369,2,8,7,15,4,2011-02-05 04:11:39,2011-02-05 04:11:39
baef1cfbbc5eb61ae140ef11128e11f804a45369...7f65c338fc16cf26b351e83e7c3ec125b74abb02,3,9,8,17,6,2011-02-05 04:46:05,2011-02-05 04:46:05
7f65c338fc16cf26b351e83e7c3ec125b74abb02...b3085f8ae5d78adacce6968966405247b89f5dd7,2,28,2,30,4,2011-02-05 06:33:16,2011-02-05 06:33:16
b3085f8ae5d78adacce6968966405247b89f5dd7...8ce7beaea05cff2ba6cda6ad6747e8840291ff06,1,1,1,2,1,2011-02-05 06:36:23,2011-02-05 06:36:23
8ce7beaea05cff2ba6cda6ad6747e8840291ff06...f2b0f8ea0fc5849801a2aeb71f2db106e5655aea,2,41,12,53,9,2011-02-05 18:16:27,2011-02-05 18:16:27
f2b0f8ea0fc5849801a2aeb71f2db106e5655aea...0b8b60caca5a40b1b3a40cb6414458b95961f813,1,2,2,4,2,2011-02-05 19:21:17,2011-02-05 19:21:17
0b8b60caca5a40b1b3a40cb6414458b95961f813...accee3961ce742884672eba24cbf04138ef2bb1d,2,3,3,6,3,2011-02-05 20:06:49,2011-02-05 20:06:49
accee3961ce742884672eba24cbf04138ef2bb1d...7536f63b32214f7726abc8ec9745538a1ee33e91,35,5519,0,5519,18,2011-02-06 06:06:29,2011-02-06 06:06:29
7536f63b32214f7726abc8ec9745538a1ee33e91...1291888153927072fb2c9ac735c42ce23a297668,1,34,8,42,4,2011-02-06 06:07:06,2011-02-06 06:07:06
1291888153927072fb2c9ac735c42ce23a297668...5582ad149c6f4fcdd0a8dfaf1f22ed0f2bf295b2,2,25,2,27,3,2011-02-06 06:16:03,2011-02-06 06:16:03
5582ad149c6f4fcdd0a8dfaf1f22ed0f2bf295b2...7494345c39162c9052894125ee7af37e1f18adb2,2,14,6,20,2,2011-02-06 06:20:27,2011-02-06 06:20:27
7494345c39162c9052894125ee7af37e1f18adb2...d89ad6423cec80c7550fb0a45d6cdf7b7b31564e,2,28,4,32,6,2011-02-06 06:31:52,2011-02-06 06:31:52
d89ad6423cec80c7550fb0a45d6cdf7b7b31564e...0737307e8c519250aad43420245b4a3eae578650,1,1,2,3,2,2011-02-06 17:28:01,2011-02-06 17:28:01
0737307e8c519250aad43420245b4a3eae578650...5718a678e53be46d90d5bc07519907d317908928,1,4,0,4,1,2011-02-06 18:46:40,2011-02-06 18:46:40
5718a678e53be46d90d5bc07519907d317908928...f6e38f3800f769b6f03799a1792b2cb1a9f42c32,16,274,71,345,51,2011-02-07 18:48:40,2011-02-07 18:48:40
f6e38f3800f769b6f03799a1792b2cb1a9f42c32...608877c066fd69879476ced8d057fa73530da100,1,141,131,272,35,2011-02-07 22:18:14,2011-02-07 22:18:14
608877c066fd69879476ced8d057fa73530da100...1bac26b9a8c90e4bf1175f9c5b9493c5a506fb0c,1,3,1,4,2,2011-02-07 22:32:16,2011-02-07 22:32:16
1bac26b9a8c90e4bf1175f9c5b9493c5a506fb0c...0f50ef12bf795c20486e51785a5ba70a19825735,1,10,1,11,2,2011-02-07 22:52:39,2011-02-07 22:52:39
0f50ef12bf795c20486e51785a5ba70a19825735...327d69de7365e200461bd0f8d5f676a97048423b,1,1,1,2,2,2011-02-07 23:39:29,2011-02-07 23:39:29
327d69de7365e200461bd0f8d5f676a97048423b...f80e997c508cd4c218a5d0ac89018f1be908af85,1,2,2,4,2,2011-02-07 23:44:43,2011-02-07 23:44:43
f80e997c508cd4c218a5d0ac89018f1be908af85...66312066a01af1325280b07d8e6942b03a46d650,1,30,0,30,1,2011-02-07 23:56:39,2011-02-07 23:56:39
66312066a01af1325280b07d8e6942b03a46d650...90a79ba39aa3eb8cf61f977db2d4fddde80665c9,2,2,1,3,2,2011-02-08 11:59:38,2011-02-08 11:59:38
90a79ba39aa3eb8cf61f977db2d4fddde80665c9...a105ca5d7a232edd4713f37fbbe9ee3fec5f9e77,2,40,16,56,11,2011-02-08 12:00:01,2011-02-08 12:00:01
a105ca5d7a232edd4713f37fbbe9ee3fec5f9e77...74ffca17e2ca6a9f061913797efeebbc578692c5,4,42,3,45,6,2011-02-08 12:00:21,2011-02-08 12:00:21
74ffca17e2ca6a9f061913797efeebbc578692c5...4e7c2ba1d7318d60cd371b98bf2afbaebd68acd5,1,11,12,23,8,2011-02-08 12:20:18,2011-02-08 12:20:18
4e7c2ba1d7318d60cd371b98bf2afbaebd68acd5...340eaded4e30cf25bcd4e9781d33a617fe9c0f84,1,1,0,1,1,2011-02-08 14:05:38,2011-02-08 14:05:38
340eaded4e30cf25bcd4e9781d33a617fe9c0f84...d3b38d578f41240442cb043012b0035a20eebd67,2,19,0,19,2,2011-02-08 14:06:02,2011-02-08 14:06:02
d3b38d578f41240442cb043012b0035a20eebd67...c2666c9a455852ef1ae8fec986d6c0fdfc2b779f,1,1,0,1,1,2011-02-09 00:09:54,2011-02-09 00:09:54
c2666c9a455852ef1ae8fec986d6c0fdfc2b779f...208630aa4b6460cb31cd81be2cc83d4075f1f27b,3,49,50,99,9,2011-02-09 02:06:27,2011-02-09 02:06:27
208630aa4b6460cb31cd81be2cc83d4075f1f27b...6ca7c9c495d4195114a6b9d1130dc107921f83b2,2,15,3,18,5,2011-02-09 02:13:24,2011-02-09 02:13:24
6ca7c9c495d4195114a6b9d1130dc107921f83b2...9f6d50d02ea7ce1c5c2adf1c7819700a7912e0d7,2,26,3,29,3,2011-02-09 02:41:32,2011-02-09 02:41:32
9f6d50d02ea7ce1c5c2adf1c7819700a7912e0d7...0d9c5d5a5e2ecf3e38f61509e681c05b515bb1b4,1,60,1,61,2,2011-02-09 12:58:42,2011-02-09 12:58:42
0d9c5d5a5e2ecf3e38f61509e681c05b515bb1b4...8c59905033e1a833f6c2f6f7aa7abad6d68926da,1,8,9,17,4,2011-02-09 12:59:05,2011-02-09 12:59:05
8c59905033e1a833f6c2f6f7aa7abad6d68926da...1ca9ceda599c52d9692eab82e17797e4006c93f2,1,7,2,9,2,2011-02-09 13:04:05,2011-02-09 13:04:05
1ca9ceda599c52d9692eab82e17797e4006c93f2...f913fab6be3bb4af48092d29c02e9bd5377261d4,4,174,7,181,7,2011-02-10 09:27:38,2011-02-10 09:27:38
f913fab6be3bb4af48092d29c02e9bd5377261d4...41dc3fc2e85d3c1db8c9cc4b479e3ace75d82abf,6,121,6,127,8,2011-02-10 11:55:24,2011-02-10 11:55:24
41dc3fc2e85d3c1db8c9cc4b479e3ace75d82abf...0aacecb74c32021bd9ccaee8e9b20b107f5c16ca,1,2,0,2,1,2011-02-10 13:23:24,2011-02-10 13:23:24
0aacecb74c32021bd9ccaee8e9b20b107f5c16ca...b01cc1bd8935f3b97504029c260f4b75061228c2,1,2,0,2,1,2011-02-11 18:23:55,2011-02-11 18:23:55
b01cc1bd8935f3b97504029c260f4b75061228c2...337a6bc0f61fd3f72f1e2cacbb3bb5821028e44f,1,1,1,2,1,2011-02-12 05:23:41,2011-02-12 05:23:41
337a6bc0f61fd3f72f1e2cacbb3bb5821028e44f...d1cd53d9cf1c42ee8d1913fe00bb836ee7fa8d6c,2,181,81,262,20,2011-02-12 13:02:42,2011-02-12 13:02:42
d1cd53d9cf1c42ee8d1913fe00bb836ee7fa8d6c...6314a1b42e4f695b4c575585375fe91697911d5c,11,271,47,318,29,2011-02-12 13:03:34,2011-02-12 13:03:34
6314a1b42e4f695b4c575585375fe91697911d5c...f6d4e5b08a27dd6be4c4cbf0da79dfe2c2bdebac,1,17,17,34,8,2011-02-12 13:11:33,2011-02-12 13:11:33
f6d4e5b08a27dd6be4c4cbf0da79dfe2c2bdebac...9ae2a9477642e3e868d9981a68472b3c250e1a9d,1,2,2,4,2,2011-02-12 13:12:01,2011-02-12 13:12:01
9ae2a9477642e3e868d9981a68472b3c250e1a9d...492b8a0821b4cd66a33b5ad8d18234ddcba947f4,3,45,2,47,5,2011-02-12 15:07:27,2011-02-12 15:07:27
492b8a0821b4cd66a33b5ad8d18234ddcba947f4...e258d9a10b92ef581556d9f265d7798d28b3330d,2,21,3,24,8,2011-02-12 19:11:35,2011-02-12 19:11:35
e258d9a10b92ef581556d9f265d7798d28b3330d...ff4a24af515a5fa36f522d96e9491de0194b8bed,2,3,3,6,3,2011-02-12 19:11:42,2011-02-12 19:11:42
ff4a24af515a5fa36f522d96e9491de0194b8bed...47b1a8e704b375f0b4f79db8432e4373d33e746d,2,28,9,37,4,2011-02-12 19:11:49,2011-02-12 19:11:49
47b1a8e704b375f0b4f79db8432e4373d33e746d...bc5c2537ae3d09d3b9145beb027ff9f60eac6ba3,2,7,3,10,5,2011-02-12 19:11:57,2011-02-12 19:11:57
bc5c2537ae3d09d3b9145beb027ff9f60eac6ba3...ba1876cef22e46fe4e80ce32547ec9870991b63b,2,3,0,3,2,2011-02-12 19:12:05,2011-02-12 19:12:05
ba1876cef22e46fe4e80ce32547ec9870991b63b...632d9f994f1203815bfc00a530c115be8dad5c1d,3,11,3,14,4,2011-02-12 19:12:14,2011-02-12 19:12:14
632d9f994f1203815bfc00a530c115be8dad5c1d...204e83e3318dff37bb9dc1d4e9019782188e0466,1,43,28,71,8,2011-02-12 19:12:21,2011-02-12 19:12:21
204e83e3318dff37bb9dc1d4e9019782188e0466...e1e3f243715c400bc6e2cec5bd650ac90ecb7f44,1,20,13,33,5,2011-02-12 19:12:28,2011-02-12 19:12:28
e1e3f243715c400bc6e2cec5bd650ac90ecb7f44...179fefcf7c1e9c6f0a4db5b31a4444bee24e73fa,3,45,8,53,6,2011-02-12 19:12:36,2011-02-12 19:12:36
179fefcf7c1e9c6f0a4db5b31a4444bee24e73fa...eaf17475b28061f9beed778b9711077379daeae1,1,12,1,13,2,2011-02-12 20:42:39,2011-02-12 20:42:39
eaf17475b28061f9beed778b9711077379daeae1...ee060202409c5700fc2237ce5dab1c0a0486b1d3,1,2,5,7,4,2011-02-12 22:38:23,2011-02-12 22:38:23
ee060202409c5700fc2237ce5dab1c0a0486b1d3...d068a0424426293a63c99200e9dd0add1edcb27a,1,17,19,36,4,2011-02-12 23:37:35,2011-02-12 23:37:35
d068a0424426293a63c99200e9dd0add1edcb27a...e3a2fef7cc23a4c38c543b8d5a366baf954e12c7,1,0,6,6,1,2011-02-12 23:38:50,2011-02-12 23:38:50
e3a2fef7cc23a4c38c543b8d5a366baf954e12c7...c40a1d1835eebdc1661f6d8d19660df8f349394c,1,0,3,3,1,2011-02-12 23:50:39,2011-02-12 23:50:39
c40a1d1835eebdc1661f6d8d19660df8f349394c...c7618d5fa642f608459b3eb50074c7039abb3709,2,81,45,126,19,2011-02-13 01:50:54,2011-02-13 01:50:54
c7618d5fa642f608459b3eb50074c7039abb3709...a797b7dba0644558ca7bf825b22268f2b4d9d3b5,2,34,2,36,5,2011-02-13 01:56:12,2011-02-13 01:56:12
a797b7dba0644558ca7bf825b22268f2b4d9d3b5...f6aa469b1da50228b7e082c4ac0ecbe57575a373,2,35,3,38,6,2011-02-13 02:24:05,2011-02-13 02:24:05
f6aa469b1da50228b7e082c4ac0ecbe57575a373...337b6786fdfcc7a8b2f8eced0de6b966ab5553de,3,173,9,182,11,2011-02-13 22:51:40,2011-02-13 22:51:40
337b6786fdfcc7a8b2f8eced0de6b966ab5553de...7e46b170007dd7b9a95e845cbb971d4eb170e317,1,7,7,14,5,2011-02-14 00:06:52,2011-02-14 00:06:52
7e46b170007dd7b9a95e845cbb971d4eb170e317...756f1c218dcbcb6c593fc0631149d39d47f2ada8,1,19,13,32,5,2011-02-14 00:07:09,2011-02-14 00:07:09
756f1c218dcbcb6c593fc0631149d39d47f2ada8...6b1191b1a2cecb48661d476b3a7f17e17c0d819c,1,3,1,4,1,2011-02-14 01:42:12,2011-02-14 01:42:12
6b1191b1a2cecb48661d476b3a7f17e17c0d819c...a26034ffbf8951276b79ccb298423bc809246637,8,223,211,434,28,2011-02-14 01:42:26,2011-02-14 01:42:26
a26034ffbf8951276b79ccb298423bc809246637...06b22963eae4751d3d5f9616ba24b0f33b8158b0,7,44,41,85,30,2011-02-14 13:04:51,2011-02-14 13:04:51
06b22963eae4751d3d5f9616ba24b0f33b8158b0...bb26c328ecb831889bedb0c8354a93c8176187c6,5,23,3,26,5,2011-02-14 13:05:14,2011-02-14 13:05:14
bb26c328ecb831889bedb0c8354a93c8176187c6...72e4a6865d36f8885e7a35ca8de8fe6d1ec3ff18,3,30,17,47,16,2011-02-14 13:05:31,2011-02-14 13:05:31
72e4a6865d36f8885e7a35ca8de8fe6d1ec3ff18...d7c2dcd5387e12828daf6fe4b852f2e894da79e8,3,4,4,8,3,2011-02-14 15:02:02,2011-02-14 15:02:02
d7c2dcd5387e12828daf6fe4b852f2e894da79e8...6eacbfd4111127c0cfc5e9272ef4553a163ed7df,7,17,17,34,15,2011-02-14 23:18:30,2011-02-14 23:18:30
6eacbfd4111127c0cfc5e9272ef4553a163ed7df...64a0a33c33079fa8ea79f1935d2a56281427e0f0,4,37,20,57,26,2011-02-14 23:45:32,2011-02-14 23:45:32
64a0a33c33079fa8ea79f1935d2a56281427e0f0...4bb2db0caec69bfa5903fbc81d2635cc17922c46,1,4,3,7,2,2011-02-14 23:45:41,2011-02-14 23:45:41
4bb2db0caec69bfa5903fbc81d2635cc17922c46...64b042bb3c017e327edc326ce370a16a910ea4a6,4,39,1,40,4,2011-02-15 08:12:29,2011-02-15 08:12:29
64b042bb3c017e327edc326ce370a16a910ea4a6...0577edf61097f3e677905a202f2c0e62a6514646,2,13,2,15,4,2011-02-15 18:15:38,2011-02-15 18:15:38
0577edf61097f3e677905a202f2c0e62a6514646...e9d99c43711087c8840b725726efc7237e125477,1,108,89,197,45,2011-02-16 00:12:52,2011-02-16 00:12:52
e9d99c43711087c8840b725726efc7237e125477...9323f81dc03047371329c954c8eec8ef97d4dc16,1,25,7,32,2,2011-02-16 00:18:09,2011-02-16 00:18:09
9323f81dc03047371329c954c8eec8ef97d4dc16...a40685fdfcdb1a4fb8769a2d68fbbae632a8cdcd,1,57,54,111,42,2011-02-16 00:24:49,2011-02-16 00:24:49
a40685fdfcdb1a4fb8769a2d68fbbae632a8cdcd...319de16ff0687072eefe5487b088af9e7ba11fd0,9,307,268,575,171,2011-02-16 01:56:53,2011-02-16 01:56:53
319de16ff0687072eefe5487b088af9e7ba11fd0...d5042109b80a9976df58e081e2ab74a4bde26d23,1,1,1,2,1,2011-02-16 03:30:27,2011-02-16 03:30:27
d5042109b80a9976df58e081e2ab74a4bde26d23...24e0b56dcb92febdaf9ea83b394d7866c7c956a9,1,13,2,15,3,2011-02-16 12:50:46,2011-02-16 12:50:46
24e0b56dcb92febdaf9ea83b394d7866c7c956a9...ada08cd6d824e4cee976d3c3b68b0d153b403eee,2,27,9,36,12,2011-02-16 12:50:57,2011-02-16 12:50:57
ada08cd6d824e4cee976d3c3b68b0d153b403eee...9ebc9108defa0267f0f84dcf16bfab83b332da75,1,1,1,2,1,2011-02-16 15:44:13,2011-02-16 15:44:13
9ebc9108defa0267f0f84dcf16bfab83b332da75...8c3416f4688d5f6fe84aac1264a6c54ee326960d,1,3,2,5,3,2011-02-16 22:30:44,2011-02-16 22:30:44
8c3416f4688d5f6fe84aac1264a6c54ee326960d...5edb61438e05e7e962474d0a9e1b5e3b7cdc6475,1,1,1,2,1,2011-02-17 02:11:44,2011-02-17 02:11:44
5edb61438e05e7e962474d0a9e1b5e3b7cdc6475...ed7a30782b7bf0e30fd47fc407e3b9c22bd80d2f,1,47,41,88,14,2011-02-17 03:50:55,2011-02-17 03:50:55
ed7a30782b7bf0e30fd47fc407e3b9c22bd80d2f...969217d45566e6853a2358088002e80b4afb9708,4,33,11,44,6,2011-02-17 04:35:26,2011-02-17 04:35:26
969217d45566e6853a2358088002e80b4afb9708...f81d5d68546cede0adfb7be808688bde3a08df1b,1,1,1,2,1,2011-02-17 21:08:45,2011-02-17 21:08:45
f81d5d68546cede0adfb7be808688bde3a08df1b...fe1110018ae98dec8d62d83f4672313e246f4170,2,83,37,120,28,2011-02-18 00:58:34,2011-02-18 00:58:34
fe1110018ae98dec8d62d83f4672313e246f4170...e06dfda91862d8c5015b0036c59d829359ed7f7b,1,9,2,11,3,2011-02-18 06:50:13,2011-02-18 06:50:13
e06dfda91862d8c5015b0036c59d829359ed7f7b...eb80803454441be0f9d10232fc3b00d40682a2d7,1,1,1,2,1,2011-02-18 13:40:53,2011-02-18 13:40:53
eb80803454441be0f9d10232fc3b00d40682a2d7...f58dd619b84d2afb42f035f38f5fada75b6a815b,1,1,1,2,1,2011-02-18 22:42:37,2011-02-18 22:42:37
f58dd619b84d2afb42f035f38f5fada75b6a815b...34662e7a301e651df6d8e7d978b0138c3dce76e4,1,4,1,5,1,2011-02-19 07:40:09,2011-02-19 07:40:09
34662e7a301e651df6d8e7d978b0138c3dce76e4...670f4d9628c047aac1473bffa520863f74a4614f,1,1,1,2,1,2011-02-19 07:41:17,2011-02-19 07:41:17
670f4d9628c047aac1473bffa520863f74a4614f...127725c56062659c284b18ca097db99be863227b,1,1,1,2,1,2011-02-19 08:09:40,2011-02-19 08:09:40
127725c56062659c284b18ca097db99be863227b...c63bc87a9872ed8379426c2cb4d44c78e9eed632,1,0,2,2,1,2011-02-19 08:10:01,2011-02-19 08:10:01
c63bc87a9872ed8379426c2cb4d44c78e9eed632...563a164c056497fb8ac5c5c2cc8e8643213de94e,1,6,5,11,1,2011-02-19 08:10:19,2011-02-19 08:10:19
563a164c056497fb8ac5c5c2cc8e8643213de94e...d3cc5dbb325d83dff69db5ac1487ac4b8518e2d3,1,2,2,4,2,2011-02-19 08:10:37,2011-02-19 08:10:37
d3cc5dbb325d83dff69db5ac1487ac4b8518e2d3...b3c7e399a4a6600a48c95bb0989e82e181603b2d,3,8,3,11,4,2011-02-19 08:10:57,2011-02-19 08:10:57
b3c7e399a4a6600a48c95bb0989e82e181603b2d...de161fbf21a77509d93804a66b28d2f28731e7e4,1,38,0,38,3,2011-02-19 08:37:46,2011-02-19 08:37:46
de161fbf21a77509d93804a66b28d2f28731e7e4...791ecb4be4d64618a40e1a80fad26a5e3b4d4b90,4,95,5,100,7,2011-02-19 11:48:42,2011-02-19 11:48:42
791ecb4be4d64618a40e1a80fad26a5e3b4d4b90...fe3c9ad55103f8fe473bdcf77d06cb958cbaf217,5,21,6,27,6,2011-02-19 12:55:09,2011-02-19 12:55:09
fe3c9ad55103f8fe473bdcf77d06cb958cbaf217...75a1aaa1f9341e558b6efe9227cf663d55704469,3,51,2,53,5,2011-02-19 14:05:07,2011-02-19 14:05:07
75a1aaa1f9341e558b6efe9227cf663d55704469...1abf126e612fca1efec2986400e2996be8130d22,2,23,3,26,4,2011-02-19 14:45:54,2011-02-19 14:45:54
1abf126e612fca1efec2986400e2996be8130d22...1d4640a58f1ab1652d884d15bad1ec5a1d7c1df4,1,1,1,2,1,2011-02-19 22:28:39,2011-02-19 22:28:39
1d4640a58f1ab1652d884d15bad1ec5a1d7c1df4...8ee9a4627e6716f24f529260928a1c36e7941e66,1,5,2,7,2,2011-02-19 23:59:59,2011-02-19 23:59:59
8ee9a4627e6716f24f529260928a1c36e7941e66...1073a83f2ceb330c80da275c0709786a7a84c513,3,35,5,40,3,2011-02-20 04:55:11,2011-02-20 04:55:11
1073a83f2ceb330c80da275c0709786a7a84c513...674062c355b1acdc49c2b0cf2ba0d23e0eb8371c,2,13,4,17,5,2011-02-20 13:43:52,2011-02-20 13:43:52
674062c355b1acdc49c2b0cf2ba0d23e0eb8371c...52fc61e0cfb334af69154e862c148036d111dba6,3,75,4,79,8,2011-02-20 23:09:25,2011-02-20 23:09:25
52fc61e0cfb334af69154e862c148036d111dba6...01c42cbb99e6d14ef8efc74223efb0c2b3672280,1,2,2,4,2,2011-02-20 23:43:55,2011-02-20 23:43:55
01c42cbb99e6d14ef8efc74223efb0c2b3672280...4419f5fc00d82bdc022b0b188bb75a452c575d6f,2,30,1,31,9,2011-02-21 10:12:23,2011-02-21 10:12:23
4419f5fc00d82bdc022b0b188bb75a452c575d6f...f21fc714eadcb90e1b61c0d86b34843f761516ea,1,1,0,1,1,2011-02-21 12:35:19,2011-02-21 12:35:19
f21fc714eadcb90e1b61c0d86b34843f761516ea...b700c3a918a03ea0aa4fd16690af82c21813a6ae,1,4,0,4,4,2011-02-21 13:45:29,2011-02-21 13:45:29
b700c3a918a03ea0aa4fd16690af82c21813a6ae...b151bccdcc654856b849ab19b6deb68c22794e23,2,11,1,12,2,2011-02-21 13:45:57,2011-02-21 13:45:57
b151bccdcc654856b849ab19b6deb68c22794e23...470d9b2602fe53e8c6cbcd9287cd86048cae67d0,1,1,2,3,1,2011-02-21 13:46:13,2011-02-21 13:46:13
470d9b2602fe53e8c6cbcd9287cd86048cae67d0...6902824ac204d2207f50a3b788ae9d3d5947d01f,3,24,2,26,6,2011-02-21 14:03:59,2011-02-21 14:03:59
6902824ac204d2207f50a3b788ae9d3d5947d01f...ae10b2772b30a2fa6a8c8de22a20d8a940fa6a95,1,1,0,1,1,2011-02-21 14:16:29,2011-02-21 14:16:29
ae10b2772b30a2fa6a8c8de22a20d8a940fa6a95...13f9fd38dc299a682c61e175c83070a7c5a84103,2,130,14,144,6,2011-02-21 14:23:02,2011-02-21 14:23:02
13f9fd38dc299a682c61e175c83070a7c5a84103...c411377bd56e0f97c56a3f9c13f0b7a435906dd9,2,22,3,25,2,2011-02-21 15:43:42,2011-02-21 15:43:42
c411377bd56e0f97c56a3f9c13f0b7a435906dd9...1b062f6613ba234cd2e72df9823ae1b65de02b21,1,1,1,2,1,2011-02-21 18:43:54,2011-02-21 18:43:54
1b062f6613ba234cd2e72df9823ae1b65de02b21...fdf9602961bce9439d489ea2d1b11b919b0c7cf4,4,23,11,34,12,2011-02-21 19:15:02,2011-02-21 19:15:02
fdf9602961bce9439d489ea2d1b11b919b0c7cf4...e57e29616772fe628333fd71b3f4cf7c2c17eff8,1,1,1,2,1,2011-02-21 23:00:44,2011-02-21 23:00:44
e57e29616772fe628333fd71b3f4cf7c2c17eff8...00fb22d83600a1e3ca162257a46e4a2a5004ef2b,1,5,2,7,1,2011-02-22 00:57:28,2011-02-22 00:57:28
00fb22d83600a1e3ca162257a46e4a2a5004ef2b...337d102b8612503bb9dc712bfbf07432a9a96302,4,63,4,67,8,2011-02-22 03:07:57,2011-02-22 03:07:57
337d102b8612503bb9dc712bfbf07432a9a96302...37343bac8a62aa31431e343f25f957a5392863fb,4,14,70,84,4,2011-02-22 11:27:58,2011-02-22 11:27:58
37343bac8a62aa31431e343f25f957a5392863fb...b9a20d1e3bacd9e461dd8b82c219b5100c4b7876,2,8,4,12,4,2011-02-22 11:33:04,2011-02-22 11:33:04
b9a20d1e3bacd9e461dd8b82c219b5100c4b7876...6ce03dd888cba5fc63feac0b2535972c84ebc6e2,1,2,2,4,1,2011-02-23 09:41:38,2011-02-23 09:41:38
6ce03dd888cba5fc63feac0b2535972c84ebc6e2...7aa84917a4ae8ca380fea1ae1937706d367389ed,6,88,32,120,12,2011-02-23 13:36:58,2011-02-23 13:36:58
7aa84917a4ae8ca380fea1ae1937706d367389ed...12bd7bcb35703c2d2d19f6b79140d727ddee6e5f,3,20,3,23,6,2011-02-23 13:43:21,2011-02-23 13:43:21
12bd7bcb35703c2d2d19f6b79140d727ddee6e5f...4b13e76debbb64818559b504a2dd043af5fcad33,2,18,3,21,4,2011-02-24 01:00:57,2011-02-24 01:00:57
4b13e76debbb64818559b504a2dd043af5fcad33...174d8db57caf56e845aee54c02b57c14b777f892,2,23,2,25,5,2011-02-24 13:34:51,2011-02-24 13:34:51
174d8db57caf56e845aee54c02b57c14b777f892...a4f791a1a63caad9106dcba08ae4091a02c94d75,2,4,4,8,4,2011-02-25 01:02:59,2011-02-25 01:02:59
a4f791a1a63caad9106dcba08ae4091a02c94d75...c2518f55c71e2705b959e339315990ebf359176e,2,3,1,4,3,2011-02-25 01:03:18,2011-02-25 01:03:18
c2518f55c71e2705b959e339315990ebf359176e...c250b8840b19c78fe87b614fee34cd1a46245c21,3,424,110,534,53,2011-02-25 02:45:48,2011-02-25 02:45:48
c250b8840b19c78fe87b614fee34cd1a46245c21...b97b9fb8f8fcc5aceb924c10c343e7a5eb4990bc,1,16,9,25,4,2011-02-25 09:44:52,2011-02-25 09:44:52
b97b9fb8f8fcc5aceb924c10c343e7a5eb4990bc...4d70d48ecbfe2b972c55c3b4fa1237dfe54f5b6b,4,260,19,279,23,2011-02-25 15:14:26,2011-02-25 15:14:26
4d70d48ecbfe2b972c55c3b4fa1237dfe54f5b6b...0a9b5d7adee86def16972debf6441deb96135ce2,7,99,20,119,14,2011-02-26 01:44:41,2011-02-26 01:44:41
0a9b5d7adee86def16972debf6441deb96135ce2...312d2f3edd9cf25a76822da52e0725c26dcf051b,1,1,1,2,1,2011-02-26 05:37:35,2011-02-26 05:37:35
312d2f3edd9cf25a76822da52e0725c26dcf051b...380906b94659930be656e929ff417bd474f6e81a,2,1382,1358,2740,2,2011-02-26 08:49:01,2011-02-26 08:49:01
380906b94659930be656e929ff417bd474f6e81a...f5bbeb147bdf4047cc0ae011ca2426b3f4bef70c,1,1,1,2,1,2011-02-26 08:49:05,2011-02-26 08:49:05
f5bbeb147bdf4047cc0ae011ca2426b3f4bef70c...e5dfc6cf94d437b1894cb4a93a4117cf3e90e07f,2,1358,1382,2740,2,2011-02-26 08:50:15,2011-02-26 08:50:15
e5dfc6cf94d437b1894cb4a93a4117cf3e90e07f...0b53d318ef29a34afdb4ecca1c50641760a525eb,2,5,3,8,3,2011-02-26 12:43:57,2011-02-26 12:43:57
0b53d318ef29a34afdb4ecca1c50641760a525eb...b5b5ba6cd9179372cead3e6d19f732285e80b799,2,11,3,14,3,2011-02-26 12:44:25,2011-02-26 12:44:25
b5b5ba6cd9179372cead3e6d19f732285e80b799...2366415f48282faef6e45993b08d1dec1f0b5e35,5,29,15,44,11,2011-02-27 00:24:35,2011-02-27 00:24:35
2366415f48282faef6e45993b08d1dec1f0b5e35...2dfbe92d7c292cd395a00246ce7aa0ca0bf96e5e,1,1,1,2,1,2011-02-27 11:54:03,2011-02-27 11:54:03
2dfbe92d7c292cd395a00246ce7aa0ca0bf96e5e...28123d715389d85e78b757287baedf577d71c4a9,1,2,1,3,1,2011-02-27 21:16:58,2011-02-27 21:16:58
28123d715389d85e78b757287baedf577d71c4a9...2b7b4683257c072f74b03358ccc368831b872671,2,65,6,71,11,2011-02-27 22:13:07,2011-02-27 22:13:07
2b7b4683257c072f74b03358ccc368831b872671...c5a6badbfc95d839f5952087ac59f7d1e76ac9a6,1,321,321,642,1,2011-02-27 23:31:46,2011-02-27 23:31:46
c5a6badbfc95d839f5952087ac59f7d1e76ac9a6...70d3c84d186d11edc2f6c7d46dd1d6ef26b4d56f,2,41,4,45,7,2011-02-28 02:42:28,2011-02-28 02:42:28
70d3c84d186d11edc2f6c7d46dd1d6ef26b4d56f...c9db8cc83f329289cbc98c9b110954938a6f67aa,1,20,7,27,10,2011-02-28 05:25:46,2011-02-28 05:25:46
c9db8cc83f329289cbc98c9b110954938a6f67aa...13838fb233f15ba1a409c31003ca5dc9c9a42eea,1,7,0,7,1,2011-02-28 05:39:44,2011-02-28 05:39:44
13838fb233f15ba1a409c31003ca5dc9c9a42eea...b1a0ad007966898c305f4823c590a3e808095e9a,1,4,1,5,1,2011-02-28 14:07:59,2011-02-28 14:07:59
b1a0ad007966898c305f4823c590a3e808095e9a...bd3b5e8c2b36633134ab63e5a6af7b5f5839a7c4,3,33,9,42,10,2011-03-01 02:04:35,2011-03-01 02:04:35
bd3b5e8c2b36633134ab63e5a6af7b5f5839a7c4...5aca35329cb44f05b3594c311ba4d1bae4f48e12,1,3,6,9,1,2011-03-01 03:05:57,2011-03-01 03:05:57
5aca35329cb44f05b3594c311ba4d1bae4f48e12...8a94108110a489cab80089d8fcba3a8e058b608f,128,14048,11602,25650,10275,2011-03-01 08:50:02,2011-03-01 08:50:02
8a94108110a489cab80089d8fcba3a8e058b608f...4eb060516c7f29495b613056fae12409452c6aa4,6,2332,64,2396,69,2011-03-01 08:50:18,2011-03-01 08:50:18
4eb060516c7f29495b613056fae12409452c6aa4...3a5e4244088c2361a6d617fab127dcc5905b36ad,264,8908,7387,16295,5926,2011-03-01 08:52:36,2011-03-01 08:52:36
3a5e4244088c2361a6d617fab127dcc5905b36ad...077d5dcf754e54b469f68ff132dcf75a9cfb355d,132,896,678,1574,366,2011-03-01 08:54:19,2011-03-01 08:54:19
077d5dcf754e54b469f68ff132dcf75a9cfb355d...f3ed462822396bdcc186a14c82eb3ddba46fe2d2,132,1297,1025,2322,691,2011-03-01 08:56:02,2011-03-01 08:56:02
f3ed462822396bdcc186a14c82eb3ddba46fe2d2...4d30e8bccc9bfb3b5e1d6b28745eceb2fdd86706,132,2121,2155,4276,1653,2011-03-01 08:57:42,2011-03-01 08:57:42
4d30e8bccc9bfb3b5e1d6b28745eceb2fdd86706...379ce73ee3cd4ddf4b03499c8b2094c5c70a375b,132,499,517,1016,220,2011-03-01 08:59:22,2011-03-01 08:59:22
379ce73ee3cd4ddf4b03499c8b2094c5c70a375b...c6c54bbf6618841edbebc24128d094a5e78e2e10,132,713,699,1412,367,2011-03-01 09:01:01,2011-03-01 09:01:01
c6c54bbf6618841edbebc24128d094a5e78e2e10...533517ec65ceaa684595e8427edc786e860abaea,132,555,569,1124,272,2011-03-01 09:02:40,2011-03-01 09:02:40
533517ec65ceaa684595e8427edc786e860abaea...f7c9d771341dcdb436e4ae2e72e278f0dbc28e13,132,733,696,1429,407,2011-03-01 09:04:19,2011-03-01 09:04:19
f7c9d771341dcdb436e4ae2e72e278f0dbc28e13...c06ed7275968f801ac321c78cc85d727e4b48e63,132,814,719,1533,379,2011-03-01 09:06:04,2011-03-01 09:06:04
c06ed7275968f801ac321c78cc85d727e4b48e63...d38bce59ae28e17fddea75f2f0486b1a978004c8,132,10682,8726,19408,8434,2011-03-01 09:07:46,2011-03-01 09:07:46
d38bce59ae28e17fddea75f2f0486b1a978004c8...3547d2bb9375b0f81c3839f35981e5e69013524f,132,562,618,1180,297,2011-03-01 09:09:25,2011-03-01 09:09:25
3547d2bb9375b0f81c3839f35981e5e69013524f...faf292a93e2c71e48c7eddc4c65bb947de211047,132,557,523,1080,227,2011-03-01 09:11:04,2011-03-01 09:11:04
faf292a93e2c71e48c7eddc4c65bb947de211047...9838ba0db7b7dd5142ebb6774559eb5a1070a676,132,516,515,1031,218,2011-03-01 09:12:43,2011-03-01 09:12:43
9838ba0db7b7dd5142ebb6774559eb5a1070a676...3f38a991744cf86b9e56c2fc4b7b8946f0f493b8,132,504,511,1015,214,2011-03-01 09:14:22,2011-03-01 09:14:22
3f38a991744cf86b9e56c2fc4b7b8946f0f493b8...dbe6ced0d6911386d731a045e00b0d4c005b8e45,7,196,26,222,26,2011-03-01 14:28:06,2011-03-01 14:28:06
dbe6ced0d6911386d731a045e00b0d4c005b8e45...477c482c24d6bf5968fe908af5fb5df6259f2556,1,1,1,2,1,2011-03-01 16:52:48,2011-03-01 16:52:48
477c482c24d6bf5968fe908af5fb5df6259f2556...8f1987826311cca9e527ce34762ac035f799aa64,1,6,0,6,1,2011-03-01 18:25:35,2011-03-01 18:25:35
8f1987826311cca9e527ce34762ac035f799aa64...be4a2e3f3e0a04c87e6c9127cb1011df7c53e9e9,3,49,38,87,12,2011-03-01 22:49:10,2011-03-01 22:49:10
be4a2e3f3e0a04c87e6c9127cb1011df7c53e9e9...ec193224d3580fbcfa78da96a6a7fc4343929dd8,2,7,4,11,4,2011-03-01 22:49:18,2011-03-01 22:49:18
ec193224d3580fbcfa78da96a6a7fc4343929dd8...6b95aa6fb549b3834b7feefc6fbe92f8a50da411,3,34,48,82,11,2011-03-02 10:40:48,2011-03-02 10:40:48
6b95aa6fb549b3834b7feefc6fbe92f8a50da411...a9ace1466d0a57a020fd1318378df474352ba27a,1,2,2,4,2,2011-03-02 10:44:48,2011-03-02 10:44:48
a9ace1466d0a57a020fd1318378df474352ba27a...f6c991667f6f1ab8d2fd2afc1ee2b5801e78b7e3,6,57,15,72,16,2011-03-02 12:47:36,2011-03-02 12:47:36
f6c991667f6f1ab8d2fd2afc1ee2b5801e78b7e3...751888ece3c970e208d9d77f21a35464c9122835,2,97,33,130,13,2011-03-02 12:47:44,2011-03-02 12:47:44
751888ece3c970e208d9d77f21a35464c9122835...cff4ee5cbacd4353015f528610a346f9b9f5bda8,2,5,1,6,2,2011-03-02 13:15:54,2011-03-02 13:15:54
cff4ee5cbacd4353015f528610a346f9b9f5bda8...93cd8442fc6a1b4838ccc6609b6771d697958c05,2,4,1,5,2,2011-03-02 21:36:41,2011-03-02 21:36:41
93cd8442fc6a1b4838ccc6609b6771d697958c05...03717325dddee2d30d1a59952229827af021fceb,2,2,2,4,2,2011-03-03 00:24:41,2011-03-03 00:24:41
03717325dddee2d30d1a59952229827af021fceb...22347c89d8941be0d08e39839503c8cc00ca263c,1,1,1,2,1,2011-03-03 00:25:02,2011-03-03 00:25:02
22347c89d8941be0d08e39839503c8cc00ca263c...17bd34930a35f4097082ed3e2453d42d7d4f21a4,1,2,2,4,2,2011-03-03 00:25:17,2011-03-03 00:25:17
17bd34930a35f4097082ed3e2453d42d7d4f21a4...edfed185811821a6d000f32d22fe398dfe3e0fe9,3,38,2,40,5,2011-03-03 00:41:40,2011-03-03 00:41:40
edfed185811821a6d000f32d22fe398dfe3e0fe9...49cfe253991bd255e3293da545ba9af00ab6e18f,8,14,19,33,11,2011-03-03 01:54:33,2011-03-03 01:54:33
49cfe253991bd255e3293da545ba9af00ab6e18f...c0fb9bd00b16bf384b726adb3c0dec34fc90e615,2,32,1,33,3,2011-03-03 13:03:53,2011-03-03 13:03:53
c0fb9bd00b16bf384b726adb3c0dec34fc90e615...b921f1bac090cecd87e0b99b4c7c2d7581bcf2da,4,59,3,62,6,2011-03-03 13:20:45,2011-03-03 13:20:45
b921f1bac090cecd87e0b99b4c7c2d7581bcf2da...d1290b5b43485c7018ba92981d34c1f96614924e,8,44,25,69,17,2011-03-03 13:28:20,2011-03-03 13:28:20
d1290b5b43485c7018ba92981d34c1f96614924e...b7c41c1fbb2d45634dde5f7a450ba1a5aea5a8af,3,98,6,104,6,2011-03-03 13:51:54,2011-03-03 13:51:54
b7c41c1fbb2d45634dde5f7a450ba1a5aea5a8af...afd040d4d3a06fe92e3080870b2ff2095ce86a75,110,1198,1198,2396,829,2011-03-03 15:04:39,2011-03-03 15:04:39
afd040d4d3a06fe92e3080870b2ff2095ce86a75...e8fa1abd78367d92750db4d311fed15c2727e380,1,2,5,7,2,2011-03-03 18:26:15,2011-03-03 18:26:15
e8fa1abd78367d92750db4d311fed15c2727e380...d50f59ee18f6f1241f4d14d7218b6fb64ce9c3b5,1,4,1,5,1,2011-03-03 18:42:59,2011-03-03 18:42:59
d50f59ee18f6f1241f4d14d7218b6fb64ce9c3b5...20b940614e62c1b71c7a438c686fe6a387746f28,4,24,6,30,7,2011-03-03 19:31:10,2011-03-03 19:31:10
20b940614e62c1b71c7a438c686fe6a387746f28...9428c2386937d0d311d5159a74b28cd309e92232,1,2,0,2,1,2011-03-03 19:35:27,2011-03-03 19:35:27
9428c2386937d0d311d5159a74b28cd309e92232...3ecf628b3650e0f9f086b1ae77b43ad5df48a92e,2,27,3,30,5,2011-03-03 20:56:46,2011-03-03 20:56:46
3ecf628b3650e0f9f086b1ae77b43ad5df48a92e...136930085bb9e8ed434b6b9aeddd58e336f96f5e,1,1,0,1,1,2011-03-03 21:04:32,2011-03-03 21:04:32
136930085bb9e8ed434b6b9aeddd58e336f96f5e...4e76f0f79398d7ed7c1fea88b70f846e96c94de5,2,63,45,108,38,2011-03-03 22:20:54,2011-03-03 22:20:54
4e76f0f79398d7ed7c1fea88b70f846e96c94de5...d05bb1384abba241749d89a8bf4961d3de12e628,1,25,21,46,12,2011-03-03 23:49:44,2011-03-03 23:49:44
d05bb1384abba241749d89a8bf4961d3de12e628...806bffcf08893fc9a5104b3a1208551a5627473e,1,1,0,1,1,2011-03-03 23:54:12,2011-03-03 23:54:12
806bffcf08893fc9a5104b3a1208551a5627473e...185b4f49ca2e61c62208425c06bb6a19a25eaca3,2,5,2,7,3,2011-03-04 00:01:56,2011-03-04 00:01:56
185b4f49ca2e61c62208425c06bb6a19a25eaca3...4b746a6a2421bd22c3135ac2947b5f7370d2dd87,1,15,11,26,4,2011-03-04 00:23:00,2011-03-04 00:23:00
4b746a6a2421bd22c3135ac2947b5f7370d2dd87...acd296bb9c78c410054b80bbf96e67025ed14135,1,11,8,19,17,2011-03-04 00:27:22,2011-03-04 00:27:22
acd296bb9c78c410054b80bbf96e67025ed14135...bef353873ea6623934ed7290c81fc2677a0030dd,32,32,32,64,32,2011-03-04 01:03:14,2011-03-04 01:03:14
bef353873ea6623934ed7290c81fc2677a0030dd...53b2a2539607a75878d33958b804de85241d8586,32,55,39,94,32,2011-03-04 01:04:31,2011-03-04 01:04:31
53b2a2539607a75878d33958b804de85241d8586...c11140d04b29d8d4b0527e563b841f5c16dac09d,32,32,32,64,32,2011-03-04 01:05:10,2011-03-04 01:05:10
c11140d04b29d8d4b0527e563b841f5c16dac09d...90564a156c1b0e9a5735250d5bdf4f568c3e0854,160,96,96,192,80,2011-03-04 01:07:11,2011-03-04 01:07:11
90564a156c1b0e9a5735250d5bdf4f568c3e0854...18f42f546a1bb7478829986154375abf37762e13,1,12,9,21,9,2011-03-04 01:27:14,2011-03-04 01:27:14
18f42f546a1bb7478829986154375abf37762e13...5e9deba988e07486c77873e2d8673e87759cc3f9,2,2,2,4,2,2011-03-04 05:27:28,2011-03-04 05:27:28
5e9deba988e07486c77873e2d8673e87759cc3f9...32255c20a5589af4cde4c83a36e38f33573d9c34,1,1,1,2,1,2011-03-04 21:13:42,2011-03-04 21:13:42
32255c20a5589af4cde4c83a36e38f33573d9c34...8940969a7a1506c098b212dcb3b4f8391d8d5ee8,1,14,10,24,7,2011-03-04 22:29:16,2011-03-04 22:29:16
8940969a7a1506c098b212dcb3b4f8391d8d5ee8...4772adf88e260c285ffbe6a7977ba98b4138edb1,1,4,0,4,1,2011-03-05 10:38:10,2011-03-05 10:38:10
4772adf88e260c285ffbe6a7977ba98b4138edb1...535dc08fcf639a6c9d78961ff981ba38dcdda96d,1,1,0,1,1,2011-03-05 18:20:59,2011-03-05 18:20:59
535dc08fcf639a6c9d78961ff981ba38dcdda96d...299874cbe1f3267aae61c91874d2512d6cf6e2d3,1,0,10,10,2,2011-03-06 05:55:12,2011-03-06 05:55:12
299874cbe1f3267aae61c91874d2512d6cf6e2d3...75cd087c7963ab1ac47b51ccd81911438abbbba5,1,17,0,17,1,2011-03-06 07:14:32,2011-03-06 07:14:32
75cd087c7963ab1ac47b51ccd81911438abbbba5...6bf1c343ca3ecd8bdf890267bf7f5deeb282b5e4,1,5,2,7,3,2011-03-07 00:09:11,2011-03-07 00:09:11
6bf1c343ca3ecd8bdf890267bf7f5deeb282b5e4...7f363eb6dceaed4bebad0df3cb8200a9b685f711,1,36,10,46,3,2011-03-07 00:31:48,2011-03-07 00:31:48
7f363eb6dceaed4bebad0df3cb8200a9b685f711...0d88312855949ac5fdc73daa878df415c6ff8156,1,3,5,8,1,2011-03-07 16:38:04,2011-03-07 16:38:04
0d88312855949ac5fdc73daa878df415c6ff8156...4c41159494e8700ea6a4c846fbd6b636117f7937,1,1,1,2,1,2011-03-07 17:00:57,2011-03-07 17:00:57
4c41159494e8700ea6a4c846fbd6b636117f7937...c47b69ba53e641938438898462d09b520f179578,1,2,1,3,1,2011-03-07 22:54:55,2011-03-07 22:54:55
c47b69ba53e641938438898462d09b520f179578...32adde7fc9b2400eec5c7eec21bb411738321831,1,3,3,6,3,2011-03-07 22:55:16,2011-03-07 22:55:16
32adde7fc9b2400eec5c7eec21bb411738321831...c260c533e1f1553548fc98f24820805af87f72bf,3,47,14,61,8,2011-03-08 13:43:53,2011-03-08 13:43:53
c260c533e1f1553548fc98f24820805af87f72bf...8b22f7cf78c0b66831e91e1d73d4be6e4a201f30,3,5,6,11,6,2011-03-08 19:26:32,2011-03-08 19:26:32
8b22f7cf78c0b66831e91e1d73d4be6e4a201f30...409435440a8f8d453fa88aae9afb7799972b4422,2,46,19,65,16,2011-03-08 19:51:19,2011-03-08 19:51:19
409435440a8f8d453fa88aae9afb7799972b4422...d9e61a435a90a163c1d887224bee68a386f7a171,3,9,1,10,5,2011-03-08 22:41:25,2011-03-08 22:41:25
d9e61a435a90a163c1d887224bee68a386f7a171...9e637d3061bfd620be3e2bb6a79e2d8d08154f91,3,105,90,195,73,2011-03-09 00:39:35,2011-03-09 00:39:35
9e637d3061bfd620be3e2bb6a79e2d8d08154f91...6ffe1d1e1f881f7c952b7a022841d1c591f5771d,1,3,9,12,5,2011-03-09 04:09:47,2011-03-09 04:09:47
6ffe1d1e1f881f7c952b7a022841d1c591f5771d...f05aab1a437b7f133c8152eef5987fc8cfe5403b,1,2,2,4,2,2011-03-09 12:34:17,2011-03-09 12:34:17
f05aab1a437b7f133c8152eef5987fc8cfe5403b...0cf527f77cb546d2b0e8594110acf0ce433a2d4d,1,14,14,28,6,2011-03-09 19:20:35,2011-03-09 19:20:35
0cf527f77cb546d2b0e8594110acf0ce433a2d4d...5a79b55239d9c5a230aca376ced18291b852d7b3,1,1,0,1,1,2011-03-09 19:40:44,2011-03-09 19:40:44
5a79b55239d9c5a230aca376ced18291b852d7b3...23103bddb98d493ed452d25a88c5563b7f8dad18,1,1,1,2,1,2011-03-09 22:45:20,2011-03-09 22:45:20
23103bddb98d493ed452d25a88c5563b7f8dad18...f17fc56602f8de37ef8c5565ddf04991e8c91442,12,149,135,284,94,2011-03-09 23:46:28,2011-03-09 23:46:28
f17fc56602f8de37ef8c5565ddf04991e8c91442...0a3aae8362568ab470a7288829bd8e9678e67ee2,3,2,24,26,6,2011-03-10 01:15:19,2011-03-10 01:15:19
0a3aae8362568ab470a7288829bd8e9678e67ee2...3349b95db67440cd2bcd199578232e93d0e1b88c,1,1,1,2,1,2011-03-10 17:21:16,2011-03-10 17:21:16
3349b95db67440cd2bcd199578232e93d0e1b88c...e9d27639470d2e76ce51a2522aedc69ff912de3e,3,13,1,14,3,2011-03-10 18:42:24,2011-03-10 18:42:24
e9d27639470d2e76ce51a2522aedc69ff912de3e...e2627d267d8b98c7466d2c149b58cc406a3a6599,1,1,5,6,3,2011-03-10 18:42:33,2011-03-10 18:42:33
e2627d267d8b98c7466d2c149b58cc406a3a6599...3a5b87cf6d9965b90ab744ee328e816ecc9855b7,1,3,1,4,2,2011-03-14 04:42:04,2011-03-14 04:42:04
3a5b87cf6d9965b90ab744ee328e816ecc9855b7...72c5733869c38897f31e82cbae3c6a24f7292d11,5,31,0,31,5,2011-03-14 05:22:39,2011-03-14 05:22:39
72c5733869c38897f31e82cbae3c6a24f7292d11...12a2a231005dd965732a8321add66bf1f2387944,1,23,20,43,16,2011-03-14 05:34:28,2011-03-14 05:34:28
12a2a231005dd965732a8321add66bf1f2387944...e494f88be0f1bc2aa7742299b385ca95012a7b3c,1,1,1,2,1,2011-03-14 05:45:55,2011-03-14 05:45:55
e494f88be0f1bc2aa7742299b385ca95012a7b3c...12b5152233b145dbcb9061da781107d1a696b54e,1,21,21,42,11,2011-03-14 13:53:45,2011-03-14 13:53:45
12b5152233b145dbcb9061da781107d1a696b54e...f1f10a9ce2d8cd8df0dbd4b922fd2dba335a3770,1,9,8,17,1,2011-03-14 14:58:54,2011-03-14 14:58:54
f1f10a9ce2d8cd8df0dbd4b922fd2dba335a3770...fd2f18008caeca28c60c43cce7b43fb87c6fee78,3,10,13,23,5,2011-03-14 19:49:53,2011-03-14 19:49:53
fd2f18008caeca28c60c43cce7b43fb87c6fee78...7d71a9e45fa85bff15501057b69440b4dfae688d,2,26,5,31,6,2011-03-14 21:14:10,2011-03-14 21:14:10
7d71a9e45fa85bff15501057b69440b4dfae688d...ab7ada16ed6fecae5c64216062ae79b65be44941,3,13,14,27,10,2011-03-14 21:15:34,2011-03-14 21:15:34
ab7ada16ed6fecae5c64216062ae79b65be44941...f43b3f58fb60a281c9db34c95f4a2a6384f40693,1,7,0,7,1,2011-03-14 22:49:14,2011-03-14 22:49:14
f43b3f58fb60a281c9db34c95f4a2a6384f40693...4e25bc71b18e609768c4cf99854f350a5bc8e44d,6,7,7,14,7,2011-03-14 23:00:03,2011-03-14 23:00:03
4e25bc71b18e609768c4cf99854f350a5bc8e44d...dd3313bf6d4e1928829e6e5c53579fbfdf8ed43f,1,1,1,2,1,2011-03-14 23:06:06,2011-03-14 23:06:06
dd3313bf6d4e1928829e6e5c53579fbfdf8ed43f...1fdbcadd223641f63d0548c39860d255cef325ed,6,19,3,22,6,2011-03-15 02:26:37,2011-03-15 02:26:37
1fdbcadd223641f63d0548c39860d255cef325ed...6d991d10d65046f7688d5a7301ef3f9894781054,1,1,1,2,1,2011-03-15 08:19:17,2011-03-15 08:19:17
6d991d10d65046f7688d5a7301ef3f9894781054...350a56ad4949762ba02f68cf1ba8bac2968507c0,3,81,32,113,7,2011-03-15 08:19:39,2011-03-15 08:19:39
350a56ad4949762ba02f68cf1ba8bac2968507c0...23288d1955b3188227c05c831e9e0ecae4fd161e,1,1,1,2,1,2011-03-15 08:19:57,2011-03-15 08:19:57
23288d1955b3188227c05c831e9e0ecae4fd161e...c966566171a0480ea64774f7468c6d218b1088d5,2,56,0,56,2,2011-03-15 08:20:14,2011-03-15 08:20:14
c966566171a0480ea64774f7468c6d218b1088d5...87a100b642316a5eb0db6299350208b6ed8f9248,2,2,2,4,2,2011-03-15 08:24:31,2011-03-15 08:24:31
87a100b642316a5eb0db6299350208b6ed8f9248...6eb1c58430f7c0a5fe5015c61145f0040069340b,1,1,0,1,1,2011-03-15 09:30:01,2011-03-15 09:30:01
6eb1c58430f7c0a5fe5015c61145f0040069340b...b1f67e73174e09476bbbd8ddff547c324940313c,1,21,11,32,5,2011-03-15 17:07:16,2011-03-15 17:07:16
b1f67e73174e09476bbbd8ddff547c324940313c...0b468d79b0edede17b9a7ba503a8c6a24b707efe,132,7739,7319,15058,7300,2011-03-15 20:05:03,2011-03-15 20:05:03
0b468d79b0edede17b9a7ba503a8c6a24b707efe...24350e45a3f45cc7366cff7044066e262708b1c7,264,3489,2874,6363,2784,2011-03-15 20:05:50,2011-03-15 20:05:50
24350e45a3f45cc7366cff7044066e262708b1c7...ddbbb600774c53e2fca35ce49132eac02ce04987,132,219,206,425,124,2011-03-15 20:06:26,2011-03-15 20:06:26
ddbbb600774c53e2fca35ce49132eac02ce04987...ffe88a7a6c9937cc9facb165be807618ebcc06a2,132,394,343,737,274,2011-03-15 20:06:58,2011-03-15 20:06:58
ffe88a7a6c9937cc9facb165be807618ebcc06a2...1bbe626033002ef6aef4aa30aa9ffafcab3ecea4,132,722,676,1398,522,2011-03-15 20:07:32,2011-03-15 20:07:32
1bbe626033002ef6aef4aa30aa9ffafcab3ecea4...e950cbf386b2520e2fa129fc248ae422951fdf06,132,155,155,310,83,2011-03-15 20:08:06,2011-03-15 20:08:06
e950cbf386b2520e2fa129fc248ae422951fdf06...f7c8ce1d3985ccd149a599dccd39de989ac354d7,132,210,180,390,106,2011-03-15 20:08:36,2011-03-15 20:08:36
f7c8ce1d3985ccd149a599dccd39de989ac354d7...25f975a729d0a1501beb9f1c283b367238e53d76,132,162,154,316,80,2011-03-15 20:09:10,2011-03-15 20:09:10
25f975a729d0a1501beb9f1c283b367238e53d76...71e6f9b84d5b387c6ee6398fb0f520e78da696e1,132,274,263,537,183,2011-03-15 20:09:41,2011-03-15 20:09:41
71e6f9b84d5b387c6ee6398fb0f520e78da696e1...f193c17979590b2330e325ba2676df0d20f5123d,132,208,217,425,119,2011-03-15 20:10:24,2011-03-15 20:10:24
f193c17979590b2330e325ba2676df0d20f5123d...e5ccf0b9baec197b2f7da1b16d23c90573751466,132,2780,2690,5470,2642,2011-03-15 20:11:04,2011-03-15 20:11:04
e5ccf0b9baec197b2f7da1b16d23c90573751466...364cf89e0641552cfa26877dd6f78d6942b47dc4,132,162,162,324,80,2011-03-15 20:11:36,2011-03-15 20:11:36
364cf89e0641552cfa26877dd6f78d6942b47dc4...4380fc2832f87d263b9c7ce2acf80062851b02b5,132,163,160,323,90,2011-03-15 20:12:07,2011-03-15 20:12:07
4380fc2832f87d263b9c7ce2acf80062851b02b5...d31cf12be1b11686995c993f84b8d7969d424366,132,151,151,302,81,2011-03-15 20:12:38,2011-03-15 20:12:38
d31cf12be1b11686995c993f84b8d7969d424366...1df1f2aa1c58b57c48c69048d6d01e894a721a1e,132,154,154,308,82,2011-03-15 20:13:13,2011-03-15 20:13:13
1df1f2aa1c58b57c48c69048d6d01e894a721a1e...5050e3050723573621d38d334527794e3cd3d2b2,1,18,0,18,3,2011-03-15 20:13:18,2011-03-15 20:13:18
5050e3050723573621d38d334527794e3cd3d2b2...ad4118be443266685cfc7ab2d59794e0692bc944,2,8,3,11,3,2011-03-15 20:13:21,2011-03-15 20:13:21
ad4118be443266685cfc7ab2d59794e0692bc944...243d0bec1954ad7fab44625f1440a8ce580df26c,5,58,3,61,8,2011-03-15 20:37:09,2011-03-15 20:37:09
243d0bec1954ad7fab44625f1440a8ce580df26c...b46cbc49c297a9254d2ebdf95107335ff43cded9,4,37,0,37,3,2011-03-15 22:13:24,2011-03-15 22:13:24
b46cbc49c297a9254d2ebdf95107335ff43cded9...d83cf4066ccd99ce7c3661fe2886e4c9e97adb4b,1,1,1,2,1,2011-03-15 22:13:29,2011-03-15 22:13:29
d83cf4066ccd99ce7c3661fe2886e4c9e97adb4b...10e1f5d1d29cb9561bdf6cdd90863048e2ed7973,1,1,1,2,1,2011-03-15 22:13:36,2011-03-15 22:13:36
10e1f5d1d29cb9561bdf6cdd90863048e2ed7973...ebd5682989f5929bdfc645bcbd36f57d182be233,2,9,1,10,3,2011-03-16 02:58:35,2011-03-16 02:58:35
ebd5682989f5929bdfc645bcbd36f57d182be233...f71384a52b606708b3bea5e9fbe75f1de8108701,2,13,1,14,2,2011-03-16 03:38:34,2011-03-16 03:38:34
f71384a52b606708b3bea5e9fbe75f1de8108701...ccc972e750b9a3d6cfda1e20b2fbe066bf337427,2,24,13,37,13,2011-03-16 03:50:51,2011-03-16 03:50:51
ccc972e750b9a3d6cfda1e20b2fbe066bf337427...2ee7cfcf1c671681e46b685f268797d175ecff20,1,4,4,8,4,2011-03-16 04:02:40,2011-03-16 04:02:40
2ee7cfcf1c671681e46b685f268797d175ecff20...304a50d8cac1d185685d212867a2d449c5378e9e,2,33,4,37,5,2011-03-16 04:13:57,2011-03-16 04:13:57
304a50d8cac1d185685d212867a2d449c5378e9e...ad55bb0f875d00c1bae8e6b144aaba0cc223395e,1,1,2,3,2,2011-03-16 04:26:38,2011-03-16 04:26:38
ad55bb0f875d00c1bae8e6b144aaba0cc223395e...4da019ea19a2d36190fb0ffc887a11652296dad4,2,3,3,6,2,2011-03-16 04:44:26,2011-03-16 04:44:26
4da019ea19a2d36190fb0ffc887a11652296dad4...127331041e9e002867e53980aef11c5909505147,1,10,15,25,4,2011-03-16 16:21:16,2011-03-16 16:21:16
127331041e9e002867e53980aef11c5909505147...d60a8777c1e04b4851115f5aa1c45cf52866cf23,2,20,0,20,4,2011-03-16 18:22:52,2011-03-16 18:22:52
d60a8777c1e04b4851115f5aa1c45cf52866cf23...274849c87324d36272609dc78a4ef4c4a3eb93c6,1,2,0,2,2,2011-03-16 19:02:56,2011-03-16 19:02:56
274849c87324d36272609dc78a4ef4c4a3eb93c6...c2ae6b2af7dcedaf4f6639da184912b6e4b3c1f1,2,11,34,45,7,2011-03-17 00:44:12,2011-03-17 00:44:12
c2ae6b2af7dcedaf4f6639da184912b6e4b3c1f1...1af33427cb4d6e4ec12c61b68d9da738754b429d,3,35,9,44,10,2011-03-17 00:59:30,2011-03-17 00:59:30
1af33427cb4d6e4ec12c61b68d9da738754b429d...b49ee91eb39e6008fed9d77c19b84362d3dd2b16,2,7,0,7,7,2011-03-17 08:07:40,2011-03-17 08:07:40
b49ee91eb39e6008fed9d77c19b84362d3dd2b16...354aa941b6f883a652ee005014579b26fd7542e6,1,1,0,1,1,2011-03-17 08:41:25,2011-03-17 08:41:25
354aa941b6f883a652ee005014579b26fd7542e6...7ab5ce6cf1f2ea01857f828836d1bc6a21c1109f,1,5,1,6,1,2011-03-17 10:33:08,2011-03-17 10:33:08
7ab5ce6cf1f2ea01857f828836d1bc6a21c1109f...a0878b5f95b5fc5bac02d818e864cab507b73564,1,2,1,3,2,2011-03-17 11:51:07,2011-03-17 11:51:07
a0878b5f95b5fc5bac02d818e864cab507b73564...6091f0ead37b4339a781c731abee85ae00ab0e99,1,2,0,2,1,2011-03-17 16:57:37,2011-03-17 16:57:37
6091f0ead37b4339a781c731abee85ae00ab0e99...c70bdad8b476b457e217c3c444579a8b4b853cc8,2,118,54,172,21,2011-03-17 20:06:19,2011-03-17 20:06:19
c70bdad8b476b457e217c3c444579a8b4b853cc8...413ceb57b268b94f9138faa17690bea927814b9a,3,9,9,18,9,2011-03-17 20:49:31,2011-03-17 20:49:31
413ceb57b268b94f9138faa17690bea927814b9a...5347bbd5146272bb8e8a0a7b849e323c3783e9c0,31,47,47,94,31,2011-03-17 22:56:10,2011-03-17 22:56:10
5347bbd5146272bb8e8a0a7b849e323c3783e9c0...fa852966c6c6a0e42eddbb6eb604c1c7754c7903,1,2,1,3,2,2011-03-18 01:17:48,2011-03-18 01:17:48
fa852966c6c6a0e42eddbb6eb604c1c7754c7903...16ad1d951afca1d5cee6e736fbabf67ea7cd9e97,1,2,4,6,2,2011-03-18 18:46:48,2011-03-18 18:46:48
16ad1d951afca1d5cee6e736fbabf67ea7cd9e97...0ff6bbf1db472933742d88179d3985a01e2546eb,2,7,0,7,2,2011-03-18 18:47:08,2011-03-18 18:47:08
0ff6bbf1db472933742d88179d3985a01e2546eb...bd0daa04f5c886c8eeebac0c48ef6a326cbf689e,1,4,3,7,3,2011-03-18 18:47:14,2011-03-18 18:47:14
bd0daa04f5c886c8eeebac0c48ef6a326cbf689e...1a6d98dab97df7e4bfc6fd9c82183eb9a1349078,2,28,4,32,6,2011-03-19 02:42:40,2011-03-19 02:42:40
1a6d98dab97df7e4bfc6fd9c82183eb9a1349078...775a6e694fedc6b057dc560da8e4a07dc7e9457c,3,70,4,74,5,2011-03-19 12:56:38,2011-03-19 12:56:38
775a6e694fedc6b057dc560da8e4a07dc7e9457c...f5b22ed9977d19bc35ed02bcb965c0e0f48ef127,1,13,0,13,3,2011-03-19 22:09:38,2011-03-19 22:09:38
f5b22ed9977d19bc35ed02bcb965c0e0f48ef127...7c738cd3e8f49a2e9ae951b6064aee5fc6fa3325,2,37,1,38,4,2011-03-20 11:27:03,2011-03-20 11:27:03
7c738cd3e8f49a2e9ae951b6064aee5fc6fa3325...ada8e2a6faf2c0567b024f4d55ad92a0820d9d1a,230,3017,2915,5932,2089,2011-03-20 22:16:14,2011-03-20 22:16:14
ada8e2a6faf2c0567b024f4d55ad92a0820d9d1a...2cb2674048c0619e9bdec7ec76083b053691cee6,12,216,191,407,199,2011-03-20 22:16:35,2011-03-20 22:16:35
2cb2674048c0619e9bdec7ec76083b053691cee6...a2c19f7984dd33519b923bbf5a7973b77769d42f,1,2,2,4,2,2011-03-21 15:39:26,2011-03-21 15:39:26
a2c19f7984dd33519b923bbf5a7973b77769d42f...6d8853b7c844bf9f4c7c631b17e07daedffbceae,1,17,0,17,1,2011-03-22 01:16:28,2011-03-22 01:16:28
6d8853b7c844bf9f4c7c631b17e07daedffbceae...09d163ec47723a2441e020baf7ac99561ae5b344,1,1,1,2,2,2011-03-22 01:38:53,2011-03-22 01:38:53
09d163ec47723a2441e020baf7ac99561ae5b344...a5d373a4633bb9539263b47e13c80fc9b46e3dd8,2,179,188,367,46,2011-03-22 06:57:12,2011-03-22 06:57:12
a5d373a4633bb9539263b47e13c80fc9b46e3dd8...16f4a2bec2796ed61154ad8350c02dbce9204799,3,20,12,32,11,2011-03-22 14:35:14,2011-03-22 14:35:14
16f4a2bec2796ed61154ad8350c02dbce9204799...a4ef094b0f014c5f0aef9fd9ef33e695e583337a,4,57,33,90,24,2011-03-22 20:12:17,2011-03-22 20:12:17
a4ef094b0f014c5f0aef9fd9ef33e695e583337a...66594beae7785bb811436b4f9a1277197a74c7c2,1,2,2,4,2,2011-03-22 22:01:27,2011-03-22 22:01:27
66594beae7785bb811436b4f9a1277197a74c7c2...8e7030d2639ee9b0d832fe56dbcdac59e89b679a,1,1,1,2,1,2011-03-22 23:16:22,2011-03-22 23:16:22
8e7030d2639ee9b0d832fe56dbcdac59e89b679a...62865b4cded10f513cf288042dde232d20c4f774,1,4,0,4,1,2011-03-22 23:18:09,2011-03-22 23:18:09
62865b4cded10f513cf288042dde232d20c4f774...2f3bf2830d9ede437b3db29bf740e51e9a0d9492,1,1,1,2,1,2011-03-22 23:20:52,2011-03-22 23:20:52
2f3bf2830d9ede437b3db29bf740e51e9a0d9492...5c00199581577ae1beeed1feaa937485b7d5bf24,1,18,4,22,3,2011-03-23 05:03:22,2011-03-23 05:03:22
5c00199581577ae1beeed1feaa937485b7d5bf24...1743db94f54a4785a864af95c2f307ce2be38a6e,1,1,1,2,1,2011-03-23 05:04:19,2011-03-23 05:04:19
1743db94f54a4785a864af95c2f307ce2be38a6e...7c08f4c6351f7e53a01ff800d8a61f19ca961b29,3,4,4,8,4,2011-03-23 05:06:31,2011-03-23 05:06:31
90ce8b0c99516799ce813349e1f148d040cba948...b1b172114aac7e1a169b111bb44895ad144848ff,0,0,0,0,0,2010-06-19 21:12:12,2010-06-19 21:12:12
b1b172114aac7e1a169b111bb44895ad144848ff...8f5236fa359d91acbd67993b76b83ce0cff158f2,1,1,8,9,1,2010-06-21 12:01:37,2010-06-21 12:01:37
8f5236fa359d91acbd67993b76b83ce0cff158f2...71cecc49525263494a19e37788124e3275323745,2,11,1,12,2,2010-06-23 13:20:38,2010-06-23 13:20:38
71cecc49525263494a19e37788124e3275323745...1b5f812aad107e2ce12fe7c81773113fe39a46c1,1,2,2,4,2,2010-06-23 17:19:56,2010-06-23 17:19:56
1b5f812aad107e2ce12fe7c81773113fe39a46c1...90380b8fcf54842e29f772932bab2a9f6fbb26fd,2,8,11,19,5,2010-06-23 17:38:47,2010-06-23 17:38:47
90380b8fcf54842e29f772932bab2a9f6fbb26fd...867d6907525e0d36eca609fb50faa62a522abac2,1,0,2,2,1,2010-06-24 11:21:10,2010-06-24 11:21:10
867d6907525e0d36eca609fb50faa62a522abac2...558732c37bf5faaffdd00ab278f77dc6c658ecde,1,3,7,10,3,2010-07-05 16:43:51,2010-07-05 16:43:51
558732c37bf5faaffdd00ab278f77dc6c658ecde...b9f085a9de946a442e594e997b1eafaf4dc6a211,1,2,0,2,1,2010-07-05 16:54:37,2010-07-05 16:54:37
b9f085a9de946a442e594e997b1eafaf4dc6a211...a84a390c7afc8a09c081b8eff6f11a2452896420,2,2,2,4,2,2010-07-05 17:10:58,2010-07-05 17:10:58
a84a390c7afc8a09c081b8eff6f11a2452896420...1fed50033773e76eaa4bcf3c064a9e08899d405d,2,3,3,6,3,2010-07-05 17:22:29,2010-07-05 17:22:29
1fed50033773e76eaa4bcf3c064a9e08899d405d...ab693cea8096149302b3f4ecf8eede6a358a9621,0,0,0,0,0,2010-07-17 09:31:09,2010-07-17 09:31:09
ab693cea8096149302b3f4ecf8eede6a358a9621...48dd139e5494dd6763131fddde0286d3fd4c8d5a,1,1,1,2,1,2010-07-17 09:33:27,2010-07-17 09:33:27
48dd139e5494dd6763131fddde0286d3fd4c8d5a...5dc560636b6e2ee1ff01f4a9c45f485d9d736b29,3,17,2,19,5,2010-07-20 19:14:23,2010-07-20 19:14:23
5dc560636b6e2ee1ff01f4a9c45f485d9d736b29...8c87622f8b80685098b6f7cc8b823ae2118ab439,1,1,1,2,1,2010-07-21 15:28:06,2010-07-21 15:28:06
8c87622f8b80685098b6f7cc8b823ae2118ab439...acbf74a72131bd3af4d7341a81635ee700b85b0e,18,232,58,290,36,2010-07-24 10:19:39,2010-07-24 10:19:39
acbf74a72131bd3af4d7341a81635ee700b85b0e...953f4be2014f0820a887d99a0d991618a6102c63,3,48,111,159,32,2010-07-25 20:58:58,2010-07-25 20:58:58
953f4be2014f0820a887d99a0d991618a6102c63...3227cc59511454d311e4dd8f9f5293b0f06664e9,1,1,1,2,1,2010-07-30 02:58:51,2010-07-30 02:58:51
3227cc59511454d311e4dd8f9f5293b0f06664e9...c61811a8f2679fe0dd9943f228e62756e38fb1dc,1,3,2,5,2,2010-07-30 02:59:14,2010-07-30 02:59:14
c61811a8f2679fe0dd9943f228e62756e38fb1dc...dc449e9664ff89b2acab9934a5589e04061dc4ec,1,1,4,5,1,2010-07-30 04:07:27,2010-07-30 04:07:27
dc449e9664ff89b2acab9934a5589e04061dc4ec...38813c4bbd08f246462222bcd63ec2da55826b23,1,54,56,110,25,2010-07-30 04:16:20,2010-07-30 04:16:20
38813c4bbd08f246462222bcd63ec2da55826b23...c0040b41514d37ef7d31cda9bee8718a64828390,1,11,0,11,1,2010-08-03 15:37:00,2010-08-03 15:37:00
c0040b41514d37ef7d31cda9bee8718a64828390...4441f7b0f3b4f9a0b67d6c67eeb1c9bacbac7b77,1,20,2,22,3,2010-08-03 15:37:07,2010-08-03 15:37:07
4441f7b0f3b4f9a0b67d6c67eeb1c9bacbac7b77...972a9c7e18d39f64c3783c361783406c67f1a0f9,2,9,4,13,6,2010-08-03 15:43:29,2010-08-03 15:43:29
972a9c7e18d39f64c3783c361783406c67f1a0f9...389c72c358a93597cfafc00c3182fe9fce5231cf,1,8,2,10,2,2010-08-04 14:36:44,2010-08-04 14:36:44
389c72c358a93597cfafc00c3182fe9fce5231cf...1c237cb77c9912972dc877a39f432e01a4115648,2,5,3,8,3,2010-08-04 19:08:58,2010-08-04 19:08:58
1c237cb77c9912972dc877a39f432e01a4115648...9383a37485f4c6a8b132447c7c0b66d598b0651a,1,6,6,12,1,2010-08-05 01:30:54,2010-08-05 01:30:54
9383a37485f4c6a8b132447c7c0b66d598b0651a...6c2e31e9b7004d5722b5e9b2c60a5fed7c017689,3,116,34,150,22,2010-08-05 02:14:31,2010-08-05 02:14:31
6c2e31e9b7004d5722b5e9b2c60a5fed7c017689...d302a60c8db81087c8c425cb6583c88055ad921b,3,55,2,57,6,2010-08-05 04:00:56,2010-08-05 04:00:56
d302a60c8db81087c8c425cb6583c88055ad921b...91d64a5a09f112ea4155bdb1d254124666025477,1,1,1,2,1,2010-08-05 11:29:18,2010-08-05 11:29:18
91d64a5a09f112ea4155bdb1d254124666025477...aa59bc74044b1e04b2cdfe6e27657f4d95db82c1,1,1,1,2,1,2010-08-05 12:52:59,2010-08-05 12:52:59
aa59bc74044b1e04b2cdfe6e27657f4d95db82c1...908b91b69ebdc5947bdb8944b143835e1d7d2126,3,913,9,922,9,2010-08-05 12:53:27,2010-08-05 12:53:27
908b91b69ebdc5947bdb8944b143835e1d7d2126...e10e3007d19ac1feba4d8c124f60446ecb1ace2c,1,1,1,2,1,2010-08-05 13:01:10,2010-08-05 13:01:10
e10e3007d19ac1feba4d8c124f60446ecb1ace2c...9ff58e30c1aa0ba1888888fcc1c4fd8b7e4254ad,3,8,5,13,4,2010-08-05 13:19:54,2010-08-05 13:19:54
9ff58e30c1aa0ba1888888fcc1c4fd8b7e4254ad...6d76cae2bc7640ded4e9431af269eec6d97d84a5,7,5239,0,5239,4,2010-08-06 02:13:20,2010-08-06 02:13:20
6d76cae2bc7640ded4e9431af269eec6d97d84a5...5bd352a96669a921541188685f5184d81a712dfe,1,1,1,2,1,2010-08-06 02:13:41,2010-08-06 02:13:41
5bd352a96669a921541188685f5184d81a712dfe...8419b092aeb9c28c3fe117c04c5d7d537aadaef2,2,6,1,7,2,2010-08-06 14:39:24,2010-08-06 14:39:24
8419b092aeb9c28c3fe117c04c5d7d537aadaef2...7930d8c477d2370d5657d61a35323c420a5d4ab8,3,20,4,24,8,2010-08-06 14:59:13,2010-08-06 14:59:13
7930d8c477d2370d5657d61a35323c420a5d4ab8...c543f079ffd2b3dd76729188981f0dabb1c3d66a,2,15,1,16,4,2010-08-06 16:09:28,2010-08-06 16:09:28
c543f079ffd2b3dd76729188981f0dabb1c3d66a...e2fbe478bda2e1294035e433cd952c83d0b62866,5,101,92,193,9,2010-08-06 16:19:23,2010-08-06 16:19:23
e2fbe478bda2e1294035e433cd952c83d0b62866...5d1dcfbfa5632c7ffcd05bf36260ff8755e44d00,1,0,0,0,0,2010-08-06 16:25:19,2010-08-06 16:25:19
5d1dcfbfa5632c7ffcd05bf36260ff8755e44d00...fac923a3015a890eb5ffbbeef55b12e77eba9113,4,101,89,190,86,2010-08-06 16:56:05,2010-08-06 16:56:05
fac923a3015a890eb5ffbbeef55b12e77eba9113...fc3c72a47bf186199b62b93eeef659afada385f4,2,81,73,154,72,2010-08-06 16:56:24,2010-08-06 16:56:24
fc3c72a47bf186199b62b93eeef659afada385f4...3ccc25b10c1992238f756e27c5f984e6a02f4a86,2,29,1,30,5,2010-08-06 17:16:19,2010-08-06 17:16:19
3ccc25b10c1992238f756e27c5f984e6a02f4a86...0ffbd440971c1aba8d0b8571ce468bb8b33d922a,4,95,115,210,82,2010-08-07 02:16:28,2010-08-07 02:16:28
0ffbd440971c1aba8d0b8571ce468bb8b33d922a...486b0dfb21ecc03558f457e680516a1a948682d3,8,506,606,1112,316,2010-08-07 02:19:29,2010-08-07 02:19:29
486b0dfb21ecc03558f457e680516a1a948682d3...849c6079b46576670917ab65ce4f19ec786ae09d,1,1,1,2,1,2010-08-07 02:46:50,2010-08-07 02:46:50
849c6079b46576670917ab65ce4f19ec786ae09d...b1c621bea479aaa5a143d6b864fac7afdb5f71d4,1,72,72,144,14,2010-08-07 02:47:10,2010-08-07 02:47:10
b1c621bea479aaa5a143d6b864fac7afdb5f71d4...490bd7f9bc323362dc98c01a88f9e8549dec7d42,1,1,1,2,1,2010-08-07 02:47:31,2010-08-07 02:47:31
490bd7f9bc323362dc98c01a88f9e8549dec7d42...049a246cc4829bce63b2860e4b2e3babf44e7df9,1,2,2,4,2,2010-08-07 02:47:51,2010-08-07 02:47:51
049a246cc4829bce63b2860e4b2e3babf44e7df9...e7b009ce053cee1d65d5cd77200310a0de72789d,1,1,1,2,1,2010-08-07 02:48:11,2010-08-07 02:48:11
e7b009ce053cee1d65d5cd77200310a0de72789d...8b70c75ed6a11b3f0e55996200addab3f116c145,1,1,1,2,1,2010-08-07 02:48:31,2010-08-07 02:48:31
8b70c75ed6a11b3f0e55996200addab3f116c145...e990a2cbc43e5eaa3f245cd1b6a4c6850e31f3e9,1,3,0,3,1,2010-08-07 07:39:19,2010-08-07 07:39:19
e990a2cbc43e5eaa3f245cd1b6a4c6850e31f3e9...3309c394382dd4147f3c8c9acb8afee7f974f19b,1,5,0,5,1,2010-08-07 07:58:38,2010-08-07 07:58:38
3309c394382dd4147f3c8c9acb8afee7f974f19b...e2d7d52c33618280c10020c5143553ac0953a7b3,1,4,2,6,1,2010-08-07 07:58:58,2010-08-07 07:58:58
e2d7d52c33618280c10020c5143553ac0953a7b3...94528b90670b3a72135f5318c1b7224f0fdc365a,2,33,4,37,3,2010-08-07 14:18:47,2010-08-07 14:18:47
94528b90670b3a72135f5318c1b7224f0fdc365a...7c05d23af162ba0481d2abb28022fd43a2e0bd4a,7,33,42,75,24,2010-08-07 14:27:15,2010-08-07 14:27:15
7c05d23af162ba0481d2abb28022fd43a2e0bd4a...0fda7c8a2bf1c21bcd9b971d9843af1f52ca14c8,1,2,2,4,1,2010-08-07 15:00:03,2010-08-07 15:00:03
0fda7c8a2bf1c21bcd9b971d9843af1f52ca14c8...15ca40d555ee75ea3c2e30c142cec3370c5ce88c,1,4,0,4,2,2010-08-07 15:00:29,2010-08-07 15:00:29
15ca40d555ee75ea3c2e30c142cec3370c5ce88c...9e33599bc3e2815f3d15c19a0d42f18731f49a2d,1,17,2,19,2,2010-08-07 15:00:54,2010-08-07 15:00:54
9e33599bc3e2815f3d15c19a0d42f18731f49a2d...d176d112b9b975b1fc2de7ad1484daef62f16b6c,1,1,1,2,2,2010-08-07 15:01:17,2010-08-07 15:01:17
d176d112b9b975b1fc2de7ad1484daef62f16b6c...0ea661cb12649f0b374d598725eea5803b5689cc,1,13,9,22,1,2010-08-07 15:01:38,2010-08-07 15:01:38
0ea661cb12649f0b374d598725eea5803b5689cc...c7c59bc24f6b680277c05e4b631d9e4a69f44473,3,17,3,20,7,2010-08-07 15:02:01,2010-08-07 15:02:01
c7c59bc24f6b680277c05e4b631d9e4a69f44473...ff51df013a31af1e0bdf9f8e65aca98e42ac04a9,1,5,4,9,2,2010-08-07 15:02:21,2010-08-07 15:02:21
ff51df013a31af1e0bdf9f8e65aca98e42ac04a9...653da2dcebbeb39359bb01409fa1faca1b1a598b,1,1,1,2,1,2010-08-12 10:50:22,2010-08-12 10:50:22
653da2dcebbeb39359bb01409fa1faca1b1a598b...8a006e18199607825b1b96d46071e9b049155869,5,122,34,156,17,2010-08-14 12:07:25,2010-08-14 12:07:25
8a006e18199607825b1b96d46071e9b049155869...e4a8b6c3f9991f1c503d201f15d5f9ae6849ed25,1,11,14,25,23,2010-08-14 13:02:03,2010-08-14 13:02:03
e4a8b6c3f9991f1c503d201f15d5f9ae6849ed25...13953badb7dd784c07ec4617e6a28e5143462ed2,3,44,2,46,4,2010-08-14 13:43:13,2010-08-14 13:43:13
13953badb7dd784c07ec4617e6a28e5143462ed2...1e3ed71ca6454691ec74d1415255fe7082822e56,1,0,4,4,1,2010-08-16 06:51:15,2010-08-16 06:51:15
1e3ed71ca6454691ec74d1415255fe7082822e56...14fa7f9907bae2c13c33789fb65d9cae56f6f60b,4,18,5,23,8,2010-08-17 07:08:26,2010-08-17 07:08:26
14fa7f9907bae2c13c33789fb65d9cae56f6f60b...6fd09c600f69db77eafd3873d616838e166490cb,1,1,1,2,1,2010-08-18 02:44:58,2010-08-18 02:44:58
6fd09c600f69db77eafd3873d616838e166490cb...d9bba6b13f39da08353cf8c9f63e22cc325e397f,1,39,30,69,4,2010-08-18 16:32:25,2010-08-18 16:32:25
d9bba6b13f39da08353cf8c9f63e22cc325e397f...558887052947e2c18786c3013620cbca299bae5f,2,4,5,9,3,2010-08-18 16:35:48,2010-08-18 16:35:48
558887052947e2c18786c3013620cbca299bae5f...c9016c15a9a8d16f8ae557c869e23db28fc5b690,1,33,26,59,11,2010-08-19 13:12:52,2010-08-19 13:12:52
c9016c15a9a8d16f8ae557c869e23db28fc5b690...936203434e0db40c94556c50e49c6c531e4628fb,180,1222,1523,2745,1033,2010-08-19 19:31:56,2010-08-19 19:31:56
936203434e0db40c94556c50e49c6c531e4628fb...1d291ff733587b96299ec2874fb2edb90fbfc11d,1,13,11,24,4,2010-08-20 07:15:16,2010-08-20 07:15:16
1d291ff733587b96299ec2874fb2edb90fbfc11d...3fc9d7e3907f0f8506601ff34add9215fdc69b45,3,64,9,73,15,2010-08-20 14:07:02,2010-08-20 14:07:02
3fc9d7e3907f0f8506601ff34add9215fdc69b45...c3b13d8f03a70cb9f72dad274ac8e3026bb9aa6f,5,639,333,972,19,2010-08-20 14:29:57,2010-08-20 14:29:57
c3b13d8f03a70cb9f72dad274ac8e3026bb9aa6f...1c3e3d3dba0a833981ed39da42e0bed015400d40,1,11,14,25,2,2010-08-20 15:06:09,2010-08-20 15:06:09
1c3e3d3dba0a833981ed39da42e0bed015400d40...5c6fe321fe00fa59006ea0c91300bd36a817411a,1,1,1,2,1,2010-08-21 02:56:05,2010-08-21 02:56:05
5c6fe321fe00fa59006ea0c91300bd36a817411a...49c5c075686a4afd831f5d7d8dad6fe019c49091,4,28,8,36,11,2010-08-21 03:02:47,2010-08-21 03:02:47
49c5c075686a4afd831f5d7d8dad6fe019c49091...1a2464c06966e4fb71efab3629960c74cd41ec76,2,71,40,111,2,2010-08-23 07:06:10,2010-08-23 07:06:10
1a2464c06966e4fb71efab3629960c74cd41ec76...e5c4ba6151b3220a918bd47cc3f5a4e5f9ac89d1,1,0,13,13,1,2010-08-23 07:15:14,2010-08-23 07:15:14
e5c4ba6151b3220a918bd47cc3f5a4e5f9ac89d1...0472978da5f164b6fa5ae76f721dc1d8abdefc75,1,18,0,18,1,2010-08-23 07:54:07,2010-08-23 07:54:07
0472978da5f164b6fa5ae76f721dc1d8abdefc75...e47520b8bafe1dd6e65eb439d5d7165b26c99748,11,74,29,103,22,2010-08-23 08:08:46,2010-08-23 08:08:46
e47520b8bafe1dd6e65eb439d5d7165b26c99748...2bbcb1a82132a469b5e5e8727b769e855a0e26b8,1,3,3,6,3,2010-08-23 08:12:17,2010-08-23 08:12:17
2bbcb1a82132a469b5e5e8727b769e855a0e26b8...87cd047123307aa510b4ca3dd854d154f2b10ff8,2,106,98,204,95,2010-08-23 13:39:58,2010-08-23 13:39:58
87cd047123307aa510b4ca3dd854d154f2b10ff8...06a35609a17c99512685e8cd65afb26490a72a2a,1,1,1,2,1,2010-08-23 13:51:49,2010-08-23 13:51:49
06a35609a17c99512685e8cd65afb26490a72a2a...0ed363dd1a4c0a352a60f9c8f7835005c20227c0,1,8,8,16,8,2010-08-24 02:27:22,2010-08-24 02:27:22
0ed363dd1a4c0a352a60f9c8f7835005c20227c0...188c6b3e9a99e7a5b53ebb57de0b8467c1131eee,1,1,1,2,1,2010-08-26 11:10:45,2010-08-26 11:10:45
188c6b3e9a99e7a5b53ebb57de0b8467c1131eee...35411fd7da0bfce6605d810c9844889f90cfb01b,4,51,3,54,7,2010-08-27 13:58:36,2010-08-27 13:58:36
35411fd7da0bfce6605d810c9844889f90cfb01b...2370a1038071bacd713721f5ad7a0811225bb040,10,234,2,236,11,2010-08-27 13:59:46,2010-08-27 13:59:46
2370a1038071bacd713721f5ad7a0811225bb040...38e9ca1e09bcbfdb5bf3c5bb906b7ba13efed3c6,4,61,1,62,4,2010-08-27 15:18:10,2010-08-27 15:18:10
38e9ca1e09bcbfdb5bf3c5bb906b7ba13efed3c6...c868c368eb7d84dfb75f59ba5cf99a601ac077f4,3,46,35,81,6,2010-08-28 02:44:24,2010-08-28 02:44:24
c868c368eb7d84dfb75f59ba5cf99a601ac077f4...37d5ec34b6032f1c64989b7b4b9581541273276a,1,1,1,2,1,2010-08-28 06:13:41,2010-08-28 06:13:41
37d5ec34b6032f1c64989b7b4b9581541273276a...be7f912ce75838aaa94c29967a334e443fa88aa0,1,5,4,9,4,2010-08-28 11:30:28,2010-08-28 11:30:28
be7f912ce75838aaa94c29967a334e443fa88aa0...174940cab2e689bc91388f4c6f3051331f41270d,1,35,35,70,2,2010-08-28 12:31:12,2010-08-28 12:31:12
174940cab2e689bc91388f4c6f3051331f41270d...ba876ea2cc10699f1d9ea8842f3982d8d97a2778,2,3,2,5,2,2010-08-28 13:19:28,2010-08-28 13:19:28
ba876ea2cc10699f1d9ea8842f3982d8d97a2778...af0e3217ae4d2e34de7bb90cd84f4ceff48a327e,1,5,0,5,1,2010-08-28 13:19:49,2010-08-28 13:19:49
af0e3217ae4d2e34de7bb90cd84f4ceff48a327e...6fbd860fa890dff3226ddeac9e62c52af6e792e1,1,4,1,5,1,2010-08-28 13:20:11,2010-08-28 13:20:11
6fbd860fa890dff3226ddeac9e62c52af6e792e1...dde1f13315e92266a1e411926ba4d372723f103a,1,1,1,2,1,2010-08-30 10:27:08,2010-08-30 10:27:08
dde1f13315e92266a1e411926ba4d372723f103a...57e6ee8507ba4311888bc35ebbea0b6f50516e5a,1,1,1,2,1,2010-08-30 10:31:56,2010-08-30 10:31:56
57e6ee8507ba4311888bc35ebbea0b6f50516e5a...2c82a2aaf7e7d22fab5bfa181d153689c3d80c01,1,1,0,1,1,2010-08-30 12:33:45,2010-08-30 12:33:45
2c82a2aaf7e7d22fab5bfa181d153689c3d80c01...62355d8253c299936b7df268f2792b5260c661b9,8,36,46,82,11,2010-08-30 13:25:22,2010-08-30 13:25:22
62355d8253c299936b7df268f2792b5260c661b9...5295d678b940c7f1bc2d1122d4c9aeb2c0bcd968,1,36,0,36,1,2010-08-30 13:25:47,2010-08-30 13:25:47
5295d678b940c7f1bc2d1122d4c9aeb2c0bcd968...4d8af2faa3bde14d2f3a5a30b0772b554c8af245,3,31,8,39,13,2010-08-30 15:11:21,2010-08-30 15:11:21
4d8af2faa3bde14d2f3a5a30b0772b554c8af245...7a1b69418937fa589602ea104a24213d80585b47,2,27,3,30,7,2010-08-31 00:45:35,2010-08-31 00:45:35
7a1b69418937fa589602ea104a24213d80585b47...7a601b3fc121d613dc56cd1db82a128f0fd95fa1,1,2,2,4,2,2010-09-03 18:29:33,2010-09-03 18:29:33
7a601b3fc121d613dc56cd1db82a128f0fd95fa1...94047d7a3a53d4825d8e9ba1b51022005116ac34,2,33,8,41,17,2010-09-03 18:34:30,2010-09-03 18:34:30
94047d7a3a53d4825d8e9ba1b51022005116ac34...4b4168b1bf74ec2abe6c2fb10a80f426d860e952,1,4,0,4,1,2010-09-03 18:58:53,2010-09-03 18:58:53
4b4168b1bf74ec2abe6c2fb10a80f426d860e952...17ae1d3262e777c0d3c62e30090050363de5a679,1,9,0,9,1,2010-09-03 19:04:29,2010-09-03 19:04:29
17ae1d3262e777c0d3c62e30090050363de5a679...01e8d75c203231468d00ec726511b577eaa39b09,1,1,1,2,1,2010-09-07 20:26:23,2010-09-07 20:26:23
01e8d75c203231468d00ec726511b577eaa39b09...a537235d7fff5f6c66e8d0276b8a0181e1adf9d9,1,2,1,3,1,2010-09-07 20:33:58,2010-09-07 20:33:58
a537235d7fff5f6c66e8d0276b8a0181e1adf9d9...79d92067119569e95f2a0aa6827586d83ab88eda,2,10,2,12,4,2010-09-07 20:45:48,2010-09-07 20:45:48
79d92067119569e95f2a0aa6827586d83ab88eda...1b910d7fbcc664ae22bef010af05746027b82138,1,7,1,8,2,2010-09-07 20:54:13,2010-09-07 20:54:13
1b910d7fbcc664ae22bef010af05746027b82138...a04398eb1b958830698fe42bd9f5244662e7d8b3,2,16,1,17,2,2010-09-07 20:59:28,2010-09-07 20:59:28
a04398eb1b958830698fe42bd9f5244662e7d8b3...7f84657b6b2243cc787bdb9f296710c8d13ad0bd,3,11,5,16,8,2010-09-09 00:36:08,2010-09-09 00:36:08
7f84657b6b2243cc787bdb9f296710c8d13ad0bd...329fab430b51bd49035ccffd2d736a7fe67a90ba,2,2,2,4,2,2010-09-09 00:37:33,2010-09-09 00:37:33
329fab430b51bd49035ccffd2d736a7fe67a90ba...5357000bc3fc0e22c6708fc2bd11e3e4e5abecef,2,237,233,470,3,2010-09-09 23:38:01,2010-09-09 23:38:01
5357000bc3fc0e22c6708fc2bd11e3e4e5abecef...6ea90256d767bb79649df83ec2f5b0e265d6871b,2,19,1,20,2,2010-09-09 23:43:01,2010-09-09 23:43:01
6ea90256d767bb79649df83ec2f5b0e265d6871b...6e1c46dab96395b437f77ee0c39deffa47042408,1,1,1,2,1,2010-09-10 13:09:19,2010-09-10 13:09:19
6e1c46dab96395b437f77ee0c39deffa47042408...ec4d6bb21d2b7bffae21e7c55b5444fead9df41d,1,4,4,8,4,2010-09-10 13:17:38,2010-09-10 13:17:38
ec4d6bb21d2b7bffae21e7c55b5444fead9df41d...1b0084e2a046f6cca03ef68f72e34e9b0544ae60,1,13,13,26,13,2010-09-10 17:08:14,2010-09-10 17:08:14
1b0084e2a046f6cca03ef68f72e34e9b0544ae60...13f1192911c7a4a5e761ed1d7a44946336255867,1,10,4,14,8,2010-09-10 18:11:25,2010-09-10 18:11:25
13f1192911c7a4a5e761ed1d7a44946336255867...ec8d04cffe720477908c7668018102768eb43083,2,28,7,35,7,2010-09-10 18:49:45,2010-09-10 18:49:45
ec8d04cffe720477908c7668018102768eb43083...924ae1a09c0e0fd470f9f80debe7466a193bb54d,1,3,3,6,3,2010-09-10 19:19:08,2010-09-10 19:19:08
924ae1a09c0e0fd470f9f80debe7466a193bb54d...de91b33a7888640142d10e9a82db39597e01182d,1,4,1,5,3,2010-09-10 19:22:06,2010-09-10 19:22:06
de91b33a7888640142d10e9a82db39597e01182d...19cce7925337dcabd4108fe2813f9f2d9ac230f2,2,3,3,6,3,2010-09-10 19:46:25,2010-09-10 19:46:25
19cce7925337dcabd4108fe2813f9f2d9ac230f2...ebda0e014a49bd26d08436ba222e2047e6b071c3,2,23,26,49,2,2010-09-10 20:55:09,2010-09-10 20:55:09
ebda0e014a49bd26d08436ba222e2047e6b071c3...aec5cbc370f9146cdb2b78d825f308232da19d6d,1,10,8,18,6,2010-09-10 20:59:36,2010-09-10 20:59:36
aec5cbc370f9146cdb2b78d825f308232da19d6d...43988e98357b6055749dadf5bf2f34dd243abc78,3,118,8,126,10,2010-09-10 22:54:52,2010-09-10 22:54:52
43988e98357b6055749dadf5bf2f34dd243abc78...890b0b6234f3ae742a9cb97f27fe0bb7d900b93b,3,37,14,51,13,2010-09-10 23:11:24,2010-09-10 23:11:24
890b0b6234f3ae742a9cb97f27fe0bb7d900b93b...260eff568423fca4af6456290a8c17a265a04038,1,5,2,7,1,2010-09-10 23:58:52,2010-09-10 23:58:52
260eff568423fca4af6456290a8c17a265a04038...8829b7d9567a63c5c548272e61447bc2bfdddb12,1,3,1,4,3,2010-09-11 02:30:39,2010-09-11 02:30:39
8829b7d9567a63c5c548272e61447bc2bfdddb12...ff0cb11c1b26f962f3ef522c9b6021482dffa1a3,4,45,17,62,12,2010-09-11 03:04:28,2010-09-11 03:04:28
ff0cb11c1b26f962f3ef522c9b6021482dffa1a3...dc00873da09e49afb3a3d31248e61175f4b4fea4,2,4,4,8,4,2010-09-11 03:25:39,2010-09-11 03:25:39
dc00873da09e49afb3a3d31248e61175f4b4fea4...4eb78b89ce198dc27daea4bbe1ab71ba4bd5cb89,2,16,7,23,5,2010-09-11 03:25:44,2010-09-11 03:25:44
4eb78b89ce198dc27daea4bbe1ab71ba4bd5cb89...f140436e3a7295740f3d1a9e4adb9e1ae27278bb,2,2,2,4,2,2010-09-11 06:49:33,2010-09-11 06:49:33
f140436e3a7295740f3d1a9e4adb9e1ae27278bb...f4ebd701f239d4392ba8409125406eca514cbfb5,1,11,8,19,4,2010-09-11 17:55:08,2010-09-11 17:55:08
f4ebd701f239d4392ba8409125406eca514cbfb5...e4bd5e8a2d3442205cd292fe534d109777b55a7a,3,16,4,20,6,2010-09-11 18:38:24,2010-09-11 18:38:24
e4bd5e8a2d3442205cd292fe534d109777b55a7a...864361aabd02d1ba3b9c12813ec1c45f5f68b49c,2,20,0,20,2,2010-09-11 21:28:00,2010-09-11 21:28:00
864361aabd02d1ba3b9c12813ec1c45f5f68b49c...24586d4d866b35f0b236aa4d375dcd6928162840,1,102,109,211,2,2010-09-12 01:44:51,2010-09-12 01:44:51
24586d4d866b35f0b236aa4d375dcd6928162840...31744a78cd8fe8b3c9878e8c2219fa63e0078e83,2,4,2,6,2,2010-09-12 02:09:17,2010-09-12 02:09:17
31744a78cd8fe8b3c9878e8c2219fa63e0078e83...ceedef1447a161cf551542084813ab5bb56e8e01,1,1,2,3,2,2010-09-12 06:39:02,2010-09-12 06:39:02
ceedef1447a161cf551542084813ab5bb56e8e01...6bc74f06e284dd4be40833c4231449e6c5d23ed0,1,2,2,4,1,2010-09-12 18:14:45,2010-09-12 18:14:45
6bc74f06e284dd4be40833c4231449e6c5d23ed0...686d6a414ca1ed30ff529616e0364427ea3678bc,10,167,10,177,32,2010-09-12 19:07:09,2010-09-12 19:07:09
686d6a414ca1ed30ff529616e0364427ea3678bc...3a6afc7e0b93ebc7dbe4060974dfc2d6e2973903,4,19,19,38,5,2010-09-12 19:41:48,2010-09-12 19:41:48
3a6afc7e0b93ebc7dbe4060974dfc2d6e2973903...e41d1b761449a4167474fe83e6a7862b145db84c,2,71,48,119,2,2010-09-12 20:09:23,2010-09-12 20:09:23
e41d1b761449a4167474fe83e6a7862b145db84c...574ee8279219ac12b5e66cd57f4a21d69694bae0,2,42,23,65,3,2010-09-12 20:09:37,2010-09-12 20:09:37
574ee8279219ac12b5e66cd57f4a21d69694bae0...592288fb95f12edb170dec6e6eecbdeacfde7263,3,184,135,319,3,2010-09-12 20:09:49,2010-09-12 20:09:49
592288fb95f12edb170dec6e6eecbdeacfde7263...7fbdeb49f90d596a2bd2374ce71419e20e2c5f8c,2,138,163,301,3,2010-09-12 20:10:03,2010-09-12 20:10:03
7fbdeb49f90d596a2bd2374ce71419e20e2c5f8c...24f4a4b26f1fe2be130b4f1117e5189b9f438e78,2,135,165,300,2,2010-09-12 20:10:17,2010-09-12 20:10:17
24f4a4b26f1fe2be130b4f1117e5189b9f438e78...f7f2c7251a91499e901a241e0bfd120485d025a2,4,34,47,81,10,2010-09-12 20:10:30,2010-09-12 20:10:30
f7f2c7251a91499e901a241e0bfd120485d025a2...106600edb63cdebf5764a25a6fa5cb1ac7117c4c,3,63,63,126,13,2010-09-12 20:10:43,2010-09-12 20:10:43
106600edb63cdebf5764a25a6fa5cb1ac7117c4c...ae26534567ac638e08fb7e69ff3661db3288e02a,2,102,122,224,4,2010-09-12 20:10:54,2010-09-12 20:10:54
ae26534567ac638e08fb7e69ff3661db3288e02a...5b2ec255e6558d0c6d27e1a566b28e7bb4ce6368,2,38,51,89,2,2010-09-12 20:11:06,2010-09-12 20:11:06
5b2ec255e6558d0c6d27e1a566b28e7bb4ce6368...43951647659ce0f908f7c02c6d3f4f32c5b2520a,2,53,49,102,2,2010-09-12 20:11:17,2010-09-12 20:11:17
43951647659ce0f908f7c02c6d3f4f32c5b2520a...f0835cecf8aa623be0ce4c660d1b201fbaee7360,2,80,73,153,2,2010-09-12 20:11:30,2010-09-12 20:11:30
f0835cecf8aa623be0ce4c660d1b201fbaee7360...0023357eb0979fa75aceb131fa6dc03c007b4dbf,2,52,62,114,2,2010-09-12 20:11:41,2010-09-12 20:11:41
0023357eb0979fa75aceb131fa6dc03c007b4dbf...42f7bbda1abf6c79dd28f207040a94be8d45364e,2,75,44,119,2,2010-09-12 20:11:52,2010-09-12 20:11:52
42f7bbda1abf6c79dd28f207040a94be8d45364e...a4a19b81c394ddaa986bee12bad0fc359aa7aaf6,3,43,37,80,7,2010-09-12 20:12:02,2010-09-12 20:12:02
a4a19b81c394ddaa986bee12bad0fc359aa7aaf6...cbcdd408c0310ec72655e86c31481f0b27e5e23a,2,84,49,133,2,2010-09-12 20:12:14,2010-09-12 20:12:14
cbcdd408c0310ec72655e86c31481f0b27e5e23a...411f8dc0d62eb3e3311a504b9262ed3d0c68b482,2,16,15,31,3,2010-09-12 20:12:23,2010-09-12 20:12:23
411f8dc0d62eb3e3311a504b9262ed3d0c68b482...6752258289a8de885688605146e1ecd983e3df56,2,218,105,323,2,2010-09-12 20:12:33,2010-09-12 20:12:33
6752258289a8de885688605146e1ecd983e3df56...0c65a6f7daaffb99e8269c4884b341ee1266a102,1,37,5,42,7,2010-09-12 21:56:25,2010-09-12 21:56:25
0c65a6f7daaffb99e8269c4884b341ee1266a102...fa35d2bd4d0c941fda8d0e54af59700589cd725f,1,2,2,4,2,2010-09-12 22:16:36,2010-09-12 22:16:36
fa35d2bd4d0c941fda8d0e54af59700589cd725f...62585b7570034a8c67ab327c17a987e6c41eddb9,3,22,20,42,3,2010-09-13 05:46:34,2010-09-13 05:46:34
62585b7570034a8c67ab327c17a987e6c41eddb9...f7bdebf2fec57a58e374161cd9522333e806c8db,2,67,57,124,3,2010-09-13 05:46:46,2010-09-13 05:46:46
f7bdebf2fec57a58e374161cd9522333e806c8db...06211b05cb344090a59bafae22a6a216a964d925,2,39,30,69,5,2010-09-13 05:46:59,2010-09-13 05:46:59
06211b05cb344090a59bafae22a6a216a964d925...685ddbbe24303eb33b14e16e6a915e46e7c5cf5d,2,156,135,291,2,2010-09-13 05:47:13,2010-09-13 05:47:13
685ddbbe24303eb33b14e16e6a915e46e7c5cf5d...902c1114429b3b215cc3efc98c9a639a5018da2f,2,24,20,44,2,2010-09-13 05:47:26,2010-09-13 05:47:26
902c1114429b3b215cc3efc98c9a639a5018da2f...21fccbc13e28bf63c7998c79f15fa85537caa2db,2,167,131,298,2,2010-09-13 05:47:39,2010-09-13 05:47:39
21fccbc13e28bf63c7998c79f15fa85537caa2db...11f77de5337ba692985907d41e2186ac34ea87e5,2,49,31,80,2,2010-09-13 05:47:52,2010-09-13 05:47:52
11f77de5337ba692985907d41e2186ac34ea87e5...896ebdcb71aaecde346dfc00594d8960045523ad,2,49,30,79,2,2010-09-13 05:48:06,2010-09-13 05:48:06
896ebdcb71aaecde346dfc00594d8960045523ad...c6754100051d48511721cecaebd636b6f56be203,2,315,229,544,2,2010-09-13 05:48:18,2010-09-13 05:48:18
c6754100051d48511721cecaebd636b6f56be203...0c8e8b15b59592ad0406d2fc416061225753799e,1,2,2,4,2,2010-09-13 19:43:41,2010-09-13 19:43:41
0c8e8b15b59592ad0406d2fc416061225753799e...21f60e9fa92dab7d80fbf47e97c1bd92a4f10382,1,4,4,8,1,2010-09-13 21:45:56,2010-09-13 21:45:56
21f60e9fa92dab7d80fbf47e97c1bd92a4f10382...93e83546a35f268a4bbf0a9b30186fc4ee1b0885,2,15,0,15,2,2010-09-13 22:34:39,2010-09-13 22:34:39
93e83546a35f268a4bbf0a9b30186fc4ee1b0885...b176bd4f1e626827899514c5552c41d4ac1453c6,1,4,0,4,2,2010-09-13 22:49:18,2010-09-13 22:49:18
b176bd4f1e626827899514c5552c41d4ac1453c6...759625cd90f36976b1bc98c1dd9de0e8fe309bee,4,32,5,37,6,2010-09-13 23:02:29,2010-09-13 23:02:29
759625cd90f36976b1bc98c1dd9de0e8fe309bee...238eea44ebcd6bf897bb389154e6f1c18859acc0,3,9,0,9,6,2010-09-13 23:17:11,2010-09-13 23:17:11
238eea44ebcd6bf897bb389154e6f1c18859acc0...2d7a3e71c1e250ff23d412482fab89778c642ebe,1,138,4,142,7,2010-09-13 23:17:27,2010-09-13 23:17:27
2d7a3e71c1e250ff23d412482fab89778c642ebe...efae9a166bc273253990ce34963d4fa715f3077d,7,12,11,23,9,2010-09-14 14:24:15,2010-09-14 14:24:15
efae9a166bc273253990ce34963d4fa715f3077d...d443d1606388f2c60add3b050a5da4a8e56e153b,1,0,1,1,1,2010-09-14 21:42:06,2010-09-14 21:42:06
d443d1606388f2c60add3b050a5da4a8e56e153b...a63bea3e3baf1d354667cfd8d5ddad09516c24ab,1,20,0,20,1,2010-09-16 19:56:39,2010-09-16 19:56:39
a63bea3e3baf1d354667cfd8d5ddad09516c24ab...1fb572a6d628b1fb5c47ddd881ff2b38d5c58799,3,29,2,31,4,2010-09-16 19:58:25,2010-09-16 19:58:25
1fb572a6d628b1fb5c47ddd881ff2b38d5c58799...80b9233e4a45f87b1b6da555026119af5c587d55,4,442,244,686,13,2010-09-19 14:05:43,2010-09-19 14:05:43
80b9233e4a45f87b1b6da555026119af5c587d55...804719ff23a8fc80b871900663b99085021d9b1b,2,15,2,17,4,2010-09-21 19:33:53,2010-09-21 19:33:53
804719ff23a8fc80b871900663b99085021d9b1b...5f4fe3cdfc720c46baf37a2453de77545d64535a,2,47,42,89,2,2010-09-26 09:56:37,2010-09-26 09:56:37
5f4fe3cdfc720c46baf37a2453de77545d64535a...c37add7c473e8893af17a39745525364bf79f3dc,3,9,4,13,6,2010-09-26 15:12:38,2010-09-26 15:12:38
c37add7c473e8893af17a39745525364bf79f3dc...4d966ee2021e0ba982dbb0407128aec21480014e,2,35,1,36,3,2010-09-26 20:46:37,2010-09-26 20:46:37
4d966ee2021e0ba982dbb0407128aec21480014e...7b556c2f1bb6e82f5e2a8cd353be3d8f74ba2a11,1,4,0,4,1,2010-09-26 20:53:45,2010-09-26 20:53:45
7b556c2f1bb6e82f5e2a8cd353be3d8f74ba2a11...ad3b281c97cc86d0f82f0d06399dcffd77a7e9b6,1,2,1,3,2,2010-09-26 20:57:00,2010-09-26 20:57:00
ad3b281c97cc86d0f82f0d06399dcffd77a7e9b6...bb857bf4d4eff0567cefcea17861b3728fc02b55,1,0,1,1,1,2010-09-26 23:00:44,2010-09-26 23:00:44
bb857bf4d4eff0567cefcea17861b3728fc02b55...3640abd9763dcb8002c024a2f1d749a247481021,2,21,22,43,4,2010-09-27 15:25:57,2010-09-27 15:25:57
3640abd9763dcb8002c024a2f1d749a247481021...3a66f15a68c589de07251f3de6e155ddf0422af2,2,39,36,75,2,2010-09-27 15:26:29,2010-09-27 15:26:29
3a66f15a68c589de07251f3de6e155ddf0422af2...6ee04e0f97b95c19c8b8cbb80c029f7d55df76c3,2,54,53,107,3,2010-09-27 15:26:57,2010-09-27 15:26:57
6ee04e0f97b95c19c8b8cbb80c029f7d55df76c3...d99f19fb6ae069f8c39d4fab837746f7fb3bef7a,7,68,29,97,13,2010-09-27 15:27:07,2010-09-27 15:27:07
d99f19fb6ae069f8c39d4fab837746f7fb3bef7a...e8ccba765cd9c2db624dcaf7fcc2cf638193f517,2,232,220,452,7,2010-09-27 15:27:25,2010-09-27 15:27:25
e8ccba765cd9c2db624dcaf7fcc2cf638193f517...804b94e27dc0146e2ceed8191b74c7ef4d7f58a1,2,39,40,79,2,2010-09-27 15:32:19,2010-09-27 15:32:19
804b94e27dc0146e2ceed8191b74c7ef4d7f58a1...f1328b3adb3b471ce36efb423815def1a85f7e66,3,86,65,151,4,2010-09-27 15:32:49,2010-09-27 15:32:49
f1328b3adb3b471ce36efb423815def1a85f7e66...46448ec51e1b876c48ab9d9d6fdfb1d80ace48c7,2,84,94,178,3,2010-09-27 15:33:17,2010-09-27 15:33:17
46448ec51e1b876c48ab9d9d6fdfb1d80ace48c7...1917a43c4b6f4f310ec63dcb55927ddcd0132f4d,1,16,28,44,3,2010-09-27 15:33:42,2010-09-27 15:33:42
1917a43c4b6f4f310ec63dcb55927ddcd0132f4d...494933a36bbd78d041c8c3ac60da418392d50860,1,42,44,86,1,2010-09-27 15:34:06,2010-09-27 15:34:06
494933a36bbd78d041c8c3ac60da418392d50860...4cd11f8681db0ec8efabbdcb3ebf73f650d1635c,5,243,250,493,7,2010-09-27 15:34:41,2010-09-27 15:34:41
4cd11f8681db0ec8efabbdcb3ebf73f650d1635c...46d1d951c272093cee14b4b095cebd234854a5f3,1,98,88,186,11,2010-09-27 15:35:07,2010-09-27 15:35:07
46d1d951c272093cee14b4b095cebd234854a5f3...0b7b3e1ae8737c8ea68a2fef10d4295be61478d1,1,66,51,117,2,2010-09-27 15:35:39,2010-09-27 15:35:39
0b7b3e1ae8737c8ea68a2fef10d4295be61478d1...8425cdef452bae10e1c23199f0a89a98e785bc8d,1,4,1,5,1,2010-09-27 15:36:07,2010-09-27 15:36:07
8425cdef452bae10e1c23199f0a89a98e785bc8d...2f480e088244e4fb81d3cf27d1ca7f533698a41a,1,21,13,34,2,2010-09-27 15:36:30,2010-09-27 15:36:30
2f480e088244e4fb81d3cf27d1ca7f533698a41a...74b6c76e25404d9ca5c8a8d76a29597582adec4d,1,80,63,143,1,2010-09-27 15:36:54,2010-09-27 15:36:54
74b6c76e25404d9ca5c8a8d76a29597582adec4d...025ee2c13e9e3c386c746c03ba7cd7603b4b7d10,2,78,64,142,2,2010-09-27 15:37:19,2010-09-27 15:37:19
025ee2c13e9e3c386c746c03ba7cd7603b4b7d10...554be48d01d9aea9af9d27e7296488766f04f8c1,2,96,75,171,3,2010-09-27 15:37:45,2010-09-27 15:37:45
554be48d01d9aea9af9d27e7296488766f04f8c1...25119398832db630322bfa845a381ea7f5b068d5,1,1,0,1,1,2010-09-27 15:38:08,2010-09-27 15:38:08
25119398832db630322bfa845a381ea7f5b068d5...229c738a03b938fd81a4858ad51750c76d2d666c,2,19,9,28,15,2010-09-27 16:22:30,2010-09-27 16:22:30
229c738a03b938fd81a4858ad51750c76d2d666c...cf0e0c47f0b68cb4cfe7d5711df44dd1c05c385e,1,0,2,2,1,2010-09-28 04:49:37,2010-09-28 04:49:37
cf0e0c47f0b68cb4cfe7d5711df44dd1c05c385e...e9f10deec0cc5c340d255f6f24df5d6889e94796,2,134,123,257,2,2010-09-28 07:09:19,2010-09-28 07:09:19
e9f10deec0cc5c340d255f6f24df5d6889e94796...7230b609c3619cbcd503062fecf00871a6087e4d,2,36,42,78,4,2010-09-28 07:09:40,2010-09-28 07:09:40
7230b609c3619cbcd503062fecf00871a6087e4d...66cb5d5aae6d0de993dd1ac972732aea2de8e605,1,61,47,108,1,2010-09-28 07:10:05,2010-09-28 07:10:05
66cb5d5aae6d0de993dd1ac972732aea2de8e605...45859fe9ffab2a5c28938d0722d6058076583dc2,2,114,107,221,7,2010-09-28 08:27:43,2010-09-28 08:27:43
45859fe9ffab2a5c28938d0722d6058076583dc2...a9e0305f2294012ffd6aad76fa7bab4d2c3ed4cd,2,69,57,126,2,2010-09-28 08:28:07,2010-09-28 08:28:07
a9e0305f2294012ffd6aad76fa7bab4d2c3ed4cd...ccd6a6783baef1980cbe2f04a038eaecf23742ef,2,39,37,76,2,2010-09-28 08:28:32,2010-09-28 08:28:32
ccd6a6783baef1980cbe2f04a038eaecf23742ef...5277425ae454da282edfd4322b3a282458c410e2,2,42,34,76,2,2010-09-28 08:28:56,2010-09-28 08:28:56
5277425ae454da282edfd4322b3a282458c410e2...efa27fc86cff473c5ca5c0d48bcd264c99d9fd47,13,31,30,61,31,2010-09-28 08:29:30,2010-09-28 08:29:30
efa27fc86cff473c5ca5c0d48bcd264c99d9fd47...3b255e33e846459e217c1d9a02ef4b385a34c0a1,4,190,175,365,5,2010-09-28 08:29:58,2010-09-28 08:29:58
3b255e33e846459e217c1d9a02ef4b385a34c0a1...a36a8bbb39615cde73b5fbeec2621360f69869c7,1,481,592,1073,3,2010-09-28 08:30:22,2010-09-28 08:30:22
a36a8bbb39615cde73b5fbeec2621360f69869c7...0f41f91bc2fea5a4e11936ff9011148e91366a83,4,93,96,189,5,2010-09-28 08:31:01,2010-09-28 08:31:01
0f41f91bc2fea5a4e11936ff9011148e91366a83...aec5f084a381062c2d98d17583b997beda31447a,1,22,24,46,6,2010-09-28 12:10:52,2010-09-28 12:10:52
aec5f084a381062c2d98d17583b997beda31447a...51ded1500fe8466743cd47f901a71504ad545406,2,197,127,324,4,2010-09-28 13:44:49,2010-09-28 13:44:49
51ded1500fe8466743cd47f901a71504ad545406...49544ffb3616eb3c65d3ecef0ba28f836ab57050,2,314,177,491,3,2010-09-28 13:45:22,2010-09-28 13:45:22
49544ffb3616eb3c65d3ecef0ba28f836ab57050...cd7e271e5424bd2f32f8b064072a4e040fca5a9a,3,594,220,814,34,2010-09-28 14:53:21,2010-09-28 14:53:21
cd7e271e5424bd2f32f8b064072a4e040fca5a9a...a40380f37aab87a2bbde205356c7f3f63efe8e6c,1,1,1,2,1,2010-09-28 15:09:06,2010-09-28 15:09:06
a40380f37aab87a2bbde205356c7f3f63efe8e6c...f27d85b8f4fa16f0d98d4dd56a6a77575ac0e952,1,11,4,15,1,2010-09-29 01:29:10,2010-09-29 01:29:10
f27d85b8f4fa16f0d98d4dd56a6a77575ac0e952...ed1aa807e22c8c76fd7885153d23544061a2f2ee,1,24,0,24,1,2010-09-29 17:34:26,2010-09-29 17:34:26
ed1aa807e22c8c76fd7885153d23544061a2f2ee...89e0fde94834da40f9083698227500d1ea0ec2cf,1,76,20,96,6,2010-09-29 17:58:29,2010-09-29 17:58:29
89e0fde94834da40f9083698227500d1ea0ec2cf...ebc084ca351a8d79a26f5239afc1b46a4d245139,1,5,11,16,3,2010-10-01 02:39:25,2010-10-01 02:39:25
ebc084ca351a8d79a26f5239afc1b46a4d245139...a0cabd766f9cbbf776e3a776a9eb41265502864d,2,6,1,7,3,2010-10-01 02:39:45,2010-10-01 02:39:45
a0cabd766f9cbbf776e3a776a9eb41265502864d...6d30b2847c6002bda76210045e449b89d1da8d8e,1,0,3,3,1,2010-10-01 02:40:01,2010-10-01 02:40:01
6d30b2847c6002bda76210045e449b89d1da8d8e...36ce5d0b3a5af8bae8282590b2a510272953958e,2,4,0,4,2,2010-10-01 02:40:25,2010-10-01 02:40:25
36ce5d0b3a5af8bae8282590b2a510272953958e...1429a3dbbad29809ad21947d123a64340d74e099,1,4,4,8,2,2010-10-02 13:14:47,2010-10-02 13:14:47
1429a3dbbad29809ad21947d123a64340d74e099...826692568427328400492f899a315b628b18f877,1,12,8,20,4,2010-10-02 13:56:58,2010-10-02 13:56:58
826692568427328400492f899a315b628b18f877...cb0018185465c8aa22092fd887cfd4b25e6544ab,4,33,4,37,7,2010-10-05 19:41:48,2010-10-05 19:41:48
cb0018185465c8aa22092fd887cfd4b25e6544ab...c7ce5b8929b6dea9e1d0776fdb2bc37686ef9b6b,2,8,0,8,3,2010-10-05 20:27:11,2010-10-05 20:27:11
c7ce5b8929b6dea9e1d0776fdb2bc37686ef9b6b...12187bfd26fa8205d5a6a12bdf294c0a1fc21a6c,13,223,123,346,59,2010-10-05 20:31:02,2010-10-05 20:31:02
12187bfd26fa8205d5a6a12bdf294c0a1fc21a6c...01b12a6fab25a9891085acc718d52e033188d7e7,1,1,1,2,1,2010-10-07 22:33:02,2010-10-07 22:33:02
01b12a6fab25a9891085acc718d52e033188d7e7...cf1d9f4b2cb30e8eb29b29714df592a31ddedcfa,1,1,1,2,1,2010-10-07 23:49:31,2010-10-07 23:49:31
cf1d9f4b2cb30e8eb29b29714df592a31ddedcfa...0a52a04a070fd46d50c2a0385349ef5f96d6dc58,2,2,0,2,2,2010-10-08 13:53:25,2010-10-08 13:53:25
0a52a04a070fd46d50c2a0385349ef5f96d6dc58...5b1e21e2006ec0b2b5484ca92e429fc457e9eb05,1,3,1,4,2,2010-10-08 14:16:29,2010-10-08 14:16:29
5b1e21e2006ec0b2b5484ca92e429fc457e9eb05...36167517aa6e08cfcaf1ed7c8fb8cb1dd53938d8,1,4,4,8,1,2010-10-08 14:16:50,2010-10-08 14:16:50
36167517aa6e08cfcaf1ed7c8fb8cb1dd53938d8...0d4d924ca5cae8aadb5f5973fe4b26c9c7fc7a0f,2,40,6,46,7,2010-10-08 14:17:13,2010-10-08 14:17:13
0d4d924ca5cae8aadb5f5973fe4b26c9c7fc7a0f...83f762e3ac8a531eec0886d0f10d38c86dcde715,1,81,78,159,6,2010-10-08 15:43:20,2010-10-08 15:43:20
83f762e3ac8a531eec0886d0f10d38c86dcde715...21be09dbb40ba7300b5b1fdb90cf25e8637a4971,3,32,0,32,3,2010-10-08 15:44:28,2010-10-08 15:44:28
21be09dbb40ba7300b5b1fdb90cf25e8637a4971...bbab38dc503a7d4c3e5c41d73e42fa9d6081e67b,1,5,6,11,4,2010-10-08 15:45:07,2010-10-08 15:45:07
bbab38dc503a7d4c3e5c41d73e42fa9d6081e67b...5170a12a880ea470875981bf7e75553bed11ac00,1,3,1,4,1,2010-10-08 15:45:33,2010-10-08 15:45:33
5170a12a880ea470875981bf7e75553bed11ac00...9ad73135c0e028341cd5dd7574a80b2875587973,6,10,10,20,10,2010-10-08 15:46:03,2010-10-08 15:46:03
9ad73135c0e028341cd5dd7574a80b2875587973...eae8c651774c613f1039510e560c57abfec87c68,1,1,1,2,1,2010-10-08 15:46:27,2010-10-08 15:46:27
eae8c651774c613f1039510e560c57abfec87c68...de3669d2fa16ea7603b76e9e21e575974916ecf4,1,9,0,9,1,2010-10-08 15:46:49,2010-10-08 15:46:49
de3669d2fa16ea7603b76e9e21e575974916ecf4...9d1bf9d5ad6c1ad97b1fb915975f3de3c13c4f4e,1,10,10,20,3,2010-10-08 15:47:09,2010-10-08 15:47:09
9d1bf9d5ad6c1ad97b1fb915975f3de3c13c4f4e...fb3f629457117cb754208af68dc7f63b73f92e1b,3,29,7,36,8,2010-10-08 17:54:11,2010-10-08 17:54:11
fb3f629457117cb754208af68dc7f63b73f92e1b...9937943f3a4d6f9e6e0121b41c22ec7ea64dc66c,2,1,3,4,3,2010-10-08 17:54:40,2010-10-08 17:54:40
9937943f3a4d6f9e6e0121b41c22ec7ea64dc66c...e8051e983a9a6a2fbec1ba79cb79d00c62fddb24,2,12,1,13,3,2010-10-08 21:12:55,2010-10-08 21:12:55
e8051e983a9a6a2fbec1ba79cb79d00c62fddb24...cd1134d6df87b6a8a7bebbf4c70db8e5664132ed,1,10,0,10,1,2010-10-08 22:52:41,2010-10-08 22:52:41
cd1134d6df87b6a8a7bebbf4c70db8e5664132ed...475fb82d9874d465910c446349e254e9e8afa12f,2,12,0,12,2,2010-10-08 23:17:14,2010-10-08 23:17:14
475fb82d9874d465910c446349e254e9e8afa12f...0eb8c02c6e0a9cbf88505aaf81e931a548da0ec5,1,1,0,1,1,2010-10-08 23:37:48,2010-10-08 23:37:48
0eb8c02c6e0a9cbf88505aaf81e931a548da0ec5...3ab1a0c7d6bd88063e526a8ec36e1468b9364f9e,2,63,60,123,3,2010-10-08 23:48:07,2010-10-08 23:48:07
3ab1a0c7d6bd88063e526a8ec36e1468b9364f9e...ae448e4439f306aeec4989739f137e7d64ab63ef,4,42,4,46,6,2010-10-08 23:55:38,2010-10-08 23:55:38
ae448e4439f306aeec4989739f137e7d64ab63ef...5ff085d65ed87793e06c94569c79ef41e7c4afcc,2,13,1,14,3,2010-10-09 02:11:18,2010-10-09 02:11:18
5ff085d65ed87793e06c94569c79ef41e7c4afcc...52e781290174b71b37e4675ff504edc612ea66e8,1,9,0,9,1,2010-10-09 02:57:11,2010-10-09 02:57:11
52e781290174b71b37e4675ff504edc612ea66e8...714694aeed99848b80d67444fc7280b3b67c90d6,2,20,9,29,7,2010-10-09 03:23:01,2010-10-09 03:23:01
714694aeed99848b80d67444fc7280b3b67c90d6...a3581f9a5542178ea870dcc986b659892adb0ee8,5,109,88,197,22,2010-10-09 03:36:46,2010-10-09 03:36:46
a3581f9a5542178ea870dcc986b659892adb0ee8...fae5b04f11611a891d28abc214412cf8c4fe9549,2,0,110,110,2,2010-10-09 04:10:39,2010-10-09 04:10:39
fae5b04f11611a891d28abc214412cf8c4fe9549...8fd9f2eb9f2706dc774ffbdea6bd172c83741e68,1,24,11,35,8,2010-10-09 05:10:32,2010-10-09 05:10:32
8fd9f2eb9f2706dc774ffbdea6bd172c83741e68...19352c9cd9b3ae42ef945fa1de8399e38b2533e0,1,7,3,10,3,2010-10-09 07:28:47,2010-10-09 07:28:47
19352c9cd9b3ae42ef945fa1de8399e38b2533e0...b2bd6c9d56092ed4f7a3436de764baf9e44b6f12,1,2,2,4,2,2010-10-09 07:36:07,2010-10-09 07:36:07
b2bd6c9d56092ed4f7a3436de764baf9e44b6f12...824ca0d6e560684bd0c09b09afece2586176a2c7,4,44,46,90,34,2010-10-09 07:48:09,2010-10-09 07:48:09
824ca0d6e560684bd0c09b09afece2586176a2c7...a322ba66a175abe4c34bfc6d7cdecb8d4e801ed3,2,71,65,136,2,2010-10-09 08:23:32,2010-10-09 08:23:32
a322ba66a175abe4c34bfc6d7cdecb8d4e801ed3...9584b77c35752b76116d34ac9d8b57c560ef5846,58,85,85,170,83,2010-10-09 08:25:01,2010-10-09 08:25:01
9584b77c35752b76116d34ac9d8b57c560ef5846...91310e759a616d7bc26be5274417279a42d9ff4a,1,10,5,15,4,2010-10-09 08:26:29,2010-10-09 08:26:29
91310e759a616d7bc26be5274417279a42d9ff4a...a96e50b76b38edb94356bb5d346ef96067175906,1,25,0,25,1,2010-10-09 10:01:01,2010-10-09 10:01:01
a96e50b76b38edb94356bb5d346ef96067175906...4241197b40c0facd38a672eaf7594a01a091edae,1,5,1,6,1,2010-10-09 10:23:48,2010-10-09 10:23:48
4241197b40c0facd38a672eaf7594a01a091edae...e8d50382188b475ce4b0d9dd47566200fa494971,1,2,1,3,2,2010-10-09 14:47:04,2010-10-09 14:47:04
e8d50382188b475ce4b0d9dd47566200fa494971...935f6873dd9bfa1582575c0309f0f8dcab0c0102,1,134,21,155,8,2010-10-09 14:47:28,2010-10-09 14:47:28
935f6873dd9bfa1582575c0309f0f8dcab0c0102...2e5f0c228fb7bf65c83d8d83f3237db6a5e5ccb4,2,254,169,423,3,2010-10-09 16:27:19,2010-10-09 16:27:19
2e5f0c228fb7bf65c83d8d83f3237db6a5e5ccb4...bb66cb8463190a0d65b920f44f50c23da9f58bd7,2,8,2,10,3,2010-10-09 16:46:25,2010-10-09 16:46:25
bb66cb8463190a0d65b920f44f50c23da9f58bd7...b3e02d19ecf0be17fa18db553be3e7d4734df60e,1,5,0,5,1,2010-10-09 16:51:50,2010-10-09 16:51:50
b3e02d19ecf0be17fa18db553be3e7d4734df60e...50ce4573309c88e9f4805bc26cf84d572d894f6d,1,0,3,3,3,2010-10-09 17:15:35,2010-10-09 17:15:35
50ce4573309c88e9f4805bc26cf84d572d894f6d...62dfe54d70892a50e867712eff465bdc30762906,1,5,1,6,1,2010-10-09 17:32:43,2010-10-09 17:32:43
62dfe54d70892a50e867712eff465bdc30762906...b6223d302036ed46db80115906e2230411bc91f6,2,19,0,19,3,2010-10-09 20:10:00,2010-10-09 20:10:00
b6223d302036ed46db80115906e2230411bc91f6...ee8fc8d93af9d5dbba45dc8b0cdcc4658d71d161,2,156,113,269,4,2010-10-09 21:55:33,2010-10-09 21:55:33
ee8fc8d93af9d5dbba45dc8b0cdcc4658d71d161...846febeb7abc935b986d168432323c49a3ee6735,1,2,2,4,1,2010-10-09 22:42:01,2010-10-09 22:42:01
846febeb7abc935b986d168432323c49a3ee6735...5d9140c137fa369e7c033f08685751d85cae28ff,1,8,4,12,3,2010-10-09 23:05:09,2010-10-09 23:05:09
5d9140c137fa369e7c033f08685751d85cae28ff...cf2e9f66ed1aad7537b8cd6fed5c4975b4de00d5,2,53,42,95,3,2010-10-10 01:09:20,2010-10-10 01:09:20
cf2e9f66ed1aad7537b8cd6fed5c4975b4de00d5...a92da6e80b840ba7874e6faebd54d50be85ab1ae,1,15,14,29,5,2010-10-10 01:09:34,2010-10-10 01:09:34
a92da6e80b840ba7874e6faebd54d50be85ab1ae...4d70df8b7830d32dd06728a12a39df14e07e42be,3,32,2,34,4,2010-10-10 01:59:17,2010-10-10 01:59:17
4d70df8b7830d32dd06728a12a39df14e07e42be...7de577093c0c510926c0ee4bf6b1452c250f3441,1,6,0,6,1,2010-10-10 06:07:25,2010-10-10 06:07:25
7de577093c0c510926c0ee4bf6b1452c250f3441...95d0ffbb0f96c3f77a64459a2922739d44819896,1,10,5,15,2,2010-10-10 06:37:19,2010-10-10 06:37:19
95d0ffbb0f96c3f77a64459a2922739d44819896...13229684091072db5e8c5b4b6c06c489ef33c9b0,2,8,5,13,4,2010-10-10 07:09:57,2010-10-10 07:09:57
13229684091072db5e8c5b4b6c06c489ef33c9b0...4395b6575b4b18f287ce7eeea81a40205c1c5a40,1,6,2,8,1,2010-10-10 07:59:49,2010-10-10 07:59:49
4395b6575b4b18f287ce7eeea81a40205c1c5a40...700c5a3dfe46155ae367345eb4e7a04013bb6548,2,9,1,10,2,2010-10-10 08:06:39,2010-10-10 08:06:39
700c5a3dfe46155ae367345eb4e7a04013bb6548...a23b42924a5b6e7dde03785288bec2840ec710bb,2,13,1,14,3,2010-10-10 09:38:55,2010-10-10 09:38:55
a23b42924a5b6e7dde03785288bec2840ec710bb...c4956d1b9efd0996f40d5f34af01f14613414858,1,38,4,42,10,2010-10-10 09:40:38,2010-10-10 09:40:38
c4956d1b9efd0996f40d5f34af01f14613414858...be190d1913b3e95cf13bc99d7674facfcfaec41c,5,17,11,28,7,2010-10-10 09:58:24,2010-10-10 09:58:24
be190d1913b3e95cf13bc99d7674facfcfaec41c...fee4aa31d7c8b08b58dab46c502e3c736d845539,2,5,0,5,2,2010-10-10 10:02:18,2010-10-10 10:02:18
fee4aa31d7c8b08b58dab46c502e3c736d845539...46812b4c2bdbfd791af18be066a2fa60718a3a97,3,24,4,28,6,2010-10-10 16:45:06,2010-10-10 16:45:06
46812b4c2bdbfd791af18be066a2fa60718a3a97...e226a113a6861b370770166ce7e13224e82d970e,1,1,1,2,1,2010-10-10 18:17:32,2010-10-10 18:17:32
e226a113a6861b370770166ce7e13224e82d970e...b014c81fa73c3ac613835a650da441ab06e8c6ee,2,124,108,232,6,2010-10-10 18:28:53,2010-10-10 18:28:53
b014c81fa73c3ac613835a650da441ab06e8c6ee...1b7d73848c7260e87c3e4c5a0548a36bcd1f520b,1,3,3,6,3,2010-10-10 22:41:51,2010-10-10 22:41:51
1b7d73848c7260e87c3e4c5a0548a36bcd1f520b...1d9336bb6c59b9b75c14674c41cc831af8b28429,1,1,1,2,1,2010-10-11 03:40:26,2010-10-11 03:40:26
1d9336bb6c59b9b75c14674c41cc831af8b28429...1534af4b44e91276cb3ea0a76f1e9cab4fb4eb1b,6,46,18,64,19,2010-10-11 14:36:20,2010-10-11 14:36:20
1534af4b44e91276cb3ea0a76f1e9cab4fb4eb1b...69d40b4a6f859cd6b08c41abcc8d6a0dc2a803fa,1,316,418,734,2,2010-10-11 15:18:34,2010-10-11 15:18:34
69d40b4a6f859cd6b08c41abcc8d6a0dc2a803fa...6d34d308aa5efb5492a032d6b9d1042a0145bdea,2,43,24,67,6,2010-10-11 17:41:59,2010-10-11 17:41:59
6d34d308aa5efb5492a032d6b9d1042a0145bdea...efc752423677bec795a5314e060e3a9ecce9fedc,2,138,64,202,3,2010-10-11 18:18:12,2010-10-11 18:18:12
efc752423677bec795a5314e060e3a9ecce9fedc...01d1dd6935f59a16516d4b481b6dd13edfd7b033,2,133,164,297,3,2010-10-11 20:38:29,2010-10-11 20:38:29
01d1dd6935f59a16516d4b481b6dd13edfd7b033...d2724d883e1913f34f473c6567675fb1d0f26663,1,7,1,8,3,2010-10-11 21:58:46,2010-10-11 21:58:46
d2724d883e1913f34f473c6567675fb1d0f26663...cc1a41f3de96713956215e6ba691d3f33f7716b3,1,3,3,6,1,2010-10-11 22:24:59,2010-10-11 22:24:59
cc1a41f3de96713956215e6ba691d3f33f7716b3...cf6b26d7a2e7fd3384e01a68102f6649e6ad6abc,1,7,7,14,7,2010-10-11 22:35:24,2010-10-11 22:35:24
cf6b26d7a2e7fd3384e01a68102f6649e6ad6abc...d327611b241e222922cd1161fbbebe4a23f8e485,2,22,2,24,3,2010-10-11 22:36:17,2010-10-11 22:36:17
d327611b241e222922cd1161fbbebe4a23f8e485...b12428de91faa8975dca04f6d7e4c5db76a1fd99,4,45,62,107,3,2010-10-12 01:00:58,2010-10-12 01:00:58
b12428de91faa8975dca04f6d7e4c5db76a1fd99...d83af03c595772f7570d9169f8f80e064b68b8ea,2,22,19,41,4,2010-10-12 01:01:25,2010-10-12 01:01:25
d83af03c595772f7570d9169f8f80e064b68b8ea...5ecb496d6cc304c8cbe077f04244560d7e345f60,2,20,19,39,2,2010-10-12 01:01:49,2010-10-12 01:01:49
5ecb496d6cc304c8cbe077f04244560d7e345f60...6b1a45289b9605af219111b4cd0a3cb81e876f27,2,84,105,189,2,2010-10-12 01:02:13,2010-10-12 01:02:13
6b1a45289b9605af219111b4cd0a3cb81e876f27...6f7f1f651b45b3cac20ccfa17acb0ec71ef6a671,2,119,147,266,2,2010-10-12 01:02:37,2010-10-12 01:02:37
6f7f1f651b45b3cac20ccfa17acb0ec71ef6a671...5f8332af049efc878a4c906e75e90708e90830b3,1,1,1,2,1,2010-10-12 01:02:57,2010-10-12 01:02:57
5f8332af049efc878a4c906e75e90708e90830b3...de8ff6b672fcf0010a4584d98cc845eb2ab8fc6c,2,54,79,133,3,2010-10-12 01:54:48,2010-10-12 01:54:48
de8ff6b672fcf0010a4584d98cc845eb2ab8fc6c...9ab383b394c70ebb550536f3b7ba91a5cfc3b912,2,8,2,10,2,2010-10-12 01:59:46,2010-10-12 01:59:46
9ab383b394c70ebb550536f3b7ba91a5cfc3b912...9b077ee4b651b0b2023ac673b0348e5a612335de,2,29,18,47,2,2010-10-12 02:09:35,2010-10-12 02:09:35
9b077ee4b651b0b2023ac673b0348e5a612335de...23ecf3cf6c6c1b426a5a192cee8f14ed8a7860c0,1,35,25,60,6,2010-10-12 07:27:49,2010-10-12 07:27:49
23ecf3cf6c6c1b426a5a192cee8f14ed8a7860c0...3c8bc8c64b2620e44275ff703c47b77cc77a0c59,1,7,7,14,7,2010-10-12 14:09:02,2010-10-12 14:09:02
3c8bc8c64b2620e44275ff703c47b77cc77a0c59...4ed10675f953e4349ecd3ad386ef5c8485d0220f,4,14,3,17,4,2010-10-12 17:27:07,2010-10-12 17:27:07
4ed10675f953e4349ecd3ad386ef5c8485d0220f...18a605d6ad1041d413f59876bef62b6f9c275ea2,2,40,4,44,3,2010-10-13 00:33:10,2010-10-13 00:33:10
18a605d6ad1041d413f59876bef62b6f9c275ea2...a6d7836fd1e5f4e4935b45dcd419dae9aaae51b0,1,1,1,2,2,2010-10-13 01:25:04,2010-10-13 01:25:04
a6d7836fd1e5f4e4935b45dcd419dae9aaae51b0...55b68363f21746e7794412d1a6a4d86e7dce97fe,1,1,1,2,1,2010-10-13 07:02:43,2010-10-13 07:02:43
55b68363f21746e7794412d1a6a4d86e7dce97fe...1df25941b388d88e4360d2ebe478b3cd41e3eb28,2,75,67,142,2,2010-10-14 01:11:22,2010-10-14 01:11:22
1df25941b388d88e4360d2ebe478b3cd41e3eb28...25db006b7b22f19a0fa2ce2846cced2a845a1ac5,2,54,53,107,2,2010-10-14 01:17:32,2010-10-14 01:17:32
25db006b7b22f19a0fa2ce2846cced2a845a1ac5...14419f916bbbe8017976b19a3bcf7d45e0f30f64,2,105,130,235,2,2010-10-14 01:24:55,2010-10-14 01:24:55
14419f916bbbe8017976b19a3bcf7d45e0f30f64...e50066d0b59fd106272357f5747d6f4f33b47751,2,51,43,94,5,2010-10-14 01:40:39,2010-10-14 01:40:39
e50066d0b59fd106272357f5747d6f4f33b47751...ece06a80069199acab4569e8a84666114d955535,1,14,0,14,2,2010-10-14 10:04:03,2010-10-14 10:04:03
ece06a80069199acab4569e8a84666114d955535...7be27dc0836a092f03d7a6f1fc7834ef4f585f18,2,20,1,21,2,2010-10-14 18:38:43,2010-10-14 18:38:43
7be27dc0836a092f03d7a6f1fc7834ef4f585f18...f18e27145c58fa4dcd4055c42ebfb87d0d3b64ff,2,155,105,260,13,2010-10-15 02:41:21,2010-10-15 02:41:21
f18e27145c58fa4dcd4055c42ebfb87d0d3b64ff...3c469e95fbd92986563cbc5508bfce0bcd868d47,2,226,169,395,4,2010-10-15 06:52:53,2010-10-15 06:52:53
3c469e95fbd92986563cbc5508bfce0bcd868d47...7ddeb86cb6a872059311269baf9da412be753e84,1,63,72,135,5,2010-10-15 07:34:41,2010-10-15 07:34:41
7ddeb86cb6a872059311269baf9da412be753e84...d0a056bcff57c7c870d66ca7e827d54fece2899b,1,17,0,17,1,2010-10-15 09:31:59,2010-10-15 09:31:59
d0a056bcff57c7c870d66ca7e827d54fece2899b...560f58aba3be6a23698008600a87dc0bcd747fd7,1,5,1,6,1,2010-10-15 10:22:50,2010-10-15 10:22:50
560f58aba3be6a23698008600a87dc0bcd747fd7...ac16c59d3509fe65574a0e10cef2b9051f5e6d57,2,4,4,8,2,2010-10-15 20:14:22,2010-10-15 20:14:22
ac16c59d3509fe65574a0e10cef2b9051f5e6d57...386b6811050009337bf0eb11512c7bbf339805ff,2,232,109,341,2,2010-10-16 17:00:35,2010-10-16 17:00:35
386b6811050009337bf0eb11512c7bbf339805ff...11713a8771221767f31718ef6406d276b435b9b0,2,4,2,6,2,2010-10-16 20:51:06,2010-10-16 20:51:06
11713a8771221767f31718ef6406d276b435b9b0...2a33115040557ae2cc348317ca799e293648fff7,2,5,5,10,8,2010-10-17 01:50:58,2010-10-17 01:50:58
2a33115040557ae2cc348317ca799e293648fff7...0e4737ec240f144dc072d17e99b12143d872e577,3,37,4,41,6,2010-10-17 15:40:41,2010-10-17 15:40:41
0e4737ec240f144dc072d17e99b12143d872e577...630b1fc09b6a1e521b64bc7f8792fd0807d22c07,1,0,3,3,1,2010-10-17 15:41:00,2010-10-17 15:41:00
630b1fc09b6a1e521b64bc7f8792fd0807d22c07...55d8c47d29ce24428fbfd425a5ae6030bbeaf09f,2,19,5,24,6,2010-10-17 16:09:07,2010-10-17 16:09:07
55d8c47d29ce24428fbfd425a5ae6030bbeaf09f...efcb7776a0209447cc8ac3eb12760c197eeed7bb,4,99,8,107,5,2010-10-18 05:02:28,2010-10-18 05:02:28
efcb7776a0209447cc8ac3eb12760c197eeed7bb...9dfdcf86befecad3b638df03273719c5ada90a45,7,27,25,52,21,2010-10-19 00:11:51,2010-10-19 00:11:51
9dfdcf86befecad3b638df03273719c5ada90a45...4ec58f702b3f6268d011e1942266af9d7ba664fa,1,2,1,3,1,2010-10-19 00:28:00,2010-10-19 00:28:00
4ec58f702b3f6268d011e1942266af9d7ba664fa...da17c2b84fda02aa1f1615f04e6d681cea9adcb4,1,8,0,8,1,2010-10-19 00:58:34,2010-10-19 00:58:34
da17c2b84fda02aa1f1615f04e6d681cea9adcb4...9bcdb620cbd7e2cda4b09b194b9ec7b3497c134e,2,1468,1093,2561,12,2010-10-19 04:17:29,2010-10-19 04:17:29
9bcdb620cbd7e2cda4b09b194b9ec7b3497c134e...0476014a768d450cab1f1415dc3397f06f12d7b0,2,371,287,658,2,2010-10-19 05:11:56,2010-10-19 05:11:56
0476014a768d450cab1f1415dc3397f06f12d7b0...ed195a6fd399d9d236300ecc4858a45bfbaf6659,2,384,248,632,2,2010-10-19 12:28:48,2010-10-19 12:28:48
ed195a6fd399d9d236300ecc4858a45bfbaf6659...6a369d2ff385edd3bbc2b8e0ab659f8fdef767d3,1,12,3,15,3,2010-10-19 19:42:36,2010-10-19 19:42:36
6a369d2ff385edd3bbc2b8e0ab659f8fdef767d3...a7a91c2d40e31eb2e054a5c33e63324a80fe2d59,2,68,22,90,9,2010-10-19 21:45:51,2010-10-19 21:45:51
a7a91c2d40e31eb2e054a5c33e63324a80fe2d59...f71f31228339fadd6a4d9c11d8755cfb420152bf,1,2,2,4,1,2010-10-20 08:02:07,2010-10-20 08:02:07
f71f31228339fadd6a4d9c11d8755cfb420152bf...c2cb82b3c713ddcd33e547049edd3b850cee960c,1,1,1,2,1,2010-10-20 21:08:50,2010-10-20 21:08:50
c2cb82b3c713ddcd33e547049edd3b850cee960c...1160d81e44876f02cdb42ce7500ba1dd43067fae,1,5,2,7,2,2010-10-20 21:19:50,2010-10-20 21:19:50
1160d81e44876f02cdb42ce7500ba1dd43067fae...b855dbf676a496c2d3ac1ea6bec5ebe8e4cc5590,1,8,7,15,5,2010-10-20 22:15:26,2010-10-20 22:15:26
b855dbf676a496c2d3ac1ea6bec5ebe8e4cc5590...0df4c1c411db33bd5785cf29486320287b206c59,1,6,2,8,3,2010-10-21 17:37:38,2010-10-21 17:37:38
0df4c1c411db33bd5785cf29486320287b206c59...7f404e26289e4676478f9096a61b7bc2cf56cdf2,4,5,32,37,6,2010-10-21 21:21:43,2010-10-21 21:21:43
7f404e26289e4676478f9096a61b7bc2cf56cdf2...54cb6ab1f36078453769cd03d3485525b1c5f25f,2,5,1,6,3,2010-10-21 21:22:11,2010-10-21 21:22:11
54cb6ab1f36078453769cd03d3485525b1c5f25f...7377e4f92d8f13ec649f478cac41cab35039eb40,1,1,1,2,1,2010-10-22 21:20:30,2010-10-22 21:20:30
7377e4f92d8f13ec649f478cac41cab35039eb40...f6de03b3a2cc8bb48369a58db59001bcd25c0988,4,75,5,80,8,2010-10-23 00:11:50,2010-10-23 00:11:50
f6de03b3a2cc8bb48369a58db59001bcd25c0988...67ba914b8718b00b44c07d5350ee8e468a92a9e2,1,9,9,18,9,2010-10-23 14:53:18,2010-10-23 14:53:18
67ba914b8718b00b44c07d5350ee8e468a92a9e2...af3de6a712117cebe20afe05ffe96fd7c8c163d5,4,111,56,167,22,2010-10-23 16:43:42,2010-10-23 16:43:42
af3de6a712117cebe20afe05ffe96fd7c8c163d5...2380a469d71d0f6d251a058b0ce6c7f71857251b,1,61,42,103,20,2010-10-23 21:21:34,2010-10-23 21:21:34
2380a469d71d0f6d251a058b0ce6c7f71857251b...f0416f693fa54b1a46e0db437970fcda73a5d77f,2,64,52,116,35,2010-10-23 22:07:33,2010-10-23 22:07:33
f0416f693fa54b1a46e0db437970fcda73a5d77f...74fe39764647a4447e18fe7f44374f12ed20025f,1,1,1,2,1,2010-10-23 22:15:27,2010-10-23 22:15:27
74fe39764647a4447e18fe7f44374f12ed20025f...d269738f41d1eb2fb66d1c7bf376f44845aea22d,1,4,4,8,1,2010-10-23 22:29:53,2010-10-23 22:29:53
d269738f41d1eb2fb66d1c7bf376f44845aea22d...92435e1e48514d013bc58ce294b310bec62657bf,1,83,5,88,12,2010-10-24 08:54:51,2010-10-24 08:54:51
92435e1e48514d013bc58ce294b310bec62657bf...4b61183840e43eee612de507e4b12470b61b5383,1,59,53,112,34,2010-10-24 09:13:56,2010-10-24 09:13:56
4b61183840e43eee612de507e4b12470b61b5383...2d4ddc0416993725098a5f3016213e63fc1e4b70,1,1,1,2,1,2010-10-24 09:41:08,2010-10-24 09:41:08
2d4ddc0416993725098a5f3016213e63fc1e4b70...552acc652d5cad1e2664809a437702792a73b1e8,1,2,2,4,2,2010-10-24 17:29:49,2010-10-24 17:29:49
552acc652d5cad1e2664809a437702792a73b1e8...188a8e39fd1619b2e60f1846348ba237b892cc9f,1,5,5,10,2,2010-10-25 12:57:36,2010-10-25 12:57:36
188a8e39fd1619b2e60f1846348ba237b892cc9f...1826039e002694c1804eead4786789d0369758d6,2,277,234,511,2,2010-10-25 18:21:39,2010-10-25 18:21:39
1826039e002694c1804eead4786789d0369758d6...da5f6ef9e04e6f5d43b4d93699cd56c82f7c2917,1,8,1,9,2,2010-10-25 20:52:04,2010-10-25 20:52:04
da5f6ef9e04e6f5d43b4d93699cd56c82f7c2917...4527535a935f3369c8c039e694ef823dfed7f566,1,3,0,3,1,2010-10-25 21:06:11,2010-10-25 21:06:11
4527535a935f3369c8c039e694ef823dfed7f566...cbc110a4675e987de5de075aa23b32296f5343ac,1,3,0,3,3,2010-10-26 18:11:22,2010-10-26 18:11:22
cbc110a4675e987de5de075aa23b32296f5343ac...99fbf0a46da331fbf6799756efa7460536fdff93,1,8,8,16,7,2010-10-27 16:04:33,2010-10-27 16:04:33
99fbf0a46da331fbf6799756efa7460536fdff93...f2d6c6f54d3dc05a022ede85dc15462d5fb0ea09,3,133,10,143,8,2010-10-27 16:10:48,2010-10-27 16:10:48
f2d6c6f54d3dc05a022ede85dc15462d5fb0ea09...e8c413a3e24f9828253eaadde3bdd66149912234,1,1,1,2,1,2010-10-27 20:08:54,2010-10-27 20:08:54
e8c413a3e24f9828253eaadde3bdd66149912234...12652baca69cb263382cb4992155db224f44400e,1,1,1,2,1,2010-10-28 01:56:41,2010-10-28 01:56:41
12652baca69cb263382cb4992155db224f44400e...fcc283a52de2185787d5ae4b0a04164f2a1e8882,1,0,3,3,3,2010-10-28 11:58:30,2010-10-28 11:58:30
fcc283a52de2185787d5ae4b0a04164f2a1e8882...36dd74446047570bd6bc1a8bdb8e2eaf3eb39a44,5,68,21,89,20,2010-10-28 11:58:51,2010-10-28 11:58:51
36dd74446047570bd6bc1a8bdb8e2eaf3eb39a44...4b8a391a3bd4eb605d999515c904840d7c72e97e,1,1,1,2,1,2010-10-28 12:15:05,2010-10-28 12:15:05
4b8a391a3bd4eb605d999515c904840d7c72e97e...5d0f4edb8bf6f3e77fd3e1f25e04d8efddcac1c8,1,3,3,6,2,2010-10-28 12:15:27,2010-10-28 12:15:27
5d0f4edb8bf6f3e77fd3e1f25e04d8efddcac1c8...4890ff129200f3cbb86027a173ff9ba4cedc11c4,1,1,1,2,1,2010-10-28 12:15:46,2010-10-28 12:15:46
4890ff129200f3cbb86027a173ff9ba4cedc11c4...c120794b9d1efa20732ec3bf389e7487a7408e8b,1,2,2,4,2,2010-10-28 12:16:04,2010-10-28 12:16:04
c120794b9d1efa20732ec3bf389e7487a7408e8b...181f26428abf3679e2b747fd49b88b0f104918f2,1,2,0,2,1,2010-10-28 12:16:21,2010-10-28 12:16:21
181f26428abf3679e2b747fd49b88b0f104918f2...3a679cc1c458c4e31fc22e511e9bc51ed939f102,1,1,2,3,2,2010-10-28 12:16:39,2010-10-28 12:16:39
3a679cc1c458c4e31fc22e511e9bc51ed939f102...29ea1bef215040d34fb0f03c7f39f3a82515febf,3,40,5,45,8,2010-10-28 13:00:08,2010-10-28 13:00:08
29ea1bef215040d34fb0f03c7f39f3a82515febf...20c6f3f3d1a58960fcc141eb461f244ebdf266d0,1,11,7,18,4,2010-10-31 02:35:18,2010-10-31 02:35:18
20c6f3f3d1a58960fcc141eb461f244ebdf266d0...3a25098c25a30d2eb7bf7d0f9e14d6db74a99dcf,1,2,2,4,2,2010-10-31 16:26:04,2010-10-31 16:26:04
3a25098c25a30d2eb7bf7d0f9e14d6db74a99dcf...d1175f815bcef8a0f25f803f914e707cc67be0c3,1,1,1,2,2,2010-10-31 23:46:14,2010-10-31 23:46:14
d1175f815bcef8a0f25f803f914e707cc67be0c3...2854336cc287a05531d1775e9bf80016329b60cd,6,232,326,558,80,2010-11-01 22:12:31,2010-11-01 22:12:31
2854336cc287a05531d1775e9bf80016329b60cd...775165b23634ff19692cd7226c40e2d38d1304ef,1,8,8,16,8,2010-11-01 22:18:50,2010-11-01 22:18:50
775165b23634ff19692cd7226c40e2d38d1304ef...0b0ae709d120bf54b3b8003a80f8bde7f8b9c519,2,343,272,615,2,2010-11-02 02:01:18,2010-11-02 02:01:18
0b0ae709d120bf54b3b8003a80f8bde7f8b9c519...443423c55f692e33d0f91d4bfe6adbc2c23583c2,2,562,411,973,2,2010-11-02 02:48:43,2010-11-02 02:48:43
443423c55f692e33d0f91d4bfe6adbc2c23583c2...09ccdde265ad91aa69d7446c6771567360b09bbe,2,548,402,950,3,2010-11-02 04:38:29,2010-11-02 04:38:29
09ccdde265ad91aa69d7446c6771567360b09bbe...628be3497a4c5a480f8564d782cbbd8f1f9879d7,2,1226,921,2147,2,2010-11-02 05:15:19,2010-11-02 05:15:19
628be3497a4c5a480f8564d782cbbd8f1f9879d7...3cfde8364be4f12e59e77dcd656e394236681ea8,1,13,16,29,5,2010-11-02 05:23:44,2010-11-02 05:23:44
3cfde8364be4f12e59e77dcd656e394236681ea8...a24ccfc79f94ce2e42bffd945539c320cfd058c8,1,2,2,4,2,2010-11-02 05:28:12,2010-11-02 05:28:12
a24ccfc79f94ce2e42bffd945539c320cfd058c8...5b78abeba795364e0f90448d9f51c255d0708394,3,3,3,6,3,2010-11-02 05:31:53,2010-11-02 05:31:53
5b78abeba795364e0f90448d9f51c255d0708394...72e3bc6e6f6035e3657069790391ce5058d95e20,1,12,2,14,2,2010-11-02 11:53:53,2010-11-02 11:53:53
72e3bc6e6f6035e3657069790391ce5058d95e20...a25718c157938e0bdbba7c9e9ee021ea654b1577,2,6,6,12,6,2010-11-02 18:30:31,2010-11-02 18:30:31
a25718c157938e0bdbba7c9e9ee021ea654b1577...6f30440b7291deac7e7de0c0e422f2bcc89a3c6d,4,18,5,23,8,2010-11-02 18:41:23,2010-11-02 18:41:23
6f30440b7291deac7e7de0c0e422f2bcc89a3c6d...d633a58108970613854e71eab6d8aeb8eacdac78,5,129,191,320,14,2010-11-04 04:47:54,2010-11-04 04:47:54
d633a58108970613854e71eab6d8aeb8eacdac78...b66df2f49e55886058351bc0aa9cded5500de2f5,1,1,1,2,1,2010-11-04 12:03:01,2010-11-04 12:03:01
b66df2f49e55886058351bc0aa9cded5500de2f5...74b566e81ccb0e12372bcd5828e9724f4aee8f1b,2,2,2,4,2,2010-11-04 12:39:11,2010-11-04 12:39:11
74b566e81ccb0e12372bcd5828e9724f4aee8f1b...fca56e845065da91e13b6511cc8cf7b70ad1272e,2,10,4,14,4,2010-11-04 12:39:27,2010-11-04 12:39:27
fca56e845065da91e13b6511cc8cf7b70ad1272e...85f4dd6353b9254ccf1dc5b4393b028f2eb3c4ab,3,17,3,20,5,2010-11-04 14:15:16,2010-11-04 14:15:16
85f4dd6353b9254ccf1dc5b4393b028f2eb3c4ab...25452e3aa5c67452e67ceb06f81124e538f9463c,1,1,1,2,1,2010-11-04 21:10:22,2010-11-04 21:10:22
25452e3aa5c67452e67ceb06f81124e538f9463c...80d6495f6e346917347dd1c8ca277cf0fb40165c,1,2,3,5,3,2010-11-06 03:26:46,2010-11-06 03:26:46
80d6495f6e346917347dd1c8ca277cf0fb40165c...c8c781a9d510def19720aca09b4a6d3cf75853f1,1,1,1,2,1,2010-11-06 04:32:23,2010-11-06 04:32:23
c8c781a9d510def19720aca09b4a6d3cf75853f1...1423593e8fe21072de841183cd76a667b6523ed1,1,9,5,14,5,2010-11-06 09:21:00,2010-11-06 09:21:00
1423593e8fe21072de841183cd76a667b6523ed1...24ce5033c835b76556893001758ef7e12f305373,1,28,5,33,5,2010-11-06 10:09:35,2010-11-06 10:09:35
24ce5033c835b76556893001758ef7e12f305373...d8e0052d454f581513cd8d3b683093a1f33f12e8,1,7,2,9,3,2010-11-06 16:32:08,2010-11-06 16:32:08
d8e0052d454f581513cd8d3b683093a1f33f12e8...2946a657cd339345dd2a6ba56045ba0a37b9995c,1,23,20,43,8,2010-11-07 01:00:05,2010-11-07 01:00:05
2946a657cd339345dd2a6ba56045ba0a37b9995c...969ac914ff83f8f01051c98d909c7a590c945530,8,23,21,44,13,2010-11-07 01:44:32,2010-11-07 01:44:32
969ac914ff83f8f01051c98d909c7a590c945530...7509bdf86b1bd805f9866fbc94697ea44ada65c0,7,183,54,237,10,2010-11-07 09:23:12,2010-11-07 09:23:12
7509bdf86b1bd805f9866fbc94697ea44ada65c0...1431bcc70ec46de34080ad0f44c64740e1520704,1,5,37,42,10,2010-11-07 21:02:49,2010-11-07 21:02:49
1431bcc70ec46de34080ad0f44c64740e1520704...0164ee0082614c188d26ba59ee994700bcf31ab2,1,8,6,14,4,2010-11-07 21:46:03,2010-11-07 21:46:03
0164ee0082614c188d26ba59ee994700bcf31ab2...6e201bcae22adcdf6894e56ad7426cc624bf85fd,1,31,8,39,3,2010-11-07 23:03:47,2010-11-07 23:03:47
6e201bcae22adcdf6894e56ad7426cc624bf85fd...488c9b3f115b9deb5e4b0f4e62109da6aad02cfa,1,13,1,14,2,2010-11-07 23:10:35,2010-11-07 23:10:35
488c9b3f115b9deb5e4b0f4e62109da6aad02cfa...cbe27e3cc4478431bb90dd22ecf81d0948dc7b7a,4,10,6,16,9,2010-11-08 04:42:13,2010-11-08 04:42:13
cbe27e3cc4478431bb90dd22ecf81d0948dc7b7a...6e5eb99c55ab5549b46bdf1d7b9963321d60eaff,2,2,2,4,2,2010-11-08 20:43:30,2010-11-08 20:43:30
6e5eb99c55ab5549b46bdf1d7b9963321d60eaff...33c0a14180a000c58a771f65fb463499238c3cc9,1,1,1,2,1,2010-11-08 23:50:17,2010-11-08 23:50:17
33c0a14180a000c58a771f65fb463499238c3cc9...caf51bfcd40bd718503dff418cd1953da07b1baf,1,1,1,2,1,2010-11-09 05:07:42,2010-11-09 05:07:42
caf51bfcd40bd718503dff418cd1953da07b1baf...66c72b1f80ed5bfc4001e42e9062e5a2b2db3830,1,4,4,8,3,2010-11-09 05:19:17,2010-11-09 05:19:17
66c72b1f80ed5bfc4001e42e9062e5a2b2db3830...a8114d64d55aaea4d0c4f995affbf883109fa9ef,1,31,0,31,1,2010-11-09 16:35:39,2010-11-09 16:35:39
a8114d64d55aaea4d0c4f995affbf883109fa9ef...7335388be2d2dbccf82c15f86121698487032fd6,1,0,14,14,1,2010-11-09 17:42:38,2010-11-09 17:42:38
7335388be2d2dbccf82c15f86121698487032fd6...0f065d346dc4814d42374c9069ef0e232f6d9b7b,1,22,0,22,1,2010-11-11 04:37:37,2010-11-11 04:37:37
0f065d346dc4814d42374c9069ef0e232f6d9b7b...2778f146604f33c4eab316ce6c8566a83b198ea8,1,3,3,6,4,2010-11-11 05:12:05,2010-11-11 05:12:05
2778f146604f33c4eab316ce6c8566a83b198ea8...79ab8cad03847146029f9f686aedfbdc8168807d,1,1,1,2,1,2010-11-11 05:18:27,2010-11-11 05:18:27
79ab8cad03847146029f9f686aedfbdc8168807d...d7b8d07cf21ca058251a5e21a7d0dd356aefe00c,4,48,13,61,12,2010-11-11 15:30:13,2010-11-11 15:30:13
d7b8d07cf21ca058251a5e21a7d0dd356aefe00c...659ac65cc39a6105a5e908f648bbc209112b1a37,1,0,0,0,0,2010-11-11 17:51:45,2010-11-11 17:51:45
659ac65cc39a6105a5e908f648bbc209112b1a37...4e4418d34d37ed87661bbcb30f975cd2d6d9d7a7,1,0,0,0,0,2010-11-11 17:53:59,2010-11-11 17:53:59
4e4418d34d37ed87661bbcb30f975cd2d6d9d7a7...0046f37393d0e8e74d8d8c6b0fc46e9bf211b638,4,46,15,61,9,2010-11-12 01:54:07,2010-11-12 01:54:07
0046f37393d0e8e74d8d8c6b0fc46e9bf211b638...e074d2b9e9200e211a71283b382f03906a127aca,1,3,3,6,3,2010-11-12 02:49:21,2010-11-12 02:49:21
e074d2b9e9200e211a71283b382f03906a127aca...80946dc0fa0ea8ca6245e7fec815edf8295ed396,1,2,2,4,2,2010-11-12 18:51:54,2010-11-12 18:51:54
80946dc0fa0ea8ca6245e7fec815edf8295ed396...8c7df2198acc6b81522bf0b89d348dbffd7dacce,2,428,335,763,4,2010-11-12 19:40:04,2010-11-12 19:40:04
8c7df2198acc6b81522bf0b89d348dbffd7dacce...17bd39ae5a0337f8bcd535a5fb03d27aaf0ab0c4,2,35,23,58,5,2010-11-12 19:47:41,2010-11-12 19:47:41
17bd39ae5a0337f8bcd535a5fb03d27aaf0ab0c4...a052bcb0119f0e7885ff9fa9bb5e7d39b838b6aa,1,6,6,12,4,2010-11-14 14:09:52,2010-11-14 14:09:52
a052bcb0119f0e7885ff9fa9bb5e7d39b838b6aa...dc3b524f6c0c513425f21434b44f3d9ef2d923c1,2,2,2,4,2,2010-11-14 15:50:01,2010-11-14 15:50:01
dc3b524f6c0c513425f21434b44f3d9ef2d923c1...2f91f76417ea949242b68db8e075bb43047fdd53,3,36,0,36,7,2010-11-14 23:36:40,2010-11-14 23:36:40
2f91f76417ea949242b68db8e075bb43047fdd53...bfab752286f72af8c6d4be3f30457d669610eab5,1,5,5,10,1,2010-11-16 02:21:38,2010-11-16 02:21:38
bfab752286f72af8c6d4be3f30457d669610eab5...478a4e22ad147175ca8672963154e196dbeb1ab6,1,9,3,12,2,2010-11-16 02:36:00,2010-11-16 02:36:00
478a4e22ad147175ca8672963154e196dbeb1ab6...3cbcce429c0f3fdbd9cfca0a7678a5a994262676,1,5,5,10,3,2010-11-16 13:32:07,2010-11-16 13:32:07
3cbcce429c0f3fdbd9cfca0a7678a5a994262676...587c66f7a0020bedccda7368b93eb025c84d6ac0,23,4930,5511,10441,111,2010-11-16 14:48:52,2010-11-16 14:48:52
587c66f7a0020bedccda7368b93eb025c84d6ac0...10fafed666b1bde858589787433af5bb15ceaded,2,355,256,611,3,2010-11-16 15:15:47,2010-11-16 15:15:47
10fafed666b1bde858589787433af5bb15ceaded...6ff1f386467cccaadd1d09dc7d7b8881ccb1389a,1,4,3,7,3,2010-11-16 21:34:53,2010-11-16 21:34:53
6ff1f386467cccaadd1d09dc7d7b8881ccb1389a...746ce7d9678c91ab6b811a5c4693b84ea56d64ee,2,10,1,11,2,2010-11-16 22:17:51,2010-11-16 22:17:51
746ce7d9678c91ab6b811a5c4693b84ea56d64ee...929b8ff3da31e1b143979a32659f741bbdf5d22b,1,0,16,16,1,2010-11-17 02:24:58,2010-11-17 02:24:58
929b8ff3da31e1b143979a32659f741bbdf5d22b...03b111c6cc2a09ddf8eea50d8d430a305799e9be,4,36,4,40,7,2010-11-17 02:58:59,2010-11-17 02:58:59
03b111c6cc2a09ddf8eea50d8d430a305799e9be...8acad926df509863c9b701d32c1b4a90e7e0a229,3,29,3,32,5,2010-11-17 12:24:47,2010-11-17 12:24:47
8acad926df509863c9b701d32c1b4a90e7e0a229...17d0c7ad4c8b4dff1df6dbb5cbc2b88f321827d9,2,1088,1039,2127,5,2010-11-17 13:38:53,2010-11-17 13:38:53
17d0c7ad4c8b4dff1df6dbb5cbc2b88f321827d9...f58d17db7495ce56acb9029ae4ebeab00cba085a,1,32,32,64,7,2010-11-17 15:45:15,2010-11-17 15:45:15
f58d17db7495ce56acb9029ae4ebeab00cba085a...6469eec71d9d82d8be2ac62a128273426d78ab5b,1,27,27,54,6,2010-11-17 16:11:17,2010-11-17 16:11:17
6469eec71d9d82d8be2ac62a128273426d78ab5b...1aaf270d73e42b28edace569575712cb2cbf1ef6,2,34,10,44,7,2010-11-17 16:47:46,2010-11-17 16:47:46
1aaf270d73e42b28edace569575712cb2cbf1ef6...030fdcc7c8e36f4a1c780dd974cbefe83ce202e8,2,5,0,5,2,2010-11-17 20:04:49,2010-11-17 20:04:49
030fdcc7c8e36f4a1c780dd974cbefe83ce202e8...9057450af00e34e4e9d33fb2d76b83fcc1d47802,2,21,16,37,3,2010-11-17 20:26:58,2010-11-17 20:26:58
9057450af00e34e4e9d33fb2d76b83fcc1d47802...395af9d5cf0f68130bfd75b9bdb2c20a8c6ef51a,1,8,10,18,4,2010-11-17 20:30:44,2010-11-17 20:30:44
395af9d5cf0f68130bfd75b9bdb2c20a8c6ef51a...d88cabd3da4bc82151ffaecc376c59478e191b20,4,46,5,51,20,2010-11-18 23:46:09,2010-11-18 23:46:09
d88cabd3da4bc82151ffaecc376c59478e191b20...87fe4be9c588856c872717cc714549c8f9c06956,5,20,6,26,12,2010-11-18 23:46:26,2010-11-18 23:46:26
87fe4be9c588856c872717cc714549c8f9c06956...9edd6953ccb2e173ffc94a8f3eaff8e3fa236e7f,2,156,121,277,13,2010-11-18 23:51:20,2010-11-18 23:51:20
9edd6953ccb2e173ffc94a8f3eaff8e3fa236e7f...4f2e9aed339472e6d665e7b5c34de8ec7b29bac4,2,1,2,3,2,2010-11-19 08:15:40,2010-11-19 08:15:40
4f2e9aed339472e6d665e7b5c34de8ec7b29bac4...5ef3269b78cadd6ea6b909cec3027e2c1e739f1d,1,5,4,9,2,2010-11-19 14:57:50,2010-11-19 14:57:50
5ef3269b78cadd6ea6b909cec3027e2c1e739f1d...426a28f9671018f45c85daed17d188a2289468e7,1,6,2,8,1,2010-11-19 17:30:56,2010-11-19 17:30:56
426a28f9671018f45c85daed17d188a2289468e7...da163cc9571f752c3b60a30bcad78bd359cb039d,4,84,37,121,11,2010-11-19 19:34:17,2010-11-19 19:34:17
da163cc9571f752c3b60a30bcad78bd359cb039d...237e9557d77b40348eb387e608cfe4565c988e5e,2,36,13,49,12,2010-11-19 23:04:48,2010-11-19 23:04:48
237e9557d77b40348eb387e608cfe4565c988e5e...04fec1be965ad70304635bf54c4843273e59b2a4,1,14,1,15,2,2010-11-19 23:23:03,2010-11-19 23:23:03
04fec1be965ad70304635bf54c4843273e59b2a4...8d3e66fad61c96aa2269a2a3ca38fb3f5cab1189,2,3,9,12,3,2010-11-19 23:23:17,2010-11-19 23:23:17
8d3e66fad61c96aa2269a2a3ca38fb3f5cab1189...7236b76e25d34947c8090c8061ebdf46cc233584,1,22,12,34,4,2010-11-19 23:56:38,2010-11-19 23:56:38
7236b76e25d34947c8090c8061ebdf46cc233584...b199cb36f3e236f468386c1c36a14a5eb20ebfaf,1,6,4,10,1,2010-11-20 00:06:19,2010-11-20 00:06:19
b199cb36f3e236f468386c1c36a14a5eb20ebfaf...84d809d8228cde8b4a1f7c566b3915678629c7b6,1,3,3,6,1,2010-11-20 01:15:14,2010-11-20 01:15:14
84d809d8228cde8b4a1f7c566b3915678629c7b6...8a0de6985c550ba88e5df9f1c85d9b46821c400d,1,7,8,15,1,2010-11-20 01:56:20,2010-11-20 01:56:20
8a0de6985c550ba88e5df9f1c85d9b46821c400d...077d04b7fe3298f872417064e13ff0a3547ad88d,1,1,1,2,1,2010-11-20 01:56:34,2010-11-20 01:56:34
077d04b7fe3298f872417064e13ff0a3547ad88d...762aaf45b7aadd4f7be71d05f56785efee8ed0a5,3,3,4,7,3,2010-11-20 10:51:04,2010-11-20 10:51:04
762aaf45b7aadd4f7be71d05f56785efee8ed0a5...76a51a3f041655456a276e2be9b43811fb61445e,1,1,1,2,1,2010-11-20 11:11:39,2010-11-20 11:11:39
76a51a3f041655456a276e2be9b43811fb61445e...4a8519334d5649f242ea5f8b3a0547b26831129b,1,5,2,7,3,2010-11-20 23:57:01,2010-11-20 23:57:01
4a8519334d5649f242ea5f8b3a0547b26831129b...d04ffd72471a7b400ca8e3263effb87713c7dba1,2,14,4,18,4,2010-11-21 10:16:02,2010-11-21 10:16:02
d04ffd72471a7b400ca8e3263effb87713c7dba1...4d7525c5b1d9503f0f447538409d24a28033763f,1,2,2,4,2,2010-11-21 14:08:13,2010-11-21 14:08:13
4d7525c5b1d9503f0f447538409d24a28033763f...99bad1b0554f77138ca3273fbf5af2b1aa97d089,1,37,18,55,5,2010-11-21 14:58:18,2010-11-21 14:58:18
99bad1b0554f77138ca3273fbf5af2b1aa97d089...4e3c8c6aff5d0cb2d3869cae36618da6106d65be,2,8,2,10,3,2010-11-21 15:19:46,2010-11-21 15:19:46
4e3c8c6aff5d0cb2d3869cae36618da6106d65be...2aa47f2b32ada4f78b98765441489bd59445c181,1,3,3,6,6,2010-11-21 17:35:48,2010-11-21 17:35:48
2aa47f2b32ada4f78b98765441489bd59445c181...56b9e0c45f75338c928806aa59f7f33ff204c948,1,2,3,5,1,2010-11-22 06:44:59,2010-11-22 06:44:59
56b9e0c45f75338c928806aa59f7f33ff204c948...c2de746ea5c95c9a0876b941e2de9fdbd97c6221,3,25,10,35,11,2010-11-22 18:02:33,2010-11-22 18:02:33
c2de746ea5c95c9a0876b941e2de9fdbd97c6221...1c451c0f395a14e426c17a8eb059669fa3d0d7ab,2,16,10,26,8,2010-11-23 14:11:20,2010-11-23 14:11:20
1c451c0f395a14e426c17a8eb059669fa3d0d7ab...857131685a059c82412f9952fc5560d83cc49950,1,14,12,26,7,2010-11-24 11:53:04,2010-11-24 11:53:04
857131685a059c82412f9952fc5560d83cc49950...cb9cb65c6833c0477bbae19fd0cfe51e1df050ee,1,61,46,107,2,2010-11-24 15:29:50,2010-11-24 15:29:50
cb9cb65c6833c0477bbae19fd0cfe51e1df050ee...73ff0f1287dedb64fd539612ac18f11e142460a3,1,1,1,2,1,2010-11-24 19:52:34,2010-11-24 19:52:34
73ff0f1287dedb64fd539612ac18f11e142460a3...7704bd9462648880b28f90330902432085986d45,1,49,13,62,6,2010-11-25 12:40:12,2010-11-25 12:40:12
7704bd9462648880b28f90330902432085986d45...edaf6aaba86263b8e1a8c107d7e81e03c8a37ac2,1,8,1,9,2,2010-11-26 12:34:22,2010-11-26 12:34:22
edaf6aaba86263b8e1a8c107d7e81e03c8a37ac2...1c68437d1d8e000bacd0f2444859cb779bc11245,1,1,1,2,1,2010-11-26 12:41:26,2010-11-26 12:41:26
1c68437d1d8e000bacd0f2444859cb779bc11245...4b752d6490722568789470aec883224df1bc49b1,1,19,15,34,9,2010-11-26 13:27:28,2010-11-26 13:27:28
4b752d6490722568789470aec883224df1bc49b1...537c45e394fbfe21a9170541d3c134524edd6624,7,8,8,16,7,2010-11-26 13:38:33,2010-11-26 13:38:33
537c45e394fbfe21a9170541d3c134524edd6624...c8e9d35e5cb89955ce3975f5604d0df6e6c32006,2,2,2,4,1,2010-11-26 13:38:53,2010-11-26 13:38:53
c8e9d35e5cb89955ce3975f5604d0df6e6c32006...56dc22d64c08916508862784a3c97f27e1e6900b,6,66,21,87,19,2010-11-26 14:28:27,2010-11-26 14:28:27
56dc22d64c08916508862784a3c97f27e1e6900b...f26dae8fb22c8d951078a5ce7f195b398334f901,1,8,7,15,5,2010-11-26 15:10:58,2010-11-26 15:10:58
f26dae8fb22c8d951078a5ce7f195b398334f901...165a860f872e9b385d0dea417b0e5dc28ed4eb9e,1,1,1,2,1,2010-11-26 15:33:39,2010-11-26 15:33:39
165a860f872e9b385d0dea417b0e5dc28ed4eb9e...db345ac5a2edd8c89fb3a98fd67fa4ed18abde93,1,17,15,32,6,2010-11-26 16:54:21,2010-11-26 16:54:21
db345ac5a2edd8c89fb3a98fd67fa4ed18abde93...d9ec98ca5d501c62896962a72f29150d916185db,1,15,16,31,10,2010-11-27 12:20:09,2010-11-27 12:20:09
d9ec98ca5d501c62896962a72f29150d916185db...c71451c9853ae1e75327dbbee456f8254936f4e1,1,8,6,14,5,2010-11-27 12:28:35,2010-11-27 12:28:35
c71451c9853ae1e75327dbbee456f8254936f4e1...82261de2feb26161590016d4a2b20f2e80c6ca8b,1,0,1,1,1,2010-11-27 12:34:54,2010-11-27 12:34:54
82261de2feb26161590016d4a2b20f2e80c6ca8b...0a0d4884f6747d97293b913b48e24ca79463033c,2,22,22,44,21,2010-11-27 21:59:03,2010-11-27 21:59:03
0a0d4884f6747d97293b913b48e24ca79463033c...7b4c0a73e401ab8154f26978e2a10a070684e5b5,1,4,4,8,3,2010-11-28 17:50:17,2010-11-28 17:50:17
7b4c0a73e401ab8154f26978e2a10a070684e5b5...84e65e91a133fca585e21c87c777d1e87184b3a0,1,94,90,184,48,2010-11-28 18:20:05,2010-11-28 18:20:05
84e65e91a133fca585e21c87c777d1e87184b3a0...1dd9c9c1fb9317a52461db4faa399211aeebdb34,1,1,1,2,1,2010-11-28 18:49:37,2010-11-28 18:49:37
1dd9c9c1fb9317a52461db4faa399211aeebdb34...57c55c69f8c16258f927c79415a4b8f7918679a3,1,21,8,29,9,2010-11-28 20:14:40,2010-11-28 20:14:40
57c55c69f8c16258f927c79415a4b8f7918679a3...fe74b832b1fe0234cb71d057940157d27c89b2d1,1,52,20,72,20,2010-11-29 01:00:09,2010-11-29 01:00:09
fe74b832b1fe0234cb71d057940157d27c89b2d1...a647d0b8bad1d8874e8ffa032ff39a56fe23e108,1,34,23,57,9,2010-11-29 05:33:06,2010-11-29 05:33:06
a647d0b8bad1d8874e8ffa032ff39a56fe23e108...3c951d94b66433244b31c6ab49e53f1b608c0b6e,3,39,3,42,4,2010-11-29 05:54:43,2010-11-29 05:54:43
3c951d94b66433244b31c6ab49e53f1b608c0b6e...3d07bb71c6ffc225e6d3a32975f6855b2561e85a,1,25,2,27,2,2010-11-29 06:25:25,2010-11-29 06:25:25
3d07bb71c6ffc225e6d3a32975f6855b2561e85a...612825583857f0dfbfa0c0bb3bb3c64832302f8d,2,18,1,19,2,2010-11-30 21:32:11,2010-11-30 21:32:11
612825583857f0dfbfa0c0bb3bb3c64832302f8d...f1d4f713e563e8e352b870fe30426579dcc7b5ce,2,2,2,4,2,2010-11-30 21:39:54,2010-11-30 21:39:54
f1d4f713e563e8e352b870fe30426579dcc7b5ce...5eb62e1d942f194bd418c8e51da17605a08dc601,1,14,4,18,3,2010-11-30 22:16:53,2010-11-30 22:16:53
5eb62e1d942f194bd418c8e51da17605a08dc601...0d6c945622feb8b25cbb845f4073c4e88a1ed5f4,1,2,3,5,2,2010-12-01 15:09:56,2010-12-01 15:09:56
0d6c945622feb8b25cbb845f4073c4e88a1ed5f4...e86e3031403bccb1fa6d7e4706155a29d4e22407,2,2,2,4,2,2010-12-01 17:54:06,2010-12-01 17:54:06
e86e3031403bccb1fa6d7e4706155a29d4e22407...1155b493bc37ea37a31ff2a0da2be253504a59f8,1,10,10,20,8,2010-12-01 21:44:37,2010-12-01 21:44:37
1155b493bc37ea37a31ff2a0da2be253504a59f8...a607d9d34546a4ff9313d431e275ed0bf365d42a,3,5,11,16,7,2010-12-02 01:02:11,2010-12-02 01:02:11
a607d9d34546a4ff9313d431e275ed0bf365d42a...d7391648d4035dbce70f11f131cf90587d122560,1,2,2,4,2,2010-12-02 01:03:00,2010-12-02 01:03:00
d7391648d4035dbce70f11f131cf90587d122560...6690e08eac796c06026312ca7eb0bbb594f0ae6c,1,4,4,8,4,2010-12-02 02:00:32,2010-12-02 02:00:32
6690e08eac796c06026312ca7eb0bbb594f0ae6c...f8d014504f9ff003fe3ec28ccc9dcb129974ff09,1,17,15,32,3,2010-12-02 22:38:09,2010-12-02 22:38:09
f8d014504f9ff003fe3ec28ccc9dcb129974ff09...57e5ccbc1ad6cdbb52c738e74db242539e6f3a56,1,25,6,31,2,2010-12-03 00:58:56,2010-12-03 00:58:56
57e5ccbc1ad6cdbb52c738e74db242539e6f3a56...99b5526c19841abb398364947d04460f743dc216,1,9,4,13,3,2010-12-03 18:39:09,2010-12-03 18:39:09
99b5526c19841abb398364947d04460f743dc216...e0d68084a0a89ada1ff030d03d9f9eb51dcfd159,2,11,2,13,4,2010-12-03 20:26:57,2010-12-03 20:26:57
e0d68084a0a89ada1ff030d03d9f9eb51dcfd159...84e5277a25989cadf54eba5b74292604135ae5dc,1,2,2,4,2,2010-12-04 01:23:11,2010-12-04 01:23:11
84e5277a25989cadf54eba5b74292604135ae5dc...c7d68418d2f4205d805ea4a68f0ed956ff975d0c,1,1,1,2,1,2010-12-04 04:34:04,2010-12-04 04:34:04
c7d68418d2f4205d805ea4a68f0ed956ff975d0c...81a85a0c2b6741b82819687db6a5bc092d7c4508,3,19,1,20,4,2010-12-04 07:05:04,2010-12-04 07:05:04
81a85a0c2b6741b82819687db6a5bc092d7c4508...3ad1cb7701d6f86de9b565b120da9130017ec31a,1,4,4,8,2,2010-12-04 07:05:22,2010-12-04 07:05:22
3ad1cb7701d6f86de9b565b120da9130017ec31a...821b7f362c84bdb527618416e0b237ab2d10e638,2,10,3,13,3,2010-12-04 07:05:39,2010-12-04 07:05:39
821b7f362c84bdb527618416e0b237ab2d10e638...5a792ec4ccacf7c68a3273763fab433bf57760fe,1,13,13,26,2,2010-12-04 07:05:57,2010-12-04 07:05:57
5a792ec4ccacf7c68a3273763fab433bf57760fe...cc48f66f733c9b2fdbc817d473c82300e807f779,27,402,387,789,307,2010-12-04 07:49:31,2010-12-04 07:49:31
cc48f66f733c9b2fdbc817d473c82300e807f779...70383ccf68934d3f520cae0938d86c373e625513,2,13,2,15,4,2010-12-04 07:53:23,2010-12-04 07:53:23
70383ccf68934d3f520cae0938d86c373e625513...6c53a816e7fee8f21f6ed9c7fe1c151a65ea2a57,2,5,1,6,3,2010-12-04 08:04:16,2010-12-04 08:04:16
6c53a816e7fee8f21f6ed9c7fe1c151a65ea2a57...65b26b30a760330aac94bf2cdaa4d18f337c875e,1,12,0,12,1,2010-12-04 11:38:26,2010-12-04 11:38:26
65b26b30a760330aac94bf2cdaa4d18f337c875e...d54d7a52a959611124a47b47864ca34f154d1853,14,168,344,512,79,2010-12-04 13:11:54,2010-12-04 13:11:54
d54d7a52a959611124a47b47864ca34f154d1853...ff76e2cde81d2ae6b7d74b27d83126809ff28099,1,4,4,8,2,2010-12-04 20:21:49,2010-12-04 20:21:49
ff76e2cde81d2ae6b7d74b27d83126809ff28099...84c283744fd52f59e595aefa2b49dedf50239616,1,108,108,216,37,2010-12-04 20:42:07,2010-12-04 20:42:07
84c283744fd52f59e595aefa2b49dedf50239616...f6294c00e24c1084507b0217140f6ff320afd5a9,1,24,0,24,1,2010-12-04 20:58:36,2010-12-04 20:58:36
f6294c00e24c1084507b0217140f6ff320afd5a9...778782eac81c95c5fb8a70604ed8c3da0d8bd1f7,1,37,5,42,5,2010-12-04 22:32:28,2010-12-04 22:32:28
778782eac81c95c5fb8a70604ed8c3da0d8bd1f7...b0d9eaaa6a2cd3670bc005a5a95a44790794ccad,6,243,13,256,12,2010-12-05 01:54:15,2010-12-05 01:54:15
b0d9eaaa6a2cd3670bc005a5a95a44790794ccad...54b122c9bbe0c5957759db1d1a5454e09b71327f,1,14,13,27,1,2010-12-05 02:09:29,2010-12-05 02:09:29
54b122c9bbe0c5957759db1d1a5454e09b71327f...a4d88f007c4df2b4225bedbe79b2865733b8117e,2,102,35,137,17,2010-12-05 06:46:23,2010-12-05 06:46:23
a4d88f007c4df2b4225bedbe79b2865733b8117e...8f2feb2e766e3380c2306c25aa3acae6b4b4a306,3,79,65,144,29,2010-12-05 07:36:40,2010-12-05 07:36:40
8f2feb2e766e3380c2306c25aa3acae6b4b4a306...ecca5414f901c8a5769cf3dbcfe84792522a481c,1,20,18,38,8,2010-12-05 16:48:05,2010-12-05 16:48:05
ecca5414f901c8a5769cf3dbcfe84792522a481c...63f2c07d3af51fea58e66ae3daa0f6de4f151917,1,35,32,67,14,2010-12-05 23:53:59,2010-12-05 23:53:59
63f2c07d3af51fea58e66ae3daa0f6de4f151917...bc709e6b8668c5a6ecccfc5e0238d05cb736e0b2,1,49,37,86,18,2010-12-06 01:55:53,2010-12-06 01:55:53
bc709e6b8668c5a6ecccfc5e0238d05cb736e0b2...d1c0c473ce64d6536256229dde42f0467c977355,1,10,8,18,4,2010-12-06 12:17:45,2010-12-06 12:17:45
d1c0c473ce64d6536256229dde42f0467c977355...a47c2eff6c4c58c721ddee00d54f8efdf520ba2a,1,1,1,2,1,2010-12-06 23:08:21,2010-12-06 23:08:21
a47c2eff6c4c58c721ddee00d54f8efdf520ba2a...7c23fbd9a0cb0f41abcf4a75a4708dc140f99ace,1,26,0,26,1,2010-12-06 23:09:55,2010-12-06 23:09:55
7c23fbd9a0cb0f41abcf4a75a4708dc140f99ace...1c81377af583029d014a85db62c7e78d8b924e4e,1,1,0,1,1,2010-12-08 04:03:30,2010-12-08 04:03:30
1c81377af583029d014a85db62c7e78d8b924e4e...d0056051a508610ba421bfa68c2069da2199242c,1,5,2,7,1,2010-12-08 08:00:50,2010-12-08 08:00:50
d0056051a508610ba421bfa68c2069da2199242c...0f7f6a8adf012b764343d9ee1771ab026e631a23,1,17,9,26,7,2010-12-08 18:32:20,2010-12-08 18:32:20
0f7f6a8adf012b764343d9ee1771ab026e631a23...ff7f25052bbc6050857f7401223a9f071f6eff87,1,1,2,3,1,2010-12-08 18:37:24,2010-12-08 18:37:24
ff7f25052bbc6050857f7401223a9f071f6eff87...546c77e0ae6a690e7ac49ba0ead75651948595cc,1,7,7,14,2,2010-12-11 13:30:21,2010-12-11 13:30:21
546c77e0ae6a690e7ac49ba0ead75651948595cc...f1a9a8bb418aaf2128b31e7b42e2c667ead8d8e8,2,8,0,8,2,2010-12-11 13:58:11,2010-12-11 13:58:11
f1a9a8bb418aaf2128b31e7b42e2c667ead8d8e8...cf53963b6ad7ea7e35dadc7c197a9f811dc08b30,1,2,0,2,1,2010-12-11 15:06:50,2010-12-11 15:06:50
cf53963b6ad7ea7e35dadc7c197a9f811dc08b30...9bbd12120e6da8d78f8b70517d05c70cba828f1c,2,99,291,390,11,2010-12-12 04:35:24,2010-12-12 04:35:24
9bbd12120e6da8d78f8b70517d05c70cba828f1c...b734e3514e41af3e227db3fbef677fd77868f4ec,4,59,89,148,11,2010-12-12 04:37:01,2010-12-12 04:37:01
b734e3514e41af3e227db3fbef677fd77868f4ec...3c208d1cca091934ba28a3a86948ad362f9e1e1e,1,1,1,2,1,2010-12-13 13:41:12,2010-12-13 13:41:12
3c208d1cca091934ba28a3a86948ad362f9e1e1e...38d848a3fefe703ee38cb84ea67e90d74733552b,1,7,1,8,4,2010-12-13 13:55:46,2010-12-13 13:55:46
38d848a3fefe703ee38cb84ea67e90d74733552b...d6cf84b032538eb7edb60b353ab1c60973a7b7f5,1,2,2,4,2,2010-12-13 13:56:02,2010-12-13 13:56:02
d6cf84b032538eb7edb60b353ab1c60973a7b7f5...33e7a8214be56366f76bd28dcf5677fb46d01f40,1,4,0,4,1,2010-12-13 13:56:18,2010-12-13 13:56:18
33e7a8214be56366f76bd28dcf5677fb46d01f40...69edfc7531f99427e9c3544a262c7f73611ea930,2,2,2,4,2,2010-12-13 13:56:38,2010-12-13 13:56:38
69edfc7531f99427e9c3544a262c7f73611ea930...32bf35da09660604e8c65c1ac75f28b1918cf91c,2,19,0,19,2,2010-12-13 13:56:55,2010-12-13 13:56:55
32bf35da09660604e8c65c1ac75f28b1918cf91c...49c2f23ec1b35ef2544653c1dfa93ce144160a4e,2,4,4,8,2,2010-12-13 13:57:15,2010-12-13 13:57:15
49c2f23ec1b35ef2544653c1dfa93ce144160a4e...33a6201fdf6d3334dbafcafa117959a8e3af91d6,2,24,1,25,3,2010-12-13 13:57:38,2010-12-13 13:57:38
33a6201fdf6d3334dbafcafa117959a8e3af91d6...4803410721db629a35390eb415e8c3fe86314f30,1,1,1,2,1,2010-12-13 13:57:54,2010-12-13 13:57:54
4803410721db629a35390eb415e8c3fe86314f30...2ab1e928540a4b38f5d3d639312e9978e0aa4363,1,15,5,20,1,2010-12-13 13:58:09,2010-12-13 13:58:09
2ab1e928540a4b38f5d3d639312e9978e0aa4363...bd4f4b8ab97b87c377167853479875380c25ba61,6,57,17,74,14,2010-12-13 13:58:38,2010-12-13 13:58:38
bd4f4b8ab97b87c377167853479875380c25ba61...642ba981e10678051e69051f5bee5a587fa00947,1,2,0,2,2,2010-12-13 19:37:48,2010-12-13 19:37:48
642ba981e10678051e69051f5bee5a587fa00947...38c88f7c2a0e4a7851f178cf91ab451624e37bd7,1,2,2,4,2,2010-12-14 23:44:28,2010-12-14 23:44:28
38c88f7c2a0e4a7851f178cf91ab451624e37bd7...2a0dda3df9c90047267e2c812ea75d2ec233bec6,1,5,0,5,1,2010-12-18 14:05:40,2010-12-18 14:05:40
2a0dda3df9c90047267e2c812ea75d2ec233bec6...82e8ad3dcacbd205c77a50fff51b105bdf5e0530,1,5,0,5,1,2010-12-18 15:37:55,2010-12-18 15:37:55
82e8ad3dcacbd205c77a50fff51b105bdf5e0530...5e6c5418c0cd7473fabd5d5a1a9f6a07625a8060,1,20,20,40,7,2010-12-18 16:51:18,2010-12-18 16:51:18
5e6c5418c0cd7473fabd5d5a1a9f6a07625a8060...6c357cc9bbea8ecf9e1241058d0e9da210bcfd33,1,2,1,3,1,2010-12-18 17:40:53,2010-12-18 17:40:53
6c357cc9bbea8ecf9e1241058d0e9da210bcfd33...5a33ce25003b5c17b143003910408826a68ddf1b,2,21,12,33,4,2010-12-18 19:35:46,2010-12-18 19:35:46
5a33ce25003b5c17b143003910408826a68ddf1b...f32feafccf1602a4a1349b4fd9b6d6fe9e9caadd,3,41,125,166,9,2010-12-18 22:12:08,2010-12-18 22:12:08
f32feafccf1602a4a1349b4fd9b6d6fe9e9caadd...d2ef2cd9ccf548807d0d36ef7e0767190f7fef97,3,138,214,352,13,2010-12-18 22:12:22,2010-12-18 22:12:22
d2ef2cd9ccf548807d0d36ef7e0767190f7fef97...94adbd1d127c4e4a47db56776533ab0cfecc6589,3,80,254,334,10,2010-12-18 22:12:31,2010-12-18 22:12:31
94adbd1d127c4e4a47db56776533ab0cfecc6589...177b090ec26bf5e19c694c96ca31bd9c5e5fe141,3,73,56,129,9,2010-12-18 22:12:41,2010-12-18 22:12:41
177b090ec26bf5e19c694c96ca31bd9c5e5fe141...cae809bb3c947f1cf40acfb89730e6b2f8540967,4,66,81,147,9,2010-12-18 22:12:51,2010-12-18 22:12:51
cae809bb3c947f1cf40acfb89730e6b2f8540967...812b1b2d8ce8b17ece74eadfbeea82d1ad1ad4f3,3,173,347,520,7,2010-12-18 22:13:01,2010-12-18 22:13:01
812b1b2d8ce8b17ece74eadfbeea82d1ad1ad4f3...aaaaa831fe127ae6b80aa6e8709e0c44d417f4f5,3,36,97,133,12,2010-12-18 22:13:11,2010-12-18 22:13:11
aaaaa831fe127ae6b80aa6e8709e0c44d417f4f5...4aedbcb57e8578fd572bcbce4fd1b284c5198b7a,3,36,113,149,11,2010-12-18 22:13:20,2010-12-18 22:13:20
4aedbcb57e8578fd572bcbce4fd1b284c5198b7a...994ba4f3ada79deef9ed28b2e8059e28149a7176,3,83,158,241,12,2010-12-18 22:13:30,2010-12-18 22:13:30
994ba4f3ada79deef9ed28b2e8059e28149a7176...3c50c138c58938fa3cb8b7fca2d0b8d25706e43c,3,175,169,344,13,2010-12-18 22:13:39,2010-12-18 22:13:39
3c50c138c58938fa3cb8b7fca2d0b8d25706e43c...56f5043c234c6a2429b587632717954b5463f815,3,42,11,53,8,2010-12-18 22:13:49,2010-12-18 22:13:49
56f5043c234c6a2429b587632717954b5463f815...edcb47538101b793027bf93a32a209d1fa34577c,3,197,101,298,8,2010-12-18 22:13:58,2010-12-18 22:13:58
edcb47538101b793027bf93a32a209d1fa34577c...f2a8534d7b2ddc70c9a3855c0c54e5ec4e88df05,4,71,63,134,12,2010-12-18 22:14:11,2010-12-18 22:14:11
f2a8534d7b2ddc70c9a3855c0c54e5ec4e88df05...5c3ede2171ba6b7f2fb30956cb1ecb84064f143f,3,25,58,83,9,2010-12-18 22:14:20,2010-12-18 22:14:20
5c3ede2171ba6b7f2fb30956cb1ecb84064f143f...771ffbf0f6b728eabe1e887ffebe8f59478cbd5e,3,18,17,35,5,2010-12-18 22:14:30,2010-12-18 22:14:30
771ffbf0f6b728eabe1e887ffebe8f59478cbd5e...a15aa66917279acef61aee8e3a8a94ed93652146,3,64,74,138,5,2010-12-18 22:14:39,2010-12-18 22:14:39
a15aa66917279acef61aee8e3a8a94ed93652146...4b3198d15d275a19ebc7d6af0e374ed12a518239,4,467,89,556,13,2010-12-18 22:14:52,2010-12-18 22:14:52
4b3198d15d275a19ebc7d6af0e374ed12a518239...b6fbf30a3211986a75e15aa93b4e21b590eb5a1e,3,30,104,134,9,2010-12-18 22:15:03,2010-12-18 22:15:03
b6fbf30a3211986a75e15aa93b4e21b590eb5a1e...60e36fbc723977bf350ba0248b73d4f03dfaf96f,4,150,177,327,9,2010-12-18 22:15:18,2010-12-18 22:15:18
60e36fbc723977bf350ba0248b73d4f03dfaf96f...b17b5677441b22cf3be360563434a65df5e31af3,3,113,28,141,10,2010-12-18 22:15:31,2010-12-18 22:15:31
b17b5677441b22cf3be360563434a65df5e31af3...e7703398c4de1121616aecb857843665a6cbfa88,3,30,66,96,7,2010-12-18 22:15:41,2010-12-18 22:15:41
e7703398c4de1121616aecb857843665a6cbfa88...0c33a3a89c5dd2eddef436bb03ba3d7d08a30c8d,3,68,199,267,10,2010-12-18 22:15:52,2010-12-18 22:15:52
0c33a3a89c5dd2eddef436bb03ba3d7d08a30c8d...989f59299c2476967a5ca94240ac860a4a79d087,3,50,44,94,9,2010-12-18 22:16:01,2010-12-18 22:16:01
989f59299c2476967a5ca94240ac860a4a79d087...160533410fcb94c41f6481880d80500dae57b34e,5,32,45,77,13,2010-12-18 22:16:15,2010-12-18 22:16:15
160533410fcb94c41f6481880d80500dae57b34e...d5c15a490e84d858a531e4a79aef49893ce1706a,1,8,2,10,3,2010-12-18 23:10:29,2010-12-18 23:10:29
d5c15a490e84d858a531e4a79aef49893ce1706a...eb7f2789f8e2c9214f0004426270ea8a2589d3e4,1,1,1,2,1,2010-12-19 02:01:01,2010-12-19 02:01:01
eb7f2789f8e2c9214f0004426270ea8a2589d3e4...9184dba1f5628162a57c752f88cb1b90bd9f197e,3,22,3,25,5,2010-12-21 15:14:28,2010-12-21 15:14:28
9184dba1f5628162a57c752f88cb1b90bd9f197e...af1c8b2cfaf04072dff481982b2b064e10f84488,2,10,10,20,2,2010-12-21 15:14:52,2010-12-21 15:14:52
af1c8b2cfaf04072dff481982b2b064e10f84488...eb18ea78998f28687b01adcd83970a472dad5e75,3,8,4,12,4,2010-12-21 15:15:28,2010-12-21 15:15:28
eb18ea78998f28687b01adcd83970a472dad5e75...0e651d3fd464dbc2e8c22c62dc9a62c2057efa6e,3,18,9,27,11,2010-12-21 15:16:05,2010-12-21 15:16:05
0e651d3fd464dbc2e8c22c62dc9a62c2057efa6e...2565b8070640e23b1e3dc302923d75aff35bbdcb,2,30,2,32,4,2010-12-21 15:28:11,2010-12-21 15:28:11
2565b8070640e23b1e3dc302923d75aff35bbdcb...b145b1263403b4981edfef8060aafcb25c4cf842,2,29,6,35,7,2010-12-21 23:43:04,2010-12-21 23:43:04
b145b1263403b4981edfef8060aafcb25c4cf842...a60d85aa1ab5e88f2a3f2ebb6de9cab58eb7a898,3,113,9,122,13,2010-12-22 00:42:11,2010-12-22 00:42:11
a60d85aa1ab5e88f2a3f2ebb6de9cab58eb7a898...c1376c81a7f89094b67e252e61f9a47f728795af,1,1,0,1,1,2010-12-22 16:03:33,2010-12-22 16:03:33
c1376c81a7f89094b67e252e61f9a47f728795af...8301a8b9c25fcf086b6f8de878e2833ad357ea04,2,9,5,14,7,2010-12-23 00:02:03,2010-12-23 00:02:03
8301a8b9c25fcf086b6f8de878e2833ad357ea04...47fe010a8e28b08e0273c7b90c29a40e7baf5ed0,3,29,16,45,5,2010-12-23 03:01:06,2010-12-23 03:01:06
47fe010a8e28b08e0273c7b90c29a40e7baf5ed0...85207a245bf09fdebe486b4c7bbcb65300f2a693,4,44,4,48,10,2010-12-23 03:46:16,2010-12-23 03:46:16
85207a245bf09fdebe486b4c7bbcb65300f2a693...d5d8942a160685c403d381a279e72e09de5489a9,3,19,3,22,5,2010-12-23 03:46:37,2010-12-23 03:46:37
d5d8942a160685c403d381a279e72e09de5489a9...c30be9739d5b39295fc234d3aafcb2b53ab42577,1,1,1,2,1,2010-12-23 03:52:07,2010-12-23 03:52:07
c30be9739d5b39295fc234d3aafcb2b53ab42577...56007af3213a96889c10e56ab2ac1a7ef862410a,1,1,1,2,1,2010-12-23 04:12:24,2010-12-23 04:12:24
56007af3213a96889c10e56ab2ac1a7ef862410a...6c32577d31cdb26fa83c22bb3276e850447e196a,2,27,4,31,5,2010-12-23 15:32:59,2010-12-23 15:32:59
6c32577d31cdb26fa83c22bb3276e850447e196a...b168c1b1f9f1b4933bdad8fcfda1833775f68065,2,20,6,26,8,2010-12-23 21:39:34,2010-12-23 21:39:34
b168c1b1f9f1b4933bdad8fcfda1833775f68065...ba7a1518040cb10c803c73564049a6817f0130d8,1,1,1,2,1,2010-12-25 20:27:21,2010-12-25 20:27:21
ba7a1518040cb10c803c73564049a6817f0130d8...3003ddec1a6718dfaa4d5c7a2efcfe637c735a9d,1,1,1,2,1,2010-12-25 20:30:45,2010-12-25 20:30:45
3003ddec1a6718dfaa4d5c7a2efcfe637c735a9d...40f2bb37c9e3c5f11716f513a4739a88bc82ca34,1,9,0,9,2,2010-12-25 20:46:44,2010-12-25 20:46:44
40f2bb37c9e3c5f11716f513a4739a88bc82ca34...89cb543f9e4f823fe53140c3b597e2d4b6418562,42,32,374,406,151,2010-12-26 00:46:36,2010-12-26 00:46:36
89cb543f9e4f823fe53140c3b597e2d4b6418562...79e64d7cff1fd8e1283689406ea6ddde159ba8ef,5,180,343,523,16,2010-12-26 11:49:45,2010-12-26 11:49:45
79e64d7cff1fd8e1283689406ea6ddde159ba8ef...b1487c499b4dcf46a5316baf0cfb31bf9737d671,1,6,2,8,2,2010-12-26 21:51:51,2010-12-26 21:51:51
b1487c499b4dcf46a5316baf0cfb31bf9737d671...05588a1897dd5b008ce965361981d2860b29b75a,4,100,156,256,13,2010-12-27 07:47:25,2010-12-27 07:47:25
05588a1897dd5b008ce965361981d2860b29b75a...5ba7bac5e7b600a3ce002393f454db05604c691e,5,79,1,80,5,2010-12-27 13:28:04,2010-12-27 13:28:04
5ba7bac5e7b600a3ce002393f454db05604c691e...c0335a30bc116b6e94d836b22f35b08b5519bc53,1,21,0,21,1,2010-12-27 13:41:57,2010-12-27 13:41:57
c0335a30bc116b6e94d836b22f35b08b5519bc53...93e42272a4ade841e2d6de391f5973b7a28da85d,1,1,1,2,1,2010-12-27 23:30:19,2010-12-27 23:30:19
93e42272a4ade841e2d6de391f5973b7a28da85d...d5970df38e78958e732ee628ed8ced45f58f0b84,1,8,0,8,1,2010-12-27 23:47:14,2010-12-27 23:47:14
d5970df38e78958e732ee628ed8ced45f58f0b84...d514b1b23d3904cf614b85c0a77f014184740264,1,1,1,2,1,2010-12-27 23:58:41,2010-12-27 23:58:41
d514b1b23d3904cf614b85c0a77f014184740264...b0ce5fce733dc25ae209f53de408afb85f9d6201,1,13,1,14,2,2010-12-28 00:13:13,2010-12-28 00:13:13
b0ce5fce733dc25ae209f53de408afb85f9d6201...483cddf23eaece8980ec771f0c0b298f91979e31,1,8,0,8,1,2010-12-28 13:36:12,2010-12-28 13:36:12
483cddf23eaece8980ec771f0c0b298f91979e31...031eb9983e58eb144de7b8dbd0f186213e75de0c,1,19,2,21,6,2010-12-28 21:16:25,2010-12-28 21:16:25
031eb9983e58eb144de7b8dbd0f186213e75de0c...4c378026797ac39453f99c51cb05b22943cfecea,1,2,1,3,1,2010-12-28 21:56:33,2010-12-28 21:56:33
4c378026797ac39453f99c51cb05b22943cfecea...d4e19c68e8f9cb8bfff06b1c5c91017d473fcc96,1,28,12,40,6,2010-12-28 22:54:32,2010-12-28 22:54:32
d4e19c68e8f9cb8bfff06b1c5c91017d473fcc96...a3169e3e8e58715b222172f48d2d4211a71df578,1,11,4,15,1,2010-12-28 23:25:28,2010-12-28 23:25:28
a3169e3e8e58715b222172f48d2d4211a71df578...8db865c8fbf7242cbdfe5629fda66564762900ee,1,20,0,20,2,2010-12-29 00:04:06,2010-12-29 00:04:06
8db865c8fbf7242cbdfe5629fda66564762900ee...116804fbb5eb69080930e61961a4c7bffbc434e4,1,5,5,10,2,2010-12-29 00:09:46,2010-12-29 00:09:46
116804fbb5eb69080930e61961a4c7bffbc434e4...9bb995c6e0a2026c5efba9d98bdb3322d057570f,3,16,2,18,8,2010-12-29 01:26:45,2010-12-29 01:26:45
9bb995c6e0a2026c5efba9d98bdb3322d057570f...6510bb76c679a56485220c0510cf4c77b1f0880d,1,4,2,6,1,2010-12-29 13:47:58,2010-12-29 13:47:58
6510bb76c679a56485220c0510cf4c77b1f0880d...6ace3a931303565debb6a02702a7faede503964d,1,3,3,6,2,2010-12-29 13:59:51,2010-12-29 13:59:51
6ace3a931303565debb6a02702a7faede503964d...235f29fa374d5b1aa6eaa4aa48a30f40bfbe5957,1,8,0,8,1,2010-12-29 14:23:10,2010-12-29 14:23:10
235f29fa374d5b1aa6eaa4aa48a30f40bfbe5957...b5a7ac4fff1d3830a57012da42b0ba5d92fc9d48,1,33,0,33,1,2010-12-29 15:39:44,2010-12-29 15:39:44
b5a7ac4fff1d3830a57012da42b0ba5d92fc9d48...863240e336949f93fabfc11166a1386328a30af9,1,11,0,11,1,2010-12-29 15:48:50,2010-12-29 15:48:50
863240e336949f93fabfc11166a1386328a30af9...6c51b80c04358873b05dd87d36d33ddbf3b1447f,1,23,2,25,3,2010-12-29 20:21:28,2010-12-29 20:21:28
6c51b80c04358873b05dd87d36d33ddbf3b1447f...cd2cf8724326db425ce762925415ff4c90153830,1,118,117,235,57,2010-12-29 20:34:40,2010-12-29 20:34:40
cd2cf8724326db425ce762925415ff4c90153830...ae7f7a257fdf51b93103ff71ac86b17b67135029,1,1,1,2,1,2010-12-30 13:30:37,2010-12-30 13:30:37
ae7f7a257fdf51b93103ff71ac86b17b67135029...2d854539c327b3630265bec10263ae61ce81d202,1,2,2,4,1,2010-12-31 13:10:05,2010-12-31 13:10:05
2d854539c327b3630265bec10263ae61ce81d202...fa4ac6f80ca0417b04106626c854f09a6f15879d,1,3,2,5,2,2010-12-31 15:48:51,2010-12-31 15:48:51
fa4ac6f80ca0417b04106626c854f09a6f15879d...e501f502370b829d0bb2f1ed9c6e94bbfa5206f6,2,17,11,28,5,2010-12-31 23:06:07,2010-12-31 23:06:07
e501f502370b829d0bb2f1ed9c6e94bbfa5206f6...12d5c09fdde882a9d40ac7bee74b872e5e4471ec,7,12,12,24,12,2011-01-03 13:30:12,2011-01-03 13:30:12
12d5c09fdde882a9d40ac7bee74b872e5e4471ec...9f49666114fdee60abb68d19b2746db126d2c75c,1,1,1,2,1,2011-01-03 13:52:28,2011-01-03 13:52:28
9f49666114fdee60abb68d19b2746db126d2c75c...c76ab45fc650ac4fbcf2dba02231776d7b23f1e2,3,9,1,10,4,2011-01-03 14:01:44,2011-01-03 14:01:44
c76ab45fc650ac4fbcf2dba02231776d7b23f1e2...0b0e9457b2fedea68b10f6ef019d1d1a67f4863c,1,49,0,49,1,2011-01-03 14:27:51,2011-01-03 14:27:51
0b0e9457b2fedea68b10f6ef019d1d1a67f4863c...6849c5f3d5ed14743fa8f45fb4b2bba027ec9a62,1,2,1,3,1,2011-01-04 04:02:42,2011-01-04 04:02:42
6849c5f3d5ed14743fa8f45fb4b2bba027ec9a62...2b90267fa827439a29cb016b8548aec23f3b07c2,2,16,3,19,5,2011-01-08 13:40:23,2011-01-08 13:40:23
2b90267fa827439a29cb016b8548aec23f3b07c2...34d306c71c2c30d8543ab65934d351b86f3de008,1,15,0,15,2,2011-01-08 14:50:31,2011-01-08 14:50:31
34d306c71c2c30d8543ab65934d351b86f3de008...d065e7eed2b0fdf7d492a5fb8dfd3e62b58b92da,1,1,2,3,2,2011-01-08 14:56:02,2011-01-08 14:56:02
d065e7eed2b0fdf7d492a5fb8dfd3e62b58b92da...989486d05daae847e5b121d6bef5bb53b16cfe98,3,3,9,12,3,2011-01-08 15:14:24,2011-01-08 15:14:24
989486d05daae847e5b121d6bef5bb53b16cfe98...03ab30c3f10b5cf20698ae9ac7b56caa47a88552,1,7,1,8,3,2011-01-08 16:13:58,2011-01-08 16:13:58
03ab30c3f10b5cf20698ae9ac7b56caa47a88552...663eb9656a92492bb43a5a29efed9d907dc8f6ae,3,5,3,8,4,2011-01-10 13:45:36,2011-01-10 13:45:36
663eb9656a92492bb43a5a29efed9d907dc8f6ae...52999afaf5b6960837e64bf59d83cb856d1c6a3e,1,1,1,2,1,2011-01-11 00:30:24,2011-01-11 00:30:24
52999afaf5b6960837e64bf59d83cb856d1c6a3e...b28756bb29a4fec78896791ad12775a339ce3651,2,91,16,107,11,2011-01-11 01:03:08,2011-01-11 01:03:08
b28756bb29a4fec78896791ad12775a339ce3651...90be6ca20d607977dec234ec972b77b83955749b,3,38,3,41,5,2011-01-12 23:25:33,2011-01-12 23:25:33
90be6ca20d607977dec234ec972b77b83955749b...10ca44ba8daca7258747d5c6bf16e8763a4e6ca6,1,16,7,23,5,2011-01-12 23:54:17,2011-01-12 23:54:17
10ca44ba8daca7258747d5c6bf16e8763a4e6ca6...9846fee79400d7248009b07782601a7977df8542,1,5,5,10,3,2011-01-12 23:57:45,2011-01-12 23:57:45
9846fee79400d7248009b07782601a7977df8542...0e49b8b8bda03224cef3eca1fa5f609ad50b23ad,1,1,0,1,1,2011-01-12 23:59:49,2011-01-12 23:59:49
0e49b8b8bda03224cef3eca1fa5f609ad50b23ad...0a0472f51bad24870e2bb6b89595ac922897442e,6,120,6,126,11,2011-01-13 00:15:31,2011-01-13 00:15:31
0a0472f51bad24870e2bb6b89595ac922897442e...4d2708ff010a573d78759bf9ab9e672a57ad8726,2,16,1,17,2,2011-01-13 03:13:39,2011-01-13 03:13:39
4d2708ff010a573d78759bf9ab9e672a57ad8726...857b49d1c352af68b3175f5b09750f2d18dd9acb,2,56,3,59,4,2011-01-13 04:59:31,2011-01-13 04:59:31
857b49d1c352af68b3175f5b09750f2d18dd9acb...58038a8b2bba043f98da5ed03b800f29e854b4ac,4,56,0,56,6,2011-01-13 14:54:49,2011-01-13 14:54:49
58038a8b2bba043f98da5ed03b800f29e854b4ac...3297c09da4426b6dd2b7122d67a103536b26bce9,5,57,24,81,8,2011-01-13 15:47:36,2011-01-13 15:47:36
3297c09da4426b6dd2b7122d67a103536b26bce9...3ce473617cdb6fa12b7456fa07cdafef63e40e52,1,8,0,8,2,2011-01-13 16:24:19,2011-01-13 16:24:19
3ce473617cdb6fa12b7456fa07cdafef63e40e52...924bad822a8360d4376fb4d0523d71d0e2ccebb7,2,41,1,42,19,2011-01-13 16:43:18,2011-01-13 16:43:18
924bad822a8360d4376fb4d0523d71d0e2ccebb7...444bda0be0926b0a9c1bdd03a8adb3a24a4be43a,2,61,31,92,5,2011-01-13 23:10:13,2011-01-13 23:10:13
444bda0be0926b0a9c1bdd03a8adb3a24a4be43a...0ebb02e9dc2ea9906e2db36dc3f7d998231d462f,1,3,0,3,3,2011-01-13 23:25:23,2011-01-13 23:25:23
0ebb02e9dc2ea9906e2db36dc3f7d998231d462f...88dfbc50fb80187a0e226bbbee58e7cf0d03cbda,1,29,1,30,2,2011-01-14 03:53:01,2011-01-14 03:53:01
88dfbc50fb80187a0e226bbbee58e7cf0d03cbda...eb9ebb1931de3b41b7cfe9b48e1f7bfa506d3c4e,1,10,4,14,1,2011-01-14 23:19:50,2011-01-14 23:19:50
eb9ebb1931de3b41b7cfe9b48e1f7bfa506d3c4e...74a61e35b82c8823ec73da5eb23c97e6e1724f06,2,14,4,18,5,2011-01-14 23:30:17,2011-01-14 23:30:17
74a61e35b82c8823ec73da5eb23c97e6e1724f06...f7d04c37b91063a0c2091a366de0891c05569f9e,1,8,7,15,1,2011-01-15 06:06:09,2011-01-15 06:06:09
f7d04c37b91063a0c2091a366de0891c05569f9e...84db894f44c8bf551a14bcdf790234d71fd62d34,3,432,216,648,48,2011-01-15 06:06:34,2011-01-15 06:06:34
84db894f44c8bf551a14bcdf790234d71fd62d34...73b36117232923829d73dc9806c5a1f76ab10729,1,22,0,22,1,2011-01-16 06:45:35,2011-01-16 06:45:35
73b36117232923829d73dc9806c5a1f76ab10729...be12f9e2784d8d606fc856d80fadae4e9ca34117,2,27,4,31,5,2011-01-16 08:04:39,2011-01-16 08:04:39
be12f9e2784d8d606fc856d80fadae4e9ca34117...0866dc171582125bb9d81a640a70d907553e9d54,1,75,77,152,13,2011-01-16 19:27:23,2011-01-16 19:27:23
0866dc171582125bb9d81a640a70d907553e9d54...aeddab3fc7c92befa491a95f97eff2830ae96841,1,3,3,6,3,2011-01-17 02:40:16,2011-01-17 02:40:16
aeddab3fc7c92befa491a95f97eff2830ae96841...b9db129a7e1f7b50b2263685af934c9d1a35ee0f,1,1,1,2,1,2011-01-17 13:16:07,2011-01-17 13:16:07
b9db129a7e1f7b50b2263685af934c9d1a35ee0f...b305cc33c5827ac8daecbf7395fbccb196f92d47,1,4,2,6,1,2011-01-18 00:00:11,2011-01-18 00:00:11
b305cc33c5827ac8daecbf7395fbccb196f92d47...86239cbb56cbc804c8c2961083476012a2da5cee,1,5,0,5,1,2011-01-18 16:54:28,2011-01-18 16:54:28
86239cbb56cbc804c8c2961083476012a2da5cee...0958f32209d680ae8002852b62c560e04bc09118,7,83,5,88,8,2011-01-18 16:55:00,2011-01-18 16:55:00
0958f32209d680ae8002852b62c560e04bc09118...cf7157a7a4d0ecab2e9679d3d6eabf4a02aea65d,4,23,8,31,8,2011-01-20 23:17:37,2011-01-20 23:17:37
cf7157a7a4d0ecab2e9679d3d6eabf4a02aea65d...715c00df76dc0caa7e70be5c7b5c85a4f35dc8a9,1,3,2,5,2,2011-01-21 01:37:08,2011-01-21 01:37:08
715c00df76dc0caa7e70be5c7b5c85a4f35dc8a9...80264702d0501a9817d6b11eebd5912c27824348,1,15,1,16,1,2011-01-21 02:15:13,2011-01-21 02:15:13
80264702d0501a9817d6b11eebd5912c27824348...ccd68f2d43c2f92e026610a9d36de3735b82b599,1,5,14,19,2,2011-01-22 16:21:25,2011-01-22 16:21:25
ccd68f2d43c2f92e026610a9d36de3735b82b599...a9cf3d23724ff6918103e86aa863eadd1fab811d,3,27,3,30,3,2011-01-24 07:10:18,2011-01-24 07:10:18
a9cf3d23724ff6918103e86aa863eadd1fab811d...dec539f36017fecbd749a268e4aea4b2598a3997,2,17,5,22,5,2011-01-24 08:04:14,2011-01-24 08:04:14
dec539f36017fecbd749a268e4aea4b2598a3997...a116ae663357f048277250210e7aa0585af733f0,3,29,5,34,5,2011-01-24 08:33:51,2011-01-24 08:33:51
a116ae663357f048277250210e7aa0585af733f0...63536a8ee5396340a0e6cdce439c1ca150bd9c1f,108,318,318,636,171,2011-01-24 09:49:28,2011-01-24 09:49:28
63536a8ee5396340a0e6cdce439c1ca150bd9c1f...5f923671e5e1b5ddce3c19cd195e236df8b7fd88,1,42,1,43,4,2011-01-24 21:48:27,2011-01-24 21:48:27
5f923671e5e1b5ddce3c19cd195e236df8b7fd88...f01e1cd42561263eb9f1130ebcb39ffa6eecbe63,4,30,4,34,7,2011-01-25 00:42:54,2011-01-25 00:42:54
f01e1cd42561263eb9f1130ebcb39ffa6eecbe63...131d83b9cdd6d287aa04345c78993c66c0300422,6,104,13,117,9,2011-01-25 03:39:38,2011-01-25 03:39:38
131d83b9cdd6d287aa04345c78993c66c0300422...c09249731b0e66bfee72e978e0274d698bfad091,3,44,5,49,4,2011-01-25 05:06:43,2011-01-25 05:06:43
c09249731b0e66bfee72e978e0274d698bfad091...7d0d10ce204118f32ef50d778fa975fb18314ece,3,43,2,45,4,2011-01-25 15:44:41,2011-01-25 15:44:41
7d0d10ce204118f32ef50d778fa975fb18314ece...1418c215f4b6d30e58626bcb028201b016494cb0,1,1,1,2,1,2011-01-26 00:37:55,2011-01-26 00:37:55
1418c215f4b6d30e58626bcb028201b016494cb0...4cee764a4621c210bd1ddbc2b4b7d29c09ce8de5,2,13,1,14,2,2011-01-26 03:52:41,2011-01-26 03:52:41
4cee764a4621c210bd1ddbc2b4b7d29c09ce8de5...c4b0878b4389f466d90ac458872df7ba28706023,3,14,2,16,5,2011-01-26 03:52:52,2011-01-26 03:52:52
c4b0878b4389f466d90ac458872df7ba28706023...3af1bf8217653f4e5ed337957607835e3f146039,3,22,19,41,5,2011-01-26 08:04:19,2011-01-26 08:04:19
3af1bf8217653f4e5ed337957607835e3f146039...167d1cbdf5aa6f62d7ce6282fc73db3b5b6c7a76,1,5,4,9,1,2011-01-26 14:55:27,2011-01-26 14:55:27
167d1cbdf5aa6f62d7ce6282fc73db3b5b6c7a76...5b8c59305382e1453c8d73aa2282225964c78248,2,135,3,138,4,2011-01-26 15:44:11,2011-01-26 15:44:11
5b8c59305382e1453c8d73aa2282225964c78248...10b4d93f50f1c2e90387edea5738b2439987ca33,5,62,5,67,9,2011-01-26 19:27:46,2011-01-26 19:27:46
10b4d93f50f1c2e90387edea5738b2439987ca33...ee29ec62be475e9719785917758e059b9bca124b,1,3,0,3,1,2011-01-27 02:42:45,2011-01-27 02:42:45
ee29ec62be475e9719785917758e059b9bca124b...81f844afb1035c664b20cbee784e4ac1233dbd43,1,31,29,60,6,2011-01-27 02:43:06,2011-01-27 02:43:06
81f844afb1035c664b20cbee784e4ac1233dbd43...407208b0c2b237f8ba7b1bd9d209b1053e6c77c4,2,56,0,56,5,2011-01-27 02:43:30,2011-01-27 02:43:30
407208b0c2b237f8ba7b1bd9d209b1053e6c77c4...d073d30e45c1bfbd05bacf9dfb361bf7589983bf,1,4,2,6,2,2011-01-27 03:52:14,2011-01-27 03:52:14
d073d30e45c1bfbd05bacf9dfb361bf7589983bf...8ab768f93501970ca2def2fda6a0a3893aabfb7d,2,82,58,140,16,2011-01-27 03:52:44,2011-01-27 03:52:44
8ab768f93501970ca2def2fda6a0a3893aabfb7d...276ecc72097b45b5115a7d6657332d5a37ca5435,7,78,21,99,17,2011-01-28 14:59:54,2011-01-28 14:59:54
276ecc72097b45b5115a7d6657332d5a37ca5435...b3ad41bfd51562e5d18350b18650ad4638ed0869,3,51,4,55,10,2011-01-28 15:36:41,2011-01-28 15:36:41
b3ad41bfd51562e5d18350b18650ad4638ed0869...a138e3be0e7a72ec7ae6cf89ab40ed0b75b6ff42,1,11,0,11,1,2011-01-28 15:48:35,2011-01-28 15:48:35
a138e3be0e7a72ec7ae6cf89ab40ed0b75b6ff42...86b0d5c1eb8162dca097555947d18664f4ae3ebc,1,3,4,7,2,2011-01-29 08:11:28,2011-01-29 08:11:28
86b0d5c1eb8162dca097555947d18664f4ae3ebc...a289eba59c72c8abab9722b2038ff74c366d0f04,1,4,2,6,3,2011-01-29 15:06:37,2011-01-29 15:06:37
a289eba59c72c8abab9722b2038ff74c366d0f04...7e83c3b91f46458c6b2243b21ac144499bec47cf,2,9,2,11,2,2011-01-30 13:20:00,2011-01-30 13:20:00
7e83c3b91f46458c6b2243b21ac144499bec47cf...afb8c44cdec8ac5106cf7242eeba2af87bccf72f,1,1,1,2,1,2011-01-30 13:20:14,2011-01-30 13:20:14
afb8c44cdec8ac5106cf7242eeba2af87bccf72f...d88753066d7d2c74ac0790cbd62eeeff417bf04a,1,0,1,1,1,2011-01-30 13:35:40,2011-01-30 13:35:40
d88753066d7d2c74ac0790cbd62eeeff417bf04a...776bf6e5f7d83d3a9cd41f74277106365280f574,1,1,1,2,1,2011-01-30 19:10:16,2011-01-30 19:10:16
776bf6e5f7d83d3a9cd41f74277106365280f574...432ff76035efafba73a81bab5b0c12482acdb1fe,1,9,13,22,3,2011-01-31 20:12:23,2011-01-31 20:12:23
432ff76035efafba73a81bab5b0c12482acdb1fe...cda07b4cfaf92fe82f58d3d6ca6e64ea40502b0d,5,57,11,68,12,2011-02-01 00:31:34,2011-02-01 00:31:34
cda07b4cfaf92fe82f58d3d6ca6e64ea40502b0d...e26de119f4dad4ec8bf2f8f24c1b6dd239eab04f,1,11,3,14,3,2011-02-02 04:41:47,2011-02-02 04:41:47
e26de119f4dad4ec8bf2f8f24c1b6dd239eab04f...837a2e2773125fcda0c419597b2c19a3d05b4879,1,1,1,2,1,2011-02-02 15:25:57,2011-02-02 15:25:57
837a2e2773125fcda0c419597b2c19a3d05b4879...0b8b9fbe306acd1ae310fe292fabec493f329a05,4,52,30,82,15,2011-02-02 15:33:37,2011-02-02 15:33:37
0b8b9fbe306acd1ae310fe292fabec493f329a05...01fce67c1731aa21acae6925e355ff84d32fb41b,1,4,4,8,4,2011-02-02 20:40:24,2011-02-02 20:40:24
01fce67c1731aa21acae6925e355ff84d32fb41b...f6606da3e835bf365550862833408d3733bb4d97,1,19,0,19,1,2011-02-02 20:57:33,2011-02-02 20:57:33
f6606da3e835bf365550862833408d3733bb4d97...5f2f0113db4489de4b2260bf3365b514418ad0b8,2,17,3,20,4,2011-02-03 15:54:27,2011-02-03 15:54:27
5f2f0113db4489de4b2260bf3365b514418ad0b8...bb46b44ec9b81c14d71f078537863b2a6bf18d32,3,51,18,69,10,2011-02-04 13:53:44,2011-02-04 13:53:44
bb46b44ec9b81c14d71f078537863b2a6bf18d32...46b1fdaba00a208914c5aa7790f02ed577e57f7c,1,3,0,3,2,2011-02-04 14:35:39,2011-02-04 14:35:39
46b1fdaba00a208914c5aa7790f02ed577e57f7c...6ba0f324e4fe787f065f79524c481063617377eb,3,29,2,31,4,2011-02-04 14:43:59,2011-02-04 14:43:59
6ba0f324e4fe787f065f79524c481063617377eb...05232a2604725400358c012fa17ac705c875a9f4,2,15,20,35,5,2011-02-04 16:17:45,2011-02-04 16:17:45
05232a2604725400358c012fa17ac705c875a9f4...2d0252ef417635ce2318a9015bafa916fd850ed6,5,47,20,67,22,2011-02-04 17:21:10,2011-02-04 17:21:10
2d0252ef417635ce2318a9015bafa916fd850ed6...693506609d06c171fb1673792c1cb34cb19353f8,2,16,8,24,8,2011-02-05 00:15:18,2011-02-05 00:15:18
693506609d06c171fb1673792c1cb34cb19353f8...6987048561a6bd77315d5aeb5025c8edcb9a2658,3,32,24,56,13,2011-02-05 03:56:23,2011-02-05 03:56:23
6987048561a6bd77315d5aeb5025c8edcb9a2658...4a3a97e5310339fafacaa308d7ac20c214c9d821,2,8,7,15,4,2011-02-05 04:12:33,2011-02-05 04:12:33
4a3a97e5310339fafacaa308d7ac20c214c9d821...0e4d8d47b0cc8f1d1930ec1b59204313f42412e7,3,9,8,17,6,2011-02-05 04:46:55,2011-02-05 04:46:55
0e4d8d47b0cc8f1d1930ec1b59204313f42412e7...ebd0a6a09ff95d42b0feec82d8509ffa009eb05b,2,28,2,30,4,2011-02-05 06:34:04,2011-02-05 06:34:04
ebd0a6a09ff95d42b0feec82d8509ffa009eb05b...7be9e52041c56a230712c3fc1b49e227ec4a6d38,2,41,12,53,9,2011-02-05 18:38:06,2011-02-05 18:38:06
7be9e52041c56a230712c3fc1b49e227ec4a6d38...3f3a9ae699a1fa663c0fff96e9f432a2ee05f5d1,1,2,2,4,2,2011-02-05 19:05:30,2011-02-05 19:05:30
3f3a9ae699a1fa663c0fff96e9f432a2ee05f5d1...cd2a1a0b3296c0baf35c08bc24172dd55d232cc1,1,2,2,4,2,2011-02-05 19:22:09,2011-02-05 19:22:09
cd2a1a0b3296c0baf35c08bc24172dd55d232cc1...5f0ed3e1987de5abe654f8b90b6179381eb94195,2,14,6,20,2,2011-02-06 06:22:07,2011-02-06 06:22:07
5f0ed3e1987de5abe654f8b90b6179381eb94195...1406265e17d9e64cbe82951223689d07af43fc42,1,9,3,12,4,2011-02-07 19:50:07,2011-02-07 19:50:07
1406265e17d9e64cbe82951223689d07af43fc42...40a13657e3f8d526fcab02e2a963898e89854614,1,10,1,11,2,2011-02-07 22:54:14,2011-02-07 22:54:14
40a13657e3f8d526fcab02e2a963898e89854614...e1ad54307f35f6212019bd00264ac56a323f6ea5,2,2,1,3,2,2011-02-08 12:22:44,2011-02-08 12:22:44
e1ad54307f35f6212019bd00264ac56a323f6ea5...09a820550b0d4bff9fc4fd641a1d6707b3cc0c85,2,130,1,131,4,2011-02-08 12:23:03,2011-02-08 12:23:03
09a820550b0d4bff9fc4fd641a1d6707b3cc0c85...27e7fcbab015452cb4201f32eb2682bd8dc23feb,4,42,3,45,6,2011-02-08 12:23:23,2011-02-08 12:23:23
27e7fcbab015452cb4201f32eb2682bd8dc23feb...bbfdb36b5485adc84adf7c6090cbd0ea9789d02b,1,1,0,1,1,2011-02-08 14:06:59,2011-02-08 14:06:59
bbfdb36b5485adc84adf7c6090cbd0ea9789d02b...5e485a15ad07b492e648fe784ddd136d36ffcac4,2,19,0,19,2,2011-02-08 14:07:14,2011-02-08 14:07:14
5e485a15ad07b492e648fe784ddd136d36ffcac4...c058dfa9cdd75cf23ab24985d4aeb257da8f267f,1,1,16,17,2,2011-02-09 00:11:09,2011-02-09 00:11:09
c058dfa9cdd75cf23ab24985d4aeb257da8f267f...fdd3bd9d15e8a25e2660236a53c4f587b4afffa4,1,1,0,1,1,2011-02-09 00:11:57,2011-02-09 00:11:57
fdd3bd9d15e8a25e2660236a53c4f587b4afffa4...818e70344e7193f6ebc73c82ed574e6ce3c91afc,3,50,51,101,9,2011-02-09 02:07:05,2011-02-09 02:07:05
818e70344e7193f6ebc73c82ed574e6ce3c91afc...194566480b15cf4e294d3f03ff587019b74044b2,2,15,2,17,4,2011-02-09 02:13:59,2011-02-09 02:13:59
194566480b15cf4e294d3f03ff587019b74044b2...1f814a9547842dcfabdae09573055984af9d3fab,2,17,1,18,2,2011-02-09 02:44:16,2011-02-09 02:44:16
1f814a9547842dcfabdae09573055984af9d3fab...66dc41aa052e73034615db3584d8acfc9e4f9916,2,2,2,4,2,2011-02-09 03:05:58,2011-02-09 03:05:58
66dc41aa052e73034615db3584d8acfc9e4f9916...e62e740732beed767da10312714ae380d6dc92b1,1,60,1,61,2,2011-02-09 13:00:25,2011-02-09 13:00:25
e62e740732beed767da10312714ae380d6dc92b1...5c4acfec0e39f91328f4d5637b4c312e7366b3cb,3,100,7,107,6,2011-02-10 09:29:38,2011-02-10 09:29:38
5c4acfec0e39f91328f4d5637b4c312e7366b3cb...b17f47cac759a6cc7fdeff35d33d925f886c72d4,5,91,6,97,7,2011-02-10 11:56:36,2011-02-10 11:56:36
b17f47cac759a6cc7fdeff35d33d925f886c72d4...54987dd0d1da49d2d149cc236153691c5d2996b0,1,2,0,2,1,2011-02-11 18:24:24,2011-02-11 18:24:24
54987dd0d1da49d2d149cc236153691c5d2996b0...f8ff9fee2bfa88f70b388e99e79fca2103f6c1db,1,1,1,2,1,2011-02-12 13:24:42,2011-02-12 13:24:42
f8ff9fee2bfa88f70b388e99e79fca2103f6c1db...c775f95abbc69087006a5f171b07009e140c0623,1,2,2,4,2,2011-02-12 13:25:16,2011-02-12 13:25:16
c775f95abbc69087006a5f171b07009e140c0623...48fe6099c06cc84d666d4032d746c53be43ee196,3,45,2,47,5,2011-02-12 15:15:44,2011-02-12 15:15:44
48fe6099c06cc84d666d4032d746c53be43ee196...90ee3af279bb5b5c35d3fe22c5d6e07449ce65fc,2,28,9,37,4,2011-02-12 19:24:17,2011-02-12 19:24:17
90ee3af279bb5b5c35d3fe22c5d6e07449ce65fc...89c03dcbf3dfc789ed258e697ac87de3bcc2133c,2,7,2,9,5,2011-02-12 19:24:25,2011-02-12 19:24:25
89c03dcbf3dfc789ed258e697ac87de3bcc2133c...748110cb94352fc0a796dec0d559f4c6a5a797c2,2,3,1,4,2,2011-02-12 19:24:34,2011-02-12 19:24:34
748110cb94352fc0a796dec0d559f4c6a5a797c2...6a438e2d1ab9bfdb2b4ae4cff121f812dd5fd241,3,11,3,14,4,2011-02-12 19:24:42,2011-02-12 19:24:42
6a438e2d1ab9bfdb2b4ae4cff121f812dd5fd241...cfaac48710fdab7cd427b8bea130a8a8c3f8bbbc,1,17,19,36,4,2011-02-12 23:39:39,2011-02-12 23:39:39
cfaac48710fdab7cd427b8bea130a8a8c3f8bbbc...4bcc5012b1642f01efc96f467a549943e3647cf5,2,81,45,126,19,2011-02-13 01:54:31,2011-02-13 01:54:31
4bcc5012b1642f01efc96f467a549943e3647cf5...af03867f008fee71112e49ef92e3209eefd2a8ae,2,29,2,31,4,2011-02-13 02:37:52,2011-02-13 02:37:52
af03867f008fee71112e49ef92e3209eefd2a8ae...7cfb2b6335de1092b3dbe703ccc735488fefa7ea,1,4,4,8,3,2011-02-13 03:15:34,2011-02-13 03:15:34
7cfb2b6335de1092b3dbe703ccc735488fefa7ea...7520dbd5a5d3856fbe193101d08f93ccab022d34,3,4,4,8,3,2011-02-14 15:04:26,2011-02-14 15:04:26
7520dbd5a5d3856fbe193101d08f93ccab022d34...fe21117cc3d5349aff6a1bb57ac768ef05967577,6,24,23,47,21,2011-02-14 23:25:46,2011-02-14 23:25:46
fe21117cc3d5349aff6a1bb57ac768ef05967577...551da285db768364e9111e6ad0ec368b63bb8377,1,13,2,15,3,2011-02-15 20:42:57,2011-02-15 20:42:57
551da285db768364e9111e6ad0ec368b63bb8377...ddc9cefc217f0cd0a2c3a6d6704bdc68a663ad92,1,1,1,2,1,2011-02-15 21:51:27,2011-02-15 21:51:27
ddc9cefc217f0cd0a2c3a6d6704bdc68a663ad92...95a6d5a2ef68375a47d95f35e726751ec7d10201,1,26,9,35,2,2011-02-16 00:21:27,2011-02-16 00:21:27
95a6d5a2ef68375a47d95f35e726751ec7d10201...dbe7010d4750ad7f22e6f0e6d83e979b08163021,1,57,54,111,42,2011-02-16 00:26:17,2011-02-16 00:26:17
dbe7010d4750ad7f22e6f0e6d83e979b08163021...9ec9d2efd134cd2fe64c33cf44af00780841edeb,1,39,15,54,8,2011-02-17 04:15:14,2011-02-17 04:15:14
9ec9d2efd134cd2fe64c33cf44af00780841edeb...aae16079efbb03da3dc0b66c3e62ce022d293e63,4,42,14,56,13,2011-02-17 05:01:42,2011-02-17 05:01:42
aae16079efbb03da3dc0b66c3e62ce022d293e63...b9fc7809f5a2085ea1dc3c4096ed65ff340ef252,1,1,1,2,1,2011-02-19 02:49:04,2011-02-19 02:49:04
b9fc7809f5a2085ea1dc3c4096ed65ff340ef252...19fa3bcebc979f20ed00f1aa1d09ff2ebf7e0473,1,0,2,2,1,2011-02-19 08:14:28,2011-02-19 08:14:28
19fa3bcebc979f20ed00f1aa1d09ff2ebf7e0473...10a12cd6f261f4804850710be9bcdb24026d7fd2,1,6,5,11,1,2011-02-19 08:14:44,2011-02-19 08:14:44
10a12cd6f261f4804850710be9bcdb24026d7fd2...c94804b14f8b90f6c1dae725b5f5db84ae961901,1,2,2,4,2,2011-02-19 08:15:01,2011-02-19 08:15:01
c94804b14f8b90f6c1dae725b5f5db84ae961901...efc4c62691134bdea50195b7b60f41c5639de738,3,8,3,11,4,2011-02-19 08:15:20,2011-02-19 08:15:20
efc4c62691134bdea50195b7b60f41c5639de738...c9949103df95b34209e5187b27e92e5f9fd0aa32,1,38,0,38,3,2011-02-19 08:38:53,2011-02-19 08:38:53
c9949103df95b34209e5187b27e92e5f9fd0aa32...da4dea5834682e16e446f2a1c671c1989fb42404,4,100,9,109,7,2011-02-19 11:52:33,2011-02-19 11:52:33
da4dea5834682e16e446f2a1c671c1989fb42404...909ee62563f5c9ff7f507028f19ee291a134ea30,5,21,6,27,6,2011-02-19 12:56:25,2011-02-19 12:56:25
909ee62563f5c9ff7f507028f19ee291a134ea30...3202d2abbc845cf69ba16a14002656b608aa24c4,1,1,1,2,1,2011-02-19 14:22:57,2011-02-19 14:22:57
3202d2abbc845cf69ba16a14002656b608aa24c4...626ad2c9ab9e02db8e3f19bd51654d749e84af02,3,52,2,54,5,2011-02-19 14:30:23,2011-02-19 14:30:23
626ad2c9ab9e02db8e3f19bd51654d749e84af02...69a3bb5d473c864124e57541e9dde8496da3ac15,2,23,3,26,4,2011-02-19 14:47:33,2011-02-19 14:47:33
69a3bb5d473c864124e57541e9dde8496da3ac15...2377f109bca866821fe7556c3da19dbe0178e291,3,35,5,40,3,2011-02-20 05:56:45,2011-02-20 05:56:45
2377f109bca866821fe7556c3da19dbe0178e291...6ef2b4c2daa48e2644be6167f07b6f996914518b,2,13,4,17,5,2011-02-20 13:44:37,2011-02-20 13:44:37
6ef2b4c2daa48e2644be6167f07b6f996914518b...d65ca449ace1f8e4bd3064c40343a3c5ea2a7ce0,1,29,7,36,4,2011-02-20 15:27:01,2011-02-20 15:27:01
d65ca449ace1f8e4bd3064c40343a3c5ea2a7ce0...1d1f3632c636b24c1ade41a61b5e6792a0987ec7,3,76,5,81,9,2011-02-20 23:19:21,2011-02-20 23:19:21
1d1f3632c636b24c1ade41a61b5e6792a0987ec7...3db9383dafdbeb6d50027c1ff5dda14babd23420,1,2,2,4,2,2011-02-21 00:08:07,2011-02-21 00:08:07
3db9383dafdbeb6d50027c1ff5dda14babd23420...39b8a1f7ed49de3a1a32bd842de6e2b92a4bb8b6,2,31,2,33,9,2011-02-21 10:13:11,2011-02-21 10:13:11
39b8a1f7ed49de3a1a32bd842de6e2b92a4bb8b6...e636db10662e64ddc4156c3a3c8a40d4fe71a7a7,1,1,0,1,1,2011-02-21 12:40:55,2011-02-21 12:40:55
e636db10662e64ddc4156c3a3c8a40d4fe71a7a7...bf4507f255f7fb2e162fbe5b228ef3f380f223ed,1,4,0,4,4,2011-02-21 14:06:12,2011-02-21 14:06:12
bf4507f255f7fb2e162fbe5b228ef3f380f223ed...fee8a498660374cfe9e710bd96d6f84fa64c1a2d,2,11,1,12,2,2011-02-21 14:06:28,2011-02-21 14:06:28
fee8a498660374cfe9e710bd96d6f84fa64c1a2d...4df0e5ff8468916497ce9f4baad769787bff419a,3,24,2,26,6,2011-02-21 14:08:06,2011-02-21 14:08:06
4df0e5ff8468916497ce9f4baad769787bff419a...c326ec48d834eb8128ac20a37cb647fdfa769ae6,2,130,14,144,6,2011-02-21 14:32:12,2011-02-21 14:32:12
c326ec48d834eb8128ac20a37cb647fdfa769ae6...e63db6597c89526ce90f83e3327c44c83f095eae,2,52,4,56,4,2011-02-21 16:14:04,2011-02-21 16:14:04
e63db6597c89526ce90f83e3327c44c83f095eae...5baa06ecfef0e3cfa5ce8bc04b66f63404ca571d,1,1,1,2,1,2011-02-21 18:44:42,2011-02-21 18:44:42
5baa06ecfef0e3cfa5ce8bc04b66f63404ca571d...58c4aca37090c741e8188b47750ceafdcd2b74b5,1,2,4,6,2,2011-02-21 18:45:46,2011-02-21 18:45:46
58c4aca37090c741e8188b47750ceafdcd2b74b5...25c217bc170d275a2db65fd9c9faa064797d4b2f,1,623,601,1224,230,2011-02-21 21:04:25,2011-02-21 21:04:25
25c217bc170d275a2db65fd9c9faa064797d4b2f...31d0f2fa29b766d4e739e8ad650b43435b48dfbf,4,24,10,34,12,2011-02-21 21:20:41,2011-02-21 21:20:41
31d0f2fa29b766d4e739e8ad650b43435b48dfbf...a6114e1a1442e9d87c3fdb073a34b75092794d21,1,1,1,2,1,2011-02-21 22:56:01,2011-02-21 22:56:01
a6114e1a1442e9d87c3fdb073a34b75092794d21...53663be5024285226cfe5afa1171ba1d49508089,1,5,2,7,1,2011-02-22 00:58:38,2011-02-22 00:58:38
53663be5024285226cfe5afa1171ba1d49508089...dc9d639c0aeb0e3c239d9a20f7aa51e7a3d5261b,4,63,4,67,8,2011-02-22 03:25:55,2011-02-22 03:25:55
dc9d639c0aeb0e3c239d9a20f7aa51e7a3d5261b...e89c471ebb5ae2b55b3677a953759792fce84bc8,3,10,42,52,3,2011-02-22 11:30:10,2011-02-22 11:30:10
e89c471ebb5ae2b55b3677a953759792fce84bc8...8ed8b249efa54d379f018b4ed906980c9865f0c1,2,8,4,12,4,2011-02-22 11:35:25,2011-02-22 11:35:25
8ed8b249efa54d379f018b4ed906980c9865f0c1...f87936fa892fe68114d81b7c77e29f38abb2f18a,1,2,2,4,1,2011-02-23 09:44:40,2011-02-23 09:44:40
f87936fa892fe68114d81b7c77e29f38abb2f18a...fa1a74ff3c7069c6e442b31c0c3842a24a01fc8a,2,18,3,21,4,2011-02-24 01:09:23,2011-02-24 01:09:23
fa1a74ff3c7069c6e442b31c0c3842a24a01fc8a...062cbfb1ecbc21156c66196e55893481936dec84,2,23,2,25,5,2011-02-24 13:38:32,2011-02-24 13:38:32
062cbfb1ecbc21156c66196e55893481936dec84...5b342d7c30339958e38a4c90b9769d6a3280ecdd,2,4,4,8,4,2011-02-25 01:07:49,2011-02-25 01:07:49
5b342d7c30339958e38a4c90b9769d6a3280ecdd...97e81089a2562adb88d41bb162623d84c16be8e0,2,3,1,4,3,2011-02-25 01:08:04,2011-02-25 01:08:04
97e81089a2562adb88d41bb162623d84c16be8e0...69af5573c39b10e287ba3a341b1e194c9a0c344e,3,355,58,413,27,2011-02-25 02:51:16,2011-02-25 02:51:16
69af5573c39b10e287ba3a341b1e194c9a0c344e...9a5ebbcac9480c265e8f736ec3bceb2e8a3546b9,1,16,9,25,4,2011-02-25 09:45:54,2011-02-25 09:45:54
9a5ebbcac9480c265e8f736ec3bceb2e8a3546b9...049b3ff8a25a3907e7791091cb6a87910cff95df,7,99,20,119,14,2011-02-26 02:00:18,2011-02-26 02:00:18
049b3ff8a25a3907e7791091cb6a87910cff95df...3a3102378312e2eaf4d220e46984b705bae0877b,2,5,3,8,3,2011-02-26 12:49:00,2011-02-26 12:49:00
3a3102378312e2eaf4d220e46984b705bae0877b...120d01c20b3c2deada995e671f3f918aa1d808ce,2,11,3,14,3,2011-02-26 12:49:15,2011-02-26 12:49:15
120d01c20b3c2deada995e671f3f918aa1d808ce...e2339178320778bf0d9300e22f968b2f61cad3b0,5,28,13,41,11,2011-02-27 00:28:53,2011-02-27 00:28:53
e2339178320778bf0d9300e22f968b2f61cad3b0...a90e297f58c29aa243c3f83bd045cb663667857d,1,2,1,3,1,2011-02-27 21:18:16,2011-02-27 21:18:16
a90e297f58c29aa243c3f83bd045cb663667857d...f1dd46b63dc4bc6f87baa0036015e784bc290254,2,65,6,71,11,2011-02-27 22:14:17,2011-02-27 22:14:17
f1dd46b63dc4bc6f87baa0036015e784bc290254...076ce17f0e7155cb7a0c8d6b863dbc430098187c,1,321,321,642,1,2011-02-27 23:34:14,2011-02-27 23:34:14
076ce17f0e7155cb7a0c8d6b863dbc430098187c...f5c0328fd3f5a965bace09f7aef0ada67751fad5,2,41,4,45,7,2011-02-28 02:56:02,2011-02-28 02:56:02
f5c0328fd3f5a965bace09f7aef0ada67751fad5...32ac8d913e4074da99fe4588c1d0f959f500cd4a,1,20,7,27,10,2011-02-28 05:26:48,2011-02-28 05:26:48
32ac8d913e4074da99fe4588c1d0f959f500cd4a...a5f71e12643043da9bfdb554e0774c242f0f18b9,1,7,0,7,1,2011-02-28 05:40:55,2011-02-28 05:40:55
a5f71e12643043da9bfdb554e0774c242f0f18b9...b5b5d3c2800dae65cbd5466212844a422f7c95d8,1,4,1,5,1,2011-02-28 14:09:58,2011-02-28 14:09:58
b5b5d3c2800dae65cbd5466212844a422f7c95d8...8d3ee2984796336285961a8f9a00e1ceb77f2dd4,1,3,6,9,1,2011-03-01 03:07:25,2011-03-01 03:07:25
8d3ee2984796336285961a8f9a00e1ceb77f2dd4...58bd2492839f2b1c7463aee34edbd2b009910e7d,7,196,26,222,26,2011-03-01 14:34:03,2011-03-01 14:34:03
58bd2492839f2b1c7463aee34edbd2b009910e7d...29fccc353cb43c389801b3a1552a318714a56bd6,1,6,0,6,1,2011-03-01 18:55:39,2011-03-01 18:55:39
29fccc353cb43c389801b3a1552a318714a56bd6...7207481aa8d19abf4dc9acee2c9583fe59f09e8e,2,83,25,108,10,2011-03-02 12:59:26,2011-03-02 12:59:26
7207481aa8d19abf4dc9acee2c9583fe59f09e8e...b34a08e07019eca965d48a15caebcc9cc90b0edc,2,4,1,5,2,2011-03-02 21:37:29,2011-03-02 21:37:29
b34a08e07019eca965d48a15caebcc9cc90b0edc...84f398e77c0916a44197a1ae767dbd8e62532052,1,1,1,2,1,2011-03-02 21:47:55,2011-03-02 21:47:55
84f398e77c0916a44197a1ae767dbd8e62532052...76f5b4eb5c9d91de00b823af797aafb1664e41a0,1,1,1,2,1,2011-03-03 00:37:56,2011-03-03 00:37:56
76f5b4eb5c9d91de00b823af797aafb1664e41a0...4c76896eada07f25d143e0d78989240f5ad8e020,1,2,2,4,2,2011-03-03 00:38:08,2011-03-03 00:38:08
4c76896eada07f25d143e0d78989240f5ad8e020...ac87e4f8fa5f7242a5dc274436891a50a8a60904,3,38,2,40,5,2011-03-03 00:42:56,2011-03-03 00:42:56
ac87e4f8fa5f7242a5dc274436891a50a8a60904...1985ca77eabf78d0c7a624825cde8fb4fa7752d1,2,32,1,33,3,2011-03-03 13:04:51,2011-03-03 13:04:51
1985ca77eabf78d0c7a624825cde8fb4fa7752d1...0516b9987576a475e9767517f13d8f423f6aab4c,4,60,3,63,6,2011-03-03 13:47:39,2011-03-03 13:47:39
0516b9987576a475e9767517f13d8f423f6aab4c...a97396948bdc68561a46229f8440b68a2ab79960,1,2,3,5,3,2011-03-03 13:47:46,2011-03-03 13:47:46
a97396948bdc68561a46229f8440b68a2ab79960...113a8c1f1c8de50b3192c3adbefd26b0067b1750,3,98,6,104,6,2011-03-03 13:53:12,2011-03-03 13:53:12
113a8c1f1c8de50b3192c3adbefd26b0067b1750...ef53365a7d268ee53e3fdb8847f417d27c1fb5dc,1,2,5,7,2,2011-03-03 18:27:08,2011-03-03 18:27:08
ef53365a7d268ee53e3fdb8847f417d27c1fb5dc...1091a8e73e7ed026a698f57799aee1c4f7bfdbf7,1,4,1,5,1,2011-03-03 18:45:07,2011-03-03 18:45:07
1091a8e73e7ed026a698f57799aee1c4f7bfdbf7...de46b6687f3ed9b35def38df5f4f74a304f3112c,4,26,6,32,8,2011-03-03 19:32:55,2011-03-03 19:32:55
de46b6687f3ed9b35def38df5f4f74a304f3112c...f88b9eee53598ac1fd96b321c88fa9189b391cba,2,25,2,27,4,2011-03-03 21:17:48,2011-03-03 21:17:48
f88b9eee53598ac1fd96b321c88fa9189b391cba...a9a85d7cfa8af185b0a347ef0ce9938983040cd6,2,84,68,152,54,2011-03-03 22:22:03,2011-03-03 22:22:03
a9a85d7cfa8af185b0a347ef0ce9938983040cd6...a1697e883aa64699252938155c75f9efdd66d315,2,5,2,7,3,2011-03-04 00:41:54,2011-03-04 00:41:54
a1697e883aa64699252938155c75f9efdd66d315...d9b9684eff5b4b10435312898381c46e733638d5,1,15,11,26,4,2011-03-04 00:42:21,2011-03-04 00:42:21
d9b9684eff5b4b10435312898381c46e733638d5...138c4aaa7773e885c75365dac217097781d159b9,1,11,8,19,17,2011-03-04 00:42:37,2011-03-04 00:42:37
138c4aaa7773e885c75365dac217097781d159b9...64cf5d33ac0a0bf574ee516366c08ed7e64d469e,1,12,9,21,9,2011-03-04 01:28:22,2011-03-04 01:28:22
64cf5d33ac0a0bf574ee516366c08ed7e64d469e...52739520c6fc30db15becd2d044d70f84a2bcb13,1,1,1,2,1,2011-03-04 20:05:57,2011-03-04 20:05:57
52739520c6fc30db15becd2d044d70f84a2bcb13...64011c8e5a5b7c78232b242e68e3a704ec42c3df,1,14,10,24,7,2011-03-04 22:30:18,2011-03-04 22:30:18
64011c8e5a5b7c78232b242e68e3a704ec42c3df...cb4b469a7f3c27a971006a6f3a0504a27e93be4a,1,4,0,4,1,2011-03-05 10:39:10,2011-03-05 10:39:10
cb4b469a7f3c27a971006a6f3a0504a27e93be4a...20cf3b82a1f4f7a2feb8e74152e581e621b37e89,1,3,5,8,3,2011-03-06 07:03:27,2011-03-06 07:03:27
20cf3b82a1f4f7a2feb8e74152e581e621b37e89...ee31d7124f111d492882d36461e55a8e2d778896,1,5,2,7,3,2011-03-07 00:12:02,2011-03-07 00:12:02
ee31d7124f111d492882d36461e55a8e2d778896...e81e64cd6361c43c775ccd52d9c4684fa935fcb7,3,5,5,10,5,2011-03-08 19:38:54,2011-03-08 19:38:54
e81e64cd6361c43c775ccd52d9c4684fa935fcb7...05b197dbb17fad30dd8a0cdc68bfb453697473ed,1,29,25,54,2,2011-03-08 22:50:56,2011-03-08 22:50:56
05b197dbb17fad30dd8a0cdc68bfb453697473ed...1c08ca568fa83f89119d472e0b77bb088ea2f259,3,105,90,195,73,2011-03-09 00:43:36,2011-03-09 00:43:36
1c08ca568fa83f89119d472e0b77bb088ea2f259...4c152afbb6113c5f8dbd511b3548653489e3c195,1,14,14,28,6,2011-03-09 19:22:27,2011-03-09 19:22:27
4c152afbb6113c5f8dbd511b3548653489e3c195...76636c81cddb553877fed80f62655de72d0735f9,1,1,0,1,1,2011-03-09 19:41:33,2011-03-09 19:41:33
76636c81cddb553877fed80f62655de72d0735f9...317f30a77f744281137cde87ca59855761c8e86e,1,1,1,2,1,2011-03-09 22:47:25,2011-03-09 22:47:25
317f30a77f744281137cde87ca59855761c8e86e...ec7dd583f2b33aa9a575530fbec215426348fdf6,10,129,119,248,77,2011-03-10 00:04:43,2011-03-10 00:04:43
ec7dd583f2b33aa9a575530fbec215426348fdf6...2bb360c91c42ae7a23ad7330fc13d98a6d9efa5f,3,2,24,26,6,2011-03-10 01:21:59,2011-03-10 01:21:59
2bb360c91c42ae7a23ad7330fc13d98a6d9efa5f...e9857ed5b1967d8849450fe3b5b4143d2f7c354b,1,1,1,2,1,2011-03-10 17:22:35,2011-03-10 17:22:35
e9857ed5b1967d8849450fe3b5b4143d2f7c354b...8ad87ec6ea3c0a5a5816c9b4c0cb46671562a9c7,1,1,1,2,1,2011-03-14 21:11:42,2011-03-14 21:11:42
8ad87ec6ea3c0a5a5816c9b4c0cb46671562a9c7...f10dae516015d8d48d4c13f3aa9455276ce9d1f8,3,13,14,27,10,2011-03-14 21:17:20,2011-03-14 21:17:20
f10dae516015d8d48d4c13f3aa9455276ce9d1f8...e5f49f8c064e70159d40841defbf603aabb6739d,2,26,5,31,6,2011-03-14 21:22:00,2011-03-14 21:22:00
e5f49f8c064e70159d40841defbf603aabb6739d...e8dcaa4bbac8349054734581794424895b85f059,1,17,0,17,1,2011-03-14 22:52:12,2011-03-14 22:52:12
e8dcaa4bbac8349054734581794424895b85f059...ddb1cee0e5a0fcb0c87ff39e6becd46ba981a29b,3,19,3,22,6,2011-03-15 02:27:48,2011-03-15 02:27:48
ddb1cee0e5a0fcb0c87ff39e6becd46ba981a29b...63686ce2c6657ae4db7bf6a05c3ee8ef8555e167,3,0,0,0,0,2011-03-15 02:30:54,2011-03-15 02:30:54
63686ce2c6657ae4db7bf6a05c3ee8ef8555e167...1d628d7ecf9ae832894e54acf7757a62caf7b548,5,59,3,62,8,2011-03-15 22:24:26,2011-03-15 22:24:26
1d628d7ecf9ae832894e54acf7757a62caf7b548...1e2d896e336cb9461fb9e4d3ab1e7065f13f2ea0,2,9,1,10,3,2011-03-16 03:07:30,2011-03-16 03:07:30
1e2d896e336cb9461fb9e4d3ab1e7065f13f2ea0...e594ca7f937c12939b60c9f7d77f4752cb808412,2,3,3,6,2,2011-03-16 04:45:00,2011-03-16 04:45:00
e594ca7f937c12939b60c9f7d77f4752cb808412...64c83ac6fb0813a4d74d356a2e11d0ecfee409a3,1,10,15,25,4,2011-03-16 16:52:53,2011-03-16 16:52:53
64c83ac6fb0813a4d74d356a2e11d0ecfee409a3...28462b693f2af31a30ace5ca4c29274063e0129a,2,20,0,20,4,2011-03-16 18:23:39,2011-03-16 18:23:39
28462b693f2af31a30ace5ca4c29274063e0129a...33c0d50c0cbaaded2bfe7f1ca259ec375d417b1a,1,2,0,2,2,2011-03-16 19:03:34,2011-03-16 19:03:34
33c0d50c0cbaaded2bfe7f1ca259ec375d417b1a...05c929fb3b4ce547d15ddb99520d498a6dcfc6a0,2,11,34,45,7,2011-03-17 00:50:53,2011-03-17 00:50:53
05c929fb3b4ce547d15ddb99520d498a6dcfc6a0...1d64c8a539b11998662c351d2ba847e794c2066b,2,5,0,5,5,2011-03-17 08:10:52,2011-03-17 08:10:52
1d64c8a539b11998662c351d2ba847e794c2066b...cbf9688b128cb910dc301a76c97a0a817ebf5b3e,1,1,0,1,1,2011-03-17 08:42:10,2011-03-17 08:42:10
cbf9688b128cb910dc301a76c97a0a817ebf5b3e...9ccf1d087e26260135851365deb04a74624bfbe9,2,119,54,173,21,2011-03-17 20:12:38,2011-03-17 20:12:38
9ccf1d087e26260135851365deb04a74624bfbe9...52e81079bee761500c21c11fa3cabf9a8da1546f,2,28,4,32,6,2011-03-19 02:45:51,2011-03-19 02:45:51
52e81079bee761500c21c11fa3cabf9a8da1546f...f9f2f4b7ec62c75d55bd1240ae182615e62fbe64,1,13,0,13,3,2011-03-19 22:13:35,2011-03-19 22:13:35
f9f2f4b7ec62c75d55bd1240ae182615e62fbe64...1332e898520a7f3c580ac0be6136ecf5be07b5c5,1,2,2,4,2,2011-03-21 15:41:53,2011-03-21 15:41:53
1332e898520a7f3c580ac0be6136ecf5be07b5c5...c5b476e22ac58bd927f9aa12b12976b76400c4b9,1,1,1,2,1,2011-03-22 23:24:13,2011-03-22 23:24:13
c5b476e22ac58bd927f9aa12b12976b76400c4b9...1dc518555b137beb7b3ffabc8d0e68edd2b27e61,1,6,5,11,1,2011-03-24 13:00:59,2011-03-24 13:00:59
1dc518555b137beb7b3ffabc8d0e68edd2b27e61...87fa64ca7c24fe16189fe638805e09a66c52b403,1,14,3,17,2,2011-05-09 15:49:54,2011-05-09 15:49:54
87fa64ca7c24fe16189fe638805e09a66c52b403...cfc1756ef57b019b772ac60e651a76fe2d41a7e1,1,5,1,6,1,2011-05-09 21:39:22,2011-05-09 21:39:22
cfc1756ef57b019b772ac60e651a76fe2d41a7e1...285b464fb8cb972af6bbdd7cf62b46e75c128a64,1,1,1,2,1,2011-05-09 23:56:04,2011-05-09 23:56:04
285b464fb8cb972af6bbdd7cf62b46e75c128a64...c613af4d6485586c79d692b70a9acac429f3ca9d,5,112,5,117,7,2011-09-10 01:28:31,2011-09-10 01:28:31
c613af4d6485586c79d692b70a9acac429f3ca9d...ac7c3a110f906e4dfed3a17451bf7fd9fcb81296,2,15,9,24,11,2011-09-10 01:28:40,2011-09-10 01:28:40
ac7c3a110f906e4dfed3a17451bf7fd9fcb81296...7268f8af86186518821d775c530d5558fd726930,3,8,10,18,4,2011-09-10 01:28:50,2011-09-10 01:28:50
7268f8af86186518821d775c530d5558fd726930...216a79ee477d1e8dcb9d0e631cd7cbb93ff9fb14,3,3,3,6,3,2011-09-10 01:41:36,2011-09-10 01:41:36
216a79ee477d1e8dcb9d0e631cd7cbb93ff9fb14...ed736e6a255f50c3a2f5eab400e3ba40a723bb60,3,3,3,6,3,2011-09-11 01:01:58,2011-09-11 01:01:58
ed736e6a255f50c3a2f5eab400e3ba40a723bb60...cf96d88421197177c59e446e3bd57a313621eca6,1,1,1,2,1,2012-03-10 17:45:26,2012-03-10 17:45:26
7c08f4c6351f7e53a01ff800d8a61f19ca961b29...e7d678237f8885cd333d9b3f56af5fe9a9745882,1,3,3,6,3,2011-03-23 08:48:18,2011-03-23 08:48:18
e7d678237f8885cd333d9b3f56af5fe9a9745882...1339ef4af8034cf7b2dc05efe2bc82298007c17b,1,1,1,2,1,2011-03-24 09:40:50,2011-03-24 09:40:50
1339ef4af8034cf7b2dc05efe2bc82298007c17b...f3f1983f30802c20a19c1e847aee8cd5e69826a8,1,2,1,3,2,2011-03-24 10:02:58,2011-03-24 10:02:58
f3f1983f30802c20a19c1e847aee8cd5e69826a8...3e7ce3c750f05948615474e3f1b6e98ceb35fb75,1,6,5,11,1,2011-03-24 12:36:33,2011-03-24 12:36:33
3e7ce3c750f05948615474e3f1b6e98ceb35fb75...8ddf5ba66fb886a70b94435589c588e5020f757c,1,11,3,14,3,2011-03-24 17:52:32,2011-03-24 17:52:32
8ddf5ba66fb886a70b94435589c588e5020f757c...6a5548cf839b04126ce0497d127a8b0bff764218,1,3,7,10,3,2011-03-24 17:58:13,2011-03-24 17:58:13
6a5548cf839b04126ce0497d127a8b0bff764218...5e0f5fb0f66dca87618ef20e1f7752509bad871d,1,1,0,1,1,2011-03-25 15:08:09,2011-03-25 15:08:09
5e0f5fb0f66dca87618ef20e1f7752509bad871d...8121aa60fd2dbc18dd8f4bfd42e4c1567c1199b6,1,0,6,6,2,2011-03-26 03:13:22,2011-03-26 03:13:22
8121aa60fd2dbc18dd8f4bfd42e4c1567c1199b6...3e18969bcbc7af31eb0fc663b9754ce55bc57dfa,2,3,4,7,3,2011-03-26 03:30:48,2011-03-26 03:30:48
3e18969bcbc7af31eb0fc663b9754ce55bc57dfa...2f9658fc3a6219a5faa2725bbaabaea36df076ee,1,1,1,2,1,2011-03-26 03:53:37,2011-03-26 03:53:37
2f9658fc3a6219a5faa2725bbaabaea36df076ee...5d854608feb40ff2a4e205f202d267f0f964a2b0,1,3,3,6,1,2011-03-26 03:54:53,2011-03-26 03:54:53
5d854608feb40ff2a4e205f202d267f0f964a2b0...471c9aee9771da32b942e71c7dcaef97a4c70f1c,2,4,4,8,4,2011-03-26 17:45:42,2011-03-26 17:45:42
471c9aee9771da32b942e71c7dcaef97a4c70f1c...15295a852f181d8812fd06aef2763b28443bc331,2,2,3,5,2,2011-03-26 17:50:10,2011-03-26 17:50:10
15295a852f181d8812fd06aef2763b28443bc331...d665c0b3b92b589d3361463005f64582299d56e6,1,1,1,2,1,2011-03-27 23:00:36,2011-03-27 23:00:36
d665c0b3b92b589d3361463005f64582299d56e6...18ef901e5f8e3e20256defd1cb42a2310ee9b64b,1,4,0,4,4,2011-03-28 01:22:05,2011-03-28 01:22:05
18ef901e5f8e3e20256defd1cb42a2310ee9b64b...a87be3554fc73a567b926ea51c13ea844b5113f8,20,50,63,113,54,2011-03-28 01:40:43,2011-03-28 01:40:43
a87be3554fc73a567b926ea51c13ea844b5113f8...13864703bc1d5dd4dac63c96c6a4b42a392bc57f,56,113,326,439,140,2011-03-28 02:11:19,2011-03-28 02:11:19
13864703bc1d5dd4dac63c96c6a4b42a392bc57f...5d6ee6cb18675000a97331e60f04ff1a394dac13,1,0,1,1,1,2011-03-28 02:13:05,2011-03-28 02:13:05
5d6ee6cb18675000a97331e60f04ff1a394dac13...3d5a8f758a6af8bdbcfad94dc7534cd3c1385d46,1,17,16,33,1,2011-03-28 02:14:19,2011-03-28 02:14:19
3d5a8f758a6af8bdbcfad94dc7534cd3c1385d46...7cac1ecbd0f88825564f1e28901559c1b0aecb1a,1,2,8,10,2,2011-03-28 02:25:26,2011-03-28 02:25:26
7cac1ecbd0f88825564f1e28901559c1b0aecb1a...a89ee065a157f9d31d6c02f10c5c46437c6cbf77,1,1,2,3,1,2011-03-28 02:26:15,2011-03-28 02:26:15
a89ee065a157f9d31d6c02f10c5c46437c6cbf77...579eb979615d8b735df1d387d90266ab474fe6b6,1,2,10,12,3,2011-03-28 02:27:05,2011-03-28 02:27:05
579eb979615d8b735df1d387d90266ab474fe6b6...0fdabe885baabae291da23570966a9e4a4e4df6d,3,18,37,55,4,2011-03-28 02:27:43,2011-03-28 02:27:43
0fdabe885baabae291da23570966a9e4a4e4df6d...b4f0c1a7759c8b96085411bea02cc9a539d6eaf5,1,1,7,8,1,2011-03-28 02:31:31,2011-03-28 02:31:31
b4f0c1a7759c8b96085411bea02cc9a539d6eaf5...e54c0a0c9488ab93c30f1f89c98e5a020a9ec326,9,187,215,402,20,2011-03-28 05:58:43,2011-03-28 05:58:43
e54c0a0c9488ab93c30f1f89c98e5a020a9ec326...3bad2ca47304243236fb7f2e36fdadc6e4589a93,1,1,1,2,1,2011-03-28 14:20:15,2011-03-28 14:20:15
3bad2ca47304243236fb7f2e36fdadc6e4589a93...728770a5f9bbdcd4131f3a2552666aef54764aba,1,1,1,2,1,2011-03-28 14:22:48,2011-03-28 14:22:48
728770a5f9bbdcd4131f3a2552666aef54764aba...8bb46d8b7c808bb366c7e15c46e5476e2b2b51a1,2,67,3,70,5,2011-03-28 16:11:40,2011-03-28 16:11:40
8bb46d8b7c808bb366c7e15c46e5476e2b2b51a1...cc3803e147a7bc63ec2cb447220445d8fab5ecdb,1,4,51,55,2,2011-03-28 21:27:22,2011-03-28 21:27:22
cc3803e147a7bc63ec2cb447220445d8fab5ecdb...6a25d90e4947ca09cf6f934d4acf6bfb1bccd885,1,0,4,4,1,2011-03-28 22:19:14,2011-03-28 22:19:14
6a25d90e4947ca09cf6f934d4acf6bfb1bccd885...99b2728b74cc33afc0a3ee15a0ed23c749ac63ab,2,2,2,4,2,2011-03-29 10:24:42,2011-03-29 10:24:42
99b2728b74cc33afc0a3ee15a0ed23c749ac63ab...37ed6f26812e960a034cb1312257bf7436bad965,4,67,0,67,5,2011-03-30 08:34:05,2011-03-30 08:34:05
37ed6f26812e960a034cb1312257bf7436bad965...83246ca8b9e94070e4b86e9b94ef8573c3259517,1,1,1,2,2,2011-03-30 16:46:24,2011-03-30 16:46:24
83246ca8b9e94070e4b86e9b94ef8573c3259517...abab0742d07b6a95f7eb46fcf6bd727f66f1ccd6,3,25,6,31,9,2011-03-30 16:56:53,2011-03-30 16:56:53
abab0742d07b6a95f7eb46fcf6bd727f66f1ccd6...4550f95f29f22c4656d3e6ef73e83316076c3750,2,31,0,31,2,2011-03-30 17:34:01,2011-03-30 17:34:01
4550f95f29f22c4656d3e6ef73e83316076c3750...21ef64e34c1c84bd7beb07531694d3f22fc42ffd,2,26,99,125,13,2011-03-30 17:34:14,2011-03-30 17:34:14
21ef64e34c1c84bd7beb07531694d3f22fc42ffd...8823021625785cbe8e9e2f4d6ff559fc4c8fa7c6,3,22,369,391,31,2011-03-30 17:34:26,2011-03-30 17:34:26
8823021625785cbe8e9e2f4d6ff559fc4c8fa7c6...25aaa359a28095400eefb017e981163a657e2ca6,2,1,36,37,4,2011-03-30 17:34:38,2011-03-30 17:34:38
25aaa359a28095400eefb017e981163a657e2ca6...fa4bbfcbfb4f693955f653bd06f384dd786e3c93,3,3,60,63,5,2011-03-30 17:34:49,2011-03-30 17:34:49
fa4bbfcbfb4f693955f653bd06f384dd786e3c93...c922a046755db20d08c714b469503d3dcb5e0dfc,3,13,39,52,13,2011-03-30 17:35:01,2011-03-30 17:35:01
c922a046755db20d08c714b469503d3dcb5e0dfc...5fa11b00352ec14c30a1eeea1377339adc8fc3ff,2,1,31,32,5,2011-03-30 17:35:12,2011-03-30 17:35:12
5fa11b00352ec14c30a1eeea1377339adc8fc3ff...c0caac87f990b585bb7a9f20fe7be91f2a2366ce,2,3,33,36,4,2011-03-30 17:35:22,2011-03-30 17:35:22
c0caac87f990b585bb7a9f20fe7be91f2a2366ce...1f5d684f14b16115973dc76666d0281b485aaa16,1,57,0,57,1,2011-03-30 17:35:32,2011-03-30 17:35:32
1f5d684f14b16115973dc76666d0281b485aaa16...16f6acdb89c42efaa99b81989a9fae01ff8e607d,3,24,18,42,8,2011-03-30 17:35:41,2011-03-30 17:35:41
16f6acdb89c42efaa99b81989a9fae01ff8e607d...4a6cb387228eabd746584e34dfe07b888fdb2813,1,3,8,11,2,2011-03-30 17:35:50,2011-03-30 17:35:50
4a6cb387228eabd746584e34dfe07b888fdb2813...e57cc90c164ca9e078882158d830c5d9f717e13b,3,3,70,73,5,2011-03-30 17:48:42,2011-03-30 17:48:42
e57cc90c164ca9e078882158d830c5d9f717e13b...9b3aaae255fad098e801e4813f646492a8a29e57,2,24,86,110,9,2011-03-30 17:59:44,2011-03-30 17:59:44
9b3aaae255fad098e801e4813f646492a8a29e57...84226c0b848b39b30ba4781fedb0d87ef1d2f83f,1,1,3,4,1,2011-03-30 19:23:43,2011-03-30 19:23:43
84226c0b848b39b30ba4781fedb0d87ef1d2f83f...365f501793493287903b5920bbdca9139974cb7f,1,0,0,0,0,2011-03-31 08:35:34,2011-03-31 08:35:34
365f501793493287903b5920bbdca9139974cb7f...7099d465abad0e6fd7c5ff096dc8ab55c14ecfdd,1,1,1,2,1,2011-03-31 08:42:51,2011-03-31 08:42:51
7099d465abad0e6fd7c5ff096dc8ab55c14ecfdd...94af19c43fad3e42d64981e22fe15b844f1f9eb6,34,239,239,478,212,2011-04-01 16:10:22,2011-04-01 16:10:22
94af19c43fad3e42d64981e22fe15b844f1f9eb6...9a279edc1cedecc65249b061bcb2797fe509a85b,9,21,21,42,20,2011-04-01 16:18:23,2011-04-01 16:18:23
9a279edc1cedecc65249b061bcb2797fe509a85b...98d3a0933806df70fc49f02e789c34b2b684421b,1,1,1,2,1,2011-04-02 08:32:21,2011-04-02 08:32:21
98d3a0933806df70fc49f02e789c34b2b684421b...48edaf17a330c1ec7852077a7c59e97875ad849e,3,1,21,22,5,2011-04-02 08:33:01,2011-04-02 08:33:01
48edaf17a330c1ec7852077a7c59e97875ad849e...fe124152315ef21c0673b12ecd2d5f0bd6f271b2,2,0,7,7,1,2011-04-02 08:33:40,2011-04-02 08:33:40
fe124152315ef21c0673b12ecd2d5f0bd6f271b2...c1df35b0fa1028e3708508f8b8de5d7f0d993407,1,1,1,2,1,2011-04-02 08:34:15,2011-04-02 08:34:15
c1df35b0fa1028e3708508f8b8de5d7f0d993407...765458363bc8967516ae973d255a44d5d2c19566,1,0,10,10,1,2011-04-02 08:34:50,2011-04-02 08:34:50
765458363bc8967516ae973d255a44d5d2c19566...c349aad4129ee115a0ce4832009bab56b3f10781,1,1,1,2,1,2011-04-02 08:35:25,2011-04-02 08:35:25
c349aad4129ee115a0ce4832009bab56b3f10781...5d5149cd18aa846be88ebcfae5997268359f67bb,8,2,232,234,14,2011-04-02 08:36:04,2011-04-02 08:36:04
5d5149cd18aa846be88ebcfae5997268359f67bb...24b7d9017dc4a155c4cdbaa4823b3cc46f7f57ec,2,0,82,82,2,2011-04-02 08:36:40,2011-04-02 08:36:40
24b7d9017dc4a155c4cdbaa4823b3cc46f7f57ec...576606a6f230bc50a82433eb60661737742c2a59,3,16,16,32,5,2011-04-02 08:37:15,2011-04-02 08:37:15
576606a6f230bc50a82433eb60661737742c2a59...af00f29ecb7647e455d3207a4af1c587d7d53e2f,6,7,45,52,8,2011-04-02 08:37:53,2011-04-02 08:37:53
af00f29ecb7647e455d3207a4af1c587d7d53e2f...f9972bcf8675d26291f09c7acbc9da2f5f1a2327,1,0,127,127,2,2011-04-02 08:38:25,2011-04-02 08:38:25
f9972bcf8675d26291f09c7acbc9da2f5f1a2327...89117545557f8ccfccfa9addd086a160501104b3,9,82,290,372,12,2011-04-02 08:39:08,2011-04-02 08:39:08
89117545557f8ccfccfa9addd086a160501104b3...3eb4acf118d8e3781198640f02a3d6a327861f7c,1,0,6,6,2,2011-04-02 08:39:31,2011-04-02 08:39:31
3eb4acf118d8e3781198640f02a3d6a327861f7c...eea43f2458d8e32ae033c4e585356c9abc263bc8,1,0,11,11,1,2011-04-02 08:39:52,2011-04-02 08:39:52
eea43f2458d8e32ae033c4e585356c9abc263bc8...8db51a70dad5b5f30232237e9883fa2504bf4d49,1,0,10,10,1,2011-04-02 08:40:14,2011-04-02 08:40:14
8db51a70dad5b5f30232237e9883fa2504bf4d49...1d4390b26b9e9ac05b89c7c1b51e5cd912d842ea,1,1,1,2,1,2011-04-02 08:40:38,2011-04-02 08:40:38
1d4390b26b9e9ac05b89c7c1b51e5cd912d842ea...4d94c0cb38624115299e19daae24d2312e60e273,5,2,43,45,6,2011-04-02 08:41:03,2011-04-02 08:41:03
4d94c0cb38624115299e19daae24d2312e60e273...87508fbbf37644cb5c03cec6cf63b86995f5ced5,2,2,11,13,3,2011-04-02 08:41:26,2011-04-02 08:41:26
87508fbbf37644cb5c03cec6cf63b86995f5ced5...86ba75b0904ec4cba2945881f48a628c66b9d0c5,3,1,67,68,3,2011-04-02 08:41:51,2011-04-02 08:41:51
86ba75b0904ec4cba2945881f48a628c66b9d0c5...d60ae0b7214cb33e786c567b62099174d310e6b9,36,0,5835,5835,19,2011-04-02 08:43:43,2011-04-02 08:43:43
d60ae0b7214cb33e786c567b62099174d310e6b9...603884505f84290d2379042169deae837e25b722,4,4,4,8,4,2011-04-02 08:44:04,2011-04-02 08:44:04
603884505f84290d2379042169deae837e25b722...4c468800ee82d89e715e11af291bb326d47c3ce9,28,255,298,553,69,2011-04-02 08:44:47,2011-04-02 08:44:47
4c468800ee82d89e715e11af291bb326d47c3ce9...ae5f3e74187c558accaaee7a0c8d6b467b0a0fc2,2,20,11,31,5,2011-04-02 08:45:06,2011-04-02 08:45:06
ae5f3e74187c558accaaee7a0c8d6b467b0a0fc2...62f37c69b075a5d11b5fddc6c59b4f4b418ba358,2,45,0,45,2,2011-04-02 08:45:22,2011-04-02 08:45:22
62f37c69b075a5d11b5fddc6c59b4f4b418ba358...027e3b554c30a351ac6d3eb404696ef23aa93cc6,1,5,5,10,2,2011-04-02 08:45:38,2011-04-02 08:45:38
027e3b554c30a351ac6d3eb404696ef23aa93cc6...27efda5f5b0dca23c244e7a8cb2b11361bc6dc58,1,1,2,3,1,2011-04-02 08:45:54,2011-04-02 08:45:54
27efda5f5b0dca23c244e7a8cb2b11361bc6dc58...4749159d48c42c706cd14ab105179f29deab734d,1,16,0,16,5,2011-04-02 13:26:19,2011-04-02 13:26:19
4749159d48c42c706cd14ab105179f29deab734d...32517041bd051389c349d14ccdbf882d095acf8f,1,10,0,10,4,2011-04-02 13:26:39,2011-04-02 13:26:39
32517041bd051389c349d14ccdbf882d095acf8f...bcdbafc88aaf35682165f8a814d1f13daf095fac,1,11,1,12,4,2011-04-02 13:26:54,2011-04-02 13:26:54
bcdbafc88aaf35682165f8a814d1f13daf095fac...3b94af8a849b4b37051abd5a84a03dc1fd307569,11,38,41,79,14,2011-04-02 13:27:17,2011-04-02 13:27:17
3b94af8a849b4b37051abd5a84a03dc1fd307569...29642fa76fa5c8087c49d2f37511450419fa8cf7,10,219,193,412,83,2011-04-02 13:27:40,2011-04-02 13:27:40
29642fa76fa5c8087c49d2f37511450419fa8cf7...e6a5e41cdfe71cebe72b14207923d1befc99f994,1,1,0,1,1,2011-04-02 13:46:09,2011-04-02 13:46:09
e6a5e41cdfe71cebe72b14207923d1befc99f994...74f7ad32a51c7bf9e013f1865e4039ac07fd71b9,1,74,16,90,8,2011-04-02 13:55:03,2011-04-02 13:55:03
74f7ad32a51c7bf9e013f1865e4039ac07fd71b9...ecdcf477f9fefd976dd19d1a84a6d36204b4e404,1,3,10,13,3,2011-04-02 18:48:18,2011-04-02 18:48:18
ecdcf477f9fefd976dd19d1a84a6d36204b4e404...cca232c2349b9fc979604a977808146c9d81181e,1,6,4,10,2,2011-04-02 19:03:11,2011-04-02 19:03:11
cca232c2349b9fc979604a977808146c9d81181e...eaf55548655ac085acdacfad45be9fa35c47756c,1,1,1,2,1,2011-04-02 21:45:56,2011-04-02 21:45:56
eaf55548655ac085acdacfad45be9fa35c47756c...21877c39b4d4af18c2f8b7809a8d2daaebb9c698,1,1,1,2,1,2011-04-02 21:46:28,2011-04-02 21:46:28
21877c39b4d4af18c2f8b7809a8d2daaebb9c698...09b4a41aa789bd434d6e0dea932fcd72ffb4be47,1,7,4,11,2,2011-04-02 21:49:39,2011-04-02 21:49:39
09b4a41aa789bd434d6e0dea932fcd72ffb4be47...fd309996df3bbfd14aff6aee293582cc86f8fccc,1,35,25,60,13,2011-04-02 22:13:21,2011-04-02 22:13:21
fd309996df3bbfd14aff6aee293582cc86f8fccc...e3018993921b87ebdf65558519c6530141fc327c,1,7,5,12,2,2011-04-03 23:08:48,2011-04-03 23:08:48
e3018993921b87ebdf65558519c6530141fc327c...fb55a1a77d2ca17c946d3579eed7efc259294637,1,0,11,11,1,2011-04-03 23:50:12,2011-04-03 23:50:12
fb55a1a77d2ca17c946d3579eed7efc259294637...1c7a9a403a8cdeb300423bec569febe4e52241ba,1,0,1,1,1,2011-04-04 03:42:46,2011-04-04 03:42:46
1c7a9a403a8cdeb300423bec569febe4e52241ba...4d3ab063b1b36bd4fb9a75d26b6c883d632aef0e,1,3,1,4,2,2011-04-04 12:39:21,2011-04-04 12:39:21
4d3ab063b1b36bd4fb9a75d26b6c883d632aef0e...71bf169ab1e91415b731158e6b5ba929111742dd,1,1,1,2,1,2011-04-04 15:43:56,2011-04-04 15:43:56
71bf169ab1e91415b731158e6b5ba929111742dd...30b3d51599aed4cf08ccace9ba5b1277ded78439,9,34,32,66,21,2011-04-05 00:19:17,2011-04-05 00:19:17
30b3d51599aed4cf08ccace9ba5b1277ded78439...de5f07513bb3fb8be4131685c6d3892219d8d821,1,0,3,3,1,2011-04-05 11:29:16,2011-04-05 11:29:16
de5f07513bb3fb8be4131685c6d3892219d8d821...4fa96467164d738c6f8a9c59423382257f95b747,3,68,10,78,10,2011-04-06 09:40:26,2011-04-06 09:40:26
4fa96467164d738c6f8a9c59423382257f95b747...ab9e596ca65eec5aa021b2d0a4d6c975d0869cb5,2,5,3,8,3,2011-04-06 10:12:21,2011-04-06 10:12:21
ab9e596ca65eec5aa021b2d0a4d6c975d0869cb5...91e59aeca0d4a554c418629999d1d9e758912c5c,1,6,0,6,2,2011-04-06 10:33:32,2011-04-06 10:33:32
91e59aeca0d4a554c418629999d1d9e758912c5c...b7715b4ae68be211749520e60c63d251ccf14bc1,1,1,1,2,1,2011-04-06 11:19:37,2011-04-06 11:19:37
b7715b4ae68be211749520e60c63d251ccf14bc1...8d4b414760fdd677c973f9ccfe4f5c3b41934d4d,8,30,117,147,24,2011-04-07 22:01:23,2011-04-07 22:01:23
8d4b414760fdd677c973f9ccfe4f5c3b41934d4d...fda7ac3490d78c3e6c21d7d56e7f4f9676bc9b8e,2,27,8,35,4,2011-04-09 18:47:59,2011-04-09 18:47:59
fda7ac3490d78c3e6c21d7d56e7f4f9676bc9b8e...d546179c71dc19692cd263aef46f753d312be546,1,1,1,2,1,2011-04-11 20:27:53,2011-04-11 20:27:53
d546179c71dc19692cd263aef46f753d312be546...3b6c5e5eb21b4aad296fb750f515e66ea5c01e65,1,2,2,4,2,2011-04-11 21:48:47,2011-04-11 21:48:47
3b6c5e5eb21b4aad296fb750f515e66ea5c01e65...13bb06984cdfb937d0eac13b78c7c2337442c561,2,11,2,13,3,2011-04-13 11:28:42,2011-04-13 11:28:42
13bb06984cdfb937d0eac13b78c7c2337442c561...d3c08fd8139416942da30bb22e529357e7708e2c,1,8,0,8,1,2011-04-15 21:49:22,2011-04-15 21:49:22
d3c08fd8139416942da30bb22e529357e7708e2c...89e25403ae9dfcdc3eabd66469226d3036c6cc06,2,49,16,65,6,2011-04-17 04:52:17,2011-04-17 04:52:17
89e25403ae9dfcdc3eabd66469226d3036c6cc06...d59baa07f056b60942052b4809d71eecd323837a,2,45,20,65,7,2011-04-17 04:52:31,2011-04-17 04:52:31
d59baa07f056b60942052b4809d71eecd323837a...d78e08f4a0129adad0a9ee86d7af3d7203f5c564,1,7,7,14,2,2011-04-17 14:13:19,2011-04-17 14:13:19
d78e08f4a0129adad0a9ee86d7af3d7203f5c564...f8495d2371d78468b8424e300a88cb1e5c08c342,5,11,14,25,8,2011-04-17 20:45:06,2011-04-17 20:45:06
f8495d2371d78468b8424e300a88cb1e5c08c342...5409168ba2afb6cc96aa0b0e0c445329c723eeac,1,2,2,4,1,2011-04-17 20:46:48,2011-04-17 20:46:48
5409168ba2afb6cc96aa0b0e0c445329c723eeac...78b2e254ca0ad8ac35dda6d3ecea2d392d6addee,1,3,3,6,2,2011-04-17 20:51:19,2011-04-17 20:51:19
78b2e254ca0ad8ac35dda6d3ecea2d392d6addee...d3e5380b41c1237e138c9432c8eb7d6ff91fe9ac,1,1,1,2,1,2011-04-17 20:55:26,2011-04-17 20:55:26
d3e5380b41c1237e138c9432c8eb7d6ff91fe9ac...0defa7dc9dc97a11baea3b91158fbc7c57e5c3a6,2,10,3,13,4,2011-04-18 20:00:10,2011-04-18 20:00:10
0defa7dc9dc97a11baea3b91158fbc7c57e5c3a6...487cd1fa23eab0fbf02f0e322152b4b348911cdc,1,4,0,4,2,2011-04-18 21:02:57,2011-04-18 21:02:57
487cd1fa23eab0fbf02f0e322152b4b348911cdc...b4c83138e9daa0be301d1f18458609f003d19922,1,2,3,5,1,2011-04-18 21:59:20,2011-04-18 21:59:20
b4c83138e9daa0be301d1f18458609f003d19922...6f84e520e56e295c99ac44390c3cc8ffbac11d46,1,1,1,2,1,2011-04-18 23:15:28,2011-04-18 23:15:28
6f84e520e56e295c99ac44390c3cc8ffbac11d46...9587235530b5e3315e3348b1e0d0899ec5408f6d,1,1,1,2,1,2011-04-19 02:14:07,2011-04-19 02:14:07
9587235530b5e3315e3348b1e0d0899ec5408f6d...1286d783110e8b4d1df8068ed0d9093b49cdcaec,4,127,3,130,5,2011-04-19 22:06:19,2011-04-19 22:06:19
1286d783110e8b4d1df8068ed0d9093b49cdcaec...4175e3d104b46459545809690cdd456bc65d8be8,1,3,1,4,3,2011-04-19 22:26:50,2011-04-19 22:26:50
4175e3d104b46459545809690cdd456bc65d8be8...96520e87bdd37a6a32c49cfa2df124421f6ec3ed,1,4,4,8,1,2011-04-20 11:39:10,2011-04-20 11:39:10
96520e87bdd37a6a32c49cfa2df124421f6ec3ed...196ac8f8b31302d026af6d79f764c8f146a8c78e,5,195,5,200,8,2011-04-20 14:41:47,2011-04-20 14:41:47
196ac8f8b31302d026af6d79f764c8f146a8c78e...519534bf03fc50d9176a857e3f4de5cfe1d0fa66,1,7,7,14,2,2011-04-20 16:28:02,2011-04-20 16:28:02
519534bf03fc50d9176a857e3f4de5cfe1d0fa66...26cda43012104cf700673966659f8c2f2bfb0bbe,11,21,25,46,14,2011-04-20 17:40:53,2011-04-20 17:40:53
26cda43012104cf700673966659f8c2f2bfb0bbe...2bb3401d06c423b49748f2ec4f1570cd0c9e83a4,10,11,11,22,11,2011-04-20 17:41:04,2011-04-20 17:41:04
2bb3401d06c423b49748f2ec4f1570cd0c9e83a4...fda8a9a3902649fb70806f7def55851012047490,1,1,1,2,1,2011-04-20 17:44:29,2011-04-20 17:44:29
fda8a9a3902649fb70806f7def55851012047490...6bdaef26ec9cc9841b944e1d18b13185f7bbe2f5,8,67,12,79,18,2011-04-20 17:58:37,2011-04-20 17:58:37
6bdaef26ec9cc9841b944e1d18b13185f7bbe2f5...1b1060c9168227e9ff4b1e9141ba6086134030bd,2,16,2,18,4,2011-04-20 19:50:27,2011-04-20 19:50:27
1b1060c9168227e9ff4b1e9141ba6086134030bd...99c179442782ea83c52452296d5769950f23a75a,1,2,5,7,1,2011-04-20 20:03:42,2011-04-20 20:03:42
99c179442782ea83c52452296d5769950f23a75a...8f0f73c7b8b110489a1a127cc47e3cabb0eea646,14,375,0,375,22,2011-04-20 20:42:07,2011-04-20 20:42:07
8f0f73c7b8b110489a1a127cc47e3cabb0eea646...c92e0e47657f8c53673523428011f34ba15be7bb,1,12,1,13,2,2011-04-20 21:00:24,2011-04-20 21:00:24
c92e0e47657f8c53673523428011f34ba15be7bb...6488f15a8efa6861361b6dbef02b890a997a75aa,1,4,8,12,3,2011-04-20 21:00:29,2011-04-20 21:00:29
6488f15a8efa6861361b6dbef02b890a997a75aa...327081f875edb09c7ac4fc070a40d8ae7906578d,1,9,0,9,1,2011-04-21 00:00:32,2011-04-21 00:00:32
327081f875edb09c7ac4fc070a40d8ae7906578d...7d11c30994c5f90603264c6e2fcf1d9c79ab8924,2,34,34,68,15,2011-04-22 12:01:33,2011-04-22 12:01:33
7d11c30994c5f90603264c6e2fcf1d9c79ab8924...f4be8bd53d13c9ecb7f31998f89a2def11111efb,2,34,1,35,4,2011-04-22 12:01:41,2011-04-22 12:01:41
f4be8bd53d13c9ecb7f31998f89a2def11111efb...157255fd98f7a94b9e8a5285f3f76a47ae3552d2,1,11,0,11,2,2011-04-22 12:01:48,2011-04-22 12:01:48
157255fd98f7a94b9e8a5285f3f76a47ae3552d2...59d1f82634456851592857a41100c572637642ad,8,151,4,155,13,2011-04-22 12:01:59,2011-04-22 12:01:59
59d1f82634456851592857a41100c572637642ad...a845eba8dded42a58d5b42bcb087b3f4bc65a26e,2,4,0,4,2,2011-04-22 12:02:07,2011-04-22 12:02:07
a845eba8dded42a58d5b42bcb087b3f4bc65a26e...51cfd7a50b82e5151ba96a0f81220288c2a17546,1,0,239,239,1,2011-04-22 12:02:14,2011-04-22 12:02:14
51cfd7a50b82e5151ba96a0f81220288c2a17546...6c17190bf8c6c23f21dd49b029106dd5cb41ae2e,6,110,11,121,18,2011-04-22 12:02:25,2011-04-22 12:02:25
6c17190bf8c6c23f21dd49b029106dd5cb41ae2e...8b588747ed302fcdef0b79171ed3cf129cd32a38,8,441,11,452,10,2011-04-22 12:02:38,2011-04-22 12:02:38
8b588747ed302fcdef0b79171ed3cf129cd32a38...ea248f0107eb3bed5a4a0fb65d6065e5691bea0a,3,86,3,89,6,2011-04-22 12:02:47,2011-04-22 12:02:47
ea248f0107eb3bed5a4a0fb65d6065e5691bea0a...e744fec8f9c47c8d45045d36df202deb4b6c3b9f,2,37,5,42,6,2011-04-22 12:02:55,2011-04-22 12:02:55
e744fec8f9c47c8d45045d36df202deb4b6c3b9f...0e9692bc66ed7cfbbcb4c8031b36e82751685238,2,7,2,9,2,2011-04-22 12:03:03,2011-04-22 12:03:03
0e9692bc66ed7cfbbcb4c8031b36e82751685238...01d0bf011ef9c92892fa0717764d74ecfd2ef2b6,2,4,3,7,4,2011-04-22 12:03:10,2011-04-22 12:03:10
01d0bf011ef9c92892fa0717764d74ecfd2ef2b6...0e5d5d6218e61aa6a3ac8ddadbd0bb86f7b02aa0,2,31,1,32,5,2011-04-22 12:03:18,2011-04-22 12:03:18
0e5d5d6218e61aa6a3ac8ddadbd0bb86f7b02aa0...e1f7bc0a410a4ce4eb3ab1e1426847f622e50539,7,356,0,356,10,2011-04-22 12:03:30,2011-04-22 12:03:30
e1f7bc0a410a4ce4eb3ab1e1426847f622e50539...7478aeb0a7f0726e7099586a30f980f369d676e6,8,652,0,652,9,2011-04-22 12:03:42,2011-04-22 12:03:42
7478aeb0a7f0726e7099586a30f980f369d676e6...4da29717fd46234d5b44705646f629800c80982a,2,9,2,11,3,2011-04-22 12:03:50,2011-04-22 12:03:50
4da29717fd46234d5b44705646f629800c80982a...598032b8c4ec7d642b6223af8569bef81d183385,3,39,1,40,10,2011-04-22 12:03:58,2011-04-22 12:03:58
598032b8c4ec7d642b6223af8569bef81d183385...5b0e4e49d4ab5e976fbfdde70c525a13220f3259,7,57,7,64,9,2011-04-22 12:14:54,2011-04-22 12:14:54
5b0e4e49d4ab5e976fbfdde70c525a13220f3259...12265410acda595bfbe65d790a7aa36038379e8c,3,10,3,13,5,2011-04-22 12:15:52,2011-04-22 12:15:52
12265410acda595bfbe65d790a7aa36038379e8c...abc1e92d852940a24c4343a7969bd381bb432fe0,1,5,11,16,3,2011-04-22 12:27:58,2011-04-22 12:27:58
abc1e92d852940a24c4343a7969bd381bb432fe0...13cfdb0d8b31997efbb0f413c69da304a5c73044,3,4,4,8,4,2011-04-22 14:08:31,2011-04-22 14:08:31
13cfdb0d8b31997efbb0f413c69da304a5c73044...c8092b840b4151724a6babdbeb84cf3138057c6a,7,97,67,164,47,2011-04-22 18:17:16,2011-04-22 18:17:16
c8092b840b4151724a6babdbeb84cf3138057c6a...c77372cad034b06c1b7239ff6e1284c832f4a541,3,19,2,21,3,2011-04-22 18:17:26,2011-04-22 18:17:26
c77372cad034b06c1b7239ff6e1284c832f4a541...534c427b20237fb4224323c6f626fa68720545ee,3,13,2,15,5,2011-04-22 21:18:27,2011-04-22 21:18:27
534c427b20237fb4224323c6f626fa68720545ee...5bbba4b9ada4fe278fd328565198b9a2a5fd4e4e,1,1,1,2,1,2011-04-22 21:23:26,2011-04-22 21:23:26
5bbba4b9ada4fe278fd328565198b9a2a5fd4e4e...065e6b6153a2656a9d60ca7da72236de0843e6a5,2,80,18,98,16,2011-04-23 03:55:21,2011-04-23 03:55:21
065e6b6153a2656a9d60ca7da72236de0843e6a5...f4c808b7f50d6906d96593626ccdd016b0b1b96b,2,17,0,17,3,2011-04-23 15:10:51,2011-04-23 15:10:51
f4c808b7f50d6906d96593626ccdd016b0b1b96b...b2481a2cfb6969bf8968d03bb0a13408bc2af5d0,1,1,1,2,1,2011-04-23 21:48:23,2011-04-23 21:48:23
b2481a2cfb6969bf8968d03bb0a13408bc2af5d0...f9fa9327c636b5315b5d41de03a498caed8d934a,1,6,6,12,6,2011-04-24 23:47:18,2011-04-24 23:47:18
f9fa9327c636b5315b5d41de03a498caed8d934a...449e84a2f144f026c5a047697c3fe5f01f0fcd41,2,2,2,4,2,2011-04-24 23:53:24,2011-04-24 23:53:24
449e84a2f144f026c5a047697c3fe5f01f0fcd41...a6c08a53d37cd91f2073f8744539a4297fd652f3,1,42,5,47,5,2011-04-25 05:43:53,2011-04-25 05:43:53
a6c08a53d37cd91f2073f8744539a4297fd652f3...d8bfd3955d4fedbe45a7dcb7c2a533bf0e3a9ef7,1,0,1,1,1,2011-04-25 05:59:09,2011-04-25 05:59:09
d8bfd3955d4fedbe45a7dcb7c2a533bf0e3a9ef7...1b6670dd590ef8f235166ce966d28ac49f322c54,2,19,3,22,3,2011-04-26 11:28:50,2011-04-26 11:28:50
1b6670dd590ef8f235166ce966d28ac49f322c54...930371e91b03f91691fa5e2e4f428cb72469e191,5,42,2,44,10,2011-04-26 16:49:32,2011-04-26 16:49:32
930371e91b03f91691fa5e2e4f428cb72469e191...2f9c52dc900f9cf689af23fbe5b4947ef97a924f,2,4,3,7,3,2011-04-26 16:56:17,2011-04-26 16:56:17
2f9c52dc900f9cf689af23fbe5b4947ef97a924f...c85b765288b2c36c948493a99706550eaf41a0b5,4,36,7,43,8,2011-04-27 15:46:43,2011-04-27 15:46:43
c85b765288b2c36c948493a99706550eaf41a0b5...04654e554ff5fe048275624b75fa5f9279aff175,1,4,2,6,3,2011-04-27 15:47:16,2011-04-27 15:47:16
04654e554ff5fe048275624b75fa5f9279aff175...2706fdbc87037976c3165beb5b9b73e000ff479b,3,6,2,8,3,2011-04-27 17:51:43,2011-04-27 17:51:43
2706fdbc87037976c3165beb5b9b73e000ff479b...6d98cda03cc759fb1d60b15684dc7b969abf5477,1,11,0,11,1,2011-04-28 00:20:10,2011-04-28 00:20:10
6d98cda03cc759fb1d60b15684dc7b969abf5477...e5cf560783cb76b9732520b54acb12a4261019df,1,10,0,10,1,2011-04-28 00:26:31,2011-04-28 00:26:31
e5cf560783cb76b9732520b54acb12a4261019df...fe7695533d00d4e593bcdba09f20da167bd27e7a,1,1,1,2,1,2011-04-28 00:28:42,2011-04-28 00:28:42
fe7695533d00d4e593bcdba09f20da167bd27e7a...013ce8aca2c0637ab53c2f94356111bfbb066668,1,1,1,2,1,2011-04-28 01:46:46,2011-04-28 01:46:46
013ce8aca2c0637ab53c2f94356111bfbb066668...086ab44336cd919ae6a90950f436e71b85d174a6,3,65,24,89,16,2011-04-28 13:04:16,2011-04-28 13:04:16
086ab44336cd919ae6a90950f436e71b85d174a6...07854d1c44fcf1243afeec087f31651fd5c2264b,3,88,8,96,11,2011-04-28 13:20:33,2011-04-28 13:20:33
07854d1c44fcf1243afeec087f31651fd5c2264b...2ac4f175ec7ec5f6122d079e7f1dbac4800e7657,5,46,1,47,5,2011-04-28 13:41:28,2011-04-28 13:41:28
2ac4f175ec7ec5f6122d079e7f1dbac4800e7657...cf11e3789b6643cf451d79d675a97c4de94542b0,2,16,4,20,5,2011-04-28 14:08:53,2011-04-28 14:08:53
cf11e3789b6643cf451d79d675a97c4de94542b0...7b129a82b3418edba3e26fe654f303df184a3efc,2,35,4,39,3,2011-04-28 14:19:25,2011-04-28 14:19:25
7b129a82b3418edba3e26fe654f303df184a3efc...f459169170910c3d94ee916ed79e2b9ff48915a2,2,33,1,34,3,2011-04-28 14:54:09,2011-04-28 14:54:09
f459169170910c3d94ee916ed79e2b9ff48915a2...79afd552788400bbcb8d399df1336ec7100eabd9,5,56,1,57,8,2011-04-29 11:49:59,2011-04-29 11:49:59
79afd552788400bbcb8d399df1336ec7100eabd9...e99fa0c47f5e9aed39c666ca90af5cd680102a4e,1,10,0,10,1,2011-04-29 12:03:02,2011-04-29 12:03:02
e99fa0c47f5e9aed39c666ca90af5cd680102a4e...22892c31f6b3dbc292f7a24051986a105d22bab6,1,0,12,12,1,2011-04-29 15:11:08,2011-04-29 15:11:08
22892c31f6b3dbc292f7a24051986a105d22bab6...0fa8bd3d92efd96d5760e39c7dd24ac70329d338,3,42,8,50,3,2011-04-29 15:11:17,2011-04-29 15:11:17
0fa8bd3d92efd96d5760e39c7dd24ac70329d338...12a9107a7da1a1d7dde6cc0e347990ad82785254,1,1,1,2,1,2011-04-29 15:11:24,2011-04-29 15:11:24
12a9107a7da1a1d7dde6cc0e347990ad82785254...1d7c2dedcd92e5234b8093acefed084d4e0756d7,1,3,3,6,3,2011-04-30 02:19:24,2011-04-30 02:19:24
1d7c2dedcd92e5234b8093acefed084d4e0756d7...2830872d608fb4da2e5965fc2a91ddc50eb16f70,1,4,0,4,1,2011-04-30 12:59:24,2011-04-30 12:59:24
2830872d608fb4da2e5965fc2a91ddc50eb16f70...13b4f98b8088cdf66c616625483dee5d1a302c0a,1,23,19,42,2,2011-04-30 13:37:03,2011-04-30 13:37:03
13b4f98b8088cdf66c616625483dee5d1a302c0a...c78d861c244c953023ad8a128a0749d077b4e356,2,3,2,5,3,2011-04-30 13:40:05,2011-04-30 13:40:05
c78d861c244c953023ad8a128a0749d077b4e356...4b93bd8b3a29913fef56c1090738e03c6205a453,1,6,0,6,1,2011-04-30 14:00:15,2011-04-30 14:00:15
4b93bd8b3a29913fef56c1090738e03c6205a453...817f03f63fe2948188b6fc9a2216427c6f06aafa,1,1,3,4,3,2011-04-30 22:24:08,2011-04-30 22:24:08
817f03f63fe2948188b6fc9a2216427c6f06aafa...b49900d2175830d82d8ed1cd9828b60fec19480d,1,1,1,2,1,2011-04-30 22:51:48,2011-04-30 22:51:48
b49900d2175830d82d8ed1cd9828b60fec19480d...980455969eca41494ce997ccbcef44e4670a38b4,1,1,5,6,1,2011-05-01 03:06:03,2011-05-01 03:06:03
980455969eca41494ce997ccbcef44e4670a38b4...da3aa22d04d6452f87abbb1a0fee8a90a61eff5b,3,78,36,114,20,2011-05-01 16:14:57,2011-05-01 16:14:57
da3aa22d04d6452f87abbb1a0fee8a90a61eff5b...0b1a061881ff49b0d56c48e026da421a68318a89,24,114,143,257,154,2011-05-01 16:46:02,2011-05-01 16:46:02
0b1a061881ff49b0d56c48e026da421a68318a89...5487ec803937cbb3e6b979883c69ef1eead1403d,1,2,1,3,1,2011-05-01 20:08:55,2011-05-01 20:08:55
5487ec803937cbb3e6b979883c69ef1eead1403d...c21d3afaef09f84e9512405d258d63d4111e68a8,1,1,1,2,1,2011-05-03 03:15:28,2011-05-03 03:15:28
c21d3afaef09f84e9512405d258d63d4111e68a8...a85cd1688b7a4468a4836b892f35480dc16ad331,1,1,1,2,1,2011-05-03 10:22:49,2011-05-03 10:22:49
a85cd1688b7a4468a4836b892f35480dc16ad331...18d2f4a81611fa4051ccdcfb9dd443f3a247102e,16,1153,574,1727,42,2011-05-03 10:44:23,2011-05-03 10:44:23
18d2f4a81611fa4051ccdcfb9dd443f3a247102e...48cffd9e459d8aaf9d1afa36f4e07f9624b2c4ad,2,19,0,19,2,2011-05-03 11:51:37,2011-05-03 11:51:37
48cffd9e459d8aaf9d1afa36f4e07f9624b2c4ad...41a1a89e4ede058f35f2ff6da18a828ac059d785,28,111,104,215,92,2011-05-03 11:52:04,2011-05-03 11:52:04
41a1a89e4ede058f35f2ff6da18a828ac059d785...f4860448ddad760172b4dde0323140e99d78a55f,10,187,161,348,21,2011-05-03 11:52:20,2011-05-03 11:52:20
f4860448ddad760172b4dde0323140e99d78a55f...8ce352c21d9ce4c59fcd259103350772954a6f8e,2,3,1,4,2,2011-05-03 11:52:30,2011-05-03 11:52:30
8ce352c21d9ce4c59fcd259103350772954a6f8e...950e05c3ff5daa360c3bddb84831d40b167062f1,5,215,1,216,6,2011-05-03 11:52:42,2011-05-03 11:52:42
950e05c3ff5daa360c3bddb84831d40b167062f1...05b4f2ebc2f547d2413f738551f9933aae0d34dc,3,29,10,39,5,2011-05-03 13:52:39,2011-05-03 13:52:39
05b4f2ebc2f547d2413f738551f9933aae0d34dc...f4464864c825cf534776c23beab84e79466b140d,1,1,1,2,1,2011-05-04 17:36:34,2011-05-04 17:36:34
f4464864c825cf534776c23beab84e79466b140d...95dc7c74868a2c829e8589f28fe292af062b8c68,3,102,27,129,24,2011-05-04 22:52:04,2011-05-04 22:52:04
95dc7c74868a2c829e8589f28fe292af062b8c68...ab0e3cff0eae076558c53f7710942d6aee9724ed,0,0,0,0,0,2011-05-04 22:54:22,2011-05-04 22:54:22
ab0e3cff0eae076558c53f7710942d6aee9724ed...367e51e6a1d0b6ffe5a9a6f2462ae146ad0b8d4e,1,1,1,2,1,2011-05-04 22:56:20,2011-05-04 22:56:20
367e51e6a1d0b6ffe5a9a6f2462ae146ad0b8d4e...127f1e4190265a3caf1a0dba6071582256feb2af,1,2,2,4,1,2011-05-04 23:44:26,2011-05-04 23:44:26
127f1e4190265a3caf1a0dba6071582256feb2af...23b32c75545e1f48e059fae125f94314a99dcb89,2,22,8,30,2,2011-05-05 00:09:51,2011-05-05 00:09:51
23b32c75545e1f48e059fae125f94314a99dcb89...970ae0162012185e441aa4a204c0f8b381975a47,1,2,2,4,2,2011-05-05 00:29:16,2011-05-05 00:29:16
970ae0162012185e441aa4a204c0f8b381975a47...db5807bdb1f242cc928e2fdf7110cb20af34790f,3,41,1,42,4,2011-05-05 20:26:26,2011-05-05 20:26:26
db5807bdb1f242cc928e2fdf7110cb20af34790f...171df93170df23d2fea1f8320ddb80c6f6444ff7,7,165,34,199,22,2011-05-05 20:49:26,2011-05-05 20:49:26
171df93170df23d2fea1f8320ddb80c6f6444ff7...d11acfd20959ec0d1baf93f8521e1077337b9c3b,1,1,1,2,1,2011-05-05 20:49:35,2011-05-05 20:49:35
d11acfd20959ec0d1baf93f8521e1077337b9c3b...8eccb728ccd97a07b9281d3a7c2c6bac105f285f,3,18,4,22,5,2011-05-05 22:03:17,2011-05-05 22:03:17
8eccb728ccd97a07b9281d3a7c2c6bac105f285f...21027a05c2b82045c376d5fef1c9f5502238e684,1,2,2,4,2,2011-05-05 23:11:03,2011-05-05 23:11:03
21027a05c2b82045c376d5fef1c9f5502238e684...0dc6420b3ebddd7bc2a0059b225d54ac19d4d901,3,70,4,74,8,2011-05-06 13:29:24,2011-05-06 13:29:24
0dc6420b3ebddd7bc2a0059b225d54ac19d4d901...71ec87fed83c0fb23f131d11f30031eeaa79ed77,2,23,0,23,3,2011-05-06 13:29:32,2011-05-06 13:29:32
71ec87fed83c0fb23f131d11f30031eeaa79ed77...7dd72360a2ab3a3a7ca74922da670c7361a9abb3,7,242,349,591,76,2011-05-06 13:29:44,2011-05-06 13:29:44
7dd72360a2ab3a3a7ca74922da670c7361a9abb3...8f3e1c1c63d3d3b36715afa9095e04142c4507e2,7,207,49,256,61,2011-05-06 13:29:58,2011-05-06 13:29:58
8f3e1c1c63d3d3b36715afa9095e04142c4507e2...b0d274dbd56c9ecb2e883554dc7a41408642371d,9,9,0,9,9,2011-05-06 19:49:06,2011-05-06 19:49:06
b0d274dbd56c9ecb2e883554dc7a41408642371d...4d039d8d05e931878527d1c0f7af5eed0469b3cc,1,1,1,2,1,2011-05-07 10:47:11,2011-05-07 10:47:11
4d039d8d05e931878527d1c0f7af5eed0469b3cc...032b4ab5dfc39b8166d472ae5e360f985afe2988,2,8,8,16,8,2011-05-07 16:58:35,2011-05-07 16:58:35
032b4ab5dfc39b8166d472ae5e360f985afe2988...0322f2b6533852b51d83ac4d55f11d75cc0f41b0,4,19,4,23,7,2011-05-07 16:58:45,2011-05-07 16:58:45
0322f2b6533852b51d83ac4d55f11d75cc0f41b0...e282e1b3272238af26cbfdf7d05d3184bcbf8123,1,2,0,2,1,2011-05-07 16:58:52,2011-05-07 16:58:52
e282e1b3272238af26cbfdf7d05d3184bcbf8123...c5f58f54fde93935bbc42ef1c3ee841933a30893,1,1,2,3,1,2011-05-07 16:58:58,2011-05-07 16:58:58
c5f58f54fde93935bbc42ef1c3ee841933a30893...02b837d38a37239dcd7366e7735e12aff51ab790,2,19,7,26,6,2011-05-07 16:59:08,2011-05-07 16:59:08
02b837d38a37239dcd7366e7735e12aff51ab790...eb24b546340d500502278bd124dbd527963ca4c4,4,35,0,35,5,2011-05-07 16:59:16,2011-05-07 16:59:16
eb24b546340d500502278bd124dbd527963ca4c4...fe96214939b76d1e7389b1c569d833e96e3a5074,4,28,9,37,11,2011-05-07 16:59:25,2011-05-07 16:59:25
fe96214939b76d1e7389b1c569d833e96e3a5074...2abd7af4ddd4d4cc83d2e3a52da1c76b10cd5a31,2,28,4,32,5,2011-05-07 16:59:33,2011-05-07 16:59:33
2abd7af4ddd4d4cc83d2e3a52da1c76b10cd5a31...32bd953e632ffaf6c1d4f8514600986e729ecb66,3,16,16,32,16,2011-05-07 17:05:06,2011-05-07 17:05:06
32bd953e632ffaf6c1d4f8514600986e729ecb66...385ae343fbd2355a09ba0f459445bf04406db60b,2,10,0,10,3,2011-05-07 19:02:51,2011-05-07 19:02:51
385ae343fbd2355a09ba0f459445bf04406db60b...688abe3b8dcfc007c7244ca0047a64feda445cdc,3,36,42,78,30,2011-05-07 19:55:51,2011-05-07 19:55:51
688abe3b8dcfc007c7244ca0047a64feda445cdc...161b94ef7bbdba2f8106871be796f5d703727a3f,4,84,20,104,10,2011-05-09 01:10:40,2011-05-09 01:10:40
161b94ef7bbdba2f8106871be796f5d703727a3f...ae1866ddef01753028124e2b73656a39a01ceff4,1,14,3,17,2,2011-05-09 15:40:01,2011-05-09 15:40:01
ae1866ddef01753028124e2b73656a39a01ceff4...1d350a6c51848edcb24f12a1d1c1add5cd3642fe,1,2,3,5,2,2011-05-09 18:27:28,2011-05-09 18:27:28
1d350a6c51848edcb24f12a1d1c1add5cd3642fe...eadcbcb131f2231ffcfa5c83a41c12f70f0a9af5,1,54,0,54,1,2011-05-09 18:27:36,2011-05-09 18:27:36
eadcbcb131f2231ffcfa5c83a41c12f70f0a9af5...b5da093fa92040df583048850c910ed7b42f536b,1,23,15,38,5,2011-05-09 18:27:45,2011-05-09 18:27:45
b5da093fa92040df583048850c910ed7b42f536b...5df93d529d6dd375adaf2f1c2dbd5814e26bad2f,1,43,17,60,11,2011-05-09 18:27:52,2011-05-09 18:27:52
5df93d529d6dd375adaf2f1c2dbd5814e26bad2f...7c648ea4aa2339cf0492d8c8da031dccce5458b1,1,5,0,5,1,2011-05-09 19:06:49,2011-05-09 19:06:49
7c648ea4aa2339cf0492d8c8da031dccce5458b1...e9342e9b3200bb55d92e67a3b9be7392a3e54b56,1,5,1,6,1,2011-05-09 19:06:57,2011-05-09 19:06:57
e9342e9b3200bb55d92e67a3b9be7392a3e54b56...b6c5f8060d45a7cffe42928a4b67b6a4e2ba9264,3,71,2,73,7,2011-05-09 21:35:24,2011-05-09 21:35:24
b6c5f8060d45a7cffe42928a4b67b6a4e2ba9264...8122ce7c766ab12d2d9bc5389514850ef7b22ac2,1,1,1,2,1,2011-05-09 22:30:31,2011-05-09 22:30:31
8122ce7c766ab12d2d9bc5389514850ef7b22ac2...bf7af2be15a0844f5c1ae9a47cb75fc255e0eaf6,2,8,2,10,3,2011-05-09 22:59:52,2011-05-09 22:59:52
bf7af2be15a0844f5c1ae9a47cb75fc255e0eaf6...d3641d889b0cf6fde3ca7d08530ed55331a0607d,1,2,1,3,1,2011-05-09 23:00:02,2011-05-09 23:00:02
d3641d889b0cf6fde3ca7d08530ed55331a0607d...a75120927e52210c062cd54d1cf2a6968b507cf5,1,47,19,66,3,2011-05-09 23:00:10,2011-05-09 23:00:10
a75120927e52210c062cd54d1cf2a6968b507cf5...8cbcf1d3a60a0ba1a6f3ddde9317ac07b67c6c5d,5,76,8,84,8,2011-05-09 23:00:22,2011-05-09 23:00:22
8cbcf1d3a60a0ba1a6f3ddde9317ac07b67c6c5d...cb060f0f340356ac71ed7db5399753edce278766,4,65,16,81,9,2011-05-09 23:45:54,2011-05-09 23:45:54
cb060f0f340356ac71ed7db5399753edce278766...396bc58889005f9524edeef2ed9a13f49adc84a1,1,1,1,2,1,2011-05-09 23:46:02,2011-05-09 23:46:02
396bc58889005f9524edeef2ed9a13f49adc84a1...39517438e0ed6c6fb2c72722e5adc42046320949,1,8,7,15,2,2011-05-10 00:19:02,2011-05-10 00:19:02
39517438e0ed6c6fb2c72722e5adc42046320949...014cc896bc266d3bb8e62942f9666a6ae2b0b8d9,1,20,3,23,1,2011-05-10 00:26:32,2011-05-10 00:26:32
014cc896bc266d3bb8e62942f9666a6ae2b0b8d9...724c84fe90d87c3a090160ef89b7647ce8d41e81,2,15,1,16,2,2011-05-10 12:20:47,2011-05-10 12:20:47
724c84fe90d87c3a090160ef89b7647ce8d41e81...5e39ada245ef9824ce73725e5d77f5941ce2920f,1,13,7,20,1,2011-05-10 18:49:04,2011-05-10 18:49:04
5e39ada245ef9824ce73725e5d77f5941ce2920f...6e9067623b8701b9a210438ad90a21b81967b1ed,1,1,1,2,1,2011-05-10 20:16:39,2011-05-10 20:16:39
6e9067623b8701b9a210438ad90a21b81967b1ed...73721912e2bd4d08d7bfaa641b8158ec09542dd7,1,1,0,1,1,2011-05-11 08:58:58,2011-05-11 08:58:58
73721912e2bd4d08d7bfaa641b8158ec09542dd7...4d26f6512c82f258795953fae799efce3a79fac9,1,12,2,14,2,2011-05-11 21:29:14,2011-05-11 21:29:14
4d26f6512c82f258795953fae799efce3a79fac9...71a7466dd67bd7cf88b4ce06535d8db0af6c7200,1,2,2,4,2,2011-05-12 03:03:16,2011-05-12 03:03:16
71a7466dd67bd7cf88b4ce06535d8db0af6c7200...ae3fec0da8eae3d8cce13ce55a3928360e2506ac,2,3,3,6,3,2011-05-12 13:24:07,2011-05-12 13:24:07
ae3fec0da8eae3d8cce13ce55a3928360e2506ac...df6e0314080afcd6a96c3769807991d52072b2a1,1,1,1,2,1,2011-05-13 00:48:30,2011-05-13 00:48:30
df6e0314080afcd6a96c3769807991d52072b2a1...5ecb88c146c7b4d1adb046d65c43a0b75283c03d,27,40,40,80,40,2011-05-13 04:33:42,2011-05-13 04:33:42
5ecb88c146c7b4d1adb046d65c43a0b75283c03d...1d7fa75c97f0a00de22c25ddfded1ad3e64b5ede,3,83,18,101,13,2011-05-13 12:15:52,2011-05-13 12:15:52
1d7fa75c97f0a00de22c25ddfded1ad3e64b5ede...e127e17b49429e344952bfe7e44d909388a06f19,1,1,0,1,1,2011-05-14 02:58:58,2011-05-14 02:58:58
e127e17b49429e344952bfe7e44d909388a06f19...5f605678f073967a4a7bae5c1e9c59fbc0ae0620,2,2,31,33,4,2011-05-14 12:28:36,2011-05-14 12:28:36
5f605678f073967a4a7bae5c1e9c59fbc0ae0620...2b5730873bd29e5bb449df5800dea610c462786a,3,76,56,132,11,2011-05-14 16:29:39,2011-05-14 16:29:39
2b5730873bd29e5bb449df5800dea610c462786a...c2ba96d8a949a5b55312aef2e183a5620bc2ed8d,1,3,3,6,1,2011-05-14 17:44:10,2011-05-14 17:44:10
c2ba96d8a949a5b55312aef2e183a5620bc2ed8d...c5cb2fabd260749f33a78bcdb5909e3fcca90cfc,1,6,7,13,4,2011-05-14 17:58:32,2011-05-14 17:58:32
c5cb2fabd260749f33a78bcdb5909e3fcca90cfc...07bfc76ecf22bfcd0cdbabe6af8639db2a0253dd,3,26,2,28,6,2011-05-15 00:56:01,2011-05-15 00:56:01
07bfc76ecf22bfcd0cdbabe6af8639db2a0253dd...ce6072aa963a0a8ec9e4330668f3ffecb907411b,1,25,0,25,1,2011-05-15 19:11:57,2011-05-15 19:11:57
ce6072aa963a0a8ec9e4330668f3ffecb907411b...66fd824ee08d7cbb1f359c981d9079f7c82beb70,1,1,0,1,1,2011-05-15 23:02:36,2011-05-15 23:02:36
66fd824ee08d7cbb1f359c981d9079f7c82beb70...9ad005ec1c50e254dd61bbb1760c524aa01a79e2,1,8,30,38,9,2011-05-17 10:15:58,2011-05-17 10:15:58
9ad005ec1c50e254dd61bbb1760c524aa01a79e2...578a31fea3cb439f6bfeeb7825ac835820a9f58c,5,177,85,262,40,2011-05-17 10:16:12,2011-05-17 10:16:12
578a31fea3cb439f6bfeeb7825ac835820a9f58c...ee8f6ca4054dc74f2846a3639dcdb7dc8c8b18b3,2,22,1,23,3,2011-05-17 12:45:02,2011-05-17 12:45:02
ee8f6ca4054dc74f2846a3639dcdb7dc8c8b18b3...091c9b530e3f27cadaaf952a304bfcb2fd639567,2,58,52,110,24,2011-05-18 09:51:24,2011-05-18 09:51:24
091c9b530e3f27cadaaf952a304bfcb2fd639567...a3a53e0b7364c7f9bf3a2f1551dc527505051974,7,216,69,285,36,2011-05-18 12:08:53,2011-05-18 12:08:53
a3a53e0b7364c7f9bf3a2f1551dc527505051974...5dec36de15cafd1e51f33acfd12b7b07d82a192c,1,0,9,9,1,2011-05-18 12:30:22,2011-05-18 12:30:22
5dec36de15cafd1e51f33acfd12b7b07d82a192c...8ecda079a88d625002c5bbc12740077a51f70da4,1,3,3,6,3,2011-05-18 19:39:50,2011-05-18 19:39:50
8ecda079a88d625002c5bbc12740077a51f70da4...840530cc55e0dedd637f81738ed8f9c27baba467,1,4,4,8,2,2011-05-18 20:10:41,2011-05-18 20:10:41
840530cc55e0dedd637f81738ed8f9c27baba467...9f02d80b580a4c8a9fe951c0ea3e6f82fb1cde03,1,2,2,4,2,2011-05-18 20:33:12,2011-05-18 20:33:12
9f02d80b580a4c8a9fe951c0ea3e6f82fb1cde03...26156794f12a392e18bc0aa6cb8ff8a4007459ed,1,65,55,120,35,2011-05-20 00:51:25,2011-05-20 00:51:25
26156794f12a392e18bc0aa6cb8ff8a4007459ed...30e5d7e85e8da364d96dd1aba3769b0a48fb726c,1,0,1,1,1,2011-05-20 01:45:30,2011-05-20 01:45:30
30e5d7e85e8da364d96dd1aba3769b0a48fb726c...bce125e84f58715b52132167fa97802624970205,1,28,22,50,11,2011-05-20 01:45:41,2011-05-20 01:45:41
bce125e84f58715b52132167fa97802624970205...90e8e48239085a793d34b1bd18a7834bbb46920a,1,1,1,2,1,2011-05-20 02:14:30,2011-05-20 02:14:30
90e8e48239085a793d34b1bd18a7834bbb46920a...803a454aefaca780d0614a8053f3bfe8a76e6876,1,21,19,40,4,2011-05-20 02:42:28,2011-05-20 02:42:28
803a454aefaca780d0614a8053f3bfe8a76e6876...15793309e16dcdf5de17594eaef1962a7c35ce31,2,35,8,43,2,2011-05-21 13:12:23,2011-05-21 13:12:23
15793309e16dcdf5de17594eaef1962a7c35ce31...f60d42846365b2bf2f1c9bc7a3007c303122a20b,18,741,0,741,20,2011-05-21 14:41:14,2011-05-21 14:41:14
f60d42846365b2bf2f1c9bc7a3007c303122a20b...a8598c7de2d600fa4c3b4e6d80c2fafb9063215b,2,15,0,15,2,2011-05-21 16:54:25,2011-05-21 16:54:25
a8598c7de2d600fa4c3b4e6d80c2fafb9063215b...50ad59527cc61e7764b6e1ecd8189ae6494bdc3f,4,14,12,26,6,2011-05-21 18:36:01,2011-05-21 18:36:01
50ad59527cc61e7764b6e1ecd8189ae6494bdc3f...940d17409e53658c510c1ae4962312b02e5ccaa4,2,16,16,32,12,2011-05-22 00:08:13,2011-05-22 00:08:13
940d17409e53658c510c1ae4962312b02e5ccaa4...80d60890290768267230dfcff7e70a1343fdbc25,1,1,1,2,1,2011-05-22 00:12:48,2011-05-22 00:12:48
80d60890290768267230dfcff7e70a1343fdbc25...fc8116cc4f5f27911c7685649ebac0a96fb39a49,3,17,5,22,7,2011-05-22 15:05:29,2011-05-22 15:05:29
fc8116cc4f5f27911c7685649ebac0a96fb39a49...d95355b6db0a457130bce22bb1dbf1a48731dfc6,3,15,2,17,4,2011-05-22 15:21:03,2011-05-22 15:21:03
d95355b6db0a457130bce22bb1dbf1a48731dfc6...909e002808135ee943643e6b1866e9aa5cb0b42d,2,19,3,22,2,2011-05-22 15:51:22,2011-05-22 15:51:22
909e002808135ee943643e6b1866e9aa5cb0b42d...6443adc9a904b0e2b3ac79104defd27202ff2032,1,3,1,4,2,2011-05-22 16:43:50,2011-05-22 16:43:50
6443adc9a904b0e2b3ac79104defd27202ff2032...dab90dd429c7ba02994ba27af03680646979783d,1,1,1,2,1,2011-05-22 16:59:45,2011-05-22 16:59:45
dab90dd429c7ba02994ba27af03680646979783d...fcf7fbc68cadb7efd8bc779c0e189389d6475463,6,71,14,85,13,2011-05-22 23:56:42,2011-05-22 23:56:42
fcf7fbc68cadb7efd8bc779c0e189389d6475463...17a6bb0f700dcdf422d88dcb110b76098e948674,1,5,6,11,4,2011-05-23 01:52:49,2011-05-23 01:52:49
17a6bb0f700dcdf422d88dcb110b76098e948674...4c4e46e64656e6038793e024bc97d0d1afc63d8a,2,15,7,22,5,2011-05-23 13:23:00,2011-05-23 13:23:00
4c4e46e64656e6038793e024bc97d0d1afc63d8a...55c2c302c1693b00de99235622c2a415d96d7f95,1,43,28,71,2,2011-05-23 16:08:36,2011-05-23 16:08:36
55c2c302c1693b00de99235622c2a415d96d7f95...e683beb6079122cd8ab90909ea8c4e7a6cfde36c,4,23,29,52,7,2011-05-23 16:08:45,2011-05-23 16:08:45
e683beb6079122cd8ab90909ea8c4e7a6cfde36c...c0303f5d8160d4a31bc46947e0a901d4eea2d201,1,14,2,16,5,2011-05-23 18:54:02,2011-05-23 18:54:02
c0303f5d8160d4a31bc46947e0a901d4eea2d201...4a4b6b271e681ce1c68bc0f10eb90355896e1a91,6,33,14,47,11,2011-05-24 09:17:55,2011-05-24 09:17:55
4a4b6b271e681ce1c68bc0f10eb90355896e1a91...d7036e52ab856b9e7125391cddcd18c08b5b0938,2,6,4,10,4,2011-05-24 18:39:28,2011-05-24 18:39:28
d7036e52ab856b9e7125391cddcd18c08b5b0938...a482cc0ba38febda15194dc121989eed3b6deec2,5,88,7,95,8,2011-05-24 21:28:43,2011-05-24 21:28:43
a482cc0ba38febda15194dc121989eed3b6deec2...0065d8a120843e843ec139386fac9dd76d721079,1,3,1,4,2,2011-05-24 21:33:32,2011-05-24 21:33:32
0065d8a120843e843ec139386fac9dd76d721079...723b620c7edab47561d6387c7db3ace2f3b7aa16,2,66,2,68,5,2011-05-26 08:21:35,2011-05-26 08:21:35
723b620c7edab47561d6387c7db3ace2f3b7aa16...c3db0b058c832f6f275f97d8e2e40c8e6f9f7e99,1,6,2,8,2,2011-05-26 21:03:56,2011-05-26 21:03:56
c3db0b058c832f6f275f97d8e2e40c8e6f9f7e99...20fbfbadcd79feab5077b84cbbed2b5908e685f3,1,3,1,4,2,2011-05-27 04:06:23,2011-05-27 04:06:23
20fbfbadcd79feab5077b84cbbed2b5908e685f3...69cfee2f167f64c15de6bfcd6b9779534132db2f,1,39,54,93,48,2011-05-27 04:22:37,2011-05-27 04:22:37
69cfee2f167f64c15de6bfcd6b9779534132db2f...407f62fd31689b6158902d3ffdcde64aa27679a7,18,1805,1749,3554,42,2011-05-27 10:49:47,2011-05-27 10:49:47
407f62fd31689b6158902d3ffdcde64aa27679a7...d0716044ddc2c629ee459af00b2b876c5d8c0a3d,1,12,4,16,4,2011-05-27 10:55:07,2011-05-27 10:55:07
d0716044ddc2c629ee459af00b2b876c5d8c0a3d...afca4e93490a8c9457ebfa6140158660a78df5d8,1,9,9,18,7,2011-05-27 17:05:16,2011-05-27 17:05:16
afca4e93490a8c9457ebfa6140158660a78df5d8...d34bb3c833751e49d3647ae1eea837178707d803,2,50,6,56,8,2011-05-28 13:06:08,2011-05-28 13:06:08
d34bb3c833751e49d3647ae1eea837178707d803...8f4d394c743ffe20bab880d00b8115461451e8b8,1,19,503,522,29,2011-05-28 21:28:52,2011-05-28 21:28:52
8f4d394c743ffe20bab880d00b8115461451e8b8...61da3cc47ae9f0c02fc8469f81d77dbd8b3c8961,18,18,18,36,18,2011-05-29 12:47:30,2011-05-29 12:47:30
61da3cc47ae9f0c02fc8469f81d77dbd8b3c8961...49f57a5d28c175b24c215e6329f5fc12a5cccc34,32,215,199,414,128,2011-05-29 17:41:04,2011-05-29 17:41:04
49f57a5d28c175b24c215e6329f5fc12a5cccc34...f7b251be33527bcb34623a23e6e71341f53c2930,1,68,102,170,44,2011-05-29 23:26:44,2011-05-29 23:26:44
f7b251be33527bcb34623a23e6e71341f53c2930...8ad3c41c69be9b58caef85ef6dde7e07ee299beb,1,1,1,2,1,2011-05-30 12:11:10,2011-05-30 12:11:10
8ad3c41c69be9b58caef85ef6dde7e07ee299beb...de3b58d6267a01edefb36c22f80c3399c819d465,3,28,4,32,5,2011-05-30 16:04:25,2011-05-30 16:04:25
de3b58d6267a01edefb36c22f80c3399c819d465...dc4c2f3add4f15edf05574e6e8eb101be9da4b90,2,37,2,39,3,2011-05-30 16:33:23,2011-05-30 16:33:23
dc4c2f3add4f15edf05574e6e8eb101be9da4b90...524c5fa07a38cc68a81a12428befdafcfde1afc3,13,453,1,454,16,2011-05-30 22:27:47,2011-05-30 22:27:47
524c5fa07a38cc68a81a12428befdafcfde1afc3...0994416d3f2dbe4a6428213274aef8a91e717c04,1,2,2,4,2,2011-05-30 22:50:11,2011-05-30 22:50:11
0994416d3f2dbe4a6428213274aef8a91e717c04...caefdc824665f24d083c03fbf96e6b5303dba37c,3,3,3,6,3,2011-05-31 09:42:19,2011-05-31 09:42:19
caefdc824665f24d083c03fbf96e6b5303dba37c...93e9d91501914e37ef8dfe7a9e355be9d2e9c538,8,39,20,59,18,2011-05-31 14:02:22,2011-05-31 14:02:22
93e9d91501914e37ef8dfe7a9e355be9d2e9c538...45317677008a71c261b8c00388e8c2555a96598c,9,20,5,25,10,2011-05-31 15:19:19,2011-05-31 15:19:19
45317677008a71c261b8c00388e8c2555a96598c...1cfb00dc4164f7a5342c1866a50485b1c2845cb7,3,17,36,53,8,2011-05-31 15:43:19,2011-05-31 15:43:19
1cfb00dc4164f7a5342c1866a50485b1c2845cb7...1a951fa8d474fc9e6114cf63b8ba012233c9afcd,1,10,0,10,1,2011-05-31 21:29:35,2011-05-31 21:29:35
1a951fa8d474fc9e6114cf63b8ba012233c9afcd...632dfa233839f8c76bd6b065b8420fe0ab96175a,39,2594,344,2938,152,2011-06-01 13:47:00,2011-06-01 13:47:00
632dfa233839f8c76bd6b065b8420fe0ab96175a...60cf3f2f842b6e56132b8880c70acc87bd753c2e,2,49,38,87,18,2011-06-01 15:30:06,2011-06-01 15:30:06
60cf3f2f842b6e56132b8880c70acc87bd753c2e...9abe734b83a03525fc63396a4af70dedc0a12817,2,2,2,4,2,2011-06-01 20:14:25,2011-06-01 20:14:25
9abe734b83a03525fc63396a4af70dedc0a12817...06279e454a54077fd04da477457fb2bbf0c6e470,2,6,5,11,6,2011-06-01 20:45:47,2011-06-01 20:45:47
06279e454a54077fd04da477457fb2bbf0c6e470...236708939204fca2a04e63bd7dd3b717feea70a8,1,3,3,6,3,2011-06-01 22:09:50,2011-06-01 22:09:50
236708939204fca2a04e63bd7dd3b717feea70a8...2304ca423640a7b06390530bf61c879f9ff9e4ba,2,20,1,21,5,2011-06-01 23:17:40,2011-06-01 23:17:40
2304ca423640a7b06390530bf61c879f9ff9e4ba...65cc646c4801e3f3e1df1ab06dfaa763fa4b7b22,1,0,11,11,1,2011-06-02 00:24:37,2011-06-02 00:24:37
65cc646c4801e3f3e1df1ab06dfaa763fa4b7b22...78b37975c9d9f331b9ea9fa609d0596ae30ab6b4,1,24,1,25,4,2011-06-02 12:19:32,2011-06-02 12:19:32
78b37975c9d9f331b9ea9fa609d0596ae30ab6b4...5434ce231d75004bdbe5cf2b7b24ce67a2a6e737,11,323,71,394,44,2011-06-02 16:18:47,2011-06-02 16:18:47
5434ce231d75004bdbe5cf2b7b24ce67a2a6e737...16ee37235459437309b97bda1d1c9054250b7e9e,1,1,1,2,1,2011-06-02 16:42:19,2011-06-02 16:42:19
16ee37235459437309b97bda1d1c9054250b7e9e...22598d0044d0e69f57011836e5dd5caa4d441e59,1,0,0,0,0,2011-06-02 19:50:48,2011-06-02 19:50:48
22598d0044d0e69f57011836e5dd5caa4d441e59...cb996cce059ec6f384d7ee9b67df6208c92eb719,4,117,51,168,22,2011-06-03 11:54:29,2011-06-03 11:54:29
cb996cce059ec6f384d7ee9b67df6208c92eb719...74b16162902864c59c63fcb7936f604a738aecee,3,95,36,131,13,2011-06-03 11:54:39,2011-06-03 11:54:39
74b16162902864c59c63fcb7936f604a738aecee...832ca058feecf1e80dcbe7cc38b655f8f4a6ebd4,2,12,2,14,5,2011-06-03 11:54:47,2011-06-03 11:54:47
832ca058feecf1e80dcbe7cc38b655f8f4a6ebd4...39005c2b847e0ea9816f2bbd308a03c73589b9e2,2,2,2,4,1,2011-06-03 13:43:23,2011-06-03 13:43:23
39005c2b847e0ea9816f2bbd308a03c73589b9e2...d41a25ebc6f1cc8214989838a5994199e9b152be,2,5,3,8,2,2011-06-04 14:32:55,2011-06-04 14:32:55
d41a25ebc6f1cc8214989838a5994199e9b152be...773e1717c0fbad45b3baab6a3026670e322301ad,1,3,3,6,1,2011-06-04 14:38:45,2011-06-04 14:38:45
773e1717c0fbad45b3baab6a3026670e322301ad...acbb911ad5ab6160bbbf5ee510d3097124d5cca2,1,7,1,8,3,2011-06-04 15:29:11,2011-06-04 15:29:11
acbb911ad5ab6160bbbf5ee510d3097124d5cca2...070151293d474d01324d95fc858b1148aaaf5091,1,1,1,2,1,2011-06-04 17:05:38,2011-06-04 17:05:38
070151293d474d01324d95fc858b1148aaaf5091...fc508fd5d2257d02947942adf9eeadca61d000c4,1,5,8,13,3,2011-06-04 21:42:53,2011-06-04 21:42:53
fc508fd5d2257d02947942adf9eeadca61d000c4...0b7fc04691f838e644d9526208aabcbe928c8fac,8,9,9,18,9,2011-06-04 21:51:13,2011-06-04 21:51:13
0b7fc04691f838e644d9526208aabcbe928c8fac...0638ba5bba14a0051aa7390b6f595907957c0e12,3,46,5,51,7,2011-06-05 23:44:34,2011-06-05 23:44:34
0638ba5bba14a0051aa7390b6f595907957c0e12...d14eb13992e782b2dfa7f2633b38a87e34efd45e,1,1,3,4,2,2011-06-06 12:11:48,2011-06-06 12:11:48
d14eb13992e782b2dfa7f2633b38a87e34efd45e...64e19ffb4ee32767861d25c874f0d2dfc75618b7,6,494,8,502,12,2011-06-07 16:11:25,2011-06-07 16:11:25
64e19ffb4ee32767861d25c874f0d2dfc75618b7...684b0396cfff1c4343a83bd600db69af9188986d,2,23,2,25,3,2011-06-07 16:15:54,2011-06-07 16:15:54
684b0396cfff1c4343a83bd600db69af9188986d...fcf8312ade4375faf6027afe610fb76bcdead084,3,16,6,22,11,2011-06-07 20:51:59,2011-06-07 20:51:59
fcf8312ade4375faf6027afe610fb76bcdead084...7a600166a7bac4b657bc9d8dac948ddde043a629,1,1,1,2,1,2011-06-07 20:59:07,2011-06-07 20:59:07
7a600166a7bac4b657bc9d8dac948ddde043a629...b67ff14208049e90310c4c312036116ee620c295,2,7,7,14,2,2011-06-07 21:17:41,2011-06-07 21:17:41
b67ff14208049e90310c4c312036116ee620c295...bb12a02bd8cd6e33b947b2cfa01292822099bb19,5,44,4,48,14,2011-06-08 11:12:01,2011-06-08 11:12:01
bb12a02bd8cd6e33b947b2cfa01292822099bb19...45e55b91435541203f517770c654675f67fa6a3b,14,738,29,767,45,2011-06-08 22:18:46,2011-06-08 22:18:46
45e55b91435541203f517770c654675f67fa6a3b...207e3ed9d58fabe68477aa62f7ef41464f1761e9,3,96,24,120,29,2011-06-08 22:53:55,2011-06-08 22:53:55
207e3ed9d58fabe68477aa62f7ef41464f1761e9...cb2c669d147c9f14ec0cc4ffa9f2633e6add6fac,1,2,2,4,2,2011-06-08 23:09:32,2011-06-08 23:09:32
cb2c669d147c9f14ec0cc4ffa9f2633e6add6fac...38878b599a454b1e044f8269570965148ca533f0,1,0,3,3,1,2011-06-09 11:14:53,2011-06-09 11:14:53
38878b599a454b1e044f8269570965148ca533f0...716601109a010f838e46abd1e971617581dbe9ba,2,23,7,30,9,2011-06-09 12:45:11,2011-06-09 12:45:11
716601109a010f838e46abd1e971617581dbe9ba...7f6675a5fb5a11b00ecf61f1fceaa914d42daa01,2,3,9,12,4,2011-06-09 13:13:19,2011-06-09 13:13:19
7f6675a5fb5a11b00ecf61f1fceaa914d42daa01...865d684a8af8e3ef7a11c43df861e1a69b0d8cd4,6,35,5,40,9,2011-06-09 15:05:13,2011-06-09 15:05:13
865d684a8af8e3ef7a11c43df861e1a69b0d8cd4...dfcde78161866ad2c2c863c0a8c48480c3228f84,4,7,2,9,4,2011-06-09 15:39:12,2011-06-09 15:39:12
dfcde78161866ad2c2c863c0a8c48480c3228f84...dce278673a409a10c1f74f597035b737bbf6a017,3,16,2,18,8,2011-06-09 17:03:45,2011-06-09 17:03:45
dce278673a409a10c1f74f597035b737bbf6a017...da0c7cd7778ee99a31587276faee30e94a8255ae,1,12,36,48,15,2011-06-09 19:35:44,2011-06-09 19:35:44
da0c7cd7778ee99a31587276faee30e94a8255ae...dff31de20aac85e4f4834c2466762cbf23fc0a7b,20,65,115,180,41,2011-06-09 20:01:28,2011-06-09 20:01:28
dff31de20aac85e4f4834c2466762cbf23fc0a7b...db2f9bfae173b565215a9f7320d7a45d0532f2fe,5,91,84,175,11,2011-06-09 23:15:42,2011-06-09 23:15:42
db2f9bfae173b565215a9f7320d7a45d0532f2fe...b56ef75088e17fa3555766e92a6747411ccd738c,3,28,14,42,10,2011-06-09 23:51:03,2011-06-09 23:51:03
b56ef75088e17fa3555766e92a6747411ccd738c...046ffa483ed63faae7b31e7e2cf618f88a3312ba,6,148,11,159,19,2011-06-10 08:26:05,2011-06-10 08:26:05
046ffa483ed63faae7b31e7e2cf618f88a3312ba...9e952be26f7d26a90b06a05d3948283943320b7a,2,27,1,28,3,2011-06-10 08:39:38,2011-06-10 08:39:38
9e952be26f7d26a90b06a05d3948283943320b7a...430b819967054805c49c0a27fb9f039568ee240f,11,24,29,53,18,2011-06-10 10:18:06,2011-06-10 10:18:06
430b819967054805c49c0a27fb9f039568ee240f...66436ad171d8c442037bb03e9bc1a0f99e194ac8,2,4,1,5,3,2011-06-10 10:22:42,2011-06-10 10:22:42
66436ad171d8c442037bb03e9bc1a0f99e194ac8...44a2cbad35c9b43569ad3dcf43a3dd74dcd71953,2,24,20,44,7,2011-06-10 11:54:42,2011-06-10 11:54:42
44a2cbad35c9b43569ad3dcf43a3dd74dcd71953...4dac0883f00ae7eb64c01488c53f50074efb9695,1,3,1,4,2,2011-06-10 12:16:56,2011-06-10 12:16:56
4dac0883f00ae7eb64c01488c53f50074efb9695...aa5506d6f69180820db8f1811b4c8780d39a5733,4,1283,1415,2698,9,2011-06-10 14:08:51,2011-06-10 14:08:51
aa5506d6f69180820db8f1811b4c8780d39a5733...41895618205d2dd0f2118b93e1ee7879dffe6223,1,2,0,2,1,2011-06-10 14:49:44,2011-06-10 14:49:44
41895618205d2dd0f2118b93e1ee7879dffe6223...528157ce73e4e7d9ee65c362d0cb4013eb17c5f0,6,180,0,180,8,2011-06-10 15:14:36,2011-06-10 15:14:36
528157ce73e4e7d9ee65c362d0cb4013eb17c5f0...0e03a504bf28c727283bcabbff0f4dc63feaf573,1,6,5,11,3,2011-06-10 16:18:40,2011-06-10 16:18:40
0e03a504bf28c727283bcabbff0f4dc63feaf573...c43d15b3b329c0dcd2bfeda9b647641f1dcfeaf6,5,12,17,29,17,2011-06-10 18:43:29,2011-06-10 18:43:29
c43d15b3b329c0dcd2bfeda9b647641f1dcfeaf6...87571cdb3758458c2df61a1ff6a3a086797cafb6,1,2,2,4,2,2011-06-11 09:34:57,2011-06-11 09:34:57
87571cdb3758458c2df61a1ff6a3a086797cafb6...ce3c281090320172d22e8a6057250d103c93438e,23,708,5,713,32,2011-06-11 13:48:24,2011-06-11 13:48:24
ce3c281090320172d22e8a6057250d103c93438e...7f68d06c983cab8d415d5efd520a272eecdd06f3,1,1,1,2,1,2011-06-11 15:11:46,2011-06-11 15:11:46
7f68d06c983cab8d415d5efd520a272eecdd06f3...703498b1c86678c287de8a44c08724b4e67c4e40,6,55,24,79,14,2011-06-11 15:11:56,2011-06-11 15:11:56
703498b1c86678c287de8a44c08724b4e67c4e40...4ab5a43785418a8bb46bcc480a1cf73bde631e2f,2,21,0,21,3,2011-06-11 15:27:12,2011-06-11 15:27:12
4ab5a43785418a8bb46bcc480a1cf73bde631e2f...5dc7be2192ffe8b400df1921599fa1acb165bbcf,1,8,0,8,1,2011-06-11 15:43:51,2011-06-11 15:43:51
5dc7be2192ffe8b400df1921599fa1acb165bbcf...d77514e428fa6735525a152061cc9350c5952544,1,6,0,6,3,2011-06-11 15:44:00,2011-06-11 15:44:00
d77514e428fa6735525a152061cc9350c5952544...4970ef07c2f6e33da26232703e542b926a1fd2e7,1,2,0,2,1,2011-06-11 15:45:14,2011-06-11 15:45:14
4970ef07c2f6e33da26232703e542b926a1fd2e7...d27f909d2e8e215dc9c52d090cee393a719a7965,5,33,8,41,13,2011-06-11 16:05:28,2011-06-11 16:05:28
d27f909d2e8e215dc9c52d090cee393a719a7965...0ebaf10258bf9fad4d540025a6eb3a8c471b284c,4,61,1,62,9,2011-06-11 16:22:45,2011-06-11 16:22:45
0ebaf10258bf9fad4d540025a6eb3a8c471b284c...55005a518196b60764a2d6b5bada6872ab1f49b4,1,10,0,10,1,2011-06-11 18:48:09,2011-06-11 18:48:09
55005a518196b60764a2d6b5bada6872ab1f49b4...e096d56406b93220f03c495282fd6d0d297f3851,1,10,1,11,2,2011-06-11 19:27:32,2011-06-11 19:27:32
e096d56406b93220f03c495282fd6d0d297f3851...a0791b2759b475fda9ffea31154d5e436ffdd00f,2,28,7,35,4,2011-06-11 20:40:02,2011-06-11 20:40:02
a0791b2759b475fda9ffea31154d5e436ffdd00f...4207fed9328230ce8883eda959ab562290ff7d49,1,3,1,4,1,2011-06-11 23:40:59,2011-06-11 23:40:59
4207fed9328230ce8883eda959ab562290ff7d49...0686b0662a459150d61fff5bbbba06324a81b9aa,1,2,2,4,1,2011-06-12 00:28:11,2011-06-12 00:28:11
0686b0662a459150d61fff5bbbba06324a81b9aa...f0adae4c6e857cabdff790d20dff815a37645d6f,8,48,16,64,13,2011-06-12 12:34:10,2011-06-12 12:34:10
f0adae4c6e857cabdff790d20dff815a37645d6f...f749bb829c715237c33c48c146ae78e1ed23ae71,6,69,12,81,16,2011-06-12 13:04:53,2011-06-12 13:04:53
f749bb829c715237c33c48c146ae78e1ed23ae71...9f3d76a921d149f0edf09abf9b3373c0232158f6,1,1,1,2,1,2011-06-12 13:05:02,2011-06-12 13:05:02
9f3d76a921d149f0edf09abf9b3373c0232158f6...050e11956f8bf6589e8c93c6ccdbe5fc03e7e410,13,622,3,625,15,2011-06-12 13:31:40,2011-06-12 13:31:40
050e11956f8bf6589e8c93c6ccdbe5fc03e7e410...84c71148e37235396436fa4b03de137766a15c02,3,18,5,23,6,2011-06-12 16:33:40,2011-06-12 16:33:40
84c71148e37235396436fa4b03de137766a15c02...14bac2b97df03d98089e345976b0ec1463f0b5f7,1,2,2,4,1,2011-06-12 16:57:09,2011-06-12 16:57:09
14bac2b97df03d98089e345976b0ec1463f0b5f7...5112acbf8fd1b2e600ad0384f6ff847ea5a8b027,1,2,2,4,2,2011-06-12 23:22:34,2011-06-12 23:22:34
5112acbf8fd1b2e600ad0384f6ff847ea5a8b027...7116c31373020f173370b2c29ad3894b747af818,1,1,0,1,1,2011-06-12 23:50:37,2011-06-12 23:50:37
7116c31373020f173370b2c29ad3894b747af818...13efd1046526808815e727093daca0ae3bf538f2,1,1,0,1,1,2011-06-13 04:31:56,2011-06-13 04:31:56
13efd1046526808815e727093daca0ae3bf538f2...c013c07ed7908b009cfd2ccc511e3e635c66f3d6,1,12,12,24,3,2011-06-13 13:23:49,2011-06-13 13:23:49
c013c07ed7908b009cfd2ccc511e3e635c66f3d6...bcad22655fab64ae70d8b27bba67fb028c0211b1,1,1,1,2,1,2011-06-13 17:38:17,2011-06-13 17:38:17
bcad22655fab64ae70d8b27bba67fb028c0211b1...bead688a3bde7ba0225a3421e49fb767078e3498,2,4,4,8,4,2011-06-13 17:48:02,2011-06-13 17:48:02
bead688a3bde7ba0225a3421e49fb767078e3498...479f2bce3c1dbfc53f37627ed751673b170dccc0,1,0,1,1,1,2011-06-13 20:15:04,2011-06-13 20:15:04
479f2bce3c1dbfc53f37627ed751673b170dccc0...823bac36db2e4679d03fdc36e318da779767cac6,3,12,5,17,5,2011-06-13 20:15:13,2011-06-13 20:15:13
823bac36db2e4679d03fdc36e318da779767cac6...5180e733faf4c7c650fbf3e70955b3fbfd66855c,1,1,1,2,1,2011-06-14 09:30:52,2011-06-14 09:30:52
5180e733faf4c7c650fbf3e70955b3fbfd66855c...3ee076b1355f888133b9f5915e9118066ee2acc1,1,5,5,10,5,2011-06-14 10:34:52,2011-06-14 10:34:52
3ee076b1355f888133b9f5915e9118066ee2acc1...b5e7eab9fddb981e0e20a663c76604e7d0c9a42a,3,43,2,45,7,2011-06-14 10:35:02,2011-06-14 10:35:02
b5e7eab9fddb981e0e20a663c76604e7d0c9a42a...3d970762af059656aba487d3ff4281adf578130f,3,15,15,30,15,2011-06-14 10:35:13,2011-06-14 10:35:13
3d970762af059656aba487d3ff4281adf578130f...3f37d1673bb8826e1648f77143b94356c5886e16,2,9,18,27,7,2011-06-14 10:45:49,2011-06-14 10:45:49
3f37d1673bb8826e1648f77143b94356c5886e16...06a2515145d8a5e6ee67da1f1849f157e23c6578,1,1,1,2,1,2011-06-14 23:31:45,2011-06-14 23:31:45
06a2515145d8a5e6ee67da1f1849f157e23c6578...4047a21fa8f9fd1fee136663c60ab334ac298ec2,1,3,0,3,1,2011-06-14 23:37:12,2011-06-14 23:37:12
4047a21fa8f9fd1fee136663c60ab334ac298ec2...62bb4b8c37ada04c10d2a37990326636ea7791d6,2,104,63,167,24,2011-06-15 10:48:13,2011-06-15 10:48:13
62bb4b8c37ada04c10d2a37990326636ea7791d6...896e3c69c7eec311085da349a329ee80c8fca132,29,751,58,809,69,2011-06-15 17:29:10,2011-06-15 17:29:10
896e3c69c7eec311085da349a329ee80c8fca132...28e5341bf4655d7e653753c48af7c4fe7787a734,1,2,0,2,1,2011-06-15 23:52:44,2011-06-15 23:52:44
28e5341bf4655d7e653753c48af7c4fe7787a734...e008fde23e58a716804f0f5f334e3a44f2c170c6,1,2,2,4,2,2011-06-16 15:27:11,2011-06-16 15:27:11
e008fde23e58a716804f0f5f334e3a44f2c170c6...662b372d022d0f638e62a3d4e3118f00a4fcce3d,2,257,98,355,43,2011-06-16 15:27:19,2011-06-16 15:27:19
662b372d022d0f638e62a3d4e3118f00a4fcce3d...a1991e37f4757ea1f4a195296dbd586e4a5c90ee,1,1,1,2,1,2011-06-16 16:33:47,2011-06-16 16:33:47
a1991e37f4757ea1f4a195296dbd586e4a5c90ee...c80914d0d19ba51ab14d9de09ae2e80824aefc03,1,1,1,2,1,2011-06-16 16:33:54,2011-06-16 16:33:54
c80914d0d19ba51ab14d9de09ae2e80824aefc03...439cbeaa684ce881db000d6a01f70930c426ac7f,2,22,14,36,2,2011-06-16 16:34:02,2011-06-16 16:34:02
439cbeaa684ce881db000d6a01f70930c426ac7f...aad6f21b29946bf4cc78d5d28330497cb916e35f,4,268,8,276,9,2011-06-16 16:34:12,2011-06-16 16:34:12
aad6f21b29946bf4cc78d5d28330497cb916e35f...44b03484ec0ec8843d34becbce1d4f0649066627,2,4,0,4,2,2011-06-16 16:34:20,2011-06-16 16:34:20
44b03484ec0ec8843d34becbce1d4f0649066627...aa40dc6252b00af15973a9075de48f9462fabdcd,1,1,1,2,1,2011-06-16 16:34:28,2011-06-16 16:34:28
aa40dc6252b00af15973a9075de48f9462fabdcd...22529d41b26137ac87c5e08a6c19e6e91552756e,2,26,1,27,3,2011-06-16 16:34:38,2011-06-16 16:34:38
22529d41b26137ac87c5e08a6c19e6e91552756e...dfa29161e2eff676eb4aa187f76c157556dfc5db,2,8,1,9,2,2011-06-16 16:34:46,2011-06-16 16:34:46
dfa29161e2eff676eb4aa187f76c157556dfc5db...97f22f29699476d5bcbbf599a3dba22909f4ec85,3,30,0,30,3,2011-06-16 16:34:55,2011-06-16 16:34:55
97f22f29699476d5bcbbf599a3dba22909f4ec85...30e842632e6ed95828241fb62f50eb1da9e4019c,2,20,3,23,5,2011-06-16 16:35:04,2011-06-16 16:35:04
30e842632e6ed95828241fb62f50eb1da9e4019c...b4cdf4d111e2a536abddeb38d029e71bb0d41ddb,5,55,20,75,12,2011-06-16 16:41:14,2011-06-16 16:41:14
b4cdf4d111e2a536abddeb38d029e71bb0d41ddb...b2f5efc6ac59e3341b2d617510137707f214e18f,2,57,2,59,3,2011-06-16 19:56:22,2011-06-16 19:56:22
b2f5efc6ac59e3341b2d617510137707f214e18f...b870bf6b9a4ac44331e97bce8b95cc44447580fa,4,24,51,75,8,2011-06-16 20:05:25,2011-06-16 20:05:25
b870bf6b9a4ac44331e97bce8b95cc44447580fa...fffe983da14424342fd4dd42de077d132711182f,1,3,3,6,3,2011-06-17 07:39:03,2011-06-17 07:39:03
fffe983da14424342fd4dd42de077d132711182f...222a5ed69e174e6b7b123c1101744e18aa372a4a,1,1,10,11,2,2011-06-17 09:47:01,2011-06-17 09:47:01
222a5ed69e174e6b7b123c1101744e18aa372a4a...838a16ec2055cd9736c9d426acf9fdd092e72469,2,20,24,44,7,2011-06-17 09:47:08,2011-06-17 09:47:08
838a16ec2055cd9736c9d426acf9fdd092e72469...ce165f7bbf0c481a20db6b4b9f764b8bb89348ba,4,24,4,28,10,2011-06-17 13:08:36,2011-06-17 13:08:36
ce165f7bbf0c481a20db6b4b9f764b8bb89348ba...54393493effd69b8e5a0362333ef74856accd312,1,1,1,2,1,2011-06-17 14:09:00,2011-06-17 14:09:00
54393493effd69b8e5a0362333ef74856accd312...98a69a2c0a9d6a57cc637b0e9a998495fc0bcbd7,1,18,9,27,4,2011-06-17 15:39:21,2011-06-17 15:39:21
98a69a2c0a9d6a57cc637b0e9a998495fc0bcbd7...2a122be0fc92f12df16eeac65c9dc48516cf499a,2,31,0,31,2,2011-06-17 15:39:28,2011-06-17 15:39:28
2a122be0fc92f12df16eeac65c9dc48516cf499a...f8a3d87a199a54305a0f50e24a00fa253fa43766,1,8,0,8,1,2011-06-17 15:39:35,2011-06-17 15:39:35
f8a3d87a199a54305a0f50e24a00fa253fa43766...65d8657f7f07de3b3cc6c6d1ddfb836c2658b23f,1,12,0,12,2,2011-06-17 15:39:42,2011-06-17 15:39:42
65d8657f7f07de3b3cc6c6d1ddfb836c2658b23f...1dfa567a23a1b81eb90b29ff250337a679a40dfa,2,2,2,4,2,2011-06-18 08:48:25,2011-06-18 08:48:25
1dfa567a23a1b81eb90b29ff250337a679a40dfa...89277c7f6e19c51bd8da91e5ed09845a1df17c9d,1,1,1,2,1,2011-06-18 11:58:50,2011-06-18 11:58:50
89277c7f6e19c51bd8da91e5ed09845a1df17c9d...ac4d015703868b6ebee93f690431d92dda04194b,2,1,2,3,2,2011-06-18 11:59:32,2011-06-18 11:59:32
ac4d015703868b6ebee93f690431d92dda04194b...63f9b6712909970693a9e509d13218856306bbd6,3,6,5,11,4,2011-06-19 11:24:25,2011-06-19 11:24:25
63f9b6712909970693a9e509d13218856306bbd6...656360c24044e06c881baa648f2aad9d671c3bd8,9,84,57,141,55,2011-06-19 11:24:39,2011-06-19 11:24:39
656360c24044e06c881baa648f2aad9d671c3bd8...f2dca72afd89160580454abe5a90e0b4c6be196e,4,59,29,88,10,2011-06-19 18:00:09,2011-06-19 18:00:09
f2dca72afd89160580454abe5a90e0b4c6be196e...df45e35661fbbb888465552910b9996019f193c8,2,1,1,2,1,2011-06-19 19:25:26,2011-06-19 19:25:26
df45e35661fbbb888465552910b9996019f193c8...b9ea5e163e4aff4fafaa863ee9d10614a92c564a,1,1,1,2,1,2011-06-19 19:40:18,2011-06-19 19:40:18
b9ea5e163e4aff4fafaa863ee9d10614a92c564a...9eb2afddfa0165d69f3e506122c2aa2b68618591,1,1,6,7,2,2011-06-19 19:54:20,2011-06-19 19:54:20
9eb2afddfa0165d69f3e506122c2aa2b68618591...43503b093a35ca4707c16d865f10929960bfa0b8,12,285,5,290,16,2011-06-22 06:01:44,2011-06-22 06:01:44
43503b093a35ca4707c16d865f10929960bfa0b8...e3a845de6a31554abe7ca6be247cda5bdd15edf4,1,6,6,12,5,2011-06-22 12:20:52,2011-06-22 12:20:52
e3a845de6a31554abe7ca6be247cda5bdd15edf4...53a25206c2728585c7410d572f3e88041edf16ba,1,1,1,2,1,2011-06-25 08:41:58,2011-06-25 08:41:58
53a25206c2728585c7410d572f3e88041edf16ba...219a79421745b90b2e8976b7a83c3435c337237f,3,6,3,9,4,2011-06-25 12:39:29,2011-06-25 12:39:29
219a79421745b90b2e8976b7a83c3435c337237f...d257ab46711f54375d3f8f07d9dc783e031236b7,1,0,1,1,1,2011-06-25 12:39:38,2011-06-25 12:39:38
d257ab46711f54375d3f8f07d9dc783e031236b7...a3117699a5a06ed6c488c96738c335b5b5f065c0,1,31,34,65,12,2011-06-25 12:39:48,2011-06-25 12:39:48
a3117699a5a06ed6c488c96738c335b5b5f065c0...2d6dec24c43423f71895ab0fd1b41a0b5b6c2e8a,1,34,10,44,5,2011-06-25 12:39:57,2011-06-25 12:39:57
2d6dec24c43423f71895ab0fd1b41a0b5b6c2e8a...25c5251acd79293c8cbaef393ceb1db388262190,2,33,12,45,12,2011-06-25 13:14:31,2011-06-25 13:14:31
25c5251acd79293c8cbaef393ceb1db388262190...c159374a33caee14d9903de58a9f4fe879e5741c,2,9,3,12,3,2011-06-25 16:18:40,2011-06-25 16:18:40
c159374a33caee14d9903de58a9f4fe879e5741c...650739ef172049a294f53bf51b70f6bb2d3f5dd5,1,29,8,37,9,2011-06-26 16:51:12,2011-06-26 16:51:12
650739ef172049a294f53bf51b70f6bb2d3f5dd5...821d8aaaaad3f4d11f29eb54a7812f363b5f07cb,2,18,0,18,2,2011-06-26 16:51:25,2011-06-26 16:51:25
821d8aaaaad3f4d11f29eb54a7812f363b5f07cb...2619dc828510cf36791fcf87705d2f9ce3176c86,4,81,52,133,50,2011-06-26 16:51:34,2011-06-26 16:51:34
2619dc828510cf36791fcf87705d2f9ce3176c86...4a1033898636f8c2cafc74c7934fdf7411716fdf,6,143,70,213,18,2011-06-26 16:51:46,2011-06-26 16:51:46
4a1033898636f8c2cafc74c7934fdf7411716fdf...352b7ffaf039b3b7b112dd60a690101ecec70cf2,2,4,3,7,2,2011-06-26 16:51:54,2011-06-26 16:51:54
352b7ffaf039b3b7b112dd60a690101ecec70cf2...32ea1285abe91da7cc2a11df2c7608c407d51bf0,1,4,2,6,1,2011-06-26 16:52:01,2011-06-26 16:52:01
32ea1285abe91da7cc2a11df2c7608c407d51bf0...8c2099ae64e37dc46adcad77405c93af76f72f70,1,0,5,5,4,2011-06-26 16:52:07,2011-06-26 16:52:07
8c2099ae64e37dc46adcad77405c93af76f72f70...b4bd6bb78a45d8443b4228047cdfd8baa367b2bb,2,24,3,27,5,2011-06-26 16:52:13,2011-06-26 16:52:13
b4bd6bb78a45d8443b4228047cdfd8baa367b2bb...b9eb94e789c6f31047c6fa6b89654d0657605470,2,5,1,6,2,2011-06-26 16:52:21,2011-06-26 16:52:21
b9eb94e789c6f31047c6fa6b89654d0657605470...e0139910f19e356cc826dc6c4fc870ec18fb647d,3,29,17,46,15,2011-06-26 16:52:31,2011-06-26 16:52:31
e0139910f19e356cc826dc6c4fc870ec18fb647d...8882c55496444d0238fa85e2e7849e79fff9e5e2,3,17,17,34,14,2011-06-26 16:52:38,2011-06-26 16:52:38
8882c55496444d0238fa85e2e7849e79fff9e5e2...df2d9bb3f3f95c26d27c1ad337bc32e648773e7a,1,1,1,2,1,2011-06-26 16:52:43,2011-06-26 16:52:43
df2d9bb3f3f95c26d27c1ad337bc32e648773e7a...bc56c76a1738522e0ffb9a1e7869f894df8dab5c,1,1,1,2,1,2011-06-26 16:52:50,2011-06-26 16:52:50
bc56c76a1738522e0ffb9a1e7869f894df8dab5c...c817f2f5449058c2787298d984167bf590ca7967,5,216,61,277,38,2011-06-26 17:00:24,2011-06-26 17:00:24
c817f2f5449058c2787298d984167bf590ca7967...20dc647ba82a03b0e8ce58c9040b69fe67e2d141,1,3,1,4,2,2011-06-26 19:22:53,2011-06-26 19:22:53
20dc647ba82a03b0e8ce58c9040b69fe67e2d141...bda5ed5700445a6c916d2ac7c45db1ed1897a974,1,4,3,7,2,2011-06-26 21:27:44,2011-06-26 21:27:44
bda5ed5700445a6c916d2ac7c45db1ed1897a974...0e27c4921048250c668dcb06e010a137de6f66e0,1,9,5,14,2,2011-06-27 03:32:10,2011-06-27 03:32:10
0e27c4921048250c668dcb06e010a137de6f66e0...d400ff4f139c05d205066ae07a30ac9156cb8468,1,1,1,2,1,2011-06-27 09:00:12,2011-06-27 09:00:12
d400ff4f139c05d205066ae07a30ac9156cb8468...f54135fa4dc9fd45d86ea2944191d58e00725779,3,17,2,19,4,2011-06-28 04:29:48,2011-06-28 04:29:48
f54135fa4dc9fd45d86ea2944191d58e00725779...dbffffa7dc95fc62cbecfd00284bde62ee796f48,3,45,7,52,5,2011-06-28 10:16:18,2011-06-28 10:16:18
dbffffa7dc95fc62cbecfd00284bde62ee796f48...3fe0c69332299dc1d518cc3a4f84bf435deecc1d,4,80,12,92,8,2011-06-28 10:16:34,2011-06-28 10:16:34
3fe0c69332299dc1d518cc3a4f84bf435deecc1d...60f0421ed3ea16ba78545eeabcde7a3dcdcb7cdd,1,6,4,10,4,2011-06-28 10:16:47,2011-06-28 10:16:47
60f0421ed3ea16ba78545eeabcde7a3dcdcb7cdd...54552ee29f5e24f6aefead31b7097252490c05f3,2,16,8,24,6,2011-06-28 10:17:01,2011-06-28 10:17:01
54552ee29f5e24f6aefead31b7097252490c05f3...f801e2c15dee8bf711bcccc932ef9f0ca89a0e8b,7,136,0,136,8,2011-06-28 10:17:23,2011-06-28 10:17:23
f801e2c15dee8bf711bcccc932ef9f0ca89a0e8b...0278947128cf478b47b0bc87ac0c2de0405b3d2a,1,3,3,6,3,2011-06-28 10:17:36,2011-06-28 10:17:36
0278947128cf478b47b0bc87ac0c2de0405b3d2a...a6cd78662e72188555027a459cbff2564d72a221,8,125,77,202,23,2011-06-28 10:17:56,2011-06-28 10:17:56
a6cd78662e72188555027a459cbff2564d72a221...940aed10b7bdd8f25aff38b8b923deb94ce4cee4,5,245,27,272,20,2011-06-28 10:44:33,2011-06-28 10:44:33
940aed10b7bdd8f25aff38b8b923deb94ce4cee4...6fe2a8bb3f964da1e5507e4d8d4ad1127bff1f05,2,1442,524,1966,127,2011-06-28 10:45:53,2011-06-28 10:45:53
6fe2a8bb3f964da1e5507e4d8d4ad1127bff1f05...f4aa39837a8b7a49baa938911a531e7d2eb05c2d,2,0,345,345,2,2011-06-28 13:42:46,2011-06-28 13:42:46
f4aa39837a8b7a49baa938911a531e7d2eb05c2d...230dab85c50e2e35781fe1a37b04ecffe6680003,1,0,1,1,1,2011-06-28 14:04:36,2011-06-28 14:04:36
230dab85c50e2e35781fe1a37b04ecffe6680003...b8f0346c11c9e02b1ec13db2d470f8e063a8de70,1,1,1,2,1,2011-06-29 13:52:27,2011-06-29 13:52:27
b8f0346c11c9e02b1ec13db2d470f8e063a8de70...89e0e8b6bc861bb95e55bd5e255e756fe3be1cf2,1,12,12,24,5,2011-06-29 15:12:48,2011-06-29 15:12:48
89e0e8b6bc861bb95e55bd5e255e756fe3be1cf2...38a2444277a84eb6b74425f0e324d1dceb7d2ef1,118,485,418,903,287,2011-06-30 09:06:19,2011-06-30 09:06:19
38a2444277a84eb6b74425f0e324d1dceb7d2ef1...0b58e4647efee2bf6490dd30baeb81a876c57e4a,0,0,0,0,0,2011-06-30 09:19:16,2011-06-30 09:19:16
0b58e4647efee2bf6490dd30baeb81a876c57e4a...286e45e9ea2d2b64eb919fe91d923991d27a6dd6,1,31,0,31,3,2011-07-01 15:18:27,2011-07-01 15:18:27
286e45e9ea2d2b64eb919fe91d923991d27a6dd6...3b127e3cd2802f4c282fab46700a609c7cc83f3b,1,1,1,2,1,2011-07-01 15:18:34,2011-07-01 15:18:34
3b127e3cd2802f4c282fab46700a609c7cc83f3b...d138906ad9a0e6a4c20a05200de8bb64c291ed66,4,52,44,96,23,2011-07-01 15:18:42,2011-07-01 15:18:42
d138906ad9a0e6a4c20a05200de8bb64c291ed66...1d270ac8a34b9a1f562d2e46411121499caa6e41,2,0,24,24,5,2011-07-03 16:20:48,2011-07-03 16:20:48
1d270ac8a34b9a1f562d2e46411121499caa6e41...3bd23ee96fdff0572568eaa42d69c1ce2e46cc18,2,29,2,31,2,2011-07-03 17:56:05,2011-07-03 17:56:05
3bd23ee96fdff0572568eaa42d69c1ce2e46cc18...c29e45491ea2e2a689299abda1b722ff814efd80,3,85,5,90,12,2011-07-03 17:56:15,2011-07-03 17:56:15
c29e45491ea2e2a689299abda1b722ff814efd80...43cb78fafde45fae9e057d29878c2ebf40aef873,3,15,8,23,10,2011-07-03 17:56:25,2011-07-03 17:56:25
43cb78fafde45fae9e057d29878c2ebf40aef873...f9fe112f2d65ea187ad47b280197664b551f339e,2,33,1,34,2,2011-07-03 17:56:33,2011-07-03 17:56:33
f9fe112f2d65ea187ad47b280197664b551f339e...332a485567420e844887344b6429d3b4db4b260b,5,89,11,100,8,2011-07-03 17:56:43,2011-07-03 17:56:43
332a485567420e844887344b6429d3b4db4b260b...6b31300057a3c2239dceab0b9f51e5e31132265b,2,6,5,11,4,2011-07-03 22:15:39,2011-07-03 22:15:39
6b31300057a3c2239dceab0b9f51e5e31132265b...a34e67031a09e69a50d748e5b493edbd6effb1ff,1,1,1,2,1,2011-07-04 04:06:11,2011-07-04 04:06:11
a34e67031a09e69a50d748e5b493edbd6effb1ff...286a1cad8839da3219dc3901540fb9422686e5ab,4,120,7,127,19,2011-07-04 09:52:06,2011-07-04 09:52:06
286a1cad8839da3219dc3901540fb9422686e5ab...87eb3a25aa7cca071b0768ae94a7914952af9eb3,2,0,2,2,2,2011-07-04 12:23:12,2011-07-04 12:23:12
87eb3a25aa7cca071b0768ae94a7914952af9eb3...a3733967e89d38e42c2094d887aa985ffe5e9916,2,3,2,5,2,2011-07-04 16:19:54,2011-07-04 16:19:54
a3733967e89d38e42c2094d887aa985ffe5e9916...7db68a888b633f2b65f753d50f21463b65a01edf,1,1,1,2,1,2011-07-04 16:20:03,2011-07-04 16:20:03
7db68a888b633f2b65f753d50f21463b65a01edf...c6ae0fa549a250fb862436587c88ae6ad81da90c,1,2,3,5,2,2011-07-04 16:20:10,2011-07-04 16:20:10
c6ae0fa549a250fb862436587c88ae6ad81da90c...cb2d8cd3a4f7fcaf65613aac0cad8522328de9f2,1,2,2,4,2,2011-07-04 16:20:16,2011-07-04 16:20:16
cb2d8cd3a4f7fcaf65613aac0cad8522328de9f2...8066fced3398405c5c2153ca33b3441ef7e1b2dc,1,6,1,7,2,2011-07-04 16:20:22,2011-07-04 16:20:22
8066fced3398405c5c2153ca33b3441ef7e1b2dc...c2a48110d47a281b4757401e6aeffd4f41c08825,1,1,1,2,1,2011-07-04 16:20:29,2011-07-04 16:20:29
c2a48110d47a281b4757401e6aeffd4f41c08825...94a38dfd0ea33c243c56eb91cfcb2618882edad0,4,114,53,167,40,2011-07-04 21:34:29,2011-07-04 21:34:29
94a38dfd0ea33c243c56eb91cfcb2618882edad0...6de65ab76ff7704c90c6de9d5954c7736325c3fb,4,47,11,58,8,2011-07-04 21:53:17,2011-07-04 21:53:17
6de65ab76ff7704c90c6de9d5954c7736325c3fb...90b6181657eafe1601ee90e4af26cd32cb301fb4,2,21,4,25,5,2011-07-05 09:10:58,2011-07-05 09:10:58
90b6181657eafe1601ee90e4af26cd32cb301fb4...2b2bec0cc96943c42f2f51cdc3331df4f2e33951,1,17,16,33,3,2011-07-05 09:40:29,2011-07-05 09:40:29
2b2bec0cc96943c42f2f51cdc3331df4f2e33951...b884990388245c5a5a5d8ba2ff3220515c3b54a5,1,16,13,29,7,2011-07-05 13:55:14,2011-07-05 13:55:14
b884990388245c5a5a5d8ba2ff3220515c3b54a5...b37dca1aec3afc88d91ec22030ec6bd5334affc0,1,0,1,1,1,2011-07-05 13:56:20,2011-07-05 13:56:20
b37dca1aec3afc88d91ec22030ec6bd5334affc0...89c302cf3f63f35161bdb2c09c849b30f35136e2,4,12,49,61,8,2011-07-05 14:16:37,2011-07-05 14:16:37
89c302cf3f63f35161bdb2c09c849b30f35136e2...8b34a010171d728e3e8c26b04ed46fcb386310c4,1,55,14,69,5,2011-07-05 20:09:00,2011-07-05 20:09:00
8b34a010171d728e3e8c26b04ed46fcb386310c4...471a841147ca9bb6a5cae8981be6d66ec42966a0,1,4,0,4,1,2011-07-05 20:16:08,2011-07-05 20:16:08
471a841147ca9bb6a5cae8981be6d66ec42966a0...901ea8a68d4aa064f2e72eeac5ca87968905673e,1,1,1,2,1,2011-07-06 00:21:32,2011-07-06 00:21:32
901ea8a68d4aa064f2e72eeac5ca87968905673e...21e0b3a243791deef803dddcb9e15d0a3b59af96,3,10,3,13,4,2011-07-06 10:28:18,2011-07-06 10:28:18
21e0b3a243791deef803dddcb9e15d0a3b59af96...569aa34ea5eec46ec0d899f4db682687964feec0,4,32,11,43,7,2011-07-06 23:25:30,2011-07-06 23:25:30
569aa34ea5eec46ec0d899f4db682687964feec0...f5c9c2246e4b01f8731550c2a10241ca0e0148e9,2,9,1,10,3,2011-07-06 23:44:54,2011-07-06 23:44:54
f5c9c2246e4b01f8731550c2a10241ca0e0148e9...b2050ff546da4164f90a795e55d7d8c55981783d,3,9,4,13,5,2011-07-07 01:12:45,2011-07-07 01:12:45
b2050ff546da4164f90a795e55d7d8c55981783d...ce89ebe1f06445e453e5bf18d868235d2e27a8d3,1,0,3,3,1,2011-07-07 21:46:02,2011-07-07 21:46:02
ce89ebe1f06445e453e5bf18d868235d2e27a8d3...68d18b8492c52e138994c62cc3336986a2002859,1,9,0,9,2,2011-07-08 00:39:59,2011-07-08 00:39:59
68d18b8492c52e138994c62cc3336986a2002859...319b0cfb83b07e46f3a23b7cb0dc1677da4b02eb,1,5,2,7,3,2011-07-08 09:39:56,2011-07-08 09:39:56
319b0cfb83b07e46f3a23b7cb0dc1677da4b02eb...6d029359e955a6a5fd7e4024ddd9159004c30d20,2,17,14,31,7,2011-07-08 12:07:54,2011-07-08 12:07:54
6d029359e955a6a5fd7e4024ddd9159004c30d20...823a231500f582b9fd7f02a82eb06c354a814218,1,8,8,16,8,2011-07-08 14:22:36,2011-07-08 14:22:36
823a231500f582b9fd7f02a82eb06c354a814218...ee7cac0806a00e819955d0cf156e94a3cd24ddb8,1,3,3,6,3,2011-07-09 12:19:29,2011-07-09 12:19:29
ee7cac0806a00e819955d0cf156e94a3cd24ddb8...54b9c03d8005fd37f2677e5759de42e5d61ca046,1,1,9,10,4,2011-07-10 13:52:04,2011-07-10 13:52:04
54b9c03d8005fd37f2677e5759de42e5d61ca046...723b5747933f8519708a1b75e1c01478151dec33,3,6,5,11,4,2011-07-10 19:35:05,2011-07-10 19:35:05
723b5747933f8519708a1b75e1c01478151dec33...4c5c8dca315058e2400104be0438af22a3ed61cf,1,1,1,2,1,2011-07-10 20:01:12,2011-07-10 20:01:12
4c5c8dca315058e2400104be0438af22a3ed61cf...8d6c2dad9dd4cf607a325255d65edb79a44dc8eb,1,1,1,2,1,2011-07-10 21:32:39,2011-07-10 21:32:39
8d6c2dad9dd4cf607a325255d65edb79a44dc8eb...4d920c5ecdac9ebb96ff88955a0ff0b7a3616fc6,1,5,2,7,3,2011-07-10 21:39:18,2011-07-10 21:39:18
4d920c5ecdac9ebb96ff88955a0ff0b7a3616fc6...86ac8c132799d6adb0a89f19972c9fae096f7772,1,18,0,18,2,2011-07-10 21:52:03,2011-07-10 21:52:03
86ac8c132799d6adb0a89f19972c9fae096f7772...956da729d19d619c210a2466d4435d4967249e7f,1,5,0,5,1,2011-07-12 00:08:37,2011-07-12 00:08:37
956da729d19d619c210a2466d4435d4967249e7f...24f4764a48e4141923a78c8820e4cd7b411ec0fc,242,307,484,791,329,2011-07-13 09:35:51,2011-07-13 09:35:51
24f4764a48e4141923a78c8820e4cd7b411ec0fc...12b7c2a702bea68e53c438fa2c7a4a01d890695d,4,36,13,49,9,2011-07-13 09:36:07,2011-07-13 09:36:07
12b7c2a702bea68e53c438fa2c7a4a01d890695d...3b774583711e39dae7a5cfde314288f8019f59c6,7,280,85,365,23,2011-07-14 13:47:10,2011-07-14 13:47:10
3b774583711e39dae7a5cfde314288f8019f59c6...99cd76e2734694d22861b7c224fd1e2dcb643fa0,1,5,0,5,1,2011-07-14 18:36:05,2011-07-14 18:36:05
99cd76e2734694d22861b7c224fd1e2dcb643fa0...9896b0df73d5fe49c7c315ddcabbd25aa7c706b4,1,9,8,17,2,2011-07-17 14:17:26,2011-07-17 14:17:26
9896b0df73d5fe49c7c315ddcabbd25aa7c706b4...0452d4c3cce8b41e01a21977cf35341712e70e7c,2,18,3,21,7,2011-07-17 22:22:39,2011-07-17 22:22:39
0452d4c3cce8b41e01a21977cf35341712e70e7c...8f7b5024b29321ff7b6995c6616558dca16104eb,4,181,3,184,4,2011-07-19 09:00:24,2011-07-19 09:00:24
8f7b5024b29321ff7b6995c6616558dca16104eb...127b7fdce8e89e5a8e349a7de817050ac5a64719,13,489,417,906,89,2011-07-19 13:16:09,2011-07-19 13:16:09
127b7fdce8e89e5a8e349a7de817050ac5a64719...b8db443437ae4d24331bd33ab3a91037f0927b2d,1,2,2,4,2,2011-07-19 17:19:32,2011-07-19 17:19:32
b8db443437ae4d24331bd33ab3a91037f0927b2d...afd8a47df7b66a52a310c62a6385d45f7c17c1a0,1,2,1,3,2,2011-07-25 09:19:47,2011-07-25 09:19:47
afd8a47df7b66a52a310c62a6385d45f7c17c1a0...34a71dc4e4c1f09da7fd47a566c4ae5965bc2f42,1,3,0,3,1,2011-07-25 22:18:59,2011-07-25 22:18:59
34a71dc4e4c1f09da7fd47a566c4ae5965bc2f42...6b80640fd7184352998414b33caf7b8f8671cb30,1,4,3,7,1,2011-07-26 08:27:23,2011-07-26 08:27:23
6b80640fd7184352998414b33caf7b8f8671cb30...d99b86d6c1287029f45bc043c2e004e5dc1bb9af,1,3,2,5,1,2011-07-26 08:47:46,2011-07-26 08:47:46
d99b86d6c1287029f45bc043c2e004e5dc1bb9af...4f50d248a888f04f3ba93b04aaf40aa65a7d5fee,1,9,0,9,1,2011-07-28 22:09:26,2011-07-28 22:09:26
4f50d248a888f04f3ba93b04aaf40aa65a7d5fee...db594f90ba684f45bfc8033fb190afdf567ad9f0,2,6,1,7,2,2011-07-29 09:39:23,2011-07-29 09:39:23
db594f90ba684f45bfc8033fb190afdf567ad9f0...dc2bfae1e57089675c76ae77fd6ecc38d976ccd9,4,7,6,13,5,2011-07-29 09:39:35,2011-07-29 09:39:35
dc2bfae1e57089675c76ae77fd6ecc38d976ccd9...c59a635624e83485960836f15a88ba24b63543c0,1,1,1,2,1,2011-07-29 09:39:42,2011-07-29 09:39:42
c59a635624e83485960836f15a88ba24b63543c0...441c4e08cdec1de95e5f551e74fdd295c3607139,1,1,1,2,1,2011-07-29 09:39:49,2011-07-29 09:39:49
441c4e08cdec1de95e5f551e74fdd295c3607139...f0280f2e94e9acdeb34547d49f9cad8c68aa3e83,1,1,1,2,1,2011-07-29 09:39:55,2011-07-29 09:39:55
f0280f2e94e9acdeb34547d49f9cad8c68aa3e83...643239e7df3b4e164b75847bbbb377d45da800a6,1,2,2,4,1,2011-07-29 09:40:02,2011-07-29 09:40:02
643239e7df3b4e164b75847bbbb377d45da800a6...50ed810c1ffcda2432cf1417d739a98c78f572b1,1,0,5,5,3,2011-07-29 09:40:09,2011-07-29 09:40:09
50ed810c1ffcda2432cf1417d739a98c78f572b1...fab483971cbef9f03d1c3270851db6cd0fdccc45,1,7,5,12,4,2011-07-29 09:40:15,2011-07-29 09:40:15
fab483971cbef9f03d1c3270851db6cd0fdccc45...8ac23178ad787f35e4e1f620ce417bc73b98a149,1,4,4,8,1,2011-07-29 09:40:22,2011-07-29 09:40:22
8ac23178ad787f35e4e1f620ce417bc73b98a149...9be03fe326f1129d0c5b5243e1c55563334a1656,1,0,1,1,1,2011-07-29 09:40:28,2011-07-29 09:40:28
9be03fe326f1129d0c5b5243e1c55563334a1656...7d1087521313c44192418766cd1c8b0808c37e1a,1,3,3,6,1,2011-07-29 09:40:35,2011-07-29 09:40:35
7d1087521313c44192418766cd1c8b0808c37e1a...94f74813969911a540b7d6b15bd42891ed2bf237,1,2,1,3,1,2011-07-29 09:40:43,2011-07-29 09:40:43
94f74813969911a540b7d6b15bd42891ed2bf237...5fffe574bdd624f69eb246ed0833d7a2aba16edb,2,87,43,130,22,2011-07-29 09:40:50,2011-07-29 09:40:50
5fffe574bdd624f69eb246ed0833d7a2aba16edb...2ccfb6d5c2ffb13ae3cb11a058ff574ab115518c,5,51,6,57,9,2011-07-29 09:41:00,2011-07-29 09:41:00
2ccfb6d5c2ffb13ae3cb11a058ff574ab115518c...4a6e1b56135b1a413576ea1a6d469387a1a5eb6d,11,210,0,210,16,2011-07-29 09:41:14,2011-07-29 09:41:14
4a6e1b56135b1a413576ea1a6d469387a1a5eb6d...0fbadfd1c8ce30fd4c9f2857d467047d5bfac63d,16,578,5,583,22,2011-07-29 10:20:16,2011-07-29 10:20:16
0fbadfd1c8ce30fd4c9f2857d467047d5bfac63d...343b4f1ea5ffc48c03138640a85a1781ccbf2964,3,19,2,21,6,2011-07-29 10:22:25,2011-07-29 10:22:25
343b4f1ea5ffc48c03138640a85a1781ccbf2964...5120f018daa8f2c7e3599b5a2c0d30775bb4ec21,1,1,1,2,1,2011-07-30 17:37:39,2011-07-30 17:37:39
5120f018daa8f2c7e3599b5a2c0d30775bb4ec21...ff9a66675301cf716a6af1a246636a6cfc4395fd,6,4,33,37,17,2011-07-30 19:09:23,2011-07-30 19:09:23
ff9a66675301cf716a6af1a246636a6cfc4395fd...f90449321b8cf69f567db49f81102751992fb7de,1,2,5,7,2,2011-07-30 19:22:43,2011-07-30 19:22:43
f90449321b8cf69f567db49f81102751992fb7de...56775c23eebf63495f86d41c93c60e9bc80d1ff3,1,1,0,1,1,2011-07-31 17:01:57,2011-07-31 17:01:57
56775c23eebf63495f86d41c93c60e9bc80d1ff3...290d7d4d21692336aeb074917acbf9804275fbdd,5,143,48,191,34,2011-08-01 23:38:11,2011-08-01 23:38:11
290d7d4d21692336aeb074917acbf9804275fbdd...cb1f413e4a154b3c5d308d3625d707685d79f912,1,20,21,41,2,2011-08-02 22:30:26,2011-08-02 22:30:26
cb1f413e4a154b3c5d308d3625d707685d79f912...815a47ff489321373e10cad253eecb13b1b1a531,1,1,1,2,1,2011-08-06 18:40:33,2011-08-06 18:40:33
815a47ff489321373e10cad253eecb13b1b1a531...953fed1e30ebe4fd4b5365bdd9ec92ecde36faba,1,1,1,2,1,2011-08-06 18:49:58,2011-08-06 18:49:58
953fed1e30ebe4fd4b5365bdd9ec92ecde36faba...bbe63f07c4a54f705636d3c34c6c05a5d76b085d,1,1,1,2,1,2011-08-06 18:54:21,2011-08-06 18:54:21
bbe63f07c4a54f705636d3c34c6c05a5d76b085d...0350d65fa493230c8be7bfe8a79bc5ac1a6c7aba,1,2,0,2,1,2011-08-06 19:02:20,2011-08-06 19:02:20
0350d65fa493230c8be7bfe8a79bc5ac1a6c7aba...e3c89346d217fca92b62a6d11df6b4b6d5be28a2,1,6,6,12,2,2011-08-06 20:34:04,2011-08-06 20:34:04
e3c89346d217fca92b62a6d11df6b4b6d5be28a2...be87f0b0ec992e6f3e72735d8e95c654da969f6d,16,356,23,379,31,2011-08-07 00:43:26,2011-08-07 00:43:26
be87f0b0ec992e6f3e72735d8e95c654da969f6d...4fc3741ee88493a7884708fb4a9170da31637294,4,36,2,38,4,2011-08-08 17:08:35,2011-08-08 17:08:35
4fc3741ee88493a7884708fb4a9170da31637294...27eb8bbfd09594e3f0f40391ca1a06b896acebdf,2,15,3,18,3,2011-08-10 22:26:34,2011-08-10 22:26:34
27eb8bbfd09594e3f0f40391ca1a06b896acebdf...e9a909e30ab63cc4faa28e4d9296f522bbe3bb06,1,8,7,15,7,2011-08-10 22:34:45,2011-08-10 22:34:45
e9a909e30ab63cc4faa28e4d9296f522bbe3bb06...1d32bdd3c9586ff10d0799264105850fa7e3f512,33,643,145,788,116,2011-08-11 14:07:39,2011-08-11 14:07:39
1d32bdd3c9586ff10d0799264105850fa7e3f512...42f256d512ce95d8f90f138ab34a4bdf5c42025b,2,0,282,282,2,2011-08-11 22:06:41,2011-08-11 22:06:41
42f256d512ce95d8f90f138ab34a4bdf5c42025b...21705bd97abde8a0ba2035634a0b6012b3e99411,1,1,0,1,1,2011-08-12 00:29:34,2011-08-12 00:29:34
21705bd97abde8a0ba2035634a0b6012b3e99411...4a993fab18892596242a0b22c8fbd6c3ae2dde57,1,14,4,18,6,2011-08-12 08:43:52,2011-08-12 08:43:52
4a993fab18892596242a0b22c8fbd6c3ae2dde57...bce890ace4a97ab7a7a9b918f1452c6592d9b08e,28,35,35,70,35,2011-08-12 14:14:15,2011-08-12 14:14:15
bce890ace4a97ab7a7a9b918f1452c6592d9b08e...d68666700fa3ca24701479bd0831c3dcfb9f5ab1,3,22,1,23,3,2011-08-12 14:14:24,2011-08-12 14:14:24
d68666700fa3ca24701479bd0831c3dcfb9f5ab1...cb1d660962ac89eda7956b70566ae2324b11ae9e,1,5,1,6,5,2011-08-12 14:14:33,2011-08-12 14:14:33
cb1d660962ac89eda7956b70566ae2324b11ae9e...e912edec20f4d81d1b5c1a02bede1632f3beaa83,1,2,1,3,3,2011-08-12 14:14:39,2011-08-12 14:14:39
e912edec20f4d81d1b5c1a02bede1632f3beaa83...3d027b72ebaf3fa41c9f6c17873fe3cee08d9007,3,119,0,119,4,2011-08-12 14:14:49,2011-08-12 14:14:49
3d027b72ebaf3fa41c9f6c17873fe3cee08d9007...386b12c1c668dd54d24704ef974e17b38abb825d,4,98,26,124,13,2011-08-12 14:14:58,2011-08-12 14:14:58
386b12c1c668dd54d24704ef974e17b38abb825d...1d485cf14ffa58dbeb130db2d50aa147556e0244,3,38,1,39,5,2011-08-12 14:15:08,2011-08-12 14:15:08
1d485cf14ffa58dbeb130db2d50aa147556e0244...958e049d4d90fb5e0fe582eb4339af3c58dd5c07,5,57,6,63,8,2011-08-12 14:15:17,2011-08-12 14:15:17
958e049d4d90fb5e0fe582eb4339af3c58dd5c07...1ca6e9b9e24240033349c93b05902c79c0a25bbb,10,103,12,115,16,2011-08-12 14:15:31,2011-08-12 14:15:31
1ca6e9b9e24240033349c93b05902c79c0a25bbb...351d5da69b994c2e390f8d33e66ce5836b0bf348,5,45,7,52,12,2011-08-12 14:15:41,2011-08-12 14:15:41
351d5da69b994c2e390f8d33e66ce5836b0bf348...02dcbe33171851bb8b658965a96460a458bc09a8,3,43,14,57,16,2011-08-12 14:15:50,2011-08-12 14:15:50
02dcbe33171851bb8b658965a96460a458bc09a8...a539d434d9451eb201d8b79b45740e192c1736ca,1,6,6,12,2,2011-08-12 14:15:56,2011-08-12 14:15:56
a539d434d9451eb201d8b79b45740e192c1736ca...326949e444bcdde966d2421e2fb8bd8c87c65941,13,299,292,591,136,2011-08-13 00:42:08,2011-08-13 00:42:08
326949e444bcdde966d2421e2fb8bd8c87c65941...e11c647d604168e565bf4802d5e95aa1ba339c76,1,1,1,2,1,2011-08-13 11:23:13,2011-08-13 11:23:13
e11c647d604168e565bf4802d5e95aa1ba339c76...f3bf62230aa0de220f1c7832c427201fc6f5b63b,1,1,1,2,1,2011-08-13 11:25:57,2011-08-13 11:25:57
f3bf62230aa0de220f1c7832c427201fc6f5b63b...c0a4c04e2a639a03726a205b2f8f8a637ea511bc,1,1,1,2,1,2011-08-13 11:53:33,2011-08-13 11:53:33
c0a4c04e2a639a03726a205b2f8f8a637ea511bc...1abafe696e44522e8d71c11a53501aeb70a75d38,3,18,5,23,7,2011-08-13 11:53:42,2011-08-13 11:53:42
1abafe696e44522e8d71c11a53501aeb70a75d38...566b3295fa77e9755613ac36e0d73950938cc577,15,25,24,49,21,2011-08-13 11:58:19,2011-08-13 11:58:19
566b3295fa77e9755613ac36e0d73950938cc577...a13de6cd76b12da0520ddccb2d746dd73eb70d28,25,60,44,104,37,2011-08-13 13:51:34,2011-08-13 13:51:34
a13de6cd76b12da0520ddccb2d746dd73eb70d28...2980f2ab9aabdea3a3b7ec343252889408690630,2,13,11,24,5,2011-08-14 18:15:04,2011-08-14 18:15:04
2980f2ab9aabdea3a3b7ec343252889408690630...cfba2460370a6d1808b78e2ba0709ea5c8b7e773,1,1,1,2,1,2011-08-15 08:22:22,2011-08-15 08:22:22
cfba2460370a6d1808b78e2ba0709ea5c8b7e773...d37e3baf62805b91e8cbd7b169f66b2c9d7962e5,1,2,0,2,1,2011-08-15 08:29:08,2011-08-15 08:29:08
d37e3baf62805b91e8cbd7b169f66b2c9d7962e5...283526a5a6854d1ba43f2b277d43cdd2b7f19c54,2,48,1,49,3,2011-08-15 09:01:12,2011-08-15 09:01:12
283526a5a6854d1ba43f2b277d43cdd2b7f19c54...0e3d8bcb26b71bb2ca8bf24427ca5e7482ef9ffa,1,0,9,9,1,2011-08-17 04:06:42,2011-08-17 04:06:42
0e3d8bcb26b71bb2ca8bf24427ca5e7482ef9ffa...7d782e51c1531683c7719a4d3dcf9b3ce38ebfbd,3,39,1,40,3,2011-08-17 14:12:25,2011-08-17 14:12:25
7d782e51c1531683c7719a4d3dcf9b3ce38ebfbd...bdd1409eea7ea86a9b2a645dfb47a6b273a43af4,1,4,4,8,1,2011-08-18 21:47:04,2011-08-18 21:47:04
bdd1409eea7ea86a9b2a645dfb47a6b273a43af4...b825680df804067e70fb25f7cc3f5e4db9588d41,1,2,0,2,2,2011-08-18 21:57:57,2011-08-18 21:57:57
b825680df804067e70fb25f7cc3f5e4db9588d41...41b31b4d09c238d723e951dc0233bae747cfb8e9,1,10,6,16,6,2011-08-18 22:31:32,2011-08-18 22:31:32
41b31b4d09c238d723e951dc0233bae747cfb8e9...40c8a603c3bd8ab85af5b66f4e149fe614e86eca,1,5,5,10,2,2011-08-18 22:39:20,2011-08-18 22:39:20
40c8a603c3bd8ab85af5b66f4e149fe614e86eca...920d01edb751293af2a9e6657a9c38dd02ff6fff,1,2,2,4,2,2011-08-19 18:18:06,2011-08-19 18:18:06
920d01edb751293af2a9e6657a9c38dd02ff6fff...2ac0b97d4340bef2d26ad09841553ff5d5147d23,1,4,0,4,1,2011-08-20 19:22:34,2011-08-20 19:22:34
2ac0b97d4340bef2d26ad09841553ff5d5147d23...c673bd1c4b9b1bcc8ce6de00ecb7df13b76f9e6c,1,1,1,2,1,2011-08-20 19:27:58,2011-08-20 19:27:58
c673bd1c4b9b1bcc8ce6de00ecb7df13b76f9e6c...ec530b142564d2daf345c62cceb2fcaf8fe2c725,1,90,29,119,24,2011-08-21 10:37:02,2011-08-21 10:37:02
ec530b142564d2daf345c62cceb2fcaf8fe2c725...24a45a5fda57121a6479b498f4c9c53fadde2158,1,61,0,61,21,2011-08-21 11:51:48,2011-08-21 11:51:48
24a45a5fda57121a6479b498f4c9c53fadde2158...cdd44dca454f7b2b347316e8faadd32f3684faa7,1,7,6,13,3,2011-08-21 15:45:09,2011-08-21 15:45:09
cdd44dca454f7b2b347316e8faadd32f3684faa7...2d51abfeb5abd64d970f17657e8e992495eac851,1,7,1,8,1,2011-08-21 17:19:35,2011-08-21 17:19:35
2d51abfeb5abd64d970f17657e8e992495eac851...4df45418f2b27dde75364ab5803ebbc4b0cc9c0a,1,76,75,151,31,2011-08-21 18:09:08,2011-08-21 18:09:08
4df45418f2b27dde75364ab5803ebbc4b0cc9c0a...d661cc5e3ab2d8dc427760bb4193603f48512ad8,1,1,1,2,1,2011-08-22 00:12:51,2011-08-22 00:12:51
d661cc5e3ab2d8dc427760bb4193603f48512ad8...c471d471bf9cb4f8da1fad78c5037660186ba6fd,2,75,12,87,13,2011-08-22 00:48:53,2011-08-22 00:48:53
c471d471bf9cb4f8da1fad78c5037660186ba6fd...1f233b479ad1329c7137f033c366b8f4894a6cd7,1,3,3,6,1,2011-08-22 01:07:19,2011-08-22 01:07:19
1f233b479ad1329c7137f033c366b8f4894a6cd7...e3cd0e671016f535f0108d550535335e04e5230d,1,1,1,2,1,2011-08-22 02:03:50,2011-08-22 02:03:50
e3cd0e671016f535f0108d550535335e04e5230d...8560a2c08030d67e234112b6951279de205b4778,1,6,0,6,1,2011-08-22 02:46:59,2011-08-22 02:46:59
8560a2c08030d67e234112b6951279de205b4778...a52411488398303e67e2f4019b052172edd99a68,1,0,10,10,2,2011-08-22 02:52:20,2011-08-22 02:52:20
a52411488398303e67e2f4019b052172edd99a68...11cc26681bd186be30e9cef4b78b78b54a5e66a2,2,16,0,16,2,2011-08-22 03:37:37,2011-08-22 03:37:37
11cc26681bd186be30e9cef4b78b78b54a5e66a2...549faf19bf4c59d6c67b860cb93add1c24f3420a,1,5,5,10,2,2011-08-22 04:27:36,2011-08-22 04:27:36
549faf19bf4c59d6c67b860cb93add1c24f3420a...5994a7442dbe400847f59f4858f9e52173b0ffed,1,2,2,4,1,2011-08-22 06:30:42,2011-08-22 06:30:42
5994a7442dbe400847f59f4858f9e52173b0ffed...f77666a4affeff87d180fade251e7423e2459c3a,1,61,1,62,2,2011-08-22 06:35:52,2011-08-22 06:35:52
f77666a4affeff87d180fade251e7423e2459c3a...5edf1aabc21f4c3bcd006b432e06cb3f0626ea28,1,6,0,6,1,2011-08-22 07:36:42,2011-08-22 07:36:42
5edf1aabc21f4c3bcd006b432e06cb3f0626ea28...3afe409d0ea9d2e3e1dc70abd4bc1cc1a916daf9,2,65,19,84,16,2011-08-22 07:40:12,2011-08-22 07:40:12
3afe409d0ea9d2e3e1dc70abd4bc1cc1a916daf9...b9244cfb89f786701fdb905268854776f5feddeb,1,1,1,2,1,2011-08-22 08:06:52,2011-08-22 08:06:52
b9244cfb89f786701fdb905268854776f5feddeb...0f767f9a993f5834f7a2004bf4c440a126a73d06,2,19,7,26,2,2011-08-23 00:32:35,2011-08-23 00:32:35
0f767f9a993f5834f7a2004bf4c440a126a73d06...d310f91ee7cb76db4d3dd2d1d2304a561cca3a29,2,32,24,56,11,2011-08-23 00:52:45,2011-08-23 00:52:45
d310f91ee7cb76db4d3dd2d1d2304a561cca3a29...46ef2983ba0434ee9c71385bc709b70a64b35060,2,15,1,16,3,2011-08-23 01:41:47,2011-08-23 01:41:47
46ef2983ba0434ee9c71385bc709b70a64b35060...2664fa189614a4dbbfed5cb683148707ab568f47,47,167,161,328,95,2011-08-23 02:32:37,2011-08-23 02:32:37
2664fa189614a4dbbfed5cb683148707ab568f47...0686c6b0ee7e6099cdcc48317d2649dc19dc89c9,2,14,5,19,3,2011-08-23 03:38:18,2011-08-23 03:38:18
0686c6b0ee7e6099cdcc48317d2649dc19dc89c9...c3a0dcf6e9e7859a4a990954cbab0a44e7cb1307,1,9,2,11,3,2011-08-23 03:38:28,2011-08-23 03:38:28
c3a0dcf6e9e7859a4a990954cbab0a44e7cb1307...2e56066a5b93b528fbce37285bac591b44bc6ed7,4,168,8,176,11,2011-08-23 03:38:42,2011-08-23 03:38:42
2e56066a5b93b528fbce37285bac591b44bc6ed7...6cd90236350b6531122ddbb5a99874add09f3f15,3,55,1,56,5,2011-08-23 03:51:10,2011-08-23 03:51:10
6cd90236350b6531122ddbb5a99874add09f3f15...1f770c62da69866835bb8fc9355128b6b493a97e,1,3,2,5,2,2011-08-23 04:05:47,2011-08-23 04:05:47
1f770c62da69866835bb8fc9355128b6b493a97e...a5cbb892f8206c8f4ae8fd1bcff93b8251e6264e,2,17,1,18,3,2011-08-23 04:08:24,2011-08-23 04:08:24
a5cbb892f8206c8f4ae8fd1bcff93b8251e6264e...966bbd4d56fa6f61ac40013a4e66b180eac44dea,1,2,2,4,2,2011-08-23 04:10:15,2011-08-23 04:10:15
966bbd4d56fa6f61ac40013a4e66b180eac44dea...1e72b1c5c11d1d2dc3ce3660a1eb6b775dcca5a5,6,372,390,762,9,2011-08-23 04:25:07,2011-08-23 04:25:07
1e72b1c5c11d1d2dc3ce3660a1eb6b775dcca5a5...43024142a14afe0b364895e88e0836dcb83dbef8,8,1224,0,1224,9,2011-08-23 04:41:56,2011-08-23 04:41:56
43024142a14afe0b364895e88e0836dcb83dbef8...a39066ba0bc7a100bb0473111913472326119497,2,13,2,15,4,2011-08-23 05:12:31,2011-08-23 05:12:31
a39066ba0bc7a100bb0473111913472326119497...6feb611c7b0ff5dc55880c347b2957ad3107e1f7,1,7,2,9,1,2011-08-23 05:24:31,2011-08-23 05:24:31
6feb611c7b0ff5dc55880c347b2957ad3107e1f7...a86dde20f05cb85bb2d69c483d084e6c217792cc,1,4,4,8,4,2011-08-23 06:28:45,2011-08-23 06:28:45
a86dde20f05cb85bb2d69c483d084e6c217792cc...7182cd2284a15cd5094ab6567ae14c6ad3cd901a,2,15,2,17,6,2011-08-23 06:29:01,2011-08-23 06:29:01
7182cd2284a15cd5094ab6567ae14c6ad3cd901a...be4acff3195d9d9064c5c253ac3e856b11404c85,8,0,1224,1224,9,2011-08-23 06:31:03,2011-08-23 06:31:03
be4acff3195d9d9064c5c253ac3e856b11404c85...8b87a94357c1e52c9d5aed8c684e1a4f1dcc1c89,1,28,15,43,5,2011-08-23 15:36:40,2011-08-23 15:36:40
8b87a94357c1e52c9d5aed8c684e1a4f1dcc1c89...75ddbf77a62b804740e887d940ded2f8c0bc1087,2,8,1,9,4,2011-08-23 23:43:29,2011-08-23 23:43:29
75ddbf77a62b804740e887d940ded2f8c0bc1087...ec1226b83f226150671ee6f7844bcec04f600d75,2,18,1,19,3,2011-08-24 03:51:33,2011-08-24 03:51:33
ec1226b83f226150671ee6f7844bcec04f600d75...a3fd9cf288e71b9c8e5fb6479eda3d33bc0a9d65,87,483,554,1037,43,2011-08-24 12:30:59,2011-08-24 12:30:59
a3fd9cf288e71b9c8e5fb6479eda3d33bc0a9d65...20473057d13ac3e774ae29a1557ce4d18e7cdce6,1,5,1,6,1,2011-08-25 05:44:18,2011-08-25 05:44:18
20473057d13ac3e774ae29a1557ce4d18e7cdce6...587fbff3dd500cd3444dc7a0717e541307ff869d,1,4,0,4,1,2011-08-25 06:07:28,2011-08-25 06:07:28
587fbff3dd500cd3444dc7a0717e541307ff869d...7e66ccac4c3444918fa0721e3cbf08fb35869fac,1,6,0,6,1,2011-08-25 08:01:21,2011-08-25 08:01:21
7e66ccac4c3444918fa0721e3cbf08fb35869fac...b0764e81ad04d5bd31ff99838445761503bb3526,1,12,3,15,2,2011-08-25 09:20:44,2011-08-25 09:20:44
b0764e81ad04d5bd31ff99838445761503bb3526...bb99fe46b7915ef131ba54e8348c9a1d52bd6ddd,1,5,2,7,2,2011-08-25 09:23:49,2011-08-25 09:23:49
bb99fe46b7915ef131ba54e8348c9a1d52bd6ddd...bf9ba45f6b5da97154f317ba0b8349b2822a00ba,3,31,12,43,10,2011-08-25 23:02:15,2011-08-25 23:02:15
bf9ba45f6b5da97154f317ba0b8349b2822a00ba...5eeb2d56d50dc7b280cd11267add8cf2da5f26a3,2,11,2,13,2,2011-08-26 02:43:33,2011-08-26 02:43:33
5eeb2d56d50dc7b280cd11267add8cf2da5f26a3...804a6db86e8b1c129429291da4aebbd797c77ddb,1,9,0,9,1,2011-08-26 04:34:40,2011-08-26 04:34:40
804a6db86e8b1c129429291da4aebbd797c77ddb...3e65f9633ba86d9c615556f45034301f880bca10,3,6,2,8,3,2011-08-26 04:36:31,2011-08-26 04:36:31
3e65f9633ba86d9c615556f45034301f880bca10...499f01842eac1d1248fbf60df94444c08282ef3a,1,4,1,5,1,2011-08-26 05:28:58,2011-08-26 05:28:58
499f01842eac1d1248fbf60df94444c08282ef3a...70e59aeaf85161ed26044c000a43af46719265ad,2,37,20,57,5,2011-08-26 06:19:30,2011-08-26 06:19:30
70e59aeaf85161ed26044c000a43af46719265ad...c9da5db701096813e3a7b4c64a80f4ad42a8eef8,1,12,5,17,2,2011-08-26 08:18:05,2011-08-26 08:18:05
c9da5db701096813e3a7b4c64a80f4ad42a8eef8...4d2151196163f401c42da5adae4bb06f6adf3d71,2,27,10,37,2,2011-08-26 08:42:38,2011-08-26 08:42:38
4d2151196163f401c42da5adae4bb06f6adf3d71...1154b80a64ef623580d7b4af23e10a9bbed1c4ee,3,31,0,31,4,2011-08-26 09:31:01,2011-08-26 09:31:01
1154b80a64ef623580d7b4af23e10a9bbed1c4ee...e0ae9db2722f36969e760619fd97d8604fa94bda,1,5,2,7,1,2011-08-26 09:44:40,2011-08-26 09:44:40
e0ae9db2722f36969e760619fd97d8604fa94bda...a4a250a2964eca1815ac93726c46d2021c2644f0,1,5,5,10,1,2011-08-26 21:13:01,2011-08-26 21:13:01
a4a250a2964eca1815ac93726c46d2021c2644f0...17ceb9b98aeea3062ba28aac0ba23e5021c7b903,1,1,1,2,1,2011-08-26 23:37:07,2011-08-26 23:37:07
17ceb9b98aeea3062ba28aac0ba23e5021c7b903...4c8f2dca215299bcba1a1b7547452f3a3944576e,1,275,254,529,83,2011-08-27 02:56:18,2011-08-27 02:56:18
4c8f2dca215299bcba1a1b7547452f3a3944576e...f85b96121aa267dade4391b3eeb0ffbf64b32f12,1,3,2,5,1,2011-08-27 04:55:02,2011-08-27 04:55:02
f85b96121aa267dade4391b3eeb0ffbf64b32f12...a0eb58e90b16fd620196ca2e30219d04b86bceb2,1,130,122,252,39,2011-08-28 02:05:20,2011-08-28 02:05:20
a0eb58e90b16fd620196ca2e30219d04b86bceb2...77189afb7f603fc382fbb33a3a54f2b9499dc2cf,1,58,40,98,15,2011-08-28 02:05:32,2011-08-28 02:05:32
77189afb7f603fc382fbb33a3a54f2b9499dc2cf...0f8f46802a172d47971a848227065894efd6a622,3,16,2,18,6,2011-08-28 02:37:16,2011-08-28 02:37:16
0f8f46802a172d47971a848227065894efd6a622...ce477f0873331653bbcf4bcd66a06240071a5b34,1,6,2,8,3,2011-08-28 06:49:29,2011-08-28 06:49:29
ce477f0873331653bbcf4bcd66a06240071a5b34...93fbb77d9b5f4ab936c8f29b20a704d9b11be0c7,3,48,21,69,12,2011-08-28 07:57:56,2011-08-28 07:57:56
93fbb77d9b5f4ab936c8f29b20a704d9b11be0c7...6757568bfa5a34ec7b6e6b833612fc007b31a339,7,1220,0,1220,7,2011-08-28 13:51:28,2011-08-28 13:51:28
6757568bfa5a34ec7b6e6b833612fc007b31a339...6dc48a735c2d98c4d1e5a56cb99d62a3631c3bcd,1,26,0,26,1,2011-08-28 14:43:51,2011-08-28 14:43:51
6dc48a735c2d98c4d1e5a56cb99d62a3631c3bcd...7c657b241657de6b7551dd3f064abe08478719c7,1,21,0,21,3,2011-08-29 15:55:06,2011-08-29 15:55:06
7c657b241657de6b7551dd3f064abe08478719c7...0037ca44d6981d65aaa9115aa242b25c06b49219,1,1,0,1,1,2011-08-29 17:28:15,2011-08-29 17:28:15
0037ca44d6981d65aaa9115aa242b25c06b49219...93f92635b69c16a79ae546e060522eb437dc1c25,1,1,2,3,2,2011-08-29 23:01:25,2011-08-29 23:01:25
93f92635b69c16a79ae546e060522eb437dc1c25...5ed2cf03bb309f9b2911bc863f6858edf31748a2,2,30,1,31,3,2011-08-30 08:14:35,2011-08-30 08:14:35
5ed2cf03bb309f9b2911bc863f6858edf31748a2...3256862f5f05dac1744b584e232270070ff7c3a8,4,57,10,67,9,2011-08-30 12:09:45,2011-08-30 12:09:45
3256862f5f05dac1744b584e232270070ff7c3a8...3a2e15abd9b6949fc24d83ee6b85371beae498ec,1,464,463,927,1,2011-08-30 12:11:09,2011-08-30 12:11:09
3a2e15abd9b6949fc24d83ee6b85371beae498ec...71f017b2a6677538f8c3578e33859d4586b5bea1,10,115,34,149,34,2011-08-31 08:07:07,2011-08-31 08:07:07
71f017b2a6677538f8c3578e33859d4586b5bea1...de35a3ab14ca2fb88b4524c8ea0ebaa9e28eb85b,2,51,7,58,6,2011-09-02 03:04:02,2011-09-02 03:04:02
de35a3ab14ca2fb88b4524c8ea0ebaa9e28eb85b...5c1b4ab75b487d7cb77ba1959a7e576f05ca4618,1,2,2,4,2,2011-09-02 03:47:49,2011-09-02 03:47:49
5c1b4ab75b487d7cb77ba1959a7e576f05ca4618...09fc775f42c8c0788661821fe43b2bf51281399d,1,4,1,5,1,2011-09-03 12:53:08,2011-09-03 12:53:08
09fc775f42c8c0788661821fe43b2bf51281399d...f4d93f6eb859d011989a5f5a3f452d73118c657f,2,2,2,4,2,2011-09-03 17:46:16,2011-09-03 17:46:16
f4d93f6eb859d011989a5f5a3f452d73118c657f...9110257a328bacae0a6131ca7b3c8b241fef128c,1,1,1,2,1,2011-09-03 19:50:45,2011-09-03 19:50:45
9110257a328bacae0a6131ca7b3c8b241fef128c...932b1b8d6dbd1a4d8e50aa0528c1489094f5704c,43,284,378,662,150,2011-09-04 21:17:30,2011-09-04 21:17:30
932b1b8d6dbd1a4d8e50aa0528c1489094f5704c...efd682e436d5ea6de5fe0a6d09fee70dd6fc3c50,1,1,1,2,1,2011-09-04 22:42:11,2011-09-04 22:42:11
efd682e436d5ea6de5fe0a6d09fee70dd6fc3c50...2b4341d532b376702a17212a9ff9f8710ca4c14a,2,4,0,4,2,2011-09-04 22:51:53,2011-09-04 22:51:53
2b4341d532b376702a17212a9ff9f8710ca4c14a...16bb9c594cf7306f4b2fc3ba915be43b05dad5d2,7,64,7,71,12,2011-09-08 13:24:41,2011-09-08 13:24:41
16bb9c594cf7306f4b2fc3ba915be43b05dad5d2...414c762c3abfebb2670a3b26aba7028d62303cfe,1,3,3,6,3,2011-09-08 13:24:49,2011-09-08 13:24:49
414c762c3abfebb2670a3b26aba7028d62303cfe...cf70c96ce08bec8834ada695451cc915f7558dbd,7,85,23,108,27,2011-09-08 13:25:00,2011-09-08 13:25:00
cf70c96ce08bec8834ada695451cc915f7558dbd...944ef3bb60eae989aa7d536e509f9cc80be0adcb,3,5,4,9,5,2011-09-08 13:25:11,2011-09-08 13:25:11
944ef3bb60eae989aa7d536e509f9cc80be0adcb...6819312c9843b36463d3ffb5f1acdf34b0eb3e01,1,28,13,41,6,2011-09-08 13:25:17,2011-09-08 13:25:17
6819312c9843b36463d3ffb5f1acdf34b0eb3e01...2189a8e50ab7e0c76193fe1a18934641c9a05ff0,1,1,1,2,1,2011-09-08 13:25:24,2011-09-08 13:25:24
2189a8e50ab7e0c76193fe1a18934641c9a05ff0...7cb140e6d86e9c592983ddb50bfd82480ecec7eb,2,126,8,134,7,2011-09-08 13:25:31,2011-09-08 13:25:31
7cb140e6d86e9c592983ddb50bfd82480ecec7eb...387e192f2584d283d989ebe92e63d174413e30e4,4,28,2,30,5,2011-09-08 13:25:41,2011-09-08 13:25:41
387e192f2584d283d989ebe92e63d174413e30e4...ddaca29d3dc2b4a917a9e527fd90a14ef8bc47e4,6,13,12,25,7,2011-09-09 16:18:38,2011-09-09 16:18:38
ddaca29d3dc2b4a917a9e527fd90a14ef8bc47e4...4584069c8aa43a10bef8d0711fc4451599bb4dcf,1,13,1,14,5,2011-09-09 16:57:35,2011-09-09 16:57:35
4584069c8aa43a10bef8d0711fc4451599bb4dcf...d036b87126eadb3d76a4e4c5daea1bfb767db912,4,2,137,139,6,2011-09-09 17:14:47,2011-09-09 17:14:47
d036b87126eadb3d76a4e4c5daea1bfb767db912...0b174ccf0ef99b9ee887890fc5c7ac0c7a845720,3,18,0,18,3,2011-09-09 17:20:16,2011-09-09 17:20:16
0b174ccf0ef99b9ee887890fc5c7ac0c7a845720...dc3b2a0fdf2a69864c5508a9c49aca43acac9bb2,1,14,17,31,5,2011-09-09 17:54:04,2011-09-09 17:54:04
dc3b2a0fdf2a69864c5508a9c49aca43acac9bb2...64e16c094b3b4f551798f3dbff496fe5c6798f3b,1,11,0,11,1,2011-09-09 17:57:45,2011-09-09 17:57:45
64e16c094b3b4f551798f3dbff496fe5c6798f3b...8258fe7845afda1f6820d2ed385d281ced20c943,2,84,10,94,12,2011-09-09 18:34:24,2011-09-09 18:34:24
8258fe7845afda1f6820d2ed385d281ced20c943...e55bbf4c3c42b17d52c21bc3a460b4981fdc190c,3,3,3,6,3,2011-09-09 18:34:33,2011-09-09 18:34:33
e55bbf4c3c42b17d52c21bc3a460b4981fdc190c...7deb25b8dd5aa1ed02b5e30cbc67cd1fb0c3d6e6,22,331,78,409,51,2011-09-09 19:22:28,2011-09-09 19:22:28
7deb25b8dd5aa1ed02b5e30cbc67cd1fb0c3d6e6...fb590bfa9bfdeb622677187552cae707f379c7b1,9,10,14,24,10,2011-09-09 19:33:40,2011-09-09 19:33:40
fb590bfa9bfdeb622677187552cae707f379c7b1...6273db307e2acc5e4ce91a1cf9213a195b64fd78,1,2,2,4,1,2011-09-09 19:51:06,2011-09-09 19:51:06
6273db307e2acc5e4ce91a1cf9213a195b64fd78...e216c3cb1b3bd78975d155f95df97a6f6a3f2a96,1,1,1,2,1,2011-09-09 21:36:58,2011-09-09 21:36:58
e216c3cb1b3bd78975d155f95df97a6f6a3f2a96...699688dc2cfad627c5d400c6bdb681c81e932bc0,5,11,11,22,9,2011-09-09 21:45:58,2011-09-09 21:45:58
699688dc2cfad627c5d400c6bdb681c81e932bc0...fe88584589922c1a0e068f18c82fe1b17e437fcd,2,6,1,7,3,2011-09-09 22:32:38,2011-09-09 22:32:38
fe88584589922c1a0e068f18c82fe1b17e437fcd...6ce463aadb50bbc53378a7efc512ea265da9f601,1,13,12,25,2,2011-09-09 22:33:28,2011-09-09 22:33:28
6ce463aadb50bbc53378a7efc512ea265da9f601...43329af2e3f99e6dc39c6ae390b055aa180554ad,7,93,13,106,21,2011-09-09 22:34:23,2011-09-09 22:34:23
43329af2e3f99e6dc39c6ae390b055aa180554ad...c4d8b4c0b2a39fde1086acada2f3ba5003a13c8d,1,0,1,1,1,2011-09-09 22:47:18,2011-09-09 22:47:18
c4d8b4c0b2a39fde1086acada2f3ba5003a13c8d...470c70f876b2fc9c7783a45589f7bfd1c4356078,2,17,3,20,4,2011-09-09 22:57:12,2011-09-09 22:57:12
470c70f876b2fc9c7783a45589f7bfd1c4356078...228654d17fd461908dbc887c837f282470d5c810,1,12,4,16,6,2011-09-09 23:02:33,2011-09-09 23:02:33
228654d17fd461908dbc887c837f282470d5c810...7bca049f1c620cb7e595745607257c774b6c0b2e,1,4,4,8,4,2011-09-09 23:25:48,2011-09-09 23:25:48
7bca049f1c620cb7e595745607257c774b6c0b2e...e061b036a54597b6a994573ea6aa2ee02ca8838e,2,15,0,15,2,2011-09-10 00:05:48,2011-09-10 00:05:48
e061b036a54597b6a994573ea6aa2ee02ca8838e...0516ac3d28a7ac8b756ada0e6f89473c7a6e0474,3,15,1,16,4,2011-09-10 00:29:34,2011-09-10 00:29:34
0516ac3d28a7ac8b756ada0e6f89473c7a6e0474...893cea211ae88c6f68a6c2c281890d6f63541286,6,130,6,136,9,2011-09-10 00:46:38,2011-09-10 00:46:38
893cea211ae88c6f68a6c2c281890d6f63541286...33076af6f2aa5285b3a70246e14163b901b512f7,2,15,9,24,11,2011-09-10 00:46:48,2011-09-10 00:46:48
33076af6f2aa5285b3a70246e14163b901b512f7...5f287f75f2277ba821dcf5c444ab12d8eff6cce3,11,107,43,150,30,2011-09-10 00:47:00,2011-09-10 00:47:00
5f287f75f2277ba821dcf5c444ab12d8eff6cce3...01b0eb50fd4a3503a80524f5fd783b0dba038105,3,16,10,26,5,2011-09-10 01:53:56,2011-09-10 01:53:56
01b0eb50fd4a3503a80524f5fd783b0dba038105...d14bf8c62b66a6f58252d492c2eeca1c952e508c,3,48,1,49,5,2011-09-10 02:42:05,2011-09-10 02:42:05
d14bf8c62b66a6f58252d492c2eeca1c952e508c...5fbf5fd3dd82257d81421fb9b891fa53131ee894,2,6,3,9,5,2011-09-10 02:52:37,2011-09-10 02:52:37
5fbf5fd3dd82257d81421fb9b891fa53131ee894...eaea9deca849262a677fec0f0d74495bb146f691,6,36,3,39,7,2011-09-10 03:04:30,2011-09-10 03:04:30
eaea9deca849262a677fec0f0d74495bb146f691...84e0055e8df00ff7406f424b39ce6a86f648b51f,3,10,11,21,6,2011-09-10 03:26:13,2011-09-10 03:26:13
84e0055e8df00ff7406f424b39ce6a86f648b51f...b557810207a2fb20e90872bad831634bc4734482,3,34,0,34,4,2011-09-10 03:33:54,2011-09-10 03:33:54
b557810207a2fb20e90872bad831634bc4734482...67dde2f52f69e9a3834c196135462c93b41649d0,2,2,1,3,2,2011-09-10 17:09:23,2011-09-10 17:09:23
67dde2f52f69e9a3834c196135462c93b41649d0...36120f41a900cae27377d247ec482bc427811f51,2,9,9,18,9,2011-09-10 17:19:05,2011-09-10 17:19:05
36120f41a900cae27377d247ec482bc427811f51...fee2d1877f883ccd1aeb70e5a5776e573ef765b7,1,2,0,2,1,2011-09-10 17:20:31,2011-09-10 17:20:31
fee2d1877f883ccd1aeb70e5a5776e573ef765b7...eb297583b1b78403cda501133a52e71dd0381576,1,5,0,5,1,2011-09-10 17:29:33,2011-09-10 17:29:33
eb297583b1b78403cda501133a52e71dd0381576...efb832744466548ea6f86fa027ffe702baa0d9a0,2,4,16,20,5,2011-09-10 17:38:58,2011-09-10 17:38:58
efb832744466548ea6f86fa027ffe702baa0d9a0...05e29716b446f71eef8318f8093f0c19726ae22f,12,472,401,873,26,2011-09-10 18:04:27,2011-09-10 18:04:27
05e29716b446f71eef8318f8093f0c19726ae22f...161c6328a0811280926a16275be5ef4164f5866f,1,10,2,12,4,2011-09-10 18:44:33,2011-09-10 18:44:33
161c6328a0811280926a16275be5ef4164f5866f...fcee0c1b66019a0e84bc338e76fa31695d5bd4ca,2,10,15,25,6,2011-09-10 18:58:30,2011-09-10 18:58:30
fcee0c1b66019a0e84bc338e76fa31695d5bd4ca...dafb4951a7ff191f1b41146ca46b4cc662212997,1,3,1,4,1,2011-09-10 19:45:16,2011-09-10 19:45:16
dafb4951a7ff191f1b41146ca46b4cc662212997...8d6c2517315660fbf9e69ae6b7595f33a10e5e43,3,28,8,36,10,2011-09-10 20:06:10,2011-09-10 20:06:10
8d6c2517315660fbf9e69ae6b7595f33a10e5e43...0609255dd24ee300b56387f1006c074978ebb832,1,1,1,2,1,2011-09-10 21:00:25,2011-09-10 21:00:25
0609255dd24ee300b56387f1006c074978ebb832...e130dc327548d143c3ee27af8c7e069ba772f3e7,5,27,113,140,27,2011-09-10 21:00:32,2011-09-10 21:00:32
e130dc327548d143c3ee27af8c7e069ba772f3e7...e95d0afe9e79f1864ea53e98007ca225a218417b,1,1,1,2,1,2011-09-10 21:29:21,2011-09-10 21:29:21
e95d0afe9e79f1864ea53e98007ca225a218417b...f2bc919ec00457fd53f093af53ab71c7f1bcfbcd,2,3,1,4,2,2011-09-10 21:44:57,2011-09-10 21:44:57
f2bc919ec00457fd53f093af53ab71c7f1bcfbcd...b45a4acf6f29025f28baf524809f34a14b7ccde7,2,5,1,6,2,2011-09-10 21:46:59,2011-09-10 21:46:59
b45a4acf6f29025f28baf524809f34a14b7ccde7...807b2a8216cbb8bfc82a2dc3d57fe2169f3349e4,1,3,2,5,2,2011-09-10 22:02:13,2011-09-10 22:02:13
807b2a8216cbb8bfc82a2dc3d57fe2169f3349e4...345c4c4629c8d17a8b4826fb4b97a61f19326e9f,5,6,11,17,10,2011-09-10 22:31:38,2011-09-10 22:31:38
345c4c4629c8d17a8b4826fb4b97a61f19326e9f...8e1226b4a00a0d26752b26d0ebf21ff8c5a247ad,8,24,26,50,20,2011-09-10 22:46:44,2011-09-10 22:46:44
8e1226b4a00a0d26752b26d0ebf21ff8c5a247ad...2918c3de74d1abe571b6c1eeb35e2899c39d880e,6,34,37,71,9,2011-09-10 22:53:26,2011-09-10 22:53:26
2918c3de74d1abe571b6c1eeb35e2899c39d880e...a25413bf86e5e65129f8582a713a29308296c374,2,8,5,13,3,2011-09-11 00:00:15,2011-09-11 00:00:15
a25413bf86e5e65129f8582a713a29308296c374...ccbca7a668b4d02408e707cb9ed34204a8094f01,2,25,29,54,25,2011-09-11 00:15:43,2011-09-11 00:15:43
ccbca7a668b4d02408e707cb9ed34204a8094f01...83484cc109baf6aad645e7cace2183c2b7f9c181,1,0,1,1,1,2011-09-11 00:52:03,2011-09-11 00:52:03
83484cc109baf6aad645e7cace2183c2b7f9c181...28cb5bf1622cd8fa6f324cc516974e3badc31a51,5,28,11,39,11,2011-09-11 00:52:08,2011-09-11 00:52:08
28cb5bf1622cd8fa6f324cc516974e3badc31a51...88fc8657f4a45006c15dca40bc5b182510a2f5a8,1,5,4,9,2,2011-09-11 01:12:11,2011-09-11 01:12:11
88fc8657f4a45006c15dca40bc5b182510a2f5a8...a829f85b9473c0fd58d2c149949cff0fb0b4e825,2,17,0,17,2,2011-09-11 02:28:08,2011-09-11 02:28:08
a829f85b9473c0fd58d2c149949cff0fb0b4e825...94524fbfef09bf18422141a2c8c73e880aa25b14,3,41,21,62,6,2011-09-11 04:01:41,2011-09-11 04:01:41
94524fbfef09bf18422141a2c8c73e880aa25b14...7b92ae310d59e39f91e9ee4d887c0ea7ae85e4fd,1,5,4,9,1,2011-09-11 05:31:00,2011-09-11 05:31:00
7b92ae310d59e39f91e9ee4d887c0ea7ae85e4fd...23b7758f75a7a676613464cc3f00370979df1e45,1,24,0,24,1,2011-09-11 05:37:55,2011-09-11 05:37:55
23b7758f75a7a676613464cc3f00370979df1e45...f6d11f9b05b0f5c14f6e179b800d55ecf1c1a0f7,2,8,8,16,5,2011-09-11 05:44:21,2011-09-11 05:44:21
f6d11f9b05b0f5c14f6e179b800d55ecf1c1a0f7...4224127b54a7faa31da00b8eb1d2f04eb8aa0746,1,7,4,11,2,2011-09-11 05:47:48,2011-09-11 05:47:48
4224127b54a7faa31da00b8eb1d2f04eb8aa0746...7f45651f8db35a9f5cd5a5822c133cefb607aa40,1,4,3,7,1,2011-09-11 05:57:38,2011-09-11 05:57:38
7f45651f8db35a9f5cd5a5822c133cefb607aa40...fd9045346286208c0dbd0afc1f820e868910dac8,2,22,1,23,3,2011-09-11 19:28:18,2011-09-11 19:28:18
fd9045346286208c0dbd0afc1f820e868910dac8...26b812208751edf87b4df0aee00996c5c7bcd4c9,88,243,198,441,134,2011-09-11 22:36:16,2011-09-11 22:36:16
26b812208751edf87b4df0aee00996c5c7bcd4c9...9fe050a27598cdce7f2ef7a332b4818b493a8702,1,5,0,5,2,2011-09-11 23:02:53,2011-09-11 23:02:53
9fe050a27598cdce7f2ef7a332b4818b493a8702...4e47df9de20ab12070fcb92ef2176ece7847e5f5,1,3,1,4,1,2011-09-12 07:12:28,2011-09-12 07:12:28
4e47df9de20ab12070fcb92ef2176ece7847e5f5...ca1e67049913f530b094ef71a43144cd6030024b,1,3,3,6,1,2011-09-12 07:15:47,2011-09-12 07:15:47
ca1e67049913f530b094ef71a43144cd6030024b...c76112cf1d98bf68d78ca876dffd50f4091d0ca8,1,1,1,2,1,2011-09-13 03:10:07,2011-09-13 03:10:07
c76112cf1d98bf68d78ca876dffd50f4091d0ca8...3513234cf8a9ca0195536f7856729049adbd8444,1,5,8,13,2,2011-09-13 08:22:53,2011-09-13 08:22:53
3513234cf8a9ca0195536f7856729049adbd8444...f3ae4962017727c16e3e4a35f3d58c232051aa10,3,27,28,55,5,2011-09-13 15:10:49,2011-09-13 15:10:49
f3ae4962017727c16e3e4a35f3d58c232051aa10...dd292b948e14bffa9e854620903d90193b286d96,1,8,8,16,5,2011-09-13 20:30:24,2011-09-13 20:30:24
dd292b948e14bffa9e854620903d90193b286d96...67e05fcd3982a569d647f4a64f40fe9793d35cbc,1,10,2,12,3,2011-09-13 20:43:33,2011-09-13 20:43:33
67e05fcd3982a569d647f4a64f40fe9793d35cbc...50255e33053714ec3b363cf39e2d9a7f4b0ed83c,3,65,19,84,11,2011-09-14 23:27:35,2011-09-14 23:27:35
50255e33053714ec3b363cf39e2d9a7f4b0ed83c...2fa433ed5545c1dc7a140bd4c3b59b82ff69006b,1,1,1,2,1,2011-09-14 23:58:12,2011-09-14 23:58:12
2fa433ed5545c1dc7a140bd4c3b59b82ff69006b...ce48e8e9400c7030e5a351efde172e4bd3230966,1,8,4,12,2,2011-09-15 07:26:35,2011-09-15 07:26:35
ce48e8e9400c7030e5a351efde172e4bd3230966...608548baa200d3945dee419787e3996d3e5a0b15,1,4,1,5,1,2011-09-15 23:55:30,2011-09-15 23:55:30
608548baa200d3945dee419787e3996d3e5a0b15...4397c587a43ff9bfddd295d48d850676778c6e77,6,69,78,147,36,2011-09-16 01:16:25,2011-09-16 01:16:25
4397c587a43ff9bfddd295d48d850676778c6e77...def775ae5ea59b053ffd80fb5c43a930452ae275,1,0,6,6,1,2011-09-16 06:30:05,2011-09-16 06:30:05
def775ae5ea59b053ffd80fb5c43a930452ae275...e5090a3b2abadeea9f300269055e723d26f9918b,1,2,2,4,2,2011-09-16 10:53:15,2011-09-16 10:53:15
e5090a3b2abadeea9f300269055e723d26f9918b...568681c6da0638851b2e752167d9587f63c56193,1,3,0,3,2,2011-09-16 11:12:35,2011-09-16 11:12:35
568681c6da0638851b2e752167d9587f63c56193...f9dad46d3665214ac80af06371fae10c55605086,9,105,2,107,7,2011-09-16 11:57:03,2011-09-16 11:57:03
f9dad46d3665214ac80af06371fae10c55605086...343004c4de332bfec09e8a57de775a46fecb18f9,7,34,29,63,24,2011-09-16 16:41:38,2011-09-16 16:41:38
343004c4de332bfec09e8a57de775a46fecb18f9...d1d6109229b4c103da682d4aa8bcac930c07da0b,2,19,3,22,2,2011-09-16 17:07:19,2011-09-16 17:07:19
d1d6109229b4c103da682d4aa8bcac930c07da0b...00678334aa7fb96d2f5fca3704e61e23317217a7,6,39,32,71,11,2011-09-16 18:06:42,2011-09-16 18:06:42
00678334aa7fb96d2f5fca3704e61e23317217a7...f97a574196102ef2479da4e519d7cffc7a5fdf6c,2,9,8,17,2,2011-09-16 21:19:30,2011-09-16 21:19:30
f97a574196102ef2479da4e519d7cffc7a5fdf6c...3ac877840a42144174e7ffde1721c9ed40a13b22,7,155,40,195,21,2011-09-17 19:54:52,2011-09-17 19:54:52
3ac877840a42144174e7ffde1721c9ed40a13b22...30745b2e659d22560b2c9ba99a8f8a4f2007e279,1,1,1,2,1,2011-09-17 20:06:00,2011-09-17 20:06:00
30745b2e659d22560b2c9ba99a8f8a4f2007e279...1ec25c4fb7df0fdbc30bb7ae1e06e97451dec361,2,1,2,3,2,2011-09-17 23:01:46,2011-09-17 23:01:46
1ec25c4fb7df0fdbc30bb7ae1e06e97451dec361...e63fa0ff832e4a6c18aa9f427b643b3445c5abb0,2,30,3,33,7,2011-09-18 04:09:44,2011-09-18 04:09:44
e63fa0ff832e4a6c18aa9f427b643b3445c5abb0...9316671effabcd42c7af81cb9dac9838d07c082a,1,46,7,53,4,2011-09-18 07:24:16,2011-09-18 07:24:16
9316671effabcd42c7af81cb9dac9838d07c082a...357910c1c6f5ff72ca2dbadf802a683cd630c335,1,3,3,6,3,2011-09-18 07:50:50,2011-09-18 07:50:50
357910c1c6f5ff72ca2dbadf802a683cd630c335...436aeb6e1513085d09e33683cd0f60ee4fb746a7,2,5,5,10,3,2011-09-18 08:33:39,2011-09-18 08:33:39
436aeb6e1513085d09e33683cd0f60ee4fb746a7...d15ef4532e584991301870fccc8d54b4364aa8c9,1,0,1,1,1,2011-09-18 21:33:14,2011-09-18 21:33:14
d15ef4532e584991301870fccc8d54b4364aa8c9...e5aeba018f9e6b5793612ad47a1167b8101b1973,1,0,2,2,2,2011-09-18 22:28:17,2011-09-18 22:28:17
e5aeba018f9e6b5793612ad47a1167b8101b1973...212b0485648715614c880629ebe559268489851f,3,7,6,13,4,2011-09-19 07:25:59,2011-09-19 07:25:59
212b0485648715614c880629ebe559268489851f...fc06ec0daf563718e3ea96634040878c85bb2ebd,1,1,1,2,1,2011-09-19 07:33:32,2011-09-19 07:33:32
fc06ec0daf563718e3ea96634040878c85bb2ebd...7b21bfc0745f92f83a6826a3d3e58797fb74e326,18,904,630,1534,182,2011-09-20 18:16:49,2011-09-20 18:16:49
7b21bfc0745f92f83a6826a3d3e58797fb74e326...aaf77c1676e44019abe544911ff7a06eb2690295,41,488,104,592,92,2011-09-20 18:30:06,2011-09-20 18:30:06
aaf77c1676e44019abe544911ff7a06eb2690295...b22a4fdc710684e089fd6135ac4c94b51fea2a3e,1,13,2,15,2,2011-09-21 01:33:14,2011-09-21 01:33:14
b22a4fdc710684e089fd6135ac4c94b51fea2a3e...09a01435de65989864d56a8bf74ff2d84e9c4bd5,4,55,5,60,9,2011-09-21 14:00:58,2011-09-21 14:00:58
09a01435de65989864d56a8bf74ff2d84e9c4bd5...75199e8f6d96887c10ba79870428e04ed34e1ca5,2,13,0,13,2,2011-09-21 14:20:18,2011-09-21 14:20:18
75199e8f6d96887c10ba79870428e04ed34e1ca5...eb5df8e98db5c5592d5f0a0ca4680f9368ed0db5,7,40,15,55,10,2011-09-21 15:58:21,2011-09-21 15:58:21
eb5df8e98db5c5592d5f0a0ca4680f9368ed0db5...c4cc8756437de2c9b508910ebe84f75a8d98d699,4,34,6,40,13,2011-09-21 15:58:32,2011-09-21 15:58:32
c4cc8756437de2c9b508910ebe84f75a8d98d699...8f750bf6e57b731a4cc8c710481c16bc95ee1291,1,10,11,21,6,2011-09-21 17:25:13,2011-09-21 17:25:13
8f750bf6e57b731a4cc8c710481c16bc95ee1291...e6088dce980d0032267b696fc8f725073a48965c,1,4,4,8,4,2011-09-21 21:19:18,2011-09-21 21:19:18
e6088dce980d0032267b696fc8f725073a48965c...cfadc36be592a24037928206b3dcba170471f52a,1,4,0,4,1,2011-09-21 22:43:41,2011-09-21 22:43:41
cfadc36be592a24037928206b3dcba170471f52a...f91af7252352459cc84dc5da8b367f4c571c9a31,3,9,18,27,5,2011-09-21 22:46:48,2011-09-21 22:46:48
f91af7252352459cc84dc5da8b367f4c571c9a31...5a01324f20305213cb4429b8ef4c376fe19a7fd7,3,24,9,33,5,2011-09-22 04:10:02,2011-09-22 04:10:02
5a01324f20305213cb4429b8ef4c376fe19a7fd7...0781ed8ec8dab4f4658787c9dc1ca8499ccc1a18,2,11,8,19,8,2011-09-22 04:16:21,2011-09-22 04:16:21
0781ed8ec8dab4f4658787c9dc1ca8499ccc1a18...1d96d886e7f36fcee918b7fa5c32b677bed83b0d,2,23,2,25,3,2011-09-22 04:30:20,2011-09-22 04:30:20
1d96d886e7f36fcee918b7fa5c32b677bed83b0d...4f9cf2ef2765af31c1fc2f195211f9335824824f,1,6,2,8,2,2011-09-22 04:36:15,2011-09-22 04:36:15
4f9cf2ef2765af31c1fc2f195211f9335824824f...4f109fcbfff87f1bdfc64fb3748ccff8bac297f5,1,17,7,24,2,2011-09-22 04:52:43,2011-09-22 04:52:43
4f109fcbfff87f1bdfc64fb3748ccff8bac297f5...f44c4a5d0f09367ccc032f77accc7826cc4d12e9,1,1,0,1,1,2011-09-22 05:10:52,2011-09-22 05:10:52
f44c4a5d0f09367ccc032f77accc7826cc4d12e9...d0979a5faf4fdf86650567540f623e4bbc68e09a,1,4,1,5,1,2011-09-22 05:21:51,2011-09-22 05:21:51
d0979a5faf4fdf86650567540f623e4bbc68e09a...0bd0bb7c2220339f20a6df1ce143e70c8955d1df,1,10,0,10,1,2011-09-22 05:56:47,2011-09-22 05:56:47
0bd0bb7c2220339f20a6df1ce143e70c8955d1df...c59339f450343960ee5dd2e2bb8d1a8507ccdaba,1,2,0,2,1,2011-09-22 06:37:50,2011-09-22 06:37:50
c59339f450343960ee5dd2e2bb8d1a8507ccdaba...66dc22c2d98c08a62588271507fd42bc7706541a,2,9,3,12,4,2011-09-22 15:04:27,2011-09-22 15:04:27
66dc22c2d98c08a62588271507fd42bc7706541a...2a2381a682d48ff458a77d188984384c41de2638,1,2,0,2,1,2011-09-22 15:04:34,2011-09-22 15:04:34
2a2381a682d48ff458a77d188984384c41de2638...49e019d559a4f2d7e7dbfd9a2626b9bcb7854c2d,1,1,1,2,1,2011-09-22 16:32:30,2011-09-22 16:32:30
49e019d559a4f2d7e7dbfd9a2626b9bcb7854c2d...bb641631e5e67d5bef431bee39746a7418b6af1e,2,2,0,2,2,2011-09-22 17:04:05,2011-09-22 17:04:05
bb641631e5e67d5bef431bee39746a7418b6af1e...39bbd1653a7d7b55476c529afad9d6932ee9d8ca,4,28,1,29,5,2011-09-22 21:09:00,2011-09-22 21:09:00
39bbd1653a7d7b55476c529afad9d6932ee9d8ca...ec7dde79c1cf3ea87a142ce1277b8d5b57da90e6,1,4,2,6,2,2011-09-22 21:52:00,2011-09-22 21:52:00
ec7dde79c1cf3ea87a142ce1277b8d5b57da90e6...1631e13d61c7e375469188b6d29a41a0adc54d49,1,2,0,2,1,2011-09-22 22:44:00,2011-09-22 22:44:00
1631e13d61c7e375469188b6d29a41a0adc54d49...642620897db5f29f6081cd5b112b32f42e8fe13e,1,2,2,4,1,2011-09-22 23:03:53,2011-09-22 23:03:53
642620897db5f29f6081cd5b112b32f42e8fe13e...4dab2d2f6b6327965872608febe798cc88f668bf,1,1,1,2,1,2011-09-22 23:30:05,2011-09-22 23:30:05
4dab2d2f6b6327965872608febe798cc88f668bf...0a9c52e013dede9c765fb2550cdef17caaafdccd,2,16,3,19,3,2011-09-23 04:22:30,2011-09-23 04:22:30
0a9c52e013dede9c765fb2550cdef17caaafdccd...33ad413c1ce7e30d339bd0c4f387162af26251f5,1,0,2,2,1,2011-09-23 16:33:52,2011-09-23 16:33:52
33ad413c1ce7e30d339bd0c4f387162af26251f5...6cae2a550d0d09d26554b9c0c0fbab2859ca45ec,6,225,71,296,42,2011-09-23 16:45:40,2011-09-23 16:45:40
6cae2a550d0d09d26554b9c0c0fbab2859ca45ec...b1c3174cfaf2e850da86c7649f64bf62f60046dc,1,11,17,28,12,2011-09-23 23:57:06,2011-09-23 23:57:06
b1c3174cfaf2e850da86c7649f64bf62f60046dc...f2ed107b079b050950e2fc5f2b689ca553ae12f5,9,85,167,252,31,2011-09-24 06:17:53,2011-09-24 06:17:53
f2ed107b079b050950e2fc5f2b689ca553ae12f5...ce9e3b4e9753f9b3bf2e5d8677dfbbabb0c6e33f,1,26,26,52,13,2011-09-24 13:32:57,2011-09-24 13:32:57
ce9e3b4e9753f9b3bf2e5d8677dfbbabb0c6e33f...4c457bca85b5410c47860ee4c5df0b47d48f2603,4,68,14,82,17,2011-09-24 19:48:27,2011-09-24 19:48:27
4c457bca85b5410c47860ee4c5df0b47d48f2603...482388cd61ee97d8898097fb6777c5d7ca4216af,2,10,8,18,4,2011-09-25 05:21:29,2011-09-25 05:21:29
482388cd61ee97d8898097fb6777c5d7ca4216af...3ef1762cb9f6495c89a5258461cbd9bcbc250557,3,15,5,20,5,2011-09-25 17:08:31,2011-09-25 17:08:31
3ef1762cb9f6495c89a5258461cbd9bcbc250557...735fbcfe8b955591f2c1db860eafae3fb87d4f48,2,53,41,94,24,2011-09-26 01:37:57,2011-09-26 01:37:57
735fbcfe8b955591f2c1db860eafae3fb87d4f48...11c1e61b99f40ed3e8d050fc88b624f52092b630,1,15,13,28,1,2011-09-26 10:11:18,2011-09-26 10:11:18
11c1e61b99f40ed3e8d050fc88b624f52092b630...0febe3b5bb220ecc698d4627c68c9ef4568a3cde,1,13,10,23,2,2011-09-26 11:24:38,2011-09-26 11:24:38
0febe3b5bb220ecc698d4627c68c9ef4568a3cde...29b8e34dfb27603ee3cf4fec67351c3a7a839c7c,2,7,12,19,7,2011-09-26 17:20:20,2011-09-26 17:20:20
29b8e34dfb27603ee3cf4fec67351c3a7a839c7c...8137027fd770ceb02d593605b22b8cfff1ef2e66,6,849,266,1115,124,2011-09-27 12:15:15,2011-09-27 12:15:15
8137027fd770ceb02d593605b22b8cfff1ef2e66...aaf8a31e5d86f9457672511e1beb915eb83d3c3c,1,254,178,432,64,2011-09-27 13:56:10,2011-09-27 13:56:10
aaf8a31e5d86f9457672511e1beb915eb83d3c3c...c340f6aa4dd8406fa241e23b6f36ed6be139b1a4,1,2,2,4,2,2011-09-28 02:26:12,2011-09-28 02:26:12
c340f6aa4dd8406fa241e23b6f36ed6be139b1a4...804e32fae0a7bfa6520c157888c5c5f6a77f6206,1,82,46,128,28,2011-09-28 14:00:43,2011-09-28 14:00:43
804e32fae0a7bfa6520c157888c5c5f6a77f6206...e3a6ac8f6052c4dea789c677db4ef1e367f36778,1,20,15,35,10,2011-09-29 15:30:19,2011-09-29 15:30:19
e3a6ac8f6052c4dea789c677db4ef1e367f36778...6d6fe61bf6251d1715c801196e5c4d45b24c1a79,2,37,33,70,31,2011-09-29 15:30:29,2011-09-29 15:30:29
6d6fe61bf6251d1715c801196e5c4d45b24c1a79...ec5bfed57ad86ec17a9169c279c967abbfbe52f9,1,10,8,18,5,2011-09-29 15:30:37,2011-09-29 15:30:37
ec5bfed57ad86ec17a9169c279c967abbfbe52f9...2eadc418aff64790eb5b8d06ac995c720c233e49,16,137,130,267,64,2011-09-30 10:28:39,2011-09-30 10:28:39
2eadc418aff64790eb5b8d06ac995c720c233e49...5009e45dfe366ebf520eecb49d72d5a11cee1623,4,87,40,127,27,2011-09-30 10:41:25,2011-09-30 10:41:25
5009e45dfe366ebf520eecb49d72d5a11cee1623...10d90cba83d5dfbe52eb5501279c3db71b42dd41,2,3,16,19,6,2011-09-30 11:46:23,2011-09-30 11:46:23
10d90cba83d5dfbe52eb5501279c3db71b42dd41...bf05da876ae711f021861849b4f6f5b80a91ee7f,1,23,1,24,2,2011-09-30 20:53:39,2011-09-30 20:53:39
bf05da876ae711f021861849b4f6f5b80a91ee7f...21a449168b6f9b0a4ec1589c0ebc5cf4ad6053cb,1,8,1,9,3,2011-09-30 21:40:56,2011-09-30 21:40:56
21a449168b6f9b0a4ec1589c0ebc5cf4ad6053cb...28ee7a9df3db9b4edf2deaf7d9dca2ca304bc193,1,76,77,153,7,2011-10-01 15:43:01,2011-10-01 15:43:01
28ee7a9df3db9b4edf2deaf7d9dca2ca304bc193...0d9b6a5bc43c06716212bd3f847460ce985381aa,3,246,31,277,17,2011-10-02 02:53:58,2011-10-02 02:53:58
0d9b6a5bc43c06716212bd3f847460ce985381aa...c2b9f6496e59c9268fb265ea80df8c8d7ec88034,11,161,140,301,92,2011-10-03 08:06:01,2011-10-03 08:06:01
c2b9f6496e59c9268fb265ea80df8c8d7ec88034...f3304d33109bbfc999d65506bc3d6f2c3e043d1f,1,15,0,15,1,2011-10-04 05:57:51,2011-10-04 05:57:51
f3304d33109bbfc999d65506bc3d6f2c3e043d1f...2a044732f64a8a5b26cdf11e081cd9d7b135e82a,2,19,12,31,3,2011-10-04 20:11:41,2011-10-04 20:11:41
2a044732f64a8a5b26cdf11e081cd9d7b135e82a...749f0721c4ebe14f0007ae56cc31bd7bae34ba66,1,3,3,6,3,2011-10-04 23:54:12,2011-10-04 23:54:12
749f0721c4ebe14f0007ae56cc31bd7bae34ba66...1ac2bb9b8e299e82e64d77cd97028dc907342dd8,1,4,1,5,1,2011-10-05 05:21:47,2011-10-05 05:21:47
1ac2bb9b8e299e82e64d77cd97028dc907342dd8...05cf72bace1bd455930d71e7cc94adbb01576ff1,1,1,1,2,1,2011-10-05 09:54:01,2011-10-05 09:54:01
05cf72bace1bd455930d71e7cc94adbb01576ff1...03d4a8d1b633ad918c9f85e765208bed00a1ad3a,1,50,26,76,20,2011-10-05 12:50:44,2011-10-05 12:50:44
03d4a8d1b633ad918c9f85e765208bed00a1ad3a...d30fbf8b782b96a4da0569f6d3f4031bf314b0c6,1,116,89,205,19,2011-10-05 22:56:09,2011-10-05 22:56:09
d30fbf8b782b96a4da0569f6d3f4031bf314b0c6...662eea116f5a188b6983f5f7c01c8247e3b6b309,10,968,24,992,34,2011-10-05 23:14:52,2011-10-05 23:14:52
662eea116f5a188b6983f5f7c01c8247e3b6b309...b763412aa4639d3e769eca4eab44835324e1b8d2,1,7,22,29,4,2011-10-06 11:08:11,2011-10-06 11:08:11
b763412aa4639d3e769eca4eab44835324e1b8d2...9279dce1feb1249e0451e2a8fb19b808e862efec,1,100,105,205,42,2011-10-06 17:31:18,2011-10-06 17:31:18
9279dce1feb1249e0451e2a8fb19b808e862efec...e2f9c11736db9e23004733760303f605f1cfb924,6,21,12,33,14,2011-10-06 20:39:15,2011-10-06 20:39:15
e2f9c11736db9e23004733760303f605f1cfb924...b1b1da1eac93297503c04b8394fb98e38f552f5f,8,341,72,413,38,2011-10-07 00:41:25,2011-10-07 00:41:25
b1b1da1eac93297503c04b8394fb98e38f552f5f...510ea906f7e3fcf7bf80b35302d90373b7dffb3d,2,4,4,8,2,2011-10-07 08:35:20,2011-10-07 08:35:20
510ea906f7e3fcf7bf80b35302d90373b7dffb3d...846fc7260a95cbb7235ed6f69a2cecee489d1048,1,1,1,2,1,2011-10-07 15:33:55,2011-10-07 15:33:55
846fc7260a95cbb7235ed6f69a2cecee489d1048...3f3010014b33451553c62b005c2ec09a16a9f9ce,4,53,15,68,7,2011-10-07 15:45:52,2011-10-07 15:45:52
3f3010014b33451553c62b005c2ec09a16a9f9ce...672f2db24a90ab5da10213fffe149b31b43b1391,1,6,3,9,1,2011-10-07 15:48:30,2011-10-07 15:48:30
672f2db24a90ab5da10213fffe149b31b43b1391...052a011ee6122482a471795c1994bbcfdb069611,8,367,120,487,54,2011-10-07 16:05:53,2011-10-07 16:05:53
052a011ee6122482a471795c1994bbcfdb069611...64da8eec3077eaaba5cfa62775523da772f4de44,1,21,9,30,8,2011-10-07 16:06:02,2011-10-07 16:06:02
64da8eec3077eaaba5cfa62775523da772f4de44...0f5d69155ef90d17a1763fc88712e84cf55ad4f2,1,1,1,2,2,2011-10-07 16:52:58,2011-10-07 16:52:58
0f5d69155ef90d17a1763fc88712e84cf55ad4f2...b6ad1afa6813226ff7d16f9f7b5751cb2d624c4b,3,48,13,61,6,2011-10-08 08:16:17,2011-10-08 08:16:17
b6ad1afa6813226ff7d16f9f7b5751cb2d624c4b...095dbe8804d89785b59ef0cd0381a31b31a2dab5,1,1,1,2,2,2011-10-08 11:36:05,2011-10-08 11:36:05
095dbe8804d89785b59ef0cd0381a31b31a2dab5...d5803bb5fb1a301a014bb681fedc09e2bcc6967b,2,7,7,14,7,2011-10-08 13:50:29,2011-10-08 13:50:29
d5803bb5fb1a301a014bb681fedc09e2bcc6967b...ac6361a3a641ed231e0380d2346114de11f407dc,1,3,2,5,3,2011-10-08 18:07:30,2011-10-08 18:07:30
ac6361a3a641ed231e0380d2346114de11f407dc...29def3e52c31ffd39c7a67e5fc04165133dd4440,1,3,0,3,1,2011-10-08 19:23:37,2011-10-08 19:23:37
29def3e52c31ffd39c7a67e5fc04165133dd4440...6d7461ffddda52a5bcd49bedda1307594f3599be,1,1,0,1,1,2011-10-09 11:37:48,2011-10-09 11:37:48
6d7461ffddda52a5bcd49bedda1307594f3599be...b95c06d423a019151b44dde27bcb7ea1617b83a6,1,12,11,23,2,2011-10-10 00:23:47,2011-10-10 00:23:47
b95c06d423a019151b44dde27bcb7ea1617b83a6...17659adf93574deeaeb23b867f1c67248a7a3c80,4,44,7,51,5,2011-10-10 12:35:06,2011-10-10 12:35:06
17659adf93574deeaeb23b867f1c67248a7a3c80...af244e47ccc88860fe928fec96c7873e3e4017fe,11,57,55,112,39,2011-10-10 15:32:01,2011-10-10 15:32:01
af244e47ccc88860fe928fec96c7873e3e4017fe...c61987d75ad9bc5233257f46a8246bb9d63bbbe1,8,798,818,1616,227,2011-10-10 17:32:33,2011-10-10 17:32:33
c61987d75ad9bc5233257f46a8246bb9d63bbbe1...4725a732e7b102636598e31fea4f683069a73086,1,2,2,4,2,2011-10-10 22:19:59,2011-10-10 22:19:59
4725a732e7b102636598e31fea4f683069a73086...e35ba97740dbfe5497c2517510dc55f6aa431300,2,3,3,6,3,2011-10-11 17:36:05,2011-10-11 17:36:05
e35ba97740dbfe5497c2517510dc55f6aa431300...a71bd3e0c99fec895cd2aea9ca0be228449bc2fc,1,2,2,4,2,2011-10-11 18:23:08,2011-10-11 18:23:08
a71bd3e0c99fec895cd2aea9ca0be228449bc2fc...3e940cdfd964bc37b1868b53a346308f66f995c1,1,4,3,7,2,2011-10-11 20:43:11,2011-10-11 20:43:11
3e940cdfd964bc37b1868b53a346308f66f995c1...8b801a7553f28c028fd8f602e9c5e86580600d8e,1,10,8,18,10,2011-10-11 21:55:45,2011-10-11 21:55:45
8b801a7553f28c028fd8f602e9c5e86580600d8e...5c8c7c34be173919501615151ab83229a1bd1c03,3,20,14,34,4,2011-10-11 22:21:14,2011-10-11 22:21:14
5c8c7c34be173919501615151ab83229a1bd1c03...a5e691e5de3bededca32ec8d9d997abae5ca81c9,1,13,18,31,12,2011-10-12 19:34:34,2011-10-12 19:34:34
a5e691e5de3bededca32ec8d9d997abae5ca81c9...f04af7080b12744c8f06fb8228ef683d556690d0,4,96,10,106,8,2011-10-12 20:51:59,2011-10-12 20:51:59
f04af7080b12744c8f06fb8228ef683d556690d0...38f1fe3b35c212136d959538a309c33bf2d340a9,12,237,143,380,87,2011-10-13 05:56:15,2011-10-13 05:56:15
38f1fe3b35c212136d959538a309c33bf2d340a9...9a5262b037c0b5c4270a11b19d7ef0ab59b6aef5,1,1,1,2,1,2011-10-13 06:41:40,2011-10-13 06:41:40
9a5262b037c0b5c4270a11b19d7ef0ab59b6aef5...3b22c683438e59ebe27a2d21ebd6d33fbf1644bd,3,198,72,270,58,2011-10-13 08:11:00,2011-10-13 08:11:00
3b22c683438e59ebe27a2d21ebd6d33fbf1644bd...4da7c772add8650cf01c4f3692271cba5b07e642,2,14,6,20,3,2011-10-13 09:20:10,2011-10-13 09:20:10
4da7c772add8650cf01c4f3692271cba5b07e642...1f1b16722efabb7cdc92e1fdc1b246e69974db38,2,2,1,3,2,2011-10-13 10:09:17,2011-10-13 10:09:17
1f1b16722efabb7cdc92e1fdc1b246e69974db38...d544110c52377014f08de454d08679caf9c8ab1c,1,5,14,19,3,2011-10-13 11:00:08,2011-10-13 11:00:08
d544110c52377014f08de454d08679caf9c8ab1c...639400d52fe4c364d91ec67cdb58a3174d33e8ad,1,13,0,13,1,2011-10-13 11:21:42,2011-10-13 11:21:42
639400d52fe4c364d91ec67cdb58a3174d33e8ad...c58e5724bcebc74ccfbc49a4a29de6fd0fa6103e,3,20,4,24,4,2011-10-13 11:53:59,2011-10-13 11:53:59
c58e5724bcebc74ccfbc49a4a29de6fd0fa6103e...406f9d1fa0424e9861c2d20a1001dbf4e29d4c9c,1,2,1,3,1,2011-10-13 12:23:58,2011-10-13 12:23:58
406f9d1fa0424e9861c2d20a1001dbf4e29d4c9c...43920cd32e24eb293b445028c7710b42f9abc7c4,6,27,22,49,24,2011-10-13 12:53:02,2011-10-13 12:53:02
43920cd32e24eb293b445028c7710b42f9abc7c4...99512d3544cd792e14927c24a8f92389c4006122,4,26,1,27,4,2011-10-13 13:38:38,2011-10-13 13:38:38
99512d3544cd792e14927c24a8f92389c4006122...d5a45d79fe03cad93ab5761860e9bb6fc1db4c86,119,378,185,563,258,2011-10-13 18:04:12,2011-10-13 18:04:12
d5a45d79fe03cad93ab5761860e9bb6fc1db4c86...d362c1546f8ad62811e5dee3cf0b43170e6e1c4c,104,389,213,602,240,2011-10-13 18:51:33,2011-10-13 18:51:33
d362c1546f8ad62811e5dee3cf0b43170e6e1c4c...b7845768cbfaf408b22a48e41d406f7135fe9729,3,6,18,24,6,2011-10-13 19:18:27,2011-10-13 19:18:27
b7845768cbfaf408b22a48e41d406f7135fe9729...06d9b82a27a4e47b435805938af23360e4291fb4,7,22,31,53,18,2011-10-13 19:23:45,2011-10-13 19:23:45
06d9b82a27a4e47b435805938af23360e4291fb4...38999f7e00c15b27c8200e799d7f0f3e9af607bb,1,0,6,6,1,2011-10-13 19:39:46,2011-10-13 19:39:46
38999f7e00c15b27c8200e799d7f0f3e9af607bb...f830166167833cfb7c990764f72373a9f4494259,2,50,4,54,4,2011-10-13 21:19:48,2011-10-13 21:19:48
f830166167833cfb7c990764f72373a9f4494259...8c0eefd066aa0e5bfe8c1006d055be8e2ad69a2b,144,576,261,837,289,2011-10-13 21:34:56,2011-10-13 21:34:56
8c0eefd066aa0e5bfe8c1006d055be8e2ad69a2b...5109ac370928a5924887424b6d6c803038fcb691,1,17,10,27,3,2011-10-13 21:44:58,2011-10-13 21:44:58
5109ac370928a5924887424b6d6c803038fcb691...d1e5c55258d624058a93c8cacdb1f25ae7857554,129,5865,5897,11762,1774,2011-10-14 00:12:01,2011-10-14 00:12:01
d1e5c55258d624058a93c8cacdb1f25ae7857554...d1e74092785111fb514488646f7d213a964e1703,2,13,13,26,5,2011-10-14 00:16:14,2011-10-14 00:16:14
d1e74092785111fb514488646f7d213a964e1703...6c915219027ca5785db30767620680380ff9377d,3,4,10,14,5,2011-10-14 00:20:50,2011-10-14 00:20:50
6c915219027ca5785db30767620680380ff9377d...69e1e6187a1263cdabbc0c177a1e08b1a8107a2c,6,35,60,95,60,2011-10-14 17:03:08,2011-10-14 17:03:08
69e1e6187a1263cdabbc0c177a1e08b1a8107a2c...246580573d7f1226aca39615dbf39956c520e6d7,18,251,73,324,23,2011-10-14 21:49:43,2011-10-14 21:49:43
246580573d7f1226aca39615dbf39956c520e6d7...a8e1d134a5f1838df5dab10d176c1b5350fcf891,2,17,11,28,8,2011-10-15 09:00:31,2011-10-15 09:00:31
a8e1d134a5f1838df5dab10d176c1b5350fcf891...22d738c2dc87c073c20051c9fd19fa2c2887dbaa,1,18,0,18,2,2011-10-15 10:16:24,2011-10-15 10:16:24
22d738c2dc87c073c20051c9fd19fa2c2887dbaa...c582609c8dbaa0a782999fa5f81e71d34ff219b8,1,61,23,84,6,2011-10-15 15:54:53,2011-10-15 15:54:53
c582609c8dbaa0a782999fa5f81e71d34ff219b8...93a581431a493febf173a8a3f2bd27ab450f228b,3,10,13,23,9,2011-10-16 06:42:50,2011-10-16 06:42:50
93a581431a493febf173a8a3f2bd27ab450f228b...d3cd9c0d0675e5067562a21b5341223ebd157761,1,6,4,10,3,2011-10-16 06:57:25,2011-10-16 06:57:25
d3cd9c0d0675e5067562a21b5341223ebd157761...d75337fc7b63400a4d866955d84d3092822c95ab,1,5,1,6,2,2011-10-16 09:46:01,2011-10-16 09:46:01
d75337fc7b63400a4d866955d84d3092822c95ab...03316579f4d804f6828af16b7377a214a3b51518,1,2,2,4,2,2011-10-16 09:51:22,2011-10-16 09:51:22
03316579f4d804f6828af16b7377a214a3b51518...8fb7a9002669fb7ba7bec7df90b465b92e1ed3c2,1,42,3,45,14,2011-10-16 11:04:34,2011-10-16 11:04:34
8fb7a9002669fb7ba7bec7df90b465b92e1ed3c2...b7f2aba56608fc65843abf50d1c1cc32af533a72,1,6,0,6,2,2011-10-16 14:30:43,2011-10-16 14:30:43
b7f2aba56608fc65843abf50d1c1cc32af533a72...5f2be4ecbb5df3760f4c6e49170478719d3026d7,2,10,1,11,2,2011-10-16 20:06:59,2011-10-16 20:06:59
5f2be4ecbb5df3760f4c6e49170478719d3026d7...313fab8623d68be1361e4b3383f587d79fadecd7,1,8,15,23,3,2011-10-16 20:38:22,2011-10-16 20:38:22
313fab8623d68be1361e4b3383f587d79fadecd7...d48510cc6b772048454f62d0b7caa11a75e60d79,1,4,2,6,2,2011-10-17 00:34:42,2011-10-17 00:34:42
d48510cc6b772048454f62d0b7caa11a75e60d79...62afd58c87318aa22970e86a8f80538befcadfc4,2,26,3,29,5,2011-10-17 00:56:32,2011-10-17 00:56:32
62afd58c87318aa22970e86a8f80538befcadfc4...ab72e6bdd1e42dce83fd7dba35919d6468d8ada3,1,4,2,6,2,2011-10-17 02:11:12,2011-10-17 02:11:12
ab72e6bdd1e42dce83fd7dba35919d6468d8ada3...da5c766dbbff0b85d8782c4384e44bac804afc53,2,3,3,6,2,2011-10-17 03:29:07,2011-10-17 03:29:07
da5c766dbbff0b85d8782c4384e44bac804afc53...87ffc6a6c2475fcbf61b4f27b49152901ca041cc,1,7,4,11,3,2011-10-17 13:15:40,2011-10-17 13:15:40
87ffc6a6c2475fcbf61b4f27b49152901ca041cc...6205a348f084cbab8d2953accecfc04b9fc75543,1,24,8,32,4,2011-10-17 15:43:24,2011-10-17 15:43:24
6205a348f084cbab8d2953accecfc04b9fc75543...4209ff1fcddecd51f254f595cbefd82c62750ff9,1,1,1,2,1,2011-10-17 15:52:01,2011-10-17 15:52:01
4209ff1fcddecd51f254f595cbefd82c62750ff9...1856e398c54f65e97e69ee78c9dae61044ab7318,1,6,3,9,4,2011-10-17 16:39:53,2011-10-17 16:39:53
1856e398c54f65e97e69ee78c9dae61044ab7318...544a8372fd7b27e5ba4672d127986bc82b4e739a,8,41,24,65,24,2011-10-17 16:56:18,2011-10-17 16:56:18
544a8372fd7b27e5ba4672d127986bc82b4e739a...66210cbc702af9ff5d6b08c87d09b10bd84fc0dd,17,104,43,147,64,2011-10-17 18:45:22,2011-10-17 18:45:22
66210cbc702af9ff5d6b08c87d09b10bd84fc0dd...396fcaaef92b6e5e56175b883c2cf6fcbda7ae97,40,218,106,324,166,2011-10-18 00:47:49,2011-10-18 00:47:49
396fcaaef92b6e5e56175b883c2cf6fcbda7ae97...14d24eb438c9930ff76302f263d0f2a8b42d13c1,2,26,2,28,4,2011-10-18 16:42:32,2011-10-18 16:42:32
14d24eb438c9930ff76302f263d0f2a8b42d13c1...67565a5379f19c6ca94e2c4f3b8e01684b32fe8f,5,5,5,10,5,2011-10-18 20:28:52,2011-10-18 20:28:52
67565a5379f19c6ca94e2c4f3b8e01684b32fe8f...2bc77be12e2a98ff9e4bc8fe4cf112c17c179403,2,16,4,20,5,2011-10-18 20:35:42,2011-10-18 20:35:42
2bc77be12e2a98ff9e4bc8fe4cf112c17c179403...358e5a8031be14efe33dc62e821408c2a6a8e85a,1,15,2,17,5,2011-10-19 00:09:41,2011-10-19 00:09:41
358e5a8031be14efe33dc62e821408c2a6a8e85a...26698bc85123935d5926a87a45cae25efe683639,10,324,22,346,39,2011-10-19 04:59:47,2011-10-19 04:59:47
26698bc85123935d5926a87a45cae25efe683639...51b8f0a2402d56ec84c2f12045291c0f7e6862e6,1,0,1,1,1,2011-10-20 04:23:34,2011-10-20 04:23:34
51b8f0a2402d56ec84c2f12045291c0f7e6862e6...1452cecd154c9a77af85e6a5b09e334797779be4,2,41,2,43,3,2011-10-20 12:14:06,2011-10-20 12:14:06
1452cecd154c9a77af85e6a5b09e334797779be4...b3b904994209bf568620def764e6a8e51de9ecb0,1,4,0,4,2,2011-10-20 17:21:10,2011-10-20 17:21:10
b3b904994209bf568620def764e6a8e51de9ecb0...01f4ce4c4993ecf0f5f3095e97ce92935337de61,2,16,4,20,7,2011-10-20 20:08:33,2011-10-20 20:08:33
01f4ce4c4993ecf0f5f3095e97ce92935337de61...9117a4af30b87f95f87a5ebdb2a0af965d4bebb6,1,1,1,2,2,2011-10-21 23:38:52,2011-10-21 23:38:52
9117a4af30b87f95f87a5ebdb2a0af965d4bebb6...dca81ad58a21ca9621a131c787544176618c27e8,2,24,6,30,8,2011-10-22 03:38:10,2011-10-22 03:38:10
dca81ad58a21ca9621a131c787544176618c27e8...145a77edc999fd5f1a53bc5bfd6b581386950074,34,635,208,843,60,2011-10-22 04:30:10,2011-10-22 04:30:10
145a77edc999fd5f1a53bc5bfd6b581386950074...36a44ae75f7779b558a60d5d315b36c5e2c98a0c,1,18,1,19,1,2011-10-22 06:06:44,2011-10-22 06:06:44
36a44ae75f7779b558a60d5d315b36c5e2c98a0c...ac88f048c909de17e57414e35bd4e8f2fa2c17c2,1,1,1,2,1,2011-10-22 06:13:01,2011-10-22 06:13:01
ac88f048c909de17e57414e35bd4e8f2fa2c17c2...4f00a2d316d6a8ffb6ca4ab6c89aaf8fb8bd3e60,2,47,0,47,4,2011-10-22 09:15:50,2011-10-22 09:15:50
4f00a2d316d6a8ffb6ca4ab6c89aaf8fb8bd3e60...67e6e0fcf35d93f88bfb1a4cbf5c6008d99dd923,13,840,871,1711,52,2011-10-22 17:17:57,2011-10-22 17:17:57
67e6e0fcf35d93f88bfb1a4cbf5c6008d99dd923...adf51b0cb8a4de39303267f1de86971cebfff65d,1,58,84,142,21,2011-10-22 23:39:09,2011-10-22 23:39:09
adf51b0cb8a4de39303267f1de86971cebfff65d...59c051d1707ec1c32256193221b6ee2e3e533be5,18,30,32,62,22,2011-10-23 03:43:43,2011-10-23 03:43:43
59c051d1707ec1c32256193221b6ee2e3e533be5...965c5d7cced0d2e09f5b0c3165c192ab4334331b,2,16,1,17,2,2011-10-23 15:19:09,2011-10-23 15:19:09
965c5d7cced0d2e09f5b0c3165c192ab4334331b...d89be53d95e1bc6827177d98d3c301e1f6c6fd9e,2,4,25,29,6,2011-10-24 20:50:39,2011-10-24 20:50:39
d89be53d95e1bc6827177d98d3c301e1f6c6fd9e...6df91d9539ae6469ad291cbfe257c84aeaa4d85d,2,9,13,22,11,2011-10-24 21:30:55,2011-10-24 21:30:55
6df91d9539ae6469ad291cbfe257c84aeaa4d85d...c1a014bba4f25e7d9c6c1a46737bcd5d490a13f7,1,4,10,14,4,2011-10-25 02:55:25,2011-10-25 02:55:25
c1a014bba4f25e7d9c6c1a46737bcd5d490a13f7...2e2689c7c0436f21d25e40f90f9d386311c776f9,4,29,2,31,8,2011-10-26 05:33:17,2011-10-26 05:33:17
2e2689c7c0436f21d25e40f90f9d386311c776f9...4d79083453e472d82633c5158ccbc5d6f6a6e247,3,17,4,21,6,2011-10-26 06:33:13,2011-10-26 06:33:13
4d79083453e472d82633c5158ccbc5d6f6a6e247...600c576ac56fc5c0567450c8cb5696f225de7c8d,3,17,20,37,6,2011-10-26 09:37:07,2011-10-26 09:37:07
600c576ac56fc5c0567450c8cb5696f225de7c8d...a05c70fae133d2ece1bcf1ce6f152a6a70ab8cf2,1,2,2,4,2,2011-10-26 10:38:12,2011-10-26 10:38:12
a05c70fae133d2ece1bcf1ce6f152a6a70ab8cf2...9796f69533320171bf22d769d6e4ab3f5a45aac1,6,94,24,118,24,2011-10-26 12:19:18,2011-10-26 12:19:18
9796f69533320171bf22d769d6e4ab3f5a45aac1...5a16b64ed29301fc7eb04405dac6ca4f58f550d2,1,12,8,20,5,2011-10-26 15:17:43,2011-10-26 15:17:43
5a16b64ed29301fc7eb04405dac6ca4f58f550d2...4819797f70ce718276466962418ba5ecc80d0fba,1,104,125,229,34,2011-10-26 20:55:36,2011-10-26 20:55:36
4819797f70ce718276466962418ba5ecc80d0fba...4cfb7632e0843edb19b38896a77b6e1e43711d77,5,0,19,19,5,2011-10-26 21:03:18,2011-10-26 21:03:18
4cfb7632e0843edb19b38896a77b6e1e43711d77...233cdcf42426d950e4dffeca47b26e926f50811f,1,8,11,19,4,2011-10-26 21:07:12,2011-10-26 21:07:12
233cdcf42426d950e4dffeca47b26e926f50811f...0cf139d20196cd055cae47b302370ec5442eac66,2,51,23,74,18,2011-10-26 22:47:04,2011-10-26 22:47:04
0cf139d20196cd055cae47b302370ec5442eac66...a693bbe0ac47c5ae36501bfd9f30ee28e723cb6c,1,2,0,2,1,2011-10-27 06:17:24,2011-10-27 06:17:24
a693bbe0ac47c5ae36501bfd9f30ee28e723cb6c...b87114962fa4d5dd4338b763b724f9836a31f63a,2,2,2,4,2,2011-10-28 04:11:41,2011-10-28 04:11:41
b87114962fa4d5dd4338b763b724f9836a31f63a...7a718f0f3a9d08b2f8159cdb8b665e5b84cab83e,2,14,0,14,2,2011-10-28 14:38:41,2011-10-28 14:38:41
7a718f0f3a9d08b2f8159cdb8b665e5b84cab83e...11861a29d51fb73ec2647398b306452948587cc5,1,1,1,2,1,2011-10-28 16:22:51,2011-10-28 16:22:51
11861a29d51fb73ec2647398b306452948587cc5...3e66913f967e01295d86a86b981e3f54fbda29a5,1,2,2,4,1,2011-10-28 21:23:50,2011-10-28 21:23:50
3e66913f967e01295d86a86b981e3f54fbda29a5...24f3c06e4aaee3370098d454dab61c175ccf8319,2,2,2,4,2,2011-10-29 12:24:44,2011-10-29 12:24:44
24f3c06e4aaee3370098d454dab61c175ccf8319...69eadc7f15c6bd2b3631037f500bc6c77b381a38,1,27,28,55,52,2011-10-29 14:39:02,2011-10-29 14:39:02
69eadc7f15c6bd2b3631037f500bc6c77b381a38...345be056227325817ea0f419556ce877c49c9d5b,2,28,11,39,3,2011-10-29 14:47:45,2011-10-29 14:47:45
345be056227325817ea0f419556ce877c49c9d5b...52c66a21e1b2d790f12da6e05e10142397998d31,4,58,64,122,67,2011-10-29 14:51:43,2011-10-29 14:51:43
52c66a21e1b2d790f12da6e05e10142397998d31...eedc9cb5f67dad63036126953b8955c763a86bbc,1,1,1,2,1,2011-10-29 15:01:17,2011-10-29 15:01:17
eedc9cb5f67dad63036126953b8955c763a86bbc...0a1a9b71fab11fd598e0699f09797eea55d42fce,2,28,27,55,18,2011-10-29 15:28:44,2011-10-29 15:28:44
0a1a9b71fab11fd598e0699f09797eea55d42fce...bebbc9e4a537f45bfd24a902d223ad96d743a524,2,18,6,24,4,2011-10-29 22:32:28,2011-10-29 22:32:28
bebbc9e4a537f45bfd24a902d223ad96d743a524...d17bc72880caea967ee1f4332941269837b68a2a,8,155,179,334,159,2011-10-30 07:32:21,2011-10-30 07:32:21
d17bc72880caea967ee1f4332941269837b68a2a...576e681302263c1ad0abe07b35c40b9cc4a343f1,7,0,8,8,8,2011-10-30 12:59:59,2011-10-30 12:59:59
576e681302263c1ad0abe07b35c40b9cc4a343f1...422f6e8e174b187a1224c49ca72e63193f08e081,1,23,0,23,1,2011-10-31 09:10:25,2011-10-31 09:10:25
422f6e8e174b187a1224c49ca72e63193f08e081...977316e0cb1a266b62112f58226f0a447f71336a,2,20,9,29,10,2011-10-31 11:09:10,2011-10-31 11:09:10
977316e0cb1a266b62112f58226f0a447f71336a...01964fd7e4ecd1998a2288e1759a63bd9a5fb2df,1,1,1,2,1,2011-10-31 18:54:24,2011-10-31 18:54:24
01964fd7e4ecd1998a2288e1759a63bd9a5fb2df...af1893c4ff8fdbf227a43a559d90bb1c1238b01a,3,20,6,26,6,2011-11-01 14:02:31,2011-11-01 14:02:31
af1893c4ff8fdbf227a43a559d90bb1c1238b01a...d71b4309ca3c4c7aafc446404f86499c7366a771,3,15,5,20,6,2011-11-01 20:07:42,2011-11-01 20:07:42
d71b4309ca3c4c7aafc446404f86499c7366a771...3b7a4c6adc0b709bf08679b9b3299af512166626,1,10,0,10,1,2011-11-01 21:37:12,2011-11-01 21:37:12
3b7a4c6adc0b709bf08679b9b3299af512166626...a97ecfdea80080da7e522d8dd8a4792a777694f9,1,40,0,40,1,2011-11-01 21:44:18,2011-11-01 21:44:18
a97ecfdea80080da7e522d8dd8a4792a777694f9...6d39cb4119a0fa502fca1f9b3d07436fbd258655,2,6,3,9,3,2011-11-01 21:50:17,2011-11-01 21:50:17
6d39cb4119a0fa502fca1f9b3d07436fbd258655...44a4037466f3f2db02ce191f05faa3230c17e910,1,5,4,9,1,2011-11-01 22:27:02,2011-11-01 22:27:02
44a4037466f3f2db02ce191f05faa3230c17e910...0e2c543979dfd06a40c1b34a6fb8eda2e92c8771,2,24,5,29,2,2011-11-02 17:45:32,2011-11-02 17:45:32
0e2c543979dfd06a40c1b34a6fb8eda2e92c8771...a82488bf4b57c1bc917f8ed79eac7a99d5e26bff,3,77,52,129,29,2011-11-03 10:51:02,2011-11-03 10:51:02
a82488bf4b57c1bc917f8ed79eac7a99d5e26bff...64bfec38e266942de6cc47f48550740bc3a54ced,1,2,2,4,2,2011-11-04 16:33:18,2011-11-04 16:33:18
64bfec38e266942de6cc47f48550740bc3a54ced...af7688dbec67ca7123aab7e8ead639bb7dbbced1,1,1,1,2,1,2011-11-04 23:00:37,2011-11-04 23:00:37
af7688dbec67ca7123aab7e8ead639bb7dbbced1...b2948d81798e78e0b3bcb016bd4efa4d66bc5d8e,2,62,0,62,3,2011-11-06 00:31:06,2011-11-06 00:31:06
b2948d81798e78e0b3bcb016bd4efa4d66bc5d8e...5f64af9ecb91b3a261b9094a8e6f8894c32abe61,2,15,9,24,8,2011-11-06 01:19:40,2011-11-06 01:19:40
5f64af9ecb91b3a261b9094a8e6f8894c32abe61...7f658a5429f1b8eb72157535ecdc05a136dc2be4,2,28,29,57,11,2011-11-06 16:58:04,2011-11-06 16:58:04
7f658a5429f1b8eb72157535ecdc05a136dc2be4...b745fc0f4b43280e5c5e10a52b3f3feaf3b58c2b,3,25,0,25,16,2011-11-07 01:09:13,2011-11-07 01:09:13
b745fc0f4b43280e5c5e10a52b3f3feaf3b58c2b...90d369741727dbf0cf1c94b23fb2340c7edb8b02,2,19,2,21,3,2011-11-07 07:41:24,2011-11-07 07:41:24
90d369741727dbf0cf1c94b23fb2340c7edb8b02...e92b3b723f9bf953d0465e92e444045cdc837042,2,12,1,13,6,2011-11-07 11:28:31,2011-11-07 11:28:31
e92b3b723f9bf953d0465e92e444045cdc837042...f1bc3b0401a4239696bb51fbcc8c03c3e013d894,1,2,0,2,1,2011-11-09 17:39:07,2011-11-09 17:39:07
f1bc3b0401a4239696bb51fbcc8c03c3e013d894...64fdd844740496519967068998c35109059338b5,1,1,1,2,1,2011-11-10 08:41:21,2011-11-10 08:41:21
64fdd844740496519967068998c35109059338b5...9d410ee64b1a0f2d8a714eeffa7e17e09965f01c,1,3,1,4,3,2011-11-11 12:25:53,2011-11-11 12:25:53
9d410ee64b1a0f2d8a714eeffa7e17e09965f01c...c3df840c20cc17ceb8fdcafb4215a6f3fb87fed1,5,46,12,58,16,2011-11-11 13:07:14,2011-11-11 13:07:14
c3df840c20cc17ceb8fdcafb4215a6f3fb87fed1...726f082aa95791dca4fa17dc76dbf8a392c0b1ab,1,1,2,3,1,2011-11-12 13:30:05,2011-11-12 13:30:05
726f082aa95791dca4fa17dc76dbf8a392c0b1ab...1aef1b20aaf73f19d0f4872a9702f41393014ec6,1,1,1,2,1,2011-11-12 13:39:42,2011-11-12 13:39:42
1aef1b20aaf73f19d0f4872a9702f41393014ec6...f4f61baa8c4e5213d17d99ed562186895b389952,3,17,10,27,7,2011-11-12 17:23:07,2011-11-12 17:23:07
f4f61baa8c4e5213d17d99ed562186895b389952...0426962dac7e1354d1c1aba9f319151c5d222f87,1,1,1,2,1,2011-11-12 17:37:29,2011-11-12 17:37:29
0426962dac7e1354d1c1aba9f319151c5d222f87...3fa49c4e6ed81e8e0b84e667ec782ee87b102f35,2,4,1,5,3,2011-11-12 18:47:51,2011-11-12 18:47:51
3fa49c4e6ed81e8e0b84e667ec782ee87b102f35...eb81f979a8d794a2e2beef9b4d5255fd519c536b,1,1,1,2,1,2011-11-12 18:50:50,2011-11-12 18:50:50
eb81f979a8d794a2e2beef9b4d5255fd519c536b...63ba472cc4a0ce34d28af74d11e8037a1b3d0f96,4,40,5,45,7,2011-11-12 19:06:39,2011-11-12 19:06:39
63ba472cc4a0ce34d28af74d11e8037a1b3d0f96...efe4e2e5178d2d6e6f710c3edee0d07cd6a60ab5,5,10,6,16,6,2011-11-12 19:53:56,2011-11-12 19:53:56
efe4e2e5178d2d6e6f710c3edee0d07cd6a60ab5...ba0734af9c54d1ace09285f6823cb8e4624acf99,1,4,2,6,1,2011-11-12 20:30:03,2011-11-12 20:30:03
ba0734af9c54d1ace09285f6823cb8e4624acf99...b45099eefb9a46264bcb8811dff6013cd1d0f6d6,2,16,1,17,3,2011-11-12 23:07:51,2011-11-12 23:07:51
b45099eefb9a46264bcb8811dff6013cd1d0f6d6...0db571b417ce9f9f10e30fae8513fbeaebd55fa7,2,8,2,10,4,2011-11-13 00:43:02,2011-11-13 00:43:02
0db571b417ce9f9f10e30fae8513fbeaebd55fa7...b8353016b7d6a4046f4c30017987c2e75597285b,2,17,1,18,4,2011-11-13 15:09:08,2011-11-13 15:09:08
b8353016b7d6a4046f4c30017987c2e75597285b...5de31cb8cb83c33d932d5ddf76ff81506c28bdff,7,11,7,18,11,2011-11-13 19:05:02,2011-11-13 19:05:02
5de31cb8cb83c33d932d5ddf76ff81506c28bdff...fae75a32eed227454873f8715bb0d11d6fc3ad39,1,3,0,3,1,2011-11-13 19:28:43,2011-11-13 19:28:43
fae75a32eed227454873f8715bb0d11d6fc3ad39...a6ccc8cc06e6b304e35f7a16f6067e6fa09b63ce,2,20,1,21,3,2011-11-15 09:36:08,2011-11-15 09:36:08
a6ccc8cc06e6b304e35f7a16f6067e6fa09b63ce...878cc410caf9df7f1a2742db5b6038116d4d4797,1,1,1,2,1,2011-11-16 00:03:43,2011-11-16 00:03:43
878cc410caf9df7f1a2742db5b6038116d4d4797...907015cb40a2b2cc9d3827fe990c28bed62f3524,1,1,0,1,1,2011-11-16 10:30:19,2011-11-16 10:30:19
907015cb40a2b2cc9d3827fe990c28bed62f3524...6d5f19ce82c806574a40d710d84c8e7360bc9398,0,0,0,0,0,2011-11-16 10:39:22,2011-11-16 10:39:22
6d5f19ce82c806574a40d710d84c8e7360bc9398...1adf8d438654cd91b0f5b77119e8dbf67dc975ce,4,13,14,27,8,2011-11-16 21:04:28,2011-11-16 21:04:28
1adf8d438654cd91b0f5b77119e8dbf67dc975ce...c20d33201c6eccc7f21f72bb61b1737be59b16d4,2,3,3,6,3,2011-11-17 21:16:42,2011-11-17 21:16:42
c20d33201c6eccc7f21f72bb61b1737be59b16d4...773d91ead2f47c3329c0c2d3745339e81d06eb4e,4,63,40,103,18,2011-11-17 21:30:07,2011-11-17 21:30:07
773d91ead2f47c3329c0c2d3745339e81d06eb4e...543984f462d1c031163cabfdfceb0809c65cd146,1,14,0,14,14,2011-11-17 22:00:08,2011-11-17 22:00:08
543984f462d1c031163cabfdfceb0809c65cd146...5e53f12761c5e0127f7fd44116c6db9f8088769c,1,3,4,7,2,2011-11-18 01:36:57,2011-11-18 01:36:57
5e53f12761c5e0127f7fd44116c6db9f8088769c...01f70349c9ef23d6751437dcd57d2efc193b2661,1,2,0,2,1,2011-11-18 07:09:18,2011-11-18 07:09:18
01f70349c9ef23d6751437dcd57d2efc193b2661...9b1cb755a28f020e27d4268c214b25315d4de42e,58,2719,283,3002,217,2011-11-18 13:01:06,2011-11-18 13:01:06
9b1cb755a28f020e27d4268c214b25315d4de42e...6f66b551081382323d37d9894aa0af53e9d9d725,9,54,40,94,40,2011-11-18 15:00:08,2011-11-18 15:00:08
6f66b551081382323d37d9894aa0af53e9d9d725...40b9532668b5e4d956c7be15f721be41d3defa3e,2,9,5,14,3,2011-11-18 22:54:24,2011-11-18 22:54:24
40b9532668b5e4d956c7be15f721be41d3defa3e...c29e089000a5c0ecfaecfa8d1296226d47ae2e03,1,4,3,7,2,2011-11-19 10:53:26,2011-11-19 10:53:26
c29e089000a5c0ecfaecfa8d1296226d47ae2e03...b4dcbe398d5ff5a6adb839caa26cc9a1b0d01c6d,1,1,1,2,1,2011-11-19 10:57:59,2011-11-19 10:57:59
b4dcbe398d5ff5a6adb839caa26cc9a1b0d01c6d...e41e3a543e3397e7bdd1409b58f5f17cb1f541b7,1,1,1,2,1,2011-11-19 11:38:40,2011-11-19 11:38:40
e41e3a543e3397e7bdd1409b58f5f17cb1f541b7...549c495875d279c17fbd418238a305bcc51cdad6,2,12,5,17,6,2011-11-19 14:18:44,2011-11-19 14:18:44
549c495875d279c17fbd418238a305bcc51cdad6...c8c71057aad21d71b512a87cc4a7020e8abfb12f,2,11,0,11,2,2011-11-19 15:08:07,2011-11-19 15:08:07
c8c71057aad21d71b512a87cc4a7020e8abfb12f...d0eb4693ab479ef0667cd5286ecc89c347b6b2de,4,49,10,59,8,2011-11-19 19:56:31,2011-11-19 19:56:31
d0eb4693ab479ef0667cd5286ecc89c347b6b2de...9b8e211dd368d7e5e304c79058c901bd2eb34e90,5,5,5,10,5,2011-11-19 22:57:20,2011-11-19 22:57:20
9b8e211dd368d7e5e304c79058c901bd2eb34e90...9c30d48b45cfe694233a9e636bb516bdd9200da9,4,40,12,52,13,2011-11-19 23:27:20,2011-11-19 23:27:20
9c30d48b45cfe694233a9e636bb516bdd9200da9...f6ee168919dd3638dc1a78e8cad068663cf3051e,1,4,0,4,4,2011-11-20 07:40:19,2011-11-20 07:40:19
f6ee168919dd3638dc1a78e8cad068663cf3051e...7075e932565d3a28d53ff014f0e33ce46df53496,3,59,18,77,19,2011-11-20 10:17:12,2011-11-20 10:17:12
7075e932565d3a28d53ff014f0e33ce46df53496...1240c8332db9ac68be0c9b0d17c8cc8b3a68cc01,1,4,3,7,1,2011-11-20 10:31:22,2011-11-20 10:31:22
1240c8332db9ac68be0c9b0d17c8cc8b3a68cc01...4ac594f8a55c94f6192fb33bb8f7b8a8ca671360,3,18,9,27,13,2011-11-20 10:33:44,2011-11-20 10:33:44
4ac594f8a55c94f6192fb33bb8f7b8a8ca671360...03cfad41986c91298e32d081a29d3c361098de5f,2,8,5,13,7,2011-11-20 10:50:18,2011-11-20 10:50:18
03cfad41986c91298e32d081a29d3c361098de5f...1510c3efda4d3dfdb49060f1ed66929c07dbf73a,3,8,7,15,10,2011-11-20 10:58:20,2011-11-20 10:58:20
1510c3efda4d3dfdb49060f1ed66929c07dbf73a...119e188717db82d3ce661fb5d1e0d3df1c91eb3a,1,2,2,4,3,2011-11-20 11:04:37,2011-11-20 11:04:37
119e188717db82d3ce661fb5d1e0d3df1c91eb3a...5c9901323ec07c399efbcf0fc6886a5f8a3f8589,2,45,4,49,3,2011-11-20 11:12:37,2011-11-20 11:12:37
5c9901323ec07c399efbcf0fc6886a5f8a3f8589...37b7f00fd0c86bcd6f935ae401095864076acd4d,1,19,0,19,4,2011-11-20 15:29:39,2011-11-20 15:29:39
37b7f00fd0c86bcd6f935ae401095864076acd4d...98b08bd4d449f5e32c53e498f6ba3f019b6b5191,2,9,7,16,9,2011-11-20 15:34:08,2011-11-20 15:34:08
98b08bd4d449f5e32c53e498f6ba3f019b6b5191...74b836abf541bb83047c5f07fbb6f49783d46475,2,49,7,56,7,2011-11-20 16:12:33,2011-11-20 16:12:33
74b836abf541bb83047c5f07fbb6f49783d46475...78a2719def81befc494a8b91510391e6b6f101e2,1,3,4,7,1,2011-11-20 20:43:59,2011-11-20 20:43:59
78a2719def81befc494a8b91510391e6b6f101e2...aa5230c4be0a03153206397b191a1e79cae9ecd3,1,4,5,9,2,2011-11-21 06:07:24,2011-11-21 06:07:24
aa5230c4be0a03153206397b191a1e79cae9ecd3...0a272e42012d0c727e09bd8956f58a0ef0337735,1,2,2,4,2,2011-11-21 07:08:39,2011-11-21 07:08:39
0a272e42012d0c727e09bd8956f58a0ef0337735...19e54084dc7d85d0bf190e0d79575126c5d29a50,2,10,3,13,4,2011-11-21 10:11:06,2011-11-21 10:11:06
19e54084dc7d85d0bf190e0d79575126c5d29a50...c5a899b190d1afa798efade499e8d00a5286fa28,6,40,12,52,10,2011-11-21 10:28:12,2011-11-21 10:28:12
c5a899b190d1afa798efade499e8d00a5286fa28...43c5d35315299330aaca1e2aab6fd2548eff7fcb,2,15,2,17,2,2011-11-21 12:42:09,2011-11-21 12:42:09
43c5d35315299330aaca1e2aab6fd2548eff7fcb...4d975b4f882eb2a68da02e069aa1debb99073497,5,40,12,52,10,2011-11-21 22:03:03,2011-11-21 22:03:03
4d975b4f882eb2a68da02e069aa1debb99073497...0506facd86082f48cc3cc3d3ea253e4ebbcd0ebe,3,12,4,16,5,2011-11-21 22:25:49,2011-11-21 22:25:49
0506facd86082f48cc3cc3d3ea253e4ebbcd0ebe...16e3636a1a99c0987d8cfb266c3584fedb763992,1,6,5,11,1,2011-11-21 22:50:35,2011-11-21 22:50:35
16e3636a1a99c0987d8cfb266c3584fedb763992...f2d02647fa8274c303a079191918e45d0b122472,1,3,0,3,1,2011-11-21 23:33:39,2011-11-21 23:33:39
f2d02647fa8274c303a079191918e45d0b122472...98f5127fb87bbde0b8732c144b8d405d927fba61,1,3,1,4,2,2011-11-21 23:40:11,2011-11-21 23:40:11
98f5127fb87bbde0b8732c144b8d405d927fba61...e13dc4905330dd2705d5b82420141b2fabab9a29,1,8,3,11,2,2011-11-22 01:05:14,2011-11-22 01:05:14
e13dc4905330dd2705d5b82420141b2fabab9a29...02a1b9a93e2ec7cc3bb87f2d38529b36eca65701,1,3,2,5,1,2011-11-22 01:10:00,2011-11-22 01:10:00
02a1b9a93e2ec7cc3bb87f2d38529b36eca65701...658abb0859382a07f88b2fe8e77d6c0035fcd456,1,0,2,2,2,2011-11-22 07:44:26,2011-11-22 07:44:26
658abb0859382a07f88b2fe8e77d6c0035fcd456...8ddecc39dbbb4da17a4eccff29bcf95efed991b8,4,126,54,180,15,2011-11-22 09:14:09,2011-11-22 09:14:09
8ddecc39dbbb4da17a4eccff29bcf95efed991b8...e71f33625c5979459e50644c700c04d8a27c4f4d,1,5,2,7,5,2011-11-22 09:20:58,2011-11-22 09:20:58
e71f33625c5979459e50644c700c04d8a27c4f4d...a89b15628429da79dd47c04bd191de566ef7eee6,4,213,153,366,56,2011-11-22 12:26:17,2011-11-22 12:26:17
a89b15628429da79dd47c04bd191de566ef7eee6...648adcd35ff76f56f0df88d3a7519a439da96f46,1,1,1,2,1,2011-11-24 13:17:24,2011-11-24 13:17:24
648adcd35ff76f56f0df88d3a7519a439da96f46...e954a03871cdc1c155ba7a3f3000dcf75998d9f4,1,6,0,6,1,2011-11-24 17:18:56,2011-11-24 17:18:56
e954a03871cdc1c155ba7a3f3000dcf75998d9f4...866c229f52df29f6b7b07463548532aae421fe42,4,13,2,15,5,2011-11-25 09:25:43,2011-11-25 09:25:43
866c229f52df29f6b7b07463548532aae421fe42...268d737558627346b8c75ea3d5f1d547e07df0ff,1,1,1,2,1,2011-11-25 19:40:46,2011-11-25 19:40:46
268d737558627346b8c75ea3d5f1d547e07df0ff...9c41437798d07f004e901378be04f09693935ad3,1,1,1,2,1,2011-11-26 08:43:43,2011-11-26 08:43:43
9c41437798d07f004e901378be04f09693935ad3...1086a9a8455420b7167fe5195bca4c74883dcef0,2,26,0,26,2,2011-11-26 22:27:16,2011-11-26 22:27:16
1086a9a8455420b7167fe5195bca4c74883dcef0...e4919f64b09a1813d5f1b4854f8b7c6e3a3c7a9a,2,43,55,98,26,2011-11-27 04:28:31,2011-11-27 04:28:31
e4919f64b09a1813d5f1b4854f8b7c6e3a3c7a9a...02bc523b89ae6fb37c26ce8d6424cb84751ad3ac,4,3,1,4,2,2011-11-27 10:31:26,2011-11-27 10:31:26
02bc523b89ae6fb37c26ce8d6424cb84751ad3ac...fb7ab7730d8381bd7a7aa0b1266757f02a5d4990,6,58,75,133,53,2011-11-27 13:00:56,2011-11-27 13:00:56
fb7ab7730d8381bd7a7aa0b1266757f02a5d4990...bda21e2b9d19f435d841a5ff9f8f636ae843842d,8,59,45,104,37,2011-11-27 17:52:24,2011-11-27 17:52:24
bda21e2b9d19f435d841a5ff9f8f636ae843842d...c11f9c3193901215ec79732af6ab6c66b3c1c2ba,2,7,0,7,2,2011-11-27 18:36:03,2011-11-27 18:36:03
c11f9c3193901215ec79732af6ab6c66b3c1c2ba...33a52cde08ef7ab8ba8990d40646d0dc2a8482df,3,21,9,30,5,2011-11-27 20:04:13,2011-11-27 20:04:13
33a52cde08ef7ab8ba8990d40646d0dc2a8482df...7872fc0dab2ad9971fb044b73ff33980aa4e7381,2,13,17,30,2,2011-11-27 20:13:37,2011-11-27 20:13:37
7872fc0dab2ad9971fb044b73ff33980aa4e7381...9d6321c9216db6f34cd0fe6cd6467f8b80029436,6,0,21,21,2,2011-11-27 21:17:33,2011-11-27 21:17:33
9d6321c9216db6f34cd0fe6cd6467f8b80029436...6bfae3de7cba50f53159694ae23aa65863760e06,1,2,2,4,1,2011-11-28 19:41:58,2011-11-28 19:41:58
6bfae3de7cba50f53159694ae23aa65863760e06...16ad0530c5d86dccff3952c52dff9f3138a205a5,2,7,3,10,2,2011-11-29 12:01:38,2011-11-29 12:01:38
16ad0530c5d86dccff3952c52dff9f3138a205a5...f2ebb169f9bf195a7c8126437708a482691a520d,1,2,3,5,2,2011-11-29 12:50:10,2011-11-29 12:50:10
f2ebb169f9bf195a7c8126437708a482691a520d...0d0f874d211f6ab57a5e336fa80069a65d5ae3f1,1,1,1,2,1,2011-11-29 14:20:23,2011-11-29 14:20:23
0d0f874d211f6ab57a5e336fa80069a65d5ae3f1...be8938f0d83911f33f9e439fea925a7f32ab5c96,2,10,2,12,7,2011-12-01 20:21:00,2011-12-01 20:21:00
be8938f0d83911f33f9e439fea925a7f32ab5c96...f51205d0edce4ae96a4d123388871b0ae0a136e8,11,15,15,30,14,2011-12-01 22:57:01,2011-12-01 22:57:01
f51205d0edce4ae96a4d123388871b0ae0a136e8...5e2f5d146618f1a21695d0df78853641aad5a154,4,7,7,14,7,2011-12-03 17:34:52,2011-12-03 17:34:52
5e2f5d146618f1a21695d0df78853641aad5a154...e42360b56b8a215e5752b42b63fa5f2a0b2e78fd,1,2,0,2,1,2011-12-03 19:15:12,2011-12-03 19:15:12
e42360b56b8a215e5752b42b63fa5f2a0b2e78fd...33bb3cd47cb287daa1246b705eff0f55bf72d284,2,10,1,11,3,2011-12-04 22:11:12,2011-12-04 22:11:12
33bb3cd47cb287daa1246b705eff0f55bf72d284...5f9dbef4bb5d8b9f077cd6a01b5e554f6dfb4f19,2,5,1,6,2,2011-12-05 23:11:43,2011-12-05 23:11:43
5f9dbef4bb5d8b9f077cd6a01b5e554f6dfb4f19...2693aa890ea6c8273dcdaeab6101203f37ffb1f3,1,6,18,24,2,2011-12-07 08:43:30,2011-12-07 08:43:30
2693aa890ea6c8273dcdaeab6101203f37ffb1f3...0519adb2a87090bd9ee3f61c7b9a6ff6de5fa341,1,4,4,8,1,2011-12-07 19:42:50,2011-12-07 19:42:50
0519adb2a87090bd9ee3f61c7b9a6ff6de5fa341...fc90c09efdfbc029d43e6d4c0952ed6b49f6f34d,4,87,1,88,7,2011-12-07 22:31:39,2011-12-07 22:31:39
fc90c09efdfbc029d43e6d4c0952ed6b49f6f34d...0920165bc26bd55131462befc234ce7993a744ba,1,1,1,2,1,2011-12-07 22:33:20,2011-12-07 22:33:20
0920165bc26bd55131462befc234ce7993a744ba...08bec4fbc10ca5638ad22f20a753ec5e8d92eb0e,4,62,7,69,7,2011-12-07 23:08:27,2011-12-07 23:08:27
08bec4fbc10ca5638ad22f20a753ec5e8d92eb0e...9b93f1c01c1a8bd66649d4c874301de851e46808,1,1,0,1,1,2011-12-09 19:52:20,2011-12-09 19:52:20
9b93f1c01c1a8bd66649d4c874301de851e46808...346324f1312654e9ee76c9b435583d7b2f009c90,1,15,5,20,3,2011-12-09 19:53:06,2011-12-09 19:53:06
346324f1312654e9ee76c9b435583d7b2f009c90...804a38c36945af72fced57af27469a96c8c47c55,1,5,1,6,2,2011-12-09 20:46:10,2011-12-09 20:46:10
804a38c36945af72fced57af27469a96c8c47c55...ce247476afa33510890034ada6219ec9c0e0044a,1,0,2,2,1,2011-12-09 21:09:59,2011-12-09 21:09:59
ce247476afa33510890034ada6219ec9c0e0044a...5c1c1a125443dd2219d6d9ba006c464a1c3956aa,2,5,8,13,4,2011-12-09 21:30:53,2011-12-09 21:30:53
5c1c1a125443dd2219d6d9ba006c464a1c3956aa...cfb7e477d38d76ef33883d56d69e7c5b8eba6de4,3,13,5,18,4,2011-12-09 21:41:20,2011-12-09 21:41:20
cfb7e477d38d76ef33883d56d69e7c5b8eba6de4...1a8b40c9fa1be20aee5ac0ef7a61e5ae3780f126,3,12,12,24,3,2011-12-09 21:43:24,2011-12-09 21:43:24
1a8b40c9fa1be20aee5ac0ef7a61e5ae3780f126...154438e315077e5cb95a6f34730b0eaf645d3ef6,1,11,5,16,7,2011-12-09 21:50:28,2011-12-09 21:50:28
154438e315077e5cb95a6f34730b0eaf645d3ef6...f450d7d716d94d44c3c4a167e93c3bfcb9f0f756,1,2,2,4,2,2011-12-09 21:53:21,2011-12-09 21:53:21
f450d7d716d94d44c3c4a167e93c3bfcb9f0f756...718a5ba1a1a77374c26b134ded46dab13776d1a1,2,41,1,42,5,2011-12-09 22:10:03,2011-12-09 22:10:03
718a5ba1a1a77374c26b134ded46dab13776d1a1...959f78b3c6fa77dc7df9cd449634dda240e12c75,2,13,7,20,3,2011-12-09 22:10:52,2011-12-09 22:10:52
959f78b3c6fa77dc7df9cd449634dda240e12c75...19cbdf8c8f6f5da5687cfec659841176b6af7d67,4,74,29,103,17,2011-12-09 22:13:27,2011-12-09 22:13:27
19cbdf8c8f6f5da5687cfec659841176b6af7d67...594a45ed292d79901d45252603dc8e7a5d991d22,1,8,6,14,4,2011-12-09 23:14:04,2011-12-09 23:14:04
594a45ed292d79901d45252603dc8e7a5d991d22...073d987a84d7ebdf3b70789f22b8a12a9f5ae96f,3,43,12,55,5,2011-12-09 23:16:56,2011-12-09 23:16:56
073d987a84d7ebdf3b70789f22b8a12a9f5ae96f...ff7556c4ec01395fe084746009af32ce91b2109f,6,254,81,335,33,2011-12-11 00:07:06,2011-12-11 00:07:06
ff7556c4ec01395fe084746009af32ce91b2109f...12a20b6c22854d5775388236ae289225ba388b17,2,30,0,30,1,2011-12-11 00:09:30,2011-12-11 00:09:30
12a20b6c22854d5775388236ae289225ba388b17...f2e99ecfdad245e9425bad038d5006912728e10d,3,6,13,19,16,2011-12-11 00:48:26,2011-12-11 00:48:26
f2e99ecfdad245e9425bad038d5006912728e10d...d317f2ab984c6c1bd6755de99f9600bc8d9a5041,1,2,0,2,1,2011-12-11 01:00:41,2011-12-11 01:00:41
d317f2ab984c6c1bd6755de99f9600bc8d9a5041...219b41cc155a216fc912cd37f215fb44acee317b,2,35,7,42,4,2011-12-11 08:19:04,2011-12-11 08:19:04
219b41cc155a216fc912cd37f215fb44acee317b...545c3159f57ca110f1b60f1f82b672a3a1b95b2c,1,10,1,11,3,2011-12-11 08:43:01,2011-12-11 08:43:01
545c3159f57ca110f1b60f1f82b672a3a1b95b2c...affca1369c85116022e42d34f8deae245ce654cd,2,49,1,50,3,2011-12-11 08:58:14,2011-12-11 08:58:14
affca1369c85116022e42d34f8deae245ce654cd...694bc0f22bdb30a472de6fec05a44adf5c0f1f2c,3,14,5,19,10,2011-12-11 10:03:09,2011-12-11 10:03:09
694bc0f22bdb30a472de6fec05a44adf5c0f1f2c...58276bd338a6d3f8361935dd49bc0500382f4c21,1,3,1,4,1,2011-12-11 12:04:37,2011-12-11 12:04:37
58276bd338a6d3f8361935dd49bc0500382f4c21...a935d436e9e11e1801ca5e9421a055e1f04eb125,2,51,0,51,3,2011-12-11 21:04:56,2011-12-11 21:04:56
a935d436e9e11e1801ca5e9421a055e1f04eb125...46c1d1551fce77323b3de477fe63aab0dbcf0257,1,1,1,2,1,2011-12-14 14:49:00,2011-12-14 14:49:00
46c1d1551fce77323b3de477fe63aab0dbcf0257...655b29b5ba6200560e69bcdcfae5e2e892bddd9c,2,20,0,20,3,2011-12-15 02:33:14,2011-12-15 02:33:14
655b29b5ba6200560e69bcdcfae5e2e892bddd9c...e7b5e2248420957709203c5ee56f4293730d5b31,1,71,59,130,5,2011-12-15 11:04:57,2011-12-15 11:04:57
e7b5e2248420957709203c5ee56f4293730d5b31...5df31c0164e9477a3ebb6b1bbde8604e06fbefd4,3,123,83,206,75,2011-12-15 16:12:46,2011-12-15 16:12:46
5df31c0164e9477a3ebb6b1bbde8604e06fbefd4...34e248efeca272a2c0f2b15a5347dd66fc0340c9,6,187,11,198,28,2011-12-16 13:40:19,2011-12-16 13:40:19
34e248efeca272a2c0f2b15a5347dd66fc0340c9...a1d2f1f7b76d434072c35b55678ce8a3bbfb4649,4,48,1,49,5,2011-12-16 17:02:41,2011-12-16 17:02:41
a1d2f1f7b76d434072c35b55678ce8a3bbfb4649...082cfce185bdc4cda0755549b7a3bb00500c9256,1,1,1,2,1,2011-12-16 20:21:16,2011-12-16 20:21:16
082cfce185bdc4cda0755549b7a3bb00500c9256...4d32e6abc2fe683ecdea719a368ed8a4ce84a699,1,0,5,5,1,2011-12-16 20:37:12,2011-12-16 20:37:12
4d32e6abc2fe683ecdea719a368ed8a4ce84a699...61f0aff811aa596fa62136852c59d47f988d1185,6,117,5,122,9,2011-12-16 22:06:06,2011-12-16 22:06:06
61f0aff811aa596fa62136852c59d47f988d1185...3f003a3c4b5338915e3889da8bf10577296459b3,9,92,50,142,40,2011-12-16 23:40:32,2011-12-16 23:40:32
3f003a3c4b5338915e3889da8bf10577296459b3...1b312edbeb469c58d8518cc0ece9cdb6c37f5c7e,1,4,2,6,1,2011-12-16 23:50:34,2011-12-16 23:50:34
1b312edbeb469c58d8518cc0ece9cdb6c37f5c7e...6cca104be0ee81f817a1f3cd3d3f7210fa7cc420,1,4,4,8,4,2011-12-17 00:17:26,2011-12-17 00:17:26
6cca104be0ee81f817a1f3cd3d3f7210fa7cc420...a848ef4e570c937325651f6864c650bc1fe9e137,2,4,5,9,3,2011-12-17 02:00:20,2011-12-17 02:00:20
a848ef4e570c937325651f6864c650bc1fe9e137...2494dd25f509c15d185c69a810b82188ab689390,1,4,3,7,3,2011-12-17 02:03:56,2011-12-17 02:03:56
2494dd25f509c15d185c69a810b82188ab689390...1bf58154f7dadf18e9189bd2e6bdbe6a73aae983,1,4,4,8,3,2011-12-17 02:15:01,2011-12-17 02:15:01
1bf58154f7dadf18e9189bd2e6bdbe6a73aae983...913b39b37f6ea9002b9b1fb944812bb623b962eb,1,1,1,2,1,2011-12-17 02:16:52,2011-12-17 02:16:52
913b39b37f6ea9002b9b1fb944812bb623b962eb...fefbb66bac4097b99539e292f707cd67cf4cb86a,1,1,0,1,1,2011-12-17 02:19:14,2011-12-17 02:19:14
fefbb66bac4097b99539e292f707cd67cf4cb86a...286c5c811b847fd5ef6cbc07060823c9059cedbf,1,1,1,2,1,2011-12-17 02:27:00,2011-12-17 02:27:00
286c5c811b847fd5ef6cbc07060823c9059cedbf...637a70fa7bad163de70bf4493b1ea73dd2147240,1,19,27,46,17,2011-12-17 02:31:34,2011-12-17 02:31:34
637a70fa7bad163de70bf4493b1ea73dd2147240...81bf5e395083f9bc9b6bca28dc1707064bff22a7,1,1,2,3,1,2011-12-17 02:37:26,2011-12-17 02:37:26
81bf5e395083f9bc9b6bca28dc1707064bff22a7...bfb4ed1425adb38e5c7b57a2aa9ab5479fc2123c,1,7,7,14,6,2011-12-17 02:40:35,2011-12-17 02:40:35
bfb4ed1425adb38e5c7b57a2aa9ab5479fc2123c...d3055b3382363163c3352347e69c47f58c3d49a1,1,27,28,55,18,2011-12-17 02:48:27,2011-12-17 02:48:27
d3055b3382363163c3352347e69c47f58c3d49a1...8767439af45d94025210ea13d0d4be465553b855,6,15,19,34,15,2011-12-17 03:53:25,2011-12-17 03:53:25
8767439af45d94025210ea13d0d4be465553b855...a4e516b593a5d4bd81a160b3b1a8cb4b23821b7d,2,7,5,12,3,2011-12-17 10:27:14,2011-12-17 10:27:14
a4e516b593a5d4bd81a160b3b1a8cb4b23821b7d...c7534584e8cbb33203675f92e71ec76fb5afd95c,1,2,0,2,1,2011-12-17 15:30:55,2011-12-17 15:30:55
c7534584e8cbb33203675f92e71ec76fb5afd95c...20c8aa2a2029be50449b25122f85bbef0f2b957f,19,25,25,50,25,2011-12-17 17:37:24,2011-12-17 17:37:24
20c8aa2a2029be50449b25122f85bbef0f2b957f...e31c43a360c5b36279b5651030f5e95fad5fc398,1,1,1,2,1,2011-12-17 17:38:08,2011-12-17 17:38:08
e31c43a360c5b36279b5651030f5e95fad5fc398...b5d9ad982d8f28921d31f163e6d636a310a95922,1,1,0,1,1,2011-12-17 22:10:37,2011-12-17 22:10:37
b5d9ad982d8f28921d31f163e6d636a310a95922...5003df3659f8f6d32f60bab8c409a1159cc956a1,1,3,1,4,1,2011-12-17 23:00:41,2011-12-17 23:00:41
5003df3659f8f6d32f60bab8c409a1159cc956a1...5a48cb5f61b2670b53f378bb704fa819f7e38111,1,2,0,2,1,2011-12-19 11:53:16,2011-12-19 11:53:16
5a48cb5f61b2670b53f378bb704fa819f7e38111...3e790ae63266bee48ad659ddedc792219ee33a0e,4,58,7,65,12,2011-12-19 12:11:12,2011-12-19 12:11:12
3e790ae63266bee48ad659ddedc792219ee33a0e...ad5df5119f1281a6b2329ffd2326be186a0e8fae,2,11,0,11,2,2011-12-19 12:28:39,2011-12-19 12:28:39
ad5df5119f1281a6b2329ffd2326be186a0e8fae...ed56e2c4a8f459362ae83cfce03d82193adac6ef,5,14,14,28,7,2011-12-19 12:58:18,2011-12-19 12:58:18
ed56e2c4a8f459362ae83cfce03d82193adac6ef...1ef6841cade19b06508f74d8602acee0805e88b5,2,20,22,42,7,2011-12-19 13:13:41,2011-12-19 13:13:41
1ef6841cade19b06508f74d8602acee0805e88b5...355f7fc564cb4dc67a84075664bf98ac203d2b13,2,24,11,35,9,2011-12-19 13:36:32,2011-12-19 13:36:32
355f7fc564cb4dc67a84075664bf98ac203d2b13...259ebcdeeac9929b173cae8bbc5f7dd4ee102cb8,4,19,19,38,18,2011-12-19 13:52:40,2011-12-19 13:52:40
259ebcdeeac9929b173cae8bbc5f7dd4ee102cb8...554f0601b59309df8c9da2f14c56f9ea97aabc91,5,78,11,89,17,2011-12-19 14:59:14,2011-12-19 14:59:14
554f0601b59309df8c9da2f14c56f9ea97aabc91...295fd50752d721e7bf5add5a7fa06887c605a8b4,1,1,1,2,1,2011-12-20 17:03:13,2011-12-20 17:03:13
295fd50752d721e7bf5add5a7fa06887c605a8b4...39109b0e44c77d0acf1c48c9f48e3631eff5f122,1,3,1,4,1,2011-12-21 11:05:43,2011-12-21 11:05:43
39109b0e44c77d0acf1c48c9f48e3631eff5f122...45e3dff5ac697f16829697bc2a899eaeac8986ea,2,7,8,15,5,2011-12-21 15:35:58,2011-12-21 15:35:58
45e3dff5ac697f16829697bc2a899eaeac8986ea...2f02a05ffb45be68b4164b4785ff1826833150a3,21,921,46,967,68,2011-12-22 08:33:58,2011-12-22 08:33:58
2f02a05ffb45be68b4164b4785ff1826833150a3...2f18d8b4b0bb12edbb28b0f1f4d1fc34364758c4,3,1093,19,1112,5,2011-12-22 20:18:54,2011-12-22 20:18:54
2f18d8b4b0bb12edbb28b0f1f4d1fc34364758c4...03eb2907d5e3d600964836287e9d3f48ec7ec667,1,2,2,4,1,2011-12-22 20:29:18,2011-12-22 20:29:18
03eb2907d5e3d600964836287e9d3f48ec7ec667...287565779d3ae4d3229ecbb2ff356c79b920e7d0,16,374,43,417,51,2011-12-22 20:42:40,2011-12-22 20:42:40
287565779d3ae4d3229ecbb2ff356c79b920e7d0...98c974c70b4065e649a1d1f0b21062d48bec4bdb,1,7,1,8,2,2011-12-22 22:08:32,2011-12-22 22:08:32
98c974c70b4065e649a1d1f0b21062d48bec4bdb...a9a0f0b03f9a02deb03617bf7e9773a307d1328f,29,996,266,1262,163,2011-12-22 22:38:02,2011-12-22 22:38:02
a9a0f0b03f9a02deb03617bf7e9773a307d1328f...ad1c376d39f1a07c4a00b6531f2ce1223e9183d6,1,11,3,14,4,2011-12-22 22:38:10,2011-12-22 22:38:10
ad1c376d39f1a07c4a00b6531f2ce1223e9183d6...cbe82411cc57c5c574c90b34f3e4622314ffa1c4,1,1,0,1,1,2011-12-22 22:46:05,2011-12-22 22:46:05
cbe82411cc57c5c574c90b34f3e4622314ffa1c4...0e9b1041d7545b5edcf94dac83011c6d9ee71747,1,2,2,4,1,2011-12-22 23:01:53,2011-12-22 23:01:53
0e9b1041d7545b5edcf94dac83011c6d9ee71747...4c376852fe4f8d8ed13b34cdd52c398a9c3f5750,16,935,742,1677,642,2011-12-22 23:02:28,2011-12-22 23:02:28
4c376852fe4f8d8ed13b34cdd52c398a9c3f5750...a0721a30178d621501756db543258bc2d527af21,3,24,9,33,12,2011-12-22 23:03:48,2011-12-22 23:03:48
a0721a30178d621501756db543258bc2d527af21...a976159db0d40d8e1bd1a7bc70f7508839e8a95d,2,264,262,526,124,2011-12-23 01:49:32,2011-12-23 01:49:32
a976159db0d40d8e1bd1a7bc70f7508839e8a95d...dce820ff70f00e974afd3e6e310aa825bc55319f,9,309,93,402,32,2011-12-23 03:46:06,2011-12-23 03:46:06
dce820ff70f00e974afd3e6e310aa825bc55319f...90e05aaeac612a4251640564aa65f103ac635e12,4,623,63,686,4,2011-12-23 03:53:56,2011-12-23 03:53:56
90e05aaeac612a4251640564aa65f103ac635e12...0e29e48c0548586e999eea090f2da7f2b03563c6,3,5,5,10,5,2011-12-23 04:00:26,2011-12-23 04:00:26
0e29e48c0548586e999eea090f2da7f2b03563c6...3e2edad9c7c6b980bbc182e9b7569138d1c70a3b,1,1,1,2,1,2011-12-23 04:03:27,2011-12-23 04:03:27
3e2edad9c7c6b980bbc182e9b7569138d1c70a3b...d49fd627a64aa888924ef463d4de59fc904c6609,1,1,1,2,1,2011-12-23 04:04:43,2011-12-23 04:04:43
d49fd627a64aa888924ef463d4de59fc904c6609...2d1a681f77259e9652c357a634920d7f8f1ecd97,1,17,0,17,1,2011-12-23 05:00:51,2011-12-23 05:00:51
2d1a681f77259e9652c357a634920d7f8f1ecd97...7a67102e8d869eb0d130d99b90387bd40aa91ee7,1,1,1,2,1,2011-12-23 11:19:00,2011-12-23 11:19:00
7a67102e8d869eb0d130d99b90387bd40aa91ee7...64066a59d9fd4ee746e373e98a2cc1c7e26801e3,1,2,1,3,2,2011-12-23 11:22:13,2011-12-23 11:22:13
64066a59d9fd4ee746e373e98a2cc1c7e26801e3...7c6e265a9f5e084f383532abef7624cca08c8071,1,165,143,308,13,2011-12-23 11:24:35,2011-12-23 11:24:35
7c6e265a9f5e084f383532abef7624cca08c8071...2a9ae71780eca4da32d5e226b48785d1091388b7,3,12,12,24,6,2011-12-23 12:19:05,2011-12-23 12:19:05
2a9ae71780eca4da32d5e226b48785d1091388b7...27f5fefc54a2b728558cc5d7e6557d0eb88fd61d,1,1,1,2,1,2011-12-23 18:46:29,2011-12-23 18:46:29
27f5fefc54a2b728558cc5d7e6557d0eb88fd61d...6fcbe90954c6b0661c4b68c79856ec55202f85f2,2,4,4,8,2,2011-12-23 19:13:10,2011-12-23 19:13:10
6fcbe90954c6b0661c4b68c79856ec55202f85f2...14ba0df3d0b14bd7ecc5fbe099ea11864718b492,1,10,10,20,6,2011-12-23 19:18:44,2011-12-23 19:18:44
14ba0df3d0b14bd7ecc5fbe099ea11864718b492...1c169071998702880b4fa534c06b35c20f184eef,4,43,0,43,5,2011-12-24 00:14:45,2011-12-24 00:14:45
1c169071998702880b4fa534c06b35c20f184eef...ddb2a9eb9e3f3f14212eb85325fb2f30aba1fb1f,2,15,7,22,6,2011-12-24 11:01:57,2011-12-24 11:01:57
ddb2a9eb9e3f3f14212eb85325fb2f30aba1fb1f...91f5970bb4acc84dcb92e4f4f0034fcb7aba1582,1,2,0,2,1,2011-12-24 11:15:26,2011-12-24 11:15:26
91f5970bb4acc84dcb92e4f4f0034fcb7aba1582...fe876f01193942121d6968f514beecf7e018b605,1,1,1,2,1,2011-12-24 11:58:49,2011-12-24 11:58:49
fe876f01193942121d6968f514beecf7e018b605...d72c0bdc46a97c53d5e60b7e373d2f8e24673bb1,2,19,18,37,8,2011-12-24 19:38:37,2011-12-24 19:38:37
d72c0bdc46a97c53d5e60b7e373d2f8e24673bb1...4c445fdfaa7c315ed2fcdcf4c00de2c3cdcfcbb6,2,10,0,10,2,2011-12-24 20:45:58,2011-12-24 20:45:58
4c445fdfaa7c315ed2fcdcf4c00de2c3cdcfcbb6...4403ce10b75b4b399064eccb960f9f38c796431d,1,0,7,7,1,2011-12-24 20:48:19,2011-12-24 20:48:19
4403ce10b75b4b399064eccb960f9f38c796431d...ff1f423d29f431e732978ac44d2ad9d5a8917d17,2,5,5,10,3,2011-12-25 12:47:13,2011-12-25 12:47:13
ff1f423d29f431e732978ac44d2ad9d5a8917d17...db2b1458b1fc83c8485687634934b7c4909cde78,2,26,8,34,6,2011-12-25 13:24:39,2011-12-25 13:24:39
db2b1458b1fc83c8485687634934b7c4909cde78...5df784ab4293fb6740d062fe868be7bcafed348a,1,5,2,7,1,2011-12-25 18:53:29,2011-12-25 18:53:29
5df784ab4293fb6740d062fe868be7bcafed348a...b04578372930431827019a821ff946b36db3256d,1,2,2,4,2,2011-12-25 19:44:20,2011-12-25 19:44:20
b04578372930431827019a821ff946b36db3256d...e8a6fee6e66f9745e2580b329c93e369801a8318,2,5,3,8,3,2011-12-27 08:22:55,2011-12-27 08:22:55
e8a6fee6e66f9745e2580b329c93e369801a8318...a62ce30661c62606b5648ac27ac808bbb1b0e6bb,1,26,1,27,18,2011-12-27 09:28:50,2011-12-27 09:28:50
a62ce30661c62606b5648ac27ac808bbb1b0e6bb...cac7818e5ee83db486c170cb0002eb3f41d4fa84,1,4,16,20,4,2011-12-27 14:54:00,2011-12-27 14:54:00
cac7818e5ee83db486c170cb0002eb3f41d4fa84...12206bdf0fdafc6a4a3922b77902deaa3d5d4370,1,3,3,6,1,2011-12-27 15:04:05,2011-12-27 15:04:05
12206bdf0fdafc6a4a3922b77902deaa3d5d4370...ae0ce4373ff63fac22f4673928f2cf4378cb54e0,1,5,5,10,10,2011-12-27 15:35:41,2011-12-27 15:35:41
ae0ce4373ff63fac22f4673928f2cf4378cb54e0...46c12d1293aa90209f3c640f214c4b5a3d6cb9e6,6,33,6,39,11,2011-12-27 22:49:24,2011-12-27 22:49:24
46c12d1293aa90209f3c640f214c4b5a3d6cb9e6...a343a84ce6a8e7e0de2998ac423cbc1cecdb9aea,3,60,0,60,4,2011-12-28 22:20:30,2011-12-28 22:20:30
a343a84ce6a8e7e0de2998ac423cbc1cecdb9aea...953a471a21444be9bcbc60537853c058d2b23314,2,18,1,19,3,2011-12-29 01:18:30,2011-12-29 01:18:30
953a471a21444be9bcbc60537853c058d2b23314...ec07a30e821ada170904df8901787e05b7959594,1,1,1,2,1,2011-12-29 07:28:21,2011-12-29 07:28:21
ec07a30e821ada170904df8901787e05b7959594...3367913c3db97a15b64f03646ac2c4486a77376f,2,36,6,42,6,2011-12-29 13:57:32,2011-12-29 13:57:32
3367913c3db97a15b64f03646ac2c4486a77376f...f185024fc40d38fb4bcb9d3bb4a9b7a9e0f94219,3,25,12,37,11,2011-12-29 17:03:38,2011-12-29 17:03:38
f185024fc40d38fb4bcb9d3bb4a9b7a9e0f94219...a82204fa9a5c9262252cb038628ce49477e0f7cf,2,25,11,36,3,2011-12-29 19:06:57,2011-12-29 19:06:57
a82204fa9a5c9262252cb038628ce49477e0f7cf...0bf2d337701a41d9fc42c6cac608e18f989a9866,3,102,37,139,17,2011-12-29 20:22:13,2011-12-29 20:22:13
0bf2d337701a41d9fc42c6cac608e18f989a9866...067352ec02c6ca80feb9709e161ea04547b37324,2,13,20,33,8,2011-12-30 12:21:40,2011-12-30 12:21:40
067352ec02c6ca80feb9709e161ea04547b37324...e5999ce234c2e2af05ba5ca5f7e44f35c864603e,1,8,8,16,3,2011-12-30 12:41:24,2011-12-30 12:41:24
e5999ce234c2e2af05ba5ca5f7e44f35c864603e...5e75678c8b7d3cc54aa27b7b682561c5fee64c6c,2,20,2,22,3,2011-12-30 12:44:35,2011-12-30 12:44:35
5e75678c8b7d3cc54aa27b7b682561c5fee64c6c...ca984aa50a4ac9278c8828c8fa178e678baa77a1,1,12,0,12,1,2011-12-30 12:52:49,2011-12-30 12:52:49
ca984aa50a4ac9278c8828c8fa178e678baa77a1...fa226cd740f1349383d5e8399dc8a5255b70f07a,1,5,1,6,2,2011-12-30 12:55:08,2011-12-30 12:55:08
fa226cd740f1349383d5e8399dc8a5255b70f07a...baf63f6e5731bea3da74803ac17be890a99b056b,1,5,1,6,1,2011-12-30 14:12:31,2011-12-30 14:12:31
baf63f6e5731bea3da74803ac17be890a99b056b...27444618f6f8822110808a5d663a400334b8e9d7,2,26,2,28,6,2011-12-30 14:35:29,2011-12-30 14:35:29
27444618f6f8822110808a5d663a400334b8e9d7...c458700382724e85d8572fc80cd829f54d57d43d,2,13,2,15,3,2011-12-30 14:51:05,2011-12-30 14:51:05
c458700382724e85d8572fc80cd829f54d57d43d...39201d8fe55df561911e274f805eff3fa7e5819f,1,18,0,18,1,2011-12-30 14:55:44,2011-12-30 14:55:44
39201d8fe55df561911e274f805eff3fa7e5819f...afb21094a9fefd157f22b9706026625b66d10048,1,10,0,10,2,2011-12-30 15:30:51,2011-12-30 15:30:51
afb21094a9fefd157f22b9706026625b66d10048...d3ef13044e73c64e7f8f46c5030040a5566012b3,3,20,16,36,7,2011-12-30 18:01:34,2011-12-30 18:01:34
d3ef13044e73c64e7f8f46c5030040a5566012b3...de697769b7c1b67d038f49799b167690f5320177,3,36,33,69,20,2011-12-30 18:14:31,2011-12-30 18:14:31
de697769b7c1b67d038f49799b167690f5320177...f2dcca6631d4908e735ae4f935b03f2531c85595,1,172,172,344,97,2011-12-30 19:18:03,2011-12-30 19:18:03
f2dcca6631d4908e735ae4f935b03f2531c85595...103890561be52a074ef30c08d4ecc2d98066c259,2,25,28,53,2,2011-12-30 20:23:26,2011-12-30 20:23:26
103890561be52a074ef30c08d4ecc2d98066c259...32ee74f89edd88fb37ca223b1e146eebe8fb6c1b,1,13,14,27,5,2011-12-30 20:29:27,2011-12-30 20:29:27
32ee74f89edd88fb37ca223b1e146eebe8fb6c1b...ffb0519d44dbf6254f0c0600397d901d207be839,1,6,7,13,4,2011-12-30 20:34:07,2011-12-30 20:34:07
ffb0519d44dbf6254f0c0600397d901d207be839...1fed65224f2b5912f8d28cf6de47577f287088e9,1,3,1,4,2,2011-12-30 20:35:44,2011-12-30 20:35:44
1fed65224f2b5912f8d28cf6de47577f287088e9...937213c2c37f71be1b112d9767f6ee8aecf0cfcf,1,5,4,9,3,2011-12-30 20:36:54,2011-12-30 20:36:54
937213c2c37f71be1b112d9767f6ee8aecf0cfcf...67f7756000aab9cf1042fa155abe9b5d1020b117,1,7,7,14,2,2011-12-30 20:39:08,2011-12-30 20:39:08
67f7756000aab9cf1042fa155abe9b5d1020b117...143fa9193c4dd7d921686350298cc689e476f1d9,1,2,2,4,1,2011-12-30 20:43:01,2011-12-30 20:43:01
143fa9193c4dd7d921686350298cc689e476f1d9...d4f11eb7766286d48800425b9d923ea28f7cdf2e,1,3,1,4,2,2011-12-30 21:13:08,2011-12-30 21:13:08
d4f11eb7766286d48800425b9d923ea28f7cdf2e...9fe578c212b16752d478e7b1cb73325c3922f7ad,1,5,0,5,1,2011-12-30 21:13:53,2011-12-30 21:13:53
9fe578c212b16752d478e7b1cb73325c3922f7ad...060783d52ddf73f4b538526a917a19006258149e,1,6,0,6,1,2011-12-31 00:43:11,2011-12-31 00:43:11
060783d52ddf73f4b538526a917a19006258149e...72793766a7e5218e8b5d7161cc466abfd70a7d46,1,7,0,7,1,2011-12-31 15:30:22,2011-12-31 15:30:22
72793766a7e5218e8b5d7161cc466abfd70a7d46...068dcbddb9b967bc13ed296ca485bd3dcf49490f,1,1,1,2,1,2011-12-31 15:34:49,2011-12-31 15:34:49
068dcbddb9b967bc13ed296ca485bd3dcf49490f...f250ef3573d44ebb2c17c401851768a235742062,2,26,5,31,8,2012-01-01 17:45:40,2012-01-01 17:45:40
f250ef3573d44ebb2c17c401851768a235742062...b9910bddd268f211a5b97e98d912caaf5d4b257c,1,2,1,3,1,2012-01-01 20:59:09,2012-01-01 20:59:09
b9910bddd268f211a5b97e98d912caaf5d4b257c...1aaa0dd09865980743f940bc16ea1982aee49866,1,8,1,9,2,2012-01-01 21:11:05,2012-01-01 21:11:05
1aaa0dd09865980743f940bc16ea1982aee49866...9cce7a5ea8e3006069041e6a6bf7294f7e643396,1,1,1,2,1,2012-01-01 21:54:33,2012-01-01 21:54:33
9cce7a5ea8e3006069041e6a6bf7294f7e643396...8af9084495deb74fb3b34b8690daac6774d03109,1,1,1,2,1,2012-01-02 11:19:06,2012-01-02 11:19:06
8af9084495deb74fb3b34b8690daac6774d03109...cb99b598c1b868016f82a1d8c3b957f0277fba2c,2,113,58,171,39,2012-01-02 14:21:50,2012-01-02 14:21:50
cb99b598c1b868016f82a1d8c3b957f0277fba2c...991d3d6c12296b381959ae86e74fd505604daeac,1,58,30,88,18,2012-01-02 14:51:25,2012-01-02 14:51:25
991d3d6c12296b381959ae86e74fd505604daeac...07132fb5d4debdc1566a9fe7761f9e9946322820,1,7,7,14,6,2012-01-02 15:35:16,2012-01-02 15:35:16
07132fb5d4debdc1566a9fe7761f9e9946322820...6fa62b8166f00d6cf1160b84dce37416f0051f00,2,36,6,42,8,2012-01-02 18:02:47,2012-01-02 18:02:47
6fa62b8166f00d6cf1160b84dce37416f0051f00...1572a3d4b2dd4afd004765ba73a2c38b311b65ee,2,7,2,9,2,2012-01-02 18:47:18,2012-01-02 18:47:18
1572a3d4b2dd4afd004765ba73a2c38b311b65ee...ef5c873dbaddc2ac73a2e6c3d19bf1852a877a2e,1,31,29,60,9,2012-01-02 19:20:47,2012-01-02 19:20:47
ef5c873dbaddc2ac73a2e6c3d19bf1852a877a2e...b895b297a610c30c2eb80c0433d8e5736a509d53,1,1,1,2,1,2012-01-02 20:09:58,2012-01-02 20:09:58
b895b297a610c30c2eb80c0433d8e5736a509d53...fc9e0606d5333fc1906c85cc7ac3b2020e0b1baa,2,28,1,29,2,2012-01-02 20:45:09,2012-01-02 20:45:09
fc9e0606d5333fc1906c85cc7ac3b2020e0b1baa...31b1cbc623c246570e7301c0334df938d840638f,2,16,1,17,5,2012-01-02 21:30:47,2012-01-02 21:30:47
31b1cbc623c246570e7301c0334df938d840638f...c93933441e77cefbcb354196bda9a29b7e75df18,2,14,1,15,2,2012-01-03 09:06:19,2012-01-03 09:06:19
c93933441e77cefbcb354196bda9a29b7e75df18...e5719b203c5a1ee799cd8cb6100342940e260fd7,2,3,1,4,2,2012-01-03 13:09:12,2012-01-03 13:09:12
e5719b203c5a1ee799cd8cb6100342940e260fd7...e52c52ea13be6002ebfa14b7e17ff3004faaf737,5,66,7,73,10,2012-01-03 22:49:13,2012-01-03 22:49:13
e52c52ea13be6002ebfa14b7e17ff3004faaf737...57ac1fc69600f0a27df02e3c2ddbd341ff35d5af,1,1,0,1,1,2012-01-03 23:02:53,2012-01-03 23:02:53
57ac1fc69600f0a27df02e3c2ddbd341ff35d5af...8e9043bccbe18d4b6d1550bffeff4c28e5135f6c,2,11,5,16,2,2012-01-04 18:08:13,2012-01-04 18:08:13
8e9043bccbe18d4b6d1550bffeff4c28e5135f6c...bc63ba700a0ae3ba435c267789d8c2e3931016df,3,32,20,52,12,2012-01-04 23:55:34,2012-01-04 23:55:34
bc63ba700a0ae3ba435c267789d8c2e3931016df...8312b85c979c8ddd314abe0a7edb6cb37fe3e3ac,4,80,15,95,9,2012-01-05 00:45:31,2012-01-05 00:45:31
8312b85c979c8ddd314abe0a7edb6cb37fe3e3ac...33f839b252b26922841a11836785a6826bb459a6,1,6,6,12,2,2012-01-06 17:15:15,2012-01-06 17:15:15
33f839b252b26922841a11836785a6826bb459a6...4629668ffacddb0b8ddb5d8cc7fb8d01f039a4e3,2,22,4,26,5,2012-01-07 08:53:36,2012-01-07 08:53:36
4629668ffacddb0b8ddb5d8cc7fb8d01f039a4e3...56b37bf1cfcff2ca077cc73e6bf88ba66d0cf642,2,9,3,12,4,2012-01-07 10:26:29,2012-01-07 10:26:29
56b37bf1cfcff2ca077cc73e6bf88ba66d0cf642...c3697a091b7ff0d19f13821b18516ec8eaa1b8f8,3,9,7,16,8,2012-01-07 11:17:44,2012-01-07 11:17:44
c3697a091b7ff0d19f13821b18516ec8eaa1b8f8...e3a7bfccbb83712caf0645e4e33f5c03d9dc462b,3,34,2,36,6,2012-01-07 18:15:28,2012-01-07 18:15:28
e3a7bfccbb83712caf0645e4e33f5c03d9dc462b...f21a9da4857f4877a5178ba1c80fb0f7ad328a3f,2,31,7,38,9,2012-01-07 18:39:14,2012-01-07 18:39:14
f21a9da4857f4877a5178ba1c80fb0f7ad328a3f...aa5d307da65cb0933172c9640efeb44d94323be5,2,5,1,6,2,2012-01-07 18:43:46,2012-01-07 18:43:46
aa5d307da65cb0933172c9640efeb44d94323be5...f46003559cc59d27df7a4926001fd10b84f4ab22,2,20,8,28,4,2012-01-07 19:05:29,2012-01-07 19:05:29
f46003559cc59d27df7a4926001fd10b84f4ab22...ca187fea88b626508e125e0843c991fe63f8ed95,2,7,1,8,2,2012-01-07 19:53:20,2012-01-07 19:53:20
ca187fea88b626508e125e0843c991fe63f8ed95...cd4686304344529538470481ddd452d2534650ae,2,10,1,11,2,2012-01-07 21:42:37,2012-01-07 21:42:37
cd4686304344529538470481ddd452d2534650ae...c51c9b3ce61239ec2a11df56baf24106738bb44a,1,16,16,32,2,2012-01-07 21:47:38,2012-01-07 21:47:38
c51c9b3ce61239ec2a11df56baf24106738bb44a...d101ed2cb8d5a25e0120764fe5ed86c101a2113a,1,41,36,77,11,2012-01-07 21:52:07,2012-01-07 21:52:07
d101ed2cb8d5a25e0120764fe5ed86c101a2113a...aa4e1522968b19499801fe3d73d6b2f3bf3b3acd,2,6,1,7,3,2012-01-08 09:51:36,2012-01-08 09:51:36
aa4e1522968b19499801fe3d73d6b2f3bf3b3acd...40f0ecc56a23d35c2849f8e79276f6d8931412d1,7,56,32,88,7,2012-01-08 15:05:15,2012-01-08 15:05:15
40f0ecc56a23d35c2849f8e79276f6d8931412d1...27508918fbbbfda6f5e3b697bbea6bf2c4a6b8b8,2,12,4,16,4,2012-01-08 15:43:32,2012-01-08 15:43:32
27508918fbbbfda6f5e3b697bbea6bf2c4a6b8b8...05a3ecbf9637b8873dc0eb6913a94117a90c9bc0,3,25,11,36,5,2012-01-08 16:08:43,2012-01-08 16:08:43
05a3ecbf9637b8873dc0eb6913a94117a90c9bc0...4a92059b0811bb1538f60d18981a27126683baf8,1,9,10,19,10,2012-01-08 19:16:33,2012-01-08 19:16:33
4a92059b0811bb1538f60d18981a27126683baf8...78c92c416790b22eb837dbf852f93134e354173d,1,2,2,4,1,2012-01-08 19:23:57,2012-01-08 19:23:57
78c92c416790b22eb837dbf852f93134e354173d...15d10a5210378bba88c7dfa1f45a4d3528ddfc3f,2,27,8,35,5,2012-01-08 19:42:14,2012-01-08 19:42:14
15d10a5210378bba88c7dfa1f45a4d3528ddfc3f...19c544ff4250720558119084a60daa6363f45919,2,18,4,22,4,2012-01-08 20:00:30,2012-01-08 20:00:30
19c544ff4250720558119084a60daa6363f45919...62766f42482f5071e7af1a806ae5c287f2332921,3,11,16,27,4,2012-01-08 21:36:22,2012-01-08 21:36:22
62766f42482f5071e7af1a806ae5c287f2332921...4288c8831bde86f1be581d65c13e2f878a02c7ff,3,109,10,119,10,2012-01-09 21:42:03,2012-01-09 21:42:03
4288c8831bde86f1be581d65c13e2f878a02c7ff...630a64343101dbc646f89a98ef4743685b651b9a,1,1,0,1,1,2012-01-10 21:19:10,2012-01-10 21:19:10
630a64343101dbc646f89a98ef4743685b651b9a...e1ba9111ac7ae0a625adc467712e86a9e8000570,1,1,1,2,1,2012-01-11 10:19:05,2012-01-11 10:19:05
e1ba9111ac7ae0a625adc467712e86a9e8000570...30c846bf3d086acee8dbc1164abdca718a9f19d3,2,14,1,15,6,2012-01-12 21:55:19,2012-01-12 21:55:19
30c846bf3d086acee8dbc1164abdca718a9f19d3...4c16e772308e525b9b35799e230a5499df80b47c,1,8,18,26,3,2012-01-12 22:03:34,2012-01-12 22:03:34
4c16e772308e525b9b35799e230a5499df80b47c...64229eb3882be7080f73bc4559f44dc34507b140,1,36,0,36,1,2012-01-13 21:57:30,2012-01-13 21:57:30
64229eb3882be7080f73bc4559f44dc34507b140...4e29b70b9dfb836a6ece537728f1ad9702786948,4,150,107,257,15,2012-01-14 17:26:32,2012-01-14 17:26:32
4e29b70b9dfb836a6ece537728f1ad9702786948...e308cfc0e155f51f14c8eb4e678c15c5f632ae30,6,48,3,51,10,2012-01-15 01:36:14,2012-01-15 01:36:14
e308cfc0e155f51f14c8eb4e678c15c5f632ae30...c5dcba4159e00ed7fc43b605946be489602ab369,2,23,3,26,5,2012-01-15 02:01:21,2012-01-15 02:01:21
c5dcba4159e00ed7fc43b605946be489602ab369...665ec600a40ffc3c9baea30be9c8765939512748,3,20,1,21,3,2012-01-15 02:33:31,2012-01-15 02:33:31
665ec600a40ffc3c9baea30be9c8765939512748...c35399ba0da5a266138c2332ce8d54089e3949ac,1,1,1,2,1,2012-01-15 03:27:48,2012-01-15 03:27:48
c35399ba0da5a266138c2332ce8d54089e3949ac...aef0283f89a0667914ad3524c125ce4efbdad9b9,2,7,2,9,3,2012-01-15 16:06:56,2012-01-15 16:06:56
aef0283f89a0667914ad3524c125ce4efbdad9b9...203c4fef4d4f9c3a241cef0927ae895fcfe9ec48,9,16,16,32,11,2012-01-19 11:23:31,2012-01-19 11:23:31
203c4fef4d4f9c3a241cef0927ae895fcfe9ec48...e8e4293a485fc51d7b699c24e5d1340fdee25d03,1,2,3,5,1,2012-01-19 17:38:56,2012-01-19 17:38:56
e8e4293a485fc51d7b699c24e5d1340fdee25d03...477f4d80616392bbd3352cad50faedb9c1494b33,1,3,3,6,2,2012-01-19 22:05:47,2012-01-19 22:05:47
477f4d80616392bbd3352cad50faedb9c1494b33...905e33f84a1a10e4f0183d879c52076ef876fc3b,2,25,1,26,3,2012-01-20 23:15:22,2012-01-20 23:15:22
905e33f84a1a10e4f0183d879c52076ef876fc3b...f0d467675040dbb979015d97adba449dc7fd02ad,1,5,4,9,1,2012-01-21 15:32:52,2012-01-21 15:32:52
f0d467675040dbb979015d97adba449dc7fd02ad...58346e92fad0656da1dabf9bc68e3a19ce044e37,1,11,11,22,9,2012-01-21 15:42:37,2012-01-21 15:42:37
58346e92fad0656da1dabf9bc68e3a19ce044e37...4d030e540dc7b64d783510ba0d46c40f9713d305,1,1,1,2,1,2012-01-21 15:45:54,2012-01-21 15:45:54
4d030e540dc7b64d783510ba0d46c40f9713d305...7beb0db79b468b5cc6f20b05873a631ace989a84,3,40,12,52,11,2012-01-22 16:41:20,2012-01-22 16:41:20
7beb0db79b468b5cc6f20b05873a631ace989a84...752a43e24516cdc1341b0baeec5fae21ef796b62,9,16,16,32,11,2012-01-23 16:17:47,2012-01-23 16:17:47
752a43e24516cdc1341b0baeec5fae21ef796b62...804bd403838dbd01154f8f477b0ebf2045e7b4b5,1,1,5,6,1,2012-01-24 07:42:38,2012-01-24 07:42:38
804bd403838dbd01154f8f477b0ebf2045e7b4b5...6ae393d74db1f8e553c80951f3eaeb3ba16fc223,2,14,10,24,4,2012-01-24 08:02:34,2012-01-24 08:02:34
6ae393d74db1f8e553c80951f3eaeb3ba16fc223...8f168976d68282a6180d2af4e12c4f3b6dd09c85,2,12,1,13,2,2012-01-24 10:00:39,2012-01-24 10:00:39
8f168976d68282a6180d2af4e12c4f3b6dd09c85...0907233040fa0fe48185f2eb650dd677bdeb7878,1,7,0,7,1,2012-01-24 10:32:28,2012-01-24 10:32:28
0907233040fa0fe48185f2eb650dd677bdeb7878...332b248be8dc2578db7a24f0b9c2af28e7b97754,1,6,0,6,1,2012-01-25 14:26:46,2012-01-25 14:26:46
332b248be8dc2578db7a24f0b9c2af28e7b97754...ef926192fdf21baa9906b8f5882763a546119434,1,2,3,5,2,2012-01-25 16:43:52,2012-01-25 16:43:52
ef926192fdf21baa9906b8f5882763a546119434...1d54e3a95676e04ef3bcf7a251ba5a425d7e583f,1,0,6,6,2,2012-01-27 22:25:44,2012-01-27 22:25:44
1d54e3a95676e04ef3bcf7a251ba5a425d7e583f...234b7e372000381657250fe133cbcfa90ffbb2a9,1,7,11,18,4,2012-01-27 23:46:22,2012-01-27 23:46:22
234b7e372000381657250fe133cbcfa90ffbb2a9...d6d4d60109af87889e57ee263f64d2f7955890c3,1,4,3,7,3,2012-01-28 01:50:14,2012-01-28 01:50:14
d6d4d60109af87889e57ee263f64d2f7955890c3...f9ea6196139fed76a8cf65bccfdc2c34c1e8ce91,1,8,5,13,1,2012-01-28 18:18:01,2012-01-28 18:18:01
f9ea6196139fed76a8cf65bccfdc2c34c1e8ce91...6b16580aaa7aa3453a874802e14eaf17db745c46,2,38,5,43,9,2012-01-28 20:27:23,2012-01-28 20:27:23
6b16580aaa7aa3453a874802e14eaf17db745c46...58bcb7d1615511d34c155dedcde981b7f92df788,1,6,1,7,1,2012-01-28 20:34:02,2012-01-28 20:34:02
58bcb7d1615511d34c155dedcde981b7f92df788...4a3aceed3f0d93e675288edfdf598c8b2e9811b8,1,2,0,2,1,2012-01-28 20:37:05,2012-01-28 20:37:05
4a3aceed3f0d93e675288edfdf598c8b2e9811b8...1cc800783c0f02a8f65e85b53ecb05ae5c0a4d88,3,17,11,28,10,2012-01-28 20:54:48,2012-01-28 20:54:48
1cc800783c0f02a8f65e85b53ecb05ae5c0a4d88...7ad7a8d2d32704872430a03885e1b763b2b667ad,2,59,0,59,2,2012-01-28 20:58:22,2012-01-28 20:58:22
7ad7a8d2d32704872430a03885e1b763b2b667ad...d9061c01a975c3313a815f793cd773d3e657c3cf,2,30,3,33,6,2012-01-29 09:00:12,2012-01-29 09:00:12
d9061c01a975c3313a815f793cd773d3e657c3cf...123f567093eb3bd2f9cb295f4553eb62433c2962,4,50,22,72,24,2012-01-29 09:30:28,2012-01-29 09:30:28
123f567093eb3bd2f9cb295f4553eb62433c2962...a4b472dd809c8a696d1488a54dcaf3870ec9e661,13,229,93,322,31,2012-01-29 19:24:32,2012-01-29 19:24:32
a4b472dd809c8a696d1488a54dcaf3870ec9e661...b5d0cc9091c04e7d6f0d7eed5b6d409805430ed6,1,1,1,2,1,2012-01-29 21:39:39,2012-01-29 21:39:39
b5d0cc9091c04e7d6f0d7eed5b6d409805430ed6...f1dc83cb9877d349df88674a0752ddf42657485b,3,182,84,266,71,2012-01-30 08:27:50,2012-01-30 08:27:50
f1dc83cb9877d349df88674a0752ddf42657485b...a678e9ea6589bd95d9d30e86a50d3694ebf60908,8,198,5,203,20,2012-01-31 19:23:09,2012-01-31 19:23:09
a678e9ea6589bd95d9d30e86a50d3694ebf60908...c82f1dcf95d4ecdc7e020a4715fbb1b097a6a796,1,1,0,1,1,2012-01-31 19:47:40,2012-01-31 19:47:40
c82f1dcf95d4ecdc7e020a4715fbb1b097a6a796...844a24bbb97af663ebf8dbeab4499acafe105943,61,1345,639,1984,558,2012-01-31 20:36:11,2012-01-31 20:36:11
844a24bbb97af663ebf8dbeab4499acafe105943...d8e75f6c6f97f1797f841d3b72973188e359e1e7,1,2,1,3,3,2012-02-01 04:25:30,2012-02-01 04:25:30
d8e75f6c6f97f1797f841d3b72973188e359e1e7...dcbd5eefd677cb7cb2bcdedab4b7f73173ed82fa,1,1,1,2,1,2012-02-01 20:08:10,2012-02-01 20:08:10
dcbd5eefd677cb7cb2bcdedab4b7f73173ed82fa...ccbadbc5c2255629abb7f84f1aead4c9b1dc86d4,1,2,2,4,1,2012-02-01 21:36:18,2012-02-01 21:36:18
ccbadbc5c2255629abb7f84f1aead4c9b1dc86d4...1030d66a14c29026efc6c8d3ad69ad2c57bf4589,2,34,19,53,14,2012-02-02 04:44:17,2012-02-02 04:44:17
1030d66a14c29026efc6c8d3ad69ad2c57bf4589...086697b23156222e22476e6c546cff6e76658139,1,1,2,3,1,2012-02-02 17:03:32,2012-02-02 17:03:32
086697b23156222e22476e6c546cff6e76658139...ead8a869ce9b23cf1fc704efb0903d3e4905fb4b,1,3,3,6,2,2012-02-03 17:45:28,2012-02-03 17:45:28
ead8a869ce9b23cf1fc704efb0903d3e4905fb4b...442ab475c86323b407b10e048f3d319280fb690b,2,2,2,4,2,2012-02-03 17:51:14,2012-02-03 17:51:14
442ab475c86323b407b10e048f3d319280fb690b...f950a99acbc2e881389cfb64c6bc5a021d467d7f,1,3,3,6,3,2012-02-03 17:52:39,2012-02-03 17:52:39
f950a99acbc2e881389cfb64c6bc5a021d467d7f...6bbc85cd6a32a0208586b291b82b08b1b9f0399f,1,5,5,10,2,2012-02-03 17:54:08,2012-02-03 17:54:08
6bbc85cd6a32a0208586b291b82b08b1b9f0399f...20dbbcc2643e4983b3cfc85d1ae074ff4e0a6d27,1,2,2,4,2,2012-02-03 17:57:15,2012-02-03 17:57:15
20dbbcc2643e4983b3cfc85d1ae074ff4e0a6d27...e2e3d4da0c5056d5899d9604e0d455098be27513,1,5,5,10,1,2012-02-03 20:13:16,2012-02-03 20:13:16
e2e3d4da0c5056d5899d9604e0d455098be27513...20106af74df303f23460de7986f83aebab584a6f,1,5,5,10,1,2012-02-03 20:14:14,2012-02-03 20:14:14
20106af74df303f23460de7986f83aebab584a6f...00227b65296da44404b2b6c60a753142a967e46d,1,2,2,4,2,2012-02-03 20:16:06,2012-02-03 20:16:06
00227b65296da44404b2b6c60a753142a967e46d...6ecadcbdd2d2d34948e6482bfffe2c818887b39e,11,67,69,136,41,2012-02-03 20:45:45,2012-02-03 20:45:45
6ecadcbdd2d2d34948e6482bfffe2c818887b39e...954e3b4ad37b572cdc46baf3e35c712f4049efea,6,120,6,126,13,2012-02-04 12:48:01,2012-02-04 12:48:01
954e3b4ad37b572cdc46baf3e35c712f4049efea...9c045d00dc37f4eb082e022ac12b659345413d7e,2,30,0,30,2,2012-02-04 12:48:12,2012-02-04 12:48:12
9c045d00dc37f4eb082e022ac12b659345413d7e...bb6921ce888cfc981c4df8d5f079b0b7a4121ff6,2,29,3,32,8,2012-02-04 12:48:21,2012-02-04 12:48:21
bb6921ce888cfc981c4df8d5f079b0b7a4121ff6...faeee611d69717614424b6c3867cd5798ee25496,6,42,6,48,13,2012-02-04 13:01:30,2012-02-04 13:01:30
faeee611d69717614424b6c3867cd5798ee25496...52d72a5a3e62ed8fde5796e0e131a8f7a5aefac3,1,5,2,7,3,2012-02-04 16:05:30,2012-02-04 16:05:30
52d72a5a3e62ed8fde5796e0e131a8f7a5aefac3...4d8a0f8902dd55348fbaf897048bef1cba285f05,2,12,1,13,2,2012-02-04 16:05:39,2012-02-04 16:05:39
4d8a0f8902dd55348fbaf897048bef1cba285f05...e734477bd739de737d98deef91dfe9f7b8c1c030,2,8,1,9,2,2012-02-04 16:05:48,2012-02-04 16:05:48
e734477bd739de737d98deef91dfe9f7b8c1c030...56d787df99a923cf96d02f9cd07ca8d383dbc028,2,18,3,21,3,2012-02-04 16:05:58,2012-02-04 16:05:58
56d787df99a923cf96d02f9cd07ca8d383dbc028...2b0c1ea64155bd3f825b06e266d73c00dbf4196f,3,8,6,14,6,2012-02-04 16:06:09,2012-02-04 16:06:09
2b0c1ea64155bd3f825b06e266d73c00dbf4196f...928f605efe0af2362c368e4bd9c280c7620abf3f,1,5,3,8,2,2012-02-04 18:26:58,2012-02-04 18:26:58
928f605efe0af2362c368e4bd9c280c7620abf3f...62efdcb037da9df8fb1a3a29cabb517d49288b5d,3,24,22,46,4,2012-02-04 18:27:07,2012-02-04 18:27:07
62efdcb037da9df8fb1a3a29cabb517d49288b5d...62dc16dcd8664d43b6e136156a6f853efe625cfd,1,6,2,8,3,2012-02-04 18:27:14,2012-02-04 18:27:14
62dc16dcd8664d43b6e136156a6f853efe625cfd...c6065545ef127ef244defd520b2bb1afe3a5c153,2,48,32,80,27,2012-02-04 18:27:24,2012-02-04 18:27:24
c6065545ef127ef244defd520b2bb1afe3a5c153...878cc62bd49db0800e132051252b368acdeaf55a,1,1,1,2,1,2012-02-04 18:27:32,2012-02-04 18:27:32
878cc62bd49db0800e132051252b368acdeaf55a...ef4d84d11ab9357d9c6e35b2a3a0a9d4fb310075,2,13,1,14,2,2012-02-04 18:43:20,2012-02-04 18:43:20
ef4d84d11ab9357d9c6e35b2a3a0a9d4fb310075...3db80c4c05734f2f1c7b6f12e44146b31334bbe1,1,3,3,6,3,2012-02-04 18:44:42,2012-02-04 18:44:42
3db80c4c05734f2f1c7b6f12e44146b31334bbe1...d3154d1896c5cc1c046e43c2cf5253415d6429ae,4,52,1,53,5,2012-02-04 19:56:40,2012-02-04 19:56:40
d3154d1896c5cc1c046e43c2cf5253415d6429ae...a4f68c1b40471fc1b099a27f4c4d8eb181bada8c,1,1,1,2,1,2012-02-04 20:02:46,2012-02-04 20:02:46
a4f68c1b40471fc1b099a27f4c4d8eb181bada8c...170e5d5f7421cc5d6142e1e6b0762392fb68dbb3,4,22,15,37,18,2012-02-04 21:01:11,2012-02-04 21:01:11
170e5d5f7421cc5d6142e1e6b0762392fb68dbb3...2894ec71c962c7e3cdc69d7ab44a01b142795b38,1,1,1,2,1,2012-02-04 21:44:31,2012-02-04 21:44:31
2894ec71c962c7e3cdc69d7ab44a01b142795b38...9b762d170a9d895eadae270569c1dee6dbd976c5,1,6,3,9,4,2012-02-04 22:12:58,2012-02-04 22:12:58
9b762d170a9d895eadae270569c1dee6dbd976c5...d02ba7f4ee7c448de28724369fc5dd9cf3e2538a,3,126,8,134,6,2012-02-05 07:11:53,2012-02-05 07:11:53
d02ba7f4ee7c448de28724369fc5dd9cf3e2538a...ad8ebb7006be7d93f1c6a29770dbca2752488a62,3,23,10,33,7,2012-02-05 07:51:37,2012-02-05 07:51:37
ad8ebb7006be7d93f1c6a29770dbca2752488a62...1cd18f4cfdaf5f4a4002e9c59e1146e5fa0d70d3,2,0,5,5,5,2012-02-05 08:09:26,2012-02-05 08:09:26
1cd18f4cfdaf5f4a4002e9c59e1146e5fa0d70d3...3732c82f5946ec192324a353085cf1988adc0269,1,1,1,2,1,2012-02-05 08:12:07,2012-02-05 08:12:07
3732c82f5946ec192324a353085cf1988adc0269...a90aad35116d1a796a301626db5abff5f361da8a,2,68,7,75,11,2012-02-05 08:35:08,2012-02-05 08:35:08
a90aad35116d1a796a301626db5abff5f361da8a...0f6cf4aba1d3db4be9a0d593becfc10bc4aa1fbe,6,57,63,120,10,2012-02-05 10:26:05,2012-02-05 10:26:05
0f6cf4aba1d3db4be9a0d593becfc10bc4aa1fbe...44d1791779ecf86ab5de92bce5236f9401efce0e,1,5,1,6,2,2012-02-05 10:29:08,2012-02-05 10:29:08
44d1791779ecf86ab5de92bce5236f9401efce0e...9f95d79cee4130c653fef5c6709a73036c661333,1,2,2,4,2,2012-02-05 15:41:33,2012-02-05 15:41:33
9f95d79cee4130c653fef5c6709a73036c661333...0ccbb5356ab77ba33750982e7ac3963e5d1c314f,1,1,1,2,1,2012-02-05 15:53:09,2012-02-05 15:53:09
0ccbb5356ab77ba33750982e7ac3963e5d1c314f...09ad6d1b88381497493120c4be882175c11a4bc8,1,15,11,26,9,2012-02-06 02:00:19,2012-02-06 02:00:19
09ad6d1b88381497493120c4be882175c11a4bc8...175e6d77df526dea1ade94661e487072e7c7cd88,4,86,26,112,18,2012-02-07 18:46:29,2012-02-07 18:46:29
175e6d77df526dea1ade94661e487072e7c7cd88...f9ec6bd3df8b4754d0539e479e1ade5f02e30b72,1,4,4,8,2,2012-02-09 08:37:33,2012-02-09 08:37:33
f9ec6bd3df8b4754d0539e479e1ade5f02e30b72...bd5861251490758e189d6d657de4683897024c70,2,18,9,27,10,2012-02-09 18:41:20,2012-02-09 18:41:20
bd5861251490758e189d6d657de4683897024c70...03eeb020a00dedba2594326bd606d8b41d51e80f,2,34,2,36,4,2012-02-09 18:56:23,2012-02-09 18:56:23
03eeb020a00dedba2594326bd606d8b41d51e80f...b46d90c63ad866d5d7d6b09d8986339e0842550d,4,31,3,34,8,2012-02-09 18:56:32,2012-02-09 18:56:32
b46d90c63ad866d5d7d6b09d8986339e0842550d...538257b4ae5cd8a5e3b9fc79c167294560101e18,2,9,4,13,3,2012-02-09 18:56:41,2012-02-09 18:56:41
538257b4ae5cd8a5e3b9fc79c167294560101e18...75a9c8a5ef6408cd51fd75fc8aefb2e812e353a1,2,16,3,19,2,2012-02-09 18:56:49,2012-02-09 18:56:49
75a9c8a5ef6408cd51fd75fc8aefb2e812e353a1...49288f838809d797fa7b8b2e6a2cb2f65d6cf8bd,3,28,5,33,7,2012-02-09 18:56:58,2012-02-09 18:56:58
49288f838809d797fa7b8b2e6a2cb2f65d6cf8bd...4b71c9998e4983e193bb3b648a8a445edd54c52f,2,3,1,4,3,2012-02-09 18:57:06,2012-02-09 18:57:06
4b71c9998e4983e193bb3b648a8a445edd54c52f...b926765a7c04e88a85f2360a238efde9ffe98244,2,34,2,36,3,2012-02-09 18:57:13,2012-02-09 18:57:13
b926765a7c04e88a85f2360a238efde9ffe98244...e445b66fd8a2b5e931debad3c920be1345871ad9,2,61,0,61,2,2012-02-09 18:57:22,2012-02-09 18:57:22
e445b66fd8a2b5e931debad3c920be1345871ad9...a6b6c6e17129379fa1f9ffce1ed7eaaa5d6f1127,3,30,3,33,7,2012-02-09 18:57:31,2012-02-09 18:57:31
a6b6c6e17129379fa1f9ffce1ed7eaaa5d6f1127...bc8875e37c2eb5e2fa3b86bcf620a6a97f955cfe,3,17,1,18,5,2012-02-09 18:57:40,2012-02-09 18:57:40
bc8875e37c2eb5e2fa3b86bcf620a6a97f955cfe...46f1369d92c1ac4e37e9b1efffc7c87d759508eb,1,2,2,4,2,2012-02-09 18:57:47,2012-02-09 18:57:47
46f1369d92c1ac4e37e9b1efffc7c87d759508eb...2aae05772755df50ae29eb3d699fad75ffded6a3,2,10,6,16,8,2012-02-09 18:57:54,2012-02-09 18:57:54
2aae05772755df50ae29eb3d699fad75ffded6a3...d6f9c1e7744f1c8eeb19c76d9c9b8ec04d1e96d2,3,134,133,267,20,2012-02-09 18:58:03,2012-02-09 18:58:03
d6f9c1e7744f1c8eeb19c76d9c9b8ec04d1e96d2...75c60e80536552125f014fde15e2964ec128c65c,10,13,14,27,11,2012-02-09 18:58:17,2012-02-09 18:58:17
75c60e80536552125f014fde15e2964ec128c65c...c609b792f74948bc4e485ebfcb456ef1b6f8ce0a,2,14,6,20,3,2012-02-09 18:58:25,2012-02-09 18:58:25
c609b792f74948bc4e485ebfcb456ef1b6f8ce0a...f0a1633425d5afdaec85e188ce67d647e218ff23,7,15,15,30,15,2012-02-09 18:58:36,2012-02-09 18:58:36
f0a1633425d5afdaec85e188ce67d647e218ff23...ec5e2f0ccc1d1d5e6a744e2be77deae68c66fcf8,4,1154,10,1164,4,2012-02-09 18:58:45,2012-02-09 18:58:45
ec5e2f0ccc1d1d5e6a744e2be77deae68c66fcf8...875a5ea8d47c2c10432572fec788a81217073a4f,3,46,12,58,11,2012-02-09 18:58:53,2012-02-09 18:58:53
875a5ea8d47c2c10432572fec788a81217073a4f...4dbeb4bca4638ff851a2f4844d262dbe1652f7b5,7,55,6,61,13,2012-02-09 18:59:05,2012-02-09 18:59:05
4dbeb4bca4638ff851a2f4844d262dbe1652f7b5...55aa285a339e3815bfec1077962e2bf4596a43bc,1,2,1,3,1,2012-02-09 18:59:12,2012-02-09 18:59:12
55aa285a339e3815bfec1077962e2bf4596a43bc...8ae02fde2b2434e80dea44c9f28461fe8cb585c9,1,11,0,11,1,2012-02-10 01:13:09,2012-02-10 01:13:09
8ae02fde2b2434e80dea44c9f28461fe8cb585c9...c1acda6d8f276dda9a962186e028c396a5a2e53c,21,43,44,87,30,2012-02-10 01:13:29,2012-02-10 01:13:29
c1acda6d8f276dda9a962186e028c396a5a2e53c...7019123d21f202bfce54ad30eb33ae9f4b3bcef9,3,11,0,11,5,2012-02-10 01:13:38,2012-02-10 01:13:38
7019123d21f202bfce54ad30eb33ae9f4b3bcef9...e41647a52241c441fe8a5579a89d24e8aad55c0b,1,3,1,4,2,2012-02-10 01:13:45,2012-02-10 01:13:45
e41647a52241c441fe8a5579a89d24e8aad55c0b...8d381acb24f3114b9cf560391671ad1274b4bfaa,2,18,15,33,9,2012-02-10 01:40:43,2012-02-10 01:40:43
8d381acb24f3114b9cf560391671ad1274b4bfaa...fc14996c8d6821f545f4fdaba7093261d03254b0,1,10,13,23,5,2012-02-10 01:45:03,2012-02-10 01:45:03
fc14996c8d6821f545f4fdaba7093261d03254b0...ad8022f89a515521f7de5e22503a1df31974fc23,1,2,3,5,3,2012-02-10 02:34:06,2012-02-10 02:34:06
ad8022f89a515521f7de5e22503a1df31974fc23...8be356ea99489e932174f7c1d54d2ff766a52311,1,3,10,13,6,2012-02-10 11:31:47,2012-02-10 11:31:47
8be356ea99489e932174f7c1d54d2ff766a52311...0ce6636102d9e1c8c158c0e3eadb5a5db6b06a71,2,28,2,30,6,2012-02-10 22:51:07,2012-02-10 22:51:07
0ce6636102d9e1c8c158c0e3eadb5a5db6b06a71...114b655247243d553131b508111d173c3c1181ff,2,10,1,11,2,2012-02-10 23:45:22,2012-02-10 23:45:22
114b655247243d553131b508111d173c3c1181ff...4768f39c95ea702788eafe86c6206fb605773965,1,1,1,2,1,2012-02-11 00:05:57,2012-02-11 00:05:57
4768f39c95ea702788eafe86c6206fb605773965...c406b554c76ec57bbeddea090a7ca1a4f1f6daa9,2,54,22,76,7,2012-02-11 00:40:18,2012-02-11 00:40:18
c406b554c76ec57bbeddea090a7ca1a4f1f6daa9...8a986cb5bce3f66dcf39059ad18c3cc8bfc2d391,2,51,24,75,18,2012-02-11 01:48:45,2012-02-11 01:48:45
8a986cb5bce3f66dcf39059ad18c3cc8bfc2d391...5a4e63e62a8cde925d5a7b05c44a2ec14853b46e,2,35,47,82,3,2012-02-11 03:09:54,2012-02-11 03:09:54
5a4e63e62a8cde925d5a7b05c44a2ec14853b46e...a77679dfaa963361b6daad6de0d7de1b53d4f104,3,45,29,74,18,2012-02-11 04:18:15,2012-02-11 04:18:15
a77679dfaa963361b6daad6de0d7de1b53d4f104...995f7a16a8bf539caf076a7744441a383e9a38b2,3,62,2,64,7,2012-02-11 09:31:18,2012-02-11 09:31:18
995f7a16a8bf539caf076a7744441a383e9a38b2...130e7ab617d746291629de6a5a1fbb5ea9cd3fe5,3,18,8,26,10,2012-02-11 09:55:54,2012-02-11 09:55:54
130e7ab617d746291629de6a5a1fbb5ea9cd3fe5...c007de5b7900689ed54bc022adefcb02a576836d,1,2,2,4,1,2012-02-11 10:17:45,2012-02-11 10:17:45
c007de5b7900689ed54bc022adefcb02a576836d...44452b11eb964e34e62ce8d5feab1c45d29c2e58,1,1,1,2,1,2012-02-11 12:47:35,2012-02-11 12:47:35
44452b11eb964e34e62ce8d5feab1c45d29c2e58...d72d5ce8274992ce01e39f866a7a250bc459eefe,2,7,1,8,3,2012-02-11 13:50:27,2012-02-11 13:50:27
d72d5ce8274992ce01e39f866a7a250bc459eefe...4b81d790a83e8710032ea58a8edbc8b8dab8fbcf,3,6,12,18,5,2012-02-11 18:01:53,2012-02-11 18:01:53
4b81d790a83e8710032ea58a8edbc8b8dab8fbcf...ccc0e122d42dad0f645407c469383d85bae92048,3,18,2,20,4,2012-02-11 20:05:50,2012-02-11 20:05:50
ccc0e122d42dad0f645407c469383d85bae92048...a411242e947c2c330a87ec5149510114312c8b8d,3,21,2,23,3,2012-02-11 20:53:48,2012-02-11 20:53:48
a411242e947c2c330a87ec5149510114312c8b8d...98b4572ef7fee55d4ec92705cf45770a1318c10b,2,12,0,12,2,2012-02-11 22:12:49,2012-02-11 22:12:49
98b4572ef7fee55d4ec92705cf45770a1318c10b...328c70ef157533f57d38e7c9a5740095565ebf9d,1,1,0,1,1,2012-02-11 22:17:02,2012-02-11 22:17:02
328c70ef157533f57d38e7c9a5740095565ebf9d...1c9c29b5b2a3b9b8375a32534dd60c486042b5a3,2,58,18,76,9,2012-02-12 12:19:02,2012-02-12 12:19:02
1c9c29b5b2a3b9b8375a32534dd60c486042b5a3...61fe50fdd6c74e03c365606d3270e831e81a1e4b,1,16,1,17,2,2012-02-12 14:29:30,2012-02-12 14:29:30
61fe50fdd6c74e03c365606d3270e831e81a1e4b...f46c4140ce3bce1d591699b81a5e9577204ce762,1,1,0,1,1,2012-02-12 14:49:42,2012-02-12 14:49:42
f46c4140ce3bce1d591699b81a5e9577204ce762...03c80067c6061cd6f7484aeb9f953ffad59b8fad,1,5,0,5,1,2012-02-12 15:10:08,2012-02-12 15:10:08
03c80067c6061cd6f7484aeb9f953ffad59b8fad...d1f85555008f4444927c92ea3d9b1286079ef650,1,21,4,25,3,2012-02-12 15:18:24,2012-02-12 15:18:24
d1f85555008f4444927c92ea3d9b1286079ef650...2df1847c9b59b183bb3331fb19a7f76c72358edf,1,5,0,5,1,2012-02-12 17:10:31,2012-02-12 17:10:31
2df1847c9b59b183bb3331fb19a7f76c72358edf...4f1ac8f5f15f08f34dc06c7442cec50a7af31c45,5,189,87,276,49,2012-02-13 10:51:17,2012-02-13 10:51:17
4f1ac8f5f15f08f34dc06c7442cec50a7af31c45...bd13cfa917d3cc4dc854fc0d486adcb45f5b551a,4,50,0,50,4,2012-02-13 20:57:44,2012-02-13 20:57:44
bd13cfa917d3cc4dc854fc0d486adcb45f5b551a...803de60c088e7a439b5549575e1e3a082ae26d54,3,5,4,9,3,2012-02-14 09:55:09,2012-02-14 09:55:09
803de60c088e7a439b5549575e1e3a082ae26d54...2000f375cde88358cdc66f775f4de14df1234f72,2,45,6,51,7,2012-02-14 21:29:50,2012-02-14 21:29:50
2000f375cde88358cdc66f775f4de14df1234f72...41256d2341b8ecf4c4987e6acc3d84aafe2674c8,4,21,25,46,10,2012-02-15 17:33:51,2012-02-15 17:33:51
41256d2341b8ecf4c4987e6acc3d84aafe2674c8...6072e108e2738dbde7c2ad976a45745551859a20,3,27,1,28,4,2012-02-16 00:58:49,2012-02-16 00:58:49
6072e108e2738dbde7c2ad976a45745551859a20...b9b3e9f0efe3fe9d5d976533ff2f13359825f5da,2,2,2,4,2,2012-02-16 01:10:21,2012-02-16 01:10:21
b9b3e9f0efe3fe9d5d976533ff2f13359825f5da...06da2be00fb371a27e10ce37821643914c93adc6,1,3,2,5,1,2012-02-16 01:37:12,2012-02-16 01:37:12
06da2be00fb371a27e10ce37821643914c93adc6...ea8af819ab5348c7521c253e8e8f55efaeee181c,2,4,4,8,2,2012-02-16 02:06:59,2012-02-16 02:06:59
ea8af819ab5348c7521c253e8e8f55efaeee181c...c05930c858bdfe59dec5fa257dc05b614fa7320b,2,15,0,15,2,2012-02-16 02:08:11,2012-02-16 02:08:11
c05930c858bdfe59dec5fa257dc05b614fa7320b...e5e45d8afc713f8838f757e7f65cf72c23f39333,1,7,7,14,3,2012-02-16 02:10:48,2012-02-16 02:10:48
e5e45d8afc713f8838f757e7f65cf72c23f39333...46671e9b6856be277cd7a82053faae8633ac7ea7,3,4,4,8,4,2012-02-16 02:12:20,2012-02-16 02:12:20
46671e9b6856be277cd7a82053faae8633ac7ea7...50c64ed37966699e49d475202bbe1d5049471f46,2,18,1,19,2,2012-02-16 04:01:58,2012-02-16 04:01:58
50c64ed37966699e49d475202bbe1d5049471f46...19e1a3556ff97ce89fc85db63f5a07190e2bc326,1,1,1,2,1,2012-02-16 04:32:42,2012-02-16 04:32:42
19e1a3556ff97ce89fc85db63f5a07190e2bc326...8f4d12ead2563a8c65722a23fc10c3a3f817dcaa,1,1,1,2,1,2012-02-16 11:45:57,2012-02-16 11:45:57
8f4d12ead2563a8c65722a23fc10c3a3f817dcaa...758a0cd0f1c646abf6f7d4f01850d3729ad603e0,2,14,7,21,2,2012-02-16 14:40:32,2012-02-16 14:40:32
758a0cd0f1c646abf6f7d4f01850d3729ad603e0...5b37a02ba3c2857d192ec4311270113ed71c275d,2,5,6,11,3,2012-02-16 18:27:42,2012-02-16 18:27:42
5b37a02ba3c2857d192ec4311270113ed71c275d...9d7b5558ee21bd047c1b3845d4af7540000476bf,1,15,13,28,6,2012-02-16 21:59:22,2012-02-16 21:59:22
9d7b5558ee21bd047c1b3845d4af7540000476bf...7ecb6813c97ffd480f6aab005353f059c94a3d65,1,2,2,4,2,2012-02-17 16:51:22,2012-02-17 16:51:22
7ecb6813c97ffd480f6aab005353f059c94a3d65...9fa536dc4f1b4c815ad21a28290bc5142d339cc1,1,7,1,8,2,2012-02-17 20:03:40,2012-02-17 20:03:40
9fa536dc4f1b4c815ad21a28290bc5142d339cc1...7981efe04fbdcd7d6d434e2306d4e3ed17a9f0e0,12,139,141,280,75,2012-02-17 20:04:11,2012-02-17 20:04:11
7981efe04fbdcd7d6d434e2306d4e3ed17a9f0e0...2a1a0f47bb53ef3e1fb1a9c222fed22d8361a1b1,1,1,1,2,1,2012-02-17 20:09:40,2012-02-17 20:09:40
2a1a0f47bb53ef3e1fb1a9c222fed22d8361a1b1...c1bdfd6f6fff0844c17853972358a2300f6aac23,10,10,11,21,11,2012-02-17 20:23:42,2012-02-17 20:23:42
c1bdfd6f6fff0844c17853972358a2300f6aac23...b039bd3fb04ab92909a30050beaf634768116a46,18,0,0,0,0,2012-02-18 09:32:18,2012-02-18 09:32:18
b039bd3fb04ab92909a30050beaf634768116a46...8d221e554c0d47256f02d42f1b86909a67c86ed3,1,2,2,4,1,2012-02-18 09:36:58,2012-02-18 09:36:58
8d221e554c0d47256f02d42f1b86909a67c86ed3...52b06e29c76dc9a5184edf3bbea64f0d4d5442b1,2,16,4,20,6,2012-02-18 09:50:03,2012-02-18 09:50:03
52b06e29c76dc9a5184edf3bbea64f0d4d5442b1...7dd0ceba2e8413d79c2aaff62733f4631cd3c1e7,7,39,9,48,9,2012-02-18 13:37:30,2012-02-18 13:37:30
7dd0ceba2e8413d79c2aaff62733f4631cd3c1e7...25a68c65749d16019988bbb7a96b5e8efdb591f6,1,2,2,4,2,2012-02-18 21:40:00,2012-02-18 21:40:00
25a68c65749d16019988bbb7a96b5e8efdb591f6...03aa030f07b4b75add143f895f18fd7d54f770ca,1,5,3,8,1,2012-02-18 21:50:48,2012-02-18 21:50:48
03aa030f07b4b75add143f895f18fd7d54f770ca...0fe4218427ab293ade4075eef2a0fed29c6c0e51,2,13,16,29,2,2012-02-19 07:39:05,2012-02-19 07:39:05
0fe4218427ab293ade4075eef2a0fed29c6c0e51...7a7ec73efe494235807ade1318c8f3ccade9edc3,1,20,14,34,3,2012-02-19 08:00:06,2012-02-19 08:00:06
7a7ec73efe494235807ade1318c8f3ccade9edc3...9d0bf662734b4a7bdf1ae339390c8fe8b0991ea7,1,4,0,4,1,2012-02-19 08:09:20,2012-02-19 08:09:20
9d0bf662734b4a7bdf1ae339390c8fe8b0991ea7...1d78897c5de5bc387dabd997ed8e64dd541708bb,2,29,11,40,5,2012-02-19 09:02:52,2012-02-19 09:02:52
1d78897c5de5bc387dabd997ed8e64dd541708bb...cfd0cb00647ac5ccf48c775605eafbade07217d7,1,6,2,8,3,2012-02-19 09:19:38,2012-02-19 09:19:38
cfd0cb00647ac5ccf48c775605eafbade07217d7...f0c2228709b0481eac09c860d7a4a30d3987cc19,8,191,15,206,20,2012-02-19 16:42:12,2012-02-19 16:42:12
f0c2228709b0481eac09c860d7a4a30d3987cc19...e1bbf3b6bc8a10cfea9c3101434b13d202637830,1,1,1,2,2,2012-02-19 16:53:55,2012-02-19 16:53:55
e1bbf3b6bc8a10cfea9c3101434b13d202637830...9e62428c2814358350ae715f0d51b4c7d4f258a0,2,12,3,15,2,2012-02-20 18:57:51,2012-02-20 18:57:51
9e62428c2814358350ae715f0d51b4c7d4f258a0...7d7d2d354c6670b645a14a7bd941c5f2cac79063,1,7,0,7,1,2012-02-20 19:08:22,2012-02-20 19:08:22
7d7d2d354c6670b645a14a7bd941c5f2cac79063...0e54c23caf21e5680aff68660b5d5b5937b98262,3,26,18,44,10,2012-02-21 02:59:05,2012-02-21 02:59:05
0e54c23caf21e5680aff68660b5d5b5937b98262...5b560ec0c06478327765297e3863cd9314ff167b,1,12,10,22,7,2012-02-21 18:28:35,2012-02-21 18:28:35
5b560ec0c06478327765297e3863cd9314ff167b...a3bb4df8956185c345e3a4c68df15ad7286788b0,1,2,0,2,1,2012-02-21 23:54:02,2012-02-21 23:54:02
a3bb4df8956185c345e3a4c68df15ad7286788b0...3ac0961e1ec3f935474e3c1c3f16bee1cc5ae54a,3,15,2,17,4,2012-02-22 00:42:19,2012-02-22 00:42:19
3ac0961e1ec3f935474e3c1c3f16bee1cc5ae54a...354c84d277e3a9516cd2af1567eb02cb4da1a3e4,7,27,29,56,16,2012-02-22 05:26:50,2012-02-22 05:26:50
354c84d277e3a9516cd2af1567eb02cb4da1a3e4...a65eed39425581b206f934dd6eed960af8a64f3e,3,17,3,20,7,2012-02-22 07:14:10,2012-02-22 07:14:10
a65eed39425581b206f934dd6eed960af8a64f3e...c8703189966ef9ce0c9dd300270bf442fa2bf7b6,1,2,2,4,2,2012-02-22 07:14:20,2012-02-22 07:14:20
c8703189966ef9ce0c9dd300270bf442fa2bf7b6...8b5361619818a8e16562d054d7dc8ddf61147384,4,80,34,114,22,2012-02-22 19:40:27,2012-02-22 19:40:27
8b5361619818a8e16562d054d7dc8ddf61147384...8842183448862377b5fa2107d5d5c5d2aa78b9b9,1,17,9,26,5,2012-02-22 21:13:36,2012-02-22 21:13:36
8842183448862377b5fa2107d5d5c5d2aa78b9b9...6daad896fb616bbcd3171a04c00442294fa84173,1,0,6,6,1,2012-02-22 21:42:50,2012-02-22 21:42:50
6daad896fb616bbcd3171a04c00442294fa84173...f2de5f4caba819fad10a78bfec47ae6f29cc2c29,5,176,13,189,13,2012-02-23 08:07:07,2012-02-23 08:07:07
f2de5f4caba819fad10a78bfec47ae6f29cc2c29...239e41f7c551308cea64561eed43ef2e81b60370,3,18,30,48,11,2012-02-23 21:39:12,2012-02-23 21:39:12
239e41f7c551308cea64561eed43ef2e81b60370...1525874238fd705ec17a066291935a9316bd3044,1,22,2,24,6,2012-02-23 22:51:14,2012-02-23 22:51:14
1525874238fd705ec17a066291935a9316bd3044...e4f468b9405ce7560dd00a383138f7d15e8549ec,1,3,4,7,2,2012-02-24 22:50:36,2012-02-24 22:50:36
e4f468b9405ce7560dd00a383138f7d15e8549ec...ce4cd788efff1a01c775235dcccf35fbb1bc0ec8,1,1,1,2,1,2012-02-24 22:53:48,2012-02-24 22:53:48
ce4cd788efff1a01c775235dcccf35fbb1bc0ec8...5a013cebd92e5d935088043398e6c04ff6107879,1,13,182,195,12,2012-02-24 23:24:30,2012-02-24 23:24:30
5a013cebd92e5d935088043398e6c04ff6107879...9f6859e1eac0c39e2e4fb79a1336eb63b0295fec,7,27,11,38,8,2012-02-26 14:35:46,2012-02-26 14:35:46
9f6859e1eac0c39e2e4fb79a1336eb63b0295fec...d96ffa130e8771adbbd717b92751d1c336db00ec,1,22,0,22,1,2012-02-26 16:19:40,2012-02-26 16:19:40
d96ffa130e8771adbbd717b92751d1c336db00ec...26d12af6fdbdf63822dd8b637f9b0c63a7664b4c,2,2,2,4,2,2012-02-26 20:48:48,2012-02-26 20:48:48
26d12af6fdbdf63822dd8b637f9b0c63a7664b4c...e0d78f898fb4000236881f447c9435f3395f3349,7,88,56,144,32,2012-02-26 21:17:58,2012-02-26 21:17:58
e0d78f898fb4000236881f447c9435f3395f3349...4bbacd2663aab52bc8e55d2051dc69f42b982f42,1,13,5,18,6,2012-02-27 13:29:56,2012-02-27 13:29:56
4bbacd2663aab52bc8e55d2051dc69f42b982f42...59b2439e7e7aeba44ab52082f9014898104a0141,1,1,1,2,1,2012-02-27 14:40:27,2012-02-27 14:40:27
59b2439e7e7aeba44ab52082f9014898104a0141...0447cc123118c4740ccc6e25914f0e30308da55e,1,2,0,2,1,2012-02-27 14:40:36,2012-02-27 14:40:36
0447cc123118c4740ccc6e25914f0e30308da55e...7061da514ada660a7b6c34e7eccf3940afec67fa,2,3,0,3,1,2012-02-27 19:04:33,2012-02-27 19:04:33
7061da514ada660a7b6c34e7eccf3940afec67fa...ce88b57b9aca0325e5b90944019f602a92f93475,4,80,23,103,27,2012-02-27 21:15:25,2012-02-27 21:15:25
ce88b57b9aca0325e5b90944019f602a92f93475...2ddfcfbec67e1373dd61ed1640ff6ddcdef9e3aa,1,7,5,12,1,2012-02-27 22:52:07,2012-02-27 22:52:07
2ddfcfbec67e1373dd61ed1640ff6ddcdef9e3aa...abf2d4295f0ec52fdafdda956ad3e5bc59e63d63,1,21,10,31,8,2012-02-27 22:54:35,2012-02-27 22:54:35
abf2d4295f0ec52fdafdda956ad3e5bc59e63d63...4b641b78fa1e9cf774d1c0339ef07a854c35e011,1,5,1,6,2,2012-02-28 09:50:18,2012-02-28 09:50:18
4b641b78fa1e9cf774d1c0339ef07a854c35e011...de9942a6673cfbe442abdfabc1e8f7c0a652ef5b,3,20,1,21,4,2012-02-28 19:34:04,2012-02-28 19:34:04
de9942a6673cfbe442abdfabc1e8f7c0a652ef5b...97061bdf30216adfe50a1a367ddeefe06af5fefc,2,8,14,22,6,2012-02-28 21:23:45,2012-02-28 21:23:45
97061bdf30216adfe50a1a367ddeefe06af5fefc...c471cfd67425a6394a6f91bf6e71573e8f482850,1,2,3,5,3,2012-02-29 08:57:48,2012-02-29 08:57:48
c471cfd67425a6394a6f91bf6e71573e8f482850...ae640e5ea08809f56be20957895a61168dbfaeca,8,11,49,60,9,2012-02-29 17:46:23,2012-02-29 17:46:23
ae640e5ea08809f56be20957895a61168dbfaeca...413e37481d0b81d50b5826f660eeb79f360be9fc,3,44,8,52,9,2012-02-29 20:12:16,2012-02-29 20:12:16
413e37481d0b81d50b5826f660eeb79f360be9fc...3db5b0e48554ccc76becefb86b630c9cf72be9f1,3,95,5,100,7,2012-03-01 00:57:01,2012-03-01 00:57:01
3db5b0e48554ccc76becefb86b630c9cf72be9f1...d2988ce0f4eb3e021ed317f7d0347e1f48481f37,1,1,0,1,1,2012-03-01 01:06:22,2012-03-01 01:06:22
d2988ce0f4eb3e021ed317f7d0347e1f48481f37...98a1e14e093211f15e91daa4c9de0402be5d31b8,2,1,1,2,1,2012-03-01 16:09:01,2012-03-01 16:09:01
98a1e14e093211f15e91daa4c9de0402be5d31b8...b05abd8314a3e20c23b52248906848dcac6f09a4,1,1,1,2,1,2012-03-01 19:32:48,2012-03-01 19:32:48
b05abd8314a3e20c23b52248906848dcac6f09a4...d0f162c73c35b304e1cf9a8133b3a8f54fd3f740,1,3,3,6,3,2012-03-01 19:49:19,2012-03-01 19:49:19
d0f162c73c35b304e1cf9a8133b3a8f54fd3f740...45570580839ce2e4e4674b42375dbc1300f91f14,1,3,0,3,1,2012-03-01 21:38:45,2012-03-01 21:38:45
45570580839ce2e4e4674b42375dbc1300f91f14...1c33c0a02a89d7d2090c4f9e2c0c85209281347b,2,63,4,67,4,2012-03-01 23:02:38,2012-03-01 23:02:38
1c33c0a02a89d7d2090c4f9e2c0c85209281347b...df1e505d9f99e557b22270365c90f9517a19bd27,1,2,0,2,1,2012-03-02 00:05:13,2012-03-02 00:05:13
df1e505d9f99e557b22270365c90f9517a19bd27...fe7ccdc5bee76028a14f4afd2532f748253854a4,1,2,1,3,1,2012-03-02 03:42:20,2012-03-02 03:42:20
fe7ccdc5bee76028a14f4afd2532f748253854a4...10e671efaa824e5614ceb79356f0bf59ebb58c4d,1,1,1,2,1,2012-03-02 03:48:26,2012-03-02 03:48:26
10e671efaa824e5614ceb79356f0bf59ebb58c4d...60119d4f49f78a635f801d53c102f1463e28fe8a,2,20,0,20,3,2012-03-02 04:04:56,2012-03-02 04:04:56
60119d4f49f78a635f801d53c102f1463e28fe8a...2a4e49595acd263e9bac67c32b1683dc4310901b,2,10,4,14,2,2012-03-02 04:22:16,2012-03-02 04:22:16
2a4e49595acd263e9bac67c32b1683dc4310901b...84dd83f0185687adfe44452afb2fc9cff15ba594,1,10,1,11,2,2012-03-02 04:27:46,2012-03-02 04:27:46
84dd83f0185687adfe44452afb2fc9cff15ba594...a255d3933828ea5ab5173bc41336a64f446057bb,2,8,6,14,7,2012-03-02 05:03:52,2012-03-02 05:03:52
a255d3933828ea5ab5173bc41336a64f446057bb...746987f916bfb24a0671429d9993ad727dc7c8bc,5,39,47,86,19,2012-03-02 11:07:36,2012-03-02 11:07:36
746987f916bfb24a0671429d9993ad727dc7c8bc...e88a65660f8d114b8c5e8670f228af7f4bdd81a0,3,6,2,8,4,2012-03-02 11:29:14,2012-03-02 11:29:14
e88a65660f8d114b8c5e8670f228af7f4bdd81a0...8cadf1d79a00819ee153eafa9590abe21249969c,1,1,1,2,1,2012-03-02 16:06:11,2012-03-02 16:06:11
8cadf1d79a00819ee153eafa9590abe21249969c...7b624c6c3205094b4fbf2ef2b7164ff7668665a5,1,294,221,515,74,2012-03-02 16:45:06,2012-03-02 16:45:06
7b624c6c3205094b4fbf2ef2b7164ff7668665a5...4887a8de170ad9227d79f39f5bd3d2564f4e7ef8,2,10,4,14,3,2012-03-02 16:55:56,2012-03-02 16:55:56
4887a8de170ad9227d79f39f5bd3d2564f4e7ef8...d93a2ef887e353192ff8b0a7a5271ad80abf2b52,2,28,0,28,4,2012-03-02 16:56:04,2012-03-02 16:56:04
d93a2ef887e353192ff8b0a7a5271ad80abf2b52...40b248acc76c833710e58f2539563b8bbaee4336,1,7,1,8,2,2012-03-02 16:56:11,2012-03-02 16:56:11
40b248acc76c833710e58f2539563b8bbaee4336...fcaf8eae14d0a7f884328bdf0238dd1e2881c681,3,10,1,11,3,2012-03-02 16:56:20,2012-03-02 16:56:20
fcaf8eae14d0a7f884328bdf0238dd1e2881c681...3ed0b6ed64ff7a69644d1c1eacfb62b0aedadf71,2,7,0,7,2,2012-03-02 17:13:53,2012-03-02 17:13:53
3ed0b6ed64ff7a69644d1c1eacfb62b0aedadf71...2ade1e916f308fef246811f6511aa27b7dd9d51b,16,100,101,201,69,2012-03-02 17:16:52,2012-03-02 17:16:52
2ade1e916f308fef246811f6511aa27b7dd9d51b...89b57a7c776554a5ba1a1082aa8c745858006042,1,1,1,2,1,2012-03-02 20:34:46,2012-03-02 20:34:46
89b57a7c776554a5ba1a1082aa8c745858006042...b9bf7cce896a4886f77b2162042a6fb676463b86,4,52,2,54,5,2012-03-02 22:32:22,2012-03-02 22:32:22
b9bf7cce896a4886f77b2162042a6fb676463b86...126d9e1b499663e72cc795906bdbcd333aceaf0a,2,8,7,15,4,2012-03-02 22:35:26,2012-03-02 22:35:26
126d9e1b499663e72cc795906bdbcd333aceaf0a...c76200a0bfbbec747fa420cc6ef21868dcc3bf69,3,40,8,48,23,2012-03-03 01:06:37,2012-03-03 01:06:37
c76200a0bfbbec747fa420cc6ef21868dcc3bf69...d636150e533a2954f9b74aa6ca2e7375b18437ef,6,184,16,200,16,2012-03-03 02:13:35,2012-03-03 02:13:35
d636150e533a2954f9b74aa6ca2e7375b18437ef...c0e73a4909832e0db7cac5345128979a21529786,8,106,81,187,37,2012-03-03 09:11:54,2012-03-03 09:11:54
c0e73a4909832e0db7cac5345128979a21529786...3576c99f745d421d3728992f82dd0158243968a2,1,32,5,37,3,2012-03-03 10:13:35,2012-03-03 10:13:35
3576c99f745d421d3728992f82dd0158243968a2...3b2c53ac6972ae970d6634693d6fd05a4fa169e0,1,5,1,6,2,2012-03-03 17:16:43,2012-03-03 17:16:43
3b2c53ac6972ae970d6634693d6fd05a4fa169e0...48840cc9d1f9e20e5122518e2442c0baa08e9f4c,1,1,1,2,1,2012-03-03 17:41:32,2012-03-03 17:41:32
48840cc9d1f9e20e5122518e2442c0baa08e9f4c...dc49e6143a1e3cfafa4b7b41e4ab3c86d3e68918,3,20,5,25,5,2012-03-03 17:50:18,2012-03-03 17:50:18
dc49e6143a1e3cfafa4b7b41e4ab3c86d3e68918...c988397279147b9d38c5b3feed9647c586fa049a,2,19,1,20,6,2012-03-03 19:02:49,2012-03-03 19:02:49
c988397279147b9d38c5b3feed9647c586fa049a...7ce1ad7c0364102523e4696a6926c099b7f0584e,2,7,7,14,5,2012-03-03 19:57:25,2012-03-03 19:57:25
7ce1ad7c0364102523e4696a6926c099b7f0584e...dd441701ced9621f184f8e601339cfb9c16a844b,3,14,7,21,8,2012-03-03 21:34:51,2012-03-03 21:34:51
dd441701ced9621f184f8e601339cfb9c16a844b...149e54103415921359e549d5e7fe9f4fbd1ecb75,2,34,23,57,17,2012-03-03 21:50:49,2012-03-03 21:50:49
149e54103415921359e549d5e7fe9f4fbd1ecb75...af3791fa7ff559e96e142efbc4f90c75093200c8,1,249,9,258,10,2012-03-03 22:02:23,2012-03-03 22:02:23
af3791fa7ff559e96e142efbc4f90c75093200c8...503c85affc904d7d042c5bd985d6c0c3c7cb0e2e,1,1,1,2,1,2012-03-03 22:41:21,2012-03-03 22:41:21
503c85affc904d7d042c5bd985d6c0c3c7cb0e2e...21c38f9c343dac598248c29537f67305c2853178,1,2,1,3,1,2012-03-03 22:54:55,2012-03-03 22:54:55
21c38f9c343dac598248c29537f67305c2853178...4dca9d166a42717b7d7bf5cf3c5da8149cf88cb2,2,90,4,94,11,2012-03-04 01:20:03,2012-03-04 01:20:03
4dca9d166a42717b7d7bf5cf3c5da8149cf88cb2...794fe19e196b98533ee539d35fd7ab7f688166b7,1,25,5,30,6,2012-03-04 04:50:58,2012-03-04 04:50:58
794fe19e196b98533ee539d35fd7ab7f688166b7...60a62bf6f296f2f7680f01343b7fbc254063aae5,1,1,1,2,1,2012-03-04 09:33:28,2012-03-04 09:33:28
60a62bf6f296f2f7680f01343b7fbc254063aae5...59a436e963db9018a930b9b5c83785bdc2ab0139,4,62,4,66,8,2012-03-04 16:10:18,2012-03-04 16:10:18
59a436e963db9018a930b9b5c83785bdc2ab0139...20b021e5062de5b78d637e65a5df614682d26878,1,2,2,4,1,2012-03-04 16:47:28,2012-03-04 16:47:28
20b021e5062de5b78d637e65a5df614682d26878...cfd0cd1bc900b24e6206ca065520eef91d3ca3fa,1,15,0,15,1,2012-03-04 17:34:22,2012-03-04 17:34:22
cfd0cd1bc900b24e6206ca065520eef91d3ca3fa...a78e61b5e97e0bf300bdc698b5f6d969f85d72c0,1,2,2,4,2,2012-03-04 20:32:12,2012-03-04 20:32:12
a78e61b5e97e0bf300bdc698b5f6d969f85d72c0...b403e43c5164d07af88e924a5fdbd3f051c6cb9e,3,112,76,188,74,2012-03-05 02:23:17,2012-03-05 02:23:17
b403e43c5164d07af88e924a5fdbd3f051c6cb9e...30b8ff3042a05758e85a2b5511326df1933e98c3,4,68,54,122,54,2012-03-05 02:23:31,2012-03-05 02:23:31
30b8ff3042a05758e85a2b5511326df1933e98c3...6ad7cf18413e62caf3432c10d37d4ac2e535b92e,2,80,66,146,52,2012-03-05 02:23:40,2012-03-05 02:23:40
6ad7cf18413e62caf3432c10d37d4ac2e535b92e...4e058d82c58466bd60efc471658a300e46d72828,2,6,6,12,3,2012-03-05 02:23:49,2012-03-05 02:23:49
4e058d82c58466bd60efc471658a300e46d72828...6c7b9b5ec8fd7b45dac3a2cc45820fc3a6fd1388,2,19,4,23,5,2012-03-05 02:23:57,2012-03-05 02:23:57
6c7b9b5ec8fd7b45dac3a2cc45820fc3a6fd1388...bf6ccebef74f36ce2950e8b84e32da53cfee8bda,2,13,5,18,5,2012-03-05 02:24:06,2012-03-05 02:24:06
bf6ccebef74f36ce2950e8b84e32da53cfee8bda...2002ed9e09bb2ec5ebbad1d4c8df27d8a870cc0e,2,25,1,26,3,2012-03-05 02:24:14,2012-03-05 02:24:14
2002ed9e09bb2ec5ebbad1d4c8df27d8a870cc0e...ad97f0ec4bec531eceafc6b088d8171cf8abb1c4,2,3,2,5,2,2012-03-05 02:24:23,2012-03-05 02:24:23
ad97f0ec4bec531eceafc6b088d8171cf8abb1c4...5ccc6f17b8452ef1377755d21148036dc0c88ba0,2,10,2,12,3,2012-03-05 03:25:27,2012-03-05 03:25:27
5ccc6f17b8452ef1377755d21148036dc0c88ba0...7e92ad8506e6f312b4feb69e74ef17c42678bc05,4,142,9,151,12,2012-03-05 03:41:01,2012-03-05 03:41:01
7e92ad8506e6f312b4feb69e74ef17c42678bc05...8c9b032ea03911185622ea4ef12ccea5ee7e3455,5,137,8,145,20,2012-03-05 04:17:55,2012-03-05 04:17:55
8c9b032ea03911185622ea4ef12ccea5ee7e3455...399aa72330d806d2cde36f3e8d0acce11b5f2f4a,4,56,25,81,24,2012-03-05 08:13:09,2012-03-05 08:13:09
399aa72330d806d2cde36f3e8d0acce11b5f2f4a...6b48b8856432e145fce7294f274305fea11cc9a6,1,1,1,2,1,2012-03-05 08:47:22,2012-03-05 08:47:22
6b48b8856432e145fce7294f274305fea11cc9a6...101b6e13e360506e188fe55ab10ae70f56f085c4,1,12,5,17,9,2012-03-05 09:42:31,2012-03-05 09:42:31
101b6e13e360506e188fe55ab10ae70f56f085c4...f95141abcc8a56c533500befac7baf2ae25b5a5a,1,10,7,17,8,2012-03-05 10:30:00,2012-03-05 10:30:00
f95141abcc8a56c533500befac7baf2ae25b5a5a...bf0abe0ea6cb492810c5b4f9306a19c8afe603bb,2,53,40,93,18,2012-03-05 12:27:19,2012-03-05 12:27:19
bf0abe0ea6cb492810c5b4f9306a19c8afe603bb...878ec9e6463d253b7ad840656d0630c42adcbb77,3,3,3,6,3,2012-03-05 17:22:23,2012-03-05 17:22:23
878ec9e6463d253b7ad840656d0630c42adcbb77...60fa88aab9ef32d50dbc6a407990908ad6832548,1,1,1,2,1,2012-03-05 17:30:27,2012-03-05 17:30:27
60fa88aab9ef32d50dbc6a407990908ad6832548...ecc8208f881340c7b97500e47af6315055182503,9,0,0,0,0,2012-03-09 12:13:31,2012-03-09 12:13:31
ecc8208f881340c7b97500e47af6315055182503...54a1fa74bfdf9a22dbe47e440531965b1e46c7a1,1,1,1,2,1,2012-03-10 10:03:33,2012-03-10 10:03:33
54a1fa74bfdf9a22dbe47e440531965b1e46c7a1...c4527b1df743c43983e9912c81b73bc0b02fe1b9,1,1,3,4,3,2012-03-10 17:24:11,2012-03-10 17:24:11
c4527b1df743c43983e9912c81b73bc0b02fe1b9...4cd9b4bb5081338176e66dae14115130d50831a9,5,57,53,110,4,2012-03-10 17:36:41,2012-03-10 17:36:41
4cd9b4bb5081338176e66dae14115130d50831a9...c6425aafa58867d90ae11e7420bd6ba90693dd88,3,4,4,8,4,2012-03-10 17:50:59,2012-03-10 17:50:59
c6425aafa58867d90ae11e7420bd6ba90693dd88...e1a31aadb0dcfe03853b3c288ff81c1ed32dc227,1,1,1,2,1,2012-03-11 11:49:38,2012-03-11 11:49:38
e1a31aadb0dcfe03853b3c288ff81c1ed32dc227...aba9ebcaee8edf3fb0b99bdc670c0620dab1b270,1,2,2,4,2,2012-03-11 19:49:19,2012-03-11 19:49:19
aba9ebcaee8edf3fb0b99bdc670c0620dab1b270...bf1112de7d0618ece5c107627ff18b1c0d098f85,1,1,1,2,1,2012-03-12 10:43:59,2012-03-12 10:43:59
bf1112de7d0618ece5c107627ff18b1c0d098f85...771fce45b40deec44b47014829c1f7e973fc7fd7,2,15,3,18,3,2012-03-12 17:09:18,2012-03-12 17:09:18
771fce45b40deec44b47014829c1f7e973fc7fd7...b2dcec228ab024f843f136c4bf230aea750b92d5,1,1,1,2,1,2012-03-12 17:22:22,2012-03-12 17:22:22
b2dcec228ab024f843f136c4bf230aea750b92d5...2f520139bedffc8622d8c598443c90d58f6a427e,1,0,7,7,2,2012-03-12 18:51:48,2012-03-12 18:51:48
2f520139bedffc8622d8c598443c90d58f6a427e...20c69c5e51f1ca180978a51d64246b70f778df83,4,60,2,62,10,2012-03-12 19:41:31,2012-03-12 19:41:31
20c69c5e51f1ca180978a51d64246b70f778df83...dd246a62c743461b5010dbb09f356563c4c0351d,8,61,63,124,38,2012-03-12 20:05:48,2012-03-12 20:05:48
dd246a62c743461b5010dbb09f356563c4c0351d...ebc6fc9354c857bc0ac00895175c2575b01b1bd7,1,11,0,11,1,2012-03-12 20:14:58,2012-03-12 20:14:58
ebc6fc9354c857bc0ac00895175c2575b01b1bd7...3a5f9cd1ae8a2c7101f141d9730878abb74ec92f,2,17,1,18,4,2012-03-12 20:28:09,2012-03-12 20:28:09
3a5f9cd1ae8a2c7101f141d9730878abb74ec92f...3cc2cdddb3ac1e8a71978a0899d600def67ca4c7,1,3,1,4,1,2012-03-12 21:58:07,2012-03-12 21:58:07
3cc2cdddb3ac1e8a71978a0899d600def67ca4c7...db512b4d8c8c8b6e8a0dbc217617b4de97d84b69,1,10,12,22,5,2012-03-12 22:00:44,2012-03-12 22:00:44
db512b4d8c8c8b6e8a0dbc217617b4de97d84b69...9d98b9eb4bee1c9d69694f37dc618c36ecfecb8d,3,10,2,12,4,2012-03-12 22:33:18,2012-03-12 22:33:18
9d98b9eb4bee1c9d69694f37dc618c36ecfecb8d...d694f17536839be3fbd37fc51416790322a02a92,1,2,2,4,2,2012-03-12 23:05:16,2012-03-12 23:05:16
d694f17536839be3fbd37fc51416790322a02a92...37d04889108bb4334b873fa8b0b017343e15c5a1,1,10,0,10,1,2012-03-13 00:15:43,2012-03-13 00:15:43
37d04889108bb4334b873fa8b0b017343e15c5a1...d174216587197dcc6c4c9abcacb8e428a1f078bf,1,12,3,15,1,2012-03-13 01:01:22,2012-03-13 01:01:22
d174216587197dcc6c4c9abcacb8e428a1f078bf...7487c74020f97829e466c7efbdf7bd9e5fa90b1b,3,7,2,9,4,2012-03-13 03:48:03,2012-03-13 03:48:03
7487c74020f97829e466c7efbdf7bd9e5fa90b1b...0ee801e3603218a3c3a8c0adbc94f69e40523ee2,3,15,14,29,12,2012-03-13 03:48:11,2012-03-13 03:48:11
0ee801e3603218a3c3a8c0adbc94f69e40523ee2...f7daa38a0025da1613e772af2aec419169b086cc,3,40,10,50,12,2012-03-13 03:48:20,2012-03-13 03:48:20
f7daa38a0025da1613e772af2aec419169b086cc...aa900c39a8e3134d09e2285cce030c1b33b1e820,2,9,2,11,3,2012-03-13 06:59:04,2012-03-13 06:59:04
aa900c39a8e3134d09e2285cce030c1b33b1e820...dd13596944c3aa312c828ac03a1f1acd8fb60dc2,1,4,0,4,1,2012-03-13 16:33:56,2012-03-13 16:33:56
dd13596944c3aa312c828ac03a1f1acd8fb60dc2...f5afa22abd13d69ecc2fca628ed47bb945f7c431,2,14,1,15,3,2012-03-13 17:35:00,2012-03-13 17:35:00
f5afa22abd13d69ecc2fca628ed47bb945f7c431...69b96f824d2de0904f03e457c564f22fb8ed57e4,2,51,0,51,3,2012-03-13 17:52:48,2012-03-13 17:52:48
69b96f824d2de0904f03e457c564f22fb8ed57e4...78638a9a5180eb373df0d4430a2169bd49fa9e42,59,112,112,224,101,2012-03-13 17:53:31,2012-03-13 17:53:31
78638a9a5180eb373df0d4430a2169bd49fa9e42...3dc946e49e479f1f7d783dd8915e5ad81d145ef7,2,5,1,6,2,2012-03-13 19:23:52,2012-03-13 19:23:52
3dc946e49e479f1f7d783dd8915e5ad81d145ef7...01c8862abd7004ebcdf8aae81c34737cd8dc7e15,1,9,0,9,1,2012-03-13 21:49:48,2012-03-13 21:49:48
01c8862abd7004ebcdf8aae81c34737cd8dc7e15...2a0f4578efdda44325df9b32ff5f1790ca1e7752,1,11,5,16,5,2012-03-13 22:21:38,2012-03-13 22:21:38
2a0f4578efdda44325df9b32ff5f1790ca1e7752...4b14546215ad4ef15f04e748e3b5f0da7b613b45,3,17,13,30,9,2012-03-13 23:02:31,2012-03-13 23:02:31
4b14546215ad4ef15f04e748e3b5f0da7b613b45...3ef55dfaa03b3f5be3ee3632dfc59b8f752d2dec,4,29,8,37,5,2012-03-13 23:29:15,2012-03-13 23:29:15
3ef55dfaa03b3f5be3ee3632dfc59b8f752d2dec...21fb1c59c311253af1388ec92139ff1bb687a091,4,5,5,10,4,2012-03-14 07:41:02,2012-03-14 07:41:02
21fb1c59c311253af1388ec92139ff1bb687a091...43cb17bbe50cb72ef9f10a9d959b1adc4d01c304,1,7,1,8,2,2012-03-14 08:40:35,2012-03-14 08:40:35
43cb17bbe50cb72ef9f10a9d959b1adc4d01c304...f8446024bc1a15f7ffff90cb658a274fa0ca2a9a,130,20872,16146,37018,12844,2012-03-14 08:51:40,2012-03-14 08:51:40
f8446024bc1a15f7ffff90cb658a274fa0ca2a9a...f49bbc986dd7396219f9d5f3e96bf605a95e8fbc,260,17960,14162,32122,10010,2012-03-14 08:53:34,2012-03-14 08:53:34
f49bbc986dd7396219f9d5f3e96bf605a95e8fbc...f30536b547d8a75babdd216202acfd377811017b,130,4758,2064,6822,1930,2012-03-14 08:55:00,2012-03-14 08:55:00
f30536b547d8a75babdd216202acfd377811017b...67dd5b7d96b3471a2ad82a41d256727e1562d719,130,7594,5836,13430,3471,2012-03-14 08:56:23,2012-03-14 08:56:23
67dd5b7d96b3471a2ad82a41d256727e1562d719...bf586ee8d28012da0e67bb56a83002c098de5abc,130,1384,1140,2524,815,2012-03-14 08:57:46,2012-03-14 08:57:46
bf586ee8d28012da0e67bb56a83002c098de5abc...9fad0d61eaba53ad0833ee9e12f40cebd72ee7d6,130,1703,524,2227,460,2012-03-14 08:59:12,2012-03-14 08:59:12
9fad0d61eaba53ad0833ee9e12f40cebd72ee7d6...0a32209add7effa58ecdc4af7f04cef17c3a20fc,130,1813,717,2530,484,2012-03-14 09:00:35,2012-03-14 09:00:35
0a32209add7effa58ecdc4af7f04cef17c3a20fc...ec5a71b4ae70d309009919aa368c809f4c12b59f,130,1360,383,1743,264,2012-03-14 09:01:56,2012-03-14 09:01:56
ec5a71b4ae70d309009919aa368c809f4c12b59f...43daea5390a84ba4bc977533f2deb1dc6cbcc16e,130,2101,334,2435,342,2012-03-14 09:03:19,2012-03-14 09:03:19
43daea5390a84ba4bc977533f2deb1dc6cbcc16e...8256abc181eb4634d0d09242752654b44b7b3447,130,14577,1903,16480,1461,2012-03-14 09:05:08,2012-03-14 09:05:08
8256abc181eb4634d0d09242752654b44b7b3447...a63be60b1dcc8e3e087fb5088ba753c89a42b92c,130,106047,43212,149259,14686,2012-03-14 09:06:29,2012-03-14 09:06:29
a63be60b1dcc8e3e087fb5088ba753c89a42b92c...50b9f1f5502cba964a646cb4c1a2e1a3fd7b3648,130,563,387,950,272,2012-03-14 09:07:51,2012-03-14 09:07:51
50b9f1f5502cba964a646cb4c1a2e1a3fd7b3648...2e745328fdfa2254326c97bb0b38efe9735c17e4,130,524,333,857,205,2012-03-14 09:09:14,2012-03-14 09:09:14
2e745328fdfa2254326c97bb0b38efe9735c17e4...0c1a8a99df3cd0adaba0a952396edd0dcadd12b1,130,846,656,1502,527,2012-03-14 09:10:38,2012-03-14 09:10:38
0c1a8a99df3cd0adaba0a952396edd0dcadd12b1...4f4cdc8dad3ee7053a1561636074690d052df0c2,130,521,332,853,201,2012-03-14 09:12:00,2012-03-14 09:12:00
4f4cdc8dad3ee7053a1561636074690d052df0c2...e47b92dad7302f34f9ee9f3ab12b8ae9c56461ec,34,7281,0,7281,18,2012-03-14 09:12:43,2012-03-14 09:12:43
e47b92dad7302f34f9ee9f3ab12b8ae9c56461ec...661139a29e4193d055e9927afe6bb47151744985,34,7205,0,7205,18,2012-03-14 09:13:24,2012-03-14 09:13:24
661139a29e4193d055e9927afe6bb47151744985...830900c24af939ec29bff891168b62c5a41782c5,34,7150,1,7151,19,2012-03-14 09:14:07,2012-03-14 09:14:07
830900c24af939ec29bff891168b62c5a41782c5...e540f27475f3bfd12f65edfca30908c34af7e248,34,7135,0,7135,18,2012-03-14 09:14:48,2012-03-14 09:14:48
e540f27475f3bfd12f65edfca30908c34af7e248...9d1d1f06db07900927f26ba1595d26a6f16cfbcc,34,7172,0,7172,18,2012-03-14 09:15:31,2012-03-14 09:15:31
9d1d1f06db07900927f26ba1595d26a6f16cfbcc...eb9eaa6d7182e8156699a692916af4b167cdc363,1,8,12,20,8,2012-03-14 10:58:23,2012-03-14 10:58:23
eb9eaa6d7182e8156699a692916af4b167cdc363...14df122f865e5c050a26c619f616d4983d6a4ed2,5,70,3,73,10,2012-03-14 19:06:23,2012-03-14 19:06:23
14df122f865e5c050a26c619f616d4983d6a4ed2...1235cd376e6bc8fd5c6cafe4bffeb6fa018e1476,1,4,0,4,2,2012-03-14 20:46:52,2012-03-14 20:46:52
1235cd376e6bc8fd5c6cafe4bffeb6fa018e1476...dad1f5c21e14ab226cf4e7b28cf27fe7195be0e2,7,642,18,660,10,2012-03-14 22:16:46,2012-03-14 22:16:46
dad1f5c21e14ab226cf4e7b28cf27fe7195be0e2...a673ec80e21447b9833c744293cd5c60bfcce2ff,1,2,2,4,2,2012-03-14 22:23:35,2012-03-14 22:23:35
a673ec80e21447b9833c744293cd5c60bfcce2ff...a935e834433cfc691882c2bbf1249a39abecd35b,2,3,15,18,4,2012-03-15 02:46:07,2012-03-15 02:46:07
a935e834433cfc691882c2bbf1249a39abecd35b...e6ae858811ab880c18069dbd0055bddee85b45ba,3,3,3,6,3,2012-03-15 03:29:49,2012-03-15 03:29:49
e6ae858811ab880c18069dbd0055bddee85b45ba...f946b12c068a75d624766caaa7d814dec104f5e2,1,1,1,2,1,2012-03-15 07:56:01,2012-03-15 07:56:01
f946b12c068a75d624766caaa7d814dec104f5e2...8ef60df067a50d6d1f178bcf7aa285b6fa771dae,1,21,1,22,3,2012-03-15 13:16:27,2012-03-15 13:16:27
8ef60df067a50d6d1f178bcf7aa285b6fa771dae...b018128ea5f9ad494afb0007c597bc61630dc087,4,30,6,36,6,2012-03-15 15:06:57,2012-03-15 15:06:57
b018128ea5f9ad494afb0007c597bc61630dc087...e41fcdd4d9d687b6e6ed481b7a5378ae65f5e0f4,1,1,1,2,1,2012-03-15 16:50:29,2012-03-15 16:50:29
e41fcdd4d9d687b6e6ed481b7a5378ae65f5e0f4...ea9d96739f0814bdf2c5a5f250498e11a378db49,1,1,1,2,1,2012-03-15 18:55:08,2012-03-15 18:55:08
ea9d96739f0814bdf2c5a5f250498e11a378db49...a395e531de234ef6828e3f18ffc58afa4638da65,1,1,0,1,1,2012-03-16 00:29:11,2012-03-16 00:29:11
a395e531de234ef6828e3f18ffc58afa4638da65...49e7f4a229d8acf5920560987d6cd843c15df534,1,3,3,6,4,2012-03-16 00:36:52,2012-03-16 00:36:52
49e7f4a229d8acf5920560987d6cd843c15df534...232c99cee12be011c37d55ebdc36c8669b5ca0f7,1,13,11,24,1,2012-03-16 18:41:31,2012-03-16 18:41:31
232c99cee12be011c37d55ebdc36c8669b5ca0f7...ecf75e5957dfccc44c6a79abcc095592e26b576a,1,3,2,5,1,2012-03-16 19:30:00,2012-03-16 19:30:00
ecf75e5957dfccc44c6a79abcc095592e26b576a...c8c59c812c0cff2f473bdb0ea3af242efd298369,1,8,10,18,7,2012-03-16 21:41:19,2012-03-16 21:41:19
c8c59c812c0cff2f473bdb0ea3af242efd298369...edcaf8b7ffb035c3b699b6fb72a0d467e5ec2474,1,30,36,66,13,2012-03-16 23:27:40,2012-03-16 23:27:40
edcaf8b7ffb035c3b699b6fb72a0d467e5ec2474...ddd53dafb5fa6ba3cd5075c8e7b3214556c73b50,3,37,5,42,8,2012-03-17 01:24:39,2012-03-17 01:24:39
ddd53dafb5fa6ba3cd5075c8e7b3214556c73b50...e57bedee78de9a0893005a08299e5a4396ebfbaa,1,1,0,1,1,2012-03-17 04:39:23,2012-03-17 04:39:23
e57bedee78de9a0893005a08299e5a4396ebfbaa...8d71734f1573fb9ea657ac16c2b31fdb43d78ac6,3,3,3,6,4,2012-03-17 09:11:24,2012-03-17 09:11:24
8d71734f1573fb9ea657ac16c2b31fdb43d78ac6...69748864359f6038edca18b9e99a34fcc4a5a36b,1,1,1,2,1,2012-03-17 16:20:04,2012-03-17 16:20:04
69748864359f6038edca18b9e99a34fcc4a5a36b...f0b9bb2ef958052ab9c9b414dbcfa653eca7b83e,1,1,1,2,1,2012-03-17 17:44:42,2012-03-17 17:44:42
f0b9bb2ef958052ab9c9b414dbcfa653eca7b83e...b452439a6ef291e54877668719aa32888b3b3e1a,2,3,3,6,3,2012-03-17 20:13:06,2012-03-17 20:13:06
b452439a6ef291e54877668719aa32888b3b3e1a...1ff9be1144e80802ea810e6e70ef2b54b6e42047,3,39,36,75,14,2012-03-17 21:45:36,2012-03-17 21:45:36
1ff9be1144e80802ea810e6e70ef2b54b6e42047...f13328f7762dbdc920395bdf5c50fe0b6e40f1db,1,0,15,15,1,2012-03-17 22:13:20,2012-03-17 22:13:20
f13328f7762dbdc920395bdf5c50fe0b6e40f1db...c7cc4cfb9ebef17930db4a92cd0632a536a4ff7a,5,27,4,31,7,2012-03-17 22:31:03,2012-03-17 22:31:03
c7cc4cfb9ebef17930db4a92cd0632a536a4ff7a...c8e2f7591d6ea3545aeb32fa4c92cbeb9a622546,2,19,3,22,5,2012-03-18 20:58:22,2012-03-18 20:58:22
c8e2f7591d6ea3545aeb32fa4c92cbeb9a622546...358c5a1c2a182484516781e8342dfc9772d81b04,1,2,2,4,2,2012-03-19 12:52:15,2012-03-19 12:52:15
358c5a1c2a182484516781e8342dfc9772d81b04...6afc1d1a6b2c5c006f617cd5c023dafa9ced13c4,1,34,10,44,10,2012-03-19 20:44:51,2012-03-19 20:44:51
6afc1d1a6b2c5c006f617cd5c023dafa9ced13c4...163c8def8246f1398141023c8e7e2568cf24525c,1,3,2,5,2,2012-03-19 21:02:35,2012-03-19 21:02:35
163c8def8246f1398141023c8e7e2568cf24525c...ed27ae071f5a3c6515cd205333aa3dee58714751,5,35,5,40,20,2012-03-20 20:51:16,2012-03-20 20:51:16
ed27ae071f5a3c6515cd205333aa3dee58714751...86f9ab20b0ad3e7ad060c740adaa75f8b707d7cf,1,1,1,2,1,2012-03-20 21:04:57,2012-03-20 21:04:57
86f9ab20b0ad3e7ad060c740adaa75f8b707d7cf...1101739668f34a19e6e053e3bfdbf062e88db471,1,10,8,18,5,2012-03-21 05:57:22,2012-03-21 05:57:22
1101739668f34a19e6e053e3bfdbf062e88db471...4219e2b7f833171bd24c6dd9802deb9eb7d0bafe,4,41,4,45,4,2012-03-21 22:29:32,2012-03-21 22:29:32
4219e2b7f833171bd24c6dd9802deb9eb7d0bafe...1e28567e0d2be1f09a301131b1a29b939e797d6c,2,12,8,20,5,2012-03-22 07:29:39,2012-03-22 07:29:39
1e28567e0d2be1f09a301131b1a29b939e797d6c...a8d0fc10015be745c5d274b990d94dfb7d57c9d5,3,120,44,164,11,2012-03-22 08:10:19,2012-03-22 08:10:19
a8d0fc10015be745c5d274b990d94dfb7d57c9d5...e78d6b406bede7c021aaecf7ae2c8c893e0ea84a,3,13,3,16,4,2012-03-22 08:49:48,2012-03-22 08:49:48
e78d6b406bede7c021aaecf7ae2c8c893e0ea84a...ce7113ccbe5047baeb317c4b854ec119f8b5b460,1,2,2,4,2,2012-03-22 18:09:22,2012-03-22 18:09:22
ce7113ccbe5047baeb317c4b854ec119f8b5b460...b3d0d8552a659137e8b5d6d5c056f757c50ced44,1,1,0,1,1,2012-03-23 02:31:12,2012-03-23 02:31:12
b3d0d8552a659137e8b5d6d5c056f757c50ced44...ae1b7e9699a7ff2e5359fb414d235ac04a631abb,1,1,1,2,1,2012-03-23 02:31:29,2012-03-23 02:31:29
ae1b7e9699a7ff2e5359fb414d235ac04a631abb...1fe7155823d592768c4cabdc94659250ea9609ba,140,5566,4087,9653,3916,2012-03-23 02:35:22,2012-03-23 02:35:22
1fe7155823d592768c4cabdc94659250ea9609ba...45a5bd8b9ba20bd2bb5b754e819ba06e57df9bfd,280,2271,2190,4461,2195,2012-03-23 02:41:04,2012-03-23 02:41:04
45a5bd8b9ba20bd2bb5b754e819ba06e57df9bfd...4cf8f40f910b718104ff0c5177ee40deed6acb5f,140,138,129,267,120,2012-03-23 02:44:50,2012-03-23 02:44:50
4cf8f40f910b718104ff0c5177ee40deed6acb5f...ab0617b69b70ae922fba52ab5905809b12ce8185,140,1607,1548,3155,1558,2012-03-23 02:48:24,2012-03-23 02:48:24
ab0617b69b70ae922fba52ab5905809b12ce8185...565fad7693f7cc757f068627e1b38358fd53bb2f,140,79,74,153,72,2012-03-23 02:52:11,2012-03-23 02:52:11
565fad7693f7cc757f068627e1b38358fd53bb2f...987eecb02d52ef76563a336cda619bbc49e4a0f5,140,131,119,250,108,2012-03-23 02:56:00,2012-03-23 02:56:00
987eecb02d52ef76563a336cda619bbc49e4a0f5...122086032b35e8f97659542e8afef38474a2c7d2,140,112,106,218,95,2012-03-23 02:59:34,2012-03-23 02:59:34
122086032b35e8f97659542e8afef38474a2c7d2...32734ca27d8f4d8b8e6a0bd675dc672a61153daf,140,110,101,211,94,2012-03-23 03:03:11,2012-03-23 03:03:11
32734ca27d8f4d8b8e6a0bd675dc672a61153daf...5370b94d413d4eab2779ec6adc3c634bcb6d977a,140,154,141,295,131,2012-03-23 03:06:20,2012-03-23 03:06:20
5370b94d413d4eab2779ec6adc3c634bcb6d977a...6017c9fd2d1cf97ffab193ddbd04c26d7544b95d,140,477,468,945,228,2012-03-23 03:09:42,2012-03-23 03:09:42
6017c9fd2d1cf97ffab193ddbd04c26d7544b95d...6e76389c22070a5e1be4f64bcb419bb227124422,140,1617,1579,3196,1601,2012-03-23 03:12:58,2012-03-23 03:12:58
6e76389c22070a5e1be4f64bcb419bb227124422...07f6054cd57c91c897d9283f601443f00aa4aed2,140,76,73,149,71,2012-03-23 03:17:00,2012-03-23 03:17:00
07f6054cd57c91c897d9283f601443f00aa4aed2...c6ba0b54b7041496cc87c5cb30980608523db3cc,140,85,79,164,77,2012-03-23 03:20:36,2012-03-23 03:20:36
c6ba0b54b7041496cc87c5cb30980608523db3cc...5b3721b067782132cbfe932bda9e22fba7b82703,140,76,73,149,71,2012-03-23 03:24:45,2012-03-23 03:24:45
5b3721b067782132cbfe932bda9e22fba7b82703...38061221c341bde559a5935bed3b78468b28d657,140,76,73,149,71,2012-03-23 03:29:30,2012-03-23 03:29:30
38061221c341bde559a5935bed3b78468b28d657...2ca980195653a754a1c4726f5bb253147c6cb329,3,39,7,46,13,2012-03-23 05:31:11,2012-03-23 05:31:11
2ca980195653a754a1c4726f5bb253147c6cb329...46871eb1bb37e0c34f4498e671f6418f9487d69f,2,4,2,6,4,2012-03-23 09:32:11,2012-03-23 09:32:11
46871eb1bb37e0c34f4498e671f6418f9487d69f...f356a2e52fd0c36045b960412196552944a57888,2,6,8,14,2,2012-03-23 16:14:46,2012-03-23 16:14:46
f356a2e52fd0c36045b960412196552944a57888...a033d4992cc651e8dade81c87cc687911e8d63fe,1,190,141,331,9,2012-03-23 16:51:01,2012-03-23 16:51:01
a033d4992cc651e8dade81c87cc687911e8d63fe...2591fb8d4c0246f68b79554976c012039df75359,3,5,5,10,5,2012-03-23 16:53:23,2012-03-23 16:53:23
2591fb8d4c0246f68b79554976c012039df75359...658ca67d9fd01d3f64ade4ea28bce0d14bca2faa,1,1,1,2,1,2012-03-23 16:58:48,2012-03-23 16:58:48
7c08f4c6351f7e53a01ff800d8a61f19ca961b29...81f7a6587f682960811330bb591d08e89439a39f,0,0,0,0,0,2011-03-23 06:01:52,2011-03-23 06:01:52
81f7a6587f682960811330bb591d08e89439a39f...d0052fcc5c47fe38d64f50cf6bdd40c9283dc63a,1,3,3,6,3,2011-03-23 08:52:39,2011-03-23 08:52:39
d0052fcc5c47fe38d64f50cf6bdd40c9283dc63a...258957f4b909b5f893a452ea3a13e82719037cbb,1,1,1,2,1,2011-03-26 13:19:04,2011-03-26 13:19:04
258957f4b909b5f893a452ea3a13e82719037cbb...9b0f1de56693156ce78edf5456dc32e55d7b11e4,1,1,1,2,1,2011-03-27 23:01:47,2011-03-27 23:01:47
9b0f1de56693156ce78edf5456dc32e55d7b11e4...ce9b216882ea11bf351f222513458bc503556a91,2,67,3,70,5,2011-03-28 16:15:43,2011-03-28 16:15:43
ce9b216882ea11bf351f222513458bc503556a91...d935b232a26a8094a92fa2c56cd8b0dc5de42f23,2,2,2,4,2,2011-03-29 10:25:18,2011-03-29 10:25:18
d935b232a26a8094a92fa2c56cd8b0dc5de42f23...032beb11da915c612831bb68ddc99bcf153169e4,3,25,6,31,9,2011-03-30 18:49:42,2011-03-30 18:49:42
032beb11da915c612831bb68ddc99bcf153169e4...e37fae7fb95238af00fee5b1087b01134ed391aa,1,1,0,1,1,2011-03-30 19:26:11,2011-03-30 19:26:11
e37fae7fb95238af00fee5b1087b01134ed391aa...6bf0fe6c4e134521c4f8762c796083f8eb6f4b5c,1,0,0,0,0,2011-03-31 08:35:20,2011-03-31 08:35:20
6bf0fe6c4e134521c4f8762c796083f8eb6f4b5c...e6fe336f10d461b84989a88786a8fd0bfb489a3e,1,14,10,24,6,2011-03-31 23:20:55,2011-03-31 23:20:55
e6fe336f10d461b84989a88786a8fd0bfb489a3e...686ef6c7596ca1fcfde01212ca3ebcdeb9378e74,2,45,0,45,2,2011-04-02 08:50:05,2011-04-02 08:50:05
686ef6c7596ca1fcfde01212ca3ebcdeb9378e74...e5aa2bdcecf52b99ddbaa82ae98d557721d8ae61,1,1,1,2,1,2011-04-03 00:11:29,2011-04-03 00:11:29
e5aa2bdcecf52b99ddbaa82ae98d557721d8ae61...05054aba7684c8d5b2bbe4ea0e2aee24ae7deba2,1,7,5,12,2,2011-04-03 23:09:39,2011-04-03 23:09:39
05054aba7684c8d5b2bbe4ea0e2aee24ae7deba2...79bb9c145620ad6b4b424e2390c6e0b6905c122b,1,8,0,8,1,2011-04-16 18:43:01,2011-04-16 18:43:01
79bb9c145620ad6b4b424e2390c6e0b6905c122b...cdd75e078ab548a3690113b3bdaeda47decba92a,1,6,5,11,1,2011-04-17 04:12:01,2011-04-17 04:12:01
cdd75e078ab548a3690113b3bdaeda47decba92a...9b21a0c92132f5b5c9c8ca33fba88c1eab2f2933,1,7,7,14,2,2011-04-17 14:27:53,2011-04-17 14:27:53
9b21a0c92132f5b5c9c8ca33fba88c1eab2f2933...1d499d50d08f8b36aed9e008dadfc26e4fe1b208,3,14,3,17,6,2011-04-18 21:10:42,2011-04-18 21:10:42
1d499d50d08f8b36aed9e008dadfc26e4fe1b208...b061cb97be8254f7b0f816cd10db0bf811f9509e,1,1,1,2,1,2011-04-18 23:20:07,2011-04-18 23:20:07
b061cb97be8254f7b0f816cd10db0bf811f9509e...24adaf76f14bb32fcd2389b0339fd9cfc2cc98c2,2,16,2,18,4,2011-04-20 19:51:54,2011-04-20 19:51:54
24adaf76f14bb32fcd2389b0339fd9cfc2cc98c2...64995cdd63e01b6bf5372cec76c3fe1d2a3cff62,1,2,5,7,1,2011-04-20 20:04:46,2011-04-20 20:04:46
64995cdd63e01b6bf5372cec76c3fe1d2a3cff62...53678ef5083a20955e3f0192bbe9005cc7abbded,1,4,3,7,1,2011-04-21 17:43:22,2011-04-21 17:43:22
53678ef5083a20955e3f0192bbe9005cc7abbded...4d62386cad7f50ae13e0af6b5856e2a12fff313b,3,39,1,40,10,2011-04-22 12:06:11,2011-04-22 12:06:11
4d62386cad7f50ae13e0af6b5856e2a12fff313b...e87c9da4374389f5189637803819110593556196,3,10,3,13,5,2011-04-22 12:21:58,2011-04-22 12:21:58
e87c9da4374389f5189637803819110593556196...5977193c018c1aff38cc3f8139798b027742550a,1,5,11,16,3,2011-04-22 12:28:58,2011-04-22 12:28:58
5977193c018c1aff38cc3f8139798b027742550a...9269b606ba96d68c3b6be843539bfa6f443c72dc,3,88,20,108,10,2011-04-22 21:05:29,2011-04-22 21:05:29
9269b606ba96d68c3b6be843539bfa6f443c72dc...fe2713dd5ec2d659cfcb0da79979638ddee9deb7,1,1,1,2,1,2011-04-22 21:25:16,2011-04-22 21:25:16
fe2713dd5ec2d659cfcb0da79979638ddee9deb7...6a3d91828fd6959e8a3e6d944754bad37480bfee,2,80,18,98,16,2011-04-23 04:40:06,2011-04-23 04:40:06
6a3d91828fd6959e8a3e6d944754bad37480bfee...f53fe1e79eef77837c07670286a5157074f6fcf9,1,1,1,2,1,2011-04-23 21:49:22,2011-04-23 21:49:22
f53fe1e79eef77837c07670286a5157074f6fcf9...44dbac6482223d28509f4d8002d8e7bc9138ca1f,1,6,6,12,6,2011-04-24 23:47:36,2011-04-24 23:47:36
44dbac6482223d28509f4d8002d8e7bc9138ca1f...637cf5de3a5f6666b6d4527b7dcb0c76dd5e0595,1,11,0,11,1,2011-04-28 00:23:42,2011-04-28 00:23:42
637cf5de3a5f6666b6d4527b7dcb0c76dd5e0595...5aeeafba26e413eb36bca5a73240ce45ae4ca46f,1,1,1,2,1,2011-04-28 01:47:21,2011-04-28 01:47:21
5aeeafba26e413eb36bca5a73240ce45ae4ca46f...0e9e0f0b21b667ec3d2889f7912d6a49dab102ea,1,3,3,6,3,2011-04-30 02:48:56,2011-04-30 02:48:56
0e9e0f0b21b667ec3d2889f7912d6a49dab102ea...c05dd20fa5896ac9e983415a60ce13fb0f028dc0,1,4,0,4,1,2011-04-30 13:02:47,2011-04-30 13:02:47
c05dd20fa5896ac9e983415a60ce13fb0f028dc0...b44757ce5187fd7019593b838adfd81dfd401b1d,1,23,19,42,2,2011-04-30 13:37:53,2011-04-30 13:37:53
b44757ce5187fd7019593b838adfd81dfd401b1d...fa261ea432c606d58dfcb09dde50fb89b43f8dcb,1,3,2,5,1,2011-05-01 20:11:04,2011-05-01 20:11:04
fa261ea432c606d58dfcb09dde50fb89b43f8dcb...53354f80f679f3b52fc51832eca580a6c6211917,1,1,1,2,1,2011-05-03 10:25:50,2011-05-03 10:25:50
53354f80f679f3b52fc51832eca580a6c6211917...64e625b6a15da6848bda75941e2a5d8e781ac889,1,2,2,4,1,2011-05-04 23:44:54,2011-05-04 23:44:54
64e625b6a15da6848bda75941e2a5d8e781ac889...d06531d3f01347f51c494b6275b89ff4607037b3,1,2,2,4,2,2011-05-05 23:12:55,2011-05-05 23:12:55
d06531d3f01347f51c494b6275b89ff4607037b3...b3a46135955d0f1d3e3d39185ef977996c8cce9a,1,14,3,17,2,2011-05-09 15:45:10,2011-05-09 15:45:10
b3a46135955d0f1d3e3d39185ef977996c8cce9a...fb052a15edbaf81a60c1d64b6088f2d4bdeec926,1,5,1,6,1,2011-05-09 21:37:52,2011-05-09 21:37:52
fb052a15edbaf81a60c1d64b6088f2d4bdeec926...af1943f1394d2f59ab433cb1170a7d22d7743665,1,1,1,2,1,2011-05-09 22:31:07,2011-05-09 22:31:07
af1943f1394d2f59ab433cb1170a7d22d7743665...fda65ffea57bf6f15a94f37c4ab74352f679e282,1,1,1,2,1,2011-05-09 23:47:50,2011-05-09 23:47:50
fda65ffea57bf6f15a94f37c4ab74352f679e282...4cb2b53c222a8b02941d7bd32f012e62c1acd94f,1,8,7,15,2,2011-05-10 00:20:21,2011-05-10 00:20:21
4cb2b53c222a8b02941d7bd32f012e62c1acd94f...7fd113e6184c1602e4ad6d6d7a92c78a158e78ff,1,20,3,23,1,2011-05-10 00:28:05,2011-05-10 00:28:05
7fd113e6184c1602e4ad6d6d7a92c78a158e78ff...5c08cda6113cf65ca489385bdbece43cd8b1913c,2,15,1,16,2,2011-05-10 12:28:29,2011-05-10 12:28:29
5c08cda6113cf65ca489385bdbece43cd8b1913c...9a4e5112b2384f1ec1db837b41d1ce9792143754,1,12,2,14,2,2011-05-11 21:30:05,2011-05-11 21:30:05
9a4e5112b2384f1ec1db837b41d1ce9792143754...fc391631779f2e4cd35b4eb6e03505b63e9ba7f7,1,1,1,2,1,2011-05-13 00:49:26,2011-05-13 00:49:26
fc391631779f2e4cd35b4eb6e03505b63e9ba7f7...8385b31c8989e7f44d545b58a3904bdfd86ac8e8,23,34,34,68,34,2011-05-13 04:39:49,2011-05-13 04:39:49
8385b31c8989e7f44d545b58a3904bdfd86ac8e8...5be8fdb03e9912516614f0b4c5f8b51003c1b771,1,25,0,25,1,2011-05-15 19:12:29,2011-05-15 19:12:29
5be8fdb03e9912516614f0b4c5f8b51003c1b771...e1dfa95cd1619ac02cc010c3d3b1ab6b6ad85063,2,58,52,110,24,2011-05-18 09:52:44,2011-05-18 09:52:44
e1dfa95cd1619ac02cc010c3d3b1ab6b6ad85063...49f4a28cce1a3325c6c0182005cc7daf2959bc82,1,4,4,8,2,2011-05-18 20:12:15,2011-05-18 20:12:15
49f4a28cce1a3325c6c0182005cc7daf2959bc82...d12ac6d048e52a253f0efd5bad94377807f3343c,1,2,2,4,2,2011-05-18 20:35:32,2011-05-18 20:35:32
d12ac6d048e52a253f0efd5bad94377807f3343c...770b91ca7bef42c29481320b4276ad7f38bdf87f,1,2,2,4,2,2011-05-19 02:51:39,2011-05-19 02:51:39
770b91ca7bef42c29481320b4276ad7f38bdf87f...be776521dbe535497223b314c4d58874f1ae6992,1,65,55,120,35,2011-05-20 00:52:36,2011-05-20 00:52:36
be776521dbe535497223b314c4d58874f1ae6992...b5c6b4f1d4603eee15bd426a5c5b0594c4d2e4f7,1,27,22,49,11,2011-05-20 01:48:41,2011-05-20 01:48:41
b5c6b4f1d4603eee15bd426a5c5b0594c4d2e4f7...08f5ac3d51c2e4b9ddf28a1bae640c1970decd8c,2,16,16,32,12,2011-05-22 00:08:40,2011-05-22 00:08:40
08f5ac3d51c2e4b9ddf28a1bae640c1970decd8c...2c3d3400ef5abfd6be15276d4b5d584319ccecc3,1,1,1,2,1,2011-05-22 00:13:08,2011-05-22 00:13:08
2c3d3400ef5abfd6be15276d4b5d584319ccecc3...82b9fed1c7a9faf7c9cc8de70aae45e9c66f05e5,1,3,1,4,2,2011-05-22 16:44:14,2011-05-22 16:44:14
82b9fed1c7a9faf7c9cc8de70aae45e9c66f05e5...b9bdc96f9ea8e4d572a79471c68ec239136a4d01,1,1,1,2,1,2011-05-22 17:00:23,2011-05-22 17:00:23
b9bdc96f9ea8e4d572a79471c68ec239136a4d01...18ecfad76785746b14e441d7379fc3b086da8d7a,1,4,5,9,3,2011-05-23 01:54:37,2011-05-23 01:54:37
18ecfad76785746b14e441d7379fc3b086da8d7a...afa092853fb0fde4abc172f7867121074f260618,4,23,30,53,7,2011-05-25 17:31:36,2011-05-25 17:31:36
afa092853fb0fde4abc172f7867121074f260618...7f3eda2f76ea41e938cf623030f3a68e573d5017,5,88,7,95,8,2011-05-25 17:31:47,2011-05-25 17:31:47
7f3eda2f76ea41e938cf623030f3a68e573d5017...879267f254946a26ebc179f3880e14a59e11e038,31,215,199,414,127,2011-05-29 17:50:52,2011-05-29 17:50:52
879267f254946a26ebc179f3880e14a59e11e038...4124ef339c2827d1a337c1b7d58fa50676349412,1,1,1,2,1,2011-05-30 12:11:46,2011-05-30 12:11:46
4124ef339c2827d1a337c1b7d58fa50676349412...6e87dacf62e742b78787659b9a51561fd5465682,3,28,4,32,5,2011-05-30 16:19:53,2011-05-30 16:19:53
6e87dacf62e742b78787659b9a51561fd5465682...d2abec535e33ee781a6d8909840b88048d034970,2,2,2,4,2,2011-05-31 09:44:18,2011-05-31 09:44:18
d2abec535e33ee781a6d8909840b88048d034970...9f71bef7e993e3a12d36700fafff62d294b8f250,2,2,2,4,2,2011-05-31 09:44:21,2011-05-31 09:44:21
9f71bef7e993e3a12d36700fafff62d294b8f250...0e90de0a15de6308da07877bc482c07feb866442,1,24,1,25,4,2011-06-02 12:20:11,2011-06-02 12:20:11
0e90de0a15de6308da07877bc482c07feb866442...f578563291ba2f2112d99d138e1ca8cbdeec4eea,1,3,3,6,1,2011-06-04 14:39:16,2011-06-04 14:39:16
f578563291ba2f2112d99d138e1ca8cbdeec4eea...c1baaa8c8799750f66d84d9ab35ce332596107ea,1,7,1,8,3,2011-06-04 15:31:41,2011-06-04 15:31:41
c1baaa8c8799750f66d84d9ab35ce332596107ea...a5b44ed873e4a12eb958033859a52af43f691f85,1,6,5,11,3,2011-06-10 16:19:56,2011-06-10 16:19:56
a5b44ed873e4a12eb958033859a52af43f691f85...1b51aa74b80d60ae3460e5fb29efbbdc3464c365,1,2,2,4,2,2011-06-11 09:35:36,2011-06-11 09:35:36
1b51aa74b80d60ae3460e5fb29efbbdc3464c365...5d71bec5e46d1b4953327ff505a575f268c655b2,1,3,1,4,1,2011-06-11 23:41:28,2011-06-11 23:41:28
5d71bec5e46d1b4953327ff505a575f268c655b2...4f215cfcd78f4f46d8ca7fe541c6f47e6201a789,1,2,2,4,1,2011-06-12 00:26:43,2011-06-12 00:26:43
4f215cfcd78f4f46d8ca7fe541c6f47e6201a789...eb96665b7a176224d7287e50cd710708cb24d6ef,2,105,63,168,25,2011-06-15 10:50:08,2011-06-15 10:50:08
eb96665b7a176224d7287e50cd710708cb24d6ef...25ee9b49139eec49ac2a44439f86fc1006e88a58,1,2,2,4,2,2011-06-16 15:28:12,2011-06-16 15:28:12
25ee9b49139eec49ac2a44439f86fc1006e88a58...7880d999005170745040d1725ab0d8899235a794,2,22,14,36,2,2011-06-16 16:42:54,2011-06-16 16:42:54
7880d999005170745040d1725ab0d8899235a794...d90bd88d734b1327661c0718601ec22708520aa6,2,1,2,3,2,2011-06-18 12:01:10,2011-06-18 12:01:10
d90bd88d734b1327661c0718601ec22708520aa6...a0285bb612a607d1af6a6a5afdf7205434a4ec7a,1,1,1,2,1,2011-06-19 19:40:50,2011-06-19 19:40:50
a0285bb612a607d1af6a6a5afdf7205434a4ec7a...d8ef686e2451c86e327af6a665e24b3a157d90b6,1,4,3,7,2,2011-06-26 21:29:13,2011-06-26 21:29:13
d8ef686e2451c86e327af6a665e24b3a157d90b6...a441032e0e5363f2151ccfe95150fb29c6907579,1,1,1,2,1,2011-06-29 16:40:31,2011-06-29 16:40:31
a441032e0e5363f2151ccfe95150fb29c6907579...5a0787f904945e2d1b18b65389b6f76a98b36bf5,4,52,44,96,23,2011-07-01 15:19:34,2011-07-01 15:19:34
5a0787f904945e2d1b18b65389b6f76a98b36bf5...00886dfd2bb20f5119ecb77e295fbe40b15f6901,1,1,1,2,1,2011-07-10 21:33:42,2011-07-10 21:33:42
00886dfd2bb20f5119ecb77e295fbe40b15f6901...c828cc1ba62d9a4ebc144a081fff44c60d339e3a,1,5,2,7,3,2011-07-10 21:40:14,2011-07-10 21:40:14
c828cc1ba62d9a4ebc144a081fff44c60d339e3a...220ce42333b8bff16b4b0b434cfc2570dcce9985,1,18,0,18,2,2011-07-10 21:52:50,2011-07-10 21:52:50
220ce42333b8bff16b4b0b434cfc2570dcce9985...a925b3780e09986131059b7a12f78e968267e0fa,2,0,24,24,5,2011-07-14 00:27:55,2011-07-14 00:27:55
a925b3780e09986131059b7a12f78e968267e0fa...2a1874521e92d569d9daf88567247bfbf0fcfc25,1,5,0,5,1,2011-07-14 19:40:30,2011-07-14 19:40:30
2a1874521e92d569d9daf88567247bfbf0fcfc25...41e086cfb5c25901b39e7d0e387ca0a5425868f9,1,9,0,9,1,2011-07-28 22:10:27,2011-07-28 22:10:27
41e086cfb5c25901b39e7d0e387ca0a5425868f9...c0fa1965e2f45e1b56377216cac3b8154c430496,2,4,4,8,2,2011-07-29 09:48:05,2011-07-29 09:48:05
c0fa1965e2f45e1b56377216cac3b8154c430496...1959aa939da799dea339014721a109d28c52ae2d,1,1,1,2,1,2011-08-06 18:41:00,2011-08-06 18:41:00
1959aa939da799dea339014721a109d28c52ae2d...fe96e20a3e8da374a1207caf9886b25b32bbbd26,1,1,1,2,1,2011-08-06 18:50:19,2011-08-06 18:50:19
fe96e20a3e8da374a1207caf9886b25b32bbbd26...4217f358c0b2765ec1824d994c5926ad7ad26a10,1,1,1,2,1,2011-08-06 18:54:40,2011-08-06 18:54:40
4217f358c0b2765ec1824d994c5926ad7ad26a10...199f10f9c09c5e5073c2e3a3a03f4a66d5c36855,1,2,0,2,1,2011-08-06 19:02:56,2011-08-06 19:02:56
199f10f9c09c5e5073c2e3a3a03f4a66d5c36855...3e5fc7ebb1ebbaa2d6815b8e5b98d8c845012bca,1,6,6,12,2,2011-08-06 20:34:19,2011-08-06 20:34:19
3e5fc7ebb1ebbaa2d6815b8e5b98d8c845012bca...329d80faabc05ef896337b2f7bebbd60100a03cd,1,4,0,4,1,2011-08-20 19:23:16,2011-08-20 19:23:16
329d80faabc05ef896337b2f7bebbd60100a03cd...6f9d250698b55a021c67bd3c9e22c70fd52846f4,1,1,1,2,1,2011-08-20 19:28:25,2011-08-20 19:28:25
6f9d250698b55a021c67bd3c9e22c70fd52846f4...e71d0133bdd86b4d2941b4c6501fc37e1aecdee5,1,7,2,9,1,2011-08-23 05:59:54,2011-08-23 05:59:54
e71d0133bdd86b4d2941b4c6501fc37e1aecdee5...a7ec5c433c5545edea8ca4b9ef5240990bb1fd04,1,2,2,4,2,2011-08-23 06:00:08,2011-08-23 06:00:08
a7ec5c433c5545edea8ca4b9ef5240990bb1fd04...671483f37b0e356023828cd98433777b53d95a33,2,65,19,84,16,2011-08-23 15:54:45,2011-08-23 15:54:45
671483f37b0e356023828cd98433777b53d95a33...e9a1c03dba16755697a4ee8969dc38a4a883565a,2,32,24,56,11,2011-08-23 15:55:22,2011-08-23 15:55:22
e9a1c03dba16755697a4ee8969dc38a4a883565a...3e7d79b6ace41587ce4a63f688caa34447f4aef6,3,55,1,56,5,2011-08-23 15:55:48,2011-08-23 15:55:48
3e7d79b6ace41587ce4a63f688caa34447f4aef6...38530700bfa1bbee900d1a87811acf74305a0040,6,372,390,762,9,2011-08-23 15:56:18,2011-08-23 15:56:18
38530700bfa1bbee900d1a87811acf74305a0040...f317bd20d762616ad5cf502c59eb55835a75056a,2,13,2,15,4,2011-08-23 15:56:40,2011-08-23 15:56:40
f317bd20d762616ad5cf502c59eb55835a75056a...e2d7a784c8aa56883a84ba536bc4ba4803fcb94e,2,27,1,28,3,2011-08-23 15:57:01,2011-08-23 15:57:01
e2d7a784c8aa56883a84ba536bc4ba4803fcb94e...8b42dfa47e448ed4d6755b32425b1c33821f5776,1,28,15,43,5,2011-08-23 15:57:19,2011-08-23 15:57:19
8b42dfa47e448ed4d6755b32425b1c33821f5776...71836f4c7693ac90b9cc38bbc575a55b9f74713e,1,6,0,6,1,2011-08-25 08:13:28,2011-08-25 08:13:28
71836f4c7693ac90b9cc38bbc575a55b9f74713e...1f7c6c011a54583237c9f7d9bfcee77faec73e1f,1,1,1,2,1,2011-09-09 21:43:11,2011-09-09 21:43:11
1f7c6c011a54583237c9f7d9bfcee77faec73e1f...52279a41137e13ab0056728a730b5d6ecf132841,7,94,14,108,21,2011-09-09 22:50:03,2011-09-09 22:50:03
52279a41137e13ab0056728a730b5d6ecf132841...afe47636f7dbbd18a79148c3c5d14e897a7d66dc,1,4,4,8,4,2011-09-09 23:27:31,2011-09-09 23:27:31
afe47636f7dbbd18a79148c3c5d14e897a7d66dc...2f7fadc38efa58ac0a8f93f936b82332a199f396,5,112,5,117,7,2011-09-10 01:07:50,2011-09-10 01:07:50
2f7fadc38efa58ac0a8f93f936b82332a199f396...fbe2eead2fa9d808658ca582241bcacb02618840,2,15,9,24,11,2011-09-10 01:08:02,2011-09-10 01:08:02
fbe2eead2fa9d808658ca582241bcacb02618840...1a76dbefdfc60e2d5954c0ba614c3d054ba9c3f0,10,87,57,144,25,2011-09-10 01:08:24,2011-09-10 01:08:24
1a76dbefdfc60e2d5954c0ba614c3d054ba9c3f0...722d4068a7e798f65b01d0d60676f7e8eff8703b,2,2,2,4,2,2011-09-10 01:32:14,2011-09-10 01:32:14
722d4068a7e798f65b01d0d60676f7e8eff8703b...5e451b9e6f201d6e29256555c148be0847a42b3d,1,1,1,2,1,2011-09-10 01:34:55,2011-09-10 01:34:55
5e451b9e6f201d6e29256555c148be0847a42b3d...2954c36ff7631a0e0180a6f8aa112fe782294d2e,3,41,21,62,6,2011-09-11 04:06:29,2011-09-11 04:06:29
2954c36ff7631a0e0180a6f8aa112fe782294d2e...0326e2e61138f8495a4b863d6960e7666c054944,1,4,2,6,1,2011-09-11 05:32:14,2011-09-11 05:32:14
0326e2e61138f8495a4b863d6960e7666c054944...f242c02fb97254715cf929d011851e4469d1fcfe,1,24,0,24,1,2011-09-11 05:38:50,2011-09-11 05:38:50
f242c02fb97254715cf929d011851e4469d1fcfe...16787c690396d5ce4d24070bd910e23ba6559c84,2,8,8,16,5,2011-09-11 05:45:26,2011-09-11 05:45:26
16787c690396d5ce4d24070bd910e23ba6559c84...460150975c2ef7ff8ab087682bc30ac462a7e935,1,7,4,11,2,2011-09-11 05:48:39,2011-09-11 05:48:39
460150975c2ef7ff8ab087682bc30ac462a7e935...2c8e45e1f4a85691cb6349b37d4340ab8e33b023,1,4,3,7,1,2011-09-11 05:58:34,2011-09-11 05:58:34
2c8e45e1f4a85691cb6349b37d4340ab8e33b023...70a69017751cc26c33f4a1de295fbd24e7545e3c,3,34,0,34,4,2011-09-14 20:33:42,2011-09-14 20:33:42
70a69017751cc26c33f4a1de295fbd24e7545e3c...ee23919a8af3f046b7579cc3f477cad48510acb9,2,17,0,17,2,2011-09-14 20:33:55,2011-09-14 20:33:55
ee23919a8af3f046b7579cc3f477cad48510acb9...27c8d612800e7b6adadc7b112bb1619934cd799e,1,0,6,6,1,2011-09-16 06:26:22,2011-09-16 06:26:22
27c8d612800e7b6adadc7b112bb1619934cd799e...c9676d035fa885734abc7f539c1392b64db5fc9b,1,1,1,2,1,2011-09-16 10:57:53,2011-09-16 10:57:53
c9676d035fa885734abc7f539c1392b64db5fc9b...ae51b46d1904ac14c3c67e440db9ae3506f300ec,6,34,37,71,9,2011-09-17 18:08:28,2011-09-17 18:08:28
ae51b46d1904ac14c3c67e440db9ae3506f300ec...add0628528d12e63cca0e9603bbcd93315ee142f,1,13,2,15,2,2011-09-21 01:37:17,2011-09-21 01:37:17
add0628528d12e63cca0e9603bbcd93315ee142f...3606f1f7b2eb422a49944824b1d8dbc227dc879f,1,4,0,4,1,2011-09-21 22:45:25,2011-09-21 22:45:25
3606f1f7b2eb422a49944824b1d8dbc227dc879f...65942eb31f448f6ac1cc16b8ff29b18253fa103d,3,9,19,28,5,2011-09-21 22:58:15,2011-09-21 22:58:15
65942eb31f448f6ac1cc16b8ff29b18253fa103d...5978d7a341aaa7d2adb8579e65c5028de0271f26,1,1,1,2,1,2011-09-22 00:58:42,2011-09-22 00:58:42
5978d7a341aaa7d2adb8579e65c5028de0271f26...2a4aa8bcf7be28bac9d5ed6a029c2c3f52f389e7,2,11,8,19,8,2011-09-22 05:36:57,2011-09-22 05:36:57
2a4aa8bcf7be28bac9d5ed6a029c2c3f52f389e7...35e807c4a5fb5bb4d72ede54c92d7359a19c3370,1,6,2,8,2,2011-09-22 05:39:07,2011-09-22 05:39:07
35e807c4a5fb5bb4d72ede54c92d7359a19c3370...4443c6fd72ce9504d6736d03fd68948106deabbc,1,1,1,2,1,2011-09-22 05:40:54,2011-09-22 05:40:54
4443c6fd72ce9504d6736d03fd68948106deabbc...ed156a44caed412d5852912bfc7e93357e9452b9,1,17,7,24,2,2011-09-22 05:48:42,2011-09-22 05:48:42
ed156a44caed412d5852912bfc7e93357e9452b9...e3bc2590816b684bc44ce8516b3786a5027cc384,2,8,11,19,8,2011-09-22 22:55:47,2011-09-22 22:55:47
e3bc2590816b684bc44ce8516b3786a5027cc384...a084a07ebe8357c5a05ad03c478c89c2e358a398,1,2,2,4,1,2011-09-22 23:02:57,2011-09-22 23:02:57
a084a07ebe8357c5a05ad03c478c89c2e358a398...07c404be88c658698b89258e88d61b9af0366eaf,1,1,1,2,1,2011-10-18 18:09:23,2011-10-18 18:09:23
07c404be88c658698b89258e88d61b9af0366eaf...6372368b563404ad2011ef12bf65ec9fce6a59dc,2,2,2,4,2,2011-10-27 16:10:08,2011-10-27 16:10:08
6372368b563404ad2011ef12bf65ec9fce6a59dc...eabbb361d2ff4f40898a2891a74ff8a84c03d712,3,43,43,86,20,2011-11-06 16:59:26,2011-11-06 16:59:26
eabbb361d2ff4f40898a2891a74ff8a84c03d712...bf5fdf1397c48e3a56819d4d8bf20b54d1cb377b,5,5,5,10,5,2011-11-19 22:57:47,2011-11-19 22:57:47
bf5fdf1397c48e3a56819d4d8bf20b54d1cb377b...68f37a908162ac54cf90c50da6e4f4515ad7bf93,2,9,3,12,3,2011-12-03 21:17:41,2011-12-03 21:17:41
68f37a908162ac54cf90c50da6e4f4515ad7bf93...b5853cf043fe22277e5aff7648b5b1a74b778255,2,50,1,51,3,2011-12-11 10:09:15,2011-12-11 10:09:15
b5853cf043fe22277e5aff7648b5b1a74b778255...c9ab2bfb39c03883623dbd858791b39690391900,2,15,24,39,9,2011-12-30 12:29:47,2011-12-30 12:29:47
c9ab2bfb39c03883623dbd858791b39690391900...7b9016e5a229c2269d758959e4d07a0dbe4e710f,1,10,0,10,2,2011-12-30 15:31:09,2011-12-30 15:31:09
7b9016e5a229c2269d758959e4d07a0dbe4e710f...580389c588ade9709f54c1494c5af6747011f043,1,6,0,6,1,2011-12-31 00:43:31,2011-12-31 00:43:31
580389c588ade9709f54c1494c5af6747011f043...7bee6b451afd80f98aa8c720ec2d61177f0674b5,1,7,0,7,1,2011-12-31 15:30:41,2011-12-31 15:30:41
7bee6b451afd80f98aa8c720ec2d61177f0674b5...79248a7e0a3918c1ed934601f6c295521c346b03,1,1,1,2,1,2011-12-31 15:35:04,2011-12-31 15:35:04
79248a7e0a3918c1ed934601f6c295521c346b03...ca141051286c116cbbced71eb26a323d30c8a0ca,2,10,4,14,2,2012-01-04 18:35:45,2012-01-04 18:35:45
ca141051286c116cbbced71eb26a323d30c8a0ca...a9789c0d444869dd4cfe0ba7e17b5d404b81ac6b,2,22,4,26,5,2012-01-07 09:05:36,2012-01-07 09:05:36
a9789c0d444869dd4cfe0ba7e17b5d404b81ac6b...9e124926167e2565ab64976bd20e131aca330ebd,2,5,1,6,2,2012-01-07 18:48:12,2012-01-07 18:48:12
9e124926167e2565ab64976bd20e131aca330ebd...9bc6119daf03d5f33095f52b5eac1aed1359c775,1,8,18,26,3,2012-01-12 22:17:22,2012-01-12 22:17:22
9bc6119daf03d5f33095f52b5eac1aed1359c775...2b793b1a3580a318ba8a505f8a70942bf849de25,1,2,3,5,1,2012-01-19 17:39:59,2012-01-19 17:39:59
2b793b1a3580a318ba8a505f8a70942bf849de25...405a0ba9de87a506a84a6f52590f6914518e0cce,2,2,2,4,2,2012-01-21 15:48:08,2012-01-21 15:48:08
405a0ba9de87a506a84a6f52590f6914518e0cce...0d7431774f9b4b7db2062911515d531e6b0f0093,1,1,1,2,1,2012-01-22 18:53:41,2012-01-22 18:53:41
0d7431774f9b4b7db2062911515d531e6b0f0093...723f995658c4c661a1a2660af48097f1a7dd88ad,1,6,0,6,1,2012-01-25 14:33:15,2012-01-25 14:33:15
723f995658c4c661a1a2660af48097f1a7dd88ad...33f9ba7ba023359db035c7008703bf0723ef2f44,4,14,15,29,8,2012-01-26 15:00:57,2012-01-26 15:00:57
33f9ba7ba023359db035c7008703bf0723ef2f44...46c08c8f951d2a5c662cc38f5a61bd22fa417a05,1,2,2,4,2,2012-02-05 15:41:53,2012-02-05 15:41:53
46c08c8f951d2a5c662cc38f5a61bd22fa417a05...a7a703dbdcf5778e97126db9a6ddba1f855c8230,1,1,1,2,1,2012-02-05 15:54:01,2012-02-05 15:54:01
a7a703dbdcf5778e97126db9a6ddba1f855c8230...2646df45374d7c9054adda998e64f3beb6ae6f62,1,22,11,33,8,2012-02-11 02:07:40,2012-02-11 02:07:40
2646df45374d7c9054adda998e64f3beb6ae6f62...f202387e6c807878b4fc80e0efa83a488e157b7a,1,1,1,2,1,2012-02-11 12:47:58,2012-02-11 12:47:58
f202387e6c807878b4fc80e0efa83a488e157b7a...ce9916a2c80b52b327b010c55edb9ae28ccb6b8a,1,7,0,7,1,2012-02-12 17:16:37,2012-02-12 17:16:37
ce9916a2c80b52b327b010c55edb9ae28ccb6b8a...c63a454bb684bee99aa7c13ec441040e5f091c71,1,1,1,2,1,2012-02-14 23:05:23,2012-02-14 23:05:23
c63a454bb684bee99aa7c13ec441040e5f091c71...813dc01cd88e13b4d125cb24061ebb86c7ce3b09,4,35,0,35,5,2012-02-18 10:11:17,2012-02-18 10:11:17
813dc01cd88e13b4d125cb24061ebb86c7ce3b09...5144f72be25b401cd6b37d842b58514cca6a948a,1,2,2,4,2,2012-02-18 21:40:26,2012-02-18 21:40:26
5144f72be25b401cd6b37d842b58514cca6a948a...9729ad7466b25af4ae396d751c1a86541434a221,1,5,3,8,1,2012-02-18 21:51:18,2012-02-18 21:51:18
9729ad7466b25af4ae396d751c1a86541434a221...1addaafa0ad848142b676cd2669db5ddb21735b0,2,13,15,28,2,2012-02-19 07:42:02,2012-02-19 07:42:02
1addaafa0ad848142b676cd2669db5ddb21735b0...2a5a0b8097a35e355b0742cb2c912913581d259a,1,20,14,34,3,2012-02-19 08:00:59,2012-02-19 08:00:59
2a5a0b8097a35e355b0742cb2c912913581d259a...7baee7a03b8f9ec4840942eecb80fcbe1c75b231,1,4,0,4,1,2012-02-19 08:10:20,2012-02-19 08:10:20
7baee7a03b8f9ec4840942eecb80fcbe1c75b231...25b5da2abdebef867f1e38c95f5622df3741d0db,2,29,11,40,5,2012-02-19 09:04:19,2012-02-19 09:04:19
25b5da2abdebef867f1e38c95f5622df3741d0db...4d959686e66feac9871304be80945270ccc3742d,1,6,2,8,3,2012-02-19 09:22:18,2012-02-19 09:22:18
4d959686e66feac9871304be80945270ccc3742d...4f6c36435cb3a083c25c040c278ef89a70810f16,2,12,3,15,2,2012-02-20 18:58:34,2012-02-20 18:58:34
4f6c36435cb3a083c25c040c278ef89a70810f16...0af93e108e3dc5e0216ab45cae2dec86ee750771,1,7,0,7,1,2012-02-20 19:08:56,2012-02-20 19:08:56
0af93e108e3dc5e0216ab45cae2dec86ee750771...b45fbc66670a375b0d6d42ecd160b7c9e9e00dc6,3,13,1,14,3,2012-02-22 00:52:19,2012-02-22 00:52:19
b45fbc66670a375b0d6d42ecd160b7c9e9e00dc6...38715d8af83ba73db6f80c832fe04089f2cc6644,1,3,4,7,2,2012-02-24 22:50:58,2012-02-24 22:50:58
38715d8af83ba73db6f80c832fe04089f2cc6644...c0258f1da754309e25236cded6affb4d2a402238,1,1,1,2,1,2012-02-24 22:54:00,2012-02-24 22:54:00
c0258f1da754309e25236cded6affb4d2a402238...41cd3b2ab121c1a9bf8797d221fd2a7bf0475a17,1,1,1,2,1,2012-02-25 12:55:41,2012-02-25 12:55:41
41cd3b2ab121c1a9bf8797d221fd2a7bf0475a17...dad3e552349a708f32f492ca0cbc398b7b075de7,1,1,1,2,1,2012-03-01 19:34:23,2012-03-01 19:34:23
dad3e552349a708f32f492ca0cbc398b7b075de7...523d6167d6075eb3b9cb3aef71feb940ea0be5a3,2,58,4,62,5,2012-03-01 23:03:46,2012-03-01 23:03:46
523d6167d6075eb3b9cb3aef71feb940ea0be5a3...695187902367882e59136fd3ef6fa9e0363869fa,1,7,10,17,4,2012-03-12 22:13:34,2012-03-12 22:13:34
695187902367882e59136fd3ef6fa9e0363869fa...ddfa89b959a03417fc3eb24738b0cb1049940e5d,1,11,5,16,5,2012-03-13 22:25:10,2012-03-13 22:25:10
ddfa89b959a03417fc3eb24738b0cb1049940e5d...d498033818d2e1b395e303003536462c8690e96e,3,5,5,10,4,2012-03-14 07:48:03,2012-03-14 07:48:03
d498033818d2e1b395e303003536462c8690e96e...1f924cf72d76466a359371267c448d19c4e1352a,3,45,2,47,5,2012-03-14 18:51:20,2012-03-14 18:51:20
1f924cf72d76466a359371267c448d19c4e1352a...2acf028b4b92c4085c04695b83b503d25797a637,1,1,1,2,1,2012-03-15 07:58:19,2012-03-15 07:58:19
2acf028b4b92c4085c04695b83b503d25797a637...838adb231254dfec5b1fd4b7588c2cd9593debc7,1,1,0,1,1,2012-03-16 00:32:42,2012-03-16 00:32:42
838adb231254dfec5b1fd4b7588c2cd9593debc7...2f6b8482f6a1117ac51efec675a7362f9b450349,1,3,3,6,4,2012-03-16 00:38:18,2012-03-16 00:38:18
2f6b8482f6a1117ac51efec675a7362f9b450349...1dd8848bebfcf98ae688984c7686250f7956acb6,1,3,2,5,1,2012-03-16 19:32:13,2012-03-16 19:32:13
1dd8848bebfcf98ae688984c7686250f7956acb6...92929d5ef4ba555e2fedf683e8223ba748963538,1,2,1,3,1,2012-03-17 12:58:16,2012-03-17 12:58:16
92929d5ef4ba555e2fedf683e8223ba748963538...651c0414a8be83785f64db7efd88837f2a0f0ce1,1,3,0,3,2,2012-03-24 07:36:23,2012-03-24 07:36:23
651c0414a8be83785f64db7efd88837f2a0f0ce1...fd2efb35fbb4c031fb52d4b969b0d8118df6a8e2,3,31,12,43,10,2012-03-24 07:43:24,2012-03-24 07:43:24
fd2efb35fbb4c031fb52d4b969b0d8118df6a8e2...8e73302070d69b49c65390d7a8c3c3a367c0b3d9,1,7,1,8,1,2012-03-24 12:26:46,2012-03-24 12:26:46
8e73302070d69b49c65390d7a8c3c3a367c0b3d9...15fb61c62ce403bc2ba7f63c5f519a988ce2c5d2,1,3,1,4,2,2012-03-24 13:56:48,2012-03-24 13:56:48
15fb61c62ce403bc2ba7f63c5f519a988ce2c5d2...0bbe7379ee3e2cb290f9c9e841bb2f1457e14b16,2,15,6,21,9,2012-03-25 06:53:47,2012-03-25 06:53:47
0bbe7379ee3e2cb290f9c9e841bb2f1457e14b16...e293d82c36133d722cf6b5e71c56d92853ceaf00,4,92,10,102,12,2012-03-31 18:42:38,2012-03-31 18:42:38
e293d82c36133d722cf6b5e71c56d92853ceaf00...a15d3b58d8c4cbb6137f0458544ec03f3394bb08,2,20,3,23,4,2012-05-27 19:09:49,2012-05-27 18:51:03
a15d3b58d8c4cbb6137f0458544ec03f3394bb08...7ca10b1dac758924f9bbd219880cc17a537c5e47,2,3,20,23,4,2012-05-28 17:41:39,2012-05-28 17:41:39
7ca10b1dac758924f9bbd219880cc17a537c5e47...9ca0ff6268eeff92d0d0ac2c315d4b6a8e229155,1,6,1,7,3,2012-07-30 19:55:23,2012-07-30 19:55:23
9ca0ff6268eeff92d0d0ac2c315d4b6a8e229155...b2eb4787a0fff9c9993b78be5c698e85108f3446,1,4,14,18,1,2012-07-30 19:58:22,2012-07-30 19:58:22
b2eb4787a0fff9c9993b78be5c698e85108f3446...4dea4883e6c50d75f215a6b9bcbd95273f57c72d,2,29,11,40,8,2012-07-30 20:03:46,2012-07-30 20:03:46
4dea4883e6c50d75f215a6b9bcbd95273f57c72d...0b0c51a09501823433d2051e9b7ac3829d01871e,3,3,3,6,3,2012-07-30 20:54:15,2012-07-30 20:54:15
0b0c51a09501823433d2051e9b7ac3829d01871e...e2ac91735f8acb9d1b792f510ed38e4afcb744b5,1,1,1,2,1,2012-07-30 21:00:55,2012-07-30 21:00:55
e2ac91735f8acb9d1b792f510ed38e4afcb744b5...d0d5dc6cd76f01c8a71b677357ad2f702cb54416,2,3,3,6,2,2012-08-01 09:01:52,2012-08-01 08:56:35
d0d5dc6cd76f01c8a71b677357ad2f702cb54416...c718b4a0369bb2b7333d862037d30662d5f4c19d,3,3,3,6,3,2012-08-01 20:06:44,2012-08-01 20:06:44
c718b4a0369bb2b7333d862037d30662d5f4c19d...b45c377f8f488955e0c7069cad3f3dd21910b071,4,46,1,47,5,2012-10-17 21:43:08,2012-10-17 21:43:08
b45c377f8f488955e0c7069cad3f3dd21910b071...25d23d9846f945a7a0bbd562302e6ccb9ca5a5c1,3,4,4,8,4,2012-10-17 22:25:52,2012-10-17 22:25:52
25d23d9846f945a7a0bbd562302e6ccb9ca5a5c1...6383d2358c1077b16b13eb6e6975d7a200ed7285,1,67,0,67,3,2012-10-18 18:21:54,2012-10-18 18:21:54
6383d2358c1077b16b13eb6e6975d7a200ed7285...1515eb46daa0897ba5ad5f0a2db8969255f1b343,9,163,52,215,33,2012-11-17 22:03:15,2012-11-17 21:00:53
1515eb46daa0897ba5ad5f0a2db8969255f1b343...2da4ace0bc1bc1d79bf43b368cb857f6f0cd6b1b,2,11,4,15,7,2012-12-03 12:11:34,2012-11-27 21:27:14
2da4ace0bc1bc1d79bf43b368cb857f6f0cd6b1b...59a3e26425cfabdb39295085ca6f3d5922bf1ec6,3,4,4,8,4,2012-12-10 21:38:03,2012-12-10 21:38:03
59a3e26425cfabdb39295085ca6f3d5922bf1ec6...6e70f67470d6d4baf87728702886f89ac075b73c,1,3,3,6,3,2012-12-10 22:37:47,2012-12-10 22:34:51
6e70f67470d6d4baf87728702886f89ac075b73c...27cd872e6e36a81d0bb6f5b8765a1705fecfc253,8,191,36,227,30,2013-02-12 10:41:43,2013-02-09 19:25:52
27cd872e6e36a81d0bb6f5b8765a1705fecfc253...d19a27066b2247102e65412aa66917aff0091112,2,108,1,109,6,2013-02-12 11:13:42,2013-02-12 04:54:53
d19a27066b2247102e65412aa66917aff0091112...d3a45e10c8ac8268899999129daa27652ec0da35,2,48,2,50,4,2013-02-12 11:13:42,2013-02-04 23:57:59
d3a45e10c8ac8268899999129daa27652ec0da35...d7094bbce8cb838f3b40f504f198c098ff1cf727,4,88,19,107,13,2013-02-12 11:13:42,2013-02-12 10:22:41
d7094bbce8cb838f3b40f504f198c098ff1cf727...f6f6f87a9832f9bd441f6510a6b233e72771e4f5,1,49,1,50,4,2013-02-19 18:52:19,2013-02-12 22:48:37
f6f6f87a9832f9bd441f6510a6b233e72771e4f5...747d3f0d0390d1eeae28cb74c310c08c8b4fb58c,3,4,4,8,4,2013-02-19 20:18:32,2013-02-19 20:18:32
747d3f0d0390d1eeae28cb74c310c08c8b4fb58c...2378c31430a2b441d23efe98c0af32fe4af0fb53,1,5,6,11,1,2013-02-20 01:23:25,2013-02-20 01:23:25
2378c31430a2b441d23efe98c0af32fe4af0fb53...a6927d821941fa5c25f277479e84e3c32fe005cd,1,1,1,2,1,2013-02-20 01:38:58,2013-02-20 01:38:58
a6927d821941fa5c25f277479e84e3c32fe005cd...a57743c9ff904e8c8a90499d9f92bdbd52ff113a,1,5,0,5,1,2013-02-20 19:28:39,2013-02-20 19:26:54
a57743c9ff904e8c8a90499d9f92bdbd52ff113a...304a5e06287290392f2d654446b97b4f6c685b1c,3,4,4,8,4,2013-02-20 19:52:28,2013-02-20 19:52:28
304a5e06287290392f2d654446b97b4f6c685b1c...956b755d7e62a799ba691d00e02e82065ca6bb6b,1,1,1,2,1,2013-03-28 21:12:13,2013-03-28 21:12:13
956b755d7e62a799ba691d00e02e82065ca6bb6b...7dd37edf6292ad0d24059e7039cabefceca32caa,6,140,0,140,7,2013-08-12 18:26:48,2013-08-12 17:20:58
658ca67d9fd01d3f64ade4ea28bce0d14bca2faa...bbb2595f89c43df03e33283e1bbbbfc38f0697c8,0,0,0,0,0,2012-03-29 06:18:26,2012-03-29 06:18:26
bbb2595f89c43df03e33283e1bbbbfc38f0697c8...a815fd1652f493d1f51b8c585f1919c46a19afa3,1,1,1,2,1,2012-03-29 15:05:31,2012-03-29 15:05:31
a815fd1652f493d1f51b8c585f1919c46a19afa3...ec2119e1940667a56a7b5c62020739def3b5a68e,1,2,2,4,2,2012-03-29 15:07:09,2012-03-29 15:07:09
ec2119e1940667a56a7b5c62020739def3b5a68e...37c0e10e8c2a8630c372d15b36cc4f07b7a2830b,1,1,1,2,1,2012-03-29 15:08:38,2012-03-29 15:08:38
37c0e10e8c2a8630c372d15b36cc4f07b7a2830b...277661c2af8e183e08916c9ca85581a2611d75a4,2,5,6,11,2,2012-03-29 15:09:52,2012-03-29 15:09:52
277661c2af8e183e08916c9ca85581a2611d75a4...6c5933d1753f223f69dab4b2c6665d7628da349c,1,2,1,3,2,2012-03-29 15:11:14,2012-03-29 15:11:14
6c5933d1753f223f69dab4b2c6665d7628da349c...515b3b85ede46f99686e3ea18fabda71acce13b7,1,4,4,8,1,2012-03-29 15:12:43,2012-03-29 15:12:43
515b3b85ede46f99686e3ea18fabda71acce13b7...814385321bead68f7f49aa3c52b79e1cffda79ad,1,2,2,4,2,2012-03-29 15:14:08,2012-03-29 15:14:08
814385321bead68f7f49aa3c52b79e1cffda79ad...35124ae3e22e590f0fd33cac75fc5ba92c0580e9,1,12,4,16,3,2012-03-30 18:03:54,2012-03-30 18:03:54
35124ae3e22e590f0fd33cac75fc5ba92c0580e9...13822974dd063a094d46e4c928fb331a738e1d0b,2,1,27,28,3,2012-03-31 12:12:12,2012-03-31 12:12:12
13822974dd063a094d46e4c928fb331a738e1d0b...aafa73db546683edbaefdd17859f2722349e9373,4,89,9,98,10,2012-03-31 18:46:18,2012-03-31 18:46:18
aafa73db546683edbaefdd17859f2722349e9373...456d4db251ac8b04f10d7f09eb711f5cc9a73e8d,1,4,1,5,2,2012-04-01 17:17:21,2012-04-01 17:17:21
456d4db251ac8b04f10d7f09eb711f5cc9a73e8d...61b13444c50c5f1198b14eb6053c396ec8622ca4,1,1,5,6,1,2012-04-02 19:52:32,2012-04-02 19:52:32
61b13444c50c5f1198b14eb6053c396ec8622ca4...9a3e9c27c277e482908b43692b1f1b200d69fee3,1,1,1,2,1,2012-04-06 18:59:06,2012-04-06 18:59:06
9a3e9c27c277e482908b43692b1f1b200d69fee3...a6ba67ffd1ddaf6835572d5b10fcfbe6532f91de,5,26,26,52,25,2012-04-09 04:32:42,2012-04-09 04:32:42
a6ba67ffd1ddaf6835572d5b10fcfbe6532f91de...8adfdf08de76e1d2ceb2ce073a1ff97d68f94b44,1,1,1,2,1,2012-04-09 10:03:31,2012-04-09 10:03:31
8adfdf08de76e1d2ceb2ce073a1ff97d68f94b44...01dfe35b38b26137165f28b7821c6a6178956bc1,2,8,1,9,5,2012-04-10 06:06:14,2012-04-10 06:06:14
01dfe35b38b26137165f28b7821c6a6178956bc1...8ed9e9074c9841c0e5e6b35d659fdc7c654eea93,1,2,2,4,1,2012-04-10 20:02:56,2012-04-10 20:02:56
8ed9e9074c9841c0e5e6b35d659fdc7c654eea93...ee43524e227c13fc1dcef819fb1a37322b7ba3c9,1,2,2,4,1,2012-04-11 17:20:59,2012-04-11 17:20:59
ee43524e227c13fc1dcef819fb1a37322b7ba3c9...3f77b84489a73fd60949d3e72b6229d82ec16d1b,1,0,2,2,1,2012-04-11 21:27:18,2012-04-11 21:27:18
3f77b84489a73fd60949d3e72b6229d82ec16d1b...2fa8b3f143c37172a9433dcd42a6fe3829280468,1,12,6,18,5,2012-04-13 11:40:44,2012-04-13 11:40:44
2fa8b3f143c37172a9433dcd42a6fe3829280468...64bbf5187c6e56c62ef9028fa72695bbf8b4e14a,1,1,1,2,1,2012-04-16 11:40:25,2012-04-16 11:40:25
64bbf5187c6e56c62ef9028fa72695bbf8b4e14a...143305126b9ec3f6b7771d10f0642ed3f3f6a3bd,1,5,1,6,2,2012-04-20 13:01:04,2012-04-20 13:01:04
143305126b9ec3f6b7771d10f0642ed3f3f6a3bd...839a71b0a586b1c274546ac3ed8e599be8db10b9,1,17,0,17,2,2012-04-21 22:57:32,2012-04-21 22:57:32
839a71b0a586b1c274546ac3ed8e599be8db10b9...521fe472e5dcc48274cc511f8fdf0f1c912402c1,1,8,2,10,3,2012-04-22 17:20:39,2012-04-22 17:20:39
521fe472e5dcc48274cc511f8fdf0f1c912402c1...a3c8201b77002645f86c39f978fe132cb2dbab14,2,11,4,15,4,2012-05-08 21:20:05,2012-04-29 12:25:06
a3c8201b77002645f86c39f978fe132cb2dbab14...ffe620f20332c292ac94f169e23910a39f4e9ae9,1,1,1,2,1,2012-05-10 06:40:39,2012-05-04 06:20:50
ffe620f20332c292ac94f169e23910a39f4e9ae9...35423f6fb1bf6f8dcde657debbe981943474985b,1,6,3,9,3,2012-05-10 16:30:46,2012-05-10 16:29:34
35423f6fb1bf6f8dcde657debbe981943474985b...589af4971e259e7660ede6d0270207c856347c8f,1,1,1,2,1,2012-05-11 18:19:32,2012-05-11 18:15:30
589af4971e259e7660ede6d0270207c856347c8f...6bb85d98b0574aec1aec9fb97c26ce16bc060522,1,8,1,9,1,2012-05-15 07:23:52,2012-05-15 07:18:16
6bb85d98b0574aec1aec9fb97c26ce16bc060522...d3fa8d92ea1b5c2404d5f750bf7efd5461840bf7,1,10,18,28,7,2012-05-16 21:19:09,2012-04-28 03:57:23
d3fa8d92ea1b5c2404d5f750bf7efd5461840bf7...0f69a16785b88d03dc246a652cf348e0f2704e8e,2,20,3,23,4,2012-05-27 18:51:03,2012-05-27 18:51:03
0f69a16785b88d03dc246a652cf348e0f2704e8e...4d2fdd41855e978ec5f3b8a03e8599994d7f5b70,4,104,52,156,23,2012-06-04 06:59:01,2012-06-04 00:33:09
658ca67d9fd01d3f64ade4ea28bce0d14bca2faa...14c42b8e95178b2049a8724f5cae373c55f07c40,1,1,1,2,1,2012-03-23 18:05:31,2012-03-23 18:05:31
14c42b8e95178b2049a8724f5cae373c55f07c40...2577d58e9d484239a524331de06f5c255126e993,1,2,2,4,2,2012-03-23 19:44:52,2012-03-23 19:44:52
2577d58e9d484239a524331de06f5c255126e993...5d4fb5cfea08e15a5211ccb69f45a2d9c83009f4,1,1,1,2,1,2012-03-25 19:04:11,2012-03-25 19:04:11
5d4fb5cfea08e15a5211ccb69f45a2d9c83009f4...00ec03fd4457ce6a90868195f65ef9c206c5fcc7,2,5,6,11,2,2012-03-26 14:17:13,2012-03-26 14:17:13
00ec03fd4457ce6a90868195f65ef9c206c5fcc7...0fe9f3ce275e93d68b17b9e16b77ef1850665076,1,2,1,3,2,2012-03-26 20:22:02,2012-03-26 20:22:02
0fe9f3ce275e93d68b17b9e16b77ef1850665076...f95baa1d8a8a96f843745118c38b7d13824a1e38,1,4,4,8,1,2012-03-27 09:07:03,2012-03-27 09:07:03
f95baa1d8a8a96f843745118c38b7d13824a1e38...9ddbed6f15a4f04695da7601ddb5a8b1d0def865,1,2,2,4,2,2012-03-28 20:28:13,2012-03-28 20:28:13
9ddbed6f15a4f04695da7601ddb5a8b1d0def865...782c1a770eada77edc5e947caec7bef715d5307d,1,3,2,5,1,2012-03-29 15:25:27,2012-03-29 15:25:27
782c1a770eada77edc5e947caec7bef715d5307d...8c54d7cf717cd2c861a87d2c68f90186e53f60a2,1,3,2,5,1,2012-03-29 16:33:48,2012-03-29 16:33:48
8c54d7cf717cd2c861a87d2c68f90186e53f60a2...6cbb96ef5c9b459f265e9da61c9cf00c833a313d,1,1,1,2,1,2012-03-29 16:44:00,2012-03-29 16:44:00
6cbb96ef5c9b459f265e9da61c9cf00c833a313d...159d1be6567a3696468b77c64169f4f5a5429c14,2,15,2,17,2,2012-03-29 16:49:59,2012-03-29 16:49:59
159d1be6567a3696468b77c64169f4f5a5429c14...31e84e40f8e4c5e6d4fb4bd9276d2e535545fa33,2,12,0,12,2,2012-03-29 18:39:21,2012-03-29 18:39:21
31e84e40f8e4c5e6d4fb4bd9276d2e535545fa33...8bb5b60628b296aac622af559173665ac7579dae,1,2,1,3,1,2012-03-29 18:53:27,2012-03-29 18:53:27
8bb5b60628b296aac622af559173665ac7579dae...9383a2761c67d588378f3679cc6c8ea3651a73c8,73,35,104,139,76,2012-03-30 08:02:08,2012-03-30 08:02:08
9383a2761c67d588378f3679cc6c8ea3651a73c8...eb163f37cb62268443d592f8ce08bd8a0ab9631d,20,145,197,342,99,2012-03-30 09:08:29,2012-03-30 09:08:29
eb163f37cb62268443d592f8ce08bd8a0ab9631d...4fe87c370dc7c282212c63c0502de13f411da79a,5,9,38,47,9,2012-03-30 09:20:04,2012-03-30 09:20:04
4fe87c370dc7c282212c63c0502de13f411da79a...5dad221558ba92df58b9aeefc89becf18983ca92,2,48,0,48,2,2012-03-30 09:33:51,2012-03-30 09:33:51
5dad221558ba92df58b9aeefc89becf18983ca92...27322df99527ea2f0a3388261e736746430dcf98,1,16,7,23,3,2012-03-30 17:59:12,2012-03-30 17:59:12
27322df99527ea2f0a3388261e736746430dcf98...23d34597615d8209de72bd819539a696ba0d1e7f,18,54,120,174,32,2012-03-31 08:24:29,2012-03-31 08:24:29
23d34597615d8209de72bd819539a696ba0d1e7f...a1ffb021072026ad58546609cd2c34f737fd26cc,11,46,205,251,26,2012-03-31 10:34:11,2012-03-31 10:34:11
a1ffb021072026ad58546609cd2c34f737fd26cc...9e11ff2665cceeba7b53557f4eeb0689ac71d54a,1,2,1,3,2,2012-03-31 11:44:57,2012-03-31 11:44:57
9e11ff2665cceeba7b53557f4eeb0689ac71d54a...d66035c4a6629fd68a373448bf95b7818c0d72a2,2,1,27,28,3,2012-03-31 12:08:39,2012-03-31 12:08:39
d66035c4a6629fd68a373448bf95b7818c0d72a2...3f1650680916b06df630bb4a5906c41a079ca42b,1,0,12,12,2,2012-03-31 12:18:50,2012-03-31 12:18:50
3f1650680916b06df630bb4a5906c41a079ca42b...c7229c681e648ea810e907784855eb91d47a7bfb,2,1,41,42,3,2012-03-31 12:22:52,2012-03-31 12:22:52
c7229c681e648ea810e907784855eb91d47a7bfb...dec21a1d4b37238d1f036e83bcd0a3e7eddc33c2,2,0,67,67,3,2012-03-31 12:26:46,2012-03-31 12:26:46
dec21a1d4b37238d1f036e83bcd0a3e7eddc33c2...d38690796cd5c046c0b141174737b7615c143bb1,8,6,144,150,10,2012-03-31 12:38:11,2012-03-31 12:38:11
d38690796cd5c046c0b141174737b7615c143bb1...bfbe4dfff749c27cda528bf632f8dda28a48e774,1,0,5,5,1,2012-03-31 12:54:40,2012-03-31 12:54:40
bfbe4dfff749c27cda528bf632f8dda28a48e774...95d9662f3984199062f237386a45b1a2c170f01d,1,0,29,29,1,2012-03-31 12:57:06,2012-03-31 12:57:06
95d9662f3984199062f237386a45b1a2c170f01d...fbfaa35fb0a2a1206221e00c56cf6136cf93b6f1,2,13,9,22,7,2012-03-31 13:01:59,2012-03-31 13:01:59
fbfaa35fb0a2a1206221e00c56cf6136cf93b6f1...800e3941c50139347ab48e6d6731d445875357ed,1,39,19,58,14,2012-03-31 13:11:02,2012-03-31 13:11:02
800e3941c50139347ab48e6d6731d445875357ed...9ed6e08ff99c18710c0e4875f827235f04c89d76,15,32,251,283,40,2012-03-31 13:55:03,2012-03-31 13:55:03
9ed6e08ff99c18710c0e4875f827235f04c89d76...37c8bc89f20104c0ac02dbc9b2aa7f3a09aa771a,1,0,22,22,2,2012-03-31 13:58:03,2012-03-31 13:58:03
37c8bc89f20104c0ac02dbc9b2aa7f3a09aa771a...d2e273e2958316ac8045971d7bfc790596e8f6cf,4,0,676,676,4,2012-03-31 14:50:54,2012-03-31 14:50:54
d2e273e2958316ac8045971d7bfc790596e8f6cf...6d9227bb0fd3e85db604ca36dba2cfb1d8ef877d,2,0,12,12,6,2012-03-31 15:20:57,2012-03-31 15:20:57
6d9227bb0fd3e85db604ca36dba2cfb1d8ef877d...98e9d1c6aba3670712887b0b20317dcb0e25f249,8,122,171,293,26,2012-03-31 16:03:09,2012-03-31 16:03:09
98e9d1c6aba3670712887b0b20317dcb0e25f249...79ce1be26b5f0b213344f4afb69674e9f6cb8947,1,1,1,2,1,2012-03-31 16:30:36,2012-03-31 16:30:36
79ce1be26b5f0b213344f4afb69674e9f6cb8947...ad355e48ce07ae60648c8858faaa4c9c746c8cd8,1,0,0,0,0,2012-03-31 17:16:14,2012-03-31 17:16:14
ad355e48ce07ae60648c8858faaa4c9c746c8cd8...c39e1cff9937a2d63d62f54118da3619f4418ff4,4,89,9,98,10,2012-03-31 18:22:12,2012-03-31 18:22:12
c39e1cff9937a2d63d62f54118da3619f4418ff4...7b89e0fc571491214503583aad8f7b48efbe2a9d,1,1,1,2,1,2012-03-31 18:24:43,2012-03-31 18:24:43
7b89e0fc571491214503583aad8f7b48efbe2a9d...2d01c9de6918bf998d35bfe8473c57914738a9c6,2,1,9,10,3,2012-03-31 18:27:17,2012-03-31 18:27:17
2d01c9de6918bf998d35bfe8473c57914738a9c6...89b66efafcc224a0f2a306e2b5dcb30d343f28b2,1,1,1,2,1,2012-03-31 18:55:23,2012-03-31 18:55:23
89b66efafcc224a0f2a306e2b5dcb30d343f28b2...f38cf60c35bc9427ad14e261eea40acf91bc2c49,2,4,4,8,4,2012-03-31 19:39:28,2012-03-31 19:39:28
f38cf60c35bc9427ad14e261eea40acf91bc2c49...b41ebcf1b9454bf0905c69594fa2dd1af19e7a60,8,3,112,115,15,2012-03-31 22:24:24,2012-03-31 22:24:24
b41ebcf1b9454bf0905c69594fa2dd1af19e7a60...cb2fafe57443ff499e992f6b166b6097bdb54907,1,4,1,5,2,2012-04-01 17:13:55,2012-04-01 17:13:55
cb2fafe57443ff499e992f6b166b6097bdb54907...7d5979f95386775205a5b825cd2a9ec7d8a311b8,1,0,4,4,1,2012-04-01 21:03:50,2012-04-01 21:03:50
7d5979f95386775205a5b825cd2a9ec7d8a311b8...cac5d9fd80b3bba0ca3059c8ad106799f54863ea,1,2,1,3,1,2012-04-01 21:11:46,2012-04-01 21:11:46
cac5d9fd80b3bba0ca3059c8ad106799f54863ea...60ceeda9d5a1dc2f62b605db5627e1da55a13911,1,1,5,6,1,2012-04-02 19:50:28,2012-04-02 19:50:28
60ceeda9d5a1dc2f62b605db5627e1da55a13911...4b3fd424f46d6a6491dd549783b37401dcba89f5,1,9,3,12,3,2012-04-02 20:29:50,2012-04-02 20:29:50
4b3fd424f46d6a6491dd549783b37401dcba89f5...38115ea742a9d775d9b02d2b56ef5392a8b9165d,1,5,2,7,1,2012-04-05 14:06:06,2012-04-05 14:06:06
38115ea742a9d775d9b02d2b56ef5392a8b9165d...5e047ed859251d8019a185262b8f5abf5966af09,1,1,12,13,1,2012-04-05 14:49:02,2012-04-05 14:49:02
5e047ed859251d8019a185262b8f5abf5966af09...5c954136eaef3d98d532368deec4c19cf892f664,2,52,8,60,9,2012-04-05 15:44:04,2012-04-05 15:44:04
5c954136eaef3d98d532368deec4c19cf892f664...723445f40e33c1c68b4b501f8064e78a5ebd346e,1,2,2,4,1,2012-04-06 09:17:37,2012-04-06 09:17:37
723445f40e33c1c68b4b501f8064e78a5ebd346e...b4a98271339e1595fc5e362da0d1b82b3c492448,1,1,1,2,1,2012-04-06 18:55:42,2012-04-06 18:55:42
b4a98271339e1595fc5e362da0d1b82b3c492448...8663bc110305844b2f8b0829ee2ddfc5be61b758,9,77,38,115,26,2012-04-06 21:24:33,2012-04-06 21:24:33
8663bc110305844b2f8b0829ee2ddfc5be61b758...8dd04fd84b4f69c4326e120c301d49a6c00e8e64,2,5,3,8,4,2012-04-07 15:16:11,2012-04-07 15:16:11
8dd04fd84b4f69c4326e120c301d49a6c00e8e64...393aeb79b818dd8fa921b051b1091525bbd52930,2,19,1,20,7,2012-04-07 22:35:57,2012-04-07 22:35:57
393aeb79b818dd8fa921b051b1091525bbd52930...4f623524125ce059951ab879d34b50f6024225f4,1,7,13,20,8,2012-04-08 12:29:05,2012-04-08 12:29:05
4f623524125ce059951ab879d34b50f6024225f4...5c53e30607014163872e89c221b206992a9acfef,11,31,164,195,35,2012-04-08 21:13:32,2012-04-08 21:13:32
5c53e30607014163872e89c221b206992a9acfef...93d1fdb1304ed5b2e5ea2e0f1e84db7fff5eb7fa,4,36,3,39,5,2012-04-09 00:43:08,2012-04-09 00:43:08
93d1fdb1304ed5b2e5ea2e0f1e84db7fff5eb7fa...a0b55f30a843a9ce12a907d65edcd479f5a5b1cb,5,26,26,52,25,2012-04-09 04:28:32,2012-04-09 04:28:32
a0b55f30a843a9ce12a907d65edcd479f5a5b1cb...36ab8ae270d287ec048ff3000f1213e68bc5e1dc,1,1,1,2,1,2012-04-09 10:00:32,2012-04-09 10:00:32
36ab8ae270d287ec048ff3000f1213e68bc5e1dc...883c38c499d58ec1c8182933de88f7d1164387e3,7,33,73,106,25,2012-04-09 13:24:57,2012-04-09 13:24:57
883c38c499d58ec1c8182933de88f7d1164387e3...6f7aa51b2c3fbcbbc76404cee3cbe511feabaf1f,7,128,0,128,7,2012-04-09 17:25:02,2012-04-09 17:25:02
6f7aa51b2c3fbcbbc76404cee3cbe511feabaf1f...f195f1ed2481d34ff56df36cf46ad7d377f2af93,3,42,12,54,7,2012-04-09 22:41:20,2012-04-09 22:41:20
f195f1ed2481d34ff56df36cf46ad7d377f2af93...1f11069aa59df03157ed90788c7759df77ec4377,2,8,1,9,5,2012-04-10 06:04:53,2012-04-10 06:04:53
1f11069aa59df03157ed90788c7759df77ec4377...b90d4e5b749be3b6caec8ece7729beb3876ea4b8,3,131,24,155,14,2012-04-10 12:29:25,2012-04-10 12:29:25
b90d4e5b749be3b6caec8ece7729beb3876ea4b8...916d705538045529709c83033ef22f9b3895a462,1,2,2,4,1,2012-04-10 20:00:18,2012-04-10 20:00:18
916d705538045529709c83033ef22f9b3895a462...28e5b665189548557993b522e3bd7adeed3f62ea,2,18,4,22,3,2012-04-10 20:05:46,2012-04-10 20:05:46
28e5b665189548557993b522e3bd7adeed3f62ea...93240b7d903af86e135c3b1724a81d2daf31441f,5,30,12,42,10,2012-04-10 20:49:45,2012-04-10 20:49:45
93240b7d903af86e135c3b1724a81d2daf31441f...f5a9e5e92867344b6251fdf58c05717b2ef26018,1,1,1,2,1,2012-04-11 02:03:59,2012-04-11 02:03:59
f5a9e5e92867344b6251fdf58c05717b2ef26018...f0697570e916022637c6147de3f1dfb2eb360ea6,1,2,2,4,2,2012-04-11 13:00:38,2012-04-11 13:00:38
f0697570e916022637c6147de3f1dfb2eb360ea6...e2548ec2a9e2f8dc733bcc72681fd28a34af4dbd,2,6,2,8,2,2012-04-11 17:49:22,2012-04-11 17:49:22
e2548ec2a9e2f8dc733bcc72681fd28a34af4dbd...632b6a1a73bc47226e40dc0a9891c67138a2161c,2,23,8,31,4,2012-04-11 21:11:22,2012-04-11 21:11:22
632b6a1a73bc47226e40dc0a9891c67138a2161c...5a4d7e63ceb5d1a987c3466e3c6b0149eff5e222,1,0,2,2,1,2012-04-11 21:25:22,2012-04-11 21:25:22
5a4d7e63ceb5d1a987c3466e3c6b0149eff5e222...cbc411571aac8299dc2a0c98d0366a972d5d5f6a,1,1,1,2,1,2012-04-11 21:35:08,2012-04-11 21:35:08
cbc411571aac8299dc2a0c98d0366a972d5d5f6a...844e56e21aa45a4bf1c549129e46f7d7959c74d8,3,12,62,74,8,2012-04-12 16:35:28,2012-04-12 16:35:28
844e56e21aa45a4bf1c549129e46f7d7959c74d8...2cd516002d43cdc09741618f0a0db047ee6d78fd,2,5,1,6,2,2012-04-12 20:23:41,2012-04-12 20:23:41
2cd516002d43cdc09741618f0a0db047ee6d78fd...57a12ca0ac1bd6f6650d6f45852dd2e0fe6bec0c,1,12,6,18,5,2012-04-13 11:38:52,2012-04-13 11:38:52
57a12ca0ac1bd6f6650d6f45852dd2e0fe6bec0c...be1082b3fe027c5f3ead0da40e408b18b9d84f6c,1,8,0,8,1,2012-04-14 06:40:20,2012-04-14 06:40:20
be1082b3fe027c5f3ead0da40e408b18b9d84f6c...a9187e54472cd65dda0fac77cacd586c00fd7ea9,1,1,1,2,1,2012-04-14 06:40:53,2012-04-14 06:40:53
a9187e54472cd65dda0fac77cacd586c00fd7ea9...749243941c0761a9dbf7afd5ef0fe1769a6647cd,3,20,36,56,11,2012-04-14 12:35:31,2012-04-14 12:35:31
749243941c0761a9dbf7afd5ef0fe1769a6647cd...0e0102389787444f3981aea19867a9dad6a4999b,6,42,64,106,35,2012-04-14 13:35:25,2012-04-14 13:35:25
0e0102389787444f3981aea19867a9dad6a4999b...5116c51b40edc37ed2e1bd68d0069321bc1f3f04,1,10,5,15,6,2012-04-15 16:34:13,2012-04-15 16:34:13
5116c51b40edc37ed2e1bd68d0069321bc1f3f04...157f8238190d69e92c61c114f3331cf3f975c561,1,2,2,4,1,2012-04-15 21:25:23,2012-04-15 21:25:23
157f8238190d69e92c61c114f3331cf3f975c561...38d7a3a0fe1960939a73a3d00dd18c0742731ab9,1,1,1,2,1,2012-04-16 11:38:43,2012-04-16 11:38:43
38d7a3a0fe1960939a73a3d00dd18c0742731ab9...718f149bb203d6b3f77bb8126e664054ee90fe7d,2,17,0,17,2,2012-04-19 15:00:55,2012-04-19 15:00:55
718f149bb203d6b3f77bb8126e664054ee90fe7d...a901654a96dd4287ab3a700aff86bcac4b49f32a,1,1,1,2,1,2012-04-20 01:31:07,2012-04-20 01:31:07
a901654a96dd4287ab3a700aff86bcac4b49f32a...d5b93d3281fe93cbef5de84a52001f64dbd839bd,4,24,10,34,7,2012-04-20 11:09:32,2012-04-20 11:09:32
d5b93d3281fe93cbef5de84a52001f64dbd839bd...3d5d0be49920bfdfe501570f38c4c9ea6d05a5f5,1,5,1,6,2,2012-04-20 12:58:32,2012-04-20 12:58:32
3d5d0be49920bfdfe501570f38c4c9ea6d05a5f5...53fb45c6d82da6136bd06c0318c364fd076e67be,3,30,4,34,5,2012-04-20 17:34:29,2012-04-20 17:34:29
53fb45c6d82da6136bd06c0318c364fd076e67be...4536359887b34eea5e7b8cf6864d9092b46c2980,4,32,71,103,17,2012-04-21 03:04:10,2012-04-21 03:04:10
4536359887b34eea5e7b8cf6864d9092b46c2980...64bc22be941bec893ea8ebdd624d2baed38a14ba,1,3,5,8,1,2012-04-21 12:35:06,2012-04-21 12:35:06
64bc22be941bec893ea8ebdd624d2baed38a14ba...83fc9651713edfed9c3eff52b73933eb67a46a59,2,21,4,25,4,2012-04-21 22:52:03,2012-04-21 22:52:03
83fc9651713edfed9c3eff52b73933eb67a46a59...3c5ff9d703be67b43655c5a40e8ee3719ad2871b,6,93,9,102,11,2012-04-22 14:44:08,2012-04-22 14:44:08
3c5ff9d703be67b43655c5a40e8ee3719ad2871b...e7d648d8cbea71b7d9ffd6f0f7b2bfea3dbdf245,1,4,2,6,3,2012-04-22 15:07:36,2012-04-22 15:07:36
e7d648d8cbea71b7d9ffd6f0f7b2bfea3dbdf245...bc8b9bd438d0b8f68ef14a5ecc81326fd7447edf,2,3,0,3,2,2012-04-22 15:58:53,2012-04-22 15:58:53
bc8b9bd438d0b8f68ef14a5ecc81326fd7447edf...d93b2a8d8d397ae2d85986414870d46c30a6258f,1,8,2,10,3,2012-04-22 17:18:14,2012-04-22 17:18:14
d93b2a8d8d397ae2d85986414870d46c30a6258f...530ab32e9f0a9364cc20059d37b492315f760e63,1,10,1,11,1,2012-04-23 18:05:12,2012-04-23 18:05:12
530ab32e9f0a9364cc20059d37b492315f760e63...03a442c8ad6addf8c223ca0d3864a9d58d409d44,2,51,34,85,11,2012-04-24 16:05:47,2012-04-24 16:05:47
03a442c8ad6addf8c223ca0d3864a9d58d409d44...612247b3a0acbdec17b9c52410b2349533ff2d95,4,65,11,76,7,2012-04-24 16:47:31,2012-04-24 16:47:31
612247b3a0acbdec17b9c52410b2349533ff2d95...c4e62eff9074bedb5f2242b46625c35721502989,5,49,3,52,7,2012-04-24 18:03:14,2012-04-24 18:03:14
c4e62eff9074bedb5f2242b46625c35721502989...eb351ac9cba2d6b2750aecb4353ba482d6dca87f,41,132,439,571,84,2012-04-24 19:55:52,2012-04-24 19:55:52
eb351ac9cba2d6b2750aecb4353ba482d6dca87f...921d7f08b915fdce35caccf531a635151e3562ee,1,0,9,9,1,2012-04-24 21:08:13,2012-04-24 21:08:13
921d7f08b915fdce35caccf531a635151e3562ee...ea9dc9f4b03ae034c1dc080730422dda7a9c2e47,1,1,1,2,1,2012-04-25 06:37:16,2012-04-25 06:37:16
ea9dc9f4b03ae034c1dc080730422dda7a9c2e47...1858e476721890ce1f47dfa4d2739d9e0f11621b,38,46,3335,3381,52,2012-04-25 19:17:47,2012-04-25 19:17:47
1858e476721890ce1f47dfa4d2739d9e0f11621b...be12c9e9082c12e0510b88d08e735ea2af939b07,6,16,79,95,15,2012-04-26 17:15:40,2012-04-26 17:15:40
be12c9e9082c12e0510b88d08e735ea2af939b07...a6b2a15348f66090fd095492cdd768c36fefbe90,2,4,44,48,5,2012-04-26 17:48:50,2012-04-26 17:48:50
a6b2a15348f66090fd095492cdd768c36fefbe90...8aca3d1cc295c89ab852f71ecfeac562d4f192ea,2,2,16,18,5,2012-04-26 18:06:17,2012-04-26 18:06:17
8aca3d1cc295c89ab852f71ecfeac562d4f192ea...c34d069a75dc3486b984928745b06b8d39767475,2,11,12,23,12,2012-04-26 19:56:20,2012-04-26 19:56:20
c34d069a75dc3486b984928745b06b8d39767475...ddc5d59c6a547f76797d99510df8c3cec61e5f89,2,10,2,12,4,2012-04-27 06:56:31,2012-04-27 06:56:31
ddc5d59c6a547f76797d99510df8c3cec61e5f89...226acf35c84b379aa2e3c3b4672c18c61e3a8114,1,1,1,2,1,2012-04-28 03:25:08,2012-04-28 03:25:08
226acf35c84b379aa2e3c3b4672c18c61e3a8114...8df8e516ab9d6eb1f86e4f814a479242402e1ffd,1,8,29,37,7,2012-04-28 03:26:16,2012-04-28 03:26:16
8df8e516ab9d6eb1f86e4f814a479242402e1ffd...21f11e5280696560dbd98b7acd54b762e095d810,2,4,4,8,4,2012-04-28 03:37:59,2012-04-28 03:37:59
21f11e5280696560dbd98b7acd54b762e095d810...bcdc99dda2c417571fe5185cc730aaa9515316c6,1,10,18,28,7,2012-04-28 03:57:23,2012-04-28 03:57:23
bcdc99dda2c417571fe5185cc730aaa9515316c6...f4cc78271126b86ca630624aad63d48339bd3db2,1,1,1,2,1,2012-04-28 04:05:13,2012-04-28 04:05:13
7dd37edf6292ad0d24059e7039cabefceca32caa...1989df601402125da1420b896eb7a6bab5a8c11f,1,1,1,2,1,2014-02-01 01:15:13,2014-02-01 01:15:13
4d2fdd41855e978ec5f3b8a03e8599994d7f5b70...1c13cc023fbbc5af0009275e857a97d74cd98191,1,2,0,2,2,2012-06-04 11:24:05,2012-06-04 11:22:36
f4cc78271126b86ca630624aad63d48339bd3db2...b49bc5c9903ca216eebe6b3356a50e3cc737bfe5,1,0,5,5,1,2012-04-28 13:03:16,2012-04-28 13:03:16
b49bc5c9903ca216eebe6b3356a50e3cc737bfe5...10cade8fac143984fc8416f3179c955e9f0c7f7b,1,2,4,6,3,2012-04-28 13:19:04,2012-04-28 13:19:04
f4cc78271126b86ca630624aad63d48339bd3db2...cfe552ccb39e15544bbb1ab1eccc41081e0c6441,1,6,8,14,1,2012-04-28 07:29:42,2012-04-28 07:29:42
cfe552ccb39e15544bbb1ab1eccc41081e0c6441...a7829f33349f0778d52c35615465b11e42e573b4,1,1,0,1,1,2012-04-28 07:33:37,2012-04-28 07:33:37
a7829f33349f0778d52c35615465b11e42e573b4...6b430b883f3cfdc8a8016c539dd590c9f7e211b1,1,1,1,2,1,2012-04-28 18:58:11,2012-04-28 18:58:11
adea5a3880c6f211a1b9e03255bb88e43f36a08c...8dc1b2e03f2402911dd68172ecc0b0bb22fd3e18,1,1,0,1,1,2014-07-18 13:03:38,2011-05-14 02:58:58
8dc1b2e03f2402911dd68172ecc0b0bb22fd3e18...8892b0c2c36e67ea8470de302a51f12654df668a,1,6,0,6,2,2014-07-18 13:05:52,2013-07-31 13:24:29
8892b0c2c36e67ea8470de302a51f12654df668a...e982cbd4a13a17e8c9246860fec8be8716519a66,1,1,0,1,1,2014-07-18 13:07:31,2011-05-15 23:02:36
e982cbd4a13a17e8c9246860fec8be8716519a66...6726d750979a7c29e0dd866b4ea367eef7c8a420,1,4,2,6,4,2014-07-18 13:07:52,2014-01-24 13:52:43
03f1d69f1e4313c34f965f5a3ef922a5084aa619...3bd937aec2fa26fd7e9d9c3269aca5e663d14aa7,1,10,13,23,2,2012-06-04 20:46:37,2012-06-04 19:31:23
3bd937aec2fa26fd7e9d9c3269aca5e663d14aa7...0a8a6b92b28fad50924a84cf2b4e1d7c5e501a1f,1,3,2,5,2,2012-06-04 20:49:42,2012-06-04 19:39:57
0a8a6b92b28fad50924a84cf2b4e1d7c5e501a1f...45d43317b7db845a7c565522b3e6e6b2dab46a64,6,99,110,209,36,2012-06-06 11:55:09,2012-06-06 09:54:26
45d43317b7db845a7c565522b3e6e6b2dab46a64...ff6ee5f06c2850f098863d4a747069e10727293e,2,17,0,17,2,2012-06-08 14:02:15,2012-04-19 15:00:55
ff6ee5f06c2850f098863d4a747069e10727293e...3631a028e2d8eef9ade7b174d9cbe1440d4acfad,1,2,2,4,2,2012-06-27 22:43:14,2012-06-20 23:13:35
3631a028e2d8eef9ade7b174d9cbe1440d4acfad...9014b138e6d78aa5fef2c63b8e482379005d32b2,2,6,9,15,3,2012-06-27 22:56:04,2012-06-21 00:03:06
9014b138e6d78aa5fef2c63b8e482379005d32b2...d92c38a28177f4cad91c1921ca2b621d3af01912,1,1,1,2,1,2012-06-29 13:11:13,2012-06-29 13:08:30
d92c38a28177f4cad91c1921ca2b621d3af01912...a89e76d15149c0758e6459d695ce60722cad7101,1,7,0,7,1,2012-06-30 14:30:45,2012-06-30 14:25:51
a89e76d15149c0758e6459d695ce60722cad7101...342e8a6246d0c3893ecbe80584f30d6d0f05aa6f,1,2,2,4,2,2012-06-30 21:24:26,2012-06-07 11:46:06
342e8a6246d0c3893ecbe80584f30d6d0f05aa6f...fea5e0b80f6fcb4c520a113a7b46b20ecd678413,2,4,1,5,2,2012-06-30 22:21:50,2012-06-30 22:20:34
fea5e0b80f6fcb4c520a113a7b46b20ecd678413...32bd77d392e331e823792abcd9d31045f681776d,1,13,0,13,1,2012-07-01 10:56:20,2012-07-01 10:55:46
32bd77d392e331e823792abcd9d31045f681776d...8bea1a7e4eacfe311651eafb506ab1f4e7691feb,1,3,1,4,1,2012-07-01 11:26:53,2012-07-01 11:25:24
8bea1a7e4eacfe311651eafb506ab1f4e7691feb...c5e35afbccb2777b8eea882e95eba44ed582c361,1,35,1,36,2,2012-07-01 22:06:33,2012-07-01 22:04:16
c5e35afbccb2777b8eea882e95eba44ed582c361...f5db3bddb34f7a2b5807b5af74dc49863fe5f06b,2,10,1,11,3,2012-07-05 12:40:20,2012-07-05 12:39:05
f5db3bddb34f7a2b5807b5af74dc49863fe5f06b...f1e416566a2e09f25b75a379f31a71962fa66437,1,1,1,2,1,2012-07-07 14:02:45,2012-07-07 14:00:03
f1e416566a2e09f25b75a379f31a71962fa66437...fd88fe657b42cf314bcd23bf79edf71c378520f4,1,2,1,3,1,2012-07-07 21:12:02,2012-07-07 21:08:43
fd88fe657b42cf314bcd23bf79edf71c378520f4...9a2ca4266ad3a58af7db3ecbf9b99270519bb8f2,1,2,1,3,1,2012-07-07 22:44:26,2012-07-07 22:44:26
9a2ca4266ad3a58af7db3ecbf9b99270519bb8f2...dcede04715fb4896ae7892c2a63ea534496ee0bf,1,6,8,14,2,2012-07-08 22:38:52,2012-07-08 22:35:17
dcede04715fb4896ae7892c2a63ea534496ee0bf...8ba78a0daf037b93194ccd1eb84614d72c7482a9,1,2,1,3,1,2012-07-08 23:30:11,2012-07-08 23:26:53
10cade8fac143984fc8416f3179c955e9f0c7f7b...2cadd8623915227d594be2b5a2749435215dd240,1,0,0,0,0,2012-04-28 18:17:06,2012-04-28 18:17:06
10cade8fac143984fc8416f3179c955e9f0c7f7b...5c3e88060e286ffa28092d7d6e49edde857053c7,1,2,3,5,1,2012-04-28 18:16:46,2012-04-28 18:16:46
10cade8fac143984fc8416f3179c955e9f0c7f7b...a0d34348dd680a180496d1cc5d3bdbaec249f3f0,1,2,2,4,2,2012-04-28 17:18:16,2012-04-28 17:18:16
50b0984a8b83133e7108098da9807e94c853364b...02bed132c23e438ca5862af484480c34dc15dc71,1,18,18,36,9,2012-04-28 20:20:39,2012-04-28 20:20:39
8ba78a0daf037b93194ccd1eb84614d72c7482a9...c2ff027861dcbdd0c6ac82eb6e7f74455499c4e6,1,7,0,7,1,2012-07-22 14:06:16,2012-07-21 23:16:47
8ba78a0daf037b93194ccd1eb84614d72c7482a9...c6d06a9453859c5520312454b6353498332ff838,1,4,1,5,2,2012-07-16 04:29:13,2012-07-16 04:29:13
80d32b51b02602c0d785754e29799eccd31b9f5a...97502a96f4c51131e4e4c11bf8824de23ad5246f,1,1,1,2,1,2012-04-28 19:32:22,2012-04-26 01:03:03
498bf5c26cfba5e4c452501c82cfa8501cfc7d96...94e91f75b989fade5cff010a389d1ebc9569180a,1,1,1,2,1,2012-07-28 17:33:19,2012-07-28 17:31:41
94e91f75b989fade5cff010a389d1ebc9569180a...da33d67181b53fe6cc737ac1220153814a1509f6,1,6,1,7,3,2012-07-30 20:00:17,2012-07-30 19:56:28
da33d67181b53fe6cc737ac1220153814a1509f6...c14f325c4eef628bc7bfd8873c3a72aeb0219141,1,4,14,18,1,2012-07-30 20:00:17,2012-07-30 19:58:55
c14f325c4eef628bc7bfd8873c3a72aeb0219141...e34685034b60be1112160e76091e5aee60149fa1,2,29,12,41,8,2012-07-30 20:03:33,2012-07-30 20:03:09
e34685034b60be1112160e76091e5aee60149fa1...28a4d039a2725ad51d23b92aa89e5b59e98e4a9b,3,4,4,8,4,2012-07-30 20:43:45,2012-07-30 20:43:45
28a4d039a2725ad51d23b92aa89e5b59e98e4a9b...fa6577f5b2af9848b661fc24719b59e07d214728,1,7,6,13,1,2012-07-30 22:12:40,2012-07-30 20:16:11
fa6577f5b2af9848b661fc24719b59e07d214728...751a34e4b345c303c131bf72918073ec853a66aa,1,6,5,11,2,2012-08-01 11:57:10,2012-07-31 20:13:52
751a34e4b345c303c131bf72918073ec853a66aa...a276bdebb2e8ef4619d0cb9a02b0b9f4f73ee998,1,4,0,4,1,2012-08-01 12:02:01,2012-07-31 20:20:41
a276bdebb2e8ef4619d0cb9a02b0b9f4f73ee998...68fd7f56e18df609561f8c82f247eb0c4cac2f83,1,6,0,6,1,2012-08-02 11:16:30,2012-08-02 11:13:22
68fd7f56e18df609561f8c82f247eb0c4cac2f83...445b9663e71e80c2cc30a58ee84811d09a3eaa82,3,0,0,0,0,2012-08-02 11:53:12,2012-08-02 10:47:59
445b9663e71e80c2cc30a58ee84811d09a3eaa82...d1ae3c899f9284beba43ae2c82c42a5feeabdda1,1,5,4,9,3,2012-08-02 11:55:00,2012-08-02 10:54:19
d1ae3c899f9284beba43ae2c82c42a5feeabdda1...e9f458133c7e2357e66b3e0b97f7b454ae34a684,2,8,0,8,1,2012-08-02 23:23:34,2012-08-02 23:21:48
e9f458133c7e2357e66b3e0b97f7b454ae34a684...c8e681f6243fd0df1489d966089f12a16fd71c69,2,13,0,13,2,2012-08-03 09:20:03,2012-08-03 09:17:52
c8e681f6243fd0df1489d966089f12a16fd71c69...1d280026c3797a23075739f28bb238972afad317,1,11,3,14,2,2012-08-03 21:46:35,2012-08-03 20:06:41
1d280026c3797a23075739f28bb238972afad317...49f9bb271dfeecca431398363e6683780ebcc70a,1,5,5,10,4,2012-08-04 15:41:20,2012-08-04 15:38:18
49f9bb271dfeecca431398363e6683780ebcc70a...c54034a2ad9e0ebf918530fa4b8f11e4ea0f489e,1,40,25,65,12,2012-08-04 19:27:27,2012-08-04 19:24:40
c54034a2ad9e0ebf918530fa4b8f11e4ea0f489e...df8a2bf4cbc962e52f3d8b440eaeeea2a984bbfc,1,2,2,4,2,2012-08-05 17:27:05,2012-08-05 17:21:14
df8a2bf4cbc962e52f3d8b440eaeeea2a984bbfc...6536f7597b4cbccc53846d099fbc7a6b13929ab7,1,4,1,5,1,2012-08-06 22:18:00,2012-08-06 20:15:09
6536f7597b4cbccc53846d099fbc7a6b13929ab7...fba0149e1604ad4ab3745abff8bba0d38bbfe321,2,45,0,45,2,2012-08-10 21:32:34,2012-08-10 20:19:20
fba0149e1604ad4ab3745abff8bba0d38bbfe321...3264894ee02f7099272619fa4f6072d4d2e95eb6,1,5,4,9,1,2012-08-10 21:35:55,2012-08-10 20:12:45
3264894ee02f7099272619fa4f6072d4d2e95eb6...57d9ccc4aaef0420f6ba60a26e6af4e83b803ae9,1,97,86,183,11,2012-08-16 19:12:30,2012-08-16 18:51:47
57d9ccc4aaef0420f6ba60a26e6af4e83b803ae9...01b02317172a5030b77a09aada11657c00398416,1,4,4,8,1,2012-08-16 22:15:52,2012-08-16 20:05:41
01b02317172a5030b77a09aada11657c00398416...e4b7e7d86deb1303997d6c3b893c76ead2d6d46a,1,7,0,7,1,2012-08-16 22:16:56,2012-08-16 20:13:45
e4b7e7d86deb1303997d6c3b893c76ead2d6d46a...03e79c3386ba495438f05b59f270c8d14055c231,1,1,1,2,1,2012-08-17 15:15:43,2012-06-13 18:42:18
03e79c3386ba495438f05b59f270c8d14055c231...232a30804446739602d883e87c3b809c4f99d282,1,3,0,3,1,2012-08-19 22:48:29,2012-08-19 22:46:46
232a30804446739602d883e87c3b809c4f99d282...eaa6e4e2d164d71b14b8504ef66928e9e3e18d7d,1,1,0,1,1,2012-08-19 23:07:48,2012-05-17 22:53:57
eaa6e4e2d164d71b14b8504ef66928e9e3e18d7d...b05d2f51b806da184fb8c56619f4d275a3294bb5,1,1,1,2,1,2012-08-20 00:14:54,2012-08-20 00:13:09
b05d2f51b806da184fb8c56619f4d275a3294bb5...42aee6ffe5f16852347e0cf069447950e9d2ef85,1,7,4,11,1,2012-08-21 21:36:41,2012-08-21 21:32:53
42aee6ffe5f16852347e0cf069447950e9d2ef85...27c2ccc1ea0d08752a480aae30d48be6126d21ff,2,58,58,116,30,2012-08-21 21:42:18,2012-08-21 20:29:16
27c2ccc1ea0d08752a480aae30d48be6126d21ff...4b8c6c405619f7624847a469304e0d1cea053f19,1,29,0,29,1,2012-08-23 00:37:38,2012-08-23 00:36:46
4b8c6c405619f7624847a469304e0d1cea053f19...81bfe428e1dd65235e88533e9fa8531486adfae0,1,2,2,4,1,2012-08-25 12:27:48,2012-08-25 12:25:34
81bfe428e1dd65235e88533e9fa8531486adfae0...f6351851b668f529a960df1b547d3b98dfa85388,1,1,1,2,1,2012-08-30 11:42:47,2012-08-30 10:45:11
f6351851b668f529a960df1b547d3b98dfa85388...fa8a09fdc596ff828bb1c53b661e5007ed63fc29,1,1,3,4,2,2012-08-30 11:45:06,2012-08-30 11:04:57
fa8a09fdc596ff828bb1c53b661e5007ed63fc29...b8340d26e4a177636a8a9a5acd824a45b1cbdd98,28,68,53,121,50,2012-08-30 11:47:56,2012-06-28 08:49:07
b8340d26e4a177636a8a9a5acd824a45b1cbdd98...df0c1055cd09eed24ba56efa7df206512e4aa96c,1,41,2,43,4,2012-08-31 12:16:36,2012-08-31 10:50:00
df0c1055cd09eed24ba56efa7df206512e4aa96c...f6159d426b60aee8226c76ad9eada38ebb3e1875,3,30,0,30,4,2012-08-31 18:38:12,2012-08-31 18:35:50
f6159d426b60aee8226c76ad9eada38ebb3e1875...90fee02feeeed712a05d714d76d8acc07d3ed9a1,1,4,2,6,3,2012-08-31 22:01:54,2012-08-31 20:19:04
90fee02feeeed712a05d714d76d8acc07d3ed9a1...c274a9cbd03bd3a90c2400b6efc63a59c5e64b33,1,4,0,4,1,2012-09-01 00:26:02,2012-09-01 00:24:33
c274a9cbd03bd3a90c2400b6efc63a59c5e64b33...c088a42670df867667401f131b865d9c7686667f,1,104,43,147,9,2012-09-01 10:03:56,2012-09-01 10:01:36
c088a42670df867667401f131b865d9c7686667f...c2f1aa5a3c605927f1fb86c0d4eaa9f9067a0313,2,20,0,20,3,2012-09-01 13:27:29,2012-09-01 13:24:39
c2f1aa5a3c605927f1fb86c0d4eaa9f9067a0313...92f7af3c36ec62e0b55c69ae8e359e53c8cfec15,6,57,4,61,9,2012-09-01 16:39:51,2012-09-01 16:32:27
92f7af3c36ec62e0b55c69ae8e359e53c8cfec15...c9f1a13f87174b21fe2b6230fc1b2f44e03c8d61,1,3,1,4,1,2012-09-01 19:40:28,2012-09-01 19:38:44
c9f1a13f87174b21fe2b6230fc1b2f44e03c8d61...f0c469c7be1b8eb1326bb8ab263bdcdd1e8fa47e,1,9,8,17,6,2012-09-01 22:06:25,2012-09-01 22:05:18
f0c469c7be1b8eb1326bb8ab263bdcdd1e8fa47e...23268608512444de626e63dee1815fb5b5207a48,6,100,25,125,17,2012-09-02 16:17:15,2012-04-29 01:22:05
23268608512444de626e63dee1815fb5b5207a48...53f533f8648eb869978020c11f0c9c8f4dae4679,1,1,2,3,2,2012-09-05 21:52:01,2012-09-05 21:50:17
53f533f8648eb869978020c11f0c9c8f4dae4679...376a18993b7d4f7de82c8fa82c0be32961d9f397,3,400,0,400,3,2012-09-07 15:45:25,2012-09-07 15:45:25
376a18993b7d4f7de82c8fa82c0be32961d9f397...7e8483e70b8180277b6ea99c1315ede7d887ce85,1,15,5,20,1,2012-09-07 23:50:55,2012-09-07 23:49:38
7e8483e70b8180277b6ea99c1315ede7d887ce85...b0e2cb8e470acc552b4ed3fde3d5b1322b426bf2,2,10,9,19,4,2012-09-08 10:40:05,2012-09-08 10:38:41
b0e2cb8e470acc552b4ed3fde3d5b1322b426bf2...cd5181f84c7d4f2002efb777b6cf042771135f7a,1,8,0,8,1,2012-09-08 18:54:07,2012-09-08 18:52:17
cd5181f84c7d4f2002efb777b6cf042771135f7a...7c6630920eb5a755ad1c12ea999f729cc7d9b7d0,4,7,3,10,5,2012-09-08 19:21:13,2012-09-08 19:20:27
7c6630920eb5a755ad1c12ea999f729cc7d9b7d0...1b5b8b874fb79a8d2b2bc7ca8f93535ff8196167,3,214,78,292,24,2012-09-15 10:46:39,2012-09-12 10:59:19
1b5b8b874fb79a8d2b2bc7ca8f93535ff8196167...81c77d24eff8d97752681f413451a170861e865d,1,61,1,62,2,2012-09-15 11:18:28,2012-09-15 11:16:07
81c77d24eff8d97752681f413451a170861e865d...18d88a169fecf7efa2fba2ba2867e7a37084c7fc,1,30,0,30,1,2012-09-15 11:41:49,2012-09-15 11:37:33
18d88a169fecf7efa2fba2ba2867e7a37084c7fc...421ce44e8bb7386d1f5826d0473a3e24f6075d35,1,8,0,8,1,2012-09-15 12:17:26,2012-09-15 12:15:54
421ce44e8bb7386d1f5826d0473a3e24f6075d35...336dfc3413b22bc5a5008bba7ff383886da96d60,4,13,5,18,8,2012-09-15 23:33:56,2012-09-15 23:33:56
336dfc3413b22bc5a5008bba7ff383886da96d60...3a64adef611ba152eb96d77645480e1953825803,1,11,2,13,2,2012-09-19 22:01:06,2012-09-19 11:13:10
3a64adef611ba152eb96d77645480e1953825803...57cdbf3bf8e80eb5c265852bfa5eb4b3f514809e,1,11,1,12,2,2012-09-19 22:01:24,2012-09-19 20:36:34
57cdbf3bf8e80eb5c265852bfa5eb4b3f514809e...1189dca471b9d2c01a570526fbbcddf659dfff43,1,3,0,3,1,2012-09-19 22:01:37,2012-09-19 20:09:46
1189dca471b9d2c01a570526fbbcddf659dfff43...bd514f28e49887e8555c289546286dc27a17ddcc,1,7,0,7,1,2012-09-22 11:09:49,2012-09-22 11:08:40
bd514f28e49887e8555c289546286dc27a17ddcc...1f537335d9ff659cb0996d6523ad8ab7b3c49f4e,2,49,0,49,3,2012-09-27 12:54:48,2012-09-27 12:36:30
1f537335d9ff659cb0996d6523ad8ab7b3c49f4e...4dba4ed548c0abdf4cdc0f3781d1c4d89a567d23,2,5,3,8,5,2012-09-30 13:36:01,2012-09-30 13:36:01
4dba4ed548c0abdf4cdc0f3781d1c4d89a567d23...cf482d6e2a322a8c84570ae282b774fa09491c98,1,31,0,31,1,2012-09-30 17:42:38,2012-09-30 17:37:25
cf482d6e2a322a8c84570ae282b774fa09491c98...b1462e0a36bc6bb2c221bda107da74a6381b9675,1,5,0,5,1,2012-10-03 21:44:14,2012-10-03 10:58:16
b1462e0a36bc6bb2c221bda107da74a6381b9675...8868a067e02b4fe9f1c669f06e90fc28171b9758,3,6,6,12,6,2012-10-03 21:47:48,2012-10-03 18:43:36
8868a067e02b4fe9f1c669f06e90fc28171b9758...a35d7fd1e1c8e2a1e95b6d16949f9fb3977f15cb,2,3,3,6,5,2012-10-04 11:46:53,2012-10-04 10:45:22
a35d7fd1e1c8e2a1e95b6d16949f9fb3977f15cb...0636c9583fda5a81a18b47876bcddac62bd2e547,1,4,4,8,1,2012-10-05 21:18:17,2012-10-05 21:14:56
0636c9583fda5a81a18b47876bcddac62bd2e547...c06b724a00236b086a5a64510d8bf11978f083f8,2,4,2,6,2,2012-10-06 11:07:29,2012-10-06 11:02:11
c06b724a00236b086a5a64510d8bf11978f083f8...1be0515fe9940a7a727680a775395fe5f0c12b1d,1,43,0,43,1,2012-10-11 00:06:52,2012-10-11 00:03:27
1be0515fe9940a7a727680a775395fe5f0c12b1d...3ac70a5907e054c734ca26e435f1ec1215797b08,5,31,0,31,5,2012-10-11 10:14:24,2012-10-11 10:11:52
3ac70a5907e054c734ca26e435f1ec1215797b08...cf17d5e2676f7ddf71ce0a78bfa0060da718924c,1,3,3,6,1,2012-10-11 21:49:40,2012-10-11 10:47:29
cf17d5e2676f7ddf71ce0a78bfa0060da718924c...a1d21c08774c87b8d2995aada5ad20c650ad7570,1,3,1,4,1,2012-10-11 22:05:49,2012-10-11 22:04:25
a1d21c08774c87b8d2995aada5ad20c650ad7570...8139a7990a682f282096167bcea35004cacf5559,1,6,1,7,1,2012-10-12 00:02:40,2012-10-11 23:54:52
8139a7990a682f282096167bcea35004cacf5559...e2dea54efe53fbeb66e684973ed6ad05f63969cc,1,10,0,10,1,2012-10-12 23:17:50,2012-10-12 10:37:35
e2dea54efe53fbeb66e684973ed6ad05f63969cc...d2891d1c0751d53c10f19672ac7d232b6e5088b0,1,8,1,9,2,2012-10-12 23:46:47,2012-10-12 23:45:45
d2891d1c0751d53c10f19672ac7d232b6e5088b0...4cdc416d039c7cfc04aa7bc156dd5a1c737375ed,1,1,1,2,1,2012-10-13 09:05:22,2012-10-13 09:02:18
4cdc416d039c7cfc04aa7bc156dd5a1c737375ed...cc0478606a1d3dd804bc005a78e616550d3d0d41,3,22,2,24,3,2012-10-13 17:51:53,2012-09-28 03:34:45
cc0478606a1d3dd804bc005a78e616550d3d0d41...81020708eae0a38b56cad86a043a78ffac9ba32a,1,6,4,10,1,2012-10-15 23:56:40,2012-10-15 23:54:37
81020708eae0a38b56cad86a043a78ffac9ba32a...6ebb6f918872c2a714ddb9808984e70daaa95cd8,1,1,1,2,1,2012-10-17 00:47:07,2012-10-17 00:39:13
6ebb6f918872c2a714ddb9808984e70daaa95cd8...33d11463a0b9258ac0c72fd856b6d42512616e8d,1,2,2,4,2,2012-10-17 00:53:53,2012-10-17 00:53:53
33d11463a0b9258ac0c72fd856b6d42512616e8d...73991b0b325f07fc62179c3684ed921f141e69ce,1,2,2,4,1,2012-10-17 19:48:47,2012-10-17 11:03:40
73991b0b325f07fc62179c3684ed921f141e69ce...92d3430f12171f16f566c9050c40feefb830a4a3,4,44,1,45,5,2012-10-17 21:40:41,2012-10-17 21:38:33
92d3430f12171f16f566c9050c40feefb830a4a3...58806ce1530305390f593cc78b66d77443c6e1b2,2,8,3,11,4,2012-10-17 21:57:58,2012-10-17 21:57:58
58806ce1530305390f593cc78b66d77443c6e1b2...0f54fed0b6a94e981007cf9202d867fb1f9ba3ce,2,3,3,6,3,2012-10-17 22:15:49,2012-10-17 22:15:49
0f54fed0b6a94e981007cf9202d867fb1f9ba3ce...8c46ead92b9c6674cee524215f47a067d1940b31,1,1,1,2,1,2012-10-17 22:17:37,2012-10-17 22:17:37
8c46ead92b9c6674cee524215f47a067d1940b31...773a29295a8811fd018b3b30c6efa9266c5f540a,1,65,0,65,3,2012-10-18 18:18:25,2012-10-18 18:18:25
773a29295a8811fd018b3b30c6efa9266c5f540a...fd90a906333b569340e5507fec3f3a4d4c1d0f47,1,6,0,6,1,2012-10-18 20:59:23,2012-10-16 20:12:52
fd90a906333b569340e5507fec3f3a4d4c1d0f47...700717db1f7e3032cfd89ea80f37eb69bc54a188,1,7,0,7,1,2012-10-19 21:54:38,2012-10-19 10:52:30
700717db1f7e3032cfd89ea80f37eb69bc54a188...e7685b87c13e87d429dd30065373d8dd2f20a2e4,1,37,4,41,4,2012-10-20 12:42:24,2012-10-19 00:12:41
e7685b87c13e87d429dd30065373d8dd2f20a2e4...13bbe9161d38d3c0778577a3547fab2d181a8e5e,1,1,1,2,1,2012-10-20 13:57:51,2012-10-20 13:57:51
13bbe9161d38d3c0778577a3547fab2d181a8e5e...6c1c490f64bb5114570a45a523bec365f89f681d,1,10,0,10,1,2012-10-20 19:23:06,2012-10-20 19:21:19
6c1c490f64bb5114570a45a523bec365f89f681d...e86e4ce0bd0a538fcde0f9b0c4f26c6810621bb5,2,43,2,45,4,2012-10-21 14:50:30,2012-10-18 16:55:14
e86e4ce0bd0a538fcde0f9b0c4f26c6810621bb5...ce168bb8994b0a7e032166e63a8b1cec034694d6,1,1,2,3,1,2012-10-23 16:57:59,2012-09-09 18:13:42
ce168bb8994b0a7e032166e63a8b1cec034694d6...baf1f1dcde1f318fdb6514eaa8497fc958aa69d3,2,8,0,8,1,2012-10-24 21:50:37,2012-10-24 20:30:23
baf1f1dcde1f318fdb6514eaa8497fc958aa69d3...37c87b785da934815f1f5ca863d88ac0685bff2a,3,129,16,145,15,2012-10-28 15:38:26,2012-10-28 14:47:07
37c87b785da934815f1f5ca863d88ac0685bff2a...ad2d57a2ccb6316001205739090a2a1d79453207,1,4,0,4,2,2012-10-29 16:30:51,2012-10-29 16:26:10
ad2d57a2ccb6316001205739090a2a1d79453207...2733253633b8fa7663de2d95a356b92556cef551,1,12,4,16,2,2012-10-29 20:40:32,2012-10-29 20:39:12
2733253633b8fa7663de2d95a356b92556cef551...f8c005b4ec618a40b5ccd573c246a0b6d2960844,1,1,1,2,1,2012-11-02 08:30:42,2012-11-02 08:29:55
f8c005b4ec618a40b5ccd573c246a0b6d2960844...fdb855e7b23d9080f87ed13560bbe383271796cb,1,1,1,2,1,2012-11-13 10:25:55,2012-11-12 21:15:41
fdb855e7b23d9080f87ed13560bbe383271796cb...25e041f270bec5a69e525d47f18a73fe917d1787,4,19,23,42,5,2012-11-15 14:22:28,2012-11-15 12:23:02
25e041f270bec5a69e525d47f18a73fe917d1787...06c14a63a2c27e5eddfbd6f7b35bcb1d0fc2882b,1,129,63,192,9,2012-11-17 22:55:28,2012-10-23 11:02:48
06c14a63a2c27e5eddfbd6f7b35bcb1d0fc2882b...9003d6fece7e0f86be008e189abf18be44fe9b93,2,2,2,4,2,2012-11-20 23:18:26,2012-11-20 23:00:20
9003d6fece7e0f86be008e189abf18be44fe9b93...19710955e4761c4ff23f64f64c07312da26d0d8c,1,17,3,20,4,2012-11-22 06:08:31,2012-11-16 05:17:58
19710955e4761c4ff23f64f64c07312da26d0d8c...9ee9a7265a76d435d886942ee431a216564d13f0,2,3,2,5,3,2012-11-22 13:50:50,2012-11-20 21:14:20
9ee9a7265a76d435d886942ee431a216564d13f0...c7dcb1d808597e0806fb352bb5ddc4b58c452f4c,2,9,1,10,2,2012-11-23 23:28:25,2012-11-23 22:28:20
c7dcb1d808597e0806fb352bb5ddc4b58c452f4c...046300c43b44c3238e980f01c177170ed4efde34,1,1,1,2,1,2012-11-24 08:49:30,2012-11-24 08:36:42
046300c43b44c3238e980f01c177170ed4efde34...3e4058be9f3f7bc58a356278a70d44c07f1c967c,2,4,1,5,2,2012-11-24 14:10:16,2012-11-24 13:52:00
3e4058be9f3f7bc58a356278a70d44c07f1c967c...c72172244ef81f793d1eca9a54f58a11f27b0917,2,53,9,62,9,2012-12-04 04:58:54,2012-11-19 01:04:39
c72172244ef81f793d1eca9a54f58a11f27b0917...8c9a8fd5c4e5ed157d2d5fa09f3d6d05d2290bbf,1,2,2,4,2,2012-12-04 18:41:22,2012-12-04 18:36:56
8c9a8fd5c4e5ed157d2d5fa09f3d6d05d2290bbf...b2ae0a63aeec741f1e51bac9a95a27fd635f9652,9,162,54,216,33,2012-12-10 21:14:16,2012-11-17 21:00:53
b2ae0a63aeec741f1e51bac9a95a27fd635f9652...319627c184e71ae267d6b7f000e293168c7b6e09,3,38,4,42,8,2012-12-10 21:14:16,2012-11-27 21:26:29
319627c184e71ae267d6b7f000e293168c7b6e09...1f0af3c529885beca39e0d4981fb4794ef3102c2,3,4,4,8,4,2012-12-10 21:45:04,2012-12-10 21:45:04
1f0af3c529885beca39e0d4981fb4794ef3102c2...f2530dcb17bf0601cb48e452d1a67d35e5e5d518,1,3,3,6,3,2012-12-10 22:37:12,2012-12-10 22:34:51
f2530dcb17bf0601cb48e452d1a67d35e5e5d518...8ab2aceb6591e5e7c2f50e85a90ec85b42c5c16f,1,1,1,2,1,2012-12-15 21:42:19,2012-04-11 02:03:59
8ab2aceb6591e5e7c2f50e85a90ec85b42c5c16f...647410510721989018a8942e4d1b1f8096798e7a,1,19,0,19,1,2012-12-19 18:13:06,2012-12-19 18:07:52
647410510721989018a8942e4d1b1f8096798e7a...c4a9e5bd8d4c158e63b2fc77796a961ba0a191f4,1,2,2,4,2,2012-12-21 20:53:44,2012-12-21 20:52:06
c4a9e5bd8d4c158e63b2fc77796a961ba0a191f4...c26541f5cb0f069ff9562fa34d8408e69f9976e8,1,1,1,2,1,2013-01-10 00:05:20,2013-01-10 00:03:34
c26541f5cb0f069ff9562fa34d8408e69f9976e8...89ba1b27b4442cbb43555f607ab7d0f189a2af50,1,7,4,11,2,2013-01-17 21:41:05,2013-01-08 20:43:35
89ba1b27b4442cbb43555f607ab7d0f189a2af50...6bd3896fcb5c626a5ef613895d52c69130156d3a,2,9,1,10,3,2013-02-02 11:10:38,2013-02-02 10:57:25
6bd3896fcb5c626a5ef613895d52c69130156d3a...3610d11ba06f242d409100fd456ecf22d3bfcf7f,1,20,16,36,2,2013-02-02 13:08:59,2013-02-02 13:00:38
3610d11ba06f242d409100fd456ecf22d3bfcf7f...ec93ecdd1071e5552fa10afa1160e2081cfc1de0,1,1,1,2,1,2013-02-02 13:24:35,2013-02-02 13:21:26
ec93ecdd1071e5552fa10afa1160e2081cfc1de0...056b2b5f65e6b12c609dbd064cbe1e44a8730bf7,1,27,20,47,19,2013-02-07 12:04:52,2013-02-07 11:12:25
056b2b5f65e6b12c609dbd064cbe1e44a8730bf7...498a5de07bd325628c9bd7a804144a9f714ca721,2,59,2,61,6,2013-02-10 15:34:27,2013-02-10 15:06:52
498a5de07bd325628c9bd7a804144a9f714ca721...9918b3f50212bfb408eebc8f9965beb061baf840,8,119,4,123,14,2013-02-10 15:34:38,2013-02-05 21:52:29
9918b3f50212bfb408eebc8f9965beb061baf840...209f174e58b8d621a06c701281e547a659d9d99c,1,3,1,4,2,2013-02-10 19:57:05,2013-02-10 19:49:03
209f174e58b8d621a06c701281e547a659d9d99c...b4fb448f8387d92832fc70ac58de69c73d5f1729,1,3,3,6,2,2013-02-11 07:42:09,2013-02-11 07:40:11
b4fb448f8387d92832fc70ac58de69c73d5f1729...dec7dd99f095f938bc4306a0260d5b131935ad82,3,14,15,29,4,2013-02-12 22:39:43,2013-02-12 21:11:22
dec7dd99f095f938bc4306a0260d5b131935ad82...9eb7d59665972690bea790fd1ed12eeb142c0ee4,1,1,1,2,1,2013-02-13 01:04:15,2013-02-13 01:04:15
9eb7d59665972690bea790fd1ed12eeb142c0ee4...3d6388941d231e7ae1b5a53cdf2e401b704744b5,1,0,5,5,1,2013-02-16 23:09:43,2013-02-16 19:30:55
3d6388941d231e7ae1b5a53cdf2e401b704744b5...83e512fa6e45d2c9e63735bb0c3cd8f1fcd2e616,1,4,9,13,1,2013-02-16 23:25:22,2013-02-16 23:23:39
83e512fa6e45d2c9e63735bb0c3cd8f1fcd2e616...57b62a74cb44ac3cf8b1a9d4cf75bfe953208814,1,2,2,4,1,2013-02-16 23:34:34,2013-02-16 23:31:54
57b62a74cb44ac3cf8b1a9d4cf75bfe953208814...9936fdb11d0bbf0bd242f259bfb97bbf849d16f8,13,314,175,489,37,2013-02-19 17:37:54,2013-02-09 18:32:51
9936fdb11d0bbf0bd242f259bfb97bbf849d16f8...1c60d07ba23e0350351c278ad28d0bd5aa410b40,2,108,1,109,6,2013-02-19 17:37:54,2013-02-12 04:54:53
1c60d07ba23e0350351c278ad28d0bd5aa410b40...0e7861aec73702f7933ce2a93056f7983939f0d6,2,48,2,50,4,2013-02-19 17:37:54,2013-02-04 23:57:59
0e7861aec73702f7933ce2a93056f7983939f0d6...0cc350a896f70ace18280410eb616a9197d862b0,5,82,13,95,13,2013-02-19 17:37:54,2013-02-12 10:22:41
0cc350a896f70ace18280410eb616a9197d862b0...62d5338bf208aea3e10b020d0cf65bd93dcc253f,1,51,1,52,5,2013-02-19 18:48:46,2013-02-12 22:33:38
62d5338bf208aea3e10b020d0cf65bd93dcc253f...f61f800c29e2b421a00b52c51ec513eee944d5d8,3,4,4,8,4,2013-02-19 20:17:23,2013-02-19 20:17:23
f61f800c29e2b421a00b52c51ec513eee944d5d8...5d1791ffd2ffdb70cbcf81a49cb0a7cda3fe1f46,1,5,6,11,1,2013-02-20 01:22:22,2013-02-20 01:22:22
5d1791ffd2ffdb70cbcf81a49cb0a7cda3fe1f46...4cdfb24c9847f89a332742dbc476f189de4989dc,1,1,1,2,1,2013-02-20 01:36:44,2013-02-20 01:36:44
4cdfb24c9847f89a332742dbc476f189de4989dc...3adfc3f97dc8ac5985a495b1a690b964f48ba208,1,5,0,5,1,2013-02-20 19:26:54,2013-02-20 19:26:54
3adfc3f97dc8ac5985a495b1a690b964f48ba208...67a937c2c24b7eee8be13a1d3faff595d8f45839,3,4,4,8,4,2013-02-20 19:53:27,2013-02-20 19:53:27
67a937c2c24b7eee8be13a1d3faff595d8f45839...3872bc51c966ac779f24772e24511423491ea49e,4,23,24,47,9,2013-02-20 22:03:39,2013-02-20 01:08:55
3872bc51c966ac779f24772e24511423491ea49e...0f555f813b1bc3995d19160be17c8b2cb6a440c1,1,6,0,6,1,2013-02-24 03:25:38,2013-02-24 03:25:00
0f555f813b1bc3995d19160be17c8b2cb6a440c1...db1e8bdc33a8bfa4b47a765cb2a7a66aafa52bad,1,10,94,104,4,2013-02-25 17:55:12,2013-02-19 23:19:50
db1e8bdc33a8bfa4b47a765cb2a7a66aafa52bad...52bac4ede1c825c097c7a7027c1637a7cd9cbf4d,2,2,2,4,2,2013-02-25 18:01:15,2013-02-25 18:01:15
52bac4ede1c825c097c7a7027c1637a7cd9cbf4d...97a67b26f3debc40c73f835dd17cbef98fe5d8c6,3,64,13,77,15,2013-02-25 19:18:04,2013-02-25 19:01:57
97a67b26f3debc40c73f835dd17cbef98fe5d8c6...577a27a9fc921b29c08b379116633e7b0e5a7f6b,1,1,1,2,1,2013-03-02 19:13:47,2013-02-27 20:28:55
c2055ee1610e610c372cc17c34e4e1686fcb2011...75743c189d5138e47fd139b154c42e3bb67361c8,2,14,1,15,2,2012-04-28 23:44:14,2012-04-28 23:44:14
c2055ee1610e610c372cc17c34e4e1686fcb2011...527cce80dc03b57f8654f4a5ea64a17a1b3ef7d9,6,22,8,30,6,2012-04-28 23:11:55,2012-04-28 23:11:55
577a27a9fc921b29c08b379116633e7b0e5a7f6b...843034a8d653af5b711a4ff79292e46e26717038,1,11,0,11,1,2013-03-26 17:28:55,2013-03-26 16:56:40
97c899284000df8d733f5cff7ec8e8406a455c8c...9bea85795705d015cdadc82c68b99196a8554f5c,1,2,0,2,2,2012-04-29 02:06:50,2012-04-29 01:56:25
41af26dd5338c67eda5dbd18a8fd4811aff68e47...4c6fb23dd40216604f914d4f869b40d23b13bf73,1,1,1,2,1,2013-03-28 21:11:17,2013-03-28 21:11:17
4c6fb23dd40216604f914d4f869b40d23b13bf73...d2b883483974c3a45d2f74d40df164b1ae9e00e3,1,1,1,2,1,2013-03-29 19:55:52,2013-03-29 19:31:56
d2b883483974c3a45d2f74d40df164b1ae9e00e3...fbac080691760731319cefcb62617a9dd92af0af,1,2,1,3,1,2013-03-30 12:38:42,2013-03-30 12:36:31
fbac080691760731319cefcb62617a9dd92af0af...6297673efda48e72012da5ccea59d6b55cad3eff,1,1,1,2,1,2013-05-14 00:50:37,2012-08-31 02:19:11
6297673efda48e72012da5ccea59d6b55cad3eff...528345069d8f9f3fb9350e12742fbfefb854fd29,1,1,1,2,1,2013-05-14 14:32:38,2013-05-14 10:40:33
528345069d8f9f3fb9350e12742fbfefb854fd29...e149d8ebf04415fb0bab5b1dda16ef7d196ade7c,1,1,1,2,1,2013-05-24 16:26:23,2013-05-24 13:36:17
e149d8ebf04415fb0bab5b1dda16ef7d196ade7c...1deeda5785d2f7a27ddf8df89640e96ecc9e3e88,1,1,3,4,2,2013-05-24 16:36:25,2013-05-24 16:35:20
1deeda5785d2f7a27ddf8df89640e96ecc9e3e88...227d7f63e4c1797acc3552fdfe994181636fd033,1,1,1,2,1,2013-05-28 16:00:04,2013-05-28 15:54:53
227d7f63e4c1797acc3552fdfe994181636fd033...9b5fe022153c1c9e2ad131905d9b78f5daf7fa9d,1,2,0,2,1,2013-05-30 01:52:25,2013-05-29 22:33:51
9b5fe022153c1c9e2ad131905d9b78f5daf7fa9d...c97cc85b748524d2e0d66c770d485ffeded8e950,1,9,2,11,2,2013-05-31 12:09:17,2013-05-31 12:07:40
c97cc85b748524d2e0d66c770d485ffeded8e950...e3b6fed320f6e67b7e5dc28bab610f342a81f7d7,1,13,9,22,7,2013-06-24 18:42:42,2013-06-24 17:48:23
e3b6fed320f6e67b7e5dc28bab610f342a81f7d7...e2b86571bfa3503fe43adfa92e9c9f4271a7a135,1,4,4,8,4,2013-06-24 19:00:28,2013-06-24 19:00:28
e2b86571bfa3503fe43adfa92e9c9f4271a7a135...165cc1dc2f1cda87f7da65e8a6483318d3ca12be,1,1,1,2,1,2013-06-27 07:45:58,2013-06-27 07:42:09
165cc1dc2f1cda87f7da65e8a6483318d3ca12be...7b7592cafaff9b7b06a4949465bb723541ede40a,1,9,0,9,1,2013-07-08 19:06:45,2013-07-08 19:01:37
7b7592cafaff9b7b06a4949465bb723541ede40a...e8971345b4bf0e7ce2124d033ee3385919f47309,5,31,0,31,11,2013-07-10 16:12:15,2013-07-01 17:58:04
e8971345b4bf0e7ce2124d033ee3385919f47309...288d70fccc802adabd2e20f14b3fe42591680cd4,1,2,1,3,2,2013-07-11 15:10:26,2013-07-11 15:06:34
288d70fccc802adabd2e20f14b3fe42591680cd4...6b4b18e7e217acaa35f2d45d97121105f28e3aad,1,1,1,2,1,2013-07-17 10:51:48,2013-07-17 10:50:40
6b4b18e7e217acaa35f2d45d97121105f28e3aad...dfe36f10dfecdf0ac54d0a7d3d242e5c8e69e391,2,2,2,4,2,2013-07-18 12:48:11,2013-07-18 11:53:54
dfe36f10dfecdf0ac54d0a7d3d242e5c8e69e391...eda39fe704b1b76a94f44b49949660bef2827ed2,1,1,1,2,1,2013-07-25 11:39:53,2013-07-25 10:57:49
eda39fe704b1b76a94f44b49949660bef2827ed2...f3a961f009afe4f1be4a5bb6d5c37c98c30fed41,1,20,0,20,1,2013-07-25 15:09:25,2013-07-25 12:48:22
f3a961f009afe4f1be4a5bb6d5c37c98c30fed41...ed6ec47ff72f5597d53f8c3e3ccd9ba13c360d4e,1,4,0,4,1,2013-07-31 11:09:52,2013-07-30 09:11:15
ed6ec47ff72f5597d53f8c3e3ccd9ba13c360d4e...8af0b1afd2ab0c22497baaae03a5495da9af230d,1,6,0,6,2,2013-07-31 14:14:38,2013-07-31 13:24:29
8af0b1afd2ab0c22497baaae03a5495da9af230d...b50be6857ca6779a190e8e42127512618d52591d,9,284,4,288,12,2013-08-12 18:11:10,2013-08-12 17:20:58
b50be6857ca6779a190e8e42127512618d52591d...ec67af0bd609c412b76eaa4cc89968a2a8e5ad6a,2,10,5,15,6,2013-08-13 16:00:13,2013-08-13 16:00:13
ec67af0bd609c412b76eaa4cc89968a2a8e5ad6a...30e17be1f64f5edaf9200e65748db3c8643b26ad,3,4,4,8,4,2013-08-13 16:09:05,2013-08-13 16:09:05
30e17be1f64f5edaf9200e65748db3c8643b26ad...e61e20e4979678ee4e48fba81ccd30f70a963700,3,94,0,94,3,2013-08-13 16:18:07,2013-08-13 16:16:30
e61e20e4979678ee4e48fba81ccd30f70a963700...506913cdd85fbe52eb29e62e6884b398f0ef1dc2,1,9,0,9,1,2013-08-13 16:24:46,2013-08-13 16:24:46
506913cdd85fbe52eb29e62e6884b398f0ef1dc2...d77ce64fe89fed76a3f9827c2e385ff1f1f2f8f3,1,0,62,62,1,2013-08-13 17:15:54,2013-08-13 17:15:54
d77ce64fe89fed76a3f9827c2e385ff1f1f2f8f3...0d4ef66f7cd61ebceecd1642ac2f863fb210be7a,1,1,1,2,1,2013-08-13 17:16:41,2013-08-13 17:16:28
0d4ef66f7cd61ebceecd1642ac2f863fb210be7a...08e5fcb3e641f7f0af873910117a4951fb2719b7,1,1,0,1,1,2013-08-13 20:34:52,2013-08-13 20:34:52
08e5fcb3e641f7f0af873910117a4951fb2719b7...bf611f14ec13312aa822beec72c63bd04950613c,1,3,1,4,1,2013-08-16 16:23:05,2012-04-29 16:48:43
bf611f14ec13312aa822beec72c63bd04950613c...d5da495a2edc741b6496821baa0d6bcee9dce9bb,1,5,6,11,3,2013-08-16 21:55:08,2012-12-24 01:33:44
d5da495a2edc741b6496821baa0d6bcee9dce9bb...d9dc98159d0454d74aebec3e9a763ddecea0961e,1,8,1,9,2,2013-08-17 20:12:01,2013-08-15 00:30:51
d9dc98159d0454d74aebec3e9a763ddecea0961e...7826824aef42097e265ad5132bfbff4c64762dd7,1,26,31,57,6,2013-08-17 22:45:01,2013-08-17 22:45:01
7826824aef42097e265ad5132bfbff4c64762dd7...9ab7ed9b726a2bb0eee1d89327b9bf7ea75bba38,1,1,0,1,1,2013-09-09 12:13:18,2013-07-06 02:38:33
9ab7ed9b726a2bb0eee1d89327b9bf7ea75bba38...87d2750b39f6f2d54b7047225521a44dcd37e896,2,33,0,33,3,2013-09-11 01:05:47,2013-08-28 01:06:33
87d2750b39f6f2d54b7047225521a44dcd37e896...d1dc8a0d009436c76321f0a70addf679ebf6ff56,2,26,0,26,2,2013-09-11 01:09:47,2013-08-23 10:49:37
d1dc8a0d009436c76321f0a70addf679ebf6ff56...701c1a11bc1ea94e48199f4c0711472fbcfd99c3,3,4,4,8,4,2013-09-11 01:15:38,2013-09-11 01:15:38
d20fbf46ba8dbb3339b0e79ac140e066ba3e8b02...b1be28554f583189987641c945f70f72d4450aed,1,1,1,2,1,2012-04-29 07:03:12,2012-04-29 07:03:12
701c1a11bc1ea94e48199f4c0711472fbcfd99c3...fba6af5a1ed5924f400666f6747e706a20cceadc,1,1,1,2,1,2013-09-11 11:06:09,2013-09-11 11:02:07
701c1a11bc1ea94e48199f4c0711472fbcfd99c3...3203f684e8e51cbfa1b39d7b6a56e340981ad4d5,1,2,0,2,1,2013-09-11 11:05:39,2013-09-11 11:05:39
7c27d1561e3210132576b315f0cd0603e2c1f7bd...d12d55ec26f127a09d9c133dd61dceaad2282b0e,1,18,0,18,1,2012-04-29 11:56:22,2012-04-29 11:56:22
d12d55ec26f127a09d9c133dd61dceaad2282b0e...0525f6d8bdd8cf1aafaac40c4325aceb49b3c6f8,1,2,5,7,1,2012-04-29 16:01:09,2012-04-29 16:00:41
7c27d1561e3210132576b315f0cd0603e2c1f7bd...905bd7fb44a0dbd0be0d455ab428c388714ae700,5,60,13,73,15,2012-04-29 09:51:12,2012-04-29 09:51:12
905bd7fb44a0dbd0be0d455ab428c388714ae700...02a5b41db4ff8544f93a5d9854b346a9aae4f556,3,29,47,76,6,2012-04-29 11:40:10,2012-04-29 11:40:10
02a5b41db4ff8544f93a5d9854b346a9aae4f556...9350d1d59c1a4e6a9ac246a808f55da35de0df69,2,11,4,15,4,2012-04-29 12:25:06,2012-04-29 12:25:06
9350d1d59c1a4e6a9ac246a808f55da35de0df69...5aa51fa99976ad6133dc6dbb226ecba2c65e6be2,3,52,9,61,5,2012-04-29 13:27:25,2012-04-29 10:45:46
5aa51fa99976ad6133dc6dbb226ecba2c65e6be2...3e8b40f479a02e0f8c40ef3c7dae740082478b89,9,65,35,100,23,2012-04-29 13:37:23,2012-04-29 13:37:23
3e8b40f479a02e0f8c40ef3c7dae740082478b89...a15cfb2e451feb626d141461eb058ff760bed913,3,39,45,84,21,2012-04-29 14:03:46,2012-04-29 14:03:46
434d122a74647c647f906aaabe235ae62601682d...cca302cde6b524992d89add9b9f293d86ac8fba0,2,18,1,19,2,2013-09-11 12:18:56,2013-09-11 12:17:15
cca302cde6b524992d89add9b9f293d86ac8fba0...75d2bcda10f00366e6d847f2c90db3e772433e46,2,10,3,13,6,2013-09-13 14:18:55,2013-08-02 18:46:17
75d2bcda10f00366e6d847f2c90db3e772433e46...3f3d887a6844ec2db743fee64c9e53e04d39a368,3,136,16,152,35,2013-09-15 05:49:16,2013-09-15 05:49:16
3f3d887a6844ec2db743fee64c9e53e04d39a368...3ffc7b52f8704443ef0c20f34bb50c9144898ef7,4,25,4,29,5,2013-09-15 05:53:07,2013-09-15 05:53:07
3ffc7b52f8704443ef0c20f34bb50c9144898ef7...6903d1690a92aa040adfb0c8eb37cf62e4206714,1,10,10,20,9,2013-09-15 06:02:38,2013-09-15 06:02:38
6903d1690a92aa040adfb0c8eb37cf62e4206714...629813a8041da266d7ea1a001cd46259f87a486a,1,1,1,2,1,2013-09-15 09:45:16,2013-02-15 19:11:46
629813a8041da266d7ea1a001cd46259f87a486a...efee30e6b0ea5c7bbfd4adb84c186f92edf49c13,1,1,1,2,1,2013-09-15 16:59:10,2013-09-15 16:59:10
efee30e6b0ea5c7bbfd4adb84c186f92edf49c13...ca77e38d243c5f1f1a5070cba0988d230d0bb050,6,35,16,51,12,2013-09-15 18:29:40,2013-09-15 18:14:26
ca77e38d243c5f1f1a5070cba0988d230d0bb050...0317edf0c7779902d49c6efb8242af61e5569cde,3,16,136,152,35,2013-09-24 19:19:20,2013-09-24 19:19:20
0317edf0c7779902d49c6efb8242af61e5569cde...e2403db95a494c0660ef09f94d9fca1604111be2,1,7,3,10,2,2013-09-24 19:20:19,2013-09-17 20:59:56
e2403db95a494c0660ef09f94d9fca1604111be2...037ec1054ca8c08e65307f53e5851fe50ac5e8bf,1,4,0,4,1,2013-10-09 11:44:43,2013-10-09 11:20:37
037ec1054ca8c08e65307f53e5851fe50ac5e8bf...ea04c81d372aaa1b1aebdacefc46735ef9559fb6,1,5,2,7,1,2013-10-13 17:11:59,2013-10-13 17:09:26
ea04c81d372aaa1b1aebdacefc46735ef9559fb6...c4f29c91f9ad0fc3982f785f21093ba624ead8f8,1,9,18,27,4,2013-10-21 18:03:12,2013-09-17 23:14:38
c4f29c91f9ad0fc3982f785f21093ba624ead8f8...ead7c496a4bdd0eb8e2282ce982e1292846e7c91,2,22,1,23,3,2013-10-23 00:25:20,2013-09-25 13:33:29
ead7c496a4bdd0eb8e2282ce982e1292846e7c91...6de3726423b8df4fb8ab05caa109a8c6308e6060,2,28,0,28,2,2013-10-23 12:05:05,2013-10-21 15:12:48
6de3726423b8df4fb8ab05caa109a8c6308e6060...3a46f621fe376c9fac59fd980b9c58100bcdf47c,1,1,1,2,1,2013-10-23 22:29:53,2013-10-23 22:28:41
3a46f621fe376c9fac59fd980b9c58100bcdf47c...8f36d1fd952f5bc2066a8d33721025351bf2b4ce,4,4,4,8,4,2013-10-25 04:37:26,2013-10-25 04:37:26
8f36d1fd952f5bc2066a8d33721025351bf2b4ce...11b750b031a1aabc9b0300e693d5d6c13bd1907f,1,1,1,2,1,2013-10-25 11:54:10,2013-10-25 11:54:10
11b750b031a1aabc9b0300e693d5d6c13bd1907f...d491702ed7ef704a204d358024590e5f7c2e3c47,1,1,1,2,1,2013-10-25 11:55:50,2013-10-24 09:11:52
e75bd7e51cd6fe1f02fcdb438d58770917116c8f...584e2c03376895aeb0404cc1fcc1ad24dfdbc58e,6,57,16,73,8,2012-04-29 16:25:46,2012-04-29 16:25:46
584e2c03376895aeb0404cc1fcc1ad24dfdbc58e...ee0a7c741e98214bac7eeb60b848cf099ff28836,1,3,1,4,1,2012-04-29 16:48:43,2012-04-29 16:48:43
ee0a7c741e98214bac7eeb60b848cf099ff28836...cec6bd5a59547dc97fe98975c570fc27a1e970be,26,105,1321,1426,72,2012-04-29 17:58:00,2012-04-29 17:58:00
cec6bd5a59547dc97fe98975c570fc27a1e970be...76c3314b6de15dd78eaa5c61aba1444a87084b87,1,0,2,2,2,2012-04-29 18:23:38,2012-04-29 18:06:11
76c3314b6de15dd78eaa5c61aba1444a87084b87...e7d99aa0fee232e8dd2b9a15112a56f35cea4e9b,1,10,11,21,6,2012-04-29 18:33:54,2012-04-29 18:33:54
e7d99aa0fee232e8dd2b9a15112a56f35cea4e9b...5b644a5464e9612138dd7061abd386433bdc09f0,2,54,51,105,3,2012-04-29 18:44:32,2012-04-29 18:44:32
5b644a5464e9612138dd7061abd386433bdc09f0...eefb00f30124f775ca52258ccd8549054fe8230f,4,6,48,54,6,2012-04-29 18:47:36,2012-04-29 18:45:55
eefb00f30124f775ca52258ccd8549054fe8230f...3904b74a3f2f92fefe1d39281ed683c52f2fef03,107,306,354,660,320,2012-04-29 18:57:15,2012-04-28 16:09:37
3904b74a3f2f92fefe1d39281ed683c52f2fef03...af71ce06ead0c42e3c352c4f0afd77abbc3b907d,1,5,4,9,2,2012-04-29 19:44:31,2012-04-29 19:44:31
af71ce06ead0c42e3c352c4f0afd77abbc3b907d...6ff118cdb9bb5904b8ce3021f52c4450fead49f5,4,56,57,113,37,2012-04-29 22:50:48,2012-04-29 22:50:48
d491702ed7ef704a204d358024590e5f7c2e3c47...7984b58e78f96541e48e7772be62afe2847aca24,1,3,3,6,3,2013-10-31 20:35:29,2013-10-31 20:35:29
6ff118cdb9bb5904b8ce3021f52c4450fead49f5...b719cbb901026eb86cbf691f126f8cf92b717ca4,1,13,13,26,12,2012-05-12 04:39:31,2012-04-30 01:48:30
6ff118cdb9bb5904b8ce3021f52c4450fead49f5...d5a277ba4d608284991428fc3f7d6e0dbe6f8300,2,4,4,8,4,2012-04-30 02:18:30,2012-04-30 02:18:30
d5a277ba4d608284991428fc3f7d6e0dbe6f8300...eba4197c71d152b30ddfe48e9dfbbd88f1ffd104,1,6,3,9,4,2012-04-30 07:41:59,2012-04-30 07:40:11
b149d1fcd630d307f3d921a9e20055ed98732946...848a7594748c0124a208425dbf0fd2cc861995c3,1,3,3,6,1,2013-11-02 17:18:18,2013-11-02 17:18:18
848a7594748c0124a208425dbf0fd2cc861995c3...30eb916bdb9b6b9fc881dfda919b49d036953a3b,4,16,4,20,5,2013-11-06 14:17:26,2013-11-06 14:17:26
30eb916bdb9b6b9fc881dfda919b49d036953a3b...c5d071f85a2a0642110803c945ad628d070088a0,2,4,1,5,2,2013-11-07 14:38:53,2013-11-07 14:38:53
c5d071f85a2a0642110803c945ad628d070088a0...46755c50ee770719c69a0a105183deb1046cb6af,1,2,2,4,1,2013-11-22 08:16:50,2013-03-15 18:14:01
46755c50ee770719c69a0a105183deb1046cb6af...8e8584f959dce2ad5519421dbb134f5a3014d567,1,0,14,14,1,2013-11-23 13:47:09,2013-11-23 13:47:09
8e8584f959dce2ad5519421dbb134f5a3014d567...23126866ecf3b6375a7c59d5623801fc9b4aee2b,2,3,0,3,3,2013-12-02 18:45:56,2013-12-02 17:21:48
23126866ecf3b6375a7c59d5623801fc9b4aee2b...2d4f399ad40c63bbfd7917a9f2006f4ebb495099,1,4,0,4,2,2013-12-04 15:52:30,2013-12-04 15:46:56
2d4f399ad40c63bbfd7917a9f2006f4ebb495099...474e7dd6d08105fce66d7f62670a6c120c0b1198,1,6,0,6,1,2013-12-11 19:49:22,2013-12-11 17:28:05
474e7dd6d08105fce66d7f62670a6c120c0b1198...2c1d92bc64eb5d768d7ac1cc91a4f9d1c2d76f43,1,253,34,287,47,2014-01-02 12:39:00,2014-01-02 12:39:00
2c1d92bc64eb5d768d7ac1cc91a4f9d1c2d76f43...1036e3ec7c7d7f99e3d9138e8f461c2cc690e03c,1,11,64,75,3,2014-01-17 14:29:57,2014-01-17 14:21:34
1036e3ec7c7d7f99e3d9138e8f461c2cc690e03c...03d9b9ea0af403bf27ce552b9f8262b47bfdff0e,1,14,0,14,1,2014-01-19 17:46:57,2013-09-07 17:46:42
03d9b9ea0af403bf27ce552b9f8262b47bfdff0e...85057522bc220585363e637528d970d3802475e8,1,4,2,6,4,2014-01-24 14:05:59,2014-01-24 13:52:43
85057522bc220585363e637528d970d3802475e8...257f8528b722ea943b2f2113fc2135743e2d80dc,1,90,29,119,34,2014-01-26 20:52:39,2014-01-26 20:52:39
257f8528b722ea943b2f2113fc2135743e2d80dc...74181c0a2c5eb52c63666f830403c9331fc1ad69,2,9,0,9,2,2014-01-26 22:50:12,2014-01-26 22:48:28
74181c0a2c5eb52c63666f830403c9331fc1ad69...b8713ee69a7a171a01cf94c56d3b83bc09e41506,1,1,1,2,1,2014-03-05 21:35:37,2013-10-01 14:08:36
b8713ee69a7a171a01cf94c56d3b83bc09e41506...f108b1f7d79526fb2fc0a6ff212744cffb399d15,1,11,1,12,2,2014-03-22 10:19:58,2014-03-22 10:14:15
f108b1f7d79526fb2fc0a6ff212744cffb399d15...f2a9f715657105306e6cf0b978be60bb6f745c8a,2,26,12,38,7,2014-03-24 11:35:13,2014-03-24 11:33:04
f2a9f715657105306e6cf0b978be60bb6f745c8a...83420e70ef98c015207f8a49bd35ebb098ac6df5,1,3,4,7,1,2014-04-19 17:01:52,2014-04-19 17:01:52
83420e70ef98c015207f8a49bd35ebb098ac6df5...ca3927dfb946cf7de2fbd1d85ce9433f02069eba,1,1,1,2,1,2014-04-21 17:21:14,2014-04-21 14:48:33
ca3927dfb946cf7de2fbd1d85ce9433f02069eba...c1a8c420fe4b27fb2caf5e46d23b5712fc0ac535,5,51,2,53,13,2014-04-21 22:31:44,2014-04-20 17:35:24
c1a8c420fe4b27fb2caf5e46d23b5712fc0ac535...1170f285ddd6a94a65f911a27788ba49ca08c0b0,2,36,1,37,7,2014-04-21 22:31:44,2014-04-20 20:32:09
1170f285ddd6a94a65f911a27788ba49ca08c0b0...aa80f498de6d687e613860933ac58433ab71ea4b,6,154,2,156,11,2014-04-21 22:31:44,2014-04-20 20:32:48
aa80f498de6d687e613860933ac58433ab71ea4b...80109083136d7d633810d765b74e4c3018434010,1,105,3,108,2,2014-04-21 22:31:44,2014-04-21 10:53:34
80109083136d7d633810d765b74e4c3018434010...194159ba443645947e1a86bfd12e28dc78022521,3,4,4,8,4,2014-04-21 22:38:26,2014-04-21 22:38:26
194159ba443645947e1a86bfd12e28dc78022521...1edb163592a21975d69aaca3215678f192421b71,1,1,1,2,1,2014-04-22 15:50:20,2014-04-22 15:50:20
1edb163592a21975d69aaca3215678f192421b71...b91c385e324f1cb94d20e2ad146372c259d51d3b,5,34,1,35,8,2014-04-23 13:22:02,2014-04-23 13:22:02
b91c385e324f1cb94d20e2ad146372c259d51d3b...b1b680c8fe3fcfdc934971c9860f0b8644defdc7,3,4,4,8,4,2014-04-28 20:28:15,2014-04-28 20:28:15
b1b680c8fe3fcfdc934971c9860f0b8644defdc7...48a4729cd75321b5410839abd690207aa00f0169,1,1,1,2,1,2014-04-28 23:03:36,2014-04-28 23:03:36
48a4729cd75321b5410839abd690207aa00f0169...e1812617cf534b00230e38af118194d8bf0b48b6,1,1,1,2,1,2014-04-28 23:07:51,2014-04-28 23:06:25
e1812617cf534b00230e38af118194d8bf0b48b6...28e23306aa53bbbb8fb87db85f99d970b051026c,3,0,100,100,3,2014-05-12 13:46:22,2014-05-12 13:46:22
28e23306aa53bbbb8fb87db85f99d970b051026c...7feb54bbae3f637ab3c4dd4831d4385964f574df,3,50,4,54,9,2014-05-12 13:46:40,2014-05-12 13:46:40
7feb54bbae3f637ab3c4dd4831d4385964f574df...fe5b3e36a2734581add6cfc11f55eb667887f092,2,48,0,48,2,2014-05-14 16:07:32,2014-05-14 16:07:32
fe5b3e36a2734581add6cfc11f55eb667887f092...53b98b5a7cd7febc97add511c36d91285e03d86a,3,4,4,8,4,2014-05-14 16:09:51,2014-05-14 16:09:51
53b98b5a7cd7febc97add511c36d91285e03d86a...37d6821d35074ccbf1b0deeeb03561b07dbafd45,1,1,1,2,1,2014-05-14 16:24:08,2014-05-14 16:24:02
37d6821d35074ccbf1b0deeeb03561b07dbafd45...d39fcff11a152e37fbc9a0fb34216415ef2a03da,1,9,9,18,10,2014-05-15 11:17:54,2014-05-15 11:11:29
d39fcff11a152e37fbc9a0fb34216415ef2a03da...d29f3b9e878c10417d66e1542ac52fe2ca242cf8,1,1,2,3,2,2014-06-18 18:38:30,2014-06-18 18:35:38
d29f3b9e878c10417d66e1542ac52fe2ca242cf8...b44519072e8a0ef56a0ae9e6e4a1fb04273eb0eb,3,50,3,53,4,2014-07-14 15:38:00,2014-07-08 19:58:14
b44519072e8a0ef56a0ae9e6e4a1fb04273eb0eb...aa9c45c2e425662d980cca82974da0986fdbe406,3,3,50,53,4,2014-07-15 00:09:38,2014-07-15 00:09:38
aa9c45c2e425662d980cca82974da0986fdbe406...778a5553426965d96e3118e438a28ae3cbd209d0,1,1,0,1,1,2014-07-25 13:46:15,2014-07-25 13:46:15
778a5553426965d96e3118e438a28ae3cbd209d0...bc03817b42900c24643aaa086cbbf41d96c08dde,1,1,1,2,1,2014-08-02 17:01:23,2014-08-02 17:01:23
bc03817b42900c24643aaa086cbbf41d96c08dde...d23d19c15eb816cc0c7ff1831fee050779db9873,1,2,2,4,1,2014-08-06 12:30:49,2014-08-06 12:28:51
d23d19c15eb816cc0c7ff1831fee050779db9873...399052d224143c3dbd7e7bbbff14ff577881c669,1,2,12,14,2,2014-08-08 16:47:31,2014-08-08 16:45:18
399052d224143c3dbd7e7bbbff14ff577881c669...88cb7aa6aa2272b02aa3914111083c4cd3094f1b,1,19,7,26,4,2014-08-11 11:11:30,2014-08-07 13:20:59
88cb7aa6aa2272b02aa3914111083c4cd3094f1b...4d5e972a2c9f3e2f6ce115f7fbe44df8dd8612ef,2,8,0,8,2,2014-08-11 12:47:06,2014-08-05 19:20:05
4d5e972a2c9f3e2f6ce115f7fbe44df8dd8612ef...c2fe73133b62a1d9e8f7a6b43966570b14618d7e,4,21,0,21,4,2014-08-11 13:04:23,2014-07-17 19:59:28
c2fe73133b62a1d9e8f7a6b43966570b14618d7e...30042d475bf084c6723c6217a21598d9247a9c41,6,75,28,103,25,2014-08-11 14:14:06,2014-08-08 14:20:08
30042d475bf084c6723c6217a21598d9247a9c41...c9e3b9949cd55f090591fbdc4a114fcb8368b6d9,3,52,3,55,6,2014-08-11 16:15:06,2014-08-11 16:04:53
c9e3b9949cd55f090591fbdc4a114fcb8368b6d9...027bd348642007617518379f8b02546abacaa6e0,5,61,5,66,10,2014-08-11 20:01:41,2014-08-11 19:36:16
027bd348642007617518379f8b02546abacaa6e0...4fce0193d21b893f0ba186b10cfcdd6350fa5865,3,4,4,8,4,2014-08-20 20:00:40,2014-08-20 20:00:40
4fce0193d21b893f0ba186b10cfcdd6350fa5865...e484df76b68ea8b23e5d6d07d61d408c8d756931,1,1,1,2,1,2014-08-20 20:33:50,2014-08-20 20:31:45
e484df76b68ea8b23e5d6d07d61d408c8d756931...27c682ffa08264dee63c82751ebfa9d8eeaf62df,1,1,1,2,1,2014-08-20 20:36:42,2014-08-20 20:36:24
27c682ffa08264dee63c82751ebfa9d8eeaf62df...8adc56ca78fa362dc59de81b641e6d65b6abf289,2,2,2,4,2,2014-08-26 13:45:06,2014-08-26 13:44:24
8adc56ca78fa362dc59de81b641e6d65b6abf289...4685026840f0e2b895f980b6a33ad1b282aa7852,6,51,5,56,8,2014-08-28 02:12:37,2014-08-21 15:55:23
4685026840f0e2b895f980b6a33ad1b282aa7852...0517f498cd74fc52acec59fa97d442b344e4f4a9,3,4,4,8,4,2014-09-02 20:43:24,2014-09-02 20:43:24
0517f498cd74fc52acec59fa97d442b344e4f4a9...89157fe11fce1bcb69a871b04f8f371dc83cc9a1,1,1,1,2,1,2014-09-03 01:07:29,2014-09-03 01:07:29
89157fe11fce1bcb69a871b04f8f371dc83cc9a1...78085844a7b728fab156ce85bf3463e79cf85b98,1,1,1,2,1,2014-09-03 01:36:44,2014-09-03 01:34:29
78085844a7b728fab156ce85bf3463e79cf85b98...065caafa70b6c422f73e364a4c241b6538969d7b,6,55,4,59,10,2014-09-08 18:22:29,2014-09-04 21:04:53
065caafa70b6c422f73e364a4c241b6538969d7b...ba2be2761341a6b3d8d578f16c92fa278c0a42bc,3,24,13,37,6,2014-09-11 18:54:33,2013-03-13 08:50:45
ba2be2761341a6b3d8d578f16c92fa278c0a42bc...3132edae41dbb13b924e98e8f0254e847155a050,1,4,4,8,2,2014-09-17 07:26:45,2014-09-17 03:30:11
3132edae41dbb13b924e98e8f0254e847155a050...df657a768248c07fdbdc950b08366f655d0f2f5d,1,1,1,2,1,2014-09-29 23:47:33,2014-09-29 23:31:29
df657a768248c07fdbdc950b08366f655d0f2f5d...f58392d8d8b68e2e7777768f39941cd995ce16e4,5,25,3,28,7,2014-10-06 13:08:45,2014-10-05 18:06:51
f58392d8d8b68e2e7777768f39941cd995ce16e4...643374bcf544dbcd1091539a9f3c832b5440fee2,1,0,5,5,1,2014-10-10 19:22:46,2014-10-10 19:18:54
643374bcf544dbcd1091539a9f3c832b5440fee2...a92e386e2622fa16cc49debc840357b711d8a38f,1,1,1,2,1,2014-10-22 16:25:45,2014-10-22 16:23:21
a92e386e2622fa16cc49debc840357b711d8a38f...151d6dbf9c04539bf557af7b380e2a941b7745e4,3,4,4,8,4,2014-10-22 16:36:19,2014-10-22 16:36:19
151d6dbf9c04539bf557af7b380e2a941b7745e4...486b6ca3bc50c112ffd17e0f57bfe779a930eff3,1,1,1,2,1,2014-10-22 17:33:07,2014-10-22 17:33:07
486b6ca3bc50c112ffd17e0f57bfe779a930eff3...a1dcd82b28c9c9ddb9fb790e7be7120ba339cd2e,3,189,62,251,36,2014-11-05 02:30:21,2014-11-05 01:38:38
a1dcd82b28c9c9ddb9fb790e7be7120ba339cd2e...c83b024b37a448e3eece766a435cf148c806a22d,1,0,4,4,1,2014-11-13 10:36:21,2014-11-13 09:30:36
c83b024b37a448e3eece766a435cf148c806a22d...5940da16afb314c52cf52d4aebfedb77c6cc886b,5,42,21,63,20,2014-11-25 19:04:56,2014-11-16 15:42:09
5940da16afb314c52cf52d4aebfedb77c6cc886b...a25c444bc701b496f2b05f57fc3ec42cdac9dd85,2,85,21,106,18,2015-01-02 18:38:58,2015-01-02 17:35:41
a25c444bc701b496f2b05f57fc3ec42cdac9dd85...35dc639cd62e86a3e50fd0e305e12c42746d4891,1,1,1,2,1,2015-01-03 00:23:14,2015-01-03 00:20:18
35dc639cd62e86a3e50fd0e305e12c42746d4891...592187e11b934f83153133cd5b3a246a881359e7,3,4,4,8,4,2015-01-03 02:07:00,2015-01-03 02:07:00
592187e11b934f83153133cd5b3a246a881359e7...52136afda4fa085189cb0655c60e44287706d273,1,1,1,2,1,2015-01-03 02:49:44,2015-01-03 02:49:44
52136afda4fa085189cb0655c60e44287706d273...032ffade8acf6f79ff4cc7632d10df4619c32b72,1,2,5,7,2,2015-01-03 03:01:51,2015-01-03 03:01:51
032ffade8acf6f79ff4cc7632d10df4619c32b72...2fd8054fda5b8ec304d675f82f4bd80c16e3fd95,3,35,84,119,19,2015-01-05 18:41:06,2015-01-05 18:13:34
2fd8054fda5b8ec304d675f82f4bd80c16e3fd95...113a8980f4f85c2013c7c4bd962daa463ec03554,1,2,1,3,1,2015-01-05 18:42:52,2014-11-25 22:06:31
113a8980f4f85c2013c7c4bd962daa463ec03554...4f6fffc1dc429f1ad428ecf8e6620739e8837450,3,102,0,102,3,2015-01-05 18:43:15,2014-09-10 17:06:19
4f6fffc1dc429f1ad428ecf8e6620739e8837450...4c241f1b710da6419d9dca160e80b23b82db7758,3,19,3,22,5,2015-01-05 18:43:32,2014-12-03 21:14:00
4c241f1b710da6419d9dca160e80b23b82db7758...d020da6646c5142bc092247d218a3d1ce3e993f7,4,39,10,49,9,2015-01-05 18:43:54,2014-12-09 20:32:03
d020da6646c5142bc092247d218a3d1ce3e993f7...88b7957b34b2305ece54a3aab57a87701279a1d8,1,1,1,2,1,2015-01-13 18:10:54,2015-01-13 18:08:57
88b7957b34b2305ece54a3aab57a87701279a1d8...bd9dcd226b5b11fa40668553d26ce06000b3be75,3,4,4,8,4,2015-01-13 18:14:08,2015-01-13 18:14:08
bd9dcd226b5b11fa40668553d26ce06000b3be75...4296a1da8b2acf118814669fa045a3c353c8892e,1,1,1,2,1,2015-01-13 19:16:07,2015-01-13 19:16:07
4296a1da8b2acf118814669fa045a3c353c8892e...99e6ac77f2b5c701896dd83ce99ff12278cdbeef,1,2,1,3,1,2015-01-14 18:57:59,2015-01-14 18:46:15
99e6ac77f2b5c701896dd83ce99ff12278cdbeef...9435474068c2ae2261105adbbe7aebdb80b778f3,1,5,1,6,1,2015-01-19 17:09:43,2015-01-19 17:08:20
9435474068c2ae2261105adbbe7aebdb80b778f3...1e39d0f6280abf34c7719db5e7ed1c333f5e5919,5,80,8,88,11,2015-01-27 00:22:47,2015-01-25 22:22:46
1e39d0f6280abf34c7719db5e7ed1c333f5e5919...7dd4c5221a0975165c95142ba749553c7d7cff32,4,5,5,10,5,2015-01-27 16:55:02,2015-01-27 16:54:46
7dd4c5221a0975165c95142ba749553c7d7cff32...4376d6ef7bc451278abc81476ea3d59f1fa63544,1,1,1,2,1,2015-01-27 17:26:26,2015-01-27 17:26:26
4376d6ef7bc451278abc81476ea3d59f1fa63544...e60557c249d33e100008cc30890cde2daeb677bb,3,66,101,167,6,2015-01-28 17:32:15,2015-01-28 17:03:05
e60557c249d33e100008cc30890cde2daeb677bb...785e57e296ed8f920789eb120da80944ff4f17fd,1,1,1,2,2,2015-02-07 03:20:02,2015-02-07 03:20:02
785e57e296ed8f920789eb120da80944ff4f17fd...3b20558beb6abef0b53f3c8e4ca6b598219f1d0d,2,8,0,8,2,2015-03-18 12:39:12,2015-03-04 12:49:12
3b20558beb6abef0b53f3c8e4ca6b598219f1d0d...2342693b31f740a422abf7267c53b4e7bc487c1b,3,30,2,32,6,2015-03-18 12:39:37,2015-03-10 00:05:13
2342693b31f740a422abf7267c53b4e7bc487c1b...5388692144973ca17ea09612c92dd0b75207f642,3,4,4,8,4,2015-03-18 12:43:42,2015-03-18 12:43:42
5388692144973ca17ea09612c92dd0b75207f642...b2a7878c109e619b6eeefaabb43f815f508b7f6e,1,1,1,2,1,2015-03-19 00:22:09,2015-03-19 00:22:09
04785d2697b05186362b8d430c06109cdb91c069...9a7261f688a02d9751c863804ca0c7612e67f51c,1,1,1,2,1,2012-05-18 21:56:40,2012-05-18 21:56:40
eba4197c71d152b30ddfe48e9dfbbd88f1ffd104...96af6918351564fd527b2f7d4ebebb914dd781bc,1,1,1,2,1,2012-04-30 11:52:37,2012-04-30 11:52:37
eba4197c71d152b30ddfe48e9dfbbd88f1ffd104...a18e43c5bb8cb7c82c84ca1b42d847a62ac9f077,7,66,56,122,18,2012-04-30 11:30:29,2012-04-30 11:05:30
2aebd79a9c20717e19a9cfbc2e61a778c88e8051...1a66f53f9413583d1da266356bb35e5f82868641,2,4,9,13,3,2012-05-19 10:10:22,2012-05-19 10:10:22
1a66f53f9413583d1da266356bb35e5f82868641...078ea51b1c7504e3f941bc1d96b0499ace29bdb0,1,25,25,50,6,2012-05-19 10:32:59,2012-05-19 10:32:59
078ea51b1c7504e3f941bc1d96b0499ace29bdb0...822d6d6dabc959532fb2904376580e8947c519f6,11,72,54,126,45,2012-05-19 11:51:54,2012-05-19 11:51:54
822d6d6dabc959532fb2904376580e8947c519f6...38408f8007eae21b9f1cbbcc7f86d4b2042ff86a,44,296,295,591,227,2012-05-19 15:43:34,2012-05-19 15:43:34
38408f8007eae21b9f1cbbcc7f86d4b2042ff86a...4b58e94f271790675782f617288d915169e99654,1,1,1,2,1,2012-05-19 21:33:38,2012-05-19 21:31:38
4b58e94f271790675782f617288d915169e99654...35e65855680be2c8a495ec926c7eaf992c79edc0,3,3,0,3,3,2012-05-19 22:25:46,2012-05-19 22:24:21
35e65855680be2c8a495ec926c7eaf992c79edc0...b0c1e5c081472436bf2300af3073cef1df1bd696,1,8,0,8,1,2012-05-20 09:58:00,2012-05-20 09:58:00
b0c1e5c081472436bf2300af3073cef1df1bd696...03f86a5adb930eac55dea1e903fb958c002d5bc4,5,31,17,48,17,2012-05-20 11:18:42,2012-05-20 11:18:42
03f86a5adb930eac55dea1e903fb958c002d5bc4...23b941845887e3b967d76cb115d3bc51e7310b71,2,11,12,23,2,2012-05-20 16:23:14,2012-05-20 16:23:14
23b941845887e3b967d76cb115d3bc51e7310b71...6ed7d40727f70934df6ab0ac96f5f1c4f01c534f,2,122,52,174,16,2012-05-21 23:28:58,2012-05-21 23:28:58
6ed7d40727f70934df6ab0ac96f5f1c4f01c534f...ed7ea5a6020cb3e09a7f05c4206a11196766bbd2,2,2,2,4,2,2012-05-22 11:15:28,2012-05-22 11:13:44
ed7ea5a6020cb3e09a7f05c4206a11196766bbd2...cafa5bf4f48df500b7c191b01f4ae73f527e6166,1,2,2,4,2,2012-05-22 11:22:45,2012-05-22 11:22:45
cafa5bf4f48df500b7c191b01f4ae73f527e6166...115d522c84d85c99b2a154e29174d95380eaf0c1,1,13,3,16,1,2012-05-22 11:43:58,2012-05-22 11:43:58
115d522c84d85c99b2a154e29174d95380eaf0c1...6219591f2e5ac725e30b1583ef7fd28063d2ad75,1,2,0,2,1,2012-05-22 11:56:03,2012-05-22 11:56:03
6219591f2e5ac725e30b1583ef7fd28063d2ad75...d5c7f9efc3702888b556cbf932116421b464e8b8,3,25,4,29,4,2012-05-22 17:59:33,2012-05-12 10:01:45
d5c7f9efc3702888b556cbf932116421b464e8b8...df7a65ac4ba36dd155e80b8bcfe607390976ad47,2,4,2,6,4,2012-05-22 18:37:38,2012-05-22 18:26:46
df7a65ac4ba36dd155e80b8bcfe607390976ad47...459c3b67b7a9aeb96c9a2d57b18c0987c02f2369,1,1,1,2,1,2012-05-22 20:16:24,2012-05-22 20:01:24
459c3b67b7a9aeb96c9a2d57b18c0987c02f2369...8ee1a664f9ef127bc488b03f478e8ba2f0dc7f19,1,7,4,11,4,2012-05-22 20:33:42,2012-05-22 20:30:24
8ee1a664f9ef127bc488b03f478e8ba2f0dc7f19...0df4593f0edb8508eceff96ce5aebc59a073b506,3,7,8,15,5,2012-05-22 20:51:05,2012-05-22 20:46:27
0df4593f0edb8508eceff96ce5aebc59a073b506...817535d73e57d0930fd5294387fca17bc0257515,3,6,7,13,7,2012-05-23 10:20:03,2012-05-23 10:20:03
817535d73e57d0930fd5294387fca17bc0257515...f1ebcdc7c2140eca632ed64296ec4e0893feb136,1,25,31,56,19,2012-05-24 07:52:06,2012-05-24 07:52:06
f1ebcdc7c2140eca632ed64296ec4e0893feb136...f4abba5200e3164003781698c0854383bbc210be,3,11,1,12,3,2012-05-24 07:57:22,2012-05-24 07:57:22
f4abba5200e3164003781698c0854383bbc210be...3b2993ed04f200a89c2d49590131c97c8974e9ac,4,49,5,54,9,2012-05-24 11:02:19,2012-05-24 11:02:19
3b2993ed04f200a89c2d49590131c97c8974e9ac...1e6c3368f2517f32b0651d68277ea8c9ef81d9b2,7,243,31,274,21,2012-05-24 11:25:01,2012-05-24 11:25:01
1e6c3368f2517f32b0651d68277ea8c9ef81d9b2...2daf1ae8b9676c809ed948202cbd7bec4dd62740,1,2,4,6,1,2012-05-24 11:51:18,2012-05-24 11:47:40
2daf1ae8b9676c809ed948202cbd7bec4dd62740...8c72aa237918e31a525022f72b22cac75451af86,3,31,5,36,6,2012-05-24 15:42:06,2012-05-23 20:25:23
8c72aa237918e31a525022f72b22cac75451af86...2042f537a6d7d67bdf65ca322aad1c6124e07527,2,2,4,6,4,2012-05-24 21:55:50,2012-05-24 21:55:39
2042f537a6d7d67bdf65ca322aad1c6124e07527...323b414441e13681c2a4117dc7043926f938f48a,1,33,0,33,1,2012-05-25 11:10:45,2012-05-25 11:00:42
323b414441e13681c2a4117dc7043926f938f48a...e73838b6ddcc7b37c03f9eee04fa6e6a283fedb3,5,93,81,174,40,2012-05-25 17:03:15,2012-05-25 17:03:15
e73838b6ddcc7b37c03f9eee04fa6e6a283fedb3...edfa95c22ffe8f58060bb985ad1b6fbca9506f5e,6,22,20,42,20,2012-05-25 18:43:43,2012-05-25 18:37:38
edfa95c22ffe8f58060bb985ad1b6fbca9506f5e...ce8f874b88942863be17b4ee02bb27632cc0e65e,3,28,1,29,6,2012-05-25 19:00:44,2012-05-25 19:00:44
ce8f874b88942863be17b4ee02bb27632cc0e65e...45284a90a515e71552f37c539a3cfdc38f15d869,8,25,24,49,21,2012-05-25 19:49:47,2012-05-25 19:13:51
45284a90a515e71552f37c539a3cfdc38f15d869...c2139bbcefb2249bdf1012f843f7daa6a5806922,1,1,1,2,1,2012-05-25 22:02:15,2012-05-25 22:02:15
c2139bbcefb2249bdf1012f843f7daa6a5806922...3b5083bee5e96539dec599106aece9889e70ce05,6,75,40,115,27,2012-05-26 09:43:37,2012-05-26 09:43:37
3b5083bee5e96539dec599106aece9889e70ce05...12f4bd74fcc4b6907241ca460bc406665430569d,1,0,1,1,1,2012-05-26 09:53:33,2012-05-26 09:53:33
12f4bd74fcc4b6907241ca460bc406665430569d...fb871f66a8a9cbf2a908725360290914ea3f59da,1,3,0,3,1,2012-05-26 14:15:45,2012-05-26 14:15:45
fb871f66a8a9cbf2a908725360290914ea3f59da...7a4233b69c3a4f4ff023bb58ed30f9f7307d7cd2,1,0,19,19,1,2012-05-26 14:42:28,2012-05-26 14:42:28
7a4233b69c3a4f4ff023bb58ed30f9f7307d7cd2...a8a81aae20a81e012fddc24f3ede556501af64a2,4,52,24,76,11,2012-05-27 15:11:13,2012-05-26 23:08:44
a8a81aae20a81e012fddc24f3ede556501af64a2...4423757c0c50afbe2470434778c8d5e5b4a70925,2,17,2,19,5,2012-05-27 15:45:08,2012-05-27 15:24:35
4423757c0c50afbe2470434778c8d5e5b4a70925...f2b6763ad7cb281ca8699a9c3d532a82f965be4f,7,56,44,100,22,2012-05-27 18:38:47,2012-05-26 18:50:44
f2b6763ad7cb281ca8699a9c3d532a82f965be4f...cc4b4d9fd34d9b601de0bafaa3c1f249729fa49a,2,14,11,25,5,2012-05-27 21:03:21,2012-05-27 21:03:21
cc4b4d9fd34d9b601de0bafaa3c1f249729fa49a...c3b56c7cdde661464da4aaa72cafb11c9260d754,1,6,17,23,4,2012-05-27 21:11:27,2012-05-27 21:11:27
c3b56c7cdde661464da4aaa72cafb11c9260d754...a768b1d94a708a06be67619e72149d5bb6d286e5,1,58,53,111,52,2012-05-28 09:15:31,2012-05-28 09:15:31
a768b1d94a708a06be67619e72149d5bb6d286e5...a535040bfac30766cb475054dac5a6359073e48b,1,11,19,30,3,2012-05-28 09:55:38,2012-05-28 09:55:38
c09f6ff0a58d016eeb7536f1df1fa956f94f671c...e4d4cb6130b046d145ab1069df0c04d78786eedd,1,12,18,30,4,2012-04-30 12:45:25,2012-04-30 12:45:25
b4b8977814071bc0d624524404d08ff632b38d55...5c59e43aef288d2f7adcaac4c0ae7692d6c01ba3,1,1,1,2,1,2012-05-31 14:33:45,2012-05-31 14:33:45
b4b8977814071bc0d624524404d08ff632b38d55...aa1aa1ad410c640ff22260b9c6bf3c36be98ff8e,1,1,1,2,1,2012-04-30 14:15:36,2012-04-30 14:15:36
aa1aa1ad410c640ff22260b9c6bf3c36be98ff8e...4b11762f7d7aed2f4f36c4158326c0a4332038f9,2,13,3,16,3,2012-04-30 14:19:55,2012-04-30 14:12:38
a535040bfac30766cb475054dac5a6359073e48b...28e424532fdeaf05053e1b531eeacbfa831af1fb,1,2,2,4,2,2012-05-28 19:13:09,2012-05-28 19:13:09
a535040bfac30766cb475054dac5a6359073e48b...432339a72c20f78abf1999892a39c71b5d853174,4,22,2,24,6,2012-05-28 18:03:34,2012-05-28 18:03:34
3d842a0a94e413185b9abb87e7b3da7c27b6d7ad...fe43ad5707d116bb1729bc17a24ca16c90ae040d,1,1,1,2,1,2012-04-30 15:50:32,2012-04-30 15:50:32
6799ffad9a4c7cd22c86c8e3cfdb8e55ad85cdc3...0199bdc0b411d4aba0173053417bbeea8224b26b,1,10,13,23,2,2012-06-04 20:41:05,2012-06-04 19:31:23
0199bdc0b411d4aba0173053417bbeea8224b26b...840ffd80baad85c05670d6b642f654cffaa93cc3,1,3,2,5,2,2012-06-04 20:41:05,2012-06-04 19:39:57
4b28ea37e52e18720c1c2a6ad611dee986126dd5...2626ea4a74d09642a50c3fb30944513b68dda289,2,14,2,16,6,2012-05-31 08:02:35,2012-05-31 07:59:58
2626ea4a74d09642a50c3fb30944513b68dda289...473c272246dcb7cb2ea528e6405a465f16e82764,1,51,104,155,15,2012-05-31 14:24:37,2012-05-31 14:24:37
473c272246dcb7cb2ea528e6405a465f16e82764...0dc904979d5b6df78662653d498c91f4d54f36c2,2,26,31,57,20,2012-05-31 14:46:07,2012-05-31 14:46:07
0dc904979d5b6df78662653d498c91f4d54f36c2...4553f511557052d6f18811807ae6136f81fa86a3,2,1021,1021,2042,2,2012-05-31 15:21:13,2012-05-31 15:21:13
4553f511557052d6f18811807ae6136f81fa86a3...ea4e0aad9efd691aa200bf7bbabd282267234b3a,2,13,31,44,12,2012-05-31 15:43:21,2012-05-31 15:41:31
ea4e0aad9efd691aa200bf7bbabd282267234b3a...ba10be70322027074e5f9defc1423eb0cc77473c,7,31,10,41,20,2012-05-31 16:03:49,2012-05-10 21:09:29
fe43ad5707d116bb1729bc17a24ca16c90ae040d...596cb9c7e287abbb98c64974fb4944d522cb6b5a,61,310,310,620,268,2012-04-30 18:45:03,2012-04-28 16:02:01
596cb9c7e287abbb98c64974fb4944d522cb6b5a...78ba9670af373f5261f95d6560bfd08425adcaad,6,239,51,290,44,2012-04-30 18:48:19,2012-04-30 18:41:38
78ba9670af373f5261f95d6560bfd08425adcaad...ddfc7c2530197112fb105b6dd237574bc2fd6b49,2,5,5,10,3,2012-04-30 19:01:06,2012-04-30 19:01:06
fe43ad5707d116bb1729bc17a24ca16c90ae040d...1f0f686852f056deee4f8b340f9888a3bfc392db,1,1,0,1,1,2012-04-30 16:57:51,2012-04-30 16:57:51
1f0f686852f056deee4f8b340f9888a3bfc392db...f5a80f58e1848aefe6688d93b08b33457b370799,1,1,1,2,2,2012-04-30 21:24:57,2012-04-30 21:24:57
840ffd80baad85c05670d6b642f654cffaa93cc3...e1643e3535c4160c1a56c80f4d4db9848dc65e7a,4,20,9,29,8,2012-06-07 15:52:12,2012-06-07 15:34:25
ba10be70322027074e5f9defc1423eb0cc77473c...f6fc83c97514ced9de48ca9ea442a9b166d3e211,2,9,1,10,2,2012-05-31 18:45:35,2012-05-31 18:45:35
ddfc7c2530197112fb105b6dd237574bc2fd6b49...6ac8afc3f927f5e41c84dcc16c56ff6458338d87,1,1,0,1,1,2012-05-01 03:10:51,2012-05-01 03:10:51
ddfc7c2530197112fb105b6dd237574bc2fd6b49...2a09404792f9d369718143fdfbe9530fe2e60912,1,9,0,9,3,2012-04-30 19:10:27,2012-04-30 18:35:04
2a09404792f9d369718143fdfbe9530fe2e60912...8fad77da9597e0dd9fca1eaa3a7b605f76501872,15,74,11,85,73,2012-04-30 19:10:27,2012-04-30 18:38:44
8fad77da9597e0dd9fca1eaa3a7b605f76501872...0819957eda318205e17591dccd81482701eab25c,1,6,0,6,1,2012-04-30 19:10:27,2012-04-30 18:40:02
583f1d74256861994543f060290ee73020be35da...4fdd378beb81a86d826d7ee83c7d2250ed958be1,3,11,8,19,6,2012-05-01 05:40:04,2012-05-01 05:40:04
4fdd378beb81a86d826d7ee83c7d2250ed958be1...46b082e05ccedffeb623028caf70adbaba7bce6f,3,26,2,28,6,2012-05-01 09:29:55,2012-05-01 08:40:25
46b082e05ccedffeb623028caf70adbaba7bce6f...80c0cbf1c97047daed2c5b41b296bbc56fe1d7e3,1,9,3,12,1,2012-05-01 09:29:55,2012-05-01 09:29:20
80c0cbf1c97047daed2c5b41b296bbc56fe1d7e3...aaa3382fdc35bfa5e26c029225a2eb190da66b79,1,1,1,2,1,2012-05-01 18:33:50,2012-05-01 18:33:50
aaa3382fdc35bfa5e26c029225a2eb190da66b79...435081fd22cec08d98ccbf1efcd223ccaa634ecd,1,15,11,26,7,2012-05-01 20:23:17,2012-05-01 20:23:17
23d230f05833a63e951b8f451ff6c9f570eb3208...329bb9296f402c6e7d7b648937b72b13a6f5756c,8,199,151,350,76,2012-06-08 09:26:22,2012-06-08 09:26:22
329bb9296f402c6e7d7b648937b72b13a6f5756c...1f203f84d01508345997f921bc9feed8b4ff2fc5,1,6,0,6,1,2012-06-08 09:40:33,2012-06-08 09:40:33
1f203f84d01508345997f921bc9feed8b4ff2fc5...d2ad3b0f962909c14eab2ffda2fa66740f434c79,2,19,10,29,5,2012-06-08 09:53:54,2012-06-08 09:53:54
d2ad3b0f962909c14eab2ffda2fa66740f434c79...3c05b500a55406d0bd87cf24baa67469dbf90a03,1,24,20,44,2,2012-06-08 10:03:52,2012-06-07 18:06:47
3c05b500a55406d0bd87cf24baa67469dbf90a03...7ab6e32843e74176c71fc76219014e3c1f8f41b6,1,21,13,34,4,2012-06-08 10:13:52,2012-06-07 19:07:43
7ab6e32843e74176c71fc76219014e3c1f8f41b6...7ae66517c1b8a93f5a546671c609d2b06b4fb4af,1,1,1,2,1,2012-06-08 10:14:01,2012-06-08 10:07:20
7ae66517c1b8a93f5a546671c609d2b06b4fb4af...18aed863b46e719d7efaeab624fb8aa4cd62f360,2,11,1,12,3,2012-06-08 12:22:58,2012-06-08 10:52:39
18aed863b46e719d7efaeab624fb8aa4cd62f360...c63c62a18a2b434284d3438bcb2be0893d8fcce3,1,6,0,6,1,2012-06-08 16:46:45,2012-06-08 16:46:45
c63c62a18a2b434284d3438bcb2be0893d8fcce3...90985048fc1882483794e6734eb91401aefbe768,1,2,2,4,2,2012-06-08 20:04:03,2012-06-08 19:52:16
90985048fc1882483794e6734eb91401aefbe768...b6d533af4d03f27ea957baa5fd70f7d0b942ef9a,4,124,8,132,12,2012-06-08 20:07:58,2012-05-29 21:55:20
b6d533af4d03f27ea957baa5fd70f7d0b942ef9a...a035d9d6502c824155783dd74f88912ba2dffd9b,3,16,16,32,8,2012-06-08 20:52:43,2012-06-08 20:52:43
a035d9d6502c824155783dd74f88912ba2dffd9b...484fcd34a4819ff11ef72f3c9e1eb467a282b2f6,4,26,3,29,7,2012-06-08 22:12:14,2012-06-08 22:12:14
484fcd34a4819ff11ef72f3c9e1eb467a282b2f6...aa423575e7b464433fcfc4bf4b8e1d7627b17ce6,7,30,48,78,16,2012-06-09 13:59:52,2012-06-09 13:59:52
aa423575e7b464433fcfc4bf4b8e1d7627b17ce6...ad47364dd324508e8332ea853da59772431398aa,2,0,23,23,2,2012-06-09 15:05:54,2012-06-09 15:05:54
ad47364dd324508e8332ea853da59772431398aa...ef906b163202679413f1fdae7106b8de86477dbe,1,1,2,3,2,2012-06-09 15:22:24,2012-06-09 15:22:24
ef906b163202679413f1fdae7106b8de86477dbe...fc40a6504b78e604a6ba90a3b85b1ed54ee238a2,4,35,19,54,11,2012-06-09 15:55:24,2012-06-09 15:55:24
fc40a6504b78e604a6ba90a3b85b1ed54ee238a2...514e82702232139ec76f36a6e1fa4b63f47c6990,1,3,1,4,1,2012-06-09 16:07:30,2012-06-09 16:07:30
514e82702232139ec76f36a6e1fa4b63f47c6990...17d6cd90299e39823e80a005e7a04bc24ee8af4c,1,12,0,12,1,2012-06-09 18:41:46,2012-06-09 18:41:46
17d6cd90299e39823e80a005e7a04bc24ee8af4c...b0d8085c67884f36c8fb4af5f1fdae844e4700f7,1,3,0,3,1,2012-06-09 19:14:13,2012-06-09 19:14:13
b0d8085c67884f36c8fb4af5f1fdae844e4700f7...e9497a3803c2da2d099ad1ca403a98cdb0ee322f,1,1,1,2,1,2012-06-10 05:18:16,2012-06-10 05:18:16
e9497a3803c2da2d099ad1ca403a98cdb0ee322f...1a10a06b9f510f796beb2ffef39c7885cba2ad67,1,5,1,6,3,2012-06-10 17:56:16,2012-06-10 17:53:35
1a10a06b9f510f796beb2ffef39c7885cba2ad67...c4c7fbcc0d9264beb931b45969fc0d8d655c4f83,36,3112,2016,5128,64,2012-06-11 08:40:23,2012-06-11 08:34:00
c4c7fbcc0d9264beb931b45969fc0d8d655c4f83...3dd5d726d1c3bf8f5901c992d7586e5ec146bc2d,2,9,1,10,3,2012-06-11 20:14:06,2012-06-11 20:05:13
3dd5d726d1c3bf8f5901c992d7586e5ec146bc2d...35f9c2c07a8ed29b278db21a61f5b87581024258,7,39,36,75,27,2012-06-12 12:23:41,2012-06-12 12:16:44
35f9c2c07a8ed29b278db21a61f5b87581024258...a7ef802fa4b48d0c159940d405d83522adb9d4b3,1,1,0,1,1,2012-06-12 12:25:51,2012-06-12 12:25:51
a7ef802fa4b48d0c159940d405d83522adb9d4b3...e9ef9776d186a3379cdbf47a73b14e89b74d0926,3,19,11,30,7,2012-06-13 10:04:46,2012-06-13 09:36:27
e9ef9776d186a3379cdbf47a73b14e89b74d0926...86c20e39eb9ea0bbd25889403d16d857748aff9b,2,2,2,4,2,2012-06-13 11:16:34,2012-06-13 11:13:56
86c20e39eb9ea0bbd25889403d16d857748aff9b...a2022dae7ff70b00ab61e2ca2da0980a7747824b,1,5,21,26,2,2012-06-13 11:37:22,2012-06-13 11:28:09
a2022dae7ff70b00ab61e2ca2da0980a7747824b...fe873e276527534b3c0c22f457ee314cf029ced4,2,9,1,10,3,2012-06-14 09:32:40,2012-06-14 09:32:40
fe873e276527534b3c0c22f457ee314cf029ced4...4d46106f8c233c5af283c903000ef8c6f1165393,3,142,178,320,20,2012-06-14 13:32:42,2012-06-14 13:24:47
4db34e7b4fabe4f70bce9429ee9814eb6168dc72...fedac99c859c626544d38fc0ea07207ef3fd101a,4,77,4,81,7,2012-06-05 14:46:15,2012-06-05 14:46:15
fedac99c859c626544d38fc0ea07207ef3fd101a...17824e2b74ca02b9914e853c818fa512a0f9ef34,3,13,2,15,3,2012-06-06 08:09:32,2012-06-06 08:05:27
17824e2b74ca02b9914e853c818fa512a0f9ef34...29a80354ab5e5b85fa37863f70b1cf95646dc699,5,17,16,33,15,2012-06-06 08:32:03,2012-06-06 08:32:03
29a80354ab5e5b85fa37863f70b1cf95646dc699...9c096ab981d57123a0774f9ddf229084e0bb54a1,3,44,3,47,6,2012-06-06 08:42:14,2012-06-06 08:40:11
9c096ab981d57123a0774f9ddf229084e0bb54a1...eb286aa22f2a83a091b856ab2ecda1bded4203e3,4,16,12,28,12,2012-06-06 08:53:16,2012-06-06 08:53:16
eb286aa22f2a83a091b856ab2ecda1bded4203e3...70a0351fefaab4bce8c1085008ec5f12ba6cf279,3,27,14,41,14,2012-06-06 09:06:33,2012-06-06 09:06:33
70a0351fefaab4bce8c1085008ec5f12ba6cf279...7edf231d4666604a455621c4800c6b031a2f0b5b,6,99,110,209,36,2012-06-06 11:52:53,2012-06-06 09:54:26
7edf231d4666604a455621c4800c6b031a2f0b5b...f0664dc8ae541b21e3cf421725e7933a9b3a799e,3,5,31,36,8,2012-06-06 11:54:40,2012-06-06 11:53:12
f0664dc8ae541b21e3cf421725e7933a9b3a799e...4fea46a030689d7ae774ee0217dbce28de5a1b29,3,16,3,19,6,2012-06-06 13:17:32,2012-06-06 13:17:32
4fea46a030689d7ae774ee0217dbce28de5a1b29...f5ce1793a88e6aca1ccefd7bdec622587357df19,1,1,1,2,1,2012-06-06 13:19:06,2012-06-06 13:19:06
f5ce1793a88e6aca1ccefd7bdec622587357df19...2c57809a560cb67c79b9e8a77cc713e8a2424c8e,1,22,16,38,5,2012-06-06 13:47:48,2012-06-06 13:45:28
2c57809a560cb67c79b9e8a77cc713e8a2424c8e...4464bbba15d50ed32beb5995c13d26791ca61fe4,5,86,3,89,10,2012-06-07 07:59:14,2012-06-07 07:59:14
314d82a94e2d4270b6ec8aa4b3fc2e8ebc404f08...939af5a6548bbbae3838773217aecdee910539e8,1,1,1,2,1,2012-06-01 06:09:58,2012-06-01 06:09:58
939af5a6548bbbae3838773217aecdee910539e8...72130385bfe503bd440e52605c44a10a0480a25b,2,32,2,34,5,2012-06-02 00:46:07,2012-06-01 23:58:53
72130385bfe503bd440e52605c44a10a0480a25b...d4648a34467bb2e90af4038e3424077afa63ceba,1,0,3,3,1,2012-06-02 00:50:06,2012-06-02 00:50:06
d4648a34467bb2e90af4038e3424077afa63ceba...f65e412abd289f78aff278a782e29eff1749c6e5,1,4,3,7,1,2012-06-02 09:38:23,2012-06-02 09:35:36
f65e412abd289f78aff278a782e29eff1749c6e5...ade44b8d402c425ca687f254bbaaf161522e5c04,1,7,7,14,6,2012-06-02 17:44:15,2012-06-02 17:44:06
ade44b8d402c425ca687f254bbaaf161522e5c04...566ac30eb92574f698a848739fa5008d5e08a2ee,1,4,2,6,4,2012-06-02 17:50:24,2012-06-02 17:50:24
566ac30eb92574f698a848739fa5008d5e08a2ee...7676d6e764c47c9d33a755c3b861034b32de77ac,2,11,12,23,11,2012-06-02 19:24:18,2012-06-02 19:24:18
7676d6e764c47c9d33a755c3b861034b32de77ac...6522283a712af96a98e99d675b69ca15aadbace8,1,2,1,3,2,2012-06-02 19:28:18,2012-06-02 19:28:18
b86a00187d621bef9da5060ea16f26d9f12dc9dd...227cec686e512412f613c3d14743b85445765d92,2,5,4,9,3,2012-05-03 06:57:22,2012-05-03 06:57:22
227cec686e512412f613c3d14743b85445765d92...e84f79f05113f546810c1908c7baef99fb1e874a,27,75,38,113,44,2012-05-03 13:27:01,2012-05-03 13:27:01
4d46106f8c233c5af283c903000ef8c6f1165393...88601bad84ef0efa2da58c8a46ed4a5726cfe291,3,9,9,18,8,2012-06-14 19:10:30,2012-06-14 19:06:07
88601bad84ef0efa2da58c8a46ed4a5726cfe291...023b70415b689f18115b7bf3842ed6d57c90fa8d,1,5,1,6,3,2012-06-14 19:44:08,2012-06-14 19:44:08
023b70415b689f18115b7bf3842ed6d57c90fa8d...edee20ff506779b7a7d4e10321a0a619ce0eb03d,1,3,3,6,3,2012-06-14 22:12:15,2012-06-14 22:04:30
edee20ff506779b7a7d4e10321a0a619ce0eb03d...fd6a9d35d9034436d2f8092717c5b210da6ff6ce,1,4,4,8,4,2012-06-14 22:12:15,2012-06-14 22:10:51
fd6a9d35d9034436d2f8092717c5b210da6ff6ce...5bdd0d6b6a8d5cfa88077c6837a21041c7bfd562,2,10,11,21,5,2012-06-15 12:49:19,2012-06-15 12:41:16
5bdd0d6b6a8d5cfa88077c6837a21041c7bfd562...1794e36fa1facef40638f59012c2dac4ac4fa261,3,25,21,46,10,2012-06-16 20:57:33,2012-06-16 20:57:33
1794e36fa1facef40638f59012c2dac4ac4fa261...1ace912f7e1916e03bc91ef91318803817d6a72e,2,2,2,4,2,2012-06-16 21:29:41,2012-06-16 21:29:41
1ace912f7e1916e03bc91ef91318803817d6a72e...79ef3901da8c162aa103657c33cfddfca8627a04,1,1,1,2,1,2012-06-16 23:23:03,2012-06-16 23:23:03
79ef3901da8c162aa103657c33cfddfca8627a04...fadcc6ddb7f5dfde14fd80497b21076cadae927f,4,14,14,28,4,2012-06-16 23:23:39,2012-06-16 23:23:39
fadcc6ddb7f5dfde14fd80497b21076cadae927f...d708298184f8e19f250d2cee5bb900e496ed1175,1,1,1,2,1,2012-06-17 00:18:23,2012-06-17 00:18:23
d708298184f8e19f250d2cee5bb900e496ed1175...ac1b9ae6301e2c38af7951f1feb56dafc380d3e7,4,16,15,31,4,2012-06-17 09:39:02,2012-06-17 09:39:02
4d46106f8c233c5af283c903000ef8c6f1165393...3c0877938f5eafc822d32b6c4f85e5a46b873390,1,2,1,3,1,2012-06-14 14:42:55,2012-06-14 14:42:55
4464bbba15d50ed32beb5995c13d26791ca61fe4...bac6a68064309eb8e9ad81ad10e983b40273a52f,1,1,2,3,2,2012-06-07 11:35:04,2012-06-07 11:35:04
4464bbba15d50ed32beb5995c13d26791ca61fe4...6fd1950a4e29c1b5ed071a880db64103715ead51,3,81,129,210,25,2012-06-07 08:32:10,2012-06-07 08:31:08
6fd1950a4e29c1b5ed071a880db64103715ead51...b48432201bae813027c045e412e28ba4c1806d92,1,2,1,3,1,2012-06-07 09:04:15,2012-06-07 09:01:49
b48432201bae813027c045e412e28ba4c1806d92...4ce5a5fe7806e3dd0ea0d7c53c0d6d831a0edac8,1,2,2,4,1,2012-06-07 09:19:10,2012-06-07 09:19:10
4ce5a5fe7806e3dd0ea0d7c53c0d6d831a0edac8...17f3e9258e6050c274a7294213bd08bb71f2d2da,6,21,21,42,20,2012-06-07 09:50:20,2012-06-07 09:50:20
17f3e9258e6050c274a7294213bd08bb71f2d2da...875c76251710c9b643a4e6164b5570713fe024f5,2,18,6,24,6,2012-06-07 10:51:48,2012-06-07 10:51:48
6522283a712af96a98e99d675b69ca15aadbace8...f823ae3b3e835dd4abdb987ea0fcc22573bb308d,1,1,1,2,1,2012-06-03 19:46:14,2012-06-03 19:46:14
f823ae3b3e835dd4abdb987ea0fcc22573bb308d...71d9a2a7fe8cfadec8a46d208a218786aff09107,1,2,2,4,2,2012-06-03 20:31:49,2012-06-03 20:31:49
71d9a2a7fe8cfadec8a46d208a218786aff09107...a89034a2d8c0ca84184d260090d87645cfdc0e7d,5,10,19,29,4,2012-06-03 20:54:34,2012-06-03 20:54:34
6522283a712af96a98e99d675b69ca15aadbace8...43a46e90048884b3e8457331c86b96c0ac6a9415,1,6,2,8,1,2012-06-03 19:44:37,2012-06-03 19:44:37
e84f79f05113f546810c1908c7baef99fb1e874a...1adc87cd324db6003ef2962e68e11ccc9b104658,10,14,14,28,13,2012-05-03 14:53:17,2012-05-03 14:53:17
e84f79f05113f546810c1908c7baef99fb1e874a...b52672d77822e88752cb178c8a359adde83ff0ba,19,80,80,160,76,2012-05-03 14:39:16,2012-05-03 14:39:16
ac1b9ae6301e2c38af7951f1feb56dafc380d3e7...8ba5bf31986fa746ecc81683c64999dcea4f8e0a,7,320,0,320,9,2012-06-18 16:34:36,2012-06-18 16:32:03
8ba5bf31986fa746ecc81683c64999dcea4f8e0a...959a3f9791d780062c4efe8765404a8ef95e87f0,4,301,41,342,20,2012-06-19 12:25:22,2012-06-19 12:25:22
ac1b9ae6301e2c38af7951f1feb56dafc380d3e7...108f8dddeae66efd47c13afa6033f36b6fd39c8f,3,3,6,9,3,2012-06-18 16:09:05,2012-06-08 13:28:07
108f8dddeae66efd47c13afa6033f36b6fd39c8f...aee9eecb920cf281e8339a5f7edadc6f2dd04fea,5,16,14,30,5,2012-06-18 16:12:29,2012-06-08 10:32:16
aee9eecb920cf281e8339a5f7edadc6f2dd04fea...ffa6d95f65363b7f4f9047ab11561880be29049a,1,23,0,23,1,2012-06-18 21:56:10,2012-06-07 12:08:46
ffa6d95f65363b7f4f9047ab11561880be29049a...c57ba673312cb5774d544353044e2182b6223040,4,13,22,35,8,2012-06-18 22:49:33,2012-06-18 22:49:30
c57ba673312cb5774d544353044e2182b6223040...f8ef93a6576837ef3598066d6ed715171a91cd04,1,1,1,2,1,2012-06-19 08:37:53,2012-06-13 18:42:18
f8ef93a6576837ef3598066d6ed715171a91cd04...45a1a54b0b234996a9880bd89924df2aa86b8f9a,1,11,10,21,8,2012-06-19 09:33:27,2012-06-10 21:59:50
45a1a54b0b234996a9880bd89924df2aa86b8f9a...41eb70f7620dbae43bb72f265489fa3ac19c5c66,2,29,6,35,5,2012-06-19 12:55:40,2012-06-19 12:55:40
41eb70f7620dbae43bb72f265489fa3ac19c5c66...f08fa5b5556e6a3e81fdd644f5b7bcc9e795821a,3,3,3,6,3,2012-06-19 15:37:28,2012-06-19 15:37:28
f08fa5b5556e6a3e81fdd644f5b7bcc9e795821a...a54a8bab0c6a96c03452040e92b2a3141695a363,2,43,6,49,4,2012-06-22 12:28:15,2012-06-22 12:28:15
a54a8bab0c6a96c03452040e92b2a3141695a363...6bc1b222994301782bd80780bdeec8c4eb44631a,1,4,2,6,4,2012-06-22 13:09:26,2012-06-16 18:49:50
6bc1b222994301782bd80780bdeec8c4eb44631a...7f225880e4b7f846a1e910f6be0bce11f9a8d5ec,2,5,5,10,2,2012-06-22 13:46:49,2012-06-22 13:43:57
7f225880e4b7f846a1e910f6be0bce11f9a8d5ec...ea9536b17fe16b2be45aa4a3552f919682c93e3e,1,3,2,5,1,2012-06-23 02:00:40,2012-06-23 02:00:40
ea9536b17fe16b2be45aa4a3552f919682c93e3e...c864b36ba12f195cb1d3f9b1ad27ad71d5d8b5ea,1,1,0,1,1,2012-06-23 14:02:15,2012-06-21 09:37:12
c864b36ba12f195cb1d3f9b1ad27ad71d5d8b5ea...946d3d9f84ea7979a4abf0857e4aa7ee33576303,1,2,2,4,2,2012-06-23 14:14:56,2012-06-19 11:42:02
946d3d9f84ea7979a4abf0857e4aa7ee33576303...d4da08375b634544b95859d4d4667b8f05e3a29a,5,52,7,59,13,2012-06-23 14:31:16,2012-06-08 10:00:51
d4da08375b634544b95859d4d4667b8f05e3a29a...e1b74d00945ae772300432a51a71e735143c8905,1,2,1,3,1,2012-06-23 14:54:45,2012-06-23 14:54:45
e1b74d00945ae772300432a51a71e735143c8905...e0fce8706d31f104f781676b49e7fe0df83438e0,6,28,57,85,20,2012-06-23 15:11:15,2012-06-23 15:11:15
e0fce8706d31f104f781676b49e7fe0df83438e0...19a810b18cacea12f201b5a235d1af9218d9c2e9,1,2,1,3,1,2012-06-23 16:47:52,2012-06-23 16:44:40
19a810b18cacea12f201b5a235d1af9218d9c2e9...4b722b31e1778310ba0c1ed96fdacf99aa203dd2,4,7,4,11,7,2012-06-24 17:54:56,2012-06-24 17:54:56
4b722b31e1778310ba0c1ed96fdacf99aa203dd2...d69f1d71c4ee382542d09e80b18ef01feac5884c,1,2,2,4,2,2012-06-25 06:48:32,2012-06-24 02:55:23
d69f1d71c4ee382542d09e80b18ef01feac5884c...531878302735e6a2b36d82b584947bbf8eae8111,1,13,23,36,6,2012-06-25 18:26:17,2012-06-25 18:24:26
531878302735e6a2b36d82b584947bbf8eae8111...b6c356b7bb97f3d6d4831b31e67868313bbbc090,9,81,21,102,26,2012-06-26 15:08:42,2012-06-26 15:08:42
b6c356b7bb97f3d6d4831b31e67868313bbbc090...05d333ba3bb16af024c11966d2072de38fe9f82f,4,24,19,43,5,2012-06-26 16:18:44,2012-06-26 09:14:23
05d333ba3bb16af024c11966d2072de38fe9f82f...fa182e8ae82f33764d5e1f70bcd45899e1bf17e6,2,23,5,28,3,2012-06-26 16:39:14,2012-06-12 10:30:52
10a9c260fcf659a855da2850e09820b1c38e5cee...6492e8e5e6643c5a90d71727af7f17a362b9362b,1,6,10,16,2,2012-06-07 12:37:37,2012-06-07 12:36:54
6492e8e5e6643c5a90d71727af7f17a362b9362b...c28e700c7e54e3071f173b34a12eb1c4f6e39552,46,22,474,496,178,2012-06-07 13:02:35,2012-06-07 13:02:35
f29234167ad0193f35360023c65212c39cf87d1b...f699641161a4ec8b6cbee938fd3a4379e7889ff2,4,104,52,156,23,2012-06-04 06:44:13,2012-06-04 00:33:09
f699641161a4ec8b6cbee938fd3a4379e7889ff2...5ef599c7b32a238bfda6f56cd149bacb61b85c77,1,7,7,14,12,2012-06-04 18:39:54,2012-06-04 18:39:54
c0395dea46231b20a97c884d4f22fc8e9dbdde66...ea28bc2688b44559787fc12a3b8fc7939ee86f9b,1,0,44,44,1,2012-05-03 15:00:36,2012-05-03 15:00:36
ea28bc2688b44559787fc12a3b8fc7939ee86f9b...e9a56606e738c478373d052bbd876ff84afdb995,10,12,12,24,12,2012-05-03 15:42:56,2012-05-03 15:42:56
e9a56606e738c478373d052bbd876ff84afdb995...10cf3c64273db407402ea9723569dfc8d059e186,12,71,112,183,37,2012-05-03 16:30:07,2012-05-03 16:19:18
10cf3c64273db407402ea9723569dfc8d059e186...00c0d3c44ebc4e3461653ec96cd47023cc0a6e5b,5,7,6,13,9,2012-05-03 18:18:05,2012-05-03 18:18:05
4a2e80fff44d0eb1856b593ac5f31ab1492b3e45...b139315f1c5e3eb05c76237c2824bdf03bd689b6,6,259,15,274,18,2012-08-02 14:08:39,2012-08-02 14:08:39
b139315f1c5e3eb05c76237c2824bdf03bd689b6...c4b2a3262cc79383d6562cfc7e9af20135c8e0bf,3,110,3,113,9,2012-08-10 11:38:18,2012-08-10 11:38:18
fa182e8ae82f33764d5e1f70bcd45899e1bf17e6...ada961b0d20cc31c6d414b556ba2dafb4e73c406,1,1,1,2,1,2012-06-27 16:13:14,2012-06-27 16:11:45
ada961b0d20cc31c6d414b556ba2dafb4e73c406...1cf8287e3a6f252b79e9b9a8f945f11a92e17cd5,1,2,2,4,2,2012-06-27 21:40:29,2012-06-20 23:13:35
1cf8287e3a6f252b79e9b9a8f945f11a92e17cd5...c8928b91b515c0712bdb633c1d1b2656b80baff8,2,6,9,15,3,2012-06-27 22:54:42,2012-06-21 00:03:06
c8928b91b515c0712bdb633c1d1b2656b80baff8...8a5d1a6b93e05546c5fdbfc497d7fb3a3377cf85,28,53,54,107,50,2012-06-28 08:49:07,2012-06-28 08:49:07
8a5d1a6b93e05546c5fdbfc497d7fb3a3377cf85...4f53e77f0720bd4d74b1b08857db8f7d32c65008,1,6,53,59,3,2012-06-28 11:42:36,2012-06-28 11:42:36
4f53e77f0720bd4d74b1b08857db8f7d32c65008...26cb227cfe42d2500eac62dc0d90fb5227b275b3,3,17,13,30,4,2012-06-28 14:29:29,2012-06-28 14:28:25
26cb227cfe42d2500eac62dc0d90fb5227b275b3...54b1519dfd90ea042105fc42aa439763c8df93d4,1,8,8,16,1,2012-06-28 15:18:50,2012-06-28 15:18:50
54b1519dfd90ea042105fc42aa439763c8df93d4...b9ecbedb31375a887d100ccf550a091c8d5d4fd7,1,1,1,2,1,2012-06-29 13:10:41,2012-06-29 13:08:30
b9ecbedb31375a887d100ccf550a091c8d5d4fd7...47da7b7a9aefce66fa2c54833b5ba308781fc95e,2,9,5,14,6,2012-06-30 11:18:07,2012-06-30 11:18:07
47da7b7a9aefce66fa2c54833b5ba308781fc95e...596e15293c9f522a2b001d49a0c40005711682a6,1,5,1,6,2,2012-06-30 12:30:32,2012-06-30 12:30:32
596e15293c9f522a2b001d49a0c40005711682a6...db87016b1a92b790c4250a2b5c16ceadd737a00e,2,7,0,7,2,2012-06-30 13:06:42,2012-06-30 13:06:42
db87016b1a92b790c4250a2b5c16ceadd737a00e...5d81ad1af14ee3127b53f923687ed5c4e00329ee,1,7,0,7,1,2012-06-30 14:25:51,2012-06-30 14:25:51
5d81ad1af14ee3127b53f923687ed5c4e00329ee...2c2c8a63266b586e3782267fb361504e5ac05abe,1,2,0,2,2,2012-06-30 16:50:28,2012-06-30 16:49:11
2c2c8a63266b586e3782267fb361504e5ac05abe...c446bdee84efe42f5c0bbfee16986a80c83ec9a2,1,4,1,5,3,2012-06-30 18:52:49,2012-06-30 18:50:24
c446bdee84efe42f5c0bbfee16986a80c83ec9a2...deed192dda621f1cdc8eb7240f1e5914045402dd,5,9,9,18,9,2012-06-30 19:19:07,2012-06-30 19:19:07
deed192dda621f1cdc8eb7240f1e5914045402dd...da200c5e35cdbb617572977bcbf97fae33920b2e,4,25,21,46,11,2012-06-30 19:27:47,2012-06-30 19:25:16
da200c5e35cdbb617572977bcbf97fae33920b2e...03896eb5df74a47237ec3ed9a73aadc925e90dbb,1,5,2,7,3,2012-06-30 20:21:23,2012-06-30 20:21:23
03896eb5df74a47237ec3ed9a73aadc925e90dbb...55ffcf8e7b414a39e2dfc9c9eb4c5d3fa548e78e,1,2,2,4,2,2012-06-30 21:16:40,2012-06-07 11:46:06
55ffcf8e7b414a39e2dfc9c9eb4c5d3fa548e78e...c5fb8299ef9658a58221d4894dadd080cc25962b,2,4,1,5,2,2012-06-30 22:20:34,2012-06-30 22:20:34
c5fb8299ef9658a58221d4894dadd080cc25962b...c68f4c514c7b1102772b6ea11e9e59c7c87f7fae,1,13,0,13,1,2012-07-01 10:55:46,2012-07-01 10:55:46
c68f4c514c7b1102772b6ea11e9e59c7c87f7fae...9974069620b0f0e6ac2f1e9bd64819ae0a0e623b,1,3,1,4,1,2012-07-01 11:25:24,2012-07-01 11:25:24
9974069620b0f0e6ac2f1e9bd64819ae0a0e623b...2b9fb2e6443c04e4415b17083d727bd80047b6e5,1,15,4,19,7,2012-07-01 13:14:27,2012-05-11 16:41:47
2b9fb2e6443c04e4415b17083d727bd80047b6e5...bd283aa844b04651b7c8b4e85f48c6dced1678f0,3,134,38,172,17,2012-07-01 14:21:34,2012-05-26 02:55:33
bd283aa844b04651b7c8b4e85f48c6dced1678f0...da573fbb4172fb962c9f021fc0c03cf91b13e746,2,22,10,32,4,2012-07-01 16:27:36,2012-05-26 23:24:57
da573fbb4172fb962c9f021fc0c03cf91b13e746...f572ee0c65ec5eac9edb0cb3e35c96ec86d89ffb,3,76,7,83,8,2012-07-01 16:36:43,2012-05-26 20:19:13
f572ee0c65ec5eac9edb0cb3e35c96ec86d89ffb...e74787391e8fdf87d9a92138028911746809bd7c,2,7,4,11,3,2012-07-01 19:52:35,2012-07-01 19:49:38
e74787391e8fdf87d9a92138028911746809bd7c...7313468f85c3ade1275fc7fef193a4429f4af4bf,1,35,1,36,2,2012-07-01 22:04:16,2012-07-01 22:04:16
7313468f85c3ade1275fc7fef193a4429f4af4bf...2cd4cf58d32c5d4b163a466f608dff31bac66b87,2,8,3,11,4,2012-07-02 01:40:50,2012-07-02 01:40:50
2cd4cf58d32c5d4b163a466f608dff31bac66b87...784d0c261c76535dc760bc8d76793d92f35c1513,1,1,1,2,1,2012-07-02 08:16:42,2012-07-02 08:16:42
784d0c261c76535dc760bc8d76793d92f35c1513...925a6936b94c74b2e67d90da1fcf2e19efc335cf,1,5,8,13,3,2012-07-03 07:22:13,2012-07-02 12:35:59
925a6936b94c74b2e67d90da1fcf2e19efc335cf...ab7f0710584a3cbb3737e9a7fd8e3fd21765e594,1,3,3,6,1,2012-07-03 07:31:06,2012-07-03 07:29:10
ab7f0710584a3cbb3737e9a7fd8e3fd21765e594...cf731a543eaae43f989f237727411763c386af1b,1,1,1,2,1,2012-07-03 09:57:15,2012-07-03 09:56:41
cf731a543eaae43f989f237727411763c386af1b...f33e15036907d6e4bda6116dc84097e9e590d2c8,2,29,7,36,7,2012-07-03 21:20:12,2012-06-30 15:41:51
f33e15036907d6e4bda6116dc84097e9e590d2c8...bee498f3a2f66210db39f0be244ec4fa888b6940,3,81,0,81,3,2012-07-03 21:20:12,2012-06-30 17:54:38
bee498f3a2f66210db39f0be244ec4fa888b6940...a92e7f37c4ae84b6b8d8016cc6783211e9047219,12,121,93,214,66,2012-07-03 21:20:12,2012-07-02 23:31:14
a92e7f37c4ae84b6b8d8016cc6783211e9047219...b0eee0ba4bcc15c767a64794caff9d233f12a5d5,10,22,26,48,26,2012-07-03 21:20:12,2012-07-02 23:33:44
b0eee0ba4bcc15c767a64794caff9d233f12a5d5...a222d6e80029de772a291e18460d96dcfbd23570,3,9,3,12,5,2012-07-03 21:20:12,2012-07-02 23:42:16
fa182e8ae82f33764d5e1f70bcd45899e1bf17e6...24dec9edaac7849c7831ff0ee4245b6637a9639e,4,8,8,16,8,2012-06-27 02:45:45,2012-06-27 01:17:15
5f9b2be559f1ce9206cdb5129d3d68148814e619...62ae711cecc823f0499cbddac3465c256dee106a,1,1,1,2,1,2012-08-04 21:58:31,2012-08-04 21:58:31
62ae711cecc823f0499cbddac3465c256dee106a...9ea4dc90b9d72648f0f26cc60b19727b35267da0,1,8,6,14,1,2012-08-04 22:46:15,2012-08-04 22:46:15
9ea4dc90b9d72648f0f26cc60b19727b35267da0...86c5c0154f69728eba4aad6204621f07cdd3459d,1,2,2,4,1,2012-08-04 22:56:43,2012-08-04 22:56:43
86c5c0154f69728eba4aad6204621f07cdd3459d...197863523a7631ae1d11d4fdf49b747a96e011a3,1,103,35,138,19,2012-08-04 23:42:33,2012-08-04 23:05:12
197863523a7631ae1d11d4fdf49b747a96e011a3...5d4f993bb1f01c3a79194031827380dc763ce628,3,20,9,29,4,2012-08-05 00:27:57,2012-08-04 22:05:57
5d4f993bb1f01c3a79194031827380dc763ce628...1c3464e809bf84a18cf909959e910b8c6e5df0db,1,3,3,6,2,2012-08-05 01:10:34,2012-08-05 01:10:34
1c3464e809bf84a18cf909959e910b8c6e5df0db...19642a7a09a0f9c7fbeeaec687316f7f9f8027bb,1,2,2,4,2,2012-08-05 01:19:25,2012-08-05 01:19:25
c28e700c7e54e3071f173b34a12eb1c4f6e39552...0e36948f627983bbf2b3cc4c4d2ec4a5a64e6e0a,1,2,2,4,2,2012-06-07 15:24:48,2012-06-07 15:24:48
00c0d3c44ebc4e3461653ec96cd47023cc0a6e5b...59d2b8aa16126d8d0a453f07d5c3497048bcd6b0,1,11,2,13,2,2012-05-16 13:13:39,2012-05-03 18:52:56
00c0d3c44ebc4e3461653ec96cd47023cc0a6e5b...11a5355517487eab56c34d92b45d7d67fde6dbd3,4,5,0,5,5,2012-05-03 19:31:23,2012-05-03 19:23:50
11a5355517487eab56c34d92b45d7d67fde6dbd3...ec5423df05dedeee6651c36dd4d90fec0d8cca7c,1,1,1,2,1,2012-05-04 06:20:50,2012-05-04 06:20:50
ec5423df05dedeee6651c36dd4d90fec0d8cca7c...865cd35c9b357e20994f6c6a51f2ae000ba0a3ee,33,182,237,419,71,2012-05-05 12:06:36,2012-05-05 12:01:38
865cd35c9b357e20994f6c6a51f2ae000ba0a3ee...208e26b39c95ab7569780a7962b25dd4749d9a18,1,1,0,1,1,2012-05-05 14:45:02,2012-05-05 14:45:02
208e26b39c95ab7569780a7962b25dd4749d9a18...1583d402240d88ad2a4acc024d348a21657ccaba,4,5,5,10,4,2012-05-05 14:54:30,2012-05-05 14:54:30
1583d402240d88ad2a4acc024d348a21657ccaba...d7dfab59ead97b35c6f6786784225f377783e376,26,94,167,261,100,2012-05-05 19:41:44,2012-05-05 17:47:03
d7dfab59ead97b35c6f6786784225f377783e376...57102ce7819ecc3df3e979a4926d0cecc09c6f6e,1,2,2,4,2,2012-05-05 20:33:08,2012-05-05 20:33:08
57102ce7819ecc3df3e979a4926d0cecc09c6f6e...ecdd0914b18bc0f8ae0c03385a6c11ada4b3de6c,1,5,6,11,5,2012-05-06 07:50:30,2012-05-06 07:50:30
ecdd0914b18bc0f8ae0c03385a6c11ada4b3de6c...1aae1cba99b0f8232527742d64b120e4d902c68d,4,14,13,27,13,2012-05-07 15:25:12,2012-05-07 15:25:12
1aae1cba99b0f8232527742d64b120e4d902c68d...5cbfb48b92cb26a335f9c8c0f79d3390290103e2,3,61,4,65,7,2012-05-07 17:08:20,2012-05-07 17:08:20
184cf9ab798d5b25d855649ddb2ca580949778df...60873ea2ade8bed909b9f2dabb0f8a499226e10d,2,65,6,71,5,2012-08-10 14:03:18,2012-08-10 14:03:18
60873ea2ade8bed909b9f2dabb0f8a499226e10d...cab044c66ca3d1f3cfc704f64364aced2b9645af,5,62,4,66,8,2012-08-18 11:29:31,2012-08-18 11:29:31
cab044c66ca3d1f3cfc704f64364aced2b9645af...f7955c703de85059f06963ae948d64c28ceeef27,4,53,30,83,12,2012-08-18 12:48:54,2012-08-18 12:48:54
f7955c703de85059f06963ae948d64c28ceeef27...0b013951086814ebee048f0fa9a620e03f891494,2,25,1,26,3,2012-08-18 13:00:42,2012-08-18 13:00:42
0b013951086814ebee048f0fa9a620e03f891494...d3d1e599211c31e05d095b878de517dbb6fc998c,3,17,6,23,5,2012-08-18 13:16:52,2012-08-18 13:16:52
d3d1e599211c31e05d095b878de517dbb6fc998c...d865503389c7ebc1341f5b8f993858505289c6cd,6,225,42,267,22,2012-08-30 22:11:56,2012-08-30 22:11:56
d865503389c7ebc1341f5b8f993858505289c6cd...cd583d6dbd222ae61331a6965b0e1fc86c974c50,4,78,11,89,12,2012-09-04 16:53:31,2012-09-04 16:53:31
a222d6e80029de772a291e18460d96dcfbd23570...e4a1407a9cf35e6449136c22647a58cb14451e7a,2,10,1,11,3,2012-07-05 12:39:05,2012-07-05 12:39:05
e4a1407a9cf35e6449136c22647a58cb14451e7a...0f49b2bce2d5b3c5891c8a329bab7dffe16fc79b,2,18,3,21,3,2012-07-05 13:43:28,2012-07-05 13:39:19
0f49b2bce2d5b3c5891c8a329bab7dffe16fc79b...d3c2eb103f6682c029a850e60dc4cf85896b6aa2,3,20,11,31,3,2012-07-05 14:20:48,2012-07-05 14:20:48
a222d6e80029de772a291e18460d96dcfbd23570...3caf53524c5285f1a057e00fc6549cde0ca67dda,1,1,1,2,1,2012-07-04 21:34:55,2012-07-04 21:34:55
a222d6e80029de772a291e18460d96dcfbd23570...581a36245c84850616cfd837177f0fd39e85f06d,1,1,1,2,1,2012-07-04 19:43:31,2012-07-04 19:43:31
8855f9380e93d759eea93c32cdf25b76b72e15c4...8dafd04c45a66ff60f0503da1ebea14628322b45,1,1,2,3,2,2012-07-07 09:34:04,2012-07-07 09:34:04
a04f68b15d8466d0d34f6df1009668cf60dad206...9a3026a920286e9932401300d14f72a85ba03a43,1,1,1,2,1,2012-08-05 20:53:09,2012-08-05 20:47:29
9a3026a920286e9932401300d14f72a85ba03a43...ad237fb72f769bbd99b5ed6e3292bead614e1c94,2,6,1,7,2,2012-08-06 08:42:21,2012-08-06 08:42:21
ad237fb72f769bbd99b5ed6e3292bead614e1c94...ede49c7ee03dd1519d0c375d953cb73e106837b6,1,4,3,7,1,2012-08-06 14:59:59,2012-08-06 14:58:54
706fd9adc0b6587c7f96a834c757708e64fcf615...4a103086d5c67fa4fcc53c106c9fdf644c742dd8,401,6647,6157,12804,2927,2012-06-07 16:08:47,2012-06-07 16:08:47
4a103086d5c67fa4fcc53c106c9fdf644c742dd8...87ff89d12d109066ff355ed267787d32a6b5aeb7,1,16,0,16,1,2012-06-07 16:32:28,2012-06-07 16:32:28
87ff89d12d109066ff355ed267787d32a6b5aeb7...5e6ded2e58597fa324c550bad35a30ee630ce223,5,365,1,366,5,2012-06-07 16:36:53,2012-06-07 16:36:26
5e6ded2e58597fa324c550bad35a30ee630ce223...1a412dda621d8623abb91f8687f52de30a79901a,3,38,5,43,14,2012-06-07 16:49:19,2012-06-07 16:39:27
1a412dda621d8623abb91f8687f52de30a79901a...90fb6a46485d4f3c70d3864ab0a0e2f619449d31,12,621,478,1099,33,2012-06-07 16:54:43,2012-06-07 16:48:29
90fb6a46485d4f3c70d3864ab0a0e2f619449d31...6a66fc08b3a1e3ec56e05cd48647060ac3a4da94,1,2,0,2,1,2012-06-07 17:47:32,2012-06-07 17:47:32
aa757ac22de3e657df49086cf01a26f6c73b8dfb...eb0140bddca4d25be2bf02144f43b1b12b0cbed3,1,4,0,4,2,2012-05-16 21:15:49,2012-05-16 15:56:56
eb0140bddca4d25be2bf02144f43b1b12b0cbed3...006c2b8fc166e53d4ffccda9c42ef9fc109e1c8d,2,4,3,7,4,2012-05-17 09:10:48,2012-05-17 09:05:38
006c2b8fc166e53d4ffccda9c42ef9fc109e1c8d...009e237cf0c25ce13e73d58feb54ef4f86e47e4e,4,27,5,32,5,2012-05-17 11:34:53,2012-05-17 11:29:52
009e237cf0c25ce13e73d58feb54ef4f86e47e4e...c4996df16c58b46844d2e046bca5a3d41dfcc122,2,62,2,64,3,2012-05-17 11:54:51,2012-05-17 11:54:51
c4996df16c58b46844d2e046bca5a3d41dfcc122...82a76ef67d944b1a4507cac81476bebba0c90e4a,1,2,0,2,1,2012-05-17 12:03:19,2012-05-17 12:03:19
82a76ef67d944b1a4507cac81476bebba0c90e4a...dcd4383107d96c18bcb53312ca4de070374b334c,2,33,0,33,4,2012-05-17 14:02:05,2012-05-17 14:02:05
dcd4383107d96c18bcb53312ca4de070374b334c...20e697368219603599649bc67aea5e087caedeae,1,139,63,202,30,2012-05-17 15:41:37,2012-05-17 15:41:37
20e697368219603599649bc67aea5e087caedeae...ab268e18486b244f6633f2e013c12b6664a3661a,2,9,0,9,2,2012-05-17 15:53:19,2012-05-17 15:53:19
ab268e18486b244f6633f2e013c12b6664a3661a...4774875896dec4098dba2981d562bd74e75c463f,1,1,1,2,1,2012-05-17 20:04:47,2012-05-17 20:04:47
aa757ac22de3e657df49086cf01a26f6c73b8dfb...c647065b490667a6691a1c358d471def9ad72b60,1,7,7,14,7,2012-05-16 18:33:48,2012-05-16 18:32:53
c647065b490667a6691a1c358d471def9ad72b60...67fd30e9abdf0ad0fc95fd4d2d5bd7ba35a74038,1,1,1,2,1,2012-05-16 18:38:02,2012-05-16 18:38:02
67fd30e9abdf0ad0fc95fd4d2d5bd7ba35a74038...6e3b9962cce022a611fb84fbde11ad274d29a341,1,2,2,4,2,2012-05-16 18:38:23,2012-05-16 18:38:23
6e3b9962cce022a611fb84fbde11ad274d29a341...f92c7c5df2f6f09e3c5d4112d950c60738dea7f8,1,1,1,2,1,2012-05-16 18:40:24,2012-05-16 18:40:24
aa757ac22de3e657df49086cf01a26f6c73b8dfb...e656ca9ab87efa040c694221ac9d6143f42c9887,1,1,2,3,2,2012-05-16 15:47:25,2012-05-16 15:47:25
5cbfb48b92cb26a335f9c8c0f79d3390290103e2...9877e84caaf42b307086dcc62003e1d2e7c80671,1,7,4,11,3,2012-05-07 18:03:21,2012-05-07 17:38:14
b546e7eb633022ee1962570387f22fb2bcea46ed...7e81213b5a4570926afbd67eff7f2675f636d720,1,31,0,31,1,2012-09-05 19:12:39,2012-09-05 19:12:39
7e81213b5a4570926afbd67eff7f2675f636d720...d683263f97aedd67f17f4b78ac65d915f4e70d36,8,199,11,210,20,2012-09-07 16:51:11,2012-09-07 16:51:11
d683263f97aedd67f17f4b78ac65d915f4e70d36...a92bae0f0622fb45afb94bf5448b49bc32ebb643,3,56,7,63,11,2012-09-07 17:31:05,2012-09-07 17:31:05
a92bae0f0622fb45afb94bf5448b49bc32ebb643...375178fc19c1170fe046ad26befeba02fc19548c,4,119,16,135,18,2012-09-07 18:39:22,2012-09-07 18:39:22
375178fc19c1170fe046ad26befeba02fc19548c...ca9c3cd39fade827cced1b5198dd37bb80c208b0,12,143,24,167,26,2012-09-07 19:40:59,2012-09-07 19:40:59
d3c2eb103f6682c029a850e60dc4cf85896b6aa2...83da36ebfbdad2ac6e714b5308c076a1fb64b0be,1,1,1,2,1,2012-07-06 09:10:27,2012-07-06 09:10:27
d3c2eb103f6682c029a850e60dc4cf85896b6aa2...8fdc56d2a6f7537cdd52272501af9e94cab96ed4,5,14,14,28,13,2012-07-05 23:23:02,2012-07-05 22:23:03
8fdc56d2a6f7537cdd52272501af9e94cab96ed4...86eb606b88b3979de8074c3a049535150a0cc8a5,2,404,394,798,27,2012-07-06 09:20:07,2012-07-06 09:15:20
86eb606b88b3979de8074c3a049535150a0cc8a5...4c417cc9ebd65595128b81cdddc9ea8293cbcbbe,1,1,1,2,1,2012-07-06 11:58:49,2012-07-06 11:57:14
4c417cc9ebd65595128b81cdddc9ea8293cbcbbe...2ba4278cb38f1346d70cf427bbeac71a4d1dc5ad,1,1,1,2,1,2012-07-06 14:33:29,2012-07-06 14:29:23
009235b1383e67b750a56e14a59c5f9b556b4d88...a4a4b139cd1b2e5dd7a05f195c8990f4d94e882d,1,1,1,2,1,2013-01-01 12:14:55,2013-01-01 12:13:31
a4a4b139cd1b2e5dd7a05f195c8990f4d94e882d...7cb0cd5afffb8e38930eed7d52bd120176019e71,1,3,4,7,5,2013-01-01 12:20:36,2013-01-01 12:20:36
7cb0cd5afffb8e38930eed7d52bd120176019e71...739724ff825fc0a37f31a28607256bd09e008f0a,1,164,0,164,1,2013-01-01 15:17:26,2013-01-01 15:17:26
739724ff825fc0a37f31a28607256bd09e008f0a...c5ce0e8a687ecf7fbc38fa85c5311a6320a246c6,1,24,2,26,4,2013-01-01 15:21:32,2013-01-01 14:26:34
8dafd04c45a66ff60f0503da1ebea14628322b45...0a68a2994be17ed2669accead331881cb0be41dd,6,118,11,129,19,2012-07-07 13:30:25,2012-07-07 13:30:25
8dafd04c45a66ff60f0503da1ebea14628322b45...52a9e15794ac050afb17837a34407722e7249854,1,2,0,2,1,2012-07-07 13:29:20,2012-07-07 13:29:20
ede49c7ee03dd1519d0c375d953cb73e106837b6...c8780d9f4d32a1ff7b78f0b6bbb052e1e30d90f7,1,1,1,2,1,2012-08-06 21:28:58,2012-08-06 21:28:58
ede49c7ee03dd1519d0c375d953cb73e106837b6...4f3a6b853a6160a9f96d0b73199524a9bb062f90,1,4,1,5,1,2012-08-06 20:15:09,2012-08-06 20:15:09
6a66fc08b3a1e3ec56e05cd48647060ac3a4da94...33999d9871f9a0484190494e83d4a7e22e063e54,3,8,4,12,3,2012-06-07 20:11:24,2012-06-07 20:11:24
33999d9871f9a0484190494e83d4a7e22e063e54...f269f305444f3c972e74755e9adff5ef575401d5,1,8,8,16,6,2012-06-07 23:02:52,2012-06-07 23:02:52
f269f305444f3c972e74755e9adff5ef575401d5...06ea10e1f19ec311f4f6c71d5446c12e92807497,1,4,0,4,1,2012-06-08 08:25:42,2012-06-08 08:25:42
6a66fc08b3a1e3ec56e05cd48647060ac3a4da94...0ae727beda8b34deb5061d87fbbeb40e5ac80db3,5,55,4,59,7,2012-06-07 19:08:36,2012-06-07 17:52:13
4774875896dec4098dba2981d562bd74e75c463f...c23d306df83d226b4f3b5b852ec9fb22be12c61e,1,1,0,1,1,2012-05-17 22:53:57,2012-05-17 22:53:57
2e729c6c331982e1e0d439c6e5ba04c99c670029...6524ef501d99e959dc8d1f1c5b852f8f2849ddc7,1,5,4,9,4,2012-05-08 15:25:31,2012-05-08 15:25:31
828d691f62814edf3e93d981c0f991a48781fb79...8413c85f3d9a5d7f0485e621ec5836484c974f30,2,16,4,20,6,2012-09-07 19:48:22,2012-09-07 19:48:22
8413c85f3d9a5d7f0485e621ec5836484c974f30...3ffbfe4abcc9380fbaeeb7a370109775166b23d8,1,5,0,5,1,2012-09-07 19:56:07,2012-09-07 19:56:07
3ffbfe4abcc9380fbaeeb7a370109775166b23d8...dbf8b93c527733fb5e3ea101a67bd94db745888e,2,16,11,27,7,2012-09-17 18:57:23,2012-09-17 18:57:23
2ba4278cb38f1346d70cf427bbeac71a4d1dc5ad...91e4f7effb6c0911d2db68c9f17b40f484838538,1,1,1,2,1,2012-07-06 18:24:07,2012-07-06 18:24:07
c5ce0e8a687ecf7fbc38fa85c5311a6320a246c6...08140aec5c565dba1d1a8158ad631889f9aab2e6,1,1,1,2,1,2013-01-01 17:12:15,2013-01-01 17:12:15
0a68a2994be17ed2669accead331881cb0be41dd...3727f6d09681e4cb23d67e14ecc677a364c991bd,4,9,3,12,3,2012-07-08 10:56:49,2012-07-08 10:56:49
a4bb7dd552cf9e45cdd0b38938b18c576419fd8d...29ca3d3c4b3d330337cce8713196ef7eea956dc9,1,1,1,2,1,2012-07-07 14:00:03,2012-07-07 14:00:03
29ca3d3c4b3d330337cce8713196ef7eea956dc9...bbc590697a8cde2faf067b124d08fe9488db4905,2,0,27,27,2,2012-07-07 14:44:55,2012-07-07 14:44:55
bbc590697a8cde2faf067b124d08fe9488db4905...d94cfdcfae92fd4409cd1b5e14eebc75033266fd,1,4,4,8,4,2012-07-07 15:42:04,2012-07-07 15:42:04
fa3f0aa021bea85b9196ef154a32c7bb1023a1e9...ee191715eae73362768184aa95206cf61bac5d38,64,187,155,342,180,2012-08-07 10:00:22,2012-07-20 19:14:27
ee191715eae73362768184aa95206cf61bac5d38...c5ef65bcf324f4c90b53be90f4aec069a68e8c59,125,629,583,1212,551,2012-08-07 10:00:22,2012-07-21 08:00:10
c5ef65bcf324f4c90b53be90f4aec069a68e8c59...a8b3ddec5f05268b67b3efe6a7dc6accb1bac715,4,30,27,57,8,2012-08-07 10:00:22,2012-07-21 08:01:46
a8b3ddec5f05268b67b3efe6a7dc6accb1bac715...67646dc28d6fc7b4032f1f5a18a5347e81755638,1,103,16,119,14,2012-08-07 10:00:22,2012-08-03 21:00:22
67646dc28d6fc7b4032f1f5a18a5347e81755638...13338a6314a6c7120b29a22d8256deb52465aa8f,1,3,4,7,3,2012-08-07 10:00:23,2012-08-04 09:31:44
13338a6314a6c7120b29a22d8256deb52465aa8f...b55e07771fdc9f9cc80fb099429774672aaf9be9,1,2,1,3,2,2012-08-07 10:00:23,2012-08-04 09:17:04
b55e07771fdc9f9cc80fb099429774672aaf9be9...127b461b11af985a52fb482f09c7cd7a08832f9d,2,22,17,39,13,2012-08-07 10:00:23,2012-08-05 14:12:10
127b461b11af985a52fb482f09c7cd7a08832f9d...02e6b6409b3df1766abdc3d6438b6f339a3163af,1,1,1,2,1,2012-08-07 10:00:23,2012-08-04 11:22:39
02e6b6409b3df1766abdc3d6438b6f339a3163af...7e01e532c06e86e81558fea1d60f0f44b6ff50f2,1,15,10,25,12,2012-08-07 10:00:23,2012-08-04 09:05:13
7e01e532c06e86e81558fea1d60f0f44b6ff50f2...fe8484efda257e151d9c1ca5151e546c9262bf0f,3,57,31,88,18,2012-08-07 10:00:23,2012-08-04 13:55:53
fe8484efda257e151d9c1ca5151e546c9262bf0f...17da0aa893d4933bef52151243a72d90ad16d5de,1,6,5,11,5,2012-08-07 10:00:24,2012-08-04 09:12:21
17da0aa893d4933bef52151243a72d90ad16d5de...9e8df02d685e1ce6181f285d1c487cd01e65ca74,1,24,17,41,10,2012-08-07 10:00:24,2012-07-21 20:24:13
9e8df02d685e1ce6181f285d1c487cd01e65ca74...64e2e3562705dfee31a0922bbbe14bdf49d242d7,1,2,2,4,2,2012-08-07 10:00:24,2012-08-04 09:24:30
64e2e3562705dfee31a0922bbbe14bdf49d242d7...9e0a10ba77ad1737c4aaf49e5d4b4380f912bc0e,1,2,3,5,2,2012-08-07 10:00:24,2012-08-05 12:46:18
9e0a10ba77ad1737c4aaf49e5d4b4380f912bc0e...bf4da7a4420ccacf76090301a1e0efa1eea17751,1,6,1,7,1,2012-08-07 10:00:24,2012-08-03 21:01:47
bf4da7a4420ccacf76090301a1e0efa1eea17751...46cc530fad3c6ae4009557121971fe749742aef6,1,2,2,4,1,2012-08-07 14:22:25,2012-08-07 14:22:25
7495730d32498c7ee8113e190ece98ab3ce45a30...5d80d30a237725109d3d822d99e82a34e36f1a22,1,0,3,3,1,2012-05-18 10:25:15,2012-05-18 10:25:15
7495730d32498c7ee8113e190ece98ab3ce45a30...7549de841c6e0d18822af047763f5e3211539be8,2,13,5,18,4,2012-05-18 10:12:45,2012-05-18 10:08:36
7549de841c6e0d18822af047763f5e3211539be8...45f55a9fccaac3240826aa993aba4247310be331,1,1,1,2,1,2012-05-18 11:45:42,2012-05-18 11:45:42
45f55a9fccaac3240826aa993aba4247310be331...d04f72fb31bab43386e12963c1c6dec23ae16143,5,69,29,98,22,2012-05-18 12:52:24,2012-05-18 12:52:24
d04f72fb31bab43386e12963c1c6dec23ae16143...02eca6c0e238c43f888e9e17c373dbb479c868bb,3,9,3,12,6,2012-05-18 15:06:25,2012-05-18 15:06:25
02eca6c0e238c43f888e9e17c373dbb479c868bb...91727c76cda3f8bf286ee69652bc3625f150f6e7,1,12,14,26,4,2012-05-18 17:40:41,2012-05-17 11:39:00
1b05546bd50d1bf99e3d0e7def1238edf8d44065...c2e1ecb4b136016ab2996712aa0583fd91657bc9,4,27,19,46,9,2012-05-09 17:33:31,2012-05-09 17:33:31
c2e1ecb4b136016ab2996712aa0583fd91657bc9...1c1a22963236c6015724bfbf43dd56dbe40a6cf9,1,6,3,9,3,2012-05-10 16:31:48,2012-05-10 16:29:34
1c1a22963236c6015724bfbf43dd56dbe40a6cf9...169b1a404c8118bb75840523d5fb3543de9c8889,20,73,73,146,66,2012-05-10 18:15:49,2012-05-10 18:14:04
169b1a404c8118bb75840523d5fb3543de9c8889...c970bcf36897bcfff0a44a9ca0328dd0d1409b07,1,1,1,2,1,2012-05-10 19:32:52,2012-05-10 19:31:41
c970bcf36897bcfff0a44a9ca0328dd0d1409b07...b1155adcde0282a533a5ad1d7220adbd52011230,2,2,0,2,2,2012-05-10 19:42:13,2012-05-10 19:42:13
b1155adcde0282a533a5ad1d7220adbd52011230...73f7d346997d9520ea672b4f311349d7ba8b9075,1,6,2,8,1,2012-05-10 20:01:11,2012-05-10 20:01:11
73f7d346997d9520ea672b4f311349d7ba8b9075...46648b641d86b663f825227df5af5473f13a3fb4,3,5,5,10,4,2012-05-10 20:19:01,2012-05-10 20:19:01
46648b641d86b663f825227df5af5473f13a3fb4...d171b3cc0b32374fd5891254b04693e9ec8ed946,1,12,0,12,1,2012-05-10 20:34:03,2012-05-10 20:34:03
d171b3cc0b32374fd5891254b04693e9ec8ed946...3dde02640c1bec4a2b34d12e6f92aa0a7f035227,1,1,0,1,1,2012-05-10 20:44:40,2012-05-10 20:44:40
3dde02640c1bec4a2b34d12e6f92aa0a7f035227...1c30063faf88662c26c2e8847f1544cdb078e395,1,2,2,4,2,2012-05-11 06:53:36,2012-05-11 06:53:36
1c30063faf88662c26c2e8847f1544cdb078e395...367379581fe11ff8a5a7b8729829197750c4dbb0,1,3,2,5,1,2012-05-11 10:43:43,2012-05-11 10:43:43
367379581fe11ff8a5a7b8729829197750c4dbb0...0611e1fed2308ad5613cffd3629dfa5a97248dff,1,1,1,2,1,2012-05-11 18:15:30,2012-05-11 18:15:30
0611e1fed2308ad5613cffd3629dfa5a97248dff...25128856f51cd795d176c3da7808913a45e2b964,1,1,1,2,1,2012-05-11 18:51:19,2012-05-11 17:03:51
25128856f51cd795d176c3da7808913a45e2b964...365853da016f242937a657b488514e2f69fa6d82,8,272,17,289,24,2012-05-12 07:29:41,2012-05-12 07:24:20
365853da016f242937a657b488514e2f69fa6d82...de79d23ce04193e0bc140991533359002f62ddf9,1,4,1,5,2,2012-05-12 09:03:46,2012-05-12 09:00:03
de79d23ce04193e0bc140991533359002f62ddf9...33ffd28d76d775c970691a3da282e98b349735c4,3,9,3,12,6,2012-05-12 17:58:32,2012-05-12 17:58:32
33ffd28d76d775c970691a3da282e98b349735c4...bbb12581dbd91945857cb4731368671776d4d388,3,17,17,34,12,2012-05-12 20:35:21,2012-05-12 20:32:43
bbb12581dbd91945857cb4731368671776d4d388...fcb09b5746192fea1b672346c915ee11e4120d7e,2,76,12,88,16,2012-05-14 20:40:45,2012-05-14 20:40:45
fcb09b5746192fea1b672346c915ee11e4120d7e...bb4452f212e211bca7b6b57904d59270ffd7a503,1,8,1,9,1,2012-05-15 07:21:10,2012-05-15 07:18:16
bb4452f212e211bca7b6b57904d59270ffd7a503...085c03e08b29fafc92ef49c2a3717ec23cf1c500,1,3,2,5,3,2012-05-15 08:08:34,2012-05-15 08:08:34
9313dea7006ab77d54735fdd5825a812684e7144...d0b353696478a05937377dd5c8289e69a95f059a,3,63,52,115,10,2012-09-17 20:16:36,2012-09-17 20:16:36
d0b353696478a05937377dd5c8289e69a95f059a...c5e2ecae6949d4e89530610d768bbbd563ddc19b,2,8,1,9,2,2012-09-17 22:45:00,2012-09-17 22:45:00
c5e2ecae6949d4e89530610d768bbbd563ddc19b...06227fbb835aabab1f4bfb9ef26c9d07c90ff8ea,1,3,3,6,3,2012-09-17 22:51:48,2012-09-17 22:51:48
06227fbb835aabab1f4bfb9ef26c9d07c90ff8ea...ae6ffd2e7ef69180560eaeae9a00f76cd3721691,3,43,11,54,13,2012-09-18 09:37:30,2012-09-18 09:37:30
ae6ffd2e7ef69180560eaeae9a00f76cd3721691...7e8c64d8e68398937028400f801dbe02a830f9d4,1,3,12,15,2,2012-09-18 09:59:03,2012-09-18 09:59:03
7e8c64d8e68398937028400f801dbe02a830f9d4...dbc17d035b255a4da977251fe399f5c80cffeecd,1,12,20,32,7,2012-09-21 22:36:26,2012-09-21 22:36:26
dbc17d035b255a4da977251fe399f5c80cffeecd...49d1e6b0e20a363cbf9b105e8e6d3fc5fc1cad2f,6,72,83,155,26,2012-09-21 23:47:04,2012-09-21 23:47:04
49d1e6b0e20a363cbf9b105e8e6d3fc5fc1cad2f...45e5eedea99ed5aaa1df8ab505527566097e2328,1,4,10,14,6,2012-09-22 00:17:08,2012-09-22 00:17:08
45e5eedea99ed5aaa1df8ab505527566097e2328...9234131c05ec0c63e035883d9586cb1630f3881a,1,1,1,2,1,2012-09-22 00:22:43,2012-09-22 00:22:43
9234131c05ec0c63e035883d9586cb1630f3881a...3074243a5fdd2116fdd34d4cbcd58c45fe35e12a,1,2,1,3,1,2012-09-22 00:22:58,2012-09-22 00:22:58
3074243a5fdd2116fdd34d4cbcd58c45fe35e12a...f0e09e27f6461cf65cbaa68c097e8368e0f14ec0,1,1,0,1,1,2012-09-24 11:16:16,2012-09-24 11:16:16
f0e09e27f6461cf65cbaa68c097e8368e0f14ec0...1a6d07783d980664312ce729e1fc8867ad1a3b5c,1,3,3,6,3,2012-09-24 11:19:32,2012-09-24 11:19:32
1a6d07783d980664312ce729e1fc8867ad1a3b5c...e3c9742cd462706d4da76fcdd6ede7dd1354ad6c,1,1,1,2,1,2012-09-24 11:51:50,2012-09-24 11:51:50
e3c9742cd462706d4da76fcdd6ede7dd1354ad6c...588b839b26d922f2ddc2bbdd6377367f31e4ab4d,1,1,1,2,1,2012-09-24 11:52:43,2012-09-24 11:52:43
588b839b26d922f2ddc2bbdd6377367f31e4ab4d...0354cecbfd0cbd4e7440d56332dbb4d20f6a2fb2,3,19,3,22,4,2012-09-24 11:56:17,2012-09-24 11:53:37
0354cecbfd0cbd4e7440d56332dbb4d20f6a2fb2...49dc1e7d28477534daa61a34df2f0308742287e4,1,2,2,4,2,2012-09-24 12:15:08,2012-09-24 12:15:08
49dc1e7d28477534daa61a34df2f0308742287e4...3a338d00ec0d32d54faa0bf88409d02638eae60d,1,2,0,2,1,2012-09-24 12:17:38,2012-09-24 12:17:38
3a338d00ec0d32d54faa0bf88409d02638eae60d...d146b250aecd7adb13ad7b998cc60cc3a10fd0b6,1,1,1,2,1,2012-09-24 12:18:14,2012-09-24 12:18:14
d146b250aecd7adb13ad7b998cc60cc3a10fd0b6...0bcfc068b011c41aeed135649276106147d90d70,1,4,0,4,2,2012-09-24 12:23:25,2012-09-24 12:23:25
0bcfc068b011c41aeed135649276106147d90d70...15c1920964d2ff9a820986232cac11ae2dea048d,1,11,4,15,3,2012-09-24 12:30:17,2012-09-24 12:30:17
15c1920964d2ff9a820986232cac11ae2dea048d...b6784bee66d2c310318b6553fbb13f5707475efb,1,1,5,6,1,2012-09-24 12:40:56,2012-09-24 12:40:56
b6784bee66d2c310318b6553fbb13f5707475efb...a589fdff81ab36c57ff0a1003e60ee0dd55f3a88,1,1,0,1,1,2012-09-24 12:55:37,2012-09-24 12:55:37
33f8afda3af50792d717e56ecd41eb6cd6cc908b...884f77bd15f051224cdd8de63597db05ff3d7f43,1,6,8,14,1,2013-01-01 20:00:52,2013-01-01 19:50:13
884f77bd15f051224cdd8de63597db05ff3d7f43...feb41c32468b6a17ac8e0f0b5c9575ffd3f08798,1,165,202,367,59,2013-01-01 22:00:34,2013-01-01 21:46:54
feb41c32468b6a17ac8e0f0b5c9575ffd3f08798...0d3f16b12ea92aff208c4bb88d342eb787c92f71,1,15,15,30,3,2013-01-01 23:45:57,2013-01-01 23:45:57
0d3f16b12ea92aff208c4bb88d342eb787c92f71...695b2089e72a8ffec713b5107496b4332a4e0713,1,2,2,4,1,2013-01-02 20:33:18,2013-01-02 20:33:18
695b2089e72a8ffec713b5107496b4332a4e0713...07fbc6ae0e3b7742915b785c737b7e6e8a0e3503,5,79,9,88,18,2013-01-02 21:21:46,2013-01-02 20:42:52
07fbc6ae0e3b7742915b785c737b7e6e8a0e3503...a7b7efe78d5964efbf54463316f2d88ad51c929c,2,22,22,44,15,2013-01-02 21:21:46,2013-01-02 21:11:32
a7b7efe78d5964efbf54463316f2d88ad51c929c...a051a9d9297fa0c14e000d3cb8f47606cd9ae8a8,1,4,6,10,1,2013-01-02 21:46:36,2013-01-02 21:46:08
a051a9d9297fa0c14e000d3cb8f47606cd9ae8a8...3f890f8dc707eac30a72b7f79981d79e17ba0ff4,1,16,15,31,5,2013-01-02 22:37:05,2013-01-02 22:32:10
3f890f8dc707eac30a72b7f79981d79e17ba0ff4...9b5f64cc6ed5f1e904093fe4e6ff0f681b8e545f,83,729,613,1342,369,2013-01-02 23:32:57,2013-01-01 13:12:42
9b5f64cc6ed5f1e904093fe4e6ff0f681b8e545f...3fc43c964ef7ab52261ec3a164d66b19f06f5cea,2,21,5,26,6,2013-01-03 14:16:23,2013-01-03 14:13:51
3fc43c964ef7ab52261ec3a164d66b19f06f5cea...84ea85fb90a3914fef9ab74b1f4f5bb919bec068,1,2,4,6,1,2013-01-03 16:37:44,2013-01-03 16:37:40
84ea85fb90a3914fef9ab74b1f4f5bb919bec068...1b3f832ab7291b6d92a27288bb97b3a3b712ebcb,2,19,5,24,4,2013-01-03 17:49:00,2013-01-03 17:49:00
1b3f832ab7291b6d92a27288bb97b3a3b712ebcb...ffa50ca35219aa328e8e4ecda450a53c27c2e710,2,12,0,12,2,2013-01-03 19:41:45,2013-01-03 19:41:45
ffa50ca35219aa328e8e4ecda450a53c27c2e710...6248833d9e35926d6ccd4b4d602f7ea89fea0c74,2,5,1,6,2,2013-01-03 21:04:55,2012-12-30 22:59:02
6248833d9e35926d6ccd4b4d602f7ea89fea0c74...850630b4b7e79b76ad9732db1be6a2aa4257893f,1,2,2,4,2,2013-01-03 21:16:43,2013-01-03 21:12:11
850630b4b7e79b76ad9732db1be6a2aa4257893f...b740da3504ea3b9c841f5a9eb14191a0b5410565,3,24,1,25,4,2013-01-04 12:55:20,2013-01-04 12:55:20
b740da3504ea3b9c841f5a9eb14191a0b5410565...c8eff0dbcb0936aac2748a7a896d08f34b54c50f,1,16,13,29,4,2013-01-05 02:02:10,2013-01-05 01:42:25
c8eff0dbcb0936aac2748a7a896d08f34b54c50f...a843539af2f557e9bdc71b9b5ef66eabe0e39e3c,1,9,2,11,3,2013-01-05 17:04:00,2013-01-05 17:01:16
a843539af2f557e9bdc71b9b5ef66eabe0e39e3c...a2396a4c8f2ccd7f91adee6d8c2e9c31f13f0e3f,11,96,177,273,26,2013-01-06 17:18:28,2012-10-23 21:04:37
a2396a4c8f2ccd7f91adee6d8c2e9c31f13f0e3f...69a46c5ca7d4e6819096af88cd8d51174efd46df,1,41,1,42,2,2013-01-06 17:18:29,2012-12-17 21:48:23
69a46c5ca7d4e6819096af88cd8d51174efd46df...a890469d3bffe267aed0260fd267e44e53b14c5e,1,3,2,5,2,2013-01-06 21:59:23,2013-01-06 21:56:13
a890469d3bffe267aed0260fd267e44e53b14c5e...c698c55966ed9179828857398d27bf69e64713a2,3,5,2,7,3,2013-01-07 16:54:30,2013-01-07 16:54:30
c698c55966ed9179828857398d27bf69e64713a2...bb7f34d619bfe6b4e067af967ab30635c772def9,1,1,1,2,1,2013-01-08 03:16:46,2013-01-08 03:16:46
bb7f34d619bfe6b4e067af967ab30635c772def9...23ca3a01940c63942885df4709712cebf4df79ec,4,81,7,88,16,2013-01-08 17:17:13,2012-06-02 01:13:36
23ca3a01940c63942885df4709712cebf4df79ec...34ee7d9875d26809b0a2c6115edee0a35be0d17d,7,20,20,40,17,2013-01-08 18:08:15,2013-01-08 18:07:12
34ee7d9875d26809b0a2c6115edee0a35be0d17d...55da775ce1bfba20db33b56c29957faa63917980,3,32,1,33,4,2013-01-08 19:02:38,2013-01-06 16:40:56
55da775ce1bfba20db33b56c29957faa63917980...f58efd07ff2b2edb377d02567615e79e8d05248b,2,2,2,4,2,2013-01-08 19:13:43,2013-01-08 04:41:59
f58efd07ff2b2edb377d02567615e79e8d05248b...99315f709e26ea80de8ea3af4e336dbdbe467711,1,7,4,11,2,2013-01-08 20:43:35,2013-01-08 20:43:35
99315f709e26ea80de8ea3af4e336dbdbe467711...1884868adcc6945afaf7a96e01d35eafb623b847,2,9,8,17,5,2013-01-08 20:58:11,2013-01-08 20:58:11
1884868adcc6945afaf7a96e01d35eafb623b847...cfa70d0c94a43d94e3ee48db87f2b88c29a862e1,6,59,8,67,13,2013-01-09 16:19:22,2013-01-03 00:00:39
cfa70d0c94a43d94e3ee48db87f2b88c29a862e1...efa3f71cc4d35afe7e1ca479de2eca7808215d6f,1,1,2,3,1,2013-01-09 18:55:58,2013-01-09 18:55:58
efa3f71cc4d35afe7e1ca479de2eca7808215d6f...e6949373b0e4fcacde4cc269b647f1e1be8cade9,1,4,0,4,3,2013-01-09 19:02:09,2013-01-09 18:59:24
e6949373b0e4fcacde4cc269b647f1e1be8cade9...ce580dd8ea04237cfe34cd02df0b8944a5345f4f,1,2,1,3,1,2013-01-09 22:32:51,2013-01-09 22:32:51
ce580dd8ea04237cfe34cd02df0b8944a5345f4f...066cf2d70e30d6fae2a53b71b44137afa44ae5fa,1,0,9,9,1,2013-01-09 23:32:27,2013-01-09 23:32:27
066cf2d70e30d6fae2a53b71b44137afa44ae5fa...227bd3f8dbcedb4d90cf5474bc237ca4bd46d49d,1,1,1,2,1,2013-01-10 00:03:34,2013-01-10 00:03:34
227bd3f8dbcedb4d90cf5474bc237ca4bd46d49d...62f842e2e568c87387e3da3ab76600bd0aab3e95,2,11,4,15,4,2013-01-10 00:06:56,2013-01-09 09:07:44
62f842e2e568c87387e3da3ab76600bd0aab3e95...cdad0b28d49eecb13773c112410f3c126fdd1625,2,11,2,13,3,2013-01-10 08:06:04,2013-01-10 08:05:01
cdad0b28d49eecb13773c112410f3c126fdd1625...4da5947a876a4ec2cba9de8b0ef1513832328c67,1,11,11,22,6,2013-01-10 20:16:25,2013-01-10 20:16:25
4da5947a876a4ec2cba9de8b0ef1513832328c67...71d76ec011b393990ba9f5fb63727dbe36c3c440,4,100,7,107,9,2013-01-11 11:00:19,2013-01-11 10:59:17
71d76ec011b393990ba9f5fb63727dbe36c3c440...9f9a7f03d77e2b6002f841be42eccf8ff287f279,1,4,3,7,1,2013-01-11 12:01:56,2013-01-11 12:01:56
9f9a7f03d77e2b6002f841be42eccf8ff287f279...2e55cf580e48b02165b7aafb0d9368c714742137,1,4,1,5,2,2013-01-11 16:52:53,2013-01-11 16:49:55
2e55cf580e48b02165b7aafb0d9368c714742137...eb6c107624930c97390185fdbf7f887c50665808,4,49,1,50,7,2013-01-11 17:10:28,2013-01-11 05:57:54
eb6c107624930c97390185fdbf7f887c50665808...f9a46d7bc9b321214f75c2e5fa8f416405a59ed9,1,2,0,2,1,2013-01-11 18:31:39,2012-12-26 01:37:39
f9a46d7bc9b321214f75c2e5fa8f416405a59ed9...5362134090adce86c755a6ab48831ba834b70704,1,2,2,4,2,2013-01-11 18:52:47,2013-01-10 21:17:52
5362134090adce86c755a6ab48831ba834b70704...1bbd36a36add9b15db43014cf5e7bdb72a86fef1,1,7,7,14,1,2013-01-11 19:15:17,2013-01-11 19:15:17
1bbd36a36add9b15db43014cf5e7bdb72a86fef1...4e2e8f39d19d79a59c2696b2c40cb619a54fa745,3,47,22,69,5,2013-01-11 19:45:46,2013-01-11 19:42:33
4e2e8f39d19d79a59c2696b2c40cb619a54fa745...f08e739bc2ba5d3530a806378087227728369464,2,8,1,9,3,2013-01-11 20:09:33,2013-01-11 20:09:33
f08e739bc2ba5d3530a806378087227728369464...bcdb4898cae2f24599b39845b8e4cd7edc202424,3,10,3,13,5,2013-01-11 20:27:51,2013-01-11 20:27:51
bcdb4898cae2f24599b39845b8e4cd7edc202424...a170c3f755351beb35f8166ec3c7e9d524d9602d,1,0,14,14,3,2013-01-12 04:59:29,2013-01-12 04:59:29
a170c3f755351beb35f8166ec3c7e9d524d9602d...97121cb96e2f9f02f977010b5549b88f1a73610b,2,11,1,12,2,2013-01-12 14:50:18,2013-01-12 11:00:31
97121cb96e2f9f02f977010b5549b88f1a73610b...17f8496fea9b866769b2d2a04326acbe25e9256f,1,4,4,8,2,2013-01-12 14:55:06,2013-01-12 11:20:18
17f8496fea9b866769b2d2a04326acbe25e9256f...223fc8eaf9d04eb2c277a30f4f46745d4403b69b,5,15,8,23,10,2013-01-12 20:14:22,2013-01-12 20:10:08
223fc8eaf9d04eb2c277a30f4f46745d4403b69b...0171ba65dbbff377282c03b86c83036168c84b22,2,20,33,53,5,2013-01-12 20:46:08,2013-01-12 20:46:08
0171ba65dbbff377282c03b86c83036168c84b22...ba50d3e05bc9a33aef495a5fbca239afe52237b3,7,843,790,1633,65,2013-01-12 23:44:53,2013-01-12 23:44:53
ba50d3e05bc9a33aef495a5fbca239afe52237b3...0ca2d1e20a82d5ff0f86ac14988c5e348f9192c3,1,1,1,2,1,2013-01-13 18:36:49,2013-01-13 18:35:59
0ca2d1e20a82d5ff0f86ac14988c5e348f9192c3...4720117a31344483119856fb5ed803fe4c35936f,1,12,0,12,2,2013-01-13 20:11:24,2013-01-13 20:11:24
effc2cad95dbf96ee6fd0ac3fd2da18948135d49...3047981517ffa0c75c97f05446bd0d41865e323b,3,23,6,29,11,2012-07-08 16:17:53,2012-07-08 16:17:53
3047981517ffa0c75c97f05446bd0d41865e323b...1aa0d8ac4d3149fad6ebe80834d9e6f83021cf55,3,20,1,21,3,2012-07-08 16:25:12,2012-07-08 16:25:12
1aa0d8ac4d3149fad6ebe80834d9e6f83021cf55...146aff3bac974e56ec8cb597c2720d1cd4f77b26,1,11,29,40,6,2012-07-08 18:08:28,2012-07-07 16:39:09
146aff3bac974e56ec8cb597c2720d1cd4f77b26...d44aa98184ced66d95ba95d0e4a255d09c15df0c,1,6,6,12,2,2012-07-08 22:35:17,2012-07-08 22:35:17
d44aa98184ced66d95ba95d0e4a255d09c15df0c...590de18add78945344de049c2d3e7021fd46ce53,1,2,1,3,1,2012-07-08 23:26:53,2012-07-08 23:26:53
590de18add78945344de049c2d3e7021fd46ce53...1d2982362df1dbd9b08ffcc1d2506b2e3789250e,2,9,1,10,3,2012-07-09 12:10:54,2012-07-09 11:58:07
1d2982362df1dbd9b08ffcc1d2506b2e3789250e...d9db1d3373e9bee37258d7f6b50bea80c767a28c,2,8,3,11,4,2012-07-09 12:10:54,2012-07-09 12:07:01
d9db1d3373e9bee37258d7f6b50bea80c767a28c...828f7b62e8d29f796403606a797d7aec6da98647,2,7,3,10,3,2012-07-10 11:22:55,2012-07-10 11:22:55
d94cfdcfae92fd4409cd1b5e14eebc75033266fd...8e9865241600a2ee0541b30902b4b0c828d2e60b,1,1,1,2,1,2013-07-22 14:32:09,2013-07-22 14:32:09
d94cfdcfae92fd4409cd1b5e14eebc75033266fd...249c445446f0811d6396cfd3053aed33edf2e7b3,1,2,1,3,1,2012-07-07 21:08:43,2012-07-07 21:08:43
249c445446f0811d6396cfd3053aed33edf2e7b3...8015593bc1f2f226e7979bfdee8b7e88658d0e74,1,2,1,3,1,2012-07-07 22:41:04,2012-07-07 22:41:04
8015593bc1f2f226e7979bfdee8b7e88658d0e74...5e94ef293cb1cfe4dc43cbd5509653c0e0bf66cf,1,5,1,6,1,2012-07-08 09:53:45,2012-07-08 09:53:45
46cc530fad3c6ae4009557121971fe749742aef6...1ef1bceb3b79f73686e1857e5cdb051b8c11bc09,3,232,39,271,4,2012-08-07 20:06:34,2012-08-07 20:06:34
085c03e08b29fafc92ef49c2a3717ec23cf1c500...fbb73894395b728ec96c661da6f87523718c5398,3,11,2,13,5,2012-06-05 11:28:32,2012-06-05 11:28:32
085c03e08b29fafc92ef49c2a3717ec23cf1c500...5f75ac91df2ef1c19946f65e08aa50165f061cd4,4,71,8,79,7,2012-05-16 11:21:50,2012-05-16 11:21:46
4720117a31344483119856fb5ed803fe4c35936f...272de9eb6baad45abec029aae92c2b7d9478c841,2,24,10,34,6,2013-01-14 21:15:47,2013-01-11 22:12:22
272de9eb6baad45abec029aae92c2b7d9478c841...d53e3b15eee6cb89e3a4651b0f89b01fd30360d7,1,1,0,1,1,2013-01-14 21:15:47,2013-01-11 22:43:53
d53e3b15eee6cb89e3a4651b0f89b01fd30360d7...6045efa029dcae58ec6aab20bdcb0dc325851048,1,6,4,10,3,2013-01-14 21:15:47,2013-01-11 22:58:36
6045efa029dcae58ec6aab20bdcb0dc325851048...abbb88886bb1cd6013432c70586fbc118d378e27,1,6,9,15,2,2013-01-14 21:17:01,2013-01-14 21:17:01
abbb88886bb1cd6013432c70586fbc118d378e27...a7ed09d13d9532089bd2380edab1df5df96082a6,1,7,0,7,3,2013-01-14 21:34:55,2013-01-14 21:18:24
828f7b62e8d29f796403606a797d7aec6da98647...76d5daa60f90d3692b3ff3b7f5054e4bc7c1f374,1,2,2,4,2,2012-07-10 21:26:42,2012-07-10 21:26:42
828f7b62e8d29f796403606a797d7aec6da98647...5664338e22c1312e68293181a41b290434b2018a,1,1,1,2,1,2012-07-10 15:27:50,2012-07-10 15:27:50
29a09b3638e625458b5e07ed0956451432421acf...4bd55547214ae149acadffe60536c379d51e318f,3,19,1,20,4,2013-07-23 08:38:38,2013-07-23 08:38:38
4bd55547214ae149acadffe60536c379d51e318f...c00a8525c6a003b57afbe6cdef243ffad397dcbe,1,20,1,21,2,2013-07-23 10:40:50,2013-07-23 10:40:50
c00a8525c6a003b57afbe6cdef243ffad397dcbe...6b4967e88368934dbbb1f289c790ab813fa59c72,1,11,5,16,5,2013-07-23 12:34:29,2013-07-23 12:06:02
6b4967e88368934dbbb1f289c790ab813fa59c72...33242fe015a9519748cd328939dca3136f462344,3,72,4,76,9,2013-07-23 12:33:07,2012-10-24 15:11:41
33242fe015a9519748cd328939dca3136f462344...e716518ad29898fb25c820023aaf2fdd1c9eb4af,1,13,12,25,8,2013-07-23 13:20:43,2013-07-21 14:57:30
e716518ad29898fb25c820023aaf2fdd1c9eb4af...5dbca13f3baa2e1bafd77e84a80ad6d8a074712e,2,27,2,29,4,2013-07-23 13:43:12,2013-07-23 13:41:09
5dbca13f3baa2e1bafd77e84a80ad6d8a074712e...fb052b528ad5f0a92f7420ab8ade16462b6435fd,15,17,26,43,11,2013-07-23 15:28:22,2013-02-25 06:18:27
fb052b528ad5f0a92f7420ab8ade16462b6435fd...ad98b985aa18fbca65b45aae2421b985904bf561,1,2,1,3,2,2013-07-23 19:21:29,2013-07-23 19:20:53
ad98b985aa18fbca65b45aae2421b985904bf561...311c1d2848bde59bf03627e5c3d72b319285201b,1,1,1,2,1,2013-07-23 20:16:31,2013-07-23 17:32:09
311c1d2848bde59bf03627e5c3d72b319285201b...65e03a424e82e157b4513cdebb500891f5c78363,5,43,9,52,9,2013-07-23 20:21:23,2013-07-12 13:52:18
65e03a424e82e157b4513cdebb500891f5c78363...c928725b933ff479c04e8a7fb74c4dc2ba138aa7,1,3,0,3,1,2013-07-24 08:26:03,2013-07-23 20:58:43
c928725b933ff479c04e8a7fb74c4dc2ba138aa7...31c13a99bb9ebdaf12ccab4e880c5da930d86e79,9,64,9,73,14,2013-07-24 10:56:33,2013-07-16 13:10:04
e11e4fc1025e1ffd547bc92129109bb440b424c0...483fb75049847d483f073b5ff81e42970d81ac07,1,1,0,1,1,2012-08-07 20:25:21,2012-08-07 20:25:21
483fb75049847d483f073b5ff81e42970d81ac07...5c3bc25598bd8bcf726ac0cb6e35735b6fc1fcbf,1,2,1,3,1,2012-08-07 20:26:37,2012-08-07 20:26:37
5c3bc25598bd8bcf726ac0cb6e35735b6fc1fcbf...50c41e77e88e591b25080a8c870c8d08d47aa171,1,5,4,9,2,2012-08-07 20:28:12,2012-08-07 20:28:12
50c41e77e88e591b25080a8c870c8d08d47aa171...a4abe7ed56d44418c8203b4605085caf9b349654,1,7,7,14,2,2012-08-08 10:56:12,2012-08-08 10:56:12
a4abe7ed56d44418c8203b4605085caf9b349654...fa4cb348170134fce7e99eedf497ee8f5e0fe165,1,6,2,8,3,2012-08-08 11:07:49,2012-08-08 11:07:49
fa4cb348170134fce7e99eedf497ee8f5e0fe165...2da3af23aa10af3e06536a46134b1053f80eb8b2,1,8,4,12,8,2012-08-08 12:43:16,2012-08-08 11:43:21
2da3af23aa10af3e06536a46134b1053f80eb8b2...396357741b88dfcd85486db673dbb822da8b2de0,15,22,26,48,35,2012-08-08 12:50:01,2012-08-07 13:41:54
396357741b88dfcd85486db673dbb822da8b2de0...12cda89ffe6a03031a321d61ff8b91f9978e4b2e,1,1,1,2,1,2012-08-08 13:00:24,2012-08-07 13:49:33
12cda89ffe6a03031a321d61ff8b91f9978e4b2e...576ec12f8e7024679202b6213b8664ccd8b451b7,7,15,8,23,15,2012-08-08 13:02:31,2012-08-08 12:52:21
576ec12f8e7024679202b6213b8664ccd8b451b7...4c97101b1f0815a3f311fc77483b935fe62966bb,25,42,42,84,39,2012-08-08 14:33:15,2012-08-08 14:33:15
4c97101b1f0815a3f311fc77483b935fe62966bb...7515f6576b593c5f7a1ff2b2f934d5442b52b884,1,3,2,5,2,2012-08-08 14:37:10,2012-08-08 14:37:10
c346d358fdca2e375a0840664165a51a47f4ae69...222a956ecc5b163420d524a675ed01d75622ea6b,1,1,6,7,2,2013-01-15 18:15:40,2013-01-15 02:23:42
c346d358fdca2e375a0840664165a51a47f4ae69...2f8ab2f1b09ae8858720af53df77f19e83bd8f66,1,29,10,39,6,2013-01-15 12:46:54,2013-01-15 12:39:41
2f8ab2f1b09ae8858720af53df77f19e83bd8f66...43f89e0ad6fa111f3d53dfa71786353e0265bf39,9,17,17,34,17,2013-01-15 12:50:26,2013-01-15 11:29:53
43f89e0ad6fa111f3d53dfa71786353e0265bf39...c9b577ead6ca9a96e2066fd739b7c340dae5ca3a,1,8,3,11,2,2013-01-15 12:56:09,2013-01-15 11:19:49
c9b577ead6ca9a96e2066fd739b7c340dae5ca3a...74d72e21b405956bec9775b90e052e89f03a5e2e,1,1,1,2,1,2013-01-15 13:36:47,2013-01-15 13:36:47
74d72e21b405956bec9775b90e052e89f03a5e2e...984e91e28f3fb1d3f87f3f1de9fd54922b91c23c,1,3,3,6,2,2013-01-15 15:51:33,2013-01-15 15:51:33
984e91e28f3fb1d3f87f3f1de9fd54922b91c23c...83d0cc52141dbbd977da836fd7f77e0e735e2110,1,1,1,2,1,2013-01-15 15:55:38,2013-01-15 15:55:13
83d0cc52141dbbd977da836fd7f77e0e735e2110...50a985b09b439a0d52aad8694d377a3483cb02e1,8,147,61,208,31,2013-01-15 16:41:45,2013-01-01 21:28:48
50a985b09b439a0d52aad8694d377a3483cb02e1...4cf057faab0858ff73506e88dac4020e6eb96cf6,1,0,8,8,1,2013-01-15 17:02:24,2013-01-15 17:01:18
76d5daa60f90d3692b3ff3b7f5054e4bc7c1f374...fe443b11def46828a140bdd5521807e6a6c27bf8,1,1,1,2,1,2012-07-11 02:57:26,2012-07-11 02:57:26
c9a1f9d1fca6acd1361a7ae15c4dd7f58538233e...fb8ec2855bac1fd335a00ac5b550ae54aea3100f,1,0,2,2,1,2012-07-12 16:27:08,2012-07-12 16:22:09
fb8ec2855bac1fd335a00ac5b550ae54aea3100f...e806f047f3e54a0c3830cf669935a8f12854990b,1,0,50,50,2,2012-07-12 17:44:15,2012-07-12 16:49:32
e806f047f3e54a0c3830cf669935a8f12854990b...8c670ee34714acffbc64e5cafd1e664fb8341a37,1,15,5,20,3,2012-07-12 21:02:58,2012-07-12 21:02:58
8c670ee34714acffbc64e5cafd1e664fb8341a37...18b9dc41543616ba5b15d0400564e665b76701d1,5,8,8,16,6,2012-07-13 15:33:13,2012-07-13 15:30:45
18b9dc41543616ba5b15d0400564e665b76701d1...b6215f68100884600fb23bc2a16b9a8c27dd1d6b,1,3,3,6,2,2012-07-13 15:49:50,2012-07-13 15:49:50
b6215f68100884600fb23bc2a16b9a8c27dd1d6b...c13a98968e25c84b418c779004b3c8b0cdc81355,1,2,2,4,2,2012-07-14 10:32:39,2012-07-14 10:31:34
c13a98968e25c84b418c779004b3c8b0cdc81355...9a25d8618a6a3fa91605b17b55f9f89fddee9b8f,1,2,2,4,2,2012-07-14 10:32:39,2012-07-14 10:32:05
9a25d8618a6a3fa91605b17b55f9f89fddee9b8f...8f002867b2aa414c4f98bbd7992e3b44825b228a,3,18,30,48,18,2012-07-14 21:07:11,2012-07-14 21:07:11
8f002867b2aa414c4f98bbd7992e3b44825b228a...3e8d8bb094b9f765d94ac033b9135bcb81b816d2,1,7,2,9,3,2012-07-14 21:33:13,2012-07-14 21:33:13
3e8d8bb094b9f765d94ac033b9135bcb81b816d2...9877d25dc67b9c852e1a69ece6153894d4c9d1d1,1,1,1,2,1,2012-07-14 23:02:30,2012-07-14 23:02:30
9877d25dc67b9c852e1a69ece6153894d4c9d1d1...8b3c2f2c51183bde47bd1e98057b77866f35dd6e,2,13,0,13,6,2012-07-14 23:08:42,2012-07-14 23:08:42
8b3c2f2c51183bde47bd1e98057b77866f35dd6e...0f57935bcd8cd525d8d661c5af4fb70b79e126ae,1,3,3,6,3,2012-07-15 00:08:52,2012-07-15 00:08:52
0f57935bcd8cd525d8d661c5af4fb70b79e126ae...c57abd3c29cedcca00821d2a0d5708f10977f3c6,3,3,49,52,4,2012-07-15 02:04:37,2012-07-15 02:04:37
c57abd3c29cedcca00821d2a0d5708f10977f3c6...fb46f243b4c48ab42ed2f33a2636f7c33f5861a9,3,6,6,12,5,2012-07-15 09:19:50,2012-07-15 09:19:00
fb46f243b4c48ab42ed2f33a2636f7c33f5861a9...bf9d5eff4cd74ffc8fcd1f610587e5ad00dc7f3f,1,6,6,12,1,2012-07-15 09:25:13,2012-07-15 09:25:13
bf9d5eff4cd74ffc8fcd1f610587e5ad00dc7f3f...34340517fc2ac324114791d784502de2a4780757,1,2,1,3,1,2012-07-15 09:30:27,2012-07-15 09:24:21
34340517fc2ac324114791d784502de2a4780757...cdcdd131da950741fa74debc21bef8632fd3c684,12,29,52,81,25,2012-07-15 19:10:32,2012-07-15 19:07:02
cdcdd131da950741fa74debc21bef8632fd3c684...35ddeee45573de57ae3c791bf36496b4a7028ddf,1,0,1,1,1,2012-07-15 19:19:23,2012-07-15 19:19:23
31c13a99bb9ebdaf12ccab4e880c5da930d86e79...5a5d59471719af520ddc203a6b81cd2f6ef81a20,1,1,1,2,1,2013-07-24 11:14:32,2013-07-24 11:14:32
03ec3219a04093da6c2e82436cee5c451df4f8aa...52eb19b545118e8c2044d106f4527ce2200c967a,1,2,8,10,3,2013-07-22 18:36:03,2013-07-22 18:36:03
52eb19b545118e8c2044d106f4527ce2200c967a...162f7b938f6cff91b1e4d6086ddcc88cbb1a1cd6,4,95,16,111,16,2013-07-22 18:43:58,2013-07-22 18:43:58
162f7b938f6cff91b1e4d6086ddcc88cbb1a1cd6...00276e0414ce796a71a28d4c675a22b041aa3450,6,84,37,121,11,2013-07-25 12:52:35,2013-07-25 12:52:35
00276e0414ce796a71a28d4c675a22b041aa3450...06103c8ef53b7ac71def7ed34c337bb4b7dd89d9,4,164,39,203,7,2013-07-25 13:45:38,2013-07-25 13:45:38
06103c8ef53b7ac71def7ed34c337bb4b7dd89d9...f8297f63233ccf78f923a597ed7d8327f90230c2,24,172,67,239,48,2013-07-25 15:19:36,2013-07-25 15:19:36
f8297f63233ccf78f923a597ed7d8327f90230c2...a758c9c1866559ab5dbf4a7705c07e8532dcd253,3,38,13,51,14,2013-07-25 15:36:58,2013-07-25 15:31:34
a758c9c1866559ab5dbf4a7705c07e8532dcd253...88e1e6f9f3fc6eb9f148805b6df6ec8af4cf6977,1,51,0,51,3,2013-07-26 15:28:09,2013-07-26 15:28:09
88e1e6f9f3fc6eb9f148805b6df6ec8af4cf6977...6b39010d5793689af2d3e5d9a2f9e92d99d0f105,1,2,14,16,3,2013-07-26 15:33:32,2013-07-26 15:33:32
6b39010d5793689af2d3e5d9a2f9e92d99d0f105...c1ed21fa9ee5f64bcf6f70fa30580989bd579a91,1,6,2,8,3,2013-07-26 15:39:44,2013-07-26 15:39:44
c1ed21fa9ee5f64bcf6f70fa30580989bd579a91...9c6d57ef5a242e4058b5743471db8f2b6273c86e,1,3,2,5,4,2013-07-26 15:40:27,2013-07-26 15:40:27
9c6d57ef5a242e4058b5743471db8f2b6273c86e...3f7113f1d976a9bd668afd8114269e8c594dd842,1,2,2,4,3,2013-07-26 15:46:48,2013-07-26 15:46:48
3f7113f1d976a9bd668afd8114269e8c594dd842...52643a69e3fac42c14143f3ca71ec9f5b7e64296,2,17,13,30,10,2013-07-26 15:47:00,2013-07-26 15:47:00
52643a69e3fac42c14143f3ca71ec9f5b7e64296...d5ca1693341daccce9b0dd8504967a56b289d92f,2,10,4,14,7,2013-07-26 15:52:17,2013-07-26 15:52:17
d5ca1693341daccce9b0dd8504967a56b289d92f...c8cbdabfab3a150904a2214930e82112d0231ff2,3,5,5,10,5,2013-07-26 16:08:12,2013-07-26 16:08:12
c8cbdabfab3a150904a2214930e82112d0231ff2...086389f5fc64bc47661f53332bf6ab3e2e882392,2,30,0,30,2,2013-07-30 10:52:36,2013-07-30 10:52:36
086389f5fc64bc47661f53332bf6ab3e2e882392...68e0a169c4f9fa7f8071e014b274fd59e970f9a3,13,113,74,187,54,2013-07-30 10:52:52,2013-07-30 10:52:52
68e0a169c4f9fa7f8071e014b274fd59e970f9a3...12e9804d163777af17cc2a3dfdfff49e5f750ebd,17,61,47,108,41,2013-07-30 11:08:59,2013-07-30 11:08:59
12e9804d163777af17cc2a3dfdfff49e5f750ebd...fddc5957c53bd654312c4a238a8cdcfe5f4ef4cc,6,156,44,200,23,2013-07-30 11:34:31,2013-07-30 11:34:31
7515f6576b593c5f7a1ff2b2f934d5442b52b884...074e65b04a82b4105ea9649c6ab8f5a796bc6984,1,1,1,2,1,2012-10-05 15:32:28,2012-10-05 15:32:28
7515f6576b593c5f7a1ff2b2f934d5442b52b884...0955d16a165e9da2f69813cc9983fd10dddbfa62,1,3,2,5,3,2012-08-08 14:50:59,2012-08-08 14:50:59
0955d16a165e9da2f69813cc9983fd10dddbfa62...db729266d6feb3b4b4519bd789c4693b9aac00d1,4,5,5,10,5,2012-08-08 16:02:25,2012-08-08 15:59:31
7f3678dc4cd7146c49bac3fb8f5211f647636aa3...6e21a59402e1a90c16113e1fac8e4ff39b6914d3,2,6,4,10,4,2013-04-19 08:01:45,2013-04-19 08:01:45
6e21a59402e1a90c16113e1fac8e4ff39b6914d3...ade34c44dae4f5cf9d51bf7f900bf06efa98ff12,1,2,0,2,1,2013-05-09 13:04:07,2013-05-09 13:04:07
ade34c44dae4f5cf9d51bf7f900bf06efa98ff12...941d23e54890bcc9e73734c5c1f3c82193fd97d6,1,1,1,2,1,2013-05-09 13:13:15,2013-05-09 13:13:15
941d23e54890bcc9e73734c5c1f3c82193fd97d6...104ad0504b4b123277b3f0e7c0be7fb9e84c2d72,6,112,115,227,47,2013-05-09 14:16:43,2013-05-09 14:16:43
104ad0504b4b123277b3f0e7c0be7fb9e84c2d72...75bf394d86b802de670502400e9ab7eca2808935,5,115,43,158,17,2013-05-09 14:59:26,2013-05-09 14:59:26
75bf394d86b802de670502400e9ab7eca2808935...f6801a234fb9460eac80d146534ac340e178c466,6,224,0,224,3,2013-05-10 11:52:04,2013-05-10 11:52:04
b4b00349179208c5c7ec6a7e1715663afc40cb1a...d406afe12edcedbaf745225713ebf3e36fa776fc,1,12,9,21,1,2013-01-16 01:00:05,2013-01-15 20:47:31
d406afe12edcedbaf745225713ebf3e36fa776fc...eee865257aaa9005947a7b4994c475c2ad59d698,4,63,13,76,17,2013-01-16 23:29:06,2013-01-16 18:36:22
eee865257aaa9005947a7b4994c475c2ad59d698...248aee16066b2a336f16c844580cf043d853874b,2,15,12,27,6,2013-01-16 23:48:06,2013-01-16 19:21:47
248aee16066b2a336f16c844580cf043d853874b...295650bd01bc4d68e918b483a2366a092dae6636,2,5,5,10,5,2013-01-17 03:35:46,2013-01-17 03:35:46
295650bd01bc4d68e918b483a2366a092dae6636...6158c79dbef832bc8530107ab2d34f04a04471da,8,171,14,185,14,2013-01-17 03:53:17,2012-06-07 09:23:25
6158c79dbef832bc8530107ab2d34f04a04471da...3647c0a49a2f4535b8a9aba40e662743e4d53e76,3,6,11,17,9,2013-01-18 05:09:39,2013-01-18 05:09:39
3647c0a49a2f4535b8a9aba40e662743e4d53e76...56f34f9f225026ccd8e36b2cf917d09b8f55d393,1,0,14,14,2,2013-01-18 14:00:57,2013-01-18 13:57:17
56f34f9f225026ccd8e36b2cf917d09b8f55d393...1dd749284325ea8fe747a3728ed92bafef4ff6a0,1,1,1,2,1,2013-01-18 19:52:04,2013-01-18 19:50:12
1dd749284325ea8fe747a3728ed92bafef4ff6a0...0375244eaeae1e2c09cc58c4c62e8f9e951217d0,1,3,2,5,1,2013-01-18 23:38:12,2013-01-18 23:38:12
0375244eaeae1e2c09cc58c4c62e8f9e951217d0...d194f290571f7e9dda7d2fd7a6f2b171120f2f14,1,5,4,9,1,2013-01-19 07:27:16,2013-01-15 13:05:58
d194f290571f7e9dda7d2fd7a6f2b171120f2f14...755f215590af5a9bc70917412b28cd710318ec63,1,313,313,626,20,2013-01-19 11:05:06,2013-01-17 12:33:04
755f215590af5a9bc70917412b28cd710318ec63...37718eb50b60f44462a64f735072e43a9d60b9a6,1,5,5,10,5,2013-01-19 15:58:33,2013-01-19 15:06:52
37718eb50b60f44462a64f735072e43a9d60b9a6...fe54377dae1357a7f102d72614a13f0ef8b2dbdf,9,164,77,241,20,2013-01-20 04:39:35,2013-01-12 08:37:19
fe54377dae1357a7f102d72614a13f0ef8b2dbdf...f96c86b02943009d4c2e01d8e4457db040723a25,1,2,0,2,1,2013-01-20 04:45:00,2013-01-20 04:45:00
f96c86b02943009d4c2e01d8e4457db040723a25...7aa538357c8d94df3d5811706bf6dfe5d21421ca,1,1,17,18,5,2013-01-20 06:53:45,2013-01-20 06:53:45
7aa538357c8d94df3d5811706bf6dfe5d21421ca...c6e0dedbdb22f4db6577886a2b67e5423684fe7f,2,5,1,6,2,2013-01-21 19:32:36,2013-01-21 19:27:38
c6e0dedbdb22f4db6577886a2b67e5423684fe7f...013db6ba85fb880bd1f9a5ad2e91dc5c1efe197c,2,21,4,25,3,2013-01-21 21:34:36,2013-01-21 21:34:36
013db6ba85fb880bd1f9a5ad2e91dc5c1efe197c...8ce1e392fa785895be561b3164df53dc11091054,1,1,1,2,1,2013-01-21 21:42:47,2013-01-21 21:42:47
8ce1e392fa785895be561b3164df53dc11091054...456f9b98471e2aab71c6f58e3bf40a1026a3b466,1,3,5,8,4,2013-01-22 02:22:18,2013-01-22 02:22:18
456f9b98471e2aab71c6f58e3bf40a1026a3b466...cc4de61a2b36abf418d6f4c720d9e62c405e0612,12,31,31,62,31,2013-01-22 11:47:34,2013-01-22 11:47:34
cc4de61a2b36abf418d6f4c720d9e62c405e0612...e535da6865f0e02f0b593b52ed2e040b24a886d6,1,3,3,6,3,2013-01-22 12:50:10,2013-01-22 12:46:42
e535da6865f0e02f0b593b52ed2e040b24a886d6...5b2d9bacd2512bcdf371c05b0b43bc713dcca080,3,22,8,30,9,2013-01-22 12:55:34,2013-01-22 11:46:22
5b2d9bacd2512bcdf371c05b0b43bc713dcca080...214fb700b9e0fb7268a2c8b87595b1b9fb090867,2,24,9,33,3,2013-01-22 23:17:26,2013-01-22 21:13:57
35ddeee45573de57ae3c791bf36496b4a7028ddf...bebbbb7af096ecffc0d7585617fdfacb196bc7c2,2,22,0,22,3,2012-07-16 16:52:31,2012-07-16 16:52:31
bebbbb7af096ecffc0d7585617fdfacb196bc7c2...aeda55e6bffc3cfbf53698af398a19c1a0f02d46,4,34,7,41,4,2012-07-16 17:57:55,2012-07-05 15:09:48
35ddeee45573de57ae3c791bf36496b4a7028ddf...dea554bd9df193ee11b7d924ffa0631fabdfdaee,2,112,4,116,11,2012-07-16 00:30:39,2012-07-16 00:30:39
dea554bd9df193ee11b7d924ffa0631fabdfdaee...b90caf014c8cb447d34217e81bbc3fb57b2df89b,1,1,1,2,1,2012-07-16 02:29:19,2012-07-16 02:29:19
b90caf014c8cb447d34217e81bbc3fb57b2df89b...1fefd91e1e9facc786d27e3234cb69c4212f6d1d,2,21,7,28,5,2012-08-04 20:01:40,2012-08-04 20:01:40
372158a3cfedfc76d931f73cc3acf148babc4248...b2314d9e1e08749f2c05151f9cd44520d2b3a03a,2,29,7,36,7,2013-07-24 11:33:03,2013-02-28 08:00:38
b2314d9e1e08749f2c05151f9cd44520d2b3a03a...bd0dcc6c89e262780df3c17f18b2462f50b48137,7,28,8,36,10,2013-07-24 17:41:45,2013-07-18 15:10:49
bd0dcc6c89e262780df3c17f18b2462f50b48137...10f8a2100279621ca0e0fa47d99ee744741a05e7,1,9,0,9,1,2013-07-24 21:58:14,2013-07-24 21:58:14
10f8a2100279621ca0e0fa47d99ee744741a05e7...dab52d99fc821f31ab64177551b90d0a513f1eee,1,1,1,2,1,2013-07-25 11:38:14,2013-07-25 10:57:49
dab52d99fc821f31ab64177551b90d0a513f1eee...92476e880caae75b1abad6ca50f821f9698c6c1e,3,23,3,26,5,2013-07-25 13:25:23,2013-07-25 13:25:23
92476e880caae75b1abad6ca50f821f9698c6c1e...8c9240222fd882d9ae3819ff289989df1bcd05d7,1,20,0,20,1,2013-07-25 15:06:41,2013-07-25 12:48:22
8c9240222fd882d9ae3819ff289989df1bcd05d7...9b88dd3809a178e5bdc2e4a5d2794c2842a2cd43,1,1,1,2,1,2013-07-25 16:31:53,2013-07-25 16:31:53
9b88dd3809a178e5bdc2e4a5d2794c2842a2cd43...bddb4a68181f773f9f8d479b1afb1453439739ba,1,10,0,10,1,2013-07-25 17:03:15,2013-07-25 17:03:15
bddb4a68181f773f9f8d479b1afb1453439739ba...5ed7ec99b6cef20b941d2f35838864d1e440ac6b,1,2,0,2,1,2013-07-25 18:14:51,2013-07-25 18:14:18
5ed7ec99b6cef20b941d2f35838864d1e440ac6b...8f3aefdec33f6cb4bdda142ff9f7fa423c0bebbd,2,27,30,57,9,2013-07-25 22:19:17,2013-07-25 22:17:40
8f3aefdec33f6cb4bdda142ff9f7fa423c0bebbd...31fadc120213284da76801cc7bc56e9f32d7281b,10,390,127,517,33,2013-07-26 09:41:27,2013-07-26 08:59:40
31fadc120213284da76801cc7bc56e9f32d7281b...7cca8d56d28e321ffc395c92f82d97adaa0dcf94,2,17,1,18,2,2013-07-26 10:13:27,2013-07-26 10:02:32
7cca8d56d28e321ffc395c92f82d97adaa0dcf94...2a979d2a7bec485e4b90b7ae99ace0dd16faa948,4,18,6,24,9,2013-07-26 11:22:30,2013-07-26 11:22:30
2a979d2a7bec485e4b90b7ae99ace0dd16faa948...8676318d2dae9a570d2314e4e6da8c00aaf2e2a0,6,40,10,50,12,2013-07-26 18:45:38,2013-07-26 18:43:46
8676318d2dae9a570d2314e4e6da8c00aaf2e2a0...e07e4030b9170d522a9670a80c4fd40acff369cb,8,84,28,112,23,2013-07-27 18:23:04,2012-07-03 09:50:40
e07e4030b9170d522a9670a80c4fd40acff369cb...ca39c0a6becf497880181b3a5ef6db84130f9723,1,30,0,30,1,2013-07-28 00:18:32,2013-02-23 23:01:45
ca39c0a6becf497880181b3a5ef6db84130f9723...47c755327be9a3b976f5f78fc21f336f27aa6413,28,31,31,62,31,2013-07-28 01:46:03,2013-07-28 01:45:25
47c755327be9a3b976f5f78fc21f336f27aa6413...4e0ff351466fc2d74cc8d1d40ea78da2b3859d0d,4,32,12,44,13,2013-07-28 02:50:02,2013-07-28 02:50:02
4e0ff351466fc2d74cc8d1d40ea78da2b3859d0d...0d0ccf81a0c18f42866d914672469f720861988a,2,4,4,8,2,2013-07-28 02:52:59,2013-07-28 02:52:59
0d0ccf81a0c18f42866d914672469f720861988a...b70c371fc1f18ea0c43b503122df3f311afc7105,3,21,12,33,8,2013-07-28 08:05:39,2013-07-28 08:05:39
b70c371fc1f18ea0c43b503122df3f311afc7105...0b35a2cce3d183dac3fed404029a5ed463a45f26,1,1,1,2,1,2013-07-28 18:09:29,2013-07-28 18:09:29
0b35a2cce3d183dac3fed404029a5ed463a45f26...33e6cf5ec324bb1154ae1a0379f9c9ef6ff51420,1,18,62,80,9,2013-07-29 08:54:53,2013-07-26 09:48:24
33e6cf5ec324bb1154ae1a0379f9c9ef6ff51420...c694e6220ec78ed28ec7f621035ec21c8923a0c1,1,5,5,10,1,2013-07-29 10:51:54,2013-07-28 10:58:19
c694e6220ec78ed28ec7f621035ec21c8923a0c1...70c080fcdb7acbc4c3f86ee85ea84b5861c26bb9,2,6,5,11,4,2013-07-29 10:57:33,2013-07-28 10:58:19
70c080fcdb7acbc4c3f86ee85ea84b5861c26bb9...382c53d7d88da70a3645c6db063995382f61dc45,3,36,18,54,16,2013-07-29 12:03:51,2013-02-23 19:34:59
382c53d7d88da70a3645c6db063995382f61dc45...ac0955876089002f0f60857d09fe1c94d67eca4f,4,46,4,50,6,2013-07-29 13:53:47,2013-07-28 15:11:04
ac0955876089002f0f60857d09fe1c94d67eca4f...fdd7a355bf053217d25b8d2189e37069c1304283,38,64,49,113,81,2013-07-29 15:10:22,2013-07-29 13:50:58
fdd7a355bf053217d25b8d2189e37069c1304283...e4937b6dde5c30f34c8a65960d7d48b5d7ade356,1,1,0,1,1,2013-07-29 15:10:23,2013-07-29 15:07:50
e4937b6dde5c30f34c8a65960d7d48b5d7ade356...402b4a7a20a4f00fce0f01cdc3f5f97967fdb935,1,30,42,72,6,2013-07-29 16:37:43,2013-07-29 15:50:41
402b4a7a20a4f00fce0f01cdc3f5f97967fdb935...5c1143910e071c73671424036408c4548742d24f,264,194,366,560,275,2013-07-29 18:28:13,2013-07-29 17:19:04
5c1143910e071c73671424036408c4548742d24f...05ea5a213935b6f1c02f634b6a7674bd2f296458,1,1,1,2,1,2013-07-29 22:41:08,2013-07-29 22:41:08
05ea5a213935b6f1c02f634b6a7674bd2f296458...6ed579e7eb6e1eda3dd1b0afb306d58b9498bfa0,1,1,1,2,1,2013-07-30 00:21:06,2013-07-30 00:21:06
6ed579e7eb6e1eda3dd1b0afb306d58b9498bfa0...e351dbf6ee5d344a0fe73a6d05c7dcad7b1d2e9c,5,71,22,93,9,2013-07-30 07:21:08,2013-07-30 07:21:08
e351dbf6ee5d344a0fe73a6d05c7dcad7b1d2e9c...53e9ab72e92f4fc8a11f95713ae16e217baf963a,2,11,11,22,2,2013-07-30 07:21:33,2013-07-30 07:21:33
53e9ab72e92f4fc8a11f95713ae16e217baf963a...d4dd55e78ccc8d38de750313f75d6921137e71ab,2,4,3,7,2,2013-07-30 12:06:49,2013-07-30 12:06:49
d4dd55e78ccc8d38de750313f75d6921137e71ab...7b57e575c94691e40533e84d84235a0c6c90ab7b,5,67,23,90,26,2013-07-30 13:26:18,2013-02-23 15:28:45
7b57e575c94691e40533e84d84235a0c6c90ab7b...5b47a9c5a0dcb513dc5ff68b617b3aa374c90f3b,1,4,0,4,1,2013-07-30 14:14:53,2013-07-30 14:14:53
5b47a9c5a0dcb513dc5ff68b617b3aa374c90f3b...dffda2ba4e55d4567b3a829d410dae794636ebdd,2,16,11,27,2,2013-07-30 15:30:20,2013-07-30 15:30:20
dffda2ba4e55d4567b3a829d410dae794636ebdd...8550df869bef11d176aa926aa056df9f3566a304,1,0,4,4,1,2013-07-30 15:59:04,2013-07-30 15:59:04
8550df869bef11d176aa926aa056df9f3566a304...dafec05548acdc3146d5fe850528f9e017681a07,1,1,0,1,1,2013-07-30 17:04:30,2012-11-28 16:48:04
dafec05548acdc3146d5fe850528f9e017681a07...75cf5fc7f0244c081cc25651d066de3ba852f1e8,1,26,14,40,4,2013-07-30 17:22:41,2013-07-26 21:32:56
75cf5fc7f0244c081cc25651d066de3ba852f1e8...3c45fb8589bfff580bb4d9d3c13172183c597abd,2,15,3,18,6,2013-07-30 17:39:44,2013-04-20 03:20:01
3c45fb8589bfff580bb4d9d3c13172183c597abd...5154c9f92caa38bd5893320ed72fbc7305233822,1,27,12,39,5,2013-07-30 18:25:30,2013-07-25 19:27:23
de64c4d6e97c980fb4c0ace045fc4070b3f763d9...1d1cfd0bd8016358719a1e73117c811f02ca8c02,1,27,0,27,1,2013-08-09 13:31:24,2013-08-09 13:31:24
ab696e3a21a1a7b943e704b24749f43c4d036e15...ab8c9703683856eef0346b661e36d6f05db67435,1,4,4,8,1,2012-10-05 21:17:21,2012-10-05 21:14:56
ab8c9703683856eef0346b661e36d6f05db67435...950e6183c60d368c62f627eaed54961be0a207d8,2,6,4,10,4,2012-10-05 21:38:01,2012-10-05 21:38:01
950e6183c60d368c62f627eaed54961be0a207d8...db78086b4540f968620ffe465174d7094267f04b,1,6,3,9,2,2012-10-05 21:47:04,2012-10-05 21:47:04
db78086b4540f968620ffe465174d7094267f04b...c1b06c8137d82ab34204f62aa4324335b1fd9a23,1,1,1,2,1,2012-10-05 21:55:15,2012-10-05 21:55:15
c1b06c8137d82ab34204f62aa4324335b1fd9a23...1c010ce41d6790b94d396aabe5c585cf1cc04b70,1,3,0,3,3,2012-10-05 22:26:33,2012-10-05 22:26:33
1c010ce41d6790b94d396aabe5c585cf1cc04b70...065b52f18e7016b385feb8ad3de5dafb72ad202d,1,5,8,13,3,2012-10-05 22:43:04,2012-10-05 22:43:04
065b52f18e7016b385feb8ad3de5dafb72ad202d...5a64bd38e61aeeaf4476a42aca06654f5ce6e429,1,1,1,2,2,2012-10-05 22:51:45,2012-10-05 22:51:45
5a64bd38e61aeeaf4476a42aca06654f5ce6e429...84f9741664dadb3185c3d8822b720b340374066e,1,4,2,6,1,2012-10-05 23:08:16,2012-10-05 23:08:16
db729266d6feb3b4b4519bd789c4693b9aac00d1...7731cc8689b47ca83e988919b44bcec2c6728e4e,1,26,25,51,6,2012-08-08 16:49:28,2012-08-08 16:49:28
cb4b0de49e027f09f8abe63e2fa43f60fc1ef13f...9ce83546720b9536c02817e802c9376eb74f811d,9,265,9,274,17,2013-05-10 15:00:55,2013-05-10 15:00:55
9ce83546720b9536c02817e802c9376eb74f811d...8a1f0177778275d8ee4707ef0dca79553b03a035,2,46,2,48,4,2013-05-10 15:09:57,2013-05-10 15:09:57
8a1f0177778275d8ee4707ef0dca79553b03a035...eb5e50215a630ed028eca2d85d4131e9e186377d,1,28,1,29,3,2013-05-10 15:18:19,2013-05-10 15:18:19
eb5e50215a630ed028eca2d85d4131e9e186377d...76d93a52cd56be23104f824e6755ecc8d3a34d94,4,146,0,146,4,2013-05-10 16:07:13,2013-05-10 16:07:13
214fb700b9e0fb7268a2c8b87595b1b9fb090867...389892aae595b86c4be28c43e3312d76a68a0173,1,0,7,7,1,2013-01-23 00:26:20,2013-01-23 00:26:20
214fb700b9e0fb7268a2c8b87595b1b9fb090867...0db86273ae1c31ee9881fe63f210cb2120fde18a,1,6,0,6,1,2013-01-23 00:02:31,2013-01-22 21:15:52
aeda55e6bffc3cfbf53698af398a19c1a0f02d46...f2abfe1e4853df1848d178c3de369c80932292e8,2,33,5,38,9,2012-07-17 17:45:35,2012-07-17 00:37:52
aeda55e6bffc3cfbf53698af398a19c1a0f02d46...fcad6c48f07bdc6346c065849a87f0f02afb6f94,2,22,5,27,3,2012-07-17 09:49:46,2012-07-17 09:24:56
fcad6c48f07bdc6346c065849a87f0f02afb6f94...29132ebdef0e0b9c09e456b05f0e6a22f1106a4f,8,110,38,148,21,2012-07-17 12:24:41,2012-04-29 01:22:05
5154c9f92caa38bd5893320ed72fbc7305233822...4c6ffcf721b9a36b9b7e4730f4f4716cc90a5f02,4,16,6,22,5,2013-07-31 08:58:50,2013-07-31 07:11:49
588b523233e6cd3e7f9695b76ba639fe26fe5192...679627660fef3c7a9f7be743a168930e4a0e58ae,1,1,3,4,2,2013-08-09 16:34:35,2013-08-09 16:34:35
679627660fef3c7a9f7be743a168930e4a0e58ae...9f736294205486443f047e93f8ca53b5b00ac1d3,4,3,4,7,6,2013-08-09 16:36:16,2013-08-09 16:36:16
9f736294205486443f047e93f8ca53b5b00ac1d3...b3cec920a2a7d547944823c539a7ebd99b3af23a,1,0,2,2,2,2013-08-09 16:39:07,2013-08-09 16:39:07
b3cec920a2a7d547944823c539a7ebd99b3af23a...fb16ee5a31256c1e230a697044c3ded2dbdec3e8,1,0,1,1,1,2013-08-09 16:41:39,2013-08-09 16:41:39
fb16ee5a31256c1e230a697044c3ded2dbdec3e8...ae96ad872f0bd16c0997991c0a7109e0139f9373,1,1,1,2,1,2013-08-09 16:42:56,2013-08-09 16:42:56
ae96ad872f0bd16c0997991c0a7109e0139f9373...9b4a789eefc4b0c081056f3cb97e07895b5ffc00,1,5,3,8,4,2013-08-09 16:45:19,2013-08-09 16:45:19
9b4a789eefc4b0c081056f3cb97e07895b5ffc00...f093646bfc2b459b4e37bae8fe3f2b52e4e58ff3,1,0,1,1,1,2013-08-09 16:47:13,2013-08-09 16:47:13
f093646bfc2b459b4e37bae8fe3f2b52e4e58ff3...3c3d308ea3e017868b6530df144dd1824471b6f2,1,3,2,5,3,2013-08-10 18:50:06,2013-08-10 18:48:46
3c3d308ea3e017868b6530df144dd1824471b6f2...7970d97a708f0d2f4fbd654eaf785338ab04cc1e,9,38,31,69,27,2013-08-10 19:00:12,2013-08-10 19:00:12
7970d97a708f0d2f4fbd654eaf785338ab04cc1e...3f1f91f155c89d0be9f920bb88a2c32f652fa79b,1,6,2,8,2,2013-08-10 19:02:55,2013-08-10 19:02:55
3f1f91f155c89d0be9f920bb88a2c32f652fa79b...d5a7a3d6a80684caa8f5c3c7d5b454e3da1799a1,1,2,1,3,1,2013-08-10 20:04:59,2013-08-10 20:04:59
d5a7a3d6a80684caa8f5c3c7d5b454e3da1799a1...77028194415cb03b1ff2a85a86d806a0366bccff,2,16,5,21,3,2013-08-10 22:58:12,2013-08-10 22:58:12
77028194415cb03b1ff2a85a86d806a0366bccff...21be9fef7b14edd75c6ee402ec2bb28bf9b6ce59,2,4,4,8,3,2013-08-10 23:01:30,2013-08-10 23:01:30
21be9fef7b14edd75c6ee402ec2bb28bf9b6ce59...ae19315b4d8a19eda07ea8f313c485ca0a7875d0,4,40,2,42,5,2013-08-11 13:23:31,2013-08-11 13:23:31
ae19315b4d8a19eda07ea8f313c485ca0a7875d0...d985fd7a189cdbfa2093c1225bdeb7eefaeb6978,1,1,1,2,1,2013-08-11 13:27:42,2013-08-11 13:27:42
d985fd7a189cdbfa2093c1225bdeb7eefaeb6978...b4c493ecd3b8d0d55347949984561762ad2ef1dc,1,2,2,4,2,2013-08-11 13:28:55,2013-08-11 13:28:55
b4c493ecd3b8d0d55347949984561762ad2ef1dc...b61b6346284fb32614aab965bd2cb09b383fc9f5,4,63,5,68,4,2013-08-11 14:28:51,2013-08-11 14:28:51
b61b6346284fb32614aab965bd2cb09b383fc9f5...841b7af8120e854f3aa37b8918f461efcbbef3d6,1,2,2,4,2,2013-08-12 15:40:41,2013-08-12 15:40:41
841b7af8120e854f3aa37b8918f461efcbbef3d6...44f907dd980defaab2c06b4ead2255ec3566bcd5,3,13,3,16,3,2013-08-12 19:05:20,2013-08-12 19:05:20
44f907dd980defaab2c06b4ead2255ec3566bcd5...157604a87fa7e1331c25fcbed558f0799aa5b8df,5,247,9,256,15,2013-08-13 19:54:57,2013-08-13 19:54:57
157604a87fa7e1331c25fcbed558f0799aa5b8df...5b522cd85a63cf5e352c500447aa91002e83845e,1,2,1,3,2,2013-08-19 12:12:48,2013-08-19 12:12:48
5b522cd85a63cf5e352c500447aa91002e83845e...52edc16086e3c28a78c31975bb4da2f9450590b4,4,32,17,49,18,2013-08-19 12:50:26,2013-08-19 12:50:26
84f9741664dadb3185c3d8822b720b340374066e...cd99c12f05b10cb1b3a07b7b4fcd9fb89785f7a8,5,14,4,18,5,2012-10-06 01:41:50,2012-10-06 01:41:50
cd99c12f05b10cb1b3a07b7b4fcd9fb89785f7a8...d99639da035f3465633f18c78eee239fd18fce21,1,1,1,2,1,2012-10-06 01:49:59,2012-10-06 01:49:59
d99639da035f3465633f18c78eee239fd18fce21...b9039268a17b06e7fe069721e99f6d69181c344d,3,100,23,123,20,2012-10-06 04:43:29,2012-10-06 04:43:29
b9039268a17b06e7fe069721e99f6d69181c344d...12f39be508cab95a9841987c3df589ef69de706e,1,10,10,20,2,2012-10-06 04:46:35,2012-10-06 04:46:35
12f39be508cab95a9841987c3df589ef69de706e...cc337a74f1808b216fff96f1695d8b066d2636f6,3,201,17,218,22,2012-10-06 06:21:57,2012-10-06 06:21:57
cc337a74f1808b216fff96f1695d8b066d2636f6...6d46c740d80b0c7f75064bc6bb4d99b15b106ba4,2,4,2,6,2,2012-10-06 11:03:20,2012-10-06 11:02:11
6d46c740d80b0c7f75064bc6bb4d99b15b106ba4...117e99511e0985701780ed1bcd3afd456e244ae3,5,186,89,275,14,2012-10-06 11:14:50,2012-10-06 11:14:11
117e99511e0985701780ed1bcd3afd456e244ae3...8a2216648fcc1c6e504902e612b046c213de46d7,3,123,3,126,3,2012-10-06 12:40:00,2012-10-06 12:40:00
8a2216648fcc1c6e504902e612b046c213de46d7...b6b8a3f66b5cf4f00bd7ce668ac04f21bb73e0b9,4,430,400,830,33,2012-10-06 14:27:20,2012-09-27 22:16:49
b6b8a3f66b5cf4f00bd7ce668ac04f21bb73e0b9...91ef2a5253a50a602523bdda943c32c4cfe719fe,4,33,27,60,15,2012-10-06 16:57:24,2012-10-06 16:57:24
91ef2a5253a50a602523bdda943c32c4cfe719fe...69035b0b1c6e3bd4569070bf0f0c774def397f0d,2,84,61,145,29,2012-10-06 19:35:22,2012-10-06 19:19:51
69035b0b1c6e3bd4569070bf0f0c774def397f0d...2100da9dcdba7a8bc18f6180fd7e61640319b48a,5,8,5,13,6,2012-10-06 21:40:58,2012-10-06 21:40:58
2100da9dcdba7a8bc18f6180fd7e61640319b48a...ab232937355e8f7ed959ebafd16f8ac7b2a2f85d,1,2,0,2,1,2012-10-06 21:50:30,2012-10-06 21:50:30
ab232937355e8f7ed959ebafd16f8ac7b2a2f85d...35e8dc5169013437d71ae60e05c7f3356d86236e,2,7,23,30,6,2012-10-07 02:27:08,2012-10-06 22:56:28
35e8dc5169013437d71ae60e05c7f3356d86236e...cb9f71dd99f0e524c871830b248cf28fcacd5753,4,36,20,56,18,2012-10-07 14:21:34,2012-10-07 14:20:29
cb9f71dd99f0e524c871830b248cf28fcacd5753...34a736b7521def321b2104d541e634134c5d1c62,1,4,3,7,2,2012-10-07 19:59:16,2012-10-07 19:16:01
34a736b7521def321b2104d541e634134c5d1c62...ec1aad1671bfbba7ef58e7477dd14d7add065838,6,132,21,153,15,2012-10-07 23:21:07,2012-10-07 23:11:12
ec1aad1671bfbba7ef58e7477dd14d7add065838...08eb54ae711ec087457333a259a7861eb5b39063,2,2,4,6,2,2012-10-08 00:28:19,2012-10-08 00:28:19
08eb54ae711ec087457333a259a7861eb5b39063...75301d99d314a992a202fad64b2667528f9d51c8,1,20,2,22,4,2012-10-08 03:08:31,2012-10-08 03:08:31
75301d99d314a992a202fad64b2667528f9d51c8...88cc002e16635c9ad9f76b737366c5206f421c6e,3,3,3,6,4,2012-10-08 04:05:10,2012-10-08 04:05:10
88cc002e16635c9ad9f76b737366c5206f421c6e...4797ad80da57f3f8a7c029008f3e937240cf23e6,2,4,1,5,2,2012-10-08 08:06:56,2012-10-08 08:04:29
4797ad80da57f3f8a7c029008f3e937240cf23e6...a62d53c03252bdf82b21b64874efe053160cbdb7,2,19,0,19,3,2012-10-08 15:40:09,2012-10-08 15:36:51
a62d53c03252bdf82b21b64874efe053160cbdb7...9a2bceed1aab52f65820c378f5ae1f608322b55c,17,71,41,112,39,2012-10-08 16:24:42,2012-10-06 20:56:47
9a2bceed1aab52f65820c378f5ae1f608322b55c...a8f888feb464afd7cfbe024242fa2a405a2d5f90,1,14,2,16,2,2012-10-09 13:08:22,2012-10-09 11:34:03
a8f888feb464afd7cfbe024242fa2a405a2d5f90...8cb9968a91cf533cb82e1e13948551e91b510878,2,14,14,28,9,2012-10-09 13:08:32,2012-10-09 12:56:19
8cb9968a91cf533cb82e1e13948551e91b510878...273b96ef9d3acb25d69e206555412774abab6022,2,2,1,3,2,2012-10-09 13:08:32,2012-10-09 13:01:38
273b96ef9d3acb25d69e206555412774abab6022...c9b4e9ac3a6c56f2b006b723972e77722d3ac937,1,2,1,3,1,2012-10-09 19:23:02,2012-10-09 19:23:02
c9b4e9ac3a6c56f2b006b723972e77722d3ac937...3190abcd75b1fcd660353da4001885ef82cbc596,2,55,6,61,5,2012-10-09 19:36:35,2012-10-09 19:36:35
3190abcd75b1fcd660353da4001885ef82cbc596...0a0fe8f71d54e8479e3050ef3bb9d545fd734a65,1,1,1,2,1,2012-10-09 20:06:55,2012-10-09 20:06:55
0a0fe8f71d54e8479e3050ef3bb9d545fd734a65...252cd271e88e1c60fc49c06fac9d45e4c7f8750e,1,2,6,8,1,2012-10-09 20:44:43,2012-10-09 20:40:44
252cd271e88e1c60fc49c06fac9d45e4c7f8750e...c2150d4d2c5342488e474825c67dd3210fafc0e7,1,5,2,7,1,2012-10-09 22:00:58,2012-10-09 21:06:37
c2150d4d2c5342488e474825c67dd3210fafc0e7...7f4dbdc036a4439ed3e4954625fe91596b314a36,1,15,28,43,12,2012-10-09 22:15:29,2012-10-03 15:09:02
7f4dbdc036a4439ed3e4954625fe91596b314a36...a8b1861fc4d0a48b4879af803bba094eef145017,7,22,150,172,29,2012-10-09 22:15:29,2012-10-03 15:21:39
a8b1861fc4d0a48b4879af803bba094eef145017...b625e8272bd41714c838cfda3fb54e1f5177f009,4,43,23,66,10,2012-10-09 22:15:29,2012-10-03 15:53:40
b625e8272bd41714c838cfda3fb54e1f5177f009...32ac067a6ddca465cd94fc7ee35bfe54a675979b,1,43,3,46,8,2012-10-09 22:39:43,2012-09-28 17:25:09
32ac067a6ddca465cd94fc7ee35bfe54a675979b...f578ee32fa41b7d2b3308d98e9d528ab4853a720,1,8,1,9,2,2012-10-10 00:20:51,2012-10-10 00:20:51
f578ee32fa41b7d2b3308d98e9d528ab4853a720...041ef9ed68722fa5f8c38c9e39fad67714f35014,1,2,2,4,2,2012-10-10 00:31:11,2012-10-10 00:28:48
041ef9ed68722fa5f8c38c9e39fad67714f35014...c99ad64df7f8b7bdf504ef1c329610fce3c7f1b0,1,2,1,3,1,2012-10-10 03:30:28,2012-10-10 03:30:28
c99ad64df7f8b7bdf504ef1c329610fce3c7f1b0...dcdaf9a07901c80c0d93663b348595dd2ba7b7a6,1,1,1,2,1,2012-10-10 15:56:25,2012-10-10 15:54:27
dcdaf9a07901c80c0d93663b348595dd2ba7b7a6...f7b69665fd0ce21adae7cfaed7fade63f8aae1fd,1,3,1,4,1,2012-10-10 17:57:16,2012-10-10 17:57:16
84f9741664dadb3185c3d8822b720b340374066e...70fac984c88d81a93502468f79f5c661dfe3b3aa,1,3,3,6,1,2012-10-06 00:17:00,2012-10-06 00:17:00
b1517a310a0a9aa416bc479397d5a7b402be64e2...b8e49d70f2bbbb9008dbbf9d8b0dee46dcf25fa6,9,20,11,31,20,2012-08-08 17:53:11,2012-08-08 17:08:05
b8e49d70f2bbbb9008dbbf9d8b0dee46dcf25fa6...e0988ecd1ea90fc7c75ecd9f0959cef5fd9021ff,1,2,0,2,1,2012-08-08 21:13:33,2012-08-08 21:13:33
e0988ecd1ea90fc7c75ecd9f0959cef5fd9021ff...180b672a652a8ea09484d9657957fa06dbcb83a8,2,3,3,6,3,2012-08-08 21:22:27,2012-08-08 21:22:27
180b672a652a8ea09484d9657957fa06dbcb83a8...96a6912ec5183e2b338bf2e1b655ea10760bfb54,2,7,5,12,7,2012-08-08 21:40:20,2012-08-08 21:40:20
96a6912ec5183e2b338bf2e1b655ea10760bfb54...5c09c59bc76510a5388623259b3827ee894cd66b,5,24,8,32,16,2012-08-09 12:36:05,2012-08-09 12:36:05
5c09c59bc76510a5388623259b3827ee894cd66b...5f8da527abf6ce1d995d4f6454a07f7e442f7fd5,1,2,1,3,2,2012-08-09 14:26:11,2012-08-09 14:25:35
5f8da527abf6ce1d995d4f6454a07f7e442f7fd5...751774c29f6ad8f6ad08bc48a4d085829dd279e0,2,46,42,88,33,2012-08-09 18:13:29,2012-08-09 10:12:22
751774c29f6ad8f6ad08bc48a4d085829dd279e0...7275576235ae2e87f3de7b0facb3f9b0a2368f28,1,3,3,6,1,2012-08-09 22:22:30,2012-08-09 20:22:22
b31eea069cf9bc801c82a975307a9173527d78f2...ce5bd42259bc95d372ab0d65dbae793e6251ea80,2,17,11,28,6,2013-05-18 09:06:30,2013-05-18 09:06:30
ce5bd42259bc95d372ab0d65dbae793e6251ea80...331546f6ee7f50a92c01f919e1bb4bea6ed32625,3,215,312,527,59,2013-05-18 09:48:46,2013-05-18 09:48:46
331546f6ee7f50a92c01f919e1bb4bea6ed32625...028bbd15cad0e48d2b679b986e90c6af0f7e28a0,6,500,1,501,24,2013-05-18 11:48:57,2013-05-18 11:48:57
028bbd15cad0e48d2b679b986e90c6af0f7e28a0...7d041b93944174c88bf8c9342d91203b28041a04,4,100,35,135,11,2013-05-18 11:49:56,2013-05-18 11:49:56
7d041b93944174c88bf8c9342d91203b28041a04...38a8cf1cdccb937297c7735aa73f6c02d468e7df,2,35,7,42,7,2013-05-18 16:30:34,2013-05-18 16:30:34
38a8cf1cdccb937297c7735aa73f6c02d468e7df...d58c98d73c41b97e9543f88d3a81ffa6f23e4c7d,1,5,0,5,1,2013-05-19 10:27:17,2013-05-19 10:27:17
d58c98d73c41b97e9543f88d3a81ffa6f23e4c7d...264f8650e375112e874298ec1c5ba65b193fda2a,3,22,2,24,10,2013-05-19 10:35:17,2013-05-19 10:35:17
264f8650e375112e874298ec1c5ba65b193fda2a...d0ecefc2c9114b21e5f83d534990ffc3a44b8cba,16,221,56,277,46,2013-05-29 16:47:10,2013-05-29 16:47:10
d0ecefc2c9114b21e5f83d534990ffc3a44b8cba...52d2a8b3119479246225f7f888c370320cf8622f,1,12,0,12,1,2013-05-29 16:52:17,2013-05-29 16:52:17
52d2a8b3119479246225f7f888c370320cf8622f...05929ee89bc51de772343d18d5a7bf2518d41333,1,84,0,84,1,2013-05-30 16:55:59,2013-05-30 16:55:59
05929ee89bc51de772343d18d5a7bf2518d41333...dfa7c5cade318ce113a95e12cae47c446604e993,1,4,1,5,3,2013-05-30 16:56:26,2013-05-30 16:56:26
dfa7c5cade318ce113a95e12cae47c446604e993...7f9a0b7061e78a43b97abd6a3716d1e2017d72e3,1,19,0,19,3,2013-05-30 16:56:53,2013-05-30 16:56:53
7f9a0b7061e78a43b97abd6a3716d1e2017d72e3...e6f7f4533c183800c2a9ac526d8ee8887e96ac5d,7,188,11,199,13,2013-05-30 17:08:58,2013-05-30 17:08:58
e6f7f4533c183800c2a9ac526d8ee8887e96ac5d...e6ba63def327441a167a901108b10e8dccfe9ab1,1,6,2,8,2,2013-05-30 17:24:10,2013-05-30 17:21:32
e6ba63def327441a167a901108b10e8dccfe9ab1...8d81c6bc821b614f8c6fec337a7bc6c992816c31,1,10,12,22,4,2013-05-30 17:24:20,2013-05-30 17:24:20
8d81c6bc821b614f8c6fec337a7bc6c992816c31...7609e0b42e0014a6ad0adf9dafc7018cb268070e,1,0,4,4,4,2013-05-30 17:25:57,2013-05-30 17:25:57
b44a5d19244150010fa89691eb2262965fa681d8...0de2645c00c2330060c9889c71afd3a528ed7a3a,2,10,0,10,2,2013-01-23 09:49:48,2013-01-23 09:42:34
0de2645c00c2330060c9889c71afd3a528ed7a3a...71c8539570dec000ad24d1a11fa443812b56f876,1,1,1,2,1,2013-01-23 20:36:48,2013-01-23 20:36:48
71c8539570dec000ad24d1a11fa443812b56f876...93e79b45bc5288d1ca0eb5b6eade30d3c7110b24,4,66,9,75,11,2013-01-24 07:58:17,2013-01-23 20:11:46
93e79b45bc5288d1ca0eb5b6eade30d3c7110b24...9893fa12b735f3f47b35d4063d86dddf3145cb25,4,26,21,47,5,2013-01-24 08:26:13,2012-10-13 14:05:34
9893fa12b735f3f47b35d4063d86dddf3145cb25...57c6617c92959856e8cacd809f0e29f57df4f318,1,4,3,7,2,2013-01-24 10:01:32,2013-01-24 10:01:12
57c6617c92959856e8cacd809f0e29f57df4f318...57d439e2d4b1b22289cd9a16bac3324ce13a8e13,2,9,9,18,9,2013-01-24 10:51:14,2013-01-24 10:51:14
57d439e2d4b1b22289cd9a16bac3324ce13a8e13...e2252bf9772bdcc699e4cb8ff1eb4672965bda29,1,1,1,2,1,2013-01-24 10:58:06,2013-01-24 10:58:06
e2252bf9772bdcc699e4cb8ff1eb4672965bda29...eaa716a4130bb019204669d32389db8b399c0f71,1,11,8,19,1,2013-01-24 12:59:39,2013-01-24 11:53:32
eaa716a4130bb019204669d32389db8b399c0f71...1f6b2e7a658594e6ae9507c5f98eb429d19c0c9d,2,27,9,36,4,2013-01-25 01:01:47,2013-01-25 00:21:26
1f6b2e7a658594e6ae9507c5f98eb429d19c0c9d...eafc0364764ba12babd76194d8e1f78b876471ec,3,42,8,50,10,2013-01-25 11:53:40,2013-01-25 11:53:40
eafc0364764ba12babd76194d8e1f78b876471ec...b9c8bbf3726a1956be1db70ffd3bef04a2e5311a,2,32,2,34,5,2013-01-25 13:56:41,2013-01-25 13:52:24
b9c8bbf3726a1956be1db70ffd3bef04a2e5311a...2babab0bb351ff7a13fd23795f5e926a9bf95d22,9,152,68,220,40,2013-01-25 16:23:33,2013-01-25 16:23:33
2babab0bb351ff7a13fd23795f5e926a9bf95d22...5b99d5a330fc412ce56b9e5f9cf0b971654da90c,1,4,1,5,2,2013-01-25 16:50:37,2013-01-25 16:50:37
5b99d5a330fc412ce56b9e5f9cf0b971654da90c...ce27fb198dcce5dad47de83fc81119d3bb6567ce,9,68,152,220,40,2013-01-25 16:58:37,2013-01-25 16:58:37
ce27fb198dcce5dad47de83fc81119d3bb6567ce...ebb504db692cac496f4f45762d1d14644c9fa6fa,14,230,251,481,57,2013-01-25 19:50:46,2013-01-25 19:50:46
ebb504db692cac496f4f45762d1d14644c9fa6fa...1686e0d184aaf704e5131a8651a070c4a0e58b03,2,9,2,11,4,2013-01-25 20:27:49,2013-01-25 20:27:49
1686e0d184aaf704e5131a8651a070c4a0e58b03...58062a6302a2bf1013d100deb053ccae2298bb84,1,16,16,32,16,2013-01-25 21:41:45,2013-01-25 21:41:45
58062a6302a2bf1013d100deb053ccae2298bb84...424eb67867162032d92e0bfe3403f051765de805,2,2,1,3,2,2013-01-26 11:20:57,2013-01-26 11:19:31
424eb67867162032d92e0bfe3403f051765de805...cebbec9b6122579a32a019a0449d4995dcf2191d,1,3,4,7,2,2013-01-26 12:34:40,2013-01-26 12:28:44
cebbec9b6122579a32a019a0449d4995dcf2191d...55416e235d95b6168034236e5b1cdc581d544cc6,6,19,5,24,10,2013-01-26 12:47:11,2013-01-26 12:47:11
55416e235d95b6168034236e5b1cdc581d544cc6...d18893d5ce083b357fa1c43cafb56908c5a14a0e,1,3,2,5,2,2013-01-26 15:45:29,2013-01-26 15:39:20
d18893d5ce083b357fa1c43cafb56908c5a14a0e...6605ac331a9e03fa41c301d122c5727c0d98b970,2,17,7,24,9,2013-01-26 16:51:44,2013-01-26 16:51:44
6605ac331a9e03fa41c301d122c5727c0d98b970...962f133f72abe2a1174d48baa52aa8549762a022,1,6,2,8,3,2013-01-26 18:59:44,2013-01-26 18:57:10
110c72930948a8853acfce0ab747247a06a935f7...23f94f0741100233862922a8e77a3ac9dc1833e9,2,13,1,14,3,2012-07-17 20:00:54,2012-07-17 19:58:18
23f94f0741100233862922a8e77a3ac9dc1833e9...8184aff2b0a3fbe6759163c0289f640a393a3e99,1,4,1,5,1,2012-07-17 20:04:47,2012-07-17 20:04:47
29132ebdef0e0b9c09e456b05f0e6a22f1106a4f...d5012d6371e804fc0427112cc1ceacbe8a059c4f,2,5,1,6,2,2012-07-17 16:44:02,2012-07-17 14:38:04
29132ebdef0e0b9c09e456b05f0e6a22f1106a4f...52df0d50b0d903c8d845404b8da89b174f8824cc,1,1,1,2,1,2012-07-17 14:01:01,2012-07-17 14:01:01
0674b38ce904aa9d7a629313831ad24be3d8f3e6...ccf8f1e18f138dae369a2004c83db9704ad52d99,3,13,0,13,3,2013-07-31 10:59:15,2013-07-31 06:37:54
ccf8f1e18f138dae369a2004c83db9704ad52d99...7de35a9ef372eb47442d5d1278cc15b6155e5054,1,4,0,4,1,2013-07-31 11:09:12,2013-07-30 09:11:15
7de35a9ef372eb47442d5d1278cc15b6155e5054...4d8ecbdfda4da95685a2a51906425c6baa58a09f,2,6,6,12,3,2013-07-31 11:22:38,2013-07-31 11:22:38
4d8ecbdfda4da95685a2a51906425c6baa58a09f...8f5533ab250df07ea84f98d39808806e282468a5,6,79,3,82,13,2013-07-31 11:42:30,2013-07-23 14:25:21
8f5533ab250df07ea84f98d39808806e282468a5...31e6d58d46894ca35080b4eab7967e4c6aae82d4,5,195,26,221,32,2013-07-31 12:54:17,2013-05-03 14:02:10
31e6d58d46894ca35080b4eab7967e4c6aae82d4...c21e86ab9e3e5ebd6d245d038cb0cb352cd84c3a,3,14,25,39,11,2013-07-31 13:02:36,2013-06-18 18:14:07
c21e86ab9e3e5ebd6d245d038cb0cb352cd84c3a...e01b5a5823fa06a63382f87472978a16c77048d2,1,11,2,13,3,2013-07-31 13:02:36,2013-06-18 18:15:13
e01b5a5823fa06a63382f87472978a16c77048d2...e888a9b30dd9d62a930b9244d1b5531bb17544b4,3,10,1,11,4,2013-07-31 13:27:58,2013-02-19 21:58:09
e888a9b30dd9d62a930b9244d1b5531bb17544b4...a3a59a3197d4e03c5c016edc581bfc5f25668bca,1,6,0,6,2,2013-07-31 13:24:29,2013-07-31 13:24:29
a3a59a3197d4e03c5c016edc581bfc5f25668bca...acd1d439fd9b3e77bc0291dcd62c09f345d8622c,4,49,20,69,12,2013-07-31 13:54:00,2013-07-29 09:47:49
acd1d439fd9b3e77bc0291dcd62c09f345d8622c...1c3c21b38d154eff0286c194711dced2ac39dd3d,2,23,2,25,6,2013-07-31 14:38:59,2013-03-27 16:37:08
1c3c21b38d154eff0286c194711dced2ac39dd3d...a1889397a9f0e6a35189de455098b4c70923e561,4,93,5,98,6,2013-07-31 17:54:05,2013-07-30 12:24:13
a1889397a9f0e6a35189de455098b4c70923e561...1123f4551158b7fc65d3bd88c375a4517dcd0720,8,152,8,160,11,2013-07-31 18:12:03,2013-07-20 21:49:33
1123f4551158b7fc65d3bd88c375a4517dcd0720...5df84b268de45fffd90930e6442eb511cba71f5f,2,2,4,6,2,2013-08-01 14:27:30,2013-08-01 14:27:30
5df84b268de45fffd90930e6442eb511cba71f5f...31ee1207877578ad683c1d4f3aed47fc6dc7637e,4,27,52,79,5,2013-08-01 22:07:59,2013-08-01 22:07:59
31ee1207877578ad683c1d4f3aed47fc6dc7637e...aa830009de940e31711b4858501becd7f34a1972,3,37,11,48,9,2013-08-02 11:41:56,2013-08-01 18:09:47
aa830009de940e31711b4858501becd7f34a1972...893d8de6f5d0b6bf23e2ed072e18fe2e012395c6,2,36,0,36,3,2013-08-02 12:41:54,2013-02-24 13:57:29
893d8de6f5d0b6bf23e2ed072e18fe2e012395c6...fd0d48646760c3024ce605d919d69c8b8449382d,1,1,1,2,1,2013-08-02 13:26:53,2013-07-31 21:03:22
fd0d48646760c3024ce605d919d69c8b8449382d...920b242e307297778c6e5010f23502c4f41f299c,1,31,17,48,14,2013-08-02 13:42:46,2013-08-01 21:27:11
920b242e307297778c6e5010f23502c4f41f299c...a0ed2f9260f995b0cdf145f2802fc8123c25db65,2,23,3,26,3,2013-08-02 14:41:29,2013-07-31 05:50:39
a0ed2f9260f995b0cdf145f2802fc8123c25db65...1b47508ac88c1b1ee6ae71f032abb268395ac00e,2,16,2,18,3,2013-08-02 16:51:10,2013-08-01 07:51:01
1b47508ac88c1b1ee6ae71f032abb268395ac00e...425d076d0c8cf7376a1478d118c58bcff5b1b74d,2,9,2,11,5,2013-08-02 18:46:17,2013-08-02 18:46:17
425d076d0c8cf7376a1478d118c58bcff5b1b74d...a0c58113b9de072482a5fee2a085218e67971b41,1,1,1,2,1,2013-08-03 19:42:02,2013-08-03 19:42:02
a0c58113b9de072482a5fee2a085218e67971b41...0bcdcc7eb9ca2265cb83225257df65a8def3e14a,5,41,6,47,10,2013-08-04 00:02:43,2013-08-03 16:15:15
0bcdcc7eb9ca2265cb83225257df65a8def3e14a...784377544e01322b0d09e5cf4e8f6dda159df854,4,36,10,46,12,2013-08-04 09:04:37,2013-08-04 09:01:01
784377544e01322b0d09e5cf4e8f6dda159df854...b278f7478d37d3620e5addf7cc2070bc38c10871,1,0,6,6,1,2013-08-04 09:57:11,2013-08-04 09:57:11
b6a957f0ba8a2ed1b24d7ee042a9c4beaf51ab03...2e7f45a3721a8afbc61a4320ae9ab3908d1e81b4,3,31,22,53,19,2013-08-21 21:25:15,2013-08-21 21:25:15
2e7f45a3721a8afbc61a4320ae9ab3908d1e81b4...e9b703f5a5e5de68a28abd2e6651e6100b0c6b49,1,2,2,4,2,2013-08-21 21:30:02,2013-08-19 22:42:48
e9b703f5a5e5de68a28abd2e6651e6100b0c6b49...eadecf0cdbc30d2351b91ae77d7a441f592bc5d0,2,4,0,4,2,2013-08-21 21:30:02,2013-08-19 23:42:53
eadecf0cdbc30d2351b91ae77d7a441f592bc5d0...77478d84ade2e7b4720231e52d0c517741b18768,1,11,1,12,2,2013-08-21 21:30:02,2013-08-20 00:39:30
77478d84ade2e7b4720231e52d0c517741b18768...63378163f9c5f3f9f9b42a6f260f798aa7e4b1f6,3,30,5,35,11,2013-08-21 21:30:45,2013-08-20 03:14:21
63378163f9c5f3f9f9b42a6f260f798aa7e4b1f6...b773ef8fa0ef09641abf376ca8d4083d8966ec52,1,21,13,34,9,2013-08-21 21:30:45,2013-08-20 06:47:43
b773ef8fa0ef09641abf376ca8d4083d8966ec52...cea720450485e0871daa7f9477fdf2bff5a5b821,2,24,35,59,11,2013-08-21 21:30:46,2013-08-20 07:32:18
cea720450485e0871daa7f9477fdf2bff5a5b821...ced3e6b17d18174216cdbe1ec7c24cc1819db787,4,14,2,16,6,2013-08-21 21:31:50,2013-08-20 08:33:44
ced3e6b17d18174216cdbe1ec7c24cc1819db787...f5552571dc7a0d9da9df1d108bc4bbef6857c157,4,36,1,37,4,2013-08-21 21:31:50,2013-08-20 13:23:25
f5552571dc7a0d9da9df1d108bc4bbef6857c157...3a8ae71ab5efb387b31386bcd7d8ce72d25d1abd,1,6,0,6,1,2013-08-21 21:31:50,2013-08-20 14:48:02
3a8ae71ab5efb387b31386bcd7d8ce72d25d1abd...1db5fce1eee27cb260b47d3c631ee8f8d02de8c2,1,1,0,1,1,2013-08-21 21:32:03,2013-08-20 16:28:59
1db5fce1eee27cb260b47d3c631ee8f8d02de8c2...839940f27f25c2dafaa5b2ec934c2dd6b80903e8,4,19,10,29,4,2013-08-21 21:32:04,2013-08-20 17:03:33
839940f27f25c2dafaa5b2ec934c2dd6b80903e8...01223840f34ff2eacf1425bc133c347564fe2614,3,86,5,91,11,2013-08-21 21:32:04,2013-08-21 01:17:26
01223840f34ff2eacf1425bc133c347564fe2614...c5fbd1636203e697c214dcad54e4f3db1d7c9685,3,3,3,6,3,2013-08-21 21:32:04,2013-08-20 17:59:23
c5fbd1636203e697c214dcad54e4f3db1d7c9685...7775ced938da18066da73adba322be1a49be3e6d,1,2,2,4,1,2013-08-21 21:32:04,2013-08-21 03:22:25
7775ced938da18066da73adba322be1a49be3e6d...244e2b71f512605f3d0a8e1ba4c9d6b538acf69d,3,36,24,60,13,2013-08-21 21:32:04,2013-08-20 14:13:41
244e2b71f512605f3d0a8e1ba4c9d6b538acf69d...8e571e5f8f21d87ab5a5462730289c755b8022d3,2,99,12,111,12,2013-08-21 21:32:04,2013-08-19 23:04:50
8e571e5f8f21d87ab5a5462730289c755b8022d3...c7364a11f6df8d1c2d340a52e6e58e9a76ceb44f,1,7,7,14,7,2013-08-21 21:32:04,2013-08-21 10:48:16
c7364a11f6df8d1c2d340a52e6e58e9a76ceb44f...3f416f637918cc162877be95a59d50825b203089,2,31,12,43,10,2013-08-21 21:32:04,2013-08-20 18:13:43
3f416f637918cc162877be95a59d50825b203089...cb5c0bec14fd9be19daa84a7b21cf29f7a19ff3b,1,1,1,2,1,2013-08-21 21:32:04,2013-08-21 13:01:52
cb5c0bec14fd9be19daa84a7b21cf29f7a19ff3b...3e20a8856bf72e2f921b3a39440bed8336cb9713,2,15,1,16,3,2013-08-21 21:32:04,2013-08-20 20:56:39
3e20a8856bf72e2f921b3a39440bed8336cb9713...2d903929a70078cf1c50bf7b6e7718b1a4a691df,1,1,1,2,1,2013-08-21 21:32:05,2013-08-21 14:49:50
2d903929a70078cf1c50bf7b6e7718b1a4a691df...beefac8aaeed0bd8c66e8c7fcbfae1c0f8e01f85,1,9,5,14,2,2013-08-21 21:32:05,2013-08-21 21:27:46
beefac8aaeed0bd8c66e8c7fcbfae1c0f8e01f85...ac45f9c9c5b5f64556c95d458368185298d21042,4,18,10,28,7,2013-08-23 11:07:43,2013-08-23 11:07:43
ac45f9c9c5b5f64556c95d458368185298d21042...9cc6cfc4057e07b73a1d72a1177d568362b0c517,4,62,9,71,10,2013-08-23 11:07:55,2013-08-23 11:07:55
f7b69665fd0ce21adae7cfaed7fade63f8aae1fd...7ef2781ca0ce48872e21dce2f322c9e4106d1cfd,1,28,0,28,1,2012-10-11 00:03:27,2012-10-11 00:03:27
f7b69665fd0ce21adae7cfaed7fade63f8aae1fd...f315006d50a1391393507cef1c52147cb766e45d,1,3,3,6,1,2012-10-10 23:38:48,2012-10-10 23:38:48
6b56aeec6e21c1cf7eccfd89f0f5c6722a066efc...470deb5cbb765e2e731c5b0b184247c7f87482aa,1,6,1,7,1,2012-10-12 00:01:30,2012-10-11 23:54:52
470deb5cbb765e2e731c5b0b184247c7f87482aa...95f7ea3af1854f575a47218a08d1a8d5357f8d9b,5,15,12,27,8,2012-10-12 15:23:22,2012-10-12 15:22:20
95f7ea3af1854f575a47218a08d1a8d5357f8d9b...24c7d828b00c5cfb203addca06c82fc30d2e989a,2,1,1,2,1,2012-10-12 21:18:42,2012-10-12 21:16:55
24c7d828b00c5cfb203addca06c82fc30d2e989a...ffbc599f77120674cd16e6dcac2f22998c84e407,95,0,5722,5722,53,2012-10-12 21:21:51,2012-10-12 21:21:40
ffbc599f77120674cd16e6dcac2f22998c84e407...f8c3acc8074988eed88667e58255abab1b093119,1,107,1361,1468,22,2012-10-12 22:00:35,2012-10-12 22:00:35
f8c3acc8074988eed88667e58255abab1b093119...c870cb48cd0ec4b5dfdc5df95e6f0b5f5f8a738b,1,10,0,10,1,2012-10-12 23:17:00,2012-10-12 10:37:35
7275576235ae2e87f3de7b0facb3f9b0a2368f28...92b2dec918d7b73456899ecb5726cc03b86bd068,2,16,13,29,15,2012-08-10 16:07:46,2012-08-09 18:08:47
92b2dec918d7b73456899ecb5726cc03b86bd068...eff6ba2f64ea5426502daadb04fbe1e85ace068a,2,45,0,45,2,2012-08-10 20:19:20,2012-08-10 20:19:20
eff6ba2f64ea5426502daadb04fbe1e85ace068a...cb38fd9632f314bd78324083005dc8df55200390,1,5,4,9,1,2012-08-10 21:35:16,2012-08-10 20:12:45
cb38fd9632f314bd78324083005dc8df55200390...87e0a75c03747c5b7ed87311c2e1f34d9fb20bee,1,1,1,2,1,2012-08-10 22:20:59,2012-08-10 22:18:33
3c296382b8dea5de7f4e1e11b66bd7cecaf2ee51...4492f06408828355a827824c805fd631a3b59d1b,5,280,0,280,5,2013-06-07 14:28:38,2013-06-07 14:28:38
4492f06408828355a827824c805fd631a3b59d1b...c7aa4b5338e6bcf62f66eb53b309aa3a69b9a55d,2,22,1,23,4,2013-06-07 14:36:31,2013-06-07 14:36:31
c7aa4b5338e6bcf62f66eb53b309aa3a69b9a55d...cd809619a270ad48f1a77ee8c32bb0c7d8293f63,3,65,8,73,9,2013-06-07 14:49:48,2013-06-07 14:49:48
cd809619a270ad48f1a77ee8c32bb0c7d8293f63...91c470def50c4de420b0c6ee7debddc5bbd53ec8,5,156,37,193,30,2013-06-07 16:56:43,2013-06-07 16:56:43
91c470def50c4de420b0c6ee7debddc5bbd53ec8...315ab41e416c777d4f42932d42df07872e8f8895,6,241,151,392,21,2013-06-07 17:47:17,2013-06-07 17:47:17
962f133f72abe2a1174d48baa52aa8549762a022...a4c9a4a5fe99e8c0bdc3d82eb7b6326150404792,1,0,1,1,1,2013-03-13 21:26:15,2013-03-13 21:26:15
962f133f72abe2a1174d48baa52aa8549762a022...4b3f7110ae1e9ef7862c67a38431780080f0062c,4,18,7,25,9,2013-01-26 19:53:09,2013-01-26 19:49:02
4b3f7110ae1e9ef7862c67a38431780080f0062c...14d1d504d5c839869a7f612b7d35fa1adf983f5b,2,2,2,4,2,2013-01-27 11:09:50,2013-01-27 11:09:36
14d1d504d5c839869a7f612b7d35fa1adf983f5b...f46d7314b50d71a75f51ebae9c5957cb96b11bd9,4,14,8,22,8,2013-01-28 09:17:56,2013-01-28 09:17:56
f46d7314b50d71a75f51ebae9c5957cb96b11bd9...c47fa3b4814240bb47342a4446d40ea83bd3ed19,3,6,3,9,5,2013-01-28 09:21:07,2013-01-28 09:21:07
c47fa3b4814240bb47342a4446d40ea83bd3ed19...4f16376274a4e52074722c615fccef5fac5f009a,10,72,41,113,47,2013-01-28 21:10:50,2013-01-28 13:12:56
4f16376274a4e52074722c615fccef5fac5f009a...f7394d2c32b4b4717066f254adaa513d08ab32a4,8,38,20,58,19,2013-01-28 21:11:00,2013-01-28 13:24:48
f7394d2c32b4b4717066f254adaa513d08ab32a4...537d44b1b937c6857ded0a2dc5703c61c5e980b4,1,1,0,1,1,2013-01-29 11:12:33,2013-01-29 11:12:33
537d44b1b937c6857ded0a2dc5703c61c5e980b4...b99a4e1073e5504ec8f40447a8e9fd1066c76b7f,1,5,5,10,2,2013-01-29 13:12:04,2013-01-29 13:05:34
8184aff2b0a3fbe6759163c0289f640a393a3e99...a2e927b7ed25bd319f866c55b18cd214a149d859,5,27,5,32,11,2012-07-18 18:16:55,2012-07-18 12:00:31
8184aff2b0a3fbe6759163c0289f640a393a3e99...adad6c3afeea91422a22312939330ce8165084e3,1,10,0,10,1,2012-07-18 11:45:42,2012-07-18 11:45:42
adad6c3afeea91422a22312939330ce8165084e3...810fd236fad03e687e714c6a8e0ccd21229f89c1,1,8,3,11,2,2012-07-18 12:19:06,2012-07-18 12:10:40
810fd236fad03e687e714c6a8e0ccd21229f89c1...1e89a208d0d741558c31a161222e8aa96764e08c,1,16,10,26,2,2012-07-18 13:01:12,2012-07-18 12:59:12
1e89a208d0d741558c31a161222e8aa96764e08c...6d0dbd88f649f5038732de8643e9c9ba50ebb567,1,6,6,12,3,2012-07-18 15:04:29,2012-07-18 15:04:29
6d0dbd88f649f5038732de8643e9c9ba50ebb567...d8e221db90294e0f26ee41ef81a1466907ca201d,1,1,1,2,2,2012-07-18 15:22:27,2012-07-18 15:22:27
59d99772f0e3c69bc1824ce1e76438d89c50c9b9...a875f612e0ae84c2084d0b6230ffafe32a9777c8,4,31,1,32,4,2012-07-25 20:24:41,2012-07-16 22:26:31
a875f612e0ae84c2084d0b6230ffafe32a9777c8...7d06f975fe445f0393455b3eb9ec17dbe04f2ec3,1,3,0,3,1,2012-07-25 20:32:53,2012-07-25 20:32:31
7d06f975fe445f0393455b3eb9ec17dbe04f2ec3...4b5cb116e30020c459ad8c9314ae9311b461beb5,1,1,1,2,1,2012-07-25 20:46:57,2012-07-25 20:45:46
4b5cb116e30020c459ad8c9314ae9311b461beb5...ab6cd1c839b136cbc94178da433b2e97ab7f6061,4,140,87,227,49,2012-07-25 20:58:48,2012-07-25 07:12:59
b278f7478d37d3620e5addf7cc2070bc38c10871...07876cf02b6db453ca0397c29c225668872fa96d,26,139,107,246,130,2013-08-04 11:09:39,2013-08-03 05:41:15
b278f7478d37d3620e5addf7cc2070bc38c10871...470a9bb22d4471744e5c20af5d755b232312d58c,1,33,30,63,3,2013-08-04 10:18:17,2013-08-04 10:18:17
7ef2781ca0ce48872e21dce2f322c9e4106d1cfd...06f5da3d7813e9a23b1e98ecf8b75fc6073800e9,5,31,0,31,5,2012-10-11 10:11:52,2012-10-11 10:11:52
7ef2781ca0ce48872e21dce2f322c9e4106d1cfd...b498ce820384c6967fbec3a32be3b9cd5b01e63d,1,1,1,2,1,2012-10-11 08:38:14,2012-10-11 08:38:14
72efdc4d9229231ac44303fba1c504705f1515d6...2ee6a46696d4936fbfcb7adc74eb33e50cb9aefe,1,2,0,2,2,2012-10-15 19:11:32,2012-10-15 19:08:07
2ee6a46696d4936fbfcb7adc74eb33e50cb9aefe...1636b0338273290e762f83baffe4bbe375163319,1,1,0,1,1,2012-10-15 19:18:16,2012-10-15 19:18:16
1636b0338273290e762f83baffe4bbe375163319...6b0a836c9c4a311440c2259af9c689933e70703a,2,16,5,21,4,2012-10-15 21:05:40,2012-10-15 20:18:47
6b0a836c9c4a311440c2259af9c689933e70703a...08286ca5d93c142a60edda5ee37b3a8a7bc72274,3,12,12,24,12,2012-10-15 21:05:40,2012-10-15 20:33:16
08286ca5d93c142a60edda5ee37b3a8a7bc72274...07abb7a6b7af2c45be553acf08d85cd2d72057ad,3,292,354,646,108,2012-10-15 23:47:26,2012-10-13 18:37:39
07abb7a6b7af2c45be553acf08d85cd2d72057ad...9190d89829c4e0b9b0f36e1c717ea451a1a13efd,1,6,4,10,1,2012-10-15 23:55:46,2012-10-15 23:54:37
9190d89829c4e0b9b0f36e1c717ea451a1a13efd...8f94d282232db238e4fca9aece6aae5acd6d7d1c,1,4,3,7,1,2012-10-16 07:04:12,2012-10-16 07:02:12
8f94d282232db238e4fca9aece6aae5acd6d7d1c...bfcda7781a886ab2b7b41937c0f49c088f58a3d7,1,2,2,4,2,2012-10-16 08:03:29,2012-10-16 08:03:29
bfcda7781a886ab2b7b41937c0f49c088f58a3d7...fd02bcff4aee885d395f2439efdd522c22e40794,1,1,1,2,1,2012-10-17 00:39:13,2012-10-17 00:39:13
fd02bcff4aee885d395f2439efdd522c22e40794...9d2e1f065ede189f65e79eb3cb33a33b460a4351,1,14,2,16,4,2012-10-17 09:59:10,2012-10-17 09:55:38
9d2e1f065ede189f65e79eb3cb33a33b460a4351...3e0857041b6bfc9deef392315c978abede706c92,1,2,2,4,1,2012-10-17 19:46:59,2012-10-17 11:03:40
3e0857041b6bfc9deef392315c978abede706c92...9305c0e12d43c4df999c3301a1f0c742264a657e,4,44,1,45,5,2012-10-17 21:36:41,2012-10-17 21:36:41
9305c0e12d43c4df999c3301a1f0c742264a657e...31dcaf49a0ed6bda13a6d556412b6993a9bd41ba,2,4,5,9,2,2012-10-17 21:53:21,2012-10-17 21:53:21
31dcaf49a0ed6bda13a6d556412b6993a9bd41ba...0775ab295566ccb306b8ae6340d2690c3d0aa6af,1,18,0,18,1,2012-10-18 07:02:20,2012-10-18 06:57:21
0775ab295566ccb306b8ae6340d2690c3d0aa6af...4fb510fde4db95d15205afefdefade97eee4d3ef,1,65,0,65,3,2012-10-18 18:10:46,2012-10-18 18:10:46
4fb510fde4db95d15205afefdefade97eee4d3ef...db598dd8a053fe17c3308f89cd8f40676e2c479e,1,6,0,6,1,2012-10-18 20:58:05,2012-10-16 20:12:52
db598dd8a053fe17c3308f89cd8f40676e2c479e...0b908b92a2ca4fb74a103e96bb75c53c05d0a428,4,188,46,234,32,2012-10-18 23:58:52,2012-10-18 23:58:52
0b908b92a2ca4fb74a103e96bb75c53c05d0a428...4cef9a09f9b0d89abf323a1cf8b9e8354e316c18,1,7,0,7,1,2012-10-19 21:51:24,2012-10-19 10:52:30
4cef9a09f9b0d89abf323a1cf8b9e8354e316c18...04b53ebfb7f45d64d73be33f536b422e179aacbf,2,23,3,26,3,2012-10-20 03:41:54,2012-10-20 03:41:54
04b53ebfb7f45d64d73be33f536b422e179aacbf...7a908747a52f7cc12d7006058daad6a6c973c462,1,7,0,7,2,2012-10-20 03:51:15,2012-10-20 03:51:15
7a908747a52f7cc12d7006058daad6a6c973c462...3084b1cfd6110e2ef57f1a67f8b7dbda309e2e13,11,1215,1312,2527,6,2012-10-20 09:08:52,2012-10-19 16:19:17
3084b1cfd6110e2ef57f1a67f8b7dbda309e2e13...681550ca6d5ff3e591a769643e37fd0b50f29c91,4,16,35,51,9,2012-10-20 11:55:13,2012-10-20 10:34:50
681550ca6d5ff3e591a769643e37fd0b50f29c91...eed4faf16f37a8b0af06a52eada05b84dead4c0d,1,37,4,41,4,2012-10-20 12:40:54,2012-10-19 00:12:41
eed4faf16f37a8b0af06a52eada05b84dead4c0d...dfd4a7175119ddb422d8426dcc15902265d5a428,4,50,5,55,14,2012-10-20 12:56:16,2012-10-20 12:33:57
dfd4a7175119ddb422d8426dcc15902265d5a428...dcbf08cce59ceb83918b1b63c2bb827828bbdd2c,2,37,27,64,17,2012-10-20 13:36:24,2012-10-20 13:36:24
dcbf08cce59ceb83918b1b63c2bb827828bbdd2c...c2e19e26bc33d34eff57079bd1a6838ff64d9e81,2,16,6,22,6,2012-10-20 13:49:52,2012-10-20 13:48:38
c2e19e26bc33d34eff57079bd1a6838ff64d9e81...cfb3eb2e3d1af6d4f6ba852f50f57865e34ece38,1,24,23,47,24,2012-10-20 13:54:26,2012-10-20 13:53:28
cfb3eb2e3d1af6d4f6ba852f50f57865e34ece38...300d052713a4312bcfca334ea34b348d57549950,1,1,1,2,1,2012-10-20 13:57:15,2012-10-20 13:57:15
300d052713a4312bcfca334ea34b348d57549950...4b27813198ae31892f1159d437e492f7745761a0,18,533,75,608,62,2012-10-20 18:05:11,2012-10-20 15:40:14
4b27813198ae31892f1159d437e492f7745761a0...2f722d9728c1946d5d800b3e0b24de7f566a755d,1,10,0,10,1,2012-10-20 19:22:34,2012-10-20 19:21:19
2f722d9728c1946d5d800b3e0b24de7f566a755d...d7c6a57d606bbb8185f9215ffce4c0516a9ae438,8,140,224,364,59,2012-10-20 21:22:46,2012-10-20 21:22:46
5fb22329a14695419f191da8b7d0b5b22793aff0...c433fcb3fb34fccd69782979f0e7cd5f2d4a4893,14,260,67,327,55,2012-10-13 03:44:50,2012-10-13 03:44:50
c433fcb3fb34fccd69782979f0e7cd5f2d4a4893...b3b3db3d954a5226f870a0b4403343c78efae8dc,4,111,95,206,42,2012-10-13 05:36:07,2012-10-13 05:36:07
b3b3db3d954a5226f870a0b4403343c78efae8dc...10dc4797eadc1868c794c746953036c87ed0ea73,1,1,1,2,1,2012-10-13 09:02:18,2012-10-13 09:02:18
10dc4797eadc1868c794c746953036c87ed0ea73...22742e4ac40274e8c91bdad9b8be251da50a3753,1,4,0,4,2,2012-10-13 09:17:25,2012-10-13 09:17:25
22742e4ac40274e8c91bdad9b8be251da50a3753...fa2e28ccc45d383ad9b1398565a9d106a80fd1db,1,1,1,2,1,2012-10-13 09:30:09,2012-10-13 09:30:09
fa2e28ccc45d383ad9b1398565a9d106a80fd1db...cc83a4af0c51627bcdd566e4c01dcabcae51212c,1,1,1,2,1,2012-10-13 13:58:36,2012-10-10 15:49:26
cc83a4af0c51627bcdd566e4c01dcabcae51212c...7a44dc555a3c9bfd1691ebb346b91f25d2f94c7d,2,15,1,16,3,2012-10-13 14:28:20,2012-10-04 13:24:23
7a44dc555a3c9bfd1691ebb346b91f25d2f94c7d...e6f45aa623d9a67a2d6389665ca1bea0556dc832,1,4,0,4,1,2012-10-13 19:01:30,2012-10-13 18:59:58
e6f45aa623d9a67a2d6389665ca1bea0556dc832...a451d2b4a21af062bd1295f71ae62ef770963d4f,2,2,2,4,2,2012-10-14 21:03:01,2012-10-14 21:03:01
a451d2b4a21af062bd1295f71ae62ef770963d4f...afbf913b90a820702a2a4cad669c25d8808a5843,1,6,4,10,2,2012-10-15 08:00:22,2012-10-15 08:00:22
afbf913b90a820702a2a4cad669c25d8808a5843...58365401c92d2377c93def71d33165a77f36157b,15,785,760,1545,653,2012-10-15 09:17:06,2012-10-15 09:17:06
87e0a75c03747c5b7ed87311c2e1f34d9fb20bee...97fe70d30bddfa24bf5ef5d2148a1a5ae6bf54b2,1,28,28,56,23,2012-08-11 09:11:20,2012-08-11 09:11:20
97fe70d30bddfa24bf5ef5d2148a1a5ae6bf54b2...22527a821bbca73a4900906be8b01c81a414ad95,1,1,1,2,1,2012-08-11 12:22:28,2012-08-11 11:34:35
22527a821bbca73a4900906be8b01c81a414ad95...f10a1b06416e59a66cc9c3c8437fe045cb0fb03c,2,9,7,16,7,2012-08-11 12:47:44,2012-08-11 12:44:34
f10a1b06416e59a66cc9c3c8437fe045cb0fb03c...09c589810d54ef14132084e34f4ef6133fdac3b9,1,4,4,8,4,2012-08-11 13:29:29,2012-08-11 13:29:29
09c589810d54ef14132084e34f4ef6133fdac3b9...3eb28d011927a657cad1bf4463611a72c6bb1325,4,13,15,28,17,2012-08-11 16:56:14,2012-08-11 16:56:14
3eb28d011927a657cad1bf4463611a72c6bb1325...4d9e4c64f1330fbdfe6a7931879deebf7154f403,1,3,8,11,2,2012-08-11 19:48:11,2012-08-11 19:46:36
4d9e4c64f1330fbdfe6a7931879deebf7154f403...b82eb10b2605477b3e583c9378257a9e6c8fd2ed,1,1,1,2,1,2012-08-11 21:05:26,2012-08-11 21:05:26
b82eb10b2605477b3e583c9378257a9e6c8fd2ed...7d0f8831922535502569a5dda989dde339b4e491,1,3,4,7,2,2012-08-11 21:23:31,2012-08-11 18:58:45
7d0f8831922535502569a5dda989dde339b4e491...66021033381f154ddf8a9ecf93fcbb41a7abda17,8,24,23,47,22,2012-08-11 21:23:31,2012-08-11 20:29:18
66021033381f154ddf8a9ecf93fcbb41a7abda17...900816464dbd7b1fcc009177f9de03791edc6e88,2,4,4,8,4,2012-08-11 21:23:31,2012-08-11 20:44:42
900816464dbd7b1fcc009177f9de03791edc6e88...be7f1099c61004bda8c491fc4e7aab9f8b2c8512,2,17,0,17,7,2012-08-11 21:32:24,2012-08-11 21:32:24
be7f1099c61004bda8c491fc4e7aab9f8b2c8512...15fffcc7510ec2bf0fafdc254206619a8ab0923f,3,3,3,6,3,2012-08-11 21:46:23,2012-08-11 21:43:45
15fffcc7510ec2bf0fafdc254206619a8ab0923f...759ae3c2dafe149485a15d9a3bc97527c1ac1163,2,10,2,12,3,2012-08-11 23:24:18,2012-08-11 23:15:50
759ae3c2dafe149485a15d9a3bc97527c1ac1163...140179c77046f45136821db2f902f2da64ec4bb6,1,1,1,2,1,2012-08-12 10:37:55,2012-08-11 21:01:11
140179c77046f45136821db2f902f2da64ec4bb6...9e7b5ba50fd9c23876b0a17a03e6875a6899b7c6,1,0,2,2,1,2012-08-12 10:43:05,2012-08-12 10:43:05
9e7b5ba50fd9c23876b0a17a03e6875a6899b7c6...dbb63e56eaa6e2e2a574d4327464332b3ef9f970,1,1,1,2,1,2012-08-12 12:44:40,2012-08-11 20:15:05
dbb63e56eaa6e2e2a574d4327464332b3ef9f970...2bb2eecb6358ea4243ab7a6286048b86302f5128,6,0,18,18,6,2012-08-12 12:44:40,2012-08-11 20:18:09
2bb2eecb6358ea4243ab7a6286048b86302f5128...e7e08fd48b3f88d4eb481f5b213b923fc1db3675,6,18,10,28,13,2012-08-12 12:44:40,2012-08-11 20:20:59
e7e08fd48b3f88d4eb481f5b213b923fc1db3675...a0a0203a392f67832ba7a8a2f099e70d7db2d19e,2,21,0,21,2,2012-08-12 12:44:40,2012-08-11 13:34:51
a0a0203a392f67832ba7a8a2f099e70d7db2d19e...79d62a71751140315227891bbe175630f9d3edc3,3,46,0,46,2,2012-08-12 12:44:40,2012-08-11 14:41:25
79d62a71751140315227891bbe175630f9d3edc3...d4a0b27838c815af87698920cc4db7d2afd6f05b,142,1072,481,1553,1038,2012-08-12 12:44:40,2012-08-12 10:32:08
d4a0b27838c815af87698920cc4db7d2afd6f05b...4e68e861533846010e372ecf58e3cd0439081754,2,14,0,14,3,2012-08-12 12:44:41,2012-08-12 12:39:48
4e68e861533846010e372ecf58e3cd0439081754...031896c5101de83bca65e872fb4a91c15f55a42e,1,14,2,16,1,2012-08-12 13:22:33,2012-08-12 13:22:33
031896c5101de83bca65e872fb4a91c15f55a42e...49bb72c403b24b58d8d8067dcd945f57878df9f0,1,1,1,2,1,2012-08-12 16:08:58,2012-08-12 16:08:58
49bb72c403b24b58d8d8067dcd945f57878df9f0...c1684e3dcb2adf0fec8fd423cc73122330c268fe,1,1,1,2,1,2012-08-12 18:40:22,2012-08-09 20:36:51
c1684e3dcb2adf0fec8fd423cc73122330c268fe...dce34dc9696734f7ca02d410ddac69d714a25f1e,5,17,15,32,15,2012-08-12 18:45:39,2012-08-12 18:36:43
dce34dc9696734f7ca02d410ddac69d714a25f1e...5513480fe1e616c236a7629072b4317e334b9b4b,1,15,7,22,1,2012-08-12 18:47:18,2012-08-12 18:43:01
5513480fe1e616c236a7629072b4317e334b9b4b...59a655988ee95e4b4e4646cebea88b620d8fcdd2,2,18,6,24,4,2012-08-12 18:52:52,2012-07-15 11:41:05
59a655988ee95e4b4e4646cebea88b620d8fcdd2...99321e30cebbffeafc6ae19f4f92a0a665cbf19b,7,161,0,161,9,2012-08-12 19:39:27,2012-08-12 19:17:54
99321e30cebbffeafc6ae19f4f92a0a665cbf19b...ac37c9e495eb1003cc6d126ed5d686a29fb08596,2,5,4,9,5,2012-08-12 20:49:10,2012-08-12 20:22:56
ac37c9e495eb1003cc6d126ed5d686a29fb08596...8a1f439d3aca3a021a43ba6c4235c3ac68908657,2,8,6,14,8,2012-08-12 20:49:10,2012-08-12 20:26:17
8a1f439d3aca3a021a43ba6c4235c3ac68908657...1930b899bd69fb084856257598ab5ddd8ee4e016,1,2,0,2,1,2012-08-13 06:15:20,2012-08-13 06:15:20
1930b899bd69fb084856257598ab5ddd8ee4e016...6d68022a274df2e19205d7313034cf6eb619f346,1,1,1,2,1,2012-08-13 07:56:14,2012-08-12 21:53:54
6d68022a274df2e19205d7313034cf6eb619f346...a06503d09b73fa2842ec79170b84453034fca904,2,23,20,43,11,2012-08-13 07:56:14,2012-08-12 21:25:42
a06503d09b73fa2842ec79170b84453034fca904...73f0f18c8fc04a03bbfb20794aabb95944c90f63,1,7,6,13,3,2012-08-13 08:58:21,2012-08-13 08:58:21
73f0f18c8fc04a03bbfb20794aabb95944c90f63...5e958b958b4b27082a393decf64ec573fa7454b2,1,6,5,11,2,2012-08-13 09:54:13,2012-08-13 09:14:08
5e958b958b4b27082a393decf64ec573fa7454b2...d774ad752d9844cb7a28fe338d4d711c8576ee6f,3,12,8,20,10,2012-08-13 09:54:21,2012-08-13 09:34:40
d774ad752d9844cb7a28fe338d4d711c8576ee6f...45baaabafb6cf911afad9ec63c86753b284f7269,3,7,6,13,8,2012-08-13 10:56:59,2012-08-13 10:09:20
45baaabafb6cf911afad9ec63c86753b284f7269...d2975718fe0585cad1ed1462cc4d65373a6c7bb0,1,6,6,12,5,2012-08-13 14:54:13,2012-08-13 14:54:13
d2975718fe0585cad1ed1462cc4d65373a6c7bb0...0dac73ebd733d9140476b66b81afa56c5b0f65b2,1,2,2,4,2,2012-08-13 16:23:26,2012-08-13 16:22:23
0dac73ebd733d9140476b66b81afa56c5b0f65b2...b109ff8062f4bb225181ec462d69c9dd79339567,2,14,13,27,11,2012-08-13 19:02:18,2012-08-13 18:56:05
b109ff8062f4bb225181ec462d69c9dd79339567...a025b75f6c3021ab400224250defa2db37b8122c,1,2,2,4,2,2012-08-13 19:25:27,2012-08-13 19:25:27
a025b75f6c3021ab400224250defa2db37b8122c...363dbd920e9b77da83895598f0fc9f7f835df65d,3,10,11,21,11,2012-08-13 19:26:12,2012-08-13 19:07:51
363dbd920e9b77da83895598f0fc9f7f835df65d...0df0cf70d43a642393d118523b7efdc04dae6105,3,15,11,26,13,2012-08-14 07:51:39,2012-08-14 07:45:53
0df0cf70d43a642393d118523b7efdc04dae6105...e04230e2e406dcf74eeec8d3c95c84362c7da780,3,132,107,239,56,2012-08-14 08:32:16,2012-08-14 07:44:04
e04230e2e406dcf74eeec8d3c95c84362c7da780...d1452f60974da6f0e54ff9ad7a03d2c115675d10,1,6,8,14,6,2012-08-14 10:19:17,2012-08-14 10:19:17
d1452f60974da6f0e54ff9ad7a03d2c115675d10...faf570df187bc82a3bcffa5613165a6e6cc56a57,9,61,53,114,56,2012-08-14 10:29:53,2012-08-14 09:57:18
faf570df187bc82a3bcffa5613165a6e6cc56a57...dcf72835e358529571dba53af1451fb39ce36c6b,1,2,3,5,2,2012-08-14 10:29:53,2012-08-14 10:03:45
dcf72835e358529571dba53af1451fb39ce36c6b...2ae58b20ec72ce501c91dff8a8fcc8fe40cf5019,1,9,4,13,4,2012-08-14 10:29:53,2012-08-14 10:09:45
2ae58b20ec72ce501c91dff8a8fcc8fe40cf5019...9299dc42ed4986d2a1eb7c7f7fe7c276b9f6b6d6,4,4,4,8,4,2012-08-14 12:09:23,2012-08-14 12:09:23
9299dc42ed4986d2a1eb7c7f7fe7c276b9f6b6d6...8fe03865f7d7059e051976d1f9336f2ff83a30c6,1,2,2,4,1,2012-08-14 12:24:43,2012-08-14 12:24:43
8fe03865f7d7059e051976d1f9336f2ff83a30c6...5b27e6f64b481be0fda0996456482eb56e12f2b5,1,1,1,2,1,2012-08-14 12:28:55,2012-08-14 12:28:55
5b27e6f64b481be0fda0996456482eb56e12f2b5...0c198b85a3292cb7f2f2cd1b2d6dc6f04a1ed831,5,6,5,11,5,2012-08-14 12:31:06,2012-08-14 12:22:08
0c198b85a3292cb7f2f2cd1b2d6dc6f04a1ed831...d6b8b125fbd370bb575c43ba66270e22de919a51,2,2,5,7,2,2012-08-14 12:38:23,2012-08-14 12:38:23
d6b8b125fbd370bb575c43ba66270e22de919a51...c2d59e556499ecee3d8a1fc684f49a21463ab1c1,6,163,192,355,73,2012-08-14 12:45:28,2012-08-14 12:36:11
c2d59e556499ecee3d8a1fc684f49a21463ab1c1...62a9ed0ac761bc737ba355519bb209517b330039,1,2,1,3,2,2012-08-14 13:07:32,2012-08-14 12:43:33
62a9ed0ac761bc737ba355519bb209517b330039...4e7f04cdad2eb1ec39ea2e3769657da082a6494f,1,3,2,5,3,2012-08-14 13:09:01,2012-08-14 13:05:53
4e7f04cdad2eb1ec39ea2e3769657da082a6494f...a351e383b664d4b2da6d49a50c9a3c37ae2c5848,1,1,1,2,1,2012-08-14 13:57:16,2012-08-14 13:57:04
a351e383b664d4b2da6d49a50c9a3c37ae2c5848...c35501a1280e02638c0e5bf2530cb48e15a68ad0,1,1,1,2,1,2012-08-14 14:15:50,2012-08-14 14:15:39
c35501a1280e02638c0e5bf2530cb48e15a68ad0...9cb80356fc4cff7b8ecda91877755d6e361667c4,1,2,2,4,2,2012-08-14 14:19:58,2012-08-14 14:19:58
9cb80356fc4cff7b8ecda91877755d6e361667c4...7d48e077b573afb4184301be6565a88e8a9b6e28,3,7,7,14,5,2012-08-14 15:24:31,2012-08-14 15:24:31
7d48e077b573afb4184301be6565a88e8a9b6e28...f2fe7a3e36bebb529f33f5b702b7643a3db85c72,3,15,17,32,16,2012-08-14 17:54:53,2012-08-14 17:48:38
f2fe7a3e36bebb529f33f5b702b7643a3db85c72...37c9318748896a1bb7e33a05a7db2c5de268ff22,3,37,24,61,24,2012-08-14 18:14:31,2012-08-14 18:12:38
37c9318748896a1bb7e33a05a7db2c5de268ff22...367bfaa5226eaae3278989e63f16063d5cc46cd8,3,34,13,47,6,2012-08-14 19:23:25,2012-08-14 19:12:08
367bfaa5226eaae3278989e63f16063d5cc46cd8...34ac1457962165afbe8203742fdc5308e2979db6,3,5,2,7,5,2012-08-14 21:35:12,2012-08-13 10:39:47
34ac1457962165afbe8203742fdc5308e2979db6...0120985095ad6fd59be111bb9a3927ee04b426e8,3,20,16,36,19,2012-08-14 21:35:12,2012-08-14 18:51:50
0120985095ad6fd59be111bb9a3927ee04b426e8...928baee7478f2e1bd48fb8e0801f4f1ffc4f7aea,2,4,2,6,3,2012-08-14 21:35:12,2012-08-14 19:17:25
928baee7478f2e1bd48fb8e0801f4f1ffc4f7aea...212a5129842ffec9d42ae0dbdb55964fab2c5fa2,2,4,4,8,4,2012-08-14 21:45:12,2012-08-14 21:10:01
212a5129842ffec9d42ae0dbdb55964fab2c5fa2...e091c18f50266097f648efc7cac2503968e9d217,2,5,9,14,2,2012-08-14 21:45:12,2012-08-14 21:44:46
e091c18f50266097f648efc7cac2503968e9d217...450c0df6537e4cb85194754ffa051565f356bbc6,2,41,34,75,31,2012-08-14 21:46:23,2012-08-14 21:38:35
450c0df6537e4cb85194754ffa051565f356bbc6...478a69314e0f1a7fb4e9fd80f2cd3b9f210cc780,5,8,13,21,8,2012-08-14 22:31:29,2012-08-14 22:31:06
478a69314e0f1a7fb4e9fd80f2cd3b9f210cc780...e0ec7507ac6c9e08ddbdf8a3ddedc430b22c7be9,1,16,14,30,3,2012-08-15 07:45:28,2012-08-15 07:45:28
e0ec7507ac6c9e08ddbdf8a3ddedc430b22c7be9...c7734491f87ac711ff5d749213e8cac0adb3686b,1,1,1,2,1,2012-08-15 08:13:09,2012-08-15 08:12:45
c7734491f87ac711ff5d749213e8cac0adb3686b...20a7a244d78b835473c3e4d9b86e1c991d252daf,1,6,1,7,3,2012-08-15 08:21:40,2012-08-15 08:21:40
20a7a244d78b835473c3e4d9b86e1c991d252daf...2048bbee8c17495d5156d40073715cb9d7511c5a,1,2,3,5,1,2012-08-15 08:25:01,2012-08-15 08:25:01
2048bbee8c17495d5156d40073715cb9d7511c5a...d674bd603ee39721a6b22d8e28a16f46502dff35,1,7,1,8,3,2012-08-15 08:29:05,2012-08-15 08:29:05
d674bd603ee39721a6b22d8e28a16f46502dff35...54afdbf37869ef27671b2ba9887043254ce82dd0,4,23,23,46,23,2012-08-15 08:38:04,2012-08-15 08:38:04
54afdbf37869ef27671b2ba9887043254ce82dd0...cca01c96d18f72cfc156ccfade769735b9de4f98,1,29,29,58,21,2012-08-15 08:46:31,2012-08-15 08:46:31
cca01c96d18f72cfc156ccfade769735b9de4f98...31ae103a1530752d0ee54e3883ca141a1cdb3f87,1,1,1,2,1,2012-08-15 08:54:18,2012-08-15 08:54:18
31ae103a1530752d0ee54e3883ca141a1cdb3f87...64531df5df1fdb93af4eebaa7994716d6cd5b15f,1,5,9,14,3,2012-08-15 08:58:26,2012-08-15 08:37:06
64531df5df1fdb93af4eebaa7994716d6cd5b15f...e0d67f3440b3b2c854da013fd1f9894477e26a77,3,4,6,10,4,2012-08-15 08:58:26,2012-08-15 08:57:05
e0d67f3440b3b2c854da013fd1f9894477e26a77...dfbcbf212493b9e5bb527e7ec2d97ae3cec480fa,1,6,6,12,3,2012-08-15 09:05:03,2012-08-15 09:04:40
dfbcbf212493b9e5bb527e7ec2d97ae3cec480fa...d1d393f975f5b14ce465fd85309520bd3c7d9162,1,1,1,2,1,2012-08-15 09:11:55,2012-08-15 09:11:55
d1d393f975f5b14ce465fd85309520bd3c7d9162...fc99f127d88df9944e2cff4c36429290c3f32918,1,2,0,2,1,2012-08-15 09:16:28,2012-08-15 09:16:28
fc99f127d88df9944e2cff4c36429290c3f32918...52c351a151b7c7808d652581e97b40da7d700492,1,1,1,2,1,2012-08-15 09:18:11,2012-08-15 09:18:11
52c351a151b7c7808d652581e97b40da7d700492...ebc1325721e43808cef4334edaffc23a43f86614,1,4,2,6,2,2012-08-15 09:34:41,2012-08-15 09:31:23
ebc1325721e43808cef4334edaffc23a43f86614...ca6015ca71785dc59106ca36634d93daf59ff5bb,1,11,2,13,2,2012-08-15 09:47:02,2012-08-15 09:47:02
ca6015ca71785dc59106ca36634d93daf59ff5bb...ea1e8b38b3bbf8f21f22028ac256ce62c40d1fc1,2,21,3,24,7,2012-08-15 09:53:40,2012-08-15 09:53:40
ea1e8b38b3bbf8f21f22028ac256ce62c40d1fc1...814fde32d9096296737cbc90c133c00b3bfde27f,1,3,3,6,3,2012-08-15 10:02:32,2012-08-15 10:02:32
814fde32d9096296737cbc90c133c00b3bfde27f...f8ea12f36b7f2e077887a1a02478ea24884b4514,2,4,4,8,4,2012-08-15 10:13:54,2012-08-15 10:09:59
f8ea12f36b7f2e077887a1a02478ea24884b4514...5d01f3caea348fdf99312ba0ee1ab668f2f81c3c,2,4,2,6,2,2012-08-15 10:23:41,2012-08-15 10:02:50
5d01f3caea348fdf99312ba0ee1ab668f2f81c3c...2d2dca2d8e8f2b7f05f90594a291a2c78fe828d0,1,2,2,4,1,2012-08-15 10:29:10,2012-08-15 10:28:43
2d2dca2d8e8f2b7f05f90594a291a2c78fe828d0...187ec5a1664377337afdc9c701307717ab80ab9e,1,2,1,3,2,2012-08-15 10:37:08,2012-08-15 10:37:08
187ec5a1664377337afdc9c701307717ab80ab9e...64a3c7f9aeda347a72e3f1e8e88381b5b3d479d8,2,23,9,32,10,2012-08-15 10:46:32,2012-08-15 10:46:07
64a3c7f9aeda347a72e3f1e8e88381b5b3d479d8...de2cb5fede0766a52717024615cc56a03465fe61,1,2,1,3,2,2012-08-15 11:28:47,2012-08-15 11:27:40
de2cb5fede0766a52717024615cc56a03465fe61...4d393e1bd979984dbafa8fd040aae6223209565e,1,1,1,2,1,2012-08-15 11:39:39,2012-08-15 11:39:39
4d393e1bd979984dbafa8fd040aae6223209565e...f2fff84bc3e85b9c9c132dec614e8b293df8f6bb,1,2,1,3,2,2012-08-15 12:20:44,2012-08-15 12:19:53
f2fff84bc3e85b9c9c132dec614e8b293df8f6bb...c1584890b1764831309eba393eba74afba39487d,1,3,3,6,3,2012-08-15 12:29:40,2012-08-15 12:29:40
c1584890b1764831309eba393eba74afba39487d...0ab570217a07726426fd6728c472093a87df691f,1,6,6,12,6,2012-08-15 12:58:43,2012-08-15 12:58:43
0ab570217a07726426fd6728c472093a87df691f...607665a396e52a4e788543496e3be7b47972bf54,1,2,3,5,1,2012-08-15 14:40:12,2012-08-15 12:00:04
607665a396e52a4e788543496e3be7b47972bf54...4e17f4589accf5be0954eebc41d36ef96125d47c,1,5,0,5,2,2012-08-15 14:57:17,2012-08-15 14:56:33
4e17f4589accf5be0954eebc41d36ef96125d47c...518af78e21cf69d4cdd1827dd103210c67a17e19,1,0,1,1,1,2012-08-15 15:33:21,2012-08-15 15:33:21
518af78e21cf69d4cdd1827dd103210c67a17e19...a9facb455f6f0d5a2d3d594832cecccbee323d6b,4,10,9,19,10,2012-08-15 15:41:38,2012-08-15 15:41:09
a9facb455f6f0d5a2d3d594832cecccbee323d6b...27192564c3193a54165752e8803b4d7b635f9022,1,7,3,10,3,2012-08-15 16:07:03,2012-08-15 16:07:03
87e0a75c03747c5b7ed87311c2e1f34d9fb20bee...060ac8e7115b51374de7d5e34c784d9df5764d0b,10,121,27,148,55,2012-08-11 06:07:15,2012-08-11 06:07:15
9daf81b94e7945d7adfdf62206cf9cb436166f0d...2ae8a8a77d6968a155db9b17ba13e21d91bd351b,8,33,12,45,17,2013-06-19 14:36:02,2013-06-19 14:36:02
2ae8a8a77d6968a155db9b17ba13e21d91bd351b...ab5cbae9b7f2639ae33165e36c30e6563c1364c4,10,203,45,248,29,2013-06-19 14:36:22,2013-06-19 14:36:22
ab5cbae9b7f2639ae33165e36c30e6563c1364c4...f25a385a5eb81ee660a82e6dd41e80938672f69c,7,87,7,94,16,2013-06-19 15:23:52,2013-06-19 15:23:52
f25a385a5eb81ee660a82e6dd41e80938672f69c...41214eaf18c083012c57836befa4b833cf8a3698,4,33,5,38,8,2013-06-19 15:41:04,2013-06-19 15:41:04
41214eaf18c083012c57836befa4b833cf8a3698...73e30e9d3b1890502a7feef80c8856690fcd8c07,1,60,1,61,8,2013-06-19 16:01:48,2013-06-19 16:01:48
73e30e9d3b1890502a7feef80c8856690fcd8c07...6f667999e1186b8eaa9c86e4cbd80d5c0ba20576,5,110,4,114,6,2013-06-20 13:54:11,2013-06-20 13:54:11
6f667999e1186b8eaa9c86e4cbd80d5c0ba20576...80bdf68d6b5fd44056479ccc74cd24281b787a64,4,129,3,132,7,2013-06-20 14:12:59,2013-06-20 14:12:59
80bdf68d6b5fd44056479ccc74cd24281b787a64...47e4b86ddf67c3ab0725f41d4802bc05ed0a6423,4,40,2,42,5,2013-06-20 14:19:30,2013-06-20 14:19:30
47e4b86ddf67c3ab0725f41d4802bc05ed0a6423...0e8ee50e868e7ce501fffb48096fcf8d0b1e05a6,1,1,1,2,1,2013-06-20 14:27:33,2013-06-20 14:27:33
0e8ee50e868e7ce501fffb48096fcf8d0b1e05a6...92a10f5552315b22e7d374123e3d09249b6b9883,2,40,2,42,4,2013-06-20 15:02:43,2013-06-20 15:02:43
92a10f5552315b22e7d374123e3d09249b6b9883...cca40703dfdc6171bebe9be50a82ef61a0749cb0,2,21,12,33,5,2013-06-21 14:32:15,2013-06-21 14:32:15
cca40703dfdc6171bebe9be50a82ef61a0749cb0...48493cff73fd01870306965f1c48193602754a78,1,2,2,4,1,2013-06-22 11:56:37,2013-06-22 11:56:37
48493cff73fd01870306965f1c48193602754a78...e2d7e83256234251a81ad3388428f6579795a672,3,164,11,175,15,2013-06-22 16:15:51,2013-06-22 16:15:51
3beabb5afd8df56af48461bc0f6011f2d96aa088...f403653cf146384946e5c879ad2a351768ebc226,3,40,72,112,7,2013-03-17 13:32:50,2013-01-19 12:09:46
f403653cf146384946e5c879ad2a351768ebc226...912b5d2a6bc78067d6a7e130f10514c51bd1a58f,4,205,4,209,6,2013-03-17 18:21:36,2013-03-17 17:21:05
912b5d2a6bc78067d6a7e130f10514c51bd1a58f...c94db53eaa9b344f9227fa4dff2b1a5e9c7dce9d,1,6,1,7,2,2013-03-17 18:29:22,2013-03-17 18:29:22
c94db53eaa9b344f9227fa4dff2b1a5e9c7dce9d...f3a6d74db9d9dbf7af84a74878256f5531baeb13,1,1,1,2,1,2013-03-17 21:43:49,2013-03-17 21:43:49
f3a6d74db9d9dbf7af84a74878256f5531baeb13...0df8ff3dbec8e3ce1b699ee23e36fc211e44a612,1,4,4,8,4,2013-03-17 21:48:52,2013-03-17 21:48:52
0df8ff3dbec8e3ce1b699ee23e36fc211e44a612...68905695b897e62b0c18d9edd87171a0eae4e67e,1,4,2,6,2,2013-03-17 22:56:07,2013-03-17 22:56:07
68905695b897e62b0c18d9edd87171a0eae4e67e...20a91cce04c72bc8c64a1c43b7398edac7b709cc,4,31,6,37,10,2013-03-17 23:03:58,2013-03-17 19:48:30
20a91cce04c72bc8c64a1c43b7398edac7b709cc...7cf0f04230b1b6dd2680548338fe584c0ad3f85a,1,5,0,5,1,2013-03-18 08:45:44,2013-03-17 21:14:14
7cf0f04230b1b6dd2680548338fe584c0ad3f85a...0efafa4c54ab8ad684df66c8e34928bb2ba88656,2,24,1,25,3,2013-03-18 10:10:19,2013-03-18 10:09:29
0efafa4c54ab8ad684df66c8e34928bb2ba88656...9dc5702932a0031bc4fb5473f2cdccffc61dbe30,2,18,0,18,3,2013-03-18 10:22:43,2013-03-18 10:22:43
9dc5702932a0031bc4fb5473f2cdccffc61dbe30...6197935152419f064911f7a26b70da32f31435c7,10,26,46,72,17,2013-03-18 20:16:29,2013-03-17 10:45:45
6197935152419f064911f7a26b70da32f31435c7...4485b2a74cd0cb066669157da90480076b3570c7,2,11,11,22,6,2013-03-18 22:55:32,2013-03-18 22:55:32
4485b2a74cd0cb066669157da90480076b3570c7...31b5275235bac150a54059db0288a19b9e0516c7,6,38,16,54,11,2013-03-18 22:58:22,2013-03-18 20:52:16
b99a4e1073e5504ec8f40447a8e9fd1066c76b7f...ee26797cff6ef17817c58e6a2f86db81c21f9800,15,20,17,37,17,2013-01-29 17:55:55,2013-01-29 15:45:40
ee26797cff6ef17817c58e6a2f86db81c21f9800...eb9430fc4be16f2256f8ff4d8ee90577fb0a8f5a,2,32,19,51,7,2013-01-29 18:39:11,2013-01-29 18:33:43
eb9430fc4be16f2256f8ff4d8ee90577fb0a8f5a...47ddd6a4082d55d8856b7e6beac553485dd627f7,7,200,6,206,20,2013-01-29 22:13:23,2013-01-20 18:07:10
b99a4e1073e5504ec8f40447a8e9fd1066c76b7f...c6560e4843c94da7eab435b71288579d608c26c0,1,0,1,1,1,2013-01-29 15:39:03,2013-01-29 14:12:13
4c5cea70734fe8f4082c6a9bd8b26cf0a157ca78...6c69de80bdcd2744bc64cb933c2d863dd5e74a33,1,2,1,3,2,2012-11-11 20:23:45,2012-11-11 20:23:45
6c69de80bdcd2744bc64cb933c2d863dd5e74a33...09a39ca0824611280ae180fe4cc59df669097ecb,1,1,1,2,1,2012-11-12 20:19:11,2012-11-12 20:19:11
d8e221db90294e0f26ee41ef81a1466907ca201d...c54905b3597545dbe1a6d8cd0a60186bccf8b3e7,3,54,24,78,13,2012-07-18 18:43:35,2012-07-18 16:34:13
c54905b3597545dbe1a6d8cd0a60186bccf8b3e7...123362dd37a076987f265179fe16dcd2b6a16d12,2,3,9,12,8,2012-07-19 18:02:20,2012-07-19 18:02:20
123362dd37a076987f265179fe16dcd2b6a16d12...5d560dcb981400451d69a834f7c6a9090f5e5221,2,53,27,80,16,2012-07-19 21:02:22,2012-07-19 21:02:22
d8e221db90294e0f26ee41ef81a1466907ca201d...a7928dedc83bfe00736fc4ef3a905652684b55d4,1,1,1,2,1,2012-07-18 18:34:08,2012-07-18 18:34:08
ab6cd1c839b136cbc94178da433b2e97ab7f6061...00d5e632fabc03a0633b9910605b23bcec439cdc,1,2,1,3,2,2012-07-28 17:17:33,2012-07-28 17:17:33
00d5e632fabc03a0633b9910605b23bcec439cdc...07d70e9b267797f5f375a1dfcc0513a68d0feb5f,1,1,1,2,1,2012-07-28 17:31:41,2012-07-28 17:31:41
07d70e9b267797f5f375a1dfcc0513a68d0feb5f...690ed5794672495e4cffca9a4a701008d254a4e7,2,33,7,40,8,2012-07-29 22:14:26,2012-07-29 22:14:26
690ed5794672495e4cffca9a4a701008d254a4e7...c0748a621ceaae0f90133bb7980c857bf13811a1,1,1,1,2,1,2012-07-29 23:53:56,2012-07-29 23:53:56
59f58bf7319b624694f05a1b73efcddf5a667954...61ecb5f48a4732f1471f858c64904ec1c4763925,1,92,9,101,15,2013-08-04 12:04:12,2013-08-02 18:24:26
61ecb5f48a4732f1471f858c64904ec1c4763925...ebb3e50243448545c7314a1932a9067ddca5960b,5,80,13,93,13,2013-08-04 13:14:18,2013-07-31 05:52:11
ebb3e50243448545c7314a1932a9067ddca5960b...3e0eb2d7885fdccabcc4b97e5c57e68bbd5d7978,18,39,52,91,33,2013-08-04 16:17:10,2013-08-04 16:17:10
3e0eb2d7885fdccabcc4b97e5c57e68bbd5d7978...e8183a8193ebc80fdc6fef789813c2c0c3615e5c,1,67,36,103,13,2013-08-04 16:34:28,2013-08-02 13:26:19
e8183a8193ebc80fdc6fef789813c2c0c3615e5c...1593a86494f246f5410a7ad2f96bef67fb778778,1,12,14,26,11,2013-08-04 18:46:06,2013-08-04 18:45:29
1593a86494f246f5410a7ad2f96bef67fb778778...995ffbb2a60c80217bf4cbe028b7712fafaf11f2,3,103,9,112,8,2013-08-04 23:08:45,2013-08-04 23:06:47
995ffbb2a60c80217bf4cbe028b7712fafaf11f2...28d3b33c04cc2e2250059039c5ebbab97869d525,1,4,0,4,1,2013-08-05 00:18:10,2013-08-05 00:18:10
28d3b33c04cc2e2250059039c5ebbab97869d525...0b071ba7df7394b9caa040aca314b8015ebad776,1,4,4,8,2,2013-08-05 00:29:55,2013-08-05 00:29:55
0b071ba7df7394b9caa040aca314b8015ebad776...f067887a4f1e8b12cec8e5e585cf25fce99c6709,1,4,0,4,4,2013-08-05 05:03:53,2013-08-05 05:03:53
f067887a4f1e8b12cec8e5e585cf25fce99c6709...26c4bd38acd4c1b5125eaa381420c2ca5603bd39,1,2,1,3,3,2013-08-05 12:14:27,2013-08-05 12:14:27
26c4bd38acd4c1b5125eaa381420c2ca5603bd39...94d7fed7750322e8b80402c1e731bab6d4509f2e,2,14,9,23,2,2013-08-05 13:06:09,2013-08-04 19:40:16
94d7fed7750322e8b80402c1e731bab6d4509f2e...6d88d47be6d37234aab86d0e863e371f28347d12,9,100,4,104,13,2013-08-05 13:47:28,2013-07-31 02:29:34
6d88d47be6d37234aab86d0e863e371f28347d12...75c87e2d38b181163a61ea99f2a17273274a3a2b,2,13,0,13,2,2013-08-05 14:02:28,2013-08-05 14:01:49
9aa358cedd1ad93c0f4c20700db7016651dc0598...8363406dadbbda02c163687e89b5971ebba3597b,1,7,3,10,4,2013-08-23 11:56:37,2013-08-23 11:56:37
8363406dadbbda02c163687e89b5971ebba3597b...2787de652af50917bdbadf6c4f2eb6f8603e65f2,1,4,4,8,2,2013-08-23 13:38:55,2013-08-23 13:38:55
2787de652af50917bdbadf6c4f2eb6f8603e65f2...35230adf6351ac81f02088a240bf861914a050ee,1,1,0,1,1,2013-08-23 16:59:35,2013-08-23 16:59:35
35230adf6351ac81f02088a240bf861914a050ee...f33db5a09acfc3df3085235a5712c46094eb9a0d,2,19,6,25,4,2013-08-24 13:19:55,2013-08-21 18:23:53
f33db5a09acfc3df3085235a5712c46094eb9a0d...f4e9804567ce45ef01f6613ce194e96d293ac04b,2,8,1,9,2,2013-08-24 16:10:12,2013-08-24 16:08:05
f4e9804567ce45ef01f6613ce194e96d293ac04b...32a962bdbfb187ad884273cdbc02e8b0dbb692e6,2,44,47,91,26,2013-08-24 22:00:23,2013-08-05 17:41:22
32a962bdbfb187ad884273cdbc02e8b0dbb692e6...72712755c46c787c99dd194c7ec634bd43600567,1,1,0,1,1,2013-08-25 22:09:03,2013-08-25 22:09:03
72712755c46c787c99dd194c7ec634bd43600567...51a9a5980af3b4762d09c4aa4551d370a1b8b9a8,1,3,0,3,1,2013-08-26 01:29:43,2013-08-26 01:29:43
0921b74e695931c5f76414546d34da874079a6c3...0614e99fbdb9d14a57035da320a4fc7aca232469,1,3,3,6,3,2012-10-11 18:40:38,2012-10-11 18:40:38
0614e99fbdb9d14a57035da320a4fc7aca232469...501d793398c3ecc3c8a54475d07609cf34643553,1,4,0,4,2,2012-10-11 19:40:14,2012-10-11 19:09:12
501d793398c3ecc3c8a54475d07609cf34643553...b5f224e8e23ca380a93304abe583f1de59c2404e,1,3,3,6,2,2012-10-11 21:10:49,2012-10-11 20:58:50
b5f224e8e23ca380a93304abe583f1de59c2404e...2d1214d92ae67acaf2246c3dc2ea37cdf7e1c2a5,1,3,3,6,1,2012-10-11 21:47:37,2012-10-11 10:47:29
2d1214d92ae67acaf2246c3dc2ea37cdf7e1c2a5...dd0cbc6bdccfc51329427b8a6023f6e866d48cba,1,3,1,4,1,2012-10-11 22:05:12,2012-10-11 22:04:25
d7c6a57d606bbb8185f9215ffce4c0516a9ae438...b87e2f46c80d15abcda0e181ab894fb938ceb12f,2,19,0,19,2,2012-10-20 22:19:38,2012-10-20 22:11:16
58365401c92d2377c93def71d33165a77f36157b...2236351b9ea7b6822fee2d0c49eb8f3094a4bb29,1,1,1,2,1,2012-10-15 12:19:41,2012-10-15 12:19:41
2236351b9ea7b6822fee2d0c49eb8f3094a4bb29...05b849162266c0df355bccdf53bd1e0617a19bb0,1,2,0,2,1,2012-10-15 14:37:29,2012-10-15 14:37:29
58365401c92d2377c93def71d33165a77f36157b...c3fabb282d429de931ef10c91cee55700578eb86,1,3,0,3,1,2012-10-15 11:16:46,2012-10-15 11:16:46
c3fabb282d429de931ef10c91cee55700578eb86...2811e543c648a0669c88185a4d117eeb8ff09689,1,6,0,6,1,2012-10-15 19:12:10,2012-10-15 19:12:10
27192564c3193a54165752e8803b4d7b635f9022...383da137851bd5fbe4f5f22e13d6237f3532a5bb,1,1,1,2,1,2012-08-15 17:41:16,2012-08-15 17:41:16
27192564c3193a54165752e8803b4d7b635f9022...60f5e1023066b92270d01aa121efe228f6edc379,2,4,4,8,4,2012-08-15 16:19:21,2012-08-15 16:19:21
60f5e1023066b92270d01aa121efe228f6edc379...2b157b0adc5cbe4fb0161f8319aca809b32eeae0,1,1,1,2,1,2012-08-15 19:07:48,2012-08-15 19:07:48
2b157b0adc5cbe4fb0161f8319aca809b32eeae0...f7c2e82d765c4baa1cd57ac8908aa01807e077a1,1,8,7,15,6,2012-08-15 20:42:18,2012-08-15 20:42:18
f7c2e82d765c4baa1cd57ac8908aa01807e077a1...37e05357cd16e008f32d5651b6c11390a8bec2e5,1,9,8,17,6,2012-08-15 20:48:09,2012-08-15 19:57:16
37e05357cd16e008f32d5651b6c11390a8bec2e5...24de85c419ed46baf95098822f3f455887bc00f6,2,14,13,27,14,2012-08-15 20:48:09,2012-08-15 20:47:31
24de85c419ed46baf95098822f3f455887bc00f6...27d16a3ca4a330f5aa46015ccd7d5a9ee72873b6,1,5,4,9,2,2012-08-15 20:53:52,2012-08-15 20:52:19
27d16a3ca4a330f5aa46015ccd7d5a9ee72873b6...fd04e711d2a5440d7a828644ee65b88bf00c83b5,1,3,1,4,1,2012-08-15 21:59:31,2012-08-15 21:59:09
fd04e711d2a5440d7a828644ee65b88bf00c83b5...e38112d882a8aec0aaf6d52ab6d07fa1a408a3aa,1,17,3,20,1,2012-08-15 23:47:55,2012-08-13 12:10:40
e38112d882a8aec0aaf6d52ab6d07fa1a408a3aa...d1d514af044209a6af790ba012c4637232c5335d,1,8,7,15,3,2012-08-16 00:13:28,2012-08-16 00:13:28
d1d514af044209a6af790ba012c4637232c5335d...62c3f6362ad46946ec9cc37554026897f1ea9452,1,6,3,9,2,2012-08-16 02:08:16,2012-08-16 02:08:16
62c3f6362ad46946ec9cc37554026897f1ea9452...0c257f5a232bdf251f6f9de542c702ab76ad1be3,1,2,2,4,2,2012-08-16 03:09:01,2012-08-16 03:09:01
0c257f5a232bdf251f6f9de542c702ab76ad1be3...befa1dd7a5f88bcf994598c36438338109478409,1,3,3,6,3,2012-08-16 03:12:08,2012-08-16 03:12:08
4eaf73d7bc7541557ceb19b7ff5b758f726bab32...2a36a1a07145860bad45d9c416281313ff53b910,1,2,2,4,1,2012-08-17 15:06:38,2012-08-17 15:06:38
31b5275235bac150a54059db0288a19b9e0516c7...36b45611bcaee0ba55b40384f29e8b6546f109bb,1,8,0,8,1,2013-03-19 00:05:38,2013-03-18 23:54:24
47ddd6a4082d55d8856b7e6beac553485dd627f7...3f1a0c0040b9a950584f4b309a1b670b0e709de5,7,143,9,152,9,2013-01-30 19:28:16,2013-01-30 19:28:16
3f1a0c0040b9a950584f4b309a1b670b0e709de5...23e319d7298c8b778181e85dd9b6cbed095f8147,5,32,0,32,19,2013-01-30 20:26:17,2013-01-30 20:26:17
23e319d7298c8b778181e85dd9b6cbed095f8147...c8c7cdc8f8f81b2f162db7acc8faaef0ece3b6ae,1,1,1,2,1,2013-01-30 20:35:45,2013-01-30 20:34:54
c8c7cdc8f8f81b2f162db7acc8faaef0ece3b6ae...fc8efc2d9e693923d3da272e0978e5b0631006f9,2,14,5,19,5,2013-01-30 20:44:14,2013-01-30 20:29:39
fc8efc2d9e693923d3da272e0978e5b0631006f9...3895ebc734c2b3be13d77cdd080b4a76bd4c36e9,1,1,0,1,1,2013-01-30 21:11:53,2013-01-30 21:10:28
47ddd6a4082d55d8856b7e6beac553485dd627f7...52533a64d5866a3586dbfba69c6cb9e39bff7466,1,2,2,4,2,2013-01-30 18:48:05,2013-01-30 18:48:05
bdb5f287144ebf901582ba2b3bde439541fb56f4...1ee40f2141b0cffd4be69fbe5e6a8c526bcf6243,1,3,3,6,3,2013-02-02 02:30:50,2013-02-02 00:10:34
1ee40f2141b0cffd4be69fbe5e6a8c526bcf6243...5f7eecd09af8d69722d483b73b5ac3a086ad0e42,1,3,2,5,2,2013-02-02 02:30:50,2013-02-02 00:33:39
5f7eecd09af8d69722d483b73b5ac3a086ad0e42...c4b6659269260e0a9d75859bbe430b0971b1c15d,2,15,1,16,3,2013-02-02 02:30:50,2013-02-02 00:56:27
c4b6659269260e0a9d75859bbe430b0971b1c15d...2ca37af621c077ab805b8fcb0fb18aef0cfe802d,2,27,2,29,4,2013-02-02 02:30:50,2013-02-02 01:10:16
2ca37af621c077ab805b8fcb0fb18aef0cfe802d...db5049c9f7c6347e4d7866599877beb9e8e78f60,1,1,1,2,1,2013-02-02 09:42:01,2013-02-02 09:42:01
db5049c9f7c6347e4d7866599877beb9e8e78f60...ace9d4efc3e6e0b07fd94b039d62e0d32c81ed3f,4,43,28,71,9,2013-02-02 09:58:31,2013-02-02 09:56:41
ace9d4efc3e6e0b07fd94b039d62e0d32c81ed3f...63d6a50dd8ab4f47c9ae11c1d2a4c4c7eed06be6,2,9,1,10,3,2013-02-02 11:02:36,2013-02-02 10:57:25
63d6a50dd8ab4f47c9ae11c1d2a4c4c7eed06be6...1f8e7bb07592f422406313e3eb41f78790ec94a5,1,1,1,2,1,2013-02-02 11:13:47,2013-02-02 11:13:32
1f8e7bb07592f422406313e3eb41f78790ec94a5...a1c470a6f6084ee3d803d884b62df61ab6f5c5df,1,21,35,56,3,2013-02-02 13:01:24,2013-02-02 13:00:38
a1c470a6f6084ee3d803d884b62df61ab6f5c5df...fdaaa241715ece2f706041faf16fb282e2782593,1,7,1,8,2,2013-02-02 13:34:42,2013-02-02 13:34:42
fdaaa241715ece2f706041faf16fb282e2782593...0694d2196f0fadde37ff2d002a9a4a8edb3ca504,3,36,7,43,5,2013-02-02 22:53:46,2013-02-02 21:21:50
0694d2196f0fadde37ff2d002a9a4a8edb3ca504...c9c40bc6bc64e67365338751e4967d86d0882abf,2,6,4,10,3,2013-02-02 23:01:32,2013-02-02 21:53:43
c9c40bc6bc64e67365338751e4967d86d0882abf...08dc90bccf7c4ffa8b04064d74b54c1150af5ff9,4,58,2,60,6,2013-02-03 00:11:32,2013-02-03 00:08:45
08dc90bccf7c4ffa8b04064d74b54c1150af5ff9...293f7a21147ad94c92c7d5b3f33cbab2f87b001b,3,39,0,39,5,2013-02-03 02:22:40,2013-02-03 02:22:40
293f7a21147ad94c92c7d5b3f33cbab2f87b001b...bc7a219b1e7979ebf0b511d8a3775a0af6dbad33,1,1,1,2,1,2013-02-03 04:57:38,2013-02-03 04:57:38
bc7a219b1e7979ebf0b511d8a3775a0af6dbad33...f556df90be995a83b979cf875705d98521ab4dc7,2,63,3,66,8,2013-02-03 14:26:46,2013-02-02 12:48:55
f556df90be995a83b979cf875705d98521ab4dc7...2c173ff3b45e0a123147e3633082bbf9a7624536,1,1,2,3,2,2013-02-03 18:23:16,2013-02-03 18:22:53
2c173ff3b45e0a123147e3633082bbf9a7624536...869c9ba30615cb24fb5786787a2db8655f2f0d2b,10,153,46,199,29,2013-02-04 02:40:38,2013-02-03 23:53:48
869c9ba30615cb24fb5786787a2db8655f2f0d2b...fb606e10ac07af6014cae838c21bf30cf50e8b40,1,2,5,7,3,2013-02-04 09:02:50,2013-02-04 09:02:50
fb606e10ac07af6014cae838c21bf30cf50e8b40...55c585f1c7a9c91308193f0648caf36203174564,2,61,17,78,14,2013-02-04 09:09:10,2013-02-04 09:04:56
55c585f1c7a9c91308193f0648caf36203174564...40ca99097f34b2180b2afe6d0056cade4c732618,1,4,1,5,2,2013-02-04 10:47:59,2013-02-04 10:47:59
40ca99097f34b2180b2afe6d0056cade4c732618...2edef932ff4ffc766c7abe18bde2cc77babd8fef,1,1,4,5,2,2013-02-04 11:15:22,2013-02-04 11:15:22
2edef932ff4ffc766c7abe18bde2cc77babd8fef...21ea58b8ccf95798271157876d59d46dcc745b0d,3,19,17,36,6,2013-02-04 11:55:45,2013-02-04 11:55:45
21ea58b8ccf95798271157876d59d46dcc745b0d...3f1c7b70537330435e2ec2fca9550f7b7fa4372e,26,314,370,684,106,2013-02-04 12:21:36,2013-01-28 14:51:50
3f1c7b70537330435e2ec2fca9550f7b7fa4372e...7c5b244826be636429791a8ca76b2adc678e82e7,26,117,256,373,67,2013-02-04 15:38:25,2013-02-02 21:58:02
7c5b244826be636429791a8ca76b2adc678e82e7...40260bc30b11bfe0134107bf9dc82a0cd1dcd800,1,8,12,20,2,2013-02-04 17:00:19,2013-02-04 17:00:19
40260bc30b11bfe0134107bf9dc82a0cd1dcd800...5c70299a712434c8f1b2156230634913c6a0c813,1,27,7,34,3,2013-02-04 20:06:38,2013-02-04 20:06:38
5c70299a712434c8f1b2156230634913c6a0c813...826d9de00e74a53d7cc65fcb2aaa5ccdf33674ab,3,0,6,6,3,2013-02-04 23:31:50,2013-02-04 23:31:50
826d9de00e74a53d7cc65fcb2aaa5ccdf33674ab...ec469ade2b04b94bfeb59fb0fc7d9300470be615,32,102,84,186,83,2013-02-05 09:16:07,2013-02-05 09:16:07
ec469ade2b04b94bfeb59fb0fc7d9300470be615...a097ee32d8364045a950d6a36b19630fc34397f1,2,16,7,23,8,2013-02-05 10:39:35,2013-02-05 10:39:35
a097ee32d8364045a950d6a36b19630fc34397f1...ea425ebcb2d42a60ab3934b3bac9378b08e39d12,1,1,1,2,1,2013-02-06 06:07:42,2013-02-06 06:07:42
ea425ebcb2d42a60ab3934b3bac9378b08e39d12...2390fe3f4f8f52e24157d79b0c60247207c9716f,2,20,9,29,11,2013-02-06 09:06:21,2013-02-06 09:02:41
2390fe3f4f8f52e24157d79b0c60247207c9716f...5449240c548bb6877923791d02e800c6b25393f5,6,74,4,78,9,2013-02-06 10:28:05,2013-02-06 10:25:35
5449240c548bb6877923791d02e800c6b25393f5...afa3e1633431137f4e76c7efc359b579f4d9c08e,1,8,0,8,1,2013-02-06 13:24:38,2013-02-06 13:23:18
afa3e1633431137f4e76c7efc359b579f4d9c08e...d7504a3d7b8645bdb979bab7ded0e9a9b6dccd0e,2,2,1,3,2,2013-02-06 20:20:43,2013-02-06 20:20:43
d7504a3d7b8645bdb979bab7ded0e9a9b6dccd0e...d18f796a481e79a3800d4672d6189e4c496cce3d,3,46,20,66,13,2013-02-06 21:01:55,2013-02-01 20:22:20
d18f796a481e79a3800d4672d6189e4c496cce3d...6afc85af47f7d9f4494519de8842111734a61459,1,1,1,2,1,2013-02-07 06:10:13,2013-02-07 06:10:13
6afc85af47f7d9f4494519de8842111734a61459...720888a14699a80a6cd07d32514b9dcd5b1005fb,6,23,2,25,7,2013-02-07 08:48:08,2013-02-07 08:48:08
720888a14699a80a6cd07d32514b9dcd5b1005fb...43efefae692729925c0f75c55e93bd1f33f42bfd,1,27,20,47,19,2013-02-07 11:12:25,2013-02-07 11:12:25
43efefae692729925c0f75c55e93bd1f33f42bfd...aa85ccf8ce11c4b8374c74fd9dfe72647be49ada,5,116,98,214,23,2013-02-07 12:05:36,2013-02-07 10:51:25
aa85ccf8ce11c4b8374c74fd9dfe72647be49ada...2b916895a1cea39de3280a6910e2886aebfcfc64,1,4,3,7,4,2013-02-07 13:33:36,2013-02-07 13:33:36
2b916895a1cea39de3280a6910e2886aebfcfc64...04d9730b127c689b8eda01cbc913efa6e2eb230b,3,72,3,75,6,2013-02-07 19:05:54,2013-02-06 02:35:10
04d9730b127c689b8eda01cbc913efa6e2eb230b...b5391515cd9b3f2608ca41fa61471a04b771389a,1,1,3,4,1,2013-02-07 19:51:27,2013-02-07 19:51:27
b5391515cd9b3f2608ca41fa61471a04b771389a...64623a2e115d781c99c7df4dbb67a1e576c0165a,2,33,15,48,12,2013-02-07 21:36:12,2013-02-07 21:35:23
64623a2e115d781c99c7df4dbb67a1e576c0165a...112c6e987dbe789c8eb1889852f6056131c8d4d6,1,1,1,2,1,2013-02-07 22:57:26,2013-02-07 22:57:26
112c6e987dbe789c8eb1889852f6056131c8d4d6...c44d748272d1d39e7cd48b625c526f532703aa29,3,32,8,40,5,2013-02-08 00:07:56,2013-02-06 22:25:51
c44d748272d1d39e7cd48b625c526f532703aa29...e486475a13ba626f67008ade3544c74003f0a881,1,2,5,7,4,2013-02-08 09:01:56,2013-02-08 09:01:56
e486475a13ba626f67008ade3544c74003f0a881...2ed90eac49b99d66ee4f2d59af8553274a4d095f,5,31,5,36,11,2013-02-08 15:32:09,2013-02-08 15:32:09
2ed90eac49b99d66ee4f2d59af8553274a4d095f...868e0f3cb4cc47418e43a08c373f0707e3cf301c,1,0,2,2,2,2013-02-08 16:11:33,2013-02-08 16:11:33
868e0f3cb4cc47418e43a08c373f0707e3cf301c...db09a2de6e1bc7121d301dad9610efcda9c7a925,3,17,0,17,6,2013-02-08 20:12:03,2013-02-08 20:12:03
db09a2de6e1bc7121d301dad9610efcda9c7a925...f44922c79516b9caf0e09fb060f20c896668b90f,3,23,23,46,13,2013-02-08 20:35:19,2013-02-08 20:30:06
f44922c79516b9caf0e09fb060f20c896668b90f...0201b9d6d89ea277383e1fc0007bfaa33351b60b,2,12,1,13,3,2013-02-09 09:17:26,2013-02-09 09:17:26
0201b9d6d89ea277383e1fc0007bfaa33351b60b...d93edffa896a68fc74c9a414c6beee289d176798,2,5,11,16,4,2013-02-09 14:16:10,2013-02-09 14:16:10
d93edffa896a68fc74c9a414c6beee289d176798...718afcafc202940cd15799459178a2534b8217d5,3,45,0,45,2,2013-02-09 15:34:22,2013-02-09 15:30:33
718afcafc202940cd15799459178a2534b8217d5...0e18fb04bad99de237b5eb8ea4f9ff2f3cd147d3,1,1,5,6,1,2013-02-09 17:31:04,2013-02-09 17:30:26
0e18fb04bad99de237b5eb8ea4f9ff2f3cd147d3...a4e97cf315142e61bb4bc3ed8259b95d8586d09c,8,127,6,133,14,2013-02-10 11:55:54,2013-02-05 21:52:29
a4e97cf315142e61bb4bc3ed8259b95d8586d09c...0478780b8efdfcbc0d2c17f1459cac45701e1d86,2,2,0,2,2,2013-02-10 16:56:36,2013-02-10 16:36:35
0478780b8efdfcbc0d2c17f1459cac45701e1d86...8ef3235034a1a7616714a5d61486dc68536f74ee,3,23,2,25,4,2013-02-10 17:54:02,2013-02-10 17:49:28
8ef3235034a1a7616714a5d61486dc68536f74ee...af2bb174708e662c59f43f3f8df79e4de7411451,1,6,0,6,1,2013-02-10 17:58:42,2013-02-10 17:58:42
af2bb174708e662c59f43f3f8df79e4de7411451...5cc0f5f8c1f35218ee4bce2d8c943a86f1888b96,2,3,3,6,3,2013-02-10 18:58:25,2013-02-10 18:52:52
5cc0f5f8c1f35218ee4bce2d8c943a86f1888b96...604d8763dc2c901a3557e15880895d88af5c4127,1,4,2,6,3,2013-02-10 19:08:19,2013-02-10 19:07:24
604d8763dc2c901a3557e15880895d88af5c4127...8fbc20b24bd14e22f3d9c0dd02781ddf1f2b5bd7,1,3,3,6,2,2013-02-10 19:49:16,2013-02-10 19:43:08
8fbc20b24bd14e22f3d9c0dd02781ddf1f2b5bd7...5ce6a7cea25ac8e616fa6bd132ee341a240aad6f,1,4,11,15,2,2013-02-10 23:07:50,2013-02-10 23:07:50
5ce6a7cea25ac8e616fa6bd132ee341a240aad6f...a10f3908042a71ec5ef81bf76f0f278ca5e7a596,5,29,8,37,8,2013-02-11 07:39:14,2013-02-11 07:39:14
a10f3908042a71ec5ef81bf76f0f278ca5e7a596...7db770b013f26b81bef878541c1016a3eb291011,1,2,2,4,1,2013-02-11 09:38:39,2013-02-11 09:28:46
09a39ca0824611280ae180fe4cc59df669097ecb...17b14d481984f3a466a02993b35940430e5dbe91,1,1,1,2,1,2012-11-12 21:15:41,2012-11-12 21:15:41
5d560dcb981400451d69a834f7c6a9090f5e5221...6006c1f076ae7661a601ab6efa4087caf935fbba,1,1,1,2,1,2012-07-24 18:45:56,2012-07-24 18:45:56
6006c1f076ae7661a601ab6efa4087caf935fbba...c7ac44e64ba0862e77753bf4859102bb1dbfe883,1,1,1,2,1,2012-07-25 06:20:26,2012-07-25 06:20:26
5d560dcb981400451d69a834f7c6a9090f5e5221...85cd458944c16769a707921619e94ccc3dfbf7bd,2,6,6,12,4,2012-07-20 10:29:22,2012-07-20 10:29:22
85cd458944c16769a707921619e94ccc3dfbf7bd...324d48d0a7de895aeb7397cd3365ab03ac7f6724,4,10,10,20,9,2012-07-20 11:28:36,2012-07-20 11:28:36
324d48d0a7de895aeb7397cd3365ab03ac7f6724...38c18f1747ef272f397e1080f04e52f27bd1bc33,1,1,1,2,1,2012-07-20 11:42:44,2012-07-20 11:42:44
38c18f1747ef272f397e1080f04e52f27bd1bc33...32a4df6c55f2efd020b7fbc44c858f61b07da17d,1,12,0,12,2,2012-07-21 11:49:07,2012-07-21 11:49:07
32a4df6c55f2efd020b7fbc44c858f61b07da17d...423244bc6b670abc2b7d6896add5c1baf0b4ef2a,3,39,16,55,8,2012-07-21 12:24:29,2012-07-21 12:24:29
423244bc6b670abc2b7d6896add5c1baf0b4ef2a...9ecd978e269f28f711080fa66e47c84e6ff08d90,1,1,1,2,1,2012-07-21 13:38:28,2012-07-21 13:38:24
9ecd978e269f28f711080fa66e47c84e6ff08d90...1af0271d7c6f5ecda2247a2b363d25f493c7b05a,3,17,1,18,5,2012-07-21 20:30:34,2012-07-21 20:30:34
1af0271d7c6f5ecda2247a2b363d25f493c7b05a...4ceb9db9d849905720a1c958a5f8629753ef6604,1,1,1,2,1,2012-07-21 20:38:25,2012-07-21 20:38:25
4ceb9db9d849905720a1c958a5f8629753ef6604...2b6644388f1a33f0b2eeb1c7a576fc04cfa72e0a,1,1,1,2,1,2012-07-21 22:13:55,2012-07-21 22:13:55
2b6644388f1a33f0b2eeb1c7a576fc04cfa72e0a...ea667ee3aeed33bce1dd681d9c0ea42f9926db5a,1,7,0,7,1,2012-07-21 23:16:47,2012-07-21 23:16:47
ea667ee3aeed33bce1dd681d9c0ea42f9926db5a...01c392623d988d7486bdaa870886df0ea3da5fa7,6,28,4,32,9,2012-07-22 01:10:24,2012-07-22 01:10:24
01c392623d988d7486bdaa870886df0ea3da5fa7...8b0190984116873158ee627c7a033a7bd4c3a199,3,378,337,715,15,2012-07-22 07:29:44,2012-07-20 09:32:38
8b0190984116873158ee627c7a033a7bd4c3a199...473d5f4ba1ce4ea93e7cb371b78d318423dfebe6,1,1,1,2,1,2012-07-22 07:29:51,2012-07-20 14:05:39
473d5f4ba1ce4ea93e7cb371b78d318423dfebe6...d796c94b03ffbe90895ec68c5041806907cb9577,8,38,30,68,33,2012-07-22 07:29:52,2012-07-20 10:18:38
d796c94b03ffbe90895ec68c5041806907cb9577...7fa51a24a8ca47f41f5d711e81b8a71b08542a36,4,26,26,52,21,2012-07-22 07:29:52,2012-07-21 19:06:13
7fa51a24a8ca47f41f5d711e81b8a71b08542a36...d11d45aad969be313b9e046d0d42b179a3fb6906,5,24,12,36,16,2012-07-22 07:29:52,2012-07-20 19:20:42
d11d45aad969be313b9e046d0d42b179a3fb6906...f1d5dc81ac37fe9a7c7ca860900ee6a16150bb09,2,8,8,16,6,2012-07-22 07:29:53,2012-07-21 20:02:28
f1d5dc81ac37fe9a7c7ca860900ee6a16150bb09...56dbe924a6e700cefbfd34f1a5aa6c1ee01478dc,26,100,79,179,81,2012-07-22 07:29:53,2012-07-20 10:45:19
56dbe924a6e700cefbfd34f1a5aa6c1ee01478dc...cacd845996d1245f6aed257bff5f748f46206d3f,4,7,5,12,5,2012-07-22 07:29:53,2012-07-20 11:52:16
cacd845996d1245f6aed257bff5f748f46206d3f...3cb2457f46b3e40ff6b6acffcb3fd44cbea091e5,73,230,150,380,211,2012-07-22 07:29:54,2012-07-20 12:22:00
3cb2457f46b3e40ff6b6acffcb3fd44cbea091e5...bdca5ea345c548a82a80d198906818c9ccbef896,96,376,294,670,328,2012-07-22 07:29:54,2012-07-20 12:48:51
bdca5ea345c548a82a80d198906818c9ccbef896...0d914d08a0d7b5a1521f498a8047971fe6cd61e7,32,181,96,277,88,2012-07-22 07:29:55,2012-07-20 13:36:52
0d914d08a0d7b5a1521f498a8047971fe6cd61e7...ca07fda2efea24cb43423b884fa4648d44e52963,24,54,48,102,50,2012-07-22 07:29:56,2012-07-20 14:16:57
ca07fda2efea24cb43423b884fa4648d44e52963...a84d79f572fbe7512b999c6b3cd7667cbe3138ff,32,77,53,130,75,2012-07-22 07:29:56,2012-07-20 16:53:11
a84d79f572fbe7512b999c6b3cd7667cbe3138ff...00ace01411b4cb558e71bfaf34cf42870e73092b,2,99,25,124,9,2012-07-22 08:29:07,2012-07-22 08:29:07
e567f439bdfc60e16c465220fdaa8ea8a0fae936...dd16b17099b7d86f27773df048c5014cf439b282,1,6,1,7,3,2012-07-30 19:54:29,2012-07-30 19:54:29
dd16b17099b7d86f27773df048c5014cf439b282...b1d463468694f2e91fde67221b7996e9c52a9720,1,4,14,18,1,2012-07-30 19:57:22,2012-07-30 19:57:22
b1d463468694f2e91fde67221b7996e9c52a9720...4129201c3e0fa057c198bdefcb34686a23b4a93c,2,30,13,43,10,2012-07-30 20:01:50,2012-07-30 20:01:50
4129201c3e0fa057c198bdefcb34686a23b4a93c...8d3e501502c308cbdd3cc95b62ace0fe11d373ab,1,8,7,15,2,2012-07-30 22:10:21,2012-07-30 20:16:11
8d3e501502c308cbdd3cc95b62ace0fe11d373ab...964979e8ecec3ceccb2119ccb7270111b953611e,1,3,3,6,2,2012-07-31 20:13:52,2012-07-31 20:13:52
964979e8ecec3ceccb2119ccb7270111b953611e...ebbc414d1729f24e395ee050a62276229c59d75d,1,4,0,4,1,2012-08-01 11:59:28,2012-07-31 20:20:41
ebbc414d1729f24e395ee050a62276229c59d75d...c59fff707ac5cfa1f6d12e889a157b569cf2429e,1,1,0,1,1,2012-08-02 10:27:53,2012-08-02 10:27:53
c59fff707ac5cfa1f6d12e889a157b569cf2429e...d7816c563b58ed53d49956321d549a16e2b2ebc0,1,6,0,6,1,2012-08-02 10:45:55,2012-08-02 10:45:55
75c87e2d38b181163a61ea99f2a17273274a3a2b...fb26c4996a0c4d41aa80d28ce65ab050ffe6df6b,1,3,0,3,1,2013-08-07 18:57:56,2013-08-07 18:57:56
75c87e2d38b181163a61ea99f2a17273274a3a2b...04489c7dbf8f69de84ca272a0a1710e7b6067e9d,2,27,5,32,5,2013-08-05 17:34:35,2013-08-05 17:34:35
51a9a5980af3b4762d09c4aa4551d370a1b8b9a8...b785a80d1934ef05165f222779c3f47c32889825,2,13,3,16,7,2013-08-26 11:47:24,2013-08-25 00:26:34
b785a80d1934ef05165f222779c3f47c32889825...fa572666998bf5dc70d15ec9386d5d3692b264f2,5,35,7,42,12,2013-08-26 19:34:29,2013-08-26 19:34:29
fa572666998bf5dc70d15ec9386d5d3692b264f2...dd3a883894a219bc6c69e556c694734ab82b33e9,3,96,55,151,15,2013-08-26 21:15:53,2013-07-02 22:19:56
51a9a5980af3b4762d09c4aa4551d370a1b8b9a8...5fd2c979cb1289e87b3d2172304106a5b7083459,1,1,1,2,1,2013-08-26 09:19:40,2013-08-26 09:18:21
6b0d93df18a5c265f87ee6e64dbdffbdecfcea4f...e6b34193c5c7d117ededdab04bb16caf8864f07c,2,5,2,7,4,2012-10-20 23:25:35,2012-10-20 23:25:35
6b3d2bc9810153506620c7794a7a87ade29e3a97...1a3ff63199cd14f772a86090c4546953f3f19343,1,2,3,5,1,2012-10-21 14:41:59,2012-10-21 14:37:57
1a3ff63199cd14f772a86090c4546953f3f19343...e987d20ac92ceef382cc02dfab38aac64d84dc5d,2,43,2,45,4,2012-10-21 14:49:35,2012-10-18 16:55:14
6086f7356d37f4a544e3e103501f7fb4e268015c...6e4c9840988b1aa3ae4598a7d04b13ada078be33,1,6,1,7,1,2012-08-17 18:19:14,2012-08-17 18:16:38
befa1dd7a5f88bcf994598c36438338109478409...4412de5d8d5be6fa9b9a3c0a0881ed741dbe3569,1,1,1,2,1,2012-08-16 06:08:45,2012-08-16 06:08:45
b1e0ec06f0d538eb2ab16a7c1ecefd1d896e6382...310cdf492d2642e7cf00bcc169895f5954f10369,1,0,4,4,4,2013-07-02 10:08:16,2013-07-02 10:08:16
310cdf492d2642e7cf00bcc169895f5954f10369...67dcea711e92025d0e8676b869b7ef15dbc6db73,7,84,17,101,21,2013-07-02 10:19:02,2013-07-02 10:19:02
67dcea711e92025d0e8676b869b7ef15dbc6db73...3b20af3e96b45fd3cfd9beb74bd09f65b4e38aa8,2,47,0,47,3,2013-07-02 10:25:18,2013-07-02 10:25:18
3b20af3e96b45fd3cfd9beb74bd09f65b4e38aa8...6a8cfbf07b2ba7e18db4d86aed0111be4457981e,2,86,1,87,3,2013-07-02 10:43:44,2013-07-02 10:43:44
6a8cfbf07b2ba7e18db4d86aed0111be4457981e...f343cbf06cba0e2ace0157224f85b89488093fa1,1,3,1,4,3,2013-07-02 10:51:18,2013-07-02 10:51:18
f343cbf06cba0e2ace0157224f85b89488093fa1...9ef715d256938bd5d2c95a88ce0479aa5e493981,1,4,2,6,3,2013-07-02 10:51:38,2013-07-02 10:51:38
9ef715d256938bd5d2c95a88ce0479aa5e493981...dbd3e775c1d2209d2b35cb1fa4b82e20b18c99d7,1,16,11,27,6,2013-07-02 11:06:00,2013-07-02 11:06:00
dbd3e775c1d2209d2b35cb1fa4b82e20b18c99d7...2202e3f7d3b3855d59d87c3865982f43b9370ba1,1,1,1,2,1,2013-07-02 11:06:26,2013-07-02 11:06:26
2202e3f7d3b3855d59d87c3865982f43b9370ba1...61ff46cf8b483d857768832818693f6225b534ca,3,67,2,69,5,2013-07-02 17:02:01,2013-07-02 17:02:01
61ff46cf8b483d857768832818693f6225b534ca...3a6580e485c11fc5502ffd1bb53347459db43421,5,32,31,63,27,2013-07-02 17:02:20,2013-07-02 17:02:20
5180e40bee92edc4ef00d593a4609ff3a5295c90...9d6ecc6bc668b5a243905486fa724d53508ad2b5,3,32,3,35,6,2013-03-19 00:11:07,2013-03-18 23:58:33
5b4805ae2bbc14b159e3bfd84e78eb9189ffa6eb...b2039d39d537340c1617f23d68b3f40f070e01db,1,6,4,10,1,2013-01-31 12:37:42,2013-01-31 12:37:42
b2039d39d537340c1617f23d68b3f40f070e01db...89cb771be7b53c40642872cdbedb15943bdf8e34,11,81,40,121,30,2013-01-31 12:54:40,2013-01-31 12:39:29
89cb771be7b53c40642872cdbedb15943bdf8e34...9a4a1ce323237d0aadafbddcd270c47be251bac2,2,34,3,37,6,2013-01-31 15:01:50,2013-01-31 15:00:39
7db770b013f26b81bef878541c1016a3eb291011...74003ca36b0712830c3756bc00a0d1f1d4b313ea,1,1,1,2,1,2013-02-12 14:14:19,2013-02-12 14:14:19
7db770b013f26b81bef878541c1016a3eb291011...5a3d9490f14263cc4ed78b6adcb764936b07b4ae,2,5,5,10,4,2013-02-11 20:56:35,2013-02-11 20:50:49
7733f1463141f2f0fd00cc18730582cfb365dc5d...a72b8a224721775b31e2075c99165f1e3ca28092,1,2,1,3,2,2012-11-13 10:45:08,2012-11-13 10:45:08
00ace01411b4cb558e71bfaf34cf42870e73092b...690cabe2033b43999f576cbe581b8f465903eda0,1,2,2,4,1,2012-07-22 16:05:53,2012-07-22 16:05:53
690cabe2033b43999f576cbe581b8f465903eda0...ebc89a800ac743bccb56810526c352fedd2aaa3e,1,2,2,4,1,2012-07-22 17:48:10,2012-07-22 17:48:10
ebc89a800ac743bccb56810526c352fedd2aaa3e...ae4125ffce6c0a82e9016f67d60d31bc7595887c,1,7,13,20,5,2012-07-23 11:48:04,2012-07-23 11:48:04
00ace01411b4cb558e71bfaf34cf42870e73092b...cc65f4ec8db21ee24f954bf52c39749b4b7caca4,1,1,1,2,1,2012-07-22 14:54:47,2012-07-22 14:54:47
d7816c563b58ed53d49956321d549a16e2b2ebc0...39541be3bc76f937cd8a2182aee4c92c9212c6b7,3,0,0,0,0,2012-08-02 11:52:16,2012-08-02 10:47:59
39541be3bc76f937cd8a2182aee4c92c9212c6b7...07e10fbe9f1a77fe03cfceeb008e1e56caba3a40,1,5,4,9,3,2012-08-02 11:54:07,2012-08-02 10:54:19
07e10fbe9f1a77fe03cfceeb008e1e56caba3a40...2a16eb07927c866b4d8e1d318f71bd1038b34cae,2,8,0,8,1,2012-08-02 23:22:49,2012-08-02 23:21:48
2a16eb07927c866b4d8e1d318f71bd1038b34cae...8fbfd217196e6bc49677d348338ded64d3373e9a,1,1,1,2,1,2012-08-03 07:26:11,2012-08-03 07:26:11
8fbfd217196e6bc49677d348338ded64d3373e9a...a55cde8ab1dc33723b4bac472b6fac6bb45d725a,1,8,7,15,3,2012-08-03 07:35:39,2012-08-03 07:35:39
a55cde8ab1dc33723b4bac472b6fac6bb45d725a...c5d6f6d6829e730bdddf63c1252304f0c49a9053,2,411,404,815,63,2012-08-03 08:53:30,2012-08-03 08:47:27
c5d6f6d6829e730bdddf63c1252304f0c49a9053...083a3a4e39bc3ead6090e862935d223d8719c4ce,2,13,0,13,2,2012-08-03 09:17:52,2012-08-03 09:17:52
083a3a4e39bc3ead6090e862935d223d8719c4ce...2407c45c180703f935a2280cb3325beadc2ac8cc,1,9,28,37,6,2012-08-03 09:27:31,2012-08-03 09:26:47
2407c45c180703f935a2280cb3325beadc2ac8cc...9908201d7fc3340b83db21298033c5b347f38d65,6,15,15,30,9,2012-08-03 13:18:13,2012-08-03 13:18:13
9908201d7fc3340b83db21298033c5b347f38d65...5aec69ed290552e7ea20bdef416c5bc23f6231f8,1,5,0,5,1,2012-08-03 13:40:29,2012-08-03 13:40:29
5aec69ed290552e7ea20bdef416c5bc23f6231f8...129f1ac8484d63c2e61a44fb2a18dd17246c1c4d,1,1,1,2,1,2012-08-03 14:10:04,2012-08-03 14:10:04
129f1ac8484d63c2e61a44fb2a18dd17246c1c4d...d01eaf7104e96b2fcf373ddfbc80ef4568bd0387,4,31,18,49,12,2012-08-03 16:51:28,2012-08-03 16:46:30
d01eaf7104e96b2fcf373ddfbc80ef4568bd0387...b496be331c19f41bee3a8f6c79de0722f91d6662,1,11,3,14,2,2012-08-03 20:27:45,2012-08-03 20:06:41
b496be331c19f41bee3a8f6c79de0722f91d6662...10f979fd92000de1ac9713351f5cb749e2cbca03,3,7,3,10,5,2012-08-04 10:57:12,2012-08-03 00:03:52
10f979fd92000de1ac9713351f5cb749e2cbca03...121fd109de09ece4e263e508f9034df9b583da46,8,46,51,97,20,2012-08-04 12:22:23,2012-08-04 12:17:02
121fd109de09ece4e263e508f9034df9b583da46...09a719a4e6820d462fc796606cb242583ad4e79d,2,4,3,7,2,2012-08-04 12:55:13,2012-08-04 12:55:13
09a719a4e6820d462fc796606cb242583ad4e79d...542c20b38263afb8161d354e6a2cc4ef6bb21de5,1,5,5,10,4,2012-08-04 15:38:18,2012-08-04 15:38:18
542c20b38263afb8161d354e6a2cc4ef6bb21de5...865ff32b84316a416661abc3e3e15c753395486c,1,40,25,65,12,2012-08-04 19:24:40,2012-08-04 19:24:40
d7816c563b58ed53d49956321d549a16e2b2ebc0...6f229d2d7a4621fd73e0a5d22b8b7d42dec9493e,1,1,1,2,1,2012-08-02 11:29:19,2012-08-02 11:29:19
cf041b883c6a089f0b113846918fdb074e465713...7a2296eb5bb05a4109392f8333e934d576d79d35,1,44,0,44,1,2013-08-08 09:36:17,2013-08-07 17:47:07
04489c7dbf8f69de84ca272a0a1710e7b6067e9d...263b873599a50609df7865ff9cf24c63cd3e82d2,2,33,18,51,21,2013-08-06 07:07:52,2013-08-06 06:58:07
04489c7dbf8f69de84ca272a0a1710e7b6067e9d...71093d22b62548fc2667468f1ae9e28f4fef30db,2,13,1,14,3,2013-08-05 19:26:51,2013-08-05 19:26:51
bd97026490b3a78db5af0a385cc53ad65e4f66d5...c9a69cdb9386f16f0323a2e529d37129591a83e9,1,2,3,5,2,2013-08-27 12:05:13,2013-08-27 12:05:13
c9a69cdb9386f16f0323a2e529d37129591a83e9...08e7a643690513bc90d4ae855ae0260233fe6e0c,1,1,1,2,1,2013-08-27 12:21:42,2013-08-26 02:07:00
08e7a643690513bc90d4ae855ae0260233fe6e0c...4f7ed3f2d14d1c9ec2b9f8b3fae5cced008606ea,1,102,66,168,12,2013-08-27 13:39:56,2013-08-27 13:39:56
4f7ed3f2d14d1c9ec2b9f8b3fae5cced008606ea...095643e69145d6899313c518fdd39919c9a89908,1,3,2,5,1,2013-08-27 14:25:26,2013-08-27 00:00:11
22471a41ba676afdab55daf34f1c7c25b327bbb9...b4066d7d2149782cd694b98d1a6ed5c7ee885f55,5,973,934,1907,9,2012-10-21 18:12:59,2012-10-21 18:12:59
b4066d7d2149782cd694b98d1a6ed5c7ee885f55...5e629a015e96a5564a0b0a273e1374b9651ce8e9,3,45,0,45,1,2012-10-21 20:40:31,2012-10-21 20:40:31
5e629a015e96a5564a0b0a273e1374b9651ce8e9...104ca49c57e3e48fe518985e2eee60ce6969d7ab,1,0,3,3,1,2012-10-21 20:44:02,2012-10-21 20:44:02
104ca49c57e3e48fe518985e2eee60ce6969d7ab...58cc3e8484c4fb7db787ec2c21d8aeac3d131f3e,2,2,6,8,3,2012-10-22 07:31:28,2012-10-22 07:28:22
58cc3e8484c4fb7db787ec2c21d8aeac3d131f3e...e70170c2cbc8871f3bc1f585601b831eef0be9dc,1,132,154,286,15,2012-10-22 12:45:41,2012-10-22 12:45:41
6e4c9840988b1aa3ae4598a7d04b13ada078be33...4c934f3921a59c7b3e088f6472b6f6da40848567,2,49,14,63,4,2012-08-18 02:15:20,2012-08-18 02:15:20
4c934f3921a59c7b3e088f6472b6f6da40848567...4da1d0fd65e01abe013e0d5a9174b81c6bbfa677,1,11,0,11,1,2012-08-18 07:58:42,2012-08-18 07:55:13
4da1d0fd65e01abe013e0d5a9174b81c6bbfa677...6cb76cb140d8ca9815fc90829b6636eb6e43ac42,2,8,5,13,6,2012-08-18 08:18:24,2012-08-18 08:18:24
6cb76cb140d8ca9815fc90829b6636eb6e43ac42...1ad05172cb5e2fafe85540e2525114843c693955,1,4,2,6,3,2012-08-18 08:24:23,2012-08-18 08:24:23
6e4c9840988b1aa3ae4598a7d04b13ada078be33...e437dd1d6be5fdc3a7acf7abcf97b922e628313b,1,3,3,6,3,2012-08-18 00:29:46,2012-08-18 00:29:46
71d07fb048849db5a0a3b1d81f87fae51c6097c0...e98cb05edf87eebf939a680066822c16f1257f44,1,13,4,17,4,2012-08-16 07:44:42,2012-08-16 07:44:00
e98cb05edf87eebf939a680066822c16f1257f44...688678e7c091e4549777d8cc47e8984d5e672976,1,19,16,35,2,2012-08-16 07:56:42,2012-08-16 07:56:42
688678e7c091e4549777d8cc47e8984d5e672976...8c356acf2e6896759e6ca7a369f0b04766a928f3,1,19,14,33,4,2012-08-16 08:26:18,2012-08-16 08:26:18
8c356acf2e6896759e6ca7a369f0b04766a928f3...fcc8de0598f5a2024ad8a49e9bc38912b9511ca7,2,19,13,32,12,2012-08-16 11:01:16,2012-08-16 11:01:16
fcc8de0598f5a2024ad8a49e9bc38912b9511ca7...d69bd23b553d2d299e565ea8bd51a38a2b185acf,1,1,1,2,1,2012-08-16 13:31:01,2012-08-16 13:31:01
d69bd23b553d2d299e565ea8bd51a38a2b185acf...37a894b48c857d89820e6e8f90436422a075f7ad,1,4,2,6,3,2012-08-16 14:54:45,2012-08-16 14:54:45
37a894b48c857d89820e6e8f90436422a075f7ad...5c79dd586534bc88ce7dc81c2d781c772d28b121,1,100,88,188,11,2012-08-16 19:03:11,2012-08-16 19:03:11
5c79dd586534bc88ce7dc81c2d781c772d28b121...d739d531a111f8780c2183605b56c4e2352ec4a5,1,1,1,2,1,2012-08-16 20:04:50,2012-08-16 20:03:58
d739d531a111f8780c2183605b56c4e2352ec4a5...2079b730f139685bcedf0c92d5ed9a3f64b51e9f,1,4,4,8,1,2012-08-16 22:15:19,2012-08-16 20:05:41
2079b730f139685bcedf0c92d5ed9a3f64b51e9f...b1f18e95a5481e582f52a42807506369b73d8c6a,1,7,0,7,1,2012-08-16 22:16:19,2012-08-16 20:13:45
b1f18e95a5481e582f52a42807506369b73d8c6a...ad11dbf670fb4b419be0c208c77cb1081d57b3b1,1,6,3,9,6,2012-08-17 12:11:23,2012-08-17 12:11:23
9d6ecc6bc668b5a243905486fa724d53508ad2b5...ae8fcedbc7694010490ac2b365b397e8e2e39b44,1,6,0,6,1,2013-03-19 02:18:35,2013-03-19 02:18:35
9a4a1ce323237d0aadafbddcd270c47be251bac2...d877778bf39184d5b203eaf0add7c4265f820e02,1,1,1,2,1,2013-01-31 18:40:38,2013-01-31 18:40:38
9a4a1ce323237d0aadafbddcd270c47be251bac2...7947c9e3a6bd8c1dfe7fc209fb2256a528149bb6,5,47,22,69,19,2013-01-31 17:57:45,2013-01-31 17:56:26
c4841b3de4ffe0047dfc2d3435c22e77b0f98d86...fafee74306e869c23edcef864f9d816565a5c4a2,3,15,19,34,4,2013-02-12 22:25:09,2013-02-12 21:11:22
fafee74306e869c23edcef864f9d816565a5c4a2...3a002db6f1ef98d04634911808f9cf1b8e9dceff,3,6,6,12,6,2013-02-13 00:10:36,2013-02-13 00:10:36
3a002db6f1ef98d04634911808f9cf1b8e9dceff...e94f405d9499d310ef58b7409a98759a5f5512b0,15,82,66,148,71,2013-02-13 09:29:32,2013-02-13 08:55:43
e94f405d9499d310ef58b7409a98759a5f5512b0...ac4faa6dc33407c93566884e53fa5d8ef44c0a2a,2,20,9,29,5,2013-02-13 17:24:49,2013-02-13 17:24:49
ac4faa6dc33407c93566884e53fa5d8ef44c0a2a...142ec8b2835c242339b930c47a70a3c7036df91d,1,10,7,17,7,2013-02-13 22:11:49,2013-02-13 22:10:43
142ec8b2835c242339b930c47a70a3c7036df91d...f1029b308f3ea967a5d93aea2b730671898a56f5,1,1,1,2,1,2013-02-14 07:33:10,2013-02-14 07:33:10
f1029b308f3ea967a5d93aea2b730671898a56f5...138de533ff677b470a1e7b4b6ff084a5b7a7444b,3,23,2,25,6,2013-02-14 09:22:59,2013-02-14 08:45:55
138de533ff677b470a1e7b4b6ff084a5b7a7444b...668d0b8d499c45ef7d449b5e56f0adc97660d417,1,1,1,2,1,2013-02-14 10:23:52,2013-02-14 10:22:33
668d0b8d499c45ef7d449b5e56f0adc97660d417...f179a5198e05e1be8ba8be87c1f0e1a8924cf005,1,1,3,4,1,2013-02-14 23:29:21,2013-02-14 23:29:21
f179a5198e05e1be8ba8be87c1f0e1a8924cf005...f5e4a699ca0f58818acbdf9081164060cee910fa,4,49,2,51,6,2013-02-15 01:00:55,2013-02-15 01:00:55
5a3d9490f14263cc4ed78b6adcb764936b07b4ae...0560bfb705687c831e2769b1202706e2ceb1f7a7,1,49,4,53,7,2013-02-12 12:36:29,2013-02-11 15:49:30
5a3d9490f14263cc4ed78b6adcb764936b07b4ae...278dad5b411e3e2ba8b428f7761882424353dea7,3,27,3,30,6,2013-02-12 09:10:42,2013-02-12 06:00:38
e27a43cc54f120c49cac33b36568b128bcfaef5a...00ff69a827b38054afe557fc7d0a589b270ed871,2,7,7,14,10,2012-11-13 19:46:29,2012-11-13 19:46:29
00ff69a827b38054afe557fc7d0a589b270ed871...fa18b0ac89723f4ed6e46e744039bf375c8945a5,1,14,19,33,9,2012-11-13 20:48:25,2012-11-10 22:35:46
fa18b0ac89723f4ed6e46e744039bf375c8945a5...ce1af8d7023f02e4521cce3bcdbc9fd13d76c5f8,1,5,5,10,3,2012-11-13 20:48:25,2012-11-10 23:59:24
ce1af8d7023f02e4521cce3bcdbc9fd13d76c5f8...ebcf6b36ffa7ee20b7219d34200b093186befcb4,2,18,20,38,10,2012-11-13 20:52:58,2012-11-11 12:05:29
ae4125ffce6c0a82e9016f67d60d31bc7595887c...38ce709fe44ebf37e6c8531451eab98fe0a552a0,2,24,4,28,4,2012-07-24 14:01:57,2012-07-24 14:01:57
38ce709fe44ebf37e6c8531451eab98fe0a552a0...f758bdab5eec3e615598948dd5bcf9bb7b910c9d,11,269,98,367,36,2012-07-24 20:24:16,2012-07-24 20:24:16
ae4125ffce6c0a82e9016f67d60d31bc7595887c...226a3e7e00357a5c055faa5138d8338243c4c2c9,1,1,1,2,1,2012-07-23 22:45:40,2012-07-23 22:28:29
4865274bc130c90e2f6107994fcdeecd9cea3f84...04e8ef5a8361042577c2ebdb0512561e8249e0c5,1,2,2,4,2,2012-07-25 20:33:38,2012-07-25 20:33:38
7a2296eb5bb05a4109392f8333e934d576d79d35...e868eaf680a3d7acfcd3c76743bb248d29ac7b60,1,1,1,2,1,2013-08-10 21:24:24,2013-08-10 21:24:24
7a2296eb5bb05a4109392f8333e934d576d79d35...fb1dd6b13a0e6b1ef64eac88467321d097942cd2,4,30,12,42,8,2013-08-08 13:05:55,2013-08-08 13:05:55
fb1dd6b13a0e6b1ef64eac88467321d097942cd2...1c4a9bd9ad1a8e61817c6aa2b0d8d0ad2c080047,3,15,3,18,3,2013-08-08 13:27:48,2013-08-08 13:27:48
1c4a9bd9ad1a8e61817c6aa2b0d8d0ad2c080047...7e6af9d40ce0232deb9d4c6943beef0b62a20a08,1,18,4,22,3,2013-08-08 13:45:26,2013-08-08 12:16:48
7a2296eb5bb05a4109392f8333e934d576d79d35...f96fe3cd1eb56bdd4433f76a933a98915ea25ece,1,7,5,12,1,2013-08-08 11:45:06,2013-08-08 11:45:06
0b771fcf2923cef1b0d759fda79907c39ad733b4...c33d1ca1d98003de29cdecb6080b52c5c52139bd,20,30,30,60,29,2013-08-06 11:13:17,2013-08-05 16:23:26
c33d1ca1d98003de29cdecb6080b52c5c52139bd...12806758347dfd63a3cd1bfc0d925c09fdbd9cff,4,139,9,148,11,2013-08-06 12:50:47,2013-05-07 09:06:03
12806758347dfd63a3cd1bfc0d925c09fdbd9cff...1c64a0f29e47a3da1dfac06b04ef84280bd809a7,2,14,1,15,4,2013-08-06 13:50:59,2013-02-26 09:51:56
1c64a0f29e47a3da1dfac06b04ef84280bd809a7...709cd2c4b751bcdfed7c8a27306778a758523658,1,4,0,4,2,2013-08-06 15:56:01,2013-04-18 20:04:00
709cd2c4b751bcdfed7c8a27306778a758523658...d53e574676ba0809394017f1f3a5bc24512e5bed,2,10,1,11,3,2013-08-06 17:41:52,2013-08-06 16:38:31
d53e574676ba0809394017f1f3a5bc24512e5bed...c7739e30b20f55c2b055b12a628bfb5c2228ba4e,2,28,5,33,6,2013-08-07 09:53:33,2013-08-07 09:38:30
095643e69145d6899313c518fdd39919c9a89908...2fbf9497609168c93aa35691f06bcc4edaa86d77,1,1,1,2,1,2013-08-28 10:35:46,2013-08-28 10:35:46
e70170c2cbc8871f3bc1f585601b831eef0be9dc...6a64822bf4632707212314a25a843c862bdb3874,2,9,2,11,4,2012-10-22 20:52:36,2012-10-22 20:52:36
e70170c2cbc8871f3bc1f585601b831eef0be9dc...4cceb5cb31bb6d36da58672629e8e07b023a857f,1,5,5,10,1,2012-10-22 17:23:19,2012-10-22 17:23:19
0d1653395bc8b88bc6db3fb4d70a09cb6520ae4e...527f967ec1e8d463d8f950549d7f5c9b4a4ffc7b,1,29,7,36,7,2012-08-18 08:39:33,2012-08-18 08:37:06
527f967ec1e8d463d8f950549d7f5c9b4a4ffc7b...4c1286cf78d03fb7df03774f5f4beb9756ec29c0,4,6,4,10,5,2012-08-18 08:56:56,2012-08-18 08:56:56
4c1286cf78d03fb7df03774f5f4beb9756ec29c0...c03cf0b096c241d9b8c83d775355625d2d8a8e86,1,4,4,8,4,2012-08-18 09:02:28,2012-08-18 08:59:10
c03cf0b096c241d9b8c83d775355625d2d8a8e86...f34de7dd6eb7852c272ab2ecc102aa6f06c1d5aa,1,2,0,2,1,2012-08-18 09:02:38,2012-08-18 09:02:38
f34de7dd6eb7852c272ab2ecc102aa6f06c1d5aa...2284419a2c7b5da643e53754e3bf82637b52017b,1,1,1,2,1,2012-08-18 09:15:05,2012-08-18 09:15:05
2284419a2c7b5da643e53754e3bf82637b52017b...85e7a5e140104e7402ba51c313c9e53cb60d96f2,3,13,6,19,5,2012-08-18 09:36:09,2012-08-18 09:30:48
85e7a5e140104e7402ba51c313c9e53cb60d96f2...16ab519f62f4418a8cff143ea92e642ae89bb2cf,1,1,2,3,1,2012-08-18 09:55:36,2012-08-18 09:55:36
20661d2f0d093e9d990b6838d227eb44c4ed2c78...1fe90b281baa1601e4582fd9454b92740e527d89,1,1,1,2,1,2013-03-19 17:35:10,2013-03-19 17:35:10
31308b3195b84bf6dfa14416db27ba5c1e91e3ad...eb03fe164277b3d7a2ff856415457176d6a2ee51,3,100,1,101,4,2013-01-31 19:41:57,2013-01-31 19:34:36
eb03fe164277b3d7a2ff856415457176d6a2ee51...3c0a81aaf0a4ba675f80d50c788aea706d0c812c,2,2,5,7,2,2013-01-31 19:41:57,2013-01-31 19:40:53
3c0a81aaf0a4ba675f80d50c788aea706d0c812c...7bbd17bf20e46283954aead2750c24642fd8d9f9,3,9,6,15,6,2013-01-31 19:55:00,2013-01-31 19:55:00
7bbd17bf20e46283954aead2750c24642fd8d9f9...b757e7ae183e30e52e809d7f347f15285dd3d9fd,1,3,2,5,3,2013-01-31 21:21:24,2013-01-31 21:21:24
b757e7ae183e30e52e809d7f347f15285dd3d9fd...339944491ce06be8e1a8e7f2027261c90d1f166b,2,53,59,112,14,2013-02-01 08:16:29,2013-02-01 01:00:25
339944491ce06be8e1a8e7f2027261c90d1f166b...8eb84081ada2a1a71ca701c8d3f0db0d4c61ae28,1,2,0,2,1,2013-02-01 08:34:39,2013-02-01 08:34:39
8eb84081ada2a1a71ca701c8d3f0db0d4c61ae28...56e553129f554f83c8e99ef3368544921dbd8a82,1,7,2,9,1,2013-02-01 08:55:19,2013-02-01 08:55:19
56e553129f554f83c8e99ef3368544921dbd8a82...393c268e725f5b229ecb554f3fac02cfc250d2df,4,38,12,50,11,2013-02-01 10:55:05,2013-02-01 02:36:34
393c268e725f5b229ecb554f3fac02cfc250d2df...a0c67c69bf49d9e1902afd57d95b8511aa911ccb,1,15,2,17,3,2013-02-01 12:42:30,2013-02-01 12:42:30
a0c67c69bf49d9e1902afd57d95b8511aa911ccb...ab51dff83d100af6ef026cab8cb75134e28296eb,2,17,1,18,3,2013-02-01 19:52:27,2013-02-01 19:52:27
f5e4a699ca0f58818acbdf9081164060cee910fa...b8061397eac019f42f875b6fff99b26a6dfdf229,38,38,0,38,38,2013-02-15 08:02:44,2013-02-14 22:25:15
f5e4a699ca0f58818acbdf9081164060cee910fa...7d5e35cdb46124e2471833b9570add1a00a1d9e0,2,18,1,19,3,2013-02-15 07:29:15,2013-02-15 07:29:15
4506ae0497d388f8bc118b9f6f916a5da48d599a...0a8402eb052a5c35085baa5408aaf4ee36ebc0a6,8,102,2,104,12,2013-02-24 14:33:20,2013-02-24 14:00:34
0a8402eb052a5c35085baa5408aaf4ee36ebc0a6...c35f2e67c1d9d25ea5413a7db820ec7dcde3c39b,1,4,0,4,1,2013-02-24 14:33:20,2013-02-24 14:32:52
c35f2e67c1d9d25ea5413a7db820ec7dcde3c39b...a5733fcd7be7adb8b236825beff4ccda19900f9e,1,1,1,2,1,2013-02-24 14:45:53,2013-02-24 14:44:50
a5733fcd7be7adb8b236825beff4ccda19900f9e...8503120c1024ad7ec2151196a743d6daec21334b,2,42,9,51,7,2013-02-24 15:06:55,2013-02-23 12:13:44
ebcf6b36ffa7ee20b7219d34200b093186befcb4...54fbe6ce5f758d63213ef571f175978823881834,1,2,2,4,2,2012-11-13 21:51:50,2012-11-13 21:51:50
f758bdab5eec3e615598948dd5bcf9bb7b910c9d...50837434dbafe7d542aa4bd499f50314b1bac36f,2,13,12,25,3,2012-07-25 01:44:28,2012-07-25 01:44:28
50837434dbafe7d542aa4bd499f50314b1bac36f...ace9ccfe9f6b987861404fdf08d22a5663953713,1,1,1,2,1,2012-07-25 02:03:26,2012-07-25 02:03:26
f758bdab5eec3e615598948dd5bcf9bb7b910c9d...487b92a13ca88cff7297fec57848a166094d5711,1,1,1,2,1,2012-07-24 23:21:15,2012-07-23 03:12:36
487b92a13ca88cff7297fec57848a166094d5711...f1128e54746ca211254f4f6b0a37809812957b3e,1,1,1,2,1,2012-07-24 23:21:16,2012-07-24 23:17:27
6e70f47d02a9c5d32c0d3e88cdd6f0f93458e7ca...ab680725bfb2f0d79cff26331b30a3d583c55a80,1,1,0,1,1,2013-08-10 22:08:05,2013-08-10 22:08:05
ab680725bfb2f0d79cff26331b30a3d583c55a80...6bdb3b1135d1bd7b2dc24131b9d26ac19ebdba67,6,50,2,52,7,2013-08-12 11:15:59,2013-05-13 11:38:53
6bdb3b1135d1bd7b2dc24131b9d26ac19ebdba67...71b5617c24bb997db294480f07611233069e3359,2,14,2,16,4,2013-08-12 16:41:39,2013-08-12 16:41:39
71b5617c24bb997db294480f07611233069e3359...3f6cc33cffa5774beedf7997354fc269497a93dd,10,373,4,377,12,2013-08-12 18:05:25,2013-08-12 17:20:58
3f6cc33cffa5774beedf7997354fc269497a93dd...6c12cd15e990b0ff5a5e85328f0a092f4bfe8080,4,28,3,31,7,2013-08-13 00:59:27,2012-10-20 12:50:44
6c12cd15e990b0ff5a5e85328f0a092f4bfe8080...dcdc579d162b750ee3449e34efd772703592faca,4,113,71,184,21,2013-08-13 11:11:52,2013-08-13 11:11:52
dcdc579d162b750ee3449e34efd772703592faca...163a34ce4bc1086b346a52c7271f48d2c207f710,4,47,6,53,7,2013-08-13 12:14:11,2013-08-12 11:30:38
58e4fe464cadeaab53b08511dceb5b0e2b82ebd1...8442268869a691767788bcbb4df90ddb28abb8f2,1,2,0,2,1,2013-08-08 18:13:52,2013-08-08 18:13:39
c7739e30b20f55c2b055b12a628bfb5c2228ba4e...8a160d5de1763614ab1a86107e779b0afd151ade,1,1,2,3,1,2013-08-07 11:00:39,2013-08-07 11:00:39
5b889b2408eeaf72f45d8f97c114d8ba9f540726...b89c2a5d9eb70ca36629ef657c98e3371e9a5c4f,2,34,1,35,4,2013-08-28 11:51:45,2013-08-23 15:49:42
b89c2a5d9eb70ca36629ef657c98e3371e9a5c4f...da800be6ddfdd4c88b48011ef264ea1ec6365725,4,98,6,104,13,2013-08-28 13:39:26,2013-08-28 06:22:47
da800be6ddfdd4c88b48011ef264ea1ec6365725...12023887ea3e495e070b1f624078612776edf9be,1,3,3,6,3,2013-08-28 13:48:47,2013-08-28 13:48:47
12023887ea3e495e070b1f624078612776edf9be...112799e9a870c4f93e79f182eb450b092fefa638,1,2,1,3,1,2013-08-28 14:54:13,2013-08-28 14:54:13
112799e9a870c4f93e79f182eb450b092fefa638...169637649baa012a8a77b17465c5c0c1085336ea,1,3,2,5,1,2013-08-29 06:39:06,2013-08-29 06:35:17
169637649baa012a8a77b17465c5c0c1085336ea...5cdacbda034af928f5033c9afc7b50ee0b13f75c,4,27,2,29,4,2013-08-29 07:22:24,2013-08-28 12:17:20
5cdacbda034af928f5033c9afc7b50ee0b13f75c...8d473b2c54035cbcd3aacef0cb83a9769cd05ad3,2,12,1,13,3,2013-08-29 07:25:56,2013-08-29 04:08:01
8d473b2c54035cbcd3aacef0cb83a9769cd05ad3...cf8d6e910839238ee9b2d0a094d98cb8d48dc530,3,11,7,18,4,2013-08-29 10:36:35,2013-08-29 00:03:21
cf8d6e910839238ee9b2d0a094d98cb8d48dc530...af953c45cc56df28d02675e196eca1b54ce28a43,4,26,5,31,8,2013-08-29 13:39:31,2013-08-29 13:39:31
af953c45cc56df28d02675e196eca1b54ce28a43...f19a3669b87641d7882491c3590d3c1c79756197,2,19,0,19,2,2013-08-29 15:13:34,2013-08-29 15:09:58
f19a3669b87641d7882491c3590d3c1c79756197...c7d0ff0cad24dbf444f2e4b534377c3352c7aa98,23,38,38,76,35,2013-08-29 16:11:03,2013-08-29 16:09:35
c7d0ff0cad24dbf444f2e4b534377c3352c7aa98...d72f83c410be9e04e5168bbcce60c1719e3b9fa8,1,13,13,26,8,2013-08-29 16:48:59,2013-08-29 16:48:22
d72f83c410be9e04e5168bbcce60c1719e3b9fa8...be48c6c19915f78f1378dba8b0c6c41ab8e8ab59,1,11,0,11,1,2013-08-29 18:15:58,2013-08-29 18:15:58
be48c6c19915f78f1378dba8b0c6c41ab8e8ab59...50d25a9c5a140e533a57ce21427aa9b1666a85d1,1,1,1,2,1,2013-08-29 18:22:04,2013-08-29 18:22:04
50d25a9c5a140e533a57ce21427aa9b1666a85d1...36bbe3b7c52d459ed4862bbad1b44541a58cda00,1,9,4,13,4,2013-08-29 18:50:55,2013-08-29 18:50:55
36bbe3b7c52d459ed4862bbad1b44541a58cda00...13be3bfef1441f9f3c9eb3cad21b5ae158fdb874,1,0,2,2,1,2013-08-30 06:45:32,2013-08-30 06:44:56
13be3bfef1441f9f3c9eb3cad21b5ae158fdb874...e973ee6a9879969b8ae05bb7ff681172cc5386a5,7,130,16,146,15,2013-08-30 06:41:07,2013-08-30 06:41:07
e973ee6a9879969b8ae05bb7ff681172cc5386a5...e2f06226ea4a38377cdb69f2f5768e4e00c2d88e,4,56,38,94,10,2013-08-30 07:36:36,2013-08-29 08:58:56
e2f06226ea4a38377cdb69f2f5768e4e00c2d88e...e4a67fd90626ced92a61f38ef682d2aa4f34a3ff,1,1,1,2,1,2013-08-30 10:03:39,2013-08-30 10:02:23
e4a67fd90626ced92a61f38ef682d2aa4f34a3ff...11cd7388f77aa9d12ab6b57285c3801b237e241b,75,163,163,326,138,2013-08-30 14:57:51,2013-08-29 23:20:00
11cd7388f77aa9d12ab6b57285c3801b237e241b...b04f8ddbaa57daaefee9eacbab1eaad437d8ff0a,1,9,15,24,8,2013-08-30 19:28:21,2013-08-30 19:28:21
b04f8ddbaa57daaefee9eacbab1eaad437d8ff0a...7211741fc5d50425133ab942181cc095c56d7387,3,22,16,38,7,2013-08-30 23:43:10,2013-08-30 03:44:37
7211741fc5d50425133ab942181cc095c56d7387...a89c856a7aadc830951342a1fa49c1a1b5ac9156,1,2,2,4,2,2013-08-31 01:05:36,2013-08-31 01:05:36
a89c856a7aadc830951342a1fa49c1a1b5ac9156...e87997dd3340bd0914854cce0ce0e3e03b31db4d,1,2,2,4,2,2013-08-31 08:33:14,2013-08-31 08:32:58
e87997dd3340bd0914854cce0ce0e3e03b31db4d...9885f077570cad5af48623ad5dff88c3b7425aa8,1,19,17,36,2,2013-08-31 11:59:53,2013-08-31 11:55:45
9885f077570cad5af48623ad5dff88c3b7425aa8...3e34005b1b4a9a447e3b3fd76e71f0c73d530414,2,28,0,28,2,2013-08-31 13:18:01,2013-08-31 13:05:17
3e34005b1b4a9a447e3b3fd76e71f0c73d530414...e0643cb676d2b7f3219c9bf6ac2c2f990eee6899,1,50,45,95,4,2013-08-31 13:23:56,2013-08-31 13:23:56
e0643cb676d2b7f3219c9bf6ac2c2f990eee6899...e909ceae9b3e72b72e0a2baaa92bba9714f18cd2,9,286,33,319,25,2013-08-31 14:02:32,2013-06-01 17:24:46
e909ceae9b3e72b72e0a2baaa92bba9714f18cd2...92a710cd03fc2248d2ca048ddf3c0334d0089068,1,2,2,4,2,2013-08-31 15:14:52,2013-08-31 15:14:52
92a710cd03fc2248d2ca048ddf3c0334d0089068...1c0c879be3a21affec3d5eb2d6b6e4f0a0803aec,2,8,16,24,2,2013-08-31 19:19:22,2013-08-31 19:04:53
1c0c879be3a21affec3d5eb2d6b6e4f0a0803aec...ff9e1161984f43f34f9ecff5ee80959016447cf3,2,7,0,7,4,2013-09-01 00:26:44,2013-08-31 19:11:37
ff9e1161984f43f34f9ecff5ee80959016447cf3...17d898dedd52db947a1b78383890d8a4c92ab6c2,1,1,1,2,1,2013-09-01 12:58:33,2013-09-01 12:58:33
17d898dedd52db947a1b78383890d8a4c92ab6c2...c01cd4c4234368b050cb872defe5f16597db4bdb,1,5,17,22,2,2013-09-01 13:47:35,2013-09-01 13:47:35
c01cd4c4234368b050cb872defe5f16597db4bdb...41feab3654ace895d3528493b3e14bd40113839f,1,19,21,40,2,2013-09-01 18:07:08,2013-09-01 18:02:30
41feab3654ace895d3528493b3e14bd40113839f...4292097078279226cb725c2921011fb14634b9af,1,189,16,205,19,2013-09-02 10:07:03,2013-09-02 09:39:37
4292097078279226cb725c2921011fb14634b9af...365c3e8b73eab825a8ecd0cf8046e1a0824ccd45,27,47,49,96,46,2013-09-02 10:11:02,2013-09-02 10:06:32
365c3e8b73eab825a8ecd0cf8046e1a0824ccd45...868b4c921c3c129085842aafc1857fccdd04f529,3,3,15,18,5,2013-09-02 10:11:16,2013-09-02 10:10:03
868b4c921c3c129085842aafc1857fccdd04f529...102f26c92923d0e5e80de9b473f2343f76b04aa8,4,53,22,75,14,2013-09-02 11:32:00,2013-08-30 08:48:36
102f26c92923d0e5e80de9b473f2343f76b04aa8...973502c04704aac4742e2d996cb758acd5035d46,1,12,11,23,4,2013-09-02 12:15:04,2013-09-02 12:15:04
973502c04704aac4742e2d996cb758acd5035d46...6ecbac21a9017a53fe18ac81c9c1d2f28185a292,2,10,1,11,2,2013-09-03 07:05:01,2013-09-03 07:05:01
6ecbac21a9017a53fe18ac81c9c1d2f28185a292...b6889c68d7af2e3b8efa01f7050c068afe015080,3,11,4,15,3,2013-09-03 08:02:55,2013-09-03 08:01:13
b6889c68d7af2e3b8efa01f7050c068afe015080...3baf1d10429ae4ab503e0b96daeb88cfb860e54c,2,22,5,27,4,2013-09-03 11:48:03,2013-09-03 11:48:03
3baf1d10429ae4ab503e0b96daeb88cfb860e54c...3550b27a89f7d5df5f05e58dc34e5e574e479386,1,9,4,13,2,2013-09-03 11:53:35,2013-09-03 11:49:42
3550b27a89f7d5df5f05e58dc34e5e574e479386...dd656073ad80d0e8ec9e9dfea30da75a660d759c,3,20,12,32,5,2013-09-03 11:53:35,2013-09-03 11:51:55
dd656073ad80d0e8ec9e9dfea30da75a660d759c...7b04038a7f4b291bc05124c4b5300001dc94e13f,3,61,13,74,8,2013-09-03 12:59:08,2013-09-01 04:04:32
7b04038a7f4b291bc05124c4b5300001dc94e13f...ec784c486bd8368fed25b1ad7a4328baaa2bcc74,1,3,1,4,3,2013-09-03 13:48:46,2013-09-03 13:48:46
ec784c486bd8368fed25b1ad7a4328baaa2bcc74...2fd03b39ab008a8607345dc5b769d5b02729bf23,2,6,6,12,7,2013-09-03 13:55:21,2013-09-03 13:55:21
2fd03b39ab008a8607345dc5b769d5b02729bf23...86964a7b4f32bb19267b42d0d530f54de0fb1347,1,10,2,12,1,2013-09-03 15:10:43,2013-09-03 15:10:43
86964a7b4f32bb19267b42d0d530f54de0fb1347...8f7f8bf6884ada8622bc3696c7465c904164d314,1,2,3,5,1,2013-09-03 15:50:34,2013-09-03 15:50:34
8f7f8bf6884ada8622bc3696c7465c904164d314...3db66b1d65c12a94476017cbcc86e72fd842d29e,13,46,57,103,34,2013-09-03 15:51:34,2013-09-03 15:51:34
3db66b1d65c12a94476017cbcc86e72fd842d29e...cb98ffe8f45d77a7e892fbb80b47de999062dc74,2,6,4,10,3,2013-09-03 17:37:27,2013-09-03 17:37:27
cb98ffe8f45d77a7e892fbb80b47de999062dc74...5649c0af9d90ba1368abbe6c233ee61c976c8137,20,64,60,124,41,2013-09-03 18:22:21,2013-09-03 18:22:21
5649c0af9d90ba1368abbe6c233ee61c976c8137...1ccdc08189fd509ba87a4d916173baff7b2642a5,1,89,76,165,35,2013-09-04 16:32:05,2013-08-21 17:53:38
1ccdc08189fd509ba87a4d916173baff7b2642a5...533d1ab334219d1c0d7791f94d71df771ef8ce76,1,3,0,3,1,2013-09-04 17:18:08,2013-09-04 17:18:08
533d1ab334219d1c0d7791f94d71df771ef8ce76...34d52fd32ed6192daa37e3fc1303cc5661130bad,2,20,1,21,2,2013-09-04 18:05:59,2013-08-31 21:18:44
11a4b6d9239471b3675900f3019f698a98acf590...ea57112d531dfc6d2be50f47ee89f3a06f8ff1a8,2,2,9,11,4,2012-10-22 22:11:17,2012-10-22 22:08:56
ea57112d531dfc6d2be50f47ee89f3a06f8ff1a8...3541a10d492db6d1f509f3a50a024568c16c5229,2,16,3,19,5,2012-10-23 00:49:08,2012-10-23 00:13:59
3541a10d492db6d1f509f3a50a024568c16c5229...9fd2f9c5f3c008f524874fd7cf78237e65bf567e,2,21,8,29,9,2012-10-23 16:49:22,2012-10-23 16:48:24
9fd2f9c5f3c008f524874fd7cf78237e65bf567e...c736a1a9f8f1b70adcbbce8a098fa7c0c4062785,1,1,1,2,1,2012-10-24 14:21:30,2012-10-24 14:20:07
c736a1a9f8f1b70adcbbce8a098fa7c0c4062785...83041ca8025425530fcd32b50f247077ac0a5b74,1,6,6,12,5,2012-10-24 14:52:21,2012-10-23 19:34:58
83041ca8025425530fcd32b50f247077ac0a5b74...495a8b8107dbd4fb511954bcd2322d125addd94e,5,104,38,142,23,2012-10-24 15:08:37,2012-10-23 20:25:38
495a8b8107dbd4fb511954bcd2322d125addd94e...82b3e6ffcb9d810cc0e3ec27d25f89ce1fd525e0,3,30,4,34,7,2012-10-24 15:19:56,2012-10-24 09:33:56
82b3e6ffcb9d810cc0e3ec27d25f89ce1fd525e0...1b096ad77362441d22c3eb7bfa03e9e221af2236,1,0,5,5,1,2012-10-24 19:49:57,2012-10-24 19:49:57
1b096ad77362441d22c3eb7bfa03e9e221af2236...da958eb2098372c20cc3aaf905777b1a8d3144eb,2,8,0,8,1,2012-10-24 21:43:24,2012-10-24 20:30:23
da958eb2098372c20cc3aaf905777b1a8d3144eb...ce1eb320e59b577a600eb84d7f423a1897be3576,1,6,18,24,2,2012-10-24 22:53:00,2012-10-24 22:53:00
ce1eb320e59b577a600eb84d7f423a1897be3576...da56e1bac6449daef9aeab8d076d2594d9fd5b44,2,32,34,66,9,2012-10-25 06:49:51,2012-10-24 21:41:45
16ab519f62f4418a8cff143ea92e642ae89bb2cf...bfa9fc69bf0afae907af0ba3ef2cab8e10a4fa61,2,14,1,15,2,2012-08-18 11:08:44,2012-08-18 11:00:52
1fe90b281baa1601e4582fd9454b92740e527d89...bc4111ba68e5eede1f68882a16d68441a845e30b,15,60,32,92,30,2013-03-19 22:42:39,2013-03-19 05:04:59
1fe90b281baa1601e4582fd9454b92740e527d89...054ce2aa02c88221ffa5665a4b9a5739cbbd0a39,3,25,3,28,4,2013-03-19 22:30:43,2013-03-19 22:17:31
e0bd93ddd7b9fd8f8fe37e40814c0e00487332ba...d75a54c184ef322fb427972ff86190c8e8cbf481,1,6,6,12,1,2013-02-01 20:48:22,2013-02-01 20:47:50
d75a54c184ef322fb427972ff86190c8e8cbf481...0412b7d28072ddef7dc1d0b363b6c6c88a439be8,2,2,2,4,2,2013-02-01 21:25:29,2013-02-01 21:25:29
0412b7d28072ddef7dc1d0b363b6c6c88a439be8...04141c525d2b5021b8e9d2452582181097a0850d,2,12,3,15,3,2013-02-01 21:53:18,2013-02-01 21:51:08
400fba9ca847c40310491c560c9ce71144deec20...dcf8cd30aed682d42f388c3e8a03098403ef3a16,1,96,112,208,22,2013-02-15 08:37:12,2013-02-15 08:36:07
dcf8cd30aed682d42f388c3e8a03098403ef3a16...02e5909f7ae436dab8e4d13370670c467163b8aa,2,7,4,11,3,2013-02-15 14:44:27,2013-02-15 14:44:27
02e5909f7ae436dab8e4d13370670c467163b8aa...a8d1421dd9d0ada64b9d8a3e96ed0b431c66ac97,1,4,3,7,2,2013-02-15 15:09:31,2013-02-15 15:09:31
a8d1421dd9d0ada64b9d8a3e96ed0b431c66ac97...b19d83fc12ebbabbaa9d72286f2e4bfa071ff784,2,32,12,44,5,2013-02-15 15:37:52,2013-02-15 15:37:52
b19d83fc12ebbabbaa9d72286f2e4bfa071ff784...35185495e3f70f900b542bf95d744f51e5c5cb92,1,2,0,2,1,2013-02-15 16:12:14,2013-02-15 16:12:14
35185495e3f70f900b542bf95d744f51e5c5cb92...87854b0bdf354059f949350a4d63a0ed071d564c,1,1,1,2,1,2013-02-15 19:13:36,2013-02-15 19:11:46
87854b0bdf354059f949350a4d63a0ed071d564c...91c26eadc9b4efa5399ec0f6c84b56a3f8eb84f4,1,4,2,6,2,2013-02-16 02:21:05,2013-02-16 02:21:05
91c26eadc9b4efa5399ec0f6c84b56a3f8eb84f4...e74e207cce54802f897adcb42149440ee154821e,51,1035,294,1329,245,2013-02-16 08:19:04,2013-02-10 15:15:49
8503120c1024ad7ec2151196a743d6daec21334b...b7ba4fc408c43ecee385d2ca3582697ec54ac8a6,3,13,3,16,6,2013-02-24 16:50:23,2013-02-24 16:31:26
8503120c1024ad7ec2151196a743d6daec21334b...6d8f59dab9caef8ab5c7d15d7ae848eceb041b9d,1,1,1,2,1,2013-02-24 16:02:10,2013-02-24 16:02:10
8503120c1024ad7ec2151196a743d6daec21334b...d5462596478992075fd04705fedd6a3cca49fae8,2,10,0,10,2,2013-02-24 15:55:38,2013-02-24 14:43:56
8503120c1024ad7ec2151196a743d6daec21334b...636c45fc58bcc19d7669a739ccd05ff475381f48,2,15,2,17,4,2013-02-24 15:49:28,2013-02-24 15:49:28
c91a12716ddf820d5248b4b09ec078d00ea4aa37...1e34fd3c03e8f9a9e2b9be35488b8209178a4df0,1,1,1,2,1,2012-11-13 22:48:23,2012-11-13 22:48:23
1e34fd3c03e8f9a9e2b9be35488b8209178a4df0...1620c27936718a87bbc8acce7886ef20fee2b3fe,2,17,5,22,7,2012-11-14 09:43:33,2012-11-14 09:39:58
1620c27936718a87bbc8acce7886ef20fee2b3fe...550ddc66b496473c8ee282c7ab6be5885a359d75,2,6,1,7,2,2012-11-14 09:50:15,2012-11-14 09:50:15
550ddc66b496473c8ee282c7ab6be5885a359d75...2dbfa66f4db54c2bbac0f160de96a91fcf39997d,1,0,5,5,1,2012-11-14 10:46:30,2012-11-14 10:46:30
2dbfa66f4db54c2bbac0f160de96a91fcf39997d...92d7f541da8b59520c833b19fbba52d3ecef2428,4,17,23,40,4,2012-11-15 14:08:06,2012-11-15 12:23:02
92d7f541da8b59520c833b19fbba52d3ecef2428...f51e409a5fb34020e170494320a421503689aea0,5,203,43,246,30,2012-11-15 15:15:21,2012-11-09 18:21:46
f51e409a5fb34020e170494320a421503689aea0...71e14cf3aa024496adcb23e83ddf13a7c5ddeb32,1,10,15,25,5,2012-11-15 15:31:08,2012-06-08 12:57:42
71e14cf3aa024496adcb23e83ddf13a7c5ddeb32...1194a9699932088385f9f88869be28a251597f45,1,4,0,4,1,2012-11-15 18:17:57,2012-11-15 18:17:57
1194a9699932088385f9f88869be28a251597f45...7cfb567e457379f52a80fe0e8d98dd8191391c6e,1,2,2,4,2,2012-11-15 19:33:56,2012-11-15 19:33:56
ace9ccfe9f6b987861404fdf08d22a5663953713...82292141a07b9860add18c42b50ad98610a8250d,1,3,0,3,1,2012-07-25 08:00:23,2012-07-25 07:57:00
82292141a07b9860add18c42b50ad98610a8250d...942818e1b35aefd382f45f1b4552ea250f5e1090,1,1,0,1,1,2012-07-25 08:16:35,2012-07-25 08:16:35
ace9ccfe9f6b987861404fdf08d22a5663953713...c3a05d8794ea79aa7321ba8d1a36423a7d202d60,1,1,1,2,1,2012-07-25 02:55:08,2012-07-25 02:55:08
737b53ab9a01f9e3cc59265cb017a8792f80adf5...09a5f5aabe27f63ec8d8982efa6cef9bf7b86022,1,3,3,6,3,2013-08-13 12:37:08,2013-08-13 12:30:02
09a5f5aabe27f63ec8d8982efa6cef9bf7b86022...ae3535169af804352517b7fea94a42a1c9c4b762,2,10,5,15,6,2013-08-13 16:06:22,2013-08-13 16:06:22
ae3535169af804352517b7fea94a42a1c9c4b762...cbe6d5568f4f5053ed7228ca3c3d0cce77cf9560,2,15,9,24,6,2013-08-13 16:06:41,2013-08-13 16:06:41
cbe6d5568f4f5053ed7228ca3c3d0cce77cf9560...db682dcc9e028fa40bb4d3efb322fd3191ed1bd2,3,95,0,95,4,2013-08-13 16:16:30,2013-08-13 16:16:30
db682dcc9e028fa40bb4d3efb322fd3191ed1bd2...907ef9d0d157c47c66bf265dca93a0bee8664ea3,5,75,32,107,17,2013-08-13 17:23:05,2013-06-04 20:41:49
907ef9d0d157c47c66bf265dca93a0bee8664ea3...4e50e4065489f06d72eed8ce2d9ae98639be5a93,1,20,21,41,21,2013-08-13 20:22:46,2013-08-13 20:22:46
4e50e4065489f06d72eed8ce2d9ae98639be5a93...4eeb8ec147022d3a7360d9fa78d3cd1c76accfb1,2,27,37,64,27,2013-08-13 23:08:13,2013-08-05 15:07:12
4eeb8ec147022d3a7360d9fa78d3cd1c76accfb1...71c491972eecae8783cf46e69fac7e5f9f83fc59,5,38,4,42,9,2013-08-14 11:46:11,2013-08-10 08:13:41
71c491972eecae8783cf46e69fac7e5f9f83fc59...ff410565bf1cf1a2905c1ef83db408d455211446,5,47,7,54,11,2013-08-14 16:40:19,2013-08-14 14:14:32
ff410565bf1cf1a2905c1ef83db408d455211446...b6178fa24be8a628cb002afe6a80db6391bb67d8,2,10,5,15,6,2013-08-14 16:57:55,2013-08-14 16:57:55
b6178fa24be8a628cb002afe6a80db6391bb67d8...354009d67eb56301457ec26c1c847af5fdfc083b,2,9,11,20,3,2013-08-14 23:27:16,2013-08-14 23:27:16
354009d67eb56301457ec26c1c847af5fdfc083b...29255fcb4f5f50334cda9546ada2f31e825deec3,12,19,17,36,15,2013-08-15 11:14:10,2013-08-15 11:14:10
29255fcb4f5f50334cda9546ada2f31e825deec3...bc5716fc9ce517c6aaa2b78f311724a335488924,1,2,0,2,1,2013-08-15 11:41:18,2013-02-26 19:12:27
8442268869a691767788bcbb4df90ddb28abb8f2...f8a6a4eba1b52dd634ab3e72637cd47412dcfa6e,4,42,14,56,8,2013-08-09 10:51:58,2013-08-09 10:31:17
db0779dbe1da8cff96f8fc9e92ce269a5cf1c1c1...5737c57d95cc8c17b1aa2da4809f70ad4c212716,1,5,1,6,3,2013-08-09 20:02:05,2013-08-09 20:02:05
5737c57d95cc8c17b1aa2da4809f70ad4c212716...00d23a13ebaf6057d1428e798bfb6cf47bb5ef7c,4,70,2,72,7,2013-08-10 14:10:18,2013-08-07 16:03:31
00d23a13ebaf6057d1428e798bfb6cf47bb5ef7c...cb92e3391b0560bc3d519f066185522316b4533f,1,6,2,8,3,2013-08-10 19:00:22,2013-08-10 18:54:22
cb92e3391b0560bc3d519f066185522316b4533f...22af1394c64b6687e45747ae9f643068b340a867,5,10,0,10,3,2013-08-10 19:32:07,2013-08-10 19:32:07
34d52fd32ed6192daa37e3fc1303cc5661130bad...7b623247e84f1cf47d4cae1500c40954ed8905a5,1,16,16,32,9,2013-09-04 20:21:24,2013-09-04 20:21:24
7b623247e84f1cf47d4cae1500c40954ed8905a5...4170b9f402efa7c3c065b02da32555fca2c631c0,1,7,7,14,7,2013-09-04 21:19:04,2013-09-04 21:17:43
4170b9f402efa7c3c065b02da32555fca2c631c0...ebfe42d018b1268969238a5b90bfb5fe46d0d44f,1,6,0,6,1,2013-09-05 09:47:45,2013-09-05 09:47:45
ebfe42d018b1268969238a5b90bfb5fe46d0d44f...bab039d74c09bfba378b7a9b4a0a6d974e20f792,1,0,6,6,1,2013-09-05 09:49:10,2013-09-05 09:49:10
bab039d74c09bfba378b7a9b4a0a6d974e20f792...7b62b80693d57f4bfd7a2f045bfd5c2f787601f8,1,11,0,11,1,2013-09-05 09:56:03,2013-09-05 09:56:03
7b62b80693d57f4bfd7a2f045bfd5c2f787601f8...eacf060e01617ea5e910e8f8a5805483cd5c60b0,2,12,2,14,2,2013-09-05 12:45:33,2013-09-05 12:43:10
34d52fd32ed6192daa37e3fc1303cc5661130bad...b7af44d474a4394f90248240255d57c3c46e4894,1,5,6,11,2,2013-09-04 19:33:05,2013-09-04 19:33:05
da56e1bac6449daef9aeab8d076d2594d9fd5b44...f64a5ef404cb6fd28e008a01039a3beea2fa8e1b,4,108,13,121,11,2012-10-25 14:16:44,2012-10-10 12:58:39
f64a5ef404cb6fd28e008a01039a3beea2fa8e1b...11b8712cc743b496bdff5fe405a5036734ca67c3,1,5,0,5,1,2012-10-25 14:16:56,2012-10-25 11:51:18
11b8712cc743b496bdff5fe405a5036734ca67c3...7de439f32d5da88f8a5717717a9e152441708a9f,2,12,0,12,2,2012-10-25 14:16:56,2012-10-25 12:27:43
7de439f32d5da88f8a5717717a9e152441708a9f...bd6d9ea87cfa252c2992904897e137bc23da56c3,2,5,3,8,4,2012-10-25 16:13:10,2012-10-25 16:13:10
bd6d9ea87cfa252c2992904897e137bc23da56c3...137fdbeebd83e50d8c24c0b6be091e7d7088ef9a,3,718,9,727,7,2012-10-25 18:59:13,2012-10-25 18:59:13
137fdbeebd83e50d8c24c0b6be091e7d7088ef9a...e8b258895adec3d892ada30722517976b298e420,1,3,3,6,1,2012-10-25 19:03:01,2012-10-25 19:02:22
da56e1bac6449daef9aeab8d076d2594d9fd5b44...502be865c68635d5c31fa3fa58162b48412153ad,2,12,3,15,3,2012-10-25 09:31:14,2012-10-25 09:31:14
502be865c68635d5c31fa3fa58162b48412153ad...f824a951776db86c04aaefc1e7c1c12ffb84c798,2,12,0,12,2,2012-10-25 12:19:53,2012-10-25 12:19:53
f824a951776db86c04aaefc1e7c1c12ffb84c798...5bc6929f9af4d71065bce42578e49354096a7bf4,1,2,0,2,1,2012-11-09 16:15:19,2012-11-09 16:15:19
5bc6929f9af4d71065bce42578e49354096a7bf4...3f2fc2f41abf226913517eb1e655f823f2c5e53a,1,1,1,2,1,2012-11-09 16:16:58,2012-11-09 16:16:58
e41c30801433b30a1805ae8dd2fe79887c6dab0b...547b181046539f548839e42544521503fbe4d821,8,82,54,136,40,2012-08-18 14:04:06,2012-08-18 14:04:06
547b181046539f548839e42544521503fbe4d821...58683e9c82d6e7c5fbb7acef79eef9408b776ab0,8,35,2,37,15,2012-08-18 14:07:21,2012-08-18 13:46:17
58683e9c82d6e7c5fbb7acef79eef9408b776ab0...212b9826bdda5c3c2eb680e6f9c5b046b4172300,7,94,5,99,10,2012-08-18 14:07:21,2012-08-18 12:53:22
212b9826bdda5c3c2eb680e6f9c5b046b4172300...f04bb6d798b07aa5e7c1d99d700fa6ddc7d39e62,3,13,5,18,5,2012-08-18 14:07:21,2012-08-18 11:52:05
f04bb6d798b07aa5e7c1d99d700fa6ddc7d39e62...a120fac65a17137bc8ac710477478474e3f9973e,2,35,1,36,7,2012-08-18 14:38:49,2012-08-18 14:36:55
a120fac65a17137bc8ac710477478474e3f9973e...de3ad8bb2d14ccf878121b96e6e0359dd8b1f9d5,2,8,4,12,6,2012-08-18 14:38:49,2012-08-18 14:38:02
bfa9fc69bf0afae907af0ba3ef2cab8e10a4fa61...b16f8b5fbe4d912daa48b0209dea871b854d8376,1,40,0,40,1,2012-09-17 07:56:43,2012-07-09 07:58:24
7a3409fc645c3e9c839fef08f05ec3bbcd9fb9cb...483e1b807e7a3c9e49fe5fcbf9b1300ef98a381c,1,27,22,49,14,2013-03-19 22:58:54,2013-03-18 22:09:26
483e1b807e7a3c9e49fe5fcbf9b1300ef98a381c...5938e7013ebba3c0fd1257fe4b00f341e1095e0e,1,2,2,4,2,2013-03-20 02:16:48,2013-03-20 02:16:48
5938e7013ebba3c0fd1257fe4b00f341e1095e0e...9a85ad89c20e88340cdba85b8e9f5806c95835db,8,104,1,105,12,2013-03-20 04:02:55,2013-03-18 22:48:47
9a85ad89c20e88340cdba85b8e9f5806c95835db...ccb87f97ada8c846e7d0860d95b619a199af243a,1,3,3,6,4,2013-03-20 09:21:40,2013-03-20 09:21:40
ccb87f97ada8c846e7d0860d95b619a199af243a...23490a2394bf03e119e4c9a7a09a9ba35edad430,2,2,19,21,4,2013-03-20 09:41:53,2013-03-20 09:41:53
23490a2394bf03e119e4c9a7a09a9ba35edad430...a45d06ca3dc994e48cfce815ab913cc188c4b30f,1,4,0,4,1,2013-03-20 16:00:25,2013-03-20 16:00:25
a45d06ca3dc994e48cfce815ab913cc188c4b30f...a9ee0e2970b5dcff63dce9db6dac9681355fc69d,1,1,0,1,1,2013-03-20 16:08:08,2013-03-20 16:05:43
a9ee0e2970b5dcff63dce9db6dac9681355fc69d...80e68ee2ffb44d90c66b48e2db18ec4e16c025b4,1,16,0,16,1,2013-03-20 22:43:26,2013-03-20 22:38:23
80e68ee2ffb44d90c66b48e2db18ec4e16c025b4...a7960bcb3575fd9fcd5180986ddcdba1caa46dd5,2,66,23,89,13,2013-03-20 22:46:26,2013-03-18 22:06:24
a7960bcb3575fd9fcd5180986ddcdba1caa46dd5...0ff12c28d0ce8d64209d8df1438fd4e98f96e979,1,0,1,1,1,2013-03-20 22:50:48,2013-03-20 22:49:27
0ff12c28d0ce8d64209d8df1438fd4e98f96e979...aaec4f2bd8a63b3dceebad7804c5897e7874833d,3,19,0,19,3,2013-03-20 23:20:57,2013-03-18 21:22:26
aaec4f2bd8a63b3dceebad7804c5897e7874833d...f9ab543720532400e8b0d490cdbe67ea09ae9c17,12,210,47,257,40,2013-03-21 08:27:24,2013-03-21 06:27:06
e74e207cce54802f897adcb42149440ee154821e...976dc07bafbd64f08c78ad6b1a4cbec5be9c85f4,1,0,5,5,1,2013-02-16 19:30:55,2013-02-16 19:30:55
e74e207cce54802f897adcb42149440ee154821e...632361611c6386696dc525ad3aecf065e6ed98ee,2,10,4,14,6,2013-02-16 12:31:13,2013-02-16 12:26:36
e3e0f49ecebeaaa6ed69bcc5e1655688e8321c42...b88bf9f1257080d5dcc08792c8e57118fb183987,1,3,1,4,2,2013-02-24 17:35:08,2013-02-24 17:35:08
b88bf9f1257080d5dcc08792c8e57118fb183987...438ce4ec559152d219a03b50fe840f49dc0e5191,1,12,12,24,6,2013-02-24 20:03:24,2013-02-24 20:03:24
4ae9e83f2b02f560b60bb60e698b3d454f7ee9e8...7e85ee8cd277d004a3b43e15a031fa6d9dc010c8,1,2,0,2,1,2013-02-24 20:12:00,2013-02-24 20:09:45
e369dc28075b4331c125494fe7bd73855d73a0ce...6b03179e126d4df01623dccc162c1579f349e41e,4,52,2,54,5,2013-02-24 16:32:34,2013-01-29 05:28:09
7cfb567e457379f52a80fe0e8d98dd8191391c6e...ff0d3126afbc30ae1aab3a9d352300e59937fe5e,1,2,2,4,2,2012-11-16 13:32:36,2012-11-16 13:25:45
7cfb567e457379f52a80fe0e8d98dd8191391c6e...5e3b99d4cfc50857566688c543866c82ff51dc4d,1,2,2,4,1,2012-11-15 21:53:08,2012-11-15 21:53:08
942818e1b35aefd382f45f1b4552ea250f5e1090...69f4856f23ff61b8816901c1f3369c7d8237d97c,1,1,1,2,1,2012-07-25 08:57:30,2012-07-25 08:57:30
69f4856f23ff61b8816901c1f3369c7d8237d97c...f3c9a16a423c90baaf3804cb050d320741f799a2,1,4,2,6,2,2012-07-25 17:10:40,2012-07-25 17:10:40
942818e1b35aefd382f45f1b4552ea250f5e1090...206c248f1e8be71890d248cc705702a5eda6d0c8,1,1,1,2,1,2012-07-25 08:44:43,2012-07-25 08:44:43
bc5716fc9ce517c6aaa2b78f311724a335488924...55339a76691724109770092976e660ac62358bc5,1,0,9,9,1,2013-08-15 19:24:58,2013-08-15 19:24:58
55339a76691724109770092976e660ac62358bc5...22c6497f990fd12359b759a71abfcbf3f52b2d52,23,111,42,153,40,2013-08-15 23:47:26,2013-08-11 20:19:09
22c6497f990fd12359b759a71abfcbf3f52b2d52...165f44aaaa0b9008f35d8f6a3474db061559ad53,12,249,295,544,73,2013-08-16 18:12:10,2013-08-16 18:12:10
165f44aaaa0b9008f35d8f6a3474db061559ad53...240886183b022055b5a5115916c7c9766ec55c51,2,11,1,12,3,2013-08-16 19:14:29,2013-07-31 20:35:44
240886183b022055b5a5115916c7c9766ec55c51...c2907a6e3d96315027f7313885f3d0212dd19cbe,1,5,4,9,1,2013-08-17 05:55:43,2013-08-17 05:55:43
bc5716fc9ce517c6aaa2b78f311724a335488924...b9ef96e73cf2f2613eb6ca96038ef8c4271ac116,2,21,0,21,3,2013-08-15 18:59:58,2013-08-15 18:59:58
b9ef96e73cf2f2613eb6ca96038ef8c4271ac116...7a698c05b56d7d5e267241dc71c16c403efd2965,1,2,7,9,1,2013-08-18 13:58:55,2013-08-18 13:58:55
4fa2738ff3ff2704140c8bcb6671d76e9f31f776...2ac89012d8ff750ea5443b6f6f347dacb697e059,2,24,0,24,2,2013-08-09 12:08:34,2013-08-07 08:07:16
d70908e9c2fda803181ff53f82bf58eaaec22d3e...a2374bcf476b49441793f1ad213126b07543da54,1,42,57,99,12,2013-09-05 13:51:23,2013-08-22 17:54:26
a2374bcf476b49441793f1ad213126b07543da54...ed9cd4fd8b425ab5010b27aefc7ef6e50d55fb54,4,26,6,32,12,2013-09-05 14:47:58,2013-08-30 04:03:23
ed9cd4fd8b425ab5010b27aefc7ef6e50d55fb54...6a6428a36f221446b17eaf4876e92d3db1781962,31,49,151,200,72,2013-09-05 19:39:23,2013-09-05 19:38:59
6a6428a36f221446b17eaf4876e92d3db1781962...93dd31cadfb5f02352740aac32bc2f6cdf923b48,1,9,0,9,2,2013-09-05 21:52:36,2013-09-05 21:16:50
93dd31cadfb5f02352740aac32bc2f6cdf923b48...4d13cc56de46ccfc89e9f1381ba4f194070bbdb7,13,19,15,34,16,2013-09-06 00:14:58,2013-09-05 22:23:48
4d13cc56de46ccfc89e9f1381ba4f194070bbdb7...82bbb9fe812ac2a575bf1291055093adfb9b8fff,3,9,0,9,3,2013-09-06 12:30:18,2013-09-05 20:51:11
82bbb9fe812ac2a575bf1291055093adfb9b8fff...e1266e50b29540c07a78ab6f544d9a5073ee8a58,5,23,0,23,4,2013-09-06 12:30:19,2013-09-05 20:51:31
e1266e50b29540c07a78ab6f544d9a5073ee8a58...8625c7aab3760d16572792fea23a95e572e28ead,4,54,1,55,5,2013-09-06 13:14:52,2013-08-30 19:08:40
8625c7aab3760d16572792fea23a95e572e28ead...bd8e1a354cb1fde5e5411e3c729a0d179f4eb37b,3,101,8,109,11,2013-09-06 13:51:58,2013-09-01 15:42:43
e8b258895adec3d892ada30722517976b298e420...45c8818503ebda101e7ff0f642c18880dd323669,1,1,1,2,1,2012-10-25 19:49:18,2012-10-25 19:44:48
e8b258895adec3d892ada30722517976b298e420...ed96292833e78c07f7c7bce5e38794a3b9c4201c,2,7,3,10,4,2012-10-25 19:18:06,2012-10-25 19:18:06
ed96292833e78c07f7c7bce5e38794a3b9c4201c...50dfd4b96959e89ea4372b2bba2e411e08ae04c9,1,0,2,2,1,2012-10-25 19:21:02,2012-10-25 19:21:02
50dfd4b96959e89ea4372b2bba2e411e08ae04c9...8b18f0d74be89c302e1f4d8ab79dd07d5a3c09ce,1,3,3,6,1,2012-10-25 19:22:25,2012-10-25 19:22:25
8b18f0d74be89c302e1f4d8ab79dd07d5a3c09ce...d7f8894465f9a5ce6450c0f3965855355c87feae,1,1,1,2,1,2012-10-25 19:30:53,2012-10-25 19:30:53
d7f8894465f9a5ce6450c0f3965855355c87feae...9edec9e75d3fdb7390b30872bc0f849de0251ec4,1,1,1,2,1,2012-10-25 19:49:57,2012-10-25 19:44:48
9edec9e75d3fdb7390b30872bc0f849de0251ec4...6fd321652aba307c86ac0df3c25c920e0e948d1e,1,38,24,62,26,2012-10-25 21:15:52,2012-10-25 21:14:17
6fd321652aba307c86ac0df3c25c920e0e948d1e...efaf07265b1e848aa392e7e88a0599f98c1ceb3d,1,14,14,28,9,2012-10-25 21:24:02,2012-10-25 21:20:55
efaf07265b1e848aa392e7e88a0599f98c1ceb3d...0887211b03c888b522652b73af92d8dd7362ad74,1,2,2,4,1,2012-10-25 21:50:34,2012-10-25 20:26:22
0887211b03c888b522652b73af92d8dd7362ad74...84849723ad374672d22369c9ff98952956136394,2,9,10,19,3,2012-10-25 21:56:30,2012-10-25 10:51:19
84849723ad374672d22369c9ff98952956136394...142f69eb8c79ea5a54799354231b219f7c53b1cc,3,55,2,57,6,2012-10-25 23:34:47,2012-10-25 23:25:59
142f69eb8c79ea5a54799354231b219f7c53b1cc...c426d5665095e7b91df69e54d4773180b12ff548,1,1,1,2,1,2012-10-25 23:55:31,2012-10-25 23:50:25
c426d5665095e7b91df69e54d4773180b12ff548...7b6978553aa8cde493f02ddd93bbd711afbf28ae,1,13,9,22,1,2012-10-26 01:38:15,2012-09-26 19:41:47
7b6978553aa8cde493f02ddd93bbd711afbf28ae...edaacc41124c562961df478be1382773216cac55,1,1,1,2,1,2012-10-26 01:39:39,2012-09-28 15:09:05
edaacc41124c562961df478be1382773216cac55...3deed3239470304a67013b5cdc864a8a2087bacf,4,7,6,13,6,2012-10-26 01:40:05,2012-09-28 17:17:40
3deed3239470304a67013b5cdc864a8a2087bacf...b430e1db5f26d1de3a5cd0d6eae18603070fdab4,1,10,0,10,1,2012-10-26 01:40:19,2012-09-28 19:57:38
b430e1db5f26d1de3a5cd0d6eae18603070fdab4...f02f29dccc6207829f64156f539704125cdce75d,1,8,4,12,1,2012-10-26 01:40:33,2012-10-26 00:25:22
f02f29dccc6207829f64156f539704125cdce75d...0efca2a8198f5e7a702c0fbb38be489a6bd23ef5,1,9,10,19,4,2012-10-26 01:40:51,2012-10-26 01:00:21
0efca2a8198f5e7a702c0fbb38be489a6bd23ef5...f6e2a2b21003a44db997bcd2cb85a36108ff7bb0,1,1,1,2,1,2012-10-26 01:47:30,2012-10-26 01:45:15
f6e2a2b21003a44db997bcd2cb85a36108ff7bb0...02b66f161f3b27e31a93527eac32504125de576a,1,1,1,2,1,2012-10-26 08:26:47,2012-10-26 08:23:33
02b66f161f3b27e31a93527eac32504125de576a...fbb664066f8970279af020cf163cb364156290c3,3,10,1,11,3,2012-10-26 18:48:57,2012-10-26 18:44:00
fbb664066f8970279af020cf163cb364156290c3...1b4b0dc01381d88d5c2e42ed5c91786e82ae1255,1,5,1,6,5,2012-10-26 20:16:00,2012-10-26 20:09:48
1b4b0dc01381d88d5c2e42ed5c91786e82ae1255...d1e59794d1ffa2ad342f5becda84ba2c53ef0ca3,1,6,2,8,2,2012-10-26 20:41:45,2012-10-26 20:40:35
d1e59794d1ffa2ad342f5becda84ba2c53ef0ca3...c902623d507f361dd4359d262d07952f75c008da,1,19,4,23,2,2012-10-26 20:48:35,2012-10-26 20:47:45
c902623d507f361dd4359d262d07952f75c008da...18357bf3acae0c70e4fd3b692efb4db7638cb574,3,19,4,23,6,2012-10-27 16:24:48,2012-10-27 01:51:14
18357bf3acae0c70e4fd3b692efb4db7638cb574...fa1083fb0cfdce0fee4cbbf4d391ddb491223a0f,1,9,2,11,1,2012-10-27 16:25:14,2012-10-27 01:52:12
fa1083fb0cfdce0fee4cbbf4d391ddb491223a0f...7cf2858747e4b1ba4a1f850170332d31291ad24f,1,13,2,15,3,2012-10-27 16:25:53,2012-10-27 15:10:02
7cf2858747e4b1ba4a1f850170332d31291ad24f...15ea36dfc0d5997dfedf9c2fc3ff29fbb7b284a0,1,1,1,2,1,2012-10-27 16:26:33,2012-10-27 15:10:41
15ea36dfc0d5997dfedf9c2fc3ff29fbb7b284a0...b760503a270484679ad0e06b73e3ed417a113221,9,59,11,70,13,2012-10-27 16:38:32,2012-10-27 09:49:46
b760503a270484679ad0e06b73e3ed417a113221...0fe02feab43aa0f0d0608de85cff7183055e6dd7,5,52,15,67,17,2012-10-27 17:41:12,2012-10-27 17:18:03
0fe02feab43aa0f0d0608de85cff7183055e6dd7...d8bd8292155eb7cd6a3099a5dc8b94e2e4e62c8a,1,1,1,2,1,2012-10-27 19:09:52,2012-10-26 12:29:51
d8bd8292155eb7cd6a3099a5dc8b94e2e4e62c8a...cb2817543fed794d27ccc6f15304b735017e1dcd,1,1,1,2,1,2012-10-27 19:20:21,2012-10-27 19:18:48
cb2817543fed794d27ccc6f15304b735017e1dcd...c5da577b9e394b3b4696e4f4ca495c82951b6678,1,17,9,26,1,2012-10-27 20:04:06,2012-10-27 19:55:50
c5da577b9e394b3b4696e4f4ca495c82951b6678...845d8408e7aa09a63c98f160b2c6bc9fa6dbb20f,4,73,26,99,17,2012-10-28 08:20:54,2012-10-27 19:32:50
845d8408e7aa09a63c98f160b2c6bc9fa6dbb20f...e6b0ee768c46368a41a5b278180d1d1ecbd3d5c6,1,5,3,8,6,2012-10-28 08:21:27,2012-10-27 19:59:35
e6b0ee768c46368a41a5b278180d1d1ecbd3d5c6...39082494e62d70be62cde1eb10620548fd62dfb6,9,176,29,205,28,2012-10-28 08:21:56,2012-10-27 21:12:08
39082494e62d70be62cde1eb10620548fd62dfb6...54b45dfb5384e5db24932b0d183b226c990d23ed,2,11,2,13,5,2012-10-28 08:35:04,2012-10-28 08:34:05
54b45dfb5384e5db24932b0d183b226c990d23ed...13b4d44860ebdfa3b5b2a0cb338013aff86ccdf8,1,1,1,2,1,2012-10-28 11:34:24,2012-10-28 11:33:38
13b4d44860ebdfa3b5b2a0cb338013aff86ccdf8...f105fbe52b21da206bfbaedf0e92326667d7b2d4,3,128,15,143,15,2012-10-28 15:34:14,2012-10-28 14:47:07
f105fbe52b21da206bfbaedf0e92326667d7b2d4...780eaa4779c5e6bd6bdc2c34e71aeae5d1b0dbbd,1,10,6,16,7,2012-10-28 17:04:21,2012-10-28 15:42:34
780eaa4779c5e6bd6bdc2c34e71aeae5d1b0dbbd...88393357a6839fb4ce57793523bc25b17dc188a4,1,5,0,5,1,2012-10-28 17:04:50,2012-10-28 15:51:51
88393357a6839fb4ce57793523bc25b17dc188a4...8d7e526229c27567860f7479dbce15d245742feb,1,8,5,13,2,2012-10-28 18:58:12,2012-10-28 18:56:19
8d7e526229c27567860f7479dbce15d245742feb...95f3f0cbbe65cf6eead85f544fc0826e5e6a2ef4,1,2,2,4,2,2012-10-28 21:36:01,2012-10-28 21:35:01
95f3f0cbbe65cf6eead85f544fc0826e5e6a2ef4...b4627bcabe6704c5bd1cbfb2d3a1421e05c29cd7,4,22,8,30,4,2012-10-28 22:46:54,2012-10-28 22:02:41
b4627bcabe6704c5bd1cbfb2d3a1421e05c29cd7...f427ecdc88f71bbd2e8590da514e59c37c453217,5,64,2,66,7,2012-10-29 06:06:09,2012-10-04 17:14:50
f427ecdc88f71bbd2e8590da514e59c37c453217...d7d7ad2881b66d2c6be45ab0b055f492d3b589e9,3,23,3,26,6,2012-10-29 14:41:05,2012-10-29 13:40:32
d7d7ad2881b66d2c6be45ab0b055f492d3b589e9...8c556a32f232ef9e9a3581d7129bd15d4f495d9f,1,4,0,4,2,2012-10-29 16:29:28,2012-10-29 16:26:10
8c556a32f232ef9e9a3581d7129bd15d4f495d9f...04717ee9b1d1f8ccc0f37107f7008662726689c2,1,23,27,50,34,2012-10-29 18:12:12,2012-10-29 18:08:07
04717ee9b1d1f8ccc0f37107f7008662726689c2...a92c7c6e262a4374c9e92162017c2707ed1644c9,1,12,4,16,2,2012-10-29 20:40:10,2012-10-29 20:39:12
a92c7c6e262a4374c9e92162017c2707ed1644c9...322d858abe8d9090a4e1108c734d9bcebe8ecd8a,1,2,1,3,1,2012-10-29 22:13:01,2012-10-29 22:12:20
322d858abe8d9090a4e1108c734d9bcebe8ecd8a...e784b5e594946acabe1fe41c4d4d7fdc17f4a1cb,2,3,0,3,3,2012-10-30 02:27:01,2012-10-30 02:27:01
e784b5e594946acabe1fe41c4d4d7fdc17f4a1cb...402a986c25db9c95a6ba83089e98c5aa92c4da05,2,32,17,49,10,2012-10-30 05:33:46,2012-10-02 16:16:37
402a986c25db9c95a6ba83089e98c5aa92c4da05...e8269a6729150d26a5497d5eb51226ca19fa21b9,3,40,5,45,7,2012-10-30 05:58:36,2012-09-09 20:25:06
e8269a6729150d26a5497d5eb51226ca19fa21b9...3f3076edbf8d6fb204984a1a7fddbde408d5b104,2,39,0,39,5,2012-10-30 08:01:57,2012-10-29 19:33:00
3f3076edbf8d6fb204984a1a7fddbde408d5b104...5229ac20bedea017bfd29e6cb03916715c09cc7f,1,4,1,5,2,2012-10-30 08:31:25,2012-10-30 08:28:19
5229ac20bedea017bfd29e6cb03916715c09cc7f...a24ffa52d02998f5082fbc5a461ccdc8004db4a6,3,19,16,35,7,2012-10-30 21:26:03,2012-10-27 20:38:15
a24ffa52d02998f5082fbc5a461ccdc8004db4a6...2f9f211da867d872a0d3576c3ac515d74f5798cd,3,34,28,62,17,2012-10-30 21:29:09,2012-10-30 21:20:42
2f9f211da867d872a0d3576c3ac515d74f5798cd...9c4ddea8e6cb5bd06b4ba9b53df5fb29f964a8ee,1,5,5,10,5,2012-10-30 22:07:31,2012-10-30 22:05:47
9c4ddea8e6cb5bd06b4ba9b53df5fb29f964a8ee...5c7406b236b641ac1802d1471f04b27166909121,6,388,8,396,13,2012-10-30 22:41:29,2012-10-30 19:53:56
5c7406b236b641ac1802d1471f04b27166909121...0dcaddb57143048c4647047ccbb5574d2ea713a5,6,48,6,54,13,2012-10-31 08:51:19,2012-10-30 20:59:23
0dcaddb57143048c4647047ccbb5574d2ea713a5...f1be2c7a81b6364e353b351919eca588d288d4a4,2,7,2,9,2,2012-10-31 11:01:39,2012-10-31 11:01:39
f1be2c7a81b6364e353b351919eca588d288d4a4...958c1d12e584dfe493697edf1083f99b1a41d1a9,1,17,15,32,7,2012-11-01 00:02:23,2012-10-31 23:56:53
958c1d12e584dfe493697edf1083f99b1a41d1a9...acab68d8a76c8021a9c7c467e83f5843fe5b2f6c,1,5,2,7,1,2012-11-01 12:50:54,2012-11-01 10:58:02
acab68d8a76c8021a9c7c467e83f5843fe5b2f6c...a8c415f8447cafb58315aa9b6e7240d46991f445,1,42,0,42,1,2012-11-01 18:49:08,2012-11-01 18:44:45
a8c415f8447cafb58315aa9b6e7240d46991f445...c5d0f49dc285b0c200ad0d1496914f13d8e6293d,4,40,7,47,8,2012-11-01 22:02:32,2012-11-01 20:11:05
c5d0f49dc285b0c200ad0d1496914f13d8e6293d...71dbc01ad7d768b12e0d5cfeaaf83cc411ad4d50,1,1,1,2,1,2012-11-02 08:30:31,2012-11-02 08:29:55
71dbc01ad7d768b12e0d5cfeaaf83cc411ad4d50...6b1f73113ab4d651362b0a4a72512f99e13eddf1,2,5,5,10,4,2012-11-02 09:52:15,2012-11-02 09:51:10
6b1f73113ab4d651362b0a4a72512f99e13eddf1...ffc649df888ea35d0e6848bf53ee26917fccc27e,2,70,1,71,3,2012-11-02 21:59:51,2012-11-02 10:54:00
ffc649df888ea35d0e6848bf53ee26917fccc27e...a738d80dd1d81addc2cebda5636bb254002acac7,1,4,3,7,1,2012-11-02 22:05:51,2012-11-02 20:15:40
a738d80dd1d81addc2cebda5636bb254002acac7...90af863410cae9d043f5378a7cfdab92a696b562,1,9,0,9,1,2012-11-02 22:20:32,2012-11-02 20:33:07
90af863410cae9d043f5378a7cfdab92a696b562...75fb8f433fc0bc64fed0b8dcc540f7a3544f9aa4,1,23,4,27,2,2012-11-02 22:32:43,2012-11-02 20:48:55
75fb8f433fc0bc64fed0b8dcc540f7a3544f9aa4...0131da06220c1bc7e25df9ea50219e480e5004b3,4,30,14,44,7,2012-11-03 05:03:55,2012-11-02 15:49:29
0131da06220c1bc7e25df9ea50219e480e5004b3...4a9b3826fdfa1d78f640d4fee922005ed8210498,1,34,1,35,3,2012-11-03 09:25:55,2012-11-03 09:22:34
4a9b3826fdfa1d78f640d4fee922005ed8210498...f12fa7750c95cafa3a317be6a62ed3a2f53caf3c,4,65,1,66,5,2012-11-03 10:59:16,2012-07-07 12:24:50
f12fa7750c95cafa3a317be6a62ed3a2f53caf3c...b99707bdedbcbf832bd88eaefd488c841110a222,3,15,2,17,4,2012-11-03 12:07:02,2012-11-03 11:54:06
b99707bdedbcbf832bd88eaefd488c841110a222...4b2fb7efea5379d6d91da4513982debeeb49504b,1,11,0,11,1,2012-11-03 16:19:26,2012-11-03 16:04:53
4b2fb7efea5379d6d91da4513982debeeb49504b...e51a9c0c948855ed8fe7e1a694e17727af604926,1,4,0,4,1,2012-11-03 19:13:18,2012-11-03 19:07:56
e51a9c0c948855ed8fe7e1a694e17727af604926...be6522561f01aa2a0b503fb35f35c9fd34c5110f,2,21,1,22,3,2012-11-03 20:28:49,2012-11-03 20:26:59
be6522561f01aa2a0b503fb35f35c9fd34c5110f...d7688a010a34033a5cc8eecf7b1460169c0e056e,14,61,50,111,40,2012-11-03 21:08:05,2012-11-03 20:43:11
d7688a010a34033a5cc8eecf7b1460169c0e056e...b61778dcf642341c831041ab103ee0545eb8a1e6,1,0,9,9,1,2012-11-03 22:56:04,2012-11-03 22:53:51
b61778dcf642341c831041ab103ee0545eb8a1e6...26e0651c42a70104d237b5433970158d27b244dc,1,9,0,9,1,2012-11-04 10:35:38,2012-11-04 10:32:53
26e0651c42a70104d237b5433970158d27b244dc...6f716e9e5f8f373f48b59791b80f0d68ce9e5bd2,12,121,40,161,27,2012-11-04 18:26:59,2012-11-04 18:16:06
6f716e9e5f8f373f48b59791b80f0d68ce9e5bd2...4f6e9c6af231d955632f64b129d9a2eeaf9a1c68,1,19,19,38,1,2012-11-04 19:18:45,2012-11-04 18:59:43
4f6e9c6af231d955632f64b129d9a2eeaf9a1c68...3bb8c6e1cdc1f400ebef1dc956c771bafd02dafd,1,7,0,7,2,2012-11-04 20:26:23,2012-11-04 20:25:48
3bb8c6e1cdc1f400ebef1dc956c771bafd02dafd...69a0c91c90a3c8f8d5913874aca918aecbe69410,3,34,9,43,4,2012-11-04 22:21:49,2012-11-04 22:20:26
69a0c91c90a3c8f8d5913874aca918aecbe69410...32d5f03f10069311b4f2c87d3cd38e968df74365,2,6,2,8,3,2012-11-04 23:41:58,2012-11-04 23:41:33
778b8bdcf4fb2c7ddbf22ddbe8665001387b21ae...9b755a298a55849bf8e831a46639999609aedfff,5,10,32,42,6,2012-11-17 21:38:19,2012-11-17 21:38:19
9b755a298a55849bf8e831a46639999609aedfff...4585e123187a8a94a0db11d11358398911b10168,1,1,1,2,1,2012-11-17 22:25:37,2012-11-17 22:25:37
4585e123187a8a94a0db11d11358398911b10168...ccb2b574e8ea961f11b1c36bcbdf396cd9acb550,2,15,10,25,5,2012-11-17 22:25:52,2012-11-17 22:25:52
ccb2b574e8ea961f11b1c36bcbdf396cd9acb550...04775b4598d1a9c5bcc0c1da431e368f28dcd13e,1,129,63,192,9,2012-11-17 22:54:09,2012-10-23 11:02:48
04775b4598d1a9c5bcc0c1da431e368f28dcd13e...2564e310141ab0f23b5282ecaec8e820250c355a,1,2,2,4,2,2012-11-18 00:29:31,2012-11-18 00:29:31
de3ad8bb2d14ccf878121b96e6e0359dd8b1f9d5...f29032eac65c076e54e000966602c35239de15ac,1,0,9,9,1,2012-08-18 21:04:08,2012-08-18 21:04:08
de3ad8bb2d14ccf878121b96e6e0359dd8b1f9d5...8d5c11caad7f87d14b486a46890782fa0b66bb74,4,23,5,28,12,2012-08-18 16:03:57,2012-08-18 15:28:17
de3ad8bb2d14ccf878121b96e6e0359dd8b1f9d5...afc1bd7ab87268b33a8b44b3238f562cdaf2a72f,3,11,11,22,5,2012-08-18 15:51:16,2012-08-18 15:47:21
de3ad8bb2d14ccf878121b96e6e0359dd8b1f9d5...abc4038b0b47e41bb2d75a37944bbb1699806922,1,1,3,4,1,2012-08-18 15:17:42,2012-08-18 15:17:42
89e809c4000ba14145e60bf8ea623c1b3e925fd3...b1b32b2074a1aa906ba02fe221bfabef25617026,2,13,0,13,2,2012-09-18 05:02:16,2012-09-18 05:02:16
b1b32b2074a1aa906ba02fe221bfabef25617026...70248cce0a8a3144df9f36e15fbeb5cc1b091c3e,1,16,0,16,1,2012-09-18 05:09:07,2012-09-18 04:27:07
f9ab543720532400e8b0d490cdbe67ea09ae9c17...3be368c73e8e6696e7cc74421aeb4d06d8e828c8,2,18,13,31,14,2013-04-08 11:54:03,2013-04-08 11:54:03
f9ab543720532400e8b0d490cdbe67ea09ae9c17...f7795e968dd07323aa5bd16f9da0e60d97a75d0f,1,4,1,5,1,2013-03-22 10:01:51,2013-03-22 10:01:51
f7795e968dd07323aa5bd16f9da0e60d97a75d0f...829dc3c5a64d3fa203b8cc0055e83cf23addfee3,6,43,6,49,13,2013-03-22 16:31:29,2013-03-20 10:47:56
829dc3c5a64d3fa203b8cc0055e83cf23addfee3...164528acc8752f33a3af4c1255b24702a4c81240,2,8,2,10,3,2013-03-22 16:55:12,2013-03-22 16:55:12
f9ab543720532400e8b0d490cdbe67ea09ae9c17...a907fa088ed822f05526b13fc74487f9056a62cd,1,1,1,2,1,2013-03-21 10:03:28,2013-03-21 10:03:28
a7358586e95016e414d90bccdff4675b1b65bbe3...7a80904b002a1983282c7dfa3ac05046098242ce,1,4,9,13,1,2013-02-16 23:23:39,2013-02-16 23:23:39
7a80904b002a1983282c7dfa3ac05046098242ce...218bbef0c4890b3b853dee945a02215533b923b7,1,2,2,4,1,2013-02-16 23:31:54,2013-02-16 23:31:54
218bbef0c4890b3b853dee945a02215533b923b7...9c2066d567492a4a285c053039f671a2ca4a23d4,1,1,1,2,1,2013-02-17 13:33:29,2013-02-17 13:33:29
9c2066d567492a4a285c053039f671a2ca4a23d4...5ec0405a09c4b05b7ee6c58bf52a06290143d788,2,18,13,31,4,2013-02-18 08:22:25,2013-02-18 08:20:26
5ec0405a09c4b05b7ee6c58bf52a06290143d788...09ca0107689c6219ba311be58134407e49125235,1,5,7,12,2,2013-02-18 10:38:21,2013-02-18 10:38:21
09ca0107689c6219ba311be58134407e49125235...92837ae56999a6f602d22130bfb3c49cd9b40242,3,11,7,18,9,2013-02-18 13:32:45,2013-02-18 13:26:33
92837ae56999a6f602d22130bfb3c49cd9b40242...64d0f89ab1dc6ef8a84814f567050fc063d67de2,1,10,19,29,4,2013-02-18 14:35:22,2013-02-18 14:35:22
64d0f89ab1dc6ef8a84814f567050fc063d67de2...29628e0b6e5b1c6324e0c06cc56a49a5aa0747e0,5,19,40,59,16,2013-02-18 16:19:09,2013-02-18 16:12:42
29628e0b6e5b1c6324e0c06cc56a49a5aa0747e0...aea98e8c5357b15da214af311e8cb74b1503f958,2,0,15,15,3,2013-02-18 20:46:26,2013-02-18 18:06:12
aea98e8c5357b15da214af311e8cb74b1503f958...282b2f40cd0aa09815001e178f60c9e71667d847,2,1,13,14,3,2013-02-18 21:12:19,2013-02-18 18:09:54
282b2f40cd0aa09815001e178f60c9e71667d847...7b8529d206731bab01855a60f4a6f84e4221f2e1,1,5,8,13,2,2013-02-18 21:13:05,2013-02-18 18:11:56
7b8529d206731bab01855a60f4a6f84e4221f2e1...21765c0a6c7cece4d052c8c7af6022ac9c61b7cf,1,4,7,11,4,2013-02-18 21:49:59,2013-02-18 21:49:59
21765c0a6c7cece4d052c8c7af6022ac9c61b7cf...ffcfb19f47f5995406003cffca24cf62c6d234a8,1,12,0,12,1,2013-02-18 21:51:56,2013-02-18 18:31:10
ffcfb19f47f5995406003cffca24cf62c6d234a8...b4492a8ca4a7ae4daa3a6b03c3d7a845fad74931,5,106,77,183,22,2013-02-18 23:10:49,2013-02-17 23:56:24
b4492a8ca4a7ae4daa3a6b03c3d7a845fad74931...3e71368423b41c9418117328216e66f95cbaab03,2,57,1,58,7,2013-02-18 23:42:02,2013-02-13 17:37:40
3e71368423b41c9418117328216e66f95cbaab03...607772b942010d2b237c95d2ba74c958986def04,1,0,1,1,1,2013-02-18 23:55:40,2013-02-18 23:55:40
607772b942010d2b237c95d2ba74c958986def04...4b9fa49bc0cf5d2e01b6b98dec6d23fed774f254,2,7,7,14,7,2013-02-19 01:13:13,2013-02-19 01:12:37
a8449d436210d19d77a6710f44f44e2d8f924214...ae2a8bb4569e569d0cc2cd8173443862418d3698,1,3,8,11,1,2013-02-24 21:47:14,2013-02-24 21:47:14
ae2a8bb4569e569d0cc2cd8173443862418d3698...5eebb49c690097ec950b4db2a8eaa892c27433c0,1,1,0,1,1,2013-02-24 21:59:15,2013-02-24 21:58:07
5eebb49c690097ec950b4db2a8eaa892c27433c0...7b49da1c3818cb90f95adaa0b18edaef5f088f16,2,20,38,58,5,2013-02-24 23:09:13,2013-02-24 23:09:13
7b49da1c3818cb90f95adaa0b18edaef5f088f16...8f839aaa180fd7bfcbc933998c9d8e7e75ad09aa,1,11,11,22,3,2013-02-25 07:15:11,2013-02-25 07:15:11
8f839aaa180fd7bfcbc933998c9d8e7e75ad09aa...3ded2aef71e35e00e9822a39b3805b31deb0eef5,3,8,8,16,8,2013-02-25 07:33:29,2013-02-25 07:33:29
3ded2aef71e35e00e9822a39b3805b31deb0eef5...87e8dfaa47a07662351a8a8dc9a15c6afef87b88,1,4,2,6,2,2013-02-25 07:43:03,2013-02-25 07:43:03
87e8dfaa47a07662351a8a8dc9a15c6afef87b88...6d52bcbb7cb962e4874a8e7a3d1d8ee77233cd19,1,2,0,2,1,2013-02-25 07:58:11,2013-02-25 07:56:30
ff0d3126afbc30ae1aab3a9d352300e59937fe5e...d8ee46afff913975404887cdd2eec635a03013f8,2,3,3,6,2,2012-11-16 15:19:54,2012-11-12 22:17:05
aa01c99f5587b36c354e80c682ad52e1a3b41455...40909826172374b849ddc9db8e1a8be9a8c3251b,1,3,11,14,1,2013-08-18 16:43:41,2013-08-18 16:43:41
40909826172374b849ddc9db8e1a8be9a8c3251b...4668c142dce77c6f29fb75532c1acfa1b2d322ff,7,60,1,61,7,2013-08-19 06:51:28,2013-08-07 06:51:32
4668c142dce77c6f29fb75532c1acfa1b2d322ff...3844089edc43ff29aab5bac82a0eecab23d8d14a,7,67,8,75,14,2013-08-19 06:51:41,2013-08-15 07:32:54
3844089edc43ff29aab5bac82a0eecab23d8d14a...630b9df42f771e90d9beb1766d4e7aa2107bd82d,1,24,0,24,1,2013-08-19 11:10:03,2013-08-19 11:07:51
630b9df42f771e90d9beb1766d4e7aa2107bd82d...7d28bed13bfd07452fb7bc007544a34f7649a31f,1,36,26,62,19,2013-08-19 11:16:10,2013-08-19 11:16:10
7d28bed13bfd07452fb7bc007544a34f7649a31f...7737305a4f5dc5006d92dac3a61523ad6c2a523a,3,14,7,21,8,2013-08-19 13:00:17,2013-08-19 13:00:17
7737305a4f5dc5006d92dac3a61523ad6c2a523a...7bc57a6d71dd4d00bb09cfa67be547591fd759ce,2,26,1,27,5,2013-08-19 13:15:09,2013-08-19 13:14:31
7bc57a6d71dd4d00bb09cfa67be547591fd759ce...58c6d0209d71872f0682d478921db1e00496e16c,1,10,0,10,1,2013-08-19 13:24:45,2013-08-19 13:24:45
58c6d0209d71872f0682d478921db1e00496e16c...7b69c3e7758770dd632e1754c30714e91868e037,45,65,400,465,112,2013-08-19 13:09:41,2013-08-19 12:29:32
7b69c3e7758770dd632e1754c30714e91868e037...ddeb20e31b3fd362bf8a22a40e61171d66177100,1,2,2,4,2,2013-08-19 13:35:11,2013-08-19 13:34:04
ddeb20e31b3fd362bf8a22a40e61171d66177100...3c0300405009b82b52fd15483371097221662fcd,4,49,11,60,11,2013-08-19 16:01:33,2013-08-17 22:05:13
2ac89012d8ff750ea5443b6f6f347dacb697e059...33fc083b0db392bd35bc9d5d9a141adb25537253,1,2,2,4,2,2013-08-13 11:20:12,2013-08-13 10:38:29
2ac89012d8ff750ea5443b6f6f347dacb697e059...b575d690bbc1c4cd7f575346132c09fca8c736a7,1,17,21,38,2,2013-08-09 12:34:37,2013-08-09 12:34:37
bd8e1a354cb1fde5e5411e3c729a0d179f4eb37b...79cc66692ad282b41a15fba9da9222c3140d4405,13,179,64,243,26,2013-09-06 17:57:25,2013-09-06 17:57:25
bd8e1a354cb1fde5e5411e3c729a0d179f4eb37b...e492ab8e7eb5fc2c1d4a50669aeaa3d6163dc5f3,2,7,1,8,4,2013-09-06 15:28:28,2013-09-06 15:28:28
e492ab8e7eb5fc2c1d4a50669aeaa3d6163dc5f3...b80be68e088f56f5b2ab5371b92a478a14937e8b,1,4,4,8,3,2013-09-06 15:34:32,2013-09-06 15:34:32
b80be68e088f56f5b2ab5371b92a478a14937e8b...32838a5beb29fe4f23fa7881e6535b1b7384d39c,1,10,1,11,2,2013-09-06 15:35:53,2013-09-06 15:35:10
bd8e1a354cb1fde5e5411e3c729a0d179f4eb37b...f0d9b529a995c147c919113738a4c09082087593,1,1,0,1,1,2013-09-06 15:25:33,2013-09-06 15:25:33
45c8818503ebda101e7ff0f642c18880dd323669...1d6b7f302a56fd6064f91d67c26c149c547de57b,1,38,24,62,26,2012-10-25 21:14:17,2012-10-25 21:14:17
1d6b7f302a56fd6064f91d67c26c149c547de57b...48be78cf088e6fca87d1e4da7c527e17305f9fe2,1,14,14,28,9,2012-10-25 21:20:55,2012-10-25 21:20:55
45c8818503ebda101e7ff0f642c18880dd323669...9912a30b062fa62a4a8e7d598942dbf2cf2738af,1,2,2,4,1,2012-10-25 20:26:22,2012-10-25 20:26:22
32d5f03f10069311b4f2c87d3cd38e968df74365...b85cb92ba97a67cd6e0893be05ffbc6c65b4f83f,2,15,4,19,4,2012-11-04 23:52:41,2012-11-04 23:46:30
32d5f03f10069311b4f2c87d3cd38e968df74365...f7552a2889568b16fe76a286559c2eba4e38f508,1,1,1,2,1,2012-11-04 23:45:20,2012-11-04 23:44:20
f7552a2889568b16fe76a286559c2eba4e38f508...d828d4e186b5433f637b86c4e44a3b68acab5cb8,2,37,1,38,2,2012-11-04 23:58:37,2012-11-04 23:57:45
2564e310141ab0f23b5282ecaec8e820250c355a...1f1f60d12f78ee68d59b577fdb6a31857b1d0f44,1,5,0,5,2,2012-11-18 23:07:38,2012-11-18 23:07:38
2564e310141ab0f23b5282ecaec8e820250c355a...3bdb2ca5608d6530adbf91e7914e5d5e05acc07a,1,1,1,2,1,2012-11-18 19:08:45,2012-11-18 19:08:45
2564e310141ab0f23b5282ecaec8e820250c355a...76859e6eab1e411d1b7cc92d8160e89df6375cfb,1,1,1,2,1,2012-11-18 16:46:39,2012-11-18 16:46:39
e94584204215413980680525ee19d120b16e70dc...cccbb6bff3be5fe5f9653e625cf839eb1aedc7f6,1,3,3,6,3,2012-08-19 07:57:48,2012-08-19 07:57:30
cccbb6bff3be5fe5f9653e625cf839eb1aedc7f6...675431dfaaa7fc9fbd89be2602332287489ee04f,2,7,5,12,3,2012-08-19 09:17:45,2012-08-19 09:17:45
675431dfaaa7fc9fbd89be2602332287489ee04f...500fe9c639f37533fb8525d53dacbe986c0e3a9f,1,276,35,311,21,2012-08-19 14:30:07,2012-08-19 14:30:07
500fe9c639f37533fb8525d53dacbe986c0e3a9f...536b0303637c55c914784b57841e6d59c4968d5f,2,11,10,21,4,2012-08-19 14:38:21,2012-08-19 14:38:21
536b0303637c55c914784b57841e6d59c4968d5f...2892cb0ec4ebde4955f12c92183b7804558ca381,1,17,10,27,3,2012-08-19 15:56:46,2012-08-19 15:52:22
2892cb0ec4ebde4955f12c92183b7804558ca381...5f2d9cdbb1b1a8c91dcdd55e672801536711b5ef,1,8,7,15,3,2012-08-19 16:24:50,2012-08-19 16:23:28
afc1bd7ab87268b33a8b44b3238f562cdaf2a72f...e4984812cd54f7c5f27ccb754fc8ddadcb0693f9,1,2,7,9,1,2012-08-18 16:09:37,2012-08-18 16:06:45
1758bf76e4a108ef65a6d5d30196b005e4b302e7...e99293250ed9d0ae471faff240bc2e9910a1ec6f,1,1,1,2,1,2012-08-18 19:44:09,2012-08-18 19:44:09
70248cce0a8a3144df9f36e15fbeb5cc1b091c3e...b771bcc7b4ce37368d28db307030cf7c4c773ea2,1,8,0,8,3,2012-09-18 15:06:10,2012-09-18 14:56:39
ed576b69f9cc0202adbb82da778f1ff6036626b4...4a7292df3be2338ff5d915a9ab3107067f662534,5,230,766,996,159,2013-04-08 18:33:52,2013-04-08 17:49:08
4a7292df3be2338ff5d915a9ab3107067f662534...161c4da588d4cc757da44bcbb5875a84a7b8a7e6,2,17,0,17,3,2013-04-08 19:41:36,2013-04-08 19:28:15
0df59bc212529a769ab949c2f5884a2817ef85da...93cffc3b37d7ef7a20c53f9001f0451a37be7584,37,170,155,325,107,2013-03-22 17:50:07,2013-03-22 09:50:45
93cffc3b37d7ef7a20c53f9001f0451a37be7584...f7d945e325fd8edd0d827e652fb410bb2589de02,1,1,1,2,1,2013-03-22 21:41:13,2013-03-22 21:40:12
f7d945e325fd8edd0d827e652fb410bb2589de02...930af661abdb4eb7322f1ab06f21df9ed04af43d,13,95,31,126,53,2013-03-23 01:57:48,2013-03-23 01:57:48
4b9fa49bc0cf5d2e01b6b98dec6d23fed774f254...9a3988ca5ad5808fad0d5bd8e25fe560d0d48ec0,1,17,13,30,4,2013-02-19 09:50:22,2013-02-19 09:50:22
9a3988ca5ad5808fad0d5bd8e25fe560d0d48ec0...ebabd772911f732ef54e014f130f6f5530198e14,5,20,5,25,6,2013-02-19 09:51:24,2013-02-19 09:51:24
ebabd772911f732ef54e014f130f6f5530198e14...efa300088f4bdb7224d5f1200f6ff4dd526c47a7,1,2,2,4,1,2013-02-19 15:25:26,2013-02-19 15:25:26
efa300088f4bdb7224d5f1200f6ff4dd526c47a7...00031b73bda7d910aa19876694ebb6778c4b3e70,2,2,2,4,2,2013-02-19 16:31:41,2013-02-19 16:31:41
00031b73bda7d910aa19876694ebb6778c4b3e70...1add79bc4007fee658f193b65aea2af2347aab6b,1,1,1,2,1,2013-02-19 17:44:19,2013-02-19 17:44:19
1add79bc4007fee658f193b65aea2af2347aab6b...d51fb74360b94f2a856573174f8aae3cd905dd35,12,169,44,213,26,2013-02-19 18:23:29,2013-02-09 17:17:01
d51fb74360b94f2a856573174f8aae3cd905dd35...c6d69c12ea7ee9ad35abc7dbf95e00d624d0df5d,2,109,1,110,6,2013-02-19 18:23:30,2013-02-12 04:54:53
c6d69c12ea7ee9ad35abc7dbf95e00d624d0df5d...1f39eafd60761bf6a60b74d9e9859621da1b9363,2,50,4,54,5,2013-02-19 18:23:30,2013-02-04 23:57:59
1f39eafd60761bf6a60b74d9e9859621da1b9363...35c991aa06aa34fa458f01eac49275ff4c2d76f9,5,85,19,104,15,2013-02-19 18:23:30,2013-02-12 10:22:41
35c991aa06aa34fa458f01eac49275ff4c2d76f9...8fbea5e1881e8c310a462599a191619688ba67dd,1,19,0,19,1,2013-02-19 18:23:30,2013-02-12 23:06:03
4b9fa49bc0cf5d2e01b6b98dec6d23fed774f254...22d5e4b4af4a5913865bb3e4de4c25b6709cc4c5,1,1,1,2,1,2013-02-19 08:01:06,2013-02-19 08:01:06
6d52bcbb7cb962e4874a8e7a3d1d8ee77233cd19...906dc8522a1745e0e12c8061e4170540f7d0f486,4,11,21,32,8,2013-02-25 17:14:42,2013-02-25 17:14:42
906dc8522a1745e0e12c8061e4170540f7d0f486...8e5fbebe020878cdce98f8efce50bc337968b2ca,1,6,6,12,6,2013-02-25 17:22:02,2013-02-25 17:22:02
6d52bcbb7cb962e4874a8e7a3d1d8ee77233cd19...f28c301a4720ef110643728192c27b2ca0ed193a,1,15,0,15,2,2013-02-25 16:13:27,2013-02-25 16:13:27
b4a98e028adb5b32dcfa7384e46f57b28b43b684...44046e8a38225067d4d0feac35367eeae133446a,4,49,0,49,8,2012-11-17 01:07:38,2012-11-17 00:50:50
05dbc07c52ec222f57d358f13f9192ab2b20d098...29d59a879ea5b116cc31a2fd91be1f7562e487c2,4,23,5,28,7,2012-11-25 22:13:30,2012-11-25 22:13:22
29d59a879ea5b116cc31a2fd91be1f7562e487c2...2ea80b94d7f6e0d25207d6b716c52ca4c57a02fb,3,24,1,25,4,2012-11-27 08:45:37,2012-11-27 08:45:37
2ea80b94d7f6e0d25207d6b716c52ca4c57a02fb...1893467784deb6cd8a493997e8bac933cc2e4af9,4,183,140,323,16,2012-11-27 17:47:19,2012-11-26 20:42:27
1893467784deb6cd8a493997e8bac933cc2e4af9...905ea9619b871ded3204b1d0deb7e6fb9b081679,2,7,4,11,2,2012-11-27 17:47:20,2012-11-26 20:45:21
905ea9619b871ded3204b1d0deb7e6fb9b081679...64f6e0370a8d8d2c088f189b622fa4b0726f41b5,2,15,17,32,7,2012-11-27 17:47:20,2012-11-26 20:52:44
64f6e0370a8d8d2c088f189b622fa4b0726f41b5...86644e065fbde410aa32e052e206d1c53a916fd3,1,20,26,46,1,2012-11-27 17:47:22,2012-11-27 16:33:56
86644e065fbde410aa32e052e206d1c53a916fd3...d37483c533868e78afd0ca3faf993fee97097f9f,1,4,8,12,2,2012-11-27 19:54:46,2012-11-27 19:54:46
d37483c533868e78afd0ca3faf993fee97097f9f...c10aaa70a4cc2e567dc29953f33f0a4219717d61,2,5,2,7,3,2012-11-27 20:24:16,2012-11-27 20:22:18
c10aaa70a4cc2e567dc29953f33f0a4219717d61...7a62339f595f03170903d04cbb3e170fd03c657b,2,703,0,703,2,2012-11-27 21:30:52,2012-11-27 21:30:52
7a62339f595f03170903d04cbb3e170fd03c657b...7cea123bdebd45dc1bafe02d57a90995e76c28a9,2,3,3,6,3,2012-11-27 21:49:00,2012-11-27 21:49:00
7cea123bdebd45dc1bafe02d57a90995e76c28a9...ba2adc9c05aa343b58d087a81d9dc84f82b32790,1,11,6,17,1,2012-11-27 23:21:55,2012-11-27 23:21:55
ba2adc9c05aa343b58d087a81d9dc84f82b32790...38055222bd4f56bac6ae0f7a53c07bf924967daf,2,299,5,304,10,2012-11-28 00:26:37,2012-11-28 00:26:37
3c0300405009b82b52fd15483371097221662fcd...b9590a69357917a3dbf2c7234774803bd43767ef,1,2,2,4,2,2013-08-19 22:42:48,2013-08-19 22:42:48
b9590a69357917a3dbf2c7234774803bd43767ef...ac0e41e2c4d5c3712327fb4fe30420ec7a17c8d2,2,4,0,4,2,2013-08-19 23:42:53,2013-08-19 23:42:53
ac0e41e2c4d5c3712327fb4fe30420ec7a17c8d2...fdbf492946a030bdf394aae8896bbad9a446e0fd,1,11,1,12,2,2013-08-20 00:39:30,2013-08-20 00:39:30
fdbf492946a030bdf394aae8896bbad9a446e0fd...e55ca60903adcfd525938335b1ad9dbb6fd96c3e,3,30,5,35,11,2013-08-20 05:53:58,2013-08-20 03:14:21
e55ca60903adcfd525938335b1ad9dbb6fd96c3e...b53ed351b34918e337cbf26773998dafc6f82f4d,1,21,13,34,9,2013-08-20 06:50:37,2013-08-20 06:47:43
b53ed351b34918e337cbf26773998dafc6f82f4d...905409855c6b69f613190fcc2d8bd8bf5e1580b5,2,24,35,59,11,2013-08-20 07:55:00,2013-08-20 07:32:18
905409855c6b69f613190fcc2d8bd8bf5e1580b5...8dc76c4b9108f49afc5db07a23f34ad259a7642b,4,14,2,16,6,2013-08-20 08:33:44,2013-08-20 08:33:44
8dc76c4b9108f49afc5db07a23f34ad259a7642b...1ed77e7782069e938e896a0b8d0fd50156ed3680,4,36,1,37,4,2013-08-20 13:54:05,2013-08-20 13:23:25
1ed77e7782069e938e896a0b8d0fd50156ed3680...86f4459f9e3c035ec96578617605e93234bf2700,1,6,0,6,1,2013-08-20 14:48:02,2013-08-20 14:48:02
86f4459f9e3c035ec96578617605e93234bf2700...859e678b3d4df084c771e6344dd1a2b2ae716afe,1,1,0,1,1,2013-08-20 16:28:59,2013-08-20 16:28:59
859e678b3d4df084c771e6344dd1a2b2ae716afe...96346ed5adf90849ac5ebd10d74377ed2e0c061c,4,19,10,29,4,2013-08-20 19:25:57,2013-08-20 17:03:33
b575d690bbc1c4cd7f575346132c09fca8c736a7...9c711ee3a6a638add26d19dad70447c981371598,2,5,3,8,2,2013-08-09 13:12:15,2013-08-09 13:12:15
9c711ee3a6a638add26d19dad70447c981371598...ddae74b64ccb1173e3f2f06d54dd45643130f9e0,5,44,3,47,10,2013-08-09 13:19:52,2013-08-01 15:31:34
263eecc583223652dd24f9189144b39d5dd5b62d...cd4068f35900f22d0384717db0dd7b882d72a4f9,1,2,2,4,2,2013-09-06 18:31:27,2013-09-06 18:31:27
cd4068f35900f22d0384717db0dd7b882d72a4f9...cc957cb16cfdad7e6c9e97dc885fc415abbf5eaa,2,12,0,12,2,2013-09-06 18:56:37,2013-09-06 16:54:48
32838a5beb29fe4f23fa7881e6535b1b7384d39c...c438cc2a3653644ea42987f7e65f6f638ca85f6c,2,14,2,16,3,2013-09-06 20:46:38,2013-09-06 20:46:38
f0d9b529a995c147c919113738a4c09082087593...337bd248a5ac13957b3287ec8bd7a8a4e21be53e,2,28,6,34,12,2013-09-06 17:59:44,2013-09-06 17:59:44
f2fd4ebfb81bb38598fb8fe8ca8bf5790e48144b...5c143cb340df6825714a6317901b6df03d4ef4b0,2,9,10,19,3,2012-10-25 21:55:42,2012-10-25 10:51:19
5c143cb340df6825714a6317901b6df03d4ef4b0...f3a2bcdee906f7ca1434b6275fdc09b3a454cf46,3,55,2,57,6,2012-10-25 23:25:59,2012-10-25 23:25:59
f3a2bcdee906f7ca1434b6275fdc09b3a454cf46...71734dfa72140f90c71e199c3a63f47024636df9,1,1,1,2,1,2012-10-25 23:50:25,2012-10-25 23:50:25
71734dfa72140f90c71e199c3a63f47024636df9...3629a159f97b03f1142acdea03bdfa91edecea8d,1,13,9,22,1,2012-10-26 00:40:32,2012-09-26 19:41:47
3629a159f97b03f1142acdea03bdfa91edecea8d...02dda22832d313bde18798b2f5f1e9120a849815,1,1,1,2,1,2012-10-26 00:40:32,2012-09-28 15:09:05
02dda22832d313bde18798b2f5f1e9120a849815...bdcd2f6b105fffea0b8438625a29a1ccb2962680,4,7,6,13,6,2012-10-26 00:40:33,2012-09-28 17:17:40
bdcd2f6b105fffea0b8438625a29a1ccb2962680...3266c26eb22599a5577d41856baa04e99f87efe4,1,10,0,10,1,2012-10-26 00:40:33,2012-09-28 19:57:38
3266c26eb22599a5577d41856baa04e99f87efe4...c8508943a2e69840e3ec3322dba98551cbb23a9b,1,8,4,12,1,2012-10-26 00:55:55,2012-10-26 00:25:22
c8508943a2e69840e3ec3322dba98551cbb23a9b...3e10d22df5ce3a97d815b156bff11d879f40aa3a,1,9,10,19,4,2012-10-26 01:13:09,2012-10-26 01:00:21
3e10d22df5ce3a97d815b156bff11d879f40aa3a...fabe9c9e5f0a437b5389faaf469ce53091abd3cf,1,1,1,2,1,2012-10-26 01:45:15,2012-10-26 01:45:15
d35b95c2f45bc5bc91deab12e503b04126fe70d7...dbe984c397d6c1e49167dd8fbfb655dd17a14572,1,11,0,11,1,2012-11-05 01:45:30,2012-11-05 00:35:40
dbe984c397d6c1e49167dd8fbfb655dd17a14572...81342c28c6e4fbf98296555691750c33bce1bbc7,1,4,1,5,1,2012-11-05 02:37:01,2012-11-05 02:23:03
81342c28c6e4fbf98296555691750c33bce1bbc7...c7d5e7c75bc1570751acb01f296ea8deaf70b43b,2,3,2,5,3,2012-11-05 07:39:56,2012-11-05 07:38:41
c7d5e7c75bc1570751acb01f296ea8deaf70b43b...a23c9c48a81e8efadeeb91d1403c9d797a348fe7,7,52,3,55,10,2012-11-05 19:56:25,2012-11-05 19:27:06
a23c9c48a81e8efadeeb91d1403c9d797a348fe7...f7d87b30fb3636f0964880a6dd8a066db54ce3c1,2,19,10,29,7,2012-11-05 23:30:50,2012-11-05 12:14:40
f7d87b30fb3636f0964880a6dd8a066db54ce3c1...93e0ec553dae73a2a86cb23b058414d8f9ae3bd6,1,1,1,2,1,2012-11-06 09:21:30,2012-11-06 09:19:14
93e0ec553dae73a2a86cb23b058414d8f9ae3bd6...79209dfdc51e74f8fdf7d7b5b32ffe97794368d8,1,7,5,12,5,2012-11-06 10:18:12,2012-11-06 10:16:01
79209dfdc51e74f8fdf7d7b5b32ffe97794368d8...e645c89bbbcf62479441e50b5e5fdf48a80d424f,2,8,0,8,4,2012-11-06 11:23:32,2012-11-06 11:19:14
e645c89bbbcf62479441e50b5e5fdf48a80d424f...84e33545c90f353eacf8d01b33d9bec635f4e2c0,1,6,2,8,1,2012-11-06 22:50:00,2012-11-06 13:53:10
84e33545c90f353eacf8d01b33d9bec635f4e2c0...4f36ea451d9321913c9fc235dd4f05d4305453df,1,5,3,8,1,2012-11-07 00:04:38,2012-11-06 11:58:25
4f36ea451d9321913c9fc235dd4f05d4305453df...5b190733e902217536faf080ba58a9d5f958967e,1,8,2,10,3,2012-11-07 00:46:40,2012-11-07 00:44:49
5b190733e902217536faf080ba58a9d5f958967e...34d0c30e877739c8a7354ecd878f2ffe9e7c613f,1,6,5,11,2,2012-11-07 17:30:10,2012-11-07 17:24:49
34d0c30e877739c8a7354ecd878f2ffe9e7c613f...b8726179249ede88c988c13fd4b1077e49e8b151,1,9,0,9,1,2012-11-07 17:36:17,2012-11-07 17:31:14
b8726179249ede88c988c13fd4b1077e49e8b151...908226cf1acb6c4029d73318a0aaa923f58c9157,2,123,31,154,13,2012-11-07 23:10:24,2012-11-07 22:04:57
908226cf1acb6c4029d73318a0aaa923f58c9157...087274d08f40b7d3e37a6d138789bd4ec4903139,3,25,0,25,5,2012-11-09 08:03:52,2012-11-09 08:00:27
087274d08f40b7d3e37a6d138789bd4ec4903139...3344d8de3e34f1134a2fa19fa4a82b5acee8af0d,2,2,2,4,2,2012-11-09 10:49:27,2012-11-09 10:48:32
3344d8de3e34f1134a2fa19fa4a82b5acee8af0d...31eefc834900e0b327f7257cc95d54e4cba49f9c,1,1,0,1,1,2012-11-09 14:33:37,2012-11-09 14:16:06
31eefc834900e0b327f7257cc95d54e4cba49f9c...bf35fb600637b020748d05b704a1c0257c7cb63a,6,95,156,251,10,2012-11-09 18:44:13,2012-11-08 10:00:26
bf35fb600637b020748d05b704a1c0257c7cb63a...dc95791e61750024a610b6c5cf4d32b7325fcb51,2,27,0,27,3,2012-11-09 18:44:47,2012-11-09 18:37:50
dc95791e61750024a610b6c5cf4d32b7325fcb51...6554137eebe4bd10bdf3f1be21f63f0a9cffd7ff,2,16,1,17,2,2012-11-09 20:11:36,2012-11-09 20:07:53
6554137eebe4bd10bdf3f1be21f63f0a9cffd7ff...e6bc0c5babe97af86679ef7fe4f5975eb86f532f,2,19,1,20,3,2012-11-10 11:10:43,2012-11-10 11:05:58
e6bc0c5babe97af86679ef7fe4f5975eb86f532f...48a2917d46571840d3df43f2b434f81166071a17,1,0,2,2,1,2012-11-10 14:45:45,2012-11-10 14:42:27
48a2917d46571840d3df43f2b434f81166071a17...825a793555aafcbd670e50759f9a5046f11703df,1,8,4,12,4,2012-11-10 17:48:27,2012-11-10 16:39:59
825a793555aafcbd670e50759f9a5046f11703df...3db2aeec988f7bc9ad8a0844809a5bd4d7211669,1,2,1,3,2,2012-11-11 20:25:30,2012-11-11 20:23:45
3db2aeec988f7bc9ad8a0844809a5bd4d7211669...b3ea37e304554b511789a7429319484a7436d2e3,1,1,1,2,1,2012-11-13 10:25:11,2012-11-12 21:15:41
b3ea37e304554b511789a7429319484a7436d2e3...897d8adb1c1938261472de39ccd8066b3aacf8df,1,2,1,3,2,2012-11-13 10:46:46,2012-11-13 10:45:08
897d8adb1c1938261472de39ccd8066b3aacf8df...5e9af1600d74cbbfef5ad13fdf377dad73e0dd86,2,7,7,14,10,2012-11-13 19:47:26,2012-11-13 19:46:29
5e9af1600d74cbbfef5ad13fdf377dad73e0dd86...538d6c0fcd7e0a5505aa4d0424edc823ce2f511f,1,14,19,33,9,2012-11-13 21:01:25,2012-11-10 22:35:46
538d6c0fcd7e0a5505aa4d0424edc823ce2f511f...fe21c233d44a5cafff0766eb17ed3df20e08b70f,1,5,5,10,3,2012-11-13 21:01:34,2012-11-10 23:59:24
fe21c233d44a5cafff0766eb17ed3df20e08b70f...af044d86b87d23eb504687ab66027d8c124dff81,2,18,20,38,10,2012-11-13 21:02:08,2012-11-11 12:05:29
af044d86b87d23eb504687ab66027d8c124dff81...d33f8d0f54fc57fddfad3c01d3f487c55d06d267,1,2,2,4,2,2012-11-13 22:00:35,2012-11-13 21:51:50
d33f8d0f54fc57fddfad3c01d3f487c55d06d267...911d3581ea065410f742497cc498ae2bc58f9e91,1,1,1,2,1,2012-11-13 22:49:08,2012-11-13 22:48:23
911d3581ea065410f742497cc498ae2bc58f9e91...8967906e0a38884665cf542dfb2d84b087d23d99,2,17,5,22,7,2012-11-14 09:45:57,2012-11-14 09:39:58
8967906e0a38884665cf542dfb2d84b087d23d99...ebafba50a418d4a444a067a3d35cea7f98a20158,2,6,1,7,2,2012-11-14 09:55:12,2012-11-14 09:50:15
ebafba50a418d4a444a067a3d35cea7f98a20158...dea4214bb5903398b72e96a2fea24baeca8ed9f3,1,0,5,5,1,2012-11-14 10:49:12,2012-11-14 10:46:30
dea4214bb5903398b72e96a2fea24baeca8ed9f3...33f1181c31e0ee5bc5e20ca2a8549508de807623,4,17,23,40,4,2012-11-15 14:11:22,2012-11-15 12:23:02
33f1181c31e0ee5bc5e20ca2a8549508de807623...a1fd9555f2cc32d10cdbc4aa71f86bac50ffd9c1,1,10,15,25,5,2012-11-15 15:39:39,2012-06-08 12:57:42
a1fd9555f2cc32d10cdbc4aa71f86bac50ffd9c1...b39b0aedbfbddf8fab0c43b92dc237caa8da375f,1,2,2,4,2,2012-11-16 13:33:59,2012-11-16 13:25:45
b39b0aedbfbddf8fab0c43b92dc237caa8da375f...cefbf09a4d17ac1f5a90c9a8e68b21bfdd973d31,2,3,3,6,2,2012-11-16 23:20:11,2012-11-12 22:17:05
cefbf09a4d17ac1f5a90c9a8e68b21bfdd973d31...0d49fdb573d44794cc78c6af4761cc79c5330315,4,49,0,49,8,2012-11-17 01:08:02,2012-11-17 00:50:50
0d49fdb573d44794cc78c6af4761cc79c5330315...d69c3bf1373b2cb961c445802bc1b5d0d871f887,1,22,7,29,10,2012-11-17 11:50:54,2012-11-17 11:49:28
d69c3bf1373b2cb961c445802bc1b5d0d871f887...0e3f7814d7106768e8eafcba0e74238fcdb90f9d,8,148,8,156,11,2012-11-17 14:39:34,2012-11-17 14:37:30
0e3f7814d7106768e8eafcba0e74238fcdb90f9d...dd740e2b2e2780cc5b4357f1cd9b62f830945ec4,2,18,4,22,5,2012-11-17 14:51:10,2012-11-03 20:06:57
dd740e2b2e2780cc5b4357f1cd9b62f830945ec4...0aaaad14b7b9f139ca1b53d02a5d91a013b1e830,1,1,1,2,1,2012-11-17 14:59:34,2012-11-17 14:59:34
0aaaad14b7b9f139ca1b53d02a5d91a013b1e830...11539aad1eb72ec9ec579f5440db90c4b0911283,1,8,11,19,5,2012-11-17 15:13:37,2012-11-17 15:05:34
11539aad1eb72ec9ec579f5440db90c4b0911283...a023952e10092775215aeb2277d2fe3af5794e3b,1,3,5,8,1,2012-11-17 15:54:12,2012-11-17 09:51:30
a023952e10092775215aeb2277d2fe3af5794e3b...1b6e751430b6c151079f616ec5d4f8f3446ea24e,3,13,2,15,4,2012-11-17 16:12:24,2012-11-17 16:06:24
1b6e751430b6c151079f616ec5d4f8f3446ea24e...fc379b48655a365f0dd51880a1f68a15811f903a,2,15,4,19,4,2012-11-17 16:26:24,2012-10-11 21:20:25
fc379b48655a365f0dd51880a1f68a15811f903a...3d4f5f60860051190b11478fd2855c3288f0eab5,2,12,5,17,6,2012-11-17 18:21:09,2012-11-17 18:16:30
3d4f5f60860051190b11478fd2855c3288f0eab5...04adb7626ba6e578d172df292e86ae384d195939,4,587,1,588,5,2012-11-17 19:12:18,2012-10-31 00:09:49
04adb7626ba6e578d172df292e86ae384d195939...94208399d958e0e9028d61d76f1b877eb3a8f74d,2,5,1,6,2,2012-11-17 20:24:19,2012-10-24 20:02:30
94208399d958e0e9028d61d76f1b877eb3a8f74d...2bfea3620842103d76972a17d77c3b75b4d30b86,2,12,3,15,3,2012-11-17 20:30:22,2012-10-25 09:31:14
2bfea3620842103d76972a17d77c3b75b4d30b86...d881275341583f42dc85bcb781e8465a634d2a20,2,12,0,12,2,2012-11-17 20:30:47,2012-10-25 12:19:53
d881275341583f42dc85bcb781e8465a634d2a20...2fdb7e6ca5746e266325d7a7b2e038502c96ce89,1,2,0,2,1,2012-11-17 20:31:07,2012-11-09 16:15:19
2fdb7e6ca5746e266325d7a7b2e038502c96ce89...9fa6aa9534efe00afbdd733b70a90ec555730891,1,1,1,2,1,2012-11-17 20:31:21,2012-11-09 16:16:58
9fa6aa9534efe00afbdd733b70a90ec555730891...a586f2a7e56b854bb13403524259289974c7232c,5,10,32,42,6,2012-11-17 22:05:16,2012-11-17 21:38:19
a586f2a7e56b854bb13403524259289974c7232c...6e598fee931f48b52c76504dd2dcc345823c8688,1,1,1,2,1,2012-11-17 22:27:05,2012-11-17 22:25:37
6e598fee931f48b52c76504dd2dcc345823c8688...e8da482bbe15b8aba7c29cc987e74675d5b1145d,2,15,10,25,5,2012-11-17 22:27:27,2012-11-17 22:25:52
e8da482bbe15b8aba7c29cc987e74675d5b1145d...31da2a5e56dba374279cc8276d9ccb2e3096e4a9,1,129,63,192,9,2012-11-17 22:55:05,2012-10-23 11:02:48
31da2a5e56dba374279cc8276d9ccb2e3096e4a9...c262252c27dd2ca5553e33de5e39515ddfb4ac1a,1,2,2,4,2,2012-11-18 00:32:51,2012-11-18 00:29:31
c262252c27dd2ca5553e33de5e39515ddfb4ac1a...eb67a45a39a39d86faeefa1dc466fe2a6065655a,1,53,33,86,33,2012-11-18 12:33:10,2012-11-18 12:33:10
eb67a45a39a39d86faeefa1dc466fe2a6065655a...17c61aaea303a5f21537d9978c28135f6f17b489,1,5,0,5,2,2012-11-18 23:09:00,2012-11-18 23:07:38
17c61aaea303a5f21537d9978c28135f6f17b489...27ecabf73f82104dd7624a9321ea34b15e51d83d,1,1,1,2,1,2012-11-19 23:44:53,2012-11-18 19:08:45
27ecabf73f82104dd7624a9321ea34b15e51d83d...5b6db35a7472d745c2878b77406c0b730ea362d7,1,1,1,2,1,2012-11-19 23:46:36,2012-11-18 16:46:39
5b6db35a7472d745c2878b77406c0b730ea362d7...3a0e0230f76131cf23c0fdd0b18f3dd718c0f62f,8,133,7,140,13,2012-11-20 00:03:30,2012-11-17 21:53:31
3a0e0230f76131cf23c0fdd0b18f3dd718c0f62f...e56c8d7e0ac253f7c136584d9a09fed7a4c5db29,1,1,1,2,1,2012-11-20 10:03:22,2012-11-20 01:31:21
e56c8d7e0ac253f7c136584d9a09fed7a4c5db29...e15df5b6b56235059f45628f651cdb0e91c632a3,1,1,1,2,1,2012-11-20 18:21:17,2012-11-20 18:18:32
e15df5b6b56235059f45628f651cdb0e91c632a3...aab701f1aaae725f510b142b785ccc083939d365,2,2,2,4,2,2012-11-20 23:06:38,2012-11-20 23:00:20
aab701f1aaae725f510b142b785ccc083939d365...1220f22b88c324d84e6e0f52115d3f00fcba46b6,1,1,1,2,1,2012-11-21 00:52:07,2012-11-20 23:53:08
1220f22b88c324d84e6e0f52115d3f00fcba46b6...699a67480ac3b8046f450b293422b9534a4770a1,1,3,3,6,3,2012-11-21 08:54:02,2012-11-21 08:52:09
699a67480ac3b8046f450b293422b9534a4770a1...49484b54bc26122257ac73b059897870d6ef716f,1,2,0,2,1,2012-11-21 09:20:02,2012-11-21 09:19:00
49484b54bc26122257ac73b059897870d6ef716f...6d1307102104d5982e5dc8c3485ffd7bfdb658d3,1,11,9,20,4,2012-11-22 00:07:36,2012-11-22 00:06:17
6d1307102104d5982e5dc8c3485ffd7bfdb658d3...187441602c992fe8e97e32a7a53cc433cf06dd46,1,136,145,281,67,2012-11-22 00:32:27,2012-11-18 06:20:49
187441602c992fe8e97e32a7a53cc433cf06dd46...6d85f1212f4007e353455f6ae6598f22e6c17414,1,17,3,20,4,2012-11-22 06:08:04,2012-11-16 05:17:58
6d85f1212f4007e353455f6ae6598f22e6c17414...74e22f97725d4c85564c9d5210d8cdc19b19520d,2,3,2,5,3,2012-11-22 13:47:52,2012-11-20 21:14:20
74e22f97725d4c85564c9d5210d8cdc19b19520d...63546533c1fd7cfe003140bbe15a7d465aa787eb,2,6,4,10,3,2012-11-22 14:08:37,2012-11-22 14:07:21
63546533c1fd7cfe003140bbe15a7d465aa787eb...84dc6afac76bce4aab200b839329a7bccf1a2224,1,6,4,10,1,2012-11-22 15:37:17,2012-11-22 15:36:18
84dc6afac76bce4aab200b839329a7bccf1a2224...12cf9d2be3cccb2ff63d78e93f97188040488a3d,2,14,3,17,3,2012-11-22 19:14:04,2012-11-22 19:10:01
12cf9d2be3cccb2ff63d78e93f97188040488a3d...9bd67f056c6d1697d81841e3e21661069f57b14e,5,116,33,149,24,2012-11-22 19:54:20,2012-11-22 19:09:40
9bd67f056c6d1697d81841e3e21661069f57b14e...b9f9bc9a170430901fae188c375076f9b2cac784,1,6,0,6,1,2012-11-22 19:56:41,2012-11-22 19:55:50
b9f9bc9a170430901fae188c375076f9b2cac784...42fa51c0027b1c40b897a0d51051a63962f95637,5,43,40,83,16,2012-11-22 21:10:42,2012-11-20 12:15:16
42fa51c0027b1c40b897a0d51051a63962f95637...072b9d0d3d71f9e0ecbb8966f1c3b3238fc4d14f,1,11,11,22,7,2012-11-22 22:16:46,2012-11-22 22:16:04
072b9d0d3d71f9e0ecbb8966f1c3b3238fc4d14f...918d020de28d6707bdb44e99d32676bbe89d09c6,1,1,1,2,1,2012-11-22 23:02:20,2012-11-22 23:01:20
918d020de28d6707bdb44e99d32676bbe89d09c6...a892cd3191cd2e0d98756764ed7be3ad59b95850,1,9,6,15,5,2012-11-23 09:19:09,2012-11-23 09:02:18
a892cd3191cd2e0d98756764ed7be3ad59b95850...c90156fc188200795a24c24b9ea97eef32356e55,1,8,0,8,1,2012-11-23 12:02:29,2012-11-23 12:00:08
c90156fc188200795a24c24b9ea97eef32356e55...f88319dc3cd5a4a032e539f468dc118cb5fa9872,1,4,3,7,2,2012-11-23 12:13:24,2012-11-22 21:29:39
f88319dc3cd5a4a032e539f468dc118cb5fa9872...d46b24e682cdae4404c42477956adc3e778a573a,1,27,2,29,3,2012-11-23 15:07:29,2012-11-23 15:02:49
d46b24e682cdae4404c42477956adc3e778a573a...56f8e4b79c0559e1df5bf262a8ad73fc471d234c,1,1,1,2,1,2012-11-23 16:23:15,2012-11-23 16:20:36
56f8e4b79c0559e1df5bf262a8ad73fc471d234c...90c7aa074095311862b71f3b4ee7220369785375,4,53,5,58,8,2012-11-23 18:07:50,2012-11-22 18:27:28
90c7aa074095311862b71f3b4ee7220369785375...a79e4521e5ff86e138c76bdacb582ba85a7e8d68,1,1,1,2,1,2012-11-23 19:41:08,2012-11-23 19:40:42
a79e4521e5ff86e138c76bdacb582ba85a7e8d68...6a00c1968b78484dc821d56567443c28fad6dfbc,111,28358,84,28442,153,2012-11-23 22:16:15,2012-11-23 19:59:59
6a00c1968b78484dc821d56567443c28fad6dfbc...625dc3f0722d80eaffacc39171ea7337ab089ae4,2,9,1,10,2,2012-11-23 23:19:17,2012-11-23 22:28:20
625dc3f0722d80eaffacc39171ea7337ab089ae4...421e599ad34b93e9537bf4deeca343f5b2e69f06,2,13,1,14,3,2012-11-23 23:20:22,2012-11-23 22:44:48
421e599ad34b93e9537bf4deeca343f5b2e69f06...158a0332bfef38277ba0a6f7a89815624a7d0ea2,1,1,1,2,1,2012-11-24 03:30:52,2012-11-24 03:30:52
158a0332bfef38277ba0a6f7a89815624a7d0ea2...3fd8458fb3a30ea9fc6b3e7c08ff2d66a63e5067,6,101,23,124,18,2012-11-24 06:26:50,2012-11-24 05:43:20
3fd8458fb3a30ea9fc6b3e7c08ff2d66a63e5067...24582f18ff3aeb263f951dd2acf56f0a857fda17,1,7,0,7,1,2012-11-24 06:27:11,2012-11-24 05:53:44
24582f18ff3aeb263f951dd2acf56f0a857fda17...2ecf3a9344812ed4e6d1f8ca27238ee574f2e096,1,2,2,4,1,2012-11-24 07:08:28,2012-11-24 07:07:50
2ecf3a9344812ed4e6d1f8ca27238ee574f2e096...8e8f1ddf57f8cc001f2ca3f816eecbc6111edc1c,1,0,3,3,1,2012-11-24 07:27:09,2012-11-24 07:26:36
8e8f1ddf57f8cc001f2ca3f816eecbc6111edc1c...a708b8fcbe49e857d9f900d6375d56f61e22212a,1,14,23,37,8,2012-11-24 08:49:07,2012-11-24 08:48:21
a708b8fcbe49e857d9f900d6375d56f61e22212a...9efe1a7210ee161d5688f66a759bcd8d89d33142,2,5,1,6,3,2012-11-24 11:20:41,2012-11-24 11:10:25
9efe1a7210ee161d5688f66a759bcd8d89d33142...0d3ec8d0fb74424bb49e3169d5d051a36e8d2348,2,4,1,5,2,2012-11-24 14:05:30,2012-11-24 13:52:00
0d3ec8d0fb74424bb49e3169d5d051a36e8d2348...fc570b14152997f19523be3317da5e1438dbc34b,2,15,0,15,2,2012-11-24 15:01:10,2012-11-24 14:56:31
fc570b14152997f19523be3317da5e1438dbc34b...75bc081b917d98a8f51201a2b26ce3a8f5dd4d62,2,9,0,9,2,2012-11-24 16:15:03,2012-11-24 16:12:59
75bc081b917d98a8f51201a2b26ce3a8f5dd4d62...a12db81135b56a9d33b369c47b79a61d8dbbf268,1,18,10,28,3,2012-11-24 20:33:59,2012-11-24 18:16:17
a12db81135b56a9d33b369c47b79a61d8dbbf268...f1afd57a32c7eb2a674d3f7e2d6341b23f7afee4,1,2,2,4,2,2012-11-24 21:05:25,2012-11-24 21:03:12
f1afd57a32c7eb2a674d3f7e2d6341b23f7afee4...8c2f36260e71acb41596004f6abc2ead4c917f6d,3,24,1,25,4,2012-11-24 21:05:41,2012-11-24 21:04:17
8c2f36260e71acb41596004f6abc2ead4c917f6d...2e5b725197db406aa8b94aa4a86e2bac3dc571b1,1,1,0,1,1,2012-11-25 11:57:14,2012-11-25 11:55:23
2e5b725197db406aa8b94aa4a86e2bac3dc571b1...4389b51fabf6d5d98d3d59681a527e0b4fbe4331,2,20,10,30,4,2012-11-25 18:08:27,2012-11-24 22:43:13
4389b51fabf6d5d98d3d59681a527e0b4fbe4331...6945f60c2b2406ba06d889020d50aaba80e7d317,4,54,48,102,21,2012-11-25 18:08:51,2012-11-24 22:47:41
6945f60c2b2406ba06d889020d50aaba80e7d317...72231610b3b1211a7d38e6fde03e77faff741862,2,2,2,4,2,2012-11-25 18:32:25,2012-11-25 18:31:30
72231610b3b1211a7d38e6fde03e77faff741862...37c54c27bdb555de8525fbb56681cf4448d0020c,2,4,4,8,3,2012-11-25 18:53:50,2012-11-25 18:51:42
37c54c27bdb555de8525fbb56681cf4448d0020c...02ab5d180eded836fd258f59908c994ce1fec61d,1,1,1,2,1,2012-11-25 18:55:23,2012-11-25 18:53:24
02ab5d180eded836fd258f59908c994ce1fec61d...22ca5bab95d65d0fdec0b6914f9ab96795cfe138,5,58,4,62,10,2012-11-25 19:43:18,2012-11-25 19:39:23
22ca5bab95d65d0fdec0b6914f9ab96795cfe138...7c91b67cfaf4669df55a715e62d891faea796f20,4,23,5,28,7,2012-11-25 22:16:44,2012-11-25 22:13:22
7c91b67cfaf4669df55a715e62d891faea796f20...71e5ad248e104f68a0d755cd5f76e86631607be5,3,24,1,25,4,2012-11-27 08:55:26,2012-11-27 08:45:37
71e5ad248e104f68a0d755cd5f76e86631607be5...4467d86b61e47f4c9dcb130865a6700736500b4a,1,4,8,12,2,2012-11-27 19:59:03,2012-11-27 19:54:46
4467d86b61e47f4c9dcb130865a6700736500b4a...5509eb862668ebeadd52248e2af124dfce2cce72,2,5,2,7,3,2012-11-27 20:25:21,2012-11-27 20:22:18
5509eb862668ebeadd52248e2af124dfce2cce72...28120a94364bae3c2aec3a530a2cebdac50ece2f,2,703,0,703,2,2012-11-27 21:57:40,2012-11-27 21:30:52
28120a94364bae3c2aec3a530a2cebdac50ece2f...212214e8921fda7dac0c6d1784fca1ea4415948a,2,3,3,6,3,2012-11-27 21:58:16,2012-11-27 21:49:00
212214e8921fda7dac0c6d1784fca1ea4415948a...1c05619c1f8168a12dab767ecd867ee00f43db0b,3,4,4,8,4,2012-11-27 22:09:10,2012-11-27 22:09:10
1c05619c1f8168a12dab767ecd867ee00f43db0b...931b0f8ccd883630a85871f9482d72986a41f828,1,11,6,17,1,2012-11-27 23:22:49,2012-11-27 23:21:55
931b0f8ccd883630a85871f9482d72986a41f828...ecf292aa2c89935bbc243d29ead3e01f1380e246,2,299,5,304,10,2012-11-28 00:30:44,2012-11-28 00:26:37
ecf292aa2c89935bbc243d29ead3e01f1380e246...54ce0ff7ba2afbac6d0a18e282b336e0ddb8c3a6,1,1,1,2,1,2012-11-28 08:28:21,2012-11-28 02:57:50
54ce0ff7ba2afbac6d0a18e282b336e0ddb8c3a6...a21e8dee7682abdba646c5b72b6371d392e44dd1,3,50,5,55,9,2012-11-28 16:25:34,2012-11-28 16:16:00
a21e8dee7682abdba646c5b72b6371d392e44dd1...89593048e2eb5ef64a51da43728307e2dbef5783,4,48,10,58,10,2012-11-28 21:34:43,2012-11-28 21:31:13
89593048e2eb5ef64a51da43728307e2dbef5783...957de74ebe8219b97f628a21004ca83833146713,1,6,6,12,4,2012-11-28 21:55:47,2012-11-28 21:44:50
957de74ebe8219b97f628a21004ca83833146713...e3ea668b47f6b7d63abd93a62b89f809cd3d5146,1,8,3,11,1,2012-11-28 21:56:03,2012-11-28 21:52:50
e3ea668b47f6b7d63abd93a62b89f809cd3d5146...bb6e661e0ef96bfc5503cd9d5026ab89c683188f,1,1,1,2,1,2012-11-28 23:42:00,2012-11-28 23:28:30
bb6e661e0ef96bfc5503cd9d5026ab89c683188f...fe55052cca019371de712fde9daef6c1cc518a8a,2,2,2,4,2,2012-11-28 23:45:10,2012-11-28 13:19:05
fe55052cca019371de712fde9daef6c1cc518a8a...83df1f3b571667f3d625c95af745c6ff687ef78e,2,8,9,17,7,2012-11-29 15:38:09,2012-11-29 15:36:43
83df1f3b571667f3d625c95af745c6ff687ef78e...47c5b50d346237f30584ad9303dea8f6933ffae3,9,14,14,28,14,2012-11-29 20:52:22,2012-11-24 17:25:42
47c5b50d346237f30584ad9303dea8f6933ffae3...0fc5878c5fdcc46df93e3faa6388c75b160bdd8e,1,1,1,2,1,2012-11-30 15:24:51,2012-11-10 15:48:46
0fc5878c5fdcc46df93e3faa6388c75b160bdd8e...88638ddd3dd5e2c1aa2982cbb5d0512ede23b5fc,1,1,1,2,1,2012-11-30 20:13:51,2012-11-30 20:10:52
88638ddd3dd5e2c1aa2982cbb5d0512ede23b5fc...676e4d5497955bd16b06411c02875683bc312621,2,26,2,28,5,2012-12-01 11:23:49,2012-12-01 11:17:00
676e4d5497955bd16b06411c02875683bc312621...ae549cc1dd8740f5463739602967f6595a1b3ce9,32,19,163,182,67,2012-12-01 13:15:55,2012-12-01 13:15:06
ae549cc1dd8740f5463739602967f6595a1b3ce9...1b93499849f497af405de113355681e3af68d50b,3,25,6,31,8,2012-12-01 14:43:38,2012-10-13 10:21:35
1b93499849f497af405de113355681e3af68d50b...c9a47fb379cab4c0fe9be27c9924236e75327bd0,2,4,4,8,4,2012-12-03 09:45:42,2012-12-03 09:37:26
c9a47fb379cab4c0fe9be27c9924236e75327bd0...3d62eaea692b230ddc45faa48286b356ca561218,2,7,6,13,3,2012-12-03 19:49:28,2012-12-03 19:03:05
3d62eaea692b230ddc45faa48286b356ca561218...237a404d3ec678d1088dcd0b3630a3ea67ce08ea,2,53,9,62,9,2012-12-03 19:55:33,2012-11-19 01:21:05
237a404d3ec678d1088dcd0b3630a3ea67ce08ea...7fea7cf5d74a488f0c81b76cb7dc7fa74a86569c,6,32,5,37,9,2012-12-04 12:24:04,2012-12-04 12:18:57
7fea7cf5d74a488f0c81b76cb7dc7fa74a86569c...db455d6ff9655eee09b0473afff599effd5bbe1a,1,2,2,4,2,2012-12-04 18:39:49,2012-12-04 18:36:56
db455d6ff9655eee09b0473afff599effd5bbe1a...8c099ec3ec969ceef8de2e7fc90220b59cdf9b71,1,2,2,4,1,2012-12-04 21:00:17,2012-12-04 20:49:02
8c099ec3ec969ceef8de2e7fc90220b59cdf9b71...b6f67bd50e77b8501a4e90b7a83381412b18fcc7,1,4,3,7,3,2012-12-04 22:50:19,2012-12-04 22:48:39
b6f67bd50e77b8501a4e90b7a83381412b18fcc7...6a098aa6f29b484254de50c4eb113bdbad1d7e78,5,28,8,36,9,2012-12-04 22:53:52,2012-12-03 23:39:03
6a098aa6f29b484254de50c4eb113bdbad1d7e78...a8045c3af2ad9da7332dadfc011bcaf50365dc7d,1,2,3,5,1,2012-12-04 23:20:35,2012-12-03 15:46:48
a8045c3af2ad9da7332dadfc011bcaf50365dc7d...57a41d985acabc7fc25f08081e58f0978cc8c1dc,3,6,2,8,3,2012-12-06 08:54:47,2012-12-06 08:47:51
57a41d985acabc7fc25f08081e58f0978cc8c1dc...e9301ae451f84b06687d27af0a43bcb986054f63,2,25,4,29,4,2012-12-06 16:19:35,2012-12-06 16:14:44
e9301ae451f84b06687d27af0a43bcb986054f63...67bddc0b7b6468abe875f30e4b70560787b5eb5b,2,23,3,26,3,2012-12-06 19:05:16,2012-12-06 19:00:56
67bddc0b7b6468abe875f30e4b70560787b5eb5b...a0578a1a1c5e200fe45cf5902b295f4e92f87c75,1,5,3,8,1,2012-12-07 16:42:17,2012-12-07 16:39:36
a0578a1a1c5e200fe45cf5902b295f4e92f87c75...4214a22e060f9d692b77294659023633c63e1647,56,228,147,375,186,2012-12-08 10:16:03,2012-12-08 10:13:52
4214a22e060f9d692b77294659023633c63e1647...9af9cdb3eb21617bae37c159d8ab94a4688e3b3f,1,1,1,2,1,2012-12-08 11:20:48,2012-12-08 11:19:18
9af9cdb3eb21617bae37c159d8ab94a4688e3b3f...fa5460460696863ebd7c8ebae325b4ebce1a777b,3,21,2,23,5,2012-12-08 11:47:33,2012-12-08 11:41:11
fa5460460696863ebd7c8ebae325b4ebce1a777b...a155fb7408801ad27dfbbce374f73a809dee3540,1,1,1,2,1,2012-12-08 11:54:22,2012-12-08 11:52:09
a155fb7408801ad27dfbbce374f73a809dee3540...152d6cb411c5e75151d4cdc4be4992df61e9bf5b,1,1,1,2,1,2012-12-08 13:51:41,2012-12-02 21:26:00
152d6cb411c5e75151d4cdc4be4992df61e9bf5b...c81e8e7068bdaa000ad6fbed8d452ac074ba19a9,1,2,1,3,1,2012-12-08 18:48:41,2012-12-08 18:47:53
c81e8e7068bdaa000ad6fbed8d452ac074ba19a9...fce779475e221e322a25dbf30dc25003e831afc2,5,6,48,54,18,2012-12-08 20:08:37,2012-12-08 19:58:59
fce779475e221e322a25dbf30dc25003e831afc2...d6bad2e9ea77ce48ee5755a7b44682d892bfa3d4,2,13,2,15,3,2012-12-09 15:18:52,2012-12-09 15:17:56
d6bad2e9ea77ce48ee5755a7b44682d892bfa3d4...984cf8417b9f6738e3bc09cbcfb697eeffe441a5,1,2,2,4,1,2012-12-10 16:50:37,2012-12-10 16:43:07
984cf8417b9f6738e3bc09cbcfb697eeffe441a5...fce1fa0f7fb984d4e76eb81ffc3cb9826046c3b5,9,167,57,224,33,2012-12-10 21:13:28,2012-11-17 21:00:53
fce1fa0f7fb984d4e76eb81ffc3cb9826046c3b5...77b06e41516d8136b56c040cba7e235b14750bfb,3,34,4,38,7,2012-12-10 21:13:28,2012-11-27 21:24:31
77b06e41516d8136b56c040cba7e235b14750bfb...82d4786544e2331b23de468aba875e9600162d76,3,3,3,6,3,2012-12-10 21:49:48,2012-12-10 21:49:48
82d4786544e2331b23de468aba875e9600162d76...919fbe08c906f6f59dccb2a45a58e49d61df7c7b,1,3,3,6,3,2012-12-10 22:36:17,2012-12-10 22:34:51
919fbe08c906f6f59dccb2a45a58e49d61df7c7b...deb205b8ce560957167a6d0472d4ffca3a40abd9,1,2,2,4,2,2012-12-11 15:26:53,2012-12-11 15:25:47
deb205b8ce560957167a6d0472d4ffca3a40abd9...d92d9cf2aa15e70bcca8a3c9b2efa4ea8961ca4e,3,10,12,22,4,2012-12-11 21:35:37,2012-12-11 21:30:07
d92d9cf2aa15e70bcca8a3c9b2efa4ea8961ca4e...8a1b4dbda207d8c790b5801d62e7ff3df65a79df,1,7,7,14,4,2012-12-11 23:45:03,2012-12-11 23:43:37
8a1b4dbda207d8c790b5801d62e7ff3df65a79df...c20c3a20a313b24df6d115e585c04c8dc60d3970,2,34,1,35,5,2012-12-12 21:05:49,2012-12-12 19:34:59
c20c3a20a313b24df6d115e585c04c8dc60d3970...44e56238d79890176a747181d32fbc53be157706,3,13,3,16,4,2012-12-14 20:16:04,2012-12-14 20:13:36
44e56238d79890176a747181d32fbc53be157706...0c3e4848b63574f0f02528bb15a4cfbd23333bc8,5,14,18,32,6,2012-12-15 00:33:48,2012-12-13 13:20:47
0c3e4848b63574f0f02528bb15a4cfbd23333bc8...c252ed567c9844294bbe7924de62eb747d4cc0d9,5,657,13,670,6,2012-12-15 13:12:25,2012-12-15 13:03:17
c252ed567c9844294bbe7924de62eb747d4cc0d9...d196f8f7ebb74be47f7811cbe4c45b594fab18ad,5,6,91,97,6,2012-12-15 13:15:16,2012-11-24 17:10:51
d196f8f7ebb74be47f7811cbe4c45b594fab18ad...1af69a240c5b215ff999abd14de39d587ca9b3c0,1,9,0,9,1,2012-12-15 13:30:06,2012-12-15 13:29:46
1af69a240c5b215ff999abd14de39d587ca9b3c0...084a8e295916e0139f0333f029f44c773f30d847,2,37,19,56,3,2012-12-15 14:30:46,2012-12-15 14:25:54
084a8e295916e0139f0333f029f44c773f30d847...9cf566233bb5ad16c36329645fc6090577fb42f6,2,30,0,30,2,2012-12-15 14:46:55,2012-12-15 12:13:45
9cf566233bb5ad16c36329645fc6090577fb42f6...a7465ee7dfe7ced5f057de1b75e4ec05de3e38e5,1,55,0,55,1,2012-12-15 14:47:30,2012-12-15 12:49:56
a7465ee7dfe7ced5f057de1b75e4ec05de3e38e5...311bd0055d6302ce42d3831f95d8b255986ddc40,4,232,88,320,26,2012-12-15 14:47:48,2012-12-15 14:15:11
311bd0055d6302ce42d3831f95d8b255986ddc40...9534192c107aeaa1920408c0127920a4c61d9ca1,2,15,9,24,6,2012-12-15 14:48:09,2012-12-15 14:43:44
9534192c107aeaa1920408c0127920a4c61d9ca1...55aae4b86319cb95f6fab6dddbb1bd94e7f1994c,1,62,61,123,41,2012-12-15 22:27:55,2012-12-15 22:27:55
55aae4b86319cb95f6fab6dddbb1bd94e7f1994c...06b5f5fcb6db2fc20e2d455a34f3f4b0293cfd8c,3,7,3,10,3,2012-12-15 23:22:25,2012-12-15 23:18:45
06b5f5fcb6db2fc20e2d455a34f3f4b0293cfd8c...53b40d75b787b1f76e08aa078de88bae6473a3fc,2,13,1,14,2,2012-12-16 19:40:10,2012-12-16 19:34:41
53b40d75b787b1f76e08aa078de88bae6473a3fc...0bbc7c2b4921919ae989c6335be3b25676c6c40f,2,18,13,31,6,2012-12-16 20:13:30,2012-12-16 20:08:47
0bbc7c2b4921919ae989c6335be3b25676c6c40f...528483cae22fa89f46a48a7d20d50f2880fb3bf7,1,10,8,18,1,2012-12-16 20:46:17,2012-12-16 20:42:01
528483cae22fa89f46a48a7d20d50f2880fb3bf7...1caa483914edf851137b3c1e39f4364772bd46c9,1,3,5,8,3,2012-12-16 22:09:05,2012-12-16 20:24:15
1caa483914edf851137b3c1e39f4364772bd46c9...ddea0e0d7ee1a885f8ecbe45d7306a39c7780d63,3,25,5,30,7,2012-12-18 09:04:47,2012-12-18 08:56:30
ddea0e0d7ee1a885f8ecbe45d7306a39c7780d63...6d712e0d66ddb415c9876a26417b731765c81ba1,1,1,0,1,1,2012-12-18 10:51:34,2012-12-14 20:22:58
6d712e0d66ddb415c9876a26417b731765c81ba1...2545dc59bf44131a1f60f7393f29f025939f3a09,1,16,3,19,4,2012-12-18 13:05:12,2012-12-18 11:39:23
2545dc59bf44131a1f60f7393f29f025939f3a09...e11bd5c5ac0c7d85723451f8da7b6ad30fefc680,1,2,1,3,1,2012-12-18 13:14:37,2012-12-18 12:04:17
e11bd5c5ac0c7d85723451f8da7b6ad30fefc680...034c3551188189cc0faa9a9ccc88a191c855aa45,2,8,8,16,4,2012-12-18 13:20:51,2012-12-18 11:52:30
034c3551188189cc0faa9a9ccc88a191c855aa45...470f3eca34b390051afcaa71fd6673f712cb1722,1,19,0,19,1,2012-12-19 18:10:39,2012-12-19 18:07:52
470f3eca34b390051afcaa71fd6673f712cb1722...9892919b0df0e7369ab793119342182cf91d549d,3,33,2,35,5,2012-12-19 20:56:19,2012-12-19 18:12:08
9892919b0df0e7369ab793119342182cf91d549d...b7607003a543b11c62ad4d2ca1f8e12bd4b97b89,2,28,3,31,5,2012-12-20 08:14:10,2012-12-20 08:10:19
b7607003a543b11c62ad4d2ca1f8e12bd4b97b89...be10289d03332da7c074e93f8a1541baa29c1990,3,40,2,42,9,2012-12-21 09:10:21,2012-12-21 09:01:03
be10289d03332da7c074e93f8a1541baa29c1990...9e7183073f64e541587e8dcfd8bb3ddeb47f8162,1,3,0,3,1,2012-12-21 12:36:22,2012-12-21 12:36:22
9e7183073f64e541587e8dcfd8bb3ddeb47f8162...a0155f35343afbfd9e98ab9aa4615f06780f697e,1,4,2,6,2,2012-12-21 18:56:04,2012-12-21 18:56:04
a0155f35343afbfd9e98ab9aa4615f06780f697e...91af9230add54138e1c397a193301f3498df64c1,1,2,2,4,2,2012-12-21 20:53:23,2012-12-21 20:52:06
91af9230add54138e1c397a193301f3498df64c1...db22145afb9623fdcaa4269b5eefa045320e028e,1,23,23,46,12,2012-12-22 10:06:05,2012-12-17 09:47:38
db22145afb9623fdcaa4269b5eefa045320e028e...99196381374c5f88b7138236aa5d6a969e281590,6,49,19,68,19,2012-12-22 13:45:06,2012-12-17 09:49:26
99196381374c5f88b7138236aa5d6a969e281590...3aba929bccde2e25a02861552f438f6f2f88edcc,2,52,49,101,30,2012-12-22 15:04:49,2012-12-22 15:00:15
3aba929bccde2e25a02861552f438f6f2f88edcc...903892be7b51bd22c10a6e6f49a7a2ee67fd2288,19,911,862,1773,78,2012-12-22 15:39:49,2012-12-22 00:59:06
903892be7b51bd22c10a6e6f49a7a2ee67fd2288...f2a7b52cfbe51cff2ef6d9f0c7ea05a7f04f33cc,1,14,0,14,1,2012-12-24 02:18:06,2012-09-27 23:49:10
f2a7b52cfbe51cff2ef6d9f0c7ea05a7f04f33cc...5eba053459272dce908656a5bfca2c6bab2cfc76,1,12,0,12,1,2012-12-24 02:18:56,2012-09-27 23:52:24
5eba053459272dce908656a5bfca2c6bab2cfc76...515cf94b6031cd03039d2a6617969b673eacf848,7,26,20,46,13,2012-12-24 02:19:16,2012-09-28 07:20:01
515cf94b6031cd03039d2a6617969b673eacf848...95b4f34b5e3c98e5ad7c20134f785ff39f2fb718,1,32,21,53,12,2012-12-24 02:19:31,2012-09-28 07:25:08
95b4f34b5e3c98e5ad7c20134f785ff39f2fb718...cade3405c05097c13d316e8423f70474f4bed8c3,4,35,25,60,9,2012-12-24 02:19:53,2012-09-28 07:27:38
cade3405c05097c13d316e8423f70474f4bed8c3...5f07d24eaaa4879d90db6d7b4085cd6238042bd0,1,1,1,2,1,2012-12-24 02:20:19,2012-09-28 04:30:13
5f07d24eaaa4879d90db6d7b4085cd6238042bd0...b362a559692115b188f621b43162cb31282b0fd1,3,8,8,16,5,2012-12-24 02:20:32,2012-12-24 01:32:04
b362a559692115b188f621b43162cb31282b0fd1...00aea69f06b5eb2f7f22e5422382cabe561c449f,1,5,5,10,3,2012-12-24 02:21:19,2012-12-24 01:33:44
00aea69f06b5eb2f7f22e5422382cabe561c449f...2164cd00ecdb61774d05f5f278078a28c926779f,1,8,0,8,1,2012-12-24 02:21:36,2012-12-24 02:11:32
2164cd00ecdb61774d05f5f278078a28c926779f...1114d8203ea48f4a1021f59a87954d321d8b1fa5,1,1,1,2,1,2012-12-24 10:26:38,2012-12-24 10:25:58
1114d8203ea48f4a1021f59a87954d321d8b1fa5...ef98ae2910a6b5c86e1e0b003110455778e63324,4,15,15,30,15,2012-12-24 13:06:47,2012-12-24 13:04:02
ef98ae2910a6b5c86e1e0b003110455778e63324...cd914175c8209c5f366e87d94f8f6d050347757d,2,10,13,23,6,2012-12-24 19:30:20,2012-12-24 19:25:02
cd914175c8209c5f366e87d94f8f6d050347757d...5489fc47df76c3f25a959510b885fa9a28b495b4,8,34,35,69,11,2012-12-24 20:40:17,2012-12-24 20:37:36
5489fc47df76c3f25a959510b885fa9a28b495b4...3ad34c231bb6e13c29dd268f9557a9cb241280fa,5,140,170,310,40,2012-12-24 21:12:13,2012-12-22 19:00:08
3ad34c231bb6e13c29dd268f9557a9cb241280fa...3b32e5cc2d4b6db22148cd7e51cdb735aeb25b13,3,208,21,229,20,2012-12-24 21:13:38,2012-12-24 19:17:16
3b32e5cc2d4b6db22148cd7e51cdb735aeb25b13...8738da03c623c702aa57a90216bde0e70f42a957,1,3,2,5,1,2012-12-24 22:06:57,2012-12-24 22:06:57
8738da03c623c702aa57a90216bde0e70f42a957...1c1df12388e394b7f1dc3949d23b99fa80cf6f6a,9,65,60,125,42,2012-12-25 09:46:28,2012-12-25 08:40:08
1c1df12388e394b7f1dc3949d23b99fa80cf6f6a...4f67ab63761a949a4ee8dab5ae38f23b32dc56e5,2,4,1,5,3,2012-12-26 11:48:27,2012-12-26 11:45:41
4f67ab63761a949a4ee8dab5ae38f23b32dc56e5...0c79e5e347e3c5d3f942d4338bb5476f0277cd21,3,37,14,51,10,2012-12-26 13:30:11,2012-12-26 13:19:28
0c79e5e347e3c5d3f942d4338bb5476f0277cd21...e2396bf1220c543ee8d15c7640481889caace61d,1,11,10,21,1,2012-12-26 13:44:57,2012-12-26 13:33:47
e2396bf1220c543ee8d15c7640481889caace61d...fbc06eef1af1d7ecf91fae5a94a1994f356ffd22,34,127,118,245,67,2012-12-27 00:10:50,2012-12-25 14:56:22
fbc06eef1af1d7ecf91fae5a94a1994f356ffd22...3cb87ec605fb9e7785aa0580bd8220797b622e0c,3,1,44,45,6,2012-12-27 08:43:41,2012-12-27 08:37:57
3cb87ec605fb9e7785aa0580bd8220797b622e0c...8d1b1902488855e56c93f66d5a30b3ec746ff183,25,2914,2780,5694,41,2012-12-28 19:48:05,2012-12-27 08:37:57
8d1b1902488855e56c93f66d5a30b3ec746ff183...be4259004fd21ff5c78f02e9093a0786780e1c21,1,13,5,18,1,2012-12-28 20:44:45,2012-12-28 20:42:58
be4259004fd21ff5c78f02e9093a0786780e1c21...5097d3c5faab2b6582c4cebee2b265fcdbb893eb,5,48,4,52,9,2012-12-28 22:35:08,2012-12-28 22:16:13
5097d3c5faab2b6582c4cebee2b265fcdbb893eb...0c96aae700b6c1ab8da64e755a8e67195103e6dd,1,27,27,54,27,2012-12-29 10:32:20,2012-12-29 10:30:12
0c96aae700b6c1ab8da64e755a8e67195103e6dd...2d74a5fd65d94ea4cfb91dec56bf5d18c07e32c6,1,6,3,9,2,2012-12-29 14:37:57,2012-12-29 14:25:24
2d74a5fd65d94ea4cfb91dec56bf5d18c07e32c6...d529d413f742b16e787c5ddb4e843fa66d1b0809,2,9,5,14,4,2012-12-29 14:38:32,2012-12-29 14:30:17
d529d413f742b16e787c5ddb4e843fa66d1b0809...9e5ada79bf2d25fa862babe74517a6c7b5b89968,30,166,157,323,93,2012-12-29 20:57:57,2012-12-29 15:35:12
9e5ada79bf2d25fa862babe74517a6c7b5b89968...e871e0217838ee0a7a47ec1bdf81add5198227e7,1,4,2,6,2,2012-12-30 10:22:26,2012-12-30 10:22:26
e871e0217838ee0a7a47ec1bdf81add5198227e7...fa7153612999191323a206b8bf478f6a78d55073,3,47,12,59,11,2012-12-31 07:11:58,2012-12-31 05:33:21
fa7153612999191323a206b8bf478f6a78d55073...814c3b2e2a8da001af38f679ed2334239150a975,2,5,0,5,2,2012-12-31 09:24:48,2012-12-31 09:18:59
814c3b2e2a8da001af38f679ed2334239150a975...ac72782e61a8e08381cb66005295a4c24ed37f33,1,11,0,11,1,2012-12-31 11:48:43,2012-12-30 14:08:06
ac72782e61a8e08381cb66005295a4c24ed37f33...fd1279a44df3b9a837453cd79fd0fbcf81bae39d,9,111,20,131,19,2012-12-31 11:49:10,2012-12-30 14:19:22
fd1279a44df3b9a837453cd79fd0fbcf81bae39d...dfd8623de4e225e33c334086ff4e2ccdfb07247f,5,137,28,165,20,2012-12-31 17:51:13,2012-12-31 17:34:08
dfd8623de4e225e33c334086ff4e2ccdfb07247f...56e54727661bc34bd2b6f9fa6a75f5370149256e,4,11,15,26,11,2013-01-01 09:14:24,2013-01-01 09:12:06
56e54727661bc34bd2b6f9fa6a75f5370149256e...3f2f50699ee9502281fcde8497a0915cb414fff3,2,46,50,96,45,2013-01-01 15:13:37,2013-01-01 15:13:37
3f2f50699ee9502281fcde8497a0915cb414fff3...c3d919d12a340ad38e1e263532e72605920ee850,1,164,0,164,1,2013-01-01 15:20:25,2013-01-01 15:17:26
c3d919d12a340ad38e1e263532e72605920ee850...fff9752cb3164591a61816a35a967b5e7dbc2592,1,6,8,14,1,2013-01-01 20:02:33,2013-01-01 19:50:13
fff9752cb3164591a61816a35a967b5e7dbc2592...520a3f090c0541ddfaf3e949ca1edc6a113b6305,1,15,15,30,3,2013-01-01 23:47:12,2013-01-01 23:45:57
520a3f090c0541ddfaf3e949ca1edc6a113b6305...da2cdd3a0f7663ebdf20e33d553bc9d98b2b65fc,1,2,2,4,1,2013-01-02 20:33:58,2013-01-02 20:33:18
da2cdd3a0f7663ebdf20e33d553bc9d98b2b65fc...056ace0f395a58eeac03da9f9ee7e3872e1e407b,5,79,9,88,18,2013-01-02 21:22:14,2013-01-02 20:42:52
056ace0f395a58eeac03da9f9ee7e3872e1e407b...7be9fa224ceaeed7070541430c31b9235d309f0a,2,22,22,44,15,2013-01-02 21:22:51,2013-01-02 21:11:32
7be9fa224ceaeed7070541430c31b9235d309f0a...61c861546bdbae694f22e2c54e9ca0f42331cae1,1,16,15,31,5,2013-01-02 22:38:58,2013-01-02 22:32:10
61c861546bdbae694f22e2c54e9ca0f42331cae1...be1e006c581cc45ed48ae0b423e7a0a996d2199b,84,723,606,1329,367,2013-01-02 23:50:00,2013-01-01 13:12:42
be1e006c581cc45ed48ae0b423e7a0a996d2199b...70cc95d1ccab823d30d123d17e864c4867ee244b,2,21,5,26,6,2013-01-03 14:17:14,2013-01-03 14:13:51
70cc95d1ccab823d30d123d17e864c4867ee244b...a893ee3315d6a134b46ff8c36c44a8efbbe34886,1,1,1,2,1,2013-01-03 17:03:51,2013-01-03 17:03:51
a893ee3315d6a134b46ff8c36c44a8efbbe34886...4081042ef51c0e679c78f2d0d13514af3434ed13,2,19,5,24,4,2013-01-03 19:45:29,2013-01-03 17:49:00
4081042ef51c0e679c78f2d0d13514af3434ed13...5b8c0d22cc07ca727c032edf3309fab9cb39f21d,2,12,0,12,2,2013-01-03 19:45:57,2013-01-03 19:41:45
5b8c0d22cc07ca727c032edf3309fab9cb39f21d...b641357a37528c39de0c181ad495cbd39f3bf530,1,2,2,4,2,2013-01-03 21:17:30,2013-01-03 21:12:11
b641357a37528c39de0c181ad495cbd39f3bf530...96301d21bb2ec7c5e06e3cea54fa2cdcd25a464d,3,24,1,25,4,2013-01-04 13:03:55,2013-01-04 12:55:20
96301d21bb2ec7c5e06e3cea54fa2cdcd25a464d...f23d3ce8d47cc3ec58cb7fb1b32d3d3237c025f5,3,3,3,6,3,2013-01-04 18:49:58,2013-01-04 18:49:58
f23d3ce8d47cc3ec58cb7fb1b32d3d3237c025f5...f02e1167d788280e33de3df68fa41e89cb083619,1,16,12,28,3,2013-01-05 02:04:28,2013-01-05 01:42:25
f02e1167d788280e33de3df68fa41e89cb083619...7ca9b7162830218c299aa1132bca9781ce1e4e90,1,3,2,5,2,2013-01-06 22:00:29,2013-01-06 21:56:13
7ca9b7162830218c299aa1132bca9781ce1e4e90...012229914cb1391ee4fcb6c183a341a6491cd377,3,5,2,7,3,2013-01-07 20:02:02,2013-01-07 16:54:30
012229914cb1391ee4fcb6c183a341a6491cd377...b6119a637357ad8422d5744e66413ed2f4901f01,1,1,1,2,1,2013-01-08 03:17:55,2013-01-08 03:16:46
b6119a637357ad8422d5744e66413ed2f4901f01...beef02eeaaf0f6a70a56e1d81e3ec39659e2ad1e,5,9,9,18,9,2013-01-08 18:11:40,2013-01-08 18:07:12
beef02eeaaf0f6a70a56e1d81e3ec39659e2ad1e...9d6d0de7c1704fa39efb1f725bd8f80961ce3496,3,32,1,33,4,2013-01-08 19:03:53,2013-01-06 16:40:56
9d6d0de7c1704fa39efb1f725bd8f80961ce3496...78739faedb01baee06e84c69f6fab84c9e8b718e,1,1,1,2,1,2013-01-08 19:16:14,2013-01-08 04:41:59
78739faedb01baee06e84c69f6fab84c9e8b718e...c95ae7729f713a300e67bf30e9506ba78919113a,1,7,4,11,2,2013-01-08 20:45:27,2013-01-08 20:43:35
c95ae7729f713a300e67bf30e9506ba78919113a...7c39e041b1e107f437f61e97a11ce9e011d9ad2b,2,9,8,17,5,2013-01-08 20:59:42,2013-01-08 20:58:11
7c39e041b1e107f437f61e97a11ce9e011d9ad2b...af8e858c1596623ffcccedc57433a009455bc314,6,59,8,67,13,2013-01-09 16:19:56,2013-01-03 00:00:39
af8e858c1596623ffcccedc57433a009455bc314...785ec24720b3d7b38cf683f298b730c0c4014ac9,1,4,0,4,3,2013-01-09 19:02:51,2013-01-09 18:59:24
785ec24720b3d7b38cf683f298b730c0c4014ac9...1d3368b587c786128d1cf0b6f172f35e03269ecc,1,2,1,3,1,2013-01-09 22:34:33,2013-01-09 22:32:51
1d3368b587c786128d1cf0b6f172f35e03269ecc...7f7b6a369b5d8749bf7ef3324803b8041ff59b56,1,0,9,9,1,2013-01-09 23:34:36,2013-01-09 23:32:27
7f7b6a369b5d8749bf7ef3324803b8041ff59b56...f9604c8247e1b0369fecc9855494faff3c6ae3e8,1,1,1,2,1,2013-01-10 00:05:00,2013-01-10 00:03:34
f9604c8247e1b0369fecc9855494faff3c6ae3e8...b4544dbd5bf7fec73d03f31c0e59135d64fd818c,2,11,2,13,3,2013-01-10 08:07:06,2013-01-10 08:05:01
b4544dbd5bf7fec73d03f31c0e59135d64fd818c...72ef63bf86b12e752f186d562d9094cfde30af27,1,11,11,22,6,2013-01-10 20:17:37,2013-01-10 20:16:25
72ef63bf86b12e752f186d562d9094cfde30af27...c94fcc4117987c4ebe29ad63da01035230c8afd5,4,100,7,107,9,2013-01-11 11:01:19,2013-01-11 10:59:17
c94fcc4117987c4ebe29ad63da01035230c8afd5...b86c3ddce88390dacc04094fbdce1b722fb8127b,1,4,3,7,1,2013-01-11 13:10:32,2013-01-11 12:01:56
b86c3ddce88390dacc04094fbdce1b722fb8127b...1d03ff06bbcc726c815f26f79067692019b2c71a,2,8,1,9,3,2013-01-11 20:14:39,2013-01-11 20:09:33
1d03ff06bbcc726c815f26f79067692019b2c71a...b3887ab98ac5317ebe7889e8b35752ebfd9740f9,3,10,3,13,5,2013-01-11 20:35:45,2013-01-11 20:27:51
b3887ab98ac5317ebe7889e8b35752ebfd9740f9...fb130cb40ea9b93bae741a4f359f19819597a112,2,11,1,12,2,2013-01-12 14:51:15,2013-01-12 11:00:31
fb130cb40ea9b93bae741a4f359f19819597a112...f16eb0b0d049595f837005986b1db539528fef2f,1,4,4,8,2,2013-01-12 14:55:42,2013-01-12 11:20:18
f16eb0b0d049595f837005986b1db539528fef2f...d828c5c3a0c0aa736ca7b35fe0cb566ba14f04e4,1,1,1,2,1,2013-01-13 18:37:21,2013-01-13 18:35:59
d828c5c3a0c0aa736ca7b35fe0cb566ba14f04e4...64f1a175bd8228493ef600a62cd2f331a17787e6,1,12,0,12,2,2013-01-13 20:12:50,2013-01-13 20:11:24
64f1a175bd8228493ef600a62cd2f331a17787e6...863e0ab57d44d6d0fb1d7dc887e16b2f2159931c,1,2,2,4,2,2013-01-14 12:50:58,2013-01-10 21:17:52
863e0ab57d44d6d0fb1d7dc887e16b2f2159931c...9d4f906d47d9e0a589cf21c63b9a1f2bcdfd54b5,1,7,7,14,1,2013-01-14 12:52:13,2013-01-11 19:15:17
9d4f906d47d9e0a589cf21c63b9a1f2bcdfd54b5...5a53f1043cc86feef82864e4f5a57de78d57664b,1,30,11,41,5,2013-01-15 12:49:21,2013-01-15 12:39:41
5a53f1043cc86feef82864e4f5a57de78d57664b...360676d9d86ed36a2ffcf1318904b2b56cfae641,9,17,17,34,17,2013-01-15 12:52:06,2013-01-15 11:29:53
360676d9d86ed36a2ffcf1318904b2b56cfae641...b7828705c8a87a079b6226caf959c821bd51fa91,1,8,3,11,2,2013-01-15 13:09:43,2013-01-15 11:19:49
b7828705c8a87a079b6226caf959c821bd51fa91...6428f1cb72b912a94217fb22eb187f5b80f7088f,1,1,1,2,1,2013-01-15 13:37:25,2013-01-15 13:36:47
6428f1cb72b912a94217fb22eb187f5b80f7088f...464e9669a128b94812452a8e1834b3214e061b5d,1,1,1,2,1,2013-01-15 15:56:03,2013-01-15 15:55:13
464e9669a128b94812452a8e1834b3214e061b5d...321a6da0d4016192e48116ae96cd2162b8a55e67,153,18891,17924,36815,15997,2013-01-15 16:30:17,2013-01-15 14:42:06
321a6da0d4016192e48116ae96cd2162b8a55e67...3f9ab5209f23d6713b6c261ead20cf4731ce02f1,138,15461,49295,64756,13769,2013-01-15 16:30:18,2013-01-15 16:10:46
3f9ab5209f23d6713b6c261ead20cf4731ce02f1...1e95d5ba825bd57278a763e85118c6a683d63b1f,1954,43464,38596,82060,29756,2013-01-15 16:30:18,2013-01-15 16:29:09
1e95d5ba825bd57278a763e85118c6a683d63b1f...40d8b6e28c06a04631014d1eaee63c0ef957937f,1,12,9,21,1,2013-01-16 01:01:08,2013-01-15 20:47:31
40d8b6e28c06a04631014d1eaee63c0ef957937f...ab6ff2e0ac3a059c890d84a7a8b8f8646ddbbd4f,1,1,1,2,1,2013-01-17 21:58:53,2013-01-17 21:58:53
ab6ff2e0ac3a059c890d84a7a8b8f8646ddbbd4f...d90abcc9dad9b239e77aa67bfdd0c431072e2434,1,1,1,2,1,2013-01-18 19:52:25,2013-01-18 19:50:12
d90abcc9dad9b239e77aa67bfdd0c431072e2434...f6257a147df0be2f21c390ad10f6cd724b99cd93,1,3,2,5,1,2013-01-18 23:39:29,2013-01-18 23:38:12
f6257a147df0be2f21c390ad10f6cd724b99cd93...457290326fa38297467922d827c630ae2026e88b,1,5,4,9,1,2013-01-19 07:43:26,2013-01-15 13:05:58
457290326fa38297467922d827c630ae2026e88b...5f3c45f7458825b5ca88fb60e5349762fb74d5ae,12,31,31,62,31,2013-01-22 11:50:40,2013-01-22 11:47:34
5f3c45f7458825b5ca88fb60e5349762fb74d5ae...34718395edec9aaf01443b7c9d89ebe14400721e,3,22,8,30,9,2013-01-22 12:58:09,2013-01-22 11:46:22
34718395edec9aaf01443b7c9d89ebe14400721e...dc0bf53276f28421006d041dc21c7dc8d0393b2d,2,24,9,33,3,2013-01-22 23:18:32,2013-01-22 21:13:57
dc0bf53276f28421006d041dc21c7dc8d0393b2d...54887d686b1552ae98e3eb4fa57a64036eea72a5,1,6,0,6,1,2013-01-23 00:05:19,2013-01-22 21:15:52
54887d686b1552ae98e3eb4fa57a64036eea72a5...f4132140f52c88b67d11743d4062a9d455959ffc,3,35,2,37,4,2013-01-23 06:26:34,2013-01-23 06:22:07
f4132140f52c88b67d11743d4062a9d455959ffc...2e6b0c5ca7265b3cee2ff68a9ef5d1865afb9a49,2,10,0,10,2,2013-01-23 09:50:24,2013-01-23 09:42:34
2e6b0c5ca7265b3cee2ff68a9ef5d1865afb9a49...1c061ef568bf05827d449e1bbe426d624851e935,1,1,1,2,1,2013-01-24 00:21:42,2013-01-23 20:36:48
1c061ef568bf05827d449e1bbe426d624851e935...9328ef0e84db2559af56d24c40e6b24b74e29a6f,1,1,1,2,1,2013-01-24 10:30:05,2013-01-24 10:12:48
9328ef0e84db2559af56d24c40e6b24b74e29a6f...d571894fc09b34b8b43cb8f1790c743a47679851,1,11,8,19,1,2013-01-24 13:00:43,2013-01-24 11:53:32
d571894fc09b34b8b43cb8f1790c743a47679851...42fcfcaa529dac1fe3066797d7e4ab7aa6f6cdf3,3,42,8,50,10,2013-01-25 11:56:38,2013-01-25 11:53:40
42fcfcaa529dac1fe3066797d7e4ab7aa6f6cdf3...2d8b0315f46d24c6567a05422bd609f3a689bda8,2,32,2,34,5,2013-01-25 13:57:18,2013-01-25 13:52:24
2d8b0315f46d24c6567a05422bd609f3a689bda8...5ab24e205af03835fe2e5b856ec253e7405e6769,1,4,1,5,2,2013-01-25 23:43:21,2013-01-25 16:50:37
5ab24e205af03835fe2e5b856ec253e7405e6769...c87f89c0db9314d26a3ad9afceb812e2d2f07f96,1,1,1,2,1,2013-01-27 11:11:42,2013-01-27 11:09:36
c87f89c0db9314d26a3ad9afceb812e2d2f07f96...f6075b0596e20951bd8232f09d97fb7fac08308c,1,1,0,1,1,2013-01-29 11:13:47,2013-01-29 11:12:33
f6075b0596e20951bd8232f09d97fb7fac08308c...5da6ce11edb60319c014c07c40b03674ea89de4c,15,20,17,37,17,2013-01-29 17:58:24,2013-01-29 15:45:40
5da6ce11edb60319c014c07c40b03674ea89de4c...d5ad9d3dfe729f8b605965e131c787fae9f84377,5,32,0,32,19,2013-01-30 20:34:39,2013-01-30 20:26:17
d5ad9d3dfe729f8b605965e131c787fae9f84377...256352a790baf8f71e114f0940cf230a273a16da,1,1,0,1,1,2013-01-30 21:11:19,2013-01-30 21:10:28
256352a790baf8f71e114f0940cf230a273a16da...11ec0253ab4cc926ab9e77619132cb398231ac33,11,81,40,121,30,2013-01-31 12:55:00,2013-01-31 12:39:29
11ec0253ab4cc926ab9e77619132cb398231ac33...73bb9664da6a1be1477e0f7e40c9e1b995f2114f,2,72,5,77,6,2013-01-31 13:58:05,2013-01-31 13:58:05
73bb9664da6a1be1477e0f7e40c9e1b995f2114f...db49b6d2b298bc53b55df9ee7cf80e6492d3116b,2,34,3,37,6,2013-01-31 15:02:03,2013-01-31 15:00:39
db49b6d2b298bc53b55df9ee7cf80e6492d3116b...5ebd0452ba6ff93980e6f9a8958f6ea01c835ffe,1,7,2,9,1,2013-02-01 08:58:35,2013-02-01 08:55:19
5ebd0452ba6ff93980e6f9a8958f6ea01c835ffe...11f6295551fbcedae50df0efcae5eb34555a46dd,1,15,2,17,3,2013-02-01 12:43:20,2013-02-01 12:42:30
11f6295551fbcedae50df0efcae5eb34555a46dd...56a7d112376006937b424eb8262b902c42d17353,1,6,6,12,1,2013-02-01 20:48:44,2013-02-01 20:47:50
56a7d112376006937b424eb8262b902c42d17353...a22480797d8b4992f92854624dbf4ac328cbf765,1,0,1,1,1,2013-02-02 00:19:04,2013-01-29 14:12:13
a22480797d8b4992f92854624dbf4ac328cbf765...923b0de962ee863b27756fe916b00a7c40d7f2fe,1,3,3,6,3,2013-02-02 02:41:06,2013-02-02 00:10:34
923b0de962ee863b27756fe916b00a7c40d7f2fe...fd61ce9c4f03ddc66139e4658933216fa630c208,1,3,2,5,2,2013-02-02 02:41:48,2013-02-02 00:33:39
fd61ce9c4f03ddc66139e4658933216fa630c208...c39be8b836282c1060e64dc17c6cb8184c14cf0b,2,9,1,10,3,2013-02-02 11:03:08,2013-02-02 10:57:25
c39be8b836282c1060e64dc17c6cb8184c14cf0b...aaf6f39743cfe24b0db7fa34017ca364ef7e5e06,1,1,1,2,1,2013-02-02 11:14:53,2013-02-02 11:13:32
aaf6f39743cfe24b0db7fa34017ca364ef7e5e06...974909bc9a01ebd3d6f9f938c713ff90e1f41e5a,1,21,35,56,3,2013-02-02 13:02:43,2013-02-02 13:00:38
974909bc9a01ebd3d6f9f938c713ff90e1f41e5a...f28fbe7314712d3e594a0f6509361378162cc7ea,1,7,1,8,2,2013-02-02 13:38:02,2013-02-02 13:34:42
f28fbe7314712d3e594a0f6509361378162cc7ea...e18bd68dbc64dfe08ae0fbb54591d5c8f7e456eb,3,36,7,43,5,2013-02-02 22:55:59,2013-02-02 21:21:50
e18bd68dbc64dfe08ae0fbb54591d5c8f7e456eb...be5369fd24adfc788e59eaf0363d4d137ded6ef8,2,6,4,10,3,2013-02-02 23:03:05,2013-02-02 21:53:43
be5369fd24adfc788e59eaf0363d4d137ded6ef8...6155b66d0685e0e305dfa422dfd02f2a6c7127b8,1,1,2,3,2,2013-02-03 18:24:09,2013-02-03 18:22:53
6155b66d0685e0e305dfa422dfd02f2a6c7127b8...f5232597ea31bf274b02983f32ba89be4f7bf02b,2,61,17,78,14,2013-02-04 09:11:29,2013-02-04 09:04:56
f5232597ea31bf274b02983f32ba89be4f7bf02b...7a90c6adccb57eb27b363c9cffc759243e17ed1f,10,33,29,62,30,2013-02-04 20:09:20,2013-02-04 20:08:18
7a90c6adccb57eb27b363c9cffc759243e17ed1f...f58aae9311ade7a59ca97ec1e5dee7c08ab86f28,1,27,7,34,3,2013-02-04 20:23:37,2013-02-04 20:23:37
f58aae9311ade7a59ca97ec1e5dee7c08ab86f28...933e956ba4b1ad5f8823f0a294ffc795e949edf1,2,20,9,29,11,2013-02-06 09:06:57,2013-02-06 09:02:41
933e956ba4b1ad5f8823f0a294ffc795e949edf1...3b952123ac29f66371f5c51a00026faf7cb945c1,1,8,0,8,1,2013-02-06 13:27:53,2013-02-06 13:23:18
3b952123ac29f66371f5c51a00026faf7cb945c1...20ac33100cd20c17d1ceab075d96698974cc4778,2,1,2,3,2,2013-02-06 20:19:41,2013-02-06 20:16:15
20ac33100cd20c17d1ceab075d96698974cc4778...5ba76825cfe3fbc0967f38ac57fee4f09d6f2ead,1,1,1,2,1,2013-02-07 06:12:02,2013-02-07 06:10:13
5ba76825cfe3fbc0967f38ac57fee4f09d6f2ead...a81363d85accfe09fe6885b255355dfb108e25af,1,27,20,47,19,2013-02-07 12:03:46,2013-02-07 11:12:25
a81363d85accfe09fe6885b255355dfb108e25af...ad2311dfc68fb10710093c5b8c827249852402dd,5,115,102,217,23,2013-02-07 12:14:03,2013-02-07 10:51:25
ad2311dfc68fb10710093c5b8c827249852402dd...833ccd4b5b4b294e7ca8d32faa4461be7fafb13c,2,33,15,48,12,2013-02-07 21:38:14,2013-02-07 21:35:23
833ccd4b5b4b294e7ca8d32faa4461be7fafb13c...660f80c3d60083ecba26c83c0670ccca7fc56e09,3,32,8,40,5,2013-02-08 00:08:23,2013-02-06 22:25:51
660f80c3d60083ecba26c83c0670ccca7fc56e09...830b9fde460cedeb9a9a52e11a2d456d08c5198f,1,1,0,1,1,2013-02-08 08:28:37,2013-02-08 08:28:37
830b9fde460cedeb9a9a52e11a2d456d08c5198f...b8c6de31a6f08321a6cf6e3ede2dab90c9f1febd,5,31,5,36,11,2013-02-08 15:36:57,2013-02-08 15:32:09
b8c6de31a6f08321a6cf6e3ede2dab90c9f1febd...15796db507f5ce64f6935a0b634b4d1000c28401,3,17,0,17,6,2013-02-08 20:13:43,2013-02-08 20:12:03
15796db507f5ce64f6935a0b634b4d1000c28401...2d53799ca6674de39b5d3ac66c28b434d079725c,2,12,1,13,3,2013-02-09 09:19:59,2013-02-09 09:17:26
2d53799ca6674de39b5d3ac66c28b434d079725c...7b278278ab66ddaba85b1a0604d6764005d29c70,1,3,9,12,3,2013-02-09 14:22:33,2013-02-09 14:16:10
7b278278ab66ddaba85b1a0604d6764005d29c70...bb12ea2cf1cb0e093bd35886398e0f27d49fcde8,1,1,5,6,1,2013-02-09 17:33:34,2013-02-09 17:30:26
bb12ea2cf1cb0e093bd35886398e0f27d49fcde8...4c261c61f21bae4dc72e1ec2dffbce94a3603d73,2,63,3,66,8,2013-02-10 12:01:49,2013-02-02 12:48:55
4c261c61f21bae4dc72e1ec2dffbce94a3603d73...60186aa2e5db5900b96cbc3dac0ad23b72a37e80,8,129,11,140,14,2013-02-10 12:09:58,2013-02-05 21:52:29
60186aa2e5db5900b96cbc3dac0ad23b72a37e80...d8e68f421e676de16953090c187e165a6c1ed900,2,2,0,2,2,2013-02-10 17:08:15,2013-02-10 16:36:35
d8e68f421e676de16953090c187e165a6c1ed900...b18ad807e0b7f34df4e4b319af128883a54c03bd,3,23,2,25,4,2013-02-10 17:58:22,2013-02-10 17:49:28
b18ad807e0b7f34df4e4b319af128883a54c03bd...7b5ca126ee37cd386d9900b2ef29901debb28e9e,1,4,2,6,3,2013-02-10 19:09:58,2013-02-10 19:07:24
7b5ca126ee37cd386d9900b2ef29901debb28e9e...44afe4460218c1207ca9d7b1495e3f60cb06d898,1,3,3,6,2,2013-02-10 19:50:11,2013-02-10 19:43:08
44afe4460218c1207ca9d7b1495e3f60cb06d898...77f6eb2a6099fc06d01c77df2374e0528351822b,1,3,1,4,2,2013-02-10 19:54:48,2013-02-10 19:49:03
77f6eb2a6099fc06d01c77df2374e0528351822b...743263a1058bb54617446507cbb645aab571ac93,3,15,19,34,4,2013-02-12 22:22:10,2013-02-12 21:11:22
743263a1058bb54617446507cbb645aab571ac93...f83bec4847de7853ba3770ccaa05874b9d441e7d,3,6,6,12,6,2013-02-13 00:12:44,2013-02-13 00:12:44
f83bec4847de7853ba3770ccaa05874b9d441e7d...cfdc003ab7d456ad76a7c3eb33274a055270df23,1,1,1,2,1,2013-02-14 10:25:07,2013-02-14 10:22:33
cfdc003ab7d456ad76a7c3eb33274a055270df23...6f29147488e14555ae2e7c56f0f74996010e97e3,3,0,6,6,3,2013-02-14 23:45:36,2013-02-04 23:31:50
6f29147488e14555ae2e7c56f0f74996010e97e3...e7ab0d35c1c93c1ffb5ee64e5996a7b1e6552571,1,1,1,2,1,2013-02-14 23:46:27,2013-02-07 22:57:26
e7ab0d35c1c93c1ffb5ee64e5996a7b1e6552571...89ce55b301d163500b99c72bfefd9f07c5542091,1,49,4,53,7,2013-02-14 23:47:04,2013-02-11 15:49:30
89ce55b301d163500b99c72bfefd9f07c5542091...1c086df50e76f1fd84e0d90bfb1d0b13468ba13b,1,1,3,4,1,2013-02-14 23:47:41,2013-02-14 23:29:21
1c086df50e76f1fd84e0d90bfb1d0b13468ba13b...bc6746ac303ab625f2bc6fc878bd63661c784a59,4,49,2,51,6,2013-02-15 01:02:14,2013-02-15 01:00:55
bc6746ac303ab625f2bc6fc878bd63661c784a59...42e87c17f27f68ea43c78938d4972211b141ede3,2,18,1,19,3,2013-02-15 08:18:49,2013-02-15 07:29:15
42e87c17f27f68ea43c78938d4972211b141ede3...5921f15c113f41f3baca0b599ccb9dad83649682,2,7,4,11,3,2013-02-15 14:51:17,2013-02-15 14:44:27
5921f15c113f41f3baca0b599ccb9dad83649682...1b54c85a53edec2f802223c702cb1dfde6be9aa5,1,4,3,7,2,2013-02-15 15:11:53,2013-02-15 15:09:31
1b54c85a53edec2f802223c702cb1dfde6be9aa5...5a803ce10ef0c1b3777fb781d6feba72610c4265,1,1,1,2,1,2013-02-15 19:15:31,2013-02-15 19:11:46
5a803ce10ef0c1b3777fb781d6feba72610c4265...461d6e22957770449cd99367358c5e419bc3a86d,1,4,2,6,2,2013-02-16 02:21:45,2013-02-16 02:21:05
461d6e22957770449cd99367358c5e419bc3a86d...41848b078a2f0402b23043da7cfb517d0a194aa3,2,10,4,14,6,2013-02-16 12:32:03,2013-02-16 12:26:36
41848b078a2f0402b23043da7cfb517d0a194aa3...5c3c8bf09a986660fcd4421df38745167a10ba11,1,0,5,5,1,2013-02-16 23:05:35,2013-02-16 19:30:55
5c3c8bf09a986660fcd4421df38745167a10ba11...ad2b091c1f48687188295e57b5cf4f6ad751f572,1,4,9,13,1,2013-02-16 23:25:03,2013-02-16 23:23:39
ad2b091c1f48687188295e57b5cf4f6ad751f572...ba794f68bfa86c2744e89adeb6027c9d6059d85e,1,2,2,4,1,2013-02-16 23:34:18,2013-02-16 23:31:54
ba794f68bfa86c2744e89adeb6027c9d6059d85e...94ef17e2c223225cfa3a4bd2f9b4e1d961269e88,1,1,1,2,1,2013-02-17 13:55:22,2013-02-17 13:55:22
94ef17e2c223225cfa3a4bd2f9b4e1d961269e88...5d853db90e71691f2b6b0827b002b9d0edb38fd1,1,10,19,29,4,2013-02-18 14:36:49,2013-02-18 14:35:22
5d853db90e71691f2b6b0827b002b9d0edb38fd1...a7e33c5bf3a5d854a088c6e56f2684952b1cd2b6,12,169,44,213,26,2013-02-19 17:39:03,2013-02-09 17:26:24
a7e33c5bf3a5d854a088c6e56f2684952b1cd2b6...2d0c22e02db42763f66f9b941cd2c798590c03b9,2,109,1,110,6,2013-02-19 17:39:03,2013-02-12 04:54:53
2d0c22e02db42763f66f9b941cd2c798590c03b9...0e46c7f7ac9c8c56149090b58a277239708cf4f7,2,50,4,54,5,2013-02-19 17:39:04,2013-02-04 23:57:59
0e46c7f7ac9c8c56149090b58a277239708cf4f7...3ef4bbf495cc6c061789132e3d50a8231a89406b,5,85,19,104,15,2013-02-19 17:39:04,2013-02-12 10:22:41
3ef4bbf495cc6c061789132e3d50a8231a89406b...84ce990c0790c61230e2c6dca6768f91e67b3ee6,1,19,0,19,1,2013-02-19 17:39:04,2013-02-12 23:02:05
84ce990c0790c61230e2c6dca6768f91e67b3ee6...18d920ea4839fb54f9d2a5dcb555b6a5666ee469,3,3,3,6,3,2013-02-19 20:15:33,2013-02-19 20:15:33
18d920ea4839fb54f9d2a5dcb555b6a5666ee469...4f99b0b635c39d2e0e8037768e0a35e7e31495ed,1,1,1,2,1,2013-02-19 21:32:59,2013-02-19 08:01:06
4f99b0b635c39d2e0e8037768e0a35e7e31495ed...23ef6e1baf29d0390d5b94de0441e19f722d3aab,1,8,93,101,4,2013-02-19 23:20:46,2013-02-19 23:19:50
23ef6e1baf29d0390d5b94de0441e19f722d3aab...c7f80b428bc7440d61f94b8ae99c5d5959369541,1,5,6,11,1,2013-02-20 01:20:08,2013-02-20 01:20:08
c7f80b428bc7440d61f94b8ae99c5d5959369541...8d4342f2c97db93c54a1a5fef26a526caac62df1,1,1,1,2,1,2013-02-20 01:43:28,2013-02-20 01:43:28
8d4342f2c97db93c54a1a5fef26a526caac62df1...8ad436636fd385abd144274952b0c066885af042,3,15,6,21,5,2013-02-20 19:57:39,2013-02-20 19:52:44
8ad436636fd385abd144274952b0c066885af042...96790fc02214b4d36df0ecb630159e65b28a5174,4,21,22,43,7,2013-02-20 22:01:07,2013-02-20 01:08:55
96790fc02214b4d36df0ecb630159e65b28a5174...b17a572eb36acfa59cdf001c4ed3b965ade2b7a7,1,3,1,4,1,2013-02-20 23:34:22,2013-02-20 23:32:35
b17a572eb36acfa59cdf001c4ed3b965ade2b7a7...8a99d718f7db2d018a37f78a8e5639ff2d1d2aa8,2,4,3,7,3,2013-02-22 22:09:48,2013-02-22 22:00:41
8a99d718f7db2d018a37f78a8e5639ff2d1d2aa8...251f345db68278547fae520632765dc229a02a18,1,2,1,3,1,2013-02-22 22:31:14,2013-02-22 22:27:39
251f345db68278547fae520632765dc229a02a18...f96dd05542885d9839d4c79639164551e1f01563,1,1,1,2,1,2013-02-23 13:42:11,2013-02-23 13:35:52
f96dd05542885d9839d4c79639164551e1f01563...e69d810741b145100b9f0c9a4ce165adb9e2775f,1,1,1,2,1,2013-02-23 13:55:01,2013-02-23 13:52:33
e69d810741b145100b9f0c9a4ce165adb9e2775f...5732f7b62be4bdb289af0dc389d399f9d2e9dcf8,3,7,7,14,7,2013-02-23 14:23:06,2013-02-23 14:19:32
5732f7b62be4bdb289af0dc389d399f9d2e9dcf8...89fb1836a8e6115317a08c43dceee985377535fb,1,9,0,9,2,2013-02-23 14:47:42,2013-02-23 14:45:34
89fb1836a8e6115317a08c43dceee985377535fb...ad69293958226ef4c1355628d944a2692cca820f,1,3,2,5,2,2013-02-23 15:01:14,2013-02-23 15:00:23
ad69293958226ef4c1355628d944a2692cca820f...da8c7890824664e0219988ce4c41c103fceb575d,1,3,2,5,3,2013-02-23 15:37:29,2013-02-23 15:35:22
da8c7890824664e0219988ce4c41c103fceb575d...0fa827c55fd2aed38e986f53493b5462a1e2d350,2,11,11,22,8,2013-02-23 15:42:27,2013-02-23 15:40:19
0fa827c55fd2aed38e986f53493b5462a1e2d350...29b0d89ee9f9260d94b2352441938aab0e77f554,1,1,1,2,1,2013-02-23 16:05:59,2013-02-23 16:05:38
29b0d89ee9f9260d94b2352441938aab0e77f554...fceafa192901856edc0d44b593420e36100136b8,1,4,2,6,1,2013-02-23 20:23:00,2013-02-23 20:21:35
fceafa192901856edc0d44b593420e36100136b8...a97c441e18684570fbecd47b19bd47b4c06cc565,1,3,1,4,1,2013-02-23 20:28:03,2013-02-23 20:26:41
a97c441e18684570fbecd47b19bd47b4c06cc565...2683e8ea2098dd8d49229497648fa625caab0057,1,2,1,3,1,2013-02-23 20:33:58,2013-02-23 20:33:43
2683e8ea2098dd8d49229497648fa625caab0057...d1e87eb3baf75b1b6a0ada46a9b77f7e347cdb60,2,19,2,21,4,2013-02-23 20:39:05,2013-02-23 19:59:09
d1e87eb3baf75b1b6a0ada46a9b77f7e347cdb60...1702be89c86d1b1a01efb16fa7836335ad709184,1,10,3,13,1,2013-02-23 20:43:55,2013-02-23 20:42:56
1702be89c86d1b1a01efb16fa7836335ad709184...72db38facc2b713046ad25a1a5034fcbc328478c,1,24,5,29,2,2013-02-23 21:03:03,2013-02-23 21:01:43
72db38facc2b713046ad25a1a5034fcbc328478c...f60dd6f55dcd646dcec4f7f8b2cc73af985ccba3,1,2,1,3,1,2013-02-24 03:07:55,2013-02-24 03:06:04
f60dd6f55dcd646dcec4f7f8b2cc73af985ccba3...1845c53081ecf3800e9fdc261bae7904d859592f,2,10,0,10,2,2013-02-24 15:58:16,2013-02-24 14:43:56
1845c53081ecf3800e9fdc261bae7904d859592f...f8b41da43156aa4283c83f2e579e8b18157c9b20,4,52,2,54,5,2013-02-24 16:45:48,2013-01-29 05:28:09
f8b41da43156aa4283c83f2e579e8b18157c9b20...455baa68ebabb472f901e3b476b3344c94090303,2,20,38,58,5,2013-02-24 23:11:10,2013-02-24 23:09:13
455baa68ebabb472f901e3b476b3344c94090303...b83feeea43a4a2e85bbc61d259b711a410c0ee05,1,11,11,22,3,2013-02-25 07:15:46,2013-02-25 07:15:11
b83feeea43a4a2e85bbc61d259b711a410c0ee05...cf114cffea5482a32064de86c61417d511c2edca,1,2,0,2,1,2013-02-25 07:59:44,2013-02-25 07:56:30
cf114cffea5482a32064de86c61417d511c2edca...3fb98406dc2b3777dc21b191258e48d25ff12c67,48,327,258,585,272,2013-02-25 13:27:14,2013-02-25 13:27:14
3fb98406dc2b3777dc21b191258e48d25ff12c67...33fc43895279dc3525031dba2a06ea77b28c90dc,3,61,9,70,11,2013-02-25 19:04:26,2013-02-25 19:01:57
33fc43895279dc3525031dba2a06ea77b28c90dc...1742fd08f5e2f7353b67b58b4ef9185121ce300e,2,47,1,48,2,2013-02-25 21:30:56,2013-02-25 21:29:38
1742fd08f5e2f7353b67b58b4ef9185121ce300e...702d39921cb95883d3b7590eadd65b03f76d0f92,7,17,11,28,11,2013-02-25 22:37:23,2013-02-25 21:53:08
702d39921cb95883d3b7590eadd65b03f76d0f92...e7f2c6f2d7bf6687a058f6bdcc2f17e372c2d729,4,6,6,12,4,2013-02-26 19:06:35,2013-02-26 19:06:35
e7f2c6f2d7bf6687a058f6bdcc2f17e372c2d729...61283a8208b1fb4d6197556e3f1c36cfd5c80e17,1,2,0,2,1,2013-02-26 19:12:27,2013-02-26 19:12:27
61283a8208b1fb4d6197556e3f1c36cfd5c80e17...52093827c7c858268a0ef2c85285ec6a4114d1de,1,1,1,2,1,2013-02-26 19:13:43,2013-02-26 19:13:43
52093827c7c858268a0ef2c85285ec6a4114d1de...b170c077ccd86280715dbc57cf2cac9a2327ff4b,1,1,1,2,1,2013-02-26 19:28:38,2013-02-26 19:28:38
b170c077ccd86280715dbc57cf2cac9a2327ff4b...67f3a6e9cfe98b9376f90fc1b6f980570f3bcaa9,1,1,1,2,1,2013-02-26 20:14:17,2013-02-26 20:12:28
67f3a6e9cfe98b9376f90fc1b6f980570f3bcaa9...bbe8205693733bf38edaf12fa84bd06a1a00bd64,3,5,4,9,5,2013-02-27 09:03:33,2013-02-27 03:26:15
bbe8205693733bf38edaf12fa84bd06a1a00bd64...7f04031ef194639e7dc55ff9a873eeb09949a740,3,290,66,356,4,2013-02-27 13:19:45,2013-02-27 12:12:37
7f04031ef194639e7dc55ff9a873eeb09949a740...171a6635d2948bb7181d39193aca1d4ae6b297f0,1,1,1,2,1,2013-02-27 20:32:08,2013-02-27 20:28:55
171a6635d2948bb7181d39193aca1d4ae6b297f0...3919810923d44d0cd8068ab7b21c8aba041180ed,1,1,1,2,1,2013-02-27 21:18:06,2013-02-26 21:28:47
3919810923d44d0cd8068ab7b21c8aba041180ed...ed381bd922faa1379f1021f2a3dd57fe8a5163b2,1,1,1,2,1,2013-02-28 13:26:56,2013-02-28 11:59:35
ed381bd922faa1379f1021f2a3dd57fe8a5163b2...d43dfdf4b965bb77edb4631c3710fa423b722b93,1,2,2,4,1,2013-03-01 21:18:00,2013-03-01 21:15:23
d43dfdf4b965bb77edb4631c3710fa423b722b93...142728277a9be9a16e7e87086fbcd95041ae4071,1,10,0,10,1,2013-03-02 15:13:17,2013-03-02 15:11:23
142728277a9be9a16e7e87086fbcd95041ae4071...327c98ff08a95205919df4ae31dc633c1acec643,1,4,1,5,1,2013-03-02 21:45:06,2013-03-02 21:45:06
327c98ff08a95205919df4ae31dc633c1acec643...1ac7d4e345a06224d4805162192b038001f4d2af,1,1,1,2,1,2013-03-10 15:00:24,2013-03-10 14:57:51
1ac7d4e345a06224d4805162192b038001f4d2af...e5c57fe1b429b401d47ac7bf8f9056b707c5ec07,1,9,4,13,1,2013-03-12 12:08:01,2013-03-12 12:04:32
e5c57fe1b429b401d47ac7bf8f9056b707c5ec07...101ec4bf8aaf577c27ac9f11e52f4e604bc66c5a,2,19,12,31,4,2013-03-13 08:54:37,2013-03-13 08:50:45
101ec4bf8aaf577c27ac9f11e52f4e604bc66c5a...f96d2848c6e200dd965631d6bc2502d073fb20ab,1,24,2,26,4,2013-03-17 15:05:19,2013-01-01 14:26:34
f96d2848c6e200dd965631d6bc2502d073fb20ab...2757d492bb6920ad1b98f19872c19ee0d8b4223d,2,35,31,66,25,2013-03-17 15:05:30,2013-03-17 08:41:54
2757d492bb6920ad1b98f19872c19ee0d8b4223d...1c9bd69ff045cf304fcfe127eac53e8712d33d75,2,11,11,22,4,2013-03-17 15:05:55,2013-03-17 09:19:30
1c9bd69ff045cf304fcfe127eac53e8712d33d75...9e920a488846db7398c0d6584f824f32b2a0dd42,1,1,1,2,1,2013-03-17 21:44:20,2013-03-17 21:43:49
9e920a488846db7398c0d6584f824f32b2a0dd42...5c788770167bc236fb1e16ac6d1414db26fee26c,1,2,2,4,1,2013-03-18 19:48:47,2013-03-18 19:48:47
5c788770167bc236fb1e16ac6d1414db26fee26c...b91067d9aa42e31d4375e00a703beaacdb30d608,2,2,19,21,4,2013-03-20 09:43:14,2013-03-20 09:32:13
b91067d9aa42e31d4375e00a703beaacdb30d608...add0dc02ad69a5798adfaa12d44c6e9fd5651746,1,1,0,1,1,2013-03-20 16:11:21,2013-03-20 16:05:43
add0dc02ad69a5798adfaa12d44c6e9fd5651746...7206330c15b6d37dba46e311fd5135b25cf9f9e9,1,4,1,5,1,2013-03-22 11:44:42,2013-03-22 10:01:51
7206330c15b6d37dba46e311fd5135b25cf9f9e9...dd897e4eeb20cab9ac708c46f34c5f09758205c8,6,43,6,49,13,2013-03-22 16:45:41,2013-03-20 10:47:56
dd897e4eeb20cab9ac708c46f34c5f09758205c8...deec020bf5927abbdd667912f80794c32c03e609,2,8,2,10,3,2013-03-22 16:58:36,2013-03-22 16:55:12
deec020bf5927abbdd667912f80794c32c03e609...1363b418234d9af214ba9093014259fbb0ea2242,1,1,1,2,1,2013-03-22 17:51:55,2013-03-21 10:03:28
1363b418234d9af214ba9093014259fbb0ea2242...f7ca464039b4f21705a8a7074f6c542c3e4937b4,37,164,148,312,100,2013-03-22 18:08:55,2013-03-22 09:50:45
f7ca464039b4f21705a8a7074f6c542c3e4937b4...d35e621633640797d2db15ec2ff05ff97a3b80a6,13,95,31,126,53,2013-03-23 02:02:10,2013-03-23 01:57:48
d35e621633640797d2db15ec2ff05ff97a3b80a6...8772f9b4a6fd424c404cc1945ec57ddc767397ef,1,1,1,2,1,2013-03-23 19:01:44,2013-03-23 19:00:18
8772f9b4a6fd424c404cc1945ec57ddc767397ef...5e2bb1223c4e622113cef0edb6d7df53fab0367c,1,1,1,2,1,2013-03-24 17:55:45,2013-03-24 16:12:23
5e2bb1223c4e622113cef0edb6d7df53fab0367c...207117ae731096d8148c17c6ca16f06ebf18537c,2,16,2,18,3,2013-03-26 13:05:37,2013-03-24 20:59:44
1f1f60d12f78ee68d59b577fdb6a31857b1d0f44...f9891f20872e2a468c4910a968c5e2fae75d0e51,5,69,3,72,11,2012-11-20 10:23:12,2012-11-19 17:57:40
8b659e439b51953064a7a79924b4066e08d7127d...edf7ad36faab8d45aafe1f96feaf46794de22fc1,8,133,7,140,13,2012-11-20 00:03:09,2012-11-17 21:53:31
5f2d9cdbb1b1a8c91dcdd55e672801536711b5ef...268fa9631ec8bba04ab82aa80891e07cc02cdce2,1,3,3,6,3,2012-08-19 18:04:52,2012-08-19 18:04:52
11cdfb35a4ae39ac091ff5418fd0b21adb9a1db3...319e1355190d414ee1b095b26fbb494cf9a27578,3,50,5,55,5,2012-09-18 17:43:50,2012-09-08 16:29:29
319e1355190d414ee1b095b26fbb494cf9a27578...40e62a5ccd08f241e977c9ffcb96005b9f2d95e6,2,11,0,11,4,2012-09-18 19:05:41,2012-09-18 18:58:40
40e62a5ccd08f241e977c9ffcb96005b9f2d95e6...44767f2caf028d89e1a283d04bb552d0e18bb936,1,15,18,33,3,2012-09-18 19:15:15,2012-09-18 10:28:49
161c4da588d4cc757da44bcbb5875a84a7b8a7e6...f69396665c1dd3b6b70cc053f16403c66d57ce60,1,8,8,16,8,2013-04-08 20:02:18,2013-04-08 20:02:18
930af661abdb4eb7322f1ab06f21df9ed04af43d...b614c47f8c05f8c29a974dac984d0f07c3a09fce,3,67,10,77,16,2013-03-23 11:24:34,2013-01-12 12:09:30
930af661abdb4eb7322f1ab06f21df9ed04af43d...46246c66243c97198879c9ac79ef859ae2474524,2,32,7,39,5,2013-03-23 11:02:23,2013-01-30 18:46:27
46246c66243c97198879c9ac79ef859ae2474524...1c8a1706fbd91b303245292dcf0da0651f1b80e0,1,1,1,2,1,2013-03-23 12:27:16,2013-03-23 12:27:16
930af661abdb4eb7322f1ab06f21df9ed04af43d...15f12d4181355604efa7b429fc3bcbae08d27f40,1,1,1,2,1,2013-03-23 07:55:24,2013-03-22 22:01:47
bd006e00e43f44266afb07e7cd762bb7f5f2b323...132d5822b0651bd0f192388693cb22263e68ddf5,1,8,93,101,4,2013-02-19 23:19:50,2013-02-19 23:19:50
bd006e00e43f44266afb07e7cd762bb7f5f2b323...3f49d91463fcb74611d8b3eb19f5b68c6aae6812,1,1,1,2,1,2013-02-19 23:03:33,2013-02-19 23:03:33
86b96038f22237b9d1c5da9f7f9f6aae7afa2578...509798ae069064181e3d70d155812cbe02331490,1,1,3,4,1,2013-02-25 19:13:10,2013-02-25 19:13:10
509798ae069064181e3d70d155812cbe02331490...f1255a3c0904a55ef267fa5f8687a1ce78f6894a,3,61,9,70,11,2013-02-25 19:21:58,2013-02-25 19:01:57
f1255a3c0904a55ef267fa5f8687a1ce78f6894a...5d883589a8f6950e98538c9509a201d61573460d,1,82,74,156,35,2013-02-25 19:23:26,2013-02-24 10:38:34
5d883589a8f6950e98538c9509a201d61573460d...0836670c5cd8bb17322504c46e07d3944add63c3,2,47,1,48,2,2013-02-25 21:29:38,2013-02-25 21:29:38
0836670c5cd8bb17322504c46e07d3944add63c3...e76147a83a7306d6d83057b982207ddab37eb942,7,24,16,40,16,2013-02-25 22:05:20,2013-02-25 21:53:08
e76147a83a7306d6d83057b982207ddab37eb942...6a057e1595dfe45a0411c116f603801266c87395,2,79,2,81,2,2013-02-25 23:10:57,2013-02-25 23:10:57
6a057e1595dfe45a0411c116f603801266c87395...6a8f95d812797a0c7af85df27c51f588c8649c69,1,11,11,22,11,2013-02-26 01:12:55,2013-02-26 01:12:55
6a8f95d812797a0c7af85df27c51f588c8649c69...8dd8400f7eb7a4cf0a2e1a0c6cd3e5825ac94be7,1,2,3,5,1,2013-02-26 09:00:14,2013-02-26 09:00:14
8dd8400f7eb7a4cf0a2e1a0c6cd3e5825ac94be7...41d7a9a907881f52f27ad5f743707a27e8574366,26,2,2,4,2,2013-02-26 13:36:57,2013-02-26 08:51:56
41d7a9a907881f52f27ad5f743707a27e8574366...b3d2ccb5bfbaf6e7fe1f98843baaa48c35a70950,2,0,0,0,0,2013-02-26 13:36:57,2013-02-26 08:52:49
b3d2ccb5bfbaf6e7fe1f98843baaa48c35a70950...89f40e36246100df6a11316c31a76712ebc6c501,1050,0,0,0,0,2013-02-26 13:36:57,2013-02-26 08:53:47
89f40e36246100df6a11316c31a76712ebc6c501...fc074db29c29e6a5d46f09e01caeea47902e046a,1,9,12,21,6,2013-02-26 13:36:57,2013-02-26 08:57:29
fc074db29c29e6a5d46f09e01caeea47902e046a...737a5d71f084ac804519c0bac33e2498d712bbb7,1,1,1,2,1,2013-02-26 13:36:57,2013-02-26 08:58:36
737a5d71f084ac804519c0bac33e2498d712bbb7...33836cf88dd08ebd66d19ad7f732b12f089abd27,224,385,377,762,334,2013-02-26 13:36:57,2013-02-26 12:19:18
33836cf88dd08ebd66d19ad7f732b12f089abd27...4d9f39f3074da38c1cc3cd571c6c964a7c6f8843,1,0,0,0,0,2013-02-26 13:36:58,2013-02-26 13:30:04
4d9f39f3074da38c1cc3cd571c6c964a7c6f8843...28e545c4b3c18fd1d3641b1194bf53699a7c868a,1,5,7,12,2,2013-02-26 14:00:16,2013-02-26 14:00:16
28e545c4b3c18fd1d3641b1194bf53699a7c868a...0dc7ff6b7abc72d9909d93cd05e33f377ba6806c,1,1,1,2,1,2013-02-26 14:20:37,2013-02-26 14:20:37
0dc7ff6b7abc72d9909d93cd05e33f377ba6806c...1535fcfdbafc386efe14c0926d53869f03231bc8,1,2,2,4,2,2013-02-26 14:38:11,2013-02-26 14:38:11
1535fcfdbafc386efe14c0926d53869f03231bc8...0fe11fca408dadcb6ff314f9f508597c064db73c,1,6,5,11,5,2013-02-26 15:02:24,2013-02-26 15:02:24
0fe11fca408dadcb6ff314f9f508597c064db73c...33234aa8f718a4fd7a1535416cf4593414b60a13,1,6,3,9,1,2013-02-26 20:04:32,2013-02-26 20:04:32
33234aa8f718a4fd7a1535416cf4593414b60a13...9ce1b6191b374421ed42a84ae5d4585f1d33f1fc,1,1,1,2,1,2013-02-26 20:12:28,2013-02-26 20:12:28
9ce1b6191b374421ed42a84ae5d4585f1d33f1fc...9e6725c5eabfaf0f0153b4d40390b4916fd7d9eb,1,7,0,7,1,2013-02-26 20:46:32,2013-02-26 20:46:32
9e6725c5eabfaf0f0153b4d40390b4916fd7d9eb...6ca475d540361090e8b28154ce5391de718d5c63,156,26835,17272,44107,15417,2013-02-26 20:51:06,2013-02-25 21:47:41
6ca475d540361090e8b28154ce5391de718d5c63...87cc3da81417248ed70133735a63348057794b54,2026,52335,38381,90716,29657,2013-02-26 20:51:06,2013-02-25 22:02:09
87cc3da81417248ed70133735a63348057794b54...58a2fc820eba04a24c7cc6d4c66b5aea6abe8c5a,1,1,1,2,1,2013-02-26 20:51:06,2013-01-17 21:58:53
44046e8a38225067d4d0feac35367eeae133446a...4a5e8087ac7676ef08e76275c1f756778b39c13e,8,148,8,156,11,2012-11-17 14:37:30,2012-11-17 14:37:30
44046e8a38225067d4d0feac35367eeae133446a...ac4aa8a76c5fe49d3a028d74c86b6589ead8d608,1,22,7,29,10,2012-11-17 11:49:28,2012-11-17 11:49:28
38055222bd4f56bac6ae0f7a53c07bf924967daf...eeaab083fe3dd75eb7ff618d552a7752795b5ebc,1,1,1,2,1,2012-11-28 02:57:50,2012-11-28 02:57:50
96346ed5adf90849ac5ebd10d74377ed2e0c061c...082b0638ef05391fa3004463bd7f49721cde3c1d,2,15,1,16,3,2013-08-21 14:10:51,2013-08-20 20:56:39
96346ed5adf90849ac5ebd10d74377ed2e0c061c...f9d1d5dc1377cb21b39452b0897e7a79a3d02844,3,86,5,91,11,2013-08-21 01:17:26,2013-08-21 01:17:26
f9d1d5dc1377cb21b39452b0897e7a79a3d02844...deebb1a97767b69249a107848661456bf452d1f1,3,3,3,6,3,2013-08-21 01:23:41,2013-08-20 17:59:23
deebb1a97767b69249a107848661456bf452d1f1...83e434a2c2910d9e0540ea693d5f65e6550240c1,1,2,2,4,1,2013-08-21 04:20:29,2013-08-21 03:22:25
83e434a2c2910d9e0540ea693d5f65e6550240c1...b065aeb17f9daf395e22d4d5f9f49c0e2c7f4522,3,36,24,60,13,2013-08-21 05:32:19,2013-08-20 14:13:41
b065aeb17f9daf395e22d4d5f9f49c0e2c7f4522...ececbe77ff573707d8f25084018e66ee07f820fd,2,99,12,111,12,2013-08-21 10:44:20,2013-08-19 23:04:50
ececbe77ff573707d8f25084018e66ee07f820fd...a5cf5da50d93ccb75de2af6ee3b65d942076d0f8,1,7,7,14,7,2013-08-21 10:48:16,2013-08-21 10:48:16
a5cf5da50d93ccb75de2af6ee3b65d942076d0f8...f7290581fe2106c08d97215ab93e27cf6b27e100,2,31,12,43,10,2013-08-21 12:30:21,2013-08-20 18:13:43
f7290581fe2106c08d97215ab93e27cf6b27e100...d3ed15b79d8b9288c4f6af07d5161f0727dd7669,1,1,1,2,1,2013-08-21 13:01:52,2013-08-21 13:01:52
ddae74b64ccb1173e3f2f06d54dd45643130f9e0...453915bb1272c9a9189a741e6a9b9246edfcbd03,1,6,5,11,4,2013-08-09 14:57:25,2013-08-09 14:57:25
453915bb1272c9a9189a741e6a9b9246edfcbd03...0cac4fbf699bb6a3de5f4a48c6e047a4dc6c2df7,5,25,3,28,8,2013-08-09 16:22:42,2013-02-04 15:50:15
d5df914fe14fd96cec1cd3465852b8da72e7c5f6...c1bbc8cae961904c93afb7de8911fe42e2b16236,1,1,0,1,1,2013-09-06 21:05:53,2013-09-06 21:05:53
c1bbc8cae961904c93afb7de8911fe42e2b16236...028db9750357d504c55a7ac686c9abaa3c847ac6,1,3,1,4,1,2013-09-06 21:26:15,2013-09-06 20:41:22
028db9750357d504c55a7ac686c9abaa3c847ac6...0c295a771886272fe50e49aef94d282b8f4725da,1,3,5,8,1,2013-09-06 21:41:12,2013-09-06 21:41:12
0c295a771886272fe50e49aef94d282b8f4725da...0b7cf56e28078a6d5e2a9cd21ef08176ad9a453b,1,1,1,2,1,2013-09-06 22:00:38,2013-09-06 22:00:19
0b7cf56e28078a6d5e2a9cd21ef08176ad9a453b...e844e10b4f06c13d24d405fe0d2e80a23d260508,2,6,7,13,4,2013-09-06 22:01:36,2013-09-06 22:01:23
a91799a30c79ebbf0e5d9cad35362b4960c030fb...a5bcc09c8f2b0c1cc06a6039a700fbf6103656f7,1,92,64,156,23,2013-09-06 16:37:08,2013-09-06 16:37:08
a91799a30c79ebbf0e5d9cad35362b4960c030fb...9f6e6009a44f26b9acfe3aadf76da7c29627a00b,2,47,3,50,7,2013-09-06 16:06:19,2013-09-06 16:05:50
9f6e6009a44f26b9acfe3aadf76da7c29627a00b...630eb0564abd228da439d86ad93acb4089d795e7,1,1,4,5,1,2013-09-06 16:09:16,2013-09-06 16:09:16
907f19eba743de3f0720bc2e2cd2fad45b2c0170...6d2be870d7413ad830ae487e6b36bf8581d450f1,1,1,0,1,1,2013-09-07 18:16:36,2013-09-07 18:16:36
fabe9c9e5f0a437b5389faaf469ce53091abd3cf...90c76564669fa03caefcf4318ffdf9ba8fa4d40b,1,1,1,2,1,2012-10-26 08:23:33,2012-10-26 08:23:33
90c76564669fa03caefcf4318ffdf9ba8fa4d40b...be29329ccd49a84d3f7238111aebf97c4aaac581,3,10,1,11,3,2012-10-26 18:44:00,2012-10-26 18:44:00
be29329ccd49a84d3f7238111aebf97c4aaac581...195bc37f1d251eb7b5bc4d5f916f3b08745a504f,1,5,1,6,5,2012-10-26 20:09:48,2012-10-26 20:09:48
195bc37f1d251eb7b5bc4d5f916f3b08745a504f...46d27a6b8d8e988f665d102a1504e178133f7668,1,6,2,8,2,2012-10-26 20:40:35,2012-10-26 20:40:35
46d27a6b8d8e988f665d102a1504e178133f7668...789ea3342d5cdfc850a2f68818e707cdc5111bb9,1,19,4,23,2,2012-10-26 20:47:45,2012-10-26 20:47:45
789ea3342d5cdfc850a2f68818e707cdc5111bb9...11699ac4b5f98ec11dba02b356a8fd4ab6b4b889,5,61,65,126,41,2012-10-26 23:13:02,2012-10-25 17:57:32
207117ae731096d8148c17c6ca16f06ebf18537c...33c4abb71a3534deab13564eb3168ed0cbfe1786,1,11,0,11,1,2013-03-26 17:29:53,2013-03-26 16:51:05
3fb83729b9fd7d5e46263286d42f47cb52ac2824...3587991ba8d223fe9fe4d54a094b82dbc9c27bc2,2,3,2,5,3,2012-11-22 11:34:15,2012-11-20 21:14:20
3587991ba8d223fe9fe4d54a094b82dbc9c27bc2...7b2d95eb3054e95d2fa4c36d8194cd74816118a7,2,6,4,10,3,2012-11-22 14:07:21,2012-11-22 14:07:21
edf7ad36faab8d45aafe1f96feaf46794de22fc1...d179794c6bb6a7bfb6515b9cd1842bfebcee52c8,1,1,1,2,1,2012-11-20 01:31:21,2012-11-20 01:31:21
a2ba02614f693debf977db9f3c7ec81c127e3778...7631fb8f37f0ba8155208a7a9f79f3a9958ac9b1,1,5,4,9,1,2012-08-19 19:21:53,2012-08-19 19:21:23
7631fb8f37f0ba8155208a7a9f79f3a9958ac9b1...a43ecc04445a02982cb9c52357db25066b197c37,1,0,4,4,2,2012-08-19 19:25:41,2012-08-19 19:25:41
a43ecc04445a02982cb9c52357db25066b197c37...2f59e94a4150c84c8b4e387fd82f0509eadc4f4b,3,52,7,59,7,2012-08-19 19:47:41,2012-08-19 19:47:41
2f59e94a4150c84c8b4e387fd82f0509eadc4f4b...9729f77326af9f6dc8644ec2574a2c356f84f32d,1,17,17,34,7,2012-08-19 19:50:07,2012-08-19 19:50:07
9729f77326af9f6dc8644ec2574a2c356f84f32d...4db38cbfe1087a51cd5d3d4fed9c7fcb952424d7,2,16,2,18,4,2012-08-19 20:45:26,2012-08-19 18:15:52
4db38cbfe1087a51cd5d3d4fed9c7fcb952424d7...514a0013cd38fc586e3b4d8582da2f65c1cdd50c,1,3,0,3,1,2012-08-19 22:46:46,2012-08-19 22:46:46
514a0013cd38fc586e3b4d8582da2f65c1cdd50c...3631db88cbae4b50b1d1b0fda0dfaa6a47f4eb0d,1,1,1,2,1,2012-08-20 00:13:09,2012-08-20 00:13:09
3631db88cbae4b50b1d1b0fda0dfaa6a47f4eb0d...26e0ba07aef4dcd6c57e1b03f2000c28672985e5,2,9,12,21,7,2012-08-20 01:03:50,2012-08-20 01:03:50
26e0ba07aef4dcd6c57e1b03f2000c28672985e5...30bdf22bc7a262858b02b65b0ed154dec46d911d,1,5,3,8,1,2012-08-20 03:46:36,2012-08-20 03:42:57
30bdf22bc7a262858b02b65b0ed154dec46d911d...3fce0d2a9162cf6e749a6de0b18890dea8955e89,2,12,0,12,3,2012-08-20 06:47:30,2012-08-20 06:47:30
3fce0d2a9162cf6e749a6de0b18890dea8955e89...bfc380baeaca359ac7b36eb35a2415e6a37e836c,2,11,4,15,5,2012-08-20 08:46:21,2012-08-20 08:46:21
bfc380baeaca359ac7b36eb35a2415e6a37e836c...4e82d614002f3fb46a3504b3a4fa2dcbf7f53dab,2,10,0,10,4,2012-08-20 13:02:25,2012-08-20 13:01:57
4e82d614002f3fb46a3504b3a4fa2dcbf7f53dab...1288572d9203472be8aa28e956027899fec3ed92,1,2,4,6,1,2012-08-20 16:23:17,2012-08-20 16:23:17
1288572d9203472be8aa28e956027899fec3ed92...610746f6cb89c13b364c27fc41ecc9592cbe1605,1,59,3,62,3,2012-08-20 19:21:00,2012-08-20 19:21:00
610746f6cb89c13b364c27fc41ecc9592cbe1605...54899d810dfb892558699ddbd5f724a358dc96e1,2,22,11,33,7,2012-08-20 20:25:41,2012-08-20 20:24:48
54899d810dfb892558699ddbd5f724a358dc96e1...62954ba04c86c4cea3b17a872ba6a0837730e17d,3,22,5,27,6,2012-08-20 20:50:49,2012-08-20 20:45:13
62954ba04c86c4cea3b17a872ba6a0837730e17d...831f2846dd9b3a93344e3c5cb3ea57d76317ae2c,1,2,2,4,2,2012-08-20 21:27:28,2012-08-20 21:27:28
831f2846dd9b3a93344e3c5cb3ea57d76317ae2c...e89bc39935afc5096e6a51a49874b2d30cbc2b5e,2,4,6,10,4,2012-08-21 07:00:55,2012-08-21 06:44:16
e89bc39935afc5096e6a51a49874b2d30cbc2b5e...ab2f65bb7f9083b5fac777f5e3b7872c58837f4f,2,0,4,4,2,2012-08-21 09:20:22,2012-08-21 09:20:22
44767f2caf028d89e1a283d04bb552d0e18bb936...b946db5241b924c72c1079ce30d9b368e2b82f07,6,29,3,32,7,2012-09-27 13:06:58,2012-09-27 13:06:58
44767f2caf028d89e1a283d04bb552d0e18bb936...901af865505310a70dd02ea5b3becbf45819b652,3,34,1,35,4,2012-09-19 16:06:53,2012-09-19 16:06:53
901af865505310a70dd02ea5b3becbf45819b652...4e9a74b81df1c7aaea2f90a3a4911920e134b275,3,1,34,35,4,2012-09-19 17:15:12,2012-09-19 17:15:12
4e9a74b81df1c7aaea2f90a3a4911920e134b275...1360bd4186239d7e4c4481b7d6a1a650fe69d12f,1,11,2,13,2,2012-09-19 19:09:49,2012-09-19 11:13:10
1360bd4186239d7e4c4481b7d6a1a650fe69d12f...acd74ffa358a64861fae8fd7bf020fc3a50341b2,1,11,1,12,2,2012-09-19 21:59:47,2012-09-19 20:36:34
acd74ffa358a64861fae8fd7bf020fc3a50341b2...0fdfcee257155ad29ff161725d94f41f0e77691f,1,3,0,3,1,2012-09-19 22:00:14,2012-09-19 20:09:46
0fdfcee257155ad29ff161725d94f41f0e77691f...3ae397a98c427a56717a20933d76ade97bfb0886,1,5,0,5,1,2012-09-20 07:40:18,2012-09-20 07:36:48
3ae397a98c427a56717a20933d76ade97bfb0886...7e32dab3a64570c67993d38b5bc25c9bd1f7455e,2,34,4,38,6,2012-09-20 08:12:47,2012-09-20 08:08:08
7e32dab3a64570c67993d38b5bc25c9bd1f7455e...89136b2725db3cb774ae4b39849684ae8f3847aa,2,3,1,4,3,2012-09-20 08:31:37,2012-09-20 08:31:37
7441a29f52046c96c072e1ae1f21d0be488b5a76...18255779e9711354372085179d7bf94d803b6895,1,8,1,9,1,2013-04-10 05:39:36,2013-04-10 05:39:36
18255779e9711354372085179d7bf94d803b6895...118faa0893957bff0ac34765fc9a66c586c4a932,1,3,3,6,3,2013-04-10 08:16:15,2013-04-10 08:16:15
118faa0893957bff0ac34765fc9a66c586c4a932...e7b9c11c3f87e235e643c340d38325fbd4257047,2,35,36,71,5,2013-04-10 11:05:29,2013-04-10 08:43:19
e7b9c11c3f87e235e643c340d38325fbd4257047...68d6c52ed63d2b3f4834cd3138a487fe5f6c1fc7,1,61,20,81,9,2013-04-11 00:11:26,2013-04-11 00:11:26
68d6c52ed63d2b3f4834cd3138a487fe5f6c1fc7...c852d4568186b9a23af510762acb94003fc83e65,1,66,63,129,36,2013-04-11 00:38:25,2013-04-11 00:38:25
c852d4568186b9a23af510762acb94003fc83e65...fe01404bb9f276446fc42390242da25122f91663,4,22,4,26,6,2013-04-11 08:38:24,2013-04-11 08:36:12
fe01404bb9f276446fc42390242da25122f91663...ddfc68379f47af18b90068f17e9a1f7e7cbfb505,1,1,1,2,1,2013-04-11 09:01:17,2013-04-11 09:01:17
e7514e4978178ba68a872ac0004dd6f8049f3d76...76aecfbc4b49f5ab0613cccff1df6fab03253fab,7,43,12,55,12,2013-03-23 16:11:10,2013-03-23 15:09:56
76aecfbc4b49f5ab0613cccff1df6fab03253fab...f670cce9f53984277a8ca3b191f162bebab19ea9,1,1,1,2,1,2013-03-23 19:00:18,2013-03-23 19:00:18
e7514e4978178ba68a872ac0004dd6f8049f3d76...6985f0c09bdf87509a1ca3c98f7ba45a7a9dbc0c,1,5,4,9,2,2013-03-23 15:22:44,2013-03-23 15:15:10
d384878cc1a73047e79d1a8c4bd924ad39ef8899...f5dbb566ee07bf3328015c70574b832052b4ebb7,1,1,4,5,2,2013-03-24 09:57:38,2013-03-24 09:57:38
f5dbb566ee07bf3328015c70574b832052b4ebb7...ae417dd4d569669e8e1d8f15e643c6ba0820aafe,2,26,1,27,5,2013-03-24 12:13:19,2013-03-24 12:08:29
ae417dd4d569669e8e1d8f15e643c6ba0820aafe...e16c48e001ccd06830bb0bfd1d20e22ec30fce59,6,37,7,44,9,2013-03-24 12:47:01,2013-03-24 12:47:01
e16c48e001ccd06830bb0bfd1d20e22ec30fce59...e12aad2d57f76f8acbc369feb257cea342cc30c8,1,4,4,8,3,2013-03-24 13:30:04,2013-03-24 13:30:04
e12aad2d57f76f8acbc369feb257cea342cc30c8...bc35b95274e0c98c09cf5db5407c0d43f2a1d362,2,5,5,10,5,2013-03-24 14:27:50,2013-03-24 14:27:27
9dde0dc631f10cea1e7e086b48b18585f5985c3f...fd3a066ae319956d14a35445d83293fecdfdcce7,1,0,23,23,1,2013-02-20 02:05:02,2013-02-20 02:05:02
fd3a066ae319956d14a35445d83293fecdfdcce7...ae2d04f7265bd804e82c601e9cbb52965c564418,2,30,4,34,6,2013-02-20 12:48:49,2013-02-19 16:01:29
ae2d04f7265bd804e82c601e9cbb52965c564418...8bbca211b6d4457e2f7acc3d41e54373f03ecddd,6,7623,4415,12038,1122,2013-02-20 12:52:15,2013-02-18 21:02:33
8bbca211b6d4457e2f7acc3d41e54373f03ecddd...4246fe6006090c08dcb2966889f74f48c80c5e65,2,9,9,18,5,2013-02-20 12:54:59,2013-02-18 21:51:58
4246fe6006090c08dcb2966889f74f48c80c5e65...cb5545ea2d747e2457221a03e985ef9b4a79ee2e,2,2,2,4,2,2013-02-20 13:16:00,2013-02-20 13:16:00
cb5545ea2d747e2457221a03e985ef9b4a79ee2e...b55cde054ee7dd22f93c3522a8ddb1d04193bcac,6,57,8,65,12,2013-02-20 19:27:32,2013-02-20 19:27:32
b55cde054ee7dd22f93c3522a8ddb1d04193bcac...3fef304ff237fe692459c1f5b840acf7886c50bb,3,37,55,92,18,2013-02-20 19:34:01,2013-02-19 02:21:29
3fef304ff237fe692459c1f5b840acf7886c50bb...edf93127bf2f9dc35b45cdea5d39a1b417ab1638,3,34,18,52,10,2013-02-20 19:43:44,2013-02-19 02:47:47
edf93127bf2f9dc35b45cdea5d39a1b417ab1638...10f9ba046f6122414fe5501934b6e080c3554a85,1,7,23,30,3,2013-02-20 19:45:36,2013-02-19 10:46:11
10f9ba046f6122414fe5501934b6e080c3554a85...e8fc3f3783744e4fcd3ff0ac43e3ce2572292f3a,2,10,2,12,3,2013-02-20 19:45:36,2013-02-20 19:09:27
e8fc3f3783744e4fcd3ff0ac43e3ce2572292f3a...4e36e0a8b34e5ac58a6b3c1444a999d9b257203b,1,2,2,4,1,2013-02-20 21:09:40,2013-02-20 21:08:33
4e36e0a8b34e5ac58a6b3c1444a999d9b257203b...50677b29af39ca670274fb45087415c883c78b04,4,21,22,43,7,2013-02-20 21:56:57,2013-02-20 01:08:55
50677b29af39ca670274fb45087415c883c78b04...649118961ce3952138536235fc842921e39bfa33,1,3,1,4,1,2013-02-20 23:32:35,2013-02-20 23:32:35
649118961ce3952138536235fc842921e39bfa33...3c6318e831658b88ba7c3e04f315329071b25e34,3,35,5,40,5,2013-02-21 10:01:23,2013-02-21 09:12:08
3c6318e831658b88ba7c3e04f315329071b25e34...5488437ab69cde9161d3de3ffb4ba5eff1111792,2,39,64,103,18,2013-02-21 20:26:40,2013-02-21 20:26:06
5488437ab69cde9161d3de3ffb4ba5eff1111792...f13bfbec70e096f230e3dcda88a2cb215e7f8899,2,3,1,4,2,2013-02-22 18:19:33,2013-02-22 18:08:35
f13bfbec70e096f230e3dcda88a2cb215e7f8899...60fff6fc9496c7c851182dd6ebac10bb011be2ba,2,6,1,7,3,2013-02-22 21:02:53,2013-02-22 20:52:20
60fff6fc9496c7c851182dd6ebac10bb011be2ba...09fcb70c804b76fccc8fc0ac545873e5ab30c00a,2,4,3,7,3,2013-02-22 22:05:31,2013-02-22 22:00:41
09fcb70c804b76fccc8fc0ac545873e5ab30c00a...ce094e570e0ff085b88b2303e25124331f558e45,1,2,1,3,1,2013-02-22 22:27:39,2013-02-22 22:27:39
58a2fc820eba04a24c7cc6d4c66b5aea6abe8c5a...bd669e47d7331ee41f929486e48ed39ad7bec1a7,1,11,5,16,3,2013-02-26 21:46:46,2013-02-26 21:46:46
bd669e47d7331ee41f929486e48ed39ad7bec1a7...5c51d71f9ae40f002530d9f4f2f477abaa76d78d,1,2,0,2,1,2013-02-26 22:08:39,2013-02-26 22:07:56
5c51d71f9ae40f002530d9f4f2f477abaa76d78d...dfa9324966ce1a38346d15e35805d042848aabf1,5,67,14,81,8,2013-02-27 00:31:53,2013-02-12 16:58:49
dfa9324966ce1a38346d15e35805d042848aabf1...8459eac031b3f0737857facae4aeb2e937b3d9f9,3,26,25,51,4,2013-02-27 01:07:22,2013-02-27 01:07:22
8459eac031b3f0737857facae4aeb2e937b3d9f9...f0bd55392244130821c4e9210b23135ddb0cf790,1,11,22,33,10,2013-02-27 01:30:49,2013-02-27 01:27:35
f0bd55392244130821c4e9210b23135ddb0cf790...a28e2e7c4d84a94ad8c243cbca53786bd7e60971,2,4,0,4,1,2013-02-27 01:45:08,2013-02-27 01:45:08
a28e2e7c4d84a94ad8c243cbca53786bd7e60971...40b9f4fb8bc9140876be7ab539c30e613a8898ee,4,16,15,31,16,2013-02-27 09:02:07,2013-02-27 03:26:15
40b9f4fb8bc9140876be7ab539c30e613a8898ee...210894167799780283101636c99d8010b30bf09c,3,290,66,356,4,2013-02-27 12:13:55,2013-02-27 12:12:37
210894167799780283101636c99d8010b30bf09c...50328f0a618674b7143d86acaa7016c5293e9774,12,161,69,230,53,2013-02-27 15:54:27,2013-02-20 01:11:54
50328f0a618674b7143d86acaa7016c5293e9774...59a352087591a26023412cbcb830cd1d34fc9b99,10,147,100,247,41,2013-02-27 16:26:54,2013-02-26 13:53:34
59a352087591a26023412cbcb830cd1d34fc9b99...1b100d7beed757246df1da8417590a6f2aabc2bc,1,7,2,9,2,2013-02-27 18:24:23,2013-02-27 18:24:23
1b100d7beed757246df1da8417590a6f2aabc2bc...b2c697b02911e6d02455e27afd33747f793103b6,1,1,1,2,1,2013-02-27 20:09:27,2013-02-27 20:09:27
b2c697b02911e6d02455e27afd33747f793103b6...7aaa8a7779f454c670448c580c8fa36cb37649d3,1,2,2,4,2,2013-02-27 20:12:48,2013-02-27 20:12:48
7aaa8a7779f454c670448c580c8fa36cb37649d3...b0ba21db0721a9dbc6b98e1760fad64c7c86ff91,1,1,1,2,1,2013-02-27 20:30:54,2013-02-27 20:28:55
58a2fc820eba04a24c7cc6d4c66b5aea6abe8c5a...fba6df19b5d7076e6858b3bd773911a529d60b30,1,1,1,2,1,2013-02-26 21:28:47,2013-02-26 21:28:47
2a0e4c249f30ef591c8b1ca36e9e1f38bf3395b4...6ebf115206289bce8f3d86318871faac13d6e835,3,50,5,55,9,2012-11-28 16:17:10,2012-11-28 16:16:00
6ebf115206289bce8f3d86318871faac13d6e835...cc3c4a9d55e765cfe664e3dbd58201de99232096,4,48,10,58,10,2012-11-28 21:34:02,2012-11-28 21:31:13
cc3c4a9d55e765cfe664e3dbd58201de99232096...163b471e9ea13e3d9984bde9aad2694646bb8997,1,6,6,12,4,2012-11-28 21:44:50,2012-11-28 21:44:50
163b471e9ea13e3d9984bde9aad2694646bb8997...514ce1d35f8ed0f82484ddbc5039e6d927d646b7,2,2,2,4,2,2012-11-28 23:28:30,2012-11-28 23:28:30
2a0e4c249f30ef591c8b1ca36e9e1f38bf3395b4...a8495fb188ff77b605dc7dabbe5248644805e3eb,3,3,3,6,3,2012-11-28 13:19:05,2012-11-28 13:19:05
17fb5768e0d5442ddef1ad0b0eefb2f5c6be1319...0073f1d94fad3f04ed77e63984cfd7827f78e580,1,1,1,2,1,2013-08-21 14:50:08,2013-08-21 14:49:50
38d2e7c22592f8c06fb961cfaee2f8309857e7c0...d179fc72cfafb32dee9f52aec9c1a94fff51ef07,1,3,3,6,6,2013-09-06 19:23:29,2013-09-06 19:23:29
d179fc72cfafb32dee9f52aec9c1a94fff51ef07...c7c19ac4080a533ef881b57e88e1efbc2882f7d2,1,4,0,4,1,2013-09-06 19:27:40,2013-09-06 19:27:40
122020fdb93980df850ae02f61d97da27e2cb515...73f38eb4d15d3da4707d8637178334c2f105ca19,1,1,4,5,1,2013-09-06 22:15:23,2013-09-06 22:06:58
73f38eb4d15d3da4707d8637178334c2f105ca19...b4cd8169de604943f8aaee3666282c95e650e5f4,3,15,1,16,6,2013-09-06 22:15:23,2013-09-06 22:13:51
a5bcc09c8f2b0c1cc06a6039a700fbf6103656f7...af67b93c02610739d9421b0e503e33c547371765,1,70,75,145,24,2013-09-06 18:44:40,2013-09-06 18:44:40
630eb0564abd228da439d86ad93acb4089d795e7...b79df0b35861400f573e74d0305d7298c221e7ff,3,48,22,70,3,2013-09-06 21:27:34,2013-09-06 21:25:34
b79df0b35861400f573e74d0305d7298c221e7ff...d0051308450880dbc2df6de96a6d1aab954df000,1,1,1,2,1,2013-09-06 22:20:43,2013-09-06 22:20:43
630eb0564abd228da439d86ad93acb4089d795e7...9b7f4aab326067a3ad503887a4e42c9d76d0bc25,5,21,0,21,7,2013-09-06 20:50:18,2013-09-06 20:50:18
9b7f4aab326067a3ad503887a4e42c9d76d0bc25...e12de0ac0485d8799d08fda556b66399c6f89fc9,1,0,2,2,1,2013-09-06 22:04:58,2013-09-06 22:04:58
630eb0564abd228da439d86ad93acb4089d795e7...d8d61d8260badd87b85accaf5776587f2d355c10,2,22,1,23,3,2013-09-06 20:23:27,2013-09-06 15:56:48
d8d61d8260badd87b85accaf5776587f2d355c10...c72392dab4b4cf6f5d9b35a3dcb582fbfe38ebb8,1,32,8,40,6,2013-09-06 20:33:23,2013-09-06 15:56:06
c72392dab4b4cf6f5d9b35a3dcb582fbfe38ebb8...076cf131ec8084ce6d9cc3a05b0f4bcc167d6cbc,1,4,4,8,2,2013-09-06 20:33:23,2013-09-06 19:24:55
076cf131ec8084ce6d9cc3a05b0f4bcc167d6cbc...ca3ac4a3e37cc844bef7f7553c6b1a6cc642e6e6,1,45,2,47,4,2013-09-06 22:26:13,2013-09-06 21:35:21
ca3ac4a3e37cc844bef7f7553c6b1a6cc642e6e6...0ac5e8d8e945b2232333fd777e7684c4c2c68316,1,1,0,1,1,2013-09-06 22:26:13,2013-09-06 21:57:32
0ac5e8d8e945b2232333fd777e7684c4c2c68316...9587d4eea09bc8d8a852dfb24c2a9227c74fd8ad,2,7,7,14,7,2013-09-06 22:26:13,2013-09-06 22:22:04
9587d4eea09bc8d8a852dfb24c2a9227c74fd8ad...01a5359477fbc82488dddf9476581fe72c049b51,5,10,8,18,9,2013-09-06 22:45:31,2013-09-06 22:36:05
630eb0564abd228da439d86ad93acb4089d795e7...eade315da1c8372ac1dfcf1fd20ea87f454d71ac,7,40,1,41,10,2013-09-06 16:31:17,2013-09-06 16:18:16
eade315da1c8372ac1dfcf1fd20ea87f454d71ac...b69d1eac641433dba3d6e505261f9ad7db384bd7,1,62,62,124,30,2013-09-06 17:04:13,2013-09-06 15:52:13
9dcd537b72f402f6ff986add7a03305e7d6b3f56...31e16c1343cf0d0d65e9d6e86c61bbcd7bd5fd76,1,2,2,4,1,2013-09-07 18:48:37,2013-09-07 18:48:24
31e16c1343cf0d0d65e9d6e86c61bbcd7bd5fd76...e192739b3e3209a371a5d0f5f05fd083e88259f2,1,3,1,4,1,2013-09-07 19:08:54,2013-09-07 19:08:54
e192739b3e3209a371a5d0f5f05fd083e88259f2...04415bf81b2440a08fc224e6c481bcb5840bbcbc,5,42,3,45,9,2013-09-07 19:53:29,2013-09-06 20:28:48
04415bf81b2440a08fc224e6c481bcb5840bbcbc...e4b012feebac7e9b8619e54791fd9bba2f6930b6,1,13,4,17,3,2013-09-07 20:10:07,2013-09-07 20:10:07
e4b012feebac7e9b8619e54791fd9bba2f6930b6...c348550d35276008018a42c002251b0e2fe9cfe1,1,6,6,12,6,2013-09-07 22:36:00,2013-09-07 22:35:55
c348550d35276008018a42c002251b0e2fe9cfe1...b11564fd36587b1077bf7d77b62b7879cc08c382,2,32,7,39,2,2013-09-08 00:00:38,2013-09-07 20:58:32
b11564fd36587b1077bf7d77b62b7879cc08c382...ded11aa620e5b38c78ff92e691a459d1977a2539,2,30,2,32,7,2013-09-08 07:04:43,2013-09-07 23:56:49
ded11aa620e5b38c78ff92e691a459d1977a2539...fa7bc2467114e0a5e3551eece515795255ef308b,1,6,6,12,3,2013-09-08 09:23:37,2013-09-08 09:23:37
fa7bc2467114e0a5e3551eece515795255ef308b...0ee8aa5c3908e2f8f8408083ff213e6e5eed4d4d,1,0,2,2,2,2013-09-08 14:42:16,2013-09-08 14:42:16
0ee8aa5c3908e2f8f8408083ff213e6e5eed4d4d...96fd5557f93ba3aa89a40f474014308cc44cca0d,18,47,68,115,56,2013-09-08 15:05:16,2013-09-08 15:05:16
96fd5557f93ba3aa89a40f474014308cc44cca0d...1a1e14786aa35b4d80b46be747b5128800cf0f97,1,5,1,6,2,2013-09-08 17:40:42,2013-09-08 17:38:12
1a1e14786aa35b4d80b46be747b5128800cf0f97...c687bf0620d67e0579302515904ffe169581d036,1,2,2,4,2,2013-09-08 18:43:04,2013-09-08 18:43:04
c687bf0620d67e0579302515904ffe169581d036...9d11522599bb9f9fd6ad22c15c6168a4f2ac9b4e,14,56,56,112,45,2013-09-08 19:20:01,2013-09-08 19:20:01
9d11522599bb9f9fd6ad22c15c6168a4f2ac9b4e...28a571348bca9c5a3c137e495e7d3c9349a5bd56,3,17,5,22,5,2013-09-08 20:05:35,2013-09-08 13:07:12
11699ac4b5f98ec11dba02b356a8fd4ab6b4b889...2249bd275cbae6b73716bf36f5f36def1bb4222e,3,19,4,23,6,2012-10-27 02:26:42,2012-10-27 01:51:14
2249bd275cbae6b73716bf36f5f36def1bb4222e...c159d9cec0baab7bbd04d5d51a92a51e354a722a,1,9,2,11,1,2012-10-27 02:26:53,2012-10-27 01:52:12
c159d9cec0baab7bbd04d5d51a92a51e354a722a...a5152bb64677fb9b976f6b35e80b11b368ef1e08,1,13,2,15,3,2012-10-27 15:34:18,2012-10-27 15:10:02
a5152bb64677fb9b976f6b35e80b11b368ef1e08...b55de81b9e4d820a223c066022050a0df0ee1dd0,1,1,1,2,1,2012-10-27 15:34:47,2012-10-27 15:10:41
11699ac4b5f98ec11dba02b356a8fd4ab6b4b889...373df56d36891b9ab1f88519bf9e8f3c0b3bb108,2,16,4,20,4,2012-10-27 01:01:34,2012-10-27 01:01:34
456d6c15dbbfc81c355e790c15cda3c28205123e...572a300e56bc0192a9c82565a1d39b96f18bebee,6,40,22,62,12,2013-03-27 15:37:47,2013-03-25 04:34:46
572a300e56bc0192a9c82565a1d39b96f18bebee...87f48607184ca3688ad1c0376aa0bfe27668c63b,3,39,0,39,3,2013-03-27 16:52:40,2013-03-27 16:23:59
87f48607184ca3688ad1c0376aa0bfe27668c63b...9a41045b77c05ea62c49e1bd6f29ebbee7f36954,1,9,0,9,2,2013-03-27 17:21:26,2013-03-27 17:05:31
9a41045b77c05ea62c49e1bd6f29ebbee7f36954...bec250211b0665cfb38b8f2cb6c30a0ca17da7bf,1,4,2,6,2,2013-03-27 22:03:12,2013-03-27 22:01:11
bec250211b0665cfb38b8f2cb6c30a0ca17da7bf...ebac592a83c1f7c231b6cb1e05049ce53bb9347b,56,303,238,541,252,2013-03-28 08:22:57,2013-03-27 22:14:41
ebac592a83c1f7c231b6cb1e05049ce53bb9347b...d7eaadb4f810e9790d01dae99d218415c8b673a2,2,29,0,29,2,2013-03-28 20:07:43,2013-03-28 20:02:35
d7eaadb4f810e9790d01dae99d218415c8b673a2...2847ae66653831bc7e413a26c9310c24c1c6fae2,3,3,3,6,3,2013-03-28 20:12:39,2013-03-28 20:12:39
2847ae66653831bc7e413a26c9310c24c1c6fae2...1cf4968cc5503aeffd663f6472215ba5f8feeaf5,1,1,1,2,1,2013-03-28 21:07:32,2013-03-28 21:07:32
1cf4968cc5503aeffd663f6472215ba5f8feeaf5...56d4356d8cb6e683c354a4b8f22a17d37624d6e8,1,2,2,4,2,2013-03-28 21:45:30,2013-03-28 01:51:44
56d4356d8cb6e683c354a4b8f22a17d37624d6e8...149150deb128b1a5df8b5c1f8756abf589d53422,2,20,19,39,17,2013-03-29 11:59:50,2013-03-29 11:57:07
149150deb128b1a5df8b5c1f8756abf589d53422...d1b7bd030b1db111e1a3505b1fc029ab964382cc,8,13,13,26,13,2013-03-29 12:00:24,2013-03-28 17:16:53
d1b7bd030b1db111e1a3505b1fc029ab964382cc...28cb46befb012cbb90744ca68da1d552bb9475ce,1,3,3,6,1,2013-03-29 12:01:38,2013-03-25 12:12:53
28cb46befb012cbb90744ca68da1d552bb9475ce...1d620fb957ea557aa6e4420b037a5262b4edcb67,1,1,1,2,1,2013-03-29 19:55:23,2013-03-29 19:31:56
1d620fb957ea557aa6e4420b037a5262b4edcb67...abaab6ef48f262d47f018eeae66ad616697d8479,1,28,0,28,1,2013-03-29 20:50:33,2013-03-29 20:46:35
abaab6ef48f262d47f018eeae66ad616697d8479...1c42a3ec736f55b79bc1a7b4cad4cbe65b9cb27e,6,141,11,152,8,2013-03-30 11:03:33,2013-03-04 11:05:11
1c42a3ec736f55b79bc1a7b4cad4cbe65b9cb27e...c3779d42142eb83eb8694177a12066261b3243aa,21,342,483,825,61,2013-03-30 11:12:37,2013-03-07 19:15:39
c3779d42142eb83eb8694177a12066261b3243aa...29c77c5ed242b2f4aab029b86128afd83eabcdfa,1,10,6,16,5,2013-03-30 11:49:21,2013-03-27 05:59:05
29c77c5ed242b2f4aab029b86128afd83eabcdfa...ed3dd2759e7a95f3a0933782212dcb644c32a8c4,1,2,1,3,1,2013-03-30 12:38:28,2013-03-30 12:36:31
ed3dd2759e7a95f3a0933782212dcb644c32a8c4...999817375b705cddc1377dd453c89dec71688300,1,8,0,8,1,2013-03-30 20:22:43,2013-03-30 20:21:59
999817375b705cddc1377dd453c89dec71688300...a825b1903d355f8f7f41123fc36deb71d98db665,1,2,2,4,1,2013-03-31 07:41:44,2013-03-31 07:40:44
a825b1903d355f8f7f41123fc36deb71d98db665...930cd8eebb947239c84e8fd1c71294441c5abea3,1,8,4,12,1,2013-03-31 08:01:05,2013-03-31 07:59:34
930cd8eebb947239c84e8fd1c71294441c5abea3...405d6208e55a3db4d82f2f9b1898b8e481688e96,1,4,1,5,1,2013-03-31 08:35:48,2013-03-31 08:34:28
405d6208e55a3db4d82f2f9b1898b8e481688e96...a15a3e9148e9707f8ab3477be512546e7cf73607,2,39,1,40,2,2013-04-01 19:07:58,2013-03-31 07:54:52
a15a3e9148e9707f8ab3477be512546e7cf73607...d04e8f8c7869b79a6f848a94bd51ce71223c2df2,2,5,2,7,3,2013-04-05 19:21:59,2013-04-05 17:59:15
d04e8f8c7869b79a6f848a94bd51ce71223c2df2...82b5e10e6174d98564d2044da7202e9ed06529b6,1,67,64,131,36,2013-04-11 00:41:03,2013-04-11 00:38:25
82b5e10e6174d98564d2044da7202e9ed06529b6...427b59495e7e2a1c58a46d278f6decec1d37938c,4,22,4,26,6,2013-04-11 08:58:06,2013-04-11 08:36:12
427b59495e7e2a1c58a46d278f6decec1d37938c...93231851f8dd4e1882f601de9086d7aaf46b93a9,1,1,1,2,1,2013-04-11 17:39:29,2013-04-11 13:27:14
93231851f8dd4e1882f601de9086d7aaf46b93a9...709ee83cd3ccbaeabcfcbb9391bb72d1bcaf01d3,1,7,8,15,1,2013-04-11 18:17:19,2013-04-11 18:13:09
709ee83cd3ccbaeabcfcbb9391bb72d1bcaf01d3...991432ee8ab49eca76113f0b6c23e885ea316507,1,13,0,13,1,2013-04-12 08:18:24,2013-04-12 08:13:38
991432ee8ab49eca76113f0b6c23e885ea316507...9c49e64b66994ff25980d9d0d21ce3599b17cc4b,3,42,18,60,5,2013-04-12 08:25:44,2013-04-06 14:04:30
9c49e64b66994ff25980d9d0d21ce3599b17cc4b...8ab5db7a3348b7890eae5db20e48f820bf09c81c,1,4,3,7,1,2013-04-12 10:11:22,2013-04-12 10:10:26
8ab5db7a3348b7890eae5db20e48f820bf09c81c...abdcf818431525ec1c1165b9351cc16c5c5fa1c6,2,18,7,25,7,2013-04-12 18:16:35,2013-04-12 18:00:49
abdcf818431525ec1c1165b9351cc16c5c5fa1c6...991ce52bc872f827de8e7b5b441e2dfa2185bfd2,1,3,0,3,1,2013-04-12 19:01:52,2013-04-12 18:59:56
991ce52bc872f827de8e7b5b441e2dfa2185bfd2...6e3b80239e9a066ac2e9d10212196acbc2e6d35c,2,14,13,27,6,2013-04-12 23:25:59,2013-04-12 23:22:02
6e3b80239e9a066ac2e9d10212196acbc2e6d35c...9176fa70c1541d29d4d1865770d48b174e5dd968,1,6,2,8,2,2013-04-14 17:08:50,2013-04-14 17:08:45
9176fa70c1541d29d4d1865770d48b174e5dd968...19ad7231da25ac944a3515d61b0fe3cc83f2992a,1,1,1,2,1,2013-04-15 16:22:51,2013-04-15 16:19:17
19ad7231da25ac944a3515d61b0fe3cc83f2992a...56f6348c5071c1a1aaea989a16d5055d24ab6740,1,1,1,2,1,2013-04-15 20:28:30,2013-04-15 20:23:35
56f6348c5071c1a1aaea989a16d5055d24ab6740...807264ed8d04f3ef2755f68f581cf5f0d03817dc,1,1,1,2,1,2013-04-16 07:00:57,2013-04-16 06:58:39
807264ed8d04f3ef2755f68f581cf5f0d03817dc...d8d498347f8144ec075e76e57303e839ac9ab452,1,1,1,2,1,2013-04-18 17:42:46,2013-04-18 17:40:45
d8d498347f8144ec075e76e57303e839ac9ab452...4376a6452471e633a4373db097b118b2aeb58f33,1,2,2,4,2,2013-04-18 17:45:27,2013-04-18 17:44:20
4376a6452471e633a4373db097b118b2aeb58f33...6bb8df0a982bb394f2cf33cfc9d9d71589515801,1,8,3,11,5,2013-04-22 18:03:21,2013-04-22 17:04:28
6bb8df0a982bb394f2cf33cfc9d9d71589515801...da89c7bbc0ad1a2e06caabf9e25acc700a43c37f,1,1,1,2,1,2013-04-24 03:15:08,2013-04-23 15:10:25
da89c7bbc0ad1a2e06caabf9e25acc700a43c37f...399ceaab96d3b9724a63faea13d7fc153325516a,1,17,15,32,5,2013-04-24 07:27:36,2013-04-24 07:27:03
399ceaab96d3b9724a63faea13d7fc153325516a...240649ef6853b0a60dc70efffc48dcf08487eaff,1,1,1,2,1,2013-04-24 07:41:30,2013-04-24 07:41:06
240649ef6853b0a60dc70efffc48dcf08487eaff...8b345614cd39514cc1efe271c3b73c6130801fb3,3,19,19,38,19,2013-04-25 08:38:18,2013-04-25 08:32:27
8b345614cd39514cc1efe271c3b73c6130801fb3...4391718f26466f82f943e37368181d5c0520fa35,5,62,52,114,17,2013-05-01 11:52:38,2013-04-03 10:42:33
4391718f26466f82f943e37368181d5c0520fa35...4f10b35a2e4012512ae57cadd19f34ec8d4979a1,1,2,2,4,1,2013-05-04 09:36:28,2013-05-04 09:36:28
4f10b35a2e4012512ae57cadd19f34ec8d4979a1...0b0d98fd4ed2929a34d6540549baf96ed6c1910f,1,4,3,7,2,2013-05-05 14:14:41,2013-05-01 14:40:49
0b0d98fd4ed2929a34d6540549baf96ed6c1910f...0fc4c405a4985de92dde6e8088cd5773a72b2294,1,1,0,1,1,2013-05-06 10:54:10,2013-05-06 10:19:52
0fc4c405a4985de92dde6e8088cd5773a72b2294...1ef423b003c9ead08a00fdba54507e95539a5734,1,8,2,10,3,2013-05-06 17:46:27,2013-05-06 17:45:24
1ef423b003c9ead08a00fdba54507e95539a5734...acd9dc3888aa8af881b917028062c3bdca6e610c,2,15,4,19,4,2013-05-06 17:56:48,2013-05-06 17:55:02
acd9dc3888aa8af881b917028062c3bdca6e610c...23b234a9d9ea26acb9bb12ba14231ce8844d2e53,3,20,3,23,6,2013-05-07 19:36:51,2013-05-06 03:32:07
23b234a9d9ea26acb9bb12ba14231ce8844d2e53...b5d6a5b21a2af4f0b4c3e8e3ca4b44e77812d996,1,2,2,4,2,2013-05-10 08:18:27,2013-05-08 10:56:50
b5d6a5b21a2af4f0b4c3e8e3ca4b44e77812d996...6d3d6081e83295b4d0af8d4dbcf388bebc33ba41,3,15,4,19,5,2013-05-10 08:23:15,2013-05-05 17:44:43
6d3d6081e83295b4d0af8d4dbcf388bebc33ba41...b41ad878732c45bf178818c2ae9cc9cb9e5a0e5a,1,1,1,2,1,2013-05-10 11:24:25,2013-05-10 11:23:32
b41ad878732c45bf178818c2ae9cc9cb9e5a0e5a...13de270bd52d057584023de08ea869722a7e5d5a,2,77,70,147,20,2013-05-11 23:11:55,2013-05-11 23:08:57
13de270bd52d057584023de08ea869722a7e5d5a...18a2fb19074ce6789639b62710c279a711dabf97,2,41,4,45,2,2013-05-11 23:37:09,2013-05-11 23:34:02
18a2fb19074ce6789639b62710c279a711dabf97...a9703edc618d90d2e08122b481608e3dafc3ab63,1,1,1,2,1,2013-05-13 00:16:31,2013-05-12 19:24:48
a9703edc618d90d2e08122b481608e3dafc3ab63...cac0f7b72e5d42239803df5338db03f1d19c22e6,1,3,1,4,1,2013-05-13 17:47:40,2013-05-13 17:43:28
cac0f7b72e5d42239803df5338db03f1d19c22e6...be6e7ff6ebda7acca71e32c2e7890c62e98ba81a,1,2,1,3,1,2013-05-13 18:07:37,2013-05-11 07:53:54
be6e7ff6ebda7acca71e32c2e7890c62e98ba81a...20bed77567dc04f7efa0b35a0f4e08d61c692535,1,1,1,2,1,2013-05-14 14:32:07,2013-05-14 10:40:33
20bed77567dc04f7efa0b35a0f4e08d61c692535...7f4269229cd6ca0ef94a34fd045e3ced9bdd57d0,1,16,12,28,6,2013-05-15 11:03:42,2013-05-15 00:25:45
7f4269229cd6ca0ef94a34fd045e3ced9bdd57d0...a9048c40edffd189e9b99699c5947e69f9ca15f1,1,4,3,7,1,2013-05-16 12:34:19,2013-05-16 09:55:21
a9048c40edffd189e9b99699c5947e69f9ca15f1...a3c4c170f42d4bb9574d1b1c0c5502c07e03fc4d,1,1,1,2,1,2013-05-16 13:58:00,2013-05-16 13:56:30
a3c4c170f42d4bb9574d1b1c0c5502c07e03fc4d...df5a8a07fc909e37016889bc1d37c53c90e747c5,1,26,3,29,3,2013-05-18 15:22:42,2013-05-18 15:20:02
df5a8a07fc909e37016889bc1d37c53c90e747c5...38fbc8384748140dc4b94818d38c0ecbb8fb77d5,1,4,2,6,2,2013-05-18 15:28:39,2013-05-18 15:16:07
38fbc8384748140dc4b94818d38c0ecbb8fb77d5...694f4ff9e28aac1ec0309fd379b4b53067c6c52f,1,14,2,16,1,2013-05-18 16:12:56,2013-05-18 16:05:35
694f4ff9e28aac1ec0309fd379b4b53067c6c52f...66005c643c806995ff8430f1b66a3fb779418de0,1,2,1,3,1,2013-05-19 15:34:25,2013-05-19 15:30:26
66005c643c806995ff8430f1b66a3fb779418de0...b3dc23a6d5c0057f738a2bdb00b033c6da07631b,2,27,15,42,12,2013-05-19 16:08:20,2013-05-19 16:06:35
b3dc23a6d5c0057f738a2bdb00b033c6da07631b...367089a846b7546c98e1c6543b36bfc3b19ee9e8,1,1,1,2,1,2013-05-20 12:04:46,2013-05-19 22:59:17
367089a846b7546c98e1c6543b36bfc3b19ee9e8...0eddedf7db782a05e098c7024a9056aef7283b81,3,21,20,41,9,2013-05-20 16:05:43,2013-05-20 15:45:24
0eddedf7db782a05e098c7024a9056aef7283b81...63cab03f6ddd9faa5a770ae08791b2a70aa0a578,1,7,13,20,4,2013-05-20 17:49:11,2013-05-20 17:45:32
63cab03f6ddd9faa5a770ae08791b2a70aa0a578...bac187c0d8e829fb3ca2ca82965eabbcbcb6ddd5,4,69,8,77,7,2013-05-21 08:45:24,2013-05-21 08:06:49
bac187c0d8e829fb3ca2ca82965eabbcbcb6ddd5...cb9aaac91fb41b29b3d0d94f3cd208123c02a2ca,2,41,5,46,4,2013-05-21 17:17:27,2013-05-21 05:17:56
cb9aaac91fb41b29b3d0d94f3cd208123c02a2ca...fa90ef250f9ee5aa4f2fd4bad02e4720e69b89c0,1,1,5,6,1,2013-05-21 17:21:52,2013-05-21 12:41:39
fa90ef250f9ee5aa4f2fd4bad02e4720e69b89c0...3f7ecb512eb39f1d6b633de7f4c635430298c891,1,1,1,2,1,2013-05-21 19:29:28,2013-05-21 19:29:14
3f7ecb512eb39f1d6b633de7f4c635430298c891...1add64684cef6877bf0faeb4a205be6ae07fc98e,4,98,4,102,4,2013-05-22 12:57:57,2013-05-22 11:57:36
1add64684cef6877bf0faeb4a205be6ae07fc98e...194eaceca758f70a612983d5cc8d64bfaf8f4b31,1,1,1,2,1,2013-05-22 13:43:01,2013-05-22 13:39:46
194eaceca758f70a612983d5cc8d64bfaf8f4b31...239b89950caa88902ee2303353742e5302dc0eb0,1,1,1,2,1,2013-05-22 14:26:39,2013-05-22 14:25:49
239b89950caa88902ee2303353742e5302dc0eb0...a6ff705aea7ffcfb5477ce8c94a6cc1cd70f4bb1,1,7,7,14,1,2013-05-22 21:09:22,2013-05-22 21:08:06
a6ff705aea7ffcfb5477ce8c94a6cc1cd70f4bb1...7df9c2bc7d6226b9f9ca7dd3da3f34c4b0482b06,1,1,1,2,1,2013-05-23 12:37:56,2013-05-23 12:36:53
7df9c2bc7d6226b9f9ca7dd3da3f34c4b0482b06...9ed2121eca0d4543dd665d7c5a3015beaee28eb4,1,2,1,3,1,2013-05-23 12:54:24,2013-05-23 12:52:55
9ed2121eca0d4543dd665d7c5a3015beaee28eb4...cd15a51c3eb2918107814e7c42533ebef982a431,1,12,3,15,2,2013-05-23 15:12:33,2013-05-23 14:57:44
cd15a51c3eb2918107814e7c42533ebef982a431...d6025d790f3f5ecc11981cb43e1e14f85adcdb4d,1,1,1,2,1,2013-05-24 16:25:48,2013-05-24 13:36:17
d6025d790f3f5ecc11981cb43e1e14f85adcdb4d...82fc3ce41db298ae4b191d4a15bddfaf02ea11af,1,1,3,4,2,2013-05-24 16:36:12,2013-05-24 16:35:20
82fc3ce41db298ae4b191d4a15bddfaf02ea11af...fd48d2d438ed6f58b9bae08b8866dd6e50dd673d,3,49,1,50,7,2013-05-24 21:20:44,2013-05-23 15:14:27
fd48d2d438ed6f58b9bae08b8866dd6e50dd673d...8f2eaab0e5dbcd9dd5cfa0b4eec2a9026b83d309,1,1,1,2,1,2013-05-27 09:16:27,2013-05-27 09:15:40
8f2eaab0e5dbcd9dd5cfa0b4eec2a9026b83d309...2e026739dcab545703160456503a1183c6c0702d,1,40,3,43,2,2013-05-28 12:43:05,2013-05-28 12:41:13
2e026739dcab545703160456503a1183c6c0702d...17d60438e9c5dff35e8abe311b1ea1ed06f8f98a,1,1,1,2,1,2013-05-28 15:59:41,2013-05-28 15:54:53
17d60438e9c5dff35e8abe311b1ea1ed06f8f98a...1ce5672753c004da1cbe3347e2c7f652b48251b2,1,2,0,2,1,2013-05-29 00:15:09,2013-05-29 00:14:01
1ce5672753c004da1cbe3347e2c7f652b48251b2...e873de0a5afe30b8ed4bb473d95413410433d6f3,1,2,0,2,1,2013-05-30 01:50:52,2013-05-29 22:33:51
e873de0a5afe30b8ed4bb473d95413410433d6f3...1c5cccedb46497daf90ff6e8e53d33680efa3b85,1,9,2,11,2,2013-05-31 12:08:42,2013-05-31 12:07:40
1c5cccedb46497daf90ff6e8e53d33680efa3b85...f7fefb361d044cac897bff86531281b2e2ead83e,1,3,1,4,2,2013-05-31 12:20:10,2013-05-31 12:18:29
f7fefb361d044cac897bff86531281b2e2ead83e...56192d21d5fde1b4085bb7a175e450f1e94ee962,1,1,1,2,1,2013-06-01 09:50:09,2013-06-01 09:48:38
56192d21d5fde1b4085bb7a175e450f1e94ee962...023710211f0ab9d914dc8967dc6c77b8b30c39a6,4,0,13,13,13,2013-06-03 14:14:29,2013-06-03 14:06:48
023710211f0ab9d914dc8967dc6c77b8b30c39a6...44a0abd7928b7f81a9b0e272b1dddd92f1913e0d,2,5,1,6,3,2013-06-08 14:14:45,2013-06-08 13:05:50
44a0abd7928b7f81a9b0e272b1dddd92f1913e0d...3bd9852401cfbc8a1dfec4082303a5514ee69bf4,2,28,0,28,3,2013-06-09 16:16:56,2013-06-06 18:15:26
3bd9852401cfbc8a1dfec4082303a5514ee69bf4...46dacb5bb157ff78e21c19f1f1b109edf378ddcb,3,16,0,16,3,2013-06-09 19:06:23,2013-06-09 19:05:15
46dacb5bb157ff78e21c19f1f1b109edf378ddcb...cd1aec65cc255d5ca6882a72714247d1106027c6,2,2,2,4,2,2013-06-10 18:37:38,2013-06-10 18:36:40
cd1aec65cc255d5ca6882a72714247d1106027c6...b75f1f3d27d06e5fe4fdcc8e74ec3e7caeff7704,1,7,1,8,2,2013-06-11 16:27:09,2013-06-11 16:25:39
b75f1f3d27d06e5fe4fdcc8e74ec3e7caeff7704...60353458ae7105ea943dc425954403c581b05255,4,37,9,46,7,2013-06-12 18:57:21,2013-06-03 13:53:04
60353458ae7105ea943dc425954403c581b05255...e65f0c255940f9f4ae5e3429e59f3d314104e1fc,1,2,2,4,2,2013-06-14 07:33:20,2013-03-13 17:16:27
e65f0c255940f9f4ae5e3429e59f3d314104e1fc...e411e9931272cd22247095fc2af8d26d58eeddd6,1,3,3,6,1,2013-06-15 01:29:20,2013-06-15 01:28:17
e411e9931272cd22247095fc2af8d26d58eeddd6...a952044228432fac8043b8f034b19296d308a44a,1,1,1,2,1,2013-06-17 11:01:48,2013-06-17 07:37:19
a952044228432fac8043b8f034b19296d308a44a...9d86550a70ccb84249f493cef74db4636f20c3f1,1,2,0,2,2,2013-06-18 11:26:41,2013-06-18 10:15:10
9d86550a70ccb84249f493cef74db4636f20c3f1...f171ed6b68ef6511268da314769c0ce6ef373f01,1,1,1,2,1,2013-06-19 08:39:01,2013-06-19 08:37:24
f171ed6b68ef6511268da314769c0ce6ef373f01...891d00335389734b68df3b9f663dee8aa327322e,1,3,3,6,3,2013-06-20 14:01:13,2013-06-20 01:02:25
891d00335389734b68df3b9f663dee8aa327322e...b5f8339211ba0c0c2b5bd8ce72b64f12b5547a61,1,1,1,2,1,2013-06-20 14:43:41,2013-06-20 14:41:29
b5f8339211ba0c0c2b5bd8ce72b64f12b5547a61...843802ec269d5c3676a7d3a021539008f8f5233d,1,3,2,5,2,2013-06-20 17:35:59,2013-06-20 17:34:02
843802ec269d5c3676a7d3a021539008f8f5233d...ee8996d8a6f8fc462a6e912bcf0cf80530704ab4,1,6,9,15,1,2013-06-21 15:53:10,2013-06-21 15:46:10
ee8996d8a6f8fc462a6e912bcf0cf80530704ab4...9b0604e5149e20fc98f07256af60eac87421a346,1,5,2,7,1,2013-06-21 17:16:51,2013-06-20 06:36:13
9b0604e5149e20fc98f07256af60eac87421a346...519fdacf5127540638f7c1b4a3656d9a31f16a8b,2,4,2,6,2,2013-06-21 19:00:06,2013-06-21 19:00:06
519fdacf5127540638f7c1b4a3656d9a31f16a8b...4821a99ca437496bbe660b5f16a61014816752fb,3,63,66,129,28,2013-06-22 22:29:59,2013-06-22 21:05:22
4821a99ca437496bbe660b5f16a61014816752fb...11a8a7f2660cd864b56061e32d74304b80da11ba,1,2,2,4,1,2013-06-24 04:11:08,2013-06-24 03:59:03
11a8a7f2660cd864b56061e32d74304b80da11ba...7e6c0387b32669babba91dca6538609330eb5e26,1,2,2,4,1,2013-06-24 11:03:29,2013-06-24 11:00:53
7e6c0387b32669babba91dca6538609330eb5e26...02619227a9271047c7d4b62a6aec744ca17f7270,1,13,9,22,7,2013-06-24 18:40:19,2013-06-24 17:48:23
02619227a9271047c7d4b62a6aec744ca17f7270...030ef4d1afe8c49da24ae7e6a1b8205041db8c61,1,3,3,6,3,2013-06-25 11:52:15,2013-06-25 05:40:56
030ef4d1afe8c49da24ae7e6a1b8205041db8c61...20295f278815598858ada0096324f77088a0df52,1,1,1,2,1,2013-06-27 07:44:17,2013-06-27 07:42:09
20295f278815598858ada0096324f77088a0df52...ceff19805e9624a37819c09bcbaa278cf2b8b08d,1,1,1,2,1,2013-06-27 21:53:54,2013-06-27 16:39:50
ceff19805e9624a37819c09bcbaa278cf2b8b08d...058ad52b3db97bd01e2a12e61799f77269839dc6,1,1,1,2,1,2013-06-27 22:03:39,2013-06-26 17:25:34
058ad52b3db97bd01e2a12e61799f77269839dc6...b91e138405b9c6547380717f93cbc34c62af7b95,1,5,4,9,3,2013-06-28 07:50:59,2013-04-21 13:52:02
b91e138405b9c6547380717f93cbc34c62af7b95...def1881370dad3bef7808c9ab00800d0b17e8b92,1,1,1,2,1,2013-06-28 07:52:25,2013-06-28 07:43:14
def1881370dad3bef7808c9ab00800d0b17e8b92...62a9abeff05e4af61878bff7ff615cd298cf0d7e,2,5,5,10,2,2013-06-29 18:17:38,2013-06-29 18:14:32
62a9abeff05e4af61878bff7ff615cd298cf0d7e...4453d8651af4579b3b83d873cadbda0707b7ab2a,1,7,0,7,1,2013-07-03 12:46:31,2013-07-03 12:44:03
4453d8651af4579b3b83d873cadbda0707b7ab2a...6151fdf930c9a513597e94fe8e8aee5e88c69ca1,2,24,6,30,7,2013-07-03 14:39:05,2013-07-03 06:13:38
6151fdf930c9a513597e94fe8e8aee5e88c69ca1...44df41e5fd151378aee2730c497f82e0db68666a,8,7,7,14,7,2013-07-03 14:39:26,2013-07-03 14:35:04
44df41e5fd151378aee2730c497f82e0db68666a...583f340d7dd52c6182530fd4ca798d01c4d93609,1,9,2,11,4,2013-07-03 15:12:04,2013-07-02 08:19:44
583f340d7dd52c6182530fd4ca798d01c4d93609...9c501e6638dce82b579fc769c52664246a336371,1,5,3,8,1,2013-07-04 09:45:34,2013-07-04 09:44:22
9c501e6638dce82b579fc769c52664246a336371...fa37f45c32c8fa7c6909b72e94b9d90e6efe7ed9,1,22,11,33,3,2013-07-04 12:34:00,2013-07-03 11:59:35
fa37f45c32c8fa7c6909b72e94b9d90e6efe7ed9...82a6a956d50edf1008b89b886090459d2e65ac1a,2,7,6,13,4,2013-07-04 13:33:40,2013-07-04 13:32:32
82a6a956d50edf1008b89b886090459d2e65ac1a...25d987b21e3af11b3ab3e37478a2dfd32f886d97,1,3,2,5,1,2013-07-04 14:20:09,2013-07-04 14:19:00
25d987b21e3af11b3ab3e37478a2dfd32f886d97...95aa2182b7878c1c64b1812b02caa38060ebcab4,2,27,1,28,3,2013-07-05 00:41:01,2013-07-05 00:41:01
95aa2182b7878c1c64b1812b02caa38060ebcab4...6c984587711f82c0fc5223bbf6e8bb3b71732a3e,1,16,2,18,2,2013-07-05 10:54:42,2013-07-05 10:53:19
6c984587711f82c0fc5223bbf6e8bb3b71732a3e...80673e20f212fbefd1a8d53ae521e95c6eedf201,1,7,0,7,1,2013-07-06 22:34:43,2013-07-06 22:31:59
80673e20f212fbefd1a8d53ae521e95c6eedf201...4140bfb93c88470c1fb6c45a4ea15d819a6baa35,1,2,1,3,1,2013-07-07 16:40:53,2013-07-07 01:24:38
4140bfb93c88470c1fb6c45a4ea15d819a6baa35...abce5abe6686551e68f7e8a663f8918c56d307b1,3,22,10,32,8,2013-07-08 12:32:28,2013-07-08 12:29:28
abce5abe6686551e68f7e8a663f8918c56d307b1...f551d5a3de4f32f0b6322a1d884990e34ab67528,1,8,0,8,1,2013-07-08 13:59:06,2013-07-08 13:57:50
f551d5a3de4f32f0b6322a1d884990e34ab67528...5567dc68e6fc7788cd9451e5fea52396ffaf3675,1,10,3,13,3,2013-07-08 16:21:34,2013-07-08 16:08:30
5567dc68e6fc7788cd9451e5fea52396ffaf3675...0a91a8dbe3e406d5a321bdcea0d1ab82110c157f,1,9,0,9,1,2013-07-08 19:06:37,2013-07-08 19:01:37
0a91a8dbe3e406d5a321bdcea0d1ab82110c157f...5192dbbf5546eb62e1c24d36d91f270b1a2b5eaf,2,5,4,9,3,2013-07-09 11:16:45,2013-07-07 01:24:38
5192dbbf5546eb62e1c24d36d91f270b1a2b5eaf...7bbf6971329d7fdd5343895c7e8c292f7e64d95e,1,1,1,2,1,2013-07-09 15:58:02,2013-07-09 15:55:45
7bbf6971329d7fdd5343895c7e8c292f7e64d95e...13546cae9c7922088266c32a5be2bda77545a04b,7,33,1,34,13,2013-07-10 15:32:28,2013-07-01 17:58:04
13546cae9c7922088266c32a5be2bda77545a04b...14b50739787d9bb69e763894f78b10971fe2bc63,1,2,0,2,2,2013-07-10 16:10:26,2013-07-10 16:10:26
14b50739787d9bb69e763894f78b10971fe2bc63...2f9378223d0c92447e2529d5eeaad7d301b78b84,1,3,0,3,1,2013-07-10 19:05:00,2013-02-23 15:33:28
2f9378223d0c92447e2529d5eeaad7d301b78b84...c278d81da40430f401cb7ce24f6bc603c40f3de7,1,2,1,3,2,2013-07-11 15:07:59,2013-07-11 15:06:34
c278d81da40430f401cb7ce24f6bc603c40f3de7...83119fd582931fd2bf05832e6a3fe8c56bd4a804,1,1,0,1,1,2013-07-12 00:24:32,2013-03-15 14:15:52
83119fd582931fd2bf05832e6a3fe8c56bd4a804...80a7dd6f7fa0b2fe56978eafdf4a1c7eaf0ad29b,1,4,4,8,1,2013-07-12 10:06:26,2013-07-12 09:50:08
80a7dd6f7fa0b2fe56978eafdf4a1c7eaf0ad29b...61c8c1b6dcd267a7d4777ff3b0a78eaedb9b95d3,1,16,0,16,2,2013-07-12 10:22:29,2013-07-12 10:19:16
61c8c1b6dcd267a7d4777ff3b0a78eaedb9b95d3...8904e9fb98eaa94fd38e28706e2fe6786d3adc70,2,37,1,38,4,2013-07-13 22:09:24,2013-07-13 22:09:24
8904e9fb98eaa94fd38e28706e2fe6786d3adc70...d1a002a44c6dc7569f5ef08fdb1f823a49758470,1,1,1,2,1,2013-07-14 16:35:58,2013-07-14 03:28:04
d1a002a44c6dc7569f5ef08fdb1f823a49758470...1a4233eef1e61f32fa66a719d16c405f38f6f8ad,1,12,7,19,7,2013-07-15 15:38:04,2013-07-15 15:31:06
1a4233eef1e61f32fa66a719d16c405f38f6f8ad...3860d5e8f814e26baf4deee9258392cd34a4b456,1,83,52,135,10,2013-07-16 23:22:11,2013-07-16 19:27:52
3860d5e8f814e26baf4deee9258392cd34a4b456...2e068d4e5a730d42c103a2931b02e62e8dc5109a,1,1,1,2,1,2013-07-17 10:51:42,2013-07-17 10:50:40
2e068d4e5a730d42c103a2931b02e62e8dc5109a...3f97c33a9ffd0f5102583ac6988f79cb1b839a05,1,1,1,2,1,2013-07-18 12:05:06,2013-07-18 11:58:51
3f97c33a9ffd0f5102583ac6988f79cb1b839a05...5d16e923b65dccf897e384f01fbd3a50a4325deb,2,2,2,4,2,2013-07-18 12:48:04,2013-07-18 11:53:54
5d16e923b65dccf897e384f01fbd3a50a4325deb...cbfe56c856f9bb79fdd36d7e573c6156bb88720a,1,2,0,2,1,2013-07-18 16:41:56,2013-07-18 16:41:01
cbfe56c856f9bb79fdd36d7e573c6156bb88720a...cf2986c885d5d58ddf8f341d7aa456f0a7801b16,1,1,1,2,1,2013-07-19 09:19:54,2013-07-19 08:48:38
cf2986c885d5d58ddf8f341d7aa456f0a7801b16...c89cc4fc2932efc5fe89a5f3c2ce4795e5928c40,1,1,1,2,1,2013-07-19 09:31:18,2013-07-19 05:46:08
c89cc4fc2932efc5fe89a5f3c2ce4795e5928c40...9386bbc75f23a8b9bd747eb3b37bc220fe04563b,1,6,6,12,3,2013-07-19 10:31:48,2013-07-19 08:01:13
9386bbc75f23a8b9bd747eb3b37bc220fe04563b...01910115329c2073e6c68b214155dd5fb87132c8,2,21,3,24,6,2013-07-22 08:08:41,2013-07-22 07:55:45
01910115329c2073e6c68b214155dd5fb87132c8...be6d795854b5b3c50d3370720b8eb3861d5ff32f,1,1,1,2,1,2013-07-25 11:39:42,2013-07-25 10:57:49
be6d795854b5b3c50d3370720b8eb3861d5ff32f...fdef471912022dd5d65946fa6f86adbc3c60f630,1,20,0,20,1,2013-07-25 15:09:19,2013-07-25 12:48:22
fdef471912022dd5d65946fa6f86adbc3c60f630...93564959365f18beb9bd22e7b51c76398d6255b9,1,1,1,2,1,2013-07-25 16:32:42,2013-07-25 16:31:53
93564959365f18beb9bd22e7b51c76398d6255b9...00b39e0145c5b9117503b20bba74948294a30e5a,3,51,3,54,4,2013-07-27 21:59:27,2013-05-24 09:01:34
00b39e0145c5b9117503b20bba74948294a30e5a...a2eb2195567e645c58ec20c382294b62640b9ea1,1,22,25,47,4,2013-07-27 22:02:57,2013-05-24 10:19:44
a2eb2195567e645c58ec20c382294b62640b9ea1...dd2a512f68fc61d10577f21a4dc367202b58fc08,1,1,1,2,1,2013-07-27 22:46:55,2013-07-27 22:46:55
dd2a512f68fc61d10577f21a4dc367202b58fc08...41492f0f1b4048cf578eb34c7d3424c4f317f31c,3,21,12,33,8,2013-07-28 08:07:29,2013-07-28 08:05:39
41492f0f1b4048cf578eb34c7d3424c4f317f31c...88ddb93a8a0ca16ef5ecd1f23a36b5c10486971a,1,1,1,2,1,2013-07-28 08:57:34,2013-06-29 14:28:05
88ddb93a8a0ca16ef5ecd1f23a36b5c10486971a...f17c2026cffc5dc3e4a46a1f720e8bdba2bef737,1,1,1,2,1,2013-07-28 18:10:25,2013-07-28 18:09:29
f17c2026cffc5dc3e4a46a1f720e8bdba2bef737...02ac44b29a25632fb6ae3ad40ed83f08565f51e9,2,28,66,94,13,2013-07-29 08:55:50,2013-07-29 08:51:54
02ac44b29a25632fb6ae3ad40ed83f08565f51e9...f8e6434912784b8055ba33ca110047f5b5bb2856,1,5,5,10,1,2013-07-29 10:52:50,2013-07-28 10:58:19
f8e6434912784b8055ba33ca110047f5b5bb2856...b5ac25dc0c1d2d66b70451c551b271b920b85455,2,6,5,11,4,2013-07-29 11:06:34,2013-07-28 10:58:19
b5ac25dc0c1d2d66b70451c551b271b920b85455...bf4c8d8c9810b2c21cfc2fd619fcdf2f5ad5c7fd,1,6,1,7,3,2013-07-29 11:28:41,2013-07-29 11:23:36
bf4c8d8c9810b2c21cfc2fd619fcdf2f5ad5c7fd...72fb37f9fdf0397e7e67856b28fc5f1f4546b57b,1,4,0,4,1,2013-07-31 11:09:45,2013-07-30 09:11:15
72fb37f9fdf0397e7e67856b28fc5f1f4546b57b...f2969c7e02f7b300d410df1154dd585a5082c433,1,6,0,6,2,2013-07-31 13:26:23,2013-07-31 13:24:29
f2969c7e02f7b300d410df1154dd585a5082c433...f4806e3ef697a41e8e4f762466d37129cfb5431d,1,1,1,2,1,2013-08-03 23:36:30,2013-08-03 19:42:02
f4806e3ef697a41e8e4f762466d37129cfb5431d...145e0a14f0c098d7bbf2bfb593f7b6cfe1b02d72,1,92,9,101,15,2013-08-04 12:07:11,2013-08-02 18:24:26
145e0a14f0c098d7bbf2bfb593f7b6cfe1b02d72...bc33fef90a851da91758fa6c1126456e61aadf35,1,66,35,101,12,2013-08-04 16:36:29,2013-08-02 13:26:19
bc33fef90a851da91758fa6c1126456e61aadf35...56d56d55b18249a00f96b014ef23b0631e191dd1,1,12,14,26,11,2013-08-04 18:46:45,2013-08-04 18:45:29
56d56d55b18249a00f96b014ef23b0631e191dd1...fcc8381505a336369870e9e521badf8c4fc18209,1,4,4,8,2,2013-08-05 00:31:42,2013-08-05 00:29:55
fcc8381505a336369870e9e521badf8c4fc18209...d4c19a6e7e45f3ff4dbbb2424904b726709bb24f,1,4,0,4,2,2013-08-06 15:56:38,2013-04-18 20:04:00
d4c19a6e7e45f3ff4dbbb2424904b726709bb24f...e8ea55212bc1520da2e9b87af9990505c5baa000,1,44,0,44,1,2013-08-08 09:36:57,2013-08-07 17:47:07
e8ea55212bc1520da2e9b87af9990505c5baa000...6cf33d49d1e903837b0d9321ff745bd894198431,1,0,14,14,1,2013-08-08 10:29:15,2013-08-08 10:29:15
6cf33d49d1e903837b0d9321ff745bd894198431...bf55bbdcb55b830e3d34b07a067584bce4e6f158,1,18,4,22,3,2013-08-08 13:47:30,2013-08-08 12:16:48
bf55bbdcb55b830e3d34b07a067584bce4e6f158...d8dc2b123d31f309ced3d29b6c7467531619c7ae,1,7,5,12,1,2013-08-08 14:27:48,2013-08-08 11:45:06
d8dc2b123d31f309ced3d29b6c7467531619c7ae...70cf70ad21feb2cec17b46c65cdf47b50a817657,1,2,0,2,1,2013-08-08 18:14:20,2013-08-08 18:13:39
70cf70ad21feb2cec17b46c65cdf47b50a817657...12edced1de2b38fbb0c3c2070ba5c7302ab1843c,1,5,1,6,3,2013-08-09 20:02:57,2013-08-09 20:02:05
12edced1de2b38fbb0c3c2070ba5c7302ab1843c...9e2a2c491b47255dd81735e96186ac237bf9f06e,1,1,0,1,1,2013-08-10 22:08:33,2013-08-10 22:08:05
9e2a2c491b47255dd81735e96186ac237bf9f06e...a2286ac96445e943ffcbc624ee9a52d80d42533a,10,373,4,377,12,2013-08-12 18:10:21,2013-08-12 17:20:58
a2286ac96445e943ffcbc624ee9a52d80d42533a...1a274ccd6bc1afbdac80344c9b6e5810c1162b5f,2,10,5,15,6,2013-08-13 16:03:49,2013-08-13 16:03:49
1a274ccd6bc1afbdac80344c9b6e5810c1162b5f...90363e388c61874add3f3557ee654a996ec75d78,2,15,9,24,6,2013-08-13 16:04:21,2013-08-13 16:04:21
90363e388c61874add3f3557ee654a996ec75d78...bebbb611a8e0c3469f16f3423c88c75cc3c146f4,3,3,3,6,3,2013-08-13 16:10:05,2013-08-13 16:10:05
bebbb611a8e0c3469f16f3423c88c75cc3c146f4...5fdd6af1ebabb9c8b5eac5d6b9ae4204628fa520,3,95,0,95,4,2013-08-13 16:17:17,2013-08-13 16:16:30
5fdd6af1ebabb9c8b5eac5d6b9ae4204628fa520...f24ae3373bd1964bf1d50c72c95196dc231007af,1,1,1,2,1,2013-08-13 17:17:27,2013-08-13 17:17:27
f24ae3373bd1964bf1d50c72c95196dc231007af...3a829bf75a2b3e2259fe2081142a36542361d84c,1,7,4,11,5,2013-08-14 17:05:30,2013-08-14 16:57:55
3a829bf75a2b3e2259fe2081142a36542361d84c...cb2fee567fed40f076644e4bdce906225d2fd6a8,1,1,1,2,1,2013-08-14 17:11:58,2013-08-14 17:11:58
cb2fee567fed40f076644e4bdce906225d2fd6a8...2b750fff5653781f07e65a54a99e7da66361ec9e,1,11,0,11,1,2013-08-15 16:21:14,2013-05-18 14:35:39
2b750fff5653781f07e65a54a99e7da66361ec9e...adf70506b96c74503fcecc3d1f6f3f5ed0180f76,1,2,2,4,1,2013-08-15 17:09:28,2013-05-19 10:14:19
adf70506b96c74503fcecc3d1f6f3f5ed0180f76...bbe2ad3e387a94de1898fb6bab17846b48e82f64,1,2,2,4,1,2013-08-21 04:21:40,2013-08-21 03:22:25
bbe2ad3e387a94de1898fb6bab17846b48e82f64...9a7d59e8c7e90588fc0301fe09c11fbae9ffe1f3,2,24,7,31,4,2013-08-22 11:34:19,2013-08-22 11:25:21
9a7d59e8c7e90588fc0301fe09c11fbae9ffe1f3...3b32b1544f7d1ff885d2cd7f4c96a6e5025e4725,1,0,4,4,1,2013-08-22 13:21:41,2013-08-20 09:26:48
3b32b1544f7d1ff885d2cd7f4c96a6e5025e4725...1b236048b9a915296dc13081fad7bb75d0ff1f4d,1,4,3,7,2,2013-08-22 13:39:21,2013-08-22 08:39:31
1b236048b9a915296dc13081fad7bb75d0ff1f4d...616a4d385a79d6809b618dcc8bcbda05b032d5fc,15,253,79,332,40,2013-08-22 21:49:11,2013-08-19 13:35:26
616a4d385a79d6809b618dcc8bcbda05b032d5fc...5547ba743cde37d043c411fd463bcd817dca4302,2,6,6,12,6,2013-08-23 01:35:10,2013-08-22 15:14:56
5547ba743cde37d043c411fd463bcd817dca4302...98635f2a0eda5f161889c16af3e672a01ee9fe3d,1,1,1,2,1,2013-08-27 13:22:51,2013-08-26 09:18:21
98635f2a0eda5f161889c16af3e672a01ee9fe3d...d3b7b6a7a452314ae12f633dec6d87b4f3465bea,1,3,2,5,1,2013-08-27 14:27:49,2013-08-27 00:00:11
d3b7b6a7a452314ae12f633dec6d87b4f3465bea...50d9bed1d5408f7a6d86a5a96f71edbba62b20bf,1,1,1,2,1,2013-08-28 11:12:43,2013-08-28 10:35:46
50d9bed1d5408f7a6d86a5a96f71edbba62b20bf...6f44ef16cb207281933cf80d1d3863e39e73866c,1,13,13,26,8,2013-08-29 16:49:32,2013-08-29 16:48:22
6f44ef16cb207281933cf80d1d3863e39e73866c...c9a021b04262abbf44ac57ed2ee5c6530a17f77e,1,19,17,36,2,2013-08-31 13:52:49,2013-08-31 11:55:45
c9a021b04262abbf44ac57ed2ee5c6530a17f77e...bc78ffa270cd6b2607749c0ed2b3974b98eef0f4,1,17,3,20,2,2013-09-04 14:55:33,2013-09-03 11:48:03
bc78ffa270cd6b2607749c0ed2b3974b98eef0f4...8f4552adf16f84d08b49706ab45a80551c58f0e6,1,3,0,3,1,2013-09-04 17:19:46,2013-09-04 17:18:08
8f4552adf16f84d08b49706ab45a80551c58f0e6...406fd9f97f4b04212276e2e78d8216ef5a27a514,1,15,9,24,6,2013-09-05 06:53:24,2013-04-22 17:50:17
406fd9f97f4b04212276e2e78d8216ef5a27a514...d6b11b0abbf3e841dca7b57b4c56404bf089d48d,1,11,0,11,1,2013-09-05 10:32:55,2013-09-05 09:56:03
d6b11b0abbf3e841dca7b57b4c56404bf089d48d...e62f3910226f996278e15e401974c87566ed6fd8,1,9,0,9,2,2013-09-05 21:55:09,2013-09-05 21:16:50
e62f3910226f996278e15e401974c87566ed6fd8...5d029f2222e74b3bae2dc6b446214014b708917b,1,9,7,16,1,2013-09-06 20:06:51,2013-09-06 20:01:29
5d029f2222e74b3bae2dc6b446214014b708917b...afc624cab015be3c05dbe2c184416c4838db4b82,1,3,1,4,1,2013-09-06 21:31:04,2013-09-06 20:41:22
afc624cab015be3c05dbe2c184416c4838db4b82...37587624bf79490e97da1bd04547cdce8b77b9fb,1,4,1,5,1,2013-09-07 16:17:01,2013-09-07 15:36:31
37587624bf79490e97da1bd04547cdce8b77b9fb...9d3a66aa9fd33f68fc22fc1d86b7aaf382018f57,1,8,0,8,1,2013-09-07 18:01:10,2013-09-07 17:59:57
9d3a66aa9fd33f68fc22fc1d86b7aaf382018f57...aa50b7e8373031838c4d1d5fa7da809d3c20dc23,1,1,0,1,1,2013-09-09 10:07:39,2013-07-06 02:38:33
aa50b7e8373031838c4d1d5fa7da809d3c20dc23...693ebff1a4f5eeda56279188ee473be6a1088e46,1,9,0,9,1,2013-09-10 13:18:20,2013-09-10 12:39:51
693ebff1a4f5eeda56279188ee473be6a1088e46...988b61c550d798f9a66d17ee0511fb7a9a7f33ca,2,33,0,33,3,2013-09-11 01:05:03,2013-08-27 22:50:11
988b61c550d798f9a66d17ee0511fb7a9a7f33ca...42e8fabb59a915b9dd5b4fa43676bbf35c5bac62,3,77,0,77,4,2013-09-11 01:08:34,2013-08-23 10:49:37
42e8fabb59a915b9dd5b4fa43676bbf35c5bac62...0a34f397590bc8db9c57f624dcdf24a9750eb3df,3,4,4,8,4,2013-09-11 01:25:27,2013-09-11 01:25:27
0a34f397590bc8db9c57f624dcdf24a9750eb3df...91a073a337ddcd9a4efa7a5828b01e1efc28988f,1,1,1,2,1,2013-09-11 11:04:04,2013-09-11 11:04:04
91a073a337ddcd9a4efa7a5828b01e1efc28988f...2a7d3030f9703464fb56e29dbe764eb1b2c88359,1,13,16,29,6,2013-09-11 11:43:29,2013-09-10 22:00:36
2a7d3030f9703464fb56e29dbe764eb1b2c88359...169594f5ae09782ab1909fc3a9939a23507b4901,2,18,1,19,2,2013-09-11 12:18:52,2013-09-11 12:17:15
169594f5ae09782ab1909fc3a9939a23507b4901...61867e226dda35741ba363da9f5859007e4381bc,2,24,4,28,4,2013-09-13 12:27:28,2013-09-12 23:01:47
61867e226dda35741ba363da9f5859007e4381bc...7cfb5243f12f90862734afc7ca6ee95169ce52ad,1,6,16,22,6,2013-09-13 13:30:20,2013-09-13 13:28:38
7cfb5243f12f90862734afc7ca6ee95169ce52ad...61de57260b4b2bb54fe3c494d104b85e957c9be2,2,9,2,11,5,2013-09-13 13:40:15,2013-08-02 18:46:17
61de57260b4b2bb54fe3c494d104b85e957c9be2...dbc2e8eb73ca15fd3f2b9c5ddfa69651330bcead,1,7,2,9,3,2013-09-13 16:42:47,2013-09-13 15:45:42
dbc2e8eb73ca15fd3f2b9c5ddfa69651330bcead...e66fe357b2324f984e91392286b3b0e6b5dd627e,2,14,2,16,3,2013-09-14 07:03:03,2013-09-13 12:18:50
e66fe357b2324f984e91392286b3b0e6b5dd627e...22b74fa09d7ccbc8c52270d648a0da7f3f0fa2bc,3,134,15,149,35,2013-09-15 05:48:15,2013-09-15 05:48:15
22b74fa09d7ccbc8c52270d648a0da7f3f0fa2bc...4607c7325dca510428f8e67a97bd73d647ffb35f,5,46,4,50,6,2013-09-15 06:29:31,2013-09-15 06:29:31
4607c7325dca510428f8e67a97bd73d647ffb35f...4770fc1c625351f0f2cc60553db773c8a89ac230,1,1,0,1,1,2013-09-15 08:44:29,2013-09-15 08:44:29
4770fc1c625351f0f2cc60553db773c8a89ac230...ae5f4a04b42a7979ea101ca01f743a3bedd6c514,1,1,1,2,1,2013-09-15 16:59:53,2013-09-15 16:59:53
ae5f4a04b42a7979ea101ca01f743a3bedd6c514...12a30e92210144ac5e5762d55131dd10740fa463,7,60,21,81,18,2013-09-15 18:25:34,2013-09-15 18:14:26
12a30e92210144ac5e5762d55131dd10740fa463...efcf4d2bd982d58a0f2d5738779dead01438c060,1,10,8,18,1,2013-09-16 20:53:02,2013-09-16 20:49:46
efcf4d2bd982d58a0f2d5738779dead01438c060...3c3b3fc10b08bc549bbc449e750f833dbaf10493,2,10,3,13,6,2013-09-17 16:42:19,2013-09-17 14:28:20
3c3b3fc10b08bc549bbc449e750f833dbaf10493...6a708cd654fe63278ea8a14b3e44da847c62ebf4,1,6,0,6,1,2013-09-17 20:33:11,2013-09-17 20:33:11
6a708cd654fe63278ea8a14b3e44da847c62ebf4...72f7932cfbe079f5063a2f1b4c09b520d99f5e42,1,5,2,7,3,2013-09-18 13:43:34,2013-09-18 13:43:34
72f7932cfbe079f5063a2f1b4c09b520d99f5e42...87c8de2a06433a6d87a85a8f79e378feafa5ed46,1,0,6,6,1,2013-09-18 14:54:30,2013-09-18 14:54:30
87c8de2a06433a6d87a85a8f79e378feafa5ed46...75c0aa43d33d1a6e1aad306ea144226843b1edab,4,468,0,468,6,2013-09-19 07:07:29,2013-09-19 07:07:29
75c0aa43d33d1a6e1aad306ea144226843b1edab...1ef9a296da7cb131bde1949821dae0ff9b33c024,2,4,2,6,4,2013-09-19 10:38:01,2013-09-19 10:37:23
1ef9a296da7cb131bde1949821dae0ff9b33c024...b541cf24d03b694bccce337cbc93aaa0c3a08307,1,1,1,2,1,2013-09-19 17:29:56,2013-09-19 16:55:09
b541cf24d03b694bccce337cbc93aaa0c3a08307...b8e7730f3e25a0bcabca82bf5a2e06411ffcc92e,2,9,0,9,2,2013-09-21 10:56:17,2013-09-21 03:54:48
b8e7730f3e25a0bcabca82bf5a2e06411ffcc92e...61b685847e63e94d678988d6c7a8a7477b37275d,1,26,0,26,1,2013-09-21 22:18:26,2013-09-21 15:22:45
61b685847e63e94d678988d6c7a8a7477b37275d...177270ea73bd1d68fcb55a06c49e2e294dead948,1,1,1,2,1,2013-09-21 22:18:46,2013-09-21 20:34:45
177270ea73bd1d68fcb55a06c49e2e294dead948...8e51bea4fb2302a636547ed3f938b16628621478,1,6,4,10,4,2013-09-22 17:07:14,2013-09-12 22:34:22
8e51bea4fb2302a636547ed3f938b16628621478...b5eddde09523bd55cde1cf8e22d46d3f594503d7,1,3,1,4,1,2013-09-22 17:07:36,2013-09-22 14:11:02
b5eddde09523bd55cde1cf8e22d46d3f594503d7...18fe77e4ed01a7761a24de7ec7b1c3a1314fc197,4,15,22,37,14,2013-09-22 20:08:59,2013-09-22 13:55:09
18fe77e4ed01a7761a24de7ec7b1c3a1314fc197...1fa8c612fc764c456f4d838805ff7fd5634b1e16,1,6,4,10,3,2013-09-22 21:07:54,2013-09-22 20:58:46
1fa8c612fc764c456f4d838805ff7fd5634b1e16...938d98c8d18a6cba61b54ce0f9cc3af9e7afa134,1,2,0,2,1,2013-09-23 11:40:07,2013-09-23 10:17:22
938d98c8d18a6cba61b54ce0f9cc3af9e7afa134...a722dfda93eafd6ff02b91f7a222eaccfc444ef4,1,13,3,16,2,2013-09-23 14:40:27,2013-09-23 13:46:19
a722dfda93eafd6ff02b91f7a222eaccfc444ef4...c695f293e3ce74657268e532ee69ae64c92bfa1c,1,13,11,24,5,2013-09-23 15:07:40,2013-09-23 14:17:15
c695f293e3ce74657268e532ee69ae64c92bfa1c...959adcc1def92550966eef05622c3de30bebf855,1,1,1,2,1,2013-09-23 22:30:23,2013-09-23 22:30:05
959adcc1def92550966eef05622c3de30bebf855...13aff91ae785b1e39948bf0431b96dc189e2b976,1,1,1,2,1,2013-09-23 23:25:19,2013-09-23 22:36:33
13aff91ae785b1e39948bf0431b96dc189e2b976...de8715ca9749c182b3610ea3d1959c3a5603a919,1,2,2,4,1,2013-09-24 13:41:44,2013-09-24 13:41:12
de8715ca9749c182b3610ea3d1959c3a5603a919...1cc572a071003583f15cdbca2f5b4d910ebd3504,3,15,134,149,35,2013-09-24 19:12:25,2013-09-24 19:12:25
1cc572a071003583f15cdbca2f5b4d910ebd3504...f3853172a4bde963ff9908870bc2ea53eb73bc04,1,7,3,10,2,2013-09-24 19:14:30,2013-09-17 20:59:56
f3853172a4bde963ff9908870bc2ea53eb73bc04...43ab759ce3dffa796a95c1fe8679bc3c3eee2700,1,2,2,4,1,2013-09-25 16:32:07,2013-09-25 16:20:33
43ab759ce3dffa796a95c1fe8679bc3c3eee2700...b7e5b5ba1ed03243f53f9f0bbaa58a33691c815d,3,20,3,23,5,2013-09-25 17:53:00,2013-09-23 15:18:20
b7e5b5ba1ed03243f53f9f0bbaa58a33691c815d...cb95516a880d62059825fc1fd154f457abb8075d,1,189,16,205,19,2013-09-27 16:44:49,2013-09-02 09:39:37
cb95516a880d62059825fc1fd154f457abb8075d...73ffe26816738c15515e5764e96c056f0d98559a,2,15,2,17,3,2013-09-27 16:45:26,2013-09-27 15:00:42
73ffe26816738c15515e5764e96c056f0d98559a...20f394f4d5a5e0b4647aac2dd7b5ab8dc89d36fa,1,7,5,12,2,2013-09-30 14:21:40,2013-09-30 10:44:41
20f394f4d5a5e0b4647aac2dd7b5ab8dc89d36fa...997a332cbbf2828b96df03eeb502affd66685155,2,3,2,5,2,2013-10-01 14:21:04,2013-10-01 14:20:26
997a332cbbf2828b96df03eeb502affd66685155...7ebd10019d5c6c173825a41c5d435c80bee7b82a,3,21,4,25,4,2013-10-01 18:34:39,2013-10-01 18:34:39
7ebd10019d5c6c173825a41c5d435c80bee7b82a...1f6306106005fbf9e9457d2857fb6898e07b122c,1,6,2,8,1,2013-10-02 14:15:42,2013-10-02 14:15:18
1f6306106005fbf9e9457d2857fb6898e07b122c...67d887fbae1204f86361aa77edf8104330432e5e,1,1,1,2,1,2013-10-04 00:14:07,2013-10-04 00:13:22
67d887fbae1204f86361aa77edf8104330432e5e...f8393edb52e3dc73185f2496bfa08463fa4ffa09,1,2,2,4,2,2013-10-09 00:30:50,2013-10-08 14:20:02
f8393edb52e3dc73185f2496bfa08463fa4ffa09...b495c24375aa1fe0373727511cf81298337a1227,3,37,2,39,5,2013-10-09 10:55:32,2013-05-30 05:16:09
b495c24375aa1fe0373727511cf81298337a1227...9f8a36eb20895d9e542820d5190bfa77ad1b85d9,1,4,0,4,1,2013-10-09 11:40:32,2013-10-09 11:20:37
9f8a36eb20895d9e542820d5190bfa77ad1b85d9...3e6d8959123f4155295b0fc0abb9542013f696ff,1,6,6,12,4,2013-10-11 00:57:20,2013-10-10 21:52:50
3e6d8959123f4155295b0fc0abb9542013f696ff...766fbd53cb6ae6b31c6b88848d3abb64d2881e72,1,9,8,17,3,2013-10-11 19:35:52,2013-10-11 16:45:00
766fbd53cb6ae6b31c6b88848d3abb64d2881e72...2b8519760e04ca0ef3c9989c36588dde93a8152a,1,9,0,9,2,2013-10-12 00:12:55,2013-10-12 00:11:49
2b8519760e04ca0ef3c9989c36588dde93a8152a...2fb127b8813ad049938e398e757d9ecef0eaacde,1,1,0,1,1,2013-10-13 17:00:55,2013-10-13 17:00:55
2fb127b8813ad049938e398e757d9ecef0eaacde...ef9133768c2aed52646ad0b6274edf836aa672b2,1,5,2,7,1,2013-10-13 17:11:53,2013-10-13 17:09:26
ef9133768c2aed52646ad0b6274edf836aa672b2...e532d1e38f30689f6483ee5fd580eaf8d08a6b1e,1,10,10,20,6,2013-10-14 12:10:55,2013-10-14 11:40:56
e532d1e38f30689f6483ee5fd580eaf8d08a6b1e...b268488806bd0cbfd29a874069ece89f61585935,2,6,4,10,2,2013-10-14 12:17:00,2013-10-14 11:59:56
b268488806bd0cbfd29a874069ece89f61585935...5c1be8a870f9783c4164cf09b1e9db3205ad1f1e,2,10,0,10,2,2013-10-14 14:38:34,2013-10-14 12:19:02
5c1be8a870f9783c4164cf09b1e9db3205ad1f1e...7f62d794b303bedfd094742a84dcc8b85df3ba8b,2,7,2,9,2,2013-10-14 15:55:15,2013-10-14 12:43:55
7f62d794b303bedfd094742a84dcc8b85df3ba8b...6e7de2edb0565e0ea2fd4ff6701e97ead67138b9,1,6,0,6,1,2013-10-14 22:43:48,2013-10-14 20:16:49
6e7de2edb0565e0ea2fd4ff6701e97ead67138b9...1acd5fc9d293ac07adbb38d11c415dbadd431353,1,26,3,29,4,2013-10-15 11:37:51,2013-10-15 10:55:43
1acd5fc9d293ac07adbb38d11c415dbadd431353...312ca5e9cb89af790fa8af04811a3e4c5e621758,1,6,6,12,5,2013-10-15 13:58:57,2013-10-15 13:34:11
312ca5e9cb89af790fa8af04811a3e4c5e621758...0fb2897c81c6c39f5d3a94ab50070c5fe8a602ad,2,4,2,6,2,2013-10-18 12:33:07,2013-10-17 23:51:45
0fb2897c81c6c39f5d3a94ab50070c5fe8a602ad...472917024b53ea4ff95fa103fcb76fa532f1ce66,2,35,2,37,5,2013-10-18 13:44:34,2013-09-25 16:59:33
472917024b53ea4ff95fa103fcb76fa532f1ce66...8ffa99ccb6173e6dd53a83204933d99a9a6748a3,1,24,0,24,2,2013-10-18 20:22:47,2013-10-17 01:48:03
8ffa99ccb6173e6dd53a83204933d99a9a6748a3...045d192222f531948313bde8d43746dde33b522d,1,4,2,6,1,2013-10-21 17:10:51,2013-10-21 14:53:25
045d192222f531948313bde8d43746dde33b522d...166be6a77e40a40f12c7724db6f4524babd03715,1,9,20,29,4,2013-10-21 18:01:39,2013-09-17 23:14:38
166be6a77e40a40f12c7724db6f4524babd03715...ed67184b3051c392a6cb722e889c062233730c2e,1,6,6,12,3,2013-10-21 22:56:25,2013-10-21 22:56:25
ed67184b3051c392a6cb722e889c062233730c2e...26d1496f9003cabc2aef17fd28e684b1767b0587,1,1,1,2,1,2013-10-22 16:06:20,2013-10-22 16:05:26
26d1496f9003cabc2aef17fd28e684b1767b0587...6e413928387a3665a6504339c1c9c464ebff7645,3,56,0,56,4,2013-10-23 00:24:30,2013-09-25 13:33:29
6e413928387a3665a6504339c1c9c464ebff7645...cc0dcfc64405419d95e87c8dcc612bd441a8d6de,2,28,0,28,2,2013-10-23 12:04:14,2013-10-21 15:12:48
cc0dcfc64405419d95e87c8dcc612bd441a8d6de...f571345ef795d28fbe8aa7e6291a77fe372f3cf8,2,2,2,4,2,2013-10-23 22:29:16,2013-10-23 22:28:41
f571345ef795d28fbe8aa7e6291a77fe372f3cf8...c30516e9cca2ddc92a43187284521d0faad2aa88,5,5,5,10,5,2013-10-25 04:31:51,2013-10-25 04:31:51
c30516e9cca2ddc92a43187284521d0faad2aa88...7aebbc1632916c35fb4e969a09a46c8773403781,1,1,1,2,1,2013-10-25 11:53:39,2013-10-25 11:53:39
7aebbc1632916c35fb4e969a09a46c8773403781...cd59b6f2f3b7a304438e99379a57844840e6b3a6,1,1,1,2,1,2013-10-25 11:55:45,2013-10-24 09:11:52
cd59b6f2f3b7a304438e99379a57844840e6b3a6...4b4b795bd56782ddbbecf427d0ae88b27d896ee8,1,1,1,2,1,2013-10-25 21:37:46,2013-10-25 21:36:07
4b4b795bd56782ddbbecf427d0ae88b27d896ee8...1ef737416ab56a6becee36876769909a37541465,1,22,17,39,4,2013-10-26 20:57:56,2013-10-25 23:07:40
1ef737416ab56a6becee36876769909a37541465...3b4b376bd1dde3cbe64cf8f1a4fb1756904af710,1,17,22,39,4,2013-10-26 21:36:16,2013-10-26 21:29:42
3b4b376bd1dde3cbe64cf8f1a4fb1756904af710...9074d2f5f9f32d851eb938418a77bdb24131536f,1,6,0,6,1,2013-10-30 11:48:16,2013-10-30 11:46:07
9074d2f5f9f32d851eb938418a77bdb24131536f...f832f0d2c309ac31bbf3616c34495c48509b0fb3,1,11,0,11,1,2013-10-30 12:12:19,2013-10-30 12:11:31
f832f0d2c309ac31bbf3616c34495c48509b0fb3...e21d935f52980aefc972e11c9bd551dd75b1a659,1,4,2,6,1,2013-10-30 12:27:23,2013-10-29 18:36:22
e21d935f52980aefc972e11c9bd551dd75b1a659...3ec994de2af20def51da54a510cb264d744ea48b,1,3,4,7,2,2013-10-30 13:26:39,2013-10-30 13:25:21
3ec994de2af20def51da54a510cb264d744ea48b...dd0c204828f58f63caa573b0a03df7665c97e6d3,1,2,2,4,2,2013-11-01 09:47:29,2013-11-01 09:43:27
dd0c204828f58f63caa573b0a03df7665c97e6d3...60ec8ae4b2165d827fbdabc287c07c95794103ec,1,2,2,4,1,2013-11-01 10:02:48,2013-11-01 09:59:16
60ec8ae4b2165d827fbdabc287c07c95794103ec...9d23c3d03d3c2df13ea11e0d536d51e95e3e262d,2,2,2,4,2,2013-11-01 23:29:15,2013-11-01 14:00:02
9d23c3d03d3c2df13ea11e0d536d51e95e3e262d...2e881f15b8095b99743f6354f84e4d2333029b4d,4,5,5,10,4,2013-11-02 01:32:10,2013-11-02 01:29:39
2e881f15b8095b99743f6354f84e4d2333029b4d...376ba1c5b3487583228341b488cc8dcf080cd808,1,1,1,2,1,2013-11-07 14:33:10,2013-11-05 11:25:19
376ba1c5b3487583228341b488cc8dcf080cd808...2d09f368f3261c3f372bd77f06d0fbb8fd0ac6c1,2,15,0,15,2,2013-11-07 14:42:52,2013-11-07 14:42:25
2d09f368f3261c3f372bd77f06d0fbb8fd0ac6c1...88639d3f7b431871a737221b288413a04fc51a6b,1,1,1,2,1,2013-11-07 14:49:19,2013-11-07 14:49:19
88639d3f7b431871a737221b288413a04fc51a6b...1669a438a9137a91865a70be288a522e7543d265,1,1,1,2,1,2013-11-08 23:35:52,2013-11-08 22:20:50
1669a438a9137a91865a70be288a522e7543d265...12ff1623d63046b9e27f7f8b9fe20750106889ca,2,14,34,48,10,2013-11-09 23:09:02,2013-11-09 10:32:19
12ff1623d63046b9e27f7f8b9fe20750106889ca...8d1f3396679c8bb446ad43b0727b45bdb77d87b4,1,6,10,16,3,2013-11-12 20:05:06,2013-11-12 19:27:21
8d1f3396679c8bb446ad43b0727b45bdb77d87b4...16e5fdd9cb8cca4d203b9255a9771b3c370e37d6,2,25,1,26,3,2013-11-14 20:19:03,2013-11-14 19:55:13
16e5fdd9cb8cca4d203b9255a9771b3c370e37d6...47b6a7c354871892949916018fabe780c7006103,1,1,1,2,1,2013-11-15 12:11:12,2013-11-15 12:09:46
47b6a7c354871892949916018fabe780c7006103...b41540f1566213297ada89d6e11040b853f8f04d,1,1,1,2,1,2013-11-15 15:22:55,2013-11-15 15:21:58
b41540f1566213297ada89d6e11040b853f8f04d...402967f49c6ee5769c47e2df4699a0d5bd588c52,1,4,0,4,1,2013-11-18 14:35:21,2013-11-18 14:32:25
402967f49c6ee5769c47e2df4699a0d5bd588c52...1135525eacbda195558fc92d0b4409fdf8e5cd7d,1,1,1,2,1,2013-11-19 00:11:37,2013-11-19 00:10:58
1135525eacbda195558fc92d0b4409fdf8e5cd7d...f89cddae666099892ef2a157ad94f367e1bffd84,1,2,1,3,1,2013-11-19 09:50:20,2013-11-19 09:50:20
f89cddae666099892ef2a157ad94f367e1bffd84...af16a35ff4c7047c62679bab2f5b7a1fcf3d1f72,1,5,2,7,1,2013-11-19 15:33:28,2013-11-16 04:03:01
af16a35ff4c7047c62679bab2f5b7a1fcf3d1f72...2fb6dbe81dfe027872982642181f5a86bb1f91dd,1,15,20,35,7,2013-11-19 21:24:42,2013-11-15 19:06:32
2fb6dbe81dfe027872982642181f5a86bb1f91dd...ed8814b24a18cecdeb2631281bceb2f8432a2546,1,2,3,5,1,2013-11-20 09:52:49,2013-11-20 09:49:08
ed8814b24a18cecdeb2631281bceb2f8432a2546...0bb05f6b9257b7ac99ee42fcf71b57823c67425b,1,2,2,4,1,2013-11-22 08:15:37,2013-03-15 18:14:01
0bb05f6b9257b7ac99ee42fcf71b57823c67425b...01fed9c258d91bd94ca567d344be5daea7dcc53d,1,0,97,97,1,2013-11-23 13:47:41,2013-11-23 13:47:41
01fed9c258d91bd94ca567d344be5daea7dcc53d...0934894976042033d74f809cefa229b82cff85f2,1,2,1,3,1,2013-11-24 20:19:39,2013-11-24 19:33:04
0934894976042033d74f809cefa229b82cff85f2...c0c77955629b27869ba78b91e1cb9b057860a3fc,1,1,1,2,1,2013-11-24 21:29:14,2013-11-24 21:28:29
c0c77955629b27869ba78b91e1cb9b057860a3fc...e19506d14ef87b11906de3d3e860470479924617,1,5,1,6,2,2013-11-25 13:27:35,2013-11-25 11:22:43
e19506d14ef87b11906de3d3e860470479924617...0e98050847644f66c6aad38e359d560594a7a4cc,1,2,0,2,2,2013-11-28 00:00:32,2013-11-27 23:53:10
0e98050847644f66c6aad38e359d560594a7a4cc...86c5115cad6bb980d503eca502bac513f03645ca,2,3,0,3,3,2013-12-02 18:41:18,2013-12-02 17:21:48
86c5115cad6bb980d503eca502bac513f03645ca...deeed42253edf583974662657c70014d1634b46b,1,4,0,4,2,2013-12-04 15:52:04,2013-12-04 15:46:56
deeed42253edf583974662657c70014d1634b46b...a53820b1b1747d6f9b5ee5723aa7526ededdaba7,1,6,0,6,1,2013-12-11 19:43:44,2013-12-11 17:28:05
a53820b1b1747d6f9b5ee5723aa7526ededdaba7...e4174da34ab239f04d9c79fec9822b01d63e453b,1,24,0,24,1,2013-12-14 21:36:27,2013-12-01 02:05:15
e4174da34ab239f04d9c79fec9822b01d63e453b...6833773775fe135c38768418d31ec3f789d8f06f,1,5,6,11,3,2013-12-18 17:38:00,2013-12-18 05:40:25
6833773775fe135c38768418d31ec3f789d8f06f...6980059af2835ed3d15b4a59e16321bc8d828c0e,1,2,1,3,1,2013-12-18 23:37:14,2013-12-18 23:36:01
6980059af2835ed3d15b4a59e16321bc8d828c0e...fc2c8ee4c80848a14d61d627a7fc3a8c73914afa,1,1,1,2,2,2013-12-25 11:11:25,2013-12-25 11:06:25
fc2c8ee4c80848a14d61d627a7fc3a8c73914afa...66ada281d5842da82f1fdc813b941ebb04dec6e3,1,6,1,7,2,2013-12-27 01:06:33,2013-12-27 01:04:28
66ada281d5842da82f1fdc813b941ebb04dec6e3...3cf9ba5fa31083b17c7363e512d365bac0f57c24,1,6,0,6,1,2013-12-30 22:46:56,2013-12-30 22:42:11
3cf9ba5fa31083b17c7363e512d365bac0f57c24...f20da282972628daed1d792104500600d233d897,1,5,2,7,2,2013-12-30 22:57:47,2013-12-30 22:55:12
f20da282972628daed1d792104500600d233d897...bbcdfb4d69ccebde33b3803c8660c25730b181f8,1,1,1,2,1,2014-01-01 16:54:04,2014-01-01 16:54:04
bbcdfb4d69ccebde33b3803c8660c25730b181f8...4d05e672bfdc832e1d073237134041bb8c2f554d,1,2,2,4,2,2014-01-02 21:22:26,2014-01-02 20:14:11
4d05e672bfdc832e1d073237134041bb8c2f554d...ca4cd3fd107bb16fa1990f86392c1926c11eb138,1,4,4,8,4,2014-01-02 21:28:10,2014-01-02 19:22:52
ca4cd3fd107bb16fa1990f86392c1926c11eb138...1ccfcbe13e636584b19575c53e029918b70a3b39,1,2,2,4,1,2014-01-03 17:04:23,2014-01-03 17:02:58
1ccfcbe13e636584b19575c53e029918b70a3b39...a32680407b092a13f45a070f595f1996139b7539,1,1,1,2,1,2014-01-15 23:45:06,2014-01-15 21:17:08
a32680407b092a13f45a070f595f1996139b7539...b83dae688e7cd6775bf6d12c7fe5a7a5f40e7437,1,3,2,5,2,2014-01-16 12:59:18,2014-01-16 12:58:08
b83dae688e7cd6775bf6d12c7fe5a7a5f40e7437...f746d1fc74e5253b7c12484eab081818c8853b14,1,11,71,82,3,2014-01-17 14:29:19,2014-01-17 14:21:34
f746d1fc74e5253b7c12484eab081818c8853b14...267aeabfc74e48ee2eb652bf5e8829f50f3d360b,1,14,0,14,1,2014-01-19 17:46:18,2013-09-07 17:46:42
267aeabfc74e48ee2eb652bf5e8829f50f3d360b...0946aac61d0da2aceafe6179cdb64ccad583d924,1,13,13,26,3,2014-01-20 22:08:03,2013-07-01 12:05:49
0946aac61d0da2aceafe6179cdb64ccad583d924...45535c8a4cba200cd610010ec1e2d515de6c2475,1,1,1,2,1,2014-01-21 01:08:59,2013-10-01 14:08:36
45535c8a4cba200cd610010ec1e2d515de6c2475...ebed0149505c9689650442ddc4e9a3efbf3579be,1,3,2,5,1,2014-01-22 15:19:07,2014-01-22 15:17:44
ebed0149505c9689650442ddc4e9a3efbf3579be...126af8fa7bbb711775c3859786955ccb8f3946fb,9,60,60,120,60,2014-01-22 22:26:05,2014-01-22 21:17:32
126af8fa7bbb711775c3859786955ccb8f3946fb...75177681347b6e8c763f4be919908c5d3842e579,11,35,35,70,35,2014-01-22 22:28:07,2014-01-22 21:26:10
75177681347b6e8c763f4be919908c5d3842e579...169bee85eacd5fbbf4c8f5270dbfb906934a788e,1,5,5,10,1,2014-01-23 14:05:14,2014-01-23 14:01:26
169bee85eacd5fbbf4c8f5270dbfb906934a788e...c539a4490f8c49bcd264d3d08c8686624cca6698,2,4,1,5,2,2014-01-24 13:14:46,2014-01-23 17:17:53
c539a4490f8c49bcd264d3d08c8686624cca6698...60054e6e31abbe8ec17631f1afff77c947a05fad,1,4,2,6,4,2014-01-24 14:05:55,2014-01-24 13:52:43
60054e6e31abbe8ec17631f1afff77c947a05fad...682420d108ee3e056ea0d538b61ffa2a850a2222,1,104,35,139,40,2014-01-26 20:48:32,2014-01-26 20:48:32
682420d108ee3e056ea0d538b61ffa2a850a2222...b55d0ebff20c1870ea33ac9947e2accd4d436822,3,25,0,25,4,2014-01-26 22:49:04,2014-01-26 22:48:28
b55d0ebff20c1870ea33ac9947e2accd4d436822...4e115af105a257f3d87327d1d324a6938a504245,1,1,1,2,1,2014-01-29 17:08:55,2014-01-29 16:54:02
4e115af105a257f3d87327d1d324a6938a504245...c888bee8363be84963b0b401279d418d27f6f2b3,1,6,3,9,4,2014-02-18 14:32:44,2014-02-18 14:29:22
c888bee8363be84963b0b401279d418d27f6f2b3...b86ff4ee82b1dddea7179d72ee3368cb8962cbc6,1,1,1,2,1,2014-03-13 13:15:48,2014-03-13 13:08:11
b86ff4ee82b1dddea7179d72ee3368cb8962cbc6...468d06077a33d35c9f8f0bc83b17377ea501bacd,2,23,5,28,4,2014-03-22 10:14:15,2014-03-22 10:14:15
468d06077a33d35c9f8f0bc83b17377ea501bacd...efb0c848ac6cc1846b62e9c9ad704b882f558a7b,3,27,13,40,8,2014-03-24 11:34:37,2014-03-24 11:33:04
efb0c848ac6cc1846b62e9c9ad704b882f558a7b...5b2d17d910d84e26ef229f0379bce66979f97e07,1,1,1,2,1,2014-04-10 23:33:50,2014-04-10 23:32:20
5b2d17d910d84e26ef229f0379bce66979f97e07...cbc80eef6dea315a056f46d02fb129b068867024,1,4,6,10,6,2014-04-15 21:46:01,2014-04-15 21:43:29
cbc80eef6dea315a056f46d02fb129b068867024...ec2d456df8a56a3000b991adcd5ce3aede974492,1,1,1,2,1,2014-04-16 13:40:32,2014-04-16 13:19:55
ec2d456df8a56a3000b991adcd5ce3aede974492...1997421f8e14641698e67d138121f7bd430d3060,1,1,1,2,1,2014-04-18 13:16:43,2014-04-18 13:16:43
1997421f8e14641698e67d138121f7bd430d3060...d6c685cc78d6bde96a60d82b9a065db3cd44ac66,1,1,1,2,1,2014-04-21 17:20:56,2014-04-21 14:48:33
d6c685cc78d6bde96a60d82b9a065db3cd44ac66...2a5bcb69f42b84464b24b5c835dca6467b6aa7f1,5,51,2,53,13,2014-04-21 22:30:57,2014-04-20 17:33:59
2a5bcb69f42b84464b24b5c835dca6467b6aa7f1...6872f42757d7ef6a97e0b6ec5db4d2615d8a2bd8,2,36,1,37,7,2014-04-21 22:31:05,2014-04-20 20:29:06
6872f42757d7ef6a97e0b6ec5db4d2615d8a2bd8...985434fb1d6bf2335bf96c6ebf91c3674f1f399f,6,155,2,157,11,2014-04-21 22:31:08,2014-04-20 20:29:40
985434fb1d6bf2335bf96c6ebf91c3674f1f399f...cebfbcdb862c7800e84d7413afc80de992486c4a,2,212,6,218,5,2014-04-21 22:31:08,2014-04-21 10:48:54
cebfbcdb862c7800e84d7413afc80de992486c4a...486b6f398bba109ba68b2f29c604e2cf13099aab,4,20,3,23,4,2014-04-21 22:51:51,2014-04-21 22:51:51
486b6f398bba109ba68b2f29c604e2cf13099aab...a0f60958cf67d7ed1128e362cb1d6abee49169ed,1,34,0,34,1,2014-04-21 23:28:24,2014-04-21 23:28:24
a0f60958cf67d7ed1128e362cb1d6abee49169ed...036b2d4f30ce77414b1c14d5c9f0f07a546ec904,1,1,1,2,1,2014-04-22 15:49:50,2014-04-22 15:49:50
036b2d4f30ce77414b1c14d5c9f0f07a546ec904...2d450cc3e5afda821dd7d527ad34378c2f131fc5,1,2,2,4,2,2014-04-22 22:29:13,2014-04-22 20:54:14
2d450cc3e5afda821dd7d527ad34378c2f131fc5...19bd6b9477e8f09f867640f72f3eb335cebe1d6a,6,50,1,51,10,2014-04-23 13:01:38,2014-04-23 12:49:12
19bd6b9477e8f09f867640f72f3eb335cebe1d6a...47a352f84e82767ac0e58ea387b192bf896fd574,1,0,1,1,1,2014-04-23 13:15:41,2014-04-23 13:15:41
47a352f84e82767ac0e58ea387b192bf896fd574...c47324b2de6c967dd76ad6095c4b42b177e5473b,3,3,3,6,3,2014-04-28 20:34:35,2014-04-28 20:34:35
c47324b2de6c967dd76ad6095c4b42b177e5473b...ce6c665f125f43c00c71f31c3a08c9b0602b3af9,1,1,1,2,1,2014-04-28 23:01:01,2014-04-28 23:01:01
ce6c665f125f43c00c71f31c3a08c9b0602b3af9...73136a887d72d257f1e26610f40e1d5978407ca1,2,2,2,4,2,2014-04-28 23:07:17,2014-04-28 23:06:25
73136a887d72d257f1e26610f40e1d5978407ca1...41ab97b6a4e785a35b6199134aad39091b6b1aab,1,1,1,2,1,2014-05-05 10:42:41,2014-05-05 10:41:01
41ab97b6a4e785a35b6199134aad39091b6b1aab...4001ec8698f577b973c5a540801d8a0bbea1205b,4,1,103,104,4,2014-05-12 13:41:34,2014-05-12 13:41:34
4001ec8698f577b973c5a540801d8a0bbea1205b...ad32c218850ad40972dcef57beb460f8c979dd6d,3,49,4,53,9,2014-05-12 13:42:06,2014-05-12 13:42:06
ad32c218850ad40972dcef57beb460f8c979dd6d...ffcb0091783c637670afeee6faa616e912f23279,3,96,0,96,4,2014-05-14 16:26:26,2014-05-14 16:07:32
ffcb0091783c637670afeee6faa616e912f23279...4e922f608424b36e83ff54a106392476e9e24c3e,3,3,3,6,3,2014-05-14 16:27:50,2014-05-14 16:27:45
4e922f608424b36e83ff54a106392476e9e24c3e...4752580881643d38b8c6c1b471d1ab8429c873d1,1,1,1,2,1,2014-05-14 16:31:37,2014-05-14 16:31:37
4752580881643d38b8c6c1b471d1ab8429c873d1...5c65aa924365aeac81d44dd912e68f704fe78cba,2,17,17,34,18,2014-05-15 11:17:17,2014-05-15 11:11:29
5c65aa924365aeac81d44dd912e68f704fe78cba...220c09e97acb8ca4267a0b754256e522e008c2d8,1,9,5,14,2,2014-05-16 16:30:23,2014-05-16 15:52:59
220c09e97acb8ca4267a0b754256e522e008c2d8...044a4fd7a898354de1cd6f923e4f929ce2db5faa,1,1,1,2,1,2014-05-16 21:43:26,2014-04-05 14:26:11
044a4fd7a898354de1cd6f923e4f929ce2db5faa...d5ca48245132dee7359b616cd4416242bc28eaaa,1,16,18,34,8,2014-05-17 13:18:32,2014-05-17 13:14:53
d5ca48245132dee7359b616cd4416242bc28eaaa...d57cf88c1e14bad8fb4611725245c381241dd748,1,1,1,2,1,2014-05-29 22:59:56,2014-05-29 22:58:12
d57cf88c1e14bad8fb4611725245c381241dd748...7342784b99a45cf661fd23f3ffd52eb02ce5cf3a,1,1,1,2,1,2014-06-15 19:13:05,2014-06-15 10:44:33
7342784b99a45cf661fd23f3ffd52eb02ce5cf3a...ce06ef5569705ab4a7c0a495deb7fe5efb63c153,1,1,2,3,2,2014-06-18 18:38:19,2014-06-18 18:35:38
ce06ef5569705ab4a7c0a495deb7fe5efb63c153...ddc715edd3e473a995f7f8a1b8277be33324641f,1,3,0,3,1,2014-07-07 19:31:57,2014-07-07 19:29:01
ddc715edd3e473a995f7f8a1b8277be33324641f...4ae68f677b3348765d8649d8b57beffa18fe8d3d,3,49,2,51,4,2014-07-14 15:38:43,2014-07-08 19:58:14
4ae68f677b3348765d8649d8b57beffa18fe8d3d...291e837bda016d8556c2f6a4712729955a1667d0,3,2,49,51,4,2014-07-15 00:12:40,2014-07-15 00:12:40
291e837bda016d8556c2f6a4712729955a1667d0...12ac0bb91bd2c18c06409e88b025f42cfe1ef555,1,1,1,2,1,2014-08-02 17:00:50,2014-08-02 17:00:50
12ac0bb91bd2c18c06409e88b025f42cfe1ef555...e0fb48c2548c05b010c3b8d64f5906b092b0b503,1,2,2,4,1,2014-08-06 12:28:51,2014-08-06 12:28:51
e0fb48c2548c05b010c3b8d64f5906b092b0b503...50369c5295400aadd00076680afc619a0264d0bc,1,1,1,2,1,2014-08-07 02:21:16,2014-08-07 00:32:41
50369c5295400aadd00076680afc619a0264d0bc...bafc7237a94894164ac99a82ce6eb0d4c09ba059,1,2,12,14,2,2014-08-08 16:47:54,2014-08-08 16:45:18
bafc7237a94894164ac99a82ce6eb0d4c09ba059...5d6e4031dff26c3df32712e5037037a7c71a81ea,1,1,1,2,1,2014-08-11 10:10:52,2014-08-11 10:01:14
5d6e4031dff26c3df32712e5037037a7c71a81ea...00ec30d3c43ff2be0bb4d0ff14310d67475503c8,2,28,8,36,6,2014-08-11 11:09:56,2014-08-07 13:20:59
00ec30d3c43ff2be0bb4d0ff14310d67475503c8...27ab82f7fc72cdc9800f5cd6e0e1bc39a3175ef3,1,2,2,4,2,2014-08-14 01:45:36,2014-08-14 01:44:16
27ab82f7fc72cdc9800f5cd6e0e1bc39a3175ef3...25d9ae5214b59f06f385190733914eaa459751ff,3,16,0,16,4,2014-08-20 15:44:02,2014-08-11 12:45:08
25d9ae5214b59f06f385190733914eaa459751ff...45ac9d4fb087d21902469fc22643f5201d41a0cd,5,34,0,34,5,2014-08-20 15:44:02,2014-07-17 19:59:28
45ac9d4fb087d21902469fc22643f5201d41a0cd...26cd48e166ac4d84317c8ee6d63ac52a87e8da99,7,93,25,118,20,2014-08-20 15:44:02,2014-08-08 14:20:08
26cd48e166ac4d84317c8ee6d63ac52a87e8da99...dd68f319b365f6cb38c5a6c106faf4f6142d7d88,4,56,8,64,6,2014-08-20 15:44:02,2014-08-11 16:04:53
dd68f319b365f6cb38c5a6c106faf4f6142d7d88...2a446c896e7c814661fb9c4f212b071b2a7fa446,6,76,5,81,11,2014-08-20 15:44:02,2014-08-11 19:36:16
2a446c896e7c814661fb9c4f212b071b2a7fa446...1f5ff0b1eb2f123523dd659916b6f0a4c0068249,3,3,3,6,3,2014-08-20 20:09:42,2014-08-20 20:09:42
1f5ff0b1eb2f123523dd659916b6f0a4c0068249...ed4cf3b450f1d6e3b0aa4af6692348c0323fc7a3,2,2,2,4,2,2014-08-20 20:33:23,2014-08-20 20:31:45
ed4cf3b450f1d6e3b0aa4af6692348c0323fc7a3...4fa3c041054865cf0b7004200cf9bcc325ff1369,1,1,1,2,1,2014-08-20 20:37:33,2014-08-20 20:37:33
4fa3c041054865cf0b7004200cf9bcc325ff1369...5d647e5f1755d0fa571d14e3eb60b1f886d4d059,2,2,2,4,2,2014-08-26 13:45:01,2014-08-26 13:44:24
5d647e5f1755d0fa571d14e3eb60b1f886d4d059...4c96bd8fb31d2325112ba92ed3cbdc3ff1bbfabc,7,65,5,70,10,2014-08-28 02:05:30,2014-08-21 15:55:23
4c96bd8fb31d2325112ba92ed3cbdc3ff1bbfabc...20474d5bc77621698c408cfb0b3d39be131d05f9,1,123,21,144,18,2014-08-28 15:10:11,2014-08-28 03:04:23
20474d5bc77621698c408cfb0b3d39be131d05f9...d54022b6558e620563a2f09ed03f9676312710a9,3,3,3,6,3,2014-09-02 20:50:34,2014-09-02 20:50:34
d54022b6558e620563a2f09ed03f9676312710a9...b8db1ded5e3b7778a0942018971bbcbe2ce657e8,2,2,2,4,2,2014-09-03 01:35:30,2014-09-03 01:34:29
b8db1ded5e3b7778a0942018971bbcbe2ce657e8...d9d4d62d8539fc3b72c979c04d11e160bc8fff9d,7,69,4,73,12,2014-09-08 18:09:14,2014-09-04 21:04:53
d9d4d62d8539fc3b72c979c04d11e160bc8fff9d...314e9cd38f6bf72a619e5d07c99371439c33ba11,6,32,3,35,10,2014-10-06 12:54:26,2014-10-05 18:06:51
314e9cd38f6bf72a619e5d07c99371439c33ba11...c41f613b75406880b147652d80e50091e072f591,2,2,2,4,2,2014-10-22 16:32:18,2014-10-22 16:23:21
c41f613b75406880b147652d80e50091e072f591...da3a23a4dfff58a8b43e7607966b87550ad1b119,3,3,3,6,3,2014-10-22 16:44:14,2014-10-22 16:44:14
da3a23a4dfff58a8b43e7607966b87550ad1b119...17ffd24d9b3528c5dcb0d50e86df2b03a9b288fc,1,12,1,13,1,2014-11-25 18:15:58,2014-11-25 18:13:45
17ffd24d9b3528c5dcb0d50e86df2b03a9b288fc...3d35ea43001991d94c192abca1832628cd255bb0,6,49,20,69,20,2014-11-25 19:00:17,2014-11-16 15:42:09
3d35ea43001991d94c192abca1832628cd255bb0...37ca9fe9cb6477d2f2b205f5fb99fdbaa25d6026,1,1,1,2,1,2015-01-03 00:22:03,2015-01-03 00:20:18
37ca9fe9cb6477d2f2b205f5fb99fdbaa25d6026...1d5dfd01ec56fe8bb5ee6648490fd4094139f7c8,3,3,3,6,3,2015-01-03 01:54:56,2015-01-03 01:54:56
1d5dfd01ec56fe8bb5ee6648490fd4094139f7c8...57671dd0b91ed4def9c7a49c486944f4e98fed9d,1,3,0,3,1,2015-01-15 08:32:32,2015-01-15 08:24:54
9e11253497d7592964e311d007ac5ba28ca22808...71a3162a70a282f150f76e8f0fc5865aa7a338a4,1,6,4,10,1,2012-11-22 15:36:18,2012-11-22 15:36:18
71a3162a70a282f150f76e8f0fc5865aa7a338a4...ea6b95dbec77371d517392ffb465017b8eb7001c,2,14,3,17,3,2012-11-22 19:13:01,2012-11-22 19:10:01
ea6b95dbec77371d517392ffb465017b8eb7001c...a026e480da89cb99c9dc6c954fb5a37ded0f9315,5,116,33,149,24,2012-11-22 19:53:59,2012-11-22 19:09:40
a026e480da89cb99c9dc6c954fb5a37ded0f9315...891c5306242760c8bb494412b9f8f86762664427,1,6,0,6,1,2012-11-22 19:55:50,2012-11-22 19:55:50
891c5306242760c8bb494412b9f8f86762664427...0e3690d2309e64ce7b7ae4938d41544c25f29870,5,43,40,83,16,2012-11-22 21:08:51,2012-11-20 12:15:16
6cb4233aa2afa39842177046d577c2f5da5274a7...8c21c53c8b7325afb38c94764a57d1f095c88b41,1,1,1,2,1,2012-11-20 18:19:50,2012-11-20 18:18:32
8c21c53c8b7325afb38c94764a57d1f095c88b41...a32f30c79c1be8e088917bced0f97760a92045ef,2,2,2,4,2,2012-11-20 23:00:20,2012-11-20 23:00:20
a32f30c79c1be8e088917bced0f97760a92045ef...8fdb28219df22245d7e50b4e8374d8567ca84f0f,1,1,1,2,1,2012-11-21 00:05:32,2012-11-20 23:53:08
8fdb28219df22245d7e50b4e8374d8567ca84f0f...fbfa654a15487f9a49e9a5d34a4e9694fe878a8f,3,67,7,74,14,2012-11-21 02:19:44,2012-11-21 01:58:14
fbfa654a15487f9a49e9a5d34a4e9694fe878a8f...48e8b5e9446f5f9a0667fccbb0ecbd987a27078b,5,61,3,64,16,2012-11-21 03:50:23,2012-11-21 03:45:38
48e8b5e9446f5f9a0667fccbb0ecbd987a27078b...b781354ad1d57be852c859eed4943ead1f1c994d,1,4,4,8,1,2012-11-21 08:06:21,2012-11-21 08:06:21
b781354ad1d57be852c859eed4943ead1f1c994d...693b8a65ad9ccb14266c08a3831c8e8537d7d83c,1,3,3,6,3,2012-11-21 08:52:09,2012-11-21 08:52:09
693b8a65ad9ccb14266c08a3831c8e8537d7d83c...978d4476cf1956fe91a2a6b3b5d2157005560c33,1,2,0,2,1,2012-11-21 09:19:00,2012-11-21 09:19:00
978d4476cf1956fe91a2a6b3b5d2157005560c33...e2b18081968d1dd931c95669451852fdd34f28ef,1,11,9,20,4,2012-11-22 00:06:17,2012-11-22 00:06:17
e2b18081968d1dd931c95669451852fdd34f28ef...8e5573e99abd5351dfbd6de1214662ecf7f6c9ba,1,136,145,281,67,2012-11-22 00:31:17,2012-11-18 06:20:49
8e5573e99abd5351dfbd6de1214662ecf7f6c9ba...d80d05fc673665fa614e65eb2c38b654ccf28235,1,17,3,20,4,2012-11-22 06:06:59,2012-11-16 05:17:58
ab2f65bb7f9083b5fac777f5e3b7872c58837f4f...32ffcb21a00e08eb478cc287bc3254ee765d815d,1,29,0,29,1,2012-08-21 13:01:11,2012-08-21 13:01:11
ab2f65bb7f9083b5fac777f5e3b7872c58837f4f...fd58d6c258058f8ac54e241b21b949bdbe50059b,1,16,37,53,6,2012-08-21 12:43:37,2012-08-21 12:43:37
fd58d6c258058f8ac54e241b21b949bdbe50059b...a193372753ad9d1d15ad5e2d6d06bbc07ca3f433,3,45,2,47,4,2012-08-21 18:23:57,2012-08-21 15:43:08
a193372753ad9d1d15ad5e2d6d06bbc07ca3f433...4353a6163c00d4193307dae533e3e6ae9b44d18f,3,31,4,35,7,2012-08-21 19:52:25,2012-08-21 19:52:25
4353a6163c00d4193307dae533e3e6ae9b44d18f...3fd89d99036696ba08dd2dd7e20a5b375f85d23b,1,3,1,4,1,2012-08-21 21:32:53,2012-08-21 21:32:53
3fd89d99036696ba08dd2dd7e20a5b375f85d23b...13d47c3f338e1e9a5da943b97b5334c0523d2e2c,2,58,60,118,30,2012-08-21 21:38:16,2012-08-21 20:29:16
13d47c3f338e1e9a5da943b97b5334c0523d2e2c...dfe63a52effab2c8b5f72a6aceb8646f03d490bb,2,0,12,12,3,2012-08-22 01:48:47,2012-08-22 01:48:47
dfe63a52effab2c8b5f72a6aceb8646f03d490bb...e2b4eddc11b391bc0047032776e9ca7c2f9328b3,2,29,29,58,17,2012-08-22 18:55:24,2012-08-22 15:48:22
e2b4eddc11b391bc0047032776e9ca7c2f9328b3...7cfe8e8fce7677ec696f42a7d1501a97e8191a3d,4,25,4,29,5,2012-08-22 18:55:24,2012-08-22 16:06:03
6a6f589bfe4d03c3de04753330c307832cd2dcbe...15202baace1453e7576806f13d137ae930de6dcb,1,3,3,6,1,2012-09-29 20:41:55,2012-09-29 20:41:55
15202baace1453e7576806f13d137ae930de6dcb...a014ddfef2f606471f25c756d97b3b50fcbd9e91,4,65,37,102,9,2012-09-29 20:56:18,2012-09-24 20:30:38
a014ddfef2f606471f25c756d97b3b50fcbd9e91...f0f327bbfe1caae6d11fbe20a3b5b96eed1704cf,4,71,18,89,18,2012-09-29 20:56:18,2012-09-26 17:56:21
f0f327bbfe1caae6d11fbe20a3b5b96eed1704cf...10e505b1b37f29c9ac6567134c48677b042c2a87,1,1,1,2,2,2012-09-29 21:50:34,2012-09-29 21:45:28
10e505b1b37f29c9ac6567134c48677b042c2a87...dad7eec6e1c1770f5d81d5c5ed2de296c1eca969,1,5,4,9,1,2012-09-29 23:45:50,2012-09-29 23:43:47
dad7eec6e1c1770f5d81d5c5ed2de296c1eca969...3abf6105b6c953c6feb28708b9903f583cb28438,2,13,11,24,9,2012-09-30 04:46:32,2012-09-30 04:46:32
3abf6105b6c953c6feb28708b9903f583cb28438...ab2a1773fdef2ff240b124268f5ae1118d8e27b5,1,1,1,2,1,2012-09-30 04:53:13,2012-09-30 04:53:13
ab2a1773fdef2ff240b124268f5ae1118d8e27b5...ddd7d1af203d6d260c970d8ee8749fedbce6bba1,1,16,6,22,7,2012-09-30 14:50:56,2012-09-30 14:50:56
ddd7d1af203d6d260c970d8ee8749fedbce6bba1...28abf5f0ebc9d380f25dd278d7ef4642c4504545,7,150,22,172,29,2012-09-30 14:51:06,2012-09-30 14:51:06
28abf5f0ebc9d380f25dd278d7ef4642c4504545...c2532825dbe2a422bbce67285637febb0ef9c9f1,1,28,15,43,12,2012-09-30 14:51:11,2012-09-30 14:51:11
c2532825dbe2a422bbce67285637febb0ef9c9f1...d5a4f209c3889a76a23a19f3212ab2d7b5c62e1c,7,75,7,82,15,2012-09-30 16:38:16,2012-09-30 15:13:23
d5a4f209c3889a76a23a19f3212ab2d7b5c62e1c...d0345b71146ecb60af2277585b604fbc244d267b,1,31,0,31,1,2012-09-30 17:37:57,2012-09-30 17:37:25
d0345b71146ecb60af2277585b604fbc244d267b...08d675a98f1ae1d27f7e1946125ed5316c576802,4,26,0,26,7,2012-09-30 20:40:25,2012-09-30 18:44:27
08d675a98f1ae1d27f7e1946125ed5316c576802...92b5341b19e9b35083ee671afc2afb2f252c662d,4,93,53,146,15,2012-09-30 20:49:41,2012-09-29 12:45:56
92b5341b19e9b35083ee671afc2afb2f252c662d...864a0514b85637ee92d6f1ba596997195dfc7107,1,9,3,12,4,2012-09-30 20:54:01,2012-09-23 20:53:40
864a0514b85637ee92d6f1ba596997195dfc7107...8bd7b598b6de1be1e3f72f3a1ee62803b1c02010,10,58,50,108,22,2012-09-30 21:16:19,2012-09-30 21:16:14
8bd7b598b6de1be1e3f72f3a1ee62803b1c02010...7cc4068c4470876c526830778cbdac2fdfd6dc26,5,62,3,65,17,2012-10-01 05:34:50,2012-07-12 01:43:15
7cc4068c4470876c526830778cbdac2fdfd6dc26...e7723683dc652613df369d5ca412e8b1217012d3,7,76,2,78,17,2012-10-01 06:40:27,2012-09-30 12:34:13
e7723683dc652613df369d5ca412e8b1217012d3...1ce4aedcefb68086918adc4137d75a6f2c0bd1f2,1,8,6,14,6,2012-10-01 12:19:33,2012-10-01 12:17:55
1ce4aedcefb68086918adc4137d75a6f2c0bd1f2...14681eaa53a035fa1c8fc390d5cca0b340fdcdb3,1,0,9,9,1,2012-10-01 16:00:41,2012-10-01 16:00:41
14681eaa53a035fa1c8fc390d5cca0b340fdcdb3...55fa86a97f399df117d0de5f19d97dc72185c556,1,2,1,3,1,2012-10-01 18:36:16,2012-10-01 18:36:16
55fa86a97f399df117d0de5f19d97dc72185c556...2aac3ce0c6d944093f5c32e170c9a0d90e8e1f94,1,2,2,4,1,2012-10-01 21:46:12,2012-10-01 21:46:12
2aac3ce0c6d944093f5c32e170c9a0d90e8e1f94...030b55393ea1164080a25eb6e241e43918bae8ac,1,0,2,2,2,2012-10-01 21:53:21,2012-10-01 21:53:21
030b55393ea1164080a25eb6e241e43918bae8ac...4c75344cc1d3c74ed73b7a8d6aab92a173afe8f5,1,1,1,2,1,2012-10-02 08:04:12,2012-10-02 08:04:12
4c75344cc1d3c74ed73b7a8d6aab92a173afe8f5...5f8b97f9fb058e5e02f1f99423fc3b0020ecdeb0,3,33,7,40,11,2012-10-02 13:42:05,2012-10-02 11:19:44
5f8b97f9fb058e5e02f1f99423fc3b0020ecdeb0...3b6f980bedbbf091fe29bececa2b262d2084ce4d,5,47,27,74,11,2012-10-02 14:52:45,2012-10-02 14:52:45
3b6f980bedbbf091fe29bececa2b262d2084ce4d...43530384b7f2a18b44e06e7043b988427b334653,1,1,1,2,1,2012-10-03 01:14:55,2012-10-03 01:14:55
43530384b7f2a18b44e06e7043b988427b334653...934f35f1f958f48a36eff64b13e43a9d55a476e0,1,1,1,2,1,2012-10-03 01:16:33,2012-10-03 01:16:33
89136b2725db3cb774ae4b39849684ae8f3847aa...2315f1a2ee4e83f7514f20302cdac4782b63751a,1,16,1,17,3,2012-09-20 19:07:34,2012-09-20 19:07:34
89136b2725db3cb774ae4b39849684ae8f3847aa...26ff2be787d3c1fad2df4a009fa05b4c11b8cf30,9,25,21,46,31,2012-09-20 19:03:24,2012-09-20 19:03:24
26ff2be787d3c1fad2df4a009fa05b4c11b8cf30...e06b54391dd06a0448b7676ec38f3734a4f86300,1,1,1,2,1,2012-09-20 20:49:26,2012-09-20 20:49:26
e06b54391dd06a0448b7676ec38f3734a4f86300...837425b425c2d58596f3ed04a7ed79541279ee7e,47,23,346,369,125,2012-09-20 23:06:55,2012-09-19 20:39:14
ddfc68379f47af18b90068f17e9a1f7e7cbfb505...408da7b4578ee6616d7a72fda9591364f254e9a6,1,1,1,2,1,2013-04-11 13:27:14,2013-04-11 13:27:14
151938ddb5f9537c80c1a6426f2c6ce14adc92d9...d5824ef69d7b58ef71175bdb5e9420d601aa194c,1,0,15,15,1,2013-03-25 08:32:02,2013-03-23 04:10:27
d5824ef69d7b58ef71175bdb5e9420d601aa194c...0a9ea56056ee4a7ded265dc56fff309c906473d1,2,8,7,15,4,2013-03-25 08:32:12,2013-03-23 04:34:58
0a9ea56056ee4a7ded265dc56fff309c906473d1...d9b12ecbe62aa7c9fb0f913e7eefc21662f8e21b,2,6,4,10,3,2013-03-25 08:38:34,2013-03-23 04:43:07
bc35b95274e0c98c09cf5db5407c0d43f2a1d362...c5b2414a52c0959acbcf107a60bf129539e2415e,1,1,1,2,1,2013-03-24 16:12:23,2013-03-24 16:12:23
bc35b95274e0c98c09cf5db5407c0d43f2a1d362...266de5f9ae9e9f2fbfaec3b7e4b5fb9941967801,3,490,0,490,2,2013-03-24 16:08:01,2013-03-24 16:08:01
266de5f9ae9e9f2fbfaec3b7e4b5fb9941967801...97774429aeb54df4c09895c07cd1b09e70201f7d,17,654,427,1081,184,2013-03-24 16:40:40,2013-03-24 16:40:40
97774429aeb54df4c09895c07cd1b09e70201f7d...9572a3992b3f92ef6c77f51c44497e18d168a30c,1,6,4,10,2,2013-03-24 17:00:24,2013-03-24 17:00:24
9572a3992b3f92ef6c77f51c44497e18d168a30c...f02c6c27600c6e78b3f4bb3447cfc025a1f27a90,1,2,0,2,1,2013-03-24 17:31:20,2013-03-24 17:31:20
f02c6c27600c6e78b3f4bb3447cfc025a1f27a90...6073091b77458da34c74c313b1395b4214874db1,2,3,3,6,3,2013-03-24 17:49:31,2013-03-24 17:49:31
ce094e570e0ff085b88b2303e25124331f558e45...48a9194755a291441c26acbcd6b6c703c40e5f38,1,1,1,2,1,2013-02-23 09:53:10,2013-02-23 09:53:10
ce094e570e0ff085b88b2303e25124331f558e45...88c726bea0436a404c751cb497e7981b68e74383,1,2,1,3,2,2013-02-22 22:33:02,2013-02-22 18:59:11
88c726bea0436a404c751cb497e7981b68e74383...f565c6f9994b2559a5164dc709a926eac7ebd5fe,1,7,0,7,3,2013-02-22 22:33:02,2013-02-22 20:02:45
f565c6f9994b2559a5164dc709a926eac7ebd5fe...e5a8df06be8ce82f5ba10dca5087339704ffd0fa,1,6,7,13,5,2013-02-22 22:55:11,2013-02-22 22:50:47
e5a8df06be8ce82f5ba10dca5087339704ffd0fa...dcf651c27edff13236fda0a480059b57dbe6e074,1,9,2,11,2,2013-02-22 23:08:48,2013-02-22 23:06:45
dcf651c27edff13236fda0a480059b57dbe6e074...7ec2a21be15af5b2c7513482c3bcfdd1e12782ed,12,148,67,215,70,2013-02-23 09:18:08,2013-02-23 08:45:56
226a9fb2ea417dacbd01c95dd5283c9478e0abf6...21189cb80b9960940008a52cdc0de86145176497,1,2,0,2,2,2013-02-27 21:48:17,2013-02-27 21:48:17
233f86443c30580de24d4f302fa40ce9db5c0b9e...f79013843d9e3ffced16eba34068fbff2cda2c0d,1,1,1,2,1,2012-11-17 15:00:19,2012-11-17 14:59:34
f79013843d9e3ffced16eba34068fbff2cda2c0d...7a38e86bde3cae12353fe0a4b5de9420ba780fb1,1,8,11,19,5,2012-11-17 15:26:10,2012-11-17 15:05:34
7a38e86bde3cae12353fe0a4b5de9420ba780fb1...8c69278764ae31b0cd495d21b84444bf2471c103,1,3,5,8,1,2012-11-17 15:34:14,2012-11-17 09:51:30
8c69278764ae31b0cd495d21b84444bf2471c103...ec9d6b1122dd09168d8b2dbcabc745f22f0ef766,3,13,2,15,4,2012-11-17 16:06:24,2012-11-17 16:06:24
ec9d6b1122dd09168d8b2dbcabc745f22f0ef766...9e7723f851dc6e4d5eea96ab808e1a4cdd4eabd7,1,140,133,273,19,2012-11-17 16:18:01,2012-11-10 01:17:43
9e7723f851dc6e4d5eea96ab808e1a4cdd4eabd7...2a67374b51c5705d5c64a5d7117ad8552e98b4bb,2,15,4,19,4,2012-11-17 16:25:21,2012-10-11 21:20:25
2a67374b51c5705d5c64a5d7117ad8552e98b4bb...e0363c688d9b85124ec4fbac00debe5f4dc1e63c,2,12,5,17,6,2012-11-17 18:19:59,2012-11-17 18:16:30
e0363c688d9b85124ec4fbac00debe5f4dc1e63c...7058b595b668b49daef8beb76a2b5c5f1d991b00,4,587,1,588,5,2012-11-17 19:10:25,2012-10-31 00:09:49
7058b595b668b49daef8beb76a2b5c5f1d991b00...1520748dac95a7f114e4bb2feeee04d46c720494,4,52,2,54,6,2012-11-17 19:24:54,2012-11-17 19:24:54
b7e44313bb7b44e83d64cd6c490e26d90142438f...d913a8b41281c506451156bdebc9a1851cb49fae,2,8,9,17,7,2012-11-29 15:36:43,2012-11-29 15:36:43
d913a8b41281c506451156bdebc9a1851cb49fae...0eeae15056edf07f786d3be5b47c14ab62eacd31,9,14,14,28,14,2012-11-29 20:45:43,2012-11-24 17:25:42
0eeae15056edf07f786d3be5b47c14ab62eacd31...008e625c669513371e27964a82ad6a0abeefc49d,1,1,1,2,1,2012-11-30 20:10:52,2012-11-30 20:10:52
008e625c669513371e27964a82ad6a0abeefc49d...84a5294788eed87e042823f2e49900b6044e3b77,1,1,0,1,1,2012-12-01 06:54:42,2012-12-01 06:54:42
84a5294788eed87e042823f2e49900b6044e3b77...a0cd6dd11e81cd0e229d6d109524c8a7e52bc9e1,2,26,2,28,5,2012-12-01 11:22:43,2012-12-01 11:17:00
a0cd6dd11e81cd0e229d6d109524c8a7e52bc9e1...c0efbc7b534c716fdfba2e5e32a4c41b90f334eb,1,0,1,1,1,2012-12-01 12:52:26,2012-12-01 12:52:26
c0efbc7b534c716fdfba2e5e32a4c41b90f334eb...349c4c37f8be401592793b47a591ff079c4a7fbb,3,25,6,31,8,2012-12-01 13:05:52,2012-10-13 10:21:35
349c4c37f8be401592793b47a591ff079c4a7fbb...90d3af380e8efec0301dd91600c6686232de3943,32,19,163,182,67,2012-12-01 13:15:06,2012-12-01 13:15:06
0073f1d94fad3f04ed77e63984cfd7827f78e580...bb011cf809359da3f717e35b5e70fec7897dd22f,1,3,8,11,1,2013-08-21 19:38:07,2013-08-21 19:38:07
c7c19ac4080a533ef881b57e88e1efbc2882f7d2...df462cf7604578c2afd43b988b7ea1fe5e727896,2,15,1,16,3,2013-09-06 19:46:43,2013-09-06 18:43:58
df462cf7604578c2afd43b988b7ea1fe5e727896...db3de528071ac66903f82c2fe5b34db4a5281f5b,1,9,7,16,1,2013-09-06 20:01:29,2013-09-06 20:01:29
db3de528071ac66903f82c2fe5b34db4a5281f5b...5ca290f5db3a5f735cdbdc7130c044192beb7f66,2,13,5,18,4,2013-09-06 20:15:35,2013-09-06 20:15:35
5ca290f5db3a5f735cdbdc7130c044192beb7f66...efd1e6096ee87fe332cf989ba5479e9461d0fb3a,13,169,22,191,25,2013-09-06 20:28:12,2013-09-06 20:27:51
c7c19ac4080a533ef881b57e88e1efbc2882f7d2...559cb826b850faeb7ad198a3a78a38f07dcf3b42,1,1,1,2,1,2013-09-06 19:37:43,2013-09-06 19:37:43
b4cd8169de604943f8aaee3666282c95e650e5f4...77da814827bcdb32e62aca55c486a1cf447d420d,1,1,0,1,1,2013-09-06 22:16:40,2013-09-06 22:16:40
ffe21e1f40b99d82d441eb46de323c6bfb0687e9...2326dedde81c59950d2b1e0653a837e1d7019acd,2,24,10,34,4,2013-09-06 17:24:18,2013-09-06 17:16:06
ffe21e1f40b99d82d441eb46de323c6bfb0687e9...6f7977bb63ea592faaa7b3bdf2898f8361f30260,1,13,0,13,1,2013-09-06 17:16:03,2013-09-06 16:46:33
6f7977bb63ea592faaa7b3bdf2898f8361f30260...cdeff3acc2b7d77b7f309db7e98878e08ad9ff25,2,104,5,109,12,2013-09-06 17:16:03,2013-09-06 17:14:09
cdeff3acc2b7d77b7f309db7e98878e08ad9ff25...be983ee4031bb91f0a56e310633adbc50d9221a3,1,10,1,11,2,2013-09-06 17:18:24,2013-09-06 17:18:24
be983ee4031bb91f0a56e310633adbc50d9221a3...273a1e6b8d42f9c0d2ff8ad88eedbc83ae3ee12b,2,14,40,54,4,2013-09-06 17:31:50,2013-09-06 17:15:09
273a1e6b8d42f9c0d2ff8ad88eedbc83ae3ee12b...a962286b74f1e8c8cb19fb45a057800da8c2fb56,4,115,80,195,18,2013-09-06 17:31:50,2013-09-06 17:31:44
a962286b74f1e8c8cb19fb45a057800da8c2fb56...05e14e8eaf577e64dc45e26466ebb6117589e572,2,42,3,45,6,2013-09-06 17:39:46,2013-09-06 17:32:52
28a571348bca9c5a3c137e495e7d3c9349a5bd56...496b4d03314a96549d3e1f5c69d2d35bc4716906,1,5,1,6,5,2013-09-14 19:32:25,2013-09-14 19:32:25
28a571348bca9c5a3c137e495e7d3c9349a5bd56...aeed2cf3b23161f228c8b221e56ea4d8a7cf71aa,1,13,0,13,1,2013-09-09 11:59:35,2013-09-09 11:59:35
aeed2cf3b23161f228c8b221e56ea4d8a7cf71aa...6dca603abb0eb164ba87657caf5cc65bca449719,2,9,1,10,3,2013-09-09 12:47:41,2013-09-06 18:47:08
6dca603abb0eb164ba87657caf5cc65bca449719...7c6f2ddcd9ab0d4a3a134da3f62e3d115045b4b9,2,47,25,72,5,2013-09-09 13:03:50,2013-09-04 10:53:55
7c6f2ddcd9ab0d4a3a134da3f62e3d115045b4b9...5e1c7d4cf6019772d861ea8408b60377b5352e71,1,1,0,1,1,2013-09-09 13:03:50,2013-09-08 03:11:57
5e1c7d4cf6019772d861ea8408b60377b5352e71...1185370c2c7e66428c45c69e960d10198e17e367,1,1,0,1,1,2013-09-09 13:25:13,2013-07-06 02:38:33
1185370c2c7e66428c45c69e960d10198e17e367...cbf08c6b0ca39406cada4bd1ffc6d334a79822e8,3,23,0,23,3,2013-09-09 13:47:18,2013-09-08 19:57:36
cbf08c6b0ca39406cada4bd1ffc6d334a79822e8...789d8f07487f80c5b90ec9cbb1fcf99837ef3ace,1,1,1,2,1,2013-09-09 13:54:08,2013-09-09 13:54:08
789d8f07487f80c5b90ec9cbb1fcf99837ef3ace...fb51c9a0f262eae0ebb36ba1067dc0a4db314401,2,2,2,4,2,2013-09-09 15:30:31,2013-09-09 15:30:31
fb51c9a0f262eae0ebb36ba1067dc0a4db314401...0d74f9553c6acb8b53a502ca5e39542dcc4412c1,2,57,35,92,5,2013-09-09 16:51:03,2013-09-07 12:32:12
0d74f9553c6acb8b53a502ca5e39542dcc4412c1...910a5760f6f5ffc42b4b264b08057207b8e26106,1,11,6,17,2,2013-09-09 18:22:29,2013-09-09 18:22:29
910a5760f6f5ffc42b4b264b08057207b8e26106...a52cc1c0888c2cedb07b2c0619c1a92a2f6e2c40,2,5,1,6,2,2013-09-09 19:19:09,2013-09-09 16:48:56
a52cc1c0888c2cedb07b2c0619c1a92a2f6e2c40...9d700322b38ea670800a97f2b92dd2fc2c6ff28d,20,49,58,107,46,2013-09-09 20:03:13,2013-09-09 08:59:47
9d700322b38ea670800a97f2b92dd2fc2c6ff28d...ec2778b445546f624d3b3a1f2118e751b10bb2e7,8,117,21,138,29,2013-09-09 20:32:51,2013-09-08 07:04:31
ec2778b445546f624d3b3a1f2118e751b10bb2e7...d9413d33b2a8371731a92289123683cf6f440290,12,75,76,151,56,2013-09-09 20:32:52,2013-09-08 08:43:33
d9413d33b2a8371731a92289123683cf6f440290...df2fd4e09b1d51e5154e607babf232610a0ec0c4,32,0,78,78,32,2013-09-09 21:01:07,2013-09-09 20:44:38
908efca81723af7a3f4fb5b586e530ed7cd3952b...83ba0a9d4b078fd177ac5c06699486d708d62bff,9,59,11,70,13,2012-10-27 16:31:00,2012-10-27 09:49:46
83ba0a9d4b078fd177ac5c06699486d708d62bff...04b00b668d0d56c37460cbed19671f4b1b5916c3,5,52,15,67,17,2012-10-27 17:40:39,2012-10-27 17:18:03
04b00b668d0d56c37460cbed19671f4b1b5916c3...b7d81715dc85fd5ec10a207b8b6ebca8399497e0,1,1,1,2,1,2012-10-27 19:21:33,2012-10-27 19:18:48
b7d81715dc85fd5ec10a207b8b6ebca8399497e0...fc2681b22b120a468607c6aeb06163d8e5dbf897,1,17,9,26,1,2012-10-27 19:55:50,2012-10-27 19:55:50
fc2681b22b120a468607c6aeb06163d8e5dbf897...cd17a24083f3ef17cf4c40a41c9d03c250d817c6,4,73,26,99,17,2012-10-27 21:15:45,2012-10-27 19:32:50
cd17a24083f3ef17cf4c40a41c9d03c250d817c6...882c47cd405cfd29194f2e968678a5aa1d6ec75f,1,5,3,8,6,2012-10-27 21:15:45,2012-10-27 19:59:35
882c47cd405cfd29194f2e968678a5aa1d6ec75f...5fec97b9df6ea075483276de159e522a29437773,9,176,29,205,28,2012-10-28 08:19:38,2012-10-27 21:12:08
5fec97b9df6ea075483276de159e522a29437773...aff9b2f5662f8a007bb90a427190c0d573a3ba65,2,11,2,13,5,2012-10-28 08:34:05,2012-10-28 08:34:05
aff9b2f5662f8a007bb90a427190c0d573a3ba65...785bf0d5a04d8466091a701b732b0c6f87b548e4,1,1,1,2,1,2012-10-28 11:33:38,2012-10-28 11:33:38
785bf0d5a04d8466091a701b732b0c6f87b548e4...98032f67c725e257bd3c53374ff0ee22e2c77d7c,1,3,1,4,1,2012-10-28 11:40:10,2012-10-28 11:40:10
98032f67c725e257bd3c53374ff0ee22e2c77d7c...611c4d6f1c24763e5e6e331a5dcf9b610288aaa8,3,128,15,143,15,2012-10-28 15:31:35,2012-10-28 14:47:07
611c4d6f1c24763e5e6e331a5dcf9b610288aaa8...58a086acfbec833f44cd53e984972250bbb67457,1,10,6,16,7,2012-10-28 15:57:15,2012-10-28 15:42:34
58a086acfbec833f44cd53e984972250bbb67457...58337b32236eb57d82bf62ed077add3ec69e37f2,1,5,0,5,1,2012-10-28 17:03:23,2012-10-28 15:51:51
58337b32236eb57d82bf62ed077add3ec69e37f2...b4420d96023b9d9067ebc8e8dcd8ca7cea41aff1,1,8,5,13,2,2012-10-28 18:57:03,2012-10-28 18:56:19
b4420d96023b9d9067ebc8e8dcd8ca7cea41aff1...0b98ef632147a26f2430a3ede48d9e58983cc3ae,1,5,2,7,2,2012-10-28 21:18:09,2012-10-28 21:18:09
0b98ef632147a26f2430a3ede48d9e58983cc3ae...effe96b303aba45a88e1a24f613fef9ad974a53a,1,2,2,4,2,2012-10-28 21:35:25,2012-10-28 21:35:01
0e3690d2309e64ce7b7ae4938d41544c25f29870...e94f8babc2b649f5204656c740ed232d8fa571d1,1,11,11,22,7,2012-11-22 22:16:04,2012-11-22 22:16:04
e94f8babc2b649f5204656c740ed232d8fa571d1...c13912ac7f8d5af6e0d3091d627981c005f08130,1,1,1,2,1,2012-11-22 23:01:20,2012-11-22 23:01:20
c13912ac7f8d5af6e0d3091d627981c005f08130...2875b5dcab23c027d019656b08da8b911bc60711,1,9,6,15,5,2012-11-23 09:02:18,2012-11-23 09:02:18
2875b5dcab23c027d019656b08da8b911bc60711...63e6cd1bb3edccb4db1eb6a79153fa31d2114cd4,1,8,0,8,1,2012-11-23 12:00:08,2012-11-23 12:00:08
0e3690d2309e64ce7b7ae4938d41544c25f29870...eabb44417ce1842007719b4b9378acca0e668b45,1,4,3,7,2,2012-11-22 21:29:39,2012-11-22 21:29:39
e06189f7ceb48013b37b902588bea6750c989b14...5301a9d7b1c2151e9b0496c7e244e8ceb6d273c1,4,2,7,9,8,2012-08-23 08:16:16,2012-08-23 08:16:16
5301a9d7b1c2151e9b0496c7e244e8ceb6d273c1...03671ad7e30749ecde70a7af04fff0b57476b1e0,1,5,4,9,2,2012-08-23 08:24:50,2012-08-23 08:23:23
03671ad7e30749ecde70a7af04fff0b57476b1e0...44c09de555f83b0596a0886e3f51a9a84368d036,3,33,12,45,9,2012-08-23 08:59:22,2012-08-23 08:56:55
44c09de555f83b0596a0886e3f51a9a84368d036...10d32072afa1e1d4391108191800ce7007a63f2e,1,2,2,4,2,2012-08-23 09:27:56,2012-08-23 09:18:41
934f35f1f958f48a36eff64b13e43a9d55a476e0...443999a1eeea70e4deebcf31f8f845696be62c3d,1,8,1,9,2,2012-10-04 12:03:48,2012-10-04 12:03:48
934f35f1f958f48a36eff64b13e43a9d55a476e0...c76877c1d2985e37c3c988d107c44e829fb118af,1,3,0,3,1,2012-10-03 10:59:24,2012-10-03 10:56:15
c76877c1d2985e37c3c988d107c44e829fb118af...d25a599dca9b7644b238f6c89a66545dfdabe393,2,5,2,7,3,2012-10-03 11:32:26,2012-10-03 11:32:26
d25a599dca9b7644b238f6c89a66545dfdabe393...218abcc9e550d266a9979e10f562fc21b8f34c6a,6,40,7,47,11,2012-10-03 17:47:35,2012-10-03 16:50:12
218abcc9e550d266a9979e10f562fc21b8f34c6a...8c427448d53ec0d860e1669f35deed73d0240ba1,2,77,5,82,7,2012-10-03 20:10:32,2012-10-03 19:51:11
8c427448d53ec0d860e1669f35deed73d0240ba1...1c03b23567a3098b9ab5df64b14e0dea8d1414ea,1,5,0,5,1,2012-10-03 21:43:23,2012-10-03 10:58:16
1c03b23567a3098b9ab5df64b14e0dea8d1414ea...234ca6c61d27d1cd430a5290ff858c25afb93098,3,6,6,12,6,2012-10-03 21:44:56,2012-10-03 18:43:36
234ca6c61d27d1cd430a5290ff858c25afb93098...89544b2bd2323cdc5c29e056838a23abcee07d6e,1,1,0,1,1,2012-10-04 07:51:14,2012-10-03 18:03:01
89544b2bd2323cdc5c29e056838a23abcee07d6e...725128289398ba4bce60a4093d9d69bbcea01d92,1,15,0,15,1,2012-10-04 07:51:14,2012-10-03 18:06:05
725128289398ba4bce60a4093d9d69bbcea01d92...a1a5c0854f0b0d3c94a772c8b994ee2d1d2f9be1,2,3,3,6,5,2012-10-04 10:45:22,2012-10-04 10:45:22
a1a5c0854f0b0d3c94a772c8b994ee2d1d2f9be1...0ad6d7e61294befd5868c5ab422669d9ef3db52f,2,1,14,15,2,2012-10-04 20:35:59,2012-10-04 20:35:59
0ad6d7e61294befd5868c5ab422669d9ef3db52f...53c8b2c0c52cf999b644184bfe51e9f59d89286e,5,38,34,72,26,2012-10-04 20:41:03,2012-10-04 20:41:03
e758ecc628bb1d8960d0a59a140a43d7103e89e4...486e67598f8d8e83890ef3c90399d660d8e9eee6,1,6,0,6,3,2012-09-21 11:17:25,2012-09-21 11:12:51
486e67598f8d8e83890ef3c90399d660d8e9eee6...2b1ae4dbd2b0389e1e412d68262cd2a9b8209a70,1,1,1,2,1,2012-09-21 23:22:50,2012-09-21 23:22:50
2b1ae4dbd2b0389e1e412d68262cd2a9b8209a70...69ff1b7390e140f332a5aa55c44a091c838923fb,2,3,1,4,2,2012-09-22 07:16:22,2012-09-07 16:42:06
69ff1b7390e140f332a5aa55c44a091c838923fb...59afc18f3735abfd7ab4b1a904000a547daed4ca,1,85,49,134,20,2012-09-22 09:39:53,2012-09-22 09:38:19
59afc18f3735abfd7ab4b1a904000a547daed4ca...baa33cd8faa16737524b1ac355802a10dd63571c,4,61,22,83,19,2012-09-22 09:47:34,2012-09-22 09:45:51
baa33cd8faa16737524b1ac355802a10dd63571c...822cfce3df53301d9f9f4c14bd8a0cb2a1956e2e,3,8,3,11,3,2012-09-22 10:02:21,2012-09-22 10:02:21
822cfce3df53301d9f9f4c14bd8a0cb2a1956e2e...2aaa467a2ab57d5616d384a70e2b6f8217ece63e,1,7,0,7,1,2012-09-22 11:09:12,2012-09-22 11:08:40
2aaa467a2ab57d5616d384a70e2b6f8217ece63e...0ab8c58ca896643ea0bb0830a96274160d14cc69,1,2,2,4,1,2012-09-22 13:10:42,2012-09-22 13:10:42
0ab8c58ca896643ea0bb0830a96274160d14cc69...8599f64e54adfb32ee6550ed7a6ec9944034d978,2,7,0,7,2,2012-09-22 13:17:13,2012-09-22 13:17:13
8599f64e54adfb32ee6550ed7a6ec9944034d978...3174b5f2f5bb0b0a6b775a1a50464b6bf2a4b067,2,6,1,7,2,2012-09-23 11:27:01,2012-09-23 11:25:47
3174b5f2f5bb0b0a6b775a1a50464b6bf2a4b067...8cdc84726e13da4c796db614765658835d4786a1,9,44,28,72,29,2012-09-23 17:55:53,2012-09-23 17:55:52
8cdc84726e13da4c796db614765658835d4786a1...5330cd50cdb0674cd08cbfb40af9ac51267fbbec,19,106,80,186,83,2012-09-23 17:59:27,2012-09-23 17:59:27
5330cd50cdb0674cd08cbfb40af9ac51267fbbec...98b6ce60f4f4456fb00259ec118e1fed2a4dfaa4,1,1,1,2,1,2012-09-23 18:18:29,2012-09-23 18:17:36
98b6ce60f4f4456fb00259ec118e1fed2a4dfaa4...799786a7b64937314250bc638a60b1d4e132bec2,1,6,1,7,2,2012-09-23 18:32:52,2012-09-23 18:19:58
799786a7b64937314250bc638a60b1d4e132bec2...874908e3bba8538d1c108e1b38f9d9519c6e5416,1,3,2,5,3,2012-09-23 18:32:52,2012-09-23 18:32:17
874908e3bba8538d1c108e1b38f9d9519c6e5416...43c7f8c3a3cfaec001a76b1b683de3cc47eb2d2f,1,3,2,5,2,2012-09-23 20:11:46,2012-09-23 20:11:46
43c7f8c3a3cfaec001a76b1b683de3cc47eb2d2f...54c81a1c936f3682e3405d6737958fdffa39bed9,1,1,1,2,1,2012-09-23 20:49:22,2012-09-23 20:49:22
54c81a1c936f3682e3405d6737958fdffa39bed9...6eda8d784a128309a67540fb0a62373667958daa,1,1,1,2,1,2012-09-24 14:06:04,2012-09-24 14:03:12
6eda8d784a128309a67540fb0a62373667958daa...e72e22e518a730cd28cd68c9374fa79a45e27a9c,1,1,1,2,1,2012-09-24 14:07:58,2012-09-24 14:07:58
e72e22e518a730cd28cd68c9374fa79a45e27a9c...fc69fff9ab5bba8a6cff3eaf51f02a3204b1c015,4,52,44,96,7,2012-09-24 20:12:45,2012-09-24 20:11:42
fc69fff9ab5bba8a6cff3eaf51f02a3204b1c015...515fd6a5de2f1bf817fac9ced07d0485d594b510,1,2,1,3,1,2012-09-24 20:42:58,2012-09-24 20:42:58
9a62fc3f938dcc266a367a4537b516b67c48131b...712a7927139e3abf9532d73bc88d35e0ebb3a022,1,7,8,15,1,2013-04-11 18:13:09,2013-04-11 18:13:09
712a7927139e3abf9532d73bc88d35e0ebb3a022...0f99246b6f4e7d08600c19fbbeb8feb1a335f985,1,13,0,13,1,2013-04-12 08:17:17,2013-04-12 08:13:38
0f99246b6f4e7d08600c19fbbeb8feb1a335f985...ab686022f8619b57e7f851fb2ce8617583d70d8d,3,42,18,60,5,2013-04-12 08:17:17,2013-04-06 14:04:30
ab686022f8619b57e7f851fb2ce8617583d70d8d...8fc68af9c09f47760080327fb820fe88f02f9bf9,1,4,3,7,1,2013-04-12 10:10:26,2013-04-12 10:10:26
8fc68af9c09f47760080327fb820fe88f02f9bf9...b04fd579d58332632c85ecd1ab3c7062e90086a8,2,18,7,25,7,2013-04-12 18:12:42,2013-04-12 18:00:49
b04fd579d58332632c85ecd1ab3c7062e90086a8...d58e985aaa48150e43d51d3eeb2713e28a8e61e9,1,3,0,3,1,2013-04-12 18:59:56,2013-04-12 18:59:56
d58e985aaa48150e43d51d3eeb2713e28a8e61e9...cdf520ee86e7613f29421fb2c99646ce00899b3d,13,12,12,24,6,2013-04-12 21:00:17,2013-04-06 16:44:58
cdf520ee86e7613f29421fb2c99646ce00899b3d...751b007c9840de9cb4e5fc622e8ea9f44e5554ca,3,97,85,182,9,2013-04-12 21:00:48,2013-04-06 17:09:44
751b007c9840de9cb4e5fc622e8ea9f44e5554ca...6f3e1397394da838db9e9aee6ba0eb102ac6f49b,4,34,21,55,2,2013-04-12 21:05:34,2013-04-12 21:04:40
6f3e1397394da838db9e9aee6ba0eb102ac6f49b...5e84abec14fe43cc08198411cbd2b67804ab7e47,9,8,8,16,1,2013-04-12 21:07:24,2013-04-06 18:29:35
5e84abec14fe43cc08198411cbd2b67804ab7e47...3ca3d2206c31ed251474d66b6775fa0903c09eae,8,6,6,12,5,2013-04-12 21:10:04,2013-04-06 18:43:31
3ca3d2206c31ed251474d66b6775fa0903c09eae...44293c5c053d616326d5dfe82252e5e8431d81ea,2,1,1,2,1,2013-04-12 21:11:12,2013-04-06 18:45:36
44293c5c053d616326d5dfe82252e5e8431d81ea...3810dc3070468abd3a3d9beec406a5aa3edd6b52,10,11,11,22,4,2013-04-12 21:13:59,2013-04-06 18:51:40
3810dc3070468abd3a3d9beec406a5aa3edd6b52...612ef3e5c9ba172868d22d93be64a340b7742fc6,28,27,27,54,3,2013-04-12 21:31:58,2013-04-06 18:59:39
612ef3e5c9ba172868d22d93be64a340b7742fc6...e8446be5600a8f5022e82541df432268ae5f737d,2,1,1,2,1,2013-04-12 21:33:22,2013-04-06 19:01:32
e8446be5600a8f5022e82541df432268ae5f737d...56e777eba3687bd56b954de4b3dfa44775481b14,7,5,5,10,2,2013-04-12 21:42:07,2013-04-06 19:04:06
56e777eba3687bd56b954de4b3dfa44775481b14...6d968317698b99115be2652a9e2e41adc3a28e79,2,1,1,2,1,2013-04-12 21:42:58,2013-04-07 00:29:09
6d968317698b99115be2652a9e2e41adc3a28e79...aad5661c6c44ac58c4218fcac8d433ae2293dfce,2,8,8,16,6,2013-04-12 23:22:02,2013-04-12 23:22:02
aad5661c6c44ac58c4218fcac8d433ae2293dfce...3f05c70be065fd915d2cddc1e7f74d1d4cb1e54e,1,1,1,2,1,2013-04-13 09:09:47,2013-04-13 09:06:28
3f05c70be065fd915d2cddc1e7f74d1d4cb1e54e...844fbc85c1d419ed7ecbb7208bd392c1770ea72d,4,10,4,14,5,2013-04-13 09:09:47,2013-04-07 08:37:38
844fbc85c1d419ed7ecbb7208bd392c1770ea72d...f56b703b2748c958468344d894902ac18ec36d78,1,1,2,3,2,2013-04-13 09:38:13,2013-04-13 09:38:13
f56b703b2748c958468344d894902ac18ec36d78...c4186c2fec6f5418c81366a911792bf5295db494,5,20,12,32,10,2013-04-13 10:23:25,2013-04-12 21:22:31
c4186c2fec6f5418c81366a911792bf5295db494...9ac4dbd7b53d187ca54f28e247d3a120660938ca,4,107,59,166,28,2013-04-13 14:37:27,2013-04-13 00:02:28
9ac4dbd7b53d187ca54f28e247d3a120660938ca...be9ae693c46021fd3a70c0ec21dd566960b29ffb,3,28,15,43,9,2013-04-13 16:55:50,2013-04-13 16:20:01
be9ae693c46021fd3a70c0ec21dd566960b29ffb...a506b6981bc48caec30bca3de94d2ac3e6fc1660,4,133,119,252,31,2013-04-14 20:45:01,2013-04-14 14:55:17
a506b6981bc48caec30bca3de94d2ac3e6fc1660...1de63cccb101fc801b60eb5ed42663a9499e595a,1,1,1,2,1,2013-04-15 16:19:17,2013-04-15 16:19:17
1de63cccb101fc801b60eb5ed42663a9499e595a...bfb2504402ea80962f457cb042d9fef21439feb9,1,2,1,3,1,2013-04-15 16:28:20,2013-04-15 16:26:25
bfb2504402ea80962f457cb042d9fef21439feb9...1628dfd0b9200f709e4f174cb39b8fd398ad5d7d,1,3,3,6,3,2013-04-15 17:38:24,2013-04-15 17:36:44
1628dfd0b9200f709e4f174cb39b8fd398ad5d7d...53df89c0feca59517d407a6c35fdb16cb6349310,1,16,11,27,7,2013-04-15 18:27:58,2013-04-15 18:27:58
53df89c0feca59517d407a6c35fdb16cb6349310...b0bbccf6307b0f4914eabd520467bc159d25923f,1,1,1,2,1,2013-04-15 20:23:35,2013-04-15 20:23:35
b0bbccf6307b0f4914eabd520467bc159d25923f...58b3a974fc30c369eabacc747e1763cf04d053fd,1,1,1,2,1,2013-04-16 06:59:55,2013-04-16 06:58:39
58b3a974fc30c369eabacc747e1763cf04d053fd...a98465c040319b74b697bace11da5b13cc42427f,2,3,2,5,2,2013-04-16 19:34:06,2013-04-16 19:34:06
a98465c040319b74b697bace11da5b13cc42427f...356443fd956c45e66c24256edc8f673d773b6ac8,1,2,2,4,2,2013-04-18 05:55:12,2013-04-18 05:55:12
356443fd956c45e66c24256edc8f673d773b6ac8...93c1576f17f6c5ee73f94f8de007f3c33010dc81,1,1,1,2,1,2013-04-18 09:47:25,2013-04-18 09:46:51
d9b12ecbe62aa7c9fb0f913e7eefc21662f8e21b...066bf42675040abd7b1a42e5559890e5f9881058,3,13,33,46,16,2013-03-25 20:38:21,2013-03-25 20:25:53
066bf42675040abd7b1a42e5559890e5f9881058...ccf8d8111339fffc63d0334e83d9db8c99e9172e,1,1,0,1,1,2013-03-26 00:56:52,2013-03-26 00:56:52
ccf8d8111339fffc63d0334e83d9db8c99e9172e...a4b8a4b632dbb6d9fed1a8654aed99a9c53560d4,2,8,3,11,5,2013-03-26 03:45:27,2013-03-24 02:11:55
a4b8a4b632dbb6d9fed1a8654aed99a9c53560d4...e17fa9e877e84e93b699c2bd13ea48dbbb86e451,2,16,1,17,3,2013-03-26 12:19:54,2013-03-24 20:59:44
d9b12ecbe62aa7c9fb0f913e7eefc21662f8e21b...a05042fd3a225c8de1cca4bcfb64bf0594ecff3c,1,3,3,6,1,2013-03-25 12:19:30,2013-03-25 12:12:53
014638a1311dfc64e6f6eed28f12eeb227926150...521765f63d724f0a1becb614530170f5d00fc6a9,4,173,96,269,12,2013-03-24 20:19:19,2013-03-06 23:33:51
014638a1311dfc64e6f6eed28f12eeb227926150...0e0eb8a9553bb89347ceb159537ccc417cb5e7f5,1,14,0,14,3,2013-03-24 18:59:56,2013-03-24 18:57:02
7ec2a21be15af5b2c7513482c3bcfdd1e12782ed...2b76f19f2b89ac96bae2a169d71b23553c8101c7,2,19,0,19,3,2013-02-23 22:53:46,2013-02-23 22:50:02
7ec2a21be15af5b2c7513482c3bcfdd1e12782ed...664855b74e1f417384dc7aef35a3df5f86db52d6,2,36,2,38,4,2013-02-23 15:40:50,2013-02-23 12:42:04
7ec2a21be15af5b2c7513482c3bcfdd1e12782ed...069280a6893d0f496c8f15922807939c68459ec3,8,64,23,87,35,2013-02-23 14:15:30,2013-02-23 09:24:35
7ec2a21be15af5b2c7513482c3bcfdd1e12782ed...91c947066408d496f8990ba90fbf2c4d1d80f63f,1,2,0,2,1,2013-02-23 12:01:28,2013-02-23 12:01:28
21189cb80b9960940008a52cdc0de86145176497...af3321a1e80eece49bd934b4f03f9c4ddd702767,1,1,1,2,1,2013-02-27 22:33:47,2013-02-27 22:23:27
90d3af380e8efec0301dd91600c6686232de3943...2e2c4968f6b9b57354af7229687d179941ed74c5,3,28,3,31,8,2012-12-03 04:54:34,2012-12-03 04:54:34
2e2c4968f6b9b57354af7229687d179941ed74c5...baae4b818778180fedfcfcfc7aa77acfb9b237fb,2,4,4,8,4,2012-12-03 09:45:18,2012-12-03 09:37:26
90d3af380e8efec0301dd91600c6686232de3943...cacafe89d075e3db7dab6b2f26fe096a2beaabcb,1,1,1,2,1,2012-12-02 21:26:00,2012-12-02 21:26:00
90d3af380e8efec0301dd91600c6686232de3943...0ff1d4fa49832a60fe7f0dfb0ef6e6765c05c2fb,1,1,1,2,1,2012-12-02 02:55:26,2012-12-02 02:55:26
c5f768f8cc53a54686bcb1867cc4400393427ffe...8d65b6082c8bf5df25608d8733470879a8a61d7d,3,49,4,53,4,2013-08-22 07:51:07,2013-08-22 07:42:10
8d65b6082c8bf5df25608d8733470879a8a61d7d...8cd8742981020e315acc4e70bdf3613fcf68e3a8,1,1,1,2,2,2013-08-22 07:52:54,2013-08-22 07:14:06
8cd8742981020e315acc4e70bdf3613fcf68e3a8...297f5af222bde02a7cdd005da2e4b00ec81801de,2,21,7,28,5,2013-08-22 11:27:04,2013-08-22 11:25:21
297f5af222bde02a7cdd005da2e4b00ec81801de...ce0e86cf761dc182ae6fb8c0d68964955d19ec75,1,1,1,2,1,2013-08-22 12:53:14,2013-08-22 07:55:14
ce0e86cf761dc182ae6fb8c0d68964955d19ec75...bac4d03ce68eae7fe13f1891ecdc015817c6d1d8,1,0,4,4,1,2013-08-22 13:20:50,2013-08-20 09:26:48
bac4d03ce68eae7fe13f1891ecdc015817c6d1d8...2e926b041c36d46d921acba516a262e21ddaa60d,1,4,3,7,2,2013-08-22 13:37:03,2013-08-22 08:39:31
2e926b041c36d46d921acba516a262e21ddaa60d...768bbf3efe0c412bced1e865e90139a0f07dc613,1,1,1,2,1,2013-08-22 13:47:17,2013-08-22 13:47:17
768bbf3efe0c412bced1e865e90139a0f07dc613...6af05e7a0f0e4604d6a67899acaa99d73ec0dfaa,5,53,4,57,8,2013-08-22 14:24:07,2013-08-14 08:05:01
6af05e7a0f0e4604d6a67899acaa99d73ec0dfaa...65cf82bd08631a7aa8d9dd007b2527476fa3304f,2,40,15,55,6,2013-08-22 14:08:54,2013-08-21 16:22:22
65cf82bd08631a7aa8d9dd007b2527476fa3304f...9d1987d7679165ad3a7c2b713a8a488cc1421905,2,21,0,21,3,2013-08-22 15:50:52,2013-05-18 20:15:10
9d1987d7679165ad3a7c2b713a8a488cc1421905...b0ce6fe656873825271bacb55e55474fc346c1c6,13,218,77,295,34,2013-08-22 17:58:26,2013-08-22 00:12:19
b0ce6fe656873825271bacb55e55474fc346c1c6...57c82f909b212708a17edd11014be718bd02be3b,2,7,7,14,7,2013-08-23 00:25:35,2013-08-22 15:14:56
70440a8bd17a9798f2164115dfa6068bc0a0f4f2...67863b3bfebaa5bc3556d2c7612c7fcc2e3b2348,1,1,1,2,1,2013-09-06 23:59:25,2013-09-06 23:59:25
67863b3bfebaa5bc3556d2c7612c7fcc2e3b2348...498014ccd5f0ab6281e60fd29d754376aed93111,1,1,1,2,1,2013-09-07 00:07:57,2013-09-07 00:07:57
498014ccd5f0ab6281e60fd29d754376aed93111...adc0ab3386520874dbc96c2f905fd66769b8f16d,2,7,2,9,3,2013-09-07 00:13:01,2013-09-05 03:36:31
adc0ab3386520874dbc96c2f905fd66769b8f16d...b7451b72edfde0c1ad3c6e33a7a170f16fc53083,1,2,2,4,1,2013-09-07 00:36:17,2013-09-07 00:36:17
05e14e8eaf577e64dc45e26466ebb6117589e572...b2f5ac16565605f20a0c4e90acc6beed5a5ac1ce,2,24,0,24,3,2013-09-06 18:32:46,2013-09-06 18:23:50
b2f5ac16565605f20a0c4e90acc6beed5a5ac1ce...0756a4d664b3d243a70aa53567cec5d8d25e37f7,1,1,0,1,1,2013-09-07 00:36:42,2013-09-07 00:36:42
5c645ec81a872116533ee6d3928b750d3737b68a...bac86ad1a350ba99464e9a24a589e7833a901730,2,2,3,5,3,2013-09-14 19:34:57,2013-09-14 19:34:57
bac86ad1a350ba99464e9a24a589e7833a901730...3c5775d36f7e431d9691829a78580873111cb714,1,2,1,3,2,2013-09-14 20:58:30,2013-09-14 20:58:30
3c5775d36f7e431d9691829a78580873111cb714...2fa0dd73b18f55d0fdd1c1d54b1d18031bfcf1ed,1,8,4,12,2,2013-09-14 21:24:48,2013-09-14 21:23:45
2fa0dd73b18f55d0fdd1c1d54b1d18031bfcf1ed...351a061497b262e2ef994552d04c31b63d801179,1,5,4,9,2,2013-09-14 23:11:07,2013-09-14 23:11:07
351a061497b262e2ef994552d04c31b63d801179...aae5a96d5754ad34e48b7f673ef2411a3bbc1015,4,153,17,170,37,2013-09-15 05:42:23,2013-09-15 05:40:16
aae5a96d5754ad34e48b7f673ef2411a3bbc1015...8d29005524b141da8ff4d9b9bc4d858d43bb7154,9,108,19,127,12,2013-09-15 18:14:26,2013-09-15 18:14:26
8d29005524b141da8ff4d9b9bc4d858d43bb7154...18ffdb1772ba60e085cff8fd9a1d4a7b129b4032,58,111,84,195,86,2013-09-16 16:52:05,2013-09-16 16:52:05
18ffdb1772ba60e085cff8fd9a1d4a7b129b4032...f40c82213f28109be8eb3ee516bc4a13461352c8,4,28,0,28,4,2013-09-16 16:53:42,2013-09-16 16:53:42
f40c82213f28109be8eb3ee516bc4a13461352c8...1234225068e0a48ad22fe46a9ff1a6c482a74389,1,3,0,3,3,2013-09-16 17:12:50,2013-09-16 17:12:50
1234225068e0a48ad22fe46a9ff1a6c482a74389...9d12f68a53477a90bb4ad8eb223b04c09bcca11e,1,10,8,18,1,2013-09-16 20:49:46,2013-09-16 20:49:46
9d12f68a53477a90bb4ad8eb223b04c09bcca11e...5abc43cabfa80d4c95d00edff5a948cf3d6e61d5,1,5,5,10,3,2013-09-17 08:05:45,2013-09-17 08:05:45
5abc43cabfa80d4c95d00edff5a948cf3d6e61d5...94001421321bd8808c4027a72aa32a1eef005764,3,18,12,30,12,2013-09-17 09:18:55,2013-09-15 07:12:16
94001421321bd8808c4027a72aa32a1eef005764...f5f662fa5f4efd1f0fdd7901ed58c34f384af532,4,20,1,21,6,2013-09-17 14:21:11,2013-09-17 14:21:11
f5f662fa5f4efd1f0fdd7901ed58c34f384af532...8e04ad9fc2ba759cf3fc701d5423b44cbbf8ecb5,1,8,0,8,2,2013-09-17 14:34:12,2012-11-06 15:20:37
8e04ad9fc2ba759cf3fc701d5423b44cbbf8ecb5...73a610d2a81bc3bf2d3834786b2458bc85953ed0,2,14,12,26,7,2013-09-17 14:41:01,2013-09-17 14:28:20
73a610d2a81bc3bf2d3834786b2458bc85953ed0...5a424c2393bf9f2524b8075723e90298c1297846,2,59,2,61,6,2013-09-17 15:47:19,2013-09-17 09:48:48
5a424c2393bf9f2524b8075723e90298c1297846...2c6079775e12366279dc0bb094ba860e4473be3c,1,1,1,2,2,2013-09-17 16:39:25,2013-09-17 16:38:12
2c6079775e12366279dc0bb094ba860e4473be3c...a772ea8117c42a0027c79212a572f87614bb7173,2,23,1,24,2,2013-09-17 16:53:59,2013-09-17 09:54:55
a772ea8117c42a0027c79212a572f87614bb7173...5be56d0e0d8492a41b3d40757a4f2677211a9179,1,64,0,64,1,2013-09-17 17:23:32,2013-09-17 17:23:32
5be56d0e0d8492a41b3d40757a4f2677211a9179...50633e7353694ff54f14b04469be3792f286182f,2,16,2,18,4,2013-09-18 07:03:52,2013-09-18 06:56:05
50633e7353694ff54f14b04469be3792f286182f...893198509e3b821a56a56e4326929e0613aad983,2,2,6,8,2,2013-09-18 10:44:38,2013-09-16 20:20:29
893198509e3b821a56a56e4326929e0613aad983...2f0566fa61e13277364e3aef338fa5c143f5a704,10,111,12,123,30,2013-09-18 11:37:08,2013-09-15 21:51:24
2f0566fa61e13277364e3aef338fa5c143f5a704...4f40b97d9728175c195c81f2413d800238bc8804,1,14,12,26,4,2013-09-18 13:42:47,2013-09-18 13:35:51
4f40b97d9728175c195c81f2413d800238bc8804...2daada800f8e28cc1ba664b3008efaefab8fb570,3,57,9,66,9,2013-09-18 13:48:36,2013-09-17 11:46:38
2daada800f8e28cc1ba664b3008efaefab8fb570...d1c9802811b5c3f5abd3defcfecac160135fa6e7,11,27,28,55,21,2013-09-18 14:35:41,2013-09-18 14:35:41
d1c9802811b5c3f5abd3defcfecac160135fa6e7...98514849dce07acfaa224a90a784bba9d97249e5,6,127,1,128,10,2013-09-18 15:44:10,2012-12-18 00:04:10
df2fd4e09b1d51e5154e607babf232610a0ec0c4...522d3d61325811e7bec120ed1f3c2a5f89f701a0,1,1,1,2,1,2013-09-09 23:02:41,2013-09-09 23:02:41
effe96b303aba45a88e1a24f613fef9ad974a53a...f1cc2be0c53858b673afc3b26347d3bb25e424f6,4,22,8,30,4,2012-10-28 22:44:03,2012-10-28 22:02:41
f1cc2be0c53858b673afc3b26347d3bb25e424f6...4ea8105120121c7ef0d3dd6eb23f2bf5f55b496a,5,64,2,66,7,2012-10-29 06:04:03,2012-10-04 17:14:50
4ea8105120121c7ef0d3dd6eb23f2bf5f55b496a...4c4d08502cbef6e0ed85470b2a5aade7fafa099f,3,23,3,26,6,2012-10-29 14:31:54,2012-10-29 13:40:32
4c4d08502cbef6e0ed85470b2a5aade7fafa099f...b774c5993cf80000966ae8f04c985116f98ee5ac,1,4,0,4,2,2012-10-29 16:28:04,2012-10-29 16:26:10
b774c5993cf80000966ae8f04c985116f98ee5ac...d30516e163c1870b2467c63f97c8263f9da40226,1,23,27,50,34,2012-10-29 18:08:07,2012-10-29 18:08:07
d30516e163c1870b2467c63f97c8263f9da40226...bc00075d51cd3e3b5f9a4d7d0f138e0a819adcb9,1,12,4,16,2,2012-10-29 20:39:12,2012-10-29 20:39:12
bc00075d51cd3e3b5f9a4d7d0f138e0a819adcb9...24b2aad8e399fdeb4668fe6f4b7b997cf94100ca,1,2,1,3,1,2012-10-29 22:12:20,2012-10-29 22:12:20
24b2aad8e399fdeb4668fe6f4b7b997cf94100ca...81f5d4a1a7b955afe530d5292726b3a8a93d7038,2,3,0,3,3,2012-10-30 02:28:35,2012-10-30 02:27:01
81f5d4a1a7b955afe530d5292726b3a8a93d7038...2b5f848207b1dab35afd6f63d0107629c76d4d9a,2,32,17,49,10,2012-10-30 05:24:42,2012-10-02 16:16:37
2b5f848207b1dab35afd6f63d0107629c76d4d9a...9741912a9aaad083eaa8b9780cde37e1843cc4ae,3,40,5,45,7,2012-10-30 05:58:14,2012-09-09 20:25:06
9741912a9aaad083eaa8b9780cde37e1843cc4ae...6de6988f9990b4b53f5a20bfc3811b3cc49291c5,2,39,0,39,5,2012-10-30 08:00:32,2012-10-29 19:33:00
6de6988f9990b4b53f5a20bfc3811b3cc49291c5...5dc4437dfad8241a5830e4d2ab59635b814281d6,1,4,1,5,2,2012-10-30 08:28:19,2012-10-30 08:28:19
5dc4437dfad8241a5830e4d2ab59635b814281d6...43d7cee86e05dc267d66c3a308746fc1ac58271e,2,39,0,39,2,2012-10-30 20:35:23,2012-10-30 13:02:54
43d7cee86e05dc267d66c3a308746fc1ac58271e...9a02851340c5c30b8e2c174783cd86d5cab7ab81,3,19,16,35,7,2012-10-30 21:23:28,2012-10-27 20:38:15
9a02851340c5c30b8e2c174783cd86d5cab7ab81...73245b3285f63694d2c63c9b197165dc6d9cfd4e,3,34,28,62,17,2012-10-30 21:27:55,2012-10-30 21:20:42
73245b3285f63694d2c63c9b197165dc6d9cfd4e...2f035a9723d62a63027df4c779c665e8191dd95b,1,5,5,10,5,2012-10-30 22:05:47,2012-10-30 22:05:47
2f035a9723d62a63027df4c779c665e8191dd95b...08cf54990ae112083b159aa4e263c1f64f396f39,6,388,8,396,13,2012-10-30 22:40:21,2012-10-30 19:53:56
effe96b303aba45a88e1a24f613fef9ad974a53a...ee96f83ab0242476d36321efa7edf0bc17271994,1,2,2,4,2,2012-10-28 21:46:09,2012-10-28 21:46:09
9d4baf80c6b701bc6fe975fce3011f1388aeb046...fbd1df8e16fc17a5d73f36136298c20b8ec3d618,1,27,2,29,3,2012-11-23 15:06:31,2012-11-23 15:02:49
10d32072afa1e1d4391108191800ce7007a63f2e...395c6083af93cc37c7d16ef4db451091841cefdc,3,109,51,160,26,2012-08-23 19:46:57,2012-08-23 19:07:56
395c6083af93cc37c7d16ef4db451091841cefdc...f5ea730dac0986b2d48889a2d0fab2c5befb4494,3,16,11,27,8,2012-08-23 20:59:45,2012-08-23 20:50:25
f5ea730dac0986b2d48889a2d0fab2c5befb4494...6786b38ace99dfa4db4f70d32249450771c3fa0f,2,7,7,14,5,2012-08-24 00:18:29,2012-08-24 00:18:29
10d32072afa1e1d4391108191800ce7007a63f2e...f200ffd701468bbb983854749bee8a5ced96499c,1,2,2,4,2,2012-08-23 14:46:38,2012-08-23 14:46:38
515fd6a5de2f1bf817fac9ced07d0485d594b510...f51eab796d087439eedcb768cdd312517780940e,9,79,56,135,40,2012-09-25 01:02:59,2012-09-25 01:02:59
515fd6a5de2f1bf817fac9ced07d0485d594b510...29cd3d6c01d7afbcf5141430b2dd93daede22ade,1,1,1,2,1,2012-09-25 00:14:11,2012-09-25 00:14:11
93c1576f17f6c5ee73f94f8de007f3c33010dc81...f71fdf83a8959f1b2131965cd893925d91ce81bc,1,1,1,2,1,2013-04-18 17:41:55,2013-04-18 17:40:45
f71fdf83a8959f1b2131965cd893925d91ce81bc...9f7b277d2e14abd89972f7593aad3543a5028760,1,2,2,4,2,2013-04-18 17:44:20,2013-04-18 17:44:20
9f7b277d2e14abd89972f7593aad3543a5028760...5306285ce21d59742d67a447c9c1a1e4be6d86a4,2,16,0,16,3,2013-04-18 18:38:07,2013-04-18 18:38:07
5306285ce21d59742d67a447c9c1a1e4be6d86a4...bfe25de42993fdbfccd4759f48ac6694e1ed32d9,1,3,0,3,1,2013-04-19 07:53:50,2013-04-19 07:53:19
bfe25de42993fdbfccd4759f48ac6694e1ed32d9...59d127e45f5ed31e346162a0ac312f672c096821,2,13,0,13,2,2013-04-19 08:08:16,2013-04-17 15:20:31
59d127e45f5ed31e346162a0ac312f672c096821...714161c8642646f1f617436479313ca49c71b5c8,2,10,0,10,2,2013-04-19 17:58:29,2013-04-19 17:58:29
714161c8642646f1f617436479313ca49c71b5c8...3be8165b6267bea021df6e6c4e758a4c877c961e,1,1,4,5,2,2013-04-20 09:34:35,2013-04-20 09:30:00
3be8165b6267bea021df6e6c4e758a4c877c961e...4e25198ec298732409217321be10e1e06be2fcbd,2,12,8,20,5,2013-04-20 15:18:21,2013-03-25 05:48:23
4e25198ec298732409217321be10e1e06be2fcbd...1ddeeb5b8ed5b2cf28302c8aca0a2915a3cfb240,1,1,3,4,1,2013-04-20 15:18:29,2013-03-25 05:52:56
1ddeeb5b8ed5b2cf28302c8aca0a2915a3cfb240...78c842a3230f026ad678d243e5459cd6b314d99a,48,206,148,354,116,2013-04-20 15:18:35,2013-03-25 05:53:48
e17fa9e877e84e93b699c2bd13ea48dbbb86e451...25f2acfed0fc110f88abbfffb5c5c62a76670db0,5,87,7,94,15,2013-03-26 17:26:57,2013-03-26 15:44:26
25f2acfed0fc110f88abbfffb5c5c62a76670db0...705591508dbdd0d82f952abf882d97606a637e28,1,1,0,1,1,2013-03-26 17:27:03,2013-03-26 15:49:39
95d504f414509a299eb42c161963ec3adb47950b...738eef0f8b7139a76b6c3be2227aa218742f4234,2,20,19,39,17,2013-03-29 11:57:07,2013-03-29 11:57:07
24234555a01f3ebff2e969210024c86842896671...9c4882b391157f6aa3c0ade309638ffcd3bdf684,1,3,3,6,2,2013-03-24 20:56:40,2013-03-24 20:55:30
7acabbb9800de4492c0ee612a8a0aa784eb07f49...2f4a4703e1931fadf5ed81387b26cf84caf5bef9,5,47,36,83,15,2013-02-23 13:31:21,2013-02-23 12:39:21
2f4a4703e1931fadf5ed81387b26cf84caf5bef9...c12891e8cd629cc16fc5d22e485b87ca3169df2c,1,1,1,2,1,2013-02-23 13:36:51,2013-02-23 13:35:52
fc38d6a92be8baec1d02fbdf95e56c4204b9425b...b902a92b71c76b2c154f7e55ded9161e6d146825,1,1,1,2,1,2013-02-23 23:10:12,2013-02-23 23:10:12
b902a92b71c76b2c154f7e55ded9161e6d146825...9d2c0a0ae6ce931699daa87735d5b8b2afaa20f9,4,10,11,21,8,2013-02-23 23:28:49,2013-02-23 22:19:01
9d2c0a0ae6ce931699daa87735d5b8b2afaa20f9...22d82a7742c3b091857fda8612273360459110ee,4,23,7,30,9,2013-02-23 23:28:49,2013-02-23 23:25:05
22d82a7742c3b091857fda8612273360459110ee...f480b395256612de83b2f912bfecee03366bc990,1,38,25,63,12,2013-02-24 00:58:57,2013-02-24 00:58:57
f480b395256612de83b2f912bfecee03366bc990...17a28b39a8d77997f83ecd94ebcff7b198b8cb05,1,2,1,3,1,2013-02-24 03:07:06,2013-02-24 03:06:04
17a28b39a8d77997f83ecd94ebcff7b198b8cb05...c10ed58746d341dc83169018030b8dbe823fc4eb,1,5,1,6,2,2013-02-24 09:28:05,2013-02-24 09:28:05
c10ed58746d341dc83169018030b8dbe823fc4eb...f56ca3f0e6c263905e6c22fdb272f95c40c78870,2,4,4,8,3,2013-02-24 10:15:17,2013-02-24 10:15:17
129d2e8f85b1e80f10ec967b72ba0af9b239019f...f3ae67a62f5bdcee892f19667967e8738f734908,1,1,1,2,1,2013-02-23 16:05:38,2013-02-23 16:05:38
5278776a882ce8ba60fdd9a82dda4d8bac513976...6bd6a568960e9ddebd78da8e008b235b3b76c5a2,2,21,0,21,2,2013-02-23 16:02:07,2013-02-23 16:02:07
5278776a882ce8ba60fdd9a82dda4d8bac513976...8c1cc4b3b04f639ae40bc806380bc4a9dd568eb0,1,3,0,3,1,2013-02-23 15:53:31,2013-02-23 15:33:28
4526b67fe43b7240747a6a553d39045f126a9af8...ab1c25f674f8fdaa06897ce5ce65e559c0a6de1b,1,4,0,4,1,2013-02-28 09:26:47,2013-02-28 09:26:47
ab1c25f674f8fdaa06897ce5ce65e559c0a6de1b...481f3f13b54a5cacc5b67b32c4ada267fc709d21,2,6,6,12,2,2013-02-28 10:11:26,2013-02-28 10:05:26
481f3f13b54a5cacc5b67b32c4ada267fc709d21...06de130dae8b7a6c95143077d7a82fab37da0bc0,3,43,3,46,5,2013-02-28 13:05:48,2013-02-28 13:04:12
06de130dae8b7a6c95143077d7a82fab37da0bc0...aa089b106b6cfc9a47cd54a0f9eb44bd44811ed9,3,33,1,34,3,2013-02-28 13:21:48,2013-02-28 12:45:21
aa089b106b6cfc9a47cd54a0f9eb44bd44811ed9...d009ffe436410f6935798d910b0e489d53411dfa,1,1,1,2,1,2013-02-28 13:25:14,2013-02-28 11:59:35
d009ffe436410f6935798d910b0e489d53411dfa...2ee21d9f0d9eaed0494f3b9cd4b5bc9beffffae5,16,220,25,245,44,2013-02-28 14:28:13,2013-02-18 10:37:26
2ee21d9f0d9eaed0494f3b9cd4b5bc9beffffae5...cf304691649fbe3b0d7f8e9396358be9df62430f,3,35,14,49,10,2013-02-28 16:08:16,2013-02-28 16:05:25
cf304691649fbe3b0d7f8e9396358be9df62430f...0c82b1dfc48b4870e8fbcfb782ae02cdca821e1f,2,11,0,11,2,2013-02-28 16:35:13,2013-02-28 16:35:13
baae4b818778180fedfcfcfc7aa77acfb9b237fb...161cafb6f695df5d886ed94ab2489a420cd97ecc,1,4,0,4,1,2012-12-03 12:11:32,2012-12-03 12:08:22
161cafb6f695df5d886ed94ab2489a420cd97ecc...74809fdcc75c400e7d2eac4fa1b0f4113f9f395b,1,9,5,14,3,2012-12-03 12:13:24,2012-12-03 12:13:24
b21e0753ae520a8adce04d9e8b0db065d76c3e98...d5ed81c7951578c8cf0eb6fefd09db632455edd0,1,2,1,3,1,2012-12-08 18:47:53,2012-12-08 18:47:53
d5ed81c7951578c8cf0eb6fefd09db632455edd0...8248d1402982041490b5d6bb45514ffdba0e18d3,5,6,48,54,18,2012-12-08 20:07:59,2012-12-08 19:58:59
8248d1402982041490b5d6bb45514ffdba0e18d3...49519328b4988bf89c11d50191cdee8e9bec3aaa,2,13,2,15,3,2012-12-09 15:17:56,2012-12-09 15:17:56
49519328b4988bf89c11d50191cdee8e9bec3aaa...ae8e97384bbacaf4094b5f98c83b8599478b3fac,4,973,10,983,4,2012-12-09 20:13:26,2012-12-09 20:12:52
ae8e97384bbacaf4094b5f98c83b8599478b3fac...be9f2919e0e52faa7f7177c795d20646eff89874,2,113,69,182,21,2012-12-09 21:30:01,2012-12-09 21:22:36
be9f2919e0e52faa7f7177c795d20646eff89874...0cdfa76e68468ddf0a99198e1db07a703354b5af,1,2,2,4,1,2012-12-10 16:49:04,2012-12-10 16:43:07
0cdfa76e68468ddf0a99198e1db07a703354b5af...a2f2a399566dd68ce7e312fff5a5ba857066797d,9,167,57,224,33,2012-12-10 21:11:39,2012-11-17 21:00:53
a2f2a399566dd68ce7e312fff5a5ba857066797d...27560924ec1e567be4727ef8d7dfc4d3879c048c,3,34,4,38,7,2012-12-10 21:11:40,2012-11-27 21:19:37
27560924ec1e567be4727ef8d7dfc4d3879c048c...1eb0da1c5ba3096f218d1df13d02a2b8e1ac7a36,1,3,3,6,3,2012-12-10 22:34:51,2012-12-10 22:34:51
1eb0da1c5ba3096f218d1df13d02a2b8e1ac7a36...7e97f4f510b2972c867ae7674fc40134413c16ab,1,2,2,4,2,2012-12-11 15:25:47,2012-12-11 15:25:47
7e97f4f510b2972c867ae7674fc40134413c16ab...0eed8ece320a8a0334c78abc43c82fdb9f1f9827,3,10,12,22,4,2012-12-11 21:34:17,2012-12-11 21:30:07
0eed8ece320a8a0334c78abc43c82fdb9f1f9827...6cad5f212a203d694405e8122e7902ff6bee4185,1,7,7,14,4,2012-12-11 23:43:37,2012-12-11 23:43:37
6cad5f212a203d694405e8122e7902ff6bee4185...6ed6a18a033ba78de9418f5b56b80f8b3d3aaf11,2,34,1,35,5,2012-12-12 21:05:00,2012-12-12 19:34:59
6ed6a18a033ba78de9418f5b56b80f8b3d3aaf11...088d3bc2f84b6b68fee7e5de053b58049bd110e7,19,171,68,239,52,2012-12-13 11:33:11,2012-12-13 11:33:11
088d3bc2f84b6b68fee7e5de053b58049bd110e7...7eba5fbc027face8dd33475148d442655a92cecd,1,4,2,6,2,2012-12-13 13:02:08,2012-12-13 13:02:08
6d27547d202586c5f85909de84a012bc177f7a30...5fa5621f574f9ae211ed756c3e2ad453470dae8a,2,7,6,13,3,2012-12-03 19:47:08,2012-12-03 19:03:05
5fa5621f574f9ae211ed756c3e2ad453470dae8a...88e17156393be86df64d44554de8ab77a6d3ed7d,2,53,9,62,9,2012-12-03 19:53:15,2012-11-19 01:21:05
88e17156393be86df64d44554de8ab77a6d3ed7d...b64d30405a3d5468dc8c6232747d45bbeee4f7bb,5,28,8,36,9,2012-12-04 04:13:01,2012-12-03 23:39:03
926bc421d9bcf04a79f0026a60d3d4b0570b7fe2...ded40142a92813a8901faa4a6ca398e6679152f6,3,22,0,22,3,2013-09-07 00:43:58,2013-09-07 00:43:41
ded40142a92813a8901faa4a6ca398e6679152f6...37d46b20fc5325b6fb082f95936a6c97c92dcf7d,1,1,1,2,1,2013-09-07 01:00:11,2013-09-07 00:54:19
37d46b20fc5325b6fb082f95936a6c97c92dcf7d...a9589dd280ba84db3131f32b423ef45c67a5a236,1,1,1,2,1,2013-09-07 03:11:55,2013-09-07 03:11:55
a9589dd280ba84db3131f32b423ef45c67a5a236...2530735d2d57316d1df8177745e93a78de663ff7,13,8,21,29,16,2013-09-07 04:56:40,2013-09-07 04:56:40
2530735d2d57316d1df8177745e93a78de663ff7...97a626d898575fc8925700a6db7d43cf3099898e,1,1,1,2,1,2013-09-07 04:56:57,2013-09-07 04:56:57
97a626d898575fc8925700a6db7d43cf3099898e...ec47de77d6a7bc9327047d157fb5706751413f18,1,4,4,8,4,2013-09-07 12:09:13,2013-09-07 06:05:21
ec47de77d6a7bc9327047d157fb5706751413f18...636860fbfb4e34e08749d4576bc9571028150526,4,50,50,100,8,2013-09-07 15:03:49,2013-09-07 14:25:51
636860fbfb4e34e08749d4576bc9571028150526...4e88d106dc18a3e7c01b218a56451610821275c7,1,29,14,43,7,2013-09-07 15:03:50,2013-09-07 15:00:50
4e88d106dc18a3e7c01b218a56451610821275c7...ae7f9afaf6592fa477792647bd8cee0a8560b4eb,1,3,3,6,3,2013-09-07 15:25:16,2013-09-07 15:25:16
ae7f9afaf6592fa477792647bd8cee0a8560b4eb...8aaca651cf5732bbf395d24a7d9f2edfab00250c,2,29,4,33,7,2013-09-07 15:25:43,2013-09-07 15:25:43
8aaca651cf5732bbf395d24a7d9f2edfab00250c...f5add4712f684a78215263771b8acaeb48e64a81,1,8,3,11,4,2013-09-07 15:43:44,2013-09-07 15:43:44
f5add4712f684a78215263771b8acaeb48e64a81...73de9dd1fa4e226e8955dfb36408b9c4fc292cb2,1,39,23,62,3,2013-09-07 15:59:49,2013-09-07 00:05:01
73de9dd1fa4e226e8955dfb36408b9c4fc292cb2...9079436b0092db4a7e0031c27747d97f68b0fc5b,1,29,0,29,1,2013-09-07 16:01:35,2013-09-07 00:07:51
9079436b0092db4a7e0031c27747d97f68b0fc5b...bacbbb481da8a582642a265459f2144db813dcee,3,122,0,122,3,2013-09-07 16:03:38,2013-09-07 16:03:23
98514849dce07acfaa224a90a784bba9d97249e5...a2e25e8a830b1d8b3daa9afb1c2ad4f954bb7d3c,3,543,0,543,4,2013-09-19 04:13:04,2013-09-19 04:13:04
d6e222f30a0277d31522439c86e7e939ef1a858e...7008ed61c519f93a9b6c5c547ad718ad2deb959b,3,27,13,40,4,2013-09-09 23:55:16,2013-09-04 16:08:13
7008ed61c519f93a9b6c5c547ad718ad2deb959b...f2a44528825ac07ca28c8bb7dc01b4375df8dc2c,2,11,0,11,2,2013-09-10 12:26:54,2013-09-09 09:40:37
f2a44528825ac07ca28c8bb7dc01b4375df8dc2c...30fc49a7ca0d030c7855f31ed44395903fa6abdd,1,1,0,1,1,2013-09-10 12:33:53,2013-09-06 19:01:54
30fc49a7ca0d030c7855f31ed44395903fa6abdd...2bc51438664b5ffbbd1430b4f9f3307f18b2b9db,1,4,2,6,1,2013-09-10 12:48:03,2013-09-10 12:48:03
2bc51438664b5ffbbd1430b4f9f3307f18b2b9db...af67ce5e18525ba52ee4533229468ed07f912536,3,112,7,119,13,2013-09-10 13:07:17,2013-09-07 21:12:13
af67ce5e18525ba52ee4533229468ed07f912536...fca4c4826e7b4cec84c3f8140bb929e38eea962c,1,9,0,9,1,2013-09-10 13:17:47,2013-09-10 12:39:51
fca4c4826e7b4cec84c3f8140bb929e38eea962c...4ba373840a7b299fff4a7bcc1001e32dffceee86,4,45,5,50,10,2013-09-10 13:49:39,2013-09-10 13:49:39
4ba373840a7b299fff4a7bcc1001e32dffceee86...0ac7cc32655c670168b3c111cef1101ed1a09d1a,1,1,1,2,1,2013-09-10 13:54:26,2013-09-10 13:54:26
0ac7cc32655c670168b3c111cef1101ed1a09d1a...5df8f749e6338c85a091f41803e6ecb280fc9f70,1,2,1,3,1,2013-09-10 14:12:23,2013-09-01 18:21:08
5df8f749e6338c85a091f41803e6ecb280fc9f70...d59f1993f150f83524051d96b52df08da4dcf011,3,28,17,45,5,2013-09-10 14:12:23,2013-09-02 06:02:07
d59f1993f150f83524051d96b52df08da4dcf011...b2b763448f726ee952743596e9a34fcb154bdb12,26,96,95,191,95,2013-09-10 15:09:59,2013-09-06 18:24:52
b2b763448f726ee952743596e9a34fcb154bdb12...79ccd1a101e6379c5a49da18fc006816e5ed127c,1,4,3,7,4,2013-09-10 16:07:29,2013-09-10 16:06:43
79ccd1a101e6379c5a49da18fc006816e5ed127c...4840fd9cbc3987781f7e6fab2520c9bd42aec057,6,33,11,44,10,2013-09-10 16:22:55,2013-09-07 21:13:57
4840fd9cbc3987781f7e6fab2520c9bd42aec057...053de6131af83c63ec17d38578889c71de913d24,2,13,1,14,2,2013-09-10 17:00:10,2013-09-10 13:09:55
053de6131af83c63ec17d38578889c71de913d24...d5d0e03ec826e0664f1c9b8b042497f7f5219b0c,1,1,1,2,1,2013-09-10 17:17:01,2013-09-10 17:17:01
d5d0e03ec826e0664f1c9b8b042497f7f5219b0c...4e96dac450e3546bf86220932f5a64fea1ad5bac,2,26,0,26,3,2013-09-10 17:56:49,2013-09-10 17:56:49
4e96dac450e3546bf86220932f5a64fea1ad5bac...8165c2cfd1922bb9d56a9e68e6456736acacf445,1,12,5,17,1,2013-09-10 18:24:34,2013-09-10 18:23:31
08cf54990ae112083b159aa4e263c1f64f396f39...d55c54a5da241e294c1162a19a07ab3f59e58dc7,1,1,0,1,1,2012-10-30 23:19:31,2012-10-30 23:19:31
fbd1df8e16fc17a5d73f36136298c20b8ec3d618...7b9a1fb9649d169f4ec0e539c4901c66b0f5ebb6,1,1,1,2,1,2012-11-23 16:20:36,2012-11-23 16:20:36
7b9a1fb9649d169f4ec0e539c4901c66b0f5ebb6...90b86291d022a09031d1df397d7aaebc30e435f7,4,52,4,56,8,2012-11-23 17:53:04,2012-11-22 18:27:28
90b86291d022a09031d1df397d7aaebc30e435f7...5c81e9de0f0dfd5b8c105f53e9940845caca2788,1,1,1,2,1,2012-11-23 19:40:42,2012-11-23 19:40:42
5c81e9de0f0dfd5b8c105f53e9940845caca2788...a27582484cf814554907d2d1ad077852de36963f,2,9,1,10,2,2012-11-23 23:12:17,2012-11-23 22:28:20
a27582484cf814554907d2d1ad077852de36963f...0a0a0d66b316598f7c296e8bf75749a14ce3ac49,2,13,1,14,3,2012-11-23 23:13:12,2012-11-23 22:44:48
0a0a0d66b316598f7c296e8bf75749a14ce3ac49...c8985a8a7317042a641e870cb75b3005cc5d67b1,6,101,23,124,18,2012-11-24 05:43:20,2012-11-24 05:43:20
c8985a8a7317042a641e870cb75b3005cc5d67b1...fdb5c98d7ee54c7f89ec10b0203263f1f5b37510,1,7,0,7,1,2012-11-24 05:53:44,2012-11-24 05:53:44
fdb5c98d7ee54c7f89ec10b0203263f1f5b37510...18d7c1ea3ad4523ec848b800fd85984582efe32c,1,2,2,4,1,2012-11-24 07:07:50,2012-11-24 07:07:50
18d7c1ea3ad4523ec848b800fd85984582efe32c...f2d8004967ed1888ea6e7430541ffad546ecf43f,1,0,3,3,1,2012-11-24 07:26:36,2012-11-24 07:26:36
f2d8004967ed1888ea6e7430541ffad546ecf43f...be64dd35fbb9b2b49fa5774b7e7f777df8351c1a,1,14,23,37,8,2012-11-24 08:48:21,2012-11-24 08:48:21
be64dd35fbb9b2b49fa5774b7e7f777df8351c1a...bf1871d874a371ad0ae6c7e098e7665a468dca16,2,5,1,6,3,2012-11-24 11:16:52,2012-11-24 11:10:25
bf1871d874a371ad0ae6c7e098e7665a468dca16...dc569c880143db07e01b3293d698ad8fe4a0136f,2,4,1,5,2,2012-11-24 14:03:21,2012-11-24 13:52:00
dc569c880143db07e01b3293d698ad8fe4a0136f...08b4a22293ca237e4fc6900c876241ca60941393,1,11,5,16,1,2012-11-24 14:26:05,2012-11-24 14:19:55
08b4a22293ca237e4fc6900c876241ca60941393...a962bc7c45d868523a18e5139b96b275b3df2589,2,15,0,15,2,2012-11-24 15:00:00,2012-11-24 14:56:31
a962bc7c45d868523a18e5139b96b275b3df2589...35a0fff28ad7e3ca26f902893a7659343e490f82,2,9,0,9,2,2012-11-24 16:12:59,2012-11-24 16:12:59
35a0fff28ad7e3ca26f902893a7659343e490f82...44815bad6b3a21831eaf659d446c4a1182e4833c,5,6,91,97,6,2012-11-24 17:10:51,2012-11-24 17:10:51
44815bad6b3a21831eaf659d446c4a1182e4833c...abd0e76d2d248957979ecdb3cf1604ce29594632,1,18,10,28,3,2012-11-24 18:18:54,2012-11-24 18:16:17
abd0e76d2d248957979ecdb3cf1604ce29594632...690cac3a34321208c4601e37bd5166ee7133e5ef,1,2,2,4,2,2012-11-24 21:10:51,2012-11-24 21:03:12
690cac3a34321208c4601e37bd5166ee7133e5ef...d26691958443a4b968fecba5510c37768153fafa,3,24,1,25,4,2012-11-24 21:10:51,2012-11-24 21:04:17
fbd1df8e16fc17a5d73f36136298c20b8ec3d618...2bca9a4edaddbecfec4b5e25b21d8e439bba7495,1,1,1,2,1,2012-11-23 16:20:18,2012-11-23 16:20:18
14924ea96bb377fb128e572e11d77a48fe58b50a...e57338f2b96c57d2060885cc23846317f50731c4,1,30,30,60,9,2012-08-24 12:23:50,2012-08-24 12:23:50
e57338f2b96c57d2060885cc23846317f50731c4...b7c3b044fcc354f675ff1941d9e4377d6782394c,1,1,3,4,1,2012-08-24 23:08:16,2012-08-24 23:08:16
b7c3b044fcc354f675ff1941d9e4377d6782394c...d7a2e816a15a121c50b85c4470c91a676cbc827b,1,7,0,7,1,2012-08-25 09:12:43,2012-08-25 08:52:57
d7a2e816a15a121c50b85c4470c91a676cbc827b...01b9c3d5193fe61b82ae8b26242a13fdec22f211,5,246,57,303,20,2012-08-25 11:14:45,2012-08-21 18:54:14
01b9c3d5193fe61b82ae8b26242a13fdec22f211...df7c1a13a0a400747966098049093cebdac385bf,2,148,151,299,47,2012-08-25 12:13:43,2012-08-25 12:11:56
df7c1a13a0a400747966098049093cebdac385bf...e6e01f619dbc56aafaa57811ab4de32140ef33e2,1,2,2,4,1,2012-08-25 12:25:34,2012-08-25 12:25:34
e6e01f619dbc56aafaa57811ab4de32140ef33e2...62e1c5a441d957e44d7527a6d901587b40203a51,2,14,1,15,2,2012-08-25 12:39:52,2012-08-25 12:37:00
62e1c5a441d957e44d7527a6d901587b40203a51...28ea4d4b07d98385e0bbfd54058e7eb42b246d26,2,41,27,68,24,2012-08-25 20:22:32,2012-08-25 11:02:52
28ea4d4b07d98385e0bbfd54058e7eb42b246d26...c73f2bd65c8a94b9d52b6684e0d7fb0055401daa,1,1,1,2,1,2012-08-26 03:24:32,2012-08-26 03:24:32
c73f2bd65c8a94b9d52b6684e0d7fb0055401daa...5a9e127efc37490b2a1caa605e987a693245b5fa,3,38,11,49,13,2012-08-26 20:54:49,2012-08-26 20:54:49
f51eab796d087439eedcb768cdd312517780940e...5a1bf7eccb100ea4f4f61ceba9381a11e3e0afc5,1,1,1,2,1,2012-09-25 15:08:07,2012-09-25 15:08:07
7c11b1a47060cc2710b56c7879bbe73cb5587fb2...70a0de37d132e5f1514fb939875f69649f103124,57,1412,343,1755,435,2012-09-26 10:48:09,2012-09-26 10:48:09
70a0de37d132e5f1514fb939875f69649f103124...2c8267bf3db608b99c04ae903c424b60cafaaf93,24,51,51,102,43,2012-09-26 12:14:51,2012-09-26 12:14:51
2c8267bf3db608b99c04ae903c424b60cafaaf93...bb7da7844ff9f11286509c22a2549bbd4553d58d,2,21,6,27,7,2012-09-26 13:07:11,2012-09-26 13:07:11
bb7da7844ff9f11286509c22a2549bbd4553d58d...b3ee80a0cf0e60876f03b797d2bdc69505dbdfcb,4,31,32,63,7,2012-09-26 19:10:17,2012-09-26 19:10:17
b3ee80a0cf0e60876f03b797d2bdc69505dbdfcb...3cbe686af6b6a3f23a607b2eb7497c55d88e8345,3,17,3,20,6,2012-09-26 19:12:56,2012-09-26 19:12:56
3cbe686af6b6a3f23a607b2eb7497c55d88e8345...50d573d2c0b3e17cbf1aa240b03b52e4ad0c32cd,2,49,0,49,3,2012-09-27 12:36:30,2012-09-27 12:36:30
50d573d2c0b3e17cbf1aa240b03b52e4ad0c32cd...c9c9a5642512155e9693bf5fa6221fd26adeccca,2,15,0,15,2,2012-09-27 13:57:28,2012-09-27 13:55:27
c9c9a5642512155e9693bf5fa6221fd26adeccca...01362745ba72286309ff1955219a5ffc32c760b0,1,2,2,4,1,2012-09-27 17:24:34,2012-09-27 17:24:34
01362745ba72286309ff1955219a5ffc32c760b0...373932fa6b9137a7e760d81dc66d49fc10ff2942,9,222,46,268,9,2012-09-27 19:43:37,2012-09-24 05:48:13
373932fa6b9137a7e760d81dc66d49fc10ff2942...1df58968a4b2247aff91db40f1325f079ba3cdce,1,9,1,10,1,2012-09-27 20:19:04,2012-09-27 20:19:04
1df58968a4b2247aff91db40f1325f079ba3cdce...84fa9099c6a760104d69a87d3cc2cba192f1ebf2,2,1,2,3,2,2012-09-27 21:33:52,2012-09-27 21:33:52
84fa9099c6a760104d69a87d3cc2cba192f1ebf2...d08096317ab598b7a350d61b9b8396a3be7b8c79,2,14,1,15,3,2012-09-27 21:36:02,2012-09-27 21:17:21
d08096317ab598b7a350d61b9b8396a3be7b8c79...e44bedd13f974321c0c5deece9f5ac3da02e64c0,1,1,1,2,1,2012-09-28 00:25:31,2012-09-28 00:25:31
e44bedd13f974321c0c5deece9f5ac3da02e64c0...751a7d0c32746dc6774f1b561db523b25365148a,2,15,0,15,3,2012-09-28 02:35:57,2012-09-28 02:16:38
751a7d0c32746dc6774f1b561db523b25365148a...b8244c654c85034bd4209a93a7802eb306c32e2b,3,22,2,24,3,2012-09-28 03:34:45,2012-09-28 03:34:45
b8244c654c85034bd4209a93a7802eb306c32e2b...07ffe7814394815d116cdbe814ec6a523b345df1,3,31,12,43,12,2012-09-28 12:35:26,2012-09-28 12:35:26
07ffe7814394815d116cdbe814ec6a523b345df1...3fcca0e94721a734882389ce473f522d293907e9,2,14,0,14,2,2012-09-28 15:10:52,2012-09-20 00:18:19
3fcca0e94721a734882389ce473f522d293907e9...1cd6e04cd4f768bcd4385b75de433d497d938f82,13,275,19,294,35,2012-09-28 15:16:08,2012-09-20 15:51:30
1cd6e04cd4f768bcd4385b75de433d497d938f82...6c2faaceb0482267cec19da0ff432984028f9d0c,6,35,42,77,25,2012-09-28 18:33:05,2012-09-28 18:10:22
6c2faaceb0482267cec19da0ff432984028f9d0c...fea0ca4334b8c35100c0ca1048f81b9b3573bc26,1,50,0,50,1,2012-09-28 21:36:53,2012-09-28 13:50:02
fea0ca4334b8c35100c0ca1048f81b9b3573bc26...15d355d79dc26fb150776e6e019b2f667e4cb2ff,1,3,2,5,3,2012-09-29 03:14:16,2012-09-29 03:14:16
15d355d79dc26fb150776e6e019b2f667e4cb2ff...2f6e00a840176f95c836f25a41cc1a7d31941ba5,5,108,7,115,12,2012-09-29 09:22:28,2012-09-29 09:01:08
2f6e00a840176f95c836f25a41cc1a7d31941ba5...82a74dce243935688f4f9cd447521d4d141c563b,1,2,2,4,2,2012-09-29 10:10:52,2012-09-29 10:10:52
82a74dce243935688f4f9cd447521d4d141c563b...ffdd6595ea2220f8e8a6fb3aacd3213b751d982f,6,62,51,113,32,2012-09-29 10:33:18,2012-09-22 09:55:37
ffdd6595ea2220f8e8a6fb3aacd3213b751d982f...8867c276135887458c21536f53c8b4045baefefc,1,5,0,5,1,2012-09-29 18:04:08,2012-09-29 18:04:08
78c842a3230f026ad678d243e5459cd6b314d99a...70d3adf9f2ebfdfc9e64376b71b596ebb12d77f8,1,5,4,9,3,2013-04-21 13:52:02,2013-04-21 13:52:02
c1d4af6884fbf6c232f6d3fedd168609e0449239...f2a0be61517d213f23100aded043e073ea66694a,1,1,1,2,1,2013-03-26 19:26:20,2013-03-26 19:26:20
f2a0be61517d213f23100aded043e073ea66694a...34a50e99e80295aa0a8970a775f53c62fe220c5a,2,29,9,38,7,2013-03-26 22:19:32,2013-03-26 22:18:03
738eef0f8b7139a76b6c3be2227aa218742f4234...a40746b1cbc912119f9f873614017953b17a4d7a,2,6,3,9,4,2013-03-29 12:32:21,2013-03-29 12:32:21
9c4882b391157f6aa3c0ade309638ffcd3bdf684...e79b857a07905340556f781a7d63016236b21c61,6,40,22,62,12,2013-03-25 05:06:02,2013-03-25 04:34:46
c12891e8cd629cc16fc5d22e485b87ca3169df2c...21f333bcefccc151d6439246f8203d609ab6ca79,4,40,18,58,21,2013-02-23 13:44:57,2013-02-23 13:44:57
c12891e8cd629cc16fc5d22e485b87ca3169df2c...2db9cbe97c3f375e1db6759db73cf15d09341420,1,1,1,2,1,2013-02-23 13:38:13,2013-02-23 13:38:13
b6aede326803bfdf18f932ec2fa8b9304467d29f...44164c5c308da32a804dfb03ce0bffde2a6b4c56,2,9,1,10,3,2013-02-24 11:15:02,2013-02-23 22:14:06
44164c5c308da32a804dfb03ce0bffde2a6b4c56...5a6a4249f3a6b16ca93ce436017d02433f6ec47f,1,0,4,4,1,2013-02-24 11:31:00,2013-02-24 11:31:00
5a6a4249f3a6b16ca93ce436017d02433f6ec47f...cbb9f629b88d97dd9a3f8d425fd56c8b80d7cddf,2,0,19,19,3,2013-02-24 11:38:32,2013-02-24 11:38:32
f3ae67a62f5bdcee892f19667967e8738f734908...b6f4a92ff45d98a63dc29402d8ad86b88e6a6697,2,15,2,17,4,2013-02-23 18:01:38,2013-02-23 18:01:38
f3ae67a62f5bdcee892f19667967e8738f734908...67dd54dc841a93a67eac87dc13ed047d72f920dc,5,26,9,35,12,2013-02-23 17:24:32,2013-02-23 17:24:32
0ad76843b5032af52022adff7b676db633ce8b7e...687d2e967dbc7c2ba29a90c74becc539d3ac2b9d,2,20,3,23,4,2013-02-23 16:43:17,2013-02-23 16:41:30
0c82b1dfc48b4870e8fbcfb782ae02cdca821e1f...f39fead1c37f1b6ed8772e252f96adee44447a3d,2,12,1,13,3,2013-03-01 22:32:20,2013-03-01 22:32:20
0c82b1dfc48b4870e8fbcfb782ae02cdca821e1f...892bc91cb0036d6868081363628f65094c4790d6,5,53,28,81,16,2013-03-01 08:35:04,2013-01-26 16:05:47
892bc91cb0036d6868081363628f65094c4790d6...3318595c0bfeda9f6bae8aa11dda68647ae55fde,2,33,1,34,2,2013-03-01 08:35:18,2013-01-26 17:23:10
3318595c0bfeda9f6bae8aa11dda68647ae55fde...6d3b0c33dcb38cdb3e72531c447250e76cd3e486,1,2,2,4,1,2013-03-01 21:15:23,2013-03-01 21:15:23
6d3b0c33dcb38cdb3e72531c447250e76cd3e486...0657646cb81d8742eec59dcd325baa519bb3c63f,1,0,2,2,1,2013-03-01 21:52:08,2013-03-01 21:52:08
0657646cb81d8742eec59dcd325baa519bb3c63f...203c17c21ec2d4a45fd40a027b32f3f545c6dce4,1,2,0,2,1,2013-03-01 22:46:53,2013-03-01 22:46:09
203c17c21ec2d4a45fd40a027b32f3f545c6dce4...952ba5237ea62e7647cdd5214b1df79c0e7cea38,3,108,33,141,27,2013-03-02 07:41:14,2013-03-01 20:29:39
952ba5237ea62e7647cdd5214b1df79c0e7cea38...fb3d85bd14f1f7a8969ef8c54f2f0603e161f428,1,25,1,26,4,2013-03-02 08:24:08,2013-03-01 20:32:39
fb3d85bd14f1f7a8969ef8c54f2f0603e161f428...0f306cad8442f9808e4410f190f434144ff6376a,1,1,1,2,1,2013-03-02 08:45:42,2013-03-02 08:45:42
0f306cad8442f9808e4410f190f434144ff6376a...8ee1eddb7e148de89aebde9e68da495633fc1ec9,10,85,2,87,12,2013-03-02 09:29:02,2012-12-13 21:11:06
8ee1eddb7e148de89aebde9e68da495633fc1ec9...d680a3f4477056c69629b0421db4bb254b8c69d0,4,34,8,42,9,2013-03-02 09:29:02,2012-12-14 23:26:08
d680a3f4477056c69629b0421db4bb254b8c69d0...c5a25c2771f0362a5775f81f9f4eb6b3c9caed62,5,10,2,12,7,2013-03-02 09:29:03,2012-12-17 21:35:35
c5a25c2771f0362a5775f81f9f4eb6b3c9caed62...d63e55039d42c2ba8bb6c8f8d133ede085b60969,6,271,215,486,53,2013-03-02 12:33:17,2013-03-02 11:12:51
d63e55039d42c2ba8bb6c8f8d133ede085b60969...e0449316ebacaa550e9c529f8c9cb9a9b44e3765,4,55,15,70,17,2013-03-02 14:05:49,2013-03-02 14:00:28
e0449316ebacaa550e9c529f8c9cb9a9b44e3765...fe5d9fe5fec2617b9eb8564df77ba5324834cadc,1,10,0,10,1,2013-03-02 15:11:23,2013-03-02 15:11:23
fe5d9fe5fec2617b9eb8564df77ba5324834cadc...384c180e414a982a6cc5ccabc675bcfb4fd80988,4,13,2,15,6,2013-03-02 17:11:10,2013-03-02 17:01:24
384c180e414a982a6cc5ccabc675bcfb4fd80988...21722702c8ca85895d245ce2967e7336a168585d,35,110,6,116,100,2013-03-02 18:04:23,2013-03-02 18:04:23
21722702c8ca85895d245ce2967e7336a168585d...8e8c9b908a0fe0d2437fcf3f0378eb2a62b81986,2,16,12,28,4,2013-03-02 21:41:08,2013-03-02 21:41:08
8e8c9b908a0fe0d2437fcf3f0378eb2a62b81986...0868e5a8ac6811fffcb25e9dc8248d87d25abcd1,1,7,4,11,4,2013-03-02 23:27:59,2013-02-23 18:00:54
0868e5a8ac6811fffcb25e9dc8248d87d25abcd1...97afc49bb0cca34cb83b371c5f83d74cb3974b91,1,1,1,2,1,2013-03-03 15:07:38,2013-03-03 15:07:38
501c7a221cfd022b6d0021fd9a54005c5ffc7a23...795ac7deda64e67a059b489f8684bb440ca7f7ad,6,32,5,37,9,2012-12-04 12:22:42,2012-12-04 12:18:57
795ac7deda64e67a059b489f8684bb440ca7f7ad...c196e01100b27288b284f89d4492b7e52bca3a8e,1,2,2,4,2,2012-12-04 18:36:56,2012-12-04 18:36:56
c196e01100b27288b284f89d4492b7e52bca3a8e...632cf32b43609f7d674c81f81f01eb9e4a059f1f,1,2,2,4,1,2012-12-04 20:49:02,2012-12-04 20:49:02
632cf32b43609f7d674c81f81f01eb9e4a059f1f...45f00dbb93a0e929f4320b9c652fef51655e6872,1,4,3,7,3,2012-12-04 22:48:39,2012-12-04 22:48:39
45f00dbb93a0e929f4320b9c652fef51655e6872...37abad73d6b61031ece67d8e58612cb39326d28e,1,2,3,5,1,2012-12-04 23:11:54,2012-12-03 15:46:48
37abad73d6b61031ece67d8e58612cb39326d28e...553838a285d6ef4005d7a97fc07aebfb0dcdb921,3,6,2,8,3,2012-12-06 08:52:02,2012-12-06 08:47:51
553838a285d6ef4005d7a97fc07aebfb0dcdb921...34dcf51e06fc57fc5462bd40f6a4c8ee949521da,2,25,4,29,4,2012-12-06 16:14:44,2012-12-06 16:14:44
34dcf51e06fc57fc5462bd40f6a4c8ee949521da...66dfcc10b37120638894cb412a15274b17cfb360,2,23,3,26,3,2012-12-06 19:00:56,2012-12-06 19:00:56
66dfcc10b37120638894cb412a15274b17cfb360...53b879f045f0e55cc8f4bedff67b5a14f3057561,1,5,3,8,1,2012-12-07 16:39:36,2012-12-07 16:39:36
53b879f045f0e55cc8f4bedff67b5a14f3057561...c91667338a4e774e2819ccf4da852dc7b759bc19,56,228,147,375,186,2012-12-08 10:13:52,2012-12-08 10:13:52
c91667338a4e774e2819ccf4da852dc7b759bc19...6140795150b3811d5969315c02556861575e87eb,1,1,1,2,1,2012-12-08 11:19:39,2012-12-08 11:19:18
6140795150b3811d5969315c02556861575e87eb...04e6542b5a904762a4e723c9b04ba5650ee9dc2e,3,21,2,23,5,2012-12-08 11:41:11,2012-12-08 11:41:11
04e6542b5a904762a4e723c9b04ba5650ee9dc2e...35492f8fc4006acda4b5762ef187625e9c590c74,1,1,1,2,1,2012-12-08 11:52:09,2012-12-08 11:52:09
7eba5fbc027face8dd33475148d442655a92cecd...a001f3c31e751e6ab1622ae7f65f7f8aeca2ef9a,3,13,3,16,4,2012-12-14 20:15:48,2012-12-14 20:15:48
7eba5fbc027face8dd33475148d442655a92cecd...55a2d5b577bcf988d33ca4c8decfae6e96f58c7b,5,14,18,32,6,2012-12-13 13:20:47,2012-12-13 13:20:47
bacbbb481da8a582642a265459f2144db813dcee...2223b83a5503fe79bf401b5a2dd00938d5e2848c,1,8,3,11,3,2013-09-07 16:33:10,2013-09-07 16:33:10
bacbbb481da8a582642a265459f2144db813dcee...c54fa1a7bc365fec79d4971bf22d5ad2799fde67,1,4,1,5,1,2013-09-07 16:13:45,2013-09-07 15:36:31
c54fa1a7bc365fec79d4971bf22d5ad2799fde67...7bb627936034c1b9500a8d250cce75b30f980b23,1,5,1,6,1,2013-09-07 16:31:08,2013-09-07 16:30:03
7bb627936034c1b9500a8d250cce75b30f980b23...476b07641c35728d260cadacc2735dbba6ec98c9,1,1,1,2,1,2013-09-07 16:32:39,2013-09-07 16:32:39
bbabc5325c78a5d591e5c48ddfb8bf9a0a861a68...c65ae7c969644fe0008165e966ca2d8156153293,1,2,2,4,2,2013-09-19 04:26:24,2013-09-19 04:26:24
c65ae7c969644fe0008165e966ca2d8156153293...8b3bae9466c2736719aba2e41439c80dd1989844,1,2,2,4,2,2013-09-19 04:29:55,2013-09-19 04:29:55
8b3bae9466c2736719aba2e41439c80dd1989844...8e134c27c932069076d87b551e8fe710a1e1572e,4,89,87,176,86,2013-09-19 05:57:02,2013-09-19 05:57:02
8e134c27c932069076d87b551e8fe710a1e1572e...9d3e60aa3e97642d20317d6732f374ed91e7a90b,1,226,303,529,175,2013-09-19 06:57:01,2013-09-19 06:57:01
9d3e60aa3e97642d20317d6732f374ed91e7a90b...e23de9e350d716c4d9ebe0b27c9f2752fe1aa543,2,2,2,4,2,2013-09-19 10:24:12,2013-09-19 10:24:12
e23de9e350d716c4d9ebe0b27c9f2752fe1aa543...55b9bff07f6e2eca7c909d1804dc64553e866622,2,3,1,4,3,2013-09-19 10:37:23,2013-09-19 10:37:23
55b9bff07f6e2eca7c909d1804dc64553e866622...7fec5a2240835af7c7f3accd64d9d894d4f92782,2,7,0,7,2,2013-09-19 13:27:19,2013-09-19 13:27:19
7fec5a2240835af7c7f3accd64d9d894d4f92782...4e9f800742c3048402acbaea67ec3c6bc3bd0935,3,25,91,116,13,2013-09-19 14:01:39,2013-09-19 08:38:56
4e9f800742c3048402acbaea67ec3c6bc3bd0935...59a34c43a8c3d62eaa400d48a9c26ed5400fc647,1,21,10,31,6,2013-09-19 14:12:03,2013-09-18 22:51:08
8165c2cfd1922bb9d56a9e68e6456736acacf445...751dc0a36b384024377a7bd1254ae110af313ec1,1,1,1,2,1,2013-09-10 20:10:00,2013-09-10 20:10:00
9bf0eedba581ba66b8b8391a7e611d6cf7ef5448...68847135bc9acb2c51c2d36797d0a85395f0cd35,6,98,211,309,65,2012-10-31 06:19:44,2012-08-10 19:00:21
68847135bc9acb2c51c2d36797d0a85395f0cd35...146ed13a111c97c1c04902a6c0eda1e4ee6e604c,6,48,6,54,13,2012-10-31 08:46:16,2012-10-30 20:59:23
146ed13a111c97c1c04902a6c0eda1e4ee6e604c...7f75460fd6befbef805fee3c91608efb0e9f444d,2,7,2,9,2,2012-10-31 10:58:14,2012-10-31 10:58:14
9d7130e066310d3d9bdc69ad2c7403713304f727...612357f8ef729689cf52101add8c90d0528a7421,1,1,0,1,1,2012-11-25 11:55:23,2012-11-25 11:55:23
612357f8ef729689cf52101add8c90d0528a7421...f3a0ecc9ee0eae09d2c779a74b32cce7e38c1773,1,2,2,4,1,2012-11-25 14:58:06,2012-11-25 14:58:06
f3a0ecc9ee0eae09d2c779a74b32cce7e38c1773...9f7cefd5059e78d75f1e1a852b51a6286ecec728,2,20,10,30,4,2012-11-25 18:06:17,2012-11-24 22:43:13
9f7cefd5059e78d75f1e1a852b51a6286ecec728...a5d47415f47025b014e580af1533e9023dc32945,4,54,48,102,21,2012-11-25 18:06:17,2012-11-24 22:47:41
a5d47415f47025b014e580af1533e9023dc32945...f89901dc0525f3ea1ca023aef4fd0862514bf550,2,2,2,4,2,2012-11-25 18:31:53,2012-11-25 18:31:30
f89901dc0525f3ea1ca023aef4fd0862514bf550...7644800070bf3027fb10cd45ea9f0e36e8334fc1,2,4,4,8,3,2012-11-25 18:51:42,2012-11-25 18:51:42
7644800070bf3027fb10cd45ea9f0e36e8334fc1...f26b956e807b7d5603e4a80533e3a12fd625a605,1,1,1,2,1,2012-11-25 18:54:38,2012-11-25 18:53:24
f26b956e807b7d5603e4a80533e3a12fd625a605...ae206d78f6d991e1d7ea1c1bb8bd85f4658c0877,5,58,4,62,10,2012-11-25 19:39:23,2012-11-25 19:39:23
5a9e127efc37490b2a1caa605e987a693245b5fa...bfa3d5af34937eef52dc4cfb22e831ff4a720fe8,1,1,1,2,1,2012-08-28 00:04:20,2012-08-28 00:04:20
5a9e127efc37490b2a1caa605e987a693245b5fa...b2ffa2ea90110bb8ccb67692aaad2069b0075869,1,1,1,2,1,2012-08-26 21:28:44,2012-08-26 21:28:44
f7cffd43ec4a878bfa438b5ac1e500bb0fe2c12d...1f84b042f1c3fab0f806de814d668917dd86236a,2,9,8,17,8,2012-09-25 16:41:57,2012-09-25 16:38:47
226b733c267d7a8d01aad01ad1929fe15c6aac14...7cc3acbb70c8f66060b377ed402df3085288b006,1,15,9,24,6,2013-04-22 17:51:42,2013-04-22 17:50:17
7cc3acbb70c8f66060b377ed402df3085288b006...73c26f0c95e83582e933e0ef2f71a013f7a9740e,1,8,3,11,5,2013-04-22 18:00:50,2013-04-22 17:04:28
34a50e99e80295aa0a8970a775f53c62fe220c5a...6e67d764ae66658b113f99390a80c6f352b74b67,1,10,6,16,5,2013-03-27 05:59:05,2013-03-27 05:59:05
24e710e65995b7f9edcd44efb81ae2681808e7ca...83f182da664645d3eff6f90a98f18d6f7af310bd,2,30,0,30,1,2013-03-29 15:55:13,2013-03-29 15:54:00
83f182da664645d3eff6f90a98f18d6f7af310bd...6293eaa062db473a208c782f0e419314152a071e,1,1,1,2,1,2013-03-29 18:16:30,2013-03-29 18:16:30
6293eaa062db473a208c782f0e419314152a071e...391ec5a08582f9479366e38afb4cb0547c39f073,1,2,2,4,1,2013-03-29 18:31:29,2013-03-29 17:59:34
f6989e559ced30b5272520a46d1a22aff1abaf0d...654d8e96ae03470a603def2f79c9b8cd0f62f132,1,9,0,9,2,2013-03-27 17:05:31,2013-03-27 17:05:31
f6989e559ced30b5272520a46d1a22aff1abaf0d...9e462f810194800af30ea19a6fb8ac5697d839b4,3,39,0,39,3,2013-03-27 16:24:36,2013-03-27 16:23:59
bb2705d3dbe8f3a8dbabc89030edf1d6d6af9818...c89717fabee46d70d73308f8ba1f2510f07bd596,1,1,1,2,1,2013-02-23 13:52:33,2013-02-23 13:52:33
67c39a64e018ee32b9c020615babea9b3ac7215f...6bbf4e57c8b250d09a70d3d840531a42147705e9,1,1,1,2,1,2013-02-23 13:59:51,2013-02-23 13:59:51
e4e12875905ae7360e131e9ef93ce91c638b65fd...e4ee3d8fcac987bc91ab9c559f39f52949227b76,3,9,13,22,6,2013-02-24 12:11:19,2013-02-24 12:10:42
10026c2ad0da99591567ba13afe4b489e050ca4a...7e6ad76b24a003bfb4ced8d9b3b22a46c1590e02,2,7,5,12,7,2013-02-23 20:48:22,2013-02-23 16:19:21
7e6ad76b24a003bfb4ced8d9b3b22a46c1590e02...cf890c110e159de16d54a59dc878272776d38514,1,24,5,29,2,2013-02-23 21:01:43,2013-02-23 21:01:43
cf890c110e159de16d54a59dc878272776d38514...150e202172034adb5175663411b15efacca52aae,2,10,7,17,10,2013-02-23 21:04:08,2013-02-23 21:04:08
150e202172034adb5175663411b15efacca52aae...1c11ee63459c4362affbd6a20f2ddf9c2ecd8dce,2,3,1,4,2,2013-02-23 21:27:07,2013-02-23 19:11:47
687d2e967dbc7c2ba29a90c74becc539d3ac2b9d...1cd2f51eb43f9ed043982770b4efd5f28f53f302,4,27,1,28,7,2013-02-23 16:45:26,2013-02-23 16:10:48
687d2e967dbc7c2ba29a90c74becc539d3ac2b9d...335a060fa6a919fc5eb1ff22315f9b3ae44438b7,1,2,6,8,4,2013-02-23 16:45:05,2013-02-23 16:45:05
03e40140ff3d9506aed1d69cd0e7f764e1c8bce9...51cc7029b96d028989e92a185a2f88b89283d287,1,3,1,4,2,2013-03-04 16:03:48,2013-03-03 22:25:49
51cc7029b96d028989e92a185a2f88b89283d287...3ea0c7d35ac461cb469170486683d10732eb534b,4,88,3,91,9,2013-03-04 16:30:59,2013-02-23 18:44:54
3ea0c7d35ac461cb469170486683d10732eb534b...d9330d5be2ee60b208dcab2616eb164ea2e6bf36,4,72,0,72,8,2013-03-04 21:08:53,2013-02-23 18:02:01
97afc49bb0cca34cb83b371c5f83d74cb3974b91...e4bf0f2c367ca77266900af3461e1ec440c8689d,1,8,1,9,2,2013-03-03 19:00:44,2013-03-03 18:58:13
97afc49bb0cca34cb83b371c5f83d74cb3974b91...df7668a9e47100bc2ac58a3b0fec4665d4aadb48,1,1,1,2,1,2013-03-03 18:34:10,2013-03-03 18:34:10
a001f3c31e751e6ab1622ae7f65f7f8aeca2ef9a...50fd96497b2129b8a350f789dfdc8ce0b0df4988,1,1,0,1,1,2012-12-14 20:22:58,2012-12-14 20:22:58
3984ccbcec7a892af4700b1c4b5e6e3e74452459...b052e6cc959b540e4d1de8a747689c25c6aeace9,5,657,13,670,6,2012-12-15 13:09:40,2012-12-15 13:03:17
b052e6cc959b540e4d1de8a747689c25c6aeace9...c2a6b2a43fb8f32cff078c823054e2e65f325464,2,33,3,36,7,2012-12-15 13:17:25,2012-12-12 03:33:03
c2a6b2a43fb8f32cff078c823054e2e65f325464...730c0d2e72e8d8445bbff27d2f766f78171bc435,1,5,5,10,2,2012-12-15 13:22:22,2012-12-15 13:22:22
730c0d2e72e8d8445bbff27d2f766f78171bc435...b594e4923c20de34a3113f714d12e64e2e0295c8,1,9,0,9,1,2012-12-15 13:29:46,2012-12-15 13:29:46
b594e4923c20de34a3113f714d12e64e2e0295c8...1e5b0fc4d0c8b5b6005dd01359e8e0145a63992a,2,37,19,56,3,2012-12-15 14:25:54,2012-12-15 14:25:54
1e5b0fc4d0c8b5b6005dd01359e8e0145a63992a...1b646e656e46909af447056b4f98b9744aae4978,2,30,0,30,2,2012-12-15 14:44:46,2012-12-15 12:13:45
1b646e656e46909af447056b4f98b9744aae4978...bd414aed01d48339ed02b9714565939536ffbfcb,1,55,0,55,1,2012-12-15 14:44:47,2012-12-15 12:49:56
bd414aed01d48339ed02b9714565939536ffbfcb...47e1df896b17aaaa97b73ef64010a7df4ea3d8d6,4,232,88,320,26,2012-12-15 14:44:47,2012-12-15 14:15:11
47e1df896b17aaaa97b73ef64010a7df4ea3d8d6...27f8129d64292868f6a328f7bf9a1bed67967ff3,2,15,9,24,6,2012-12-15 14:44:47,2012-12-15 14:43:44
27f8129d64292868f6a328f7bf9a1bed67967ff3...9facca28b619ad94680cf07774ee7a377034ca42,3,7,3,10,3,2012-12-15 23:18:45,2012-12-15 23:18:45
9facca28b619ad94680cf07774ee7a377034ca42...d7b49f5b0dcecfcc9b5a77632ecbba88e7637490,7,5,328,333,10,2012-12-16 14:22:09,2012-12-13 16:57:39
d7b49f5b0dcecfcc9b5a77632ecbba88e7637490...f811649710fb51e48217e9a78991735977decfd8,1,32,24,56,11,2012-12-16 14:56:28,2012-08-20 20:03:58
f811649710fb51e48217e9a78991735977decfd8...69597e5bcc89aadafd1b76abf7efab30ee0b8b1a,8,564,268,832,78,2012-12-16 15:23:26,2012-08-25 13:33:07
69597e5bcc89aadafd1b76abf7efab30ee0b8b1a...bf14aed3cc3cc1a7422873a4a8bc0e9ad1615c6f,2,1,1,2,1,2012-12-16 18:42:53,2012-12-16 18:40:57
bf14aed3cc3cc1a7422873a4a8bc0e9ad1615c6f...507c0814847fe3637d23625cc6f26bf2cfa5f66f,2,13,1,14,2,2012-12-16 19:39:37,2012-12-16 19:34:41
507c0814847fe3637d23625cc6f26bf2cfa5f66f...704ee33f503c96b96c2682b946a11b3b42318ba7,2,60,30,90,19,2012-12-16 19:46:02,2012-12-16 01:53:25
704ee33f503c96b96c2682b946a11b3b42318ba7...dbdd2538607e06f5f59c6f3c16737acb6bc68918,6,893,4,897,6,2012-12-16 20:07:12,2012-12-16 20:05:49
dbdd2538607e06f5f59c6f3c16737acb6bc68918...ed711c4bd5fd3b6321cae00bbad0876295c5c537,2,18,13,31,6,2012-12-16 20:12:45,2012-12-16 20:08:47
ed711c4bd5fd3b6321cae00bbad0876295c5c537...72a6ac568d28afdfa5be6bcb01526adb03eedfae,1,10,8,18,1,2012-12-16 20:42:01,2012-12-16 20:42:01
72a6ac568d28afdfa5be6bcb01526adb03eedfae...12a96bfa263d514884ef11009913b2f8bb163472,1,3,5,8,3,2012-12-16 21:26:16,2012-12-16 20:24:15
12a96bfa263d514884ef11009913b2f8bb163472...85712a53552a6457c9362b4bf037b1ba6a2e45e1,1,5,2,7,3,2012-12-16 21:26:16,2012-12-16 21:00:11
85712a53552a6457c9362b4bf037b1ba6a2e45e1...bbabfdcccee9ccd98fc140233dee748253bcb4a2,1,7,2,9,1,2012-12-17 08:46:26,2012-12-17 08:46:26
ff49449425eb9d4d04096f4f1bc4b32158683699...65b6eff322a4a3331601e111934dee95c090961c,1,13,0,13,2,2013-09-07 16:47:38,2013-09-07 16:41:34
65b6eff322a4a3331601e111934dee95c090961c...4e784f337c4f8ec14e8ea3615fe79f033699e348,1,3,0,3,1,2013-09-07 16:58:49,2013-09-07 16:58:49
4e784f337c4f8ec14e8ea3615fe79f033699e348...55a11683f7b094ae4fd0b9fa030d18a12657ba98,11,89,14,103,28,2013-09-07 17:14:07,2013-09-07 16:52:14
55a11683f7b094ae4fd0b9fa030d18a12657ba98...d34b94b00fa817871939ea6c097621a3e4a87311,28,385,353,738,251,2013-09-07 17:37:09,2013-09-06 18:57:00
d34b94b00fa817871939ea6c097621a3e4a87311...8ef060e0e67ae30cc1a0fee9c679f116d3cc24f1,1,1,1,2,1,2013-09-07 17:41:33,2013-09-07 17:41:33
8ef060e0e67ae30cc1a0fee9c679f116d3cc24f1...a44cbca2a5f1388c6511dad48443877fa660845a,1,14,0,14,1,2013-09-07 17:47:48,2013-09-07 17:46:42
a44cbca2a5f1388c6511dad48443877fa660845a...a86ecc80a2665378c336aec16274fb1539066d9b,1,8,0,8,1,2013-09-07 17:59:57,2013-09-07 17:59:57
59a34c43a8c3d62eaa400d48a9c26ed5400fc647...df27803a55ffea71d468a6aab0d897caa2b7a797,6,163,22,185,50,2013-09-19 17:11:49,2013-05-24 06:02:07
df27803a55ffea71d468a6aab0d897caa2b7a797...2c5c422d3446a0464eac403ad14fa0ad10c891f0,1,1,1,2,1,2013-09-19 17:26:01,2013-09-19 16:55:09
59a34c43a8c3d62eaa400d48a9c26ed5400fc647...a075e2ad0dcce65cb5cf4cb654ac8a6839db0baf,5,27,12,39,10,2013-09-19 17:02:25,2013-09-19 16:39:43
1278ee3ca7876950b203f648a79d672ba31f382d...7fe5b656c9d4f54d70b83edaa6225115805a2325,2,33,0,33,3,2013-09-11 01:02:48,2013-08-27 22:50:11
7fe5b656c9d4f54d70b83edaa6225115805a2325...baec6a26dd259a0b41f59fa123f7675d8e05de61,3,77,0,77,4,2013-09-11 01:07:22,2013-08-23 10:49:37
baec6a26dd259a0b41f59fa123f7675d8e05de61...5eca021d48cc388d89347d01cb7bfafc9fcfa331,1,13,16,29,6,2013-09-11 11:42:49,2013-09-10 22:00:36
5eca021d48cc388d89347d01cb7bfafc9fcfa331...da843e7dba4ae8ed2846475564bb6ded82960827,2,18,1,19,2,2013-09-11 12:17:15,2013-09-11 12:17:15
da843e7dba4ae8ed2846475564bb6ded82960827...170f72136758add6c9c0c59240cfce73d5672cc2,2,28,3,31,5,2013-09-11 12:48:32,2013-09-07 13:20:04
170f72136758add6c9c0c59240cfce73d5672cc2...abb10db06fb2ecb3e897462ec72417d10b39b8a4,2,16,2,18,4,2013-09-11 13:28:04,2013-09-11 13:20:15
abb10db06fb2ecb3e897462ec72417d10b39b8a4...e61cc87129727c66120b67c376feda3533544db1,2,29,2,31,3,2013-09-11 17:35:26,2013-09-11 15:12:56
7f75460fd6befbef805fee3c91608efb0e9f444d...dd0d2c0be56a28f868d501b06975984c138f4830,1,17,15,32,7,2012-10-31 23:56:53,2012-10-31 23:56:53
dd0d2c0be56a28f868d501b06975984c138f4830...ede8a0be05f7b55d07ab5f60f3e8e3135a54f743,1,5,2,7,1,2012-11-01 10:58:02,2012-11-01 10:58:02
ede8a0be05f7b55d07ab5f60f3e8e3135a54f743...d9213d09dbb28f687b53d051cddcae03337066c8,1,42,0,42,1,2012-11-01 18:47:41,2012-11-01 18:44:45
d9213d09dbb28f687b53d051cddcae03337066c8...af7ea808d8540d1be87d89172f371ac928ff5c19,4,40,7,47,8,2012-11-01 20:14:51,2012-11-01 20:11:05
af7ea808d8540d1be87d89172f371ac928ff5c19...f975c4857d4442bf3d7c4cf1c28d317d26a2e297,1,1,1,2,1,2012-11-02 08:29:55,2012-11-02 08:29:55
f975c4857d4442bf3d7c4cf1c28d317d26a2e297...0d8432da552b2ddf2d2326edccae627dd05a414e,2,5,5,10,4,2012-11-02 09:51:10,2012-11-02 09:51:10
0d8432da552b2ddf2d2326edccae627dd05a414e...92fc263a2898b804c3b46447fd47e2898fbf8ff1,1,4,2,6,1,2012-11-02 12:57:19,2012-11-02 12:54:50
92fc263a2898b804c3b46447fd47e2898fbf8ff1...feaf9f279a73d87549c17fc7fb36463f1c7367a1,2,70,1,71,3,2012-11-02 21:58:24,2012-11-02 10:54:00
feaf9f279a73d87549c17fc7fb36463f1c7367a1...082fad0b83638332f85c5957eb8dcc5e38417608,1,4,3,7,1,2012-11-02 22:04:27,2012-11-02 20:15:40
082fad0b83638332f85c5957eb8dcc5e38417608...07361d1fd6b4531e422e2593c91b47bc6bf88993,1,9,0,9,1,2012-11-02 22:19:45,2012-11-02 20:33:07
07361d1fd6b4531e422e2593c91b47bc6bf88993...d1de7596b207b3a7dea8203334ef1739db3b1c94,1,23,4,27,2,2012-11-02 22:31:03,2012-11-02 20:48:55
7f75460fd6befbef805fee3c91608efb0e9f444d...c4b71beb658981011a455753bbb58024bfbeb713,1,1,1,2,1,2012-10-31 20:40:08,2012-10-31 20:40:08
7f75460fd6befbef805fee3c91608efb0e9f444d...ba81164fb771391b92575b5aaab6e286f56eb831,2,5,1,6,2,2012-10-31 13:58:28,2012-10-24 20:02:30
3f6a1f430a5c7892d38902debdd5861a6d7bc443...e98eff836d677755cad076ed3026cc2a03491e81,1,2,1,3,1,2012-08-28 20:45:51,2012-08-28 20:45:51
e98eff836d677755cad076ed3026cc2a03491e81...20012b961ea5306e1a381a3a2880627dd5af0d15,1,31,19,50,10,2012-08-28 21:20:55,2012-08-28 21:18:55
20012b961ea5306e1a381a3a2880627dd5af0d15...3afb5916b215c79e36408b729c9516bc435f5cb7,3,19,2,21,5,2012-08-28 21:23:07,2012-08-28 21:22:06
3afb5916b215c79e36408b729c9516bc435f5cb7...9eafb6592e9ed27a59cb3cd9920c44cf230a6c65,1,6,2,8,4,2012-08-28 22:04:34,2012-08-28 22:02:53
785980d30e263db621282b69ba40e636dee1a82d...7235cc76859ba63b3eba3e91abd74aa8dd66c8c9,1,41,2,43,4,2012-08-31 12:14:45,2012-08-31 10:50:00
7235cc76859ba63b3eba3e91abd74aa8dd66c8c9...44f541ab47317fc8e8de71df514c79caad5e5aad,3,30,0,30,4,2012-08-31 18:35:50,2012-08-31 18:35:50
44f541ab47317fc8e8de71df514c79caad5e5aad...70896386ecc1808283e1f2f1fb9ced3bb0ac8301,1,4,2,6,3,2012-08-31 22:01:02,2012-08-31 20:19:04
73c26f0c95e83582e933e0ef2f71a013f7a9740e...f17aa998be1f197004ac5d708cc7bcc0c3362bf0,1,1,1,2,1,2013-04-24 03:12:47,2013-04-23 15:10:25
f17aa998be1f197004ac5d708cc7bcc0c3362bf0...949b4e94588e73067f64b5b6d22e569a105baaf7,1,17,15,32,5,2013-04-24 07:27:03,2013-04-24 07:27:03
949b4e94588e73067f64b5b6d22e569a105baaf7...db394e6ab2c1d3d53b8b8d691e995d0c3584b944,1,1,1,2,1,2013-04-24 07:41:06,2013-04-24 07:41:06
73c26f0c95e83582e933e0ef2f71a013f7a9740e...172b50b72224dea985cd665accab2ff3110f6674,2,3,3,6,3,2013-04-23 18:18:17,2013-04-23 18:17:04
72b1522a2f32bd42fb9defb777328e3d46b3b36f...33503600b5562a2d0c0ba8d376a40432a4b30893,1,2,1,3,1,2013-03-30 12:36:31,2013-03-30 12:36:31
33503600b5562a2d0c0ba8d376a40432a4b30893...5c55e0fc98a38dc0e59dbd80ff6f236ced697763,1,0,3,3,1,2013-03-30 19:17:31,2013-03-30 19:14:48
5c55e0fc98a38dc0e59dbd80ff6f236ced697763...91d06ea719f505e1e223d5ea058a837e4d2c613a,1,8,0,8,1,2013-03-30 20:21:59,2013-03-30 20:21:59
91d06ea719f505e1e223d5ea058a837e4d2c613a...ffc8e2e0ae9f1e35f4b7c78e6235bd0e3ba41aa9,1,10,0,10,1,2013-03-30 23:23:27,2013-03-30 23:23:27
ffc8e2e0ae9f1e35f4b7c78e6235bd0e3ba41aa9...b5e1e2ec0320bc5b114b7dbffc8cbf16cefb0a4f,1,3,3,6,2,2013-03-30 23:49:31,2013-03-30 23:49:31
b5e1e2ec0320bc5b114b7dbffc8cbf16cefb0a4f...c119d0f152e939420613868294d58fa4b902e18a,1,2,2,4,1,2013-03-31 07:40:44,2013-03-31 07:40:44
c119d0f152e939420613868294d58fa4b902e18a...ac4d82b94a700214ebb13bcdcbbdd4fd9bdefc0f,1,8,4,12,1,2013-03-31 07:59:34,2013-03-31 07:59:34
ac4d82b94a700214ebb13bcdcbbdd4fd9bdefc0f...4a1d425cfe88983b34b1ecd3ad2aa9993af84467,1,4,1,5,1,2013-03-31 08:34:28,2013-03-31 08:34:28
4a1d425cfe88983b34b1ecd3ad2aa9993af84467...3ff3212713403c5bb8c5b067d2f00d62cf111036,2,42,1,43,4,2013-03-31 20:39:01,2013-03-31 20:29:35
3ff3212713403c5bb8c5b067d2f00d62cf111036...2d0db67813d457dc890a2287d9e98593565d650f,2,15,2,17,3,2013-04-01 03:00:06,2013-03-31 01:26:29
2d0db67813d457dc890a2287d9e98593565d650f...2bcbca3451cf7738d8e88c20023f9e799a044e9d,5,11,7,18,7,2013-04-01 12:04:41,2013-04-01 12:03:55
2bcbca3451cf7738d8e88c20023f9e799a044e9d...b474ffe63a3f99daeef2324a674f7ddfbb653c41,2,6,1,7,2,2013-04-01 13:37:37,2013-04-01 13:37:37
b474ffe63a3f99daeef2324a674f7ddfbb653c41...a01361b5ae9df5220c0ce7b42c5ff36094d5718c,3,1436,0,1436,5,2013-04-01 14:48:47,2013-04-01 14:42:31
a01361b5ae9df5220c0ce7b42c5ff36094d5718c...51028f50b624efae273dcbe828ec80c1846c74dc,2,10,3,13,3,2013-04-01 16:17:00,2013-04-01 16:17:00
51028f50b624efae273dcbe828ec80c1846c74dc...dcf563071fad7fe286c6921c949639fc99f51351,2,12,4,16,2,2013-04-01 16:32:57,2013-04-01 16:32:57
dcf563071fad7fe286c6921c949639fc99f51351...2817a29d9059886b163e72ab03f9012fa938645b,1,2,2,4,3,2013-04-01 17:59:57,2013-04-01 17:58:16
2817a29d9059886b163e72ab03f9012fa938645b...8c41bd93c2412ddeb9dbe8bd73e1d3c3427d171b,4,19,5,24,9,2013-04-01 17:59:57,2013-04-01 17:51:53
8c41bd93c2412ddeb9dbe8bd73e1d3c3427d171b...2f81a0ca6543f4f7b59bf6cd9aeb8ae87f1e968e,2,39,1,40,2,2013-04-01 19:04:44,2013-03-31 07:54:52
2f81a0ca6543f4f7b59bf6cd9aeb8ae87f1e968e...edc782b7b50b379c2b95cf8ba13ffae541fe58ed,1,0,1,1,1,2013-04-01 20:53:04,2013-04-01 20:50:49
edc782b7b50b379c2b95cf8ba13ffae541fe58ed...8d05e6c0c7fe35df86799fa2fdcdb6499a4f6312,1,7,7,14,6,2013-04-01 21:32:09,2013-04-01 21:30:43
8d05e6c0c7fe35df86799fa2fdcdb6499a4f6312...b9dbd1dd2fddbd4ba20e1ab983b0d6712d21da00,1,22,0,22,1,2013-04-02 16:59:43,2013-04-02 16:59:43
b9dbd1dd2fddbd4ba20e1ab983b0d6712d21da00...f2d3c4b0caccd509dda8463ec71549a1a0cda0b7,1,18,0,18,1,2013-04-02 17:15:37,2013-03-26 00:11:23
f2d3c4b0caccd509dda8463ec71549a1a0cda0b7...8ce46375ae3927eec142a8689215ac5039123a03,11,872,872,1744,15,2013-04-03 01:00:55,2013-04-03 01:00:55
8ce46375ae3927eec142a8689215ac5039123a03...7fd1571b2e7f75c2e456de89d8c5bd805b16c1a9,3,43,43,86,3,2013-04-03 02:12:15,2013-04-02 23:07:41
7fd1571b2e7f75c2e456de89d8c5bd805b16c1a9...8aedde03850c450a5cd65cd2a908127f1afac390,7,6,6,12,1,2013-04-03 02:12:24,2013-04-02 23:22:38
8aedde03850c450a5cd65cd2a908127f1afac390...756a70b48de73daccf2a4581996830900239a4b7,8,193,192,385,6,2013-04-03 02:12:26,2013-04-02 23:37:40
756a70b48de73daccf2a4581996830900239a4b7...629d704d5fccc9b4b5e997b06f34a04b502953d1,7,10,10,20,5,2013-04-03 02:12:30,2013-04-02 23:42:30
629d704d5fccc9b4b5e997b06f34a04b502953d1...e3cfbaaca45bad6d1f064644c9bab7b2f3a38708,5,4,4,8,1,2013-04-03 02:12:35,2013-04-02 23:45:54
e3cfbaaca45bad6d1f064644c9bab7b2f3a38708...fde2e4fd6ecdf6aa9c31d004f91be2b8df76ddb9,15,35,36,71,14,2013-04-03 03:59:45,2013-04-03 03:22:07
fde2e4fd6ecdf6aa9c31d004f91be2b8df76ddb9...c8deaa9e7b8523f4231c354972bc0dc1e29cebe1,1,1,1,2,1,2013-04-03 09:07:17,2013-04-03 09:07:17
391ec5a08582f9479366e38afb4cb0547c39f073...0524ad3fade53b447369ed5aca21f925c8f3f523,1,6,3,9,1,2013-03-29 19:49:37,2013-03-29 19:49:37
391ec5a08582f9479366e38afb4cb0547c39f073...485c024567c83160b66a62d1bd3f152070808281,1,1,1,2,1,2013-03-29 19:31:56,2013-03-29 19:31:56
15c3906eeb827aad1fdfcb1cd58990dc56b76ae1...35cab0f8e43c01a7d5ede4ebc96e5e8723a04338,1,6,2,8,1,2013-03-27 18:39:52,2013-03-27 18:37:40
35cab0f8e43c01a7d5ede4ebc96e5e8723a04338...4befef91f17cd082f387caaa8871c5852cd4c9ce,1,4,2,6,2,2013-03-27 22:01:11,2013-03-27 22:01:11
4befef91f17cd082f387caaa8871c5852cd4c9ce...c5084e7557314fd8bd493c2af9059273aaecdb54,56,303,238,541,252,2013-03-28 08:24:07,2013-03-27 22:14:41
c5084e7557314fd8bd493c2af9059273aaecdb54...65ad1b1f8514eb3b464fca2913f68a906e934ed7,1,43,42,85,43,2013-03-28 08:46:40,2013-03-28 08:46:40
65ad1b1f8514eb3b464fca2913f68a906e934ed7...ab76467d54b3ed0118436fd895acde0ea74edb57,16,3150,0,3150,9,2013-03-28 08:54:16,2013-03-28 08:54:16
ab76467d54b3ed0118436fd895acde0ea74edb57...0a22f7aad210f1a79dd63ffec15d80e343791d07,22,3377,0,3377,12,2013-03-28 09:01:30,2013-03-28 09:01:30
0a22f7aad210f1a79dd63ffec15d80e343791d07...244e765a94c02633c028260228b18618906ea46b,15,528,461,989,412,2013-03-28 09:06:11,2013-03-28 09:06:11
6bbf4e57c8b250d09a70d3d840531a42147705e9...d7429defe6f8d1dce49976cf49827d18ff6be025,6,111,2,113,7,2013-02-24 11:38:28,2013-02-23 16:07:50
d7429defe6f8d1dce49976cf49827d18ff6be025...5099f31a31c80e82bdc185b23c9ac5f1f472fefb,1,10,0,10,1,2013-02-24 11:53:59,2013-02-24 11:53:59
6bbf4e57c8b250d09a70d3d840531a42147705e9...1b7fb29dfb8579dc627208b8ca6500b5341489a9,3,8,9,17,7,2013-02-23 14:19:32,2013-02-23 14:19:32
e4ee3d8fcac987bc91ab9c559f39f52949227b76...ade992c61e15fbc83d87bfc688c0f844b6ef19fd,3,57,3,60,5,2013-02-24 12:58:38,2013-02-24 12:20:41
e4ee3d8fcac987bc91ab9c559f39f52949227b76...4b01ee7a50a9bfa88991461bb4a91edc59b48d34,3,18,3,21,4,2013-02-24 12:27:13,2013-02-24 12:12:41
4b01ee7a50a9bfa88991461bb4a91edc59b48d34...a44531ae1592cf266e6c24387f49d665c639b480,3,20,2,22,5,2013-02-24 12:27:13,2013-02-24 12:25:17
e4ee3d8fcac987bc91ab9c559f39f52949227b76...f07a5f0a21857204465019b4e68f914d31cb396a,2,46,11,57,5,2013-02-24 12:23:23,2013-02-24 12:18:21
1c11ee63459c4362affbd6a20f2ddf9c2ecd8dce...32a7ab21482ef06f7e01a70fad8495f659c4d29f,3,10,1,11,3,2013-02-23 22:05:22,2013-02-23 21:39:37
a05ab448f7a738d30ee7e8a513a65b6a67e8ea8e...cc53d9b30bd73c12413c28101d5db9f9f4df517c,2,18,2,20,4,2013-02-23 17:32:29,2013-02-23 17:29:56
d9330d5be2ee60b208dcab2616eb164ea2e6bf36...22be90dd171deebd0cf52bdd749f27b18e29a2f2,1,5,3,8,5,2013-03-06 07:30:23,2013-03-06 07:28:12
22be90dd171deebd0cf52bdd749f27b18e29a2f2...d1a5fe07ed96794864d9aa69502ed056bb7a561b,1,1,1,2,1,2013-03-06 10:40:33,2013-03-06 10:40:33
d1a5fe07ed96794864d9aa69502ed056bb7a561b...b3aa853ec536926c4fd2739c8d39091fe48e51c9,1,2,5,7,3,2013-03-06 14:33:35,2013-03-06 14:33:35
b3aa853ec536926c4fd2739c8d39091fe48e51c9...2add24cc2c605a51695258d45d6d1b61556dec9f,1,1,2,3,2,2013-03-06 16:00:46,2013-03-06 15:58:04
d9330d5be2ee60b208dcab2616eb164ea2e6bf36...9ba0e4e4ee2725679ae5cb9e3dd637b0208e5ad3,2,4,3,7,4,2013-03-05 18:13:36,2013-03-05 18:13:36
2047865964e534646f7fe15165785bfbca892b9d...804366327d728d23a9f7a25ff77a6eed3c9f9323,2,9,3,12,4,2013-03-03 19:10:11,2013-02-27 20:50:33
804366327d728d23a9f7a25ff77a6eed3c9f9323...b01381072a3eaa7e7ace5cf3efa3c825854c452f,1,4,0,4,1,2013-03-03 19:44:44,2013-03-03 19:44:44
b01381072a3eaa7e7ace5cf3efa3c825854c452f...3bbcec0aba81b626a26c19736dbac49999007d6c,3,6,6,12,5,2013-03-03 20:03:11,2013-03-03 20:03:11
3bbcec0aba81b626a26c19736dbac49999007d6c...60dd4eabe772a773f74493e05162af6b9eb86249,1,3,3,6,2,2013-03-03 21:44:06,2013-03-03 21:44:06
ddb454b2b06409753d61c3ed868dcbdaf5d857e3...7df03268a467a9aec9c4c574c85317a738ca33ae,1,18,3,21,5,2012-12-18 13:03:47,2012-12-18 11:39:23
7df03268a467a9aec9c4c574c85317a738ca33ae...31f49f1396c4cc565017066e9f17c6b850a89687,1,2,1,3,1,2012-12-18 13:10:12,2012-12-18 12:04:17
31f49f1396c4cc565017066e9f17c6b850a89687...6534a95ac3142ff79f8152b0d5dcbf9330d8abde,2,8,8,16,4,2012-12-18 13:20:01,2012-12-18 11:52:30
6534a95ac3142ff79f8152b0d5dcbf9330d8abde...abd0f304b162b3120b1c7321fbfc3090e5f3c92c,1,19,0,19,1,2012-12-19 18:07:52,2012-12-19 18:07:52
abd0f304b162b3120b1c7321fbfc3090e5f3c92c...3989ce52ef78840eefe01541628daa220191c0ad,3,33,2,35,5,2012-12-19 20:51:12,2012-12-19 18:12:08
3989ce52ef78840eefe01541628daa220191c0ad...c04c03daa3620dc5106740a976738ada35203ab5,2,28,3,31,5,2012-12-20 08:10:19,2012-12-20 08:10:19
c04c03daa3620dc5106740a976738ada35203ab5...3dcd435a0eb4380a3846e9c65140df480975687e,7,65,32,97,23,2012-12-20 19:27:00,2012-12-20 19:25:48
3dcd435a0eb4380a3846e9c65140df480975687e...d407164c0499c234ec043f5720b3209311b2f4e9,3,195,59,254,16,2012-12-20 19:45:15,2012-08-25 11:13:37
d407164c0499c234ec043f5720b3209311b2f4e9...4007c8f6eb2067ba18da24c4a0fb97d392a76817,1,1,1,2,1,2012-12-20 20:50:06,2012-12-20 20:50:06
4007c8f6eb2067ba18da24c4a0fb97d392a76817...e277301c2c96915ba1408d57a866bc65e51de95a,3,40,2,42,9,2012-12-21 09:09:32,2012-12-21 09:01:03
e277301c2c96915ba1408d57a866bc65e51de95a...52a2588df69e5252bee98e76e8d3a2aa37bce23c,1,2,2,4,2,2012-12-21 20:52:06,2012-12-21 20:52:06
52a2588df69e5252bee98e76e8d3a2aa37bce23c...d19109fd37e75ccf29d2ca64370102753dbc7c5b,21,911,863,1774,78,2012-12-22 00:59:06,2012-12-22 00:59:06
d19109fd37e75ccf29d2ca64370102753dbc7c5b...d9a0b6ab36b6beb4251acf1de1fdf255e1223e02,1,23,23,46,12,2012-12-22 09:38:27,2012-12-17 09:47:38
d9a0b6ab36b6beb4251acf1de1fdf255e1223e02...1e4a27d08790c96f657d2e960c8142d1ca69aede,6,49,19,68,19,2012-12-22 12:32:39,2012-12-17 09:49:26
1e4a27d08790c96f657d2e960c8142d1ca69aede...0dc3fc954f53d5b03b864e63b309acfdbb40dbf9,2,52,49,101,30,2012-12-22 15:04:10,2012-12-22 15:00:15
0dc3fc954f53d5b03b864e63b309acfdbb40dbf9...38f725da547f07baaa791acfe2c116a7fc6b02fe,1,1,1,2,1,2012-12-22 15:08:22,2012-12-22 15:08:22
38f725da547f07baaa791acfe2c116a7fc6b02fe...9d62220e008c5e1b03e3026aaa97afac2e4eb67b,5,2658,3,2661,3,2012-12-22 18:01:55,2012-12-22 18:01:55
9d62220e008c5e1b03e3026aaa97afac2e4eb67b...dc704516c240011a9aeda17f631ade35c65cda58,1,14,0,14,1,2012-12-24 00:15:36,2012-09-27 23:49:10
dc704516c240011a9aeda17f631ade35c65cda58...089d9ca1df43fb36eaa857e2d617a94a82c6b906,1,12,0,12,1,2012-12-24 00:18:50,2012-09-27 23:52:24
089d9ca1df43fb36eaa857e2d617a94a82c6b906...8d35fd4c327e05b63c72a1c1e9a4a68de4dddcf0,7,26,20,46,13,2012-12-24 00:24:14,2012-09-28 07:20:01
8d35fd4c327e05b63c72a1c1e9a4a68de4dddcf0...585aa11d233b7e3e40fe45fa69ef045d8f282345,1,32,21,53,12,2012-12-24 00:26:09,2012-09-28 07:25:08
585aa11d233b7e3e40fe45fa69ef045d8f282345...b9fc70141abd4c812b03df50452a0d3ed8cd62d2,4,35,25,60,9,2012-12-24 00:45:58,2012-09-28 07:27:38
b9fc70141abd4c812b03df50452a0d3ed8cd62d2...6b9f130278f98b3a15f7ad1959269c200e084f03,1,1,1,2,1,2012-12-24 00:47:17,2012-09-28 04:30:13
6b9f130278f98b3a15f7ad1959269c200e084f03...c31c2c92b8ef0b58394ac55fa4f61acc07091047,3,8,8,16,5,2012-12-24 01:33:24,2012-12-24 01:32:04
c31c2c92b8ef0b58394ac55fa4f61acc07091047...1ae64e96c161229a74efc4235917dcaae7e9cd05,1,5,5,10,3,2012-12-24 01:33:44,2012-12-24 01:33:44
1ae64e96c161229a74efc4235917dcaae7e9cd05...8bc410b44536e03ee38a0087256faf367dd98dd9,1,8,0,8,1,2012-12-24 02:11:32,2012-12-24 02:11:32
8bc410b44536e03ee38a0087256faf367dd98dd9...e8f07f0378cef5a133028c502ff4064b91cd0611,1,1,1,2,1,2012-12-24 10:25:58,2012-12-24 10:25:58
e8f07f0378cef5a133028c502ff4064b91cd0611...4a71b842662162e0892a9269179421ff2191adba,4,15,15,30,15,2012-12-24 13:05:36,2012-12-24 13:04:02
4a71b842662162e0892a9269179421ff2191adba...35d1cd0b28d1d9cd7bffbfbc6cc2e02b58404415,5,140,170,310,40,2012-12-24 18:44:19,2012-12-22 19:00:08
35d1cd0b28d1d9cd7bffbfbc6cc2e02b58404415...1c8be95a864540d416602577d1aa03d58ba33168,2,10,13,23,6,2012-12-24 19:28:07,2012-12-24 19:25:02
1c8be95a864540d416602577d1aa03d58ba33168...f56f6cfa58345b964ceb2614e4366639381c8f6f,8,34,35,69,11,2012-12-24 20:38:05,2012-12-24 20:37:36
f56f6cfa58345b964ceb2614e4366639381c8f6f...ad769efa85e0296033572315025fed9fa9aefade,3,208,21,229,20,2012-12-24 20:48:48,2012-12-24 19:17:16
ad769efa85e0296033572315025fed9fa9aefade...b70498d675bbd96849b466cdd45c1c189f227444,1,4,2,6,1,2012-12-24 23:26:46,2012-12-24 23:26:46
b70498d675bbd96849b466cdd45c1c189f227444...9c5a6adf3341c59efee4ca6d0037f8069185e0e3,9,65,60,125,42,2012-12-25 09:44:09,2012-12-25 08:40:08
9c5a6adf3341c59efee4ca6d0037f8069185e0e3...0907d3c6f511ef3dc68d381389a32b9b54ae4be7,2,4,1,5,3,2012-12-26 11:45:41,2012-12-26 11:45:41
0907d3c6f511ef3dc68d381389a32b9b54ae4be7...4500d3522defd7df869756e8ee2c876a747a8fa9,3,37,14,51,10,2012-12-26 13:29:07,2012-12-26 13:19:28
4500d3522defd7df869756e8ee2c876a747a8fa9...e2ec7b47b3acb0338d971942ca7ffd36c2a4d8f4,1,7,10,17,1,2012-12-26 13:45:13,2012-12-26 13:33:47
e2ec7b47b3acb0338d971942ca7ffd36c2a4d8f4...b3a8c9dab87be6bc4b8096d292abe0b35c700bdd,34,127,118,245,67,2012-12-27 00:07:22,2012-12-25 14:56:22
b3a8c9dab87be6bc4b8096d292abe0b35c700bdd...db278c3bf9177043c42a9ed8b529a5c117938460,3,1,44,45,6,2012-12-27 08:37:57,2012-12-27 08:37:57
bbabfdcccee9ccd98fc140233dee748253bcb4a2...c64b57d16688025b2d48668d5c4cb9eda7484612,1,1,1,2,1,2012-12-17 19:15:01,2012-12-17 19:15:01
bbabfdcccee9ccd98fc140233dee748253bcb4a2...ac8eb82abb23f7ae50ab85100619f13257b03526,1,1,1,2,1,2012-12-17 09:35:36,2012-12-17 09:35:36
f8f47718abb4c93ef00f93dde42101a8dd17a700...0d1ba84d13eb6000c9f6e54b03d52863fcd31f27,6,180,26,206,28,2013-09-20 11:47:24,2013-09-04 01:01:45
0d1ba84d13eb6000c9f6e54b03d52863fcd31f27...4db2752e28668ed8826b770ef2ed26e8c1562db6,1,14,0,14,1,2013-09-20 19:56:35,2013-09-20 19:56:35
e61cc87129727c66120b67c376feda3533544db1...bd72c2acb60a7adeb0334a823063d6eab9206081,1,1,1,2,1,2013-09-11 21:45:00,2013-09-11 21:45:00
7b57a72d6d5b268e5b9b0788903685adc1a6b56c...965cc0b1ffa27574e5684a18f9400577e5b4598d,4,30,14,44,7,2012-11-03 05:03:33,2012-11-02 15:49:29
965cc0b1ffa27574e5684a18f9400577e5b4598d...39f5bc7fc3a4bb43ed8a1358b17fe0521a1a63ac,1,34,1,35,3,2012-11-03 09:22:34,2012-11-03 09:22:34
39f5bc7fc3a4bb43ed8a1358b17fe0521a1a63ac...ac2052ebc84c45709ab5f0f25e685bf656ce79bc,4,65,1,66,5,2012-11-03 10:57:33,2012-07-07 12:24:50
ac2052ebc84c45709ab5f0f25e685bf656ce79bc...095eca8dd85cb27ed0b22829903df10f19cdab6c,3,15,2,17,4,2012-11-03 12:03:15,2012-11-03 11:54:06
095eca8dd85cb27ed0b22829903df10f19cdab6c...0546794397130b1574a667d57667bd032bff78d3,1,11,0,11,1,2012-11-03 16:18:47,2012-11-03 16:04:53
9eafb6592e9ed27a59cb3cd9920c44cf230a6c65...ebc773ada3e4f40cf5084268387b873d7fe22e8b,32,74,77,151,74,2012-08-29 09:20:32,2012-08-28 18:59:56
ebc773ada3e4f40cf5084268387b873d7fe22e8b...361d6738f89f8443855d4378d3241566d9fca6e9,3,25,9,34,9,2012-08-29 09:21:33,2012-08-29 07:45:02
361d6738f89f8443855d4378d3241566d9fca6e9...b5240d25c1bf724f0008478e7f6cccd0a6d6bd1e,2,27,27,54,24,2012-08-29 09:32:18,2012-08-29 08:00:29
b5240d25c1bf724f0008478e7f6cccd0a6d6bd1e...4e70ad11d29bde54b846920ce0dcf8d10741d3ae,2,20,2,22,4,2012-08-29 14:37:37,2012-08-29 13:13:20
4e70ad11d29bde54b846920ce0dcf8d10741d3ae...adbdb18adc37eaffd2ff174853f8026bd29fb998,2,2,2,4,2,2012-08-29 19:25:02,2012-08-29 19:25:02
adbdb18adc37eaffd2ff174853f8026bd29fb998...723c9a8c6db60108f584972498fa6bbd3b408444,1,9,9,18,2,2012-08-29 21:44:12,2012-08-29 21:43:10
9eafb6592e9ed27a59cb3cd9920c44cf230a6c65...c87b08d2a12180203e6f278a9de8a2f5d5e8982f,1,2,2,4,2,2012-08-29 00:46:42,2012-08-29 00:46:42
70896386ecc1808283e1f2f1fb9ced3bb0ac8301...f99ecaff064af334adfd9a690e77c24ed8b15cbd,1,4,0,4,1,2012-09-01 00:24:33,2012-09-01 00:24:33
f99ecaff064af334adfd9a690e77c24ed8b15cbd...e376558ed257a4f8ce63779058f3d181ef49caa0,1,104,43,147,9,2012-09-01 10:03:01,2012-09-01 10:01:36
e376558ed257a4f8ce63779058f3d181ef49caa0...f7142b6111fef01c2b1a4a37219c3dfbfdea2dc2,1,5,4,9,1,2012-09-01 13:03:05,2012-09-01 13:03:05
f7142b6111fef01c2b1a4a37219c3dfbfdea2dc2...5faadea439a405ecd80ec06c0d6a769e47ebeec2,3,559,1,560,3,2012-09-01 13:20:38,2012-09-01 13:20:38
5faadea439a405ecd80ec06c0d6a769e47ebeec2...74c025d0285450bf277afbee095172af54562ab6,2,9,1,10,3,2012-09-01 13:24:39,2012-09-01 13:24:39
74c025d0285450bf277afbee095172af54562ab6...306d34873cff2722e209d8c6058f13eac1532a7b,6,56,3,59,8,2012-09-01 16:38:55,2012-09-01 16:32:27
306d34873cff2722e209d8c6058f13eac1532a7b...c6088bc91d29b6b49eba0ec82b0239a557c658ef,1,3,1,4,1,2012-09-01 19:38:44,2012-09-01 19:38:44
c6088bc91d29b6b49eba0ec82b0239a557c658ef...28fd876bae15df747d164dcae229840d2cf135ca,2,17,2,19,4,2012-09-01 20:20:46,2012-09-01 20:07:18
70896386ecc1808283e1f2f1fb9ced3bb0ac8301...fef641d1640c0de3ce816bcc1ab9bbb12002d69a,1,9,8,17,6,2012-08-31 23:13:50,2012-08-31 23:13:50
db394e6ab2c1d3d53b8b8d691e995d0c3584b944...9e80663c95a1d2c17b0d6cf9400d882e4fa89721,1,1,1,2,1,2013-04-24 18:02:19,2013-04-24 18:02:19
db394e6ab2c1d3d53b8b8d691e995d0c3584b944...f043cfe3e2c1097804f486ecf05d18f054eb64fb,1,3,2,5,2,2013-04-24 17:26:13,2013-04-24 17:26:13
7902fd74f1fbc5c47f2feb95e447bb307b37e0c9...36aecb12b850aeed173a8e524cacb3444f807785,6,65,2,67,10,2013-05-30 17:48:10,2013-05-30 17:48:10
36aecb12b850aeed173a8e524cacb3444f807785...571864c84595558e0d72031485dda772e5b4a5c8,1,1,1,2,1,2013-05-30 18:07:53,2013-05-30 18:07:53
571864c84595558e0d72031485dda772e5b4a5c8...9d06c6ccc92e240af245205316cf6075b37a24e3,1,26,22,48,3,2013-05-30 18:23:14,2013-05-30 18:23:14
9d06c6ccc92e240af245205316cf6075b37a24e3...ac90aee55cb0258253011ec6910c1e553e07377f,2,11,9,20,5,2013-05-30 23:38:44,2013-05-30 23:38:44
ac90aee55cb0258253011ec6910c1e553e07377f...728d3fe1bac6b5f23dbd088e11860cfba51cf7b5,1,6,6,12,3,2013-05-31 07:11:15,2013-05-31 07:10:18
c8deaa9e7b8523f4231c354972bc0dc1e29cebe1...c250f9c99b59bb011dae9bc97783458621462b65,2,87,25,112,14,2013-04-03 20:27:20,2013-04-03 20:27:20
c250f9c99b59bb011dae9bc97783458621462b65...7ccbe6a4fa62c2f3f250d12e70b7db1abfa085d2,4,10,8,18,11,2013-04-03 21:30:34,2013-04-03 03:42:00
c8deaa9e7b8523f4231c354972bc0dc1e29cebe1...bd9b324a99ec77026c3dd0f749e28c919fe5ee59,1,1,1,2,1,2013-04-03 13:49:48,2013-04-03 13:49:48
ce11dde7c028131fe42bdb87fac1b5dca2d0a2f3...9916e69bf10ce80645c362edefa150ab70b532b4,1,28,0,28,1,2013-03-29 20:48:07,2013-03-29 20:46:35
9916e69bf10ce80645c362edefa150ab70b532b4...c32fc79aa120a0a129680805aef6731c1c2c7aef,6,141,11,152,8,2013-03-29 23:03:53,2013-03-04 11:05:11
c32fc79aa120a0a129680805aef6731c1c2c7aef...6c730da1f6d34f5c38fa1d990d368286e016546c,22,340,481,821,61,2013-03-29 23:15:19,2013-03-07 19:15:39
6c730da1f6d34f5c38fa1d990d368286e016546c...465b01f065a8482bfa42c19e3854a3c810e69d33,3,29,1,30,5,2013-03-30 10:59:50,2013-03-06 21:15:36
465b01f065a8482bfa42c19e3854a3c810e69d33...5080311998a8ecc5b3f9fa162c19e55b70aa9f85,2,6,1,7,2,2013-03-30 11:13:08,2013-03-25 08:10:32
5080311998a8ecc5b3f9fa162c19e55b70aa9f85...86aaff75d09fb9c801ec29d1f961cd4706043be9,1,17,10,27,7,2013-03-30 11:19:39,2013-03-17 21:17:35
86aaff75d09fb9c801ec29d1f961cd4706043be9...80b658f5aa58313be5890e3d607b9537f461ea3b,1,4,15,19,3,2013-03-30 11:22:28,2013-03-13 04:28:53
244e765a94c02633c028260228b18618906ea46b...26ad3abadf3252c9c4a5eef4be0a8fa1796b58bd,1,1,1,2,1,2013-03-28 15:10:13,2013-03-28 15:10:13
1b7fb29dfb8579dc627208b8ca6500b5341489a9...3dddbc0f2380d2654e66c8df4bb40d5e1d42af98,2,17,1,18,3,2013-02-23 14:50:33,2013-02-23 14:50:33
1b7fb29dfb8579dc627208b8ca6500b5341489a9...722683f508566cf06bcc85f9f1810c3cde80344c,1,9,0,9,2,2013-02-23 14:45:34,2013-02-23 14:45:34
7106a1e594dc28108e7e4f83af3ffb25289d3bb0...b9cc61021a0db1e5b41e61d3e53180e4fc618f9c,1,6,1,7,2,2013-02-24 13:21:40,2013-02-24 13:05:29
b9cc61021a0db1e5b41e61d3e53180e4fc618f9c...99edbe0e279166db82caaf545ef92d5446a6a07e,5,60,7,67,9,2013-02-24 13:32:45,2013-02-24 11:58:02
d7e835f76d81d66a6d8964dba20506a1c6e559d8...5a9b2bce242bd2f8a9fed6ac735406ce68b10738,3,23,0,23,5,2013-02-24 12:56:15,2013-02-24 12:36:04
5a9b2bce242bd2f8a9fed6ac735406ce68b10738...deb4e097ae2a495480a2907028fc3c76eed0cbb7,1,1,1,2,1,2013-02-24 12:58:24,2013-02-24 12:58:24
83ecb7b145644a1489db4137ac4d779bf1f294ca...2b48fcc607010065c0f8107baf669dd41b164f3c,4,55,2,57,6,2013-02-23 22:20:34,2013-02-23 22:20:34
83ecb7b145644a1489db4137ac4d779bf1f294ca...b88abd684041ffa66bfe445e1ac26164e803d488,2,31,2,33,3,2013-02-23 22:20:00,2013-02-23 22:20:00
cc53d9b30bd73c12413c28101d5db9f9f4df517c...48dc0cbf2a97dde2d34f3785f4582e2a54295d26,2,4,4,8,3,2013-02-23 17:54:54,2013-02-23 17:54:54
cc53d9b30bd73c12413c28101d5db9f9f4df517c...5ae0c933a8572c173401386f9037901e6b5fff2b,3,10,26,36,14,2013-02-23 17:43:34,2013-02-23 17:42:53
5ae0c933a8572c173401386f9037901e6b5fff2b...f368c25f10f3dd3031f16b147dd814ba098884f5,1,4,4,8,5,2013-02-23 17:47:36,2013-02-23 17:47:36
2add24cc2c605a51695258d45d6d1b61556dec9f...bb998c9fecb31db875418efb0b46a20bfa2ddea7,1,1,1,2,1,2013-03-06 17:12:42,2013-03-06 17:12:42
c31a9793c62457a68217326e9dfded8f0fb38d96...e2ee02c5bd412a6a1b33353cac1a222be989d71f,2,13,4,17,3,2013-03-07 00:38:44,2013-03-01 05:01:25
e2ee02c5bd412a6a1b33353cac1a222be989d71f...25ce177e66fb0e88a39806f5a493e03f1801775a,1,3,0,3,1,2013-03-07 13:53:52,2013-03-07 13:53:52
25ce177e66fb0e88a39806f5a493e03f1801775a...4cccb85e292fea01b3459cd97d751ed35179a7b7,6,50,30,80,33,2013-03-07 14:22:03,2013-03-07 08:21:59
db278c3bf9177043c42a9ed8b529a5c117938460...11ded967c443087487f3872aafd86842608b4c64,25,2920,2786,5706,41,2012-12-28 19:06:12,2012-12-28 19:00:11
11ded967c443087487f3872aafd86842608b4c64...37b3fd27ae63001cb3258f7d147aeb24712d00a2,1,13,5,18,1,2012-12-28 20:43:34,2012-12-28 20:42:58
37b3fd27ae63001cb3258f7d147aeb24712d00a2...e9c24bef74e55729b190cf07e0ac452aa4c86fcd,5,48,4,52,9,2012-12-28 22:34:54,2012-12-28 22:16:13
e9c24bef74e55729b190cf07e0ac452aa4c86fcd...2d0b35d2bb0829aac2aeae55a27611cb1f64a138,1,27,27,54,27,2012-12-29 10:30:12,2012-12-29 10:30:12
2d0b35d2bb0829aac2aeae55a27611cb1f64a138...ba4331f1775ef4dd2895b3592092973e24db3c25,1,6,3,9,2,2012-12-29 14:25:24,2012-12-29 14:25:24
ba4331f1775ef4dd2895b3592092973e24db3c25...13a2b11425f87f674f0273af5fa70c1e4cf327ed,2,9,5,14,4,2012-12-29 14:30:17,2012-12-29 14:30:17
13a2b11425f87f674f0273af5fa70c1e4cf327ed...067505ad19f088e8db1d8c788ceea388c7241bcd,30,164,158,322,93,2012-12-29 20:54:33,2012-12-29 15:35:12
067505ad19f088e8db1d8c788ceea388c7241bcd...fb9f1b9bfb7378027adfe916733c701a89f8bb24,3,12,100,112,13,2012-12-29 20:58:12,2012-12-24 21:32:41
fb9f1b9bfb7378027adfe916733c701a89f8bb24...59ddb79e9090f8609f9125379db08adc95d507c0,2,0,14,14,2,2012-12-29 20:58:12,2012-12-24 21:36:44
59ddb79e9090f8609f9125379db08adc95d507c0...02f3daadd6c4f4ae2ab4f37c6e4c523f438c205e,3,1,41,42,5,2012-12-29 20:58:12,2012-12-24 21:43:28
02f3daadd6c4f4ae2ab4f37c6e4c523f438c205e...052271168bc8f46c64451340d39682d5efdef9b6,31,0,1120,1120,31,2012-12-29 20:58:12,2012-12-24 21:46:34
052271168bc8f46c64451340d39682d5efdef9b6...d4ea02b9929eca32887efe773a8e6a717590b055,5,2,559,561,9,2012-12-29 20:58:12,2012-12-24 21:55:11
d4ea02b9929eca32887efe773a8e6a717590b055...b2d20e982627b8c5f21fe68c5531b40ee20f1cfc,3,21,52,73,14,2012-12-29 20:58:12,2012-12-24 21:57:49
b2d20e982627b8c5f21fe68c5531b40ee20f1cfc...f27a4ee3270bd57299ce02d622978ac4d839137e,304,49,257012,257061,195,2012-12-29 20:59:06,2012-12-24 22:10:40
f27a4ee3270bd57299ce02d622978ac4d839137e...ebd25985962bd1466257385abcf7e8fc0df9ca0f,11,2,322,324,12,2012-12-29 20:59:07,2012-12-24 22:14:06
ebd25985962bd1466257385abcf7e8fc0df9ca0f...59351247bd635c55bb72a156d71f0d3a27563a67,1,0,17,17,1,2012-12-29 20:59:07,2012-12-24 22:15:45
59351247bd635c55bb72a156d71f0d3a27563a67...d1c72d9e01d55dae8c293b28ec6a1c95070c8326,2,0,134,134,3,2012-12-29 20:59:07,2012-12-24 22:18:50
d1c72d9e01d55dae8c293b28ec6a1c95070c8326...4a6490a4a0d0d7e45b1f549e3f9d97e5e2aeb731,3,2,29,31,4,2012-12-29 20:59:07,2012-12-24 22:20:38
4a6490a4a0d0d7e45b1f549e3f9d97e5e2aeb731...641acf76e706dcff0932b0825f1acbde715cc2c4,3,0,38,38,3,2012-12-29 20:59:07,2012-12-24 22:22:33
641acf76e706dcff0932b0825f1acbde715cc2c4...5d5e1f5afa4b2c0b0a0ead37741ef7778187a48c,2,0,29,29,2,2012-12-29 20:59:07,2012-12-24 22:24:23
5d5e1f5afa4b2c0b0a0ead37741ef7778187a48c...e00d1b6dc66524bf8d26c608e50e1e442a3bf5d0,3,0,43,43,3,2012-12-29 20:59:07,2012-12-24 22:27:17
e00d1b6dc66524bf8d26c608e50e1e442a3bf5d0...9f9a4cdecdea16c202292e9dee2444827abfae3a,2,0,40,40,3,2012-12-29 20:59:07,2012-12-24 22:29:24
9f9a4cdecdea16c202292e9dee2444827abfae3a...2ecf56ea3f86cde1caaf4b21a807440d3870dcf0,3,13,91,104,15,2012-12-29 20:59:07,2012-12-24 22:43:34
2ecf56ea3f86cde1caaf4b21a807440d3870dcf0...130829334c32f48b9ba6e6251d0e780c0d99cd4d,1,0,18,18,1,2012-12-29 20:59:07,2012-12-24 22:44:47
130829334c32f48b9ba6e6251d0e780c0d99cd4d...ef017a5f00d9e84059e00e8fea123be51b293f75,12,24,23,47,23,2012-12-29 20:59:07,2012-12-25 20:07:27
ef017a5f00d9e84059e00e8fea123be51b293f75...7ee7599ab389129c539f62b8295fcf1128defa13,49,60,410,470,154,2012-12-29 20:59:08,2012-12-26 20:47:29
7ee7599ab389129c539f62b8295fcf1128defa13...4e5369a5962e59877ade8975620d73485061a706,3,44,21,65,12,2012-12-29 21:32:07,2012-12-29 21:19:47
db278c3bf9177043c42a9ed8b529a5c117938460...cb988061017146abfb7a663ddecc7ecec1742f7c,1,1,1,2,1,2012-12-27 19:37:12,2012-12-27 19:37:12
c64b57d16688025b2d48668d5c4cb9eda7484612...55972ee5c799c75f2d3a320a46297076aaae614a,3,25,5,30,7,2012-12-18 08:56:30,2012-12-18 08:56:30
a7b7d6320c6838e884778c92a0d478b6df980628...a04df803a590c5bffd9437d9199bc0107ba0e966,4,30,27,57,13,2012-12-29 23:52:50,2012-12-29 23:52:50
a04df803a590c5bffd9437d9199bc0107ba0e966...9ef3cab40b1806d99172e94954976413f860a476,2,8,5,13,6,2012-12-30 09:18:25,2012-12-16 22:43:33
9ef3cab40b1806d99172e94954976413f860a476...4511aeb6b8b843ee913fb43a37c9686980210948,5,91,100,191,18,2012-12-30 09:19:19,2012-12-17 15:09:07
4511aeb6b8b843ee913fb43a37c9686980210948...68985db48212c701a3d975636123a5d79bdc006f,2,37,61,98,8,2012-12-30 09:19:35,2012-12-17 12:02:41
68985db48212c701a3d975636123a5d79bdc006f...807eff74396faba24ad420236d83e9716feffe1e,1,1,2,3,1,2012-12-30 09:20:13,2012-12-20 21:54:31
807eff74396faba24ad420236d83e9716feffe1e...ce3c71faf1ff83494193b48a6f99256d0628b2a2,2,4,6,10,4,2012-12-30 09:20:27,2012-12-21 18:07:13
ce3c71faf1ff83494193b48a6f99256d0628b2a2...f80a1934cdb465c70ecc215fdf867e555a670623,1,4,17,21,5,2012-12-30 10:10:15,2012-12-30 10:10:15
f80a1934cdb465c70ecc215fdf867e555a670623...cee40c7d79930ff42bde4730f43e68a624e47b0f,3,45,11,56,10,2012-12-31 05:33:21,2012-12-31 05:33:21
cee40c7d79930ff42bde4730f43e68a624e47b0f...d11038acb2ea2f59a1d00a41b553f578b5f2c59c,2,5,0,5,2,2012-12-31 09:18:59,2012-12-31 09:18:59
d11038acb2ea2f59a1d00a41b553f578b5f2c59c...a53c4740268721036a6b3bc73f5e8f557c18bac0,1,11,0,11,1,2012-12-31 11:45:20,2012-12-30 14:08:06
a53c4740268721036a6b3bc73f5e8f557c18bac0...acc5396e6d0ac49ae9dc6abc08903b81e6553199,9,111,20,131,19,2012-12-31 11:47:34,2012-12-30 14:19:22
acc5396e6d0ac49ae9dc6abc08903b81e6553199...9180146d21cf2a31eec994b4adc0e50c7120f17f,5,137,28,165,20,2012-12-31 17:34:08,2012-12-31 17:34:08
9180146d21cf2a31eec994b4adc0e50c7120f17f...3570ff734e93f493e023b912c9a97101f605f7f5,1,4,2,6,1,2012-12-31 22:40:02,2012-12-31 22:40:02
3570ff734e93f493e023b912c9a97101f605f7f5...bacb097ac31af2479c43934747b34fad7c91f55c,4,11,15,26,11,2013-01-01 09:14:11,2013-01-01 09:12:06
bacb097ac31af2479c43934747b34fad7c91f55c...3aa4b8165da23a2f094d0eeffacbda5484f4c1f6,3,28,1,29,5,2013-01-01 10:54:56,2012-12-13 16:26:34
3aa4b8165da23a2f094d0eeffacbda5484f4c1f6...cf7afeb2d18b22f857a35d5cb698e2c180aadd2f,1,2,2,4,1,2013-01-01 11:24:02,2013-01-01 11:24:02
4db2752e28668ed8826b770ef2ed26e8c1562db6...dc8f95b639f9ebe65d2188cb3e4f04f9fd68e384,6,403,22,425,9,2013-09-20 22:21:49,2013-09-20 22:21:49
37faf12e66a74642d73639569225c95e400bbae2...c82f6c2227f1b86df8726293e8d6d59449b0ab93,2,19,0,19,4,2013-09-12 08:30:45,2013-09-12 08:30:45
c82f6c2227f1b86df8726293e8d6d59449b0ab93...4c5641dd92e5cfa0223f417f30d109ff998b8041,1,4,3,7,1,2013-09-12 09:14:16,2013-09-12 09:14:16
0546794397130b1574a667d57667bd032bff78d3...90e530978d590a5bdcf75525aa03f844766018b8,2,18,4,22,5,2012-11-03 20:06:57,2012-11-03 20:06:57
0546794397130b1574a667d57667bd032bff78d3...3e98d98b69e67f2f72055e4b3204d0486eaeff50,1,4,0,4,1,2012-11-03 19:12:24,2012-11-03 19:07:56
3e98d98b69e67f2f72055e4b3204d0486eaeff50...973f539ab83bb46645f2f711190735c66a246797,2,21,1,22,3,2012-11-03 20:28:33,2012-11-03 20:26:59
973f539ab83bb46645f2f711190735c66a246797...fc10418fba4fb906e4265650b62c510d526d63f7,14,61,50,111,40,2012-11-03 21:07:35,2012-11-03 20:43:11
fc10418fba4fb906e4265650b62c510d526d63f7...4e8d9524c62d071718a85d1d55a18310be91b4f7,1,0,9,9,1,2012-11-03 22:53:51,2012-11-03 22:53:51
4e8d9524c62d071718a85d1d55a18310be91b4f7...249c3d730e632b3c5b8c2bf5e6e871d61df15c6c,1,9,0,9,1,2012-11-04 10:32:53,2012-11-04 10:32:53
249c3d730e632b3c5b8c2bf5e6e871d61df15c6c...4285571c5a9bf6ca3cb7c4d774942b9ae5b537e4,12,121,40,161,27,2012-11-04 18:16:06,2012-11-04 18:16:06
723c9a8c6db60108f584972498fa6bbd3b408444...141e6cd2acf62af895ca3d5db7b034fbb1273621,1,1,1,2,1,2012-08-30 10:45:11,2012-08-30 10:45:11
141e6cd2acf62af895ca3d5db7b034fbb1273621...36df198e4b2f03102389e6e8aa08365c0d0bd974,1,1,3,4,2,2012-08-30 11:44:41,2012-08-30 11:04:57
36df198e4b2f03102389e6e8aa08365c0d0bd974...ae88e73fa630694a152b54df68d53ce535312e45,17,56,56,112,54,2012-08-30 13:46:16,2012-08-29 20:40:51
ae88e73fa630694a152b54df68d53ce535312e45...fb3d916c201d5882098bbcc94f60765412ba7aff,2,9,8,17,3,2012-08-30 13:51:13,2012-08-30 13:51:13
fb3d916c201d5882098bbcc94f60765412ba7aff...879b245baa727090e242c482a8f12ee52f169642,2,18,2,20,3,2012-08-30 17:28:13,2012-08-30 17:28:13
879b245baa727090e242c482a8f12ee52f169642...a9a773ff38a9fd28085e8b62b8a160c4e2ea5efb,2,15,7,22,5,2012-08-30 17:36:05,2012-08-30 17:36:05
a9a773ff38a9fd28085e8b62b8a160c4e2ea5efb...f698b973eaaf88bb5fb4bf263471305614d6c962,1,4,2,6,1,2012-08-30 20:16:28,2012-08-30 20:16:28
f698b973eaaf88bb5fb4bf263471305614d6c962...17d57275f991f001fbdbf4a85159244096f43499,1,1,1,2,1,2012-08-31 02:19:11,2012-08-31 02:19:11
723c9a8c6db60108f584972498fa6bbd3b408444...06b1dedae55167cbfeeab338773979b015cafbfd,1,1,1,2,1,2012-08-30 00:09:47,2012-08-30 00:09:47
03ad7d3c2085fa252e7bf6a725fec1ed3d1e6a7c...cc9b767fc60a8b0455a67f00ca23077b55e709bb,3,19,1,20,3,2012-09-04 07:27:28,2012-09-04 07:24:39
cc9b767fc60a8b0455a67f00ca23077b55e709bb...22f85b9057825b5b4139abf5fd7e8c4ba0d16981,2,21,0,21,4,2012-09-04 07:41:12,2012-09-04 07:41:12
22f85b9057825b5b4139abf5fd7e8c4ba0d16981...51ee8507767c72807ad1e4e9982f5bef0e4413a5,1,3,1,4,2,2012-09-04 20:27:58,2012-09-04 20:27:58
51ee8507767c72807ad1e4e9982f5bef0e4413a5...4193a0f3d581c973542a2c72f2175d3b938b035d,1,5,5,10,5,2012-09-04 20:47:45,2012-09-04 20:47:38
03ad7d3c2085fa252e7bf6a725fec1ed3d1e6a7c...813241f65562bc0e7f20264238424d82bee2febc,1,2,2,4,2,2012-09-03 14:20:05,2012-09-03 14:20:05
813241f65562bc0e7f20264238424d82bee2febc...a7d831a3056449b2aca88492031be8cedef58f87,1,2,2,4,2,2012-09-03 15:31:37,2012-09-03 15:31:37
909873060ca63eed855de219131a32454558980b...8f7276b782e4e10f3e361f9d833f4e415e70bb28,3,18,18,36,18,2013-04-25 08:35:51,2013-04-25 08:32:27
8f7276b782e4e10f3e361f9d833f4e415e70bb28...86243d2e57e450b52ae063d23653e74bf9b85e4d,1,1,5,6,1,2013-04-25 16:41:57,2013-04-25 16:41:57
86243d2e57e450b52ae063d23653e74bf9b85e4d...5a5e1ac24d3fedca3c3f085b1bd9b13ebbef2d45,1,2,3,5,2,2013-04-25 16:42:08,2013-04-25 16:42:08
5a5e1ac24d3fedca3c3f085b1bd9b13ebbef2d45...6bccbc05a443b97e8651a36df10de6ac5283aee4,1,1,1,2,1,2013-04-25 17:22:16,2013-04-25 17:22:16
6bccbc05a443b97e8651a36df10de6ac5283aee4...4769db6b5fddaed93a8d8d03d0c36f7262e9ac8b,2,9,1,10,2,2013-04-26 06:59:34,2013-04-26 06:57:39
4769db6b5fddaed93a8d8d03d0c36f7262e9ac8b...4ff682c1ba1cd051243842bbd2feb19e75b559f3,1,2,0,2,1,2013-04-28 08:47:07,2013-04-28 08:47:07
4ff682c1ba1cd051243842bbd2feb19e75b559f3...f7f69cf7dd2730f3cf07f8dc71fc60b6c15bbf64,1,2,1,3,1,2013-04-28 13:10:59,2013-04-28 13:09:22
f7f69cf7dd2730f3cf07f8dc71fc60b6c15bbf64...90fe9141ded9f7005546e9a66f31fd196f60e7e4,4,27,2,29,5,2013-04-28 14:45:05,2013-04-28 14:45:05
90fe9141ded9f7005546e9a66f31fd196f60e7e4...3a4276ffc35326f20e95890b50a67aebeabc9ad0,2,19,2,21,4,2013-04-28 15:15:41,2013-04-28 15:15:41
3a4276ffc35326f20e95890b50a67aebeabc9ad0...b47b0211f52dad9d816db587a33f2d7055a226b3,6,6,6,12,6,2013-04-29 15:21:37,2013-04-29 13:30:51
b47b0211f52dad9d816db587a33f2d7055a226b3...1267d2d9bc8bbb38406a676de31c861ec40b5567,7,14,14,28,12,2013-04-29 17:40:43,2013-04-29 17:40:03
a7e2835276b212425dc07251c833b406304ab1a4...7264e5c66110b6748b1d40ee3b0d511c71f3232f,2,40,15,55,12,2013-05-19 11:29:38,2013-05-19 09:44:34
7264e5c66110b6748b1d40ee3b0d511c71f3232f...6a479955f0dcb37e04593bda715fd5f13c1f1106,1,1,0,1,1,2013-05-19 11:29:49,2013-05-19 10:22:40
6a479955f0dcb37e04593bda715fd5f13c1f1106...1d543949d7acc93a172e8a2c9272d8b983a421ef,1,15,2,17,13,2013-05-19 11:30:01,2013-05-19 10:42:44
1d543949d7acc93a172e8a2c9272d8b983a421ef...08b501e7d314e9c45dd51d3ba27b2ecb0287df3b,8,136,48,184,56,2013-05-19 11:31:45,2013-05-19 09:15:35
08b501e7d314e9c45dd51d3ba27b2ecb0287df3b...1fe587d80bfcf062a94252fb532c8ac035c833b9,2,55,12,67,32,2013-05-19 11:35:19,2013-05-19 10:42:35
a7e2835276b212425dc07251c833b406304ab1a4...660762681cfbd8cabce0b6c83fae5b3b60c0d60c,12,124,41,165,12,2013-05-19 11:18:35,2013-05-18 15:43:21
3d883e8bd96df8f2166aec6331b80781463539a6...7882c3a67377de7eed7f52a0b91a0a12b2e32655,1,4,5,9,2,2013-05-31 08:17:34,2013-05-31 08:16:06
7882c3a67377de7eed7f52a0b91a0a12b2e32655...f513764e72faf6bd4be1f063d2842cd4e5d76f7d,1,3,4,7,1,2013-05-31 11:43:05,2013-05-31 11:43:05
f513764e72faf6bd4be1f063d2842cd4e5d76f7d...646a2216e97a581314c9a2598d481b9e954f2e47,1,9,2,11,2,2013-05-31 12:07:40,2013-05-31 12:07:40
646a2216e97a581314c9a2598d481b9e954f2e47...f10e9af22759cc287a967bba02c75d2834761f1e,1,3,1,4,2,2013-05-31 12:18:29,2013-05-31 12:18:29
f10e9af22759cc287a967bba02c75d2834761f1e...23e1b59cf2ad6a75637dd0273973e657e48e317e,2,32,8,40,7,2013-05-31 16:48:51,2013-04-16 18:49:22
23e1b59cf2ad6a75637dd0273973e657e48e317e...5090c7b58bd3c774daf17a13d7408968f0ee8da0,1,1,1,2,1,2013-05-31 17:16:54,2013-05-02 10:55:47
5090c7b58bd3c774daf17a13d7408968f0ee8da0...fa7cb4ef3cc5f4c3514857bd25b43d31815eba94,2,26,2,28,4,2013-05-31 21:04:06,2013-05-13 16:38:29
fa7cb4ef3cc5f4c3514857bd25b43d31815eba94...84909377f2f2eea07ab8bf398dafc69e2d736b50,1,11,0,11,1,2013-05-31 21:28:44,2013-05-31 21:26:16
84909377f2f2eea07ab8bf398dafc69e2d736b50...369b6fab25b55ceb363ba2a8cb7e0f1a88ef8f8d,5,30,2,32,5,2013-05-31 21:59:04,2013-05-30 07:25:58
369b6fab25b55ceb363ba2a8cb7e0f1a88ef8f8d...de66b56790598f2ff97b8df859356d755ce64e20,2,26,2,28,3,2013-06-01 08:26:46,2013-06-01 08:26:46
de66b56790598f2ff97b8df859356d755ce64e20...f315693304865162d0b1bb8f913e9c5f14fb351e,1,1,1,2,1,2013-06-01 09:48:38,2013-06-01 09:48:38
f315693304865162d0b1bb8f913e9c5f14fb351e...02fd87c821e02864cd14130350c6fd50e9f974db,9,48,50,98,40,2013-06-01 10:06:36,2013-06-01 10:06:36
02fd87c821e02864cd14130350c6fd50e9f974db...5442fe46da0a11227b5a361a10cf9fbb1ae5a85e,1,176,1,177,11,2013-06-01 10:10:48,2013-06-01 10:10:48
5442fe46da0a11227b5a361a10cf9fbb1ae5a85e...fffb55860e608bb1f2bcec238771bdb4c7e52626,1,2,2,4,1,2013-06-01 10:31:25,2013-06-01 10:31:25
fffb55860e608bb1f2bcec238771bdb4c7e52626...127d9b2792131995caf87c16b73dbd61f360de2a,1,1,2,3,1,2013-06-01 11:08:13,2012-11-07 16:23:16
127d9b2792131995caf87c16b73dbd61f360de2a...07a73a2714a504ae487112c1679977fccc19b159,1,2,4,6,2,2013-06-01 11:55:49,2013-04-30 20:28:09
07a73a2714a504ae487112c1679977fccc19b159...61524b09cfa3b51643d0e79cbf0e1e08ede357ae,5,47,5,52,13,2013-06-01 22:20:54,2013-06-01 22:16:57
61524b09cfa3b51643d0e79cbf0e1e08ede357ae...590a41164e558fec8b54399d296c67dfffce6970,3,32,29,61,17,2013-06-02 04:32:29,2013-06-02 04:32:29
590a41164e558fec8b54399d296c67dfffce6970...09d0568697cf5f82737816cf8041a6c270861a7d,1,2,6,8,3,2013-06-02 17:31:38,2013-06-02 17:31:02
09d0568697cf5f82737816cf8041a6c270861a7d...b55624a0263e31be80fbe7bb51e47ccd253e7a5d,2,22,2,24,4,2013-06-02 18:39:45,2013-06-02 08:13:54
b55624a0263e31be80fbe7bb51e47ccd253e7a5d...51aa000378c00a442273f01142acdebc94dec68d,2,167,141,308,25,2013-06-02 18:39:45,2013-06-02 08:40:54
51aa000378c00a442273f01142acdebc94dec68d...164c67c831c0d71ff30e7a4d1c5f5e6ed0d2f178,1,4,4,8,1,2013-06-03 07:59:20,2013-06-03 07:59:20
164c67c831c0d71ff30e7a4d1c5f5e6ed0d2f178...6900cb79dcbc502e0b18476e53ad493b7069ffb8,1,1,1,2,1,2013-06-03 09:48:03,2013-06-03 09:48:03
6900cb79dcbc502e0b18476e53ad493b7069ffb8...c9d07d251fc68fe1a80c2a49e183bbef546238d9,2,3,2,5,3,2013-06-03 11:18:16,2013-06-03 11:18:16
c9d07d251fc68fe1a80c2a49e183bbef546238d9...c36b75c814f068fcb722d46bd5e71cbaddf9bf2d,4,0,13,13,13,2013-06-03 14:06:48,2013-06-03 14:06:48
c36b75c814f068fcb722d46bd5e71cbaddf9bf2d...4f4e9243e4cf585e32a882804084853108ef94c0,3,7,7,14,7,2013-06-03 17:30:40,2013-05-30 17:39:54
7ccbe6a4fa62c2f3f250d12e70b7db1abfa085d2...cd1ca26702005c51dbcbeea593650b939cb2d3eb,3,7,3,10,7,2013-04-04 02:42:31,2013-04-04 02:42:31
9191ce6643fd3852d77ad033b24ae8cdd6f418f8...2c27300f343df2bae0db0f4c3594e5ae5b0b219f,2,3,1,4,2,2013-04-04 16:12:12,2013-04-04 16:12:12
e081601f6e81e0c41e66200753c348a5009c3ccf...ec04fd1344bda8067404b720ce48b01eb3546c6e,8,13,13,26,13,2013-03-28 17:16:53,2013-03-28 17:16:53
6cb6e1128f090d5edde9918ba2ae79c1e38b65ad...a61dbd62193d036d082fdad4d1af3b48ebec4fb3,1,3,2,5,2,2013-02-23 15:00:23,2013-02-23 15:00:23
a61dbd62193d036d082fdad4d1af3b48ebec4fb3...f49e9a517f2fdc1d9ed7ac841ace77636cbd6747,6,173,31,204,33,2013-02-23 15:16:39,2013-02-23 14:07:21
f49e9a517f2fdc1d9ed7ac841ace77636cbd6747...9e959e8d588d20988522200ad205e335e681c168,1,3,2,5,3,2013-02-23 15:35:22,2013-02-23 15:35:22
9e959e8d588d20988522200ad205e335e681c168...8d17114899256ef4033cd17645f90975ddf5628b,2,11,11,22,8,2013-02-23 15:40:19,2013-02-23 15:40:19
722683f508566cf06bcc85f9f1810c3cde80344c...5612f54bd56086e2a375e86474ec734c172e7d1f,1,92,6,98,4,2013-02-24 09:58:03,2013-02-23 18:11:56
99edbe0e279166db82caaf545ef92d5446a6a07e...c7294614795a3c0b3a872707bbea93733ef2077d,2,29,2,31,6,2013-02-24 15:40:51,2013-02-24 14:54:09
99edbe0e279166db82caaf545ef92d5446a6a07e...bc787f6a3222c2d425d96dea57a1516b31677bf5,6,7,7,14,7,2013-02-24 14:16:45,2013-02-24 14:16:45
99edbe0e279166db82caaf545ef92d5446a6a07e...8c8f94fe9dcdd4983ebeb59951e6f7399bc287a2,5,41,16,57,9,2013-02-24 13:43:45,2013-02-24 13:43:45
0a341ab40dd35cd97127a4ebd77e0bfe3b21fafa...bfd4a71d419c9c811b0f1db5b2734153f7b8e3ed,1,2,4,6,2,2013-02-23 18:27:37,2013-02-23 18:27:37
bfd4a71d419c9c811b0f1db5b2734153f7b8e3ed...98ab8e8876e130de24e1de9473a4db716d5b002e,2,21,14,35,4,2013-02-23 18:31:17,2013-02-23 18:28:17
98ab8e8876e130de24e1de9473a4db716d5b002e...e3296268de8f2c387c4155ae1b8d39bb109f265d,2,281,0,281,2,2013-02-23 18:35:38,2013-02-23 18:33:57
c8e3a23d0f6d6683c7d5d4f4107b0c716b879cf0...0ea5bf88dddd7fbdef7fe8d00162c9753565f5c0,3,24,4,28,3,2013-03-07 00:13:12,2013-03-07 00:00:05
0ea5bf88dddd7fbdef7fe8d00162c9753565f5c0...876fc3912881e15eda2b02c3b4933af313d0a498,2,27,16,43,23,2013-03-07 00:14:46,2013-03-07 00:09:36
4cccb85e292fea01b3459cd97d751ed35179a7b7...bbbd698c7a4dd19e6394660bece7e6e907b0a824,5,65,22,87,33,2013-03-07 19:24:51,2013-03-07 19:24:51
bbbd698c7a4dd19e6394660bece7e6e907b0a824...1b81f328f4fb74d35a8397385fbc18aef03ac297,1,4,0,4,2,2013-03-07 20:05:06,2013-03-07 20:05:06
4cccb85e292fea01b3459cd97d751ed35179a7b7...81804ae474d6fe5d3ab9348cfe86ee3779473a2a,2,38,4,42,11,2013-03-07 18:30:38,2013-02-25 21:53:14
a991b01167ea187f8b1e249f7d5a56d26440e386...11187386f466075f37cf69a0e99a341c30cdf7ef,1,68,34,102,11,2013-09-21 15:41:26,2013-09-21 08:07:10
a991b01167ea187f8b1e249f7d5a56d26440e386...43a2ec7999dcb0c9b09552b9b44741e89f87bc33,2,9,0,9,2,2013-09-21 10:42:11,2013-09-21 03:54:48
4c5641dd92e5cfa0223f417f30d109ff998b8041...018037736fe575307f5331ebb4b126a0c886ecef,1,1,2,3,3,2013-09-12 18:32:23,2013-09-12 18:32:23
4285571c5a9bf6ca3cb7c4d774942b9ae5b537e4...d94dc2d1fa190d202d19a351f00a6b42e670fecb,1,19,19,38,1,2012-11-04 18:29:10,2012-11-04 17:52:37
4193a0f3d581c973542a2c72f2175d3b938b035d...b791fda0dfd689a1514a1a2a55d60e0baa57a107,1,1,1,2,1,2012-09-05 10:50:23,2012-09-05 10:46:21
3f53cac520d6a4f87b7b8e45eeb06921a58c515f...5262a288df07daa050a0e17669c3f103f47a8640,1,0,18,18,1,2012-09-06 03:02:33,2012-09-06 03:02:33
5262a288df07daa050a0e17669c3f103f47a8640...ee1b3e2a3a50e29254a91cf9f4de2996701ccee0,1,1,1,2,1,2012-09-06 11:00:16,2012-09-06 11:00:16
ee1b3e2a3a50e29254a91cf9f4de2996701ccee0...39aa8901e11f07627958ad624146bffe0e1d05a3,1,18,18,36,18,2012-09-06 21:08:15,2012-09-06 21:07:14
1267d2d9bc8bbb38406a676de31c861ec40b5567...cee96b87c04d365c7649726da86d86cb655b05da,1,2,2,4,1,2013-04-30 16:38:59,2013-04-30 16:38:59
3d5a546254b357ad27d5465700945e2bc472c3bc...1927bf7c91761040a7e46197fc2d19b66f2ae332,1,3,3,6,3,2013-05-19 11:39:21,2013-05-19 11:39:21
4f4e9243e4cf585e32a882804084853108ef94c0...0fd9f7c95f748764867dc148a2bacef807466d85,6,88,30,118,13,2013-06-05 21:08:00,2013-06-04 21:35:11
4f4e9243e4cf585e32a882804084853108ef94c0...54485557855d58d9a5027511025d5ab22f721c6d,2,8,3,11,3,2013-06-04 11:46:10,2013-06-04 11:31:06
5ac7f777cde6cdabee8c804fd8c71c4fd5f71d3c...df3d7e66daedc2d4be8b7ca2f5046ac80e0297f8,3,4,4,8,4,2013-07-07 23:48:56,2013-07-07 23:48:12
df3d7e66daedc2d4be8b7ca2f5046ac80e0297f8...0b69a755029f8a8ba6005b9d77be8132a7bc0fb3,1,7,0,7,2,2013-07-08 00:32:04,2013-07-08 00:32:04
0b69a755029f8a8ba6005b9d77be8132a7bc0fb3...03d9566e0df45c72bffa99fe244a92f0279da56f,48,382,194,576,288,2013-07-08 00:39:54,2013-07-08 00:39:54
272d62e1dab8cce97aeec66469785922a0d0ad3d...5c771da3abddb99fe5740440aa5c815ca04afad0,1,0,1,1,1,2013-04-04 19:42:44,2013-04-04 19:42:44
5c771da3abddb99fe5740440aa5c815ca04afad0...ce23e33399a8a21a87de94bfbf12ae57f833b52c,1,0,4,4,1,2013-04-04 20:03:45,2013-04-04 20:03:45
ef348b52983069e3b39075dcdbe8f09a95586b3c...86b1c316899f154b1800ab936330ac8924251e40,3,8,7,15,6,2013-03-28 19:08:37,2013-03-28 19:00:59
86b1c316899f154b1800ab936330ac8924251e40...ae5247cb51635aa3abfe969acf2216969f961a5a,2,29,0,29,2,2013-03-28 20:03:19,2013-03-28 20:02:35
ae5247cb51635aa3abfe969acf2216969f961a5a...e301ea3efb9b59a86c35bc7dcd51b0794212ebdd,1,63,36,99,17,2013-03-28 21:10:11,2013-03-28 21:10:11
e301ea3efb9b59a86c35bc7dcd51b0794212ebdd...d85d393500ae93a40aa6f1251f249e979b91a4d5,1,10,7,17,4,2013-03-28 21:31:05,2013-03-28 21:31:05
d85d393500ae93a40aa6f1251f249e979b91a4d5...e5d252f5b9bc586a61113943f13e8fe6147d9e3d,1,2,2,4,2,2013-03-28 21:44:26,2013-03-28 01:51:44
e3296268de8f2c387c4155ae1b8d39bb109f265d...799be90fde8a7b77b3876eb593751e410c718d1f,1,22,18,40,15,2013-02-23 19:01:52,2013-02-23 19:01:52
799be90fde8a7b77b3876eb593751e410c718d1f...31bcb102b24338e5cc0e69ade997e8fdc257b6b5,1,4,2,6,1,2013-02-23 20:21:35,2013-02-23 20:21:35
31bcb102b24338e5cc0e69ade997e8fdc257b6b5...9b97f01dea093de484366924842c89550472d0b6,1,3,1,4,1,2013-02-23 20:26:41,2013-02-23 20:26:41
e3296268de8f2c387c4155ae1b8d39bb109f265d...539900f117dce5d9b51e2b9e8ff225c423060d52,5,42,13,55,8,2013-02-23 18:41:33,2013-02-23 18:41:33
477d737e1e6bdf93950c8a381906925c594fac2f...6983a1a540a6e6c3bd941fa15ddd8cb49f9ec74e,46,588,284,872,257,2013-03-08 15:11:45,2013-03-08 14:15:23
6983a1a540a6e6c3bd941fa15ddd8cb49f9ec74e...cbfb8ed53b31ec9701f5fb8e519a8644fd4c8095,2,33,2,35,2,2013-03-08 17:19:24,2013-03-08 17:16:38
cbfb8ed53b31ec9701f5fb8e519a8644fd4c8095...8a92139d8a5c2ecb4a7a55da74d293c71390e9ed,1,8,7,15,5,2013-03-08 21:52:41,2013-03-08 21:41:16
8a92139d8a5c2ecb4a7a55da74d293c71390e9ed...5e80571bf92d93c177bea9e5ee7d89153ecadbad,5,34,6,40,11,2013-03-09 11:02:22,2012-09-21 18:22:54
5e80571bf92d93c177bea9e5ee7d89153ecadbad...6a91b638423de954b7d96c38e2372100800139fb,3,24,7,31,8,2013-03-09 11:38:45,2013-03-09 11:38:45
6a91b638423de954b7d96c38e2372100800139fb...f3d1aebed1f72fc150e03aba18cc5bc56de6f5c4,1,25,19,44,13,2013-03-09 14:08:16,2013-03-09 14:08:16
f3d1aebed1f72fc150e03aba18cc5bc56de6f5c4...e6f5b7eacd32afb892c486a5b0994f7f11170868,4,18,17,35,6,2013-03-09 15:10:28,2013-03-09 15:01:33
e6f5b7eacd32afb892c486a5b0994f7f11170868...360217fc87db82575c8b07704143ced07c2a234c,2,32,12,44,6,2013-03-09 16:46:20,2013-03-09 16:46:20
360217fc87db82575c8b07704143ced07c2a234c...8aefd30379eba9aa7e5afcc69cc352adf0d23489,1,2,0,2,1,2013-03-09 22:39:14,2013-03-09 22:39:14
8aefd30379eba9aa7e5afcc69cc352adf0d23489...63c52dcbcdd47cb1a47662846dfe4e1812d2444c,1,1,1,2,1,2013-03-10 14:57:51,2013-03-10 14:57:51
ec2b91f48b0cea45afd4470a6c1cbb4ea939514f...68b10fa1776f927180dd20f4818b5e6e07537615,1,5,0,5,1,2013-09-21 19:09:25,2013-09-21 19:08:52
43a2ec7999dcb0c9b09552b9b44741e89f87bc33...3ea0194bb4cd42b2d707163b03a96765a35bf03b,1,1,0,1,1,2013-09-21 14:28:05,2013-09-21 14:28:05
e4c6fca6d21f6a6d16bd69d86928270b4d2d38fb...8b366a50f47443947debc327ae9950e3119e05ca,1,6,4,10,4,2013-09-12 22:36:45,2013-09-12 22:34:22
8b366a50f47443947debc327ae9950e3119e05ca...9451d8d558e6dafa4e270c33608a291610ccf77d,2,21,3,24,4,2013-09-13 07:56:19,2013-09-12 13:27:35
9451d8d558e6dafa4e270c33608a291610ccf77d...ad6fcdb8d24d84a130f847f45b51d7e892ccca08,1,3,5,8,5,2013-09-13 11:27:54,2013-09-12 14:04:28
ad6fcdb8d24d84a130f847f45b51d7e892ccca08...c1ec08998d1b690855d5e69a1f4d9d2f01d44ae6,2,7,3,10,3,2013-09-13 12:09:21,2013-09-13 12:08:34
c1ec08998d1b690855d5e69a1f4d9d2f01d44ae6...990ce9aab97802ab7da629be1b0b27ab4bcc8578,2,24,4,28,4,2013-09-13 12:26:46,2013-09-12 23:01:47
990ce9aab97802ab7da629be1b0b27ab4bcc8578...e4aab1bb8db24e226891556f072968625a68abdf,1,6,16,22,6,2013-09-13 13:29:21,2013-09-13 13:28:38
e4aab1bb8db24e226891556f072968625a68abdf...ec89e1725a29076d37b36f85de983b8a7cf7c329,1,6,6,12,1,2013-09-13 13:34:12,2013-09-13 13:34:12
ec89e1725a29076d37b36f85de983b8a7cf7c329...39b49fd33970720b973498d2c8275ced129d3a7a,1,7,2,9,3,2013-09-13 16:42:06,2013-09-13 15:45:42
39b49fd33970720b973498d2c8275ced129d3a7a...6feb75129f42fdac751d0b79a2a005b4c0ad5c2d,6,82,30,112,9,2013-09-14 00:09:41,2013-09-06 23:23:25
6feb75129f42fdac751d0b79a2a005b4c0ad5c2d...c89d80e2cc9bf1f401aa3af4047bdc6f3dc5bfa4,4,13,5,18,4,2013-09-14 06:48:59,2013-09-12 14:03:29
c89d80e2cc9bf1f401aa3af4047bdc6f3dc5bfa4...74b91b3888383fca28dea00e0e1ffb5aecec7c0f,1,12,0,12,1,2013-09-14 07:33:15,2013-09-14 07:33:12
74b91b3888383fca28dea00e0e1ffb5aecec7c0f...886bb9d8780303b4c8f45c55e0ac0a6b644b73af,2,3,7,10,3,2013-09-14 11:19:32,2013-09-14 11:19:32
886bb9d8780303b4c8f45c55e0ac0a6b644b73af...ff723d894d9272ea721d1996432ffc806c2b8180,2,47,22,69,22,2013-09-14 17:52:17,2013-08-21 11:25:19
3e9b36688df22e067eaa77f68a04c7616454ed86...fcd3d4c68f06748c754c08eada526b678741e8c5,3,34,9,43,4,2012-11-04 21:43:54,2012-11-04 21:43:54
fcd3d4c68f06748c754c08eada526b678741e8c5...088f68252d1f3c9e5d51a5ea3ab769397a65859f,1,1,1,2,1,2012-11-04 22:16:32,2012-11-04 22:16:32
3e9b36688df22e067eaa77f68a04c7616454ed86...aee9c7b094cbd36c898ea465269935f156412ab9,1,7,0,7,2,2012-11-04 20:25:48,2012-11-04 20:25:48
aee9c7b094cbd36c898ea465269935f156412ab9...b98083ce3dfc35a3f3732f4873761a3f78e4194f,1,1,4,5,3,2012-11-04 21:58:40,2012-11-04 21:54:54
cff911f4ba3b3e6393c58da5131ce8b188a68f0c...ba141e6906a32683a9a4ae7059351fa951b6470b,1,8,0,8,1,2012-09-06 19:13:31,2012-09-06 19:13:31
ba141e6906a32683a9a4ae7059351fa951b6470b...c65100248ddc4c305487013846b9fd343f7f3078,1,13,1,14,5,2012-09-06 20:08:14,2012-09-06 20:08:14
c65100248ddc4c305487013846b9fd343f7f3078...58786897a1e3ef5d31134cb0870a321425d56fea,1,5,5,10,1,2012-09-06 20:10:08,2012-09-06 20:10:08
cff911f4ba3b3e6393c58da5131ce8b188a68f0c...e5983af7c16cc889cf7d52fdae67270717a1a846,1,1,2,3,2,2012-09-05 21:50:17,2012-09-05 21:50:17
39aa8901e11f07627958ad624146bffe0e1d05a3...07b3d39d101ff0465a5084266745b3db143552e9,1,1,1,2,1,2012-09-07 15:49:55,2012-09-07 15:46:53
39aa8901e11f07627958ad624146bffe0e1d05a3...09e3d364b922510f4c14a4d843e59c37304fa1a7,1,4,3,7,1,2012-09-07 15:34:18,2012-09-07 15:34:15
39aa8901e11f07627958ad624146bffe0e1d05a3...7055e20d24638d646457686177be9a60362f1129,1,1,0,1,1,2012-09-07 15:19:12,2012-09-07 15:18:01
39aa8901e11f07627958ad624146bffe0e1d05a3...0e296131bb9c94b9bedee34c2a30774107d1d899,3,7,12,19,7,2012-09-07 14:58:17,2012-09-07 14:58:17
39aa8901e11f07627958ad624146bffe0e1d05a3...c634375e9c47220d272525fcf35ddf4d6989e208,1,2,3,5,1,2012-09-07 14:43:55,2012-09-07 14:43:55
8f08f0afbbdf19574db40158ea8ac5a1a13e7471...ce45240df4e2b424ff4852b1cc71d01a031457c9,1,0,5,5,1,2013-04-30 19:40:16,2013-04-30 19:39:41
ce45240df4e2b424ff4852b1cc71d01a031457c9...a5becad9094e5c5403b692b9a7b3a6ffaabf64a3,6,69,56,125,21,2013-05-01 11:46:06,2013-04-03 10:42:33
a5becad9094e5c5403b692b9a7b3a6ffaabf64a3...780fa48f5fb81b2f0f58de95167abff84a6149aa,1,4,3,7,2,2013-05-01 14:40:49,2013-05-01 14:40:49
780fa48f5fb81b2f0f58de95167abff84a6149aa...6bdeed1b811ddf9a920e925ad05d82cffbf13c3a,1,14,0,14,1,2013-05-01 18:13:44,2013-05-01 18:13:09
6bdeed1b811ddf9a920e925ad05d82cffbf13c3a...9f7a01ef2bed8c0395a970286e8f87fd7d344b3b,29,578,772,1350,577,2013-05-02 14:25:23,2013-05-02 14:16:25
9f7a01ef2bed8c0395a970286e8f87fd7d344b3b...d48b7230a8b8d44607b19749fb4a0a8a25d50cf1,1,24,10,34,8,2013-05-03 07:46:51,2013-05-03 07:46:04
9b22baddef1a6676f82fe7c112894cc8de045334...980ae2ab29cb25182404eb1ccc919573edcc44f5,4,180,60,240,36,2013-05-19 12:36:38,2013-05-19 10:57:06
980ae2ab29cb25182404eb1ccc919573edcc44f5...761bbbbbae0cd930e93ad6340f4213269a7f28ed,1,1,0,1,1,2013-05-19 12:36:38,2013-05-19 12:33:41
761bbbbbae0cd930e93ad6340f4213269a7f28ed...181f2ec603dd01d3c38ff1a57849d5ed1642a4ff,1,6,0,6,2,2013-05-19 12:38:48,2013-05-19 12:38:16
181f2ec603dd01d3c38ff1a57849d5ed1642a4ff...a9b98f59aaff3f7281fedb27563a263dbb7753ec,1,3,2,5,1,2013-05-19 13:24:10,2013-05-19 13:23:11
a9b98f59aaff3f7281fedb27563a263dbb7753ec...f88700d610d69ba5b44ab7b0692f8792aab3b54b,3,12,4,16,5,2013-05-19 13:33:05,2013-05-19 13:25:49
f88700d610d69ba5b44ab7b0692f8792aab3b54b...b06f6c1618a64cbab9a7d09a169c75fdf0a8dda8,1,1,1,2,1,2013-05-19 14:23:14,2013-05-19 14:23:14
d34b1c29e294b19e51a47918125314a1540c01d4...65f9e0affd8ca04e2c597c43c1547ef7c888ec2a,3,70,1,71,4,2013-05-19 12:16:12,2013-05-19 12:15:36
9ed971f4f1d2f05ecf7e2760556259eb2dca85f8...b67f2ac8e6f8cdef237590ffb2c85fc30454ba75,3,14,4,18,8,2013-06-06 12:28:58,2013-06-06 12:27:00
b67f2ac8e6f8cdef237590ffb2c85fc30454ba75...e2518fdf46a687454066b8a75263c9019b1e965d,2,41,2,43,5,2013-06-06 14:01:48,2012-09-28 02:04:40
e2518fdf46a687454066b8a75263c9019b1e965d...80b15113112d7852bc262af47c18cd02ff904492,2,2,2,4,2,2013-06-06 16:05:33,2013-05-27 03:26:27
80b15113112d7852bc262af47c18cd02ff904492...357d62d9f2972bf1bc21e5835c12c849143e06af,2,17,3,20,2,2013-06-06 16:05:33,2013-06-06 16:03:47
687afdaa48681e5c094679e7295d09b36a41b657...e71b63e280559122371d125d75a593dc2435c394,3,13,1,14,5,2013-06-04 14:19:27,2013-06-04 14:19:27
e71b63e280559122371d125d75a593dc2435c394...a35ed202419a054a9125ee6205a1a7b4eb3cb46d,5,102,7,109,8,2013-06-04 16:39:09,2013-06-04 16:37:44
a35ed202419a054a9125ee6205a1a7b4eb3cb46d...b00c6371afab778ab6c6206fb2dbb3f2c7f750b4,2,19,2,21,3,2013-06-05 11:59:59,2013-04-09 16:24:54
b00c6371afab778ab6c6206fb2dbb3f2c7f750b4...bb863faecd3e1d785933bce7cef7e4b4b28dc3d5,8,81,67,148,35,2013-06-05 16:55:58,2013-06-05 16:55:50
bb863faecd3e1d785933bce7cef7e4b4b28dc3d5...8c5b805ca11ff25ffa8a4efd0781efe5cc872de3,1,15,12,27,8,2013-06-05 18:18:56,2013-06-05 18:16:16
8c5b805ca11ff25ffa8a4efd0781efe5cc872de3...31fd64ad8a98d7de0acb9144ae6f7bd124700cb0,3,137,50,187,14,2013-06-05 22:54:46,2013-06-05 21:29:44
03d9566e0df45c72bffa99fe244a92f0279da56f...9aed3201aad270635259b57e6f9fabc0cc11f481,1,3,0,3,1,2013-07-08 04:17:10,2013-07-08 04:17:10
03d9566e0df45c72bffa99fe244a92f0279da56f...43073dbd76a31b3c171877dc2edf9d177a10531f,1,3,3,6,1,2013-07-08 01:18:06,2013-07-08 01:18:06
43073dbd76a31b3c171877dc2edf9d177a10531f...6bdc47f75ca31d607653eebee3a144631df46aae,1,2,2,4,2,2013-07-08 02:44:17,2013-07-08 02:44:17
ce23e33399a8a21a87de94bfbf12ae57f833b52c...17be12df473c24f5b717dd553400971893a9676c,1,1,1,2,1,2013-04-05 05:52:12,2013-04-05 05:52:12
ce23e33399a8a21a87de94bfbf12ae57f833b52c...1aca9d93beaac9f5e37cd90d1e29e572b5f7a86d,1,1,1,2,1,2013-04-04 22:16:16,2013-04-04 22:16:16
c2a045198c1c006cbb6c1e141221e78bdde9a78f...4c05fdb467d1de68348401fc47869e8f35dcc278,1,2,1,3,1,2013-02-23 20:33:43,2013-02-23 20:33:43
4c05fdb467d1de68348401fc47869e8f35dcc278...2cd0edaa477b327024e4007c8eaf46646dcd0f21,2,19,2,21,4,2013-02-23 20:35:27,2013-02-23 19:59:09
2cd0edaa477b327024e4007c8eaf46646dcd0f21...24a2bcbcdd9e76901cd8f8bb38d9d5b6e0bc4fd6,1,10,3,13,1,2013-02-23 20:42:56,2013-02-23 20:42:56
63c52dcbcdd47cb1a47662846dfe4e1812d2444c...b3c6a20e715e9d4735d832adbffc1c274fbc117c,1,1,1,2,1,2013-03-10 18:09:33,2013-03-10 17:51:07
68b10fa1776f927180dd20f4818b5e6e07537615...d8f2d940cce0085420b289fd81c3235c2128a3cc,1,1,1,2,1,2013-09-21 20:34:45,2013-09-21 20:34:45
8d3f932f18c75fcbb32cf3dd5998445d65b5db0f...d5c3c45f2fdfee09d81ad8dc7b0db8338d6d0aae,1,11,0,11,1,2012-11-05 00:35:40,2012-11-05 00:35:40
8d3f932f18c75fcbb32cf3dd5998445d65b5db0f...e44ab5bb4fd3aa826ca4243a8ea9fd7125800da2,2,37,1,38,2,2012-11-04 23:52:05,2012-11-04 23:42:17
8d3f932f18c75fcbb32cf3dd5998445d65b5db0f...957787ace0a14fa2ee2539d47a64b266bc93b6bd,2,6,2,8,3,2012-11-04 23:41:33,2012-11-04 23:41:33
957787ace0a14fa2ee2539d47a64b266bc93b6bd...0a49e6164c78ab6c828c08896856a77e2b423c91,1,1,1,2,1,2012-11-04 23:44:20,2012-11-04 23:44:20
0a49e6164c78ab6c828c08896856a77e2b423c91...5a00a57aa591c766f5ee1d8c59b64618d74fe191,2,15,4,19,4,2012-11-04 23:52:00,2012-11-04 23:46:30
257c4011cb887524048acb8796b130761617d195...335a9f9cf1e2f40679e91cf42cfd0e636885a397,10,31,48,79,25,2012-09-07 19:08:07,2012-09-07 19:06:23
335a9f9cf1e2f40679e91cf42cfd0e636885a397...ad50243cd143906d573b11397fa0fd080c9cd7f1,1,2,1,3,2,2012-09-07 19:33:02,2012-09-07 19:33:02
ad50243cd143906d573b11397fa0fd080c9cd7f1...5999eb42eb6dad6a74c43eb6e9d96ac368ad97b4,1,6,8,14,2,2012-09-07 19:34:48,2012-09-07 19:34:48
4321ee25c5c490b94fa0c6e2da5e0b3df215ff81...292322f977b1844e15ba25d59d1e985461571c15,29,213,196,409,202,2012-09-07 17:17:34,2012-09-07 17:17:09
cceff73acd7d82904a4b9c28dea2448f09c941b0...e1a37d55374a399dee9c302419fbe9badd92abb0,1,13,5,18,5,2012-09-07 15:57:46,2012-09-07 15:57:46
d48b7230a8b8d44607b19749fb4a0a8a25d50cf1...f9f0e8da4d1107575ebee07a808cd254ac3d9dc0,1,4,2,6,2,2013-05-04 08:18:04,2013-05-04 08:08:38
f9f0e8da4d1107575ebee07a808cd254ac3d9dc0...ac9daa0cbdd82a6b3bcaf0cd5874bd7cdb94fc60,2,3,2,5,4,2013-05-04 09:53:12,2013-05-04 09:53:12
ac9daa0cbdd82a6b3bcaf0cd5874bd7cdb94fc60...66c83dce074b48342dbfd0d9039c76b8949f0833,2,18,0,18,4,2013-05-04 10:08:15,2013-05-04 10:08:15
66c83dce074b48342dbfd0d9039c76b8949f0833...f3b3c569e770f8b576aba446847430586486bac6,1,1,1,2,2,2013-05-04 11:29:40,2013-05-04 11:29:40
f3b3c569e770f8b576aba446847430586486bac6...da85c8cf326fa8858bac29f1b92da7972dd88dda,1,2,1,3,1,2013-05-05 13:27:14,2013-05-05 13:27:14
da85c8cf326fa8858bac29f1b92da7972dd88dda...371dbbe6e01f0fd0276998f6d7f78c86b49d2e97,1,8,7,15,3,2013-05-05 13:52:07,2013-05-05 13:52:07
371dbbe6e01f0fd0276998f6d7f78c86b49d2e97...a96bff179a57c6c7fb79585120088f155831a6ae,1,1,1,2,1,2013-05-05 15:01:45,2013-05-05 14:22:25
a96bff179a57c6c7fb79585120088f155831a6ae...86d3079d5797811c1e118cfd600a913685212165,1,1,0,1,1,2013-05-06 10:19:52,2013-05-06 10:19:52
86d3079d5797811c1e118cfd600a913685212165...e88680899490b9ed8b58c88ee78dc189506204c5,1,8,2,10,3,2013-05-06 17:45:24,2013-05-06 17:45:24
e88680899490b9ed8b58c88ee78dc189506204c5...bc02a963db3aeebf7c349d83a492b6e093f42b00,2,15,4,19,4,2013-05-06 17:55:02,2013-05-06 17:55:02
bc02a963db3aeebf7c349d83a492b6e093f42b00...1ad83145dff92117839400e4cfacdfee6473b2a6,1,0,9,9,1,2013-05-07 14:06:15,2013-05-07 05:43:06
1ad83145dff92117839400e4cfacdfee6473b2a6...99a6f0e77c6e02b310687667d41df56c17b953bf,3,20,8,28,6,2013-05-07 19:22:05,2013-05-06 03:32:07
99a6f0e77c6e02b310687667d41df56c17b953bf...d89b421352998020b9a9f2e7c3fd2ab8cc352593,1,1,1,2,1,2013-05-07 23:05:37,2013-05-07 23:05:01
d89b421352998020b9a9f2e7c3fd2ab8cc352593...6c6c67f5a6150ca89bbcfb06561a61d2cd7730cf,1,3,3,6,1,2013-05-07 23:07:29,2013-05-07 23:07:29
6c6c67f5a6150ca89bbcfb06561a61d2cd7730cf...bc46f67fa83a82d48eafc0e3bbd368a3746e3936,1,1,2,3,1,2013-05-08 00:18:42,2013-05-08 00:18:42
d48b7230a8b8d44607b19749fb4a0a8a25d50cf1...291250f7b66a6b81d2fc64eecc82cb2b4bd6c090,2,4,0,4,2,2013-05-03 13:46:53,2013-05-03 13:46:53
b06f6c1618a64cbab9a7d09a169c75fdf0a8dda8...3cb1e9b93cc453eac53e71f4897dc0df26e8264b,1,9,4,13,6,2013-05-19 14:51:36,2013-05-19 14:51:36
b06f6c1618a64cbab9a7d09a169c75fdf0a8dda8...2d309a7043e3625cfeeadbc252322e5599dfffc0,7,109,30,139,17,2013-05-19 14:45:00,2013-05-19 08:52:29
357d62d9f2972bf1bc21e5835c12c849143e06af...69373f3420d28597332a72269b5fae721cc6ae19,4,24,0,24,4,2013-06-07 23:58:41,2013-03-03 05:48:34
17da10ae650e4de24991a53db079d4e0d1aed3cb...6fc339f2f1b4ec631995e92f2ea1795d6286ef0b,1,0,1,1,1,2013-07-08 08:56:11,2013-07-08 08:55:13
6fc339f2f1b4ec631995e92f2ea1795d6286ef0b...8c18f6f61c83c62bc919b0e13338440614b7ad9c,1,1,1,2,1,2013-07-08 09:57:28,2013-07-08 09:35:30
8c18f6f61c83c62bc919b0e13338440614b7ad9c...9383e37a7636879a0f889c0bca38675f7fc85f5b,1,3,3,6,3,2013-07-08 10:03:26,2013-07-08 10:03:26
9383e37a7636879a0f889c0bca38675f7fc85f5b...181f63c22dc0de823031be84b86277b282e4e221,3,22,10,32,8,2013-07-08 12:29:28,2013-07-08 12:29:28
181f63c22dc0de823031be84b86277b282e4e221...da79ccca1d34f427952cce4555e598a700adb8de,2,33,3,36,5,2013-07-08 12:33:40,2013-07-02 15:25:01
da79ccca1d34f427952cce4555e598a700adb8de...10845751632e843aeb21a030c7df7f9848bf65aa,1,8,0,8,1,2013-07-08 13:57:50,2013-07-08 13:57:50
10845751632e843aeb21a030c7df7f9848bf65aa...660c30ed953667b44bdec7058dafe10e0a8ce402,1,10,3,13,3,2013-07-08 16:08:30,2013-07-08 16:08:30
660c30ed953667b44bdec7058dafe10e0a8ce402...c0f03175ceeb132b88d6ff81d28d397e5a303989,7,105,98,203,44,2013-07-08 17:59:54,2013-06-20 06:51:20
c0f03175ceeb132b88d6ff81d28d397e5a303989...dab921751d6410d9d1efcbad1819acea435dbd43,1,9,0,9,1,2013-07-08 19:01:37,2013-07-08 19:01:37
dab921751d6410d9d1efcbad1819acea435dbd43...c0a4894dca4bda0053a56cd677c80340a68c4c95,1,1,1,2,1,2013-07-08 20:47:02,2013-07-08 20:47:02
c0a4894dca4bda0053a56cd677c80340a68c4c95...95eb68c98fe2dc95277d4e26a0316d856dc868dd,2,11,3,14,3,2013-07-09 10:41:52,2013-07-08 15:05:08
95eb68c98fe2dc95277d4e26a0316d856dc868dd...ef3fddf26e8bfe956a52c2aa678db6637caf7adf,2,5,4,9,3,2013-07-09 11:11:41,2013-07-07 01:24:38
ef3fddf26e8bfe956a52c2aa678db6637caf7adf...57815e263055842aba56b633ecc7e7ef814dff1f,1,4,4,8,4,2013-07-09 11:13:43,2013-07-09 11:10:36
57815e263055842aba56b633ecc7e7ef814dff1f...74bc63b1094582e011aded3e8d0fdd82cf623b5b,1,7,1,8,3,2013-07-09 13:14:11,2013-07-09 13:14:11
74bc63b1094582e011aded3e8d0fdd82cf623b5b...bd563f0f571e7c76b40e8c8d7a0e1f34dcfeb810,2,6,39,45,7,2013-07-09 13:17:26,2013-07-09 13:17:26
bd563f0f571e7c76b40e8c8d7a0e1f34dcfeb810...57f190ed3b77eb105cc86ecfabc455662410d40a,1,10,5,15,5,2013-07-09 13:58:56,2013-07-09 13:58:56
57f190ed3b77eb105cc86ecfabc455662410d40a...3c736207a37840109f16f004c343c77b5ee389b6,1,1,1,2,1,2013-07-09 15:55:45,2013-07-09 15:55:45
3c736207a37840109f16f004c343c77b5ee389b6...550b6195edf547ca821f578341a78d68d4121551,1,1,0,1,1,2013-07-09 17:47:57,2013-07-09 17:44:57
550b6195edf547ca821f578341a78d68d4121551...b96f3043a69bec4803d0c5cd84d3107c1ea94fa5,1,2,2,4,2,2013-07-09 17:47:57,2013-07-09 17:47:47
b96f3043a69bec4803d0c5cd84d3107c1ea94fa5...6157192b6e15ca94734e56be6c71a4154c6015bd,1,7,0,7,1,2013-07-09 18:37:01,2013-07-09 18:33:01
6157192b6e15ca94734e56be6c71a4154c6015bd...38bc581bc02d83ecab6d19514ac51b57f0e11866,3,21,49,70,12,2013-07-09 19:41:30,2013-07-09 19:12:51
38bc581bc02d83ecab6d19514ac51b57f0e11866...404870ee1f0d15f6b81d0e0b059068b1f020b2f1,2,4,5,9,2,2013-07-09 19:41:30,2013-07-09 19:35:01
404870ee1f0d15f6b81d0e0b059068b1f020b2f1...7e6d852bac4de2d5ed2d5ddeabf71482d644ef51,4,150,10,160,14,2013-07-09 21:04:33,2013-07-01 14:48:14
7e6d852bac4de2d5ed2d5ddeabf71482d644ef51...1333967f91303b8c5e7e58fd6997e9abe6ee0afe,1,7,0,7,1,2013-07-09 21:04:37,2013-07-09 21:04:37
1333967f91303b8c5e7e58fd6997e9abe6ee0afe...4d92a0bd8630affbb6f289317f71d60607d26369,8,32,1,33,14,2013-07-10 13:24:05,2013-07-01 17:58:04
4d92a0bd8630affbb6f289317f71d60607d26369...77856dc875ca17cc86944e028e4c9a36b0b46dbe,1,4,0,4,2,2013-07-10 16:01:17,2013-07-10 16:01:17
77856dc875ca17cc86944e028e4c9a36b0b46dbe...ecd746191c428866e621b9d13ac90a116b1369dc,1,1,1,2,1,2013-07-11 11:36:25,2013-07-11 11:36:25
ecd746191c428866e621b9d13ac90a116b1369dc...b0953dc91385fb2823294a76d3c99e01c7b7e4ee,9,109,24,133,30,2013-07-11 13:11:59,2013-04-19 17:20:23
b0953dc91385fb2823294a76d3c99e01c7b7e4ee...684a606a4ea21de6d1cc59b69f43b3a133672d59,1,2,1,3,2,2013-07-11 15:06:34,2013-07-11 15:06:34
684a606a4ea21de6d1cc59b69f43b3a133672d59...59ebe39812858ba37e83ab0ee886f676980d472d,5,100,21,121,12,2013-07-11 20:00:08,2013-07-11 18:58:06
d7fa80258b0dc918483679066b38fc4d471acabc...23229061fcb836ecca2195cc75f91e331279a5d1,1,0,1,1,1,2013-04-05 11:08:50,2013-04-05 11:08:50
23229061fcb836ecca2195cc75f91e331279a5d1...975c5afdb5a0c2f9f61f9faecf8dbd928c4996b7,1,18,0,18,1,2013-04-05 12:18:34,2013-04-05 12:15:30
975c5afdb5a0c2f9f61f9faecf8dbd928c4996b7...a49e7dd2a34882fc68244e024eb2876b21c7e8a8,1,4,1,5,3,2013-04-05 16:03:28,2013-04-05 15:43:22
a49e7dd2a34882fc68244e024eb2876b21c7e8a8...216580e03499e035b93283df00fcc03b346fef7b,2,5,2,7,3,2013-04-05 19:09:53,2013-04-05 17:59:15
216580e03499e035b93283df00fcc03b346fef7b...4509a1be1f1164164c2b654d1e3e4169ef71b5ae,1,4,2,6,4,2013-04-06 11:50:09,2013-03-28 04:24:44
4509a1be1f1164164c2b654d1e3e4169ef71b5ae...5ab66dea50eab6625e3a07b71342268432e9cfaf,1,4,2,6,4,2013-04-06 11:50:09,2013-03-28 04:34:57
3f43f5f3b0664a126136d0ae66de92b551cb0421...7fca4416c7f7ce66d528f0d1ad829cf3b8290b89,6,137,70,207,28,2013-03-10 20:31:11,2013-02-12 19:50:47
7fca4416c7f7ce66d528f0d1ad829cf3b8290b89...ce76fbfc5a14b0dbfdf28badb4bff874c8286d48,2,6,1,7,3,2013-03-10 22:28:19,2013-03-10 22:24:34
ce76fbfc5a14b0dbfdf28badb4bff874c8286d48...9cec689e6a7e299b3416519ee075b2316ecc5a64,1,8,9,17,2,2013-03-11 11:04:29,2013-03-11 11:04:29
9e4509107bf2967d8cba28f62b4117c525bd84b0...56743cf9e337826e4c615909570bb057142a6a7b,2,3,3,6,3,2013-09-21 20:54:00,2013-09-21 20:54:00
56743cf9e337826e4c615909570bb057142a6a7b...5444a9c68353d8108df1cf69c9557740d626a18d,2,22,1,23,5,2013-09-21 21:10:14,2013-09-21 20:50:33
5444a9c68353d8108df1cf69c9557740d626a18d...222460a994072dfae9d5ac6b22a2afb116f64b2a,1,26,0,26,1,2013-09-21 22:17:21,2013-09-21 15:22:45
222460a994072dfae9d5ac6b22a2afb116f64b2a...ee0ef1b0948c19bc5fee06a6b9b4286b879f81c1,6,191,164,355,52,2013-09-22 12:04:10,2013-09-22 11:49:46
ee0ef1b0948c19bc5fee06a6b9b4286b879f81c1...a5b062576bda29abe93504dbcb126e644d07f9dd,14,28,30,58,17,2013-09-22 12:04:10,2013-09-22 12:01:57
a5b062576bda29abe93504dbcb126e644d07f9dd...51ed1ef1d56b383210830f69594b789ab3457b95,1,1,1,2,1,2013-09-22 12:36:53,2013-09-22 12:36:53
51ed1ef1d56b383210830f69594b789ab3457b95...9dc45efebae4ad46151a9d059d62e7713ccf469b,1,3,1,4,1,2013-09-22 14:11:02,2013-09-22 14:11:02
9dc45efebae4ad46151a9d059d62e7713ccf469b...ce0c5c38ea77a32e5d6d24082d3a8119ad8714cd,3,41,14,55,13,2013-09-22 16:46:16,2013-09-22 14:21:09
79a484fc8e2f62262e91d5073282c6f0ec497b01...fdea2621cd3f3de472afaab7aa7152a1dc4f505c,1,4,1,5,1,2012-11-05 02:43:11,2012-11-05 02:23:03
fdea2621cd3f3de472afaab7aa7152a1dc4f505c...2cb48fffd4eecdaf77231d8acce6e6fa484698a2,1,0,11,11,1,2012-11-05 03:12:44,2012-11-05 03:04:07
2cb48fffd4eecdaf77231d8acce6e6fa484698a2...6bd61194d49219276275542662e2fbe690534555,2,3,2,5,3,2012-11-05 07:38:41,2012-11-05 07:38:41
6bd61194d49219276275542662e2fbe690534555...39ec43b4784d49f154ba581378fd03ec6a19e48d,1,0,1,1,1,2012-11-05 08:32:08,2012-11-05 07:42:57
39ec43b4784d49f154ba581378fd03ec6a19e48d...78f66691ee7974e0ca546f09573394395a68b443,7,52,3,55,10,2012-11-05 19:27:06,2012-11-05 19:27:06
78f66691ee7974e0ca546f09573394395a68b443...d3fd8a151231726adacb99bdbcd573f95ce32262,2,19,10,29,7,2012-11-05 23:24:28,2012-11-05 12:14:40
d3fd8a151231726adacb99bdbcd573f95ce32262...11fd00c46e2826ce5852e096487762a96909b717,1,1,1,2,1,2012-11-06 09:19:14,2012-11-06 09:19:14
11fd00c46e2826ce5852e096487762a96909b717...2cc1884383a0b5371854be6806851521b623f45b,1,7,5,12,5,2012-11-06 10:17:21,2012-11-06 10:16:01
2cc1884383a0b5371854be6806851521b623f45b...79dd751b0b9e428bf386d7304f442fa9815fdbba,2,8,0,8,4,2012-11-06 11:22:42,2012-11-06 11:19:14
79dd751b0b9e428bf386d7304f442fa9815fdbba...620e0bba4969f27230d35f75bc6a1624c3fac747,1,6,2,8,1,2012-11-06 22:47:10,2012-11-06 13:53:10
620e0bba4969f27230d35f75bc6a1624c3fac747...a386675a6a636b8e6b96277da8e9191e9dc710dc,1,5,3,8,1,2012-11-07 00:03:44,2012-11-06 11:58:25
a386675a6a636b8e6b96277da8e9191e9dc710dc...e8f696097b19abbd3a98990ea4ca5f58d0444826,1,8,2,10,3,2012-11-07 00:44:49,2012-11-07 00:44:49
4d766b3c9aca36cbe7dc71df0cc93fb6f9deea60...a70492e6b532905c921678f35b5c60b22387f1c6,1,11,0,11,1,2012-11-05 01:40:21,2012-11-05 00:35:40
5999eb42eb6dad6a74c43eb6e9d96ac368ad97b4...3a10bcc91726859f9f0f817b39586712c2d37c2b,1,7,0,7,1,2012-09-07 19:51:22,2012-09-07 19:51:22
292322f977b1844e15ba25d59d1e985461571c15...72b8f8d73bef36c555121b2550343cd9e830730e,1,13,13,26,7,2012-09-07 17:35:09,2012-09-07 17:35:09
72b8f8d73bef36c555121b2550343cd9e830730e...f47af9df1d3e03512364e5fe115f025c0a0be670,3,57,62,119,19,2012-09-07 17:47:12,2012-09-07 17:43:51
f47af9df1d3e03512364e5fe115f025c0a0be670...a92b81b0e8adc47a1357a3fa26324cbda226f211,1,4,3,7,3,2012-09-07 18:01:46,2012-09-07 18:01:46
a92b81b0e8adc47a1357a3fa26324cbda226f211...e4ea53677449cfc56a0093bfbd92cb482020bb1e,1,5,1,6,2,2012-09-07 18:14:06,2012-09-07 18:14:06
e4ea53677449cfc56a0093bfbd92cb482020bb1e...6a5a12ea3e3193b3658b9237b86d98bc37d668d7,3,9,13,22,4,2012-09-07 18:37:21,2012-09-07 18:37:21
e1a37d55374a399dee9c302419fbe9badd92abb0...9ce58906af4a5f5a0739598ac10103fef3642419,1,4,3,7,2,2012-09-07 17:05:23,2012-09-07 17:05:23
bc46f67fa83a82d48eafc0e3bbd368a3746e3936...de8aa3a9a9098af35d5b56442c39dd2ed56b3299,1,1,1,2,1,2013-05-08 07:55:40,2013-05-08 07:55:40
de8aa3a9a9098af35d5b56442c39dd2ed56b3299...1fff8daf889822aa1dd9adba19c94bb522d960b4,3,17,2,19,4,2013-05-08 11:03:36,2013-05-08 10:57:35
1fff8daf889822aa1dd9adba19c94bb522d960b4...e81e319f15f448d550d7e30b204d9490a9999b99,3,15,4,19,5,2013-05-08 11:05:09,2013-05-05 17:44:43
e81e319f15f448d550d7e30b204d9490a9999b99...86b4ac665afe793a457ae84dfa1dfbbbb7e3c2bf,1,2,2,4,2,2013-05-08 11:05:23,2013-05-08 10:56:50
86b4ac665afe793a457ae84dfa1dfbbbb7e3c2bf...7476d96f83a004d674244aeb7a66289035427396,3,14,2,16,5,2013-05-08 13:48:39,2013-05-08 13:33:02
7476d96f83a004d674244aeb7a66289035427396...ea3a378c22c0a61715663b9bf807c786233f70c1,1,1,0,1,1,2013-05-08 19:45:31,2013-05-08 19:44:58
ea3a378c22c0a61715663b9bf807c786233f70c1...832b4a5722ba6b55e7b17c3bac6614ecca9aa88d,1,8,1,9,3,2013-05-08 21:12:46,2013-05-08 21:12:04
832b4a5722ba6b55e7b17c3bac6614ecca9aa88d...1556b1c3b7a18cadf4d66d2ab6301d7fe8646ba5,3,6,19,25,5,2013-05-08 23:49:05,2013-05-08 23:49:05
1556b1c3b7a18cadf4d66d2ab6301d7fe8646ba5...2f8f2ad1d7762b2c46cdc707b4921685bcea3612,1,0,42,42,3,2013-05-09 00:45:34,2013-05-09 00:45:34
bc46f67fa83a82d48eafc0e3bbd368a3746e3936...a22e15effc957df977233c64278b364a955b9ce9,2,0,21,21,7,2013-05-08 04:50:59,2013-05-08 04:50:59
a4ab0e8b8648cd4d2dd58396aaccf2be4c23dd85...41bea033b7e6b9d28c99f8c1ddedecad13009bd0,1,2,1,3,1,2013-05-19 15:31:27,2013-05-19 15:30:26
41bea033b7e6b9d28c99f8c1ddedecad13009bd0...f7d7d2be4b1d0d6b006dc293135ebd45b3ef4666,1,1,1,2,1,2013-05-19 15:58:29,2013-05-19 15:58:29
f7d7d2be4b1d0d6b006dc293135ebd45b3ef4666...bdde7feb26f89e580c2b21154196fe3f8c774677,2,25,17,42,12,2013-05-19 16:06:35,2013-05-19 16:06:35
69373f3420d28597332a72269b5fae721cc6ae19...f80b1063e404d28779a7c78cfd616fd416a2ef10,1,2,2,4,2,2013-06-08 05:53:27,2013-06-08 05:53:27
59ebe39812858ba37e83ab0ee886f676980d472d...b4c61c2665c0aa06dcdc4f823be03f23b9696408,1,3,1,4,2,2013-07-12 10:38:00,2013-07-12 08:43:50
59ebe39812858ba37e83ab0ee886f676980d472d...ac223ff6d1efda56ab1d2e5afe250f744a0a4e64,1,4,4,8,1,2013-07-12 09:50:08,2013-07-12 09:50:08
5ab66dea50eab6625e3a07b71342268432e9cfaf...f9dc1379b874f80694a80e95f0f266a3d42f7368,2,49,0,49,4,2013-04-07 17:08:53,2013-04-07 16:41:35
9cec689e6a7e299b3416519ee075b2316ecc5a64...7aacde84f2b499d9c35741cbfccb621af6b48903,14,22,64,86,42,2013-03-11 13:48:53,2013-03-02 19:25:25
7aacde84f2b499d9c35741cbfccb621af6b48903...f5156194945661d217523d6648dfb9b48707ec95,14,81,13,94,19,2013-03-11 13:48:53,2013-03-02 12:47:46
f5156194945661d217523d6648dfb9b48707ec95...8717b0668caf00ec5e81ef5a1e31b4d7c64eee8a,2,54,41,95,21,2013-03-11 13:48:54,2013-03-02 15:57:56
8717b0668caf00ec5e81ef5a1e31b4d7c64eee8a...af9e9386eb6ad22e3fa822574a4f5be4c9c29771,5,19,20,39,16,2013-03-11 13:48:54,2013-03-02 20:59:55
af9e9386eb6ad22e3fa822574a4f5be4c9c29771...cd364efa00dba5aa86187aee83e4ed9917e7e93c,2,4,7,11,7,2013-03-11 13:48:54,2013-03-03 14:32:14
cd364efa00dba5aa86187aee83e4ed9917e7e93c...7b4815b455fc99a2661492f91f7242cfb09a7017,2,2,5,7,2,2013-03-11 13:48:54,2013-03-07 10:50:49
7b4815b455fc99a2661492f91f7242cfb09a7017...1617557ae30001cef8a863687d4bcdc28151cd50,2,24,14,38,6,2013-03-11 13:48:54,2013-03-03 14:43:24
1617557ae30001cef8a863687d4bcdc28151cd50...cfc114e00ebe2ac16c37af2ccee1ed8e47247b7a,3,15,42,57,7,2013-03-11 13:48:54,2013-03-03 14:48:52
cfc114e00ebe2ac16c37af2ccee1ed8e47247b7a...5e27debc5cba30c84f99151a84c5fd846a65b091,7,239,141,380,43,2013-03-11 13:48:54,2013-03-03 14:55:11
5e27debc5cba30c84f99151a84c5fd846a65b091...14aa563f51c1a8a2ece52ca6b9e66aed9c89c0fd,2,1,22,23,4,2013-03-11 13:48:54,2013-03-05 19:40:57
14aa563f51c1a8a2ece52ca6b9e66aed9c89c0fd...ba5138b1c0253fcf390b7509ad7b954117b3be88,17,116,208,324,36,2013-03-11 13:48:54,2013-03-04 12:12:59
ba5138b1c0253fcf390b7509ad7b954117b3be88...3bdc7a6a70bb030324fdebe9b1dce1fa5358f0c6,7,23,30,53,15,2013-03-11 13:48:54,2013-03-04 14:24:01
3bdc7a6a70bb030324fdebe9b1dce1fa5358f0c6...918f44e3ae650ff124067425d31c9d3deeba2224,3,3,21,24,5,2013-03-11 13:48:54,2013-02-28 17:30:03
918f44e3ae650ff124067425d31c9d3deeba2224...e264f67174622f66503e4748e2f71c72a4a5064b,1,24,19,43,16,2013-03-11 13:48:55,2013-03-01 09:09:22
e264f67174622f66503e4748e2f71c72a4a5064b...4b31a6a9e698a26e3e359e2ccf3da1505d114cf1,4,40,12,52,8,2013-03-11 13:48:55,2013-03-04 14:57:04
4b31a6a9e698a26e3e359e2ccf3da1505d114cf1...d7bc4fbc94df6c231d71dffa45cf337ff13512ee,7,430,23,453,25,2013-03-11 13:48:55,2013-03-04 21:17:35
d7bc4fbc94df6c231d71dffa45cf337ff13512ee...7c46c8d5f27fe305507359588ca0635b6d87c59a,14,359,269,628,114,2013-03-11 13:48:55,2013-03-04 22:26:31
7c46c8d5f27fe305507359588ca0635b6d87c59a...09ba70f9f1844680ac0e0b3a7c38ff7113cbdb02,1,4,0,4,2,2013-03-11 13:48:55,2013-03-05 21:30:55
09ba70f9f1844680ac0e0b3a7c38ff7113cbdb02...f7245b83bb2df9d66a375d46a4be8de093957fa7,1,22,4,26,3,2013-03-11 13:48:55,2013-03-07 10:38:21
f7245b83bb2df9d66a375d46a4be8de093957fa7...ac37ed21b3d66dde1748f6edf3279656b0267b70,12,223,57,280,29,2013-03-11 14:04:05,2013-03-06 10:12:24
ac37ed21b3d66dde1748f6edf3279656b0267b70...557e40412729c06a2daff34a4cabcb6efb719b32,1,20,17,37,4,2013-03-11 14:04:10,2013-03-07 13:09:52
557e40412729c06a2daff34a4cabcb6efb719b32...ffe41591e75fc3acf76c634bdd0899d78e91688d,1,17,9,26,7,2013-03-11 14:04:10,2013-03-07 13:05:32
ffe41591e75fc3acf76c634bdd0899d78e91688d...17cf29920b3b3a4870c865cb53f6b935187ba4e4,1,122,80,202,3,2013-03-11 14:05:02,2013-03-07 13:42:51
17cf29920b3b3a4870c865cb53f6b935187ba4e4...189fb4e29463a2e1ee1a86a6c29c94f9f9904d6f,1,7,0,7,1,2013-03-11 14:05:04,2013-03-07 22:06:58
189fb4e29463a2e1ee1a86a6c29c94f9f9904d6f...107d9b1d974ae97132751cb1db742fd8e930fb89,4,156,30,186,23,2013-03-11 14:05:04,2013-03-08 14:44:41
107d9b1d974ae97132751cb1db742fd8e930fb89...423c0d5e293bf6bd5f859430126269c31313585a,1,7,0,7,2,2013-03-11 14:05:04,2013-03-07 13:47:50
423c0d5e293bf6bd5f859430126269c31313585a...0cee3c0e43e20ca91aca18210c0b813c42407b1b,1,15,13,28,3,2013-03-11 14:05:04,2013-03-07 16:20:15
0cee3c0e43e20ca91aca18210c0b813c42407b1b...86fd920f6761cbf93a7e5a9eb3c634e0e168a038,1,0,13,13,1,2013-03-11 14:05:04,2013-03-07 16:20:50
86fd920f6761cbf93a7e5a9eb3c634e0e168a038...4dbd1b2dd8d997f439b0116748994fd538ff893a,3,38,77,115,9,2013-03-11 14:05:05,2013-03-08 10:35:54
4dbd1b2dd8d997f439b0116748994fd538ff893a...d04964e70d5c6277e79874ba8950e23c224b323b,1,21,48,69,8,2013-03-11 14:05:05,2013-03-08 10:35:15
d04964e70d5c6277e79874ba8950e23c224b323b...f32100939e8ea8a2714e45e22467af5df55c8f33,1,9,7,16,7,2013-03-11 14:05:05,2013-03-08 12:31:14
f32100939e8ea8a2714e45e22467af5df55c8f33...e654180ce2a11ef4c525497d6c40dc542e16806c,8,24,24,48,24,2013-03-11 14:10:58,2013-03-11 14:10:58
ce0c5c38ea77a32e5d6d24082d3a8119ad8714cd...1b4b710355057b279c1e7d10b6b0d846ee98444e,5,7,7,14,7,2013-09-22 17:44:09,2013-09-22 17:34:30
e8f696097b19abbd3a98990ea4ca5f58d0444826...9a09558e9f20e088b4526fff6374a53e877cf5ec,1,6,5,11,2,2012-11-07 17:28:53,2012-11-07 17:24:49
9a09558e9f20e088b4526fff6374a53e877cf5ec...b1ac329ba9bbcba90d8ced7e16909ed169b1d16e,1,9,0,9,1,2012-11-07 17:31:14,2012-11-07 17:31:14
b1ac329ba9bbcba90d8ced7e16909ed169b1d16e...cafb266954e21dd55ddfa90597bcf02c022bcb7d,2,125,32,157,13,2012-11-07 22:56:32,2012-11-07 22:04:57
cafb266954e21dd55ddfa90597bcf02c022bcb7d...45802e12481e86f7b9c1f392a54b9d25671214d9,6,95,156,251,10,2012-11-08 10:07:16,2012-11-08 10:00:26
45802e12481e86f7b9c1f392a54b9d25671214d9...9942adac17f32a09cef77e4016627a6990ff7580,1,2,31,33,3,2012-11-08 15:13:23,2012-11-08 15:13:23
e8f696097b19abbd3a98990ea4ca5f58d0444826...b0c72d0a308bcb41c676d36c24e6b2f85e00cd95,2,2,2,4,2,2012-11-07 16:13:06,2012-11-07 16:13:06
3a10bcc91726859f9f0f817b39586712c2d37c2b...b865009d414a0f6fd0c0f5ad7434b2c13eb761c7,3,32,7,39,5,2012-09-07 20:49:22,2012-09-07 20:49:22
b865009d414a0f6fd0c0f5ad7434b2c13eb761c7...7435cc0167d1edad7bf02f89e6494189327f0109,3,22,32,54,7,2012-09-07 21:12:11,2012-09-07 21:12:11
7435cc0167d1edad7bf02f89e6494189327f0109...2649cb8ff3000ae053624300d0e6ce219af77745,1,1,1,2,1,2012-09-07 21:37:08,2012-09-07 21:37:08
3a10bcc91726859f9f0f817b39586712c2d37c2b...e78f2f6a636288ed8d9808b093e809e87523b3ac,1,2,2,4,2,2012-09-07 20:26:37,2012-09-07 20:26:37
f25fc5b2209b9c53cc0a71880ab049816f3a66a1...3d595c3bc38cf939503b69ce7a2802d5663f85b9,5,34,36,70,9,2013-05-09 13:42:14,2013-05-09 13:42:14
3d595c3bc38cf939503b69ce7a2802d5663f85b9...6634cb7b53bc35241e070f1896ff2fc439c19d0f,1,0,4,4,1,2013-05-09 13:55:25,2013-05-09 13:55:25
6634cb7b53bc35241e070f1896ff2fc439c19d0f...a53d7a0a50f12a1a731b81e646b55872717093bb,5,46,41,87,22,2013-05-09 15:13:13,2013-05-09 15:13:13
a53d7a0a50f12a1a731b81e646b55872717093bb...1906cb93609ce6042f97939a04067a122f5719a6,1,1,1,2,1,2013-05-09 15:39:56,2013-05-09 15:38:47
1906cb93609ce6042f97939a04067a122f5719a6...1e37cb37cec330a6b78925e2ef5589817428d09a,3,0,40,40,5,2013-05-09 15:44:36,2013-05-09 14:11:02
1e37cb37cec330a6b78925e2ef5589817428d09a...f026a519aea8f3ea7ca339bfbbb007e1ee0068b0,34,578,201,779,217,2013-05-09 15:44:36,2013-02-21 21:56:55
f026a519aea8f3ea7ca339bfbbb007e1ee0068b0...9a3708cec8cf76165afd0fd46d1267d7cae772ca,1,1,1,2,1,2013-05-09 17:33:02,2013-05-09 17:33:02
9a3708cec8cf76165afd0fd46d1267d7cae772ca...465a29abe09012059b4a8ff34f1020f48879ad71,2,6,5,11,5,2013-05-10 11:21:07,2013-05-10 10:47:03
465a29abe09012059b4a8ff34f1020f48879ad71...7b00d90208e998debc60e51cadb352645c91e3fd,3,17,21,38,15,2013-05-10 11:21:07,2013-05-10 11:18:07
7b00d90208e998debc60e51cadb352645c91e3fd...bdd285723f9b0044eca690634c412c1c3eec76c0,1,1,1,2,1,2013-05-10 11:23:57,2013-05-10 11:23:32
c792c83cad54f064b6ba13e285e95a90e2c61f09...33793f7c3edd8ff144ff2e9434367267c20af26a,13,198,66,264,33,2013-05-15 02:32:04,2013-05-15 02:31:16
33793f7c3edd8ff144ff2e9434367267c20af26a...4ecc6da20b00b2d00a8cc158056a10bf0a259d07,1,7,5,12,5,2013-05-15 07:00:09,2013-05-15 07:00:09
4ecc6da20b00b2d00a8cc158056a10bf0a259d07...84d8b247d20aafb376368dc458f277ad2cd71ecd,1,16,12,28,6,2013-05-15 10:48:17,2013-05-15 00:25:45
84d8b247d20aafb376368dc458f277ad2cd71ecd...c8dcee9a423fa3f31a2303e7ec20a924775730a2,1,2,0,2,1,2013-05-15 14:43:39,2013-05-15 14:43:39
c8dcee9a423fa3f31a2303e7ec20a924775730a2...f6d1ca56c9d2583c894a44841d109a597ac019bd,1,1,2,3,1,2013-05-15 14:47:03,2013-05-15 14:45:07
f6d1ca56c9d2583c894a44841d109a597ac019bd...ebfb71c64a786620947c9d598fd1ebae2958acff,1,0,2,2,1,2013-05-15 14:50:33,2013-05-15 14:50:33
bdde7feb26f89e580c2b21154196fe3f8c774677...6633eeb88634aa8c03c8737d2d23c96b96a37e0d,4,57,33,90,12,2013-05-19 17:53:16,2013-05-19 15:55:12
bdde7feb26f89e580c2b21154196fe3f8c774677...6786920fd8a1dfa43bba8333548c2496847298af,4,74,4,78,11,2013-05-19 16:10:40,2013-05-19 10:39:14
6786920fd8a1dfa43bba8333548c2496847298af...e83ff42792eb52235cacda58f3441673cc4e4c94,2,10,2,12,3,2013-05-19 16:30:53,2013-05-19 16:30:53
e83ff42792eb52235cacda58f3441673cc4e4c94...190771d003de51af28d29bdd0e0f2bc25f9d85a2,2,5,1,6,3,2013-05-19 17:53:49,2013-05-19 17:51:59
190771d003de51af28d29bdd0e0f2bc25f9d85a2...7c56212c71e4794561ffd00518599144001c35b2,1,1,1,2,1,2013-05-19 20:58:58,2013-05-19 20:58:58
cc74f8a4f79b1d0d8a4b57bdd78bdc99d18a3faa...6a092f24e01b6448f4e5601968db82720c9397de,2,5,1,6,3,2013-06-08 14:13:51,2013-06-08 13:05:50
b82a2c41387648f81387b1e03371331db3630269...66f3d57b79eee0381c29ee4c76582d6b182bfad9,6,64,4,68,12,2013-07-12 11:10:18,2013-05-18 11:43:51
66f3d57b79eee0381c29ee4c76582d6b182bfad9...6272d2f155adb4f32ef129d57e9eb5493ebde6ed,6,184,23,207,11,2013-07-12 12:26:35,2013-05-18 11:49:06
6272d2f155adb4f32ef129d57e9eb5493ebde6ed...a7d97a6778ca528199920901ed2f66e289ee5a44,2,4,4,8,3,2013-07-12 16:48:49,2013-07-12 16:48:49
a7d97a6778ca528199920901ed2f66e289ee5a44...f2cb94f1c0dc98663e7d493411bf9b82d1894559,2,17,1,18,2,2013-07-12 20:05:14,2013-07-12 20:05:14
f2cb94f1c0dc98663e7d493411bf9b82d1894559...73f86f44417f883ba3aca1ba947fdad00206a615,1,202,215,417,3,2013-07-13 08:16:52,2013-07-13 08:16:40
73f86f44417f883ba3aca1ba947fdad00206a615...755720798393e78fc3094cc3f790852737cb6813,4,31,10,41,9,2013-07-13 14:19:16,2013-07-13 09:43:14
755720798393e78fc3094cc3f790852737cb6813...9b471a8fe3649cacd43c56a0aef604bb4bd8a4f5,1,1,0,1,1,2013-07-13 17:15:28,2013-07-13 17:15:28
9b471a8fe3649cacd43c56a0aef604bb4bd8a4f5...64099e30e882fb9101887e2cf82b841c09992d5e,1,0,4,4,1,2013-07-13 19:08:44,2013-07-13 19:08:26
64099e30e882fb9101887e2cf82b841c09992d5e...1b142ef5dd7a6e5a21abf43d4d21846c9f1eb794,3,6,55,61,5,2013-07-13 21:08:48,2013-07-13 21:08:45
1b142ef5dd7a6e5a21abf43d4d21846c9f1eb794...d9c580306c4b7da49d7fd2fd1ea0e6333a784113,2,37,2,39,5,2013-07-13 21:46:05,2013-07-13 21:46:05
d1d09fecf87e9139c9493218c9211e6c91f791a3...3cdeb572d73fca3d7966318c760f61ba73e5ad5f,1,16,0,16,2,2013-07-12 10:19:16,2013-07-12 10:19:16
14cddf51c5f001bb426ce7f7a83fdc52c8d8aee9...3f1efc44f65604a3e6bc09aba3dbfb649d3e966e,1,2,0,2,2,2013-03-11 14:43:42,2013-03-11 14:43:42
3f1efc44f65604a3e6bc09aba3dbfb649d3e966e...9b74a8391de81312a6d2f97ce40f3ed856285d9f,2,2,15,17,7,2013-03-11 16:46:56,2013-03-11 15:59:59
9b74a8391de81312a6d2f97ce40f3ed856285d9f...55a9be8ecffee56ba9d8b52a34766b83ba5f4e16,1,6,4,10,1,2013-03-11 18:42:59,2013-03-11 18:42:23
55a9be8ecffee56ba9d8b52a34766b83ba5f4e16...3710a918b25311e5ce2f7f16f28ff2e2b8f7a12a,2,4,4,8,4,2013-03-11 18:58:08,2013-03-11 18:58:08
3710a918b25311e5ce2f7f16f28ff2e2b8f7a12a...1adb7b3c38641c2e9e346d21555214e7b320b836,1,8,11,19,4,2013-03-11 19:03:17,2013-03-11 19:03:17
1adb7b3c38641c2e9e346d21555214e7b320b836...b746f8a9e3fb22fe5ff58bd2bd8b20fa80cd4800,1,2,2,4,2,2013-03-11 20:07:19,2013-03-11 20:07:19
b746f8a9e3fb22fe5ff58bd2bd8b20fa80cd4800...f2f98abb955c83eca3ceea62d1711c80ae028d33,2,7,13,20,3,2013-03-11 20:08:49,2013-03-11 20:08:49
5a64f9bcbd922a5b7024e621b375f025ae30d2a1...bebb449ac334d7365a015b34b9c894dc4bf63f7f,2,30,5,35,7,2013-09-22 18:43:27,2013-09-22 18:41:24
bebb449ac334d7365a015b34b9c894dc4bf63f7f...2ca00faa913754cd5860f6e1f23c8da2529c691a,4,15,22,37,14,2013-09-22 20:02:59,2013-09-22 13:55:09
2ca00faa913754cd5860f6e1f23c8da2529c691a...e6c0020d1973abf168c3a2357ab4cf44fa2d47ca,2,3,3,6,3,2013-09-22 20:48:22,2013-09-22 19:20:22
e6c0020d1973abf168c3a2357ab4cf44fa2d47ca...4fcc1e4ad8d153f41132b171c231b6d5d4086c28,1,6,4,10,3,2013-09-22 21:02:35,2013-09-22 20:58:46
4fcc1e4ad8d153f41132b171c231b6d5d4086c28...c81b6f7b834da8d8fbcf679679ce158173df3a05,1,2,0,2,1,2013-09-23 11:37:09,2013-09-23 10:17:22
c81b6f7b834da8d8fbcf679679ce158173df3a05...98e0453f00958af63b50e70990903eb6a04e1933,1,13,3,16,2,2013-09-23 14:37:41,2013-09-23 13:46:19
98e0453f00958af63b50e70990903eb6a04e1933...6a30075eaa52b3d91665195a34901ac450df5bbb,1,11,0,11,1,2013-09-23 14:50:19,2013-09-22 22:48:43
6a30075eaa52b3d91665195a34901ac450df5bbb...a53caf28bf2ab29cf4e78a968b3887ddb6d6e83d,1,13,11,24,5,2013-09-23 15:03:50,2013-09-23 14:17:15
a53caf28bf2ab29cf4e78a968b3887ddb6d6e83d...41167645b1039067127fa215d4d28296bfa4cfdc,2,67,0,67,4,2013-09-23 15:51:58,2013-09-23 14:00:46
41167645b1039067127fa215d4d28296bfa4cfdc...e15f7f31d048ead5453b5ee810235cf88b42b3cc,1,19,3,22,2,2013-09-23 16:18:00,2013-09-23 13:50:50
e15f7f31d048ead5453b5ee810235cf88b42b3cc...4ec6d281cdc67bee1c7ac272272ae500b600fe49,1,7,0,7,1,2013-09-23 18:18:03,2013-09-23 18:18:03
4ec6d281cdc67bee1c7ac272272ae500b600fe49...ab643cd63402ef8ed4776faebc0ed4f00b933e1d,1,3,1,4,2,2013-09-23 21:05:36,2013-09-23 21:05:36
ab643cd63402ef8ed4776faebc0ed4f00b933e1d...45969bdeb56dcd1c1670860b37f96c62f977d9fd,1,1,1,2,1,2013-09-23 22:30:05,2013-09-23 22:30:05
45969bdeb56dcd1c1670860b37f96c62f977d9fd...946a2226eacfcbc4d7996b36fd9944debdf2d8c2,1,1,1,2,1,2013-09-23 23:24:40,2013-09-23 22:36:33
946a2226eacfcbc4d7996b36fd9944debdf2d8c2...4c5bc1ac30fea526259026bf762b4806dd5f1459,1,0,2,2,1,2013-09-24 08:25:39,2013-09-24 08:25:39
4c5bc1ac30fea526259026bf762b4806dd5f1459...16ceb05b4751425ed16ee0eddd0c533f067344b2,3,63,56,119,4,2013-09-24 08:29:21,2013-09-24 08:27:43
16ceb05b4751425ed16ee0eddd0c533f067344b2...6ede1db331d59e9a89eaa65101629d0ff642f8fc,1,3,0,3,1,2013-09-24 10:00:00,2013-09-24 10:00:00
6ede1db331d59e9a89eaa65101629d0ff642f8fc...45403d330a612dd24793060a796c00b41e75d13d,1,54,35,89,18,2013-09-24 10:23:42,2013-09-24 09:31:33
45403d330a612dd24793060a796c00b41e75d13d...18fb713e7bef6ff69a62821b25790bb7dc48812a,1,6,3,9,3,2013-09-24 10:23:42,2013-09-24 10:22:50
18fb713e7bef6ff69a62821b25790bb7dc48812a...53c7d66869636a6cf2b8c03c4de01ddff16f9892,1,1,1,2,1,2013-09-24 11:36:24,2013-09-23 20:35:04
9942adac17f32a09cef77e4016627a6990ff7580...a79d920a56e7200b6259e60f7811162c07c7651d,3,25,0,25,5,2012-11-09 08:00:27,2012-11-09 08:00:27
9942adac17f32a09cef77e4016627a6990ff7580...1db5d8827351acd2d039c218723d5100dc7e7f95,1,30,2,32,6,2012-11-09 00:35:39,2012-11-09 00:32:16
1db5d8827351acd2d039c218723d5100dc7e7f95...3f65f751a0082b83ff24849a1445aa0838b27d93,1,1,1,2,1,2012-11-13 00:12:27,2012-11-13 00:12:27
19eb56a277291de8c25a0edcc7af111dac7518af...aea8bf06620c931f7b1e7d991497d593b91f71c9,1,1,0,1,1,2012-11-09 14:16:06,2012-11-09 14:16:06
aea8bf06620c931f7b1e7d991497d593b91f71c9...1b307d6c8fe9a897da2daa189b7d5f59120e4410,2,27,0,27,3,2012-11-09 18:41:57,2012-11-09 18:37:50
1b307d6c8fe9a897da2daa189b7d5f59120e4410...4d817b38875c900d70793acd528afc9e954bbcb7,2,16,1,17,2,2012-11-09 20:07:53,2012-11-09 20:07:53
4d817b38875c900d70793acd528afc9e954bbcb7...34162698cc7a3c75b1d1b2e18b481aa7e865dc98,2,19,1,20,3,2012-11-10 11:05:58,2012-11-10 11:05:58
34162698cc7a3c75b1d1b2e18b481aa7e865dc98...04a7ea3283318dbec84529b055548042a43e4f4d,1,0,2,2,1,2012-11-10 14:42:27,2012-11-10 14:42:27
1d235b39142d830a221bda4c55dc3357446deb57...9b07b5edeb770b037dc735d48dfd6f979422f586,2,77,43,120,12,2012-09-07 23:08:57,2012-09-07 23:08:57
9b07b5edeb770b037dc735d48dfd6f979422f586...6add6170c0aa7c870c4a66f8e33ecde93f7fd975,1,52,50,102,8,2012-09-07 23:12:14,2012-09-07 23:12:14
6add6170c0aa7c870c4a66f8e33ecde93f7fd975...4e1fd38bd6f007b6bb4cc57a0a841b78475a9d26,2,9,9,18,6,2012-09-07 23:24:02,2012-09-07 23:23:16
4e1fd38bd6f007b6bb4cc57a0a841b78475a9d26...fa8fb2b383cc7e73c9e34bca08f29d31ff73128b,1,15,5,20,1,2012-09-07 23:49:38,2012-09-07 23:49:38
fa8fb2b383cc7e73c9e34bca08f29d31ff73128b...ce53a1d0bf51f59118569ec81e1a30b013bd352e,1,47,49,96,18,2012-09-07 23:59:00,2012-09-07 23:56:20
ce53a1d0bf51f59118569ec81e1a30b013bd352e...3622be42b0902391a93c30af8483cdf34bac2783,1,6,6,12,4,2012-09-08 01:08:57,2012-09-08 01:08:57
bdd285723f9b0044eca690634c412c1c3eec76c0...a4dec43b520fa51bf7a949576b5767242c74c982,1,14,2,16,3,2013-05-10 14:56:42,2013-05-10 14:56:42
a4dec43b520fa51bf7a949576b5767242c74c982...327e362ff30969fd4ac111fa59cbfcd4c11abd38,1,1,1,2,1,2013-05-10 15:56:39,2013-05-10 15:56:39
327e362ff30969fd4ac111fa59cbfcd4c11abd38...92351c74c16f3f234e05cd1792e3a8d5f583301c,1,2,2,4,2,2013-05-10 22:51:14,2013-05-10 22:51:14
92351c74c16f3f234e05cd1792e3a8d5f583301c...c0d8932a6d03e9326a4e407e944b09bf43cf929c,2,10,1,11,4,2013-05-11 00:48:58,2013-05-11 00:48:58
c0d8932a6d03e9326a4e407e944b09bf43cf929c...9012833af857e081b515ce760685b157638efcef,79,959,1019,1978,254,2013-05-11 03:08:45,2013-05-11 03:08:45
ebfb71c64a786620947c9d598fd1ebae2958acff...74f3884ae04ea57baee9b04ab0b5658a97cfd296,5,25,25,50,25,2013-05-15 19:55:30,2013-05-13 19:40:39
7c56212c71e4794561ffd00518599144001c35b2...022de7e1393541a3693919e1427d272df89f7f46,1,17,3,20,2,2013-05-20 03:58:06,2013-05-20 03:58:06
022de7e1393541a3693919e1427d272df89f7f46...a7dc13ec231faf917c3125eb4c158138d4edde10,1,17,0,17,3,2013-05-20 05:56:23,2013-05-20 05:56:23
7c56212c71e4794561ffd00518599144001c35b2...428875775c9f0d318081a30612feacee0ad5ed9e,1,1,1,2,1,2013-05-19 22:59:17,2013-05-19 22:59:17
6a092f24e01b6448f4e5601968db82720c9397de...79ff1aedd57a154a7563fb1b71c3e7997c513408,1,2,2,4,2,2013-06-09 12:31:04,2013-06-09 12:31:04
6a092f24e01b6448f4e5601968db82720c9397de...4bd6e5e89501680235ded6c460657a1231231931,1,1,1,2,1,2013-06-09 05:23:48,2013-06-09 05:23:48
6a092f24e01b6448f4e5601968db82720c9397de...706eced9bb9012788494c14566577ed691924e82,1,2,2,4,2,2013-06-08 15:45:39,2013-06-08 15:45:39
d9c580306c4b7da49d7fd2fd1ea0e6333a784113...51b50c47c75cb398a4479560e772bc1c4ac21cfe,1,1,1,2,1,2013-07-14 03:28:04,2013-07-14 03:28:04
f2f98abb955c83eca3ceea62d1711c80ae028d33...571b2d139baa81ae9a0afea88c5b570a2d16d313,11,103,2,105,13,2013-03-11 20:38:40,2013-03-09 14:49:37
571b2d139baa81ae9a0afea88c5b570a2d16d313...d0561242699ed29527b9ab1dabe8a668e519eba5,2,6,8,14,4,2013-03-11 20:38:53,2013-03-11 15:04:58
53c7d66869636a6cf2b8c03c4de01ddff16f9892...8e737cf28212ba65d93e62b58a21d929e0bced26,1,1,1,2,1,2013-09-24 11:55:05,2013-09-24 11:55:05
04a7ea3283318dbec84529b055548042a43e4f4d...cc0ac26f4a3947be8a3fc55d4784d3474b640c23,1,8,4,12,4,2012-11-10 17:42:20,2012-11-10 16:39:59
04a7ea3283318dbec84529b055548042a43e4f4d...bfdedb687abfbdf400387092762bb7081e8e8b56,1,1,1,2,1,2012-11-10 15:48:46,2012-11-10 15:48:46
3622be42b0902391a93c30af8483cdf34bac2783...09a99714c05316717d2797afd2e458dbf6aa880f,2,5,12,17,4,2012-09-08 08:24:13,2012-09-08 08:24:13
09a99714c05316717d2797afd2e458dbf6aa880f...dc01e41d2343386b481b983828fd861303877e81,2,10,9,19,4,2012-09-08 10:38:41,2012-09-08 10:38:41
3622be42b0902391a93c30af8483cdf34bac2783...8198a1923ebbf3181447b4efdc058a4d6a86d83d,1,2,3,5,1,2012-09-08 05:41:37,2012-09-08 05:41:37
9012833af857e081b515ce760685b157638efcef...3070e8f711f891aa3bf6e9d1e123047094bf1bb0,1,5,2,7,3,2013-05-11 15:16:06,2013-05-11 05:33:10
9012833af857e081b515ce760685b157638efcef...e23a5f9a4730ddecb8f3950ee2936716f458c506,1,5,2,7,2,2013-05-11 13:47:40,2013-05-11 13:47:40
e23a5f9a4730ddecb8f3950ee2936716f458c506...2bf403ecbd958bfb269794b36e61b69f0aede4cf,4,11,11,22,10,2013-05-11 16:29:08,2013-05-11 16:29:08
9012833af857e081b515ce760685b157638efcef...1172bef998734ef78fc69927bed57364a868c44d,1,2,1,3,1,2013-05-11 07:53:54,2013-05-11 07:53:54
74f3884ae04ea57baee9b04ab0b5658a97cfd296...31887751746088d99b2f607f929c0c4a02978740,1,2,2,4,2,2013-05-15 21:07:34,2013-05-15 21:07:34
a93672622829e0d4a2ff3240456d4d73b9d46476...f53059b41148da77e8c4cdfcdbec3a7514cd97c9,2,23,1,24,2,2013-05-20 12:38:47,2013-05-20 11:24:48
f53059b41148da77e8c4cdfcdbec3a7514cd97c9...d9d24c4521866247f1e5fc1150f5cb9b57979863,1,4,5,9,2,2013-05-20 14:17:49,2013-05-20 14:17:49
d9d24c4521866247f1e5fc1150f5cb9b57979863...c9a96075fa02b6d52bec748ffdfb413688a15774,3,30,1,31,4,2013-05-20 15:02:10,2013-05-20 14:40:34
c9a96075fa02b6d52bec748ffdfb413688a15774...266c0bb23e9d64c47ace4d162e582febd5a1e336,3,22,20,42,9,2013-05-20 15:50:40,2013-05-20 15:45:24
266c0bb23e9d64c47ace4d162e582febd5a1e336...4280217f31fc634d320b0cf30bcb6d582b19d784,3,22,2,24,3,2013-05-20 16:13:21,2013-05-20 16:13:03
4280217f31fc634d320b0cf30bcb6d582b19d784...888c86dcf30defe533451bcefc6e09a6e181389f,2,18,16,34,11,2013-05-20 16:59:37,2013-05-18 16:04:45
888c86dcf30defe533451bcefc6e09a6e181389f...490672f057cf1660606eeb14ef7f833ecff3df32,1,7,13,20,4,2013-05-20 17:45:32,2013-05-20 17:45:32
490672f057cf1660606eeb14ef7f833ecff3df32...2fd61285d109a04bf22d1822e834cbb7bcf4239f,1,3,3,6,3,2013-05-20 17:56:19,2013-05-20 17:56:19
2fd61285d109a04bf22d1822e834cbb7bcf4239f...4ba1c2e785feecfa7a47aa5336a2b595f086a765,4,61,5,66,7,2013-05-20 19:29:51,2013-04-15 13:54:37
a47116cb4c545b72f70ff61f192d59fd2e93fdad...175a102ddceae2ebd1a4e03916a23adafc35bda5,2,27,1,28,3,2013-06-09 16:13:43,2013-06-06 18:15:26
175a102ddceae2ebd1a4e03916a23adafc35bda5...4e94c84e50b960405d5708d8d9528c44c7dabe83,3,16,0,16,3,2013-06-09 19:05:15,2013-06-09 19:05:15
4e94c84e50b960405d5708d8d9528c44c7dabe83...96c71d423db13825869a929b25d6b83dde67c170,2,20,0,20,2,2013-06-09 19:08:29,2013-06-09 19:07:23
96c71d423db13825869a929b25d6b83dde67c170...7a65c95d42af421e036c5348f205128dd455a89c,2,18,7,25,8,2013-06-10 09:16:15,2013-06-04 05:55:20
7a65c95d42af421e036c5348f205128dd455a89c...13b7f299de79e3eb101c3f015386eba39a8f3928,7,44,25,69,16,2013-06-10 09:21:54,2013-06-09 19:04:36
13b7f299de79e3eb101c3f015386eba39a8f3928...4daf570b98cc840e1a154f3876bc7463924cb9ae,6,127,31,158,27,2013-06-10 09:24:10,2013-06-04 06:13:36
4daf570b98cc840e1a154f3876bc7463924cb9ae...c6e6d4eeb776c473567362405cdbc6a0328eb194,26,142,2,144,44,2013-06-10 09:30:01,2013-06-04 06:09:29
c6e6d4eeb776c473567362405cdbc6a0328eb194...dfcce4288ac6887e9995c48f2fde38f555cec03e,4,15,5,20,9,2013-06-10 10:11:46,2013-06-10 10:11:46
dfcce4288ac6887e9995c48f2fde38f555cec03e...f5d4849cbeda994e7d2e43c4aaf2aac69d5c95bb,5,215,206,421,139,2013-06-10 10:22:40,2013-06-10 10:22:40
f5d4849cbeda994e7d2e43c4aaf2aac69d5c95bb...af70dfcf317fd045df69917baca7bc0c58e2fd32,8,428,433,861,113,2013-06-10 10:34:47,2013-06-10 10:24:45
a643e4d200e12d1570174fec343a27d6bc47f735...584bd14dcfdee9585fec7794d53ce120ea73d0bc,8,77,34,111,23,2013-06-10 18:23:15,2012-06-08 13:32:35
584bd14dcfdee9585fec7794d53ce120ea73d0bc...9ff5f100ddf6c77d12327a5d19c984e1d4a46b56,2,2,2,4,2,2013-06-10 18:36:40,2013-06-10 18:36:40
0d81fd0e5f44432cbd1efb9b0e655116427dee6e...2456ffa42c33d63b54579eae0f5b9cf2a8cd3714,14,25,164,189,27,2013-07-14 17:02:55,2013-07-13 17:29:11
2456ffa42c33d63b54579eae0f5b9cf2a8cd3714...862a04a56d61238c8a9a159ce47d0fc879559a5c,1,12,7,19,7,2013-07-15 15:31:06,2013-07-15 15:31:06
faabf3614e27c2b616bf4730272fafa9627652d8...1b12e248ea556789e994caa8d3849f4de6a9096e,1,15,14,29,4,2013-03-11 21:19:48,2013-03-11 21:16:37
1b12e248ea556789e994caa8d3849f4de6a9096e...bc7a10299f7ad7f468fa78d5990b7b545d4d599d,1,7,10,17,4,2013-03-11 21:30:23,2013-03-11 02:50:18
bc7a10299f7ad7f468fa78d5990b7b545d4d599d...a50e0c9fdc563bba2ea2e14115c412100f2fd8b2,1,12,14,26,4,2013-03-11 21:40:13,2013-03-11 21:37:23
a50e0c9fdc563bba2ea2e14115c412100f2fd8b2...94521f50aa765b9187674f4c6876360a0d6f87d8,1,3,3,6,1,2013-03-11 21:48:03,2013-03-11 21:48:03
94521f50aa765b9187674f4c6876360a0d6f87d8...f8a634afa2b5810a7bfc17868ca216d277f0f24b,1,10,4,14,4,2013-03-11 22:30:02,2013-03-11 22:30:02
f8a634afa2b5810a7bfc17868ca216d277f0f24b...7e26f4cb799d67ffeae41cbe98d034d01783800a,1,1,1,2,1,2013-03-12 01:09:21,2013-03-12 01:09:21
7e26f4cb799d67ffeae41cbe98d034d01783800a...4846e2b744f4a376f9c364a90c5a852312a0ceaf,1,2,4,6,1,2013-03-12 09:09:04,2013-03-12 09:08:06
4846e2b744f4a376f9c364a90c5a852312a0ceaf...885d98d24ac842708347c36644c61fc323c081ec,2,13,1,14,3,2013-03-12 09:52:16,2013-03-12 09:52:16
885d98d24ac842708347c36644c61fc323c081ec...e1bafdbffa6e8b13db12c995eaa53508e047c83c,1,6,3,9,1,2013-03-12 12:04:32,2013-03-12 12:04:32
e1bafdbffa6e8b13db12c995eaa53508e047c83c...679af4058dae8a54438d95ceb943f449e78448c1,1,10,2,12,4,2013-03-12 13:05:10,2013-03-12 10:28:01
679af4058dae8a54438d95ceb943f449e78448c1...d744c550d51955fd623897884446b7f34318e94d,9,79,105,184,28,2013-03-12 19:33:47,2013-03-01 23:06:56
d744c550d51955fd623897884446b7f34318e94d...d3f00bd5706b35961390d3814dd7e322ead3a9a3,14,513,219,732,79,2013-03-13 08:44:49,2012-05-24 21:27:24
d3f00bd5706b35961390d3814dd7e322ead3a9a3...747f7d25490abc3d7fdb119f0ce3708d450eb4c2,2,19,12,31,4,2013-03-13 08:52:33,2013-03-13 08:50:45
747f7d25490abc3d7fdb119f0ce3708d450eb4c2...bd0cba58aafe582526086de86136060cedde38cf,1,3,3,6,3,2013-03-13 10:44:24,2013-03-13 10:44:24
bd0cba58aafe582526086de86136060cedde38cf...83a416f5e764705ed553f3513bdf9587270554c6,5,106,114,220,27,2013-03-13 14:17:40,2013-03-13 13:08:32
83a416f5e764705ed553f3513bdf9587270554c6...93af822c001b393299b4c5dc58abcd98f6e1e2e8,1,8,2,10,4,2013-03-13 14:17:40,2013-03-13 13:54:44
93af822c001b393299b4c5dc58abcd98f6e1e2e8...5d8342f321c1e1017e63555270999c9378f10185,3,42,45,87,18,2013-03-13 14:17:41,2013-03-13 13:47:48
fd8d7db4d7f5329fc2e2b348fc60ed6e81d47b13...77f6b468e5b3a389b3e56e1e1f70a56e8a0a68fa,1,2,2,4,1,2013-09-24 13:41:12,2013-09-24 13:41:12
77f6b468e5b3a389b3e56e1e1f70a56e8a0a68fa...9a041807fcde7ff7245696a743196d31ec7c7b5c,2,11,1,12,2,2013-09-24 14:10:08,2013-09-24 00:52:58
9a041807fcde7ff7245696a743196d31ec7c7b5c...5d74853e156105ea02a41f4731346dbe272c2412,3,17,145,162,36,2013-09-24 19:01:21,2013-09-21 13:34:45
5d74853e156105ea02a41f4731346dbe272c2412...68540fe4df44492571bc610a0a043d3d02b3d320,1,7,3,10,2,2013-09-24 19:06:26,2013-09-17 20:59:56
68540fe4df44492571bc610a0a043d3d02b3d320...9027da65d3590a3bd319490d78c86ef09cd04f9e,1,1,1,2,1,2013-09-24 20:00:31,2013-09-24 20:00:31
9027da65d3590a3bd319490d78c86ef09cd04f9e...05656f2388b1989c9e99e1ff2aae8b2e1c805af2,2,61,0,61,3,2013-09-25 12:47:46,2013-09-25 12:47:46
05656f2388b1989c9e99e1ff2aae8b2e1c805af2...3b810c5656774b4e1a89fd69ff26935e0a5833d2,5,79,3,82,9,2013-09-25 12:58:07,2013-09-25 12:58:07
3b810c5656774b4e1a89fd69ff26935e0a5833d2...8a3e543f268ba027a631274d1cfe44db64ad9025,3,25,5,30,8,2013-09-25 13:37:44,2013-09-25 13:37:44
8a3e543f268ba027a631274d1cfe44db64ad9025...fe9f342d8ceae96a03295e56ec743ed2e2e5fb51,2,29,11,40,4,2013-09-25 15:10:43,2013-09-25 15:10:43
fe9f342d8ceae96a03295e56ec743ed2e2e5fb51...f671fb9d1182afd15d471bf05639052cc8a7cde7,1,10,0,10,1,2013-09-25 15:11:05,2013-09-25 15:11:05
f671fb9d1182afd15d471bf05639052cc8a7cde7...15ed75d6329fae75bb0b1ec734718fbae72f7ff7,1,3,2,5,2,2013-09-25 15:39:38,2013-09-25 15:39:38
15ed75d6329fae75bb0b1ec734718fbae72f7ff7...6d3faba2d28f07f8cd7cf7aa91a6f8a555021d4f,1,21,5,26,5,2013-09-25 16:21:20,2013-09-25 16:20:06
6d3faba2d28f07f8cd7cf7aa91a6f8a555021d4f...42b9feb2e79546e1d4362c3a4f0043f3c569ace3,1,2,2,4,1,2013-09-25 16:24:30,2013-09-25 16:20:33
42b9feb2e79546e1d4362c3a4f0043f3c569ace3...83554b018ef283827c0e7459ab934d447b3419d5,3,21,4,25,5,2013-09-25 17:47:57,2013-09-23 15:18:20
83554b018ef283827c0e7459ab934d447b3419d5...04a2a6b0f9cb6bb98edfe84bf4361216d60a4e38,6,262,91,353,17,2013-09-25 18:15:59,2013-09-18 17:31:07
04a2a6b0f9cb6bb98edfe84bf4361216d60a4e38...99c87f1410106ce543a1a0332428afc472beef7f,6,85,1,86,8,2013-09-25 18:47:26,2013-09-24 00:17:59
99c87f1410106ce543a1a0332428afc472beef7f...6c06adad1dc45631c1c220d7f8fb531a9cf3ed55,2,20,2,22,2,2013-09-25 20:17:22,2013-09-23 11:07:26
6c06adad1dc45631c1c220d7f8fb531a9cf3ed55...209de62d220baa3b4c7db582349a7a3765901a68,1,6,6,12,6,2013-09-26 04:03:57,2013-09-26 04:03:57
209de62d220baa3b4c7db582349a7a3765901a68...d5606b57637f00c4349732d79541faa41acfe29c,1,18,3,21,5,2013-09-26 10:11:43,2013-09-23 15:04:48
d5606b57637f00c4349732d79541faa41acfe29c...59582a811913466784f90506619882a0555e022e,1,1,0,1,1,2013-09-26 13:55:19,2013-09-26 13:52:13
59582a811913466784f90506619882a0555e022e...48f657aa29a906be132f048319b2d75416dd22ab,1,3,2,5,1,2013-09-26 21:46:06,2013-09-26 21:46:06
48f657aa29a906be132f048319b2d75416dd22ab...90cd676d291c8e4bb064611e0df8ea98ef47bb59,1,3,3,6,1,2013-09-27 04:08:48,2013-09-27 04:08:48
90cd676d291c8e4bb064611e0df8ea98ef47bb59...3754f4ad410640382f9fe25073da03009cdc2ea3,2,15,2,17,3,2013-09-27 15:00:42,2013-09-27 15:00:42
3754f4ad410640382f9fe25073da03009cdc2ea3...8a4f5de4b69aade70cfe651079189a82a55fd1d5,1,1,0,1,1,2013-09-27 17:58:41,2013-09-27 17:58:41
8a4f5de4b69aade70cfe651079189a82a55fd1d5...8f51ba669aba94eea684ea3f3429fd8e39e70679,2,16,6,22,8,2013-09-27 22:40:43,2013-09-27 22:40:43
8f51ba669aba94eea684ea3f3429fd8e39e70679...1a63092981c685214ea189a14007da7bcc823c17,14,68,12,80,25,2013-09-28 08:55:32,2013-09-28 08:22:46
1a63092981c685214ea189a14007da7bcc823c17...47e79bfcfb65c5e7bb4e4402c593ac40def6efb4,1,1,3,4,3,2013-09-28 11:18:37,2013-09-28 11:06:40
47e79bfcfb65c5e7bb4e4402c593ac40def6efb4...783620ccc827057d1d0f2c6f4808350be9193bf9,1,5,1,6,1,2013-09-28 20:32:23,2013-09-28 00:45:25
783620ccc827057d1d0f2c6f4808350be9193bf9...5866a49369cc6a4280b25a9d1834ceababf61d88,1,3,0,3,1,2013-09-28 23:32:55,2013-09-28 23:28:32
5866a49369cc6a4280b25a9d1834ceababf61d88...a834bc84d8c76d4a7016ac4db4f631a8bcaa3d0b,3,49,6,55,4,2013-09-29 00:25:32,2013-09-26 15:28:26
a834bc84d8c76d4a7016ac4db4f631a8bcaa3d0b...b0e06c36622257fc3943f3c565bdcf04bb03c732,1,37,8,45,7,2013-09-29 14:35:42,2013-09-25 21:14:33
b0e06c36622257fc3943f3c565bdcf04bb03c732...c4fdd859ecba0b8e6dac6eca06429e66925722bd,2,21,2,23,4,2013-09-29 20:45:03,2013-09-29 17:02:25
c4fdd859ecba0b8e6dac6eca06429e66925722bd...12ca312e1bc2cab614aed854b4c38dd86fefbdda,1,4,3,7,1,2013-09-30 01:44:55,2013-09-29 17:26:03
12ca312e1bc2cab614aed854b4c38dd86fefbdda...9595183d03cfd0d94ae2dd506a3d2b86cf5c74a7,5,303,24,327,25,2013-09-30 05:05:43,2013-09-30 05:05:43
9595183d03cfd0d94ae2dd506a3d2b86cf5c74a7...728548e483a5a3486939b0c8e62520296587482e,14,157,100,257,52,2013-09-30 07:42:27,2013-09-22 20:14:17
728548e483a5a3486939b0c8e62520296587482e...c39c9f2ad8b2670d53ef845face67c29f3f4be3b,1,7,5,12,2,2013-09-30 14:19:56,2013-09-30 10:44:41
c39c9f2ad8b2670d53ef845face67c29f3f4be3b...f93896344abfdfd288e0d8249b37e2b799fd7d53,1,16,16,32,16,2013-09-30 14:28:01,2013-09-30 14:28:01
f93896344abfdfd288e0d8249b37e2b799fd7d53...2004f86b858b809101c8cc442383ac90756e306e,1,1,0,1,1,2013-09-30 17:19:53,2013-09-30 16:51:06
2004f86b858b809101c8cc442383ac90756e306e...4745ea1d27a154a44ed2cacb66b01d5de1f9e3d3,1,2,2,4,1,2013-09-30 18:16:17,2013-09-30 18:16:17
4745ea1d27a154a44ed2cacb66b01d5de1f9e3d3...d847ddfe1d4475e768c547b17642d3ed0894d54e,4,49,2,51,9,2013-09-30 19:43:44,2013-09-30 03:21:21
b036baa9902395cf913e26bcc6d5490f562e9a40...b7d3b057f32ed6aa7ee0941e1f0dec9d3e9223a3,1,5,0,5,1,2012-09-08 10:56:07,2012-09-08 10:56:07
11c7ec79938493c2123bad4aa155a2bde251fe62...01820466ca1e2425c6a5535402b36251c5e5dae5,1,2,2,4,1,2013-05-11 20:42:39,2013-05-11 20:41:34
01820466ca1e2425c6a5535402b36251c5e5dae5...a6edde326057c0bf2e7cf8929ba8f238a7fd2b41,1,2,2,4,1,2013-05-11 20:57:01,2013-05-11 20:57:01
a6edde326057c0bf2e7cf8929ba8f238a7fd2b41...679a2ac843567d32c95ccc46a215bc453ccfa2d0,2,77,70,147,20,2013-05-11 23:08:57,2013-05-11 23:08:57
679a2ac843567d32c95ccc46a215bc453ccfa2d0...2c62a509deb50e39375b0cd44cfc85a743978fdc,2,41,4,45,2,2013-05-11 23:34:02,2013-05-11 23:34:02
1708c8afb6f07417da192bae93a828065858fb3c...d258cce48238678a606b82287c245576249147cb,1,1,1,2,1,2013-05-14 10:40:33,2013-05-14 10:40:33
1708c8afb6f07417da192bae93a828065858fb3c...8f0a4665d67868dce2e204dd592b0f133edf7943,3,8,8,16,7,2013-05-14 03:49:00,2013-05-14 03:39:50
63f6ee817ec281b14e1a5fbcdc356cfcab67280b...cde820bd31e810d61cc2c9b09cc2ec7d5ddbf165,1,2,2,4,2,2013-05-16 08:11:46,2013-05-16 08:06:42
63f6ee817ec281b14e1a5fbcdc356cfcab67280b...746d3166d6fec63795ba7a3805fc2fa022367810,1,1,1,2,1,2013-05-16 07:21:18,2013-05-16 07:21:18
4ba1c2e785feecfa7a47aa5336a2b595f086a765...e24d486fbc0b1c42abe8b54217ff428e449c48cc,2,40,5,45,4,2013-05-21 07:49:21,2013-05-21 05:17:56
4ba1c2e785feecfa7a47aa5336a2b595f086a765...0594fed9ffd6cf6e10475488934cb02d9263829e,2,26,2,28,5,2013-05-20 23:28:16,2013-05-20 22:41:23
4ba1c2e785feecfa7a47aa5336a2b595f086a765...a542b808baf49ede4d40b2893f1bb74cd60d56f6,1,3,12,15,2,2013-05-20 22:53:40,2013-05-20 20:50:54
9ff5f100ddf6c77d12327a5d19c984e1d4a46b56...52f99b78bcc36c4dfdd2870ee139cd5461fb9e91,1,2,2,4,1,2013-06-11 10:40:06,2013-06-11 10:40:06
862a04a56d61238c8a9a159ce47d0fc879559a5c...aff0aa3af81b13e611c08000ae0c1f1d840b6c3c,1,7,5,12,3,2013-07-16 10:17:08,2013-07-16 10:14:16
5d8342f321c1e1017e63555270999c9378f10185...4fa7f3cdd9bcf50ec4c7f64a31c1dfc02c375f46,2,6,1,7,2,2013-03-13 17:19:29,2013-03-13 17:19:29
5d8342f321c1e1017e63555270999c9378f10185...bd68f701b1867e0a9cf17d7f0948ba493d11b7e5,1,2,2,4,2,2013-03-13 17:16:27,2013-03-13 17:16:27
d847ddfe1d4475e768c547b17642d3ed0894d54e...d9bbda7149416ae72a6e5489d0095a3f25b97793,1,1,1,2,1,2013-09-30 20:59:45,2013-09-30 20:59:45
b7d3b057f32ed6aa7ee0941e1f0dec9d3e9223a3...571698997f0ce3f362ee684754447e2e8a177863,1,3,3,6,3,2012-09-08 16:30:41,2012-09-08 16:30:41
b7d3b057f32ed6aa7ee0941e1f0dec9d3e9223a3...e69348b4e7f07ef927edaecc7126901fc91c79d0,8,34,23,57,20,2012-09-08 15:00:04,2012-09-08 15:00:04
2c62a509deb50e39375b0cd44cfc85a743978fdc...956973ca6c47219d5dc3c645bc34af8fb58b8f24,2,6,16,22,4,2013-05-12 20:29:34,2013-05-12 20:29:34
2c62a509deb50e39375b0cd44cfc85a743978fdc...b9efc03e6d9cf602203d4808d4e171e19014a25f,1,1,1,2,1,2013-05-12 19:24:48,2013-05-12 19:24:48
da9d626be0ae3ab7d516083936e23aa7f3684e4a...0a29057ebea4335d503e373e4526b1c62c15bcdc,1,1,1,2,1,2013-05-16 11:48:38,2013-05-16 11:48:38
0a29057ebea4335d503e373e4526b1c62c15bcdc...b5b63079bd758c4492ab6b6935edec3346016f25,1,4,3,7,1,2013-05-16 12:09:20,2013-05-16 09:55:21
b5b63079bd758c4492ab6b6935edec3346016f25...79715f267c7b301dc246b35182ede3e269a15aa2,1,1,1,2,1,2013-05-16 12:37:20,2013-05-16 12:37:20
79715f267c7b301dc246b35182ede3e269a15aa2...9ef4d177d1d501be44b6e1c87197fef1e26900f1,1,7,2,9,3,2013-05-16 13:00:16,2013-05-16 12:01:39
9ef4d177d1d501be44b6e1c87197fef1e26900f1...289afc3156356a60bb7d2dcb7084add0aa03b2df,1,1,1,2,1,2013-05-16 13:56:30,2013-05-16 13:56:30
289afc3156356a60bb7d2dcb7084add0aa03b2df...0732c8e8c6e156d4d9a4a1cc02d631fe41342bf8,2,22,1,23,4,2013-05-16 15:41:52,2013-05-06 10:45:56
0732c8e8c6e156d4d9a4a1cc02d631fe41342bf8...1bc6e18b4e8e35a0a2d28cff8a0eb88bb99ee0e8,1,5,7,12,2,2013-05-16 17:36:50,2013-05-16 17:36:50
1bc6e18b4e8e35a0a2d28cff8a0eb88bb99ee0e8...d4d114563280b6e202b8459be0aa471621c7b563,1,0,3,3,1,2013-05-16 17:37:48,2013-05-16 17:37:48
d4d114563280b6e202b8459be0aa471621c7b563...b16b72d415808073da0418de93bf32f71ead959d,12,931,20,951,35,2013-05-17 11:33:40,2013-03-16 10:39:18
b16b72d415808073da0418de93bf32f71ead959d...10e397e2631f8b4c3be486dfc922a91c4512684d,1,5,0,5,2,2013-05-17 14:14:23,2013-05-17 14:11:11
10e397e2631f8b4c3be486dfc922a91c4512684d...31d98d4ab55f44b5c3c446c2c51df6490ed6c0d0,2,12,1,13,3,2013-05-17 15:24:17,2013-05-17 13:51:13
31d98d4ab55f44b5c3c446c2c51df6490ed6c0d0...b1bfd9630ef049070b0cd6ae215470d3d1facd40,1,1,2,3,2,2013-05-17 15:59:06,2013-05-17 15:59:06
b1bfd9630ef049070b0cd6ae215470d3d1facd40...9c487b5974ee7e7f196079611d7352364e8873ed,30,49,43,92,41,2013-05-17 16:08:58,2013-05-17 14:33:36
9c487b5974ee7e7f196079611d7352364e8873ed...c6964feb54a15e87de5e0390d07fe5fff69729c7,1,4,6,10,3,2013-05-17 16:15:08,2013-05-17 16:15:08
c6964feb54a15e87de5e0390d07fe5fff69729c7...0509462373187948fa51366cf4e189c60d6d6688,1,3,2,5,2,2013-05-17 16:25:40,2013-05-17 15:57:46
0509462373187948fa51366cf4e189c60d6d6688...838f28974e0711f4184798ba5e54ad725bc112f0,1,1,1,2,2,2013-05-17 16:31:52,2013-05-17 16:29:41
838f28974e0711f4184798ba5e54ad725bc112f0...9666874ee180cfe02229e5f7f6488e367df246a9,1,22,18,40,9,2013-05-17 16:40:50,2013-05-17 14:12:49
9666874ee180cfe02229e5f7f6488e367df246a9...f54a8880d78f4b0b37371b0b295b2b1e73c8b67f,1,12,0,12,1,2013-05-17 20:01:41,2013-05-17 20:01:41
18856f866cc0e1cc703ae3f4c84b3c25a847b370...09f865276554f35060ff939722ec4cefd578edf6,31,87,87,174,74,2013-05-21 09:42:15,2013-05-21 09:42:15
51739c624185b4b45877f521ed5015f2fe01b6e8...536703abf029ac1b9c2ebcf6f82fb16da524bebe,1,7,1,8,2,2013-06-11 16:25:39,2013-06-11 16:25:39
536703abf029ac1b9c2ebcf6f82fb16da524bebe...64041f0e6e7a773574d7cde978d16305200004ea,4,27,2,29,5,2013-06-11 18:13:40,2013-05-05 14:44:19
64041f0e6e7a773574d7cde978d16305200004ea...78974ed525a9aa6e6b78c59f3e84df3fdbfc6fa6,1,1,0,1,1,2013-06-11 20:39:53,2013-06-11 20:37:59
78974ed525a9aa6e6b78c59f3e84df3fdbfc6fa6...92c49d6f01700961698eb3d79fd393d673cee219,4,2,27,29,5,2013-06-11 21:55:19,2013-06-11 21:54:56
51739c624185b4b45877f521ed5015f2fe01b6e8...b79aa796d8fe0d28778605b6b294e3e3a3f9ca65,1,1,2,3,1,2013-06-11 15:05:19,2013-06-11 15:05:19
ce5c8a392f2f0e08d2d100c369ae28a3e86f4efc...fba6c2ede7b25ed8c71a18dede00865dbc5b85af,1,83,52,135,10,2013-07-16 23:20:53,2013-07-16 19:27:52
fba6c2ede7b25ed8c71a18dede00865dbc5b85af...2333c9662b5ffbaec5a10fa2973b4e6e7b0555bd,7,30,17,47,13,2013-07-16 23:32:30,2013-07-16 17:21:17
2333c9662b5ffbaec5a10fa2973b4e6e7b0555bd...a3242dc9fed8959586e223badca1e27bb43f092a,1,1,1,2,1,2013-07-17 10:50:40,2013-07-17 10:50:40
a3242dc9fed8959586e223badca1e27bb43f092a...828359e52dd8f190a577442a88517e1ba9ba8da0,1,4,4,8,4,2013-07-17 13:32:14,2013-07-17 13:32:14
828359e52dd8f190a577442a88517e1ba9ba8da0...a3e7d73ed7d90d31de46c60d40424267f62e411c,7,146,99,245,16,2013-07-17 17:32:32,2013-07-16 11:11:32
1059da8de675442e84381d6366c0be254681753e...22b7870e40a3ecf022b423de6cd867dcb35a6940,5,205,215,420,139,2013-03-13 22:25:26,2013-03-13 22:25:26
e4d9f8aed11e964885cd77f8abd01ba0dfa4aa13...50eb70b08fae48445a52680b2d07a9535b25e3c5,1,8,0,8,1,2013-03-13 22:14:26,2013-03-13 22:11:35
f8c7c8f27b061b65d2dec98510bb9e76e1547791...186bff47032a264b4b4cbb06a6f277046bb10c26,1,1,0,1,1,2013-03-15 14:15:52,2013-03-15 14:15:52
2b6bb321ba03c837daaf49c9a931ad2bd792aba5...4372718e839d15c707d50cc78274a355258cf36a,1,4,1,5,1,2013-10-01 01:14:54,2013-09-30 22:22:26
4372718e839d15c707d50cc78274a355258cf36a...d64060a73650360dcabfdb4928a9e92d090925b1,1,2,2,4,2,2013-10-01 07:56:13,2013-10-01 07:56:13
d64060a73650360dcabfdb4928a9e92d090925b1...c1c44b25062c3a793ac0d8416f369383a4a58cb4,3,17,29,46,11,2013-10-01 11:20:41,2013-10-01 07:27:31
c1c44b25062c3a793ac0d8416f369383a4a58cb4...b66a51ad545ac726ef98966cbc35ee7aefdff8cd,1,1,1,2,1,2013-10-01 14:08:36,2013-10-01 14:08:36
b66a51ad545ac726ef98966cbc35ee7aefdff8cd...32e40bbe7115a14947421f9380e64cf34254f86d,1,3,7,10,2,2013-10-01 14:39:03,2013-10-01 14:39:03
32e40bbe7115a14947421f9380e64cf34254f86d...8d4b1629d4434b8b30078d064e74689ca8906f37,2,35,1,36,3,2013-10-01 16:29:48,2013-10-01 16:27:20
8d4b1629d4434b8b30078d064e74689ca8906f37...0d02c5429970804068520f0dc6f0ae9fb3e08b9c,1,2,0,2,2,2013-10-01 16:34:25,2013-10-01 16:34:19
0d02c5429970804068520f0dc6f0ae9fb3e08b9c...bf13c75c0d94d606b8a077ff73bbd0440f05b396,3,20,4,24,4,2013-10-01 17:29:23,2013-10-01 08:07:41
bf13c75c0d94d606b8a077ff73bbd0440f05b396...8c27247397cf16b17d0153ae059593c5a468de01,1,1,1,2,1,2013-10-01 17:36:06,2013-10-01 17:26:19
8c27247397cf16b17d0153ae059593c5a468de01...bf757a2f4dad519fac1b4a458376de3a040f5ca8,7,41,17,58,17,2013-10-01 17:42:59,2013-09-23 16:40:19
bf757a2f4dad519fac1b4a458376de3a040f5ca8...1d0fc61b1cadee584a27dbbe3ef3e21fd3202c85,8,83,26,109,20,2013-10-01 18:25:54,2013-09-06 18:25:13
1d0fc61b1cadee584a27dbbe3ef3e21fd3202c85...4b715fc05a75c375d5afe1860ce748ae2a2e290b,2,27,5,32,7,2013-10-01 23:37:43,2013-10-01 23:23:36
4b715fc05a75c375d5afe1860ce748ae2a2e290b...43959d1057f882e680545acd17e91c05691f177b,1,1,1,2,1,2013-10-02 00:02:42,2013-10-02 00:02:42
43959d1057f882e680545acd17e91c05691f177b...0f46ec315ea079ed1bd01d30e6e0ebec0f405c7f,1,11,1,12,3,2013-10-02 10:17:08,2013-10-02 09:57:56
0f46ec315ea079ed1bd01d30e6e0ebec0f405c7f...651bed09182cc7f2fadc54026924fd5815fc47f1,1,3,3,6,3,2013-10-02 10:29:40,2013-10-02 02:59:19
651bed09182cc7f2fadc54026924fd5815fc47f1...5381317fe37d50384ef9a3bf3fb6b64ff4e9215c,2,16,0,16,2,2013-10-02 12:16:09,2013-09-25 21:00:51
5381317fe37d50384ef9a3bf3fb6b64ff4e9215c...978e1351a60a0d7b44d367877784109ac01ebc62,2,20,7,27,8,2013-10-02 13:12:58,2013-09-19 21:02:49
978e1351a60a0d7b44d367877784109ac01ebc62...00a0d3de0204f73d3f05ae99548b1e317bfe336b,1,6,2,8,1,2013-10-02 14:15:18,2013-10-02 14:15:18
00a0d3de0204f73d3f05ae99548b1e317bfe336b...e1b77238171cc96f4451a06fb4682e2378896238,6,6,6,12,6,2013-10-02 14:41:04,2013-10-02 14:41:04
e1b77238171cc96f4451a06fb4682e2378896238...75bb6ba96660e2a06e18d99120c05db2bb9fa9cc,2,13,10,23,3,2013-10-02 16:12:53,2013-10-02 16:12:53
75bb6ba96660e2a06e18d99120c05db2bb9fa9cc...a80d9ab0fe25abdf80fd78849ddf5dd977f14316,5,237,0,237,6,2013-10-02 16:34:22,2013-10-02 16:33:41
a80d9ab0fe25abdf80fd78849ddf5dd977f14316...1285ca67eba96045b4f6fe6f5c7fd6570571f1bd,3,20,2,22,4,2013-10-02 17:28:15,2013-10-02 17:28:15
1285ca67eba96045b4f6fe6f5c7fd6570571f1bd...62dfd79f8b4a1f7e702809cc21ce262f19da0f5b,1,13,1,14,3,2013-10-03 02:29:48,2013-10-02 22:34:38
62dfd79f8b4a1f7e702809cc21ce262f19da0f5b...c4db7f075e269411287ff14b5518412250ba455f,2,82,2,84,26,2013-10-03 13:37:49,2013-09-26 18:25:30
c4db7f075e269411287ff14b5518412250ba455f...fa2e1371cda1e72d82b4133ad0b49a18e43ba411,4,34,10,44,18,2013-10-03 17:20:05,2013-08-20 05:52:32
fa2e1371cda1e72d82b4133ad0b49a18e43ba411...7a97df190cb993056aa097befb3813100cfc286e,4,30,1,31,7,2013-10-03 20:15:29,2012-11-17 12:14:12
7a97df190cb993056aa097befb3813100cfc286e...36e220f923e0c355c9b0388131f87fbfaf46ac5f,1,1,1,2,1,2013-10-04 00:13:33,2013-10-04 00:13:22
36e220f923e0c355c9b0388131f87fbfaf46ac5f...8b0014869f666b44cd20692e38073ec0a0a8cb08,4,83,9,92,10,2013-10-04 11:36:39,2013-05-20 19:22:38
8b0014869f666b44cd20692e38073ec0a0a8cb08...3895d8899d7a01f2bdb1c206e45d8578a9739c91,18,161,68,229,62,2013-10-04 14:00:36,2013-10-03 22:51:22
3895d8899d7a01f2bdb1c206e45d8578a9739c91...bcd4c3f27d5bcf701337ac7c74c042d90792bdc3,3,58,5,63,6,2013-10-04 17:27:08,2013-06-18 00:10:21
bcd4c3f27d5bcf701337ac7c74c042d90792bdc3...dc3d2ac98c1bcfad74d3e9523caf07e7e9fb15aa,6,95,3,98,10,2013-10-04 18:08:06,2013-02-23 17:57:48
dc3d2ac98c1bcfad74d3e9523caf07e7e9fb15aa...948d209adac566d89f44f073fdd77a371c18e269,5,71,26,97,44,2013-10-04 20:23:06,2013-10-03 17:44:10
948d209adac566d89f44f073fdd77a371c18e269...20472aa827669d2b83b74e521504e88e18d086a1,17,39,39,78,34,2013-10-05 09:50:03,2013-09-30 15:55:14
20472aa827669d2b83b74e521504e88e18d086a1...ed0d720b78c8f1c655ead0057d767a0712f1a6a8,2,30,2,32,3,2013-10-05 11:52:17,2013-09-24 15:23:02
ed0d720b78c8f1c655ead0057d767a0712f1a6a8...ecaba3602837d1e02fe1e961f7d3bf9086453259,4,136,52,188,28,2013-10-05 11:52:17,2013-09-24 16:37:55
ecaba3602837d1e02fe1e961f7d3bf9086453259...671757b507a60330ee37ef749a3f3a0301258f88,3,18,7,25,9,2013-10-05 16:50:20,2013-10-04 19:55:16
671757b507a60330ee37ef749a3f3a0301258f88...068b1e045f9b022495f662c80dd820aced116aec,1,7,10,17,5,2013-10-05 18:16:09,2013-10-05 18:15:25
068b1e045f9b022495f662c80dd820aced116aec...93cc6dcdac6fc3e506640fa38dd1798c3cd61cff,2,21,1,22,2,2013-10-05 18:40:36,2013-10-05 18:40:36
93cc6dcdac6fc3e506640fa38dd1798c3cd61cff...1df3c49a1a1c11198d181ddd0ce31bbb42e631d8,4,25,17,42,11,2013-10-05 20:07:52,2013-09-26 18:16:50
1df3c49a1a1c11198d181ddd0ce31bbb42e631d8...8d75d1e1bc6052f934b3fc066cd362dae75e99a3,1,2,1,3,1,2013-10-06 19:29:39,2013-10-06 19:28:17
8d75d1e1bc6052f934b3fc066cd362dae75e99a3...91547772e04e456f45c7ef86e1f76d087821c89d,1,7,3,10,3,2013-10-07 08:47:50,2013-10-07 08:47:50
91547772e04e456f45c7ef86e1f76d087821c89d...67f5dffbec366ed50264d32c25facd2681105258,1,3,0,3,1,2013-10-07 10:40:41,2013-10-07 10:40:41
67f5dffbec366ed50264d32c25facd2681105258...4dbd95ad65fa3fc86af7391b28a759b401f530d1,3,17,6,23,6,2013-10-07 13:39:14,2013-10-07 07:37:35
4dbd95ad65fa3fc86af7391b28a759b401f530d1...617aceb1b4ec97b4d70f9b3071cb46a645f69f87,4,43,2,45,8,2013-10-07 16:30:02,2013-10-07 16:30:02
617aceb1b4ec97b4d70f9b3071cb46a645f69f87...698dd82eee1cb83f51d4cd39546461bf76976b5e,2,57,3,60,3,2013-10-07 17:10:52,2013-10-07 14:48:19
698dd82eee1cb83f51d4cd39546461bf76976b5e...259a6ea82cfb8bf242449666e4b643a19e54a423,2,8,1,9,3,2013-10-07 17:39:40,2013-10-07 00:34:40
259a6ea82cfb8bf242449666e4b643a19e54a423...a8df8e34f9fc0219de73eabcb215d976e75a89ae,2,3,57,60,3,2013-10-07 17:45:52,2013-10-07 17:38:15
a8df8e34f9fc0219de73eabcb215d976e75a89ae...3eab22a0452f976727ba21b4b6e25dabba85111e,1,8,0,8,1,2013-10-07 18:29:58,2013-10-06 23:59:04
3eab22a0452f976727ba21b4b6e25dabba85111e...935001c4f1ab8660c76323854945e9e660514046,1,19,22,41,16,2013-10-07 18:49:20,2013-10-07 01:33:21
935001c4f1ab8660c76323854945e9e660514046...8ff43039466f5e3c78d3587fdbe229ed44c4e1aa,2,6,8,14,5,2013-10-08 02:00:39,2013-10-08 02:00:39
8ff43039466f5e3c78d3587fdbe229ed44c4e1aa...ddb53856b62506128a6d19184dfa80da73c77db8,7,37,8,45,9,2013-10-08 02:32:56,2013-10-08 02:32:56
ddb53856b62506128a6d19184dfa80da73c77db8...58d555caf527d6f1bdfeab14527484e4cca68648,3,16,6,22,6,2013-10-08 12:05:39,2013-10-08 12:05:39
58d555caf527d6f1bdfeab14527484e4cca68648...40b95a24ae159b6600457a23d6c2779a18037b7b,3,13,1,14,3,2013-10-08 12:24:58,2013-07-18 08:45:34
76bd33539f8a188c4b1770babe6d2b55e5030c68...20ee727ac9e0a374401473d90f055393944f197e,4,99,40,139,22,2012-09-08 18:11:45,2012-09-08 17:46:08
20ee727ac9e0a374401473d90f055393944f197e...6e2bb344e40dafdf462f6fb660837fa061faf549,1,8,0,8,1,2012-09-08 18:52:17,2012-09-08 18:52:17
6e2bb344e40dafdf462f6fb660837fa061faf549...4754f122dd9b41fc9b2dee3fa74e19fc384237ab,7,338,241,579,14,2012-09-08 19:09:37,2012-09-08 19:07:33
4754f122dd9b41fc9b2dee3fa74e19fc384237ab...3bdb65dc5959b62f910ca498cce19682e2db6308,1,5,5,10,5,2012-09-08 19:15:10,2012-09-08 19:15:10
3bdb65dc5959b62f910ca498cce19682e2db6308...d7853c55ed027cdffcda88205b9d5c16861a5bcb,1,4,6,10,4,2012-09-08 19:31:46,2012-09-08 19:25:57
e69348b4e7f07ef927edaecc7126901fc91c79d0...ccd1bb0d81381b5611fb5caf2c4ebe5927fe2095,5,37,4,41,9,2012-09-08 15:20:05,2012-09-08 15:18:08
e69348b4e7f07ef927edaecc7126901fc91c79d0...d823bb790d3b70e19e7f8bc7cfb11f3a1728a799,1,39,5,44,4,2012-09-08 15:19:49,2012-09-08 15:19:49
b1f74670cc9b575571f8820cad800fdfd99e9258...897e4eab6531cdbaf27c1b2a6716c86eb6ee1f5d,1,3,1,4,1,2013-05-13 17:43:28,2013-05-13 17:43:28
f54a8880d78f4b0b37371b0b295b2b1e73c8b67f...186ec21a3dd8c87704c579b6620da931e0f68bb3,2,16,0,16,3,2013-05-18 14:06:08,2013-05-18 14:06:08
f54a8880d78f4b0b37371b0b295b2b1e73c8b67f...ee11d325a426480a8549069b2d003bb8eec107f8,2,101,99,200,21,2013-05-18 08:29:01,2013-05-18 08:29:01
f54a8880d78f4b0b37371b0b295b2b1e73c8b67f...c278e56bafc8b2740f01e53fc5ce3650806c04ad,1,6,5,11,3,2013-05-17 23:49:33,2013-05-17 23:49:33
b632baac3c56101d59f6279767e5f3418643e425...b1ac241ddc8e496fae9bee5e88511d5698c18ca5,1,1,1,2,1,2013-05-21 11:03:25,2013-05-21 11:03:25
92c49d6f01700961698eb3d79fd393d673cee219...8821bcb2a0b4d9a049a5b645afa5080b640928e2,1,2,0,2,1,2013-06-12 08:50:37,2013-06-12 08:50:37
0938970491eee41ccde11bf3efe5b307ced8dba6...55cbd65985bfad02512a64a4cb8468140f15ee84,4,130,87,217,22,2013-06-12 18:01:41,2013-06-11 20:56:09
55cbd65985bfad02512a64a4cb8468140f15ee84...3ce1d303daa92ecb1bc3ba6344f1ec9746a79c70,4,37,9,46,7,2013-06-12 18:52:08,2013-06-03 13:53:04
a3e7d73ed7d90d31de46c60d40424267f62e411c...aa41eb9b8b2a12ffcaf81e48e3af331551ffa9e8,1,1,1,2,1,2013-07-19 08:48:38,2013-07-19 08:48:38
a3e7d73ed7d90d31de46c60d40424267f62e411c...3a0022918989edfcb8d73f484b1b900935300abe,1,1,4,5,1,2013-07-18 16:59:45,2013-07-18 16:59:45
a3e7d73ed7d90d31de46c60d40424267f62e411c...1131d4191f4819978dd4ca857593091c1703ccce,1,1,1,2,1,2013-07-18 10:37:01,2013-07-18 10:26:32
8a2f5300b21c3c20a9fc6829d9fcadb023cba4a8...6b4834952dcce0db5cbc1534635c00ff8573a6d8,7,178,112,290,17,2013-03-14 09:01:47,2012-11-29 10:10:31
6b4834952dcce0db5cbc1534635c00ff8573a6d8...9883551d50e105b324d8071232bf420935844e43,3,19,9,28,11,2013-03-14 13:49:07,2013-03-14 13:45:41
9883551d50e105b324d8071232bf420935844e43...b492e590746df51ddcdfa2a2372008455a457bcc,1,17,37,54,12,2013-03-14 13:59:45,2013-03-14 13:59:15
b492e590746df51ddcdfa2a2372008455a457bcc...34d098665d9423c0b70add5b8c8231fff9d0f774,2,2,1,3,2,2013-03-14 14:26:30,2013-03-14 14:25:27
34d098665d9423c0b70add5b8c8231fff9d0f774...2f121dfe635b3f497fe1fe03bc8eb97cdf5083b3,7,59,57,116,26,2013-03-14 16:03:43,2013-03-14 15:19:59
2f121dfe635b3f497fe1fe03bc8eb97cdf5083b3...3f2befc93163e0666dcc4f745288b98306de4b8e,12,156,46,202,13,2013-03-14 19:30:23,2013-03-14 19:28:24
3f2befc93163e0666dcc4f745288b98306de4b8e...2a2708e1b2a0e02fc4fdd4b050d60fb0033dfdde,1,17,0,17,2,2013-03-15 09:06:26,2013-03-15 08:55:12
2a2708e1b2a0e02fc4fdd4b050d60fb0033dfdde...d35ffcaaad9881d4dc1633f76cecc8ada4b31e2f,1,2,2,4,2,2013-03-15 11:50:15,2013-03-15 08:15:30
d35ffcaaad9881d4dc1633f76cecc8ada4b31e2f...7db4c81d5edb8e7681193d6c9c237e15fedf7ac3,1,9,0,9,1,2013-03-15 13:20:00,2013-03-15 13:20:00
a87ff951b6164784ecf6cae06d8a3fd5fa33ff23...18e990fa9639b5476b556c8de82717ebfc8b254e,3,17,18,35,9,2013-03-15 20:45:33,2013-03-15 20:45:33
18e990fa9639b5476b556c8de82717ebfc8b254e...0122a98dad6a7785def47466814ed2ae8d244143,1,2,1,3,1,2013-03-15 22:54:19,2013-03-15 22:54:19
a87ff951b6164784ecf6cae06d8a3fd5fa33ff23...957fcd0c9fc605bbb69e03296aede3b0bac5a8d2,1,2,2,4,1,2013-03-15 18:14:01,2013-03-15 18:14:01
40b95a24ae159b6600457a23d6c2779a18037b7b...43f213e475ec2f3b74b47adf72551df422b2f480,1,2,2,4,2,2013-10-08 14:21:45,2013-10-08 14:20:02
d7853c55ed027cdffcda88205b9d5c16861a5bcb...5d1f09f450686c53ead6f2784ba5c94ea6dccf36,1,116,60,176,8,2012-09-08 20:02:00,2012-09-08 20:02:00
5d1f09f450686c53ead6f2784ba5c94ea6dccf36...408c10e541440b078ccf5d6fcb3f344b7a94d048,1,60,60,120,3,2012-09-08 20:08:01,2012-09-08 20:08:01
408c10e541440b078ccf5d6fcb3f344b7a94d048...5c5226a52029ae75a27d6006528163a699ed0617,1,1,1,2,1,2012-09-08 20:14:13,2012-09-08 20:14:13
617d077f1f5be6cfb67a1f4f9ab0334f3c793e4c...3da43c11113e0ef109ffbecae528aef853879281,5,30,1,31,9,2012-09-08 16:13:46,2012-06-23 14:57:20
3da43c11113e0ef109ffbecae528aef853879281...7207327dd313522954da167f9a41396b97354c78,3,196,108,304,65,2012-09-08 16:22:39,2012-09-08 16:20:20
617d077f1f5be6cfb67a1f4f9ab0334f3c793e4c...210fd7c658a44e51f4696555b3ce71498db55d96,2,22,0,22,3,2012-09-08 15:58:48,2012-09-08 15:58:48
7d050e8e9ce0e08aefe035a7e203c764fbfb544b...63a9555d57069cee32de388821dbe580da1f97c0,4,48,40,88,10,2013-05-18 14:17:46,2013-05-18 11:09:38
1d3d04070e67c952170075cabcadcafc71c87213...9012a9e2000020493b881a5b79cc801c62180796,3,12,6,18,6,2013-05-18 08:40:16,2013-05-16 16:29:18
b1ac241ddc8e496fae9bee5e88511d5698c18ca5...cec9558fba1bc6401ea2ec6d71b816b4dfd31b28,3,44,3,47,6,2013-05-21 11:19:18,2013-05-21 11:03:45
b1ac241ddc8e496fae9bee5e88511d5698c18ca5...c28281f9d60b12e29481214348abc6084c31d77d,1,4,1,5,2,2013-05-21 11:18:53,2013-05-21 11:18:53
3ce1d303daa92ecb1bc3ba6344f1ec9746a79c70...81545940c68de0d1235a2fb50e61b8619f17a3e3,3,81,21,102,26,2013-06-14 14:31:11,2013-06-11 20:32:39
3ce1d303daa92ecb1bc3ba6344f1ec9746a79c70...cd7d7452bca41124b17355d4bf8be317a6d03dae,1,3,3,6,3,2013-06-13 12:59:13,2013-06-13 12:59:13
9a2715da8b4c196e1cccd3241f6f585da53359a6...2fc6c9472cd25910f978fe1d18de5c350370f901,5,24,11,35,14,2013-07-18 22:18:30,2013-07-18 19:17:40
bd92a12fae1e631b240aafb5c482088e512da331...fd95dc9e2719e5950f5339fbd48ea0819a6d8774,1,1,1,2,1,2013-07-18 11:58:51,2013-07-18 11:58:51
bd92a12fae1e631b240aafb5c482088e512da331...beefc9717119d7f287005a5f12f6398645f00f27,2,2,2,4,2,2013-07-18 11:53:54,2013-07-18 11:53:54
0122a98dad6a7785def47466814ed2ae8d244143...d5683bd06bdac923f73954020c760a4adb496be8,2,9,9,18,9,2013-03-16 18:48:40,2013-03-16 18:48:40
0122a98dad6a7785def47466814ed2ae8d244143...babd1090ee2a05ae0ec061dd08e70f2008db059b,1,0,2,2,1,2013-03-16 17:55:24,2013-03-16 17:55:24
7523e784633b7757fbc82df58f80b197eeed988a...a971d19bab9bfc33d301669b319b4766bf6d94f6,1,2,2,4,2,2013-10-09 01:06:23,2013-10-09 01:06:23
a971d19bab9bfc33d301669b319b4766bf6d94f6...24f99676195333aa345fb955cdc8d2d0cd08efa3,1,1,1,2,1,2013-10-09 09:53:43,2013-10-09 09:53:43
24f99676195333aa345fb955cdc8d2d0cd08efa3...1b9c72fc4ff9970680252499c20d6f25b1456321,1,14,14,28,12,2013-10-09 14:21:19,2013-10-09 14:20:39
1b9c72fc4ff9970680252499c20d6f25b1456321...4523fcd60101124a307bd4026296337087b66884,2,12,9,21,6,2013-10-09 14:41:54,2013-02-27 03:50:12
4523fcd60101124a307bd4026296337087b66884...9700194195735300f86803b0d023a37a89f4dff0,1,5,5,10,1,2013-10-09 15:42:27,2013-10-09 15:42:27
9700194195735300f86803b0d023a37a89f4dff0...ff9e8eccf89fc1dce441736c39dcb6e218ca8940,3,4,4,8,4,2013-10-10 12:50:32,2013-10-10 12:50:32
ff9e8eccf89fc1dce441736c39dcb6e218ca8940...cec11a3336c730e6dc2f1966fee749cc830e97c0,8,17,16,33,16,2013-10-10 13:35:56,2013-10-10 13:35:56
cec11a3336c730e6dc2f1966fee749cc830e97c0...adedc310729f7b1ca182b7b38d7d47550ae3e89d,12,27,34,61,24,2013-10-10 15:09:42,2013-10-10 15:07:48
adedc310729f7b1ca182b7b38d7d47550ae3e89d...ca874b2fe6f768bd042b859d7eba622a68e9f9dd,1,7,4,11,3,2013-10-10 17:01:12,2013-10-10 16:59:55
ca874b2fe6f768bd042b859d7eba622a68e9f9dd...1dae4ac1778f04805c0ed62c8debb13b281ba02b,173,602,678,1280,397,2013-10-10 20:49:20,2013-10-10 20:42:30
1dae4ac1778f04805c0ed62c8debb13b281ba02b...4b0f8d23c951c8f983fc849422c54d454f195b86,1,23,22,45,10,2013-10-10 21:02:31,2013-10-10 21:01:07
4b0f8d23c951c8f983fc849422c54d454f195b86...695bc0d191c126a948a7cf3acc3e37d9377ebd20,1,6,6,12,4,2013-10-11 00:56:11,2013-10-10 21:52:50
695bc0d191c126a948a7cf3acc3e37d9377ebd20...b67ab75e82ec59dd4eeca119eeaf570d7c88556c,38,92,73,165,63,2013-10-11 11:25:14,2013-10-11 11:25:14
b67ab75e82ec59dd4eeca119eeaf570d7c88556c...945e033a6964c8c83c1c5ce5f188baf41a7a7701,7,25,17,42,14,2013-10-11 12:07:25,2013-10-11 12:07:25
945e033a6964c8c83c1c5ce5f188baf41a7a7701...e527c0b6d808cb8e4bedf79ded3dc4ad1a7e17a8,12,211,50,261,47,2013-10-11 16:52:57,2012-08-01 01:49:01
e527c0b6d808cb8e4bedf79ded3dc4ad1a7e17a8...848101bf1736d1c01eb86968e85a14c7466bb376,1,3,0,3,1,2013-10-11 17:41:38,2013-10-07 14:33:47
848101bf1736d1c01eb86968e85a14c7466bb376...8bfc7cc64c4b45ccf9ad69564a5abd6b8105e28f,1,9,8,17,3,2013-10-11 19:34:11,2013-10-11 16:45:00
8bfc7cc64c4b45ccf9ad69564a5abd6b8105e28f...ad17d6a85fb75845b8a075e2617829834a9d1ffa,1,3,3,6,1,2013-10-11 21:58:07,2013-10-11 21:58:07
ad17d6a85fb75845b8a075e2617829834a9d1ffa...dd839a2dfd6a30474a2b367a4b3ce70b26c3f318,1,9,0,9,2,2013-10-12 00:11:49,2013-10-12 00:11:49
dd839a2dfd6a30474a2b367a4b3ce70b26c3f318...21c2bfdff37142215e1252700fb43455ca40cc3a,3,9,3,12,4,2013-10-12 16:08:07,2013-10-12 16:07:24
21c2bfdff37142215e1252700fb43455ca40cc3a...18ea1c473b3d314669f01e6ff347bdf8307bb941,1,19,13,32,5,2013-10-12 16:29:11,2013-10-12 16:27:02
18ea1c473b3d314669f01e6ff347bdf8307bb941...00a73c1c699e3df2790caf56635647bd72e3cd21,2,21,50,71,14,2013-10-12 16:31:19,2013-10-08 19:16:58
00a73c1c699e3df2790caf56635647bd72e3cd21...570d9c2678d6cc564f9c70138554af8f7ce9ec49,3,19,11,30,9,2013-10-13 09:54:11,2013-10-13 09:54:11
570d9c2678d6cc564f9c70138554af8f7ce9ec49...589dc49e129f63801c54c15e408c944a345b3dfe,6,14,28,42,10,2013-10-13 16:14:04,2013-10-13 16:06:58
589dc49e129f63801c54c15e408c944a345b3dfe...d9b6fb8f61e5029ce5d45d8fcb75694cee046b8f,1,5,2,7,1,2013-10-13 17:09:26,2013-10-13 17:09:26
d9b6fb8f61e5029ce5d45d8fcb75694cee046b8f...ef22d512b54cbf0b5f76151bc760391d839fbf72,3,4,0,4,3,2013-10-14 08:14:24,2013-10-14 08:11:18
c26dd4f154fe9d7aedeb28b0de4bb8cca85b55f9...307706d082d20ac868654ccbaee18879db5197db,3,34,24,58,24,2012-09-08 20:26:33,2012-09-08 20:12:18
307706d082d20ac868654ccbaee18879db5197db...67dceeef446c7c9fb5a3eaefad9c15bb298cfa3d,2,1,2,3,2,2012-09-08 20:30:11,2012-09-08 20:30:11
67dceeef446c7c9fb5a3eaefad9c15bb298cfa3d...72ca530af5e85bef6292bb1a16f3d9062f172f63,1,1,1,2,1,2012-09-08 21:34:22,2012-09-08 21:34:22
72ca530af5e85bef6292bb1a16f3d9062f172f63...518c58296667ffc36f90b873eb97aa99fa00eb1e,2,49,0,49,2,2012-09-08 22:45:02,2012-09-08 22:45:02
518c58296667ffc36f90b873eb97aa99fa00eb1e...a78dd109e6c81c49e90e36e9b793bad67c46c23c,13,162,52,214,26,2012-09-08 22:58:35,2012-09-08 22:55:29
a78dd109e6c81c49e90e36e9b793bad67c46c23c...c4aa26a983c91b1ec015fe0552077847116dfab7,10,26,13,39,18,2012-09-08 23:51:36,2012-09-08 23:51:36
c4aa26a983c91b1ec015fe0552077847116dfab7...a3b2136b284c34fb9f675b85495f2c7951d31aff,1,1,1,2,1,2012-09-09 00:22:03,2012-09-09 00:22:03
a3b2136b284c34fb9f675b85495f2c7951d31aff...5e99a3d41b5d7b7d8d135283fd25262fdcb1b7fd,1,2,0,2,2,2012-09-09 00:28:31,2012-09-09 00:28:31
7207327dd313522954da167f9a41396b97354c78...86e149ae055872fae0c2646cdfb002af287376d7,1,2,2,4,1,2012-09-08 16:54:33,2012-09-08 16:54:33
a630d08483267fbeb461f2fb06313d0e17ef6d44...d21f3d9b171a3cbff4c8ce7a9dbb8b8be3f21bac,1,1,1,2,1,2012-09-17 17:52:22,2012-09-17 17:52:22
63a9555d57069cee32de388821dbe580da1f97c0...64e11a68f19793d11915e83574b1bb693da3980e,10,5,148,153,10,2013-05-18 15:03:43,2013-05-18 14:38:11
63a9555d57069cee32de388821dbe580da1f97c0...3634948c883c89a9dbf303b9687331a2a5db43ce,4,24,19,43,8,2013-05-18 14:49:15,2013-05-18 14:40:03
3634948c883c89a9dbf303b9687331a2a5db43ce...d5ce2ff5e485bf94fcade340bc803ba4671bd95a,1,11,0,11,1,2013-05-18 14:53:13,2013-05-18 14:35:39
9012a9e2000020493b881a5b79cc801c62180796...1c921cfac34daa9c18e4e235e20fa7beb8929f1c,4,34,2,36,5,2013-05-18 12:10:40,2013-04-10 10:27:28
9012a9e2000020493b881a5b79cc801c62180796...5e208d579d64cd62c9e1e57b2b96c4469d8f1faf,1,37,31,68,3,2013-05-18 11:20:52,2013-05-18 11:20:52
9012a9e2000020493b881a5b79cc801c62180796...051cb1f4c60ac8e7087d92ef34ed41e6684d8b9b,2,17,1,18,2,2013-05-18 10:32:47,2013-05-18 10:32:47
051cb1f4c60ac8e7087d92ef34ed41e6684d8b9b...8fd44b2551b9cca765b216a31306f9c6935f1492,2,11,2,13,4,2013-05-18 10:39:11,2013-05-18 10:37:22
8fd44b2551b9cca765b216a31306f9c6935f1492...0b0741602b18928a418ba4661dc24b880daa5253,1,11,0,11,1,2013-05-18 10:45:40,2013-05-18 10:32:48
0b0741602b18928a418ba4661dc24b880daa5253...7b85ef9dfb83bd2f2cde46b9836b9fd12a033b26,1,5,0,5,1,2013-05-18 10:46:12,2013-05-18 10:45:06
7b85ef9dfb83bd2f2cde46b9836b9fd12a033b26...566e284c565a9ea95d81756c6b1f94dfa63fc61b,1,25,2,27,3,2013-05-18 10:50:28,2013-05-18 10:26:38
800513e7f3f8e4db26b40ecd2f8aae25ecc3191b...fd961941cc1c9e7e1384af527792801f8f897d9f,1,1,5,6,1,2013-05-21 12:41:39,2013-05-21 12:41:39
fd961941cc1c9e7e1384af527792801f8f897d9f...61a8de6f4f547518d217a5ff959cbd57bddf4bb0,4,58,14,72,13,2013-05-21 14:59:40,2013-02-24 15:41:10
61a8de6f4f547518d217a5ff959cbd57bddf4bb0...d595b61acae91e6111ec26cb0a4a1b1a9f4eb0d5,2,2,2,4,3,2013-05-21 15:34:19,2013-05-21 15:34:08
d595b61acae91e6111ec26cb0a4a1b1a9f4eb0d5...ea9a0857d4922fab1f9146f3a7828b67281edc89,5,92,0,92,5,2013-05-21 15:52:28,2013-05-21 15:35:12
f6567578887b7cc4efb0006ac4a3a5ba7a1c2cc7...c3df86661955f218de4788a57338bb23428f5525,4,22,2,24,5,2013-06-14 21:16:15,2013-06-14 21:11:51
c3df86661955f218de4788a57338bb23428f5525...2a6a32047d7d1c19e3e9f6d317cbe33e7d6ab49a,1,11,0,11,1,2013-06-14 23:02:45,2013-06-14 23:02:29
2a6a32047d7d1c19e3e9f6d317cbe33e7d6ab49a...a1122e14a6d2ace8907923507e7d31c44a6f7c68,1,3,3,6,1,2013-06-15 01:28:17,2013-06-15 01:28:17
a1122e14a6d2ace8907923507e7d31c44a6f7c68...990f8d92dca913462f656387b012801f01c96244,2,21,8,29,6,2013-06-15 08:50:55,2013-06-14 14:19:53
990f8d92dca913462f656387b012801f01c96244...beb652e069d386fa6295dd235d7ba84a95e9d484,1,4,3,7,3,2013-06-15 09:14:59,2013-06-15 09:14:59
beb652e069d386fa6295dd235d7ba84a95e9d484...bf9975b0eb5f839ac5ff53b4fb302548dde6a418,1,1,1,2,1,2013-06-15 10:02:25,2013-06-15 10:02:25
bf9975b0eb5f839ac5ff53b4fb302548dde6a418...b3532f7df950d07d92c231fa60a13675111208ea,1,2,0,2,1,2013-06-15 17:14:48,2013-06-15 17:14:30
b3532f7df950d07d92c231fa60a13675111208ea...aa22cbd51aa6cb35fc658dd704948a18b27d1981,2,19,23,42,10,2013-06-16 12:44:52,2013-06-15 17:31:46
aa22cbd51aa6cb35fc658dd704948a18b27d1981...1b7634a0d0e21faba71a27ae7951d7cb7aec0e49,5,106,77,183,19,2013-06-16 19:49:30,2013-06-15 20:34:25
1b7634a0d0e21faba71a27ae7951d7cb7aec0e49...39b245fd765bc8809cedbd0c898d5b385d8ef8ea,1,1,1,2,1,2013-06-17 09:35:07,2013-06-17 07:37:19
39b245fd765bc8809cedbd0c898d5b385d8ef8ea...b6f86fbeb1ffbe40480e066d1ff43115842171e0,2,12,1,13,3,2013-06-17 10:30:41,2013-06-17 10:30:41
b6f86fbeb1ffbe40480e066d1ff43115842171e0...efe6e16008b4a123666cc445f7319efce8e9b6bf,1,2,0,2,2,2013-06-18 11:26:06,2013-06-18 10:15:10
efe6e16008b4a123666cc445f7319efce8e9b6bf...f34cfec0fa1243b4a3b9865b961a2360f211f0d8,6,67,55,122,21,2013-06-18 12:01:17,2013-04-04 19:21:57
f34cfec0fa1243b4a3b9865b961a2360f211f0d8...ee77d4b25360a9fc050c32769a334fd69a011a63,22,406,152,558,108,2013-06-18 12:01:17,2013-06-05 18:55:05
ee77d4b25360a9fc050c32769a334fd69a011a63...3128f3d38d1db0bc01da9a4bf4be81119079d73a,2,9,3,12,2,2013-06-18 15:49:53,2013-06-18 15:49:45
3128f3d38d1db0bc01da9a4bf4be81119079d73a...2c4fe761a0e2b28e2c5c3b4bc506ee06824a443d,6,106,6,112,21,2013-06-18 17:32:54,2013-06-17 16:06:26
675558d00efab507ef2e538025f20abc6725b159...dc9c359546580d40df209816cef244b78dcf7435,4,9,6,15,6,2013-06-13 17:31:57,2013-06-13 16:37:08
dc9c359546580d40df209816cef244b78dcf7435...9e50833e2293aa2734f14f9873abe4f83d03b8c6,6,231,45,276,41,2013-06-13 19:06:25,2013-04-03 19:51:37
9e50833e2293aa2734f14f9873abe4f83d03b8c6...70d7e45eb0888f979775c997935bfee84c85d189,2,14,3,17,2,2013-06-13 20:08:56,2013-06-13 20:07:27
70d7e45eb0888f979775c997935bfee84c85d189...91f317c76d503b4bcae5a26c230425944dbf4ea8,8,205,0,205,6,2013-06-14 01:39:02,2013-06-14 01:39:02
2fc6c9472cd25910f978fe1d18de5c350370f901...fa217d14a040cb09f8359d8ac613cc1dac220619,1,6,6,12,3,2013-07-19 08:01:13,2013-07-19 08:01:13
2fc6c9472cd25910f978fe1d18de5c350370f901...97e5398629e36a84d3553dbe7d6eeeaa7d87ae30,1,1,1,2,1,2013-07-19 08:01:13,2013-07-19 05:46:08
2fc6c9472cd25910f978fe1d18de5c350370f901...cf6c754629a6348847cf0e83a0ffbc8a74547641,1,4,12,16,2,2013-07-19 00:15:30,2013-07-19 00:15:30
d7ba2bf3cfdf706d9628d86f3c10e5a430f37593...dce8945ea63c636a71f3bc5d610dccebc08c52eb,1,2,0,2,1,2013-07-18 16:41:01,2013-07-18 16:41:01
74a80a5169a1c870e6c2f78a18f67b366b0f60de...9bc8d887c76b987cc4c76c9a80760e1b315fc80e,1,1,1,2,2,2013-03-17 09:28:52,2013-03-17 09:26:27
9bc8d887c76b987cc4c76c9a80760e1b315fc80e...46f4b19920a52218d4ee165ce2626ebf6d905c08,1,1,3,4,2,2013-03-17 09:31:15,2013-03-17 09:31:15
46f4b19920a52218d4ee165ce2626ebf6d905c08...e11ccc76d325b6bbbf101f510a91299f507f0745,2,35,31,66,25,2013-03-17 09:44:28,2013-03-17 08:41:54
e11ccc76d325b6bbbf101f510a91299f507f0745...9d4a5b00f1977d8cddf8e241fa4bb8a9e819f188,2,11,11,22,4,2013-03-17 09:44:28,2013-03-17 09:19:30
9d4a5b00f1977d8cddf8e241fa4bb8a9e819f188...0555ef7c23cbbd991270d529cff48d96de801622,1,120,62,182,19,2013-03-17 10:05:41,2013-03-17 10:05:41
ef22d512b54cbf0b5f76151bc760391d839fbf72...af64429b991471b7a441e133b5b7d29070984f24,4,21,5,26,6,2013-10-14 22:42:42,2013-10-14 22:40:52
ef22d512b54cbf0b5f76151bc760391d839fbf72...1ab27e9a65015373a49688f3ff6723cf85d5de56,3,19,0,19,6,2013-10-14 13:19:35,2013-10-14 12:48:01
ef22d512b54cbf0b5f76151bc760391d839fbf72...b600bb7e08a884cd07838530c0a0c9de830e5c29,1,1,2,3,2,2013-10-14 10:54:37,2013-10-14 10:54:37
b600bb7e08a884cd07838530c0a0c9de830e5c29...1e8eadc94e3b27fe90ce9356b48e8543a1ff590e,7,130,58,188,32,2013-10-14 11:24:40,2013-01-05 22:43:01
1e8eadc94e3b27fe90ce9356b48e8543a1ff590e...13ddf0e0027b7646953a4c7d872ca682667c9b3f,1,10,10,20,6,2013-10-14 12:07:44,2013-10-14 11:40:56
13ddf0e0027b7646953a4c7d872ca682667c9b3f...8fc63087f6ad888b68dff17ee0c527774332d932,2,5,4,9,2,2013-10-14 12:14:27,2013-10-14 11:59:56
5e99a3d41b5d7b7d8d135283fd25262fdcb1b7fd...9ca17f883d7a637581befe8092120242d0534673,1,11,12,23,1,2012-09-09 11:00:10,2012-09-09 11:00:10
9ca17f883d7a637581befe8092120242d0534673...ffe8bc00bf9b94a366ea3d1998a2712a908a9f1b,2,4,4,8,3,2012-09-09 16:53:32,2012-09-09 16:53:32
ffe8bc00bf9b94a366ea3d1998a2712a908a9f1b...75ef980e20fc0441aedb0645aa471c9fe606e3b0,1,5,2,7,2,2012-09-09 17:37:21,2012-09-09 17:37:16
75ef980e20fc0441aedb0645aa471c9fe606e3b0...fcec904e4f3582a45d4d8e309e71e9f0c4d79a0c,1,1,2,3,1,2012-09-09 18:13:42,2012-09-09 18:13:42
fcec904e4f3582a45d4d8e309e71e9f0c4d79a0c...2e928583861bc35f1ea137cb6f3353867f160bdb,1,11,6,17,7,2012-09-09 19:07:04,2012-09-09 19:07:04
2e928583861bc35f1ea137cb6f3353867f160bdb...cb1614f7b30f336db2a807b43696e20fdab7b78c,1,3,0,3,3,2012-09-10 11:35:21,2012-09-10 11:35:21
5e99a3d41b5d7b7d8d135283fd25262fdcb1b7fd...3fb2662edcdfb03ebb4b2ab60ffe309104809246,1,2,4,6,2,2012-09-09 04:35:40,2012-09-09 04:35:40
3c27344b45d6ae249c39e602556f2f7483df1403...b139cfc0f7e70e37b9a31e9931c6b03b8a68e918,2,11,4,15,3,2012-09-08 17:19:58,2012-09-08 17:19:58
d21f3d9b171a3cbff4c8ce7a9dbb8b8be3f21bac...06f79354d009b9fe10149bf597c1570569e7d348,1,16,1,17,4,2012-09-17 19:56:19,2012-09-17 19:50:13
e73cb6391dd4f178e430c424eda6d9c97a70c7f6...96cabba80805ddda9c48307cb3d75177dc94ba29,1,26,3,29,3,2013-05-18 15:20:02,2013-05-18 15:20:02
d5ce2ff5e485bf94fcade340bc803ba4671bd95a...e4591debd19361e628317e936ed8123d9897dd6a,9,122,33,155,66,2013-05-18 16:38:52,2013-05-18 10:12:26
e4591debd19361e628317e936ed8123d9897dd6a...cd72c55d8603751af40a55d2d18f264827fa0744,8,57,2,59,35,2013-05-18 16:39:11,2013-05-18 12:00:52
cd72c55d8603751af40a55d2d18f264827fa0744...ddd9ee16fa0c7cc19fd472fd7c1f6d28693a89be,5,29,0,29,11,2013-05-18 16:39:21,2013-05-18 11:34:29
ddd9ee16fa0c7cc19fd472fd7c1f6d28693a89be...a4a761ada2286e0f08282efe8dffcd1b384c052c,1,3,0,3,3,2013-05-18 16:39:28,2013-05-18 15:57:20
d5ce2ff5e485bf94fcade340bc803ba4671bd95a...56e2f6ccae76a6f0a7f1d64677bf29e11518e5c6,1,4,2,6,2,2013-05-18 15:16:07,2013-05-18 15:16:07
d5ce2ff5e485bf94fcade340bc803ba4671bd95a...5883ae56b3e993052c46f7d9e756465b1387dd34,1,11,7,18,1,2013-05-18 15:05:45,2013-05-18 15:04:52
06603d112ccf1e246eb5db5bb4b9a81405eb0afd...4bed64c4171194385f5995e657885a3ef35ea49b,1,7,7,14,1,2013-05-18 11:34:52,2013-05-18 11:34:08
4bed64c4171194385f5995e657885a3ef35ea49b...be826aafacb9fe266209604116efe128a0b4cdc0,1,0,1,1,1,2013-05-18 11:51:09,2013-05-18 11:51:09
566e284c565a9ea95d81756c6b1f94dfa63fc61b...493aca453aa94f160764d9a89c8043f7c9a67a78,2,21,4,25,4,2013-05-18 11:44:27,2013-05-18 11:44:27
493aca453aa94f160764d9a89c8043f7c9a67a78...b11b036145d6a1e9d2192e332c8a221a595be1b6,1,1,0,1,1,2013-05-18 11:49:13,2013-05-18 11:49:13
566e284c565a9ea95d81756c6b1f94dfa63fc61b...340115200f459d02e9a3e61c9704653215e185d5,1,2,0,2,2,2013-05-18 11:13:33,2013-05-18 10:55:13
340115200f459d02e9a3e61c9704653215e185d5...215647c0f7614abe4fe0cd76bc70dd7b02f829b4,1,3,1,4,2,2013-05-18 11:19:26,2013-05-16 15:30:52
566e284c565a9ea95d81756c6b1f94dfa63fc61b...029c690b1484c6c16e9f9974fbec6bcc2b72dd77,1,2,0,2,2,2013-05-18 11:05:39,2013-05-18 10:55:13
ea9a0857d4922fab1f9146f3a7828b67281edc89...70679243d1786e03557c28929f9762a119e3ac14,3,56,156,212,16,2013-05-21 16:51:59,2012-08-01 21:09:26
70679243d1786e03557c28929f9762a119e3ac14...5d164569916b44e476a3fa2a292c6fe9c6735177,1,1,1,2,1,2013-05-21 19:29:14,2013-05-21 19:29:14
ea9a0857d4922fab1f9146f3a7828b67281edc89...375e275030574dbe4ff52aa2ca36f698d6c9fca8,1,1,1,2,1,2013-05-21 16:18:35,2013-05-21 16:18:35
2c4fe761a0e2b28e2c5c3b4bc506ee06824a443d...c86a9b63984f6692d478f6f70e3c78de4ec41814,14,317,42,359,45,2013-06-18 19:41:36,2013-06-18 19:41:36
2c4fe761a0e2b28e2c5c3b4bc506ee06824a443d...aeb1389442d0f9669edf6660b747fd10693b63a7,6,27,19,46,17,2013-06-18 18:02:00,2013-06-18 18:02:00
0f3f88ec945b2f6728b9ed04e27c5fa4bcc43898...8365ed08b83591bf6d7ddb3b3cb066d8325573bb,2,18,1,19,3,2013-06-14 09:26:30,2013-06-13 12:55:18
8365ed08b83591bf6d7ddb3b3cb066d8325573bb...b7bd7087e6480c6a071a12ce20b389a8c225e908,4,47,11,58,15,2013-06-14 10:59:26,2013-06-14 10:59:26
e1c737b62fed5b77cb22c2abe01c304bf5aef6f7...a269ea4fe0a9a7195f1bd8bf5d462f48c226d525,11,179,38,217,39,2013-07-19 14:38:34,2013-07-17 19:20:20
a269ea4fe0a9a7195f1bd8bf5d462f48c226d525...6d52844b9b3c0bd18eea03ac9dc499782b84c36b,3,48,6,54,12,2013-07-19 18:30:14,2013-07-19 18:30:14
6d52844b9b3c0bd18eea03ac9dc499782b84c36b...415a36947cb4b8b61230698e13cca2df9400e245,3,20,3,23,3,2013-07-20 03:31:15,2013-07-19 02:01:51
415a36947cb4b8b61230698e13cca2df9400e245...3aad955ea8db1592fad0012155eaa25b72e50dc5,6,64,6,70,9,2013-07-21 17:06:11,2013-07-19 19:55:16
3aad955ea8db1592fad0012155eaa25b72e50dc5...11b7b9ad0040cbe78d17514373475ee41179d3fa,2,2,1,3,2,2013-07-21 19:11:32,2013-07-20 16:00:23
11b7b9ad0040cbe78d17514373475ee41179d3fa...bb145e2c47d71b7f68280c00ced727442d2effa2,9,67,2,69,9,2013-07-21 20:17:14,2013-07-21 09:02:36
bb145e2c47d71b7f68280c00ced727442d2effa2...02b0106d43f6997f02cc6785359f8f7519215d3d,3,3,2,5,3,2013-07-22 07:06:07,2013-07-21 20:26:03
02b0106d43f6997f02cc6785359f8f7519215d3d...27c1a7257652031d3957c97271723778f27c4d7b,2,21,3,24,6,2013-07-22 07:55:45,2013-07-22 07:55:45
694d7da6c53b9ad35381dccdf4f688771b0b932e...42f8666f6aed126d9606e00688087a76dd17afc6,4,124,5,129,15,2013-10-16 10:09:33,2013-10-16 10:09:33
42f8666f6aed126d9606e00688087a76dd17afc6...763ac8b642bc21b5a05c0d540c962804b36454ec,4,127,4,131,10,2013-10-16 11:00:07,2013-10-16 11:00:07
763ac8b642bc21b5a05c0d540c962804b36454ec...3918eeb9fde03a2ad1941bce022615fff8eae34d,3,29,3,32,5,2013-10-16 11:03:46,2013-10-15 15:24:35
3918eeb9fde03a2ad1941bce022615fff8eae34d...91c77eeab837ff793311ac5b0321015a4e66d6da,1,8,2,10,3,2013-10-16 15:31:07,2013-10-16 15:29:29
91c77eeab837ff793311ac5b0321015a4e66d6da...2992f428614349b0dfe0f4183905f492fd3f62c2,2,35,8,43,8,2013-10-16 16:02:32,2013-10-16 15:58:05
2992f428614349b0dfe0f4183905f492fd3f62c2...650b6fd90efea058c54800d2ba0e0976547894a3,5,18,30,48,14,2013-10-16 16:02:49,2013-10-16 15:58:21
8ce3c3a9282ac19282060ddf6928b34a09d26672...9b7d38ed5a9eed21c496abb1b874cfe53da9c9c9,2,10,0,10,2,2013-10-14 14:36:18,2013-10-14 12:19:02
9b7d38ed5a9eed21c496abb1b874cfe53da9c9c9...54cd930baf49c45e3e91338a9f4a56d19090ff25,1,22,11,33,3,2013-10-14 14:54:22,2013-10-14 13:45:30
cb1614f7b30f336db2a807b43696e20fdab7b78c...f416ea9c8d8a5a7224236e429d51ce5606c95c5b,1,1,1,2,1,2012-09-10 15:11:24,2012-09-10 15:11:24
87c06fa4f4b908b940bea7cde95251d4daf78f3c...a01bce1e26ebd6f67809455282a26789d09cc1df,2,15,0,15,2,2012-09-15 02:24:39,2012-09-15 02:24:39
a01bce1e26ebd6f67809455282a26789d09cc1df...abfba3bb65c9a28ca3756ec5d091e2e8561fc450,1,1,1,2,1,2012-09-15 02:26:11,2012-09-15 02:26:11
abfba3bb65c9a28ca3756ec5d091e2e8561fc450...65793d714ca6b03d2cd0fcfeec54652396f7ab48,2,4,3,7,2,2012-09-15 10:02:28,2012-09-15 09:56:39
65793d714ca6b03d2cd0fcfeec54652396f7ab48...a73838fde33374573b8e765dfcb0225287d396c0,3,214,78,292,24,2012-09-15 10:22:00,2012-09-12 10:59:19
a73838fde33374573b8e765dfcb0225287d396c0...e5f8fe27acdfc0ec2e3f3f03e80311d413ba0a75,1,0,3,3,1,2012-09-15 10:41:58,2012-09-15 10:41:58
e5f8fe27acdfc0ec2e3f3f03e80311d413ba0a75...553583958d907de09c2b87788ec7454c1bde7d1c,1,61,1,62,2,2012-09-15 11:16:07,2012-09-15 11:16:07
553583958d907de09c2b87788ec7454c1bde7d1c...22242c510f84c53803afe2907649c892cb1b3d9a,1,31,1,32,2,2012-09-15 11:38:34,2012-09-15 11:37:33
22242c510f84c53803afe2907649c892cb1b3d9a...93e6733e4cbbdad34f1f0f59303ae01f577e4e58,1,8,0,8,1,2012-09-15 12:15:54,2012-09-15 12:15:54
93e6733e4cbbdad34f1f0f59303ae01f577e4e58...b1fb6f48201e00c6ea0eae37a839525657cf71e2,1,6,15,21,7,2012-09-15 19:07:42,2012-09-15 19:07:31
b1fb6f48201e00c6ea0eae37a839525657cf71e2...c7f44ae085df3a270aa998cdedb56f36900cb9ef,2,10,2,12,3,2012-09-15 19:39:08,2012-09-15 19:39:08
96cabba80805ddda9c48307cb3d75177dc94ba29...86e761fee88a8bf0499f6795c9a9b336d7c52873,2,11,2,13,3,2013-05-18 15:31:28,2013-05-18 15:27:12
5915800debef7cec01672dc0b467b7c2bd3aba03...f763227c7d2d91de6086e587aa3b52473001b2af,1,2,3,5,3,2013-05-18 16:06:31,2013-05-18 16:06:31
16683f29ea81e1e979ee88c79cbef279046dd8b1...90f1170bb92cfd588762039fc00477bfcdae11b3,1,8,2,10,2,2013-05-18 12:29:43,2013-05-18 12:24:27
16683f29ea81e1e979ee88c79cbef279046dd8b1...d77082b43877b4df0f29fa977b73b7b4feab84d4,1,40,0,40,1,2013-05-18 12:27:29,2013-05-18 12:22:40
be826aafacb9fe266209604116efe128a0b4cdc0...756b81dbd1a947351670b66c7e91116abe6aa5c2,6,114,21,135,29,2013-05-18 12:13:00,2013-05-18 12:13:00
a0c0cc924e4c6ffd22158f254ed9bc9556f05cc4...a19e9d80ffa10f8da43addcaa4ddd440beee8a4d,7,52,7,59,6,2013-05-18 15:14:05,2013-05-17 19:31:41
a0c0cc924e4c6ffd22158f254ed9bc9556f05cc4...dc43fbc2f21c12e34e309d0e8a121020391aa03a,3,56,2,58,7,2013-05-18 13:58:29,2013-05-18 11:46:31
dc43fbc2f21c12e34e309d0e8a121020391aa03a...710c59bf9b09ee5afae2e555c30e13ed59fa4583,1,4,5,9,5,2013-05-18 14:01:47,2013-05-18 14:01:47
5d164569916b44e476a3fa2a292c6fe9c6735177...d0788c277035727b7b070abd0f02d075acffc84f,2,25,1,26,5,2013-05-21 23:05:22,2012-08-03 16:17:41
5d164569916b44e476a3fa2a292c6fe9c6735177...b6ad9998e6436e81f7dfbf1961a147d00816fb1f,1,1,0,1,1,2013-05-21 22:52:15,2013-05-19 14:08:00
b6ad9998e6436e81f7dfbf1961a147d00816fb1f...8fd40b9ae783614658f6e0ca7af7f2faab0c48fc,1,0,3,3,1,2013-05-21 22:52:15,2013-05-21 22:27:27
8fd40b9ae783614658f6e0ca7af7f2faab0c48fc...dfe6ea3b1f6c7119a552ba6a018f89745e767132,1,10,0,10,1,2013-05-21 22:52:15,2013-05-21 22:31:14
90a6c3aaf084188a370bfcca421a2d735ce3b0b7...904084611d740e26eb3cb44af9a3d2f3a6d1b665,1,7,0,7,1,2013-05-22 05:30:41,2013-05-22 05:28:17
c86a9b63984f6692d478f6f70e3c78de4ec41814...7d0c3b9b2648ca71e98f81a16cec18a17d73dd9a,1,2,2,4,2,2013-06-19 09:13:43,2013-06-19 09:13:43
b7bd7087e6480c6a071a12ce20b389a8c225e908...89bf7a45250cf554295f3d17d708311d3edba101,2,35,18,53,9,2013-06-14 13:29:06,2013-06-10 15:22:30
89bf7a45250cf554295f3d17d708311d3edba101...ffa8a9ab24c8db6ed3ddc6ca09e8e852c651244b,3,14,14,28,6,2013-06-14 13:44:45,2013-06-14 13:44:45
ffa8a9ab24c8db6ed3ddc6ca09e8e852c651244b...855d1305c54dbcd3a7fed3f7b10ff63f1bac88ba,1,1,1,2,1,2013-06-14 14:05:54,2013-06-14 14:00:47
855d1305c54dbcd3a7fed3f7b10ff63f1bac88ba...5459795ef224c5c81461c06a95d38390ee91f014,3,70,7,77,11,2013-06-14 14:05:54,2013-05-21 09:57:24
5459795ef224c5c81461c06a95d38390ee91f014...46789e76c68b5713795fbf71ce5fdccb727074fa,7,29,16,45,22,2013-06-14 14:37:39,2013-06-14 14:02:30
b7bd7087e6480c6a071a12ce20b389a8c225e908...659d090025cf3ba1b33844090800efcdbc04c7c6,1,4,0,4,2,2013-06-14 13:22:52,2013-06-14 13:22:52
650b6fd90efea058c54800d2ba0e0976547894a3...eb214452c3b1dc399b629aabea926e27b5538c52,78,626,286,912,192,2013-10-17 11:12:40,2013-10-17 08:17:41
54cd930baf49c45e3e91338a9f4a56d19090ff25...e077224f4ad69a68ae58a373ef69941272d3656c,2,7,2,9,2,2013-10-14 15:53:15,2013-10-14 12:43:55
e077224f4ad69a68ae58a373ef69941272d3656c...d07d6ae1167f93f2e88b3743c070003a66a31b35,10,409,130,539,74,2013-10-14 17:00:57,2013-09-23 22:23:47
d07d6ae1167f93f2e88b3743c070003a66a31b35...1ac534a92f8cabc209ccabe223344b43bc1b11d8,1,4,0,4,1,2013-10-14 17:43:40,2013-10-14 17:43:40
1ac534a92f8cabc209ccabe223344b43bc1b11d8...8ab5f1fe4750105dae734764baed54bd4d22792b,1,4,0,4,4,2013-10-14 18:34:43,2013-10-14 18:26:54
8ab5f1fe4750105dae734764baed54bd4d22792b...42a67ec1cd8cbaffd87f0a7b34714f7d4a259cfb,2,38,20,58,22,2013-10-14 19:21:07,2013-10-14 18:24:57
42a67ec1cd8cbaffd87f0a7b34714f7d4a259cfb...83b9bfea44e23c5770fa14a8921914839929233b,35,152,145,297,71,2013-10-14 22:12:00,2013-10-14 19:13:14
83b9bfea44e23c5770fa14a8921914839929233b...018e2c055a894c4869985b0fda64e52a6c368f32,1,6,0,6,1,2013-10-14 22:41:22,2013-10-14 20:16:49
018e2c055a894c4869985b0fda64e52a6c368f32...975415a8cef38cf2a49c3ce8234c15ef97a69b5f,1,5,4,9,1,2013-10-14 23:48:24,2013-10-14 23:48:24
975415a8cef38cf2a49c3ce8234c15ef97a69b5f...ed8919cbcb83302ea71572f5c7d5e6796bb21afa,1,7,2,9,4,2013-10-15 09:57:30,2013-10-15 09:57:30
54cd930baf49c45e3e91338a9f4a56d19090ff25...ac5ec7b8bcc5623cc05d4df900c39e194f5affcf,8,105,42,147,40,2013-10-14 14:59:30,2013-07-20 19:25:27
ac5ec7b8bcc5623cc05d4df900c39e194f5affcf...b16dd1fe019b38d0dcdf4a400e9377fb06b33178,5,52,0,52,6,2013-10-14 15:42:33,2013-10-14 15:42:33
611a2b266b2f57f42e4a3f0ac04d560e805c08cf...f1bdfbd24bcc76d21c4bf7442959bdf630ac4dec,4,27,22,49,17,2012-09-10 17:31:11,2012-09-10 17:21:29
f1bdfbd24bcc76d21c4bf7442959bdf630ac4dec...6eb4f2569266391e223410ab7eaa2555ac0a4f10,9,3,214,217,6,2012-09-11 00:19:35,2012-09-11 00:19:35
6eb4f2569266391e223410ab7eaa2555ac0a4f10...0133d66734f5b0470436a22f5b85bdf7266bf1cf,1,1,1,2,1,2012-09-11 00:27:50,2012-09-11 00:27:50
0133d66734f5b0470436a22f5b85bdf7266bf1cf...859aa2a6c4496a0feafebef7c7ea8fc57d9913f4,3,17,2,19,5,2012-09-12 08:16:49,2012-09-12 08:16:49
859aa2a6c4496a0feafebef7c7ea8fc57d9913f4...703c266682be39f7153498ad0d8031231f12ee79,4,38,21,59,10,2012-09-12 09:32:50,2012-09-12 09:21:58
703c266682be39f7153498ad0d8031231f12ee79...1aa218b857ccd5e7db3718e2c0b4d4739dcb075c,1,1,2,3,1,2012-09-12 09:58:02,2012-09-12 09:56:58
1aa218b857ccd5e7db3718e2c0b4d4739dcb075c...c2c8d4044e2c6345f6e8d0f8617755dec7cd55d5,3,9,5,14,5,2012-09-12 13:03:46,2012-09-12 12:50:16
c7f44ae085df3a270aa998cdedb56f36900cb9ef...c555741aa7840d8ee4b3a191550924cca6f27105,4,12,4,16,7,2012-09-15 23:20:56,2012-09-15 23:20:56
c7f44ae085df3a270aa998cdedb56f36900cb9ef...8d75b1176f280b8949aee8dc961a2acd0dacffcd,1,1,1,2,1,2012-09-15 21:24:01,2012-09-15 21:24:01
c7f44ae085df3a270aa998cdedb56f36900cb9ef...17149496a001b0ec8af382ef5a65499c0a651f43,1,6,6,12,4,2012-09-15 20:45:13,2012-09-15 20:45:13
398841d6d3fce45b21bdfcd8385889098079f84a...0b3a6ead88c84aa30f11ad51ad3d89a016f9dd67,1,5,1,6,2,2013-05-19 08:48:30,2013-05-19 08:48:30
398841d6d3fce45b21bdfcd8385889098079f84a...bd97f7d0cb72191744552142817184e88ce8841d,7,39,25,64,13,2013-05-18 15:38:32,2013-05-18 14:10:14
2335fdd0773d61b9c02e5d4e3cd17bfe230552d5...2c84f4434cd0f6e74471d5737b049c648cff538f,1,14,2,16,1,2013-05-18 16:11:29,2013-05-18 16:05:35
2c84f4434cd0f6e74471d5737b049c648cff538f...ff881aef536640d712fd2bc53fa1ff98e300adad,2,24,5,29,5,2013-05-18 16:30:03,2013-05-18 16:26:34
ff881aef536640d712fd2bc53fa1ff98e300adad...0038296135502331c302935106d7aa568f715200,1,1,1,2,1,2013-05-18 18:48:47,2013-05-18 18:48:47
90f1170bb92cfd588762039fc00477bfcdae11b3...92ebb29c5376c1811e8607e96bddc90d24e44e2a,2,54,13,67,4,2013-05-18 12:37:04,2013-05-18 12:37:04
886f7cc751523caf335c1d59c3cdcef7950cb923...4ad1eb1c14b629cf5bcfd253ed40e875f1bddd47,5,541,556,1097,129,2013-05-19 10:42:52,2013-02-23 15:10:32
756b81dbd1a947351670b66c7e91116abe6aa5c2...1c1695668f678fd8c2db282a79d7d93c11ee0aff,1,3,3,6,3,2013-05-18 12:38:45,2013-05-18 12:38:45
3129d190714216cd83d2494a88f537699a42375f...cb86f707a04e5635817d5f37a1443f9bf7d6af21,7,109,72,181,17,2013-05-19 11:14:54,2013-05-19 10:58:13
710c59bf9b09ee5afae2e555c30e13ed59fa4583...acd0bb39df5c9ca486e49ec55ae34538242ce071,2,31,1,32,2,2013-05-18 15:36:31,2013-05-18 15:36:31
adeec00979d1b365535b8f26fda4a5f7173e975d...1b19f9e9e7db5f45c44e840ca709b1566a989efa,1,0,2,2,2,2013-06-14 08:17:33,2013-06-14 08:17:33
adeec00979d1b365535b8f26fda4a5f7173e975d...0e51d8eb66121b2558a38c9f4e366df781046873,2,22,4,26,7,2013-05-22 08:56:06,2013-05-22 08:56:06
7d0c3b9b2648ca71e98f81a16cec18a17d73dd9a...48ce167d895b7e2a9d00884a4a8679851fa890af,2,5,0,5,2,2013-06-26 07:36:25,2013-06-26 07:36:25
9da9b3eb0454fa3dea228b16c6e35b01db5eee69...2f35c6f10fcbae541691207fb0c0560a13b754fc,3,83,21,104,16,2013-06-18 20:56:51,2013-02-05 23:11:28
2f35c6f10fcbae541691207fb0c0560a13b754fc...b0b506b933155dbeaa1f5d241fba806a9e9c4732,1,1,1,2,1,2013-06-19 08:37:24,2013-06-19 08:37:24
cce42d4cf2d6820ce04e71b7c1a785ec0d19538f...7f508a36731660c8cd2659f23098f1379eaa8fb5,3,4,19,23,7,2013-10-17 12:15:08,2013-10-17 12:15:08
7f508a36731660c8cd2659f23098f1379eaa8fb5...a921f0634583e2f87475e802e2674e7159b4f25b,1,2,1,3,2,2013-10-17 12:21:17,2013-10-17 10:54:20
a921f0634583e2f87475e802e2674e7159b4f25b...98788d3c3af9f6cce2b94c276d17726f46608b08,7,7,7,14,7,2013-10-17 12:27:34,2013-10-17 12:27:34
98788d3c3af9f6cce2b94c276d17726f46608b08...2fb5a51fa3ac276efc7121ec9de91f092a986104,14,87,21,108,22,2013-10-17 13:42:28,2013-10-15 20:36:49
2fb5a51fa3ac276efc7121ec9de91f092a986104...3a66035107a640c4905f0a5f247a45f32dbe16d7,1,0,5,5,1,2013-10-17 14:45:56,2013-10-10 21:31:37
3a66035107a640c4905f0a5f247a45f32dbe16d7...50087063450b3134461f2c4c5a36c3dd8ec1980c,2,45,3,48,9,2013-10-17 16:08:17,2013-10-17 15:32:39
50087063450b3134461f2c4c5a36c3dd8ec1980c...a14f08723304be27e851c753a68c8200473a9ca1,2,9,3,12,7,2013-10-17 16:14:35,2013-10-17 16:07:47
a14f08723304be27e851c753a68c8200473a9ca1...3514bcb251fb623dbd07911e53d417d55934ffa5,2,21,15,36,9,2013-10-17 16:57:44,2013-10-17 16:57:44
3514bcb251fb623dbd07911e53d417d55934ffa5...9833b931b78ab3fac33b55873d13769f6dcdb41e,1,0,19,19,1,2013-10-17 17:51:36,2013-10-17 17:51:36
9833b931b78ab3fac33b55873d13769f6dcdb41e...7e5d7a76bf60564d39d25a101380e47da7f1e2f6,3,57,6,63,9,2013-10-17 18:01:02,2013-10-12 01:19:27
7e5d7a76bf60564d39d25a101380e47da7f1e2f6...d97bec5ee3a6284d30b613c9070588a60358e7ec,1,0,16,16,1,2013-10-17 22:58:24,2013-10-17 22:58:24
d97bec5ee3a6284d30b613c9070588a60358e7ec...dfb4cb9970f86487f0aaa88c5dfcfafa31e4f430,34,149,150,299,95,2013-10-18 00:20:11,2013-10-17 22:27:45
dfb4cb9970f86487f0aaa88c5dfcfafa31e4f430...65d1d65d52a87bba22845bcb7c3c921a8789ec19,11,46,46,92,36,2013-10-18 00:28:32,2013-10-18 00:24:41
ce823d37109208644ec8a9acf2dfa915c73c42eb...9bfe66164e0e214abc6063a1a60ce729094d0632,1,26,4,30,4,2013-10-15 11:34:29,2013-10-15 10:55:43
c2c8d4044e2c6345f6e8d0f8617755dec7cd55d5...e8c6aff3bf31b775dd70581b1cf6f86d5abd4001,3,22,5,27,11,2012-09-17 20:53:10,2012-09-05 15:05:28
c2c8d4044e2c6345f6e8d0f8617755dec7cd55d5...fbd4b3a5188d0b488648f1fdd2339e1eac6722a2,1,8,8,16,8,2012-09-12 14:13:58,2012-09-12 14:13:58
fbd4b3a5188d0b488648f1fdd2339e1eac6722a2...9db7652eef7152d06e177a4886b3484f658c1101,2,15,11,26,4,2012-09-12 21:37:44,2012-09-09 05:36:38
9db7652eef7152d06e177a4886b3484f658c1101...7e5ebcce5365a172d802c76b57771c321430317f,4,25,25,50,11,2012-09-13 14:20:11,2012-09-13 14:17:32
7e5ebcce5365a172d802c76b57771c321430317f...690170a8b9bbcea1ae51e4020aea49987fefdbd2,2,0,16,16,2,2012-09-13 18:17:52,2012-09-13 18:17:52
935a8635c2fe5b702c18027818ef4cceda4d83cd...f399a804c9436a5d3ef9e2b73c337904af2c753d,3,23,2,25,7,2012-09-16 19:58:40,2012-09-15 18:11:14
0038296135502331c302935106d7aa568f715200...caf56ad1743778bad8af6b51b08f5baa342d4cd2,3,22,2,24,14,2013-05-18 20:30:24,2013-05-18 11:26:07
caf56ad1743778bad8af6b51b08f5baa342d4cd2...7d77e9786a118dd95a268872dd9d36664066b96a,9,155,130,285,74,2013-05-18 21:01:48,2013-05-18 11:58:45
7d77e9786a118dd95a268872dd9d36664066b96a...69523c1ba385cbf8a0524cab3b0396e9cec50114,1,21,15,36,15,2013-05-18 21:11:39,2013-05-18 21:11:39
69523c1ba385cbf8a0524cab3b0396e9cec50114...0a50311063c416ec4d39f518e8d8110dd7eddbdf,9,417,362,779,50,2013-05-18 22:04:34,2013-05-18 22:04:34
0038296135502331c302935106d7aa568f715200...3eba8c7f7fc4877e7df0f83fe3bacd88082ac33e,4,23,19,42,6,2013-05-18 19:13:27,2013-05-18 10:42:18
4ad1eb1c14b629cf5bcfd253ed40e875f1bddd47...cc62cbed76daeaea28c1e4892244bcf1e148f373,1,2,2,4,2,2013-05-19 10:51:55,2013-05-19 10:51:55
4ad1eb1c14b629cf5bcfd253ed40e875f1bddd47...26e3e7ecb5e4c9af4cd5aa178f65ce1585d3ae07,4,49,20,69,21,2013-05-19 10:50:09,2013-05-19 10:43:34
e0df647143dd595aba0e9f077703775a226d015f...89955cc35f3636684ea6f2a6c9504b35a3050f0f,10,97,40,137,39,2013-05-18 13:39:42,2013-05-18 10:54:59
0e51d8eb66121b2558a38c9f4e366df781046873...8c2c178a093513240107b1bda22a3ea48bf32865,1,0,1,1,1,2013-05-22 12:51:16,2013-05-22 12:51:16
8c2c178a093513240107b1bda22a3ea48bf32865...ef8a9bc7fafc394f2c413a6ad4057d67134d742b,4,98,4,102,4,2013-05-22 12:52:46,2013-05-22 11:57:36
ef8a9bc7fafc394f2c413a6ad4057d67134d742b...0e45f75112f3c540476207fa16bdbaec14872f6c,1,1,1,2,1,2013-05-22 13:39:46,2013-05-22 13:39:46
0e45f75112f3c540476207fa16bdbaec14872f6c...2699219c233637d0086718bd58a0b693bd652bf2,1,1,1,2,1,2013-05-22 14:25:49,2013-05-22 14:25:49
2699219c233637d0086718bd58a0b693bd652bf2...01948e384f5508c126c7216e43db3654bf6330f0,2,81,71,152,20,2013-05-22 14:26:48,2013-05-22 14:22:32
01948e384f5508c126c7216e43db3654bf6330f0...dc51ec8bc214cf60ebb99732363624c23df8005f,2,32,4,36,9,2013-05-22 15:34:02,2013-05-22 15:29:16
dc51ec8bc214cf60ebb99732363624c23df8005f...51998dffe7ef18d314daf23e8e2ef1e2c0891d32,3,3,39,42,5,2013-05-22 16:21:33,2013-05-22 16:21:33
0e51d8eb66121b2558a38c9f4e366df781046873...ee8b810b977572e39dc6acf4d13cc5e05f4d65ee,4,14,2,16,5,2013-05-22 12:48:11,2013-05-21 16:01:29
b21e96d00d12f8467d61b15a943994b303504e0e...12cb0df10f12e715bcaafbee4290c92d4ed6f111,1,22,0,22,2,2013-06-27 14:44:22,2013-06-27 14:12:35
12cb0df10f12e715bcaafbee4290c92d4ed6f111...f325f86971bf7fc30e3daafc9835f66cd7951e3a,2,25,3,28,5,2013-06-27 14:44:22,2013-06-27 14:40:26
d9a43545be1af95a13c181c8b178f5631d3a4148...ffcf24c9ce781a7c194ed8722b850e7873922f6b,32,7,46,53,39,2013-06-19 15:18:40,2013-06-19 15:18:40
ffcf24c9ce781a7c194ed8722b850e7873922f6b...7462a78c1bdef2f37ea9aae5ad05170dbd14b34a,7,47,16,63,19,2013-06-19 20:16:16,2013-06-19 20:09:40
65d1d65d52a87bba22845bcb7c3c921a8789ec19...bab9123daa5d05150951f74183906a76d2b0cf27,53,2,87,89,85,2013-10-18 00:46:24,2013-10-17 23:58:02
9bfe66164e0e214abc6063a1a60ce729094d0632...944a2bb7c1ffdbf577c3b76acd76b7df7f7e11c0,1,6,6,12,5,2013-10-15 13:51:45,2013-10-15 13:34:11
9bfe66164e0e214abc6063a1a60ce729094d0632...c7634cd7fe7dc09338fcec0ca48d816a29d791b0,10,34,18,52,15,2013-10-15 13:04:12,2013-10-08 18:30:29
c7634cd7fe7dc09338fcec0ca48d816a29d791b0...949076eb11011736f9e827adfde03c842bc1f1dd,3,21,12,33,5,2013-10-15 13:38:27,2013-10-14 08:44:55
2d0e36ae37aa7e017eb4bfe923b3ed3e7a5aa1aa...d9c01da1f8ba3d4e0947fd1d619c8f4a9b013360,1,7,0,7,1,2013-05-19 09:24:35,2013-05-18 16:37:39
d9c01da1f8ba3d4e0947fd1d619c8f4a9b013360...413735b239239bc8ff38ee893e8448daf9b2bff6,1,1,1,2,1,2013-05-19 09:24:36,2013-05-19 09:24:17
0a50311063c416ec4d39f518e8d8110dd7eddbdf...cc3b3ba93a7bfdd2ece739e97e36150a719acd3e,3,29,14,43,7,2013-05-19 08:56:09,2013-05-18 15:51:14
cc3b3ba93a7bfdd2ece739e97e36150a719acd3e...c44a2c40fe0ed79b0fa00233a204d41e9c677750,4,20,9,29,10,2013-05-19 09:31:27,2013-05-19 09:20:10
c44a2c40fe0ed79b0fa00233a204d41e9c677750...65c557115f6e76293c39ce7b73b62216911f9489,2,3,2,5,4,2013-05-19 10:49:03,2013-05-19 10:49:03
0a50311063c416ec4d39f518e8d8110dd7eddbdf...004fde0702957bd73b49313ed17919da71dc909f,1,1,1,2,1,2013-05-19 08:29:24,2013-05-19 08:29:24
0a50311063c416ec4d39f518e8d8110dd7eddbdf...cafcc22b01579b51c0b4304d1e30fa5f5cb24f42,1,1,1,2,1,2013-05-19 07:28:36,2013-05-19 07:28:36
c70ca4879ee33fc4b70ad9a17d74b649f8f75487...5124ab7620a2cb448a8edec7eb6cfa69c60bcc8c,1,3,1,4,2,2013-05-19 08:36:04,2013-05-19 08:36:04
11b06532f7633478b341c9d1da6d29e9839a4e9a...3de1288042f2dc1cb8a2b36ae0fc4d9e0beb6494,8,158,2,160,10,2013-05-23 05:09:22,2013-05-17 22:18:35
f325f86971bf7fc30e3daafc9835f66cd7951e3a...6fcb7ba84239ef1f6b3451c70d40a5ae1cdffcf5,1,1,1,2,1,2013-06-27 16:39:50,2013-06-27 16:39:50
7462a78c1bdef2f37ea9aae5ad05170dbd14b34a...c4a0c91459185a1c78bb75bdf32e42943da09a7d,1,1,1,2,1,2013-06-19 23:45:28,2013-06-19 23:45:28
65750b83523870851008e804364121f8c458fc2d...a800036981c6fea8eb3dac22467965c71af05d29,71,152,152,304,152,2013-10-18 09:07:39,2013-10-18 09:02:43
a800036981c6fea8eb3dac22467965c71af05d29...ac4fec5ca2d429a565919033ea4d801db51a8e9e,2,4,2,6,2,2013-10-18 12:31:19,2013-10-17 23:51:45
ac4fec5ca2d429a565919033ea4d801db51a8e9e...651bb73ab35d664ff95e33e0fc45b8c42102946f,1,1,2,3,2,2013-10-18 12:47:28,2013-10-18 12:47:28
651bb73ab35d664ff95e33e0fc45b8c42102946f...a3372f67cba4cffc2b0c40f006fe23f9bf31650f,2,35,2,37,5,2013-10-18 13:42:45,2013-09-25 16:59:33
a3372f67cba4cffc2b0c40f006fe23f9bf31650f...f8632572ad84b05256423841cee6335490ba0698,1,24,0,24,2,2013-10-18 20:19:05,2013-10-17 01:48:03
f8632572ad84b05256423841cee6335490ba0698...59a8808632dc64b13b4b576ef9ce2a26ab897943,1,22,35,57,10,2013-10-19 08:43:06,2013-10-19 08:29:17
59a8808632dc64b13b4b576ef9ce2a26ab897943...5f52590368063fc8284e23be492d83ba751f66bf,2,4,2,6,2,2013-10-19 08:43:06,2013-10-19 08:40:20
5f52590368063fc8284e23be492d83ba751f66bf...96d1d4e29275f4f5900f0725975d2ad0a4d05816,72,309,339,648,222,2013-10-19 12:31:38,2013-10-19 12:31:38
96d1d4e29275f4f5900f0725975d2ad0a4d05816...584110417f6a3c16cc0c6723825a21940a9a2bc4,9,46,13,59,13,2013-10-19 13:48:57,2013-10-19 00:24:38
584110417f6a3c16cc0c6723825a21940a9a2bc4...8d6953d55c3aba04bbaf0f268499d6e405c653ff,2,5,12,17,2,2013-10-19 16:10:18,2013-10-18 17:14:01
8d6953d55c3aba04bbaf0f268499d6e405c653ff...a3690168cbde5e7bee16443569ad3dedd2466af7,1,1,0,1,1,2013-10-21 04:18:44,2013-10-21 04:17:52
a3690168cbde5e7bee16443569ad3dedd2466af7...b289fcf1bfeaa717ed465b2529a275b61dc02d92,80,647,635,1282,208,2013-10-21 12:31:30,2013-10-19 23:33:10
b289fcf1bfeaa717ed465b2529a275b61dc02d92...499cd912ca36597df737df73c8f91ffab36c83d9,6,33,33,66,27,2013-10-21 12:52:21,2013-10-21 12:52:21
499cd912ca36597df737df73c8f91ffab36c83d9...3565efaa451db6eb735a085ea6aae3fe86e6d283,16,137,223,360,110,2013-10-21 15:31:05,2013-10-14 13:14:17
3565efaa451db6eb735a085ea6aae3fe86e6d283...1e39982b6ef1fd10e53392f4cb52bea3805d186f,1,4,2,6,1,2013-10-21 17:02:21,2013-10-21 14:53:25
1e39982b6ef1fd10e53392f4cb52bea3805d186f...1e4f53a6eb8d1816e51eb8bd8f95e704f6b89ead,1,9,20,29,4,2013-10-21 17:54:47,2013-09-17 23:14:38
1e4f53a6eb8d1816e51eb8bd8f95e704f6b89ead...7d0d0dbf26a3c0d16e9c2b930fd6d7b89f215946,2,40,0,40,4,2013-10-21 18:31:28,2013-09-24 18:52:20
7d0d0dbf26a3c0d16e9c2b930fd6d7b89f215946...28b70425afb2fb8bcbec09d249e37fa786f8a155,2,10,1,11,4,2013-10-21 18:32:02,2013-10-18 13:09:56
28b70425afb2fb8bcbec09d249e37fa786f8a155...e565e1332ddfbb44fe7e6139375e3c243af7398d,5,62,3,65,16,2013-10-21 18:54:52,2013-10-21 17:33:57
e565e1332ddfbb44fe7e6139375e3c243af7398d...86c248aa646183ef4a1cb407bb3e4cb597272f63,1,1,1,2,1,2013-10-21 19:08:53,2013-10-21 19:05:48
86c248aa646183ef4a1cb407bb3e4cb597272f63...a098bee1b9fa4df64f3fd72ff5cbae43bf27e539,2,20,0,20,2,2013-10-21 19:26:48,2013-10-21 19:21:49
a098bee1b9fa4df64f3fd72ff5cbae43bf27e539...b5f52647fe513ec5f1b3e9b0bf06b7860ea72626,2,11,7,18,9,2013-10-22 09:09:21,2013-10-21 03:22:32
b5f52647fe513ec5f1b3e9b0bf06b7860ea72626...2110b3136552493fe7771c98f8ffb012d8bb5538,1,7,7,14,2,2013-10-22 12:10:56,2013-10-22 09:19:38
2110b3136552493fe7771c98f8ffb012d8bb5538...8e2029f8ddd744acb97e236cb0703d94b12d5ff8,16,76,16,92,16,2013-10-22 12:32:01,2013-10-22 12:28:34
8e2029f8ddd744acb97e236cb0703d94b12d5ff8...0d0f4f020afe516f23fd2305f13ff0a6a539b344,8,58,14,72,11,2013-10-22 13:24:42,2013-10-18 11:56:32
0d0f4f020afe516f23fd2305f13ff0a6a539b344...1597503a017a9ced422a81d314cb4097d53c3dfd,30,94,90,184,66,2013-10-22 13:51:39,2013-10-22 13:31:43
1597503a017a9ced422a81d314cb4097d53c3dfd...5240b83462ba4887b67da8d493dfdc23fec5df97,9,56,2,58,15,2013-10-22 14:29:57,2013-02-21 22:02:18
5240b83462ba4887b67da8d493dfdc23fec5df97...9704c49d5951aadbfc03624e399d881ebf7a3eb5,1,1,1,2,1,2013-10-22 16:05:26,2013-10-22 16:05:26
9704c49d5951aadbfc03624e399d881ebf7a3eb5...2eb8f15516089e9b2ab34d9f4eb7a4a3a65ac63e,3,56,0,56,4,2013-10-22 21:41:10,2013-09-25 13:33:29
2eb8f15516089e9b2ab34d9f4eb7a4a3a65ac63e...51d2e1fb233b5507bf14300787939717c4d93834,8,24,32,56,14,2013-10-23 01:19:56,2013-10-22 23:38:11
51d2e1fb233b5507bf14300787939717c4d93834...ae48d77ef8e14dae76fddcd5a677b897c7c7c4ae,43,103,92,195,75,2013-10-23 10:09:29,2013-10-23 10:09:29
ae48d77ef8e14dae76fddcd5a677b897c7c7c4ae...aefc1d4e65c04f3fc6863a2e0563957c3b1e726b,1,3,3,6,3,2013-10-23 11:19:42,2013-10-23 10:59:06
aefc1d4e65c04f3fc6863a2e0563957c3b1e726b...317040a73b77be8f8210801793b2ce6d1a69301e,2,28,0,28,2,2013-10-23 11:51:22,2013-10-21 15:12:48
317040a73b77be8f8210801793b2ce6d1a69301e...c3aa2948c6c14862407501290571f858ccf45b07,83,180,2,182,179,2013-10-23 12:45:03,2013-10-22 10:21:07
ec0e780e7ff2f6d4ac22fa8d41040e45b519e80e...f719d4afc74e750b34247a574f800598c3daf1cc,1,41,27,68,19,2013-10-15 14:18:51,2013-10-07 01:06:46
f719d4afc74e750b34247a574f800598c3daf1cc...dd1ab8982be0ab8bd648b57c0bbc6a100a429695,1,1,3,4,2,2013-10-15 14:36:31,2013-10-15 14:36:31
dd1ab8982be0ab8bd648b57c0bbc6a100a429695...349c12d3f5c015c2f8b36917da21230c2ac1acb4,5,55,50,105,15,2013-10-15 14:59:36,2013-10-15 12:15:02
349c12d3f5c015c2f8b36917da21230c2ac1acb4...2af58a2cef8b0d30c18f6d0d106cb0e093c673ab,1,1,1,2,1,2013-10-15 15:20:03,2013-10-15 15:17:32
413735b239239bc8ff38ee893e8448daf9b2bff6...e80636b6683893d40e171745a4ef0a2f1a09cc82,3,39,13,52,20,2013-05-19 10:05:57,2013-05-19 09:44:46
413735b239239bc8ff38ee893e8448daf9b2bff6...56d6fdbbf50b29bd162fd5ab3296a25127d7af65,1,6,6,12,4,2013-05-19 09:48:57,2013-05-18 16:50:58
8133ee6cb4c3e9fee613ee772197dc77cdc78cd1...6845dc7e8f6e4f5422e9381f5e045e1a521a76b4,1,1,1,2,1,2013-05-23 08:19:10,2013-05-23 08:19:10
88d5f3219595380bf8bb395ce00b130d1f4c9ea9...c1284c3d3c6131a9d0ded9601ae0feb9a2e81a65,4,74,2,76,6,2013-06-27 20:19:54,2013-06-27 20:19:54
c1284c3d3c6131a9d0ded9601ae0feb9a2e81a65...534ced5aadf964eca4cf29a689dc70185f582772,2,11,3,14,4,2013-06-27 23:39:20,2013-06-27 23:39:20
534ced5aadf964eca4cf29a689dc70185f582772...7c0b72a826a3637b30a57553ac83f6b913c33134,1,3,2,5,3,2013-06-28 00:13:42,2013-06-28 00:13:42
7c0b72a826a3637b30a57553ac83f6b913c33134...d097417025e71286ad5bbde6e0a79caacabbbd64,9,147,34,181,24,2013-06-28 03:59:10,2013-06-28 03:15:03
d097417025e71286ad5bbde6e0a79caacabbbd64...5caced89e0ac2f942b68bc5f163d156a42880f16,1,1,1,2,1,2013-06-28 07:43:14,2013-06-28 07:43:14
3671e7e3e0603ed8908eb1328a82396e22b9224c...18e79f1425fa87f2f38df25c65203ec4d311f499,3,19,0,19,5,2013-06-20 10:55:27,2013-06-20 10:55:27
18e79f1425fa87f2f38df25c65203ec4d311f499...fdbcbb9ebdd49ad693b686e132d1e9cd9a00801b,1,1,1,2,1,2013-06-20 13:39:58,2013-06-20 13:39:58
fdbcbb9ebdd49ad693b686e132d1e9cd9a00801b...df4a74d7097f15cc271fee1c797dee3b96755066,1,3,3,6,3,2013-06-20 13:58:01,2013-06-20 01:02:25
df4a74d7097f15cc271fee1c797dee3b96755066...6ef199a08e1c452289deda67629b1630d25ccfcf,1,1,1,2,1,2013-06-20 14:41:29,2013-06-20 14:41:29
6ef199a08e1c452289deda67629b1630d25ccfcf...04628e2016641bfa657333d6ee1f5b371c17f62c,3,5,11,16,4,2013-06-20 14:59:41,2013-06-20 03:42:23
04628e2016641bfa657333d6ee1f5b371c17f62c...7314007c5bf57b9184c0bd6a8246582dd2cb8179,1,3,2,5,2,2013-06-20 17:34:02,2013-06-20 17:34:02
7314007c5bf57b9184c0bd6a8246582dd2cb8179...552a90b44456f24de228a6c7cd916c040787cf22,4,34,2,36,9,2013-06-21 14:57:47,2013-04-19 09:44:47
552a90b44456f24de228a6c7cd916c040787cf22...b53ed5ac55d5881f129c4921199af355e2b13565,1,6,9,15,1,2013-06-21 15:50:43,2013-06-21 15:46:10
b53ed5ac55d5881f129c4921199af355e2b13565...ba610cb319d8882a663effcaf0a4e53c04593f98,1,5,2,7,1,2013-06-21 17:14:05,2013-06-20 06:36:13
ba610cb319d8882a663effcaf0a4e53c04593f98...9be93aa809c34083ebef8392e52c83df0e383be3,2,4,2,6,2,2013-06-21 18:57:12,2013-06-21 18:55:59
9be93aa809c34083ebef8392e52c83df0e383be3...ef79582e8630cb3c119caed52130c9671188addd,3,28,9,37,7,2013-06-22 07:29:37,2013-06-22 07:25:14
c3aa2948c6c14862407501290571f858ccf45b07...d72059c2ae2753ee7d7e0ba8e684ed3d04909e53,1,1,1,2,1,2013-10-23 14:56:13,2013-10-23 14:56:13
2af58a2cef8b0d30c18f6d0d106cb0e093c673ab...776b6470c10bdcf1302fa95c2e81be2b11bb2fdc,1,2,2,4,1,2013-10-15 19:28:04,2013-10-15 19:28:04
9a1ea4e7e8214a001ca43ae6f0fcea96a5d51489...753edfa4b5cf46be5fc1f04d80c25f30b18af798,1,2,2,4,1,2013-05-19 10:14:44,2013-05-19 10:14:19
56d6fdbbf50b29bd162fd5ab3296a25127d7af65...60d94c2a80a68861021526c0fef7fc40e648e81f,5,16,12,28,10,2013-05-19 11:28:09,2013-05-19 11:28:09
01769823f13df6e922faf63a2ac07293dc54b176...8c2fd050f80f528cc1609c1a7f16901194834831,5,58,8,66,10,2013-05-23 10:49:29,2013-05-21 21:32:39
8c2fd050f80f528cc1609c1a7f16901194834831...b664cb818d2e5896df2763299ea2c61a9af069a8,3,18,9,27,6,2013-05-23 12:01:27,2013-05-23 12:00:17
b664cb818d2e5896df2763299ea2c61a9af069a8...8aca2504df9d7d3c1244d1632f6cad45afa60115,1,15,0,15,1,2013-05-23 12:16:03,2013-05-23 01:12:55
8aca2504df9d7d3c1244d1632f6cad45afa60115...9e65bd33db5d211e114f6193ec2f70ccd4947e72,1,1,1,2,1,2013-05-23 12:36:53,2013-05-23 12:36:53
9e65bd33db5d211e114f6193ec2f70ccd4947e72...a46a399534c26abd3f4984149b820f34869d6b74,1,2,1,3,1,2013-05-23 12:52:55,2013-05-23 12:52:55
a46a399534c26abd3f4984149b820f34869d6b74...499a745ae1b53614035b9993b148f32d4ce3f138,3,30,4,34,7,2013-05-23 13:19:12,2013-05-21 09:11:05
499a745ae1b53614035b9993b148f32d4ce3f138...2d8c132b187d9dfefe0f409c4fb39b54a6645675,2,19,12,31,5,2013-05-23 13:19:12,2013-05-21 09:35:05
2d8c132b187d9dfefe0f409c4fb39b54a6645675...6a6bb168be90594a18ab6d62c994889b7e745055,2,14,6,20,4,2013-05-23 13:19:12,2013-05-21 10:21:31
6a6bb168be90594a18ab6d62c994889b7e745055...ec5dc0010c30f9ca7e9294b97e909f5b47ac1683,1,41,8,49,5,2013-05-23 14:15:02,2013-05-23 14:14:31
ec5dc0010c30f9ca7e9294b97e909f5b47ac1683...cf007f0cbfe936ff699d761b243343201ca5c195,1,2,2,4,2,2013-05-23 14:23:06,2013-05-23 14:22:52
cf007f0cbfe936ff699d761b243343201ca5c195...5a62236b169e74f627492a90b091e8c9339a0181,1,1,0,1,1,2013-05-23 14:48:36,2013-05-23 14:48:36
5a62236b169e74f627492a90b091e8c9339a0181...dffdca1109a2111f104f2419d081c0f971537fec,1,12,3,15,2,2013-05-23 14:57:44,2013-05-23 14:57:44
dffdca1109a2111f104f2419d081c0f971537fec...8dda8a5ecc8f481364dc8f58b4ba319e5b016679,1,0,5,5,4,2013-05-23 19:58:08,2013-05-23 19:58:08
8dda8a5ecc8f481364dc8f58b4ba319e5b016679...48424adaba74379eee311b3d1519f011212357ad,6,179,17,196,24,2013-05-23 23:03:14,2013-05-20 17:51:05
48424adaba74379eee311b3d1519f011212357ad...4fd94969d859eb25680a5a52ed482c8f22e5ee15,3,51,3,54,4,2013-05-24 10:10:48,2013-05-24 09:01:34
4fd94969d859eb25680a5a52ed482c8f22e5ee15...17559e6eb0422aa6ec7bd9b7f1345b97a2a454a6,1,22,25,47,4,2013-05-24 10:19:44,2013-05-24 10:19:44
5caced89e0ac2f942b68bc5f163d156a42880f16...27cf7ec864318daf5957fa0e65c04f7a260ee1c8,2,3,3,6,3,2013-06-28 13:56:45,2013-06-28 13:56:45
27cf7ec864318daf5957fa0e65c04f7a260ee1c8...94f420ef48eb87e6fb6f1fe66d68a11e1b8b939d,1,4,7,11,3,2013-06-28 14:27:07,2013-06-28 14:27:07
94f420ef48eb87e6fb6f1fe66d68a11e1b8b939d...8809da67a22117c0010607b801e5c31ec7bdc735,1,6,10,16,3,2013-06-28 14:38:55,2013-06-28 14:38:55
8809da67a22117c0010607b801e5c31ec7bdc735...48dd1e63bbb93479666208535a56f8c7c4aeab3a,6,501,1,502,24,2013-06-28 16:27:52,2013-06-28 16:26:05
5caced89e0ac2f942b68bc5f163d156a42880f16...70f2d9aaffcdd255b1fde6c83b7fe584c4ee3d45,2,2,2,4,2,2013-06-28 13:15:10,2013-06-28 13:15:10
70f2d9aaffcdd255b1fde6c83b7fe584c4ee3d45...ec2a102d8491a708b56abb19caeebdc5562c2a9c,1,4,7,11,3,2013-06-28 14:28:02,2013-06-28 14:27:07
ec2a102d8491a708b56abb19caeebdc5562c2a9c...dc99128343a08dce8a056e50047ea8bc909740d5,1,6,10,16,3,2013-06-28 14:39:50,2013-06-28 14:38:55
dc99128343a08dce8a056e50047ea8bc909740d5...e628753e7dd1611fb4cf770a78126e96a02ab1d7,1,3,0,3,1,2013-06-28 19:49:40,2013-06-28 19:33:20
e628753e7dd1611fb4cf770a78126e96a02ab1d7...7bd9c32f14a0a56089358f7927a3326e78bee093,1,3,3,6,1,2013-06-29 08:52:11,2013-06-29 08:50:04
7bd9c32f14a0a56089358f7927a3326e78bee093...6908b6593949a205d05da342060a9d952bd7b77c,1,0,1,1,1,2013-06-29 09:43:41,2013-06-29 09:40:31
6908b6593949a205d05da342060a9d952bd7b77c...c55cb6fa4524884c8b881b255ed0bb20f5e0b26a,1,1,1,2,1,2013-06-29 14:28:52,2013-06-29 14:28:05
c55cb6fa4524884c8b881b255ed0bb20f5e0b26a...b6aed803b20cc7898a82fd65845e97676276f3fa,2,13,0,13,2,2013-06-29 16:11:51,2013-06-27 08:58:05
b6aed803b20cc7898a82fd65845e97676276f3fa...a9b5a1e506a9e8492407399b8bec1c2a8420be60,2,9,0,9,2,2013-06-29 16:12:23,2013-06-27 08:59:30
a9b5a1e506a9e8492407399b8bec1c2a8420be60...59be2c6875eaf744798d14c9dc8498552c8d48d5,2,12,1,13,2,2013-06-29 16:48:05,2013-06-29 16:44:41
59be2c6875eaf744798d14c9dc8498552c8d48d5...b930733a67cbc1235daf675de06d73e3b6406113,2,5,5,10,2,2013-06-29 18:16:36,2013-06-29 18:14:32
b930733a67cbc1235daf675de06d73e3b6406113...d2550042894726c5b74a9a2374304b75a4ac30bc,4,31,66,97,61,2013-06-30 12:20:29,2013-06-30 12:17:33
d2550042894726c5b74a9a2374304b75a4ac30bc...02976a46c926880e78eb64424a9c8aa28d8be48a,2,27,19,46,16,2013-06-30 14:29:57,2013-06-30 13:57:00
02976a46c926880e78eb64424a9c8aa28d8be48a...3493f18d7850236dcb6292ebb1b949d6aeed7a9c,4,27,52,79,5,2013-06-30 18:56:10,2013-06-30 18:48:15
3493f18d7850236dcb6292ebb1b949d6aeed7a9c...c1d8f3b2078db05bcc66b664c1d17b7799342bd5,1,24,25,49,5,2013-07-01 09:48:58,2013-07-01 09:44:59
c1d8f3b2078db05bcc66b664c1d17b7799342bd5...0de21a6a7a6c651382bae50f13468316e40471b5,2,4,7,11,2,2013-07-01 09:52:00,2013-07-01 09:52:00
0de21a6a7a6c651382bae50f13468316e40471b5...e03a88ba217006fbd7618e3f836c2f6210638aaf,1,12,13,25,4,2013-07-01 12:10:03,2013-07-01 12:05:49
e03a88ba217006fbd7618e3f836c2f6210638aaf...3c51962cabc9537221b86c667aac5ffaa1469660,2,10,8,18,10,2013-07-01 13:21:07,2013-07-01 13:19:55
3c51962cabc9537221b86c667aac5ffaa1469660...4c1029971e810cde32ee4cd489627239b9b1b6ed,2,3,1,4,3,2013-07-01 13:38:29,2013-07-01 13:36:31
4c1029971e810cde32ee4cd489627239b9b1b6ed...5ecdf0eb9ccd47c102deb873a242ed40d1cf45cd,3,6,6,12,5,2013-07-02 18:16:22,2013-07-02 18:14:56
5ecdf0eb9ccd47c102deb873a242ed40d1cf45cd...b36f55c5a5bc7e3dac8a811973c7f7ad1c92d7c5,1,7,0,7,1,2013-07-03 12:46:05,2013-07-03 12:44:03
b36f55c5a5bc7e3dac8a811973c7f7ad1c92d7c5...295a925ceffb0499614bfbe0fb657440b7cf5b9c,1,12,2,14,3,2013-07-03 14:15:52,2013-07-03 14:03:11
295a925ceffb0499614bfbe0fb657440b7cf5b9c...2f9e5483f6e65bcc0364833517fdae26f1b8c885,2,24,6,30,7,2013-07-03 14:38:53,2013-07-03 06:13:38
2f9e5483f6e65bcc0364833517fdae26f1b8c885...75041d5ea3821912abf8b9d1cd5477228a78cb23,1,9,2,11,4,2013-07-03 15:11:04,2013-07-02 08:19:44
75041d5ea3821912abf8b9d1cd5477228a78cb23...2de0d4c4523ca3d1d6744ba0f22b8ef33bedfa03,2,10,2,12,4,2013-07-03 18:12:56,2013-07-03 17:13:47
2de0d4c4523ca3d1d6744ba0f22b8ef33bedfa03...25b9939fed397c0764fea22b72e7e94baf9505b9,1,5,3,8,1,2013-07-04 09:45:16,2013-07-04 09:44:22
25b9939fed397c0764fea22b72e7e94baf9505b9...9687e387d80bba33f82593915bb1351ae73e54f6,1,21,10,31,3,2013-07-04 12:32:49,2013-07-03 11:59:35
9687e387d80bba33f82593915bb1351ae73e54f6...23748c483b128773edb5f5e8ee509bf12732595c,2,7,6,13,4,2013-07-04 13:34:02,2013-07-04 13:32:32
23748c483b128773edb5f5e8ee509bf12732595c...541a30c3768fa86ecb85ceea8545af175bada4fb,1,3,2,5,1,2013-07-04 14:20:02,2013-07-04 14:19:00
541a30c3768fa86ecb85ceea8545af175bada4fb...d14db25feec73690b1cd52b3f8b83e3e38deb23b,2,27,1,28,3,2013-07-05 00:15:27,2013-07-04 23:58:58
d14db25feec73690b1cd52b3f8b83e3e38deb23b...80dc8175a653eee5d7f09e5f357eac75bdab3a3b,1,1,1,2,1,2013-07-05 09:58:35,2013-07-04 19:31:58
80dc8175a653eee5d7f09e5f357eac75bdab3a3b...14a5b79e294506ab045a14fbec89030510f1cefe,1,16,2,18,2,2013-07-05 10:54:34,2013-07-05 10:53:19
14a5b79e294506ab045a14fbec89030510f1cefe...430aae1b0db9fbcc15415b7bd9a14df1d88359cf,1,5,8,13,3,2013-07-05 11:21:13,2013-07-05 11:20:05
430aae1b0db9fbcc15415b7bd9a14df1d88359cf...a9dd6221af2148410c8a26dcbafd1ff8cc0fb107,24,65,24,89,39,2013-07-05 17:30:08,2013-07-04 13:19:33
a9dd6221af2148410c8a26dcbafd1ff8cc0fb107...a22b2aea192e8722aa3004c9e50e728438a453cd,1,7,0,7,1,2013-07-06 22:34:29,2013-07-06 22:31:59
a22b2aea192e8722aa3004c9e50e728438a453cd...40d26877871caed894bd59ed735f84c1807472da,1,2,1,3,1,2013-07-07 16:40:44,2013-07-07 01:24:38
40d26877871caed894bd59ed735f84c1807472da...ced144155e5c6a8fc9508abc741c30ed8dc005ad,1,1,1,2,1,2013-07-08 10:04:10,2013-07-08 09:35:30
ced144155e5c6a8fc9508abc741c30ed8dc005ad...0a84cbadb76c353d6cedeef9e6b97a9d32c60635,1,3,3,6,3,2013-07-08 10:04:38,2013-07-08 10:03:26
0a84cbadb76c353d6cedeef9e6b97a9d32c60635...cf8d0933cb5bba3ce869f55cd423054d9c128956,3,22,10,32,8,2013-07-08 12:31:46,2013-07-08 12:29:28
cf8d0933cb5bba3ce869f55cd423054d9c128956...67a6b5e53f62e90c7e8587d1f110aa3d7bb9afbf,1,8,0,8,1,2013-07-08 13:59:02,2013-07-08 13:57:50
67a6b5e53f62e90c7e8587d1f110aa3d7bb9afbf...730069197fd29d7b055a260a1344802b16415fb4,1,10,3,13,3,2013-07-08 16:21:25,2013-07-08 16:08:30
730069197fd29d7b055a260a1344802b16415fb4...b2afe396635e2de5b3a917a61350cd96fbde9ab7,7,105,98,203,44,2013-07-08 18:09:02,2013-06-20 06:51:20
b2afe396635e2de5b3a917a61350cd96fbde9ab7...f03398a2461e240c7e7401e1c51878c8af619ed2,1,9,0,9,1,2013-07-08 19:06:31,2013-07-08 19:01:37
f03398a2461e240c7e7401e1c51878c8af619ed2...c1b24b09f4e3a390d015fc53af02621b1b120bc6,2,5,4,9,3,2013-07-09 11:16:31,2013-07-07 01:24:38
c1b24b09f4e3a390d015fc53af02621b1b120bc6...e2c1e9ef55b340ecb789a4dbb2d34372c98a2fcf,1,4,4,8,4,2013-07-09 12:34:16,2013-07-09 11:10:36
e2c1e9ef55b340ecb789a4dbb2d34372c98a2fcf...7788c7189036bcd78692aaae1dd4260d7a7563bf,1,1,1,2,1,2013-07-09 15:57:44,2013-07-09 15:55:45
7788c7189036bcd78692aaae1dd4260d7a7563bf...ae685e54cb8b5d654180ac66b9fd4d68ad28a66b,1,1,1,2,1,2013-07-09 17:52:16,2013-07-08 20:47:02
ae685e54cb8b5d654180ac66b9fd4d68ad28a66b...d200405471957fa67e21b2cbf08390cefbcd8482,3,21,49,70,12,2013-07-09 19:42:11,2013-07-09 19:12:51
d200405471957fa67e21b2cbf08390cefbcd8482...a2b4af3a1a145b8b0eb018e590f0beb0e428c5d2,2,4,5,9,2,2013-07-09 19:43:20,2013-07-09 19:35:01
a2b4af3a1a145b8b0eb018e590f0beb0e428c5d2...aecbaaed0c1a0d7da99a8d3deb9328ad2b5c601d,8,32,1,33,14,2013-07-10 13:37:15,2013-07-01 17:58:04
aecbaaed0c1a0d7da99a8d3deb9328ad2b5c601d...2e3250fc90499b2977c39ca8af8d0c245c9bcd77,1,4,0,4,2,2013-07-10 16:02:56,2013-07-10 16:01:17
2e3250fc90499b2977c39ca8af8d0c245c9bcd77...f93b2fe7e698a9dd48d839465c75b16013b0f652,1,1,1,2,1,2013-07-11 11:37:42,2013-07-11 11:36:25
f93b2fe7e698a9dd48d839465c75b16013b0f652...fe0a563f812d9b05ef79ab89e0cb505b288b0d6a,1,2,1,3,2,2013-07-11 15:07:51,2013-07-11 15:06:34
fe0a563f812d9b05ef79ab89e0cb505b288b0d6a...9bb04b1a6bcb98e7061f475aaac58add89d048ba,1,4,4,8,1,2013-07-12 10:06:17,2013-07-12 09:50:08
9bb04b1a6bcb98e7061f475aaac58add89d048ba...1c8e539a7723fe2d76b5c5a8b83c8a3da2d9fc39,1,16,0,16,2,2013-07-12 10:22:19,2013-07-12 10:19:16
1c8e539a7723fe2d76b5c5a8b83c8a3da2d9fc39...b30a872973b6903e52d93532175d60d3bf68f888,2,4,4,8,3,2013-07-12 16:50:53,2013-07-12 16:48:49
b30a872973b6903e52d93532175d60d3bf68f888...45fab74561a2b339cde922c196ab3ccf998bad10,2,17,1,18,2,2013-07-12 20:06:43,2013-07-12 20:05:14
45fab74561a2b339cde922c196ab3ccf998bad10...7f210563ab90d4d3957e7e1efc5b102777357e8b,1,1,0,1,1,2013-07-12 22:00:09,2013-07-12 22:00:09
7f210563ab90d4d3957e7e1efc5b102777357e8b...db33b25e8617185acbadb4ff04eaa4c37ae67dd6,4,31,10,41,9,2013-07-13 14:20:09,2013-07-13 09:43:14
db33b25e8617185acbadb4ff04eaa4c37ae67dd6...26b88e7658e7be52de3c72b76ec64b3ce92ceda0,1,1,0,1,1,2013-07-13 17:22:00,2013-07-13 17:15:28
26b88e7658e7be52de3c72b76ec64b3ce92ceda0...e5241902f3d4b0f925eb67809dfb732dd46ba597,2,37,2,39,5,2013-07-13 21:46:37,2013-07-13 21:46:05
e5241902f3d4b0f925eb67809dfb732dd46ba597...f8fd38b56025a1fe18bfb7e12a982b35a4c7895a,1,1,1,2,1,2013-07-14 16:35:26,2013-07-14 03:28:04
f8fd38b56025a1fe18bfb7e12a982b35a4c7895a...3d25f592fe3d95df5ce0fc75f1580946d77950ef,1,12,7,19,7,2013-07-15 15:31:38,2013-07-15 15:31:06
3d25f592fe3d95df5ce0fc75f1580946d77950ef...ed473d61e50d8a40103138b96aa57f55eb9786b9,1,83,52,135,10,2013-07-16 23:21:55,2013-07-16 19:27:52
ed473d61e50d8a40103138b96aa57f55eb9786b9...0db3c45f80aa6b77ddda27487cbe2934ca0a7297,1,1,1,2,1,2013-07-17 10:51:34,2013-07-17 10:50:40
0db3c45f80aa6b77ddda27487cbe2934ca0a7297...9d9f670d935ba36e77af006cdac33dae21fedbd2,1,1,1,2,1,2013-07-18 11:46:42,2013-07-18 10:26:32
9d9f670d935ba36e77af006cdac33dae21fedbd2...1641aa7119f72fda2247a0a023b507c272ce5ba8,1,1,1,2,1,2013-07-18 12:06:50,2013-07-18 11:58:51
1641aa7119f72fda2247a0a023b507c272ce5ba8...fcd5f3a8d906e118f818b9f1409cbbccda57ae8e,2,2,2,4,2,2013-07-18 12:47:58,2013-07-18 11:53:54
fcd5f3a8d906e118f818b9f1409cbbccda57ae8e...579ca9ee8d3c47ba46385db6beb2318cea97b123,1,2,0,2,1,2013-07-18 16:41:51,2013-07-18 16:41:01
579ca9ee8d3c47ba46385db6beb2318cea97b123...c660f0e9857e570628e68fa856cc0b613382bd1a,5,24,11,35,14,2013-07-18 22:23:21,2013-07-18 19:17:40
c660f0e9857e570628e68fa856cc0b613382bd1a...b7556a4980bb632059cdc1f1286507528c3e01ce,1,1,1,2,1,2013-07-19 09:19:46,2013-07-19 08:48:38
b7556a4980bb632059cdc1f1286507528c3e01ce...e7435fbe2f1e30570fced71d286edad98674fa51,1,1,1,2,1,2013-07-19 09:30:55,2013-07-19 05:46:08
e7435fbe2f1e30570fced71d286edad98674fa51...9b26cb72d94d7d3b7bb85e55d71de35ee6c939d4,1,6,6,12,3,2013-07-19 10:31:38,2013-07-19 08:01:13
9b26cb72d94d7d3b7bb85e55d71de35ee6c939d4...496f319970fdc8d9ced6779f9866e7959b646bae,1,4,12,16,2,2013-07-19 10:36:26,2013-07-19 00:15:30
496f319970fdc8d9ced6779f9866e7959b646bae...9d3f7a21a337aa82d5c9ac5ef9a6a3888bff62a8,3,20,3,23,3,2013-07-20 03:45:29,2013-07-19 02:01:51
9d3f7a21a337aa82d5c9ac5ef9a6a3888bff62a8...706e542eb5db0d14277f34566d351b875e645bac,6,64,6,70,9,2013-07-21 17:13:20,2013-07-21 17:13:20
706e542eb5db0d14277f34566d351b875e645bac...48516d3b853e99600c60fed26b5c12ed3fc4a4d8,2,2,1,3,2,2013-07-21 19:12:50,2013-07-20 16:00:23
48516d3b853e99600c60fed26b5c12ed3fc4a4d8...816bf0c6a7a13efb7ae17c9773f984f2dd16fc72,3,3,2,5,3,2013-07-22 07:07:04,2013-07-21 20:26:03
816bf0c6a7a13efb7ae17c9773f984f2dd16fc72...92f66a613498172e6300c8a0b57513183e998597,2,21,3,24,6,2013-07-22 08:03:31,2013-07-22 07:55:45
92f66a613498172e6300c8a0b57513183e998597...43f1d51b4ba3ab2c0223928904e1d24c0571da8d,1,11,5,16,5,2013-07-23 12:37:26,2013-07-23 12:06:02
43f1d51b4ba3ab2c0223928904e1d24c0571da8d...ad898453b71d231402684c9e165bd4df9a1cfb76,3,72,4,76,9,2013-07-23 12:33:38,2012-10-24 15:11:41
ad898453b71d231402684c9e165bd4df9a1cfb76...4525eab0779a2946063288224dcebb61ba382976,2,27,2,29,4,2013-07-23 13:43:43,2013-07-23 13:41:09
4525eab0779a2946063288224dcebb61ba382976...7295a8262f4f963ba7336337e2cd175be3db6f8c,1,1,1,2,1,2013-07-23 20:19:02,2013-07-23 17:32:09
7295a8262f4f963ba7336337e2cd175be3db6f8c...45d5a4e7d22bb8541dcb8e8dc7d1e951758ac0ad,1,3,0,3,1,2013-07-24 08:27:34,2013-07-23 20:58:43
45d5a4e7d22bb8541dcb8e8dc7d1e951758ac0ad...cd46463eb170b4888931966a576188ddd17bfeff,1,1,1,2,1,2013-07-24 11:33:49,2013-07-24 11:14:32
cd46463eb170b4888931966a576188ddd17bfeff...76047498719836c7c33c4610afb21b0d000e1393,1,1,1,2,1,2013-07-25 11:39:36,2013-07-25 10:57:49
76047498719836c7c33c4610afb21b0d000e1393...d439f85bbfd9f86dd91e70498ba536394690d1ab,3,23,3,26,5,2013-07-25 13:35:04,2013-07-25 13:25:23
d439f85bbfd9f86dd91e70498ba536394690d1ab...ec6928be3430e5113a888da43a9b386f85add40b,1,20,0,20,1,2013-07-25 15:08:47,2013-07-25 12:48:22
ec6928be3430e5113a888da43a9b386f85add40b...9abbad491ac78fd061fe4b0dd96065fbbe4625fc,1,1,1,2,1,2013-07-25 16:32:38,2013-07-25 16:31:53
9abbad491ac78fd061fe4b0dd96065fbbe4625fc...68c01e15a5e46b385f5cbacc6f74a1dffabcdd55,1,10,0,10,1,2013-07-25 17:04:18,2013-07-25 17:03:15
68c01e15a5e46b385f5cbacc6f74a1dffabcdd55...efdf7442bbd81eb4bc460e98e3b5c1825eaef546,1,2,0,2,1,2013-07-25 18:16:02,2013-07-25 18:16:02
efdf7442bbd81eb4bc460e98e3b5c1825eaef546...7f892cedbad13b444151a1c163a328d968ee6b44,2,17,1,18,2,2013-07-26 10:17:50,2013-07-26 10:02:32
7f892cedbad13b444151a1c163a328d968ee6b44...5cc1ea4773f628f93dd2db9d353dc6b980e4a3ab,4,18,6,24,9,2013-07-26 12:02:10,2013-07-26 11:22:30
5cc1ea4773f628f93dd2db9d353dc6b980e4a3ab...dbbd2b1272e5a3ce7ab4b39b9a74f4ea725b104f,6,40,10,50,12,2013-07-26 18:47:58,2013-07-26 18:43:46
dbbd2b1272e5a3ce7ab4b39b9a74f4ea725b104f...081a27c3585a109b0e8b62e43f57273c69890bd3,3,21,12,33,8,2013-07-28 08:07:01,2013-07-28 08:05:39
081a27c3585a109b0e8b62e43f57273c69890bd3...192154fb17f257e74e45a28be4babc15c217ea06,1,1,1,2,1,2013-07-28 18:10:11,2013-07-28 18:09:29
192154fb17f257e74e45a28be4babc15c217ea06...c456a277255e1b63ba4dcf6ed894e37ac4f05b63,1,18,62,80,9,2013-07-29 10:05:47,2013-07-26 09:48:24
c456a277255e1b63ba4dcf6ed894e37ac4f05b63...5f8bf4368d79324f3fa076e1d7e810f53ddf4801,1,5,5,10,1,2013-07-29 10:52:42,2013-07-28 10:58:19
5f8bf4368d79324f3fa076e1d7e810f53ddf4801...518faa19c1f9212cbbbfaca6ef605fd02acd3abb,2,6,5,11,4,2013-07-29 11:06:29,2013-07-28 10:58:19
518faa19c1f9212cbbbfaca6ef605fd02acd3abb...e82846a9aa38bcc3db7e1820d11c7fa9a5f79449,1,1,1,2,1,2013-07-29 22:42:22,2013-07-29 22:41:08
e82846a9aa38bcc3db7e1820d11c7fa9a5f79449...17e632929cdf9575f538c1f98379adac8698c288,1,1,1,2,1,2013-07-30 00:32:02,2013-07-30 00:21:06
17e632929cdf9575f538c1f98379adac8698c288...88e4a3a3d932997aabebba772217f954df2fd65b,1,4,0,4,1,2013-07-30 14:18:44,2013-07-30 14:14:53
88e4a3a3d932997aabebba772217f954df2fd65b...bf132bcb8d741a161cd9ff61073ac40e7e873b59,1,26,14,40,4,2013-07-30 17:24:16,2013-07-26 21:32:56
bf132bcb8d741a161cd9ff61073ac40e7e873b59...badca4716fee99372ae545eaf6d5521db11348c1,2,15,3,18,6,2013-07-30 17:40:18,2013-04-20 03:20:01
badca4716fee99372ae545eaf6d5521db11348c1...bc617fd42c660c87f5fb6ba43c7b78449c4997d7,1,4,0,4,1,2013-07-31 11:09:37,2013-07-30 09:11:15
bc617fd42c660c87f5fb6ba43c7b78449c4997d7...d32471f8c276f19d69af6ba2531e42dac1e8d3e5,1,6,0,6,2,2013-07-31 13:26:11,2013-07-31 13:24:29
d32471f8c276f19d69af6ba2531e42dac1e8d3e5...b3e54f4a01dd410a87bc3d0669cb7b36aa74e7a8,2,2,4,6,2,2013-08-01 16:33:19,2013-08-01 14:27:30
b3e54f4a01dd410a87bc3d0669cb7b36aa74e7a8...196cc875b26f266e8f8dfd5be9daa0b8f246b9cd,3,37,11,48,9,2013-08-02 12:42:19,2013-08-01 18:09:47
196cc875b26f266e8f8dfd5be9daa0b8f246b9cd...6e4fd816c48b6ffd06fb7ae2c8ef2009bb0c6c25,2,36,0,36,3,2013-08-02 12:43:19,2013-02-24 13:57:29
6e4fd816c48b6ffd06fb7ae2c8ef2009bb0c6c25...e710f6dc56731b52f84864e7cb199dc4a8f881e7,1,31,17,48,14,2013-08-02 13:43:20,2013-08-01 21:27:11
e710f6dc56731b52f84864e7cb199dc4a8f881e7...f942554cf3f5da7efe3e66832fd58b9bdd05f2e5,1,1,1,2,1,2013-08-02 14:45:12,2013-07-06 12:26:28
f942554cf3f5da7efe3e66832fd58b9bdd05f2e5...b0bde218847692096b08d27aa37eba1745cacca8,1,1,1,2,1,2013-08-02 14:45:27,2013-07-31 21:03:22
b0bde218847692096b08d27aa37eba1745cacca8...4f8fb199948eab417961a8df66e5c41354d9fd0d,2,23,3,26,3,2013-08-02 14:45:58,2013-07-31 05:50:39
4f8fb199948eab417961a8df66e5c41354d9fd0d...4e7745cc1c89a0c464b752e6da7c1fe7bce948d0,2,16,2,18,3,2013-08-02 16:51:46,2013-08-01 07:51:01
4e7745cc1c89a0c464b752e6da7c1fe7bce948d0...97254154ab43d7973fba09ccd7ab548866f83e03,2,9,2,11,5,2013-08-02 18:46:51,2013-08-02 18:46:17
97254154ab43d7973fba09ccd7ab548866f83e03...ccef8b2aa26201ec1f3c4d3be6e69f52edf51144,1,1,1,2,1,2013-08-03 23:36:15,2013-08-03 19:42:02
ccef8b2aa26201ec1f3c4d3be6e69f52edf51144...2eac9899856d0e19c8e2df02256f2e8c4bdb5344,4,36,10,46,12,2013-08-04 09:04:58,2013-08-04 09:01:01
2eac9899856d0e19c8e2df02256f2e8c4bdb5344...01a96042740788aee1c371eb191113f2700d3ccc,1,0,6,6,1,2013-08-04 09:59:24,2013-08-04 09:57:11
01a96042740788aee1c371eb191113f2700d3ccc...9053c6da5fcfe98c05527591f9fd785223eb354a,1,33,29,62,3,2013-08-04 11:19:13,2013-08-04 10:18:17
9053c6da5fcfe98c05527591f9fd785223eb354a...90bdb42702327a4ef74e74d2e123da0731a90c4c,1,2,3,5,2,2013-08-04 11:30:30,2013-08-04 11:30:30
90bdb42702327a4ef74e74d2e123da0731a90c4c...77293f9354774e2631087935f1550c674093c433,1,92,9,101,15,2013-08-04 12:05:36,2013-08-02 18:24:26
77293f9354774e2631087935f1550c674093c433...74205c4a3c587a9eedceef1b98cd4b0d529a7510,1,66,35,101,12,2013-08-04 16:35:31,2013-08-02 13:26:19
74205c4a3c587a9eedceef1b98cd4b0d529a7510...7a5f7991939b41c63acf06b664d8fe3686eb8ecf,1,12,14,26,11,2013-08-04 18:46:41,2013-08-04 18:45:29
7a5f7991939b41c63acf06b664d8fe3686eb8ecf...59bf42f79e6f2fce2fc9128a86643cdb80b4b49a,1,4,0,4,1,2013-08-05 00:20:22,2013-08-05 00:18:10
59bf42f79e6f2fce2fc9128a86643cdb80b4b49a...7cc91eae7c4efc0108e51a28c472559c77778eaf,1,4,4,8,2,2013-08-05 00:33:00,2013-08-05 00:29:55
7cc91eae7c4efc0108e51a28c472559c77778eaf...06f484dcf9984f2a2223f20422e130844c246800,1,2,1,3,3,2013-08-05 12:16:56,2013-08-05 12:14:27
06f484dcf9984f2a2223f20422e130844c246800...ea7bef318fd42411e3db057e888367ef52fb23c3,2,14,9,23,2,2013-08-05 13:06:36,2013-08-04 19:40:16
ea7bef318fd42411e3db057e888367ef52fb23c3...891cdf120a0751b71eb534e14f814f574904ec44,2,13,0,13,2,2013-08-05 14:13:48,2013-08-05 14:01:49
891cdf120a0751b71eb534e14f814f574904ec44...363b81c59cc0252f605de7d30433934b4662cfb3,2,33,18,51,21,2013-08-06 07:34:42,2013-08-06 06:58:07
363b81c59cc0252f605de7d30433934b4662cfb3...80b95a2b1fc8c8425a81a23706af971061dc238f,2,14,1,15,4,2013-08-06 14:58:32,2013-02-26 09:51:56
80b95a2b1fc8c8425a81a23706af971061dc238f...4c90081b5b296bc2d7d9689609bfe1857e35b091,1,4,0,4,2,2013-08-06 15:56:31,2013-04-18 20:04:00
4c90081b5b296bc2d7d9689609bfe1857e35b091...e3e0cf8a0f75ae18bc401182bfbdea2c27bb0244,2,9,0,9,2,2013-08-06 17:44:31,2013-08-06 16:38:31
e3e0cf8a0f75ae18bc401182bfbdea2c27bb0244...6264e39c346a1b563dc0cbc31c5fb75830e032cb,1,3,0,3,1,2013-08-08 09:17:54,2013-08-07 18:57:56
6264e39c346a1b563dc0cbc31c5fb75830e032cb...25ce1e0e0a37d7be7ceff1e37bcb9ebd78a959d9,1,44,0,44,1,2013-08-08 09:36:52,2013-08-07 17:47:07
25ce1e0e0a37d7be7ceff1e37bcb9ebd78a959d9...9cc7407f2c6b457c1b8f1e7c2a57e7b065d9bc41,1,18,4,22,3,2013-08-08 13:47:24,2013-08-08 12:16:48
9cc7407f2c6b457c1b8f1e7c2a57e7b065d9bc41...7836bd502c4d5d65728c1e9eb58bc137b316c6e5,1,7,5,12,1,2013-08-08 14:27:34,2013-08-08 11:45:06
7836bd502c4d5d65728c1e9eb58bc137b316c6e5...7c5d43eea0d48f1c521c8f16b2d713b222407f90,1,2,0,2,1,2013-08-08 18:14:14,2013-08-08 18:13:39
7c5d43eea0d48f1c521c8f16b2d713b222407f90...2cd1439c06b2834942545a5679fa50691a736d50,1,5,1,6,3,2013-08-09 20:02:54,2013-08-09 20:02:05
2cd1439c06b2834942545a5679fa50691a736d50...43f12f368b141444b47aacea2635afbc28ed46d0,1,1,0,1,1,2013-08-10 22:08:27,2013-08-10 22:08:05
43f12f368b141444b47aacea2635afbc28ed46d0...4f470f5186d4c61a4b1c95bb9346d03b7c2f3aca,10,373,4,377,12,2013-08-12 18:07:58,2013-08-12 17:20:58
4f470f5186d4c61a4b1c95bb9346d03b7c2f3aca...79594b40c087c19fecc72af042c835b11a519b78,2,10,5,15,6,2013-08-13 16:05:41,2013-08-13 16:05:41
79594b40c087c19fecc72af042c835b11a519b78...bfbae15c669beab335400ab51a060e3d7d8e4c7a,2,15,9,24,6,2013-08-13 16:06:00,2013-08-13 16:06:00
bfbae15c669beab335400ab51a060e3d7d8e4c7a...57dc238d0e4783bf0532663af585a99572089c3b,1,1,1,2,1,2013-08-13 16:12:07,2013-08-13 16:12:07
57dc238d0e4783bf0532663af585a99572089c3b...529afa7138c6bd5efb4c6ac995597d2f25611d73,3,95,0,95,4,2013-08-13 16:17:07,2013-08-13 16:16:30
529afa7138c6bd5efb4c6ac995597d2f25611d73...39db994790d3e98b7558618c3dbfb2163e1a530c,1,2,2,4,2,2013-08-13 17:26:37,2013-08-13 10:38:29
39db994790d3e98b7558618c3dbfb2163e1a530c...b720ece06505bfaea1d1f4ee46963a34c032fe25,1,20,21,41,21,2013-08-13 20:24:14,2013-08-13 20:22:46
b720ece06505bfaea1d1f4ee46963a34c032fe25...8bd5251fd5ff32e19315f51edf3cff24bc5ccc5c,2,10,5,15,6,2013-08-14 16:58:19,2013-08-14 16:57:55
8bd5251fd5ff32e19315f51edf3cff24bc5ccc5c...52741004f682a82b5e27593fd5ab740bd22d09f6,2,9,11,20,3,2013-08-15 11:07:15,2013-08-14 23:27:16
52741004f682a82b5e27593fd5ab740bd22d09f6...d2419bb2b85003ba9a35feac8814c9b698ef557c,1,2,0,2,1,2013-08-15 11:41:53,2013-02-26 19:12:27
d2419bb2b85003ba9a35feac8814c9b698ef557c...ccff25b1431bd1bb9d633b1ca1d3aff79acc33d9,2,14,2,16,4,2013-08-15 14:22:56,2013-08-12 16:41:39
ccff25b1431bd1bb9d633b1ca1d3aff79acc33d9...7825fb878873bfab6762ce001b0446f3ebfb25ea,1,0,9,9,1,2013-08-15 19:31:57,2013-08-15 19:24:58
7825fb878873bfab6762ce001b0446f3ebfb25ea...919934602fd2767024126e094d33f0ad64947270,23,110,41,151,39,2013-08-16 00:33:02,2013-08-11 20:19:09
919934602fd2767024126e094d33f0ad64947270...c769c266017c9a527444f8f026c7a76b394d0412,3,1,48,49,5,2013-08-16 11:59:16,2013-08-16 11:57:55
c769c266017c9a527444f8f026c7a76b394d0412...1b48de06c3ca5cba57a734a09c815a2be5c4bcfe,2,137,119,256,117,2013-08-16 13:13:31,2013-08-16 13:13:31
1b48de06c3ca5cba57a734a09c815a2be5c4bcfe...a6ac4f90d0d09da884289d6f03df4e4800c8f742,2,12,2,14,3,2013-08-16 19:21:41,2013-07-31 20:35:44
a6ac4f90d0d09da884289d6f03df4e4800c8f742...e7a6eaf5fee9c5854e0d2d86f21132ac4a1415f6,1,2,2,4,2,2013-08-19 22:51:22,2013-08-19 22:42:48
e7a6eaf5fee9c5854e0d2d86f21132ac4a1415f6...f0bc2865ff9d85c952fa86ae19aee062a5e883cd,3,30,5,35,11,2013-08-20 06:12:50,2013-08-20 03:14:21
f0bc2865ff9d85c952fa86ae19aee062a5e883cd...3ae585b44977d0753a5e5f142b790716d6939258,1,1,1,2,1,2013-08-20 08:08:41,2013-08-20 08:01:42
3ae585b44977d0753a5e5f142b790716d6939258...2b1101a4a6acbf9350b62638a04edcf20ad83e97,4,36,1,37,4,2013-08-20 14:15:52,2013-08-20 13:23:25
2b1101a4a6acbf9350b62638a04edcf20ad83e97...b189169ed031c4e1d8792b19d238db16245ed0ad,1,6,0,6,1,2013-08-20 14:49:00,2013-08-20 14:48:02
b189169ed031c4e1d8792b19d238db16245ed0ad...12d364a9b0b4bf820a68104a64ba312c7290518b,4,19,10,29,4,2013-08-20 19:28:14,2013-08-20 17:03:33
12d364a9b0b4bf820a68104a64ba312c7290518b...e7d4d41a30b4cf60690fe55e47b4e10403fc8b46,1,2,2,4,1,2013-08-21 04:20:55,2013-08-21 03:22:25
e7d4d41a30b4cf60690fe55e47b4e10403fc8b46...b0821e6d3a5dcb8b040ce2323f49b46dabbc9e37,1,1,1,2,1,2013-08-21 13:02:19,2013-08-21 13:01:52
b0821e6d3a5dcb8b040ce2323f49b46dabbc9e37...28b1317fd815325b5a58a7acae12ca45de5a6ac9,1,1,1,2,1,2013-08-21 14:50:27,2013-08-21 14:49:50
28b1317fd815325b5a58a7acae12ca45de5a6ac9...69a4594cb7b4eab7c689866557c491c85cdf3aa2,1,3,8,11,1,2013-08-21 21:46:18,2013-08-21 19:38:07
69a4594cb7b4eab7c689866557c491c85cdf3aa2...161e26c2ec9f88bf0395941aaa2fd193b110affd,3,49,4,53,4,2013-08-22 07:59:59,2013-08-22 07:42:10
161e26c2ec9f88bf0395941aaa2fd193b110affd...ff92a6eb5b87c65ca47568e0ca37df949e17feb2,2,4,2,6,4,2013-08-22 07:54:35,2013-08-22 07:14:06
ff92a6eb5b87c65ca47568e0ca37df949e17feb2...26a4c835987d93f845cc2915d08780854a90c587,2,21,7,28,5,2013-08-22 11:29:59,2013-08-22 11:25:21
26a4c835987d93f845cc2915d08780854a90c587...8d02c378ab78694991483bc3f0b01e2e89f73264,1,0,4,4,1,2013-08-22 13:21:28,2013-08-20 09:26:48
8d02c378ab78694991483bc3f0b01e2e89f73264...bf9382fb02c54a5991fb2eb91322befe21177a49,1,4,3,7,2,2013-08-22 13:39:14,2013-08-22 08:39:31
bf9382fb02c54a5991fb2eb91322befe21177a49...5f061986b9903b335e4bfe41cf172d710604d5cb,13,225,77,302,34,2013-08-22 21:55:01,2013-08-22 00:12:19
5f061986b9903b335e4bfe41cf172d710604d5cb...2a166623a63b27a2b6c5c9d0f46bd726ee4e82fb,2,7,7,14,7,2013-08-23 01:33:59,2013-08-22 15:14:56
2a166623a63b27a2b6c5c9d0f46bd726ee4e82fb...2c08d474a83b438cf02595c6854f2f79e708b852,2,8,1,9,2,2013-08-24 16:10:50,2013-08-24 16:08:05
2c08d474a83b438cf02595c6854f2f79e708b852...28026c3e26388efe27c92b6e94d7363022f1efb3,1,1,1,2,1,2013-08-27 12:24:31,2013-08-26 02:07:00
28026c3e26388efe27c92b6e94d7363022f1efb3...c4e2e4f630fd86cb9993daf874c1a8964e4b92f8,1,1,1,2,1,2013-08-27 13:22:31,2013-08-26 09:18:21
c4e2e4f630fd86cb9993daf874c1a8964e4b92f8...544a190ebf53d4a6661474d3020eab2334c7f181,1,3,2,5,1,2013-08-27 14:27:44,2013-08-27 00:00:11
544a190ebf53d4a6661474d3020eab2334c7f181...68eca2b36ff8e4091fbfd210ca0782c7b8313a05,1,1,1,2,1,2013-08-28 11:12:38,2013-08-28 10:35:46
68eca2b36ff8e4091fbfd210ca0782c7b8313a05...58157be5ad31b42a1dc73e357cfdece02fd0b6ee,1,1,1,2,1,2013-08-29 06:43:35,2013-08-29 06:35:17
58157be5ad31b42a1dc73e357cfdece02fd0b6ee...ef1259342b46cd4b63678a4acddf2a2b631d342c,4,25,5,30,8,2013-08-29 13:45:02,2013-08-29 13:39:31
ef1259342b46cd4b63678a4acddf2a2b631d342c...10d15f79e5e2ca7b733e2bf1860e1778c3a712dc,2,19,0,19,2,2013-08-29 16:14:40,2013-08-29 15:09:58
10d15f79e5e2ca7b733e2bf1860e1778c3a712dc...60df34d4771b6a97f3695f2095698082073e3379,1,13,13,26,8,2013-08-29 16:49:27,2013-08-29 16:48:22
60df34d4771b6a97f3695f2095698082073e3379...cd10e998b6a8f9daaf2e25cad55f33f3df51ea88,1,0,2,2,1,2013-08-30 06:46:16,2013-08-30 06:44:56
cd10e998b6a8f9daaf2e25cad55f33f3df51ea88...76e38a21777243fec58c640d617bb71a251c5ba1,7,130,16,146,15,2013-08-30 06:47:34,2013-08-30 06:41:07
76e38a21777243fec58c640d617bb71a251c5ba1...1d874ce0f94432c1a4b42cacaeb02c5948000d0f,1,1,1,2,1,2013-08-30 10:04:17,2013-08-30 10:02:23
1d874ce0f94432c1a4b42cacaeb02c5948000d0f...21a3efcf48559b3336ca1743d94c741a82feffd6,3,22,16,38,7,2013-08-30 23:45:14,2013-08-30 03:44:37
21a3efcf48559b3336ca1743d94c741a82feffd6...0089a9a8549828d38f6c49aaefb8364c034fa434,1,1,1,2,1,2013-08-31 01:07:04,2013-08-31 01:05:36
0089a9a8549828d38f6c49aaefb8364c034fa434...68ae9f39b72253aa17341d749842b9c8923fc6b9,1,2,2,4,2,2013-08-31 08:33:46,2013-08-31 08:32:58
68ae9f39b72253aa17341d749842b9c8923fc6b9...64383e8349daee3f14e3ad863f8a75b1c95a4e4a,1,19,17,36,2,2013-08-31 12:00:33,2013-08-31 11:55:45
64383e8349daee3f14e3ad863f8a75b1c95a4e4a...4e3794dd1fbc689dcbcc455f3458539d630a1ff3,4,53,23,76,15,2013-09-02 11:34:26,2013-08-30 08:48:36
4e3794dd1fbc689dcbcc455f3458539d630a1ff3...0c5786890875f2adbcfddd0056dc2b87a768aa1e,1,12,11,23,4,2013-09-02 12:31:20,2013-09-02 12:15:04
0c5786890875f2adbcfddd0056dc2b87a768aa1e...aa1c1756870b2908486d9e685ec02cbada501e45,2,10,1,11,2,2013-09-03 07:08:25,2013-09-03 07:05:01
aa1c1756870b2908486d9e685ec02cbada501e45...b53ce2f31cd8241445a2cad81cd2ecdbdb54609c,3,11,4,15,3,2013-09-03 08:04:50,2013-09-03 08:01:13
b53ce2f31cd8241445a2cad81cd2ecdbdb54609c...c0fb6bdde3ffcfc4108d865cdc3f34a7175e5907,2,22,5,27,4,2013-09-03 11:49:59,2013-09-03 11:48:03
c0fb6bdde3ffcfc4108d865cdc3f34a7175e5907...bd0319a2614b2f5fd03db61cfbc957be9022ff54,1,9,4,13,2,2013-09-03 11:54:50,2013-09-03 11:49:42
bd0319a2614b2f5fd03db61cfbc957be9022ff54...0514fbb2f37b530e46f54e205cb8c9d722e142d6,3,20,12,32,5,2013-09-03 11:55:20,2013-09-03 11:51:55
0514fbb2f37b530e46f54e205cb8c9d722e142d6...50012577f31da9e92613501508094651ed0b4943,1,189,16,205,19,2013-09-03 12:34:44,2013-09-02 09:39:37
50012577f31da9e92613501508094651ed0b4943...115318051c092f6ca8240262bd8b17b9e56ab838,27,48,50,98,47,2013-09-03 12:34:45,2013-09-02 10:06:32
115318051c092f6ca8240262bd8b17b9e56ab838...2a14c08e71330827f44acc53708194bf6aadee47,3,3,15,18,5,2013-09-03 12:34:45,2013-09-02 10:10:03
2a14c08e71330827f44acc53708194bf6aadee47...a62b640f7d3a0b90c4009cc7efe0a19fd3ad0bfa,3,61,13,74,8,2013-09-03 13:01:43,2013-09-01 04:04:32
a62b640f7d3a0b90c4009cc7efe0a19fd3ad0bfa...4420de89b6dc2cdded9bbfae6bbc6a863d751c03,1,2,3,5,1,2013-09-03 15:51:17,2013-09-03 15:51:17
4420de89b6dc2cdded9bbfae6bbc6a863d751c03...fe0eb2f995434adbfeae9617b8231e0b3bbd3fa4,1,89,76,165,35,2013-09-04 17:04:51,2013-08-21 17:53:38
fe0eb2f995434adbfeae9617b8231e0b3bbd3fa4...cda4fc822575168e85fcf5fbf8b4d524e1d6e0d3,1,3,0,3,1,2013-09-04 17:19:32,2013-09-04 17:18:08
cda4fc822575168e85fcf5fbf8b4d524e1d6e0d3...7c1efc2fa607440d69e98ce1fd2749899e9b3ab1,1,16,16,32,9,2013-09-04 20:23:24,2013-09-04 20:21:24
7c1efc2fa607440d69e98ce1fd2749899e9b3ab1...a8624b22a786f332d535d77ce51b97bde5b3e05e,1,7,7,14,7,2013-09-04 21:18:47,2013-09-04 21:17:43
a8624b22a786f332d535d77ce51b97bde5b3e05e...77cf0d6519c431d5411576ab5588c44971598b96,1,0,6,6,1,2013-09-05 10:32:26,2013-09-05 09:49:10
77cf0d6519c431d5411576ab5588c44971598b96...622d5c7650642a2f8daeaae6fac68d142330e993,1,11,0,11,1,2013-09-05 10:32:50,2013-09-05 09:56:03
622d5c7650642a2f8daeaae6fac68d142330e993...1dd061ad7705d2851bee5e78b9fed381130ec5f4,2,12,2,14,2,2013-09-05 12:45:58,2013-09-05 12:43:10
1dd061ad7705d2851bee5e78b9fed381130ec5f4...9f69ae78478c1164d24c9e4a656d3cea54d102b1,1,9,0,9,2,2013-09-05 21:54:56,2013-09-05 21:16:50
9f69ae78478c1164d24c9e4a656d3cea54d102b1...180b9955cc8816dba1534257f63c6ce389b10759,13,19,15,34,16,2013-09-06 00:16:14,2013-09-05 22:23:48
180b9955cc8816dba1534257f63c6ce389b10759...544382dd8505bc392ba7032cd563d4117a58e315,1,2,2,4,2,2013-09-06 18:31:43,2013-09-06 18:31:27
544382dd8505bc392ba7032cd563d4117a58e315...da44a8bdc2524424bfd3e904e394457028265619,1,9,7,16,1,2013-09-06 20:06:46,2013-09-06 20:01:29
da44a8bdc2524424bfd3e904e394457028265619...2c73ba88f25230e9e62293d25de7526d018041e8,1,3,1,4,1,2013-09-06 21:30:59,2013-09-06 20:41:22
2c73ba88f25230e9e62293d25de7526d018041e8...92e89452f1aa3987cb70648e69718c6adea4b079,1,1,1,2,1,2013-09-06 21:32:08,2013-09-06 19:37:43
92e89452f1aa3987cb70648e69718c6adea4b079...2ab2d0fb255377a1630e05696b61a7d2e9c436bd,1,3,5,8,1,2013-09-06 21:41:43,2013-09-06 21:41:12
2ab2d0fb255377a1630e05696b61a7d2e9c436bd...b917458f4752e98dc7866261f40e296de3701130,5,19,0,19,7,2013-09-06 22:11:07,2013-09-06 22:06:57
b917458f4752e98dc7866261f40e296de3701130...99952bab3008622b05613ed6ec54c3e1c63c0a1d,3,48,22,70,3,2013-09-06 22:39:16,2013-09-06 22:31:25
99952bab3008622b05613ed6ec54c3e1c63c0a1d...3df9647ad96eb0f1919be921bb96e949f1a518a0,6,162,66,228,23,2013-09-07 00:01:24,2013-09-06 23:05:02
3df9647ad96eb0f1919be921bb96e949f1a518a0...6ba01f64c1e5baf1e876cabd3d625ad53f39a5e4,1,1,1,2,1,2013-09-07 00:08:56,2013-09-07 00:07:57
6ba01f64c1e5baf1e876cabd3d625ad53f39a5e4...2a2ac5c1400c67f25388621a39749c918a4efe98,3,25,0,25,4,2013-09-07 00:44:25,2013-09-07 00:38:37
2a2ac5c1400c67f25388621a39749c918a4efe98...f855058c35db9d35ba7f310d8f9db6f4533b7424,3,15,1,16,6,2013-09-07 02:59:28,2013-09-06 22:13:51
f855058c35db9d35ba7f310d8f9db6f4533b7424...fac5735a3daffb82b67ff489f0c963eaf953f6e7,2,23,3,26,6,2013-09-07 15:45:24,2013-09-07 15:41:02
fac5735a3daffb82b67ff489f0c963eaf953f6e7...a357c854c91b513e3713f2eb72e9742d49c2e701,1,4,1,5,1,2013-09-07 16:16:43,2013-09-07 15:36:31
a357c854c91b513e3713f2eb72e9742d49c2e701...9244447cc4a91c22f8f2668f9667e92a1b2de958,1,8,1,9,3,2013-09-07 17:06:19,2013-09-07 16:30:03
9244447cc4a91c22f8f2668f9667e92a1b2de958...7fcd6aa6695b39370154d6993cdbb3ba4363de91,2,17,1,18,3,2013-09-07 17:06:38,2013-09-07 16:41:34
7fcd6aa6695b39370154d6993cdbb3ba4363de91...17b67e17a33e09c81be3dd2cfb5294ea9f5ae298,1,3,0,3,1,2013-09-07 17:08:45,2013-09-07 16:58:49
17b67e17a33e09c81be3dd2cfb5294ea9f5ae298...7b8037f3aa880397d16c7a11647d53f92b7cec67,1,8,0,8,1,2013-09-07 18:01:05,2013-09-07 17:59:57
7b8037f3aa880397d16c7a11647d53f92b7cec67...63b95ca452ea7ef1103e599f8dd733b67278c8dc,1,15,3,18,6,2013-09-07 18:15:13,2013-09-07 18:13:21
63b95ca452ea7ef1103e599f8dd733b67278c8dc...be9930d7bedc78486d5294a2914585e01c492385,1,2,2,4,1,2013-09-07 18:15:13,2013-09-07 00:36:17
be9930d7bedc78486d5294a2914585e01c492385...01edcf70f2911b1953b7789bda18d2498fc73bd0,1,3,1,4,1,2013-09-07 19:09:52,2013-09-07 19:08:54
01edcf70f2911b1953b7789bda18d2498fc73bd0...c03848b540d2787adda27f73a69a7980b38c7ac6,1,13,4,17,3,2013-09-07 20:11:03,2013-09-07 20:10:07
c03848b540d2787adda27f73a69a7980b38c7ac6...7c31e195db963ad1ebb28265e721097000fa84d1,2,30,2,32,7,2013-09-08 07:17:03,2013-09-07 23:56:49
7c31e195db963ad1ebb28265e721097000fa84d1...0035a0ce2ec243ff9255157117c20caf41a61284,1,5,1,6,2,2013-09-08 17:41:34,2013-09-08 17:38:12
0035a0ce2ec243ff9255157117c20caf41a61284...b085e7c3033d49e4d7525bacb1f34340730918a8,1,2,2,4,2,2013-09-08 18:43:33,2013-09-08 18:43:04
b085e7c3033d49e4d7525bacb1f34340730918a8...e4274e3da1160997bc78c09ca8f634e04d7438d2,1,1,0,1,1,2013-09-09 11:02:21,2013-07-06 02:38:33
e4274e3da1160997bc78c09ca8f634e04d7438d2...276e053803c847ce645b1859a162a997a4ee3789,3,23,0,23,3,2013-09-09 13:49:15,2013-09-08 19:57:36
276e053803c847ce645b1859a162a997a4ee3789...01ad5085148bf7dcfc3af4d05cc8c262680f85d9,2,2,2,4,2,2013-09-09 15:31:25,2013-09-09 15:30:31
01ad5085148bf7dcfc3af4d05cc8c262680f85d9...960f5bc75901f76e9b4b356f98b22b494fb47611,1,9,0,9,1,2013-09-10 13:18:14,2013-09-10 12:39:51
960f5bc75901f76e9b4b356f98b22b494fb47611...f9f792eb04dfd48d93682070583f473166b490ae,30,49,145,194,69,2013-09-10 19:29:31,2013-09-05 19:38:59
f9f792eb04dfd48d93682070583f473166b490ae...ef3604a085ae7b6ce20a84cf27c474b9e316f607,1,1,1,2,1,2013-09-10 20:31:51,2013-09-10 20:10:00
ef3604a085ae7b6ce20a84cf27c474b9e316f607...536cc64240f7f331b805104bfd8cd82c98e44f12,2,33,0,33,3,2013-09-11 01:03:51,2013-08-27 22:50:11
536cc64240f7f331b805104bfd8cd82c98e44f12...2f2731e67e5cde279cfa938f142d34f65e2e74f1,3,77,0,77,4,2013-09-11 01:08:27,2013-08-23 10:49:37
2f2731e67e5cde279cfa938f142d34f65e2e74f1...ed9b7b6295f311dbbd7f66f0cbcb393ab122afec,1,1,1,2,1,2013-09-11 01:32:14,2013-09-11 01:32:14
ed9b7b6295f311dbbd7f66f0cbcb393ab122afec...4f0ea1aca4fce75de22878839f077fa1c1d9e21a,1,13,16,29,6,2013-09-11 11:43:24,2013-09-10 22:00:36
4f0ea1aca4fce75de22878839f077fa1c1d9e21a...b05639dcacdd8b2c1dd6db447ce7f20caefc5f54,2,18,1,19,2,2013-09-11 12:18:48,2013-09-11 12:17:15
b05639dcacdd8b2c1dd6db447ce7f20caefc5f54...e8bb41d05ccd4ccb2cb983ad6c895ff40de622df,1,1,1,2,1,2013-09-11 23:44:35,2013-09-11 21:45:00
e8bb41d05ccd4ccb2cb983ad6c895ff40de622df...66e6e2d14663f78aacdd9df4e9e8c1c008b62459,1,6,4,10,4,2013-09-12 22:45:27,2013-09-12 22:34:22
66e6e2d14663f78aacdd9df4e9e8c1c008b62459...a929adfd3b89056d83c34f729bedde78afec44db,2,21,3,24,4,2013-09-13 08:20:13,2013-09-12 13:27:35
a929adfd3b89056d83c34f729bedde78afec44db...c91ffd5f23c71dad8f2ed6b4dfecb4592572f244,2,24,4,28,4,2013-09-13 12:27:23,2013-09-12 23:01:47
c91ffd5f23c71dad8f2ed6b4dfecb4592572f244...6e17534c8903cabdd3fb2314c9a9c7b02128669e,1,6,16,22,6,2013-09-13 13:30:12,2013-09-13 13:28:38
6e17534c8903cabdd3fb2314c9a9c7b02128669e...7a2adec4d047492ed77aa0e027d889d442b0f59c,1,6,6,12,1,2013-09-13 13:35:22,2013-09-13 13:34:12
7a2adec4d047492ed77aa0e027d889d442b0f59c...097fb98f81b9d9dd3faac45f5b93d620098041bc,1,7,2,9,3,2013-09-13 16:42:40,2013-09-13 15:45:42
097fb98f81b9d9dd3faac45f5b93d620098041bc...4c4954a3c133e824390296f6bb444622a8b25331,1,12,0,12,1,2013-09-14 07:36:48,2013-09-14 07:33:12
4c4954a3c133e824390296f6bb444622a8b25331...5ecc0f828ebe270cfc92a0a2bfb4268800907904,4,153,17,170,37,2013-09-15 05:46:16,2013-09-15 05:46:16
5ecc0f828ebe270cfc92a0a2bfb4268800907904...623c4916df545f985c66a269a712e95f2724f6d0,4,56,9,65,5,2013-09-15 06:36:03,2013-09-15 06:36:03
623c4916df545f985c66a269a712e95f2724f6d0...e96bcdd64f92268820960f30637f88f206b011a9,8,64,22,86,20,2013-09-15 18:22:24,2013-09-15 18:14:26
e96bcdd64f92268820960f30637f88f206b011a9...c0625a74ce1bdc4e0fe6827a7106f653518b2c4c,1,10,8,18,1,2013-09-16 20:52:13,2013-09-16 20:49:46
c0625a74ce1bdc4e0fe6827a7106f653518b2c4c...5937f291c1dd74b40ab14be7b8a8112ff91ac08e,3,18,12,30,12,2013-09-17 09:31:13,2013-09-15 07:12:16
5937f291c1dd74b40ab14be7b8a8112ff91ac08e...325b03ea844dda21557a2779d6f7e35950174962,2,10,3,13,6,2013-09-17 16:36:32,2013-09-17 14:28:20
325b03ea844dda21557a2779d6f7e35950174962...275497c5709792b47c71538a7e58bb40e8d8d3a9,2,2,6,8,2,2013-09-18 10:49:59,2013-09-16 20:20:29
275497c5709792b47c71538a7e58bb40e8d8d3a9...14e139ecdfeec555265eec11d7bca7596311e348,1,14,2,16,3,2013-09-18 13:43:10,2013-09-18 13:35:51
14e139ecdfeec555265eec11d7bca7596311e348...dbad65ded76d571937ce276e15cad2e19e9989fb,1,0,9,9,1,2013-09-18 13:52:29,2013-09-18 13:51:53
dbad65ded76d571937ce276e15cad2e19e9989fb...778d4da9cc249839b059e45d90e3a947bb76dd6d,4,57,9,66,9,2013-09-18 13:56:01,2013-09-17 11:46:38
778d4da9cc249839b059e45d90e3a947bb76dd6d...091ae7f172de6bca8bced833434a8ee61848abfe,1,0,0,0,0,2013-09-19 00:27:07,2013-09-19 00:27:07
091ae7f172de6bca8bced833434a8ee61848abfe...886e876c7230bf2b3364d89f4240d00d8a3ab394,4,468,0,468,6,2013-09-19 07:02:52,2013-09-19 07:02:52
886e876c7230bf2b3364d89f4240d00d8a3ab394...538fdd2ae4c44000e3f40aa723a42a078767ce64,2,3,1,4,3,2013-09-19 10:37:53,2013-09-19 10:37:23
538fdd2ae4c44000e3f40aa723a42a078767ce64...9888bb28eef8062574d5c337b1dc18f745b793f6,1,1,1,2,1,2013-09-19 17:29:48,2013-09-19 16:55:09
9888bb28eef8062574d5c337b1dc18f745b793f6...85ba68cc14952e002b1799adebe9d7fc81b51a89,5,27,12,39,10,2013-09-19 19:34:59,2013-09-19 16:39:43
85ba68cc14952e002b1799adebe9d7fc81b51a89...0ad178c43d7ac377480cc5fd5e3204f912603a49,1,14,0,14,1,2013-09-20 19:57:39,2013-09-20 19:56:35
0ad178c43d7ac377480cc5fd5e3204f912603a49...e94efee946bb440a4ea9fbe89dcb58972a87e8b3,2,9,0,9,2,2013-09-21 10:56:00,2013-09-21 03:54:48
e94efee946bb440a4ea9fbe89dcb58972a87e8b3...ece8d6521771635fb5e15d1093524b4f848608fa,2,3,3,6,3,2013-09-21 20:58:18,2013-09-21 20:54:00
ece8d6521771635fb5e15d1093524b4f848608fa...e76dd4cd1a12f610698b8aa8854b0e0e1dfb21a2,2,22,1,23,5,2013-09-21 21:11:04,2013-09-21 20:50:33
e76dd4cd1a12f610698b8aa8854b0e0e1dfb21a2...bb8a08794941ebc4fa5b575bf5dadad92d637dbe,1,26,0,26,1,2013-09-21 22:18:16,2013-09-21 15:22:45
bb8a08794941ebc4fa5b575bf5dadad92d637dbe...14f76b15c4b2ab34e7afcf092e5146d401aad240,1,1,1,2,1,2013-09-21 22:18:42,2013-09-21 20:34:45
14f76b15c4b2ab34e7afcf092e5146d401aad240...aef809f90cf9fda0bc2d7337a2e1c61d69b8e621,1,3,1,4,1,2013-09-22 16:54:02,2013-09-22 14:11:02
aef809f90cf9fda0bc2d7337a2e1c61d69b8e621...b2876c0c914be0f12b57c7e6e4f6fae671108096,3,41,14,55,13,2013-09-22 16:54:54,2013-09-22 14:21:09
b2876c0c914be0f12b57c7e6e4f6fae671108096...56201fe5a85ead96f00d8ad2eda5cfd2bc4cb4b0,4,15,22,37,14,2013-09-22 20:04:50,2013-09-22 13:55:09
56201fe5a85ead96f00d8ad2eda5cfd2bc4cb4b0...eb32de26145f605940f3b6fd8f708d1b4fce3a4a,1,6,4,10,3,2013-09-22 21:05:16,2013-09-22 20:58:46
eb32de26145f605940f3b6fd8f708d1b4fce3a4a...6e6d1b1ba8cfc78a3f3c14a67f5d59462364dc06,1,2,0,2,1,2013-09-23 11:40:01,2013-09-23 10:17:22
6e6d1b1ba8cfc78a3f3c14a67f5d59462364dc06...cdb56725d4424cc58147e2ffd4426511aa95775e,1,13,3,16,2,2013-09-23 14:39:10,2013-09-23 13:46:19
cdb56725d4424cc58147e2ffd4426511aa95775e...5e549e7efe7fc5b29124846278a6b30332e40dc4,1,13,11,24,5,2013-09-23 15:07:36,2013-09-23 14:17:15
5e549e7efe7fc5b29124846278a6b30332e40dc4...a6a5c8b06df9334e546795b96566d25c6396209a,1,19,3,22,2,2013-09-23 16:18:47,2013-09-23 13:50:50
a6a5c8b06df9334e546795b96566d25c6396209a...34f4053409da0338b4592d376e026b8ab1016c6b,1,1,1,2,1,2013-09-23 22:30:18,2013-09-23 22:30:05
34f4053409da0338b4592d376e026b8ab1016c6b...db98c4888419df10de057978b85f297809e7982f,1,1,1,2,1,2013-09-23 23:25:07,2013-09-23 22:36:33
db98c4888419df10de057978b85f297809e7982f...11dfb581312ae2916802989c6e9b8c6ea1b0dc8f,1,1,1,2,1,2013-09-24 11:37:12,2013-09-23 20:35:04
11dfb581312ae2916802989c6e9b8c6ea1b0dc8f...d30d66b90728b8dc173c050c63c86e5af3ab7c40,1,2,2,4,1,2013-09-24 13:41:39,2013-09-24 13:41:12
d30d66b90728b8dc173c050c63c86e5af3ab7c40...1a922870ea07e730281c0e2a7b3a170232a81236,3,31,3,34,4,2013-09-24 16:04:42,2013-09-24 15:42:40
1a922870ea07e730281c0e2a7b3a170232a81236...50a811a170dfeddd9c27d21aee36801277d21bf3,3,17,145,162,36,2013-09-24 19:09:52,2013-09-24 19:09:52
50a811a170dfeddd9c27d21aee36801277d21bf3...e5dc08f2dbdd8bf67960f0448810d71ba58990b4,1,7,3,10,2,2013-09-24 19:10:21,2013-09-17 20:59:56
e5dc08f2dbdd8bf67960f0448810d71ba58990b4...5207928151938114cea3ca2d56990e10bf3e8544,1,2,2,4,1,2013-09-25 16:31:03,2013-09-25 16:20:33
5207928151938114cea3ca2d56990e10bf3e8544...d7ae0bc372f8423e7bcf9b5408df46fd5c8dc27d,3,21,4,25,5,2013-09-25 17:50:48,2013-09-23 15:18:20
d7ae0bc372f8423e7bcf9b5408df46fd5c8dc27d...d1047c8b4cecd2e64a1ec0882328af9d081220a3,10,26,27,53,20,2013-09-26 00:11:17,2013-09-18 14:35:41
d1047c8b4cecd2e64a1ec0882328af9d081220a3...a979a2fea5415849773fdfb37765ffedef6f50f2,1,18,3,21,5,2013-09-26 10:42:32,2013-09-23 15:04:48
a979a2fea5415849773fdfb37765ffedef6f50f2...f621aba99b978257fdb976c022d4a6c1c2f6ac03,1,1,1,2,1,2013-09-27 07:21:54,2013-09-27 06:56:43
f621aba99b978257fdb976c022d4a6c1c2f6ac03...15bdc85117785d583b9ae71d256929a431478f4c,2,15,2,17,3,2013-09-27 16:06:28,2013-09-27 15:00:42
15bdc85117785d583b9ae71d256929a431478f4c...c2a35d40db3eca728ac809a3ddb5e8fcec463bca,2,16,6,22,8,2013-09-27 22:46:37,2013-09-27 22:40:43
c2a35d40db3eca728ac809a3ddb5e8fcec463bca...5303afcd97e6c997b93704ae5be6f25abbe76106,1,3,0,3,1,2013-09-28 23:35:47,2013-09-28 23:28:32
5303afcd97e6c997b93704ae5be6f25abbe76106...5d72ce061f79f09310b1fcb523c23e6d259c02de,1,37,8,45,7,2013-09-29 14:37:45,2013-09-25 21:14:33
5d72ce061f79f09310b1fcb523c23e6d259c02de...c4468e0619ef45cae7914b2ebf8357951342dd72,1,4,3,7,1,2013-09-30 01:57:04,2013-09-29 17:26:03
c4468e0619ef45cae7914b2ebf8357951342dd72...0d74bdaf0c39feb8ec303dbbdbcadba70e46eecb,14,150,87,237,48,2013-09-30 08:14:22,2013-09-30 08:14:22
0d74bdaf0c39feb8ec303dbbdbcadba70e46eecb...98773c4bb53ff464c3782694f244e80158f975ee,1,7,5,12,2,2013-09-30 14:21:34,2013-09-30 10:44:41
98773c4bb53ff464c3782694f244e80158f975ee...47a65ad40e6b6ee282a46473977b774837950961,1,4,1,5,1,2013-10-01 01:17:29,2013-09-30 22:22:26
47a65ad40e6b6ee282a46473977b774837950961...5b97b99a014443b255cf8ab0467864c5874027da,3,17,29,46,13,2013-10-01 11:28:24,2013-10-01 07:27:31
5b97b99a014443b255cf8ab0467864c5874027da...9972a101e60d1c4bf1e0b6f3c7946c8716022711,3,21,5,26,4,2013-10-01 17:47:28,2013-10-01 08:07:41
9972a101e60d1c4bf1e0b6f3c7946c8716022711...d16753eecd3c97c781382fbb4c119f6bae314487,2,27,5,32,7,2013-10-01 23:42:13,2013-10-01 23:23:36
d16753eecd3c97c781382fbb4c119f6bae314487...65950805eb638d6539d7fde7f89dd2215d158ff9,1,1,1,2,1,2013-10-02 00:04:28,2013-10-02 00:02:42
65950805eb638d6539d7fde7f89dd2215d158ff9...3ec368014d0d74e14a7ed98ccfd638ffe0e62863,1,11,1,12,3,2013-10-02 10:33:52,2013-10-02 09:57:56
3ec368014d0d74e14a7ed98ccfd638ffe0e62863...4290cc1d6e3cbbb77d4098e15bd4db6c65ee904a,1,3,3,6,3,2013-10-02 10:35:00,2013-10-02 02:59:19
4290cc1d6e3cbbb77d4098e15bd4db6c65ee904a...e5b0f5b95d49c33f5431cf4060705b5e59ec69d4,2,16,0,16,2,2013-10-02 13:13:59,2013-09-25 21:00:51
e5b0f5b95d49c33f5431cf4060705b5e59ec69d4...dc26f3fc9bb1385c483637c04f0dca04b42fcfcb,1,1,1,2,2,2013-10-02 14:01:48,2013-10-02 13:46:47
dc26f3fc9bb1385c483637c04f0dca04b42fcfcb...9b89fcc0b0c85dad5034b048e436f06a981f28e8,1,6,2,8,1,2013-10-02 14:15:36,2013-10-02 14:15:18
9b89fcc0b0c85dad5034b048e436f06a981f28e8...06b149e220f98cd643a4445db1b5719daac0d56f,2,13,10,23,3,2013-10-02 16:13:44,2013-10-02 16:12:53
06b149e220f98cd643a4445db1b5719daac0d56f...02c7dbd2559de4fa09cf6c644a2434e440230c0d,2,19,7,26,7,2013-10-02 23:13:20,2013-09-19 21:02:49
02c7dbd2559de4fa09cf6c644a2434e440230c0d...e2e7571035173ed153b38e91a3945a074ceada57,1,1,1,2,1,2013-10-04 00:14:00,2013-10-04 00:13:22
e2e7571035173ed153b38e91a3945a074ceada57...5252885494079cf28a337644a87e61b19340f09c,1,13,1,14,3,2013-10-04 01:50:51,2013-10-02 22:34:38
5252885494079cf28a337644a87e61b19340f09c...b42f0665a8cc25869c8dbc7bb71927b7ea61f81c,1,7,3,10,3,2013-10-07 08:49:28,2013-10-07 08:47:50
b42f0665a8cc25869c8dbc7bb71927b7ea61f81c...563b5c20007b993c8ab8d88f9083ab5df4b3606a,1,3,0,3,1,2013-10-07 10:42:28,2013-10-07 10:40:41
563b5c20007b993c8ab8d88f9083ab5df4b3606a...7f0fdffd07df71409fc44a3a039c25bf01ca1310,2,6,8,14,5,2013-10-08 02:02:08,2013-10-08 02:00:39
7f0fdffd07df71409fc44a3a039c25bf01ca1310...1ab84b6c653c3169994064f7c1772a8e869c7282,7,37,8,45,9,2013-10-08 02:37:48,2013-10-08 02:32:56
1ab84b6c653c3169994064f7c1772a8e869c7282...af46932b575c494ac6d7e69c467f90cd2bb37ffe,1,2,2,4,2,2013-10-09 00:30:43,2013-10-08 14:20:02
af46932b575c494ac6d7e69c467f90cd2bb37ffe...1bf95803f3fa39fca5e5b9cb84913c82595d8fd5,1,2,2,4,2,2013-10-09 01:06:59,2013-10-09 01:06:23
1bf95803f3fa39fca5e5b9cb84913c82595d8fd5...7a58fde7a60d93b118bcaeb2d18c95e7ec512b8a,1,14,14,28,12,2013-10-09 14:22:36,2013-10-09 14:20:39
7a58fde7a60d93b118bcaeb2d18c95e7ec512b8a...8765eddf2e8470b2d359ea8c4c55ee009b89dbcb,1,6,2,8,2,2013-10-09 18:21:08,2013-10-09 18:21:08
8765eddf2e8470b2d359ea8c4c55ee009b89dbcb...2069dfeaefb1958838aece091bb815d18a25cc33,1,6,6,12,4,2013-10-11 00:57:16,2013-10-10 21:52:50
2069dfeaefb1958838aece091bb815d18a25cc33...f787869d8cac48a7cf1336c78ce5ec3b06729ab6,1,9,8,17,3,2013-10-11 19:35:48,2013-10-11 16:45:00
f787869d8cac48a7cf1336c78ce5ec3b06729ab6...8f5d3d16cb331915e397821efd6faf2700b2bc50,1,9,0,9,2,2013-10-12 00:12:52,2013-10-12 00:11:49
8f5d3d16cb331915e397821efd6faf2700b2bc50...503092b09a9def93f7f5828bbf87cc26147c5b6c,1,19,13,32,5,2013-10-12 16:30:58,2013-10-12 16:27:02
503092b09a9def93f7f5828bbf87cc26147c5b6c...ddff6522fa72aacc7475ba5cd4bf8683ff12b8c7,3,19,11,30,9,2013-10-13 09:58:12,2013-10-13 09:54:11
ddff6522fa72aacc7475ba5cd4bf8683ff12b8c7...f0c7649b1692f8441eb9b9b923b2bed8e95f9185,6,14,28,42,10,2013-10-13 16:25:21,2013-10-13 16:06:58
f0c7649b1692f8441eb9b9b923b2bed8e95f9185...5591fe6829c458346982e39e777f1fdca69e9792,1,5,2,7,1,2013-10-13 17:11:43,2013-10-13 17:09:26
5591fe6829c458346982e39e777f1fdca69e9792...4a9bae0b39aebdedf38fcb760405c04b8216c508,2,2,0,2,2,2013-10-14 08:17:51,2013-10-14 08:11:18
4a9bae0b39aebdedf38fcb760405c04b8216c508...8f5ea9d19b7a50839dead7eaf2ce6566e336067d,1,10,10,20,6,2013-10-14 12:10:51,2013-10-14 11:40:56
8f5ea9d19b7a50839dead7eaf2ce6566e336067d...e3c8db61f3d1e86ac523fc76095d7f3dd1cbe760,2,6,4,10,2,2013-10-14 12:15:50,2013-10-14 11:59:56
e3c8db61f3d1e86ac523fc76095d7f3dd1cbe760...da181056a9e111c7564127cb67df6f186a485c17,2,10,0,10,2,2013-10-14 14:38:30,2013-10-14 12:19:02
da181056a9e111c7564127cb67df6f186a485c17...8222a48253e61f4d3c1d30156a5f9e0d59a7c56c,1,22,11,33,3,2013-10-14 14:55:41,2013-10-14 13:45:30
8222a48253e61f4d3c1d30156a5f9e0d59a7c56c...7f566fdb4c8453c8fa4b44d0fe5cc28472acc2ff,2,7,2,9,2,2013-10-14 15:55:12,2013-10-14 12:43:55
7f566fdb4c8453c8fa4b44d0fe5cc28472acc2ff...ba9cf9596bb07d30614257a755f3e4fea426d2e2,2,37,19,56,21,2013-10-14 19:28:29,2013-10-14 18:24:57
ba9cf9596bb07d30614257a755f3e4fea426d2e2...07ebd23254acab0677aca8baf76440811e9473e2,1,6,0,6,1,2013-10-14 22:43:29,2013-10-14 20:16:49
07ebd23254acab0677aca8baf76440811e9473e2...ecfd958c84a2b224ff1b71c42cfe481da98c14e6,1,26,4,30,4,2013-10-15 11:36:37,2013-10-15 10:55:43
ecfd958c84a2b224ff1b71c42cfe481da98c14e6...1241a2cc104d092ff0f03a16a664e9e4ab801dd1,1,6,6,12,5,2013-10-15 13:58:51,2013-10-15 13:34:11
1241a2cc104d092ff0f03a16a664e9e4ab801dd1...b2f9c74ed1cd246022ab52d239eeb33f950dcc70,2,9,3,12,7,2013-10-17 16:15:56,2013-10-17 16:07:47
b2f9c74ed1cd246022ab52d239eeb33f950dcc70...37afcbeb92cd556ff1081c9db5a4a320efd5b7a3,1,0,16,16,1,2013-10-17 23:00:08,2013-10-17 22:58:24
37afcbeb92cd556ff1081c9db5a4a320efd5b7a3...621fc1f1d74df2d9240dea88b5f7ebdf472bca38,2,21,15,36,9,2013-10-18 12:05:26,2013-10-17 16:57:44
621fc1f1d74df2d9240dea88b5f7ebdf472bca38...dc8176eb3ae98b80eb49a88027d66fdef8094090,2,4,2,6,2,2013-10-18 12:33:00,2013-10-17 23:51:45
dc8176eb3ae98b80eb49a88027d66fdef8094090...fa90b855b2bbb2ebea0ac55f7c87de527950e549,1,1,2,3,2,2013-10-18 12:47:59,2013-10-18 12:47:28
fa90b855b2bbb2ebea0ac55f7c87de527950e549...5bb975a1398edd4d6372302b222878a9616be672,2,35,2,37,5,2013-10-18 13:44:29,2013-09-25 16:59:33
5bb975a1398edd4d6372302b222878a9616be672...f198abc7e4f0ac4b2d7e1aa6e860ffb2e491810a,1,24,0,24,2,2013-10-18 20:22:41,2013-10-17 01:48:03
f198abc7e4f0ac4b2d7e1aa6e860ffb2e491810a...742585b59cb01dd04aa86b623f83caae7e9295da,1,22,23,45,8,2013-10-19 08:52:58,2013-10-19 08:29:17
742585b59cb01dd04aa86b623f83caae7e9295da...0c850e28858016b5890ae83a6ec6880614b306a2,2,4,2,6,2,2013-10-19 08:53:43,2013-10-19 08:40:20
0c850e28858016b5890ae83a6ec6880614b306a2...15a6667a7040739a74c9bc7c83ee9435f517b284,1,4,2,6,1,2013-10-21 17:10:41,2013-10-21 14:53:25
15a6667a7040739a74c9bc7c83ee9435f517b284...37aea82b1cf1175cb5d8de80fb8b0902b3d303e5,1,9,20,29,4,2013-10-21 17:55:28,2013-09-17 23:14:38
37aea82b1cf1175cb5d8de80fb8b0902b3d303e5...823951ec55f17373561b4e97ecbe369c2cac364c,2,40,0,40,4,2013-10-21 18:33:03,2013-09-24 18:52:20
823951ec55f17373561b4e97ecbe369c2cac364c...86373dc63e8e7e06c18878d97c024b40382dc875,2,10,1,11,4,2013-10-21 18:33:27,2013-10-18 13:09:56
86373dc63e8e7e06c18878d97c024b40382dc875...6781dc624318fd03032efb3182266bae0a5c8fc0,1,1,1,2,1,2013-10-21 19:10:42,2013-10-21 19:05:48
6781dc624318fd03032efb3182266bae0a5c8fc0...71306096542f5c1587cd6dd0de99e550608400cb,1,1,0,1,1,2013-10-22 09:37:18,2013-10-21 04:17:52
71306096542f5c1587cd6dd0de99e550608400cb...b987fb188d3940830e323eed4ea6a121192011cd,2,11,7,18,9,2013-10-22 10:38:02,2013-10-21 03:22:32
b987fb188d3940830e323eed4ea6a121192011cd...4499dc81e2fb4d61fca7a988ee6198caf71ca173,1,1,1,2,1,2013-10-22 16:06:16,2013-10-22 16:05:26
4499dc81e2fb4d61fca7a988ee6198caf71ca173...2e74d6cb53a38c4cc08d4a069157be335a486ddd,3,56,0,56,4,2013-10-23 00:24:26,2013-09-25 13:33:29
2e74d6cb53a38c4cc08d4a069157be335a486ddd...bcc65c13a086f3e6d24dc7fc92a167fd836af501,8,24,32,56,14,2013-10-23 01:40:01,2013-10-22 23:38:11
bcc65c13a086f3e6d24dc7fc92a167fd836af501...9c982053f4d9c9696214d7c20ab32204d27e4a94,1,1,1,2,1,2013-10-23 02:56:12,2013-10-23 02:56:12
9c982053f4d9c9696214d7c20ab32204d27e4a94...27f3f341369c8e18ea4a360a1f7c01531836b68b,2,28,0,28,2,2013-10-23 12:01:05,2013-10-21 15:12:48
27f3f341369c8e18ea4a360a1f7c01531836b68b...7f5555db2b2c711a2ba66ee586d145d70e1a7609,1,3,3,6,3,2013-10-23 12:27:18,2013-10-23 10:59:06
7f5555db2b2c711a2ba66ee586d145d70e1a7609...bc62a20a3eff77435ad51eabc29dc231063b4c36,2,2,2,4,2,2013-10-23 22:29:09,2013-10-23 22:28:41
bc62a20a3eff77435ad51eabc29dc231063b4c36...26e45766812ff75d6a9595729a4c45bd56badb3e,1,1,1,2,1,2013-10-25 11:55:41,2013-10-24 09:11:52
26e45766812ff75d6a9595729a4c45bd56badb3e...747f77552a08fffe1bb64f862d54cb8ffffb6904,1,1,1,2,1,2013-10-25 21:37:39,2013-10-25 21:36:07
747f77552a08fffe1bb64f862d54cb8ffffb6904...e052ada0f6f21208d0f215d2f9184c4069ac1419,1,22,17,39,4,2013-10-26 20:55:10,2013-10-25 23:07:40
e052ada0f6f21208d0f215d2f9184c4069ac1419...ec0a3f5085219cd647d3e93841018987ce5384bf,4,4,4,8,4,2013-10-26 21:22:21,2013-10-26 21:22:21
ec0a3f5085219cd647d3e93841018987ce5384bf...aa645d20df05cdbd6ce28ff31f1cf00bd9af1e40,2,10,0,10,2,2013-10-30 11:47:32,2013-10-30 11:46:07
aa645d20df05cdbd6ce28ff31f1cf00bd9af1e40...da0c7723fa71f7273d5bd917a6aecc4243232a4e,1,11,0,11,1,2013-10-30 12:12:09,2013-10-30 12:11:31
da0c7723fa71f7273d5bd917a6aecc4243232a4e...142757c61ef750faa1cb135f06847e289ebaa012,1,4,2,6,1,2013-10-30 12:27:19,2013-10-29 18:36:22
142757c61ef750faa1cb135f06847e289ebaa012...1cdf7f83ff9d0a7046ec99d035b82a5bd93838c7,1,3,4,7,2,2013-10-30 13:26:35,2013-10-30 13:25:21
1cdf7f83ff9d0a7046ec99d035b82a5bd93838c7...d774cb219c4581461bd2310450605916dd7c13e6,1,4,3,7,2,2013-10-30 13:35:05,2013-10-30 13:33:28
d774cb219c4581461bd2310450605916dd7c13e6...5217d01b77188d79387bb7fa333e5349f66a8efe,1,1,1,2,1,2013-10-30 20:00:13,2013-10-30 13:12:27
5217d01b77188d79387bb7fa333e5349f66a8efe...8f104bb8d51835c240bbc7f468032b798a263b24,1,8,0,8,1,2013-10-31 16:53:05,2013-10-31 16:45:51
8f104bb8d51835c240bbc7f468032b798a263b24...f03c699159af53725b08aa5d8f7efb74b4662816,1,2,2,4,2,2013-11-01 09:46:39,2013-11-01 09:43:27
f03c699159af53725b08aa5d8f7efb74b4662816...3f1b20841af48f444e23d1ac8ee7f75738a6dd9e,1,2,2,4,1,2013-11-01 10:02:11,2013-11-01 09:59:16
3f1b20841af48f444e23d1ac8ee7f75738a6dd9e...35fd14cf42f5461520e755da7bad4d4629ea26bc,2,2,2,4,2,2013-11-01 23:28:19,2013-11-01 14:00:02
35fd14cf42f5461520e755da7bad4d4629ea26bc...33503c57ef369f07dd6a3a33ecf5cdd3fbbd0a6b,4,5,5,10,4,2013-11-02 01:32:05,2013-11-02 01:29:39
33503c57ef369f07dd6a3a33ecf5cdd3fbbd0a6b...66bf6b3f857fea1114f13fbccdb66258e43a6a05,1,2,2,4,2,2013-11-02 18:15:20,2013-11-02 18:13:29
66bf6b3f857fea1114f13fbccdb66258e43a6a05...72bc9254911cacee923bab1b21e3860bd776af48,157,28310,22887,51197,17829,2013-11-05 19:02:25,2013-11-05 19:02:25
72bc9254911cacee923bab1b21e3860bd776af48...84b9ab7c1d0dd2567a060e148ad630c7aa0103ee,2040,43668,26614,70282,19658,2013-11-05 20:44:03,2013-11-05 19:08:35
84b9ab7c1d0dd2567a060e148ad630c7aa0103ee...a71ff762356a46f37d189f503f0ec2aaaca6ad0e,3,7,5,12,4,2013-11-06 13:54:49,2013-11-06 13:54:49
a71ff762356a46f37d189f503f0ec2aaaca6ad0e...c89a56d9fe708925740d603d00261f189824e33a,1,1,1,2,1,2013-11-06 14:59:40,2013-11-06 14:59:40
c89a56d9fe708925740d603d00261f189824e33a...b3da4cc0925b5d72701ea254ec8197d0f8b85210,1,1,1,2,1,2013-11-07 14:32:26,2013-11-05 11:25:19
b3da4cc0925b5d72701ea254ec8197d0f8b85210...6026a5091b4973366c008f5439bfd496d50f5fa4,2,15,0,15,2,2013-11-07 14:42:47,2013-11-07 14:42:25
6026a5091b4973366c008f5439bfd496d50f5fa4...6c34e18bd41237328b50177411809bd800fcab21,2,20,3,23,4,2013-11-08 09:55:11,2013-11-07 11:30:04
6c34e18bd41237328b50177411809bd800fcab21...3c8879f092be25f0b60051d8e0c3a77dca354af3,1,0,22,22,2,2013-11-08 15:53:12,2013-11-08 15:47:19
3c8879f092be25f0b60051d8e0c3a77dca354af3...d4b1724b36ea03c8ca72f8addff92dc9edb5e260,1,1,1,2,1,2013-11-08 23:35:43,2013-11-08 22:20:50
d4b1724b36ea03c8ca72f8addff92dc9edb5e260...c9917f4c83982bd14553f2a953d7ea9e9dc150fd,1,1,1,2,1,2013-11-08 23:39:53,2013-11-08 02:24:55
c9917f4c83982bd14553f2a953d7ea9e9dc150fd...82e756da83085b2fc5710b11d6d2718cda85a546,1,6,3,9,4,2013-11-09 00:25:21,2013-11-03 16:55:11
82e756da83085b2fc5710b11d6d2718cda85a546...86e72f5ba9f8751e81cfd2370df44d09648b9560,1,1,1,2,1,2013-11-09 14:10:14,2013-11-09 14:08:57
86e72f5ba9f8751e81cfd2370df44d09648b9560...c9076a408c0d002babe78f5de6796e2a3a0e4731,1,1,1,2,1,2013-11-09 15:18:55,2013-11-09 15:18:55
c9076a408c0d002babe78f5de6796e2a3a0e4731...4b9e932fd46eaac4774d229c40c2ee75f8fb759b,3,18,1,19,4,2013-11-09 15:21:19,2013-11-09 11:36:10
4b9e932fd46eaac4774d229c40c2ee75f8fb759b...4aed1ee339c4a36035e1fd1a02b1ec9142feac07,2,14,34,48,10,2013-11-09 23:02:13,2013-11-09 10:32:19
4aed1ee339c4a36035e1fd1a02b1ec9142feac07...b6acc4f7498f195096e20af3e4fe0dd68d2dbac8,1,6,10,16,3,2013-11-12 19:54:37,2013-11-12 19:27:21
b6acc4f7498f195096e20af3e4fe0dd68d2dbac8...b107421acfc4046ffaa799aceef2c3b4877207f2,3,53,2,55,4,2013-11-13 05:41:30,2013-11-13 04:42:12
b107421acfc4046ffaa799aceef2c3b4877207f2...5b8c8c462d2b7b24370a39bf519c57f1ddf782b6,1,3,0,3,1,2013-11-13 17:25:31,2013-11-13 17:24:15
5b8c8c462d2b7b24370a39bf519c57f1ddf782b6...c37b2e46b9c3fc91973d6f8678bafb6e67b85031,1,25,0,25,1,2013-11-14 16:04:55,2013-11-06 20:11:54
c37b2e46b9c3fc91973d6f8678bafb6e67b85031...0aa06bd3782d1bf6961ba846ec79aded82daa5c2,2,25,1,26,3,2013-11-14 20:21:02,2013-11-14 19:55:13
0aa06bd3782d1bf6961ba846ec79aded82daa5c2...67c30426c1370f5d6c39bd73888c3902c1c5f365,2,22,1,23,4,2013-11-14 20:39:24,2013-11-14 09:32:55
67c30426c1370f5d6c39bd73888c3902c1c5f365...2cfff0cb729cd50b6045f8d7164ed5462eeac006,1,2,1,3,1,2013-11-14 22:09:20,2013-11-14 22:09:20
2cfff0cb729cd50b6045f8d7164ed5462eeac006...bdde6f6a03b9f1e13c8b13133dabd633346c9946,1,5,0,5,1,2013-11-14 22:14:37,2013-11-14 22:13:20
bdde6f6a03b9f1e13c8b13133dabd633346c9946...2a0039ba62e35714a4b7bf6dc4f243e8f2c40a24,1,1,1,2,2,2013-11-14 23:24:11,2013-11-14 23:24:11
2a0039ba62e35714a4b7bf6dc4f243e8f2c40a24...f2b5e9d5bbfced68c02f50ebb15a7adf70bca36e,1,1,1,2,1,2013-11-15 12:10:47,2013-11-15 12:09:46
f2b5e9d5bbfced68c02f50ebb15a7adf70bca36e...1e2bbc3b712d53032a3cf25e77baf3a157de66f0,1,20,12,32,8,2013-11-15 14:35:44,2013-11-13 19:16:39
1e2bbc3b712d53032a3cf25e77baf3a157de66f0...882ee16f68deeb1831b83a407911e720fbd5e9fd,1,25,19,44,13,2013-11-15 14:49:07,2013-11-15 14:38:33
882ee16f68deeb1831b83a407911e720fbd5e9fd...e8dea1f35cc037d104924994b8afbc5549b5c49e,1,1,1,2,1,2013-11-15 15:22:51,2013-11-15 15:21:58
e8dea1f35cc037d104924994b8afbc5549b5c49e...1fd762c106ed0e6888fe66e7513718ca379385c0,5,34,6,40,9,2013-11-16 18:15:46,2013-11-12 19:35:52
1fd762c106ed0e6888fe66e7513718ca379385c0...cbf8784d206819e83c43d75b422af51209c4b74c,1,5,1,6,1,2013-11-16 18:55:37,2013-11-16 18:51:47
cbf8784d206819e83c43d75b422af51209c4b74c...e85baa813f2a2c8e565fc68418ff91e84d7d5ec0,150,2954,2465,5419,1528,2013-11-17 20:20:44,2013-11-17 19:30:03
e85baa813f2a2c8e565fc68418ff91e84d7d5ec0...a776e3f42088a5a82bd0ec9c5353981a1a23e10c,1,12,4,16,1,2013-11-18 13:00:16,2013-11-18 12:58:43
a776e3f42088a5a82bd0ec9c5353981a1a23e10c...2b03d53438e7d54f754c58d8f148254a7a73ef5c,1,4,0,4,1,2013-11-18 14:33:53,2013-11-18 14:32:25
2b03d53438e7d54f754c58d8f148254a7a73ef5c...a9c50fccf295d3ff8915588cd6442f1c70f1af9a,18,27,27,54,26,2013-11-18 15:03:00,2013-08-05 16:23:26
a9c50fccf295d3ff8915588cd6442f1c70f1af9a...9f59149cfe97b3b0026bbc4ff1d2121e4cf04d0e,1,5,0,5,1,2013-11-18 17:09:54,2013-11-18 17:06:57
9f59149cfe97b3b0026bbc4ff1d2121e4cf04d0e...4c9362d81f09addac550c4c7296c1fa387f57371,1,19,18,37,12,2013-11-18 18:28:29,2013-11-18 18:25:28
4c9362d81f09addac550c4c7296c1fa387f57371...62bb4fc8063b755be00c4f2a936292fc0bf067ca,1,18,18,36,6,2013-11-18 19:08:01,2013-11-18 19:07:42
62bb4fc8063b755be00c4f2a936292fc0bf067ca...833f7d11e8f1d0171bac23e2e78c1111a83fbeaa,4,27,9,36,5,2013-11-18 19:34:39,2013-11-18 13:05:59
833f7d11e8f1d0171bac23e2e78c1111a83fbeaa...44469af34b98df85806cb9ad305b0504f3e22df7,1,1,1,2,1,2013-11-19 00:11:33,2013-11-19 00:10:58
44469af34b98df85806cb9ad305b0504f3e22df7...ac2ef4af7cb7b462b2b1801d6cdcc4774de9ed8b,1,5,2,7,1,2013-11-19 15:25:48,2013-11-16 04:03:01
ac2ef4af7cb7b462b2b1801d6cdcc4774de9ed8b...20e322f4bfaf903e0dc45d157b7a7c95d6ab4391,1,30,3,33,2,2013-11-19 18:56:06,2013-11-19 14:25:15
20e322f4bfaf903e0dc45d157b7a7c95d6ab4391...6f48ae0b0ffc42f63487f482d668507d986790df,1,15,20,35,7,2013-11-19 21:21:06,2013-11-15 19:06:32
6f48ae0b0ffc42f63487f482d668507d986790df...d8fdee7db877e3a52a761bfcbeb3536ea219ec30,3,13,2,15,4,2013-11-20 20:37:35,2013-11-20 20:34:29
d8fdee7db877e3a52a761bfcbeb3536ea219ec30...47abfa237e21ca71d8ee901cf8ba1f1c89ae1f2e,1,13,10,23,6,2013-11-21 13:17:58,2013-11-20 21:59:23
47abfa237e21ca71d8ee901cf8ba1f1c89ae1f2e...5730bf281922151f211a2509dd8b493230d6a187,2,22,1,23,4,2013-11-21 13:34:04,2013-11-21 12:11:57
5730bf281922151f211a2509dd8b493230d6a187...9cbcd06b1adf5a505646f30898c3370d1c4ab726,3,32,6,38,4,2013-11-21 21:24:00,2013-11-21 21:18:52
9cbcd06b1adf5a505646f30898c3370d1c4ab726...1eddca0a5202993dbb3f437ccb74095f6647b825,1,6,5,11,4,2013-11-22 14:32:22,2013-11-22 14:31:31
1eddca0a5202993dbb3f437ccb74095f6647b825...ea0d97c470ca2d5ddb4320fe03c77221b3064adf,1,5,5,10,2,2013-11-22 16:02:50,2013-11-21 23:46:35
ea0d97c470ca2d5ddb4320fe03c77221b3064adf...d55df0b81083d8aa02145ac5885a855a9c9577b3,2,20,1,21,3,2013-11-22 19:37:09,2013-11-20 17:50:36
d55df0b81083d8aa02145ac5885a855a9c9577b3...4212ae6fef47ec85f972f715c7f75a69071ed04b,1,5,5,10,1,2013-11-23 00:39:54,2013-11-22 01:54:27
4212ae6fef47ec85f972f715c7f75a69071ed04b...a0ab432f2fea494f2a1894fa3c778b914b7ccd87,1,18,0,18,1,2013-11-23 00:50:46,2013-11-22 12:55:02
a0ab432f2fea494f2a1894fa3c778b914b7ccd87...ddd3926280725fc4cedd1c511a95a57db7dde488,1,0,185,185,1,2013-11-23 13:57:30,2013-11-23 13:57:30
ddd3926280725fc4cedd1c511a95a57db7dde488...8750296918072c97a51f6809d19828ce3f1b8d40,6,35,43,78,34,2013-11-23 14:02:30,2013-11-23 02:47:04
8750296918072c97a51f6809d19828ce3f1b8d40...432de546113942be60089a879371073ad09fb4fe,2,3,1,4,2,2013-11-23 17:49:06,2013-11-23 17:18:42
432de546113942be60089a879371073ad09fb4fe...af65860c5bc8f5efb76df9078284996cf55114f5,1,2,1,3,1,2013-11-24 20:19:34,2013-11-24 19:33:04
af65860c5bc8f5efb76df9078284996cf55114f5...df18cc632cd78d575f434310724034630cc84304,1,1,1,2,1,2013-11-24 21:29:10,2013-11-24 21:28:29
df18cc632cd78d575f434310724034630cc84304...593ec42ad1375d8644e3eb485566315f0187de99,1,5,1,6,2,2013-11-25 13:27:27,2013-11-25 11:22:43
593ec42ad1375d8644e3eb485566315f0187de99...6cd5c67b694b3469817e38d02f79ddef7c2a7132,1,13,7,20,3,2013-11-26 17:04:23,2013-10-28 10:11:05
6cd5c67b694b3469817e38d02f79ddef7c2a7132...655b8bb10b3c00d6c96e357d085c20b397a2ffa0,3,7,0,7,3,2013-11-26 19:42:54,2013-11-23 19:51:17
655b8bb10b3c00d6c96e357d085c20b397a2ffa0...02f9e90fdfe795992d674094fe25919bb885bf0d,1,2,0,2,2,2013-11-27 23:59:00,2013-11-27 23:53:10
02f9e90fdfe795992d674094fe25919bb885bf0d...14ddc1b517266916d9e729bc20234edec1d7bd4c,3,28,11,39,5,2013-11-28 17:34:33,2013-11-23 09:53:09
14ddc1b517266916d9e729bc20234edec1d7bd4c...2f42bbaba739079713a555b9881ca5762ee0a0dc,3,35,2,37,5,2013-11-30 19:35:38,2013-11-30 01:49:56
2f42bbaba739079713a555b9881ca5762ee0a0dc...adb8c563ed4a52b9384512e95405331ca6ac655d,1,1,1,2,1,2013-12-01 19:26:42,2013-12-01 19:21:57
adb8c563ed4a52b9384512e95405331ca6ac655d...c8b4ac814ce7d71d352046c03115abba6d9489f5,1,8,1,9,4,2013-12-02 09:35:27,2013-11-30 18:07:35
c8b4ac814ce7d71d352046c03115abba6d9489f5...87433c30c766b3cf7f432dbd97bd5413db5daa07,2,3,0,3,3,2013-12-02 18:38:46,2013-12-02 17:21:48
87433c30c766b3cf7f432dbd97bd5413db5daa07...3f8583a2c8978096be177bc7c95955e65eebee5f,3,58,4,62,4,2013-12-02 18:49:47,2013-11-13 12:38:03
3f8583a2c8978096be177bc7c95955e65eebee5f...c8cf49e5c48eca4936c3729d1a4f963a4666c282,2,5,3,8,2,2013-12-04 13:28:43,2013-12-04 13:26:03
c8cf49e5c48eca4936c3729d1a4f963a4666c282...6691abcdf0db219bfa584d52eb21e891d88f2aeb,1,4,0,4,2,2013-12-04 15:51:37,2013-12-04 15:46:56
6691abcdf0db219bfa584d52eb21e891d88f2aeb...49fab30496c6468b7ff323e846e4d31423c12b2b,1,1,1,2,2,2013-12-04 22:21:27,2013-12-04 21:32:41
49fab30496c6468b7ff323e846e4d31423c12b2b...656a3adff73e3f4df4884540bd9426740593834f,1,1,1,2,1,2013-12-05 21:35:00,2013-12-05 21:22:37
656a3adff73e3f4df4884540bd9426740593834f...4f9590836ca679e4aef2627a71f4277ca4c80605,1,7,0,7,1,2013-12-06 00:10:49,2013-12-05 13:45:49
4f9590836ca679e4aef2627a71f4277ca4c80605...5a4884a978d48a21e765141cd9a4c37448875a85,4,43,1,44,4,2013-12-07 02:30:07,2013-12-07 02:21:58
5a4884a978d48a21e765141cd9a4c37448875a85...7d75a33331c971194bd07143aa8ff4b491f5c693,1,2,0,2,1,2013-12-07 02:40:58,2013-12-07 02:37:31
7d75a33331c971194bd07143aa8ff4b491f5c693...34c4b93c84e86665d66d0b31da8e30fd581d5b5f,3,32,0,32,3,2013-12-07 09:21:05,2013-12-06 13:40:51
34c4b93c84e86665d66d0b31da8e30fd581d5b5f...45c0d2e1ce0fe024e4a80c9dde8263f5ff59d577,4,26,9,35,11,2013-12-07 09:48:34,2013-12-05 21:55:33
45c0d2e1ce0fe024e4a80c9dde8263f5ff59d577...ef9832f148d72cd8a32c9398d8dd8600d30f0ab8,30,52,52,104,48,2013-12-08 17:48:30,2013-12-08 17:39:26
ef9832f148d72cd8a32c9398d8dd8600d30f0ab8...d6d700fc6d5c32b86989a51a8a721e09ca26f1f4,1,1,1,2,1,2013-12-10 12:25:43,2013-12-09 21:54:11
d6d700fc6d5c32b86989a51a8a721e09ca26f1f4...64483b483151fb0dce02ad423e48fa7645dada1b,126,549,378,927,377,2013-12-10 20:14:22,2013-12-10 18:55:17
64483b483151fb0dce02ad423e48fa7645dada1b...d32637d81b6b4adf6440bead756fb5a063e4d28d,3,15,4,19,6,2013-12-11 14:32:10,2013-12-07 13:11:27
d32637d81b6b4adf6440bead756fb5a063e4d28d...c558a43fd6bbcea9972b66965f7e8619bc247df1,4,27,27,54,6,2013-12-11 14:49:27,2013-11-23 17:27:23
c558a43fd6bbcea9972b66965f7e8619bc247df1...3f9d00e591cb95138c893c905cc705f059a92ea8,1,2,0,2,1,2013-12-11 15:06:29,2013-12-11 15:04:25
3f9d00e591cb95138c893c905cc705f059a92ea8...b953b27a922f4fe71ec36928086ddc16caf65030,1,2,0,2,1,2013-12-11 15:13:55,2013-12-11 15:13:09
b953b27a922f4fe71ec36928086ddc16caf65030...ebf55d32c1b8599f22537403d8bf85552b8adac6,1,2,0,2,1,2013-12-11 15:37:25,2013-12-11 15:37:25
ebf55d32c1b8599f22537403d8bf85552b8adac6...7a2910d790baf6df417f7821f86caafd3b275f3c,1,12,8,20,7,2013-12-11 17:34:50,2013-12-11 17:34:50
7a2910d790baf6df417f7821f86caafd3b275f3c...de1d5d5df5238136e8cd114e36065857bee1ace4,1,6,0,6,1,2013-12-11 19:39:29,2013-12-11 17:28:05
de1d5d5df5238136e8cd114e36065857bee1ace4...073eed95173dab72a615545d2cd762009dac88e6,1,1,1,2,1,2013-12-12 19:48:32,2013-12-12 19:48:32
073eed95173dab72a615545d2cd762009dac88e6...194c5ab056babda43661cd48598aec182cd86341,1,1,1,2,1,2013-12-12 20:06:47,2013-12-12 20:06:47
194c5ab056babda43661cd48598aec182cd86341...1c18c7f8ae920eb46838f7008020e0c5179e6553,1,1,1,2,1,2013-12-12 20:15:35,2013-12-12 20:15:35
1c18c7f8ae920eb46838f7008020e0c5179e6553...f05b381845918a51a5a87def1cb3d4a73f539cab,5,7,7,14,7,2013-12-13 07:21:20,2013-12-13 07:20:24
f05b381845918a51a5a87def1cb3d4a73f539cab...704f58108154ea3523369cacb74b2345f4c8a381,2,13,0,13,2,2013-12-13 23:55:35,2013-12-13 23:42:24
704f58108154ea3523369cacb74b2345f4c8a381...eb4079597dba8bca94b97afab71dd955ccf4c3fe,1,5,0,5,1,2013-12-13 23:59:27,2013-12-10 23:24:31
eb4079597dba8bca94b97afab71dd955ccf4c3fe...f39579e09f32237fe50dc60312cac2f89db193f5,1,1,1,2,1,2013-12-14 15:42:36,2013-12-13 15:58:49
f39579e09f32237fe50dc60312cac2f89db193f5...ad8a7819f2d84cb54abf4448a11ef2c625033fd9,1,13,11,24,5,2013-12-14 16:21:22,2013-12-13 21:19:48
ad8a7819f2d84cb54abf4448a11ef2c625033fd9...15ab4936d7d7c351ab8eea5f8c2765632429c9ed,1,24,0,24,1,2013-12-14 21:36:21,2013-12-01 02:05:15
15ab4936d7d7c351ab8eea5f8c2765632429c9ed...51927132856798cacbcd78021e0f6a5037021e1e,1,1,1,2,1,2013-12-15 00:51:21,2013-12-15 00:50:54
51927132856798cacbcd78021e0f6a5037021e1e...6a36b71fc2bacc1f193c042bf79ce7aa39414906,1,1,1,2,1,2013-12-15 15:51:58,2013-12-15 15:51:58
6a36b71fc2bacc1f193c042bf79ce7aa39414906...e888760854ad674772abe10e1c3741e5c6308aa9,1,3,3,6,1,2013-12-15 22:03:26,2013-12-15 22:02:20
e888760854ad674772abe10e1c3741e5c6308aa9...60517c9c09daffee678fd4337687185ce38ed35b,1,14,21,35,5,2013-12-18 13:30:20,2013-12-16 21:47:11
60517c9c09daffee678fd4337687185ce38ed35b...dd7e2925dd63700a70f04a1e4c0df837acbdd55c,1,5,6,11,3,2013-12-18 17:37:56,2013-12-18 05:40:25
dd7e2925dd63700a70f04a1e4c0df837acbdd55c...07d3d57dedbc2baf8d704d32f3d48523d2991b9e,1,2,1,3,1,2013-12-18 23:37:06,2013-12-18 23:36:01
07d3d57dedbc2baf8d704d32f3d48523d2991b9e...438f9edff6e53815c8223ec9e04740facad83a26,2,8,18,26,5,2013-12-18 23:50:36,2013-12-18 23:48:21
438f9edff6e53815c8223ec9e04740facad83a26...54b04cc8e6e4ea3f40b6320afe7e8ecfa16a8651,18,161,69,230,62,2013-12-19 14:24:13,2013-10-03 22:51:22
54b04cc8e6e4ea3f40b6320afe7e8ecfa16a8651...847d2ab5b3b786f735267f77dd02ba52451a1e7f,1,1,1,2,2,2013-12-25 11:11:20,2013-12-25 11:06:25
847d2ab5b3b786f735267f77dd02ba52451a1e7f...b536ad09cadc087b7559db2f8cca50f06c6e8f34,3,12,2,14,3,2013-12-26 10:14:25,2013-12-24 14:19:25
b536ad09cadc087b7559db2f8cca50f06c6e8f34...0e8138349ef7f30f6042853b10f28be7301c20ca,3,17,0,17,3,2013-12-26 12:46:12,2013-12-18 19:04:53
0e8138349ef7f30f6042853b10f28be7301c20ca...3bb7de8c7c3f9d5de5426d94f45fe83b5d998357,1,2,2,4,1,2013-12-26 18:07:04,2013-11-15 03:55:29
3bb7de8c7c3f9d5de5426d94f45fe83b5d998357...62f282a265ae7f8d051f7ce79788cfc1a84d1a24,2,17,0,17,2,2013-12-26 20:50:49,2013-12-26 20:50:33
62f282a265ae7f8d051f7ce79788cfc1a84d1a24...f3a9a761238977b7db9a2f8449207cd439be235e,1,6,1,7,2,2013-12-27 01:06:29,2013-12-27 01:04:28
f3a9a761238977b7db9a2f8449207cd439be235e...3b79fbabcdfefa6c5734a9645be4ffee02e4a270,1,28,23,51,6,2013-12-27 15:02:41,2013-12-27 14:57:56
3b79fbabcdfefa6c5734a9645be4ffee02e4a270...2d08390d70007236e083183d78a4435d249c5aa8,1,20,0,20,2,2013-12-28 10:11:58,2013-12-28 10:08:50
2d08390d70007236e083183d78a4435d249c5aa8...35a447a263115b22a7040a9f4a16ff4bd2078466,1,30,32,62,6,2013-12-28 11:48:54,2013-12-28 11:40:10
35a447a263115b22a7040a9f4a16ff4bd2078466...ed167e53a52af22a8dce229696184b0d87a88a78,2,22,4,26,4,2013-12-28 15:01:40,2013-12-28 14:24:25
ed167e53a52af22a8dce229696184b0d87a88a78...51d6a7d53e956ee0b32bb45e33d09b07d796429e,1,6,0,6,1,2013-12-30 22:46:16,2013-12-30 22:42:11
51d6a7d53e956ee0b32bb45e33d09b07d796429e...2d554d29f2f3b495768e4100e9b48c1bb6242799,1,5,2,7,2,2013-12-30 22:57:44,2013-12-30 22:55:12
2d554d29f2f3b495768e4100e9b48c1bb6242799...7c674dd1f19d30252bd959b26c616125c01ae58f,3,85,52,137,26,2013-12-31 11:05:59,2013-12-28 17:35:17
7c674dd1f19d30252bd959b26c616125c01ae58f...d18f99dfc7779414bf6a0025994589601edbc0ac,3,37,16,53,14,2013-12-31 11:09:52,2013-12-30 22:45:43
d18f99dfc7779414bf6a0025994589601edbc0ac...e99eeefe4403668561048753dd8def5cfee3b5aa,1,5,3,8,2,2013-12-31 11:10:22,2013-12-30 22:54:12
e99eeefe4403668561048753dd8def5cfee3b5aa...f82eb493015f4fbf0b8fc063f561b5135fc815de,6,1532,1534,3066,10,2013-12-31 13:32:58,2013-12-31 11:24:11
f82eb493015f4fbf0b8fc063f561b5135fc815de...a05ca51c08d1cc4e69ca9b33a5a519e062d8236f,1,33,6,39,3,2013-12-31 15:23:11,2013-12-31 15:20:44
a05ca51c08d1cc4e69ca9b33a5a519e062d8236f...a228545026e30d3223b3fbb13a262b5e005101ae,1,8,3,11,2,2013-12-31 18:03:25,2013-12-31 18:02:01
a228545026e30d3223b3fbb13a262b5e005101ae...3fd16e6261f9c19a68ba69f1d97027a6eaf3a22b,6,45,26,71,13,2013-12-31 20:04:22,2013-12-09 17:29:39
3fd16e6261f9c19a68ba69f1d97027a6eaf3a22b...ea82e98f8cf0e718bd25c7a68ee4e0b0214001ec,1,1,1,2,1,2014-01-01 00:42:45,2014-01-01 00:23:20
ea82e98f8cf0e718bd25c7a68ee4e0b0214001ec...865723f2670d7a7acf8e66a42d99cfb807cf9aac,1,6,6,12,6,2014-01-01 14:56:42,2014-01-01 14:56:31
865723f2670d7a7acf8e66a42d99cfb807cf9aac...8b1de986f6df8f3c53b45a0ad9adf9b49978a824,1,2,2,4,2,2014-01-02 21:22:21,2014-01-02 20:14:11
8b1de986f6df8f3c53b45a0ad9adf9b49978a824...5dcb28706080344eaa0743a8f88799d961d9b071,1,4,4,8,4,2014-01-02 21:25:51,2014-01-02 19:22:52
5dcb28706080344eaa0743a8f88799d961d9b071...8841cbbe82a4ed983e1a84e12782e6095bf2c97e,1,28,0,28,1,2014-01-02 21:36:50,2014-01-02 21:28:56
8841cbbe82a4ed983e1a84e12782e6095bf2c97e...0a4e36c68f91b99cf9ae8eec8312ef55843916fa,1,34,0,34,1,2014-01-03 00:45:22,2013-12-07 07:13:20
0a4e36c68f91b99cf9ae8eec8312ef55843916fa...7a4d2b8e3d785f518ceec74c7ead862b84715618,1,5,4,9,3,2014-01-03 17:01:52,2014-01-03 16:04:38
7a4d2b8e3d785f518ceec74c7ead862b84715618...2206321ff9494c5f05350def8b50d9680c59adca,1,2,2,4,1,2014-01-03 17:04:18,2014-01-03 17:02:58
2206321ff9494c5f05350def8b50d9680c59adca...5d99cd6877377824a6a5de92475ad0572ab6fb0f,1,1,2,3,2,2014-01-04 15:13:21,2014-01-04 15:11:21
5d99cd6877377824a6a5de92475ad0572ab6fb0f...e694b0631f6f33a4c16b3f9650dff67c55b2c830,1,2,2,4,2,2014-01-10 13:26:22,2014-01-10 01:44:07
e694b0631f6f33a4c16b3f9650dff67c55b2c830...bd3af2ee642fc2885fdc641d3563f64bd345663d,1,1,1,2,1,2014-01-10 13:33:58,2014-01-10 04:31:22
bd3af2ee642fc2885fdc641d3563f64bd345663d...6728f159f060e536f1543b4afecb602b6693babb,2,12,4,16,4,2014-01-11 13:21:25,2014-01-09 15:03:37
6728f159f060e536f1543b4afecb602b6693babb...b79bf9c7a9c1bc0e3cf0c5c4b0d8191a3033530b,1,9,6,15,3,2014-01-12 17:45:45,2014-01-12 17:24:04
b79bf9c7a9c1bc0e3cf0c5c4b0d8191a3033530b...cb4a000adbb750da62daab318a9f4da8e3d4fdcd,2,21,6,27,3,2014-01-12 17:47:03,2014-01-12 17:26:20
cb4a000adbb750da62daab318a9f4da8e3d4fdcd...18d75e079245d7ba789d69eacda2aaf7603d678e,1,3,2,5,2,2014-01-12 20:39:36,2014-01-12 20:38:04
18d75e079245d7ba789d69eacda2aaf7603d678e...deefdc8e600e80da8b6d17d0a02f142a26f1a599,1,1,1,2,1,2014-01-15 23:44:47,2014-01-15 21:17:08
deefdc8e600e80da8b6d17d0a02f142a26f1a599...f8d93f2c71f5a6dff349ec290f9ca6d7d316ba4f,1,7,2,9,3,2014-01-16 12:09:15,2014-01-16 12:07:53
f8d93f2c71f5a6dff349ec290f9ca6d7d316ba4f...b63dad3f452d8331d6e0372192a8ed2fcda23815,1,9,8,17,2,2014-01-16 12:17:42,2014-01-16 12:16:09
b63dad3f452d8331d6e0372192a8ed2fcda23815...363b8c690a992f78f40137e0ff406cb3167653d6,1,3,2,5,2,2014-01-16 12:59:15,2014-01-16 12:58:08
363b8c690a992f78f40137e0ff406cb3167653d6...b1cc1633e0ae2b74611dde2b832c0368c2984b4e,1,1,0,1,1,2014-01-17 01:49:06,2014-01-17 01:47:02
b1cc1633e0ae2b74611dde2b832c0368c2984b4e...b8ec3b6ddd835a66a239a4bdd5ee51b541ca09e4,1,11,71,82,3,2014-01-17 14:28:21,2014-01-17 14:21:34
b8ec3b6ddd835a66a239a4bdd5ee51b541ca09e4...4f058655d0defad179f1a92c7e2d1f282c26b1f0,1,3,1,4,2,2014-01-17 19:52:02,2014-01-17 19:50:47
4f058655d0defad179f1a92c7e2d1f282c26b1f0...85149a8b7fb560960fb6e8b64e1d9f486e982c19,2,5,8,13,3,2014-01-17 21:06:54,2014-01-17 20:58:19
85149a8b7fb560960fb6e8b64e1d9f486e982c19...fcc290eda96984478e54aa929d55cef6c0aa3986,1,14,0,14,1,2014-01-19 17:43:20,2013-09-07 17:46:42
fcc290eda96984478e54aa929d55cef6c0aa3986...a292ad1105409771f270a2b1255f3511b102c504,1,1,1,2,1,2014-01-21 01:06:08,2013-10-01 14:08:36
a292ad1105409771f270a2b1255f3511b102c504...f7c2852f30fd5fe6980d6983725a41e64c6d2c53,1,3,2,5,1,2014-01-22 15:19:02,2014-01-22 15:17:44
f7c2852f30fd5fe6980d6983725a41e64c6d2c53...a4c32d70c2bcf9731b6d6ff3370d2260ab4812af,1,9,3,12,1,2014-01-22 15:45:10,2014-01-22 15:44:50
a4c32d70c2bcf9731b6d6ff3370d2260ab4812af...4cf556db4850d922ccda4fe9529ea5aa43620b0b,1,2,2,4,1,2014-01-22 16:04:31,2014-01-22 16:03:55
4cf556db4850d922ccda4fe9529ea5aa43620b0b...8eca53f0bef783e5c11877fe18a6651543605af1,1,33,0,33,1,2014-01-22 18:09:44,2014-01-16 12:46:35
8eca53f0bef783e5c11877fe18a6651543605af1...6bca149af5b8e2d6fb6fe19bdb53904f07248033,11,65,65,130,65,2014-01-22 21:59:55,2014-01-22 21:17:32
6bca149af5b8e2d6fb6fe19bdb53904f07248033...6bf05c0267b388bdf6f2bda6f1915c1ac8a02b35,11,35,35,70,35,2014-01-22 22:00:06,2014-01-22 21:26:10
6bf05c0267b388bdf6f2bda6f1915c1ac8a02b35...c91e772b3a5bf45b690645001386339e7a268bd7,1,5,5,10,1,2014-01-23 14:05:09,2014-01-23 14:01:26
c91e772b3a5bf45b690645001386339e7a268bd7...e47b90e48f3532d312afcfaec55b2711b2129c02,2,24,2,26,5,2014-01-24 08:18:57,2014-01-20 16:28:16
e47b90e48f3532d312afcfaec55b2711b2129c02...6ea5f9e0de8851f4fdb840d41da73c284c53bfba,2,4,1,5,2,2014-01-24 13:14:41,2014-01-23 17:17:53
6ea5f9e0de8851f4fdb840d41da73c284c53bfba...e2e4de65551f152e20070bb42f1b4eb20feb0811,1,4,2,6,4,2014-01-24 14:05:49,2014-01-24 13:52:43
e2e4de65551f152e20070bb42f1b4eb20feb0811...a21fc1c08667dc319601b8195d0a7d3a4b8f2af5,1,11,6,17,4,2014-01-25 20:21:30,2014-01-14 12:41:52
a21fc1c08667dc319601b8195d0a7d3a4b8f2af5...a0a6112afc08c7471b70ee5e35170dfee3b488f3,1,1,1,2,1,2014-01-26 08:30:27,2014-01-26 08:30:10
a0a6112afc08c7471b70ee5e35170dfee3b488f3...db60a520857dfe1564d824809dacfffd55662a16,1,5,2,7,2,2014-01-26 14:36:55,2014-01-26 14:36:55
db60a520857dfe1564d824809dacfffd55662a16...319cfd209738c11ab2c81a5aa3a19e46a13761ef,1,86,31,117,35,2014-01-26 20:38:01,2014-01-26 20:13:35
319cfd209738c11ab2c81a5aa3a19e46a13761ef...38635977b7e8e3f103cbdb039cc71a0a6031bbf6,1,15,1,16,2,2014-01-26 20:40:44,2014-01-26 20:40:14
38635977b7e8e3f103cbdb039cc71a0a6031bbf6...6f8e655ca0b58c40d0ad42ba388daf0b410034a5,3,25,0,25,4,2014-01-26 22:49:01,2014-01-26 22:48:28
6f8e655ca0b58c40d0ad42ba388daf0b410034a5...05cef1939e523bdd80d3d3f7864c3b89a2cab303,1,1,1,2,1,2014-01-29 17:08:42,2014-01-29 16:54:02
05cef1939e523bdd80d3d3f7864c3b89a2cab303...0573120cb406066041b0235a3912dc38bc9f10ef,1,2,0,2,1,2014-01-29 23:04:19,2014-01-29 16:08:01
0573120cb406066041b0235a3912dc38bc9f10ef...5f42c0219550b62e62db6e0f3834671a994e3cd8,2,48,33,81,10,2014-01-29 23:26:42,2014-01-29 17:18:32
5f42c0219550b62e62db6e0f3834671a994e3cd8...0f272629ca18e440aef67b4a3fd9377a57fb25a8,3,15,8,23,9,2014-02-04 13:21:13,2013-11-17 13:50:14
0f272629ca18e440aef67b4a3fd9377a57fb25a8...fd3fa851b592700a8b04af46f626454db0db02e4,2,88,7,95,6,2014-02-04 17:06:37,2014-01-08 17:35:47
fd3fa851b592700a8b04af46f626454db0db02e4...8864d2478946506db22d2d2d37585f55536fb358,2,9,19,28,9,2014-02-05 20:32:17,2014-02-05 04:16:39
8864d2478946506db22d2d2d37585f55536fb358...a77ec255737eb87d5e876083651c9aaf950d6f46,1,4,0,4,1,2014-02-05 20:46:24,2014-02-05 20:46:02
a77ec255737eb87d5e876083651c9aaf950d6f46...5f03b06919997aaba4244034afafdf3b84a3e7d3,1,8,0,8,1,2014-02-06 00:30:30,2014-02-06 00:29:41
5f03b06919997aaba4244034afafdf3b84a3e7d3...c58a98cc34d471d743cd39e873e5b730a372d01b,1,23,18,41,12,2014-02-06 21:34:41,2014-02-06 21:34:22
c58a98cc34d471d743cd39e873e5b730a372d01b...687b3d96c40d745371c64bca7fe6d46a4e7e379c,1,1,1,2,1,2014-02-06 21:38:06,2014-02-06 21:38:06
687b3d96c40d745371c64bca7fe6d46a4e7e379c...63d69837463abb6b660da34be5d762f6b5c6fcea,1,1,1,2,1,2014-02-06 21:53:09,2014-02-06 21:53:09
63d69837463abb6b660da34be5d762f6b5c6fcea...dbb9819360bcec1094a3486cde36e3d80faa1168,2,17,4,21,5,2014-02-09 11:00:25,2014-02-09 10:50:09
dbb9819360bcec1094a3486cde36e3d80faa1168...e9ffe7e3c8e8fefa1f5675a30016740d6c812cca,1,10,0,10,1,2014-02-10 15:10:18,2014-02-10 15:05:01
e9ffe7e3c8e8fefa1f5675a30016740d6c812cca...76700c5437d4b5187f58a3f99104f45002d1524e,3,8,3,11,5,2014-02-10 15:12:22,2014-02-10 14:55:57
76700c5437d4b5187f58a3f99104f45002d1524e...d6db48e5f6320ec3d76419b67c6a3819f078be5c,2,35,2,37,5,2014-02-12 16:05:07,2014-02-12 15:07:23
d6db48e5f6320ec3d76419b67c6a3819f078be5c...32a880ae95fe19f0c6383571d4aab58f03044686,1,1,0,1,1,2014-02-13 13:03:43,2014-02-13 13:03:43
32a880ae95fe19f0c6383571d4aab58f03044686...9a446211bd13998aa6f0b6a3e6e6cdd1c69df704,2,9,2,11,3,2014-02-15 01:57:32,2013-12-06 01:14:57
9a446211bd13998aa6f0b6a3e6e6cdd1c69df704...a6f05af016b5488b42b9334ec915d6dfd2702c00,2,5,0,5,2,2014-02-15 02:06:08,2014-02-15 02:04:44
a6f05af016b5488b42b9334ec915d6dfd2702c00...14366ed33e4473c8c2f321f224dd62221adc7629,1,8,1,9,2,2014-02-15 18:30:13,2014-02-15 18:11:46
14366ed33e4473c8c2f321f224dd62221adc7629...a088ce90f2495d6da8678f60454ac427167de6bf,1,6,3,9,4,2014-02-18 14:32:41,2014-02-18 14:29:22
a088ce90f2495d6da8678f60454ac427167de6bf...e56ce87bd8cb85a14d34e7bdfac4b55fac95faea,1,1,1,2,1,2014-02-19 17:33:32,2014-02-19 17:29:47
e56ce87bd8cb85a14d34e7bdfac4b55fac95faea...12da6902e9cd8de2bc9eeef08c850a6c79aaa7cc,2,10,1,11,3,2014-02-20 22:59:51,2014-02-20 18:13:25
12da6902e9cd8de2bc9eeef08c850a6c79aaa7cc...23cbfc9a254eef6c06252dfd4f8f7b9b7456f8e2,1,3,0,3,1,2014-02-23 12:51:42,2014-02-23 12:21:09
23cbfc9a254eef6c06252dfd4f8f7b9b7456f8e2...a36513c2b41f50856144b8b66d5afc71e264b3cc,1,8,1,9,2,2014-02-23 12:52:14,2014-02-23 11:00:24
a36513c2b41f50856144b8b66d5afc71e264b3cc...79cc1fa58df17c3d9335a07086111bad8caa2d88,4,7,7,14,7,2014-02-23 12:52:45,2014-02-22 16:54:32
79cc1fa58df17c3d9335a07086111bad8caa2d88...882f2a5b811ad6b528556bef0e31a37710baff94,1,5,0,5,1,2014-02-23 12:54:17,2014-02-22 15:25:49
882f2a5b811ad6b528556bef0e31a37710baff94...98070b94a9bbb8e915e724c4d23933bd3b243b3c,1,11,0,11,1,2014-02-23 12:54:56,2014-02-22 14:18:51
98070b94a9bbb8e915e724c4d23933bd3b243b3c...4f6ff7ee85be1105b5ab78ac1bbe17a4c8c24d4e,2,11,3,14,4,2014-02-23 12:56:04,2014-02-22 12:39:33
4f6ff7ee85be1105b5ab78ac1bbe17a4c8c24d4e...39b099bdd26798566621f2c13957d587a3e3c387,1,2,2,4,3,2014-02-23 12:58:08,2014-02-21 14:07:54
39b099bdd26798566621f2c13957d587a3e3c387...3a5da7a11c009e46a50a8c4f432deb890151740a,1,4,1,5,1,2014-02-24 17:29:46,2014-02-24 17:26:29
3a5da7a11c009e46a50a8c4f432deb890151740a...985d0865a3cfb5850f926dfd9742fa7a9ca88bdc,1,4,0,4,1,2014-02-25 15:48:51,2014-02-22 17:06:39
985d0865a3cfb5850f926dfd9742fa7a9ca88bdc...dde67de0f656014821942ee8abe50f5187924288,1,3,0,3,1,2014-02-25 16:21:29,2014-02-22 12:07:50
dde67de0f656014821942ee8abe50f5187924288...f2b513c9e8416855a92e66928c2e22a8fc639273,1,10,12,22,2,2014-02-26 02:01:02,2014-02-25 15:44:46
f2b513c9e8416855a92e66928c2e22a8fc639273...5cda1d27027ea74d8a1b53e43bef697cd4426e9a,3,19,0,19,3,2014-03-01 01:49:13,2013-12-21 22:03:17
5cda1d27027ea74d8a1b53e43bef697cd4426e9a...4aaea2921d7c98dd98fc99596239f8863cb312cc,8,9,9,18,8,2014-03-02 16:21:10,2014-03-02 16:05:57
4aaea2921d7c98dd98fc99596239f8863cb312cc...e7649789eddeb2ce8f3bf8f69ddc624006d0a46c,1,6,1,7,1,2014-03-03 15:42:32,2014-03-03 15:40:06
e7649789eddeb2ce8f3bf8f69ddc624006d0a46c...8e704b176f30c9c208a45125d8f36319cf1aafa8,1,11,3,14,3,2014-03-03 16:19:03,2014-02-23 12:55:25
8e704b176f30c9c208a45125d8f36319cf1aafa8...f582b61f1c5a0fad85d3a7022e480acb9d597d4a,1,3,3,6,2,2014-03-11 12:10:40,2014-03-11 12:09:44
f582b61f1c5a0fad85d3a7022e480acb9d597d4a...141bb90b4c66cca1c4bfafe2a0e5c5777c55c61c,1,1,1,2,1,2014-03-13 13:14:40,2014-03-13 13:08:11
141bb90b4c66cca1c4bfafe2a0e5c5777c55c61c...1a2939bc26b7077e3196cea9bce52826ec7a6d9d,3,21,1,22,4,2014-03-13 15:59:23,2014-03-13 15:55:38
1a2939bc26b7077e3196cea9bce52826ec7a6d9d...9f7bd831846a921e233c1f95d725235db9550438,1,8,0,8,1,2014-03-16 14:47:08,2014-03-15 19:18:05
9f7bd831846a921e233c1f95d725235db9550438...a01daaf2319ecb2361cc3ecbe872c4fb7fc4817f,2,18,2,20,3,2014-03-19 11:23:41,2014-03-18 17:02:42
a01daaf2319ecb2361cc3ecbe872c4fb7fc4817f...0726482c9d77195946a67bad533a5a95a4a1086b,1,2,2,4,2,2014-03-21 15:25:18,2014-03-21 15:23:59
0726482c9d77195946a67bad533a5a95a4a1086b...c8c2d60614c614174ef30f5bc69601264713a8ef,2,4,1,5,2,2014-03-21 21:11:50,2014-03-21 21:09:57
c8c2d60614c614174ef30f5bc69601264713a8ef...d1503afd66ca8f2f8d3819ba8a60727e0ee66cec,4,53,11,64,10,2014-03-22 10:07:27,2014-03-20 15:50:50
d1503afd66ca8f2f8d3819ba8a60727e0ee66cec...5f7b3e56cea045d177589c673c682c69bd6ed709,1,3,0,3,1,2014-03-22 11:37:06,2014-03-22 11:25:26
5f7b3e56cea045d177589c673c682c69bd6ed709...f05f5c231a916082b5fa2e0980fbf7abeb390032,1,3,1,4,3,2014-03-22 13:21:35,2014-03-22 13:21:31
f05f5c231a916082b5fa2e0980fbf7abeb390032...c9b2feffeed46765ed6c4b74066059e2a6541735,1,8,4,12,4,2014-03-22 14:05:28,2014-03-22 13:41:45
c9b2feffeed46765ed6c4b74066059e2a6541735...d908b67e81ee3f5413c7581522605a2d0bf836ff,1,1,1,2,1,2014-03-23 20:20:43,2014-03-23 20:17:52
d908b67e81ee3f5413c7581522605a2d0bf836ff...779ef57c37583488eed737b978f76929148dc663,4,30,13,43,9,2014-03-24 11:34:22,2014-03-24 11:33:04
779ef57c37583488eed737b978f76929148dc663...7af32bca38f01dc5b677a4161bf0853149f97b3e,1,2,1,3,1,2014-03-24 13:09:23,2014-03-24 13:06:57
7af32bca38f01dc5b677a4161bf0853149f97b3e...90916e1708f879675ad3b0c999aaa54478af719b,1,10,10,20,7,2014-03-24 13:19:50,2014-03-24 13:15:32
90916e1708f879675ad3b0c999aaa54478af719b...38096da5c0db7e7a3bb5b6e977f8e17adbf389ac,2,20,4,24,2,2014-03-24 13:45:56,2014-02-22 19:29:55
38096da5c0db7e7a3bb5b6e977f8e17adbf389ac...c0a9c2f72ac289b2ba8313c6a2c56be5ed94f01d,3,13,26,39,5,2014-03-25 18:10:29,2014-03-25 14:17:23
c0a9c2f72ac289b2ba8313c6a2c56be5ed94f01d...fe83cfe9eddae67838d453fa247bd47e1b3bf277,2,14,5,19,2,2014-03-27 11:02:06,2014-03-25 21:06:54
fe83cfe9eddae67838d453fa247bd47e1b3bf277...f659c8e13aa5691f7460131c84b283ed4fe990bf,2,5,7,12,4,2014-03-27 12:14:39,2014-03-26 14:55:59
f659c8e13aa5691f7460131c84b283ed4fe990bf...31892af3f03fa75dd59a2f70beebb29993098778,2,10,1,11,2,2014-03-29 06:29:38,2014-03-29 05:58:25
31892af3f03fa75dd59a2f70beebb29993098778...30ba506e978b31e16676b8da7b5e6cd8b4c4d8d4,1,11,13,24,5,2014-03-29 14:23:28,2014-03-29 14:17:19
30ba506e978b31e16676b8da7b5e6cd8b4c4d8d4...059bc7eb60a43de3679e5a0320f631a30d8e4e13,1,1,1,2,1,2014-03-30 18:27:11,2014-03-30 18:25:06
059bc7eb60a43de3679e5a0320f631a30d8e4e13...c0882fefcaca82e25318397bf85ae43dfed90775,1,1,1,2,1,2014-03-30 23:37:02,2014-03-30 23:30:07
c0882fefcaca82e25318397bf85ae43dfed90775...916f0de74ba00f65cc789c075ce94f7fba858976,1,3,0,3,1,2014-03-31 11:12:16,2014-03-31 11:10:25
916f0de74ba00f65cc789c075ce94f7fba858976...a5297c1ef4c4c010d1eb979177d4633beb5f9cad,3,40,7,47,10,2014-03-31 11:29:08,2014-03-28 14:42:58
a5297c1ef4c4c010d1eb979177d4633beb5f9cad...f0d03d41be380b973c154507baae1ff498de2dbd,4,4,15,19,8,2014-03-31 11:55:33,2014-03-31 11:54:22
f0d03d41be380b973c154507baae1ff498de2dbd...07e2a5681435e493be93dceac611c3870ae6b1c6,1,119,22,141,19,2014-03-31 12:24:12,2014-03-31 09:54:17
07e2a5681435e493be93dceac611c3870ae6b1c6...73474df9541bd5fabbf419debc5d72c09619f625,3,20,2,22,5,2014-04-01 18:45:12,2014-03-22 15:52:05
73474df9541bd5fabbf419debc5d72c09619f625...bd5965ce68c347971dd7b706e3c9b636105b75d1,1,11,0,11,1,2014-04-02 20:18:56,2014-04-02 20:11:49
bd5965ce68c347971dd7b706e3c9b636105b75d1...1cce00a7620f1882b3b1999e799eb1d3cc65c1ca,2,8,4,12,2,2014-04-03 12:28:02,2014-04-02 06:14:47
1cce00a7620f1882b3b1999e799eb1d3cc65c1ca...23526d2f483a893414884a154a10c0c43bcd0689,3,94,6,100,3,2014-04-08 15:29:02,2014-03-19 18:38:12
23526d2f483a893414884a154a10c0c43bcd0689...32529e6432dfca3ace93d129cdb22fcebc3a2730,1,1,1,2,1,2014-04-09 11:13:45,2014-04-09 03:58:40
32529e6432dfca3ace93d129cdb22fcebc3a2730...6fa7d7c594597ab7072ffa740da5b6f4a5a6cd26,5,40,4,44,7,2014-04-09 20:54:39,2014-04-09 20:41:33
6fa7d7c594597ab7072ffa740da5b6f4a5a6cd26...690a5984a3c0a706b8cc296bdcccd524b2079559,5,73,2,75,7,2014-04-09 23:15:14,2014-03-30 17:03:35
690a5984a3c0a706b8cc296bdcccd524b2079559...d5cef2a19c5a70766693264d08605f56d26e573d,2,8,8,16,4,2014-04-10 00:44:45,2014-04-10 00:40:33
d5cef2a19c5a70766693264d08605f56d26e573d...e68c084ed17d185f19658e1d7fe8c7047d59aea6,1,3,4,7,3,2014-04-10 05:51:04,2014-04-10 05:51:04
e68c084ed17d185f19658e1d7fe8c7047d59aea6...728fd27c005e98868a3be74949f306038e30e427,1,5,3,8,1,2014-04-10 10:19:15,2014-04-10 05:19:55
728fd27c005e98868a3be74949f306038e30e427...129cb7e2228cf076104eb5de69e6063f1bf34dd9,2,5,1,6,3,2014-04-10 17:16:08,2014-03-31 20:35:45
129cb7e2228cf076104eb5de69e6063f1bf34dd9...de95867284ddf84bb4ca5e5946bae96d5d23babf,1,3,1,4,1,2014-04-10 17:33:34,2014-04-10 17:31:59
de95867284ddf84bb4ca5e5946bae96d5d23babf...9afedbef4207a86d17d9525664bcd06f403cc6f9,2,54,3,57,3,2014-04-10 21:05:09,2014-03-23 19:45:22
9afedbef4207a86d17d9525664bcd06f403cc6f9...746cded010c7ba3e2bf2df4cde32dcc9b75cb0d3,4,14,10,24,5,2014-04-10 21:21:55,2014-03-23 22:09:26
746cded010c7ba3e2bf2df4cde32dcc9b75cb0d3...4ea02bdb0dc6776fc29d8164e417469c9ba10f18,4,37,29,66,12,2014-04-10 21:22:13,2014-03-23 20:45:31
4ea02bdb0dc6776fc29d8164e417469c9ba10f18...1d3d2b9a2458cbf11b7e828fb59b3f2cb73d14fe,2,13,10,23,4,2014-04-10 21:22:13,2014-03-23 22:34:14
1d3d2b9a2458cbf11b7e828fb59b3f2cb73d14fe...80f6cbbadbd33574c8b949a8fbc77a5e94398e54,1,8,2,10,2,2014-04-10 21:22:13,2014-04-10 19:14:50
80f6cbbadbd33574c8b949a8fbc77a5e94398e54...d501c79f7b1635a01af13e094da47ac19c4365be,1,1,1,2,1,2014-04-10 23:34:25,2014-04-10 23:32:20
d501c79f7b1635a01af13e094da47ac19c4365be...a3570798929337baeba237c7e7eec35d9f2c18c4,1,4,4,8,2,2014-04-11 21:03:54,2014-04-11 21:01:00
a3570798929337baeba237c7e7eec35d9f2c18c4...1252b77824639fba398cf70586bdd75c42f86fdf,4,25,1,26,6,2014-04-12 18:06:03,2014-04-12 01:27:34
1252b77824639fba398cf70586bdd75c42f86fdf...724ccd2ec15af78263adfc970ec9fb1f0597002b,1,4,6,10,6,2014-04-15 21:45:52,2014-04-15 21:43:29
724ccd2ec15af78263adfc970ec9fb1f0597002b...a476b15aa594f9b63d2ff32c65783f50dc47c63e,2,8,5,13,4,2014-04-16 11:30:50,2014-04-16 11:22:15
a476b15aa594f9b63d2ff32c65783f50dc47c63e...9510e96da647a5cc2ba6bab381f0df86a3a7db8b,1,10,0,10,1,2014-04-16 11:49:38,2014-04-16 11:47:56
9510e96da647a5cc2ba6bab381f0df86a3a7db8b...20dbbc5fa25bb4dd8d583ab16c7fc761b3e27ec3,2,2,2,4,2,2014-04-16 12:38:04,2014-04-16 12:35:17
20dbbc5fa25bb4dd8d583ab16c7fc761b3e27ec3...82803611eb1ca2ec8f4ea8569d4bf4abbd91cdb2,1,1,1,2,1,2014-04-16 13:42:02,2014-04-16 13:19:55
82803611eb1ca2ec8f4ea8569d4bf4abbd91cdb2...e0930608230fc7e1f1a68d51296661200857658a,1,28,10,38,4,2014-04-17 00:31:09,2014-04-14 17:09:17
e0930608230fc7e1f1a68d51296661200857658a...fa60ac76c032aae884c3c277e89cb323a463994c,1,1,1,2,1,2014-04-18 00:47:54,2014-04-18 00:47:54
fa60ac76c032aae884c3c277e89cb323a463994c...8e5ce99d83fe51c228f68212603abcf2d1af9ef2,1,1,1,2,1,2014-04-18 13:14:31,2014-04-18 13:14:31
8e5ce99d83fe51c228f68212603abcf2d1af9ef2...9e28bfb3240b6fc11384139616a9024db835ccda,1,10,0,10,1,2014-04-18 14:32:53,2014-04-18 14:32:14
9e28bfb3240b6fc11384139616a9024db835ccda...839deb7a77a2321309da944031b7316322a0afbb,1,3,0,3,1,2014-04-18 19:03:30,2014-04-18 19:00:26
839deb7a77a2321309da944031b7316322a0afbb...b6863879e1cf20acdecb3606da8fe66b486836cf,1,9,0,9,1,2014-04-18 19:11:14,2014-04-18 16:41:29
b6863879e1cf20acdecb3606da8fe66b486836cf...1b43131b5d65060a7e067fbf6167517c559d2807,2,41,49,90,7,2014-04-18 20:11:10,2014-04-18 20:06:26
1b43131b5d65060a7e067fbf6167517c559d2807...25adac9b42e65caa5d2d42b6322e59ffb48df775,1,1,1,2,1,2014-04-21 17:20:51,2014-04-21 14:48:33
25adac9b42e65caa5d2d42b6322e59ffb48df775...4352a50871e239ebcdf64eee6f0b88e714015c1b,5,50,2,52,13,2014-04-21 22:30:27,2014-04-20 17:31:53
4352a50871e239ebcdf64eee6f0b88e714015c1b...d63e20942f3024f24cb8cd85a49461ba8a9b6736,2,37,1,38,7,2014-04-21 22:30:27,2014-04-20 20:27:33
d63e20942f3024f24cb8cd85a49461ba8a9b6736...5f0829a27e85d89ad8c433f5c6a7a7d17c9e9292,6,157,2,159,10,2014-04-21 22:30:27,2014-04-20 20:28:01
5f0829a27e85d89ad8c433f5c6a7a7d17c9e9292...d63bfb14dd1a35672fff18cd41f386330e109f8e,3,316,9,325,7,2014-04-21 22:30:27,2014-04-21 10:46:00
d63bfb14dd1a35672fff18cd41f386330e109f8e...3f1abbfc4097e1b9bace016258d8870f14ba8557,2,18,1,19,2,2014-04-21 23:10:57,2014-04-21 23:10:57
3f1abbfc4097e1b9bace016258d8870f14ba8557...7bb9bebe4764625e64b2a5725e47b45501f0537d,1,34,0,34,1,2014-04-21 23:29:05,2014-04-21 23:29:05
7bb9bebe4764625e64b2a5725e47b45501f0537d...6ec346ba7b251a9bcebcd467dde72463197ad210,2,25,0,25,2,2014-04-22 08:48:11,2014-04-15 15:52:30
6ec346ba7b251a9bcebcd467dde72463197ad210...a937687633e86f547c95ba8d21228ff220b5385c,1,1,1,2,1,2014-04-22 15:49:21,2014-04-22 15:49:00
a937687633e86f547c95ba8d21228ff220b5385c...362ce5e936842bc3b3ea0aec15074e3752fe0ce5,2,15,0,15,2,2014-04-22 15:49:29,2014-04-22 15:44:03
362ce5e936842bc3b3ea0aec15074e3752fe0ce5...49f5a2949311c6aaaac0005c4f6ab79cf96ee09d,1,2,2,4,2,2014-04-22 22:29:07,2014-04-22 20:54:14
49f5a2949311c6aaaac0005c4f6ab79cf96ee09d...c5306d4af1e9430d2397e8d83b37fa3598a17e83,15,16,16,32,17,2014-04-23 00:13:43,2014-04-22 23:05:14
c5306d4af1e9430d2397e8d83b37fa3598a17e83...6915220ff9d6eeb2a669421d06bce9403ed6480c,7,54,1,55,11,2014-04-23 12:56:13,2014-04-23 12:49:12
6915220ff9d6eeb2a669421d06bce9403ed6480c...274bedb9285241636a4f989b8867a8bcd72c1bad,1,0,1,1,1,2014-04-23 13:14:52,2014-04-23 13:14:52
274bedb9285241636a4f989b8867a8bcd72c1bad...a742cf17113ab85fc94f4865a7506aeaf7766798,3,18,18,36,18,2014-04-24 09:52:36,2014-04-24 09:36:25
a742cf17113ab85fc94f4865a7506aeaf7766798...d16948bd19737a60811eeaae77b8eb282de8bdb3,3,18,2,20,3,2014-04-25 12:36:28,2014-04-25 12:20:25
d16948bd19737a60811eeaae77b8eb282de8bdb3...42659ceb3f635b9eb640c0c7168e02fc71fabd05,1,4,0,4,1,2014-04-25 13:36:56,2014-04-25 12:55:32
42659ceb3f635b9eb640c0c7168e02fc71fabd05...2b0e9aa57d4c5b5dbad7d300b4e383d384941034,3,16,0,16,3,2014-04-25 13:56:39,2014-04-24 18:10:03
2b0e9aa57d4c5b5dbad7d300b4e383d384941034...e9c78435ab9cfd27d0815c244c9a1feb08cc18d1,1,5,5,10,1,2014-04-25 14:29:24,2014-04-25 14:27:13
e9c78435ab9cfd27d0815c244c9a1feb08cc18d1...b4b63b3832896d00bd9bd9e15c00cb7f1f9ac3ad,1,5,4,9,3,2014-04-25 21:16:59,2014-04-25 21:13:58
b4b63b3832896d00bd9bd9e15c00cb7f1f9ac3ad...4a6b911fcfe9f23c7b84da08842e27b53f0becd9,1,1,1,2,1,2014-04-28 20:39:08,2014-04-28 20:39:08
4a6b911fcfe9f23c7b84da08842e27b53f0becd9...6265885c1e72891fc3256eff5ee93f95d41cadba,1,1,1,2,1,2014-04-28 22:59:49,2014-04-28 22:59:49
6265885c1e72891fc3256eff5ee93f95d41cadba...6574e6c1833ea15b4d5afd585735d2fa5ea18ae0,3,3,3,6,3,2014-04-28 23:07:07,2014-04-28 23:06:25
6574e6c1833ea15b4d5afd585735d2fa5ea18ae0...2997a2007222c48453d89b18c65e4f865d2b22a2,2,13,0,13,2,2014-04-29 00:38:34,2014-04-29 00:38:06
2997a2007222c48453d89b18c65e4f865d2b22a2...f6e9127483fe09601ed176d0e56bb77bd5cf9b8c,1,3,1,4,1,2014-04-29 06:34:21,2014-04-29 06:32:10
f6e9127483fe09601ed176d0e56bb77bd5cf9b8c...2a0f942cbd779e351100086a6183f648b1e4aa14,1,2,1,3,1,2014-04-30 22:02:06,2014-04-30 17:43:36
2a0f942cbd779e351100086a6183f648b1e4aa14...c1692fa25a6954616cb86c2166ae6bc9759c5341,1,15,7,22,4,2014-04-30 22:26:04,2014-04-30 22:26:04
c1692fa25a6954616cb86c2166ae6bc9759c5341...120a981207aacb7453c0e064ec5b3d011ec68345,2,3,2,5,2,2014-05-01 16:15:00,2014-05-01 16:10:16
120a981207aacb7453c0e064ec5b3d011ec68345...b97b24882c7c3363d6972fe1f3a5573738cf9d5a,1,1,1,2,1,2014-05-02 06:29:59,2014-05-01 17:28:07
b97b24882c7c3363d6972fe1f3a5573738cf9d5a...034866204b39f797c73997b03cd90443aa03aa91,3,20,4,24,4,2014-05-02 17:38:46,2014-05-02 17:31:22
034866204b39f797c73997b03cd90443aa03aa91...0e3704963693ddfaaa525054c42333f6ffdb4b47,4,54,10,64,15,2014-05-05 10:27:54,2014-04-28 12:27:36
0e3704963693ddfaaa525054c42333f6ffdb4b47...cddbaca6976a1e6faba8e846b87e27b35e268198,1,1,1,2,1,2014-05-05 10:42:32,2014-05-05 10:41:01
cddbaca6976a1e6faba8e846b87e27b35e268198...5783088eecddd935be3c641437748040669f91c0,2,9,1,10,4,2014-05-05 11:39:08,2014-05-05 11:36:53
5783088eecddd935be3c641437748040669f91c0...f939e25b593f2dac7f3ade86c2c4edb3b03fe51f,1,1,1,2,1,2014-05-06 16:13:55,2014-05-06 16:13:55
f939e25b593f2dac7f3ade86c2c4edb3b03fe51f...dd9cedf16abbee2893c55135323c54f64a150880,1,1,2,3,1,2014-05-06 18:40:59,2014-05-06 18:40:59
dd9cedf16abbee2893c55135323c54f64a150880...b6d3212190b114f1ef90d7ee9edcdae046432779,2,13,0,13,2,2014-05-10 15:05:09,2014-05-10 14:39:20
b6d3212190b114f1ef90d7ee9edcdae046432779...8ebf38b7a4ad4b0ca2dfec965d3eac6f8df25016,1,1,1,2,1,2014-05-11 02:22:51,2014-05-11 02:22:51
8ebf38b7a4ad4b0ca2dfec965d3eac6f8df25016...129c446e86f9a5832df54a432503ba510a6b3e0f,1,1,1,2,1,2014-05-11 20:18:21,2014-05-07 19:16:43
129c446e86f9a5832df54a432503ba510a6b3e0f...42f8029b366054cbcbc88a4f1a32e424e1938faf,1,1,0,1,1,2014-05-12 11:01:23,2014-05-12 10:59:23
42f8029b366054cbcbc88a4f1a32e424e1938faf...b718e292ac7d2e6ea9764aa618f913ead8b8bbb1,1,4,0,4,1,2014-05-12 16:44:48,2014-05-12 16:43:50
b718e292ac7d2e6ea9764aa618f913ead8b8bbb1...c530a63429c7ebf92c29c76e1926d441fa0295d0,1,1,1,2,1,2014-05-12 22:58:14,2014-05-12 22:56:34
c530a63429c7ebf92c29c76e1926d441fa0295d0...bff0eb3b24f94831832f89913a4bcc8c3ee94d80,1,1,1,2,1,2014-05-13 11:28:46,2014-05-13 04:18:01
bff0eb3b24f94831832f89913a4bcc8c3ee94d80...e05a6222cd409bbfd9fd060a3913a956014dc4ab,2,3,4,7,2,2014-05-14 00:55:05,2014-05-14 00:52:38
e05a6222cd409bbfd9fd060a3913a956014dc4ab...1abcf3a808b35abae5d425ed4d44cb6e886dc769,4,1,103,104,4,2014-05-14 08:15:06,2014-05-12 13:37:44
1abcf3a808b35abae5d425ed4d44cb6e886dc769...601107524523bca02376a0ddc1a06c6fdb8f22f3,3,49,4,53,9,2014-05-14 08:15:06,2014-05-12 13:38:05
601107524523bca02376a0ddc1a06c6fdb8f22f3...b053eb929b7d8ea191a2b0c13959bbf50cc68f1e,4,137,2,139,6,2014-05-14 16:36:44,2014-05-14 16:07:32
b053eb929b7d8ea191a2b0c13959bbf50cc68f1e...b5bacdea00c8ca980ff5885e15f7cd7b26b4dbb9,1,1,1,2,1,2014-05-14 16:37:33,2014-05-14 16:37:33
b5bacdea00c8ca980ff5885e15f7cd7b26b4dbb9...9dc7f69a4b91f98011396489a6b352c6af47a901,1,1,1,2,1,2014-05-14 16:42:26,2014-05-14 16:42:26
9dc7f69a4b91f98011396489a6b352c6af47a901...d41a00101192fcedab9f8207428f9d207e0bc72e,3,24,23,47,25,2014-05-15 11:17:02,2014-05-15 11:11:29
d41a00101192fcedab9f8207428f9d207e0bc72e...4b49cbfae47f279e1a3f33f4143ff416ddf68e3d,1,1,1,2,1,2014-05-16 09:35:43,2014-05-16 09:07:43
4b49cbfae47f279e1a3f33f4143ff416ddf68e3d...50a289d05fba760716287d582c7ea19edd1159cc,2,4,2,6,4,2014-05-16 13:40:52,2014-05-16 13:40:52
50a289d05fba760716287d582c7ea19edd1159cc...1a3371d1e41dba8d49246e6fab1bdf5b2b236d1c,1,2,0,2,1,2014-05-16 15:21:05,2014-05-16 15:01:17
1a3371d1e41dba8d49246e6fab1bdf5b2b236d1c...20215f4cae4f69f2bcbc4bbdbcd84651bee64634,1,9,5,14,2,2014-05-16 16:29:25,2014-05-16 15:52:59
20215f4cae4f69f2bcbc4bbdbcd84651bee64634...ba40d6509aac626763e534f555d50be895b53e75,1,1,1,2,1,2014-05-16 21:43:10,2014-04-05 14:26:11
ba40d6509aac626763e534f555d50be895b53e75...ee075c448461350aeb9bc4829a8581619c95224d,2,14,0,14,2,2014-05-16 22:19:49,2014-05-16 22:19:23
ee075c448461350aeb9bc4829a8581619c95224d...91e03e81bbfee069dc7a4b6e23d4ac30731c65d0,1,16,18,34,8,2014-05-17 13:14:53,2014-05-17 13:14:53
91e03e81bbfee069dc7a4b6e23d4ac30731c65d0...f3b082901774463319fbb6e918b0d846289620bf,1,14,4,18,2,2014-05-17 13:46:29,2014-05-17 10:05:29
f3b082901774463319fbb6e918b0d846289620bf...26221445df5855d189b2dc4dd76ff0a9f0bd77d0,1,8,5,13,3,2014-05-19 11:46:32,2014-05-19 07:33:12
26221445df5855d189b2dc4dd76ff0a9f0bd77d0...6a2f8985c13e5524d397b48951d6de982544a71a,1,3,3,6,3,2014-05-19 13:50:50,2014-05-19 13:02:42
6a2f8985c13e5524d397b48951d6de982544a71a...475b3791a348002f99f9553e9baed67b75994701,1,1,1,2,1,2014-05-22 07:48:36,2014-05-22 07:46:34
475b3791a348002f99f9553e9baed67b75994701...082920d8277719b799056b92f63420f051304ae7,1,8,5,13,1,2014-05-28 00:11:56,2014-05-27 18:53:19
082920d8277719b799056b92f63420f051304ae7...c9a4c1d80bd6118fdf028965a750cdaad0550b76,1,2,2,4,1,2014-05-28 08:15:56,2014-05-28 08:15:56
c9a4c1d80bd6118fdf028965a750cdaad0550b76...3252e0654e8f3336e49373084a229e6499942c6c,2,2,2,4,2,2014-05-29 22:59:22,2014-05-29 22:58:12
3252e0654e8f3336e49373084a229e6499942c6c...4c358df66a1c808dce09c9da634bb50969d18c37,1,6,0,6,1,2014-05-30 12:05:48,2014-05-29 06:53:25
4c358df66a1c808dce09c9da634bb50969d18c37...3a736c1836f65649f931c1a72e2d7bb33e52b361,1,1,0,1,1,2014-06-01 02:08:38,2013-07-09 17:44:57
3a736c1836f65649f931c1a72e2d7bb33e52b361...9334150ca4d60026be4e36e3599bb1e23ccbae7b,1,3,1,4,2,2014-06-02 22:53:00,2014-06-02 20:19:12
9334150ca4d60026be4e36e3599bb1e23ccbae7b...734e9ad2320682c1817f2a70b37880c0b208b398,1,1,1,2,1,2014-06-03 11:44:45,2014-06-03 03:38:05
734e9ad2320682c1817f2a70b37880c0b208b398...08bd249fa2ac938d35b93b2686c0c439ca160127,1,4,3,7,1,2014-06-04 16:45:27,2014-06-04 13:58:28
08bd249fa2ac938d35b93b2686c0c439ca160127...f5b6b25c5f9acbb336d87d1ef87722caca5c1d3e,1,8,6,14,3,2014-06-05 19:14:30,2014-06-05 18:54:28
f5b6b25c5f9acbb336d87d1ef87722caca5c1d3e...ab2a2f669563cea542a721fcbc907bb7c93d6e1f,2,11,9,20,3,2014-06-07 11:27:13,2014-06-07 00:31:23
ab2a2f669563cea542a721fcbc907bb7c93d6e1f...fcd2e06ae5110fe6327128e8d170302c20077988,6,9,9,18,7,2014-06-10 19:41:25,2014-06-10 19:16:31
fcd2e06ae5110fe6327128e8d170302c20077988...631d0bb2da28eee753c562d3a07f248495118823,2,2,2,4,2,2014-06-12 06:58:29,2014-06-12 06:53:36
631d0bb2da28eee753c562d3a07f248495118823...15fe4ab671bd24ebd73e3b997b63d8e122c03073,1,4,1,5,1,2014-06-12 14:53:32,2014-06-12 14:19:03
15fe4ab671bd24ebd73e3b997b63d8e122c03073...26983c4c6414f00a2bcf364436ecce0f5e73851d,2,14,1,15,3,2014-06-12 20:42:44,2014-06-12 17:43:30
26983c4c6414f00a2bcf364436ecce0f5e73851d...b0e5a527dbd2f242fa59fa8f40b7f2de4d55d57a,1,1,1,2,1,2014-06-15 19:11:36,2014-06-15 10:44:33
b0e5a527dbd2f242fa59fa8f40b7f2de4d55d57a...6b52e1793c682d4f9c8f030dcbe6908ddddf875e,1,13,0,13,1,2014-06-18 16:39:36,2014-06-16 19:30:26
6b52e1793c682d4f9c8f030dcbe6908ddddf875e...d4a3fd44f04fd06252ccfdd001772daa35c510d1,1,1,2,3,2,2014-06-18 18:37:24,2014-06-18 18:35:38
d4a3fd44f04fd06252ccfdd001772daa35c510d1...ef3ae3d1c94ac1d4ffaeeeec1ee544e91431e65b,4,38,3,41,7,2014-06-20 23:01:49,2014-05-19 16:19:35
ef3ae3d1c94ac1d4ffaeeeec1ee544e91431e65b...c38e47bec02d67fe9497fb384fafb5f2806cff0b,3,4,3,7,4,2014-06-23 12:59:39,2014-06-23 12:51:53
c38e47bec02d67fe9497fb384fafb5f2806cff0b...e4670d988aa66f3c81d5abf40dbb3f326ef5a830,1,1,1,2,1,2014-06-24 20:13:29,2014-06-24 18:16:53
e4670d988aa66f3c81d5abf40dbb3f326ef5a830...20a1c07ea1f1718ceb35b526f41c5c37b32082f8,2,38,18,56,10,2014-06-25 01:42:36,2014-06-11 20:41:25
20a1c07ea1f1718ceb35b526f41c5c37b32082f8...25d04ebe545c556d34a0333b8c30367cdc6ad84f,1,3,3,6,3,2014-06-26 11:32:02,2014-06-25 22:43:48
25d04ebe545c556d34a0333b8c30367cdc6ad84f...044d419c212478ba42c9f5887ba224414503b9c1,1,2,0,2,1,2014-06-27 13:52:35,2014-06-27 13:50:29
044d419c212478ba42c9f5887ba224414503b9c1...90b4d205662c4859a94e0456f22123e7bdf463f4,2,2,2,4,2,2014-06-30 18:09:57,2014-06-30 18:09:57
90b4d205662c4859a94e0456f22123e7bdf463f4...6d0acc344fe8105c32aaf892d84ae7e200d90cfa,1,20,16,36,11,2014-06-30 18:32:59,2014-06-26 10:56:45
6d0acc344fe8105c32aaf892d84ae7e200d90cfa...6b00b478d204e84637f87fc601203c306002ca52,1,0,8,8,1,2014-06-30 19:24:13,2014-06-30 18:35:09
6b00b478d204e84637f87fc601203c306002ca52...735ece0b89b400b95c5e38ae640a7c3fe860c377,1,12,4,16,3,2014-06-30 21:53:54,2014-06-30 21:48:14
735ece0b89b400b95c5e38ae640a7c3fe860c377...6883602021bb9ad681bfc5f01fcc08163add60e0,1,3,4,7,1,2014-07-01 19:57:31,2014-07-01 19:54:28
6883602021bb9ad681bfc5f01fcc08163add60e0...e125984394eaca8be82ed6f1ad10075ecd13e806,1,7,0,7,1,2014-07-01 21:34:24,2014-07-01 21:32:14
e125984394eaca8be82ed6f1ad10075ecd13e806...f3cd0a009ec0ed4e705ee25c5fcf60f4c2ba02f8,1,3,2,5,1,2014-07-02 14:14:17,2014-07-02 14:12:43
f3cd0a009ec0ed4e705ee25c5fcf60f4c2ba02f8...9207442fe220dfc89dd7529fd7db93c30e26812d,3,3,3,6,3,2014-07-02 16:29:16,2014-07-02 16:28:12
9207442fe220dfc89dd7529fd7db93c30e26812d...890a2d632e173edfd2b70854b72dfbd0e1a2d92b,1,5,0,5,1,2014-07-03 13:38:59,2014-07-03 13:20:03
890a2d632e173edfd2b70854b72dfbd0e1a2d92b...b6bfdacdae3241241eacc588354dac153a87b8e3,5,9,9,18,6,2014-07-06 00:27:03,2014-07-05 18:28:30
b6bfdacdae3241241eacc588354dac153a87b8e3...85f9745807ea0042225aaf4472fb63a00f3e2bcc,1,3,0,3,1,2014-07-07 19:31:47,2014-07-07 19:29:01
85f9745807ea0042225aaf4472fb63a00f3e2bcc...837cad0f6242f5292b8a4811fc48fbfbefe92a47,1,4,0,4,1,2014-07-07 22:09:22,2014-07-07 22:04:00
837cad0f6242f5292b8a4811fc48fbfbefe92a47...d8f7e00708dec84237954cde17a27e1afb657438,1,0,7,7,2,2014-07-08 12:57:47,2014-07-08 12:56:41
d8f7e00708dec84237954cde17a27e1afb657438...f3bdb83ba58a696c0696d8a6706d2c44a00da68a,1,0,7,7,1,2014-07-09 18:12:52,2014-07-09 17:54:41
f3bdb83ba58a696c0696d8a6706d2c44a00da68a...a823a749754dfd16069857aa5a0429a6413398b8,1,1,1,2,1,2014-07-10 10:09:47,2014-07-10 10:09:08
a823a749754dfd16069857aa5a0429a6413398b8...685582940bf4dfb5caf09bd8a73e6f74745190a8,3,49,2,51,4,2014-07-14 15:39:19,2014-07-08 19:58:14
685582940bf4dfb5caf09bd8a73e6f74745190a8...609153d2bf4ac313e5d9542c9efd93078eeddecc,1,5,0,5,1,2014-07-15 01:45:41,2014-07-15 01:45:41
609153d2bf4ac313e5d9542c9efd93078eeddecc...227a0f27a6927febc054cd90d17200203402c50d,3,41,4,45,6,2014-07-16 09:53:48,2014-07-14 16:42:14
227a0f27a6927febc054cd90d17200203402c50d...9be56ec62c23e45e5fa085b59579187e5bd4be61,1,1,1,2,1,2014-07-16 09:53:52,2014-07-16 09:48:49
9be56ec62c23e45e5fa085b59579187e5bd4be61...04d827a7103f6e88e204ca0b6412a4a0443e8617,1,15,7,22,6,2014-07-16 15:01:53,2014-07-16 15:01:53
04d827a7103f6e88e204ca0b6412a4a0443e8617...21853c1b908f777de354b1371c17422f10032c70,1,3,1,4,1,2014-07-16 16:35:04,2014-07-16 16:32:57
21853c1b908f777de354b1371c17422f10032c70...24e97add3101258f0af363ecba9d14dd2ca51478,1,1,1,2,1,2014-07-16 17:23:59,2014-07-16 16:08:24
24e97add3101258f0af363ecba9d14dd2ca51478...ca44366b15e65453b2ea3f405754af93d0220694,1,3,0,3,1,2014-07-16 17:36:19,2014-07-16 17:34:53
ca44366b15e65453b2ea3f405754af93d0220694...205090bc7173eff649dd7ef69805f9a760534b01,6,10,10,20,8,2014-07-21 19:55:28,2014-07-21 17:55:37
205090bc7173eff649dd7ef69805f9a760534b01...290e389fe9f8321babc2dfa55fcb7ac4ceb9524b,1,1,1,2,1,2014-07-22 17:28:02,2014-07-22 05:47:57
290e389fe9f8321babc2dfa55fcb7ac4ceb9524b...83098dccdf3172302cde54e11c36050c1d83f996,7,26,10,36,11,2014-07-24 23:27:15,2014-03-21 17:48:57
83098dccdf3172302cde54e11c36050c1d83f996...deeaa78d5ef28c30bf932ba7726868f920fac7c5,1,9,10,19,2,2014-07-25 10:22:41,2014-07-25 00:24:52
deeaa78d5ef28c30bf932ba7726868f920fac7c5...ae5a4668beceb7d90c9855d383f18fb5aad834a6,1,8,8,16,1,2014-07-25 10:26:45,2014-07-25 08:42:06
ae5a4668beceb7d90c9855d383f18fb5aad834a6...2630cafc86bf6cc86ec8b47f0074b42f45b1f944,6,9,9,18,8,2014-07-26 09:24:04,2014-07-26 01:34:13
2630cafc86bf6cc86ec8b47f0074b42f45b1f944...1c714c18d22a38ad2dca696ca8bc4201cc3da131,1,8,0,8,1,2014-07-26 13:40:31,2014-07-26 11:36:40
1c714c18d22a38ad2dca696ca8bc4201cc3da131...e3a99357cba5085f5ae937920529292edafc5c7a,1,5,0,5,1,2014-07-26 14:27:49,2014-07-26 14:00:48
e3a99357cba5085f5ae937920529292edafc5c7a...a7fe87bd286fad4b4e6f3a294bda248bb980e900,1,3,3,6,1,2014-07-27 00:47:13,2014-07-26 18:51:29
a7fe87bd286fad4b4e6f3a294bda248bb980e900...6c70b1d7df4bc6f666ee9fa55a305e7347862095,2,21,7,28,5,2014-07-28 14:58:34,2014-07-27 08:12:39
6c70b1d7df4bc6f666ee9fa55a305e7347862095...8e25b696ba896f7f9b07565e7559aa08e743288a,1,3,2,5,2,2014-07-29 10:22:42,2014-07-29 09:06:32
8e25b696ba896f7f9b07565e7559aa08e743288a...838b7f8220d4ac2af6e39e2b5a3c1a7b95131083,4,67,17,84,15,2014-07-29 11:00:26,2014-03-12 21:43:45
838b7f8220d4ac2af6e39e2b5a3c1a7b95131083...f07e9f879658966393ca0887455414cb2ed46406,1,1,0,1,1,2014-07-29 13:37:49,2014-07-29 13:37:06
f07e9f879658966393ca0887455414cb2ed46406...8567c1a3c2ed4a031ced735116ef6d2796473271,1,3,4,7,1,2014-07-30 12:16:07,2014-07-30 12:15:13
8567c1a3c2ed4a031ced735116ef6d2796473271...e4b2bea743944b67a55d0ef3d17982a2319f866d,2,5,0,5,2,2014-07-30 13:29:08,2014-07-30 13:28:43
e4b2bea743944b67a55d0ef3d17982a2319f866d...faff723770adddf3d093291e51cada3a6ef16223,1,6,13,19,4,2014-07-31 16:57:53,2014-07-31 16:54:11
faff723770adddf3d093291e51cada3a6ef16223...1cfb1052eec6c670b6fee7a1490b25409f2bb7da,1,1,1,2,1,2014-08-01 13:43:52,2014-08-01 13:10:14
1cfb1052eec6c670b6fee7a1490b25409f2bb7da...0dfc37669d86550016d0f435de87626efc663254,7,22,24,46,17,2014-08-02 14:27:34,2014-08-02 14:27:01
0dfc37669d86550016d0f435de87626efc663254...316178efe6308378f2b812f96a35f378c5003c08,1,1,1,2,1,2014-08-02 16:59:27,2014-08-02 16:59:27
316178efe6308378f2b812f96a35f378c5003c08...e275016f09a907c85c8f1b4c87388dfab330b2fd,1,3,32,35,4,2014-08-02 19:04:05,2014-08-02 19:02:29
e275016f09a907c85c8f1b4c87388dfab330b2fd...4121ce3dfacbad0e67f204a25abf1756cbc7088f,2,2,2,4,2,2014-08-05 11:29:00,2014-08-05 11:28:04
4121ce3dfacbad0e67f204a25abf1756cbc7088f...5fdfa2d9b49cfb31298d75ffc51800e730bf876c,1,25,0,25,1,2014-08-05 12:49:38,2014-08-05 12:40:27
5fdfa2d9b49cfb31298d75ffc51800e730bf876c...3d8e106ae96ba75a2ea01b0424b92b87ee0f7e07,1,1,1,2,1,2014-08-07 02:20:05,2014-08-07 00:32:41
3d8e106ae96ba75a2ea01b0424b92b87ee0f7e07...72e98d5c160442a2cf2c016d9bbb78bc6e09b2e7,1,2,12,14,2,2014-08-08 16:45:18,2014-08-08 16:45:18
72e98d5c160442a2cf2c016d9bbb78bc6e09b2e7...ffb9cbfdaaaa84378d59a25abe9fb711ece4de7e,1,1,1,2,1,2014-08-11 10:09:32,2014-08-11 10:01:14
ffb9cbfdaaaa84378d59a25abe9fb711ece4de7e...d07394a51e1194b5bf8edeb1c6127e6c8df197a4,2,28,8,36,6,2014-08-11 11:09:47,2014-08-07 13:20:59
d07394a51e1194b5bf8edeb1c6127e6c8df197a4...db1cfbc1a9d8bafdf14ac2cda321b15f9a77e3d2,1,1,1,2,1,2014-08-12 16:27:45,2014-08-12 16:27:24
db1cfbc1a9d8bafdf14ac2cda321b15f9a77e3d2...123f490ae35a71e15de4d14c15f88fa20f0f6654,1,2,2,4,2,2014-08-14 01:45:32,2014-08-14 01:44:16
123f490ae35a71e15de4d14c15f88fa20f0f6654...99b5567796b2a4b96547a51e630f8c5b23d78531,2,5,1,6,3,2014-08-14 10:11:42,2014-08-14 09:56:25
99b5567796b2a4b96547a51e630f8c5b23d78531...73cc96478b349789a0effacec8304836268c1f2f,1,1,1,2,1,2014-08-14 16:15:18,2014-08-14 16:00:06
73cc96478b349789a0effacec8304836268c1f2f...f5e8376288783554e4da398183dfa627c73401e5,2,9,5,14,6,2014-08-15 08:10:35,2014-01-19 20:00:34
f5e8376288783554e4da398183dfa627c73401e5...955fdc8cdb0c1a98741687513980b64de8f20c75,1,9,9,18,3,2014-08-18 16:54:24,2014-08-18 16:49:50
955fdc8cdb0c1a98741687513980b64de8f20c75...75d7bb8d4313f83a832a65cc5e9b17b8ccf97fd1,1,5,0,5,1,2014-08-19 10:15:34,2014-08-19 10:14:14
75d7bb8d4313f83a832a65cc5e9b17b8ccf97fd1...190d81179f5eba6f2a1042321f0d39f04860163a,1,3,1,4,1,2014-08-19 10:16:41,2014-08-19 10:09:29
190d81179f5eba6f2a1042321f0d39f04860163a...d1e4fb996bd969c9a5d1dc4546b3fd46766ad25e,1,15,7,22,3,2014-08-19 10:30:01,2014-08-19 10:27:27
d1e4fb996bd969c9a5d1dc4546b3fd46766ad25e...3cd3b49eb50155ac7c29589b66498359b4934c00,1,2,1,3,1,2014-08-19 11:18:42,2014-08-19 11:17:23
3cd3b49eb50155ac7c29589b66498359b4934c00...18f25efc9ec18e6d5c0ceada2b0349b7117beb77,1,7,3,10,3,2014-08-19 11:27:03,2014-08-19 11:23:17
18f25efc9ec18e6d5c0ceada2b0349b7117beb77...c0e49ef767e6fd7a4d77ab625e15383948ac250d,1,4,0,4,1,2014-08-19 16:09:22,2014-08-19 16:06:07
c0e49ef767e6fd7a4d77ab625e15383948ac250d...9f9fdc4b0a33abfe3255302300ea1e3d1c33a3a0,4,33,10,43,5,2014-08-19 20:55:35,2014-08-19 20:38:45
9f9fdc4b0a33abfe3255302300ea1e3d1c33a3a0...477ab02312d47969bdfd7c1616da27379bb1b967,1,1,1,2,1,2014-08-19 21:45:38,2014-06-07 12:54:54
477ab02312d47969bdfd7c1616da27379bb1b967...48368d421cfd1ebef3217d44c349f5dcd6f0ec9d,4,61,16,77,14,2014-08-19 21:47:21,2014-08-19 14:22:51
48368d421cfd1ebef3217d44c349f5dcd6f0ec9d...52b878d805c2dc810ddc1ea5493bb7b86455eacc,4,17,1,18,5,2014-08-20 15:43:43,2014-08-05 19:20:05
52b878d805c2dc810ddc1ea5493bb7b86455eacc...da051da8df5e69944745072611351d4cfc6435d5,6,50,1,51,6,2014-08-20 15:43:43,2014-07-17 19:59:28
da051da8df5e69944745072611351d4cfc6435d5...dd0c3f4ee1a30c1a1e6055061c6ba6e58c6b54d1,8,113,25,138,21,2014-08-20 15:43:43,2014-08-08 14:20:08
dd0c3f4ee1a30c1a1e6055061c6ba6e58c6b54d1...0268b855f9eab3377f2821164ef3e66037789e09,5,65,8,73,7,2014-08-20 15:43:43,2014-08-11 16:04:53
0268b855f9eab3377f2821164ef3e66037789e09...f7c494f2506250b8cb5923714360a3642ed63e0f,8,94,5,99,12,2014-08-20 15:43:43,2014-08-07 04:18:10
f7c494f2506250b8cb5923714360a3642ed63e0f...8b19a4e275313cf2226f535d3ec10f414e0c6885,1,1,1,2,1,2014-08-20 20:14:55,2014-08-20 20:14:55
8b19a4e275313cf2226f535d3ec10f414e0c6885...66638a09c582a3b9de23c04ccaa326e6ba6575b7,3,3,3,6,3,2014-08-20 20:32:51,2014-08-20 20:31:45
66638a09c582a3b9de23c04ccaa326e6ba6575b7...808c0dc705cd4b5be9903d20163e08bb080a42c2,1,1,1,2,1,2014-08-20 20:38:01,2014-08-20 20:38:01
808c0dc705cd4b5be9903d20163e08bb080a42c2...f8344398fc4156a6367c40987a9de70fd2ad22ce,1,1,1,2,1,2014-08-22 15:34:53,2014-08-22 15:22:09
f8344398fc4156a6367c40987a9de70fd2ad22ce...d3c75da7fbcdf5d32ab332c9de276e1ffd15f312,1,2,1,3,1,2014-08-22 15:40:07,2014-08-22 10:24:46
d3c75da7fbcdf5d32ab332c9de276e1ffd15f312...4684464b354951c94b81d0bb25741ceb5c3e75e1,1,2,1,3,1,2014-08-22 17:23:58,2014-08-22 16:56:38
4684464b354951c94b81d0bb25741ceb5c3e75e1...9bc10919809007fada06c0dc4bc5285f80e2e965,2,6,6,12,2,2014-08-23 23:31:09,2014-08-23 23:30:14
9bc10919809007fada06c0dc4bc5285f80e2e965...fa76275e8a2fcad7a13c1a6fbf13764942225959,1,3,4,7,1,2014-08-26 12:11:59,2014-08-24 03:01:13
fa76275e8a2fcad7a13c1a6fbf13764942225959...adb0c535a9015002e7ec0b58f2c5a6ff1ca054b2,2,2,2,4,2,2014-08-26 13:44:55,2014-08-26 13:44:24
adb0c535a9015002e7ec0b58f2c5a6ff1ca054b2...8e77ac634ffcbeab634aa8c3f1bda7e6fab229a0,1,11,0,11,1,2014-08-26 18:50:42,2014-08-26 17:52:20
8e77ac634ffcbeab634aa8c3f1bda7e6fab229a0...4db64e8491fb154f65e824b4a0f7d27e66b477cc,1,5,0,5,1,2014-08-26 19:22:32,2014-08-26 19:22:08
4db64e8491fb154f65e824b4a0f7d27e66b477cc...e3453b61c6269d7868ceb404abaea5ad2569778f,8,78,5,83,12,2014-08-28 01:50:29,2014-08-21 15:55:23
e3453b61c6269d7868ceb404abaea5ad2569778f...996ac768e3e5df837b19881ddd9e6e1a91709e22,1,123,21,144,18,2014-08-28 15:08:11,2014-08-28 03:04:23
996ac768e3e5df837b19881ddd9e6e1a91709e22...ce4057591adac537038736ee41d084e08eea553e,1,1,1,2,1,2014-08-30 03:12:24,2014-08-30 03:06:31
ce4057591adac537038736ee41d084e08eea553e...b877697472073454423a0cdff695387d9039b464,4,46,5,51,6,2014-08-30 11:16:47,2014-08-29 14:01:21
b877697472073454423a0cdff695387d9039b464...24d84520aa80fa168faec0af3942a296f299927c,1,2,0,2,1,2014-09-02 12:15:07,2014-09-02 05:59:05
24d84520aa80fa168faec0af3942a296f299927c...75d03c775553b9778db513213376d335d23819a8,1,1,1,2,1,2014-09-02 20:54:38,2014-09-02 20:54:38
75d03c775553b9778db513213376d335d23819a8...900f28a2b5fb8be99c896fc50de8ed46c702e2ba,1,1,1,2,1,2014-09-03 01:08:02,2014-09-03 01:08:02
900f28a2b5fb8be99c896fc50de8ed46c702e2ba...f7c7ab0e8980b38dbdc846c35c2461ff08105381,3,3,3,6,3,2014-09-03 01:35:07,2014-09-03 01:34:29
f7c7ab0e8980b38dbdc846c35c2461ff08105381...289d38b731798ed362a5ca343210921e0d5127ab,1,1,1,2,1,2014-09-03 15:49:37,2014-09-03 03:27:36
289d38b731798ed362a5ca343210921e0d5127ab...414e3fc59dcb429d9d96a91348f7c0eb661d70fa,1,2,1,3,1,2014-09-06 00:40:52,2014-09-06 00:32:31
414e3fc59dcb429d9d96a91348f7c0eb661d70fa...c9e0afe2d3fa51b1b76ff5cbd53f95cf19f984f1,2,53,4,57,4,2014-09-06 11:48:34,2014-09-05 23:55:24
c9e0afe2d3fa51b1b76ff5cbd53f95cf19f984f1...8635fa0b118fcf7e7a0234fb2edb57715d6f6a61,1,7,4,11,4,2014-09-06 12:01:02,2014-09-06 11:59:27
8635fa0b118fcf7e7a0234fb2edb57715d6f6a61...731654197cfbc49296c0d5869aae698b315440e9,1,13,8,21,3,2014-09-08 17:24:48,2014-09-06 20:58:26
731654197cfbc49296c0d5869aae698b315440e9...a7af6ad96a35634383c2d73fa049127e85a886a6,8,82,4,86,14,2014-09-08 18:05:26,2014-09-04 21:04:53
a7af6ad96a35634383c2d73fa049127e85a886a6...5767bc722ff9d65b20226a0aff438b38b46cc594,1,13,4,17,5,2014-09-09 13:33:04,2014-09-09 13:32:19
5767bc722ff9d65b20226a0aff438b38b46cc594...e2d4677a1cd30cf0e79180534ff0a64e04b7be00,1,1,1,2,1,2014-09-10 11:17:37,2014-09-10 08:44:12
e2d4677a1cd30cf0e79180534ff0a64e04b7be00...eba54eb157f0ad4965304ff425a5d300170724fb,1,1,1,2,1,2014-09-10 15:17:57,2014-09-10 15:17:33
eba54eb157f0ad4965304ff425a5d300170724fb...cc8486b6fe7247ce1bf06f661248191483f7296c,1,1,1,2,1,2014-09-10 16:27:14,2014-09-10 16:26:15
cc8486b6fe7247ce1bf06f661248191483f7296c...31b5e3e010e30877d073b2c82061f82e5762d1d5,1,3,2,5,1,2014-09-11 19:42:48,2014-09-11 19:37:16
31b5e3e010e30877d073b2c82061f82e5762d1d5...452587aba858820bdde317083a8a67abf56dcec0,1,5,1,6,2,2014-09-13 13:23:46,2014-09-13 13:23:00
452587aba858820bdde317083a8a67abf56dcec0...9a66244bd8c8b7202ff51f4aa6069f716ab64317,1,4,4,8,2,2014-09-17 07:24:05,2014-09-17 03:30:11
9a66244bd8c8b7202ff51f4aa6069f716ab64317...aa1939c1d1e923d98fb00250dee34e00421bcee5,1,3,1,4,2,2014-09-17 12:43:44,2014-09-17 12:37:27
aa1939c1d1e923d98fb00250dee34e00421bcee5...a6c294a5a293b1096e4e8dd86933c76356c70d71,1,8,8,16,6,2014-09-21 15:34:23,2014-09-21 15:15:44
a6c294a5a293b1096e4e8dd86933c76356c70d71...59d369db7854b55f22ff75da92971dcd0ab4322f,2,9,1,10,3,2014-09-22 17:39:39,2014-09-17 19:33:50
59d369db7854b55f22ff75da92971dcd0ab4322f...8cee5875a65d6b736c3cbafa774abdc62336ed08,1,1,1,2,1,2014-09-22 17:42:51,2014-09-18 16:41:58
8cee5875a65d6b736c3cbafa774abdc62336ed08...2376319ce089cb3d5484fc1d9861f81a80d6abc4,1,2,0,2,1,2014-09-22 17:43:35,2014-09-19 19:03:55
2376319ce089cb3d5484fc1d9861f81a80d6abc4...dd7346ed1daf30ee37517057b58900bd10ba978b,1,4,2,6,1,2014-09-22 17:46:28,2014-09-19 14:03:38
dd7346ed1daf30ee37517057b58900bd10ba978b...943716c8ee601f4c12b5e0dc4a04e85c9dbe244b,1,4,0,4,2,2014-09-24 00:06:50,2014-09-23 23:51:14
943716c8ee601f4c12b5e0dc4a04e85c9dbe244b...9beca95eb0f2b5c19b6f7824fd75326527132566,1,6,4,10,1,2014-09-24 17:05:09,2014-09-24 13:57:07
9beca95eb0f2b5c19b6f7824fd75326527132566...8c0851051d46d62f3bdc1efcbb1614103f1629a3,9,33,7,40,10,2014-09-29 22:17:39,2014-09-27 22:12:34
8c0851051d46d62f3bdc1efcbb1614103f1629a3...011541d948dac99100940e974f5cf243199be534,1,1,1,2,1,2014-09-29 23:58:00,2014-09-29 23:31:29
011541d948dac99100940e974f5cf243199be534...000415687323a7a7342eb2ec7e1bb1801613a652,1,1,1,2,1,2014-10-01 17:10:18,2014-10-01 14:24:46
000415687323a7a7342eb2ec7e1bb1801613a652...e71ef9b6f2d91b5863d7039cfefcea076611d552,1,20,0,20,1,2014-10-02 10:35:59,2014-10-02 10:19:18
e71ef9b6f2d91b5863d7039cfefcea076611d552...0aad1f1ea912e1c855c1ff9c0b89fa28d2035ca3,3,9,2,11,3,2014-10-06 12:24:10,2014-10-05 01:09:32
0aad1f1ea912e1c855c1ff9c0b89fa28d2035ca3...c5c4bfa12aa0e8d4e8b46d77b6159f59330c3313,7,33,5,38,11,2014-10-06 12:50:48,2014-10-05 18:06:51
c5c4bfa12aa0e8d4e8b46d77b6159f59330c3313...e24b246e2b9651fab08e0104293d65ee283d27c0,1,7,3,10,5,2014-10-06 14:46:47,2014-10-06 12:59:04
e24b246e2b9651fab08e0104293d65ee283d27c0...0a31b4ea8e844f6b2f02027ef4d94b09c34ebb91,1,0,5,5,1,2014-10-10 19:22:40,2014-10-10 19:18:54
0a31b4ea8e844f6b2f02027ef4d94b09c34ebb91...5e4ddcc52d167d03f36dcf75c0e1a2190b2979da,1,1,1,2,1,2014-10-15 22:56:09,2014-10-15 21:48:35
5e4ddcc52d167d03f36dcf75c0e1a2190b2979da...a57f32411fa778005af0774c557b87c8ab32c1eb,3,6,6,12,5,2014-10-17 00:10:59,2014-10-17 00:00:17
a57f32411fa778005af0774c557b87c8ab32c1eb...7d90fed1a073318defbb7cf80015530a38a09bbc,1,7,7,14,3,2014-10-18 10:56:18,2014-10-17 20:01:42
7d90fed1a073318defbb7cf80015530a38a09bbc...ab0899fc6b83b8e35dec824c5300ae240fd1024e,1,1,1,2,1,2014-10-19 23:20:32,2014-10-19 09:01:14
ab0899fc6b83b8e35dec824c5300ae240fd1024e...66be18ea58825e82f5c8ea55bd871b3b895980fb,3,3,3,6,3,2014-10-22 16:24:30,2014-10-22 16:23:21
66be18ea58825e82f5c8ea55bd871b3b895980fb...811508b0512d3fa6b2328f8647fbf9eace68eceb,1,1,1,2,1,2014-10-22 16:49:25,2014-10-22 16:49:25
811508b0512d3fa6b2328f8647fbf9eace68eceb...164970bac10a6b9d67bf12cbb00444ec85e51b57,1,1,1,2,1,2014-10-22 17:32:32,2014-10-22 17:32:32
164970bac10a6b9d67bf12cbb00444ec85e51b57...b087d9b5e6e16a8135e09adf8386e34fbb64d046,1,0,2,2,1,2014-10-23 12:51:19,2014-10-23 12:15:54
b087d9b5e6e16a8135e09adf8386e34fbb64d046...2bc0dacd405092569dd556e4fe45c8ef48eb7fb6,1,9,12,21,3,2014-10-24 22:59:21,2014-10-24 22:58:31
2bc0dacd405092569dd556e4fe45c8ef48eb7fb6...0f14263c909f30ee25c22f806c48181b4ef70410,1,1,1,2,1,2014-10-27 10:43:35,2014-10-27 04:49:07
0f14263c909f30ee25c22f806c48181b4ef70410...54c2c5e0485d3951df553513a5640224cb668050,1,11,5,16,2,2014-10-27 22:20:46,2014-10-27 22:17:50
54c2c5e0485d3951df553513a5640224cb668050...deb11b0edf0bde7408748682a8ba49bff5fbef3e,1,2,2,4,2,2014-10-27 23:50:25,2014-10-27 22:18:37
deb11b0edf0bde7408748682a8ba49bff5fbef3e...aa9e90d8490a1d514b5b4f0bdd232891aa29aaec,1,3,1,4,2,2014-10-29 17:39:24,2014-10-29 15:31:40
aa9e90d8490a1d514b5b4f0bdd232891aa29aaec...10890606bc57afc38c5fbc7eb87dfcd35da524d6,1,8,6,14,7,2014-10-30 12:30:38,2014-10-30 10:27:19
10890606bc57afc38c5fbc7eb87dfcd35da524d6...28033632f8533a16943bda816ed11ed3b2773b05,1,6,6,12,2,2014-10-30 18:46:31,2014-10-30 05:46:16
28033632f8533a16943bda816ed11ed3b2773b05...5fa841d22f502c1a8d3c5590327025fca0e34438,1,8,3,11,1,2014-10-30 22:19:51,2014-10-30 19:45:01
5fa841d22f502c1a8d3c5590327025fca0e34438...2365c7c230c9fd597f578168ae8fad234045d03e,1,5,5,10,3,2014-10-30 22:27:47,2014-10-30 22:26:13
2365c7c230c9fd597f578168ae8fad234045d03e...de8825685491ed0e3078cdcef0f7fed7b08796cc,1,2,19,21,2,2014-10-30 22:35:19,2014-10-30 22:34:10
de8825685491ed0e3078cdcef0f7fed7b08796cc...89df9d244d47d7c6cf29bd482a791dd4c684e237,1,4,2,6,2,2014-10-30 22:44:54,2014-10-30 22:42:54
89df9d244d47d7c6cf29bd482a791dd4c684e237...4a30e0aeb9b9fc7d29cb574ae837afe429da6e20,1,6,3,9,2,2014-10-30 23:04:37,2014-10-30 23:01:20
4a30e0aeb9b9fc7d29cb574ae837afe429da6e20...78af6f134b7df11773c4cb3597475cfbfe55277d,1,6,0,6,1,2014-10-31 17:38:00,2014-10-31 17:34:41
78af6f134b7df11773c4cb3597475cfbfe55277d...672015407b091ab3189aa7f5e2c6b142deb150ea,1,1,1,2,1,2014-11-01 16:37:29,2014-11-01 16:36:28
672015407b091ab3189aa7f5e2c6b142deb150ea...61f20b42cdbe9c246d210ad5a0d3a22ada32c443,4,200,62,262,38,2014-11-05 02:25:08,2014-11-05 01:38:38
61f20b42cdbe9c246d210ad5a0d3a22ada32c443...df47f0c918a366ddbeba0c7997e64500eeb3f516,1,1,1,2,1,2014-11-09 21:12:21,2014-11-09 21:10:31
df47f0c918a366ddbeba0c7997e64500eeb3f516...bcdfa0eb9a7ffdd2938f1365ef93ad8aec0c7fb2,1,1,1,2,1,2014-11-10 14:39:09,2014-11-09 21:31:53
bcdfa0eb9a7ffdd2938f1365ef93ad8aec0c7fb2...b078ccf8bfcd105873f13141403a6057e430463d,1,7,3,10,3,2014-11-12 21:01:12,2014-11-12 21:00:48
b078ccf8bfcd105873f13141403a6057e430463d...f31e9c7a9d03626e753fdb2bb9457228d71d570f,2,0,8,8,2,2014-11-13 10:34:59,2014-11-13 09:30:36
f31e9c7a9d03626e753fdb2bb9457228d71d570f...159978e5c09b5e3cfbc1922a0890e030d9f52ae5,1,6,0,6,2,2014-11-15 08:56:35,2014-11-15 08:06:37
159978e5c09b5e3cfbc1922a0890e030d9f52ae5...7323e15d872058ff4519f2c294507b16c9df7c9b,1,5,0,5,1,2014-11-15 16:46:41,2014-11-15 16:46:41
7323e15d872058ff4519f2c294507b16c9df7c9b...2e7ca0994013c4238e00fd3d126f89ad3bc21b86,1,9,5,14,3,2014-11-16 13:33:29,2014-11-15 19:31:09
2e7ca0994013c4238e00fd3d126f89ad3bc21b86...614dd44d0d2e5f8f12256835c3453f420f54c3b4,1,6,6,12,2,2014-11-20 14:35:41,2014-11-13 18:59:00
614dd44d0d2e5f8f12256835c3453f420f54c3b4...61be9373af859931129b76e0a6138b47c2f82a83,1,1,1,2,1,2014-11-20 16:10:09,2014-11-20 15:35:36
61be9373af859931129b76e0a6138b47c2f82a83...db227d9d20d848c56f94ce0ca175fde7e1180c21,1,1,0,1,1,2014-11-23 22:08:41,2014-11-23 17:47:28
db227d9d20d848c56f94ce0ca175fde7e1180c21...1fa2e7aba1a4837eede4b5c0e4f9e14fdd413c6d,1,4,2,6,1,2014-11-24 10:13:17,2014-11-24 10:09:39
1fa2e7aba1a4837eede4b5c0e4f9e14fdd413c6d...276332d85c76a4de9fc1cb4bcb2f1636c0322414,2,25,0,25,2,2014-11-24 15:29:24,2014-11-15 11:13:05
276332d85c76a4de9fc1cb4bcb2f1636c0322414...3c317064d8dfef21ef83b4b496ea4cf0dc1eefa9,1,28,3,31,2,2014-11-24 15:36:46,2014-11-24 15:31:41
3c317064d8dfef21ef83b4b496ea4cf0dc1eefa9...c3a40af6ec50e537b82ce6ca3acf5d665db76f29,1,6,0,6,2,2014-11-25 18:15:06,2014-11-25 18:13:45
c3a40af6ec50e537b82ce6ca3acf5d665db76f29...2fd16232b106cf99ed42eccf57da1eed1f815d41,8,64,22,86,24,2014-11-25 18:48:50,2014-11-16 15:42:09
2fd16232b106cf99ed42eccf57da1eed1f815d41...51dff0f588525ff3a0658064d6442a9228fed983,1,1,1,2,1,2014-12-03 23:45:16,2014-12-03 22:13:36
51dff0f588525ff3a0658064d6442a9228fed983...a87ade7e30c80de93ec7ad8335d8714b494a58fb,1,11,0,11,1,2014-12-04 00:19:41,2014-11-30 23:02:43
a87ade7e30c80de93ec7ad8335d8714b494a58fb...7e47c3e6afd4084c9763a670b078c54e84b8f895,1,2,2,4,2,2014-12-04 01:11:24,2014-12-04 01:07:40
7e47c3e6afd4084c9763a670b078c54e84b8f895...fdbe038ced67f567853cde4ea154747f5074344f,1,1,1,2,2,2014-12-05 16:33:20,2014-12-05 15:23:14
fdbe038ced67f567853cde4ea154747f5074344f...9abfe2c02d603fac28d769c48a89835a1d324ad7,1,1,1,2,1,2014-12-05 18:18:00,2014-12-05 18:17:14
9abfe2c02d603fac28d769c48a89835a1d324ad7...62048bcd62351043f76cc86732053051c8895341,1,1,1,2,1,2014-12-06 14:26:20,2014-12-05 18:02:59
62048bcd62351043f76cc86732053051c8895341...e24ec760f11807c974277a89491b25bbafcef401,1,3,2,5,1,2014-12-06 16:52:26,2014-12-06 16:51:32
e24ec760f11807c974277a89491b25bbafcef401...43c55a7d4e24b34ec3032ca54d567e73870852d0,1,1,1,2,1,2014-12-07 17:26:26,2014-12-06 21:49:59
43c55a7d4e24b34ec3032ca54d567e73870852d0...30a12d6ca66ae2558740ef05f4a0b44566cfefa3,1,7,0,7,1,2014-12-08 17:58:40,2014-12-08 15:49:35
30a12d6ca66ae2558740ef05f4a0b44566cfefa3...5fb7086b6b4c0129c57ea5928fd91d272f3e5858,1,6,4,10,2,2014-12-08 18:18:32,2014-12-08 18:15:46
5fb7086b6b4c0129c57ea5928fd91d272f3e5858...ec861bca692dde67579967c5ebeb0f6b5995aad7,1,1,1,2,1,2014-12-11 17:12:36,2014-12-11 15:19:10
ec861bca692dde67579967c5ebeb0f6b5995aad7...89f9bf61bbbf8f5d2593c53ae3fbe45d8f110311,1,4,1,5,1,2014-12-13 18:42:51,2014-12-13 18:41:31
89f9bf61bbbf8f5d2593c53ae3fbe45d8f110311...3ac7d83ba501fb6559585b53dab3530a9503ce0c,1,2,2,4,2,2014-12-17 00:01:29,2014-12-16 23:53:31
3ac7d83ba501fb6559585b53dab3530a9503ce0c...b6c05b2b94d475de773e933c20a8d6d8a5dca5e5,2,29,15,44,9,2014-12-17 13:26:36,2014-12-17 13:01:19
b6c05b2b94d475de773e933c20a8d6d8a5dca5e5...79561e7c3bee245f388fa57d995fc402357611ba,1,5,5,10,1,2014-12-18 16:35:35,2014-12-18 16:34:11
79561e7c3bee245f388fa57d995fc402357611ba...ab6df6419c4659ff4b3d4c218f2a2a1d89288c68,1,3,3,6,1,2014-12-18 16:58:31,2014-12-18 16:55:33
ab6df6419c4659ff4b3d4c218f2a2a1d89288c68...0e3626260df15d7516ece2c8e60898f21f3e5ebb,1,3,1,4,1,2014-12-20 00:12:54,2014-12-20 00:11:52
0e3626260df15d7516ece2c8e60898f21f3e5ebb...d237aaa9293e61d0cd854450da41ab80df4d4957,1,1,1,2,2,2014-12-22 12:51:19,2014-12-20 20:02:26
d237aaa9293e61d0cd854450da41ab80df4d4957...70c965ad4ff06337229c4095a2b2221467781b92,2,12,7,19,5,2014-12-23 19:40:40,2014-12-23 13:38:34
70c965ad4ff06337229c4095a2b2221467781b92...2d0ae995d6b2fb58853fc59802ad781ba03376a6,2,24,2,26,2,2014-12-24 20:07:32,2014-12-24 19:15:48
2d0ae995d6b2fb58853fc59802ad781ba03376a6...116d2098f61cff44596175b5d8b9d8d0d4005a0e,1,2,1,3,1,2014-12-28 00:51:38,2014-12-28 00:49:16
116d2098f61cff44596175b5d8b9d8d0d4005a0e...e17d98ff0292caf02b62a3e84e10e3aaff3f4015,1,3,3,6,1,2015-01-01 16:41:52,2015-01-01 16:38:53
e17d98ff0292caf02b62a3e84e10e3aaff3f4015...0114b9df1359422c49bfc8a5dd9e7c09bb049553,4,87,35,122,20,2015-01-02 18:33:46,2015-01-02 17:35:41
0114b9df1359422c49bfc8a5dd9e7c09bb049553...22d30486763081a8a0109b8481b52b26b758859e,3,3,3,6,3,2015-01-03 00:20:59,2015-01-03 00:20:18
22d30486763081a8a0109b8481b52b26b758859e...4747c2f17ff9b5d0fbe49607a58d47c9a02b9932,1,1,1,2,1,2015-01-03 01:40:43,2015-01-03 01:40:43
4747c2f17ff9b5d0fbe49607a58d47c9a02b9932...8d21fee7abd89d56e72e3d138bfeb286ddf2142c,1,1,1,2,1,2015-01-03 02:50:42,2015-01-03 02:50:42
8d21fee7abd89d56e72e3d138bfeb286ddf2142c...3b76a82a266d7f96019445a9189ac9b129328e25,1,6,6,12,1,2015-01-03 13:49:17,2015-01-03 09:41:42
3b76a82a266d7f96019445a9189ac9b129328e25...5e45c4f7c21202346ef2da7acd28cd7077350a78,2,15,0,15,2,2015-01-05 19:25:41,2015-01-05 19:24:34
5e45c4f7c21202346ef2da7acd28cd7077350a78...a1a230382d6e510199fb625d2d185a579713b712,1,1,1,2,1,2015-01-13 16:54:05,2015-01-13 16:28:43
a1a230382d6e510199fb625d2d185a579713b712...f143e25883bb420fd8ec140a09dc88a899e9607e,3,10,1,11,3,2015-01-13 18:10:11,2014-11-25 22:06:31
f143e25883bb420fd8ec140a09dc88a899e9607e...d7597b31d5c03106eeba4be14a33b32a5e25f4ee,5,142,0,142,5,2015-01-13 18:10:11,2014-09-10 17:06:19
d7597b31d5c03106eeba4be14a33b32a5e25f4ee...72e0b033662faa11bb7f516f18a132728aa0ae28,4,31,1,32,4,2015-01-13 18:10:11,2014-12-03 21:14:00
72e0b033662faa11bb7f516f18a132728aa0ae28...553779c4055e8742cc832ed525b9ee34b174934f,5,45,2,47,7,2015-01-13 18:10:11,2014-12-09 20:32:03
553779c4055e8742cc832ed525b9ee34b174934f...d7a06ee7e571b6dad07c0f5b519b1db02e2a476c,3,53,5,58,6,2015-01-13 18:10:11,2014-12-11 13:31:03
d7a06ee7e571b6dad07c0f5b519b1db02e2a476c...f9de1998f9aac2387b6896653b3aa51ad372da81,2,2,2,4,2,2015-01-13 18:10:25,2015-01-13 18:08:57
f9de1998f9aac2387b6896653b3aa51ad372da81...e2fea7c7145e6d26a17126c60bf090bab2932e7e,1,1,1,2,1,2015-01-13 18:12:22,2015-01-13 18:12:22
e2fea7c7145e6d26a17126c60bf090bab2932e7e...4c6bd574ad5fd8c6e9988b571ad41123ed348992,1,1,1,2,1,2015-01-13 19:15:55,2015-01-13 19:15:55
4c6bd574ad5fd8c6e9988b571ad41123ed348992...79df62f4d2254a1158f5fda4bfddbfcea570c735,1,2,1,3,1,2015-01-14 18:57:14,2015-01-14 18:46:15
79df62f4d2254a1158f5fda4bfddbfcea570c735...b9101fa7a2180f121fc828174149b61e9151e69d,1,3,0,3,1,2015-01-15 08:30:38,2015-01-15 08:24:54
b9101fa7a2180f121fc828174149b61e9151e69d...fb614ff4a712cf7d221ed9ddeb7e4164e882ba81,1,6,1,7,3,2015-01-16 15:34:46,2015-01-16 15:31:49
fb614ff4a712cf7d221ed9ddeb7e4164e882ba81...cba3d8ab076f3a34c23ca51ea9c31e9e7688e833,1,1,1,2,1,2015-01-16 23:24:51,2015-01-16 22:50:37
cba3d8ab076f3a34c23ca51ea9c31e9e7688e833...46f1f736104dab9de3dc27084f6224c2789ae584,1,5,1,6,1,2015-01-19 17:09:57,2015-01-19 17:08:20
46f1f736104dab9de3dc27084f6224c2789ae584...829d62bd52d2bd56d3101e557fc7775f432c707b,2,17,0,17,2,2015-01-27 16:48:47,2015-01-27 16:48:04
829d62bd52d2bd56d3101e557fc7775f432c707b...9316a04a9cb8e2f57068c1655c18510f943120e4,1,4,14,18,2,2015-02-03 13:43:05,2015-02-03 13:41:57
9316a04a9cb8e2f57068c1655c18510f943120e4...5104d935045c85d6e3a7354dcb74b5009e5794f2,1,3,3,6,3,2015-02-03 14:12:19,2015-02-03 14:10:55
5104d935045c85d6e3a7354dcb74b5009e5794f2...16f533b2a4b5278844fdd077e04c4bebba33b968,1,2,2,4,2,2015-02-03 17:27:29,2015-02-03 13:03:05
16f533b2a4b5278844fdd077e04c4bebba33b968...3b1dc45602d6222c7980cad4b5416cfac1d4710f,1,9,8,17,2,2015-02-03 21:38:13,2015-02-03 21:35:28
3b1dc45602d6222c7980cad4b5416cfac1d4710f...64735731e0fe8292965d98e8a543d98f9d902835,1,1,1,2,2,2015-02-07 03:15:06,2015-02-07 03:15:06
64735731e0fe8292965d98e8a543d98f9d902835...d686c9b6310b657746ddbbc43882976e5fc3a57b,1,1,1,2,1,2015-02-12 08:32:02,2014-04-08 14:12:15
d686c9b6310b657746ddbbc43882976e5fc3a57b...778ccee9bc83f986dc4b395a22c86de9bad88af7,1,5,4,9,1,2015-02-23 14:24:21,2015-02-22 17:46:15
778ccee9bc83f986dc4b395a22c86de9bad88af7...089dcbc26687d0884f9f8556b02f91b1c03eea93,1,1,1,2,1,2015-02-24 05:35:06,2015-02-24 04:13:31
089dcbc26687d0884f9f8556b02f91b1c03eea93...7a30dc87ad12b74678fb45db909add07d5f35dca,1,9,3,12,3,2015-03-02 17:37:38,2015-02-07 21:32:31
7a30dc87ad12b74678fb45db909add07d5f35dca...c5a8b442bdbb70cd34595f6c8c6d10bb6d038989,1,0,4,4,4,2015-03-02 18:33:52,2015-03-02 18:18:48
c5a8b442bdbb70cd34595f6c8c6d10bb6d038989...7d3418c9cd00acc32e01aa42c2bf226bf795b39c,1,5,3,8,1,2015-03-05 15:00:17,2015-03-05 14:13:56
7d3418c9cd00acc32e01aa42c2bf226bf795b39c...9cfcdd03e3bee661705d9348596db2ff90740ab7,1,1,1,2,1,2015-03-09 11:06:43,2015-03-09 11:05:49
9cfcdd03e3bee661705d9348596db2ff90740ab7...412137a1e856553787d0ba8bcefddd53f167bb2e,1,1,1,2,1,2015-03-10 11:12:54,2015-03-10 09:10:24
412137a1e856553787d0ba8bcefddd53f167bb2e...fc2ec51941e5866e29a82d68959181224c45ed4e,1,1,1,2,1,2015-03-13 12:14:40,2015-03-13 06:38:27
fc2ec51941e5866e29a82d68959181224c45ed4e...581a43948f09c4e1717ba2d1d99480dcff74ac44,3,16,0,16,4,2015-03-18 12:46:36,2015-03-04 12:49:12
581a43948f09c4e1717ba2d1d99480dcff74ac44...b6b3cb9899214a23ebb0f4ebf0e0b300b0ee524f,3,24,2,26,3,2015-03-18 12:47:16,2015-03-04 13:11:25
b6b3cb9899214a23ebb0f4ebf0e0b300b0ee524f...5510f070711540aaa8d3707776cd77494e688ef9,4,51,5,56,7,2015-03-18 12:47:43,2015-03-10 00:05:13
5510f070711540aaa8d3707776cd77494e688ef9...9d915ac1be1e7b8cfea3c92f707a4aeff4e62583,1,1,1,2,1,2015-03-18 12:48:39,2015-03-18 12:48:39
9d915ac1be1e7b8cfea3c92f707a4aeff4e62583...999c31426abb87dd16185abe20aef02303d2b77a,1,1,1,2,1,2015-03-19 00:18:04,2015-03-19 00:18:04
ef79582e8630cb3c119caed52130c9671188addd...ef37b23050637da643b47b1ee744702d4d603f4c,5,40,2,42,9,2013-06-22 11:12:43,2013-06-22 11:12:43
efb05978b36ef6eeb02f47b7c58b138d089d581a...4cfbde71a33973cb8c8da406b2523dfc742358e7,2,2,1,3,2,2013-10-23 16:22:14,2013-10-23 16:13:17
4cfbde71a33973cb8c8da406b2523dfc742358e7...5ab8b5d72c5277833908bc57b0765682e5aadc0b,9,207,37,244,33,2013-10-23 21:56:54,2013-10-23 21:56:54
5ab8b5d72c5277833908bc57b0765682e5aadc0b...c573d6de173c0e6743473081cde786e749641a48,2,12,21,33,7,2013-10-23 22:27:06,2013-10-22 14:52:04
c573d6de173c0e6743473081cde786e749641a48...4ce5c119b5a6109058500e207333cc6889d78abe,2,2,2,4,2,2013-10-23 22:28:41,2013-10-23 22:28:41
4ce5c119b5a6109058500e207333cc6889d78abe...8688f03eef9cf5fd763ba35481ddcff933a60c30,4,85,4,89,13,2013-10-23 23:27:08,2013-10-03 21:36:21
8688f03eef9cf5fd763ba35481ddcff933a60c30...382d324ccc0753962ec31ac23a4bde4fb2b9454e,1,1,0,1,1,2013-10-24 14:33:11,2013-10-24 14:33:11
382d324ccc0753962ec31ac23a4bde4fb2b9454e...9bf5610890530ce5db9af7ef89ae5b8612f46a94,31,92,90,182,69,2013-10-24 17:30:03,2013-10-24 17:30:03
9bf5610890530ce5db9af7ef89ae5b8612f46a94...43569647ab234cd1d2f4d41399b97b4b793d573a,4,10,10,20,10,2013-10-24 18:44:07,2013-10-23 14:04:02
43569647ab234cd1d2f4d41399b97b4b793d573a...08c9ab5a0f564a3ac7803e6a97fae855f2e0524e,2,2,0,2,2,2013-10-24 19:07:41,2013-10-24 19:01:25
08c9ab5a0f564a3ac7803e6a97fae855f2e0524e...c052699be3637c22e3a26383a4bdabc8c3cc0feb,3,14,6,20,6,2013-10-24 19:24:04,2013-10-24 17:34:40
c052699be3637c22e3a26383a4bdabc8c3cc0feb...9eecb9169566db263e243e4522b08ea1403ee95f,7,105,8,113,19,2013-10-24 21:40:01,2013-10-19 12:40:12
9eecb9169566db263e243e4522b08ea1403ee95f...4e0a2fe59c8b9c32c2f3111474354356474128a8,4,67,26,93,9,2013-10-25 00:38:00,2013-10-15 15:18:06
4e0a2fe59c8b9c32c2f3111474354356474128a8...43cfc652d250ba6bc746f22ce429d6e0a7e60103,1,1,1,2,1,2013-10-25 01:25:51,2013-10-25 01:25:51
43cfc652d250ba6bc746f22ce429d6e0a7e60103...3afde36d03e2b3b5ff5a265af39d8fb27afa8959,2,12,0,12,2,2013-10-25 09:23:19,2013-10-25 09:19:41
3afde36d03e2b3b5ff5a265af39d8fb27afa8959...3b0293370a35704c9b3c50e5f50b9c4e6edfd680,1,1,1,2,1,2013-10-25 11:55:05,2013-10-24 09:11:52
3b0293370a35704c9b3c50e5f50b9c4e6edfd680...cc2049cdd7f7afa3ffdccf5ef77af84a9abbf8f9,1,1,1,2,1,2013-10-25 21:36:07,2013-10-25 21:36:07
cc2049cdd7f7afa3ffdccf5ef77af84a9abbf8f9...f2d8027c9aea93750fc4213d9e733c8575e89502,23,68,68,136,53,2013-10-26 17:50:40,2013-10-26 17:50:40
f2d8027c9aea93750fc4213d9e733c8575e89502...9d740eb8b15de31f1c5520659df683d90342bb44,74,628,629,1257,533,2013-10-26 19:15:03,2013-10-26 19:15:03
9d740eb8b15de31f1c5520659df683d90342bb44...3351e94ffa37d3824a49b687125ee4a430b69bbe,1,24,19,43,2,2013-10-26 20:53:12,2013-10-25 23:07:40
3351e94ffa37d3824a49b687125ee4a430b69bbe...b35ff0d9208c426cc0f67c65d724972974734f57,63,541,541,1082,191,2013-10-27 01:27:42,2013-10-27 01:27:42
b35ff0d9208c426cc0f67c65d724972974734f57...b9a90b371c90a987ed57f7a4a7cc1274c432b438,3,3,4,7,7,2013-10-27 03:57:08,2013-10-27 03:57:08
17559e6eb0422aa6ec7bd9b7f1345b97a2a454a6...f3ba6495e29d84f8d98a2acd390821ff0d23fd7a,1,2,3,5,3,2013-05-24 14:22:08,2013-05-24 14:22:08
17559e6eb0422aa6ec7bd9b7f1345b97a2a454a6...81f454a32296ad27437eaf19acfcdad9a9c03fca,1,1,1,2,1,2013-05-24 13:36:17,2013-05-24 13:36:17
17559e6eb0422aa6ec7bd9b7f1345b97a2a454a6...fb1d8134846b468a6b972d3af1a23d7ee381b149,1,1,1,2,1,2013-05-24 10:37:20,2013-05-24 10:37:20
48dd1e63bbb93479666208535a56f8c7c4aeab3a...904b82759cce6f85d06564c42123da030da52341,1,2,2,4,2,2013-06-28 16:53:49,2013-06-28 16:53:49
904b82759cce6f85d06564c42123da030da52341...e1dd24d2f6dd3464ab50593320a7eb2325d6c196,1,3,0,3,1,2013-06-28 19:33:20,2013-06-28 19:33:20
e1dd24d2f6dd3464ab50593320a7eb2325d6c196...4f6be9a0c43050500af598527e1453d27c5c5b85,3,0,75,75,4,2013-06-29 00:48:15,2013-06-28 16:10:34
4f6be9a0c43050500af598527e1453d27c5c5b85...f02a703ca6867806fbef71dd8d64d9a19975fe6c,1,0,4,4,1,2013-06-29 00:48:15,2013-06-28 16:13:31
f02a703ca6867806fbef71dd8d64d9a19975fe6c...57d46bcde3a473ea2d61f4f466d870e85d7b5eb4,1,0,19,19,1,2013-06-29 00:48:16,2013-06-28 16:14:49
57d46bcde3a473ea2d61f4f466d870e85d7b5eb4...da6d303df4a9e5d51a6575b073980199d79508b8,1,0,31,31,1,2013-06-29 00:48:16,2013-06-28 16:22:28
da6d303df4a9e5d51a6575b073980199d79508b8...bb33ee5e7bf5325696e80e6d87e7614a9607a1b7,1,0,7,7,3,2013-06-29 00:48:16,2013-06-28 16:37:14
bb33ee5e7bf5325696e80e6d87e7614a9607a1b7...f73d04dda9f1a96acdab77dacd7bdeaad66ad736,4,2,25,27,4,2013-06-29 00:48:16,2013-06-28 16:38:04
f73d04dda9f1a96acdab77dacd7bdeaad66ad736...5e08b792eff2a3ca340ad5a8a568c665e52ec39e,1,0,10,10,2,2013-06-29 00:48:16,2013-06-28 17:50:06
5e08b792eff2a3ca340ad5a8a568c665e52ec39e...c196564132a351549245a5d795391ad1ea56195c,9,13,167,180,16,2013-06-29 00:48:16,2013-06-28 18:13:06
c196564132a351549245a5d795391ad1ea56195c...6ba69c8456461aa30f415331b948f7f92dfcf211,3,13,70,83,14,2013-06-29 00:48:16,2013-06-28 23:00:50
6ba69c8456461aa30f415331b948f7f92dfcf211...8eadbc5a03d06f5bfedfa3fad35ad0801d2ab6ff,6,10,37,47,12,2013-06-29 00:48:16,2013-06-28 23:50:36
8eadbc5a03d06f5bfedfa3fad35ad0801d2ab6ff...7379d9aceab01e007966b5fe1f47ba7590deb887,3,0,55,55,5,2013-06-29 01:38:13,2013-06-29 01:38:13
7379d9aceab01e007966b5fe1f47ba7590deb887...425a4292083c7355a2a4ef9676f605a9c3b8fe70,1,0,6,6,2,2013-06-29 02:16:06,2013-06-29 01:42:10
425a4292083c7355a2a4ef9676f605a9c3b8fe70...24bbf1367a1eed9443571622ab74c2c3e3d3db11,5,4,39,43,6,2013-06-29 02:16:28,2013-06-29 02:05:00
24bbf1367a1eed9443571622ab74c2c3e3d3db11...adc6f38867dd5b57c9e1c50395eec01f6bdd651f,1,3,3,6,1,2013-06-29 08:50:04,2013-06-29 08:50:04
adc6f38867dd5b57c9e1c50395eec01f6bdd651f...c8756e17fbd5293ee1e0582201c41e2febc58ae1,1,0,1,1,1,2013-06-29 09:42:34,2013-06-29 09:40:31
c8756e17fbd5293ee1e0582201c41e2febc58ae1...6118d6d1c982e428cf398ac998eb9f0baba15bad,9,3,16,19,11,2013-06-29 09:58:36,2013-06-29 09:52:29
6118d6d1c982e428cf398ac998eb9f0baba15bad...b5f709e6f4c67020bedb141b9b18c5cd1e05f829,1,1,1,2,1,2013-06-29 14:28:05,2013-06-29 14:28:05
ef37b23050637da643b47b1ee744702d4d603f4c...680b512fc1509ca05cf56fada30f6b833735362a,2,39,1,40,5,2013-06-22 13:05:12,2013-06-22 13:05:12
b9a90b371c90a987ed57f7a4a7cc1274c432b438...32f0f8489a0f509b06ef117a0d958d03b8412098,1,2,0,2,2,2013-10-27 15:06:36,2013-10-27 15:06:36
92c9052addb73b7e73ea349b4244bdd4f0087ca0...fbab3209fc6b32752a71d012add57cd440adfc94,1,1,3,4,2,2013-05-24 16:35:20,2013-05-24 16:35:20
fbab3209fc6b32752a71d012add57cd440adfc94...7e95d7a93088675f984d1079e4e3c3ddc1723b0f,2,30,2,32,6,2013-05-24 18:48:02,2013-05-24 18:45:03
7e95d7a93088675f984d1079e4e3c3ddc1723b0f...1514f17aa60772f48839130f9a5071b9ffe15213,3,49,1,50,7,2013-05-24 21:15:08,2013-05-23 15:14:27
1514f17aa60772f48839130f9a5071b9ffe15213...6de81d65f443a01961c23139ca5d7653ef012d35,4,42,1,43,5,2013-05-25 08:52:54,2013-03-25 14:45:24
6de81d65f443a01961c23139ca5d7653ef012d35...f940e564e4623d531eb97a2cf1b116851003f9fd,4,40,9,49,9,2013-05-25 10:10:53,2013-05-24 15:55:50
f940e564e4623d531eb97a2cf1b116851003f9fd...c0439b621086ae0ae348759a5a24969be8148d6a,1,0,1,1,1,2013-05-25 12:01:52,2013-05-25 12:01:52
c0439b621086ae0ae348759a5a24969be8148d6a...b3bccce1a09aae6dfb2eba7f77d3f373f03d8e0c,6,6,6,12,6,2013-05-25 12:16:46,2013-05-19 10:04:12
b3bccce1a09aae6dfb2eba7f77d3f373f03d8e0c...b7cf44dde88c52b3e3020bd9dae3b3d0792b9a6d,2,2,1,3,2,2013-05-25 12:32:44,2013-05-25 12:31:51
b7cf44dde88c52b3e3020bd9dae3b3d0792b9a6d...ab61dd28293746e26f2aa8728be5f04d6e7e536c,4,154,134,288,127,2013-05-25 12:32:44,2013-05-25 12:21:46
ab61dd28293746e26f2aa8728be5f04d6e7e536c...be0bab1bb8da80402248cd1fa22fd4cc09b34fe7,3,32,15,47,8,2013-05-25 13:31:07,2013-05-25 13:18:48
be0bab1bb8da80402248cd1fa22fd4cc09b34fe7...2ee447fb5f8974b432d3dd421af9a242215aea44,2,60,3,63,6,2013-05-25 14:06:44,2013-04-20 11:38:14
2ee447fb5f8974b432d3dd421af9a242215aea44...31f6421b134e4e83a459d2faa1009b33fefd6276,2,6,1,7,3,2013-05-25 14:27:26,2013-03-18 20:29:37
b5f709e6f4c67020bedb141b9b18c5cd1e05f829...ea3fe78a9d742904f6902cdc353a11d795418105,2,13,0,13,2,2013-06-29 16:08:39,2013-06-27 08:58:05
ea3fe78a9d742904f6902cdc353a11d795418105...7fbab3ebaf8b60bbe847b772f895df47067a60d3,2,9,0,9,2,2013-06-29 16:09:31,2013-06-27 08:59:30
7fbab3ebaf8b60bbe847b772f895df47067a60d3...59b0c48ce27951048146358739baf08056c5e821,2,12,1,13,2,2013-06-29 16:44:41,2013-06-29 16:44:41
59b0c48ce27951048146358739baf08056c5e821...8b9b8d3bda09eb1b447631182d06c6c5e51425f6,4,16,86,102,21,2013-06-29 16:49:36,2013-06-29 13:41:57
8b9b8d3bda09eb1b447631182d06c6c5e51425f6...acd7b34aafe352ef604edcb73f75041c5cbba6b9,41,80,81,161,78,2013-06-29 16:49:37,2013-06-29 16:34:41
acd7b34aafe352ef604edcb73f75041c5cbba6b9...74151765073ce280cc5df0bfe411971c6212a0ff,1,5,21,26,2,2013-06-29 16:56:00,2013-06-29 16:56:00
74151765073ce280cc5df0bfe411971c6212a0ff...3fd0ee5b46807c18c731045b4f5b360b5b091c61,2,5,5,10,2,2013-06-29 18:14:32,2013-06-29 18:14:32
b5f709e6f4c67020bedb141b9b18c5cd1e05f829...d51b7794bfd1ddfd92f71f71d07daf931421c5f7,3,1,33,34,6,2013-06-29 15:22:15,2013-06-29 15:22:15
864613c7e08ad6a5bc1737a5c21c711bd0385663...ecf63d5d89c5b511a023a4dcc32a142e1eed97e6,1,2,0,2,1,2013-06-22 20:49:24,2013-06-22 20:49:24
ecf63d5d89c5b511a023a4dcc32a142e1eed97e6...1559f84d8b5c2d4d088a27fc0edf02f01a1d65f0,4,33,4,37,8,2013-06-22 21:45:41,2013-06-22 21:39:14
1559f84d8b5c2d4d088a27fc0edf02f01a1d65f0...338ec9333da9dc422c29c935a19d24bfb2b78c28,1,1,1,2,1,2013-06-22 22:18:23,2013-06-19 20:40:36
338ec9333da9dc422c29c935a19d24bfb2b78c28...bd9fbd1497edc585c5bec28c7d4bc8d1afd1943b,4,66,68,134,30,2013-06-22 22:18:23,2013-06-22 21:05:22
bd9fbd1497edc585c5bec28c7d4bc8d1afd1943b...b0907d66a5ac7bdc5585cbebc56acf21274f2709,1,5,1,6,1,2013-06-23 19:41:24,2013-06-22 20:30:44
b0907d66a5ac7bdc5585cbebc56acf21274f2709...6466a0837b741e72a7aa55b4e28e132a48b82d85,1,2,2,4,1,2013-06-24 03:59:03,2013-06-24 03:59:03
6466a0837b741e72a7aa55b4e28e132a48b82d85...cd000dacc7cef8e55793d19242d0df0f3e736949,1,27,17,44,10,2013-06-24 09:55:43,2013-06-24 09:55:43
cd000dacc7cef8e55793d19242d0df0f3e736949...299983616ffc146a6f5aa03af9b3f4a56853f05c,2,5,3,8,5,2013-06-24 09:59:08,2013-06-23 21:43:09
299983616ffc146a6f5aa03af9b3f4a56853f05c...e161e4ff1176acb1b3636e3f93280055185d3d78,1,2,2,4,1,2013-06-24 11:00:53,2013-06-24 11:00:53
e161e4ff1176acb1b3636e3f93280055185d3d78...5a6f12182ef14883df6534dc3465059b78f54a1c,1,13,9,22,7,2013-06-24 18:43:44,2013-06-24 17:48:23
5a6f12182ef14883df6534dc3465059b78f54a1c...0346563939396fb89dec8df31f82eaefaaeb8616,9,17,17,34,12,2013-06-25 01:37:54,2013-06-25 01:37:54
0346563939396fb89dec8df31f82eaefaaeb8616...9a2b07f1b45741da39a7606474aec3548780032b,1,3,3,6,3,2013-06-25 07:46:17,2013-06-25 05:40:56
9a2b07f1b45741da39a7606474aec3548780032b...e10757ff4dbbc1aedd09df6c542948409c49d75f,3,18,4,22,7,2013-06-25 11:50:43,2013-06-25 11:50:43
e10757ff4dbbc1aedd09df6c542948409c49d75f...f819bef3dc935851f71e4ad84592eee8664a48f3,4,27,8,35,6,2013-06-25 15:20:41,2013-02-26 03:27:52
f819bef3dc935851f71e4ad84592eee8664a48f3...b91787910c9d5a036674d46a73d1b48ca33123a3,5,106,52,158,35,2013-06-25 16:22:37,2013-06-23 01:48:09
b91787910c9d5a036674d46a73d1b48ca33123a3...ec371ace004203100d24a74edafc16534dd5d5a9,3,8,2,10,3,2013-06-25 18:28:35,2013-06-25 18:28:35
ec371ace004203100d24a74edafc16534dd5d5a9...c6862d57c1e987f0f98a77826d19358b9040bad1,1,14,13,27,12,2013-06-26 12:07:52,2013-06-26 11:25:24
c6862d57c1e987f0f98a77826d19358b9040bad1...273dc550a4eccdad958541f456332312b3369504,4,19,2,21,5,2013-06-26 12:13:26,2013-06-26 08:07:18
78bc96caf52430a24540354ef34496f8823685b2...88f03db05fb3c42648289fa6ed27d6c13e2719cb,1,3,2,5,2,2013-10-27 17:54:56,2013-10-27 17:51:40
88f03db05fb3c42648289fa6ed27d6c13e2719cb...35db9d58d691d90b0c33e18b613067609d9e638f,7,306,293,599,21,2013-10-27 20:28:08,2013-10-27 20:26:51
35db9d58d691d90b0c33e18b613067609d9e638f...0336d0d95e8ce9eb8479ad556d53ada78d06b59c,3,12,16,28,12,2013-10-28 13:17:48,2013-10-28 13:17:48
0336d0d95e8ce9eb8479ad556d53ada78d06b59c...ffcfb4cdccefaf3b8d3a1e2e7adbfbd2539bbb32,1,1,1,2,1,2013-10-28 18:52:26,2013-10-28 18:52:26
ffcfb4cdccefaf3b8d3a1e2e7adbfbd2539bbb32...6b560b50b9b02691f712bbf1380d20d8eb103a4a,1,3,1,4,1,2013-10-29 14:26:06,2013-10-29 14:26:06
6b560b50b9b02691f712bbf1380d20d8eb103a4a...497930b7f69e2c298faa3f784c4523ea351e5e6f,1,2,2,4,2,2013-10-29 20:53:51,2013-10-29 20:53:51
497930b7f69e2c298faa3f784c4523ea351e5e6f...fd219fa24c7911adab60e1f5e4fd3d7f9d82a969,12,266,10,276,23,2013-10-29 21:10:12,2013-10-24 15:28:09
fd219fa24c7911adab60e1f5e4fd3d7f9d82a969...8f7355982305da2daccbdfa156b45d62d1cc2c99,1,4,4,8,3,2013-10-29 21:22:45,2013-10-29 21:22:45
8f7355982305da2daccbdfa156b45d62d1cc2c99...3c5cdaf47aae7e4f21398be1a5eaa07f7c5ce31c,2,14,0,14,2,2013-10-30 06:53:20,2013-10-29 22:06:59
3c5cdaf47aae7e4f21398be1a5eaa07f7c5ce31c...5733764a2c2923ae9a1b7c91de5a8d15414c99ef,1,44,0,44,1,2013-10-30 06:55:07,2013-10-29 22:31:53
5733764a2c2923ae9a1b7c91de5a8d15414c99ef...b47a052eb50567813d629e332bb0428d73c8892e,2,10,0,10,2,2013-10-30 11:46:07,2013-10-30 11:46:07
b47a052eb50567813d629e332bb0428d73c8892e...1edef50880f740e00fa1cd501c2ac56ec6fd10e4,1,11,0,11,1,2013-10-30 12:11:31,2013-10-30 12:11:31
1edef50880f740e00fa1cd501c2ac56ec6fd10e4...e9a356a695094fa8a6c4c2b3d1629332bd875b93,1,4,2,6,1,2013-10-30 12:26:33,2013-10-29 18:36:22
e9a356a695094fa8a6c4c2b3d1629332bd875b93...9fde42a69a56cb6c8cdfd67b07c67a1b97638f12,5,40,1,41,7,2013-10-30 12:54:07,2013-10-28 20:52:11
9fde42a69a56cb6c8cdfd67b07c67a1b97638f12...0b1d425a4128928291bfaa2c2582e715ef60937d,1,1,1,2,1,2013-10-30 13:12:27,2013-10-30 13:12:27
0b1d425a4128928291bfaa2c2582e715ef60937d...51e65754729ebb85b1f049e7995cae514be65c85,1,3,4,7,2,2013-10-30 13:25:21,2013-10-30 13:25:21
51e65754729ebb85b1f049e7995cae514be65c85...eafe279120e7e6ebe7b6d42443366088ba1a50c8,1,4,3,7,2,2013-10-30 13:33:28,2013-10-30 13:33:28
eafe279120e7e6ebe7b6d42443366088ba1a50c8...e9cb333bc359a31c548c97dc07e392cfe39be18e,3,90,24,114,19,2013-10-30 15:17:49,2013-10-30 15:17:28
e9cb333bc359a31c548c97dc07e392cfe39be18e...15f82c701161b327cef54b469c00b6cbe01534db,4,81,11,92,13,2013-10-30 15:45:43,2013-10-14 05:33:45
15f82c701161b327cef54b469c00b6cbe01534db...8faaf03b86030f242e35aebd56d9b969c53e7be9,1,1,1,2,2,2013-10-30 17:42:35,2013-10-30 17:42:35
31f6421b134e4e83a459d2faa1009b33fefd6276...cf159e5c939fa609c94e4d762d9d9363a6601a95,1,2,1,3,2,2013-05-25 22:39:34,2013-05-25 22:39:34
cf159e5c939fa609c94e4d762d9d9363a6601a95...36d47f72e300321c4a328a643d489436535d1442,1,1,1,2,1,2013-05-25 22:53:24,2013-05-25 22:53:24
36d47f72e300321c4a328a643d489436535d1442...d228c1192ed59ab0114d9eba82ac99df611652d2,38,363,77,440,95,2013-05-25 23:27:34,2013-05-15 23:14:28
d228c1192ed59ab0114d9eba82ac99df611652d2...0fa8d43e742ee8b480d938a47836b5a3720c2677,25,37,39,76,33,2013-05-27 02:47:50,2013-05-27 02:47:50
31f6421b134e4e83a459d2faa1009b33fefd6276...9a524e3c5bd8fafd4996a6f1486de8a2cbb052a2,1,4,1,5,1,2013-05-25 18:25:29,2013-05-25 18:25:29
5e3a6532aab7bf51aa5857c3de9479a7be0c2ae4...64cdea68e71829905da6374a066d1700375255ec,1,8,0,8,2,2013-06-29 21:19:20,2013-06-29 21:19:20
64cdea68e71829905da6374a066d1700375255ec...5ff2ffa3304b2e49e17257575327f9fc08ce227e,1,5,2,7,3,2013-06-30 07:43:02,2013-06-30 06:26:10
5ff2ffa3304b2e49e17257575327f9fc08ce227e...2c406818058e88a907e24bfd244418d2a55619d7,4,31,66,97,61,2013-06-30 12:17:33,2013-06-30 12:17:33
2c406818058e88a907e24bfd244418d2a55619d7...dd9c6bc359a799fcbed647055b596239956a472a,2,27,19,46,16,2013-06-30 13:57:00,2013-06-30 13:57:00
dd9c6bc359a799fcbed647055b596239956a472a...b9ebca6a2881f8f0a141a87adac869ae87f9df29,1,0,1,1,1,2013-07-01 06:32:23,2013-07-01 06:32:23
b9ebca6a2881f8f0a141a87adac869ae87f9df29...8b8b2f2fc7a4a79a7a18305c77d287809004c59e,1,24,25,49,5,2013-07-01 09:49:56,2013-07-01 09:44:59
8b8b2f2fc7a4a79a7a18305c77d287809004c59e...3fd8eb1a276fa452293112562463898de7351139,2,4,7,11,2,2013-07-01 09:52:37,2013-07-01 09:52:00
3fd8eb1a276fa452293112562463898de7351139...a763915a03579868c6abdc5cdffbb4c398dc52ee,5,12,14,26,8,2013-07-01 10:01:59,2013-07-01 10:01:25
a763915a03579868c6abdc5cdffbb4c398dc52ee...d5589b4cd3238c4bf4063ddd8239d22b37caa7d3,4,8,25,33,4,2013-07-01 10:02:17,2013-07-01 10:02:17
d5589b4cd3238c4bf4063ddd8239d22b37caa7d3...88de53d4a86548016f245a1413b856aa334bc737,1,12,13,25,4,2013-07-01 12:05:49,2013-07-01 12:05:49
88de53d4a86548016f245a1413b856aa334bc737...7f264e02f4480c49d1440be882416a10951c2165,18,81,2883,2964,43,2013-07-01 12:29:33,2013-07-01 11:53:06
7f264e02f4480c49d1440be882416a10951c2165...cfcf4b3605f9653e4e056088d89932b2a0e4281b,123,212,161,373,256,2013-07-01 12:29:33,2013-07-01 12:22:27
cfcf4b3605f9653e4e056088d89932b2a0e4281b...a6a905c619e48bb3db4a5fbb09e5e03abb7ed0f6,2,10,8,18,10,2013-07-01 13:19:55,2013-07-01 13:19:55
a6a905c619e48bb3db4a5fbb09e5e03abb7ed0f6...a521d103227be4e5660cf7a66bf98003696aa781,2,3,1,4,3,2013-07-01 13:36:31,2013-07-01 13:36:31
a521d103227be4e5660cf7a66bf98003696aa781...909433fa506dc3c8412cecb4439049acb9a3f447,7,23,49,72,18,2013-07-01 19:49:11,2013-07-01 19:49:11
909433fa506dc3c8412cecb4439049acb9a3f447...09b446dfe86f01f9d21e8c6351a31c5587a5b7a9,1,3,1,4,2,2013-07-01 20:46:35,2013-07-01 20:28:45
09b446dfe86f01f9d21e8c6351a31c5587a5b7a9...e021b87c0009c11aa2e62b62fc40b4b0209a8e5d,8,26,11,37,20,2013-07-01 20:49:07,2013-07-01 20:49:07
e021b87c0009c11aa2e62b62fc40b4b0209a8e5d...72c65fea41a6a01f24e134e7627417d94746291a,6,15,16,31,7,2013-07-01 20:50:58,2013-07-01 20:50:58
72c65fea41a6a01f24e134e7627417d94746291a...6a0374d03705b04872ac72af2be92aedbf0c213f,1,5,1,6,2,2013-07-01 21:16:25,2013-07-01 21:13:57
6a0374d03705b04872ac72af2be92aedbf0c213f...6c66a41c3dc697dc3bda4e31e8b05084d2ede915,2,4,12,16,3,2013-07-01 21:16:25,2013-07-01 21:14:44
273dc550a4eccdad958541f456332312b3369504...a9ea7d8c708c8265cccc17f23c62b2268d9e94f8,2,9,1,10,3,2013-06-26 14:30:58,2013-06-26 14:30:58
8faaf03b86030f242e35aebd56d9b969c53e7be9...8f09ec61f8d24fcd4ad4a4438be4d90300d55175,1,45,0,45,3,2013-10-30 22:08:12,2013-10-30 22:08:12
8f09ec61f8d24fcd4ad4a4438be4d90300d55175...47217f2f290264b0467a079492779cbf3cbfa4f0,1,1,9,10,1,2013-10-31 09:15:42,2013-10-31 09:15:42
8faaf03b86030f242e35aebd56d9b969c53e7be9...efb0100ee67931329f17bc9988ecd5f0619cea14,2,68,19,87,8,2013-10-30 20:40:15,2013-10-30 19:14:23
1a4b43521883ce85dfbda29b89822a59ffc5220b...f077f891986b3220f2b1223f491b0077595c0313,1,1,1,2,1,2013-05-27 08:14:38,2013-05-27 08:14:38
6c66a41c3dc697dc3bda4e31e8b05084d2ede915...8160e6341d160607f7898ea4a9c389e84d547763,1,1,1,2,1,2013-07-02 16:52:54,2013-07-02 16:52:54
b6a87f5c93efa5192433be1e45fc4e79d54efdc7...1184d077893ff1bc947e45b00a4d565f3df81776,13,164,23,187,34,2013-06-26 17:11:47,2013-06-21 20:59:33
a023a84c060eaaa4cf520c33d9c73adab7af3d30...726ded5708e4e8767e69a6f6f6a039e75667ce03,38,128,4,132,131,2013-10-31 15:42:28,2013-10-31 15:42:28
726ded5708e4e8767e69a6f6f6a039e75667ce03...0d9c1499901480ed52c08e1b94ecc80c7b55bc0e,1,8,0,8,1,2013-10-31 16:52:06,2013-10-31 16:45:51
0d9c1499901480ed52c08e1b94ecc80c7b55bc0e...c64efe37345cc632e24beb8c7e2a81ef5d3713ba,2,4,1,5,2,2013-10-31 17:15:54,2013-10-31 17:15:54
c64efe37345cc632e24beb8c7e2a81ef5d3713ba...f4f01fb03c2855d42b4d9589c0c090439e02c55b,1,30,0,30,1,2013-10-31 17:39:10,2013-10-31 12:38:51
f4f01fb03c2855d42b4d9589c0c090439e02c55b...2bba0d275bdf392deb144a6e83392a80d57c8c03,1,27,4,31,3,2013-11-01 09:31:01,2013-11-01 09:19:37
ae71e3134e87e4cb1631c4d85462ee76116774db...d467e117856a7fa6da5e90471144aaa82d822065,3,23,7,30,6,2013-05-27 09:25:29,2013-05-27 08:29:43
d467e117856a7fa6da5e90471144aaa82d822065...2a22540057d029507dc56c8203099887b35ed12d,1,4,3,7,1,2013-05-27 09:14:51,2013-05-27 09:14:16
2a22540057d029507dc56c8203099887b35ed12d...749c2e4333893671565124b1676f5398ef9d6368,1,1,1,2,1,2013-05-27 09:15:40,2013-05-27 09:15:40
ddf9ced5bc542c9ca9146450df752ed8ccdccc5f...3632d289dedc2e83cde1976e5a4cd00b08c799ee,2,5,5,10,4,2013-07-02 18:14:56,2013-07-02 18:14:56
3632d289dedc2e83cde1976e5a4cd00b08c799ee...8a679386c3924026f8558f9cd0164890a9461e2c,1,7,0,7,1,2013-07-03 12:44:03,2013-07-03 12:44:03
8a679386c3924026f8558f9cd0164890a9461e2c...63b2155919c017591e70782fb0ad92167a160f30,1,12,2,14,3,2013-07-03 14:09:20,2013-07-03 14:03:11
63b2155919c017591e70782fb0ad92167a160f30...c5bc98d7e1779263dc870843cab296f052e9a318,2,24,6,30,7,2013-07-03 14:36:21,2013-07-03 06:13:38
c5bc98d7e1779263dc870843cab296f052e9a318...067e0424ce8a0e15e2faac3f9f9fabe9b7667c72,1,9,2,11,4,2013-07-03 15:05:03,2013-07-02 08:19:44
067e0424ce8a0e15e2faac3f9f9fabe9b7667c72...8759778185d0539bf9c11e3fda497a9486b9acab,2,10,2,12,4,2013-07-03 18:09:58,2013-07-03 17:13:47
8759778185d0539bf9c11e3fda497a9486b9acab...231e31c690b020028940be76a1037297ba254ce0,1,5,3,8,1,2013-07-04 09:44:22,2013-07-04 09:44:22
231e31c690b020028940be76a1037297ba254ce0...428de2e3394873810645010020d65841ab72bb14,1,21,10,31,3,2013-07-04 11:53:13,2013-07-03 11:59:35
428de2e3394873810645010020d65841ab72bb14...f407f75aae242d1bd8d4ac7f19c5d4075353c65e,2,7,6,13,4,2013-07-04 13:32:32,2013-07-04 13:32:32
f407f75aae242d1bd8d4ac7f19c5d4075353c65e...da5069f68f9ec0cf80f50f6708d103afd56d23ae,1,3,2,5,1,2013-07-04 14:19:00,2013-07-04 14:19:00
1184d077893ff1bc947e45b00a4d565f3df81776...2ec54e7fbcec658844e3fd0515d9990291d954a6,1,1,1,2,1,2013-06-26 17:25:34,2013-06-26 17:25:34
2bba0d275bdf392deb144a6e83392a80d57c8c03...757945b47de45b6eaa0b0e14f87936261a60d227,1,17,2,19,4,2013-11-02 23:57:35,2013-11-02 23:57:35
2bba0d275bdf392deb144a6e83392a80d57c8c03...67c6c1a7cb2ef971497ba8827be5d6e781c0d2e8,1,2,2,4,2,2013-11-01 09:46:03,2013-11-01 09:43:27
67c6c1a7cb2ef971497ba8827be5d6e781c0d2e8...89116cf24a3efaaaad5d1168627b3ec84ef823cb,1,2,2,4,1,2013-11-01 09:59:16,2013-11-01 09:59:16
749c2e4333893671565124b1676f5398ef9d6368...b14bd604043ba1d89493558f4f6cb7a9bcf17923,1,35,46,81,11,2013-05-27 10:06:56,2013-05-27 09:54:14
b14bd604043ba1d89493558f4f6cb7a9bcf17923...7a923128278e9e07cd8e7ca50400ba24617825dd,1,1,1,2,1,2013-05-27 11:47:18,2013-05-23 09:55:59
7a923128278e9e07cd8e7ca50400ba24617825dd...37ea9f9c03b8ec4305ac978e85db653b432b9921,1,1,2,3,1,2013-05-27 12:05:03,2013-05-27 11:59:16
37ea9f9c03b8ec4305ac978e85db653b432b9921...6f8627dd7fd482007694dd1e4a99f9e207e6d8c2,4,15,3,18,5,2013-05-27 11:57:06,2013-05-24 17:30:37
749c2e4333893671565124b1676f5398ef9d6368...08726cb0136c9de88568e7d6b77249b817094660,1,1,1,2,1,2013-05-27 09:35:34,2013-05-27 09:34:14
da5069f68f9ec0cf80f50f6708d103afd56d23ae...2cbd579efe2d646814bd6cb7aca8bd43a96f14ae,2,27,1,28,3,2013-07-04 23:58:58,2013-07-04 23:58:58
da5069f68f9ec0cf80f50f6708d103afd56d23ae...62a826ab31ca0e399dcef1ea37b459c194cbf7b5,1,1,1,2,1,2013-07-04 19:31:58,2013-07-04 19:31:58
d17d60d38dbc443d713facc2d831bf05434ee43b...5005303ae7919eef26dab9f8ba279696966ebf1d,1,1,1,2,1,2013-06-27 07:42:09,2013-06-27 07:42:09
5005303ae7919eef26dab9f8ba279696966ebf1d...cab333cb16656cbb7d2bcfb06b2f7aeab9bac7af,2,36,10,46,6,2013-06-27 09:58:01,2013-06-25 20:41:00
cab333cb16656cbb7d2bcfb06b2f7aeab9bac7af...e26b589b8cd2c46c0e6af360abaacdb2fb0af27d,1,6,4,10,1,2013-06-27 13:02:00,2013-06-27 13:02:00
e26b589b8cd2c46c0e6af360abaacdb2fb0af27d...99b467f272da91b8894dc90d793d8d2c40b78d8c,3,40,8,48,16,2013-06-27 13:44:21,2013-06-27 13:44:21
99b467f272da91b8894dc90d793d8d2c40b78d8c...8db264cbc88e46eb8bc79e8e819a72f814db503e,1,8,2,10,1,2013-06-27 14:29:26,2013-06-27 14:29:26
881851f3bbfce226746482109d32e8e2f0f8f45e...6c1b55d61a3b2c5e401bf63c1c65d569217a130b,1,3,1,4,2,2013-11-03 08:52:40,2013-11-03 08:52:40
6c1b55d61a3b2c5e401bf63c1c65d569217a130b...4202d9cf0c359b5bb41247905454572b7f9644d9,1,1,0,1,1,2013-11-03 08:53:28,2013-11-03 08:53:28
4202d9cf0c359b5bb41247905454572b7f9644d9...539e3693d4712b249a95cfad8cfdeecdad1777a6,2,40,1,41,2,2013-11-03 10:27:54,2013-11-01 12:55:35
539e3693d4712b249a95cfad8cfdeecdad1777a6...f40f90d63b4be295269b5f0de5f919be22daba5c,2,7,2,9,3,2013-11-03 11:45:15,2013-11-03 11:45:15
89116cf24a3efaaaad5d1168627b3ec84ef823cb...c7dabe49ddba83df169080cac21988061c82a3ef,2,2,2,4,2,2013-11-01 14:15:36,2013-11-01 14:00:02
a64de33b791b4f1d8864dd0879b246c3cd5fa345...90af278203963e3e3f96e443971cd38a2dad34e4,5,23,5,28,6,2013-05-27 14:01:14,2013-05-24 20:36:09
90af278203963e3e3f96e443971cd38a2dad34e4...5e05ec3ea60a367f97ebf1321f79bf929446f07d,1,4,3,7,1,2013-05-27 14:28:57,2013-05-27 13:48:28
5e05ec3ea60a367f97ebf1321f79bf929446f07d...1e29428db292a8d2c5a4c6492ab1407834081235,1,9,3,12,2,2013-05-27 15:34:31,2013-05-27 15:34:31
1e29428db292a8d2c5a4c6492ab1407834081235...d194714c0a707773bd470bffb3d67a60e40bb787,7,340,1,341,9,2013-05-27 16:25:35,2013-02-08 23:45:26
d194714c0a707773bd470bffb3d67a60e40bb787...0268aba96bf91de3d172cd6ce2e44c3ce33ef7a0,4,57,5,62,10,2013-05-27 17:29:53,2013-05-27 16:31:49
0268aba96bf91de3d172cd6ce2e44c3ce33ef7a0...0027f1390443f199087d0784920450d93a359614,1,12,0,12,1,2013-05-27 18:12:47,2013-05-27 18:05:59
0027f1390443f199087d0784920450d93a359614...cd79f337233be3f2dfa22316314c9d4834093e31,4,78,95,173,11,2013-05-27 20:55:08,2013-05-27 20:41:39
cd79f337233be3f2dfa22316314c9d4834093e31...33dd8f544205be923e2a06106909ebcd3583526b,1,7,1,8,4,2013-05-28 05:55:04,2013-05-28 05:53:52
33dd8f544205be923e2a06106909ebcd3583526b...8365d76da01af1d4391cba32d62178791d074b06,1,40,3,43,2,2013-05-28 12:41:13,2013-05-28 12:41:13
8365d76da01af1d4391cba32d62178791d074b06...d321d1acf0fdf00247e78b9686be84c18b35b9d8,3,41,3,44,5,2013-05-28 14:04:07,2013-05-28 13:56:14
d321d1acf0fdf00247e78b9686be84c18b35b9d8...1fdc3d256d5d515bd0b4646ad57f231a2359e0cd,1,1,1,2,1,2013-05-28 15:54:53,2013-05-28 15:54:53
3e60cc2992ad963b22c2ba879a1efe98510ef77c...b9fceadfd440daec09dee3c7c9d01997f94ec94f,1,16,2,18,2,2013-07-05 10:54:10,2013-07-05 10:53:19
b9fceadfd440daec09dee3c7c9d01997f94ec94f...577b0f91894469872974ad609b4fabca949cdc1b,1,5,8,13,3,2013-07-05 11:20:37,2013-07-05 11:20:05
577b0f91894469872974ad609b4fabca949cdc1b...7442eb1a242ecf9d186d4e7de1b94e360e04782d,24,65,24,89,39,2013-07-05 17:27:07,2013-07-04 13:19:33
7442eb1a242ecf9d186d4e7de1b94e360e04782d...1116df0751cc0d5862590b08adfffe7bacd6bf43,1,7,0,7,2,2013-07-05 17:33:19,2013-07-05 17:33:19
f40f90d63b4be295269b5f0de5f919be22daba5c...08e2ecee3b542fb4186be8da3b0cc2af628df0a1,1,3,3,6,3,2013-11-03 13:16:48,2013-11-03 13:16:48
ede04f94bd0efe1fe9354c58b3a7ca918fd11ea6...090315f5dfb9b0a6539daaec6cb88ad93e6e77af,4,5,5,10,4,2013-11-02 01:29:39,2013-11-02 01:29:39
1fdc3d256d5d515bd0b4646ad57f231a2359e0cd...01ae881bb4d13d6fe1b77f8758cc0bc72786cfaa,3,3,3,6,3,2013-05-29 22:11:26,2013-05-29 22:11:26
1fdc3d256d5d515bd0b4646ad57f231a2359e0cd...a2967d5204729771e3716c431ea98f8ee8562d3e,2,11,0,11,2,2013-05-28 17:37:44,2013-05-28 17:35:08
a2967d5204729771e3716c431ea98f8ee8562d3e...ded95ccdce0ba983c405ddde9eb071e454245a94,5,23,6,29,11,2013-05-28 19:12:47,2013-05-28 19:11:41
ded95ccdce0ba983c405ddde9eb071e454245a94...8a6e040bfa58c69ba9760a67d7d2e714bffccfc1,1,2,0,2,1,2013-05-29 00:14:01,2013-05-29 00:14:01
8a6e040bfa58c69ba9760a67d7d2e714bffccfc1...7426e72302db9c8c78235afc5c335a437a7ad760,1,11,0,11,1,2013-05-29 12:49:42,2013-05-29 12:48:02
7426e72302db9c8c78235afc5c335a437a7ad760...5939864616d56cf949f0bca348a8e05230b62fe0,2,40,1,41,3,2013-05-29 13:23:08,2013-05-29 13:23:08
5939864616d56cf949f0bca348a8e05230b62fe0...8010289ea2f30f0bb819feba7ec78e67c198023b,3,27,25,52,11,2013-05-29 13:50:26,2013-05-29 13:47:21
8010289ea2f30f0bb819feba7ec78e67c198023b...d727518ad61beda4d9c2b744c9c05a805aa23ed1,3,50,8,58,10,2013-05-29 15:25:42,2013-05-29 14:55:56
d727518ad61beda4d9c2b744c9c05a805aa23ed1...dcd915fcab3841aa3b59122476c128ae3cb9e53c,1,3,3,6,3,2013-05-29 19:38:52,2013-05-29 19:38:52
dcd915fcab3841aa3b59122476c128ae3cb9e53c...e6ff238431ebfdfe957ca05dea5f69d3750d7f22,1,2,0,2,1,2013-05-30 01:46:58,2013-05-29 22:33:51
e6ff238431ebfdfe957ca05dea5f69d3750d7f22...bb80d2976bdf785a0cedd52945c8f3f55a20ace5,1,34,53,87,5,2013-05-30 05:46:31,2013-05-30 05:30:29
bb80d2976bdf785a0cedd52945c8f3f55a20ace5...69f7db153d8108dcef033207d49f4c80febf3d70,3,55,8,63,10,2013-05-30 05:46:31,2013-05-30 05:16:09
69f7db153d8108dcef033207d49f4c80febf3d70...59235816bd063cb8b24acfc92ae1b5cd09a1f7ba,3,24,4,28,4,2013-05-30 14:19:13,2013-05-29 17:47:49
59235816bd063cb8b24acfc92ae1b5cd09a1f7ba...616f3c4a795ba6d74c5f28d200d1921e998232f4,1,11,11,22,3,2013-05-30 14:48:30,2013-05-30 14:25:11
616f3c4a795ba6d74c5f28d200d1921e998232f4...5074c75a37f88726f3ae057999144545881d3cfc,4,21,1,22,5,2013-05-30 15:06:05,2013-05-30 15:05:42
1116df0751cc0d5862590b08adfffe7bacd6bf43...4367c637d6989ad2bef2168e46485c65dd503b82,1,1,1,2,1,2013-07-06 12:26:28,2013-07-06 12:26:28
4367c637d6989ad2bef2168e46485c65dd503b82...de676f94b7de1db0c04d089d087e301701135449,1,19,0,19,1,2013-07-06 15:18:53,2013-07-06 15:18:53
de676f94b7de1db0c04d089d087e301701135449...c94093c5bae0f8d9c29a2eeda2de2ea85a0c3ca6,2,1,10,11,3,2013-07-06 15:25:46,2013-07-06 15:25:46
c94093c5bae0f8d9c29a2eeda2de2ea85a0c3ca6...2d96e660f9fb5cbc16de74f29d66daee6d8eaa44,1,7,0,7,1,2013-07-06 22:33:45,2013-07-06 22:31:59
2d96e660f9fb5cbc16de74f29d66daee6d8eaa44...d63327d84368b834793374c4a73d88f94a1e85da,1,2,1,3,1,2013-07-07 16:40:05,2013-07-07 01:24:38
d63327d84368b834793374c4a73d88f94a1e85da...c8c22ccdcb7d16f817f59807ae1199c8f93158ed,1,1,4,5,2,2013-07-07 22:49:58,2013-07-07 22:49:58
c8c22ccdcb7d16f817f59807ae1199c8f93158ed...d66bd1dfb9e090154e586680023aa2b1f22e735d,1,1,0,1,1,2013-07-07 22:51:29,2013-07-07 22:51:29
1116df0751cc0d5862590b08adfffe7bacd6bf43...76ee39ce14b851a8247c3111de0fbc91db4de1b1,1,25,22,47,8,2013-07-05 20:39:52,2013-06-22 12:56:55
090315f5dfb9b0a6539daaec6cb88ad93e6e77af...61074353864293d3ea51e51e09cf4deedee12963,5,89,19,108,12,2013-11-02 10:22:30,2013-11-02 08:30:39
61074353864293d3ea51e51e09cf4deedee12963...073b974e6613adc88cade7d34af701e52e2cc8fd,1,8,2,10,2,2013-11-02 13:52:28,2013-11-01 18:55:40
090315f5dfb9b0a6539daaec6cb88ad93e6e77af...c3936c0d79d79aced25ceba8beff0c91a6b5c2ed,7,82,5,87,10,2013-11-02 09:29:07,2013-11-02 09:28:22
126250a4c422f66469eb70d792dcfd65b1ac5178...db2727f9524f46e0af1aed581a03ffeac4fbaafe,1,14,10,24,10,2013-07-07 23:26:52,2013-07-07 23:26:52
db2727f9524f46e0af1aed581a03ffeac4fbaafe...626fa28878b1167d20d2419d68d561297390510a,3,39,1,40,2,2013-07-07 23:35:08,2013-07-07 23:35:08
7288e1b02b2504b1694fe14df2d81e6a354c5610...c347f78cc1b2a06958f692f0622deceac534dc6b,51,150,150,300,108,2013-11-03 18:08:55,2013-11-03 18:08:55
c347f78cc1b2a06958f692f0622deceac534dc6b...f67e18f39eef898ee99120bb3913a34a1c118089,14,37,37,74,32,2013-11-03 18:17:58,2013-11-03 18:17:58
f67e18f39eef898ee99120bb3913a34a1c118089...9b95fa7777c4b484f8053b87f48d65c853945f19,2,50,4,54,8,2013-11-03 19:05:10,2013-11-03 08:18:48
8b3d9d96ed8304d749c9056c42be89084d9b34aa...19256f300e44b0a682f76fc1dda673862bae49d1,67,171,2,173,171,2013-11-02 17:18:46,2013-11-02 17:18:46
19256f300e44b0a682f76fc1dda673862bae49d1...99b681e227b5b7880d6edd0d8dd670034d431859,5,89,45,134,46,2013-11-02 18:03:13,2013-10-28 14:00:54
99b681e227b5b7880d6edd0d8dd670034d431859...88b9d4ff3aefbe1f0f01de684d300770276add1d,1,2,2,4,2,2013-11-02 18:13:29,2013-11-02 18:13:29
88b9d4ff3aefbe1f0f01de684d300770276add1d...b44d42be6d05e88071844b64c6519223cdd2fa80,2,27,4,31,8,2013-11-02 18:44:19,2013-11-02 18:39:56
9b95fa7777c4b484f8053b87f48d65c853945f19...9c5f6cd565f1bc519dec20e3e44313cb8d8e0e94,4,38,5,43,8,2013-11-07 18:06:32,2013-10-28 19:34:09
9b95fa7777c4b484f8053b87f48d65c853945f19...8ecba51ea0e3a70a6cb0d823acc6f660007081dc,1,12,12,24,1,2013-11-04 17:45:27,2013-11-04 17:45:27
8ecba51ea0e3a70a6cb0d823acc6f660007081dc...37a2e70cec08b365f3ec00bf4d91794ccb368daa,1,72,33,105,10,2013-11-04 21:37:36,2013-11-04 20:55:52
9b95fa7777c4b484f8053b87f48d65c853945f19...cb32175bfde5733cffc45be34448b236411a589f,1,5,2,7,3,2013-11-04 00:14:24,2013-10-02 13:27:38
b44d42be6d05e88071844b64c6519223cdd2fa80...d0669843d0310a5c633548686ad8ce19404fc594,4,28,3,31,6,2013-11-03 08:36:09,2013-10-28 15:57:56
b44d42be6d05e88071844b64c6519223cdd2fa80...dcfc8fa9721955dc4fcfb6e5e506be12f74c5b85,18,59,59,118,48,2013-11-02 19:27:47,2013-11-02 19:27:47
b44d42be6d05e88071844b64c6519223cdd2fa80...9367b9e828eac9130b08eff42d7d0ab9b9110a86,3,5,5,10,5,2013-11-02 19:15:40,2013-11-02 19:13:36
30203a0deaf82c8af26b1b5453851f83d2248b67...7a7c789d5a7ce1c62e3739cb2624454189410ece,8,103,9,112,24,2013-11-07 22:52:17,2013-11-02 19:01:17
7a7c789d5a7ce1c62e3739cb2624454189410ece...536c44782007bf35dd17c1fd2c8551cb4ddd967b,3,1,2,3,3,2013-11-08 01:10:25,2013-11-08 01:10:25
536c44782007bf35dd17c1fd2c8551cb4ddd967b...f2e0266be766b0b6149377b90ae3ddc41c91c3fb,2,20,3,23,4,2013-11-08 09:47:36,2013-11-07 11:30:04
f2e0266be766b0b6149377b90ae3ddc41c91c3fb...b780d03d624e712d7b1f6b6796058b950e975675,1,0,22,22,2,2013-11-08 15:47:19,2013-11-08 15:47:19
b780d03d624e712d7b1f6b6796058b950e975675...bc21e9c0d9253f9d49a0063830a645d1c724c696,4,30,146,176,21,2013-11-08 15:58:17,2013-10-31 16:27:21
bc21e9c0d9253f9d49a0063830a645d1c724c696...72f63bd24d44b5a4f24ad8fa27ebba96d9a507d8,5,16,3,19,7,2013-11-08 16:10:37,2013-11-04 15:50:14
72f63bd24d44b5a4f24ad8fa27ebba96d9a507d8...60d27fe7da57ad2325157296d97f35aaf8546da5,1,1,1,2,1,2013-11-08 16:25:17,2013-11-08 16:25:17
60d27fe7da57ad2325157296d97f35aaf8546da5...ccd11c09c3bea966606f5c68dd2246b0c6757f65,1,1,0,1,1,2013-11-08 17:03:59,2013-11-08 17:03:59
ccd11c09c3bea966606f5c68dd2246b0c6757f65...413307fe355d90a089411e4b08cf6aa44db7ce0f,1,1,1,2,1,2013-11-08 22:20:50,2013-11-08 22:20:50
413307fe355d90a089411e4b08cf6aa44db7ce0f...cab72a439b4d97a5659437373d06fc613e06e0bc,1,1,1,2,1,2013-11-08 23:38:45,2013-11-08 02:24:55
cab72a439b4d97a5659437373d06fc613e06e0bc...a8e84521c4e413ab1c50edd94ebd8a4724b6a851,1,6,3,9,4,2013-11-09 00:24:31,2013-11-03 16:55:11
cb2c3ce15443a0666646e8b60984830c38d3ecde...c0a2388a1c4ead1afaec98e4ebc953a772ca3849,17,2593,2,2595,15,2013-11-04 22:03:28,2013-11-04 17:31:34
1830f50493cae042dac11957af986b0fd84f889f...e953c78eeb81ee69dccd356145563fd6f9e4c7b6,3,36,24,60,10,2013-11-09 08:42:17,2013-11-09 08:41:03
e953c78eeb81ee69dccd356145563fd6f9e4c7b6...3c10d1e64faeb67b41e7aa501b21252e357a4564,1,0,3,3,1,2013-11-09 08:51:05,2013-11-09 08:51:05
3c10d1e64faeb67b41e7aa501b21252e357a4564...7e714827ead50f77aa82394cc2511ff96ab67fa4,2,7,4,11,4,2013-11-09 10:28:16,2013-11-09 10:21:53
7e714827ead50f77aa82394cc2511ff96ab67fa4...e6dd70b4dba3b7d812fecda7288c9707990ea71b,3,17,3,20,3,2013-11-09 11:11:58,2013-11-09 11:11:58
e6dd70b4dba3b7d812fecda7288c9707990ea71b...14c1872d29a662689a316ef9ab1ccdd82d3ca906,1,11,11,22,4,2013-11-09 11:39:55,2013-11-08 01:11:37
14c1872d29a662689a316ef9ab1ccdd82d3ca906...10a39debb2b95b41c8c4ec53247a3d1efe6c7f1b,1,5,2,7,1,2013-11-09 12:18:46,2013-11-09 10:27:37
10a39debb2b95b41c8c4ec53247a3d1efe6c7f1b...c82e850eed2eb3957ed792908b73622ebd3034a7,1,1,1,2,1,2013-11-09 14:08:57,2013-11-09 14:08:57
c82e850eed2eb3957ed792908b73622ebd3034a7...f4a6c9aa1309a70ca9f52bf26c3ea367bb32bd48,1,3,3,6,1,2013-11-09 14:38:47,2013-11-09 14:38:47
f4a6c9aa1309a70ca9f52bf26c3ea367bb32bd48...af2dc4ebb84a6b0ceb68edd79fcc6ec4bf313325,1,1,1,2,1,2013-11-09 15:09:25,2013-11-09 15:09:25
af2dc4ebb84a6b0ceb68edd79fcc6ec4bf313325...d15985d81ff1c3b353a48a87189b7847798214c0,3,18,1,19,4,2013-11-09 15:11:50,2013-11-09 11:36:10
d15985d81ff1c3b353a48a87189b7847798214c0...98de90d3d81f5db9e969e70b8ce3f0e368726208,5,6,6,12,6,2013-11-09 15:17:17,2013-11-09 15:17:17
98de90d3d81f5db9e969e70b8ce3f0e368726208...e7383f16b438a03ea2258a49e4889fd6e2303e53,2,3,11,14,4,2013-11-09 15:23:14,2013-11-09 09:13:29
e7383f16b438a03ea2258a49e4889fd6e2303e53...8bc350b38516d8c3a14aed113dd3402b9375b75c,2,14,34,48,10,2013-11-09 22:56:53,2013-11-09 10:32:19
8bc350b38516d8c3a14aed113dd3402b9375b75c...6c5f5b9a414b8bdfafc45db5710acf200cca9885,1,1,1,2,1,2013-11-10 11:10:13,2013-11-10 11:10:13
ee48f4af99a8b5666339f927c459253f9f98e91f...4ad9f4d4eaeec0fc5bcd3cef029d49ca23975dba,1,5,1,6,5,2013-11-02 19:55:36,2013-11-02 19:55:36
ee48f4af99a8b5666339f927c459253f9f98e91f...e737c009b81df4a0126d61234e1d55f19956a78b,25,303,281,584,132,2013-11-02 19:45:40,2013-11-02 19:37:48
18c642b96c5160d13971f7699a43d0f672435b26...9f76ea1eaad0db0183fa3b5bade16392db0cafbd,3,24,1,25,3,2013-11-02 19:18:35,2013-11-02 19:16:33
9f76ea1eaad0db0183fa3b5bade16392db0cafbd...36ded01527b690b5df0574492af9cfcc2ea3d1dc,116,248,181,429,160,2013-11-02 19:24:56,2013-10-18 11:25:30
859a20560ebd44d917e564d16f3f5f7091c7d823...da235c9a8469b1fe813c1e51593e6b915892eb6a,1,13,4,17,2,2013-11-04 22:29:09,2013-11-04 22:28:38
da235c9a8469b1fe813c1e51593e6b915892eb6a...bdca4944647a734fab592ab08c6311e365231287,1,1,1,2,1,2013-11-04 22:57:43,2013-11-04 22:57:43
bdca4944647a734fab592ab08c6311e365231287...8a0489221eb20f9687125cabda64bb16ea3bad0b,2,0,3,3,3,2013-11-05 17:17:50,2013-11-05 17:17:50
8a0489221eb20f9687125cabda64bb16ea3bad0b...76da053641e52db540801e18b362497c01e9bb1d,1,24,1,25,2,2013-11-05 18:02:24,2013-11-05 18:02:24
76da053641e52db540801e18b362497c01e9bb1d...e5e044da87800feb6ef63fef1765d8c05022d926,4,51,24,75,9,2013-11-05 18:26:58,2013-11-05 09:54:23
e5e044da87800feb6ef63fef1765d8c05022d926...79716dcca8a83f298d3d744080f713e499726c23,1,2,2,4,1,2013-11-05 18:51:54,2013-11-05 18:51:54
79716dcca8a83f298d3d744080f713e499726c23...c349bcbdf9c3520a0050bddf49ea59d9418c3ecb,1,7,6,13,2,2013-11-05 20:02:33,2013-11-05 20:02:33
c349bcbdf9c3520a0050bddf49ea59d9418c3ecb...b914991b3705cb6c91013d962c55cda9deb18d83,2,35,0,35,2,2013-11-05 23:26:58,2013-11-05 23:17:28
b914991b3705cb6c91013d962c55cda9deb18d83...87908b4fc2faa7696833448594f493257c7596d2,1,2,1,3,1,2013-11-06 00:38:46,2013-11-06 00:38:46
87908b4fc2faa7696833448594f493257c7596d2...a9093dd3763df6b2045a08b0520f248bda708723,1,2,2,4,1,2013-11-06 03:35:20,2013-11-06 03:35:20
a9093dd3763df6b2045a08b0520f248bda708723...3c4832214ff78e704679d7c7410d3fb8da80df78,1,1,1,2,1,2013-11-06 09:22:29,2013-11-06 09:22:29
3c4832214ff78e704679d7c7410d3fb8da80df78...366bdc45661038c199ff7f268d045f6b7cb5c398,4,4,4,8,4,2013-11-06 09:47:07,2013-11-06 09:47:07
366bdc45661038c199ff7f268d045f6b7cb5c398...8265323c9169e95e9e765aa976b0e8065f0bd484,1,8,6,14,5,2013-11-06 11:27:35,2013-11-05 19:49:19
8265323c9169e95e9e765aa976b0e8065f0bd484...106b019dc9b48aa749947e406e5445feb045e8a2,7,520,19,539,29,2013-11-06 13:47:58,2013-11-06 13:47:58
106b019dc9b48aa749947e406e5445feb045e8a2...c7bf4c27a0b82c6d33622c648a6016b68c9f44d9,1,12,3,15,4,2013-11-06 15:27:08,2013-11-06 15:27:08
c7bf4c27a0b82c6d33622c648a6016b68c9f44d9...f16abe44a1ec1dda46a962af4d32405b20c78c1c,1,5,3,8,2,2013-11-06 17:05:40,2013-11-06 17:05:16
f16abe44a1ec1dda46a962af4d32405b20c78c1c...e5b7045422d8e02de8aa05a69f689fa91fcbbeba,5,29,29,58,16,2013-11-07 04:00:48,2013-11-07 04:00:48
e5b7045422d8e02de8aa05a69f689fa91fcbbeba...ae029b440a3125937802d261e151206fda427145,1,5,3,8,2,2013-11-07 07:17:17,2013-11-07 07:17:17
ae029b440a3125937802d261e151206fda427145...6fe2b001dba45134d7c10729c57959995e241a88,4,161,137,298,39,2013-11-07 10:53:26,2013-11-04 16:04:57
6fe2b001dba45134d7c10729c57959995e241a88...e7b61e571788b7d3efc1ba704dd908f828340255,1,4,0,4,1,2013-11-07 10:57:02,2013-11-05 17:26:59
e7b61e571788b7d3efc1ba704dd908f828340255...ba6c9fae452d3e4260ed0c1c74230da74f74f665,2,16,37,53,22,2013-11-07 10:57:02,2013-11-06 19:31:19
ba6c9fae452d3e4260ed0c1c74230da74f74f665...ccbba98131ace3beb43790c65e8f4eee94e9631c,1,1,7,8,2,2013-11-07 10:57:02,2013-11-06 19:32:29
ccbba98131ace3beb43790c65e8f4eee94e9631c...b1b04df06522b092a9b4768d2d61c52956e00eca,3,53,17,70,9,2013-11-07 12:29:50,2013-10-10 21:12:10
b1b04df06522b092a9b4768d2d61c52956e00eca...f51c1f590085556abca44fd2a49618162203b2ec,9,616,65,681,51,2013-11-07 12:49:49,2013-11-06 17:25:05
f51c1f590085556abca44fd2a49618162203b2ec...ac2d86f8d31b8acca4b1ee362b1bff154bd37eab,1,6,0,6,2,2013-11-07 13:45:59,2013-11-07 11:43:19
ac2d86f8d31b8acca4b1ee362b1bff154bd37eab...7be638390e18fcbfaaed638f9908673360c280d3,3,142,144,286,33,2013-11-07 14:12:15,2013-08-26 14:34:02
7be638390e18fcbfaaed638f9908673360c280d3...3935b0f2634d200b122079eb7bf82d9cd4f4c511,1,1,1,2,1,2013-11-07 14:31:44,2013-11-05 11:25:19
3935b0f2634d200b122079eb7bf82d9cd4f4c511...c29dd76f401853508e684b737697566eb719e7e0,2,15,0,15,2,2013-11-07 14:42:25,2013-11-07 14:42:25
6c5f5b9a414b8bdfafc45db5710acf200cca9885...9b7455e918a437c3db91e88dcbf6d9c93fef96f8,13,254,38,292,42,2013-11-11 07:53:09,2013-11-01 20:15:41
9b7455e918a437c3db91e88dcbf6d9c93fef96f8...6010b5360f9cb228c19e1d1f85e1b63a11ec6d35,1,3,3,6,1,2013-11-11 09:43:17,2013-11-11 09:43:17
6010b5360f9cb228c19e1d1f85e1b63a11ec6d35...dbbd10e75f2f078909d231b2fd5ca1a351726faa,1,3,1,4,2,2013-11-11 09:46:24,2013-11-11 09:46:24
6c5f5b9a414b8bdfafc45db5710acf200cca9885...a17fc3623119b89fba9cf568b24fd94ae32a54a2,1,47,14,61,9,2013-11-11 07:46:54,2013-11-11 07:46:54
65c4ac3b2434d1828cb76c9f4454fe64e81354ee...7548aa8ffd46eb6e0f73730d1b2eb515ba581f95,150,433,1,434,427,2013-11-02 20:12:09,2013-11-02 20:12:09
7548aa8ffd46eb6e0f73730d1b2eb515ba581f95...bec0b2a8c637ba2dc3745ad0c1e68ccc6c2f78bd,4,86,4,90,11,2013-11-02 20:35:45,2013-11-02 20:35:45
bec0b2a8c637ba2dc3745ad0c1e68ccc6c2f78bd...2a03a9a9a1c4517be75e72899e545b0bc9dd0688,1,0,3,3,1,2013-11-02 20:42:42,2013-11-02 20:42:42
15592a04d769782e0bd98f07e96ed1c406f51c01...2397daab4a1b95a055514b009818730f4dfc4799,2,64,27,91,10,2013-11-11 10:43:09,2013-11-05 13:30:31
2397daab4a1b95a055514b009818730f4dfc4799...dffcc5e97988d92b2b8a3bba23a49bcb3cf5d040,1,2,2,4,2,2013-11-11 10:51:38,2013-11-11 10:49:48
2a03a9a9a1c4517be75e72899e545b0bc9dd0688...c3791463a5a9674f8e0148fbab57eae23c138896,98,748,96,844,674,2013-11-03 04:48:47,2013-11-02 21:34:05
c3791463a5a9674f8e0148fbab57eae23c138896...8eec2d93b6e93b8a1107fb3de2acd68d6994d6ec,152,630,630,1260,381,2013-11-03 04:50:33,2013-11-02 21:02:56
8eec2d93b6e93b8a1107fb3de2acd68d6994d6ec...3f115776e1ffaf7b48976f88faf36c423e544d1d,16,172,5,177,171,2013-11-03 04:50:38,2013-11-02 22:50:35
3f115776e1ffaf7b48976f88faf36c423e544d1d...5732bc52f1d8f65cb35e19f0621d051233913fe8,30,260,1,261,258,2013-11-03 04:50:48,2013-11-02 23:53:29
5732bc52f1d8f65cb35e19f0621d051233913fe8...776ee92f00c22c009a4db0fb4ce50284ca29d6fb,1,9,46,55,45,2013-11-03 04:50:48,2013-11-03 00:11:21
776ee92f00c22c009a4db0fb4ce50284ca29d6fb...8f85e734581d3c63905b991fc82fe05e7a1df709,1,8,8,16,8,2013-11-03 04:50:48,2013-11-03 00:20:53
8f85e734581d3c63905b991fc82fe05e7a1df709...0fdb692c6c94d912f17a3e2ad12413fb072d38ec,18,188,0,188,188,2013-11-03 04:50:48,2013-11-03 00:37:15
0fdb692c6c94d912f17a3e2ad12413fb072d38ec...7a61c68c50d3837c50e35c252fd76220f08b5290,128,739,206,945,696,2013-11-03 04:50:49,2013-11-03 04:36:09
2a03a9a9a1c4517be75e72899e545b0bc9dd0688...3bc0d46a840f17dce561daca8a6b8690b2cf5d0a,154,647,647,1294,390,2013-11-02 22:20:39,2013-11-02 21:02:56
dffcc5e97988d92b2b8a3bba23a49bcb3cf5d040...f67cce0434907ef00db25577d46fdd04c0ad765d,1,1,1,2,1,2013-11-11 14:48:48,2013-11-11 14:48:33
f67cce0434907ef00db25577d46fdd04c0ad765d...d87127655f540747e7dc83badc015ea520b880f5,4,47,6,53,7,2013-11-11 16:58:02,2013-11-07 15:50:51
d87127655f540747e7dc83badc015ea520b880f5...5fda9c9810dfdf36b557e10d0d76775a72b0e0c6,1,1,1,2,1,2013-11-11 17:03:01,2013-11-11 17:03:01
dffcc5e97988d92b2b8a3bba23a49bcb3cf5d040...4142d151025d6169d67b513c4569603d0e751a6d,35,13,13,26,5,2013-11-11 12:34:01,2013-11-11 08:05:17
3bc0d46a840f17dce561daca8a6b8690b2cf5d0a...e2ae8b048e7198428f696375b8bdcd89e90002d1,30,260,1,261,258,2013-11-02 23:53:29,2013-11-02 23:53:29
e2ae8b048e7198428f696375b8bdcd89e90002d1...8d7ddec17cbf99c3887f191a4472ecaabe0f6cf6,1,9,46,55,45,2013-11-03 00:11:21,2013-11-03 00:11:21
8d7ddec17cbf99c3887f191a4472ecaabe0f6cf6...e459893e3454e60cb55f9995106324d5f2a8643f,1,8,8,16,8,2013-11-03 00:20:53,2013-11-03 00:20:53
0be7f57a9067c1596ece496e50a796b2529452bc...bc742ca110ca06b220261d37b985ecbfb7ebbaab,3,1,4,5,4,2013-11-11 22:05:14,2013-11-11 22:05:14
bc742ca110ca06b220261d37b985ecbfb7ebbaab...8ed96464e99c73150ab6eff5df70b6274a871a4a,1,1,1,2,1,2013-11-12 17:45:35,2013-11-12 16:06:45
8ed96464e99c73150ab6eff5df70b6274a871a4a...9aa6d4bdb6618ba4f17acc7b7c0d1462d6cbc718,1,6,10,16,3,2013-11-12 19:27:21,2013-11-12 19:27:21
9aa6d4bdb6618ba4f17acc7b7c0d1462d6cbc718...0048ed77c7016a03aed6dbc255a6372f3df2ccd5,1,5,5,10,2,2013-11-12 19:42:44,2013-11-12 19:42:44
0048ed77c7016a03aed6dbc255a6372f3df2ccd5...cb83448891f2920c926f61826d8eae4051a3d8f2,3,56,6,62,10,2013-11-13 05:35:34,2013-11-13 04:42:12
cb83448891f2920c926f61826d8eae4051a3d8f2...94d567ba30ce962fe395e61db492256972970364,1,3,0,3,1,2013-11-13 17:24:15,2013-11-13 17:24:15
94d567ba30ce962fe395e61db492256972970364...4301d6fa364623b0847f042e7bd6e37e03dcd752,1,25,0,25,1,2013-11-14 16:03:53,2013-11-06 20:11:54
393cdbfaa2d47c85f6764e80600de48f26f43327...fe995e6cbdcf2766cf0aa951c8ef4549ad27694c,19,199,0,199,199,2013-11-03 00:37:15,2013-11-03 00:37:15
4301d6fa364623b0847f042e7bd6e37e03dcd752...3560ef043e5c70de30ca7d5d7d6d09c150eb6eb4,2,25,1,26,3,2013-11-14 20:02:26,2013-11-14 19:55:13
fe995e6cbdcf2766cf0aa951c8ef4549ad27694c...cbc7cbbc5b5ef03059d8876074560635f2f647b7,24,194,194,388,58,2013-11-03 09:22:11,2013-11-03 09:22:11
3e845b79ce9f74c0942e2c41259d33bd835f2941...17ed99f3a3eea4bd27fa34be59c3582616ed8079,2,22,1,23,4,2013-11-14 20:36:55,2013-11-14 09:32:55
17ed99f3a3eea4bd27fa34be59c3582616ed8079...8e6d1b97921dd3ead6afd5eb39fcd2c82244e106,1,5,0,5,1,2013-11-14 22:13:20,2013-11-14 22:13:20
8e6d1b97921dd3ead6afd5eb39fcd2c82244e106...6e9e6ca0712cf1d2d0874ea5c8b63140804605a5,1,1,1,2,1,2013-11-15 12:09:46,2013-11-15 12:09:46
8e6d1b97921dd3ead6afd5eb39fcd2c82244e106...32e75803be8b3e9c35e6735c265125c4130ffabc,1,2,2,4,1,2013-11-15 03:55:29,2013-11-15 03:55:29
a90ffcac218e6783f931d3a44eca4d830b9315ba...10a09b8e609b93c2b2500368c33d9db81906009b,4,4,4,8,4,2013-11-15 13:23:14,2013-11-15 13:23:10
10a09b8e609b93c2b2500368c33d9db81906009b...3ccc0253f2a29fe6f3227ca96dcab20143188b21,1,4,4,8,2,2013-11-15 13:39:40,2013-11-15 13:38:23
3ccc0253f2a29fe6f3227ca96dcab20143188b21...8ca3963ab2a2cafb224f04759ec2d6c493fdb99d,1,3,4,7,2,2013-11-15 13:51:17,2013-11-11 16:07:52
8ca3963ab2a2cafb224f04759ec2d6c493fdb99d...115fd140ab9522e6ac688f389db681d79562df74,1,4,4,8,2,2013-11-15 14:30:22,2013-11-15 13:39:23
115fd140ab9522e6ac688f389db681d79562df74...7e0ebd74c107e3267b1df438ed7f061f8be5cf05,1,20,12,32,8,2013-11-15 14:32:46,2013-11-13 19:16:39
7e0ebd74c107e3267b1df438ed7f061f8be5cf05...d011714002d4d8d73440149f24aa86142caf886f,1,1,1,2,1,2013-11-15 15:21:58,2013-11-15 15:21:58
d011714002d4d8d73440149f24aa86142caf886f...ceecc962ad8f6bbbc2b989aec53eee6c6cca04b9,2,17,1,18,2,2013-11-16 00:09:35,2013-11-15 23:54:20
ceecc962ad8f6bbbc2b989aec53eee6c6cca04b9...b642d540d4ef2e72b0a89fe95b8777702ce08973,1,5,3,8,3,2013-11-16 10:13:04,2013-11-16 10:13:04
b642d540d4ef2e72b0a89fe95b8777702ce08973...0e079e4331a8be4dbd18d5e5776116330b0a5e61,5,35,6,41,9,2013-11-16 18:07:35,2013-11-12 19:35:52
0e079e4331a8be4dbd18d5e5776116330b0a5e61...326539f6a4936cda031b4a5f7caad788569f3329,1,5,1,6,1,2013-11-16 18:54:36,2013-11-16 18:51:47
326539f6a4936cda031b4a5f7caad788569f3329...2b7fc3629571b0a96247f5f92d6bd15767ecd122,1,2,0,2,1,2013-11-17 20:22:06,2013-11-17 20:22:06
2b7fc3629571b0a96247f5f92d6bd15767ecd122...b2d2d7e60f8faec060d753d93d009a436559d807,13,0,0,0,0,2013-11-18 02:33:28,2013-11-18 02:33:28
7ad3ab081cf540808a503f9dd18e7720a239bf22...ffdae5b66d681145d6e9288fd98718e6c7b263e4,1,12,4,16,1,2013-11-18 12:58:43,2013-11-18 12:58:43
ffdae5b66d681145d6e9288fd98718e6c7b263e4...ba63b9895b478c0093e61c288df0ff053ad726a8,1,4,0,4,1,2013-11-18 14:32:25,2013-11-18 14:32:25
ba63b9895b478c0093e61c288df0ff053ad726a8...4a00f132e0cc5246f7e7bd04b6d84a9d9ea4a0c1,1,5,0,5,1,2013-11-18 17:08:59,2013-11-18 17:06:57
4a00f132e0cc5246f7e7bd04b6d84a9d9ea4a0c1...a0f3eeccf3d5a90f9914bfe20b15df05673ea59d,4,51,7,58,11,2013-11-18 17:24:56,2013-11-18 17:24:56
a0f3eeccf3d5a90f9914bfe20b15df05673ea59d...058e4340640fb229a822c4313a710bd59419bd7a,5,204,241,445,21,2013-11-18 17:42:51,2013-11-18 17:27:09
058e4340640fb229a822c4313a710bd59419bd7a...bc0413cbc6fd472371e907f17303c5ddcc9b4642,1,20,19,39,12,2013-11-18 18:25:28,2013-11-18 18:25:28
bc0413cbc6fd472371e907f17303c5ddcc9b4642...97ac22ebfca0a5b0759f495cc5d7bed3f9da6615,4,27,9,36,5,2013-11-18 19:32:13,2013-11-18 13:05:59
97ac22ebfca0a5b0759f495cc5d7bed3f9da6615...3f19b63f8b7d70fde838d6949eab28e2c8d8ca99,1,23,23,46,11,2013-11-18 19:38:28,2013-11-18 18:59:39
3f19b63f8b7d70fde838d6949eab28e2c8d8ca99...9348fc5628ccbbe156e9523b5eb8ba3ce783166e,1,1,1,2,1,2013-11-19 00:10:58,2013-11-19 00:10:58
9348fc5628ccbbe156e9523b5eb8ba3ce783166e...4fdd51b73240bf9c8d9472fcc45df699f0714755,4,79,6,85,14,2013-11-19 07:04:20,2013-10-29 17:31:54
4fdd51b73240bf9c8d9472fcc45df699f0714755...68b540c97751f052a7622a7ab80a32a7d89d2aa2,2,40,3,43,5,2013-11-19 07:14:22,2013-11-09 04:17:23
68b540c97751f052a7622a7ab80a32a7d89d2aa2...42197e31aa6098c959edcbcf1bf20cb8bcdef15f,1,4,1,5,1,2013-11-19 15:23:59,2013-11-16 04:03:01
42197e31aa6098c959edcbcf1bf20cb8bcdef15f...3c3be2e8eca8ee5b451871092f05fd32d3369c45,1,1,1,2,1,2013-11-19 17:53:28,2013-11-19 17:53:28
170eedf583b43b236f3c9b88c41ddd95a8a31b31...ebfa508fa32b27de6f3e2ca04c81b46408b0506e,1,30,3,33,2,2013-11-19 18:23:44,2013-11-19 14:25:15
ebfa508fa32b27de6f3e2ca04c81b46408b0506e...b5eef8535aa278fa050c1af8c1e368e28ff18401,1,7,13,20,6,2013-11-19 18:57:17,2013-11-15 19:06:32
b5eef8535aa278fa050c1af8c1e368e28ff18401...73b3c257e339985f2ab009c3ccf9a74be9e1d134,1,0,0,0,0,2013-11-19 23:34:20,2013-11-19 23:34:01
73b3c257e339985f2ab009c3ccf9a74be9e1d134...4cfe6ba6a3d16a16f0561f2f3c5b56d117f8a60d,4,5,5,10,10,2013-11-20 04:08:21,2013-11-20 02:02:30
4cfe6ba6a3d16a16f0561f2f3c5b56d117f8a60d...331d79a77d48e1a46df0290689d4d865e67221c4,2,36,1,37,4,2013-11-20 16:26:26,2013-11-20 09:28:22
331d79a77d48e1a46df0290689d4d865e67221c4...8f5a688d00f2f73a0913acb04247322f13e2c971,2,8,2,10,4,2013-11-20 16:51:53,2013-11-20 15:31:53
8f5a688d00f2f73a0913acb04247322f13e2c971...fafb6cf049bb9f4591a8b94cffda12c081cd096f,3,13,2,15,4,2013-11-20 20:36:20,2013-11-20 20:34:29
fafb6cf049bb9f4591a8b94cffda12c081cd096f...8e670a0e503ae11941bb6ba0e70e0e579286d362,3,13,1,14,5,2013-11-21 09:26:49,2013-11-21 09:26:49
1116a5662c1648ea3a80acc4b9a3929778bb4036...752d3d70da6291039f33781a0a2ef6f3b7c5fcb5,2,20,4,24,3,2013-11-21 12:52:00,2013-11-21 12:11:57
752d3d70da6291039f33781a0a2ef6f3b7c5fcb5...f39fd3cd20337e4f742f6eb3f0df28e79bb722a6,1,6,9,15,5,2013-11-21 12:52:01,2013-11-21 12:18:30
f39fd3cd20337e4f742f6eb3f0df28e79bb722a6...b6a6cf4ab791b092e18ab16537aa88dd7ae9bc36,1,13,10,23,6,2013-11-21 13:15:23,2013-11-20 21:59:23
b6a6cf4ab791b092e18ab16537aa88dd7ae9bc36...27f04e79b1a639b2f6360e9159f003a3db60f567,9,34,33,67,26,2013-11-21 14:12:39,2013-11-21 14:04:31
27f04e79b1a639b2f6360e9159f003a3db60f567...2b4bed6dbd864ce78e9300f28b05045c386cd248,1,48,99,147,42,2013-11-21 17:51:08,2013-11-20 23:54:23
2b4bed6dbd864ce78e9300f28b05045c386cd248...e6d5f7ae49cd4ffb0e4c6d69d77efcb33f0e5be7,1,30,36,66,17,2013-11-21 19:58:28,2013-11-21 19:57:58
e6d5f7ae49cd4ffb0e4c6d69d77efcb33f0e5be7...1718b5256cd65b8701e315e307c2eb2b5dd4c8d9,3,32,6,38,4,2013-11-21 21:18:52,2013-11-21 21:18:52
1718b5256cd65b8701e315e307c2eb2b5dd4c8d9...d6cc37d601166200e72385401f4384f818a18cfd,6,374,300,674,33,2013-11-21 21:50:59,2013-11-21 07:48:29
d6cc37d601166200e72385401f4384f818a18cfd...3ac823fc5b88db7808f4d1cbca122713c6c9e03a,5,34,0,34,5,2013-11-22 10:09:51,2013-11-19 16:49:16
3ac823fc5b88db7808f4d1cbca122713c6c9e03a...48ce09f2f658c539fa6be4c223bca1b51146241d,2,9,1,10,5,2013-11-22 12:30:50,2013-11-05 10:49:16
9c6b57f709bb6123d8abae6ba05e92085ec2f426...4a54b69e8829fd3e7994f5248c4711c4f594e8a5,1,5,5,10,2,2013-11-22 14:07:10,2013-11-21 23:46:35
4a54b69e8829fd3e7994f5248c4711c4f594e8a5...9f8810ac51afe7eda276ca54a46cb49fb23c1d5a,1,6,5,11,4,2013-11-22 14:34:37,2013-11-22 14:31:31
9f8810ac51afe7eda276ca54a46cb49fb23c1d5a...b9d908da54169472fad090e61538c362d92098d4,3,3,3,6,3,2013-11-22 17:10:18,2013-11-22 17:10:18
b9d908da54169472fad090e61538c362d92098d4...82a58ce5b67e0b79fa0efbad72e21d9d1be25ceb,1,0,7,7,1,2013-11-22 18:29:09,2013-11-22 18:29:09
47afe073244b5a2611d15c47f980e729b2c728c3...18185724e614fb3449612ce3df811af32fbc0582,2,20,1,21,3,2013-11-22 19:36:33,2013-11-20 17:50:36
18185724e614fb3449612ce3df811af32fbc0582...f0fc1690b4ab072c452d3d5230ea2c80ae726ea9,1,0,1,1,1,2013-11-22 20:28:22,2013-11-22 20:28:22
f0fc1690b4ab072c452d3d5230ea2c80ae726ea9...c456ea4ec88a0ab43179ccfe811cb6d8483a1db8,1,5,5,10,1,2013-11-23 00:39:25,2013-11-22 01:54:27
c456ea4ec88a0ab43179ccfe811cb6d8483a1db8...033b26173bbcdf55294f0a019c61cbf6341582b2,1,18,0,18,1,2013-11-23 00:48:54,2013-11-22 12:55:02
033b26173bbcdf55294f0a019c61cbf6341582b2...455e2896b122a331057483634bea9c8074bdc97d,1,9,0,9,1,2013-11-24 14:26:45,2013-11-24 14:26:45
033b26173bbcdf55294f0a019c61cbf6341582b2...dfde4d90123c247857ed45ccd1849f8e86c0849d,1,0,266,266,1,2013-11-23 12:53:50,2013-11-23 12:53:50
0c46ca83e820cd725f5d0fa299c2b5405bfeee1b...db4527e3c0486c46356e3d625931369e8b3bec19,1,2,0,2,1,2013-11-27 12:29:22,2013-11-27 12:29:22
db4527e3c0486c46356e3d625931369e8b3bec19...96dd48c83f429688629b866f8fc64e1a4f3249f3,2,15,7,22,4,2013-11-27 12:34:31,2013-11-27 12:34:31
96dd48c83f429688629b866f8fc64e1a4f3249f3...4fcfc31865240d635c6e13e1f71ed52c0f6bd72c,2,14,1,15,2,2013-11-27 12:56:33,2013-11-27 12:56:33
4fcfc31865240d635c6e13e1f71ed52c0f6bd72c...eece3c224e0019a30aa491a44ef66193d93f7ce8,2,92,0,92,3,2013-11-27 13:32:12,2013-11-27 13:32:12
eece3c224e0019a30aa491a44ef66193d93f7ce8...19b34fbe63a8ec5edd61777b7ff681370cff14f2,1,89,0,89,1,2013-11-27 15:20:53,2013-11-27 15:20:53
19b34fbe63a8ec5edd61777b7ff681370cff14f2...5e63977c0e5d0dff755817b86364a5c8882deaf7,2,7,1,8,4,2013-11-27 15:28:33,2013-11-27 15:28:33
5e63977c0e5d0dff755817b86364a5c8882deaf7...67b51b98959025c7a5e928f640488e230efde82e,1,1,1,2,1,2013-11-27 16:29:37,2013-11-27 16:29:37
67b51b98959025c7a5e928f640488e230efde82e...0b3c8fc85168bac7327e7c4372e92b52575547e9,1,104,50,154,15,2013-11-27 16:29:49,2013-11-27 16:29:49
0b3c8fc85168bac7327e7c4372e92b52575547e9...17c3997f6828e88e4646071a8187c1318b65597d,5,398,85,483,35,2013-11-27 17:44:18,2013-09-26 23:35:53
17c3997f6828e88e4646071a8187c1318b65597d...52015b963d263642957aec880b52ad4063b484cd,3,32,15,47,6,2013-11-27 17:45:05,2013-10-09 12:29:14
52015b963d263642957aec880b52ad4063b484cd...f450bc9f44bc1270eae911daa157c155c29d1d9d,6,90,37,127,35,2013-11-27 17:45:22,2013-11-21 17:14:16
f450bc9f44bc1270eae911daa157c155c29d1d9d...01e8ac47b37ccf1b4d9b9710ae2d9b6b486c3c7a,2,1,1,2,2,2013-11-27 17:45:47,2013-11-27 17:43:37
1d2dd3b9fa939506127e602f1b029045b286b9fd...3ca0815c0b4ddf7dd1fe74839e2c3e8633c3ea31,3,16,16,32,13,2013-11-23 13:40:01,2013-11-21 20:33:35
3ca0815c0b4ddf7dd1fe74839e2c3e8633c3ea31...ffc37e2343a93cf6d44247e20cd263b41f931716,16,737,614,1351,240,2013-11-23 14:06:59,2013-10-18 22:49:24
ffc37e2343a93cf6d44247e20cd263b41f931716...62b393c5ae774c9d5d85bf6eda620354d21e61b1,6,37,45,82,36,2013-11-23 14:53:47,2013-11-23 02:47:04
62b393c5ae774c9d5d85bf6eda620354d21e61b1...1124e163403a1d474016cfc3cf9173eb44349e34,1,2,2,4,2,2013-11-23 15:49:14,2013-11-23 15:49:14
1124e163403a1d474016cfc3cf9173eb44349e34...a480f8320a5b36501bfd0e8cd70b8dc04adf2d08,2,14,16,30,9,2013-11-23 16:03:43,2013-11-23 16:03:43
a480f8320a5b36501bfd0e8cd70b8dc04adf2d08...1e970584178c44d561d54dc8bf0c3837b89bad5a,2,60,0,60,4,2013-11-23 16:11:22,2013-11-23 14:35:24
1e970584178c44d561d54dc8bf0c3837b89bad5a...0ec712dd1190f609d928bbaa1d635e692a75242b,3,6,6,12,8,2013-11-23 16:26:11,2013-11-23 16:26:11
0ec712dd1190f609d928bbaa1d635e692a75242b...e112654fc81ddb3fbffbb8382b004d69367a85fe,2,27,0,27,3,2013-11-23 16:50:28,2013-11-23 16:50:28
e112654fc81ddb3fbffbb8382b004d69367a85fe...42fef2944640659b95679381a9c8f02b3be884b1,2,3,1,4,2,2013-11-23 17:47:47,2013-11-23 17:18:42
42fef2944640659b95679381a9c8f02b3be884b1...cf7ddc576583a15dec0800f4146c2e979795bf30,2,8,19,27,5,2013-11-23 17:55:28,2013-11-23 17:55:28
cf7ddc576583a15dec0800f4146c2e979795bf30...9e8744455286f9d28e7fb80838aa5fb1bf1d2719,1,5,1,6,2,2013-11-23 18:05:13,2013-11-23 18:05:13
9e8744455286f9d28e7fb80838aa5fb1bf1d2719...a739573e178694cf2c4ad77b57fbc7e90c1c5d55,1,1,1,2,1,2013-11-23 18:50:20,2013-11-23 18:50:20
01e8ac47b37ccf1b4d9b9710ae2d9b6b486c3c7a...ecd855658960d32efeb9cd97cad1ed076520e696,1,1,1,2,1,2013-11-27 18:37:21,2013-11-27 18:37:21
a739573e178694cf2c4ad77b57fbc7e90c1c5d55...957d22b8508c5884defcd19f91f580de679db9ca,1,2,2,4,2,2013-11-23 22:48:34,2013-11-23 22:48:34
041a076dadce547d450cf73d97401d63cde8891d...df6760f12c2f08287e2aa7b5ddee6e567ab83220,3,58,4,62,4,2013-11-27 21:35:25,2013-11-13 12:38:03
df6760f12c2f08287e2aa7b5ddee6e567ab83220...a5b94d9d4ea7f85f68bbbb7520d0d5475fbb846c,2,2,4,6,4,2013-11-27 22:42:39,2013-11-27 22:42:39
a5b94d9d4ea7f85f68bbbb7520d0d5475fbb846c...077af42139db84d88f293ab5eadc989a9169dce1,1,2,0,2,2,2013-11-27 23:57:13,2013-11-27 23:53:10
077af42139db84d88f293ab5eadc989a9169dce1...d1df395f3ae768e495a105db2f85352c44ba1c28,1,7,0,7,1,2013-11-28 13:48:38,2013-11-27 15:01:18
d1df395f3ae768e495a105db2f85352c44ba1c28...7477a4ffde4781f4e84503e66d7f775074089887,38,67,67,134,53,2013-11-28 13:50:11,2013-11-26 09:43:46
7477a4ffde4781f4e84503e66d7f775074089887...c8b637d88e279412f52388b72c2bb581060b4ee9,1,1,1,2,1,2013-11-28 16:41:20,2013-11-28 16:41:20
c8b637d88e279412f52388b72c2bb581060b4ee9...34b8a385588a051814f77481c875047c8bd23b37,3,28,11,39,5,2013-11-28 17:29:02,2013-11-23 09:53:09
ce5ad8199c275c6fb87e4fe678532b8747bc196f...101da92ebdf913d60b114ff4ebeef6e776e8bc6e,1,1,1,2,1,2013-11-24 09:15:43,2013-11-24 09:14:21
101da92ebdf913d60b114ff4ebeef6e776e8bc6e...7169722d5c4c9f9829e353fbeda08b7550bf8991,1,4,0,4,1,2013-11-24 10:10:34,2013-11-24 08:10:21
7169722d5c4c9f9829e353fbeda08b7550bf8991...3ea65d1f68f9da9be51695d030349146c1ad0248,1,12,6,18,3,2013-11-24 10:51:37,2013-11-24 10:49:32
3ea65d1f68f9da9be51695d030349146c1ad0248...87ea38cc9e5ed484538427854121c8614b50802f,1,1,1,2,1,2013-11-24 11:08:41,2013-11-24 11:08:41
87ea38cc9e5ed484538427854121c8614b50802f...17912522cee1277c8c126394fbe94b7172f92e83,1,2,2,4,2,2013-11-24 13:34:43,2013-11-24 13:32:57
17912522cee1277c8c126394fbe94b7172f92e83...8adbfdfcc4c6941ecdc5ba696dab03121568ba89,1,3,3,6,1,2013-11-24 14:33:22,2013-11-24 14:33:22
8adbfdfcc4c6941ecdc5ba696dab03121568ba89...d47f794f8fa05591632b8cad4b134858e7ae140d,2,41,11,52,11,2013-11-24 15:23:28,2013-11-24 15:19:47
d47f794f8fa05591632b8cad4b134858e7ae140d...e681b2861d969eb5c5cd27ec8a9a14ebc8860bd1,2,5,2,7,4,2013-11-24 15:45:01,2013-11-24 15:43:24
e681b2861d969eb5c5cd27ec8a9a14ebc8860bd1...f88e7608696aa48ec2a2638893f3e548a4f6b840,1,21,0,21,2,2013-11-24 17:59:46,2013-11-24 17:12:46
f88e7608696aa48ec2a2638893f3e548a4f6b840...19e5cd77f0536b778b00788e34d8199835143855,4,32,3,35,7,2013-11-24 18:15:50,2013-11-22 22:31:50
19e5cd77f0536b778b00788e34d8199835143855...2a0ae9b9ecf7a2f835faf7d944f41bf83c316a50,1,1,5,6,2,2013-11-24 19:22:22,2013-11-24 17:07:52
2a0ae9b9ecf7a2f835faf7d944f41bf83c316a50...bfe7377adbc0d10dc553a317671c193dce692ad3,1,2,1,3,1,2013-11-24 20:19:05,2013-11-24 19:33:04
bfe7377adbc0d10dc553a317671c193dce692ad3...03bc0a8ac5b465a9a1ec88dedb0a2f4bd91dd547,1,1,1,2,1,2013-11-24 21:28:29,2013-11-24 21:28:29
03bc0a8ac5b465a9a1ec88dedb0a2f4bd91dd547...eb38257e5199ca06b8b32f82dd50f64fd6b0d98d,7,197,15,212,23,2013-11-24 22:51:22,2013-11-05 04:11:51
eb38257e5199ca06b8b32f82dd50f64fd6b0d98d...4e07d93325b3989073b181e4505f2e6ed707743b,4,8,8,16,5,2013-11-25 03:05:59,2013-11-25 03:05:59
4e07d93325b3989073b181e4505f2e6ed707743b...83ab04c6d6a65c78cac32e5796908c6a542c85c7,2,6,4,10,2,2013-11-25 03:07:21,2013-11-25 03:07:21
83ab04c6d6a65c78cac32e5796908c6a542c85c7...de220fb85ef0cc1451cdfaa2a29f5f0c9f798e98,1,5,2,7,2,2013-11-25 13:11:50,2013-11-25 13:11:50
de220fb85ef0cc1451cdfaa2a29f5f0c9f798e98...70e61310d690fab109c5298e41783db61306f831,1,5,1,6,2,2013-11-25 13:26:10,2013-11-25 11:22:43
70e61310d690fab109c5298e41783db61306f831...3411af3cd195ef79f3320ee9b2ab261e9ee5a3f5,1,3,3,6,2,2013-11-25 14:16:04,2013-11-25 14:12:43
3411af3cd195ef79f3320ee9b2ab261e9ee5a3f5...7349a22d291c5c8e10cb9842809ab5675e42660b,1,1,1,2,1,2013-11-25 15:21:25,2013-11-25 15:21:25
7349a22d291c5c8e10cb9842809ab5675e42660b...7a0a3a64a827480c737060bcd5af9af25c3b3c15,1,0,4,4,2,2013-11-25 15:31:03,2013-11-25 14:39:19
7a0a3a64a827480c737060bcd5af9af25c3b3c15...1c7a83ee8e3da431d9d21dae42da8f1f89973f7c,3,4,2,6,3,2013-11-26 00:16:19,2013-11-22 10:23:12
1c7a83ee8e3da431d9d21dae42da8f1f89973f7c...c74504c2dd21974571ab72805fbfc8d4d76ce151,5,115,5,120,11,2013-11-26 01:01:16,2013-11-15 02:26:19
c74504c2dd21974571ab72805fbfc8d4d76ce151...16d73d7416a7902703ee8022f093667f7ac9ef5b,2,9,9,18,9,2013-11-26 09:18:54,2013-11-26 05:52:47
34b8a385588a051814f77481c875047c8bd23b37...91fce675a453764cb233e53c0460826600c828fa,1,1,1,2,1,2013-11-28 20:01:08,2013-11-28 20:01:08
16d73d7416a7902703ee8022f093667f7ac9ef5b...14940fdd96e77778cacdf0963913a343b1f33b9a,2,27,3,30,5,2014-01-10 10:45:26,2013-11-26 12:00:50
16d73d7416a7902703ee8022f093667f7ac9ef5b...9d6c48aeb02320fd33b4314928c4a3bcfc49f667,1,2,2,4,2,2013-11-26 13:08:05,2013-11-26 13:07:07
9d6c48aeb02320fd33b4314928c4a3bcfc49f667...5725236c3ee4323203aa681cb54d1ff1d7f376df,1,13,7,20,3,2013-11-26 16:51:39,2013-10-28 10:11:05
5725236c3ee4323203aa681cb54d1ff1d7f376df...384816fccb6dfc7fc40f8059811341ba3572d9ff,3,7,0,7,3,2013-11-26 19:41:51,2013-11-23 19:51:17
384816fccb6dfc7fc40f8059811341ba3572d9ff...bb5ab908cc8ab71ddb619daa72a9aa5081af5f8b,1,1,1,2,1,2013-11-26 19:49:54,2013-11-26 19:49:46
bb5ab908cc8ab71ddb619daa72a9aa5081af5f8b...ac17525039b127e8712c402d0b09ffa864c37ef5,1,2,2,4,2,2013-11-26 20:32:14,2013-11-26 20:31:52
936dbaf12812218726deac6803865148686adbd1...42ac13800952e74e3969b850fa635b400948c5ee,1,5,3,8,4,2013-11-29 02:42:24,2013-11-29 02:42:24
42ac13800952e74e3969b850fa635b400948c5ee...7e2d61a9724644d6d1c7ce9361d9fd5be3e2ab86,7,77,27,104,25,2013-11-29 13:01:30,2013-11-05 10:02:54
7e2d61a9724644d6d1c7ce9361d9fd5be3e2ab86...f563c339ca2eed81706ab17726c79a6f00d7c553,8,214,74,288,31,2013-11-29 18:00:53,2013-11-11 17:56:01
f563c339ca2eed81706ab17726c79a6f00d7c553...b72b85af153848ef5f1f07f5c1e5a81e3563b015,2,11,95,106,6,2013-11-29 18:00:53,2013-11-12 14:18:09
b72b85af153848ef5f1f07f5c1e5a81e3563b015...9af7e18f3579df18625b9eda70735790f23aeb96,1,1,1,2,1,2013-11-29 22:57:36,2013-11-29 22:57:14
9af7e18f3579df18625b9eda70735790f23aeb96...50a8ab7cd1e611e6422a148becaec02218577d67,13,173,81,254,44,2013-11-30 10:00:23,2013-11-30 09:53:08
50a8ab7cd1e611e6422a148becaec02218577d67...6310d658b7c8a39747a8cda3e3b8716266cffb0d,1,2,1,3,1,2013-11-30 10:31:17,2013-11-30 10:30:56
6310d658b7c8a39747a8cda3e3b8716266cffb0d...ec73ce5d8a0bc3643188d97629c30d226849bddc,1,2,2,4,2,2013-11-30 12:59:32,2013-11-30 09:19:24
ec73ce5d8a0bc3643188d97629c30d226849bddc...c0a2daad78c66def2ce6592977b78dab6475dd53,1,13,0,13,1,2013-11-30 13:31:58,2013-11-30 00:39:19
c0a2daad78c66def2ce6592977b78dab6475dd53...f3e7ab366c597571198dc8d024f09e619991bac4,12,19,20,39,13,2013-11-30 13:37:15,2013-11-30 13:37:15
f3e7ab366c597571198dc8d024f09e619991bac4...2080bce695d480dd5fd851fdada221df923aa290,1,8,1,9,4,2013-11-30 18:17:36,2013-11-30 18:07:35
2080bce695d480dd5fd851fdada221df923aa290...2688462f914960b568dce4cb529db77e982a5284,1,32,41,73,7,2013-11-30 18:47:16,2013-11-28 13:22:07
2688462f914960b568dce4cb529db77e982a5284...fddb0131d37109c809ec391e1a134ef1d9e442a7,3,36,3,39,6,2013-11-30 19:18:37,2013-11-30 01:49:56
fddb0131d37109c809ec391e1a134ef1d9e442a7...3b60ffa334e68cf44ac79c2997c05a2d14da15d5,1,1,1,2,1,2013-12-01 19:21:57,2013-12-01 19:21:57
3b60ffa334e68cf44ac79c2997c05a2d14da15d5...b8be3055f1d81ee956ea1572c48cc352b63099db,1,1,8,9,3,2013-12-01 23:03:59,2013-12-01 19:12:48
b8be3055f1d81ee956ea1572c48cc352b63099db...9ccde8cfafda03c961343b4523ac035428c4ff25,1,1,1,2,1,2013-12-02 17:12:04,2013-12-02 17:12:04
38b4adc6960d28483124509aa363dadbe8cc17a6...98dd8dd02e6a005266866ab1cb4a2ec00dce0193,2,12,28,40,6,2014-02-09 10:54:02,2014-02-09 10:54:02
98dd8dd02e6a005266866ab1cb4a2ec00dce0193...a5391db76a20c8bb35a7bc0192870fddf747c54c,2,17,4,21,5,2014-02-09 10:59:18,2014-02-09 10:50:09
a5391db76a20c8bb35a7bc0192870fddf747c54c...a7e2957110e8cac6ad5bf233ce4cc1fa528ac0e0,1,0,5,5,1,2014-02-09 11:10:21,2014-02-09 11:09:55
a7e2957110e8cac6ad5bf233ce4cc1fa528ac0e0...4f8e8a6ec2e449e7a6c2e89f011c744ec6874c82,4,4,4,8,6,2014-02-09 11:13:10,2014-02-09 11:13:10
4f8e8a6ec2e449e7a6c2e89f011c744ec6874c82...97a8fd4682b27a3a9f280e661e58db4bae55590a,2,9,1,10,3,2014-02-09 11:17:38,2014-02-09 11:17:13
97a8fd4682b27a3a9f280e661e58db4bae55590a...80cd64ee17191ffb235c5850a8fa60cae96c1b89,2,38,2,40,3,2014-02-09 11:23:09,2014-02-09 11:10:05
80cd64ee17191ffb235c5850a8fa60cae96c1b89...75a96f06e916dda9124da9ddf765f3b8d5530914,2,9,2,11,3,2014-02-09 11:30:03,2014-02-09 10:53:23
75a96f06e916dda9124da9ddf765f3b8d5530914...2085f53f567f7619ecf3eab93fdacab7a5991a11,2,30,23,53,6,2014-02-09 11:42:10,2014-02-09 11:41:44
2085f53f567f7619ecf3eab93fdacab7a5991a11...250841017c6c456806cadd214b4e130aa998233d,1,4,0,4,1,2014-02-09 11:42:34,2014-02-09 11:40:23
250841017c6c456806cadd214b4e130aa998233d...d5df7a0515b08621a526a9c9ffde7d7702c5b07e,5,48,2,50,9,2014-02-09 12:22:59,2014-02-09 12:22:29
d5df7a0515b08621a526a9c9ffde7d7702c5b07e...9c4ad454d18816d418b0bd31be91fae16c795f15,3,5,8,13,6,2014-02-09 12:33:52,2014-02-09 12:33:52
9c4ad454d18816d418b0bd31be91fae16c795f15...5cc0555603167c7532b7b714e2672687da8f106e,4,56,24,80,11,2014-02-09 12:39:20,2014-02-09 12:37:14
5cc0555603167c7532b7b714e2672687da8f106e...42607a9e33e63639d1da2166b9a2f85c691e07ae,10,55,51,106,16,2014-02-09 12:42:26,2014-02-09 12:41:55
42607a9e33e63639d1da2166b9a2f85c691e07ae...11c021336c8cb1c92be998f1a44c89a746275107,1,3,0,3,1,2014-02-09 12:46:38,2014-02-09 12:46:38
11c021336c8cb1c92be998f1a44c89a746275107...935e6c1dfc10808272bfda1bbda03bfee035f3dc,1,6,1,7,1,2014-02-09 14:03:41,2014-02-09 14:03:41
935e6c1dfc10808272bfda1bbda03bfee035f3dc...6a9ed7d403a5f90a7c7354097aae99b74e8ce215,5,100,3,103,16,2014-02-09 14:22:22,2013-11-16 14:55:50
6a9ed7d403a5f90a7c7354097aae99b74e8ce215...f90be002d9d3c10b87c74741986e2cbf9f2b858e,2,11,0,11,2,2014-02-09 14:48:11,2014-02-09 14:48:11
f90be002d9d3c10b87c74741986e2cbf9f2b858e...1b29d3289473a6c3ce565c0ddc1bed4d5b5ac9a3,1,3,3,6,2,2014-02-09 17:08:03,2014-02-09 12:29:29
1b29d3289473a6c3ce565c0ddc1bed4d5b5ac9a3...d25622000ac8a591101ade28708d3b4b8ae4b24f,2,16,1,17,2,2014-02-09 17:20:09,2014-02-09 12:32:35
d25622000ac8a591101ade28708d3b4b8ae4b24f...d238ab29915b24bb717b3fdc2d552c65a43ba9ab,1,2,2,4,3,2014-02-09 17:48:15,2014-02-09 17:47:40
d238ab29915b24bb717b3fdc2d552c65a43ba9ab...95ede98e602407a6515400999cc1bfa228d8af95,1,1,1,2,1,2014-02-09 19:30:34,2014-02-09 19:30:13
643180b5d253e2cbc9cfccccafa5b1e35dcf5583...c75dd664cf70a159257337c3eda978de2bec9e7a,2,3,0,3,3,2013-12-02 18:37:59,2013-12-02 17:21:48
c75dd664cf70a159257337c3eda978de2bec9e7a...12615dab78cb6fc7d8c74b7b65a4136b0feeb33f,3,20,2,22,5,2013-12-03 02:18:04,2013-12-03 02:11:59
12615dab78cb6fc7d8c74b7b65a4136b0feeb33f...4d738fcc3bad4e13c3667646a86f9a17603b7d23,1,1,1,2,1,2013-12-04 09:11:42,2013-12-04 09:11:42
4d738fcc3bad4e13c3667646a86f9a17603b7d23...91c38ce4b236e6eeb5f6f636250df7316fa766bd,3,65,33,98,12,2013-12-04 11:36:20,2013-11-08 14:44:37
91c38ce4b236e6eeb5f6f636250df7316fa766bd...abb04f1f3f19f460643177e780004ff199423757,2,5,3,8,2,2013-12-04 13:26:03,2013-12-04 13:26:03
abb04f1f3f19f460643177e780004ff199423757...1d20e6df9553346c79edd92e6e8934e9c5c4aa2c,2,25,1,26,6,2013-12-04 13:34:01,2013-12-04 13:32:46
1d20e6df9553346c79edd92e6e8934e9c5c4aa2c...ab587fa51a3be3ffc6f011189c0abab32dec6155,1,17,15,32,4,2013-12-04 13:55:20,2013-12-04 13:55:20
ab587fa51a3be3ffc6f011189c0abab32dec6155...df800b160990884246d73786e85b082d9b703b57,1,8,0,8,1,2013-12-04 13:55:45,2013-12-04 13:55:45
df800b160990884246d73786e85b082d9b703b57...ce05b8a69ee0e9f7f7e0154b2b9bf1dcb15edbcb,3,63,11,74,12,2013-12-04 13:56:22,2013-12-04 13:56:22
ce05b8a69ee0e9f7f7e0154b2b9bf1dcb15edbcb...cd9e85ece94214718257d972e9e5ab4bac3f0e65,1,4,0,4,2,2013-12-04 15:46:56,2013-12-04 15:46:56
cd9e85ece94214718257d972e9e5ab4bac3f0e65...3b8e46cbc7cdb03bb40b3b099997a5f659a2d402,11,341,117,458,23,2013-12-04 16:01:49,2013-12-04 16:01:31
e2f28572b745c6a8555b8bfd00df10c936c434c0...29345390b81a3bfce22af43617cabd0d08de3632,3,25,28,53,10,2014-02-09 20:39:04,2014-02-09 20:35:35
29345390b81a3bfce22af43617cabd0d08de3632...12385a5f868ee697266756511a85434627ae7ca6,2,79,29,108,9,2014-02-09 21:01:17,2014-02-09 13:54:46
12385a5f868ee697266756511a85434627ae7ca6...651a6f76f30f4083dfa2a75c5acd86359c2fc4a2,1,1,2,3,1,2014-02-09 21:23:14,2014-02-09 16:36:08
651a6f76f30f4083dfa2a75c5acd86359c2fc4a2...21f034165c73d6c529e2c30a69a44970537a8296,1,0,1,1,1,2014-02-09 21:30:08,2014-02-09 21:30:08
21f034165c73d6c529e2c30a69a44970537a8296...c5395eef7693e1ae222cbfd81d031237c1802c7f,2,11,4,15,6,2014-02-10 10:21:23,2014-02-10 10:18:20
c5395eef7693e1ae222cbfd81d031237c1802c7f...0d98422b1365ae1e75051036936aab31248d5ee1,1,65,134,199,34,2014-02-10 10:22:30,2014-02-10 10:21:42
0d98422b1365ae1e75051036936aab31248d5ee1...b102c27ff4d21ea6262e600227530f75337a5df2,4,29,6,35,11,2014-02-10 10:38:43,2013-07-22 00:27:56
b102c27ff4d21ea6262e600227530f75337a5df2...9a4ee8ddb858ae07ff42be0261c867aa3d2eb53c,5,34,6,40,9,2014-02-10 12:28:39,2014-02-09 16:44:31
9a4ee8ddb858ae07ff42be0261c867aa3d2eb53c...59d9b264745bb1a4736bb6df4dafb83049835483,8,121,2,123,11,2014-02-10 13:24:40,2013-09-29 08:52:45
59d9b264745bb1a4736bb6df4dafb83049835483...f5123c7291e855713b59e739bad0e50a1d50d3ef,10,94,24,118,17,2014-02-10 14:13:29,2014-01-08 16:48:43
f5123c7291e855713b59e739bad0e50a1d50d3ef...ee9fcb1672ddf5910ed8c45c37a00f32ebbe2bb1,6,219,61,280,20,2014-02-10 15:04:19,2014-02-07 21:34:56
ee9fcb1672ddf5910ed8c45c37a00f32ebbe2bb1...c3dd38c57427f2d51222b4789137848f5a3194e7,1,10,0,10,1,2014-02-10 15:09:04,2014-02-10 15:05:01
c3dd38c57427f2d51222b4789137848f5a3194e7...fb1e3435a4d7e0265f19a1a9f130c9485fb8dfe9,3,8,3,11,5,2014-02-10 15:09:04,2014-02-10 14:55:57
fb1e3435a4d7e0265f19a1a9f130c9485fb8dfe9...a718fcf201b04ba254e9073be82f51ae1ae3a853,1,2,2,4,2,2014-02-11 08:01:48,2014-02-11 08:00:51
a718fcf201b04ba254e9073be82f51ae1ae3a853...eefc88feefec0c3685bfb102714530b751b4ae90,15,229,30,259,34,2014-02-11 19:05:12,2014-02-01 19:23:31
eefc88feefec0c3685bfb102714530b751b4ae90...e0381cdf2e7f677c5b29f2e3351993e92915569a,1,1,1,2,1,2014-02-12 09:26:08,2014-02-12 09:23:28
e0381cdf2e7f677c5b29f2e3351993e92915569a...73f51e411372ba3e74ccf5a2c2be88927ac2c6dd,2,11,2,13,2,2014-02-12 14:34:26,2014-02-11 14:59:57
73f51e411372ba3e74ccf5a2c2be88927ac2c6dd...7e27885c6e7588471fd94a4def16b7081577bdfc,2,35,2,37,5,2014-02-12 16:00:01,2014-02-12 15:07:23
7e27885c6e7588471fd94a4def16b7081577bdfc...b333de0f5dc6e66bd77cce9ffe0eef06a9e31f02,1,26,1,27,6,2014-02-12 17:16:40,2014-02-12 17:16:40
b333de0f5dc6e66bd77cce9ffe0eef06a9e31f02...80bbe2265d1afd43f8519427ad8ce0b147aceb43,1,2,16,18,2,2014-02-12 17:21:25,2014-02-12 17:21:25
80bbe2265d1afd43f8519427ad8ce0b147aceb43...bad9456b9cabd6a14fe6e3edeacde55b51fbffdc,2,7,6,13,5,2014-02-12 17:22:50,2014-02-12 17:22:50
bad9456b9cabd6a14fe6e3edeacde55b51fbffdc...dbe82e74f2ed4ae2f63247af75161ad00ab34a44,4,514,2,516,5,2014-02-12 18:53:35,2014-02-12 18:53:35
dbe82e74f2ed4ae2f63247af75161ad00ab34a44...7e941ba67ceab8a74ba50509d13ed4298f8305cd,3,14,32,46,5,2014-02-12 18:55:20,2014-02-12 18:55:20
7e941ba67ceab8a74ba50509d13ed4298f8305cd...f0f1ba75b090e533c1b39f516cea2d9a15307ac3,1,5,1,6,2,2014-02-12 19:09:43,2014-02-12 19:09:30
f0f1ba75b090e533c1b39f516cea2d9a15307ac3...c3434fed5bb223b2765a85f88053d42b70d81ad9,1,0,43,43,1,2014-02-13 08:31:39,2014-02-13 08:31:39
3b8e46cbc7cdb03bb40b3b099997a5f659a2d402...0daa2f1bf1dde97cc10781b4f1e6a1a987ec2330,1,1,1,2,2,2013-12-04 21:32:41,2013-12-04 21:32:41
c3434fed5bb223b2765a85f88053d42b70d81ad9...6873eeeefbc3a081c98351ff25b4cdc42dbf3d7d,2,22,1,23,3,2014-02-13 16:43:21,2014-02-13 11:23:12
c3434fed5bb223b2765a85f88053d42b70d81ad9...8aa1efff6d6cb1589a1977f3e68f4c26eb6adc74,20,71,72,143,37,2014-02-13 12:12:40,2014-02-09 11:38:13
8aa1efff6d6cb1589a1977f3e68f4c26eb6adc74...390001ce52802a7fa1fceeabfb646e6b32911fb9,1,70,99,169,20,2014-02-13 12:31:18,2014-02-09 16:39:04
390001ce52802a7fa1fceeabfb646e6b32911fb9...f94f466cd3461527fb76a3e8951039a3c2388829,5,93,23,116,22,2014-02-13 15:27:27,2013-01-10 09:27:20
f94f466cd3461527fb76a3e8951039a3c2388829...e86aa83dc34ef9ef38eec9a37b3f81bed6548002,1,2,2,4,1,2014-02-13 15:32:50,2014-02-13 15:32:50
e86aa83dc34ef9ef38eec9a37b3f81bed6548002...474eeccb52416c24ed375c0026af54e586a67ff3,1,1,1,2,1,2014-02-13 16:36:53,2014-02-13 16:36:53
474eeccb52416c24ed375c0026af54e586a67ff3...83a3add4bed8d8d49f93b30c817c66908b0a26ba,1,1,1,2,1,2014-02-13 19:30:18,2014-02-13 18:32:56
83a3add4bed8d8d49f93b30c817c66908b0a26ba...007c5cd36762c125102d4f6c48d7e7f42dbfdcff,1,3,2,5,2,2014-02-14 01:50:27,2014-02-14 01:50:27
007c5cd36762c125102d4f6c48d7e7f42dbfdcff...2e4200b5c7cb4887b7034bb5dcbbd354e4698f27,2,21,0,21,2,2014-02-14 11:52:50,2014-02-13 18:19:13
2e4200b5c7cb4887b7034bb5dcbbd354e4698f27...f3805f5c529d788f72f68d80b492d059cc62e6b2,1,4,1,5,1,2014-02-14 12:45:35,2014-02-14 12:45:35
f3805f5c529d788f72f68d80b492d059cc62e6b2...e3d0790bd0b036ed3589659c1196e2c571e3dd8e,4,24,2,26,5,2014-02-14 22:58:03,2014-02-14 03:48:44
e3d0790bd0b036ed3589659c1196e2c571e3dd8e...0242134d32aa99a54442211ed05576b7061866d1,9,176,8,184,21,2014-02-14 23:25:19,2014-02-14 17:28:51
0242134d32aa99a54442211ed05576b7061866d1...f683cb90bea2afbe0ef4c011acd4ab590c37410d,6,44,3,47,7,2014-02-15 00:53:44,2014-01-23 02:13:59
f683cb90bea2afbe0ef4c011acd4ab590c37410d...0bd92d68ade11b56124c7cdfbbfff6eb37899291,2,26,3,29,7,2014-02-15 01:00:39,2014-02-13 14:04:19
0bd92d68ade11b56124c7cdfbbfff6eb37899291...865392c47899d70229d2450ec398582f31e3cf1d,2,5,0,5,2,2014-02-15 02:04:44,2014-02-15 02:04:44
1864c6b5ad70c3c403bc5621fb5856a114a98845...ae734b75c1fc365be9c2e2a08c8c569166233149,1,1,1,2,1,2013-12-05 12:09:36,2013-12-05 05:43:48
1864c6b5ad70c3c403bc5621fb5856a114a98845...164df40501d91ae8dd250700df15302c64001a69,1,1,1,2,1,2013-12-05 00:03:28,2013-12-05 00:03:28
3c547a423f5394d816b5a942570abd904f07bfba...116d39842dab2569013856e9f3701a7cb6554f09,2,28,0,28,3,2014-02-17 03:58:31,2014-02-17 03:24:34
116d39842dab2569013856e9f3701a7cb6554f09...81cd3a74609086a34ced5a5af65768f58cee2c87,1,1,1,2,1,2014-02-17 03:58:31,2014-02-17 03:54:36
81cd3a74609086a34ced5a5af65768f58cee2c87...a7639722f57eebc71cd396512e1fe5c86bebbf15,2,41,5,46,4,2014-02-17 03:58:31,2014-02-17 03:55:03
a7639722f57eebc71cd396512e1fe5c86bebbf15...faf6a911ad7357c8dd1defa3be0317a8418febf7,4,34,3,37,5,2014-02-17 19:46:13,2014-02-15 21:44:14
865392c47899d70229d2450ec398582f31e3cf1d...3d898b0e124277ad4602287c8dd47d7baa322691,1,1,1,2,1,2014-02-15 12:00:56,2014-02-15 12:00:56
865392c47899d70229d2450ec398582f31e3cf1d...4ac4c98cbd0c57570d41f05758dea08f6bb7127b,1,1,1,2,1,2014-02-15 11:08:01,2014-02-15 10:36:53
4ac4c98cbd0c57570d41f05758dea08f6bb7127b...00da02cbfd2dc2c98e516d4f816063df5fb81b5b,1,1,1,2,1,2014-02-15 12:02:16,2014-02-15 11:57:58
8209906a0e71bba5c31cdf9bfa7f5bfbfd4dc7ec...cbf8e8aa125d25aa0d4b3a65ef9915acca4a4e81,1,1,1,2,1,2013-12-05 14:08:34,2013-12-05 14:08:34
cbf8e8aa125d25aa0d4b3a65ef9915acca4a4e81...4ca39684ee1e21b7e508d58ee89f9a0c309399c4,1,2,2,4,2,2013-12-05 14:11:46,2013-12-05 14:10:58
4ca39684ee1e21b7e508d58ee89f9a0c309399c4...e9c6d0422422d7ea5ff3be8992ca73b5ba73bd0c,1,16,2,18,2,2013-12-05 14:20:30,2013-12-05 14:19:46
e9c6d0422422d7ea5ff3be8992ca73b5ba73bd0c...e36c165b140c6f86678f7d12785d1957afa1735c,1,1,1,2,1,2013-12-05 21:22:37,2013-12-05 21:22:37
e36c165b140c6f86678f7d12785d1957afa1735c...3396d5716b2fccf5de5322cc50efef3c6e9b1152,1,1,1,2,1,2013-12-05 22:07:50,2013-12-05 22:07:50
3396d5716b2fccf5de5322cc50efef3c6e9b1152...38662d11c4201c9fe9ba810515c2ed0b939065c0,1,1,1,2,1,2013-12-05 22:11:30,2013-12-05 22:11:30
faf6a911ad7357c8dd1defa3be0317a8418febf7...45edb9d2359c60952fd791616df887eb95f75746,3,35,8,43,9,2014-02-18 09:23:30,2014-02-18 09:19:04
45edb9d2359c60952fd791616df887eb95f75746...b78f9a12c83b19f24b4b450de29159d597059673,2,108,158,266,19,2014-02-18 10:36:06,2014-02-17 22:49:57
b78f9a12c83b19f24b4b450de29159d597059673...2a9ee49f3cbdc42a98a0c8bc654165f2f35ef3d6,4,34,28,62,6,2014-02-18 10:36:06,2014-02-17 23:01:03
2a9ee49f3cbdc42a98a0c8bc654165f2f35ef3d6...6b310bafc56c026a47a34dbc83cfb43eafb40a03,1,13,2,15,3,2014-02-18 10:36:07,2014-02-17 23:07:11
6b310bafc56c026a47a34dbc83cfb43eafb40a03...203f55b5d5e2476a9bef7fe50796103f76f378e8,1,2,2,4,1,2014-02-18 12:21:25,2014-02-18 12:20:02
203f55b5d5e2476a9bef7fe50796103f76f378e8...621c5cf4a501c8e80348df0ddbe726defd6be2ed,4,111,40,151,6,2014-02-18 12:38:06,2014-01-04 21:26:24
621c5cf4a501c8e80348df0ddbe726defd6be2ed...d3e33fff12266b51ab1488f7094855aef6061e9e,1,2,2,4,2,2014-02-18 12:49:42,2014-02-18 11:25:39
d3e33fff12266b51ab1488f7094855aef6061e9e...ffa238c3f781b064e5c0cfd0b40d1a7da9d84a49,1,6,3,9,4,2014-02-18 14:29:22,2014-02-18 14:29:22
ffa238c3f781b064e5c0cfd0b40d1a7da9d84a49...20f455b3d6298431fae34a8f92905f4dd3a4f99f,3,0,4,4,3,2014-02-18 16:33:30,2014-02-18 16:33:30
20f455b3d6298431fae34a8f92905f4dd3a4f99f...e1c8bc8fea1a4eabaa76e4ee3d583c1b4f3796a9,1,8,6,14,2,2014-02-18 19:23:38,2014-02-18 16:20:35
e1c8bc8fea1a4eabaa76e4ee3d583c1b4f3796a9...b4f21d1807e0faf709ee5ae3a1518d6db8983581,3,54,0,54,2,2014-02-19 10:58:20,2014-02-19 09:21:10
b4f21d1807e0faf709ee5ae3a1518d6db8983581...99416c7ad061f9316089ee490ea721f79141bdf3,2,25,5,30,3,2014-02-19 12:45:24,2014-02-18 16:49:13
99416c7ad061f9316089ee490ea721f79141bdf3...821fc925f0e384966d0b06d03fc1dd0d14cd8ec0,1,1,1,2,1,2014-02-19 17:29:47,2014-02-19 17:29:47
821fc925f0e384966d0b06d03fc1dd0d14cd8ec0...cb844497d01ddb45603e47891cdf36ae0b006d03,2,3,0,3,2,2014-02-20 12:40:42,2014-02-20 12:40:42
faf6a911ad7357c8dd1defa3be0317a8418febf7...df2652c44836374bb8a691e755edbc153805f9cc,2,45,0,45,2,2014-02-17 22:51:40,2014-02-17 22:51:40
9d95dd08e55df6ce193a955656400f2190ef390a...be6d1f39e803aa86977a76c4e0a62ffbb5accf56,1,1,1,2,1,2014-02-15 12:35:41,2014-02-15 12:20:48
be6d1f39e803aa86977a76c4e0a62ffbb5accf56...8251438cb8c1d47779e9fc33cfa84dad9851a774,2,6,4,10,3,2014-02-15 12:54:35,2014-02-15 12:54:35
8251438cb8c1d47779e9fc33cfa84dad9851a774...2ebccebf0609229317c2f5b9a76664dc216f27eb,1,1,1,2,1,2014-02-15 13:19:33,2014-02-15 12:40:41
2ebccebf0609229317c2f5b9a76664dc216f27eb...23b781cc3d17f12c5158f781b2c8cd9d47550c20,4,75,18,93,11,2014-02-15 14:01:44,2014-02-15 10:28:09
23b781cc3d17f12c5158f781b2c8cd9d47550c20...fd4d8f0f520021186681dd0a0d413ed83f4d10f9,1,1,1,2,1,2014-02-15 14:14:58,2014-02-15 14:01:11
fd4d8f0f520021186681dd0a0d413ed83f4d10f9...4d4e0ea461e381b437c3e585b19f2f6e24e2f645,2,2,2,4,2,2014-02-15 14:16:16,2014-02-15 13:40:26
4d4e0ea461e381b437c3e585b19f2f6e24e2f645...8bbdcc76e4a84cde92b8dbfd01581d098bd2187d,5,32,7,39,9,2014-02-15 14:47:32,2013-09-29 19:56:04
8bbdcc76e4a84cde92b8dbfd01581d098bd2187d...79558c787ebfd0fe723acb061a375b19a27f18cd,5,25,12,37,10,2014-02-15 14:56:04,2014-02-15 13:41:01
79558c787ebfd0fe723acb061a375b19a27f18cd...985ae732b2fbb073a7c98ff857f463449345df27,1,3,0,3,1,2014-02-15 16:17:58,2014-02-15 15:26:22
985ae732b2fbb073a7c98ff857f463449345df27...d97bf2e9c8971764690caaf81a0914bc368d6b02,3,28,0,28,3,2014-02-15 16:14:28,2014-02-15 12:45:52
d97bf2e9c8971764690caaf81a0914bc368d6b02...1150053b994a6de665db51a18a07b992bd6714f1,2,6,5,11,5,2014-02-15 16:18:16,2014-02-15 14:55:50
1150053b994a6de665db51a18a07b992bd6714f1...65b421c6613dab85039d5d7b9601528ad9e6038c,3,6,5,11,4,2014-02-15 16:21:15,2014-02-15 16:21:15
65b421c6613dab85039d5d7b9601528ad9e6038c...d0133504e57589dc8983a20bf488e069bddd772c,2,30,1,31,2,2014-02-15 16:24:05,2014-02-15 14:36:07
d0133504e57589dc8983a20bf488e069bddd772c...0b6f9f7c6fb3589157c3231f28409c97c5c451ab,3,15,15,30,7,2014-02-15 16:51:18,2014-02-15 16:45:16
0b6f9f7c6fb3589157c3231f28409c97c5c451ab...44814e78ccd3a54da41c1b77ba3504c648ef4e89,1,8,1,9,2,2014-02-15 18:11:46,2014-02-15 18:11:46
44814e78ccd3a54da41c1b77ba3504c648ef4e89...1c1dffca757b0b6acaf99d893d68847250ab4146,2,6,1,7,2,2014-02-15 18:39:21,2014-02-15 17:55:33
1c1dffca757b0b6acaf99d893d68847250ab4146...cd7f37b6471dc947f06a40149e6c9789531e50a0,2,1,2,3,2,2014-02-15 18:42:12,2014-02-15 18:42:12
cd7f37b6471dc947f06a40149e6c9789531e50a0...94b5bc361aef2ae2d46a49dbfe32d9271c185800,3,19,0,19,3,2014-02-15 18:50:31,2014-02-15 16:27:12
94b5bc361aef2ae2d46a49dbfe32d9271c185800...f46ef750b9d08ef6081ab57428201028d77adb53,1,4,2,6,1,2014-02-15 19:25:23,2014-02-15 18:35:41
f46ef750b9d08ef6081ab57428201028d77adb53...9db4271bd11ac23a5a5652bbcdf8fb6d4b997651,2,28,2,30,2,2014-02-15 21:58:03,2014-02-15 21:58:03
9db4271bd11ac23a5a5652bbcdf8fb6d4b997651...653527de40115ddab04a7dcc69134ee4be45fa01,1,10,1,11,2,2014-02-16 12:12:49,2014-02-16 11:21:35
653527de40115ddab04a7dcc69134ee4be45fa01...74d4d58b62f3a68bf77b983bc8a475a130d1f95e,5,25,17,42,9,2014-02-16 12:25:21,2014-02-16 12:23:16
74d4d58b62f3a68bf77b983bc8a475a130d1f95e...bb83a32623ba18de737c7abc81bd2dfae12d7858,1,2,2,4,2,2014-02-16 13:50:32,2014-02-16 11:26:56
bb83a32623ba18de737c7abc81bd2dfae12d7858...57ba5bf97b13acdaccd6e091e6f23b619a6faedb,1,4,2,6,1,2014-02-16 13:50:32,2014-02-16 11:57:50
57ba5bf97b13acdaccd6e091e6f23b619a6faedb...8274fa60f88607eb0e81908f049c391455956dd8,4,66,7,73,5,2014-02-16 14:18:45,2014-02-16 13:50:27
8274fa60f88607eb0e81908f049c391455956dd8...a8ba76c2d3ad95595590af31c5cda123dc3868b7,4,31,5,36,7,2014-02-16 15:50:50,2014-02-16 13:47:51
38662d11c4201c9fe9ba810515c2ed0b939065c0...317fd13c7ac25db94d3dabf8ee115acbfbd3e5a7,1,7,0,7,1,2013-12-06 00:09:45,2013-12-05 13:45:49
317fd13c7ac25db94d3dabf8ee115acbfbd3e5a7...4d0c72eb68fc6518ef02c757b37e5548d0007f41,1,0,2,2,1,2013-12-06 06:10:52,2013-12-06 04:42:35
4d0c72eb68fc6518ef02c757b37e5548d0007f41...482ca0cecc93a76cbcbfbf784f56db160b2e5cfc,1,5,5,10,5,2013-12-06 09:00:09,2013-12-06 08:59:30
482ca0cecc93a76cbcbfbf784f56db160b2e5cfc...9a73e7f40c851cef262dd36da444c81492632ee5,1,1,1,2,1,2013-12-06 11:51:45,2013-12-06 11:44:43
38662d11c4201c9fe9ba810515c2ed0b939065c0...aba75b0d71808ed9ebc625e31a47da158f25b29d,2,38,12,50,7,2013-12-05 23:55:31,2013-12-05 23:55:31
cb844497d01ddb45603e47891cdf36ae0b006d03...6dfd02f88c49ce0d39191088863f6f45b0d7784e,1,4,4,8,4,2014-02-20 18:26:59,2014-02-20 18:26:59
cb844497d01ddb45603e47891cdf36ae0b006d03...3841feee86cae65165f120db7a5d80ffc76dd520,2,9,1,10,2,2014-02-20 18:13:25,2014-02-20 18:13:25
cdf6eba1816669bd77a28da903d931b5a4b15992...6b078044745ee3c665051a886021c6fd1f6873b6,5,44,3,47,7,2014-03-08 23:58:04,2014-03-08 23:57:25
6b078044745ee3c665051a886021c6fd1f6873b6...abccbcf52da4a0f0c388b8a770b5de04d6d6e64c,1,7,7,14,5,2014-03-09 00:04:21,2014-03-09 00:04:21
abccbcf52da4a0f0c388b8a770b5de04d6d6e64c...add1584bfa89cec574491bd42af7039d4869afd3,3,2,3,5,4,2014-03-09 00:17:54,2014-03-09 00:17:54
add1584bfa89cec574491bd42af7039d4869afd3...41afae4ce906838fc87d63962104cfb47991f68b,11,254,106,360,46,2014-03-09 01:57:18,2014-01-20 00:45:29
41afae4ce906838fc87d63962104cfb47991f68b...40afdaf08ca7562d8908b999511cd40a432520a9,1,1,1,2,1,2014-03-09 02:35:45,2014-03-09 02:35:35
40afdaf08ca7562d8908b999511cd40a432520a9...0615eaf24ad42e22873915bf8c1f5aca824d62c4,3,13,7,20,5,2014-03-09 06:33:33,2014-03-09 06:33:33
0615eaf24ad42e22873915bf8c1f5aca824d62c4...84c137490bad9043279278524bf958da8fb69fae,1,3,0,3,1,2014-03-09 08:23:47,2014-03-09 08:23:47
84c137490bad9043279278524bf958da8fb69fae...06615d0d6e75b537291ea6be74a973a8b6160211,1,2,4,6,4,2014-03-09 10:07:21,2014-03-02 13:37:30
06615d0d6e75b537291ea6be74a973a8b6160211...3a34f71d4dcadae3d8e6c1c603b47e603f0dada3,1,1,7,8,2,2014-03-09 10:07:21,2014-03-02 13:55:37
3a34f71d4dcadae3d8e6c1c603b47e603f0dada3...deff74ea0cc38794cd10a1a3866904c227c986f7,1,1,1,2,1,2014-03-09 10:27:12,2014-03-09 10:24:23
deff74ea0cc38794cd10a1a3866904c227c986f7...8b67fa755140fb4a6b961dfa97744286b5262a3c,1,2,2,4,2,2014-03-09 19:10:56,2014-03-09 19:10:56
8b67fa755140fb4a6b961dfa97744286b5262a3c...7339f43c718008394cf5c5119994f956e27bce70,1,3,1,4,2,2014-03-09 19:29:00,2014-03-09 19:29:00
7339f43c718008394cf5c5119994f956e27bce70...3315535ae899624688cc121db9c29f9a8ae51f9c,1,1,1,2,1,2014-03-09 20:20:34,2014-03-09 20:20:34
3315535ae899624688cc121db9c29f9a8ae51f9c...0e52b2863bb3286d5958c9f1289db47151261f90,1,2,2,4,2,2014-03-09 21:07:39,2014-03-09 21:07:39
0e52b2863bb3286d5958c9f1289db47151261f90...c564277937a1f0b78b2c2b701e6381319d9685c2,4,18,14,32,14,2014-03-09 21:10:49,2014-03-09 20:37:05
a06fd092ef3cdfb3d5327a95bd946a483a98a3de...f463789f6230c2fccf40c1e410443551bfb205a7,1,2,1,3,2,2013-12-06 14:22:47,2013-12-06 13:59:08
f463789f6230c2fccf40c1e410443551bfb205a7...54d9e3ccf6dd16f76fc9852edc19e4007e26dd7a,1,1,1,2,1,2013-12-06 14:22:52,2013-12-06 14:01:36
54d9e3ccf6dd16f76fc9852edc19e4007e26dd7a...19e437497172640a1b488228fb218719f9f7f5b4,3,10,6,16,5,2013-12-06 14:22:52,2013-12-06 14:05:12
19e437497172640a1b488228fb218719f9f7f5b4...72479a29579f72a7713ac3c07eb92f5bafee25bd,1,1,1,2,1,2013-12-06 14:23:21,2013-12-06 14:20:16
72479a29579f72a7713ac3c07eb92f5bafee25bd...621c25c419ae0f4d6d0f76725e5f3585d76228d0,5,25,4,29,7,2013-12-06 14:23:34,2013-12-06 14:21:13
621c25c419ae0f4d6d0f76725e5f3585d76228d0...362dd68fb20be195462af22448416c9895ce7df7,1,5,1,6,3,2013-12-06 15:35:18,2013-12-06 11:48:05
362dd68fb20be195462af22448416c9895ce7df7...b63acdfe7123c243b28e15f29e5b7a8487d69221,1,1,1,2,1,2013-12-06 18:06:59,2013-12-06 18:06:59
b63acdfe7123c243b28e15f29e5b7a8487d69221...38e24d680d28b92997def9ab46a961d09bb81dce,3,35,7,42,10,2013-12-06 19:12:38,2013-12-05 16:46:25
38e24d680d28b92997def9ab46a961d09bb81dce...bbc73e6a12227f5ed52fd38bc37f56f434a0a72c,2,8,2,10,3,2013-12-06 19:20:16,2013-12-06 01:14:57
bbc73e6a12227f5ed52fd38bc37f56f434a0a72c...ffc0e0ca3760759688b497ed9f580c3ebd807f80,1,1,1,2,1,2013-12-06 19:22:53,2013-12-06 19:22:53
ffc0e0ca3760759688b497ed9f580c3ebd807f80...a020dd0a99da13d0f024d42c46f01d8f503e9d5e,4,43,1,44,4,2013-12-07 02:21:58,2013-12-07 02:21:58
a020dd0a99da13d0f024d42c46f01d8f503e9d5e...19b22d4f0e0eafec1aafb9489f0830ae572b5db5,1,2,0,2,1,2013-12-07 02:37:31,2013-12-07 02:37:31
6dfd02f88c49ce0d39191088863f6f45b0d7784e...adcedfe8ba2376ab5106f0d6704770be95db6f12,1,2,2,4,2,2014-02-20 18:32:04,2014-02-20 18:32:04
c564277937a1f0b78b2c2b701e6381319d9685c2...7feb70eef3e8e76315e2535ccec94ac4ce34d7d2,3,140,8,148,14,2014-03-10 00:55:44,2014-03-10 00:38:24
19b22d4f0e0eafec1aafb9489f0830ae572b5db5...a1a26690b9c060e2ba1cf6437d5fa9b9a8952017,1,7,0,7,1,2013-12-07 08:28:22,2013-12-07 08:28:22
476abc7ea72fc7cbfed8e5a7b50b5d82e5d32105...462edd22e5577ff9ee6477f7572b571700d1a2aa,1,2,2,4,3,2014-02-21 21:23:06,2014-02-21 14:07:54
462edd22e5577ff9ee6477f7572b571700d1a2aa...578bdb532cd88333569ef3f77042653e1a9f2d9d,5,72,2,74,8,2014-02-22 12:26:29,2014-02-22 10:36:15
578bdb532cd88333569ef3f77042653e1a9f2d9d...cd027aaadfeac84111306ecda11ef5a0cfaacb75,5,37,0,37,4,2014-02-22 12:50:12,2014-02-18 13:46:23
cd027aaadfeac84111306ecda11ef5a0cfaacb75...847171b0d09c7da95cd404bab80f84c890fc5cfd,1,5,0,5,3,2014-02-22 12:50:12,2014-02-18 17:07:07
847171b0d09c7da95cd404bab80f84c890fc5cfd...926e18d7d126fcf7f4b2d25ce4155423ac6e2f90,5,44,13,57,16,2014-02-22 12:50:12,2014-02-21 13:46:23
926e18d7d126fcf7f4b2d25ce4155423ac6e2f90...d399731bf29bf842c756a77ff8a58706bac3d65f,2,11,3,14,4,2014-02-22 13:39:09,2014-02-22 12:39:33
d399731bf29bf842c756a77ff8a58706bac3d65f...173aa5199737c60ab883a0469684e83c01604ce8,2,11,3,14,3,2014-02-22 14:36:49,2014-02-22 14:36:49
3bd45ba00d0f43e9ea192eca132624b30cae4eee...819e09b848e4f1cc45165a99ffbef1307b215a08,4,27,2,29,6,2014-03-10 15:25:18,2014-03-10 15:17:57
819e09b848e4f1cc45165a99ffbef1307b215a08...daaf6cf9a4d2155d5fc59ab8bdcbbf328b523592,1,16,0,16,1,2014-03-10 16:25:47,2014-03-10 16:25:47
daaf6cf9a4d2155d5fc59ab8bdcbbf328b523592...1be31c320c2e0efa1730f73509d64e024ab31a0c,2,8,0,8,2,2014-03-10 20:11:23,2014-03-10 20:11:23
1be31c320c2e0efa1730f73509d64e024ab31a0c...05daaf2eea1bbff8da6f5367b9f7f05f8b1ab67e,1,12,0,12,1,2014-03-10 20:28:01,2014-03-10 20:24:47
05daaf2eea1bbff8da6f5367b9f7f05f8b1ab67e...40f6ca54f848f783f65855fcc7188a276de3974b,2,6,6,12,3,2014-03-10 23:23:45,2014-03-10 23:23:45
40f6ca54f848f783f65855fcc7188a276de3974b...107c9f545346149b03354678f53a177709edaced,2,53,5,58,3,2014-03-11 04:13:26,2014-03-11 02:52:29
107c9f545346149b03354678f53a177709edaced...6f470650d097abbc06021efd50b2bdc3c9ce4d3b,1,4,3,7,2,2014-03-11 10:56:27,2014-03-11 10:56:27
6f470650d097abbc06021efd50b2bdc3c9ce4d3b...ce3d9f847de0a34c08359fbea0f9c82550639c3a,1,3,3,6,2,2014-03-11 12:09:44,2014-03-11 12:09:44
ce3d9f847de0a34c08359fbea0f9c82550639c3a...89e4226ed180692ca0ee5e5e7cc52f5f4c8326a3,1,2,2,4,3,2014-03-11 12:11:16,2014-03-11 12:11:16
6d20a80d986848da5944904c7f91d6e002701ef1...8a9c8bb90736451e6bdea82723cbb23a695146fb,3,32,0,32,3,2013-12-07 09:14:22,2013-12-06 13:40:51
8a9c8bb90736451e6bdea82723cbb23a695146fb...41ebc4838d2b09e7f3ece8889e21492902b55dc8,4,26,9,35,11,2013-12-07 09:47:34,2013-12-05 21:55:33
41ebc4838d2b09e7f3ece8889e21492902b55dc8...a8f4553aaecc7bc6775e0fd54f8c615c792b3d97,2,50,1,51,4,2013-12-07 11:58:37,2013-12-04 07:11:34
a8f4553aaecc7bc6775e0fd54f8c615c792b3d97...e7dcd40da29008070267828fc15f5dfc94493111,1,1,0,1,1,2013-12-07 12:06:28,2013-12-07 12:06:28
e7dcd40da29008070267828fc15f5dfc94493111...65faa84de3fd3f42e938301574cccdec1578657d,2,2,32,34,5,2013-12-07 14:58:27,2013-12-07 14:52:30
173aa5199737c60ab883a0469684e83c01604ce8...e1d2a0bd046258100f1dff9ef3718829c36b5850,2,15,0,15,2,2014-02-23 16:16:12,2014-02-23 16:00:52
173aa5199737c60ab883a0469684e83c01604ce8...98f13762d7e18c0ba12044eed56e9198ca056c66,3,31,7,38,7,2014-02-22 16:45:33,2014-02-22 15:00:23
98f13762d7e18c0ba12044eed56e9198ca056c66...09b725f51bbfa0f01b27ee2d718889926d409519,1,11,0,11,1,2014-02-22 17:11:43,2014-02-22 14:18:51
09b725f51bbfa0f01b27ee2d718889926d409519...8cd32f09659cc271050a62b978f244b8a3445315,10,63,22,85,21,2014-02-22 17:29:06,2014-02-22 13:27:57
8cd32f09659cc271050a62b978f244b8a3445315...271929dd9d3aa5184cbb13d79b3651ac32e640ea,1,5,0,5,1,2014-02-22 17:31:40,2014-02-22 15:25:49
271929dd9d3aa5184cbb13d79b3651ac32e640ea...2798e63fa1fe1466ea4baf4058622f7bbe014033,1,1,0,1,1,2014-02-22 17:50:19,2014-02-22 17:50:19
2798e63fa1fe1466ea4baf4058622f7bbe014033...ede99f0ec3a14e3ba218b53c51d4295dbef77e3e,2,22,0,22,2,2014-02-22 19:14:41,2014-02-22 17:43:03
ede99f0ec3a14e3ba218b53c51d4295dbef77e3e...1d3ae4760b060f0df2965a2cfbee941bf8da6b31,1,3,1,4,3,2014-02-22 20:43:50,2014-02-22 20:43:50
1d3ae4760b060f0df2965a2cfbee941bf8da6b31...7e1376c2b0ea9e02e61c1c764f02cd40c6f7e849,4,21,1,22,5,2014-02-22 22:33:48,2014-02-22 21:28:27
7e1376c2b0ea9e02e61c1c764f02cd40c6f7e849...b8874084868080baff29ac3453d20a845fd1568c,4,7,7,14,7,2014-02-22 22:36:54,2014-02-22 16:54:32
b8874084868080baff29ac3453d20a845fd1568c...202bf69c2f69d9ee20ac3fd409116a8946dc0784,2,24,5,29,6,2014-02-23 08:30:02,2014-02-19 23:44:57
202bf69c2f69d9ee20ac3fd409116a8946dc0784...072fb923e1b2e39e85a4ed4569ee7cd94f26a0bb,1,8,1,9,2,2014-02-23 11:00:24,2014-02-23 11:00:24
072fb923e1b2e39e85a4ed4569ee7cd94f26a0bb...6d18ab01d96dbc7da2fd8807b9d8422d9e9e0b7d,1,0,3,3,1,2014-02-23 11:33:29,2014-02-19 03:36:37
6d18ab01d96dbc7da2fd8807b9d8422d9e9e0b7d...b645be80e99709c8b1f9b3d1c26e99e22fdca08b,1,3,0,3,1,2014-02-23 12:45:52,2014-02-23 12:21:09
89e4226ed180692ca0ee5e5e7cc52f5f4c8326a3...1d42a86ec7e16336955735474f88e7632a34f3cb,1,1,0,1,1,2014-03-11 12:52:43,2014-03-11 12:52:43
65faa84de3fd3f42e938301574cccdec1578657d...27dc7908d59385950b0f3ff1aa4bf0cddd787a2a,1,1,1,2,1,2013-12-08 13:16:45,2013-12-08 13:16:45
65faa84de3fd3f42e938301574cccdec1578657d...a7cf48a2b7878bf98879f2963ab9a7d0e6493d9a,1,2,1,3,2,2013-12-07 16:19:29,2013-12-07 08:54:50
a7cf48a2b7878bf98879f2963ab9a7d0e6493d9a...5c61b8519d8ce02e4308201f3e81fdc99ad80b58,4,20,1,21,9,2013-12-07 20:46:03,2013-12-07 18:28:01
65faa84de3fd3f42e938301574cccdec1578657d...2e3c7d882015375c130c21884d83cb9fb7759d94,1,4,0,4,1,2013-12-07 16:01:28,2013-12-07 16:01:17
4f7b7ef6837ee8e385785b164534fd5bc6c38e9f...a8a5c31966ff157b8d720fb0c8fd2df0191e2e61,1,1,1,2,2,2014-02-23 17:07:52,2014-02-23 17:07:52
a8a5c31966ff157b8d720fb0c8fd2df0191e2e61...27e906971067707a5fd9f910fd33bf0884103b87,1,2,0,2,1,2014-02-23 19:05:45,2014-02-23 19:04:58
27e906971067707a5fd9f910fd33bf0884103b87...b1d10205ce0c4bb355e20bed6258b5264ed06cc5,2,150,11,161,5,2014-02-23 20:36:25,2014-02-23 18:56:21
b1d10205ce0c4bb355e20bed6258b5264ed06cc5...91f4a75a6b83c51aae7318d6aec4e5557ffe42ff,1,4,1,5,1,2014-02-24 17:29:00,2014-02-24 17:26:29
91f4a75a6b83c51aae7318d6aec4e5557ffe42ff...65b4626528fc133a09ebc8d19fbaa871bdb7e17d,1,9,0,9,1,2014-02-25 12:41:50,2014-02-16 10:51:58
65b4626528fc133a09ebc8d19fbaa871bdb7e17d...e8161980347da5a68b4224d8a9ffc466630a796d,32,48,47,95,42,2014-02-25 15:28:32,2014-02-22 17:30:28
e8161980347da5a68b4224d8a9ffc466630a796d...e65c0ccac0741b793ba7be96f9dcc148bf26ca7d,1,4,0,4,1,2014-02-25 15:48:27,2014-02-22 17:06:39
e65c0ccac0741b793ba7be96f9dcc148bf26ca7d...355572ac56389a8d02cb93ea6a859e0d546bc6fb,1,3,0,3,1,2014-02-25 16:19:31,2014-02-22 12:07:50
355572ac56389a8d02cb93ea6a859e0d546bc6fb...4132e013ec96750455a967e0d061abe223820c20,1,7,7,14,1,2014-02-25 16:28:36,2014-02-25 16:28:36
4132e013ec96750455a967e0d061abe223820c20...3390550f6f645f82354eaffa1d3c89dfa041f1aa,1,10,12,22,2,2014-02-26 01:59:34,2014-02-25 15:44:46
3390550f6f645f82354eaffa1d3c89dfa041f1aa...48a8b714d49d7a4ceee66473aea72c2d8c84a672,1,1,1,2,1,2014-02-26 02:02:35,2014-02-25 19:29:15
48a8b714d49d7a4ceee66473aea72c2d8c84a672...2bab9d6d9ea095c4bcaeede2df576708afd46291,6,68,58,126,35,2014-02-26 15:58:04,2013-11-12 06:54:01
2bab9d6d9ea095c4bcaeede2df576708afd46291...4622d23ccf50a72432ff0c7416a4d6e0789c4f0b,1,2,6,8,4,2014-02-26 16:46:24,2014-02-26 16:43:14
6d3ebe10f4f8c4b91c9cbeccf9696ca79b6909f9...c4f772ed346fa68df503f545d28719c082f6b338,1,1,1,2,1,2014-03-11 14:46:13,2014-03-11 14:46:13
c4f772ed346fa68df503f545d28719c082f6b338...f4d91638fc4ab126ee9a269552511f5963ee61b4,1,40,38,78,3,2014-03-11 17:33:57,2014-03-11 17:33:57
f4d91638fc4ab126ee9a269552511f5963ee61b4...aaad3e27ac7cfcbbfeac6353d17d27e8da523cc8,5,154,49,203,21,2014-03-11 22:33:04,2014-03-07 11:56:28
aaad3e27ac7cfcbbfeac6353d17d27e8da523cc8...d181384e5f01e9d23fd9872b2cb532e0d70249b6,1,15,3,18,3,2014-03-12 18:17:43,2014-03-12 18:17:43
d181384e5f01e9d23fd9872b2cb532e0d70249b6...fc79c3fb3daf64b911b1ff8fed30f73c56630416,3,4,5,9,3,2014-03-12 18:34:05,2014-03-12 18:34:05
fc79c3fb3daf64b911b1ff8fed30f73c56630416...6983201cfb172c2895ed6eea1e0f0eb3804d4c00,3,63,17,80,14,2014-03-12 21:43:45,2014-03-12 21:43:45
6983201cfb172c2895ed6eea1e0f0eb3804d4c00...4b4c7045179ec4c0d9dc15c6518d5defd33b41aa,1,1,0,1,1,2014-03-12 22:28:05,2014-03-12 22:25:10
3f900a1e2c1d9cbf0a7275a13fc542f7df2b845a...f876552f4bd3f4b87441856b6e93d97938c45d39,3,57,4,61,3,2013-12-08 14:14:18,2013-12-08 14:14:18
f876552f4bd3f4b87441856b6e93d97938c45d39...626bdf648a2c4c4f5fd25fbc4af41a1acfa18d7f,32,55,55,110,54,2013-12-08 17:40:09,2013-12-08 17:39:26
626bdf648a2c4c4f5fd25fbc4af41a1acfa18d7f...c047dda057542b3b8722c6433028e3b800c38af9,1,1,1,2,1,2013-12-08 18:18:53,2013-12-08 18:18:53
5c61b8519d8ce02e4308201f3e81fdc99ad80b58...e2e2482391a4e7bd519be9b72e92ed00b2ab2f07,1,1,1,2,1,2013-12-08 01:13:53,2013-12-08 01:13:53
4622d23ccf50a72432ff0c7416a4d6e0789c4f0b...1b5bd470f03eff89f060648981f604fb04ad9ab3,1,1,1,2,1,2014-02-27 07:27:40,2014-02-27 07:27:40
4b4c7045179ec4c0d9dc15c6518d5defd33b41aa...c8823cf481a29e23fe3b9a4ce9f45f6d0b58ea9b,1,2,2,4,1,2014-03-13 09:04:30,2014-03-12 17:15:36
c8823cf481a29e23fe3b9a4ce9f45f6d0b58ea9b...958b511a80c01ac010561c8fefe4548203700fa3,1,1,1,2,1,2014-03-13 13:13:27,2014-03-13 13:08:11
958b511a80c01ac010561c8fefe4548203700fa3...5a976b4bec79cdb6b75581be6478356fb13fda77,3,21,1,22,4,2014-03-13 15:58:14,2014-03-13 15:55:38
5a976b4bec79cdb6b75581be6478356fb13fda77...72cfbdc10ab53ee9a3a9f253f38e9919728c0813,2,355,394,749,132,2014-03-14 08:44:56,2014-03-14 08:44:56
72cfbdc10ab53ee9a3a9f253f38e9919728c0813...666a2ad22ff868c214bf251d1171148d943cfc82,5,663,771,1434,46,2014-03-14 14:18:08,2014-03-14 14:18:08
4b4c7045179ec4c0d9dc15c6518d5defd33b41aa...61917aa08b4ab2bc35f3ffe87b7693bd8b58e205,3,340,227,567,11,2014-03-13 09:03:01,2014-01-29 04:53:30
61917aa08b4ab2bc35f3ffe87b7693bd8b58e205...5c5b266b5478aa4e8bd92f141c56f3a0997749eb,2,2,7,9,3,2014-03-13 09:03:01,2014-03-12 22:09:18
c047dda057542b3b8722c6433028e3b800c38af9...744aac6dace325752e3b1c7c8af64a7bc655186f,1,1,1,2,1,2013-12-09 21:54:11,2013-12-09 21:54:11
b1dcfddb729514d8eaa0a8276fa9fdb22a6f037e...9f76d0d351953b513e9cd4e2fbd7690077a65fae,1,1,1,2,1,2014-02-27 18:38:37,2014-02-27 18:36:44
9f76d0d351953b513e9cd4e2fbd7690077a65fae...7b4743580a2ac8e0194fb3781732cfb0bf96c3b7,1,1,1,2,1,2014-02-28 08:54:53,2014-02-28 08:54:53
7b4743580a2ac8e0194fb3781732cfb0bf96c3b7...c23b3717be71e4b2e5a32f156ef0a7b4703d012d,3,45,6,51,8,2014-02-28 12:05:55,2014-02-18 19:00:09
c23b3717be71e4b2e5a32f156ef0a7b4703d012d...72b080c2c8a5ab7930b13688b2865ebc5b636687,2,1,24,25,3,2014-02-28 12:18:45,2014-02-17 00:28:48
72b080c2c8a5ab7930b13688b2865ebc5b636687...2f25cdc18a3c15dd9feb9daa522f41aac39e232b,1,34,5,39,2,2014-02-28 13:10:07,2014-02-25 20:47:59
2f25cdc18a3c15dd9feb9daa522f41aac39e232b...55fb16258888443bc70398248b6e681f3bc032c8,2,7,2,9,3,2014-02-28 14:22:33,2014-02-28 14:22:33
55fb16258888443bc70398248b6e681f3bc032c8...7f2505ad9e27962ecbd61d2ce26ad691727404a4,27,38,38,76,34,2014-02-28 16:44:03,2014-02-28 16:44:03
7f2505ad9e27962ecbd61d2ce26ad691727404a4...cbd04c7c498689382ce56a7b7b31eca5ba98b590,1,2,2,4,2,2014-02-28 17:22:48,2014-02-28 17:22:15
cbd04c7c498689382ce56a7b7b31eca5ba98b590...ea869b514846cdd4803e3a87b08686113c14f7f2,1,6,1,7,1,2014-02-28 21:38:25,2014-02-23 14:10:28
ea869b514846cdd4803e3a87b08686113c14f7f2...7c0102379a1a1b386f4f4908d4a05b01df5f29f0,1,3,3,6,2,2014-02-28 23:00:53,2014-02-28 23:00:53
7c0102379a1a1b386f4f4908d4a05b01df5f29f0...8137215973c8cf97f58f244021b1a4e75923ade8,2,11,0,11,2,2014-03-01 01:42:56,2014-03-01 01:42:56
8137215973c8cf97f58f244021b1a4e75923ade8...1f5f015c32550c1424dd7804e8ee4717bcc5b9b7,20,27,28,55,26,2014-03-01 02:03:46,2014-03-01 02:03:46
1f5f015c32550c1424dd7804e8ee4717bcc5b9b7...75d0dcbf848e687042d889a8172962b6ea4206af,1,24,25,49,3,2014-03-01 09:25:06,2014-02-28 19:40:03
75d0dcbf848e687042d889a8172962b6ea4206af...a19f0d0c1e128634b9e393c52148167bf8718b4c,3,23,6,29,9,2014-03-01 09:36:48,2014-02-26 15:03:51
a19f0d0c1e128634b9e393c52148167bf8718b4c...c679cb7f600b13646a1a2b5fc8a03dfcc2e413f2,2,19,2,21,2,2014-03-01 12:45:45,2014-02-28 12:14:09
c679cb7f600b13646a1a2b5fc8a03dfcc2e413f2...8c98f39624a60c63a16e097b64e5f71ecc27271f,6,109,1,110,10,2014-03-01 12:52:45,2013-05-19 10:20:34
666a2ad22ff868c214bf251d1171148d943cfc82...cfbc887b2ca5824eaec1267864c6d6ed9df1a204,1,1,1,2,1,2014-03-14 18:00:27,2014-03-14 18:00:27
666a2ad22ff868c214bf251d1171148d943cfc82...37f7f233f5f30c28ea60a7fbc272ffd296e2dbe1,2,12,2,14,3,2014-03-14 16:21:59,2014-03-14 16:20:31
37f7f233f5f30c28ea60a7fbc272ffd296e2dbe1...d22b291890c1736a40c0ad97448c7318df2eebb2,8,105,15,120,11,2014-03-14 22:32:17,2014-03-14 22:18:20
356f064c49f926dd771e6ee590b43c8ac5dc4efc...81f5408c7a16b8c79053950f05fe7a873506ca55,3,149,0,149,6,2014-03-20 04:23:21,2014-03-20 04:21:27
81f5408c7a16b8c79053950f05fe7a873506ca55...831ce69cbbcf239c0fbbf525643e12e69275c93b,1,2,0,2,1,2014-03-20 04:25:26,2014-03-20 04:25:26
831ce69cbbcf239c0fbbf525643e12e69275c93b...3ecc25bd587d10f16831d6d1939ec7c758fc90c4,1,0,96,96,1,2014-03-20 09:37:39,2014-03-20 09:37:39
3ecc25bd587d10f16831d6d1939ec7c758fc90c4...0cf158cf9ac6f4d03faf8b72a71bf1d06ad8503e,1,4,3,7,4,2014-03-20 17:30:41,2014-03-20 17:30:41
0cf158cf9ac6f4d03faf8b72a71bf1d06ad8503e...222262ca2354abadf259f4186a0b43f583ed1bd1,1,1,3,4,2,2014-03-20 21:22:00,2014-03-20 21:21:14
0873200e7f61315ad375061a3dc6d37b514ff985...a2814846ca006b4fbf3a893ec52cd9d444b3a3eb,45,371,262,633,154,2013-12-10 20:12:48,2013-12-08 17:20:06
a2814846ca006b4fbf3a893ec52cd9d444b3a3eb...072e25eee70c0e629fcbb37f0485a6c6694b6856,1,6,7,13,6,2013-12-10 20:32:58,2013-12-10 20:32:58
072e25eee70c0e629fcbb37f0485a6c6694b6856...f3582a059470553cddda9a5c11f438764f9b81c6,1,1,1,2,1,2013-12-11 13:12:23,2013-12-11 13:12:12
f3582a059470553cddda9a5c11f438764f9b81c6...248fdb1110abefbdc14e3464c556b8a22abe4edc,3,95,66,161,19,2013-12-11 13:16:29,2013-12-11 13:16:29
248fdb1110abefbdc14e3464c556b8a22abe4edc...cee4fe73071b469edf118bec3a080ffca906d323,1,5,3,8,3,2013-12-11 13:23:07,2013-12-11 13:23:07
cee4fe73071b469edf118bec3a080ffca906d323...5db028affbffa2dc7a957fcf73401830b43bf540,5,173,17,190,21,2013-12-11 14:19:05,2013-12-11 14:19:05
5db028affbffa2dc7a957fcf73401830b43bf540...c7c647419cb857fe53cf1368c10223c6e042c216,3,15,4,19,6,2013-12-11 14:30:20,2013-12-07 13:11:27
c7c647419cb857fe53cf1368c10223c6e042c216...75924cfa6dca95aa1f02e38802df285271dc7c14,3,45,7,52,6,2013-12-11 17:49:28,2013-12-08 19:12:01
75924cfa6dca95aa1f02e38802df285271dc7c14...5cd6477fd6ea31eeb4d281e8e431b7a5fb8038a1,3,10,2,12,3,2013-12-11 20:24:17,2013-12-08 23:07:04
5cd6477fd6ea31eeb4d281e8e431b7a5fb8038a1...9c5f59f48954507f9d547c0d51f038f1a216a6c2,1,5,6,11,4,2013-12-11 22:16:06,2013-12-11 22:16:06
9c5f59f48954507f9d547c0d51f038f1a216a6c2...9922ed46e2e81845006792310f3f1a3bf0d7b2a6,4,26,54,80,7,2013-12-12 09:24:43,2013-11-23 17:27:23
9922ed46e2e81845006792310f3f1a3bf0d7b2a6...24fcca6bddca3db33ac73c29ad9167ac279e4d94,1,21,1,22,3,2013-12-12 13:56:34,2013-12-12 10:45:27
24fcca6bddca3db33ac73c29ad9167ac279e4d94...7d44b5d5d00a7850c3cd7a8abbf7a91e7c0d7994,1,22,13,35,12,2013-12-12 14:38:50,2013-12-12 14:16:21
8c98f39624a60c63a16e097b64e5f71ecc27271f...775975f15d7d461c154e558cba5fb0592539126f,7,64,24,88,12,2014-03-01 13:07:57,2014-03-01 09:42:08
bb2c58c70133b3a03437e7d45510b062cb31b36c...659b5678fcb89417ce1967bc590fdd693f906e69,1,2,0,2,1,2014-03-15 11:34:11,2014-03-15 11:33:04
659b5678fcb89417ce1967bc590fdd693f906e69...834d78ffc3a7eb62d55ac269f83ac0e7473662ea,2,7,4,11,5,2014-03-15 12:49:03,2014-03-15 12:47:32
834d78ffc3a7eb62d55ac269f83ac0e7473662ea...885e7adf568037b59b5642ab061133eaa00e5d7d,1,8,0,8,1,2014-03-16 14:40:59,2014-03-15 19:18:05
885e7adf568037b59b5642ab061133eaa00e5d7d...abade6413bf55d305f005c02577ad7c6aede7fdf,1,20,0,20,2,2014-03-16 18:34:18,2014-03-16 09:02:55
abade6413bf55d305f005c02577ad7c6aede7fdf...ad43fdaa0008ce8d3d05e840f67af631d1329489,1,35,1,36,2,2014-03-16 19:40:52,2014-03-05 18:23:25
ad43fdaa0008ce8d3d05e840f67af631d1329489...584044566414d3f4595337225aa23b52a089a680,2,27,2,29,3,2014-03-17 10:49:59,2014-03-17 10:49:59
584044566414d3f4595337225aa23b52a089a680...fad47367bf622635b4cf931db72310cce41cebb4,2,41,1,42,2,2014-03-17 11:22:27,2014-03-04 22:40:44
fad47367bf622635b4cf931db72310cce41cebb4...cc5804bcab9e410a2c0fc2225fd0233bf8db0511,1,3,2,5,1,2014-03-17 22:45:06,2014-03-17 15:58:34
cc5804bcab9e410a2c0fc2225fd0233bf8db0511...b47ef04ea2a3b1a48160253dd0ab906e621cecee,1,8,2,10,2,2014-03-18 03:54:35,2014-03-18 03:54:35
b47ef04ea2a3b1a48160253dd0ab906e621cecee...61296fb1baabe616c74091dcae9d4f2f6ba6dda6,1,3,4,7,2,2014-03-18 09:57:47,2014-03-17 17:06:11
61296fb1baabe616c74091dcae9d4f2f6ba6dda6...fc167c9b5ee958019b3f95916c93b97ecb0e1053,1,1,1,2,1,2014-03-18 11:25:37,2014-03-17 17:50:31
fc167c9b5ee958019b3f95916c93b97ecb0e1053...2e5b82f6277227b69e9a6c5261a6deb14fff15dc,4,0,0,0,0,2014-03-18 13:51:06,2014-03-18 13:51:06
2e5b82f6277227b69e9a6c5261a6deb14fff15dc...8520e43e138f518b5962c00f05e17dab70a407da,1,1,1,2,1,2014-03-18 14:30:52,2014-03-18 14:30:52
8520e43e138f518b5962c00f05e17dab70a407da...61fdb8d487f62e5b89b3bef9cb2b212dcec6d1e5,1,25,25,50,2,2014-03-18 14:35:22,2014-03-17 10:46:58
61fdb8d487f62e5b89b3bef9cb2b212dcec6d1e5...c11b9346d4ebc10d8d98945a974016a5e85f25e6,1,2,2,4,2,2014-03-19 10:49:29,2014-03-19 00:39:14
c11b9346d4ebc10d8d98945a974016a5e85f25e6...0399523cf1ac1f6adcfe593e05824ff4f98da3d3,2,18,2,20,3,2014-03-19 11:22:01,2014-03-18 17:02:42
0399523cf1ac1f6adcfe593e05824ff4f98da3d3...ac9c7701a7ab869e6ec610630c6b1cfd368fe8ce,1,1,1,2,1,2014-03-20 00:37:00,2014-03-19 21:28:52
222262ca2354abadf259f4186a0b43f583ed1bd1...f2eea960e052db2d280e6dd016b0f8f23d5a8ef7,1,1,1,2,1,2014-03-21 10:02:15,2014-03-21 06:30:10
f2eea960e052db2d280e6dd016b0f8f23d5a8ef7...4d0c5f61427a8e67552ee2d777fffbadc7aff3b2,5,61,8,69,16,2014-03-21 10:12:36,2014-03-13 11:23:12
4d0c5f61427a8e67552ee2d777fffbadc7aff3b2...2f37ad88b14d50f38b31adaa6c904e38c573dfc4,2,3,3,6,3,2014-03-21 10:17:14,2014-03-21 10:17:14
2f37ad88b14d50f38b31adaa6c904e38c573dfc4...86c89265698f636107a31f3538d2cd604049990d,2,181,0,181,2,2014-03-21 10:19:19,2014-03-21 10:19:19
86c89265698f636107a31f3538d2cd604049990d...35f46ec7a99291a560e374183ab4feba2a5c679a,2,5,5,10,2,2014-03-21 10:24:45,2014-03-21 10:24:45
35f46ec7a99291a560e374183ab4feba2a5c679a...aa93a1890f25cbd43bfab0b6684915d8b3c42702,225,23,27552,27575,161,2014-03-21 11:05:36,2014-03-21 11:05:36
aa93a1890f25cbd43bfab0b6684915d8b3c42702...11e22129d50c00e50e3e7521b6e08004d32d070e,4,0,71,71,10,2014-03-21 11:15:58,2014-03-21 11:15:58
11e22129d50c00e50e3e7521b6e08004d32d070e...bcc15e2b21217c280afd613b1beff238e23fce75,5,8,59,67,14,2014-03-21 11:47:25,2014-03-21 11:45:38
bcc15e2b21217c280afd613b1beff238e23fce75...9344bbb446b97840d0bd8d8e64d6a8f171f290f8,2,0,23,23,4,2014-03-21 11:56:00,2014-03-21 11:56:00
9344bbb446b97840d0bd8d8e64d6a8f171f290f8...99339c77f648fcdc30f6d914cb7efd902327ade7,1,0,33,33,1,2014-03-21 12:27:37,2014-03-21 12:27:37
99339c77f648fcdc30f6d914cb7efd902327ade7...8b81dee60c1533e714a310fa5c3907356042a64c,7,3,144,147,17,2014-03-21 12:50:43,2014-03-21 12:32:01
8b81dee60c1533e714a310fa5c3907356042a64c...f567d04b249913db4a37adab8ba521cdc974d423,3,5,105,110,16,2014-03-21 13:46:17,2014-03-21 13:46:17
f567d04b249913db4a37adab8ba521cdc974d423...6d1ae5e27c3fe612209023bacd8a201fffedc375,2,2,4,6,2,2014-03-21 13:53:16,2014-03-21 13:53:16
6d1ae5e27c3fe612209023bacd8a201fffedc375...4965a774074780f3e4858bcc975476f71edf2c2c,15,48,211,259,42,2014-03-21 14:54:53,2014-03-21 14:54:53
4965a774074780f3e4858bcc975476f71edf2c2c...f6c1f05fbf8fdf980c91666d1c14990632e18503,1,0,12,12,3,2014-03-21 15:10:34,2014-03-21 15:10:34
f6c1f05fbf8fdf980c91666d1c14990632e18503...797d742662a47417ab875b7a1f5d7919caf5363f,1,0,7,7,1,2014-03-21 15:18:04,2014-03-21 15:18:04
797d742662a47417ab875b7a1f5d7919caf5363f...cb47969cd7271749393998a21bc8c467088d6235,1,0,7,7,3,2014-03-21 15:20:52,2014-03-21 15:20:52
cb47969cd7271749393998a21bc8c467088d6235...274048351ae2fc35995645a6dad7c98f74f51eb1,2,2,28,30,5,2014-03-21 15:35:33,2014-03-21 15:35:33
274048351ae2fc35995645a6dad7c98f74f51eb1...1ea44a3abd4e58777247a095afd03dd01efdef55,4,28,81,109,29,2014-03-21 17:17:10,2014-03-21 17:17:10
1ea44a3abd4e58777247a095afd03dd01efdef55...b71f183d2e4eb9397ae52c139eb0863be731b778,1,1,1,2,1,2014-03-21 17:23:04,2014-03-21 17:22:39
b71f183d2e4eb9397ae52c139eb0863be731b778...bf5430a20b65b3e76a2f8cd2580101e0baa59f82,9,3,3162,3165,11,2014-03-21 17:36:46,2014-03-21 17:30:40
bf5430a20b65b3e76a2f8cd2580101e0baa59f82...907ac646415a911b54d84c5203d4fa78ed1b91d5,3,3,3,6,3,2014-03-21 18:56:31,2014-03-21 16:24:49
907ac646415a911b54d84c5203d4fa78ed1b91d5...0f9560855e5ed203b8c911c23237826e28a62a38,29,78,1454,1532,88,2014-03-21 20:06:50,2014-03-21 13:21:43
0f9560855e5ed203b8c911c23237826e28a62a38...753a22a6352638b7df55176584795ac8c5d4232c,3,7,5,12,3,2014-03-21 20:29:51,2014-03-21 17:48:57
753a22a6352638b7df55176584795ac8c5d4232c...06160cb945e35f7d58e2313e23fb6be70d5b47b7,3,1,27,28,5,2014-03-21 20:34:47,2014-03-21 20:34:35
06160cb945e35f7d58e2313e23fb6be70d5b47b7...ad83d37bf8e47a9704948df3035e09a5e1584c04,1,1,5,6,3,2014-03-21 20:38:24,2014-03-21 20:38:24
ad83d37bf8e47a9704948df3035e09a5e1584c04...ad3942d325fff29e78d02b454b8fec3afb3871a7,1,1,3,4,2,2014-03-21 20:40:04,2014-03-21 20:40:04
ad3942d325fff29e78d02b454b8fec3afb3871a7...253e8ac29fa4eb86bfc327fd4b68291370c9011c,3,4,10,14,3,2014-03-21 21:07:39,2014-03-21 21:07:39
253e8ac29fa4eb86bfc327fd4b68291370c9011c...051c666acac770dea1af2fc223cc695f985f02f7,1,0,24,24,2,2014-03-21 21:16:14,2014-03-21 21:16:14
051c666acac770dea1af2fc223cc695f985f02f7...6993f2886bb9535c6cde95ec0c743f40b40e324e,2,3,3,6,3,2014-03-21 21:16:31,2014-03-21 21:16:31
6993f2886bb9535c6cde95ec0c743f40b40e324e...7e0f9095f762a74116b0b4ba0c88267bdf184e0f,1,0,12,12,2,2014-03-21 21:17:36,2014-03-21 21:17:36
7e0f9095f762a74116b0b4ba0c88267bdf184e0f...918a16bc4c099ab0cae72a231de3e99e2a9d02cb,2,15,1,16,2,2014-03-21 21:34:47,2014-03-21 14:57:18
918a16bc4c099ab0cae72a231de3e99e2a9d02cb...e80de93af6a0a21a9063a55c4d6d20e3927243e9,5,15,66,81,20,2014-03-21 23:10:07,2014-03-21 23:07:13
e80de93af6a0a21a9063a55c4d6d20e3927243e9...306283bf358470b7d439822af90051ac62e95bae,1,0,10,10,3,2014-03-21 23:25:54,2014-03-21 23:25:54
306283bf358470b7d439822af90051ac62e95bae...d74e33eb0ec289d3125a5a8048d756f9d232bd62,1,2,8,10,2,2014-03-21 23:34:21,2014-03-21 23:34:21
d74e33eb0ec289d3125a5a8048d756f9d232bd62...80e6960580b8400f419cd7177293ed3d293f6e10,2,1,6,7,3,2014-03-22 00:18:19,2014-03-22 00:18:19
80e6960580b8400f419cd7177293ed3d293f6e10...aaa21102592e96c543d60513755d6c81f639f122,1,25,7,32,3,2014-03-22 09:35:06,2014-03-21 08:15:33
aaa21102592e96c543d60513755d6c81f639f122...6ca6c36f82b97eafeada61384b2e2f1d0587da86,4,51,10,61,10,2014-03-22 09:59:18,2014-03-20 15:50:50
6ca6c36f82b97eafeada61384b2e2f1d0587da86...0757e0f30d5ad3731d4a59fe571256369663c2f6,2,9,5,14,5,2014-03-22 10:05:14,2014-03-22 10:02:00
0757e0f30d5ad3731d4a59fe571256369663c2f6...1c8dbb0cc268c6a2edc8268776b440f64867e6fb,2,9,0,9,2,2014-03-22 11:25:26,2014-03-22 11:25:26
1c8dbb0cc268c6a2edc8268776b440f64867e6fb...ee4edb1eda2ac8f09eb298929282b44776930c89,9,77,100,177,36,2014-03-22 11:56:48,2014-03-22 00:44:34
ee4edb1eda2ac8f09eb298929282b44776930c89...6877a9d4156baa3a0c22288c7ef920915b6e1cf8,1,5,4,9,3,2014-03-22 13:39:27,2014-03-22 13:36:01
6877a9d4156baa3a0c22288c7ef920915b6e1cf8...6a0291bdaf43e5467a524dcc67f85b55f36fe46f,1,8,2,10,2,2014-03-22 13:43:11,2014-03-22 13:41:45
6a0291bdaf43e5467a524dcc67f85b55f36fe46f...bc315266c86f371ab04d05c43383775267e8595a,4,10,6,16,7,2014-03-22 15:39:46,2014-03-22 15:33:37
bc315266c86f371ab04d05c43383775267e8595a...acee46fc950153c1c411f779b20f66141eb0d245,2,16,2,18,4,2014-03-22 15:52:05,2014-03-22 15:52:05
acee46fc950153c1c411f779b20f66141eb0d245...c94bff2b26f8844fe15d68a79511ff3a6853dc61,5,13,5,18,8,2014-03-22 16:00:50,2014-03-22 16:00:50
c94bff2b26f8844fe15d68a79511ff3a6853dc61...96fc3908ad25f40b4c6e2f76be2639f665223227,1,19,12,31,2,2014-03-22 17:05:56,2014-03-22 16:12:43
96fc3908ad25f40b4c6e2f76be2639f665223227...684e8a941bd0d08504718996c1afaf57957ce070,1,1,1,2,1,2014-03-22 17:11:39,2014-03-22 17:11:39
684e8a941bd0d08504718996c1afaf57957ce070...e61d99d96daedfea2f6ba071945ef0d2f86883c7,4,30,16,46,6,2014-03-22 18:28:12,2014-03-22 17:16:49
e61d99d96daedfea2f6ba071945ef0d2f86883c7...491419b5ffac3752a1c1804a763c017a2ed82e16,2,20,1,21,5,2014-03-22 18:43:17,2013-05-19 19:28:33
491419b5ffac3752a1c1804a763c017a2ed82e16...74b34676468f2cbf0e5e996cca6f83fabe7a3f6d,9,18,203,221,27,2014-03-22 18:58:50,2014-03-22 17:31:52
74b34676468f2cbf0e5e996cca6f83fabe7a3f6d...232181d1c5307d9af5fc292682661e91439a9289,9,22,20,42,22,2014-03-22 20:12:58,2014-03-22 20:08:59
232181d1c5307d9af5fc292682661e91439a9289...3a97f992fbfbcf8b0480875b257e5d541a4b8315,21,179,177,356,101,2014-03-22 20:32:20,2014-03-22 20:30:49
3a97f992fbfbcf8b0480875b257e5d541a4b8315...b66e85342b6ab28b7f48b47fe3fcfbccd5d9943f,1,15,17,32,9,2014-03-22 20:35:46,2014-03-22 20:28:12
b66e85342b6ab28b7f48b47fe3fcfbccd5d9943f...fa8b4735287c92b03d23823de8a4e1168d1951d9,3,30,4,34,6,2014-03-22 21:48:12,2014-03-21 07:38:25
fa8b4735287c92b03d23823de8a4e1168d1951d9...a6fc18594ebf3e4268df701de5180c126ae2ca5e,1,2,0,2,2,2014-03-22 22:12:52,2014-03-22 22:12:52
a6fc18594ebf3e4268df701de5180c126ae2ca5e...58161e4e93d1fc796fc804c943028d4433f4813c,2,53,2,55,4,2014-03-23 19:45:22,2014-03-23 19:45:22
58161e4e93d1fc796fc804c943028d4433f4813c...3f7615cddc69235d466fb680fb05869f2a80d1e4,1,1,1,2,1,2014-03-23 20:18:39,2014-03-23 20:17:52
3f7615cddc69235d466fb680fb05869f2a80d1e4...7ac8380799eedb374621317b62ccf026d86ea245,4,57,0,57,5,2014-03-24 11:21:32,2014-03-22 18:08:04
7ac8380799eedb374621317b62ccf026d86ea245...bff77e2aa81f90b5be2fd00220b479077d8082de,1,3,3,6,1,2014-03-24 11:27:04,2014-03-24 11:06:39
bff77e2aa81f90b5be2fd00220b479077d8082de...2ec82c7387db071278201796208808de84c90dbf,4,30,13,43,9,2014-03-24 11:33:55,2014-03-24 11:33:04
2ec82c7387db071278201796208808de84c90dbf...416a8580232075d569cf3c386a97067884c67a60,4,50,12,62,11,2014-03-24 12:11:54,2014-03-03 17:59:03
222262ca2354abadf259f4186a0b43f583ed1bd1...dda6224459ed843dfd63e85729613fcc60ce925f,1,1,1,2,1,2014-03-21 00:42:11,2014-03-21 00:42:11
dda6224459ed843dfd63e85729613fcc60ce925f...cc8a800d0c7c9335f74d1b9e4ae16bc44e8f85a9,1,1,1,2,1,2014-03-21 10:14:57,2014-03-21 06:30:10
cc8a800d0c7c9335f74d1b9e4ae16bc44e8f85a9...b74ec85c1d4285aa6b3e220c6b55596dd6bdafad,5,61,8,69,16,2014-03-21 10:18:26,2014-03-13 11:23:12
b74ec85c1d4285aa6b3e220c6b55596dd6bdafad...caa753ffd634eb6305f844fdd958314e5aa0d341,2,5,5,10,2,2014-03-21 10:25:21,2014-03-21 10:24:45
caa753ffd634eb6305f844fdd958314e5aa0d341...563d6a6bbaaf80dd60164f8f0e3335215c3ae019,1,2,2,4,2,2014-03-21 15:23:59,2014-03-21 15:23:59
563d6a6bbaaf80dd60164f8f0e3335215c3ae019...79989263a29c4823f8f2e9cf2753fa34be8f9beb,3,3,3,6,3,2014-03-21 19:02:03,2014-03-21 16:24:49
79989263a29c4823f8f2e9cf2753fa34be8f9beb...60d2213d4314d0406e1c7771d3d8841145502bf7,2,4,1,5,2,2014-03-21 21:09:57,2014-03-21 21:09:57
60d2213d4314d0406e1c7771d3d8841145502bf7...0c19383a1ffaaefe92b7b3bfaac6885525afd9a9,1,25,7,32,3,2014-03-22 09:55:10,2014-03-21 08:15:33
0c19383a1ffaaefe92b7b3bfaac6885525afd9a9...80f08dbdbc1f9c8b4ed75298955016feb697c4a1,4,51,10,61,10,2014-03-22 10:01:14,2014-03-20 15:50:50
80f08dbdbc1f9c8b4ed75298955016feb697c4a1...4b725320481b73c2c0e638405e9d5fada32119a0,2,9,0,9,2,2014-03-22 11:35:56,2014-03-22 11:25:26
4b725320481b73c2c0e638405e9d5fada32119a0...07d4b3c8f28eb73bdbf2b1f61990daf01880e46b,1,8,2,10,2,2014-03-22 13:44:13,2014-03-22 13:41:45
07d4b3c8f28eb73bdbf2b1f61990daf01880e46b...908bdea482d0a5af7a4c9d38ae52ed876d30cbe4,2,16,2,18,4,2014-03-22 15:54:02,2014-03-22 15:52:05
908bdea482d0a5af7a4c9d38ae52ed876d30cbe4...d345a030c2f3b332512e5091248dd8b06e859eac,5,13,5,18,8,2014-03-22 16:11:12,2014-03-22 16:00:50
d345a030c2f3b332512e5091248dd8b06e859eac...6d254e5a97e719800846e34058ae9752172dbb0e,1,1,1,2,1,2014-03-22 17:17:51,2014-03-22 17:11:39
6d254e5a97e719800846e34058ae9752172dbb0e...e1a6a3024fdca1160c52784bace931cdf6cd52e5,1,1,1,2,1,2014-03-23 20:20:19,2014-03-23 20:17:52
e1a6a3024fdca1160c52784bace931cdf6cd52e5...1694e091f122f1c85c85317f519f5aa237cf317b,1,1,1,2,1,2014-03-24 04:09:12,2014-03-24 04:09:12
1694e091f122f1c85c85317f519f5aa237cf317b...f847aeb6f88b2a39d32a916b0649330764dc145e,1,3,3,6,1,2014-03-24 11:27:27,2014-03-24 11:06:39
f847aeb6f88b2a39d32a916b0649330764dc145e...70b34f095c85a70f05439de1c96b7c761b1c9e32,4,30,13,43,9,2014-03-24 11:34:18,2014-03-24 11:33:04
70b34f095c85a70f05439de1c96b7c761b1c9e32...68a80166cd2a7e36d077a550468d382f443a079e,1,2,1,3,1,2014-03-24 13:09:19,2014-03-24 13:06:57
68a80166cd2a7e36d077a550468d382f443a079e...57a373b08c44e325b31d9c79184b82f1d8cb764f,1,10,10,20,7,2014-03-24 13:19:46,2014-03-24 13:15:32
57a373b08c44e325b31d9c79184b82f1d8cb764f...eb1600e9d1916d9db40ce1dce101224bd8859add,2,20,4,24,2,2014-03-24 13:45:50,2014-02-22 19:29:55
eb1600e9d1916d9db40ce1dce101224bd8859add...345281b880ef69519656d23f898b899b02cd51cc,1,1,1,2,1,2014-03-24 17:06:58,2014-03-24 16:58:05
345281b880ef69519656d23f898b899b02cd51cc...21eaad68e6f26b9f88437c63d584c0a9fb39c9be,3,14,1,15,3,2014-03-24 17:27:06,2014-03-20 04:08:28
21eaad68e6f26b9f88437c63d584c0a9fb39c9be...b4f165fe941b1aaca49e417330103a02fecb2e85,2,24,1,25,3,2014-03-25 11:46:48,2014-03-21 07:52:49
b4f165fe941b1aaca49e417330103a02fecb2e85...24604844866a0b28122a1c47ac85072ea05b9b71,4,50,4,54,10,2014-03-25 13:34:12,2014-02-18 22:44:33
24604844866a0b28122a1c47ac85072ea05b9b71...ddcbde41eec12f7a84b00635cdbf1c93d4e4d297,2,8,2,10,3,2014-03-25 13:55:29,2014-03-22 21:57:01
ddcbde41eec12f7a84b00635cdbf1c93d4e4d297...bf69375c4d2eaec4f00c646b9e7e84a9397d1a20,2,14,2,16,3,2014-03-25 14:34:28,2014-03-25 14:02:51
bf69375c4d2eaec4f00c646b9e7e84a9397d1a20...d84beb3d9105300a94061dd94911a0c3cd9021d2,2,2,14,16,3,2014-03-25 16:07:37,2014-03-25 16:07:37
d84beb3d9105300a94061dd94911a0c3cd9021d2...7eaf329ad38ff7ea6b47f1b0a3c20ca7a5ad079b,3,13,26,39,4,2014-03-25 18:03:02,2014-03-25 14:17:23
7eaf329ad38ff7ea6b47f1b0a3c20ca7a5ad079b...78211b13a51f2ada1c7beb81ff97ef11f9e239eb,8,153,26,179,19,2014-03-25 18:31:54,2014-03-04 01:12:42
78211b13a51f2ada1c7beb81ff97ef11f9e239eb...81d3d48b5ed841414c1d91743aea23dab36c8b4b,1,4,3,7,3,2014-03-25 23:30:33,2014-03-25 20:02:53
81d3d48b5ed841414c1d91743aea23dab36c8b4b...1cb6729f58ef14c2042373d8bd61fa264a955705,1,6,0,6,1,2014-03-26 00:02:07,2014-03-25 20:58:47
1cb6729f58ef14c2042373d8bd61fa264a955705...39fc8d4b8e94d9e019148ce9d287e72b3363a7bf,2,38,10,48,3,2014-03-26 00:04:49,2014-03-25 18:32:24
39fc8d4b8e94d9e019148ce9d287e72b3363a7bf...4bd7411edf21f235a0a2b67f170a2bad8c37518c,1,2,2,4,1,2014-03-26 14:11:12,2014-03-26 13:57:00
4bd7411edf21f235a0a2b67f170a2bad8c37518c...994274ea8315282484bc24aa403b2fd12b5bdeec,1,6,24,30,4,2014-03-26 14:41:45,2014-03-26 14:39:52
994274ea8315282484bc24aa403b2fd12b5bdeec...4678efd3f1e2f764583a59b9c1f4302d955acebb,1,15,8,23,6,2014-03-26 17:02:52,2014-03-26 01:40:56
4678efd3f1e2f764583a59b9c1f4302d955acebb...fe61ba91c723b77173fc3221dbd92ad267cbd3a9,4,6,4,10,4,2014-03-27 10:11:01,2014-03-27 02:43:31
fe61ba91c723b77173fc3221dbd92ad267cbd3a9...3d74f1f64a78e5aeebb91c76e44d8e318a1c0023,1,1,1,2,1,2014-03-27 11:01:04,2014-03-27 10:59:54
3d74f1f64a78e5aeebb91c76e44d8e318a1c0023...0134d00be5446d9ae51a1a36e4e10289037f8782,1,2,3,5,2,2014-03-27 11:01:20,2014-03-26 23:06:09
0134d00be5446d9ae51a1a36e4e10289037f8782...e2e773c04abeab04866eac14c0040ef3aa653e1b,2,14,5,19,2,2014-03-27 11:02:02,2014-03-25 21:06:54
e2e773c04abeab04866eac14c0040ef3aa653e1b...5f04240381cf5ad0cf3a9f6e2e38601fa65f42e1,3,7,8,15,5,2014-03-27 12:12:58,2014-03-26 14:55:59
5f04240381cf5ad0cf3a9f6e2e38601fa65f42e1...c9014a95bc9fb37d8e380f65f7926dadc598c8e7,1,7,7,14,5,2014-03-28 11:30:35,2014-03-27 18:19:31
c9014a95bc9fb37d8e380f65f7926dadc598c8e7...a6a0800579c806d54af7edd425063be8de4051ab,2,10,1,11,2,2014-03-29 06:28:43,2014-03-29 05:58:25
a6a0800579c806d54af7edd425063be8de4051ab...c139e3e0a0d190b9b06e0cf2ec0c0c409ca978c3,1,11,13,24,5,2014-03-29 14:23:23,2014-03-29 14:17:19
c139e3e0a0d190b9b06e0cf2ec0c0c409ca978c3...18b2c03ea31027d2f102df3c6b173cb6e63da52d,1,5,1,6,2,2014-03-29 18:47:47,2014-03-29 18:44:11
18b2c03ea31027d2f102df3c6b173cb6e63da52d...0f9f8738d5599fa3950606c8e6a462f4813e4830,1,1,1,2,1,2014-03-30 18:27:05,2014-03-30 18:25:06
0f9f8738d5599fa3950606c8e6a462f4813e4830...273f8e2297b1cd0d7998ae97710edc8b69d057f6,1,1,0,1,1,2014-03-30 21:46:38,2014-03-30 18:46:05
273f8e2297b1cd0d7998ae97710edc8b69d057f6...422f5d9a2cf57292195477a845264d0dd4d9fa11,1,1,1,2,1,2014-03-30 23:34:29,2014-03-30 23:30:07
422f5d9a2cf57292195477a845264d0dd4d9fa11...bdec84806365209bf800e9213a1cbb9b5dc2aa29,2,31,9,40,4,2014-03-31 10:35:06,2014-03-31 06:09:12
bdec84806365209bf800e9213a1cbb9b5dc2aa29...8e73d3a2c17bd3233d5c6c560dda73f74083f44f,2,13,12,25,5,2014-03-31 10:57:44,2014-03-25 19:51:15
8e73d3a2c17bd3233d5c6c560dda73f74083f44f...2f2d21fe5cc5d7a103d36c39704a0925a7be73bc,1,1,1,2,1,2014-03-31 11:01:27,2014-03-31 11:01:13
2f2d21fe5cc5d7a103d36c39704a0925a7be73bc...25da849896c86c382da6337e719ef57460a77c85,1,3,0,3,1,2014-03-31 11:12:12,2014-03-31 11:10:25
25da849896c86c382da6337e719ef57460a77c85...5268d71f18d12c362d74010210309c1cec8e8a1a,3,40,7,47,10,2014-03-31 11:20:20,2014-03-28 14:42:58
5268d71f18d12c362d74010210309c1cec8e8a1a...07c42cee7f400ca35106aa5562cdfa99cb1b8b62,4,4,15,19,8,2014-03-31 11:55:25,2014-03-31 11:54:22
07c42cee7f400ca35106aa5562cdfa99cb1b8b62...ef3734693277242e98996f591d9acf39e8819441,1,6,2,8,1,2014-03-31 12:12:16,2014-03-31 12:10:59
ef3734693277242e98996f591d9acf39e8819441...6405889a722580c01cf009159a2beb5b09e2fda0,1,119,22,141,19,2014-03-31 12:24:09,2014-03-31 09:54:17
6405889a722580c01cf009159a2beb5b09e2fda0...cfb7eca2a19119c4e54c3301918de360f8966984,1,4,0,4,1,2014-04-01 18:48:06,2014-04-01 18:48:06
cfb7eca2a19119c4e54c3301918de360f8966984...36d1e3725fd0b6a196ddb662fd1eb8bca638d38c,2,12,14,26,2,2014-04-02 17:01:03,2014-04-02 08:08:20
36d1e3725fd0b6a196ddb662fd1eb8bca638d38c...1a1b22679d8408f81d91dba2c92cb15f9ebf377e,1,11,0,11,1,2014-04-02 20:16:33,2014-04-02 20:11:49
1a1b22679d8408f81d91dba2c92cb15f9ebf377e...28a686a0b75e118a4a24462f3b3d31c8231f010a,2,8,4,12,2,2014-04-03 12:27:57,2014-04-02 06:14:47
28a686a0b75e118a4a24462f3b3d31c8231f010a...7b3a221ad674ce74afd5db2a7dd0a0a3beb354ed,2,18,4,22,6,2014-04-03 18:56:41,2014-03-31 20:16:34
7b3a221ad674ce74afd5db2a7dd0a0a3beb354ed...23984cf907168d2a26579e54bf53d5d222431f01,1,6,6,12,2,2014-04-03 19:28:10,2014-04-03 06:59:06
23984cf907168d2a26579e54bf53d5d222431f01...4ad4a236de1726eac6da1f865c9f2f80e080794f,1,2,0,2,1,2014-04-04 07:48:56,2014-04-04 04:05:30
4ad4a236de1726eac6da1f865c9f2f80e080794f...5891fd3f89337fc190cf671575407233440d2736,12,246,6,252,26,2014-04-05 17:01:03,2014-04-01 00:16:09
5891fd3f89337fc190cf671575407233440d2736...38679254bf2006c0b31bdb172802024836dac46c,3,17,6,23,6,2014-04-05 22:17:13,2014-04-05 22:14:53
38679254bf2006c0b31bdb172802024836dac46c...5e74d6cf0a4fa0caa51e77af77d55c2572f0917d,1,33,1,34,2,2014-04-07 12:59:27,2014-04-05 13:11:40
5e74d6cf0a4fa0caa51e77af77d55c2572f0917d...32c857908998503cd595311eebc9256d44f65803,1,1,1,2,1,2014-04-07 13:06:09,2014-04-07 13:04:49
32c857908998503cd595311eebc9256d44f65803...c148d8e7301856c5a2251dd4916df4a9f96e285e,1,1,1,2,1,2014-04-07 13:57:04,2014-04-07 13:18:08
c148d8e7301856c5a2251dd4916df4a9f96e285e...61b7fcf4783178e5212688d34449f8204e40082a,1,1,1,2,1,2014-04-08 11:34:37,2014-04-08 04:15:00
61b7fcf4783178e5212688d34449f8204e40082a...d9c7d9eb6ebbf92098787c127bb3e64f85978cca,4,313,313,626,25,2014-04-08 14:09:01,2014-03-26 13:30:47
d9c7d9eb6ebbf92098787c127bb3e64f85978cca...9063e6ed39c3dadbef8545b34ab62ce037c94d96,1,1,1,2,1,2014-04-08 14:12:15,2014-04-08 14:12:15
9063e6ed39c3dadbef8545b34ab62ce037c94d96...8158557f225f91041c529b92caf06e4f8045a716,1,2,2,4,1,2014-04-08 15:13:36,2014-04-08 15:13:05
8158557f225f91041c529b92caf06e4f8045a716...2cb70131790d5455b94d640e0f6838434b64e39b,3,94,6,100,3,2014-04-08 15:28:58,2014-03-19 18:38:12
2cb70131790d5455b94d640e0f6838434b64e39b...f22177a9a3bf9d47695b69b1de06445f93f9d809,1,2,9,11,4,2014-04-08 16:15:40,2014-04-08 15:21:20
f22177a9a3bf9d47695b69b1de06445f93f9d809...763b1d55e28dbfdab8971bf58bc723fa14f47c3f,1,1,1,2,1,2014-04-09 11:13:37,2014-04-09 03:58:40
763b1d55e28dbfdab8971bf58bc723fa14f47c3f...396d65b5807cc6e25e2559634bdc8d6cfc22a837,1,2,1,3,1,2014-04-09 11:39:08,2014-04-09 11:37:57
396d65b5807cc6e25e2559634bdc8d6cfc22a837...f6f188ffc7d48f7f38edea35234f23f2cfefda0b,5,40,4,44,7,2014-04-09 20:50:21,2014-04-09 20:41:33
f6f188ffc7d48f7f38edea35234f23f2cfefda0b...3a9a4570efc933a50efec27bdd06af11877eeac6,6,98,2,100,8,2014-04-09 22:44:30,2014-03-30 17:03:35
3a9a4570efc933a50efec27bdd06af11877eeac6...941f947bfd8d8f1a608634cf42f212b3a5a1933c,3,16,17,33,8,2014-04-10 00:43:05,2014-04-10 00:40:33
941f947bfd8d8f1a608634cf42f212b3a5a1933c...0b43308e2de5dcac67b530bb03376655dfb61cef,1,5,3,8,1,2014-04-10 10:19:02,2014-04-10 05:19:55
0b43308e2de5dcac67b530bb03376655dfb61cef...32e62374506827723423471a115e6b25313ed887,7,20,10,30,11,2014-04-10 12:54:32,2014-04-10 12:45:48
32e62374506827723423471a115e6b25313ed887...ddd25b280f69ffcb5eb7ab2695c6094256090947,4,25,2,27,6,2014-04-10 13:44:43,2014-04-10 13:43:55
ddd25b280f69ffcb5eb7ab2695c6094256090947...b4681be154dd7194041e94f3eb6d7f24217b9a1b,2,5,1,6,3,2014-04-10 17:16:04,2014-03-31 20:35:45
b4681be154dd7194041e94f3eb6d7f24217b9a1b...ae78227de3740cce7e2b460b2845f19443c4d090,1,3,1,4,1,2014-04-10 17:33:28,2014-04-10 17:31:59
ae78227de3740cce7e2b460b2845f19443c4d090...7e89434084d7952d107aef1c41f2019a73310634,2,53,2,55,4,2014-04-10 21:02:54,2014-03-23 19:45:22
7e89434084d7952d107aef1c41f2019a73310634...5f22bda3827f32289793b90a387d8c77d602a859,4,14,10,24,5,2014-04-10 21:06:58,2014-03-23 22:09:26
5f22bda3827f32289793b90a387d8c77d602a859...2e42c859da42a871244aca36162a0aad2b63c02b,4,37,30,67,12,2014-04-10 21:18:35,2014-03-23 20:45:31
2e42c859da42a871244aca36162a0aad2b63c02b...2ad0bc132a6f70a128d8e1fec689c6a474ddde89,2,13,10,23,4,2014-04-10 21:18:36,2014-03-23 22:34:14
2ad0bc132a6f70a128d8e1fec689c6a474ddde89...1bcc8eb0f64831b24c2769e033a10e530c8ed140,1,8,2,10,2,2014-04-10 21:18:36,2014-04-10 19:14:50
1bcc8eb0f64831b24c2769e033a10e530c8ed140...593e72c141f52b9f581b65314f421d70c6abde02,1,1,1,2,1,2014-04-10 23:33:39,2014-04-10 23:32:20
593e72c141f52b9f581b65314f421d70c6abde02...3f48ca207130db502c8a9f8b7e6efa04453c4504,1,4,4,8,2,2014-04-11 21:03:25,2014-04-11 21:01:00
3f48ca207130db502c8a9f8b7e6efa04453c4504...d9f8cc12aeeb5309139a79d9b613fa405ebed36e,5,83,9,92,12,2014-04-12 09:43:10,2014-04-12 09:42:06
d9f8cc12aeeb5309139a79d9b613fa405ebed36e...a6eda3a5fc524333b476deed5057ee9803d91108,3,13,2,15,6,2014-04-12 13:35:11,2014-04-12 13:31:37
a6eda3a5fc524333b476deed5057ee9803d91108...6b3a8d27052bb5b242ab6c1c2fb0d6da5b49681d,4,26,1,27,6,2014-04-12 17:51:38,2014-04-12 01:27:34
6b3a8d27052bb5b242ab6c1c2fb0d6da5b49681d...9fb61cb64a18924b7f252677166533f747884b48,13,76,12,88,27,2014-04-13 23:03:20,2014-03-31 19:25:08
9fb61cb64a18924b7f252677166533f747884b48...f004374f8ff0ad30a694a0f4b74ba24ca9cf3227,1,1,1,2,1,2014-04-13 23:14:16,2014-04-13 22:52:43
f004374f8ff0ad30a694a0f4b74ba24ca9cf3227...a195ec847e44e8ec6f688dfed55b37eb8ec144cf,4,183,1,184,13,2014-04-14 22:09:48,2014-04-14 17:07:02
a195ec847e44e8ec6f688dfed55b37eb8ec144cf...76ed0a615cd0ef6cb411257a9d447656d1887f16,1,4,6,10,6,2014-04-15 21:45:39,2014-04-15 21:43:29
76ed0a615cd0ef6cb411257a9d447656d1887f16...5672b29d57bcd7041268727c0a288b33eb708af4,1,3,0,3,1,2014-04-15 21:48:45,2014-04-15 20:15:32
5672b29d57bcd7041268727c0a288b33eb708af4...cb7ee25462f1f6862c19ea88c29df9b0f97bba37,2,8,5,13,4,2014-04-16 11:23:00,2014-04-16 11:22:15
cb7ee25462f1f6862c19ea88c29df9b0f97bba37...62ac77fa23e9610628f1b1d395273248790145ff,1,10,0,10,1,2014-04-16 11:49:33,2014-04-16 11:47:56
62ac77fa23e9610628f1b1d395273248790145ff...8edba6eb9009cfd54c8c4e9e6a982ba8f83e3a93,2,2,2,4,2,2014-04-16 12:37:24,2014-04-16 12:35:17
8edba6eb9009cfd54c8c4e9e6a982ba8f83e3a93...c064971e6bd1906c3665b25e0d659c0e47bb4a00,4,5,3,8,5,2014-04-16 13:39:25,2014-04-16 13:39:00
c064971e6bd1906c3665b25e0d659c0e47bb4a00...fcbcdf72d60ccfd808187c3322457decc927712c,1,1,1,2,1,2014-04-16 13:42:48,2014-04-16 13:19:55
fcbcdf72d60ccfd808187c3322457decc927712c...71c8ae543ffec847ec275859bc406202f5029604,2,26,2,28,2,2014-04-16 20:37:08,2014-04-16 14:55:34
71c8ae543ffec847ec275859bc406202f5029604...841e21a85c17c87f8b7b41b5cbb5eae15888f9b7,1,5,0,5,2,2014-04-16 21:38:22,2014-04-16 19:03:25
841e21a85c17c87f8b7b41b5cbb5eae15888f9b7...7f8bd1a4b39ed834dffa0adc8fa19ef6b807f45d,2,43,42,85,11,2014-04-16 22:02:25,2014-04-14 20:11:52
7f8bd1a4b39ed834dffa0adc8fa19ef6b807f45d...8c1d8a6215b123f2d0981f926db1f0405392ae5f,1,28,10,38,4,2014-04-17 00:31:01,2014-04-14 17:09:17
8c1d8a6215b123f2d0981f926db1f0405392ae5f...f039c555cad59ef21b2ce3fcfda0579d82fd45a6,3,6,8,14,6,2014-04-17 19:21:27,2014-04-17 19:10:41
f039c555cad59ef21b2ce3fcfda0579d82fd45a6...edaff9b0dffc9ad984671673214d671d84abe144,1,4,2,6,4,2014-04-17 19:26:49,2014-04-17 19:23:14
edaff9b0dffc9ad984671673214d671d84abe144...548acd77fd6356073ad4fa514c3d61f6589da43b,2,17,1,18,2,2014-04-18 00:07:05,2014-04-10 12:03:50
548acd77fd6356073ad4fa514c3d61f6589da43b...22cbaea9c7f3eeeda4a8570278910f879449ddb9,3,20,7,27,5,2014-04-18 00:37:25,2014-04-18 00:21:22
22cbaea9c7f3eeeda4a8570278910f879449ddb9...4df5dc42dd29ce2bba1ac3b7c6b45aac5b14fad1,1,1,1,2,1,2014-04-18 00:42:04,2014-04-17 14:16:36
4df5dc42dd29ce2bba1ac3b7c6b45aac5b14fad1...24016c9b6202c1089444e7b572a9ad442ca786ee,1,1,1,2,1,2014-04-18 06:32:24,2014-04-18 06:28:24
24016c9b6202c1089444e7b572a9ad442ca786ee...bdfa3fd9b3b93ad94e8de7fe3b4c38d395368812,1,1,0,1,1,2014-04-18 11:18:51,2014-04-18 06:00:41
bdfa3fd9b3b93ad94e8de7fe3b4c38d395368812...1dc4a8daecb31a04d702b7dbc238e0afa92b8aa3,1,1,1,2,1,2014-04-18 13:09:58,2014-04-18 13:09:58
1dc4a8daecb31a04d702b7dbc238e0afa92b8aa3...3a4a5a5c99909c1a9f496a3f6f299b6d535e4b50,1,10,0,10,1,2014-04-18 14:32:49,2014-04-18 14:32:14
3a4a5a5c99909c1a9f496a3f6f299b6d535e4b50...8d7023dc714acc957fac7ef422ccee4d83429b09,1,2,1,3,1,2014-04-18 15:56:14,2014-04-18 15:51:13
8d7023dc714acc957fac7ef422ccee4d83429b09...13340df76984d019ff9d4612ed6f38507546aade,1,7,7,14,4,2014-04-18 17:24:39,2014-04-18 16:40:58
13340df76984d019ff9d4612ed6f38507546aade...a9ad0818996f2c307f505dca68008841be06e0fc,1,3,0,3,1,2014-04-18 19:03:27,2014-04-18 19:00:26
a9ad0818996f2c307f505dca68008841be06e0fc...1816baf4f7de0a1557108e1d26f754eca3e543c0,1,1,1,2,1,2014-04-18 19:03:57,2014-04-18 16:10:46
1816baf4f7de0a1557108e1d26f754eca3e543c0...b1e7dd445bb64c27df8e2b6902a76a67c79332ab,1,9,0,9,1,2014-04-18 19:11:10,2014-04-18 16:41:29
b1e7dd445bb64c27df8e2b6902a76a67c79332ab...b06e45bbf6988f9f8671bbc5b5b63d419d50edda,2,41,49,90,7,2014-04-18 20:11:04,2014-04-18 20:06:26
b06e45bbf6988f9f8671bbc5b5b63d419d50edda...bc5d568e1e5c8f109bc83c1cdd943de60b66f763,7,169,27,196,21,2014-04-18 22:34:00,2014-04-08 05:30:25
bc5d568e1e5c8f109bc83c1cdd943de60b66f763...0086c9eb48101b6dabefa7f9195ac7d197780f09,2,9,0,9,2,2014-04-20 01:41:28,2014-04-20 01:39:08
0086c9eb48101b6dabefa7f9195ac7d197780f09...9e86c3f0a62a33a541b0ccf7d86a3db87e8e8705,3,6,2,8,6,2014-04-20 17:09:12,2014-04-20 17:08:04
9e86c3f0a62a33a541b0ccf7d86a3db87e8e8705...33d1dc2eeb5db83f07b6b7fbf3b10ef01b74702b,4,3,5,8,5,2014-04-20 17:10:52,2014-04-16 20:49:37
33d1dc2eeb5db83f07b6b7fbf3b10ef01b74702b...ab0afef9590730064d40ca074c3b2be3baebf9cb,4,43,45,88,8,2014-04-21 09:43:38,2014-04-21 09:41:30
ab0afef9590730064d40ca074c3b2be3baebf9cb...0dad0ca55ec6081d3e92ac8340ed9f8d5c65a606,5,27,68,95,6,2014-04-21 09:51:21,2014-04-21 09:50:53
0dad0ca55ec6081d3e92ac8340ed9f8d5c65a606...50dddbdfc7489847d55465ad352fc3278b2a9a08,37,54,52,106,52,2014-04-21 11:50:43,2014-03-30 19:11:05
50dddbdfc7489847d55465ad352fc3278b2a9a08...62eb79fc4cc956b798e5c3a3be96101037ae9cb0,13,26,28,54,15,2014-04-21 11:50:50,2014-04-21 10:25:43
62eb79fc4cc956b798e5c3a3be96101037ae9cb0...d7de6ed07eda3968d50e9045ff585763845bb290,1,4,2,6,3,2014-04-21 12:58:41,2014-04-21 12:51:52
d7de6ed07eda3968d50e9045ff585763845bb290...0bd913a19cf0e7515834d6cb6d9e668840fecce5,1,1,1,2,1,2014-04-21 17:20:46,2014-04-21 14:48:33
0bd913a19cf0e7515834d6cb6d9e668840fecce5...546740544d7f69254a67b06a3fc7fa0c43512958,5,49,1,50,12,2014-04-21 22:29:12,2014-04-20 17:29:12
546740544d7f69254a67b06a3fc7fa0c43512958...380545bf85cbf17fc698d136815b7691f8d023ca,2,36,1,37,7,2014-04-21 22:29:24,2014-04-20 20:24:53
380545bf85cbf17fc698d136815b7691f8d023ca...34526c2f56b863c2103655a0893ac801667e86ea,6,95,2,97,17,2014-04-21 22:29:39,2014-04-20 20:25:39
34526c2f56b863c2103655a0893ac801667e86ea...5577fd673e071fbfb0d140ea66b31983956ab174,3,316,9,325,7,2014-04-21 22:29:42,2014-04-21 10:39:52
5577fd673e071fbfb0d140ea66b31983956ab174...df81625da64473c43c7d0a948704d9efca84edbf,2,52,1,53,2,2014-04-21 23:21:55,2014-04-21 23:21:55
df81625da64473c43c7d0a948704d9efca84edbf...97b5833e212d3e6520dfa43525aa75f625a760a0,2,25,0,25,2,2014-04-22 08:47:26,2014-04-15 15:52:30
97b5833e212d3e6520dfa43525aa75f625a760a0...55da4e818d835205f42280ca06ef2a9a6d75fe08,2,15,0,15,2,2014-04-22 15:47:52,2014-04-22 15:44:03
55da4e818d835205f42280ca06ef2a9a6d75fe08...935159d9517ca951cbd5665c521d3c91102948d8,3,27,2,29,4,2014-04-22 16:48:39,2014-04-21 19:46:09
935159d9517ca951cbd5665c521d3c91102948d8...5c19c698b1d84eeaa47d56460d60478b50df6b8c,2,94,22,116,12,2014-04-22 17:52:58,2014-04-21 09:25:48
5c19c698b1d84eeaa47d56460d60478b50df6b8c...417e9f383f53b331576c26b29b9ab92ccb2e6df9,2,56,8,64,6,2014-04-22 17:52:58,2014-04-21 12:04:53
417e9f383f53b331576c26b29b9ab92ccb2e6df9...1d0f1ee1993fe9fb95888158946f897a34e95a39,2,17,14,31,6,2014-04-22 17:52:58,2014-04-21 21:08:00
1d0f1ee1993fe9fb95888158946f897a34e95a39...4499c676eff03d6c8a30d256c677b9958b8d0705,1,2,2,4,2,2014-04-22 22:29:03,2014-04-22 20:54:14
4499c676eff03d6c8a30d256c677b9958b8d0705...ba1728dd9b19088c0c37253a938a6d97c61d5ed6,18,18,19,37,19,2014-04-23 00:10:58,2014-04-22 23:05:14
ba1728dd9b19088c0c37253a938a6d97c61d5ed6...423e2cf1eafcac42bfa84de6043a35ad445e296d,2,11,11,22,7,2014-04-23 11:47:49,2014-04-22 20:49:52
423e2cf1eafcac42bfa84de6043a35ad445e296d...c3228ef3e213c6149f21ac51648823017c1d9b9f,2,102,0,102,3,2014-04-23 11:48:36,2014-04-22 21:15:18
c3228ef3e213c6149f21ac51648823017c1d9b9f...e192f131033d68e1b018263aee6fe8804a923b22,7,53,1,54,11,2014-04-23 12:49:53,2014-04-23 12:49:12
e192f131033d68e1b018263aee6fe8804a923b22...07235aec9d0853b4fa58629c572912786b6270c9,2,5,2,7,2,2014-04-23 12:56:54,2014-04-23 11:06:23
07235aec9d0853b4fa58629c572912786b6270c9...0424c84d541d7b0e23783c33c2db495543e3bd47,1,3,1,4,3,2014-04-23 13:16:38,2014-04-23 13:13:15
0424c84d541d7b0e23783c33c2db495543e3bd47...9bf890f6f9d137d5b86fd9a6a38fb11c5d21b1af,1,4,2,6,2,2014-04-23 19:45:38,2014-04-23 19:34:57
9bf890f6f9d137d5b86fd9a6a38fb11c5d21b1af...e32e359d6ab4e91bbf8fd67d96a687d0006d38b9,1,3,2,5,2,2014-04-23 19:45:49,2014-04-23 19:38:09
e32e359d6ab4e91bbf8fd67d96a687d0006d38b9...5cd64296205e1b5cc4fc1f7e02e22d62795bb604,1,6,2,8,1,2014-04-24 06:43:16,2014-04-24 06:41:37
5cd64296205e1b5cc4fc1f7e02e22d62795bb604...9bbb43dd1ad0d570d059f18a20db2605c76c8a1e,1,2,0,2,1,2014-04-24 06:43:24,2014-04-24 06:42:30
9bbb43dd1ad0d570d059f18a20db2605c76c8a1e...1a3cde5f9fc11ac34251bc44e9f1a82c4ffb4dc8,3,18,18,36,18,2014-04-24 09:51:53,2014-04-24 09:36:25
1a3cde5f9fc11ac34251bc44e9f1a82c4ffb4dc8...bee118a7011bda1b26e885c7258a8d5e04436863,1,2,2,4,2,2014-04-24 11:06:57,2014-04-24 11:06:02
bee118a7011bda1b26e885c7258a8d5e04436863...7421e1e320fc46a52af0a1e4518b0ce4344c1a0f,1,7,0,7,1,2014-04-24 22:35:38,2014-04-24 21:36:40
7421e1e320fc46a52af0a1e4518b0ce4344c1a0f...b8b179bbf50f8ec3e2102f7109c594cb1ba85e93,1,2,2,4,2,2014-04-24 22:35:59,2014-04-24 22:30:43
b8b179bbf50f8ec3e2102f7109c594cb1ba85e93...782fa14db4b855b4c5034413d1065ea0915f6491,1,2,0,2,2,2014-04-25 09:45:58,2014-04-25 09:43:20
782fa14db4b855b4c5034413d1065ea0915f6491...6d87acc390d96b78423031a4c1c16f15ce202b85,3,18,2,20,3,2014-04-25 12:36:20,2014-04-25 12:20:25
6d87acc390d96b78423031a4c1c16f15ce202b85...658710be005da9d7a4bd09bc02ecd84f65681ea6,1,4,0,4,1,2014-04-25 13:36:18,2014-04-25 12:55:32
658710be005da9d7a4bd09bc02ecd84f65681ea6...ae1535606145df9c858d4c5a5a2d9a9cff9f3992,3,17,1,18,4,2014-04-25 13:56:04,2014-04-24 18:10:03
ae1535606145df9c858d4c5a5a2d9a9cff9f3992...bde1bc66724db34dcde598f064448da1f2a8a810,2,44,35,79,2,2014-04-25 14:12:55,2014-04-13 15:18:02
bde1bc66724db34dcde598f064448da1f2a8a810...c050ce7de2091f580bf85ab367d9c7f5cb26f44c,1,5,5,10,1,2014-04-25 14:29:18,2014-04-25 14:27:13
c050ce7de2091f580bf85ab367d9c7f5cb26f44c...788fce4c917eee27b10f38f7eb0b75cd2af3ec43,2,6,6,12,4,2014-04-25 15:40:33,2014-04-25 15:39:49
788fce4c917eee27b10f38f7eb0b75cd2af3ec43...6b38e48ba11ec3d5aa433948d1354a8627c1edba,1,6,0,6,3,2014-04-25 20:52:51,2014-04-11 20:55:07
6b38e48ba11ec3d5aa433948d1354a8627c1edba...abd68b5affaec35e941b49f1b0a4cb8d70c22d7b,1,5,4,9,3,2014-04-25 21:16:24,2014-04-25 21:13:58
abd68b5affaec35e941b49f1b0a4cb8d70c22d7b...e441cebce340f54741be957817cc034000deab3c,22,68,71,139,45,2014-04-26 14:03:40,2014-04-26 14:00:15
e441cebce340f54741be957817cc034000deab3c...22d99200a16c06ba5fa2ee9fc35c941143e9b0fb,1,13,14,27,7,2014-04-26 14:10:00,2014-04-26 14:09:19
22d99200a16c06ba5fa2ee9fc35c941143e9b0fb...3bb0f118ca375f25cd0c03a5733ee2ef9d79dfa5,11,77,38,115,28,2014-04-26 15:46:57,2014-04-26 08:22:48
3bb0f118ca375f25cd0c03a5733ee2ef9d79dfa5...996564df4d70947913c70b071cf4a6841c658be2,53,79,80,159,71,2014-04-26 18:35:57,2014-04-26 17:18:45
996564df4d70947913c70b071cf4a6841c658be2...a5cc99de24be3e5ea4dfa287af678b86598b7915,2,66,5,71,6,2014-04-26 20:11:04,2014-04-26 16:32:17
a5cc99de24be3e5ea4dfa287af678b86598b7915...529ae6087c8e68587689de646960235e95c26cf0,1,5,0,5,1,2014-04-27 18:20:51,2014-04-27 18:17:37
529ae6087c8e68587689de646960235e95c26cf0...b89bbb3c21c71a846674a7cad253699ed17ac3fa,4,128,166,294,96,2014-04-27 19:06:08,2014-04-27 19:05:25
b89bbb3c21c71a846674a7cad253699ed17ac3fa...23f3c53aff54b7f298f29e97042d00dbd9379d00,1,5,0,5,1,2014-04-27 19:21:07,2014-04-27 19:19:54
23f3c53aff54b7f298f29e97042d00dbd9379d00...63ae243a13759f2a87184784fa268d6d003c694a,2,19,13,32,10,2014-04-28 12:20:26,2014-04-28 12:18:43
63ae243a13759f2a87184784fa268d6d003c694a...c73d8c41e41b7407e6a2f4f55337fc3778dc839f,1,1,1,2,1,2014-04-28 15:21:57,2014-04-28 14:05:28
c73d8c41e41b7407e6a2f4f55337fc3778dc839f...305ab00087a29ff400e815187b5568f84d2d8739,1,5,0,5,1,2014-04-28 16:43:50,2014-04-28 16:43:33
305ab00087a29ff400e815187b5568f84d2d8739...edca57817fa5c366483194020967cd9d4ef1318c,1,1,1,2,1,2014-04-28 20:46:13,2014-04-28 20:46:13
edca57817fa5c366483194020967cd9d4ef1318c...1d20693fa67f314de08e51af57af6fb5460b7b0c,4,4,67,71,12,2014-04-28 22:49:24,2014-04-28 22:41:16
1d20693fa67f314de08e51af57af6fb5460b7b0c...a72069f5d288fa9dc902e986af9d94a4af99136f,3,3,3,6,3,2014-04-28 23:07:03,2014-04-28 23:06:25
a72069f5d288fa9dc902e986af9d94a4af99136f...997648d80b8ac5eba8cbbc2ec3951b109b248bac,2,13,0,13,2,2014-04-29 00:38:29,2014-04-29 00:38:06
997648d80b8ac5eba8cbbc2ec3951b109b248bac...95c5e244fef906c688642f555292635e1b10a8c3,1,3,1,4,1,2014-04-29 06:34:00,2014-04-29 06:32:10
95c5e244fef906c688642f555292635e1b10a8c3...62bbfba3aa96011a374f935d2c2176e5c2c90b85,1,1,1,2,1,2014-04-29 10:52:43,2014-04-29 10:46:54
62bbfba3aa96011a374f935d2c2176e5c2c90b85...f02f20a7395fe6681cfcae1c52d4bab68f6aa0d5,2,16,12,28,3,2014-04-29 14:55:36,2014-04-29 04:44:04
f02f20a7395fe6681cfcae1c52d4bab68f6aa0d5...cda5745df0e9301c65e13f552ee19a4bf0490997,2,17,0,17,4,2014-04-29 14:55:45,2014-04-15 22:54:30
cda5745df0e9301c65e13f552ee19a4bf0490997...72493b1b7c43ffdcb3f2ce2d0f055ebb49485f4b,3,3,0,3,3,2014-04-30 11:20:44,2014-04-25 16:27:48
72493b1b7c43ffdcb3f2ce2d0f055ebb49485f4b...a2cac1b68d601d4dafc4713c85849edda7b37bcd,1,0,1,1,1,2014-04-30 11:27:56,2014-04-30 11:23:39
a2cac1b68d601d4dafc4713c85849edda7b37bcd...6d4df45e2927c45344b9f014f739466d61f808c8,2,64,0,64,3,2014-04-30 11:38:31,2014-04-28 13:28:03
6d4df45e2927c45344b9f014f739466d61f808c8...bb5c7e4e8d783bf3a2880ab5cf1fa57fd35cd198,4,30,5,35,7,2014-04-30 11:57:35,2014-04-12 03:58:56
bb5c7e4e8d783bf3a2880ab5cf1fa57fd35cd198...1084456ac2e707fc562906e95ad78f409dcc9325,2,21,7,28,11,2014-04-30 14:55:12,2014-04-30 14:53:20
1084456ac2e707fc562906e95ad78f409dcc9325...a6ecd5dbb34249f756a337c359eef1e8d78dc01e,5,113,50,163,25,2014-04-30 18:26:39,2014-04-26 07:34:20
a6ecd5dbb34249f756a337c359eef1e8d78dc01e...35c2a14a49ac3cb25dcff818b280bf0b4c290287,9,93,55,148,31,2014-04-30 19:26:11,2014-04-30 19:25:12
35c2a14a49ac3cb25dcff818b280bf0b4c290287...c0d5521e69397a0f1d089d662d3b00dc5bdafa66,1,2,1,3,1,2014-04-30 22:02:00,2014-04-30 17:43:36
c0d5521e69397a0f1d089d662d3b00dc5bdafa66...6ca53678699a4eececa3b178f0f7e051956bf580,2,5,3,8,2,2014-04-30 22:12:18,2014-04-30 22:11:29
6ca53678699a4eececa3b178f0f7e051956bf580...3cd1db9121e14f6d227c69779cf04c830241189e,1,16,8,24,4,2014-04-30 22:25:32,2014-04-30 22:22:43
3cd1db9121e14f6d227c69779cf04c830241189e...e5941ba5f3f8787b649d2c5c3492bcbdc121b435,2,1,3,4,2,2014-04-30 22:35:40,2014-04-30 22:33:46
e5941ba5f3f8787b649d2c5c3492bcbdc121b435...d56267ba57f28395946fadd6401ad7e1606c3cb0,3,11,2,13,4,2014-05-01 13:30:49,2014-05-01 09:55:52
d56267ba57f28395946fadd6401ad7e1606c3cb0...d5a9d74eec66ce7e21eae2d9a5065fdd637333c5,1,2,1,3,1,2014-05-01 16:17:55,2014-05-01 16:10:16
d5a9d74eec66ce7e21eae2d9a5065fdd637333c5...5ab93bbe747f5af185631a4ea591a501e3f8a06c,2,44,5,49,8,2014-05-02 03:12:42,2014-05-02 02:50:56
5ab93bbe747f5af185631a4ea591a501e3f8a06c...35b7dd4ddbedb6cfdef8a0a758de5e941a8fd36c,1,1,1,2,1,2014-05-02 06:29:20,2014-05-01 17:28:07
35b7dd4ddbedb6cfdef8a0a758de5e941a8fd36c...61fd00d4fd65f44d0a05be4c7e95124e4102ec27,3,21,5,26,5,2014-05-02 17:33:58,2014-05-02 17:31:22
61fd00d4fd65f44d0a05be4c7e95124e4102ec27...f8fa735dc2a0d06e904b458633d0143820a59ac0,2,28,1,29,4,2014-05-03 00:53:39,2014-05-01 12:39:58
7d44b5d5d00a7850c3cd7a8abbf7a91e7c0d7994...b9c7234e2a88a62201eaf865c5c57d5d66e7c64b,1,2,2,4,2,2013-12-12 15:08:59,2013-12-12 14:57:39
b9c7234e2a88a62201eaf865c5c57d5d66e7c64b...2c837233f5de7d5e309833e39782c7a208a03880,2,10,2,12,3,2013-12-12 15:09:12,2013-12-12 14:58:14
2c837233f5de7d5e309833e39782c7a208a03880...e01ade61fe3e9340dc98cffe773dd8152389a8ce,1,19,9,28,8,2013-12-12 20:08:22,2013-12-12 20:08:22
e01ade61fe3e9340dc98cffe773dd8152389a8ce...d4d0dd74164705c535cb24035289003e37def172,1,1,1,2,1,2013-12-13 10:42:14,2013-12-13 10:42:14
7d44b5d5d00a7850c3cd7a8abbf7a91e7c0d7994...cddb1e95b93bc3ec0990bd28fa600850d05df32a,1,3,3,6,2,2013-12-12 14:48:54,2013-12-12 14:48:54
3273bd7b254680a5b241e2fdbc3196956b2b44e8...bb2ca9fe6cdd490526b44b30f207c8f743bfaa84,10,67,19,86,24,2014-03-01 20:44:42,2014-03-01 19:06:15
bb2ca9fe6cdd490526b44b30f207c8f743bfaa84...f732d55dfcd06faf16a5d45798ae2f53d7784d66,1,1,0,1,1,2014-03-01 20:46:23,2014-03-01 20:46:23
416a8580232075d569cf3c386a97067884c67a60...f34e8fc890d44f4f913fe812f2cdeb5666f0fa27,4,26,4,30,10,2014-03-25 08:17:03,2014-03-23 05:10:12
416a8580232075d569cf3c386a97067884c67a60...eed7e1d4f6c048e37cf817561c4892374a13ff6b,1,2,1,3,1,2014-03-24 13:08:47,2014-03-24 13:06:57
eed7e1d4f6c048e37cf817561c4892374a13ff6b...60d2dde2867dc91a5b93bf1d03799c6d043da8fb,1,10,10,20,7,2014-03-24 13:19:27,2014-03-24 13:15:32
60d2dde2867dc91a5b93bf1d03799c6d043da8fb...ec08d62a20f55cfdfb9fbd21d8bc5627c54337c7,2,20,4,24,2,2014-03-24 13:41:04,2014-02-22 19:29:55
ec08d62a20f55cfdfb9fbd21d8bc5627c54337c7...51c8045145b29fed604f716d4d17958aa803b5ea,54,70,550,620,153,2014-03-24 15:42:56,2014-03-24 15:42:56
51c8045145b29fed604f716d4d17958aa803b5ea...d81a9c50d84d515ddc8ee76ecc5ad5d86e210504,1,1,1,2,1,2014-03-24 17:06:06,2014-03-24 16:58:05
d81a9c50d84d515ddc8ee76ecc5ad5d86e210504...1edfa155e34dde549ef0e93414f2846dce59e5f7,3,14,1,15,3,2014-03-24 17:24:52,2014-03-20 04:08:28
f8fa735dc2a0d06e904b458633d0143820a59ac0...724a7bf222e31f42e2ab431cc09da224081d03fa,2,38,1,39,2,2014-05-07 18:28:42,2014-05-06 20:57:37
f8fa735dc2a0d06e904b458633d0143820a59ac0...87d873ab476e2d213caa4cbdf11fddacb5755890,1,1,1,2,1,2014-05-03 23:18:56,2014-05-03 23:18:13
87d873ab476e2d213caa4cbdf11fddacb5755890...402fc4f6c9921f56eecbb6e3fc69154270be6468,4,50,10,60,14,2014-05-05 10:06:51,2014-04-28 12:27:36
402fc4f6c9921f56eecbb6e3fc69154270be6468...6a6f294f518a96334c73b2e5f934cdd2f0feda7e,1,1,1,2,1,2014-05-05 10:42:21,2014-05-05 10:41:01
6a6f294f518a96334c73b2e5f934cdd2f0feda7e...4b6ba2c1d1dcf6d7d587ee19b3565879ab8ee219,3,47,2,49,6,2014-05-05 11:40:06,2014-04-22 20:01:16
4b6ba2c1d1dcf6d7d587ee19b3565879ab8ee219...2a2d7db01f0032c9dbf446757c121fa2a5904a45,2,9,1,10,4,2014-05-05 11:39:03,2014-05-05 11:36:53
2a2d7db01f0032c9dbf446757c121fa2a5904a45...76979a257d289b99998c463023308c888662d874,2,14,0,14,2,2014-05-05 12:29:24,2014-05-05 12:22:01
76979a257d289b99998c463023308c888662d874...2dd52d043344c9e9acf65149d8c72b32b40f4643,1,66,66,132,2,2014-05-05 17:42:36,2014-05-05 14:54:54
2dd52d043344c9e9acf65149d8c72b32b40f4643...549b65824184711823e6a8c38ccf7365f10023d8,2,5,4,9,3,2014-05-06 00:02:14,2014-05-03 17:02:07
549b65824184711823e6a8c38ccf7365f10023d8...e8f1395f4e65f9d2ffc7a0448980ebaca0b2991a,14,33,3,36,17,2014-05-06 07:14:03,2014-05-05 17:50:51
e8f1395f4e65f9d2ffc7a0448980ebaca0b2991a...0d138b9cf450b213b950595527b63d253926609d,4,11,5,16,9,2014-05-06 07:14:32,2014-05-05 18:39:26
0d138b9cf450b213b950595527b63d253926609d...79e4a189f3b17b5a7426f889c4412126eb169256,1,8,3,11,2,2014-05-06 18:39:13,2014-05-06 18:37:48
79e4a189f3b17b5a7426f889c4412126eb169256...a75318e813c50e16550eb889fa0c375fa19b88b9,1,1,0,1,1,2014-05-06 23:50:32,2014-05-06 23:47:22
a75318e813c50e16550eb889fa0c375fa19b88b9...f53d1576caab1594b29f6215604ef23ab6e5745e,3,21,0,21,5,2014-05-07 05:24:39,2014-05-07 05:23:23
f53d1576caab1594b29f6215604ef23ab6e5745e...2afb6e0526eeffde141d7f2b81dc54df7f45f1ba,2,8,6,14,2,2014-05-07 05:42:53,2014-05-07 05:41:59
2afb6e0526eeffde141d7f2b81dc54df7f45f1ba...1ed876ee5bd71092faf07559a25091bc27f96489,3,44,0,44,4,2014-05-07 06:07:10,2014-05-07 06:06:41
1ed876ee5bd71092faf07559a25091bc27f96489...10327be1f3f9fed5dc40f6fe42e5494afcf7aa76,1,0,12,12,2,2014-05-07 12:16:01,2014-05-07 12:16:01
10327be1f3f9fed5dc40f6fe42e5494afcf7aa76...ab2865a48eb7163cd135e34fbfa35e62136ff1d8,1,13,13,26,13,2014-05-07 12:19:17,2014-05-07 12:19:17
ab2865a48eb7163cd135e34fbfa35e62136ff1d8...af06203cead2968f4d58a718100dedc0faa7c619,3,11,6,17,4,2014-05-07 13:04:21,2014-05-07 13:01:37
af06203cead2968f4d58a718100dedc0faa7c619...f67433e74b06bbeb9b6bba0a9db5fb33512bdb43,1,14,3,17,3,2014-05-07 20:05:32,2014-05-07 20:04:29
f67433e74b06bbeb9b6bba0a9db5fb33512bdb43...d8bf415ab29ef3ef843286e69c646ebcce58c172,3,42,2,44,6,2014-05-07 20:47:02,2014-05-07 20:46:23
d8bf415ab29ef3ef843286e69c646ebcce58c172...7f63ac5a9f0ed76d2e372a8c0fda95cce67e7170,5,65,4,69,8,2014-05-07 21:29:04,2014-05-07 21:28:34
7f63ac5a9f0ed76d2e372a8c0fda95cce67e7170...bc82c0dbac33ced1a4d6953e8626236ae05af956,1,2,2,4,2,2014-05-08 02:32:36,2014-05-08 02:12:58
bc82c0dbac33ced1a4d6953e8626236ae05af956...f2bf59a5bc373eeb60136f3b3764e156efbc1ea8,4,49,3,52,7,2014-05-08 17:34:45,2014-05-08 17:33:59
f2bf59a5bc373eeb60136f3b3764e156efbc1ea8...189bcb9b094ab4c9f328488e9ae6f9e85ba0b229,1,2,3,5,2,2014-05-08 17:40:48,2014-05-08 17:39:09
189bcb9b094ab4c9f328488e9ae6f9e85ba0b229...e244e456c7e5b9ba87c32fcf2c7363170982ab9c,4,10,6,16,10,2014-05-08 20:45:26,2014-05-08 19:49:54
e244e456c7e5b9ba87c32fcf2c7363170982ab9c...51fed81e339183a32b753733e511c57efe7ca40c,1,146,185,331,19,2014-05-08 20:52:34,2014-05-07 19:40:02
51fed81e339183a32b753733e511c57efe7ca40c...7f48d44c606e59f239f825cc221f6d92bd2ce9af,1,2,5,7,5,2014-05-08 20:52:53,2014-05-07 19:49:45
7f48d44c606e59f239f825cc221f6d92bd2ce9af...e3bc11cca9425367efb4ce1eb923785895a83c1b,7,17,16,33,15,2014-05-08 20:53:00,2014-05-07 19:50:09
e3bc11cca9425367efb4ce1eb923785895a83c1b...92a1e71100427e0d6e16b9c2bb355ea0a48eb71d,6,12,6,18,7,2014-05-08 20:53:11,2014-05-07 20:03:10
92a1e71100427e0d6e16b9c2bb355ea0a48eb71d...7194d40236fc9f848f6efd313c1636ba1aceb700,7,88,44,132,34,2014-05-08 20:53:21,2014-05-07 20:14:39
99b7d74914d0675370d4b9ca62e57ee087578472...ccd80dc3b6ed3abc0e51d43af81043f3e0e11109,2,13,0,13,2,2013-12-13 23:42:24,2013-12-13 23:42:24
ccd80dc3b6ed3abc0e51d43af81043f3e0e11109...f685f94c9867461a7838a56b2c2adbec984eee7e,1,5,0,5,1,2013-12-13 23:56:18,2013-12-10 23:24:31
f685f94c9867461a7838a56b2c2adbec984eee7e...2ddf1fc50f8fbb26ce5c6b9115111564bf21248c,2,39,9,48,5,2013-12-14 12:53:37,2013-12-13 14:05:45
2ddf1fc50f8fbb26ce5c6b9115111564bf21248c...07fe0bf3f4a49a734f83f5ea30130449dacf9660,1,4,6,10,5,2013-12-14 12:57:58,2013-12-13 14:36:51
07fe0bf3f4a49a734f83f5ea30130449dacf9660...e1cfc4b96a955d3d1ee4d544942853cf924200ec,1,1,1,2,1,2013-12-14 15:41:26,2013-12-13 15:58:49
e1cfc4b96a955d3d1ee4d544942853cf924200ec...bed52afee7a336b833c015bb8878f504cef46bd1,1,15,12,27,6,2013-12-14 15:49:25,2013-12-14 15:42:50
bed52afee7a336b833c015bb8878f504cef46bd1...d599b590ebe6e2d3a60cf033de4d81c6b963bb04,1,13,11,24,5,2013-12-14 16:20:38,2013-12-13 21:19:48
d599b590ebe6e2d3a60cf033de4d81c6b963bb04...668571386926ff5453d0e11f59b0a89c0dc1dfa2,55,362,338,700,182,2013-12-14 16:59:15,2013-12-12 20:23:24
668571386926ff5453d0e11f59b0a89c0dc1dfa2...75ec1fdf16ac76b5c945aef1cdb9a1e104369c85,1,6,6,12,2,2013-12-14 17:34:45,2013-12-12 19:26:57
75ec1fdf16ac76b5c945aef1cdb9a1e104369c85...8f994f1bccfe4309d63433d78978109a32f0826b,1,36,10,46,13,2013-12-14 18:02:56,2013-12-07 19:03:11
8f994f1bccfe4309d63433d78978109a32f0826b...164a3a388cfeeaec9ae240e7a8c8abcdc104a4d4,1,6,4,10,5,2013-12-14 20:03:09,2013-12-14 20:00:59
164a3a388cfeeaec9ae240e7a8c8abcdc104a4d4...1fa681ee11ac234cdc515338397625f514e85b73,1,24,0,24,1,2013-12-14 21:35:14,2013-12-01 02:05:15
1fa681ee11ac234cdc515338397625f514e85b73...e904d421d06bb53fbc9f55bd129b0b213d9908c5,1,1,1,2,1,2013-12-15 00:50:54,2013-12-15 00:50:54
f732d55dfcd06faf16a5d45798ae2f53d7784d66...7ba29189fabccdfde34071846bc08252588554d7,1,4,0,4,1,2014-03-02 13:01:52,2014-03-02 13:01:52
f732d55dfcd06faf16a5d45798ae2f53d7784d66...6268792e19ab37446e438f4777c0bb8e786c5c3f,1,2,3,5,2,2014-03-02 08:02:42,2014-03-02 08:02:42
09ab447d083558c0822acd58ab621e06c206ccba...35ed792cf248d6b245e299d13fe47b56f4c6bf42,2,24,1,25,3,2014-03-25 11:46:15,2014-03-21 07:52:49
35ed792cf248d6b245e299d13fe47b56f4c6bf42...16afffffe87bf8b7de6403329937433ac5096697,4,50,4,54,10,2014-03-25 13:33:13,2014-02-18 22:44:33
16afffffe87bf8b7de6403329937433ac5096697...e3c4205b79cff2be809c3698df2e9d53303b5070,3,5,5,10,4,2014-03-25 13:44:59,2014-03-25 13:43:51
e3c4205b79cff2be809c3698df2e9d53303b5070...86dcac463437dce06ddcade10fa3f308436ba608,2,8,2,10,3,2014-03-25 13:53:24,2014-03-22 21:57:01
86dcac463437dce06ddcade10fa3f308436ba608...69d4b1c3ea64f298380b0531c34509ae5eec89b9,2,14,2,16,3,2014-03-25 14:33:44,2014-03-25 14:02:51
69d4b1c3ea64f298380b0531c34509ae5eec89b9...9b7ba8af1b4ddb539cd69cbec9645cd873db7624,3,13,26,39,4,2014-03-25 18:01:37,2014-03-25 14:17:23
9b7ba8af1b4ddb539cd69cbec9645cd873db7624...1506c71a95cd7f58fbc6363edf2ef742c58d2487,8,153,26,179,19,2014-03-25 18:31:20,2014-03-04 01:12:42
1506c71a95cd7f58fbc6363edf2ef742c58d2487...378359de1c927e8b323b6b9fa2c4d2d2606a613f,1,6,0,6,1,2014-03-25 20:58:47,2014-03-25 20:58:47
378359de1c927e8b323b6b9fa2c4d2d2606a613f...42336c84a0daedfd8242333622eefe202e32398e,4,40,24,64,6,2014-03-25 22:30:58,2014-03-25 22:30:29
42336c84a0daedfd8242333622eefe202e32398e...ff874f363ce6556577f03909b15c71c051d5b617,1,4,3,7,3,2014-03-25 22:54:52,2014-03-25 20:02:53
d2e96b5792367af5aa0140f7e2673d654bb266df...4535dedc42b90b8f75576e48a12e2e63d4e93048,2,5,13,18,5,2014-05-09 04:34:57,2014-05-09 04:33:24
4535dedc42b90b8f75576e48a12e2e63d4e93048...1e8b1db050de72edc3c434e6e5d5dd55ae78ae2e,1,4,1,5,1,2014-05-09 04:39:31,2014-05-09 04:38:56
1e8b1db050de72edc3c434e6e5d5dd55ae78ae2e...31eac71a760b5f30796abfb0b18c3f7578b93e84,3,53,0,53,2,2014-05-09 04:49:09,2014-05-09 04:48:10
31eac71a760b5f30796abfb0b18c3f7578b93e84...8a090c21f10c503dd5f29885e78bfb0cb5588ba4,2,11,8,19,5,2014-05-09 17:47:43,2014-05-09 10:23:28
8a090c21f10c503dd5f29885e78bfb0cb5588ba4...0c198035e958a3caa0bd1e0fd9f419bf1308399d,4,35,3,38,8,2014-05-10 08:58:51,2014-05-07 01:14:06
0c198035e958a3caa0bd1e0fd9f419bf1308399d...c54fb3d922fdcd00c4e17676fe4cdaa3a3f6f6d8,6,11,10,21,11,2014-05-10 12:55:22,2014-05-10 12:40:42
c54fb3d922fdcd00c4e17676fe4cdaa3a3f6f6d8...e9d0ef19bc87aafd71d513cd927db2655267809b,2,13,0,13,2,2014-05-10 15:03:42,2014-05-10 14:39:20
e9d0ef19bc87aafd71d513cd927db2655267809b...9d0ebceb324ebb13b6d859153f95b2ef0c7c326b,2,9,5,14,5,2014-05-10 16:10:05,2014-05-10 16:06:25
9d0ebceb324ebb13b6d859153f95b2ef0c7c326b...8cf6c5c789d9b687e373e0d08cc483885b0daea3,2,8,8,16,7,2014-05-11 02:19:49,2014-05-11 02:13:50
8cf6c5c789d9b687e373e0d08cc483885b0daea3...537f5905c9877d7a57031d23d9489528b89de554,1,1,0,1,1,2014-05-11 02:29:42,2014-05-11 02:27:09
537f5905c9877d7a57031d23d9489528b89de554...ff938b36231e98dbefc4d2a73dde30d67a338866,1,1,1,2,1,2014-05-11 20:18:01,2014-05-07 19:16:43
ff938b36231e98dbefc4d2a73dde30d67a338866...2455699a9167b6696941ae2804b1e59e64083d71,1,1,0,1,1,2014-05-12 11:01:19,2014-05-12 10:59:23
2455699a9167b6696941ae2804b1e59e64083d71...e1f0efc501ad4e8999af51824806c091587fb21c,1,4,0,4,1,2014-05-12 16:44:40,2014-05-12 16:43:50
e1f0efc501ad4e8999af51824806c091587fb21c...aa3fd4b97e5a3f550c2b6a9a6fd23b540ae59078,1,1,1,2,1,2014-05-12 22:58:11,2014-05-12 22:56:34
aa3fd4b97e5a3f550c2b6a9a6fd23b540ae59078...0bb90de869303f4e0fc9479391fde7c68b4088a0,1,2,2,4,2,2014-05-13 11:05:35,2014-05-13 11:04:49
0bb90de869303f4e0fc9479391fde7c68b4088a0...81aeffccf32804aaf9343a32632e526fc6ec0f24,1,1,1,2,1,2014-05-13 11:28:43,2014-05-13 04:18:01
81aeffccf32804aaf9343a32632e526fc6ec0f24...fb9edfa3e637edcbcdd0fafbb905209a906e75af,2,2,1,3,2,2014-05-13 13:17:32,2014-05-13 13:17:04
fb9edfa3e637edcbcdd0fafbb905209a906e75af...50f228ae7c7d5eb68c1544423dcb3dfa31f2dc74,2,3,4,7,2,2014-05-14 00:55:00,2014-05-14 00:52:38
50f228ae7c7d5eb68c1544423dcb3dfa31f2dc74...7fef18ba9e5a8b47bc24b5bb259c8bf3d3879f2a,4,2,106,108,6,2014-05-14 08:18:26,2014-05-12 11:28:07
7fef18ba9e5a8b47bc24b5bb259c8bf3d3879f2a...e7b0cace455c2da24492660636bfd48c45a19cdf,3,50,4,54,9,2014-05-14 08:18:27,2014-05-12 11:38:39
e7b0cace455c2da24492660636bfd48c45a19cdf...77f0327d800965716122ead24584a0cffc018e54,4,137,2,139,6,2014-05-14 16:42:38,2014-05-14 16:07:32
77f0327d800965716122ead24584a0cffc018e54...95cf17244c086cb31eef86bdb0db57a0b5d05e38,1,1,1,2,1,2014-05-14 16:45:54,2014-05-14 16:45:54
95cf17244c086cb31eef86bdb0db57a0b5d05e38...9f5adf8db37280e8ddc093a36c9ad1c20142a5ca,1,1,1,2,1,2014-05-14 16:52:33,2014-05-14 16:52:33
9f5adf8db37280e8ddc093a36c9ad1c20142a5ca...d1860a3529cb5af358451dd6548f0a815f02531d,1,1,1,2,1,2014-05-15 09:52:30,2014-05-14 22:34:59
d1860a3529cb5af358451dd6548f0a815f02531d...93d5b0d5b6fac67fe7cbd3b86d3073550396958f,1,1,1,2,1,2014-05-15 10:36:14,2014-05-14 19:00:57
93d5b0d5b6fac67fe7cbd3b86d3073550396958f...2914f66983a92fcae55673c517dd8d01e8c238c4,15,229,61,290,41,2014-05-15 11:02:06,2014-03-05 20:19:40
2914f66983a92fcae55673c517dd8d01e8c238c4...c5185172a6645714a1b9df53728c530e2d0d2f2e,3,24,23,47,25,2014-05-15 11:16:57,2014-05-15 11:11:29
c5185172a6645714a1b9df53728c530e2d0d2f2e...e8a7436941f56d27b0096c93ef4ea1da13a5b95f,44,45,45,90,46,2014-05-15 18:01:31,2014-05-15 17:41:55
e8a7436941f56d27b0096c93ef4ea1da13a5b95f...6f0dcec44c2a1175dd558d60e526c4c5e7e39c25,1,1,1,2,1,2014-05-16 09:35:28,2014-05-16 09:07:43
6f0dcec44c2a1175dd558d60e526c4c5e7e39c25...79f15ab1ef964c0209c4484ccf62ba458fd582b3,5,13,12,25,11,2014-05-16 10:37:05,2014-05-16 03:12:32
79f15ab1ef964c0209c4484ccf62ba458fd582b3...2a66d12e77821fbd4f2e4c3cb93eb9f84ca6f9ab,2,4,2,6,4,2014-05-16 13:19:21,2014-05-16 13:13:11
2a66d12e77821fbd4f2e4c3cb93eb9f84ca6f9ab...0504d19db0482fee0e9adda3bf84cda212c07fe9,1,2,0,2,1,2014-05-16 15:20:58,2014-05-16 15:01:17
0504d19db0482fee0e9adda3bf84cda212c07fe9...bd45139d4e17304229da5464c907c614e64278d1,1,9,5,14,2,2014-05-16 16:27:55,2014-05-16 15:52:59
bd45139d4e17304229da5464c907c614e64278d1...75d2da797e100442d3573dfa7ae490972cea32d8,2,26,2,28,3,2014-05-16 16:38:26,2014-05-16 15:56:25
75d2da797e100442d3573dfa7ae490972cea32d8...6f8301d6cd3815409c7c2c8468dbfd239d39f468,2,29,0,29,3,2014-05-16 20:54:21,2014-05-16 20:52:10
6f8301d6cd3815409c7c2c8468dbfd239d39f468...62de03ee337e085dbaa9d94a43a2aedbd3cdef84,3,42,36,78,12,2014-05-16 21:14:13,2014-05-16 21:12:59
62de03ee337e085dbaa9d94a43a2aedbd3cdef84...8c5fbcf50aecec8ecfb802694af4dd7e0c9d666f,1,1,1,2,1,2014-05-16 21:44:20,2014-04-05 14:26:11
8c5fbcf50aecec8ecfb802694af4dd7e0c9d666f...b7a67b788cf2fa59a84f933492413379eb3cab83,2,19,2,21,6,2014-05-16 22:16:06,2014-05-16 17:04:26
b7a67b788cf2fa59a84f933492413379eb3cab83...0594d2d71492653a27e2668c2f18ba128f9277d9,2,14,0,14,2,2014-05-16 22:20:45,2014-05-16 22:19:23
0594d2d71492653a27e2668c2f18ba128f9277d9...bc2bfbadcc2b914613547abdc87241b2ae33fac2,1,16,18,34,8,2014-05-17 13:11:00,2014-05-17 13:11:00
bc2bfbadcc2b914613547abdc87241b2ae33fac2...8b874730086aa11570d08aa63ca74b4b888fb989,2,2,2,4,2,2014-05-17 17:31:09,2014-05-17 16:54:34
8b874730086aa11570d08aa63ca74b4b888fb989...ed98757e4b443a7372dc25a147815b28d0abc4f5,1,8,0,8,8,2014-05-18 17:00:32,2014-03-24 08:40:01
ed98757e4b443a7372dc25a147815b28d0abc4f5...db2aacff9906c0f9c7c004173787ef8c292451f1,2,5,11,16,5,2014-05-19 07:30:59,2014-05-19 07:26:31
db2aacff9906c0f9c7c004173787ef8c292451f1...4dd37a3a6eb744a9901eb53454a86bf304a71426,1,8,5,13,3,2014-05-19 11:46:27,2014-05-19 07:33:12
4dd37a3a6eb744a9901eb53454a86bf304a71426...a69534ddd4308d19a06f323037e74205e5192ac9,4,0,88,88,4,2014-05-19 12:21:01,2014-05-19 12:10:13
a69534ddd4308d19a06f323037e74205e5192ac9...1e78d132dad66cae93b94e3c854bcb4fd4b49b6e,2,3,3,6,3,2014-05-19 12:37:00,2014-05-19 12:35:44
1e78d132dad66cae93b94e3c854bcb4fd4b49b6e...16c433967a93cf75e82569d6624ef0d5090bc92b,1,6,4,10,4,2014-05-19 13:12:08,2014-05-19 13:11:11
16c433967a93cf75e82569d6624ef0d5090bc92b...0f84037e104d63ef341dcfa6a465bef4782fb8fb,15,1208,986,2194,699,2014-05-19 13:14:09,2014-05-19 13:14:09
0f84037e104d63ef341dcfa6a465bef4782fb8fb...269291019ec2dddddd6dd3b9833a37e7b94944ab,1,3,3,6,3,2014-05-19 13:50:46,2014-05-19 13:02:42
269291019ec2dddddd6dd3b9833a37e7b94944ab...c38925a6018a7943936d1fd2b9038ab5de406545,2,64,2,66,5,2014-05-19 14:05:23,2014-05-16 17:56:44
c38925a6018a7943936d1fd2b9038ab5de406545...157575c7c8ad4e55b68077c2d10b41d596038e2e,1,1,1,2,1,2014-05-19 14:05:23,2014-05-19 13:59:02
157575c7c8ad4e55b68077c2d10b41d596038e2e...3e2bb807b1127a6f57176972db5951dc6d120208,2,3,11,14,3,2014-05-20 10:23:17,2014-05-20 10:19:40
3e2bb807b1127a6f57176972db5951dc6d120208...0007a43198670a1716bc5ff2d0a659daa4c7cf63,2,45,3,48,7,2014-05-20 16:19:40,2014-05-16 13:40:57
0007a43198670a1716bc5ff2d0a659daa4c7cf63...24a41ecc3590f8d92d085d4a4caa5f8bf962ceae,3,77,11,88,7,2014-05-21 03:37:00,2014-05-18 20:43:13
24a41ecc3590f8d92d085d4a4caa5f8bf962ceae...0fa1aeb8d8142bd6bceb0c9a36c8e42eeca21770,2,22,23,45,13,2014-05-21 03:37:41,2014-05-19 04:14:55
0fa1aeb8d8142bd6bceb0c9a36c8e42eeca21770...f7270dcd9d655f037604cf6044306582875dfbf4,1,22,22,44,2,2014-05-21 10:56:23,2014-05-20 03:16:36
f7270dcd9d655f037604cf6044306582875dfbf4...1a29675d76de00d6fad9b366fc66e8b6d541c3b6,1,17,3,20,5,2014-05-21 10:57:49,2014-05-16 16:11:29
1a29675d76de00d6fad9b366fc66e8b6d541c3b6...d61b6224b09cb2aa6fb75ccecab246f91553ef7b,3,145,2,147,7,2014-05-21 11:04:38,2014-05-18 04:58:16
d61b6224b09cb2aa6fb75ccecab246f91553ef7b...c60240e712ebea192b89baf7024e5478172420fe,1,21,0,21,6,2014-05-21 11:04:46,2014-05-18 05:46:12
c60240e712ebea192b89baf7024e5478172420fe...d8c532036a33feacd1420706e0365cf146b9e4b9,3,8,10,18,6,2014-05-21 11:04:46,2014-05-20 14:41:01
d8c532036a33feacd1420706e0365cf146b9e4b9...fd62bc165ce6eabca077c51bdd6292eef27b84c0,3,71,24,95,11,2014-05-21 11:04:46,2014-05-20 15:25:59
fd62bc165ce6eabca077c51bdd6292eef27b84c0...f25c5de4ceb1f75a58acc6364c7e8a9b217bc08c,1,2,0,2,2,2014-05-21 11:04:46,2014-05-21 10:54:24
f25c5de4ceb1f75a58acc6364c7e8a9b217bc08c...aa9a146a69655849d588da7eba4a71a2ea4b6361,1,3,0,3,1,2014-05-21 15:20:38,2014-05-21 15:11:01
aa9a146a69655849d588da7eba4a71a2ea4b6361...485163f72cf916231fbef78a645a19dfa34928b2,1,1,1,2,1,2014-05-22 07:48:04,2014-05-22 07:46:34
485163f72cf916231fbef78a645a19dfa34928b2...fb45e666c204d7188c38469ca1f661a9b113b85b,4,45,3,48,7,2014-05-22 11:38:39,2014-05-12 16:46:47
fb45e666c204d7188c38469ca1f661a9b113b85b...7d4a51e239bcde34d1614877accb3aa5f5589e0c,2,18,2,20,3,2014-05-22 14:20:21,2014-05-22 11:29:30
7d4a51e239bcde34d1614877accb3aa5f5589e0c...1f6b3cf145fc1057f478607c2c845e66efaaf546,2,71,1,72,2,2014-05-22 16:34:00,2014-05-22 15:08:32
1f6b3cf145fc1057f478607c2c845e66efaaf546...8462883f9b16810fbc6175d78d7bb13a297debe9,9,326,0,326,8,2014-05-23 12:07:58,2014-05-20 14:29:32
8462883f9b16810fbc6175d78d7bb13a297debe9...8f87b679ed9879bd5ef9dbc1566f87ed8442fd3b,1,1,1,2,1,2014-05-23 12:51:22,2014-05-23 12:50:10
8f87b679ed9879bd5ef9dbc1566f87ed8442fd3b...8dad90911afb0007856f82c0ab9199af7cb43111,1,3,6,9,4,2014-05-24 09:03:45,2014-05-24 08:53:22
8dad90911afb0007856f82c0ab9199af7cb43111...e692c5818b7a57a878dce8d96e697493d680a123,1,3,4,7,3,2014-05-24 10:19:49,2014-05-24 10:19:49
e692c5818b7a57a878dce8d96e697493d680a123...cdfefbec721b59695e28e5992eda1cc52af48212,2,20,11,31,16,2014-05-24 11:12:56,2014-05-24 09:51:57
cdfefbec721b59695e28e5992eda1cc52af48212...be733bf672eebb7d03061a293a2b0b03c727ab44,5,39,13,52,6,2014-05-24 12:11:50,2014-05-24 09:52:18
be733bf672eebb7d03061a293a2b0b03c727ab44...a59870e21784166725f7cb3230becef50553ee3a,5,79,33,112,7,2014-05-24 13:56:43,2014-05-22 09:42:46
a59870e21784166725f7cb3230becef50553ee3a...dbdbda87fc38816c45584ea7a97876078cbffb3a,1,9,0,9,1,2014-05-24 13:59:28,2014-05-24 13:57:04
dbdbda87fc38816c45584ea7a97876078cbffb3a...0c685ab64fcfb46bcd8cfa9b2d2a22d94f6223b3,1,2,14,16,3,2014-05-25 19:26:44,2014-05-25 19:25:23
0c685ab64fcfb46bcd8cfa9b2d2a22d94f6223b3...1992d55eb3731bccef549c2cede08cfcca1309de,2,2,1,3,2,2014-05-25 21:15:31,2014-05-25 21:14:50
1992d55eb3731bccef549c2cede08cfcca1309de...099625d760cfc07d8e579ea7deaff4ebdbf47574,3,0,0,0,0,2014-05-25 21:17:18,2014-05-25 21:16:40
099625d760cfc07d8e579ea7deaff4ebdbf47574...47d345fe6dbd20b5b24671e432da11883eba261f,1,1,1,2,1,2014-05-25 22:07:57,2014-05-25 22:07:15
47d345fe6dbd20b5b24671e432da11883eba261f...22d33d52cbc840f4648a3809b893aec48409b29b,1,1,1,2,1,2014-05-25 23:03:28,2014-05-25 07:24:53
22d33d52cbc840f4648a3809b893aec48409b29b...4d4ea654187c2cfecbcdfe3d67badcc50786ef25,1,9,0,9,1,2014-05-25 23:37:11,2014-05-24 17:31:34
4d4ea654187c2cfecbcdfe3d67badcc50786ef25...c0a56001e0e5c35615842f4ed223b7baeb234730,3,41,2,43,5,2014-05-27 00:03:41,2014-05-26 20:09:17
c0a56001e0e5c35615842f4ed223b7baeb234730...430faebe3baa3daecc0ea083c1259c2b43b0557f,2,30,25,55,9,2014-05-27 19:46:30,2014-05-27 16:57:53
430faebe3baa3daecc0ea083c1259c2b43b0557f...0204893a18a0857ab04e26714bd002a854337d48,1,1,0,1,1,2014-05-27 23:48:50,2014-05-27 23:48:50
0204893a18a0857ab04e26714bd002a854337d48...5d7ad16a1b8c0efb29ab0d18370a4392308263f3,1,8,5,13,1,2014-05-28 00:11:51,2014-05-27 18:53:19
5d7ad16a1b8c0efb29ab0d18370a4392308263f3...91ef348bd6ac5d3051d428806b143c419af91aa8,1,3,48,51,3,2014-05-28 07:35:43,2014-05-27 20:18:51
91ef348bd6ac5d3051d428806b143c419af91aa8...5f135e6a0b77e76649aac48434740cc703e843ff,2,8,3,11,3,2014-05-28 16:02:29,2014-05-28 15:57:40
5f135e6a0b77e76649aac48434740cc703e843ff...b8b1fbd4c1c42d3cf84d67c1923716842025680b,3,3,3,6,3,2014-05-28 18:26:08,2014-05-28 18:16:24
b8b1fbd4c1c42d3cf84d67c1923716842025680b...0ee27d5b62a76781f5d78fc3f506dca624941062,1,2,1,3,1,2014-05-29 11:52:17,2014-05-28 23:00:30
0ee27d5b62a76781f5d78fc3f506dca624941062...ce1dd6a7303fefa8020dd35effcfcc5c251e4627,1,21,0,21,2,2014-05-29 11:52:48,2014-05-28 23:38:59
ce1dd6a7303fefa8020dd35effcfcc5c251e4627...d099c03789cb88e450002ceaf072990b50052995,1,1,1,2,1,2014-05-29 11:52:55,2014-05-29 00:17:58
d099c03789cb88e450002ceaf072990b50052995...3d98941d5c1b0ed9ff89cbf5b1cf6af24964d759,34,40,40,80,40,2014-05-29 11:53:02,2014-05-29 00:39:14
3d98941d5c1b0ed9ff89cbf5b1cf6af24964d759...d192e02b27805e9e39395ad85a2667cc310ff87f,1,1,1,2,1,2014-05-29 11:53:08,2014-05-29 00:46:06
d192e02b27805e9e39395ad85a2667cc310ff87f...c5afdc3d73945c8e9d45442dd488f413e67ce2aa,1,1,1,2,1,2014-05-29 13:28:58,2014-05-29 13:28:58
c5afdc3d73945c8e9d45442dd488f413e67ce2aa...b6a960cd1df4a191fc2900bcaa76c73f2696fc4d,7,107,0,107,13,2014-05-29 22:36:30,2014-05-29 21:03:10
b6a960cd1df4a191fc2900bcaa76c73f2696fc4d...4956e182ac207437eaf182f076de6717ee00843c,1,2,1,3,2,2014-05-29 22:36:49,2014-05-29 22:34:35
4956e182ac207437eaf182f076de6717ee00843c...e4eae5df0ec222fa13d6bac226b3b10c75f3d40d,3,51,1,52,4,2014-05-29 22:39:02,2014-05-29 22:23:09
e4eae5df0ec222fa13d6bac226b3b10c75f3d40d...35bdf87034000d7e00521ed62f0e12f9bed6ea9c,3,3,3,6,3,2014-05-29 22:58:55,2014-05-29 22:58:12
35bdf87034000d7e00521ed62f0e12f9bed6ea9c...16d037c4f06104670b88989daa76b05a2f10fd85,1,6,6,12,6,2014-05-29 23:44:29,2014-05-29 23:43:49
16d037c4f06104670b88989daa76b05a2f10fd85...b266392b638c188daf3621e7f919cc12d65a4e2a,1,6,0,6,1,2014-05-30 12:05:43,2014-05-29 06:53:25
b266392b638c188daf3621e7f919cc12d65a4e2a...08a2b3b9cf64c1f1405a24e14500212a613a023c,1,7,9,16,2,2014-05-30 15:01:42,2014-05-30 10:42:13
08a2b3b9cf64c1f1405a24e14500212a613a023c...e3792bb95f3c3854e39269aeb1ff4c7b3e859e70,5,119,44,163,30,2014-05-30 20:00:25,2014-05-25 17:37:31
e3792bb95f3c3854e39269aeb1ff4c7b3e859e70...c95a3fadb7356e766fe48fae69ce81355180f46a,3,16,4,20,5,2014-05-30 20:25:17,2014-03-21 07:38:25
c95a3fadb7356e766fe48fae69ce81355180f46a...ba31e45f08366929b02df2607324dccb3cf4a1e6,6,0,69,69,11,2014-06-01 10:01:29,2014-06-01 10:00:09
ba31e45f08366929b02df2607324dccb3cf4a1e6...a83c56a45a976375ffe1bdf014b0f1c38a610ee6,2,115,119,234,9,2014-06-01 17:07:19,2014-05-24 20:39:55
a83c56a45a976375ffe1bdf014b0f1c38a610ee6...ad408d09854c416f342b82a277a95bc0e721cfd6,1,1,1,2,1,2014-06-01 17:22:15,2014-06-01 10:32:52
ad408d09854c416f342b82a277a95bc0e721cfd6...33511662ddbff0ca22cf5a0b7fdeca2f6764759f,3,34,11,45,9,2014-06-01 19:12:23,2014-05-22 22:51:11
33511662ddbff0ca22cf5a0b7fdeca2f6764759f...d773a08b270e3b2c387985a9d9a4d01c991469c8,2,43,1,44,3,2014-06-01 19:37:57,2014-05-27 15:48:50
d773a08b270e3b2c387985a9d9a4d01c991469c8...a2fb5c9d69b0a7bfbb7f5576eb9e801c159a1f0b,1,5,1,6,1,2014-06-01 20:07:22,2014-06-01 20:03:33
a2fb5c9d69b0a7bfbb7f5576eb9e801c159a1f0b...f8dd382a48d7dea8cda04a6674f305651e88c654,2,0,21,21,3,2014-06-02 11:13:03,2014-06-02 11:05:38
f8dd382a48d7dea8cda04a6674f305651e88c654...160fd6c7c1699e0be89d9a48f4cc9386bab0e9de,1,1,1,2,1,2014-06-02 11:14:02,2014-05-31 17:50:29
160fd6c7c1699e0be89d9a48f4cc9386bab0e9de...724e6008722acb9b69ea3d1749ac8c1125837d03,3,37,11,48,6,2014-06-02 13:34:31,2014-05-28 22:26:57
724e6008722acb9b69ea3d1749ac8c1125837d03...170255caf43f2d0ae072f0b7a22da90f50bd95b0,1,8,3,11,4,2014-06-02 15:39:23,2014-06-02 15:35:20
170255caf43f2d0ae072f0b7a22da90f50bd95b0...cb3266c1b0d6328dcf316f2d6d0db28a10df6816,1,3,1,4,2,2014-06-02 22:52:55,2014-06-02 20:19:12
cb3266c1b0d6328dcf316f2d6d0db28a10df6816...206cb74cef0c8d81d6a6ed3ecb8b2fd8848abb26,1,1,1,2,1,2014-06-03 11:44:39,2014-06-03 03:38:05
206cb74cef0c8d81d6a6ed3ecb8b2fd8848abb26...c8382f4c6578104a21263c865485d60f3d64965b,1,4,4,8,2,2014-06-03 12:10:44,2014-06-03 07:02:03
c8382f4c6578104a21263c865485d60f3d64965b...8d6e0d45882444cf528b10832811fa19613f184a,6,6,1,7,3,2014-06-03 19:03:32,2014-05-22 12:12:22
8d6e0d45882444cf528b10832811fa19613f184a...868b5e5e957eae6d88be12b2e52ca971de81ed8d,1,12,0,12,1,2014-06-04 16:42:23,2014-06-04 16:37:10
868b5e5e957eae6d88be12b2e52ca971de81ed8d...52b7e772e4da846efb2d75b22ec05c7105091b76,1,4,3,7,1,2014-06-04 16:45:24,2014-06-04 13:58:28
52b7e772e4da846efb2d75b22ec05c7105091b76...4fb50a9a82a15134a72c4c77fe57e641002b7340,1,42,19,61,18,2014-06-05 14:30:43,2014-06-05 14:30:43
4fb50a9a82a15134a72c4c77fe57e641002b7340...2e4bcb9b0265ceb0ef0eae6da2a91f89d037d05f,2,7,4,11,3,2014-06-05 15:10:42,2014-06-05 15:06:50
2e4bcb9b0265ceb0ef0eae6da2a91f89d037d05f...342b25449d800ce29ae56ff8285869cbc3133a75,3,8,5,13,4,2014-06-05 15:57:48,2014-06-05 15:56:56
342b25449d800ce29ae56ff8285869cbc3133a75...4ad299f287e6b8bc4ccd0ecbbfd1efcf4aca8251,1,8,6,14,3,2014-06-05 19:14:14,2014-06-05 18:54:28
4ad299f287e6b8bc4ccd0ecbbfd1efcf4aca8251...1238f92c649ccd4ba99da0ce70be7597c90515d4,1,8,2,10,2,2014-06-05 22:26:40,2014-06-05 22:26:40
1238f92c649ccd4ba99da0ce70be7597c90515d4...c9aedce01ae54f26d612b070ded57d2cb3eb8483,3,7,4,11,4,2014-06-05 22:31:22,2014-06-05 22:29:24
c9aedce01ae54f26d612b070ded57d2cb3eb8483...31fc34e447137631e6ea58fc33f3642e65479472,3,630,296,926,87,2014-06-06 06:27:21,2014-06-06 06:03:33
31fc34e447137631e6ea58fc33f3642e65479472...9f1c4e4d3f997dea150d19ca43d2471d66def120,6,115,17,132,7,2014-06-06 06:28:17,2014-05-29 10:30:47
9f1c4e4d3f997dea150d19ca43d2471d66def120...7d388956cecf02fa84939ab913b594cd96462302,1,7,1,8,1,2014-06-06 06:34:44,2014-06-06 06:34:13
7d388956cecf02fa84939ab913b594cd96462302...b236a5581898aca7bff082a6d642bf457278c658,2,1,1,2,1,2014-06-06 06:43:24,2014-06-06 06:40:04
b236a5581898aca7bff082a6d642bf457278c658...c81847181c5b0eb430559a32de2de0b0cd790e08,2,6,6,12,6,2014-06-06 12:29:56,2014-06-06 12:29:27
c81847181c5b0eb430559a32de2de0b0cd790e08...c8c1883962ebb0668663134e023ffbe1c753a450,1,194,100,294,31,2014-06-06 19:25:58,2014-06-06 19:19:20
c8c1883962ebb0668663134e023ffbe1c753a450...a517e9ac857dd4d022cd77f742dd0848fbaec5d1,2,9,7,16,3,2014-06-07 11:25:02,2014-06-07 00:31:23
a517e9ac857dd4d022cd77f742dd0848fbaec5d1...211ff288a03ba4623399e222d15a33075e958f0a,1,8,4,12,4,2014-06-07 20:35:29,2014-06-07 20:33:56
211ff288a03ba4623399e222d15a33075e958f0a...2b13576c8f48bde808f58621ff26e5b1ab3ed4c1,2,9,3,12,6,2014-06-07 23:57:58,2014-06-07 03:41:15
2b13576c8f48bde808f58621ff26e5b1ab3ed4c1...98949e3b108100a40cb6ad59be78f33580439fef,3,68,6,74,9,2014-06-08 00:06:06,2014-06-08 00:04:58
98949e3b108100a40cb6ad59be78f33580439fef...3fc4f03895ae356a5861d0385de71e7a590811b6,7,72,3,75,14,2014-06-08 00:18:43,2014-05-29 21:03:10
3fc4f03895ae356a5861d0385de71e7a590811b6...83fe38ae30fe6053f378c4adfc4387f2e8bd030c,1,2,2,4,2,2014-06-08 01:11:17,2014-06-08 01:10:44
83fe38ae30fe6053f378c4adfc4387f2e8bd030c...b568bdf8da30fe5940a31add9f3a2b8029ecb04d,6,92,85,177,26,2014-06-08 01:18:18,2014-06-08 01:17:31
b568bdf8da30fe5940a31add9f3a2b8029ecb04d...25f4e71ed30befbd6af02a7d35807d0d3170e57d,8,25,21,46,21,2014-06-08 19:17:59,2014-06-08 07:54:35
25f4e71ed30befbd6af02a7d35807d0d3170e57d...55fa4c2d3423b051fce5663b3efc13e458fbb777,3,36,9,45,9,2014-06-09 00:13:11,2014-06-09 00:12:27
55fa4c2d3423b051fce5663b3efc13e458fbb777...bf019c977055ade45c5c260ed235bb5dcf7e2be7,1,5,2,7,2,2014-06-09 01:58:15,2014-06-09 01:57:55
bf019c977055ade45c5c260ed235bb5dcf7e2be7...08218252d8be4633ac0e94863da527d824648d63,17,247,27,274,28,2014-06-09 02:33:52,2014-06-09 02:30:15
08218252d8be4633ac0e94863da527d824648d63...b78710ec022d5d04b62f69eb086478faeee2ee38,1,2,2,4,1,2014-06-09 03:08:34,2014-06-09 03:07:35
b78710ec022d5d04b62f69eb086478faeee2ee38...d4623d13b731efef499b49576f883a5578297fdd,2,16,11,27,14,2014-06-09 08:32:27,2014-06-09 08:28:39
d4623d13b731efef499b49576f883a5578297fdd...a11ed8dcfdce6820012ea219d1bbadb28c67b60d,1,6,0,6,1,2014-06-09 14:32:09,2014-06-09 14:29:22
a11ed8dcfdce6820012ea219d1bbadb28c67b60d...0a515b02fcfa937e2a148148ca7be3e291e31d2e,2,1,1,2,2,2014-06-09 16:02:20,2014-06-09 16:00:12
0a515b02fcfa937e2a148148ca7be3e291e31d2e...417da8a78277a14bd2348aec12d79b43f3dac6ee,6,21,13,34,13,2014-06-09 16:16:04,2014-06-09 16:09:16
417da8a78277a14bd2348aec12d79b43f3dac6ee...7406feae33b70319c6e3a3edcd40e863692d29ed,1,3,4,7,4,2014-06-09 16:52:35,2014-06-09 16:52:05
7406feae33b70319c6e3a3edcd40e863692d29ed...11f0bdc00757e5646337633f6a045b085f0653b2,1,8,1,9,2,2014-06-09 18:43:13,2014-06-09 18:14:58
11f0bdc00757e5646337633f6a045b085f0653b2...e5879811e6854852a2a0d8c850dd2a1795e09e9a,1,2,3,5,2,2014-06-09 20:07:28,2014-06-08 20:40:22
e5879811e6854852a2a0d8c850dd2a1795e09e9a...5cde9a7018021fc3c005e4ebcfa63967bcf56285,3,14,16,30,8,2014-06-09 20:08:20,2014-06-08 20:42:12
5cde9a7018021fc3c005e4ebcfa63967bcf56285...eeea58306178a7ae010767332693ed28e1ce03ac,1,0,1,1,1,2014-06-09 22:42:32,2014-06-09 22:41:35
eeea58306178a7ae010767332693ed28e1ce03ac...e108da65fe7b84a101412cd31e3bda241e373ed6,1,36,36,72,3,2014-06-10 13:19:38,2014-06-10 13:18:58
e108da65fe7b84a101412cd31e3bda241e373ed6...d232a5f93f2c0be93b6aa5669e9cba0f328a4a9b,2,29,2,31,3,2014-06-10 13:43:24,2014-06-10 09:32:46
d232a5f93f2c0be93b6aa5669e9cba0f328a4a9b...0767055dfc255ba120811f6d9cba2c7e593b0731,6,60,74,134,12,2014-06-10 19:00:12,2014-06-10 16:22:07
0767055dfc255ba120811f6d9cba2c7e593b0731...de0e285be80e0ca756088a97335d8faa698fbe6b,6,7,7,14,7,2014-06-10 19:39:05,2014-06-10 19:16:31
de0e285be80e0ca756088a97335d8faa698fbe6b...1ff11304dcebbabdede8ef3d659ca0e54055e2fd,10,79,6,85,15,2014-06-11 07:03:11,2014-05-25 20:52:47
1ff11304dcebbabdede8ef3d659ca0e54055e2fd...7bd2ad1dd9fc449ed1b4832fab5c975d7c8aa895,4,16,14,30,10,2014-06-11 15:40:08,2014-06-10 19:35:48
7bd2ad1dd9fc449ed1b4832fab5c975d7c8aa895...45e47f7b95aad98d91bb40e19dda14ae120980a4,4,7,2,9,7,2014-06-11 15:48:57,2014-06-11 15:45:18
45e47f7b95aad98d91bb40e19dda14ae120980a4...fa42cf77b26bc1f09f9d62bc14338b295d700d87,2,23,11,34,3,2014-06-11 17:28:21,2014-06-11 17:25:02
fa42cf77b26bc1f09f9d62bc14338b295d700d87...8c20f4af12d1f0f4798467dfac33858d05bfc182,1,3,2,5,2,2014-06-11 19:43:53,2014-06-11 18:46:57
8c20f4af12d1f0f4798467dfac33858d05bfc182...c6725d69a2b7f00653886f0aeae301b7ce0baf69,1,1,1,2,1,2014-06-11 21:18:03,2014-06-11 21:13:34
c6725d69a2b7f00653886f0aeae301b7ce0baf69...1c0e6e9d9f97d4183d1a696911613f1730e9a887,2,2,2,4,2,2014-06-12 06:56:29,2014-06-12 06:53:36
1c0e6e9d9f97d4183d1a696911613f1730e9a887...910b37e35682bd7c9a94eb2c8ae27504db2caf4f,1,4,1,5,1,2014-06-12 14:53:29,2014-06-12 14:19:03
910b37e35682bd7c9a94eb2c8ae27504db2caf4f...84714dfed726212122ac9a143ddbe6719dac5884,1,1,1,2,1,2014-06-12 15:55:31,2014-06-12 15:55:31
84714dfed726212122ac9a143ddbe6719dac5884...961c9d6c6b1975fba8eb1492288e0fc49652c43d,12,114,13,127,10,2014-06-12 17:22:57,2014-06-12 17:21:26
961c9d6c6b1975fba8eb1492288e0fc49652c43d...e51662e7bc2a946e6656e4954c902451a04eaf0e,4,149,9,158,10,2014-06-12 17:28:16,2014-06-11 19:26:17
e51662e7bc2a946e6656e4954c902451a04eaf0e...83e96ee99b6cd8ce1863dcca24dfbf4a8d6b5429,1,6,5,11,6,2014-06-12 17:29:04,2014-06-12 17:08:27
83e96ee99b6cd8ce1863dcca24dfbf4a8d6b5429...49d4ace2d2798f1239b8d9d773c88b1a9848b34f,1,6,0,6,1,2014-06-12 18:12:33,2014-06-12 18:12:07
49d4ace2d2798f1239b8d9d773c88b1a9848b34f...d9eef1f4f7b4401a0ff6e3feb3352b6e661f705a,1,7,0,7,1,2014-06-12 18:15:31,2014-06-11 17:21:14
d9eef1f4f7b4401a0ff6e3feb3352b6e661f705a...d3bf537324c1164dee45070f90d48661b27a781f,2,14,1,15,3,2014-06-12 20:42:39,2014-06-12 17:43:30
d3bf537324c1164dee45070f90d48661b27a781f...d94de802d34c858805a01d3c699799aebc247ec3,9,131,15,146,18,2014-06-13 16:40:42,2014-04-20 12:58:29
d94de802d34c858805a01d3c699799aebc247ec3...1cb5dfe05f4e8363a7cf39d400e328f4b1c33366,2,3,2,5,3,2014-06-13 17:13:10,2014-05-28 17:40:31
1cb5dfe05f4e8363a7cf39d400e328f4b1c33366...4b922b809413eb9e9d59be0c3b41d0cedefbeb29,3,6,4,10,5,2014-06-13 21:53:27,2014-06-13 21:43:49
4b922b809413eb9e9d59be0c3b41d0cedefbeb29...ec2f0417364050aed3e8c2aa1948915d08c39514,1,5,2,7,1,2014-06-14 18:54:48,2014-06-14 18:52:37
ec2f0417364050aed3e8c2aa1948915d08c39514...2a45086debb372a1e254efa98aee4da8ba495827,1,5,2,7,1,2014-06-15 18:06:15,2014-06-15 18:05:40
2a45086debb372a1e254efa98aee4da8ba495827...c903543127e642e619213cdefda9cea15df09c16,4,42,3,45,4,2014-06-15 18:26:35,2014-06-15 18:25:39
c903543127e642e619213cdefda9cea15df09c16...a067c61b94926f408e151ff5b4e0ce0d3b775183,3,31,0,31,4,2014-06-15 18:47:57,2014-06-15 18:46:56
a067c61b94926f408e151ff5b4e0ce0d3b775183...13aa079941dcfd953ba03a83f55c8a14399d15c2,2,20,1,21,2,2014-06-15 19:07:27,2014-06-15 19:06:48
13aa079941dcfd953ba03a83f55c8a14399d15c2...3ef87f664bb8b2a46546de755bfc4e158c90032f,5,93,2,95,9,2014-06-15 19:34:34,2014-06-15 19:34:02
3ef87f664bb8b2a46546de755bfc4e158c90032f...e5cde2062c0fbe21476978cc318c84134bf7bc46,8,234,3,237,18,2014-06-15 21:57:00,2014-06-15 21:55:44
e5cde2062c0fbe21476978cc318c84134bf7bc46...a81282a512e706011747ec4cd1a990bae167edc6,5,220,39,259,39,2014-06-15 23:02:24,2014-06-15 23:01:49
a81282a512e706011747ec4cd1a990bae167edc6...39e2ad4532f08523ed42438520d2ea5162a65183,3,7,7,14,5,2014-06-16 01:07:28,2014-06-16 00:45:15
39e2ad4532f08523ed42438520d2ea5162a65183...534d9f1e822ef49550c195a4e9493970781c4591,2,28,0,28,1,2014-06-16 01:15:05,2014-04-19 10:49:23
534d9f1e822ef49550c195a4e9493970781c4591...ec7cddd361c7e575397e067c5f0e0846c11a0b10,2,34,0,34,1,2014-06-16 01:15:12,2014-04-19 10:35:02
ec7cddd361c7e575397e067c5f0e0846c11a0b10...380cafe5bee50d4cc9d90ef6e33e47be9de25e0b,2,31,0,31,1,2014-06-16 01:15:17,2014-04-19 11:57:08
380cafe5bee50d4cc9d90ef6e33e47be9de25e0b...44a50603d402a40158159e9cc05c776fe67973be,1,1,1,2,1,2014-06-16 06:45:58,2014-06-15 10:44:33
44a50603d402a40158159e9cc05c776fe67973be...d4305a15c1d48a0248ce1da1989a145009029e6c,2,46,1,47,2,2014-06-16 07:27:46,2014-06-16 07:27:14
d4305a15c1d48a0248ce1da1989a145009029e6c...183e9d20294dec28df8ae5ea8ed7acc712adcd2b,3,41,5,46,5,2014-06-16 12:29:52,2014-06-06 09:19:16
183e9d20294dec28df8ae5ea8ed7acc712adcd2b...f7709b3ce4ce698b80de5f436386bdeb4e0b0419,5,22,10,32,11,2014-06-16 15:52:33,2014-06-16 14:15:19
f7709b3ce4ce698b80de5f436386bdeb4e0b0419...a15bf2cd4e8f7279488f04aaf3040f420dc5f9cb,3,29,0,29,2,2014-06-16 15:53:34,2014-06-16 14:18:42
a15bf2cd4e8f7279488f04aaf3040f420dc5f9cb...2dba6ab767d8532df5f9ea2b58325ef823d3c6f8,5,80,2,82,6,2014-06-16 16:39:05,2014-06-11 13:00:52
2dba6ab767d8532df5f9ea2b58325ef823d3c6f8...a5fed757aaa1eebe4f22f8e2a6c47296e850712f,2,3,3,6,3,2014-06-16 16:54:57,2014-06-16 16:54:23
a5fed757aaa1eebe4f22f8e2a6c47296e850712f...11b8e6154b32c0a46c8910c21070692f3d08f6b4,2,7,3,10,4,2014-06-16 16:59:06,2014-06-16 16:58:35
11b8e6154b32c0a46c8910c21070692f3d08f6b4...d9a7663b11269ca0adda26ad16e47350b680bab5,2,58,2,60,6,2014-06-16 17:20:52,2014-06-16 17:20:05
d9a7663b11269ca0adda26ad16e47350b680bab5...02860e779c7a93e50817df55d8a7f64b642319eb,1,7,4,11,2,2014-06-16 17:29:00,2014-06-16 17:28:31
02860e779c7a93e50817df55d8a7f64b642319eb...a0bf14a2accb75987657a9656bccfc8b9df8d375,8,85,42,127,9,2014-06-16 19:03:27,2014-06-16 17:28:03
a0bf14a2accb75987657a9656bccfc8b9df8d375...6a937cc0a4b0aa36380b5e6cbbccedcbb350a115,1,0,1,1,1,2014-06-16 20:23:11,2014-06-16 19:45:07
6a937cc0a4b0aa36380b5e6cbbccedcbb350a115...d36b54d753a1fb79f32f6b7a91d582bccb7ab311,5,75,4,79,7,2014-06-16 20:23:28,2014-06-16 19:59:24
d36b54d753a1fb79f32f6b7a91d582bccb7ab311...6e248d8f8c95da9cbd654d43df76c20e6d0ec352,2,19,1,20,3,2014-06-16 20:35:24,2014-06-16 08:46:34
6e248d8f8c95da9cbd654d43df76c20e6d0ec352...71f573330b76ebca21c65013e5b6e13e68c3e5ed,1,1,1,2,1,2014-06-16 22:00:06,2014-06-16 21:58:35
71f573330b76ebca21c65013e5b6e13e68c3e5ed...095f73aa224d46c67274104679bdc54f2a53499d,1,8,4,12,4,2014-06-16 22:10:07,2014-06-16 22:09:27
095f73aa224d46c67274104679bdc54f2a53499d...7f095ea74419cda5534b0cc9fbedc41f84f41318,1,2,2,4,1,2014-06-16 22:50:07,2014-06-16 22:49:37
7f095ea74419cda5534b0cc9fbedc41f84f41318...dc7d0f50e22bc52bc4656879452c482394347b75,4,4,4,8,4,2014-06-16 23:25:58,2014-06-16 23:25:13
dc7d0f50e22bc52bc4656879452c482394347b75...6e7da2bfafb63f5f7c35ed281807cdb54794c2f0,2,27,4,31,6,2014-06-17 01:44:22,2014-06-17 01:43:45
6e7da2bfafb63f5f7c35ed281807cdb54794c2f0...57a770b8e586399926311d86639c6789a1563253,1,3,1,4,1,2014-06-17 07:36:41,2014-06-17 07:36:27
57a770b8e586399926311d86639c6789a1563253...aa10f57d9460f121dea2ec2635e478ed02cc18b5,7,29,29,58,23,2014-06-17 16:06:12,2014-06-17 15:57:16
aa10f57d9460f121dea2ec2635e478ed02cc18b5...7f0c207d1b33b03b5bfe89c0e09d4f790c8a1d0a,3,7,0,7,2,2014-06-17 16:57:15,2014-06-17 15:50:31
7f0c207d1b33b03b5bfe89c0e09d4f790c8a1d0a...f16554f440a9640dd619ac01278565e4e3e1e2c6,1,0,0,0,0,2014-06-17 16:57:27,2014-06-17 16:56:22
f16554f440a9640dd619ac01278565e4e3e1e2c6...f355d253f81c78b595e25e84309b648c24208d73,6,147,26,173,31,2014-06-18 00:46:52,2014-06-18 00:45:38
f355d253f81c78b595e25e84309b648c24208d73...cd82069b97a73e89540bd8ed6fe42659eccb351c,1,2,3,5,3,2014-06-18 04:32:35,2014-06-18 04:32:23
cd82069b97a73e89540bd8ed6fe42659eccb351c...1122d2979a65cf3ebbccd3b5f99f29fdc675fa57,7,58,1,59,5,2014-06-18 05:12:53,2014-06-18 05:12:31
1122d2979a65cf3ebbccd3b5f99f29fdc675fa57...819d5f0c89146dee0350290c9635e13a3069ccae,10,145,6,151,13,2014-06-18 06:27:56,2014-06-18 06:27:03
819d5f0c89146dee0350290c9635e13a3069ccae...1d9f308fa19b7740cf9bd28ddada52b572e25c3a,2,2,4,6,4,2014-06-18 16:05:36,2014-06-18 14:47:13
1d9f308fa19b7740cf9bd28ddada52b572e25c3a...807aadaaad317b67965052048b3a2fb92a1aaa79,1,13,0,13,1,2014-06-18 16:38:49,2014-06-16 19:30:26
807aadaaad317b67965052048b3a2fb92a1aaa79...427f218a5ecec315a18583c1013e315d9102d6d3,1,1,2,3,2,2014-06-18 18:37:19,2014-06-18 18:35:38
427f218a5ecec315a18583c1013e315d9102d6d3...30d8b95139a1fa3070f3b112115e624ffcf8e555,2,5,2,7,3,2014-06-19 15:02:53,2014-06-19 15:02:53
30d8b95139a1fa3070f3b112115e624ffcf8e555...bfe5f72c7ee4ecec374af9a52c320c019abfc338,2,7,1,8,2,2014-06-20 06:42:27,2014-06-20 06:40:59
bfe5f72c7ee4ecec374af9a52c320c019abfc338...44b00af9bc3e6e8a561103aa5ca564995ca3c594,2,11,1,12,2,2014-06-20 06:48:57,2014-06-20 06:48:29
44b00af9bc3e6e8a561103aa5ca564995ca3c594...90058942338528a9e6b0995c8cd0f357ca0ed900,2,8,4,12,4,2014-06-20 11:55:12,2014-06-20 11:52:36
90058942338528a9e6b0995c8cd0f357ca0ed900...0b871ec22a3397063a0150d26efc0d1e1a293108,2,3,1,4,2,2014-06-20 12:16:53,2014-06-20 01:46:18
0b871ec22a3397063a0150d26efc0d1e1a293108...d9a83d597ee5aa510cf1aaa086e2fc3f1d7ee4c6,3,37,16,53,8,2014-06-20 13:10:43,2014-06-19 23:50:01
d9a83d597ee5aa510cf1aaa086e2fc3f1d7ee4c6...6e5a7367524d3e3abd3d0f60f2e8a41796908101,3,34,2,36,5,2014-06-20 16:49:56,2014-05-19 16:19:35
6e5a7367524d3e3abd3d0f60f2e8a41796908101...33403790e6beb93f653a38189ad0e216678d3f3c,1,1,0,1,1,2014-06-20 17:36:36,2014-06-20 14:23:37
33403790e6beb93f653a38189ad0e216678d3f3c...db9cb83d2fec781f6479f19b63d50b44a35ae632,1,1,11,12,2,2014-06-20 20:51:02,2014-06-20 20:50:59
db9cb83d2fec781f6479f19b63d50b44a35ae632...d107c7bd7db183d85bb3b22e0019b3be8af262d2,1,3,0,3,1,2014-06-20 22:47:54,2014-06-20 22:47:14
d107c7bd7db183d85bb3b22e0019b3be8af262d2...0cabf3aefb9d8d261841af089e872b6e08d9e29d,1,1,1,2,1,2014-06-21 09:23:30,2014-06-21 09:17:10
0cabf3aefb9d8d261841af089e872b6e08d9e29d...aa0886e7ae1f372488210e4e51ee6901af8ec643,2,58,5,63,4,2014-06-22 18:24:46,2014-06-22 18:23:45
aa0886e7ae1f372488210e4e51ee6901af8ec643...f577b2db3cec683ad0c3720eae7419c8d19c72c2,1,1,1,2,1,2014-06-22 20:01:09,2014-06-22 20:00:49
f577b2db3cec683ad0c3720eae7419c8d19c72c2...72d1c4a6ddb0742954e47f771e5de6f88c55a483,1,3,3,6,2,2014-06-22 20:03:44,2014-06-22 20:03:25
72d1c4a6ddb0742954e47f771e5de6f88c55a483...29582ad4a3ef5888ef86a45167ed8e7414c1347e,3,25,4,29,6,2014-06-23 01:30:29,2014-06-23 01:29:27
29582ad4a3ef5888ef86a45167ed8e7414c1347e...f50a17785cdb67bc9d1b146d01c731cb6bfc48cf,5,20,7,27,7,2014-06-23 07:37:38,2014-06-21 13:00:35
f50a17785cdb67bc9d1b146d01c731cb6bfc48cf...a90f0e605e9a7c1b30ccdca222ee2a0e7a78043b,1,2,0,2,1,2014-06-23 11:29:10,2014-06-23 11:25:50
a90f0e605e9a7c1b30ccdca222ee2a0e7a78043b...6015083e9d156e30c8cd5e200317f4c0f10f4abf,1,2,1,3,2,2014-06-23 12:17:32,2014-06-23 12:05:57
6015083e9d156e30c8cd5e200317f4c0f10f4abf...3619518c9bb8483ed911e987554ee5ae599f78d3,4,6,4,10,6,2014-06-23 12:57:24,2014-06-23 12:51:53
3619518c9bb8483ed911e987554ee5ae599f78d3...d38e3bfe5abd79866909ebb469920c5ed14e03f8,1,1,2,3,1,2014-06-23 13:11:10,2014-06-23 13:10:44
d38e3bfe5abd79866909ebb469920c5ed14e03f8...21c959138401bd9f57fd789409c80add01c4b075,1,7,0,7,2,2014-06-23 14:00:54,2014-06-23 12:45:06
21c959138401bd9f57fd789409c80add01c4b075...68b89f4d13b69771b232c1fcb0fb598000b6eb98,1,1,1,2,1,2014-06-23 17:23:09,2014-06-22 02:37:39
68b89f4d13b69771b232c1fcb0fb598000b6eb98...0dd737a719cfbd3bc11ff6f2b90161883fcebea0,3,19,17,36,9,2014-06-24 03:25:52,2014-06-24 03:25:09
0dd737a719cfbd3bc11ff6f2b90161883fcebea0...e4c9ccdbb5295c952a0ca12f988ae1b2164b1623,2,11,1,12,4,2014-06-24 03:39:57,2014-06-24 03:39:17
e4c9ccdbb5295c952a0ca12f988ae1b2164b1623...48a2e027bf5eeca75b7694ea0b3c271dc46ae094,2,18,1,19,3,2014-06-24 03:48:59,2014-06-24 03:48:33
48a2e027bf5eeca75b7694ea0b3c271dc46ae094...198ce3073c763ab17cb5e8d012d64d8ea756282d,1,35,0,35,1,2014-06-24 07:03:06,2014-06-23 07:28:42
198ce3073c763ab17cb5e8d012d64d8ea756282d...088b30f49b0f5e14fc6876eb424af340d5479dac,1,2,11,13,2,2014-06-24 10:43:40,2014-06-24 10:43:10
088b30f49b0f5e14fc6876eb424af340d5479dac...60375eda324d708870dc2ba18b4ac4d6114a68f6,4,512,224,736,65,2014-06-24 18:58:53,2014-06-08 18:30:52
60375eda324d708870dc2ba18b4ac4d6114a68f6...ea64ef7ed702ebaf68877c73ba0d8bb832d16415,1,1,1,2,1,2014-06-24 20:09:04,2014-06-24 18:16:53
ea64ef7ed702ebaf68877c73ba0d8bb832d16415...e8e16abe6a797789427a79cd66175ae70f392a08,2,38,18,56,10,2014-06-25 01:42:18,2014-06-11 20:41:25
e8e16abe6a797789427a79cd66175ae70f392a08...8dcc7810f07e2ce76ebee50c70a5c16f1bc9edec,2,7,2,9,3,2014-06-25 08:58:23,2014-06-12 16:58:50
8dcc7810f07e2ce76ebee50c70a5c16f1bc9edec...f1428dc796817a241d49319122663129d78ca853,3,64,27,91,18,2014-06-25 14:04:46,2014-06-25 12:53:09
f1428dc796817a241d49319122663129d78ca853...54a6ab207762bf581bf74e7e3d6b9e0520864baa,1,1,1,2,1,2014-06-25 16:32:14,2014-06-25 15:15:20
54a6ab207762bf581bf74e7e3d6b9e0520864baa...82f6500275a3ad6a07de866584cdb3986abf0f65,1,3,2,5,1,2014-06-26 11:24:32,2014-06-26 09:33:09
82f6500275a3ad6a07de866584cdb3986abf0f65...2ed41449bf5b1fcdb67cdd7d0a8d3aaf5261e5f1,1,3,3,6,3,2014-06-26 11:31:57,2014-06-25 22:43:48
2ed41449bf5b1fcdb67cdd7d0a8d3aaf5261e5f1...31c56f1ee0274ce0e289c056c566a82ff346c8f1,1,91,90,181,43,2014-06-26 17:59:04,2014-06-25 16:23:04
31c56f1ee0274ce0e289c056c566a82ff346c8f1...cbcb7c010bdc015c79b4b8a0ba2955abb23aee82,1,30,4,34,9,2014-06-26 20:49:09,2014-06-21 09:40:36
cbcb7c010bdc015c79b4b8a0ba2955abb23aee82...78bff08341cfd5b729697c13a7478e83726782d1,1,1,1,2,1,2014-06-27 01:21:15,2014-06-27 01:21:09
78bff08341cfd5b729697c13a7478e83726782d1...8e48ca47e956ad2ec7eb19fca6eae3a58c0bf6c8,1,2,0,2,1,2014-06-27 13:51:55,2014-06-27 13:50:29
8e48ca47e956ad2ec7eb19fca6eae3a58c0bf6c8...54fdf5901ba205daee04a4e4e40a4863e1d2af4c,2,18,2,20,18,2014-06-27 14:36:05,2014-06-27 14:34:48
54fdf5901ba205daee04a4e4e40a4863e1d2af4c...9f3c691259145894075094f98702255bc2d2d864,1,2,2,4,2,2014-06-30 11:12:52,2014-06-29 21:56:21
9f3c691259145894075094f98702255bc2d2d864...43d7566cc90a01ddcfd4fa3b904ce93a6edd9291,1,2,2,4,2,2014-06-30 11:41:47,2014-06-30 11:39:35
43d7566cc90a01ddcfd4fa3b904ce93a6edd9291...24ba5f7fb26d8c668df8c16f5474d6c076e3e980,1,20,16,36,11,2014-06-30 18:32:50,2014-06-26 10:56:45
24ba5f7fb26d8c668df8c16f5474d6c076e3e980...92609560841b2dd3df2d4dfa3e8ac2fe732da885,1,0,8,8,1,2014-06-30 19:23:52,2014-06-30 18:35:09
92609560841b2dd3df2d4dfa3e8ac2fe732da885...af9949f4efe5c2a6fd51b925fe96e4a6644e2799,2,19,11,30,8,2014-06-30 20:32:03,2014-06-30 20:30:57
af9949f4efe5c2a6fd51b925fe96e4a6644e2799...c45fcd278b48b066ef03765c82005ba96183db09,1,12,4,16,3,2014-06-30 21:52:23,2014-06-30 21:48:14
c45fcd278b48b066ef03765c82005ba96183db09...8c7d2edd45cc1f1a9c5146e3be9716fbcfcbc826,1,2,2,4,1,2014-06-30 22:49:07,2014-06-30 22:47:53
8c7d2edd45cc1f1a9c5146e3be9716fbcfcbc826...2b8f22a578321affe9aca9b6ea84fc26db3e222a,1,3,4,7,1,2014-07-01 19:56:28,2014-07-01 19:54:28
2b8f22a578321affe9aca9b6ea84fc26db3e222a...accdc448bc5c203503cac7cce92e17c6910038ed,1,7,0,7,1,2014-07-01 21:34:13,2014-07-01 21:32:14
accdc448bc5c203503cac7cce92e17c6910038ed...bbba492fbb7351c68d7c94a390a77db342ff571d,1,8,0,8,1,2014-07-02 03:55:27,2014-07-02 03:54:46
bbba492fbb7351c68d7c94a390a77db342ff571d...e88723acf8eb0c8f13a0285baea477ec8a40a3bd,1,2,5,7,3,2014-07-02 11:54:59,2014-07-01 18:20:54
e88723acf8eb0c8f13a0285baea477ec8a40a3bd...a56773245b8926ddb73d957cf725aa83c5e5a9ea,1,3,2,5,1,2014-07-02 14:14:11,2014-07-02 14:12:43
a56773245b8926ddb73d957cf725aa83c5e5a9ea...f5740af868329a743d3b34022b5e1450850cdb2f,3,15,1,16,3,2014-07-02 16:44:10,2014-07-01 20:42:25
f5740af868329a743d3b34022b5e1450850cdb2f...0b2a36ecf787620ff96c6a342c11a9c39bcfc41b,2,17,0,17,2,2014-07-02 17:22:14,2014-07-02 17:16:31
0b2a36ecf787620ff96c6a342c11a9c39bcfc41b...f99267e5e6779d192959569155846f8b0ca5eb07,1,5,0,5,1,2014-07-03 13:38:52,2014-07-03 13:20:03
f99267e5e6779d192959569155846f8b0ca5eb07...b68c7a5abbb737c54dff91e56e0e56e67cd3f718,3,178,15,193,7,2014-07-04 10:19:12,2014-07-01 13:48:00
b68c7a5abbb737c54dff91e56e0e56e67cd3f718...83a185a3f7d07af295880ed02efba4af4c86a204,2,19,2,21,3,2014-07-05 11:35:53,2014-07-05 09:40:08
83a185a3f7d07af295880ed02efba4af4c86a204...1f889800d6c3c2989c0f8c12c631967e8e3ce428,2,29,2,31,6,2014-07-05 23:33:34,2014-07-05 23:33:03
1f889800d6c3c2989c0f8c12c631967e8e3ce428...2f0cc4f5fbdddbecbd9c2093baf851fd92dbe205,3,61,19,80,7,2014-07-05 23:38:34,2014-07-04 16:48:13
2f0cc4f5fbdddbecbd9c2093baf851fd92dbe205...7f84f7fba7a2c967d7153644fbfaf62e4ed6dc5e,1,2,2,4,2,2014-07-06 00:19:17,2014-07-05 18:19:36
7f84f7fba7a2c967d7153644fbfaf62e4ed6dc5e...4b30bddb7a01dca77d0d6c2958b47add1f072c94,1,2,2,4,1,2014-07-06 00:20:55,2014-07-06 00:20:19
4b30bddb7a01dca77d0d6c2958b47add1f072c94...50ebddad6acf41f3093b7ff7c1332fd4cb617de2,1,5,5,10,1,2014-07-06 00:24:19,2014-07-06 00:24:00
50ebddad6acf41f3093b7ff7c1332fd4cb617de2...ef392387c24fa5bd9bf3fd3c43781cefcafbee3f,5,9,9,18,6,2014-07-06 00:26:56,2014-07-05 18:28:30
ef392387c24fa5bd9bf3fd3c43781cefcafbee3f...8fbd9b0b1cc7b1afa7b77a421423ba4ec2a80416,1,23,1,24,1,2014-07-06 07:30:35,2014-07-06 07:30:05
8fbd9b0b1cc7b1afa7b77a421423ba4ec2a80416...a1ddfe440151c81898b94df4d5ea99696398c3f7,2,13,0,13,2,2014-07-06 08:00:03,2014-07-06 06:57:23
a1ddfe440151c81898b94df4d5ea99696398c3f7...1bb8ccdb9e70bee35759f2ada4d661481852ab95,3,56,12,68,11,2014-07-06 19:45:09,2014-07-05 12:43:12
1bb8ccdb9e70bee35759f2ada4d661481852ab95...cf9e33f930be9032f68e12301e6d1f9f9d139f3c,1,3,0,3,1,2014-07-07 19:32:39,2014-07-07 19:29:01
cf9e33f930be9032f68e12301e6d1f9f9d139f3c...5acb0a913997aea83dbbf272bcc97f67a25a32c4,1,9,9,18,8,2014-07-07 19:33:03,2014-07-06 22:31:10
5acb0a913997aea83dbbf272bcc97f67a25a32c4...c379fc4eec885101ac30e0505f967048c869e630,1,4,0,4,1,2014-07-07 22:09:15,2014-07-07 22:04:00
c379fc4eec885101ac30e0505f967048c869e630...28962c57f3f2b4543cd67d55ca635e9198f585dd,11,169,169,338,169,2014-07-07 23:10:48,2014-07-07 23:08:42
28962c57f3f2b4543cd67d55ca635e9198f585dd...0100afb01399e4605a68daec0e7b447e163e0b1d,2,3,2,5,2,2014-07-07 23:13:00,2014-07-07 23:12:39
0100afb01399e4605a68daec0e7b447e163e0b1d...1326cd28d09f4e657c6ed3af9a23ea6a356d0708,2,0,0,0,0,2014-07-07 23:22:20,2014-07-07 23:21:47
1326cd28d09f4e657c6ed3af9a23ea6a356d0708...1318254669d1b7f8b09c2558e4f187fa1ee2884c,1,1,1,2,1,2014-07-07 23:56:22,2014-07-07 23:56:22
1318254669d1b7f8b09c2558e4f187fa1ee2884c...9918b76447e601631e160d27feb4d873d7d99d8b,1,0,7,7,2,2014-07-08 12:57:41,2014-07-08 12:56:41
9918b76447e601631e160d27feb4d873d7d99d8b...2100bcef41a9f24764289b44976a08b7e5c5666f,1,21,0,21,1,2014-07-08 13:20:15,2014-07-08 09:24:08
2100bcef41a9f24764289b44976a08b7e5c5666f...4368457a27b010d13bac54a2dac57203768ffd15,1,1,1,2,1,2014-07-08 17:30:37,2014-07-08 17:29:59
4368457a27b010d13bac54a2dac57203768ffd15...e548328851ee1e0d030ad3625c5e8a5315a12ed4,8,223,153,376,15,2014-07-09 00:13:24,2014-06-11 15:09:10
e548328851ee1e0d030ad3625c5e8a5315a12ed4...9673013abe4cd64183bf55d89adfa04927e3b947,1,13,3,16,3,2014-07-09 11:32:44,2014-07-09 11:31:50
9673013abe4cd64183bf55d89adfa04927e3b947...a3d710a38f1fab5e092cef7a17826674a00e70ea,1,0,7,7,1,2014-07-09 18:12:32,2014-07-09 17:54:41
a3d710a38f1fab5e092cef7a17826674a00e70ea...aba75e73db6a0baca1b721698ca24f026bb4a745,4,75,7,82,10,2014-07-10 06:53:53,2014-07-10 06:53:16
aba75e73db6a0baca1b721698ca24f026bb4a745...23ff98888e5c183b299f29ea651c9b545ef02807,1,1,1,2,1,2014-07-10 06:58:22,2014-07-10 06:57:35
23ff98888e5c183b299f29ea651c9b545ef02807...bddea532f76dd59b54aede74fc7aac0d535b367b,2,261,117,378,40,2014-07-10 10:05:05,2014-06-23 06:33:42
bddea532f76dd59b54aede74fc7aac0d535b367b...dc7ac339a6d1e91a5121d5f3113b759db98d3674,1,1,1,2,1,2014-07-10 10:09:42,2014-07-10 10:09:08
dc7ac339a6d1e91a5121d5f3113b759db98d3674...eb7e232e7fd9468b19dfbdf51fb16e9c530969dc,1,1,1,2,1,2014-07-10 17:01:12,2014-07-10 17:00:02
eb7e232e7fd9468b19dfbdf51fb16e9c530969dc...3e13c1d9b174cb6fc1a97f6fde418150e0968bdd,2,8,0,8,2,2014-07-10 17:01:12,2014-07-10 17:00:09
3e13c1d9b174cb6fc1a97f6fde418150e0968bdd...736e289445aea5083da04ddd8734c3ff20310408,3,51,2,53,4,2014-07-10 21:36:04,2014-07-08 19:58:14
736e289445aea5083da04ddd8734c3ff20310408...563046a7de24d5e1eac1d455ec5530d0479186e0,2,19,1,20,4,2014-07-12 02:01:47,2014-07-12 01:59:21
563046a7de24d5e1eac1d455ec5530d0479186e0...aa1c615428a9bb2e175076b1fc4b6b4a3955c55d,1,0,1,1,1,2014-07-12 14:17:20,2014-07-12 14:16:53
aa1c615428a9bb2e175076b1fc4b6b4a3955c55d...dda6759e0e7f4ff4e1a856c1d907cea619a1dfda,3,48,28,76,25,2014-07-12 16:50:23,2014-07-12 13:33:21
dda6759e0e7f4ff4e1a856c1d907cea619a1dfda...be38c5bcc8b6d641d210cbcf0508605223366778,2,24,5,29,5,2014-07-12 16:50:32,2014-07-07 07:54:58
be38c5bcc8b6d641d210cbcf0508605223366778...dcb1b971c254c4c23216b8335ec40abb7d30b288,3,31,40,71,14,2014-07-14 10:18:42,2014-07-13 17:37:56
dcb1b971c254c4c23216b8335ec40abb7d30b288...1d1debeed439ce4a685859537dd5c587f72d942c,1,1,0,1,1,2014-07-14 14:54:43,2014-07-13 15:35:25
1d1debeed439ce4a685859537dd5c587f72d942c...572885729e028eae2f2b823ef87543b7c66bdb10,3,25,3,28,6,2014-07-14 16:51:24,2014-07-14 16:50:41
572885729e028eae2f2b823ef87543b7c66bdb10...4b53bfff3714d1f6f0f830d56fff296fb57b21da,1,4,0,4,1,2014-07-14 16:55:05,2014-07-14 12:02:00
4b53bfff3714d1f6f0f830d56fff296fb57b21da...6d5238f6c873f8ad652ee206b88849a50e68accc,8,131,0,131,6,2014-07-14 17:00:45,2014-06-19 19:24:59
6d5238f6c873f8ad652ee206b88849a50e68accc...f2011e21a2d803ab6328852c3af4a4bf6701b11d,2,11,6,17,6,2014-07-15 07:59:25,2014-07-14 19:40:55
f2011e21a2d803ab6328852c3af4a4bf6701b11d...fe5f29eb1db795257d4095df0e1547c17daadade,2,3,3,6,3,2014-07-15 12:51:16,2014-07-15 12:48:29
fe5f29eb1db795257d4095df0e1547c17daadade...01515ebaa45a7facc6b450f3fea77dcdbec85887,3,10,4,14,5,2014-07-15 19:21:44,2014-07-14 12:16:35
01515ebaa45a7facc6b450f3fea77dcdbec85887...d6f293ad1b5179f027e2c62ba8e79612f0076b8a,2,27,13,40,10,2014-07-16 07:43:50,2014-07-15 09:10:50
d6f293ad1b5179f027e2c62ba8e79612f0076b8a...72419ca8da8c6f472896754e9c01932900fd099d,3,41,4,45,6,2014-07-16 09:43:14,2014-07-14 16:42:14
72419ca8da8c6f472896754e9c01932900fd099d...f8a2a5604bd2d26274dad53c3f4fadb1644fb6d9,1,1,1,2,1,2014-07-16 09:50:01,2014-07-16 09:48:49
f8a2a5604bd2d26274dad53c3f4fadb1644fb6d9...15feb1d8e863349c500d88aa4934baecaa525898,2,0,0,0,0,2014-07-16 12:30:43,2014-07-16 11:50:32
15feb1d8e863349c500d88aa4934baecaa525898...3552afa25e0359d56191b1d692db59463222ad44,1,8,0,8,1,2014-07-16 14:54:38,2014-07-16 14:52:49
3552afa25e0359d56191b1d692db59463222ad44...8e34bcdfba16cb1dc3096da57d1e82d3839472a8,1,3,1,4,1,2014-07-16 16:35:01,2014-07-16 16:32:57
8e34bcdfba16cb1dc3096da57d1e82d3839472a8...de709001c45c6646ecf39689949e3011ae5be197,2,19,2,21,4,2014-07-16 16:59:37,2014-07-16 16:59:08
de709001c45c6646ecf39689949e3011ae5be197...30a4cad2bfdf080037f1bff3754b0d3ad0c5bafd,1,1,1,2,1,2014-07-16 17:23:48,2014-07-16 16:08:24
30a4cad2bfdf080037f1bff3754b0d3ad0c5bafd...a8c4e0e93b7888fcf02389e7e3555acb162f089b,1,8,0,8,1,2014-07-16 17:35:41,2014-07-16 17:34:53
a8c4e0e93b7888fcf02389e7e3555acb162f089b...71ff5708b4f9b5a9e080531a1e307cad87bccfc5,1,114,114,228,2,2014-07-16 17:55:38,2014-07-11 18:27:14
71ff5708b4f9b5a9e080531a1e307cad87bccfc5...63ae8de8fcc2fff581608ff0587f6497b38ba909,1,2,1,3,1,2014-07-16 18:26:04,2014-07-15 16:43:52
63ae8de8fcc2fff581608ff0587f6497b38ba909...2fb1939a9efae24560d41fbb7f6a280a1d2e8d06,1,10,0,10,1,2014-07-21 09:04:53,2014-07-21 09:03:51
2fb1939a9efae24560d41fbb7f6a280a1d2e8d06...ff8d715a0a62eb4d70e6c2bf38fa1113ed2899e5,2,8,1,9,2,2014-07-21 09:09:58,2014-07-21 09:09:31
ff8d715a0a62eb4d70e6c2bf38fa1113ed2899e5...f57e84392e9aea19f8f9dc31f1e5351de356ce34,2,22,0,22,2,2014-07-21 09:14:34,2014-07-21 09:14:00
f57e84392e9aea19f8f9dc31f1e5351de356ce34...88135a8cf7d587b88e47f1223cf01c7698b52b74,3,41,14,55,12,2014-07-21 09:50:58,2014-07-21 09:50:21
88135a8cf7d587b88e47f1223cf01c7698b52b74...e2220c1c086675e5c3a87d2f09cb71e6562ad733,4,46,5,51,13,2014-07-21 10:37:10,2014-07-21 10:36:34
e2220c1c086675e5c3a87d2f09cb71e6562ad733...6e41ae1a4e924908fc07ef6b4ce28feb31c994fd,2,4,3,7,3,2014-07-21 17:07:48,2014-07-21 17:02:25
6e41ae1a4e924908fc07ef6b4ce28feb31c994fd...59fec1ca9b3c426466f0c613a5ecf2badb992460,6,10,10,20,8,2014-07-21 19:54:22,2014-07-21 17:55:37
59fec1ca9b3c426466f0c613a5ecf2badb992460...2c6ef625ad73c38769f086733356e37a938b69c3,1,1,0,1,1,2014-07-22 08:47:27,2014-07-21 23:05:14
2c6ef625ad73c38769f086733356e37a938b69c3...0e35ae37bbff7f25d17c678867127055b9874d8a,1,1,1,2,1,2014-07-22 17:27:51,2014-07-22 05:47:57
0e35ae37bbff7f25d17c678867127055b9874d8a...04030acb85c8fecae7ae3773c9595bb14bdb4547,1,3,0,3,1,2014-07-22 18:00:47,2014-07-21 22:37:45
04030acb85c8fecae7ae3773c9595bb14bdb4547...86655111c92131df2f32db16e89b7d95d4992646,1,4,1,5,1,2014-07-23 10:15:44,2014-07-16 08:50:35
86655111c92131df2f32db16e89b7d95d4992646...ddb5674945725ec8f6e6336f73d3d56e331f34ae,5,63,18,81,15,2014-07-23 10:16:11,2014-07-16 09:06:33
ddb5674945725ec8f6e6336f73d3d56e331f34ae...9638daec5cb584dc3b62b7373e0f7cd2fc808b7e,3,40,1,41,6,2014-07-23 12:49:55,2014-07-23 03:01:55
9638daec5cb584dc3b62b7373e0f7cd2fc808b7e...663af270b58f350bcbd9df5cd04ffe69e8ac37c8,1,10,0,10,1,2014-07-23 19:26:42,2014-07-23 19:23:36
663af270b58f350bcbd9df5cd04ffe69e8ac37c8...7cbb4f79d1e3f1690fb31b118f47590d9470b59b,1,7,10,17,5,2014-07-24 12:47:24,2014-07-24 12:46:29
7cbb4f79d1e3f1690fb31b118f47590d9470b59b...c86b9d198598b735ba203a56b449cd80516abfef,1,7,1,8,2,2014-07-24 13:29:45,2014-07-24 13:24:52
c86b9d198598b735ba203a56b449cd80516abfef...b159b55997989b42dd9b82af578ca7ab01a2192d,1,4,3,7,3,2014-07-24 13:39:40,2014-07-23 21:31:31
b159b55997989b42dd9b82af578ca7ab01a2192d...0f8e8c86ddcb09c4fb1941d4e1076b0716352828,1,5,0,5,1,2014-07-24 15:40:49,2014-07-24 15:27:26
0f8e8c86ddcb09c4fb1941d4e1076b0716352828...5822ca6c108e4cde134e55632dbaf79aeead1777,1,2,3,5,1,2014-07-24 18:10:27,2014-07-24 17:57:00
5822ca6c108e4cde134e55632dbaf79aeead1777...b918bc921ca104ac0ab877e9fa0f6b49a5242679,2,20,10,30,8,2014-07-24 18:30:16,2014-07-24 17:36:15
b918bc921ca104ac0ab877e9fa0f6b49a5242679...5ca82ff71baa9d749c98ef68e8f8814cf7afcf5d,4,11,5,16,4,2014-07-24 22:13:12,2014-03-21 17:48:57
5ca82ff71baa9d749c98ef68e8f8814cf7afcf5d...2a97db33a79c0be179b5bc35860400287f1ae26a,2,9,5,14,5,2014-07-24 22:48:05,2014-03-22 10:02:00
2a97db33a79c0be179b5bc35860400287f1ae26a...0ac986fd8cb2561a22aa3291672723b50397e5ac,1,5,4,9,3,2014-07-24 23:18:06,2014-03-22 13:36:01
0ac986fd8cb2561a22aa3291672723b50397e5ac...ce95ab8f025cc9f35990f0c2d9a290eec1ece753,2,8,1,9,2,2014-07-25 10:16:55,2014-07-25 08:04:58
ce95ab8f025cc9f35990f0c2d9a290eec1ece753...2127b6fe9918dc51b6d170fef6eed7f42485436d,1,9,10,19,2,2014-07-25 10:22:36,2014-07-25 00:24:52
2127b6fe9918dc51b6d170fef6eed7f42485436d...d8961a5ad05b103b7b37e8e7a992f5d2f761fc2c,1,8,8,16,1,2014-07-25 10:26:41,2014-07-25 08:42:06
d8961a5ad05b103b7b37e8e7a992f5d2f761fc2c...6e7e5bacd51d1ab4411c58eea04a137639a0a354,9,9,65,74,10,2014-07-25 15:54:54,2014-07-14 19:09:33
6e7e5bacd51d1ab4411c58eea04a137639a0a354...2bacc9f3b70e45b172675452b7dd32900fbb8a8b,3,14,0,14,5,2014-07-25 16:11:01,2014-07-25 16:09:15
2bacc9f3b70e45b172675452b7dd32900fbb8a8b...919d10e619872b56a4d6bc91ccd031b90775a437,2,25,2,27,6,2014-07-25 16:35:53,2014-07-25 16:35:25
919d10e619872b56a4d6bc91ccd031b90775a437...e01c565b4777e1546caede74f3f7d5650e30e3ab,1,1,1,2,1,2014-07-25 16:44:15,2014-07-25 16:43:54
e01c565b4777e1546caede74f3f7d5650e30e3ab...3268711417b3c67f6eb08bec3f39f2d51186e11b,1,6,1,7,1,2014-07-25 16:50:17,2014-07-25 16:49:51
3268711417b3c67f6eb08bec3f39f2d51186e11b...4f8a5bd8d0f14280b25e4389b881f9f719159c38,2,14,0,14,5,2014-07-25 17:25:16,2014-07-25 13:32:14
4f8a5bd8d0f14280b25e4389b881f9f719159c38...d1c08d4758998318eb1a881a3963b63bc89435b8,1,1,1,2,1,2014-07-25 19:17:18,2014-07-25 19:11:34
d1c08d4758998318eb1a881a3963b63bc89435b8...08e8e2137db9381d473f6c5b6b1d4240c47b7414,6,8,8,16,8,2014-07-26 09:21:16,2014-07-26 01:34:13
08e8e2137db9381d473f6c5b6b1d4240c47b7414...bc3d401b9f95ebc5bd25488708b5a82074c53ebb,2,6,2,8,3,2014-07-26 11:56:58,2014-07-26 10:06:19
bc3d401b9f95ebc5bd25488708b5a82074c53ebb...0d8d4fe9b4968364e40eb05eae5c7d30f9514516,1,15,0,15,1,2014-07-26 12:48:25,2014-07-26 10:01:44
0d8d4fe9b4968364e40eb05eae5c7d30f9514516...df678b750026db2f9bc0108dddead4c35a9cfba3,2,31,2,33,4,2014-07-26 12:53:31,2014-07-26 10:06:48
df678b750026db2f9bc0108dddead4c35a9cfba3...ddf2b7d96b1048b1210d2315d92275496352ccaf,1,8,0,8,1,2014-07-26 13:40:24,2014-07-26 11:36:40
ddf2b7d96b1048b1210d2315d92275496352ccaf...1ef544f91f0d4be3f44ae7fd0498530e57a9b160,1,5,0,5,1,2014-07-26 14:27:46,2014-07-26 14:00:48
1ef544f91f0d4be3f44ae7fd0498530e57a9b160...3a2badcbb73c2aed6451d2451da1c4fc8d934ab2,2,11,1,12,3,2014-07-26 16:04:01,2014-07-21 17:38:34
3a2badcbb73c2aed6451d2451da1c4fc8d934ab2...7e708a2536d4828d06f7aa4002fbd5cfc20bef16,2,33,1,34,6,2014-07-26 16:22:31,2014-07-26 16:21:53
e904d421d06bb53fbc9f55bd129b0b213d9908c5...dfc95d240d95ff03fee59c3acf80c211da210d90,1,1,1,2,1,2013-12-15 12:11:02,2013-12-15 12:10:46
dfc95d240d95ff03fee59c3acf80c211da210d90...3beffea4b0aa5e28b4e3a6b34fff4c7bf0b6fab3,2,4,107,111,6,2013-12-15 13:43:52,2013-12-15 13:42:58
e904d421d06bb53fbc9f55bd129b0b213d9908c5...f27ed47b60a6a48438a64b9599015ea2cd03b57e,1,1,1,2,1,2013-12-15 09:00:13,2013-12-15 09:00:13
a08f906556c14357852bbc9c4c7d10c6558dafcf...ea4da8e63c314b4f7cbcb4dd06eef466c1e872ed,10,10,10,20,10,2014-03-02 16:05:57,2014-03-02 16:05:57
ea4da8e63c314b4f7cbcb4dd06eef466c1e872ed...90577c0eb4f46352322d5911e1d7ae69dcf149e7,1,0,25,25,1,2014-03-02 21:19:28,2014-03-02 21:19:28
90577c0eb4f46352322d5911e1d7ae69dcf149e7...3c5fc708f1a8f60c05182869f6f3ec13697bbcf2,4,203,182,385,140,2014-03-03 05:27:17,2014-03-03 05:27:17
3c5fc708f1a8f60c05182869f6f3ec13697bbcf2...84207b6134dd4944f7549040a3825e90bc6fdc7e,2,14,17,31,9,2014-03-03 05:39:58,2014-03-03 05:39:58
84207b6134dd4944f7549040a3825e90bc6fdc7e...57e08aa23247141db58c244f01afda52110b86b7,2,68,157,225,25,2014-03-03 06:19:06,2014-03-03 06:19:06
57e08aa23247141db58c244f01afda52110b86b7...55ba92a9c9fc22ce5482c1a7d18ffb0003be2b80,2,4,7,11,4,2014-03-03 06:27:22,2014-03-03 06:27:22
55ba92a9c9fc22ce5482c1a7d18ffb0003be2b80...f7587b20da822912f65ba07cd3a5f02076f97338,2,4,6,10,4,2014-03-03 06:31:55,2014-03-03 06:31:55
f7587b20da822912f65ba07cd3a5f02076f97338...bc4dc6e99c532b844a26c8a9021a4d04703e28cd,4,117,125,242,81,2014-03-03 07:35:42,2014-03-03 07:35:42
bc4dc6e99c532b844a26c8a9021a4d04703e28cd...82ac3894867b111f83252e808b3ed47f38ef5378,9,373,394,767,230,2014-03-03 10:18:39,2014-03-03 10:18:39
82ac3894867b111f83252e808b3ed47f38ef5378...5679fce87c1eb2a48f0ea2ecefb08e2285828af0,4,435,195,630,9,2014-03-03 10:56:11,2014-03-03 10:56:11
5679fce87c1eb2a48f0ea2ecefb08e2285828af0...21d8175242273a2371bd9374994bacdd118309d3,2,3,7,10,2,2014-03-03 11:16:19,2014-03-03 11:16:19
21d8175242273a2371bd9374994bacdd118309d3...c41335fa27a23171ec8c319eaa0a713e575c1036,2,11,1,12,3,2014-03-03 11:20:48,2014-03-03 11:20:48
c41335fa27a23171ec8c319eaa0a713e575c1036...6b63742ce5a63484890f147830d3fa9b2d0342f9,3,6,6,12,5,2014-03-03 11:29:50,2014-03-03 11:29:50
6b63742ce5a63484890f147830d3fa9b2d0342f9...6acaa5238668593d6d854b28dbfa65e95796585c,5,53,10,63,6,2014-03-03 12:28:24,2014-02-26 22:34:19
6acaa5238668593d6d854b28dbfa65e95796585c...0d912258921a442c48d5787228db2db5af7e8fa5,121,208,208,416,204,2014-03-03 12:38:09,2014-03-02 14:25:53
0d912258921a442c48d5787228db2db5af7e8fa5...2b6436e2d5d9fdc1961b2d5b5022122afcb0703a,13,70,64,134,33,2014-03-03 13:37:17,2014-03-02 15:00:30
2b6436e2d5d9fdc1961b2d5b5022122afcb0703a...eae4f16177f7362509e3579836424f177c8502bf,1,3,6,9,3,2014-03-03 13:49:18,2014-03-03 13:49:18
eae4f16177f7362509e3579836424f177c8502bf...0dffaf9c25b9b69f690fc2783c2d528997f9ece8,1,20,6,26,7,2014-03-03 14:45:48,2014-03-03 14:38:07
0dffaf9c25b9b69f690fc2783c2d528997f9ece8...5a4f1298cf00fe4e2e35d0a3c02281b4c6afe07c,1,6,1,7,1,2014-03-03 15:40:06,2014-03-03 15:40:06
5a4f1298cf00fe4e2e35d0a3c02281b4c6afe07c...c8d61fa109b5a4dee1eb6f7ae62c1e6ac00c2cab,1,11,3,14,3,2014-03-03 16:16:41,2014-02-23 12:55:25
c8d61fa109b5a4dee1eb6f7ae62c1e6ac00c2cab...7bbb6958dcb6a450f926e5bb49b07391f801aef1,5,112,23,135,26,2014-03-03 19:35:19,2014-01-16 18:24:39
7bbb6958dcb6a450f926e5bb49b07391f801aef1...53c576452e2e8feef857cd67a5c17f9159d95eb6,5,50,2,52,6,2014-03-03 21:57:06,2014-03-02 20:46:51
53c576452e2e8feef857cd67a5c17f9159d95eb6...20da67d325190ec131ae5da2ae415335ecbeae24,1,1,4,5,1,2014-03-04 01:50:09,2014-03-04 01:50:09
ff874f363ce6556577f03909b15c71c051d5b617...3cdb0baa453e2cc09c0a5c5c04cce66a6dc4e789,1,3,1,4,2,2014-03-25 23:42:19,2014-03-25 23:42:19
7e708a2536d4828d06f7aa4002fbd5cfc20bef16...999758fc7a2d6fcb01eb40de937d4420f884788d,2,8,0,8,2,2014-07-26 16:48:36,2014-07-26 16:48:36
a1bc3683ff51a24e17cb514dc6ee90b7bef66301...cdd6617da679e19059907979b03c4ef7b15691e6,5,29,4,33,9,2013-12-15 20:49:52,2013-12-14 23:15:35
cdd6617da679e19059907979b03c4ef7b15691e6...1689744aee1f13b2f4e270ce63cea143eb6d868e,1,3,3,6,1,2013-12-15 22:02:20,2013-12-15 22:02:20
1689744aee1f13b2f4e270ce63cea143eb6d868e...db41778e8ccbbba19954c3b47853b8520ab263a1,1,1,1,2,1,2013-12-16 14:22:54,2013-12-13 17:29:22
db41778e8ccbbba19954c3b47853b8520ab263a1...3eb58f0dd11ae10fa5741afbc43e229332a4373a,1,0,1,1,1,2013-12-16 14:30:51,2013-12-16 14:30:51
3eb58f0dd11ae10fa5741afbc43e229332a4373a...e2f142030b81a37e1c3187f5d336dcb6014fd1c0,2,21,3,24,5,2013-12-16 15:58:08,2013-12-16 15:45:18
20da67d325190ec131ae5da2ae415335ecbeae24...99291f5db0ed2779dc851e83179449b18471a9ad,1,50,3,53,6,2014-03-04 20:17:52,2014-01-29 06:41:04
99291f5db0ed2779dc851e83179449b18471a9ad...6436f1fad9ce51f18735106ac75aeea3d6d1f310,2,34,3,37,7,2014-03-04 20:25:14,2014-03-04 20:17:07
20da67d325190ec131ae5da2ae415335ecbeae24...97a597132412b81298daab501498061e41c66cbe,1,2,2,4,2,2014-03-04 19:32:54,2014-03-04 19:32:21
97a597132412b81298daab501498061e41c66cbe...24f0113fb9bc1a47094a12eff2ae78e8f2bcb0fb,1,6,6,12,6,2014-03-04 20:06:30,2014-03-04 20:06:30
24f0113fb9bc1a47094a12eff2ae78e8f2bcb0fb...6fe22b30e007b7ac49eae48a53e7ba0a4ee79a4b,5,101,8,109,9,2014-03-04 20:16:35,2014-02-23 22:58:26
ab4c96cff08b7a196807c0faaeca1b8b7ad1e8ea...45ef4baf5cb018acba16c269e3d470ee1de146e0,1,2,2,4,1,2014-03-26 13:57:00,2014-03-26 13:57:00
45ef4baf5cb018acba16c269e3d470ee1de146e0...5233b366935dcc81e47546921ab4eb5007c83719,1,6,24,30,4,2014-03-26 14:39:52,2014-03-26 14:39:52
5233b366935dcc81e47546921ab4eb5007c83719...b9e50e47742f67dcf3c37aad989b350e8255154e,1,15,8,23,6,2014-03-26 16:57:57,2014-03-26 01:40:56
b9e50e47742f67dcf3c37aad989b350e8255154e...d320863878f097b5cbf33ace12e3adb5e02f27e0,3,19,25,44,11,2014-03-26 17:10:58,2014-03-26 17:10:58
d320863878f097b5cbf33ace12e3adb5e02f27e0...bf2b0affe42c9c7334188129e39fcdcbca126351,1,1,1,2,1,2014-03-26 18:51:17,2014-03-26 18:51:17
bf2b0affe42c9c7334188129e39fcdcbca126351...b077ba7ac1af3fb6557d9d32dc08cf6da07cc73d,4,6,4,10,4,2014-03-27 02:44:52,2014-03-27 02:43:31
b077ba7ac1af3fb6557d9d32dc08cf6da07cc73d...c170c3761bf230e5891940b0fd9b2a9af20a41ae,1,2,3,5,2,2014-03-27 10:11:39,2014-03-26 23:06:09
c170c3761bf230e5891940b0fd9b2a9af20a41ae...c19bbefca2b51f8d9052424044ab5beb8dafdf3d,1,1,1,2,1,2014-03-27 10:59:54,2014-03-27 10:59:54
c19bbefca2b51f8d9052424044ab5beb8dafdf3d...a779757706b19ef244dc1ede2e1e992735461623,2,14,5,19,2,2014-03-27 11:01:47,2014-03-25 21:06:54
a779757706b19ef244dc1ede2e1e992735461623...306deab2c70a6d93c6188924e1cfa8c2d50ccd48,3,7,8,15,5,2014-03-27 12:01:33,2014-03-26 14:55:59
306deab2c70a6d93c6188924e1cfa8c2d50ccd48...dadf2ee75f88653b94b9c05a3118fd1590853e77,1,6,3,9,3,2014-03-27 13:17:49,2014-03-27 12:08:42
dadf2ee75f88653b94b9c05a3118fd1590853e77...e2ac0203d9fceccf0e76b547a58c35793c620b71,1,7,7,14,5,2014-03-27 18:19:31,2014-03-27 18:19:31
e2ac0203d9fceccf0e76b547a58c35793c620b71...12e9adcd71efa36234b697e47fbf59c8117e29a1,1,2,2,4,2,2014-03-27 21:48:12,2014-03-27 21:48:12
12e9adcd71efa36234b697e47fbf59c8117e29a1...5e4e0b6fe97c6c9de8355f8738403691637a0b07,11,33,12,45,17,2014-03-28 22:55:06,2014-03-27 20:24:19
5e4e0b6fe97c6c9de8355f8738403691637a0b07...21f208e66e6472b8db8cdfd7cd1102d71bb15733,2,10,1,11,2,2014-03-29 05:58:25,2014-03-29 05:58:25
21f208e66e6472b8db8cdfd7cd1102d71bb15733...0f1f12c5641acfbbf1fe58b0e6dd6f755fbbe61e,3,15,16,31,6,2014-03-29 10:08:52,2014-03-27 20:17:10
0f1f12c5641acfbbf1fe58b0e6dd6f755fbbe61e...e62dea9ad5a4695cbcdec3c7e51b5914d0b2485d,2,12,11,23,6,2014-03-29 10:08:52,2014-03-27 21:26:20
e62dea9ad5a4695cbcdec3c7e51b5914d0b2485d...c6ffa4cab6d9dd0b54386bc6cafe6e8658b3fb2a,1,5,0,5,3,2014-03-29 10:08:52,2014-03-27 21:30:50
c6ffa4cab6d9dd0b54386bc6cafe6e8658b3fb2a...c5d1df70a415ecbb0e8f00fe76122cb2ed100d53,8,33,81,114,24,2014-03-29 10:08:52,2014-03-27 21:53:04
c5d1df70a415ecbb0e8f00fe76122cb2ed100d53...41903d025a6ea79ccc4cc38a398b1286ef6e1319,5,8,67,75,10,2014-03-29 10:08:52,2014-03-27 22:02:28
41903d025a6ea79ccc4cc38a398b1286ef6e1319...2cc8840397bff8e5f99a7a2486dd295c42769e65,3,2,3,5,3,2014-03-29 12:54:30,2014-03-29 12:54:30
2cc8840397bff8e5f99a7a2486dd295c42769e65...ed4c2e1c0d9e43c09767b02fd8b4bd74a5dfe512,6,16,10,26,13,2014-03-29 12:54:56,2014-03-24 12:49:05
ed4c2e1c0d9e43c09767b02fd8b4bd74a5dfe512...f30e6590f40c8b008cbe5833579fca4fd93ecc61,1,11,13,24,5,2014-03-29 14:21:49,2014-03-29 14:17:19
f30e6590f40c8b008cbe5833579fca4fd93ecc61...88f1e3d93d8f48a302ff75b1936e471c4a52fff9,1,74,0,74,1,2014-03-29 14:37:40,2014-03-25 15:24:47
88f1e3d93d8f48a302ff75b1936e471c4a52fff9...e819a3cd622fe9404b1f5ea7891906c4cdabbb12,1,24,17,41,8,2014-03-29 18:25:57,2014-03-29 18:24:14
e819a3cd622fe9404b1f5ea7891906c4cdabbb12...f356b6ecc3fe15634d504690c1793460e5fe9bee,1,5,1,6,2,2014-03-29 18:47:15,2014-03-29 18:44:11
37f8a83ad050a1040712876002edcbfc0b057603...30ccb36cb9c1bc9bd30edb2b67f26ef2a1e4fb53,1,3,3,6,1,2014-07-27 00:47:06,2014-07-26 18:51:29
30ccb36cb9c1bc9bd30edb2b67f26ef2a1e4fb53...df0d5ea7bc9821923c70e7bf06d3646598cf019d,10,49,79,128,7,2014-07-27 01:10:03,2014-07-26 01:23:01
df0d5ea7bc9821923c70e7bf06d3646598cf019d...f8ec200671649282b9e62fb1a4dfc138fa4eb4fb,1,1,1,2,1,2014-07-27 11:29:36,2014-07-27 11:23:16
f8ec200671649282b9e62fb1a4dfc138fa4eb4fb...99c2c917c3f859f2cc3fc1f7d5abb72730aa6c48,2,13,4,17,2,2014-07-27 11:32:07,2014-07-25 17:20:00
99c2c917c3f859f2cc3fc1f7d5abb72730aa6c48...df55a697b39223dc183f3660a435c61e6aea84d5,1,6,4,10,1,2014-07-27 11:55:40,2014-07-27 11:55:40
df55a697b39223dc183f3660a435c61e6aea84d5...b4c80238a2b6c3f9fb7437d216082315c601055b,1,1,1,2,1,2014-07-27 12:33:04,2014-07-27 12:33:04
b4c80238a2b6c3f9fb7437d216082315c601055b...d82cf95c5260eb690429f22055f7af9aa6ef2cb9,1,4,0,4,1,2014-07-27 13:49:32,2014-07-27 13:48:21
d82cf95c5260eb690429f22055f7af9aa6ef2cb9...2077bbe3fefb58eadfde0f2f36af13a0f1d3704a,2,12,0,12,2,2014-07-28 14:06:06,2014-07-28 14:05:41
2077bbe3fefb58eadfde0f2f36af13a0f1d3704a...acbe3fac7c1210aacf2a931d9c5dde4f8fecd6c4,2,21,7,28,5,2014-07-28 14:57:49,2014-07-27 08:12:39
acbe3fac7c1210aacf2a931d9c5dde4f8fecd6c4...d84b881600788e9a9d3c2ad7d3fe4a03d1880086,2,39,3,42,5,2014-07-28 17:33:28,2014-07-28 17:32:43
d84b881600788e9a9d3c2ad7d3fe4a03d1880086...394053ce605a30c742d6270a80986b255adb3a30,4,45,18,63,11,2014-07-28 17:47:55,2014-07-28 17:47:28
394053ce605a30c742d6270a80986b255adb3a30...13d44f54a265e9fc6185e1d5518da8ad568fbaad,1,8,6,14,2,2014-07-29 09:00:19,2014-07-29 08:54:11
13d44f54a265e9fc6185e1d5518da8ad568fbaad...9fb1652ac33f3ea7ba2f05e089d73691c9d41b8e,1,3,2,5,2,2014-07-29 09:09:40,2014-07-29 09:06:32
9fb1652ac33f3ea7ba2f05e089d73691c9d41b8e...5ac7fd96649a2523a767c23c083842a5cc40dd9c,1,34,16,50,9,2014-07-29 13:10:27,2014-07-29 13:08:49
5ac7fd96649a2523a767c23c083842a5cc40dd9c...c0ddc410ecbc02de32c6507ad4e63740491415c7,1,17,39,56,8,2014-07-29 13:27:28,2014-07-29 13:23:03
c0ddc410ecbc02de32c6507ad4e63740491415c7...dcedc453a2e6446d052fc7a3d24fe190a607e958,1,4,0,4,1,2014-07-29 13:43:29,2014-07-29 13:39:19
dcedc453a2e6446d052fc7a3d24fe190a607e958...053af1422a051cf22600d2a0cbecd8c4fdb0b068,1,2,0,2,1,2014-07-29 16:19:48,2014-07-29 16:19:25
053af1422a051cf22600d2a0cbecd8c4fdb0b068...9abc36b626bb1902154adc5d02bb081556577ceb,1,4,2,6,2,2014-07-29 16:24:22,2014-07-29 16:24:07
9abc36b626bb1902154adc5d02bb081556577ceb...fb8ddac27afa2720226051cb0daff47bd0377a49,1,1,1,2,1,2014-07-29 16:29:32,2014-07-29 16:12:35
fb8ddac27afa2720226051cb0daff47bd0377a49...0a4fbf4e13b194383f9eecc0af337a50fb6dfe98,2,26,35,61,12,2014-07-29 16:39:01,2014-07-29 16:38:08
0a4fbf4e13b194383f9eecc0af337a50fb6dfe98...3deddc2fdf1f47a9564b6d39ee53dc5bdd944dc2,2,19,0,19,2,2014-07-29 17:03:59,2014-07-29 17:02:59
3deddc2fdf1f47a9564b6d39ee53dc5bdd944dc2...cc875e94cf6c18530595a59e91ecd23f5c961146,1,17,1,18,2,2014-07-29 17:10:58,2014-07-29 17:10:31
cc875e94cf6c18530595a59e91ecd23f5c961146...8e7fdfdb6fb0e910d5b507ba2da56a297bfba25c,2,28,3,31,8,2014-07-29 17:22:30,2014-07-29 17:22:00
8e7fdfdb6fb0e910d5b507ba2da56a297bfba25c...7e6eeef366d00b1bac3406477cc8e7714725baf7,1,3,4,7,1,2014-07-30 12:16:01,2014-07-30 12:15:13
7e6eeef366d00b1bac3406477cc8e7714725baf7...813f938093a2c9a04ec69ff18bdb61413adf61a4,1,3,0,3,1,2014-07-30 13:33:44,2014-07-30 13:33:02
813f938093a2c9a04ec69ff18bdb61413adf61a4...7cb4a82eaf2c6b59a80699ae91b63180eb8a47ef,2,2,0,2,2,2014-07-30 16:59:39,2014-07-29 13:18:44
7cb4a82eaf2c6b59a80699ae91b63180eb8a47ef...82695c3f2b3f8f4fbc8ec0753c0f5f23f0769bee,1,1,1,2,1,2014-07-30 16:59:46,2014-07-30 16:58:45
82695c3f2b3f8f4fbc8ec0753c0f5f23f0769bee...7dc29dcb99202d170eedf37a7b9bc17be1df36d9,1,5,4,9,4,2014-07-30 17:04:38,2014-07-30 17:03:54
7dc29dcb99202d170eedf37a7b9bc17be1df36d9...5736631233f509de8013df7f71c7698783886a28,1,2,1,3,2,2014-07-30 18:33:58,2014-07-30 18:31:59
5736631233f509de8013df7f71c7698783886a28...e22ad1c3250a59d046d73bf34ae39c0c40e03c98,3,54,4,58,6,2014-07-30 19:36:01,2014-07-27 21:39:40
e22ad1c3250a59d046d73bf34ae39c0c40e03c98...567ae0d52955696d3e329b3a29f13c6b5b3f2208,1,3,2,5,3,2014-07-30 20:22:56,2014-07-30 20:22:04
567ae0d52955696d3e329b3a29f13c6b5b3f2208...063e7e56bcd34d76e9072ebfa3b9f1d9679dc6e9,2,1,2,3,2,2014-07-31 13:25:23,2014-07-31 12:06:46
063e7e56bcd34d76e9072ebfa3b9f1d9679dc6e9...42bb047d33afc2bc6205a2d9ffc24aeec626ce7f,1,6,13,19,4,2014-07-31 16:57:50,2014-07-31 16:54:11
42bb047d33afc2bc6205a2d9ffc24aeec626ce7f...e2c129fa5bfcb761a075db8fcce05b26eb07072d,2,11,18,29,8,2014-07-31 17:46:53,2014-07-29 11:45:16
e2c129fa5bfcb761a075db8fcce05b26eb07072d...e02d82155ad071639b985904289392003c5f03f1,1,1,1,2,1,2014-08-01 13:43:47,2014-08-01 13:10:14
e02d82155ad071639b985904289392003c5f03f1...ee0208108bd66cec04b28aca76eb506d9a2e1fd3,2,1,8,9,2,2014-08-01 14:14:28,2014-08-01 14:14:28
ee0208108bd66cec04b28aca76eb506d9a2e1fd3...893f188386cf156ce90cafbc136e335da16f8247,5,13,7,20,8,2014-08-02 08:26:08,2014-08-02 08:26:08
893f188386cf156ce90cafbc136e335da16f8247...2ff2809c73e2b88c7ca8c236c48211b0570406f2,7,22,24,46,17,2014-08-02 14:27:26,2014-08-02 14:27:01
2ff2809c73e2b88c7ca8c236c48211b0570406f2...a4eb5909588eb8be7e906206750d1b90c02ec4d1,1,1,1,2,1,2014-08-02 16:57:34,2014-08-02 16:57:34
a4eb5909588eb8be7e906206750d1b90c02ec4d1...59fca56469c566435dfab0b19f219f159b32de61,1,3,32,35,4,2014-08-02 19:03:57,2014-08-02 19:02:29
59fca56469c566435dfab0b19f219f159b32de61...27b7783fbe6063236ed2a28027683c836a023b66,1,0,49,49,1,2014-08-03 00:02:48,2014-08-03 00:02:06
27b7783fbe6063236ed2a28027683c836a023b66...2c5eee9f88e885742563e642ef7d6141af3b0dd0,1,0,2,2,1,2014-08-03 13:27:26,2014-08-03 13:15:24
2c5eee9f88e885742563e642ef7d6141af3b0dd0...0b1d0afc92e1dbc353418953960a083cbba63c50,2,20,0,20,2,2014-08-03 13:27:57,2014-08-03 12:02:21
0b1d0afc92e1dbc353418953960a083cbba63c50...23b0d636d3dc8b37fee6dc7539b0cd1f245b673a,2,12,0,12,2,2014-08-03 13:28:14,2014-08-03 10:59:21
23b0d636d3dc8b37fee6dc7539b0cd1f245b673a...1cb919e408d943cf2fadebb2b12517f523feb718,1,1,1,2,1,2014-08-03 19:11:32,2014-08-03 19:10:00
1cb919e408d943cf2fadebb2b12517f523feb718...6b2473d3e8048158dbc8c886d755cbf948325077,2,56,7,63,6,2014-08-03 21:02:41,2014-08-03 19:02:40
6b2473d3e8048158dbc8c886d755cbf948325077...99f3a65c730f643d35d959aa9a693101b2d21efd,1,3,3,6,3,2014-08-03 21:02:49,2014-08-03 20:32:36
99f3a65c730f643d35d959aa9a693101b2d21efd...a918c60c378b575ca52ebcfae977056b8bc5a4de,3,72,1,73,5,2014-08-04 01:59:48,2014-08-04 01:58:44
a918c60c378b575ca52ebcfae977056b8bc5a4de...6ebfff7f667f8e30afc6fb32a4349b6d0a4aa4ba,1,47,8,55,5,2014-08-04 03:28:41,2014-08-04 03:15:32
6ebfff7f667f8e30afc6fb32a4349b6d0a4aa4ba...b2ab666aad269fbd6fc7a9999aa0e76e08744188,1,2,2,4,1,2014-08-04 03:57:36,2014-08-04 03:57:02
b2ab666aad269fbd6fc7a9999aa0e76e08744188...d77f92fa1ee473160f50ab8482876e4bab33f8cf,1,3,1,4,1,2014-08-04 04:07:08,2014-08-04 04:06:33
d77f92fa1ee473160f50ab8482876e4bab33f8cf...d723da383da81de6d2b3b149eb8ced80d9d2c29c,1,1,1,2,1,2014-08-04 04:18:22,2014-08-04 04:18:22
d723da383da81de6d2b3b149eb8ced80d9d2c29c...a582431b414295ad4cabf0dc8d76229512a459df,3,7,7,14,6,2014-08-04 12:31:18,2014-08-04 11:29:59
a582431b414295ad4cabf0dc8d76229512a459df...f3c0cb0120aa5805daa880f18b24f40bacde651f,4,14,1,15,4,2014-08-05 00:21:25,2014-07-31 22:36:06
f3c0cb0120aa5805daa880f18b24f40bacde651f...d679672a3954745159426a41ef1fdc959624b367,1,20,13,33,3,2014-08-05 11:10:30,2014-08-05 11:09:37
d679672a3954745159426a41ef1fdc959624b367...0014d5b3055ea7a01c1268bd0bcac50ff31c50f8,2,2,2,4,2,2014-08-05 11:28:54,2014-08-05 11:28:04
0014d5b3055ea7a01c1268bd0bcac50ff31c50f8...9ed92906b3b9096464e293d2e636ac25f3c279e6,8,8,14,22,11,2014-08-05 12:23:57,2014-08-05 12:23:34
9ed92906b3b9096464e293d2e636ac25f3c279e6...5e42e9f0592f987a9caba3b1322ba070927a1195,1,25,0,25,1,2014-08-05 12:49:34,2014-08-05 12:40:27
5e42e9f0592f987a9caba3b1322ba070927a1195...0e69af51b1557ebe3ce93fe31498f3fa797b4b83,2,28,4,32,5,2014-08-07 01:52:49,2014-08-07 01:52:03
0e69af51b1557ebe3ce93fe31498f3fa797b4b83...91195c77d09cde526df75eb06d1c1145e19d8ea5,1,17,17,34,2,2014-08-07 02:00:13,2014-08-07 01:59:11
91195c77d09cde526df75eb06d1c1145e19d8ea5...bbcd86e264077fa3796dc584667ebf51313f485c,1,19,0,19,2,2014-08-07 02:14:42,2014-08-07 02:13:37
bbcd86e264077fa3796dc584667ebf51313f485c...b6a6033096685a5027a4aea5f92e2715ef481dbd,1,1,1,2,1,2014-08-07 02:18:29,2014-08-07 00:32:41
b6a6033096685a5027a4aea5f92e2715ef481dbd...9cc5d99bdeff5be0f8df1618b989050061ed5629,2,61,2,63,4,2014-08-07 04:15:44,2014-08-07 04:13:22
9cc5d99bdeff5be0f8df1618b989050061ed5629...796030590a851b1e75fee9172661abf0d6390cc3,1,2,0,2,1,2014-08-07 12:32:12,2014-08-07 12:30:50
796030590a851b1e75fee9172661abf0d6390cc3...a7336cdcbe90cfb32561b2f68dbe2ef40d544db8,1,2,2,4,2,2014-08-07 12:34:53,2014-08-07 12:33:42
a7336cdcbe90cfb32561b2f68dbe2ef40d544db8...4c56b6f820df969e270738ce6cc1cdce3f024334,1,1,1,2,1,2014-08-07 14:12:09,2014-08-07 14:11:15
4c56b6f820df969e270738ce6cc1cdce3f024334...29585e9b6a0ce15dc0149c8424cd11c3e27ee295,2,7,0,7,2,2014-08-07 18:41:28,2014-08-07 06:06:44
29585e9b6a0ce15dc0149c8424cd11c3e27ee295...267630ad50c69ebfe594de37a0636264aa5be7d6,1,2,2,4,2,2014-08-07 23:57:49,2014-08-07 23:56:59
267630ad50c69ebfe594de37a0636264aa5be7d6...fda3eccea3096e052532d44ec33b5ddf3db885cb,1,1,1,2,1,2014-08-08 15:45:14,2014-08-08 15:45:14
fda3eccea3096e052532d44ec33b5ddf3db885cb...f7c609b9dc8eb0ef53b5f2b5f9ee9da0d40dff46,1,2,0,2,2,2014-08-08 16:11:52,2014-03-22 22:12:52
f7c609b9dc8eb0ef53b5f2b5f9ee9da0d40dff46...288b557ac47a76085dc9b8b124fcf3ce67610ac5,1,65,11,76,3,2014-08-08 16:43:57,2014-08-08 14:17:27
288b557ac47a76085dc9b8b124fcf3ce67610ac5...ab883a3477147faece3484d50f7e38bf9b138d8f,2,5,5,10,4,2014-08-08 17:59:29,2014-08-08 17:59:02
ab883a3477147faece3484d50f7e38bf9b138d8f...98d6f128d0fd5aec0c8d49da273e369e8345a726,3,33,18,51,8,2014-08-08 20:55:45,2014-08-08 20:47:35
98d6f128d0fd5aec0c8d49da273e369e8345a726...ee74f9fe3bcd8c2648e4623d5929fceac851b97f,3,106,6,112,8,2014-08-09 07:51:06,2014-08-09 07:50:00
ee74f9fe3bcd8c2648e4623d5929fceac851b97f...cdc42ac0d663130a63bb8b36293acb0bc4294d7b,1,3,0,3,1,2014-08-10 11:32:16,2014-08-10 11:31:06
cdc42ac0d663130a63bb8b36293acb0bc4294d7b...07c79252828c17b9b799d59a3bbbe45c62fe6d38,1,12,0,12,1,2014-08-10 14:24:56,2014-08-10 14:24:19
07c79252828c17b9b799d59a3bbbe45c62fe6d38...4ce5ced230481fc93288aeea922398bc36102d1e,2,22,1,23,3,2014-08-11 06:35:37,2014-08-08 10:08:26
4ce5ced230481fc93288aeea922398bc36102d1e...927d7b8b712680ca9fb9ec2a16dccae0f3c8e794,1,1,1,2,1,2014-08-11 10:08:20,2014-08-11 10:01:14
927d7b8b712680ca9fb9ec2a16dccae0f3c8e794...9a51270dba8a1f0ca282411a9da62a81a10cb6bb,2,28,8,36,6,2014-08-11 11:09:34,2014-08-07 13:20:59
9a51270dba8a1f0ca282411a9da62a81a10cb6bb...0e9d6ad54ac5e34bd0a1577353e651a500fa52a7,1,1,1,2,1,2014-08-12 16:27:41,2014-08-12 16:27:24
0e9d6ad54ac5e34bd0a1577353e651a500fa52a7...49419ffd050d34c4f0948a0e9b68eb081985277b,7,28,60,88,16,2014-08-12 17:48:21,2014-08-11 11:34:48
49419ffd050d34c4f0948a0e9b68eb081985277b...8f9dd9f256239d77ef20d6b4d2f48f08208e504a,5,141,110,251,46,2014-08-12 18:44:09,2014-08-12 18:12:50
8f9dd9f256239d77ef20d6b4d2f48f08208e504a...72fdd62e93cf8bc3a6bfad4d24b06a474ad56942,4,90,25,115,21,2014-08-12 19:51:11,2014-08-12 19:49:20
72fdd62e93cf8bc3a6bfad4d24b06a474ad56942...e705d8c4b49d5c5ee747075f12709011f55b7a8a,2,11,19,30,15,2014-08-12 20:25:42,2014-08-12 20:25:42
e705d8c4b49d5c5ee747075f12709011f55b7a8a...67870137b9e1f1384af7465b4eb978d0f4dab3b7,1,6,6,12,4,2014-08-12 20:55:35,2014-08-12 20:27:38
67870137b9e1f1384af7465b4eb978d0f4dab3b7...05063c60da3f001a1876a6eade259d497393606a,1,13,10,23,4,2014-08-13 16:41:39,2014-08-13 16:00:45
05063c60da3f001a1876a6eade259d497393606a...0f44d9f9b153a25376e57060e849cddfaab9c350,4,6,6,12,4,2014-08-13 22:24:43,2014-08-13 16:33:06
0f44d9f9b153a25376e57060e849cddfaab9c350...d38007e86d8c9248f1e38d8e3dcd21b0f0a2d95f,1,0,2,2,1,2014-08-14 01:43:07,2014-08-14 01:42:05
d38007e86d8c9248f1e38d8e3dcd21b0f0a2d95f...46edcd621e3092bcbf5817f98d7ff2ae86266f0e,1,2,2,4,2,2014-08-14 01:45:28,2014-08-14 01:44:16
46edcd621e3092bcbf5817f98d7ff2ae86266f0e...63ccf64079f833ff93a3fe9d158df2ec99015147,2,5,1,6,3,2014-08-14 10:09:22,2014-08-14 09:56:25
63ccf64079f833ff93a3fe9d158df2ec99015147...d9559fe163791be263bf8ea406fc287cbbfc9e45,1,1,1,2,1,2014-08-14 15:55:09,2014-08-14 11:16:15
d9559fe163791be263bf8ea406fc287cbbfc9e45...2b694919db8234b5d4e920ac09066c9fe265dcd7,1,1,1,2,1,2014-08-14 16:15:14,2014-08-14 16:00:06
2b694919db8234b5d4e920ac09066c9fe265dcd7...b5784048e085e8db5d0e959c12278ef727994e98,2,24,2,26,5,2014-08-15 02:47:34,2014-08-15 02:47:02
b5784048e085e8db5d0e959c12278ef727994e98...2cbafd814f151b8c926ed8a955627edb8ea23b23,2,7,3,10,4,2014-08-15 08:14:20,2014-08-15 08:11:53
2cbafd814f151b8c926ed8a955627edb8ea23b23...23455aeee2a9edc71d15d5e15db77fdf641489d9,1,1,1,2,1,2014-08-15 11:30:36,2014-08-15 11:18:04
23455aeee2a9edc71d15d5e15db77fdf641489d9...6011f245036ad1a652881e65b4b25cc5773bfb1b,1,1,1,2,1,2014-08-15 15:02:18,2014-08-15 15:01:49
6011f245036ad1a652881e65b4b25cc5773bfb1b...3af14109499bba8ea5b2a94e6a26cecb6cc002cd,1,10,1,11,2,2014-08-15 16:38:09,2014-08-15 12:18:55
3af14109499bba8ea5b2a94e6a26cecb6cc002cd...41cf159c0ac0a7380874cb6f17464dd741ad1d9b,1,2,2,4,1,2014-08-15 17:51:32,2014-08-15 14:04:05
41cf159c0ac0a7380874cb6f17464dd741ad1d9b...28d97533246fa1051e416ff772a40190b1f30e4d,1,4,2,6,1,2014-08-15 17:57:49,2014-08-15 17:29:01
28d97533246fa1051e416ff772a40190b1f30e4d...ee7289656c4aa18df91b3b18fff31cd010109de7,1,41,30,71,13,2014-08-15 19:17:48,2014-08-15 17:58:50
ee7289656c4aa18df91b3b18fff31cd010109de7...ad2faaa4918ff1cfce2671a91d0e016515319481,1,3,1,4,2,2014-08-18 13:16:18,2014-08-18 13:15:24
ad2faaa4918ff1cfce2671a91d0e016515319481...d818e02134ae719108e12b24a7da7416328c2190,1,9,9,18,3,2014-08-18 16:54:15,2014-08-18 16:49:50
d818e02134ae719108e12b24a7da7416328c2190...126606c5b8499830cd56cbe632f6af17bc7471ea,1,11,2,13,1,2014-08-18 17:00:12,2014-08-15 19:19:04
126606c5b8499830cd56cbe632f6af17bc7471ea...3a80189479a29220bac6d205a1b97184bd76a876,7,37,2,39,10,2014-08-18 17:36:34,2014-08-16 15:21:14
3a80189479a29220bac6d205a1b97184bd76a876...5f54752b9dd243ffcb8cb3cb8dc46f8d3666d8bd,5,23,16,39,15,2014-08-19 00:40:41,2014-08-19 00:37:16
5f54752b9dd243ffcb8cb3cb8dc46f8d3666d8bd...d6c6181f9ecf90be7d298c670ce23c0327417bb7,1,5,0,5,1,2014-08-19 10:15:28,2014-08-19 10:14:14
d6c6181f9ecf90be7d298c670ce23c0327417bb7...c3c686b92de20b99161d1208e8aec7112213bb28,1,3,1,4,1,2014-08-19 10:16:36,2014-08-19 10:09:29
c3c686b92de20b99161d1208e8aec7112213bb28...20e3a004ac88b127a51bb332ca2653fe06a19a97,1,15,7,22,3,2014-08-19 10:29:25,2014-08-19 10:27:27
20e3a004ac88b127a51bb332ca2653fe06a19a97...89f33f427e9b73c77c93cf61d7ce82543297dd05,1,2,1,3,1,2014-08-19 11:18:39,2014-08-19 11:17:23
89f33f427e9b73c77c93cf61d7ce82543297dd05...b3f6a0f5a1b88a9a96080531b7391f6a3a0ce5aa,1,7,3,10,3,2014-08-19 11:26:04,2014-08-19 11:23:17
b3f6a0f5a1b88a9a96080531b7391f6a3a0ce5aa...24d9aee1880ced5892af42f35539a5d705adf512,2,8,5,13,4,2014-08-19 16:00:39,2014-08-19 14:56:01
24d9aee1880ced5892af42f35539a5d705adf512...22a28dd8b02a19dc6333b5ab26fec7d6e66c1bf8,1,4,0,4,1,2014-08-19 16:09:18,2014-08-19 16:06:07
22a28dd8b02a19dc6333b5ab26fec7d6e66c1bf8...6e5e2b0e28707d1a2cb5d7fafaba2e07bd81bdb2,4,7,1,8,4,2014-08-19 17:32:05,2014-08-19 13:23:29
6e5e2b0e28707d1a2cb5d7fafaba2e07bd81bdb2...72ad014b6aee3e8d996af4646b97228e82fc4cc1,5,43,13,56,9,2014-08-19 20:30:22,2014-07-12 17:37:59
72ad014b6aee3e8d996af4646b97228e82fc4cc1...dc9751a6e7009290b1515934ccf771e2306aa4ab,1,1,1,2,1,2014-08-19 21:45:30,2014-06-07 12:54:54
dc9751a6e7009290b1515934ccf771e2306aa4ab...9dcb2cf4e639650ae430aa3cac7797c131559294,4,61,16,77,14,2014-08-19 21:45:59,2014-08-19 14:22:51
9dcb2cf4e639650ae430aa3cac7797c131559294...824e02bf836affa182dd4bcb7b3e1796f1389b38,2,73,76,149,17,2014-08-20 02:51:23,2014-08-20 02:50:14
824e02bf836affa182dd4bcb7b3e1796f1389b38...cba018242527bb6bc3c0fd1a7e35495b6dcc25e4,1,1,1,2,1,2014-08-20 06:59:24,2014-08-20 06:57:13
cba018242527bb6bc3c0fd1a7e35495b6dcc25e4...c586fcd4eade52fad7528f322a8dff034f68b577,1,1,1,2,1,2014-08-20 07:23:18,2014-08-14 13:24:47
c586fcd4eade52fad7528f322a8dff034f68b577...49280a73ea533bca0b870d1b135bb9e4a7ce989b,2460,154077,88758,242835,55166,2014-08-20 08:05:47,2014-08-14 18:13:35
49280a73ea533bca0b870d1b135bb9e4a7ce989b...6981eced83ea2d6462b21c12ecea044e02e56d05,1,1,1,2,1,2014-08-20 18:01:50,2014-08-20 18:00:59
6981eced83ea2d6462b21c12ecea044e02e56d05...298148528059a84887364acc8a2faa3220eb4897,1,4,4,8,1,2014-08-20 18:38:43,2014-08-20 18:37:33
298148528059a84887364acc8a2faa3220eb4897...1c00c38b4a81abb54bb8b93d3aa4ce6e661df3dc,4,17,1,18,5,2014-08-20 18:42:48,2014-08-05 19:20:05
1c00c38b4a81abb54bb8b93d3aa4ce6e661df3dc...bf650a2ee78c6d1f4544a875dcc777cf27fe93e9,6,50,1,51,6,2014-08-20 18:42:48,2014-07-17 19:59:28
bf650a2ee78c6d1f4544a875dcc777cf27fe93e9...3123f8452cf49071be9110e277eea60ba0032216,8,122,27,149,19,2014-08-20 18:42:48,2014-08-08 14:20:08
3123f8452cf49071be9110e277eea60ba0032216...1a45d059c70385fcd6f4a3955f3b4e4cc96d0150,5,65,8,73,7,2014-08-20 18:42:48,2014-07-28 04:54:29
1a45d059c70385fcd6f4a3955f3b4e4cc96d0150...2b31342cdf14fc20e07c43d258f1e7334ad664a6,8,115,7,122,15,2014-08-20 18:42:48,2014-08-07 04:18:10
2b31342cdf14fc20e07c43d258f1e7334ad664a6...2da20379c0dd0171eb11c188909096f708dd6095,2,95,3,98,5,2014-08-20 20:08:49,2014-08-20 14:15:23
2da20379c0dd0171eb11c188909096f708dd6095...ad96254af98f961d6691481c27127613afeee840,1,1,1,2,1,2014-08-20 20:25:35,2014-08-20 20:25:35
ad96254af98f961d6691481c27127613afeee840...f8aa2aa48679e12e05e8d8f01710e81a6df6022c,3,3,3,6,3,2014-08-20 20:32:39,2014-08-20 20:31:45
f8aa2aa48679e12e05e8d8f01710e81a6df6022c...fbe45076234b1509a574a78a0f2b2dda602836db,1,10,5,15,1,2014-08-22 02:18:40,2014-08-22 02:17:25
fbe45076234b1509a574a78a0f2b2dda602836db...588f66d18235762f8e0f96200c88bc4ba6c1c579,2,23,3,26,5,2014-08-22 02:34:20,2014-08-22 02:08:53
588f66d18235762f8e0f96200c88bc4ba6c1c579...7abb88a19cb18005d5607859743eab78bcd57375,1,1,1,2,1,2014-08-22 15:34:41,2014-08-22 15:22:09
7abb88a19cb18005d5607859743eab78bcd57375...8aca08f82888ccc0aaf981c04ce7e5bcb4048d88,1,2,1,3,1,2014-08-22 15:40:04,2014-08-22 10:24:46
8aca08f82888ccc0aaf981c04ce7e5bcb4048d88...c19c7c192c1cdbfa29cc4a33fdc6f0c0bb477e86,1,2,1,3,1,2014-08-22 17:23:55,2014-08-22 16:56:38
c19c7c192c1cdbfa29cc4a33fdc6f0c0bb477e86...46393980cf27680ddd3151e90d4af43cf2e0cc12,3,34,1,35,10,2014-08-23 12:12:31,2014-08-23 09:29:56
46393980cf27680ddd3151e90d4af43cf2e0cc12...3d88ed33418632c3d8def0d98659248120a26df2,2,16,52,68,6,2014-08-23 13:31:48,2014-08-23 13:30:01
3d88ed33418632c3d8def0d98659248120a26df2...4ae75cf0514feff6e5595abbb87c9abc85f9cbc3,1,13,0,13,1,2014-08-23 21:36:08,2014-08-23 09:37:25
4ae75cf0514feff6e5595abbb87c9abc85f9cbc3...1a918806ca67e8e4818aeb1c304e4546baab9e4d,4,52,27,79,11,2014-08-23 23:19:58,2014-08-22 07:26:06
1a918806ca67e8e4818aeb1c304e4546baab9e4d...da2077ed678de4b4b00821c99c5b912b8890066b,2,6,6,12,2,2014-08-23 23:31:05,2014-08-23 23:30:14
da2077ed678de4b4b00821c99c5b912b8890066b...8c8ce2ee64b098dc52ebda7ce95644cb7c2f9cb2,1,4,0,4,1,2014-08-24 17:35:01,2014-08-24 17:33:36
8c8ce2ee64b098dc52ebda7ce95644cb7c2f9cb2...187ee0a4ac346b91ba5c302b6171d91a2dddbcbe,3,2,3,5,3,2014-08-25 17:13:58,2014-08-25 14:07:14
187ee0a4ac346b91ba5c302b6171d91a2dddbcbe...5d2b4669e8e1bf61d6f3cc33326097507755c706,1,2,0,2,1,2014-08-25 18:44:39,2014-08-25 17:17:13
5d2b4669e8e1bf61d6f3cc33326097507755c706...95556fdd63a37f4714592c74bb2e6c0793bbafdc,1,3,4,7,1,2014-08-26 12:11:55,2014-08-24 03:01:13
95556fdd63a37f4714592c74bb2e6c0793bbafdc...9c849f7c7a788746e648a4b6084cf8b190eeea12,2,2,2,4,2,2014-08-26 13:44:51,2014-08-26 13:44:24
9c849f7c7a788746e648a4b6084cf8b190eeea12...808722e062ff261af4f24342b15fcf67c37c5cf0,1,1,1,2,1,2014-08-26 14:07:57,2014-08-26 14:00:33
808722e062ff261af4f24342b15fcf67c37c5cf0...34116ad71c5f934fc2702c32a8cd743f36a85479,1,25,0,25,1,2014-08-26 14:45:18,2014-08-26 14:35:32
34116ad71c5f934fc2702c32a8cd743f36a85479...e920c900ec5189115ed8648c21952444c7790b34,1,9,0,9,1,2014-08-26 18:11:53,2014-08-26 18:11:35
e920c900ec5189115ed8648c21952444c7790b34...588afbb2be6cf03afde8e1b17980bea09f54ba9a,2,106,59,165,28,2014-08-26 18:35:17,2014-08-20 14:12:25
588afbb2be6cf03afde8e1b17980bea09f54ba9a...1b89f976f4919a36c6b70eba428c3a02a94e2822,1,11,0,11,1,2014-08-26 18:50:37,2014-08-26 17:52:20
1b89f976f4919a36c6b70eba428c3a02a94e2822...4f0916c374e37ff945f04d7981f3b435eb7cd350,1,5,0,5,1,2014-08-26 19:22:28,2014-08-26 19:22:08
4f0916c374e37ff945f04d7981f3b435eb7cd350...403cc55f236d0877592f194ad34d6c1b5f0321ea,1,10,14,24,3,2014-08-26 19:52:15,2014-08-26 19:43:23
403cc55f236d0877592f194ad34d6c1b5f0321ea...c13a4c95c1db4c80c84b764888293c408275b384,1,1,1,2,1,2014-08-27 00:50:34,2014-08-26 23:39:07
c13a4c95c1db4c80c84b764888293c408275b384...307eef20e35e78b1e812dc347c6c959e380267cf,3,12,2,14,3,2014-08-27 07:16:51,2014-08-23 08:27:33
307eef20e35e78b1e812dc347c6c959e380267cf...e86030b3be2ac9af4a2855d88802c0b750152c8a,1,4,2,6,1,2014-08-27 11:45:34,2014-08-27 11:43:13
e86030b3be2ac9af4a2855d88802c0b750152c8a...574f8f560fa84474969c1c49a1a38b041e5f016b,1,3,0,3,1,2014-08-27 12:02:17,2014-08-27 12:01:30
574f8f560fa84474969c1c49a1a38b041e5f016b...4883516bea2aebff38b193f4c9707928040d0f8a,8,79,5,84,12,2014-08-28 01:27:48,2014-08-21 15:55:23
4883516bea2aebff38b193f4c9707928040d0f8a...9ac713645bb870c45d7aaf16b003e392f62d4ea3,7,18,18,36,13,2014-08-28 06:46:54,2014-08-28 06:44:26
9ac713645bb870c45d7aaf16b003e392f62d4ea3...419f9075c4458bbf4618fd94ac9a03ac7301efa0,2,113,10,123,8,2014-08-28 14:50:09,2014-08-28 03:04:23
419f9075c4458bbf4618fd94ac9a03ac7301efa0...c32c220881ebca2be7b7bb5bec6ca4b25d1d6454,2,22,6,28,3,2014-08-28 19:23:46,2014-08-28 18:12:49
c32c220881ebca2be7b7bb5bec6ca4b25d1d6454...8f033ee04b2422078e1bd4a2a5b554247d0c4752,1,2,2,4,2,2014-08-28 19:32:44,2014-08-28 19:30:20
8f033ee04b2422078e1bd4a2a5b554247d0c4752...f201cfae12961c60d293201add0c09a4e3024533,1,4,2,6,2,2014-08-28 23:37:21,2014-08-28 23:33:36
f201cfae12961c60d293201add0c09a4e3024533...022fdb2ac4a795af0fb1808942b260e2dc3d404d,1,6,1,7,1,2014-08-29 08:25:32,2014-08-29 08:22:59
022fdb2ac4a795af0fb1808942b260e2dc3d404d...0396001830a1e9a8a12e13a8bb7f702c34d57b39,1,1,1,2,1,2014-08-30 03:11:37,2014-08-30 03:06:31
0396001830a1e9a8a12e13a8bb7f702c34d57b39...3297f9e1ad97da1e63ca827239663d6b33949037,4,46,5,51,6,2014-08-30 11:16:42,2014-08-29 14:01:21
3297f9e1ad97da1e63ca827239663d6b33949037...d839c756645b5091d55f67bbc4ff10718ff61a6b,2,12,1,13,2,2014-08-30 16:51:52,2014-08-30 16:48:55
d839c756645b5091d55f67bbc4ff10718ff61a6b...f4da04a771a67e15c0f529c429c44ab9388fe6be,1,1,1,2,1,2014-08-31 01:37:15,2014-08-30 22:18:58
f4da04a771a67e15c0f529c429c44ab9388fe6be...074b6785e09040eb6fd3b9bd3e4bf0cc6e1588f0,1,2,3,5,1,2014-08-31 16:33:33,2014-08-31 16:23:41
074b6785e09040eb6fd3b9bd3e4bf0cc6e1588f0...e42a82edf2acbe1cb32757072dc4965380f40e09,1,1,1,2,1,2014-09-01 00:11:57,2014-09-01 00:06:38
e42a82edf2acbe1cb32757072dc4965380f40e09...a7ac5f018726694e3a79180ef97f2813c715fac0,1,3,15,18,2,2014-09-01 18:50:31,2014-09-01 18:48:06
a7ac5f018726694e3a79180ef97f2813c715fac0...7eabd22217dcf2a67173b055ace63ca3fce8eb48,2,35,2,37,3,2014-09-02 12:11:45,2014-09-01 09:30:00
7eabd22217dcf2a67173b055ace63ca3fce8eb48...52eadbf5c0bad53ca46eea3bb96a17c3320b55b2,1,15,3,18,2,2014-09-02 12:12:49,2014-09-02 12:12:49
52eadbf5c0bad53ca46eea3bb96a17c3320b55b2...9cacc25037501d243cb5fb8ad2ace8fa9d8cdd68,1,2,0,2,1,2014-09-02 12:15:02,2014-09-02 05:59:05
9cacc25037501d243cb5fb8ad2ace8fa9d8cdd68...6ec31cb51637eba500db05e89291aad8d6bfb103,1,21,14,35,6,2014-09-02 20:19:54,2014-09-02 20:17:46
6ec31cb51637eba500db05e89291aad8d6bfb103...d92b08536d873c0966e8192e64d8e8bd9de79ebe,1,1,1,2,1,2014-09-02 21:08:20,2014-09-02 21:08:20
d92b08536d873c0966e8192e64d8e8bd9de79ebe...cedccd2688e2eacaad647d57cc487d1fe6162438,1,2,1,3,1,2014-09-03 01:03:41,2014-09-03 01:01:13
cedccd2688e2eacaad647d57cc487d1fe6162438...f030cdd402d9833a618e9db3192f1bd305d2a869,1,1,1,2,1,2014-09-03 01:08:28,2014-09-03 01:08:28
f030cdd402d9833a618e9db3192f1bd305d2a869...15c71a07b8051345f8792b2739a1b68503c3fa7e,3,3,3,6,3,2014-09-03 01:35:03,2014-09-03 01:34:29
15c71a07b8051345f8792b2739a1b68503c3fa7e...0d70bc63d02e973de932ec4a144b4158cdd35b41,2,13,0,13,2,2014-09-03 01:41:53,2014-09-03 01:41:21
0d70bc63d02e973de932ec4a144b4158cdd35b41...de18a687ada58c5296f3f41b432aa2d26de8e3d9,1,1,1,2,1,2014-09-03 15:49:33,2014-09-03 03:27:36
de18a687ada58c5296f3f41b432aa2d26de8e3d9...0bc67a16d314642bfa6eadbdce6db86089f43b33,1,7,7,14,6,2014-09-04 13:45:35,2014-09-04 13:34:59
0bc67a16d314642bfa6eadbdce6db86089f43b33...676db20824b574d1283208cb1f1d07eb793dbb25,1,1,1,2,1,2014-09-04 16:32:52,2014-09-04 16:31:33
676db20824b574d1283208cb1f1d07eb793dbb25...368e5cea58eefbfd1b997e68f6a29785cbd12117,1,3,3,6,4,2014-09-05 11:11:12,2014-09-05 01:04:53
368e5cea58eefbfd1b997e68f6a29785cbd12117...994294e0da6c78b42280d68bda7a939d7f383d4a,1,3,3,6,3,2014-09-05 16:31:10,2014-09-05 16:16:30
994294e0da6c78b42280d68bda7a939d7f383d4a...0c3a23d2b9fd5399c2cdda8c72d43c960040886a,1,1,1,2,1,2014-09-05 18:30:01,2014-09-05 17:06:20
0c3a23d2b9fd5399c2cdda8c72d43c960040886a...d0c6016367c11d4d4cc42ace340f951f5b75738e,1,12,11,23,1,2014-09-05 18:35:00,2014-05-16 10:11:35
d0c6016367c11d4d4cc42ace340f951f5b75738e...ffa9e60638bc1447cba9ddef4585b70267c435f7,1,6,0,6,1,2014-09-05 18:41:22,2014-09-05 18:38:44
ffa9e60638bc1447cba9ddef4585b70267c435f7...c5578ba9fa052a814c27fe0069f98ed994751634,1,15,8,23,2,2014-09-05 19:05:25,2014-09-05 18:59:10
c5578ba9fa052a814c27fe0069f98ed994751634...5e2f336f69f21e12fbafe6f5a4c0493258547e8a,1,16,16,32,10,2014-09-05 19:44:56,2014-09-05 19:41:37
5e2f336f69f21e12fbafe6f5a4c0493258547e8a...e5cdfb151039cdd22a17480f0f1fb9ccbad5eb56,1,3,2,5,2,2014-09-05 22:37:53,2014-09-05 21:58:44
e5cdfb151039cdd22a17480f0f1fb9ccbad5eb56...4ca44d5e10936f9dc2b370b965a91ccc75fb0955,2,35,25,60,2,2014-09-05 22:39:47,2014-09-05 22:26:05
4ca44d5e10936f9dc2b370b965a91ccc75fb0955...de3a3096d89581729d140172a50b3aab6541710f,1,1,1,2,1,2014-09-05 22:48:20,2014-09-05 22:47:20
de3a3096d89581729d140172a50b3aab6541710f...d4ef9a4a21ecf897ebcbdc49737fdb5b210fbb98,1,5,0,5,1,2014-09-06 00:00:36,2014-09-05 20:19:03
d4ef9a4a21ecf897ebcbdc49737fdb5b210fbb98...fee499c80b479873685530c24d6a9bd1eb9f49a0,1,7,13,20,3,2014-09-06 00:36:56,2014-09-05 23:41:47
fee499c80b479873685530c24d6a9bd1eb9f49a0...af28f3c17515a1de9abb668942e896d777b67cba,1,2,1,3,1,2014-09-06 00:40:49,2014-09-06 00:32:31
af28f3c17515a1de9abb668942e896d777b67cba...2b4817108122fc1098541f34a50fcab74bc1b94e,1,25,11,36,11,2014-09-06 11:36:02,2014-09-06 11:31:36
2b4817108122fc1098541f34a50fcab74bc1b94e...d19291e9ad58107825581bd2297398cf8d824fba,2,56,4,60,4,2014-09-06 12:00:29,2014-09-05 23:55:24
d19291e9ad58107825581bd2297398cf8d824fba...a932c596fc5bfcfcb358981540917c8d6f9dc575,2,5,0,5,2,2014-09-06 14:09:32,2014-09-06 14:07:34
a932c596fc5bfcfcb358981540917c8d6f9dc575...ba8983333a561b56c44c2d72c87f918604eae7f9,1,1,1,2,1,2014-09-06 16:21:36,2014-09-06 15:13:45
ba8983333a561b56c44c2d72c87f918604eae7f9...f8fdb7177b79b79968a3f40612d33c7367ae584f,1,16,0,16,1,2014-09-06 17:03:14,2014-09-06 17:02:06
f8fdb7177b79b79968a3f40612d33c7367ae584f...48e10710074a06584b6f8331a6e74492be5acf18,4,21,1,22,5,2014-09-06 18:02:28,2014-09-04 15:32:51
48e10710074a06584b6f8331a6e74492be5acf18...267b121b1e8a87adc61771ec786e6d9037df2462,1,1,1,2,1,2014-09-07 10:29:52,2014-09-07 09:29:20
267b121b1e8a87adc61771ec786e6d9037df2462...27e7972e63c6f7d6555a724a3b356b4e08b0fefa,3,28,1,29,3,2014-09-08 11:58:06,2014-09-08 11:56:35
27e7972e63c6f7d6555a724a3b356b4e08b0fefa...813619405b4920c44f455b23ef407c6c66eb5746,1,13,8,21,3,2014-09-08 17:24:38,2014-09-06 20:58:26
813619405b4920c44f455b23ef407c6c66eb5746...9c4fb019cb76eb3314357a18e225a63e113dc1fd,9,85,4,89,15,2014-09-08 17:54:21,2014-09-04 21:04:53
9c4fb019cb76eb3314357a18e225a63e113dc1fd...b0def3bcac1a2e1117050e00fa1b187a897f0c2e,3,33,3,36,6,2014-09-08 19:41:14,2014-09-08 01:01:42
b0def3bcac1a2e1117050e00fa1b187a897f0c2e...1f1a32928873a4e7cfe2f8f15631aa63df335490,1,1,1,2,1,2014-09-08 20:51:34,2014-09-08 20:01:58
1f1a32928873a4e7cfe2f8f15631aa63df335490...a3e9e9e6c6dc9ccff85c2a6d8db88cc207127f0c,3,10,1,11,3,2014-09-08 21:22:49,2014-09-08 19:54:57
a3e9e9e6c6dc9ccff85c2a6d8db88cc207127f0c...a0954a0681c949e7c94f8ab1e04f8b046d11d844,1,1,0,1,1,2014-09-08 21:31:12,2014-09-08 21:28:55
a0954a0681c949e7c94f8ab1e04f8b046d11d844...84b50718abf1cd9883e39faff6aa7fc59fd5b75d,1,13,4,17,5,2014-09-09 13:32:59,2014-09-09 13:32:19
84b50718abf1cd9883e39faff6aa7fc59fd5b75d...987fce90bfa9bbbe4279fa8cd547eaa6319d157b,1,1,1,2,1,2014-09-09 14:05:28,2014-09-09 14:00:01
987fce90bfa9bbbe4279fa8cd547eaa6319d157b...a8ded528b3c2f66d56f1f5499cf2021f3829c8e4,5,70,13,83,7,2014-09-09 15:07:41,2014-09-09 12:29:49
a8ded528b3c2f66d56f1f5499cf2021f3829c8e4...c981d9140d569d489d338741b6a3d878c4e712da,3,21,7,28,5,2014-09-09 18:54:07,2014-08-31 16:51:55
c981d9140d569d489d338741b6a3d878c4e712da...77ec85adae4d975871758ad59aed073168c2c822,1,3,1,4,1,2014-09-10 00:10:00,2014-09-09 21:52:44
77ec85adae4d975871758ad59aed073168c2c822...c2fe985733ecf5ec113a92f155cc6b769932d544,1,1,1,2,1,2014-09-10 11:17:31,2014-09-10 08:44:12
c2fe985733ecf5ec113a92f155cc6b769932d544...67872bfff12de7dcf22c966970fe21f65fe593c8,4,62,14,76,11,2014-09-10 11:57:31,2014-09-09 21:28:45
67872bfff12de7dcf22c966970fe21f65fe593c8...35cd0854f9bf1e8837397b91552f9efddec24158,2,6,4,10,4,2014-09-10 14:34:32,2014-09-10 13:54:28
35cd0854f9bf1e8837397b91552f9efddec24158...2e749f247c1f989c6fe794299f1db27627866bce,1,1,1,2,1,2014-09-10 15:17:54,2014-09-10 15:17:33
2e749f247c1f989c6fe794299f1db27627866bce...ac54e6af95a2d38734aa17daad5eaf0ee453acf9,1,1,1,2,1,2014-09-10 16:27:11,2014-09-10 16:26:15
ac54e6af95a2d38734aa17daad5eaf0ee453acf9...4500784b24856b23924e7d36b405f2df1499ea83,1,1,0,1,1,2014-09-10 17:10:39,2014-09-10 17:07:40
4500784b24856b23924e7d36b405f2df1499ea83...a358e8dc4441c4b20133d0686b8b9ff57fcc2eb6,1,7,1,8,2,2014-09-10 17:26:01,2014-09-10 17:25:40
a358e8dc4441c4b20133d0686b8b9ff57fcc2eb6...d321218a5251aeaeb6ed4da851faa829b9e25d0f,1,3,2,5,1,2014-09-11 19:42:40,2014-09-11 19:37:16
d321218a5251aeaeb6ed4da851faa829b9e25d0f...7de55fa68e694b84e5ea9c383d87153b5be0d43a,4,39,2,41,9,2014-09-11 20:15:03,2014-09-09 17:34:40
7de55fa68e694b84e5ea9c383d87153b5be0d43a...ac1adfbe4a822a3347401f574e64f83e36128cec,2,22,0,22,2,2014-09-12 21:34:42,2014-09-12 21:33:48
ac1adfbe4a822a3347401f574e64f83e36128cec...31309d4722aa5e08d10733f8cf36d3184799044b,1,1,0,1,1,2014-09-13 07:47:14,2014-09-13 07:47:14
31309d4722aa5e08d10733f8cf36d3184799044b...4b8798cfb9465af1b65ec3cba7ee10b8f969a363,1,3,0,3,1,2014-09-13 13:22:26,2014-09-13 13:21:52
4b8798cfb9465af1b65ec3cba7ee10b8f969a363...d1190a164607941e6fbe726589c563860ca8741c,1,5,1,6,2,2014-09-13 13:23:40,2014-09-13 13:23:00
d1190a164607941e6fbe726589c563860ca8741c...563eaf04998da3ef88de4553f54eccd900a12805,8,83,5,88,6,2014-09-15 19:06:21,2014-09-15 16:17:28
563eaf04998da3ef88de4553f54eccd900a12805...68ab3b1ac1baa1509c8c31c124620849ad19c527,1,1,0,1,1,2014-09-16 00:28:49,2014-09-16 00:27:52
68ab3b1ac1baa1509c8c31c124620849ad19c527...04e7c7d51f832407c49c3abb3413fbfbdb410f6f,2,15,0,15,3,2014-09-16 10:24:01,2014-09-16 10:17:33
04e7c7d51f832407c49c3abb3413fbfbdb410f6f...3f6430d084097082ea02a8e49ce3e28c7b75582c,1,2,0,2,1,2014-09-16 12:32:55,2014-09-16 12:32:23
3f6430d084097082ea02a8e49ce3e28c7b75582c...722516536e0dd99690ab6df4c27bbceb29df4d5b,1,4,4,8,2,2014-09-17 07:23:20,2014-09-17 03:30:11
722516536e0dd99690ab6df4c27bbceb29df4d5b...fdcef1b86359b1c658b58fdfc6bfdebc11f830f6,1,3,1,4,2,2014-09-17 12:42:55,2014-09-17 12:37:27
fdcef1b86359b1c658b58fdfc6bfdebc11f830f6...40ce3efda20c4f30de234467c4595e44a65f37fe,1,28,14,42,2,2014-09-17 15:14:11,2014-09-17 15:13:27
40ce3efda20c4f30de234467c4595e44a65f37fe...d4c68c46aacbb151034baa321efe3d104e489e29,5,143,56,199,9,2014-09-17 15:18:10,2014-09-04 16:35:44
d4c68c46aacbb151034baa321efe3d104e489e29...07b4c3e115ba6cbd29d1b037f9a6bb774ca449a3,1,1,1,2,1,2014-09-19 11:05:48,2014-09-19 11:05:20
07b4c3e115ba6cbd29d1b037f9a6bb774ca449a3...c61d2c0387aeeaf5600b85c08b0d01b10655155c,1,2,2,4,4,2014-09-19 16:10:37,2014-09-17 23:45:42
c61d2c0387aeeaf5600b85c08b0d01b10655155c...a0a65b2fd21d3f09997ff1701cb44e32d6eb0f59,2,9,1,10,3,2014-09-19 16:12:48,2014-09-17 19:33:50
a0a65b2fd21d3f09997ff1701cb44e32d6eb0f59...e295b0f8757db9bca72c21c15e7db6003a96393d,1,1,1,2,1,2014-09-19 16:16:23,2014-09-18 16:41:58
e295b0f8757db9bca72c21c15e7db6003a96393d...aa9c69a726d1dc3035a7518c90519b2cdf5475f6,1,6,2,8,1,2014-09-19 16:21:43,2014-09-19 16:21:43
aa9c69a726d1dc3035a7518c90519b2cdf5475f6...988c7425ff038f0b8b1c7d5ea9e04fc70b2b01f8,1,2,1,3,2,2014-09-19 16:26:36,2014-09-19 16:26:36
988c7425ff038f0b8b1c7d5ea9e04fc70b2b01f8...0f52bf7c96e0b407a381bc4596f34cd01065f90d,3,4,4,8,3,2014-09-19 16:33:44,2014-09-19 16:31:15
0f52bf7c96e0b407a381bc4596f34cd01065f90d...b287676739849aae397969aef4e0e09e88cf8bdb,1,4,2,6,1,2014-09-19 19:05:56,2014-09-19 14:03:38
b287676739849aae397969aef4e0e09e88cf8bdb...17a4038cf3aad025c653342eb18882c38dbdb1a9,1,2,0,2,1,2014-09-19 19:06:11,2014-09-19 19:03:55
17a4038cf3aad025c653342eb18882c38dbdb1a9...8a782571333f21e83980411301a0c8cc2d59a0b7,1,6,4,10,1,2014-09-21 14:05:26,2014-09-21 14:00:19
8a782571333f21e83980411301a0c8cc2d59a0b7...02b3a6dcc0aef39f9174d4ac7a70679161de0962,1,8,8,16,6,2014-09-21 15:33:49,2014-09-21 15:15:44
02b3a6dcc0aef39f9174d4ac7a70679161de0962...99c2e40384ff74755145e05bd12f081316941e81,1,3,1,4,1,2014-09-21 16:34:08,2014-09-21 15:46:01
99c2e40384ff74755145e05bd12f081316941e81...f1d7fffc95fa60488db29a48f38c571978bdc608,2,24,23,47,5,2014-09-22 16:07:18,2014-09-22 10:37:07
f1d7fffc95fa60488db29a48f38c571978bdc608...1c1f418802503a78589171a540a4b795c5f53875,1,6,5,11,1,2014-09-22 19:24:48,2014-09-22 13:40:11
1c1f418802503a78589171a540a4b795c5f53875...09b5ff64b80b2a31dc32961df16e2d3f4b681235,1,58,107,165,16,2014-09-23 14:11:29,2014-09-23 14:11:15
09b5ff64b80b2a31dc32961df16e2d3f4b681235...58d7b84d53832a056128192c335127f10e082f2c,3,59,6,65,8,2014-09-23 14:11:58,2014-09-16 17:37:18
58d7b84d53832a056128192c335127f10e082f2c...991ec655b64a6284a09117a8474026d9a75bc963,3,25,0,25,3,2014-09-23 14:12:10,2014-09-17 05:34:10
991ec655b64a6284a09117a8474026d9a75bc963...b4c99203528b176fe3ebcf38002ef2c2ea723a7a,1,4,0,4,2,2014-09-24 00:01:59,2014-09-23 23:51:14
b4c99203528b176fe3ebcf38002ef2c2ea723a7a...cc74d8e02e8b659b914859d60002aaa47600f0ff,3,66,3,69,4,2014-09-24 10:33:07,2014-09-22 21:29:44
cc74d8e02e8b659b914859d60002aaa47600f0ff...ae14c75014379d1cf405509b65eb986c0cb3b0f3,4,25,5,30,7,2014-09-24 11:21:50,2014-09-23 21:17:00
ae14c75014379d1cf405509b65eb986c0cb3b0f3...bebdb026ceb659d5e86955f5ab07fd971040a878,1,6,4,10,1,2014-09-24 17:05:06,2014-09-24 13:57:07
bebdb026ceb659d5e86955f5ab07fd971040a878...40e5eb4114e66dfaacea162fc9f39c0618dcfad9,1,3,3,6,2,2014-09-24 17:30:23,2014-09-24 17:29:07
40e5eb4114e66dfaacea162fc9f39c0618dcfad9...cf78a0ccc39902f73a1e1540b59c3b6c89aa51f6,1,12,2,14,4,2014-09-24 18:19:43,2014-09-24 17:07:56
cf78a0ccc39902f73a1e1540b59c3b6c89aa51f6...5356183716daa88e5c0009b179de55370bd5c5da,1,8,0,8,1,2014-09-24 18:33:57,2014-09-24 17:08:45
5356183716daa88e5c0009b179de55370bd5c5da...02aa3e30e9cb8e5be5c33082c3548e2a6e1b91cb,5,90,33,123,10,2014-09-24 18:49:46,2014-09-15 15:17:12
02aa3e30e9cb8e5be5c33082c3548e2a6e1b91cb...d7b32d31205834262758ca5f48e5fe3a453f7ad3,6,5,66,71,4,2014-09-24 19:56:24,2014-09-24 19:49:30
d7b32d31205834262758ca5f48e5fe3a453f7ad3...b5d60927078743b68ee13795601c694a1d837e1c,1,3,3,6,1,2014-09-25 13:10:14,2014-09-25 13:09:12
b5d60927078743b68ee13795601c694a1d837e1c...00c2a721e20f6487571ed14b69aed620f474104c,3,89,47,136,26,2014-09-25 14:28:11,2014-09-08 00:26:12
00c2a721e20f6487571ed14b69aed620f474104c...1dec42822c76c10ca9c1dc939546758c0c11b1b7,8,132,5,137,14,2014-09-25 18:36:31,2014-09-23 18:13:59
1dec42822c76c10ca9c1dc939546758c0c11b1b7...e8a08514de6b97de1fce13b6c6b24cf72d1d60d9,3,21,3,24,7,2014-09-25 21:50:50,2014-09-25 18:21:12
e8a08514de6b97de1fce13b6c6b24cf72d1d60d9...692df414190b0cef0926bf50a758c222fefa6114,1,1,1,2,1,2014-09-25 22:02:40,2014-09-25 22:02:40
692df414190b0cef0926bf50a758c222fefa6114...9d7a4ea20510a2e35fdeac21d67f3f4c17634c25,5,117,8,125,8,2014-09-26 01:25:46,2014-09-18 11:42:51
9d7a4ea20510a2e35fdeac21d67f3f4c17634c25...d7bc30ffd26ebbe6d98fcd08d9120f44702d2a62,1,2,2,4,2,2014-09-26 17:08:26,2014-09-26 17:06:49
d7bc30ffd26ebbe6d98fcd08d9120f44702d2a62...091289d95039cfaa4a94cd40ac5055915f72971e,1,1,1,2,1,2014-09-26 17:24:09,2014-09-26 17:24:09
091289d95039cfaa4a94cd40ac5055915f72971e...7355885ef504cc34f447311741511018f777667f,3,12,1,13,3,2014-09-26 17:40:35,2014-09-26 17:01:34
7355885ef504cc34f447311741511018f777667f...f9e8da154225fb2829fda834f934d5e268fa7c83,1,1,1,2,1,2014-09-29 11:46:24,2014-09-29 03:40:31
f9e8da154225fb2829fda834f934d5e268fa7c83...f0e7a695f5c3723ccf171aefe1b3f0e47c09a28a,11,42,7,49,12,2014-09-29 22:17:13,2014-09-27 22:12:34
f0e7a695f5c3723ccf171aefe1b3f0e47c09a28a...4743a944295faccb494e31b7a805499bad2cedaa,1,1,1,2,1,2014-09-29 23:31:29,2014-09-29 23:31:29
4743a944295faccb494e31b7a805499bad2cedaa...e9c8aefbcee51d4c2fdda716450061ad7beaa01b,349,2528,1371,3899,1329,2014-09-30 18:51:54,2014-09-30 16:19:08
e9c8aefbcee51d4c2fdda716450061ad7beaa01b...74c38bad1d80ff94a973f4c4608011f45e80f2d9,1,9,9,18,9,2014-10-01 00:23:53,2014-10-01 00:06:01
74c38bad1d80ff94a973f4c4608011f45e80f2d9...b21ec1ab6e92c1d35edca4a71e01f928ef0e1656,1,1,1,2,1,2014-10-01 17:10:14,2014-10-01 14:24:46
b21ec1ab6e92c1d35edca4a71e01f928ef0e1656...adae2245726a8bcdcb7d4b35455fe7caacc435b6,1,20,0,20,1,2014-10-02 10:34:19,2014-10-02 10:19:18
adae2245726a8bcdcb7d4b35455fe7caacc435b6...ab8afafcc06b4d1f306459756a74eee3392b782d,1,23,0,23,1,2014-10-04 07:25:11,2014-10-04 07:25:11
ab8afafcc06b4d1f306459756a74eee3392b782d...d2f01afed0fb3357c68f2eb80b3add4651e2b279,1,1,1,2,1,2014-10-04 08:34:50,2014-10-04 08:34:50
d2f01afed0fb3357c68f2eb80b3add4651e2b279...154f5f0de108f428de2d5f488e0264f4459a4b66,1,1,1,2,1,2014-10-04 12:24:18,2014-10-03 13:49:28
154f5f0de108f428de2d5f488e0264f4459a4b66...0dbf366d90bb2e1403aede815e96d85ba989953f,1,1,1,2,1,2014-10-04 17:16:05,2014-10-04 17:13:54
0dbf366d90bb2e1403aede815e96d85ba989953f...e9609fb7a1758e5de10360d4f181a6e602658406,3,9,2,11,3,2014-10-06 12:24:07,2014-10-05 01:09:32
e9609fb7a1758e5de10360d4f181a6e602658406...f8d845910b17c119b7ed7fe8b448800bd39c17bc,8,37,5,42,12,2014-10-06 12:43:05,2014-10-05 18:06:51
f8d845910b17c119b7ed7fe8b448800bd39c17bc...2999bf055a121aaa8cc5da7e11fe513107e88f7d,1,7,3,10,5,2014-10-06 14:46:43,2014-10-06 12:59:04
2999bf055a121aaa8cc5da7e11fe513107e88f7d...082abce81e48fe9397cce096e13d5199c99adfe9,3,34,0,34,4,2014-10-06 17:14:11,2014-10-06 17:09:21
082abce81e48fe9397cce096e13d5199c99adfe9...b3569b3a825e82d25ffadf49f436c13f30a205f8,1,13,0,13,1,2014-10-06 17:30:33,2014-10-06 17:30:33
b3569b3a825e82d25ffadf49f436c13f30a205f8...c2508990cb53b52783ebb38dc0b5f0ab5d023c76,4,27,4,31,7,2014-10-06 17:44:01,2014-10-04 17:04:21
c2508990cb53b52783ebb38dc0b5f0ab5d023c76...96f022203a552fef19403c01b12fa6d30da560a0,3,28,1,29,6,2014-10-06 21:37:38,2014-10-06 20:07:20
96f022203a552fef19403c01b12fa6d30da560a0...dbd52f339cdae7fb57526cb86d45792438799e5b,1,1,1,2,1,2014-10-06 21:46:26,2014-10-06 21:44:58
dbd52f339cdae7fb57526cb86d45792438799e5b...fa4b6482df08d308fe88044b8c8bf981c6225fb8,6,159,5,164,10,2014-10-07 21:55:47,2014-10-07 20:27:31
fa4b6482df08d308fe88044b8c8bf981c6225fb8...b2f7b517e52b9b6b08e47e783f8b6a949b690dbb,1,12,5,17,1,2014-10-08 12:19:33,2014-10-08 12:19:11
b2f7b517e52b9b6b08e47e783f8b6a949b690dbb...d8306650071369ee9d7cad71120d13c22e900a10,3,11,2,13,4,2014-10-08 18:03:46,2014-08-21 11:53:22
d8306650071369ee9d7cad71120d13c22e900a10...e31be40f163e7d478946530acb1068c6deadb845,5,56,11,67,14,2014-10-09 15:39:17,2014-09-06 20:42:36
e31be40f163e7d478946530acb1068c6deadb845...71988ed953131908fa2a1ba9fac294cedaa6e6c9,9,256,36,292,36,2014-10-09 15:41:27,2014-10-06 23:53:21
71988ed953131908fa2a1ba9fac294cedaa6e6c9...fd3dccb8dd4a7ae0ce5e5e5af25452bfca4462a7,4,51,2,53,7,2014-10-10 17:12:26,2014-10-08 22:47:48
fd3dccb8dd4a7ae0ce5e5e5af25452bfca4462a7...625480cf0862f5998ed7e1e324087e58f8a740a7,1,0,5,5,1,2014-10-10 19:22:36,2014-10-10 19:18:54
625480cf0862f5998ed7e1e324087e58f8a740a7...d2a2af67f7c2c41a831acd33cd8cba5875c216cf,1,6,4,10,2,2014-10-12 12:02:27,2014-10-12 11:50:18
d2a2af67f7c2c41a831acd33cd8cba5875c216cf...bc13a08f89b4a9b7980588b013f358b2721c42a6,4,45,6,51,8,2014-10-12 20:03:01,2014-10-09 12:18:31
bc13a08f89b4a9b7980588b013f358b2721c42a6...6398ebab93a6a19afd1aee9cef120f052a801717,3,14,1,15,3,2014-10-13 15:39:23,2014-10-12 18:53:19
6398ebab93a6a19afd1aee9cef120f052a801717...555952c3e6fd0f4041ea7012d216641f6ffafe5b,1,4,1,5,1,2014-10-14 07:59:14,2014-10-14 07:26:13
555952c3e6fd0f4041ea7012d216641f6ffafe5b...da0ebe39f6ed1edc4043c97f6fd7e6872ba86508,2,30,25,55,5,2014-10-15 07:18:14,2014-10-14 21:15:43
da0ebe39f6ed1edc4043c97f6fd7e6872ba86508...813954f15a2256c05cd29740f55aa882322727a1,1,1,1,2,1,2014-10-15 22:56:00,2014-10-15 21:48:35
813954f15a2256c05cd29740f55aa882322727a1...b729ef0bda5009389da7e3a5498dc1f6233761d6,1,5,0,5,1,2014-10-16 14:54:35,2014-10-14 12:48:45
b729ef0bda5009389da7e3a5498dc1f6233761d6...e8262b59418d68d55a97a25567e4bc4f078ed3cb,4,83,9,92,11,2014-10-16 17:36:43,2014-10-14 13:10:27
e8262b59418d68d55a97a25567e4bc4f078ed3cb...a1a54b00d289579af9ff50dee46db12bae775f01,1,2,2,4,2,2014-10-16 23:42:05,2014-10-16 23:41:15
a1a54b00d289579af9ff50dee46db12bae775f01...0569e0dd74566603029dde791ed31436d42862b4,3,3,3,6,3,2014-10-17 00:02:23,2014-10-17 00:00:17
0569e0dd74566603029dde791ed31436d42862b4...a1578055e61e8815d1b6d445e8b24ad02d38c3ee,1,50,2,52,5,2014-10-17 01:58:31,2014-10-14 23:52:21
a1578055e61e8815d1b6d445e8b24ad02d38c3ee...55a5f0b49a7adca008076fa0af6f67ef64d575d8,1,3,0,3,1,2014-10-17 12:57:15,2014-10-17 12:56:39
55a5f0b49a7adca008076fa0af6f67ef64d575d8...37ab955d69ea541b4c66e225cc24dc0a2ee057be,1,7,7,14,3,2014-10-18 10:56:12,2014-10-17 20:01:42
37ab955d69ea541b4c66e225cc24dc0a2ee057be...a2ebbf891675d264a9fa6a9b2bcef976386b8da7,1,1,1,2,1,2014-10-19 23:20:28,2014-10-19 09:01:14
a2ebbf891675d264a9fa6a9b2bcef976386b8da7...417923c69ee93f1737517156b13beaefc81f1e0e,1,5,1,6,2,2014-10-20 14:52:36,2014-10-20 14:51:25
417923c69ee93f1737517156b13beaefc81f1e0e...3f3bed8fb9109783aaa15a700a811255b8640cea,3,111,1,112,6,2014-10-20 17:15:34,2014-10-14 14:20:24
3f3bed8fb9109783aaa15a700a811255b8640cea...117e97061093665a50bf35139e25e82da0afdf32,1,1,1,2,1,2014-10-20 17:17:00,2014-10-15 20:35:54
117e97061093665a50bf35139e25e82da0afdf32...53bc81dca3d785d0b399cacbf84cc660355895fc,3,19,3,22,7,2014-10-21 07:17:42,2014-10-20 20:32:43
53bc81dca3d785d0b399cacbf84cc660355895fc...d5a273eadb00ee3edd7e81d373b7237220b42571,6,46,35,81,11,2014-10-21 18:20:26,2014-10-18 10:00:38
d5a273eadb00ee3edd7e81d373b7237220b42571...0f9b4b5a904afac74dfc072e8c3ffa1a403b95ad,4,4,4,8,4,2014-10-22 16:24:13,2014-10-22 16:23:21
0f9b4b5a904afac74dfc072e8c3ffa1a403b95ad...c5780adeecfbd85a80b5aa7130dd86e78b23e497,1,1,1,2,1,2014-10-22 16:56:07,2014-10-22 16:56:07
c5780adeecfbd85a80b5aa7130dd86e78b23e497...c4092e8bde69d86f0f2eb51aa3d11d80882e924e,1,1,1,2,1,2014-10-22 17:29:56,2014-10-22 17:29:56
c4092e8bde69d86f0f2eb51aa3d11d80882e924e...81095a1ae52d16f0c29b789683ba898554e876d0,2,13,0,13,2,2014-10-22 17:39:27,2014-10-22 17:38:57
81095a1ae52d16f0c29b789683ba898554e876d0...7db89f79b33474f21f3a1b402e63d243976cc110,1,7,0,7,1,2014-10-22 18:12:47,2014-10-22 18:12:47
7db89f79b33474f21f3a1b402e63d243976cc110...41d5222a6a07586815cdf99399a71beca5900a6e,1,5,5,10,4,2014-10-23 12:04:17,2014-10-23 05:04:47
41d5222a6a07586815cdf99399a71beca5900a6e...f70a733abc7eb9b585e11be1167513d972f9d419,3,46,2,48,5,2014-10-23 12:51:08,2014-10-22 13:59:00
f70a733abc7eb9b585e11be1167513d972f9d419...ba6a599ce4e363cdce2d4cc439ce57436fb194fb,1,0,2,2,1,2014-10-23 12:51:14,2014-10-23 12:15:54
ba6a599ce4e363cdce2d4cc439ce57436fb194fb...7750fc8fa80470e4c10b3753667e04f78ebe4781,3,24,2,26,3,2014-10-23 18:35:55,2014-10-23 16:24:34
7750fc8fa80470e4c10b3753667e04f78ebe4781...69b5428c12c4b79434a0effdba42fc76296c63b5,1,1,1,2,1,2014-10-24 11:49:47,2014-10-23 20:00:33
69b5428c12c4b79434a0effdba42fc76296c63b5...17c09704abc06b06b5a47910769a5b82198075cd,1,2,2,4,1,2014-10-24 19:41:43,2014-10-24 04:01:25
17c09704abc06b06b5a47910769a5b82198075cd...6f2658aa34475db660accee58bfcf0bbbe7e09f6,1,9,12,21,3,2014-10-24 22:59:17,2014-10-24 22:58:31
6f2658aa34475db660accee58bfcf0bbbe7e09f6...03a20e5abd27c025c3175547d21ca31b9425e719,17,1,6226,6227,19,2014-10-25 12:20:04,2014-10-20 16:28:48
03a20e5abd27c025c3175547d21ca31b9425e719...7227ec8eccde8ea28addad6c276276cb1d2a6efe,2,14,15,29,14,2014-10-25 12:21:49,2014-10-24 19:35:20
7227ec8eccde8ea28addad6c276276cb1d2a6efe...7fa6781f818deea61cef4c13b139fa9586a6ca7a,3,54,3,57,4,2014-10-25 17:12:17,2014-10-22 16:16:32
7fa6781f818deea61cef4c13b139fa9586a6ca7a...b42930e4b7f344256cf5625d8b26c7626a354244,3,18,11,29,10,2014-10-27 08:17:31,2014-10-25 09:05:38
b42930e4b7f344256cf5625d8b26c7626a354244...e317d7fc7269061d12f71bf87d2f1b9e8da1ec8b,1,1,1,2,1,2014-10-27 10:44:18,2014-10-27 10:44:18
e317d7fc7269061d12f71bf87d2f1b9e8da1ec8b...5cc8180a651b11f00a0a05296f8db15db1e48cdc,8,71,3,74,6,2014-10-27 11:13:05,2014-10-27 11:03:05
5cc8180a651b11f00a0a05296f8db15db1e48cdc...6149a0ab1804e238551424585a346166186fad6f,1,3,3,6,1,2014-10-27 11:13:23,2014-10-27 11:07:23
6149a0ab1804e238551424585a346166186fad6f...af1c85e851b25c8a340af5973148c2987917a5d2,1,1,0,1,1,2014-10-27 11:13:47,2014-10-23 01:21:02
af1c85e851b25c8a340af5973148c2987917a5d2...abee4f718e6f08b523fc61fb812ef88d13a2e4b2,1,5,2,7,5,2014-10-27 12:19:57,2014-10-27 12:19:20
abee4f718e6f08b523fc61fb812ef88d13a2e4b2...6a1bd837b108d968d4cb552320ab4b7472f10c3f,3,12,1,13,3,2014-10-27 12:59:09,2014-10-27 08:35:01
6a1bd837b108d968d4cb552320ab4b7472f10c3f...0a4183dfe6a8508026f776b4e93fc7043186269b,1,1,1,2,1,2014-10-27 13:03:15,2014-10-27 13:01:12
0a4183dfe6a8508026f776b4e93fc7043186269b...a0cfd77971dc0e61427ca468e9b6ea9a548c796e,2,3,1,4,2,2014-10-27 15:10:35,2014-10-27 15:10:35
a0cfd77971dc0e61427ca468e9b6ea9a548c796e...dea3eefa728df4c3919e7d5115af351ba28c6e7f,1,1,1,2,1,2014-10-27 21:53:34,2014-10-27 21:16:39
dea3eefa728df4c3919e7d5115af351ba28c6e7f...b7231e39a41d1897e73832803e4ceeeda11615e5,1,11,5,16,2,2014-10-27 22:20:18,2014-10-27 22:17:50
b7231e39a41d1897e73832803e4ceeeda11615e5...9766ed6a0ef5c374ab9f43cdf0ad73b714f84d92,1,2,2,4,2,2014-10-27 23:49:50,2014-10-27 22:18:37
9766ed6a0ef5c374ab9f43cdf0ad73b714f84d92...d73c7e5db66b7c149db59e07bc4c6253629cf907,9,65,29,94,23,2014-10-29 12:01:35,2014-10-25 04:42:44
d73c7e5db66b7c149db59e07bc4c6253629cf907...bb42bab6d32aab3344b809e49c696a83d45a2954,2,10,0,10,2,2014-10-29 12:25:59,2014-10-28 12:10:45
bb42bab6d32aab3344b809e49c696a83d45a2954...21358e72253aac0d26af0cff2f597c1ab7bf151c,3,65,43,108,11,2014-10-29 17:16:23,2014-10-27 23:28:37
21358e72253aac0d26af0cff2f597c1ab7bf151c...92628cc98205373480d162634a13136e02a97bec,1,3,1,4,2,2014-10-29 17:39:18,2014-10-29 15:31:40
92628cc98205373480d162634a13136e02a97bec...9d1c5088bdd469e750e2f37caa392e0b956f80b2,1,8,6,14,7,2014-10-30 12:30:06,2014-10-30 10:27:19
9d1c5088bdd469e750e2f37caa392e0b956f80b2...cb952099f4aeac263501c185441872af06927606,1,32,11,43,5,2014-10-30 12:51:39,2014-10-30 11:57:22
cb952099f4aeac263501c185441872af06927606...d9bb7128fe7bc565a2dbbd1e89bb0345711b46f6,4,12,12,24,4,2014-10-30 13:08:01,2014-10-13 22:15:36
d9bb7128fe7bc565a2dbbd1e89bb0345711b46f6...ffd31c017f94234e1024a3345f601b020980aa47,2,3,1,4,2,2014-10-30 13:20:57,2014-10-29 00:40:02
ffd31c017f94234e1024a3345f601b020980aa47...9c9f35ed27d1762f8da5ac0683d350952debf709,2,5,1,6,2,2014-10-30 17:58:02,2014-10-30 17:52:42
9c9f35ed27d1762f8da5ac0683d350952debf709...79b67179278f7c8c9dfeb127bef439022bb88550,1,6,6,12,2,2014-10-30 18:46:27,2014-10-30 05:46:16
79b67179278f7c8c9dfeb127bef439022bb88550...aca514b7c4a9051d8a5eb4cebf3737ab01b98f40,1,1,1,2,1,2014-10-30 19:50:00,2014-10-30 19:49:30
aca514b7c4a9051d8a5eb4cebf3737ab01b98f40...30bd586a1c140216760ad89d4bd3170e9fdf26cf,1,8,3,11,1,2014-10-30 22:19:48,2014-10-30 19:45:01
30bd586a1c140216760ad89d4bd3170e9fdf26cf...ee2e09864d40f9781bf38d8048b1ddeb56baa089,1,5,5,10,3,2014-10-30 22:27:44,2014-10-30 22:26:13
ee2e09864d40f9781bf38d8048b1ddeb56baa089...01119c9c0f17387d2046bbd700835d85330d5151,1,2,19,21,2,2014-10-30 22:35:15,2014-10-30 22:34:10
01119c9c0f17387d2046bbd700835d85330d5151...f2de56223540c1e728c82baf206ffa6e6f285eab,1,4,2,6,2,2014-10-30 22:44:51,2014-10-30 22:42:54
f2de56223540c1e728c82baf206ffa6e6f285eab...31d1ccca3f5c793e6801e6b56b4af19d7a845e82,1,6,3,9,2,2014-10-30 23:04:34,2014-10-30 23:01:20
31d1ccca3f5c793e6801e6b56b4af19d7a845e82...12bace46c1ca089e075ac9a2aac142302967a1c5,4,12,17,29,12,2014-10-31 10:43:54,2014-10-31 10:38:53
12bace46c1ca089e075ac9a2aac142302967a1c5...40ad022d5e366f56424dcdb885607d13c00a550e,4,38,2,40,5,2014-10-31 17:30:56,2014-10-31 13:08:24
40ad022d5e366f56424dcdb885607d13c00a550e...c2cad66e4743afa28b3bf476e62aae29cc8abc47,1,6,0,6,1,2014-10-31 17:37:56,2014-10-31 17:34:41
c2cad66e4743afa28b3bf476e62aae29cc8abc47...e876c7f1ee4e0f071f7920b729829a3373ce2a9b,1,20,2,22,3,2014-10-31 19:40:34,2014-10-31 19:38:46
e876c7f1ee4e0f071f7920b729829a3373ce2a9b...17205a98ed0e4fb2a4ce9137508ee65efc448c07,3,33,1,34,5,2014-10-31 22:38:46,2014-10-31 13:04:46
17205a98ed0e4fb2a4ce9137508ee65efc448c07...3ac46d072675efcfd63c7fdcb4c816f9f1c18352,1,1,1,2,1,2014-11-01 16:37:26,2014-11-01 16:36:28
3ac46d072675efcfd63c7fdcb4c816f9f1c18352...74d0311d6b1fb3ab16072d5fad9de8b996e8af1c,1,15,2,17,2,2014-11-03 12:18:48,2014-11-03 09:46:38
74d0311d6b1fb3ab16072d5fad9de8b996e8af1c...12e5b87b89074cd0380ddcdadd24a6c621178c07,4,48,5,53,8,2014-11-03 13:59:17,2014-10-08 19:12:42
12e5b87b89074cd0380ddcdadd24a6c621178c07...d3e71a6daaf6f64e5efb45baf7b35269052d5d96,1,18,2,20,1,2014-11-03 14:00:34,2014-11-03 13:34:32
d3e71a6daaf6f64e5efb45baf7b35269052d5d96...378f94e39e566c915fe60e01f0ea7e52343513da,2,12,12,24,7,2014-11-03 15:51:23,2014-03-27 21:26:20
378f94e39e566c915fe60e01f0ea7e52343513da...6b32adda5935baa7cf99886c6c41a4eda358d2ef,20,27,27,54,27,2014-11-04 02:07:05,2014-11-03 22:48:03
6b32adda5935baa7cf99886c6c41a4eda358d2ef...c3b101fae5fb1218ebad78b3439a4b5ae1f05142,11,46,41,87,19,2014-11-04 02:43:21,2014-11-03 10:30:48
c3b101fae5fb1218ebad78b3439a4b5ae1f05142...d373e223bdb0722b1d7ff9c470f3bf562815507c,1,7,2,9,1,2014-11-04 12:27:53,2014-11-04 12:25:35
d373e223bdb0722b1d7ff9c470f3bf562815507c...e7ec0af6fc393d3d0022918c4d46d8975bb65367,1,2,2,4,2,2014-11-04 12:36:18,2014-11-04 12:35:42
e7ec0af6fc393d3d0022918c4d46d8975bb65367...109719a9cb8b2998f60c51819b3bb73fc2f0d3e9,5,199,72,271,42,2014-11-05 02:22:45,2014-11-05 01:38:38
109719a9cb8b2998f60c51819b3bb73fc2f0d3e9...0e03d4618be44e02321529814399d8e978d2a184,1,0,7,7,1,2014-11-05 09:06:20,2014-11-05 09:00:22
0e03d4618be44e02321529814399d8e978d2a184...77209e783ce085dd9642167cbd60089b742dd55e,1,3,4,7,1,2014-11-05 14:10:16,2014-11-05 14:09:25
77209e783ce085dd9642167cbd60089b742dd55e...1f50ea730e250acdc9f62f1ce1a769296fc20bb8,3,16,3,19,8,2014-11-06 14:31:30,2014-11-06 11:29:43
1f50ea730e250acdc9f62f1ce1a769296fc20bb8...3fb6e178572d72d7ed1d4637005bb0f62964c40e,1,1,1,2,1,2014-11-09 21:12:00,2014-11-09 21:10:31
3fb6e178572d72d7ed1d4637005bb0f62964c40e...c6d5f743713529537b3f5cbdf146c6222a635d5a,1,1,1,2,1,2014-11-10 14:39:04,2014-11-09 21:31:53
c6d5f743713529537b3f5cbdf146c6222a635d5a...7c44d4be34966761481c806d33ef9128a57ede21,1,1,1,2,1,2014-11-11 01:02:26,2014-11-11 00:47:47
7c44d4be34966761481c806d33ef9128a57ede21...3e0d7de8a6380c5747717cf32166864a22f258d5,1,7,3,10,3,2014-11-12 21:01:07,2014-11-12 21:00:48
3e0d7de8a6380c5747717cf32166864a22f258d5...606c57a132a1e1e680853c014efc41110ee75a80,4,36,15,51,7,2014-11-12 21:46:00,2014-11-12 20:18:11
606c57a132a1e1e680853c014efc41110ee75a80...d4bec655ae1c1122d7aea4bf8e58cc8a2b7bcc74,1,1,0,1,1,2014-11-13 09:08:17,2014-11-13 09:07:44
d4bec655ae1c1122d7aea4bf8e58cc8a2b7bcc74...2d12a599383efff4ac1914e4cc5cf3b08cb2ff53,3,28,1,29,4,2014-11-13 10:03:01,2014-11-05 02:57:47
2d12a599383efff4ac1914e4cc5cf3b08cb2ff53...4f5614d68ec6fa8520e80aacc27e0e30c376969b,2,0,8,8,2,2014-11-13 10:34:03,2014-11-13 09:30:36
4f5614d68ec6fa8520e80aacc27e0e30c376969b...99ae86d1d4d64e89026a53616b11e100362f8a95,1,3,6,9,2,2014-11-13 13:35:57,2014-11-13 13:34:47
99ae86d1d4d64e89026a53616b11e100362f8a95...1a73d6394eb738adb8b94e37bb1fbf879d948d18,1,7,0,7,1,2014-11-13 19:09:51,2014-11-13 16:56:29
1a73d6394eb738adb8b94e37bb1fbf879d948d18...cf5e2c46f2122c19c60f74299275f6fbcdd9144b,1,5,5,10,3,2014-11-13 19:10:40,2014-11-13 17:01:22
cf5e2c46f2122c19c60f74299275f6fbcdd9144b...b050dc46a9758e370c5b05ff25a133b741ffe465,1,3,0,3,1,2014-11-13 19:16:29,2014-11-13 17:16:20
b050dc46a9758e370c5b05ff25a133b741ffe465...3c2507c38629052ca9b266685b4763494b656947,1,6,0,6,2,2014-11-15 08:55:31,2014-11-15 08:06:37
3c2507c38629052ca9b266685b4763494b656947...d49c42e20e24df2f248f15ac902121c1cc554656,1,5,0,5,1,2014-11-15 16:44:29,2014-11-15 16:44:29
d49c42e20e24df2f248f15ac902121c1cc554656...7796f62c36555569125f8bb00cfb8b84b6da4eec,1,3,0,3,1,2014-11-15 19:06:13,2014-11-15 10:53:36
7796f62c36555569125f8bb00cfb8b84b6da4eec...42001e027c71d449bf6919a1758647e9901c32d8,1,9,5,14,3,2014-11-16 13:33:14,2014-11-15 19:31:09
42001e027c71d449bf6919a1758647e9901c32d8...b2534bfa7b3b4f9d5e6c4db48556d2ae6ba3b4a9,1,16,4,20,5,2014-11-16 13:36:08,2014-11-15 12:29:16
b2534bfa7b3b4f9d5e6c4db48556d2ae6ba3b4a9...5a6d6c5e0b70418ef0ead321879c88dc861e5538,1,1,1,2,1,2014-11-17 17:12:19,2014-11-17 17:10:50
5a6d6c5e0b70418ef0ead321879c88dc861e5538...4fbeec56313e4171e864b8c62f5548f82b8249f1,1,2,2,4,2,2014-11-17 17:34:36,2014-11-15 14:52:35
4fbeec56313e4171e864b8c62f5548f82b8249f1...49d409576713799813dc8830758ec801c6f32f89,2,14,14,28,24,2014-11-17 17:45:21,2014-11-15 16:25:45
49d409576713799813dc8830758ec801c6f32f89...03d983f7c39e8ba5b09d4000a234768715f8834f,3,16,8,24,7,2014-11-17 22:57:19,2014-11-17 18:04:38
03d983f7c39e8ba5b09d4000a234768715f8834f...229abe62fa9c269cd8dda19ba62b25714ce0ee15,1,1,0,1,1,2014-11-17 23:43:25,2014-11-17 23:42:54
229abe62fa9c269cd8dda19ba62b25714ce0ee15...dfcac7d7f5f1f108ae2c561f0f755f08d75a1c27,3,65,12,77,4,2014-11-18 08:20:04,2014-11-16 17:42:23
dfcac7d7f5f1f108ae2c561f0f755f08d75a1c27...50434aebe2d3307263ca55f6dd9fa7ace2f87d8f,3,4,4,8,3,2014-11-19 14:51:07,2014-11-18 12:25:03
50434aebe2d3307263ca55f6dd9fa7ace2f87d8f...ac359dc7710ed8c62b6f058fe5a0ecfd6ce27602,1,4,6,10,2,2014-11-19 22:56:25,2014-11-19 22:56:04
ac359dc7710ed8c62b6f058fe5a0ecfd6ce27602...03e8c182888e27c7609cbc7705a46ab7b7107f12,4,114,11,125,5,2014-11-19 23:15:05,2014-11-17 17:13:47
03e8c182888e27c7609cbc7705a46ab7b7107f12...2f8cd09a0654befa77dee3b32bbf82e231ff9e62,1,200,45,245,11,2014-11-19 23:25:00,2014-11-17 22:07:20
2f8cd09a0654befa77dee3b32bbf82e231ff9e62...1b8c067a4f7b022dabe4e0a068bc0836e46c822b,1,475,474,949,168,2014-11-19 23:25:00,2014-11-17 22:09:08
1b8c067a4f7b022dabe4e0a068bc0836e46c822b...593353d8af5b4b8d1a1e627712fe68ed593961d0,1,6,6,12,2,2014-11-20 14:35:29,2014-11-13 18:59:00
593353d8af5b4b8d1a1e627712fe68ed593961d0...2e2607870d6201f305e56ab4117bbce2fef63f17,1,1,1,2,1,2014-11-20 16:09:57,2014-11-20 15:35:36
2e2607870d6201f305e56ab4117bbce2fef63f17...01f2cf2aecc932d43b20b55fc19a8fa440457b5f,5,77,3,80,12,2014-11-20 18:53:28,2014-10-07 13:07:46
01f2cf2aecc932d43b20b55fc19a8fa440457b5f...145467a63688eb9055d176d84655cc029060da30,1,7,1,8,3,2014-11-20 19:44:05,2014-11-20 16:08:04
145467a63688eb9055d176d84655cc029060da30...feded19104b14bc28aaccf550265157df84593ba,3,24,11,35,3,2014-11-21 15:57:38,2014-11-15 14:43:06
feded19104b14bc28aaccf550265157df84593ba...910dcd574a4dff47abb78476e918fb6a9908cd23,1,5,5,10,1,2014-11-21 16:49:48,2014-11-21 16:43:39
910dcd574a4dff47abb78476e918fb6a9908cd23...f91c6ecc223dbed05f6640af515e8b56895170ac,3,26,3,29,4,2014-11-21 18:02:40,2014-11-18 17:58:43
f91c6ecc223dbed05f6640af515e8b56895170ac...4ea39230fc2c77cc091ebbbdb3d445920b299746,1,64,18,82,7,2014-11-21 20:07:45,2014-11-21 19:53:36
4ea39230fc2c77cc091ebbbdb3d445920b299746...cc5aa809e2519366e9df6581e5990ac4b41b0e24,1,1,1,2,1,2014-11-21 20:59:54,2014-11-21 20:58:53
cc5aa809e2519366e9df6581e5990ac4b41b0e24...45920594842e51c6a0ab2c31f7c69064f93d5161,1,2,10,12,1,2014-11-22 12:26:49,2014-11-22 11:20:17
45920594842e51c6a0ab2c31f7c69064f93d5161...8014001d9287d516c58be80ad71fb63593648b3d,7,26,19,45,21,2014-11-22 21:33:46,2014-11-22 21:30:14
8014001d9287d516c58be80ad71fb63593648b3d...2d06c112d1b737578cd54b9193fce20d3bf10a6f,7,19,26,45,21,2014-11-23 05:26:58,2014-11-23 05:26:58
2d06c112d1b737578cd54b9193fce20d3bf10a6f...22d292e23b1b60fd5c304b3d867ecf70860e7048,1,1,0,1,1,2014-11-23 22:08:13,2014-11-23 17:47:28
22d292e23b1b60fd5c304b3d867ecf70860e7048...e10c5a8fdda3753581f1e9e74bc3a2d6b1d34a9c,1,4,2,6,1,2014-11-24 10:17:27,2014-11-24 10:09:39
e10c5a8fdda3753581f1e9e74bc3a2d6b1d34a9c...60cf46fdf5176eb24ba4d47441ed24104f1493cc,2,25,0,25,2,2014-11-24 15:29:14,2014-11-15 11:13:05
60cf46fdf5176eb24ba4d47441ed24104f1493cc...9d0e61f04dc7fdb06572c46a45bb635ef889ce4b,1,28,3,31,2,2014-11-24 15:35:31,2014-11-24 15:31:41
9d0e61f04dc7fdb06572c46a45bb635ef889ce4b...014f699c8bc77da972990b767ab7a5582a8844e9,1,1,1,2,1,2014-11-24 15:46:28,2014-11-24 15:29:30
014f699c8bc77da972990b767ab7a5582a8844e9...78fe7ec14ff14130a99edb30584b0ffc49c8ec8c,3,12,9,21,6,2014-11-24 20:55:43,2014-11-21 14:26:46
78fe7ec14ff14130a99edb30584b0ffc49c8ec8c...299e7718cfbda4e0e1dabcfc96c37c71db83ac6d,1,2,0,2,1,2014-11-24 20:59:43,2014-11-24 20:58:56
299e7718cfbda4e0e1dabcfc96c37c71db83ac6d...3350531cebad22d9e65ae8ce791d92ae1de5437f,1,1,1,2,1,2014-11-25 12:51:58,2014-11-25 05:20:46
3350531cebad22d9e65ae8ce791d92ae1de5437f...f671905fdb678eb9fc3763d94bfe560b2d9d0b40,3,15,10,25,3,2014-11-25 16:27:30,2014-11-23 14:08:34
f671905fdb678eb9fc3763d94bfe560b2d9d0b40...f46ebc680b4868d61aec629ceded380ef313a687,1,6,0,6,2,2014-11-25 18:15:02,2014-11-25 18:13:45
f46ebc680b4868d61aec629ceded380ef313a687...2a20bccda984e6d516bba3eb7e8f307185754a3b,9,67,27,94,25,2014-11-25 18:32:24,2014-11-16 15:42:09
2a20bccda984e6d516bba3eb7e8f307185754a3b...8e3c3be32d0c39a31997b905ebf0490280baa347,2,71,16,87,7,2014-11-26 08:15:33,2014-11-26 08:03:10
8e3c3be32d0c39a31997b905ebf0490280baa347...87254532fba9605d1da8f134f07dfc11a4434200,1,3,0,3,1,2014-11-26 08:22:49,2014-11-26 08:22:04
87254532fba9605d1da8f134f07dfc11a4434200...5f79da581440dba6275f70e8a6ef440a32dbb895,1,37,2,39,3,2014-11-26 19:05:21,2014-11-26 03:48:36
5f79da581440dba6275f70e8a6ef440a32dbb895...6f65bd1cf08c7dff9581d9033a6d534f3202eb27,2,19,15,34,9,2014-11-27 00:36:04,2014-11-19 21:08:57
6f65bd1cf08c7dff9581d9033a6d534f3202eb27...8819f6f7c9ffb78a13ed3e19803d89b6637358c6,1,2,2,4,2,2014-11-27 10:57:54,2014-11-27 02:18:47
8819f6f7c9ffb78a13ed3e19803d89b6637358c6...e3ea5d4dad95a95de1f41893475a423a5e5c08d5,1,3,4,7,1,2014-11-27 15:54:09,2014-11-27 15:21:28
e3ea5d4dad95a95de1f41893475a423a5e5c08d5...3ac39bb63d6155c784690394d27bbdfc4b80f957,2,16,0,16,2,2014-11-27 16:23:43,2014-11-27 16:22:23
3ac39bb63d6155c784690394d27bbdfc4b80f957...25e0329fbed7f669868ecd1ac87cd40cc5e1eef5,1,0,12,12,1,2014-11-29 10:22:08,2014-11-29 10:15:37
25e0329fbed7f669868ecd1ac87cd40cc5e1eef5...d62e16fe46684f86dada90fb615651686945263d,1,1,1,2,1,2014-12-01 00:18:16,2014-12-01 00:08:46
d62e16fe46684f86dada90fb615651686945263d...ba3e97618696bdd68e4ac9b2220f58e6b3d15bd4,3,23,5,28,7,2014-12-01 21:00:36,2014-11-30 17:11:52
ba3e97618696bdd68e4ac9b2220f58e6b3d15bd4...943b1047de0cf20dad26a81182a7e6dcd86fc626,1,3,3,6,1,2014-12-01 21:01:18,2014-11-25 16:20:40
943b1047de0cf20dad26a81182a7e6dcd86fc626...bc5bb3e1a0fd8e4641eafa263e6e5871198fbff4,1,5,2,7,1,2014-12-01 22:04:44,2014-12-01 21:42:48
bc5bb3e1a0fd8e4641eafa263e6e5871198fbff4...3a42d9730cbb07ffbb983791e631f5d0a6746f68,3,14,1,15,3,2014-12-02 08:02:54,2014-12-01 10:13:01
3a42d9730cbb07ffbb983791e631f5d0a6746f68...ccc30ffe57e5f1e4dbda371b8a1d00c19a3150aa,5,92,7,99,12,2014-12-02 13:43:59,2014-11-27 18:34:14
ccc30ffe57e5f1e4dbda371b8a1d00c19a3150aa...2d0d6cadd41a132950e28fd08a99f72c085e0a42,2,5,2,7,3,2014-12-02 17:02:18,2014-12-02 14:12:33
2d0d6cadd41a132950e28fd08a99f72c085e0a42...0a70d63b0b7cced774270586768ccb5ccebbb7ca,1,2,2,4,2,2014-12-02 20:58:49,2014-12-02 20:57:08
0a70d63b0b7cced774270586768ccb5ccebbb7ca...de92c61e4043dc0d9cd9f7ea3725798e2017a8a5,1,1,1,2,1,2014-12-02 23:42:14,2014-11-20 16:58:24
de92c61e4043dc0d9cd9f7ea3725798e2017a8a5...e9975ed3cd3243d78b89fe2b44a152263ba5a602,3,28,14,42,4,2014-12-03 13:32:59,2014-12-03 01:52:58
e9975ed3cd3243d78b89fe2b44a152263ba5a602...99c0cc5300be21bd067aa9903b567ce64258942f,5,59,34,93,12,2014-12-03 18:42:02,2014-12-03 12:33:44
99c0cc5300be21bd067aa9903b567ce64258942f...38960a5dd8dc2f3a6b78439ecabc99507656934d,1,2,1,3,2,2014-12-03 19:09:23,2014-12-03 19:09:23
38960a5dd8dc2f3a6b78439ecabc99507656934d...5219a02fdadaaa76f1335f6a668c23dbf5790dac,4,41,0,41,3,2014-12-03 19:17:05,2014-12-03 14:44:09
5219a02fdadaaa76f1335f6a668c23dbf5790dac...82c0c7b34fa599ac24036121cc34cea1c0b954fb,1,1,1,2,1,2014-12-03 23:44:06,2014-12-03 22:13:36
82c0c7b34fa599ac24036121cc34cea1c0b954fb...48bd44670b4c58735d5cdf6762d6b61219ecbb12,1,11,0,11,1,2014-12-04 00:19:28,2014-11-30 23:02:43
48bd44670b4c58735d5cdf6762d6b61219ecbb12...e8c88c93ecb9cedebee90d55acc8a42649720ae0,1,2,2,4,2,2014-12-04 01:10:28,2014-12-04 01:07:40
e8c88c93ecb9cedebee90d55acc8a42649720ae0...d57124433f0d0f2bf61ea4e14962f3b663ab20c7,4,23,3,26,5,2014-12-04 15:59:05,2014-12-04 14:11:30
d57124433f0d0f2bf61ea4e14962f3b663ab20c7...6ba960266a14756dbf6365029d46bd157bd2b155,4,107,31,138,13,2014-12-04 20:39:32,2014-12-04 16:56:11
6ba960266a14756dbf6365029d46bd157bd2b155...58e0d6bdbc2f7db6c7377bcdaa3d4bd23f119d15,1,1,1,2,2,2014-12-05 16:33:16,2014-12-05 15:23:14
58e0d6bdbc2f7db6c7377bcdaa3d4bd23f119d15...6a94c97729591ba929885c713964304a773969a2,1,1,1,2,1,2014-12-05 18:17:36,2014-12-05 18:17:14
6a94c97729591ba929885c713964304a773969a2...01e117abf054176577b549165e240e2402e2e344,1,1,1,2,1,2014-12-06 11:47:42,2014-12-06 11:46:39
01e117abf054176577b549165e240e2402e2e344...00018642c958e529cac4563b68fd2d18ce59326b,1,1,1,2,1,2014-12-06 14:23:37,2014-12-06 12:56:43
00018642c958e529cac4563b68fd2d18ce59326b...a80e4817a78589a52164020e13ae677dc60f2208,1,1,1,2,1,2014-12-06 14:26:16,2014-12-05 18:02:59
a80e4817a78589a52164020e13ae677dc60f2208...284496e6929e9ec42ee711db1ae1e7d1cb95d063,1,3,2,5,1,2014-12-06 16:52:22,2014-12-06 16:51:32
284496e6929e9ec42ee711db1ae1e7d1cb95d063...991f523753baff73b32859c906649767a2bc8061,1,2,2,4,2,2014-12-07 10:54:04,2014-12-07 09:26:21
991f523753baff73b32859c906649767a2bc8061...44527ac346df590bfc42075d06e7bf0885bd9eda,1,1,1,2,1,2014-12-07 17:25:46,2014-12-06 21:49:59
44527ac346df590bfc42075d06e7bf0885bd9eda...614cbf1c3c5010d0180deac6d335b37d174c89ec,1,2,1,3,1,2014-12-08 12:20:00,2014-12-07 20:02:19
614cbf1c3c5010d0180deac6d335b37d174c89ec...b249d4dcc780a99e1cfc8d1ef09f6643e7262350,1,6,1,7,4,2014-12-08 12:24:07,2014-12-07 23:34:03
b249d4dcc780a99e1cfc8d1ef09f6643e7262350...4862eb6e5b6dae63e5c156fa1095c5b87503620b,1,7,0,7,1,2014-12-08 17:58:26,2014-12-08 15:49:35
4862eb6e5b6dae63e5c156fa1095c5b87503620b...6022da4f48a1c3fd019aac52b3fe9b804b1746f9,1,6,4,10,2,2014-12-08 18:18:23,2014-12-08 18:15:46
6022da4f48a1c3fd019aac52b3fe9b804b1746f9...da562d6a8785d28b75475c1c3d1eb5987253bc35,1,2,2,4,1,2014-12-09 12:31:33,2014-12-09 12:26:57
da562d6a8785d28b75475c1c3d1eb5987253bc35...491bf20d190b88ec64b9e9c6579d0bd165925677,1,1,1,2,1,2014-12-11 17:12:33,2014-12-11 15:19:10
491bf20d190b88ec64b9e9c6579d0bd165925677...f446acf8bbd6360fdb5a9d34186c5fadf98282b7,3,28,1,29,3,2014-12-11 18:28:57,2014-12-11 16:52:42
f446acf8bbd6360fdb5a9d34186c5fadf98282b7...63d8f84e5d48d5b36f8cc3a32aaaa6d07cf5ecaf,1,1,1,2,1,2014-12-11 18:40:05,2014-12-11 18:28:13
63d8f84e5d48d5b36f8cc3a32aaaa6d07cf5ecaf...a189e9f0d03bfdbf5008533358c2941f15b86d58,2,2,1,3,2,2014-12-11 19:44:27,2014-12-11 19:43:47
a189e9f0d03bfdbf5008533358c2941f15b86d58...4b96e862b4674e85d1a28f2849685aa3135bc557,3,23,1,24,3,2014-12-12 13:50:38,2014-12-08 22:37:59
4b96e862b4674e85d1a28f2849685aa3135bc557...c64286c62b5960387d5e8fc3e28cd37662bda6cb,3,22,0,22,3,2014-12-12 16:49:44,2014-12-04 13:22:45
c64286c62b5960387d5e8fc3e28cd37662bda6cb...f8b4cf4022aae460d7bbfb9510858baf37ae6c15,3,7,15,22,6,2014-12-12 20:09:04,2014-12-11 19:36:13
f8b4cf4022aae460d7bbfb9510858baf37ae6c15...b37607193639e25a6c630e8d1b3d3bca0833a652,1,20,0,20,1,2014-12-12 20:09:59,2014-12-11 19:51:04
b37607193639e25a6c630e8d1b3d3bca0833a652...0a8b911582eee85ea6da0d40dd2c7b12de5a78b2,4,10,6,16,5,2014-12-12 20:13:57,2014-12-12 00:28:03
0a8b911582eee85ea6da0d40dd2c7b12de5a78b2...e905d4984dbaca7e9175205d64ef8794fa7ded12,1,4,1,5,1,2014-12-13 18:42:45,2014-12-13 18:41:31
e905d4984dbaca7e9175205d64ef8794fa7ded12...9189ef438ef885446b20bf4c017d3cf53335ab08,1,5,0,5,1,2014-12-13 20:57:25,2014-12-13 20:54:28
9189ef438ef885446b20bf4c017d3cf53335ab08...eb632bfba51263f9a91e1699be25dac7b7bab53e,3,12,9,21,10,2014-12-14 15:47:06,2014-12-14 15:43:27
eb632bfba51263f9a91e1699be25dac7b7bab53e...1690b92b0d53e625ef6623a317149013725015af,3,31,2,33,3,2014-12-15 18:42:08,2014-12-15 14:14:39
1690b92b0d53e625ef6623a317149013725015af...4cc646bb56693c8068044ed3b8d5eeb69adde088,1,2,2,4,2,2014-12-15 18:43:34,2014-12-15 18:42:52
4cc646bb56693c8068044ed3b8d5eeb69adde088...fdf4dc6cea0cdfea061f2d72a368adf6a8d24157,3,59,2,61,4,2014-12-15 19:58:01,2014-12-06 20:43:19
fdf4dc6cea0cdfea061f2d72a368adf6a8d24157...66c0529b3edb40e25713cbf32ea8794befc829ae,1,1,1,2,1,2014-12-15 23:20:41,2014-12-15 23:15:55
66c0529b3edb40e25713cbf32ea8794befc829ae...10482faf1996e654cb9849d7c0065841ad2adf35,3,14,0,14,4,2014-12-16 15:56:35,2014-12-16 00:22:28
10482faf1996e654cb9849d7c0065841ad2adf35...c085bea6c34979b9acc3108afd018cb391557002,4,25,1,26,4,2014-12-16 23:39:19,2014-12-09 13:43:40
c085bea6c34979b9acc3108afd018cb391557002...ebfb1dab26783b2d41212908d2e7994dcbb9421b,1,2,2,4,2,2014-12-17 00:01:06,2014-12-16 23:53:31
ebfb1dab26783b2d41212908d2e7994dcbb9421b...a38951948a62c0d51a8b50a599f17e590f750bf5,4,38,23,61,11,2014-12-17 13:24:27,2014-12-17 13:01:19
a38951948a62c0d51a8b50a599f17e590f750bf5...6d8c14621e2878ea2051ee56326c66969a1d18d0,4,31,12,43,10,2014-12-17 14:16:05,2014-12-14 03:22:37
6d8c14621e2878ea2051ee56326c66969a1d18d0...47912d9f2b8f55044aef5b8ed9b006e8dd8ce976,3,41,0,41,5,2014-12-17 17:41:12,2014-12-17 16:25:28
47912d9f2b8f55044aef5b8ed9b006e8dd8ce976...c2d8da7555e3fef30c43f3ffe2e8963ca1f9fdd5,1,5,5,10,1,2014-12-18 16:34:11,2014-12-18 16:34:11
c2d8da7555e3fef30c43f3ffe2e8963ca1f9fdd5...2f13a48f333ff6f4bf1fd6c22c082cd0e9120ed8,1,3,3,6,1,2014-12-18 16:56:50,2014-12-18 16:55:33
2f13a48f333ff6f4bf1fd6c22c082cd0e9120ed8...f46a16614d0a8339362ed7a48eef8f1914f96c85,3,20,26,46,6,2014-12-18 20:14:29,2014-06-20 12:32:11
f46a16614d0a8339362ed7a48eef8f1914f96c85...a970d6d941c849eba482b6a4b254c28f5e15524c,1,4,5,9,2,2014-12-19 11:57:50,2014-12-19 04:52:01
a970d6d941c849eba482b6a4b254c28f5e15524c...ea1865223886295674422923a2a9d38bacb0564d,1,12,3,15,5,2014-12-19 19:26:46,2014-12-18 20:39:15
ea1865223886295674422923a2a9d38bacb0564d...c24624025bf7fe741a882e79b892055688245cc2,1,3,1,4,1,2014-12-20 00:12:50,2014-12-20 00:11:52
c24624025bf7fe741a882e79b892055688245cc2...1ad5deedd4c51729be680e3c2730c2ef5ab4f831,5,24,7,31,12,2014-12-22 12:26:57,2014-12-16 23:30:26
1ad5deedd4c51729be680e3c2730c2ef5ab4f831...66e91543998bdece82d9c154dced1a62824e228b,1,1,1,2,2,2014-12-22 12:51:09,2014-12-20 20:02:26
66e91543998bdece82d9c154dced1a62824e228b...4c92ecd70592a7f64d8890ce2b0d67017512636a,1,3,2,5,1,2014-12-22 16:35:57,2014-12-22 01:54:42
4c92ecd70592a7f64d8890ce2b0d67017512636a...ac098867c004b7336aac30d0689e70fbd73a7306,2,13,6,19,3,2014-12-22 20:19:48,2014-12-22 20:13:47
ac098867c004b7336aac30d0689e70fbd73a7306...51ea30a43bafad40b4a24ad0be346796a9c7ab6a,4,43,17,60,10,2014-12-23 19:26:56,2014-12-23 17:27:49
51ea30a43bafad40b4a24ad0be346796a9c7ab6a...126eb58abef119b799f81bd3626cb777910847cf,2,12,7,19,5,2014-12-23 19:40:35,2014-12-23 13:38:34
126eb58abef119b799f81bd3626cb777910847cf...b9169a100d4a836e3401395dc1e5bf120a36887d,2,24,2,26,2,2014-12-24 20:07:27,2014-12-24 19:15:48
b9169a100d4a836e3401395dc1e5bf120a36887d...1173140dbf5604241209b2df3d6123adbe6e9e36,2,3,2,5,3,2014-12-26 20:57:30,2014-12-26 20:27:11
1173140dbf5604241209b2df3d6123adbe6e9e36...2af33a0719e02806598c85deed9817c564b6817f,1,3,1,4,3,2014-12-26 23:29:52,2014-12-26 22:48:18
2af33a0719e02806598c85deed9817c564b6817f...322560489b2d2f873c7b8bd7799efd7cf80fb28b,3,39,12,51,15,2014-12-27 14:12:17,2014-12-27 11:36:44
322560489b2d2f873c7b8bd7799efd7cf80fb28b...965a999ae5a03ca595f3842feacfbce5dc12f20a,1,55,6,61,5,2014-12-27 15:26:43,2014-11-29 08:36:39
965a999ae5a03ca595f3842feacfbce5dc12f20a...a79012f6d88a8cd67bd35c54b91d826f2b7a4cb2,3,10,7,17,7,2014-12-27 15:29:21,2014-12-27 14:06:38
a79012f6d88a8cd67bd35c54b91d826f2b7a4cb2...b429a9796a162f9e12e6d34579468621ba9accc7,3,22,1,23,4,2014-12-27 17:17:18,2014-12-23 20:49:05
b429a9796a162f9e12e6d34579468621ba9accc7...3483682749577b4b5a8141a766489d5b460e30e9,6,49,13,62,16,2014-12-27 17:26:20,2014-12-23 21:29:01
3483682749577b4b5a8141a766489d5b460e30e9...1cbdb49b0aaba726435db55c4d71dc6a8ade1d2b,1,2,1,3,1,2014-12-28 00:51:33,2014-12-28 00:49:16
1cbdb49b0aaba726435db55c4d71dc6a8ade1d2b...1702bc52cc20ed0729893177fc8f4391b4b3183c,3,123,80,203,12,2014-12-29 18:42:29,2014-12-02 18:25:46
1702bc52cc20ed0729893177fc8f4391b4b3183c...79645529e7ce03a7eef1e51e7058a9880f83efb5,3,77,120,197,9,2014-12-29 20:37:15,2014-12-29 20:35:03
79645529e7ce03a7eef1e51e7058a9880f83efb5...a9da5dd5b6f722a230a69211ad8e00a20cafcd38,3,26,23,49,7,2014-12-30 13:31:18,2014-12-29 21:23:18
a9da5dd5b6f722a230a69211ad8e00a20cafcd38...d49b5851b45cee5471aef37d2b301e3084f94e08,1,19,0,19,2,2014-12-30 15:03:41,2014-12-29 19:48:04
d49b5851b45cee5471aef37d2b301e3084f94e08...9311a94ca50ac86f9c945922c212c6e605d2d90a,2,6,7,13,3,2014-12-30 16:53:33,2014-12-30 16:50:50
9311a94ca50ac86f9c945922c212c6e605d2d90a...f1a22feaa877e4ff655db7014557112274419898,1,4,4,8,3,2014-12-31 13:02:06,2014-12-31 05:21:32
f1a22feaa877e4ff655db7014557112274419898...e11ff3975f69b96521d94417bbe4125f4abb2774,3,53,4,57,6,2014-12-31 14:42:07,2014-11-15 13:45:00
e11ff3975f69b96521d94417bbe4125f4abb2774...c0bed63889b86f821f76133251566eafb70065f1,1,1,1,2,1,2014-12-31 14:51:10,2014-12-31 14:49:03
c0bed63889b86f821f76133251566eafb70065f1...4abfa73c1861c53d43f0448726346866b04b9b72,4,2,2,4,2,2014-12-31 16:33:27,2014-12-31 16:25:11
4abfa73c1861c53d43f0448726346866b04b9b72...8de2a44064ca11749579a5887f59821fa35e1fdc,3,31,3,34,4,2014-12-31 19:46:17,2014-12-23 15:51:36
8de2a44064ca11749579a5887f59821fa35e1fdc...f461bc02cbfa7c04748e4b2392586fa3835330b1,2,4,1,5,2,2014-12-31 22:27:43,2014-12-31 22:26:15
f461bc02cbfa7c04748e4b2392586fa3835330b1...8e68b590abd22dc46e8aa3c963c32713755f6172,1,3,3,6,1,2015-01-01 16:40:08,2015-01-01 16:38:53
8e68b590abd22dc46e8aa3c963c32713755f6172...1b8346439180ac443e397fcb176879680882f75c,1,0,4,4,1,2015-01-01 18:36:26,2014-12-26 18:48:13
1b8346439180ac443e397fcb176879680882f75c...fda458c0b6902c248e84c5cde03ff5f4a4dce665,5,87,35,122,21,2015-01-02 18:23:18,2015-01-02 17:35:41
fda458c0b6902c248e84c5cde03ff5f4a4dce665...20dcf5155b0cefca3412a28fd550757766878b9a,4,4,4,8,4,2015-01-03 00:20:44,2015-01-03 00:20:18
20dcf5155b0cefca3412a28fd550757766878b9a...880d7638cf66ed28a60b62335ccfc5dfd5052937,2,2,2,4,2,2015-01-03 00:44:36,2015-01-03 00:44:36
880d7638cf66ed28a60b62335ccfc5dfd5052937...f7ec788bf5b5e14068c1be8e6b9dc006152ba8af,1,1,1,2,1,2015-01-03 02:48:54,2015-01-03 02:48:54
f7ec788bf5b5e14068c1be8e6b9dc006152ba8af...5f8761c6396f0d27b8948f55700ec176fedbf5d5,1,6,6,12,1,2015-01-03 13:48:59,2015-01-03 09:41:42
5f8761c6396f0d27b8948f55700ec176fedbf5d5...01487684123342f052e139291175f4ea3d11a09b,2,84,0,84,2,2015-01-03 17:07:28,2015-01-01 03:16:51
01487684123342f052e139291175f4ea3d11a09b...0a06ae9ef383ba00d7c30453e5d7d897506de842,2,15,0,15,2,2015-01-03 18:27:46,2015-01-03 18:27:08
0a06ae9ef383ba00d7c30453e5d7d897506de842...4aed731154b12e2948ee2b6a8baa5083840a343b,3,11,6,17,6,2015-01-03 18:36:13,2015-01-03 18:36:13
4aed731154b12e2948ee2b6a8baa5083840a343b...0e21fd4e4048718fe065a8ff080c1d0df8173883,2,15,0,15,2,2015-01-05 19:25:36,2015-01-05 19:24:34
0e21fd4e4048718fe065a8ff080c1d0df8173883...d8fb557a519a419a53d648ce1ef12dad8673151f,3,13,1,14,3,2015-01-06 07:45:10,2015-01-05 17:23:57
d8fb557a519a419a53d648ce1ef12dad8673151f...5e18f6f724dda3f6462c92f825b31b2e423f4e7c,1,2,2,4,1,2015-01-06 08:00:27,2015-01-06 07:56:53
5e18f6f724dda3f6462c92f825b31b2e423f4e7c...557c514f900b1280cfd4a892be893dd4c338ae74,1,10,6,16,2,2015-01-08 14:09:24,2015-01-07 23:49:02
557c514f900b1280cfd4a892be893dd4c338ae74...600ea43e6735cfc035dc4a17ab23fd7927f1f9ee,1,5,0,5,1,2015-01-08 14:43:40,2015-01-08 14:43:40
600ea43e6735cfc035dc4a17ab23fd7927f1f9ee...bbcbacf0ad4fc9aa89d13c35f4b084185b284a49,1,1,1,2,1,2015-01-08 14:44:21,2015-01-08 14:44:21
bbcbacf0ad4fc9aa89d13c35f4b084185b284a49...7e65876b7c34d0c43c94ba01543a0050270a34fe,6,50,9,59,15,2015-01-10 09:13:50,2015-01-09 21:18:34
7e65876b7c34d0c43c94ba01543a0050270a34fe...1a352fe1751cb1ec1dc2977e72cac9dc9b770bc1,2,27,11,38,5,2015-01-10 16:11:57,2015-01-09 22:05:58
1a352fe1751cb1ec1dc2977e72cac9dc9b770bc1...ef5889409bba675499dfd38831358daba16811ab,3,45,26,71,11,2015-01-10 23:35:49,2015-01-10 14:18:06
ef5889409bba675499dfd38831358daba16811ab...6a08020fcff3681202047ba002c700fedebc6e74,1,1,1,2,1,2015-01-13 16:53:59,2015-01-13 16:28:43
6a08020fcff3681202047ba002c700fedebc6e74...33f1ccf5b1a928b8680e25b3e419834d139e04e8,4,11,2,13,4,2015-01-13 18:02:55,2014-11-25 22:06:31
33f1ccf5b1a928b8680e25b3e419834d139e04e8...41b4bc73ee0da7b2e09f4af47fc1fd21144c710f,6,165,1,166,6,2015-01-13 18:02:56,2014-09-10 17:06:19
41b4bc73ee0da7b2e09f4af47fc1fd21144c710f...de67dedc771ad2edec15c1d00c083a1a084e1e89,5,45,1,46,5,2015-01-13 18:02:56,2014-12-03 21:14:00
de67dedc771ad2edec15c1d00c083a1a084e1e89...818e59a3f0fbadf6c447754d202d88df025f8f2a,6,59,2,61,8,2015-01-13 18:02:56,2014-12-09 20:32:03
818e59a3f0fbadf6c447754d202d88df025f8f2a...bcfb47780ce7caecb409a9e9c1c314266e41d392,5,63,5,68,8,2015-01-13 18:02:56,2014-12-11 13:31:03
bcfb47780ce7caecb409a9e9c1c314266e41d392...9b403a108cfd1e63b5a99174c65c65fc41116d6e,3,3,3,6,3,2015-01-13 18:09:34,2015-01-13 18:08:57
9b403a108cfd1e63b5a99174c65c65fc41116d6e...6bf1930fb5c7c6a47992ff368e21c58f4f14b402,1,1,1,2,1,2015-01-13 18:11:37,2015-01-13 18:11:37
6bf1930fb5c7c6a47992ff368e21c58f4f14b402...f7ce66bc466e04249fbdc66048c3de6f605fddb1,1,1,1,2,1,2015-01-13 19:14:05,2015-01-13 19:14:05
f7ce66bc466e04249fbdc66048c3de6f605fddb1...2e2617991a6f446defc755c6b73e6e9db865f197,2,13,0,13,2,2015-01-14 14:48:06,2015-01-14 14:47:29
2e2617991a6f446defc755c6b73e6e9db865f197...02c059ff7f282e541629a67e25a70a292cc01d87,1,2,1,3,1,2015-01-14 18:57:10,2015-01-14 18:46:15
02c059ff7f282e541629a67e25a70a292cc01d87...478546fcef38d95866a92bc44d10e15b26c7254c,6,65,3,68,12,2015-01-14 19:37:56,2015-01-12 01:52:22
478546fcef38d95866a92bc44d10e15b26c7254c...327703c0672b705f264d2611aacbe2ce9795749b,1,3,0,3,1,2015-01-15 08:29:00,2015-01-15 08:24:54
327703c0672b705f264d2611aacbe2ce9795749b...b419bd38431b83eec93376cd911e2b17eb8e7342,2,4,4,8,4,2015-01-15 20:13:27,2015-01-15 20:07:39
b419bd38431b83eec93376cd911e2b17eb8e7342...065b2a82f6d7539032e15308351fa5eee95c0cb9,3,50,0,50,3,2015-01-16 01:43:49,2015-01-15 14:56:07
065b2a82f6d7539032e15308351fa5eee95c0cb9...bd08cfca6ff04e7cec940f5b59e97cdcceddcc69,4,10,5,15,6,2015-01-16 14:42:03,2015-01-13 08:02:17
bd08cfca6ff04e7cec940f5b59e97cdcceddcc69...433e7dd5076e492290a90130c9b3e2b1319b2f95,1,6,1,7,2,2015-01-16 15:31:49,2015-01-16 15:31:49
433e7dd5076e492290a90130c9b3e2b1319b2f95...cef3f805c21c029d017e6704565f9f2f5746a1e5,1,9,9,18,2,2015-01-16 17:03:15,2015-01-16 16:41:14
cef3f805c21c029d017e6704565f9f2f5746a1e5...be0bc9a9e7ad4421cea4aeebf274278e256d1a62,1,1,1,2,1,2015-01-16 23:24:48,2015-01-16 22:50:37
be0bc9a9e7ad4421cea4aeebf274278e256d1a62...5f600db37a61be24cfe75bb2f327bb7bb57a468c,1,8,1,9,2,2015-01-17 14:31:59,2015-01-17 14:30:52
5f600db37a61be24cfe75bb2f327bb7bb57a468c...467fd7ea1afe6d80735af73ece45eaa61d9ff3c5,1,2,10,12,3,2015-01-17 15:54:34,2015-01-17 15:54:34
467fd7ea1afe6d80735af73ece45eaa61d9ff3c5...85c0eb1e3baf09d79d463a20fedc3fbded3093f9,1,6,8,14,2,2015-01-17 17:52:34,2015-01-17 17:49:16
85c0eb1e3baf09d79d463a20fedc3fbded3093f9...29737a2949e9b56df03dae3f84fccd8fe0443358,1,52,60,112,11,2015-01-17 19:45:41,2015-01-16 23:51:31
29737a2949e9b56df03dae3f84fccd8fe0443358...ecbe20fe20ddc54aa034530b38a73195ee3f598d,1,2,0,2,1,2015-01-17 23:18:06,2015-01-17 23:11:47
ecbe20fe20ddc54aa034530b38a73195ee3f598d...eea66a6e97f9c3392cf24b971c15a6a7ea634202,1,2,0,2,1,2015-01-18 00:16:41,2015-01-18 00:14:44
eea66a6e97f9c3392cf24b971c15a6a7ea634202...4df91d05e8ffca15f58d09d9fd0f0ae16891565b,1,18,7,25,12,2015-01-18 18:43:47,2015-01-18 18:40:21
4df91d05e8ffca15f58d09d9fd0f0ae16891565b...e8191caca5fcfb819d19620d7feaac328417a3c3,3,18,5,23,6,2015-01-18 18:45:40,2015-01-18 18:29:33
e8191caca5fcfb819d19620d7feaac328417a3c3...af523573fc523cf5afba24b178f4b6bded6f1def,2,7,1,8,2,2015-01-18 21:07:48,2015-01-18 21:06:56
af523573fc523cf5afba24b178f4b6bded6f1def...bc3021b93bb8a5fc8176c18f5c8b820068a86366,1,1,1,2,1,2015-01-19 01:48:47,2015-01-19 01:02:15
bc3021b93bb8a5fc8176c18f5c8b820068a86366...07bd23d3297c214d9119e4e4ed421184597863c5,2,29,7,36,6,2015-01-19 02:26:19,2015-01-19 02:23:06
07bd23d3297c214d9119e4e4ed421184597863c5...bb2b4acc7a8435e204b772954995487e87866ef9,2,10,0,10,2,2015-01-19 15:45:55,2015-01-18 19:30:07
bb2b4acc7a8435e204b772954995487e87866ef9...db2a97870d74bc689428d9c2a942115ef799f2d2,4,128,15,143,8,2015-01-19 16:25:05,2015-01-19 14:31:23
db2a97870d74bc689428d9c2a942115ef799f2d2...3e803f9cbd58f6558066af4a6b54e1b71063ee4a,1,5,1,6,1,2015-01-19 17:08:20,2015-01-19 17:08:20
3e803f9cbd58f6558066af4a6b54e1b71063ee4a...7a1ccc069971277d74fde143966de3f3d24c9a91,2,5,3,8,5,2015-01-19 20:41:29,2015-01-19 20:12:57
7a1ccc069971277d74fde143966de3f3d24c9a91...70845c6809f53d9d4029d760aa0118a47b92cb9d,1,26,24,50,18,2015-01-20 16:46:37,2015-01-20 10:39:23
70845c6809f53d9d4029d760aa0118a47b92cb9d...7b677fe063910e67dbeb123fcd164305e0425f34,1,1,1,2,1,2015-01-20 16:57:00,2015-01-20 16:44:41
7b677fe063910e67dbeb123fcd164305e0425f34...b1bf8d64fbadcab860eb98662c49b8db33db0c3c,5,30,11,41,12,2015-01-23 07:58:34,2015-01-21 19:59:40
b1bf8d64fbadcab860eb98662c49b8db33db0c3c...6dc6ec218860e4d4c5c1833c9b8607c4014c85d7,1,11,8,19,3,2015-01-24 15:18:19,2015-01-20 15:20:02
6dc6ec218860e4d4c5c1833c9b8607c4014c85d7...3d4a826174b7a411a03be39725e60c940944a7fe,5,109,8,117,12,2015-01-27 13:40:39,2015-01-23 22:16:05
3d4a826174b7a411a03be39725e60c940944a7fe...c93fb26527027cfff41b7f2c29ae2c2b7e1fa3b3,3,18,1,19,3,2015-01-27 16:48:33,2015-01-27 16:48:04
c93fb26527027cfff41b7f2c29ae2c2b7e1fa3b3...b626c289ccf9cc487f97d91c2a45cac096d9d0c7,1,1,1,2,1,2015-01-27 17:10:08,2015-01-27 17:10:08
b626c289ccf9cc487f97d91c2a45cac096d9d0c7...b25101a0d05eea4f2f2c5e8906e4e03ecbbbfa3a,1,1,1,2,1,2015-01-27 17:27:03,2015-01-27 17:27:03
b25101a0d05eea4f2f2c5e8906e4e03ecbbbfa3a...39a8640e3045d7920a87d3456d3eb51736658619,2,13,0,13,2,2015-01-28 11:39:22,2015-01-28 11:38:31
39a8640e3045d7920a87d3456d3eb51736658619...341a20ff6c4daee3048a4c4c8fb0e8becf2a540f,1,1,1,2,1,2015-01-30 13:30:07,2015-01-29 21:57:03
341a20ff6c4daee3048a4c4c8fb0e8becf2a540f...e775200e05d65605240c4562208140cbd9b087df,1,9,17,26,1,2015-02-02 02:07:38,2015-02-02 02:06:27
e775200e05d65605240c4562208140cbd9b087df...9c456ea8ff49eb8323f0b776935444197b6d75f2,1,4,14,18,2,2015-02-03 13:42:53,2015-02-03 13:41:57
9c456ea8ff49eb8323f0b776935444197b6d75f2...346451164e56b01d8174bb21e3354f47db2764ae,1,3,3,6,3,2015-02-03 14:12:12,2015-02-03 14:10:55
346451164e56b01d8174bb21e3354f47db2764ae...dfa07166642b53f502fe63642ccdad900ed8f526,1,2,2,4,2,2015-02-03 17:27:20,2015-02-03 13:03:05
dfa07166642b53f502fe63642ccdad900ed8f526...2401ef8682220cf49fcc053fe8c933fd9b8275fe,1,9,8,17,2,2015-02-03 21:38:09,2015-02-03 21:35:28
2401ef8682220cf49fcc053fe8c933fd9b8275fe...d3404c1ca8fab9dcde84b2eab29863eae11954ce,1,2,2,4,1,2015-02-04 12:33:48,2015-02-04 06:01:59
d3404c1ca8fab9dcde84b2eab29863eae11954ce...e6ffe43b670dddafd97360f81441e9e590d3408b,2,4,4,8,4,2015-02-07 18:57:50,2015-02-07 18:57:50
e6ffe43b670dddafd97360f81441e9e590d3408b...208d5c42e7d0f8ceea002542ba4b2eaa5dd6dca7,6,6,64,70,12,2015-02-07 19:50:15,2015-02-07 18:59:44
208d5c42e7d0f8ceea002542ba4b2eaa5dd6dca7...1d85d057c3174a49b78379c6332abb89b754af10,4,46,4,50,41,2015-02-08 19:23:01,2015-02-08 19:23:01
1d85d057c3174a49b78379c6332abb89b754af10...37b50db09230f90827008cc8404675d8b4876c10,2,49,1,50,3,2015-02-09 15:48:51,2015-01-28 11:13:35
37b50db09230f90827008cc8404675d8b4876c10...f8c040e1676506e3bcba5f2744199fdcde430552,3,15,6,21,9,2015-02-09 15:48:51,2015-01-28 11:13:54
f8c040e1676506e3bcba5f2744199fdcde430552...1c1193da39c40a97a4bc8d6d5a8ac72e8060ced3,1,2,1,3,1,2015-02-11 00:14:26,2015-02-10 19:27:20
1c1193da39c40a97a4bc8d6d5a8ac72e8060ced3...0c9e006d5fddfe470553d792e2ecee02f467f2a8,1,4,1,5,3,2015-02-12 12:56:49,2015-02-12 12:56:49
0c9e006d5fddfe470553d792e2ecee02f467f2a8...5697a4c9cfb70962ddf90099214b2d69a6ae27b7,1,4,3,7,3,2015-02-12 15:33:02,2015-02-11 15:00:12
5697a4c9cfb70962ddf90099214b2d69a6ae27b7...1b93b0977d2fa7d3cca2fb64168655582e7a88f9,3,12,2,14,4,2015-02-13 12:08:49,2015-02-12 18:58:37
1b93b0977d2fa7d3cca2fb64168655582e7a88f9...86e9744593c6688849da8adc26bf19e51404c113,1,2,1,3,1,2015-02-13 18:47:35,2015-02-13 18:47:35
86e9744593c6688849da8adc26bf19e51404c113...c16f9c2d2880378e3e73365d740c7cea30ed2840,1,2,1,3,1,2015-02-14 15:21:54,2015-02-14 15:18:17
c16f9c2d2880378e3e73365d740c7cea30ed2840...9b7d512d5fb88844d920929b3cbb9d6c38b8b891,3,55,5,60,4,2015-02-14 17:52:53,2015-02-14 08:50:38
9b7d512d5fb88844d920929b3cbb9d6c38b8b891...9be44b8ee3d9d64c170072b394b0d4f7417ba24d,1,1,1,2,1,2015-02-16 01:13:02,2015-02-16 01:07:22
9be44b8ee3d9d64c170072b394b0d4f7417ba24d...a970c277305d7cfa17b290667ce2a145abf96711,1,14,0,14,1,2015-02-16 15:12:18,2015-02-15 19:40:13
a970c277305d7cfa17b290667ce2a145abf96711...e38499123278b75f9cfd0348a5d125336dab3fa5,1,8,16,24,3,2015-02-16 19:29:34,2015-02-16 19:28:41
e38499123278b75f9cfd0348a5d125336dab3fa5...fcaf2e135dbe9a2c31d54045d665fd1dfcfa8d5e,2,13,18,31,6,2015-02-16 20:00:00,2015-02-16 19:22:22
fcaf2e135dbe9a2c31d54045d665fd1dfcfa8d5e...d1dd71f1a78d15a1f80cb3df2d01de55b5e4379b,1,2,0,2,1,2015-02-17 18:54:01,2015-02-17 18:53:20
d1dd71f1a78d15a1f80cb3df2d01de55b5e4379b...c231ec1af0c40f17b67fbd6d6af34b2d8b7a9616,8,8,8,16,8,2015-02-20 14:22:24,2015-02-20 14:20:38
c231ec1af0c40f17b67fbd6d6af34b2d8b7a9616...a3f7b034d7a8dacc117fef4d2237d63ec2274cba,14,65,65,130,65,2015-02-22 14:38:54,2015-02-19 03:19:21
a3f7b034d7a8dacc117fef4d2237d63ec2274cba...2a28606b15070677f9d4aa3cc61a939d9fc501fa,1,3,1,4,1,2015-02-22 15:12:18,2015-02-22 15:11:18
2a28606b15070677f9d4aa3cc61a939d9fc501fa...ca910b0c5a7d2e2d09a131a901abaa2db383f443,1,11,14,25,7,2015-02-22 17:29:43,2015-02-22 17:29:01
ca910b0c5a7d2e2d09a131a901abaa2db383f443...61705f0091940ed32478254dd39514083954c506,4,38,0,38,3,2015-02-23 12:37:46,2015-02-22 01:56:51
61705f0091940ed32478254dd39514083954c506...31ffb1b94e4dde4ab1604a990b6634cff24fd214,1,18,6,24,6,2015-02-23 12:46:23,2015-02-22 19:43:38
31ffb1b94e4dde4ab1604a990b6634cff24fd214...6e8f42cfc7002dc8471baa9573da3e9b52006230,1,5,4,9,1,2015-02-23 14:23:59,2015-02-22 17:46:15
6e8f42cfc7002dc8471baa9573da3e9b52006230...56aa6fc00b7c6efcd02fcd9944b5d20cc8131ac9,1,1,1,2,1,2015-02-24 05:31:21,2015-02-24 04:13:31
56aa6fc00b7c6efcd02fcd9944b5d20cc8131ac9...10f7c96f017801be2ffb8e494ee4d5c3cb4d04c9,1,1,1,2,1,2015-02-25 13:48:02,2015-02-25 13:47:11
10f7c96f017801be2ffb8e494ee4d5c3cb4d04c9...634f4229c5cafeb3a1c03e5deb9434d7c0f74ebe,1,1,1,2,1,2015-02-25 13:49:48,2015-02-25 13:49:48
634f4229c5cafeb3a1c03e5deb9434d7c0f74ebe...2972fd235325f5d2bf50897507913027b44a31a3,1,1,1,2,1,2015-02-25 14:07:25,2015-02-25 14:07:25
2972fd235325f5d2bf50897507913027b44a31a3...aa6853da22ea6d2fb93d6b067bb073190d86f41a,2,13,0,13,2,2015-02-25 14:11:47,2015-02-25 14:11:19
aa6853da22ea6d2fb93d6b067bb073190d86f41a...0831a43c3afc3f93b8ed0c58630836e38248be12,3,9,1,10,3,2015-02-26 16:00:52,2015-02-26 08:50:53
0831a43c3afc3f93b8ed0c58630836e38248be12...9cd8343cc3776abe6d5b5a96270189532f45788e,1,2,2,4,1,2015-02-27 22:54:31,2015-02-27 21:56:38
9cd8343cc3776abe6d5b5a96270189532f45788e...41f9eecf4b90145ee4dc77d8d65bedf980313258,1,9,3,12,3,2015-03-02 17:37:14,2015-02-07 21:32:31
41f9eecf4b90145ee4dc77d8d65bedf980313258...edb5c9a01e0312eb23a955e13282c93d4ec9b097,1,0,4,4,4,2015-03-02 18:33:47,2015-03-02 18:18:48
edb5c9a01e0312eb23a955e13282c93d4ec9b097...5ebe921a8e4ea947580467b904105e14cbef3071,1,18,3,21,3,2015-03-02 23:45:52,2015-02-28 21:53:06
5ebe921a8e4ea947580467b904105e14cbef3071...1c0f66f371a3786d0e90950faf66aa9e462b2aef,1,12,0,12,1,2015-03-03 00:57:26,2015-02-25 18:57:47
1c0f66f371a3786d0e90950faf66aa9e462b2aef...5de18e50dcfaec06f7fb25e62bef914f9d157938,1,5,3,8,1,2015-03-05 15:00:11,2015-03-05 14:13:56
5de18e50dcfaec06f7fb25e62bef914f9d157938...7f2d60996ca26003d35bead426b10fd8dd908347,1,2,2,4,1,2015-03-05 17:18:25,2015-03-05 12:09:08
7f2d60996ca26003d35bead426b10fd8dd908347...283b630d6324c936cbe42d8f0169f056b3ba59c6,4,49,5,54,6,2015-03-07 13:30:28,2015-03-05 12:41:15
283b630d6324c936cbe42d8f0169f056b3ba59c6...8917684c736c445b7f4bfb7225b632cc3e5d400c,1,69,9,78,4,2015-03-08 19:41:29,2015-03-08 18:37:22
8917684c736c445b7f4bfb7225b632cc3e5d400c...fba158bf8dd0cee2b4c21352e4899067f0b8bf19,1,1,1,2,1,2015-03-09 11:06:37,2015-03-09 11:05:49
fba158bf8dd0cee2b4c21352e4899067f0b8bf19...5a3b53112193cc74d2043e09894dd29a763b1105,1,2,2,4,1,2015-03-09 14:11:49,2015-03-09 14:06:18
5a3b53112193cc74d2043e09894dd29a763b1105...2654e1b93923bac55f12b4e66c5e39b16695ace5,5,34,4,38,6,2015-03-09 14:17:54,2015-03-08 10:50:32
2654e1b93923bac55f12b4e66c5e39b16695ace5...40fb8f4ecd740cbfc2b2c3651d69cbbb3cc2506b,1,1,1,2,1,2015-03-09 14:18:18,2015-03-09 14:18:18
40fb8f4ecd740cbfc2b2c3651d69cbbb3cc2506b...084c97c29bea444751d82ed90e595803ca16a36c,1,1,1,2,1,2015-03-09 15:57:04,2015-03-09 15:57:04
084c97c29bea444751d82ed90e595803ca16a36c...ee24ba26661d273e28a0a741ff0621c26e970c43,2,13,0,13,2,2015-03-09 17:10:15,2015-03-09 17:09:39
ee24ba26661d273e28a0a741ff0621c26e970c43...7a08c966ac45a77e6a41fc1cfa1bdbca02dcb1ff,1,13,1,14,2,2015-03-10 00:46:29,2015-03-07 17:45:57
7a08c966ac45a77e6a41fc1cfa1bdbca02dcb1ff...6819cab5d66b4acb7d9cb1a3f1cb8bfa23bc6fbe,1,40,35,75,27,2015-03-10 00:54:01,2015-03-07 14:15:21
6819cab5d66b4acb7d9cb1a3f1cb8bfa23bc6fbe...98d8e052eafc0640fbef3fa38e813424ee0aa5ce,1,1,1,2,1,2015-03-10 11:12:44,2015-03-10 09:10:24
98d8e052eafc0640fbef3fa38e813424ee0aa5ce...3d55798e9839a561b98bea80f5a70df7c9049fa0,1,1,1,2,1,2015-03-11 23:58:18,2015-03-11 23:21:08
3d55798e9839a561b98bea80f5a70df7c9049fa0...8084a68f7844ee61bcc5798c7557e2c3b4770b8a,2,7,0,7,2,2015-03-12 13:24:02,2015-03-12 11:19:42
8084a68f7844ee61bcc5798c7557e2c3b4770b8a...8d3011ff5cca33d5544029d5b41c9bd194609fa7,1,1,1,2,1,2015-03-12 23:16:29,2015-03-12 22:56:38
8d3011ff5cca33d5544029d5b41c9bd194609fa7...311116aa645b51bfeb6d366f3167022754c2be82,1,8,0,8,1,2015-03-13 00:10:04,2015-02-07 21:13:07
311116aa645b51bfeb6d366f3167022754c2be82...639583ed1daccc8033ad6358743199441f9474f9,1,1,1,2,1,2015-03-13 12:14:35,2015-03-13 06:38:27
639583ed1daccc8033ad6358743199441f9474f9...96bbade674a9bde23d54f68350f83893666f18a5,1,5,0,5,1,2015-03-13 12:51:27,2015-03-13 12:48:39
96bbade674a9bde23d54f68350f83893666f18a5...4e8b1648d0ba51ac2e6701eabe6a066e4c0d1422,1,8,3,11,3,2015-03-13 15:42:25,2015-03-12 17:12:11
4e8b1648d0ba51ac2e6701eabe6a066e4c0d1422...9bb451aedba9761eb78968183d21a7e27a7c7f1b,1,16,53,69,5,2015-03-13 17:25:34,2015-02-04 17:22:06
9bb451aedba9761eb78968183d21a7e27a7c7f1b...f8ed647435e13d62d4df0bbc76d37b91d0ad81fb,1,5,0,5,1,2015-03-13 19:42:09,2015-03-13 19:40:25
f8ed647435e13d62d4df0bbc76d37b91d0ad81fb...08f38d19f8a13d9976a41e5b422d8e248e1841e2,5,6,6,12,5,2015-03-14 16:29:54,2015-03-07 16:34:33
08f38d19f8a13d9976a41e5b422d8e248e1841e2...0094ad227d217091d2ec2db5b996b4e3e7719318,1,0,3,3,1,2015-03-14 19:06:55,2015-03-14 19:06:55
0094ad227d217091d2ec2db5b996b4e3e7719318...d0607a7eee75121527cd03c89de82a222e298eae,3,42,1,43,3,2015-03-14 19:35:16,2015-02-16 19:42:11
d0607a7eee75121527cd03c89de82a222e298eae...2583ee2a7ef18f20e8814c68df45c2021a3aa220,1,1,1,2,1,2015-03-16 12:17:15,2015-03-16 06:05:43
2583ee2a7ef18f20e8814c68df45c2021a3aa220...36fb3b39de312a1283d2d08f1ed3b602c8ca7f84,1,4,4,8,4,2015-03-16 12:25:03,2015-03-15 14:51:24
36fb3b39de312a1283d2d08f1ed3b602c8ca7f84...eaf86858d40d40384375bd967b34818d0d8a9979,1,5,0,5,1,2015-03-16 17:13:57,2015-03-16 15:55:43
eaf86858d40d40384375bd967b34818d0d8a9979...cb48e192fb8928c5cf4ff3eb0cc34502f19734ff,3,64,4,68,3,2015-03-16 23:58:08,2015-03-02 22:13:14
cb48e192fb8928c5cf4ff3eb0cc34502f19734ff...11892713710382d82482897a33edf27b1ac1f722,1,16,0,16,1,2015-03-17 17:42:57,2015-03-17 17:41:11
11892713710382d82482897a33edf27b1ac1f722...26fd7262746a5d7b1a94abf8a16cba4218cc7267,4,18,2,20,6,2015-03-18 12:50:49,2015-03-04 12:49:12
26fd7262746a5d7b1a94abf8a16cba4218cc7267...e63363f8e075fa8d66326ad6a1cc3391cc95cd97,4,41,2,43,4,2015-03-18 12:51:21,2015-03-04 13:11:25
e63363f8e075fa8d66326ad6a1cc3391cc95cd97...2a4113dbd532ce952308992633d802dc169a75f1,5,68,3,71,8,2015-03-18 12:51:51,2015-03-10 00:05:13
2a4113dbd532ce952308992633d802dc169a75f1...159f3bfafced8b546010caeaafabecf735598e34,1,1,1,2,1,2015-03-18 12:52:17,2015-03-18 12:52:17
159f3bfafced8b546010caeaafabecf735598e34...a81c224ad1e7ee22cb37e299bf2a399fb8e67bc3,1,1,1,2,1,2015-03-19 00:17:41,2015-03-19 00:17:41
e2f142030b81a37e1c3187f5d336dcb6014fd1c0...1a9f13df59e83eb6e0c20f96d878826519eca62a,1,7,4,11,2,2013-12-19 13:59:07,2013-12-18 21:31:48
e2f142030b81a37e1c3187f5d336dcb6014fd1c0...3ce9829b615336b0f3ac39b080c27fc8cf5af483,8,126,17,143,20,2013-12-16 21:33:28,2013-11-29 19:38:13
3ce9829b615336b0f3ac39b080c27fc8cf5af483...fe1389e911b0cdc487e5547c09c920c12f4e1ce0,1,1,1,2,1,2013-12-16 22:52:37,2013-12-16 22:07:39
fe1389e911b0cdc487e5547c09c920c12f4e1ce0...860c2c8bc5c77194c41464655851379bf512a052,40,448,419,867,76,2013-12-17 09:17:43,2013-12-11 20:44:27
860c2c8bc5c77194c41464655851379bf512a052...9217b89da3295116a098ae2a071a3c4a64a0a5d0,9,20,50,70,26,2013-12-17 09:17:44,2013-12-11 21:19:19
9217b89da3295116a098ae2a071a3c4a64a0a5d0...334551339de38569ac3530886e3f9cc681190224,1,4,15,19,6,2013-12-17 09:17:44,2013-12-11 22:23:10
334551339de38569ac3530886e3f9cc681190224...8662654d6d50e4d89f771a757ae5fc83c6b74db0,55,226,220,446,196,2013-12-17 09:17:44,2013-12-11 22:31:34
8662654d6d50e4d89f771a757ae5fc83c6b74db0...0e9d3472d7f7b38d36be2f09393b04e1783bca3b,3,29,15,44,12,2013-12-17 09:17:44,2013-12-12 10:28:04
0e9d3472d7f7b38d36be2f09393b04e1783bca3b...2c9e84af4a08096c47ebd3d54b463af1a3c7de77,3,11,12,23,5,2013-12-17 09:17:44,2013-12-12 10:36:40
2c9e84af4a08096c47ebd3d54b463af1a3c7de77...b55282b98bf7883490fcc586d501e1b36c7a1c9c,10,86,72,158,47,2013-12-17 09:17:44,2013-12-12 20:34:39
b55282b98bf7883490fcc586d501e1b36c7a1c9c...c5eac3a2f69acf12e794f6c9a3418c9051ce16ed,2,34,15,49,7,2013-12-17 09:17:44,2013-12-12 22:33:09
c5eac3a2f69acf12e794f6c9a3418c9051ce16ed...a4cb1400046f29f933b388ad6390f517e1f80c7a,3,34,25,59,14,2013-12-17 09:17:44,2013-12-13 11:02:54
a4cb1400046f29f933b388ad6390f517e1f80c7a...da36d03fe69c35e2f289590c8c44c4c0d1281f24,1,16,9,25,2,2013-12-17 09:17:44,2013-12-13 19:22:21
da36d03fe69c35e2f289590c8c44c4c0d1281f24...259cd3cd41a80a4725d669fa73498dbfe55a6fdf,6,52,40,92,9,2013-12-17 09:17:45,2013-12-13 18:28:42
259cd3cd41a80a4725d669fa73498dbfe55a6fdf...e85932b54ebc4f03df008accafb2c8acb37361d4,1,17,10,27,8,2013-12-17 09:17:45,2013-12-13 19:51:21
e85932b54ebc4f03df008accafb2c8acb37361d4...ebda5800aeef3f3158b53aa28b3d503bc972a9a7,4,35,30,65,6,2013-12-17 09:17:45,2013-12-13 20:29:30
ebda5800aeef3f3158b53aa28b3d503bc972a9a7...d44de9b933fb7d987d814034769a1ba2eda6545c,6,17,17,34,12,2013-12-17 09:17:45,2013-12-14 08:50:28
d44de9b933fb7d987d814034769a1ba2eda6545c...2732edc5f2305cf454d5df43c7d85a68c639493e,10,54,46,100,23,2013-12-17 09:17:45,2013-12-14 09:08:44
2732edc5f2305cf454d5df43c7d85a68c639493e...69039becde74308d6218c72c1e410cd0049fd2bd,13,55,62,117,38,2013-12-17 09:17:45,2013-12-14 10:11:52
69039becde74308d6218c72c1e410cd0049fd2bd...5ba743e26230ef4c63069efc92c5844fd98995dc,14,53,51,104,32,2013-12-17 09:17:45,2013-12-14 17:51:58
5ba743e26230ef4c63069efc92c5844fd98995dc...30bdad1c47bdd04226e849ca62f703edadf23c0f,3,57,56,113,23,2013-12-17 09:17:45,2013-12-14 19:36:22
30bdad1c47bdd04226e849ca62f703edadf23c0f...b3e182faba4a45ae617509bc5e15fd0b8e096e9a,1,2,3,5,2,2013-12-17 09:17:45,2013-12-15 10:29:24
b3e182faba4a45ae617509bc5e15fd0b8e096e9a...f831da2feddf63c3be17d53d460bbacd1d59ddce,1,1,8,9,2,2013-12-17 09:17:46,2013-12-15 19:46:46
f831da2feddf63c3be17d53d460bbacd1d59ddce...b3d5efe23fb5af586eb274c059ad17645da1c135,1,25,0,25,2,2013-12-17 09:17:46,2013-12-16 10:34:10
b3d5efe23fb5af586eb274c059ad17645da1c135...4a56a93cc458e9ab4dcab95d9f5067d4975dd1a2,64,69,69,138,86,2013-12-17 09:17:46,2013-12-16 10:52:05
4a56a93cc458e9ab4dcab95d9f5067d4975dd1a2...6e895f9e069f73982751cd2d4aa5aa693136a274,50,9,16,25,14,2013-12-17 10:16:48,2013-12-17 09:27:08
6e895f9e069f73982751cd2d4aa5aa693136a274...0242c56fd86137bc8f67404492b5c03987bc3d1a,12,71,87,158,43,2013-12-17 20:53:18,2013-12-17 16:47:19
0242c56fd86137bc8f67404492b5c03987bc3d1a...7eea9bf30399e9a49fe164851c6132cd19a88e08,7,34,23,57,18,2013-12-17 20:55:16,2013-12-16 18:30:33
7eea9bf30399e9a49fe164851c6132cd19a88e08...2bc89f83b31a5d23e67dd3d4f0d70d0c91279b9f,1,0,3,3,1,2013-12-17 21:21:40,2013-12-17 21:21:40
2bc89f83b31a5d23e67dd3d4f0d70d0c91279b9f...9bfdad5472659992a657708a8ec8f07e6b18f061,1,8,9,17,4,2013-12-17 21:24:25,2013-12-17 21:24:25
9bfdad5472659992a657708a8ec8f07e6b18f061...b62031441b2e1cb1eeb7e1d6f254c553643add96,1,14,21,35,5,2013-12-18 13:12:04,2013-12-16 21:47:11
b62031441b2e1cb1eeb7e1d6f254c553643add96...2fd7fc134cf0c0685ceac22fd858509aa43f819f,2,26,1,27,3,2013-12-18 13:59:53,2013-12-18 02:33:41
2fd7fc134cf0c0685ceac22fd858509aa43f819f...d4e578d0f64971483ded49f9cae460ea174b5138,4,17,4,21,8,2013-12-18 14:34:53,2013-12-03 09:24:45
d4e578d0f64971483ded49f9cae460ea174b5138...d34c8c338a843df2a540f19d15efc1ff12e3119c,1,5,6,11,3,2013-12-18 17:37:11,2013-12-18 05:40:25
d34c8c338a843df2a540f19d15efc1ff12e3119c...f1b3ab9c2158f5a7da113aef4158499ce2d42ee2,4,29,0,29,6,2013-12-18 17:40:00,2013-12-18 15:59:08
f1b3ab9c2158f5a7da113aef4158499ce2d42ee2...a39d672ec7d53637805a61b45a51bc0e7d297a36,8,100,83,183,26,2013-12-18 18:44:04,2013-11-05 09:16:27
a39d672ec7d53637805a61b45a51bc0e7d297a36...4ac5def4a27802fb16a8941195bc0d98b9e2e35c,1,2,5,7,1,2013-12-18 23:23:25,2013-12-18 17:13:40
4ac5def4a27802fb16a8941195bc0d98b9e2e35c...cc2d9602746395d5f406632139378d469ca6301b,1,2,1,3,1,2013-12-18 23:36:01,2013-12-18 23:36:01
cc2d9602746395d5f406632139378d469ca6301b...23d9f517dc3ca31816bb8596f5a59f1ae44304ee,2,8,18,26,5,2013-12-18 23:48:21,2013-12-18 23:48:21
23d9f517dc3ca31816bb8596f5a59f1ae44304ee...832ab0dbaacf381d15445259f292d88175ff84f2,2,18,4,22,4,2013-12-20 00:02:50,2013-12-19 05:42:32
832ab0dbaacf381d15445259f292d88175ff84f2...1b9cbef198809f5e765d17b1b6d49bad794dbd0a,1,1,0,1,1,2013-12-20 04:43:34,2013-12-20 04:43:34
1b9cbef198809f5e765d17b1b6d49bad794dbd0a...eabc3b6c8dd67e9ff49da9f2f41cc653898cd0a1,2,9,6,15,3,2013-12-20 10:09:06,2013-12-20 10:04:58
eabc3b6c8dd67e9ff49da9f2f41cc653898cd0a1...b80a8357d683b9a04a14ff46b1a132ad480e8a61,2,2,4,6,2,2013-12-20 14:19:03,2013-12-20 14:07:18
b80a8357d683b9a04a14ff46b1a132ad480e8a61...7f2485b4d180956aa556a88ed1d9754eeeeea054,2,8,0,8,2,2013-12-21 22:03:17,2013-12-21 22:03:17
7f2485b4d180956aa556a88ed1d9754eeeeea054...73c9e65b75cd956410ae71f39fb2f6a9b7b45b42,2,15,6,21,6,2013-12-22 10:39:17,2013-12-18 09:34:20
73c9e65b75cd956410ae71f39fb2f6a9b7b45b42...742ed9878e7edbb7a11667c489c719c4d9ab82de,11,62,51,113,38,2013-12-22 10:39:17,2013-12-18 10:19:56
742ed9878e7edbb7a11667c489c719c4d9ab82de...972babc3b45971a69a6b2a49fc498d92db674cae,2,11,25,36,16,2013-12-22 10:39:17,2013-12-18 12:10:23
972babc3b45971a69a6b2a49fc498d92db674cae...9b3389b7268e48c16ed79256e516af787ad652df,10,99,60,159,34,2013-12-22 10:39:17,2013-12-18 12:16:33
9b3389b7268e48c16ed79256e516af787ad652df...2b56d6910269ace19e3007d2b4a3445f7886314f,3,117,32,149,20,2013-12-22 10:39:17,2013-12-18 10:28:21
2b56d6910269ace19e3007d2b4a3445f7886314f...86804ab063cb9666b69638372abfe4174a2472b2,9,24,84,108,22,2013-12-22 10:39:17,2013-12-18 13:49:29
86804ab063cb9666b69638372abfe4174a2472b2...439b364e1e81371bd87488beed35ce051be8aaaa,2,5,5,10,4,2013-12-22 10:39:17,2013-12-18 15:49:42
439b364e1e81371bd87488beed35ce051be8aaaa...f25fa9d8590c7759c1ec7ffecf1d67be81237674,10,47,64,111,23,2013-12-22 10:39:17,2013-12-18 16:56:11
f25fa9d8590c7759c1ec7ffecf1d67be81237674...4582993302262dec06a39028cc878247542c2334,2,27,12,39,11,2013-12-22 10:39:18,2013-12-19 09:26:18
4582993302262dec06a39028cc878247542c2334...d4733b6df07b1f8a869eed8eac86869d1d14472c,1,7,3,10,1,2013-12-22 10:39:18,2013-12-19 19:32:00
d4733b6df07b1f8a869eed8eac86869d1d14472c...65cd74be8e99d06c7861edc5050e34d6444e4d56,18,116,82,198,68,2013-12-22 10:39:18,2013-12-19 14:57:23
65cd74be8e99d06c7861edc5050e34d6444e4d56...70c9654d454fe7a2206319a20e0b4158a6de639d,3,6,6,12,6,2013-12-22 10:39:18,2013-12-19 20:36:02
70c9654d454fe7a2206319a20e0b4158a6de639d...9cdf1f6d547b6dffcee26f0a525429452551bb4a,10,66,65,131,28,2013-12-22 10:39:18,2013-12-19 20:57:09
9cdf1f6d547b6dffcee26f0a525429452551bb4a...2239081ff16aab1eaafea003433f7139bf13e097,5,33,35,68,20,2013-12-22 10:39:18,2013-12-19 21:33:46
2239081ff16aab1eaafea003433f7139bf13e097...16aae35ca8508dff2e0b94da67b8c880fe98e9d1,2,19,5,24,8,2013-12-22 10:39:18,2013-12-20 09:39:12
16aae35ca8508dff2e0b94da67b8c880fe98e9d1...517c24bcfabcc704a6b3b3f1eb39b05a3cf41954,2,9,6,15,3,2013-12-22 10:39:18,2013-12-20 09:44:32
517c24bcfabcc704a6b3b3f1eb39b05a3cf41954...99bd39ef6e1017f75c71fc276f43a941fe6081ea,3,69,20,89,12,2013-12-22 10:39:18,2013-12-20 13:03:14
99bd39ef6e1017f75c71fc276f43a941fe6081ea...2fef9e5375b0267734392080858d9fced15ee2f9,95,101,101,202,137,2013-12-22 10:39:55,2013-12-22 10:35:17
2fef9e5375b0267734392080858d9fced15ee2f9...690d1cb8d0341ac71613f6bb93f0793335ec6dfd,2,3,2,5,3,2013-12-22 10:39:55,2013-12-22 10:36:49
690d1cb8d0341ac71613f6bb93f0793335ec6dfd...ba60fcbcf7645afd82f3135ecb56562f8a9c9824,8,10,13,23,14,2013-12-22 15:53:57,2013-12-20 13:12:25
ba60fcbcf7645afd82f3135ecb56562f8a9c9824...4f064c2f0511dc900c7f4a736573c309de84dec7,1,4,4,8,2,2013-12-22 16:07:18,2013-12-22 16:07:18
4f064c2f0511dc900c7f4a736573c309de84dec7...17c66e6fe77bc5eb2bd9e6f8f032a105d3cac3d7,3,4,4,8,4,2013-12-22 16:08:17,2013-12-22 16:07:52
17c66e6fe77bc5eb2bd9e6f8f032a105d3cac3d7...71450f6b4515f99bae770da69f79f5072e2ff608,1,1,1,2,1,2013-12-22 16:11:47,2013-12-22 16:11:47
71450f6b4515f99bae770da69f79f5072e2ff608...865603780b0da7bc787199b839c41883cf406e6e,1,4,5,9,2,2013-12-22 17:50:49,2013-12-22 17:50:49
865603780b0da7bc787199b839c41883cf406e6e...046a8eb9c499e0281a8e263a66e05dd6305d9e4e,1,2,1,3,1,2013-12-22 18:04:08,2013-12-22 18:04:08
046a8eb9c499e0281a8e263a66e05dd6305d9e4e...3a30b9c5755baca0cf74d68cf5218dc6a49c29c9,1,4,1,5,2,2013-12-22 19:22:56,2013-12-22 19:22:56
3a30b9c5755baca0cf74d68cf5218dc6a49c29c9...b4a11f2720fbbb47f7c03a5a00b3cfb334266a92,1,0,9,9,1,2013-12-22 19:43:29,2013-12-22 19:22:37
b4a11f2720fbbb47f7c03a5a00b3cfb334266a92...8cff95e937a3a10e577082bfbcd75ed82ec0223b,1,1,1,2,1,2013-12-23 08:44:16,2013-12-23 08:44:16
8cff95e937a3a10e577082bfbcd75ed82ec0223b...5891990b6e6f6e90a873ceb199b321177a90c9eb,8,85,81,166,36,2013-12-23 19:15:08,2013-12-22 23:10:53
5891990b6e6f6e90a873ceb199b321177a90c9eb...5241763c81b6afe1c0327ff7eb0d75c643f24ce0,6,229,49,278,36,2013-12-23 20:37:43,2013-12-23 11:39:19
5241763c81b6afe1c0327ff7eb0d75c643f24ce0...da16bb30ff238aa4d59b4186d92ef5429d8d0045,21,122,229,351,97,2013-12-23 20:37:56,2013-12-23 09:37:34
da16bb30ff238aa4d59b4186d92ef5429d8d0045...e32095616c50bef9b06dc8637a99584ba947bae5,91,113,154,267,97,2013-12-23 20:37:56,2013-12-23 15:01:13
e32095616c50bef9b06dc8637a99584ba947bae5...137a3d7c77e235e6752b00fe9901a700b68fcef2,1,3,0,3,1,2013-12-23 21:21:23,2013-12-23 21:21:23
137a3d7c77e235e6752b00fe9901a700b68fcef2...7577d03809849d3d878d0ee57ec9d6a8524b5b32,1,2,2,4,2,2013-12-23 22:54:44,2013-12-23 22:54:44
7577d03809849d3d878d0ee57ec9d6a8524b5b32...2ec8e3443bc9345d986710244e05a3cce56c8da1,2,24,15,39,10,2013-12-23 23:12:09,2013-12-23 23:07:54
2ec8e3443bc9345d986710244e05a3cce56c8da1...82a35e24d4de58e637661591b14d9b4658bcab11,8,15,27,42,19,2013-12-24 09:56:50,2013-12-24 09:08:04
82a35e24d4de58e637661591b14d9b4658bcab11...e9e522a8e7455900a775678e5d6bc518a289b8d1,1,4,0,4,4,2013-12-24 10:09:24,2013-12-24 10:09:24
8fcc0140d075688e7b0565dea225f4380fc638c4...3e25c8ac69ae336102d91f1d2591ab03f3a91e33,1,1,1,2,1,2014-03-04 20:50:21,2014-03-04 19:33:28
3e25c8ac69ae336102d91f1d2591ab03f3a91e33...a248c88372fa445c1159511fae2b98208f149f69,3,4,3,7,3,2014-03-04 23:13:15,2014-03-04 23:13:15
a248c88372fa445c1159511fae2b98208f149f69...5d568bcfa66916e3de61e0090c724c899debd981,4,12,4,16,5,2014-03-04 23:35:03,2014-02-27 15:32:20
5d568bcfa66916e3de61e0090c724c899debd981...5a5815d373c1b4af073d330e6d658fa8e739dbe8,1,1,1,2,1,2014-03-05 06:35:07,2014-03-05 06:35:07
5a5815d373c1b4af073d330e6d658fa8e739dbe8...ac699cdc174a825e6b78c6f3c6e967bc961413c8,1,4,3,7,3,2014-03-05 08:00:55,2014-03-05 07:57:13
ac699cdc174a825e6b78c6f3c6e967bc961413c8...95c74b9d699c29fe808684774548e2864d64665a,8,37,8,45,11,2014-03-05 19:09:28,2014-03-04 14:12:13
95c74b9d699c29fe808684774548e2864d64665a...c627da0ccc12861163f28177aa7538b420a9d310,8,297,34,331,33,2014-03-05 20:33:58,2014-02-19 18:01:55
c627da0ccc12861163f28177aa7538b420a9d310...b77f26313cddbfde20dcf2661e9bd35458c2d1bd,9,71,27,98,21,2014-03-05 20:37:53,2014-03-04 11:23:32
b77f26313cddbfde20dcf2661e9bd35458c2d1bd...20948612c79b936424cb12cf9988713708232ced,1,77,78,155,19,2014-03-05 23:14:27,2014-01-18 04:33:31
20948612c79b936424cb12cf9988713708232ced...06efeae598c6dafbe56d2ea323a0dccdd5bf2b8e,3,32,34,66,11,2014-03-06 09:20:01,2014-03-06 09:13:22
06efeae598c6dafbe56d2ea323a0dccdd5bf2b8e...9b729ddd8f2040722971ccfb3b12f7d8162633d1,6,75,1,76,6,2014-03-06 13:28:43,2014-03-04 00:52:28
9b729ddd8f2040722971ccfb3b12f7d8162633d1...34236efc5e569ce7d42f7d52dd798e59f95457f8,1,13,11,24,7,2014-03-06 17:33:58,2014-02-28 18:53:32
34236efc5e569ce7d42f7d52dd798e59f95457f8...1562b9896f8f614ef40fd032b1ec777280b377c1,2,4,1,5,2,2014-03-06 19:35:58,2014-03-06 19:35:58
1562b9896f8f614ef40fd032b1ec777280b377c1...8ce3ea687cfae0bc47fcf023cb1f523dae4664ef,2,1,4,5,2,2014-03-06 19:50:04,2014-03-06 19:50:04
8ce3ea687cfae0bc47fcf023cb1f523dae4664ef...e46e15e5a17c1c42d01a343e7044d2d21588493d,2,15,4,19,8,2014-03-06 21:22:42,2014-03-06 21:22:42
e46e15e5a17c1c42d01a343e7044d2d21588493d...1232acb88411f9c4327971c8edff1d191eb0f170,1,4,1,5,1,2014-03-06 21:34:31,2014-03-06 21:34:31
1232acb88411f9c4327971c8edff1d191eb0f170...ec675ed6ccd1ad80e289dc01275e225552c489a3,16,16,16,32,16,2014-03-06 23:43:04,2014-03-06 15:03:25
ec675ed6ccd1ad80e289dc01275e225552c489a3...8f9c3d05650cd418c57f2ded49ed1acbb5c05e77,1,1,2,3,2,2014-03-07 14:18:06,2014-03-07 14:18:06
8f9c3d05650cd418c57f2ded49ed1acbb5c05e77...a0f252520291924f8fb7cb0d85f1680294508560,4,770,0,770,5,2014-03-07 14:29:23,2014-02-22 17:46:31
a0f252520291924f8fb7cb0d85f1680294508560...219d928852c256a81d09dbaa29ed4cec42d2fdfa,6,176,40,216,20,2014-03-07 14:52:13,2014-03-01 19:21:57
219d928852c256a81d09dbaa29ed4cec42d2fdfa...70ec4d776ef0e68960ccee21476b8654e9399f53,5,228,6,234,15,2014-03-08 03:25:23,2014-03-08 03:24:13
70ec4d776ef0e68960ccee21476b8654e9399f53...210d0489c5daad56b806f8165f9fe09fb3c2a019,84,287,189,476,251,2014-03-08 08:57:40,2014-02-26 21:48:20
210d0489c5daad56b806f8165f9fe09fb3c2a019...0c6a3399523d850cfbd20de54cd089419a47383d,5,19,11,30,13,2014-03-08 10:13:48,2014-03-08 10:13:45
0c6a3399523d850cfbd20de54cd089419a47383d...8446a2438ffeab845e31cba4489f03fccc387298,1,10,0,10,1,2014-03-08 10:51:49,2014-03-08 10:51:08
8446a2438ffeab845e31cba4489f03fccc387298...56c80e8b4433df13e2b79f9ac4591d9a970398f5,1,7,13,20,5,2014-03-08 11:32:57,2014-03-08 11:32:57
56c80e8b4433df13e2b79f9ac4591d9a970398f5...b787ef2dbff957c5b5a64be13f01f985d17ff05b,1,1,0,1,1,2014-03-08 11:49:06,2014-03-08 11:49:06
b787ef2dbff957c5b5a64be13f01f985d17ff05b...8d7e048a8b428bebe82be735a84570f9250441e6,1,4,3,7,2,2014-03-08 19:58:24,2014-03-08 19:58:19
8d7e048a8b428bebe82be735a84570f9250441e6...28779abb759d5687a27011b40c0d2f34ada815e9,2,1,2,3,2,2014-03-08 21:53:20,2014-03-08 21:06:12
28779abb759d5687a27011b40c0d2f34ada815e9...cd7a2a077ed5dc4dd04e55d60e72fd15d71e928a,2,16,7,23,7,2014-03-08 21:59:12,2014-03-08 21:59:12
f356b6ecc3fe15634d504690c1793460e5fe9bee...975337e5c348a770df5a1925ce256ab54cb8c529,1,16,55,71,24,2014-03-30 03:51:01,2014-03-29 18:56:08
975337e5c348a770df5a1925ce256ab54cb8c529...bc9be72bdc9bb4dfc7f967ac3856115f0a6166b8,5,125,80,205,26,2014-03-30 05:13:00,2014-03-29 18:57:28
4e6142ee84e966418799fed1fc5d8594a9e08c02...3bc6b18cb92462ff5ae54efd0fce5340e9149b0f,2,17,5,22,6,2014-01-03 10:29:37,2014-01-03 10:25:24
3bc6b18cb92462ff5ae54efd0fce5340e9149b0f...a61c4293745164d3a76e7d82d75102f1906590ff,1,1,1,2,1,2014-01-03 10:32:33,2014-01-03 10:32:33
a61c4293745164d3a76e7d82d75102f1906590ff...196f0a356df9c5dbdc28b73cf45b57cc7c43af9a,1,5,4,9,2,2014-01-03 12:37:14,2014-01-02 20:36:15
196f0a356df9c5dbdc28b73cf45b57cc7c43af9a...e6800ea136aaa882682dbb7dc54423c5f002b551,1,5,4,9,3,2014-01-03 16:59:15,2014-01-03 16:04:38
e6800ea136aaa882682dbb7dc54423c5f002b551...4d27d311f6d598b799ce2cb2df88a1dc54ab8166,1,2,2,4,1,2014-01-03 17:02:58,2014-01-03 17:02:58
4d27d311f6d598b799ce2cb2df88a1dc54ab8166...c717ebbfecd248d1a0ffeffa6d167109936fbe3f,1,1,2,3,2,2014-01-04 15:11:21,2014-01-04 15:11:21
c717ebbfecd248d1a0ffeffa6d167109936fbe3f...2692a0c6217b1b5ea2730f5861cb96c991fc8673,1,3,3,6,3,2014-01-04 22:08:27,2014-01-04 22:06:50
2692a0c6217b1b5ea2730f5861cb96c991fc8673...a7588e2e220bab47bf18601b173d6bfd429f5931,2,16,36,52,7,2014-01-05 19:52:46,2014-01-05 08:29:54
a7588e2e220bab47bf18601b173d6bfd429f5931...d4b059d3eb2850f43a06162c8316777cb1681d7b,1,11,1,12,3,2014-01-05 19:52:46,2014-01-05 09:13:10
d4b059d3eb2850f43a06162c8316777cb1681d7b...5d9da7597ebae302ba15c0ee85aaece80a6d4926,1,4,6,10,7,2014-01-05 19:52:46,2014-01-05 09:12:56
5d9da7597ebae302ba15c0ee85aaece80a6d4926...f5f761716731ceedaf165a068e6f88164cd87e79,1,4,4,8,3,2014-01-05 19:52:46,2014-01-05 19:47:24
f5f761716731ceedaf165a068e6f88164cd87e79...f630373b929bc62bf4d66d60c532f7832e5fbe67,4,24,23,47,9,2014-01-05 19:52:53,2014-01-05 08:32:22
f630373b929bc62bf4d66d60c532f7832e5fbe67...021b0b0029cdecc528a137a5e6913be81c901504,1,4,0,4,1,2014-01-05 20:10:15,2014-01-05 20:10:15
021b0b0029cdecc528a137a5e6913be81c901504...27afd302c687528ff1dc3156961e409862c6eca2,17,136,0,136,17,2014-01-05 20:18:33,2014-01-04 21:49:35
27afd302c687528ff1dc3156961e409862c6eca2...b57c48d012e300f518841fe066c85ecde2747cdf,4,88,0,88,4,2014-01-05 20:18:33,2014-01-04 22:06:24
b57c48d012e300f518841fe066c85ecde2747cdf...6a320cc14ae6cd2606cc10a5ba8b1c09f737bab4,10,15,15,30,12,2014-01-06 21:48:41,2014-01-06 21:48:41
6a320cc14ae6cd2606cc10a5ba8b1c09f737bab4...2dcde523abe6dca42d9b2d46a47c402979974c77,1,3,3,6,4,2014-01-06 22:01:29,2014-01-06 21:57:56
e9e522a8e7455900a775678e5d6bc518a289b8d1...1716b7ce5a02b2a77188dfea2d41e25dfa58821c,92,491,487,978,344,2013-12-24 11:25:17,2013-12-24 11:25:17
1716b7ce5a02b2a77188dfea2d41e25dfa58821c...542198c1d059b3ecf64477c1c10c0518d229345b,2,8,0,8,2,2013-12-24 14:25:48,2013-12-24 14:19:25
542198c1d059b3ecf64477c1c10c0518d229345b...d17404aa90cf0a439828e7f14105f3f522ab3bcc,11,52,122,174,35,2013-12-24 14:57:13,2013-12-24 14:57:13
d17404aa90cf0a439828e7f14105f3f522ab3bcc...9267fb88efb5a81adcf5aac582fb62b3ee269c08,5,95,6,101,9,2013-12-24 15:53:09,2013-12-24 15:53:09
9267fb88efb5a81adcf5aac582fb62b3ee269c08...f326720a7363f305a6767d71fc3a8db2dcb05c0e,4,197,2,199,5,2013-12-24 16:20:11,2013-12-24 14:40:12
f326720a7363f305a6767d71fc3a8db2dcb05c0e...9b8192ce5101b622dbbae61f5ce784cd3e144a4d,3,19,21,40,4,2013-12-24 16:20:11,2013-12-24 15:28:31
e9e522a8e7455900a775678e5d6bc518a289b8d1...d7a4b156d935ffcb8cdd9290688457453fc06b24,1,10,19,29,5,2013-12-24 10:57:57,2013-12-24 10:57:57
2f3e1fe3234f5ebaca7635b0a080c2a751c3c758...20399083f49faceef1e48530822137257bca9d6a,6,66,19,85,12,2014-03-30 08:36:45,2014-03-27 11:32:48
2dcde523abe6dca42d9b2d46a47c402979974c77...52cad43bc3d3126fcf7e08582373c12e88895cd3,4,98,364,462,20,2014-01-09 08:27:54,2014-01-07 00:11:13
52cad43bc3d3126fcf7e08582373c12e88895cd3...7959aff8be437f6cc9cbab2cdae86a6aad24f925,3,263,1,264,3,2014-01-12 17:35:15,2014-01-12 17:35:15
2dcde523abe6dca42d9b2d46a47c402979974c77...0423e0796a75db8226e2032083ce6c674da337dc,1,12,11,23,11,2014-01-08 11:54:37,2014-01-04 02:26:11
0423e0796a75db8226e2032083ce6c674da337dc...64887c644a8fe1004a15e27087d4e27c95c90fcd,7,92,4,96,10,2014-01-08 13:00:12,2014-01-08 13:00:12
64887c644a8fe1004a15e27087d4e27c95c90fcd...f343f5e5389738cf06ddeef5ca961508f2f8c881,1,1,1,2,1,2014-01-08 13:06:53,2014-01-08 13:06:41
9b8192ce5101b622dbbae61f5ce784cd3e144a4d...96967f642fbbd01a10e1c1e17764dd6af7c35e97,1,1,1,2,1,2013-12-24 16:26:50,2013-12-24 16:26:50
08bb238eae8f40df103441b067818ecc72fe51b8...7df049c417e7d1e538755a7010c57c71ca9d5b5e,2,45,45,90,10,2013-12-25 20:57:52,2013-12-25 20:57:52
a2407c9577c400bf9931ff1db1d7757afa378162...da7ab8728c795e1853cea4215469ae3649664c6d,2,3,3,6,3,2014-03-30 11:48:27,2014-03-30 11:48:27
56ab5f52c717ad9f54f94b09b6c61568f612ba6b...c726598c3da5320df88a10fc407f8df6874589b1,3,2,3,5,3,2014-01-12 18:40:37,2014-01-12 18:40:37
c726598c3da5320df88a10fc407f8df6874589b1...fbe1abac4af3a7fc138bd176471e36acb1070a58,4,14,7,21,6,2014-01-12 19:31:07,2014-01-12 19:27:08
fbe1abac4af3a7fc138bd176471e36acb1070a58...720c6d3a44f5a723854e5eda4e963155b136582f,1,2,0,2,1,2014-01-12 20:13:32,2014-01-12 20:13:32
720c6d3a44f5a723854e5eda4e963155b136582f...225a6ed2cfecc609760a36c3b20369daeec52e07,1,1,1,2,2,2014-01-12 20:40:22,2014-01-12 20:40:22
225a6ed2cfecc609760a36c3b20369daeec52e07...d674fe6dee16735dd2670243153326806b7e6cb0,2,8,18,26,6,2014-01-12 21:08:46,2014-01-12 21:04:22
d674fe6dee16735dd2670243153326806b7e6cb0...d562527a160f420c6af0d2736ad4e6c87b0d2ef1,6,20,20,40,19,2014-01-12 21:24:33,2014-01-12 21:20:53
d562527a160f420c6af0d2736ad4e6c87b0d2ef1...0a7588dd3f5ec5beef0298389661e78fd63ad6a6,1,2,1,3,2,2014-01-12 21:29:27,2014-01-12 21:29:27
0a7588dd3f5ec5beef0298389661e78fd63ad6a6...89f12c0596db201c7d052120d4337a36bc0aab17,1,12,1,13,1,2014-01-12 23:11:55,2014-01-12 20:32:26
89f12c0596db201c7d052120d4337a36bc0aab17...9d2c5b0420bcbf00505a403241a2927cabc90805,2,11,0,11,2,2014-01-12 23:38:28,2014-01-12 23:33:48
9d2c5b0420bcbf00505a403241a2927cabc90805...22198e6ce5be070e727b5c5ef45374a5af048018,1,15,5,20,4,2014-01-12 23:39:44,2014-01-12 23:39:44
22198e6ce5be070e727b5c5ef45374a5af048018...132c26649c7fc46921619c266cf7eda7ef54eb7a,1,1,1,2,1,2014-01-13 16:30:46,2014-01-13 16:30:46
132c26649c7fc46921619c266cf7eda7ef54eb7a...4f25d97404dc2a6faa5c9f467c246cb42b65b44c,1,0,11,11,1,2014-01-13 16:31:30,2014-01-13 16:31:30
4f25d97404dc2a6faa5c9f467c246cb42b65b44c...660b7e70001209a53f0e51c66e2e19071f796d9f,1,2,5,7,2,2014-01-13 16:32:09,2014-01-13 16:32:09
660b7e70001209a53f0e51c66e2e19071f796d9f...ac8d0a48157c4a53f971cf2450cb6c8ee6c05f36,2,5,3,8,5,2014-01-13 17:11:21,2014-01-13 17:11:21
ac8d0a48157c4a53f971cf2450cb6c8ee6c05f36...2607fa901699916c4825f145fa8a84f49b8524ff,24,398,351,749,310,2014-01-14 15:43:27,2014-01-14 15:43:27
f343f5e5389738cf06ddeef5ca961508f2f8c881...1dbbdb29a040106f072a4a0315a066a251cc4939,1,9,5,14,3,2014-01-08 15:52:13,2014-01-08 15:52:13
f343f5e5389738cf06ddeef5ca961508f2f8c881...8845ab62f553f29561decdbabd6eb0ea96c3c1d6,1,2,1,3,2,2014-01-08 14:53:40,2014-01-08 14:53:40
828c9be4366e3e7b52eeae5cf1e75155a39bcdaa...dbe2fb632de6d4e116f00f9e74b583a5bdc051a9,2,1,1,2,2,2013-12-24 16:35:13,2013-12-24 16:35:13
dbe2fb632de6d4e116f00f9e74b583a5bdc051a9...285e765891149704cbd5ddb784887ad187416ef7,3,48,2,50,4,2013-12-24 19:16:56,2013-12-24 18:00:29
285e765891149704cbd5ddb784887ad187416ef7...8c78cba47f78f6b56ca1948b108f0f37965f387d,2,4,5,9,3,2013-12-24 22:48:22,2013-12-24 22:48:22
8c78cba47f78f6b56ca1948b108f0f37965f387d...5d826586578d09d183b8bd0b64571b7cfebe888b,1,1,1,2,1,2013-12-25 11:02:43,2013-12-25 11:02:43
5d826586578d09d183b8bd0b64571b7cfebe888b...e82e7ae1e8b7300017bb390462e5c2f7b48e2cde,1,1,1,2,2,2013-12-25 11:06:25,2013-12-25 11:06:25
e82e7ae1e8b7300017bb390462e5c2f7b48e2cde...b798d2bf97a48aac1b0a70e9b3d82457a5212123,1,4,0,4,2,2013-12-25 14:56:41,2013-12-25 14:56:41
b798d2bf97a48aac1b0a70e9b3d82457a5212123...0dd907562247cbf88092a736b82d7d0c27407328,1,2,2,4,1,2013-12-25 17:18:14,2013-12-25 17:18:14
029acbe54452ce98b5e2047d5d64370a15c44018...318cdc07dea58bdd21adee838b9ee8ddfdcfaa7c,1,2,1,3,1,2013-12-26 10:10:50,2013-12-26 10:09:58
318cdc07dea58bdd21adee838b9ee8ddfdcfaa7c...398642fd9b6e9b4d83baed7b9708ca0cd942540b,3,17,0,17,3,2013-12-26 12:35:50,2013-12-18 19:04:53
398642fd9b6e9b4d83baed7b9708ca0cd942540b...4e7aa573ec3b9c8e0784db9013dbc31b6c3eaac5,1,1,0,1,1,2013-12-26 12:52:31,2013-12-26 12:52:31
4e7aa573ec3b9c8e0784db9013dbc31b6c3eaac5...8f04f53dd847896f49a9bc367bb7269984ebdb6e,7,37,20,57,15,2013-12-26 13:03:50,2013-12-26 12:46:15
8f04f53dd847896f49a9bc367bb7269984ebdb6e...922430177ccdaed2561ec442a76de3eb89ae88a0,2,11,6,17,2,2013-12-26 13:12:30,2013-12-26 13:12:30
922430177ccdaed2561ec442a76de3eb89ae88a0...52325b0a04cf1fcf444cece197585a35cf65bab9,3,29,12,41,8,2013-12-26 14:04:58,2013-12-26 14:04:58
52325b0a04cf1fcf444cece197585a35cf65bab9...aef019de6113e6c750e3ba49dc1e9f2a179eb0ca,4,50,3,53,6,2013-12-26 16:26:24,2013-12-16 16:04:28
aef019de6113e6c750e3ba49dc1e9f2a179eb0ca...8925aaf61304c22f5ba86dad5d6b15c277b33cfb,2,72,4,76,9,2013-12-26 18:21:02,2013-12-26 17:03:17
8925aaf61304c22f5ba86dad5d6b15c277b33cfb...fec5330c7937efe30294d060a57af6400ce073a9,1,2,2,4,2,2013-12-26 18:21:02,2013-12-26 17:37:04
fec5330c7937efe30294d060a57af6400ce073a9...ce1bc2c94b30a42a2c7c0d58e6cb6d8875cadf60,6,15,12,27,13,2013-12-26 18:25:09,2013-12-26 17:40:28
ce1bc2c94b30a42a2c7c0d58e6cb6d8875cadf60...b355e98a5091a76ad4b8657a6a971e7e0595aa26,1,16,5,21,4,2013-12-26 18:25:09,2013-12-26 18:05:45
b355e98a5091a76ad4b8657a6a971e7e0595aa26...e179291fa58b08c6e52cceb1590666fbcca8f363,1,34,0,34,3,2013-12-26 18:25:09,2013-12-26 18:20:38
e179291fa58b08c6e52cceb1590666fbcca8f363...cfbdd587f6964f65fd8b7de049227fa1ead858da,2,32,1,33,3,2013-12-26 18:29:32,2013-12-26 18:29:32
cfbdd587f6964f65fd8b7de049227fa1ead858da...d430f1d98b564543d1c90d067efdf1ee6851d8d3,1,2,1,3,1,2013-12-26 18:41:03,2013-12-26 18:41:03
d430f1d98b564543d1c90d067efdf1ee6851d8d3...8779aa806e6b5442e60c111f9d5d6874a026e001,1,6,0,6,1,2013-12-26 19:39:28,2013-12-26 19:04:06
8779aa806e6b5442e60c111f9d5d6874a026e001...d8d83777ebbe15af7587a24698435555ba3bb842,2,17,0,17,2,2013-12-26 20:50:33,2013-12-26 20:50:33
9723e999a0b4acb212210241851dbe75dfbc1a55...69a4f383f6e84bac16afad103d332103e4e7bcc1,1,1,1,2,1,2014-03-30 18:25:06,2014-03-30 18:25:06
69a4f383f6e84bac16afad103d332103e4e7bcc1...92dbf342868e68dfe60569c60dd5aa5925194221,1,2,1,3,1,2014-03-30 18:50:18,2014-03-30 18:50:18
92dbf342868e68dfe60569c60dd5aa5925194221...778ce245dd466bce1b19f89e52cf9ed8f1b46513,39,55,54,109,54,2014-03-30 19:11:05,2014-03-30 19:11:05
778ce245dd466bce1b19f89e52cf9ed8f1b46513...47509e3c5d7acc94aaa7999533e50710e12121a8,1,1,0,1,1,2014-03-30 21:45:52,2014-03-30 18:46:05
47509e3c5d7acc94aaa7999533e50710e12121a8...cb5dd99bb422dff38d5e804a91fe876f19a884e6,1,1,1,2,1,2014-03-30 23:31:07,2014-03-30 23:30:07
2607fa901699916c4825f145fa8a84f49b8524ff...82f466b571bd17e9d1242dfc74b18617cff17ca4,1,1,1,2,1,2014-01-15 21:17:08,2014-01-15 21:17:08
2607fa901699916c4825f145fa8a84f49b8524ff...cd69db68cf88703bac25150578bfe4e5d0dbcd3d,1,1,1,2,1,2014-01-15 20:24:09,2014-01-15 20:24:09
fa250c2cf9d9f7b06468e010c86594bf4bb55cf5...9ae17d994b1b0dee952c2e64f3727ce7a6ffb398,1,1,1,2,1,2014-01-08 21:20:29,2014-01-08 21:20:29
9ae17d994b1b0dee952c2e64f3727ce7a6ffb398...9eb16031ca837624433c49646289b50f9566a25d,4,30,7,37,7,2014-01-09 23:50:03,2013-11-19 08:44:30
9eb16031ca837624433c49646289b50f9566a25d...270c9fe48883deaacbc15014ceebef6f895559ab,1,2,2,4,2,2014-01-10 13:25:22,2014-01-10 01:44:07
270c9fe48883deaacbc15014ceebef6f895559ab...81bb8d12209a419142b1bf6961fbf9fc44419dcd,1,1,1,2,1,2014-01-10 13:33:30,2014-01-10 04:31:22
81bb8d12209a419142b1bf6961fbf9fc44419dcd...3326a412ccde9f72e22a070a0b4d922048ed2286,5,40,5,45,9,2014-01-10 22:43:10,2014-01-10 22:06:19
3326a412ccde9f72e22a070a0b4d922048ed2286...f7c2c0a3be84d1dbd64d49676fbd4110bc009b31,1,0,34,34,1,2014-01-10 23:23:06,2014-01-10 23:22:55
f7c2c0a3be84d1dbd64d49676fbd4110bc009b31...18374c1d8c37dd251dae72470b6c532bddf140eb,2,8,2,10,4,2014-01-11 13:08:04,2014-01-11 13:05:28
18374c1d8c37dd251dae72470b6c532bddf140eb...1e9e7351f88a59261da6e616934c8283a6e3e565,2,12,4,16,4,2014-01-11 13:20:28,2014-01-09 15:03:37
1e9e7351f88a59261da6e616934c8283a6e3e565...0179852d7faf461d55cf3ae69393abb3f3cd2910,5,33,8,41,7,2014-01-11 14:50:34,2013-12-04 19:59:05
0179852d7faf461d55cf3ae69393abb3f3cd2910...3d4ed28dce851beab8f679190fc91366742bca68,1,8,3,11,3,2014-01-11 16:58:29,2014-01-11 16:58:29
3d4ed28dce851beab8f679190fc91366742bca68...9cc3371a0f45894de12d2fb60a57afd111fb9c3e,1,4,5,9,6,2014-01-12 08:41:57,2014-01-12 08:41:09
9cc3371a0f45894de12d2fb60a57afd111fb9c3e...9918c11114ac3ec9622631558ef26ebf3919cb69,3,15,8,23,9,2014-01-12 16:07:39,2013-11-17 13:50:14
9918c11114ac3ec9622631558ef26ebf3919cb69...1c24096f1e860960fa44df937713528065b5f79a,1,9,6,15,3,2014-01-12 17:28:51,2014-01-12 17:24:04
1c24096f1e860960fa44df937713528065b5f79a...1afe7488322f9b53ea00f47fb07c4374a5f2150e,2,21,6,27,3,2014-01-12 17:28:51,2014-01-12 17:26:20
0dd907562247cbf88092a736b82d7d0c27407328...cb488c5c352ac3388917769db991cb02b07e952f,1,0,1,1,1,2013-12-25 22:22:13,2013-12-25 22:22:13
0dd907562247cbf88092a736b82d7d0c27407328...80027d2c38d8980bbe570a62f44e1fd5a7882ae2,5,45,28,73,22,2013-12-25 20:19:14,2013-12-25 19:54:14
d8d83777ebbe15af7587a24698435555ba3bb842...929ceadda129090e260ec693178b992cd02da7bb,2,7,3,10,4,2013-12-26 23:51:53,2013-10-25 18:05:02
929ceadda129090e260ec693178b992cd02da7bb...694e6c6f52aeeb0de02281a0ee6e9d6fa12f1ea8,1,1,1,2,1,2013-12-29 13:01:55,2013-12-29 13:01:55
694e6c6f52aeeb0de02281a0ee6e9d6fa12f1ea8...6ad7bd44c6246b9fe74105b87a02f79a505f3205,1,3,51,54,4,2013-12-31 11:35:05,2013-12-31 11:35:05
d8d83777ebbe15af7587a24698435555ba3bb842...6e3ca6507cd0a431d63924a708c39f6faa21341b,1,1,1,2,1,2013-12-26 21:58:37,2013-12-26 21:55:13
6e3ca6507cd0a431d63924a708c39f6faa21341b...025ec2e7fe3f4056835eda94d204ec87901fa11f,1,6,1,7,2,2013-12-27 01:04:28,2013-12-27 01:04:28
025ec2e7fe3f4056835eda94d204ec87901fa11f...6aa1a316604c063db88a8aa4cd2f25065ae1394c,2,18,12,30,3,2013-12-27 10:17:25,2013-12-27 10:17:25
6aa1a316604c063db88a8aa4cd2f25065ae1394c...f00243f36df8dfe504491e03be5d5aea076340b3,1,2,0,2,1,2013-12-27 10:42:24,2013-12-27 10:42:24
f00243f36df8dfe504491e03be5d5aea076340b3...2504a50cc2285b5e5f17d5403c9a79b620471b25,2,9,3,12,5,2013-12-27 14:36:19,2013-12-27 14:36:19
2504a50cc2285b5e5f17d5403c9a79b620471b25...85270ef3f5bf96b556e697bc5a46bf925ec4be21,1,28,23,51,6,2013-12-27 15:02:22,2013-12-27 14:57:56
85270ef3f5bf96b556e697bc5a46bf925ec4be21...40b876763539e1700826ebffcd9402043054b13b,2,0,3,3,2,2013-12-27 20:06:28,2013-12-27 20:06:28
40b876763539e1700826ebffcd9402043054b13b...efddae252ce8fe469196839a29a564c0b4942c89,1,19,24,43,18,2013-12-27 20:25:35,2013-12-27 20:25:35
cb5dd99bb422dff38d5e804a91fe876f19a884e6...a449e7feec73c7a14a972721942ce0f649c9d875,2,31,9,40,4,2014-03-31 10:13:19,2014-03-31 06:09:12
a449e7feec73c7a14a972721942ce0f649c9d875...0fd51cf0bd31afb085d16476d5a54bedf4a1bc32,2,13,12,25,5,2014-03-31 10:50:38,2014-03-25 19:51:15
0fd51cf0bd31afb085d16476d5a54bedf4a1bc32...029d77eaaa23912bf839eaeba400c77054eb319e,1,1,1,2,1,2014-03-31 11:01:13,2014-03-31 11:01:13
029d77eaaa23912bf839eaeba400c77054eb319e...d57ba04d890bab2d5ebe494e5e23d7374d658036,1,3,0,3,1,2014-03-31 11:11:55,2014-03-31 11:10:25
d57ba04d890bab2d5ebe494e5e23d7374d658036...4339e9a92d98371a50a6fe54ab7ea0c602ecee28,3,40,7,47,10,2014-03-31 11:19:59,2014-03-28 14:42:58
4339e9a92d98371a50a6fe54ab7ea0c602ecee28...981b864fbd28590c4ac829ce55bb7543f57d1de8,4,4,15,19,8,2014-03-31 11:54:22,2014-03-31 11:54:22
981b864fbd28590c4ac829ce55bb7543f57d1de8...246face20984b70b93751d144760bfd9b45d2c09,1,6,2,8,1,2014-03-31 12:10:59,2014-03-31 12:10:59
246face20984b70b93751d144760bfd9b45d2c09...4d996b8e69c1374fd6ea2674384903456a74cc4b,1,119,22,141,19,2014-03-31 12:19:43,2014-03-31 09:54:17
4d996b8e69c1374fd6ea2674384903456a74cc4b...d902fd625d11bd8a69c3a26b5ed90eefa38d2f6d,1,15,1,16,3,2014-03-31 16:24:01,2014-03-31 16:22:29
d902fd625d11bd8a69c3a26b5ed90eefa38d2f6d...4aa80149e71d02947164a89ec5da6fd035393425,4,52,1,53,5,2014-03-31 18:08:51,2014-03-23 16:29:10
4aa80149e71d02947164a89ec5da6fd035393425...9769337ca855f4831c855d6663ff3f688ee1652d,1,4,0,4,1,2014-04-01 18:49:51,2014-04-01 18:48:06
cb5dd99bb422dff38d5e804a91fe876f19a884e6...9a982d5ccc91dd6fc0e5d6fa98df0e5acbf50da7,2,49,50,99,7,2014-03-30 23:55:40,2014-03-28 22:22:00
cd69db68cf88703bac25150578bfe4e5d0dbcd3d...63ff03c4ecaaf962710f0fa3801eadef1116bea6,1,1,1,2,1,2014-01-16 21:34:35,2014-01-16 21:34:35
66f546b90624297858b0f958abbe5c2b3e8bdffb...5c7ac7494ab5f1cdc364f829f61ffef85ad7344b,1,10,5,15,1,2014-01-19 14:35:59,2014-01-19 14:35:59
5c7ac7494ab5f1cdc364f829f61ffef85ad7344b...c9de1b4a55713ad1557f8c40621226253038f665,10,216,13,229,36,2014-01-19 16:43:12,2014-01-15 14:20:47
efddae252ce8fe469196839a29a564c0b4942c89...14bcbd9937f50ec21196dbb2bc3126e6a4427b37,2,5,5,10,5,2013-12-27 22:19:23,2013-12-27 22:17:59
efddae252ce8fe469196839a29a564c0b4942c89...3efd1b8b939c0a600b2d63317d224ebaab766f01,3,40,3,43,7,2013-12-27 21:43:52,2013-12-22 19:44:49
9769337ca855f4831c855d6663ff3f688ee1652d...8f621b83e9e68aa79d2e83b71b4f8217e05af12c,1,2,0,2,1,2014-04-04 07:25:55,2014-04-04 04:05:30
9769337ca855f4831c855d6663ff3f688ee1652d...cb9704fc4ff0d0091814c59bc3bed90e9728cb16,1,1,1,2,1,2014-04-02 15:32:51,2014-04-02 15:29:56
9769337ca855f4831c855d6663ff3f688ee1652d...6eb891f57ad8b13bded1c7d0f4683cf63ba18c76,1,1,1,2,1,2014-04-02 15:28:09,2014-04-02 15:26:34
fce6a29428a7b57fdfb98178e3b27c0567471b9c...d9d9242505a59549a7519a35c0f59af13efac462,1,1,1,2,1,2014-05-22 07:46:34,2014-05-22 07:46:34
d9d9242505a59549a7519a35c0f59af13efac462...604162604bf816fa46b0d972621f06de64df6a66,15,1272,1,1273,15,2014-05-22 08:53:26,2014-03-26 16:44:21
34490792f167f7703cf4396b4bb26163a8af6382...9e5033b302676856901a7808910fcab5c3fe1d27,1,7,2,9,3,2014-01-16 12:07:53,2014-01-16 12:07:53
9e5033b302676856901a7808910fcab5c3fe1d27...d35f2bfd5b3a73340275bbd2af5065cba8d42c97,1,9,8,17,2,2014-01-16 12:16:09,2014-01-16 12:16:09
d35f2bfd5b3a73340275bbd2af5065cba8d42c97...c05b2f58e7f38293fdf0f92e618fcbe769881912,1,3,2,5,2,2014-01-16 12:58:08,2014-01-16 12:58:08
c05b2f58e7f38293fdf0f92e618fcbe769881912...a6e3fb80b0e079c49da722515ed71768022264b8,2,10,3,13,3,2014-01-16 13:38:40,2014-01-16 13:35:16
a6e3fb80b0e079c49da722515ed71768022264b8...2a31d00933fd1d06ae3013f2c0eb8f4982fa7db6,2,12,12,24,12,2014-01-16 16:44:20,2014-01-16 16:44:20
2a31d00933fd1d06ae3013f2c0eb8f4982fa7db6...7535e9f4a4f5317a0073a8fde0eacf17ce31bac0,1,1,1,2,1,2014-01-16 19:04:10,2014-01-16 19:03:39
54d396ff8500b56b81e0b131cd9158359179e5ca...9173d2cb746f253ca31183eb63ac47e440c74ce3,1,1,0,1,1,2014-01-17 01:47:02,2014-01-17 01:47:02
9173d2cb746f253ca31183eb63ac47e440c74ce3...dd98ccd4821f71543a5489d421ea2dee28901f17,2,30,0,30,2,2014-01-17 02:13:08,2014-01-17 02:13:08
dd98ccd4821f71543a5489d421ea2dee28901f17...86e69bf3b67ff1e156413e07cef018ec52c2cdd4,2,7,2,9,3,2014-01-17 10:46:03,2014-01-17 10:45:31
86e69bf3b67ff1e156413e07cef018ec52c2cdd4...a67e327db53f49aff374d5974b69de43da288bac,1,11,64,75,3,2014-01-17 14:21:34,2014-01-17 14:21:34
a67e327db53f49aff374d5974b69de43da288bac...4a5aac47a619a27c2458cfdcba56d53b05c789ad,1,3,1,4,2,2014-01-17 19:50:47,2014-01-17 19:50:47
4a5aac47a619a27c2458cfdcba56d53b05c789ad...bc7668eb515b8ee7a32fbfb64dc4dff4d06abb5b,2,5,8,13,3,2014-01-17 21:06:11,2014-01-17 20:58:19
bc7668eb515b8ee7a32fbfb64dc4dff4d06abb5b...298a2b577ffbe7f8ed00588694c792ac9adcefbe,2,8,7,15,7,2014-01-17 23:03:16,2014-01-15 23:01:30
298a2b577ffbe7f8ed00588694c792ac9adcefbe...b87c59b04bc549a5ba42023d04e4be7a4737f7d9,11,17,17,34,17,2014-01-17 23:12:45,2014-01-17 22:27:04
b87c59b04bc549a5ba42023d04e4be7a4737f7d9...20bab2cf9d02a5c6477d8aac066a635986e0d3f3,38,1324,185,1509,124,2014-01-18 09:46:19,2014-01-18 09:09:43
20bab2cf9d02a5c6477d8aac066a635986e0d3f3...8a34d35696927e1eafce3fdfdd87246b3f189268,1,1,1,2,1,2014-01-18 13:33:42,2014-01-18 13:33:42
8a34d35696927e1eafce3fdfdd87246b3f189268...2f65b8e14c03a6b43c11d5de791b8d4d91721777,1,9,5,14,2,2014-01-18 17:23:13,2014-01-18 17:22:11
2f65b8e14c03a6b43c11d5de791b8d4d91721777...f468662e2495292356e5fd75241621563893fd4f,1,1,1,2,1,2014-01-18 19:18:50,2014-01-18 19:17:12
f468662e2495292356e5fd75241621563893fd4f...4dc3be250662b4132d8475fb02983a6d8f1eec23,2,7,7,14,6,2014-01-18 20:31:35,2014-01-18 20:31:35
4dc3be250662b4132d8475fb02983a6d8f1eec23...74d8fdcfa6a49cb30210c690dff08fc62b642e2a,1,2,1,3,2,2014-01-18 22:06:00,2014-01-18 18:01:13
74d8fdcfa6a49cb30210c690dff08fc62b642e2a...10e0cfc0e4e77b85e8261c908baf1c4814ded3f8,10,73,26,99,22,2014-01-18 22:06:00,2014-01-18 18:34:54
10e0cfc0e4e77b85e8261c908baf1c4814ded3f8...9d487ae2a16d1efd501e65c78e6885c8cdcd4421,1,2,2,4,3,2014-01-19 06:58:22,2014-01-19 06:58:22
9d487ae2a16d1efd501e65c78e6885c8cdcd4421...994c842bc9266f3d1e36b10e9365d74844ccb28c,1,1,1,2,1,2014-01-19 08:09:17,2014-01-19 08:07:58
994c842bc9266f3d1e36b10e9365d74844ccb28c...1f58834ac6858aa33629a27cb252de00141e76b0,1,1,1,2,1,2014-01-19 08:21:57,2014-01-19 08:21:57
c9de1b4a55713ad1557f8c40621226253038f665...374faa472150e2e1fb70224a764b82d3d51994f7,4,108,32,140,25,2014-01-19 17:16:07,2013-09-26 07:25:35
c9de1b4a55713ad1557f8c40621226253038f665...e802c97581594e3a37e6497443b105ecb9920a55,3,33,2,35,4,2014-01-19 17:10:24,2014-01-19 17:10:24
e802c97581594e3a37e6497443b105ecb9920a55...1ea96acaf56acee692fe6f5668644962231be5e1,1,8,2,10,2,2014-01-19 17:14:31,2014-01-19 17:14:31
61cfcec5b7d47232a1d6facbde71d4cca35986eb...3518e9ec1f23f0278aefea6738f9d49eb7d4fe52,1,1,1,2,1,2013-12-28 00:02:39,2013-12-27 23:58:18
3518e9ec1f23f0278aefea6738f9d49eb7d4fe52...aff57793b46e108c6e48d5ce3b889bf90b513df9,1,7,13,20,1,2013-12-28 08:34:46,2013-12-27 22:03:03
aff57793b46e108c6e48d5ce3b889bf90b513df9...bb8ec71f61066587aa3a8feb0aedab213422775a,4,63,27,90,16,2013-12-28 08:42:59,2013-12-24 22:43:47
bb8ec71f61066587aa3a8feb0aedab213422775a...a7add2f2965dac3c2f63b1459c8bde725250c977,9,51,26,77,12,2013-12-28 08:43:06,2013-12-27 14:17:56
a7add2f2965dac3c2f63b1459c8bde725250c977...c81fae6b9588ab9ef1edd7309c00e72a87154bc1,14,75,71,146,46,2013-12-28 08:53:02,2013-12-28 08:53:02
c81fae6b9588ab9ef1edd7309c00e72a87154bc1...b7a7baa55471e67b98d509cddf2f0994f7ce786f,1,20,0,20,2,2013-12-28 10:08:50,2013-12-28 10:08:50
b7a7baa55471e67b98d509cddf2f0994f7ce786f...f28ea0230846c81e9b6725454bb3a10df24678aa,1,30,41,71,9,2013-12-28 11:42:33,2013-12-28 11:40:10
f28ea0230846c81e9b6725454bb3a10df24678aa...6a6136141b133aff7583d51d687719961d261244,1,5,1,6,2,2013-12-28 14:21:01,2013-12-28 14:05:56
6a6136141b133aff7583d51d687719961d261244...280c1a65ccacd679bf298bf2b169ff01e7266b8e,1,8,1,9,1,2013-12-28 14:25:16,2013-12-28 14:24:25
248b9bb5544c1cf0b9f36091f0608814dedac6b5...9494f29d4fffc30e6ae111a995ca1d07a0cbf439,1,1,1,2,1,2014-04-05 14:26:11,2014-04-05 14:26:11
9494f29d4fffc30e6ae111a995ca1d07a0cbf439...fd23c06023a0585ee743c0752dc94da66694cf63,12,246,6,252,26,2014-04-05 16:50:51,2014-04-01 00:16:09
fd23c06023a0585ee743c0752dc94da66694cf63...0a65da941c1643f0ce8d2c9644b12d3f07319c6d,2,7,10,17,9,2014-04-05 19:00:31,2014-04-05 18:58:59
0a65da941c1643f0ce8d2c9644b12d3f07319c6d...d2f4553d705951ca8043d687f9493c559f494a0c,3,17,6,23,6,2014-04-05 22:16:01,2014-04-05 22:14:53
d2f4553d705951ca8043d687f9493c559f494a0c...cd914e31c9a889f18c50c15b4f6ee4959624001f,73,337,295,632,416,2014-04-06 21:33:43,2014-04-05 06:04:46
cd914e31c9a889f18c50c15b4f6ee4959624001f...78623d253b754effe61622dd3e49c266a5a85d5f,2,2,2,4,2,2014-04-07 12:30:05,2014-04-04 07:10:17
78623d253b754effe61622dd3e49c266a5a85d5f...7a7f6fccae7470efc515ecd7efb917f5cf3f8b87,1,33,1,34,2,2014-04-07 12:52:41,2014-04-05 13:11:40
7a7f6fccae7470efc515ecd7efb917f5cf3f8b87...3cba90f22a9120ebf9b00d1d074b8fb2152ecd2e,1,1,1,2,1,2014-04-07 13:04:49,2014-04-07 13:04:49
3cba90f22a9120ebf9b00d1d074b8fb2152ecd2e...d6c9bdd8258fec4d0b4270903e95a42847796608,1,1,1,2,1,2014-04-07 13:54:34,2014-04-07 13:18:08
d6c9bdd8258fec4d0b4270903e95a42847796608...36de29200e1ea713c278f7672ab1790e1500c423,1,1,1,2,1,2014-04-08 11:33:40,2014-04-08 04:15:00
36de29200e1ea713c278f7672ab1790e1500c423...c8c2b8a6382f255b4f0b8296906bdef8eebb5809,4,313,313,626,25,2014-04-08 13:52:07,2014-03-26 13:30:47
c8c2b8a6382f255b4f0b8296906bdef8eebb5809...868f37183b978f2d717a74a0a5b8a8f8d48e1209,3,3,2,5,3,2014-04-08 14:08:25,2014-04-08 14:08:25
868f37183b978f2d717a74a0a5b8a8f8d48e1209...a1fa6fcabc163f9b097d3910cd0f9f42bb9698f1,1,2,2,4,1,2014-04-08 15:13:05,2014-04-08 15:13:05
a1fa6fcabc163f9b097d3910cd0f9f42bb9698f1...d35d2f61c595fc9e6a03cfcbc21a4d5f937e3633,3,94,6,100,3,2014-04-08 15:24:49,2014-03-19 18:38:12
d35d2f61c595fc9e6a03cfcbc21a4d5f937e3633...b9bfcd82f0995b3bdd97a1c2cffa1cdd47ebc3c4,1,2,9,11,4,2014-04-08 16:15:08,2014-04-08 15:21:20
b9bfcd82f0995b3bdd97a1c2cffa1cdd47ebc3c4...2aaa045c61a3d4b325f964aa01554107b47b9774,4,39,7,46,9,2014-04-08 17:55:17,2013-09-13 15:11:48
2aaa045c61a3d4b325f964aa01554107b47b9774...5ca522b9ed13e2695576267720434659b4c1e93b,1,1,1,2,1,2014-04-09 03:58:40,2014-04-09 03:58:40
5ca522b9ed13e2695576267720434659b4c1e93b...11e7254c3dd788e0aefffcabac08f3542c9e1123,1,2,1,3,1,2014-04-09 11:38:43,2014-04-09 11:37:57
11e7254c3dd788e0aefffcabac08f3542c9e1123...2791fbf59d85a20adac22ed73c88a97fc0350426,11,19,20,39,17,2014-04-09 20:20:22,2014-04-09 20:20:22
2791fbf59d85a20adac22ed73c88a97fc0350426...5f2f47fdfcc063a60ad1c3688e0c6d44b066d549,5,40,4,44,7,2014-04-09 20:41:33,2014-04-09 20:41:33
5f2f47fdfcc063a60ad1c3688e0c6d44b066d549...071c9337750b296d198cced56f3ffad0e176afb6,6,48,13,61,9,2014-04-09 23:25:07,2014-04-08 10:52:59
071c9337750b296d198cced56f3ffad0e176afb6...f095356ba2244f6ed48463bac0b46d3c3e671204,6,94,4,98,10,2014-04-10 00:04:51,2014-03-30 17:03:35
f095356ba2244f6ed48463bac0b46d3c3e671204...59b1d3098f393f0754b60ebb710450cba9891e6e,3,16,17,33,8,2014-04-10 00:40:33,2014-04-10 00:40:33
59b1d3098f393f0754b60ebb710450cba9891e6e...7e3834adc993317bc691cc6edc0be13538dc39ad,1,5,3,8,1,2014-04-10 05:19:55,2014-04-10 05:19:55
7e3834adc993317bc691cc6edc0be13538dc39ad...b513fa5fc6f10a6e224d602bfac8f850040cef7c,7,20,10,30,11,2014-04-10 12:45:48,2014-04-10 12:45:48
b513fa5fc6f10a6e224d602bfac8f850040cef7c...395d75ea6bd1ee5259fd5a3b3ac1b028739a22d2,4,25,2,27,6,2014-04-10 13:43:55,2014-04-10 13:43:55
395d75ea6bd1ee5259fd5a3b3ac1b028739a22d2...ea5a98470467d5a53f10caf77510c77504f733dd,1,9,22,31,10,2014-04-10 17:03:23,2014-04-03 14:26:57
ea5a98470467d5a53f10caf77510c77504f733dd...b5a9166f7e0e21ae0f2cc8f218b422bc2c116fb0,2,5,1,6,3,2014-04-10 17:15:37,2014-03-31 20:35:45
b5a9166f7e0e21ae0f2cc8f218b422bc2c116fb0...d5031ecf881eaefe7ada1c35228b35a1852dd343,1,3,1,4,1,2014-04-10 17:31:59,2014-04-10 17:31:59
d5031ecf881eaefe7ada1c35228b35a1852dd343...3becac84845cee8f12a5fb7f68c87cbaf029c6a0,4,14,10,24,5,2014-04-10 18:16:12,2014-03-23 22:09:26
3becac84845cee8f12a5fb7f68c87cbaf029c6a0...25860096f981b0b3026b38329e4b69c72b1d8db9,4,38,29,67,12,2014-04-10 18:57:43,2014-03-23 20:45:31
25860096f981b0b3026b38329e4b69c72b1d8db9...8176150850b2e34b2afe1dc107e184eb4c6cd668,2,13,10,23,4,2014-04-10 19:22:47,2014-03-23 22:34:14
8176150850b2e34b2afe1dc107e184eb4c6cd668...ee837b9a22220d08fea1e499bec3b094851a1bbe,1,8,2,10,2,2014-04-10 19:22:47,2014-04-10 19:14:50
ee837b9a22220d08fea1e499bec3b094851a1bbe...c487b1e2308968b659c2509e5dd40e56ebe4e63b,1,1,1,2,1,2014-04-10 23:33:00,2014-04-10 23:32:20
c487b1e2308968b659c2509e5dd40e56ebe4e63b...476db08b1600be76adc5da539c6f7c0603d47ee5,1,4,4,8,2,2014-04-11 21:01:00,2014-04-11 21:01:00
476db08b1600be76adc5da539c6f7c0603d47ee5...3e3a7372f58e005813dd1b9e61eb85a5e43c7173,5,83,9,92,12,2014-04-12 09:42:06,2014-04-12 09:42:06
3e3a7372f58e005813dd1b9e61eb85a5e43c7173...3417ba03094b644f01597d6b5a43ccbc71a55378,3,13,2,15,6,2014-04-12 13:33:22,2014-04-12 13:31:37
3417ba03094b644f01597d6b5a43ccbc71a55378...d3b71b976dee4b02908235b8007db254a9795268,4,26,1,27,6,2014-04-12 17:34:16,2014-04-12 01:27:34
d3b71b976dee4b02908235b8007db254a9795268...b82f30785ff0f9fedf38fc79624a9064a903de4a,1,0,1,1,1,2014-04-13 01:26:25,2014-04-13 01:26:25
66cbd81456d5116f16191e0076931afd5839c49e...666990a2a09593d33d8e445398b3b322350ea993,1,1,1,2,1,2014-04-02 16:45:42,2014-04-02 16:45:42
666990a2a09593d33d8e445398b3b322350ea993...608e6eb2959c6e56e5c702ca0d15fa0e6c2eef16,1,3,0,3,1,2014-04-02 16:47:18,2014-04-02 16:47:18
608e6eb2959c6e56e5c702ca0d15fa0e6c2eef16...ca93f02c621ea0f686e0bde3e4130e99116fd9d5,2,12,14,26,2,2014-04-02 16:58:37,2014-04-02 08:08:20
ca93f02c621ea0f686e0bde3e4130e99116fd9d5...e6ced2bb086396b57601d04ad5b3ba347d1eb785,1,11,0,11,1,2014-04-02 20:11:49,2014-04-02 20:11:49
e6ced2bb086396b57601d04ad5b3ba347d1eb785...d73d0e071c1b4c86d57994a0ab55a74cfe80cdf5,117,1183,1102,2285,616,2014-04-03 11:28:10,2014-04-02 00:46:34
d73d0e071c1b4c86d57994a0ab55a74cfe80cdf5...a8e2ec0e82aaebfa53a8074581b22849896537df,2,8,4,12,2,2014-04-03 12:25:11,2014-04-02 06:14:47
a8e2ec0e82aaebfa53a8074581b22849896537df...8f63849df28449e916336a11cbbe7abf8ca03d42,1,1,1,2,1,2014-04-03 13:05:31,2014-04-03 13:05:31
8f63849df28449e916336a11cbbe7abf8ca03d42...0f6ea69e275fe5ed75479d69b0a233be9ae4fd76,1,1,1,2,1,2014-04-03 15:03:31,2014-04-03 15:03:31
0f6ea69e275fe5ed75479d69b0a233be9ae4fd76...074d3183d92cd5ed5da8f51e7048b12a96f55e0a,2,18,4,22,6,2014-04-03 18:54:16,2014-03-31 20:16:34
074d3183d92cd5ed5da8f51e7048b12a96f55e0a...c28beb429107956f8bde8053936502124c964bec,1,6,6,12,2,2014-04-03 19:24:29,2014-04-03 06:59:06
604162604bf816fa46b0d972621f06de64df6a66...6ab67919ac25143444a57f14f6aed76ffe8a6960,2,17,4,21,5,2014-05-22 12:23:51,2014-05-22 11:33:44
604162604bf816fa46b0d972621f06de64df6a66...46082339d2f87fdad4899e007ac529fb5d75e122,1,1,1,2,1,2014-05-22 10:19:54,2014-05-22 10:19:54
e8d4aed3b97493a050f69dca1f6562991d5c511b...af4a8478e4beaa5c870620d6b5a2555eaed8b850,2,17,1,18,2,2014-01-19 17:43:31,2014-01-19 17:42:29
af4a8478e4beaa5c870620d6b5a2555eaed8b850...1f5268a01f82c314b48d195b7d7a344f9db58b6d,1,7,2,9,2,2014-01-19 18:09:52,2014-01-19 18:09:52
1f5268a01f82c314b48d195b7d7a344f9db58b6d...3f1a008266e8797ae104905b4d3168fa2a33b9ae,4,67,3,70,9,2014-01-19 18:35:49,2014-01-19 18:35:49
3f1a008266e8797ae104905b4d3168fa2a33b9ae...a68f32579145dfbd51d87e14f9b5e04c770f9081,2,65,0,65,4,2014-01-19 18:56:16,2014-01-19 18:56:16
a68f32579145dfbd51d87e14f9b5e04c770f9081...b1fc8c19b20a12f30d0b3cc3eaa0a354551b8a6e,1,1,1,2,1,2014-01-19 18:57:06,2014-01-19 18:57:06
b1fc8c19b20a12f30d0b3cc3eaa0a354551b8a6e...51832c8aec73e1ead02905e9d1fb74c549567868,1,1,1,2,1,2014-01-19 18:57:59,2014-01-19 18:57:59
51832c8aec73e1ead02905e9d1fb74c549567868...34263c67b4315bb326c15d23bdf0363b3a372e17,2,2,3,5,3,2014-01-19 19:11:32,2014-01-19 19:11:32
34263c67b4315bb326c15d23bdf0363b3a372e17...6bbb82001455efb39a57c8ccfe09ff027633eced,2,59,1,60,5,2014-01-19 19:27:30,2014-01-19 19:27:10
6bbb82001455efb39a57c8ccfe09ff027633eced...6e7bd0b63bd01949ac4fd647f2597639bed0c3a2,1,2,2,4,2,2014-01-20 01:29:09,2014-01-20 01:29:09
6e7bd0b63bd01949ac4fd647f2597639bed0c3a2...d818e0c9b2b88276cc499974f9eee893170bf0a8,101,7057,1957,9014,487,2014-01-20 02:45:21,2014-01-20 02:45:21
d818e0c9b2b88276cc499974f9eee893170bf0a8...be8173af513dfb86edf8fc2fd981cc9ce101229e,4,3,3,6,4,2014-01-20 03:15:31,2014-01-20 03:15:31
be8173af513dfb86edf8fc2fd981cc9ce101229e...a029efca446025427a12ed886484890be15329d4,2,0,30,30,3,2014-01-20 04:31:35,2014-01-20 04:31:35
a029efca446025427a12ed886484890be15329d4...9ddc358e8d598f38d8443be708962d8b1f34b7e2,1,1,1,2,1,2014-01-20 05:13:16,2014-01-20 05:13:16
9ddc358e8d598f38d8443be708962d8b1f34b7e2...457c16d0d607f8940cfc75bedafa1f122e17bcb9,1,5,5,10,5,2014-01-20 08:19:23,2014-01-19 20:00:34
457c16d0d607f8940cfc75bedafa1f122e17bcb9...a9f171151814c03fcb0dcc87b153397e90562ea2,1,34,2,36,4,2014-01-20 08:52:57,2014-01-19 09:30:26
a9f171151814c03fcb0dcc87b153397e90562ea2...b86321e9a42652909d9c3373f3b97fcc9ed2c290,1,23,8,31,7,2014-01-20 08:52:58,2014-01-20 02:38:46
b86321e9a42652909d9c3373f3b97fcc9ed2c290...1c360dbbf56b76e1df7c945458ae2987306fcfcd,1,7,4,11,3,2014-01-20 08:52:58,2014-01-20 03:02:29
1c360dbbf56b76e1df7c945458ae2987306fcfcd...980eda01909c9fd5c5e16f276ca663e71371a0a2,1,12,0,12,3,2014-01-20 08:52:58,2014-01-20 08:23:40
980eda01909c9fd5c5e16f276ca663e71371a0a2...056be4358de0e747f789e4a711ea5dd51749ab11,2,8,2,10,5,2014-01-20 11:01:14,2014-01-20 11:01:14
056be4358de0e747f789e4a711ea5dd51749ab11...6ab58e3605834e1372ebc4e7f690946d070e7f91,2,3,3,6,4,2014-01-20 11:12:15,2014-01-20 11:11:27
6ab58e3605834e1372ebc4e7f690946d070e7f91...b0602e935ca8f7fca4d43083a752a6a418bb1e71,1,1,1,2,1,2014-01-20 11:48:06,2014-01-20 11:48:06
b0602e935ca8f7fca4d43083a752a6a418bb1e71...53aa6c6ac1b6534f2e3a159014401b84bf1f70c1,4,85,33,118,27,2014-01-20 12:30:29,2014-01-20 12:30:29
53aa6c6ac1b6534f2e3a159014401b84bf1f70c1...e8920e96d0a36c5bbe75e7bdaa45e0016f72cfa5,1,2,2,4,2,2014-01-20 12:46:21,2014-01-20 12:46:21
e8920e96d0a36c5bbe75e7bdaa45e0016f72cfa5...ee25ea0daf7a0d1570052e5c121ed68cde9a97db,1,0,1,1,1,2014-01-20 15:57:35,2014-01-20 15:57:35
280c1a65ccacd679bf298bf2b169ff01e7266b8e...5dfd824d38ec7d1f695494e46d603e89cae68661,3,45,41,86,21,2013-12-28 17:35:17,2013-12-28 17:35:17
5dfd824d38ec7d1f695494e46d603e89cae68661...c988745cca1225496bfd36910dc3cec5065d8cc4,3,33,24,57,15,2013-12-30 22:46:05,2013-12-30 22:45:43
c988745cca1225496bfd36910dc3cec5065d8cc4...bfe9052831c6d7ad7501b71c884525b3b471eebc,1,5,3,8,2,2013-12-30 22:54:12,2013-12-30 22:54:12
280c1a65ccacd679bf298bf2b169ff01e7266b8e...71a03e01aa19cbde08e915d156abf39b67d904ef,4,92,19,111,20,2013-12-28 16:20:18,2013-12-27 04:14:08
71a03e01aa19cbde08e915d156abf39b67d904ef...81a5e35c8d357051e558e6f0d1b6ff7a7523a537,1,3,3,6,2,2013-12-28 16:33:24,2013-12-28 16:33:24
81a5e35c8d357051e558e6f0d1b6ff7a7523a537...bbdf01e00aed1e86f6aaeba81065be21af35d415,4,34,11,45,8,2013-12-28 19:37:42,2013-12-28 19:13:08
bbdf01e00aed1e86f6aaeba81065be21af35d415...81354b82bf647fd100e836dae2639e9c8d76c5eb,3,7,16,23,7,2013-12-28 19:42:58,2013-12-28 13:24:14
81354b82bf647fd100e836dae2639e9c8d76c5eb...54790e669d73269bea6320c947ed8a46e98b8025,3,46,14,60,11,2013-12-28 19:43:29,2013-12-28 13:41:11
54790e669d73269bea6320c947ed8a46e98b8025...ba7206cd81458865bace85914905392291b05829,20,80,53,133,28,2013-12-28 19:53:00,2013-12-28 13:55:54
ba7206cd81458865bace85914905392291b05829...9f13c3328199d2fa70235cdc63bb06b1efc5b117,4,15,42,57,11,2013-12-28 19:54:26,2013-12-28 17:27:33
9f13c3328199d2fa70235cdc63bb06b1efc5b117...6d66ba59488bbd0d4f0c2f32b2921f1512301143,4,44,4,48,11,2013-12-28 20:25:32,2013-12-20 23:15:39
6d66ba59488bbd0d4f0c2f32b2921f1512301143...5782c94f2382303dd28a35a9b9591ad480286220,2,20,12,32,6,2013-12-28 21:00:16,2013-12-28 21:00:16
5782c94f2382303dd28a35a9b9591ad480286220...00110904ac67050c639f93cfd7b5e19218bcef5b,11,187,76,263,60,2013-12-29 16:53:42,2013-12-27 19:55:58
00110904ac67050c639f93cfd7b5e19218bcef5b...308960b92af90849874ff94862ef5b07b4f4d9fd,1,2,0,2,2,2013-12-29 17:25:22,2013-12-29 17:25:22
308960b92af90849874ff94862ef5b07b4f4d9fd...20d487c27b40bb70496ddc7419011ca78b7d4940,9,10,10,20,10,2013-12-29 17:48:37,2013-12-29 17:42:12
20d487c27b40bb70496ddc7419011ca78b7d4940...98b52ae201f17b3fb702403ce676c7d324f3bfbc,1,3,0,3,1,2013-12-29 18:17:25,2013-12-29 18:17:25
98b52ae201f17b3fb702403ce676c7d324f3bfbc...7b88a96553bffcaffb3d8ecb54d0ef7c3c0e934f,6,40,12,52,8,2013-12-29 19:31:59,2013-12-29 19:26:13
7b88a96553bffcaffb3d8ecb54d0ef7c3c0e934f...82aadbb5d50cca5e4c42f3f5b7cb1707b818ab28,2,3,3,6,3,2013-12-29 19:35:58,2013-12-29 19:35:58
82aadbb5d50cca5e4c42f3f5b7cb1707b818ab28...21f22f9544b0c6c4390bcd1acd98e6e5201ed83e,2,17,9,26,9,2013-12-29 19:43:10,2013-12-29 19:43:10
21f22f9544b0c6c4390bcd1acd98e6e5201ed83e...d1eb362afb0a45f16ac9f1163dd467c361de2c8d,1,0,2,2,1,2013-12-29 19:45:25,2013-12-29 19:45:25
d1eb362afb0a45f16ac9f1163dd467c361de2c8d...368d90e2616d3eb9746675e157688457e7ffcf96,1,0,1,1,1,2013-12-29 19:45:34,2013-12-29 19:45:34
368d90e2616d3eb9746675e157688457e7ffcf96...8cfcd801c4b2e6402c1c814f64db99a5b7501170,1,1,1,2,1,2013-12-29 19:57:03,2013-12-29 19:57:03
8cfcd801c4b2e6402c1c814f64db99a5b7501170...38ce41103fecf58418163b19403608988a291b56,6,8,8,16,8,2013-12-29 20:25:28,2013-12-29 20:24:40
38ce41103fecf58418163b19403608988a291b56...1d4bcb86eab521aa3f9dfc52e77d8a51448aa0f7,8,31,31,62,26,2013-12-29 20:25:28,2013-12-29 20:11:12
1d4bcb86eab521aa3f9dfc52e77d8a51448aa0f7...856aaaf2b15228bd5babbe44654c3c1ca39e8fd7,5,13,14,27,12,2013-12-29 20:25:28,2013-12-29 20:21:23
856aaaf2b15228bd5babbe44654c3c1ca39e8fd7...e5bcd1d455cd11d3892adf6717a51ae04169f705,4,13,13,26,11,2013-12-29 20:48:58,2013-12-29 20:46:26
e5bcd1d455cd11d3892adf6717a51ae04169f705...34a215d5066f8ae0629070916714801b0ea03eab,5,36,62,98,16,2013-12-29 20:48:58,2013-12-29 20:47:55
34a215d5066f8ae0629070916714801b0ea03eab...5892a83b1827a2724725f95b0ed92d2a05a11304,1,1,1,2,1,2013-12-29 20:48:58,2013-12-29 20:35:49
5892a83b1827a2724725f95b0ed92d2a05a11304...7d7b27d2b1256787849c9e3902d7aa26ac71685b,1,7,9,16,4,2013-12-29 21:35:37,2013-12-29 21:35:37
7d7b27d2b1256787849c9e3902d7aa26ac71685b...99649ddcb21b5c07258569d4585ffe3cf9eb4f38,7,62,77,139,25,2013-12-30 18:09:45,2013-12-30 17:15:49
99649ddcb21b5c07258569d4585ffe3cf9eb4f38...e5c89c62f2ea0b4d873eea8945d61cec3ba82673,1,1,1,2,1,2013-12-30 18:09:45,2013-12-30 17:52:22
e5c89c62f2ea0b4d873eea8945d61cec3ba82673...d6dc88cbc1ebc4cfba6faf39edf6eebd41873029,1,6,5,11,1,2013-12-30 21:10:04,2013-12-30 16:00:50
d6dc88cbc1ebc4cfba6faf39edf6eebd41873029...0d2c8ff2be733c7cc83a023bbafe0258faa5603c,4,18,12,30,10,2013-12-30 21:11:16,2013-12-30 10:12:40
0d2c8ff2be733c7cc83a023bbafe0258faa5603c...e187caa3afd7d292353fb32be1647da2cf0968da,3,14,0,14,3,2013-12-30 21:11:16,2013-12-30 11:49:53
e187caa3afd7d292353fb32be1647da2cf0968da...c31d7c48139260ccb72deda9b0033db0db86e84a,2,33,15,48,6,2013-12-30 21:11:17,2013-12-30 12:24:24
c31d7c48139260ccb72deda9b0033db0db86e84a...7ed20e015335076fc98ad805eaf241f8a0d872d5,5,21,27,48,12,2013-12-30 21:11:17,2013-12-30 15:03:06
7ed20e015335076fc98ad805eaf241f8a0d872d5...80d74097b4bd7186ad99b6d41d0ed90347a39b21,13,65,52,117,30,2013-12-30 21:11:17,2013-12-30 14:42:15
80d74097b4bd7186ad99b6d41d0ed90347a39b21...966de8497373dc47756105516b4b839734ed316e,1,6,30,36,4,2013-12-30 22:01:00,2013-12-30 22:01:00
966de8497373dc47756105516b4b839734ed316e...1c242a297b5b1857d76cab9b24f9f1d3b7f5240d,4,22,65,87,20,2013-12-30 22:18:22,2013-12-30 22:15:29
1c242a297b5b1857d76cab9b24f9f1d3b7f5240d...0150830687188681ba7e4ae9b6da1a832a6d5141,1,4,0,4,1,2013-12-30 22:42:11,2013-12-30 22:42:11
0150830687188681ba7e4ae9b6da1a832a6d5141...270f7e21676f043464e9a3e252fec0a63e3c0b2a,1,5,2,7,2,2013-12-30 22:55:12,2013-12-30 22:55:12
b82f30785ff0f9fedf38fc79624a9064a903de4a...8da86fd19b0907d3ea20593ca75073dce727d1aa,1,1,1,2,1,2014-04-13 22:52:43,2014-04-13 22:52:43
b82f30785ff0f9fedf38fc79624a9064a903de4a...72d3889db4eb3a14acb94f613edd79f0f27d26e3,13,76,12,88,27,2014-04-13 22:22:26,2014-03-31 19:25:08
3545f31bcf91065303c1adaa5154b28e8f8a5d78...48348782e65438829147d0d066276d1caa0d485b,1,14,0,14,1,2014-05-22 12:50:13,2014-05-22 12:42:31
48348782e65438829147d0d066276d1caa0d485b...635acf42c53e77e1ab0fd61e248730d99501c5c1,1,2,1,3,2,2014-05-22 14:05:19,2014-05-22 14:05:19
635acf42c53e77e1ab0fd61e248730d99501c5c1...ad994a3c5b5911a12a5e2f2a8d06c036be1b8ad8,2,18,2,20,3,2014-05-22 14:15:09,2014-05-22 11:29:30
ad994a3c5b5911a12a5e2f2a8d06c036be1b8ad8...beec05686ccc3bee8461f9a5a02c607a02352ae1,7,85,82,167,67,2014-05-22 15:59:17,2014-05-20 19:54:56
beec05686ccc3bee8461f9a5a02c607a02352ae1...756c390fb5bce5157d2882526be0b99f45ce52c9,2,71,1,72,2,2014-05-22 16:33:10,2014-05-22 15:08:32
756c390fb5bce5157d2882526be0b99f45ce52c9...4dc4d12e27e4e0337568651136eee5b6f2171204,4,222,201,423,38,2014-05-22 22:35:16,2013-12-12 09:59:05
4dc4d12e27e4e0337568651136eee5b6f2171204...be88b062afaa58559bb12623e8ed8843f07b97a1,2,13,0,13,2,2014-05-23 00:29:48,2014-05-22 22:45:02
be88b062afaa58559bb12623e8ed8843f07b97a1...f851a954ac605c4a525761a18d2dcbfb6f8deeca,9,326,0,326,8,2014-05-23 12:05:46,2014-05-20 14:29:32
f851a954ac605c4a525761a18d2dcbfb6f8deeca...f01d2a8f9be8bc2005b7f1620a2ca40530fb5065,1,1,1,2,1,2014-05-23 12:50:10,2014-05-23 12:50:10
f01d2a8f9be8bc2005b7f1620a2ca40530fb5065...19b490820678cc8a5d0bd068127e425178799e34,1,3,6,9,4,2014-05-24 09:02:58,2014-05-24 08:53:22
19b490820678cc8a5d0bd068127e425178799e34...dbb48d2bb99a5f660cf2d85f137b8d87fc12d99f,2,20,11,31,16,2014-05-24 09:51:57,2014-05-24 09:51:57
dbb48d2bb99a5f660cf2d85f137b8d87fc12d99f...f47e226ff7d2460ebe587d4fc1565b113b1c709f,1,6,13,19,10,2014-05-24 11:29:23,2014-05-24 11:29:23
f47e226ff7d2460ebe587d4fc1565b113b1c709f...9fb0f5dddc4cf7f2d294af1bcde2c359cffd90a5,5,39,13,52,6,2014-05-24 12:10:50,2014-05-24 09:52:18
9fb0f5dddc4cf7f2d294af1bcde2c359cffd90a5...63fc91b3cac523690655c1d86d09972e0cc3a29d,5,79,33,112,7,2014-05-24 13:56:18,2014-05-22 09:42:46
63fc91b3cac523690655c1d86d09972e0cc3a29d...b8fc167b32926e09d6d73eddc555343360f9c087,1,9,0,9,1,2014-05-24 13:58:57,2014-05-24 13:57:04
b8fc167b32926e09d6d73eddc555343360f9c087...3caf957ed5eaa831a485abcb89f27266dbf3e82b,4,49,103,152,12,2014-05-24 14:18:45,2014-05-24 14:18:45
3caf957ed5eaa831a485abcb89f27266dbf3e82b...c5d73b687d21658e61ff63ba4dd477c8079a11c9,1,1,1,2,1,2014-05-24 14:22:08,2014-05-24 14:22:08
c5d73b687d21658e61ff63ba4dd477c8079a11c9...2779c299c8b7e4556b5285acc86d17560522e702,1,2,14,16,3,2014-05-25 19:25:23,2014-05-25 19:25:23
2779c299c8b7e4556b5285acc86d17560522e702...b7de5f5d3f0d895c29ed27ad872d360bf95c8a2f,3,106,95,201,17,2014-05-25 20:23:17,2014-05-25 20:08:05
b7de5f5d3f0d895c29ed27ad872d360bf95c8a2f...417ec4a68b0460bd563801549ca90de64e55face,2,1,3,4,3,2014-05-25 21:01:41,2014-05-25 21:01:41
417ec4a68b0460bd563801549ca90de64e55face...536ebaa048f69c18aa36448074f65f2741e35df5,2,2,1,3,2,2014-05-25 21:14:50,2014-05-25 21:14:50
536ebaa048f69c18aa36448074f65f2741e35df5...9d1bf8f841af27c70d1fa5817e88d893ce7c0507,5,0,0,0,0,2014-05-25 21:16:40,2014-05-25 21:16:40
9d1bf8f841af27c70d1fa5817e88d893ce7c0507...ee51ab9d232e52d17cd5ad32e230fd715cffe638,1,1,1,2,1,2014-05-25 22:07:15,2014-05-25 22:07:15
ee51ab9d232e52d17cd5ad32e230fd715cffe638...2b432d4634c693c177433aff69ec73e1fd1dd80f,1,1,1,2,1,2014-05-25 23:01:51,2014-05-25 07:24:53
2b432d4634c693c177433aff69ec73e1fd1dd80f...83f4e865956e6527b4155ae03e313b36ccbe274f,1,1,1,2,1,2014-05-25 23:26:12,2014-05-25 23:25:43
83f4e865956e6527b4155ae03e313b36ccbe274f...e98d303562a50c57b55bbe2d4ebdec76f6624770,1,9,0,9,1,2014-05-25 23:34:20,2014-05-24 17:31:34
e98d303562a50c57b55bbe2d4ebdec76f6624770...b625e861e5d2709a16588ecb82f46e1fb86004c7,1,1,1,2,1,2014-05-26 13:44:50,2014-05-26 13:44:50
b625e861e5d2709a16588ecb82f46e1fb86004c7...2e613ea5c52d4d12e071987178af18c0371d6e2f,3,41,2,43,5,2014-05-26 21:40:55,2014-05-26 20:09:17
ee25ea0daf7a0d1570052e5c121ed68cde9a97db...8efd20f96d2045cf08baded98e18d241e4c6122d,4,304,152,456,40,2014-01-20 18:32:07,2014-01-10 00:31:36
8efd20f96d2045cf08baded98e18d241e4c6122d...56516ade5ebde53af16ffdf97d3dce8d27a31e4b,1,2,1,3,3,2014-01-21 00:51:23,2014-01-21 00:51:23
56516ade5ebde53af16ffdf97d3dce8d27a31e4b...6070a5d6a6950bdbd93853c4b1636c7eec820b20,2,35,6,41,5,2014-01-21 03:25:33,2014-01-21 03:25:33
6070a5d6a6950bdbd93853c4b1636c7eec820b20...fb862c875eae6b61bd1939bf071ba48890524679,1,7,3,10,3,2014-01-21 04:08:02,2014-01-21 04:08:02
fb862c875eae6b61bd1939bf071ba48890524679...8482ab6633c8d2e05e151ffaf0ee045f881febe7,1,0,3,3,3,2014-01-21 04:58:05,2014-01-21 04:58:05
8482ab6633c8d2e05e151ffaf0ee045f881febe7...151dae2bea1dad9fa8f24ea8adcf58dbb1820aa8,1,1,1,2,1,2014-01-21 08:21:51,2014-01-21 08:21:51
151dae2bea1dad9fa8f24ea8adcf58dbb1820aa8...494b408041c59e9079e624040d48412559f241ae,1,14,16,30,4,2014-01-21 10:37:49,2014-01-21 10:37:49
ee25ea0daf7a0d1570052e5c121ed68cde9a97db...8649833cf816069204ef806c42c4551c6ebc5d10,1,1,1,2,1,2014-01-20 16:33:11,2014-01-20 16:33:11
df075c74896b63ff39c250bb52a1f168265dfeee...ec020cab7ef4b1943a8fe9a4d6872f7e874db707,1,1,1,2,1,2013-12-30 22:59:18,2013-12-30 22:59:18
ec020cab7ef4b1943a8fe9a4d6872f7e874db707...bfcc686d22df10c268752635947dd242317ba156,11,34,67,101,27,2013-12-30 22:59:34,2013-12-30 22:53:54
bfcc686d22df10c268752635947dd242317ba156...a5e2a0e569809b7ea0c379e12d637ef0e5c9c8b9,1,7,0,7,2,2013-12-30 23:10:49,2013-12-30 23:08:55
a5e2a0e569809b7ea0c379e12d637ef0e5c9c8b9...0b825adcf2a4608c8fb02a19cc56dc96ef1414a1,10,0,0,0,0,2013-12-31 10:25:02,2013-12-31 10:25:02
0b825adcf2a4608c8fb02a19cc56dc96ef1414a1...7b119c1c77c8e0d17b55088f83a1552c73ceb31c,1,1,1,2,1,2013-12-31 10:34:03,2013-12-31 02:31:21
7b119c1c77c8e0d17b55088f83a1552c73ceb31c...1fb873cd6bb1867b71151bcf0c84ba8ebd205326,2,7,7,14,7,2013-12-31 10:56:41,2013-12-31 10:56:41
1fb873cd6bb1867b71151bcf0c84ba8ebd205326...6b172a6d6dcfe88be4dc0e5052707a756c1c830c,1,6,6,12,3,2013-12-31 12:11:05,2013-12-31 12:09:47
6b172a6d6dcfe88be4dc0e5052707a756c1c830c...587b678d41e481294a302a8467121162bf06f274,1,3,1,4,3,2013-12-31 12:12:53,2013-12-31 12:12:30
587b678d41e481294a302a8467121162bf06f274...a95f74e7078e2f38935e3de5e3229b8ff585ae00,1,1,0,1,1,2013-12-31 12:16:51,2013-12-31 12:16:34
a95f74e7078e2f38935e3de5e3229b8ff585ae00...9953e98e6ad9298869cd12e20bd3c05c0d19fa10,6,1614,1614,3228,10,2013-12-31 13:14:09,2013-12-31 11:24:11
9953e98e6ad9298869cd12e20bd3c05c0d19fa10...80004c7cc08b849ec7d18f1699429dd9cc95af57,1,1,1,2,1,2013-12-31 14:27:25,2013-12-31 13:07:40
80004c7cc08b849ec7d18f1699429dd9cc95af57...f46603f8304a5b39c3b3064ec819587a78937113,2,62,24,86,5,2013-12-31 14:27:25,2013-12-31 13:09:19
f46603f8304a5b39c3b3064ec819587a78937113...69f0249d7b6dfbf278bbc2d5907f598d5ed241af,1,33,4,37,3,2013-12-31 15:20:44,2013-12-31 15:20:44
69f0249d7b6dfbf278bbc2d5907f598d5ed241af...75220d3b5dbe03ef70d42433178a9598133a4ac1,1,8,4,12,4,2013-12-31 15:24:40,2013-12-31 15:13:40
75220d3b5dbe03ef70d42433178a9598133a4ac1...d0eeddd6fcd93b23bb632ad3ea95ae3f871907e3,2,15,12,27,6,2013-12-31 15:26:44,2013-12-31 13:36:45
d0eeddd6fcd93b23bb632ad3ea95ae3f871907e3...553500133cc4426f20407391f3493716357db45f,2,0,26,26,2,2013-12-31 16:29:04,2013-12-31 15:22:07
553500133cc4426f20407391f3493716357db45f...5dfec4e23b4a3b81f8ec19bf0cf45147ad6b18e5,1,12,1,13,3,2013-12-31 16:29:04,2013-12-31 15:22:42
5dfec4e23b4a3b81f8ec19bf0cf45147ad6b18e5...c40209dcc09f19524fb85251f39a4051491bbec0,8,84,32,116,18,2013-12-31 16:30:58,2013-12-31 15:23:42
c40209dcc09f19524fb85251f39a4051491bbec0...63137a8304d4387132e749c97aad1049526f601c,4,36,8,44,6,2013-12-31 17:04:54,2013-12-31 16:25:57
63137a8304d4387132e749c97aad1049526f601c...1d23d766ab85301eb527629400933fd601355f1a,6,11,11,22,10,2013-12-31 17:04:54,2013-12-31 16:55:12
1d23d766ab85301eb527629400933fd601355f1a...b8e3373f458aa363d59c61b58be390a5a1156467,5,36,41,77,18,2013-12-31 17:35:00,2013-12-31 11:28:01
b8e3373f458aa363d59c61b58be390a5a1156467...4d8d76e7a89858932b6f4f280a0ebf4cf94ab4b7,1,8,3,11,2,2013-12-31 18:02:01,2013-12-31 18:02:01
4d8d76e7a89858932b6f4f280a0ebf4cf94ab4b7...4befb3015c26810a68cfcf57e0cd8b062f56f1c5,6,45,26,71,13,2013-12-31 19:58:49,2013-12-09 17:29:39
4befb3015c26810a68cfcf57e0cd8b062f56f1c5...a502bbb2f0910753007b344e8cc07e74a93dcc09,1,1,1,2,1,2014-01-01 00:23:20,2014-01-01 00:23:20
a502bbb2f0910753007b344e8cc07e74a93dcc09...fecfd5030036d370c10114f1817605a3e47e73ff,8,143,162,305,106,2014-01-01 10:01:46,2014-01-01 10:01:46
fecfd5030036d370c10114f1817605a3e47e73ff...6edd5b0793281865833edec17ac45b1ddb21ba50,1,1,4,5,4,2014-01-01 10:52:56,2014-01-01 10:52:56
6edd5b0793281865833edec17ac45b1ddb21ba50...fbbe7ca30c9bd4c1f1d4611118da6c746be89566,1,1,0,1,1,2014-01-01 11:07:43,2014-01-01 11:07:43
fbbe7ca30c9bd4c1f1d4611118da6c746be89566...18d962f2e6cc8829d60d6f6dfb3ee3855fa5362e,2,28,12,40,5,2014-01-01 11:40:16,2013-12-31 17:41:34
18d962f2e6cc8829d60d6f6dfb3ee3855fa5362e...2139e09d83aa40fa12d2a0b726d21521eec86583,1,1,8,9,2,2014-01-01 11:41:43,2013-12-31 20:47:14
2139e09d83aa40fa12d2a0b726d21521eec86583...8a2f304a798497373a19530e58d7290d13e35e6d,1,23,10,33,4,2014-01-01 15:51:58,2014-01-01 15:48:16
8a2f304a798497373a19530e58d7290d13e35e6d...f17d00278ee4a22421dc8148588d94fe7fa17427,2,29,30,59,7,2014-01-01 17:11:09,2014-01-01 17:01:06
f17d00278ee4a22421dc8148588d94fe7fa17427...0ce945a67151acf2c58bc35a47f4c3d45ff30085,10,50,2,52,7,2014-01-01 17:11:15,2014-01-01 17:05:12
0ce945a67151acf2c58bc35a47f4c3d45ff30085...791142e8b3e35bb387f4efbb6c7f73f2171a7164,2,2,3,5,4,2014-01-01 17:37:52,2014-01-01 17:37:52
791142e8b3e35bb387f4efbb6c7f73f2171a7164...30a42a4fc36edfad51f0e4f28e5c776434302d1c,1,2,2,4,2,2014-01-01 18:12:46,2014-01-01 18:11:54
30a42a4fc36edfad51f0e4f28e5c776434302d1c...1386075f62dfdee4584e76e7d86dff72f5d3c7ed,2,2,5,7,3,2014-01-01 18:45:43,2014-01-01 18:44:39
1386075f62dfdee4584e76e7d86dff72f5d3c7ed...b2d78939d171f12ae7baaf0a2fa5a29b43bb2e47,2,8,5,13,3,2014-01-01 21:59:12,2014-01-01 21:55:50
b2d78939d171f12ae7baaf0a2fa5a29b43bb2e47...7a30eab06e05f9c5901ad2f70378948450473c88,1,1,1,2,1,2014-01-02 09:06:52,2014-01-02 09:06:52
63d0cbab042c981d6ef63a3193fb1fa0027db0fd...9b29a551e4a6a2bc50ade95b0ccce1d3633f85da,1,66,27,93,14,2014-04-14 22:19:37,2014-04-14 18:19:11
63d0cbab042c981d6ef63a3193fb1fa0027db0fd...09af48c70fb5cc652ea109487015472e9ef984df,4,183,1,184,13,2014-04-14 17:07:02,2014-04-14 17:07:02
09af48c70fb5cc652ea109487015472e9ef984df...17c18844561431aabed89c3bd48de951db7d13ab,6,59,3,62,11,2014-04-14 19:55:10,2014-04-14 19:13:49
17c18844561431aabed89c3bd48de951db7d13ab...0bcc92c6917738caa2f08ec16d26fad62974fb47,3,38,0,38,3,2014-04-14 20:49:40,2014-04-14 18:41:47
2e613ea5c52d4d12e071987178af18c0371d6e2f...b7aa7c4ab4372d2b7994d252c8bc87f77dd217ae,10,70,18,88,26,2014-05-28 15:22:46,2014-05-27 21:13:08
2e613ea5c52d4d12e071987178af18c0371d6e2f...4865326f2200aa1c480526feef5428cf780ab3c6,2,30,25,55,9,2014-05-27 19:43:52,2014-05-27 16:57:53
4865326f2200aa1c480526feef5428cf780ab3c6...fe53bc524b9c7cbc814868acde94226d0ba2bc84,1,3,48,51,3,2014-05-27 20:18:51,2014-05-27 20:18:51
fe53bc524b9c7cbc814868acde94226d0ba2bc84...f011b903630b3167dc960829ec8c4cb5d46c2b94,1,0,3,3,1,2014-05-27 20:28:49,2014-05-27 20:28:49
f011b903630b3167dc960829ec8c4cb5d46c2b94...fed2877cf1307eb9c3ef36787fe96a51526db17e,1,1,1,2,1,2014-05-27 22:23:44,2014-05-27 22:23:44
fed2877cf1307eb9c3ef36787fe96a51526db17e...d0f7c7f59abaab88335c840f5a2d886434381100,1,1,1,2,1,2014-05-27 22:28:13,2014-05-27 22:28:13
d0f7c7f59abaab88335c840f5a2d886434381100...2ea1e70b85fee2ee1229c62b82ae283bea68cb73,1,8,5,13,1,2014-05-27 23:42:16,2014-05-27 18:53:19
2ea1e70b85fee2ee1229c62b82ae283bea68cb73...4b57e203fe8c1550e5235a064a875bbeca293953,4,6,5,11,6,2014-05-27 23:46:48,2014-05-27 23:46:48
4b57e203fe8c1550e5235a064a875bbeca293953...e97b7a26779054e7bb4326c688b0ed7823037dec,9,15,31,46,22,2014-05-28 07:24:08,2014-05-28 07:22:53
e97b7a26779054e7bb4326c688b0ed7823037dec...fd427f1fe3c563d5fe0badfec0a39d6cd43454da,2,8,3,11,3,2014-05-28 15:57:40,2014-05-28 15:57:40
fd427f1fe3c563d5fe0badfec0a39d6cd43454da...32586b0ba43816d325be0ce807f75623683eed7a,5,26,1,27,6,2014-05-28 17:23:28,2014-05-23 07:07:15
32586b0ba43816d325be0ce807f75623683eed7a...7e3cf3cfd27e53ced0a1fc65a02849f78a292d3d,1,2,1,3,1,2014-05-28 17:51:39,2014-05-26 11:52:37
8606785faad2ce637d5265726f3b4adba5bd1286...088cb711fe8c8bfb6af04ac7ef094817802c4256,1,2,1,3,2,2014-01-21 16:40:52,2014-01-21 16:40:52
7a30eab06e05f9c5901ad2f70378948450473c88...6dd8631617de56aae72f7d6b3708b83459d629c2,1,5,5,10,5,2014-01-02 19:22:52,2014-01-02 19:22:52
401be8a2062c359f7acea6b0ace30e96b8f30574...0f37d2e4c0175d7b0ebe63e1146250437fc88cd0,1,4,6,10,6,2014-04-15 21:44:37,2014-04-15 21:43:29
0f37d2e4c0175d7b0ebe63e1146250437fc88cd0...4e3d8ae61055dbb83d193585f2f36af6537b31cc,1,3,0,3,1,2014-04-15 21:47:51,2014-04-15 20:15:32
4e3d8ae61055dbb83d193585f2f36af6537b31cc...465980d070a33555cdabb4787db50a4e23228de2,2,8,5,13,4,2014-04-16 11:22:15,2014-04-16 11:22:15
465980d070a33555cdabb4787db50a4e23228de2...ae5b6627965bc8342ad533e7c4dcb5bde3bcedc8,1,10,0,10,1,2014-04-16 11:47:56,2014-04-16 11:47:56
ae5b6627965bc8342ad533e7c4dcb5bde3bcedc8...eefad142dee466c1ead6038fbeec75479b1afead,2,2,2,4,2,2014-04-16 12:36:02,2014-04-16 12:35:17
eefad142dee466c1ead6038fbeec75479b1afead...28102991172ab931d030412275f926c1b05c688d,1,1,1,2,1,2014-04-16 13:33:53,2014-04-16 13:19:55
28102991172ab931d030412275f926c1b05c688d...b5ce21accb57a5b70420574647d56eb837eb7722,4,5,3,8,5,2014-04-16 13:39:00,2014-04-16 13:39:00
b5ce21accb57a5b70420574647d56eb837eb7722...0e45669fa9eb82c6de8e226c6da53ab5e88575f5,2,26,2,28,2,2014-04-16 19:38:31,2014-04-16 14:55:34
0e45669fa9eb82c6de8e226c6da53ab5e88575f5...79f05616fbf48cf7c205ef17666af0c3d47b3c1e,5,11,14,25,15,2014-04-16 20:49:37,2014-04-16 20:49:37
79f05616fbf48cf7c205ef17666af0c3d47b3c1e...7cd74fc96ee982acfed7a98e76d4623eabde146d,1,5,0,5,2,2014-04-16 21:35:17,2014-04-16 19:03:25
7cd74fc96ee982acfed7a98e76d4623eabde146d...a13df671a5a5b867397ce05f73a59a3f4504868a,2,43,42,85,11,2014-04-16 21:57:11,2014-04-14 20:11:52
a13df671a5a5b867397ce05f73a59a3f4504868a...030dd4f72ca4d84c0a5e09ee625123d03651fdd1,1,28,10,38,4,2014-04-17 00:29:17,2014-04-14 17:09:17
030dd4f72ca4d84c0a5e09ee625123d03651fdd1...66ec9ee441618894c1ccebdcdd5eb4d7fbf4a6d3,38,181,181,362,145,2014-04-17 00:36:29,2014-04-14 18:12:44
66ec9ee441618894c1ccebdcdd5eb4d7fbf4a6d3...47927eb786f432cb069f0b00fd810c465a78fd71,6,13,48,61,9,2014-04-17 01:03:22,2014-04-17 01:03:22
2a5c750ad151c51d875d41eb080e4c160e8a2627...7b064e539009b4845ca31bd4a3dd5a9b913d1a0e,1,134,98,232,34,2014-06-01 16:36:32,2014-05-20 07:38:12
7b064e539009b4845ca31bd4a3dd5a9b913d1a0e...5b98ba08e2cc8760525fc1e0a2c917c063b0d5e2,2,115,115,230,9,2014-06-01 17:05:19,2014-05-24 20:39:55
5b98ba08e2cc8760525fc1e0a2c917c063b0d5e2...f384b638e20ba33fee948cbf5aa816e2512b0479,1,1,1,2,1,2014-06-01 17:19:42,2014-06-01 10:32:52
f384b638e20ba33fee948cbf5aa816e2512b0479...7a38f889222dfbdf0e0d8d22001c30264d420054,3,34,11,45,9,2014-06-01 19:10:38,2014-05-22 22:51:11
7a38f889222dfbdf0e0d8d22001c30264d420054...d04e7302240f5be34cdd303002bc8e7dcd81f529,2,43,1,44,3,2014-06-01 19:36:25,2014-05-27 15:48:50
d04e7302240f5be34cdd303002bc8e7dcd81f529...5a504a5311b0108586e633128f6ef8be6e05249a,1,5,1,6,1,2014-06-01 20:03:33,2014-06-01 20:03:33
5a504a5311b0108586e633128f6ef8be6e05249a...5046c110cfbf5e867fec47c8c68677a76c9e1b68,2,0,21,21,3,2014-06-02 11:05:38,2014-06-02 11:05:38
5046c110cfbf5e867fec47c8c68677a76c9e1b68...ce993efda876b19569267badb6af5fd0e80cdee3,3,37,11,48,6,2014-06-02 13:32:38,2014-05-28 22:26:57
ce993efda876b19569267badb6af5fd0e80cdee3...a00efa30d6e5ca220b914415904fff5fa0a6f2c5,1,8,3,11,4,2014-06-02 15:35:20,2014-06-02 15:35:20
a00efa30d6e5ca220b914415904fff5fa0a6f2c5...11f0899bbe7c04dc6109f57c3b36ed8621b8f08e,10,120,17,137,22,2014-06-02 19:22:15,2014-04-15 03:58:51
11f0899bbe7c04dc6109f57c3b36ed8621b8f08e...e0208944708aa9e1034531a047a731b1c93b50c6,1,3,1,4,2,2014-06-02 22:50:50,2014-06-02 20:19:12
7e3cf3cfd27e53ced0a1fc65a02849f78a292d3d...6cfa2fae3963c11e4c8ad180decba2928736dba0,1,2,1,3,1,2014-05-28 23:00:30,2014-05-28 23:00:30
6cfa2fae3963c11e4c8ad180decba2928736dba0...bf9953cfb8d92f2757b6d5f0ba93d03533321619,1,21,0,21,2,2014-05-28 23:38:59,2014-05-28 23:38:59
7e3cf3cfd27e53ced0a1fc65a02849f78a292d3d...69337d485cd3f8cc938bebbf2d01121e0d688889,3,3,3,6,3,2014-05-28 18:16:24,2014-05-28 18:16:24
088cb711fe8c8bfb6af04ac7ef094817802c4256...a4fbdcdf660fe1f032a332fb51ad37104117b41f,2,3,3,6,3,2014-01-22 08:26:38,2014-01-22 01:54:55
088cb711fe8c8bfb6af04ac7ef094817802c4256...047394f79c2cbc6cf44684a1f0d17aba1ddfe1c8,2,18,0,18,3,2014-01-22 08:21:54,2014-01-22 08:06:06
7f110e7959a11608ba2714e563d67b2cdf61049c...aaf5b3e7aad6fc8250143655854cc03c3b0a68c8,1,6,4,10,2,2014-01-02 19:47:40,2014-01-02 19:43:45
47927eb786f432cb069f0b00fd810c465a78fd71...464b98b1feda5e5b41c961cf4386cc116f1618bd,2,6,3,9,2,2014-04-17 18:28:09,2014-04-17 18:28:09
464b98b1feda5e5b41c961cf4386cc116f1618bd...0e27882b3a51a09edf2ce0e8ca1a4480aea335b5,1,1,1,2,1,2014-04-17 18:29:07,2014-04-17 18:29:07
47927eb786f432cb069f0b00fd810c465a78fd71...cb68eb3e6dd740185734ffcbc4e287860fcc118d,2,69,51,120,2,2014-04-17 18:02:42,2014-04-17 18:02:42
cb68eb3e6dd740185734ffcbc4e287860fcc118d...21a1fddcc417c8af2f97d55fb83f645d8f3b5a19,1,2,2,4,1,2014-04-17 18:04:57,2014-04-17 18:04:57
21a1fddcc417c8af2f97d55fb83f645d8f3b5a19...7283c21173a8f338850f5e61d44aa9a39b5553a5,1,3,4,7,1,2014-04-17 18:07:19,2014-04-17 18:07:19
47927eb786f432cb069f0b00fd810c465a78fd71...00e3b9a2a992ee0b7288eeeb03e7cbd52ebc6dce,7,158,26,184,21,2014-04-17 16:54:35,2014-04-08 05:30:25
00e3b9a2a992ee0b7288eeeb03e7cbd52ebc6dce...c082f3c74c63f0939e349896cc802205a8863dfa,3,6,8,14,6,2014-04-17 19:18:07,2014-04-17 19:10:41
c082f3c74c63f0939e349896cc802205a8863dfa...3cea917e3e8a26b5b701c160f4f6e03b1b85cf84,1,4,4,8,4,2014-04-17 19:23:14,2014-04-17 19:23:14
e0208944708aa9e1034531a047a731b1c93b50c6...4445d36d471aae81086ed785536687a92e5aaa6d,16,134,114,248,62,2014-06-03 11:30:14,2014-06-03 11:30:14
e0208944708aa9e1034531a047a731b1c93b50c6...f39b8867a1b30d6e9f1dff2a544c89354dd55b0d,1,1,1,2,1,2014-06-03 03:49:43,2014-06-03 03:49:43
61185bba72dbb13e4f5f233f6be790957a57914c...e79725cdf90e3271626ed66f70b63640d3fcc521,1,1,1,2,1,2014-05-29 00:17:58,2014-05-29 00:17:58
e79725cdf90e3271626ed66f70b63640d3fcc521...1dcc603efff8229838f27019668d864a0bcbfa59,34,40,40,80,40,2014-05-29 00:39:14,2014-05-29 00:39:14
1dcc603efff8229838f27019668d864a0bcbfa59...d240b29c086f434c87c2a5be7af539ceb8c0f55f,1,1,1,2,1,2014-05-29 00:46:06,2014-05-29 00:46:06
a5ec11c4bbb8f82e02871f154b3cfe0008b00a2b...c3fdeb28fff35573bf86ef04b234c7f5817b0dea,3,32,3,35,5,2014-01-22 14:13:15,2014-01-21 17:25:33
c3fdeb28fff35573bf86ef04b234c7f5817b0dea...03395b4277f3bcd52d5582041b5ea84dcffc1015,1,2,2,4,2,2014-01-22 15:15:27,2014-01-22 15:15:27
03395b4277f3bcd52d5582041b5ea84dcffc1015...6f06c749b73abea84cd61a7bcfd1cc9732fbefe5,1,3,2,5,1,2014-01-22 15:17:44,2014-01-22 15:17:44
6f06c749b73abea84cd61a7bcfd1cc9732fbefe5...2ba09c000d643eaba39a0e80b0329d55b0ae2d2c,1,1,1,2,1,2014-01-22 15:21:05,2014-01-22 15:21:05
2ba09c000d643eaba39a0e80b0329d55b0ae2d2c...dfc092622e5e55081f9a76fddea752494c4505ba,1,9,3,12,1,2014-01-22 15:44:50,2014-01-22 15:44:50
dfc092622e5e55081f9a76fddea752494c4505ba...4416aa1d3f22e5ac88a628ab52a5d19023b58b26,1,2,2,4,1,2014-01-22 16:04:44,2014-01-22 16:03:55
4416aa1d3f22e5ac88a628ab52a5d19023b58b26...5f9790072d52443aff9a0e04f1552f1e29489521,1,33,0,33,1,2014-01-22 18:08:51,2014-01-16 12:46:35
5f9790072d52443aff9a0e04f1552f1e29489521...79e1d6ebd70898d514a44b85648e3d24104c4243,11,71,71,142,71,2014-01-22 21:17:32,2014-01-22 21:17:32
79e1d6ebd70898d514a44b85648e3d24104c4243...05d36dc06e6d767bb28993c65a54b703f319a386,11,36,36,72,36,2014-01-22 21:26:10,2014-01-22 21:26:10
aaf5b3e7aad6fc8250143655854cc03c3b0a68c8...44d40ba5216f396aabaee6c7a0c7be75e1173ff2,1,2,2,4,2,2014-01-02 20:14:11,2014-01-02 20:14:11
ecff136f69c33e978553c016e0777d9a94b76b3b...11e30b684d1a74bf7cc3b3bd22c0ffbdaa28f0a0,2,17,1,18,2,2014-04-17 23:57:20,2014-04-10 12:03:50
11e30b684d1a74bf7cc3b3bd22c0ffbdaa28f0a0...a4acb804634af17cfd9ee7070ec3865d7cc2a7a3,3,20,7,27,5,2014-04-18 00:36:52,2014-04-18 00:21:22
a4acb804634af17cfd9ee7070ec3865d7cc2a7a3...214d1e1b0f1574ecab856f0096e409109efa9523,1,1,1,2,1,2014-04-18 00:41:25,2014-04-17 14:16:36
214d1e1b0f1574ecab856f0096e409109efa9523...0d397e5a5b98c475b664ff12f11729671fe1ad42,7,26,158,184,22,2014-04-18 05:27:30,2014-04-18 05:27:30
593b3c32bd299c7f03cf1a62173d0c4d23a4e975...c5226eb72acab8622b572b5d494fa951f26d0025,1,1,1,2,1,2014-06-03 11:44:06,2014-06-03 03:38:05
c5226eb72acab8622b572b5d494fa951f26d0025...7be646425f62734cbd457b93c2b7cf5aa14f923b,1,4,4,8,2,2014-06-03 12:10:07,2014-06-03 07:02:03
d240b29c086f434c87c2a5be7af539ceb8c0f55f...56cfa508c796ad317e813647eadd9f7142f6d2dc,3,51,1,52,4,2014-05-29 22:23:09,2014-05-29 22:23:09
d240b29c086f434c87c2a5be7af539ceb8c0f55f...62f9508ade5233fc7bf8af5b3afcd2f5b57d8288,2,53,7,60,5,2014-05-29 16:01:55,2013-11-24 17:12:46
d240b29c086f434c87c2a5be7af539ceb8c0f55f...45fa5201874df2883be003b7ed29ac14751431b8,6,115,17,132,7,2014-05-29 10:42:11,2014-05-29 10:30:47
05d36dc06e6d767bb28993c65a54b703f319a386...b8c82419455587843df95c01bd9555eaab094854,1,19,0,19,1,2014-01-23 11:45:25,2014-01-23 11:45:25
b8c82419455587843df95c01bd9555eaab094854...81830ce34f351f8dffa5febb6fd8712585576cf5,1,5,5,10,1,2014-01-23 14:01:26,2014-01-23 14:01:26
81830ce34f351f8dffa5febb6fd8712585576cf5...12303ab738ab6c6eecf1f546aa9c0fb8ba5df950,1,1,1,2,1,2014-01-23 14:29:09,2014-01-23 14:29:09
05d36dc06e6d767bb28993c65a54b703f319a386...8295169f063aec231c48f92a7747405cb7be6c40,1,3,3,6,3,2014-01-23 08:21:14,2014-01-23 08:13:29
05d36dc06e6d767bb28993c65a54b703f319a386...8be9a250c190d9dd8615da4616cdfe401ad6e0af,1,1,1,2,1,2014-01-23 03:48:37,2014-01-23 03:48:37
3c699c0a5ded6f6c51c0375d46b91b326b36e16a...07711e999779eff4296d1a363c1131dbb14acae2,1,28,0,28,1,2014-01-02 21:29:59,2014-01-02 21:28:56
07711e999779eff4296d1a363c1131dbb14acae2...449ede03b84df7edda8fe5410481f4fa24394d4a,1,4,4,8,3,2014-01-02 22:07:33,2014-01-02 22:06:25
449ede03b84df7edda8fe5410481f4fa24394d4a...756a6accdbe1d717073f3d08605a123e89982713,1,2,2,4,2,2014-01-02 22:14:54,2014-01-02 22:14:54
756a6accdbe1d717073f3d08605a123e89982713...ed2828f0a0263116618e9f338f9604d7387f10f7,2,28,17,45,7,2014-01-02 23:36:50,2014-01-02 23:31:53
ed2828f0a0263116618e9f338f9604d7387f10f7...b1a399b8644a2b705c2ceb4fabb47172c31ff6c9,1,0,1,1,1,2014-01-02 23:42:03,2014-01-02 23:42:03
b1a399b8644a2b705c2ceb4fabb47172c31ff6c9...7d0a5190328f277b97b1f55171e1fecb22a1e461,2,0,2,2,2,2014-01-02 23:44:49,2014-01-02 23:44:49
7d0a5190328f277b97b1f55171e1fecb22a1e461...ea83102d0f0c215ae2bd16a2c8c474ce615bad9a,1,34,0,34,1,2014-01-03 00:43:26,2013-12-07 07:13:20
0d397e5a5b98c475b664ff12f11729671fe1ad42...bad4721b45e0a3e05b6122644e5da41616313ffe,1,1,0,1,1,2014-04-18 06:00:41,2014-04-18 06:00:41
7be646425f62734cbd457b93c2b7cf5aa14f923b...72f055e535fb25f8b18be031f8fe18674c1d7f6a,5,25,9,34,11,2014-06-05 22:17:27,2014-06-05 21:42:08
7be646425f62734cbd457b93c2b7cf5aa14f923b...61960dd02c4b58f8bcfc9dbb1eb1852ff63c8beb,2,72,0,72,3,2014-06-03 15:55:17,2014-06-02 20:07:28
61960dd02c4b58f8bcfc9dbb1eb1852ff63c8beb...083d285b82832f95b57c64144020cc2ce8895a22,6,6,1,7,3,2014-06-03 16:00:33,2014-05-22 12:12:22
083d285b82832f95b57c64144020cc2ce8895a22...fb9d8f06520f495d0c36236f7534dbe660c7e164,2,11,1,12,3,2014-06-04 06:53:17,2014-05-28 17:03:26
fb9d8f06520f495d0c36236f7534dbe660c7e164...7e2c87809ca601b7290203dd54ba3e9f90a702bd,3,101,16,117,11,2014-06-04 11:23:25,2014-05-29 15:15:01
7e2c87809ca601b7290203dd54ba3e9f90a702bd...45e049937d2564d11035827ca9a9221b86215e45,3,44,3,47,7,2014-06-04 11:57:19,2014-06-03 03:36:59
45e049937d2564d11035827ca9a9221b86215e45...2f7a7842baa50d74b9d4e93180375b7ff13b43e3,1,12,0,12,1,2014-06-04 16:37:10,2014-06-04 16:37:10
2f7a7842baa50d74b9d4e93180375b7ff13b43e3...7f27cca5c509f3a3c0e9772dec7012a1c24247c3,1,4,3,7,1,2014-06-04 16:44:58,2014-06-04 13:58:28
7f27cca5c509f3a3c0e9772dec7012a1c24247c3...52d9521354daa7a2d3a335be971459a7310dd29f,1,1,1,2,1,2014-06-05 10:31:04,2014-06-05 10:31:04
52d9521354daa7a2d3a335be971459a7310dd29f...ae3fe6ccbb925236aa3cfc9173d2d307634fded4,1,42,18,60,17,2014-06-05 14:33:02,2014-06-05 14:30:43
ae3fe6ccbb925236aa3cfc9173d2d307634fded4...237c229b91ae852ac5f4f0a52b37de3e243ee61f,2,7,4,11,3,2014-06-05 15:11:10,2014-06-05 15:06:50
237c229b91ae852ac5f4f0a52b37de3e243ee61f...a03d38ddd43957a402b64caddf74a73df72140fb,3,8,5,13,4,2014-06-05 15:56:56,2014-06-05 15:56:56
a03d38ddd43957a402b64caddf74a73df72140fb...e560558ecb3a727c8f3f23e3a036413f8d8679eb,1,0,1,1,1,2014-06-05 16:03:17,2014-06-05 16:02:25
e560558ecb3a727c8f3f23e3a036413f8d8679eb...4f72e5f03ae803fd9faa1445245c1050ca004526,2,10,0,10,2,2014-06-05 16:26:24,2014-05-20 13:27:12
4f72e5f03ae803fd9faa1445245c1050ca004526...5643a3b51be338196d0b292d5626ad43648448d3,12,142,77,219,17,2014-06-05 17:12:01,2014-05-19 08:45:55
5643a3b51be338196d0b292d5626ad43648448d3...84cafc2b3575fe1040c5ed98d3f82d3b42d606f7,1,8,6,14,3,2014-06-05 18:54:28,2014-06-05 18:54:28
84cafc2b3575fe1040c5ed98d3f82d3b42d606f7...484f3edf1e79388f73dcb07e39d79d0c5029ae9e,4,11,3,14,4,2014-06-05 19:41:56,2013-10-15 05:15:13
484f3edf1e79388f73dcb07e39d79d0c5029ae9e...5c95a55330bc2531405700a399bfb555bfe80120,1,8,2,10,2,2014-06-05 22:31:51,2014-06-05 22:26:40
5c95a55330bc2531405700a399bfb555bfe80120...e071f67b7fb1aa171baf5fb1f57310007cc91ab4,3,7,4,11,4,2014-06-05 22:32:13,2014-06-05 22:29:24
347cab4faef22e6c903c9a0a407a0da06805a3de...7ff326928a08d4c51141768bd305a44ca5ecb2e7,4,4,4,8,4,2014-05-29 22:58:12,2014-05-29 22:58:12
7ff326928a08d4c51141768bd305a44ca5ecb2e7...9cbf7f25efa6ba3c4419b46fa11977e8b967aa26,1,6,6,12,6,2014-05-29 23:44:12,2014-05-29 23:43:49
9cbf7f25efa6ba3c4419b46fa11977e8b967aa26...7c6e96ec1f99289740132135895be83776cc9ca5,1,6,0,6,1,2014-05-30 12:01:21,2014-05-29 06:53:25
7c6e96ec1f99289740132135895be83776cc9ca5...6f4d7f41b1a430febed559b89f18b7db95e2aaa8,1,7,9,16,2,2014-05-30 15:00:13,2014-05-30 10:42:13
6f4d7f41b1a430febed559b89f18b7db95e2aaa8...c4c2c99669ef9d58306856c47058b121bbecfe5f,5,106,45,151,30,2014-05-30 19:58:42,2014-05-25 17:37:31
c4c2c99669ef9d58306856c47058b121bbecfe5f...a31d7c48b028ec4c4b650b33b540bbe987d28a1d,1,1,1,2,1,2014-05-31 17:50:29,2014-05-31 17:50:29
a31d7c48b028ec4c4b650b33b540bbe987d28a1d...875ce287e25d7576f9bd102f86adae09d242360f,1,1,1,2,1,2014-05-31 20:50:07,2014-05-31 20:50:07
875ce287e25d7576f9bd102f86adae09d242360f...83e7555ffee305c1ea1e0655fd1f0aa35269533f,6,0,69,69,11,2014-06-01 10:00:09,2014-06-01 10:00:09
62f9508ade5233fc7bf8af5b3afcd2f5b57d8288...cb9c9a7b5879671053c7d2ad6e79943a8814b274,7,107,0,107,13,2014-05-29 21:03:10,2014-05-29 21:03:10
5826dc52827254f44833acf678f429af94b4d636...aa12ea05cee4af5f2655ed9526ad9852419cc82e,3,630,297,927,87,2014-06-06 06:25:35,2014-06-06 06:03:33
aa12ea05cee4af5f2655ed9526ad9852419cc82e...1fe941adb0570a58cc5d2eb372611ade8d0e8776,1,7,1,8,1,2014-06-06 06:34:13,2014-06-06 06:34:13
1fe941adb0570a58cc5d2eb372611ade8d0e8776...daaeb8415823444a9020460cf825efc3fae866a2,2,1,1,2,1,2014-06-06 06:42:52,2014-06-06 06:40:04
12303ab738ab6c6eecf1f546aa9c0fb8ba5df950...d7ce48f175eae17897b3b3ff792998873ff1c6ec,1,1,1,2,1,2014-01-23 15:13:20,2014-01-23 15:13:20
12303ab738ab6c6eecf1f546aa9c0fb8ba5df950...7d9014864ca7a829ca590e0839671a9ef5a226d0,1,1,1,2,1,2014-01-23 15:11:15,2014-01-23 15:11:15
89df51803ef6e3990fbe7854818a3a3361639568...16f3a6a4c7bab11644d11c2be029374e5095cb56,1,1,1,2,1,2014-01-23 20:32:24,2014-01-23 20:32:24
16f3a6a4c7bab11644d11c2be029374e5095cb56...78a2617703bc1dada409f126db5c3db214913ff4,2,24,2,26,5,2014-01-24 08:10:17,2014-01-20 16:28:16
78a2617703bc1dada409f126db5c3db214913ff4...4b3b25104d6795867a7fbe0c2f6f855ca96358e5,1,3,1,4,2,2014-01-24 12:26:38,2014-01-24 12:26:19
4b3b25104d6795867a7fbe0c2f6f855ca96358e5...4d8209431d2b1c97d86cf92992e6ddc1555c7ac7,2,4,1,5,2,2014-01-24 13:13:17,2014-01-23 17:17:53
4d8209431d2b1c97d86cf92992e6ddc1555c7ac7...e1d18b9d2e8ac292940f070b0a8cb9733756acd9,1,4,2,6,4,2014-01-24 13:52:43,2014-01-24 13:52:43
e1d18b9d2e8ac292940f070b0a8cb9733756acd9...38be3cf5e4c4980b484e1013c2a4047725ba8d3e,2,26,0,26,2,2014-01-24 16:40:24,2014-01-24 13:35:17
38be3cf5e4c4980b484e1013c2a4047725ba8d3e...06bd181f97e5e5561ae7e80efae4c38ee670773f,2,2,2,4,2,2014-01-24 16:40:43,2014-01-24 13:41:54
f293063c201b9ccc5258fc288b483697461e8116...9bc377d7d0c33697326172513aac6e8dad58fe96,1,1,1,2,1,2014-04-18 06:30:40,2014-04-18 06:28:24
9bc377d7d0c33697326172513aac6e8dad58fe96...8394e570baf91cff5e5349c0ef06c4f06f06d0b1,4,77,0,77,5,2014-04-18 08:11:08,2014-04-17 09:44:30
8394e570baf91cff5e5349c0ef06c4f06f06d0b1...dc7bc42cce39f8141df40d831de9befb13946fef,2,4,2,6,2,2014-04-18 11:18:15,2014-04-18 11:13:20
dc7bc42cce39f8141df40d831de9befb13946fef...54d5c37de6572eae57a66339bb38719e681cee82,1,1,1,2,1,2014-04-18 13:05:18,2014-04-18 13:05:18
54d5c37de6572eae57a66339bb38719e681cee82...c2b269df6e9221cbca21fc90e46ccaf8c7d608a2,1,10,0,10,1,2014-04-18 14:32:14,2014-04-18 14:32:14
c2b269df6e9221cbca21fc90e46ccaf8c7d608a2...ed532a6a1ee675432940e69cec866b52aca96575,1,2,1,3,1,2014-04-18 15:55:35,2014-04-18 15:51:13
ed532a6a1ee675432940e69cec866b52aca96575...6b2ce38c4935a4af0b56aa0978171d26c8a4d286,1,1,1,2,1,2014-04-18 16:10:46,2014-04-18 16:10:46
6b2ce38c4935a4af0b56aa0978171d26c8a4d286...275811a93c1e5bc6505605967cf2da01f1c038fe,1,7,7,14,4,2014-04-18 16:54:46,2014-04-18 16:40:58
275811a93c1e5bc6505605967cf2da01f1c038fe...b43bbd6d399c9ecca09c2e181715c8856ef5a598,1,3,0,3,1,2014-04-18 19:00:26,2014-04-18 19:00:26
b43bbd6d399c9ecca09c2e181715c8856ef5a598...11ac50b18e578498c1d95e0a75921b5864387d46,1,9,0,9,1,2014-04-18 19:10:21,2014-04-18 16:41:29
11ac50b18e578498c1d95e0a75921b5864387d46...26d118c3fea34d9487a93b8ae570ef90e7079a76,2,41,49,90,7,2014-04-18 20:06:26,2014-04-18 20:06:26
26d118c3fea34d9487a93b8ae570ef90e7079a76...956bd644249337b9467c017aac4eec228dde8c5d,7,169,27,196,21,2014-04-18 20:44:47,2014-04-08 05:30:25
956bd644249337b9467c017aac4eec228dde8c5d...1b3a3fc1e4e331f76a8efc0fd59a90063c896603,2,9,0,9,2,2014-04-20 01:39:08,2014-04-20 01:39:08
1b3a3fc1e4e331f76a8efc0fd59a90063c896603...bbe818b23c60415734da1a7a3ced92ab42601069,3,4,4,8,4,2014-04-20 06:34:01,2014-04-20 06:32:57
bbe818b23c60415734da1a7a3ced92ab42601069...471fb04a307870794e3cefb1177405b506ee1a0a,3,6,2,8,6,2014-04-20 17:08:04,2014-04-20 17:08:04
1181b8a4a95551659be6737e41e9fc9d23eb8df4...b5a54168f90b7000ce3ea06d0332bea1887ababf,2,6,6,12,6,2014-06-06 12:29:27,2014-06-06 12:29:27
b5a54168f90b7000ce3ea06d0332bea1887ababf...5472bf4df079bec171db4e8a62659e9782595ce2,1,198,102,300,31,2014-06-06 19:19:20,2014-06-06 19:19:20
5472bf4df079bec171db4e8a62659e9782595ce2...7f4347b1766b34d4c970226ca1be539d78b3d8b5,2,9,7,16,3,2014-06-07 00:31:23,2014-06-07 00:31:23
7f4347b1766b34d4c970226ca1be539d78b3d8b5...e2112edd9ac6a5f1877a62dd1c88d2d1726350de,2,9,3,12,6,2014-06-07 03:41:15,2014-06-07 03:41:15
e2112edd9ac6a5f1877a62dd1c88d2d1726350de...cfcca7ccce3dc527d16757ff6dc978e50c4a2e61,8,94,33,127,25,2014-06-07 12:37:43,2014-06-07 12:09:27
cfcca7ccce3dc527d16757ff6dc978e50c4a2e61...9ed4a8c6b1a552a03fd27b77f1b742e3f9c66bde,1,1,1,2,1,2014-06-07 12:54:54,2014-06-07 12:54:54
9ed4a8c6b1a552a03fd27b77f1b742e3f9c66bde...11284a63d48c84f1d60b5686d55cf8a9f8d64422,4,91,11,102,7,2014-06-07 12:59:02,2013-11-03 23:34:11
11284a63d48c84f1d60b5686d55cf8a9f8d64422...d98cc41a845237edd62013e3156a0991dfb3d93e,2,7,1,8,4,2014-06-07 13:04:06,2014-06-07 13:03:33
d98cc41a845237edd62013e3156a0991dfb3d93e...58de495c54c203dfa838538fb6ca46187120f4e6,4,3,47,50,3,2014-06-07 15:04:10,2014-06-07 13:10:56
58de495c54c203dfa838538fb6ca46187120f4e6...fc31319752945d4d39f70c8278ecd42af240bc64,1,5,0,5,1,2014-06-07 15:16:49,2014-06-07 15:16:49
fc31319752945d4d39f70c8278ecd42af240bc64...47a9347b9828ed0186d676ee0c5cadd9e6a93edb,2,56,0,56,4,2014-06-07 17:48:45,2014-06-07 17:48:45
47a9347b9828ed0186d676ee0c5cadd9e6a93edb...d7f1f316bcb21853597515a25e6e43639b9ed021,1,77,57,134,5,2014-06-07 20:02:05,2014-06-07 19:55:16
d7f1f316bcb21853597515a25e6e43639b9ed021...5836a5771f2aefca83349b111f4191d6485af1d5,1,8,4,12,4,2014-06-07 20:33:56,2014-06-07 20:33:56
5836a5771f2aefca83349b111f4191d6485af1d5...1a01e24331194a8580d9f16b02e02f8403680942,1,3,0,3,1,2014-06-07 21:12:13,2014-06-07 21:08:23
1a01e24331194a8580d9f16b02e02f8403680942...250e2b422b4da93f38cd61319b9b3c9f422e6ede,3,21,3,24,5,2014-06-07 23:35:57,2014-06-07 23:35:57
250e2b422b4da93f38cd61319b9b3c9f422e6ede...6fd455adfcc85f6bd390bce784a1b5dfe5d610ea,3,68,6,74,9,2014-06-08 00:05:51,2014-06-08 00:04:58
6fd455adfcc85f6bd390bce784a1b5dfe5d610ea...f70f669941775ceef8433f4c66b189f82d53074f,7,72,3,75,14,2014-06-08 00:18:30,2014-05-29 21:03:10
f70f669941775ceef8433f4c66b189f82d53074f...6c27ff957a6162870b91138ccddda8530a0450b0,1,0,1,1,1,2014-06-08 00:35:28,2014-06-08 00:35:28
6c27ff957a6162870b91138ccddda8530a0450b0...1e84d261d618c11c939028ba37db09bae81b1eef,1,2,2,4,2,2014-06-08 01:10:44,2014-06-08 01:10:44
1e84d261d618c11c939028ba37db09bae81b1eef...4ce7a6bc84c68406e39f48550434faeef3277eba,6,92,85,177,26,2014-06-08 01:18:02,2014-06-08 01:17:31
4ce7a6bc84c68406e39f48550434faeef3277eba...d8f6b55aa8f05a479eb0018b470932805f2c95d1,1,5,2,7,2,2014-06-08 03:36:59,2014-06-08 03:36:59
d8f6b55aa8f05a479eb0018b470932805f2c95d1...6e5651e514367174a3fa887d6babfe3830339b16,8,25,21,46,21,2014-06-08 19:15:47,2014-06-08 07:54:35
6e5651e514367174a3fa887d6babfe3830339b16...3f91238adf819b1d86f800d6b535b3c04447dac2,3,36,9,45,9,2014-06-09 00:12:59,2014-06-09 00:12:27
3f91238adf819b1d86f800d6b535b3c04447dac2...8721adcbfbc0bba7fe8341605a4ab4dffd9774d6,1,5,2,7,2,2014-06-09 01:57:55,2014-06-09 01:57:55
8721adcbfbc0bba7fe8341605a4ab4dffd9774d6...8c12d51ea27479555e226894c50c83043211d71d,17,247,27,274,28,2014-06-09 02:30:15,2014-06-09 02:30:15
8c12d51ea27479555e226894c50c83043211d71d...7018bcfb71847a3f016d8f65cb60f72fcbb22f5a,1,2,2,4,1,2014-06-09 03:07:35,2014-06-09 03:07:35
7018bcfb71847a3f016d8f65cb60f72fcbb22f5a...96e4b52ab2c6fae3e46a197d44c42cb6ebde7d9c,4,59,75,134,41,2014-06-09 08:13:37,2014-06-06 19:12:18
96e4b52ab2c6fae3e46a197d44c42cb6ebde7d9c...1aaf4053f5bda3e064448ca5abfa20eb3d029565,2,16,11,27,14,2014-06-09 08:28:39,2014-06-09 08:28:39
1aaf4053f5bda3e064448ca5abfa20eb3d029565...67ce2e74e1aafd3f85f6d64059d204e434e0e5f4,1,6,0,6,1,2014-06-09 14:29:22,2014-06-09 14:29:22
67ce2e74e1aafd3f85f6d64059d204e434e0e5f4...3a926c077863f0491ef66edbe451ee67c8fe59df,2,21,8,29,7,2014-06-09 15:12:28,2014-06-09 15:12:28
3a926c077863f0491ef66edbe451ee67c8fe59df...dd551326433241f321fef9177e9487fef13348db,2,0,360,360,2,2014-06-09 15:53:09,2014-06-09 15:53:09
dd551326433241f321fef9177e9487fef13348db...4b25ebf112d8bf4fcee6ee8339913bffdc81035d,1,0,1,1,1,2014-06-09 16:00:12,2014-06-09 16:00:12
4b25ebf112d8bf4fcee6ee8339913bffdc81035d...c17cd151d855ca1b8fcec894c5fccaa4a05be512,6,17,12,29,11,2014-06-09 16:09:16,2014-06-09 16:09:16
c17cd151d855ca1b8fcec894c5fccaa4a05be512...f146e70cb1cfe34a9993a9a1d95faf2bb8b15ab1,1,3,4,7,4,2014-06-09 16:52:23,2014-06-09 16:52:05
f146e70cb1cfe34a9993a9a1d95faf2bb8b15ab1...6b97ae352170d7be47176787056239cfbacb4803,1,8,1,9,2,2014-06-09 18:14:58,2014-06-09 18:14:58
6b97ae352170d7be47176787056239cfbacb4803...127218b92bb8482fcb8b02457ed9797486ed3a22,1,3,4,7,3,2014-06-09 19:35:17,2014-06-08 20:40:22
127218b92bb8482fcb8b02457ed9797486ed3a22...40bfd8561d016f6632c95d03e46a720571ad1a8a,3,14,16,30,8,2014-06-09 19:38:10,2014-06-08 20:42:12
40bfd8561d016f6632c95d03e46a720571ad1a8a...bc0aba7786978ec312809eae5ecb3d751608b5b7,7,24,161,185,21,2014-06-09 21:53:25,2014-06-09 20:03:04
bc0aba7786978ec312809eae5ecb3d751608b5b7...fea8ccdcc4fa47ea1d494843624c92197b4f2153,1,0,1,1,1,2014-06-09 22:41:35,2014-06-09 22:41:35
fea8ccdcc4fa47ea1d494843624c92197b4f2153...df09d854828bcff56eb72f48ff1ba8fce7e90c90,4,6,22,28,5,2014-06-10 06:42:31,2014-06-09 19:24:05
df09d854828bcff56eb72f48ff1ba8fce7e90c90...9560dac3c0980d0c4bc75948d4a8c977fbbd3a6d,1,1,1,2,1,2014-06-10 10:48:08,2014-06-10 10:48:08
9560dac3c0980d0c4bc75948d4a8c977fbbd3a6d...34f4fd70245c2daee29f9866600c6203c58e25c2,1,36,36,72,3,2014-06-10 13:18:58,2014-06-10 13:18:58
34f4fd70245c2daee29f9866600c6203c58e25c2...d8f19bb3b6f858bef499fdab41948a5a5e8d55aa,2,29,2,31,3,2014-06-10 13:35:05,2014-06-10 09:32:46
d8f19bb3b6f858bef499fdab41948a5a5e8d55aa...a00b78b1e2ac9bf271d55c1799138a27f5e0d03e,4,75,11,86,10,2014-06-10 18:00:52,2014-05-09 06:48:41
a00b78b1e2ac9bf271d55c1799138a27f5e0d03e...93d05536fd8179483c725467de8e33454b48a430,6,60,74,134,12,2014-06-10 18:37:37,2014-06-10 16:22:07
93d05536fd8179483c725467de8e33454b48a430...f97c53c0989336563c535c9737dff197b403054d,6,7,7,14,7,2014-06-10 19:38:25,2014-06-10 19:16:31
f97c53c0989336563c535c9737dff197b403054d...868ff4e37c1e4cfaf7283496c24f6e711ad66005,2,6,1,7,2,2014-06-10 20:04:43,2014-06-10 18:28:32
868ff4e37c1e4cfaf7283496c24f6e711ad66005...a1c6cd6a167f90fc4dfd76b2a2de87bc617b26e6,2,22,1,23,2,2014-06-10 21:04:24,2014-06-10 20:52:14
a1c6cd6a167f90fc4dfd76b2a2de87bc617b26e6...e2efc8965edf684aaf48621680ef54b84e116576,10,79,6,85,15,2014-06-11 06:57:30,2014-05-25 20:52:47
e2efc8965edf684aaf48621680ef54b84e116576...e163a3d17b2551001677b615ccdaeadf17705d29,1,1,1,2,1,2014-06-11 07:22:30,2014-06-11 07:22:30
e163a3d17b2551001677b615ccdaeadf17705d29...42736ac8e8c31137131714013951249a09e6e7d4,11,210,16,226,27,2014-06-11 14:03:34,2014-06-06 11:10:20
42736ac8e8c31137131714013951249a09e6e7d4...68efbfde5e35013c14c0c30cabb1c94b80a48807,1,4,0,4,1,2014-06-11 15:35:33,2014-06-11 15:07:33
68efbfde5e35013c14c0c30cabb1c94b80a48807...5a3ae7e260f68602b25dbe3fc6ed13249a5c6515,4,16,14,30,10,2014-06-11 15:37:52,2014-06-10 19:35:48
5a3ae7e260f68602b25dbe3fc6ed13249a5c6515...99f5ea9cc8f41724e07b88c6142d0092961ce5e0,4,7,2,9,7,2014-06-11 15:45:18,2014-06-11 15:45:18
99f5ea9cc8f41724e07b88c6142d0092961ce5e0...64d94cffc73fc4de1389e16d98142d253155b325,2,23,11,34,3,2014-06-11 17:25:02,2014-06-11 17:25:02
64d94cffc73fc4de1389e16d98142d253155b325...4123f55c3304eced289666e256fca1e8d5d7a69d,1,3,2,5,2,2014-06-11 18:46:57,2014-06-11 18:46:57
4123f55c3304eced289666e256fca1e8d5d7a69d...2e4d667ec1ebcc433353ee191f239e528a44c56f,1,1,0,1,1,2014-06-11 20:03:36,2014-06-11 20:03:36
2e4d667ec1ebcc433353ee191f239e528a44c56f...c307383ec9d30cd59f858cfdad9621a4d5adf200,1,1,1,2,1,2014-06-11 21:17:21,2014-06-11 21:13:34
c307383ec9d30cd59f858cfdad9621a4d5adf200...6e8d614acd1b65a1ae472da7db88a7b2751dc388,1,7,0,7,1,2014-06-12 01:07:34,2014-06-11 17:21:14
6e8d614acd1b65a1ae472da7db88a7b2751dc388...43372fc7aa50b52487f29fffdea3c597a0e8117f,1,2,2,4,2,2014-06-12 06:42:02,2014-06-12 06:37:21
43372fc7aa50b52487f29fffdea3c597a0e8117f...dfa3505ff1edf8453645592f1ffc39be81927935,2,2,2,4,2,2014-06-12 06:53:36,2014-06-12 06:53:36
dfa3505ff1edf8453645592f1ffc39be81927935...1c58cabad7f5b792e9cfd8f00feffd8212fdfbb1,4,141,8,149,9,2014-06-12 12:17:49,2014-06-11 19:26:17
1c58cabad7f5b792e9cfd8f00feffd8212fdfbb1...a2cd0e12c9410a7b8a30064e3967c617f4de2de5,2,10,3,13,5,2014-06-12 13:28:36,2014-06-12 13:28:36
a2cd0e12c9410a7b8a30064e3967c617f4de2de5...bcc3d2b9788cbee5f3fc654c1b0e8324294d8f02,1,4,1,5,1,2014-06-12 14:19:03,2014-06-12 14:19:03
3149cdce32e7261b2d44128ab712c4d4f1a5d429...67d9f70e4c804355422a6f8810dfa42ede8a3bae,1,2,1,3,2,2014-05-29 22:34:35,2014-05-29 22:34:35
d01edbcddac0e533135f2263ce2d6c1df18dc61e...3b869b09d084eb486c936ac4b528e288ceec83d5,1,1,0,1,1,2014-01-23 18:48:09,2014-01-23 16:26:15
3b869b09d084eb486c936ac4b528e288ceec83d5...d7aa0bd8022bd4a575a56dd97a7d2a83e442f5bc,1,3,3,6,3,2014-01-23 20:07:14,2014-01-23 08:13:29
06bd181f97e5e5561ae7e80efae4c38ee670773f...2a30b39f40265c9228fc2e706bcb6e1df1aae991,3,31,5,36,5,2014-01-25 00:10:25,2014-01-25 00:09:56
2a30b39f40265c9228fc2e706bcb6e1df1aae991...f5f556dba3c89333d4533e0603de79b62083d807,1,4,0,4,1,2014-01-25 00:23:28,2014-01-25 00:23:28
f5f556dba3c89333d4533e0603de79b62083d807...29ddae7436e84f4713c7babeabdf9a1fa62d6543,3,3,2,5,3,2014-01-25 03:07:14,2014-01-25 03:07:14
29ddae7436e84f4713c7babeabdf9a1fa62d6543...2ff93e027c7b35378cc450a926bc2e4a446cacf0,36,190,107,297,68,2014-01-25 09:41:56,2014-01-24 21:43:00
06bd181f97e5e5561ae7e80efae4c38ee670773f...f56c88a8eed91f68f6845bbf730f7b7361c5cfb1,3,13,68,81,10,2014-01-24 22:32:03,2014-01-24 22:32:03
471fb04a307870794e3cefb1177405b506ee1a0a...3f76339355c1fe550dedf676feddd42a5d48be58,4,43,45,88,8,2014-04-21 09:43:08,2014-04-21 09:41:30
3f76339355c1fe550dedf676feddd42a5d48be58...3f01e82c591b880faa5066ba28a3f11b2b82154c,5,27,68,95,6,2014-04-21 09:50:53,2014-04-21 09:50:53
3f01e82c591b880faa5066ba28a3f11b2b82154c...25b2ce896b93982e5e89931625e20349fb815fda,5,75,90,165,6,2014-04-21 10:12:09,2014-04-21 10:12:09
25b2ce896b93982e5e89931625e20349fb815fda...df3b1a01c7d6326e966fbe13aa149265f4bf9c8f,5,435,448,883,10,2014-04-21 10:15:04,2014-04-21 10:15:04
df3b1a01c7d6326e966fbe13aa149265f4bf9c8f...428c0bbe1bcd303560d7e96d7d2721ff3fdc0e3f,13,26,28,54,15,2014-04-21 10:27:34,2014-04-21 10:25:43
428c0bbe1bcd303560d7e96d7d2721ff3fdc0e3f...a4553e051087a026b7f52bfb56c0d880c39c9cc2,1,4,2,6,3,2014-04-21 12:51:52,2014-04-21 12:51:52
a4553e051087a026b7f52bfb56c0d880c39c9cc2...405b13fe83e3d8c9079545429d40c434eb496893,1,2,2,4,2,2014-04-21 13:37:12,2014-04-21 13:37:12
471fb04a307870794e3cefb1177405b506ee1a0a...251e833c75b761c673d69e5f2a8e0cbd07586009,7,0,12,12,4,2014-04-21 03:00:39,2014-04-21 02:48:29
bcc3d2b9788cbee5f3fc654c1b0e8324294d8f02...7beaeeed2b99ec120486ee53e1eb7f1fe2515b9c,2,7,2,9,3,2014-06-12 16:58:50,2014-06-12 16:58:50
2ff93e027c7b35378cc450a926bc2e4a446cacf0...09d1e0486a1f9c1fbfb496768252273821fccc7f,1,2,0,2,2,2014-01-25 14:56:51,2014-01-25 10:02:46
b9e0ea3cb4ad25f767c77cb85a05f800aefda65b...3acdb3068a3b9663c3ef8d724b8da444dc52c2b4,1,7,1,8,1,2014-01-25 15:59:38,2014-01-25 15:59:38
c54e7ec9ca1417bee0409489ed12f3e0f942a784...b2514c02e186662ab82b77106a1a85abecf94039,1,1,1,2,1,2014-04-21 17:19:46,2014-04-21 14:48:33
b2514c02e186662ab82b77106a1a85abecf94039...fb09a489ca2c9c8940348e0cafafdbd7aff4740a,2,94,22,116,12,2014-04-21 18:58:09,2014-04-21 09:25:48
fb09a489ca2c9c8940348e0cafafdbd7aff4740a...2f9d1576e8395d401bd55d43046a6a65b575ab10,2,56,8,64,6,2014-04-21 19:17:14,2014-04-21 12:04:53
2f9d1576e8395d401bd55d43046a6a65b575ab10...1667e736a7da634bbda0df171bb60a980cbab7a3,1,8,8,16,2,2014-04-21 20:42:11,2014-04-21 20:42:11
1667e736a7da634bbda0df171bb60a980cbab7a3...ab90c4707bc8c813962658350b2e6c13ea0b4711,2,17,14,31,6,2014-04-21 21:08:00,2014-04-21 21:08:00
ab90c4707bc8c813962658350b2e6c13ea0b4711...8b93b31487d6d3b0fcbbd0498991ea0db9088054,5,49,1,50,12,2014-04-21 22:11:26,2014-04-20 17:12:43
8b93b31487d6d3b0fcbbd0498991ea0db9088054...c083e3815aec23b99833da710eea574e6f2e8566,2,36,1,37,7,2014-04-21 22:11:26,2014-04-20 20:10:32
c083e3815aec23b99833da710eea574e6f2e8566...75c0d4ea3ae48970f788c482ee0bd6b29a7f1307,6,95,2,97,17,2014-04-21 22:11:26,2014-04-20 20:13:41
75c0d4ea3ae48970f788c482ee0bd6b29a7f1307...c07f3e60c2d455e36ba4ac339d4283d32bbc3814,3,316,9,325,7,2014-04-21 22:11:26,2014-04-21 10:32:25
c07f3e60c2d455e36ba4ac339d4283d32bbc3814...f286721f7fdc2202f77a5f4d650d9d0779b86811,2,25,0,25,2,2014-04-22 08:46:18,2014-04-15 15:52:30
f286721f7fdc2202f77a5f4d650d9d0779b86811...9fb95dfc9fa1f9df73e384624c345199dd281dd5,2,15,0,15,2,2014-04-22 15:44:03,2014-04-22 15:44:03
26cd19561331ac4a8a5f084a30c8ba0123d33278...9980f67154ed3b10493e159d62c72ab6394769fe,1,6,5,11,6,2014-06-12 17:08:27,2014-06-12 17:08:27
9980f67154ed3b10493e159d62c72ab6394769fe...7b17350a1bfa527358e722baf962a5f9cfb838ea,12,114,13,127,10,2014-06-12 17:22:43,2014-06-12 17:21:26
7b17350a1bfa527358e722baf962a5f9cfb838ea...386166970c506b5f7b70f63bfb86d1ea64a980cf,1,6,0,6,1,2014-06-12 18:12:07,2014-06-12 18:12:07
386166970c506b5f7b70f63bfb86d1ea64a980cf...2d425116e2f26ab546c380784df1de79562009a7,2,14,1,15,3,2014-06-12 20:41:49,2014-06-12 17:43:30
2d425116e2f26ab546c380784df1de79562009a7...bf743a4d571bbb7da276bc21c61f6ada5d26942c,5,54,4,58,7,2014-06-13 12:50:43,2014-06-06 14:49:02
7dd87aa305152d3ebe4ae5053878de0463a79480...798fd59fad241ca8e48ba2a4526935b92736d30d,1,11,6,17,4,2014-01-25 20:20:17,2014-01-14 12:41:52
798fd59fad241ca8e48ba2a4526935b92736d30d...ee4b806a851f6f7ad121899ed246dbcd7353ca75,1,1,2,3,3,2014-01-25 22:22:03,2014-01-25 22:22:03
ee4b806a851f6f7ad121899ed246dbcd7353ca75...966b186981d619d964152ebcda1bd844ec5f6c8c,5,120,4,124,11,2014-01-26 02:37:05,2014-01-26 02:37:05
966b186981d619d964152ebcda1bd844ec5f6c8c...8bc3780b67cc37dec04d622833dfa3a26c38fa84,1,1,2,3,1,2014-01-26 03:56:36,2014-01-26 03:56:36
8bc3780b67cc37dec04d622833dfa3a26c38fa84...ca95f8e4359325567fa441eef8f18cb710850eeb,6,85,94,179,36,2014-01-26 05:50:40,2014-01-26 05:50:40
ca95f8e4359325567fa441eef8f18cb710850eeb...9ffab9cee1a5bd1a2f6c326ae970d92526f9a304,23,137,76,213,44,2014-01-26 07:50:47,2014-01-25 20:54:25
9ffab9cee1a5bd1a2f6c326ae970d92526f9a304...8e1fc0349124d4a792e02bfd4c90576f9e3bda95,1,1,1,2,1,2014-01-26 08:30:10,2014-01-26 08:30:10
8e1fc0349124d4a792e02bfd4c90576f9e3bda95...3c47786cb91617b3757e57b6bfeda06ef14e561a,3,42,6,48,10,2014-01-26 12:01:09,2014-01-26 11:46:28
3c47786cb91617b3757e57b6bfeda06ef14e561a...f901b4d6c869f4cfb4fc28a861c481f28e46bb3f,9,29,40,69,24,2014-01-26 12:08:05,2014-01-26 11:57:08
f901b4d6c869f4cfb4fc28a861c481f28e46bb3f...4f03b718f712b39f306f6dfe177e1f65b5437ac2,4,3,3,6,3,2014-01-26 12:17:03,2014-01-26 12:17:03
4f03b718f712b39f306f6dfe177e1f65b5437ac2...2b154ae2803d46c68d3ec78789866d22231a92d0,1,4,2,6,2,2014-01-26 14:35:22,2014-01-26 14:35:22
2b154ae2803d46c68d3ec78789866d22231a92d0...8f2f48ecc9431c4d8959354a607fa559aa85dd99,1,1,1,2,1,2014-01-26 17:42:41,2014-01-23 23:04:47
8f2f48ecc9431c4d8959354a607fa559aa85dd99...c3881944e8651ad98e29561154186e87928ca319,4,1,3,4,4,2014-01-26 19:32:01,2014-01-26 19:32:01
c3881944e8651ad98e29561154186e87928ca319...10e3faf191d8f230dde8534d1c8fad8c8717816e,33,997,892,1889,160,2014-01-26 19:42:30,2014-01-22 06:43:33
10e3faf191d8f230dde8534d1c8fad8c8717816e...780ae7e9f804037626ce29ba3707c6c8b77ce4fc,1,90,39,129,44,2014-01-26 20:13:35,2014-01-26 20:13:35
780ae7e9f804037626ce29ba3707c6c8b77ce4fc...2cbe1e28fbf0662f8398e2cb5e7c7a1df11991bf,1,15,1,16,2,2014-01-26 20:40:14,2014-01-26 20:40:14
2cbe1e28fbf0662f8398e2cb5e7c7a1df11991bf...dfa28981ced2a6c005cc3c12fdc6b560080818a0,3,25,0,25,4,2014-01-26 22:48:28,2014-01-26 22:48:28
dfa28981ced2a6c005cc3c12fdc6b560080818a0...6758a9c0fc34dc9944895b98045d2b26c8147ea2,1,6,1,7,2,2014-01-27 11:49:55,2014-01-27 11:49:55
6758a9c0fc34dc9944895b98045d2b26c8147ea2...3145ae06beed2f8c679db5d7a06907dd2a03d138,1,6,6,12,2,2014-01-27 21:01:22,2014-01-26 13:17:47
3145ae06beed2f8c679db5d7a06907dd2a03d138...b951a7fbc12045eff104940dafaec308a543ead2,5,50,63,113,22,2014-01-27 21:01:22,2014-01-26 13:29:04
b951a7fbc12045eff104940dafaec308a543ead2...b87bc461c89f2006f0b27c7240fb488fac32bed1,3,31,41,72,20,2014-01-27 21:02:07,2014-01-26 14:28:33
b87bc461c89f2006f0b27c7240fb488fac32bed1...88a2d39159872f6a7fced1bae591550650fd7f38,5,102,20,122,11,2014-01-27 22:34:22,2014-01-27 20:28:53
88a2d39159872f6a7fced1bae591550650fd7f38...3e4dc5ecf25aa2b38eed73472899f0de5a319c04,2,6,1,7,2,2014-01-28 13:17:01,2014-01-22 09:53:41
3e4dc5ecf25aa2b38eed73472899f0de5a319c04...2b6914049a882e2f1b398baf54940e815b85a90a,4,58,21,79,18,2014-01-28 13:31:02,2014-01-22 19:09:02
2b6914049a882e2f1b398baf54940e815b85a90a...5dc4a8652cd6e2a80fbedd8984f30c8fc482c3ea,1,6,0,6,1,2014-01-28 14:10:40,2014-01-28 14:10:40
5dc4a8652cd6e2a80fbedd8984f30c8fc482c3ea...0ca647357ecb0e3fe507d90a9518198751b2d408,1,1,0,1,1,2014-01-28 19:08:37,2014-01-28 19:08:29
0ca647357ecb0e3fe507d90a9518198751b2d408...8b2c1ac06d3d1cf99661f4af75030abb456e1665,2,20,1,21,3,2014-01-28 19:39:15,2014-01-28 19:36:57
8b2c1ac06d3d1cf99661f4af75030abb456e1665...ad975c64fcdf3faa67cacd51665c4f95a2c5b060,1,2,0,2,1,2014-01-29 16:08:01,2014-01-29 16:08:01
9fb95dfc9fa1f9df73e384624c345199dd281dd5...58176dee88ac7c1038c7f685af023e634b143d02,1,23,19,42,3,2014-04-22 21:45:00,2014-04-22 21:45:00
bf743a4d571bbb7da276bc21c61f6ada5d26942c...e66896226a41eb9e56b08d7adf29b44c0cd87dad,3,9,11,20,7,2014-06-14 13:14:12,2014-06-13 08:12:31
e66896226a41eb9e56b08d7adf29b44c0cd87dad...0b980ef85779835d5600564f1327c478712a4882,1,2,2,4,2,2014-06-14 13:14:12,2014-06-14 10:48:47
0b980ef85779835d5600564f1327c478712a4882...d2cbcbcc76a0718d45ca2305c8a55b86eb4c58c1,2,7,7,14,5,2014-06-14 13:14:13,2014-06-14 10:50:18
bf743a4d571bbb7da276bc21c61f6ada5d26942c...504c89e8008c557a1e83c45535b549f77a3503b2,9,201,7,208,15,2014-06-13 13:31:40,2014-05-28 16:07:27
504c89e8008c557a1e83c45535b549f77a3503b2...cc35bd461d35da2b03c0a1a8ff92123d716db9a9,2,81,10,91,7,2014-06-13 13:34:04,2013-12-30 07:37:27
cc35bd461d35da2b03c0a1a8ff92123d716db9a9...4696cd9671243958fd4a596631d75b3cbca325c3,9,131,15,146,18,2014-06-13 16:45:56,2014-04-20 12:58:29
4696cd9671243958fd4a596631d75b3cbca325c3...50b9313e0a0739dfe1ac699449b66ed3e62add51,3,41,5,46,5,2014-06-13 17:03:58,2014-06-06 09:19:16
50b9313e0a0739dfe1ac699449b66ed3e62add51...06c0e740a41f64a49a11569e76edee7be04770e0,2,3,2,5,3,2014-06-13 17:09:51,2014-05-28 17:40:31
06c0e740a41f64a49a11569e76edee7be04770e0...612290400f79fb2293a6a0b0cfa5743ab0cef6b1,3,6,4,10,5,2014-06-13 21:43:49,2014-06-13 21:43:49
612290400f79fb2293a6a0b0cfa5743ab0cef6b1...79956d06946c881cb71958f27a12f62b9cab8de5,2,35,2,37,4,2014-06-14 00:01:35,2014-04-14 23:44:05
79956d06946c881cb71958f27a12f62b9cab8de5...856863860352aa1f0288e6c9168a0e423c4f5184,8,200,149,349,56,2014-06-14 09:17:48,2013-10-16 14:24:59
856863860352aa1f0288e6c9168a0e423c4f5184...cbff097bd91fad42c7231026968f686598b1d7a2,3,93,14,107,20,2014-06-14 11:42:43,2014-06-06 15:55:56
cbff097bd91fad42c7231026968f686598b1d7a2...4b4524291adbc78ab880317124803fc37a2e414a,5,86,50,136,17,2014-06-14 11:43:39,2014-06-06 18:12:23
4b4524291adbc78ab880317124803fc37a2e414a...f17b24e407385eb18651bf023a187347aa9c1f75,45,493,566,1059,195,2014-06-14 11:43:44,2014-06-06 20:39:33
f17b24e407385eb18651bf023a187347aa9c1f75...2ca5fc55b0a0b18ce4f060ee999ef355b5ceb0a3,3,5,7,12,4,2014-06-14 14:20:42,2014-06-14 14:20:42
2ca5fc55b0a0b18ce4f060ee999ef355b5ceb0a3...5949c2118d7cc7cffe86cd9db1820b186b88bfc0,2,11,5,16,8,2014-06-14 16:53:33,2014-06-14 16:12:43
5949c2118d7cc7cffe86cd9db1820b186b88bfc0...c24e979ece2729716593291d3ebd81fdf7fc3b7d,2,10,1,11,2,2014-06-14 18:01:02,2014-06-14 18:01:02
c24e979ece2729716593291d3ebd81fdf7fc3b7d...c281831a5cb20a31cb080ff7b4af4bcfc83fcf3d,1,5,2,7,1,2014-06-14 18:52:37,2014-06-14 18:52:37
ad975c64fcdf3faa67cacd51665c4f95a2c5b060...af64f829d7b9179ebda0033cef5f0c0d9dd73079,1,1,1,2,1,2014-01-29 16:54:02,2014-01-29 16:54:02
03401701f3671f62ef51ff791e226b0d38a978ca...985377980513dbe7d5a6d7f7c139ce5446b5c288,1,2,2,4,2,2014-04-22 22:28:47,2014-04-22 20:54:14
dd57b89fcb8f009fc73f16efea9539e5888eb59d...7a1f8414c3b71b6af03e5be9f5f8db115551c410,1,1,1,2,1,2014-06-15 10:44:33,2014-06-15 10:44:33
1ed02843abe74a188bb7f9bc984e52ef63ae9a1f...e9d12bae1e59e51738c11c492c620f56f96106bf,2,52,37,89,13,2014-01-29 22:41:11,2014-01-29 17:18:32
e9d12bae1e59e51738c11c492c620f56f96106bf...fabc678f930431fd6e502fe7930ee772eff96898,2,32,19,51,9,2014-01-30 08:48:45,2014-01-30 08:37:15
fabc678f930431fd6e502fe7930ee772eff96898...9c8d62a06fc83efa019f23b6b87b39a82c95ab97,1,4,2,6,2,2014-01-30 08:49:02,2014-01-30 08:49:02
9c8d62a06fc83efa019f23b6b87b39a82c95ab97...a938fff0309d83a64ea588a56bf07984f1436a0e,1,18,21,39,7,2014-01-31 17:52:22,2014-01-31 17:52:22
a938fff0309d83a64ea588a56bf07984f1436a0e...4a488c14833000eaf5d2b4c2787b6a61c99a4f53,1,1,1,2,1,2014-02-01 18:42:41,2014-02-01 18:42:41
4a488c14833000eaf5d2b4c2787b6a61c99a4f53...f9698c43918c118a29516cbef4e23c197eb2dc25,4,31,16,47,15,2014-02-01 19:38:15,2014-02-01 16:37:08
f9698c43918c118a29516cbef4e23c197eb2dc25...76ff266df1d68eb76836f159b799ed3e64979089,4,26,12,38,15,2014-02-01 19:38:15,2014-02-01 18:30:54
76ff266df1d68eb76836f159b799ed3e64979089...b5fbdf97db15be7efc1059c82099a42018f8d7ac,1,1,1,2,1,2014-02-02 14:16:55,2014-02-02 14:16:55
b5fbdf97db15be7efc1059c82099a42018f8d7ac...ab2f21080d8b3112c1ba9a0bf923eae733be4242,1,9,0,9,1,2014-02-02 14:31:34,2014-02-02 14:31:34
985377980513dbe7d5a6d7f7c139ce5446b5c288...11d453bcadad3c9a5ae35882792d0f1e8e8e7818,18,18,19,37,19,2014-04-22 23:31:49,2014-04-22 23:05:14
c755c8daa2e05dcf21d4a1b47625fba1e72d7109...1e5c01c26ec5c0f08901434004b790cb1d5fe5a5,1,5,2,7,1,2014-06-15 18:05:40,2014-06-15 18:05:40
1e5c01c26ec5c0f08901434004b790cb1d5fe5a5...edd9f8a7b2beb0fe2f83a9e50157c45364753121,4,42,3,45,4,2014-06-15 18:25:39,2014-06-15 18:25:39
edd9f8a7b2beb0fe2f83a9e50157c45364753121...24afb1d7a746da131212d050404bbe8837cf6f1d,3,31,0,31,4,2014-06-15 18:47:23,2014-06-15 18:46:56
24afb1d7a746da131212d050404bbe8837cf6f1d...f717ef083aac2e839a86de1bac02b95e5fd1a4b1,2,20,1,21,2,2014-06-15 19:06:48,2014-06-15 19:06:48
f717ef083aac2e839a86de1bac02b95e5fd1a4b1...a58f49d104e5a0d7adb8df1af6f1e36fa37b09b6,5,93,2,95,9,2014-06-15 19:34:02,2014-06-15 19:34:02
a58f49d104e5a0d7adb8df1af6f1e36fa37b09b6...a8ce5fdc28bdbe091476d49d014d68f8ba4353e7,8,234,3,237,18,2014-06-15 21:56:51,2014-06-15 21:55:44
a8ce5fdc28bdbe091476d49d014d68f8ba4353e7...c1276785f90b89c8bced606b9cbf7b1a612506e5,5,220,39,259,39,2014-06-15 23:01:49,2014-06-15 23:01:49
c1276785f90b89c8bced606b9cbf7b1a612506e5...ec6e2eac60be52f7a5979ebc29a64197f5a11174,2,28,0,28,1,2014-06-15 23:28:20,2014-04-19 10:49:23
ec6e2eac60be52f7a5979ebc29a64197f5a11174...7da16b99dfa72beb782467d3644467457e1c6145,2,34,0,34,1,2014-06-15 23:29:53,2014-04-19 10:35:02
7da16b99dfa72beb782467d3644467457e1c6145...d7576bb27ad2825814ed9909271d3f64cb0e2bc4,2,31,0,31,1,2014-06-16 00:20:22,2014-04-19 11:57:08
d7576bb27ad2825814ed9909271d3f64cb0e2bc4...d17a4cb0378b89f2e3e949e708577bd353cd4363,3,7,7,14,5,2014-06-16 00:45:15,2014-06-16 00:45:15
d17a4cb0378b89f2e3e949e708577bd353cd4363...c8c79367a26a6cdc076e5f188094dd898a043ed2,2,46,1,47,2,2014-06-16 07:27:32,2014-06-16 07:27:14
c8c79367a26a6cdc076e5f188094dd898a043ed2...808388c28ca98cd76c45e3f0d7033f70cc08c735,5,22,10,32,11,2014-06-16 14:15:19,2014-06-16 14:15:19
808388c28ca98cd76c45e3f0d7033f70cc08c735...37a8f5aeedcfc5b4605960e5dc3d989456ce88b9,3,29,0,29,2,2014-06-16 14:18:42,2014-06-16 14:18:42
37a8f5aeedcfc5b4605960e5dc3d989456ce88b9...bb39037fcbe07a4c4060764533b5c03a4018bf81,5,80,2,82,6,2014-06-16 16:28:52,2014-06-11 13:00:52
bb39037fcbe07a4c4060764533b5c03a4018bf81...f047dd2f3eb15619c9137d3389b22e6914092f1c,2,3,3,6,3,2014-06-16 16:54:43,2014-06-16 16:54:23
f047dd2f3eb15619c9137d3389b22e6914092f1c...2b79be2beee8531ab1ef4efca75589705774d8f7,2,7,3,10,4,2014-06-16 16:58:35,2014-06-16 16:58:35
2b79be2beee8531ab1ef4efca75589705774d8f7...067b9668fb3552a9b40e299095be08c1642d84c4,2,58,2,60,6,2014-06-16 17:20:05,2014-06-16 17:20:05
067b9668fb3552a9b40e299095be08c1642d84c4...6e3ac5f4743b75c3e3dd36560c92af15e5b72997,1,7,4,11,2,2014-06-16 17:28:31,2014-06-16 17:28:31
6e3ac5f4743b75c3e3dd36560c92af15e5b72997...eb8600a65673649ea15ed18d17127f741807ac8b,8,85,42,127,9,2014-06-16 19:03:00,2014-06-16 17:28:03
eb8600a65673649ea15ed18d17127f741807ac8b...a96dbda6d35d33f77293b595a6506a600261f17c,1,0,1,1,1,2014-06-16 19:45:07,2014-06-16 19:45:07
a96dbda6d35d33f77293b595a6506a600261f17c...b341f33697cdd26cc967c2ca4a0ac679f4167319,5,75,4,79,7,2014-06-16 20:21:37,2014-06-16 19:59:24
b341f33697cdd26cc967c2ca4a0ac679f4167319...4529af9ecf7debc9281021462531ec4d9697013b,2,19,1,20,3,2014-06-16 20:34:00,2014-06-16 08:46:34
4529af9ecf7debc9281021462531ec4d9697013b...fa9a26745f3aac5c9d2402069d4c99ac328d2fdf,1,1,1,2,1,2014-06-16 21:58:35,2014-06-16 21:58:35
fa9a26745f3aac5c9d2402069d4c99ac328d2fdf...4169d4694aca592e9b7e97a9d0d138548261bdc9,1,8,4,12,4,2014-06-16 22:09:27,2014-06-16 22:09:27
4169d4694aca592e9b7e97a9d0d138548261bdc9...317c480c046284256786aaa6723104df8be9c693,1,2,2,4,1,2014-06-16 22:49:37,2014-06-16 22:49:37
317c480c046284256786aaa6723104df8be9c693...82c935d44cac6f041628fff4f32d1efdde96e720,4,4,4,8,4,2014-06-16 23:25:13,2014-06-16 23:25:13
82c935d44cac6f041628fff4f32d1efdde96e720...b22917bd5062ad39ad9f00b121a4f6c6fa727a31,2,27,4,31,6,2014-06-17 01:44:08,2014-06-17 01:43:45
b22917bd5062ad39ad9f00b121a4f6c6fa727a31...d359647715bccffd7cfc5eb8bcf5edb5c714fb00,1,5,1,6,1,2014-06-17 03:40:13,2014-06-17 03:40:13
d359647715bccffd7cfc5eb8bcf5edb5c714fb00...61d7ae31cf286277ddefaf8006597be40388d2ee,1,3,1,4,1,2014-06-17 07:36:27,2014-06-17 07:36:27
ab2f21080d8b3112c1ba9a0bf923eae733be4242...0837eacc4e1fa7916e48135e8ba43f54a7a64997,5,69,27,96,21,2014-02-02 17:47:06,2014-01-09 04:31:34
0837eacc4e1fa7916e48135e8ba43f54a7a64997...3ffeb931869cc68a8e0916219702ee282afc6e9d,31,666,624,1290,124,2014-02-02 17:47:21,2014-01-09 15:05:15
c3152e5bcd5bb2027fac1411f238adc70eec20e7...3c06b2f2a341922db4294b91117c7b1c34119a8c,7,53,1,54,11,2014-04-23 11:27:52,2014-04-22 20:19:46
3c06b2f2a341922db4294b91117c7b1c34119a8c...48c4ea4146a00a4cec91e13c81724a3899d392db,2,11,11,22,7,2014-04-23 11:45:41,2014-04-22 20:49:52
48c4ea4146a00a4cec91e13c81724a3899d392db...2ffa6ca73a1ecc16cdfa8c03402a17a5c2e2f8cb,2,102,0,102,3,2014-04-23 11:46:11,2014-04-22 21:15:18
2ffa6ca73a1ecc16cdfa8c03402a17a5c2e2f8cb...af5f688392b7fc110d06660ff91f79c742ae751d,2,5,2,7,2,2014-04-23 12:49:46,2014-04-23 11:06:23
af5f688392b7fc110d06660ff91f79c742ae751d...3a435a057c691bf9d5936766f54c5f9bd01be176,1,3,1,4,3,2014-04-23 13:15:03,2014-04-23 13:13:15
3a435a057c691bf9d5936766f54c5f9bd01be176...e74d2183c28467aefc0b87e3fa6d405dbfdea82c,1,4,2,6,2,2014-04-23 19:44:36,2014-04-23 19:34:57
e74d2183c28467aefc0b87e3fa6d405dbfdea82c...0aa4c6c3911fd38567ea2d20c425d1e81e859ee1,1,3,2,5,2,2014-04-23 19:44:36,2014-04-23 19:38:09
0aa4c6c3911fd38567ea2d20c425d1e81e859ee1...91afc00513bd2fa6302ea2be35e1f842cbd5fd38,10,118,90,208,38,2014-04-24 00:12:34,2013-10-03 07:20:04
91afc00513bd2fa6302ea2be35e1f842cbd5fd38...7c24027bad25ebe4bd929bf622eb500446f12b7e,3,18,18,36,18,2014-04-24 09:38:18,2014-04-24 09:36:25
7c24027bad25ebe4bd929bf622eb500446f12b7e...d238c5891239784b61e597c625fe1b340a629da1,1,2,2,4,2,2014-04-24 11:06:02,2014-04-24 11:06:02
d238c5891239784b61e597c625fe1b340a629da1...b0f4eecfa74a71ec3e968df21d0ac6658ec03d8c,1,2,0,2,1,2014-04-24 13:14:26,2014-04-24 06:42:30
b0f4eecfa74a71ec3e968df21d0ac6658ec03d8c...25209715d44562dcbf26f04ed9e0d19ee3c2aa84,1,6,2,8,1,2014-04-24 13:14:42,2014-04-24 06:41:37
25209715d44562dcbf26f04ed9e0d19ee3c2aa84...53d97e4fe300f2775b5bb1b8010ec415994fa105,1,7,0,7,1,2014-04-24 21:36:40,2014-04-24 21:36:40
53d97e4fe300f2775b5bb1b8010ec415994fa105...843613add4d5e7493140fedd10c40c41706b68a8,1,2,2,4,2,2014-04-24 22:30:43,2014-04-24 22:30:43
843613add4d5e7493140fedd10c40c41706b68a8...e368912902add8accf08d290ea77df49bd488744,1,2,0,2,2,2014-04-25 09:43:20,2014-04-25 09:43:20
e368912902add8accf08d290ea77df49bd488744...9e7f86b890a71bcc86ec7bcd9ee0c05801b5e807,3,18,2,20,3,2014-04-25 12:20:25,2014-04-25 12:20:25
9e7f86b890a71bcc86ec7bcd9ee0c05801b5e807...3776926cfe503f16c7195621da20c5b89bda70a2,3,17,1,18,4,2014-04-25 13:54:49,2014-04-24 18:10:03
3776926cfe503f16c7195621da20c5b89bda70a2...deb561bbe2dbacac32d65272beab3a7708e2c31d,2,44,35,79,2,2014-04-25 14:12:31,2014-04-13 15:18:02
deb561bbe2dbacac32d65272beab3a7708e2c31d...f65eb15ac6807e3a44846be3cccc9bfc3e4b72cb,1,5,5,10,1,2014-04-25 14:27:13,2014-04-25 14:27:13
f65eb15ac6807e3a44846be3cccc9bfc3e4b72cb...0315f01087d75f68654f62883a9f36a0f9f71676,2,6,6,12,4,2014-04-25 15:39:49,2014-04-25 15:39:49
0315f01087d75f68654f62883a9f36a0f9f71676...5c0333de2e08db6e47ad06e61b3214cf626d386d,1,0,3,3,1,2014-04-25 17:29:33,2014-04-25 17:29:33
5c0333de2e08db6e47ad06e61b3214cf626d386d...3033a7193afcd1abdc0158e95ca3a241d8448d25,1,6,0,6,3,2014-04-25 20:45:11,2014-04-11 20:55:07
3033a7193afcd1abdc0158e95ca3a241d8448d25...d1f93e9c1e2c61bb06a6f99c80bd9437c5081f2d,1,5,4,9,3,2014-04-25 21:15:47,2014-04-25 21:13:58
d1f93e9c1e2c61bb06a6f99c80bd9437c5081f2d...0707b824fe77e08ca8b75fcc3738ada694f2a3a6,12,299,41,340,49,2014-04-26 10:07:44,2014-03-24 13:03:06
0707b824fe77e08ca8b75fcc3738ada694f2a3a6...6d6af7244b7e3c42ef77c89d6c3e8e0e79e7176f,1,4,0,4,3,2014-04-26 13:39:55,2014-04-26 13:39:55
6d6af7244b7e3c42ef77c89d6c3e8e0e79e7176f...680a0f08b1ace39f995fce975caabb1875b07c6f,22,68,71,139,45,2014-04-26 14:02:53,2014-04-26 14:00:15
680a0f08b1ace39f995fce975caabb1875b07c6f...2128b3a6887a45e99724f52ac2eaf4a5f4d97c84,1,13,14,27,7,2014-04-26 14:09:19,2014-04-26 14:09:19
2128b3a6887a45e99724f52ac2eaf4a5f4d97c84...8b5b199e20ad2d8d3e91873ce0cd5d3035e05ece,11,77,38,115,28,2014-04-26 15:46:23,2014-04-26 08:22:48
8b5b199e20ad2d8d3e91873ce0cd5d3035e05ece...2bcb8bfc8de5cd57ebb64b326cd7609aa0d8c1c7,53,79,80,159,71,2014-04-26 17:18:45,2014-04-26 17:18:45
2bcb8bfc8de5cd57ebb64b326cd7609aa0d8c1c7...58ed387db33e407f35c0486c1e7cbd37c35c8618,2,66,5,71,6,2014-04-26 18:13:59,2014-04-26 16:32:17
58ed387db33e407f35c0486c1e7cbd37c35c8618...8905fcbda6854b5b7fdd8a1ee3277f8f1039e114,1,5,0,5,1,2014-04-27 18:17:37,2014-04-27 18:17:37
8905fcbda6854b5b7fdd8a1ee3277f8f1039e114...ab8d8e00c9d34a48a640434f454d98c02cfaeb54,4,128,166,294,96,2014-04-27 19:05:41,2014-04-27 19:05:25
ab8d8e00c9d34a48a640434f454d98c02cfaeb54...1ce759b69f641fd780790630c79559fc68a2d923,1,5,0,5,1,2014-04-27 19:19:54,2014-04-27 19:19:54
1ce759b69f641fd780790630c79559fc68a2d923...b829d53b37946d5e3148e2c51ae7ec41f470b756,2,19,13,32,10,2014-04-28 12:18:43,2014-04-28 12:18:43
61d7ae31cf286277ddefaf8006597be40388d2ee...3a6cb9f497af4e5eb8351706056eae50a4ed3c45,3,7,0,7,2,2014-06-17 16:21:38,2014-06-17 15:50:31
61d7ae31cf286277ddefaf8006597be40388d2ee...95cc0e15b45dd0986bdfd9fa3fedee4550c744c8,8,31,31,62,25,2014-06-17 15:57:16,2014-06-17 15:57:16
54bfa4caab11d364eb208ba6639836fa22d69a04...9ab798a8d8911a431bcb28b0bd82e391e879077a,1,2,1,3,2,2014-02-02 19:05:35,2014-02-02 19:03:23
9ab798a8d8911a431bcb28b0bd82e391e879077a...a42e04f77de9fcec673eb78d05fdc26a6ab74cf6,1,5,5,10,3,2014-02-02 20:09:34,2014-01-15 12:53:19
a42e04f77de9fcec673eb78d05fdc26a6ab74cf6...5616234d4d7b28ee807df89f4f817f080ac57d36,1,0,1,1,1,2014-02-02 20:14:16,2014-02-02 20:14:16
b829d53b37946d5e3148e2c51ae7ec41f470b756...dd3f3e4e895b252e93bc0cc6c2537c67a4195995,1,1,1,2,1,2014-04-28 14:05:28,2014-04-28 14:05:28
66a99fa21076529a5e71996a8862597284403727...77ff4a93606fe676c2fef4ec2d1812628d7ed01e,1,0,0,0,0,2014-06-17 16:56:22,2014-06-17 16:56:22
95cc0e15b45dd0986bdfd9fa3fedee4550c744c8...a8fa96796f07668c0fcdbc27a540bbb939d5bf2a,1,1,1,2,1,2014-06-17 16:23:26,2014-06-17 16:23:26
5616234d4d7b28ee807df89f4f817f080ac57d36...ad913f242d6b3de3d188d5a28977e33b14bcda16,1,2,1,3,2,2014-02-02 20:44:01,2014-02-02 20:44:01
d2e732cde3de85e05bc979b2214f876bf5366434...26b03f25265227498a2559af807918fe2a1d246f,1,5,0,5,1,2014-04-28 16:43:33,2014-04-28 16:43:33
26b03f25265227498a2559af807918fe2a1d246f...aabceadd7d7a61468b0dc7dc9d560a770abae0cf,4,4,68,72,12,2014-04-28 22:41:36,2014-04-28 22:41:16
aabceadd7d7a61468b0dc7dc9d560a770abae0cf...68d264059abb21b96c4fe68bf4d99520268a451c,3,3,3,6,3,2014-04-28 23:06:25,2014-04-28 23:06:25
68d264059abb21b96c4fe68bf4d99520268a451c...650065f0ef9daf2bf2fc6b36c33e071f510d253a,2,13,0,13,2,2014-04-29 00:38:06,2014-04-29 00:38:06
650065f0ef9daf2bf2fc6b36c33e071f510d253a...0fb7570c5cc89e6a8adaa5052574de29ccf6adde,1,3,1,4,1,2014-04-29 06:33:15,2014-04-29 06:32:10
0fb7570c5cc89e6a8adaa5052574de29ccf6adde...2df7238512ecb9c19922a288592f4edfac1df43f,1,1,1,2,1,2014-04-29 10:46:54,2014-04-29 10:46:54
2df7238512ecb9c19922a288592f4edfac1df43f...a2340ac6d6b7e31c7e97e8fdaf3e1d73e43b24ba,2,16,12,28,3,2014-04-29 13:43:08,2014-04-29 04:44:04
a2340ac6d6b7e31c7e97e8fdaf3e1d73e43b24ba...390f888745803a2f6c75c5a22402daf1221f8e29,2,17,0,17,4,2014-04-29 13:43:08,2014-04-15 22:54:30
390f888745803a2f6c75c5a22402daf1221f8e29...83413c53d20859eaa2f1ffe73d119c9be6f74787,3,3,0,3,3,2014-04-30 11:15:03,2014-04-25 16:27:48
83413c53d20859eaa2f1ffe73d119c9be6f74787...d9c272b22f116adbaff11570e5d6f9a299a358dc,1,0,1,1,1,2014-04-30 11:23:39,2014-04-30 11:23:39
d9c272b22f116adbaff11570e5d6f9a299a358dc...8ec388a69da13a8a5cf82604a26abe13be7dd1cb,2,64,0,64,3,2014-04-30 11:36:12,2014-04-28 13:28:03
8ec388a69da13a8a5cf82604a26abe13be7dd1cb...7fd1b35ed794e7d0a2a18f6ac168adba25a7de23,4,30,5,35,7,2014-04-30 11:56:52,2014-04-12 03:58:56
7fd1b35ed794e7d0a2a18f6ac168adba25a7de23...7c54f8cced37313572d72f59bd2ef7ce12aa8fe1,2,21,7,28,11,2014-04-30 14:53:20,2014-04-30 14:53:20
7c54f8cced37313572d72f59bd2ef7ce12aa8fe1...a5f6cbce07b5f3ab48d931e3fd1883c757fb9b45,3,106,94,200,22,2014-04-30 16:36:25,2014-04-30 16:04:30
e4708385fde278fbbff5428f756632455c2bcaf5...91f1b6dcdc5da47d7794a55e3114820407a5bd62,8,254,24,278,19,2014-06-17 20:16:02,2014-06-10 12:04:19
91f1b6dcdc5da47d7794a55e3114820407a5bd62...8d2ac948a9583220d2324cf908bff3cc1d0beb2b,6,147,26,173,31,2014-06-18 00:45:38,2014-06-18 00:45:38
8d2ac948a9583220d2324cf908bff3cc1d0beb2b...405b9dcd8b16fe923e1d4beadc8bb05906eaf7d5,1,2,3,5,3,2014-06-18 04:32:23,2014-06-18 04:32:23
405b9dcd8b16fe923e1d4beadc8bb05906eaf7d5...09b63a7ccee85566dbe6dd476b507e8c310e8092,7,58,1,59,5,2014-06-18 05:12:31,2014-06-18 05:12:31
09b63a7ccee85566dbe6dd476b507e8c310e8092...2cee1d464217ff9f0d0af1e14ecd0b9b70ad1b7e,10,145,6,151,13,2014-06-18 06:28:35,2014-06-18 06:27:03
2cee1d464217ff9f0d0af1e14ecd0b9b70ad1b7e...d015c9d11cd59491ddf9105f05a41ad5af0243b0,2,2,4,6,4,2014-06-18 14:47:13,2014-06-18 14:47:13
d015c9d11cd59491ddf9105f05a41ad5af0243b0...de9012907063e210e97c0d65cde312ff6174d420,1,13,0,13,1,2014-06-18 16:30:10,2014-06-16 19:30:26
de9012907063e210e97c0d65cde312ff6174d420...87d0a3384cc263fe0df749a28e2fbc1e1240f043,7,120,2,122,8,2014-06-18 17:53:07,2014-06-06 16:16:17
87d0a3384cc263fe0df749a28e2fbc1e1240f043...0be4d64487537fe5fe220cfb8896c4da08bb22a8,1,1,2,3,2,2014-06-18 18:35:38,2014-06-18 18:35:38
0be4d64487537fe5fe220cfb8896c4da08bb22a8...63670a474c14b1989f1a3f4ee7fd0fbacb5a764a,1,3,48,51,2,2014-06-18 18:58:50,2014-06-18 18:55:49
63670a474c14b1989f1a3f4ee7fd0fbacb5a764a...9996158db467f9bef8243fcc36dc3602570e3613,20,94,69,163,72,2014-06-19 12:54:59,2014-06-17 23:07:54
9996158db467f9bef8243fcc36dc3602570e3613...80f4487d17a0040e9be35e7ee6ac478bafe6504a,1,3,0,3,2,2014-06-19 14:46:04,2014-06-19 09:05:50
80f4487d17a0040e9be35e7ee6ac478bafe6504a...01399fa0aaa817281c77bbb4b7d82c6c8487c916,1,0,3,3,2,2014-06-19 16:11:25,2014-06-19 16:11:25
01399fa0aaa817281c77bbb4b7d82c6c8487c916...d862fae5bbfb52ab7aeaad5a59b3d8b27b30c8f9,4,777,0,777,3,2014-06-19 16:56:36,2014-06-19 14:03:36
d862fae5bbfb52ab7aeaad5a59b3d8b27b30c8f9...9f4852f649fad459a451995c4a17a7d8db5972c9,2,7,1,8,2,2014-06-20 06:41:32,2014-06-20 06:40:59
9f4852f649fad459a451995c4a17a7d8db5972c9...08221d1b5c1eec782c792818a2aa4a74ca7f1fcb,2,11,1,12,2,2014-06-20 06:48:29,2014-06-20 06:48:29
08221d1b5c1eec782c792818a2aa4a74ca7f1fcb...b67e9ed8c991830acdc12f2b97f92769719556a7,2,8,4,12,4,2014-06-20 11:53:17,2014-06-20 11:52:36
b67e9ed8c991830acdc12f2b97f92769719556a7...608aa8d101b03004ed2181fac82d8f3d28253bbd,2,3,1,4,2,2014-06-20 12:14:17,2014-06-20 01:46:18
608aa8d101b03004ed2181fac82d8f3d28253bbd...fbb684d95ed71487fe16135321d59ddb043ee903,3,37,16,53,8,2014-06-20 12:55:02,2014-06-19 23:50:01
fbb684d95ed71487fe16135321d59ddb043ee903...9a46836a0c3e15021df242f3dd5a33306f7e27bc,1,1,1,2,2,2014-06-20 13:13:34,2014-06-20 13:12:52
9a46836a0c3e15021df242f3dd5a33306f7e27bc...78c32f1caa9cb9b28be2d867aff586a2016122ed,3,34,2,36,5,2014-06-20 15:59:02,2014-05-19 16:19:35
78c32f1caa9cb9b28be2d867aff586a2016122ed...407d070329b4df81dab488db35bb068976e3be43,7,75,2,77,18,2014-06-20 17:04:41,2014-06-06 18:47:15
407d070329b4df81dab488db35bb068976e3be43...97adfc2bf8393d1128917ea1f57f3c3a7ef8caa6,1,1,0,1,1,2014-06-20 17:35:59,2014-06-20 14:23:37
97adfc2bf8393d1128917ea1f57f3c3a7ef8caa6...2764146586509c2c81ad14da4ac86efa3a949308,3,22,2,24,7,2014-06-20 19:29:46,2014-06-15 11:02:39
2764146586509c2c81ad14da4ac86efa3a949308...3425d42bf1945a3e6b2562de6c71a614e6ab2845,2,3,3,6,3,2014-06-20 21:53:18,2014-06-20 21:53:18
3425d42bf1945a3e6b2562de6c71a614e6ab2845...1892ced10a8c0a74a93acddecdb3329fc58a017b,1,3,0,3,1,2014-06-20 22:47:14,2014-06-20 22:47:14
1892ced10a8c0a74a93acddecdb3329fc58a017b...cecbb71312a5cc515ac1ddf821bdeb072c3bfaea,1,1,1,2,1,2014-06-21 09:21:35,2014-06-21 09:17:10
cecbb71312a5cc515ac1ddf821bdeb072c3bfaea...bc19ff6479261d80f3b1751700b7b9d4d7428211,1,2,2,4,2,2014-06-21 12:10:07,2014-06-21 12:07:30
bc19ff6479261d80f3b1751700b7b9d4d7428211...c6a711d9e50835eca0f3fcf79089ef75251ec931,5,29,29,58,18,2014-06-21 19:01:37,2014-06-21 16:27:46
c6a711d9e50835eca0f3fcf79089ef75251ec931...f07735c619c121d8785082972acd8fbad8b236af,1,10,2,12,2,2014-06-22 17:03:58,2014-06-22 17:03:58
f07735c619c121d8785082972acd8fbad8b236af...b30d32ff24096e4191d661e2aaa734c92795237f,2,58,5,63,4,2014-06-22 18:23:45,2014-06-22 18:23:45
b30d32ff24096e4191d661e2aaa734c92795237f...8b878c7a6429be499edca5cb6897c226f5bdcba2,1,1,1,2,1,2014-06-22 20:00:49,2014-06-22 20:00:49
8b878c7a6429be499edca5cb6897c226f5bdcba2...ecc06d44ed67c5bd27278244e5cf315d6fa2c893,1,3,3,6,2,2014-06-22 20:03:25,2014-06-22 20:03:25
ecc06d44ed67c5bd27278244e5cf315d6fa2c893...21c496ea52b8bdf0d97507c00a87286425dac087,3,25,4,29,6,2014-06-23 01:36:22,2014-06-23 01:29:27
21c496ea52b8bdf0d97507c00a87286425dac087...9618d68b345fe69c787f8426b07e920e647e05f3,5,20,7,27,7,2014-06-23 07:31:45,2014-06-21 13:00:35
9618d68b345fe69c787f8426b07e920e647e05f3...18b3788401e823266a560b12000697da04490beb,1,2,0,2,1,2014-06-23 11:27:52,2014-06-23 11:25:50
18b3788401e823266a560b12000697da04490beb...1d9596025e53a33763d9dbb61e7dda015ec60b25,1,2,1,3,2,2014-06-23 12:06:04,2014-06-23 12:05:57
1d9596025e53a33763d9dbb61e7dda015ec60b25...809362518d6dbb7ca989b32ed97b39f6156563b9,4,6,4,10,6,2014-06-23 12:54:25,2014-06-23 12:51:53
809362518d6dbb7ca989b32ed97b39f6156563b9...1bbffe7867a2e5169bc89fbfab5da9b4b7bc0b05,1,1,2,3,1,2014-06-23 13:10:44,2014-06-23 13:10:44
1bbffe7867a2e5169bc89fbfab5da9b4b7bc0b05...908160f6926506dc64244e9d5a4507bc67ea0a81,1,7,0,7,2,2014-06-23 13:59:36,2014-06-23 12:45:06
908160f6926506dc64244e9d5a4507bc67ea0a81...1c50d6ae2bee31ccf605066186d4d48aaf2de7ea,4,7,2,9,4,2014-06-23 16:36:40,2014-06-20 05:00:04
1c50d6ae2bee31ccf605066186d4d48aaf2de7ea...bcd2e6c697ee29ab1c1240a6b30281d53329b333,1,1,1,2,1,2014-06-23 17:13:45,2014-06-22 02:37:39
bcd2e6c697ee29ab1c1240a6b30281d53329b333...7f76251fb7ea8593a47ab55ac22d6cb500b39e2f,3,21,42,63,9,2014-06-23 19:27:25,2014-06-22 03:32:14
7f76251fb7ea8593a47ab55ac22d6cb500b39e2f...535219e4f7047c5ccbc70029dfdbcf69e0f83abc,2,3,3,6,3,2014-06-23 22:50:51,2014-06-23 22:50:51
535219e4f7047c5ccbc70029dfdbcf69e0f83abc...0a8c0eda2ab2e7330bcf3bd5dc7c3434ab1a7a90,1,5,9,14,10,2014-06-23 23:30:06,2014-06-14 14:55:52
0a8c0eda2ab2e7330bcf3bd5dc7c3434ab1a7a90...c33447a50c1b0a96c6e2261f7c45d2522a3fe28d,3,36,9,45,6,2014-06-23 23:57:20,2014-06-14 14:58:16
c33447a50c1b0a96c6e2261f7c45d2522a3fe28d...0fba4c0ed7fa1d71a6a9d6777cc64933f8d0005a,3,19,17,36,9,2014-06-24 03:25:09,2014-06-24 03:25:09
0fba4c0ed7fa1d71a6a9d6777cc64933f8d0005a...0b571753a89f2a7a34c76dea5ee81f821b980779,2,11,1,12,4,2014-06-24 03:39:17,2014-06-24 03:39:17
0b571753a89f2a7a34c76dea5ee81f821b980779...fe262c0b848c96ef624680d43dc78eae55157967,2,18,1,19,3,2014-06-24 03:48:33,2014-06-24 03:48:33
fe262c0b848c96ef624680d43dc78eae55157967...460ec09d2ed26f5862aabeaa480bcb713d5f331f,1,35,0,35,1,2014-06-24 07:02:28,2014-06-23 07:28:42
460ec09d2ed26f5862aabeaa480bcb713d5f331f...150d88cc2c0866ef65f077387e3e560e9c9c3f80,3,39,9,48,7,2014-06-24 11:09:38,2014-06-24 11:09:38
150d88cc2c0866ef65f077387e3e560e9c9c3f80...dbbcfca476e29354c3a5c6221112b55741babc14,4,18,7,25,9,2014-06-24 12:55:36,2014-06-24 04:13:34
dbbcfca476e29354c3a5c6221112b55741babc14...cd20b5d1864e3c0f2d9ce8b9d186c201e5d89c00,4,515,225,740,66,2014-06-24 18:55:22,2014-06-08 18:30:52
cd20b5d1864e3c0f2d9ce8b9d186c201e5d89c00...48241ec9c4e971042c69fb26a8328f3055eed462,1,1,1,2,1,2014-06-24 20:06:06,2014-06-24 18:16:53
48241ec9c4e971042c69fb26a8328f3055eed462...7f4e2ef1e9e9f5c86217ccf9ac97391291a9d422,2,38,18,56,10,2014-06-25 01:40:21,2014-06-11 20:41:25
7f4e2ef1e9e9f5c86217ccf9ac97391291a9d422...d68987ae25f0e0fb30727473803758af53d75671,4,28,13,41,17,2014-06-25 02:02:03,2014-06-25 02:01:39
d68987ae25f0e0fb30727473803758af53d75671...fd4ccd045cf8edf0bf10ee0c576c7b7c5819170c,3,19,1,20,3,2014-06-25 02:03:22,2014-06-07 23:47:43
fd4ccd045cf8edf0bf10ee0c576c7b7c5819170c...815e7a57216b3e6ef716e924016acb09633ea8d1,2,50,1,51,2,2014-06-25 11:08:16,2014-06-25 10:52:25
815e7a57216b3e6ef716e924016acb09633ea8d1...9385aa3198e7ab460990dd8f82e466fd243557a0,3,20,2,22,4,2014-06-25 11:20:18,2014-02-15 11:24:20
9385aa3198e7ab460990dd8f82e466fd243557a0...e769846eec14d3b522c132104e2ecba9cf96d3b0,1,1,1,2,1,2014-06-25 12:37:12,2014-06-25 12:37:12
e769846eec14d3b522c132104e2ecba9cf96d3b0...e0cd07ec2f394e6db3d17de19809a8f377cd1578,3,64,27,91,18,2014-06-25 14:02:12,2014-06-25 12:53:09
e0cd07ec2f394e6db3d17de19809a8f377cd1578...77c0a904cbb2ff144dc42deac4e9fbca0c370f1b,1,1,1,2,1,2014-06-25 15:15:20,2014-06-25 15:15:20
77c0a904cbb2ff144dc42deac4e9fbca0c370f1b...7e2c804c9417617934cd731a4537719a1bd8d985,5,384,315,699,11,2014-06-25 19:39:56,2014-05-16 09:55:09
7e2c804c9417617934cd731a4537719a1bd8d985...0d363b25b82b0a86b7243512470f364bef92bc3d,1,29,4,33,9,2014-06-26 08:01:52,2014-06-21 09:40:36
0d363b25b82b0a86b7243512470f364bef92bc3d...a8c5630c98ca826c1ea20ff196333ee9688c3a78,1,3,2,5,1,2014-06-26 11:23:32,2014-06-26 09:33:09
a8c5630c98ca826c1ea20ff196333ee9688c3a78...e9c730f6be4c6ca913f7627c59eedfc3d359851e,1,3,3,6,3,2014-06-26 11:27:13,2014-06-25 22:43:48
e9c730f6be4c6ca913f7627c59eedfc3d359851e...ec85df2fa5e3872591da4100dc6bdaa120a92529,1,91,90,181,43,2014-06-26 17:57:19,2014-06-25 16:23:04
ec85df2fa5e3872591da4100dc6bdaa120a92529...68c9a72e29c929d896a25b3a0f566c09b6723dd4,6,72,40,112,20,2014-06-26 19:02:42,2014-06-24 13:07:36
68c9a72e29c929d896a25b3a0f566c09b6723dd4...5e9773269a2a1464b845b7cc98b62b3e9d863131,1,1,0,1,1,2014-06-26 19:16:23,2014-06-26 19:16:23
5e9773269a2a1464b845b7cc98b62b3e9d863131...1e8411259f14f2ef788cc4e7c2a4cdbb537d39b3,1,2,0,2,1,2014-06-27 13:51:21,2014-06-27 13:50:29
1e8411259f14f2ef788cc4e7c2a4cdbb537d39b3...70576740b0bb5289873f5a9a9a4e1a26b2c330e5,2,18,2,20,18,2014-06-27 14:34:48,2014-06-27 14:34:48
70576740b0bb5289873f5a9a9a4e1a26b2c330e5...f12b68af71efa0b061710c83364f231734d07e55,1,13,11,24,3,2014-06-28 14:18:24,2014-06-28 14:05:13
f12b68af71efa0b061710c83364f231734d07e55...985ad99a7110e44ade26370e73ac9fdcae9628b8,1,1,1,2,1,2014-06-29 18:15:50,2014-06-29 18:15:50
985ad99a7110e44ade26370e73ac9fdcae9628b8...4c39c270af91ddbc213e077fc06b4bf67c7c6e99,1,2,2,4,2,2014-06-29 21:56:21,2014-06-29 21:56:21
4c39c270af91ddbc213e077fc06b4bf67c7c6e99...add78c58b5adb1d6e92cb5c998465442492d7bfb,1,2,2,4,2,2014-06-30 11:39:35,2014-06-30 11:39:35
add78c58b5adb1d6e92cb5c998465442492d7bfb...fd5897193f0bd8fa211885be5726f8e5613f3c08,3,16,7,23,7,2014-06-30 14:25:57,2014-06-30 13:13:35
fd5897193f0bd8fa211885be5726f8e5613f3c08...5359188b0802f39201a6ce45a08391597c8174bb,1,20,16,36,11,2014-06-30 18:20:51,2014-06-26 10:56:45
5359188b0802f39201a6ce45a08391597c8174bb...cf252dbea66d9c4a84aa1bc8da93b5e5cc759b9a,4,25,3,28,5,2014-06-30 18:20:51,2014-06-26 10:58:12
cf252dbea66d9c4a84aa1bc8da93b5e5cc759b9a...0b5bafe993417b2b936ab083299e6549e1cbf528,1,0,8,8,1,2014-06-30 18:36:18,2014-06-30 18:35:09
0b5bafe993417b2b936ab083299e6549e1cbf528...29c1151a5577cccfdb18109ccb42330cde124d89,5,53,2,55,12,2014-06-30 19:34:35,2014-06-16 07:39:18
29c1151a5577cccfdb18109ccb42330cde124d89...874053edf92c02e1ab155bdf7491b08f9863dce8,2,19,11,30,8,2014-06-30 20:30:57,2014-06-30 20:30:57
874053edf92c02e1ab155bdf7491b08f9863dce8...e3c7af18a307f9d020eb798bdad6cc63ab22dac9,1,12,4,16,3,2014-06-30 21:52:04,2014-06-30 21:48:14
e3c7af18a307f9d020eb798bdad6cc63ab22dac9...f3a933d7c19b944a2dc86c1232f5c6c7224d2fe7,1,1,1,2,1,2014-06-30 22:38:30,2014-06-30 22:38:30
f3a933d7c19b944a2dc86c1232f5c6c7224d2fe7...bbf0a9545bd098f09aeb0c2fb63497eb0ddf13ad,1,2,2,4,1,2014-06-30 22:48:49,2014-06-30 22:47:53
bbf0a9545bd098f09aeb0c2fb63497eb0ddf13ad...81edf2d006f57d53ef08d0c881adf66f9aa391f7,1,74,74,148,19,2014-06-30 23:47:19,2014-06-30 23:47:19
81edf2d006f57d53ef08d0c881adf66f9aa391f7...34ba86706f0db33d9a0ab44e4abb78703e7262a9,6,144,21,165,11,2014-07-01 10:12:58,2014-06-14 07:24:19
34ba86706f0db33d9a0ab44e4abb78703e7262a9...71461b14ab0c5a3801d85738fde3aedd407d7115,3,34,3,37,8,2014-07-01 10:32:53,2014-05-24 10:29:31
71461b14ab0c5a3801d85738fde3aedd407d7115...c26579eaa76a465fbe8a18205fd756a377f7a4da,1,0,8,8,1,2014-07-01 12:51:06,2014-07-01 12:51:06
c26579eaa76a465fbe8a18205fd756a377f7a4da...0b6f05ede648ce62a5c91c7c38a0a362711f0656,4,119,64,183,23,2014-07-01 13:31:01,2014-06-06 12:35:40
0b6f05ede648ce62a5c91c7c38a0a362711f0656...232f2028d57bb3b55304d3ea80ab0a06122f0b34,1,3,4,7,1,2014-07-01 19:54:32,2014-07-01 19:54:28
232f2028d57bb3b55304d3ea80ab0a06122f0b34...20ec9daf7c2a4460e99a2983d7e32b7db5ee7ce6,3,14,0,14,5,2014-07-01 21:29:41,2014-07-01 13:32:26
20ec9daf7c2a4460e99a2983d7e32b7db5ee7ce6...db9a1a0c47cacb9fa4ba7a39ffedeecf4e672223,1,7,0,7,1,2014-07-01 21:32:14,2014-07-01 21:32:14
db9a1a0c47cacb9fa4ba7a39ffedeecf4e672223...e9249bc20b49c7b6721a8a58bc4bb9dd4827855a,1,8,0,8,1,2014-07-02 03:54:46,2014-07-02 03:54:46
e9249bc20b49c7b6721a8a58bc4bb9dd4827855a...5842d8eba454fdb9b276af343606e3b04e64091f,1,2,5,7,3,2014-07-02 11:54:02,2014-07-01 18:20:54
5842d8eba454fdb9b276af343606e3b04e64091f...3de4f8bab6509586d9e7283ea33f51d4729c8a13,1,2,2,4,2,2014-07-02 14:11:52,2014-07-02 14:11:52
3de4f8bab6509586d9e7283ea33f51d4729c8a13...c37000ab04a1592ecb7436d45bd2b4b9d015c9b3,1,3,2,5,1,2014-07-02 14:12:43,2014-07-02 14:12:43
c37000ab04a1592ecb7436d45bd2b4b9d015c9b3...7c3d6149a7bdb15fa4a254876c27aadd7feb2c3d,1,0,5,5,1,2014-07-02 14:19:15,2014-07-02 14:19:15
7c3d6149a7bdb15fa4a254876c27aadd7feb2c3d...27ee608b5557c3cd18aab6a61f854a0f6c18f3df,3,15,1,16,3,2014-07-02 16:45:02,2014-07-01 20:42:25
27ee608b5557c3cd18aab6a61f854a0f6c18f3df...10e83d48a3b199f9c8c73882be1ded5016f86a1a,4,19,3,22,5,2014-07-02 17:01:36,2014-07-02 04:43:07
10e83d48a3b199f9c8c73882be1ded5016f86a1a...1a3bec4a26248f93982e0349bab53adaab80e968,2,17,0,17,2,2014-07-02 17:16:31,2014-07-02 17:16:31
1a3bec4a26248f93982e0349bab53adaab80e968...42f5c8f39710691ce1606289698ee321a8ac0627,1,2,2,4,1,2014-07-02 17:21:34,2014-07-02 17:21:34
42f5c8f39710691ce1606289698ee321a8ac0627...a93ee5112d42d37187e30aa4edcc1864a79d384a,4,12,2,14,4,2014-07-03 00:36:53,2014-07-02 15:51:51
a93ee5112d42d37187e30aa4edcc1864a79d384a...23d68c0f0d705fede71e1a99625d9988a63cdad3,1,1,15,16,2,2014-07-03 04:33:03,2014-07-03 04:33:03
23d68c0f0d705fede71e1a99625d9988a63cdad3...9bc2d766a0c31701a4c0e20a8b04164bb22cf6d5,6,101,9,110,9,2014-07-03 11:42:52,2014-06-30 13:06:28
9bc2d766a0c31701a4c0e20a8b04164bb22cf6d5...814bcc33951db8a469b9bba26fb021fc2d8ad480,1,5,0,5,1,2014-07-03 13:21:20,2014-07-03 13:20:03
814bcc33951db8a469b9bba26fb021fc2d8ad480...1bb1d3168b813e050df757ff40cdaf2feab45fdb,2,3,1,4,2,2014-07-04 07:00:16,2014-07-03 20:37:56
1bb1d3168b813e050df757ff40cdaf2feab45fdb...1966054febbb96b713db27513617eabdbd70957b,3,177,15,192,6,2014-07-04 10:05:31,2014-07-01 13:48:00
788cde326ae3c7bf37f98432c2994d1fb94fa41e...e1d839237f7ce38ef078b7f09cc3a1aeaacc02f0,2,10,2,12,3,2014-02-02 21:43:53,2014-02-02 21:38:28
e1d839237f7ce38ef078b7f09cc3a1aeaacc02f0...ab922c5cd84d3bde09917b72cfddd8c6a4985f26,1,1,1,2,1,2014-02-02 22:40:16,2014-02-02 22:40:16
ab922c5cd84d3bde09917b72cfddd8c6a4985f26...d4a5019bef116028edb6e66eac9156da96a3d704,5,426,117,543,59,2014-02-03 13:32:32,2014-02-03 13:09:27
d4a5019bef116028edb6e66eac9156da96a3d704...e7e3435b4d0d409aa98a66d2d7961f7541d19f9f,5,33,0,33,4,2014-02-03 15:18:32,2014-02-03 10:46:17
e7e3435b4d0d409aa98a66d2d7961f7541d19f9f...6e0f1bc06df87453875e639f66cb608bcb393429,2,13,15,28,4,2014-02-03 15:22:10,2014-02-03 15:22:10
6e0f1bc06df87453875e639f66cb608bcb393429...867f8fd6c7f204769f2c72d1684b5c8c220aa5b4,1,2,4,6,2,2014-02-04 11:24:13,2014-02-04 11:24:13
867f8fd6c7f204769f2c72d1684b5c8c220aa5b4...35cecb1ebd0ccda0be7a518d1b7273333d26fbae,2,95,8,103,9,2014-02-04 16:48:06,2014-01-08 17:35:47
35cecb1ebd0ccda0be7a518d1b7273333d26fbae...5848bea9dc9458a9517d4c98993d742976771342,4,44,175,219,18,2014-02-04 19:02:28,2014-01-31 10:59:27
5848bea9dc9458a9517d4c98993d742976771342...be0ad62994a340ad54a0b328771931932a45a899,4,93,58,151,62,2014-02-04 19:02:28,2014-01-31 14:18:55
be0ad62994a340ad54a0b328771931932a45a899...343dfff13370dac679b640196979a33951127290,5,23,43,66,23,2014-02-04 19:02:28,2014-02-02 22:16:07
343dfff13370dac679b640196979a33951127290...2b272241809c939add6c81f312c479066e47c638,1,1,1,2,1,2014-02-04 20:14:41,2014-02-04 20:14:41
2b272241809c939add6c81f312c479066e47c638...6f504266b2e755b49a5ee4c63822ffa7b3d0fd8a,2,1,2,3,2,2014-02-04 23:45:18,2014-02-04 23:45:18
6f504266b2e755b49a5ee4c63822ffa7b3d0fd8a...aea9faa146f5ce8bfaf038dfa2f4377e0543c569,1,1,1,2,1,2014-02-05 14:39:44,2014-01-29 15:53:47
aea9faa146f5ce8bfaf038dfa2f4377e0543c569...c29d6f767691cceb9964c0d212e01281ac6721d3,2,27,17,44,9,2014-02-05 19:57:40,2014-02-04 18:19:14
c29d6f767691cceb9964c0d212e01281ac6721d3...297c009cf22b14b0124b790303404ee06a289999,1,9,12,21,11,2014-02-05 19:57:40,2014-02-05 19:45:57
297c009cf22b14b0124b790303404ee06a289999...f265c1ef13e6eaa75c8e1cfdaade527a1505bb5e,1,18,18,36,13,2014-02-05 19:58:50,2014-02-03 03:00:48
f265c1ef13e6eaa75c8e1cfdaade527a1505bb5e...a0fc7fa5df1545b34e1d31312aebc7ca31db6ef3,1,2,1,3,2,2014-02-05 20:17:01,2014-02-05 20:15:47
a0fc7fa5df1545b34e1d31312aebc7ca31db6ef3...a878bf9b093bf15d751b070d132fec52a7523a47,2,9,18,27,9,2014-02-05 20:22:40,2014-02-05 04:16:39
a878bf9b093bf15d751b070d132fec52a7523a47...2dd88f0687c2bc9c457816a011bf5e46f6bf84ad,1,4,0,4,1,2014-02-05 20:46:02,2014-02-05 20:46:02
2dd88f0687c2bc9c457816a011bf5e46f6bf84ad...55d19d370f335e3f19a65c955b5efcffbf093791,1,0,1,1,1,2014-02-05 21:26:56,2014-02-05 21:26:56
55d19d370f335e3f19a65c955b5efcffbf093791...36f260341a1720d7a38e482234c84ff8e73eab85,1,33,2,35,2,2014-02-05 23:30:45,2014-02-05 19:27:01
36f260341a1720d7a38e482234c84ff8e73eab85...b17c75564f2f8a4a4ff63be649e7c9902c42cbf7,1,8,0,8,1,2014-02-06 00:29:41,2014-02-06 00:29:41
b17c75564f2f8a4a4ff63be649e7c9902c42cbf7...c43c469a2e4633361f5dccf7dc7ce37054008d18,2,12,0,12,2,2014-02-06 09:02:09,2014-01-04 04:57:50
c43c469a2e4633361f5dccf7dc7ce37054008d18...b22d6c47a7e4c7ab26a8b7b033d11fa6743aae86,5,60,0,60,6,2014-02-06 09:45:49,2013-11-18 20:16:09
b22d6c47a7e4c7ab26a8b7b033d11fa6743aae86...d3cf6cfacfb828faad4f4f97c904e259304649b3,7,16,12,28,10,2014-02-06 10:16:40,2013-11-24 13:12:22
d3cf6cfacfb828faad4f4f97c904e259304649b3...84fb7b468e941602f8f7edccc198dd21f8c9734d,1,23,18,41,12,2014-02-06 21:34:22,2014-02-06 21:34:22
84fb7b468e941602f8f7edccc198dd21f8c9734d...43510cffcbf64e73232da1d6209151c7232fd2b6,1,1,1,2,1,2014-02-06 21:54:27,2014-02-06 21:54:27
43510cffcbf64e73232da1d6209151c7232fd2b6...65131911dba08dcc1451d71ae4d5101724d722f6,2,40,1,41,4,2014-02-07 20:29:25,2013-11-27 19:45:20
65131911dba08dcc1451d71ae4d5101724d722f6...8847a0c601e4261823b1726b2db73eec2ac17940,11,142,34,176,22,2014-02-08 09:59:09,2014-02-03 18:31:27
8847a0c601e4261823b1726b2db73eec2ac17940...02add43568b694ef25afeae474b5b1da883826c6,2,10,2,12,2,2014-02-08 10:06:54,2014-02-08 10:06:54
02add43568b694ef25afeae474b5b1da883826c6...6c5a30b4e7f51e8c255dc104714d5748e5b5870c,1,21,0,21,2,2014-02-08 10:49:27,2014-02-08 10:49:27
6c5a30b4e7f51e8c255dc104714d5748e5b5870c...114b70ccf8dcd7af86d5cd464d66aa7761400884,4,49,0,49,3,2014-02-08 12:12:46,2013-09-19 12:07:59
114b70ccf8dcd7af86d5cd464d66aa7761400884...b041850853188428ac3b843001603db8f8a69392,1,1,1,2,1,2014-02-08 12:22:11,2013-12-28 11:18:34
a5f6cbce07b5f3ab48d931e3fd1883c757fb9b45...73a57b06f9d8c963b9be2bdb83122a004a4a8b0b,7,81,81,162,67,2014-05-20 16:35:16,2014-05-20 16:24:23
a5f6cbce07b5f3ab48d931e3fd1883c757fb9b45...24ec9538b7ca400f68ba08fab380445ca95d7c02,5,113,50,163,25,2014-04-30 18:23:19,2014-04-26 07:34:20
24ec9538b7ca400f68ba08fab380445ca95d7c02...8f6dff372b174e772920de6d82bd085f1a74eaf2,9,93,55,148,31,2014-04-30 19:25:12,2014-04-30 19:25:12
8f6dff372b174e772920de6d82bd085f1a74eaf2...927245ccd8de111338d72d8f5e9172f33a991826,1,2,1,3,1,2014-04-30 22:01:35,2014-04-30 17:43:36
927245ccd8de111338d72d8f5e9172f33a991826...e049c88603b474ccc5dbe02a60760280b149ecd8,2,5,3,8,2,2014-04-30 22:11:52,2014-04-30 22:11:29
e049c88603b474ccc5dbe02a60760280b149ecd8...b0d032f9fc3627144fa355158675b6acacab1f23,1,16,8,24,4,2014-04-30 22:22:43,2014-04-30 22:22:43
b0d032f9fc3627144fa355158675b6acacab1f23...45c2d1f5d95dfbd6fcb306057e4c7338fb37a1bf,3,2,4,6,3,2014-04-30 22:33:46,2014-04-30 22:33:46
45c2d1f5d95dfbd6fcb306057e4c7338fb37a1bf...e2e4cdba1178ebcfd95c19eb063abd55b4afbcbb,3,11,2,13,4,2014-05-01 13:28:11,2014-05-01 09:55:52
e2e4cdba1178ebcfd95c19eb063abd55b4afbcbb...2ce51967638ac9f01c1c25bb33d51115ce99e0df,1,2,1,3,1,2014-05-01 16:20:47,2014-05-01 16:10:16
2ce51967638ac9f01c1c25bb33d51115ce99e0df...a0c4b8465db3a4b2df247912d79c5c0a752cee76,2,44,5,49,8,2014-05-02 03:08:19,2014-05-02 02:50:56
a0c4b8465db3a4b2df247912d79c5c0a752cee76...c8d257e81dd35ccb94f7f046537740d766137b59,1,1,1,2,1,2014-05-02 06:28:07,2014-05-01 17:28:07
c8d257e81dd35ccb94f7f046537740d766137b59...0dce44e16be2d4850120cd333380ab9171c5964a,1,3,4,7,3,2014-05-02 07:06:15,2014-05-02 07:06:15
0dce44e16be2d4850120cd333380ab9171c5964a...d1799233f46c39379fe429a4ece128d96b128006,6,35,10,45,13,2014-05-02 16:07:17,2014-05-01 07:03:24
d1799233f46c39379fe429a4ece128d96b128006...142c27218a0bb07bb197faab7b1d8eb3a084f5b9,3,21,5,26,5,2014-05-02 17:33:22,2014-05-02 17:31:22
142c27218a0bb07bb197faab7b1d8eb3a084f5b9...3818d96426b6368e375ee4d1ccbf14d0a2c35919,2,28,1,29,4,2014-05-03 00:46:47,2014-05-01 12:39:58
3818d96426b6368e375ee4d1ccbf14d0a2c35919...faa8c71fd9e97794e73f7e7564446846d72d8bb2,1,3,3,6,2,2014-05-03 21:44:40,2014-05-03 21:34:55
faa8c71fd9e97794e73f7e7564446846d72d8bb2...13ec89f267fe19739bc727428edeecb273f24a65,1,1,1,2,1,2014-05-03 23:18:26,2014-05-03 23:18:13
13ec89f267fe19739bc727428edeecb273f24a65...5e1f4656b98816c96a1cc051224c1b699db480e0,4,50,10,60,14,2014-05-05 10:02:11,2014-04-28 12:27:36
5e1f4656b98816c96a1cc051224c1b699db480e0...87776859affc45b9b485d8377c046dd464aaeef4,1,1,1,2,1,2014-05-05 10:41:01,2014-05-05 10:41:01
87776859affc45b9b485d8377c046dd464aaeef4...7131e14d00b9b293cec4608925f2be6f94474350,3,47,2,49,6,2014-05-05 11:36:15,2014-04-22 20:01:16
7131e14d00b9b293cec4608925f2be6f94474350...fb7c347f7bd360b567c0b30697a6a200be2d6778,2,9,1,10,4,2014-05-05 11:36:53,2014-05-05 11:36:53
fb7c347f7bd360b567c0b30697a6a200be2d6778...3b7c66a3ac0fcaa5dd02f87888c787d2c735c1a7,2,14,0,14,2,2014-05-05 12:28:07,2014-05-05 12:22:01
3b7c66a3ac0fcaa5dd02f87888c787d2c735c1a7...942556df2ffd3276dc127edd3cbb9d177095d882,3,34,16,50,12,2014-05-05 12:29:27,2014-05-04 14:29:49
942556df2ffd3276dc127edd3cbb9d177095d882...6923fdbbf1824d6e28cc1d283b48146c7f58c6ea,1,66,66,132,2,2014-05-05 17:34:46,2014-05-05 14:54:54
6923fdbbf1824d6e28cc1d283b48146c7f58c6ea...df60db0e7872796b4a48e62e9733f85c8ddf8306,2,5,4,9,3,2014-05-06 00:01:15,2014-05-03 17:02:07
df60db0e7872796b4a48e62e9733f85c8ddf8306...12474dacef3b85b1115f78aec905cc3079c68fb1,14,33,3,36,17,2014-05-06 07:13:07,2014-05-05 17:50:51
12474dacef3b85b1115f78aec905cc3079c68fb1...da9cf53cb536511a8abaade9f20e1dd8c4a02c7d,4,11,5,16,9,2014-05-06 07:13:07,2014-05-05 18:39:26
da9cf53cb536511a8abaade9f20e1dd8c4a02c7d...7951f125e77f67d70e58a31436eee46abdb8bf44,1,8,3,11,2,2014-05-06 18:37:52,2014-05-06 18:37:48
7951f125e77f67d70e58a31436eee46abdb8bf44...4492ea5475fd7c27c2cfda17c5f105940a3f06e7,1,1,0,1,1,2014-05-06 23:47:22,2014-05-06 23:47:22
4492ea5475fd7c27c2cfda17c5f105940a3f06e7...61da5f3f02f34810aaa6fcddac3808318a5b95c4,1,7,7,14,2,2014-05-07 05:14:15,2014-05-07 05:13:53
61da5f3f02f34810aaa6fcddac3808318a5b95c4...694441827714a3e08f0d02c4650dc3388a867baa,3,21,0,21,5,2014-05-07 05:23:23,2014-05-07 05:23:23
694441827714a3e08f0d02c4650dc3388a867baa...f9d7e18dc5fa324ed095c6aafd83a34f3086a3de,2,8,6,14,2,2014-05-07 05:41:59,2014-05-07 05:41:59
f9d7e18dc5fa324ed095c6aafd83a34f3086a3de...827d5dc189fba33ec69d8916be310ff1e76361b1,3,44,0,44,4,2014-05-07 06:06:41,2014-05-07 06:06:41
827d5dc189fba33ec69d8916be310ff1e76361b1...541310023d5c46b280dcc8092c43cd36785d2634,1,51,0,51,1,2014-05-07 12:21:54,2014-05-07 12:21:54
541310023d5c46b280dcc8092c43cd36785d2634...a2e3c9694823d6d451d6dd234e9d416600aacc68,3,11,6,17,4,2014-05-07 13:04:01,2014-05-07 13:01:37
1966054febbb96b713db27513617eabdbd70957b...7fd55c3481a004afb049e15ae3b8c93ce8bf0603,10,46,17,63,12,2014-07-04 18:15:00,2014-06-30 18:34:45
7fd55c3481a004afb049e15ae3b8c93ce8bf0603...1f8bb95cc2286a882e0f7a4692f77b285d811d11,2,6,6,12,2,2014-07-05 00:50:28,2014-07-05 00:45:26
1f8bb95cc2286a882e0f7a4692f77b285d811d11...9209049211acbe1a53c3dc409dd5fe26edf21634,2,19,2,21,3,2014-07-05 09:42:27,2014-07-05 09:40:08
9209049211acbe1a53c3dc409dd5fe26edf21634...dd9a23d5cfb44cb6f150610c267d0de1d963b849,2,68,48,116,8,2014-07-05 11:36:49,2014-07-04 11:53:01
dd9a23d5cfb44cb6f150610c267d0de1d963b849...80a12f21e30149529d831029f3cebc5728092aad,2,29,2,31,6,2014-07-05 23:33:03,2014-07-05 23:33:03
1966054febbb96b713db27513617eabdbd70957b...35c2c3704185dfdf6498ccf625872fa28bd7ece1,3,61,19,80,7,2014-07-04 17:34:20,2014-07-04 16:48:13
b041850853188428ac3b843001603db8f8a69392...0ac13eccebb3d879f79b31585b1e81f655067179,3,32,14,46,5,2014-02-08 14:01:59,2014-02-08 13:50:01
0ac13eccebb3d879f79b31585b1e81f655067179...a3e0d7753d8a3cec7efcc69b9af8160bdf17947b,1,43,0,43,1,2014-02-08 14:05:27,2014-02-08 14:05:27
b041850853188428ac3b843001603db8f8a69392...fcc21837dc691ba6465853c0b68927cb075a4591,1,1,1,2,1,2014-02-08 13:20:56,2014-02-08 13:20:39
fcc21837dc691ba6465853c0b68927cb075a4591...5d263dee304fdaf95e18d2f0619d6925984a7f02,31,154,94,248,77,2014-02-08 16:12:19,2014-01-20 20:15:14
5d263dee304fdaf95e18d2f0619d6925984a7f02...07ae47f7f8b5d5f80238ea3018163cad12917852,2,4,2,6,4,2014-02-08 20:01:55,2014-02-08 20:00:43
07ae47f7f8b5d5f80238ea3018163cad12917852...6fe26bd3ee75a6d804ca3861181ad61b1cca45ea,2,97,46,143,11,2014-02-08 20:52:06,2013-09-18 01:34:45
8a95b4fca793eeb8adceffe697b55214509019eb...bdf3473e64879d196e79fe8832cdacc6efb68150,3,77,11,88,7,2014-05-21 03:26:04,2014-05-18 20:43:13
bdf3473e64879d196e79fe8832cdacc6efb68150...870b0a1f8689aa8fd4806623262228b8ac3a88a5,2,22,23,45,13,2014-05-21 03:30:48,2014-05-19 04:14:55
870b0a1f8689aa8fd4806623262228b8ac3a88a5...27a3cfcd77d2b8b3e89ba29852523cf342351a43,1,0,1,1,1,2014-05-21 03:42:07,2014-05-21 03:42:07
27a3cfcd77d2b8b3e89ba29852523cf342351a43...dfeef8e1472eadf7c3d350f6ee7328352e5953f0,1,2,0,2,2,2014-05-21 10:54:24,2014-05-21 10:54:24
dfeef8e1472eadf7c3d350f6ee7328352e5953f0...bb0a9a070b9570c85bcb17346dae6513e4ba6e76,9,74,24,98,7,2014-05-21 11:35:47,2014-05-19 05:23:45
bb0a9a070b9570c85bcb17346dae6513e4ba6e76...64ee097b3b33716b10837644f9e18b87f25d606e,1,3,0,3,1,2014-05-21 15:11:01,2014-05-21 15:11:01
a2e3c9694823d6d451d6dd234e9d416600aacc68...fc974313b85da932a70f1f993b33207d78d31831,1,14,3,17,3,2014-05-07 20:05:11,2014-05-07 20:04:29
fc974313b85da932a70f1f993b33207d78d31831...e9a456d11b5b63389b466ed435ef3915f0e79e4c,3,42,2,44,6,2014-05-07 20:46:23,2014-05-07 20:46:23
e9a456d11b5b63389b466ed435ef3915f0e79e4c...5a917cfef319df33ca30a3b27bd0b0533b8e63bb,5,65,4,69,8,2014-05-07 21:28:34,2014-05-07 21:28:34
a2e3c9694823d6d451d6dd234e9d416600aacc68...8eb51a8cf62bbbea2bbc776ea00ba08332151d92,1,1,1,2,1,2014-05-07 19:16:43,2014-05-07 19:16:43
f751109cb240290cb946f8d4def0c7a5fb92569b...e0e8e1e3835fe75019380cfe59c4b0375465b4ce,1,1,1,2,2,2014-07-06 00:16:36,2014-07-05 14:01:31
e0e8e1e3835fe75019380cfe59c4b0375465b4ce...fff7b507ef2f85bb47abd2ee32982682d7822ac4,1,2,2,4,2,2014-07-06 00:18:52,2014-07-05 18:19:36
fff7b507ef2f85bb47abd2ee32982682d7822ac4...86c74eacd60b578645d81c3d822011ae27286a6f,1,2,2,4,1,2014-07-06 00:20:19,2014-07-06 00:20:19
86c74eacd60b578645d81c3d822011ae27286a6f...ab431fbd4f1b133d0ab9f18cb76fd2b8e9eecc19,1,5,5,10,1,2014-07-06 00:24:00,2014-07-06 00:24:00
ab431fbd4f1b133d0ab9f18cb76fd2b8e9eecc19...67f9f385aa36c0337d0e961d3a06e9d5f44d678e,5,9,9,18,6,2014-07-06 00:26:26,2014-07-05 18:28:30
67f9f385aa36c0337d0e961d3a06e9d5f44d678e...32fefc6f70c529ee5f13b2d82a26333fb7a4ed14,1,23,1,24,1,2014-07-06 07:30:18,2014-07-06 07:30:05
32fefc6f70c529ee5f13b2d82a26333fb7a4ed14...2572c07cc64177e985b453d0f0b819e85fe080cc,2,13,0,13,2,2014-07-06 07:56:18,2014-07-06 06:57:23
2572c07cc64177e985b453d0f0b819e85fe080cc...b144bfb5ce1e3e283c7fddac29a4653c6bc7fb3f,3,20,3,23,5,2014-07-06 19:19:27,2014-07-05 18:48:57
b144bfb5ce1e3e283c7fddac29a4653c6bc7fb3f...6d302f6396b7531eaa22dc5b544d233334e6fc92,3,56,12,68,11,2014-07-06 19:41:02,2014-07-05 12:43:12
6d302f6396b7531eaa22dc5b544d233334e6fc92...2c1384fbacfdea78b5acc3e652c7bd6422fea1ef,1,9,9,18,8,2014-07-06 22:31:10,2014-07-06 22:31:10
2c1384fbacfdea78b5acc3e652c7bd6422fea1ef...e6b3d6c22f5c638b08f653bada4d51b47174852c,1,3,0,3,1,2014-07-07 19:29:01,2014-07-07 19:29:01
e6b3d6c22f5c638b08f653bada4d51b47174852c...54546cee88f1db4e7e0ad75ebb9672c118b2236c,1,4,0,4,1,2014-07-07 22:04:00,2014-07-07 22:04:00
54546cee88f1db4e7e0ad75ebb9672c118b2236c...89b9e6e5d68297e7fe10baea6abcd96e24de0e09,11,169,169,338,169,2014-07-07 23:08:42,2014-07-07 23:08:42
89b9e6e5d68297e7fe10baea6abcd96e24de0e09...fddd95254e3ccd8c6836e56b8f5481a0a13568bd,2,3,2,5,2,2014-07-07 23:12:39,2014-07-07 23:12:39
fddd95254e3ccd8c6836e56b8f5481a0a13568bd...136a3ffe21988d49e443867d129cc01fb62b34cd,2,0,0,0,0,2014-07-07 23:21:47,2014-07-07 23:21:47
136a3ffe21988d49e443867d129cc01fb62b34cd...75ff7b8fb8335e181ad05e1d4244b4295cc7a105,6,63,31,94,16,2014-07-08 12:21:41,2014-07-03 18:30:17
75ff7b8fb8335e181ad05e1d4244b4295cc7a105...9f18b6bcb027f7689eefca4c32b17707b39930e7,1,0,7,7,2,2014-07-08 12:56:41,2014-07-08 12:56:41
9f18b6bcb027f7689eefca4c32b17707b39930e7...865bc7178364145f901c5ac5a5b8eb722cc0a646,1,21,0,21,1,2014-07-08 13:19:08,2014-07-08 09:24:08
865bc7178364145f901c5ac5a5b8eb722cc0a646...503e59c9b0cfd93a47dc1921452cece49055451b,1,1,1,2,1,2014-07-08 17:30:11,2014-07-08 17:29:59
503e59c9b0cfd93a47dc1921452cece49055451b...8780849da06f866720284d2c61d0aae5890e92ae,8,223,153,376,15,2014-07-09 00:05:49,2014-06-11 15:09:10
8780849da06f866720284d2c61d0aae5890e92ae...e167e96cfea670422ca75d0b35fe7c4195f25b63,7,20,14,34,15,2014-07-09 07:54:34,2014-06-26 14:55:36
e167e96cfea670422ca75d0b35fe7c4195f25b63...5ebf03b7dd2d1c215f5c0b725083d36379a7ac5b,1,13,3,16,3,2014-07-09 11:31:50,2014-07-09 11:31:50
5ebf03b7dd2d1c215f5c0b725083d36379a7ac5b...5e2c4a4bd1f86962842783e0b42ada7b9c14c247,3,51,2,53,4,2014-07-09 11:59:20,2014-07-08 19:58:14
5e2c4a4bd1f86962842783e0b42ada7b9c14c247...3a85aae2eacae836e2a92de77615569883b81932,1,0,7,7,1,2014-07-09 17:54:41,2014-07-09 17:54:41
3a85aae2eacae836e2a92de77615569883b81932...011abb7d96c75f6154c15a8a0f997d8c27698679,14,76,16,92,19,2014-07-09 20:01:09,2014-07-08 20:42:40
011abb7d96c75f6154c15a8a0f997d8c27698679...b7455b52a07feb6cee482ecef9c1797d9b16221f,1,2,2,4,1,2014-07-10 04:47:57,2014-07-10 02:24:19
b7455b52a07feb6cee482ecef9c1797d9b16221f...008bff92b7028673cdab872a6733770606efce83,4,75,7,82,10,2014-07-10 06:53:43,2014-07-10 06:53:16
008bff92b7028673cdab872a6733770606efce83...b02abd688a60e2dedf607e34d2cc97aca8d1c2b5,1,1,1,2,1,2014-07-10 06:57:35,2014-07-10 06:57:35
b02abd688a60e2dedf607e34d2cc97aca8d1c2b5...e1fa7dffdc1b141cb858160890d448ca778366e4,2,261,117,378,40,2014-07-10 10:03:04,2014-06-23 06:33:42
e1fa7dffdc1b141cb858160890d448ca778366e4...fef26e9a874dceeff5289e3f5bd06f22343c41e6,1,1,1,2,1,2014-07-10 10:09:08,2014-07-10 10:09:08
fef26e9a874dceeff5289e3f5bd06f22343c41e6...d88333661b687e178fcc6e47835a2d002ff5d17a,1,45,52,97,44,2014-07-10 11:17:53,2014-07-10 11:17:53
d88333661b687e178fcc6e47835a2d002ff5d17a...849538d03df21b69f0754a38ee4ec5f48fa02c52,4,18,38,56,11,2014-07-10 13:36:43,2014-04-06 15:30:46
849538d03df21b69f0754a38ee4ec5f48fa02c52...9e5a37c82d35a706e30265ecc8ea699a9f09d1d5,1,1,1,2,1,2014-07-10 17:00:31,2014-07-10 17:00:02
9e5a37c82d35a706e30265ecc8ea699a9f09d1d5...ceb2aaf1d427ac592a9f2bb969454af3d0f729d1,2,8,0,8,2,2014-07-10 17:00:31,2014-07-10 17:00:09
ceb2aaf1d427ac592a9f2bb969454af3d0f729d1...d5e1a2d5eb269df40979cda3eff3ed92c6d06d9c,1,21,0,21,1,2014-07-10 17:06:42,2014-07-10 17:06:42
d5e1a2d5eb269df40979cda3eff3ed92c6d06d9c...4e4c10bc6155d4a0eab117ad4c8afdf53853f5e0,1,0,87,87,1,2014-07-10 21:30:39,2014-07-10 21:30:39
4e4c10bc6155d4a0eab117ad4c8afdf53853f5e0...ebb13bbd884d8c3053d1d342ef0423240feb05e6,2,19,1,20,4,2014-07-12 02:00:39,2014-07-12 01:59:21
ebb13bbd884d8c3053d1d342ef0423240feb05e6...6732566967888f2c12efee1146940c85c0154e60,4,14,12,26,7,2014-07-12 05:43:26,2014-07-12 05:43:17
6732566967888f2c12efee1146940c85c0154e60...b48c2c59253b2f2bedea40ed890f0be6ccad9f46,1,0,1,1,1,2014-07-12 14:16:53,2014-07-12 14:16:53
b48c2c59253b2f2bedea40ed890f0be6ccad9f46...a764a9ccff6e2a2cf048e658dd824bf302c74df7,3,48,28,76,25,2014-07-12 16:49:37,2014-07-12 13:33:21
a764a9ccff6e2a2cf048e658dd824bf302c74df7...22b2fb0ba1d130c0ff0e1658ee9c2224a619a4a7,2,24,5,29,5,2014-07-12 16:49:43,2014-07-07 07:54:58
22b2fb0ba1d130c0ff0e1658ee9c2224a619a4a7...037f81fedcbe860bacea01fa6415849e0e379c15,1,1,0,1,1,2014-07-13 15:35:25,2014-07-13 15:35:25
037f81fedcbe860bacea01fa6415849e0e379c15...dd6ef3197a4d10696c5ef4ddb55b0d4baaba4340,3,31,40,71,14,2014-07-13 17:37:56,2014-07-13 17:37:56
dd6ef3197a4d10696c5ef4ddb55b0d4baaba4340...7affb4ad58e7ee93e4cca0c350315c63035ed648,1,6,2,8,1,2014-07-14 11:46:19,2014-07-14 11:46:19
7affb4ad58e7ee93e4cca0c350315c63035ed648...38e001ab6caa8e5da68dbefd17322adcd2603c21,11,150,122,272,17,2014-07-14 12:45:19,2014-07-12 13:50:27
38e001ab6caa8e5da68dbefd17322adcd2603c21...9cd5201abd24ba2632753029ee1957947cdc32f5,4,35,8,43,9,2014-07-14 14:50:41,2014-07-14 11:23:34
9cd5201abd24ba2632753029ee1957947cdc32f5...efe87d3e48df9b7470a3006eeb7322f12b368fdf,1,4,0,4,1,2014-07-14 14:50:41,2014-07-14 12:02:00
efe87d3e48df9b7470a3006eeb7322f12b368fdf...f7a78f9bba4efd0231aec0326a73fdbd004d1faa,8,131,0,131,6,2014-07-14 15:00:49,2014-06-19 19:24:59
f7a78f9bba4efd0231aec0326a73fdbd004d1faa...dd9b3312d0a931daf21c10279cef204f04648ef9,4,5,6,11,4,2014-07-14 16:23:57,2014-07-14 16:23:57
dd9b3312d0a931daf21c10279cef204f04648ef9...5dcdbe95c749d36072f527e120a8cb463199ae0d,4,58,14,72,14,2014-07-14 18:50:03,2014-07-11 19:01:37
5dcdbe95c749d36072f527e120a8cb463199ae0d...4e424084e6d796f7ed5f215330cd0b98287c1300,2,11,6,17,6,2014-07-15 07:57:54,2014-07-14 19:40:55
4e424084e6d796f7ed5f215330cd0b98287c1300...671e0c937c112b1908048b4d8deb14c0116b8946,1,4,5,9,1,2014-07-15 10:59:16,2014-07-15 07:25:23
671e0c937c112b1908048b4d8deb14c0116b8946...9a2ab629776735fae2c9184dc4b9d9029bad15b2,2,3,3,6,3,2014-07-15 12:48:29,2014-07-15 12:48:29
9a2ab629776735fae2c9184dc4b9d9029bad15b2...b65a2001e7be3811903fc8769fa4d3df3d324f18,2,9,1,10,2,2014-07-15 18:41:26,2014-07-15 11:13:23
b65a2001e7be3811903fc8769fa4d3df3d324f18...015496539247b24c73b163f279ae8c8d3ccefc4c,3,10,4,14,5,2014-07-15 19:20:59,2014-07-14 12:16:35
015496539247b24c73b163f279ae8c8d3ccefc4c...28efafa24c8304f2553a0d00f90ed05e7e66318c,2,28,13,41,11,2014-07-16 07:38:57,2014-07-15 09:10:50
28efafa24c8304f2553a0d00f90ed05e7e66318c...6e2b82fdf65c63c4a32620b7577f492579ecd91e,3,41,4,45,6,2014-07-16 09:28:00,2014-07-14 16:42:14
6e2b82fdf65c63c4a32620b7577f492579ecd91e...f8df55050cf89a6d6073ecac6db4354e3f178d9b,1,1,1,2,1,2014-07-16 09:48:49,2014-07-16 09:48:49
f8df55050cf89a6d6073ecac6db4354e3f178d9b...c5d8e4a0d167b593bcda290f5a3538e0e55aae1d,2,0,0,0,0,2014-07-16 11:50:53,2014-07-16 11:50:32
c5d8e4a0d167b593bcda290f5a3538e0e55aae1d...5954aa6db084b9e81960f095d2145c876fdbece4,1,8,0,8,1,2014-07-16 14:52:49,2014-07-16 14:52:49
5954aa6db084b9e81960f095d2145c876fdbece4...7d0519c725f25cb0b52e42c60f2505e21d2ab4b3,1,3,1,4,1,2014-07-16 16:34:27,2014-07-16 16:32:57
7d0519c725f25cb0b52e42c60f2505e21d2ab4b3...145d231782172301e25521d12efc54c52258bc92,2,19,2,21,4,2014-07-16 16:59:08,2014-07-16 16:59:08
145d231782172301e25521d12efc54c52258bc92...d9f78d5344c26b3da7461e19b6f59806dc9d70cd,1,1,1,2,1,2014-07-16 17:23:11,2014-07-16 16:08:24
d9f78d5344c26b3da7461e19b6f59806dc9d70cd...c62c480b2bfd8e1e73223e27db75788f0e9b28ec,1,8,0,8,1,2014-07-16 17:34:53,2014-07-16 17:34:53
c62c480b2bfd8e1e73223e27db75788f0e9b28ec...e7827b94940860d6af737b5ea0105b6460cba53c,1,114,114,228,2,2014-07-16 17:54:13,2014-07-11 18:27:14
e7827b94940860d6af737b5ea0105b6460cba53c...b8d255071ead897cf68120cd2fae7c91326ca2cc,1,2,1,3,1,2014-07-16 18:21:27,2014-07-15 16:43:52
b8d255071ead897cf68120cd2fae7c91326ca2cc...70c54a3694975c43a2e0e22c4a90c3cbe1eb54e4,5,40,5,45,9,2014-07-18 16:10:59,2014-07-14 20:42:05
70c54a3694975c43a2e0e22c4a90c3cbe1eb54e4...5875b8d13333bf709b54f91a143304826d57f2fd,1,10,0,10,1,2014-07-21 09:04:36,2014-07-21 09:03:51
5875b8d13333bf709b54f91a143304826d57f2fd...2984b30ce84eccedfcc5b5241d12720913d0b80a,2,8,1,9,2,2014-07-21 09:09:31,2014-07-21 09:09:31
2984b30ce84eccedfcc5b5241d12720913d0b80a...dcb4ed517082d13ccf7da9bd5d16c77bcecbf139,2,22,0,22,2,2014-07-21 09:14:00,2014-07-21 09:14:00
dcb4ed517082d13ccf7da9bd5d16c77bcecbf139...7dacc6ae4657ecc18bd92a94b50950871f914168,3,41,14,55,12,2014-07-21 09:50:21,2014-07-21 09:50:21
7dacc6ae4657ecc18bd92a94b50950871f914168...e24e9e0438cf3ba6c557558f68587d135a85e126,4,46,5,51,13,2014-07-21 10:36:34,2014-07-21 10:36:34
e24e9e0438cf3ba6c557558f68587d135a85e126...3f1412ff7bbfd7b1a15b7ed8c574ee8ba5aa6309,2,4,3,7,3,2014-07-21 17:05:19,2014-07-21 17:02:25
3f1412ff7bbfd7b1a15b7ed8c574ee8ba5aa6309...8fbf13a6c85d68b996bc09cb6e8c969e5e32005b,6,11,11,22,9,2014-07-21 19:49:12,2014-07-21 17:55:37
8fbf13a6c85d68b996bc09cb6e8c969e5e32005b...b4cf7e3d1de2d9700812872b04f6fe8eb88e8bff,1,1,1,2,1,2014-07-21 20:03:45,2014-07-21 17:28:49
6fe26bd3ee75a6d804ca3861181ad61b1cca45ea...f43e895b15df4d5852b79049729d598baa86c186,1,2,16,18,3,2014-02-08 23:01:16,2014-02-08 23:01:16
b57ee15b12aacf70ccd13ad301f7ebb51d19439f...5ea34f3f86af307e1a1c02b49136f51a4f63da88,1,2,2,4,2,2014-05-08 02:12:58,2014-05-08 02:12:58
5ea34f3f86af307e1a1c02b49136f51a4f63da88...b25aee3b7bef07dd07bed2209efcdf1a8146112c,4,49,3,52,7,2014-05-08 17:34:24,2014-05-08 17:33:59
b25aee3b7bef07dd07bed2209efcdf1a8146112c...fc32e9c0d92c51cedf7d686ce84ec52ed0d12a86,1,2,3,5,2,2014-05-08 17:39:43,2014-05-08 17:39:09
fc32e9c0d92c51cedf7d686ce84ec52ed0d12a86...b1432bfc22bf0cac25c4b0c8d52456cb8b5804e8,4,10,6,16,10,2014-05-08 19:49:54,2014-05-08 19:49:54
b1432bfc22bf0cac25c4b0c8d52456cb8b5804e8...d667263169f624c30d9aabcc6f250e4540ca6671,1,147,200,347,19,2014-05-08 19:50:21,2014-05-07 19:40:02
d667263169f624c30d9aabcc6f250e4540ca6671...43a80f4812a762c2ea96b3de45662ace04404287,1,2,5,7,5,2014-05-08 19:50:21,2014-05-07 19:49:45
43a80f4812a762c2ea96b3de45662ace04404287...c70a61eb49e4ed8f3b2a5011a7a5e6cda43c8598,7,17,16,33,15,2014-05-08 20:11:15,2014-05-07 19:50:09
c70a61eb49e4ed8f3b2a5011a7a5e6cda43c8598...cff59bedc23fd4d53557f677ddc42402b56963d0,6,12,6,18,7,2014-05-08 20:11:20,2014-05-07 20:03:10
cff59bedc23fd4d53557f677ddc42402b56963d0...99d9fa329a9da87933ac9eff6c5f9c7514bc9f9a,7,88,44,132,34,2014-05-08 20:11:20,2014-05-07 20:14:39
99d9fa329a9da87933ac9eff6c5f9c7514bc9f9a...7fe60ae64ad712430bce26af7812ed4452a91af0,2,38,1,39,2,2014-05-09 02:51:15,2014-05-06 20:57:37
7fe60ae64ad712430bce26af7812ed4452a91af0...5182efce8d73ec552a1d7f3e86a24369bb261044,2,5,13,18,5,2014-05-09 04:34:30,2014-05-09 04:33:24
5182efce8d73ec552a1d7f3e86a24369bb261044...5400b29ebfdcd8fb657bf42ddd6f81764b99f63a,1,4,1,5,1,2014-05-09 04:38:56,2014-05-09 04:38:56
5400b29ebfdcd8fb657bf42ddd6f81764b99f63a...fdbd29dd27d617f7275a1a106a2934c7f8df04c7,3,53,0,53,2,2014-05-09 04:48:10,2014-05-09 04:48:10
fdbd29dd27d617f7275a1a106a2934c7f8df04c7...66880e4cd128ea81ae53ac6f292f00c563521009,2,11,8,19,5,2014-05-09 16:35:07,2014-05-09 10:23:28
66880e4cd128ea81ae53ac6f292f00c563521009...35e1b1efab262ed78b3b8916ec01eb897872fe60,1,128,128,256,98,2014-05-09 17:34:53,2014-05-09 17:34:53
35e1b1efab262ed78b3b8916ec01eb897872fe60...a5de0df58b5431b25a3246a57432db73843be87f,4,35,3,38,8,2014-05-10 08:56:39,2014-05-07 01:14:06
a5de0df58b5431b25a3246a57432db73843be87f...fb90b7cda2f57c6b58778476d654473854317361,6,11,10,21,11,2014-05-10 12:40:42,2014-05-10 12:40:42
fb90b7cda2f57c6b58778476d654473854317361...f574220f0988f3aa1aca4f133887fbde0e5a6f10,2,13,0,13,2,2014-05-10 14:39:20,2014-05-10 14:39:20
f574220f0988f3aa1aca4f133887fbde0e5a6f10...edecbb551bf8e8d0915c6c563ce9f880c59f8d95,1,1,5,6,2,2014-05-10 14:41:54,2014-05-10 14:41:54
edecbb551bf8e8d0915c6c563ce9f880c59f8d95...4cf82e5bcf87e0d5419d941c2ef7ec8855801319,2,9,5,14,5,2014-05-10 16:09:07,2014-05-10 16:06:25
4cf82e5bcf87e0d5419d941c2ef7ec8855801319...38036e16c8fc7a1f7438f86dca12d667d7b300f1,2,8,8,16,7,2014-05-11 02:13:50,2014-05-11 02:13:50
38036e16c8fc7a1f7438f86dca12d667d7b300f1...63df886df728c35d3b12da6a03062b46d84d8978,1,1,0,1,1,2014-05-11 02:28:15,2014-05-11 02:27:09
63df886df728c35d3b12da6a03062b46d84d8978...a75324c6544d728d3bd8f678b1b8021fdff18332,3,227,6,233,7,2014-05-11 22:50:01,2013-08-21 00:21:21
a75324c6544d728d3bd8f678b1b8021fdff18332...9762ba26304dd927d69fc5446df2e83dc22aa2e3,1,3,3,6,2,2014-05-11 23:39:00,2014-05-11 23:39:00
9762ba26304dd927d69fc5446df2e83dc22aa2e3...393c0e24223c701edeb8ce7dc9d0f852f0c081ad,6,69,28,97,10,2014-05-12 00:42:26,2013-08-19 05:36:36
393c0e24223c701edeb8ce7dc9d0f852f0c081ad...c1b412ebd62c124bd3752815b1c784e12ea07347,1,8,8,16,8,2014-05-12 02:09:12,2014-05-12 02:09:12
c1b412ebd62c124bd3752815b1c784e12ea07347...a9b7f31bfc0e40e0447a22bc4725e449c354f02b,3,1,12,13,3,2014-05-12 02:15:59,2014-05-12 02:15:59
a9b7f31bfc0e40e0447a22bc4725e449c354f02b...986bd41f8a6e7a667380c59d347edbdf61b7fd02,1,1,0,1,1,2014-05-12 10:59:23,2014-05-12 10:59:23
986bd41f8a6e7a667380c59d347edbdf61b7fd02...5971630de910b3e6f8210c5d28541b6c4af78f04,1,4,6,10,2,2014-05-12 11:09:53,2014-05-12 11:09:53
5971630de910b3e6f8210c5d28541b6c4af78f04...13087020a92afe778970f8445b8add6b167ba084,1,4,0,4,1,2014-05-12 16:44:21,2014-05-12 16:43:50
13087020a92afe778970f8445b8add6b167ba084...a1be7237ca108eb2d5d669e4306e93afcc79c6cb,1,1,1,2,1,2014-05-12 22:56:34,2014-05-12 22:56:34
a1be7237ca108eb2d5d669e4306e93afcc79c6cb...c501662f3c3f03876effcf3ede94922c0cec43bd,1,2,2,4,2,2014-05-13 11:04:49,2014-05-13 11:04:49
c501662f3c3f03876effcf3ede94922c0cec43bd...57296b41624c37206d89275882eb71eca5157214,2,2,8,10,2,2014-05-13 11:24:28,2014-05-13 11:24:28
57296b41624c37206d89275882eb71eca5157214...f2a8e47cfd75f6135634a833f0a6a621909b4c3a,1,1,1,2,1,2014-05-13 11:27:33,2014-05-13 04:18:01
f2a8e47cfd75f6135634a833f0a6a621909b4c3a...5eb81ce44532596ecc1c781d93f3421a467a6206,6,58,14,72,14,2014-05-13 13:09:33,2014-04-29 08:07:57
5eb81ce44532596ecc1c781d93f3421a467a6206...1165e9992ee83a7706a6cc2f6fd3e2e31cacc97c,2,2,1,3,2,2014-05-13 13:17:04,2014-05-13 13:17:04
1165e9992ee83a7706a6cc2f6fd3e2e31cacc97c...a06808d370ab2216562720efde1fd3e4f85486ad,2,3,4,7,2,2014-05-14 00:54:32,2014-05-14 00:52:38
a06808d370ab2216562720efde1fd3e4f85486ad...3800f63721f6fc1c940abfb10fe21257dcf13521,4,2,106,108,6,2014-05-14 08:19:48,2014-05-12 11:28:07
3800f63721f6fc1c940abfb10fe21257dcf13521...255449c1ee61c14778658caae8c430fa4d76afd6,3,50,4,54,9,2014-05-14 08:19:48,2014-05-12 11:38:39
255449c1ee61c14778658caae8c430fa4d76afd6...d4069a0a0dcddf18d44d2c86227cb08adada0c6b,4,137,2,139,6,2014-05-14 16:59:15,2014-05-14 16:07:32
b4cf7e3d1de2d9700812872b04f6fe8eb88e8bff...a2d0831e4242b97e0378414c4379ad8d3030ed6e,1,1,0,1,1,2014-07-22 08:45:50,2014-07-21 23:05:14
a2d0831e4242b97e0378414c4379ad8d3030ed6e...06ba4b9eee7f60feda6dbbe753604d5bb029f06a,1,1,1,2,1,2014-07-22 17:27:27,2014-07-22 05:47:57
06ba4b9eee7f60feda6dbbe753604d5bb029f06a...731f313d604a6cc141f36d8a1ba9a75790c70154,1,3,0,3,1,2014-07-22 18:00:22,2014-07-21 22:37:45
731f313d604a6cc141f36d8a1ba9a75790c70154...19d8f2ebf4299b814eb8df472056a0f65fc7b5d7,1,4,1,5,1,2014-07-23 10:10:23,2014-07-16 08:50:35
19d8f2ebf4299b814eb8df472056a0f65fc7b5d7...8c30df15f17c180fbfb3e378c5469c63cde6599b,5,63,18,81,15,2014-07-23 10:10:23,2014-07-16 09:06:33
8c30df15f17c180fbfb3e378c5469c63cde6599b...fa3cf006b2912708e8c0b294cea91933cf35781f,3,40,1,41,6,2014-07-23 12:45:09,2014-07-23 03:01:55
fa3cf006b2912708e8c0b294cea91933cf35781f...faacc54ac8601e8bdbfdc8651d68267d570a9c4b,1,1,1,2,1,2014-07-23 14:16:51,2014-07-23 14:10:42
faacc54ac8601e8bdbfdc8651d68267d570a9c4b...8568e7cfa4fb87cd0a9ead1b3fbb7a39d19e98b9,1,10,0,10,1,2014-07-23 19:23:36,2014-07-23 19:23:36
8568e7cfa4fb87cd0a9ead1b3fbb7a39d19e98b9...9b1515906eb28819465276bfa55c6b42c858797d,2,12,12,24,12,2014-07-24 12:25:15,2014-07-24 12:25:15
9b1515906eb28819465276bfa55c6b42c858797d...936fba5878075576570ab7d2c84bfba80d183c18,1,7,10,17,5,2014-07-24 12:46:29,2014-07-24 12:46:29
936fba5878075576570ab7d2c84bfba80d183c18...577ced2aae2136ed4e9dd9a75b2277373e2fa4a4,1,5,1,6,3,2014-07-24 12:51:47,2014-07-24 12:51:47
577ced2aae2136ed4e9dd9a75b2277373e2fa4a4...66211b4b75a93c15f4914e698cf58d48b73a2fe0,1,7,1,8,2,2014-07-24 13:24:52,2014-07-24 13:24:52
66211b4b75a93c15f4914e698cf58d48b73a2fe0...e01fa71142da45e8505b17b5574c9ec6a9d82914,1,4,3,7,3,2014-07-24 13:39:20,2014-07-23 21:31:31
e01fa71142da45e8505b17b5574c9ec6a9d82914...99cd80dc744226f44c492c3580276800eea23c0d,1,5,0,5,1,2014-07-24 15:27:26,2014-07-24 15:27:26
99cd80dc744226f44c492c3580276800eea23c0d...5f919b9c81a26832f98033335a601ec1ca718db7,1,2,3,5,1,2014-07-24 17:57:00,2014-07-24 17:57:00
5f919b9c81a26832f98033335a601ec1ca718db7...b1abfb3c59467d0bb088e19be76fc42fcb570835,2,8,0,8,2,2014-07-24 18:22:19,2014-07-13 08:58:36
b1abfb3c59467d0bb088e19be76fc42fcb570835...64e75c47ef8dd3c61b85798c7bb34e48c52ccc96,2,20,10,30,8,2014-07-24 18:27:10,2014-07-24 17:36:15
64e75c47ef8dd3c61b85798c7bb34e48c52ccc96...b157ffdbb97576a60995e719575ee733bba17508,2,16,0,16,5,2014-07-24 20:33:51,2014-07-24 20:24:01
b157ffdbb97576a60995e719575ee733bba17508...bb395a15ba16cc3ae223265afb69ec95f0f78855,1,4,0,4,1,2014-07-24 23:55:57,2014-07-24 23:55:57
bb395a15ba16cc3ae223265afb69ec95f0f78855...6508db2ff9fc5be95fec903b3fa7ab8204fe316a,2,8,1,9,2,2014-07-25 08:04:58,2014-07-25 08:04:58
6508db2ff9fc5be95fec903b3fa7ab8204fe316a...aa8bc7fa7d9298aad1b3e65996ab34af63903369,1,9,10,19,2,2014-07-25 10:22:02,2014-07-25 00:24:52
aa8bc7fa7d9298aad1b3e65996ab34af63903369...f9b7a0383c6f0fbadb83306db667675d9f9dd2b4,1,8,8,16,1,2014-07-25 10:24:00,2014-07-25 08:42:06
b4cf7e3d1de2d9700812872b04f6fe8eb88e8bff...3582698c138a7a311d12a57d0b35359815e8dbc9,9,9,65,74,10,2014-07-21 23:03:02,2014-07-14 19:09:33
d4069a0a0dcddf18d44d2c86227cb08adada0c6b...8a2f04db914a66c4bfca7fc2f9a523c14dbbf3eb,1,1,1,2,1,2014-05-14 19:00:57,2014-05-14 19:00:57
ed4812692e3a103444303b0a3dd1429bbdf9511c...f44dbf74a4abf9c45d49568c7ca46363ff6e5112,3,13,4,17,5,2014-07-25 16:09:15,2014-07-25 16:09:15
f44dbf74a4abf9c45d49568c7ca46363ff6e5112...a64bc3df77e074ddb7aa5c42eb2a84c26917a3b7,2,25,2,27,6,2014-07-25 16:35:38,2014-07-25 16:35:25
a64bc3df77e074ddb7aa5c42eb2a84c26917a3b7...6f386b0acb9edae1ff1bde00ed76e4448b608d91,1,1,1,2,1,2014-07-25 16:43:54,2014-07-25 16:43:54
6f386b0acb9edae1ff1bde00ed76e4448b608d91...08681d7757152d805533296d69ad9b8e2c129b1c,1,6,1,7,1,2014-07-25 16:49:51,2014-07-25 16:49:51
08681d7757152d805533296d69ad9b8e2c129b1c...b8cb5ba7081388ef38eccdf8e826747ad3a67e66,2,14,0,14,5,2014-07-25 17:23:52,2014-07-25 13:32:14
b8cb5ba7081388ef38eccdf8e826747ad3a67e66...57d2b3f2a7e5a7fafb99efc9d93e67bc98feea1b,1,1,1,2,1,2014-07-25 19:16:47,2014-07-25 19:11:34
57d2b3f2a7e5a7fafb99efc9d93e67bc98feea1b...e1c85167a3de7adf51105d5f0751b39fa0d49ba7,6,8,8,16,8,2014-07-26 09:20:24,2014-07-26 01:34:13
b90c112cb1c3d6f80a748c784a191741f4ea3948...5ab95168cc719a59b64eb3923e9641d8b5f619e1,1,1,1,2,1,2014-05-14 22:34:59,2014-05-14 22:34:59
e1c85167a3de7adf51105d5f0751b39fa0d49ba7...6eed751162f10a3e93f4fa7c1eed2c43b70bb0ca,2,6,2,8,3,2014-07-26 11:55:20,2014-07-26 10:06:19
e1c85167a3de7adf51105d5f0751b39fa0d49ba7...e569144910e336d2f76a3a31998ec672377d31cc,1,15,0,15,1,2014-07-26 10:01:44,2014-07-26 10:01:44
e569144910e336d2f76a3a31998ec672377d31cc...d0889863de50d65659f56f0b9ea0672a8b6482a1,2,31,2,33,4,2014-07-26 10:35:51,2014-07-26 10:06:48
597ab3ce98e1d73975901da0ee3cdcccd825eeb4...860d31ac7a3bdd4b27db8b34b110b3d801ddaf8a,3,24,23,47,25,2014-05-15 11:16:25,2014-05-15 11:11:29
860d31ac7a3bdd4b27db8b34b110b3d801ddaf8a...4ef10f245ada0c7d5ae8dc31eebffa63790d40fb,15,229,61,290,41,2014-05-15 11:25:35,2014-03-05 20:19:40
4ef10f245ada0c7d5ae8dc31eebffa63790d40fb...27aa85246a218b0999c7c9d227eed2afb08ed510,1,7,1,8,2,2014-05-15 11:55:36,2014-05-12 20:52:49
27aa85246a218b0999c7c9d227eed2afb08ed510...e520a73eeea6b185b719901ab9985ecef00e5664,44,45,45,90,46,2014-05-15 17:58:41,2014-05-15 17:41:55
63058786882f6a32649a0fdafae9cb425c95cd4e...08b85de9b7a8940702dba9348b642538da888c6c,1,8,0,8,1,2014-07-26 13:39:29,2014-07-26 11:36:40
08b85de9b7a8940702dba9348b642538da888c6c...5a311d2ccc48cb3a89858c92e449ffbfd9cbfb00,2,5,1,6,2,2014-07-26 13:50:05,2014-07-26 08:40:40
5a311d2ccc48cb3a89858c92e449ffbfd9cbfb00...5cdb8f8c1ea7161ca9e3b702ec7cdd7e3cd0999a,4,34,8,42,17,2014-07-26 14:03:00,2014-07-24 18:01:12
5cdb8f8c1ea7161ca9e3b702ec7cdd7e3cd0999a...6d5daa30cf29d0bada0586213ecb2959152566b4,1,5,0,5,1,2014-07-26 14:27:02,2014-07-26 14:00:48
6d5daa30cf29d0bada0586213ecb2959152566b4...90faa196f67863370a4682ecfd053e189cd46705,2,5,5,10,4,2014-07-26 14:38:46,2014-07-26 11:06:49
90faa196f67863370a4682ecfd053e189cd46705...08451f17d08486055542daecdcc3be1779f0815b,2,11,1,12,3,2014-07-26 16:03:19,2014-07-21 17:38:34
08451f17d08486055542daecdcc3be1779f0815b...805774df1f2ec9552f1d9c826f5ca9276684da11,2,33,1,34,6,2014-07-26 16:22:19,2014-07-26 16:21:53
805774df1f2ec9552f1d9c826f5ca9276684da11...e1347e9253821a31f9896de9eb993e2376e7398f,2,8,0,8,2,2014-07-26 17:00:02,2014-07-26 16:48:36
e1347e9253821a31f9896de9eb993e2376e7398f...f14898a45308c3a46e9a742f7f7ee7869364e95b,1,3,3,6,1,2014-07-27 00:38:49,2014-07-26 18:51:29
f14898a45308c3a46e9a742f7f7ee7869364e95b...11181a64f947236402903deb6fa8c4df7b8bff75,10,49,79,128,7,2014-07-27 01:05:49,2014-07-26 01:23:01
11181a64f947236402903deb6fa8c4df7b8bff75...2ab0ed7b2842fbb8bf36ee7df9949d10546d953d,1,1,1,2,1,2014-07-27 11:23:16,2014-07-27 11:23:16
2ab0ed7b2842fbb8bf36ee7df9949d10546d953d...2f73b527dda6683868fac2791f7f07ccb01ea0d9,2,13,4,17,2,2014-07-27 11:31:25,2014-07-25 17:20:00
2f73b527dda6683868fac2791f7f07ccb01ea0d9...fe87f8d6707e13fb9416d8e4c1ebc01817d53755,1,9,2,11,1,2014-07-27 11:48:59,2014-07-27 11:48:59
fe87f8d6707e13fb9416d8e4c1ebc01817d53755...c83583fb349cdbc4a7c31c1cc4cafcb02712e964,1,0,5,5,1,2014-07-27 11:49:53,2014-07-27 11:49:53
c83583fb349cdbc4a7c31c1cc4cafcb02712e964...53a61d82b38b7c39fa8ec4bd3047014694e96f60,1,4,0,4,1,2014-07-27 13:48:21,2014-07-27 13:48:21
53a61d82b38b7c39fa8ec4bd3047014694e96f60...729e4ae4f0730585ac4640e7fa3aa06374677ff2,6,35,0,35,7,2014-07-28 12:30:41,2014-07-28 12:30:41
729e4ae4f0730585ac4640e7fa3aa06374677ff2...80708ac77204c491f86c6a8215aaba8cf0989154,2,13,3,16,3,2014-07-28 14:01:07,2014-07-27 22:59:20
80708ac77204c491f86c6a8215aaba8cf0989154...0af593dbe5cae53543456fefb9ec9e2c8cc0146a,2,12,0,12,2,2014-07-28 14:05:41,2014-07-28 14:05:41
0af593dbe5cae53543456fefb9ec9e2c8cc0146a...668d432d0a25ef68e101f2c6492dc4d75da931bd,2,21,7,28,5,2014-07-28 14:57:12,2014-07-27 08:12:39
668d432d0a25ef68e101f2c6492dc4d75da931bd...cb60d22bd94738174440f8d60a04c3d9c38636c9,2,39,3,42,5,2014-07-28 17:32:43,2014-07-28 17:32:43
cb60d22bd94738174440f8d60a04c3d9c38636c9...d6e73a876d77e889efe839345d39690a7004e2f4,4,45,18,63,11,2014-07-28 17:47:28,2014-07-28 17:47:28
d6e73a876d77e889efe839345d39690a7004e2f4...62c74abbb06a081708c2cb5cc459f39beb26acaa,1,8,6,14,2,2014-07-29 08:56:24,2014-07-29 08:54:11
62c74abbb06a081708c2cb5cc459f39beb26acaa...e5619330e2d3bf901155e98ef3fa7d224b6a260a,1,3,2,5,2,2014-07-29 09:06:32,2014-07-29 09:06:32
e5619330e2d3bf901155e98ef3fa7d224b6a260a...ef9f109013adc6e140c1a71d874aa88e893657b7,5,102,1,103,6,2014-07-29 09:37:11,2014-07-15 11:30:34
ef9f109013adc6e140c1a71d874aa88e893657b7...b012122d303050542a3e227e6673d278c82d5cea,1,34,16,50,9,2014-07-29 13:08:49,2014-07-29 13:08:49
b012122d303050542a3e227e6673d278c82d5cea...e46801f13d63b3ec28381ee8a9b5b62320136a67,1,17,39,56,8,2014-07-29 13:23:03,2014-07-29 13:23:03
e46801f13d63b3ec28381ee8a9b5b62320136a67...f294f93a1729bb87bedb8d79fdecf4197d0f9e5b,1,4,0,4,1,2014-07-29 13:39:51,2014-07-29 13:39:19
f294f93a1729bb87bedb8d79fdecf4197d0f9e5b...5ed3834cbefcf399dbdd0e7f26a033aba65e7a54,1,2,0,2,1,2014-07-29 16:20:03,2014-07-29 16:19:25
5ed3834cbefcf399dbdd0e7f26a033aba65e7a54...44185591385ac278b66e2007208c8656f323f9b6,1,4,2,6,2,2014-07-29 16:24:07,2014-07-29 16:24:07
44185591385ac278b66e2007208c8656f323f9b6...b9daa4f0e12908c9f0736e2784913da3974d07b0,1,1,1,2,1,2014-07-29 16:27:35,2014-07-29 16:12:35
b9daa4f0e12908c9f0736e2784913da3974d07b0...a338e0773592ce4030407428c77815a713b6c9c7,2,26,35,61,12,2014-07-29 16:38:51,2014-07-29 16:38:08
a338e0773592ce4030407428c77815a713b6c9c7...8ebd6d35d77c1c535a9ffe8151445ad853845b61,2,19,0,19,2,2014-07-29 17:02:59,2014-07-29 17:02:59
8ebd6d35d77c1c535a9ffe8151445ad853845b61...b9a9b052e8b4a47504abc0f14be3087aaa700e47,1,17,1,18,2,2014-07-29 17:10:31,2014-07-29 17:10:31
b9a9b052e8b4a47504abc0f14be3087aaa700e47...096a5de5d2bf564f859eca115874f5643ef31658,2,28,3,31,8,2014-07-29 17:22:00,2014-07-29 17:22:00
096a5de5d2bf564f859eca115874f5643ef31658...17e75d03f92cff7d1d5d4679a8a09b13e08f3264,2,9,5,14,4,2014-07-29 23:55:55,2014-07-29 17:04:13
17e75d03f92cff7d1d5d4679a8a09b13e08f3264...abb97cffdfe9f957b58c6b2613e2714c8291c5b3,1,3,4,7,1,2014-07-30 12:15:13,2014-07-30 12:15:13
abb97cffdfe9f957b58c6b2613e2714c8291c5b3...7fcfefbc4a502c8bf390838be4fa726efb2036dd,1,3,0,3,1,2014-07-30 13:33:02,2014-07-30 13:33:02
7fcfefbc4a502c8bf390838be4fa726efb2036dd...67d7da5fb9498b811f0168f5df2308ad4743027f,2,2,0,2,2,2014-07-30 16:58:53,2014-07-29 13:18:44
67d7da5fb9498b811f0168f5df2308ad4743027f...34c60c42b61ffd88b1074cc81787977dcc20eb21,1,1,1,2,1,2014-07-30 16:58:53,2014-07-30 16:58:45
34c60c42b61ffd88b1074cc81787977dcc20eb21...66630f589cd641efe91f111919ad5059b8a01a88,1,5,4,9,4,2014-07-30 17:03:54,2014-07-30 17:03:54
66630f589cd641efe91f111919ad5059b8a01a88...d47409831fbd44739d261c32c53a094748028e4f,31,187,198,385,153,2014-07-30 18:14:03,2014-07-26 11:21:52
d47409831fbd44739d261c32c53a094748028e4f...c2ab501bab71579a9df4c927f31cfb11c131883e,1,2,1,3,2,2014-07-30 18:31:59,2014-07-30 18:31:59
c2ab501bab71579a9df4c927f31cfb11c131883e...97a38de230371c0b6ad8a86abba8425186c147c7,3,54,4,58,6,2014-07-30 19:35:02,2014-07-27 21:39:40
97a38de230371c0b6ad8a86abba8425186c147c7...4453c80634fb72b60e849480e52c06b570c696d5,1,3,2,5,3,2014-07-30 20:22:04,2014-07-30 20:22:04
4453c80634fb72b60e849480e52c06b570c696d5...9a922dcad1e50afc91329009e8689e5c08c2a1bf,2,1,2,3,2,2014-07-31 12:06:46,2014-07-31 12:06:46
9a922dcad1e50afc91329009e8689e5c08c2a1bf...9d9f0acd7e245c9f9c30727a003666618754c924,12,81,13,94,22,2014-07-31 12:07:28,2014-07-25 12:07:04
9d9f0acd7e245c9f9c30727a003666618754c924...0dd05c9e66ebb5cb97136f84373f43582783e1a6,2,13,3,16,6,2014-07-31 13:13:55,2014-07-26 11:00:54
0dd05c9e66ebb5cb97136f84373f43582783e1a6...da599022504995891bf745a6424e242ca9097b07,1,6,13,19,4,2014-07-31 16:54:11,2014-07-31 16:54:11
da599022504995891bf745a6424e242ca9097b07...76f2f58a1853fd7a774f3df3fe454022a0206ff9,2,61,3,64,4,2014-07-31 17:35:27,2014-07-10 14:00:36
76f2f58a1853fd7a774f3df3fe454022a0206ff9...75790808993691d2869db577df6db47ecbef6f5a,2,11,18,29,8,2014-07-31 17:43:46,2014-07-29 11:45:16
75790808993691d2869db577df6db47ecbef6f5a...cdc25ac4747bf5a6cdc2e70461c2d43c54529d35,3,16,2,18,5,2014-07-31 19:29:46,2014-07-26 09:06:30
cdc25ac4747bf5a6cdc2e70461c2d43c54529d35...a0bfe4ea984fbf1720c24de42310c48b72f75f08,1,2,2,4,2,2014-07-31 21:46:49,2014-07-31 21:46:49
a0bfe4ea984fbf1720c24de42310c48b72f75f08...1ed6fbcf44f0eebf29fd9b36be03bc5d73acee0a,6,19,18,37,13,2014-08-01 11:41:28,2014-07-23 09:41:06
e520a73eeea6b185b719901ab9985ecef00e5664...862e1ff2340a1e28a3e7c6904d2b0283085f34c8,4,45,3,48,7,2014-05-17 20:36:45,2014-05-12 16:46:47
e520a73eeea6b185b719901ab9985ecef00e5664...d11e83620380fdd98679b09062eefd25f0a98e21,1,12,11,23,1,2014-05-16 10:11:35,2014-05-16 10:11:35
e520a73eeea6b185b719901ab9985ecef00e5664...257fd48004df3243c80a4bc1bc6bd1e91f22b84b,1,3,5,8,1,2014-05-16 09:21:56,2014-05-16 09:21:56
257fd48004df3243c80a4bc1bc6bd1e91f22b84b...8a9d54aa694b45f82c039912d417e2a391198852,1,1,1,2,1,2014-05-16 09:34:40,2014-05-16 09:07:43
8a9d54aa694b45f82c039912d417e2a391198852...cb15231888df2545356ad307eaea07f36aa0e8e0,4,64,2,66,6,2014-05-16 09:57:19,2014-03-13 11:32:20
cb15231888df2545356ad307eaea07f36aa0e8e0...f5d4b45df106ad3d37783ef8ea424c030bb6b196,2,10,8,18,9,2014-05-16 10:08:31,2014-05-10 16:40:44
f5d4b45df106ad3d37783ef8ea424c030bb6b196...cebd8753c65ec33730f495bb7085f34884f7c3d6,2,2,10,12,2,2014-05-16 10:11:35,2014-05-16 06:41:10
1ed6fbcf44f0eebf29fd9b36be03bc5d73acee0a...5ad48a9ef2f83d06e94e7ca0988c4b7218aae0fb,8,21,26,47,14,2014-08-01 12:41:24,2014-07-13 07:58:53
5ad48a9ef2f83d06e94e7ca0988c4b7218aae0fb...e9fde1c7ecc9c46ad2ae608a8718a1527b42a1ec,1,4,18,22,1,2014-08-01 12:41:24,2014-07-13 07:59:17
e9fde1c7ecc9c46ad2ae608a8718a1527b42a1ec...4a475ce1c84cbec9417e3d0ded97dcff5f7a38a4,6,213,15,228,10,2014-08-01 12:41:24,2014-07-13 14:49:45
4a475ce1c84cbec9417e3d0ded97dcff5f7a38a4...73b3318b1da9a0fc852b884fac236ecb3a7f998d,1,37,0,37,1,2014-08-01 12:41:24,2014-07-13 15:19:13
73b3318b1da9a0fc852b884fac236ecb3a7f998d...dd9c8f9382d626b432902de6178fb70a7a04a8b0,1,12,17,29,7,2014-08-01 12:41:24,2014-07-13 17:38:28
dd9c8f9382d626b432902de6178fb70a7a04a8b0...a4ead67ee9000a41f7bdca2978c5b2e309066220,11,50,52,102,20,2014-08-01 12:41:25,2014-07-13 17:42:06
a4ead67ee9000a41f7bdca2978c5b2e309066220...f8aeeff291f83b8b0cf767b41ca5bdc6192db296,1,4,11,15,1,2014-08-01 12:41:25,2014-07-13 20:24:21
4a981307359d5886d7e982aad8cfdac84d21152c...d64f192df188903ea5a1ab8dfd6679e5d52aaf9b,5,13,12,25,11,2014-05-16 10:38:24,2014-05-16 03:12:32
d64f192df188903ea5a1ab8dfd6679e5d52aaf9b...424fe76349a2e34eafef13c2450a7a1f4d3115a6,2,4,2,6,4,2014-05-16 13:13:11,2014-05-16 13:13:11
424fe76349a2e34eafef13c2450a7a1f4d3115a6...1ab278f39d9bec7d23adcd459c0028b176d073d4,2,0,8,8,2,2014-05-16 13:22:36,2014-05-16 13:03:59
1ab278f39d9bec7d23adcd459c0028b176d073d4...fadc6cd1bd095da0686ae507d1095c1fedb04f51,1,0,1,1,1,2014-05-16 13:24:41,2014-05-16 13:24:41
fadc6cd1bd095da0686ae507d1095c1fedb04f51...393ddc10a78354b573b9e746247df013f7bd6151,2,60,0,60,2,2014-05-16 13:30:25,2014-05-16 12:20:12
393ddc10a78354b573b9e746247df013f7bd6151...2c176eb95cc53f29367e56e0a8eec336834a299d,3,3,3,6,3,2014-05-16 13:41:17,2014-05-16 13:41:17
2c176eb95cc53f29367e56e0a8eec336834a299d...ddd52b221c5b005e42db3177f25a6b81561dea63,1,1,1,2,1,2014-05-16 13:45:58,2014-05-16 13:35:23
ddd52b221c5b005e42db3177f25a6b81561dea63...1be03aff5c24e902b89503dda32891aa4881579e,2,14,2,16,4,2014-05-16 14:40:07,2014-05-16 12:25:45
8c2b405ba8343e68bc32ac2c860be0c6cfd7d631...8b7347220f3d86b46f5f87270c6cdcb9960895fd,5,47,2,49,9,2014-08-01 13:30:58,2014-07-26 12:25:44
8b7347220f3d86b46f5f87270c6cdcb9960895fd...7ce4ef58c95fc17d4914e1962608aad79d7c46f1,1,1,1,2,1,2014-08-01 13:30:58,2014-08-01 13:10:14
7ce4ef58c95fc17d4914e1962608aad79d7c46f1...a9bdce7e5503a450c2c291fb2cb1e2097617ba75,18,86,185,271,50,2014-08-01 14:26:00,2014-07-26 20:55:31
a9bdce7e5503a450c2c291fb2cb1e2097617ba75...1a31d9ef913f954c26a4837b1ffb568ced21ff05,2,0,14,14,3,2014-08-01 14:53:53,2014-08-01 14:53:53
1a31d9ef913f954c26a4837b1ffb568ced21ff05...a2479f46f3d05b37254ad701b6b76f84624d3cb5,6,55,5,60,7,2014-08-01 21:51:49,2014-07-29 12:56:00
a2479f46f3d05b37254ad701b6b76f84624d3cb5...8f9d6e83a005901bc2a368a28017ee52a8c081f8,4,13,29,42,7,2014-08-01 23:32:00,2014-08-01 16:53:18
8f9d6e83a005901bc2a368a28017ee52a8c081f8...e075d2e66baae98c5b5c06bff384665ab50e0223,5,13,7,20,8,2014-08-02 08:17:45,2014-08-02 01:32:53
e075d2e66baae98c5b5c06bff384665ab50e0223...de0a22be35bbe6f23d826bcc9aa27756ffe59e8c,2,2,2,4,2,2014-08-02 13:14:13,2014-08-02 13:14:13
de0a22be35bbe6f23d826bcc9aa27756ffe59e8c...fb4f3e04b13681c5ec4cbf37d280ffebc887d620,7,22,24,46,17,2014-08-02 14:27:01,2014-08-02 14:27:01
fb4f3e04b13681c5ec4cbf37d280ffebc887d620...d28396f5268f1974ef1e84d13bcf1ac107005ced,5,9,42,51,5,2014-08-02 14:28:40,2014-08-01 15:09:28
d28396f5268f1974ef1e84d13bcf1ac107005ced...e26366da44bb343e7a95d01ff0dd18b8026c2802,1,1,1,2,1,2014-08-02 16:55:20,2014-08-02 16:52:07
e26366da44bb343e7a95d01ff0dd18b8026c2802...75f2c65cb6e16242d066a9aac2dcf8a01106dc1a,1,3,32,35,4,2014-08-02 19:02:29,2014-08-02 19:02:29
75f2c65cb6e16242d066a9aac2dcf8a01106dc1a...a9fa3d466771b1f5d05fcf55f94abfaf7b0c3258,1,0,49,49,1,2014-08-03 00:02:06,2014-08-03 00:02:06
a9fa3d466771b1f5d05fcf55f94abfaf7b0c3258...72f1eb48df335c110f39d56f7978d95896a56bb8,2,12,0,12,2,2014-08-03 11:02:31,2014-08-03 10:59:21
72f1eb48df335c110f39d56f7978d95896a56bb8...74325339327e5b8a2480aee7f482bc71f73c71f9,2,20,0,20,2,2014-08-03 12:02:21,2014-08-03 12:02:21
74325339327e5b8a2480aee7f482bc71f73c71f9...44169a00c1fe7c130a8b9774e3b02ccce524a3eb,1,0,2,2,1,2014-08-03 13:15:24,2014-08-03 13:15:24
44169a00c1fe7c130a8b9774e3b02ccce524a3eb...0f2ceee0254349ee4ac7d472d3efe67ee161a917,6,31,8,39,8,2014-08-03 15:21:01,2014-08-02 22:33:18
0f2ceee0254349ee4ac7d472d3efe67ee161a917...0d23450e81dc355c354a873fe187687e4aaa4886,2,10,1,11,4,2014-08-03 16:50:25,2014-08-01 16:29:59
0d23450e81dc355c354a873fe187687e4aaa4886...6e77acc589aaf4d95bb1665fe9526a7bc1e24a7c,1,1,1,2,1,2014-08-03 18:21:45,2014-08-03 18:21:45
6e77acc589aaf4d95bb1665fe9526a7bc1e24a7c...40fb6a560139150daa8f231f65b4044d45a97a8d,2,1,8,9,2,2014-08-03 19:08:24,2014-08-03 19:08:24
40fb6a560139150daa8f231f65b4044d45a97a8d...2d542bf60cc37c59872c5a20d6af3bf826038739,1,1,1,2,1,2014-08-03 19:10:00,2014-08-03 19:10:00
2d542bf60cc37c59872c5a20d6af3bf826038739...cbb29af1aa1ebe11b38e73a6f34df9cd171d6c5b,2,56,7,63,6,2014-08-03 19:27:01,2014-08-03 19:02:40
cbb29af1aa1ebe11b38e73a6f34df9cd171d6c5b...1b00738f73444693dd94958f3fc53c089f4d96e7,1,3,3,6,3,2014-08-03 20:32:36,2014-08-03 20:32:36
1b00738f73444693dd94958f3fc53c089f4d96e7...c06e124b5e73bd99c6ec563c64fd50d6a45457d8,3,72,1,73,5,2014-08-04 01:59:29,2014-08-04 01:58:44
c06e124b5e73bd99c6ec563c64fd50d6a45457d8...b508c1c317c026eeec82b04142d9e3956192619c,1,47,8,55,5,2014-08-04 03:15:32,2014-08-04 03:15:32
b508c1c317c026eeec82b04142d9e3956192619c...059f5d17c5fe92d6b4c5d189020ea59e9bed4472,1,2,2,4,1,2014-08-04 03:57:02,2014-08-04 03:57:02
059f5d17c5fe92d6b4c5d189020ea59e9bed4472...d4f62a7ae7bed98f3ee3f5c9a76f5591ec7841fd,1,3,1,4,1,2014-08-04 04:06:33,2014-08-04 04:06:33
d4f62a7ae7bed98f3ee3f5c9a76f5591ec7841fd...399cf303cbfe086e78fd9421b75c6df55fc234d0,1,1,1,2,1,2014-08-04 10:57:09,2014-08-04 10:57:09
399cf303cbfe086e78fd9421b75c6df55fc234d0...5e06fa1469180909c51c07151692412269e51ea3,2,35,0,35,4,2014-08-04 11:47:37,2014-06-16 07:47:45
5e06fa1469180909c51c07151692412269e51ea3...e4dd8b5dde922d967697b2bdd573aa2364da4f1b,3,7,7,14,6,2014-08-04 12:29:00,2014-08-04 11:29:59
e4dd8b5dde922d967697b2bdd573aa2364da4f1b...bf5382c6e549d78da9f7029cd86686459b52eaed,4,8,24,32,8,2014-08-04 13:21:03,2014-03-09 11:00:42
bf5382c6e549d78da9f7029cd86686459b52eaed...98e8da3709e400d549e87c7ff1450a2685c0adcf,7,81,7,88,17,2014-08-04 13:39:02,2014-05-21 10:32:19
98e8da3709e400d549e87c7ff1450a2685c0adcf...b50ea73e1e0179c1925167832318a6d0316ee50b,1,2,2,4,2,2014-08-04 14:21:13,2014-08-04 14:21:13
b50ea73e1e0179c1925167832318a6d0316ee50b...8193a46c6e44300fb7c33edd67f11901b30db148,1,1,1,2,1,2014-08-04 14:23:37,2014-08-04 13:55:16
8193a46c6e44300fb7c33edd67f11901b30db148...6d256ae248cfa1f111d03d29402a669a95cdff3c,1,8,4,12,4,2014-08-04 14:54:43,2014-08-04 14:54:43
6d256ae248cfa1f111d03d29402a669a95cdff3c...746f2a4bed52254e1034c4462033226ff565146c,4,14,1,15,4,2014-08-05 00:12:08,2014-07-31 22:36:06
746f2a4bed52254e1034c4462033226ff565146c...5f6558f82f980ff1326ae0f71b4cdaa545c6f4c2,1,20,13,33,3,2014-08-05 11:09:37,2014-08-05 11:09:37
5f6558f82f980ff1326ae0f71b4cdaa545c6f4c2...21d0ceefb564ffd0f20115a8b5523cc5fddaf34b,2,2,2,4,2,2014-08-05 11:28:04,2014-08-05 11:28:04
21d0ceefb564ffd0f20115a8b5523cc5fddaf34b...fcd42a48190d395b8daea82acfc0609549a78705,2,1,5,6,2,2014-08-05 11:49:53,2014-08-04 23:54:44
fcd42a48190d395b8daea82acfc0609549a78705...0efd72dc908da84d7d586d553cce34f0cf01eb54,8,8,14,22,11,2014-08-05 12:23:34,2014-08-05 12:23:34
0efd72dc908da84d7d586d553cce34f0cf01eb54...edcc75e5ac5b9dc2f174580e7adacd3be586f8bd,1,25,0,25,1,2014-08-05 12:44:57,2014-08-05 12:40:27
edcc75e5ac5b9dc2f174580e7adacd3be586f8bd...938da36cb12c07c93a44bb1b77984427e809d213,4,30,1,31,4,2014-08-06 12:41:34,2013-12-13 06:04:28
938da36cb12c07c93a44bb1b77984427e809d213...dfe86449c9951824dfa95d44af36ef1d8e578bdc,2,28,4,32,5,2014-08-07 01:52:31,2014-08-07 01:52:03
dfe86449c9951824dfa95d44af36ef1d8e578bdc...8d93b21ec9777a5458aae374df1d8957bba21551,1,17,17,34,2,2014-08-07 01:59:11,2014-08-07 01:59:11
8d93b21ec9777a5458aae374df1d8957bba21551...5257b85ab8a4a86b24005e3ca8c542ede44b0687,1,19,0,19,2,2014-08-07 02:13:37,2014-08-07 02:13:37
5257b85ab8a4a86b24005e3ca8c542ede44b0687...61ed9592356747b6324ca84a09df03c1bd030af9,1,1,1,2,1,2014-08-07 02:15:54,2014-08-07 00:32:41
61ed9592356747b6324ca84a09df03c1bd030af9...173d989c91361243d0638f1e39db7148bc0ea4f8,2,61,2,63,4,2014-08-07 04:14:12,2014-08-07 04:13:22
173d989c91361243d0638f1e39db7148bc0ea4f8...57b60f9f93f4aa660c191c54ebb30ce44e54f236,1,2,0,2,1,2014-08-07 12:30:50,2014-08-07 12:30:50
57b60f9f93f4aa660c191c54ebb30ce44e54f236...157c42a976966b4d0a159e414f892ece7474180a,1,2,2,4,2,2014-08-07 12:34:07,2014-08-07 12:33:42
157c42a976966b4d0a159e414f892ece7474180a...f9f9f3ad6073c353af924ed90c9386efd7bde8ac,1,1,1,2,1,2014-08-07 14:11:15,2014-08-07 14:11:15
f9f9f3ad6073c353af924ed90c9386efd7bde8ac...f676305ecede116332884ea682fc953c29813232,2,7,0,7,2,2014-08-07 18:44:20,2014-08-07 06:06:44
f676305ecede116332884ea682fc953c29813232...51673c146e48ff6230eace39bac18fd555607bee,1,2,2,4,2,2014-08-07 23:57:31,2014-08-07 23:56:59
51673c146e48ff6230eace39bac18fd555607bee...f3ef55ea7ad39b8b949051d7c2ff8d46db973381,1,65,11,76,3,2014-08-08 16:31:56,2014-08-08 14:17:27
f3ef55ea7ad39b8b949051d7c2ff8d46db973381...73ff4498aab1df286cf9aeb2ad9d801ac8e0263e,2,5,5,10,4,2014-08-08 17:59:02,2014-08-08 17:59:02
73ff4498aab1df286cf9aeb2ad9d801ac8e0263e...f53b1c779b9a6258cfb61ef00ed5ec8340b96d52,15,472,3,475,16,2014-08-08 18:01:59,2014-07-26 17:15:54
f53b1c779b9a6258cfb61ef00ed5ec8340b96d52...09c0fa2c5365817f5ec21a048612d7a926b7d3a6,1,1,1,2,1,2014-08-08 19:42:48,2014-08-08 19:42:48
09c0fa2c5365817f5ec21a048612d7a926b7d3a6...8fe406864c5bbdd20e32d6127d377ed292006c5c,3,33,18,51,8,2014-08-08 20:54:30,2014-08-08 20:47:35
8fe406864c5bbdd20e32d6127d377ed292006c5c...27b6f284353a7a477a1a0ae4beffd12003a91fb5,3,106,6,112,8,2014-08-09 07:50:00,2014-08-09 07:50:00
27b6f284353a7a477a1a0ae4beffd12003a91fb5...dc462a8ed55edacd71709f3db6fd225296871927,2,0,2,2,2,2014-08-09 15:13:00,2014-08-09 15:13:00
dc462a8ed55edacd71709f3db6fd225296871927...61d783f3d7c9d4c7a0ac05f7fbbaba78e5cef5aa,1,3,0,3,1,2014-08-10 11:31:06,2014-08-10 11:31:06
61d783f3d7c9d4c7a0ac05f7fbbaba78e5cef5aa...f915d39afe3565ac2355de57c11843530b96f3bc,1,12,0,12,1,2014-08-10 14:24:19,2014-08-10 14:24:19
f915d39afe3565ac2355de57c11843530b96f3bc...12ad61aa9ff92958d56bb5b0c0c372e24a596148,1,15,0,15,1,2014-08-10 21:58:18,2014-08-10 21:58:18
12ad61aa9ff92958d56bb5b0c0c372e24a596148...f0b358880a6825d667c037757caac470bc526a1f,2,22,1,23,3,2014-08-11 06:33:18,2014-08-08 10:08:26
f0b358880a6825d667c037757caac470bc526a1f...cdfdcf4b70bebfc68871df885387790c6afbc23c,2,17,2,19,2,2014-08-11 06:51:57,2014-08-10 12:53:37
cdfdcf4b70bebfc68871df885387790c6afbc23c...dfadbdac6a63dce3304dff1977b5b0a15dc2d7b5,2,69,6,75,7,2014-08-11 09:47:37,2014-08-11 09:47:37
dfadbdac6a63dce3304dff1977b5b0a15dc2d7b5...2e7be92b4df29ac851d570e57da5dcf756c5ac52,1,1,1,2,1,2014-08-11 10:06:08,2014-08-11 10:01:14
2e7be92b4df29ac851d570e57da5dcf756c5ac52...e92b057e06b41eb05930637119e83ed3acd3d324,6,43,13,56,12,2014-08-11 11:04:33,2014-08-11 07:51:52
e92b057e06b41eb05930637119e83ed3acd3d324...c2d3f18874e1999919a8639aa075dea587203b53,1,2,2,4,1,2014-08-11 11:06:29,2014-08-11 09:34:32
c2d3f18874e1999919a8639aa075dea587203b53...7efce77de254ee2ffabaf00b826ece19c04eb2d9,2,28,8,36,6,2014-08-11 11:08:17,2014-08-07 13:20:59
7efce77de254ee2ffabaf00b826ece19c04eb2d9...954e7b8aad3f3925e63a0a156b7df7466895e073,1,2,0,2,2,2014-08-11 18:29:37,2014-08-11 18:29:37
954e7b8aad3f3925e63a0a156b7df7466895e073...5b0375ec3e7473fcc29c21003fef80c0d0be183f,2,26,1,27,2,2014-08-12 11:58:10,2014-07-11 06:55:49
5b0375ec3e7473fcc29c21003fef80c0d0be183f...f7dba61881ff5c26ad1c9a6dff71a8dc4ebede5a,2,20,1,21,4,2014-08-12 11:58:10,2014-07-14 14:53:23
f7dba61881ff5c26ad1c9a6dff71a8dc4ebede5a...2003cb23d4f1b3be717855d41b562d4d5cfebe99,1,1,1,2,1,2014-08-12 16:27:24,2014-08-12 16:27:24
2003cb23d4f1b3be717855d41b562d4d5cfebe99...a9fd740d22bc4fed5fdb280c036618000ee13df1,28,207,182,389,90,2014-08-12 17:15:40,2014-08-12 14:54:42
a9fd740d22bc4fed5fdb280c036618000ee13df1...549284faa4c58de420918ecd3120607db473787f,7,28,41,69,16,2014-08-12 17:46:10,2014-08-11 11:34:48
549284faa4c58de420918ecd3120607db473787f...6745b6fd7a57c493d9e050dc76799cef810bed01,1,1,1,2,1,2014-08-12 18:40:32,2014-08-12 18:40:32
6745b6fd7a57c493d9e050dc76799cef810bed01...8f9862cd4d0e9706babf947079739fd476455df7,4,90,25,115,21,2014-08-12 19:49:20,2014-08-12 19:49:20
8f9862cd4d0e9706babf947079739fd476455df7...2cc8ffe258008096a70791115b2daa12f0ef0192,5,48,6,54,11,2014-08-12 19:53:29,2014-08-09 19:03:19
2cc8ffe258008096a70791115b2daa12f0ef0192...85c22dd4c4a406301b4378a4682456dfa1900830,2,17,1,18,5,2014-08-12 20:17:00,2014-08-08 18:10:09
85c22dd4c4a406301b4378a4682456dfa1900830...68686430638215b5405b20bd767c0be392c9221d,59,59,59,118,59,2014-08-12 23:22:09,2014-04-16 19:35:16
68686430638215b5405b20bd767c0be392c9221d...d38a00332ed012b889cce00d8ea51da728023ead,4,24,24,48,22,2014-08-13 00:16:04,2014-08-13 00:16:04
d38a00332ed012b889cce00d8ea51da728023ead...3687aa00932c0e951643790fcb0f863049aa0446,2,28,34,62,2,2014-08-13 14:27:17,2014-08-13 13:24:24
3687aa00932c0e951643790fcb0f863049aa0446...7f4be9cbc2ea9ed34845aac9974134fe4c220e0b,1,1,1,2,1,2014-08-13 16:33:18,2014-08-13 16:33:18
7f4be9cbc2ea9ed34845aac9974134fe4c220e0b...d441a9d00629bbaf3f1ef0e4f75f3ce08b76c214,1,13,10,23,4,2014-08-13 16:41:11,2014-08-13 16:00:45
1be03aff5c24e902b89503dda32891aa4881579e...9d8c73f6a1c636853a5c5013f21985d702b2301b,3,293,24,317,14,2014-05-16 16:59:31,2014-02-22 13:29:43
1be03aff5c24e902b89503dda32891aa4881579e...7271f5db78f7c369f5dba1c0013b5eff584114df,1,2,0,2,1,2014-05-16 15:20:31,2014-05-16 15:01:17
7271f5db78f7c369f5dba1c0013b5eff584114df...e7ffba8f78849fbf60b98fb8d67ef4577b585e3b,1,9,5,14,2,2014-05-16 16:26:37,2014-05-16 15:52:59
e7ffba8f78849fbf60b98fb8d67ef4577b585e3b...ebd70d4d00c252d5122c13906da5bddc8de0bce5,2,26,2,28,3,2014-05-16 16:33:17,2014-05-16 15:56:25
ebd70d4d00c252d5122c13906da5bddc8de0bce5...2e364a0aacb49a5160896b1ca5a2619baa3f4d9b,4,57,4,61,12,2014-05-16 16:57:38,2014-05-08 20:06:46
2e364a0aacb49a5160896b1ca5a2619baa3f4d9b...6bb6df29431b606937637be5837cc671836b142b,2,19,2,21,6,2014-05-16 17:08:52,2014-05-16 17:04:26
6bb6df29431b606937637be5837cc671836b142b...1efb2e73bf13100639c4f06963220549a7eb725c,1,1,1,2,1,2014-05-16 20:39:12,2014-05-16 20:39:12
1efb2e73bf13100639c4f06963220549a7eb725c...fa89acf1d0a4adbf0802c1275494f5159a912c9e,2,29,0,29,3,2014-05-16 20:52:10,2014-05-16 20:52:10
fa89acf1d0a4adbf0802c1275494f5159a912c9e...1109ebd7b373e14b68616346ea5dd3e89a8ae2fe,3,42,36,78,12,2014-05-16 21:12:59,2014-05-16 21:12:59
1109ebd7b373e14b68616346ea5dd3e89a8ae2fe...79e9da3d1ef8c4bdc20d53b668228abb219ac55b,2,14,0,14,2,2014-05-16 22:19:23,2014-05-16 22:19:23
79e9da3d1ef8c4bdc20d53b668228abb219ac55b...ebb0279f4a7a7155c44c09506bbe5b1f9acc83a2,4,15,2,17,6,2014-05-16 22:41:40,2013-10-30 11:11:04
ebb0279f4a7a7155c44c09506bbe5b1f9acc83a2...9a4bf72fbd34b88f0cd618f948aff5d84fe3d00a,1,0,0,0,0,2014-05-17 08:15:58,2014-05-17 08:15:58
d441a9d00629bbaf3f1ef0e4f75f3ce08b76c214...b4dce7c37ab7666b023ac791d2c46dad6c8aa637,1,11,2,13,1,2014-08-15 19:19:04,2014-08-15 19:19:04
d441a9d00629bbaf3f1ef0e4f75f3ce08b76c214...e0e28bfe715b3f7d4e6cc7ab7bf4000b22c0cf79,2,57,1,58,2,2014-08-13 16:56:26,2014-08-13 13:32:14
e0e28bfe715b3f7d4e6cc7ab7bf4000b22c0cf79...468236889fe0af8bf49ca2fe0ce3353bc71f0685,1,2,2,4,1,2014-08-13 17:02:26,2014-04-16 19:50:18
468236889fe0af8bf49ca2fe0ce3353bc71f0685...e5376999fa9c75efe42ba963a00e2552f66cab9c,6,11,9,20,9,2014-08-13 18:20:15,2014-08-13 18:09:31
e5376999fa9c75efe42ba963a00e2552f66cab9c...69478859261bd1b3e82cc785fddb5e50e3e7645f,4,6,6,12,4,2014-08-13 22:23:52,2014-08-13 16:33:06
69478859261bd1b3e82cc785fddb5e50e3e7645f...01801edd3760f97a4ebc4d43ca5bbdbbdfebbb0a,5,86,3,89,8,2014-08-13 22:29:42,2014-05-21 13:05:41
01801edd3760f97a4ebc4d43ca5bbdbbdfebbb0a...2a9f44dfbe293a1217097acc34993f48c0139e99,1,1,1,2,1,2014-08-14 00:19:22,2014-08-14 00:11:12
2a9f44dfbe293a1217097acc34993f48c0139e99...25e06bca57c068d4b9e9b4221b16a667ccb0d38e,3,77,5,82,4,2014-08-14 00:36:26,2014-04-15 19:01:55
25e06bca57c068d4b9e9b4221b16a667ccb0d38e...da009ce32c1b8b27c1a897a28bacf293d98f3398,1,0,2,2,1,2014-08-14 01:42:39,2014-08-14 01:42:05
da009ce32c1b8b27c1a897a28bacf293d98f3398...a7443c24a367dccc886b69d2b361515f9fa38a58,1,2,2,4,2,2014-08-14 01:44:36,2014-08-14 01:44:16
a7443c24a367dccc886b69d2b361515f9fa38a58...7244a8d0ae296833201e634ac31177b936da2ad9,1,1,1,2,1,2014-08-14 07:58:15,2014-08-14 07:58:15
7244a8d0ae296833201e634ac31177b936da2ad9...b42e5ca058178d67027bf66d37d00ade635b4c26,2,78,1,79,8,2014-08-14 09:45:43,2014-07-12 12:08:50
b42e5ca058178d67027bf66d37d00ade635b4c26...055d95fce0668e11f2dae48d2439f378349d2524,2,5,1,6,3,2014-08-14 10:08:06,2014-08-14 09:56:25
055d95fce0668e11f2dae48d2439f378349d2524...cf79b57ad09c145b82ccaab798d88958316027cf,2,7,3,10,4,2014-08-14 13:05:51,2014-08-13 19:23:21
cf79b57ad09c145b82ccaab798d88958316027cf...fe38be96c1769ee83c65246704d2ae435c8d4150,2,33,5,38,4,2014-08-14 13:36:41,2014-08-14 13:32:50
fe38be96c1769ee83c65246704d2ae435c8d4150...b3660d28f3422a33a84de7a7ccad404b3135a1a8,2,34,25,59,6,2014-08-14 14:43:44,2014-08-08 13:40:44
b3660d28f3422a33a84de7a7ccad404b3135a1a8...0bfb53866199f366ed140d49938fd185e5898156,1,1,1,2,1,2014-08-14 15:22:21,2014-08-14 11:16:15
0bfb53866199f366ed140d49938fd185e5898156...bef5b9b7cdca04713ab5a34fa02b2e8dfcf79d9e,1,1,1,2,1,2014-08-14 16:13:52,2014-08-14 16:00:06
bef5b9b7cdca04713ab5a34fa02b2e8dfcf79d9e...2a4492aecb50122f7cc2c643f7ea5b086f301165,2,32,3,35,3,2014-08-14 17:28:12,2014-08-13 14:59:58
2a4492aecb50122f7cc2c643f7ea5b086f301165...302145328560ded44bcfded8a67a1e7df08b411b,8,31,3,34,15,2014-08-14 17:56:23,2014-08-14 11:17:52
302145328560ded44bcfded8a67a1e7df08b411b...982addeb37464ee1dce01f816b08bf51e9e032a6,1,7,1,8,7,2014-08-14 18:13:08,2014-08-14 18:12:36
982addeb37464ee1dce01f816b08bf51e9e032a6...4d2f9c38e835383fe42548353890ed4a302eaa58,2,24,2,26,5,2014-08-15 02:47:22,2014-08-15 02:47:02
4d2f9c38e835383fe42548353890ed4a302eaa58...12adcd505ebe8159cf4644cfa8d393b15ca9d5ea,2,7,3,10,4,2014-08-15 08:14:55,2014-08-15 08:11:53
12adcd505ebe8159cf4644cfa8d393b15ca9d5ea...99561eef26b75947891929a2b7d5b2c605aa2456,1,1,1,2,1,2014-08-15 11:18:04,2014-08-15 11:18:04
99561eef26b75947891929a2b7d5b2c605aa2456...deed00c0d803d324a3dfdeba52458b6b009c1a90,13,106,67,173,45,2014-08-15 12:14:45,2014-08-07 02:56:23
deed00c0d803d324a3dfdeba52458b6b009c1a90...e122facbd89c5768528f5ba3b13552d43f989757,8,62,10,72,17,2014-08-15 12:20:02,2014-08-11 11:24:51
e122facbd89c5768528f5ba3b13552d43f989757...64bb122c3dede3538294bab07d5f1a1980713d31,1,1,1,2,1,2014-08-15 13:03:43,2014-08-15 13:03:43
64bb122c3dede3538294bab07d5f1a1980713d31...0ad4672c0f9cc8fb819abbc97c13ceaffc011a7d,1,1,1,2,1,2014-08-15 15:01:49,2014-08-15 15:01:49
0ad4672c0f9cc8fb819abbc97c13ceaffc011a7d...2724cdbff635a40819f206411de23e9b14867a58,9,126,7,133,27,2014-08-15 15:09:47,2014-05-19 21:27:09
2724cdbff635a40819f206411de23e9b14867a58...ef90d395abfc4a9b0338146cf456f68d4f0557c7,1,10,1,11,2,2014-08-15 16:27:30,2014-08-15 12:18:55
ef90d395abfc4a9b0338146cf456f68d4f0557c7...1d79d08d9aef1565cf56d50f0742285efae53631,1,2,2,4,1,2014-08-15 16:39:06,2014-08-15 14:04:05
1d79d08d9aef1565cf56d50f0742285efae53631...7ca665c5f593953cba2cfeebd4f82acd38231031,1,4,2,6,1,2014-08-15 17:56:14,2014-08-15 17:29:01
11932e978f980846d2c3326ff070ece7e65bf75c...a2dd618e3b4a7472fab852da450ca5eef92a922f,2,64,2,66,5,2014-05-17 10:26:15,2014-05-16 17:56:44
a2dd618e3b4a7472fab852da450ca5eef92a922f...5b185ecc68c04c0ee63cf44de43d831623daa263,5,44,5,49,5,2014-05-17 12:32:05,2014-05-16 20:40:00
5b185ecc68c04c0ee63cf44de43d831623daa263...a0d5970d4483920993c09617d3c7f632af6da19c,1,12,0,12,3,2014-05-17 13:01:06,2014-05-17 12:59:06
a0d5970d4483920993c09617d3c7f632af6da19c...727d048f0991ccbd1564c6fb225ffbfd2f1a2102,1,16,18,34,8,2014-05-17 13:08:49,2014-05-17 13:08:49
727d048f0991ccbd1564c6fb225ffbfd2f1a2102...268670a3a40aac87ed8c5570a97ed01aa0f2c0ab,1,14,4,18,2,2014-05-17 13:45:15,2014-05-17 10:05:29
152afadef12e3dcb9ce92567d2e58269749d63b9...b6aa60f4252311ef8ef24b4ffd99984197be7ee6,1,9,9,18,3,2014-08-18 16:53:25,2014-08-18 16:49:50
b6aa60f4252311ef8ef24b4ffd99984197be7ee6...5853c87a458f62ebd62d7809168355610de2570c,7,38,2,40,11,2014-08-18 16:55:12,2014-08-16 15:21:14
5853c87a458f62ebd62d7809168355610de2570c...3e241313a4cea5dbf53068181408a7c34f00c9ca,3,15,2,17,5,2014-08-18 17:20:29,2014-08-05 00:30:00
3e241313a4cea5dbf53068181408a7c34f00c9ca...f76222e1d3f593c188c26e4f1da56a6ce3470dc0,1,1,0,1,1,2014-08-18 17:44:10,2014-08-18 17:44:10
f76222e1d3f593c188c26e4f1da56a6ce3470dc0...a3d7f58151e4a2996476d400bab0335b8d616bde,1,0,6,6,1,2014-08-18 17:55:05,2014-08-18 17:53:53
a3d7f58151e4a2996476d400bab0335b8d616bde...132d0e516e5881cb3f6445e9d84e01c9f2123254,2,13,3,16,2,2014-08-18 17:57:50,2014-08-18 17:57:50
132d0e516e5881cb3f6445e9d84e01c9f2123254...9432f1e750eca440e19903ee1b1cef0679f6f98b,6,24,17,41,16,2014-08-19 00:37:47,2014-08-19 00:37:16
9432f1e750eca440e19903ee1b1cef0679f6f98b...15cafaa5657bae31df6e515b425dd353b7352aa3,1,5,0,5,1,2014-08-19 10:14:14,2014-08-19 10:14:14
15cafaa5657bae31df6e515b425dd353b7352aa3...5dbe2a9431dc7335359f58c58dc02e9f92c47525,1,3,1,4,1,2014-08-19 10:16:05,2014-08-19 10:09:29
5dbe2a9431dc7335359f58c58dc02e9f92c47525...700618706425ae15888b9e60bdc7a00dd0b32a2f,1,15,7,22,3,2014-08-19 10:28:48,2014-08-19 10:27:27
700618706425ae15888b9e60bdc7a00dd0b32a2f...c587bd5a9405973e7b62f2698822956bdd639434,1,2,1,3,1,2014-08-19 11:18:05,2014-08-19 11:17:23
c587bd5a9405973e7b62f2698822956bdd639434...3569536491f16c9d112959d23cf3c18417063c54,1,7,3,10,3,2014-08-19 11:24:36,2014-08-19 11:23:17
3569536491f16c9d112959d23cf3c18417063c54...6295ea0027d808dcc309aa42cc58f6fdf172c3fc,20,101,76,177,63,2014-08-19 15:57:01,2014-08-17 17:06:25
6295ea0027d808dcc309aa42cc58f6fdf172c3fc...54164b814cab71a8a0503743befbdcc99ae6c7a0,2,8,5,13,4,2014-08-19 15:58:30,2014-08-19 14:56:01
54164b814cab71a8a0503743befbdcc99ae6c7a0...03c1609c473e14063bcea02dec248095d9c10579,1,4,0,4,1,2014-08-19 16:07:44,2014-08-19 16:06:07
03c1609c473e14063bcea02dec248095d9c10579...ad9ba9d27bc1ea441246c9e8803df41ca6b4a913,3,0,3,3,3,2014-08-19 16:40:49,2014-08-19 16:40:49
ad9ba9d27bc1ea441246c9e8803df41ca6b4a913...11d9cbe2f46583716aed4859f180a973bf2d5cf4,4,7,1,8,4,2014-08-19 17:31:46,2014-08-19 13:23:29
11d9cbe2f46583716aed4859f180a973bf2d5cf4...fa02120d360387bebbbe735e86686bb4c7c43db2,5,43,13,56,9,2014-08-19 20:29:31,2014-07-12 17:37:59
fa02120d360387bebbbe735e86686bb4c7c43db2...9d6551204eff9d1ab70b67578f99630716df7490,32,161,308,469,134,2014-08-19 20:44:25,2014-08-18 14:30:44
9d6551204eff9d1ab70b67578f99630716df7490...5f2542f12a90cfcfb7be776424ef2f7b200df006,7,125,18,143,27,2014-08-19 21:34:38,2013-11-16 17:54:12
5f2542f12a90cfcfb7be776424ef2f7b200df006...fca677fa438879cbb3ebb828268cb2b976e514d8,4,61,16,77,14,2014-08-19 21:40:50,2014-08-19 14:22:51
fca677fa438879cbb3ebb828268cb2b976e514d8...9247da1032c1b8c98b0fcfb278bbbdbc8edc8783,2,73,76,149,17,2014-08-20 02:51:12,2014-08-20 02:50:14
9247da1032c1b8c98b0fcfb278bbbdbc8edc8783...12cf10cacd62cfa22814dcb2be35801f4b9b7d6f,1,1,1,2,1,2014-08-20 06:57:35,2014-08-20 06:57:13
12cf10cacd62cfa22814dcb2be35801f4b9b7d6f...724d72e1a2eb898eedf9bd307c20918910cd2ade,1,1,1,2,1,2014-08-20 08:22:21,2014-08-14 13:24:47
724d72e1a2eb898eedf9bd307c20918910cd2ade...efa67b897b6ed5c6bbee1aa2646f4ba7ea6e2bc2,2296,144014,82294,226308,50385,2014-08-20 08:22:41,2014-08-14 18:13:35
efa67b897b6ed5c6bbee1aa2646f4ba7ea6e2bc2...d1299fce0eeeb2a7749fecafc87260462e75aac9,1,1,1,2,1,2014-08-20 18:00:59,2014-08-20 18:00:59
d1299fce0eeeb2a7749fecafc87260462e75aac9...6f59d291585420800275cff8aa8377c19616b79a,1,4,4,8,1,2014-08-20 18:37:33,2014-08-20 18:37:33
6f59d291585420800275cff8aa8377c19616b79a...ec71191be0947e22630141e726f0e1f298f930df,4,17,1,18,5,2014-08-20 18:39:40,2014-08-05 19:20:05
ec71191be0947e22630141e726f0e1f298f930df...28e765810df46a3f28ff4785491e9973593382fd,6,50,1,51,6,2014-08-20 18:39:40,2014-07-17 19:59:28
28e765810df46a3f28ff4785491e9973593382fd...0d8d30b7ddfe83ab03120f4560c7aa153f4d0ed1,8,122,27,149,19,2014-08-20 18:39:40,2014-08-08 14:20:08
0d8d30b7ddfe83ab03120f4560c7aa153f4d0ed1...5307ce565fbedb9cc27cbe7c757b41a00438d37c,5,65,8,73,7,2014-08-20 18:39:40,2014-07-28 04:54:29
5307ce565fbedb9cc27cbe7c757b41a00438d37c...53ff0969822ac2248a89ccb6fef1088212dc800d,8,115,7,122,15,2014-08-20 18:39:40,2014-08-07 04:18:10
53ff0969822ac2248a89ccb6fef1088212dc800d...144cff3f516f7c718cbe4bd3165e18781c09042a,2,95,3,98,5,2014-08-20 20:04:21,2014-08-20 14:15:23
144cff3f516f7c718cbe4bd3165e18781c09042a...b902be798e4a2b760fa6bc86dac5af1c127e5e58,3,3,3,6,3,2014-08-20 20:31:45,2014-08-20 20:31:45
b902be798e4a2b760fa6bc86dac5af1c127e5e58...56252e7f46afce36fd112971c28188a3fd509a43,2,13,3,16,5,2014-08-22 02:08:53,2014-08-22 02:08:53
56252e7f46afce36fd112971c28188a3fd509a43...459cfb523d8812081a623b29d0b8ab13bf87190a,1,10,5,15,1,2014-08-22 02:18:26,2014-08-22 02:17:25
459cfb523d8812081a623b29d0b8ab13bf87190a...a6222af0ed94f807180b02f762c6011b368444a5,1,10,0,10,1,2014-08-22 02:37:36,2014-08-22 02:08:53
a6222af0ed94f807180b02f762c6011b368444a5...14aff0bd8249168e6677b45d192490d984bfd2b4,1,1,1,2,1,2014-08-22 15:22:09,2014-08-22 15:22:09
14aff0bd8249168e6677b45d192490d984bfd2b4...b7336ec17917a5cea92e90ac7d1ede6f4c25fdd3,1,2,1,3,1,2014-08-22 15:38:52,2014-08-22 10:24:46
b7336ec17917a5cea92e90ac7d1ede6f4c25fdd3...a76aab3583a0bcd5bc48f3a8c9a93ab420a75eec,1,2,1,3,1,2014-08-22 16:56:38,2014-08-22 16:56:38
a76aab3583a0bcd5bc48f3a8c9a93ab420a75eec...0396cd8f190b39597516abf2162542b196cf0c6d,1,1,1,2,1,2014-08-22 17:40:14,2014-08-21 12:41:33
0396cd8f190b39597516abf2162542b196cf0c6d...a6691e5dcfdfd1529987be3bdcf06e7ab9948356,2,36,0,36,2,2014-08-22 19:55:56,2014-08-21 17:09:05
a6691e5dcfdfd1529987be3bdcf06e7ab9948356...f9c7732e964980bdb8bf805869ce8d2494007ea0,1,3,2,5,2,2014-08-22 19:57:15,2014-08-22 19:57:15
f9c7732e964980bdb8bf805869ce8d2494007ea0...03d89168a27f7c5a8fb4b466170c997aca5fdf02,2,8,2,10,3,2014-08-23 00:07:12,2014-08-21 11:53:22
03d89168a27f7c5a8fb4b466170c997aca5fdf02...1c660d0de29fc8b293c6200769aa4b7189f20f6b,3,34,1,35,10,2014-08-23 12:13:28,2014-08-23 09:29:56
1c660d0de29fc8b293c6200769aa4b7189f20f6b...2c681e8a8c453b1691219eace7ed5dc636e37948,1,5,10,15,4,2014-08-23 13:27:36,2014-08-23 13:26:59
2c681e8a8c453b1691219eace7ed5dc636e37948...c7fa27d702fc3988feae57f663779b31bfe8f340,2,16,52,68,6,2014-08-23 13:30:01,2014-08-23 13:30:01
c7fa27d702fc3988feae57f663779b31bfe8f340...46c7707e50400e237cbd774a31ad801669ca3905,5,9,13,22,13,2014-08-23 13:41:13,2014-08-19 16:11:10
46c7707e50400e237cbd774a31ad801669ca3905...a7d964ab87ad7352af3e33b8f3c12e4643a80f02,13,105,63,168,44,2014-08-23 13:41:13,2014-08-19 16:47:23
a7d964ab87ad7352af3e33b8f3c12e4643a80f02...ba1d707b0f5666809b09bb8234f2df64bf0d7490,5,68,71,139,36,2014-08-23 13:44:34,2014-08-21 12:26:49
ba1d707b0f5666809b09bb8234f2df64bf0d7490...1f45f3cea1623d7b1414c48869535bd3350b4ba8,1,2,2,4,2,2014-08-23 16:03:11,2014-08-23 16:03:11
1f45f3cea1623d7b1414c48869535bd3350b4ba8...be4baaefe2e8e7effa3c510b31746dbb41ec422a,1,13,0,13,1,2014-08-23 21:35:13,2014-08-23 09:37:25
be4baaefe2e8e7effa3c510b31746dbb41ec422a...19999befbec89171f7b3d6d75d3b0600e5c41cc0,1,3,2,5,1,2014-08-23 23:13:51,2014-08-23 23:07:27
19999befbec89171f7b3d6d75d3b0600e5c41cc0...abd640fbdfce2c8dc8bca039525694d3a1a0297a,4,52,27,79,11,2014-08-23 23:18:03,2014-08-22 07:26:06
abd640fbdfce2c8dc8bca039525694d3a1a0297a...0c9f40f776e2be75656996e1bb1e5f37f903675f,2,6,6,12,2,2014-08-23 23:30:42,2014-08-23 23:30:14
0c9f40f776e2be75656996e1bb1e5f37f903675f...e39af5ea592bbe4e7a643e67f0c379adc10ed392,5,29,4,33,8,2014-08-23 23:32:58,2014-08-18 14:36:51
e39af5ea592bbe4e7a643e67f0c379adc10ed392...50ae4b4b9e146848ce0d95e76662ec0cf667fbe6,1,4,0,4,1,2014-08-24 17:33:36,2014-08-24 17:33:36
50ae4b4b9e146848ce0d95e76662ec0cf667fbe6...7d62fb5957dce7b51316079409b4311877f54bfe,4,8251,7535,15786,1483,2014-08-24 19:26:29,2014-08-23 19:41:58
7d62fb5957dce7b51316079409b4311877f54bfe...d074dfc0162709177601f090f636cad3aebb1072,1,578,578,1156,105,2014-08-25 00:13:34,2014-08-24 17:43:19
d074dfc0162709177601f090f636cad3aebb1072...e0cf030194dfeb6c27b21eabe6868f39e21cc66c,3,2,3,5,3,2014-08-25 14:07:14,2014-08-25 14:07:14
e0cf030194dfeb6c27b21eabe6868f39e21cc66c...4c85a0d95fa39f33c0f5335199a2e9d58a8736a9,1,2,0,2,1,2014-08-25 17:20:10,2014-08-25 17:17:13
7ca665c5f593953cba2cfeebd4f82acd38231031...90b64db39c4fd1243182068c3a54c3e08cd0f4b9,1,41,30,71,13,2014-08-15 19:17:18,2014-08-15 17:58:50
7ca665c5f593953cba2cfeebd4f82acd38231031...230393e5e81ff524a3ab8c476f75011d3ac53115,2,14,3,17,3,2014-08-15 18:59:36,2014-08-15 16:40:46
268670a3a40aac87ed8c5570a97ed01aa0f2c0ab...b6b873d2ada0d7c2a616d11f161a7688df15f45f,3,4,4,8,4,2014-05-17 16:54:34,2014-05-17 16:54:34
b6b873d2ada0d7c2a616d11f161a7688df15f45f...acb20016c0567876e7fc8144ecbe77905ee8388a,1,23,20,43,2,2014-05-17 18:42:58,2014-05-16 16:39:03
acb20016c0567876e7fc8144ecbe77905ee8388a...f7845449b44b5547115c0201795a6b8c1b594b0e,1,3,4,7,4,2014-05-17 18:42:58,2014-05-16 16:59:44
f7845449b44b5547115c0201795a6b8c1b594b0e...e3a9714ce3aa7433480672902a59e9ea803dc9de,1,8,0,8,8,2014-05-18 16:49:14,2014-03-24 08:40:01
e3a9714ce3aa7433480672902a59e9ea803dc9de...949ee521fab106b44218c30577eb55f0097d39cd,2,3,12,15,6,2014-05-18 18:27:35,2014-04-07 23:06:03
949ee521fab106b44218c30577eb55f0097d39cd...5a2556afb9b1b3ef6e0622552970c67ac84ecd28,1,2,1,3,1,2014-05-18 18:35:06,2014-05-18 18:34:32
5a2556afb9b1b3ef6e0622552970c67ac84ecd28...ec9043ab2f6027da709d1daf0df5599db6a77453,4,27,4,31,5,2014-05-18 19:52:07,2014-02-21 06:43:08
268670a3a40aac87ed8c5570a97ed01aa0f2c0ab...6aacb4c9915c83a897dbde0b11cc46131fc7d16e,1,17,3,20,5,2014-05-17 15:32:17,2014-05-16 16:11:29
6aacb4c9915c83a897dbde0b11cc46131fc7d16e...1d3d01b4f74f80655ac354f7a39e3908a9b41b14,3,146,2,148,7,2014-05-18 04:58:16,2014-05-18 04:58:16
1d3d01b4f74f80655ac354f7a39e3908a9b41b14...5789ff73302854e60e9c9ea77c60cc4912fd97a1,1,21,0,21,6,2014-05-18 05:46:12,2014-05-18 05:46:12
4c85a0d95fa39f33c0f5335199a2e9d58a8736a9...f42f54517dd53376a5d677204482bf4ce48531d1,1,9,3,12,4,2014-08-26 15:02:28,2014-08-26 15:02:28
4c85a0d95fa39f33c0f5335199a2e9d58a8736a9...5473c36cef38ee5cb964f8d55dcd85f2b5ad8386,1,3,4,7,1,2014-08-26 12:11:25,2014-08-24 03:01:13
5473c36cef38ee5cb964f8d55dcd85f2b5ad8386...cbdda28208c9c2aea479d5a482ff27bf37869d34,3,12,2,14,3,2014-08-26 12:20:31,2014-08-23 08:27:33
cbdda28208c9c2aea479d5a482ff27bf37869d34...2b66878a47f83bb543ee98e6a49f1f06327adf18,1,2,0,2,2,2014-08-26 13:44:07,2014-08-26 13:44:07
2b66878a47f83bb543ee98e6a49f1f06327adf18...a3e88e64a478ec7e43fd381b6ff2a76c28a7d38f,2,2,2,4,2,2014-08-26 13:44:24,2014-08-26 13:44:24
a3e88e64a478ec7e43fd381b6ff2a76c28a7d38f...035f2e699c3f7fbd41bc5ba0a59551e4c3dbdba6,1,1,1,2,1,2014-08-26 14:00:33,2014-08-26 14:00:33
035f2e699c3f7fbd41bc5ba0a59551e4c3dbdba6...e02f45d5ea767b0028ecf24bb5874992eb3ca7dd,1,25,0,25,1,2014-08-26 14:40:12,2014-08-26 14:35:32
e02f45d5ea767b0028ecf24bb5874992eb3ca7dd...5675eb371f8af55569602c2c6c6f275968b1ce3b,3,85,16,101,14,2014-08-26 18:03:37,2014-08-23 16:01:33
5675eb371f8af55569602c2c6c6f275968b1ce3b...60428ed5db76f509f4a0eb737d96b4f0ae6b0ad5,15,117,112,229,67,2014-08-26 18:08:00,2014-08-21 16:47:57
60428ed5db76f509f4a0eb737d96b4f0ae6b0ad5...348c89cbfbe3b9be6e759d8d5696d4fde1827d9b,1,9,0,9,1,2014-08-26 18:11:35,2014-08-26 18:11:35
348c89cbfbe3b9be6e759d8d5696d4fde1827d9b...a2bcec34918ba38a22b46aa5b24317c90fecf0b0,2,104,57,161,27,2014-08-26 18:31:13,2014-08-20 14:12:25
a2bcec34918ba38a22b46aa5b24317c90fecf0b0...ced3e303ca6c902c14d08b68806230ce04c71ff7,1,11,0,11,1,2014-08-26 18:50:17,2014-08-26 17:52:20
ced3e303ca6c902c14d08b68806230ce04c71ff7...cfee67ae100343f9e20f412a0b2c56e001d84eca,1,1,1,2,1,2014-08-26 19:10:54,2014-08-26 19:09:50
cfee67ae100343f9e20f412a0b2c56e001d84eca...7b9537fb270e46d9b89ead0c6dc9b9f68dc93131,1,5,0,5,1,2014-08-26 19:22:08,2014-08-26 19:22:08
7b9537fb270e46d9b89ead0c6dc9b9f68dc93131...5ecead9ab993d3939068740bf195e2fff281c8ab,1,9,13,22,3,2014-08-26 19:43:23,2014-08-26 19:43:23
5ecead9ab993d3939068740bf195e2fff281c8ab...00f8b4dfae1bd4b604c41776f5aabf1b46345722,1,2,2,4,2,2014-08-26 20:42:41,2014-08-26 20:41:42
00f8b4dfae1bd4b604c41776f5aabf1b46345722...905c4fdcc301cf7840202dcacd95b9265d57160b,1,1,1,2,1,2014-08-27 00:48:12,2014-08-26 23:39:07
905c4fdcc301cf7840202dcacd95b9265d57160b...215400480217dc868cb637f0081d6ba05859b956,1,1,1,2,1,2014-08-27 07:18:56,2014-08-27 07:18:56
215400480217dc868cb637f0081d6ba05859b956...83762da3fbc00fdb5c6cfbcd04e25ff00c599102,1,4,2,6,1,2014-08-27 11:43:13,2014-08-27 11:43:13
83762da3fbc00fdb5c6cfbcd04e25ff00c599102...6aae07fe619fb3a202f0f2cd74ef1c6e8872a672,1,3,0,3,1,2014-08-27 12:01:30,2014-08-27 12:01:30
6aae07fe619fb3a202f0f2cd74ef1c6e8872a672...a81af7f49de7ff3f51f111de28ed3a682f67ea89,6,28,0,28,7,2014-08-27 12:34:53,2014-08-26 11:10:30
a81af7f49de7ff3f51f111de28ed3a682f67ea89...f0d3dd4f04efa49e0b58da4847cb89770b59d4a8,4,6,3,9,5,2014-08-27 14:58:44,2014-08-26 05:22:55
f0d3dd4f04efa49e0b58da4847cb89770b59d4a8...4dd5c8581d89a9f8e1e34e14c682584e562bf8b1,1,6,4,10,1,2014-08-27 21:26:08,2014-08-27 16:37:33
4dd5c8581d89a9f8e1e34e14c682584e562bf8b1...19e6397f82e82438eb3047be0233aa2e555b3a12,1,0,2,2,1,2014-08-27 21:32:01,2014-08-27 21:32:01
19e6397f82e82438eb3047be0233aa2e555b3a12...3cbb7590cb0ece38f665b516db30cd5a9431f8c8,8,79,5,84,12,2014-08-28 01:26:53,2014-08-21 15:55:23
3cbb7590cb0ece38f665b516db30cd5a9431f8c8...3a44e20005e654affea89af49d82532d4d55e4a7,7,18,18,36,13,2014-08-28 06:44:26,2014-08-28 06:44:26
3a44e20005e654affea89af49d82532d4d55e4a7...c9c0be31c5d0adfe75316cdcff81e5b72bcf9b63,2,113,10,123,8,2014-08-28 14:48:39,2014-08-28 03:04:23
c9c0be31c5d0adfe75316cdcff81e5b72bcf9b63...191d953c99b2b437370612fb63b1247a4f543e5e,3,24,19,43,9,2014-08-28 15:58:16,2014-08-19 16:32:02
191d953c99b2b437370612fb63b1247a4f543e5e...2db1ed1033c0f542b3ffcbbb970d1b4dc881900f,3,26,1,27,4,2014-08-28 15:58:21,2014-08-19 16:44:10
2db1ed1033c0f542b3ffcbbb970d1b4dc881900f...1e404180c1bd3535987aba96d42030daab1e9c9f,2,22,6,28,3,2014-08-28 19:17:50,2014-08-28 18:12:49
1e404180c1bd3535987aba96d42030daab1e9c9f...569e0a299ddf484a694d26b283214d1e55f7283e,1,2,2,4,2,2014-08-28 19:30:20,2014-08-28 19:30:20
569e0a299ddf484a694d26b283214d1e55f7283e...efcbf3e095dce3491eb52774978afe3f7bbdf217,3,21,3,24,7,2014-08-28 23:18:34,2014-08-28 20:26:37
efcbf3e095dce3491eb52774978afe3f7bbdf217...e98c5513cb63ea8e1db28a3ea01b157fb11dfed1,1,4,2,6,2,2014-08-28 23:33:36,2014-08-28 23:33:36
e98c5513cb63ea8e1db28a3ea01b157fb11dfed1...909015a51b98749cabb0d13f8ea0bf58ec707fa3,1,6,1,7,1,2014-08-29 08:24:50,2014-08-29 08:22:59
909015a51b98749cabb0d13f8ea0bf58ec707fa3...bc06d2c11c32bde94b717a75bd3325ef1b94c902,4,24,9,33,7,2014-08-29 11:22:08,2014-08-17 14:21:48
bc06d2c11c32bde94b717a75bd3325ef1b94c902...cf337773063112d531b40bcb26740dd0b698291f,1,2,1,3,1,2014-08-29 11:27:15,2014-08-29 11:27:15
cf337773063112d531b40bcb26740dd0b698291f...045b8d32671f6fc19a4452d6e514d54c37834301,1,0,5,5,1,2014-08-29 13:20:13,2014-08-29 13:19:06
045b8d32671f6fc19a4452d6e514d54c37834301...e622caaa857e74cef4fe7757b6e5b802af814788,3,35,7,42,7,2014-08-29 13:40:08,2013-10-25 07:13:00
e622caaa857e74cef4fe7757b6e5b802af814788...149605dfb4309331d0337af9ac962e67332a45a7,1,1,0,1,1,2014-08-29 13:42:22,2014-08-29 13:42:22
149605dfb4309331d0337af9ac962e67332a45a7...eb2af16c59c3014541e2ad8ca63e510bc076dd8b,6,16,3,19,8,2014-08-29 14:12:03,2013-11-21 01:03:02
eb2af16c59c3014541e2ad8ca63e510bc076dd8b...2c0ec04225cb286a9bbd36b75a9b02fa0aca613b,1,1,1,2,1,2014-08-29 14:58:58,2014-08-29 14:58:58
2c0ec04225cb286a9bbd36b75a9b02fa0aca613b...7a8f405bba59982e6330885922b64d9cf88a67b4,1,8,9,17,3,2014-08-29 15:22:55,2014-08-29 15:22:55
7a8f405bba59982e6330885922b64d9cf88a67b4...4926c0afe3ff8f306f752b9ae45366cc8fd3e42c,1,4,0,4,1,2014-08-29 23:49:39,2014-08-29 21:23:13
4926c0afe3ff8f306f752b9ae45366cc8fd3e42c...135a58f9dc9dd121b8e3577538456fb15f63b897,1,2,2,4,2,2014-08-30 00:40:53,2014-08-30 00:40:53
135a58f9dc9dd121b8e3577538456fb15f63b897...05a8cef4288e2a85dbaff12bc2683a75c9998618,1,1,1,2,1,2014-08-30 03:10:30,2014-08-30 03:06:31
05a8cef4288e2a85dbaff12bc2683a75c9998618...66757fee7e921ad4c35e0b3f80c25e026100b31c,9,123,5,128,12,2014-08-30 10:37:10,2014-08-29 12:54:08
66757fee7e921ad4c35e0b3f80c25e026100b31c...6613ea6e3ff2597c04db35ef885562e95c1ef012,4,46,5,51,6,2014-08-30 11:14:44,2014-08-29 14:01:21
6613ea6e3ff2597c04db35ef885562e95c1ef012...eacf244506d8b7e6dd6483834ea122fec864da85,7,71,4,75,10,2014-08-30 11:27:56,2014-08-27 08:41:12
eacf244506d8b7e6dd6483834ea122fec864da85...df251e033c88e6b5982f490ed863aa96c057bc8c,1,1,1,2,1,2014-08-30 11:27:56,2014-08-30 11:06:33
df251e033c88e6b5982f490ed863aa96c057bc8c...3a297d78169b7d3c6d688cf0e349f4663acc6bad,2,34,1,35,3,2014-08-30 13:07:00,2014-08-28 20:15:18
3a297d78169b7d3c6d688cf0e349f4663acc6bad...502142179996e32e1c7f334c3d986f21115cfac8,2,12,1,13,2,2014-08-30 16:51:12,2014-08-30 16:48:55
502142179996e32e1c7f334c3d986f21115cfac8...8b6cb9d0ddc21e68a1c63b25ceb685151ef21e6f,1,1,1,2,1,2014-08-30 22:18:58,2014-08-30 22:18:58
8b6cb9d0ddc21e68a1c63b25ceb685151ef21e6f...032c091659666ea63f80f4c2d7f9b8bc72214f18,3,36,1,37,4,2014-08-31 07:03:53,2014-08-30 18:06:38
032c091659666ea63f80f4c2d7f9b8bc72214f18...21a9e8adf06d5c132f5f0411fc6a89144363dbf8,1,2,3,5,1,2014-08-31 16:30:50,2014-08-31 16:23:41
21a9e8adf06d5c132f5f0411fc6a89144363dbf8...ab9c886459e179a7741efd3be440653afe260dff,1,1,1,2,1,2014-09-01 00:06:38,2014-09-01 00:06:38
ab9c886459e179a7741efd3be440653afe260dff...be8ccc26488552123cd371645dcb4fd13c05fe80,2,4,1,5,2,2014-09-01 12:39:21,2014-08-27 15:18:23
be8ccc26488552123cd371645dcb4fd13c05fe80...a8521a2c228bd9e981dc8a2bea4e26f4544a52a7,1,3,15,18,2,2014-09-01 18:48:06,2014-09-01 18:48:06
a8521a2c228bd9e981dc8a2bea4e26f4544a52a7...03c1a6cb80ef03f16d60e4d34ed61b17497effd0,1,4,5,9,2,2014-09-01 23:33:26,2014-09-01 10:38:08
03c1a6cb80ef03f16d60e4d34ed61b17497effd0...e03b7940e564a6a88269b3030e43354baabcd669,2,35,2,37,3,2014-09-02 12:06:44,2014-09-01 09:30:00
e03b7940e564a6a88269b3030e43354baabcd669...e9264bc25d265ba1c8ff69517dea8c5ce6ad6df8,1,15,3,18,2,2014-09-02 12:12:19,2014-09-02 12:12:19
e9264bc25d265ba1c8ff69517dea8c5ce6ad6df8...4a303341fcec8e01cbd47d98bbe5520eabaa7d9e,1,2,0,2,1,2014-09-02 12:14:02,2014-09-02 05:59:05
4a303341fcec8e01cbd47d98bbe5520eabaa7d9e...b3752d410ab15bafbb09e477c5f8696bb2d4c871,2,6,6,12,4,2014-09-02 17:34:52,2014-08-27 14:29:49
9fef66ef7c3dbb156d0b235261ec499f81494eae...dfde0b3b063c0ec511fe6d58789468b6c229c59b,1,6,6,12,6,2014-08-16 11:32:33,2014-08-16 11:32:33
dfde0b3b063c0ec511fe6d58789468b6c229c59b...7ed3d0bb61f46f56b8a001b7b2d983eaf9a65466,1,3,1,4,2,2014-08-18 13:15:24,2014-08-18 13:15:24
7ed3d0bb61f46f56b8a001b7b2d983eaf9a65466...e0a98e2374b1d7660ef3841a5bb2626f1c69970a,4,57,5,62,4,2014-08-18 15:54:24,2014-08-17 22:29:49
ec9043ab2f6027da709d1daf0df5599db6a77453...5f24cf9705f567f081c2ec704034ef5425306eff,1,17,8,25,6,2014-05-18 23:05:19,2014-05-17 22:26:46
ec9043ab2f6027da709d1daf0df5599db6a77453...c7a4ae94a0e2c5001b303a59b856f58e5d53f679,2,4,4,8,4,2014-05-18 21:42:03,2014-05-18 21:42:03
4e32e47348473757280ca7a8d78edf6011fe65a3...125b3d440761efca8fa808a4b815384ece847d6a,3,8,10,18,6,2014-05-20 14:41:01,2014-05-20 14:41:01
125b3d440761efca8fa808a4b815384ece847d6a...03900a02d5fd2efd6ae98bdb9974b78146f63040,3,71,24,95,11,2014-05-20 15:25:59,2014-05-20 15:25:59
03900a02d5fd2efd6ae98bdb9974b78146f63040...12c72796c3a385f21bc97389bef91dcd4148c0f9,1,2,1,3,2,2014-05-20 15:53:21,2014-05-20 15:53:21
12c72796c3a385f21bc97389bef91dcd4148c0f9...3bec38888f6f4ee9245b004fcb9fe15b35cef469,2,45,3,48,7,2014-05-20 16:14:49,2014-05-16 13:40:57
58eb4ce002aaa0431cdcc3026527051ac2fa18d5...138e3873a53a4fcd17ddccaa2132ff1af82dc7a6,1,22,13,35,5,2014-09-02 20:17:46,2014-09-02 20:17:46
138e3873a53a4fcd17ddccaa2132ff1af82dc7a6...bda28097126c0ff77c51d598ccc19663bcd3ee95,1,2,1,3,1,2014-09-03 01:03:16,2014-09-03 01:01:13
bda28097126c0ff77c51d598ccc19663bcd3ee95...1435cfbe8dbd85c17c9a25af99f910c407dfa9bd,7,87,6,93,14,2014-09-03 01:09:18,2014-08-19 13:24:31
1435cfbe8dbd85c17c9a25af99f910c407dfa9bd...0fd23545dbbb8a738717cc0a55b2359f8c052dc1,3,3,3,6,3,2014-09-03 01:34:29,2014-09-03 01:34:29
0fd23545dbbb8a738717cc0a55b2359f8c052dc1...09c1f18f223cd60c948f7dae6aedccea70a92274,2,13,0,13,2,2014-09-03 01:41:21,2014-09-03 01:41:21
09c1f18f223cd60c948f7dae6aedccea70a92274...4db75925be90affaf49ffe5361b47a56762f93d0,1,1,1,2,1,2014-09-03 15:49:00,2014-09-03 03:27:36
4db75925be90affaf49ffe5361b47a56762f93d0...89559bcfb096ccc625e0e9ab41e2136fcb32a514,1,13,8,21,3,2014-09-03 18:25:11,2014-09-03 17:49:56
89559bcfb096ccc625e0e9ab41e2136fcb32a514...e9103402c0fa873aea58a6a11dba510cd308cb84,35,448,526,974,96,2014-09-03 19:36:03,2014-08-12 12:08:40
e9103402c0fa873aea58a6a11dba510cd308cb84...d7a9659110bbdab48d364c534d2bdd74a5f4aa36,1,7,7,14,6,2014-09-04 13:45:10,2014-09-04 13:34:59
d7a9659110bbdab48d364c534d2bdd74a5f4aa36...646b9ce8484261872924253d47adda5346d51afe,1,1,1,2,1,2014-09-04 14:23:32,2014-09-04 14:23:32
646b9ce8484261872924253d47adda5346d51afe...2ca244aae62d28e3fcf97c47fd7d5e3c89fd9c87,1,1,1,2,1,2014-09-04 16:31:33,2014-09-04 16:31:33
2ca244aae62d28e3fcf97c47fd7d5e3c89fd9c87...344f37718b23c1749484d25458ebfda5033e1beb,1,3,3,6,4,2014-09-05 01:04:53,2014-09-05 01:04:53
344f37718b23c1749484d25458ebfda5033e1beb...f8bb8436e533abad563b5235cf0e62e42dbc5f01,2,10,12,22,6,2014-09-05 13:12:14,2014-09-05 13:12:14
f8bb8436e533abad563b5235cf0e62e42dbc5f01...1101467ce0756272a54f4c7bc65c4c335a94111b,112,1244,417,1661,264,2014-09-05 13:22:16,2014-09-04 12:15:09
1101467ce0756272a54f4c7bc65c4c335a94111b...5d044339037be879a11b03fe8bd8c3ef1d520b1a,1,3,3,6,3,2014-09-05 16:30:24,2014-09-05 16:16:30
5d044339037be879a11b03fe8bd8c3ef1d520b1a...885ff6845e54511022677c1f28b84ddd4f2165dd,9,5,123,128,12,2014-09-05 18:06:02,2014-09-05 18:06:02
885ff6845e54511022677c1f28b84ddd4f2165dd...0f90f741de913a4502adc51063df77278d01a5ca,1,1,1,2,1,2014-09-05 18:28:46,2014-09-05 17:06:20
0f90f741de913a4502adc51063df77278d01a5ca...6d504562f5f27698a668759254101290b82e89b9,1,6,0,6,1,2014-09-05 18:39:55,2014-09-05 18:38:44
6d504562f5f27698a668759254101290b82e89b9...62939aba994390701a404830f047dbeeee2b84d0,1,0,7,7,1,2014-09-05 18:43:33,2014-09-05 18:43:33
62939aba994390701a404830f047dbeeee2b84d0...7a259008a76c5bcd6c1e5ba3a45d17a6184c4242,1,6,0,6,2,2014-09-05 18:59:56,2014-09-05 18:59:10
7a259008a76c5bcd6c1e5ba3a45d17a6184c4242...5c5011ce6892392e6fd2d900ec87a6c5287ae711,1,16,16,32,10,2014-09-05 19:44:41,2014-09-05 19:41:37
5c5011ce6892392e6fd2d900ec87a6c5287ae711...45768e6b72607b4bc913358c560830454f3336a7,1,3,2,5,2,2014-09-05 22:00:01,2014-09-05 21:58:44
813ded775d2491bc12b55b8dbbb4a2e591e9dd15...7999ed9b69b8f1a0aed035d56d9102ef7881643f,2,5,11,16,5,2014-05-19 07:30:26,2014-05-19 07:26:31
7999ed9b69b8f1a0aed035d56d9102ef7881643f...bfac6bef833d2520853c88188560b81bc7e3988d,1,8,5,13,3,2014-05-19 11:42:11,2014-05-19 07:33:12
bfac6bef833d2520853c88188560b81bc7e3988d...950b6de16ac2f8135612f2ed5984c090dd8e4dcf,11,103,9,112,7,2014-05-19 11:59:13,2014-05-19 05:23:45
950b6de16ac2f8135612f2ed5984c090dd8e4dcf...a1f0c4c697e8d848ce43ad8ce346a058f288db19,4,0,88,88,4,2014-05-19 12:13:01,2014-05-19 12:10:13
a1f0c4c697e8d848ce43ad8ce346a058f288db19...5abc811a40dbeee092b9f50055d229e9c24274fa,11,9,103,112,7,2014-05-19 12:22:46,2014-05-19 12:22:46
5abc811a40dbeee092b9f50055d229e9c24274fa...b68fac7e88c08cd0bb3dde86388292ddc863eba5,2,3,3,6,3,2014-05-19 12:35:44,2014-05-19 12:35:44
b68fac7e88c08cd0bb3dde86388292ddc863eba5...d20aa78cbfbefb255ee7f60038c4f090d2deeedc,1,6,4,10,4,2014-05-19 13:11:23,2014-05-19 13:11:11
d20aa78cbfbefb255ee7f60038c4f090d2deeedc...1a69d276bdc3009e42812071d06ba8c9dccc2104,14,1140,950,2090,632,2014-05-19 13:17:35,2014-05-19 13:17:35
1a69d276bdc3009e42812071d06ba8c9dccc2104...2f43229c2f044207f193e753baf1bd3fb6164da4,1,3,3,6,3,2014-05-19 13:50:23,2014-05-19 13:02:42
2f43229c2f044207f193e753baf1bd3fb6164da4...ecbabc216dd2fd30ee67ee75dd2a1d8a88e4f574,1,1,2,3,1,2014-05-19 13:57:06,2014-05-19 13:57:06
ecbabc216dd2fd30ee67ee75dd2a1d8a88e4f574...3b765029f04a43a2ba432936553e33d7c4a4ce29,1,1,1,2,1,2014-05-19 13:59:02,2014-05-19 13:59:02
3b765029f04a43a2ba432936553e33d7c4a4ce29...ba5ddf7aed542d25f0fdb25a04d87305de0f3972,4,9,18,27,6,2014-05-19 17:16:45,2014-05-17 09:29:08
45768e6b72607b4bc913358c560830454f3336a7...b878c73fc34e661e1cc30fc96171ce09918efced,2,35,25,60,2,2014-09-05 22:26:05,2014-09-05 22:26:05
ba5ddf7aed542d25f0fdb25a04d87305de0f3972...44304cf04e46cf7fa974571efd24716e03e05f94,1,22,22,44,2,2014-05-20 03:16:36,2014-05-20 03:16:36
2145a7782a2a0a4902b3cc4bc769010d4e2c337a...3ab36d00462ed2f0563ad9f4dd3be23e3567d481,1,1,1,2,1,2014-09-05 22:47:20,2014-09-05 22:47:20
3ab36d00462ed2f0563ad9f4dd3be23e3567d481...fb545e5a27369570076d0d34626f3c7e916ee2e4,1,5,0,5,1,2014-09-05 23:59:02,2014-09-05 20:19:03
fb545e5a27369570076d0d34626f3c7e916ee2e4...f7d3a6255c7ae3beb9ccdf6d20f6598061cd1bff,1,1,1,2,1,2014-09-06 00:05:51,2014-09-05 23:10:00
f7d3a6255c7ae3beb9ccdf6d20f6598061cd1bff...77b3907d6dcd5ab0da01a782bb4b94bd6ca82b63,1,7,13,20,3,2014-09-06 00:36:35,2014-09-05 23:41:47
77b3907d6dcd5ab0da01a782bb4b94bd6ca82b63...0f0a5c07f9f0f4d18d4c048ed6d9554965f79d5b,1,2,1,3,1,2014-09-06 00:38:50,2014-09-06 00:32:31
0f0a5c07f9f0f4d18d4c048ed6d9554965f79d5b...88c4e01d343f6b9165b086adbfe6664885229b00,1,25,11,36,11,2014-09-06 11:31:36,2014-09-06 11:31:36
88c4e01d343f6b9165b086adbfe6664885229b00...7353e26d5d41563ca51520fb38b5950530cb6b9c,2,53,4,57,4,2014-09-06 11:47:56,2014-09-05 23:55:24
7353e26d5d41563ca51520fb38b5950530cb6b9c...0a2bc6e6bd29ccfbed86c58835c68c349c5a6757,1,7,4,11,4,2014-09-06 11:59:27,2014-09-06 11:59:27
0a2bc6e6bd29ccfbed86c58835c68c349c5a6757...0e4d79c4f0591da3d2b0cf030cb8a79abe482345,2,5,0,5,2,2014-09-06 14:07:34,2014-09-06 14:07:34
0e4d79c4f0591da3d2b0cf030cb8a79abe482345...fa74dba994bb3e70839623073a6ab5dfc815a9b3,1,1,1,2,1,2014-09-06 15:13:45,2014-09-06 15:13:45
fa74dba994bb3e70839623073a6ab5dfc815a9b3...dfe209a0c0801855cd8157199cb3bb31e5be11ce,1,16,0,16,1,2014-09-06 17:02:06,2014-09-06 17:02:06
dfe209a0c0801855cd8157199cb3bb31e5be11ce...0707fbc73fe553883d5ee8c1c4d79287d29c3809,1,9,11,20,2,2014-09-06 17:20:56,2014-09-06 17:20:56
0707fbc73fe553883d5ee8c1c4d79287d29c3809...a4ab0495cc28285fc4ba16c0f83b9277e99ad0a4,1,1,8,9,2,2014-09-06 17:32:10,2014-09-06 17:32:10
a4ab0495cc28285fc4ba16c0f83b9277e99ad0a4...e5febfb3c3873e535be1cde047a1f738922564d5,1,12,12,24,2,2014-09-06 17:44:17,2014-09-06 17:44:17
e5febfb3c3873e535be1cde047a1f738922564d5...14c8456ffe7e6388383e6fe5c3f51cd20810ea49,4,21,1,22,5,2014-09-06 18:01:06,2014-09-04 15:32:51
14c8456ffe7e6388383e6fe5c3f51cd20810ea49...0b5bd398fa8fb145112f5664e6742dacbf25ae85,2,9,3,12,2,2014-09-06 23:13:29,2014-09-06 23:10:03
0b5bd398fa8fb145112f5664e6742dacbf25ae85...f36ab2d3f220a001745c6b7cd1712dd8415aa31c,1,1,1,2,1,2014-09-07 09:29:20,2014-09-07 09:29:20
f36ab2d3f220a001745c6b7cd1712dd8415aa31c...4680d25df23875bced0f17d361782bda80ce79d6,3,28,1,29,3,2014-09-08 11:39:09,2014-09-06 00:07:42
4680d25df23875bced0f17d361782bda80ce79d6...60c38c1a4e482ef86465c9ac40e0b47af175ffa7,2,7,3,10,4,2014-09-08 12:45:47,2014-09-08 12:41:59
60c38c1a4e482ef86465c9ac40e0b47af175ffa7...638d1393eebfdd4ae360cf1b279d4a0c3072aba5,1,2,2,4,2,2014-09-08 14:11:20,2014-09-07 02:26:05
638d1393eebfdd4ae360cf1b279d4a0c3072aba5...5f3806b8612efca45dba1a75b29ad1bbbc12a7ca,1,13,8,21,3,2014-09-08 17:22:15,2014-09-06 20:58:26
5f3806b8612efca45dba1a75b29ad1bbbc12a7ca...cbbc7131c1cb0ed40280198a5dad8f5e8023f774,1,2,2,4,1,2014-09-08 17:44:03,2014-09-08 17:42:18
cbbc7131c1cb0ed40280198a5dad8f5e8023f774...342ccbddc1f2362f867e030befaeb10449cf4539,9,85,4,89,15,2014-09-08 17:49:07,2014-09-04 21:04:53
342ccbddc1f2362f867e030befaeb10449cf4539...f9419a6dc0bd0c1ec3c6b4176a1fa8cadc755cf4,1,2,2,4,1,2014-09-08 17:56:46,2014-09-08 17:54:34
f9419a6dc0bd0c1ec3c6b4176a1fa8cadc755cf4...d28b5f13b332bda4317949b98e33f528d30ec006,3,33,3,36,6,2014-09-08 19:27:34,2014-09-08 01:01:42
d28b5f13b332bda4317949b98e33f528d30ec006...d4467ede7730e0dc7a703f6865ec9ce9c7580d5f,1,7,6,13,1,2014-09-08 19:32:32,2014-09-08 12:15:33
d4467ede7730e0dc7a703f6865ec9ce9c7580d5f...aa399f6b8bf55cd02f99ef3c55b61482e2f74014,2,4,4,8,2,2014-09-08 20:23:44,2014-09-08 19:06:13
aa399f6b8bf55cd02f99ef3c55b61482e2f74014...16548cfc7c9d86ae7b0d13425ec7608f0571130c,1,1,1,2,1,2014-09-08 20:49:06,2014-09-08 20:01:58
16548cfc7c9d86ae7b0d13425ec7608f0571130c...d3543af7509d01f396997f13ab3c3b391839a511,1,3,3,6,3,2014-09-08 21:10:58,2014-09-08 21:10:58
d3543af7509d01f396997f13ab3c3b391839a511...b161c01c48b4c353d7d1a47e9097391a8eb2e047,3,21,7,28,5,2014-09-08 21:16:50,2014-08-31 16:51:55
b161c01c48b4c353d7d1a47e9097391a8eb2e047...f7eee04ebe32277d2f3d7860abfb9a22c6ccf19d,3,10,1,11,3,2014-09-08 21:22:23,2014-09-08 19:54:57
f7eee04ebe32277d2f3d7860abfb9a22c6ccf19d...5cba975d26d10ff5d85e123fb2084671a009cc9b,1,1,0,1,1,2014-09-08 21:28:55,2014-09-08 21:28:55
5cba975d26d10ff5d85e123fb2084671a009cc9b...2508be35ca8bc5440b93d3152cd80ee5f8e159e3,1,8,16,24,2,2014-09-08 23:31:21,2014-09-08 23:31:21
2508be35ca8bc5440b93d3152cd80ee5f8e159e3...c7f7432be54695ea16a2ba1cc5f8e5e1facf43f7,1,13,4,17,5,2014-09-09 13:32:19,2014-09-09 13:32:19
c7f7432be54695ea16a2ba1cc5f8e5e1facf43f7...e5ae03fd5a887a7038fb6878ffeec85b92829d1b,1,1,1,2,1,2014-09-09 14:00:01,2014-09-09 14:00:01
e5ae03fd5a887a7038fb6878ffeec85b92829d1b...c32bc1a7a7bbb3d5bd0a2c11bc77dd5ab1c32fbc,5,70,15,85,7,2014-09-09 15:05:31,2014-09-09 12:29:49
c32bc1a7a7bbb3d5bd0a2c11bc77dd5ab1c32fbc...c53f2451a83fc081c1886d07c390cf0447b1143f,2,38,1,39,3,2014-09-09 16:29:30,2014-09-05 20:27:26
c53f2451a83fc081c1886d07c390cf0447b1143f...d26199cb70ffc60fc1f54b87fd0723f62fe793e0,1,4,2,6,2,2014-09-09 18:27:05,2014-09-09 18:26:03
d26199cb70ffc60fc1f54b87fd0723f62fe793e0...9562ffea9719f2b1795e676718c6d433a1f8d4ed,5,12,14,26,8,2014-09-09 18:55:57,2014-09-08 19:16:59
9562ffea9719f2b1795e676718c6d433a1f8d4ed...4b8a1d2c0d1a8c5107f3aef01597db78d2a2a5ce,2,32,15,47,6,2014-09-09 19:58:07,2014-06-26 19:14:30
4b8a1d2c0d1a8c5107f3aef01597db78d2a2a5ce...b9d9287f59eb5c33dd8bc81179b4cf197fd54456,3,48,8,56,9,2014-09-09 19:59:35,2014-08-09 10:44:48
07b6404d2245519fd88c2d51b4455ed099d3a1f0...b8c480a12b16e625dd1229db6b48cd6074a22507,2,3,11,14,3,2014-05-20 10:21:05,2014-05-20 10:19:40
b8c480a12b16e625dd1229db6b48cd6074a22507...a4737bf6ae36a5f1cb29f2232f6deeff084fabff,1,1,2,3,2,2014-05-20 12:19:17,2014-05-20 12:19:17
a4737bf6ae36a5f1cb29f2232f6deeff084fabff...1b07781292c2cef9367b521dc0f2b40f4d363083,2,5,2,7,3,2014-05-20 12:27:07,2014-05-20 12:27:07
b9d9287f59eb5c33dd8bc81179b4cf197fd54456...b4d486c80ff6bdfaec8f85e724b44ce5e74a5bb6,1,3,1,4,1,2014-09-09 21:52:44,2014-09-09 21:52:44
aa4d10d9192c1681d33b08b636fe1bd86f126bf5...df7187d7957f7b94d6f5207e00218a23fe93212e,2,30,14,44,3,2014-09-10 00:48:33,2014-08-26 17:39:41
df7187d7957f7b94d6f5207e00218a23fe93212e...a4c23f70deda5321687cd1f759c65a35d161e793,1,3,3,6,1,2014-09-10 00:57:26,2014-09-10 00:57:26
a4c23f70deda5321687cd1f759c65a35d161e793...ef8ef2a42d4a168cf34daa3c2d795095c0414745,1,1,1,2,1,2014-09-10 08:44:12,2014-09-10 08:44:12
ef8ef2a42d4a168cf34daa3c2d795095c0414745...6d5958c7a358d8ad0037fdd4922a65e19d12d77c,4,62,14,76,11,2014-09-10 11:54:16,2014-09-09 21:28:45
6d5958c7a358d8ad0037fdd4922a65e19d12d77c...1ac32e76ac14323eef70142f57b8d7a3a192a829,5,142,57,199,9,2014-09-10 13:07:07,2014-09-04 16:35:44
1ac32e76ac14323eef70142f57b8d7a3a192a829...61f56e239f6747589046a3da9c294860e0ff1196,2,6,4,10,4,2014-09-10 14:32:33,2014-09-10 13:54:28
61f56e239f6747589046a3da9c294860e0ff1196...00535e8e6b402cab29ea3dbb7b4cc470f9839678,7,87,4,91,13,2014-09-10 15:14:20,2014-05-18 07:56:55
00535e8e6b402cab29ea3dbb7b4cc470f9839678...e265112cd11c40b43ef8cf255ac5280e4d2e182a,1,1,1,2,1,2014-09-10 15:17:33,2014-09-10 15:17:33
e265112cd11c40b43ef8cf255ac5280e4d2e182a...96010ae15bc2ce6b6a73a224da04fde94242a10d,1,1,1,2,1,2014-09-10 16:26:15,2014-09-10 16:26:15
96010ae15bc2ce6b6a73a224da04fde94242a10d...fbeb7979ee43cb386265ff7aec757e35b4cf61f8,1,1,0,1,1,2014-09-10 17:07:40,2014-09-10 17:07:40
fbeb7979ee43cb386265ff7aec757e35b4cf61f8...cc5e81c46d3e2d05ae06bda19995cdff3fc328fd,1,7,1,8,2,2014-09-10 17:25:40,2014-09-10 17:25:40
cc5e81c46d3e2d05ae06bda19995cdff3fc328fd...9a5fe5b29fd431431a53da63ad8825d878ee5878,1,4,4,8,2,2014-09-10 17:30:04,2014-09-10 17:30:04
9a5fe5b29fd431431a53da63ad8825d878ee5878...c5b4145fca75282b79848e0ff02a5aa4378770c7,1,3,2,5,1,2014-09-11 19:37:16,2014-09-11 19:37:16
c5b4145fca75282b79848e0ff02a5aa4378770c7...66580fe97c0ec8fe16ce7ff7f75a67c7f2340f83,4,39,2,41,9,2014-09-11 20:09:23,2014-09-09 17:34:40
66580fe97c0ec8fe16ce7ff7f75a67c7f2340f83...ce078ef976d83395dc19c9a1576529a5a0678514,4,32,3,35,7,2014-09-12 06:48:38,2014-08-04 16:14:45
ce078ef976d83395dc19c9a1576529a5a0678514...b011afe6c86951a71313c106dce6639c647f6c95,1,1,1,2,1,2014-09-12 18:31:22,2014-09-12 18:31:22
b011afe6c86951a71313c106dce6639c647f6c95...8f334e55be99ae271d82f9b961a2dc6258487d9c,7,7,7,14,7,2014-09-12 18:45:59,2014-09-12 18:45:59
8f334e55be99ae271d82f9b961a2dc6258487d9c...52ef6a47269a455113d95992f868939131f9c10c,24,1639,23,1662,50,2014-09-12 19:05:23,2014-09-12 18:50:36
52ef6a47269a455113d95992f868939131f9c10c...9c8c28f6f4690814997b5a04ad29938798dd4333,1,11,0,11,1,2014-09-12 19:25:21,2014-09-12 19:25:21
9c8c28f6f4690814997b5a04ad29938798dd4333...5e32605ce9baebf07b741c9235ea6351d565ce10,2,22,0,22,2,2014-09-12 20:58:54,2014-09-12 20:11:09
5e32605ce9baebf07b741c9235ea6351d565ce10...afa119918c5584e7ca169c80720fd11d8b3436d0,1,3,0,3,1,2014-09-12 21:45:08,2014-09-12 21:45:08
afa119918c5584e7ca169c80720fd11d8b3436d0...08042f1a73ce6b0feca7a80fc6afc121928b8702,1,3,0,3,1,2014-09-13 13:21:52,2014-09-13 13:21:52
08042f1a73ce6b0feca7a80fc6afc121928b8702...0ae79014c09f4ddd2575f53371d994773d0bd43c,1,5,1,6,2,2014-09-13 13:23:00,2014-09-13 13:23:00
0ae79014c09f4ddd2575f53371d994773d0bd43c...5472d18e3193050f5b9a25b71852ca7b77f852a5,6,34,26,60,10,2014-09-13 13:33:21,2014-09-13 02:46:22
5472d18e3193050f5b9a25b71852ca7b77f852a5...22bfc451467ec6e13044a87a97cf00e9f8a845e4,52,101,98,199,73,2014-09-13 17:00:42,2014-09-11 12:43:49
22bfc451467ec6e13044a87a97cf00e9f8a845e4...e1424b237003723c12400b5e1cfd95c87650e62b,2,17,8,25,5,2014-09-13 17:06:21,2014-09-02 17:23:51
e1424b237003723c12400b5e1cfd95c87650e62b...6072f17d09cbe8b7cecfbfa1a253d0a4f2152170,1,18,40,58,6,2014-09-13 19:34:37,2014-06-20 12:32:11
6072f17d09cbe8b7cecfbfa1a253d0a4f2152170...6426928f5665953b93f6887e9bf9eadfb03489b6,1,1,1,2,1,2014-09-14 00:20:01,2014-09-14 00:20:01
6426928f5665953b93f6887e9bf9eadfb03489b6...8ed7834fb2830364b590b6fa6453efc8129ed0d5,1,1,1,2,1,2014-09-15 00:31:10,2014-08-13 13:55:24
8ed7834fb2830364b590b6fa6453efc8129ed0d5...021f963e2382a60de3ba41293ff718402671a1b3,1,9,9,18,2,2014-09-15 10:41:58,2014-09-15 10:41:58
021f963e2382a60de3ba41293ff718402671a1b3...abcf28a07695a45cb5fb15b81bffc97bea5e0be3,8,83,5,88,6,2014-09-15 18:56:59,2014-09-15 16:17:28
abcf28a07695a45cb5fb15b81bffc97bea5e0be3...0d1561d19739e83cf20150585c9e26894b428bad,1,1,0,1,1,2014-09-16 00:27:52,2014-09-16 00:27:52
0d1561d19739e83cf20150585c9e26894b428bad...ed7821231b7dbf34a6c8ca65be3b9bcbda4a0703,17,274,4,278,33,2014-09-16 09:08:09,2014-07-15 09:35:29
ed7821231b7dbf34a6c8ca65be3b9bcbda4a0703...d63ac5b595694c44ed8a64d782a177d2f92125d9,2,14,0,14,3,2014-09-16 10:19:00,2014-09-16 10:17:33
d63ac5b595694c44ed8a64d782a177d2f92125d9...92a8213fdbb6f7612847f3d803a9f91d0f9d6392,1,2,0,2,1,2014-09-16 12:32:23,2014-09-16 12:32:23
92a8213fdbb6f7612847f3d803a9f91d0f9d6392...82a5ce801b1ed2a61016541b0fe3a40f5bfc89c2,2,5,1,6,4,2014-09-16 12:38:51,2014-09-16 12:38:51
82a5ce801b1ed2a61016541b0fe3a40f5bfc89c2...a0dfef02df258d530c9d2d235a4a0bbd76e13d16,1,73,78,151,5,2014-09-16 17:12:33,2014-09-16 17:12:33
a0dfef02df258d530c9d2d235a4a0bbd76e13d16...ab8248361e0a7b4fc7684eaaa5891e16b8562683,1,4,4,8,2,2014-09-17 07:21:33,2014-09-17 03:30:11
ab8248361e0a7b4fc7684eaaa5891e16b8562683...54fd84e43230bc739160b680c5ba51542e2e6e7d,1,3,1,4,2,2014-09-17 12:37:27,2014-09-17 12:37:27
54fd84e43230bc739160b680c5ba51542e2e6e7d...0eb5cde9da3252fbdbbb59ae6e421ca04814ad3c,3,120,45,165,17,2014-09-17 13:55:33,2014-08-26 05:54:37
0eb5cde9da3252fbdbbb59ae6e421ca04814ad3c...023a3d99156b458e0a8b0cb039aeca485066be07,2,3,3,6,2,2014-09-17 15:11:10,2014-09-17 15:11:10
023a3d99156b458e0a8b0cb039aeca485066be07...fc2b8ddcc8a0d68dcd333a77314c816469ba96af,2,36,39,75,32,2014-09-17 15:15:44,2014-09-17 08:43:45
fc2b8ddcc8a0d68dcd333a77314c816469ba96af...7fce7f51eff58b86b97cb797546da57096c0a786,2,9,0,9,3,2014-09-17 19:33:50,2014-09-17 19:33:50
7fce7f51eff58b86b97cb797546da57096c0a786...d8ee13789b93c8edcf13bf1b20ab9e0098eb81bd,1,5,1,6,1,2014-09-17 21:35:11,2014-09-17 21:34:28
d8ee13789b93c8edcf13bf1b20ab9e0098eb81bd...6c1a0581abd9cf21fa37c6c9e9937986da45005c,5,8,4,12,5,2014-09-18 11:28:05,2014-09-17 19:55:34
6c1a0581abd9cf21fa37c6c9e9937986da45005c...33e817a6d8b163aa6e8a2fb15d7269d1ecbbcf59,3,10,3,13,4,2014-09-18 11:32:51,2014-09-17 21:58:20
33e817a6d8b163aa6e8a2fb15d7269d1ecbbcf59...8facb02faf1880187888b26724760865547b05b0,1,2,2,4,4,2014-09-18 13:00:55,2014-09-17 23:45:42
8facb02faf1880187888b26724760865547b05b0...ad491ecc6e20569a4f5c30a671a935f5c766a295,3,17,0,17,5,2014-09-18 14:48:28,2014-09-17 17:56:56
ad491ecc6e20569a4f5c30a671a935f5c766a295...7fc13178d6b0e4b365c43991a6661c6b2118a3a9,1,1,1,2,1,2014-09-18 16:42:55,2014-09-18 16:41:58
7fc13178d6b0e4b365c43991a6661c6b2118a3a9...4dcfacb5b92dc06c4a351119cf501d842d46d192,3,12,4,16,4,2014-09-18 16:56:31,2014-09-18 16:54:38
4dcfacb5b92dc06c4a351119cf501d842d46d192...abc11b0a33fd823ad341ab2cc113c73545eb61e6,2,33,10,43,5,2014-09-18 18:00:35,2014-09-18 16:11:37
abc11b0a33fd823ad341ab2cc113c73545eb61e6...e008a10c2ffef7d64100bcbe83ef2c5f4b1b2168,2,16,8,24,6,2014-09-18 18:01:31,2014-09-06 22:13:46
e008a10c2ffef7d64100bcbe83ef2c5f4b1b2168...47ff469057f168a08c4d90708c701b91a70b5fd0,1,1,1,2,1,2014-09-19 11:05:20,2014-09-19 11:05:20
47ff469057f168a08c4d90708c701b91a70b5fd0...185ab9ffefcf81378d7da02dddca0a59487b9613,3,14,2,16,3,2014-09-19 11:51:42,2014-09-18 19:44:37
185ab9ffefcf81378d7da02dddca0a59487b9613...9d30412a5ad1c72b3d319b4c2bceacb53a0ff1da,4,5,5,10,4,2014-09-19 16:31:15,2014-09-19 16:31:15
9d30412a5ad1c72b3d319b4c2bceacb53a0ff1da...7add30df01f46ec91b8da411620a0f1a117c1b73,1,4,2,6,1,2014-09-19 18:38:58,2014-09-19 14:03:38
7add30df01f46ec91b8da411620a0f1a117c1b73...828edc5ba91e124392417c5a87c17647dbb1cf67,1,2,0,2,1,2014-09-19 19:03:55,2014-09-19 19:03:55
828edc5ba91e124392417c5a87c17647dbb1cf67...b88e31348b5abe535b220fcea774709fbb67d3d4,1,2,2,4,2,2014-09-20 05:58:49,2014-09-20 05:58:49
79d41bd91cf15ce048401dd16e71e43666089b0c...d18579d21910d9e6d2a664cbaf9719785b1d0c7f,1,7,9,16,6,2014-09-20 17:23:22,2014-09-20 14:55:54
d18579d21910d9e6d2a664cbaf9719785b1d0c7f...5bf654e44b7473a2a4c284d0a4c47585d19f3a46,1,6,4,10,1,2014-09-21 14:00:19,2014-09-21 14:00:19
5bf654e44b7473a2a4c284d0a4c47585d19f3a46...11f307a5a8fa66605652e0496c7385e584bfcad7,2,21,6,27,4,2014-09-21 15:08:17,2014-09-07 11:56:34
11f307a5a8fa66605652e0496c7385e584bfcad7...aeb48b9bc5b78563b1d4d7ed43a33535dd4ff751,1,2,2,4,2,2014-09-21 15:28:37,2014-09-21 15:28:37
aeb48b9bc5b78563b1d4d7ed43a33535dd4ff751...ee442e97da390b7136dc12b66ddfa70263a60b5c,1,8,8,16,6,2014-09-21 15:31:13,2014-09-21 15:15:44
ee442e97da390b7136dc12b66ddfa70263a60b5c...b9b8895acb4f5652fcb97525d0683afad5615406,4,6,6,12,6,2014-09-21 16:03:31,2014-09-21 15:30:18
b9b8895acb4f5652fcb97525d0683afad5615406...21819e6dbf422fe3ebe23cc006c0ef7bfc5c73de,1,3,1,4,1,2014-09-21 16:32:19,2014-09-21 15:46:01
21819e6dbf422fe3ebe23cc006c0ef7bfc5c73de...c9a53035d61588bc7c76eb38db74b774d64b5c1c,1,1,94,95,2,2014-09-22 10:18:08,2014-09-22 09:21:01
c9a53035d61588bc7c76eb38db74b774d64b5c1c...c6fd1e904cb15da1a627843c79b89b19beabe2a1,4,18,3,21,6,2014-09-22 12:10:03,2014-09-21 07:51:59
c6fd1e904cb15da1a627843c79b89b19beabe2a1...903d144d85f5d25c4968dc41bd5a5ea9434a9703,2,24,23,47,5,2014-09-22 16:04:57,2014-09-22 10:37:07
903d144d85f5d25c4968dc41bd5a5ea9434a9703...24aa85cea9d741fcbc288f12f59e22f1d05f79d7,1,6,5,11,1,2014-09-22 19:22:25,2014-09-22 13:40:11
24aa85cea9d741fcbc288f12f59e22f1d05f79d7...37b13033c61d24045b8182944c0964fffc8ff7d0,8,8,8,16,8,2014-09-22 19:49:48,2014-09-21 17:58:44
37b13033c61d24045b8182944c0964fffc8ff7d0...7fe554b2a3d72d0142e5c9e97efbd0a672c2d790,5,297,347,644,20,2014-09-22 20:56:19,2014-09-22 17:15:20
7fe554b2a3d72d0142e5c9e97efbd0a672c2d790...d42a45de407c7d7962aa7a2dd79f7d32b423e600,5,66,130,196,12,2014-09-22 20:56:19,2014-09-22 18:07:30
d42a45de407c7d7962aa7a2dd79f7d32b423e600...0dab07e5da43f8965db24adc4363cec01944de4d,5,86,109,195,10,2014-09-22 20:56:19,2014-09-22 18:23:34
0dab07e5da43f8965db24adc4363cec01944de4d...3c6ac0bab8bfaf1f1bb79a8b6a7a36533666908c,5,95,107,202,8,2014-09-23 12:45:59,2014-09-23 12:45:59
3c6ac0bab8bfaf1f1bb79a8b6a7a36533666908c...0bea6c8749d035f7b915d670946793630b8c86c5,1,46,110,156,16,2014-09-23 13:24:32,2014-09-16 10:46:50
0bea6c8749d035f7b915d670946793630b8c86c5...83cd18633fb13924d8a50a1cd4ed21cb9552a635,3,59,6,65,8,2014-09-23 13:25:31,2014-09-16 17:37:18
83cd18633fb13924d8a50a1cd4ed21cb9552a635...463952d94014ac2ea70a96828ddbf1330b504fc7,3,25,0,25,3,2014-09-23 14:03:37,2014-09-17 05:34:10
463952d94014ac2ea70a96828ddbf1330b504fc7...b8cdc7dcc3fc6897fb2a75f90023f5c67aad327f,5,40,26,66,17,2014-09-23 18:13:31,2014-09-20 19:34:23
b8cdc7dcc3fc6897fb2a75f90023f5c67aad327f...ed297061a676e629983664031d77da1d0a70af7d,3,28,7,35,9,2014-09-23 18:13:31,2014-09-20 22:00:52
ed297061a676e629983664031d77da1d0a70af7d...2a1bdf5ced3f22c2ff687afab45d811cfa555e74,5,10,10,20,9,2014-09-23 18:13:31,2014-09-20 22:29:13
2a1bdf5ced3f22c2ff687afab45d811cfa555e74...1fd6e13bf2db025dc93482184439cc1a900db276,10,244,276,520,13,2014-09-23 19:03:12,2014-09-23 16:29:17
1fd6e13bf2db025dc93482184439cc1a900db276...e043aae9bb2e3fa244f59b07fc16f57476cb80ff,3,90,15,105,8,2014-09-23 19:03:12,2014-09-23 17:41:32
e043aae9bb2e3fa244f59b07fc16f57476cb80ff...729cd6a11a6f14b56bfc2551834b4e0892142b12,1,5,1,6,3,2014-09-23 23:51:14,2014-09-23 23:51:14
729cd6a11a6f14b56bfc2551834b4e0892142b12...a1709220d527385378e128949da4140709758d00,1,2,2,4,2,2014-09-24 00:47:08,2014-09-24 00:47:08
a1709220d527385378e128949da4140709758d00...d128eac316dd5a8578fbae506028a3f2ade49420,4,58,7,65,9,2014-09-24 01:58:33,2014-09-21 17:15:48
d128eac316dd5a8578fbae506028a3f2ade49420...2f3a4cd573166e6b7bac9ed89d448ca34ab93edf,35,35,35,70,35,2014-09-24 10:28:56,2014-09-24 05:13:13
2f3a4cd573166e6b7bac9ed89d448ca34ab93edf...cf43a1ee909ab5dbca5b6a40247cd093a3e2ac8d,3,66,3,69,4,2014-09-24 10:32:42,2014-09-22 21:29:44
cf43a1ee909ab5dbca5b6a40247cd093a3e2ac8d...0aca91cf7f0ec6547659a9404f139a0c9ba280a1,2,2,1,3,2,2014-09-24 10:32:42,2014-09-24 10:31:42
0aca91cf7f0ec6547659a9404f139a0c9ba280a1...b9a670b22799a44fe7d3467d1d21949f9f717593,4,25,5,30,7,2014-09-24 11:20:57,2014-09-23 21:17:00
b9a670b22799a44fe7d3467d1d21949f9f717593...21683011d5b46806d12106a3079b704ed41cd261,1,6,4,10,1,2014-09-24 17:04:11,2014-09-24 13:57:07
21683011d5b46806d12106a3079b704ed41cd261...450a61600407d7320b85b75b441ce67b199da68b,1,3,3,6,2,2014-09-24 17:29:07,2014-09-24 17:29:07
450a61600407d7320b85b75b441ce67b199da68b...066e672d79ceb416ac87e51c8fa400221fa8604f,1,12,2,14,4,2014-09-24 18:19:11,2014-09-24 17:07:56
066e672d79ceb416ac87e51c8fa400221fa8604f...c692e37b6350171ee2e04b3e7090babf34ac140b,1,8,0,8,1,2014-09-24 18:32:49,2014-09-24 17:08:45
c692e37b6350171ee2e04b3e7090babf34ac140b...a4f23eba2e690f1331fe35d6f29af42899e80395,5,90,33,123,10,2014-09-24 18:46:10,2014-09-15 15:17:12
a4f23eba2e690f1331fe35d6f29af42899e80395...d7ab2cefb7ec94bf45d37a02c79b6703ea2880e5,6,5,66,71,4,2014-09-24 19:49:30,2014-09-24 19:49:30
d7ab2cefb7ec94bf45d37a02c79b6703ea2880e5...49e693c8137d260906608f585dfb177255ab9322,1,12,1,13,2,2014-09-25 02:45:03,2014-09-25 02:45:03
49e693c8137d260906608f585dfb177255ab9322...ac2e7f08d824a2586933697b9a121dbbc42ee640,1,18,18,36,16,2014-09-25 11:19:23,2014-09-24 16:44:58
ac2e7f08d824a2586933697b9a121dbbc42ee640...9f576dd54fafdd76aa250f8947cc76c7ae19216c,1,3,1,4,1,2014-09-25 11:19:23,2014-09-24 16:58:00
9f576dd54fafdd76aa250f8947cc76c7ae19216c...e077c29155e5ecb1ff24eb61d30c99505797e84d,3,27,3,30,5,2014-09-25 11:44:22,2014-09-20 14:38:37
e077c29155e5ecb1ff24eb61d30c99505797e84d...3a463995433a380c9421eeece90b977e91bacc5b,1,0,2,2,1,2014-09-25 12:18:03,2014-09-25 12:18:03
3a463995433a380c9421eeece90b977e91bacc5b...5066fda34d88a61211c204617996297af9fbb119,1,3,3,6,1,2014-09-25 13:09:12,2014-09-25 13:09:12
5066fda34d88a61211c204617996297af9fbb119...215aa4f53b6bbd07d5c1eecfa94e7fcd00da813e,3,89,47,136,26,2014-09-25 14:25:03,2014-09-08 00:26:12
215aa4f53b6bbd07d5c1eecfa94e7fcd00da813e...74e7f91e6de11bc41ecba5d0b2e1b78d03865d32,8,132,4,136,14,2014-09-25 17:53:44,2014-09-23 18:13:59
74e7f91e6de11bc41ecba5d0b2e1b78d03865d32...d8e157d5ab1648a509b25d5ec571572ae936de79,2,292,274,566,66,2014-09-25 18:28:32,2014-09-24 20:55:16
d8e157d5ab1648a509b25d5ec571572ae936de79...45bd7b3bd9008941580c100b9fc7361e3ff3ff0d,3,21,3,24,7,2014-09-25 21:49:44,2014-09-25 18:21:12
45bd7b3bd9008941580c100b9fc7361e3ff3ff0d...a8f07530a74839d20f1f2fb2cc7f5b8ef2215782,5,117,8,125,8,2014-09-26 00:16:54,2014-09-18 11:42:51
a8f07530a74839d20f1f2fb2cc7f5b8ef2215782...d1ca70110f49f0be90206c8da516ac16aebc8c75,9,20,32,52,18,2014-09-26 06:50:16,2014-09-25 17:59:03
d1ca70110f49f0be90206c8da516ac16aebc8c75...17557d068c43bd61cdc6c18caf250ffa469414a1,8,50,7,57,12,2014-09-26 16:12:40,2014-09-22 16:46:43
17557d068c43bd61cdc6c18caf250ffa469414a1...ef5f9b6ae8c873927aa6047f5f9d1d902a0c2177,4,26,6,32,4,2014-09-26 17:01:27,2014-09-10 07:23:58
ef5f9b6ae8c873927aa6047f5f9d1d902a0c2177...d16bc7f0e46785bcf422310c41d20b25c0112051,1,2,2,4,2,2014-09-26 17:07:55,2014-09-26 17:06:49
d16bc7f0e46785bcf422310c41d20b25c0112051...f5c932ddec8605df82319850d0f0e2f4dad1de11,1,1,1,2,1,2014-09-26 17:23:46,2014-09-26 17:23:46
f5c932ddec8605df82319850d0f0e2f4dad1de11...b23d47412c12352ba2e2133b05a15ccd09e81af3,3,12,1,13,3,2014-09-26 17:36:28,2014-09-26 17:01:34
b23d47412c12352ba2e2133b05a15ccd09e81af3...45840927d3516770be2654422e752357d5c063a5,4,70,17,87,12,2014-09-26 17:42:47,2014-09-18 22:40:51
45840927d3516770be2654422e752357d5c063a5...dbdae3a75512bddbf0b75ea6354fb3fc4bdb53cf,5,24,30,54,9,2014-09-26 18:03:44,2014-09-26 06:43:50
dbdae3a75512bddbf0b75ea6354fb3fc4bdb53cf...c1ae0621bab6b013025ec9024691ce7ad556409e,5,40,22,62,13,2014-09-27 06:49:50,2014-09-26 21:18:22
c1ae0621bab6b013025ec9024691ce7ad556409e...a54adcecff891374341adaad6a8187d416595b70,1,1,1,2,1,2014-09-27 06:57:09,2014-09-27 06:57:09
a54adcecff891374341adaad6a8187d416595b70...e1fbb68e4e0aaa18391beb4718864c739929f232,1,1,1,2,1,2014-09-27 20:48:30,2014-09-27 20:48:30
e1fbb68e4e0aaa18391beb4718864c739929f232...caf5cd7ba7c9d73194e394a26c81f1a677d54a6c,1,1,1,2,1,2014-09-28 11:33:29,2014-09-28 11:32:26
caf5cd7ba7c9d73194e394a26c81f1a677d54a6c...b2aad7b836bfde012756cca69291c14d2fdbd334,37,123,122,245,101,2014-09-28 17:01:38,2014-09-26 12:31:50
b2aad7b836bfde012756cca69291c14d2fdbd334...9e8658db51376fec3300461774d8e4654d643c5f,1,1,1,2,1,2014-09-29 11:45:28,2014-09-29 03:40:31
9e8658db51376fec3300461774d8e4654d643c5f...4b257cf26151df1f725b26e699d896c95eb20215,3,3,3,6,3,2014-09-29 12:13:40,2014-09-29 12:13:40
4b257cf26151df1f725b26e699d896c95eb20215...df578bf175d27684c792631a2e50a05fc37c04bb,1,3,3,6,1,2014-09-29 12:53:44,2014-09-29 12:50:36
df578bf175d27684c792631a2e50a05fc37c04bb...311b3ad9db94c3e04f929c2622be4f10d759f45e,3,45,2,47,7,2014-09-29 16:00:14,2014-09-29 15:17:44
311b3ad9db94c3e04f929c2622be4f10d759f45e...90761d00e375ec552d5c1d7225dd97977cdd1816,4,5,3,8,5,2014-09-29 21:43:16,2014-09-29 21:43:16
90761d00e375ec552d5c1d7225dd97977cdd1816...054bdfeff113459a48974d08098915431d0a093d,11,42,7,49,12,2014-09-29 22:06:31,2014-09-27 22:12:34
054bdfeff113459a48974d08098915431d0a093d...12809e160995eb617fe394c75e5b9f3211c056ff,1,3,1,4,1,2014-09-29 23:51:39,2014-09-29 23:51:33
12809e160995eb617fe394c75e5b9f3211c056ff...a407b846b4c706a54887afaf26b052914601b8b5,5,56,11,67,14,2014-09-30 00:45:43,2014-09-06 20:42:36
a407b846b4c706a54887afaf26b052914601b8b5...f5cfd09c257e5a4ed6d01d32505c48b02e3860d5,4,39,2,41,6,2014-09-30 12:45:04,2014-07-28 16:29:33
f5cfd09c257e5a4ed6d01d32505c48b02e3860d5...c7b5883c781608f20f42ebedbfc260ea082709d6,1,3,0,3,3,2014-09-30 17:24:20,2014-09-30 17:24:20
c7b5883c781608f20f42ebedbfc260ea082709d6...d6a15026c4234c732bd2db0b39e1b1e478b1286e,334,2445,1296,3741,1269,2014-09-30 18:55:50,2014-09-30 16:19:08
d6a15026c4234c732bd2db0b39e1b1e478b1286e...fe2afcd318493c933ab1191a5a64271869a1227f,3,44,2,46,5,2014-09-30 21:13:27,2014-09-29 21:09:03
fe2afcd318493c933ab1191a5a64271869a1227f...20f868bc5a7178849db9c671e684825ce2cf6107,1,1,1,2,1,2014-10-01 17:06:30,2014-10-01 14:24:46
20f868bc5a7178849db9c671e684825ce2cf6107...333960582170457473aafe24dbcb8502af7d8ffc,2,22,3,25,4,2014-10-01 19:31:35,2014-10-01 19:24:10
333960582170457473aafe24dbcb8502af7d8ffc...32c7d3c061b83e9206ef2bf13fbc302a1998f317,7,100,28,128,18,2014-10-01 20:23:20,2014-09-30 17:15:59
32c7d3c061b83e9206ef2bf13fbc302a1998f317...ca139bbfdf48bf59b0918a7d675cdc5d4ae60957,1,20,0,20,1,2014-10-02 10:19:18,2014-10-02 10:19:18
ca139bbfdf48bf59b0918a7d675cdc5d4ae60957...01a7e0b9c527449ab85e9e9b43303a325aef67a4,1,2,0,2,2,2014-10-02 10:52:05,2014-10-02 10:52:05
01a7e0b9c527449ab85e9e9b43303a325aef67a4...d49993fa8f3fb10fde43983a323d53dfba815db9,1,1,1,2,1,2014-10-02 13:08:07,2014-10-02 12:37:05
d49993fa8f3fb10fde43983a323d53dfba815db9...85f6d893138c052f0fa24d7c2005b9c222af91b4,4,123,8,131,7,2014-10-02 15:52:40,2014-09-16 00:25:02
85f6d893138c052f0fa24d7c2005b9c222af91b4...8c581ff39475c1b3b25d60945cc1c73a7f8eb1be,5,73,10,83,8,2014-10-02 19:42:30,2014-09-13 01:23:35
8c581ff39475c1b3b25d60945cc1c73a7f8eb1be...1e5e2a470768549117ac4696ce3e8b4e51d65664,3,90,0,90,4,2014-10-04 23:47:26,2014-10-04 23:47:26
8c581ff39475c1b3b25d60945cc1c73a7f8eb1be...4ad57bbe31bc1813264824111de2f9f74dbda0d6,1,23,0,23,1,2014-10-04 07:20:35,2014-09-20 08:05:03
4ad57bbe31bc1813264824111de2f9f74dbda0d6...2bb00b0b0b5232aff806c8a9b3f1126c1cf79221,1,1,1,2,1,2014-10-04 08:32:30,2014-10-04 08:32:30
2bb00b0b0b5232aff806c8a9b3f1126c1cf79221...acdbecda055eaa6d63d5bc6aa5b23d7e925121aa,1,2,2,4,1,2014-10-04 11:22:11,2014-10-04 11:22:11
acdbecda055eaa6d63d5bc6aa5b23d7e925121aa...ae5dbe5aa8d55916efdda192e83e1f303662f745,1,1,1,2,1,2014-10-04 12:00:00,2014-10-04 09:36:23
ae5dbe5aa8d55916efdda192e83e1f303662f745...6fa9fa91a5fcb228b3c385b35a2018b3821a447a,1,1,1,2,1,2014-10-04 12:02:22,2014-10-03 13:49:28
6f6e7d01dce94668e178b26da547c4643ed3a6cc...9dff5ce7c70780f4ee91567d98dba227093b49e2,3,28,1,29,6,2014-10-06 21:35:53,2014-10-06 20:07:20
9dff5ce7c70780f4ee91567d98dba227093b49e2...87eedfff44d23a8600557bcd9fa3ebbea0f3841e,1,1,1,2,1,2014-10-06 21:44:58,2014-10-06 21:44:58
87eedfff44d23a8600557bcd9fa3ebbea0f3841e...e9b85fd6264bf054091142e40b340a105554ad0a,1,10,0,10,1,2014-10-07 12:22:57,2014-10-07 08:29:02
e9b85fd6264bf054091142e40b340a105554ad0a...d1e87aebf70dd035c98a0b0f0162c0a2c398598c,2,135,144,279,3,2014-10-07 16:04:56,2014-10-04 17:36:45
d1e87aebf70dd035c98a0b0f0162c0a2c398598c...c1ef234e310fb984ced37eac8c8b90f5b6155e5f,3,13,2,15,4,2014-10-07 17:06:39,2014-09-18 20:03:09
c1ef234e310fb984ced37eac8c8b90f5b6155e5f...ed37f7e979186c99a6f351c289eb486461601d80,5,134,5,139,9,2014-10-07 20:27:31,2014-10-07 20:27:31
ed37f7e979186c99a6f351c289eb486461601d80...8a4e9be3e561c3532bc06d63491736b075a35b2a,1,1,0,1,1,2014-10-07 21:28:23,2014-10-07 21:10:22
8a4e9be3e561c3532bc06d63491736b075a35b2a...0eccf8fbea143234c9af3d290d41d5c315e714f9,1,59,59,118,2,2014-10-07 22:11:09,2014-10-07 22:11:09
0eccf8fbea143234c9af3d290d41d5c315e714f9...e949f4435fb8fb0b874cf8bb0ba9d61d423152f2,1,12,5,17,1,2014-10-08 12:19:11,2014-10-08 12:19:11
e949f4435fb8fb0b874cf8bb0ba9d61d423152f2...9e2e4cb6dda5fa1d4d6b047adbcc215daf4d6ff1,1,3,0,3,1,2014-10-08 18:06:18,2014-10-08 18:06:18
9e2e4cb6dda5fa1d4d6b047adbcc215daf4d6ff1...ca61195827efdf6ec54e8280e4cfd9a34f07b8b4,3,48,11,59,6,2014-10-08 18:28:38,2014-10-08 15:27:17
ca61195827efdf6ec54e8280e4cfd9a34f07b8b4...0af4ddabf4c89a9501e45373c52243010fa7fb82,2,2,2,4,2,2014-10-08 19:59:19,2014-10-08 19:59:19
0af4ddabf4c89a9501e45373c52243010fa7fb82...88b6cf4ae41a983bda735a5f61f69f6b1482e2ca,2,48,1,49,3,2014-10-08 22:10:47,2014-10-04 11:02:10
88b6cf4ae41a983bda735a5f61f69f6b1482e2ca...30b44cea38cdbc19c7a2ffed395667c98610678c,1,0,1,1,1,2014-10-08 22:10:50,2014-10-08 22:02:47
30b44cea38cdbc19c7a2ffed395667c98610678c...15d350fbce7807ce85d79ae6e31199039062bcd4,1,2,2,4,1,2014-10-09 12:45:19,2014-10-09 12:19:43
15d350fbce7807ce85d79ae6e31199039062bcd4...f633ba778d302c12f4295714a78fa20dff98b39f,9,256,36,292,36,2014-10-09 14:32:06,2014-10-06 23:53:21
f633ba778d302c12f4295714a78fa20dff98b39f...bf1bb07bf02b207f59e7d07243fff367236014d3,3,4,3,7,3,2014-10-09 15:48:27,2014-10-09 15:48:23
bf1bb07bf02b207f59e7d07243fff367236014d3...d6a87eefd87250e68457488cfd62fb2cc8211b24,1,1,0,1,1,2014-10-09 15:54:42,2014-10-09 15:04:10
d6a87eefd87250e68457488cfd62fb2cc8211b24...92a17eaae081a213171b044858d6fc29df2df733,5,22,14,36,12,2014-10-09 17:44:58,2014-10-09 16:04:50
92a17eaae081a213171b044858d6fc29df2df733...16ed35fafc0583b485a0289afda632f8261ecc96,2,13,1,14,2,2014-10-09 18:58:20,2014-10-07 17:53:19
16ed35fafc0583b485a0289afda632f8261ecc96...4ef9618e12510a84a4d21440b1e18ab704ee6d73,1,2,3,5,2,2014-10-09 18:59:33,2014-10-09 16:38:23
4ef9618e12510a84a4d21440b1e18ab704ee6d73...2bd1bbc42430f9815d16b779735b77c35ea4cde7,11,411,488,899,51,2014-10-09 19:38:50,2014-05-22 19:51:30
2bd1bbc42430f9815d16b779735b77c35ea4cde7...65c1a37490b1e504cb69fb09731cfda85fcd6002,1,38,121,159,17,2014-10-09 19:38:50,2014-09-19 19:06:33
65c1a37490b1e504cb69fb09731cfda85fcd6002...322cbe0db7bbe5433e4f529dfb8151d1f91a87c9,1,1,1,2,1,2014-10-10 12:00:44,2014-10-10 07:31:55
322cbe0db7bbe5433e4f529dfb8151d1f91a87c9...1b5918f160365b97986f21da1a7c35ffd2d5b0b0,5,6,20,26,5,2014-10-10 12:43:26,2014-10-10 09:59:47
1b5918f160365b97986f21da1a7c35ffd2d5b0b0...115c307184d441fbc27a8f43a99af5d992cfcc13,4,30,1,31,6,2014-10-10 13:22:20,2014-10-10 10:40:13
115c307184d441fbc27a8f43a99af5d992cfcc13...fa534b92dda0771661a98a1ca302ced264d0a6da,1,2,2,4,2,2014-10-10 13:50:02,2014-10-09 11:02:25
fa534b92dda0771661a98a1ca302ced264d0a6da...466b38ea3dfb49597e9668ffb14ed017a10bb09d,1,1,0,1,1,2014-10-10 14:04:32,2014-10-10 13:17:39
466b38ea3dfb49597e9668ffb14ed017a10bb09d...06b11b617e7d3439bb36b65d1cacd4cc75f36c69,4,51,2,53,7,2014-10-10 16:10:32,2014-10-08 22:47:48
06b11b617e7d3439bb36b65d1cacd4cc75f36c69...9db3653670d85fbd34cd196b6f4964503c88a5c2,1,0,5,5,1,2014-10-10 19:18:54,2014-10-10 19:18:54
9db3653670d85fbd34cd196b6f4964503c88a5c2...c6ea678c2e5fef985df933b6fd472b425476e6be,1,11,0,11,1,2014-10-11 11:44:50,2014-10-11 05:28:12
c6ea678c2e5fef985df933b6fd472b425476e6be...63ff4177467fbcceedf9c87e9cab4ae31a4ce119,1,1,1,2,1,2014-10-11 14:56:48,2014-10-11 14:56:48
63ff4177467fbcceedf9c87e9cab4ae31a4ce119...bc46e4d4fa61eead13fe58048ae646f07d632e4f,1,2,2,4,2,2014-10-11 15:14:29,2014-10-11 15:14:24
bc46e4d4fa61eead13fe58048ae646f07d632e4f...c48a29a02a457cfdb1cff11009401459ba24e870,1,6,4,10,2,2014-10-12 11:59:26,2014-10-12 11:50:18
c48a29a02a457cfdb1cff11009401459ba24e870...6448dd833524ac3fc503506b624841c9d642de8a,2,18,10,28,8,2014-10-12 16:47:48,2014-10-12 13:37:17
6448dd833524ac3fc503506b624841c9d642de8a...8d789449c7861b8cf8b10d244f26d9d354989aaf,4,45,6,51,8,2014-10-12 20:01:24,2014-10-09 12:18:31
8d789449c7861b8cf8b10d244f26d9d354989aaf...8701b5900774be3126321c2449b4d0e8091a9725,1,19,18,37,5,2014-10-13 11:19:05,2014-10-13 10:24:36
8701b5900774be3126321c2449b4d0e8091a9725...59d487e7fc02980e76dad053dd989c8b4899444f,3,14,1,15,3,2014-10-13 15:37:58,2014-10-12 18:53:19
59d487e7fc02980e76dad053dd989c8b4899444f...905a9a263bea16ce3332870ec7b3e525ff09e978,1,3,0,3,1,2014-10-13 15:52:09,2014-10-13 14:57:01
905a9a263bea16ce3332870ec7b3e525ff09e978...7131efa154a3e4dd0121503578fa6ca676366431,1,4,1,5,1,2014-10-14 07:30:26,2014-10-14 07:26:13
7131efa154a3e4dd0121503578fa6ca676366431...9743aa5436448a709a6ae82bb905dc4fae56cb80,1,3,1,4,1,2014-10-14 16:13:37,2014-10-14 12:54:04
6fa9fa91a5fcb228b3c385b35a2018b3821a447a...04bd84786d39b8a17620dfb3b354599d8d95417b,1,13,0,13,1,2014-10-06 17:11:06,2014-10-04 17:49:58
6fa9fa91a5fcb228b3c385b35a2018b3821a447a...8121860be4b9379d107959290e5748bbaf6de1fe,1,1,1,2,1,2014-10-04 17:13:54,2014-10-04 17:13:54
9743aa5436448a709a6ae82bb905dc4fae56cb80...1b2debe89684724f0617bb89aa49cb70273ab0f1,2,0,12,12,11,2014-10-15 12:28:27,2014-10-15 12:28:27
9743aa5436448a709a6ae82bb905dc4fae56cb80...7a893ee77171d6cc37ffd40d67af6161633235e0,2,30,25,55,5,2014-10-15 07:17:44,2014-10-14 21:15:43
844ba211ceea11ad2aa81f6a55c518228dd33a53...51165401be3e9d084c6a3ebb99246e5bb29bb752,2,6,8,14,2,2014-10-06 17:35:52,2014-10-06 17:35:52
8121860be4b9379d107959290e5748bbaf6de1fe...6baa46cb8b7903c87d7855dc32d5c6a219c10ff1,1,1,1,2,1,2014-10-05 21:13:04,2014-10-05 21:12:46
4443c6f6d8e481db8142e79391ad0b65ebcf46e3...2ccbaba1f26ae262b301aa9ae1d41efed2f6aee9,2,3,1,4,3,2014-10-15 13:09:35,2014-10-14 19:55:54
2ccbaba1f26ae262b301aa9ae1d41efed2f6aee9...3af5af1a61d73c533aca4fb0ea1f53e4f6300b17,1,2,2,4,1,2014-10-15 15:36:19,2014-10-15 15:36:19
1e224b39c700122cd7b1c3f8d463ea4e7cb07f58...e501d4c505ede0c87c2d1a8667167314021489e2,3,9,2,11,3,2014-10-06 12:23:42,2014-10-05 01:09:32
e501d4c505ede0c87c2d1a8667167314021489e2...a24cf217220dca44b7bd5b36ad9c14a96bca486e,8,37,5,42,12,2014-10-06 12:35:16,2014-10-05 18:06:51
a24cf217220dca44b7bd5b36ad9c14a96bca486e...2f16ff5a6cbd71fc6c50e88e4087f3657222e90e,4,29,4,33,7,2014-10-06 13:31:39,2014-10-04 17:04:21
2f16ff5a6cbd71fc6c50e88e4087f3657222e90e...13409b932ae9eb2776e619f7fa82445dcde5818b,1,7,3,10,5,2014-10-06 14:46:16,2014-10-06 12:59:04
13409b932ae9eb2776e619f7fa82445dcde5818b...1edaa55201e5f8c191c6ba7fdeeb88ac0b711ca8,1,15,0,15,1,2014-10-06 16:28:55,2014-10-06 16:05:44
1edaa55201e5f8c191c6ba7fdeeb88ac0b711ca8...ec2fd02bb3f9f7e732de1566e81f84637e29f161,3,34,0,34,4,2014-10-06 17:09:55,2014-10-06 17:09:21
3af5af1a61d73c533aca4fb0ea1f53e4f6300b17...10b17a22bec2eaf44c3315614aea87c127caee46,9,189,42,231,31,2014-10-15 19:31:17,2014-07-22 12:25:22
3af5af1a61d73c533aca4fb0ea1f53e4f6300b17...db7b393aff88d75d421c75d92110c7d04414d223,1,1,0,1,1,2014-10-15 19:20:08,2014-10-15 19:20:08
1e3bfcaf12405ebc7d55955418588d8a5a81a302...a6a8268d1974778d93e112c739b4cf0564b7e043,4,104,105,209,29,2014-10-15 20:04:13,2014-10-15 15:37:23
a6a8268d1974778d93e112c739b4cf0564b7e043...f6c208d95c1b8b0450f45f6589a794392dbd2541,1,1,1,2,1,2014-10-15 20:36:11,2014-10-15 20:35:54
f6c208d95c1b8b0450f45f6589a794392dbd2541...947af46db3c285edd3679106d374b258d491ecb8,1,1,1,2,1,2014-10-15 22:54:15,2014-10-15 21:48:35
947af46db3c285edd3679106d374b258d491ecb8...374c14b7fd8a7ba06cebfa83dd40915a50796d3e,2,18,5,23,7,2014-10-16 07:27:20,2014-10-15 13:52:18
374c14b7fd8a7ba06cebfa83dd40915a50796d3e...2e5b2c612ec3b410d2a35133d073341e6958eeba,3,19,10,29,6,2014-10-16 07:30:37,2014-10-11 19:39:38
2e5b2c612ec3b410d2a35133d073341e6958eeba...b962653060f1968f5a2647b8a20259dc30a3433f,3,19,3,22,6,2014-10-16 12:16:24,2014-10-16 10:43:46
b962653060f1968f5a2647b8a20259dc30a3433f...303a8486310447f0f83058d185faa9bfbc2ad700,1,1,1,2,1,2014-10-16 13:56:37,2014-10-16 13:56:37
303a8486310447f0f83058d185faa9bfbc2ad700...80b8d3bee035b56b0d9ac57dd732dffa3b2d5f3c,1,5,0,5,1,2014-10-16 14:53:17,2014-10-14 12:48:45
80b8d3bee035b56b0d9ac57dd732dffa3b2d5f3c...157f9cf240427bd52aa09a895ac4456da167f876,2,21,26,47,3,2014-10-16 16:49:21,2014-10-15 07:14:46
157f9cf240427bd52aa09a895ac4456da167f876...a5c77417a651c93036cf963e6da518653115be7e,4,83,10,93,12,2014-10-16 16:49:21,2014-10-14 13:10:27
a5c77417a651c93036cf963e6da518653115be7e...bedd43929731f3a3c3dca6725d5e09239b36a210,1,2,2,4,2,2014-10-16 23:41:15,2014-10-16 23:41:15
bedd43929731f3a3c3dca6725d5e09239b36a210...babbf1899916a0ad4eae45e40ca13e2c00707718,3,3,3,6,3,2014-10-17 00:00:17,2014-10-17 00:00:17
babbf1899916a0ad4eae45e40ca13e2c00707718...2e1ed5f33cf5756b52a10ceadd0ce8e9ecf989e3,1,49,2,51,4,2014-10-17 01:46:15,2014-10-14 23:52:21
2e1ed5f33cf5756b52a10ceadd0ce8e9ecf989e3...6ce6c77e03fea68ef1bdadd45f15e403f5b71057,1,3,0,3,1,2014-10-17 12:56:39,2014-10-17 12:56:39
6ce6c77e03fea68ef1bdadd45f15e403f5b71057...7ae03204ac207bee78d668952744da853a3a732b,3,2,117,119,4,2014-10-17 14:31:49,2014-10-17 14:31:49
7ae03204ac207bee78d668952744da853a3a732b...8d6e1afe0be0570253a508f43e2ef89ae640984e,2,22,0,22,2,2014-10-17 18:20:56,2014-10-17 12:13:59
8d6e1afe0be0570253a508f43e2ef89ae640984e...c1b9f99a812d01124ba4ddefcafaa90dcb5b05ae,1,7,7,14,3,2014-10-18 10:55:11,2014-10-17 20:01:42
c1b9f99a812d01124ba4ddefcafaa90dcb5b05ae...825ea8385857a98a36b3dc67c427b0000b5d9112,1,2,1,3,1,2014-10-19 06:44:39,2014-10-19 00:27:31
825ea8385857a98a36b3dc67c427b0000b5d9112...6c79d3297782fed07b81faaf0e9c0c7d63590e35,2,2,2,4,2,2014-10-19 06:46:46,2014-10-19 01:01:56
6c79d3297782fed07b81faaf0e9c0c7d63590e35...62a53bdf11c01e16b4e2500c7cf05fe372ccc261,1,1,1,2,1,2014-10-19 09:01:14,2014-10-19 09:01:14
c213a1887e9acd3c25ea535b82915ad22e1edc7d...ec8a2e3b0787a3027cd0a0954a8637fc9bd6a5f3,1,2,2,4,2,2014-10-19 11:00:53,2014-10-19 10:57:46
ec8a2e3b0787a3027cd0a0954a8637fc9bd6a5f3...c974b7bbe0abddd9796c65a23b68e61ba75cb5a3,1,1,1,2,1,2014-10-19 11:00:54,2014-10-19 10:58:59
c974b7bbe0abddd9796c65a23b68e61ba75cb5a3...0fb83f1491b5b8bda49270d3cfdde1f1772f8b58,1,1,1,2,1,2014-10-19 15:26:51,2014-10-19 15:23:50
0fb83f1491b5b8bda49270d3cfdde1f1772f8b58...968510e5d709ca83933fbff733a19437e469c10a,2,16,16,32,2,2014-10-19 17:22:48,2014-10-19 16:31:21
968510e5d709ca83933fbff733a19437e469c10a...a39df37049c6b708924eed1521963929e0694b0c,1,5,1,6,2,2014-10-20 14:51:25,2014-10-20 14:51:25
a39df37049c6b708924eed1521963929e0694b0c...685edab9da89b54e3e0e7bbc1c9f8b33d3f45969,4,29,3,32,5,2014-10-20 15:26:00,2014-10-19 19:17:38
685edab9da89b54e3e0e7bbc1c9f8b33d3f45969...6d11bb102dd6876a936297c1ee8cddbaca22eee3,2,0,22,22,2,2014-10-20 15:26:00,2014-10-19 19:19:30
6d11bb102dd6876a936297c1ee8cddbaca22eee3...b8f2c972d0be8572727081c9c07ba18a3d446273,4,6,13,19,11,2014-10-20 15:26:00,2014-10-19 19:25:09
b8f2c972d0be8572727081c9c07ba18a3d446273...740934b507856d38c026d5f47dba32588688204b,17,1,6209,6210,19,2014-10-20 16:28:48,2014-10-20 16:28:48
740934b507856d38c026d5f47dba32588688204b...59026bfbf957cd31c659bdfac36d992816eba114,2,20,6,26,8,2014-10-20 16:42:10,2014-10-16 02:52:41
59026bfbf957cd31c659bdfac36d992816eba114...5732424beed38f81870f2dd9d913310bca1eaf44,3,111,1,112,6,2014-10-20 17:14:44,2014-10-14 14:20:24
5732424beed38f81870f2dd9d913310bca1eaf44...2118aa8aeafe0a215eae7188c40484d791921c67,1,3,2,5,1,2014-10-20 18:01:28,2014-10-20 18:01:01
2118aa8aeafe0a215eae7188c40484d791921c67...4fe6824ffd319b199140e291f0f742e7fe1f4615,3,3,2,5,3,2014-10-20 20:37:19,2014-10-20 18:05:43
4fe6824ffd319b199140e291f0f742e7fe1f4615...54e695331b07a572e0f37085725d23df69980628,3,21,5,26,8,2014-10-20 21:08:29,2014-10-16 01:03:40
54e695331b07a572e0f37085725d23df69980628...dbf7a3df45e733c1e51d98318fd87de5ffc160a8,2,5,0,5,3,2014-10-20 21:59:07,2014-10-19 22:34:35
dbf7a3df45e733c1e51d98318fd87de5ffc160a8...edcb33c92e11ad5ac92a928e65b7d321fa9d067c,1,1,1,2,1,2014-10-21 01:49:44,2014-10-21 01:49:44
edcb33c92e11ad5ac92a928e65b7d321fa9d067c...f0bb3c98cc9e128cb0c1622be9eb41a26794c91f,3,19,3,22,7,2014-10-21 07:16:57,2014-10-20 20:32:43
f0bb3c98cc9e128cb0c1622be9eb41a26794c91f...3a34e45fdbecc1f1ead0a3c2f1c01111a865710e,1,3,3,6,3,2014-10-21 13:08:27,2014-10-21 12:07:32
3a34e45fdbecc1f1ead0a3c2f1c01111a865710e...0e16c3e3cd61b119e067b369f3ff928a2e4045b4,3,35,15,50,4,2014-10-21 14:02:51,2014-09-02 13:30:53
0e16c3e3cd61b119e067b369f3ff928a2e4045b4...9f1202c166093160c8796dc570d675415fdf5bf8,2,6,1,7,2,2014-10-21 15:13:29,2014-10-20 20:22:02
9f1202c166093160c8796dc570d675415fdf5bf8...c34e13e17c664ea43b85572428bcf74c7509db3f,3,8,2,10,3,2014-10-21 18:03:15,2014-10-20 11:01:03
c34e13e17c664ea43b85572428bcf74c7509db3f...8b4cc9df9c0760eb4896f1423b6119bdad5674c6,6,46,35,81,11,2014-10-21 18:18:21,2014-10-18 10:00:38
8b4cc9df9c0760eb4896f1423b6119bdad5674c6...bbc3505ef81768aa2afac8f73e6d45b5e8000c55,6,3,52,55,38,2014-10-21 18:54:32,2014-10-21 18:54:32
bbc3505ef81768aa2afac8f73e6d45b5e8000c55...494cd857c897dc4051193abc10d181fa51de4966,1,2,2,4,3,2014-10-21 22:32:46,2014-10-21 22:32:46
494cd857c897dc4051193abc10d181fa51de4966...533532302ae842c95cf7294ef6cd7f3e2bfaca65,4,102,27,129,14,2014-10-22 02:25:50,2014-10-21 18:11:31
533532302ae842c95cf7294ef6cd7f3e2bfaca65...494ba051bb0d3ebbdbea7598251b1ee6fe9b69b4,6,126,138,264,64,2014-10-22 02:25:50,2014-10-21 17:15:10
494ba051bb0d3ebbdbea7598251b1ee6fe9b69b4...e55fc60f81ecbd5810991784f27c145edfbd35b2,1,0,1,1,1,2014-10-22 03:49:40,2014-10-22 03:06:29
e55fc60f81ecbd5810991784f27c145edfbd35b2...bdb4118b1ad166e2d02f725354ca1c1021976cb5,2,33,16,49,9,2014-10-22 04:27:00,2014-10-20 11:10:53
bdb4118b1ad166e2d02f725354ca1c1021976cb5...eb82fb0a9d14ca317d366afb65e21d742bbe46a5,2,61,29,90,9,2014-10-22 04:27:00,2014-10-21 08:31:24
eb82fb0a9d14ca317d366afb65e21d742bbe46a5...9dc782b6313910dc8e650f3a3013320ffb1209db,4,4,4,8,4,2014-10-22 16:23:21,2014-10-22 16:23:21
9dc782b6313910dc8e650f3a3013320ffb1209db...36ea03eb36b4d4248e2bec0bb97328f2a1fd794e,1,1,2,3,1,2014-10-22 17:11:37,2014-10-22 17:11:37
36ea03eb36b4d4248e2bec0bb97328f2a1fd794e...4bf86d25e576dc68c38b3b7470900f8a681cd5e5,2,13,0,13,2,2014-10-22 17:38:57,2014-10-22 17:38:57
4bf86d25e576dc68c38b3b7470900f8a681cd5e5...8c4ca16c65174db63471f12b005f5423b61de073,2,45,3,48,3,2014-10-22 17:55:02,2014-10-22 16:16:32
8c4ca16c65174db63471f12b005f5423b61de073...b62f72498af8a8cb4ddb3000421c5642bda57761,2,7,2,9,2,2014-10-22 18:46:04,2014-10-22 18:28:57
b62f72498af8a8cb4ddb3000421c5642bda57761...28da093ae24c3fb9070055df5d727a9c51c9cf83,1,7,1,8,1,2014-10-22 19:24:33,2014-10-22 00:52:31
28da093ae24c3fb9070055df5d727a9c51c9cf83...ef9e3c5ed8bcbc345c09ec89c8e8a0ab6d3f8fab,1,1,0,1,1,2014-10-23 01:21:02,2014-10-23 01:21:02
ef9e3c5ed8bcbc345c09ec89c8e8a0ab6d3f8fab...bc6caa5d456a51be88c5382f40f1733d8258b970,1,4,4,8,2,2014-10-23 09:16:17,2014-10-23 09:16:17
bc6caa5d456a51be88c5382f40f1733d8258b970...22c85bf1a8e938def99bf76afc11486655ff3e11,1,5,5,10,4,2014-10-23 12:03:41,2014-10-23 05:04:47
22c85bf1a8e938def99bf76afc11486655ff3e11...41b337efa085b6b9cfdb2cf724d977005ff77e75,3,46,2,48,5,2014-10-23 12:05:39,2014-10-22 13:59:00
41b337efa085b6b9cfdb2cf724d977005ff77e75...4b0a45ce64bfa1ce39d963738ffb0af57f4517e5,1,0,2,2,1,2014-10-23 12:15:54,2014-10-23 12:15:54
4b0a45ce64bfa1ce39d963738ffb0af57f4517e5...70428902c0c4d7660118b935241b54c17f662802,1,1,0,1,1,2014-10-23 13:39:26,2014-10-23 13:37:19
70428902c0c4d7660118b935241b54c17f662802...2d75515a4c4fe726e26ebb1a2d2acbc9d047cba6,4,54,5,59,10,2014-10-23 13:49:24,2014-10-20 21:29:28
2d75515a4c4fe726e26ebb1a2d2acbc9d047cba6...92269b7b53c9f69dd28e119c40b6bf32f96f7bd3,3,24,2,26,3,2014-10-23 16:24:34,2014-10-23 16:24:34
92269b7b53c9f69dd28e119c40b6bf32f96f7bd3...2c9a03d4874d8938f18e99772a3d0962f9b16681,2,14,3,17,4,2014-10-23 19:03:57,2014-10-23 18:15:41
2c9a03d4874d8938f18e99772a3d0962f9b16681...adf8fb34ced765b25634ec4bef6a40ea55defff5,1,1,1,2,1,2014-10-24 11:48:39,2014-10-23 20:00:33
adf8fb34ced765b25634ec4bef6a40ea55defff5...e50e0ee27bf16090fe36a87cf91fe2baa27b70f1,2,3,2,5,2,2014-10-24 13:10:39,2014-10-11 14:03:35
e50e0ee27bf16090fe36a87cf91fe2baa27b70f1...1bdf1cb1c0a31a7759e93a514feffb84f95a7fa8,2,12,17,29,9,2014-10-24 13:10:39,2014-10-11 14:30:45
1bdf1cb1c0a31a7759e93a514feffb84f95a7fa8...45db842c9bcd6f9afe274c120f43847657473839,2,17,0,17,3,2014-10-24 15:04:43,2014-10-24 12:53:58
45db842c9bcd6f9afe274c120f43847657473839...d49183e4bed8ecf21faad44372ea15ff00f781b5,1,1,3,4,1,2014-10-24 15:07:50,2014-10-24 15:07:50
d49183e4bed8ecf21faad44372ea15ff00f781b5...1387c8064381d922c9176e754e4743448efeb7f3,1,2,2,4,1,2014-10-24 19:41:18,2014-10-24 04:01:25
1387c8064381d922c9176e754e4743448efeb7f3...dc241fdfdf55f4086777b7bd45cf75b2c9861312,1,9,12,21,3,2014-10-24 22:58:31,2014-10-24 22:58:31
dc241fdfdf55f4086777b7bd45cf75b2c9861312...695956376ff09b0d6fd5c438f912b9eb05459145,2,14,15,29,14,2014-10-25 04:31:12,2014-10-24 19:35:20
695956376ff09b0d6fd5c438f912b9eb05459145...7f089ac2e3e6a7f4b2b41085a37d35e074fad805,3,18,11,29,10,2014-10-27 08:11:33,2014-10-25 09:05:38
7f089ac2e3e6a7f4b2b41085a37d35e074fad805...ed7c4df1ee40b9a0793cd294614673fc312bbc33,1,1,1,2,1,2014-10-27 10:36:55,2014-10-27 04:49:07
ed7c4df1ee40b9a0793cd294614673fc312bbc33...dd1ea70779adff294140eddb0229c382e12f32f3,8,71,3,74,6,2014-10-27 10:56:44,2014-10-24 19:29:59
dd1ea70779adff294140eddb0229c382e12f32f3...01b4a13db4d544e71d91bc5f3e9d6e9a44d3ed75,1,4,0,4,1,2014-10-27 11:01:12,2014-10-27 11:01:12
01b4a13db4d544e71d91bc5f3e9d6e9a44d3ed75...984a57a9c9cba44fde61e21c08996dc678f13e81,1,0,4,4,1,2014-10-27 12:21:37,2014-10-27 12:21:37
984a57a9c9cba44fde61e21c08996dc678f13e81...d4bc0bf435402f32d1e31aeffd280276349283d8,1,3,1,4,1,2014-10-27 12:51:40,2014-10-03 01:58:36
d4bc0bf435402f32d1e31aeffd280276349283d8...528c9af5436814f60e88c9d31c991d72f7ea7fbc,3,12,1,13,3,2014-10-27 12:56:25,2014-10-27 08:35:01
528c9af5436814f60e88c9d31c991d72f7ea7fbc...5b8e37a69e66715e9b6a5fc8c4b701498e281a88,1,1,1,2,1,2014-10-27 13:01:12,2014-10-27 13:01:12
5b8e37a69e66715e9b6a5fc8c4b701498e281a88...af7d66b4f2015b7681edde6736d552c69d119dd4,1,1,1,2,1,2014-10-27 21:16:39,2014-10-27 21:16:39
af7d66b4f2015b7681edde6736d552c69d119dd4...e460b1c573359b256d79c0d4cf6aeb492deca97c,1,11,5,16,2,2014-10-27 22:17:50,2014-10-27 22:17:50
e460b1c573359b256d79c0d4cf6aeb492deca97c...6b39401bafa955f4891700996aa666349fcdef74,1,2,2,4,2,2014-10-27 23:48:29,2014-10-27 22:18:37
6b39401bafa955f4891700996aa666349fcdef74...00aa562884a418c4ee20e223ab82c3455997ee7d,6,268,28,296,28,2014-10-28 08:02:10,2014-09-14 10:34:41
00aa562884a418c4ee20e223ab82c3455997ee7d...ae7cb992bca5d211c9456487feb21b84387006eb,2,6,3,9,3,2014-10-28 08:13:50,2014-10-28 01:36:47
ae7cb992bca5d211c9456487feb21b84387006eb...9e746c13e81241fbf1ae64ec118edaa491790046,2,10,9,19,3,2014-10-28 14:06:57,2014-08-12 15:23:01
9e746c13e81241fbf1ae64ec118edaa491790046...22da5f8817ffff3917bcf8a652dce84f382c9202,4,42,8,50,9,2014-10-28 14:06:58,2014-08-12 16:14:06
22da5f8817ffff3917bcf8a652dce84f382c9202...713f23492a52df8dbb4ae1175f5d0a0f3e2c4005,2,10,3,13,3,2014-10-28 14:06:58,2014-10-11 12:47:54
713f23492a52df8dbb4ae1175f5d0a0f3e2c4005...28634394f53b9ab27d3419cfde047ee78e491d97,7,115,6,121,15,2014-10-28 14:11:12,2014-10-13 11:10:00
28634394f53b9ab27d3419cfde047ee78e491d97...1e64a1e7b11490b203f4f12b41da63a3e2d4e410,1,2,0,2,2,2014-10-28 14:12:10,2014-10-28 14:12:10
1e64a1e7b11490b203f4f12b41da63a3e2d4e410...349471eeb9a4db2f5d8e95cb6555e7b3f2c94e3f,3,5,3,8,4,2014-10-28 14:15:52,2014-10-28 14:15:52
349471eeb9a4db2f5d8e95cb6555e7b3f2c94e3f...c9178ef17a0e1070f5a25096d8e13385d404dc92,10,69,30,99,24,2014-10-29 11:59:35,2014-10-25 04:42:44
c9178ef17a0e1070f5a25096d8e13385d404dc92...03bd79ed2124d149114fa3b702878d75159ba2b8,2,10,0,10,2,2014-10-29 12:21:24,2014-10-28 12:10:45
03bd79ed2124d149114fa3b702878d75159ba2b8...f3740caa7ec540f2ffe8b1a75acc88a0308ca09c,1,2,0,2,1,2014-10-29 12:37:54,2014-10-29 12:37:54
f3740caa7ec540f2ffe8b1a75acc88a0308ca09c...5c9c1e029d139bd3d5213804af2ed9f317cd0b86,3,65,43,108,11,2014-10-29 17:05:42,2014-10-27 23:28:37
5c9c1e029d139bd3d5213804af2ed9f317cd0b86...388c6038fdc7ce1d1314b1ffdf5943807f123977,1,3,1,4,2,2014-10-29 17:37:52,2014-10-29 15:31:40
388c6038fdc7ce1d1314b1ffdf5943807f123977...85086c815873c4cf0bc2f1f2809119088cbe55f1,19,369,18,387,36,2014-10-29 23:17:29,2014-09-25 22:24:17
aac594f65f613929f904f2ecb466edfb573e17b4...cbd936d0f87cf5109d3ef67c07797c657912f424,2,41,0,41,2,2014-10-30 12:22:13,2014-10-29 14:38:46
cbd936d0f87cf5109d3ef67c07797c657912f424...68d3db8a7b3dfe2690df3e7f750a5010086d6aa6,1,8,6,14,7,2014-10-30 12:29:18,2014-10-30 10:27:19
68d3db8a7b3dfe2690df3e7f750a5010086d6aa6...4a9b4a23bdb51c9fce06facaf78c9ba0a54f1266,1,31,12,43,4,2014-10-30 12:46:14,2014-10-30 11:57:22
4a9b4a23bdb51c9fce06facaf78c9ba0a54f1266...c0eea4645b7859a505ac65652f5ebb55a75e59b7,1,2,0,2,1,2014-10-30 12:53:20,2014-10-30 12:53:20
c0eea4645b7859a505ac65652f5ebb55a75e59b7...03467368dbd6a427985f86463faa61619f08c833,4,12,12,24,4,2014-10-30 13:02:04,2014-10-13 22:15:36
03467368dbd6a427985f86463faa61619f08c833...eab3dc195eff4123460fb99d7819a7f6627e7115,2,3,1,4,2,2014-10-30 13:19:32,2014-10-29 00:40:02
eab3dc195eff4123460fb99d7819a7f6627e7115...eb4f6de980c5148ba48d4ed67f31cca27dd132a8,5,108,12,120,9,2014-10-30 15:52:59,2014-09-30 01:24:33
eb4f6de980c5148ba48d4ed67f31cca27dd132a8...57e40551e41eaf31ff96672beea9b1f732f2e331,3,13,1,14,4,2014-10-30 17:52:42,2014-10-30 17:52:42
57e40551e41eaf31ff96672beea9b1f732f2e331...cc25bfebd52ef6fa80b0bc7b312a8b1a9a76b787,1,2,2,4,2,2014-10-30 18:15:31,2014-08-02 08:22:02
cc25bfebd52ef6fa80b0bc7b312a8b1a9a76b787...fd061b6591ddc0b3045661ff22243919a7c76f17,13,142,2,144,10,2014-10-30 18:39:11,2014-10-30 15:55:38
fd061b6591ddc0b3045661ff22243919a7c76f17...affc04060f02dfbd00e8747fc104fa67ad45daca,1,6,6,12,2,2014-10-30 18:45:16,2014-10-30 05:46:16
affc04060f02dfbd00e8747fc104fa67ad45daca...8f79c154ca19c3a4b70da044df2489e6765cb814,1,1,1,2,1,2014-10-30 19:49:30,2014-10-30 19:49:30
8f79c154ca19c3a4b70da044df2489e6765cb814...9e3aaa5a46b5ecc099d518bc01c7433d5c9efdef,1,8,3,11,1,2014-10-30 22:18:39,2014-10-30 19:45:01
9e3aaa5a46b5ecc099d518bc01c7433d5c9efdef...08c5887f134da761dc59f52280116dd9849985a7,1,5,5,10,3,2014-10-30 22:26:13,2014-10-30 22:26:13
08c5887f134da761dc59f52280116dd9849985a7...f85fcc75e3c19d9694012afe97947d7b516d5dfc,1,2,19,21,2,2014-10-30 22:34:10,2014-10-30 22:34:10
f85fcc75e3c19d9694012afe97947d7b516d5dfc...e7cb4f2fbaff7996fb48e9c79aa0ec454abcf8f7,1,4,2,6,2,2014-10-30 22:42:54,2014-10-30 22:42:54
e7cb4f2fbaff7996fb48e9c79aa0ec454abcf8f7...19242c675f16ddde37b68af8bbe07de66e237e13,1,6,3,9,2,2014-10-30 23:04:10,2014-10-30 23:01:20
19242c675f16ddde37b68af8bbe07de66e237e13...f2ddc439b1938acb6cae693bda9d8cf83a4583be,6,93,11,104,17,2014-10-30 23:10:52,2014-10-14 18:56:39
f2ddc439b1938acb6cae693bda9d8cf83a4583be...c0c1bb9e64d7e1cea50dc4818ffcf229b568578b,4,12,17,29,12,2014-10-31 10:38:53,2014-10-31 10:38:53
c0c1bb9e64d7e1cea50dc4818ffcf229b568578b...98da408964b229ee0b35bb8c4500820e3606aeab,3,48,18,66,8,2014-10-31 12:01:47,2014-10-31 09:22:15
98da408964b229ee0b35bb8c4500820e3606aeab...ed2f96819c9ad6e21e4d397b6418915f5caf522f,4,18,4,22,5,2014-10-31 12:06:40,2014-10-31 11:04:01
ed2f96819c9ad6e21e4d397b6418915f5caf522f...715ccfde24f9f2b7f6710429370a1eff3c78fc2a,4,38,2,40,5,2014-10-31 17:30:30,2014-10-31 13:08:24
715ccfde24f9f2b7f6710429370a1eff3c78fc2a...3f651b3e88ac1ba8d04acd5a074362866a0a963a,1,6,0,6,1,2014-10-31 17:34:41,2014-10-31 17:34:41
3f651b3e88ac1ba8d04acd5a074362866a0a963a...e958c760f90672e6d1422fb5509f64c12527a451,1,20,2,22,3,2014-10-31 19:40:07,2014-10-31 19:38:46
e958c760f90672e6d1422fb5509f64c12527a451...e548d08f243335b4f11190417830a5f3027efd2a,2,2,2,4,2,2014-10-31 19:55:45,2014-10-31 19:55:45
e548d08f243335b4f11190417830a5f3027efd2a...934a16dc93a5f46f965ba299dbd543703d32d493,3,61,3,64,8,2014-10-31 22:21:54,2014-10-30 17:38:47
934a16dc93a5f46f965ba299dbd543703d32d493...d6d55368d45ca05c4c08c4981f9dba5c9b2bd72e,3,33,1,34,5,2014-10-31 22:37:52,2014-10-31 13:04:46
d6d55368d45ca05c4c08c4981f9dba5c9b2bd72e...6d0547c1ad4c370a6efb136fb3ba8422b012643f,1,1,1,2,1,2014-11-01 16:36:28,2014-11-01 16:36:28
6d0547c1ad4c370a6efb136fb3ba8422b012643f...332706eaa02d191118966801ae4f4607a767c0eb,1,15,2,17,2,2014-11-03 11:32:41,2014-11-03 09:46:38
d968bd5258438694b000b347a482ddcd33a9b395...d3db878e4beff057400dd780c24f3601a5d31f95,16,24,32,56,23,2014-11-03 12:47:39,2014-10-31 22:39:46
d3db878e4beff057400dd780c24f3601a5d31f95...c548c8d0d1112d2c4bace2eebf73ede35300d842,6,57,4,61,8,2014-11-03 12:59:19,2014-10-31 15:43:34
c548c8d0d1112d2c4bace2eebf73ede35300d842...ceb1ffcc8da92a82338582bc6801de4bc8f05e32,4,48,5,53,8,2014-11-03 13:51:48,2014-10-08 19:12:42
ceb1ffcc8da92a82338582bc6801de4bc8f05e32...c0c78f1b707f825eee974c65515a837f8cf46e66,1,18,2,20,1,2014-11-03 13:52:27,2014-11-03 13:34:32
c0c78f1b707f825eee974c65515a837f8cf46e66...f7969b0920c403118656f6bfec58d6454d79ef1a,83,420,430,850,313,2014-11-03 16:56:37,2014-10-28 10:02:56
f7969b0920c403118656f6bfec58d6454d79ef1a...ebc8e79cf3bdd42a99e91d6e679248d07097d3db,5,93,3,96,14,2014-11-03 17:29:19,2014-04-14 15:58:59
ebc8e79cf3bdd42a99e91d6e679248d07097d3db...8b77b64f1cf878b100d1d2001c8a73938ea3e1ed,3,46,30,76,8,2014-11-03 18:02:11,2014-11-03 17:00:18
8b77b64f1cf878b100d1d2001c8a73938ea3e1ed...d89f56dc4d03f6bf6602536b8b62602ec0d46d2f,9,73,27,100,27,2014-11-03 19:14:39,2014-10-18 18:03:10
d89f56dc4d03f6bf6602536b8b62602ec0d46d2f...ca88aa34ad2bf088130ceb329cdbe91c907b8248,1,1,1,2,1,2014-11-03 19:18:46,2014-11-03 19:18:46
ca88aa34ad2bf088130ceb329cdbe91c907b8248...2d06e3155a13e3ca9e63b97c7c9499a1e1ffd654,2,18,0,18,2,2014-11-03 19:31:23,2014-10-11 16:53:29
2d06e3155a13e3ca9e63b97c7c9499a1e1ffd654...1cf109515a08aecb34c48bedb1df8027f7fad701,1,3,3,6,3,2014-11-03 20:00:49,2014-11-03 18:24:22
1cf109515a08aecb34c48bedb1df8027f7fad701...7b420367524ad9f29b8bf0284f4b40bd6cfc8b93,6,138,8,146,10,2014-11-03 20:30:46,2014-11-03 19:16:28
7b420367524ad9f29b8bf0284f4b40bd6cfc8b93...a71a2ea756673cd3c7a2c5125fa7e7f334b05475,21,28,28,56,28,2014-11-04 01:59:30,2014-11-03 22:48:03
a71a2ea756673cd3c7a2c5125fa7e7f334b05475...5c517ec21839358249c6f17611abbf84661fb200,12,53,46,99,22,2014-11-04 02:40:26,2014-11-03 10:30:48
5c517ec21839358249c6f17611abbf84661fb200...36f514f06553ef299001b4e9a5f63ec806a50581,22,864,6,870,27,2014-11-04 09:26:40,2014-03-14 17:34:49
36f514f06553ef299001b4e9a5f63ec806a50581...f0ff452451c0a2db6db53b6f068c794a47450d78,1,7,2,9,1,2014-11-04 12:25:35,2014-11-04 12:25:35
f0ff452451c0a2db6db53b6f068c794a47450d78...e0685368c6b122404cf0817d5cb17ab1b211cf6d,1,2,2,4,2,2014-11-04 12:35:42,2014-11-04 12:35:42
e0685368c6b122404cf0817d5cb17ab1b211cf6d...74e1980cf96eb45079bef464fabdcbe0a6db2423,4,50,5,55,5,2014-11-04 16:23:58,2014-10-27 20:21:59
74e1980cf96eb45079bef464fabdcbe0a6db2423...ca48cef3b440a9e8a121713e370b9988dcf0aa2b,1,1,1,2,1,2014-11-04 16:27:35,2014-11-04 16:27:35
ca48cef3b440a9e8a121713e370b9988dcf0aa2b...e645b79ef5e5238c418df8f4ab5d52eb7bbc78e7,1,7,1,8,3,2014-11-04 19:26:37,2014-11-04 19:26:37
e645b79ef5e5238c418df8f4ab5d52eb7bbc78e7...83daf53636da676bc3a32b957168e9205714198e,1,1,1,2,1,2014-11-04 21:08:32,2014-11-04 21:08:32
83daf53636da676bc3a32b957168e9205714198e...df0523debcc2d0984f1bc11d323f04227d4b388b,4,42,2,44,7,2014-11-04 22:56:57,2014-11-04 20:19:10
df0523debcc2d0984f1bc11d323f04227d4b388b...81477c91f68d7091f8da417a030dd4b9b776b70a,5,199,72,271,42,2014-11-05 01:38:38,2014-11-05 01:38:38
81477c91f68d7091f8da417a030dd4b9b776b70a...f1f0c4f16bd7a1138a881c3645719e84e200440a,1,0,7,7,1,2014-11-05 09:00:30,2014-11-05 09:00:22
f1f0c4f16bd7a1138a881c3645719e84e200440a...f5fe9f29c8a9ae93226125b99e751f1176e22801,2,84,3,87,4,2014-11-05 14:08:09,2014-11-05 14:08:09
f5fe9f29c8a9ae93226125b99e751f1176e22801...9f4c718b2f3b09ce23a837853ba2289cec85ae4f,1,3,4,7,1,2014-11-05 14:09:25,2014-11-05 14:09:25
9f4c718b2f3b09ce23a837853ba2289cec85ae4f...b07aa52e8a8e4c7fdc7265f75ce2e7992e657ae9,1,6,1,7,1,2014-11-05 14:54:35,2014-11-05 01:56:00
b07aa52e8a8e4c7fdc7265f75ce2e7992e657ae9...c7c098cf97fbb1416f302c76799058ad63a5f7aa,3,16,3,19,8,2014-11-06 14:30:30,2014-11-06 11:29:43
c7c098cf97fbb1416f302c76799058ad63a5f7aa...091f5b5a4e83759cf9d96fe2b9f56183b49765f6,1,1,1,2,1,2014-11-09 21:10:31,2014-11-09 21:10:31
091f5b5a4e83759cf9d96fe2b9f56183b49765f6...006451f8943af2974a9a2c105dbc8470a33624c1,1,1,1,2,1,2014-11-10 14:36:42,2014-11-09 21:31:53
006451f8943af2974a9a2c105dbc8470a33624c1...b748a8bc670af10c37560836c353ce911eaeecc0,4,28,4,32,4,2014-11-10 14:47:45,2014-11-10 14:43:40
b748a8bc670af10c37560836c353ce911eaeecc0...88b2a20f047347da86f448fe09a56251d29e4168,1,2,8,10,2,2014-11-10 17:16:14,2014-11-09 22:08:02
88b2a20f047347da86f448fe09a56251d29e4168...498ae3a36069e2dfa4e041eeddb40278ea907c76,1,1,24,25,4,2014-11-10 17:28:46,2014-11-09 21:24:22
542fd80a275b8d3207bc40b51b0dc466bfb1e3b6...b239c3d27e68ff6a0f4e11ae5a1eeea613c30325,1,1,0,1,1,2014-11-10 20:41:35,2014-11-10 20:41:35
b239c3d27e68ff6a0f4e11ae5a1eeea613c30325...faf4d5c51025e39bbebf9bf34063652410b7b481,1,1,1,2,1,2014-11-11 01:01:07,2014-11-11 00:47:47
faf4d5c51025e39bbebf9bf34063652410b7b481...b3fd39f7c8921b314f12dd53ee65740464d4a5f1,1,37,17,54,4,2014-11-11 06:14:29,2014-11-10 13:38:03
b3fd39f7c8921b314f12dd53ee65740464d4a5f1...b7a5b6ab8672daf907ba57e50edbed4cad596d4b,8,71,14,85,14,2014-11-11 15:29:32,2014-11-05 06:01:49
b7a5b6ab8672daf907ba57e50edbed4cad596d4b...40ba6f21bb5a728987da9a7055c74fa3c65da4db,3,3,2,5,3,2014-11-11 15:41:09,2014-11-11 15:41:09
40ba6f21bb5a728987da9a7055c74fa3c65da4db...b8ba73cd0cb6a3dbdaeb3df65936970956829de3,5,18,19,37,9,2014-11-11 18:05:14,2014-11-11 17:59:49
b8ba73cd0cb6a3dbdaeb3df65936970956829de3...5ec367ccdd2ff70270b1f578821c817785d7aecf,3,25,14,39,12,2014-11-11 21:52:30,2014-11-11 08:40:03
5ec367ccdd2ff70270b1f578821c817785d7aecf...95b8323ac23fbc720b8c00745e5208d50d3d99d2,1,0,1,1,1,2014-11-11 21:54:26,2014-11-11 21:36:01
95b8323ac23fbc720b8c00745e5208d50d3d99d2...3bc7a14ea52d916576b3d61dc6ba48b340a02671,4,10,7,17,7,2014-11-11 21:54:27,2014-11-11 21:36:41
3bc7a14ea52d916576b3d61dc6ba48b340a02671...d647764a53a77be89c8d7239d70adcf8343d9f3a,1,7,3,10,3,2014-11-12 10:40:55,2014-11-12 09:29:06
d647764a53a77be89c8d7239d70adcf8343d9f3a...c56c42b5c01ed774cfa8e044cd372a984608536c,2,9,3,12,2,2014-11-12 10:53:30,2014-07-11 20:11:04
c56c42b5c01ed774cfa8e044cd372a984608536c...4e9a6c94e6bea805e089df2dee2d4ab2c902c827,1,1,1,2,1,2014-11-12 11:22:08,2014-11-12 11:22:08
4e9a6c94e6bea805e089df2dee2d4ab2c902c827...42b5e4feeacf7cfa57867bf9fd5a6046de8c1cd3,4,34,15,49,8,2014-11-12 18:04:45,2014-10-31 18:26:27
42b5e4feeacf7cfa57867bf9fd5a6046de8c1cd3...aa77e90aa91f90c9be5fb8e492b033875545bee4,2,0,6,6,2,2014-11-12 19:11:40,2014-11-12 19:11:40
aa77e90aa91f90c9be5fb8e492b033875545bee4...f9213a85c312d5590158a3bef6896468f11d7a69,1,48,2,50,3,2014-11-12 19:46:34,2014-11-06 20:33:43
f9213a85c312d5590158a3bef6896468f11d7a69...f742c653e029a2baf69a0bc85806f05affa63915,1,5,5,10,5,2014-11-12 20:26:31,2014-11-12 20:26:31
f742c653e029a2baf69a0bc85806f05affa63915...11b7680d0e640a7d4b1c942f74e9197b6ec924b1,1,7,3,10,3,2014-11-12 21:00:48,2014-11-12 21:00:48
11b7680d0e640a7d4b1c942f74e9197b6ec924b1...bfb11b95626f39e2f5e18d97d7761c6f93dcc1a9,4,36,15,51,7,2014-11-12 21:38:18,2014-11-12 20:18:11
bfb11b95626f39e2f5e18d97d7761c6f93dcc1a9...311feae8ba2a7b47e998764a1b0a26b5132e56f0,1,10,0,10,2,2014-11-13 08:45:14,2014-11-13 05:08:35
311feae8ba2a7b47e998764a1b0a26b5132e56f0...dec7da3c4c8fb8c4fe3e34bdbd6f23dcbc42ad4c,1,1,0,1,1,2014-11-13 09:07:44,2014-11-13 09:07:44
dec7da3c4c8fb8c4fe3e34bdbd6f23dcbc42ad4c...7ef81b5cdd4c8eda12aa7786484a0bfde00aaaa4,2,0,8,8,2,2014-11-13 09:30:53,2014-11-13 09:30:36
7ef81b5cdd4c8eda12aa7786484a0bfde00aaaa4...e118e3af371ae58cee7420d2ea2020c8bdeb461e,2,24,1,25,3,2014-11-13 10:06:59,2014-11-05 02:57:47
e118e3af371ae58cee7420d2ea2020c8bdeb461e...7fd1f3a645fda76c517be17f373ced1e69c2ae7b,1,3,6,9,2,2014-11-13 13:34:47,2014-11-13 13:34:47
7fd1f3a645fda76c517be17f373ced1e69c2ae7b...e541bbd0dc36a61b6eb148dc4694d9638d7bd5f2,1,7,8,15,2,2014-11-13 13:38:19,2014-11-13 13:38:19
e541bbd0dc36a61b6eb148dc4694d9638d7bd5f2...098368d82f67715723b5bd4445a8fe92a0ceae98,1,7,0,7,1,2014-11-13 16:56:29,2014-11-13 16:56:29
098368d82f67715723b5bd4445a8fe92a0ceae98...d5a109f6e6684b2ea8028af5c57f4257872d11aa,1,5,5,10,3,2014-11-13 19:10:02,2014-11-13 17:01:22
d5a109f6e6684b2ea8028af5c57f4257872d11aa...c24a2e6cbd391c0d6359fce00e6390de9af9d2d0,5,3,77,80,8,2014-11-13 19:12:29,2014-11-13 16:35:33
c24a2e6cbd391c0d6359fce00e6390de9af9d2d0...3a550bb6d32172fc1ec5dd314d20ef1235db995a,1,3,0,3,1,2014-11-13 19:15:45,2014-11-13 17:16:20
bfb11b95626f39e2f5e18d97d7761c6f93dcc1a9...bc8abe36ba5508fe788f6d49a26749268d368583,3,25,1,26,3,2014-11-13 05:46:03,2014-11-07 04:47:04
a305695f28cb15165a19c3871aec878a230a5105...d552da1f8d42b7c6db992fee42bc4781f5fdde43,4,38,6,44,6,2014-11-15 08:38:19,2014-11-10 21:21:31
d552da1f8d42b7c6db992fee42bc4781f5fdde43...4f90c99635149fae2f488c03f0b52303fe97e0aa,1,6,0,6,2,2014-11-15 08:53:55,2014-11-15 08:06:37
4f90c99635149fae2f488c03f0b52303fe97e0aa...13d613f80011852404198dfafd1f09c0c0ea42e6,4,53,25,78,6,2014-11-15 13:45:42,2014-11-15 13:45:42
4f90c99635149fae2f488c03f0b52303fe97e0aa...b4bb5cd0a31c6e9ebc2be9dff245f506940f9159,1,1,3,4,1,2014-11-15 13:07:31,2014-11-15 12:54:53
4f90c99635149fae2f488c03f0b52303fe97e0aa...48515ee1f7bec437544a0a958332483298f4028b,1,16,4,20,5,2014-11-15 12:29:16,2014-11-15 12:29:16
4f90c99635149fae2f488c03f0b52303fe97e0aa...88e13b44edaaad8a49ec0e6a1195b7ca12333b77,1,18,9,27,4,2014-11-15 10:57:53,2014-11-15 10:57:53
39e3ef88c237e3f4cedc89cd36494a6d3f490812...a7c58eaca45ede76f94d2859877c7f42b28c48da,2,8,1,9,2,2014-11-15 15:20:11,2014-11-15 14:04:34
39e3ef88c237e3f4cedc89cd36494a6d3f490812...f59fd15c4928caf3dfcbd50f6ab47be409a43b01,43,2583,812,3395,254,2014-11-15 14:00:43,2013-12-25 13:13:18
f59fd15c4928caf3dfcbd50f6ab47be409a43b01...83d104d61af1ee7d8dc1192f0801a7cee972e9de,4,25,53,78,6,2014-11-15 14:28:04,2014-11-15 14:27:41
05e0e4674ce9995a1dc5962001747abce30e4f69...f61256da3a266c75c2f75c35172832bf2d605939,23,240,237,477,153,2014-11-16 12:19:34,2014-11-16 01:56:42
f61256da3a266c75c2f75c35172832bf2d605939...de912495ab1c3b3e05e79068861ab6b3b5f5c32e,1,8,0,8,1,2014-11-16 12:32:40,2014-11-16 12:32:40
de912495ab1c3b3e05e79068861ab6b3b5f5c32e...dec93d89912965f94f9e942f0a89ca586fb91454,3,24,3,27,5,2014-11-16 14:44:13,2014-11-15 19:36:41
dec93d89912965f94f9e942f0a89ca586fb91454...cffa55908271bfbce9069b979ab150cd806c6d59,1,5,3,8,1,2014-11-16 20:25:09,2014-11-15 17:43:48
cffa55908271bfbce9069b979ab150cd806c6d59...2577ae6a082e8a6abc964f999757e908257eafc1,12,125,64,189,25,2014-11-16 20:28:26,2014-11-15 17:35:02
2577ae6a082e8a6abc964f999757e908257eafc1...c211c59b4a9ef66152eee0109107f22a9bd1a22f,1,1,2,3,1,2014-11-16 20:28:31,2014-11-15 17:35:53
c211c59b4a9ef66152eee0109107f22a9bd1a22f...cd7146debec77ef787a7ecb59a482f47968f5601,1,1,2,3,1,2014-11-16 20:28:37,2014-11-15 18:06:34
cd7146debec77ef787a7ecb59a482f47968f5601...d58597a7b8b47add828c9418cdf48299e3b8f5bb,3,34,27,61,8,2014-11-16 20:28:43,2014-11-10 20:04:04
d58597a7b8b47add828c9418cdf48299e3b8f5bb...b503fee7ec03485bf7172a6a85ca7228847705de,5,45,110,155,22,2014-11-16 20:40:50,2014-11-15 19:41:30
b503fee7ec03485bf7172a6a85ca7228847705de...0bf99193f88238aea0a12970503a7b5dceb206ec,1,0,27,27,1,2014-11-16 20:40:54,2014-11-15 18:55:16
0bf99193f88238aea0a12970503a7b5dceb206ec...1851dcf377d05a5d167cf482674e4c4a4e2502a5,3,15,0,15,3,2014-11-16 20:41:42,2014-11-15 18:55:53
1851dcf377d05a5d167cf482674e4c4a4e2502a5...9eeb788cfb70d07d87b3d07434d6a149ab2d7471,8,102,93,195,27,2014-11-16 20:41:44,2014-11-15 19:58:26
9eeb788cfb70d07d87b3d07434d6a149ab2d7471...e87bee6f50d323a769d61e8f1ca685f45de24079,2,10,17,27,5,2014-11-16 20:41:44,2014-11-15 20:17:43
e87bee6f50d323a769d61e8f1ca685f45de24079...fab26cf5e0aaffa99dd6d1378391ffd99c5ce9bc,3,6,30,36,7,2014-11-16 21:18:33,2014-11-16 21:08:17
fab26cf5e0aaffa99dd6d1378391ffd99c5ce9bc...580e9d0045d1b6ffaf7d52751a17b1a5a6075705,1,1,1,2,1,2014-11-17 01:32:04,2014-11-17 01:32:04
580e9d0045d1b6ffaf7d52751a17b1a5a6075705...bb4a92d7845878b2ce0c4a5ca154cb4db22f7bad,2,32,7,39,6,2014-11-17 08:21:24,2014-11-16 21:16:41
bb4a92d7845878b2ce0c4a5ca154cb4db22f7bad...6a05f0dfe3a12fa0dd5e840f0dc5ce6b23158525,3,6,10,16,6,2014-11-17 08:24:56,2014-11-17 08:24:56
6a05f0dfe3a12fa0dd5e840f0dc5ce6b23158525...684b2077b3a6d3fb99365e402ce8205bf54c6efd,1,1,1,2,1,2014-11-17 12:42:14,2014-11-17 12:42:14
684b2077b3a6d3fb99365e402ce8205bf54c6efd...fc3643743456e98ceb902ee1e48c1bc5f56034cf,1,3,1,4,1,2014-11-17 13:17:08,2014-11-17 13:17:08
fc3643743456e98ceb902ee1e48c1bc5f56034cf...524e71c9c20da57722b22b978d87690379ca4ade,1,401,418,819,38,2014-11-17 16:38:04,2014-11-15 12:08:40
524e71c9c20da57722b22b978d87690379ca4ade...4252a14c396bb806a86dfda2d0f6a4f3d96c102a,2,17,9,26,8,2014-11-17 17:04:08,2014-11-15 11:04:02
4252a14c396bb806a86dfda2d0f6a4f3d96c102a...8fce7978307058f9bc7d9f815858f27fdd954409,1,1,1,2,1,2014-11-17 17:10:50,2014-11-17 17:10:50
8fce7978307058f9bc7d9f815858f27fdd954409...82aca216e130973d142473ebb4b22d1eae146ec7,1,2,2,4,2,2014-11-17 17:32:42,2014-11-15 14:52:35
82aca216e130973d142473ebb4b22d1eae146ec7...19ae13d9ed76208b29bb40aec1bfff8196aa7331,2,14,14,28,24,2014-11-17 17:44:09,2014-11-15 16:25:45
9a5a4361c577d14cad303019f14ebc6d1ec01674...c1584e1df45a28cc374f634982065472dd23cc11,1,2,2,4,1,2014-11-15 16:05:24,2014-11-15 16:05:24
c1584e1df45a28cc374f634982065472dd23cc11...c5def493d0993d65bf7d96f0a204006cbeaa6178,2,29,2,31,2,2014-11-15 16:39:02,2014-11-15 16:37:13
c5def493d0993d65bf7d96f0a204006cbeaa6178...c5132382f081bd1b5a3618bbf23fa0cf720af14b,1,5,0,5,1,2014-11-15 16:41:01,2014-11-15 16:15:36
c5132382f081bd1b5a3618bbf23fa0cf720af14b...35dac5070bc3422cd2c6c2f46a28d1a1af2a2c50,11,245,4,249,14,2014-11-15 17:07:18,2014-11-08 16:08:12
83d104d61af1ee7d8dc1192f0801a7cee972e9de...fefb77934e6b8f91ce44be7e1438146cb99baa19,1,10,7,17,7,2014-11-15 15:34:20,2014-11-15 15:34:20
83d104d61af1ee7d8dc1192f0801a7cee972e9de...9dde0a211e0be8829e03b3c0fb236c408f888d44,2,2,2,4,2,2014-11-15 15:29:13,2014-11-15 14:50:22
19ae13d9ed76208b29bb40aec1bfff8196aa7331...7b4a994599b75a07cb07d1e0cc26b3bbf25ab7a6,3,16,8,24,7,2014-11-17 18:15:07,2014-11-17 18:04:38
1ed9b9e2e2b62f6ef89558f98d786e9fcd649152...fa680ce1e252666d125264b2e93782c127ebe8c8,1,10,1,11,4,2014-11-15 18:33:39,2014-11-15 12:15:56
fa680ce1e252666d125264b2e93782c127ebe8c8...d2d6c0c097072e2a8ece755fdc2d50c111104e7d,4,25,2,27,10,2014-11-15 18:36:33,2014-11-15 10:03:04
6ae1e3ba9f3a5316504c7543ba4abc472990de95...a37f4525133f97dcdca06c51476a60785b82007d,1,0,1,1,1,2014-11-17 21:27:00,2014-11-17 21:27:00
a37f4525133f97dcdca06c51476a60785b82007d...4b9eb7602d6d8756933d1a767004155a263cc150,1,6,4,10,2,2014-11-17 21:49:01,2014-11-17 21:49:01
4b9eb7602d6d8756933d1a767004155a263cc150...87f187b960e82da01aa13f329552e1608c339326,1,6,9,15,2,2014-11-17 22:26:04,2014-11-17 22:26:04
87f187b960e82da01aa13f329552e1608c339326...cbffc900bb8ce3c98aeae7cd8a3612d9c8c1baab,1,1,1,2,1,2014-11-17 23:37:18,2014-11-17 23:22:30
cbffc900bb8ce3c98aeae7cd8a3612d9c8c1baab...dee3946a91be2c880b5930550db681aae54b19ed,2,2,0,2,2,2014-11-17 23:42:54,2014-11-17 23:42:54
dee3946a91be2c880b5930550db681aae54b19ed...d18810131995dac63f9d89b0beaeadfc935130aa,3,64,15,79,4,2014-11-18 06:37:06,2014-11-16 17:42:23
d18810131995dac63f9d89b0beaeadfc935130aa...d63703f1cd373f2a1d52e1947835b44d9565c1e0,6,75,5,80,13,2014-11-18 21:44:16,2014-11-15 22:56:37
d63703f1cd373f2a1d52e1947835b44d9565c1e0...08fbbaa45b7b3f3a811b33c6bdf4222acd21d0b0,3,42,19,61,16,2014-11-19 02:47:16,2014-11-18 01:05:14
08fbbaa45b7b3f3a811b33c6bdf4222acd21d0b0...536795f79a956febc06a7fa5c86e3a395f2c94eb,2,23,2,25,4,2014-11-19 04:17:17,2014-11-16 23:13:40
536795f79a956febc06a7fa5c86e3a395f2c94eb...5617508fb9607eb2c06742742418765028066c5b,1,1,1,2,1,2014-11-19 11:01:39,2014-11-18 17:42:16
5617508fb9607eb2c06742742418765028066c5b...cf7a2a000e16b86dd721a021f1a2001529d8d707,3,4,4,8,3,2014-11-19 12:11:35,2014-11-18 12:25:03
cf7a2a000e16b86dd721a021f1a2001529d8d707...84d88f5cbe92efbaa37dc0cda633083a25143dfd,1,1,1,2,1,2014-11-19 15:03:48,2014-11-19 15:03:48
84d88f5cbe92efbaa37dc0cda633083a25143dfd...0eba8bd8f64a8ef122ff58d723336d272f06c673,1,1,1,2,1,2014-11-19 15:33:38,2014-11-19 15:33:38
0eba8bd8f64a8ef122ff58d723336d272f06c673...f17acd59303a27876966927869af7f4bfe38a74a,1,208,47,255,11,2014-11-19 16:09:38,2014-11-17 22:07:20
f17acd59303a27876966927869af7f4bfe38a74a...233165083593baf5f62194f50df26fb830e5f570,1,475,476,951,171,2014-11-19 16:09:38,2014-11-17 22:09:08
233165083593baf5f62194f50df26fb830e5f570...dca33ac15de81817c388234323ab358d97055689,2,32,34,66,18,2014-11-19 20:35:39,2014-11-18 20:45:12
dca33ac15de81817c388234323ab358d97055689...e23240474b4c7d630a4224a558f2e47a4b957cd1,2,10,13,23,5,2014-11-19 20:35:39,2014-11-18 20:50:03
e23240474b4c7d630a4224a558f2e47a4b957cd1...a97e72aaabd1d065d49f909be20f0f3367a346d4,3,17,26,43,6,2014-11-19 20:35:39,2014-11-18 20:50:52
a97e72aaabd1d065d49f909be20f0f3367a346d4...f88ad710faf0ebb53d96d6ab59f525c9aea4be41,4,14,23,37,9,2014-11-19 20:35:39,2014-11-18 20:52:09
f88ad710faf0ebb53d96d6ab59f525c9aea4be41...b69b4008d1046c1682728f20b57423870fea710b,1,6,10,16,4,2014-11-19 20:35:40,2014-11-18 20:52:26
b69b4008d1046c1682728f20b57423870fea710b...0900815097f75a89132b7a2f25b0cac135a49b82,1,8,11,19,3,2014-11-19 20:35:40,2014-11-18 20:52:58
0900815097f75a89132b7a2f25b0cac135a49b82...9d3d1a03214c3f40f9c3bb61b78a380b0f7a77cd,1,15,16,31,11,2014-11-19 20:35:40,2014-11-18 20:53:54
9d3d1a03214c3f40f9c3bb61b78a380b0f7a77cd...45db7f7db85ea490fa914fa57ac943d83a6c07f1,1,6,11,17,4,2014-11-19 20:53:24,2014-11-19 20:53:24
45db7f7db85ea490fa914fa57ac943d83a6c07f1...5bcd292098b4de7bb03ef778e24d9e2f433d0dae,2,3,4,7,2,2014-11-19 21:07:49,2014-11-19 19:31:48
5bcd292098b4de7bb03ef778e24d9e2f433d0dae...4932a7b8e0a25c7447d7ad7ae8ae53a35d2541ac,1,1,2,3,2,2014-11-19 21:29:05,2014-11-19 21:29:05
4932a7b8e0a25c7447d7ad7ae8ae53a35d2541ac...47b7f601eeb93bd7a91f87b77da658212f2f2314,2,19,15,34,9,2014-11-19 22:03:47,2014-11-19 21:08:57
47b7f601eeb93bd7a91f87b77da658212f2f2314...e7b9a58b081299b30f807d5c66f7a5d1940efe4c,1,4,6,10,2,2014-11-19 22:56:04,2014-11-19 22:56:04
e7b9a58b081299b30f807d5c66f7a5d1940efe4c...ab2819aa7b09d36d9ff24830a9825aa52b87fdb4,4,114,11,125,5,2014-11-19 23:11:44,2014-11-17 17:13:47
ab2819aa7b09d36d9ff24830a9825aa52b87fdb4...d2bcb0598058dd93eac94bdbb7dd2565cff0abea,1,9,0,9,2,2014-11-20 02:23:13,2014-11-20 02:10:46
d2bcb0598058dd93eac94bdbb7dd2565cff0abea...51f2de1530a49ef9c2f315025b47e107295cd38f,1,35,0,35,1,2014-11-20 02:43:12,2014-11-20 02:43:12
51f2de1530a49ef9c2f315025b47e107295cd38f...d6e2bbe734fe65f1cec825b9c507ad7bbb09f2f0,1,1,4,5,2,2014-11-20 11:18:08,2014-11-20 11:18:08
d6e2bbe734fe65f1cec825b9c507ad7bbb09f2f0...788fa9fffa0105d391b8fe35f2894bc5b4e29066,3,27,6,33,8,2014-11-20 13:45:11,2014-11-20 09:28:16
788fa9fffa0105d391b8fe35f2894bc5b4e29066...327df551e89a505c5756becee97c40198f38aff2,1,6,6,12,2,2014-11-20 14:33:32,2014-11-13 18:59:00
327df551e89a505c5756becee97c40198f38aff2...11662022be261d9a926b763e9fecc9f55ac3514a,2,32,18,50,8,2014-11-20 15:13:58,2014-11-14 16:48:00
11662022be261d9a926b763e9fecc9f55ac3514a...1a63093e22a18688914a82651c461e2ea89cd564,3,18,4,22,8,2014-11-20 15:13:58,2014-11-14 17:45:31
1a63093e22a18688914a82651c461e2ea89cd564...38ab0f13fac428dd05dad02ef7c94da5035927ad,1,1,1,2,1,2014-11-20 16:09:21,2014-11-20 15:35:36
38ab0f13fac428dd05dad02ef7c94da5035927ad...53908c1f934b32e83e9fa34c14910b1837f7f610,1,1,1,2,1,2014-11-20 16:58:24,2014-11-20 16:58:24
53908c1f934b32e83e9fa34c14910b1837f7f610...21e21c7bc2b8bf7ae127e2aa75048a60d05a6e0f,11,197,88,285,30,2014-11-20 17:49:49,2014-11-15 19:25:43
21e21c7bc2b8bf7ae127e2aa75048a60d05a6e0f...5c481db29572a387651681b43d5d4523f96b3793,5,77,3,80,12,2014-11-20 18:38:08,2014-10-07 13:07:46
5c481db29572a387651681b43d5d4523f96b3793...f273cedc76eded138e0418c9db0b425e40797633,2,16,0,16,1,2014-11-20 19:31:14,2014-11-20 19:26:48
f273cedc76eded138e0418c9db0b425e40797633...cfa26f29bdd9b0f82211e6f5ff7f4cd63bd66150,3,4,9,13,6,2014-11-20 19:31:14,2014-11-12 23:06:12
cfa26f29bdd9b0f82211e6f5ff7f4cd63bd66150...54d3dcbc51819ea0e36bb4dbe7de1a1e33f62c4d,1,11,17,28,5,2014-11-20 19:33:30,2014-11-12 23:06:12
54d3dcbc51819ea0e36bb4dbe7de1a1e33f62c4d...4c709cc0ef0daa2b527e056865f51796fb0d42f3,1,7,1,8,3,2014-11-20 19:42:39,2014-11-20 16:08:04
4c709cc0ef0daa2b527e056865f51796fb0d42f3...d8f00e1918ce4df76920f3d79bc8d805fa69e29e,1,2,0,2,1,2014-11-20 21:26:25,2014-11-20 21:25:49
d8f00e1918ce4df76920f3d79bc8d805fa69e29e...5b17dcd8ef9c444af2e0a234d708c37b313ef04f,2,25,7,32,4,2014-11-21 08:45:08,2014-11-21 01:35:58
5b17dcd8ef9c444af2e0a234d708c37b313ef04f...f1783ee479608a8c4ab627d3be1bb9bd07846bb1,1,5,1,6,1,2014-11-21 13:20:48,2014-11-21 12:05:22
f1783ee479608a8c4ab627d3be1bb9bd07846bb1...f957e2b04c9844ec849ffab07f8a1a5f10f753ff,1,14,0,14,1,2014-11-21 15:39:37,2014-11-21 11:04:19
f957e2b04c9844ec849ffab07f8a1a5f10f753ff...72729f844e0dd9bd01b3874171b89ab0d136a40e,3,24,11,35,3,2014-11-21 15:55:19,2014-11-15 14:43:06
72729f844e0dd9bd01b3874171b89ab0d136a40e...8330b50c8587fc5484650f5bf47a3f03b50fb2ca,1,7,2,9,4,2014-11-21 16:41:13,2014-11-16 01:01:45
8330b50c8587fc5484650f5bf47a3f03b50fb2ca...a3aeba0f9535e59133e49374a6485a85f26d756e,1,1,1,2,1,2014-11-21 16:47:31,2014-11-21 16:43:39
a3aeba0f9535e59133e49374a6485a85f26d756e...5b26a014a81ba0d404d46e11d2b45c01d92b97e5,3,26,3,29,4,2014-11-21 18:01:28,2014-11-18 17:58:43
5b26a014a81ba0d404d46e11d2b45c01d92b97e5...343162410f9270012e4fdd8396d542b39cc63269,5,40,0,40,7,2014-11-21 19:23:17,2014-11-15 11:17:55
343162410f9270012e4fdd8396d542b39cc63269...06726965c3e53e9a6b87e1532951a93d5f94f426,1,64,18,82,7,2014-11-21 19:53:36,2014-11-21 19:53:36
06726965c3e53e9a6b87e1532951a93d5f94f426...a7c3d0f288a66d327e71476e9a9bfcc791602b8c,1,1,1,2,1,2014-11-21 20:59:09,2014-11-21 20:58:53
a7c3d0f288a66d327e71476e9a9bfcc791602b8c...c7087bc777a078f71a0705d9d0eba51d2679a206,3,62,5,67,5,2014-11-21 21:02:31,2014-11-16 16:21:33
c7087bc777a078f71a0705d9d0eba51d2679a206...d4ea4eea7995edd75061777fe7223c5871d6938c,2,3,2,5,2,2014-11-21 21:44:50,2014-11-21 16:38:02
d4ea4eea7995edd75061777fe7223c5871d6938c...b0a58b9085b0836a92e5a4ad72671936119fe1ba,1,2,10,12,1,2014-11-22 11:20:17,2014-11-22 11:20:17
b0a58b9085b0836a92e5a4ad72671936119fe1ba...b38637d5813f014fbe3e031253a166c208c387e1,4,31,0,31,6,2014-11-22 13:23:37,2014-11-21 20:47:46
b38637d5813f014fbe3e031253a166c208c387e1...bf1bd0fbc9d4920327ad998ad11facf842492e23,8,112,106,218,20,2014-11-22 16:52:43,2014-11-22 16:52:12
bf1bd0fbc9d4920327ad998ad11facf842492e23...733178830072caeca3c054a220808b4c557faec4,7,36,12,48,14,2014-11-22 16:58:38,2014-11-22 08:22:38
733178830072caeca3c054a220808b4c557faec4...da2a35cf9ed3ced1425aea361bca49ef759c8706,1,1,0,1,1,2014-11-22 19:39:06,2014-11-22 19:39:06
da2a35cf9ed3ced1425aea361bca49ef759c8706...a9cced7aecfb7c49fe0f84c33b86744bba8f58b5,1,2,2,4,1,2014-11-22 21:21:32,2014-11-22 21:21:32
a9cced7aecfb7c49fe0f84c33b86744bba8f58b5...f36151ed169813f2873e13ca9de616cfa4095321,9,29,22,51,24,2014-11-22 21:30:14,2014-11-22 21:30:14
f36151ed169813f2873e13ca9de616cfa4095321...bcb693ebd4d3743cb194c6fd05b2d70fb9696a4c,9,22,29,51,24,2014-11-23 05:29:23,2014-11-23 05:29:23
bcb693ebd4d3743cb194c6fd05b2d70fb9696a4c...17012b6936128fb771b98e4fa6d78caddd07a9a8,6,68,36,104,23,2014-11-23 08:29:33,2014-11-13 19:25:08
17012b6936128fb771b98e4fa6d78caddd07a9a8...572cdb43917ad860acaaffecd60b4e92599ae3eb,4,187,96,283,12,2014-11-23 08:29:53,2014-11-14 14:48:27
572cdb43917ad860acaaffecd60b4e92599ae3eb...544a716da8e2ee774dc4ae4baecfc86b07c69820,3,6,14,20,8,2014-11-23 10:51:31,2014-11-19 21:04:01
544a716da8e2ee774dc4ae4baecfc86b07c69820...29a977ab143f549c8849e9f08ca5800830eaaabb,10,70,72,142,27,2014-11-23 10:52:12,2014-11-19 22:23:58
29a977ab143f549c8849e9f08ca5800830eaaabb...a2dd08666c5aad377fb8eb4782882caf5565d441,5,13,9,22,13,2014-11-23 10:52:14,2014-11-20 20:27:56
a2dd08666c5aad377fb8eb4782882caf5565d441...5b1bb40216ff452e34198345fdad63e2be370d2c,2,13,3,16,7,2014-11-23 10:52:22,2014-11-20 21:12:21
5b1bb40216ff452e34198345fdad63e2be370d2c...240ea67ce03b2fe3daeabd7bc6fd1efd95997013,4,20,16,36,7,2014-11-23 10:52:25,2014-11-22 20:21:30
240ea67ce03b2fe3daeabd7bc6fd1efd95997013...246cfdeae3f80bd159f8bd1dcb01921b4ce92720,4,15,15,30,9,2014-11-23 10:52:45,2014-11-22 20:30:05
246cfdeae3f80bd159f8bd1dcb01921b4ce92720...98ac69af538f8d93d6f940b382dcce2d5fc6173a,1,3,3,6,3,2014-11-23 10:52:54,2014-11-20 21:18:07
98ac69af538f8d93d6f940b382dcce2d5fc6173a...37505b6397058bcc3460f23d48a7de9641cd6ef0,3,37,25,62,6,2014-11-23 10:53:18,2014-11-20 21:34:59
37505b6397058bcc3460f23d48a7de9641cd6ef0...47a131b9446eb9b31e57554f17310bc2fd43a26f,3,16,26,42,12,2014-11-23 10:53:53,2014-11-22 17:52:55
47a131b9446eb9b31e57554f17310bc2fd43a26f...6294bd3903e12507c4e70e012dade82d0f52c388,5,10,9,19,12,2014-11-23 10:54:17,2014-11-22 20:33:40
6294bd3903e12507c4e70e012dade82d0f52c388...18533fb558f66377c42bbbab672503253d3668d1,3,10,6,16,8,2014-11-23 10:54:22,2014-11-22 20:43:13
18533fb558f66377c42bbbab672503253d3668d1...0d74209ef66111f29f122d5f5fdf8e2964890cc5,1,1,0,1,1,2014-11-23 22:03:58,2014-11-23 17:47:28
0d74209ef66111f29f122d5f5fdf8e2964890cc5...91e2780dfba5609b0f83d51aee1cf7e8fe78b1f7,1,4,2,6,1,2014-11-24 10:09:39,2014-11-24 10:09:39
91e2780dfba5609b0f83d51aee1cf7e8fe78b1f7...80facd7a0f3e545d800ad759ce5458f5f2bc246e,1,0,1,1,1,2014-11-24 12:01:55,2014-11-24 06:07:44
80facd7a0f3e545d800ad759ce5458f5f2bc246e...0b16c1322f71eaaa4a05572d48413b3068866e97,1,2,7,9,2,2014-11-24 12:02:29,2014-11-24 12:02:29
0b16c1322f71eaaa4a05572d48413b3068866e97...e77462249339f465395f49f0d0b149b670a696f3,1,8,8,16,2,2014-11-24 12:31:05,2014-11-24 12:31:05
e77462249339f465395f49f0d0b149b670a696f3...8bb9e7c9992703eae3a7edec09b7b7773b4c216e,2,2,1,3,2,2014-11-24 13:32:07,2014-11-24 13:32:07
8bb9e7c9992703eae3a7edec09b7b7773b4c216e...94e2d3913d993259162b47d50ac2ab754a812f42,2,15,5,20,4,2014-11-24 14:17:57,2014-11-24 14:17:57
94e2d3913d993259162b47d50ac2ab754a812f42...cdee8659763ee7044c1507bcd2202581b1744f0b,2,25,0,25,2,2014-11-24 15:23:25,2014-11-15 11:13:05
cdee8659763ee7044c1507bcd2202581b1744f0b...0c623da66406d1f20b5e26d497d57da5ad0de066,1,28,3,31,2,2014-11-24 15:34:29,2014-11-24 15:31:41
0c623da66406d1f20b5e26d497d57da5ad0de066...d049b36f91538595b9c7cdb7a1506c130803d226,1,1,1,2,1,2014-11-24 15:45:29,2014-11-24 15:29:30
d049b36f91538595b9c7cdb7a1506c130803d226...3199ea8ed7032584015e1dce438d003a609293a5,1,22,19,41,4,2014-11-24 16:37:03,2014-11-21 17:30:37
3199ea8ed7032584015e1dce438d003a609293a5...a5bd7f2cb2ce6d9cf309748be0fe033b836c4507,1,11,8,19,5,2014-11-24 18:28:58,2014-11-23 01:12:24
a5bd7f2cb2ce6d9cf309748be0fe033b836c4507...ebb927c4c997d4c8d9a55ec78cd2476a13bd1782,1,14,12,26,6,2014-11-24 19:01:15,2014-11-24 14:51:41
ebb927c4c997d4c8d9a55ec78cd2476a13bd1782...1e9ac504e46cae277398ee21038a08fffaafd060,3,12,9,21,6,2014-11-24 20:54:57,2014-11-21 14:26:46
1e9ac504e46cae277398ee21038a08fffaafd060...1dbdc03382719d134effe262d3a028fd0ff3a7fd,1,2,0,2,1,2014-11-24 20:58:56,2014-11-24 20:58:56
1dbdc03382719d134effe262d3a028fd0ff3a7fd...31f85bae1ed0e29b1ef14940d11b4db9e65f968c,1,13,12,25,12,2014-11-24 22:31:39,2014-11-15 19:03:31
31f85bae1ed0e29b1ef14940d11b4db9e65f968c...ca801b8c8f7022cd9334a89ac9ae03f586650234,1,4,3,7,1,2014-11-24 22:38:28,2014-11-22 16:54:42
ca801b8c8f7022cd9334a89ac9ae03f586650234...e22c64dfc0230134c0e9d9ae1d9a5c1589fc8b6e,9,142,16,158,27,2014-11-25 00:24:11,2014-11-22 16:59:05
e22c64dfc0230134c0e9d9ae1d9a5c1589fc8b6e...c1552af1fe5832011e3b1c3e5b40c20ff3dbe6f9,1,1,1,2,1,2014-11-25 12:48:12,2014-11-25 05:20:46
c1552af1fe5832011e3b1c3e5b40c20ff3dbe6f9...d43dd03ca3afecc27f43fbc932f239470a2f07db,1,7,0,7,1,2014-11-25 14:09:13,2014-11-25 14:09:13
d43dd03ca3afecc27f43fbc932f239470a2f07db...9a30acad8a1996c914351bad981d937de4db29a4,7,136,22,158,24,2014-11-25 14:22:18,2014-11-21 16:55:58
9a30acad8a1996c914351bad981d937de4db29a4...4c123d0f79b3f417ec5b030c616365882e734a1e,2,3,0,3,2,2014-11-25 14:41:56,2014-11-24 19:11:55
4c123d0f79b3f417ec5b030c616365882e734a1e...a973fb2d68f2e23e599a601fdaec13d129207e9f,1,7,4,11,3,2014-11-25 14:47:32,2014-11-25 11:07:22
a973fb2d68f2e23e599a601fdaec13d129207e9f...056a3c6c374f15e23746ea8568cd5b11bfe7d442,6,62,10,72,15,2014-11-25 15:12:28,2014-10-17 13:46:42
056a3c6c374f15e23746ea8568cd5b11bfe7d442...ff3d746e8d8e8fbe6de287bd0f4c3a9fa23c18dc,2,35,10,45,6,2014-11-25 15:37:34,2014-11-25 13:29:38
ff3d746e8d8e8fbe6de287bd0f4c3a9fa23c18dc...392e11945fa246d751d23bb515703fcaf55dfa26,1,3,3,6,1,2014-11-25 16:20:40,2014-11-25 16:20:40
392e11945fa246d751d23bb515703fcaf55dfa26...8e7b384d89db67e450aef1f2eb9a12703a5942e9,3,16,11,27,3,2014-11-25 16:22:15,2014-11-23 14:08:34
8e7b384d89db67e450aef1f2eb9a12703a5942e9...e0d1f2684ae60573b209783f9fd4f9db163ad704,1,6,0,6,2,2014-11-25 18:14:01,2014-11-25 18:13:45
e0d1f2684ae60573b209783f9fd4f9db163ad704...f9c4e14aeca7df79991bca8ac2d743953cbd095c,9,67,27,94,25,2014-11-25 18:26:50,2014-11-16 15:42:09
f9c4e14aeca7df79991bca8ac2d743953cbd095c...3a9aa155e2f7326df669953980ac87e78e932c43,3,21,12,33,7,2014-11-25 20:28:21,2014-11-25 19:27:46
3a9aa155e2f7326df669953980ac87e78e932c43...c335c0fee92a658b6a09453ae73e5c542f10703a,4,31,3,34,8,2014-11-25 21:11:35,2014-11-25 18:24:57
c335c0fee92a658b6a09453ae73e5c542f10703a...8b15018fd57b7b10df321b61a17601982660ebdc,1,3,0,3,1,2014-11-26 08:22:04,2014-11-26 08:22:04
8b15018fd57b7b10df321b61a17601982660ebdc...296860f791ecdebf1c9f81db778f4d5b855c420b,1,0,5,5,1,2014-11-26 14:35:41,2014-11-26 14:35:41
296860f791ecdebf1c9f81db778f4d5b855c420b...6302893112a67343b3f5eff3f09f91b245346877,11,58,937,995,18,2014-11-26 14:41:52,2014-10-17 20:50:24
6302893112a67343b3f5eff3f09f91b245346877...9cebb95348ae6ceccdfab658a16628dfc64a06cb,1,3,3,6,1,2014-11-26 14:47:37,2014-11-26 14:45:10
9cebb95348ae6ceccdfab658a16628dfc64a06cb...14a3b60981f63334520c713bb3a2c9c694c49a1f,210,0,6253,6253,120,2014-11-26 14:56:33,2014-11-26 14:56:33
14a3b60981f63334520c713bb3a2c9c694c49a1f...379431ef91023f47797a29bb0931685033c24827,22,28,70,98,41,2014-11-26 17:46:06,2014-11-26 17:46:06
379431ef91023f47797a29bb0931685033c24827...cc870b8ef5e3464c6f051e3ef0a25dfc4b597452,1,37,2,39,3,2014-11-26 19:03:08,2014-11-26 03:48:36
cc870b8ef5e3464c6f051e3ef0a25dfc4b597452...cbb5cdd155668ba771cad6b975676d3b20fed37b,10,93,235,328,37,2014-11-26 22:49:25,2014-11-18 09:24:33
cbb5cdd155668ba771cad6b975676d3b20fed37b...e9d1f1182aaccaa8b60cf6a3491f0103d2bb0229,3,37,0,37,3,2014-11-26 23:41:54,2014-11-18 14:03:13
e9d1f1182aaccaa8b60cf6a3491f0103d2bb0229...87bd13617c57a806deb550e3af1c06ce00517a9c,1,2,2,4,2,2014-11-27 10:52:50,2014-11-27 02:18:47
87bd13617c57a806deb550e3af1c06ce00517a9c...c7fd9b242d2d63406f1de6cc3204e35aaa025233,3,33,96,129,14,2014-11-27 11:26:53,2014-11-20 10:35:56
c7fd9b242d2d63406f1de6cc3204e35aaa025233...bd337184f1b4901abdfd07b0219d6b9b45d0de2f,3,81,7,88,7,2014-11-27 11:50:08,2014-11-20 12:30:25
bd337184f1b4901abdfd07b0219d6b9b45d0de2f...093e6c68b9b5afdf1f059a2321affc999763e919,4,83,3,86,6,2014-11-27 12:55:07,2014-11-07 19:57:04
093e6c68b9b5afdf1f059a2321affc999763e919...a15aba66f2fc650f70a791fb7fa880cf85cb1229,1,3,4,7,1,2014-11-27 15:53:06,2014-11-27 15:21:28
a15aba66f2fc650f70a791fb7fa880cf85cb1229...d66bda60590daabe21f60a532a613a31a10fedbd,2,16,0,16,2,2014-11-27 16:22:36,2014-11-27 16:22:23
d66bda60590daabe21f60a532a613a31a10fedbd...7cd3f1c29595d1da7f37d29e7c3bc6a7a314cd1d,1,4,0,4,1,2014-11-27 18:02:21,2014-11-24 19:10:23
7cd3f1c29595d1da7f37d29e7c3bc6a7a314cd1d...dd35cc232aefd491c9b3b4461a22055734daf376,7,30,15,45,20,2014-11-27 18:06:35,2014-11-25 12:35:39
dd35cc232aefd491c9b3b4461a22055734daf376...abf87333a163717308927ad1f230efe45d622c69,2,14,3,17,4,2014-11-27 23:43:45,2014-11-27 02:16:31
abf87333a163717308927ad1f230efe45d622c69...f39b0421b406b411c3bcb58e8aa415d885fea505,8,54,4,58,18,2014-11-28 00:42:30,2014-09-08 17:38:07
f39b0421b406b411c3bcb58e8aa415d885fea505...6b5d82749c57a1aae8c9e81d2b85b2cadb9ef933,8,163,19,182,19,2014-11-28 10:50:42,2014-09-27 10:41:54
6b5d82749c57a1aae8c9e81d2b85b2cadb9ef933...e023ceb453c02e271d00f9ac25e154b7be712bb0,4,52,4,56,11,2014-11-28 11:00:06,2014-11-25 23:05:44
e023ceb453c02e271d00f9ac25e154b7be712bb0...912ad03226687dae91971ebd7e5cf87521f6b0de,6,182,41,223,51,2014-11-28 11:05:56,2014-11-22 17:57:13
912ad03226687dae91971ebd7e5cf87521f6b0de...c7175fcdfe94be60c04f3b1ceb6d0b2def2b6f09,9,265,11,276,13,2014-11-28 11:54:00,2014-07-05 06:03:52
c7175fcdfe94be60c04f3b1ceb6d0b2def2b6f09...ab89414f40db1598364a7fe4cfac1766cacd2668,5,189,131,320,48,2014-11-28 12:30:26,2014-11-17 08:26:10
ab89414f40db1598364a7fe4cfac1766cacd2668...deb607648ed7d484a90474b6da48642b4f39bca7,5,40,8,48,8,2014-11-28 12:48:39,2014-11-11 04:41:55
deb607648ed7d484a90474b6da48642b4f39bca7...ecf7814b3ab838a7c5e8ce14dde9ab8c46da13d0,1,1,1,2,2,2014-11-28 14:17:00,2014-11-28 14:17:00
ecf7814b3ab838a7c5e8ce14dde9ab8c46da13d0...9e80c5f457340126adcae375d6de5ee64d6075b9,3,36,5,41,8,2014-11-28 15:47:33,2014-11-27 09:35:10
9e80c5f457340126adcae375d6de5ee64d6075b9...9253042d53d61b23b3f727a00c41e8089be73836,1,38,0,38,3,2014-11-28 15:51:15,2014-08-02 23:50:55
9253042d53d61b23b3f727a00c41e8089be73836...47789410dbf351fd17a7854492b7b5b99a66bb1c,6,50,53,103,19,2014-11-28 22:59:55,2014-11-27 03:44:56
47789410dbf351fd17a7854492b7b5b99a66bb1c...17fe0bd808a47f37dd1351adb01a8ad2cc852f24,12,163,4,167,15,2014-11-28 23:22:20,2014-09-05 20:53:11
17fe0bd808a47f37dd1351adb01a8ad2cc852f24...8402909876a2dbb3fa4d011fdb8fb7ecb44c9108,1,55,37,92,9,2014-11-29 00:00:08,2014-11-27 14:45:24
8402909876a2dbb3fa4d011fdb8fb7ecb44c9108...860eb01d175f88ce9f77bc823f9711eb078db796,1,0,12,12,1,2014-11-29 10:21:25,2014-11-29 10:15:37
860eb01d175f88ce9f77bc823f9711eb078db796...3131e9cef5f0a96f4fe667b0b1626c238153d1f1,11,46,21,67,19,2014-11-29 15:27:04,2014-11-26 21:21:29
3131e9cef5f0a96f4fe667b0b1626c238153d1f1...c8dcded930a1d0ee5688ae2c2eeb8c33d942009f,5,15,2,17,6,2014-11-29 15:31:09,2014-11-29 06:19:59
c8dcded930a1d0ee5688ae2c2eeb8c33d942009f...6dbe979b4d9396e1b307c7d27388c97c13beb21c,7,76,60,136,29,2014-11-29 16:21:58,2014-11-28 22:47:53
6dbe979b4d9396e1b307c7d27388c97c13beb21c...88edce2abb235999523b65977dd1214cb39dabaa,1,1,1,2,1,2014-12-01 00:12:19,2014-12-01 00:08:46
88edce2abb235999523b65977dd1214cb39dabaa...d2202ec2d4d0477b682c6d0051f27ab4843ef89f,3,23,5,28,7,2014-12-01 04:30:33,2014-11-30 17:11:52
d2202ec2d4d0477b682c6d0051f27ab4843ef89f...e6f19ec3223ba7c398aea515c5e0f8b93e6f4359,3,20,2,22,5,2014-12-01 16:30:50,2014-11-29 13:42:06
e6f19ec3223ba7c398aea515c5e0f8b93e6f4359...9136ceb6fb8225625631671147ff70c1fcfbbcdc,7,121,214,335,85,2014-12-01 16:34:15,2014-11-29 17:09:40
9136ceb6fb8225625631671147ff70c1fcfbbcdc...fce2890e92497bec8306925f746b81ec0aeeebff,1,0,2,2,2,2014-12-01 16:36:54,2014-11-29 17:42:56
fce2890e92497bec8306925f746b81ec0aeeebff...3a8799c8a49ebfc8b72d4f23c04fae6f2c58366f,1,0,1,1,1,2014-12-01 16:37:08,2014-11-29 19:27:19
3a8799c8a49ebfc8b72d4f23c04fae6f2c58366f...b481c856978e30d54f961f3fab6ee20e0445a236,1,1,1,2,1,2014-12-01 16:37:51,2014-11-29 17:13:28
b481c856978e30d54f961f3fab6ee20e0445a236...e1513a7960399054d6686efb287f3887ad84b73f,1,21,11,32,6,2014-12-01 17:49:45,2014-12-01 13:21:03
e1513a7960399054d6686efb287f3887ad84b73f...777b4c26e343d07764a35132462e92c07e4b0aec,1,0,2,2,1,2014-12-01 18:19:58,2014-11-29 08:33:06
777b4c26e343d07764a35132462e92c07e4b0aec...e11c6fd2184a9e7b23c777e5824f9ded6221d905,3,14,1,15,3,2014-12-01 19:26:40,2014-12-01 10:13:01
e11c6fd2184a9e7b23c777e5824f9ded6221d905...1f98ec2e53e4636863396ab54f671f4546f9ba4c,1,58,11,69,6,2014-12-01 19:38:16,2014-11-29 08:36:39
1f98ec2e53e4636863396ab54f671f4546f9ba4c...43fcf3505eb22228f551ab03122f99b3d40f38ed,1,2,2,4,2,2014-12-01 20:47:41,2014-12-01 20:47:41
43fcf3505eb22228f551ab03122f99b3d40f38ed...82e4f956e3faa4a48fe3c90e02673c1a916d6943,6,34,8,42,12,2014-12-01 21:08:25,2014-11-29 16:45:06
82e4f956e3faa4a48fe3c90e02673c1a916d6943...b8cc5f3cd4c70518dceb894edf9717abff79f0b4,1,5,2,7,1,2014-12-01 21:42:48,2014-12-01 21:42:48
b8cc5f3cd4c70518dceb894edf9717abff79f0b4...1739ae9edc6e6c07ca20cad36dd15316f18f3f8e,2,12,2,14,3,2014-12-01 23:42:08,2014-11-29 14:36:36
1739ae9edc6e6c07ca20cad36dd15316f18f3f8e...bfc75996f9b7486929f0c4340bca54a8afa7ecfb,3,14,1,15,4,2014-12-02 00:36:50,2014-11-30 17:03:40
bfc75996f9b7486929f0c4340bca54a8afa7ecfb...1e1ac4ec5b925e42ee9bf922a3662426b4b43336,1,1,1,2,1,2014-12-02 05:24:56,2014-12-02 05:21:49
1e1ac4ec5b925e42ee9bf922a3662426b4b43336...5760fe66dfa19eb38dc7c335d7a360e533b7a352,1,1,1,2,1,2014-12-02 12:26:45,2014-12-02 02:53:15
5760fe66dfa19eb38dc7c335d7a360e533b7a352...1da1fe8e16e4f49447f7fb94fb092cfeafff7058,1,8,7,15,6,2014-12-02 12:31:52,2014-12-02 04:51:16
1da1fe8e16e4f49447f7fb94fb092cfeafff7058...0623f4dea46eefba46efde6c6528f7d813ef4391,5,92,7,99,12,2014-12-02 13:42:17,2014-11-27 18:34:14
0623f4dea46eefba46efde6c6528f7d813ef4391...bba545345f46f09245799f7ae0a22177a84eba71,2,5,2,7,3,2014-12-02 17:01:51,2014-12-02 14:12:33
bba545345f46f09245799f7ae0a22177a84eba71...4df3a3e0e9bfcd64a3e2eb85e0d4449d7b8f4f6e,3,60,2,62,4,2014-12-02 18:56:35,2014-12-01 15:32:40
4df3a3e0e9bfcd64a3e2eb85e0d4449d7b8f4f6e...ac51496ceb07888c034d42deee864d3e32a8152f,4,46,19,65,21,2014-12-02 18:56:50,2014-12-01 17:34:50
ac51496ceb07888c034d42deee864d3e32a8152f...00fa1474d7d2dbd5530a650ea9fe09f36bff77c7,4,89,56,145,28,2014-12-02 18:56:50,2014-12-02 16:53:04
00fa1474d7d2dbd5530a650ea9fe09f36bff77c7...5c773447c3239a297b22929f0df15d2971d72e77,1,2,2,4,2,2014-12-02 20:57:08,2014-12-02 20:57:08
5c773447c3239a297b22929f0df15d2971d72e77...4a4ad27712b44cebada1bdaebd082cf82df74610,1,21,0,21,3,2014-12-02 22:53:27,2014-12-02 22:42:07
4a4ad27712b44cebada1bdaebd082cf82df74610...b872134bfc14f6322bd1e4b0a08bf5bfd2c43a52,41,4855,1369,6224,53,2014-12-03 00:18:35,2014-11-12 01:32:44
b872134bfc14f6322bd1e4b0a08bf5bfd2c43a52...adacbd64a062662f54d6e91dc4e460eff96b5dd5,1,1,0,1,1,2014-12-03 12:04:23,2014-12-03 11:22:15
adacbd64a062662f54d6e91dc4e460eff96b5dd5...9d1a69579b996eaa208f141b409141be63f597ec,2,18,2,20,6,2014-12-03 12:49:06,2014-11-30 08:29:52
9d1a69579b996eaa208f141b409141be63f597ec...dee4d23f7e703aec2d1244e4facbf7f4c88deed5,3,28,14,42,4,2014-12-03 13:22:29,2014-12-03 01:52:58
dee4d23f7e703aec2d1244e4facbf7f4c88deed5...da9fe5c717c179a9e881a40efd3bfe36a21bf4a6,7,136,35,171,28,2014-12-03 15:37:04,2014-10-18 21:01:13
da9fe5c717c179a9e881a40efd3bfe36a21bf4a6...26dd518b5c0c6f4a7678bfb7bd3ed0bf8dc8978e,2,107,95,202,44,2014-12-03 15:37:12,2014-10-18 21:30:58
26dd518b5c0c6f4a7678bfb7bd3ed0bf8dc8978e...b06dfad88fb12a927c86a1eb23064201c9560fb1,5,59,34,93,12,2014-12-03 18:11:47,2014-12-03 12:33:44
b06dfad88fb12a927c86a1eb23064201c9560fb1...50c1d8f24b0d04c813b3dd34720df86446091afa,4,41,0,41,3,2014-12-03 18:47:23,2014-12-03 14:44:09
50c1d8f24b0d04c813b3dd34720df86446091afa...560b4207b1490a7d0cbf70cfbeba7daf2082e5be,24,72,72,144,69,2014-12-03 19:27:38,2014-11-27 00:41:27
560b4207b1490a7d0cbf70cfbeba7daf2082e5be...49d034fff21213b369c08b39772e0437c3cc723b,1,1,1,2,1,2014-12-03 23:41:46,2014-12-03 22:13:36
49d034fff21213b369c08b39772e0437c3cc723b...2cd19f3738b9c4a6861c007bf22f72a386cba07f,1,135,133,268,40,2014-12-03 23:54:47,2014-12-03 21:24:42
2cd19f3738b9c4a6861c007bf22f72a386cba07f...16f26defa7510707742a15aa89cae56f11d14c3f,39,90,90,180,90,2014-12-03 23:56:46,2014-12-03 20:36:17
16f26defa7510707742a15aa89cae56f11d14c3f...4b23a6c7a9232cc07ec95fe98be17efbd4449822,1,11,0,11,1,2014-12-04 00:18:55,2014-11-30 23:02:43
4b23a6c7a9232cc07ec95fe98be17efbd4449822...3ab8d0b8c7b6d26f8c1ed97b6a3ac2ae735f1ec9,1,1,1,2,1,2014-12-04 00:52:54,2014-12-04 00:39:54
3ab8d0b8c7b6d26f8c1ed97b6a3ac2ae735f1ec9...dc2d75f4d43ca735bfdded52ff90458ebecb9348,1,1,1,2,1,2014-12-04 01:07:40,2014-12-04 01:07:40
dc2d75f4d43ca735bfdded52ff90458ebecb9348...018d110ef547acb71b0526d0ff934e1e476244e4,5,47,4,51,11,2014-12-04 12:42:03,2014-11-29 16:41:06
018d110ef547acb71b0526d0ff934e1e476244e4...765fa36d57d08d0568438f6fd74521e7a56abb61,4,23,3,26,5,2014-12-04 15:57:10,2014-12-04 14:11:30
765fa36d57d08d0568438f6fd74521e7a56abb61...7daf00679d2848fdb6f5618009817b56486fce1b,1,42,30,72,13,2014-12-04 16:05:26,2014-11-27 22:00:28
7daf00679d2848fdb6f5618009817b56486fce1b...ce2eff7e482bcf00eb279cf66a673e273af32300,1,2,2,4,2,2014-12-04 18:24:41,2014-12-04 14:18:44
ce2eff7e482bcf00eb279cf66a673e273af32300...8d7a48027ef6848f693f57ae442a1b0ace0ebcdc,4,105,18,123,14,2014-12-04 20:27:42,2014-12-04 16:56:11
8d7a48027ef6848f693f57ae442a1b0ace0ebcdc...17c401302858bccfb607b5bade0714328b11cb0d,1,0,1,1,1,2014-12-04 20:31:55,2014-12-04 20:31:55
17c401302858bccfb607b5bade0714328b11cb0d...1d3e41e1cfc9bc648e88a5ab680420aebb5a144b,1,2,0,2,1,2014-12-04 21:42:24,2014-12-04 21:42:24
1d3e41e1cfc9bc648e88a5ab680420aebb5a144b...b6ea059b4ab7a4ed7e84cad639df95fc9d61dd81,5,82,0,82,8,2014-12-05 12:37:34,2014-12-04 16:56:30
b6ea059b4ab7a4ed7e84cad639df95fc9d61dd81...f0c7a6f36005d489e049236922abe0bd3a3eac2c,1,1,1,2,2,2014-12-05 16:31:53,2014-12-05 15:23:14
f0c7a6f36005d489e049236922abe0bd3a3eac2c...ebfadb808043c689b19cfee818c10f63866ee8fc,1,1,1,2,1,2014-12-05 18:17:14,2014-12-05 18:17:14
ebfadb808043c689b19cfee818c10f63866ee8fc...d05709821cf6ff77e00871d6fac3eb43356d44d1,1,12,7,19,1,2014-12-05 21:19:59,2014-12-05 14:25:10
d05709821cf6ff77e00871d6fac3eb43356d44d1...e3091350811dce8a38fc97cb3d14db5c970f1ec7,1,1,1,2,1,2014-12-06 11:47:08,2014-12-06 11:46:39
e3091350811dce8a38fc97cb3d14db5c970f1ec7...0fde2ca0368928bb8ee16b06b8ca33031bb779b7,1,1,1,2,1,2014-12-06 14:22:46,2014-12-06 12:56:43
0fde2ca0368928bb8ee16b06b8ca33031bb779b7...34a06d99e0fc96a0f0648bfde141d342e963e971,1,1,1,2,1,2014-12-06 14:25:48,2014-12-05 18:02:59
34a06d99e0fc96a0f0648bfde141d342e963e971...5c68870169deec9eff392c53a8e74e3482f02ade,89,1682,543,2225,91,2014-12-06 15:57:46,2014-12-04 02:21:11
5c68870169deec9eff392c53a8e74e3482f02ade...3bb52c50193bdfaa56134d055f067d1dfe302158,1,8,0,8,2,2014-12-06 16:27:15,2014-12-06 16:27:15
3bb52c50193bdfaa56134d055f067d1dfe302158...5281d9620d13386fd4403f7aa6b9a2afd9b5a93f,1,3,2,5,1,2014-12-06 16:51:32,2014-12-06 16:51:32
5281d9620d13386fd4403f7aa6b9a2afd9b5a93f...e32a8a99d99c3d6c3015e220f6719f6ddc48b4f1,1,28,17,45,5,2014-12-06 17:06:06,2014-12-05 16:15:33
e32a8a99d99c3d6c3015e220f6719f6ddc48b4f1...106dde91e4dc30766db00d4ea21b4f954f49e83e,1,1,5,6,2,2014-12-06 18:00:25,2014-12-05 14:13:22
106dde91e4dc30766db00d4ea21b4f954f49e83e...40c60efecc0fc73f0b2320b44d684586b52ee799,1,12,9,21,9,2014-12-06 18:59:49,2014-12-06 18:59:49
40c60efecc0fc73f0b2320b44d684586b52ee799...4832320e8d5038d0454cc3e1dd1dc177d0419fa9,1,2,2,4,2,2014-12-06 19:39:53,2014-12-06 19:39:53
4832320e8d5038d0454cc3e1dd1dc177d0419fa9...1917017b8d38a9c330456cbdf2e81b0dc49e6477,1,2,4,6,2,2014-12-06 19:40:55,2014-12-06 19:40:55
1917017b8d38a9c330456cbdf2e81b0dc49e6477...9f427617e4559012e1c2fd8fce46cbe225d8515d,3,18,0,18,5,2014-12-06 19:46:01,2014-12-05 20:14:20
d2d6c0c097072e2a8ece755fdc2d50c111104e7d...0d1a9d203a970a82a2f81edf0ba7d4b55442fd78,1,9,5,14,3,2014-11-15 19:31:09,2014-11-15 19:31:09
d2d6c0c097072e2a8ece755fdc2d50c111104e7d...013b5eaceac7b05dbf41d367e1899a27aa12f7be,1,6,0,6,1,2014-11-15 18:47:05,2014-11-15 10:29:58
013b5eaceac7b05dbf41d367e1899a27aa12f7be...27c9b3a27d313e75732c1e8e966b320ddbde499d,1,3,0,3,1,2014-11-15 19:03:22,2014-11-15 10:53:36
27c9b3a27d313e75732c1e8e966b320ddbde499d...5b9470efd8725eb349e6f3a66b0ea1073ede5b47,1,2,2,4,1,2014-11-15 19:42:08,2014-11-15 19:41:25
5b9470efd8725eb349e6f3a66b0ea1073ede5b47...68ef44c565d901945eb74768d439c93678315cf6,4,14,11,25,14,2014-11-16 01:12:36,2014-11-16 01:05:54
68ef44c565d901945eb74768d439c93678315cf6...c38db4d7e072e9a5002cb4897d9104e5eaa292ed,2,10,1,11,2,2014-11-16 08:03:20,2014-11-15 19:26:18
9f427617e4559012e1c2fd8fce46cbe225d8515d...1a408e42eef34d8302da06fcbeaccfa6395d1c92,1,1,1,2,1,2014-12-06 21:49:59,2014-12-06 21:49:59
7d833ee38a00aadd84dbdb4ac947e98a7e91d7aa...6bc343d8749b3698dd15d1de59dfc02928bb772c,1,2,1,3,1,2014-12-08 12:18:54,2014-12-07 20:02:19
6bc343d8749b3698dd15d1de59dfc02928bb772c...b327a614eb7d885441c6a2575e10b70ac1352aae,1,6,1,7,4,2014-12-08 12:23:34,2014-12-07 23:34:03
b327a614eb7d885441c6a2575e10b70ac1352aae...4468c08d70b5b722f3ebd4872909e56580ec7d68,65,169,169,338,118,2014-12-08 12:58:23,2014-12-06 21:00:09
4468c08d70b5b722f3ebd4872909e56580ec7d68...4d27d72d149b714431b77f2f15bad1591a9602b7,1,7,0,7,1,2014-12-08 17:54:04,2014-12-08 15:49:35
4d27d72d149b714431b77f2f15bad1591a9602b7...1aa41dd000e0779c8b1de1f8e7aa4a0f2f752655,1,6,4,10,2,2014-12-08 18:15:46,2014-12-08 18:15:46
1aa41dd000e0779c8b1de1f8e7aa4a0f2f752655...8f97413faed5431713c034897cda486507bf0cc3,6,24,45,69,9,2014-12-08 21:22:53,2014-12-06 10:05:54
8f97413faed5431713c034897cda486507bf0cc3...bac7664f274be834a09e037331889959f04a75e7,4,31,27,58,11,2014-12-08 21:22:53,2014-12-06 14:11:20
bac7664f274be834a09e037331889959f04a75e7...c0b65150ff86217e02c300afc03e44d6b5775ee8,1,1,1,2,1,2014-12-08 21:31:07,2014-12-08 21:31:07
c0b65150ff86217e02c300afc03e44d6b5775ee8...6b2d3f9206e6eb2aafb75dcd0ef50ce672bc0ff3,3,6,9,15,3,2014-12-09 09:10:51,2014-11-18 20:24:48
6b2d3f9206e6eb2aafb75dcd0ef50ce672bc0ff3...fa6e3a40e1866b64eb30e0dfbd43b340c0d831da,1,2,2,4,1,2014-12-09 12:26:57,2014-12-09 12:26:57
fa6e3a40e1866b64eb30e0dfbd43b340c0d831da...fd60e6c8878986a102f0125d9cdf61c717605cf1,1,4,0,4,1,2014-12-09 16:17:05,2014-12-09 16:14:33
fd60e6c8878986a102f0125d9cdf61c717605cf1...38fc463fbfb9b74c38f1e8c33e4c99bc2274a880,1,1,1,2,1,2014-12-11 17:11:02,2014-12-11 15:19:10
38fc463fbfb9b74c38f1e8c33e4c99bc2274a880...44927ba817a4ecf9834d429ff6c86bc5ac961305,3,28,1,29,3,2014-12-11 18:28:21,2014-12-11 16:52:42
44927ba817a4ecf9834d429ff6c86bc5ac961305...d4e449d73029dd512acb5f156ee5b4e93189e7b9,1,1,1,2,1,2014-12-11 18:30:31,2014-12-11 18:28:13
d4e449d73029dd512acb5f156ee5b4e93189e7b9...059c9ab24c41e1460fd8b7af65ea8d5f80f1aa82,4,29,0,29,4,2014-12-11 18:56:56,2014-12-10 22:25:05
059c9ab24c41e1460fd8b7af65ea8d5f80f1aa82...6a141832ab9be30d1bde4794560897bcdbe68fb6,2,2,1,3,2,2014-12-11 19:43:47,2014-12-11 19:43:47
6a141832ab9be30d1bde4794560897bcdbe68fb6...3bb78c5e7a330ed70c518e77899bf8a5ac6bf766,2,15,0,15,3,2014-12-11 20:56:54,2014-12-09 19:50:45
3bb78c5e7a330ed70c518e77899bf8a5ac6bf766...f66d9a2300f8fcb82d2bb21c43dc0e658c49086a,1,106,55,161,22,2014-12-11 22:13:24,2014-11-07 14:35:02
f66d9a2300f8fcb82d2bb21c43dc0e658c49086a...6db122c7aba5738aad92aa20c9bbf2dea6d3308e,1,89,60,149,17,2014-12-11 22:47:36,2014-11-10 12:40:02
6db122c7aba5738aad92aa20c9bbf2dea6d3308e...079ee1ff5d3ae7afee34eb9a79007f283f1471ab,1,7,0,7,1,2014-12-11 23:01:34,2014-12-11 23:01:34
079ee1ff5d3ae7afee34eb9a79007f283f1471ab...43041ee48c802418ec935a2ece59f876f5888c40,1,34,20,54,25,2014-12-11 23:24:23,2014-11-10 13:41:17
43041ee48c802418ec935a2ece59f876f5888c40...0dea81cd6d34b3e41cc4bbec99b5fdf06142b09e,3,23,1,24,3,2014-12-12 13:47:21,2014-12-08 22:37:59
0dea81cd6d34b3e41cc4bbec99b5fdf06142b09e...119154ca7f65d423bb742aa0e32ffcfcb21d4b87,2,50,33,83,7,2014-12-12 14:16:15,2014-12-04 13:05:59
119154ca7f65d423bb742aa0e32ffcfcb21d4b87...e2868308bfa4ec165fb54b6128ee18a7b4d50643,5,7,7,14,7,2014-12-12 14:34:18,2014-12-12 13:27:04
e2868308bfa4ec165fb54b6128ee18a7b4d50643...267a1dcd9b7877d97917ba6222fd247da060f9b0,9,57,20,77,15,2014-12-12 15:17:48,2014-12-01 06:11:23
267a1dcd9b7877d97917ba6222fd247da060f9b0...c7a19f42030c15ad3b3475ad9a4854e10733ff74,3,22,0,22,3,2014-12-12 15:24:39,2014-12-04 13:22:45
c7a19f42030c15ad3b3475ad9a4854e10733ff74...df30ae07fc7d7500bbbe51ed3361982f645169f2,4,30,26,56,14,2014-12-12 19:08:07,2014-12-09 14:27:20
df30ae07fc7d7500bbbe51ed3361982f645169f2...8aaf51f94c70e3cfcd2c75a0be1b6f55049d82d8,3,7,15,22,6,2014-12-12 19:50:39,2014-12-11 19:36:13
8aaf51f94c70e3cfcd2c75a0be1b6f55049d82d8...d4bdddeefe35214f194cb85e40dbb761c206e7fa,1,20,0,20,1,2014-12-12 19:50:39,2014-12-11 19:51:04
d4bdddeefe35214f194cb85e40dbb761c206e7fa...c72eb80d114fb5d90bd21b5549e8abd0bbd17f99,4,10,6,16,5,2014-12-12 19:50:39,2014-12-12 00:28:03
c72eb80d114fb5d90bd21b5549e8abd0bbd17f99...df9f2e41fae68e2079db61e07569fdc89d1d6343,1,0,21,21,2,2014-12-12 21:14:10,2014-12-12 21:08:45
df9f2e41fae68e2079db61e07569fdc89d1d6343...a5499b0916298caedfd683041515f4e3aa2c5d6d,1,0,0,0,0,2014-12-13 15:23:49,2014-12-13 15:23:06
a5499b0916298caedfd683041515f4e3aa2c5d6d...895dc880ebef46c9577c6908daf283248685f73c,27,95,94,189,95,2014-12-13 17:45:58,2014-12-13 13:04:36
895dc880ebef46c9577c6908daf283248685f73c...bc88ec550afd5ce972b8c902572c6447d89c0cc9,1,4,1,5,1,2014-12-13 18:42:25,2014-12-13 18:41:31
bc88ec550afd5ce972b8c902572c6447d89c0cc9...cc6275eeefe3da508a1203cf39aed237962e0171,2,7,2,9,2,2014-12-13 21:06:42,2014-12-13 20:54:28
cc6275eeefe3da508a1203cf39aed237962e0171...71a559e7714bf3da8987d9fc44a8ad7a9b2f9244,1,0,5,5,1,2014-12-13 21:51:57,2014-12-13 21:51:57
71a559e7714bf3da8987d9fc44a8ad7a9b2f9244...9495989265306b773fdc7f6ac8d6739c7e294444,3,12,9,21,10,2014-12-14 15:48:42,2014-12-14 15:43:27
71a559e7714bf3da8987d9fc44a8ad7a9b2f9244...2ca0870b672413cf5bc6e441bda58839f902f5b0,1,8,8,16,5,2014-12-14 12:38:01,2014-12-14 12:37:26
0fc188251069b73b293f79dba6f3e9e331ad7e91...7c1f3901bcdabb1340a621e7df9b24f3acd0d6f3,1,0,5,5,2,2014-12-14 22:07:10,2014-12-13 22:59:05
7c1f3901bcdabb1340a621e7df9b24f3acd0d6f3...e37ab311fc52ff5c9ea0951ce3a8d8b38f285900,3,27,15,42,9,2014-12-15 13:32:47,2014-11-05 18:53:16
e37ab311fc52ff5c9ea0951ce3a8d8b38f285900...aa5ef0d4fc67a95ac2a5103810d0c87d8c547bac,28,609,49,658,85,2014-12-15 13:34:15,2014-12-12 22:19:58
aa5ef0d4fc67a95ac2a5103810d0c87d8c547bac...9aeb917dad2c3d4c2830f38d3bfc63699e0ba837,9,135,8,143,18,2014-12-15 14:45:31,2014-12-07 23:21:07
9aeb917dad2c3d4c2830f38d3bfc63699e0ba837...0d5ca7b560dbb827eea625e53e4a6a67c29d7964,3,3,4,7,3,2014-12-15 15:09:18,2014-12-15 14:47:23
0d5ca7b560dbb827eea625e53e4a6a67c29d7964...d8182f294aa0a8dfb3ea4611a9adb7a748a36bf4,1,2,2,4,1,2014-12-15 15:48:42,2014-12-13 20:00:38
d8182f294aa0a8dfb3ea4611a9adb7a748a36bf4...e8223b889aab3b5ac0c2312eb9ee2307ea635c97,1,1,1,2,1,2014-12-15 17:04:07,2014-12-15 17:04:07
e8223b889aab3b5ac0c2312eb9ee2307ea635c97...222699d224ee7851e1cab5ecc029cf83836b882b,1,1,1,2,1,2014-12-15 17:25:55,2014-12-13 20:15:39
222699d224ee7851e1cab5ecc029cf83836b882b...089047331d972c0ee58d13476fc54f2118bf1359,3,31,2,33,3,2014-12-15 18:40:24,2014-12-15 14:14:39
089047331d972c0ee58d13476fc54f2118bf1359...d39461eb46b2d11051940e16818baf2f0e1b894d,1,2,2,4,2,2014-12-15 18:42:52,2014-12-15 18:42:52
d39461eb46b2d11051940e16818baf2f0e1b894d...d8f3b86a7691c8aa0ec8f5a064ad4c3218250fed,3,53,3,56,5,2014-12-15 19:41:52,2014-12-06 20:43:19
d8f3b86a7691c8aa0ec8f5a064ad4c3218250fed...3ef50a772b6419c0c41635f80995df25fbc5116e,1,6,5,11,4,2014-12-15 22:54:40,2014-12-15 21:42:17
3ef50a772b6419c0c41635f80995df25fbc5116e...ac5f2a4ef7b9993502ebc02f487cbb06bfb9bf0a,1,1,1,2,1,2014-12-15 23:15:55,2014-12-15 23:15:55
ac5f2a4ef7b9993502ebc02f487cbb06bfb9bf0a...c17d821fa74b01205f3a2fe42a96dfe804de3df3,1,19,24,43,5,2014-12-16 00:05:19,2014-12-15 21:30:02
c17d821fa74b01205f3a2fe42a96dfe804de3df3...4efe1b79e9462318ff8b2c76a09c5925ad0e0f7c,1,3,1,4,1,2014-12-16 00:15:26,2014-12-16 00:15:26
4efe1b79e9462318ff8b2c76a09c5925ad0e0f7c...4fada6f1c9930e589aebe8bdfb5795f69d253c07,2,3,1,4,3,2014-12-16 09:54:59,2014-12-16 06:49:40
2cb9d984cf7a0965ca6b1322ab836d56278f8749...ca013e652f912e279c128d4d2631eaa3b02e4db7,5,0,124,124,42,2014-12-16 14:12:46,2014-12-16 14:10:10
ca013e652f912e279c128d4d2631eaa3b02e4db7...3dbbb8a89ca4beaabd5359fe82e32ed633b15140,4,15,0,15,5,2014-12-16 15:48:49,2014-12-16 00:22:28
3dbbb8a89ca4beaabd5359fe82e32ed633b15140...f91d7366e066dc5e1edd90c6bde438fae9fe67fb,53,1292,754,2046,96,2014-12-16 19:45:19,2014-12-15 14:33:33
f91d7366e066dc5e1edd90c6bde438fae9fe67fb...d2ff8a7241b621b8013c7ec1631e95ae4445f76d,4,24,1,25,4,2014-12-16 23:34:25,2014-12-09 13:43:40
d2ff8a7241b621b8013c7ec1631e95ae4445f76d...104aaab7049afc6ef456fee52763f6d4f7dd575d,1,2,2,4,2,2014-12-17 00:00:42,2014-12-16 23:53:31
104aaab7049afc6ef456fee52763f6d4f7dd575d...1c5cbf5e5d5b350f4df4aca6431d46c767d3785a,2,15,3,18,6,2014-12-17 08:04:52,2014-12-17 07:47:58
1c5cbf5e5d5b350f4df4aca6431d46c767d3785a...c7786550c4ed396b8580db58f7da60e850894d19,4,38,23,61,11,2014-12-17 13:24:00,2014-12-17 13:01:19
c7786550c4ed396b8580db58f7da60e850894d19...b7219c7ba5fdfbf9349948b5a91af50e32822ee6,4,30,11,41,9,2014-12-17 14:11:46,2014-12-14 03:22:37
b7219c7ba5fdfbf9349948b5a91af50e32822ee6...f3eed95175f8a8a365218a09fdc2dc864ff75d0c,1,1,1,2,1,2014-12-17 14:30:59,2014-12-17 14:30:12
f3eed95175f8a8a365218a09fdc2dc864ff75d0c...108b8bf852c76855ed98f5abe55db1da845598e7,3,41,0,41,6,2014-12-17 17:33:32,2014-12-17 16:25:28
108b8bf852c76855ed98f5abe55db1da845598e7...493ab45349e7768cba137207b8a27282921e9388,1,11,8,19,2,2014-12-18 01:02:15,2014-12-18 01:02:15
493ab45349e7768cba137207b8a27282921e9388...4fb38b73073dcd54f4af41a2af14dbc36f5d9f33,1,2,1,3,2,2014-12-18 01:09:24,2014-12-17 22:49:50
4fb38b73073dcd54f4af41a2af14dbc36f5d9f33...9c1f501d7b392db84fe1b0f0e74947e806d7eefb,23,98,94,192,83,2014-12-18 10:28:17,2014-12-17 21:00:05
9c1f501d7b392db84fe1b0f0e74947e806d7eefb...4a2a433e7daca1e1797b7b34d30d49ad4e09791c,2,5,4,9,4,2014-12-18 13:01:07,2014-12-18 09:02:43
4a2a433e7daca1e1797b7b34d30d49ad4e09791c...9bcd4d812ca698fd3a2de8c52cae8e63c261e628,2,33,8,41,7,2014-12-18 15:06:33,2014-12-18 13:38:46
9bcd4d812ca698fd3a2de8c52cae8e63c261e628...0c06f06131c613dc4173c83ea17c68c31835fc71,1,3,3,6,1,2014-12-18 16:55:33,2014-12-18 16:55:33
0c06f06131c613dc4173c83ea17c68c31835fc71...5b1fb0a75d6961d78ba68c72008f1cc535f9689a,2,12,1,13,3,2014-12-18 20:17:17,2014-12-18 20:17:17
5b1fb0a75d6961d78ba68c72008f1cc535f9689a...6403e07c5093e0244497293f31f5f73cebe85b66,1,5,5,10,2,2014-12-19 04:52:01,2014-12-19 04:52:01
6403e07c5093e0244497293f31f5f73cebe85b66...742fba94554818a988fe1e6cc8aa547831cca872,15,48,61,109,50,2014-12-19 17:07:52,2014-12-19 14:54:29
742fba94554818a988fe1e6cc8aa547831cca872...0a4b04fc23356aa6970ca1b17cb5e6955b108289,36,52,57,109,52,2014-12-19 17:07:52,2014-12-19 15:25:57
0a4b04fc23356aa6970ca1b17cb5e6955b108289...337cd0983699ea5739746fb2d5066f38f8834bbb,17,31,34,65,30,2014-12-19 17:07:52,2014-12-19 17:07:03
337cd0983699ea5739746fb2d5066f38f8834bbb...1d9fc5caa947ff4ee72180185e91a9a145171712,1,4,1,5,1,2014-12-19 17:37:32,2014-12-18 20:39:15
1d9fc5caa947ff4ee72180185e91a9a145171712...995be4a1375340a53668dd80444756d77302000d,1,9,3,12,5,2014-12-19 19:11:17,2014-12-19 19:11:17
995be4a1375340a53668dd80444756d77302000d...f56132691b3321a97d7a320acbf777bf0e3d3aac,1,2,0,2,2,2014-12-19 19:37:06,2014-12-19 19:37:06
f56132691b3321a97d7a320acbf777bf0e3d3aac...a3d96bee36040975ded8e3bf02e33e48d06f1f16,1,3,1,4,1,2014-12-20 00:11:52,2014-12-20 00:11:52
a3d96bee36040975ded8e3bf02e33e48d06f1f16...57554442fe3e209c135e15dda4ea45123e579e58,26,528,142,670,63,2014-12-20 18:28:29,2014-07-24 12:57:24
57554442fe3e209c135e15dda4ea45123e579e58...07728a2c2c78b030b7de9c6b20ef028f82d6134a,1,1,1,2,1,2014-12-20 22:04:07,2014-12-20 22:04:07
57554442fe3e209c135e15dda4ea45123e579e58...27f68f8659a648cc9ed3e71f690959ed8a130c5a,1,1,1,2,2,2014-12-20 20:02:26,2014-12-20 20:02:26
07728a2c2c78b030b7de9c6b20ef028f82d6134a...7c50e7eeccd4b4581542547f5ddb603bbd62a725,3,17,2,19,4,2014-12-21 16:31:50,2014-12-21 10:21:37
653a3a4e18134803bf9cbe8668bcdd678844c995...9a23470072865b7aa659e6af0b275668c85bb44d,3,22,3,25,9,2014-12-21 21:10:43,2014-12-17 23:41:36
936e87c97ba57c75708a240d9bfe71215d84faa3...54085b0f9ba7d9f705f9b9c90d3433b0ef6aa042,6,24,6,30,13,2014-12-22 12:24:54,2014-12-16 23:30:26
54085b0f9ba7d9f705f9b9c90d3433b0ef6aa042...994d6137a2519436d17d5b3d16cb49a3fa79f93e,3,25,21,46,12,2014-12-22 12:46:40,2014-11-10 18:33:49
994d6137a2519436d17d5b3d16cb49a3fa79f93e...cf2390be164bcb3c5670f73b0a7062d6141f8664,1,3,2,5,1,2014-12-22 16:35:19,2014-12-22 01:54:42
cf2390be164bcb3c5670f73b0a7062d6141f8664...01ab84c61330ffa5ac87c637249611c5e5343e57,2,13,6,19,3,2014-12-22 20:19:18,2014-12-22 20:13:47
01ab84c61330ffa5ac87c637249611c5e5343e57...a58cfe8e719163bde76e8a1f56588f6ada1b8c20,4,120,82,202,63,2014-12-23 01:32:00,2014-12-23 01:31:56
803947161b2296a1c71b9cb7822c469a5fffef04...5ca82e710e2f92b8c5114492205c8764918407d3,8,25,10,35,11,2014-12-23 10:38:32,2014-12-21 14:36:37
5ca82e710e2f92b8c5114492205c8764918407d3...962bb9b6bd1deb042e139316108ec0da44cb22a9,2,6,2,8,2,2014-12-23 10:41:42,2014-12-23 10:11:28
962bb9b6bd1deb042e139316108ec0da44cb22a9...227a4c48be18a439f0a08a49bf1f3062babeee82,1,2,2,4,2,2014-12-23 12:05:44,2014-12-23 10:01:58
227a4c48be18a439f0a08a49bf1f3062babeee82...9fecb86a5221982ea753270b7d2b4c6487f79941,4,22,7,29,10,2014-12-23 15:01:39,2014-12-21 13:24:15
9fecb86a5221982ea753270b7d2b4c6487f79941...6e08bde8c4525dda7d82bbf55b4b45a6e16213da,12,512,9,521,15,2014-12-23 15:36:18,2014-12-02 19:39:34
6e08bde8c4525dda7d82bbf55b4b45a6e16213da...f233bf47dde1d481108142c8d6b4bb3b3d8c6d08,17,318,285,603,64,2014-12-23 15:54:25,2013-11-09 12:25:15
f233bf47dde1d481108142c8d6b4bb3b3d8c6d08...f05b03f3d7e23fcbb896fd7c6f79140b89617741,2,7,13,20,7,2014-12-23 17:10:07,2014-12-23 17:09:55
f05b03f3d7e23fcbb896fd7c6f79140b89617741...90720d549ad4be578e935cd029e38b72c020e30b,2,10,3,13,4,2014-12-23 17:43:55,2014-12-23 17:43:55
90720d549ad4be578e935cd029e38b72c020e30b...750dbb11335ef7000eae3b58df0111f715ff3f90,1,1,1,2,1,2014-12-23 18:01:03,2014-12-23 18:01:03
750dbb11335ef7000eae3b58df0111f715ff3f90...15ba0d166ff714b231dcd4bebf0af32af964cae1,2,50,0,50,1,2014-12-23 18:01:33,2014-09-14 07:57:57
15ba0d166ff714b231dcd4bebf0af32af964cae1...30cbd5d360a2b8becdef7c6a0c939e0633a5468e,6,54,70,124,23,2014-12-23 18:35:01,2014-09-14 18:26:16
30cbd5d360a2b8becdef7c6a0c939e0633a5468e...69ee7c8d76da72d1392ed2a2597ed094da05d57e,1,0,3,3,1,2014-12-23 19:23:58,2014-12-23 19:23:58
69ee7c8d76da72d1392ed2a2597ed094da05d57e...061caa5b386681dc7bdef16918873043224a299c,4,43,17,60,10,2014-12-23 19:25:31,2014-12-23 17:27:49
061caa5b386681dc7bdef16918873043224a299c...446b50b90e9e60760618b236d8b0ea75a3b19d5a,2,12,7,19,5,2014-12-23 19:35:30,2014-12-23 13:38:34
446b50b90e9e60760618b236d8b0ea75a3b19d5a...8842bc101cbe7bc896619856f29f3159c264e3b2,2,5,2,7,3,2014-12-23 19:41:53,2014-12-23 19:41:53
8842bc101cbe7bc896619856f29f3159c264e3b2...9699d8446e6fed305671721d5b1259e3e01d3ebb,1,10,10,20,4,2014-12-24 09:42:24,2014-12-24 09:42:24
9699d8446e6fed305671721d5b1259e3e01d3ebb...b3ebcb22a9d131d61241c0a15b7df32479367c91,1,2,1,3,2,2014-12-24 09:45:53,2014-12-24 09:45:53
b3ebcb22a9d131d61241c0a15b7df32479367c91...c5c235cd4fcf4f4c3cbef992b1f92c5930bb4223,1,1,1,2,1,2014-12-24 12:10:34,2014-12-24 12:10:34
c5c235cd4fcf4f4c3cbef992b1f92c5930bb4223...5dddd79433ceb88ab67d9851b49a44ce5b8f509c,6,15,4,19,8,2014-12-24 12:18:43,2014-10-09 15:46:40
5dddd79433ceb88ab67d9851b49a44ce5b8f509c...7ce9644d9347455ae6f9bd383788a65e4bcadda3,1,12,0,12,1,2014-12-24 13:18:00,2014-12-24 13:13:58
7ce9644d9347455ae6f9bd383788a65e4bcadda3...fae551d765bc24103ce1b9782aa264246abfa2b8,2,6,0,6,2,2014-12-24 13:58:32,2014-12-24 13:58:32
fae551d765bc24103ce1b9782aa264246abfa2b8...b27db97b236569d059fa824c3078e06adf8b4fae,4,111,32,143,18,2014-12-24 17:33:57,2014-12-20 21:14:46
b27db97b236569d059fa824c3078e06adf8b4fae...3daa9d60be6672841ceed5bb812b6fb25950dc16,6,180,11,191,17,2014-12-24 19:54:30,2014-12-04 20:47:48
3daa9d60be6672841ceed5bb812b6fb25950dc16...4ccdf6e57f49d7e981dcd88c1db65229b8b92487,2,24,2,26,2,2014-12-24 20:06:09,2014-12-24 19:15:48
4ccdf6e57f49d7e981dcd88c1db65229b8b92487...6571ed14b68821b1e20a33d8d37c7f33dd0d524f,1,2,8,10,2,2014-12-24 23:38:07,2014-12-24 23:38:07
6571ed14b68821b1e20a33d8d37c7f33dd0d524f...426ead27bd2a38766017d9332ae4143ad9c7a2ab,1,2,13,15,2,2014-12-25 00:29:33,2014-12-25 00:27:51
426ead27bd2a38766017d9332ae4143ad9c7a2ab...a6f0b6a98fef540ae88a61fa4104fc60a1c8eb76,1,1,1,2,1,2014-12-25 11:56:23,2014-12-25 04:13:10
a6f0b6a98fef540ae88a61fa4104fc60a1c8eb76...234a2e0b6bcad5536d5d6cbb398eb6b7cc4eb67e,9,37,21,58,22,2014-12-25 12:53:13,2014-12-25 12:30:37
234a2e0b6bcad5536d5d6cbb398eb6b7cc4eb67e...ffa548fb561d4e32b42566cc67a2499a5e321944,1,2,2,4,2,2014-12-25 13:01:15,2014-12-25 12:56:16
ffa548fb561d4e32b42566cc67a2499a5e321944...3325ec869c10aba0fcb52c826d79633818c14dbc,1,0,3,3,2,2014-12-26 12:42:49,2014-12-24 12:53:06
3325ec869c10aba0fcb52c826d79633818c14dbc...271d4f8f85edf6dacc391ff5ddf601e3ee185b53,3,21,5,26,5,2014-12-26 13:09:12,2014-12-26 13:06:41
271d4f8f85edf6dacc391ff5ddf601e3ee185b53...c5fb34c47ef43fbd54e11fa6e72de326f5453f98,1,11,0,11,1,2014-12-26 14:14:10,2014-12-26 14:14:10
c5fb34c47ef43fbd54e11fa6e72de326f5453f98...b4e76f30d12bfa8a53cc297c60055c6f4629cc4c,2,27,23,50,9,2014-12-26 16:30:34,2014-08-22 16:31:26
b4e76f30d12bfa8a53cc297c60055c6f4629cc4c...1729a5250b052832540cd696df3ff0a0a77baddf,1,0,4,4,1,2014-12-26 18:48:13,2014-12-26 18:48:13
1729a5250b052832540cd696df3ff0a0a77baddf...c2e419c26781b88f2b34b445f450b735267155b0,2,3,2,5,3,2014-12-26 20:55:34,2014-12-26 20:27:11
c2e419c26781b88f2b34b445f450b735267155b0...0821b3d53ccd575de92ed679d173d779e1ad5acd,1,3,1,4,3,2014-12-26 23:28:47,2014-12-26 22:48:18
0821b3d53ccd575de92ed679d173d779e1ad5acd...75bbcfa332397a39e95bb267100cd1524314105c,3,90,94,184,91,2014-12-26 23:52:26,2014-12-26 23:23:00
75bbcfa332397a39e95bb267100cd1524314105c...7c07612e9045f8e1b881f321ea68a4bacb2d70df,1,0,14,14,1,2014-12-27 00:31:54,2014-12-27 00:21:51
7c07612e9045f8e1b881f321ea68a4bacb2d70df...47182965465f47657cbab6858a6a8637cc32b2df,11,550,3,553,12,2014-12-27 04:27:27,2014-11-22 03:14:43
47182965465f47657cbab6858a6a8637cc32b2df...2ceb10f3b02cbebad6ed908880f49a7c3e901d12,5,42,9,51,9,2014-12-27 11:52:44,2014-12-24 14:55:57
2ceb10f3b02cbebad6ed908880f49a7c3e901d12...e112bacd21ecfe0f6845731bad18b29803a1fed9,1,2,0,2,1,2014-12-27 14:13:12,2014-12-27 14:13:12
e112bacd21ecfe0f6845731bad18b29803a1fed9...89e2c60f4396241c667b7a1de37765b7c96d702f,3,10,7,17,7,2014-12-27 14:42:13,2014-12-27 14:06:38
89e2c60f4396241c667b7a1de37765b7c96d702f...5c5eb5fea4d7dcd2b0eed982021cfa8aeee2efd8,2,19,1,20,3,2014-12-27 16:44:54,2014-12-23 20:49:05
5c5eb5fea4d7dcd2b0eed982021cfa8aeee2efd8...6d52f6f8e688b5c4e70be8352eb02c05fea60e85,5,44,12,56,15,2014-12-27 17:02:34,2014-12-23 21:29:01
6d52f6f8e688b5c4e70be8352eb02c05fea60e85...7fd5629d23f48d69057cb2a404539b2a0f9ed107,1,6,0,6,1,2014-12-27 17:26:48,2014-12-27 17:26:48
7fd5629d23f48d69057cb2a404539b2a0f9ed107...508be27dbf43b5525a298ad184a9833906b6744c,1,1,1,2,1,2014-12-28 00:38:24,2014-12-28 00:15:23
508be27dbf43b5525a298ad184a9833906b6744c...3d0c3a0482496fc1914a40ec3c3eb70e67f0d643,1,2,1,3,1,2014-12-28 00:49:16,2014-12-28 00:49:16
3d0c3a0482496fc1914a40ec3c3eb70e67f0d643...b3eda6ec3e577af9fc287a4f483fd3271a76683c,1,1,3,4,2,2014-12-28 13:47:30,2014-12-03 21:00:09
b3eda6ec3e577af9fc287a4f483fd3271a76683c...bfa21ddf7649799a2254b50cb83eb5276cb7f129,2,9,9,18,4,2014-12-28 13:47:31,2014-11-28 21:33:15
bfa21ddf7649799a2254b50cb83eb5276cb7f129...7eefdbf7ab9f5bafe5baae2b877d93efc90e3044,11,99,100,199,24,2014-12-28 13:47:31,2014-11-10 20:40:26
7eefdbf7ab9f5bafe5baae2b877d93efc90e3044...b19693e6d8a509eaea282d250310b4ce3e94fe8d,2,80,0,80,1,2014-12-28 14:57:11,2014-11-10 19:43:44
b19693e6d8a509eaea282d250310b4ce3e94fe8d...1acfd624d60160e00c9cef113b9d8af65d6b2a72,6,230,2,232,15,2014-12-28 15:08:31,2014-11-11 15:32:19
1acfd624d60160e00c9cef113b9d8af65d6b2a72...86c75996f051e574c95b9b163dfbaf37b4b4c8c2,2,66,0,66,2,2014-12-28 15:08:34,2014-11-11 21:57:50
86c75996f051e574c95b9b163dfbaf37b4b4c8c2...44de7218a57aa14ec39408cbffdb57f2d94fcc39,1,58,0,58,1,2014-12-28 15:08:34,2014-11-12 20:51:35
44de7218a57aa14ec39408cbffdb57f2d94fcc39...1eca0e95cf1aa9b7a2d2806999609924e2bc3afe,5,53,0,53,5,2014-12-28 15:08:35,2014-11-28 23:05:56
1eca0e95cf1aa9b7a2d2806999609924e2bc3afe...332154e7263d01ceea9665fb51d4d24cd8b54470,12,113,0,113,11,2014-12-28 15:23:00,2014-12-14 20:22:57
332154e7263d01ceea9665fb51d4d24cd8b54470...24dffaf0cbe416167f99afd1d47f20732929f758,4,6,10,16,10,2014-12-28 15:23:00,2014-11-27 22:02:46
24dffaf0cbe416167f99afd1d47f20732929f758...b34b8a12b7f657f379c9e0e5ee7688bf36e242d2,2,2,2,4,2,2014-12-28 15:23:00,2014-11-28 21:32:10
b34b8a12b7f657f379c9e0e5ee7688bf36e242d2...92a2d049a253fb499db88efb6cf6c9209f6f251c,85,1069,1080,2149,1004,2014-12-28 15:23:01,2014-12-07 08:43:10
92a2d049a253fb499db88efb6cf6c9209f6f251c...6854998c8f405248c304cf14ecc46617e8a9f206,2,40,19,59,7,2014-12-28 15:23:01,2014-11-27 20:30:35
6854998c8f405248c304cf14ecc46617e8a9f206...4ea43ac915e187fb0c283094504f488d5017d7ec,4,82,16,98,11,2014-12-28 15:23:01,2014-11-28 21:13:11
4ea43ac915e187fb0c283094504f488d5017d7ec...5523e4cdbb786c396c103cfab369fc2ef8d6c52a,3,8,9,17,7,2014-12-28 15:23:01,2014-11-27 20:39:33
5523e4cdbb786c396c103cfab369fc2ef8d6c52a...f50a09f2cdb268e33645a19060daefebf8c4072d,2,3,6,9,2,2014-12-28 15:23:01,2014-11-28 21:28:57
f50a09f2cdb268e33645a19060daefebf8c4072d...f9a6ebf6f5c8e1723db680bf6d462a9df8889d7f,3,7,7,14,7,2014-12-28 15:23:02,2014-11-28 21:29:45
f9a6ebf6f5c8e1723db680bf6d462a9df8889d7f...90805b240fdb1a1570c414f7d55fa1b0b77e1f24,7,146,27,173,23,2014-12-28 15:23:02,2014-11-28 22:50:34
90805b240fdb1a1570c414f7d55fa1b0b77e1f24...969e082858339b8da79af2c036d434ce91c27ee0,5,107,0,107,4,2014-12-28 16:00:07,2014-12-27 22:39:43
969e082858339b8da79af2c036d434ce91c27ee0...c599f233b17d3890df8f648f8ead25141c21495c,1,4,0,4,1,2014-12-28 16:00:07,2014-11-28 22:04:19
c599f233b17d3890df8f648f8ead25141c21495c...92e8f1f30223d95c0e71ee6ace7bdc476c81abbd,20,152,134,286,40,2014-12-28 16:00:07,2014-12-02 22:23:51
92e8f1f30223d95c0e71ee6ace7bdc476c81abbd...a0141f9eac03f0fef722e757253bbc939c018f77,2,24,21,45,15,2014-12-28 16:00:07,2014-12-13 16:41:00
a0141f9eac03f0fef722e757253bbc939c018f77...fdbfc98003f0ba2d3a12def63a75560791f3602d,12,137,92,229,56,2014-12-28 16:02:29,2014-12-14 09:17:18
fdbfc98003f0ba2d3a12def63a75560791f3602d...e53495ba3352c2c0fdb6178f2b333c30cb6b5d46,1,2,8,10,2,2014-12-28 16:02:29,2014-12-14 17:29:15
e53495ba3352c2c0fdb6178f2b333c30cb6b5d46...cf1f36bb6eb34fafe6c224003ad585a647f6117b,18,197,56,253,60,2014-12-28 16:02:29,2014-12-14 16:48:51
cf1f36bb6eb34fafe6c224003ad585a647f6117b...84d7c93feb5ebad83fa88b02779db7e85928f0a8,1,5,1,6,1,2014-12-28 16:02:29,2014-12-14 22:18:38
84d7c93feb5ebad83fa88b02779db7e85928f0a8...3dc01aaaaf7cf070933a8f5ee9a5f9136503d676,6,26,18,44,11,2014-12-28 16:02:30,2014-12-14 21:59:51
3dc01aaaaf7cf070933a8f5ee9a5f9136503d676...d3a982556d655adcf4ba331d2def685d8249170f,9,44,33,77,17,2014-12-28 16:02:30,2014-12-14 22:13:03
d3a982556d655adcf4ba331d2def685d8249170f...cf0fd65ed42d5d4f0585da413db4b1cf7c6b0d1a,21,318,229,547,80,2014-12-28 16:02:30,2014-12-17 21:10:57
cf0fd65ed42d5d4f0585da413db4b1cf7c6b0d1a...d3205e3e2eb0202e7bdffaee3e2a80ad444b1ca2,22,183,95,278,56,2014-12-28 16:02:30,2014-12-17 21:51:42
d3205e3e2eb0202e7bdffaee3e2a80ad444b1ca2...9eb4f28e89692440e01c40a179a0b2111f4f0e04,19,144,90,234,39,2014-12-28 16:02:31,2014-12-17 22:36:32
9eb4f28e89692440e01c40a179a0b2111f4f0e04...b7282db833b833ae74e6e289d45365bac25995af,2,28,11,39,8,2014-12-28 16:02:31,2014-12-18 20:54:02
b7282db833b833ae74e6e289d45365bac25995af...932d449f001a94aa5065cda652a442e4b1dd5352,1,41,0,41,1,2014-12-28 16:02:31,2014-12-27 17:57:01
932d449f001a94aa5065cda652a442e4b1dd5352...1cdfbde4db1ac6bbddb2cf8dd5192831bc0f9ce3,2,24,0,24,2,2014-12-29 08:44:13,2014-12-28 22:15:00
1cdfbde4db1ac6bbddb2cf8dd5192831bc0f9ce3...1ee9507eb3e21ce3d2d95a84b52cef687bf0606f,1,1,1,2,1,2014-12-29 09:22:19,2014-12-29 09:21:48
1ee9507eb3e21ce3d2d95a84b52cef687bf0606f...6fb9dee470d57882e378247fd2706d5f9867b5f9,4,62,10,72,13,2014-12-29 15:24:50,2014-12-29 02:02:14
6fb9dee470d57882e378247fd2706d5f9867b5f9...bae404dea30e8bb0843db94a45d011d637ff2869,1,33,54,87,32,2014-12-29 17:36:18,2014-12-27 20:15:16
bae404dea30e8bb0843db94a45d011d637ff2869...1d24f073e65113c8c6d974db0504ef7d083809f7,4,27,1,28,6,2014-12-29 18:02:45,2014-12-28 17:10:12
1d24f073e65113c8c6d974db0504ef7d083809f7...3c5d1edb39020f549c58e0696b8ab2f03a88d753,2,3,0,3,2,2014-12-29 18:06:28,2014-12-27 15:19:32
3c5d1edb39020f549c58e0696b8ab2f03a88d753...623ccdd598625591d1a12fc1564cf3ef9a87581f,3,123,80,203,12,2014-12-29 18:41:12,2014-12-02 18:25:46
623ccdd598625591d1a12fc1564cf3ef9a87581f...2d638893651052dd8232911f392376c2cd707799,1,0,3,3,1,2014-12-29 20:38:16,2014-12-29 20:37:45
2d638893651052dd8232911f392376c2cd707799...002a8ffe478b7520a64c9176f9f640633f643b9c,1,5,10,15,7,2014-12-30 00:04:27,2014-12-29 22:06:09
002a8ffe478b7520a64c9176f9f640633f643b9c...ab4f709da4516672b0bd811f2b4d0c4ba9f5b636,3,26,23,49,7,2014-12-30 12:54:05,2014-12-29 21:23:18
ab4f709da4516672b0bd811f2b4d0c4ba9f5b636...fca866763acb6b3414c20ca3772b94cb5d111733,1,19,0,19,2,2014-12-30 15:01:25,2014-12-29 19:48:04
fca866763acb6b3414c20ca3772b94cb5d111733...8c99b7920e8187f98cf4d7dbd9918bd6c6da1238,6,62,10,72,21,2014-12-30 15:14:33,2014-12-03 23:17:59
8c99b7920e8187f98cf4d7dbd9918bd6c6da1238...c6b12bc995cfd4e88169908feaf341e2daa44b7a,1,0,1,1,1,2014-12-30 15:23:29,2014-12-30 15:23:29
c6b12bc995cfd4e88169908feaf341e2daa44b7a...df3cc53fda8579fdeea84a78650f2d189f7b2c75,1,5,1,6,1,2014-12-30 15:23:42,2014-12-30 15:23:42
df3cc53fda8579fdeea84a78650f2d189f7b2c75...d7fc6eb8ca67a6a628e8c7ce669731cf563606e7,2,6,7,13,3,2014-12-30 16:50:50,2014-12-30 16:50:50
d7fc6eb8ca67a6a628e8c7ce669731cf563606e7...8082c75d188e395c973f52bfdf5d547c741edd03,3,0,8,8,3,2014-12-30 16:53:59,2014-12-30 16:25:48
8082c75d188e395c973f52bfdf5d547c741edd03...66f9a74b4514bd259976ce8ee3a4e78288358a5f,3,55,38,93,12,2014-12-30 17:16:25,2014-12-21 20:13:06
66f9a74b4514bd259976ce8ee3a4e78288358a5f...51890ce8898f821d28f2f6fb6071c936e9bd88f0,57,516,714,1230,349,2014-12-30 17:16:25,2014-12-21 20:19:05
51890ce8898f821d28f2f6fb6071c936e9bd88f0...013c2d8d02e679c969255d9b11214d020dd34418,1,4,4,8,3,2014-12-31 05:21:32,2014-12-31 05:21:32
013c2d8d02e679c969255d9b11214d020dd34418...32ca159c96339b4856837d7abec376a575ec44ab,2,9,10,19,5,2014-12-31 13:24:09,2014-12-30 00:25:51
32ca159c96339b4856837d7abec376a575ec44ab...93d73dac91104fd82d44b0dd4521cfa4f31e02aa,13,169,159,328,16,2014-12-31 13:29:17,2014-12-29 20:14:40
93d73dac91104fd82d44b0dd4521cfa4f31e02aa...478d6a950361ef541ff40b51b7c04439647e0492,1,12,2,14,3,2014-12-31 13:33:34,2014-12-30 16:19:59
478d6a950361ef541ff40b51b7c04439647e0492...41fc1c0b5eac156e200a10233c7c9210a1c0fed8,3,52,4,56,5,2014-12-31 13:48:28,2014-11-15 13:45:00
41fc1c0b5eac156e200a10233c7c9210a1c0fed8...63dee96cc7a3c929e16f88f2039812490b4b02b2,1,2,1,3,2,2014-12-31 14:19:04,2014-12-31 14:19:04
63dee96cc7a3c929e16f88f2039812490b4b02b2...09bce0b2cb6813e1b7acf184a1e26402736618a0,1,0,3,3,1,2014-12-31 14:37:13,2014-12-31 14:37:13
09bce0b2cb6813e1b7acf184a1e26402736618a0...837fc2d8cdfefce375697d95e241836c7be12696,1,1,1,2,1,2014-12-31 14:50:47,2014-12-31 14:49:03
837fc2d8cdfefce375697d95e241836c7be12696...8a9b0c15a6c0ef60dea3ba3042317520bc201206,4,2,2,4,2,2014-12-31 16:26:27,2014-12-31 16:25:11
8a9b0c15a6c0ef60dea3ba3042317520bc201206...89527576980ff14309990c152e5904ddd5ca3df7,1,112,64,176,53,2014-12-31 16:56:06,2014-12-23 21:11:55
89527576980ff14309990c152e5904ddd5ca3df7...a1487deebff7bf27a4946a9f5ddd68154fa4834d,7,314,57,371,18,2014-12-31 19:14:28,2014-09-03 08:51:07
a1487deebff7bf27a4946a9f5ddd68154fa4834d...7a878ca5cb50ad65fc465cb263a44cc93629f75c,3,31,3,34,4,2014-12-31 19:43:13,2014-12-23 15:51:36
7a878ca5cb50ad65fc465cb263a44cc93629f75c...46068d850d8debd3611ed6499d48b9907bf07ef6,13,148,22,170,31,2014-12-31 21:31:59,2014-12-31 21:25:00
46068d850d8debd3611ed6499d48b9907bf07ef6...b4bdd5262b18644456d12a00d475adf9897a9255,2,4,1,5,2,2014-12-31 22:26:15,2014-12-31 22:26:15
b4bdd5262b18644456d12a00d475adf9897a9255...c4e796aa1bab70ee66151d24a061af811e08ad08,1,1,1,2,1,2015-01-01 13:18:39,2015-01-01 13:18:39
c4e796aa1bab70ee66151d24a061af811e08ad08...e80f59e3bbaeccd9ee72e4cd9d2d01fc942d08f6,1,1,0,1,1,2015-01-01 14:18:57,2015-01-01 14:18:57
e80f59e3bbaeccd9ee72e4cd9d2d01fc942d08f6...a7aaabfaf1fa4c20065ab1133d49f40d4de6b409,1,3,3,6,1,2015-01-01 16:38:53,2015-01-01 16:38:53
a7aaabfaf1fa4c20065ab1133d49f40d4de6b409...40a85043576f6d163a2a05721a4b2710261fc4f5,11,51,30,81,27,2015-01-01 18:30:52,2014-12-30 20:45:03
40a85043576f6d163a2a05721a4b2710261fc4f5...b9feec959b9dfc08513607c9046fb38c5b8f7e8a,2,8,2,10,4,2015-01-01 18:57:52,2015-01-01 18:54:25
b9feec959b9dfc08513607c9046fb38c5b8f7e8a...f60c35cddc33d12a8c9c33ff086521cf3f350fb7,1,0,5,5,1,2015-01-01 18:59:38,2015-01-01 18:59:38
f60c35cddc33d12a8c9c33ff086521cf3f350fb7...40ccef16cb699ff66a9d4163cc195c3a3b28c5ba,1,4,0,4,1,2015-01-01 19:28:53,2015-01-01 19:28:53
40ccef16cb699ff66a9d4163cc195c3a3b28c5ba...4ee06ec3fc8e94d164afbd2f9c880c60c658a9ac,1,2,1,3,1,2015-01-02 13:51:28,2015-01-02 11:58:22
4ee06ec3fc8e94d164afbd2f9c880c60c658a9ac...a159b1facd222c20dde12f1e0117643af528d511,9,140,162,302,76,2015-01-02 14:19:36,2014-11-05 09:43:31
a159b1facd222c20dde12f1e0117643af528d511...057305e588ac90474fef47e2fb2890552a543731,2,7,2,9,3,2015-01-02 14:37:09,2014-12-30 01:52:32
057305e588ac90474fef47e2fb2890552a543731...285bd02c921d3ba731c74a2f5eca278c7941ac5c,1,12,4,16,10,2015-01-02 14:37:09,2014-11-05 10:01:48
285bd02c921d3ba731c74a2f5eca278c7941ac5c...2a9c4b4901d385f68a2c3f9cf98b7a776c2976f0,2,17,10,27,15,2015-01-02 14:37:10,2014-10-26 17:30:58
2a9c4b4901d385f68a2c3f9cf98b7a776c2976f0...1aa3e09c2043c88a760e8b73fb95dc8f1ffef50e,9,137,62,199,52,2015-01-02 14:37:10,2014-11-05 19:53:39
1aa3e09c2043c88a760e8b73fb95dc8f1ffef50e...8958170755b37ce346ae5257c1000bd936faa3b0,22,73,60,133,67,2015-01-02 15:46:04,2015-01-02 15:14:23
8958170755b37ce346ae5257c1000bd936faa3b0...937fab030d48021ccd266c67016aeaef91362e2c,1,9,10,19,10,2015-01-02 16:29:06,2015-01-02 16:29:06
937fab030d48021ccd266c67016aeaef91362e2c...23f1a8dad223ee79cd206c9032c871c874f7e7af,3,21,3,24,6,2015-01-02 17:00:41,2015-01-02 14:25:33
23f1a8dad223ee79cd206c9032c871c874f7e7af...839f431ef5b927c8b07ce33483b3a7b0dd17b761,1,17,6,23,5,2015-01-02 17:04:57,2015-01-02 14:37:54
839f431ef5b927c8b07ce33483b3a7b0dd17b761...52f0b2b62262743d5f935ddae29428e661b5d8ea,5,87,41,128,21,2015-01-02 17:35:41,2015-01-02 17:35:41
52f0b2b62262743d5f935ddae29428e661b5d8ea...15cd71ed24945ff7be5716580603fd65c0d45ef7,4,4,4,8,4,2015-01-03 00:20:18,2015-01-03 00:20:18
15cd71ed24945ff7be5716580603fd65c0d45ef7...3bac904607f1999136b97249d9aa220f1db94258,1,0,2,2,1,2015-01-03 09:13:20,2015-01-03 09:13:17
3bac904607f1999136b97249d9aa220f1db94258...83dd70b927f962976737f9ba7d616fbcf3000059,1,0,3,3,1,2015-01-03 13:27:48,2015-01-03 02:04:10
83dd70b927f962976737f9ba7d616fbcf3000059...b738178825ec9378198d77ac69699513774f0884,1,6,6,12,1,2015-01-03 13:48:31,2015-01-03 09:41:42
b738178825ec9378198d77ac69699513774f0884...db3f7c15cbf4c9025e83065d1302d0e61d570331,2,84,0,84,2,2015-01-03 17:06:40,2015-01-01 03:16:51
db3f7c15cbf4c9025e83065d1302d0e61d570331...439f15beabe2e4d21232798f805ba69367611276,2,15,0,15,2,2015-01-03 18:27:08,2015-01-03 18:27:08
439f15beabe2e4d21232798f805ba69367611276...572ad9a92e08797f12e547477efcce7893159cfb,1,7,0,7,3,2015-01-03 18:43:13,2015-01-03 18:43:13
572ad9a92e08797f12e547477efcce7893159cfb...05f702b94ca4ad77236a1e299270e8014def02e6,2,2,2,4,2,2015-01-05 15:30:15,2015-01-05 13:36:24
05f702b94ca4ad77236a1e299270e8014def02e6...3d2cae0896ee8026d1c2c5d31e4c4c8f74f2fef4,9,88,9,97,15,2015-01-05 15:51:52,2015-01-03 17:06:24
3d2cae0896ee8026d1c2c5d31e4c4c8f74f2fef4...d94fe42ae5e67e9fd600d204a08eef00cc10a7df,1,6,1,7,1,2015-01-05 15:55:48,2015-01-05 15:55:48
d94fe42ae5e67e9fd600d204a08eef00cc10a7df...6e1c9c6568c405bfa481dda4249abe2960173547,4,22,7,29,8,2015-01-05 16:19:35,2015-01-02 16:58:58
6e1c9c6568c405bfa481dda4249abe2960173547...c87ee41954737869e6026d6fb12394ec4f79d50a,4,173,13,186,8,2015-01-05 16:35:36,2015-01-01 15:31:36
c87ee41954737869e6026d6fb12394ec4f79d50a...ce17b045bf5629aac66f872c3f548205906e04db,2,15,0,15,2,2015-01-05 19:24:34,2015-01-05 19:24:34
ce17b045bf5629aac66f872c3f548205906e04db...789baf9c3a432297ff775aee7f174494e4fd9962,2,7,4,11,5,2015-01-05 19:35:30,2015-01-05 19:15:14
789baf9c3a432297ff775aee7f174494e4fd9962...e08318b4ef25cfe7d1cfbc5ae7d134ee477506ba,2,35,19,54,8,2015-01-05 19:52:54,2015-01-01 14:42:40
e08318b4ef25cfe7d1cfbc5ae7d134ee477506ba...a9aec1154e5b65fcaf608801905a1bbafcfbfbf7,1,2,0,2,1,2015-01-05 19:54:55,2015-01-05 17:06:59
a9aec1154e5b65fcaf608801905a1bbafcfbfbf7...de9ebdd39cb4f4b65475b43e0e32772d5a315654,7,33,6,39,10,2015-01-06 00:35:02,2015-01-05 20:43:15
de9ebdd39cb4f4b65475b43e0e32772d5a315654...27dd7e727153cbf12632a2161217340123687c44,3,13,1,14,3,2015-01-06 07:42:58,2015-01-05 17:23:57
27dd7e727153cbf12632a2161217340123687c44...011f21b4faddf40fdb84f2adbb75fc4c3fb94ce8,1,11,11,22,11,2015-01-06 07:48:01,2015-01-06 07:48:01
011f21b4faddf40fdb84f2adbb75fc4c3fb94ce8...e0080cf577166e160987c74e2d8324ddbbee3b6d,1,2,2,4,1,2015-01-06 07:56:53,2015-01-06 07:56:53
e0080cf577166e160987c74e2d8324ddbbee3b6d...9f328405f6691784fbd59530e7e01bd6d74e35f1,1,1,1,2,1,2015-01-06 17:43:32,2015-01-06 17:05:20
9f328405f6691784fbd59530e7e01bd6d74e35f1...6288fccfda91593438f3b2f03998b7d7b6b0fcc0,1,140,111,251,54,2015-01-06 18:51:19,2015-01-03 19:54:35
6288fccfda91593438f3b2f03998b7d7b6b0fcc0...2e65d56156b622e2393dee1af66e9c799a51924f,6,123,13,136,10,2015-01-06 19:04:25,2014-11-03 17:01:31
2e65d56156b622e2393dee1af66e9c799a51924f...ed220c4cbea04c2e77535af93bcfaa917cce607a,2,9,9,18,3,2015-01-06 21:02:26,2014-12-29 22:51:25
ed220c4cbea04c2e77535af93bcfaa917cce607a...0cdb09d48944df3f13cc1a4e1f5c49b786174ef9,2,32,1,33,3,2015-01-06 21:02:27,2015-01-06 19:56:54
0cdb09d48944df3f13cc1a4e1f5c49b786174ef9...749d23251bbd6564341405e6f8c1da129b8307e7,1,1,5,6,3,2015-01-06 23:33:55,2015-01-06 23:33:55
749d23251bbd6564341405e6f8c1da129b8307e7...fb48eb05816b1ac87d58696cdfe48be18c901f16,58,2852,1196,4048,284,2015-01-07 00:25:12,2015-01-07 00:16:35
fb48eb05816b1ac87d58696cdfe48be18c901f16...9b057b51ce01087afbeeb683098d4d2f1088fd7b,1,1,0,1,1,2015-01-07 01:02:03,2015-01-07 01:02:03
9b057b51ce01087afbeeb683098d4d2f1088fd7b...5a4ac4ead986387216e0c0e1b4d4b6a537f87e0b,4,23,6,29,5,2015-01-07 13:08:36,2015-01-05 10:32:25
5a4ac4ead986387216e0c0e1b4d4b6a537f87e0b...ee86e590516250a7db7bf7c9a979ced4faf4edd7,3,12,1,13,4,2015-01-07 13:33:26,2015-01-02 01:47:49
ee86e590516250a7db7bf7c9a979ced4faf4edd7...391bb09bb09e8208b4711c21e850b9351dd62989,5,180,91,271,96,2015-01-07 13:54:46,2015-01-02 15:37:21
391bb09bb09e8208b4711c21e850b9351dd62989...12bf42ae0db752bf4a4387d6be7276cd145f59d1,1,75,73,148,6,2015-01-07 13:54:46,2015-01-02 19:22:28
12bf42ae0db752bf4a4387d6be7276cd145f59d1...2c0f64b5f6fe25ca35feb30db7e3112a4cb916ed,1,1,1,2,1,2015-01-07 19:10:30,2015-01-07 17:35:25
2c0f64b5f6fe25ca35feb30db7e3112a4cb916ed...f7c287fca9c9e6370cc88d1457d3ed9466703687,4,31,18,49,12,2015-01-07 19:11:24,2015-01-03 19:27:18
f7c287fca9c9e6370cc88d1457d3ed9466703687...118592663dcb761fb269ead3ab8a4977bc2cd3a6,2,7,4,11,4,2015-01-07 20:54:22,2015-01-03 21:50:20
118592663dcb761fb269ead3ab8a4977bc2cd3a6...eaa1a22341aef5b92f5c3cd682f01e61c4159262,4,23,4,27,8,2015-01-07 20:54:22,2015-01-03 18:06:36
eaa1a22341aef5b92f5c3cd682f01e61c4159262...127f9e073d83904defd4bde4eaa4491f3306ca25,4,35,2,37,8,2015-01-07 20:54:22,2015-01-03 18:28:15
127f9e073d83904defd4bde4eaa4491f3306ca25...1f03d2d924ba90e83dc9d8c93438bf5ee2f17ccd,3,98,22,120,22,2015-01-07 22:33:04,2015-01-07 20:14:25
1f03d2d924ba90e83dc9d8c93438bf5ee2f17ccd...8713ea7568af8871bf1306f14cc928058df0d4c7,3,26,1,27,4,2015-01-08 00:07:49,2015-01-07 10:30:25
8713ea7568af8871bf1306f14cc928058df0d4c7...f487a3275ebb786d3e7716e1ed9cc994bd092f34,1,3,2,5,2,2015-01-08 00:12:37,2015-01-08 00:02:14
f487a3275ebb786d3e7716e1ed9cc994bd092f34...862ea825b5073588efafd5b7eed349ad098b5fe1,3,175,27,202,10,2015-01-08 00:29:20,2015-01-07 20:10:56
862ea825b5073588efafd5b7eed349ad098b5fe1...ade985999657eaef6a9510c2aeba9b2196d7bf6e,1,10,7,17,3,2015-01-08 13:49:54,2015-01-07 23:49:02
ade985999657eaef6a9510c2aeba9b2196d7bf6e...de4bfb3fad7caa426fa1f5625df6fbd7579e7cb7,1,3,6,9,2,2015-01-08 14:08:26,2015-01-08 14:04:16
de4bfb3fad7caa426fa1f5625df6fbd7579e7cb7...d6c8121ed007e59bac9a68873248104ec30d5d8b,1,3,5,8,4,2015-01-08 14:27:13,2015-01-08 14:27:10
d6c8121ed007e59bac9a68873248104ec30d5d8b...543df07720181fe23737ba14f1a261ff6f37f49c,5,19,8,27,9,2015-01-08 16:43:07,2015-01-08 10:11:35
543df07720181fe23737ba14f1a261ff6f37f49c...5c43fd48258eb977e6e611310e12a921d8470944,1,4,1,5,2,2015-01-08 18:14:45,2015-01-08 17:47:45
5c43fd48258eb977e6e611310e12a921d8470944...b8abfe141be17f20079f55b921dcaf7abe116c4b,1,2,0,2,2,2015-01-08 18:17:00,2015-01-08 17:20:56
b8abfe141be17f20079f55b921dcaf7abe116c4b...0c7633178fa9410f102e4708cef979b873bccb76,41,982,1428,2410,246,2015-01-08 19:07:54,2014-12-01 07:28:01
0c7633178fa9410f102e4708cef979b873bccb76...13e4156518e9c13606870442f4fe1607c3d72518,1,1,1,2,1,2015-01-08 20:12:40,2015-01-08 20:12:40
13e4156518e9c13606870442f4fe1607c3d72518...c1493879d98328040b36ad93cd104c0b3b546772,1,1,1,2,1,2015-01-08 21:02:18,2015-01-08 20:54:25
c1493879d98328040b36ad93cd104c0b3b546772...8fb7a0987cafc1cafc8b7eb8dd53301dea0aee40,1,1,1,2,1,2015-01-09 12:38:11,2015-01-09 09:33:50
8fb7a0987cafc1cafc8b7eb8dd53301dea0aee40...67d6a8c4e66c379111d0acf4552e162356917dd7,1,5,4,9,1,2015-01-09 15:25:57,2015-01-09 15:25:57
67d6a8c4e66c379111d0acf4552e162356917dd7...c8bac4b556cf4716dc9003e5da48060cb72ba7cb,25,72,26,98,30,2015-01-09 15:31:32,2015-01-08 17:00:04
c8bac4b556cf4716dc9003e5da48060cb72ba7cb...665e0aa6ec80a48492033a3b2b4ffdfaae3c78eb,3,218,211,429,42,2015-01-09 16:43:59,2015-01-09 15:36:36
665e0aa6ec80a48492033a3b2b4ffdfaae3c78eb...8f4877c89d0f28e289399fbb46357623a49e7eb0,9,247,75,322,32,2015-01-09 17:30:48,2015-01-08 17:10:10
8f4877c89d0f28e289399fbb46357623a49e7eb0...7102b99653e354eb8c291cfa5b4f772d15d83ae0,3,44,1,45,4,2015-01-09 18:23:29,2015-01-09 17:52:54
7102b99653e354eb8c291cfa5b4f772d15d83ae0...4986653d9d7956df26502e19277454649adbd23d,1,1,1,2,1,2015-01-09 19:33:04,2015-01-09 19:33:04
4986653d9d7956df26502e19277454649adbd23d...f2f70faa809c3b261e840441451ac93992c5ee84,1,0,9,9,1,2015-01-09 20:58:52,2015-01-09 20:58:52
f2f70faa809c3b261e840441451ac93992c5ee84...e174cce9dc258ac4d19b44eff0070d0ad48ec3a8,1,14,0,14,1,2015-01-09 23:53:09,2015-01-09 21:31:19
e174cce9dc258ac4d19b44eff0070d0ad48ec3a8...f5c3a8bff57add71b801c9c44442ea0f8fa35858,1,14,0,14,1,2015-01-10 02:48:37,2015-01-10 02:45:14
f5c3a8bff57add71b801c9c44442ea0f8fa35858...d7bc37d611b43d58be4b430faf0b9813bcde29c6,6,48,8,56,14,2015-01-10 09:05:02,2015-01-09 21:18:34
d7bc37d611b43d58be4b430faf0b9813bcde29c6...ffca9b49d4b887bd03e9e5e784a811954ac839b9,1,4,7,11,2,2015-01-10 14:42:31,2015-01-10 14:42:31
ffca9b49d4b887bd03e9e5e784a811954ac839b9...7289d01973380d5b0b497c4f2def7dc84acf4f81,2,21,2,23,6,2015-01-10 15:51:14,2015-01-10 15:48:07
7289d01973380d5b0b497c4f2def7dc84acf4f81...74f02557e0183812d6d60e2548985c5c40b3d27b,2,27,11,38,5,2015-01-10 16:10:26,2015-01-09 22:05:58
74f02557e0183812d6d60e2548985c5c40b3d27b...916e38802f151b34aaca487dc7e928946e81be73,5,108,108,216,34,2015-01-10 16:18:19,2015-01-10 16:11:15
916e38802f151b34aaca487dc7e928946e81be73...48ad288679a0cb2e2cfb17f128903e6c5b1c4870,15,986,6,992,17,2015-01-10 16:18:19,2015-01-10 16:14:20
48ad288679a0cb2e2cfb17f128903e6c5b1c4870...07988744b347302925bc6cc66511e34224db55ab,17,427,70,497,64,2015-01-10 17:24:52,2013-11-17 22:26:20
07988744b347302925bc6cc66511e34224db55ab...b86107ced15f9093f49469b76860cc98e7a7a671,1,3,1,4,2,2015-01-10 17:53:55,2015-01-10 17:51:09
b86107ced15f9093f49469b76860cc98e7a7a671...6c392bb2c00a7779a0f2a485bfdeea456ed39181,8,714,709,1423,9,2015-01-10 18:41:14,2015-01-03 15:10:12
6c392bb2c00a7779a0f2a485bfdeea456ed39181...ee8d5b91e94f6920f846512c978b703f62545ca8,7,695,248,943,17,2015-01-10 19:16:19,2015-01-03 22:05:34
ee8d5b91e94f6920f846512c978b703f62545ca8...3d495cfd77c53fc81a8e08284229fc761dae982f,3,199,0,199,3,2015-01-10 19:17:20,2015-01-04 11:07:58
3d495cfd77c53fc81a8e08284229fc761dae982f...4797af2bb8d93215eb20408ca6517b9979f4cce5,1,24,16,40,8,2015-01-10 19:17:22,2015-01-03 14:55:27
4797af2bb8d93215eb20408ca6517b9979f4cce5...f01306a6d81755bf93db6c8cab3529819e60e1fe,1,252,141,393,58,2015-01-10 19:17:22,2015-01-10 16:30:26
f01306a6d81755bf93db6c8cab3529819e60e1fe...d89019a84d2dd314d3764dbd06ba854640db9b80,1,37,13,50,11,2015-01-10 20:11:58,2015-01-10 20:11:58
d89019a84d2dd314d3764dbd06ba854640db9b80...fdc2cc948725866212a9bcc97b9b7cf21bb49b90,3,45,26,71,10,2015-01-10 22:14:15,2015-01-10 14:18:06
fdc2cc948725866212a9bcc97b9b7cf21bb49b90...be158e36251df0b07556657da47cdaf10913c57a,2,3,2,5,2,2015-01-10 23:30:47,2015-01-10 23:30:47
be158e36251df0b07556657da47cdaf10913c57a...28de5cd4de3ddacf67af40c6b31d4fefd85f31f8,3,4,2,6,4,2015-01-11 18:24:13,2015-01-11 18:24:13
28de5cd4de3ddacf67af40c6b31d4fefd85f31f8...412066e71e81e899bca63523f239e56138ec9e9d,1,1,8,9,3,2015-01-11 19:59:07,2015-01-11 19:56:26
412066e71e81e899bca63523f239e56138ec9e9d...d563e3be68369694a3bac1efd7779d8e03bb6a51,6,68,3,71,12,2015-01-11 20:21:01,2014-12-01 21:20:37
d563e3be68369694a3bac1efd7779d8e03bb6a51...68a439a18da17a65555832eff0a7c2090655b583,5,0,8,8,6,2015-01-11 22:34:47,2015-01-11 20:18:56
68a439a18da17a65555832eff0a7c2090655b583...b5c1a85b50c709770b8e98aeecfeb8e81ca29dcf,8,204,16,220,26,2015-01-12 08:16:08,2015-01-10 22:52:59
b5c1a85b50c709770b8e98aeecfeb8e81ca29dcf...a7c256cb5491bf2a77abdff01638239db5bfd9d5,8,194,21,215,35,2015-01-12 14:09:18,2014-10-15 07:42:06
a7c256cb5491bf2a77abdff01638239db5bfd9d5...58833f519797e15ae3cb39b1613e5f7e09c96952,3,6,5,11,5,2015-01-12 15:54:59,2015-01-12 13:27:25
58833f519797e15ae3cb39b1613e5f7e09c96952...8f5d6c77b6bbe0390b683cea649de6ad24d80fef,4,55,53,108,6,2015-01-12 16:35:20,2015-01-11 20:02:33
8f5d6c77b6bbe0390b683cea649de6ad24d80fef...bbbed99f6260a8b3e65cb990e49721b1ce4a441b,21,364,7,371,22,2015-01-12 17:39:18,2015-01-11 19:13:31
bbbed99f6260a8b3e65cb990e49721b1ce4a441b...26a92619f62aeb6f60e15c62e8322c96744eff26,6,34,48,82,22,2015-01-12 18:17:44,2015-01-12 15:48:49
26a92619f62aeb6f60e15c62e8322c96744eff26...9f51d0c86d9348349d921c393d6ffcbbfd521192,1,2,0,2,2,2015-01-12 18:20:44,2015-01-12 18:20:44
9f51d0c86d9348349d921c393d6ffcbbfd521192...eeb88123e725946802732162a22e5ad856e0c50c,3,59,2,61,6,2015-01-12 18:23:46,2015-01-11 20:07:45
eeb88123e725946802732162a22e5ad856e0c50c...b75c707943e159b80c179c538721406bbfb8b120,2,51,0,51,2,2015-01-12 18:47:58,2015-01-10 16:45:05
b75c707943e159b80c179c538721406bbfb8b120...4c413e231cfe788de6e371567f395c8ccbd26103,7,48,44,92,24,2015-01-12 18:58:47,2015-01-10 19:27:30
4c413e231cfe788de6e371567f395c8ccbd26103...71b7668b75d10589bbbdc7c5ca9ee7a125f91c90,4,19,7,26,10,2015-01-12 20:01:34,2015-01-10 20:35:09
71b7668b75d10589bbbdc7c5ca9ee7a125f91c90...a3e783fe11dd25bbf84bfb6201186566ed473506,13,120,36,156,41,2015-01-12 20:01:34,2015-01-08 14:03:43
a3e783fe11dd25bbf84bfb6201186566ed473506...79deb6a0716e554cac5308e86f5754f19ad436dc,11,215,111,326,60,2015-01-12 20:01:34,2015-01-09 21:59:00
79deb6a0716e554cac5308e86f5754f19ad436dc...6b5113ec94e6b9c81e3e4d9a68b0703ccb14c22d,2,64,19,83,14,2015-01-12 20:01:34,2015-01-11 09:06:42
6b5113ec94e6b9c81e3e4d9a68b0703ccb14c22d...3bba4b420ed5e89608d9d71ad328fbaed026b232,1,18,7,25,2,2015-01-12 20:01:34,2015-01-11 18:06:36
3bba4b420ed5e89608d9d71ad328fbaed026b232...511a53b3142551a1bc3093ed1b6655f57634f510,1,16,9,25,2,2015-01-12 20:01:34,2015-01-11 19:16:28
511a53b3142551a1bc3093ed1b6655f57634f510...5f7230e12f0d237cdc19d8930006b0fc7d9dbaa6,6,18,28,46,14,2015-01-12 21:31:44,2015-01-12 21:31:44
5f7230e12f0d237cdc19d8930006b0fc7d9dbaa6...f48e2258a96a08dcec843921206bcf7656e3ae45,6,94,13,107,26,2015-01-12 21:51:22,2015-01-12 11:00:27
f48e2258a96a08dcec843921206bcf7656e3ae45...21b858cb6735cdfdc695ff7b076e4cbc1981bc88,9,310,54,364,46,2015-01-12 22:39:55,2015-01-09 15:16:16
21b858cb6735cdfdc695ff7b076e4cbc1981bc88...3844ccc958f59aef731dbb054a51fa37aa1d16ec,1,1,1,2,1,2015-01-12 22:44:06,2015-01-12 21:52:37
3844ccc958f59aef731dbb054a51fa37aa1d16ec...5d7217dce307ad55ca9f20da6737f6ab605ab96f,2,2,1,3,2,2015-01-12 22:53:32,2015-01-12 22:53:32
5d7217dce307ad55ca9f20da6737f6ab605ab96f...aa8ee6a5731b37b73635e7605521fb1a54a5c10d,1,1,1,2,1,2015-01-12 23:00:09,2015-01-12 22:57:52
aa8ee6a5731b37b73635e7605521fb1a54a5c10d...65246de7b1d70d25831ab394c4f4a75813f629fe,20,1659,33,1692,46,2015-01-12 23:15:34,2015-01-02 01:39:31
65246de7b1d70d25831ab394c4f4a75813f629fe...e084ff01f27a28717eef471ff8e86b074d452f44,4,8,0,8,5,2015-01-13 16:27:11,2015-01-13 16:04:17
e084ff01f27a28717eef471ff8e86b074d452f44...e7771ec380a116dbef481001fb1ce664f5c7311e,1,1,1,2,1,2015-01-13 16:53:03,2015-01-13 16:28:43
e7771ec380a116dbef481001fb1ce664f5c7311e...958aeda4b5efcde30438979d93fc585a2f12ce02,4,11,2,13,4,2015-01-13 18:03:05,2014-11-25 22:06:31
958aeda4b5efcde30438979d93fc585a2f12ce02...316b8d49746933d1845d600314b002d9b64d3e3d,6,150,1,151,7,2015-01-13 18:03:05,2014-09-10 17:06:19
316b8d49746933d1845d600314b002d9b64d3e3d...69b5e667385db9ed5e61917a58a75f97b6a97e68,5,45,1,46,5,2015-01-13 18:03:06,2014-12-03 21:14:00
69b5e667385db9ed5e61917a58a75f97b6a97e68...a3bebfdc34686622b91e7f3154390ca2058957f9,5,55,1,56,6,2015-01-13 18:03:06,2014-12-09 20:32:03
a3bebfdc34686622b91e7f3154390ca2058957f9...baf2542c4f502d8f5adc3704eb22ca237d50aee1,5,63,5,68,8,2015-01-13 18:03:06,2014-12-11 13:31:03
baf2542c4f502d8f5adc3704eb22ca237d50aee1...cbbe6a6abba6510716e25b7ee9364274334ffcfe,3,3,3,6,3,2015-01-13 18:08:57,2015-01-13 18:08:57
cbbe6a6abba6510716e25b7ee9364274334ffcfe...7ecd654497e778550735b77794eae62a9d014272,1,0,85,85,85,2015-01-13 19:37:30,2015-01-13 19:37:30
7ecd654497e778550735b77794eae62a9d014272...1913c1ac2190cdc31de9dcd81687f5dad057e2f0,1,53,0,53,1,2015-01-13 19:44:08,2015-01-13 19:44:08
1913c1ac2190cdc31de9dcd81687f5dad057e2f0...dc90bf2ac823ed9841cc8ca4035fe0b62a18c958,1,0,3,3,1,2015-01-14 08:31:24,2015-01-14 08:14:15
dc90bf2ac823ed9841cc8ca4035fe0b62a18c958...ec7ef5afbbd12abe74314d557aabb3d85d667749,2,13,0,13,2,2015-01-14 14:47:29,2015-01-14 14:47:29
ec7ef5afbbd12abe74314d557aabb3d85d667749...88786afbffc5c095f6491e080afea394f63bb44a,2,53,3,56,5,2015-01-14 15:09:33,2015-01-13 17:18:23
88786afbffc5c095f6491e080afea394f63bb44a...a6f144fd4fee0090de3a99b1f50a4142722e7946,1,2,1,3,1,2015-01-14 18:56:49,2015-01-14 18:46:15
a6f144fd4fee0090de3a99b1f50a4142722e7946...737d24923ac69bb8b89af1bb2f3f4c4c744349e8,6,63,3,66,12,2015-01-14 18:59:39,2015-01-12 01:52:22
737d24923ac69bb8b89af1bb2f3f4c4c744349e8...28308078f397d1de36fd0da417ac7da2544ba12d,69,3098,2990,6088,111,2015-01-14 19:16:20,2015-01-12 20:20:40
28308078f397d1de36fd0da417ac7da2544ba12d...2d5da57f4856656677d82d4a56f5914f3cc431d8,2,5,5,10,3,2015-01-14 19:51:05,2015-01-14 18:40:31
2d5da57f4856656677d82d4a56f5914f3cc431d8...9801d419b9e3d3c716cb857e4337f403d1c50706,1,4,0,4,1,2015-01-14 20:00:27,2015-01-14 20:00:27
9801d419b9e3d3c716cb857e4337f403d1c50706...67bcae1e5890c77d789d10cfe8644b5ab00ffb81,7,11,21,32,9,2015-01-14 21:03:41,2015-01-14 12:36:32
67bcae1e5890c77d789d10cfe8644b5ab00ffb81...4832c004e88a68b98b976b4f68a1c9fdb4ea3530,1,3,0,3,1,2015-01-15 08:24:54,2015-01-15 08:24:54
4832c004e88a68b98b976b4f68a1c9fdb4ea3530...47bdad4e6b3bf70aec0d19d65eeb6a7319ad045a,2,29,25,54,8,2015-01-15 18:03:34,2015-01-13 00:55:57
47bdad4e6b3bf70aec0d19d65eeb6a7319ad045a...67dbc56ec8657e02247c97ec06f7cde8d4808f0d,2,14,1,15,5,2015-01-15 19:02:58,2015-01-15 17:40:31
67dbc56ec8657e02247c97ec06f7cde8d4808f0d...51dc617b21e67636d96cf645905797a4d6ff4bf0,2,4,4,8,4,2015-01-15 20:07:39,2015-01-15 20:07:39
51dc617b21e67636d96cf645905797a4d6ff4bf0...39b58ad95ade8109de0f0ae3930e333b7f689c0f,2,24,1,25,3,2015-01-16 00:42:05,2015-01-15 21:16:25
39b58ad95ade8109de0f0ae3930e333b7f689c0f...faf0d66a80e09be3656a337c33a8e70c7fbab7e3,1,6,0,6,2,2015-01-16 00:45:43,2015-01-15 16:04:47
faf0d66a80e09be3656a337c33a8e70c7fbab7e3...3f9ec12d9c9eff9a3b1a205d87c7e66587cf9967,2,62,3,65,2,2015-01-16 01:19:53,2015-01-06 09:07:40
3f9ec12d9c9eff9a3b1a205d87c7e66587cf9967...28db4af80a319485c0da724d692e2f8396aa57e3,3,50,0,50,3,2015-01-16 01:34:33,2015-01-15 14:56:07
28db4af80a319485c0da724d692e2f8396aa57e3...a34fba5e596a3ec95bf284fd77b1609e71a65019,8,46,134,180,27,2015-01-16 09:40:45,2015-01-15 10:35:35
a34fba5e596a3ec95bf284fd77b1609e71a65019...726a9550db5129badc1c44809b0bed728fa1ad90,4,10,5,15,6,2015-01-16 14:41:01,2015-01-13 08:02:17
726a9550db5129badc1c44809b0bed728fa1ad90...5338ff4808c822a8b00e90154b884b7be3011e60,1,9,9,18,2,2015-01-16 16:59:08,2015-01-16 16:41:14
5338ff4808c822a8b00e90154b884b7be3011e60...a79e6b67175f532049967268c10609af6d31d140,10,208,75,283,69,2015-01-16 18:53:02,2015-01-14 19:48:55
a79e6b67175f532049967268c10609af6d31d140...374c2419e5adef53a643bf69c4753a6bf0c78a98,1,9,0,9,1,2015-01-16 19:10:25,2015-01-16 19:10:25
374c2419e5adef53a643bf69c4753a6bf0c78a98...b4ac23290772e0c11379eb2dfb81c750b7052b66,15,110,49,159,38,2015-01-16 19:21:34,2015-01-08 15:58:23
b4ac23290772e0c11379eb2dfb81c750b7052b66...8e8daf7c9b0f951ed53c322eada0e61e55a57a9f,1,0,25,25,3,2015-01-16 19:41:05,2015-01-16 19:41:05
8e8daf7c9b0f951ed53c322eada0e61e55a57a9f...e8171daf0cd7f0e070395cb4c850c17fea32f11d,2,31,13,44,11,2015-01-16 19:47:09,2015-01-14 18:29:56
e8171daf0cd7f0e070395cb4c850c17fea32f11d...a17724b791275578334bcdc66b3a8113eb86605e,1,2,2,4,1,2015-01-16 20:29:28,2015-01-16 20:29:28
a17724b791275578334bcdc66b3a8113eb86605e...39d95fb6ada99c59d47fa0eae6d3128abafe2d58,13,111,23,134,32,2015-01-16 21:15:16,2015-01-10 18:13:28
39d95fb6ada99c59d47fa0eae6d3128abafe2d58...c72448b59725c619f4f9d6e38264484c12c4c3b9,1,1,1,2,1,2015-01-16 22:06:32,2015-01-16 22:06:32
c72448b59725c619f4f9d6e38264484c12c4c3b9...801287bff262e3beb52d4b4fd21ec529416e079e,1,1,1,2,1,2015-01-16 23:24:44,2015-01-16 22:50:37
801287bff262e3beb52d4b4fd21ec529416e079e...8be1b8b488760959410be93e460944970b8199d6,1,1,1,2,1,2015-01-16 23:30:49,2015-01-16 23:30:49
8be1b8b488760959410be93e460944970b8199d6...eb6a07e0697cf4dbaf33915e60fce56d7705ec22,1,1,1,2,1,2015-01-17 02:06:26,2015-01-17 01:47:06
eb6a07e0697cf4dbaf33915e60fce56d7705ec22...dec5157a7256b91534eaa64afb91c6e569ce17e3,1,9,2,11,2,2015-01-17 09:04:38,2015-01-17 09:01:17
dec5157a7256b91534eaa64afb91c6e569ce17e3...666c12e5295d021c8d791d4410e5753d4a2cc98e,13,627,499,1126,444,2015-01-17 10:18:45,2015-01-17 10:18:45
666c12e5295d021c8d791d4410e5753d4a2cc98e...b714316c0606110cd508863b6d12650004366aaf,1,8,1,9,2,2015-01-17 14:31:56,2015-01-17 14:30:52
b714316c0606110cd508863b6d12650004366aaf...6b1b7263f4b0065a8a514abfd7e74e17e742dbf6,3,20,1,21,3,2015-01-17 14:46:50,2015-01-17 14:43:02
6b1b7263f4b0065a8a514abfd7e74e17e742dbf6...9f86d86c62e5e805ba0191ccd546e174301998ea,1,5,7,12,5,2015-01-17 15:46:27,2015-01-17 15:46:27
9f86d86c62e5e805ba0191ccd546e174301998ea...bfa34788507505584a9885c6856c6a6083670879,1,6,8,14,2,2015-01-17 17:52:30,2015-01-17 17:49:16
bfa34788507505584a9885c6856c6a6083670879...a58a120021e4d63fbb176ecd88a7fefae54ff19c,1,84,87,171,29,2015-01-17 18:27:59,2015-01-17 18:27:59
a58a120021e4d63fbb176ecd88a7fefae54ff19c...5512338d4f2d4193cf4d9fa3dd707b149b8b9450,1,61,69,130,13,2015-01-17 19:42:58,2015-01-16 23:51:31
5512338d4f2d4193cf4d9fa3dd707b149b8b9450...7cfcdd98dcf0dbbde7cfd656e450c52342dbe6f3,1,2,0,2,1,2015-01-17 23:12:47,2015-01-17 23:11:47
7cfcdd98dcf0dbbde7cfd656e450c52342dbe6f3...a41d41046af60e585713b33ff2e6e039446ce389,1,2,0,2,1,2015-01-18 00:15:59,2015-01-18 00:14:44
a41d41046af60e585713b33ff2e6e039446ce389...8822d0bf7d9aa8c494e98cdbb4a0586e7e950a44,2,6,5,11,4,2015-01-18 01:15:09,2015-01-18 01:14:45
8822d0bf7d9aa8c494e98cdbb4a0586e7e950a44...737cd4ff3decfd3e709885d219e70d8395305965,1,18,7,25,12,2015-01-18 18:43:02,2015-01-18 18:40:21
737cd4ff3decfd3e709885d219e70d8395305965...390559a75cf634becf05ae265169f519ea176c3e,3,18,5,23,6,2015-01-18 18:44:53,2015-01-18 18:29:33
390559a75cf634becf05ae265169f519ea176c3e...4af4ccfb304b1c724f840df6ea3f367fcd5ed2d3,2,3,1,4,2,2015-01-18 19:20:15,2015-01-18 19:17:31
4af4ccfb304b1c724f840df6ea3f367fcd5ed2d3...8c8a1a0846cc96f8daae9c4c87307ba4b912fac2,4,104,81,185,4,2015-01-18 20:01:42,2015-01-18 19:58:16
8c8a1a0846cc96f8daae9c4c87307ba4b912fac2...f31ed5c934e7e664b912c13bd854cc9445f34ec5,2,7,1,8,2,2015-01-18 21:07:44,2015-01-18 21:06:56
f31ed5c934e7e664b912c13bd854cc9445f34ec5...559e15a23a7e1f2437de001e7eda2e2fa0723fb3,1,0,3,3,1,2015-01-18 21:31:21,2015-01-18 21:30:45
559e15a23a7e1f2437de001e7eda2e2fa0723fb3...663db8ea2adfd47dda50726404401ff2d290db52,1,4,6,10,3,2015-01-18 23:33:56,2015-01-18 23:32:47
663db8ea2adfd47dda50726404401ff2d290db52...511ef69194e0bbbd3a917e9f544f250a50619ffb,1,1,1,2,1,2015-01-19 01:48:35,2015-01-19 01:02:15
511ef69194e0bbbd3a917e9f544f250a50619ffb...0c910823c166b827b090df5c5c8be9e502a14d8c,2,24,2,26,2,2015-01-19 02:18:09,2015-01-18 23:35:10
0c910823c166b827b090df5c5c8be9e502a14d8c...dd0707c3ca74fd4a019e0dd143cb8fec799f5186,2,17,7,24,6,2015-01-19 02:24:09,2015-01-19 02:23:06
dd0707c3ca74fd4a019e0dd143cb8fec799f5186...6eddaa42c3843e23a16442096c43664e21c92af7,1,7,10,17,5,2015-01-19 09:19:42,2015-01-19 09:18:29
6eddaa42c3843e23a16442096c43664e21c92af7...0b3e3e21cfe7463245dc1dfc9258e18903bc1116,2,10,0,10,2,2015-01-19 15:45:50,2015-01-18 19:30:07
0b3e3e21cfe7463245dc1dfc9258e18903bc1116...e55cb91bd47d054d502c03cdbe74ac98986af3fb,4,128,15,143,8,2015-01-19 15:55:25,2015-01-19 14:31:23
e55cb91bd47d054d502c03cdbe74ac98986af3fb...06fa019c1bac6af934c0c5b7f93e5d837d96aefa,2,5,3,8,5,2015-01-19 20:39:36,2015-01-19 20:12:57
06fa019c1bac6af934c0c5b7f93e5d837d96aefa...e69eea73d94c058728143416058a6257c765a9b8,2,13,5,18,5,2015-01-20 00:09:08,2015-01-18 21:53:18
e69eea73d94c058728143416058a6257c765a9b8...504cd5d3be450376f462b66e36df6edc923e9496,2,14,2,16,3,2015-01-20 01:11:27,2015-01-20 00:47:13
504cd5d3be450376f462b66e36df6edc923e9496...c80b2144d22d29725cf4d584bfa9079dd35af064,2,26,2,28,2,2015-01-20 10:26:32,2015-01-20 09:52:23
c80b2144d22d29725cf4d584bfa9079dd35af064...cb90d489da4247c1c7ced86a42a2d89488fec67c,1,1,1,2,1,2015-01-20 13:15:39,2015-01-20 01:54:57
cb90d489da4247c1c7ced86a42a2d89488fec67c...20f1aafa14798d8caac74319a335668ffe86c224,1,26,24,50,18,2015-01-20 16:45:29,2015-01-20 10:39:23
20f1aafa14798d8caac74319a335668ffe86c224...90d9bf5ba46f806e7d4a7d19023f8d19028c4a27,1,1,1,2,1,2015-01-20 16:56:02,2015-01-20 16:44:41
90d9bf5ba46f806e7d4a7d19023f8d19028c4a27...45aaced91e4789c3a08b17f0908010923361dbec,26,28,28,56,28,2015-01-20 17:18:29,2015-01-20 14:54:12
45aaced91e4789c3a08b17f0908010923361dbec...0580133971e42c322a9c0b451d3bbf72eff2ca24,2,15,5,20,6,2015-01-22 01:02:07,2015-01-21 05:47:49
0580133971e42c322a9c0b451d3bbf72eff2ca24...11a5e45b96c3a15826927f5d0e50472767b937f1,4,105,8,113,11,2015-01-22 17:53:47,2015-01-08 22:51:00
11a5e45b96c3a15826927f5d0e50472767b937f1...1806e059f6127e3e4572db09f297984c96ea9d02,1,8,0,8,2,2015-01-22 20:50:26,2015-01-22 20:23:45
1806e059f6127e3e4572db09f297984c96ea9d02...bc93568500303b4fa00c89c7f1607fab455b6c32,2,4,0,4,2,2015-01-23 08:05:46,2015-01-23 08:05:46
bc93568500303b4fa00c89c7f1607fab455b6c32...2ed1980e0f82c9a952bdecbeb6f5d36513d74cc8,1,3,3,6,1,2015-01-23 18:00:24,2015-01-23 17:58:57
2ed1980e0f82c9a952bdecbeb6f5d36513d74cc8...56015c01c4725aeeb225a62f2702a4bbb3a3ce54,3,59,3,62,6,2015-01-23 20:07:03,2015-01-18 02:20:42
56015c01c4725aeeb225a62f2702a4bbb3a3ce54...1ee18a60460d192953fbd1e8c9b7a75aac5d0bd0,2,2,2,4,4,2015-01-23 21:20:08,2015-01-23 21:03:30
1ee18a60460d192953fbd1e8c9b7a75aac5d0bd0...242c9538c8d252f27581e2b192237301f94a2928,1,7,3,10,2,2015-01-23 21:42:33,2015-01-23 13:23:44
242c9538c8d252f27581e2b192237301f94a2928...09e8985f25ddd901a3678d4b34878d6c631b0cea,1,11,8,19,3,2015-01-24 15:18:14,2015-01-20 15:20:02
09e8985f25ddd901a3678d4b34878d6c631b0cea...2d990fb7fa6a04bb709aa9d7f687ec009c557c9e,1,4,2,6,3,2015-01-26 15:49:55,2015-01-26 10:23:48
2d990fb7fa6a04bb709aa9d7f687ec009c557c9e...5dff3513cc1bb998abe60f52269790268a74220c,2,5,3,8,3,2015-01-26 17:42:08,2015-01-26 10:09:50
5dff3513cc1bb998abe60f52269790268a74220c...e56810e839db2beddc8a7b6e917158855ef381dc,11,52,62,114,28,2015-01-27 03:47:38,2015-01-17 05:03:46
e56810e839db2beddc8a7b6e917158855ef381dc...645fe136c4354ce313be5a150864ad046c227a22,1,4,0,4,1,2015-01-27 15:05:27,2015-01-27 13:39:22
645fe136c4354ce313be5a150864ad046c227a22...617121cd4a5e0775b61eab630eacbbffc5e8dbe5,3,18,1,19,3,2015-01-27 16:48:27,2015-01-27 16:48:04
617121cd4a5e0775b61eab630eacbbffc5e8dbe5...29fa0e3c6663a45cc17163d7b48c3718e1e5a574,1,3,3,6,1,2015-01-27 18:48:46,2015-01-27 18:42:48
29fa0e3c6663a45cc17163d7b48c3718e1e5a574...7cc1b4710ea3fbe3a076d14f9265f115a615964a,2,19,1,20,2,2015-01-27 19:16:53,2015-01-24 12:14:30
7cc1b4710ea3fbe3a076d14f9265f115a615964a...405351ba2f639a1a0c092ecb6d93f9f7a646686a,1,22,0,22,1,2015-01-28 00:03:25,2015-01-27 02:37:43
405351ba2f639a1a0c092ecb6d93f9f7a646686a...6c68e40e6e7f3ba36fa0e629d5724c7f4b279bb8,3,111,6,117,19,2015-01-28 00:03:39,2015-01-27 02:40:32
6c68e40e6e7f3ba36fa0e629d5724c7f4b279bb8...f858b51ee31314225e82812f58f353721f06101a,1,3,5,8,4,2015-01-28 00:04:12,2015-01-27 02:42:48
f858b51ee31314225e82812f58f353721f06101a...df7cca6dff8c18cd891fdd73529a14aa2632e4e2,2,13,0,13,2,2015-01-28 11:39:11,2015-01-28 11:38:31
df7cca6dff8c18cd891fdd73529a14aa2632e4e2...6002393a976c457ec1a08e59cc03ce732032371d,1,1,1,2,1,2015-01-28 11:48:48,2015-01-26 01:08:00
6002393a976c457ec1a08e59cc03ce732032371d...590ee3ed167ef7d1dad681efd6d9a4dc0767f02a,1,3,3,6,2,2015-01-29 18:02:49,2015-01-17 13:53:02
590ee3ed167ef7d1dad681efd6d9a4dc0767f02a...d0c343372f62bbcccba844350353220af114f10b,1,0,5,5,1,2015-01-29 19:12:35,2015-01-29 17:53:57
d0c343372f62bbcccba844350353220af114f10b...7b92acea7055c6b39207a813b52e683a3672e467,1,3,2,5,2,2015-01-29 19:37:33,2015-01-28 14:05:47
7b92acea7055c6b39207a813b52e683a3672e467...a301061f88268255fc2660ca993a84b8bf12f9d2,3,12,3,15,4,2015-01-29 19:42:28,2015-01-22 06:43:49
a301061f88268255fc2660ca993a84b8bf12f9d2...df68751134531462f005a75e7342d46540033b88,4,25,12,37,10,2015-01-30 11:34:36,2015-01-29 12:20:56
df68751134531462f005a75e7342d46540033b88...3d3c7a62c865b9a993e73a0a367134f0416283c4,1,1,1,2,1,2015-01-30 13:30:03,2015-01-29 21:57:03
3d3c7a62c865b9a993e73a0a367134f0416283c4...7060ef71581c740bcc28ed405225537a411c36b5,2,5,37,42,6,2015-01-30 17:52:39,2015-01-30 16:23:20
7060ef71581c740bcc28ed405225537a411c36b5...c77dd64402e64e3e53b49634175f1e010a480b67,5,26,4,30,6,2015-01-30 19:29:05,2015-01-16 23:17:54
c77dd64402e64e3e53b49634175f1e010a480b67...28bb0ad19947514cd275e5692a5424e45919b5be,1,38,0,38,1,2015-01-31 16:03:08,2015-01-30 13:20:35
28bb0ad19947514cd275e5692a5424e45919b5be...0fc2f94699a425fe963be255d0da5966e914b6b0,1,0,7,7,1,2015-01-31 16:06:03,2015-01-31 02:38:29
0fc2f94699a425fe963be255d0da5966e914b6b0...c9e538b174e777a1ab51c55913ab8c185414a1ef,6,6,33,39,12,2015-02-01 23:45:01,2015-01-28 14:55:52
c9e538b174e777a1ab51c55913ab8c185414a1ef...fe770a6452919807bba59c125b02464290feeba1,1,1,1,2,1,2015-02-02 01:11:40,2015-01-31 19:20:36
fe770a6452919807bba59c125b02464290feeba1...26e07a996d9ca34b6a2582bf4112cd27fb414959,1,0,12,12,1,2015-02-02 01:13:58,2015-02-02 00:33:44
26e07a996d9ca34b6a2582bf4112cd27fb414959...7580876fbdb05a2cfe016f49a49dc55b45f11011,1,0,5,5,1,2015-02-02 01:26:43,2015-02-02 00:54:20
7580876fbdb05a2cfe016f49a49dc55b45f11011...c9df163d0ceae254fd16aec895253443b8e6fcd8,1,0,6,6,1,2015-02-02 01:35:57,2015-02-02 01:33:22
c9df163d0ceae254fd16aec895253443b8e6fcd8...6d0538bd8c38e83a605c987a40081149b254b802,1,9,17,26,1,2015-02-02 02:06:27,2015-02-02 02:06:27
6d0538bd8c38e83a605c987a40081149b254b802...3cd8f51f21878d2fcd8361adcb0d88d152e778ef,1,0,11,11,1,2015-02-02 02:38:34,2015-02-02 01:18:15
3cd8f51f21878d2fcd8361adcb0d88d152e778ef...ef90ca5f42c81dcee39878c9da96af56eb5e29a4,1,33,33,66,16,2015-02-02 15:47:42,2015-01-30 23:14:46
ef90ca5f42c81dcee39878c9da96af56eb5e29a4...3af1e7860e0160bd126bdafebf8511b1ea365af9,1,0,9,9,1,2015-02-02 16:13:48,2015-02-02 16:06:27
3af1e7860e0160bd126bdafebf8511b1ea365af9...f87457a4604efc862381020b47f4e6fe8272ac0b,19,180,22,202,62,2015-02-03 07:32:14,2015-01-26 20:57:10
f87457a4604efc862381020b47f4e6fe8272ac0b...c65c8f5696eeac056260a0850525d5266dcf8353,1,7,3,10,1,2015-02-03 13:21:06,2015-02-03 13:15:24
c65c8f5696eeac056260a0850525d5266dcf8353...6454716264163b4693c03168ec56ea894ea511f2,1,4,14,18,2,2015-02-03 13:42:49,2015-02-03 13:41:57
6454716264163b4693c03168ec56ea894ea511f2...5fdd74f4be4aa6ce54021492e1b05ebf3770463d,1,3,3,6,3,2015-02-03 14:12:08,2015-02-03 14:10:55
5fdd74f4be4aa6ce54021492e1b05ebf3770463d...9ffe013caa9360183cdb948b8e03c9c2a0da5417,2,5,1,6,2,2015-02-03 14:13:10,2015-02-03 13:46:17
9ffe013caa9360183cdb948b8e03c9c2a0da5417...43b0131fb5724cb92716eedfe35a6b2b4d84e1e5,6,50,0,50,7,2015-02-03 14:25:55,2015-01-28 11:40:48
43b0131fb5724cb92716eedfe35a6b2b4d84e1e5...d88c24f436ae23ff5aec4ea06c0c27499a71e074,4,21,12,33,7,2015-02-03 17:19:06,2015-01-28 21:43:23
d88c24f436ae23ff5aec4ea06c0c27499a71e074...ea3e40c278eb27fb3c8362d9e8cd67f957bf4f57,2,15,0,15,3,2015-02-03 17:26:08,2015-01-31 15:05:16
ea3e40c278eb27fb3c8362d9e8cd67f957bf4f57...b35c2261543be619f7fef0d74154611ce2924f26,1,2,2,4,2,2015-02-03 17:27:16,2015-02-03 13:03:05
b35c2261543be619f7fef0d74154611ce2924f26...ff39de1e1e3d5044611105e2ee654a5e438f4525,4,78,64,142,6,2015-02-03 18:46:56,2015-02-03 18:09:54
ff39de1e1e3d5044611105e2ee654a5e438f4525...92d5bedc56155e4c91c7644200415b3e42cdd31f,2,13,31,44,11,2015-02-03 20:24:24,2015-02-03 20:12:28
92d5bedc56155e4c91c7644200415b3e42cdd31f...dd83bab9316fff94637040344faf725a499a5abf,1,9,8,17,2,2015-02-03 21:38:05,2015-02-03 21:35:28
dd83bab9316fff94637040344faf725a499a5abf...cbcf92e95f8a6d275b55069de3c57835814b502f,3,36,8,44,7,2015-02-03 21:41:51,2015-02-03 20:13:43
cbcf92e95f8a6d275b55069de3c57835814b502f...3e24ab6f4ca6632c910c684fda3d0f937fade52a,6,6,4,10,6,2015-02-03 23:31:17,2015-02-03 23:02:59
3e24ab6f4ca6632c910c684fda3d0f937fade52a...fc49e736484892eaa516826d93660c7ab53a6c3e,3,55,4,59,6,2015-02-03 23:58:48,2015-01-22 03:15:59
fc49e736484892eaa516826d93660c7ab53a6c3e...16e3910e9cb93550a500553b2fb3da2b1822478b,3,5,5,10,4,2015-02-04 12:32:34,2015-02-04 06:01:59
16e3910e9cb93550a500553b2fb3da2b1822478b...4957b8a40615a082c9218c7c662fb8fccf46b14f,3,53,15,68,15,2015-02-04 14:05:41,2014-04-05 15:58:05
4957b8a40615a082c9218c7c662fb8fccf46b14f...d585ade0dfef523c1c4be9fe6dad2dfaf3d1583d,3,84,12,96,8,2015-02-04 15:54:33,2015-01-25 14:53:40
d585ade0dfef523c1c4be9fe6dad2dfaf3d1583d...2a55301f9fe1c3b62ad4e79c3109bec77b57b317,2,16,3,19,5,2015-02-04 20:17:22,2015-01-29 07:59:41
2a55301f9fe1c3b62ad4e79c3109bec77b57b317...f5749252eac68274b1e8f71b5e74c976199c360c,1,5,3,8,1,2015-02-05 10:35:23,2015-02-05 09:09:13
f5749252eac68274b1e8f71b5e74c976199c360c...5fbec369aa32d1717b7bffc169649ab5896a7ad9,2,8,2,10,3,2015-02-05 13:07:18,2015-02-05 12:20:33
5fbec369aa32d1717b7bffc169649ab5896a7ad9...67787db22a3d684ce2800c80fca477af1684deab,2,13,4,17,3,2015-02-05 19:09:10,2015-02-05 10:38:58
67787db22a3d684ce2800c80fca477af1684deab...aed1b1f6e5133f91c063f6f8b75729c4a18f99c7,2,41,0,41,2,2015-02-05 19:09:22,2015-02-05 10:53:04
aed1b1f6e5133f91c063f6f8b75729c4a18f99c7...e3702dc3f2af9e8cc6c1155b248f458899be334e,3,315,431,746,113,2015-02-05 19:15:18,2015-01-29 14:14:55
e3702dc3f2af9e8cc6c1155b248f458899be334e...c9addfd4bfadde043a1aec7854b285aa212bdd5a,1,8,0,8,8,2015-02-05 23:50:42,2015-02-05 23:40:36
c9addfd4bfadde043a1aec7854b285aa212bdd5a...fc1e9107d7d750f6eed3c8e679dfe96af8f05150,2,13,0,13,2,2015-02-06 00:15:37,2015-02-05 21:13:57
fc1e9107d7d750f6eed3c8e679dfe96af8f05150...5bc9904b3598a3cbdf7f5ebff744ffd77dc8fc87,1,4,6,10,1,2015-02-06 12:46:14,2015-02-03 12:43:51
5bc9904b3598a3cbdf7f5ebff744ffd77dc8fc87...6adc23d6b6203eaa5b4c72824c1b2abc368be857,3,0,64,64,2,2015-02-06 13:55:02,2015-02-06 12:58:31
6adc23d6b6203eaa5b4c72824c1b2abc368be857...289660f52d501df2bc4612a820cbe2097d070b70,1,0,30,30,1,2015-02-06 13:55:10,2015-02-06 13:47:38
289660f52d501df2bc4612a820cbe2097d070b70...232a1d297c8431a77f3dbb9bcf453d17eb5e3315,3,0,45,45,2,2015-02-06 13:56:01,2015-02-06 11:22:00
232a1d297c8431a77f3dbb9bcf453d17eb5e3315...fc8e1e0c107fe5fc8c82f01dfabfa9b7a196a67c,54,197,210,407,207,2015-02-06 14:35:08,2015-02-05 18:25:34
fc8e1e0c107fe5fc8c82f01dfabfa9b7a196a67c...b6323302e03a4bb3cd87ca6a14a951c74ab82046,1,1,1,2,1,2015-02-07 17:47:17,2015-02-07 16:57:37
b6323302e03a4bb3cd87ca6a14a951c74ab82046...b2b5ea88b7159a89e373a71f215596de4d8b015f,2,4,4,8,4,2015-02-07 18:52:50,2015-02-07 18:22:31
b2b5ea88b7159a89e373a71f215596de4d8b015f...edbf6de7536f7a6c1e5df019a5e1947d2c9dadf8,6,9,62,71,13,2015-02-07 19:35:20,2015-02-07 18:34:15
edbf6de7536f7a6c1e5df019a5e1947d2c9dadf8...b44a56c3080312ab94679a396e6b60a18f9b6463,2,4,1,5,2,2015-02-08 19:09:04,2015-02-07 21:36:45
b44a56c3080312ab94679a396e6b60a18f9b6463...ee86bf24d269869012d5538c22d37588cec68685,1,3,1,4,2,2015-02-08 19:57:19,2015-02-08 18:14:30
ee86bf24d269869012d5538c22d37588cec68685...d54638727ae23e8dc1e1ed0823efbd15806d9778,1,2,4,6,4,2015-02-08 20:03:29,2015-02-08 18:24:11
d54638727ae23e8dc1e1ed0823efbd15806d9778...cd260d03bd7c43b78ad3a394e1b62f526f40f4ce,8,707,658,1365,562,2015-02-08 20:12:07,2015-02-06 22:25:15
cd260d03bd7c43b78ad3a394e1b62f526f40f4ce...8cb2cfdda5a9a913dc761eba48b56b7d2f4ce2e7,1,2,0,2,2,2015-02-09 02:31:28,2015-02-05 20:26:54
8cb2cfdda5a9a913dc761eba48b56b7d2f4ce2e7...eb9fbc0b1d6497f20204d9032852a5b4ae8b2466,2,26,1,27,2,2015-02-09 13:43:40,2015-01-30 09:40:25
eb9fbc0b1d6497f20204d9032852a5b4ae8b2466...6e50fc924610119fd659bc0821c9c059c7d03c62,2,50,45,95,26,2015-02-09 13:57:02,2015-02-09 13:53:58
6e50fc924610119fd659bc0821c9c059c7d03c62...64a9540829cbfc353ce648b6d47bc80f42aa3602,1,7,0,7,1,2015-02-09 14:16:23,2015-02-09 14:15:56
64a9540829cbfc353ce648b6d47bc80f42aa3602...ac576e9f454db4942335a9a5df6168d31d4f98fe,2,50,11,61,10,2015-02-09 14:38:03,2015-02-05 21:50:31
ac576e9f454db4942335a9a5df6168d31d4f98fe...9744529c1245dc675cf69fd76448aa60dc934941,2,16,0,16,3,2015-02-09 15:21:15,2015-02-09 13:15:26
9744529c1245dc675cf69fd76448aa60dc934941...eb406aa686ff1809903366ef6896037af2f1f69b,1,7,4,11,4,2015-02-09 17:34:23,2015-02-09 17:34:23
eb406aa686ff1809903366ef6896037af2f1f69b...a8b70d251d238b4e6cfc7bb4296da15494f8dff3,819,2601,2371,4972,1955,2015-02-09 19:24:06,2015-02-09 18:19:34
a8b70d251d238b4e6cfc7bb4296da15494f8dff3...9b7b37382cb0e8b5e2d149a3102005bf62016ea3,2,18,10,28,3,2015-02-10 13:35:05,2015-02-10 09:29:00
9b7b37382cb0e8b5e2d149a3102005bf62016ea3...3518d51697f1f2e0a516cd82dfc6e05f9f686dab,4,10,5,15,5,2015-02-10 21:42:16,2015-02-09 23:54:51
3518d51697f1f2e0a516cd82dfc6e05f9f686dab...00f76b018f4fd84a02e26afc9d5006ff85231b40,1,1,2,3,2,2015-02-10 23:53:23,2015-02-10 19:24:14
00f76b018f4fd84a02e26afc9d5006ff85231b40...6e23c9be46a3ab74c39daba5ce344b818ac30608,1,1,1,2,1,2015-02-11 00:05:24,2015-02-10 19:27:20
6e23c9be46a3ab74c39daba5ce344b818ac30608...c6a49d4f17db4579389e3f0477436f2444dead10,1,2,3,5,3,2015-02-11 00:07:07,2015-02-10 20:37:53
c6a49d4f17db4579389e3f0477436f2444dead10...fdcc9c47d51289576ce17849900c96c161273037,4,21,3,24,5,2015-02-11 00:55:42,2015-02-10 17:15:54
fdcc9c47d51289576ce17849900c96c161273037...a0553d1a7cb4f5ecca90650ef9ebad4c44cf6b43,3,12,1,13,5,2015-02-11 15:17:53,2015-02-10 17:02:47
a0553d1a7cb4f5ecca90650ef9ebad4c44cf6b43...36bf6ec9eb8a3ef4e24d3a6374780603f5bbdf97,17,40,26,66,35,2015-02-11 16:47:58,2015-02-10 00:20:39
36bf6ec9eb8a3ef4e24d3a6374780603f5bbdf97...0520cfe94a1705d604e9425848fc90e6ca903059,2,6,7,13,2,2015-02-11 16:50:23,2015-02-10 12:51:02
0520cfe94a1705d604e9425848fc90e6ca903059...e1046a96bcb996c34b79974e21575d718f6b5739,13,43,47,90,9,2015-02-11 16:52:10,2015-02-10 13:11:25
e1046a96bcb996c34b79974e21575d718f6b5739...10fdd2fc1d4c95ff1b27f79a09bf69949cf909fb,2,0,0,0,0,2015-02-11 16:54:51,2015-02-10 13:18:29
10fdd2fc1d4c95ff1b27f79a09bf69949cf909fb...bbe7964185fb786599b9f4bcaa07fc54156c9e0d,9,12,21,33,13,2015-02-11 16:55:05,2015-02-10 13:30:35
bbe7964185fb786599b9f4bcaa07fc54156c9e0d...c0f0f93b5d3d100f0d975215fa4a354962f9d416,3,5,4,9,5,2015-02-11 16:55:40,2015-02-10 13:41:45
c0f0f93b5d3d100f0d975215fa4a354962f9d416...44df17d53cbf2c60bdc2835d8aebca20930e0c14,2,2,1,3,2,2015-02-11 16:55:53,2015-02-10 13:44:52
44df17d53cbf2c60bdc2835d8aebca20930e0c14...e55d888b6680a45ca957434599c37f0286034cab,44,54,126,180,99,2015-02-11 17:02:35,2015-02-10 14:17:08
e55d888b6680a45ca957434599c37f0286034cab...2482c9dd2427e03769f067a56cd8a139fe043674,10,175,144,319,19,2015-02-11 17:03:03,2015-02-11 13:24:42
2482c9dd2427e03769f067a56cd8a139fe043674...69c89aeccf31c5ea10ffc546f5d499bcb4d719de,99,82,72,154,66,2015-02-11 17:05:29,2015-02-10 15:07:44
69c89aeccf31c5ea10ffc546f5d499bcb4d719de...411028df534934ca7bc95335fcb5b0e26df931d6,2,5,29,34,7,2015-02-11 17:05:55,2015-02-10 17:03:47
411028df534934ca7bc95335fcb5b0e26df931d6...e06971340d6a8c1eb41588d8c5fb3cacac798ab3,2,3,3,6,3,2015-02-11 17:35:32,2015-02-11 17:29:20
e06971340d6a8c1eb41588d8c5fb3cacac798ab3...343c0875338128dad162d4806fe908fb31404d14,2,7,1,8,2,2015-02-11 18:01:25,2015-02-11 16:40:03
343c0875338128dad162d4806fe908fb31404d14...a6ea62aeafd4512f6d13aeda908f7622776a4537,7,89,88,177,54,2015-02-11 21:53:03,2015-02-11 05:38:02
a6ea62aeafd4512f6d13aeda908f7622776a4537...1904022f91d0e987d972359d98993422db11ab3f,2,15,2,17,4,2015-02-12 08:01:59,2015-02-11 10:09:51
1904022f91d0e987d972359d98993422db11ab3f...596564e808089f1263469dbf4744dcaa05b79222,4,40,6,46,10,2015-02-12 12:40:14,2015-02-11 19:38:52
596564e808089f1263469dbf4744dcaa05b79222...0ab8ec4312aba482b92c8b75966f1f44948bb790,1,1,2,3,2,2015-02-12 13:05:04,2015-02-10 03:03:29
0ab8ec4312aba482b92c8b75966f1f44948bb790...7b5aa20a281d1df27a9d94dd591845838a3cc804,2,15,2,17,5,2015-02-12 13:19:10,2015-02-08 18:44:07
7b5aa20a281d1df27a9d94dd591845838a3cc804...8d1816db87e9e700d9bd5336ac25686fdf30c789,2,7,1,8,4,2015-02-12 15:17:31,2015-02-12 14:54:42
8d1816db87e9e700d9bd5336ac25686fdf30c789...6b8c8d7e18bf46def3d6c9be3f9b77f52c5d85b2,1,4,3,7,3,2015-02-12 15:32:56,2015-02-11 15:00:12
6b8c8d7e18bf46def3d6c9be3f9b77f52c5d85b2...6476fa73d3ce03eac1a5a05e839257316da992db,1,3,0,3,1,2015-02-12 19:06:21,2015-02-12 19:05:52
6476fa73d3ce03eac1a5a05e839257316da992db...03f4e2d90997aec4c8f57c5c9b7925d70194327e,2,11,2,13,3,2015-02-12 19:20:17,2015-02-12 18:40:23
03f4e2d90997aec4c8f57c5c9b7925d70194327e...1784c326b1040bc1957a6f9664fdd2a8647bde50,2,11,2,13,3,2015-02-12 23:01:06,2015-02-12 02:25:12
1784c326b1040bc1957a6f9664fdd2a8647bde50...47b23ca2ee4d26a50895adf0fba19020b27d8d84,1,4,2,6,2,2015-02-13 00:24:25,2015-02-12 23:06:46
47b23ca2ee4d26a50895adf0fba19020b27d8d84...4c948c7c9d8b8bb4a36f703a6e96de5914740b0f,4,34,4,38,8,2015-02-13 12:02:37,2015-02-12 18:58:37
4c948c7c9d8b8bb4a36f703a6e96de5914740b0f...45d93baf518218c39b70fbc1eb35e9b53f66cf98,3,14,44,58,7,2015-02-13 13:39:50,2015-01-22 03:26:37
45d93baf518218c39b70fbc1eb35e9b53f66cf98...4ba7d73f94b47abfb5f90ac223973bcd64466e80,1,0,2,2,1,2015-02-13 14:21:03,2015-02-12 11:39:01
4ba7d73f94b47abfb5f90ac223973bcd64466e80...bd80fa6b0f7e5a0cc4ea26cedd56d0c4c4894420,7,130,23,153,18,2015-02-13 14:21:10,2015-02-12 11:48:28
bd80fa6b0f7e5a0cc4ea26cedd56d0c4c4894420...8fc4840289a0538af005619551c3b67f4f9e1399,3,67,3,70,9,2015-02-13 14:50:55,2015-02-12 17:14:19
8fc4840289a0538af005619551c3b67f4f9e1399...2347f3267fbbfab76930fb6068b0361bff297691,2,25,2,27,5,2015-02-13 14:57:44,2015-02-13 14:12:30
2347f3267fbbfab76930fb6068b0361bff297691...8277f5d7d0849943a2b501d256927a049adda499,1,17,2,19,1,2015-02-13 15:38:29,2015-02-11 10:22:13
8277f5d7d0849943a2b501d256927a049adda499...136edac8974ff0b570ce0a3e66e7aadf542225f0,3,19,10,29,5,2015-02-13 17:45:35,2015-02-13 14:21:33
136edac8974ff0b570ce0a3e66e7aadf542225f0...20b621eb3c3dd947a4fe77a2a11264b9072ef25c,8,34,34,68,20,2015-02-13 19:42:06,2015-02-13 18:55:36
20b621eb3c3dd947a4fe77a2a11264b9072ef25c...0f3eb8260b251a15c57f577fb33baad88b284942,2,19,4,23,4,2015-02-14 09:36:44,2015-02-14 09:21:06
0f3eb8260b251a15c57f577fb33baad88b284942...2e6d8e51db7c469ef32c7d00ff5aa7e68237f5f1,2,12,2,14,4,2015-02-14 12:38:20,2015-02-13 22:12:23
2e6d8e51db7c469ef32c7d00ff5aa7e68237f5f1...8657e7caaac41266d9ac0b73a21af64edc681613,2,23,0,23,2,2015-02-14 13:09:27,2015-02-14 13:01:37
8657e7caaac41266d9ac0b73a21af64edc681613...a1fc97c1a7949b4e8a16d22ee33ca06c887af038,1,2,1,3,1,2015-02-14 15:20:58,2015-02-14 15:18:17
a1fc97c1a7949b4e8a16d22ee33ca06c887af038...87e9cad4a4481e7cd91e2e7bac46efe54000a932,3,55,5,60,4,2015-02-14 17:52:28,2015-02-14 08:50:38
87e9cad4a4481e7cd91e2e7bac46efe54000a932...e13dca859cec90b7a04d51117fec5c18c6f90a9f,2,2,0,2,2,2015-02-14 23:39:17,2015-02-14 21:33:09
e13dca859cec90b7a04d51117fec5c18c6f90a9f...259259a819a12a9ecfd0448c646899fad78e23e0,1,8,0,8,2,2015-02-15 03:36:49,2015-02-15 03:03:25
259259a819a12a9ecfd0448c646899fad78e23e0...69c662c9817f8c558d5e7a357221fdedb3bb7f59,1,39,0,39,1,2015-02-15 19:44:40,2015-02-15 16:31:06
69c662c9817f8c558d5e7a357221fdedb3bb7f59...e8950668ca4c3160cef3e1191a02ba1388a98cac,20,72,48,120,41,2015-02-15 19:48:48,2015-02-15 14:42:05
e8950668ca4c3160cef3e1191a02ba1388a98cac...ba9f60270887ae21424683c53bced3c226d5fa39,2,1,1,2,1,2015-02-16 01:09:13,2015-02-16 01:07:22
ba9f60270887ae21424683c53bced3c226d5fa39...bc2eb6bfef00fd8ea4395e3462366b6571f88601,1,8,0,8,2,2015-02-16 13:43:06,2015-02-16 13:02:49
bc2eb6bfef00fd8ea4395e3462366b6571f88601...e63d9b98e7c5a19e94f45eb85a1f2e53f95a1a7a,1,14,0,14,1,2015-02-16 15:12:13,2015-02-15 19:40:13
e63d9b98e7c5a19e94f45eb85a1f2e53f95a1a7a...681efedce4c55cc685e044899f5dabac57d6766f,1,1,1,2,1,2015-02-16 16:14:33,2015-02-16 16:08:19
681efedce4c55cc685e044899f5dabac57d6766f...10ea9ef012cc11c9ae67ab4ba5d84e0d5d192732,1,50,1,51,4,2015-02-16 18:37:40,2015-01-29 15:57:12
10ea9ef012cc11c9ae67ab4ba5d84e0d5d192732...8ca0eb2af70b7fbfd9689553d40ef6023433f94e,9,97,0,97,4,2015-02-16 18:37:51,2015-02-11 09:14:53
8ca0eb2af70b7fbfd9689553d40ef6023433f94e...4e9ecfee7759f365dd75dbf89df0ee9a64ef50aa,1,54,0,54,1,2015-02-16 18:37:57,2015-02-13 15:42:44
4e9ecfee7759f365dd75dbf89df0ee9a64ef50aa...a1ba4627931591b80afa46e38e261f354151d91a,1,111,41,152,11,2015-02-16 18:38:02,2015-02-09 00:11:25
a1ba4627931591b80afa46e38e261f354151d91a...b7cf99a8c3d59a0e4ee1e602cc7102bbbd35b90e,2,223,2,225,3,2015-02-16 18:38:10,2015-02-11 00:01:01
b7cf99a8c3d59a0e4ee1e602cc7102bbbd35b90e...870d900cdcd29564bcc7f47cc67d51af2617f614,2,38,13,51,6,2015-02-16 18:44:04,2015-02-07 19:31:12
870d900cdcd29564bcc7f47cc67d51af2617f614...50ec49c08709ccba55a856d3f0e536e90c28124f,1,8,16,24,3,2015-02-16 19:29:30,2015-02-16 19:28:41
50ec49c08709ccba55a856d3f0e536e90c28124f...906d682ba00473b1df73c5542ccc308755e9f46a,1,3,3,6,2,2015-02-16 19:38:18,2015-02-16 19:34:37
906d682ba00473b1df73c5542ccc308755e9f46a...77e3f7dd586908b6c78d9718bbea65846e20e180,1,17,0,17,1,2015-02-16 19:55:24,2015-02-16 17:53:56
77e3f7dd586908b6c78d9718bbea65846e20e180...fb9551189da7d0462633b7f2520daa95f80b2a09,2,13,18,31,6,2015-02-16 19:59:57,2015-02-16 19:22:22
fb9551189da7d0462633b7f2520daa95f80b2a09...ad2c6a756b8c47834bcebf91552475050f9cefc4,5,42,44,86,4,2015-02-16 23:06:13,2015-02-16 20:54:00
ad2c6a756b8c47834bcebf91552475050f9cefc4...2b79a35a830cf5326b1c764963b7e8431864ec97,1,0,3,3,1,2015-02-16 23:06:53,2015-02-16 15:36:35
2b79a35a830cf5326b1c764963b7e8431864ec97...30e5356c2ecb220e0ac866a7860aefbc90b97aa0,1,18,19,37,3,2015-02-17 11:21:24,2015-02-14 08:53:17
30e5356c2ecb220e0ac866a7860aefbc90b97aa0...d027993ed14df1f9e25f13d7da87db11447c8c95,1,1,4,5,1,2015-02-17 11:21:37,2015-02-14 16:31:53
d027993ed14df1f9e25f13d7da87db11447c8c95...730fb593ad19731e7018dd83236318bfe71de86a,6,33,33,66,16,2015-02-17 11:21:59,2015-02-16 17:11:39
730fb593ad19731e7018dd83236318bfe71de86a...a00a0f880485e1f122e48e0216d34d08efe199e1,5,6,16,22,14,2015-02-17 11:35:17,2015-02-16 23:10:35
a00a0f880485e1f122e48e0216d34d08efe199e1...bcb3bfa5a2716454e15ca0203e0debf497b14273,1,4,4,8,3,2015-02-17 12:29:30,2015-02-15 00:30:33
bcb3bfa5a2716454e15ca0203e0debf497b14273...b2f7daa4a6ba4f463dd79b19c337c738201479ad,1,1,0,1,1,2015-02-17 12:35:00,2015-02-15 23:59:54
b2f7daa4a6ba4f463dd79b19c337c738201479ad...9dba901d9c44a117b35003e0c239476536c259aa,1,2,1,3,2,2015-02-17 13:08:28,2015-02-15 23:59:39
9dba901d9c44a117b35003e0c239476536c259aa...4f43e5c4353325eb8d1c455c58e299ef95e2e422,1,1,1,2,1,2015-02-17 13:11:38,2015-02-15 01:46:11
4f43e5c4353325eb8d1c455c58e299ef95e2e422...ba3a7636f1bb8c02eaabbeff9a3731ad27a82c5d,1,2,1,3,2,2015-02-17 13:14:01,2015-02-15 00:51:43
ba3a7636f1bb8c02eaabbeff9a3731ad27a82c5d...a1fa0135ecb28911f31af4df994be26db59355e4,1,3,7,10,4,2015-02-17 13:24:36,2015-02-15 22:37:55
a1fa0135ecb28911f31af4df994be26db59355e4...e4df10668ce68ae71f33649f5d87e814f73d7bd4,1,2,0,2,1,2015-02-17 18:53:57,2015-02-17 18:53:20
e4df10668ce68ae71f33649f5d87e814f73d7bd4...ec9119d4ecda241342678b1fe7ae2beb26e1040f,1,1,1,2,1,2015-02-17 18:55:18,2015-02-17 18:54:18
ec9119d4ecda241342678b1fe7ae2beb26e1040f...f9a99c410e4ccc2ca89fc6006c48a23b02bae873,1,2,0,2,1,2015-02-17 23:45:07,2015-02-16 13:25:53
f9a99c410e4ccc2ca89fc6006c48a23b02bae873...09da1b465ea8ba9ecb99b1cd02a689bb831d0e1b,1,2,2,4,2,2015-02-17 23:50:15,2015-02-17 23:48:15
09da1b465ea8ba9ecb99b1cd02a689bb831d0e1b...2aa06e439a29a1c24fa03744395cc57787e7198e,9,31,23,54,20,2015-02-18 00:05:31,2015-02-15 00:47:07
2aa06e439a29a1c24fa03744395cc57787e7198e...1153bccc1bc654a547a310d0614b989606d25950,1,1,1,2,1,2015-02-18 12:35:56,2015-02-16 13:54:25
1153bccc1bc654a547a310d0614b989606d25950...5068a51d88a7084bd0349d150816fc6041caa224,1,14,0,14,5,2015-02-18 12:36:02,2015-02-16 14:30:05
5068a51d88a7084bd0349d150816fc6041caa224...4abadc4872d96c993b472eb23ae0b0a7d24fc3e5,2,0,7,7,4,2015-02-18 15:24:40,2015-02-17 16:35:46
4abadc4872d96c993b472eb23ae0b0a7d24fc3e5...84c9b24c5afba524c8dcb4bb5f7c40c43291d132,2,74,19,93,4,2015-02-18 18:11:51,2015-02-06 13:24:51
84c9b24c5afba524c8dcb4bb5f7c40c43291d132...e2a3be1e4d9a85aa30f1b7d9064b5abb1569eea6,1,9,6,15,3,2015-02-18 20:51:06,2015-02-18 20:44:31
e2a3be1e4d9a85aa30f1b7d9064b5abb1569eea6...66d37e593c8fa22be226b34b4fc1f60f85dcdc26,2,37,2,39,4,2015-02-19 00:44:08,2015-02-17 22:50:45
66d37e593c8fa22be226b34b4fc1f60f85dcdc26...84e7fec88ddfc4178500a80d640728226d77317a,2,6,2,8,3,2015-02-19 19:19:38,2015-02-18 09:09:33
84e7fec88ddfc4178500a80d640728226d77317a...cc4effba0bf07fbcb4dcc0074af969e698b6cc75,8,54,49,103,33,2015-02-19 21:10:56,2015-02-17 21:49:59
cc4effba0bf07fbcb4dcc0074af969e698b6cc75...82f39bfb1ac9a4e9c67cb26259bc689947f4c6d0,2,2,2,4,2,2015-02-20 00:37:22,2015-02-18 21:52:16
82f39bfb1ac9a4e9c67cb26259bc689947f4c6d0...c54d73ae01cd787315ba030da17e266c49f386b3,8,44,15,59,12,2015-02-20 11:46:57,2015-02-14 19:37:12
c54d73ae01cd787315ba030da17e266c49f386b3...3886338c1d6b79cdaf15c33459373185f8159dcd,19,44,46,90,43,2015-02-20 11:47:48,2015-02-20 10:53:59
3886338c1d6b79cdaf15c33459373185f8159dcd...b6ef67d752cab200028c39c31c602dd6696b69ce,2,21,1,22,3,2015-02-20 11:53:17,2015-02-20 11:33:02
b6ef67d752cab200028c39c31c602dd6696b69ce...18dceab05bda23933d1c3782738a4095fa3b3af8,8,8,8,16,8,2015-02-20 14:22:17,2015-02-20 14:20:38
18dceab05bda23933d1c3782738a4095fa3b3af8...564487601e34b9962ad16bc7e4e62c8b68928c84,1,89,0,89,1,2015-02-20 14:53:15,2015-02-04 16:29:08
564487601e34b9962ad16bc7e4e62c8b68928c84...3a6c37fce452a3bbf185b5e58dd3e7c89b456b19,26,223,119,342,90,2015-02-20 14:55:50,2015-02-19 07:27:58
3a6c37fce452a3bbf185b5e58dd3e7c89b456b19...6f03a4ca91ed22b2ea42d5159a1ed00f347cf9aa,5,105,104,209,31,2015-02-20 18:11:59,2015-02-16 07:49:19
6f03a4ca91ed22b2ea42d5159a1ed00f347cf9aa...5355baf6c770ac1e5c7f7a4f86ef95042f76b8b4,1,0,0,0,0,2015-02-20 18:16:42,2015-02-20 18:16:42
5355baf6c770ac1e5c7f7a4f86ef95042f76b8b4...88e6fbb2e341657cb5365b9b78fb44e3c7065d2d,1,1,0,1,1,2015-02-20 18:24:29,2015-02-20 18:24:29
88e6fbb2e341657cb5365b9b78fb44e3c7065d2d...e4e140c49b1bd3dc8ae11900a0089ec908483cf0,2,38,33,71,7,2015-02-20 21:28:24,2015-02-19 22:20:27
e4e140c49b1bd3dc8ae11900a0089ec908483cf0...3207fcd0a0b90e677b1bb5cf662dee21c659adab,2,128,7,135,12,2015-02-20 21:50:41,2015-02-19 21:19:33
3207fcd0a0b90e677b1bb5cf662dee21c659adab...5131aec7d22c1b54b4081080ae51402fc0b82f19,1,1,1,2,1,2015-02-21 01:11:58,2015-02-20 22:47:41
5131aec7d22c1b54b4081080ae51402fc0b82f19...1b73c764d4ec1c52e60855e97f96396a9e9e7e4c,2,2,3,5,3,2015-02-21 14:44:05,2015-02-21 14:44:02
1b73c764d4ec1c52e60855e97f96396a9e9e7e4c...850b2ca7945563d7ba8fc3a12c1bd368e440f4a5,1,0,0,0,0,2015-02-21 15:34:00,2015-02-21 15:32:32
850b2ca7945563d7ba8fc3a12c1bd368e440f4a5...5c02c75068704b1c51544dd331753619304b173d,1,0,12,12,1,2015-02-21 18:05:11,2015-02-21 12:56:12
5c02c75068704b1c51544dd331753619304b173d...de3bda9cd36ac86cc5906bcc524e8cdd11dbb77d,1,0,5,5,2,2015-02-21 18:07:42,2015-02-21 12:56:35
de3bda9cd36ac86cc5906bcc524e8cdd11dbb77d...82e323167d3f223e9eeda87857092d6c4c8fa026,6,8,23,31,7,2015-02-21 18:07:59,2015-02-05 20:56:59
82e323167d3f223e9eeda87857092d6c4c8fa026...481d3bd617d497506d5d4127f60583a03c00ee42,2,2,2,4,2,2015-02-21 18:08:15,2015-02-21 16:49:52
481d3bd617d497506d5d4127f60583a03c00ee42...1feeefe918e0f6ea6d633855549310dd149baed5,3,5,3,8,4,2015-02-21 19:26:47,2015-02-21 18:27:49
1feeefe918e0f6ea6d633855549310dd149baed5...f0780df608e2a8db487ac6e80d37d53d2912580d,14,65,65,130,65,2015-02-22 14:36:51,2015-02-19 03:19:21
f0780df608e2a8db487ac6e80d37d53d2912580d...c564033408e02306ab7b98c81696faedd733156a,2,17,6,23,5,2015-02-22 14:47:11,2015-02-22 14:40:04
c564033408e02306ab7b98c81696faedd733156a...fbddd946adf1ae0efc90f022df3c6f6d3b1abfa1,1,3,1,4,1,2015-02-22 15:12:15,2015-02-22 15:11:18
fbddd946adf1ae0efc90f022df3c6f6d3b1abfa1...576c1096d2689ea71132ddec6c9a84590c1da022,1,11,14,25,7,2015-02-22 17:29:39,2015-02-22 17:29:01
576c1096d2689ea71132ddec6c9a84590c1da022...ddc1e0c0fbd9b8b1851d47f2e535e8c2a5b941f6,4,24,17,41,17,2015-02-22 19:20:25,2015-02-22 14:59:56
ddc1e0c0fbd9b8b1851d47f2e535e8c2a5b941f6...19c2fe04a83fb03408a239e6553ffcbefde60346,3,10,8,18,7,2015-02-22 22:22:19,2015-02-22 18:14:05
19c2fe04a83fb03408a239e6553ffcbefde60346...ed941ef2d0c0560e4eb98e0801e698d18f01d77b,2,4,1,5,2,2015-02-23 05:04:57,2015-02-23 04:23:16
ed941ef2d0c0560e4eb98e0801e698d18f01d77b...980dfca7174a3e00a214ad554bb9199529139796,3,112,33,145,16,2015-02-23 11:55:43,2015-02-20 04:43:45
980dfca7174a3e00a214ad554bb9199529139796...155a127afbd531180eaa2fd875fe111178cfb64c,3,14,15,29,7,2015-02-23 12:26:10,2015-02-23 07:31:58
155a127afbd531180eaa2fd875fe111178cfb64c...ff2e0896a3f7b566c8a0802b2191d30c6070c8f6,4,38,0,38,3,2015-02-23 12:37:42,2015-02-22 01:56:51
ff2e0896a3f7b566c8a0802b2191d30c6070c8f6...04c262aea9b398c79e753ae75aa12b1520e99854,2,19,6,25,7,2015-02-23 12:46:00,2015-02-22 19:43:38
04c262aea9b398c79e753ae75aa12b1520e99854...41d5ed480cd55a71b739e779ca11f24caaa2b302,3,54,1,55,5,2015-02-23 14:01:00,2015-02-20 19:28:34
41d5ed480cd55a71b739e779ca11f24caaa2b302...a752a2c951d1836a8f58452b499974ff3742ee16,2,9,5,14,2,2015-02-23 14:23:49,2015-02-22 17:46:15
a752a2c951d1836a8f58452b499974ff3742ee16...fae31f234823474cd2b81efba56fa714cc34d9cd,11,21,20,41,18,2015-02-23 20:26:26,2015-02-21 17:56:36
fae31f234823474cd2b81efba56fa714cc34d9cd...e3953de9003c69f3b2485b7f8f56057a0cd4ef1f,6,31,36,67,20,2015-02-23 20:26:35,2015-02-21 18:18:54
e3953de9003c69f3b2485b7f8f56057a0cd4ef1f...3e0df285fd25884e262f0916215057f33b328958,1,5,5,10,5,2015-02-24 11:31:59,2015-02-24 02:19:06
3e0df285fd25884e262f0916215057f33b328958...210bf24ddbbd0ac7975507d7a2c8e3deeb5394b5,6,312,308,620,37,2015-02-24 13:59:05,2015-02-24 13:59:05
210bf24ddbbd0ac7975507d7a2c8e3deeb5394b5...cdb73ec8cd5b072388e2af562ff8d010a1f1d91f,2,33,36,69,6,2015-02-24 14:09:52,2015-02-21 19:10:21
cdb73ec8cd5b072388e2af562ff8d010a1f1d91f...272208c1249a780d9af86fdc4a7180f5f3c68491,2,131,146,277,3,2015-02-24 14:10:01,2015-02-21 19:11:20
272208c1249a780d9af86fdc4a7180f5f3c68491...c1bf9e47ec1ef1982f963ff21f226ba793e1f6dd,2,161,161,322,123,2015-02-24 14:17:45,2015-02-21 19:13:26
c1bf9e47ec1ef1982f963ff21f226ba793e1f6dd...d8114552a026078f4f4c1f506e52545d37987d14,2,74,68,142,16,2015-02-24 14:18:28,2015-02-21 19:15:22
d8114552a026078f4f4c1f506e52545d37987d14...f3a49c628eb8dc945c059f18cd7dbd2fa765f364,2,46,43,89,3,2015-02-24 14:21:54,2015-02-21 19:17:39
f3a49c628eb8dc945c059f18cd7dbd2fa765f364...e15292daa04110f59dcb7515221e22d576437bb2,2,35,28,63,3,2015-02-24 14:22:05,2015-02-21 19:19:08
e15292daa04110f59dcb7515221e22d576437bb2...2e7414cdf4712f72b9b87bc8ee3ff8bfc1bef677,2,11,9,20,4,2015-02-24 14:22:15,2015-02-21 19:20:20
2e7414cdf4712f72b9b87bc8ee3ff8bfc1bef677...b22d20dd182f5510d9fcf00395abb13be36ae339,1,15,13,28,7,2015-02-24 14:22:20,2015-02-23 21:26:55
b22d20dd182f5510d9fcf00395abb13be36ae339...450b42eafe46bd3df916f94c7274e0d6ae8ca029,2,3,7,10,6,2015-02-24 14:22:25,2015-02-23 21:30:05
450b42eafe46bd3df916f94c7274e0d6ae8ca029...a3fca05b05551fdd7089e7be49d48c454ea50a84,2,36,0,36,2,2015-02-24 16:49:27,2015-02-24 09:54:05
a3fca05b05551fdd7089e7be49d48c454ea50a84...81911f29b70710d8f72916c49a69aa5df5cd7df8,2,0,23,23,2,2015-02-24 16:51:10,2015-02-24 16:50:21
81911f29b70710d8f72916c49a69aa5df5cd7df8...278b6987943d0a610aadc767200651ec5d7d738e,2,32,7,39,7,2015-02-25 01:05:16,2015-02-23 03:06:41
278b6987943d0a610aadc767200651ec5d7d738e...dfcdf64d475418ed579da2621e331cc4d03a78e5,3,4,4,8,4,2015-02-25 13:07:25,2015-02-25 12:15:56
dfcdf64d475418ed579da2621e331cc4d03a78e5...3fff408a27d06c3d21a1c184cd6bd47f0785e279,1,1,1,2,1,2015-02-25 13:26:23,2015-02-25 13:26:23
3fff408a27d06c3d21a1c184cd6bd47f0785e279...b8f9fd75910acdcbd7f485c4acc55f98a612d86c,1,1,1,2,1,2015-02-25 13:29:14,2015-02-25 13:29:14
b8f9fd75910acdcbd7f485c4acc55f98a612d86c...a9ab8bd4dd4093b03cb5f372b7404ba40aa2fce1,1,1,1,2,1,2015-02-25 14:03:38,2015-02-25 13:47:11
a9ab8bd4dd4093b03cb5f372b7404ba40aa2fce1...31a1f96bd32b0f3066e334a206c6fe6b56a721d0,2,13,0,13,2,2015-02-25 14:11:43,2015-02-25 14:11:19
31a1f96bd32b0f3066e334a206c6fe6b56a721d0...9d6f0dce139b5dc9ee019f16623e12c6579b45e3,1,70,51,121,26,2015-02-27 18:51:29,2015-02-22 15:24:03
9d6f0dce139b5dc9ee019f16623e12c6579b45e3...b825ec38c1e16a271c69694562963eadbe0c6352,2,8,1,9,2,2015-02-27 19:25:12,2015-02-27 17:19:56
b825ec38c1e16a271c69694562963eadbe0c6352...5a3b59370c9da4232206dd38f84de458ade7d062,1,2,2,4,1,2015-02-27 22:54:27,2015-02-27 21:56:38
5a3b59370c9da4232206dd38f84de458ade7d062...c0df8d1be9890a7914c7942defbce636573a434e,2,18,5,23,2,2015-02-28 09:09:01,2015-02-27 19:17:04
c0df8d1be9890a7914c7942defbce636573a434e...761b97c344148e2a8e0145b32a026b8e9a48994e,1,2,2,4,1,2015-03-02 13:23:52,2015-02-27 15:31:14
761b97c344148e2a8e0145b32a026b8e9a48994e...ed2575855679c2eb7f3168f67ea99d9594160eb5,1,9,3,12,3,2015-03-02 17:37:07,2015-02-07 21:32:31
ed2575855679c2eb7f3168f67ea99d9594160eb5...ac6bc2c09072515abd70b4e3898d15cd266bc8d9,1,0,4,4,4,2015-03-02 18:33:42,2015-03-02 18:18:48
ac6bc2c09072515abd70b4e3898d15cd266bc8d9...cc525e31bba1951a81eae3d2bf8625eeb14eb0a1,1,18,3,21,3,2015-03-02 23:45:27,2015-02-28 21:53:06
cc525e31bba1951a81eae3d2bf8625eeb14eb0a1...72539a5f29d9b9e5083c909d3938de823eb572c0,1,12,0,12,1,2015-03-03 00:57:12,2015-02-25 18:57:47
72539a5f29d9b9e5083c909d3938de823eb572c0...44dd65fb2ca8c008a4ca83cd8fdb2d14004f2543,1,0,1,1,1,2015-03-03 12:47:32,2015-03-03 09:30:12
44dd65fb2ca8c008a4ca83cd8fdb2d14004f2543...bff446c205e0c4d436a5147906397ab7534343f3,2,25,2,27,4,2015-03-04 14:44:38,2015-03-04 08:36:53
bff446c205e0c4d436a5147906397ab7534343f3...4fa61e0e4f35f407f7e62a32ee7729a458ec545d,1,2,6,8,2,2015-03-04 15:44:44,2015-03-04 15:26:04
4fa61e0e4f35f407f7e62a32ee7729a458ec545d...20bf3205027fe581b8f33cd98b164f16a801c813,2,2,1,3,2,2015-03-04 18:56:51,2015-03-04 17:00:12
20bf3205027fe581b8f33cd98b164f16a801c813...3bc35f7e08cd1752722a37c70c295d373e7214a8,1,12,11,23,5,2015-03-04 21:31:27,2015-03-04 19:24:30
3bc35f7e08cd1752722a37c70c295d373e7214a8...2bef57f3fb523d67ddf2d0d2db0180a21c9fd989,1,5,3,8,1,2015-03-05 15:00:05,2015-03-05 14:13:56
2bef57f3fb523d67ddf2d0d2db0180a21c9fd989...bd7c879d5a0daeaa58f2a32901db6e8d8ed5212d,1,2,2,4,1,2015-03-05 17:18:13,2015-03-05 12:09:08
bd7c879d5a0daeaa58f2a32901db6e8d8ed5212d...823f8cdbc91f85a8ab3cb1ccfec5659037b5c148,3,47,0,47,3,2015-03-06 02:31:43,2015-03-05 06:10:48
823f8cdbc91f85a8ab3cb1ccfec5659037b5c148...ac07890f959c467b3fc9c6dd6d36aafc2eff1fcc,2,15,7,22,4,2015-03-06 21:22:51,2015-03-06 20:56:11
ac07890f959c467b3fc9c6dd6d36aafc2eff1fcc...1ae2df6bfc3afadd7edb29a5887711f70cdb52c6,3,47,4,51,3,2015-03-07 13:15:27,2015-03-05 12:41:15
1ae2df6bfc3afadd7edb29a5887711f70cdb52c6...311b880fa96ecafb4d52417505548e4a5822cc96,1,3,0,3,2,2015-03-07 15:40:17,2015-02-21 20:09:30
311b880fa96ecafb4d52417505548e4a5822cc96...930fc4db7b8c4f7eeca5ce55fb7b7f8529b5a52a,1,69,9,78,4,2015-03-08 19:40:33,2015-03-08 18:37:22
930fc4db7b8c4f7eeca5ce55fb7b7f8529b5a52a...83269b2935fd0223def49626c2a8dcea821e93c3,1,1,1,2,1,2015-03-09 11:06:32,2015-03-09 11:05:49
83269b2935fd0223def49626c2a8dcea821e93c3...3a0fe942ddf56ddcf4b958147f3914fe2788db30,4,48,9,57,12,2015-03-09 11:51:05,2015-03-04 12:56:20
3a0fe942ddf56ddcf4b958147f3914fe2788db30...d16e4e1d6f95e6f46bff53cc4fd0ab398b8e5059,10,174,24,198,29,2015-03-09 13:31:07,2015-03-08 11:34:55
d16e4e1d6f95e6f46bff53cc4fd0ab398b8e5059...980d604bf237b0e09a1c7754b74d1bb2bfed0b35,1,2,2,4,1,2015-03-09 14:11:44,2015-03-09 14:06:18
980d604bf237b0e09a1c7754b74d1bb2bfed0b35...35d68e8e766217924375e1a91533fee50159291c,4,33,3,36,5,2015-03-09 14:15:12,2015-03-08 10:50:32
35d68e8e766217924375e1a91533fee50159291c...449d1effb81152e54f482784cf7febe965007096,1,1,1,2,1,2015-03-09 14:22:51,2015-03-09 14:22:51
449d1effb81152e54f482784cf7febe965007096...ffa4ff5e8cda9f6653915d435ab4381723e8112a,2,13,0,13,2,2015-03-09 17:10:09,2015-03-09 17:09:39
ffa4ff5e8cda9f6653915d435ab4381723e8112a...9853844ed3d3d25954205ce1b53962b57fef3d5e,1,13,1,14,2,2015-03-10 00:46:26,2015-03-07 17:45:57
9853844ed3d3d25954205ce1b53962b57fef3d5e...b25e542ecde4982602a96747fef581b79fceede7,1,40,35,75,27,2015-03-10 00:53:05,2015-03-07 14:15:21
b25e542ecde4982602a96747fef581b79fceede7...6e81786f924c6afdaf044ab8b41dd14695aada9f,1,1,1,2,1,2015-03-10 11:12:39,2015-03-10 09:10:24
6e81786f924c6afdaf044ab8b41dd14695aada9f...846a970106de41b65dac2fd420055173877255c7,3,2555,174,2729,66,2015-03-10 12:15:40,2015-03-07 10:40:30
846a970106de41b65dac2fd420055173877255c7...e2816f1ff9640a1039d0ba46e2b3aaa5406c8805,3,7,11,18,5,2015-03-10 17:01:29,2015-03-10 16:59:27
e2816f1ff9640a1039d0ba46e2b3aaa5406c8805...12e199356e1cfe74dd7d874a2d3fdc16a21a60d8,1,3,3,6,3,2015-03-10 18:44:27,2015-03-10 18:42:38
12e199356e1cfe74dd7d874a2d3fdc16a21a60d8...aba74d6f1e221c10be2798f55971d710521cb404,3,11,11,22,7,2015-03-10 23:12:20,2015-03-10 22:40:33
aba74d6f1e221c10be2798f55971d710521cb404...2982143dac244b5d9b49bf65380394f9c6866dd9,1,1,1,2,1,2015-03-11 16:36:08,2015-03-11 16:03:57
2982143dac244b5d9b49bf65380394f9c6866dd9...e0e2df412f530d186e35016d0a920a03b508ddd1,1,23,3,26,3,2015-03-11 16:39:50,2015-03-10 05:17:33
e0e2df412f530d186e35016d0a920a03b508ddd1...9f397155094a9ae7911f45beb36befd02480a738,1,1,1,2,1,2015-03-11 23:58:14,2015-03-11 23:21:08
9f397155094a9ae7911f45beb36befd02480a738...def39428bff977d862c0c3b36a84c870b2f14908,1,2,2,4,1,2015-03-12 12:49:07,2015-03-12 02:43:56
def39428bff977d862c0c3b36a84c870b2f14908...fee18ce415cd817c20f64009600b0c7158353974,2,7,0,7,2,2015-03-12 13:23:57,2015-03-12 11:19:42
fee18ce415cd817c20f64009600b0c7158353974...e1657cc37fdf6ecd6bee46d82c95ef67fe147e87,1,1,1,2,1,2015-03-12 23:16:22,2015-03-12 22:56:38
e1657cc37fdf6ecd6bee46d82c95ef67fe147e87...77564c6f5a82e0a02b663583364fe0a91bee2790,1,8,0,8,1,2015-03-13 00:09:56,2015-02-07 21:13:07
77564c6f5a82e0a02b663583364fe0a91bee2790...606e436a37b8bcf486ad2ddaa2afba5015deb070,1,1,1,2,1,2015-03-13 12:14:30,2015-03-13 06:38:27
606e436a37b8bcf486ad2ddaa2afba5015deb070...06085024f6401e8a55e1e43b301125175e4a7de3,1,2,1,3,1,2015-03-13 12:26:28,2015-03-13 06:47:26
06085024f6401e8a55e1e43b301125175e4a7de3...6f555e54f727f49ac1f4982b6e6126f3238746e4,1,5,0,5,1,2015-03-13 12:51:24,2015-03-13 12:48:39
6f555e54f727f49ac1f4982b6e6126f3238746e4...f1156945479021410a26067be8f486defc79e19b,1,8,3,11,3,2015-03-13 15:41:37,2015-03-12 17:12:11
f1156945479021410a26067be8f486defc79e19b...8fe451d183fbcd298d4da659af31dfe341e2252f,1,1,1,2,1,2015-03-13 15:57:37,2015-03-13 14:58:20
8fe451d183fbcd298d4da659af31dfe341e2252f...937c8a5a14c08aa3991a5774dae8db60b611dbac,1,27,0,27,1,2015-03-13 17:24:18,2015-02-04 17:22:06
937c8a5a14c08aa3991a5774dae8db60b611dbac...5b91802718b61346967e7991cf3585554c4c97fa,1,5,0,5,1,2015-03-13 19:42:03,2015-03-13 19:40:25
5b91802718b61346967e7991cf3585554c4c97fa...bd36f2d43264c76e67192ad6ce28002cd4138106,5,6,6,12,5,2015-03-14 16:29:27,2015-03-07 16:34:33
bd36f2d43264c76e67192ad6ce28002cd4138106...da8b3aa7eb174959aeec9acbf86c6728ec99fa21,3,6,6,12,5,2015-03-14 19:20:53,2015-03-14 18:35:50
da8b3aa7eb174959aeec9acbf86c6728ec99fa21...22a67d22e98c86fe4b1665c97ace6f4251a99cac,2,38,1,39,2,2015-03-14 19:47:10,2015-02-16 19:42:11
22a67d22e98c86fe4b1665c97ace6f4251a99cac...f2db113f51fe13cecd52bd3a9b7484bfeb3bd608,1,1,1,2,1,2015-03-16 12:17:01,2015-03-16 06:05:43
f2db113f51fe13cecd52bd3a9b7484bfeb3bd608...6dcbfc0700954ece013f1d12d83caeb908056e37,1,4,4,8,4,2015-03-16 12:24:58,2015-03-15 14:51:24
6dcbfc0700954ece013f1d12d83caeb908056e37...63b998a6534d24a80082b05a321d1748aedde267,1,2,2,4,2,2015-03-16 13:39:41,2015-03-15 09:05:54
63b998a6534d24a80082b05a321d1748aedde267...09062e9509c56088793776bfda9db056c797552e,1,11,0,11,1,2015-03-16 15:56:09,2015-03-16 05:11:03
09062e9509c56088793776bfda9db056c797552e...ff71d6b8de97f21208cf41cadb7fbe0bf7134bf3,1,5,0,5,1,2015-03-16 17:13:47,2015-03-16 15:55:43
ff71d6b8de97f21208cf41cadb7fbe0bf7134bf3...febcbbf89d978b60ffe13ab839dcc98639c3f522,2,10,1,11,2,2015-03-16 17:31:22,2015-03-15 22:54:20
febcbbf89d978b60ffe13ab839dcc98639c3f522...e150bbd4d65b4b2c3897bdabdda94eba508747a2,3,62,4,66,3,2015-03-16 23:45:55,2015-03-02 22:13:14
e150bbd4d65b4b2c3897bdabdda94eba508747a2...34e09e532da41d56d3ba68babd05c4fd848abaa2,2,15,5,20,3,2015-03-17 12:36:15,2015-03-16 04:51:23
34e09e532da41d56d3ba68babd05c4fd848abaa2...a0cebe82b532672d9e293c058f76711d2fcc6863,6,32,32,64,30,2015-03-17 12:40:45,2015-03-17 00:38:55
a0cebe82b532672d9e293c058f76711d2fcc6863...717bbd473c888172daed541b51f33c1297bb47cb,1,2,2,4,2,2015-03-17 15:35:41,2015-03-17 15:35:11
717bbd473c888172daed541b51f33c1297bb47cb...ddb95d6d53985877881647cfe9b7f0d618b9dd74,1,16,0,16,1,2015-03-17 17:42:54,2015-03-17 17:41:11
ddb95d6d53985877881647cfe9b7f0d618b9dd74...0c92913bb02878a528a8abe095e409b705ad7daf,5,17,19,36,12,2015-03-17 22:35:51,2015-03-17 22:34:15
0c92913bb02878a528a8abe095e409b705ad7daf...4cc501205d7548fa109504f31a83bc2f1c3eccec,1,6,6,12,1,2015-03-18 00:04:30,2015-03-18 00:03:07
4cc501205d7548fa109504f31a83bc2f1c3eccec...1bb712d79c8d023cee6e16a198662cb9a224d854,170,0,2237,2237,85,2015-03-18 08:28:28,2015-03-18 08:14:52
1bb712d79c8d023cee6e16a198662cb9a224d854...1cd2584c980ca547ba34d7b0f9d2dc89569803fb,5,121,89,210,79,2015-03-18 08:29:12,2015-03-18 08:18:50
1cd2584c980ca547ba34d7b0f9d2dc89569803fb...571e093a258b00b25c24481af7acf0d0a034ec8c,5,37,1,38,8,2015-03-18 13:11:44,2015-03-10 20:21:28
571e093a258b00b25c24481af7acf0d0a034ec8c...247251c2e1702831b7ab80a69a3f7f5831be3b96,1,7,0,7,1,2015-03-18 17:56:33,2015-03-18 12:23:46
247251c2e1702831b7ab80a69a3f7f5831be3b96...a8c53041f9645df9bfa744027efb2a36867422d8,10,136,5,141,16,2015-03-18 23:12:46,2015-03-16 19:28:53
a8c53041f9645df9bfa744027efb2a36867422d8...5a8ef2a3cf0c370e35c0b891ab97f3a17ac255d4,4,18,2,20,6,2015-03-18 23:23:21,2015-03-04 12:49:12
5a8ef2a3cf0c370e35c0b891ab97f3a17ac255d4...5447709a571cd5d95971f1d5d21d4a7edcf85bbd,4,41,2,43,4,2015-03-18 23:23:21,2015-03-04 13:11:25
5447709a571cd5d95971f1d5d21d4a7edcf85bbd...770427c2896a078925abfca2317486b284d22f04,5,68,2,70,8,2015-03-18 23:23:21,2015-03-10 00:05:13
770427c2896a078925abfca2317486b284d22f04...e3c9412d86c3c394e2604e63f3b51c102ae3e3d7,1,1,1,2,1,2015-03-18 23:23:22,2015-03-18 13:06:26
39d95fb6ada99c59d47fa0eae6d3128abafe2d58...3f23f1cfb472e77bb1f9260a71b40f895438658d,1,1,1,2,1,2015-01-16 22:04:35,2015-01-16 22:04:35
3f23f1cfb472e77bb1f9260a71b40f895438658d...3fe3bddc2895e4bd1f968a962da36748160f4dae,2,293,0,293,2,2015-01-16 23:00:45,2015-01-16 23:00:45
3fe3bddc2895e4bd1f968a962da36748160f4dae...996292d6498d25c6b3e84435e82edeff5aaa0257,1,1,1,2,1,2015-01-16 23:17:00,2015-01-16 22:50:37
996292d6498d25c6b3e84435e82edeff5aaa0257...d9edd2f68f6edaa5e634a7d93b29fe97cb7312fe,1,2,2,4,2,2015-01-16 23:24:10,2015-01-16 23:24:10
d9edd2f68f6edaa5e634a7d93b29fe97cb7312fe...d4689034becf3bc519dbddd22f702406c5cbe5b1,1,2,2,4,2,2015-01-16 23:30:28,2015-01-16 23:29:47
d4689034becf3bc519dbddd22f702406c5cbe5b1...c51258882bbf388f5c4cfc379340097ebe9beda9,3,8,5,13,5,2015-01-17 00:27:10,2015-01-17 00:27:10
c51258882bbf388f5c4cfc379340097ebe9beda9...d60b96d98881b47c845125e82269ea6a9b268fbb,1,1,1,2,1,2015-01-17 02:05:28,2015-01-17 01:47:06
d60b96d98881b47c845125e82269ea6a9b268fbb...d69ecf922ddf6d4e3698e0dfd42d9ae387df182c,1,9,2,11,2,2015-01-17 09:01:55,2015-01-17 09:01:17
d69ecf922ddf6d4e3698e0dfd42d9ae387df182c...53e1423eda369acb1882d6939a7f9e11617e5591,13,627,499,1126,444,2015-01-17 10:19:37,2015-01-17 10:18:45
53e1423eda369acb1882d6939a7f9e11617e5591...428c884083d8e60025ba1d2fa97de438c57c9d48,1,4,4,8,3,2015-01-17 11:41:18,2015-01-17 11:41:18
428c884083d8e60025ba1d2fa97de438c57c9d48...1c8b637ed97927c90a0f0056aa7b30bfe361c16b,3,2,571,573,3,2015-01-17 12:13:51,2014-11-18 16:18:14
1c8b637ed97927c90a0f0056aa7b30bfe361c16b...ce78b954cf2747add06dadd6aef8bbd70d70c667,2,1,48,49,2,2015-01-17 12:14:21,2014-11-18 16:19:39
ce78b954cf2747add06dadd6aef8bbd70d70c667...b952c3fc606ed01c6d0ff26451b6e2acf1b91ca5,4,2,29,31,4,2015-01-17 12:32:22,2014-11-18 16:22:55
b952c3fc606ed01c6d0ff26451b6e2acf1b91ca5...d79a30ba3f991bc3150fa1260fab1c10f5d3450a,1,1,8,9,1,2015-01-17 12:39:46,2014-11-18 16:27:38
d79a30ba3f991bc3150fa1260fab1c10f5d3450a...9ce36512fa925231b0496cc10f7d114c069c7c06,5,0,41,41,7,2015-01-17 12:40:12,2014-11-18 16:42:08
9ce36512fa925231b0496cc10f7d114c069c7c06...61ad1ea92b1f4df992b0ef1dcc7c781da2413815,3,1,47,48,8,2015-01-17 12:55:32,2014-11-24 13:36:10
61ad1ea92b1f4df992b0ef1dcc7c781da2413815...75f107b8842dfc890ddd65262bd09ca87c3a15be,6,6,74,80,23,2015-01-17 13:05:18,2014-11-18 16:57:05
75f107b8842dfc890ddd65262bd09ca87c3a15be...37b7776a015102e97b9bdd64d88c732883ff9989,4,8,202,210,11,2015-01-17 13:13:36,2014-11-18 17:09:20
37b7776a015102e97b9bdd64d88c732883ff9989...41f0d3d3bc8b0a6831530e1176c6415f9ba45b0b,18,13,883,896,22,2015-01-17 13:32:31,2014-11-19 17:21:49
41f0d3d3bc8b0a6831530e1176c6415f9ba45b0b...c820892eed9ea10879270e64e8109dc44829756a,6,6,287,293,11,2015-01-17 13:40:23,2014-11-19 17:22:23
c820892eed9ea10879270e64e8109dc44829756a...d4ee6cda5802adc5a38d266ccebe78fb67066179,1,0,30,30,2,2015-01-17 13:40:33,2014-11-19 17:25:36
d4ee6cda5802adc5a38d266ccebe78fb67066179...4e65f195e1b10d83bb7edc38c908747c4fd537b8,1,0,40,40,1,2015-01-17 13:40:59,2014-12-26 16:35:02
4e65f195e1b10d83bb7edc38c908747c4fd537b8...fed25f1105ff0d5fe46cd217b29371ee7f1907f2,12,17,44,61,16,2015-01-17 14:00:17,2014-11-24 13:34:02
fed25f1105ff0d5fe46cd217b29371ee7f1907f2...f4f24d30e044b5bc2014b8356058099808c22c1a,6,9,143,152,15,2015-01-17 14:07:00,2014-12-26 16:19:43
f4f24d30e044b5bc2014b8356058099808c22c1a...f6463bb38047bac7a62826ca901e3c5add40cb10,12,14,89,103,17,2015-01-17 14:20:12,2014-12-26 17:34:26
f6463bb38047bac7a62826ca901e3c5add40cb10...25264d4e2a4b3fd6a25e6b617388ea24f3d48d63,1,8,1,9,2,2015-01-17 14:30:52,2015-01-17 14:30:52
25264d4e2a4b3fd6a25e6b617388ea24f3d48d63...1b0365ad34151f266fe3faecb4edf31a51a8642c,3,0,232,232,3,2015-01-17 14:32:33,2014-11-18 16:21:21
1b0365ad34151f266fe3faecb4edf31a51a8642c...aff0e54d511f55dbcdbae6a79c237fbb3edc9973,3,20,1,21,3,2015-01-17 14:44:49,2015-01-17 14:43:02
aff0e54d511f55dbcdbae6a79c237fbb3edc9973...d038c547b5ce585cbf9ef5bb7e5298f52e4a243b,4,6,80,86,12,2015-01-17 14:55:18,2014-12-26 16:46:48
d038c547b5ce585cbf9ef5bb7e5298f52e4a243b...f635d759354842e46901ed1ae1be5f5a0b81e567,3,1,270,271,9,2015-01-17 14:55:18,2014-12-26 17:45:40
f635d759354842e46901ed1ae1be5f5a0b81e567...67235fd4ef1b006fc9cdb2fa20e7bb93b0edff4b,21,22,241,263,47,2015-01-17 14:59:25,2014-12-26 18:23:38
67235fd4ef1b006fc9cdb2fa20e7bb93b0edff4b...a420f83e7d2e446ca01ef7c13d30c2ef3e975e5c,9,42,2,44,14,2015-01-17 15:09:10,2014-12-27 07:16:53
a420f83e7d2e446ca01ef7c13d30c2ef3e975e5c...4aa089a9a9504c4a833eee8161be013206da5d15,26,10,368,378,42,2015-01-17 15:16:06,2014-12-26 18:56:08
4aa089a9a9504c4a833eee8161be013206da5d15...b845951fd41cf6a380b3e09eeb30f7d105c37061,3,7,34,41,10,2015-01-17 15:20:30,2014-12-26 19:48:44
b845951fd41cf6a380b3e09eeb30f7d105c37061...f0a1df0b0139a7f5a576dff966210b5d52247650,13,12,2913,2925,21,2015-01-17 16:23:43,2015-01-09 20:08:16
f0a1df0b0139a7f5a576dff966210b5d52247650...00a11994a57312687b9e104d2de370b139a28358,2,3,36,39,2,2015-01-17 17:34:34,2015-01-17 17:32:20
00a11994a57312687b9e104d2de370b139a28358...df3f3bbe2927b9bad80088c6adbf5e8c5ba778c9,2,1,62,63,6,2015-01-17 17:41:49,2015-01-17 17:41:49
df3f3bbe2927b9bad80088c6adbf5e8c5ba778c9...18192b9fa4387d5e6c677a7929d91ce04f92cda7,1,6,8,14,2,2015-01-17 17:51:50,2015-01-17 17:49:16
18192b9fa4387d5e6c677a7929d91ce04f92cda7...4a03d348c70caa3e21393e08e6e665ef752202ac,4,4,75,79,7,2015-01-17 17:59:07,2015-01-17 17:59:07
4a03d348c70caa3e21393e08e6e665ef752202ac...e278407b20af0fd957fc3f39244a991c7520f2ba,2,2,5,7,5,2015-01-17 18:22:52,2015-01-17 18:22:52
e278407b20af0fd957fc3f39244a991c7520f2ba...bd93032191f96bc7086aa46b91b4177601c6fce9,2,4,24,28,5,2015-01-17 18:29:52,2015-01-17 18:29:52
bd93032191f96bc7086aa46b91b4177601c6fce9...4b8d3bbab58ee99404fc84091fcca566552322ea,1,72,76,148,26,2015-01-17 18:38:01,2015-01-17 18:38:01
4b8d3bbab58ee99404fc84091fcca566552322ea...2788c46d46bc4d7afb906765ce1f484faef180c5,1,6,24,30,6,2015-01-17 18:48:46,2015-01-17 18:48:46
2788c46d46bc4d7afb906765ce1f484faef180c5...65d55c409343aab7c2ae771c459720ef797b4cdb,1,61,69,130,13,2015-01-17 19:29:50,2015-01-16 23:51:31
65d55c409343aab7c2ae771c459720ef797b4cdb...c2d5f2903cfaef4f8b17d86f4db706b61073a471,4,2,109,111,8,2015-01-17 19:40:22,2015-01-17 19:14:15
c2d5f2903cfaef4f8b17d86f4db706b61073a471...2b4ca2ec295503472d488bb75548f0a576eb6aaf,1,0,2,2,2,2015-01-17 19:42:51,2015-01-17 19:42:51
2b4ca2ec295503472d488bb75548f0a576eb6aaf...e1b93dbbef6afb86cf17be7f260f7b05ab7579e2,1,0,26,26,3,2015-01-17 19:57:34,2015-01-17 19:57:34
e1b93dbbef6afb86cf17be7f260f7b05ab7579e2...3b570dbcdb605cc6ee7e8796e1533fdd40c92362,2,1,61,62,4,2015-01-17 19:58:09,2015-01-17 19:58:09
3b570dbcdb605cc6ee7e8796e1533fdd40c92362...2c9e95639e5a353f9fe1b81ecd3fdc5e2212781e,3,3,119,122,7,2015-01-17 23:02:35,2015-01-17 23:02:35
2c9e95639e5a353f9fe1b81ecd3fdc5e2212781e...714277cb4cedd8290101f9c6b3e6382f192ae177,3,2,40,42,6,2015-01-17 23:49:44,2015-01-17 23:49:44
714277cb4cedd8290101f9c6b3e6382f192ae177...0622bca5d1b25877167b7beda96edcd3ba58db8d,6,6,35,41,8,2015-01-18 00:12:03,2015-01-18 00:00:12
0622bca5d1b25877167b7beda96edcd3ba58db8d...20e4e8fc79af9a87fb48951d03d3747f1f550551,2,4,0,4,2,2015-01-18 00:14:44,2015-01-18 00:14:44
20e4e8fc79af9a87fb48951d03d3747f1f550551...40d6b376d4ac29c1f271bb827cd9ca24860ce4b5,1,1,8,9,2,2015-01-18 00:32:54,2015-01-18 00:32:54
40d6b376d4ac29c1f271bb827cd9ca24860ce4b5...8d959f73bed135c1253c0d957355b60fce4091e9,1,4,11,15,1,2015-01-18 00:41:46,2015-01-18 00:41:46
8d959f73bed135c1253c0d957355b60fce4091e9...1d975ff44bc23efaf0ebf3e96cc35539d80bd244,2,6,5,11,4,2015-01-18 01:14:45,2015-01-18 01:14:45
1d975ff44bc23efaf0ebf3e96cc35539d80bd244...c3336e7e4f146fc62272d462288a00f8d78c1f83,5,4,45,49,14,2015-01-18 01:18:34,2015-01-18 01:18:34
c3336e7e4f146fc62272d462288a00f8d78c1f83...d029fafea1a1f2f257397fbcd0fa3b531e09854f,4,4,70,74,12,2015-01-18 17:51:15,2015-01-18 02:04:07
d029fafea1a1f2f257397fbcd0fa3b531e09854f...3b89d2d540a96ffd33c294b576147ff800b16632,2,0,46,46,7,2015-01-18 18:11:31,2015-01-18 18:11:31
3b89d2d540a96ffd33c294b576147ff800b16632...ba27f895878bb155fefb8c1b9beee2c9f3d85b3f,3,18,5,23,6,2015-01-18 18:33:19,2015-01-18 18:29:33
ba27f895878bb155fefb8c1b9beee2c9f3d85b3f...4548a282a1c64bb2ed414da3d08617d869cd3740,2,0,30,30,6,2015-01-18 18:36:32,2015-01-18 18:36:32
4548a282a1c64bb2ed414da3d08617d869cd3740...2cd00424c4a14b04973629d9f027df5281806e15,2,1,19,20,5,2015-01-18 19:01:25,2015-01-18 18:53:36
2cd00424c4a14b04973629d9f027df5281806e15...7468c948b6e7830082c939e0f43e2bd780c90527,2,3,1,4,2,2015-01-18 19:18:53,2015-01-18 19:17:31
7468c948b6e7830082c939e0f43e2bd780c90527...5fb582d952673067046de0d0ddf37b45675655db,1,0,12,12,3,2015-01-18 19:19:14,2015-01-18 19:18:07
5fb582d952673067046de0d0ddf37b45675655db...67a76500a56d6dbe970126e142e02254dad7dbf3,8,4,927,931,23,2015-01-18 19:43:21,2015-01-18 19:43:21
67a76500a56d6dbe970126e142e02254dad7dbf3...0f169098efd099fd7ae13bd8e14b798530d74da7,2,0,17,17,2,2015-01-18 19:49:51,2015-01-18 19:49:51
0f169098efd099fd7ae13bd8e14b798530d74da7...40f122c8f5195352c280440e350eb64770886282,4,104,81,185,4,2015-01-18 20:02:54,2015-01-18 19:58:16
40f122c8f5195352c280440e350eb64770886282...9704b0a82e1f1c6ed0118f948a56652594f0a43b,1,0,41,41,3,2015-01-18 20:55:01,2015-01-18 20:55:01
9704b0a82e1f1c6ed0118f948a56652594f0a43b...7e8cf74dc74539f40f4cea53c1e8bba82791fcb6,31,29,626,655,48,2015-01-18 20:58:06,2014-12-26 18:56:08
7e8cf74dc74539f40f4cea53c1e8bba82791fcb6...2b039d966f6e61a5ffb5ffac25aa198f9043de3d,12,2,573,575,22,2015-01-18 20:58:06,2014-12-30 16:39:30
2b039d966f6e61a5ffb5ffac25aa198f9043de3d...89e9f81601f7a343690e1153e70fd56091246d0b,2,7,1,8,2,2015-01-18 21:06:56,2015-01-18 21:06:56
89e9f81601f7a343690e1153e70fd56091246d0b...bd98926f0eb19d27821a8a7679b42ff46e53e4da,1,0,3,3,1,2015-01-18 21:30:45,2015-01-18 21:30:45
bd98926f0eb19d27821a8a7679b42ff46e53e4da...6e13c0490d67cdf210411f08feca3b78a49645ea,8,69,159,228,58,2015-01-18 22:43:06,2015-01-18 21:43:57
6e13c0490d67cdf210411f08feca3b78a49645ea...cf5b67d3a053831ce5a3ef24acb7059fc1f29469,1,1,112,113,5,2015-01-18 23:07:41,2015-01-18 23:07:41
cf5b67d3a053831ce5a3ef24acb7059fc1f29469...b84100e8e22b175b62ce849acbcf1fa9a1e0e5b8,1,4,6,10,3,2015-01-18 23:32:47,2015-01-18 23:32:47
b84100e8e22b175b62ce849acbcf1fa9a1e0e5b8...2fa2068406cbef08bac3e2da9b69e86c6b931f57,2,2,2,4,2,2015-01-19 01:02:15,2015-01-19 01:02:15
2fa2068406cbef08bac3e2da9b69e86c6b931f57...69c6a6868f0b4137bb293ff4326ecf4681506c37,2,24,2,26,2,2015-01-19 01:51:27,2015-01-18 23:35:10
69c6a6868f0b4137bb293ff4326ecf4681506c37...ecf109f2159f4581adb354263406116c2bda11d7,2,17,7,24,6,2015-01-19 02:23:06,2015-01-19 02:23:06
ecf109f2159f4581adb354263406116c2bda11d7...840f2bfae685b5f01f8ba747d0f64f6e8711b2ac,1,12,8,20,5,2015-01-19 02:57:38,2015-01-19 02:57:38
840f2bfae685b5f01f8ba747d0f64f6e8711b2ac...eb6e12ca6f7a5d5ec1d6093657b887a06e75f5d8,1,7,10,17,5,2015-01-19 09:19:04,2015-01-19 09:18:29
eb6e12ca6f7a5d5ec1d6093657b887a06e75f5d8...4a5512a61d36e5923ae7de9f61bec042bc8b2d21,1,1,1,2,1,2015-01-19 11:26:00,2015-01-19 09:56:08
4a5512a61d36e5923ae7de9f61bec042bc8b2d21...8e435a564034c59ac408ec71283d8ac6ede2ce1f,2,10,0,10,2,2015-01-19 14:42:26,2015-01-18 19:30:07
8e435a564034c59ac408ec71283d8ac6ede2ce1f...5792e6a88c1444d4ec84abe62077338ad3765b80,4,128,15,143,8,2015-01-19 15:52:26,2015-01-19 14:31:23
5792e6a88c1444d4ec84abe62077338ad3765b80...5008a4db440c8f7d108a6979b959025ffb5789ba,3,8,255,263,14,2015-01-19 16:11:30,2015-01-18 19:29:09
5008a4db440c8f7d108a6979b959025ffb5789ba...33457cd3b0da69320d3f66bb6d5a673950c5032f,25,117,161,278,42,2015-01-19 16:12:57,2015-01-18 01:42:41
33457cd3b0da69320d3f66bb6d5a673950c5032f...378a0d27d630386c1b0a53d4a2d48be767453198,3,6,7,13,8,2015-01-19 17:22:41,2015-01-19 17:22:41
378a0d27d630386c1b0a53d4a2d48be767453198...f6019312ba90b4a4c166bea25a36073e8be2016e,1,10,0,10,1,2015-01-19 18:08:24,2015-01-19 18:08:08
f6019312ba90b4a4c166bea25a36073e8be2016e...b19b81b3960ec2090d40be65547502a3386a769b,2,5,3,8,5,2015-01-19 20:12:57,2015-01-19 20:12:57
b19b81b3960ec2090d40be65547502a3386a769b...beed786b81dd470901bc5efe0f8077a796419417,1,1,1,2,1,2015-01-19 20:42:44,2015-01-19 20:11:11
beed786b81dd470901bc5efe0f8077a796419417...bd691f4586c8ad45bd059ff9d3621cbf8afdcdce,2,13,5,18,5,2015-01-20 00:07:34,2015-01-18 21:53:18
bd691f4586c8ad45bd059ff9d3621cbf8afdcdce...7f20041bca43ca33f0a9617793f2af7ab07c3fab,2,37,7,44,10,2015-01-20 00:24:41,2015-01-16 23:55:41
7f20041bca43ca33f0a9617793f2af7ab07c3fab...61c102d010ef480cebe576cc1576d1101975925c,2,14,2,16,3,2015-01-20 01:09:15,2015-01-20 00:47:13
61c102d010ef480cebe576cc1576d1101975925c...0ae94d0d3127adabcb0afaf32fd5dbe47d74cd57,2,26,2,28,2,2015-01-20 09:52:23,2015-01-20 09:52:23
0ae94d0d3127adabcb0afaf32fd5dbe47d74cd57...be1357e70983d4ad029a1ecdd05292f8be917a80,1,1,1,2,1,2015-01-20 13:13:53,2015-01-20 01:54:57
be1357e70983d4ad029a1ecdd05292f8be917a80...64ecb3f07db4be5eef4d9eb7687f783ee446c82f,1,26,24,50,18,2015-01-20 15:19:11,2015-01-20 10:39:23
64ecb3f07db4be5eef4d9eb7687f783ee446c82f...dccf41cff0f46a94aa1d853d1bad9052079bb454,1,1,1,2,1,2015-01-20 16:45:57,2015-01-20 16:44:41
dccf41cff0f46a94aa1d853d1bad9052079bb454...039465a6a7a18f48ea77ceadb6949990c0ec92e1,26,28,28,56,28,2015-01-20 17:18:03,2015-01-20 14:54:12
039465a6a7a18f48ea77ceadb6949990c0ec92e1...d450af8a2687ca2e90a8790eb567f9a25ebce85b,2,15,5,20,6,2015-01-21 17:44:14,2015-01-21 05:47:49
d450af8a2687ca2e90a8790eb567f9a25ebce85b...38c17871bb6dafd489367f6fe8bc56199223adb8,4,105,8,113,11,2015-01-22 17:41:19,2015-01-08 22:51:00
38c17871bb6dafd489367f6fe8bc56199223adb8...4669b6a807811d6763b9fdc5df974cb67aa1fb56,3,59,3,62,6,2015-01-22 19:36:15,2015-01-18 02:20:42
4669b6a807811d6763b9fdc5df974cb67aa1fb56...4135d837027eac43ec416856d9476c478167d8a6,1,8,0,8,2,2015-01-22 20:25:47,2015-01-22 20:23:45
4135d837027eac43ec416856d9476c478167d8a6...f8e4e4a935512aedf815f6aee85bc797b498ea75,2,4,0,4,2,2015-01-23 08:09:48,2015-01-23 08:05:46
f8e4e4a935512aedf815f6aee85bc797b498ea75...851f5bd413a93708436a129442007448755b34f3,1,3,3,6,1,2015-01-23 17:59:59,2015-01-23 17:58:57
851f5bd413a93708436a129442007448755b34f3...16ee52d21d6835302bcd5ee594c5d6a0ef22d138,4,19,7,26,9,2015-01-23 19:37:12,2015-01-21 18:26:51
16ee52d21d6835302bcd5ee594c5d6a0ef22d138...1cd41874d5a9ccbc0b5e1aca71f5be14efb92ce2,1,1,1,2,1,2015-01-23 20:05:58,2015-01-23 20:05:58
1cd41874d5a9ccbc0b5e1aca71f5be14efb92ce2...1e219ac62f3313f5a5f8eb188240a11bedd41aa1,2,2,2,4,4,2015-01-23 21:03:30,2015-01-23 21:03:30
1e219ac62f3313f5a5f8eb188240a11bedd41aa1...0386b97706052b88cd6fbbf777698810981cfeb6,1,7,3,10,2,2015-01-23 21:23:32,2015-01-23 13:23:44
0386b97706052b88cd6fbbf777698810981cfeb6...ee23e03637aa8b82311f93b0a660574a0512891a,1,11,8,19,3,2015-01-24 15:14:18,2015-01-20 15:20:02
ee23e03637aa8b82311f93b0a660574a0512891a...ea0ea7859a224225950a4df7c23eb3a7d823ddcd,1,4,2,6,3,2015-01-26 15:48:31,2015-01-26 10:23:48
ea0ea7859a224225950a4df7c23eb3a7d823ddcd...511be35779a98427387d9aa4abacce01dedd7272,2,5,3,8,3,2015-01-26 16:58:55,2015-01-26 10:09:50
511be35779a98427387d9aa4abacce01dedd7272...8196e4bdf498acb05e6680c81f9d7bf700f4295c,11,58,62,120,30,2015-01-27 01:20:06,2015-01-17 05:03:46
8196e4bdf498acb05e6680c81f9d7bf700f4295c...e77c1bc181a27f8d591a94a2f462325e8722e565,1,5,0,5,1,2015-01-27 04:30:59,2015-01-27 04:29:06
e77c1bc181a27f8d591a94a2f462325e8722e565...7a90b53d60f6a66340811417547e33e0bfadf09e,4,2,67,69,4,2015-01-27 12:48:11,2015-01-27 04:02:53
7a90b53d60f6a66340811417547e33e0bfadf09e...da224d6be0d55811d448ed6d57ac828c18cd1a80,1,4,0,4,1,2015-01-27 14:35:34,2015-01-27 13:39:22
da224d6be0d55811d448ed6d57ac828c18cd1a80...84b6c768301096849f5589d7612b129c5445abd3,3,137,96,233,45,2015-01-27 15:35:49,2015-01-27 14:40:01
84b6c768301096849f5589d7612b129c5445abd3...3a4c9e1b43ff67b6cf4c59da757666d6ac5ce4a0,5,969,883,1852,27,2015-01-27 15:39:57,2015-01-25 15:45:54
3a4c9e1b43ff67b6cf4c59da757666d6ac5ce4a0...728b6fd9ca8624271f072d5f4618dc3fd38e87f1,11,186,180,366,32,2015-01-27 15:40:02,2015-01-26 03:28:57
728b6fd9ca8624271f072d5f4618dc3fd38e87f1...6f8418089c5e81d12718187da2140394ed30da43,3,18,1,19,3,2015-01-27 16:48:04,2015-01-27 16:48:04
6f8418089c5e81d12718187da2140394ed30da43...335df82a3f13877220712090eb455a32eea87421,1,3,3,6,1,2015-01-27 18:45:52,2015-01-27 18:42:48
335df82a3f13877220712090eb455a32eea87421...332139d23dc79cdc846e8e51f0eeee7ddbc9d568,1,1,1,2,1,2015-01-27 18:50:05,2015-01-27 18:50:00
332139d23dc79cdc846e8e51f0eeee7ddbc9d568...ac650d02cbb66ab652ae529b8f03b486ef974dfb,2,19,1,20,2,2015-01-27 19:12:22,2015-01-24 12:14:30
ac650d02cbb66ab652ae529b8f03b486ef974dfb...f218a2ff455b5f7391dd38038994f2c5f8b0eca1,1,22,0,22,1,2015-01-27 23:59:30,2015-01-27 02:37:43
f218a2ff455b5f7391dd38038994f2c5f8b0eca1...7171bf755b0c4be85ddbcc164eaf87164c131021,3,111,6,117,19,2015-01-27 23:59:30,2015-01-27 02:40:32
7171bf755b0c4be85ddbcc164eaf87164c131021...14d0bd67d4bcf55f8a0a2b01433571a8b714121f,1,3,5,8,4,2015-01-27 23:59:30,2015-01-27 02:42:48
14d0bd67d4bcf55f8a0a2b01433571a8b714121f...ac6033d8835ac54c1222801f6aeb47f9997b517a,2,13,0,13,2,2015-01-28 11:38:31,2015-01-28 11:38:31
ac6033d8835ac54c1222801f6aeb47f9997b517a...0f3ea8c0bc9c7f7f5e448b0b2137bc6351f5eae3,1,1,1,2,1,2015-01-28 11:48:09,2015-01-26 01:08:00
0f3ea8c0bc9c7f7f5e448b0b2137bc6351f5eae3...24b2bc635e23e4235f51095fbe099beec27a65c8,5,26,72,98,8,2015-01-28 11:59:40,2015-01-13 19:29:07
24b2bc635e23e4235f51095fbe099beec27a65c8...cd91486213b6c3d9e0a2e6e329fffc8aff40f183,1,1,1,2,2,2015-01-28 12:00:52,2015-01-28 12:00:52
cd91486213b6c3d9e0a2e6e329fffc8aff40f183...18f3e79b13947de0bda7c985916d5a04e28936dc,6,6,33,39,12,2015-01-28 15:23:25,2015-01-28 14:55:52
18f3e79b13947de0bda7c985916d5a04e28936dc...63412262e54b4814fe115502bebded9c9993b6f7,1,2,10,12,2,2015-01-29 17:21:44,2015-01-29 17:21:44
63412262e54b4814fe115502bebded9c9993b6f7...f1ff9407c94c4574d100efc3d224c1f79e2fb53d,1,3,3,6,2,2015-01-29 17:55:20,2015-01-17 13:53:02
f1ff9407c94c4574d100efc3d224c1f79e2fb53d...f60973111806100d284d41c12206c04740063549,1,0,5,5,1,2015-01-29 18:31:12,2015-01-29 17:53:57
f60973111806100d284d41c12206c04740063549...55c76f4e3bab74c8544b72d11a99e94a1c2cfbce,1,3,2,5,2,2015-01-29 19:36:01,2015-01-28 14:05:47
55c76f4e3bab74c8544b72d11a99e94a1c2cfbce...eb4cdfbdd64a95b303eaaa40a070521aa58362fd,3,12,3,15,4,2015-01-29 19:40:20,2015-01-22 06:43:49
eb4cdfbdd64a95b303eaaa40a070521aa58362fd...5b74134f27eabf92870e1c5e81f9e4999f113eab,2,17,8,25,7,2015-01-29 20:23:01,2015-01-13 13:42:21
5b74134f27eabf92870e1c5e81f9e4999f113eab...29c0073335c7f7cdc482866e093e5e42a42625e5,4,25,12,37,10,2015-01-30 11:28:47,2015-01-29 12:20:56
29c0073335c7f7cdc482866e093e5e42a42625e5...dbabf43920bfd99f0e720c7c20228c17128a2af8,1,1,1,2,1,2015-01-30 13:29:17,2015-01-29 21:57:03
dbabf43920bfd99f0e720c7c20228c17128a2af8...4c3bfe9053766d378999d06ec34ee5fd4e39f511,10,262,347,609,51,2015-01-30 15:02:58,2015-01-30 07:26:13
4c3bfe9053766d378999d06ec34ee5fd4e39f511...277100057dac7298c714e09783648044be2ff077,1,1,1,2,1,2015-01-30 16:54:29,2015-01-30 16:54:29
277100057dac7298c714e09783648044be2ff077...955f70904a3762894162b46c9bc97cc9abcee5dc,1,1,1,2,1,2015-01-30 16:55:20,2015-01-30 16:55:20
955f70904a3762894162b46c9bc97cc9abcee5dc...293fd5da5b8c7b79bd34ef793ab45c1bb8ac69ea,2,5,37,42,6,2015-01-30 17:51:12,2015-01-30 16:23:20
293fd5da5b8c7b79bd34ef793ab45c1bb8ac69ea...a0b5f15ea5f1abd91da9a5e4e5b6a0fb5a880c43,5,26,4,30,6,2015-01-30 19:27:18,2015-01-16 23:17:54
a0b5f15ea5f1abd91da9a5e4e5b6a0fb5a880c43...888054bff7c5878e026bac2e712d5480f7e295c7,1,38,0,38,1,2015-01-31 16:01:55,2015-01-30 13:20:35
888054bff7c5878e026bac2e712d5480f7e295c7...64a899dc815f1a070dc7a7c22276e8bb41e46ea6,1,0,7,7,1,2015-01-31 16:05:26,2015-01-31 02:38:29
64a899dc815f1a070dc7a7c22276e8bb41e46ea6...75303b01a9cc900eebf1f27ba0bc6508334242fc,6,92,14,106,12,2015-01-31 17:33:11,2014-12-29 16:41:16
75303b01a9cc900eebf1f27ba0bc6508334242fc...62df1834b8d60c106c8c16524b275b8a1f47ac3a,1,1,1,2,1,2015-02-01 00:59:17,2015-01-31 19:20:36
62df1834b8d60c106c8c16524b275b8a1f47ac3a...327a00f48b71b5f82788f3c9ee3cdb25b8e1ef1a,1,0,12,12,1,2015-02-02 01:13:12,2015-02-02 00:33:44
327a00f48b71b5f82788f3c9ee3cdb25b8e1ef1a...99ca7c2bd3e04b343f4a0fe2d5add7c6d6f3a456,1,0,5,5,1,2015-02-02 01:26:04,2015-02-02 00:54:20
99ca7c2bd3e04b343f4a0fe2d5add7c6d6f3a456...0e6091249295b0e06aff2b1b4411819f94a1c529,1,0,6,6,1,2015-02-02 01:33:22,2015-02-02 01:33:22
0e6091249295b0e06aff2b1b4411819f94a1c529...c79faae761659d51d58782dbd2b8058fb4668cfa,64,101,865,966,232,2015-02-02 02:02:40,2015-01-26 20:39:52
c79faae761659d51d58782dbd2b8058fb4668cfa...f79ce63fdb6788c8b4857fece6c86de57fc129ee,1,0,11,11,1,2015-02-02 02:37:25,2015-02-02 01:18:15
f79ce63fdb6788c8b4857fece6c86de57fc129ee...8d64aae883f7721c33f88276e7c999844085659f,1,33,33,66,16,2015-02-02 15:46:33,2015-01-30 23:14:46
8d64aae883f7721c33f88276e7c999844085659f...a53541852d5601232899e54d66e623bc163c6dc2,1,0,9,9,1,2015-02-02 16:13:14,2015-02-02 16:06:27
a53541852d5601232899e54d66e623bc163c6dc2...2133f3157eff853329bafb7fda74c3c8fb4eae42,19,180,22,202,62,2015-02-03 07:29:45,2015-01-26 20:57:10
2133f3157eff853329bafb7fda74c3c8fb4eae42...5d193d042a3cc49033f0e8b5125913650d779496,1,4,14,18,2,2015-02-03 13:41:57,2015-02-03 13:41:57
5d193d042a3cc49033f0e8b5125913650d779496...9a391fbd6102176d576aa96ed3aeee9e9661b455,1,3,3,6,3,2015-02-03 14:10:55,2015-02-03 14:10:55
9a391fbd6102176d576aa96ed3aeee9e9661b455...118b11221f7f632b4d0e6e976c87f563746ec211,2,5,1,6,2,2015-02-03 14:12:37,2015-02-03 13:46:17
118b11221f7f632b4d0e6e976c87f563746ec211...8adc59038cdc6ce4f9170e4de2d716d940e136b3,6,50,0,50,7,2015-02-03 14:23:44,2015-01-28 11:40:48
8adc59038cdc6ce4f9170e4de2d716d940e136b3...cd4282816db9164791cd0ac97a3dc329ad92c522,6,132,321,453,26,2015-02-03 15:44:33,2015-01-16 23:34:32
cd4282816db9164791cd0ac97a3dc329ad92c522...250aa7c39b0025ef3ae508884fda8d6e43c9518f,4,21,12,33,7,2015-02-03 17:18:12,2015-01-28 21:43:23
250aa7c39b0025ef3ae508884fda8d6e43c9518f...cd0ceaa102c1e12b016432db4d180bee7906131f,2,15,0,15,3,2015-02-03 17:23:41,2015-01-31 15:05:16
cd0ceaa102c1e12b016432db4d180bee7906131f...66f5aa9fa5d53ddd7fbdb7ddac39c429f0c1b4fd,1,2,2,4,2,2015-02-03 17:26:58,2015-02-03 13:03:05
66f5aa9fa5d53ddd7fbdb7ddac39c429f0c1b4fd...570912a97d5051fa3aeacd9d16c3be9afcf92198,4,78,64,142,6,2015-02-03 18:09:54,2015-02-03 18:09:54
570912a97d5051fa3aeacd9d16c3be9afcf92198...9ec8aa5e5d42ac4529846f7eae6bf4982800abff,120,612,616,1228,524,2015-02-03 19:59:45,2015-01-21 16:55:57
9ec8aa5e5d42ac4529846f7eae6bf4982800abff...0e489c19f1554ecfd9825daacfbac73be8ce723e,2,13,31,44,11,2015-02-03 20:23:39,2015-02-03 20:12:28
0e489c19f1554ecfd9825daacfbac73be8ce723e...281fc03474ac18c8281ed4cf289128c87bda2030,1,9,8,17,2,2015-02-03 21:35:28,2015-02-03 21:35:28
281fc03474ac18c8281ed4cf289128c87bda2030...65e005f8cd9c656e558e53e6c8b890cd0fcc9e74,3,36,8,44,7,2015-02-03 21:40:31,2015-02-03 20:13:43
65e005f8cd9c656e558e53e6c8b890cd0fcc9e74...c0cc8f69e7abfa8578729031f97ae4b96c5cdafe,6,6,4,10,6,2015-02-03 23:30:46,2015-02-03 23:02:59
c0cc8f69e7abfa8578729031f97ae4b96c5cdafe...1fc458b5a3ec002f51bcac58f09ec77493d8c8c0,1,0,1,1,1,2015-02-03 23:32:00,2015-02-03 23:32:00
1fc458b5a3ec002f51bcac58f09ec77493d8c8c0...79f27f2b61aeac763ae048416ef8a97c2b639ae8,3,55,4,59,6,2015-02-03 23:56:53,2015-01-22 03:15:59
79f27f2b61aeac763ae048416ef8a97c2b639ae8...7d363ed43247a80d2b764723e1bf6e0e6da4e82f,3,5,5,10,4,2015-02-04 12:31:43,2015-02-04 06:01:59
7d363ed43247a80d2b764723e1bf6e0e6da4e82f...5bc5ddd8b5d787c5e744efead184d46c55d03687,8,25,29,54,10,2015-02-04 12:47:28,2015-02-03 21:35:55
5bc5ddd8b5d787c5e744efead184d46c55d03687...2be621e44c1b5b68c895383f3e20b1f17ddb447a,3,53,15,68,15,2015-02-04 14:05:23,2014-04-05 15:58:05
2be621e44c1b5b68c895383f3e20b1f17ddb447a...afe0bb7b13bb8dc4370f32225238012c873b0ee3,6,75,90,165,33,2015-02-04 14:26:40,2014-12-23 13:16:56
afe0bb7b13bb8dc4370f32225238012c873b0ee3...7145c8a62a38c3b30641bb84a51f7567ce9bc10e,4,38,90,128,30,2015-02-04 14:26:40,2015-02-04 08:21:29
7145c8a62a38c3b30641bb84a51f7567ce9bc10e...4d3470e52e005ed75aa6c7d4204bf5ca87733f85,1,0,8,8,1,2015-02-04 14:26:40,2015-02-04 08:35:40
4d3470e52e005ed75aa6c7d4204bf5ca87733f85...23c4cbc0fa8217fa5fa2f6ce77437d403ea0eaff,1,135,137,272,31,2015-02-04 14:47:24,2015-02-03 20:41:51
23c4cbc0fa8217fa5fa2f6ce77437d403ea0eaff...4444ff39a4d8c144f70fcdce08c6ca0abab67bb9,2,12,12,24,6,2015-02-04 14:56:55,2015-02-04 14:56:55
4444ff39a4d8c144f70fcdce08c6ca0abab67bb9...2730dad0d7c425f33f1ecc6cec01fdbf1cdd8376,3,84,12,96,8,2015-02-04 15:53:04,2015-01-25 14:53:40
2730dad0d7c425f33f1ecc6cec01fdbf1cdd8376...caa3562d5bec1196502352a715a539bdb0f73c2d,2,16,2,18,4,2015-02-04 18:04:00,2015-01-29 07:59:41
caa3562d5bec1196502352a715a539bdb0f73c2d...49516f7158ed0ca39ea8116d25a32a80288d47b3,1,1,0,1,1,2015-02-05 03:12:41,2015-02-05 01:57:06
49516f7158ed0ca39ea8116d25a32a80288d47b3...71ada3a8e689a883b5ffdeb1744ea16f176ab730,10,346,96,442,35,2015-02-05 05:45:08,2015-01-29 18:15:27
71ada3a8e689a883b5ffdeb1744ea16f176ab730...9d104a21e20f9c5ec41d19fd919d0e808aa13dba,1,5,0,5,1,2015-02-05 05:45:08,2015-01-29 18:17:16
9d104a21e20f9c5ec41d19fd919d0e808aa13dba...20eb51ce0ddcb8d5fdc772fc2839fefef5b28c2a,2,12,12,24,6,2015-02-05 09:59:56,2015-02-05 09:52:26
20eb51ce0ddcb8d5fdc772fc2839fefef5b28c2a...737b184d914d5cc4a6ed8fe2a1d66ec1b7369f46,1,5,3,8,1,2015-02-05 10:34:23,2015-02-05 09:09:13
737b184d914d5cc4a6ed8fe2a1d66ec1b7369f46...de62b8ef4587e8f01462629e2812f06f9ddf71e8,1,10,11,21,6,2015-02-05 11:43:55,2015-02-05 11:14:36
de62b8ef4587e8f01462629e2812f06f9ddf71e8...31d3a35579d3dd05d0de7eb384e7ed22b589ed96,2,8,2,10,3,2015-02-05 12:21:50,2015-02-05 12:20:33
31d3a35579d3dd05d0de7eb384e7ed22b589ed96...9410d69835c69562df2120495a0a8b9710f28df3,2,11,0,11,2,2015-02-05 15:40:46,2015-02-04 14:34:32
9410d69835c69562df2120495a0a8b9710f28df3...27f9ff459b17ccce8177f454174232a6ec5a79e7,2,13,4,17,3,2015-02-05 19:06:18,2015-02-05 10:38:58
27f9ff459b17ccce8177f454174232a6ec5a79e7...44ad691558c88ac54483030b2c8b749788c4600e,2,41,0,41,2,2015-02-05 19:06:18,2015-02-05 10:53:04
44ad691558c88ac54483030b2c8b749788c4600e...0204714b0bdf10d7558ee106de9a718407f3ec5a,3,315,431,746,113,2015-02-05 19:11:48,2015-01-29 14:14:55
0204714b0bdf10d7558ee106de9a718407f3ec5a...146dd7be8dad4cd6264d374b681256a8b0d5808b,1,2,0,2,2,2015-02-05 20:27:25,2015-02-05 20:26:54
146dd7be8dad4cd6264d374b681256a8b0d5808b...1f9e44030e9c5300b97ef7b029f482c53a66f13b,1,89,0,89,1,2015-02-05 21:26:45,2015-02-04 16:29:08
1f9e44030e9c5300b97ef7b029f482c53a66f13b...235124d3eaf6cc7ab9f97f1d1467d1caf18e1016,1,8,0,8,8,2015-02-05 23:45:07,2015-02-05 23:40:36
235124d3eaf6cc7ab9f97f1d1467d1caf18e1016...0f54cf28c09a80254571487e3af93be2096cfdac,2,13,0,13,2,2015-02-06 00:15:02,2015-02-05 21:13:57
0f54cf28c09a80254571487e3af93be2096cfdac...bbe28496d32f76ca161f5c33787d6ad62267fcc6,5,2,12,14,7,2015-02-06 00:37:01,2015-02-05 23:30:11
bbe28496d32f76ca161f5c33787d6ad62267fcc6...607af78bb82404d55cc3e80e5f6772fb87c168ee,3,0,45,45,2,2015-02-06 11:22:00,2015-02-06 11:22:00
607af78bb82404d55cc3e80e5f6772fb87c168ee...d39073b8aea04dc5fe6b58bcb868067da08425fa,1,2,1,3,1,2015-02-06 11:56:53,2015-02-06 11:32:03
d39073b8aea04dc5fe6b58bcb868067da08425fa...23a5ec07828b8f16d5abb89d892869ec0c635c45,1,1,1,2,1,2015-02-06 11:58:45,2015-02-06 11:58:02
23a5ec07828b8f16d5abb89d892869ec0c635c45...20b74b10be069f6bae7555113a3781a66f3767a0,1,7,0,7,1,2015-02-06 12:43:59,2015-02-04 13:16:11
20b74b10be069f6bae7555113a3781a66f3767a0...aea103b6a599a5e4c71a355b2cac237f067be13b,1,4,6,10,1,2015-02-06 12:45:05,2015-02-03 12:43:51
aea103b6a599a5e4c71a355b2cac237f067be13b...388d986b8a6bb1363dab9f53ea435dff4dfe92cb,3,0,64,64,2,2015-02-06 12:58:31,2015-02-06 12:58:31
388d986b8a6bb1363dab9f53ea435dff4dfe92cb...0ed7d155635da9f79d4dd67e4889087d3673c6da,793,2523,2305,4828,1902,2015-02-06 13:16:28,2015-01-28 12:35:27
0ed7d155635da9f79d4dd67e4889087d3673c6da...eb45a29565fe006b87657e9ee24054c66a6474f9,1,0,30,30,1,2015-02-06 13:47:38,2015-02-06 13:47:38
eb45a29565fe006b87657e9ee24054c66a6474f9...db77915c9fd35a203edd8206f702ee4082f04d4a,53,196,208,404,205,2015-02-06 14:30:35,2015-02-05 18:25:34
db77915c9fd35a203edd8206f702ee4082f04d4a...cd155c7c7160f5178833593713727f013d3ed36d,1,79,8,87,2,2015-02-06 19:48:56,2014-11-17 22:35:54
cd155c7c7160f5178833593713727f013d3ed36d...58afd30b593fbd1e3d17c1bba83597da07bdb5f5,1,7,0,7,1,2015-02-06 21:30:50,2015-02-06 21:29:40
58afd30b593fbd1e3d17c1bba83597da07bdb5f5...a8f1c70dce792831688588f271efb3a825dffef8,1,1,1,2,1,2015-02-07 17:46:04,2015-02-07 16:57:37
a8f1c70dce792831688588f271efb3a825dffef8...bd3d796ecd9a66832ad26024df65caeb63b60a5d,2,4,4,8,4,2015-02-07 18:22:31,2015-02-07 18:22:31
bd3d796ecd9a66832ad26024df65caeb63b60a5d...2832a9b028c267997b2fd3dd0989670d57cdd08f,6,6,61,67,12,2015-02-07 19:14:49,2015-02-07 18:34:15
2832a9b028c267997b2fd3dd0989670d57cdd08f...540ca563dea624823e0b363f98302a78294836ad,2,4,1,5,2,2015-02-08 19:00:57,2015-02-07 21:36:45
540ca563dea624823e0b363f98302a78294836ad...9033003d97d29f7754b0840333f6f362c0cd31f7,2,14,4,18,3,2015-02-08 19:52:19,2015-02-08 18:38:09
9033003d97d29f7754b0840333f6f362c0cd31f7...32e6a7d3a57b2287d55e8b8efa4e8cb7643b1720,8,693,647,1340,559,2015-02-08 19:55:09,2015-02-06 22:25:15
32e6a7d3a57b2287d55e8b8efa4e8cb7643b1720...82e0cd15711c7171aed7af5e481967cc721c9642,1,3,1,4,2,2015-02-08 19:56:57,2015-02-08 18:14:30
82e0cd15711c7171aed7af5e481967cc721c9642...8099d33b6553c9ee7de779ae9d191a1bf22adbda,1,2,4,6,4,2015-02-08 20:02:43,2015-02-08 18:24:11
8099d33b6553c9ee7de779ae9d191a1bf22adbda...12562747508032725d4366c08b19dd26a8ce8a0c,1,0,3,3,1,2015-02-09 12:50:47,2015-02-09 12:50:47
12562747508032725d4366c08b19dd26a8ce8a0c...981bd64dfb2854ae9d6168925ff2eb2bac273c3b,1,1,1,2,2,2015-02-09 13:23:17,2015-02-09 12:52:34
981bd64dfb2854ae9d6168925ff2eb2bac273c3b...4d73303ee974c5f1ea6af984d4578d817825026d,2,26,1,27,2,2015-02-09 13:37:55,2015-01-30 09:40:25
4d73303ee974c5f1ea6af984d4578d817825026d...e144e0e237136f8bf1831f645c3dde4541d629b0,2,50,45,95,26,2015-02-09 13:53:58,2015-02-09 13:53:58
e144e0e237136f8bf1831f645c3dde4541d629b0...e215d325a8918eef489648a7050fea3d103f023f,1,1,1,2,1,2015-02-09 14:46:00,2015-02-09 14:02:21
e215d325a8918eef489648a7050fea3d103f023f...32ed4c202f9f8ecd0bf305db06d363cd7a9927eb,5,11,9,20,8,2015-02-09 14:51:19,2015-02-09 10:14:48
32ed4c202f9f8ecd0bf305db06d363cd7a9927eb...2d7c27d3870e57edd1b2ac46b49f0a8804753a1e,2,16,0,16,3,2015-02-09 15:20:01,2015-02-09 13:15:26
2d7c27d3870e57edd1b2ac46b49f0a8804753a1e...c5d1a5ef5cf111cd35fa8545a2831dd47ba0fc70,3,1,11,12,4,2015-02-09 15:28:42,2015-02-09 15:28:42
c5d1a5ef5cf111cd35fa8545a2831dd47ba0fc70...50aa1a790ca66c2a93e0a52e00c53375b269ff49,4,54,36,90,26,2015-02-09 16:29:53,2015-02-09 16:28:03
50aa1a790ca66c2a93e0a52e00c53375b269ff49...6704b5298035d3041b9bc14b72e9a2858fef513f,2,18,0,18,2,2015-02-09 18:07:45,2015-02-09 18:02:39
6704b5298035d3041b9bc14b72e9a2858fef513f...2ee9bce654f940a8de5ef121f39b6fcb6d09741a,4,0,12,12,4,2015-02-09 18:37:23,2015-02-09 18:37:23
2ee9bce654f940a8de5ef121f39b6fcb6d09741a...8a590c4b7bde49cb562000603c7d309bf7e0f961,1,41,44,85,3,2015-02-09 20:07:49,2015-02-09 01:09:15
8a590c4b7bde49cb562000603c7d309bf7e0f961...5b75b01939d88c8799127c961bccc78367b83181,1,85,107,192,43,2015-02-09 20:08:05,2015-02-09 01:10:12
5b75b01939d88c8799127c961bccc78367b83181...c970018f41985567b7c4bb858e158cb33a180f8a,6,1,77,78,7,2015-02-10 00:16:07,2015-02-10 00:16:07
c970018f41985567b7c4bb858e158cb33a180f8a...f2c104ada605d9f7f7b7435778662c16d432dc32,2,18,10,28,3,2015-02-10 13:34:05,2015-02-10 09:29:00
f2c104ada605d9f7f7b7435778662c16d432dc32...a3473454ada67c0a16efeabcb78950641d4ac93c,1,4,5,9,2,2015-02-10 17:30:28,2015-02-10 17:30:28
a3473454ada67c0a16efeabcb78950641d4ac93c...c8e24bbc9b027a712b54e3665d27418ae538f15d,1,1,2,3,2,2015-02-10 19:24:14,2015-02-10 19:24:14
c8e24bbc9b027a712b54e3665d27418ae538f15d...e9874d4cf1f582dd78ad171b4e7ce62f3199390f,1,1,1,2,1,2015-02-10 19:27:20,2015-02-10 19:27:20
e9874d4cf1f582dd78ad171b4e7ce62f3199390f...c7a6996df7e77bc3b9c5e581e67d766627ebabec,1,2,3,5,3,2015-02-10 20:37:53,2015-02-10 20:37:53
c7a6996df7e77bc3b9c5e581e67d766627ebabec...1b8af4cfa023161924a45fb572399d2f3071bf5b,4,32,58,90,12,2015-02-10 20:41:19,2015-02-09 21:41:57
1b8af4cfa023161924a45fb572399d2f3071bf5b...1fbe8a2de334bfec5e9b77e36f8a3c1cf2cd70be,4,10,5,15,5,2015-02-10 21:24:34,2015-02-09 23:54:51
1fbe8a2de334bfec5e9b77e36f8a3c1cf2cd70be...19188826b4aa989475418f1ea9bf8631b04da1e8,4,21,3,24,5,2015-02-11 00:55:06,2015-02-10 17:15:54
19188826b4aa989475418f1ea9bf8631b04da1e8...197dd4b8f12164f6acebb3b959f9ac2040a40400,3,12,1,13,5,2015-02-11 15:14:38,2015-02-10 17:02:47
197dd4b8f12164f6acebb3b959f9ac2040a40400...d3a725054fa260e84c788b240fd03cbd0ccc1151,17,40,26,66,35,2015-02-11 15:19:22,2015-02-10 00:20:39
d3a725054fa260e84c788b240fd03cbd0ccc1151...d8341bf02444e58ff62afe04f15d9679a1b5b8f8,2,6,7,13,2,2015-02-11 15:19:22,2015-02-10 12:51:02
d8341bf02444e58ff62afe04f15d9679a1b5b8f8...fbc467c26bc0adb9867b97d0bb5642b2a85eb357,13,43,47,90,9,2015-02-11 15:19:22,2015-02-10 13:11:25
fbc467c26bc0adb9867b97d0bb5642b2a85eb357...fac3a34cbb8fd8dc74006f187dd1e83f3a040d39,2,0,0,0,0,2015-02-11 15:19:22,2015-02-10 13:18:29
fac3a34cbb8fd8dc74006f187dd1e83f3a040d39...b3cd9e0d0732e1fd7d2afd5825dda5b3857927da,9,12,21,33,13,2015-02-11 15:19:22,2015-02-10 13:30:35
b3cd9e0d0732e1fd7d2afd5825dda5b3857927da...00da46091a0b35d4822b30e29334de4f4869901e,3,5,4,9,5,2015-02-11 15:19:22,2015-02-10 13:41:45
00da46091a0b35d4822b30e29334de4f4869901e...8192a164defa24d75672e6b10cec650489b8c748,2,2,1,3,2,2015-02-11 15:19:22,2015-02-10 13:44:52
8192a164defa24d75672e6b10cec650489b8c748...2d7aca3da0a46c09e9c70ebdb56ed340691a999f,44,32,96,128,90,2015-02-11 15:19:22,2015-02-10 14:17:08
2d7aca3da0a46c09e9c70ebdb56ed340691a999f...5ab327a3894c26f57baabe14084bcce2a71b8af8,10,175,144,319,19,2015-02-11 15:29:48,2015-02-11 13:24:42
5ab327a3894c26f57baabe14084bcce2a71b8af8...ad0be620aece4dde2f94383426c284f4afef9fbc,99,82,72,154,66,2015-02-11 15:29:54,2015-02-10 15:07:44
ad0be620aece4dde2f94383426c284f4afef9fbc...7cf3a5786bc76374e743fbc0c1a1c8470a61f6c0,2,5,29,34,7,2015-02-11 15:29:54,2015-02-10 17:03:47
7cf3a5786bc76374e743fbc0c1a1c8470a61f6c0...8ec306a3a90aa2ec0baa4c9d8df68f0d49947a2c,2,3,3,6,3,2015-02-11 17:30:07,2015-02-11 17:29:20
8ec306a3a90aa2ec0baa4c9d8df68f0d49947a2c...07cfe1bd822f4108b5029aef1615a17000d0b0dc,2,7,1,8,2,2015-02-11 18:00:56,2015-02-11 16:40:03
07cfe1bd822f4108b5029aef1615a17000d0b0dc...e2d6e14662d780383e18066a3182155fb5b7747b,7,89,88,177,54,2015-02-11 21:46:25,2015-02-11 05:38:02
e2d6e14662d780383e18066a3182155fb5b7747b...93b3ef9b2e191101c1a49b332d042864df74a658,2,15,2,17,4,2015-02-12 07:58:35,2015-02-11 10:09:51
93b3ef9b2e191101c1a49b332d042864df74a658...0f7f5bc9e7a94ab91c2b3db29ef7cf000eff593f,4,40,6,46,10,2015-02-12 12:38:16,2015-02-11 19:38:52
0f7f5bc9e7a94ab91c2b3db29ef7cf000eff593f...34ccb3cc038ac30b13a7243a3dbd9366c1119746,1,1,2,3,2,2015-02-12 13:04:30,2015-02-10 03:03:29
34ccb3cc038ac30b13a7243a3dbd9366c1119746...27eeb64a96ec6d3a05714ab6319b500a935706fb,2,12,1,13,4,2015-02-12 13:07:58,2015-02-08 18:44:07
27eeb64a96ec6d3a05714ab6319b500a935706fb...e4999bf671eadd199541f81be7d672124ffb75eb,1,3,1,4,1,2015-02-12 13:18:10,2015-02-12 13:18:10
e4999bf671eadd199541f81be7d672124ffb75eb...d7509c52466aeffb13ccd8a86475e74fdb0e6292,2,7,0,7,4,2015-02-12 14:54:42,2015-02-12 14:54:42
d7509c52466aeffb13ccd8a86475e74fdb0e6292...e519ee1d352e0e36fcb8edc9d33ec2845f663d3a,1,4,3,7,3,2015-02-12 15:32:26,2015-02-11 15:00:12
e519ee1d352e0e36fcb8edc9d33ec2845f663d3a...9239f1dda7b94f53d21efb8b5e4d056e24f4e906,3,66,20,86,5,2015-02-12 18:07:09,2015-02-12 06:28:24
9239f1dda7b94f53d21efb8b5e4d056e24f4e906...a93c5fb2bfbadd4628a2a5d6b6aecbd64bd527cb,1,3,0,3,1,2015-02-12 19:05:52,2015-02-12 19:05:52
a93c5fb2bfbadd4628a2a5d6b6aecbd64bd527cb...d64baaef3b95abe9ae5d07317c9bf4df02cb8592,2,11,2,13,3,2015-02-12 19:19:44,2015-02-12 18:40:23
d64baaef3b95abe9ae5d07317c9bf4df02cb8592...de0241eb985c6dec978beda119fee353ef3e9604,2,11,2,13,3,2015-02-12 22:45:53,2015-02-12 02:25:12
de0241eb985c6dec978beda119fee353ef3e9604...bd4afef98490198e325654952d38a5735ee7e358,1,4,2,6,2,2015-02-12 23:06:46,2015-02-12 23:06:46
bd4afef98490198e325654952d38a5735ee7e358...e8cf4f8abec87b9da6ed8e5c8cf833af9b27f4dd,4,34,4,38,8,2015-02-13 12:01:28,2015-02-12 18:58:37
e8cf4f8abec87b9da6ed8e5c8cf833af9b27f4dd...00a889167f6699d02cee50848750d8d0e110d41c,6,92,26,118,33,2015-02-13 12:13:05,2015-02-06 21:19:23
00a889167f6699d02cee50848750d8d0e110d41c...b06935a486e633e9732bce2bc5f796eb437b2531,3,14,44,58,7,2015-02-13 13:01:54,2015-01-22 03:26:37
b06935a486e633e9732bce2bc5f796eb437b2531...b4e1090ab28c0e731157a61a91a6875bad392307,1,0,2,2,1,2015-02-13 13:29:45,2015-02-12 11:39:01
b4e1090ab28c0e731157a61a91a6875bad392307...f287bec5833d75750fa6368bc2802741b7924533,7,130,23,153,18,2015-02-13 13:29:59,2015-02-12 11:48:28
f287bec5833d75750fa6368bc2802741b7924533...fdf20093e0f8cd064673aa1597c20727ed4dd2a0,3,74,4,78,10,2015-02-13 14:42:49,2015-02-12 17:14:19
fdf20093e0f8cd064673aa1597c20727ed4dd2a0...002425fe39f62faafaa32e400f7531809181a1a0,2,25,2,27,5,2015-02-13 14:56:31,2015-02-13 14:12:30
002425fe39f62faafaa32e400f7531809181a1a0...648e516b8d5694c01a225fe27429f0bf7776fb43,1,17,2,19,1,2015-02-13 15:34:17,2015-02-11 10:22:13
648e516b8d5694c01a225fe27429f0bf7776fb43...b4caa91c8bedf3c236a143dc955f8ecae0439a88,1,1,1,2,1,2015-02-13 15:39:22,2015-02-13 15:39:22
b4caa91c8bedf3c236a143dc955f8ecae0439a88...5c995dcfc251b55284e1ef16545acd2acad6be04,3,18,10,28,5,2015-02-13 17:37:23,2015-02-13 14:21:33
5c995dcfc251b55284e1ef16545acd2acad6be04...18c0aaa9123579375294fcc4a8ee7e3530176b88,8,34,34,68,20,2015-02-13 19:28:24,2015-02-13 18:55:36
18c0aaa9123579375294fcc4a8ee7e3530176b88...47ee7b48adbcc0dafc3404034286c5fcbcd1cea6,2,19,4,23,4,2015-02-14 09:21:06,2015-02-14 09:21:06
47ee7b48adbcc0dafc3404034286c5fcbcd1cea6...1791a7e75af8c9e7ca54425592379fd1f840fe88,5,31,9,40,8,2015-02-14 10:19:55,2015-02-07 16:55:47
1791a7e75af8c9e7ca54425592379fd1f840fe88...8a21d250334f56845f255be5534b01d8c6eda314,2,12,2,14,4,2015-02-14 12:37:18,2015-02-13 22:12:23
8a21d250334f56845f255be5534b01d8c6eda314...0af3822dc362b6253bda1c9699466dd0bbbf6066,2,23,0,23,2,2015-02-14 13:08:05,2015-02-14 13:01:37
0af3822dc362b6253bda1c9699466dd0bbbf6066...1379165b3548b843980e59201eea8961a0b30a2d,1,2,1,3,1,2015-02-14 15:20:11,2015-02-14 15:18:17
1379165b3548b843980e59201eea8961a0b30a2d...76356d963c131252e1ce4285083fd21fd0bdedd9,3,55,5,60,4,2015-02-14 17:51:11,2015-02-14 08:50:38
76356d963c131252e1ce4285083fd21fd0bdedd9...28e97a9bdc6c672a1304570aa75f6311fb1112e2,1,18,19,37,3,2015-02-14 17:51:18,2015-02-14 08:53:17
28e97a9bdc6c672a1304570aa75f6311fb1112e2...a73c8540a888021feb640abefa936a76e21b6a1a,1,1,4,5,1,2015-02-14 17:51:18,2015-02-14 16:31:53
a73c8540a888021feb640abefa936a76e21b6a1a...49647bec6e86b8d3d370ea1d8a80423185502c5a,2,2,0,2,2,2015-02-14 23:38:50,2015-02-14 21:33:09
49647bec6e86b8d3d370ea1d8a80423185502c5a...e0b3926026984dccc86a09c0c4f32e8bec6f3fe1,1,8,0,8,2,2015-02-15 03:04:48,2015-02-15 03:03:25
e0b3926026984dccc86a09c0c4f32e8bec6f3fe1...9fbd302f91162434f375b67a533d4a955a439484,1,39,0,39,1,2015-02-15 19:43:34,2015-02-15 16:31:06
9fbd302f91162434f375b67a533d4a955a439484...15b711b5ee9ce1ddd01cf88b2bbbec4a6cbec648,20,72,48,120,41,2015-02-15 19:47:04,2015-02-15 14:42:05
15b711b5ee9ce1ddd01cf88b2bbbec4a6cbec648...d652906aebd34d9ba943507ce0c3a7be169fab7c,1,1,1,2,1,2015-02-16 01:07:22,2015-02-16 01:07:22
d652906aebd34d9ba943507ce0c3a7be169fab7c...c5a77721e2fccff427374cd987a6d8b92a37f37c,4,120,220,340,65,2015-02-16 13:40:04,2015-02-16 09:03:34
c5a77721e2fccff427374cd987a6d8b92a37f37c...5efd472178f6fd4ee6f3c823c4ec68b15dcf4834,2,199,85,284,71,2015-02-16 13:40:04,2015-02-16 09:06:42
5efd472178f6fd4ee6f3c823c4ec68b15dcf4834...f668bac9d223408627ca92b2281cf7110039510b,1,8,0,8,2,2015-02-16 13:42:43,2015-02-16 13:02:49
f668bac9d223408627ca92b2281cf7110039510b...e35c70bef44805d47f6a4ae692be878184c4fe1f,1,14,0,14,1,2015-02-16 15:11:47,2015-02-15 19:40:13
e35c70bef44805d47f6a4ae692be878184c4fe1f...4dd1f4c5eb7a617c1ee512e7a7c732d530e13916,1,1,1,2,1,2015-02-16 16:08:19,2015-02-16 16:08:19
4dd1f4c5eb7a617c1ee512e7a7c732d530e13916...ad9ecc2c209df3a48fc607f886d57f77ef972546,1,0,3,3,1,2015-02-16 18:00:02,2015-02-16 15:36:35
ad9ecc2c209df3a48fc607f886d57f77ef972546...58d0dd9260156067263ea7a2da2685c3cd88e18a,1,50,1,51,4,2015-02-16 18:31:51,2015-01-29 15:57:12
58d0dd9260156067263ea7a2da2685c3cd88e18a...cc22b009e05456e3d9cf3c152fe47fa27772be5e,9,97,0,97,4,2015-02-16 18:31:51,2015-02-11 09:14:53
cc22b009e05456e3d9cf3c152fe47fa27772be5e...273bc4b667b964b69b15bc438bcdae3dc6529a2a,1,54,0,54,1,2015-02-16 18:31:51,2015-02-13 15:42:44
273bc4b667b964b69b15bc438bcdae3dc6529a2a...b29f3b51204d53c1c8745966476543d068c173a2,1,111,41,152,11,2015-02-16 18:31:51,2015-02-09 00:11:25
b29f3b51204d53c1c8745966476543d068c173a2...d538e37e1b14603d1d0c94f185f378fc0ed1e53f,2,223,2,225,3,2015-02-16 18:31:52,2015-02-11 00:01:01
d538e37e1b14603d1d0c94f185f378fc0ed1e53f...d392c1e150a46aca72e37263c44c034d92a79f79,2,38,13,51,6,2015-02-16 18:36:53,2015-02-07 19:31:12
d392c1e150a46aca72e37263c44c034d92a79f79...f3bc7c5447a1e4bfa428a7ff32ea3336850c5c2d,1,8,16,24,3,2015-02-16 19:28:41,2015-02-16 19:28:41
f3bc7c5447a1e4bfa428a7ff32ea3336850c5c2d...4538cbf17d4391cda22d76bc6ac69f228f7400f2,1,17,0,17,1,2015-02-16 19:52:30,2015-02-16 17:53:56
4538cbf17d4391cda22d76bc6ac69f228f7400f2...35f0cae19de226d9d7771304fc8dd2619e644998,2,13,18,31,6,2015-02-16 19:56:38,2015-02-16 19:22:22
35f0cae19de226d9d7771304fc8dd2619e644998...664c038f2c5b56d1ce929243d29cd4e11ea5f9ea,5,42,44,86,4,2015-02-16 22:45:38,2015-02-16 20:54:00
664c038f2c5b56d1ce929243d29cd4e11ea5f9ea...3adc5f1ee6618a615db07d4a868b366a15c39f82,6,33,33,66,16,2015-02-16 23:07:27,2015-02-16 17:11:39
3adc5f1ee6618a615db07d4a868b366a15c39f82...8b39f33d78ce5749f8ca40a7ae6823b5f6c26c09,5,6,16,22,14,2015-02-17 11:34:13,2015-02-16 23:10:35
8b39f33d78ce5749f8ca40a7ae6823b5f6c26c09...4a0aeac1b5cfb7b6229a01119a596afb38d8a2a0,1,4,4,8,3,2015-02-17 12:27:47,2015-02-15 00:30:33
4a0aeac1b5cfb7b6229a01119a596afb38d8a2a0...d316b43d0ab9db0f9913b094b84b11362d36d054,1,1,0,1,1,2015-02-17 12:32:48,2015-02-15 23:59:54
d316b43d0ab9db0f9913b094b84b11362d36d054...81a94cc616ab80decaa495cfa1c0c623527fc0e7,1,2,1,3,2,2015-02-17 13:06:33,2015-02-15 23:59:39
81a94cc616ab80decaa495cfa1c0c623527fc0e7...63c5c9870129f6b81358c1ed7ed2392bbc46f77d,1,1,1,2,1,2015-02-17 13:09:46,2015-02-15 01:46:11
63c5c9870129f6b81358c1ed7ed2392bbc46f77d...c9ece2e6b9365fa4be16bd0de25dd7b68c8dc97e,1,2,1,3,2,2015-02-17 13:12:49,2015-02-15 00:51:43
c9ece2e6b9365fa4be16bd0de25dd7b68c8dc97e...bad6280c4e3f75f3ccd27f8fd85a4043bb296128,1,3,7,10,4,2015-02-17 13:19:58,2015-02-15 22:37:55
bad6280c4e3f75f3ccd27f8fd85a4043bb296128...32b67b3fd1d252566f60cf38fe1459bb83de2ce2,1,2,0,2,1,2015-02-17 18:53:20,2015-02-17 18:53:20
32b67b3fd1d252566f60cf38fe1459bb83de2ce2...ad50b6c853f4a6c864219fbd38b4254ffaef7b1c,1,1,1,2,1,2015-02-17 18:54:18,2015-02-17 18:54:18
ad50b6c853f4a6c864219fbd38b4254ffaef7b1c...bebc1e53a3ab059849e5c4e5a55b2f5e68b67169,1,2,0,2,1,2015-02-17 23:44:31,2015-02-16 13:25:53
bebc1e53a3ab059849e5c4e5a55b2f5e68b67169...fa66ea75326e669cd3d51fb926a4364b8ba08959,1,2,2,4,2,2015-02-17 23:48:15,2015-02-17 23:48:15
fa66ea75326e669cd3d51fb926a4364b8ba08959...307c0f299a6c26f5231d3516df5b4edc54b36553,9,31,23,54,20,2015-02-18 00:03:03,2015-02-15 00:47:07
307c0f299a6c26f5231d3516df5b4edc54b36553...098fa12dd390e733c7568d824eea2c346550c75a,1,1,1,2,1,2015-02-18 12:24:13,2015-02-16 13:54:25
098fa12dd390e733c7568d824eea2c346550c75a...b8d6cdbcc90ff8af781d13131b79ce88a9eff66d,1,14,0,14,5,2015-02-18 12:25:36,2015-02-16 14:30:05
b8d6cdbcc90ff8af781d13131b79ce88a9eff66d...e9282747a4ba99adc7e0f677b3a897830df51732,2,0,6,6,4,2015-02-18 15:22:30,2015-02-17 16:35:46
e9282747a4ba99adc7e0f677b3a897830df51732...15dc8d1c9d3697170a2c59ecaa7a2b4ba58f5990,2,74,19,93,4,2015-02-18 18:05:10,2015-02-06 13:24:51
15dc8d1c9d3697170a2c59ecaa7a2b4ba58f5990...f7d34fe741ea64f3ec89f1d742d47182065e2c2a,1,9,6,15,3,2015-02-18 20:47:15,2015-02-18 20:44:31
f7d34fe741ea64f3ec89f1d742d47182065e2c2a...ceadc94f09f0615e95146f9a42b711acfc14f40f,2,37,2,39,4,2015-02-19 00:39:41,2015-02-17 22:50:45
ceadc94f09f0615e95146f9a42b711acfc14f40f...efb1f99f943b99624c78b91ff58502125490191e,2,6,2,8,3,2015-02-19 19:18:31,2015-02-18 09:09:33
efb1f99f943b99624c78b91ff58502125490191e...1bfcc950ab6e5264bbaf2eba0ce3d3e23d671404,8,54,49,103,33,2015-02-19 21:08:11,2015-02-17 21:49:59
1bfcc950ab6e5264bbaf2eba0ce3d3e23d671404...e467919c6315be87abec72383ec1a81e2665ebec,1,1,1,2,1,2015-02-20 00:31:49,2015-02-18 21:52:16
e467919c6315be87abec72383ec1a81e2665ebec...c8074d62f8b891a200d7bd9a8e0658057261e2af,1,1,1,2,1,2015-02-20 00:36:20,2015-02-20 00:36:20
c8074d62f8b891a200d7bd9a8e0658057261e2af...0adf766e1638e3e9f348d95bc6e6734ca81606ab,1,49,0,49,1,2015-02-20 01:18:52,2015-02-17 19:36:29
0adf766e1638e3e9f348d95bc6e6734ca81606ab...dbacbc729a8dabe58466bf9abccee23be7cce877,1,47,44,91,8,2015-02-20 01:36:24,2015-02-17 20:32:47
dbacbc729a8dabe58466bf9abccee23be7cce877...4755f8fc25331c739a6f932cc8aba0cc9e62e352,7,44,15,59,12,2015-02-20 11:35:51,2015-02-14 19:37:12
4755f8fc25331c739a6f932cc8aba0cc9e62e352...32d4db66b999cde6776d4be7f71528dab94916cc,19,44,46,90,43,2015-02-20 11:35:52,2015-02-20 10:53:59
32d4db66b999cde6776d4be7f71528dab94916cc...c490e410af086fa89f40d515505bba02a08168f3,2,21,1,22,3,2015-02-20 11:51:46,2015-02-20 11:33:02
c490e410af086fa89f40d515505bba02a08168f3...d28bcba209fa3f90f92ce2fd216baf5b5800d143,1,2,2,4,1,2015-02-20 12:26:16,2015-02-20 12:26:16
d28bcba209fa3f90f92ce2fd216baf5b5800d143...dd0b487872de4e3ff966da51e3610bac996e44f0,8,8,8,16,8,2015-02-20 14:21:39,2015-02-20 14:20:38
dd0b487872de4e3ff966da51e3610bac996e44f0...bed504d70bede3431a213203c13a33905d6dbf77,26,222,118,340,91,2015-02-20 14:34:09,2015-02-19 07:27:58
bed504d70bede3431a213203c13a33905d6dbf77...bad5f262bf4a17f157808ec1aa225ba9c94c1eee,5,105,104,209,31,2015-02-20 18:00:12,2015-02-16 07:49:19
bad5f262bf4a17f157808ec1aa225ba9c94c1eee...e43f99d1a9997d51fa922bbb94225bbf4e73cb9d,1,1,1,2,1,2015-02-20 21:00:51,2015-02-20 20:31:00
e43f99d1a9997d51fa922bbb94225bbf4e73cb9d...51b606f75d3662cf6736ade400d6423cb519968b,2,38,33,71,7,2015-02-20 21:27:48,2015-02-19 22:20:27
51b606f75d3662cf6736ade400d6423cb519968b...19f7278c86b16be442301fc6935b78f3a71abbcd,1,1,1,2,1,2015-02-20 21:37:29,2015-02-20 21:37:03
19f7278c86b16be442301fc6935b78f3a71abbcd...1d1d5d1c315e0e58f02a7f2a07b56ed20b09c087,2,128,7,135,12,2015-02-20 21:49:15,2015-02-19 21:19:33
1d1d5d1c315e0e58f02a7f2a07b56ed20b09c087...99a1bbf9853e0b06385d7f221a90828e6c060132,1,1,1,2,1,2015-02-21 01:11:13,2015-02-20 22:47:41
99a1bbf9853e0b06385d7f221a90828e6c060132...fa5f936b4803416d1b16e7171dce8df535d13766,1,1,1,2,1,2015-02-21 16:13:14,2015-02-21 16:08:09
fa5f936b4803416d1b16e7171dce8df535d13766...1d9d39fa1c60896e31360d5f8d6b972979ee7c95,1,0,12,12,1,2015-02-21 16:46:26,2015-02-21 12:56:12
1d9d39fa1c60896e31360d5f8d6b972979ee7c95...2bb5b0e09863df65756fe0050406163cb70750f1,1,0,5,5,2,2015-02-21 16:46:26,2015-02-21 12:56:35
2bb5b0e09863df65756fe0050406163cb70750f1...bd059e3f8c6311dcaf8afe5e29ef373f7f84cf26,6,8,23,31,7,2015-02-21 16:52:24,2015-02-05 20:56:59
bd059e3f8c6311dcaf8afe5e29ef373f7f84cf26...787dd6519a791f210dc8275eaf2fd41454bf9670,2,2,2,4,2,2015-02-21 16:52:24,2015-02-21 16:49:52
787dd6519a791f210dc8275eaf2fd41454bf9670...ea3168dc6ced391d848c511a14cfcecfeac9d401,3,5,3,8,4,2015-02-21 18:27:49,2015-02-21 18:27:49
ea3168dc6ced391d848c511a14cfcecfeac9d401...eba6dff581aa8bd6a1c08456e83e68ad09ae4ec3,17,100,134,234,94,2015-02-22 14:35:39,2015-02-19 03:19:21
eba6dff581aa8bd6a1c08456e83e68ad09ae4ec3...88a5f17d25a25dbd2ebcf905dcecc45ce78a1615,2,17,6,23,5,2015-02-22 14:46:35,2015-02-22 14:40:04
88a5f17d25a25dbd2ebcf905dcecc45ce78a1615...7901eccf2e591447850be00011a7bb556a3c53f2,1,3,1,4,1,2015-02-22 15:11:18,2015-02-22 15:11:18
7901eccf2e591447850be00011a7bb556a3c53f2...ff5e47e7a4a638a30424331222e0abdb60842ddd,1,11,14,25,7,2015-02-22 17:29:01,2015-02-22 17:29:01
ff5e47e7a4a638a30424331222e0abdb60842ddd...b2f331dc68ec3c5a34285f7af9614e4178e9a371,4,24,17,41,17,2015-02-22 19:20:02,2015-02-22 14:59:56
b2f331dc68ec3c5a34285f7af9614e4178e9a371...c688460df6239539d2b5a1fc8c51778086fe7c35,3,3,34,37,7,2015-02-22 22:09:42,2015-02-22 16:49:29
c688460df6239539d2b5a1fc8c51778086fe7c35...556a74879f5c2d382927b5b68451c76d344e29e4,3,10,8,18,7,2015-02-22 22:13:55,2015-02-22 18:14:05
556a74879f5c2d382927b5b68451c76d344e29e4...7fa7dd48c4c785fd34161c6418de5accb1618422,2,4,1,5,2,2015-02-23 04:23:16,2015-02-23 04:23:16
7fa7dd48c4c785fd34161c6418de5accb1618422...78d43a5e1064b63db1c486516c4263ef1c4c975c,3,112,33,145,16,2015-02-23 11:38:53,2015-02-20 04:43:45
78d43a5e1064b63db1c486516c4263ef1c4c975c...f95122e541df5bebb9b5ebb6226b0013e5edc893,3,14,15,29,7,2015-02-23 12:24:43,2015-02-23 07:31:58
f95122e541df5bebb9b5ebb6226b0013e5edc893...dda2a3cf4cc29d01de180f66d19441f300732e52,4,38,0,38,3,2015-02-23 12:37:13,2015-02-22 01:56:51
dda2a3cf4cc29d01de180f66d19441f300732e52...00fbd8fd527fd6ee0319361bf194cd51a1ac1bfb,2,19,6,25,7,2015-02-23 12:45:37,2015-02-22 19:43:38
00fbd8fd527fd6ee0319361bf194cd51a1ac1bfb...1306cd1e8acfb13602ee8dc40993b2505cd7523b,3,54,1,55,5,2015-02-23 13:44:27,2015-02-20 19:28:34
1306cd1e8acfb13602ee8dc40993b2505cd7523b...e83aba0e2cce16cd1b32d1c172239a4e20867e95,2,9,5,14,2,2015-02-23 14:23:07,2015-02-22 17:46:15
e83aba0e2cce16cd1b32d1c172239a4e20867e95...934400759de817471ff37d736686201d7ae34e82,11,21,20,41,18,2015-02-23 15:55:26,2015-02-21 17:56:36
934400759de817471ff37d736686201d7ae34e82...a8fe12417f778a76837f8e4f8503779f52a396ba,6,31,36,67,20,2015-02-23 15:55:27,2015-02-21 18:18:54
a8fe12417f778a76837f8e4f8503779f52a396ba...952ce778c66d2cc01969f0e6ee4edd16becf2e66,1,2,1,3,1,2015-02-23 17:36:15,2015-02-23 17:36:15
952ce778c66d2cc01969f0e6ee4edd16becf2e66...b9c619abc101688fbbfa981525175f831d359483,2,73,32,105,8,2015-02-23 18:55:10,2015-02-22 20:18:12
b9c619abc101688fbbfa981525175f831d359483...903d1a57ab126c2b68e8f9591f11d1b5245d3561,2,180,180,360,63,2015-02-23 21:22:58,2015-02-22 20:50:16
903d1a57ab126c2b68e8f9591f11d1b5245d3561...2be6b526568aaaae5353a4a600a085d3c2135363,1,5,5,10,5,2015-02-24 11:30:33,2015-02-24 02:19:06
2be6b526568aaaae5353a4a600a085d3c2135363...1827aa902481cd80d2fb154e7b073f139936d5fc,6,313,308,621,37,2015-02-24 13:00:02,2015-02-18 21:51:05
1827aa902481cd80d2fb154e7b073f139936d5fc...441a47e1efd46001ca454b80e0d5f8c5ea4e235b,2,33,36,69,6,2015-02-24 13:00:02,2015-02-21 19:10:21
441a47e1efd46001ca454b80e0d5f8c5ea4e235b...06ffc764a9b2d2521e6a574d279b66ad411cc65c,2,131,146,277,3,2015-02-24 13:00:02,2015-02-21 19:11:20
06ffc764a9b2d2521e6a574d279b66ad411cc65c...ff67ce5076c1f4d3dc32fd755a1b65d3310c6cb1,2,40,38,78,6,2015-02-24 13:00:02,2015-02-21 19:13:26
ff67ce5076c1f4d3dc32fd755a1b65d3310c6cb1...250a3d199310a954a95fb1ffa4915f0e51ba1767,2,74,68,142,16,2015-02-24 13:00:02,2015-02-21 19:15:22
250a3d199310a954a95fb1ffa4915f0e51ba1767...f6d087b628a61a7b036cc468328497082031dc8e,2,46,43,89,3,2015-02-24 13:00:02,2015-02-21 19:17:39
f6d087b628a61a7b036cc468328497082031dc8e...3d8fee605184d8ffa47a32546298b52b52d7a087,2,35,28,63,3,2015-02-24 13:00:02,2015-02-21 19:19:08
3d8fee605184d8ffa47a32546298b52b52d7a087...25a0b5cdcd5e70a6563116639a477b915ee5784e,2,11,9,20,4,2015-02-24 13:00:03,2015-02-21 19:20:20
25a0b5cdcd5e70a6563116639a477b915ee5784e...32c108a221c54a4f680afe32175d70b5d2e92593,1,15,13,28,7,2015-02-24 13:00:03,2015-02-23 21:26:55
32c108a221c54a4f680afe32175d70b5d2e92593...8e129b42ad9c9adca599228ae2ad68271fa46d44,2,3,7,10,6,2015-02-24 13:00:03,2015-02-23 21:30:05
8e129b42ad9c9adca599228ae2ad68271fa46d44...4c2f546b55c029334d22e69bb29db97f9356faa3,2,36,0,36,2,2015-02-24 16:49:00,2015-02-24 09:54:05
4c2f546b55c029334d22e69bb29db97f9356faa3...d298b1ba5043eaa40f3f4bebe3c7634b359ba34b,2,0,23,23,2,2015-02-24 16:50:21,2015-02-24 16:50:21
d298b1ba5043eaa40f3f4bebe3c7634b359ba34b...65441bbdb02427655869c42791a0bc5a9c631292,2,32,7,39,7,2015-02-25 00:50:55,2015-02-23 03:06:41
65441bbdb02427655869c42791a0bc5a9c631292...47b35b1844b2adc167e64674824873991e9c4c2b,3,4,4,8,4,2015-02-25 12:15:56,2015-02-25 12:15:56
47b35b1844b2adc167e64674824873991e9c4c2b...660676c7e724f54f4a9b99d2aacde8c191b41b64,1,1,1,2,1,2015-02-25 13:39:01,2015-02-25 13:39:01
660676c7e724f54f4a9b99d2aacde8c191b41b64...aca73737da8ba173ad9435b1e9e1fe5d8516f3b3,1,1,1,2,1,2015-02-25 13:47:11,2015-02-25 13:47:11
aca73737da8ba173ad9435b1e9e1fe5d8516f3b3...71820721a19f5628b3176f16813d47378cb2c3cb,2,13,0,13,2,2015-02-25 14:11:19,2015-02-25 14:11:19
71820721a19f5628b3176f16813d47378cb2c3cb...fa9cb5dcdc816fe0e606b8f1020d53526e08b0d4,1,8,4,12,5,2015-02-26 17:50:09,2015-02-24 15:26:08
fa9cb5dcdc816fe0e606b8f1020d53526e08b0d4...3b966c2b73c420222d1524cda03c1a5626c90fe6,2,20,1,21,4,2015-02-27 11:23:21,2015-01-27 20:41:59
3b966c2b73c420222d1524cda03c1a5626c90fe6...8a9f39d2b3f7e9a7980128523be559ac976b607b,1,0,1,1,1,2015-02-27 14:44:06,2015-02-27 14:44:06
8a9f39d2b3f7e9a7980128523be559ac976b607b...2b19b3a031e7d5b5264bc9e880d0192301289bc2,1,70,51,121,26,2015-02-27 18:51:02,2015-02-22 15:24:03
2b19b3a031e7d5b5264bc9e880d0192301289bc2...5cf96b49e43daea6d4a0ba1c80c45e90c74f4e47,2,8,1,9,2,2015-02-27 19:23:07,2015-02-27 17:19:56
5cf96b49e43daea6d4a0ba1c80c45e90c74f4e47...dcdef1fe2ec59a7aeca39efc5a29f0d238d0c560,1,2,2,4,1,2015-02-27 22:53:11,2015-02-27 21:56:38
dcdef1fe2ec59a7aeca39efc5a29f0d238d0c560...3cf1c02695481900cf6140f54beb48f0e7d88e19,2,18,5,23,2,2015-02-28 09:07:12,2015-02-27 19:17:04
3cf1c02695481900cf6140f54beb48f0e7d88e19...9f1dbe29c0dbae57ff7950f3f64a0d083177cca8,1,4,0,4,1,2015-02-28 09:12:32,2015-02-28 09:12:32
9f1dbe29c0dbae57ff7950f3f64a0d083177cca8...90ab6ee6123f2b378a068988526b409854ddec77,1,0,4,4,1,2015-02-28 11:11:27,2015-02-28 11:11:27
90ab6ee6123f2b378a068988526b409854ddec77...23c612199a8aaef52c3c7e05b66fb02ee0aac55b,2,6,13,19,5,2015-02-28 15:10:32,2015-02-28 15:02:20
23c612199a8aaef52c3c7e05b66fb02ee0aac55b...4b8979e477a5315f3dfde0348393fd404fb70ee4,2,5,2,7,3,2015-03-01 20:37:52,2015-03-01 20:21:26
4b8979e477a5315f3dfde0348393fd404fb70ee4...80d6b6b863109cfb60a7fcc5936136e347ecd57a,3,27,43,70,14,2015-03-02 12:53:58,2015-02-24 15:17:17
80d6b6b863109cfb60a7fcc5936136e347ecd57a...f7bf135f62297c580e9b36af4c2470adb652fbaf,1,2,2,4,1,2015-03-02 13:23:18,2015-02-27 15:31:14
f7bf135f62297c580e9b36af4c2470adb652fbaf...4fdc7015c0d0849e391aa22da46b62a8fa4de27c,1,4,2,6,1,2015-03-02 13:50:27,2015-02-28 00:01:13
4fdc7015c0d0849e391aa22da46b62a8fa4de27c...f37c11eea3cb860112a26f8a65d823842f65b96f,2,14,1,15,2,2015-03-02 14:25:19,2015-02-25 18:48:35
f37c11eea3cb860112a26f8a65d823842f65b96f...fde4857fb83101d27ae4cb3552a6a6cf20d3d8ce,1,9,3,12,3,2015-03-02 17:33:58,2015-02-07 21:32:31
fde4857fb83101d27ae4cb3552a6a6cf20d3d8ce...4e8b167e4d0817b6ae93be8ad97b31bf203698d8,2,2,2,4,2,2015-03-02 18:07:34,2015-03-02 17:48:30
4e8b167e4d0817b6ae93be8ad97b31bf203698d8...08572e8d125da204fab230be5d1fdcc5d8d22256,4,23,4,27,7,2015-03-02 18:15:34,2015-02-06 21:45:46
08572e8d125da204fab230be5d1fdcc5d8d22256...fea45eff5a2f2ad10b2788603db80e5a4fe6be06,1,0,4,4,4,2015-03-02 18:33:11,2015-03-02 18:18:48
fea45eff5a2f2ad10b2788603db80e5a4fe6be06...80be597a7b2530ec0893e1d9ee8275e281f026dc,1,9,12,21,8,2015-03-02 19:06:24,2015-03-02 11:12:22
80be597a7b2530ec0893e1d9ee8275e281f026dc...8ca35d7c6a639933927f45b439363a1614da56f1,1,2,2,4,2,2015-03-02 22:01:21,2015-03-02 22:01:21
8ca35d7c6a639933927f45b439363a1614da56f1...358850781f8fd3d79aba5b1a9a0b8d28f544bf8a,5,93,186,279,9,2015-03-02 23:25:28,2015-02-19 20:04:25
358850781f8fd3d79aba5b1a9a0b8d28f544bf8a...a40a34a4b2d79dbf798df538c26222148d42b17c,1,18,3,21,3,2015-03-02 23:44:23,2015-02-28 21:53:06
a40a34a4b2d79dbf798df538c26222148d42b17c...6b28e957df364532109a1897c73a1fa8b1416bd4,1,12,0,12,1,2015-03-03 00:53:11,2015-02-25 18:57:47
6b28e957df364532109a1897c73a1fa8b1416bd4...85757d0e79f4237d7cf3ee1785946315aa6959eb,1,0,1,1,1,2015-03-03 12:46:12,2015-03-03 09:30:12
85757d0e79f4237d7cf3ee1785946315aa6959eb...70123cf084e3af7dfc61bb7bd2090ff802c3cda4,5,50,43,93,11,2015-03-03 20:20:46,2015-03-02 19:31:14
70123cf084e3af7dfc61bb7bd2090ff802c3cda4...a9e29fae105d1ddd4e0ac2059cbe62b0ee348bc8,2,25,2,27,4,2015-03-04 13:26:49,2015-03-04 08:36:53
a9e29fae105d1ddd4e0ac2059cbe62b0ee348bc8...fe42bfaaff93e6b4af34ab48892e20c9cdee0c1a,1,2,6,8,2,2015-03-04 15:26:04,2015-03-04 15:26:04
fe42bfaaff93e6b4af34ab48892e20c9cdee0c1a...36a17be9f3cf6081f7e6f83fcfeae3d09ce8a72b,2,2,1,3,2,2015-03-04 17:00:12,2015-03-04 17:00:12
36a17be9f3cf6081f7e6f83fcfeae3d09ce8a72b...d6969abf239d52f6dfed7384c6ceb7df7e618342,1,12,11,23,5,2015-03-04 21:30:14,2015-03-04 19:24:30
d6969abf239d52f6dfed7384c6ceb7df7e618342...39a7eed1bbf12020a077e4bec3d82e08f171a021,69,2070,2812,4882,417,2015-03-04 23:10:32,2015-02-23 00:53:57
39a7eed1bbf12020a077e4bec3d82e08f171a021...767c33d1fa9827908192e8ed1ac7f281f56bd811,1,2,1,3,1,2015-03-05 07:57:28,2015-02-28 15:36:19
767c33d1fa9827908192e8ed1ac7f281f56bd811...8714403614c4dfa37e806db4a6708b8a91a827a4,4,57,2,59,5,2015-03-05 08:00:13,2015-03-04 19:19:02
8714403614c4dfa37e806db4a6708b8a91a827a4...b4a1bb86695eae4750ad0ef130eb5944092c8965,1,8,5,13,5,2015-03-05 09:08:39,2015-03-05 09:08:39
b4a1bb86695eae4750ad0ef130eb5944092c8965...d61ebc8fed212366340b1ed6f5d7722613801459,12,94,42,136,24,2015-03-05 11:44:16,2015-03-04 18:05:17
d61ebc8fed212366340b1ed6f5d7722613801459...9a4a9a8a49ed3e38f3038b8d6fc7c405256271f1,1,5,3,8,1,2015-03-05 14:14:36,2015-03-05 14:13:56
9a4a9a8a49ed3e38f3038b8d6fc7c405256271f1...fb7d681705a92c6d510b06822450d6a94ed1623f,1,1,1,2,1,2015-03-05 17:14:19,2015-03-05 15:06:01
fb7d681705a92c6d510b06822450d6a94ed1623f...8e744fa1507b6d425860c54e7673e603279367eb,1,2,2,4,1,2015-03-05 17:17:56,2015-03-05 12:09:08
8e744fa1507b6d425860c54e7673e603279367eb...668d53cd125175eb708cc0af143f47b42cd42153,7,41,1,42,9,2015-03-05 20:03:40,2015-02-21 21:57:02
668d53cd125175eb708cc0af143f47b42cd42153...82f7bee1d56e1bf8ae041c6cdeb7374ea6b844de,4,42,27,69,13,2015-03-05 22:51:17,2015-03-05 13:21:29
82f7bee1d56e1bf8ae041c6cdeb7374ea6b844de...ceaf31adfff3801f1092a215f73704e15a70e90c,3,47,0,47,3,2015-03-06 02:30:02,2015-03-05 06:10:48
ceaf31adfff3801f1092a215f73704e15a70e90c...ec808e807ad711b993f199f6b4165ac6d0e1125b,2,15,7,22,4,2015-03-06 21:20:14,2015-03-06 20:56:11
ec808e807ad711b993f199f6b4165ac6d0e1125b...88c605e3e34cebd5485d286a17ac84c7b8b0faf1,3,7,1,8,3,2015-03-07 11:59:58,2015-03-07 10:57:52
88c605e3e34cebd5485d286a17ac84c7b8b0faf1...c36b60836be9e78ab877566cc43dc03960ce944d,6,36,10,46,15,2015-03-07 12:42:39,2015-03-05 17:38:42
c36b60836be9e78ab877566cc43dc03960ce944d...f4f0060feaee6bbd76a0d575487682bc541111e4,3,44,4,48,3,2015-03-07 13:09:56,2015-03-05 12:41:15
f4f0060feaee6bbd76a0d575487682bc541111e4...9eab3284447692b26f92d4b64cc8b4df78a8c5ef,1,3,0,3,1,2015-03-07 13:12:44,2015-03-07 13:12:44
9eab3284447692b26f92d4b64cc8b4df78a8c5ef...866e71140f9612e45087b8acafefa2e51ffc4a29,1,40,35,75,27,2015-03-08 09:12:53,2015-03-07 14:15:21
9eab3284447692b26f92d4b64cc8b4df78a8c5ef...90b069c33f3f8785a7d068a2032f130d2dbb0c75,1,3,0,3,2,2015-03-07 14:56:15,2015-02-21 20:09:30
90b069c33f3f8785a7d068a2032f130d2dbb0c75...87d78241a2fc85e5715fb51c554fe06e91deee58,2,7,0,7,2,2015-03-07 15:47:07,2015-03-07 13:15:26
87d78241a2fc85e5715fb51c554fe06e91deee58...e42a720ba22a51c68d2316d425234a197eaff467,6,197,9,206,125,2015-03-07 16:59:03,2015-03-07 16:34:33
180f75c2a0d15e54a7088bd5cb7a57342da5661d...888c9b6429a44824078a49fb1ebacf2e950cd887,2,12,2,14,4,2015-03-08 12:54:49,2015-02-22 03:26:17
888c9b6429a44824078a49fb1ebacf2e950cd887...a5b225084f69e27b78fab0f2954fa9520656976e,2,18,7,25,3,2015-03-08 14:42:23,2015-03-07 14:51:17
a5b225084f69e27b78fab0f2954fa9520656976e...336512fae77ec214ad6db24166b9a8676007cc09,2,13,2,15,3,2015-03-08 14:48:27,2015-03-08 14:06:23
336512fae77ec214ad6db24166b9a8676007cc09...794c3f74c32062d0f2ad021cb2af0e530b40730d,1,8,0,8,1,2015-03-08 15:32:54,2015-03-08 15:02:31
794c3f74c32062d0f2ad021cb2af0e530b40730d...e272904ff7cc4d138e316ba2e7811666053860a4,4,97,4,101,7,2015-03-08 18:44:14,2015-03-07 12:53:13
e272904ff7cc4d138e316ba2e7811666053860a4...eb9b7abb833a6d317e355265552d47e0d8f24af8,1,69,9,78,4,2015-03-08 19:36:27,2015-03-08 18:37:22
eb9b7abb833a6d317e355265552d47e0d8f24af8...63f2dd4ad774d39fc7bbe05492d30efc45e4e7a9,1,1,1,2,1,2015-03-09 11:06:09,2015-03-09 11:05:49
63f2dd4ad774d39fc7bbe05492d30efc45e4e7a9...fb146193c49e4c683dc8da39d9b7c479375fdb57,4,48,9,57,12,2015-03-09 11:49:23,2015-03-04 12:56:20
fb146193c49e4c683dc8da39d9b7c479375fdb57...fa350e2f303572ee8f9a8302dda45a12288d3d95,10,174,24,198,29,2015-03-09 13:29:58,2015-03-08 11:34:55
fa350e2f303572ee8f9a8302dda45a12288d3d95...300fdbbebba45cb4e7f32edc524171019d9bce80,1,2,2,4,1,2015-03-09 14:06:18,2015-03-09 14:06:18
300fdbbebba45cb4e7f32edc524171019d9bce80...82c9169077a066995e3b00aac551bf1c8a89d98a,4,33,3,36,5,2015-03-09 14:12:21,2015-03-08 10:50:32
82c9169077a066995e3b00aac551bf1c8a89d98a...ea9157f681654d393c970108866edb344b65a1aa,2,13,0,13,2,2015-03-09 17:09:39,2015-03-09 17:09:39
ea9157f681654d393c970108866edb344b65a1aa...df193b3cefda982dfcd4813bf4e2ac09b1358f21,2,17,0,17,3,2015-03-09 17:55:28,2015-03-09 16:56:13
df193b3cefda982dfcd4813bf4e2ac09b1358f21...578ac17f814f21648484a1d846413398e92f8808,1,4,10,14,8,2015-03-09 17:59:27,2015-03-07 16:22:16
578ac17f814f21648484a1d846413398e92f8808...756cee46d25a52108fd7190f787a7e636962df5d,2,40,1,41,3,2015-03-10 00:30:01,2015-03-07 12:18:04
756cee46d25a52108fd7190f787a7e636962df5d...b9b8411129efe13642cef1fc6bbfc62bed717352,1,13,1,14,2,2015-03-10 00:44:55,2015-03-07 17:45:57
b9b8411129efe13642cef1fc6bbfc62bed717352...d0b01ca452694361620ed1ae2714f1d792354da5,1,7,7,14,4,2015-03-10 00:49:22,2015-03-10 00:49:22
d0b01ca452694361620ed1ae2714f1d792354da5...cefbbb9db3410f757532e0f968e76a8fd9e7ce3b,1,1,1,2,1,2015-03-10 11:11:57,2015-03-10 09:10:24
cefbbb9db3410f757532e0f968e76a8fd9e7ce3b...f66c2bdc0f056ffcbf6df121ea9132aaa0c4cadb,4,2236,152,2388,63,2015-03-10 12:12:09,2015-03-07 10:40:30
f66c2bdc0f056ffcbf6df121ea9132aaa0c4cadb...0cb6a85f5ef1769823fad7cbd71d8527154ec277,1,19,6,25,5,2015-03-10 15:01:18,2015-03-10 15:01:18
0cb6a85f5ef1769823fad7cbd71d8527154ec277...1825365152c6474255f976dca4a68a8e3f070afa,3,7,11,18,5,2015-03-10 17:00:47,2015-03-10 16:59:27
1825365152c6474255f976dca4a68a8e3f070afa...57d42aef97eb8fa45584f2e863ccfa2b7c98d4b7,1,3,3,6,3,2015-03-10 18:42:38,2015-03-10 18:42:38
57d42aef97eb8fa45584f2e863ccfa2b7c98d4b7...7b1a67cce52e5c191fbfa1bca501c6f0222db019,3,11,11,22,7,2015-03-10 22:58:34,2015-03-10 22:40:33
7b1a67cce52e5c191fbfa1bca501c6f0222db019...3ed9c7bdfe9f40d31dadb6734a5692c8b9d6d6dc,2,21,1,22,2,2015-03-10 23:24:46,2015-03-04 14:36:34
3ed9c7bdfe9f40d31dadb6734a5692c8b9d6d6dc...5cf8f4596cd17f7a6096f7d5df92dde038cb12bf,2,2,6,8,2,2015-03-11 14:34:58,2015-03-06 09:57:06
5cf8f4596cd17f7a6096f7d5df92dde038cb12bf...6b605be5fe5ec62f6a927f868fc0f4e3413cd9e3,1,1,1,2,1,2015-03-11 16:34:42,2015-03-11 16:03:57
6b605be5fe5ec62f6a927f868fc0f4e3413cd9e3...a3e89f13dfb1f22a26ead8b06b37695598a4421a,1,23,3,26,3,2015-03-11 16:38:25,2015-03-10 05:17:33
a3e89f13dfb1f22a26ead8b06b37695598a4421a...ccff08c194b0b7f8a86bf9c5dd6d5be473760a1b,1,5,5,10,4,2015-03-11 18:35:25,2015-03-10 16:22:55
ccff08c194b0b7f8a86bf9c5dd6d5be473760a1b...389baccac5fce72c67cfed7a6ebcf9273edf9282,1,1,1,2,1,2015-03-11 18:49:15,2015-03-11 18:48:19
389baccac5fce72c67cfed7a6ebcf9273edf9282...bb581f62abc69864dc90ff976a05af0bf9b015dc,1,2,2,4,1,2015-03-11 18:57:10,2015-03-11 18:57:10
bb581f62abc69864dc90ff976a05af0bf9b015dc...6ff826e12ea99c0eb871716cfedc2c8e199695f3,1,1,1,2,1,2015-03-11 23:57:28,2015-03-11 23:21:08
6ff826e12ea99c0eb871716cfedc2c8e199695f3...28e8c54d7d2800a8ac98cf646a9e074055bc1b1b,1,4,7,11,3,2015-03-12 00:18:59,2015-03-11 10:12:14
28e8c54d7d2800a8ac98cf646a9e074055bc1b1b...8a481498aa995b435d8c3a0c90d7d917046f59b3,2,15,1,16,3,2015-03-12 12:19:54,2015-03-11 17:46:39
8a481498aa995b435d8c3a0c90d7d917046f59b3...27ad12a9b865bf3deebd165360f73ace722cee31,1,2,2,4,1,2015-03-12 12:43:26,2015-03-12 02:43:56
27ad12a9b865bf3deebd165360f73ace722cee31...f0f5212624d7a3edbf77126e0a3060d38db501e1,3,12,1,13,6,2015-03-12 13:18:39,2015-03-08 17:26:30
f0f5212624d7a3edbf77126e0a3060d38db501e1...b4d8b16e5109170614ba505e36f60c2ad64dafc2,2,7,0,7,2,2015-03-12 13:23:00,2015-03-12 11:19:42
b4d8b16e5109170614ba505e36f60c2ad64dafc2...e4a578e70e2e48ab792e38c67579808a1def6024,3,6,3,9,4,2015-03-12 13:40:56,2015-03-12 13:40:03
e4a578e70e2e48ab792e38c67579808a1def6024...c9f1a12925ef18d82b5f9683d589bb2c1e067650,2,24,14,38,9,2015-03-12 23:05:17,2015-03-08 10:07:55
c9f1a12925ef18d82b5f9683d589bb2c1e067650...a23ea398e8706f90b984c7ef9145c582b345ddd6,1,19,18,37,9,2015-03-12 23:13:48,2015-03-12 16:22:52
a23ea398e8706f90b984c7ef9145c582b345ddd6...53bc6e2e98b4889082049f50718b13f8d5d84b6b,1,1,1,2,1,2015-03-12 23:16:05,2015-03-12 22:56:38
53bc6e2e98b4889082049f50718b13f8d5d84b6b...a535e4acdcf1e75cc4d6302726876efc4c3a91c9,1,1,0,1,1,2015-03-12 23:26:22,2015-03-12 17:01:12
a535e4acdcf1e75cc4d6302726876efc4c3a91c9...7f8588d22ea3b53ba55d05922b67e7b3a0a7c91c,1,8,0,8,1,2015-03-13 00:08:37,2015-02-07 21:13:07
7f8588d22ea3b53ba55d05922b67e7b3a0a7c91c...d861f95c445652e4269c9015836d14dcf8b9a587,4,43,6,49,9,2015-03-13 00:18:06,2015-01-12 22:45:09
d861f95c445652e4269c9015836d14dcf8b9a587...7614efa2f9e169749ab109aab909fbc244fd76a9,1,1,1,2,1,2015-03-13 12:13:49,2015-03-13 06:38:27
7614efa2f9e169749ab109aab909fbc244fd76a9...56cd87a5aff034a7b976977a2902697cd5397b94,1,2,1,3,1,2015-03-13 12:24:44,2015-03-13 06:47:26
56cd87a5aff034a7b976977a2902697cd5397b94...f6b09a7f85c3b67b2011553838b079788c413432,1,5,0,5,1,2015-03-13 12:50:48,2015-03-13 12:48:39
f6b09a7f85c3b67b2011553838b079788c413432...a8991b9b9f11e2d5308f677d0ad1768b88e2d2ec,1,8,3,11,3,2015-03-13 15:39:32,2015-03-12 17:12:11
a8991b9b9f11e2d5308f677d0ad1768b88e2d2ec...aa5ab114e34645823b219f9a866fd82fc26b427b,8,71,3,74,12,2015-03-13 15:46:40,2015-03-12 08:32:29
aa5ab114e34645823b219f9a866fd82fc26b427b...d8de9a64d70f4bef7a223da1559638699a7a3923,1,1,1,2,1,2015-03-13 15:56:03,2015-03-13 14:58:20
d8de9a64d70f4bef7a223da1559638699a7a3923...5993b52e6d9db00259fd5a186b3c3df767fe94e2,2,29,4,33,5,2015-03-13 16:33:49,2015-02-25 21:17:15
5993b52e6d9db00259fd5a186b3c3df767fe94e2...b089759d6025582f36fbea3c4be3855c50b82462,1,27,0,27,1,2015-03-13 17:22:19,2015-02-04 17:22:06
b089759d6025582f36fbea3c4be3855c50b82462...e8a758e941bb36f69b6224b73b00b9d6a814bbdc,2,35,1,36,2,2015-03-13 18:46:13,2015-03-09 18:50:01
e8a758e941bb36f69b6224b73b00b9d6a814bbdc...b9d9ab23bdcc404708aada664e718a9d56415ca3,1,5,0,5,1,2015-03-13 19:40:25,2015-03-13 19:40:25
b9d9ab23bdcc404708aada664e718a9d56415ca3...a52cd407b86a51e1badf6771e590361e24fd7155,3,4,5,9,3,2015-03-13 20:58:28,2015-03-13 19:08:04
a52cd407b86a51e1badf6771e590361e24fd7155...34fb909180e9df06fa6a993dd5696a49cd152a0b,4,64,1,65,4,2015-03-14 18:07:16,2014-11-23 18:33:07
34fb909180e9df06fa6a993dd5696a49cd152a0b...21ffbb06ec9eb741f62ac51abab4b722fb91b9bc,3,6,6,12,5,2015-03-14 18:46:09,2015-03-14 18:35:50
21ffbb06ec9eb741f62ac51abab4b722fb91b9bc...ae87ad005f7b62f5fa5a29ef07443fa1bbb9baf0,2,38,1,39,2,2015-03-14 19:37:40,2015-02-16 19:42:11
ae87ad005f7b62f5fa5a29ef07443fa1bbb9baf0...8414fcf16b9cfa8d989db913f0961fc4ce18c71b,5,100,4,104,10,2015-03-14 20:08:23,2014-11-15 15:03:20
8414fcf16b9cfa8d989db913f0961fc4ce18c71b...4f494ed0c60cdfc44b65aeea7f42f6b7245c03af,1,1,1,2,1,2015-03-16 12:15:17,2015-03-16 06:05:43
4f494ed0c60cdfc44b65aeea7f42f6b7245c03af...39573a11db694a584de6ca2a858fa05ec4ea13e1,1,4,4,8,4,2015-03-16 12:24:25,2015-03-15 14:51:24
39573a11db694a584de6ca2a858fa05ec4ea13e1...28986da4ca167ae257abcaf7caea230eca2bcd80,5,100,8,108,9,2015-03-16 13:12:57,2015-03-16 00:33:59
28986da4ca167ae257abcaf7caea230eca2bcd80...937643a1f215d7d2063b256269d757a2ee316f07,1,2,2,4,2,2015-03-16 13:39:18,2015-03-15 09:05:54
937643a1f215d7d2063b256269d757a2ee316f07...820381d38bc02ea8b92837ce869e7332a7db9913,1,11,0,11,1,2015-03-16 15:54:27,2015-03-16 05:11:03
820381d38bc02ea8b92837ce869e7332a7db9913...0ed20d5cc4bf94646ffd4e4fcbd963b9916039cd,2,36,6,42,6,2015-03-16 16:13:49,2015-03-08 12:33:22
0ed20d5cc4bf94646ffd4e4fcbd963b9916039cd...4d9414098bd98aacd241827a01f6ad2dff71f113,1,5,0,5,1,2015-03-16 17:09:32,2015-03-16 15:55:43
4d9414098bd98aacd241827a01f6ad2dff71f113...388e79e9fcbf689d5708134534e55d176cfbcee3,4,28,0,28,4,2015-03-16 17:13:02,2015-03-11 16:00:17
388e79e9fcbf689d5708134534e55d176cfbcee3...818182b514d1c6b379130c440689355b4d231d49,2,10,1,11,2,2015-03-16 17:30:59,2015-03-15 22:54:20
818182b514d1c6b379130c440689355b4d231d49...8758a63ddbbf7a2626bd84d50cfe83b477e8de0a,3,62,4,66,3,2015-03-16 18:04:37,2015-03-02 22:13:14
8758a63ddbbf7a2626bd84d50cfe83b477e8de0a...f269c1d6f6dcc22c0a781f3223c6da0a4483b06e,11,600,57,657,75,2015-03-16 18:37:43,2015-03-13 18:49:02
f269c1d6f6dcc22c0a781f3223c6da0a4483b06e...b9cb81570e24284156e09ab1fdc3c19a8d563b07,3,31,25,56,21,2015-03-17 12:16:12,2015-03-17 11:33:25
b9cb81570e24284156e09ab1fdc3c19a8d563b07...81c2d9f60b9206c1291e5b1c3c8686f24a7726e1,5,41,18,59,9,2015-03-17 12:33:16,2015-02-06 23:16:26
81c2d9f60b9206c1291e5b1c3c8686f24a7726e1...ff2aa4019259947734c4791d6afc9f5405d901d0,2,15,5,20,3,2015-03-17 12:35:49,2015-03-16 04:51:23
ff2aa4019259947734c4791d6afc9f5405d901d0...88d798d71a20662bdf5335f0586fb9eb6e660c57,6,32,32,64,30,2015-03-17 12:40:18,2015-03-17 00:38:55
88d798d71a20662bdf5335f0586fb9eb6e660c57...71c638fc55d5b0637e0c50a71694f3e422caa0c1,1,1,2,3,1,2015-03-17 13:08:02,2015-03-17 13:08:02
71c638fc55d5b0637e0c50a71694f3e422caa0c1...64b9393ae279fde1ac535348458b3ff960177225,1,2,2,4,2,2015-03-17 15:35:11,2015-03-17 15:35:11
64b9393ae279fde1ac535348458b3ff960177225...c5c8751147d41913a05e86097ea29ccc9fc2e5be,1,16,0,16,1,2015-03-17 17:41:11,2015-03-17 17:41:11
c5c8751147d41913a05e86097ea29ccc9fc2e5be...53d11c6821b7b347e0eeefb96168cc1861715a6b,5,17,19,36,12,2015-03-17 22:34:15,2015-03-17 22:34:15
53d11c6821b7b347e0eeefb96168cc1861715a6b...d9a30ed190d68a5450cba8b3cd26ef6bcd8a70ff,1,6,6,12,1,2015-03-18 00:03:07,2015-03-18 00:03:07
d9a30ed190d68a5450cba8b3cd26ef6bcd8a70ff...debf521d498e9bd7fc61463a2db1c1ff6aa265f5,170,0,2237,2237,85,2015-03-18 08:30:20,2015-03-18 08:14:52
debf521d498e9bd7fc61463a2db1c1ff6aa265f5...465edf2bb2b6dd6158b198922dc0f185a15cc715,5,121,89,210,79,2015-03-18 08:31:00,2015-03-18 08:18:50
465edf2bb2b6dd6158b198922dc0f185a15cc715...6bff3439894ac22d80f270f36513fc86586273f3,5,37,1,38,8,2015-03-18 13:11:01,2015-03-10 20:21:28
6bff3439894ac22d80f270f36513fc86586273f3...0339844b70895d6162b4595ae615e6edf843c6cd,6,55,46,101,26,2015-03-18 17:03:25,2015-03-15 10:26:47
0339844b70895d6162b4595ae615e6edf843c6cd...a0c2eb46dd5a782c11c44f13c8efad2778be1641,20,127,156,283,77,2015-03-18 17:22:50,2015-03-13 22:40:14
a0c2eb46dd5a782c11c44f13c8efad2778be1641...b4a56ed4f55502239cb11b57f0fa75baa0a97640,1,7,0,7,1,2015-03-18 17:39:52,2015-03-18 12:23:46
b4a56ed4f55502239cb11b57f0fa75baa0a97640...65129aac07022f23afa1df7ec7fad2216634cb38,7,55,6,61,16,2015-03-18 18:27:44,2014-11-03 21:03:59
65129aac07022f23afa1df7ec7fad2216634cb38...02d78bb1a80706d941ffc6c892cc75208eb6b782,1,2,1,3,2,2015-03-18 22:46:06,2015-03-18 22:46:06
02d78bb1a80706d941ffc6c892cc75208eb6b782...81e1a35c364e5353d2bf99368ad30a4184fbb653,10,136,5,141,16,2015-03-18 23:00:09,2015-03-16 19:28:53
81e1a35c364e5353d2bf99368ad30a4184fbb653...9ddfe9b301d59c80808a7dca57138f90751176f1,4,17,1,18,5,2015-03-18 23:20:07,2015-03-04 12:49:12
9ddfe9b301d59c80808a7dca57138f90751176f1...1c83fc88d6928a5ab53bc3dde79dad3cc0bfcfdc,4,41,2,43,4,2015-03-18 23:20:07,2015-03-04 13:11:25
1c83fc88d6928a5ab53bc3dde79dad3cc0bfcfdc...011a54315e46acdf288003566b8570440f5ac985,5,68,2,70,8,2015-03-18 23:20:07,2015-03-10 00:05:13
011a54315e46acdf288003566b8570440f5ac985...e40581870a63a80fb5bbff5263b21a4fda1a7f93,1,29,0,29,1,2015-03-19 00:36:50,2015-03-19 00:36:50
