id,files,locs added,locs removed,locs total,hunks,commit time,author time
4b825dc642cb6eb9a060e54bf8d69288fbee4904...1de1d8a39fd89c1ab84cb352926e31bc6446b02a,9,1067,0,1067,9,2011-10-14 22:49:26,2011-10-14 22:49:26
1de1d8a39fd89c1ab84cb352926e31bc6446b02a...aa6f9386d9f3d5c8f36b8b28d96544cb0f448ab9,3,91,58,149,24,2011-10-14 23:11:42,2011-10-14 23:11:42
aa6f9386d9f3d5c8f36b8b28d96544cb0f448ab9...0d1ee8c09d8696774d4b3aa341ced3bf9bc9fa44,5,46,15,61,8,2011-10-15 09:23:31,2011-10-15 09:23:31
0d1ee8c09d8696774d4b3aa341ced3bf9bc9fa44...5285b1a9d467e1f6d5e4e307aeba8a22fe98f13e,8,194,116,310,21,2011-10-15 09:44:00,2011-10-15 09:43:54
5285b1a9d467e1f6d5e4e307aeba8a22fe98f13e...6050c1131141a710fbd7771ab20f41eea2688e3a,1,12,6,18,2,2011-10-15 09:48:03,2011-10-15 09:48:03
6050c1131141a710fbd7771ab20f41eea2688e3a...13c7a9285406e8204032e11435b01a95ab65ac96,8,12,12,24,12,2011-10-15 11:01:12,2011-10-15 11:01:12
13c7a9285406e8204032e11435b01a95ab65ac96...0e485bb1c5c9c34ce9a6e50f5ca2afa7b3f339cc,11,133,146,279,48,2011-10-15 11:21:13,2011-10-15 11:21:13
0e485bb1c5c9c34ce9a6e50f5ca2afa7b3f339cc...9ed3a255a71d689875bc0562cda6112f56845b71,2,106,59,165,4,2011-10-15 11:29:33,2011-10-15 11:29:33
9ed3a255a71d689875bc0562cda6112f56845b71...264d75564482e907a8de145acacb510910ef5d48,12,145,15,160,36,2011-10-15 12:02:17,2011-10-15 12:02:17
264d75564482e907a8de145acacb510910ef5d48...ef74dae5d8210c7efc873e13d2d3ea58336fe184,2,52,4,56,5,2011-10-15 12:13:20,2011-10-15 12:13:20
ef74dae5d8210c7efc873e13d2d3ea58336fe184...cd9a008559a553c73a7f8bb96bb50d2d14b5f42b,2,49,37,86,4,2011-10-15 12:18:28,2011-10-15 12:18:28
cd9a008559a553c73a7f8bb96bb50d2d14b5f42b...201dbaed57e7c18dbf440935918728043882fa3a,1,9,7,16,3,2011-10-15 18:44:52,2011-10-15 18:44:52
201dbaed57e7c18dbf440935918728043882fa3a...226257de226c3f9dc44677c6d9c91e62871e759a,6,69,51,120,19,2011-10-15 19:11:26,2011-10-15 19:11:26
226257de226c3f9dc44677c6d9c91e62871e759a...278660f00436fa21f05171f9efde3984347042c0,4,148,8,156,9,2011-10-15 19:56:49,2011-10-15 19:56:49
278660f00436fa21f05171f9efde3984347042c0...77d61ed2a02f53b09362ae41bd4d2092f450dfd8,1,2,1,3,1,2011-10-15 19:59:07,2011-10-15 19:59:07
77d61ed2a02f53b09362ae41bd4d2092f450dfd8...2f7ebbfcea12211d739d6eaa583c2de4bc799f2e,1,115,114,229,44,2011-10-15 20:01:45,2011-10-15 20:01:45
2f7ebbfcea12211d739d6eaa583c2de4bc799f2e...8b07a3b5e892cd38e3bd57a01d2e92dc86d7d0d5,1,39,0,39,1,2011-10-15 20:34:36,2011-10-15 20:34:36
8b07a3b5e892cd38e3bd57a01d2e92dc86d7d0d5...faca7e31dbf5c5ffea5eeb9e459f1ce04ad538f6,4,123,1,124,4,2011-10-16 20:11:38,2011-10-16 20:07:44
faca7e31dbf5c5ffea5eeb9e459f1ce04ad538f6...c7bdada5d12e6dc758c6745a9a8f9db4f6f83307,1,19,1,20,2,2011-10-16 20:12:34,2011-10-16 20:12:34
c7bdada5d12e6dc758c6745a9a8f9db4f6f83307...70fb097d6b7c0aaed75b0d6a2f4ca25a831b9105,4,132,65,197,27,2011-10-16 20:32:42,2011-10-16 20:32:42
70fb097d6b7c0aaed75b0d6a2f4ca25a831b9105...db1a336d84e6e705155e04a404ebc675b835ea88,1,1,2,3,1,2011-10-16 20:34:13,2011-10-16 20:34:13
db1a336d84e6e705155e04a404ebc675b835ea88...b8ea09347bac6e08c4ef50ebb783df3afb17b1ac,1,0,2,2,2,2011-10-16 21:05:01,2011-10-16 21:05:01
b8ea09347bac6e08c4ef50ebb783df3afb17b1ac...459123a8f3cedd7e2a030a682de84888f58e241c,1,16,6,22,6,2011-10-16 21:06:21,2011-10-16 21:06:21
459123a8f3cedd7e2a030a682de84888f58e241c...06f934bd0aa1f9c1a2b4327f0df8bfeb454f5953,2,155,165,320,44,2011-10-16 21:06:54,2011-10-16 21:06:54
06f934bd0aa1f9c1a2b4327f0df8bfeb454f5953...9a2c7246b7de77ca63e6a1c66033920652d775e5,2,10,10,20,3,2011-10-16 21:10:45,2011-10-16 21:10:45
9a2c7246b7de77ca63e6a1c66033920652d775e5...c9efa35efad318392624003935740abe57e7c7b3,1,41,0,41,1,2011-10-17 12:16:35,2011-10-17 12:16:35
c9efa35efad318392624003935740abe57e7c7b3...6ab7ca08530e722692d40d42dce395d136660111,2,9,2,11,3,2011-10-17 12:17:33,2011-10-17 12:17:33
6ab7ca08530e722692d40d42dce395d136660111...cade1ade9fd69294ab0489ef9dbb88f1bcc5f9a5,1,1,1,2,1,2011-10-17 12:18:14,2011-10-17 12:18:14
cade1ade9fd69294ab0489ef9dbb88f1bcc5f9a5...d971e45ad7eba5fc72fc6c562283a54e23010121,22,8,8,16,7,2011-10-17 12:26:36,2011-10-17 12:26:36
d971e45ad7eba5fc72fc6c562283a54e23010121...47112d2edcc4183fef3751d580ef3b2592414846,1,15,1,16,2,2011-10-17 12:47:11,2011-10-17 12:47:11
47112d2edcc4183fef3751d580ef3b2592414846...edfc5302d8cf746bad18499edf4c7f08b21bc6b8,4,299,0,299,4,2011-10-17 19:16:58,2011-10-17 19:16:58
edfc5302d8cf746bad18499edf4c7f08b21bc6b8...4baf28adf7f8bf9fdf41a0bd636598e143e0d5b7,1,1,1,2,1,2011-10-17 19:19:41,2011-10-17 19:19:41
4baf28adf7f8bf9fdf41a0bd636598e143e0d5b7...cf73d81a87b94ed36e4f70cd87a73475d99dee3a,1,1,1,2,1,2011-10-17 19:25:20,2011-10-17 19:25:20
cf73d81a87b94ed36e4f70cd87a73475d99dee3a...d934904056995803e4dd4c854921915cd2611495,1,5,2,7,3,2011-10-17 19:38:07,2011-10-17 19:38:07
d934904056995803e4dd4c854921915cd2611495...5473a8f5af5f8d2f21e30aaec5d89dfc9d0555f1,1,3,18,21,5,2011-10-17 19:39:43,2011-10-17 19:39:43
5473a8f5af5f8d2f21e30aaec5d89dfc9d0555f1...52897b8b521d4083976035b920c88ed9620f9c18,1,1,1,2,1,2011-10-17 19:44:33,2011-10-17 19:44:33
52897b8b521d4083976035b920c88ed9620f9c18...24533417c39783b4fdc633d412e89a1a24d87a98,1,11,24,35,3,2011-10-17 19:57:51,2011-10-17 19:57:51
24533417c39783b4fdc633d412e89a1a24d87a98...b2f2b931ae1bdbb0bec8173390128aff35b81b07,1,1,1,2,1,2011-10-17 20:12:34,2011-10-17 20:12:34
b2f2b931ae1bdbb0bec8173390128aff35b81b07...dc9e7ae8e6e2ed2bfd0825f2ae004aadb60b358d,1,1,1,2,1,2011-10-17 20:14:30,2011-10-17 20:14:30
dc9e7ae8e6e2ed2bfd0825f2ae004aadb60b358d...853896dc7f1e0aca11da7275bb13e2631baae225,1,2,2,4,2,2011-10-17 20:15:50,2011-10-17 20:15:50
853896dc7f1e0aca11da7275bb13e2631baae225...3f500ff4991901bcd20a834520d0a2f95a21e03c,1,3,2,5,2,2011-10-17 20:25:00,2011-10-17 20:25:00
3f500ff4991901bcd20a834520d0a2f95a21e03c...4c07fa0bb29322c59df4851229535d4c3345d353,2,169,0,169,2,2011-10-17 20:35:45,2011-10-17 20:35:45
4c07fa0bb29322c59df4851229535d4c3345d353...7a1685ed773ac44d45eb1f97f0abdfbe5e703c77,3,0,318,318,3,2011-10-17 20:46:26,2011-10-17 20:46:26
0ae2b0619888eea3767de79fc46f13faf74a3da4...abf51cc63af2f8c7f59992e46ffb10c2378eb2da,5,7,7,14,7,2011-10-18 12:39:40,2011-10-18 12:39:40
abf51cc63af2f8c7f59992e46ffb10c2378eb2da...92048ce55490b5a37026dfacdc611649a2328068,1,26,0,26,6,2011-10-19 12:00:28,2011-10-19 12:00:28
92048ce55490b5a37026dfacdc611649a2328068...5750941580fb5af72cb109bb566c46c5f02e5275,1,2,2,4,2,2011-10-19 12:00:58,2011-10-19 12:00:58
0ae2b0619888eea3767de79fc46f13faf74a3da4...1f4006ad5e413f8ebb9e794c9c3557eb8a657511,2,9,10,19,3,2011-10-17 21:25:14,2011-10-17 21:25:14
3f4f69afbafed90e906da7700b11e1b65f7e7cb9...3e6def385ca71b091b68efa5ee0d600b31fcce5d,2,71,0,71,2,2011-10-23 19:40:53,2011-10-17 19:23:04
3e6def385ca71b091b68efa5ee0d600b31fcce5d...844c78243625d6aa35f75acc56069e83321f9b58,3,106,16,122,6,2011-10-23 19:40:53,2011-10-18 09:14:01
844c78243625d6aa35f75acc56069e83321f9b58...ec5d905c48b1bd875757e764ae1dcd7349e84602,3,157,88,245,4,2011-10-23 19:40:53,2011-10-21 20:27:17
ec5d905c48b1bd875757e764ae1dcd7349e84602...3ab8593d6e38099a9a68b3bce1950c64046ee035,3,14,4,18,6,2011-10-23 19:40:53,2011-10-21 20:46:11
3ab8593d6e38099a9a68b3bce1950c64046ee035...c17355ea2e068ec6fae9dfb60fac96ce5bc81e21,3,87,1,88,5,2011-10-23 20:17:18,2011-10-23 20:17:18
c17355ea2e068ec6fae9dfb60fac96ce5bc81e21...c584886afd5ed1a51dbcdf18e96817c540c69526,4,75,40,115,7,2011-10-23 21:03:22,2011-10-23 21:03:22
c584886afd5ed1a51dbcdf18e96817c540c69526...1bf9752a74afaae059ff7c1b470828d4deae8893,6,53,69,122,27,2011-10-23 22:19:35,2011-10-23 22:19:35
1bf9752a74afaae059ff7c1b470828d4deae8893...92872470536dbeca7f7b497e8f1b45802efb1a9c,3,19,3,22,5,2011-10-23 22:30:48,2011-10-23 22:30:48
92872470536dbeca7f7b497e8f1b45802efb1a9c...900e81aed6be7641816f4f4c85cda7dc413375a9,1,2,2,4,2,2011-10-24 10:02:03,2011-10-24 10:01:31
900e81aed6be7641816f4f4c85cda7dc413375a9...2729d3a0a13d3048f90a88407861a38f5deaf703,1,5,0,5,2,2011-10-24 11:02:23,2011-10-24 11:02:23
2729d3a0a13d3048f90a88407861a38f5deaf703...158bf98bec96f9cf83816f620d66304cc9b60140,1,12,7,19,8,2011-10-25 08:55:13,2011-10-25 08:55:13
47d7aa289495458cc3143905a610736d430721ff...99fbd520ff7bb93953e4ad7db7438180fb345a23,1,2,2,4,1,2011-10-25 10:05:38,2011-10-25 10:05:38
4319b37d544458ed8b99b3cca1f479c0f0ca44c9...add655eca71228133b4e648b7dd815272063af88,23,0,47,47,23,2011-10-25 14:12:09,2011-10-25 14:07:48
add655eca71228133b4e648b7dd815272063af88...75e8ad03d5c718acdd3d8e4435ffe80a227f5708,2,24,0,24,2,2011-10-25 14:14:30,2011-10-25 14:12:42
75e8ad03d5c718acdd3d8e4435ffe80a227f5708...8c1a26909c22e1fe60e12a80c69d4f1be3fd8aef,1,8,3,11,4,2011-10-25 14:20:27,2011-10-25 14:20:15
8c1a26909c22e1fe60e12a80c69d4f1be3fd8aef...62c90723a850933dbdd4cae7edbd19c7cb49ecaa,1,2,0,2,2,2011-10-25 14:21:20,2011-10-25 14:21:20
62c90723a850933dbdd4cae7edbd19c7cb49ecaa...65cad9868babc33555f8f23a1540e45cdcf47be3,2,4,0,4,2,2011-10-25 14:57:44,2011-10-25 14:57:26
65cad9868babc33555f8f23a1540e45cdcf47be3...ccbf8553ac50d57c6f1f5407e06e79ffeafe4310,1,7,0,7,1,2011-10-25 16:38:55,2011-10-25 16:38:55
ccbf8553ac50d57c6f1f5407e06e79ffeafe4310...c852326dbd157ac700f896b2a6b73ac33014f783,5,24,30,54,10,2011-10-25 20:49:57,2011-10-25 20:49:57
c852326dbd157ac700f896b2a6b73ac33014f783...af23eb1ee7273c0ad217aa81f7c49251dd15ec63,2,23,24,47,2,2011-10-25 20:54:09,2011-10-25 20:54:09
af23eb1ee7273c0ad217aa81f7c49251dd15ec63...1a67776e1da77540b11d8523d61a700f8aa5bfdb,3,219,0,219,3,2011-10-29 20:56:44,2011-10-29 20:56:44
1a67776e1da77540b11d8523d61a700f8aa5bfdb...5ae33a24ba324b0e778705832e4c1b678dd2045e,2,8,4,12,5,2011-10-29 21:08:13,2011-10-29 21:08:13
097e846657c710f0e6081b0b29d626d1a4dc0bb5...e5e3713e666199d208b500c63b5790f13ecdcd56,1,11,1,12,2,2011-10-30 12:07:31,2011-10-30 12:07:31
e5e3713e666199d208b500c63b5790f13ecdcd56...b41c916f63d3e67187fea23eb4e0b53edd86be77,3,7,4,11,5,2011-10-30 12:21:35,2011-10-30 12:21:35
b41c916f63d3e67187fea23eb4e0b53edd86be77...cab6806ccefe09347e63324c29d21b776520c4fc,2,73,58,131,27,2011-10-30 12:26:51,2011-10-30 12:26:51
cab6806ccefe09347e63324c29d21b776520c4fc...94a289c020ec81a2cd401629afd85035152abff5,1,45,3,48,3,2011-10-30 12:48:18,2011-10-30 12:48:18
94a289c020ec81a2cd401629afd85035152abff5...45e4112bbb4a1977b0c920f3333e5dbe156beda5,3,208,0,208,3,2011-10-31 11:31:45,2011-10-31 11:31:45
0051acd04eda071187c1050718641c998a4d4e9c...97ca6c169a190de3dcc3d74e87ec4e8191fa2ad2,1,1,1,2,1,2011-11-03 13:49:03,2011-11-03 13:49:03
f1fbdf0b26f3a0e48e10d6eee6219646c06def4a...b2b8ec1032148680f522faae713208a13a9c18ec,1,2,2,4,2,2011-11-03 21:25:53,2011-11-03 21:25:53
b2b8ec1032148680f522faae713208a13a9c18ec...cdc4e2d0e69188eb2164019273a8da1fa0340416,1,1,1,2,1,2011-11-03 21:34:35,2011-11-03 21:34:35
cdc4e2d0e69188eb2164019273a8da1fa0340416...41631dce714515d7bf4d2282374dd32f9390daed,1,19,0,19,1,2011-11-09 13:14:34,2011-11-09 12:38:37
5583af67b6449d4b7f02d459844f56b93de9d7fd...4cbb536c9064f64c1b617827d53e40c40e58d94e,3,157,0,157,3,2011-11-10 10:40:10,2011-11-10 10:40:10
7fc838b0f14b085efa3bf30fdb8719bb3a5e8699...89b0bbb595d4ac93de48a77ef7ca16f3cc93ff94,2,5,2,7,3,2011-11-13 17:52:30,2011-11-13 17:52:30
10376e4542881eb739f0925590f0f70d15181a7a...85ad899a650095cc063a35619eff2e9e5d9d8857,3,107,0,107,3,2011-11-17 22:55:06,2011-11-17 22:55:06
85ad899a650095cc063a35619eff2e9e5d9d8857...fd5a338bf74fe91606213972f5df3eca56845988,3,44,44,88,9,2011-11-17 23:00:30,2011-11-17 23:00:30
3175a7588259616d65865ede86da1e20498e07a4...b7f9b616b01bef94db3b4ec29ddc89e9282f1401,3,9,9,18,9,2011-11-28 20:36:33,2011-11-28 20:36:33
b7f9b616b01bef94db3b4ec29ddc89e9282f1401...2b5320482e1590c04f31737e40b7cc7c59b8eda5,1,2,2,4,2,2011-11-28 20:39:44,2011-11-28 20:39:44
2b5320482e1590c04f31737e40b7cc7c59b8eda5...9692e0cfcd4f5f402419a9b038add762fd8d2d57,1,1,1,2,1,2011-11-28 21:21:16,2011-11-28 21:21:16
3175a7588259616d65865ede86da1e20498e07a4...c2217ee13fe8d8d709da7a982253bccbd232407b,1,1,1,2,1,2011-11-28 13:09:46,2011-11-28 13:09:46
289f11824aacd7071a48423630b2dad0a34270da...72584f9296f4118395eee38ee010917da099e15c,1,1,1,2,1,2011-12-04 09:47:27,2011-12-04 09:47:27
1583909943210bfe8f80179fbaa54f567ea3fdc3...b2dcf4ddab0fd9877f29c6e9d930e68bf875fc51,4,291,291,582,4,2011-11-28 16:08:31,2011-11-28 16:08:31
b2dcf4ddab0fd9877f29c6e9d930e68bf875fc51...11b2af2c7adc52218c2ce57d5fcb5575b79c8ca9,4,268,0,268,4,2011-11-29 23:05:09,2011-11-29 22:58:12
11b2af2c7adc52218c2ce57d5fcb5575b79c8ca9...68e5ff89fe5bf7281135e755ed504ca1d3222c4b,1,3,3,6,3,2011-11-30 00:33:34,2011-11-30 00:33:34
68e5ff89fe5bf7281135e755ed504ca1d3222c4b...17a8d285e3fac14a401adedb7921bd04980cc004,1,2,2,4,2,2011-11-30 00:40:21,2011-11-30 00:40:21
17a8d285e3fac14a401adedb7921bd04980cc004...557b40a8218e1a418e5ff2b996da18acf38b072a,1,3,3,6,2,2011-11-30 00:41:52,2011-11-30 00:41:52
557b40a8218e1a418e5ff2b996da18acf38b072a...3852c30a66d74cf8397d3921f92024100e756c36,1,3,3,6,3,2011-11-30 07:46:30,2011-11-30 07:46:30
3852c30a66d74cf8397d3921f92024100e756c36...3a9422dcbdad89116712fdfdcade41225f6669c6,1,6,6,12,1,2011-11-30 07:50:12,2011-11-30 07:50:12
8c34d25c03aed36bf093707ff040d9e8acd9b07f...293e9c7fce4c748efd038a2973556082c8d8c1fe,3,260,0,260,3,2012-01-15 13:02:27,2012-01-15 13:02:27
ab039705a1526d27dc34fcee584d582bd73d9b2e...e9a0d5a108816c5931b93193f8177105c56f2e80,1,1,1,2,1,2012-01-27 12:17:21,2012-01-27 12:17:21
c2fc0492e5841eedc3e646ba42d6d152dda7f15c...e025d618f58f54176c16c83f260ef585c7321c8b,3,146,0,146,3,2012-02-03 14:56:32,2012-02-03 14:56:32
b42269d8e403203030ecbd9456971a26776ae0d9...5f80b5e759cbaa0bcb26de9d76d20840f0dd2513,12,492,492,984,46,2012-02-08 20:27:16,2012-02-08 20:27:16
5f80b5e759cbaa0bcb26de9d76d20840f0dd2513...e21185aac343581bdfacd9696d14f4590c19af3e,1,2,4,6,2,2012-02-08 20:30:34,2012-02-08 20:30:34
e21185aac343581bdfacd9696d14f4590c19af3e...5019309441c0162cd714da8f5a7207891cca7946,4,292,0,292,4,2012-02-09 12:50:14,2012-02-09 12:50:14
297943fa192807fc65702b1b828bceb3a94ee6d4...73180ceac463e80bcda2541a0b80a71a4ea508eb,2,35,7,42,8,2012-02-10 17:31:55,2012-02-10 17:31:55
73180ceac463e80bcda2541a0b80a71a4ea508eb...ab426e0253a1fe41fd6077df86f34fb0a2ca65a8,2,2,2,4,2,2012-02-10 17:33:31,2012-02-10 17:33:31
ab426e0253a1fe41fd6077df86f34fb0a2ca65a8...b6760d4a924bed61cc0c5e3ea2d3aec34df9e1a3,2,285,0,285,2,2012-04-07 15:23:34,2012-04-07 15:23:34
9bbbed2ec66dada6117b0a3dc3b4a41c1af03a10...9a60f901d678557f79235b09eff8ebd1ea5fa076,1,16,0,16,1,2012-04-07 20:02:15,2012-04-07 20:02:15
9a60f901d678557f79235b09eff8ebd1ea5fa076...5cc1162da19b8900f092882b6bb0acd675836af9,3,53,1,54,3,2012-04-14 17:50:13,2012-04-14 17:50:13
5cc1162da19b8900f092882b6bb0acd675836af9...b5859dc8706f11d9ad0625cd00a1c6d797cc42ff,5,117,4,121,6,2012-04-14 18:36:37,2012-04-14 18:36:37
b5859dc8706f11d9ad0625cd00a1c6d797cc42ff...bc9fb6566a4ebd5e3a3971080db39882f3383835,2,10,0,10,3,2012-04-14 19:00:50,2012-04-14 19:00:50
bc9fb6566a4ebd5e3a3971080db39882f3383835...9ce05970b4ab30c370bde7f0606821e9739c8a58,2,49,6,55,5,2012-04-14 19:01:39,2012-04-14 19:01:39
9ce05970b4ab30c370bde7f0606821e9739c8a58...606ee1a98161ff79776a06b5c11a39440980ea55,1,16,0,16,2,2012-04-14 19:25:47,2012-04-14 19:25:47
606ee1a98161ff79776a06b5c11a39440980ea55...a2fc51082116ca4cfde74b379351db915211f9a0,2,61,0,61,2,2012-04-14 19:26:19,2012-04-14 19:26:19
a2fc51082116ca4cfde74b379351db915211f9a0...ebcc92bf4850077978f6cee129efb723c3a8d757,3,85,3,88,9,2012-04-14 21:54:05,2012-04-14 21:54:05
ebcc92bf4850077978f6cee129efb723c3a8d757...276ac17000ae0cacef9f73f74b600827904121c7,5,362,0,362,5,2012-04-17 05:18:03,2012-04-17 05:18:03
93ad20eb61f9b1aef188e5c2de99d1a651ef690e...3b93e2792564cc64c090694a6269c35b92ce22eb,1,7,0,7,1,2012-04-27 20:58:04,2012-04-27 20:58:04
3b93e2792564cc64c090694a6269c35b92ce22eb...a900ed3f85603a72dbd843f6f6dccb55ceef83e7,1,6,0,6,1,2012-04-27 21:15:40,2012-04-27 21:15:40
a900ed3f85603a72dbd843f6f6dccb55ceef83e7...a6589c64c33a9a4f16cac52c3f1ada710e1e6448,1,2,2,4,1,2012-04-27 21:53:52,2012-04-27 21:53:52
a6589c64c33a9a4f16cac52c3f1ada710e1e6448...3d64834a61f56f63375e6650395ecd10aed5897e,1,2,0,2,2,2012-05-30 06:14:51,2012-05-30 06:14:51
3d64834a61f56f63375e6650395ecd10aed5897e...95f27173e43fa1826da70dc77694d86db231cde6,1,1,1,2,1,2012-05-30 06:25:03,2012-05-30 06:25:03
95f27173e43fa1826da70dc77694d86db231cde6...6a8eb8e8e6e23af8ac3d7f1322a332af4fe791f9,1,1,1,2,1,2012-05-30 06:37:24,2012-05-30 06:37:24
a6589c64c33a9a4f16cac52c3f1ada710e1e6448...8f5575cd55919da11388e54da8e833a3b994b449,1,16,6,22,8,2012-05-25 14:44:14,2012-05-25 14:44:14
8f5575cd55919da11388e54da8e833a3b994b449...3d5dc3549150a282ba474a8f446896d960739839,1,14,0,14,1,2012-05-25 14:44:39,2012-05-25 14:44:39
3d5dc3549150a282ba474a8f446896d960739839...a4cedc870c06b22e1c5336be43729e3c42ede359,1,10,10,20,2,2012-05-25 14:57:04,2012-05-25 14:57:04
a4cedc870c06b22e1c5336be43729e3c42ede359...a3450aa96c4d954bff583322c3da3898358bbaf5,1,12,12,24,2,2012-05-25 14:58:45,2012-05-25 14:58:45
a3450aa96c4d954bff583322c3da3898358bbaf5...4ce21f98757ecf436754da9312bf61841939cb5a,1,2,2,4,2,2012-05-31 08:48:18,2012-05-31 08:48:18
4ce21f98757ecf436754da9312bf61841939cb5a...5bab0bc1581f317c9e57bfceaa6279d807e8b492,1,6,4,10,4,2012-05-31 08:50:32,2012-05-31 08:50:32
5bab0bc1581f317c9e57bfceaa6279d807e8b492...e9a90aec0b96cfe2ed31090ca27c7e0f49a4cafa,1,28,6,34,5,2012-05-31 09:06:04,2012-05-31 09:06:04
f6162c88c92b29268d30ff4c000b8b69bd4e372e...c513635dc71d3c603dd15b7913a22275fb35969e,2,7,7,14,7,2012-06-14 20:04:55,2012-06-14 20:04:55
f6162c88c92b29268d30ff4c000b8b69bd4e372e...6c399d3161812f12e651e1fc54d66334300cb836,1,56,2,58,2,2012-06-05 15:18:36,2012-06-05 15:18:28
6c399d3161812f12e651e1fc54d66334300cb836...055f4e9e8bb96363cc75333ad97452ae1957efd8,1,18,0,18,1,2012-06-05 19:22:25,2012-06-05 19:22:25
055f4e9e8bb96363cc75333ad97452ae1957efd8...1d8e4a79cf85d6e49f602f835384231944ee9f28,1,1,1,2,1,2012-06-05 19:33:25,2012-06-05 19:33:25
1d8e4a79cf85d6e49f602f835384231944ee9f28...b38f633534a8e5c388e1def181e75676b5aa7f24,2,45,0,45,8,2012-06-05 19:49:16,2012-06-05 19:49:16
b38f633534a8e5c388e1def181e75676b5aa7f24...4d9caf2a7b315d5edb8019e2e041a75d58005412,1,35,0,35,1,2012-06-08 18:36:44,2012-06-08 18:36:44
05afe8c4f26097f0beebdc3a164162c81ee2a0b9...67ced98695923556a37bc2d127a9c249640abedf,6,9450,0,9450,6,2012-06-19 13:55:23,2012-06-19 13:55:23
67ced98695923556a37bc2d127a9c249640abedf...0aaae23d698f3640e0f2c92245ec57f03c608ece,6,112,112,224,63,2012-06-19 14:26:38,2012-06-19 14:26:38
d1d44a5c196dc7f3c4404b1c3bdd268729173f33...2fa2cf821e2c0b887e8c7518084e9d1f61d40399,1,83,0,83,4,2012-07-01 08:00:15,2012-07-01 08:00:15
2fa2cf821e2c0b887e8c7518084e9d1f61d40399...a10417da99d65050abab0bfd067dce6b147cd46e,2,79,31,110,11,2012-08-09 17:01:07,2012-08-09 17:01:07
769817a3a1b4df66ed57f603f2225895e053a68b...5b572724c6995b9784e2a126282e54a9e3dc4d3e,2,17,0,17,2,2012-06-25 17:02:46,2012-06-25 17:02:46
8827d8f0ef9c8bc11ff420ff5dd202fefe3bbb64...560eeb87673d1ccd14b936691b6e8e1fe175bace,1,38,0,38,1,2012-08-13 07:30:06,2012-08-13 07:30:06
0aebc216d7b27611a36dfddba3537a11e87052ed...f3d296e385dd4a46a5ddf507539a6c150c32983e,2,131,26,157,18,2012-07-10 14:43:46,2012-07-10 14:43:46
f3d296e385dd4a46a5ddf507539a6c150c32983e...4aa432248bda4258585e7f6624a9789bac8e200e,1,13,1,14,2,2012-07-19 12:05:19,2012-07-19 12:04:14
e288d3ca6c163bfb1c9202e0985ea81257150ee8...350642dee0ccb2bba5db8b7548aa011dda94913d,1,1,1,2,1,2012-09-08 20:35:39,2012-09-08 20:33:16
6ea2a60df3405211dfc5719df991b82fb6dd0d1f...7483f75ef3d90078c9d1fbd5e5283774536bfbe0,8,359,0,359,8,2012-07-29 21:11:40,2012-07-29 21:11:40
7483f75ef3d90078c9d1fbd5e5283774536bfbe0...dd6a243ed5d88880b67f0019098ce939deb7fdfa,1,56,42,98,4,2012-07-29 21:42:49,2012-07-29 21:42:49
dd6a243ed5d88880b67f0019098ce939deb7fdfa...3f11bdb797f7c43928e3bd12d6d28280c0e38adf,1,6,5,11,1,2012-07-29 21:45:38,2012-07-29 21:45:38
3f11bdb797f7c43928e3bd12d6d28280c0e38adf...01be2751a9cf53e2549c73fa9b692962e74160c7,1,299,43,342,9,2012-07-29 22:22:37,2012-07-29 22:22:37
01be2751a9cf53e2549c73fa9b692962e74160c7...931032092f3368afddc64fe52ffb51e3ed181511,1,308,313,621,3,2012-07-29 22:31:53,2012-07-29 22:31:53
931032092f3368afddc64fe52ffb51e3ed181511...c5e556dcb29e9dd6e89bf84f6376df0ae77f1143,2,9,2,11,4,2012-07-29 22:34:21,2012-07-29 22:34:21
c5e556dcb29e9dd6e89bf84f6376df0ae77f1143...eeb0279a401af94cfa3e0c5d31c4e9704667193b,1,0,8,8,1,2012-07-29 22:40:54,2012-07-29 22:40:54
eeb0279a401af94cfa3e0c5d31c4e9704667193b...54055cc57dc7d4472402076c5dd4c4c8cd27d2de,1,7,2,9,3,2012-07-29 22:43:30,2012-07-29 22:43:30
54055cc57dc7d4472402076c5dd4c4c8cd27d2de...028b17275ebd219b99c855cb029f718dfc3d4810,1,7,1,8,1,2012-08-01 14:48:20,2012-08-01 14:48:20
028b17275ebd219b99c855cb029f718dfc3d4810...3ef1698d93c5bb5e2b260e69accaf0d93a9715de,1,4,4,8,4,2012-08-01 15:05:40,2012-08-01 15:05:40
3ef1698d93c5bb5e2b260e69accaf0d93a9715de...0499cc7b4ff9d6313d520e442defeafd881bc2a0,1,1,1,2,1,2012-08-02 12:16:14,2012-08-02 12:16:14
0499cc7b4ff9d6313d520e442defeafd881bc2a0...da590c68f678ffcc2633f260505834547d1e188a,2,0,24,24,2,2012-08-02 12:17:55,2012-08-02 12:17:55
da590c68f678ffcc2633f260505834547d1e188a...21ca591de44ac52239e2f4b302fe93b06d178d1c,1,0,1,1,1,2012-08-02 12:50:17,2012-08-02 12:50:17
5a88a2ecd0d61c0f8690f5a2c6552e2569284b81...7b55d00615c8a2029d29bfe5cfae2642e80d30e8,1,2,2,4,2,2012-09-17 17:28:21,2012-09-17 17:28:21
5a88a2ecd0d61c0f8690f5a2c6552e2569284b81...ba39896accdc6b49e538feda9ebaa79d4eb6567b,3,210,0,210,3,2012-09-14 15:53:16,2012-09-14 15:53:16
ba39896accdc6b49e538feda9ebaa79d4eb6567b...707cf049add79eeaf1983419b3431a118714cd37,1,0,1,1,1,2012-09-14 15:57:58,2012-09-14 15:57:58
a7b85d8a3dbec21b2d36ea05c633be827555d221...4acfeb719131f59142964f0c0facc8f0f1c34ed5,2,28,0,28,5,2012-09-04 07:19:47,2012-09-04 07:19:47
a7b85d8a3dbec21b2d36ea05c633be827555d221...c735e6b907aecf32062397920fa3f7f2f5c2e3df,2,8,0,8,2,2012-09-03 17:26:42,2012-08-14 13:03:02
63cab59c632b55896a0432ed13f29a62fc45d699...a2b1c8328afd87a667cf340fa6d386d37a405a38,1,1,1,2,1,2012-09-20 08:17:22,2012-09-20 08:17:22
cc2a254a5c49cb9c91ce41c5e195040809077765...07d7df09bb8fb8a2a754531f7aa75a2ce4e59ee2,1,1,1,2,1,2012-10-18 05:54:56,2012-10-18 05:54:56
7f1e1cda750c8e6bcd81361e5caa89f9b95dc743...6eabe13a276afa29b818a42ce93159ca2d7d1fb8,5,302,0,302,5,2012-12-17 18:23:00,2012-10-25 11:09:56
7f1e1cda750c8e6bcd81361e5caa89f9b95dc743...3d8b7d2d932e51b40976de5f840aae5d80a425a3,1,5,0,5,1,2012-10-27 12:28:53,2012-10-27 12:28:53
7f1e1cda750c8e6bcd81361e5caa89f9b95dc743...468dd5b726e2c8d4dc015edc3ba2f3c617b99238,1,24,2,26,5,2012-10-27 09:34:48,2012-10-27 09:31:55
468dd5b726e2c8d4dc015edc3ba2f3c617b99238...83fd81c0c0f130389ccd45b293fbd5858397b213,1,2,2,4,1,2012-10-27 09:34:48,2012-10-27 09:32:24
83fd81c0c0f130389ccd45b293fbd5858397b213...ab50ccf28cae76b0d15b0661d791b93ba2957124,1,12,9,21,9,2012-10-27 09:34:49,2012-10-27 09:34:05
ab50ccf28cae76b0d15b0661d791b93ba2957124...9e8d2b5548e1b71515ed43cc302edd35d6ac2bc2,2,40,0,40,2,2012-10-27 09:42:23,2012-10-27 09:42:23
a0fc7c2e0987ecaa5973360fc94c952e1ceaf14d...140b5d4d3f7bb81b300ad4f53fe5b11b45aa8dde,2,60,89,149,5,2013-01-01 15:09:45,2013-01-01 15:09:45
cdd97657c0950886f82637e62482e0b606786a88...3bf14b6cb8b98be3a3a3f9fed66ecb2517bf87ac,1,25,0,25,1,2012-10-29 09:32:06,2012-10-29 09:32:06
140b5d4d3f7bb81b300ad4f53fe5b11b45aa8dde...5d21a9e039ed0986ee3fc05bb50492535d91b28d,1,10,0,10,1,2013-01-09 07:38:39,2013-01-09 07:38:39
5d21a9e039ed0986ee3fc05bb50492535d91b28d...c3cd5ba33cf18cfceaa5fcb7930fcfc3d08691fb,2,7,2,9,2,2013-01-09 07:49:53,2013-01-09 07:49:53
140b5d4d3f7bb81b300ad4f53fe5b11b45aa8dde...3d6eb9133bc83846696b71fde53d700b1c921925,1,20,43,63,3,2013-01-02 12:17:12,2013-01-02 12:17:12
3bf14b6cb8b98be3a3a3f9fed66ecb2517bf87ac...5f01d2307ea25411585623773451d08fc896fd2a,5,251,0,251,5,2012-11-05 19:53:41,2012-11-05 19:53:41
5f01d2307ea25411585623773451d08fc896fd2a...6dfbe39bf65f3f9c79945ab98bcdb57de6a6aec7,4,103,100,203,18,2012-11-06 15:52:25,2012-11-05 19:53:41
f5a9a4f78db80320b64010591ac0120f80e45876...2c51fec4dc8c17be4c92969db3f20b39a4f898f8,1,2,2,4,2,2013-01-11 12:40:39,2013-01-11 12:40:39
9d7bf6177249873d978d85a170b67b7049032b2d...6d051d4c6c35c81bc733ecc5bd56baf12492b441,1,5,1,6,1,2013-01-25 14:40:42,2013-01-25 14:40:42
6d051d4c6c35c81bc733ecc5bd56baf12492b441...82f25551451f7af73012cf6c2ea14befe635c08d,2,94,12,106,11,2013-01-29 10:20:20,2013-01-29 10:20:20
82f25551451f7af73012cf6c2ea14befe635c08d...074ea0ac3865871777281ca8abfcc86c32ec6956,1,2,1,3,1,2013-01-29 11:31:25,2013-01-29 11:31:25
ce23e178073ecf3461d62c6d5440de4ba7a0f872...9010313f9ea67edb204a873fa140ab88970d6cfd,1,4,3,7,3,2012-11-07 12:43:31,2012-11-07 12:43:31
ce23e178073ecf3461d62c6d5440de4ba7a0f872...0befd599749667e933fc2021c9e335866f34ce97,1,3,2,5,3,2012-11-07 12:29:17,2012-11-07 12:29:17
85e375431996868ff2c8c866b47eac57d43e7c59...5a7439ad1e41ac89cf2d741f716b462affcb049c,1,1,1,2,1,2013-02-05 20:54:31,2013-02-05 20:54:31
85e375431996868ff2c8c866b47eac57d43e7c59...965367c8c44fb2c47027d0ffe6d5eed08c6613bd,2,76,0,76,2,2013-02-05 16:13:54,2013-02-05 16:13:54
965367c8c44fb2c47027d0ffe6d5eed08c6613bd...dc94119d7b50aff8ab6f4d671ee67b667f488fcf,1,3,6,9,3,2013-02-05 16:44:26,2013-02-05 16:44:26
ca507872dea511c99d9844dc5adecfc10bfe56f0...97a20cc7b993bfc109603323eb55485cdc164056,1,1,2,3,1,2012-11-07 20:54:47,2012-11-07 20:54:47
9fe1a478ad9b7f3ecf8a09e27e01127a37c5bd36...e82a86f8c1f3143b8db3f9a93165280368310564,1,8,1,9,1,2013-02-11 07:17:58,2013-02-11 07:17:58
e82a86f8c1f3143b8db3f9a93165280368310564...b21e325814dc32005a34444f491b0399176ad85c,1,1,0,1,1,2013-02-11 07:30:59,2013-02-11 07:30:59
b21e325814dc32005a34444f491b0399176ad85c...198a5f338a593cb0eb91e13589e8268d50182047,1,1,1,2,1,2013-02-11 09:40:36,2013-02-11 09:40:36
9fe1a478ad9b7f3ecf8a09e27e01127a37c5bd36...263bbfd9f4ada9cdf502e913555c57acffa19868,1,1,1,2,1,2013-02-08 09:50:24,2013-02-08 09:50:24
1a2901a780079aef1201a2c2d54b70fe37b02c3f...8a979bb5b98803786a2b3205e7e69e2041ba9188,1,1,1,2,1,2013-02-05 19:51:04,2013-02-05 19:51:04
8a979bb5b98803786a2b3205e7e69e2041ba9188...9362a18d60087afecc6542a2a3978e1b575ccf4c,1,2,1,3,1,2013-02-05 20:30:05,2013-02-05 20:30:05
9362a18d60087afecc6542a2a3978e1b575ccf4c...9870a9c9262bb8d10e97f53a8a81ef72db744554,1,2,2,4,1,2013-02-05 20:33:15,2013-02-05 20:33:15
9870a9c9262bb8d10e97f53a8a81ef72db744554...d24287d67a5296fdb08789ad31e4710806bfd2f8,1,1,1,2,1,2013-02-05 20:34:41,2013-02-05 20:34:41
d24287d67a5296fdb08789ad31e4710806bfd2f8...64cb2172c25d090f1e56b41bfc67a2ba1b53b3cd,2,5,1,6,2,2013-02-06 08:14:15,2013-02-06 08:14:15
42ad8700ed3a1fd923b237feccfbe4476b703303...ed8773047913b0fb3f629188131684de0e87343f,5,589,0,589,5,2012-11-09 20:01:51,2012-11-09 16:39:18
fe9c56fa5bc5761a626c5d41ae3168bff9e5660a...8bfb9b33c115b538a19fcc84d4d0978b723bca76,1,3,0,3,1,2013-02-18 18:58:05,2013-02-18 18:58:05
fe9c56fa5bc5761a626c5d41ae3168bff9e5660a...99038368d0338f36c5637aa7d014540ee73c4636,1,2,0,2,1,2013-02-18 01:03:03,2013-02-18 01:03:03
99038368d0338f36c5637aa7d014540ee73c4636...07f3d61ba110afbe7bf585e6b54c0e92f4c6b009,1,1,1,2,1,2013-02-18 01:10:31,2013-02-18 01:10:31
07f3d61ba110afbe7bf585e6b54c0e92f4c6b009...83a9b2bb19492d2c958b0cef3c9e6de4030cb9bf,1,2,1,3,1,2013-02-18 01:13:38,2013-02-18 01:13:38
83a9b2bb19492d2c958b0cef3c9e6de4030cb9bf...2be9bbef18ffd0993463451b260733cc8b239fb3,1,2,1,3,1,2013-02-18 01:14:09,2013-02-18 01:14:09
2be9bbef18ffd0993463451b260733cc8b239fb3...b8a3decbe3415a5a981210ef87e49dc20531409b,1,0,2,2,1,2013-04-30 09:17:16,2013-04-30 09:17:16
4508f34a793845acce34588534bce2d645bbf4c3...f7c80bec98d775c1ff6376ea0c3d40686c262178,4,78,7,85,10,2012-11-13 22:04:40,2012-11-10 19:22:01
4508f34a793845acce34588534bce2d645bbf4c3...ae8bdc81977abf8c7e988231d8cae43f50b43914,1,1,1,2,2,2012-11-12 19:03:53,2012-11-12 19:03:53
4508f34a793845acce34588534bce2d645bbf4c3...6bfc1a4e3b07e1df225f4c9cfb7c257ca7618469,59,278,299,577,192,2012-11-10 11:31:37,2012-11-10 11:31:37
e1df66d0903ffcbd4a305ab214e02d4536dcd123...6e563b81cc2887775d32aa6be35909db3ed78463,3,47,0,47,4,2013-02-20 13:59:46,2013-02-20 13:59:46
6108cba60e2bca334c5a0e4e70829562315c0287...532b1d6693c62d8f5e23ec17e93a4ce3cfddde07,1,22,22,44,8,2013-05-07 10:17:57,2013-05-07 10:17:57
7c234f6dccf5b0504420e0aaaa64d21610250260...0a89d8e66213389385e7bf035d5102e22e7a07f9,2,23,3,26,3,2012-11-15 15:42:37,2012-10-11 22:40:13
0a89d8e66213389385e7bf035d5102e22e7a07f9...3d453394dcea71deb12e263ca97537e18a83054e,9,19,14,33,15,2012-11-15 15:42:37,2012-11-09 23:24:29
5d0abf6d629e246f388f355738b90857be25c629...c16fbb1bc74173f3b86568cb327144897d7ffde5,1,2,6,8,1,2013-02-25 13:39:29,2013-02-25 13:39:29
5d0abf6d629e246f388f355738b90857be25c629...cfcf109dbb5671830cf75d15710705a23278739e,1,102,0,102,1,2013-02-22 12:00:44,2013-02-22 12:00:44
cfcf109dbb5671830cf75d15710705a23278739e...a7ff0a319fc9a34983e741b0e36f976842bbfa80,2,26,1,27,3,2013-02-25 11:08:36,2013-02-25 11:08:36
a7ff0a319fc9a34983e741b0e36f976842bbfa80...d3bbd39a6da4736ab45483ef24d3411a216abfee,1,14,0,14,1,2013-02-25 13:09:43,2013-02-25 13:09:43
d3bbd39a6da4736ab45483ef24d3411a216abfee...52dd699c84518399cd097aed414661dc96f0affb,1,13,0,13,1,2013-02-25 13:15:11,2013-02-25 13:15:11
52dd699c84518399cd097aed414661dc96f0affb...f66d1d9438fa74c6cc39b5573238e29d95ca755f,1,46,0,46,1,2013-02-25 13:19:33,2013-02-25 13:19:33
c2b06f9741106c35eb7e21dda4c72a54415277dd...f735772deb3464cad3d4704fe64b9feffdf720dd,1,178,0,178,1,2013-05-18 21:53:34,2013-05-18 21:53:34
f735772deb3464cad3d4704fe64b9feffdf720dd...a9d87ecf722745e5322b6faea6d57a3f87996b17,11,18,18,36,16,2013-05-18 21:54:46,2013-05-18 21:54:46
a9d87ecf722745e5322b6faea6d57a3f87996b17...d7cf342982f6b46c4e4ff7452942241c2c182d07,1,2,0,2,1,2013-05-18 21:56:04,2013-05-18 21:56:04
d7cf342982f6b46c4e4ff7452942241c2c182d07...7c1a1b90c29d21299fc44d17954333e4fe7d6412,1,43,35,78,25,2013-05-19 10:04:25,2013-05-19 10:04:25
7c1a1b90c29d21299fc44d17954333e4fe7d6412...8c93e70cc0febd8f9ef6d5dd274a9f732eb0cdd9,1,3,1,4,1,2013-05-19 10:09:13,2013-05-19 10:09:13
c2b06f9741106c35eb7e21dda4c72a54415277dd...fff49bb3ed7d66b8536f7f29d2665915e379e4df,2,320,69,389,7,2013-05-18 15:30:43,2013-05-18 15:30:43
fff49bb3ed7d66b8536f7f29d2665915e379e4df...9ef7d037615e115b71ce9b6cca9e988253facc3e,1,10,12,22,10,2013-05-18 15:39:10,2013-05-18 15:39:10
c2b06f9741106c35eb7e21dda4c72a54415277dd...2a8258728b8dd710b8807e63a26307505c2a9442,10,7,18,25,10,2013-05-18 14:53:58,2013-05-18 14:53:58
2a8258728b8dd710b8807e63a26307505c2a9442...b65b77694da6fb9f5766e5684c2a05ae9049c880,1,2,0,2,1,2013-05-18 14:58:28,2013-05-18 14:58:28
b19c26914119c22610589c72e3e89f3e94aa78c0...88d35688abe3d882507673814a45a4aae65e93b2,4,255,0,255,4,2012-11-23 09:01:29,2012-11-23 09:01:29
88d35688abe3d882507673814a45a4aae65e93b2...ab55d8f488a06085bdad12c5efa5cfda708ed5fd,1,3,3,6,3,2012-11-23 09:10:40,2012-11-23 09:10:40
d2bd9144075c0bb05fc14844e1446c2054b5da66...30e7cd679643b5b5664991205477a03a4cdcec87,12,19,16,35,17,2013-03-04 13:45:36,2013-03-04 13:45:36
30e7cd679643b5b5664991205477a03a4cdcec87...b3ebffeeeda3fa4e6914f466aef13ad15be5c207,1,15,14,29,2,2013-03-04 13:53:07,2013-03-04 13:53:07
b3ebffeeeda3fa4e6914f466aef13ad15be5c207...b7b8b5cb43a038e6356eacdaf8c170b4e3872639,1,3,13,16,4,2013-03-04 16:32:57,2013-03-04 16:32:57
d2bd9144075c0bb05fc14844e1446c2054b5da66...df2c644392ab09fa4c38080006e9900b0357c654,1,1,0,1,1,2013-03-01 20:17:31,2013-03-01 20:17:31
d2bd9144075c0bb05fc14844e1446c2054b5da66...52a5863abcaf3c4aebfd92209dc017bdfd2bf5ba,1,28,0,28,1,2013-02-28 20:51:49,2013-02-28 20:51:49
52a5863abcaf3c4aebfd92209dc017bdfd2bf5ba...ba8ab2e3efefd0cebd753abca5884912c8156644,1,696,15,711,6,2013-03-08 09:48:53,2013-03-08 09:48:53
9dcef6d70de4b1073b1c233d5e728f01da72d03d...ca49cc2c39387eaba31078aa95f0c65d50ebab5b,1,178,0,178,1,2013-05-20 18:50:10,2013-05-18 21:53:34
ca49cc2c39387eaba31078aa95f0c65d50ebab5b...6112cb12a83b506ee3ff2ab06904edecf11ad847,11,18,18,36,16,2013-05-20 18:50:11,2013-05-18 21:54:46
6112cb12a83b506ee3ff2ab06904edecf11ad847...f22ac9e0831674fecea187b42d36ced58664a693,1,2,0,2,1,2013-05-20 18:50:11,2013-05-18 21:56:04
f22ac9e0831674fecea187b42d36ced58664a693...2050a80dca8e9c2d4ccda28ed63e17aa69d1c4f4,1,43,35,78,25,2013-05-20 18:50:11,2013-05-19 10:04:25
2050a80dca8e9c2d4ccda28ed63e17aa69d1c4f4...cc6f84d99e0f3809267ff450e1824a78b946513e,1,3,1,4,2,2013-05-20 18:51:31,2013-05-19 10:09:13
7b0f8cf831e53f48141b464c2210e64bbca01372...585d999e875b6d9f9c80cee456226d1c566af87a,1,0,46,46,1,2013-06-09 17:20:07,2013-06-09 17:20:07
585d999e875b6d9f9c80cee456226d1c566af87a...bb0e622d1ed10ce62df2a05e9b572f745914a1a7,1,46,0,46,1,2013-06-09 17:55:57,2013-06-09 17:55:57
129063060cbbc701e380fa5f52762c95f932aab3...9df7d34393bdc2b76780243a9a4af3c201249198,4,331,0,331,4,2012-11-23 16:08:50,2012-11-23 16:08:50
9df7d34393bdc2b76780243a9a4af3c201249198...fcc066fbf25c31dd3e6ae9881e5e261fe79d49bd,3,154,154,308,13,2012-11-26 14:02:13,2012-11-26 14:02:13
a1fd779b525c6a7669c136d23ca9c8130e4441b8...3afbf00a907110089a5a636bea6af960a1c45506,5,485,0,485,5,2013-04-19 11:45:41,2013-04-19 11:45:41
3afbf00a907110089a5a636bea6af960a1c45506...5f80a093462add7b032bb119343eb37d6bbd73b8,3,8,15,23,9,2013-04-22 21:41:11,2013-04-22 21:41:11
a1fd779b525c6a7669c136d23ca9c8130e4441b8...f43ce85625ee0be0250af845b674b21b99eb38d0,2,84,0,84,2,2013-03-12 15:52:02,2013-03-12 15:52:02
f43ce85625ee0be0250af845b674b21b99eb38d0...a82e690bf70301c089d6f96f2dc35ddeb42c7bcf,1,8,0,8,4,2013-03-12 16:23:56,2013-03-12 16:23:56
a82e690bf70301c089d6f96f2dc35ddeb42c7bcf...dce4fd3e02c973032b769e32bb0b627fcc5a52c7,1,1,1,2,1,2013-03-12 16:55:47,2013-03-12 16:55:47
dce4fd3e02c973032b769e32bb0b627fcc5a52c7...c31319ec6b7e887177413314f60ad51ce0c21bbf,1,0,5,5,2,2013-03-12 16:58:04,2013-03-12 16:58:04
e279febfbdf850415a8dfecddcaaccd668dd1d72...56170d7337dbd31be759820aa1dfbe76dee927bb,1,6,0,6,1,2013-03-08 09:53:50,2013-03-08 09:53:50
56170d7337dbd31be759820aa1dfbe76dee927bb...8e59320826df100876708673c74a8d52b2177381,1,0,146,146,17,2013-03-08 10:02:48,2013-03-08 10:02:48
8e59320826df100876708673c74a8d52b2177381...0be08bd1e98d659522adba0ec10f1345bf995fb9,1,0,1,1,1,2013-04-22 08:40:17,2013-04-22 08:40:17
0be08bd1e98d659522adba0ec10f1345bf995fb9...c5165afab7a87440044ab29a22c5238fbd09f631,1,2,2,4,1,2013-04-22 08:42:04,2013-04-22 08:42:04
202c8517478011464e0e50923cab2bcd6344453b...1615531dc92d53aa56c0b733482da3889370539f,1,85,2,87,2,2013-05-29 13:19:11,2013-05-29 13:19:11
3a2868964a1bcb96b500c04de053de35ffacc143...4ad4bc4b5c8d3c0f3cf55d2fedc2f65b313ec62f,1,1,1,2,1,2013-06-09 18:05:57,2013-06-09 18:05:57
70c116bc33b4d429288f69abf3b0b3834af5a284...b0b6eb6029af2281742ff4375e945a6297f317a9,5,534,0,534,5,2012-12-01 18:52:23,2012-12-01 18:52:23
b0b6eb6029af2281742ff4375e945a6297f317a9...fac7a27e352522c904777bad79b7178ae3d82a06,1,58,0,58,1,2012-12-03 17:21:27,2012-12-03 17:21:27
fac7a27e352522c904777bad79b7178ae3d82a06...3ace02cfc40765a12381abf2c56316a6595dde2c,2,27,4,31,5,2012-12-03 18:06:42,2012-12-03 18:06:42
3ace02cfc40765a12381abf2c56316a6595dde2c...d311285a0f4c84366f02f320b688320c7ffc548d,5,111,111,222,33,2012-12-03 18:12:09,2012-12-03 18:12:09
d311285a0f4c84366f02f320b688320c7ffc548d...66a84156d39748d7afc5120c61edd19ce07176ca,1,0,6,6,1,2012-12-12 18:00:37,2012-12-12 18:00:37
66a84156d39748d7afc5120c61edd19ce07176ca...20f64107db465ca2c1d2abee02b6200a6ff0273a,1,0,16,16,1,2012-12-12 18:28:21,2012-12-12 18:28:21
20f64107db465ca2c1d2abee02b6200a6ff0273a...0d9262a90b4a18937370982c8ba22f620d76afbe,1,0,5,5,1,2012-12-12 19:05:33,2012-12-12 19:05:33
0d9262a90b4a18937370982c8ba22f620d76afbe...03c2656d05313af458199ba3c0fd141bea2d325a,1,3,10,13,4,2012-12-12 19:20:23,2012-12-12 19:20:23
03c2656d05313af458199ba3c0fd141bea2d325a...7b0cb531b2c9df0750eb330aa2f1da7ce06e61fb,2,5,5,10,5,2012-12-12 19:35:08,2012-12-12 19:35:08
70c116bc33b4d429288f69abf3b0b3834af5a284...af4b341fee11c5d9c880de7b9c06c0b5849d4e81,5,332,0,332,5,2012-12-01 18:04:12,2012-12-01 18:04:12
af4b341fee11c5d9c880de7b9c06c0b5849d4e81...1332f482ce758607b72aaf80ad1e4d4b0af37b44,1,2,1,3,1,2012-12-01 18:09:13,2012-12-01 18:09:13
1332f482ce758607b72aaf80ad1e4d4b0af37b44...fabe75246465faba392d59d1720ecec884e38f10,2,4,4,8,4,2012-12-22 14:15:12,2012-12-22 14:15:12
fabe75246465faba392d59d1720ecec884e38f10...478b95d8a3bb17b42bef83d99c8da9b69013aeb7,1,0,1,1,1,2012-12-22 14:22:43,2012-12-22 14:22:43
478b95d8a3bb17b42bef83d99c8da9b69013aeb7...5eaec69fcd2ff28ece033e83e3ac27166e8d304f,1,2,2,4,2,2012-12-22 14:41:14,2012-12-22 14:41:14
70c116bc33b4d429288f69abf3b0b3834af5a284...227862223e2be95c0a0494a487e44a53039c6fea,1,41,0,41,1,2012-11-30 11:16:31,2012-11-30 11:16:31
227862223e2be95c0a0494a487e44a53039c6fea...6054a705d1ef0d7c0da23bd7cc2c54636b444430,1,4,4,8,4,2012-11-30 11:52:56,2012-11-30 11:52:56
6054a705d1ef0d7c0da23bd7cc2c54636b444430...28d1dad66ac13415bf58a4c22839086825b18018,1,133,0,133,1,2012-12-10 13:17:09,2012-12-10 13:17:09
28d1dad66ac13415bf58a4c22839086825b18018...12820746df622d9efbf7c9970bf973d40b6f981b,2,18,2,20,3,2012-12-10 13:25:47,2012-12-10 13:25:47
12820746df622d9efbf7c9970bf973d40b6f981b...82495bc7a1e5e059b31fe3608daefbd52e4b8058,1,1,1,2,1,2012-12-10 13:31:48,2012-12-10 13:31:48
82495bc7a1e5e059b31fe3608daefbd52e4b8058...1f638a8947e00b4fe1e4a877c91460731b75079b,2,0,133,133,3,2012-12-10 14:37:44,2012-12-10 14:37:44
1f638a8947e00b4fe1e4a877c91460731b75079b...591a03e6044d8f1e82ed5af721bb3f10e479a1d9,1,2,2,4,2,2012-12-10 15:08:20,2012-12-10 15:08:20
70c116bc33b4d429288f69abf3b0b3834af5a284...471e77788f92d41ad7579a9730a153a5b0f38447,6,0,0,0,0,2012-11-29 22:54:14,2012-11-29 22:54:14
c09176c838f30da83ba9e509151d055c0bb837c8...ef04c7b8a39c1a3314045b74365e5d505f170dea,5,221,0,221,5,2013-05-31 12:00:51,2013-05-31 12:00:51
4ad4bc4b5c8d3c0f3cf55d2fedc2f65b313ec62f...c23e499e83666a20dd282c40fa2ad1b90c6ce477,2,9,1,10,2,2013-06-18 19:41:01,2013-06-18 19:41:01
c23e499e83666a20dd282c40fa2ad1b90c6ce477...4449b625d2d93d209792a6c6dd208c3e30580080,1,2,1,3,1,2013-06-19 06:50:52,2013-06-19 06:50:52
4ad4bc4b5c8d3c0f3cf55d2fedc2f65b313ec62f...ecd58f02176dce18c170c2cd038d58f08ac02c55,3,57,0,57,4,2013-06-16 22:20:30,2013-06-16 22:20:30
ecd58f02176dce18c170c2cd038d58f08ac02c55...6f7f40693c6288a019bc8d7748654dd446a492d1,1,7,1,8,3,2013-06-16 22:23:01,2013-06-16 22:23:01
6f7f40693c6288a019bc8d7748654dd446a492d1...ec0566a352a88b3cc31e9d81fefdc06acd9ecb01,1,1,1,2,1,2013-06-16 22:25:48,2013-06-16 22:25:48
ec0566a352a88b3cc31e9d81fefdc06acd9ecb01...99024404da7cffdfaceb2bb7b8cd4907ed2bdfcc,5,164,63,227,7,2013-06-16 23:22:10,2013-06-16 23:22:10
99024404da7cffdfaceb2bb7b8cd4907ed2bdfcc...9ce3d44ea260e9bc5260a674bdc616b01346444d,2,8,14,22,9,2013-06-16 23:29:06,2013-06-16 23:29:06
9ce3d44ea260e9bc5260a674bdc616b01346444d...e088a2e625dc97ab7437dcf4e879d1cc1155f0ea,3,15,0,15,3,2013-06-16 23:35:10,2013-06-16 23:35:10
e088a2e625dc97ab7437dcf4e879d1cc1155f0ea...6d30f63245ba510b7cf09f9c3d91133beca424f5,1,9,14,23,3,2013-06-17 18:58:42,2013-06-17 18:58:42
6d30f63245ba510b7cf09f9c3d91133beca424f5...af3e337e1cfcbf3ae0bf83bba73e9d20c8c95c47,1,1,8,9,1,2013-06-18 12:00:06,2013-06-18 12:00:06
af3e337e1cfcbf3ae0bf83bba73e9d20c8c95c47...ad3573e1046a7981b0d9623356fa66c069b2af02,2,8,17,25,2,2013-06-29 08:10:58,2013-06-29 08:10:58
ad3573e1046a7981b0d9623356fa66c069b2af02...cba7a8e37aaf834b78a01f0f8602a5e33eb0a84d,1,0,0,0,0,2013-06-29 08:11:25,2013-06-29 08:11:25
379494fa95cfdef5e1ffecf94be18ce86ad0d941...7c2682780204fc1da1e0e0319c8ae88aeee95a3f,99,5946,15115,21061,364,2012-12-10 15:03:57,2012-12-10 15:03:57
46a5171fe2ca571943636c7d79f70fdf6c28df04...91e87aa0e089e285fa94c5a5b4a3a0b351fe9ccc,5,174,21,195,19,2012-12-18 19:37:52,2012-12-18 19:37:52
9a61d6fa016597fd7b6c273b8baa54ce163c2643...a35ab4064aa73e847b79de21417a55cbe9bd1f9a,3,32,32,64,7,2012-12-10 15:15:00,2012-12-10 15:15:00
a35ab4064aa73e847b79de21417a55cbe9bd1f9a...d44f1340d9b5a18fd31fa86e3ac9040f3f4b9ae3,4,45,42,87,16,2012-12-10 15:17:57,2012-12-10 15:17:57
5d660b794d803514fc09a3e25cbf839cfed7c2fa...b27d96a4e9487a27b12e2df39a1af418b9b3955f,31,1154,1151,2305,144,2013-07-01 12:54:02,2013-07-01 12:54:02
b27d96a4e9487a27b12e2df39a1af418b9b3955f...cf749f1e40950873726ba437cbd36f1a5a1d5ad1,2,4,7,11,4,2013-07-01 12:57:31,2013-07-01 12:57:31
5b1075c13f5309242931214ee67a5f7c5af718d5...f8f12a38bc8f1dbece730c252a8972373a368d70,1,3,3,6,3,2012-12-21 14:28:12,2012-12-21 14:28:12
d44f1340d9b5a18fd31fa86e3ac9040f3f4b9ae3...a52a44508bbed675f549e9681785b52e27fad7c3,1,1,1,2,1,2012-12-12 08:00:07,2012-12-12 08:00:07
d44f1340d9b5a18fd31fa86e3ac9040f3f4b9ae3...5a153a9b5821530c33ba8dd89784acb7f1795de6,1,9,1,10,3,2012-12-10 16:30:54,2012-12-10 16:30:54
cf749f1e40950873726ba437cbd36f1a5a1d5ad1...4f57d3f8dcaf1ee8ef250d5a01415c6dccee5cb0,1,0,2,2,1,2013-07-04 22:44:36,2013-07-04 22:44:36
4f57d3f8dcaf1ee8ef250d5a01415c6dccee5cb0...cf4a23db11391c16f76b34e5a46ee674a49722ed,14,18,21,39,20,2013-07-04 22:57:11,2013-07-04 22:57:11
4a1e258d06f463e871f77d19cce822799f9d4d28...b502129bd10799c15eae4e991bdb44b6f6500d8b,1,2,2,4,2,2013-01-01 14:48:30,2013-01-01 14:48:30
b502129bd10799c15eae4e991bdb44b6f6500d8b...3fccf09ae1db2ac2d0ecf830e87ee49a648ab2c5,2,3,2,5,3,2013-01-01 14:51:54,2013-01-01 14:51:54
3fccf09ae1db2ac2d0ecf830e87ee49a648ab2c5...1b7f8bd3b53a3787da77f9a5bf962170c49652be,1,1,1,2,1,2013-01-01 14:52:18,2013-01-01 14:52:18
1b7f8bd3b53a3787da77f9a5bf962170c49652be...a3ae3c9a4362f883d6a0cf76f72a5d5851cba2d3,2,13,5,18,6,2013-01-01 14:57:55,2013-01-01 14:57:55
a3ae3c9a4362f883d6a0cf76f72a5d5851cba2d3...f4ea7262079eeda656c64fd59af4899d68cb6ad1,3,8,4,12,6,2013-01-01 15:02:18,2013-01-01 15:02:18
bf1935ac6035c75cf35e158697c6c864ce54548e...68b25ce6b9cd775bef49136363de0190ea68fd09,4,104,0,104,4,2013-07-05 17:08:12,2013-07-05 17:08:12
5ba95d8db57e7f966c226b142f357d83e6366351...8b9bb44bbf864a63c2eece6744fc40240877b0c6,1,1,1,2,1,2013-07-08 09:31:33,2013-07-08 09:31:33
8b9bb44bbf864a63c2eece6744fc40240877b0c6...c622984c4e49cb6852c7cafd3f78dc02346251e1,1,384,25,409,4,2013-07-09 09:52:09,2013-07-09 09:52:09
8b9bb44bbf864a63c2eece6744fc40240877b0c6...1f25f9e8afa78f3620bd8d7f24556b8e820755a6,1,44,0,44,1,2013-07-09 00:51:41,2013-07-09 00:51:41
1f25f9e8afa78f3620bd8d7f24556b8e820755a6...533b83f8cd7fa6fc47208a4043652b91a7f4860d,1,1,1,2,1,2013-07-09 00:54:26,2013-07-09 00:54:26
e8cff786aa172a667118100a7972bed54f5af961...baa8e362e8ed30ecdcdca6fc6a96196e436799d6,4,206,0,206,4,2013-07-10 13:38:56,2013-07-10 13:33:23
baa8e362e8ed30ecdcdca6fc6a96196e436799d6...a1a989a7cf28574e14eeb63c1fb3cba19ded2db6,1,24,0,24,1,2013-07-11 10:56:35,2013-07-11 10:56:35
a1a989a7cf28574e14eeb63c1fb3cba19ded2db6...aff81d3075d9b48ed64f1cf61cc2534002ea380e,1,10,0,10,1,2013-07-11 11:14:06,2013-07-11 11:14:06
00c5baf90f20dd1bff1a0867b7aaa2a73ffa8510...2028e09d2f5426d96f83967455bbd9a7c2e3dd7e,5,255,0,255,5,2013-07-15 02:42:03,2013-07-14 08:25:42
2028e09d2f5426d96f83967455bbd9a7c2e3dd7e...c12b586e9f6edf331941a4d1cc274a57db06cf3c,1,1,1,2,1,2013-07-15 02:42:03,2013-07-15 00:35:18
3613b1466d5e9518b83f87d828f93f962ff0f997...f8c77b4f5e496868de44b039f482c2a38007d95d,1,1,1,2,1,2013-08-06 17:19:59,2013-08-06 17:19:59
3613b1466d5e9518b83f87d828f93f962ff0f997...1adf389d84346508dab2f1ed7d5efd79b5ad9272,1,179,0,179,1,2013-07-28 06:42:14,2013-07-28 06:42:14
1adf389d84346508dab2f1ed7d5efd79b5ad9272...416e451328988fd612fec87882a7e20fe922621b,1,5,13,18,5,2013-07-28 07:13:05,2013-07-28 07:13:05
416e451328988fd612fec87882a7e20fe922621b...6a662c0f24afbeb16c21b07e5219c71417e103e7,1,65,0,65,1,2013-07-28 07:20:51,2013-07-28 07:20:51
6a662c0f24afbeb16c21b07e5219c71417e103e7...66d18cb21cc92606f23e6374eef9f186362ca292,1,44,44,88,1,2013-07-28 07:22:01,2013-07-28 07:22:01
66d18cb21cc92606f23e6374eef9f186362ca292...09a439d7101f06ed98d93930d49a833e70b68052,1,19,0,19,1,2013-07-28 07:28:44,2013-07-28 07:28:44
09a439d7101f06ed98d93930d49a833e70b68052...3da28a6613320861f391b1c5d90742c60cd3b86f,1,0,5,5,1,2013-07-28 07:45:03,2013-07-28 07:45:03
3da28a6613320861f391b1c5d90742c60cd3b86f...b6c01f736ae139d2ecad3bb59144f14b2969eacd,1,1,1,2,1,2013-07-28 07:46:33,2013-07-28 07:46:33
b6c01f736ae139d2ecad3bb59144f14b2969eacd...5d5af689f03860fcbb84032025d39f4f4b0c9cf4,1,1,1,2,1,2013-07-28 07:47:01,2013-07-28 07:47:01
5d5af689f03860fcbb84032025d39f4f4b0c9cf4...3d90103f938f688e83b5c20d0e734288dc41cf8b,1,18,0,18,1,2013-07-28 07:50:34,2013-07-28 07:50:34
3d90103f938f688e83b5c20d0e734288dc41cf8b...0f4b65f4e754c93a277cd4c4bf4058b5511c7f58,1,2,1,3,1,2013-07-28 07:54:03,2013-07-28 07:54:03
1deac9d2385df6189d98cd58cfd83556d456000a...d4b4630ac1213806c08ec21073a85a41a36a8ad9,3,139,0,139,3,2013-08-12 10:40:18,2013-08-10 07:39:58
d4b4630ac1213806c08ec21073a85a41a36a8ad9...e89bb5b5ff60476c3928084771fcb03d919313a8,1,2,7,9,3,2013-08-14 09:22:32,2013-08-14 09:20:08
e89bb5b5ff60476c3928084771fcb03d919313a8...89300811d1f649183489698c6f847acfbc831b7f,1,1,1,2,1,2013-09-07 04:30:36,2013-09-07 04:30:36
89300811d1f649183489698c6f847acfbc831b7f...6e57bcb4f26383f227cd9ba176bf06bea3f034bb,1,1,1,2,1,2013-09-07 07:03:21,2013-09-07 07:03:21
1deac9d2385df6189d98cd58cfd83556d456000a...b339b8cf612737653fe8171366a8cddb0a8a0e59,1,2,2,4,2,2013-08-11 20:18:41,2013-08-11 20:18:41
1deac9d2385df6189d98cd58cfd83556d456000a...df267012c343507695af319e64946576f3084977,1,4,1,5,1,2013-08-08 03:01:10,2013-08-08 03:01:10
0f45d43d27126972c82c16b3772e29317418cad5...42902122949183499be22fd7ff41f139a5daa7d6,1,6,6,12,6,2013-09-16 08:57:13,2013-09-16 08:57:13
29f203c4072e0790fa062148d5783ab56300eb1a...31d0d5d7f8dc169593ffcd3c11f71cffec1c1a3f,4,7,7,14,9,2013-09-10 14:45:36,2013-09-10 14:45:36
feb6492762a77db946bc13cc44a20a01546be0e6...acff8d0ce1b5a4310af6a1570c0e7ff344f8398e,1,110,0,110,1,2013-08-29 01:51:56,2013-08-29 01:51:56
acff8d0ce1b5a4310af6a1570c0e7ff344f8398e...b00515d647c2156ac87296f39e5d2d9ebd574ec5,1,13,13,26,7,2013-09-04 03:55:31,2013-09-04 03:55:31
feb6492762a77db946bc13cc44a20a01546be0e6...f0ca09c3fccf4da67d2da06e8998c4b8f6cd5086,1,9,1,10,9,2013-08-25 09:01:17,2013-08-25 09:01:17
feb6492762a77db946bc13cc44a20a01546be0e6...059ff45e365928ee90b43f6ae033b1de09d3118e,4,54,0,54,4,2013-08-23 18:46:31,2013-08-23 18:46:31
059ff45e365928ee90b43f6ae033b1de09d3118e...5a53cc02f4002fd692342b13a03cd120bb705e35,3,13,6,19,5,2013-08-23 21:38:17,2013-08-23 21:38:17
930500a2dd8f768ddf770a41621faeaa46bbb8c2...1c018f1ef4d154053d9f7db924537eb10f9012e2,2,6,5,11,6,2013-10-21 19:23:28,2013-10-21 19:23:28
f26009a28528a340ecb516b924a6cdc43396c11b...d39995f4a7d59bcdb2b02604ed07d13d20eb9f57,1,66,0,66,1,2013-09-17 18:44:02,2013-09-17 18:44:02
d39995f4a7d59bcdb2b02604ed07d13d20eb9f57...d82fb29c58a7cb7ac0662448d4bbea7cb50a5d88,1,29,2,31,4,2013-09-18 18:00:48,2013-09-18 18:00:48
d82fb29c58a7cb7ac0662448d4bbea7cb50a5d88...46afbb63c68061081b7f71514b3b39cc12112409,1,2,2,4,2,2013-09-18 19:35:37,2013-09-18 19:35:37
f26009a28528a340ecb516b924a6cdc43396c11b...cb3e371b7eaf347d59b7075b23a2baded7741e9c,2,152,0,152,2,2013-09-16 21:48:40,2013-09-16 21:48:40
cb3e371b7eaf347d59b7075b23a2baded7741e9c...8119a9388eaf58e9cad6d3ef808dc508782302ae,2,48,4,52,10,2013-09-17 20:06:34,2013-09-17 20:06:34
306c5685af27bf3c409f251e01a900c651598cee...d702b96070c1726a2ed69a1bdd6bff899ee6f0f3,1,7,7,14,3,2013-08-29 17:58:23,2013-08-29 17:58:23
7a8eb6f1cf58ab2ce8b7b192539887eefd6dfa20...3492b5193e78d891548cafa23beaa7c5125a6054,1,25,0,25,1,2013-09-21 08:10:42,2013-09-21 08:10:42
77a4e394d99a67e7fb611e8b402c2da4b80fa4f8...83514f5b5c711ba5baf6b9768b004f789191f812,1,1,1,2,1,2013-08-31 14:01:37,2013-08-31 14:01:37
1c018f1ef4d154053d9f7db924537eb10f9012e2...02107bc738466b32348734318c9c3824b5d4a472,3,140,0,140,4,2013-10-21 19:33:55,2013-08-23 17:44:46
02107bc738466b32348734318c9c3824b5d4a472...f2d5245b002463140afdcda218e64b9865976b8e,3,86,83,169,22,2013-10-21 20:32:54,2013-10-21 19:36:05
46afbb63c68061081b7f71514b3b39cc12112409...fcd4e7443434c4973d51fbc7842d39c4ec78deda,1,39,1,40,1,2013-09-18 21:20:02,2013-09-18 21:20:02
8119a9388eaf58e9cad6d3ef808dc508782302ae...e182c98c0334d320bb3771e8d25b1b85486a7071,1,55,0,55,1,2013-09-19 16:08:05,2013-09-19 16:08:05
8119a9388eaf58e9cad6d3ef808dc508782302ae...bb7bd3355ac0523e5c0d2fdf1053e75f8e0594c5,1,184,0,184,1,2013-09-17 22:35:58,2013-09-17 22:35:58
bb7bd3355ac0523e5c0d2fdf1053e75f8e0594c5...645956dbc9832e871cf6cf02670f566792397679,2,30,0,30,2,2013-09-18 20:00:35,2013-09-18 20:00:35
8662d5d0b4699b5f68b367e7dc771f178b2dd0c6...34e1b2de0f7756749b4aeee7137a44aa9f71d7e3,19,643,642,1285,33,2013-09-23 18:42:24,2013-09-23 18:42:24
5c8ffa5561e7e895f9e6869cf192d5fcd013f3b1...a78eb24fdf1b00e6d4ab1348c0ed9bf17174356a,1,16,18,34,2,2013-10-21 20:40:49,2013-10-21 20:40:49
a78eb24fdf1b00e6d4ab1348c0ed9bf17174356a...725857f5cde079c425cc7b4ae14454799c0a7f04,1,1,1,2,1,2013-10-21 20:49:42,2013-10-21 20:49:42
725857f5cde079c425cc7b4ae14454799c0a7f04...8079d8e95f16160216fcfbfb60ea430c033e2d58,1,1,1,2,1,2013-10-21 21:20:00,2013-10-21 21:20:00
8079d8e95f16160216fcfbfb60ea430c033e2d58...728dc177d5e2d9943fe5a42a625d4052f30ecb79,1,2,1,3,2,2013-10-21 21:24:03,2013-10-21 21:24:03
c7a5437452115c23891bde40feb4887382bc3bae...ba5ed0d68935c873f94d9f45459a2a0e6c9eba30,2,0,60,60,2,2013-09-19 16:10:24,2013-09-19 16:10:24
ba5ed0d68935c873f94d9f45459a2a0e6c9eba30...d0de1b6825ee8abb2a0b6d756cbb69bcc1ef2484,1,30,0,30,1,2013-09-19 16:12:28,2013-09-19 16:12:28
34e1b2de0f7756749b4aeee7137a44aa9f71d7e3...fac6a3839c865555ee7aa9c3634ad987fbd57d30,4,209,14,223,12,2013-09-23 20:35:04,2013-09-23 20:35:04
728dc177d5e2d9943fe5a42a625d4052f30ecb79...5cca368718fd40c34676c2cead3b167037a1a200,1,11,3,14,4,2013-10-23 15:26:41,2013-10-23 15:26:41
728dc177d5e2d9943fe5a42a625d4052f30ecb79...931f1779de95bb27ca6259c7ec91263bfd0ca04f,25,725,0,725,27,2013-10-22 19:57:47,2013-09-19 18:05:32
931f1779de95bb27ca6259c7ec91263bfd0ca04f...27d02663e57a73e97c85978ea74edc8fdc485f25,38,506,406,912,42,2013-10-22 19:59:19,2013-09-29 11:18:00
27d02663e57a73e97c85978ea74edc8fdc485f25...442c0fe57de911591eaf04dc77dc81c315a75f0d,2,1,63,64,2,2013-10-22 19:59:20,2013-09-29 11:23:25
442c0fe57de911591eaf04dc77dc81c315a75f0d...a20819827eb2190f5ba84cb086a8a37d38bfe8b7,1,0,77,77,1,2013-10-22 19:59:20,2013-10-22 19:55:39
728dc177d5e2d9943fe5a42a625d4052f30ecb79...e07784503ba9bf100c3cf2de87c2dbb04017f8a5,1,43,0,43,1,2013-10-22 11:17:47,2013-10-22 11:17:47
e07784503ba9bf100c3cf2de87c2dbb04017f8a5...f61bf615bbd15b1f65e2740bc0dd4ab7fbff2f97,1,4,3,7,3,2013-10-22 11:54:17,2013-10-22 11:54:17
f61bf615bbd15b1f65e2740bc0dd4ab7fbff2f97...0cdc875aed4a549f076034b4dd94703de310e4da,1,4,4,8,3,2013-10-22 14:40:43,2013-10-22 14:40:43
512c765e05a257c9176b6ecf26b83a18934ee907...1b6322e675f3482c7c824bd6aedec7a2d4f2f8b2,1,150,0,150,1,2013-09-23 21:01:20,2013-07-15 11:16:24
1b6322e675f3482c7c824bd6aedec7a2d4f2f8b2...5d3ecd58e2d2ee249bcb1cb2e434564cd24debfe,2,75,121,196,20,2013-09-23 21:01:20,2013-07-16 10:28:12
5d3ecd58e2d2ee249bcb1cb2e434564cd24debfe...4b4682ed78cd2724c9727cdb57227053c37a8613,1,1,1,2,1,2013-09-23 21:01:20,2013-07-16 10:45:43
4b4682ed78cd2724c9727cdb57227053c37a8613...52a54bebeb3a906225e64fc11a4e8f9cc7319524,1,37,18,55,8,2013-09-23 21:01:21,2013-07-16 10:54:57
52a54bebeb3a906225e64fc11a4e8f9cc7319524...b897e614892cbb1d7a7cf9f94d1e72e1a7c717fb,2,2,2,4,2,2013-09-23 21:03:10,2013-09-23 21:03:10
b897e614892cbb1d7a7cf9f94d1e72e1a7c717fb...64ac4a0289a49ca51a95ceb03007eb0632325b5c,3,143,78,221,26,2013-09-23 22:21:00,2013-09-23 22:21:00
64ac4a0289a49ca51a95ceb03007eb0632325b5c...ac73291f587febc80b1c08e58822b75ff741e465,1,7,0,7,1,2013-09-23 22:24:59,2013-09-23 22:24:59
836a757943d9fc4dff0b98e6deb57b7f0cad1044...4c8b3e5190f3072c1a53801c827809f87af77bfb,1,56,0,56,1,2013-10-29 03:52:53,2013-10-29 03:52:53
4c8b3e5190f3072c1a53801c827809f87af77bfb...2b370385119e3fbb5e16ceecce5396d39eb15698,1,369,4,373,7,2013-11-04 09:02:52,2013-11-04 09:02:52
836a757943d9fc4dff0b98e6deb57b7f0cad1044...bed3caf3f6ee3e18af5e3cddfc9a077b45cc2480,11,723,0,723,11,2013-10-28 09:28:32,2013-10-28 09:28:32
bed3caf3f6ee3e18af5e3cddfc9a077b45cc2480...4a3d6b3950831f9ce442d956a0a2b50f6fbee95b,8,0,411,411,8,2013-10-28 09:29:12,2013-10-28 09:29:12
ff43a34c9cff2a22e765a8ebc2be3ec591165049...149eeeefe973c9479e0a4c7c28085ce20b2dd6e4,2,212,0,212,2,2014-01-24 01:10:52,2014-01-24 01:10:52
149eeeefe973c9479e0a4c7c28085ce20b2dd6e4...0e03303aff1f4ac1bc9e1d3acc271fdec3c6cb13,2,41,16,57,12,2014-01-27 14:48:34,2014-01-27 14:36:08
ff43a34c9cff2a22e765a8ebc2be3ec591165049...a8b84dac0ee861f1f4c63cffc52c26f44481be81,1,1,1,2,1,2014-01-23 19:25:55,2014-01-23 19:25:55
7a56e4469954bf982b832e3e078c08ef9fef7258...2a0d26ad53a4c9cd46728f8c6edde94a8d430c86,1,1,1,2,1,2013-10-10 12:03:56,2013-10-10 12:03:56
7a56e4469954bf982b832e3e078c08ef9fef7258...d8db634c57b77ffb5628a15bc60a2fad07588b45,1,2,2,4,2,2013-10-10 09:47:29,2013-10-10 09:47:29
7a56e4469954bf982b832e3e078c08ef9fef7258...09a92336f17a042bc7dd0c33f0566ac01b9e44bd,1,113,0,113,1,2013-09-27 15:39:37,2013-09-27 15:39:37
09a92336f17a042bc7dd0c33f0566ac01b9e44bd...4db5f0b0b74375b583431d3c074f9fab1b99840b,1,20,5,25,2,2013-09-30 07:08:31,2013-09-30 07:08:31
4db5f0b0b74375b583431d3c074f9fab1b99840b...74fa1cd531c9559cae76669f91c765a245ed22c5,1,126,0,126,1,2013-09-30 08:42:31,2013-09-30 08:42:23
74fa1cd531c9559cae76669f91c765a245ed22c5...777afd3bbe3a97a21b988ea63197307e73d983b4,1,4,0,4,1,2013-09-30 09:08:39,2013-09-30 09:08:39
777afd3bbe3a97a21b988ea63197307e73d983b4...f939cff39761d0119205387c950e7ec9a51febf3,2,53,4,57,17,2013-10-02 15:47:56,2013-10-02 15:47:56
459049684378aa6c6a8d5d445815cf11224c3c2f...fc8e4b113cf5591278d4c1b95345189c2eb1f52b,1,1,1,2,1,2014-01-29 12:41:48,2014-01-29 12:41:48
459049684378aa6c6a8d5d445815cf11224c3c2f...94a6f48760ccc296bc8f3723ed3e716b4c38d2e6,1,2,1,3,2,2014-01-28 09:04:38,2014-01-28 09:04:38
7df7fcc89f003b92c320434ca30b99461f2f6ca8...5771921921b510db9ee7925d656610bafd9d9e89,1,1,0,1,1,2013-11-28 16:08:09,2013-11-28 16:08:09
5771921921b510db9ee7925d656610bafd9d9e89...e78d538e5f82cd40f2cfcb17dfbafda69ecd9b6c,3,142,141,283,13,2013-11-28 16:15:01,2013-11-28 16:08:25
7df7fcc89f003b92c320434ca30b99461f2f6ca8...277edbc10ac89fc5d4c2911b3f96ce417e7d9686,1,1,1,2,1,2013-11-26 17:54:54,2013-11-26 17:54:54
2355fcf8d19de6eaa562f809150e4ddace90d985...7644165a464865cab199276a8c03661dbe1a4f57,1,1,1,2,1,2013-10-21 18:41:07,2013-10-21 18:38:25
2355fcf8d19de6eaa562f809150e4ddace90d985...e7e1c9a5e501497958f6f1d17bac5656f720638a,6,500,500,1000,4,2013-10-18 08:18:18,2013-10-18 08:18:18
e7e1c9a5e501497958f6f1d17bac5656f720638a...66dd5bcb19c6f81c7e8d8efbf29d9a56a6667643,6,500,500,1000,4,2013-10-25 07:05:06,2013-10-25 07:05:06
66dd5bcb19c6f81c7e8d8efbf29d9a56a6667643...015a0577979b0ac63e5935f1222d7430af331dfd,6,6,6,12,6,2013-10-25 07:52:39,2013-10-25 07:52:39
015a0577979b0ac63e5935f1222d7430af331dfd...872d21c62d952164aa718c40c910f2f9d0354451,1,17,3,20,5,2013-11-01 15:33:09,2013-11-01 15:33:09
7263391c022fc4d1468253fd57e33eb171b8be14...db610ff34bf9ec0f3c5b1b2b0358986aa253f85c,1,1,1,2,1,2013-11-28 16:34:55,2013-11-28 16:34:55
db610ff34bf9ec0f3c5b1b2b0358986aa253f85c...395f7365c18684b4b81f04c8851b6a9eba3966db,1,1,1,2,1,2013-11-28 16:35:35,2013-11-28 16:35:35
395f7365c18684b4b81f04c8851b6a9eba3966db...3326cd3c401323bd3d56c767ef66cb045c9eee47,1,3,1,4,2,2013-11-28 16:41:22,2013-11-28 16:41:22
fa21a4ca903957b1bdf03cb3a4e677f39a052a19...b07eec9644f9d326f61c823d2ce5a24f5f06e2d4,1,97,0,97,1,2013-12-04 10:27:11,2013-12-04 10:27:11
b07eec9644f9d326f61c823d2ce5a24f5f06e2d4...bd8f6afbc10daa32574954e8988790834516d0c9,1,9,0,9,1,2013-12-04 10:27:53,2013-12-04 10:27:53
bd8f6afbc10daa32574954e8988790834516d0c9...d76b3ce88599c4bb9c14fc671643455ac1b23578,1,34,0,34,1,2013-12-04 10:28:56,2013-12-04 10:28:56
d76b3ce88599c4bb9c14fc671643455ac1b23578...434d0f0afc2b46b8fe086f5b27fd077bf21a70b5,1,17,0,17,1,2013-12-04 10:29:11,2013-12-04 10:29:11
434d0f0afc2b46b8fe086f5b27fd077bf21a70b5...933e6cb4abdb4b0d36532c12f82f3b895fcfb1df,1,1,1,2,1,2013-12-06 11:07:04,2013-12-06 11:07:04
933e6cb4abdb4b0d36532c12f82f3b895fcfb1df...a8f2d4feb4cf0253364576096c40a3fc4c288657,3,3,3,6,3,2013-12-06 11:13:29,2013-12-06 11:13:29
a8f2d4feb4cf0253364576096c40a3fc4c288657...20bcc12b0deebd29384f7894a7d933e95aa17ecf,1,1,1,2,1,2013-12-06 11:37:39,2013-12-06 11:37:39
872d21c62d952164aa718c40c910f2f9d0354451...c18e92dd30c62e089313b5ce05ccc32b64ae9cf9,2,21,68,89,5,2013-11-04 09:18:08,2013-11-04 09:18:08
c18e92dd30c62e089313b5ce05ccc32b64ae9cf9...068106e1139ff0b5d93b3202aa1935d9031e11a9,1,23,0,23,1,2013-11-04 10:02:05,2013-11-04 10:02:05
7f2a9d5e9661bfdc0941442af683407ca04cb1e4...0ae7fb748f0fb1346e7c8208990a3b216a79612f,4,263,0,263,4,2013-11-08 05:41:53,2013-11-08 05:41:53
0ae7fb748f0fb1346e7c8208990a3b216a79612f...326c378d10583f502364a6830604875e0f29d311,2,30,30,60,12,2013-11-08 07:01:24,2013-11-08 07:01:24
c25f3801004417a102bb8e10cccbd8b616c549f7...274dc3354d7ddaf9021ef44a81462ae862ee5f8c,2,3,1,4,2,2014-02-24 20:59:58,2014-02-24 20:59:58
3326cd3c401323bd3d56c767ef66cb045c9eee47...0fca1568674125191db93738cb48399c3c55b674,1,1,1,2,1,2013-12-02 16:35:32,2013-12-02 16:35:32
ca91fd3cce983578a7acceb8dec7131c3ba63a67...929fbccf2201a41dd71c061d62d0daef58161715,2,91,0,91,2,2013-12-12 07:47:27,2013-12-12 07:47:27
929fbccf2201a41dd71c061d62d0daef58161715...6858338167dd3c0b152ed7679e6b4cf8ad26a45e,1,15,0,15,1,2013-12-17 02:39:47,2013-12-17 02:39:47
ca91fd3cce983578a7acceb8dec7131c3ba63a67...c37d5384faa25eea0e6b0aef70cfa65f881f8d3b,1,7,8,15,6,2013-12-11 20:53:26,2013-12-11 13:42:06
ca91fd3cce983578a7acceb8dec7131c3ba63a67...a4602829eadb659d19b4c44fcc7d414b4512d2ec,1,3,3,6,3,2013-12-07 03:56:07,2013-12-07 03:56:07
080f944b011eaa6e9a901f210b897001730b5de2...28fa202f409cb2eee61a62b7b23bcb96b444ae3e,1,1,1,2,1,2013-11-12 17:24:02,2013-11-12 17:24:02
080f944b011eaa6e9a901f210b897001730b5de2...a47c0518c506b838549fdaed6dafc41d556fff3c,1,1,1,2,1,2013-11-12 16:18:41,2013-11-12 16:18:41
080f944b011eaa6e9a901f210b897001730b5de2...c0311f607f4b885cbc76cbe342310b7db6ba17a5,1,13,0,13,1,2013-11-12 15:35:37,2013-11-12 15:35:37
c0311f607f4b885cbc76cbe342310b7db6ba17a5...d7a7a4fbfb69a01f8bc4af3fdcc2140561b4f54a,1,8,0,8,1,2013-11-13 09:16:34,2013-11-13 09:16:34
d7a7a4fbfb69a01f8bc4af3fdcc2140561b4f54a...056d6c30cadfe5527196af1c059feb82e590523c,1,3,1,4,1,2013-11-19 08:12:45,2013-11-19 08:12:45
943647187cba1129171946b9800f15a722ab246a...6bc40f81096daedc809b6ea6d54cd0c1a6146819,1,1,1,2,1,2014-01-30 17:51:10,2014-01-30 17:51:10
ea6b96b60a48c2506a2edb18a713ab261116751a...9f4ad8979821b9d0052656dffaabea035eed6c86,2,0,0,0,0,2013-12-17 09:29:03,2013-12-17 09:29:03
3fb1622f940b99c8161c2659756753469c7fb054...51a210e40b20dba7d88aa3b6df01248390f2356a,24,714,714,1428,37,2013-12-16 21:47:51,2013-12-16 21:47:51
51a210e40b20dba7d88aa3b6df01248390f2356a...b96bef51b0eda4adb46c84cc874b2a0d5c7748c7,2,51,2,53,3,2013-12-16 21:54:46,2013-12-16 21:54:22
b96bef51b0eda4adb46c84cc874b2a0d5c7748c7...1d143fd8caf4d264602450bc01d7484af788706b,1,1,1,2,1,2013-12-16 21:56:48,2013-12-16 21:56:48
1d143fd8caf4d264602450bc01d7484af788706b...6f4383b9a03ea5785917952edefaebc1f01e5512,1,1,1,2,1,2013-12-16 21:58:51,2013-12-16 21:58:51
6f4383b9a03ea5785917952edefaebc1f01e5512...22a4b79406ea7a50056c8ee45c58ee3738caa1c8,1,1,0,1,1,2013-12-16 21:59:45,2013-12-16 21:59:45
3cbb85ed3d76b8e83f889a39ca9384c543e1a544...61a62d67ec2d5a19aa653ffe411f312e306556be,1,21,0,21,1,2014-02-24 21:51:30,2014-02-24 21:51:30
6bc40f81096daedc809b6ea6d54cd0c1a6146819...b213c610948ddb877f1de74caecbbbf788252b5e,1,1,1,2,1,2014-02-05 13:56:41,2014-02-05 13:56:41
6bc40f81096daedc809b6ea6d54cd0c1a6146819...6912074af53463722565761ccba2858f9be50f0e,1,22,22,44,4,2014-02-03 13:52:23,2014-02-03 13:52:23
9f4ad8979821b9d0052656dffaabea035eed6c86...19cc376cc1d437b0057fd8fe88178b9334d26f0c,1,0,7,7,1,2014-01-06 11:04:34,2014-01-06 11:04:34
9f4ad8979821b9d0052656dffaabea035eed6c86...a9634623ded6f59864e5f66d4b18a46b2a3c27c8,1,1,1,2,1,2014-01-05 13:11:31,2014-01-05 13:11:31
a9634623ded6f59864e5f66d4b18a46b2a3c27c8...73a360333a6cd81a2bdf23a1440ff64fa8af3233,1,1,1,2,1,2014-01-05 13:18:52,2014-01-05 13:18:52
73a360333a6cd81a2bdf23a1440ff64fa8af3233...a60143de4f3e7d0a93b39af4ff6f3a38deefc73a,1,1,1,2,1,2014-01-06 19:16:24,2014-01-06 19:16:24
9f4ad8979821b9d0052656dffaabea035eed6c86...ce612d8d0462ec26c14d4ccb86e43fbae1864fce,2,213,0,213,3,2014-01-05 10:48:39,2014-01-05 10:48:39
ce612d8d0462ec26c14d4ccb86e43fbae1864fce...8b4c0cdb4e939888b1cb177643c1e674cae7074f,2,95,0,95,2,2014-01-05 12:11:35,2014-01-05 12:11:35
9f4ad8979821b9d0052656dffaabea035eed6c86...469c4506c115a5bf4b6db95f9ae5886e8c1bf156,4,118,0,118,4,2013-12-30 15:32:38,2013-12-30 15:32:38
9f4ad8979821b9d0052656dffaabea035eed6c86...9d596597804760d85f311beac700e8646b4e9649,3,262,0,262,3,2013-12-30 09:35:20,2013-12-30 09:35:20
9d596597804760d85f311beac700e8646b4e9649...dc002a2a7a4801a3c1129a514270a1d3dece0bd1,1,11,28,39,6,2014-01-09 06:00:38,2014-01-09 06:00:38
dc002a2a7a4801a3c1129a514270a1d3dece0bd1...30b59e8da742803d043473a61d8e7f181e0c90f2,2,19,36,55,9,2014-01-09 06:14:27,2014-01-09 06:14:27
30b59e8da742803d043473a61d8e7f181e0c90f2...05fdbb994f14cf06dbca18a38c2994f96acc494a,1,1,1,2,1,2014-01-09 06:15:34,2014-01-09 06:15:34
9f4ad8979821b9d0052656dffaabea035eed6c86...0a14f4be110aaaca96de9143644900c973d09e78,5,161,0,161,5,2013-12-18 19:38:57,2013-12-18 19:38:57
0a14f4be110aaaca96de9143644900c973d09e78...6cadb06eaeb6098cf0984b34be343442df1ff01d,2,2,2,4,2,2013-12-19 09:37:38,2013-12-19 09:37:38
6cadb06eaeb6098cf0984b34be343442df1ff01d...287f500eb88b562596dc0d0115873bbb86635a42,1,1,1,2,1,2014-01-23 20:35:18,2014-01-23 20:35:18
287f500eb88b562596dc0d0115873bbb86635a42...0ed5c80bae32507f9285f859a904e333cd97469c,1,1,3,4,1,2014-01-28 10:00:34,2014-01-28 10:00:34
9f4ad8979821b9d0052656dffaabea035eed6c86...ac18ae3ce5e04d0e191995f8e80d1baa0bb277c1,1,3,3,6,1,2013-12-18 13:47:58,2013-12-18 13:47:58
22a4b79406ea7a50056c8ee45c58ee3738caa1c8...e41151879e548f489c79821059c03421d298ad40,1,14,5,19,2,2013-12-16 23:20:39,2013-12-16 23:20:39
61a62d67ec2d5a19aa653ffe411f312e306556be...0a0ed16a8c4088c40f5f574bb593179d9b7ea216,1,1,1,2,1,2014-02-27 23:57:28,2014-02-27 23:57:28
7b4d01a928fb1a2c792f8f6659ea7316d14ca1c9...ea867a62582175b0ce720b14dcd12a088a2de7e1,4,114,0,114,4,2014-02-21 15:30:28,2014-02-21 15:30:28
ea867a62582175b0ce720b14dcd12a088a2de7e1...fbb1c83578e6b85e17ec2647188aaf5767d8e225,5,35,4,39,7,2014-02-22 20:12:46,2014-02-22 20:12:46
fbb1c83578e6b85e17ec2647188aaf5767d8e225...7c9a1dcdc6520c9ddbb7af2fc479a5aa38082604,3,116,7,123,9,2014-02-26 09:36:25,2014-02-26 09:36:25
7c9a1dcdc6520c9ddbb7af2fc479a5aa38082604...ca14c7ba6b591642cb4adbbc1d5eb0fa72695c88,1,17,0,17,1,2014-02-26 10:23:00,2014-02-26 10:23:00
ca14c7ba6b591642cb4adbbc1d5eb0fa72695c88...52fb117db24f9d8ba80a81751f1655dc2a7df809,1,63,22,85,3,2014-03-11 12:40:36,2014-03-11 12:40:36
52fb117db24f9d8ba80a81751f1655dc2a7df809...8999d607859b7f941d18629d971866b2e1057dac,1,18,1,19,2,2014-03-11 12:57:34,2014-03-11 12:57:34
7b4d01a928fb1a2c792f8f6659ea7316d14ca1c9...09e4b3adea8b1e7f6669c7890cfe9c9c4e98d3d7,2,766,0,766,2,2014-02-18 17:14:02,2014-02-18 17:10:21
09e4b3adea8b1e7f6669c7890cfe9c9c4e98d3d7...8e1a337cb38a7d8e2009f56eb0d094d6a8471cdd,2,3744,642,4386,7,2014-02-24 23:20:12,2014-02-24 23:20:12
8e1a337cb38a7d8e2009f56eb0d094d6a8471cdd...36c5974d9832b0a132ebb1f2c0d71056ce78da60,1,2045,0,2045,1,2014-02-24 23:20:30,2014-02-24 23:20:30
36c5974d9832b0a132ebb1f2c0d71056ce78da60...84dd82ceed88ea7a1590d369d249f537360c9cd4,1,1,1,2,1,2014-02-24 23:23:11,2014-02-24 23:23:11
84dd82ceed88ea7a1590d369d249f537360c9cd4...08069d4322f4621505bef2a614d7450f70172bea,4,54,32,86,18,2014-02-27 14:09:04,2014-02-27 14:09:04
08069d4322f4621505bef2a614d7450f70172bea...55824193924e70566bbde2b72baca78b3bf6b079,1,1,1,2,1,2014-02-27 21:02:19,2014-02-27 21:02:19
55824193924e70566bbde2b72baca78b3bf6b079...8667c4884660bf022399238d0363603a5e63cd11,2,16,24,40,11,2014-03-03 13:29:45,2014-03-03 13:29:45
8667c4884660bf022399238d0363603a5e63cd11...4bdebac4db9076f6358ac57864acc5535720ac86,1,12,3,15,3,2014-03-03 15:42:06,2014-03-03 15:42:06
7b4d01a928fb1a2c792f8f6659ea7316d14ca1c9...41f1b6ae741c6ed85a2f7b4930d700990d93f210,1,4,4,8,1,2014-02-11 01:21:22,2014-02-11 01:21:22
41f1b6ae741c6ed85a2f7b4930d700990d93f210...b491b67015c09201432e7824f975b3284fdf0120,1,8,5,13,3,2014-02-21 19:59:57,2014-02-21 19:59:57
8b4c0cdb4e939888b1cb177643c1e674cae7074f...eca0754f3a22234a42f21c020fc8241a73eb9c99,3,10,14,24,10,2014-01-06 09:08:32,2014-01-06 09:08:32
eca0754f3a22234a42f21c020fc8241a73eb9c99...6a933280af3ee2a27fa3f71cc10851d04943715d,1,796,755,1551,1,2014-01-06 09:34:35,2014-01-06 09:34:35
8b4c0cdb4e939888b1cb177643c1e674cae7074f...d40861fbdcaac864999a04ae732ad49e7c51ad47,3,10,14,24,10,2014-01-06 09:03:40,2014-01-06 09:03:40
01b708ee470c04050467bb809423b7dbac73e46a...cdd8125b88e5beb8b1dee4f1a26284dc0ff4765f,1,1,1,2,1,2014-07-10 06:49:14,2014-07-10 06:49:14
cdd8125b88e5beb8b1dee4f1a26284dc0ff4765f...c9bf61652b516ee35086ce2809b14792df937c67,25,144,144,288,92,2014-07-10 06:50:59,2014-07-10 06:50:59
ec11415852c49bacb31853c221aacdae4761b323...6b96355973e95f188ad9cd4363b0414d64c0eaf8,1,1,1,2,1,2014-02-28 16:22:22,2014-02-28 16:22:22
82a4113124e1e6a005b747452bc6ca1805c4352e...3087b69d33ec45d0e6c9a5bfae82a58260e47994,3,155,143,298,10,2014-03-13 18:32:44,2014-03-13 18:32:44
3087b69d33ec45d0e6c9a5bfae82a58260e47994...4ca3829d9dde19cbe188da004d7b6d4e92d6cb86,12,27,63,90,56,2014-03-13 18:33:34,2014-03-13 18:33:34
680b36daa45ddcb0322a0644b304715bf5ce8bbe...55251a9bc212adda2d56d437f2d342a6b95b7098,2,48,38,86,13,2014-03-03 20:21:43,2014-03-03 20:21:43
6fbd282887c744548a4db77a3b2296c981d0732e...5aaa2c00254c2c68dbeeaa15eee7e2acd89b00d3,1,796,796,1592,1,2014-01-06 09:43:38,2014-01-06 09:43:38
5aaa2c00254c2c68dbeeaa15eee7e2acd89b00d3...80257b79336840a984d53794b3421d6f192586fb,1,0,6,6,3,2014-01-06 11:38:03,2014-01-06 11:38:03
4ca3829d9dde19cbe188da004d7b6d4e92d6cb86...98f400afc861741492abbe4d0d97caf4035a16c7,1,7,0,7,1,2014-03-21 17:22:03,2014-03-21 17:22:03
98f400afc861741492abbe4d0d97caf4035a16c7...3da8c930ed95f37f8aef6d62b22138004ada08ae,1,6,4,10,1,2014-03-21 17:25:22,2014-03-21 17:25:22
6f1f649ccc85fe214a9e863aae17846c67340559...ea67b69b011de52102bcc8b6d9c28c03794b2978,1,2,2,4,2,2014-03-03 20:37:52,2014-03-03 20:37:52
392e191ebaec5e5072dca1642ac994df250884f2...08095b1a614bce569651c4bd7cdf850ef3998779,1,7,7,14,3,2014-03-25 15:14:31,2014-03-25 15:14:31
ea67b69b011de52102bcc8b6d9c28c03794b2978...ad87ed4ea3c62d7b910606f628717ac0448469a9,2,15540,1,15541,2,2014-03-03 21:04:41,2014-03-03 21:04:41
9b653ae03a4c4e0626099661798ae07d332d3a08...7b19cef5b2b37037a3995946c8065b8737eb0893,1,3,3,6,2,2014-07-14 16:40:27,2014-07-14 16:40:27
9b653ae03a4c4e0626099661798ae07d332d3a08...eb792c410bf8e7aaf97d5df6cc5ead7ff2a8b869,3,48,35,83,20,2014-07-10 13:17:43,2014-07-05 06:28:54
991e39d280afc34a91684e5789023f1b276e4618...40d8116e26518b6dbe386f58ce2c5fc9c7a73bb9,1,1,1,2,1,2014-04-01 09:07:36,2014-04-01 09:07:36
64adc8d23aa4be3bfac3075d4f8b193a082bbd97...eeb39d19eb0a53a6b4be95b824fba872ed0856c7,1,1,1,2,1,2014-03-03 21:12:07,2014-03-03 21:12:07
eeb39d19eb0a53a6b4be95b824fba872ed0856c7...1800e885b52b2a3cc6b697db4fa2f711988b89c6,1,2,2,4,2,2014-03-04 17:41:43,2014-03-04 17:41:43
2fc67a37bdb32300080dee7a14b902c7a012837a...f6070272693950fbc37618044e5dbb93b34cc467,1,1,1,2,1,2014-04-01 20:16:52,2014-04-01 20:16:52
1800e885b52b2a3cc6b697db4fa2f711988b89c6...cae91904b8e4060196d3a4d85267e648e7e00a6b,2,46,0,46,2,2014-03-05 17:37:52,2014-03-05 17:16:15
cae91904b8e4060196d3a4d85267e648e7e00a6b...6d7f9f44959fa9494ac2d84b22a3d55a2bba1a50,1,10,2,12,3,2014-03-05 17:55:08,2014-03-05 17:55:08
6d7f9f44959fa9494ac2d84b22a3d55a2bba1a50...176507cc2664e67700e3460d3e54afd2a546f5f1,1,13,8,21,6,2014-03-05 18:36:24,2014-03-05 18:36:24
176507cc2664e67700e3460d3e54afd2a546f5f1...a68fa6694188b84e3eb4b053b0433add4604a7b0,3,9,8,17,7,2014-03-06 12:55:25,2014-03-06 12:55:25
a68fa6694188b84e3eb4b053b0433add4604a7b0...6d2253cc5664d1ab8323aab1634a54236a75c9de,2,10,1,11,2,2014-03-06 13:36:53,2014-03-06 13:27:08
1800e885b52b2a3cc6b697db4fa2f711988b89c6...a03cd76b1cad077ed3db62b5042f1e97280017f4,1,1,1,2,1,2014-03-05 14:56:02,2014-03-05 14:56:02
488bd55b868828b8d96dd8a1ea05a2deac65b534...c48f30549b1ec508a74141a833757ca1e0d9ca53,2,66,59,125,17,2014-07-17 07:25:43,2014-07-17 07:25:43
f6070272693950fbc37618044e5dbb93b34cc467...123b2484704a5fa3864ab79d3c961add9c22fa33,1,4,3,7,3,2014-04-03 11:07:31,2014-04-03 11:07:31
123b2484704a5fa3864ab79d3c961add9c22fa33...c7efb355823627d8060af9df6912ab2a8a359a17,1,1,1,2,1,2014-04-03 11:10:02,2014-04-03 11:10:02
c7efb355823627d8060af9df6912ab2a8a359a17...f43733a6ecfd1d94a7d46e1898fe6fb2ce1f2e0d,1,2,2,4,1,2014-04-03 11:38:45,2014-04-03 11:38:45
5be755ad0f9e1e968249ef3cfd4ebbcb51d9f6a7...9adde3415a0dea1529b1767f6781b07652313ba7,3,6,5,11,4,2014-03-07 22:36:14,2014-03-07 22:36:14
c48f30549b1ec508a74141a833757ca1e0d9ca53...97e5e27c2a115fec8b63255f06e6f09f00aeed4b,1,0,40,40,1,2014-08-18 16:07:45,2014-08-18 16:07:45
c48f30549b1ec508a74141a833757ca1e0d9ca53...a97990fcf49dd0cd8ea635264dbce6dc4c385caf,1,50,0,50,1,2014-08-13 15:40:34,2014-07-17 11:17:22
a97990fcf49dd0cd8ea635264dbce6dc4c385caf...93992e507c52b58b194ce47926e7dfd56baf237d,1,18,16,34,8,2014-08-13 16:25:04,2014-08-13 15:47:58
c48f30549b1ec508a74141a833757ca1e0d9ca53...aa3608d04b7704a0a641defcccf2d687db693e63,1,20,0,20,1,2014-08-08 02:23:48,2014-08-08 02:23:48
aa3608d04b7704a0a641defcccf2d687db693e63...31b1312f067754c97cff5d05e678c30d6cd0778a,1,4,13,17,4,2014-08-18 02:22:06,2014-08-18 02:22:06
31b1312f067754c97cff5d05e678c30d6cd0778a...926b792336808fcd65e2d574986eab7c3920610f,1,3,1,4,2,2014-08-18 02:30:10,2014-08-18 02:30:10
c48f30549b1ec508a74141a833757ca1e0d9ca53...4ca270b2c5157c77689e983f814580bf5831a647,1,1,1,2,1,2014-08-06 20:52:34,2014-08-06 20:52:34
c48f30549b1ec508a74141a833757ca1e0d9ca53...1cb5d16a466733e4cdc2ba3743b26fd05738cf70,1,4544,0,4544,1,2014-08-05 12:49:33,2014-08-05 12:49:33
1cb5d16a466733e4cdc2ba3743b26fd05738cf70...b04440bca726b0ea4ff82b6f99a21a68de241277,1,4512,0,4512,1,2014-08-05 13:01:13,2014-08-05 13:01:13
b04440bca726b0ea4ff82b6f99a21a68de241277...dea1c507004341a98997e047926491b856b6f4d5,1,1,1,2,1,2014-08-05 17:36:27,2014-08-05 17:36:27
c48f30549b1ec508a74141a833757ca1e0d9ca53...0cee9a259f2260106b93080417e30c20ed3bb5bd,1,1,1,2,1,2014-07-31 21:59:53,2014-07-31 21:59:53
c48f30549b1ec508a74141a833757ca1e0d9ca53...33e688eeea59b943f20c440f56ea91b93a3bbbc6,2,5,8,13,5,2014-07-28 13:42:55,2014-07-28 13:42:55
c48f30549b1ec508a74141a833757ca1e0d9ca53...0a5c3131584a224f20eba9c915528f04e91b88c0,3,3,3,6,3,2014-07-28 13:31:26,2014-07-28 13:31:26
0a5c3131584a224f20eba9c915528f04e91b88c0...f997ebb3ba4c6c74e9596ee0d33735ab17dcc372,2,2,2,4,2,2014-07-28 13:34:05,2014-07-28 13:34:05
f997ebb3ba4c6c74e9596ee0d33735ab17dcc372...6f748c87618dbea732e517207eb7f9f3239cdb49,2,2,2,4,2,2014-07-28 13:34:17,2014-07-28 13:34:17
c48f30549b1ec508a74141a833757ca1e0d9ca53...a9f70936c6559c68497022b81f654702811c90fc,1,1,1,2,1,2014-07-24 08:17:53,2014-07-24 08:17:53
a277bf23f9346e9edd704e01571fecd37af537d0...bfa502d889d1d4a487cd1defd81089b668769fe7,1,70,80,150,10,2014-04-13 19:38:56,2014-04-13 19:38:56
a277bf23f9346e9edd704e01571fecd37af537d0...40b2383beff72415010c28604b325f50d16bb616,2,125,0,125,2,2014-04-11 22:33:44,2014-04-11 22:33:44
40b2383beff72415010c28604b325f50d16bb616...0f369b5319b0a3eb52f6ac1d167211fff89cc183,1,1,1,2,1,2014-04-11 22:59:21,2014-04-11 22:59:21
0f369b5319b0a3eb52f6ac1d167211fff89cc183...258eb619afea495b401bfade6d7017a1cb178d69,2,17,30,47,10,2014-04-13 21:42:25,2014-04-13 21:42:25
258eb619afea495b401bfade6d7017a1cb178d69...37027f4768114f84f901c68c5fe885d8cc6d2e79,2,34,71,105,6,2014-04-15 17:32:40,2014-04-15 17:32:40
37027f4768114f84f901c68c5fe885d8cc6d2e79...9fd4707d11a7410aa50ef3f72509830873f6f3eb,1,5,5,10,2,2014-04-16 10:15:48,2014-04-16 10:15:48
a277bf23f9346e9edd704e01571fecd37af537d0...73f01455855d4731cb8c8db926ff63880323cdfd,1,3,0,3,1,2014-04-07 05:27:54,2014-03-07 12:57:46
73f01455855d4731cb8c8db926ff63880323cdfd...0b7de5c0e601d5728abe536b90b257f1070da044,3,14,3,17,3,2014-04-07 05:27:54,2014-03-10 13:44:13
0b7de5c0e601d5728abe536b90b257f1070da044...041cecffd6313752b7d0975e26e47395430b9b04,32,178,92,270,82,2014-04-07 05:27:54,2014-03-10 19:35:46
041cecffd6313752b7d0975e26e47395430b9b04...f4fc697af82db41d061178535bfee41d73fed8bf,1,1,1,2,1,2014-04-07 05:27:54,2014-03-10 19:38:45
d99a2df148da003fc72da05784df7a458f3e786b...c9dcc8a3546ecf02b9df05f14dd42f4750cf5cb0,1,4,3,7,3,2014-03-11 08:19:28,2014-03-10 15:31:49
c9dcc8a3546ecf02b9df05f14dd42f4750cf5cb0...4045951fb4a50694b7998cee4cb68c824bad6170,1,2,0,2,2,2014-03-11 08:21:28,2014-03-11 08:21:28
d99a2df148da003fc72da05784df7a458f3e786b...1e88eee0f405bb4a9cc6df19e690b8fa165f6e7e,1,2871,0,2871,1,2014-03-10 21:49:58,2014-03-10 17:37:58
d99a2df148da003fc72da05784df7a458f3e786b...1a8feb646edca8a01408bf8a7d2ed7981769ae5b,3,211,52,263,54,2014-03-10 14:41:46,2014-03-10 08:07:23
c6857cac9fdb97a15ade607e1940f318b633ac33...584a33bc047754c02e5813e8133e524ebb40e4e8,1,5,5,10,2,2014-09-02 21:52:58,2014-09-02 21:52:58
584a33bc047754c02e5813e8133e524ebb40e4e8...4c3e635f8f5f31e889a4fa0d38f729f36b383697,1,2,2,4,2,2014-09-03 15:46:27,2014-09-03 15:46:27
d7a430c2fdad9ddcbacbe222db7c24f1020c1f2b...b4dbc854c3f7906562bfb605b75e54dd5fe31802,1,1,1,2,1,2014-08-16 20:44:12,2014-08-16 20:44:12
d7a430c2fdad9ddcbacbe222db7c24f1020c1f2b...29a947272e0bc58e6ade46412e0c7b9f79d8e09e,1,39,0,39,1,2014-08-15 18:15:46,2014-08-15 18:15:46
675fe90ccec65f24f6c96f461675d00a7c4f4c28...ef047cc3ea50727e216640708477bb8f7dceae92,1,1,0,1,1,2014-04-13 20:31:02,2014-04-13 20:31:02
d0f6a36acaf4bf4bff3ac6e7583eb47139d8affb...cf6ff8ea7c2f5640d18013a35f0cfeb0b7ea513a,1,1,1,2,1,2014-04-17 00:49:30,2014-04-17 00:49:30
9933d3a05667c1f86c67749f16cc319978714e99...86e8ad2c083fdfb2c44904a00eca5f7ee8d25be7,3,41,1,42,3,2014-03-10 23:54:15,2014-03-10 23:54:15
86e8ad2c083fdfb2c44904a00eca5f7ee8d25be7...dd9ba3eb542eb98d69d03faa33081604d905d674,2,15,0,15,3,2014-03-11 15:27:17,2014-03-11 15:27:17
9933d3a05667c1f86c67749f16cc319978714e99...0457ecb0cb02afbf48250e671b4f785b92713c3b,1,19,0,19,1,2014-03-10 23:00:19,2014-03-10 23:00:19
0457ecb0cb02afbf48250e671b4f785b92713c3b...6017a9c77a25fa73934b955803a0466e92b65cee,1,4,0,4,1,2014-03-10 23:02:36,2014-03-10 23:02:36
9e5f46406d071d18238642287c5578b0fdc50348...b4ae35aa38b700a0bcfbd650c48028e9366c0e94,3,186,0,186,3,2014-11-04 16:52:06,2014-11-04 16:52:06
b4ae35aa38b700a0bcfbd650c48028e9366c0e94...5df8787c57c0d41d2a8c7650b1b6739cc7d1d1cc,1,1,1,2,1,2014-11-04 21:27:48,2014-11-04 21:27:48
9e5f46406d071d18238642287c5578b0fdc50348...44bd3c1a6b48489af073626ae8aed9ab23d3ab7a,1,33,9,42,9,2014-10-31 17:20:00,2014-10-31 17:20:00
44bd3c1a6b48489af073626ae8aed9ab23d3ab7a...d55adafdf15f97c67af9889672e5c624b76edaa7,1,1,1,2,1,2014-10-31 17:35:13,2014-10-31 17:35:13
4c3e635f8f5f31e889a4fa0d38f729f36b383697...01109315e2bca979d2bb1c88260fde036864c0c6,1,1,0,1,1,2014-09-09 17:33:15,2014-09-09 17:33:15
4c3e635f8f5f31e889a4fa0d38f729f36b383697...984bd97865d9cf01dc257e68a1496e89b939386c,2,15,0,15,3,2014-09-08 13:34:01,2014-09-08 13:31:03
984bd97865d9cf01dc257e68a1496e89b939386c...85d76b4860559851a2952c021436eab740704438,1,64,2,66,4,2014-09-19 16:40:00,2014-09-19 16:40:00
4c3e635f8f5f31e889a4fa0d38f729f36b383697...0c66b4dc800509d313d2752a2cc1ad6c72021b3a,1,78,0,78,1,2014-09-07 05:31:35,2014-09-07 05:05:19
0c66b4dc800509d313d2752a2cc1ad6c72021b3a...23c2a22d214f3582f531f1f21ba2cedda430ce01,1,25,10,35,3,2014-09-16 18:32:49,2014-09-16 18:32:49
4c3e635f8f5f31e889a4fa0d38f729f36b383697...5e0a66866d47b90f9fc7d437da3d567ec4ebba71,1,14,0,14,2,2014-09-06 20:11:52,2014-09-06 20:11:52
4c3e635f8f5f31e889a4fa0d38f729f36b383697...15296ed731ba8b94a9189cc42beadb250a1149e5,4,295,0,295,4,2014-09-06 11:54:57,2014-09-06 11:54:57
15296ed731ba8b94a9189cc42beadb250a1149e5...609d6630e3e2cbc7cb2809e31937d256cfdd73fc,1,1,1,2,1,2014-09-06 12:00:39,2014-09-06 12:00:39
609d6630e3e2cbc7cb2809e31937d256cfdd73fc...f15a11c1c9b929f25f899dfa21951993e9192139,2,2,2,4,2,2014-09-06 12:20:01,2014-09-06 12:20:01
f15a11c1c9b929f25f899dfa21951993e9192139...d9ed704d88912f473698754aec28c8dc823e252f,2,96,96,192,7,2014-09-06 14:57:29,2014-09-06 14:57:29
d9ed704d88912f473698754aec28c8dc823e252f...2b810c69dc6956b06db3f5eada9c91585f721b24,1,11,0,11,1,2014-09-06 15:13:58,2014-09-06 15:13:58
2b810c69dc6956b06db3f5eada9c91585f721b24...3de98d0f5ac2211cec1acd663bd71323a26d4b7c,2,5,1,6,3,2014-09-06 15:14:44,2014-09-06 15:14:44
3de98d0f5ac2211cec1acd663bd71323a26d4b7c...db475418bd19bdd31123f773c7a8912b62139afc,1,1,1,2,1,2014-09-06 15:27:02,2014-09-06 15:27:02
db475418bd19bdd31123f773c7a8912b62139afc...760a4ad784228987e4e74635904fe93b1e83381e,1,0,1,1,1,2014-09-06 15:38:49,2014-09-06 15:38:49
760a4ad784228987e4e74635904fe93b1e83381e...0220ebedcf7c5073894382c541887f7632eabf88,1,1,1,2,1,2014-09-15 15:08:13,2014-09-15 15:08:13
0220ebedcf7c5073894382c541887f7632eabf88...b0fd810c92f47bae7d07baf05756e15a933308c7,1,3,0,3,1,2014-09-15 15:29:56,2014-09-15 15:29:56
2eb38dcdc910e410fa3c932cd53313309f11f5b7...1ccb9c89ae65910f521f094c3cd1d3c3a0336e42,6,461,0,461,6,2014-08-17 17:28:46,2014-05-03 22:00:00
1ccb9c89ae65910f521f094c3cd1d3c3a0336e42...7f5e164d5a6b8a14c1853ac5da740b2ffec074d8,1,6,20,26,3,2014-08-17 17:28:47,2014-05-07 11:34:22
7f5e164d5a6b8a14c1853ac5da740b2ffec074d8...a3460de3b2896198141bbc0dc588aceeb25f9f87,2,8,8,16,4,2014-08-17 17:28:49,2014-08-17 17:05:35
a3460de3b2896198141bbc0dc588aceeb25f9f87...7ab37ba73f303d9803cc9ab9d462583402ce0ed6,2,24,12,36,9,2014-08-17 18:37:42,2014-08-17 18:37:42
667e37c3557134c1fbc1df158ec538e2206bc132...edb804c6fac661e11cc6ba310e0852aa1900431f,1,5,0,5,1,2014-08-18 17:59:25,2014-08-18 17:59:25
edb804c6fac661e11cc6ba310e0852aa1900431f...0ae5d68ca2ae493f425e8b3aeda440effd4b354d,1,1,1,2,1,2014-08-18 18:04:23,2014-08-18 18:04:23
0ae5d68ca2ae493f425e8b3aeda440effd4b354d...29c81a633744a3fcf042ef3b5280dde53c012846,2,48,0,48,2,2014-08-19 13:58:06,2014-08-19 13:58:06
29c81a633744a3fcf042ef3b5280dde53c012846...92b53d4a5e8a8fa5c2a04a1216300e3b911917b7,1,0,1,1,1,2014-08-19 14:24:26,2014-08-19 14:24:26
ef047cc3ea50727e216640708477bb8f7dceae92...faa49e4e54eb11e7c559c2cd69494b2a6f8da54a,46,2211,1214,3425,221,2014-04-14 07:10:25,2013-02-11 07:08:27
ef047cc3ea50727e216640708477bb8f7dceae92...4a919df3d2a708473a2b3f9f46ab1ca1d917e355,1,27,0,27,1,2014-04-14 06:24:59,2014-03-11 10:30:18
4a919df3d2a708473a2b3f9f46ab1ca1d917e355...b581de5dd1ab45511b1ab87b908ae9e5db50eab9,1,9,0,9,1,2014-04-14 06:25:00,2014-03-11 10:32:14
b581de5dd1ab45511b1ab87b908ae9e5db50eab9...e976037f20f9fa1d2bd5ac69cffab9d11947f0be,1,11,3,14,3,2014-04-14 06:25:00,2014-03-14 08:10:49
e976037f20f9fa1d2bd5ac69cffab9d11947f0be...183d0bad976c2ed1cac14d02da057568b3ef49a5,1,7,7,14,3,2014-04-14 06:25:00,2014-03-14 08:14:35
183d0bad976c2ed1cac14d02da057568b3ef49a5...5cb638a54ce38a3a2a5bf4edd9ffb15bceae8ce7,1,1,1,2,1,2014-04-14 06:25:00,2014-03-14 08:15:56
5cb638a54ce38a3a2a5bf4edd9ffb15bceae8ce7...b52ba738bab8c4bb87584926c7a7733c9d16c60f,1,2,8,10,1,2014-04-14 06:27:44,2014-04-14 06:27:44
b52ba738bab8c4bb87584926c7a7733c9d16c60f...9c1c9b885ea53c8fe9d6a75aa37d05999c779551,1,1,3,4,1,2014-04-14 06:28:59,2014-04-14 06:28:59
470033ae8ef276aa22e5a14c0be7eac2b73e3bee...d022072b5a978e8d74b96cf78d931300e1cc7a60,2,9,4,13,4,2014-04-21 20:03:38,2014-04-21 20:03:38
d082b5f239597672e150a0b226fae8059edb8a33...bb2e0fb9e53f329e770b0925c6fa10fe05352f64,1,11,0,11,1,2014-08-22 14:03:13,2014-08-22 14:03:13
a845fa37a6c38000c9061aa9afc329057d502eec...430c066f7797328afe292dabde608f1b784a1ab6,2,121,2,123,3,2014-11-07 08:05:12,2014-11-07 08:05:12
430c066f7797328afe292dabde608f1b784a1ab6...b7a0aeeedee473ce9487ff45a78e4373be4148f1,1,7,7,14,6,2014-11-07 08:25:57,2014-11-07 08:13:22
a845fa37a6c38000c9061aa9afc329057d502eec...18143d5d67c3ee8e447d1da569bbaedd4234921e,5,86,0,86,5,2014-11-06 12:27:58,2014-11-06 12:27:58
18143d5d67c3ee8e447d1da569bbaedd4234921e...7dca6083aeb63fccaecbe4d57dcf62d1a15ecf1f,4,143,18,161,8,2014-11-08 08:26:56,2014-11-08 08:26:56
7dca6083aeb63fccaecbe4d57dcf62d1a15ecf1f...96a9680049724e9127cf651d3c2efac8c13c7681,1,6,0,6,2,2014-11-08 09:55:12,2014-11-08 09:55:12
96a9680049724e9127cf651d3c2efac8c13c7681...c99dbcb2fa55bfecf02ad34cb0bd065526a7bf8a,1,0,5,5,1,2014-11-08 10:08:00,2014-11-08 10:08:00
c99dbcb2fa55bfecf02ad34cb0bd065526a7bf8a...13419b6a1f30f285f35c3505a9d83310d60259e0,1,1,1,2,1,2014-11-08 10:35:54,2014-11-08 10:35:54
13419b6a1f30f285f35c3505a9d83310d60259e0...7aea543a447d4eb7d2026c7baf14ac20d251d4ab,4,89,89,178,9,2014-11-10 18:32:39,2014-11-10 18:32:39
7aea543a447d4eb7d2026c7baf14ac20d251d4ab...6547a1a7c33ac53624c5221f791b1e4c47bbbece,4,4,4,8,4,2014-11-10 18:44:57,2014-11-10 18:44:57
6547a1a7c33ac53624c5221f791b1e4c47bbbece...d999900b7c82d4666602076b555b5802a4a8c3ab,1,72,6,78,3,2014-11-10 19:25:07,2014-11-10 19:25:07
d999900b7c82d4666602076b555b5802a4a8c3ab...8c03c2b66f3b45b9d6ea8b8a0331b644dc2966bf,1,0,1,1,1,2014-11-10 19:37:12,2014-11-10 19:37:12
8c03c2b66f3b45b9d6ea8b8a0331b644dc2966bf...daaa8ca8e0646ad683123294f6a84649ef063335,1,8,5,13,5,2014-11-10 21:30:46,2014-11-10 21:30:46
daaa8ca8e0646ad683123294f6a84649ef063335...6d9c9efa35e3c56c6ea097e07566b626cab3fe2c,1,8,0,8,1,2014-11-10 21:45:23,2014-11-10 21:45:23
6d9c9efa35e3c56c6ea097e07566b626cab3fe2c...7f51e051903d3c693b5e755be1c26534f0871547,1,0,8,8,1,2014-11-10 21:50:58,2014-11-10 21:50:58
7f51e051903d3c693b5e755be1c26534f0871547...2a3a5cb4cb6fa9cd8a46af03c7f6e5df9cbc6d8e,1,1,1,2,1,2014-11-10 22:08:15,2014-11-10 22:08:15
2a3a5cb4cb6fa9cd8a46af03c7f6e5df9cbc6d8e...e356b6d4ae9c035f3892f9a722d3994cb22dd820,1,1,1,2,1,2014-11-10 22:15:57,2014-11-10 22:15:57
e356b6d4ae9c035f3892f9a722d3994cb22dd820...dac6b1febd790922b5eac0a44cec73aedcd51942,1,2,2,4,2,2014-11-10 22:23:58,2014-11-10 22:23:58
dac6b1febd790922b5eac0a44cec73aedcd51942...ee13eba5f81181411d587c087738b009e2476699,1,10,2,12,3,2014-11-10 22:32:20,2014-11-10 22:32:20
ee13eba5f81181411d587c087738b009e2476699...48a1b7835cc23400b45b31998f9be721241dac4b,2,60,56,116,9,2014-11-12 18:46:27,2014-11-12 18:46:27
48a1b7835cc23400b45b31998f9be721241dac4b...7a99aef40e4ccb79ec2b14106eb9067a37488e05,1,2,4,6,2,2014-12-24 06:43:47,2014-12-24 06:43:47
7a99aef40e4ccb79ec2b14106eb9067a37488e05...2c2e9c20da9a01b2612cc8b9bed87017f1581459,1,2,6,8,3,2014-12-24 07:05:12,2014-12-24 07:05:12
7ca018d51b066c8db9b6ed4b9d1f8886bccfb47b...31e3f65437b33d399140dd88500f9f139b7607f5,1,1,1,2,1,2014-09-26 09:09:50,2014-09-26 09:09:50
7ca018d51b066c8db9b6ed4b9d1f8886bccfb47b...9c0940017d57ebfd40147d9f8308c1d40f2dc856,3,267,0,267,3,2014-09-24 00:28:12,2014-09-24 00:28:12
9c0940017d57ebfd40147d9f8308c1d40f2dc856...c2055c7c723cf7693fba2962b1d2dc226054f08f,1,8,8,16,4,2014-09-24 07:54:00,2014-09-24 07:54:00
c2055c7c723cf7693fba2962b1d2dc226054f08f...1b06bf8c2d5df6e87e904e842ce0b4daddd58819,1,2,2,4,2,2014-09-24 07:55:44,2014-09-24 07:55:44
1b06bf8c2d5df6e87e904e842ce0b4daddd58819...95da1a967585527b0c48f172916d7f7570974011,2,5,7,12,7,2014-12-03 15:31:10,2014-12-03 15:31:10
95da1a967585527b0c48f172916d7f7570974011...b8d05ad6fad645d0447eb520a9990e4d7a90983e,1,18,3,21,5,2014-12-04 05:50:11,2014-12-04 05:50:11
fceaaf3211c4f6c7495aa8e5fb86b9a339638f1a...69a162a3506a83702f2e9e8a36b6f781533fc311,1,14,14,28,1,2015-01-04 23:32:04,2015-01-04 23:32:04
942e90d797ea4e6c470659a8aa7cda9d52e48551...798c21d7ec316305219050ef6bf128b02e6226d4,1,1,1,2,1,2014-09-19 06:18:40,2014-09-19 06:18:40
942e90d797ea4e6c470659a8aa7cda9d52e48551...9573851bfd28533ed9b9885fd6e4226636d76c91,1,20,0,20,1,2014-09-17 12:30:57,2014-09-17 12:30:57
9573851bfd28533ed9b9885fd6e4226636d76c91...1125ac6b5206b7dc62a62404c07b059f1538c37a,1,0,1,1,1,2014-09-17 16:23:38,2014-09-17 16:23:38
cabb1cb45587d49c6981315bbf6e9b2a18a9acdd...92eb9aeae5ce196aba8f915fd7e33e4099d7ed8c,3,135,0,135,3,2014-04-21 20:42:28,2014-04-21 20:42:28
cabb1cb45587d49c6981315bbf6e9b2a18a9acdd...3508244fe4df9c43f8d928cc722226f139687a92,1,80,80,160,15,2014-04-21 20:32:12,2014-04-21 20:32:12
4d60fc4b20c7da4f6646be4da6a72460c96b55f9...3ab121157c57db7185e5f4775ab868ba96862b78,7,74,1,75,9,2014-08-25 13:35:06,2014-08-25 13:35:06
3ab121157c57db7185e5f4775ab868ba96862b78...9556b77c630eb9124b90381563a4abd00a353306,1,2,2,4,1,2014-08-25 13:40:25,2014-08-25 13:40:25
9556b77c630eb9124b90381563a4abd00a353306...611cd11495343ebc522c679f2883662ef42125d5,1,5,7,12,5,2014-08-25 15:15:13,2014-08-25 15:15:13
4d60fc4b20c7da4f6646be4da6a72460c96b55f9...9b017378e5856ed0531d90879dd70d022a2e3b66,3,86,0,86,3,2014-08-23 09:37:02,2014-08-23 09:37:02
9b017378e5856ed0531d90879dd70d022a2e3b66...aef58321907154d859d15f148df281a60befed9f,1,6,2,8,2,2014-08-23 13:10:42,2014-08-23 13:10:42
aef58321907154d859d15f148df281a60befed9f...0bc3798d6775fb1791f44304b6d29f7972e351a7,1,1,1,2,1,2014-08-23 13:14:13,2014-08-23 13:14:13
1c5fd3ea1eb70efaf1f906a0120f129cc5cd7e54...8f673c9e31c1aa5ce1e4d289be55c2384ee0ffd2,1,5,3,8,1,2014-11-07 08:38:46,2014-11-07 08:38:46
8e4d79b2e34268e49cddd0b198a4da4be6bbde3b...3c14fec1f800d7c8250cc0727faa4065f1e2ba6b,1,6,5,11,5,2015-01-04 23:45:15,2015-01-04 23:45:15
9f50d0ffb0b557ebf7880417107a5e57a8dfcad1...1bc7445faf39901cb28bb5f177249ee4a8f7fc26,1,1,1,2,1,2014-10-01 07:27:05,2014-10-01 07:27:05
eebe556a7c5ec7df04b65584d78adf8252c8e10f...d82603adc7aa0f7d47c2e767fd33636803f4117a,1,2,0,2,1,2014-12-18 07:45:28,2014-12-18 07:45:28
3a03f26ea3f8f86ebf90edb1df5c4c73ec4d68c2...b00358942f3c162ba9dc327cf0fcf6f95123d401,4,160,0,160,4,2014-04-21 21:58:40,2014-04-21 21:58:40
6c89416e8c485de87a4a8cd1e9311b9a12ed5420...d8b36a40732a8d255b81cb10a0e9cac9f73f774b,6,386,1,387,6,2014-09-04 04:52:22,2014-08-22 05:21:54
d8b36a40732a8d255b81cb10a0e9cac9f73f774b...b74a1be902707a4e9c8a139b3c6c3bc6daa413cd,5,90,135,225,17,2014-09-04 04:52:22,2014-08-24 16:40:04
b74a1be902707a4e9c8a139b3c6c3bc6daa413cd...2d1da0218149dbcef51ce9c89cd490eedca3683c,1,0,1,1,1,2014-09-04 04:52:22,2014-08-26 00:51:16
2d1da0218149dbcef51ce9c89cd490eedca3683c...5698eab9cba2cc15cf44156a9502283fa2209d51,1,21,4,25,5,2014-09-04 04:52:22,2014-08-28 14:30:53
5698eab9cba2cc15cf44156a9502283fa2209d51...98ff0424e8f92b8bbb59085df6400c4b9982d368,1,9,9,18,9,2014-09-04 04:52:36,2014-08-28 14:52:40
e49b9989b8687da7eedc5a33f7775a1562424765...966082b46c25144628a81a517bb03ca9ecd26128,1,3,13,16,7,2014-08-29 07:49:00,2014-08-29 07:49:00
966082b46c25144628a81a517bb03ca9ecd26128...4e44e3320398a76e683b57c44feb2a3d4d8515f9,1,5,0,5,1,2014-08-29 07:49:56,2014-08-29 07:49:56
4e44e3320398a76e683b57c44feb2a3d4d8515f9...19fa5196baf451ec5a3213b272ac43290756a791,1,1,1,2,1,2014-08-29 07:53:10,2014-08-29 07:53:10
19fa5196baf451ec5a3213b272ac43290756a791...abb6bb3f33bd46290e3c0b5acd658f16dbc737e0,1,1,1,2,1,2014-08-29 08:00:35,2014-08-29 08:00:35
8f673c9e31c1aa5ce1e4d289be55c2384ee0ffd2...bc0b86499e61a269bf60a262ea4c9e8bc7220c8e,2,997,0,997,2,2014-11-10 14:31:18,2014-11-10 14:31:18
bc0b86499e61a269bf60a262ea4c9e8bc7220c8e...f0df726d3b05fd54f28b0c936430a5f8c3fd2967,1,1,2,3,1,2014-11-10 14:34:12,2014-11-10 14:34:12
f0df726d3b05fd54f28b0c936430a5f8c3fd2967...6855f9c372db0c4002849271a8963f375fb86106,1,1,1,2,1,2014-11-10 14:34:59,2014-11-10 14:34:59
6855f9c372db0c4002849271a8963f375fb86106...d01ec8284b0193337642a8399873483029177187,1,3,2,5,2,2014-11-15 12:23:41,2014-11-15 12:23:41
d01ec8284b0193337642a8399873483029177187...679625ad2b8d66094616799d8f46310d96c37f1e,1,59,0,59,1,2014-12-20 10:40:42,2014-12-20 10:40:42
8f673c9e31c1aa5ce1e4d289be55c2384ee0ffd2...cfb4faf9762bfe7df7b7e3f6e29a39d16febf824,1,7,3,10,1,2014-11-08 13:21:51,2014-11-08 13:21:51
1ce76e851997c7ac51d7f76e5b4cd01ae50e607f...f711f260b6651ed0a6620211df98c2313ac912fb,1,21,0,21,1,2014-10-09 14:28:10,2014-10-09 14:28:10
f711f260b6651ed0a6620211df98c2313ac912fb...dce81dc08c595b61f68e98c460ada322c819e200,1,9,0,9,1,2014-10-09 14:29:38,2014-10-09 14:29:38
dce81dc08c595b61f68e98c460ada322c819e200...3e109766c1c470cf87f679a8d640938655265fae,2,0,19,19,2,2014-11-10 09:23:06,2014-11-10 09:23:06
3e109766c1c470cf87f679a8d640938655265fae...23bfe93e668b017c1e286f393d3d2cd20bb3c624,1,1,1,2,1,2014-11-11 10:42:54,2014-11-11 10:42:54
1ce76e851997c7ac51d7f76e5b4cd01ae50e607f...498caf292052cf8c93003315068ed7c1b9dd4a13,1,174,0,174,1,2014-10-03 08:47:16,2014-10-03 08:47:16
498caf292052cf8c93003315068ed7c1b9dd4a13...81662c79094016662ba1371c056180504a3d9bf9,2,48,93,141,20,2014-10-03 08:47:43,2014-09-23 10:24:56
81662c79094016662ba1371c056180504a3d9bf9...db8bba3432059a69540691aac1608c501b1fd27e,2,30,6,36,6,2014-10-07 07:33:32,2014-10-07 07:33:32
db8bba3432059a69540691aac1608c501b1fd27e...8b1dc8790fe01e7fccca2b720649206694cfa72d,1,0,1,1,1,2014-10-07 07:40:20,2014-10-07 07:40:20
8b1dc8790fe01e7fccca2b720649206694cfa72d...2a2197ceeb476b14936a0f11c925b0b3400cda56,1,1,1,2,1,2014-10-29 07:24:58,2014-10-29 07:24:58
1ce76e851997c7ac51d7f76e5b4cd01ae50e607f...2d1713c35beb3a2b9cce8894d813879ca03b4fc4,9,1113,0,1113,9,2014-10-02 04:03:18,2014-09-23 08:58:41
2d1713c35beb3a2b9cce8894d813879ca03b4fc4...aff762e5b73d686335c56fef3436115d5868cd6d,4,113,107,220,19,2014-10-02 04:03:18,2014-09-23 09:12:01
aff762e5b73d686335c56fef3436115d5868cd6d...005f6661ede534349972449cb4d955b3265a0e99,1,2,1,3,2,2014-10-02 04:03:18,2014-09-23 09:19:03
005f6661ede534349972449cb4d955b3265a0e99...986469a4edd1c34bb4f140de2dbc7e4bdb5338bc,1,3,3,6,3,2014-10-02 04:03:18,2014-09-23 09:19:33
986469a4edd1c34bb4f140de2dbc7e4bdb5338bc...94de4465ff2cc511fe42e3c25f1b03538d7ae598,1,1,1,2,1,2014-10-02 04:03:18,2014-09-23 09:26:33
94de4465ff2cc511fe42e3c25f1b03538d7ae598...2e48342f47d1c974b3c9d51f5c78b82ffad43dea,1,0,12,12,1,2014-10-02 04:03:19,2014-09-23 09:42:47
2e48342f47d1c974b3c9d51f5c78b82ffad43dea...6af3ccea9d7794b37ac9f5c3a98e2eb109b50d99,2,48,93,141,20,2014-10-02 04:03:19,2014-09-23 10:24:56
6af3ccea9d7794b37ac9f5c3a98e2eb109b50d99...9f893f1e59897eca79003469f68ae941febedc96,1,0,1,1,1,2014-10-02 04:03:19,2014-09-23 10:27:10
9f893f1e59897eca79003469f68ae941febedc96...98b84238d14bc7181fd9b4decd2f5f18ef48a0d2,1,0,1,1,1,2014-10-02 04:03:19,2014-09-23 10:31:03
98b84238d14bc7181fd9b4decd2f5f18ef48a0d2...d07f9ad812ec750d36127b0f9ce93e74af31324c,4,24,8,32,8,2014-10-03 08:11:19,2014-10-03 08:11:19
d07f9ad812ec750d36127b0f9ce93e74af31324c...2c417a55d8a85a3af6c835ecc6f088a68246c49c,2,93,46,139,19,2014-10-03 08:22:56,2014-10-03 08:22:56
2c417a55d8a85a3af6c835ecc6f088a68246c49c...531c1e91b872d2dbb3bb6a2333e6e49c04cc743e,1,0,174,174,1,2014-10-03 08:23:18,2014-10-03 08:23:18
d82603adc7aa0f7d47c2e767fd33636803f4117a...81c96e2150637740d1656aca2ca3131fb6ed6f97,23,77,679,756,38,2015-01-02 21:48:27,2014-05-15 00:19:18
81c96e2150637740d1656aca2ca3131fb6ed6f97...cbbb4fddd3cfed9d6cc3bfe18745983a9a3fcc8a,1,1,1,2,1,2015-01-02 21:48:27,2014-05-15 00:27:04
cbbb4fddd3cfed9d6cc3bfe18745983a9a3fcc8a...0c846e8dceffd4f17c4e46360d28bdf4bf270061,1,3,0,3,1,2015-01-02 21:48:28,2014-05-15 13:20:46
0c846e8dceffd4f17c4e46360d28bdf4bf270061...cfc80d9a7e89f3810e1e527830f86ab391b028a6,2,114,8,122,5,2015-01-02 21:48:28,2014-05-27 21:11:08
cfc80d9a7e89f3810e1e527830f86ab391b028a6...8b7e02d6187a919df8d474325a7f2951ccf1656a,1,1,1,2,1,2015-01-02 21:48:28,2014-05-27 21:44:31
8b7e02d6187a919df8d474325a7f2951ccf1656a...a245584d01806b3e5eefe001c8f2312457212698,6,12,154,166,16,2015-01-02 22:53:14,2015-01-02 22:00:17
a245584d01806b3e5eefe001c8f2312457212698...7d7fffe5c4cf417211a63cc17a54237f6d57699f,2,8,11,19,6,2015-01-02 22:53:25,2015-01-02 22:07:38
7d7fffe5c4cf417211a63cc17a54237f6d57699f...1570e3ee8f7ae3afe06e0c2d85968d28c44bf575,1,12,5,17,4,2015-01-02 22:53:32,2015-01-02 22:30:45
1570e3ee8f7ae3afe06e0c2d85968d28c44bf575...eeaa79c99f744525bb07d7e096ce36d416a24fb1,2,3,1,4,3,2015-01-02 22:53:33,2015-01-02 22:39:57
d82603adc7aa0f7d47c2e767fd33636803f4117a...772541423e521a8487051a7c50f87e9f0982ff93,1,18,1,19,1,2014-12-22 22:39:01,2014-12-22 22:39:01
54f93f9fc61e8d4d610ab7f8fb8d4c5fc1c418f5...70f30de162bb3441351c5c2080912205ece3cfb2,1,19,0,19,1,2014-04-23 22:05:40,2014-04-23 22:05:40
54f93f9fc61e8d4d610ab7f8fb8d4c5fc1c418f5...8dcc6528596fbdc350f0afb2ebcb8f25cce96455,3,177,0,177,3,2014-04-23 21:39:05,2014-04-23 21:39:05
8dcc6528596fbdc350f0afb2ebcb8f25cce96455...d0d712a0d6e1c42fecb07bac09b8fb4af331f3b0,1,4,1,5,3,2014-04-24 10:08:35,2014-04-24 10:08:35
4d9244b1703d302553c4b0db2140b00b7f126b39...b6d383161d84092a7a9f5b14db6e2637edbd3a6e,1,5,5,10,5,2014-10-14 14:30:56,2014-10-14 14:30:56
abb6bb3f33bd46290e3c0b5acd658f16dbc737e0...077626bfc420d147d048eba73a7e1c7f5eb1e463,5,5,5,10,5,2014-08-29 12:20:53,2014-08-29 12:20:53
bd8e63631145016cfdf26e658b4a8a2a393698c2...b90f9a134a34127c6986ee070c0cc3c778a68ab5,1,1,1,2,1,2014-11-12 14:59:01,2014-11-12 14:59:01
fd652d9ed2505ee9060caeb87f77be9a99f846b5...02b75d83091e2f86f98ab7f18e1844b35bf159bc,4,21,9,30,12,2014-10-29 07:12:02,2014-10-29 07:12:02
3e075bb726125a75cbcdde1cd6ca18bf9662a492...aca1dacd6188860684fc344880052f7fa94f709a,1,1,0,1,1,2015-03-18 15:41:46,2015-03-18 15:41:46
3bab1d19cf195ff9ee8732a5503c5d57774ec7d4...cbb7d9a03b6fa7b539b511608bce8f8e5b0ed549,1,30,30,60,2,2014-04-29 14:29:09,2014-04-29 14:29:09
3bab1d19cf195ff9ee8732a5503c5d57774ec7d4...5f7138664544b4016441abe07bd3892738835720,5,75,3,78,6,2014-04-24 19:29:37,2014-03-15 10:15:52
5f7138664544b4016441abe07bd3892738835720...77e10cc4e9f1dca34b4fc9970cd11406ff2e9fbc,1,5,7,12,6,2014-04-24 19:29:37,2014-03-16 03:38:33
77e10cc4e9f1dca34b4fc9970cd11406ff2e9fbc...95672da014892304cca3db461635e7c39869e310,1,2,5,7,3,2014-04-24 19:29:37,2014-03-16 09:26:54
95672da014892304cca3db461635e7c39869e310...d049cedc744a517e38f7e865dec749bd47a3e8d3,5,46,64,110,5,2014-04-24 19:42:32,2014-04-24 19:42:32
d049cedc744a517e38f7e865dec749bd47a3e8d3...71a3ab02ff1d12cd340cc43a85e239eb7d5df34b,1,1,1,2,1,2014-04-24 19:49:24,2014-04-24 19:49:24
71a3ab02ff1d12cd340cc43a85e239eb7d5df34b...9cd4a888c13ae53c68dda7b97959fe88fcad6d0a,1,1,1,2,1,2014-04-24 19:55:52,2014-04-24 19:55:52
9cd4a888c13ae53c68dda7b97959fe88fcad6d0a...38932b985887f2ec4d2a6c1f68706a7753795453,1,5,9,14,3,2014-05-04 09:58:09,2014-05-04 09:58:09
b6d383161d84092a7a9f5b14db6e2637edbd3a6e...db081686b361547913928598e9af227a619d6874,1,9,10,19,2,2014-10-28 17:29:29,2014-10-28 16:52:57
b6d383161d84092a7a9f5b14db6e2637edbd3a6e...4e8a2828dc75bfd6d4e362a428072124addb124b,6,454,0,454,6,2014-10-27 20:03:53,2014-10-27 20:03:53
4e8a2828dc75bfd6d4e362a428072124addb124b...6f3a0a2c740103591207075b15041874f95a3bb0,5,58,8,66,8,2014-10-27 20:24:48,2014-10-27 20:24:48
6f3a0a2c740103591207075b15041874f95a3bb0...f85abd98402cdeecb30290d29ae996a22f7ae91b,2,6,3,9,2,2014-10-27 20:41:03,2014-10-27 20:41:03
f85abd98402cdeecb30290d29ae996a22f7ae91b...2a77abf4450443486e08d6d5bb6672e8618b46a9,1,27,0,27,1,2014-10-27 21:04:15,2014-10-27 21:04:15
2a77abf4450443486e08d6d5bb6672e8618b46a9...63d5dc5dfbba284e2c1aeb7a26e19a0e5ff82ed7,1,19,4,23,9,2014-10-29 13:46:29,2014-10-29 13:46:29
63d5dc5dfbba284e2c1aeb7a26e19a0e5ff82ed7...a2fa7475f8bf4bc6919783b25944251be206df1d,1,10,43,53,5,2014-10-29 13:49:46,2014-10-29 13:49:46
a2fa7475f8bf4bc6919783b25944251be206df1d...6df6f1fe4a4aed43e4e379316bd5cedc2b5ef508,1,0,18,18,1,2014-10-29 13:50:34,2014-10-29 13:50:34
b6d383161d84092a7a9f5b14db6e2637edbd3a6e...44cddbd694dfca3e2c6c96c7cc0c178573416c44,1,1,1,2,1,2014-10-27 15:52:48,2014-10-27 15:52:48
b6d383161d84092a7a9f5b14db6e2637edbd3a6e...2d8a9ea0aca17ebda10a15e4fa8add7ba3727a57,1,1,1,2,1,2014-10-24 09:15:02,2014-10-24 09:15:02
077626bfc420d147d048eba73a7e1c7f5eb1e463...631f25a7ce2b88640df73b106264f688a9318ae3,1,5,0,5,1,2014-08-30 08:41:50,2014-08-30 08:41:50
631f25a7ce2b88640df73b106264f688a9318ae3...3cfd26664ff92082fcadf76a14859c1d7234ffff,1,26,0,26,1,2014-08-30 09:11:13,2014-08-30 09:11:13
44eae4deeb065454e68b3c9911181285f01003c6...647e78ab353582c68e019483840195039b392f42,1,11,0,11,1,2014-11-19 22:26:13,2014-11-19 22:26:13
647e78ab353582c68e019483840195039b392f42...1627182fc03f36fa1a1e5203dbabba2a37da9421,1,5,5,10,1,2014-11-19 23:19:41,2014-11-19 23:19:41
1627182fc03f36fa1a1e5203dbabba2a37da9421...9dcf10e8ee7045a25d94468d0faa4fda17c2bccc,2,2,0,2,2,2014-11-21 07:05:20,2014-11-21 07:05:20
b0795fed35b9fd83a6247976c9e6990d33d76551...9d9bd78a9c875e6cd8ab9555823017ef3182ece5,1,1,1,2,1,2015-01-04 23:56:37,2015-01-04 23:56:37
ec4cae94def6538c84a2e937a5549ecdd3d5be90...293b16ef75e09d511ca4ab131e7fa4c093534e6b,1,4,5,9,3,2015-01-02 23:06:12,2015-01-02 23:06:12
c43676fdda733c413ec016d4fdeb73d5477e4d65...e7bfd8f2b903ec506131efc2ac7d6cd5bfb37621,1,12,2,14,1,2014-05-06 11:30:31,2014-05-06 11:30:31
e7bfd8f2b903ec506131efc2ac7d6cd5bfb37621...fae73a1731fb40a143569773d8631c8e281916f6,1,12,0,12,1,2014-05-06 17:10:09,2014-05-06 17:10:09
c43676fdda733c413ec016d4fdeb73d5477e4d65...cf3b7a539cae81d49ff632f1c712764d4b645074,1,1,1,2,1,2014-05-06 11:19:11,2014-05-06 11:19:11
c43676fdda733c413ec016d4fdeb73d5477e4d65...5283130e3b6ca3710033a8f27077e6673bbf1c23,5,67,28,95,10,2014-05-01 02:51:06,2014-04-04 21:45:56
38932b985887f2ec4d2a6c1f68706a7753795453...7d4966316471d21a55df85bb56d4d6011b3af061,1,2,2,4,1,2014-05-07 09:35:25,2014-05-07 09:35:25
0b3e80e8099e9e42be665489930e5d0554f5a18b...f15077304becf6a0290b43e44cce8ef674a8ad26,1,1,1,2,1,2014-10-29 09:08:06,2014-10-29 09:08:06
10d9057658345191ac76b2782eb141355fd9a366...7ee62100bfc79baffdb899991f7e94ef24e203f5,3,33,13,46,10,2014-09-01 13:25:30,2014-09-01 13:20:02
d6d0d9d7caf1083cd458836898644dffb714162d...fb933c44d0201e67cdf5ac57e8fb5073383ff312,4,70,0,70,4,2014-12-01 21:10:49,2014-11-30 11:23:21
fb933c44d0201e67cdf5ac57e8fb5073383ff312...35028602fed87ff92e0fb44272fd4544530be7a2,1,2,1,3,1,2014-12-01 21:49:31,2014-12-01 21:49:31
9dcf10e8ee7045a25d94468d0faa4fda17c2bccc...10c944f57a9795c04559889fcf4aaec7269b1961,1,1,0,1,1,2014-11-30 09:54:03,2014-11-30 09:54:03
9d9bd78a9c875e6cd8ab9555823017ef3182ece5...95964600a700fefdb5a7e9d3c36789fcefbc8e7b,2,38,0,38,3,2015-01-10 12:03:45,2015-01-10 12:03:45
9d9bd78a9c875e6cd8ab9555823017ef3182ece5...b23d3fc533cf24ced58940aa9e1a6ebc7eebe6fb,3,70,0,70,3,2015-01-05 20:45:59,2015-01-05 20:45:59
293b16ef75e09d511ca4ab131e7fa4c093534e6b...f6aae58a0d7c5ace0d95ae1281b67b3d16c54941,1,2,3,5,2,2015-01-04 21:38:19,2015-01-04 21:38:19
293b16ef75e09d511ca4ab131e7fa4c093534e6b...bdf1848e638e2431b57646f54a984ff8f8893fe5,1,2,2,4,1,2015-01-04 00:13:13,2015-01-04 00:13:13
bd521cb0a4962a661221453e1f4856a1b9f27f70...a7be5eca54fe7d65d529d6c4b276c8462ae73d51,1,1,1,2,1,2014-05-06 21:00:46,2014-05-06 21:00:46
eceafbd030015620cd58c82f26ebc60927c8cbd5...dcf20ad05a7910693104b2dc573d2f77445e2b3f,1,0,1,1,1,2014-05-06 21:05:45,2014-05-06 21:05:45
2b2e134e28851bbff28d561035a87fb2bb511dbd...ed4d77cb11b541d840816c1782b29f53b33cc826,1,1,0,1,1,2014-05-06 21:18:57,2014-05-06 21:18:57
ed4d77cb11b541d840816c1782b29f53b33cc826...54f3db3d14a02a598c544c10c6e1e1588089fbc1,2,4,4,8,8,2014-05-06 21:20:06,2014-05-06 21:20:06
9c5c88f2576b3c4f0c2e2c4c4ae2a8ec55d8a348...eb28eb0187296a86f9cdc7743ebd6086b75c0e9b,1,1,1,2,1,2014-09-01 13:51:21,2014-09-01 13:51:21
420851d62126509a5444fdd06f15f57ac05ab29a...d84d182da5340806177d06eea550eade019be114,1,22,0,22,2,2014-12-04 10:45:08,2014-12-04 10:45:08
d84d182da5340806177d06eea550eade019be114...9a301eadce2055895141c7f3a6a49f494ecd8796,1,11,0,11,1,2015-01-07 17:18:16,2015-01-07 17:18:16
1dc843aaf1b6032a78082145cc2abe41f0ce0ec2...9ccfd78f1a4ba36b142599175282a450e420f10b,1,2,1,3,2,2015-01-20 15:19:11,2015-01-20 15:19:11
9ccfd78f1a4ba36b142599175282a450e420f10b...e76fad390b4f1058ea15b11e2ee2f9cabb56aef7,1,1,1,2,1,2015-01-20 15:36:52,2015-01-20 15:36:52
e76fad390b4f1058ea15b11e2ee2f9cabb56aef7...e819dffc09457cec8b69e95000f174f2c1377c3b,1,1,1,2,1,2015-01-20 15:41:00,2015-01-20 15:41:00
1dc843aaf1b6032a78082145cc2abe41f0ce0ec2...c0d339b3933d6ca8036fe46cc48c725b99c5b5e7,2,172,0,172,2,2015-01-14 13:20:50,2015-01-14 13:20:50
c0d339b3933d6ca8036fe46cc48c725b99c5b5e7...4b9f574b5fb7600e574df8e43d93a790d73faa54,1,16,16,32,10,2015-01-14 13:28:51,2015-01-14 13:28:51
4b9f574b5fb7600e574df8e43d93a790d73faa54...08dc1f6fbf355f3767a5c98ec5cec0e67317e5d5,2,491,1,492,2,2015-01-23 06:35:44,2015-01-23 06:35:44
08dc1f6fbf355f3767a5c98ec5cec0e67317e5d5...a928c0e053d9fb2ec07c29a88c26c06c6da8f22f,1,56,0,56,1,2015-01-23 06:57:09,2015-01-23 06:57:09
a928c0e053d9fb2ec07c29a88c26c06c6da8f22f...4ee75435b4a517ab3830509babe17f876c877484,1,45,2,47,4,2015-01-27 10:31:55,2015-01-27 10:31:55
4ee75435b4a517ab3830509babe17f876c877484...8c0c07b4584587834c3c36d4ab6b76716f70e8a0,1,32,14,46,1,2015-01-27 10:40:55,2015-01-27 10:40:55
8c0c07b4584587834c3c36d4ab6b76716f70e8a0...ce9ec36bef459f9bc196c9a3607f243141adbd13,2,4,1,5,2,2015-01-27 10:44:29,2015-01-27 10:44:29
f6aae58a0d7c5ace0d95ae1281b67b3d16c54941...48f9e750b525ccc6ae78a905a1b4bc25029a05ba,5,1177,0,1177,5,2015-01-04 21:48:20,2014-07-26 09:26:45
48f9e750b525ccc6ae78a905a1b4bc25029a05ba...d65354d6e8cf0a1a21e44ec22292c89b2565048f,4,148,116,264,19,2015-01-04 21:48:20,2014-07-26 09:55:59
d65354d6e8cf0a1a21e44ec22292c89b2565048f...a64991ce2c6435350e73ab8349a0ba789f5a338c,4,5,103,108,5,2015-01-04 21:54:28,2015-01-04 21:54:28
a64991ce2c6435350e73ab8349a0ba789f5a338c...b1ae83fcb49ec78eb3d52197300374248fbb2a64,2,4,4,8,4,2015-01-04 22:36:00,2015-01-04 22:36:00
b1ae83fcb49ec78eb3d52197300374248fbb2a64...a670e15c44b0445a0a178eb074de8eb70f9a6a49,1,46,85,131,2,2015-01-04 22:36:15,2015-01-04 22:36:15
a47e8c188d6b6b69ce0211a1347947a620729a42...73a687f258ab7eef202afa88764e4d0f28db7fd0,1,2,2,4,2,2014-05-10 21:43:49,2014-05-10 21:43:49
54f3db3d14a02a598c544c10c6e1e1588089fbc1...c2d2d869c1fc2f4e6ba55489da23a322a8cc1b54,1,1,1,2,1,2014-05-06 21:40:22,2014-05-06 21:40:22
eb28eb0187296a86f9cdc7743ebd6086b75c0e9b...33bbb9bc78fc3f33eeab8a2e4467b4fc6b71da02,2,109,0,109,2,2014-09-01 15:20:05,2014-09-01 15:20:05
33bbb9bc78fc3f33eeab8a2e4467b4fc6b71da02...d768a76d3204d978317a7977899c86ab68277b6a,6,94,87,181,29,2014-09-01 16:03:34,2014-09-01 16:03:34
d768a76d3204d978317a7977899c86ab68277b6a...17a2033b95dba22686c48a95d0d01c8daab632c5,7,41,158,199,27,2014-09-01 16:31:14,2014-09-01 16:31:14
17a2033b95dba22686c48a95d0d01c8daab632c5...b25d30cda9be622637834299a36702dfe69e3a0d,6,60,100,160,19,2014-09-02 20:26:33,2014-09-02 20:26:33
b25d30cda9be622637834299a36702dfe69e3a0d...ad0d506c0800cea14ce76add6414e8626abc3b2b,8,9,9,18,12,2014-09-02 20:41:33,2014-09-02 20:41:33
ad0d506c0800cea14ce76add6414e8626abc3b2b...33339779cebe5c6a63aaac602e6899ab33abf36e,1,4,1,5,2,2014-09-02 20:50:07,2014-09-02 20:50:07
eb28eb0187296a86f9cdc7743ebd6086b75c0e9b...1674122eff9497d0ed106b861af6b2bb45411979,1,1,6,7,1,2014-09-01 14:47:16,2014-09-01 14:47:16
b1167d9c67a3325a3f4099eb7d848c6c30cc87c2...36d82945df1d746c1f6ba97775b5fadad050633f,3,63,0,63,3,2015-01-25 09:51:14,2015-01-25 09:48:19
74f58bbda974d0820183d228f120c2f3258bf7f6...93ecb6f6d7d73ae9f48c0d542adfd6fcecda1f34,1,36,0,36,1,2015-02-21 17:42:15,2015-02-21 17:42:15
74f58bbda974d0820183d228f120c2f3258bf7f6...cb389652473a5502b9fd411a713fe5ab067bfabb,1,1,1,2,1,2015-02-21 16:43:11,2015-02-21 16:43:11
b09c41fcf7250b1344a506f0386fe31415af0699...285703df9132693c893efaac575e089421ed62cb,4,320,657,977,25,2015-01-04 22:59:13,2014-08-11 07:40:44
1c300a6f35fa0061edb4ad6fa6c5df0c4f3ed418...5476642acfe1e2851b55debc3f4b6d972338f2a0,1,1,1,2,1,2014-05-14 21:18:42,2014-05-14 21:18:42
1e1e82dea7fbb0c386d25e8b8b69a22fcc00f102...904496ef8f0277cecababbc8add214bfc23ff467,3,17,58,75,12,2014-05-06 22:05:17,2014-05-06 22:05:17
765fc2280bbe219278514a687d5d6243ed4f5ca4...c6cb89ee601c41ecd02e1943972f244d829cc250,3,37,3,40,4,2014-09-02 21:12:30,2014-09-02 21:12:30
c6cb89ee601c41ecd02e1943972f244d829cc250...b1d999ff4692d8c84abc6d3959e2075783c44d2e,2,6,4,10,3,2014-09-02 21:24:44,2014-09-02 21:24:44
9b9ec8d3d3d1f05df2fddb49a6257bbc235d32ea...81e4eccea302300ac0c69c7ed04c94e29f580633,1,1,0,1,1,2015-01-27 08:16:46,2015-01-27 08:16:46
2495d3361ac1e9fc15608a1b33ec2dd41c56b2dc...53a6777662eeaeff3fbc2a92dc53b80e15756666,1,1,0,1,1,2015-02-26 21:21:19,2015-02-26 21:21:19
86eaa6f31b06916232baa647677750e4485502c3...572a852a605606b256201203aab2d37f879d4d15,2,16,1,17,4,2015-01-04 23:13:24,2014-07-18 07:50:25
572a852a605606b256201203aab2d37f879d4d15...2f779436de60b9d2813e228d42f560759b70be7f,1,1,1,2,1,2015-01-04 23:13:24,2014-07-18 08:21:58
2f779436de60b9d2813e228d42f560759b70be7f...cb512ae189da3112351a69e4983b6af677ca92f4,1,2,0,2,1,2015-01-04 23:13:24,2014-08-26 09:42:20
cb512ae189da3112351a69e4983b6af677ca92f4...f0d41792c919820097b2f54eb4ed82816998c4da,3,12,14,26,13,2015-01-04 23:22:18,2015-01-04 23:22:18
5476642acfe1e2851b55debc3f4b6d972338f2a0...a96d7241d4568678cc3f5fdd260bede9b67b3dc9,1,1,1,2,1,2014-05-15 12:57:33,2014-05-15 12:57:33
5476642acfe1e2851b55debc3f4b6d972338f2a0...6e38e2a76ce1a7bce164b88bd8499bddf252effb,3,127,1,128,3,2014-05-14 21:42:15,2014-05-14 21:35:32
6e38e2a76ce1a7bce164b88bd8499bddf252effb...6f1e7316744228a7e7b38f8e8f54bfdaa7aa1372,2,6,0,6,2,2014-05-14 21:45:29,2014-05-14 21:45:29
6f1e7316744228a7e7b38f8e8f54bfdaa7aa1372...36f8578a6a8de7684cc4b6318de5fbd624066343,1,5,5,10,5,2014-11-11 00:44:08,2014-11-11 00:44:08
36f8578a6a8de7684cc4b6318de5fbd624066343...531ea5a5f05f437a0a0e5c732188d51e769152e2,2,24,12,36,9,2014-11-11 00:45:03,2014-11-11 00:45:03
531ea5a5f05f437a0a0e5c732188d51e769152e2...e9ded67745251414ca401d3665e1f3a2192c9617,1,1,1,2,1,2014-11-11 00:55:44,2014-11-11 00:55:25
904496ef8f0277cecababbc8add214bfc23ff467...e4cd19784dbce9861cb894b86fc1680abe259012,2,26,1,27,3,2014-05-09 09:58:23,2014-05-09 09:58:23
e4cd19784dbce9861cb894b86fc1680abe259012...f3a928531d425ed32149bd1a3a224afbf26656db,1,13,4,17,5,2014-05-09 10:07:25,2014-05-09 10:07:25
f3a928531d425ed32149bd1a3a224afbf26656db...a74df0ce6b305b2a5cbe77cde9b9894db16938db,1,10,0,10,1,2014-05-09 10:09:21,2014-05-09 10:09:21
904496ef8f0277cecababbc8add214bfc23ff467...2badc23bf9adfecb9197936e9bb3a1aa741c3c64,1,8,8,16,3,2014-05-06 22:46:12,2014-05-06 22:46:12
2badc23bf9adfecb9197936e9bb3a1aa741c3c64...7b84633e10186faea7623c8cf66925af3ecd4bd4,1,1,1,2,1,2014-05-07 05:18:18,2014-05-07 05:18:18
7b84633e10186faea7623c8cf66925af3ecd4bd4...34351ea4e90c80b57a2406d93c52620aaeb9eee2,1,40,5,45,5,2014-05-08 22:08:27,2014-05-08 22:08:27
904496ef8f0277cecababbc8add214bfc23ff467...5b2896d32b1b4b159c54eb6103f03053722e061a,1,1,1,2,1,2014-05-06 22:35:08,2014-05-06 22:35:08
5b2896d32b1b4b159c54eb6103f03053722e061a...b85e312ba867c6ac92d8dfdb987036c542bffbff,1,1,1,2,1,2014-05-06 22:39:37,2014-05-06 22:39:37
81e4eccea302300ac0c69c7ed04c94e29f580633...bcf933a5e2c153058be8f62e74251e1224536cc0,1,2,2,4,2,2015-02-11 19:48:38,2015-02-11 19:48:38
81e4eccea302300ac0c69c7ed04c94e29f580633...320baafaf734d84507f2628d8dfdbfdad9b3e44e,1,6958,0,6958,1,2015-02-11 11:04:30,2015-02-11 11:04:30
320baafaf734d84507f2628d8dfdbfdad9b3e44e...9625956ef3946a36b75fdc91e41bb12568aa2f39,1,1966,6930,8896,19,2015-02-23 15:36:32,2015-02-23 15:36:32
40426f77f030b6fb45951be920ff1036b2f423d2...1d172f91f782192a7643c7c37cecf0994f7a7e85,1,1,0,1,1,2015-03-10 03:43:22,2015-03-10 03:43:22
f55668e1fd2abfb8c0aefec16f744735dda7c68b...69a0a844bc84f7b97cf25ee5ce04f623b26462db,1,2,0,2,1,2014-05-26 11:35:17,2014-05-26 11:35:17
69a0a844bc84f7b97cf25ee5ce04f623b26462db...616c9b9dde32afdfece8395b38b72ca95a9fbc40,1,1,1,2,1,2014-05-26 11:35:49,2014-05-26 11:35:49
a96d7241d4568678cc3f5fdd260bede9b67b3dc9...9a79a049498905c673a2ee5df9339da582a3b35f,1,149,0,149,1,2014-05-26 08:32:06,2014-05-24 17:38:40
9a79a049498905c673a2ee5df9339da582a3b35f...c08cd54e390f559c9c1d40bd3937cef96954f596,1,118,0,118,1,2014-05-26 08:32:06,2014-05-24 17:38:48
c08cd54e390f559c9c1d40bd3937cef96954f596...1db8bdf6c160755d137f912bcbe83398a6d45494,1,62,0,62,1,2014-05-26 08:32:06,2014-05-24 17:39:39
1db8bdf6c160755d137f912bcbe83398a6d45494...d7328a6ec50a36ad9de03f84aef880f921c6c8ec,1,7185,0,7185,1,2014-05-26 08:32:10,2014-05-24 17:40:02
d7328a6ec50a36ad9de03f84aef880f921c6c8ec...0a8e35a8ec8cb688e7a8a1001f6c0fc592106201,1,45,45,90,9,2014-05-26 08:32:10,2014-05-24 21:55:13
0a8e35a8ec8cb688e7a8a1001f6c0fc592106201...fe2b91bb99df72403aa28ab482cdf96aac5dfb2c,1,26,0,26,1,2014-05-26 08:32:10,2014-05-24 22:00:33
2643c9e44530dcd673b7fb6bd849171c6f1be7b5...f9947680ff2cc138c55ffa46de2fcb4a6de6a268,1,1,1,2,1,2014-05-08 22:19:47,2014-05-08 22:19:47
80c1424e6522a3303d320b611647fa6fbc29a8e4...156245e50f84209625253239162ec959c8950cee,1,28,24,52,3,2015-02-18 20:11:49,2015-02-18 20:11:49
d0a878177e75d4c9bea4b63101784deeb7181008...f13edf65c6005b4c59cd90c4f7d8bc0ffdaa8773,1,4,4,8,2,2015-03-18 13:07:07,2015-03-18 13:07:07
f13edf65c6005b4c59cd90c4f7d8bc0ffdaa8773...d62f9167ab8237740bfa4e9d1292e26d22b02178,1,1,1,2,1,2015-03-18 13:19:14,2015-03-18 13:19:14
5f91d63d78036ee445601ce0c606cdceb0be55d2...d6bf5829210cb195a132c413bca8d92f6ef48f8f,1,1,1,2,1,2015-03-16 14:23:34,2015-03-16 14:23:34
5f91d63d78036ee445601ce0c606cdceb0be55d2...315a499c87f5d4e09b659d6971dd67eeabc982fa,1,1,1,2,1,2015-03-13 19:39:11,2015-03-13 19:39:11
b54b2447aae9a027e8a6368276409e4daeb718b3...bef864c6e483857960d76d5b397ac6dc97948109,1,2,2,4,2,2014-05-27 14:09:55,2014-05-27 14:09:55
1c3220d50a4ef0b35f442364c7656e082a4c6f99...f23b5d6f4f728a4f00be859b4e3b02e12e896d7b,1,3,2,5,1,2015-03-18 15:47:35,2015-03-18 15:47:35
52b4a355e5ff765407f919a366b5fafcfcfecb82...0675ac75acbb2362d6727636e7fade17238f7ba0,1,60,0,60,1,2014-06-01 20:22:16,2014-06-01 20:22:16
0675ac75acbb2362d6727636e7fade17238f7ba0...2a29f17d2d8da0cbf97e1fc3c66d4eb0cdc3b7f1,3,17,22,39,12,2014-06-01 20:43:29,2014-06-01 20:43:29
2a29f17d2d8da0cbf97e1fc3c66d4eb0cdc3b7f1...55fe8ccbd3b57c639897c8d2f6f7c5e814bae84b,3,5,5,10,5,2014-06-01 20:50:52,2014-06-01 20:50:52
55fe8ccbd3b57c639897c8d2f6f7c5e814bae84b...41ce3b67b5cf0abeaa80c5d7b2ab27fc114d98e3,1,2,0,2,1,2014-06-01 20:52:56,2014-06-01 20:52:56
41ce3b67b5cf0abeaa80c5d7b2ab27fc114d98e3...64e19916baaf84f2ad4db22817a0bcf279689020,1,4,5,9,1,2014-06-01 20:58:03,2014-06-01 20:58:03
f9713bb5c0740a1bf2d3fea40c833ceb96c5082c...9497e316ccc5695d7103a6c2eafde31db2ef32f5,2,15,5,20,6,2014-06-02 19:27:08,2014-06-02 19:27:08
f9713bb5c0740a1bf2d3fea40c833ceb96c5082c...f313ecdeec2f0e44c0cfabba25bfdead60250748,1,0,1,1,1,2014-06-02 16:08:09,2014-06-02 16:08:09
f313ecdeec2f0e44c0cfabba25bfdead60250748...6ef19503f7362aac8f9eaa7d7161ad38fe542b12,2,121,0,121,2,2014-06-02 16:18:43,2014-06-02 16:18:43
f9713bb5c0740a1bf2d3fea40c833ceb96c5082c...7cc90f4a8241c69ace875408e43af978faaa6e3b,1,13,1,14,1,2014-06-02 05:22:12,2014-06-02 05:22:12
9ebd952cb5e087af84b17b3efcfcd42b8b3f463e...f1ada9daa364eeb8376b2c5089a5ad685dd9e031,1,1,1,2,2,2014-06-02 19:37:40,2014-06-02 19:37:40
f1ada9daa364eeb8376b2c5089a5ad685dd9e031...f8e852f06e0158974d17a4efb7b6d60496de56be,1,1,1,2,1,2014-06-03 12:20:02,2014-06-03 12:20:02
f1ada9daa364eeb8376b2c5089a5ad685dd9e031...85fe504a3480e6387bd0f309517566dabb53add0,2,32,7,39,7,2014-06-02 20:07:02,2014-06-02 20:07:02
85fe504a3480e6387bd0f309517566dabb53add0...b08e6bc2a278829e8593b214eb6dded82833fdfa,1,1,1,2,1,2014-06-02 20:15:29,2014-06-02 20:15:29
b08e6bc2a278829e8593b214eb6dded82833fdfa...8786da5b031109b94ad9508b8b89d4a0a33cf7b4,1,1,1,2,1,2014-06-02 20:17:41,2014-06-02 20:17:41
8786da5b031109b94ad9508b8b89d4a0a33cf7b4...47cd2fd0d817b7404889606ed4272280a8aa85cd,1,1,1,2,1,2014-06-02 20:21:59,2014-06-02 20:21:59
47cd2fd0d817b7404889606ed4272280a8aa85cd...6c909d44769551c2c92980f0bf9c48d057aa3dd0,1,15,12,27,5,2014-06-03 19:23:11,2014-06-03 19:23:11
b60a96a9db5c2cfcd9435b2ec70247240a6d8b6e...65ce4241afe3ed27467046b06341569039f53633,1,3,1,4,1,2014-06-03 20:14:42,2014-06-03 20:14:42
65ce4241afe3ed27467046b06341569039f53633...e7a9c71db510e06b7771024ac3ba5cfa08db75c9,1,2,6,8,2,2014-06-03 20:39:01,2014-06-03 20:39:01
e7a9c71db510e06b7771024ac3ba5cfa08db75c9...010c7efedd88bf31141a02719f51fb44c732d5a0,2,3,3,6,2,2014-06-04 14:43:02,2014-06-04 14:43:02
010c7efedd88bf31141a02719f51fb44c732d5a0...0b903eaff5da0a5043e2769c5ec1f50620652812,1,1,1,2,1,2014-06-04 14:44:10,2014-06-04 14:44:10
0b903eaff5da0a5043e2769c5ec1f50620652812...c7a88a9e96571f15290a5d8d5a30abddc41210f2,8,4233,1,4234,8,2014-06-12 23:15:52,2014-06-12 23:15:52
c7a88a9e96571f15290a5d8d5a30abddc41210f2...0921304ad812ff6f12ebed385ec7bdb3119f2983,3,0,256,256,3,2014-06-12 23:16:39,2014-06-12 23:16:39
0921304ad812ff6f12ebed385ec7bdb3119f2983...272fb49b124a7ac8e5f82941360e1f7547a792f8,5,299,109,408,28,2014-06-13 16:10:15,2014-06-13 16:10:15
272fb49b124a7ac8e5f82941360e1f7547a792f8...c4c3eb2a4558ced000b56c7547079f9b55156b88,1,1,1,2,1,2014-06-13 16:12:18,2014-06-13 16:12:18
c4c3eb2a4558ced000b56c7547079f9b55156b88...cbd6d1694f04313c2c507b9a431a14e5e5899ff2,1,18,0,18,1,2014-06-13 21:17:06,2014-06-13 21:17:06
cbd6d1694f04313c2c507b9a431a14e5e5899ff2...15289c83f359d9d0dbe56aae3bb9c3b18e451d34,1,1,1,2,1,2014-06-14 12:46:57,2014-06-14 12:46:57
15289c83f359d9d0dbe56aae3bb9c3b18e451d34...f1379f32ca09f7115175d3fd9ff18d0b0e730bfe,1,97,3670,3767,43,2014-06-14 13:01:11,2014-06-14 13:01:11
f1379f32ca09f7115175d3fd9ff18d0b0e730bfe...2af6b5bbcb43c64c2b2eed4d7190b5754b18d6f6,1,2,1,3,1,2014-06-14 13:02:44,2014-06-14 13:02:44
2af6b5bbcb43c64c2b2eed4d7190b5754b18d6f6...45f57ed8b781c81d6348691f43bb73a26475bedc,1,8,4,12,3,2014-06-14 13:20:53,2014-06-14 13:20:53
45f57ed8b781c81d6348691f43bb73a26475bedc...81e13771b2defac091e9da1900a71443094223af,1,7,6,13,6,2014-06-14 13:33:22,2014-06-14 13:33:22
81e13771b2defac091e9da1900a71443094223af...23239018c1371d3f74bb027b1fa1355185e6a62d,1,0,18,18,1,2014-06-18 19:39:14,2014-06-18 19:39:14
23239018c1371d3f74bb027b1fa1355185e6a62d...a979af2ae7137293730d9c207ffcb7e4ae7741d7,1,41,4,45,4,2014-06-18 20:08:52,2014-06-18 20:08:52
a979af2ae7137293730d9c207ffcb7e4ae7741d7...8c9bdbe623131337f492203d72868c4b7b146985,1,4,4,8,4,2014-06-18 20:13:16,2014-06-18 20:13:16
8c9bdbe623131337f492203d72868c4b7b146985...58af713318a14f4d12e7fb6985a2919703619c77,1,31,169,200,4,2014-06-18 20:23:18,2014-06-18 20:23:18
58af713318a14f4d12e7fb6985a2919703619c77...f1dcb965d99660826cb2b51d61543ceba04f0a52,1,59,6,65,3,2014-06-18 20:53:11,2014-06-18 20:53:11
f1dcb965d99660826cb2b51d61543ceba04f0a52...632bb5d132b728a1268c1543bfcc42d2422b7024,3,117,117,234,9,2014-06-18 21:46:00,2014-06-18 21:46:00
632bb5d132b728a1268c1543bfcc42d2422b7024...313e8c6fefd7285f40f9087987f51b7be207265d,4,47,51,98,14,2014-06-18 21:59:27,2014-06-18 21:59:27
313e8c6fefd7285f40f9087987f51b7be207265d...9aa118446267c0d48891b77b862df672930f5aeb,4,12,5,17,8,2014-06-20 14:43:19,2014-06-20 14:43:19
9aa118446267c0d48891b77b862df672930f5aeb...4471a7aa89e14833a3b175a30d8fcfd98eddfc06,1,270,98,368,44,2014-06-20 15:47:27,2014-06-20 15:47:27
4471a7aa89e14833a3b175a30d8fcfd98eddfc06...27c41995297f84a50a790eb2233b2dce24a9cb3b,1,11,3,14,3,2014-06-23 20:05:17,2014-06-23 20:05:17
0b903eaff5da0a5043e2769c5ec1f50620652812...c5ffc438d003bdaec1b533d5301801cfc05149a9,1,1,1,2,1,2014-06-11 09:10:22,2014-06-11 09:10:22
0b903eaff5da0a5043e2769c5ec1f50620652812...26432702c09ec12d4ca3624501dfdc10b17a6a19,1,11,11,22,1,2014-06-06 08:49:36,2014-06-06 08:49:36
26432702c09ec12d4ca3624501dfdc10b17a6a19...9bf17d64083ecd6f23e547920f5bd0a1709d8cd8,1,2,2,4,1,2014-06-06 09:03:14,2014-06-06 09:03:14
9bf17d64083ecd6f23e547920f5bd0a1709d8cd8...d2b76a3b68ab4f7ee67cdbf9cf14e5c81fbbe3ba,1,4,4,8,1,2014-06-06 10:32:56,2014-06-06 10:32:56
d2b76a3b68ab4f7ee67cdbf9cf14e5c81fbbe3ba...35018462541cf26b8b2f6e5a49d581f370441372,1,1,1,2,1,2014-06-06 10:40:48,2014-06-06 10:40:48
51385b67ca7069bcb4f664c72ffbe0f0b93fc407...139dd35231b2ab94ef77d8ce72f0ff4d0f4c4915,1,1,1,2,1,2014-06-18 07:10:55,2014-06-18 07:10:55
7ae7fbe87088fcc4cc6b8610fcc62463c84ab632...eb29f2b6536d0d9118bd154d547974bdcacddbac,1,1,1,2,1,2014-06-25 23:51:45,2014-06-25 23:51:45
51bd895bbe83b91545f56bd99dcc95c0843aa6e9...393accc066fe38e73a215577b05955845ec871e4,1,6,2,8,3,2014-07-08 14:18:21,2014-07-08 14:18:21
51bd895bbe83b91545f56bd99dcc95c0843aa6e9...5b0b4b4fe25fed6f0a585969c0fa022122895500,1,1,1,2,1,2014-07-08 12:24:37,2014-07-08 12:24:37
5b0b4b4fe25fed6f0a585969c0fa022122895500...b5c3c0c763c702f0a48c6ab415d0757c6d18444a,1,1,1,2,1,2014-07-09 08:51:16,2014-07-09 08:51:16
51bd895bbe83b91545f56bd99dcc95c0843aa6e9...adacad8ee5a4a829568c1c35c5186c1bd8ba67e2,5,300,0,300,5,2014-07-04 08:30:52,2014-07-04 08:30:52
adacad8ee5a4a829568c1c35c5186c1bd8ba67e2...d24f158ac46906779923da9cc72e8bbad9bdf0d5,2,2,2,4,2,2014-07-04 08:41:51,2014-07-04 08:41:51
d24f158ac46906779923da9cc72e8bbad9bdf0d5...8a3c7f5e394b82b8fdbb452b0e922a01977b77ea,2,65,25,90,8,2014-07-04 21:43:15,2014-07-04 21:43:15
8a3c7f5e394b82b8fdbb452b0e922a01977b77ea...31c921879063903b04aec99d5f1cd4d6a9ffc51e,2,2,7,9,8,2014-07-08 11:32:28,2014-07-08 11:32:28
31c921879063903b04aec99d5f1cd4d6a9ffc51e...f46dd31f710abc4f229b0587367af635dedf30e1,1,1,1,2,1,2014-08-01 07:47:26,2014-08-01 07:47:26
f46dd31f710abc4f229b0587367af635dedf30e1...660065faea6e042d19657b30bb29b065c799ddf4,2,87,93,180,15,2014-10-12 08:08:31,2014-10-12 08:08:31
660065faea6e042d19657b30bb29b065c799ddf4...a785024062205ec3b4e17cb01ad093bc9248b73f,1,0,1,1,1,2014-10-12 08:15:02,2014-10-12 08:15:02
51bd895bbe83b91545f56bd99dcc95c0843aa6e9...d94079d61b0d33f01b14e99205ee7d74d6f51b04,1,51,45,96,5,2014-07-02 08:06:07,2014-07-02 08:06:07
