id,files,locs added,locs removed,locs total,hunks,commit time,author time
4b825dc642cb6eb9a060e54bf8d69288fbee4904...0e49da1687bc8192ed210947da52c9e5c5f301bb,1,0,0,0,0,2014-01-04 16:08:52,2014-01-04 16:08:52
0e49da1687bc8192ed210947da52c9e5c5f301bb...0b806ee0fc9097fa7bda7ac0109191c9c5e0a1ac,3138,1294441,0,1294441,2499,2014-02-10 01:10:30,2014-02-10 01:10:30
0b806ee0fc9097fa7bda7ac0109191c9c5e0a1ac...9ccd3615fef9244cb7999bd7b591e654caa47d87,1,0,0,0,0,2014-02-10 02:11:44,2014-02-10 02:11:44
9ccd3615fef9244cb7999bd7b591e654caa47d87...ebc38f099d6faa73769512ab881d17302b2ef493,1,26,0,26,1,2014-02-10 02:12:50,2014-02-10 02:12:50
ebc38f099d6faa73769512ab881d17302b2ef493...7cb54f712a9ea4e982a8384c029cfae22fecaa42,1,1,1,2,1,2014-02-10 02:14:35,2014-02-10 02:14:35
7cb54f712a9ea4e982a8384c029cfae22fecaa42...56bf3d0a149d7245fa92ab42cf54e7ca4cd0fec9,1,4,0,4,1,2014-02-10 04:38:03,2014-02-10 04:38:03
56bf3d0a149d7245fa92ab42cf54e7ca4cd0fec9...555d3761dbb1047017909f939eae9979f887214e,1,1,1,2,1,2014-02-10 21:42:46,2014-02-10 21:42:46
56bf3d0a149d7245fa92ab42cf54e7ca4cd0fec9...1c7726820ec53b486e946bb42cac98a600c5bdb5,1,2,3,5,1,2014-02-10 16:12:23,2014-02-10 16:12:23
56bf3d0a149d7245fa92ab42cf54e7ca4cd0fec9...a29bfdf91251a41be7eadacae0e0f0c2f63568a7,2,29,1,30,9,2014-02-10 12:55:12,2014-02-10 12:55:12
a29bfdf91251a41be7eadacae0e0f0c2f63568a7...0366d6cb83e0da170a9647714edf1e6bce38c953,1,1,1,2,1,2014-02-10 13:00:26,2014-02-10 13:00:26
56bf3d0a149d7245fa92ab42cf54e7ca4cd0fec9...df43d71f197d055365b00a8fd937d403e2c3390c,1,1,1,2,1,2014-02-10 08:14:06,2014-02-10 08:14:06
1c7726820ec53b486e946bb42cac98a600c5bdb5...5a65a6cb2b9134fbdd6e39fe3106b7a90df0cb1b,1,3,142,145,29,2014-02-11 11:36:49,2014-02-11 11:36:49
1c7726820ec53b486e946bb42cac98a600c5bdb5...335d963031bc081166b3a73d9be4bd2bef2661fc,1,2,2,4,1,2014-02-11 03:27:50,2014-02-11 03:27:50
1c7726820ec53b486e946bb42cac98a600c5bdb5...abb985e755ccf858149294868eff8a9a9feca67e,95,5286,10051,15337,1870,2014-02-11 01:37:07,2014-02-11 01:37:07
4ff524b5c9227d0eeae2a8d9761add7465c03710...8b3fecb43dbe50a9952a27f7fbc221158e0a1f03,1,6,0,6,2,2014-02-13 21:15:18,2014-02-12 15:52:59
4ff524b5c9227d0eeae2a8d9761add7465c03710...6afd1fd2cbdc95d3df1cb2964ae50ab46d03e0f5,1,219,0,219,1,2014-02-13 15:41:54,2014-02-13 15:41:54
abb985e755ccf858149294868eff8a9a9feca67e...91c0aa8340606fd716a1c7ac9d259be11c52704a,1,1,1,2,1,2014-02-11 03:40:30,2014-02-11 03:40:30
c12a8e922ff724d7fe9909c16f9a1b5aec7f010b...96bc0c9f15862b09fd977533223b1b1403ec7e21,1,1,2,3,1,2014-02-14 19:51:55,2014-02-14 19:51:55
c12a8e922ff724d7fe9909c16f9a1b5aec7f010b...a17d76e60b8eb76613b654818c932ca1ef2806d2,5,9,7,16,6,2014-02-14 14:45:20,2014-02-14 14:45:20
c12a8e922ff724d7fe9909c16f9a1b5aec7f010b...bfafcb46641df7d984e1c4eb6b843964bb922cde,1,11,20,31,8,2014-02-14 10:31:41,2014-02-14 10:31:41
bfafcb46641df7d984e1c4eb6b843964bb922cde...db3e3255a8464794ebcd0b18492009402ef33dcd,1,5,5,10,4,2014-02-14 11:42:47,2014-02-14 11:42:47
1adc330b68b1f6ca18aac05daf88c7d4d757fd0a...58cda02a389759d18176216c06f375d364cefef1,54,1452,1120,2572,127,2014-02-13 21:03:28,2014-02-13 21:03:28
1adc330b68b1f6ca18aac05daf88c7d4d757fd0a...c85146e112df17e3064d372ae2a349143f14538d,1,27,0,27,1,2014-02-12 15:08:27,2014-02-12 15:08:27
c85146e112df17e3064d372ae2a349143f14538d...03fd40149f2b3e74cfb8c9e2cbc521f340fa932e,1,0,0,0,0,2014-02-12 15:21:47,2014-02-12 15:21:47
1adc330b68b1f6ca18aac05daf88c7d4d757fd0a...0bb71e723fe63ef95e6a68bd7faf186c6a7d0e32,1,2,2,4,2,2014-02-11 19:19:52,2014-02-11 19:19:52
1adc330b68b1f6ca18aac05daf88c7d4d757fd0a...5abc0bbcf604e516f70b19fa999c4c56c86507e9,1,4,3,7,4,2014-02-11 15:44:32,2014-02-11 15:44:32
b0870e487c6cc68bb0a2cef7174f3f5697667a2e...9afdb3e0ad5bfbdafe307212f5d4ebcc7c3ac852,30,107795,88117,195912,23745,2014-02-15 05:02:41,2014-02-15 05:01:39
9afdb3e0ad5bfbdafe307212f5d4ebcc7c3ac852...8c1731b67995add31361ae526b0e6af76346181e,26,92600,188275,280875,9418,2014-02-16 00:16:33,2014-02-16 00:16:33
9afdb3e0ad5bfbdafe307212f5d4ebcc7c3ac852...d38cf2e396d1950aea1cc2e4cc1f3dbe50d43ef2,2,31,9,40,10,2014-02-15 15:17:23,2014-02-15 11:54:21
d38cf2e396d1950aea1cc2e4cc1f3dbe50d43ef2...2371a92fde0e88d80a898931d4d6bfb541607f7a,1,1,1,2,1,2014-02-15 15:19:43,2014-02-15 12:01:26
9afdb3e0ad5bfbdafe307212f5d4ebcc7c3ac852...2dac11d04415447178afedefcd5e71f3673695b7,1,16,2,18,5,2014-02-15 14:57:40,2014-02-15 11:34:21
b62ec387f340220e11902daab8484fcb85d28cda...7ca29bfaa7a23d06374c2456e0360c911bd9aa3e,42,1156,544,1700,270,2014-02-22 23:28:19,2014-02-22 23:28:19
b62ec387f340220e11902daab8484fcb85d28cda...7eb0cf4ece685092be3d3e2f70152fd64e4b0d76,5,107,107,214,89,2014-02-21 07:46:47,2014-02-21 07:46:47
8c1731b67995add31361ae526b0e6af76346181e...d7d65fa2f2b51d03f7bdfcbceedca99188ce979c,65,69928,68284,138212,8341,2014-02-19 14:57:14,2014-02-19 14:57:14
8c1731b67995add31361ae526b0e6af76346181e...408aeeafeeb07179d34e7d78d32a26f83f97f054,1,2,0,2,1,2014-02-16 07:54:09,2014-02-16 07:54:09
810d673e2384fbff843ed59bc2a5d3f0100ed511...c45daa56045fff7fa62dacc09f88a4106394426f,1,2,2,4,1,2014-02-23 12:22:21,2014-02-23 12:22:21
c45daa56045fff7fa62dacc09f88a4106394426f...6c27ac58b822763cff86d33e9d671391a6913bb8,1,1,1,2,1,2014-02-23 12:43:28,2014-02-23 12:43:28
6c27ac58b822763cff86d33e9d671391a6913bb8...51609ffc04290f8bd1ecbd9cf1639c0cc6368fac,3,566,564,1130,5,2014-02-23 13:35:05,2014-02-23 13:35:05
810d673e2384fbff843ed59bc2a5d3f0100ed511...93878992def9f0bca10cd57dd7ebbb00cd3af19b,1,3,0,3,1,2014-02-23 09:17:48,2014-02-20 11:25:43
810d673e2384fbff843ed59bc2a5d3f0100ed511...cca806143e49a4b86ba0b9194e300fa362e46493,1,1,1,2,1,2014-02-23 09:12:36,2014-02-20 11:45:23
0f3556b486209cde5c33122d99184c8678414ccc...8706fc85efbcb51231cddb697bab6af24d536334,1,11,0,11,1,2014-02-22 12:34:40,2014-02-22 12:34:40
8706fc85efbcb51231cddb697bab6af24d536334...abbba50b3201c2e5d94c6a8f092f4aa73dcbf24d,1,2,2,4,1,2014-02-22 12:40:10,2014-02-22 12:40:10
449bc14fb49d3266f5bd82dbe3c53a4b9f4062da...51c55b237b795fa4c085841dbf935c0bd103d5c7,11,14,13,27,11,2014-02-19 21:09:52,2014-02-19 21:09:52
449bc14fb49d3266f5bd82dbe3c53a4b9f4062da...6f0ba52be2e9771fdb187f2eae9b9a6d0510a8bc,1,0,2,2,1,2014-02-19 15:51:08,2014-02-19 15:38:12
891b2bdb4f2d1a1a6a1021ae569242fdf184cacc...666aeac7137fdd43504c68944597a970e4d0f46c,1,1,1,2,1,2014-02-18 13:37:22,2014-02-18 13:37:22
891b2bdb4f2d1a1a6a1021ae569242fdf184cacc...ec448845e295c4b8e897793b0971ebd9912e3101,3,20,0,20,4,2014-02-18 09:49:34,2014-02-18 09:49:34
891b2bdb4f2d1a1a6a1021ae569242fdf184cacc...3550a18fa20193b36dfd4d8ec1c2c0e8d7519e13,2,23,1,24,5,2014-02-18 05:09:31,2014-02-18 04:21:06
891b2bdb4f2d1a1a6a1021ae569242fdf184cacc...dba66e0286ca54f13366df6e16a01e70a3e811bf,5,0,1939,1939,8,2014-02-17 21:44:05,2014-02-17 21:44:05
891b2bdb4f2d1a1a6a1021ae569242fdf184cacc...339f332892fd09bba7218846a141c250ff4f429e,1,1,1,2,1,2014-02-17 20:54:26,2014-02-17 20:46:25
891b2bdb4f2d1a1a6a1021ae569242fdf184cacc...518722438fbd4fd7d0b17d8a00a3b81926e74a2e,1,1,1,2,1,2014-02-17 19:49:48,2014-02-17 19:43:22
891b2bdb4f2d1a1a6a1021ae569242fdf184cacc...afcefc7a0ea6061f993704b556e0ac193fd6d16d,1,3,2,5,1,2014-02-17 18:24:44,2014-02-17 18:24:44
891b2bdb4f2d1a1a6a1021ae569242fdf184cacc...1b6a16f8e6940cd23f0396120701b9a55e8ee6d0,1,2,2,4,1,2014-02-17 14:11:20,2014-02-17 14:00:51
51609ffc04290f8bd1ecbd9cf1639c0cc6368fac...4b07eb8deb03ce8c7870d621cd03d04d45f4caaa,43,597,148,745,47,2014-02-24 12:53:33,2014-02-24 12:53:33
4b07eb8deb03ce8c7870d621cd03d04d45f4caaa...06e358199f0c038e781753001d9292349f2040ad,1,6,2,8,2,2014-02-24 12:58:52,2014-02-24 12:58:52
51609ffc04290f8bd1ecbd9cf1639c0cc6368fac...af59a1b633abf5b58423fddc35f80fb648cb0962,1,1,1,2,1,2014-02-24 11:16:40,2014-02-24 11:16:40
51609ffc04290f8bd1ecbd9cf1639c0cc6368fac...0109fb42955d4250870d93c2b35e8a1db9aed934,1,6,0,6,2,2014-02-23 20:18:11,2014-02-23 20:15:14
0109fb42955d4250870d93c2b35e8a1db9aed934...fd03693df1a7e86ce6fef7f077398deb91e81e95,1,3,2,5,4,2014-02-23 20:20:27,2014-02-23 20:20:27
fd03693df1a7e86ce6fef7f077398deb91e81e95...026566f87222d4ef0f80f7d9f50373ff98310f2a,1,4,0,4,4,2014-02-23 20:21:31,2014-02-23 20:21:31
026566f87222d4ef0f80f7d9f50373ff98310f2a...b7386de590871a82bb576951176c0a00210ae761,1,1,1,2,1,2014-02-23 20:42:34,2014-02-23 20:42:34
a9aae3000f2529dc773a876f3a3908eb9dcb824c...bfa38b51663d59cfaec7aa469565c09a4ec05275,1,5,3,8,3,2014-02-26 14:47:22,2014-02-26 14:47:22
bfa38b51663d59cfaec7aa469565c09a4ec05275...61789718733ea30c6b6844b1804920289dda3919,1,31,0,31,2,2014-02-26 15:18:05,2014-02-26 15:18:05
51c55b237b795fa4c085841dbf935c0bd103d5c7...f2a068984c36de1f77940ae9d5dc0d017b8e642d,40,25010,5,25015,72,2014-02-21 02:01:44,2014-02-21 02:01:44
2bfbf8978189ed8d785d7f707ad573ce2a2bf2a7...3974a5e84d3170f70481f7f68052ad53130d478b,1,10,4,14,4,2014-02-19 03:48:38,2014-02-19 03:48:38
2bfbf8978189ed8d785d7f707ad573ce2a2bf2a7...b6583909a9783dd5fc9595ba56f5d9f7557898b0,1,9,7,16,7,2014-02-18 20:37:58,2014-02-18 20:37:58
06e358199f0c038e781753001d9292349f2040ad...b2ce682f6ed9493423be257a5b2e87126692a94f,20,955,334,1289,315,2014-02-25 12:31:47,2014-02-25 12:31:47
06e358199f0c038e781753001d9292349f2040ad...942f14747b704a665299aa2f82bbad6bc24a4b9d,1,1,1,2,1,2014-02-25 06:33:09,2014-02-25 06:33:09
942f14747b704a665299aa2f82bbad6bc24a4b9d...68fa537c3e6a82c1ce26f54511ce92c9b90d9c7a,1,1,0,1,1,2014-02-25 08:38:38,2014-02-25 08:38:38
a65edb4caabec21654c56552e11aacf0fd9291de...31ce3c5fd0300aac1e86bced1efc5f9ec94bdb6b,136,10782,1576,12358,457,2014-03-14 01:57:24,2014-03-14 01:57:24
a65edb4caabec21654c56552e11aacf0fd9291de...8fb19e58433d5b132590b804a7a573f5e616f745,3,59,1,60,6,2014-02-27 14:19:30,2014-02-27 14:16:00
a65edb4caabec21654c56552e11aacf0fd9291de...3985660ca441a339c6dee7076c6186f107e3c06a,1,1,1,2,1,2014-02-27 14:17:40,2014-02-27 13:39:31
a65edb4caabec21654c56552e11aacf0fd9291de...9593e9ddae32349bb08485a6fcdb30e69ea3b825,2,67,66,133,7,2014-02-27 09:28:40,2014-02-27 09:24:11
b2ce682f6ed9493423be257a5b2e87126692a94f...141b3135954737ee5be5ad2c7371796d20940719,3,20,5,25,4,2014-03-05 15:53:33,2014-03-05 15:53:33
b2ce682f6ed9493423be257a5b2e87126692a94f...ed6d9463d264d0983f75c2dc93191c8526e9115b,22,303,51,354,77,2014-02-26 13:08:17,2014-02-26 13:08:17
a919683228122dc47cb314ef6c3245ec23735568...768fc7ec8190d34c187ee2fb642bbe0c80fe8f6c,1,3,0,3,1,2014-02-26 17:25:42,2014-02-26 17:25:42
0a717ffee270b3d2761aaae6a42c06d999a5b823...bdb5d68e77a0b2d8b06c469ee91d0d09cd4fb8db,1,0,4,4,2,2014-03-14 03:26:38,2014-03-14 03:26:38
98a970585a14b63731d98cf26641045800bf2dcc...cf9d97018f7d2c89628a651f79551754ea8ea228,4,304,6,310,9,2014-03-12 12:41:09,2014-03-12 12:41:09
98a970585a14b63731d98cf26641045800bf2dcc...101112d6fddee3d6dc4abd8b3f43de24a91cb0a7,1,22,0,22,1,2014-03-11 05:21:18,2014-03-11 05:21:18
101112d6fddee3d6dc4abd8b3f43de24a91cb0a7...cde48d0c9c16867edbb4fc4e3c186933564b6da0,1,1,0,1,1,2014-03-11 05:30:33,2014-03-11 05:30:33
cde48d0c9c16867edbb4fc4e3c186933564b6da0...87fd1532159c18efc06524f2715ed74b3e32ddee,2,4,1,5,2,2014-03-11 05:38:30,2014-03-11 05:38:30
87fd1532159c18efc06524f2715ed74b3e32ddee...4927acd7ad718cb7b3f720bb48742928393160e3,1,1,1,2,1,2014-03-11 05:57:59,2014-03-11 05:57:59
98a970585a14b63731d98cf26641045800bf2dcc...1be5d6f665b51cb0d1532971783345c5e81d4638,1,2,2,4,2,2014-03-11 05:18:57,2014-03-11 01:40:37
98a970585a14b63731d98cf26641045800bf2dcc...0552b76475bcc09fcbe33a0ebeedcc84158c7ea0,1,32,1,33,4,2014-03-11 05:09:09,2014-02-21 11:00:23
0552b76475bcc09fcbe33a0ebeedcc84158c7ea0...f7cef6d61723d4c395d4f8e2bd357e42f69d109c,1,2,5,7,2,2014-03-11 05:09:24,2014-02-21 11:48:04
98a970585a14b63731d98cf26641045800bf2dcc...76b1d421f6ddbe8856b40dcec8fc468e6dc043d6,1,30,0,30,1,2014-03-06 19:46:15,2014-03-06 19:46:15
76b1d421f6ddbe8856b40dcec8fc468e6dc043d6...12a3989cd7b645f271c8b297a09cb0a4a7d8d2d4,1,7,0,7,1,2014-03-07 19:20:06,2014-03-07 19:20:06
12a3989cd7b645f271c8b297a09cb0a4a7d8d2d4...1fd08ad1ac543830bc908d5caa34d7f5371b26c1,1,1,1,2,1,2014-03-07 19:31:17,2014-03-07 19:31:17
1fd08ad1ac543830bc908d5caa34d7f5371b26c1...f1b1a38af95c28e8b08e97ca25cc7cf638ef6da3,1,5,2,7,2,2014-03-08 17:50:24,2014-03-08 17:50:24
f1b1a38af95c28e8b08e97ca25cc7cf638ef6da3...5634da99342deb17ffa3253cd5bf1494bec65001,1,8,0,8,2,2014-03-08 19:44:18,2014-03-08 19:44:18
5634da99342deb17ffa3253cd5bf1494bec65001...caa1586480bb9105a43e6790a9025c931af7452f,1,1,1,2,1,2014-03-08 19:46:04,2014-03-08 19:46:04
98a970585a14b63731d98cf26641045800bf2dcc...3ba00567c5a033625bd5789fcd83056c06edb300,1,1,1,2,1,2014-03-05 17:52:57,2014-03-05 17:52:57
98a970585a14b63731d98cf26641045800bf2dcc...9d463a89144c1623fba7125c023623eac5229dff,1,2,1,3,2,2014-03-05 14:09:41,2014-03-05 14:09:41
bdb5d68e77a0b2d8b06c469ee91d0d09cd4fb8db...c573adb8293dc53bf2ba17a0342b10f39965fbf5,1,1,1,2,1,2014-03-14 04:01:27,2014-03-14 04:01:27
81757d2e977d959e6b0bc26f9fa990417ca91de9...51429bd8d6d2fed9636e1d252a5eb86567b846ec,7,326,11,337,20,2014-03-13 08:58:03,2014-03-13 08:58:03
51429bd8d6d2fed9636e1d252a5eb86567b846ec...14bbdcb139b35e6d206df1ab3176d34245b72329,2,10,8,18,11,2014-03-13 10:31:30,2014-03-13 10:31:30
e20e3c9525c2f0d5bb95e85138a8d88a0088d439...9902c805939f49601b5f9e53273a069c4a6b917a,1,1086,1080,2166,400,2014-04-03 10:41:25,2014-04-03 09:39:17
9902c805939f49601b5f9e53273a069c4a6b917a...1076ee12d4762c62069ad085ce8f7a0512e4a52c,1,0,0,0,0,2014-04-03 10:41:33,2014-04-03 10:37:02
1076ee12d4762c62069ad085ce8f7a0512e4a52c...e7463b2b16699a70aee1ce353eee6626be3ea5bd,3,94,88,182,7,2014-04-03 10:41:43,2014-04-03 10:37:58
e20e3c9525c2f0d5bb95e85138a8d88a0088d439...3b3c4b7585867961591567e2d83e8aef27776d91,2,50,31,81,28,2014-04-03 08:35:58,2014-04-02 15:00:53
3b3c4b7585867961591567e2d83e8aef27776d91...f07a377624062caff6290898eff663cb479d277e,1,3,4,7,4,2014-04-03 08:36:01,2014-04-02 17:28:16
f07a377624062caff6290898eff663cb479d277e...4c2183bf2326b94020fd52bc03833d76ee6ea082,1,1,1,2,1,2014-04-03 08:36:01,2014-04-02 17:50:20
4c2183bf2326b94020fd52bc03833d76ee6ea082...a2bd3a1f41b8eb4ffcc5a4a5fced7d2bcd6a3a23,2,14,19,33,13,2014-04-03 08:36:01,2014-04-03 08:19:06
e20e3c9525c2f0d5bb95e85138a8d88a0088d439...4676aac33539adb78ed64c4645721dba041a749a,2,2,2,4,2,2014-04-02 07:48:02,2014-04-02 06:47:47
e20e3c9525c2f0d5bb95e85138a8d88a0088d439...0a8d2fc6dcd7191a80030b342610777de9651059,1,2,0,2,2,2014-04-01 15:12:17,2014-04-01 15:11:04
e20e3c9525c2f0d5bb95e85138a8d88a0088d439...a0fcab0a94559b0cdd38e1ee2e3d82e584420750,1,4,4,8,1,2014-04-01 08:49:10,2014-04-01 08:23:05
a0fcab0a94559b0cdd38e1ee2e3d82e584420750...465f81a37a4d7755924de49f62985ef23a43c932,2,55,0,55,7,2014-04-01 11:09:44,2014-04-01 10:45:48
e20e3c9525c2f0d5bb95e85138a8d88a0088d439...5ed527d8b886498f2270c23a92ccd2e0cfc74cf0,3,70,20,90,19,2014-03-31 16:49:26,2014-03-31 03:07:21
5ed527d8b886498f2270c23a92ccd2e0cfc74cf0...eb294bb6eadc3dcb4e7c91459d5261ce10885c5d,1,181,180,361,68,2014-03-31 16:49:48,2014-03-31 03:59:42
eb294bb6eadc3dcb4e7c91459d5261ce10885c5d...35bf23859a145989ef79c8cfac20d8c8eefe371c,3,13,6,19,7,2014-03-31 16:50:15,2014-03-31 07:52:27
35bf23859a145989ef79c8cfac20d8c8eefe371c...4dbf26cba26811878cafff6b54ec91cece792b92,1,5,0,5,1,2014-03-31 16:52:47,2014-03-31 08:27:41
4dbf26cba26811878cafff6b54ec91cece792b92...145d069da0e394c4b685a16fe0392fdcf931df4e,1,12,3,15,5,2014-03-31 16:53:19,2014-03-31 09:28:59
e20e3c9525c2f0d5bb95e85138a8d88a0088d439...9174ac7386454d943747d85bafdac573618ace30,2,17,5,22,6,2014-03-31 11:02:21,2014-03-31 11:02:21
e20e3c9525c2f0d5bb95e85138a8d88a0088d439...7ff0ce7e0070a4575a19b53b5efce00d0df46afc,1,1,1,2,1,2014-03-31 04:57:05,2014-03-30 06:16:13
e20e3c9525c2f0d5bb95e85138a8d88a0088d439...6e1e66878c988e921ceea8c19d3dd3b6ff882965,1,2,2,4,1,2014-03-28 16:06:25,2014-03-28 16:05:02
e20e3c9525c2f0d5bb95e85138a8d88a0088d439...f6e6093ab966cd84687e258c7a69dc382f04bc35,2,7,0,7,3,2014-03-27 15:16:03,2014-03-27 12:09:18
e20e3c9525c2f0d5bb95e85138a8d88a0088d439...b771d20070be906c964efdf2318937c77577abe4,1,1,0,1,1,2014-03-27 14:36:09,2014-03-27 14:36:09
b771d20070be906c964efdf2318937c77577abe4...c943167dafe03237d4d641966fa947273f7b97f6,1,0,101786,101786,1,2014-03-27 18:28:07,2014-03-27 18:28:07
e20e3c9525c2f0d5bb95e85138a8d88a0088d439...a9d4051ddfeaeb1bc3b95e5f8721cbe7bcce9610,1,2,2,4,2,2014-03-24 08:06:10,2014-03-24 08:06:10
e20e3c9525c2f0d5bb95e85138a8d88a0088d439...3037b3f6dcaea2de9de058d715a4e3dafc974039,1,19,3,22,1,2014-03-19 07:43:56,2014-03-19 07:43:56
3037b3f6dcaea2de9de058d715a4e3dafc974039...bc4e37b1322c8fa7c13b40e69d78483bbd6277dc,1,1,1,2,1,2014-03-19 07:55:12,2014-03-19 07:55:12
bc4e37b1322c8fa7c13b40e69d78483bbd6277dc...61179e82c7078adab3a6d78ed47184f111db7d62,1,11,16,27,5,2014-03-19 13:02:17,2014-03-19 13:02:17
e20e3c9525c2f0d5bb95e85138a8d88a0088d439...c0547f5691c9293f82f6713d18b344524146441a,6,41,4,45,15,2014-03-18 10:00:18,2014-02-19 15:35:39
e20e3c9525c2f0d5bb95e85138a8d88a0088d439...7ca064c3d1dda62351539b14860eb2afffcf25cb,1,1,1,2,1,2014-03-17 03:43:43,2014-03-17 03:38:53
e20e3c9525c2f0d5bb95e85138a8d88a0088d439...ad9bf692838aa7a13f37ee90b9d6086a3dae2a5f,2,9,2,11,4,2014-03-15 06:03:51,2014-03-15 05:58:53
77a840e350668a9c80b1e63b9b73aac44221c53b...bae5ad7c8bc14c44a3222017ca7b561d7aa514be,2,16,10,26,3,2014-04-06 13:53:38,2014-04-06 13:53:38
35b84d2c85fd152bee05d7d5a05e20a5f602a285...9f33134c93ecbadda70e8eefc50563e29b2eb7f2,47,1492,161,1653,151,2014-04-05 15:39:30,2014-04-05 15:39:30
9f33134c93ecbadda70e8eefc50563e29b2eb7f2...b4969373b3475799d6b24cdffeda4659c37f0b8a,8,309,212,521,14,2014-04-05 21:50:09,2014-04-05 21:50:09
e1970a4dda6742d9f89ce9ee60381e570f222a11...c6df9d8a41582c404ba49750f6a5a659331513f5,1,6,3,9,4,2014-04-10 02:50:30,2014-04-10 02:50:30
b4969373b3475799d6b24cdffeda4659c37f0b8a...7ea3e8267afaf626256c84a9a3dc61e2954fc6a2,66,2748,84,2832,142,2014-04-10 03:18:27,2014-04-10 03:18:27
b4969373b3475799d6b24cdffeda4659c37f0b8a...f103b67326376b76100ddb6373c5962378d44119,1,7,2,9,1,2014-04-05 23:13:36,2014-04-05 23:13:36
c74d918d570e2e7ac01643be892220982a4a4921...68e708cd25cb08bf4bbac857def1b61232bdf5ad,1,100,0,100,4,2013-04-10 08:37:04,2013-04-10 08:37:04
31f88a700656fc89877864e864d27b70e9aff70f...aa84f4d261dabc35f6e3a18c253bf7b948144914,1,2,1,3,1,2014-04-24 02:06:12,2014-04-24 02:06:12
31f88a700656fc89877864e864d27b70e9aff70f...88abd7200e332c0713e23f05013d5a2ea0037c75,3,22,0,22,3,2014-04-24 01:48:16,2014-04-24 01:48:16
31f88a700656fc89877864e864d27b70e9aff70f...56718eb31e1fd5594bfc04f17050d9cea09e5de2,1,12,3,15,4,2014-04-24 01:43:02,2014-04-24 01:43:02
a5f556c9ff7c80f5a30559cd22223e8a613d0a60...89568b9017ec6f2c994697ce4d48de117e71b18e,1,15,2,17,1,2014-04-10 15:57:20,2014-04-10 15:57:20
7f78452f35baef771831f042f88885a7b23b52d8...c118dfdf6ef6ff5b19729bdfb9aae1ff6ece63b7,1,1,0,1,1,2014-04-24 05:53:45,2014-04-24 05:53:45
7fadc2f93a18f2b5487fbcd6e90bcde781c53fec...87f37bc5a305e6a68ef232be580350588e300fcc,1382,489991,2789,492780,1451,2014-04-29 00:56:43,2014-04-29 00:56:43
606b9d960af6ca4517503328b870214b96ff21d3...162d2ebe4f1a6da2da62ad45c4cbfb161157d31d,184,2953,0,2953,82,2014-04-15 01:16:13,2014-04-15 01:16:13
162d2ebe4f1a6da2da62ad45c4cbfb161157d31d...ec4ef2d2e794819548d731f93728266d31261d71,33,1595,263,1858,228,2014-04-15 01:43:44,2014-04-15 01:43:44
847ad3d519eceb646701f45fe70967eaaea94d8c...a5e331c66f38396faa34e4445981b883e8b59093,2,51,15,66,20,2014-04-26 12:42:19,2014-04-26 12:42:19
87f37bc5a305e6a68ef232be580350588e300fcc...e1ab905bd754bf6aea04de6386859dfea05fae1e,1,36,3,39,3,2014-05-01 11:31:24,2014-05-01 11:30:10
ec4ef2d2e794819548d731f93728266d31261d71...a49527540f0f6fc563e72839b766f7ba5c823170,3,14,5,19,7,2014-04-17 11:30:40,2014-04-17 11:30:40
02669e95a4975898d97aeaedc913b16f60688a01...a5384bc07bc5b406df0ef33a446d09ebb35f7cd9,3,168,4,172,11,2014-04-27 10:34:37,2014-04-27 10:34:37
a5384bc07bc5b406df0ef33a446d09ebb35f7cd9...a93ad6e321408756a3a316eb6511fc66411da9da,2,7,7,14,5,2014-04-28 09:16:49,2014-04-28 09:16:49
a93ad6e321408756a3a316eb6511fc66411da9da...2c683b0f993127a0bf2150359403479caa258da0,2,7,7,14,5,2014-04-28 09:31:58,2014-04-28 09:31:58
2c683b0f993127a0bf2150359403479caa258da0...bb853d121ef7dfeda510d9325ebd94a06a0e5ae2,4,21,19,40,17,2014-04-30 16:21:58,2014-04-30 16:21:58
bb853d121ef7dfeda510d9325ebd94a06a0e5ae2...34aea718b11e105d30c938ad34e474b1bd8b5d63,1,9,5,14,5,2014-04-30 21:58:26,2014-04-30 21:58:26
5ab65f0eadec6a67eda622787206a01c8af2cf7e...4dc4e96c8a4fb7e34ecae3a39ef0f3f3fb275e97,132,188,21391,21579,253,2014-05-01 12:53:37,2014-05-01 12:53:37
4dc4e96c8a4fb7e34ecae3a39ef0f3f3fb275e97...6572d5128856b2ec55a2c417c92e584899f4906f,9,55,16,71,18,2014-05-01 14:34:10,2014-05-01 14:34:10
b8593c6f3fd4726584e56e684c9ebb5a8147ff0c...0360b454a432dc851cc1c5b0c365049ebafcec46,15,83,40,123,33,2014-04-18 14:43:54,2014-04-18 14:43:54
6572d5128856b2ec55a2c417c92e584899f4906f...f1d3b30a45f31c217929ec86b010736feed1714c,2,47,32,79,18,2014-05-02 15:40:34,2014-05-02 15:40:34
6572d5128856b2ec55a2c417c92e584899f4906f...78fd9ada4581ebcc3e5abbe1c22e78d490a7f01b,2,75,19,94,16,2014-05-02 08:05:57,2014-05-01 13:47:45
78fd9ada4581ebcc3e5abbe1c22e78d490a7f01b...e94f87578832f4f708c8c081b87b68cb28af75f4,2,94,51,145,44,2014-06-10 03:03:32,2014-05-11 01:45:52
e94f87578832f4f708c8c081b87b68cb28af75f4...151df476774c508fcabc3bb15520e25612a84790,2,60,7,67,18,2014-06-10 03:05:46,2014-05-20 08:38:18
0360b454a432dc851cc1c5b0c365049ebafcec46...a4c1fa12a54df2fe332db2ab08a03c844e4dcc93,17,371,252,623,254,2014-04-19 19:46:52,2014-04-19 19:46:52
0360b454a432dc851cc1c5b0c365049ebafcec46...8ebe956421c210f4f869156030159e374686178c,1,1,2,3,1,2014-04-18 19:26:46,2014-04-18 19:26:46
6f1410a8370cfb0b6fcbe072214ce1268cefdf04...ccfeb53005cc6685aad71dbc742b305575c305e3,1,2,0,2,1,2014-04-23 01:28:23,2014-04-23 01:28:23
6f1410a8370cfb0b6fcbe072214ce1268cefdf04...b28c1e749ab4a4a936b326d2e9898a215cb3f2dd,1,12,0,12,1,2014-04-22 07:17:20,2014-04-22 07:17:20
3c17e0c91548299b60a6d3998eadb303418512cc...72ae89c5aa8da9110ec8f89e5558d5d04935f3b5,36,2270,1408,3678,653,2014-05-05 01:50:23,2014-05-05 01:50:23
72ae89c5aa8da9110ec8f89e5558d5d04935f3b5...c688086be9bda668e81ea7d8fe50515ee05afca5,1,1,1,2,1,2014-05-05 02:09:45,2014-05-05 02:09:45
c688086be9bda668e81ea7d8fe50515ee05afca5...197d4e2f8e5b4bfee5d3d128d5ebf0007bb2ebd2,1,0,1,1,1,2014-05-05 02:33:31,2014-05-05 02:33:31
64b01d6ce04350ad9d0cf36bf489426ff7ccd40c...fa004d5c0fb79e59f81d53ab8f53906a930a8453,10,161,23,184,22,2014-09-17 14:53:29,2014-09-17 14:53:29
fa004d5c0fb79e59f81d53ab8f53906a930a8453...172d6453fa95dc77d8849bf46b207a2d09f282bb,1,4,4,8,4,2014-09-17 15:21:50,2014-09-17 15:21:50
172d6453fa95dc77d8849bf46b207a2d09f282bb...4ac71615ed30bb526946927beb391712bfba9f4d,1,1,1,2,1,2014-09-17 15:24:38,2014-09-17 15:24:38
197d4e2f8e5b4bfee5d3d128d5ebf0007bb2ebd2...716c1ae022979184e7a52d59b5a9333199cfa0bc,1,1,1,2,1,2014-05-05 21:01:08,2014-05-05 21:01:08
4ac71615ed30bb526946927beb391712bfba9f4d...a3a35702b4fd8a3cf6873731d13eac288cf76fbc,1,32,14,46,12,2014-09-17 16:20:19,2014-09-04 12:53:38
a3a35702b4fd8a3cf6873731d13eac288cf76fbc...c1227529150b4d9c862865c778b86930afcc4967,2,5,1,6,2,2014-09-17 16:20:19,2014-09-04 13:05:28
c1227529150b4d9c862865c778b86930afcc4967...e0a75f0f12787167e4178cbe1a9527b80e2d7f76,1,2,0,2,2,2014-09-17 16:20:19,2014-09-04 13:08:25
e27bc784ddb71423792f58e88266680d63f4d237...145b8c5e6fb755a2454312dc6f49ca50ff5175b2,3,24,2,26,7,2014-05-06 11:20:59,2014-05-05 13:59:18
145b8c5e6fb755a2454312dc6f49ca50ff5175b2...212b8b2a0348eed9c7f2dd593fb103dc5d4af9d3,2,24,0,24,3,2014-05-06 11:21:21,2014-05-06 09:36:39
212b8b2a0348eed9c7f2dd593fb103dc5d4af9d3...d3b7f4b1a7f73f3ec69157d2f400ae24b4e02896,1,4,1,5,1,2014-05-06 11:21:21,2014-05-06 09:38:00
d3b7f4b1a7f73f3ec69157d2f400ae24b4e02896...ab76f541961c9bf11ba51ea6aeeacab529e9e0b9,2,22,21,43,12,2014-05-06 11:21:21,2014-05-06 09:41:19
ab76f541961c9bf11ba51ea6aeeacab529e9e0b9...6c0f3f8d0ca9e30951f0e6e643af07ca7ed695a9,2,10,10,20,7,2014-05-06 11:21:21,2014-05-06 09:43:14
76aaa96d0e114d5293efed2fd0378ea390076b7e...990f6cf50e96213a4b1a2961e61a9b922cd75d71,18,288,33,321,53,2014-09-17 23:03:10,2014-09-17 23:03:10
990f6cf50e96213a4b1a2961e61a9b922cd75d71...e0ce701c8c5216fa95d0931927e3e1570c40f3ae,5,214,114,328,34,2014-09-18 02:23:42,2014-09-18 02:23:42
e0ce701c8c5216fa95d0931927e3e1570c40f3ae...7d6b160a444079fd6856b648ed077bf698b3b70c,4,18,3,21,9,2014-09-18 03:18:57,2014-09-18 03:18:57
5044bead5f344a24f971f0bb0c8d282f1785f06a...61fd1ad703d60c413c2ace7abc5bd2e6ebc06678,2,58,2,60,5,2014-05-06 14:30:24,2014-05-03 17:36:59
5044bead5f344a24f971f0bb0c8d282f1785f06a...0771020c8357eee5ea9c395782089d867db84c05,3,20,2,22,10,2014-05-06 13:06:03,2014-05-04 03:22:49
7d6b160a444079fd6856b648ed077bf698b3b70c...d0a45aafd3f92f3eda84845928e0fd986958265d,1,2,2,4,2,2014-09-19 04:22:32,2014-09-19 04:22:32
7d6b160a444079fd6856b648ed077bf698b3b70c...48ff50d447b7e09939823b691c0b5cc5cfbb9d70,1,28,17,45,14,2014-09-19 00:57:41,2014-09-19 00:57:41
7d6b160a444079fd6856b648ed077bf698b3b70c...5cd174586afd51c1fc0091bc2235d0cfd7e14539,1,4,1,5,1,2014-09-18 22:52:05,2014-09-18 22:52:05
7d6b160a444079fd6856b648ed077bf698b3b70c...5bbd9f5b4d4221c4c906afb3856bb69f97078f4b,1,2,1,3,2,2014-09-18 05:46:35,2014-09-18 05:46:35
c69c99f8be157b3cea73751a548dcb4862f3314f...0121d96288397c32ef9e3024a5866a25f7d440c5,2,9,2,11,5,2014-05-07 11:38:07,2014-05-07 11:38:07
0121d96288397c32ef9e3024a5866a25f7d440c5...6c9203fdafc3cbed2bf31d2adfa4d8f82e3e69c7,2,1,3,4,3,2014-05-07 11:42:55,2014-05-07 11:42:55
526aae62edfa31aa156d604e8b25caab512c6bff...549d344f0fef5e5748ded69b6a037698ff55f8bc,22,503,178,681,148,2014-09-19 21:39:50,2014-09-19 21:39:50
549d344f0fef5e5748ded69b6a037698ff55f8bc...0a557f3bf50a0ccff444003c5adc8078862e52c7,15,94,12,106,21,2014-09-20 00:01:41,2014-09-20 00:01:41
0a557f3bf50a0ccff444003c5adc8078862e52c7...c5b905fca82f1437486f2168270c5caa0b4bf104,1,23,0,23,1,2014-09-21 04:26:59,2014-09-21 04:26:59
c5b905fca82f1437486f2168270c5caa0b4bf104...11a5ed508b1cbde61a4d9dd4f469e86e74667623,24,306,44,350,61,2014-09-21 04:43:42,2014-09-21 04:43:42
2495df4ffce5ed3f9d94e0d10801fa6bb6cfba19...6bc556dee58b6cda0bd5805c1d2bb4f99200f8f7,1,1,1,2,2,2014-05-08 08:24:52,2014-05-08 08:24:52
2495df4ffce5ed3f9d94e0d10801fa6bb6cfba19...2f5c0e41b59b9eac7a44708a0ad3c3d056d04921,4,48,7,55,15,2014-05-08 05:46:10,2014-05-08 05:43:19
11a5ed508b1cbde61a4d9dd4f469e86e74667623...f14dd22553c4e63a08df6cbe7c2695b05ce08744,2,7,0,7,3,2014-09-21 15:56:19,2014-09-21 15:56:19
9f01f9aa952509a0453ed24474cbe66eefbb08a4...98fcb4fa7ae5d31563ae1d14b466695db6711b67,1,7,10,17,4,2014-05-08 16:20:46,2014-05-08 16:19:23
f195bf673fa8f282d2508e20ca6f08260c4e1fe7...048fdc8aeabbd80ba9cc8914ec7f7baa00ad0c3d,18,235,68,303,68,2014-09-22 03:50:48,2014-09-22 03:50:48
048fdc8aeabbd80ba9cc8914ec7f7baa00ad0c3d...cf04e1a827cadb597d8cbed534a4cc04a0ada4fc,2,28,0,28,3,2014-09-22 04:03:56,2014-09-22 04:03:56
10246920418110ccb006d538490e098b1ec2a413...8090a4ebb1c1c7a970f57b46d1df526bf12c2c37,1,4,1,5,3,2014-05-11 04:16:08,2014-05-11 04:14:33
10246920418110ccb006d538490e098b1ec2a413...14350d2c41bb5fc8bf8da0a5875b15e74ef3fea4,2,41,16,57,12,2014-05-10 02:36:36,2014-05-09 07:11:24
10246920418110ccb006d538490e098b1ec2a413...763725a56908297090439e4abf977a82a36b37a2,2,25,15,40,15,2014-05-10 02:35:26,2014-05-09 10:50:48
cf04e1a827cadb597d8cbed534a4cc04a0ada4fc...49edff9536fbf5d673f79b0cef09fea03d93f770,1,2,1,3,2,2014-11-01 09:20:19,2014-11-01 09:20:19
cf04e1a827cadb597d8cbed534a4cc04a0ada4fc...46a922d3ab6be0707754c44f35ae5733dcca6b40,1,6,0,6,2,2014-11-01 08:20:18,2014-11-01 08:20:18
cf04e1a827cadb597d8cbed534a4cc04a0ada4fc...f7eff51969629fea4165189685d231a3a927311d,2,7,0,7,2,2014-11-01 06:06:29,2014-11-01 06:06:29
cf04e1a827cadb597d8cbed534a4cc04a0ada4fc...565696280c4fd6e5cd88e2b606952f1cb710dc8d,1,1,0,1,1,2014-11-01 05:29:14,2014-11-01 05:29:14
cf04e1a827cadb597d8cbed534a4cc04a0ada4fc...6deec0c0c2bd64d10da1e4da9dec3fb4a88242dc,1,1,1,2,1,2014-09-24 11:37:17,2014-09-24 11:37:17
cf04e1a827cadb597d8cbed534a4cc04a0ada4fc...251a7a067b8fdb63c81c827b021c3808379d2f92,1,20,47,67,12,2014-09-22 23:12:44,2014-09-22 23:12:44
cf04e1a827cadb597d8cbed534a4cc04a0ada4fc...8e6442cf05a103d15b65282704501fe039de2a20,1,1,1,2,1,2014-09-22 23:05:38,2014-09-22 23:05:38
8e6442cf05a103d15b65282704501fe039de2a20...c53dc526bffb2ee497b9d0c092466af2b793bc06,1,15,0,15,4,2014-09-24 22:21:52,2014-09-24 22:21:52
1b45a38fb531f448caf515d9423683c136ad4545...56d9faebab57000c8c82fb631dbf187c55604664,3,4,4,8,4,2014-05-12 17:19:41,2014-05-12 10:45:04
46135affac29a09200fc01a34dd8408a3d83d493...72558b617332a7e9499f4d40ba782f99a1789ead,1,14,1,15,1,2014-09-25 18:48:38,2014-09-25 18:48:38
6deec0c0c2bd64d10da1e4da9dec3fb4a88242dc...b734c838db53dd97e64d2919f49477bfc1023062,1,1,1,2,1,2015-01-14 01:32:55,2015-01-14 01:32:55
8905be042d4c0a28c58b317b603e9545e8ee9c12...26146319315db1af9075fafa42d74f29dc73031b,1,4,2,6,1,2014-05-12 17:57:00,2014-05-12 10:48:35
738eb2c1a88d441eacc4149ce8f1c12a90267191...d85b67be53bac252c0a28b799d56d1b359c4ee99,56,8180,2575,10755,1613,2014-11-02 14:31:01,2014-11-02 14:31:01
870c075ebf67749b21b6cc0c705088bbe273f1bb...b24fe3dd206ce391ec4c5f68d32fc2259f275563,84,1657,341,1998,304,2014-10-03 03:10:51,2014-10-03 03:10:51
b24fe3dd206ce391ec4c5f68d32fc2259f275563...1b3a10891ebdc6e76a81c8915ba08065311e17d3,53,200,6,206,8,2014-10-03 03:25:53,2014-10-03 03:25:53
1b3a10891ebdc6e76a81c8915ba08065311e17d3...af4a97bef9bfb06e2737ad709dde157688a94daf,32,331,113,444,145,2014-10-03 11:58:41,2014-10-03 11:58:41
af4a97bef9bfb06e2737ad709dde157688a94daf...a0ae38e0c14f94911df6a651c90ff0df03821bbc,14,2035,0,2035,2,2014-10-03 13:33:23,2014-10-03 13:33:23
a0ae38e0c14f94911df6a651c90ff0df03821bbc...0fa94a96904a8ff44d1a26fd6b783c2d6a533540,72,888,10490,11378,211,2014-10-07 04:31:49,2014-10-07 04:31:49
0fa94a96904a8ff44d1a26fd6b783c2d6a533540...3cf6a6fa8cdbd69d2e36addb112ea91fe56577c4,1,2,0,2,1,2014-10-07 13:25:30,2014-10-07 13:25:30
250188e1aaf533eef6c088bf2bd58a3a230d6c9c...04af74596d070f062bd917b0364d87c57544f8d5,2,5,5,10,3,2015-01-14 12:05:33,2015-01-14 12:05:33
0f0b21e84a85ab12d24cfe9b29d50e6af1ef8b19...cdeb610a13aaa70c017c7bafc09ece19f54c6b73,1,1,1,2,1,2014-11-04 21:21:03,2014-11-04 21:21:03
45a509282e912d85c46b40974a2deb926be5be42...b324ff7ea584676fcc3292808d7e7ea609982f8e,73,3350,689,4039,301,2014-05-14 04:22:15,2014-05-14 04:22:15
45a509282e912d85c46b40974a2deb926be5be42...f5421cdaf342ba15840a4041b4a9d9efb44fa4f0,4,51,2254,2305,4,2014-05-13 15:13:08,2014-05-13 15:10:00
f5421cdaf342ba15840a4041b4a9d9efb44fa4f0...d2770ac8a669f567cf34b73c35734c4e9175647b,2,24,12,36,9,2014-05-14 02:52:08,2014-05-14 02:47:17
45a509282e912d85c46b40974a2deb926be5be42...7eb86f2fbc8e75f76473dd6a0869611cf5c0cfb6,3,42,4,46,11,2014-05-13 05:25:24,2014-05-13 05:24:26
45a509282e912d85c46b40974a2deb926be5be42...30cfc0bef4adf13b618647f6642266dd9a7eb502,1,1,1,2,1,2014-05-13 02:30:10,2014-05-13 02:15:28
64e83bfd1404ea593f0c79b478d196a3fcde42a8...703004f830f39adcde9b9565f1aa49d1b10e8d27,40,1114,116,1230,185,2014-06-16 13:22:26,2014-06-16 13:22:26
64e83bfd1404ea593f0c79b478d196a3fcde42a8...2b6106541c47f77b5778ec71fda74540cbc31149,1,7,0,7,1,2014-06-15 02:11:58,2014-06-15 02:10:45
64e83bfd1404ea593f0c79b478d196a3fcde42a8...2f79e59c000f54e9af48a0368a27d35e304eff09,2,38,3,41,5,2014-06-13 07:59:02,2014-03-31 15:06:36
64e83bfd1404ea593f0c79b478d196a3fcde42a8...eb6f7f38c0dcbe15cd0d9e1011913fa6e7f81013,1,14,5,19,5,2014-06-13 03:32:38,2014-06-13 03:31:16
64e83bfd1404ea593f0c79b478d196a3fcde42a8...1378c49a2e4d94f7feaeaa7787ab960e9029e57b,1,10,2,12,3,2014-06-13 03:02:51,2014-06-13 03:02:30
3cf6a6fa8cdbd69d2e36addb112ea91fe56577c4...26d5dac43d084f9d64646885c647ff5f1025a208,2,3,2,5,2,2014-10-08 03:00:59,2014-10-08 02:59:35
04af74596d070f062bd917b0364d87c57544f8d5...2fd9292b12b6a5d8455ab3d7305ee55ebae64c9b,1,1,1,2,1,2015-01-17 04:17:12,2015-01-17 04:17:12
04af74596d070f062bd917b0364d87c57544f8d5...726d379775b4c8e1fc2b72f0c35829cd3151c880,1,3,0,3,1,2015-01-17 01:48:35,2015-01-17 01:48:35
04af74596d070f062bd917b0364d87c57544f8d5...5823f90c53dee251f2edfcbde6c8bb3a0c943e11,1,2,2,4,2,2015-01-16 07:16:41,2015-01-16 06:25:14
5823f90c53dee251f2edfcbde6c8bb3a0c943e11...341ea429db6be0179fc3d9f4fcfcf3dd1c660b03,1,2,16,18,4,2015-01-16 07:16:58,2015-01-16 06:39:11
04af74596d070f062bd917b0364d87c57544f8d5...904770fb91a10f826160a7e00339a1d01cbdff99,1,50,15,65,16,2015-01-15 21:22:12,2015-01-15 21:22:12
04af74596d070f062bd917b0364d87c57544f8d5...d0055a751bc425b27c1e442c0e83cb618f8eca16,3,3,0,3,3,2015-01-15 08:59:07,2014-12-27 02:28:16
04af74596d070f062bd917b0364d87c57544f8d5...d2a0f86d9fd7c3795af397a0a6ad878f67c35bdd,1,7,4,11,2,2015-01-15 07:55:18,2015-01-15 07:54:31
04af74596d070f062bd917b0364d87c57544f8d5...7b9f5e65c9ebb187cf4b7e3ca639ca256915d3d1,164,72,72,144,68,2015-01-15 05:29:53,2014-09-16 00:16:26
7b9f5e65c9ebb187cf4b7e3ca639ca256915d3d1...ae7010888363d6fb9648ef069264328b78ae9047,56,116,115,231,85,2015-01-15 05:29:54,2014-09-18 01:11:49
ae7010888363d6fb9648ef069264328b78ae9047...4b70bc1f35d92728e76ee66d7b8cba250562ef51,2,1,1,2,1,2015-01-15 05:29:55,2014-09-18 19:20:48
4b70bc1f35d92728e76ee66d7b8cba250562ef51...df4141867740cde7df88c0956c99ce831a115915,27,366,215,581,137,2015-01-15 05:29:56,2014-09-21 00:06:38
df4141867740cde7df88c0956c99ce831a115915...d8f453cb39b06399282b0408e9bccd97e9340074,4,6,6,12,4,2015-01-15 05:29:56,2014-09-21 00:35:01
d8f453cb39b06399282b0408e9bccd97e9340074...6983cb80eab6631e99e5a4cf7224b802a4e131b1,4,0,0,0,0,2015-01-15 05:29:57,2014-09-21 13:03:31
6983cb80eab6631e99e5a4cf7224b802a4e131b1...5fc787abd8d373002439ca01b437fa8f46ab1e24,1,2,2,4,1,2015-01-15 05:29:58,2014-09-24 23:25:16
5fc787abd8d373002439ca01b437fa8f46ab1e24...e7893b404ecfa6785f2441489f7a4986f280cd55,3,2,2,4,2,2015-01-15 05:29:58,2014-09-28 10:51:11
e7893b404ecfa6785f2441489f7a4986f280cd55...7f20b864cd08280a38f99a0a968ed4832d32a026,1,2,2,4,2,2015-01-15 05:29:59,2014-10-07 22:45:39
7f20b864cd08280a38f99a0a968ed4832d32a026...2ca8b2683ea7cf3c80024cab841ac9d28959632b,1,5,6,11,6,2015-01-15 05:30:00,2015-01-13 09:30:44
2ca8b2683ea7cf3c80024cab841ac9d28959632b...7c430d52e986d8ef00afbb16852e6647f0df3cc7,1,2,2,4,1,2015-01-15 05:30:00,2015-01-15 05:28:55
04af74596d070f062bd917b0364d87c57544f8d5...7d2f359a0c5ec72d07f95491baa698b800b04069,1,8,1,9,2,2015-01-14 23:05:57,2015-01-14 23:02:51
7d2f359a0c5ec72d07f95491baa698b800b04069...c2ffdb05d4bffd75fd28fb791882c14ec6758b8c,1,1,1,2,1,2015-01-15 18:00:33,2015-01-15 18:00:33
c2ffdb05d4bffd75fd28fb791882c14ec6758b8c...cac555dc78047b96486d5c52e990c7dde62f0a6b,1,1,1,2,2,2015-01-16 12:48:28,2015-01-16 12:48:28
04af74596d070f062bd917b0364d87c57544f8d5...3d3b1937ddf74d96376d889a7b8dac4974b8eda2,1,53,69,122,6,2015-01-14 15:37:24,2015-01-14 15:37:24
d14baf6e41bcdbe4968e0513beccc09dfb160ecd...0dbedd18fc62f700e92a4cf581e505d849bc47ad,168,1534,1310,2844,720,2014-11-06 00:20:42,2014-11-06 00:20:42
0dbedd18fc62f700e92a4cf581e505d849bc47ad...fc676fa6f8de6b0b24cf54ecfa3f9221c607095c,4,18,8,26,12,2014-11-06 14:02:40,2014-11-06 14:02:40
b324ff7ea584676fcc3292808d7e7ea609982f8e...3164784ca3fb5deb56dcd82d16862d562cd60910,1,1,1,2,1,2014-05-20 17:07:47,2014-05-20 17:06:43
b324ff7ea584676fcc3292808d7e7ea609982f8e...fd13b25d6e1256d3ca04e604441f3a05bb25572b,1,2,2,4,1,2014-05-20 13:07:32,2014-05-20 13:05:18
a364bc437138d359b3105a8370911f0aab2385db...9737c02e21202e22da672b546fb64c620aa56f18,1,20,2,22,6,2014-05-21 01:51:51,2014-05-17 02:41:04
a364bc437138d359b3105a8370911f0aab2385db...8be3963aa01ea84cdef6878e5865d5a720ab077b,3,15,3,18,7,2014-05-21 01:47:47,2014-05-02 11:39:12
703004f830f39adcde9b9565f1aa49d1b10e8d27...57ab93bd277b4d5750a4a7634ab20f546c048e1e,2,142,9,151,15,2014-06-17 05:38:44,2014-06-11 09:57:13
57ab93bd277b4d5750a4a7634ab20f546c048e1e...8b31ae491f63a7d8b6fabe099b77ab2bf332d45b,1,9,5,14,4,2014-06-17 05:38:44,2014-06-15 04:15:33
8b31ae491f63a7d8b6fabe099b77ab2bf332d45b...b9a8c39af5b1cb30affaeecb99c99fbb9141cee9,2,12,4,16,5,2014-06-17 05:39:01,2014-06-17 05:38:27
703004f830f39adcde9b9565f1aa49d1b10e8d27...9a75d3175e9deb83f35ca5bec367c94faeb94bdb,2,52,30,82,23,2014-06-17 05:35:14,2014-06-17 05:34:48
155028612bfe26c7c8460f6acc28de6d385a3625...ddc0e7fd3bc00afa33432ed594038dbb80c7fea3,15,517,11,528,46,2014-06-17 14:58:35,2014-06-17 14:58:35
ddc0e7fd3bc00afa33432ed594038dbb80c7fea3...e086bccd63e64b8d3bd2b6b5ce000ef8abd71584,19,664,121,785,119,2014-06-19 05:23:03,2014-06-19 05:23:03
ee049d1913a1e9ff78f58effee62e6d6c19dfa7b...9142d6fc408d72178f102bad97c0c2fe1902ce55,14,79,960,1039,20,2014-10-09 03:06:51,2014-10-09 03:06:51
9142d6fc408d72178f102bad97c0c2fe1902ce55...01ffe6cf89ee0ca32222f6993a2f8e3c872ce0b5,10,406,100,506,89,2014-10-09 22:44:27,2014-10-09 22:44:27
01ffe6cf89ee0ca32222f6993a2f8e3c872ce0b5...ede3a4dd3546d3d9d9de5570e2d68dfdf8139bab,2,102,91,193,28,2014-10-10 01:41:52,2014-10-10 01:41:52
ee049d1913a1e9ff78f58effee62e6d6c19dfa7b...1c6dcee4655a356d2b39928f65164c67a18d0660,2,2,1,3,2,2014-10-08 06:39:47,2014-10-08 06:37:04
ee049d1913a1e9ff78f58effee62e6d6c19dfa7b...27b1f38401489cbb5b84b1900dbc35124bb8852d,1,1,1,2,1,2014-10-08 06:38:46,2014-10-08 03:07:05
3e7d475b59e0a25971cfcfd91f37046f534d88fe...fa62125e05b30f6a7df482af924aa8e552760f07,1,4,3,7,2,2015-01-18 06:40:01,2015-01-18 06:40:01
fa62125e05b30f6a7df482af924aa8e552760f07...a4f40ec3be67e6bd0498e18bc9c9f66274d29a48,1,1,1,2,1,2015-01-18 07:06:20,2015-01-18 07:06:20
3e7d475b59e0a25971cfcfd91f37046f534d88fe...9bfb08830b50af8bb06941e1e5bf07f503e9851f,2,46,39,85,14,2015-01-17 06:48:21,2015-01-17 06:48:21
fc676fa6f8de6b0b24cf54ecfa3f9221c607095c...ab0974448bacd736534e7027448fe8f8ebdc4b92,1,1,1,2,1,2014-11-09 09:09:41,2014-11-09 09:09:41
fc676fa6f8de6b0b24cf54ecfa3f9221c607095c...dae2f4c96f311191b9066e6fe78d23199cb5cf5f,1,1,3,4,1,2014-11-08 08:30:49,2014-11-08 08:30:49
fc676fa6f8de6b0b24cf54ecfa3f9221c607095c...1ce14e3321fe9e559d0c05401ec82806d5b493e4,3,3,3,6,3,2014-11-07 05:26:41,2014-11-07 05:26:41
8bb7cc732563a3c23f13e88be92ccb29015fb391...07b16f456020131e1a1c4ac5a37a17c0f61a1143,1,2,0,2,2,2014-05-22 05:18:33,2014-05-22 05:16:53
8bb7cc732563a3c23f13e88be92ccb29015fb391...6b1b3fbfa5d8a3fc4b58e7b84b0d358cc65a0f81,2,12,3,15,5,2014-05-21 22:01:11,2014-05-21 22:01:11
a5af2971bb3192305c38d45774e3d99ea6b095f0...e253d2010d6f880ae6c8800c8b4789ab3c5ce651,2,16,5,21,16,2014-07-03 08:07:11,2014-07-03 08:06:23
e086bccd63e64b8d3bd2b6b5ce000ef8abd71584...911914adad997b6ab6ceba9bd45349254498ed37,2,29,1,30,3,2014-06-26 12:14:37,2014-06-26 12:14:37
e086bccd63e64b8d3bd2b6b5ce000ef8abd71584...de7811ab422536800449e59900be4b3dcd2e4bcc,1,1,1,2,1,2014-06-25 04:01:56,2014-06-25 03:43:45
e086bccd63e64b8d3bd2b6b5ce000ef8abd71584...4a59f683d3772edd9233e93e1bee9c99400502f4,1,6,5,11,8,2014-06-23 15:44:36,2014-06-23 15:43:37
e086bccd63e64b8d3bd2b6b5ce000ef8abd71584...ee131f9f058e789e71fd8859e210ff3d64d45d30,1,1,0,1,1,2014-06-22 17:54:21,2014-06-22 17:52:54
e086bccd63e64b8d3bd2b6b5ce000ef8abd71584...d29ccb4db3f5d97c56a01507552e77f748ef7cd4,1,1,1,2,1,2014-06-21 15:42:57,2014-06-21 15:42:25
ede3a4dd3546d3d9d9de5570e2d68dfdf8139bab...c5069bea01f280107bbfae21a1a9e819350bf662,1,1,13,14,1,2014-10-10 03:32:57,2014-10-10 03:32:57
ede3a4dd3546d3d9d9de5570e2d68dfdf8139bab...5cb403747ea102de5233619263b2162224214947,1,7,7,14,4,2014-10-10 02:34:27,2014-10-10 02:34:27
72d5c2b8caa7416ca2c8e66cddf14f65167cc6c1...4b76b2caf5d63dac47f57e4684ea255a11ce89d6,2,2,2,4,2,2014-11-11 18:15:19,2014-11-11 18:15:19
4b76b2caf5d63dac47f57e4684ea255a11ce89d6...6628c0035bdf734a8280e5b481dc8486860e538e,2,2,2,4,2,2014-11-11 18:57:25,2014-11-11 18:57:25
9d5a2cb8470d538fa33f9f7b4d6cdd5390b3b70b...e361e8539c889d3ca66e77ebb5d0ceb61d17f49d,28,418,106,524,82,2014-12-02 17:02:41,2014-12-02 17:02:41
e361e8539c889d3ca66e77ebb5d0ceb61d17f49d...8ad12525a90d90d77dc08b3d6decae33be5675c4,4,33,2,35,11,2014-12-02 20:26:56,2014-12-02 20:26:56
fee28f7a9d15e4b2bd71cb2365937910f92c8144...f9ff086235cd4ff406b136f62fff77b85c0873f9,1,1,1,2,1,2014-05-24 04:30:28,2014-05-24 04:30:28
f9ff086235cd4ff406b136f62fff77b85c0873f9...1cad087969efefa401a11051343cd0689f660770,54,923,101,1024,154,2014-05-24 04:35:47,2014-05-24 04:35:47
1cad087969efefa401a11051343cd0689f660770...71355aaab7eca64bec694918c6b911a412ad17f0,4,17,111,128,5,2014-05-24 16:25:56,2014-05-24 16:25:56
fee28f7a9d15e4b2bd71cb2365937910f92c8144...1e41bfa9cf525d031a63919ef23e54350ef24620,1,21,15,36,12,2014-05-22 08:26:55,2014-05-22 08:24:46
fee28f7a9d15e4b2bd71cb2365937910f92c8144...92eda764df29b15ca0c348e4c2eed1eac6360047,1,14,0,14,1,2014-05-22 06:05:05,2014-05-22 06:05:05
cd80d442a212a119b4bfce95dce78a08cbc49490...3d68949a1cc41b4865618bddde23122f66764ee1,22,1687,350,2037,181,2014-07-06 14:49:27,2014-07-06 14:49:27
cd80d442a212a119b4bfce95dce78a08cbc49490...034aec2539f50f3943581c30fdf3eff3e66f7532,1,20,14,34,13,2014-07-06 12:32:29,2014-07-06 12:28:30
cd80d442a212a119b4bfce95dce78a08cbc49490...e68c3cb9f292e9d4dba3edec138ad30db9dab161,1,1,1,2,1,2014-07-06 12:31:39,2014-07-06 12:31:11
1cc96a4d7440d9e8a20f7dbf17cf5771170de83d...2af2a84a03fd707cfa4c682aff34d722343d8985,74,1415,661,2076,470,2014-06-28 02:21:45,2014-06-28 02:21:45
911914adad997b6ab6ceba9bd45349254498ed37...2482aa1362402ca26d41007b9a2fa49d84fa53aa,1,2,7,9,2,2014-06-26 12:46:55,2014-06-26 12:46:55
97731696c9e45a351d64660b46c6d027f3b0a25e...01632a824ee7e2326aa90b32d75c2fe09f61a37e,13,301,46,347,52,2014-06-30 01:41:02,2014-06-30 01:41:02
01632a824ee7e2326aa90b32d75c2fe09f61a37e...7bb5693094b0c624d761cf2044258ea5a21fff4d,2,6,3,9,4,2014-06-30 02:24:05,2014-06-30 02:24:05
7bb5693094b0c624d761cf2044258ea5a21fff4d...ff5a815523b3bb69674f7d678e9d03278ed5ec30,2,17,2,19,4,2014-06-30 04:28:05,2014-06-30 04:28:05
c72f9438668655bded4db08de781b22113b1348b...7fed1841aa7e501b4020b9ee4c1a65239f0e54cd,1,1,1,2,1,2014-10-10 03:38:45,2014-10-10 03:38:45
c8cd5222a7fa931f072e02b23c5b9d826d0ef548...e2ba6ecf57ad4bb8b90d09dd02738995cd210bba,4,2304,2129,4433,621,2014-11-12 14:39:21,2014-11-12 14:39:21
c8cd5222a7fa931f072e02b23c5b9d826d0ef548...6dd8768811cfca5bb831619d93cf870e5d20667f,41,1050,185,1235,167,2014-11-12 14:23:23,2014-11-12 14:23:23
6dd8768811cfca5bb831619d93cf870e5d20667f...12f3bc83b3c4f94287a2ecbfcd6ccb2ab9d35e25,1,1,0,1,1,2014-11-12 14:28:23,2014-11-12 14:28:23
12f3bc83b3c4f94287a2ecbfcd6ccb2ab9d35e25...d02953c5963ca080d26500ea8250e0632a80b234,1,1,1,2,1,2014-11-12 14:29:22,2014-11-12 14:29:22
8ad12525a90d90d77dc08b3d6decae33be5675c4...c981f5409f44b00d879a2698b4cf4e0156264e1c,1,0,1,1,1,2014-12-03 16:36:29,2014-12-03 16:36:29
8ad12525a90d90d77dc08b3d6decae33be5675c4...4a7114262343e39235569525b7939896f806b4e6,2,7,0,7,3,2014-12-03 05:22:06,2014-12-03 04:17:23
4a7114262343e39235569525b7939896f806b4e6...25f8f5339a803d55d448d1760b5e8671e0946509,1,1,1,2,1,2014-12-03 05:29:28,2014-12-03 05:29:28
71355aaab7eca64bec694918c6b911a412ad17f0...2760a81b0ba99dcd11ee70d01c3960213d858a57,1,1,1,2,1,2014-05-25 17:25:05,2014-05-25 17:25:05
71355aaab7eca64bec694918c6b911a412ad17f0...e6c1689b69e9e0ec530902b550c9e1e2d1cd0aae,13,118,2,120,14,2014-05-25 06:50:54,2014-05-25 03:34:51
3d68949a1cc41b4865618bddde23122f66764ee1...9ff6d55822647c87eef392147ea15641d0922d47,16,1631,12,1643,21,2014-07-07 20:44:21,2014-07-07 20:44:21
3d68949a1cc41b4865618bddde23122f66764ee1...a62305e0e3296dc226f469a75b25f72163873e85,2,14,0,14,3,2014-07-07 11:08:26,2014-07-01 14:07:04
2af2a84a03fd707cfa4c682aff34d722343d8985...8ffc113b7094c5ba7971aaa65dae4131130acef3,3,14,0,14,7,2014-06-28 12:50:20,2014-06-28 12:50:20
2af2a84a03fd707cfa4c682aff34d722343d8985...d1d15ff19d50d1e4fff447908be28fb663f78b28,1,0,0,0,0,2014-06-28 05:11:19,2014-06-28 05:10:12
ff5a815523b3bb69674f7d678e9d03278ed5ec30...002db0b1252b56c9ff8ec5da466e0bf21ec81c7d,1,2,0,2,1,2014-06-30 05:28:16,2014-06-30 05:23:17
7fed1841aa7e501b4020b9ee4c1a65239f0e54cd...f1d9de068cbafda257fb6312ee51994398a8671a,1,1,1,2,1,2014-10-10 14:00:17,2014-10-10 14:00:17
d02953c5963ca080d26500ea8250e0632a80b234...abbea4d945bbb1114570c3b6c7f649e01ca8ebb8,29,365,71,436,77,2014-11-13 03:53:12,2014-11-13 03:53:12
f7c9a4a0a8ab770dfe565c31c7c47585beb53594...c79be979d47daae613d1b1bbc732a30a74f56543,35,491,115,606,171,2014-12-07 05:04:20,2014-12-07 05:04:20
c79be979d47daae613d1b1bbc732a30a74f56543...efb257c675a028de666b4bfcbac47b16770e10e7,1,1,1,2,1,2014-12-07 05:31:43,2014-12-07 05:31:43
efb257c675a028de666b4bfcbac47b16770e10e7...c940212b8931c0cc9c24984758568c2d2d18b951,1,2,0,2,2,2014-12-07 05:39:51,2014-12-07 05:39:51
9df8d5f616dbb3f81299ccca4929c0a8f46a6d79...6851f9bfaefdd70eb009efdede444d3238c7277c,5,290,27,317,32,2014-12-08 18:47:45,2014-12-08 18:47:45
6851f9bfaefdd70eb009efdede444d3238c7277c...3aed5de7a9220b1b2c8d059a7b6a39e638f74d92,1,1,1,2,1,2014-12-08 18:51:27,2014-12-08 18:51:27
3aed5de7a9220b1b2c8d059a7b6a39e638f74d92...be4e40e90a5a322f6a7cec4893854ef5b15db600,1,6,1,7,4,2014-12-08 19:09:29,2014-12-08 19:09:29
2760a81b0ba99dcd11ee70d01c3960213d858a57...40affa8760860ece7c6c8a07fdc4795e38635c81,2,42,17,59,12,2014-05-28 07:27:30,2014-05-28 06:42:33
2760a81b0ba99dcd11ee70d01c3960213d858a57...a1635e809fbd5644e1745a07fbdf7ca789c531f9,1,110,0,110,1,2014-05-28 06:58:54,2014-05-28 06:39:06
2760a81b0ba99dcd11ee70d01c3960213d858a57...5429118f83cdf9bdc4e13dee83e9b6b11b6e0156,1,6,4,10,1,2014-05-26 05:42:44,2014-05-26 05:37:58
9ff6d55822647c87eef392147ea15641d0922d47...a8c891566ece8c34a3fe224633b5b6c92605de4d,1,42,4,46,6,2014-08-02 21:07:38,2014-08-02 21:07:38
a8c891566ece8c34a3fe224633b5b6c92605de4d...85bccf487cbc3d40b16d4cb23efa43fd75d6499f,1,25,10,35,8,2014-08-02 23:10:22,2014-08-02 23:10:22
85bccf487cbc3d40b16d4cb23efa43fd75d6499f...0dd29d0512a4e28f83f7b4529fccf9f126982a5d,1,4,5,9,4,2014-08-15 01:35:31,2014-08-15 01:35:31
9ff6d55822647c87eef392147ea15641d0922d47...678948068bbde7f12a9c5f28a467b6cf4d127851,1323,11555,39719,51274,532,2014-08-02 01:10:38,2014-08-02 01:10:38
678948068bbde7f12a9c5f28a467b6cf4d127851...a1d6cd02e39fbc84bc6f06e01496c11759b99c2d,4,13,8,21,10,2014-08-02 02:35:36,2014-08-02 02:35:36
9ff6d55822647c87eef392147ea15641d0922d47...e55ef57f6253673ab9a5553d47964cd378423334,1,7,0,7,1,2014-07-15 05:29:36,2014-07-15 05:29:03
e55ef57f6253673ab9a5553d47964cd378423334...f5c56f4a3de502ecc8e5d1730f9657abd81a014b,1,1,2,3,1,2014-07-15 07:07:29,2014-07-15 07:06:55
9ff6d55822647c87eef392147ea15641d0922d47...95383469d318e15e9c28a3507194584a3f79276b,1,5,2,7,4,2014-07-15 05:07:40,2014-07-15 05:05:55
9ff6d55822647c87eef392147ea15641d0922d47...cb127b86f47dd732ffedc782038fec69930687d0,1,1,1,2,1,2014-07-15 03:23:52,2014-07-15 03:22:24
9ff6d55822647c87eef392147ea15641d0922d47...b1e03d536f0f2cceb470b9f768b6841b4ea94251,1,4,1,5,1,2014-07-13 00:48:02,2014-07-13 00:48:02
b1e03d536f0f2cceb470b9f768b6841b4ea94251...568be61b0985d4abb1b6ca7ffcec7f79447d3514,1,2,1,3,1,2014-07-13 02:09:47,2014-07-13 02:08:50
9ff6d55822647c87eef392147ea15641d0922d47...e6df7da6abe89979dea501cd48ff288f27a3c394,2,11,12,23,8,2014-07-10 07:42:34,2014-07-10 02:55:03
9ff6d55822647c87eef392147ea15641d0922d47...9aa278c590397d0ad0f1fee80d3fafc52e00d2d4,1,3,2,5,1,2014-07-07 20:54:34,2014-07-07 20:54:34
77a15e2a3e1231bf9ba011af9ee10afe5fae17dd...e9da61411a6f1c993d528b659ebb3e5147aa44cc,8,359,14,373,29,2014-07-02 03:09:36,2014-07-02 03:09:36
77a15e2a3e1231bf9ba011af9ee10afe5fae17dd...87d27bb9974bd5b81933fb4a893d0d05d9564298,1,2,2,4,2,2014-06-30 15:01:23,2014-05-18 09:56:08
37354da5b0dc1dc8dcfd9d844e593935311f4f8f...948fd83cdded7fed77ae5213101c1a2ece580434,30,1066,89,1155,136,2014-10-12 05:13:22,2014-10-12 05:13:22
91faf8e21810c8995e4f6e3b6ba47a6482ab877e...4d2198110b4af7f203eeef95697255569e49bce7,28,458,233,691,135,2015-03-03 17:39:13,2015-03-03 17:39:13
91faf8e21810c8995e4f6e3b6ba47a6482ab877e...6f3c09047ecea651a219c36dd9fa9f96b5f06be4,5,25,4,29,12,2015-01-18 12:51:11,2015-01-18 12:51:11
91faf8e21810c8995e4f6e3b6ba47a6482ab877e...9f61a4881e018508e1914ddbb4e7740c11f0a272,1,4,0,4,2,2015-01-17 18:08:26,2015-01-17 18:06:29
43d0eddc3ce7e8de52278252c1ebbd37d52d0b5c...7d8e34c284e14533183b3b894fb4eaaac877349c,1,8,2,10,6,2014-11-13 05:38:26,2014-11-13 05:38:26
c940212b8931c0cc9c24984758568c2d2d18b951...05801b92652f3fc21063a8aab516633769c9ba55,3,106,30,136,18,2014-12-07 06:07:00,2014-12-07 06:07:00
05801b92652f3fc21063a8aab516633769c9ba55...380f12def25e4031756354907e8d5abe5466b864,1,5,8,13,2,2014-12-07 07:21:49,2014-12-07 07:21:49
be4e40e90a5a322f6a7cec4893854ef5b15db600...bcf27feb980aec593c7cb771984e46113cfad757,30,2089,773,2862,475,2014-12-17 01:31:57,2014-12-17 01:31:57
be4e40e90a5a322f6a7cec4893854ef5b15db600...089d7fa171e3a3305991047e82b4043d4f05783f,21,348,46,394,61,2014-12-15 18:42:58,2014-12-15 18:42:58
089d7fa171e3a3305991047e82b4043d4f05783f...7eb5d049c24033e0bbfa3bab91163ddaaeea68be,1,1,1,2,1,2014-12-15 18:49:18,2014-12-15 18:49:18
7eb5d049c24033e0bbfa3bab91163ddaaeea68be...99cf6c0dc40a5124c21dd60379794baadfe296c2,1,0,5,5,1,2014-12-16 01:41:50,2014-12-16 01:41:50
be4e40e90a5a322f6a7cec4893854ef5b15db600...e168d43b4a6964bf5b9808bc3f19bf1ab99a8535,1,1,1,2,1,2014-12-10 21:50:43,2014-12-10 21:50:43
be4e40e90a5a322f6a7cec4893854ef5b15db600...792d675d819119f209fb656bd366d010837a8762,1,1,1,2,1,2014-12-09 04:53:55,2014-12-09 04:53:55
be4e40e90a5a322f6a7cec4893854ef5b15db600...b8742051196a3fc74f74fb79bb900eec3c56f96f,1,1,1,2,1,2014-12-09 04:26:19,2014-12-09 04:26:19
d9adf2627a70ab37408aca9ae4140c6280dfe6df...6f0b4678e26c04abfc88c0226c803e78a108de98,50,2261,93,2354,201,2014-05-29 13:56:39,2014-05-29 13:56:39
a1d6cd02e39fbc84bc6f06e01496c11759b99c2d...3c99d58a39365efd712dd76f75fa92e832b81f80,1,0,1,1,1,2014-08-20 20:48:24,2014-08-20 20:48:24
a1d6cd02e39fbc84bc6f06e01496c11759b99c2d...e0f37da05780eab01d79484c517361fb5bb38e2d,1,2,2,4,2,2014-08-13 20:31:50,2014-08-13 20:31:50
a1d6cd02e39fbc84bc6f06e01496c11759b99c2d...798491e8d381e6fd3ade2ac146314e8da47111e8,1,2,0,2,2,2014-08-13 16:20:41,2014-08-13 16:20:41
a1d6cd02e39fbc84bc6f06e01496c11759b99c2d...f10233ba313625c9315d6708295eeb47331d0c64,4,50,0,50,2,2014-08-06 06:29:14,2014-08-06 06:29:14
c3e1d7b7c788530dc69e973352763a90da05d4e1...2ee4ac183babedd679e901b0158f5268556deceb,56,3941,1755,5696,223,2014-08-14 13:31:38,2014-08-14 13:31:38
2ee4ac183babedd679e901b0158f5268556deceb...89fa70706f9166765c3ac3f799225a467800f065,1,4,2,6,3,2014-08-14 14:59:35,2014-08-14 14:59:35
ecea1f34d34885d3151f978599c89d237ee908cc...6a9ef50cfcc6e56f44f91a65d23f0954cfd92f90,1,14,0,14,1,2014-07-02 12:13:17,2014-07-02 12:05:42
ecea1f34d34885d3151f978599c89d237ee908cc...0eed04904cbacfca6c9e35e7ab8b43b033463374,2,3,3,6,3,2014-07-02 07:34:46,2014-07-02 07:34:46
948fd83cdded7fed77ae5213101c1a2ece580434...299bccdee99a9858f3bb874c70bd435151018e3a,1,7,1,8,1,2014-10-13 03:20:56,2014-10-13 03:20:56
f53b27dca33e00cfc5f05d3dbaf58c0f97ff28bf...a34d27438cb941b820fed075a85ead0c593676df,2,29,6,35,10,2015-02-10 01:18:44,2015-02-10 01:18:28
2c2894ceb674927a35d2798b3e63adabdb020077...09489e3a78de39bb4d8690f3c65f8a5e7a56a95e,214,1074,290,1364,206,2015-03-09 05:34:56,2015-03-09 05:34:56
e0c0aef615e8c8dac370fe745972190a077dc0cc...a0511ed59a0e03232bf3abb49b3c916591453aef,9,1240,10,1250,24,2015-01-19 05:39:58,2015-01-19 05:39:58
2b22aba39e5dc449ab1f50cd497a1a39358ce84a...eac0de398fe48422f7e88509ff04a66667a95284,3,1,37,38,3,2015-01-17 19:19:57,2015-01-17 19:19:57
56b30b31e4df887a5b7b5c70a87597d250482c1f...d5cb758d36035fc35e960a466d0b370ff19e4f76,14,224,20,244,46,2014-11-17 10:46:11,2014-11-17 10:46:11
d5cb758d36035fc35e960a466d0b370ff19e4f76...e709468bb13e795cff72b3e87198c61c5b1a2ee7,10,155,9,164,19,2014-11-19 14:33:15,2014-11-19 14:33:15
e709468bb13e795cff72b3e87198c61c5b1a2ee7...d70e16f72f2db8c299279fc2903f4308191f142e,7,68,6,74,23,2014-11-26 17:24:13,2014-11-26 17:24:13
da91ca71645cccf38dc593ef790d09d4610c2aef...10b371516bfd88f354acde9a2b37cf854eb92780,3,12,8,20,7,2014-12-07 14:33:57,2014-12-07 14:33:57
d55f95e0d2a2f99a4130a33ad542c3682d0b92db...2dd302ff906285c5fdcb5f7bc822eb786870327a,2,21,33,54,11,2014-12-17 02:17:35,2014-12-17 02:17:35
2dd302ff906285c5fdcb5f7bc822eb786870327a...fd4648c081afa565cb20c923c4e3c94d88e71e4f,2,12,1,13,4,2014-12-17 02:46:55,2014-12-17 02:46:55
fd4648c081afa565cb20c923c4e3c94d88e71e4f...c8b2a5f64a44484b566bc1e2aa12aa36850f107e,7,151,1,152,13,2014-12-17 04:53:34,2014-12-17 04:53:34
99cf6c0dc40a5124c21dd60379794baadfe296c2...ef02ef28675b02e9e8fb1e09ccc6acb1dd018b95,1,1,1,2,1,2014-12-16 14:17:29,2014-12-16 14:17:29
0c2222188e7d9b9c2bcae8186c7a164b50000dc3...66a2adbf4badc7f97923e9e2c02d8f1b807d560e,2,488,22,510,15,2015-01-09 06:36:38,2015-01-09 06:36:38
0c2222188e7d9b9c2bcae8186c7a164b50000dc3...e2f5cf3ef0962e0867cd44ea3e7727bb075ffe91,1,2,4,6,3,2015-01-09 03:20:02,2015-01-09 03:19:21
6f0b4678e26c04abfc88c0226c803e78a108de98...9b8696d3dd92e2ed6f310ad0f0bf3c2182c9c6ae,61,4245,1423,5668,285,2014-06-11 13:41:03,2014-06-11 13:41:03
6f0b4678e26c04abfc88c0226c803e78a108de98...57a53fbe5280e5af1a7f01a9bdc9b6b091a73b23,1,23,0,23,4,2014-06-04 03:38:17,2014-06-04 03:32:49
57a53fbe5280e5af1a7f01a9bdc9b6b091a73b23...ffe01a51cb7229e2648a5956c40ea04460c0b43e,2,335,313,648,34,2014-06-04 03:38:30,2014-06-04 03:31:20
6f0b4678e26c04abfc88c0226c803e78a108de98...56533e6a75872fd9d2c2bf10771df96e1082bffd,1,1,0,1,1,2014-06-02 19:18:58,2014-06-02 18:42:35
6f0b4678e26c04abfc88c0226c803e78a108de98...359ea6088cbe6cdad49919eb1ee669cb73d28da0,1,8,3,11,5,2014-05-31 21:50:10,2014-05-31 21:50:10
6f0b4678e26c04abfc88c0226c803e78a108de98...91aa645d8a6d3dfa4e92a7de37a6bee5b8c3b31a,2,6,0,6,2,2014-05-31 15:13:08,2014-05-31 15:13:08
89fa70706f9166765c3ac3f799225a467800f065...1a2cb755e2d8b9d59178f36702f6dff7235b9088,82,5153,848,6001,419,2014-09-03 02:13:40,2014-09-03 02:13:40
89fa70706f9166765c3ac3f799225a467800f065...a8266cd9b2360f1d50316e2cad31e43b1c2e8613,1,2,1,3,1,2014-08-28 06:06:28,2014-08-28 06:04:09
a8266cd9b2360f1d50316e2cad31e43b1c2e8613...d344043db78cef696a3bf574ab1f93be8ac1137d,1,3,3,6,3,2014-08-28 06:12:15,2014-08-28 06:06:53
89fa70706f9166765c3ac3f799225a467800f065...d98d3fb8ea617eadc5f8e268b9f26f8e586e118c,2,6,1,7,2,2014-08-27 21:21:24,2014-08-27 21:21:24
89fa70706f9166765c3ac3f799225a467800f065...f6c81bbd7bfa3d0c30dd2d0193db5b7b95678087,5,13,13,26,9,2014-08-25 19:13:30,2014-08-25 19:13:30
89fa70706f9166765c3ac3f799225a467800f065...dbae857b293231882307c52217e9569a17da0f23,3,42,11,53,3,2014-08-25 06:54:38,2014-08-25 06:54:10
dbae857b293231882307c52217e9569a17da0f23...247e7ed716a4c0bd5140c2b2a938f7118e84fb14,82,5153,848,6001,419,2014-09-15 21:43:28,2014-09-03 02:13:40
247e7ed716a4c0bd5140c2b2a938f7118e84fb14...0c7b75d8d82d7a0c2b9347c7a2096a86a349fe7f,217,81474,8143,89617,440,2014-09-15 21:43:29,2014-09-15 14:33:30
89fa70706f9166765c3ac3f799225a467800f065...884b79ce0ee37686d758f2299cea8559ae93df27,3,8,1,9,6,2014-08-25 01:20:45,2014-08-25 01:20:45
89fa70706f9166765c3ac3f799225a467800f065...e641752911b0aa75d5bcf156a664e626ffd2521c,1,0,1,1,1,2014-08-22 16:38:24,2014-08-22 16:38:24
89fa70706f9166765c3ac3f799225a467800f065...b86d1e39b9a201c0c6b97c29217ef112c850a6aa,1,16,12,28,3,2014-08-21 15:13:57,2014-08-21 15:08:53
89fa70706f9166765c3ac3f799225a467800f065...894b82a05fa82e84e994a8aac3e1893193bafbbf,1,15,1,16,1,2014-08-20 23:06:59,2014-08-20 23:06:59
89fa70706f9166765c3ac3f799225a467800f065...f75b8a81d2f356627731633471b2fe992daa1edf,4,1254,0,1254,5,2014-08-20 04:01:41,2014-08-20 04:01:41
f75b8a81d2f356627731633471b2fe992daa1edf...b51da466e9fc25fb39e499f1d521a2a0b78c63cf,2,29,0,29,3,2014-08-20 04:19:22,2014-08-20 04:19:22
b51da466e9fc25fb39e499f1d521a2a0b78c63cf...87faf1c046ddc024cf956096f8ad342b97f3c2d4,5,525,4,529,19,2014-08-20 08:39:28,2014-08-20 08:39:28
87faf1c046ddc024cf956096f8ad342b97f3c2d4...1c0ac4ee45bf197152bc2bd6cf436a155b72f309,1,5,4,9,5,2014-08-20 10:33:17,2014-08-20 10:33:17
1c0ac4ee45bf197152bc2bd6cf436a155b72f309...5668cec030e67a89994a97db06ca7101ab9be272,4,84,22,106,43,2014-08-21 07:34:16,2014-08-21 07:34:16
5668cec030e67a89994a97db06ca7101ab9be272...d7eb4550b0d33d3b932c166d2216a4c468d49649,1,4,2,6,2,2014-08-21 07:51:18,2014-08-21 07:51:18
d7eb4550b0d33d3b932c166d2216a4c468d49649...344420f67cc0e5439bae82e580063f4110def91a,5,177,69,246,63,2014-08-22 03:24:53,2014-08-22 03:24:53
344420f67cc0e5439bae82e580063f4110def91a...3a93143e5296e1978b283e86205a61745c48fb0f,2,28,7,35,8,2014-08-22 06:25:41,2014-08-22 06:25:41
3a93143e5296e1978b283e86205a61745c48fb0f...64413191a96aed4479415a3d235117d9be2519da,4,430,49,479,48,2014-08-25 05:36:56,2014-08-25 05:36:56
64413191a96aed4479415a3d235117d9be2519da...5bddfa201e4982a27dfa2e6d70e2433e7861889c,2,51,21,72,24,2014-08-27 07:39:04,2014-08-27 07:39:04
13a848e332092b40956739a08fa0dac3357db950...a84ba9c853f972f8e666b17f3e0f875b7282e6c1,25,349,184,533,117,2014-10-14 04:01:25,2014-10-14 04:01:25
66d32b75b3d8b32033936c12b9585f519316035a...d67e8667886329ad4717178e8e09ceef1a42af34,2,40,0,40,10,2015-02-11 02:40:10,2015-02-10 19:54:22
66d32b75b3d8b32033936c12b9585f519316035a...cbade4daf6ade0f6189ec8213c307b88840bc129,1,1,1,2,1,2015-02-10 18:39:52,2015-02-10 18:39:52
09489e3a78de39bb4d8690f3c65f8a5e7a56a95e...7957709cb162a646ad5c81f81cce62f0f61b5e1c,2,7,6,13,6,2015-03-09 08:28:08,2015-03-09 08:28:08
a0511ed59a0e03232bf3abb49b3c916591453aef...75be78b3702a043ce95fc54df45b98908c9593ec,1,10,2,12,1,2015-01-20 12:01:58,2015-01-20 12:01:58
a0511ed59a0e03232bf3abb49b3c916591453aef...317c496f5c1aa25af4144ea04cef4ba6fe420830,2,26,0,26,3,2015-01-20 12:01:02,2015-01-20 12:01:02
a0511ed59a0e03232bf3abb49b3c916591453aef...92cc7b840eff99e90b64caad6883aefbe4c3dd1e,2,29,1,30,3,2015-01-19 20:47:50,2015-01-19 20:47:50
92cc7b840eff99e90b64caad6883aefbe4c3dd1e...0e8987abaf898db74b8b0278effd305673935d5e,1,9,5,14,2,2015-01-20 14:05:22,2015-01-20 14:05:22
a0511ed59a0e03232bf3abb49b3c916591453aef...a8b318871c016a9ece8964daf02f4e85d31824ad,12,109,35,144,38,2015-01-19 13:07:25,2015-01-19 13:07:25
a8b318871c016a9ece8964daf02f4e85d31824ad...c5bf43f6eb8aa9815362b1f771396e68c7f26f0f,16,110,89,199,77,2015-02-02 11:27:48,2015-02-02 11:27:48
10b371516bfd88f354acde9a2b37cf854eb92780...dc694f49b8e9a98052be38fa2a5a33cba42e668e,2,16,13,29,4,2014-12-08 09:35:06,2014-12-08 09:35:06
10b371516bfd88f354acde9a2b37cf854eb92780...88f58c5c26b0dfb759400f20e104a86af3187cb1,1,8,4,12,4,2014-12-08 05:58:39,2014-12-06 12:59:16
10b371516bfd88f354acde9a2b37cf854eb92780...45c9e169d9a6fcf1630bf6fb23cb606f0bba5fb5,1,0,0,0,0,2014-12-08 05:21:05,2014-12-08 05:20:14
c8b2a5f64a44484b566bc1e2aa12aa36850f107e...8347e008c2a23a7bab6b7847d02204c0cee54fb0,1,2,2,4,2,2014-12-17 12:14:25,2014-12-17 12:14:25
c8b2a5f64a44484b566bc1e2aa12aa36850f107e...378fb0bacec858847734452c080afb30eb308d7a,1,1,1,2,1,2014-12-16 20:16:48,2014-12-16 20:16:48
0a6f409323eda5d1ae2c968bbd482c8af1370466...7c7ab30c4ef74f3e7a90ab6d23d69d545fac7cf3,7,26,11,37,8,2015-01-13 14:22:56,2015-01-13 14:22:56
0a6f409323eda5d1ae2c968bbd482c8af1370466...88591af4ac8178c6c6ad9faad6ccb25e7104d1c0,2,3,2,5,3,2015-01-10 07:37:00,2015-01-10 07:37:00
40e32b1fca820494d2aa71d8da70e5904d270997...2c3d279c759cf6fa096f762c96920137e84d1f77,2,164,31,195,23,2014-06-10 02:36:45,2014-05-16 11:48:23
40e32b1fca820494d2aa71d8da70e5904d270997...0be5ff50aaf3041f05ea230e603742832b891123,1,11,13,24,6,2014-06-04 21:15:37,2014-06-04 21:15:37
0be5ff50aaf3041f05ea230e603742832b891123...729cadad13bdd9e49543cda7331e817c72460155,1,10,9,19,3,2014-06-04 21:30:39,2014-06-04 21:30:39
1a2cb755e2d8b9d59178f36702f6dff7235b9088...8cab401d08f8e25aa9b2dc710204785858ff3dbb,217,81474,8143,89617,440,2014-09-15 14:33:30,2014-09-15 14:33:30
1a2cb755e2d8b9d59178f36702f6dff7235b9088...21a3aa56c90db372cac63c0bcac13404d38521bd,23,27,27,54,23,2014-09-14 19:43:15,2014-09-14 19:26:31
1a2cb755e2d8b9d59178f36702f6dff7235b9088...d21f72adf2c7951fef1f5fd7e21234808bc23c38,1,6,6,12,4,2014-09-05 10:15:26,2014-09-05 10:15:26
d21f72adf2c7951fef1f5fd7e21234808bc23c38...5b6773f6bcd79d5efaa43ef1ce58817e4b3556b5,2,15,16,31,7,2014-09-06 04:42:59,2014-09-06 04:42:59
6bc49455e5ac185b4f966a3d8e03223339486c0a...fb7e27f9ed08a8dab58124cc0a9f532f070d3825,1,19,2,21,3,2014-09-16 05:40:03,2014-09-16 05:40:03
fb7e27f9ed08a8dab58124cc0a9f532f070d3825...f93712d0ae3034afd8c999511fed3d6ed9b90b1b,1,0,15,15,2,2014-09-16 06:01:35,2014-09-16 06:01:35
f93712d0ae3034afd8c999511fed3d6ed9b90b1b...103cc7ffda6f15fedacc4be4ae93283472c474c3,2,3,12,15,3,2014-09-16 06:49:31,2014-09-16 06:49:31
103cc7ffda6f15fedacc4be4ae93283472c474c3...29fa278c6a039adef517861376ee0beef5f550cf,2,22,0,22,2,2014-09-16 07:22:29,2014-09-16 07:22:29
a84ba9c853f972f8e666b17f3e0f875b7282e6c1...b4fcf5d5c43868ce6ad60797f5d42a7ac3d1699d,1,5,1,6,1,2014-10-14 04:43:51,2014-10-14 03:13:54
b3a6cc097d5bc60ee6e7ba30b177bed3a8aadc71...97e46194f4d524ff8db773f42288fa80f306433b,2,52,1,53,4,2015-02-12 03:17:29,2015-02-12 03:17:29
dfb94de0417b44b705596961d1a9646f10852605...e74982e55e966c99c48b22652f6eb5f17a782b89,3,17,7,24,10,2015-02-10 22:14:22,2015-02-10 22:14:22
e74982e55e966c99c48b22652f6eb5f17a782b89...878e8056652e97299c1db527557a2ff9cefaa4a8,1,1,0,1,1,2015-02-10 22:18:00,2015-02-10 22:18:00
878e8056652e97299c1db527557a2ff9cefaa4a8...86786588759bea9a9128f15a25c8d7145aeecbd5,1,0,1,1,1,2015-02-10 22:19:11,2015-02-10 22:19:11
86786588759bea9a9128f15a25c8d7145aeecbd5...d22b256f0841a0ff97f45c5a11aeccd7658b79fa,1,6,0,6,1,2015-02-11 02:53:04,2015-02-11 02:53:04
d22b256f0841a0ff97f45c5a11aeccd7658b79fa...1d54c2dd1c94cd8b44fc9cd5a67deba88dbabdda,3,25,2,27,5,2015-02-11 09:51:20,2015-02-11 09:51:20
3fc9017fbb1ae81569aa2ac1401e3272f89a6e65...91744e9ed3124ca48e0837ee72bfe7182fd31701,17,76,8,84,29,2015-03-10 03:53:50,2015-03-10 03:53:09
91744e9ed3124ca48e0837ee72bfe7182fd31701...57380f9aba2352755273acb9dcd5f20351e668ce,1,1,1,2,1,2015-03-10 12:53:22,2015-03-10 12:53:22
57380f9aba2352755273acb9dcd5f20351e668ce...a6f96f46b779a815b03974fece21728fe32e88d2,19,317,1,318,21,2015-03-11 00:05:49,2015-03-11 00:05:49
a6f96f46b779a815b03974fece21728fe32e88d2...9f88a40e9fa1045f60ac5b6ca36de945562d6b65,3,4,0,4,1,2015-03-11 04:44:52,2015-03-11 04:44:52
9f88a40e9fa1045f60ac5b6ca36de945562d6b65...650e13f3cd68c9b45879a905548c34e9fb5bb46f,20,272,12,284,24,2015-03-12 04:05:50,2015-03-12 04:05:50
79af8057107214a385505d3b130c42d8e4a7a875...11c1756257368f3cd41702016c3303c0d22e3b59,12,138,30,168,43,2015-01-20 23:36:25,2015-01-20 23:25:19
11c1756257368f3cd41702016c3303c0d22e3b59...da0d4e4dea021c1fc10549cd5374d1baca2e4006,2,17,6,23,7,2015-01-21 01:31:32,2015-01-21 01:31:32
da0d4e4dea021c1fc10549cd5374d1baca2e4006...14ade5500f091cd3d4e3668631fac49b1a4c546d,1,6,3,9,4,2015-01-21 02:58:47,2015-01-21 02:58:47
14ade5500f091cd3d4e3668631fac49b1a4c546d...c6eabbbec5a9fec7a0d473fe67a544af3454c3d2,3,9,9,18,8,2015-01-21 03:57:37,2015-01-21 03:57:37
c6eabbbec5a9fec7a0d473fe67a544af3454c3d2...67d357191ff74b2cfc80015941363a97e7ee19fd,6,180,1,181,7,2015-01-22 14:07:16,2015-01-22 14:07:16
ee44664b2a14c0878f2e137dc4b6a1fbf4013eab...52700563bc35f7dcfdae7650a40d6249252b64d8,1,44,2,46,2,2015-02-02 12:28:10,2015-02-02 12:28:10
52700563bc35f7dcfdae7650a40d6249252b64d8...afa13bf868239191bf2ef95ff3b039729f4bd2e1,2,6,4,10,6,2015-02-03 09:51:21,2015-02-03 09:51:21
afa13bf868239191bf2ef95ff3b039729f4bd2e1...9171f71ff55def0f661a3d76e4ebcfc945092ad3,5,20,14,34,9,2015-02-11 11:11:14,2015-02-11 11:11:14
8347e008c2a23a7bab6b7847d02204c0cee54fb0...92f28a50286932b53b16db269aa518201b145b9d,1,2,2,4,1,2014-12-17 13:45:02,2014-12-17 13:45:02
823d7ae3b554100fc35c6223568452c8fa7adf11...ffe53061cdb38db19202b0218f6bda9a71fd411e,2,2,0,2,2,2015-01-13 16:28:18,2015-01-13 16:28:18
f97582b5e9f069176a4c9226c39a880f786dae67...6c4e1650fb8b7e06c8657ca1a5de167184fda6c0,1,4,1,5,1,2015-01-10 17:55:12,2015-01-10 17:55:12
6c4e1650fb8b7e06c8657ca1a5de167184fda6c0...5a4ef1c2cc400ff7fe67714435cadb070dc9cdd5,1,2,1,3,2,2015-01-17 19:05:26,2015-01-17 19:05:26
f97582b5e9f069176a4c9226c39a880f786dae67...75c3090e9f1160aceaf7ff2caedc250a4b22ec38,1,1,1,2,1,2015-01-10 14:50:27,2015-01-10 14:50:27
f97582b5e9f069176a4c9226c39a880f786dae67...5e3a4c13da5971b48ff8f0434165ea9da2084479,1,18,18,36,18,2015-01-10 14:11:44,2015-01-10 14:11:44
8cab401d08f8e25aa9b2dc710204785858ff3dbb...642c63319eb7471c9accc0c50dfffef5d72c0078,6,106,41,147,36,2014-09-15 23:06:37,2014-09-15 23:06:37
642c63319eb7471c9accc0c50dfffef5d72c0078...f00f4b9296a827ac1014cc2cc84b0dfbb4cac497,16,1114,69,1183,82,2014-09-17 00:19:54,2014-09-17 00:19:54
38971951f8c518aee01c3c2c1311d5ee8a5a841f...b479a2c8f0c9bd09617c1b925979a3708cab0525,1,1,1,2,1,2014-10-14 08:21:50,2014-10-14 08:21:50
d0ea4754057663d2caefbabe32421fd597a8a15d...c5f509f238576dba39ffcce74ab2066f24e67b58,26,3932,2,3934,29,2015-02-14 15:10:15,2015-02-14 15:09:52
c5f509f238576dba39ffcce74ab2066f24e67b58...a49802ae332e34542c0f835cce74fb3d5e49675a,1,62,52,114,10,2015-02-14 17:54:58,2015-02-14 17:54:58
a49802ae332e34542c0f835cce74fb3d5e49675a...d2f86cc09bf4136ebc1c2bbb8ec7b48a439c0371,7,44,4,48,12,2015-02-14 22:22:06,2015-02-14 22:22:06
d0ea4754057663d2caefbabe32421fd597a8a15d...9d182e93a3d75396405733109f9f086969c4b19b,9,339,223,562,175,2015-02-13 10:49:21,2015-02-13 10:49:21
9d182e93a3d75396405733109f9f086969c4b19b...8bb1e19d7355ac92ec5cfe39fbb6db73d6c0fffe,4,75,72,147,40,2015-02-13 20:43:50,2015-02-13 20:43:50
650e13f3cd68c9b45879a905548c34e9fb5bb46f...86eedaec217a0db2325753cf682992114f9943b0,1,1,1,2,1,2015-03-12 06:23:36,2015-03-12 06:23:36
67d357191ff74b2cfc80015941363a97e7ee19fd...13dc6f53cabe0f56f6530e104747d70927f62234,4,62,10,72,11,2015-02-10 06:36:16,2015-02-10 06:36:16
13dc6f53cabe0f56f6530e104747d70927f62234...6e54fa3d4755242f70e7ee21389bf679724eb4f2,1,1,1,2,1,2015-02-10 18:17:48,2015-02-10 18:17:48
6e54fa3d4755242f70e7ee21389bf679724eb4f2...84be16758e1816307a47f9cfacca40eea6446f6a,1,1,1,2,1,2015-02-10 21:23:49,2015-02-10 21:22:05
67d357191ff74b2cfc80015941363a97e7ee19fd...2c8cc632d2c04c88ae9a7fe28b2d99794c1abd56,1,2,2,4,1,2015-02-04 01:40:09,2015-02-03 20:21:31
67d357191ff74b2cfc80015941363a97e7ee19fd...8db3c0a4dbf32d498bd9dfd84eab7f4a18757fea,1,17,9,26,8,2015-02-01 17:23:31,2015-02-01 17:23:31
67d357191ff74b2cfc80015941363a97e7ee19fd...79e330c33ee04c04f5ce3e6f88cb767057184de2,1,1,1,2,1,2015-01-31 17:02:49,2015-01-31 17:02:49
67d357191ff74b2cfc80015941363a97e7ee19fd...8baa00a6e4b60eaef78fcfd34fe72725fd8ca060,1,11,17,28,4,2015-01-27 10:10:17,2015-01-27 10:10:17
67d357191ff74b2cfc80015941363a97e7ee19fd...73ca870c81145865d5a73c7aa95431c6792d5ec1,2,25,2,27,6,2015-01-27 09:01:37,2015-01-27 09:01:37
67d357191ff74b2cfc80015941363a97e7ee19fd...977b190a2d2f7b5bc252c10836114661702e001e,2,15,0,15,3,2015-01-25 00:14:06,2015-01-25 00:14:06
977b190a2d2f7b5bc252c10836114661702e001e...ce488e1f93b06a08815aefbec0fc57976bf42256,1,2,2,4,2,2015-01-26 23:51:13,2015-01-26 23:51:13
ce488e1f93b06a08815aefbec0fc57976bf42256...5e1e78b257ad89dde7cd9becdbaa5fdadca08e19,1,8,1,9,2,2015-01-27 00:00:07,2015-01-27 00:00:07
67d357191ff74b2cfc80015941363a97e7ee19fd...f9d63a7683a1c214c7d24809fef4d3d363cc61be,1,12,7,19,2,2015-01-23 10:27:53,2015-01-23 10:27:53
67d357191ff74b2cfc80015941363a97e7ee19fd...f7b00960dd89d88c8508c4fa56eb0688122da925,1,1,1,2,1,2015-01-22 21:19:45,2015-01-22 21:19:45
573ae5dd926df0dbd63b787945ace0fa76f08976...c613fb121b292d7abf601634b2db42c966f4a4ff,4,12,11,23,9,2015-02-11 11:40:50,2015-02-11 11:40:50
bed3b7f092881223f7b58c26e65d03b052e5313f...4ccdbde845437215dbb069b42231b4aebf06e327,1,1,1,2,2,2014-12-18 04:50:47,2014-12-18 04:50:47
bed3b7f092881223f7b58c26e65d03b052e5313f...9f5bbfc322640c33c4accde98ffaee92a7b62cab,4,98,28,126,13,2014-12-18 03:56:33,2014-12-18 03:56:33
9f5bbfc322640c33c4accde98ffaee92a7b62cab...cf0a419efae977eba3ed17437f0475a0d7a11bbe,3,245,0,245,2,2014-12-20 15:32:14,2014-12-20 15:32:14
bed3b7f092881223f7b58c26e65d03b052e5313f...4bf86bdd43108138251fbdf317a11150745e8c8e,1,45,12,57,1,2014-12-18 02:38:24,2014-12-18 02:38:24
4bf86bdd43108138251fbdf317a11150745e8c8e...f27282e0872e1c4bacbe34fc9ce9a0cd167f813d,1,11,8,19,5,2014-12-18 04:46:03,2014-12-18 04:46:03
f27282e0872e1c4bacbe34fc9ce9a0cd167f813d...b3d8a72be92bde888f6240147f704f45c6b394aa,1,4,7,11,5,2014-12-18 04:52:27,2014-12-18 04:52:27
bed3b7f092881223f7b58c26e65d03b052e5313f...1a6628f5a3d005d500d72e86222f1255a3276b5a,2,1,22,23,2,2014-12-17 20:57:39,2014-12-17 20:57:39
a327eee762e7f67b924b481a05268cacfbbed4ec...9012cd408e240d6039120e56fdd47a0983890993,14,823,39,862,66,2015-01-14 00:19:11,2015-01-14 00:19:11
d30f4e52f654a26e14223a6ef9a946cc6282c0db...fc4d6765f15b6d17bceb5a045ae075fa515d862b,1,2,2,4,2,2015-01-11 12:18:10,2015-01-11 12:18:10
d30f4e52f654a26e14223a6ef9a946cc6282c0db...9bbc3f0c94bfdbaceb507e4ccaf388950d84d8f0,3,24,6,30,6,2015-01-11 05:08:32,2015-01-11 05:08:32
d30f4e52f654a26e14223a6ef9a946cc6282c0db...bb6daaa02ede319dae34733221bdae8b4f999a99,1,1,1,2,1,2015-01-11 03:05:45,2015-01-11 03:04:57
94e35ef316caa0f713eef1c3823c8fa035508090...cd218b8c09482f9f9f2d15285d55ad955673697f,10,35,26,61,32,2014-10-14 22:44:41,2014-10-14 22:44:41
cd218b8c09482f9f9f2d15285d55ad955673697f...6e87c80e41857fe4f151cdeb8b9a7206c226bd8f,1,4,1,5,1,2014-10-15 02:38:10,2014-10-15 02:38:10
6e87c80e41857fe4f151cdeb8b9a7206c226bd8f...371eac9beffdfe416b8555ee006baf0ffae2bef3,16,86,6,92,44,2014-10-16 03:06:34,2014-10-16 03:06:34
7ebb224ec1d81ccd62b77f21f01f5267220aee09...2185c018f6593e6d64b2beb62202d2291e2e008e,13,729,206,935,136,2015-02-15 04:21:26,2015-02-15 04:19:46
5c3c730bad5591f4e3707c26f7c2038157c5c127...6a38ab1b43e4a107a28c52ba2036a4886794f625,4,28,24,52,17,2015-02-13 00:56:53,2015-02-13 00:56:53
b4e1c1d717c41b48e12f8712fb5d4bbf84732229...78a268c2eb3099103164407761e06afa0c6339d4,2,39,10,49,16,2015-02-11 10:57:51,2015-02-11 10:57:39
0d3b2ea1fdb27ef4b4a1ffb6cc411deecc9c3bf2...7cdd3c86c4661953e7d765d5a9cd2cc18d7ec27f,1,5,0,5,3,2015-03-14 02:40:58,2015-03-14 02:40:58
9783f6fc969947fdbf666950ab3da21ac462c57e...f7f197c40941ffaf03fcddeb20536dec8074ca00,23,351,44,395,78,2014-12-21 14:42:44,2014-12-21 14:42:44
04362defe7c5cb0d41164dcc533f0383a0edb98b...b0509bf8f0c437e4693d7f7e5dce99cec78ce15f,1,1,1,2,1,2015-01-02 03:22:24,2015-01-02 03:22:24
04362defe7c5cb0d41164dcc533f0383a0edb98b...f2843209a5439eb6bf8a6382e8c8ef378175c111,8,313,1,314,11,2014-12-19 12:44:34,2014-12-19 12:44:34
04362defe7c5cb0d41164dcc533f0383a0edb98b...64f77aa8f365e0be713a06d940f9a2ec912553e3,3,146,98,244,117,2014-12-19 09:13:20,2014-12-19 09:13:20
04362defe7c5cb0d41164dcc533f0383a0edb98b...0b7a5b84255a53138b3a092175de7b6b9f32b058,1,8,1,9,1,2014-12-19 05:08:48,2014-12-19 05:08:48
9012cd408e240d6039120e56fdd47a0983890993...b8828361849b32674c4048a1b74e109b09db97eb,1,4,3,7,3,2015-01-14 06:49:54,2015-01-14 06:49:54
336d9ce5d7c104c7828d620295ff977203b57c2d...66afddb3e8db03a675e744f74b07acc4db8f2aa1,20,583,196,779,65,2015-01-11 14:43:31,2015-01-11 14:43:31
66afddb3e8db03a675e744f74b07acc4db8f2aa1...f3dc51fc69ec3a16c6b2a6834ff0a6d933b1ddca,10,95,59,154,32,2015-01-11 23:52:42,2015-01-11 23:52:42
371eac9beffdfe416b8555ee006baf0ffae2bef3...26d399d9858e6cd7a2a28ab75352a2f18a72b11d,1,4,0,4,2,2014-10-23 10:04:21,2014-10-23 10:04:21
371eac9beffdfe416b8555ee006baf0ffae2bef3...3161ceda2f93477164bbb0b1cf4f8b660de2f818,1,1,4,5,4,2014-10-16 08:16:24,2014-10-16 08:15:47
2185c018f6593e6d64b2beb62202d2291e2e008e...2d4cec0cb637e4af2d8954e6ed10336552a627e9,1,2,2,4,1,2015-02-15 14:26:31,2015-02-15 14:26:31
2d4cec0cb637e4af2d8954e6ed10336552a627e9...4333aa240c68f22b235981bed56d11a592fdfd1d,2,56,2,58,5,2015-02-15 15:38:25,2015-02-15 15:38:25
51b8102f14ff521334d956f9ebeef7b6e873a957...1200689245aea59a1620145a3f85cc4bd76b561f,1,4,2,6,1,2015-03-15 14:43:13,2015-03-15 14:43:13
78e7777cf5ed721b4802066a769b5ecc0c530c3b...530d717a67cc3acab10270dca700db328aa12891,1,1,0,1,1,2014-12-21 15:12:59,2014-12-21 15:12:59
7dbc19f32db7b63062e715381923c873bf18683e...a36a774897ae191ebb90ba803bac7f919e92bd6c,23,396,233,629,127,2014-12-20 18:30:06,2014-12-20 18:30:06
7a5a4d135e127416c2a2fadcedc9bf5e7a13b37d...d722537154cd87dca134e7055aa2bfdc187eb1b0,3,40,2,42,4,2015-01-03 01:34:22,2015-01-03 01:34:22
d722537154cd87dca134e7055aa2bfdc187eb1b0...0df45672e7d985268de3040c24b86b4ac075a1d8,3,77,16,93,30,2015-01-03 03:23:14,2015-01-03 03:23:14
0df45672e7d985268de3040c24b86b4ac075a1d8...fa7a3ac0d329f7e3e7ade9cd530880af2da7b7dd,1,0,6,6,1,2015-01-03 03:25:21,2015-01-03 03:25:21
f3dc51fc69ec3a16c6b2a6834ff0a6d933b1ddca...544ce2a1dbaa5548490c975c2f6f6ed7c21377b9,11,115,7,122,37,2015-01-12 13:19:09,2015-01-12 13:19:09
544ce2a1dbaa5548490c975c2f6f6ed7c21377b9...30d36581100f0bf71c6d2502be9a03443bdf8708,11,81,35,116,45,2015-01-12 23:44:02,2015-01-12 23:44:02
f3dc51fc69ec3a16c6b2a6834ff0a6d933b1ddca...f9a4e6890bf5b21ae39c12f920e11005b07df9aa,4,46,0,46,5,2015-01-12 04:54:17,2015-01-12 04:54:17
f9a4e6890bf5b21ae39c12f920e11005b07df9aa...067a0d0e640e5c478715b55cd2f6fec39bf21326,1,3,0,3,1,2015-01-12 06:04:25,2015-01-12 06:04:25
067a0d0e640e5c478715b55cd2f6fec39bf21326...928e068f71afed015bdf6851dad7d4f57f827ef6,1,1,1,2,1,2015-01-13 04:54:23,2015-01-13 04:54:23
88d64e7735a9b1ba99b3b6a785b394bccda8ea2d...41d1f9b7d64300be0e9c75893f8c2c515b07529b,1,11,1,12,3,2014-10-24 14:33:43,2014-10-24 14:33:18
88d64e7735a9b1ba99b3b6a785b394bccda8ea2d...79664b42e927d73b64b9f09046d6f56aed1c609f,1,5,5,10,3,2014-10-24 11:57:46,2014-10-24 11:57:46
4333aa240c68f22b235981bed56d11a592fdfd1d...2478935f9654de9b516f61a43e1b0e0f0d97fb26,1,2,2,4,2,2015-02-15 18:09:11,2015-02-15 18:09:11
5b54361daf933e33d4b1545f14e2cebbd04d93ff...53e1694e1e2b76026d862e84c1de88f62601cbc3,22,238,50,288,76,2015-03-16 04:14:59,2015-03-16 03:47:37
53e1694e1e2b76026d862e84c1de88f62601cbc3...a969e2e6f17d6810771e9c9c31551d57e5d1efdb,13,500,25,525,59,2015-03-17 03:45:25,2015-03-17 03:45:25
a969e2e6f17d6810771e9c9c31551d57e5d1efdb...4cac1e0cb6406609b915797ca41ad125f9b3da08,2,28,0,28,3,2015-03-17 12:25:35,2015-03-17 12:25:35
4cac1e0cb6406609b915797ca41ad125f9b3da08...9dd0d8277d0c2336bbd61b1afff51a0ce6e11717,1,1,1,2,1,2015-03-19 00:03:11,2015-03-19 00:03:11
9dd0d8277d0c2336bbd61b1afff51a0ce6e11717...90a84b4ddb64f4adc024766435f3fc75605f9aab,1,297,50,347,29,2015-03-20 03:26:01,2015-03-20 03:26:01
90a84b4ddb64f4adc024766435f3fc75605f9aab...acc6f3b285f058104fd6431bed2c4cfe4dc05a58,11,64,9,73,27,2015-03-21 03:43:33,2015-03-21 03:43:33
acc6f3b285f058104fd6431bed2c4cfe4dc05a58...40496dd76ae53c93ef5ea7e56671682a7cae9def,4,4,0,4,1,2015-03-21 13:15:30,2015-03-21 13:15:30
530d717a67cc3acab10270dca700db328aa12891...0378e1109b8ff96a3583d7da02966ef3344ee35a,2,3,1,4,2,2015-01-02 15:52:51,2015-01-02 15:52:51
530d717a67cc3acab10270dca700db328aa12891...9ee218ac9ba464687a41eea59707187aea28c962,1,2,0,2,2,2015-01-02 11:31:25,2015-01-02 11:31:25
530d717a67cc3acab10270dca700db328aa12891...4faf47eb503931f3fd44d617aadca8f34cc0ae47,4,34,44,78,25,2014-12-28 22:37:25,2014-12-28 22:37:25
530d717a67cc3acab10270dca700db328aa12891...079f1b1642aa35fe20a927c777aa42f629e1fbaf,1,1,1,2,1,2014-12-28 13:34:37,2014-12-28 13:34:37
530d717a67cc3acab10270dca700db328aa12891...d128ec926369afca89155361c68249df17bdc278,3,29,4,33,4,2014-12-28 13:01:08,2014-12-28 13:01:08
530d717a67cc3acab10270dca700db328aa12891...645a0385687fc2deefdb47f73eb4415932987c42,1,22,2,24,2,2014-12-27 16:42:37,2014-12-27 16:42:37
530d717a67cc3acab10270dca700db328aa12891...61fcca71111a35fa1e3e812f99939beba94244e8,1,5,0,5,2,2014-12-27 16:29:12,2014-12-27 16:28:02
530d717a67cc3acab10270dca700db328aa12891...3108517406be86077f3f801736aa6a3c7d3fcca5,2,7,3,10,7,2014-12-25 05:05:57,2014-12-25 05:05:57
a36a774897ae191ebb90ba803bac7f919e92bd6c...8ff61b4d0e1ae6b37c5440389a144cf0f92b0786,1,3,1,4,3,2014-12-20 23:28:08,2014-12-20 23:28:08
fa7a3ac0d329f7e3e7ade9cd530880af2da7b7dd...c83a00c603c84eeac2188cae6b4986c3b86a05c6,2,11,8,19,8,2015-01-03 04:23:52,2015-01-03 04:23:52
fa7a3ac0d329f7e3e7ade9cd530880af2da7b7dd...60afd79a6e2354e0254c280d826bc6f12f68ffa1,3,58,4,62,10,2015-01-03 03:57:02,2015-01-03 03:57:02
30d36581100f0bf71c6d2502be9a03443bdf8708...2ef5a342e34df3863ac512bb3673eba28f15e9f4,19,191,37,228,60,2015-01-13 13:49:26,2015-01-13 13:49:26
30d36581100f0bf71c6d2502be9a03443bdf8708...3a0f665c90ea645eaf56397dd873e2b8f0bcc38a,1,1,1,2,1,2015-01-13 09:16:56,2015-01-13 09:16:56
b38118c5cb363c9aa07fa90bf246eee8edeff203...6532aa627cd6a4b1f590dcf1d91c03a3860ce889,9,11,11,22,9,2014-10-26 14:07:54,2014-10-26 14:07:54
b38118c5cb363c9aa07fa90bf246eee8edeff203...f1744c8c3106b43a48bb9ac314f1f51334b54fd9,1,11,3,14,6,2014-10-26 09:33:35,2014-10-26 09:33:22
d7ea20c1664a23bb8606bff85028c01f3b123fde...2bea642583efeb68886e71950384f297f2d7ee12,7,349,1,350,21,2015-02-16 17:45:11,2015-02-16 17:45:11
1d7337ba10ad593f0786d3e356cf0b05aa9be2b4...9229d9d1bbc3bb850839e022b8c8d37609839edd,1,8,3,11,1,2015-02-25 15:33:08,2015-02-25 15:33:08
1d7337ba10ad593f0786d3e356cf0b05aa9be2b4...2ac767b1f52f2d5d9d6b2dc00e8c3d065b9fc9bb,2,7,2,9,2,2015-02-21 21:57:12,2015-02-21 21:57:12
aeee764971048cfdd0b20c244c3509a1bcb21344...2e08e111205b3ffc7fc28f0cb80e857dd4bc9640,1,1,1,2,1,2015-01-02 16:08:28,2015-01-02 16:08:28
2e08e111205b3ffc7fc28f0cb80e857dd4bc9640...28daf19744423b989e0e2f04895554e3918b5920,1,21,11,32,4,2015-01-02 16:17:46,2015-01-02 16:17:46
28daf19744423b989e0e2f04895554e3918b5920...aa36be3c9a588bdceae9fbe3f19407522668a7de,1,1,1,2,1,2015-01-02 16:21:07,2015-01-02 16:21:07
aa36be3c9a588bdceae9fbe3f19407522668a7de...bbaddfa70f3c69d040f1f2b6edcbdb5ded9e1979,1,2,3,5,2,2015-01-02 16:30:59,2015-01-02 16:30:59
bbaddfa70f3c69d040f1f2b6edcbdb5ded9e1979...e0bcec4fb8c589a68fbf898458ca87502954f81e,1,13,1,14,1,2015-01-02 16:38:31,2015-01-02 16:38:31
e0bcec4fb8c589a68fbf898458ca87502954f81e...d88e192ae49dd8c30cf4f94f4a50e41b7d912c2d,1,11,1,12,5,2015-01-02 17:27:21,2015-01-02 17:27:21
d88e192ae49dd8c30cf4f94f4a50e41b7d912c2d...ed8e70243fb1a7e88c02a8f47c431fbcc641ec62,3,3,0,3,3,2015-01-02 17:32:05,2015-01-02 17:32:05
ed8e70243fb1a7e88c02a8f47c431fbcc641ec62...fbfb87ec4f4c27c051e281978dc2e9a7d75bf3ab,1,1,1,2,1,2015-01-02 17:34:57,2015-01-02 17:34:57
fbfb87ec4f4c27c051e281978dc2e9a7d75bf3ab...8a28af024e077cdc67a527ab70f19affcf0201b5,2,2739,2702,5441,296,2015-01-02 18:08:40,2015-01-02 18:08:40
8a28af024e077cdc67a527ab70f19affcf0201b5...2144648a3d9d7f23cf580a429af3f7bdc13f94e8,1,2,2,4,2,2015-01-02 18:53:02,2015-01-02 18:53:02
2144648a3d9d7f23cf580a429af3f7bdc13f94e8...58a67a1e0f412b3daf7f4905ad7d0ebb1dc0cf6b,1,1,1,2,1,2015-01-02 20:31:43,2015-01-02 20:31:43
eb1f978b1c1693018e9a6d353ca914f8e6586b4e...aa242beb73a1f6cf0bec2eb8dabd77b8f34f83bf,6,90,0,90,4,2015-01-13 13:17:51,2015-01-13 13:17:51
eb1f978b1c1693018e9a6d353ca914f8e6586b4e...fbdd925d9be1c4c96d05089d7d5a58cd938b002c,51,4385,1970,6355,541,2015-01-03 19:52:37,2015-01-03 19:52:37
60afd79a6e2354e0254c280d826bc6f12f68ffa1...cef3bd026fa6a6c1b2e19693b111210b3ce876ac,7,60,8,68,19,2015-01-03 14:06:53,2015-01-03 14:06:53
4e31faab4a4d1a7d0d8786a07ee1210fd89c4245...1317d20740470857308650095ac1fe50afd306e2,1,21,5,26,2,2014-10-27 21:26:31,2014-10-27 21:26:11
4e31faab4a4d1a7d0d8786a07ee1210fd89c4245...5f2222ee8932171fbd22ddcfdbda93e8143eb1cf,1,1,1,2,1,2014-10-27 08:58:12,2014-10-27 08:58:09
9608d4255eb6c76b1c4496f4494c829133e096f4...e82dc402052a47b44bb3bcf50ee4801257f92778,61,2148,339,2487,374,2014-10-28 01:54:32,2014-10-28 01:54:32
2bea642583efeb68886e71950384f297f2d7ee12...ef565b977852bbcd4eb6fc5ed31087422fea632c,1,1,1,2,1,2015-02-18 03:19:29,2015-02-18 03:19:29
e15157f289dde2839c8e19b7020455bb8c4753a2...320700fc92f48c4c9d01c69f36cad1affc58b535,1,54,9,63,9,2015-03-01 23:44:02,2015-03-01 23:44:02
440cc5e4b6af1720243cff19f3b8d805b82e9260...a0ee5cc3531786a652ee43d3a57cb69dff34bd70,1,7,5,12,2,2015-03-02 22:21:46,2015-03-02 22:21:19
ddf7457894abf4678727b8a751575fee3e0e55ac...0e1d70f637c31aa107f109a2e21ec9cd5e82d047,2,0,107,107,2,2015-01-03 19:55:07,2015-01-03 19:55:07
0e1d70f637c31aa107f109a2e21ec9cd5e82d047...dc7ac86b798f40e1472871391af49a562879eadc,13,35,35,70,25,2015-01-03 20:24:16,2015-01-03 20:24:16
dc7ac86b798f40e1472871391af49a562879eadc...f39473ae7adf11e16b2a7aae2f84764a3225752b,1,14,1,15,5,2015-01-04 02:27:11,2015-01-04 02:27:11
f39473ae7adf11e16b2a7aae2f84764a3225752b...a8bcb96ad4c940c93d3fd561ddd29ce38b529303,4,69,17,86,10,2015-01-04 14:03:31,2015-01-04 14:03:31
85c084c7707c4b9cac978bc0caec0a76b5e37818...6b5b95bb4e269a1bd740707e27eae09983b84268,9,141,37,178,17,2015-01-03 16:03:13,2015-01-03 16:03:13
6b5b95bb4e269a1bd740707e27eae09983b84268...ffd4b22e09e0da3c6e14b59c930747d35535726b,1,10,2,12,3,2015-01-03 16:10:00,2015-01-03 16:10:00
ffd4b22e09e0da3c6e14b59c930747d35535726b...167c1027bea5b208e5878c96682eb2bec6f59633,5,84,2,86,11,2015-01-03 18:39:01,2015-01-03 18:39:01
167c1027bea5b208e5878c96682eb2bec6f59633...507736690de2f4125aec25ecb0339196fb89ba56,1,0,2,2,1,2015-01-03 19:00:37,2015-01-03 19:00:37
e82dc402052a47b44bb3bcf50ee4801257f92778...8b8e26c0bdc1c0925eaa7e65dc2e98452393af17,1,5,2,7,3,2014-10-28 18:55:20,2014-10-28 18:55:12
63165d80d5bbd6ecbd8a47e8f526db169cbb8dc7...5ef3f7392faf0d2d9c136fc176f7a08cb774fe40,20,952,286,1238,165,2015-02-18 22:40:02,2015-02-18 22:39:44
5ef3f7392faf0d2d9c136fc176f7a08cb774fe40...cf75bf842ddda61d82bf492938a7b0849d2be718,2,39,1,40,11,2015-02-19 03:27:02,2015-02-19 03:27:02
0e732637d07d908daf64526f222e71fea402f3db...a1f715a4da71fbc2b7d6fad68624bf8b22c6da17,43,2583,268,2851,216,2015-03-02 03:54:43,2015-03-02 03:54:10
a8bcb96ad4c940c93d3fd561ddd29ce38b529303...8c4dd8de3919b789eac1a0f030563008bdcd44f5,5,25,1,26,6,2015-01-05 00:16:40,2015-01-05 00:16:40
8c4dd8de3919b789eac1a0f030563008bdcd44f5...1ff0d5c4e57538463081c774dc40a6f8323e6cb9,7,202,102,304,20,2015-01-05 01:39:21,2015-01-05 01:39:21
1ff0d5c4e57538463081c774dc40a6f8323e6cb9...b51f64571151cad5da8e5ed20ef52a8b0ffc3534,13,188,42,230,52,2015-01-05 21:37:12,2015-01-05 21:37:12
b51f64571151cad5da8e5ed20ef52a8b0ffc3534...f75ae815d51571287892d77414d45e15bfdb849b,3,63,2,65,5,2015-01-06 02:00:35,2015-01-06 02:00:35
f75ae815d51571287892d77414d45e15bfdb849b...bd0356207631602f35e2111bc73bca2bd53e91a1,3,22,2,24,3,2015-01-06 03:39:35,2015-01-06 03:39:35
a8bcb96ad4c940c93d3fd561ddd29ce38b529303...bd184adfebe0cc0aa2cdf2bedfb7b313b51fac02,1,2,2,4,2,2015-01-04 17:30:32,2015-01-04 17:30:32
bd184adfebe0cc0aa2cdf2bedfb7b313b51fac02...20142fed28ec478fec6901181ff20479075af579,1,1,1,2,1,2015-01-04 18:11:31,2015-01-04 18:11:31
cf75bf842ddda61d82bf492938a7b0849d2be718...c6a87d3a50582d294e0c468795145899213c8a8e,1,1,1,2,1,2015-02-19 16:15:13,2015-02-19 16:15:13
cf75bf842ddda61d82bf492938a7b0849d2be718...3fdf3d8eabf3ca8c756de52a4bb6aa302c1f454f,2,2,2,4,2,2015-02-19 14:54:03,2015-02-19 14:54:03
bd0356207631602f35e2111bc73bca2bd53e91a1...7a0e4c822caa0d91506f693cb0cea2188927939f,40,398,153,551,74,2015-01-07 04:45:46,2015-01-07 04:45:46
bd0356207631602f35e2111bc73bca2bd53e91a1...996d93f972b61640b71374dcf3585b948661a026,1,3,3,6,3,2015-01-06 14:31:41,2015-01-06 14:31:41
3fdf3d8eabf3ca8c756de52a4bb6aa302c1f454f...daeac73c543d4abfa49399a3abb03da42d77684d,1,5,2,7,2,2015-02-19 21:12:45,2015-02-19 21:12:45
978769cdf1e0f73ff8cef2efd08e5aee538d6e01...1659f82e7e178c5bd6ff2fe02b600669b427245e,2,5,2,7,3,2015-01-07 22:48:38,2015-01-07 22:48:38
1659f82e7e178c5bd6ff2fe02b600669b427245e...3f1dd9c57ff684e1d2441da43c6da8a19b507973,2,36,15,51,9,2015-01-07 23:29:05,2015-01-07 23:29:05
3f1dd9c57ff684e1d2441da43c6da8a19b507973...78f4b937034c8bc24c2a871b1fc08ecbe39d0e5e,11,295,49,344,67,2015-01-08 03:41:34,2015-01-08 03:41:34
6b106b319b0b4c9436a992bf26c88d93180905e9...d6d85a23c9061149c7996a3b434e6f9b25a81e49,1,2,0,2,2,2015-01-10 20:42:28,2015-01-10 20:42:28
d6d85a23c9061149c7996a3b434e6f9b25a81e49...7a41f8c604143eec16c232cffda122b095c5108f,4,193,2,195,11,2015-01-10 20:44:20,2015-01-10 20:44:20
7a41f8c604143eec16c232cffda122b095c5108f...6306254d37292fa2590799c1fdd08536326465d5,2,135,40,175,21,2015-02-01 18:42:36,2015-02-01 18:42:36
6306254d37292fa2590799c1fdd08536326465d5...af7c8bdf236b7c572bc33a44e3bb64fecdaa99d9,2,423,65,488,36,2015-02-01 20:18:38,2015-02-01 20:18:38
6b106b319b0b4c9436a992bf26c88d93180905e9...b260bfab636f6edffb3696830cc00314c6cb1bad,2,114,11,125,9,2015-01-07 11:46:01,2015-01-07 11:46:01
6b106b319b0b4c9436a992bf26c88d93180905e9...d8c14af546351a716b3e089b2573f4b81067b4c9,1,2,2,4,2,2015-01-06 18:46:47,2015-01-06 18:46:47
d8c14af546351a716b3e089b2573f4b81067b4c9...cf616e584586bb875bed5a817c531918233444c2,2,26,5,31,6,2015-01-06 22:28:25,2015-01-06 22:28:25
cf616e584586bb875bed5a817c531918233444c2...5d86f845d7a67ec9e2c71fe975e1abcbb1a97097,1,0,1,1,1,2015-01-07 03:35:52,2015-01-07 03:35:52
31e076d16affca682e956c966c0a8f9218a2b192...f4312a5076061862908c6df732157d452c2d37b8,6,72,2,74,14,2015-02-21 09:35:06,2015-02-21 09:35:06
78f4b937034c8bc24c2a871b1fc08ecbe39d0e5e...89970848311ee2d49040a148a56d80590091877c,35,653,7694,8347,91,2015-01-10 20:35:26,2015-01-10 20:35:26
78f4b937034c8bc24c2a871b1fc08ecbe39d0e5e...d046bd88ad84f99789fbc7e544e8c8b929f14faf,4,100,2,102,8,2015-01-08 07:26:27,2015-01-08 07:26:27
d046bd88ad84f99789fbc7e544e8c8b929f14faf...08cfad00ddf7990b16855c28ade237e79bd52afe,1,1,3,4,1,2015-01-08 15:01:10,2015-01-08 15:01:10
5c5519e2c896200652102d34cafde1315b3b9146...f1b9994cbcb682defb745e2d69503984324416be,1,0,2,2,1,2015-01-08 16:14:56,2015-01-08 16:14:56
