id,files,locs added,locs removed,locs total,hunks,commit time,author time
4b825dc642cb6eb9a060e54bf8d69288fbee4904...0c7f9cc2b14f9a5c68f7847f13a7708934fe16e5,1,12,0,12,1,2011-12-28 22:28:22,2011-12-28 22:28:22
0c7f9cc2b14f9a5c68f7847f13a7708934fe16e5...c46d39b0de9da0b66c7cbf18fcae08e363c417d7,4,388,0,388,4,2011-12-28 22:32:42,2011-12-28 22:32:42
c46d39b0de9da0b66c7cbf18fcae08e363c417d7...4bb8e70c891f5dfbacf6ea151eff891bb6699dae,1,17,0,17,1,2011-12-28 22:53:36,2011-12-28 22:53:36
4bb8e70c891f5dfbacf6ea151eff891bb6699dae...97b54756d0d3c7d6f7302a36fa3b1d1918b669a7,1,7,1,8,1,2011-12-28 23:08:38,2011-12-28 23:08:38
97b54756d0d3c7d6f7302a36fa3b1d1918b669a7...c1ff98590757c0bea73544f0a687043051ebfab6,1,2,0,2,1,2011-12-28 23:14:03,2011-12-28 23:14:03
c46d39b0de9da0b66c7cbf18fcae08e363c417d7...b15963042e6f6edcba36b737ecce97d532a8f527,1,13,0,13,1,2011-12-28 22:50:39,2011-12-28 22:50:39
b15963042e6f6edcba36b737ecce97d532a8f527...24e4056e7fd1baa3777129039903bc743c686514,4,24,57,81,9,2011-12-29 14:36:02,2011-12-29 14:36:02
24e4056e7fd1baa3777129039903bc743c686514...69ed89d2277d15372c40e628805bedb775dc9f4a,1,59,25,84,9,2011-12-29 17:49:46,2011-12-29 17:49:46
69ed89d2277d15372c40e628805bedb775dc9f4a...0b3555291be18d354a85f5f345012ff0d87cf240,1,52,32,84,21,2011-12-29 19:04:08,2011-12-29 19:04:08
0b3555291be18d354a85f5f345012ff0d87cf240...336f6c7704031b7230e98d8ff1eac1041ba0e283,2,19,38,57,16,2011-12-29 19:25:46,2011-12-29 19:25:46
336f6c7704031b7230e98d8ff1eac1041ba0e283...273393942fa67ec5af722384205e0adaf5608c23,1,68,24,92,13,2011-12-29 22:34:26,2011-12-29 22:34:26
273393942fa67ec5af722384205e0adaf5608c23...118f92e33cfd0ee25883c9a173926393cc84b329,1,4,3,7,3,2011-12-29 22:56:31,2011-12-29 22:56:17
118f92e33cfd0ee25883c9a173926393cc84b329...3a67355863a0f7df1cc3512248cb50ff315169d0,2,15,4,19,5,2011-12-30 13:01:16,2011-12-30 13:01:16
3a67355863a0f7df1cc3512248cb50ff315169d0...da7a27d44ed4e0e179c6d31e9b36a4cc97b688fb,3,314,39,353,32,2011-12-31 08:48:13,2011-12-31 08:48:13
da7a27d44ed4e0e179c6d31e9b36a4cc97b688fb...ec069e17320ae2549061f8f2583b134e7e96f208,2,13,15,28,5,2011-12-31 09:23:34,2011-12-31 09:23:34
ec069e17320ae2549061f8f2583b134e7e96f208...5ca2c6f510ed152d7ad568994ea824ec184e144d,1,13,2,15,3,2011-12-31 09:53:01,2011-12-31 09:53:01
5ca2c6f510ed152d7ad568994ea824ec184e144d...32a5c398573cf18c30cb26f8d6e1a506a58b6772,4,54,2,56,7,2011-12-31 12:41:50,2011-12-31 12:41:50
32a5c398573cf18c30cb26f8d6e1a506a58b6772...7e7c2b3688de6cc01998c3665c59b663f7cad744,1,11,0,11,1,2011-12-31 12:58:19,2011-12-31 12:58:19
7e7c2b3688de6cc01998c3665c59b663f7cad744...59ef63227f90ecefe84697090832516ff55d3f71,1,1,1,2,1,2011-12-31 12:59:34,2011-12-31 12:59:34
f919fe9b084ef7fdfe45b84e150fe67cfa4329c3...3f04c5e6c7d480ddbb709bd287ff9a0607b6aca1,1,2,2,4,1,2011-12-31 21:12:09,2011-12-31 21:12:09
53862c9f9a5d6b1ce37626e7e1cda1bcb71fc781...0ece4dbfb3bf08d90b1e3f6f9b0b0d32f3d18be0,1,3,1,4,1,2012-01-01 09:52:26,2012-01-01 09:52:26
0ece4dbfb3bf08d90b1e3f6f9b0b0d32f3d18be0...5fd27b3e21969727bdac425fd7c9e6c4136ebf77,1,26,0,26,2,2012-01-01 10:04:57,2012-01-01 10:04:57
5fd27b3e21969727bdac425fd7c9e6c4136ebf77...848f50ffa84525b81599af4bf442fc1e00e184de,1,4,1,5,4,2012-01-02 17:57:14,2012-01-02 17:57:14
5fd27b3e21969727bdac425fd7c9e6c4136ebf77...dc12069b40fc382acf127a35b9e1d9162fc527af,1,9,0,9,1,2012-01-02 08:04:57,2012-01-02 08:04:57
dc12069b40fc382acf127a35b9e1d9162fc527af...e4f31af4a6cfcbedf8738ce3c108162771362de6,1,4,0,4,1,2012-01-02 08:18:43,2012-01-02 08:18:43
e4f31af4a6cfcbedf8738ce3c108162771362de6...d6d78341b9819b6c1d13b40de4f031aeeecf442b,1,8,0,8,1,2012-01-02 10:08:57,2012-01-02 10:08:57
d6d78341b9819b6c1d13b40de4f031aeeecf442b...10905d882414c9876ce363a42364bd332851cb92,1,1,1,2,1,2012-01-02 10:22:19,2012-01-02 10:22:19
19029d2c1df7198906e806e12cd42dd63459845b...34568182ef64f9bdc1025f25835fbaae18f194c6,1,1,1,2,1,2012-01-02 20:37:20,2012-01-02 20:37:20
34568182ef64f9bdc1025f25835fbaae18f194c6...821cf549fc263905b63e21595fd6e86a39a6326c,2,55,2,57,5,2012-01-02 21:08:50,2012-01-02 21:08:50
821cf549fc263905b63e21595fd6e86a39a6326c...755edaf60c5908cc828fdd658b95688bc0b6f5e4,1,2,2,4,2,2012-01-02 21:39:09,2012-01-02 21:39:09
755edaf60c5908cc828fdd658b95688bc0b6f5e4...88cb10dbd1c7c883757aee4d49cecfa530c08365,1,50,7,57,11,2012-01-03 22:46:33,2012-01-03 22:46:33
88cb10dbd1c7c883757aee4d49cecfa530c08365...8953f37397cf89b3341401eea3d23de847471099,1,10,11,21,2,2012-01-03 23:04:23,2012-01-03 23:04:23
8953f37397cf89b3341401eea3d23de847471099...d0d67fe4357cefdce459816d7f55925cc6b0801d,1,42,9,51,6,2012-01-04 19:44:30,2012-01-04 19:44:30
d0d67fe4357cefdce459816d7f55925cc6b0801d...09a021ec38701ef15cb33c29ecf80dd4025eb7d4,1,3,0,3,1,2012-01-04 21:07:52,2012-01-04 21:07:52
09a021ec38701ef15cb33c29ecf80dd4025eb7d4...e7b8b9b26c2febea532f4e5a97cfdeb1c62e26e4,1,5,3,8,4,2012-01-04 21:42:11,2012-01-04 21:42:11
e7b8b9b26c2febea532f4e5a97cfdeb1c62e26e4...67eb225ee171dd08421db090a6ab5c319a389357,1,1,1,2,1,2012-01-04 21:49:06,2012-01-04 21:49:06
67eb225ee171dd08421db090a6ab5c319a389357...0edcf9021ece57d68f86e67188f2cb20c5bee473,2,13,7,20,7,2012-01-04 22:42:50,2012-01-04 22:42:50
0edcf9021ece57d68f86e67188f2cb20c5bee473...8e82782499996c374125ab15c7eead7632413b6e,1,1,1,2,1,2012-01-04 22:53:12,2012-01-04 22:53:12
8e82782499996c374125ab15c7eead7632413b6e...b12fbbe9f6810f335e983c317337d5a23bbe59d6,2,1,1,2,1,2012-01-08 19:57:37,2012-01-08 19:57:37
b12fbbe9f6810f335e983c317337d5a23bbe59d6...194a3ac53cee20784c381d342fd7303d6cfb4454,1,11,1,12,2,2012-01-08 20:03:41,2012-01-08 20:03:41
194a3ac53cee20784c381d342fd7303d6cfb4454...50b89cdf2906fef79ec9384a7313198a71ede63d,1,4,4,8,4,2012-01-08 20:13:23,2012-01-08 20:13:23
50b89cdf2906fef79ec9384a7313198a71ede63d...9c08178ad5aca2254007a0c2ea3c23204fedeff0,1,1,1,2,1,2012-01-08 20:17:25,2012-01-08 20:17:25
9c08178ad5aca2254007a0c2ea3c23204fedeff0...938550944a5cf60f5406522905ba8237ec117d74,1,1,1,2,1,2012-01-08 20:26:44,2012-01-08 20:26:44
938550944a5cf60f5406522905ba8237ec117d74...b83b7e6432b1f70e5f285be68a14b466d4f4e22d,1,2,0,2,1,2012-01-08 20:30:08,2012-01-08 20:30:08
b83b7e6432b1f70e5f285be68a14b466d4f4e22d...43b9137dfb5939c2a92bfcd7f094ea7b7c089317,1,1,0,1,1,2012-01-11 11:31:39,2012-01-11 11:31:39
ba1bba11d6ee40854ddddf13c63f58e93a6597dc...bf8a540e757b7f9d0c839e6d9315964c20fc449f,1,2,2,4,1,2012-01-12 16:20:25,2012-01-12 16:20:25
ba1bba11d6ee40854ddddf13c63f58e93a6597dc...a654a873ea56aa83a327048f3223eaa807631652,1,2,0,2,1,2012-01-12 11:22:18,2012-01-12 11:22:18
ba1bba11d6ee40854ddddf13c63f58e93a6597dc...11e5ddc77a7927305f20016cf507791050837aca,1,6,0,6,1,2012-01-12 11:08:21,2012-01-12 11:08:21
185ba4ea767102669a8d92be637510832c49c33c...3b5fd448b1abb9d019ea9f1a23689a01802f5963,1,3,3,6,3,2012-01-12 19:45:54,2012-01-12 19:45:54
3b5fd448b1abb9d019ea9f1a23689a01802f5963...65c456cb47fde46945e793e18c145541d624de3a,1,6,1,7,1,2012-01-12 19:47:42,2012-01-12 19:47:42
65c456cb47fde46945e793e18c145541d624de3a...c5b11276504422322a8da5f8a328a62461e73d19,1,8,0,8,1,2012-01-12 20:06:15,2012-01-12 20:06:15
c5b11276504422322a8da5f8a328a62461e73d19...8cd464a92660b311d9d40894f0b43b2ef191e0a1,1,3,1,4,2,2012-01-12 20:31:18,2012-01-12 20:31:18
8cd464a92660b311d9d40894f0b43b2ef191e0a1...995c47248878e1822f80df723a49b36f17741e87,1,7,15,22,7,2012-01-12 20:50:21,2012-01-12 20:50:21
995c47248878e1822f80df723a49b36f17741e87...27ff4e5818acd2c1b4619176ed3d92171ac3f513,1,13,4,17,5,2012-01-13 08:40:31,2012-01-13 08:40:31
27ff4e5818acd2c1b4619176ed3d92171ac3f513...345423cbc3cc762bf2c17f462b831248d17c0265,1,1,1,2,1,2012-01-13 08:41:10,2012-01-13 08:41:10
345423cbc3cc762bf2c17f462b831248d17c0265...85adb2df0842f32e5c4d89fba402318f554e94c3,1,2,0,2,1,2012-01-16 04:15:03,2012-01-16 04:15:03
345423cbc3cc762bf2c17f462b831248d17c0265...b8808e6ccfeb1b84e79bdf6011a20f953ae20d8b,1,2,0,2,1,2012-01-13 20:11:09,2012-01-13 20:11:09
714d72f20f62b96ab6485da2a1dd52c19383636e...77312163d87bf00a3357f484cef658d84a458c2b,1,1,1,2,1,2012-01-16 10:53:51,2012-01-16 10:53:51
77312163d87bf00a3357f484cef658d84a458c2b...3b61cd86214005c017beb11fbc6818d3a7dcdfc7,1,3,1,4,2,2012-01-16 20:53:07,2012-01-16 20:53:07
3b61cd86214005c017beb11fbc6818d3a7dcdfc7...b649b51f917694db8813bfa0fb8ff7ea9979edbe,1,2,0,2,1,2012-01-17 19:31:54,2012-01-17 19:31:54
6ada2acb1e3479afe08053b2f3688b129d23c078...d2ce96a1f34c84d9745b489129521054e3cdf6ea,1,0,6,6,1,2012-01-17 21:08:45,2012-01-17 21:08:45
d2ce96a1f34c84d9745b489129521054e3cdf6ea...da84694fdb4ddaecb7921f0479f274f2b01ca746,1,20,9,29,5,2012-01-17 21:32:30,2012-01-17 21:32:30
da84694fdb4ddaecb7921f0479f274f2b01ca746...5cc12cdca15de56e3a93c10d884cf9736dbacfc7,1,1,1,2,1,2012-01-17 21:34:22,2012-01-17 21:34:22
5cc12cdca15de56e3a93c10d884cf9736dbacfc7...5ea857e6c2c09783bbe91fa66c4caccd15557c32,1,153,0,153,12,2012-01-17 23:30:11,2012-01-17 23:30:11
5ea857e6c2c09783bbe91fa66c4caccd15557c32...5fc00a1cf637ea9e82f9d4bfc6d89b84addd6b3a,1,10,12,22,6,2012-01-18 11:26:16,2012-01-18 11:26:16
95fdbe2f378b9a9058ed327f77bca9ab99f65c30...2aa72e677486d0e30d0effc4e39a16e0cdff7485,1,2,0,2,1,2012-02-02 21:00:07,2012-02-02 21:00:07
5fc00a1cf637ea9e82f9d4bfc6d89b84addd6b3a...bb0113e5be76fabde364363e2e6a72784b641dfe,1,8,1,9,5,2012-01-20 15:06:23,2012-01-20 15:06:23
5fc00a1cf637ea9e82f9d4bfc6d89b84addd6b3a...4818cf4164bcde142b2a7de79c97a6c01b63373f,1,1,1,2,1,2012-01-18 23:11:18,2012-01-18 23:11:18
b34f71c931fadb60b7714299e4de56308560bc77...88a5996d4cd11b05c708d8bb4c82fcb468c1060a,1,2,0,2,1,2012-01-21 18:16:53,2012-01-21 18:16:53
88a5996d4cd11b05c708d8bb4c82fcb468c1060a...e96893311ed2ef247175f96110dd880779da403a,1,2,2,4,1,2012-01-24 07:34:16,2012-01-24 07:34:16
e96893311ed2ef247175f96110dd880779da403a...d8f70bdb15c4c685fd5cdfb28336b07ad7f69f98,1,1,0,1,1,2012-01-24 12:36:07,2012-01-24 12:36:07
cad76f55cf5b6ac7c9c24311e1a09239839abca6...e45cd32be64b196c2acfffea9e315d648be1d785,3,112,0,112,3,2012-02-16 10:22:07,2012-02-16 10:22:07
2e8389fdde982ebc514fbbdf029ae8dafc3d85a0...a6970d15fdaa56ad0335bc923bdfe803cbd88e25,2,106,0,106,24,2012-01-24 23:16:11,2012-01-24 22:37:45
a6970d15fdaa56ad0335bc923bdfe803cbd88e25...26034fc27776a1bc2b9c9bcbfbd11311f335a95c,1,2,0,2,1,2012-01-27 19:24:24,2012-01-27 19:24:24
a6970d15fdaa56ad0335bc923bdfe803cbd88e25...29e9e638070fa45c71959afc903228069b4e40a3,1,1,1,2,1,2012-01-25 15:35:03,2012-01-25 15:35:03
579b9638dddee5c72b03bdc9be72d1e3056283a0...9e8a65d4f32b608313ce747aee3ce82f68550115,1,5,2,7,2,2012-02-18 10:10:37,2012-02-18 10:10:37
1b6e668ab4e98b3782318afb3af977b82885787d...7d2d581f9b4d6db94cb729dc54f92a4c30e5945a,1,2,2,4,2,2012-01-28 13:39:55,2012-01-28 13:39:55
3fef9f9b6f429af46f49ffc07df9825f186dfdbe...3d9360cf846ca9a117c3cfa7302363809b5e5cf4,1,4,4,8,3,2012-01-30 19:02:53,2012-01-30 19:02:53
3d9360cf846ca9a117c3cfa7302363809b5e5cf4...4e8065277d84610afc1fc7dd45d8885b74a73a5f,1,2,0,2,1,2012-02-01 13:58:26,2012-02-01 13:58:26
3d9360cf846ca9a117c3cfa7302363809b5e5cf4...65fcaeed0a70a761405a63663ba3692c57988ec0,1,5,0,5,1,2012-01-30 19:05:56,2012-01-30 19:05:56
1e5038207db25b9b84a3dadaa82a755a4502ce8b...343299c63fc57b9ee2b5c0938ec0c223f3298821,1,4,0,4,1,2012-02-02 20:48:48,2012-02-02 20:48:48
343299c63fc57b9ee2b5c0938ec0c223f3298821...a62f419cb9f9e7eb30a735002c98390dafac595f,1,1,0,1,1,2012-02-02 20:51:38,2012-02-02 20:51:38
65fcaeed0a70a761405a63663ba3692c57988ec0...7b4393cfc95ff5dee41edf3353a16dc2e305df59,1,8,0,8,1,2012-02-02 19:43:02,2012-02-02 19:43:02
65fcaeed0a70a761405a63663ba3692c57988ec0...9641f5750ba9a8a46c2bf4e5f7cdec192cc39166,1,14,7,21,9,2012-01-30 19:35:47,2012-01-30 19:35:47
9641f5750ba9a8a46c2bf4e5f7cdec192cc39166...cfe6448594157e3c5ce2383525ce6f23f0a07bb3,2,226,186,412,34,2012-02-15 20:16:43,2012-02-01 20:28:55
cfe6448594157e3c5ce2383525ce6f23f0a07bb3...db5857afdafea7e7fd4f35be9c6155fa36c33956,1,18,0,18,1,2012-02-15 20:17:26,2012-02-15 19:39:45
db5857afdafea7e7fd4f35be9c6155fa36c33956...7c46679b39dc7a48d8f6f8aee3eb08e3ec400fa5,1,7,2,9,2,2012-02-15 20:17:26,2012-02-15 19:53:41
7c46679b39dc7a48d8f6f8aee3eb08e3ec400fa5...f248a39aabfe3aa42f676b0ae9cf4b0375a1c122,1,5,0,5,1,2012-02-15 20:17:26,2012-02-15 20:01:19
f248a39aabfe3aa42f676b0ae9cf4b0375a1c122...ff81a1305411ac269b1a494e320b87c4d7d558d2,1,22,0,22,1,2012-02-15 20:17:26,2012-02-15 20:10:56
ff81a1305411ac269b1a494e320b87c4d7d558d2...14a86ef9efcd234e2fd11704130254df07730db6,1,2,0,2,1,2012-02-15 20:17:27,2012-02-15 20:12:15
a62f419cb9f9e7eb30a735002c98390dafac595f...cf2cf67ab72434ceebac2ca3f4445b5448e5cb67,1,2,0,2,1,2012-02-07 22:15:30,2012-02-07 22:15:30
224c75b4636d26e02c005ea0c0b0cf17659a480a...9161a9afa9cc80c7d9a6abbff170d7b40c418f32,1,2,0,2,1,2012-02-15 20:28:54,2012-02-07 22:15:30
9161a9afa9cc80c7d9a6abbff170d7b40c418f32...c733c1ae3803bd9e1bb9e65e478af101256728a7,1,1,1,2,1,2012-02-15 20:28:54,2012-02-09 17:57:26
c733c1ae3803bd9e1bb9e65e478af101256728a7...9f1ff58480e82f143f54e5b746e1bdc4244f96f2,1,1,3,4,3,2012-02-15 20:28:54,2012-02-15 20:28:21
413d3d5b7865ab5e4030e5e9ebfc5d9edf04be59...54d2650d35469f6ff912e55fe99c702a9287e985,1,1,1,2,1,2012-02-09 17:57:26,2012-02-09 17:57:26
5a2e369117550757445f6e7e384e21f6aa4e3c93...2b22ee3b4b6231db476f7a02988dbde0d54d83f2,2,5,2,7,3,2012-02-15 20:46:00,2012-02-15 20:46:00
d518b8dfe3a6f512ec1146918b768a83972a45af...138cbab3ce397c5cad55f64d498786e173b1e62d,1,1,0,1,1,2012-02-14 14:19:15,2012-02-14 14:19:15
2b22ee3b4b6231db476f7a02988dbde0d54d83f2...59e1c483bc76354b81a50efb946a527493655c5a,2,3,0,3,2,2012-02-15 20:52:06,2012-02-15 20:52:06
59e1c483bc76354b81a50efb946a527493655c5a...a2f4337ec2004116b46892482de0149608d1e773,2,11,1,12,2,2012-02-15 22:56:03,2012-02-15 22:56:03
d43232fa90f127edbec202a83ee833782b7ab0ba...0a82172d25a6528719e1625174bfcf6dd8aa2166,1,1,0,1,1,2012-03-06 12:45:29,2012-03-06 12:45:29
0a82172d25a6528719e1625174bfcf6dd8aa2166...62350f407558ad1eeb2d48d39cd06b9b60c0daf4,1,1,1,2,1,2012-03-06 12:57:52,2012-03-06 12:57:52
62350f407558ad1eeb2d48d39cd06b9b60c0daf4...a6c2f37357ae9ab5b64922c8f136253c97b8690e,1,5,0,5,1,2012-03-06 19:00:57,2012-03-06 19:00:57
a6c2f37357ae9ab5b64922c8f136253c97b8690e...3fceded114eacc1576a64e7ebfbab6d4a891eb61,2,6,2,8,3,2012-03-06 20:01:21,2012-03-06 20:01:21
3fceded114eacc1576a64e7ebfbab6d4a891eb61...45fcf19c4d2c8096fbafe71de67e2c5279d4d70d,1,4,6,10,3,2012-03-06 20:11:08,2012-03-06 20:11:08
a2f4337ec2004116b46892482de0149608d1e773...957599ab20ee112462766578340b134613b1a21b,1,5,1,6,2,2012-02-16 10:05:56,2012-02-16 10:05:56
45fcf19c4d2c8096fbafe71de67e2c5279d4d70d...8a0b80d5ac65631d7e5b27b1714d12d1b7dd73ce,1,1,1,2,1,2012-03-07 21:38:37,2012-03-07 21:38:37
45fcf19c4d2c8096fbafe71de67e2c5279d4d70d...456817d3b59a9e800bcad292a5d74c2dc4d2f502,1,15,2,17,2,2012-03-06 20:43:38,2012-03-06 20:43:38
456817d3b59a9e800bcad292a5d74c2dc4d2f502...8eb5442e2f20bcfb962b50bf2401458af248defe,1,35,10,45,8,2012-03-06 21:38:03,2012-03-06 21:38:03
957599ab20ee112462766578340b134613b1a21b...c7ce6af1c811d92aa4bbc5958cf6877d7d2f7fa4,1,1,1,2,1,2012-02-16 10:27:25,2012-02-16 10:27:25
8a0b80d5ac65631d7e5b27b1714d12d1b7dd73ce...e1786e38e91ae445bb1caf968907292ec247f80c,1,11,2,13,2,2012-03-08 15:20:33,2012-03-08 15:20:33
e1786e38e91ae445bb1caf968907292ec247f80c...c382aeb71081138e461685d5e7edcaeca488c821,1,2,2,4,2,2012-03-08 19:20:10,2012-03-08 19:20:10
c382aeb71081138e461685d5e7edcaeca488c821...40acfb1a7299058fbc23ea43d0a81ca2abd9907c,1,1,1,2,1,2012-03-08 19:23:33,2012-03-08 19:23:33
74a309a8036e1054989500ab06b3452ee8a1558d...8321fa7861d32f980173a286b574a1954e954d11,1,1,1,2,1,2012-03-07 22:02:09,2012-03-07 22:02:09
8321fa7861d32f980173a286b574a1954e954d11...7a7d3e71199867009aed9e120e1e397ee35f6995,1,2,2,4,2,2012-03-07 22:51:10,2012-03-07 22:37:04
7a7d3e71199867009aed9e120e1e397ee35f6995...811e045c60ff32afb4b7f287a4b054cf089b94fe,1,6,3,9,3,2012-03-07 22:51:20,2012-03-07 22:50:29
c7ce6af1c811d92aa4bbc5958cf6877d7d2f7fa4...2324484152227791a12da562cd05014febd05c8e,1,5,1,6,1,2012-02-16 12:33:06,2012-02-16 12:33:06
efae004bc8f79e8a43d2b749161e14c2c19257fb...807943dadc266f57caea0eba6ae0e680c787b99c,1,10,1,11,2,2012-03-08 20:02:05,2012-03-08 20:02:05
807943dadc266f57caea0eba6ae0e680c787b99c...eb4df9c0ee6313d564bb63f76a80eb52ad2fa63c,1,18,6,24,3,2012-03-08 20:59:41,2012-03-08 20:59:41
eb4df9c0ee6313d564bb63f76a80eb52ad2fa63c...5ff03982a1e7e6d91152d4ec0ebde63f798535e1,1,28,17,45,9,2012-03-08 21:35:08,2012-03-08 21:35:08
5ff03982a1e7e6d91152d4ec0ebde63f798535e1...2131784feaf59a41437c6d9bf5d7a8ab55eeb177,1,18,8,26,8,2012-03-08 21:56:13,2012-03-08 21:56:13
2324484152227791a12da562cd05014febd05c8e...0ee071780aa22dffd25345338acaae9bbf271ed3,2,17,12,29,6,2012-02-18 21:49:34,2012-02-18 21:49:34
5ce8ff4b9673fb6813998b08b763d167257a16ff...6c72dab0f78e9ff0fcb9847268ec767c217b0cf6,1,0,4,4,1,2012-03-14 20:08:59,2012-03-14 20:08:59
2131784feaf59a41437c6d9bf5d7a8ab55eeb177...047c1c25a188e72ba01f9dee0699834cd3b4201b,2,1,0,1,1,2012-03-10 10:59:46,2012-03-10 10:59:46
047c1c25a188e72ba01f9dee0699834cd3b4201b...207c823a694816daf315e1172954ab5a539457b5,2,10,10,20,10,2012-03-10 11:20:20,2012-03-10 11:20:20
2131784feaf59a41437c6d9bf5d7a8ab55eeb177...fa12a75011822b53f50514cabbf692ddc476c9ad,1,2,0,2,1,2012-03-09 17:52:56,2012-03-09 17:52:56
0ee071780aa22dffd25345338acaae9bbf271ed3...36816e3b4288962a452dcc5a4f59df6b0e5257ef,2,16,4,20,3,2012-02-19 12:06:29,2012-02-19 12:06:29
69a69204e79555ed7d8ef321f95b43e5ab063f0d...5cb28b612ff80627f90e7373aa22a4166a0abcaa,1,9,0,9,1,2012-03-10 11:33:56,2012-03-10 11:33:56
36816e3b4288962a452dcc5a4f59df6b0e5257ef...aa451fcd6ad4e3b3aa0b4148b9ccabfe56d3100e,1,2,0,2,1,2012-02-29 22:05:50,2012-02-29 22:05:50
5cb28b612ff80627f90e7373aa22a4166a0abcaa...9d495abba78ed5504ba05a2cf05682a694d27a1f,3,52,32,84,19,2012-03-10 14:39:22,2012-03-10 14:39:22
9d495abba78ed5504ba05a2cf05682a694d27a1f...92181f58f0cbd2849445767d220279b296ef61fe,1,4,0,4,1,2012-03-10 14:45:16,2012-03-10 14:45:16
92181f58f0cbd2849445767d220279b296ef61fe...a20c50db258fbd3725b968da3343ead2af211196,1,25,22,47,16,2012-03-10 18:26:12,2012-03-10 18:26:12
a20c50db258fbd3725b968da3343ead2af211196...2b58f53708d39f1e3de78b831cd049a90890705e,1,13,10,23,10,2012-03-10 19:18:01,2012-03-10 19:18:01
2b58f53708d39f1e3de78b831cd049a90890705e...6314e2e15012c9db69f76e77a8bb1c437a7312b8,2,32,4,36,6,2012-03-10 19:55:40,2012-03-10 19:55:40
6314e2e15012c9db69f76e77a8bb1c437a7312b8...adb2fc498b6efa107e8b9473e065171135a446c6,1,12,0,12,1,2012-03-10 20:36:25,2012-03-10 20:36:25
6314e2e15012c9db69f76e77a8bb1c437a7312b8...2f677e1292605c21d867a91f987b1bfbb94df7da,2,6,1,7,2,2012-03-10 20:22:32,2012-03-10 20:22:32
adb2fc498b6efa107e8b9473e065171135a446c6...78f2ce657c9e04182cee8ad0db23b5f92dabc2c6,1,13,2,15,4,2012-03-11 09:10:36,2012-03-11 09:10:36
78f2ce657c9e04182cee8ad0db23b5f92dabc2c6...b59a4bf4d7cca990f913a18d4aedaf8b3598577e,2,11,1,12,2,2012-03-11 09:15:35,2012-03-11 09:15:35
e2a13e35d681b9dd13700a49306c00031ae7d038...1bbf205bc71b89b0f72a83ac6a1e7f5c4c0f46b1,1,76,19,95,11,2012-03-10 22:36:08,2012-03-10 22:36:08
1bbf205bc71b89b0f72a83ac6a1e7f5c4c0f46b1...b0a139ef81aaa73a5227b5ac47b6caf8f58d359d,1,20,21,41,7,2012-03-10 22:51:20,2012-03-10 22:51:20
b0a139ef81aaa73a5227b5ac47b6caf8f58d359d...b23506e885d33b53191dc0675c0a05585895a24a,2,28,20,48,7,2012-03-10 23:06:48,2012-03-10 23:06:48
b23506e885d33b53191dc0675c0a05585895a24a...5fd0f58fc6c89e556410d07a54997cabc48b2c14,1,4,3,7,3,2012-03-10 23:14:40,2012-03-10 23:11:56
5fd0f58fc6c89e556410d07a54997cabc48b2c14...abfa87dc9176114c869647bbaf504535b93ff5bc,1,10,0,10,1,2012-03-10 23:24:41,2012-03-10 23:24:41
7d39965743bc7cc2d2e4400fd646e8ec9defd77b...c5c3988c32c3382f92e9efee3350a0fba8854c03,1,0,5,5,1,2012-08-09 12:14:17,2012-08-09 12:14:17
c5c3988c32c3382f92e9efee3350a0fba8854c03...587a4539120ce47a5fdac032bfad979397753f43,1,1,1,2,1,2012-08-09 12:20:46,2012-08-09 12:20:46
587a4539120ce47a5fdac032bfad979397753f43...492b60e2c4488c7ed45e6a7c52f734efaa5a4f05,1,4,1,5,2,2012-08-10 08:59:14,2012-08-10 08:59:14
8220ab9393a9b135b6171d700e7c5f9167379420...70bc3b737b4db64c648873620b14ba77004150ba,2,160,141,301,31,2012-03-12 21:51:07,2012-03-12 21:51:07
70bc3b737b4db64c648873620b14ba77004150ba...a055e97a54ef1d3cdd4f1ff17463d73ca3296660,1,104,95,199,16,2012-03-12 22:29:45,2012-03-12 22:29:45
a055e97a54ef1d3cdd4f1ff17463d73ca3296660...e06cda174e58b6f678e321e0b23f827a51dfca0f,1,43,43,86,18,2012-03-12 22:48:33,2012-03-12 22:48:33
e06cda174e58b6f678e321e0b23f827a51dfca0f...c64d9fbf97650c439eaf18b3bd6f4eecbb3ba114,2,6,0,6,3,2012-03-12 22:57:58,2012-03-12 22:57:58
c64d9fbf97650c439eaf18b3bd6f4eecbb3ba114...b2ba0ee4214d0e6c943dddc7ef0dbd6b90199e3f,1,9,9,18,9,2012-03-12 23:43:59,2012-03-12 23:43:59
b2ba0ee4214d0e6c943dddc7ef0dbd6b90199e3f...c4d6ab3b8a93182a11dd0099afa3d129a5d21074,1,6,1,7,1,2012-03-12 23:48:55,2012-03-12 23:48:55
c4d6ab3b8a93182a11dd0099afa3d129a5d21074...1a21865ea693f5a59ea95a429731c833f525893d,3,13,12,25,12,2012-03-14 20:44:04,2012-03-14 20:44:04
1a21865ea693f5a59ea95a429731c833f525893d...9d99c03392eda04e35a50a18dad9a7e121dedcac,3,18,5,23,4,2012-03-14 22:06:57,2012-03-14 22:06:57
9d99c03392eda04e35a50a18dad9a7e121dedcac...b0c5644b475a09704ea010025b491fd9211122c3,3,21,14,35,11,2012-03-14 22:53:17,2012-03-14 22:53:17
b0c5644b475a09704ea010025b491fd9211122c3...b3d680eab461db09db537e9da26e601ce59b84ad,2,11,11,22,11,2012-03-18 20:15:46,2012-03-18 20:15:46
b3d680eab461db09db537e9da26e601ce59b84ad...fb32cf1bddfab230e9e3a9514070f4f1aff3241f,1,2,1,3,2,2012-03-19 20:21:01,2012-03-19 20:21:01
fb32cf1bddfab230e9e3a9514070f4f1aff3241f...9af7fe0f3e457bb7ed22ee19958d9a402e8266c8,1,3,10,13,4,2012-03-19 21:28:16,2012-03-19 21:28:16
9af7fe0f3e457bb7ed22ee19958d9a402e8266c8...10b14ba7681d7ff1e0f6a8097ae80750180967c2,1,37,1,38,4,2012-03-20 21:28:43,2012-03-20 21:28:43
10b14ba7681d7ff1e0f6a8097ae80750180967c2...88662339a96563cba0b7e10884f8e42bb92081c5,2,10,4,14,3,2012-03-20 21:37:08,2012-03-20 21:37:08
363e4a1a70b3e366e005650c9087169a0737ddb5...5f5985b9c055f4b2bdc872ce5d744caf0b4af721,1,0,0,0,0,2013-06-03 16:16:03,2013-06-03 16:16:03
5f5985b9c055f4b2bdc872ce5d744caf0b4af721...35f67e80f0f3172d9eacbe6f7d52ebb08e79822d,1,0,0,0,0,2013-06-03 16:17:39,2013-06-03 16:17:39
35f67e80f0f3172d9eacbe6f7d52ebb08e79822d...35071aeb712c46a621320a35a2d889328673a684,1,2,0,2,1,2013-07-19 07:03:32,2013-07-19 07:03:32
88662339a96563cba0b7e10884f8e42bb92081c5...2a9e9b859c40a3d6b4fcbb8b36670b4bc74427a4,1,4,0,4,1,2012-03-20 21:56:01,2012-03-20 21:56:01
2a9e9b859c40a3d6b4fcbb8b36670b4bc74427a4...c7f5771211b4f400ef8ae92204246a2537f24139,1,2,2,4,1,2012-03-21 08:05:18,2012-03-21 08:05:18
c7f5771211b4f400ef8ae92204246a2537f24139...d3ce5a87359459060696ce6cbcb7a80f1813b535,2,10,1,11,2,2012-03-21 08:13:35,2012-03-21 08:13:35
d3ce5a87359459060696ce6cbcb7a80f1813b535...de6c37949fecfa4b06bbac7bc9f3aed90cae9b3b,2,2,1,3,2,2012-03-28 18:14:00,2012-03-28 18:14:00
de6c37949fecfa4b06bbac7bc9f3aed90cae9b3b...c87d7dff487137ca62681d66a3667f2862302997,1,203,41,244,78,2012-03-31 19:44:15,2012-03-31 19:44:15
c87d7dff487137ca62681d66a3667f2862302997...9e6b22dccc920a69c3fa82d61378340d172576d4,2,7,2,9,2,2012-03-31 19:46:42,2012-03-31 19:46:42
9e6b22dccc920a69c3fa82d61378340d172576d4...84e5d62349289a303de3e785d50adccf23190ef7,1,1,1,2,1,2012-03-31 19:49:52,2012-03-31 19:49:52
84e5d62349289a303de3e785d50adccf23190ef7...8949aae00ea126151332749d44836f543ed5ff66,2,4,1,5,2,2012-04-04 18:23:23,2012-04-04 18:23:23
8949aae00ea126151332749d44836f543ed5ff66...2da949ea1893494ede1e2cbf807608273d02f191,1,42,50,92,9,2012-04-04 19:39:30,2012-04-04 19:39:30
2da949ea1893494ede1e2cbf807608273d02f191...edff5a08c1903960e0550377a07bde9684774654,2,13,4,17,4,2012-04-04 21:32:17,2012-04-04 21:32:17
edff5a08c1903960e0550377a07bde9684774654...24cef7f5057c4d2dedbd5f60640c64da09181d02,1,365,158,523,49,2012-04-07 07:39:19,2012-03-28 22:03:28
24cef7f5057c4d2dedbd5f60640c64da09181d02...028a298341942ef6d928aa34ba226e41b4ae0f19,1,11,11,22,7,2012-04-20 21:45:36,2012-04-20 21:45:36
028a298341942ef6d928aa34ba226e41b4ae0f19...9ccb39dc8edb605e68c671494ec34163d9759cdf,1,3,34,37,3,2012-05-05 11:59:32,2012-05-05 11:59:32
9ccb39dc8edb605e68c671494ec34163d9759cdf...996287a1940629611a61d9bb7d37d7b3a3a2fca7,1,18,0,18,1,2012-09-29 01:09:48,2012-09-29 01:09:48
996287a1940629611a61d9bb7d37d7b3a3a2fca7...d9acb3da1b22941b65cf84f963fedf96fae9e497,1,1,1,2,1,2012-09-29 01:16:53,2012-09-29 01:16:53
9ccb39dc8edb605e68c671494ec34163d9759cdf...a021851e40d58ab3a85cdf5e8085c10ffe51aa85,1,5,0,5,1,2012-09-08 14:58:19,2012-09-08 14:58:19
562532949f4e63f3625f98910b01eecee0146995...7a6e73d03b2a46444ea0c827ec793107bfcf7bf3,1,1,1,2,1,2012-11-26 12:54:33,2012-11-26 12:54:33
ab44798b081997319f4207dabbb052736acfc512...c6856a6b2da033e7ba3f1ec221dcf7549c5cfc66,1,4,4,8,4,2013-01-12 17:24:55,2013-01-12 17:24:55
c6856a6b2da033e7ba3f1ec221dcf7549c5cfc66...1fe4041f0527e996c4cb6157a10d819b34ff7697,1,63,63,126,60,2013-01-12 17:25:39,2013-01-12 17:25:39
08f569060ad57423ee6b01a4612146414d1c577d...950bc935e6c08890930cc8432b3609ec72144374,1,1,1,2,1,2013-05-14 14:14:21,2013-05-14 14:14:21
08f569060ad57423ee6b01a4612146414d1c577d...f0c9da4ca83b5f6050adbe321dedfefffa335127,1,1,1,2,1,2013-03-25 03:04:09,2013-03-25 03:04:09
610543c8395f89648c026eec27215e000462a66d...2ba9c7cb56cf463f20a364bdbe9f4075eafffa94,1,6,0,6,1,2013-06-03 16:28:39,2013-06-03 16:28:39
a99229e9bc5dbdc8418d4b55f2a8609dc6779adf...f984ecb047ff84738c02b098319164929eb4c4ed,1,49,42,91,3,2013-03-26 17:14:02,2013-03-26 17:14:02
f984ecb047ff84738c02b098319164929eb4c4ed...080b1dbb560188accc022879a3a9ede2f13c0a76,1,1,0,1,1,2013-03-28 10:00:30,2013-03-28 10:00:30
2ba9c7cb56cf463f20a364bdbe9f4075eafffa94...a793605e9a1b3ae843af5c8c34864acd7baab48d,1,1,1,2,1,2013-06-27 09:24:04,2013-06-27 09:24:04
080b1dbb560188accc022879a3a9ede2f13c0a76...082d543d8fa564d7f5a917cda83ba3a461b46cfa,1,1,1,2,1,2013-04-10 04:55:50,2013-04-10 04:55:50
c033daf3379ddac46d232abe9bc886e269a93dda...b408fbdfaa418e50f086ebd07707bfc2af6737e7,1,0,6,6,1,2013-07-01 18:27:16,2013-07-01 18:27:16
ab090aeced919438c981b7fd97b84c7394c703a0...8e11d72f40a3ca9b39d23066393e6c4f485b1543,1,1,1,2,1,2013-05-08 10:22:35,2013-05-08 10:22:35
b408fbdfaa418e50f086ebd07707bfc2af6737e7...ba289c10b902f871c6af30e03924f7f6527a57c3,1,5,5,10,3,2014-04-04 15:33:50,2014-04-04 15:33:50
b408fbdfaa418e50f086ebd07707bfc2af6737e7...6cde43b0569e8198a8313641f80f3c3857e2fe4d,1,1,1,2,1,2013-07-26 14:34:43,2013-07-26 14:34:43
54eb33b6196a17c02cb8b51d4a4b649191a537f7...714194aadf8ce3fe01adad08744416ffcb472f0a,1,0,0,0,0,2013-07-31 14:46:29,2013-07-31 14:46:29
2b8a4bce1cd7ae02611fcb35ea98bea1c134a44e...3662f9bfa2754e44f165124ef34e59113a38a899,1,1,1,2,1,2013-08-11 02:39:59,2013-08-11 02:39:59
c4f511bacfaffe2f1ec62932deaaa6f6143ef2fb...2801ed37eefa5be6c9c29246032831fd26cc23d0,1,2,2,4,2,2014-01-25 20:14:12,2014-01-25 20:14:12
d505df4e4ed20f91b589893cba306fe693ab17d3...be1aaf18b1660affbb2d97b128900118d4ab5503,1,1,1,2,1,2014-06-25 08:12:34,2014-06-25 08:12:34
a57e83f0b79d474caeb12e6f517d0cf5c9f95655...d33aad069b1cfbf43208c3ccf71d02b8dc3a2018,1,1,1,2,1,2014-08-18 13:10:41,2014-08-18 13:10:41
9be1713880e231cb021beb7844e430e3955fd07d...e36939744ac351dd4643d3b7360213bcce34275f,1,1,1,2,1,2014-08-19 19:46:05,2014-08-19 19:46:05
9d4cc1072be5a8eed55f0889445cddd0555cb378...d3838d1aaabf0da32fb70594ee3cafae9925208f,1,2,2,4,2,2014-09-30 18:45:09,2014-09-30 18:45:09
6c8a8d4974b4a4298167bd2ce104a271d4413a4e...bc9968b1641684307a415e54667f216a30803207,1,1,2,3,1,2014-09-30 23:09:40,2014-09-30 23:09:40
e2d1eb90bf12a1be02079d74545453164d7e7ec4...1dc53d67e3bc98a093c7992aee0e6cf0ecf22350,1,1,1,2,1,2015-01-16 04:22:53,2015-01-16 04:22:53
c3d214ab6c3f2c87858d5d9585a06426511d4d71...822ef33f795ceab48ffc97c8363cccd70e912ee3,1,1,1,2,1,2015-03-10 14:07:54,2015-03-10 14:07:54
