id,files,locs added,locs removed,locs total,hunks,commit time,author time
4b825dc642cb6eb9a060e54bf8d69288fbee4904...d69c2d1f198ab08a26a2b3bad07ccfa6f31d37da,108,26401,0,26401,107,2011-11-18 02:35:20,2011-11-18 02:35:20
d69c2d1f198ab08a26a2b3bad07ccfa6f31d37da...052ebbe035dc36d289f75301309ead3f1042a02e,1,4,3,7,2,2011-11-18 04:09:46,2011-11-18 04:09:46
052ebbe035dc36d289f75301309ead3f1042a02e...36f1a7cadd116dd8fd1e50d011371294d4e6cd13,1,1,1,2,1,2011-11-18 04:11:37,2011-11-18 04:11:37
36f1a7cadd116dd8fd1e50d011371294d4e6cd13...7bd74d1b1f831435abab89dbafc517593f4a0c13,3,4,4,8,3,2011-11-18 08:26:23,2011-11-18 08:26:23
7bd74d1b1f831435abab89dbafc517593f4a0c13...f57add24a6e0dd18d47d891b2172469fceef93a2,1,1,1,2,1,2011-11-18 23:11:15,2011-11-18 23:11:15
f57add24a6e0dd18d47d891b2172469fceef93a2...1a824caa8ece2645353ea213bc141e7b56ea6a44,1,8,5,13,5,2011-11-18 23:30:29,2011-11-18 23:30:29
1a824caa8ece2645353ea213bc141e7b56ea6a44...ec8eccfc651fe890aeea39165fae15e9c10c72c9,2,793,0,793,2,2011-11-18 23:59:51,2011-11-18 23:59:51
ec8eccfc651fe890aeea39165fae15e9c10c72c9...4a47e39ac56717a0b2d07d4129907ecacc6047ba,1,5,2,7,1,2011-11-22 01:12:51,2011-11-22 01:12:51
4a47e39ac56717a0b2d07d4129907ecacc6047ba...a46c7f38c60d5df53ff08e57721e1a1775e48735,3,4,4,8,3,2011-11-22 01:15:45,2011-11-22 01:15:45
a46c7f38c60d5df53ff08e57721e1a1775e48735...dc59c44942e10fe4bfe43599b7cdcde580a421fc,1,22,20,42,5,2011-11-24 23:18:22,2011-11-24 23:17:58
dc59c44942e10fe4bfe43599b7cdcde580a421fc...760e6d5a9bb9fcd55ffe93a0de3d4c27c4837256,1,3,3,6,2,2011-11-24 23:25:57,2011-11-24 23:25:57
760e6d5a9bb9fcd55ffe93a0de3d4c27c4837256...f58e659095001df919bc6e6802a4ae1ebdd70616,2,13,32,45,9,2011-11-26 07:47:32,2011-11-26 07:47:32
f58e659095001df919bc6e6802a4ae1ebdd70616...c814e34df8916cd1d53503a1635450bda217dead,1,1,1,2,1,2011-11-26 07:59:57,2011-11-26 07:59:57
c814e34df8916cd1d53503a1635450bda217dead...1f18d2802b57b8f4259c9cefaca8c56fb8569fca,1,1,1,2,1,2011-11-26 08:41:40,2011-11-26 08:41:40
1f18d2802b57b8f4259c9cefaca8c56fb8569fca...012abe536d9550e3a5c17efe967746ebe4d6b2b1,2,7,3,10,4,2011-11-26 10:11:44,2011-11-26 10:11:44
012abe536d9550e3a5c17efe967746ebe4d6b2b1...d2c3f52d9df0d6c49c9e250e3864818241a4b800,1,9,31,40,4,2011-11-26 11:22:04,2011-11-26 11:22:04
d2c3f52d9df0d6c49c9e250e3864818241a4b800...08f9e60d71d828bab8e316baf4e541051d7487da,1,1,18,19,5,2011-11-26 11:46:05,2011-11-26 11:33:32
08f9e60d71d828bab8e316baf4e541051d7487da...89b4263ec178a1713b90aeb984c8978b75c903c0,5,109,146,255,40,2011-11-27 06:49:42,2011-11-27 06:49:42
89b4263ec178a1713b90aeb984c8978b75c903c0...598337d5058dd6923b0bf617bee44cfbef594c60,1,17,48,65,10,2011-11-27 07:19:50,2011-11-27 07:19:50
598337d5058dd6923b0bf617bee44cfbef594c60...7a299369b8ca00901e7ad5976fbfdb1fa583f513,3,4,4,8,3,2011-11-28 09:35:34,2011-11-28 09:35:34
7a299369b8ca00901e7ad5976fbfdb1fa583f513...a13ca9e2ccc6042d2b1f3a86a34dccd451ca8a24,3,4,4,8,3,2011-11-28 09:53:30,2011-11-28 09:53:30
a13ca9e2ccc6042d2b1f3a86a34dccd451ca8a24...61ba3fdf36a634a4c3ed809d9d976cd116757587,1,2,2,4,3,2011-11-28 21:56:41,2011-11-28 21:56:41
61ba3fdf36a634a4c3ed809d9d976cd116757587...bf61c47a0f341ec6d568f3e53d511c345a9703af,3,4,4,8,3,2011-11-28 21:58:21,2011-11-28 21:58:21
bf61c47a0f341ec6d568f3e53d511c345a9703af...a6b172e0aac24b05b252afa1fc7f3a97d0c8895b,1,31,30,61,8,2011-11-29 04:44:46,2011-11-27 09:54:06
a6b172e0aac24b05b252afa1fc7f3a97d0c8895b...f3ee05ac06926dd4dc7b66427b7167f70ba2f00b,1,5,3,8,3,2011-11-29 04:44:46,2011-11-29 04:15:10
f3ee05ac06926dd4dc7b66427b7167f70ba2f00b...4f245840d7cb5aaf20f10e9622a0093151b53d21,1,0,3,3,1,2011-11-29 06:27:16,2011-11-29 06:27:02
4f245840d7cb5aaf20f10e9622a0093151b53d21...3a61d00268c474bb07e315877ff0c278a17f726d,1,3,3,6,2,2011-11-29 06:27:16,2011-11-29 06:27:10
3a61d00268c474bb07e315877ff0c278a17f726d...948388a430218312c4de4d6bb833deb1a1880b18,1,2,0,2,1,2011-11-29 08:21:28,2011-11-29 08:20:34
948388a430218312c4de4d6bb833deb1a1880b18...a277dcdf26ed0c3d3c174a2556caecdf191dd1be,1,1,1,2,1,2011-11-29 17:51:19,2011-11-29 17:50:26
a277dcdf26ed0c3d3c174a2556caecdf191dd1be...63aa9ac5c72abdca0e9bd8bebe35d8d4260aaf84,1,1,1,2,1,2011-11-30 02:11:25,2011-11-30 01:42:37
63aa9ac5c72abdca0e9bd8bebe35d8d4260aaf84...1df7d900498439ec6bb60b69a8db81d8bb822342,1,9,4,13,1,2011-11-30 02:11:25,2011-11-30 02:11:00
1df7d900498439ec6bb60b69a8db81d8bb822342...9be7026cb7d8a9b8e63bd5d4cf50a237142fe507,1,1,1,2,1,2011-11-30 04:52:52,2011-11-30 04:52:52
1df7d900498439ec6bb60b69a8db81d8bb822342...ceef60fad8546e07591c231010bc9be1ca817a77,3,4,4,8,3,2011-11-30 03:06:24,2011-11-30 03:06:24
ceef60fad8546e07591c231010bc9be1ca817a77...3dc9e037d164a50c9bfbebd7f9abee671409e8d9,1,2,1,3,2,2011-11-30 04:03:06,2011-11-30 04:03:06
eed2c3288e7c7f0e4ae11ad28d19c8e45de8f3bb...0cbc9650fbaf2e31fefcf4970306a7c6ec1d5765,3,4,4,8,3,2011-11-30 05:26:27,2011-11-30 05:26:27
0cbc9650fbaf2e31fefcf4970306a7c6ec1d5765...f57b6e1bd67c2fdffa991839f8a08b6265f4a9d3,2,4,2,6,2,2011-11-30 06:18:51,2011-11-30 06:18:51
f57b6e1bd67c2fdffa991839f8a08b6265f4a9d3...cfbb309272b4921bfe0c808ebdee6ff5ddc32133,1,1,1,2,1,2011-12-01 19:31:25,2011-12-01 19:31:25
cfbb309272b4921bfe0c808ebdee6ff5ddc32133...555a448e2a566f26cc7bb4504dd6ba91376f3c6b,6,59,33,92,15,2011-12-01 19:47:12,2011-12-01 19:46:56
555a448e2a566f26cc7bb4504dd6ba91376f3c6b...aaa47bbc342d28eafe6e83c3607e4fe4011d5483,2,2,16,18,3,2011-12-01 22:19:46,2011-12-01 22:19:46
aaa47bbc342d28eafe6e83c3607e4fe4011d5483...a02f7a0137abcc49b68f59f9030796c5e94202e3,3,4,4,8,3,2011-12-01 23:54:34,2011-12-01 23:54:34
a02f7a0137abcc49b68f59f9030796c5e94202e3...1d4f97de34422c51cbb5651e3d403f8a151507ca,1,8,3,11,1,2011-12-02 05:29:33,2011-12-02 05:29:33
1d4f97de34422c51cbb5651e3d403f8a151507ca...e81b908fc79aae7fc7a964f6fb276b101f6b5ffe,1,47,37,84,2,2011-12-03 02:44:51,2011-12-03 02:44:39
e81b908fc79aae7fc7a964f6fb276b101f6b5ffe...2966e9a0312403b13628e9e61a5f802625e35f55,1,8,4,12,2,2011-12-04 18:48:21,2011-12-04 18:47:52
2966e9a0312403b13628e9e61a5f802625e35f55...01f2de7a9ea7be19ee2574d3d2a9eb50e736376a,1,1,1,2,1,2011-12-04 20:22:42,2011-12-04 20:22:42
01f2de7a9ea7be19ee2574d3d2a9eb50e736376a...d75c9666666a8ffc2bccc3ea842c8de4651f5a39,1,6,4,10,3,2011-12-06 04:22:52,2011-12-06 04:22:52
d75c9666666a8ffc2bccc3ea842c8de4651f5a39...8438e0783a82f588e155da68185ad2be3cf3c918,1,18,4,22,6,2011-12-06 04:43:25,2011-12-06 04:43:25
8438e0783a82f588e155da68185ad2be3cf3c918...91a4a46ea1d687de1f929e3b9f0bae9c2db0c83d,1,53,52,105,4,2011-12-06 04:43:59,2011-12-06 04:43:59
91a4a46ea1d687de1f929e3b9f0bae9c2db0c83d...59ab61227a16d62237dfe96d4e929b0f0d3387a7,1,0,5,5,1,2011-12-07 00:25:13,2011-12-07 00:24:49
91a4a46ea1d687de1f929e3b9f0bae9c2db0c83d...65ee4902a77755a4037a6357ad7e375da3299002,1,11,12,23,6,2011-12-06 07:37:35,2011-12-06 07:37:35
65ee4902a77755a4037a6357ad7e375da3299002...7fc593034f90aa15558ab7c5c46160749ac0cf2f,1,2,0,2,1,2011-12-06 07:38:06,2011-12-06 07:38:06
7fc593034f90aa15558ab7c5c46160749ac0cf2f...b3c83c994a37a94f7bc3bd67b25f5da50cd1b4aa,1,10,10,20,4,2011-12-06 07:38:37,2011-12-06 07:38:37
b3c83c994a37a94f7bc3bd67b25f5da50cd1b4aa...b81ae24ec517534c34639d3ccc3017dfd247cfbe,2,2,2,4,2,2011-12-06 07:38:58,2011-12-06 07:38:58
59ab61227a16d62237dfe96d4e929b0f0d3387a7...81854bc6e2b58f1afee0e997e2534c4dba6322d6,1,0,7,7,1,2011-12-07 20:19:48,2011-12-07 01:57:14
81854bc6e2b58f1afee0e997e2534c4dba6322d6...71494cf7e4c2d635f9523eab2903b98cf99a5737,1,5,4,9,5,2011-12-07 20:24:53,2011-12-07 20:24:53
71494cf7e4c2d635f9523eab2903b98cf99a5737...08ec11e2e7067c1c8efa63d416590d99fa697d6e,8,248,259,507,11,2011-12-07 21:03:11,2011-12-07 20:26:03
3db7ddf199c679d4d2519cb512808be800e617ba...282346ee11997e6b3d9d62cfa49ccb2a4352760c,3,24,1,25,7,2011-12-07 06:46:40,2011-12-07 06:46:40
282346ee11997e6b3d9d62cfa49ccb2a4352760c...999d40af9acc9ebb0183afd87afaa300a4e1759d,1,52,1,53,2,2011-12-07 09:52:32,2011-12-07 09:52:32
5e289848a4993b5f283a79af5782b65b912fbca6...4dd06152f5354fc2f70ac58530959e68751e2539,1,94,0,94,1,2011-12-08 22:14:22,2011-12-08 22:14:22
5e289848a4993b5f283a79af5782b65b912fbca6...63092aabc4067a505ae1c1269e03f7a2b67b68c0,2,23,4,27,8,2011-12-08 03:01:54,2011-12-08 03:01:54
63092aabc4067a505ae1c1269e03f7a2b67b68c0...fb5b13af334a5449b33389889c7c33c2c96ba119,1,6,6,12,6,2011-12-08 03:20:25,2011-12-08 03:20:25
fb5b13af334a5449b33389889c7c33c2c96ba119...f421d1a816d3af5212dbf51aa51936b8db8cc0af,2,22,13,35,9,2011-12-08 04:28:28,2011-12-08 04:11:26
f421d1a816d3af5212dbf51aa51936b8db8cc0af...0218ed3d5f181ce6e22d8f172d5b5e3bf599c578,1,4,11,15,3,2011-12-08 04:28:28,2011-12-08 04:27:23
0218ed3d5f181ce6e22d8f172d5b5e3bf599c578...42ee79e25babb50af479c282ad8986d0a33dd56c,2,28,25,53,17,2011-12-08 04:44:01,2011-12-08 04:44:01
42ee79e25babb50af479c282ad8986d0a33dd56c...60ee70a6c0ed6c4f473e7751587b67a22f70bfb0,1,3,5,8,5,2011-12-08 04:48:48,2011-12-08 04:48:48
60ee70a6c0ed6c4f473e7751587b67a22f70bfb0...02ad969c8ae1ef1e7b2973b67b8cc9fa16c27330,2,4,24,28,2,2011-12-08 04:55:00,2011-12-08 04:55:00
02ad969c8ae1ef1e7b2973b67b8cc9fa16c27330...8963588b64e45694e4da2f7591d72a9763e2b258,4,5,486,491,8,2011-12-08 05:09:25,2011-12-08 05:09:25
8963588b64e45694e4da2f7591d72a9763e2b258...0599d5198c8c28e4199d3ee2e5d087afdf88357e,45,2394,0,2394,39,2011-12-08 05:22:47,2011-12-08 05:22:47
0599d5198c8c28e4199d3ee2e5d087afdf88357e...260d572afe62a2e0777ff1c027917e25c91d7ff8,1,9,4,13,4,2011-12-08 06:27:23,2011-12-08 06:27:23
260d572afe62a2e0777ff1c027917e25c91d7ff8...ce565dcaea8e193f0e0168272f910ad591603d7d,14,110,323,433,28,2011-12-08 06:28:43,2011-12-08 06:28:43
ce565dcaea8e193f0e0168272f910ad591603d7d...4eff685f55cdf750cb4bd6d33d34563da25c3de3,1,39,21,60,7,2011-12-08 06:53:00,2011-12-08 06:53:00
78cf74b5453808e13f5b43b575d21050f23c9ec1...1c36361a0bcd2ef7aef49bd596c49eab02e7fffe,1,1,2,3,1,2011-12-08 22:27:52,2011-12-08 22:27:52
1c36361a0bcd2ef7aef49bd596c49eab02e7fffe...65f4bdbb3af443be2bb3b34745adb8e575fbdf95,1,91,100,191,15,2011-12-09 00:12:13,2011-12-09 00:12:13
65f4bdbb3af443be2bb3b34745adb8e575fbdf95...24692a60f5bc32d61b54e12db91ab698d1440dfb,12,23,55,78,16,2011-12-09 00:28:47,2011-12-09 00:25:22
24692a60f5bc32d61b54e12db91ab698d1440dfb...92b0be6e5f07149138123684b0b9a34d4fcad398,5,5,6,11,5,2011-12-09 00:34:59,2011-12-09 00:34:59
92b0be6e5f07149138123684b0b9a34d4fcad398...77b31a20060247f95442cfbfc0f0fce2f170b362,2,4,2,6,3,2011-12-09 04:17:16,2011-12-09 04:17:16
77b31a20060247f95442cfbfc0f0fce2f170b362...008768b21b2a0de359a570b52787edb91f7d3404,6,23,14,37,7,2011-12-09 04:19:46,2011-12-09 04:19:46
008768b21b2a0de359a570b52787edb91f7d3404...9a67524673e4a539c2de053d06aa107cba0b9a29,5,48,15,63,5,2011-12-09 05:39:45,2011-12-09 05:39:45
9a67524673e4a539c2de053d06aa107cba0b9a29...133250884091936123d984bfb020813accf78d20,1,0,30,30,4,2011-12-09 06:01:48,2011-12-09 06:01:48
133250884091936123d984bfb020813accf78d20...16e9adb25c1eb5443b0da1324ccc2e846a951977,2,5,2,7,3,2011-12-09 07:14:56,2011-12-08 22:10:59
16e9adb25c1eb5443b0da1324ccc2e846a951977...4c0adda3502402e8cd68805b889cc102f7a24a02,1,78,1,79,2,2011-12-09 07:14:56,2011-12-09 00:20:33
4c0adda3502402e8cd68805b889cc102f7a24a02...6314dd7509a10b88820f264791f16483904f29d8,1,19,15,34,4,2011-12-09 07:14:56,2011-12-09 00:20:43
6314dd7509a10b88820f264791f16483904f29d8...49ac3514eebcbd8b7c55a1eafe3d180ade4832e7,1,3,2,5,2,2011-12-09 07:14:56,2011-12-09 01:21:17
49ac3514eebcbd8b7c55a1eafe3d180ade4832e7...bfe5d34aa4ee8698f83f1a5829edf61e74ed57be,1,85,71,156,13,2011-12-09 07:14:56,2011-12-09 01:38:41
bfe5d34aa4ee8698f83f1a5829edf61e74ed57be...3da54e9d07fcb61874da1cc5aa3a8a79dc162bc7,2,100,51,151,15,2011-12-09 07:14:56,2011-12-09 05:18:53
3da54e9d07fcb61874da1cc5aa3a8a79dc162bc7...23993ef88ef83dac88aab927ad782b70f1a33b9f,1,9,0,9,3,2011-12-09 07:14:56,2011-12-09 06:37:10
23993ef88ef83dac88aab927ad782b70f1a33b9f...feb11debf62bbb01a5599e6c6be1e7c5607fd2db,1,23,5,28,6,2011-12-09 07:14:56,2011-12-09 06:59:29
feb11debf62bbb01a5599e6c6be1e7c5607fd2db...5293001ff5642ebec6b8261576e21254a68d971f,1,5,2,7,2,2011-12-09 07:14:56,2011-12-09 07:06:27
5293001ff5642ebec6b8261576e21254a68d971f...8b985ec67b085eef9bebd978252db1ea47e65890,2,20,28,48,4,2011-12-09 07:14:56,2011-12-09 07:10:45
8b985ec67b085eef9bebd978252db1ea47e65890...db91d57ef46bdf477434eced566b4149b0759462,1,0,2,2,1,2011-12-09 07:20:45,2011-12-09 07:20:45
a0203c652c0c1f7e4e037a49c51c7e5af85b0941...3f2c867fffac2e3eb6d5fb1bc7820f4a24a720d0,1,3,0,3,1,2011-12-09 18:37:03,2011-12-09 18:37:03
3f2c867fffac2e3eb6d5fb1bc7820f4a24a720d0...8543df96491807e422b9f9f37009c71086efbcbc,1,1,1,2,1,2011-12-09 21:14:01,2011-12-09 21:13:12
8543df96491807e422b9f9f37009c71086efbcbc...56b9273680c67d30e9f67415a14ae33c45c6a99d,1,8,3,11,2,2011-12-09 21:42:58,2011-12-09 21:42:58
56b9273680c67d30e9f67415a14ae33c45c6a99d...c6e4c46b148590650869a632079a5a7d617c72d4,1,7,0,7,1,2011-12-10 00:39:11,2011-12-10 00:38:31
c6e4c46b148590650869a632079a5a7d617c72d4...584f62e2547418a6ea0912718de6449b0cb7c648,3,4,4,8,3,2011-12-10 00:47:52,2011-12-10 00:47:52
584f62e2547418a6ea0912718de6449b0cb7c648...3ec06f7381f47a7b66bbb2be2ae58ce4902fb758,1,13,14,27,3,2011-12-10 04:45:11,2011-12-10 04:29:47
3ec06f7381f47a7b66bbb2be2ae58ce4902fb758...d73a647bdd7d14386b7440c99c929043d840f2e4,2,47,41,88,8,2011-12-10 07:15:14,2011-12-10 07:15:14
d73a647bdd7d14386b7440c99c929043d840f2e4...5d172d0deda41e1a28c596e59e937ab97136ef62,2,3,5,8,5,2011-12-10 07:37:50,2011-12-10 07:37:50
5d172d0deda41e1a28c596e59e937ab97136ef62...f46d94c6cd5c038651c74cae098d79292afc68e5,2,234,218,452,28,2011-12-15 02:47:31,2011-12-15 00:56:47
5d172d0deda41e1a28c596e59e937ab97136ef62...46effaa9b31deb074d442fbca627d6e7d00a4ac2,5,69,24,93,14,2011-12-13 04:56:12,2011-12-13 04:56:12
46effaa9b31deb074d442fbca627d6e7d00a4ac2...918d15afdc9911920330d2bae4daca4b306a0522,3,80,46,126,10,2011-12-13 21:40:13,2011-12-13 21:40:13
918d15afdc9911920330d2bae4daca4b306a0522...f549efd952ab34ce55a1846996ccb7a5171b411a,1,286,279,565,20,2011-12-13 22:31:25,2011-12-13 22:31:25
a01fb670e58a67321ab1a5bfa47f0fbe39f18d2b...61dad1ad50b9856cb15ee86b52fdd5491f271831,1,52,36,88,11,2011-12-15 07:41:13,2011-12-15 07:34:04
61dad1ad50b9856cb15ee86b52fdd5491f271831...81c03785a03c55dd8c926931dc1bb193fa9a6d7b,1,19,13,32,11,2011-12-15 08:07:23,2011-12-15 08:07:23
81c03785a03c55dd8c926931dc1bb193fa9a6d7b...60c7ac32eb189277d9fea3d1e1e529ed48028fcd,1,20,8,28,7,2011-12-15 22:13:04,2011-12-15 22:13:04
e03e1d716e1ddb50a8825b6b129b92492586ced1...b3d3d7276d4142722f39c4a2e7e0468886180747,1,1922,1637,3559,537,2011-12-15 01:58:49,2011-12-15 01:57:01
f549efd952ab34ce55a1846996ccb7a5171b411a...1bda75a20311ee14ca08f0992a9fa94a7ebcdb94,1,51,5,56,5,2011-12-14 05:55:46,2011-12-14 05:55:28
1bda75a20311ee14ca08f0992a9fa94a7ebcdb94...3787999ce8b7a05ce5e43cb00075ad3240f2e09a,1,92,23,115,17,2011-12-15 01:45:35,2011-12-15 01:45:35
3787999ce8b7a05ce5e43cb00075ad3240f2e09a...916a1147fcca6af4c6632a6f2803a67ee6d4b949,1,45,25,70,10,2011-12-15 03:33:10,2011-12-15 03:33:10
916a1147fcca6af4c6632a6f2803a67ee6d4b949...2c24b1edf043d886e4b1124c4c9ce12cfcc570c8,1,9,7,16,3,2011-12-15 04:42:13,2011-12-15 04:42:13
2c24b1edf043d886e4b1124c4c9ce12cfcc570c8...1e956fcfe79b697cfa4f5f4034371febf8a81bcf,1,11,1,12,1,2011-12-15 05:41:13,2011-12-15 05:41:13
1e956fcfe79b697cfa4f5f4034371febf8a81bcf...1801b33cf71a7d0a71aa289ce5fb9fccff5d1a12,2,28,7,35,7,2011-12-16 00:48:03,2011-12-16 00:48:03
1801b33cf71a7d0a71aa289ce5fb9fccff5d1a12...cc603754688d20d970fba16069950df642ab6858,2,61,12,73,9,2011-12-16 04:36:41,2011-12-16 04:36:41
10be9ed3d00735ba182d1834bc17fc5cd15fab35...7e7d3013c722b05ee49dfa03bdcf1c6a07dbbef6,1,46,36,82,9,2011-12-16 00:18:52,2011-12-16 00:18:52
9fbf4c7b6be919bcaa7a72b42cba63b44d228065...60abb2090c57cb8338877c88b2c68e6fe1cc51d4,1,14,5,19,7,2011-12-16 07:59:57,2011-12-16 07:59:57
60abb2090c57cb8338877c88b2c68e6fe1cc51d4...1cfad0500e8b1441aa1108ab5f3d35cfd53eb944,1,1,1,2,1,2011-12-17 01:41:25,2011-12-17 01:41:25
1cfad0500e8b1441aa1108ab5f3d35cfd53eb944...74c42ccf4e3358e6af455b5a586c963ec0c32e53,1,10,3,13,4,2011-12-20 00:38:21,2011-12-20 00:38:21
74c42ccf4e3358e6af455b5a586c963ec0c32e53...e57b93a1b8acb9319969fc3819b4564ac399fc7a,2,37,2,39,4,2011-12-20 00:39:28,2011-12-13 10:40:40
e57b93a1b8acb9319969fc3819b4564ac399fc7a...c13415b818e2a83328c8890694698fd89a67384c,2,26,10,36,10,2011-12-20 00:39:28,2011-12-14 05:52:30
c13415b818e2a83328c8890694698fd89a67384c...3666cff408c6ca1e9f1b0cd5bde394be721f6a19,5,143,196,339,31,2011-12-20 00:39:28,2011-12-14 09:41:11
3666cff408c6ca1e9f1b0cd5bde394be721f6a19...349d18df0c7c8b583528ae1ffdd479ad27bea278,1,15,8,23,6,2011-12-20 00:39:28,2011-12-14 21:31:58
349d18df0c7c8b583528ae1ffdd479ad27bea278...8503c55453c7fee16bd7e85d0e51705bd5eb5102,2,22,41,63,14,2011-12-20 00:39:28,2011-12-14 21:43:45
8503c55453c7fee16bd7e85d0e51705bd5eb5102...d38efe63456f67b4e24fb5d94b3939dbdcd321ed,1,9,11,20,3,2011-12-20 00:53:14,2011-12-20 00:53:14
c2f988ac2cd0c70891183c9e6f2d04ebd843ec50...7dbe566121cbaac20b0ed2f24d622f065e0b0512,2,19,2,21,3,2011-12-20 01:54:18,2011-12-13 01:36:54
7dbe566121cbaac20b0ed2f24d622f065e0b0512...f925a52fde350aeafa0a8e966eae649a799bc3b0,1,4,4,8,3,2011-12-20 23:15:17,2011-12-20 23:15:17
f925a52fde350aeafa0a8e966eae649a799bc3b0...b06c391df4cc7f17423693ac3324cbb2e4d8ce88,1,7,3,10,5,2011-12-20 23:28:06,2011-12-20 23:28:06
b06c391df4cc7f17423693ac3324cbb2e4d8ce88...1d056815e8060aafb009b43be52a633c019b1269,2,3,1,4,2,2011-12-20 23:37:24,2011-12-20 23:37:24
1d056815e8060aafb009b43be52a633c019b1269...0edcc2e77aa6c61973387cff5f5e1c7f82fc1e9f,1,1,1,2,1,2011-12-21 00:04:38,2011-12-21 00:04:38
0edcc2e77aa6c61973387cff5f5e1c7f82fc1e9f...212cdd8b5c77afd669f2dda99ec4954c8d837378,1,2,2,4,2,2011-12-21 01:12:06,2011-12-21 01:12:06
212cdd8b5c77afd669f2dda99ec4954c8d837378...e2fb49da71cba3462830513d777dcfe7ec362fd8,1,2,1,3,1,2011-12-21 02:52:02,2011-12-21 02:52:02
e2fb49da71cba3462830513d777dcfe7ec362fd8...9ee5fe47025b81fb12b17b0110bf1b2d7f03e05d,3,4,4,8,3,2011-12-21 21:11:54,2011-12-21 21:11:54
9ee5fe47025b81fb12b17b0110bf1b2d7f03e05d...f7a737af6a2e31f0d855c6b713f864bf07409ace,2,2,4,6,2,2011-12-23 02:25:04,2011-12-23 02:18:11
f7a737af6a2e31f0d855c6b713f864bf07409ace...cdf96b22c275e393d11a2ef446e065361fde7860,1,2,4,6,4,2011-12-23 02:25:04,2011-12-23 02:24:41
c2f988ac2cd0c70891183c9e6f2d04ebd843ec50...7cfdfcf0b978db762826acc6ea764e5d9c44638c,4,147,109,256,19,2011-12-20 01:03:26,2011-12-15 02:13:21
7cfdfcf0b978db762826acc6ea764e5d9c44638c...3e29700c821aff98a845adb3ce769a757d1f19d7,3,22,13,35,8,2011-12-20 01:03:26,2011-12-15 03:36:02
3e29700c821aff98a845adb3ce769a757d1f19d7...fabfa902bf61aac68d7ebf5c4317abfb1253b659,4,138,169,307,33,2011-12-20 01:03:26,2011-12-15 09:09:23
fabfa902bf61aac68d7ebf5c4317abfb1253b659...0f397a2a08ccfbac0d95664d1805fa2ffb9deef2,1,22,18,40,12,2011-12-20 01:03:26,2011-12-15 09:18:59
0f397a2a08ccfbac0d95664d1805fa2ffb9deef2...f0df8212eecf107e8a8f73b515957dce7fb0c200,3,52,91,143,18,2011-12-20 01:03:26,2011-12-15 10:15:20
f0df8212eecf107e8a8f73b515957dce7fb0c200...d052ca4b204cb6479f59a03e5cdcb47cd6cc40f9,2,10,4,14,7,2011-12-20 01:03:26,2011-12-16 09:25:50
d052ca4b204cb6479f59a03e5cdcb47cd6cc40f9...eb146494f7371b1feed68263a92dfc12e959069f,1,4,0,4,1,2011-12-20 01:03:26,2011-12-16 09:25:55
eb146494f7371b1feed68263a92dfc12e959069f...1cb5ddb65c9c7a8dadcb7b4003f51d9a445d8c79,1,136,0,136,1,2011-12-20 01:03:26,2011-12-16 09:26:15
1cb5ddb65c9c7a8dadcb7b4003f51d9a445d8c79...c7595000a19c204bf50f555f804a35bd36c801c8,1,65,42,107,20,2011-12-20 01:03:26,2011-12-16 12:36:26
c7595000a19c204bf50f555f804a35bd36c801c8...4a1db0db0617ff80db901461845cf421db93a00a,3,117,140,257,21,2011-12-20 01:03:26,2011-12-16 12:38:36
4a1db0db0617ff80db901461845cf421db93a00a...31bc5517466975b4a88970c18c028dc3ac07bacf,2,236,175,411,5,2011-12-20 01:03:26,2011-12-17 03:01:57
31bc5517466975b4a88970c18c028dc3ac07bacf...0399108751899758b0c6df42e192179a767268d0,1,2,0,2,1,2011-12-20 01:03:26,2011-12-17 03:22:09
0399108751899758b0c6df42e192179a767268d0...4c3206031b8434cac88f1ea155dcbc7b449b67c8,2,29,26,55,20,2011-12-20 01:03:26,2011-12-17 03:48:42
4c3206031b8434cac88f1ea155dcbc7b449b67c8...2ab81838fd91d751fd707aa9b34b24fc90f6a857,6,247,3,250,8,2011-12-20 01:03:26,2011-12-17 04:55:55
2ab81838fd91d751fd707aa9b34b24fc90f6a857...6a9b4f58d08d4fc39bb76a6fa95f18d314228662,1,21,0,21,1,2011-12-20 01:03:27,2011-12-20 00:37:08
6a9b4f58d08d4fc39bb76a6fa95f18d314228662...fefaa5fc09baac0cdb80b3e8f9fdc4d08c1f7b7c,2,271,49,320,39,2011-12-20 09:30:03,2011-12-20 09:30:03
fefaa5fc09baac0cdb80b3e8f9fdc4d08c1f7b7c...74ec9c37719c68c0bd21f60154cc3efefa701d27,3,27,4,31,4,2011-12-20 11:09:20,2011-12-20 10:47:03
74ec9c37719c68c0bd21f60154cc3efefa701d27...73d5cb4c5f8be1e343461775457f5804d17e4546,1,9,7,16,3,2011-12-20 11:23:36,2011-12-20 11:11:07
73d5cb4c5f8be1e343461775457f5804d17e4546...e31fde7109a2e86baf2c25d595fcd0b89a2a12af,3,40,45,85,11,2011-12-20 11:23:48,2011-12-20 11:23:48
e31fde7109a2e86baf2c25d595fcd0b89a2a12af...ef614a16199ecbc1d001a3f8632234743ec5360c,1,5,4,9,4,2011-12-20 11:45:23,2011-12-20 11:45:23
ef614a16199ecbc1d001a3f8632234743ec5360c...ef1233d4fb427a60eb13a9b7552751b8101152fc,2,5,5,10,5,2012-01-11 23:06:26,2012-01-11 23:06:26
ef1233d4fb427a60eb13a9b7552751b8101152fc...0d72c2b6b21c61e1d5253ddcf363ef7725eb37dc,1,28,27,55,12,2012-01-12 09:50:53,2011-12-21 00:33:26
0d72c2b6b21c61e1d5253ddcf363ef7725eb37dc...d38e91543811e7b2bf6c895d8f46e485bee10961,2,25,33,58,7,2012-01-12 09:50:53,2012-01-11 23:31:15
d38e91543811e7b2bf6c895d8f46e485bee10961...8b8d19bf3fedc5ddb31813f3fdf7fcb58c1fb2dc,2,154,33,187,19,2012-01-12 09:50:53,2012-01-12 02:17:53
8b8d19bf3fedc5ddb31813f3fdf7fcb58c1fb2dc...827617e168f317de61397a35a72fb44e6c17c1fe,5,459,146,605,41,2012-01-12 09:53:31,2012-01-12 09:49:40
cdf96b22c275e393d11a2ef446e065361fde7860...58822077f495a42b9e6e76b6223fd6b1b49a3412,1,1,1,2,1,2012-01-05 21:48:57,2012-01-05 21:48:57
58822077f495a42b9e6e76b6223fd6b1b49a3412...a9f58deb93ee5be2408fd6531c5bfcffa41a9199,1,10,5,15,3,2012-01-09 22:42:42,2012-01-09 22:42:42
a9f58deb93ee5be2408fd6531c5bfcffa41a9199...c5b5880ceac2c62df714a8d59892d6012513fa1b,1,10,8,18,4,2012-01-10 06:46:31,2012-01-10 06:46:31
cdf96b22c275e393d11a2ef446e065361fde7860...cc6c5ab9d3ad310268874d629afc663307a2662f,8,19,19,38,17,2012-01-04 20:40:58,2012-01-04 20:40:58
cc6c5ab9d3ad310268874d629afc663307a2662f...2f17721e79a19dbdb09f7ee64a336d4d5d222a3f,1,1,1,2,1,2012-01-05 02:22:29,2012-01-05 02:22:29
2f17721e79a19dbdb09f7ee64a336d4d5d222a3f...eafe8a0ef00e12f777787ff4f23bf6f403761efb,2,4,4,8,2,2012-01-05 02:25:17,2012-01-05 02:25:17
eafe8a0ef00e12f777787ff4f23bf6f403761efb...23cd5b6912371f447cbd3c51ecd3224e20bcc4e9,21,59,59,118,55,2012-01-05 02:30:25,2012-01-05 02:30:25
23cd5b6912371f447cbd3c51ecd3224e20bcc4e9...05794f56431c591430b9e40c7e2ea34e6a516fb9,23,108,108,216,98,2012-01-05 02:32:23,2012-01-05 02:32:23
05794f56431c591430b9e40c7e2ea34e6a516fb9...8a623d94cbf99129a592426f3c56f77a9e5b985d,1,2,2,4,1,2012-01-05 04:13:12,2012-01-05 04:13:12
8a623d94cbf99129a592426f3c56f77a9e5b985d...2d1c5a31df68466975a380225d0540bc1f310265,1,1,1,2,1,2012-01-05 04:14:27,2012-01-05 04:14:27
2d1c5a31df68466975a380225d0540bc1f310265...1928788b43e7c094ab36d6aa84954c0c69276490,1,1,1,2,1,2012-01-05 04:14:44,2012-01-05 04:14:44
1928788b43e7c094ab36d6aa84954c0c69276490...8b04fec56f7ecb6d861b23b99374e1542bef750f,2,4,4,8,2,2012-01-05 04:17:13,2012-01-05 04:17:13
8b04fec56f7ecb6d861b23b99374e1542bef750f...3faff2de78661036413a0e650942e28c697d46fa,32,159,159,318,145,2012-01-05 04:52:46,2012-01-05 04:52:46
3faff2de78661036413a0e650942e28c697d46fa...ad8adcbc9059c6deca7a296bcfb76807e1e42b1c,8,16,16,32,16,2012-01-05 05:19:52,2012-01-05 05:19:52
ad8adcbc9059c6deca7a296bcfb76807e1e42b1c...274d64820aa220e4870278a46a4a4ccd2458380c,1,5,5,10,5,2012-01-05 05:21:27,2012-01-05 05:21:27
274d64820aa220e4870278a46a4a4ccd2458380c...ae91a7705c4e2120a985102b608f8397121f2e1f,1,15,15,30,11,2012-01-05 05:22:35,2012-01-05 05:22:35
ae91a7705c4e2120a985102b608f8397121f2e1f...8943d6ed6ed7787ac6b50adc70381e7131d82217,13,0,0,0,0,2012-01-05 05:24:52,2012-01-05 05:24:52
8943d6ed6ed7787ac6b50adc70381e7131d82217...9d3d31df6e3722f9d1d8014c39ad90e0b2fc54d4,16,0,0,0,0,2012-01-05 05:27:14,2012-01-05 05:27:14
9d3d31df6e3722f9d1d8014c39ad90e0b2fc54d4...4bdbf8bca4ff33a46d486b948dff2abc93a2c222,1,3,3,6,3,2012-01-05 05:29:09,2012-01-05 05:29:09
4bdbf8bca4ff33a46d486b948dff2abc93a2c222...ed88fca47be81f464d189c1c208cbbfffc9bb64c,1,5,5,10,5,2012-01-05 05:30:23,2012-01-05 05:30:23
ed88fca47be81f464d189c1c208cbbfffc9bb64c...e3b59aa2a1238c28b73c870e0f7b95208ec7b4aa,1,1,1,2,1,2012-01-06 06:10:53,2012-01-06 06:10:53
e3b59aa2a1238c28b73c870e0f7b95208ec7b4aa...b7b4ed09206c7319b17545e478d3db8e3a8b95cb,2,4,4,8,2,2012-01-06 23:00:58,2012-01-06 23:00:58
b7b4ed09206c7319b17545e478d3db8e3a8b95cb...bc14ecad49212eb25b0b0b4bf53681c73b0804b7,3,3,3,6,3,2012-01-06 23:06:46,2012-01-06 23:06:46
bc14ecad49212eb25b0b0b4bf53681c73b0804b7...5a7cf6482ac9a25f23f3242a682d0f4df0c637d3,3,4,4,8,3,2012-01-07 01:51:28,2012-01-07 01:51:28
5a7cf6482ac9a25f23f3242a682d0f4df0c637d3...dc88513aca99116654da1cd2966313dc792bad3d,1,1,1,2,1,2012-01-07 03:36:29,2012-01-07 03:36:29
dc88513aca99116654da1cd2966313dc792bad3d...231aa7b81d04ce681d3c7d7afc21cad1b4ad3305,3,13,0,13,3,2012-01-10 21:13:26,2012-01-10 21:13:26
c37109eb1c9d8b6673756a03756965c13bda2ba4...73368ce348c038f9ec4630bc8569c9b50f962e77,1,1,1,2,1,2012-01-13 02:44:54,2012-01-13 02:44:54
73368ce348c038f9ec4630bc8569c9b50f962e77...a1c5623191dd41a9a610204484a196c92258a00c,3,13,6,19,6,2012-01-13 03:21:00,2012-01-13 03:21:00
a1c5623191dd41a9a610204484a196c92258a00c...4891d1c956f26c6037f5f87922b27c5e88ed259e,2,16,4,20,4,2012-01-13 05:05:05,2012-01-13 03:21:15
4891d1c956f26c6037f5f87922b27c5e88ed259e...50fe6de9f9a0f17c28d71d853db898762dd753af,2,35,6,41,5,2012-01-13 19:45:53,2012-01-13 03:03:49
50fe6de9f9a0f17c28d71d853db898762dd753af...cb5c1c367212dfffcba55a58b1829950d5c81e58,1,160,75,235,8,2012-01-13 19:45:53,2012-01-13 09:57:41
cb5c1c367212dfffcba55a58b1829950d5c81e58...f30692f0d55664d842c8e5d05f1737c43e2e92e7,2,72,6,78,15,2012-01-13 19:45:53,2012-01-13 19:45:19
f30692f0d55664d842c8e5d05f1737c43e2e92e7...e24c97bd4b83fb7f24d8e21fbdb5d01dd64ac4c1,1,0,1,1,1,2012-01-13 19:50:43,2012-01-13 19:50:43
e24c97bd4b83fb7f24d8e21fbdb5d01dd64ac4c1...85742619d9e0b69fb4f8804518cd9087a6fe1bad,2,240,61,301,42,2012-01-13 21:07:46,2012-01-13 21:07:46
85742619d9e0b69fb4f8804518cd9087a6fe1bad...75e387aaa0987366f3f319e44179c0a97066d3cb,2,4,8,12,4,2012-01-13 22:00:02,2012-01-13 21:21:08
75e387aaa0987366f3f319e44179c0a97066d3cb...e16e0abaf3d7833b0f1b735c26fe9255aec5611f,2,246,12,258,12,2012-01-14 00:31:14,2012-01-14 00:27:08
e16e0abaf3d7833b0f1b735c26fe9255aec5611f...5479af11fe3d0d14dce8ffe8300ebf92df3b8eac,1,13,3,16,1,2012-01-14 02:33:20,2012-01-14 02:33:20
c5b5880ceac2c62df714a8d59892d6012513fa1b...06a14e6ad9bad4dd89064b35eabb2e6ca772b206,1,15,3,18,3,2012-01-13 23:20:12,2012-01-12 05:58:55
06a14e6ad9bad4dd89064b35eabb2e6ca772b206...e7c23b06347e5e25b89939f1d26efe4299f5cf74,1,16,55,71,10,2012-01-14 00:13:46,2012-01-14 00:13:46
e7c23b06347e5e25b89939f1d26efe4299f5cf74...5d6fb2af58392244133bc931438e8633a95d2c81,1,21,0,21,1,2012-01-14 00:38:28,2012-01-14 00:38:28
5d6fb2af58392244133bc931438e8633a95d2c81...1b9e00842b333346627da59f012e6f852236b704,1,1,1,2,1,2012-01-14 00:40:29,2012-01-14 00:40:29
1b9e00842b333346627da59f012e6f852236b704...0cb5acbd9eae6479c8756a8806f1a3a34e54867d,1,1,1,2,1,2012-01-14 02:36:58,2012-01-14 02:36:58
459dac9cacee923f45fb46c055233c1889c5aaf2...0d413ac1dbc2307c32f42bb3aa3ea7144a9c56e2,2,426,313,739,49,2012-01-19 01:45:07,2012-01-19 01:45:07
0d413ac1dbc2307c32f42bb3aa3ea7144a9c56e2...0e39cbe5bed64918c903d45a1564b1c84cc3e6f4,8,148,148,296,124,2012-01-19 01:53:21,2012-01-19 01:53:21
0e39cbe5bed64918c903d45a1564b1c84cc3e6f4...3c860a7b8c835172ad9d2a95cbb8fa91efae9935,1,2,2,4,1,2012-01-19 01:55:26,2012-01-19 01:55:26
3c860a7b8c835172ad9d2a95cbb8fa91efae9935...04a1f135097116057a4e0069b7b2bf7cabbffe5a,1,2,2,4,2,2012-01-19 05:39:50,2012-01-19 03:58:21
04a1f135097116057a4e0069b7b2bf7cabbffe5a...207464ba386288ed5f457be1b4837907c19e5d8f,1,2,2,4,2,2012-01-20 03:28:43,2012-01-20 03:28:43
b4d7fb0617ab9cc02b1549e6c08601c4d8a41f4c...fa783e8374c04adca31fef83488b4b89218141cd,1,0,1,1,1,2012-01-17 03:36:56,2012-01-14 04:40:27
fa783e8374c04adca31fef83488b4b89218141cd...603a869e37bf215dbb13599294c61e4bd7dac635,2,72,2,74,5,2012-01-17 03:36:56,2012-01-16 23:32:56
603a869e37bf215dbb13599294c61e4bd7dac635...6b101f0778a14efa68581425ea7b6fd7dafd3158,1,2,2,4,2,2012-01-17 03:36:56,2012-01-17 03:36:20
6b101f0778a14efa68581425ea7b6fd7dafd3158...8570a2267108d599282d3a4cb89fe165adb65f75,2,14,8,22,9,2012-01-17 03:36:56,2012-01-17 03:36:28
8570a2267108d599282d3a4cb89fe165adb65f75...b1f06d68ed4381767bd3de91ce93446ec4809404,2,293,30,323,7,2012-01-17 03:36:57,2012-01-17 03:36:49
b1f06d68ed4381767bd3de91ce93446ec4809404...ee8f1c1e9bcae4d617f1d4ad430279af88ac5d3c,3,140,82,222,51,2012-01-17 04:44:32,2012-01-17 04:44:32
ee8f1c1e9bcae4d617f1d4ad430279af88ac5d3c...8653639a2d177509f4e4cfdd1d3782a71370674c,3,34,25,59,15,2012-01-17 06:12:49,2012-01-17 06:12:49
8653639a2d177509f4e4cfdd1d3782a71370674c...f0ff237168f09fc7dcbe7e125dabfdcec1e5eefb,3,494,4,498,5,2012-01-17 06:50:27,2012-01-17 06:50:27
f0ff237168f09fc7dcbe7e125dabfdcec1e5eefb...7a61bc7933a48704a34782c1b24e513f7be166de,1,0,5,5,1,2012-01-17 06:53:08,2012-01-17 06:53:08
7a61bc7933a48704a34782c1b24e513f7be166de...8cc4bc3aeb0099d8ede2cd499232ef57583fbcb8,4,11,0,11,3,2012-01-17 07:03:07,2012-01-17 07:03:07
8cc4bc3aeb0099d8ede2cd499232ef57583fbcb8...410eab6f94bcd9776b1f321dc7219666cb5691cb,1,0,1,1,1,2012-01-18 01:36:26,2012-01-18 01:36:26
410eab6f94bcd9776b1f321dc7219666cb5691cb...cdb50e3cd863d887c04a6d3a31f7905170896b16,1,3,2,5,1,2012-01-18 02:05:48,2012-01-18 02:05:48
cdb50e3cd863d887c04a6d3a31f7905170896b16...dc2e3776952d2263e85892a6483e1797c708602a,4,117,96,213,25,2012-01-18 02:49:35,2012-01-18 02:40:19
dc2e3776952d2263e85892a6483e1797c708602a...5312de215fb58f4c40d28cdd018f72e759ffec88,1,1,1,2,1,2012-01-18 05:10:37,2012-01-18 05:09:42
207464ba386288ed5f457be1b4837907c19e5d8f...694e23275fbffb58f464e7a770405dbcd86ee6e0,1,1,1,2,1,2012-01-20 03:56:00,2012-01-20 03:56:00
694e23275fbffb58f464e7a770405dbcd86ee6e0...7daf9751ccf403dc2f74620087c2a60b785691b8,3,4,4,8,3,2012-01-20 04:51:03,2012-01-20 04:51:03
7daf9751ccf403dc2f74620087c2a60b785691b8...931ed590cb61aeea2e50988bffe6ecc3a1318a3f,3,4,4,8,3,2012-01-20 06:23:01,2012-01-20 06:23:01
931ed590cb61aeea2e50988bffe6ecc3a1318a3f...ee0da539a56b96fa9130ce967cfd2ada0618d554,3,4,4,8,3,2012-01-20 07:34:16,2012-01-20 07:34:16
ee0da539a56b96fa9130ce967cfd2ada0618d554...4e4358e2c068ffd0c0bc565bb2a9438c68bab7fb,3,4,4,8,3,2012-01-20 07:34:31,2012-01-20 07:34:31
4e4358e2c068ffd0c0bc565bb2a9438c68bab7fb...95ba0bac0be46d5f5b84454b1018edce957e3181,1,5,3,8,2,2012-01-21 00:32:01,2012-01-21 00:32:01
95ba0bac0be46d5f5b84454b1018edce957e3181...80f746633e80118b5766841d9682e28cfc1134d0,2,1,1,2,1,2012-01-21 02:26:26,2012-01-21 02:26:26
80f746633e80118b5766841d9682e28cfc1134d0...e7eb9e6929e7cd167644ac628b680b7844d62ad1,1,1,1,2,1,2012-01-24 06:34:05,2012-01-24 06:34:05
e7eb9e6929e7cd167644ac628b680b7844d62ad1...4de4bbfd45a8ba67a3c9a42c8715783fcc79923b,1,1,0,1,1,2012-01-24 07:22:10,2012-01-24 07:22:10
4de4bbfd45a8ba67a3c9a42c8715783fcc79923b...50d8f666adaada361b168fc31ad0ca958a8ea126,1,1,1,2,1,2012-01-24 23:45:42,2012-01-24 23:45:42
5312de215fb58f4c40d28cdd018f72e759ffec88...a5d650e7ced6f08fe3d946bd38642db9151bece4,17,1827,1613,3440,17,2012-01-18 09:19:55,2012-01-18 09:19:55
a5d650e7ced6f08fe3d946bd38642db9151bece4...618d6f71bc2112ca38bcfaf94e528be78c0c7997,2,7,2,9,3,2012-01-19 04:10:50,2012-01-19 04:10:25
618d6f71bc2112ca38bcfaf94e528be78c0c7997...7a0c0d2217f0447d9cc6b30c427fc92fdca440e8,3,53,12,65,11,2012-01-19 05:27:26,2012-01-19 05:27:26
7a0c0d2217f0447d9cc6b30c427fc92fdca440e8...3e1fbe0577a7858c46ef587b20586807393b6e0a,1,3,1,4,1,2012-01-19 05:43:42,2012-01-19 05:43:42
3e1fbe0577a7858c46ef587b20586807393b6e0a...32410dbb36190f01723be67ca94a976b2649a765,3,16,17,33,12,2012-01-19 05:43:54,2012-01-19 05:43:54
32410dbb36190f01723be67ca94a976b2649a765...3dbf45641fd09ecc2adb8af69eef0c87cd00705b,3,145,112,257,68,2012-01-19 06:01:23,2012-01-19 06:01:23
3dbf45641fd09ecc2adb8af69eef0c87cd00705b...4a9277c7c90cb2d604caa755033813a66669d25f,1,1,1,2,1,2012-01-19 08:44:14,2012-01-19 08:44:14
4a9277c7c90cb2d604caa755033813a66669d25f...c8cf066dbc1bd94cef298599cbbe7b26bbc64036,17,383,420,803,124,2012-01-19 08:49:30,2012-01-19 08:49:30
c8cf066dbc1bd94cef298599cbbe7b26bbc64036...b5836456db4332894e168b17211380e6f1feaf97,3,34,1,35,5,2012-01-19 09:20:33,2012-01-19 09:00:43
b5836456db4332894e168b17211380e6f1feaf97...4bed3a6e62ccc3ea2613fdc2c52f497dc4f187cf,1,2,0,2,1,2012-01-19 23:26:04,2012-01-19 23:26:04
4bed3a6e62ccc3ea2613fdc2c52f497dc4f187cf...dddf76b3a54897ed8e2e06352513d26abbe4f9af,1,42,3,45,13,2012-01-20 01:00:28,2012-01-20 01:00:28
dddf76b3a54897ed8e2e06352513d26abbe4f9af...a4880a6c3a25991aaa8a6f8691861d88f28c38fe,3,162,51,213,27,2012-01-20 10:00:08,2012-01-20 06:41:01
5312de215fb58f4c40d28cdd018f72e759ffec88...0b3419da798bb7f52a48cbb995045a96856c449d,3,4,4,8,3,2012-01-18 06:16:37,2012-01-18 06:16:37
c3a5e2cafc933f5c746909901adb65f7caae3151...db3f8b3ebc975be47e69e36e8b8f7a0d5d4e82b4,2,117,15,132,7,2012-01-21 00:00:05,2012-01-20 21:48:50
db3f8b3ebc975be47e69e36e8b8f7a0d5d4e82b4...ad801a61ac43fc0982971261007c4decabc9ad16,2,114,56,170,26,2012-01-21 00:00:05,2012-01-20 23:41:57
ad801a61ac43fc0982971261007c4decabc9ad16...140b809c90ba2b43b8599dd793f8c1020b368b88,1,4,5,9,2,2012-01-21 00:58:06,2012-01-21 00:58:06
140b809c90ba2b43b8599dd793f8c1020b368b88...c2c903f3efa52a04d8f6ab9e49d973a919d202f9,2,3,3,6,3,2012-01-28 04:01:59,2012-01-21 01:25:22
c2c903f3efa52a04d8f6ab9e49d973a919d202f9...2116a9c239fc3f988bd804e826d69df319801258,2,7,5,12,5,2012-01-28 04:02:24,2012-01-21 02:45:15
2116a9c239fc3f988bd804e826d69df319801258...ad55fc8cb956c4c3c4633d19a3513d2a1113a944,2,7,9,16,4,2012-01-28 04:02:24,2012-01-21 03:28:49
ad55fc8cb956c4c3c4633d19a3513d2a1113a944...e2f60158faf354837c042e697caa63b889a30526,1,1,1,2,1,2012-01-28 04:02:24,2012-01-21 03:49:30
e2f60158faf354837c042e697caa63b889a30526...900d2401d03e384ba8cd406a214b89d94e52cacd,2,5,1,6,2,2012-01-28 04:02:24,2012-01-21 03:51:09
900d2401d03e384ba8cd406a214b89d94e52cacd...e5eb42e55cd9e4cc7318b365a27331366f771277,27,724,360,1084,133,2012-01-28 04:02:24,2012-01-21 02:56:39
e5eb42e55cd9e4cc7318b365a27331366f771277...c44f9c3680a797446d0de4be473be309ea2033e3,5,361,381,742,21,2012-01-28 04:02:24,2012-01-21 14:15:30
c44f9c3680a797446d0de4be473be309ea2033e3...ab7f8a379de65f9181e8cfa954eb082b37bc6a78,3,25,16,41,7,2012-01-28 04:02:24,2012-01-21 14:27:56
ab7f8a379de65f9181e8cfa954eb082b37bc6a78...ef4a7b91af5b7aaeaf7a94e1b17376ac26897695,5,332,187,519,46,2012-01-28 04:02:24,2012-01-26 04:02:02
ef4a7b91af5b7aaeaf7a94e1b17376ac26897695...2418712f4539469f7a060ca1c4e3b67ef3af6123,1,29,7,36,3,2012-01-28 04:02:24,2012-01-26 05:07:55
2418712f4539469f7a060ca1c4e3b67ef3af6123...c635ca97b281195dcbd3d998805f36051211ceaf,2,5,3,8,4,2012-01-28 04:02:24,2012-01-26 05:42:16
c635ca97b281195dcbd3d998805f36051211ceaf...79d7a7ed510ba99944a5a1f2f00ffb8430faf1a7,1,8,3,11,2,2012-01-28 04:02:24,2012-01-26 05:59:34
79d7a7ed510ba99944a5a1f2f00ffb8430faf1a7...5f08d3cbac44826f15ade55d9143f349b7fcb5d8,2,2,1,3,2,2012-01-28 04:02:25,2012-01-26 07:09:14
5f08d3cbac44826f15ade55d9143f349b7fcb5d8...309ce71da02c45f9b9374cc625567495498397e6,1,5,1,6,2,2012-01-28 04:02:25,2012-01-26 07:47:42
309ce71da02c45f9b9374cc625567495498397e6...1318774a62f9c0c0f4a99a40484d2e2937161c1a,1,7,3,10,4,2012-01-28 04:02:25,2012-01-26 20:08:24
1318774a62f9c0c0f4a99a40484d2e2937161c1a...6108c56dfd81edfd484214b1dd49282248d1416a,4,10,9,19,8,2012-01-28 04:02:25,2012-01-26 20:42:32
6108c56dfd81edfd484214b1dd49282248d1416a...ecb82782ebf0f46b837cc67fc05f0e66d49d1152,4,55,18,73,12,2012-01-28 04:02:25,2012-01-26 20:58:15
ecb82782ebf0f46b837cc67fc05f0e66d49d1152...f68c30136eb9d8d667b3b4db8eb13953221871fa,2,3,3,6,3,2012-01-28 04:02:25,2012-01-26 22:13:31
f68c30136eb9d8d667b3b4db8eb13953221871fa...55cf948a6b26b67e3f2e8ef6055a2119d56f960f,1,41,10,51,12,2012-01-28 04:02:25,2012-01-27 01:57:24
55cf948a6b26b67e3f2e8ef6055a2119d56f960f...160acf1d78d5b774d90c50eb84a648c472ea2301,2,13,1,14,2,2012-01-28 04:02:25,2012-01-27 04:43:57
160acf1d78d5b774d90c50eb84a648c472ea2301...25f3c14371ab8cd00f470474337fff3a88b16927,2,42,2,44,3,2012-01-28 04:02:25,2012-01-27 06:32:19
25f3c14371ab8cd00f470474337fff3a88b16927...4c4de06ecfffcab6fe78294a1abb2daa8fd7b5c9,4,78,9,87,5,2012-01-28 04:02:25,2012-01-27 15:51:30
4c4de06ecfffcab6fe78294a1abb2daa8fd7b5c9...5f40891b3bb82274649df77d89b5862ed4414fcd,1,7,7,14,2,2012-01-28 04:02:25,2012-01-27 20:49:53
5f40891b3bb82274649df77d89b5862ed4414fcd...d56773277b2d7d0da2fa688c7c1f14dd7bb76531,1,5,2,7,3,2012-01-28 04:02:25,2012-01-27 22:22:23
d56773277b2d7d0da2fa688c7c1f14dd7bb76531...d1d5604976fbbc8342647e2130df817ab95f2a9f,44,745,601,1346,124,2012-01-28 04:02:26,2012-01-24 04:05:44
d1d5604976fbbc8342647e2130df817ab95f2a9f...f50d970b0f794cfd4198b8f4f977be07a7678020,1,4,1,5,1,2012-01-28 04:03:03,2012-01-27 23:54:33
f50d970b0f794cfd4198b8f4f977be07a7678020...31cf1d8ab426c9fda2f421507d9f493608c32143,2,15,8,23,5,2012-01-28 04:03:03,2012-01-28 00:04:38
31cf1d8ab426c9fda2f421507d9f493608c32143...aa727720171758c4abff930780590b94c2ee00e8,2,20,7,27,4,2012-01-28 04:03:59,2012-01-28 00:39:41
aa727720171758c4abff930780590b94c2ee00e8...7f133d37b5e8f9ea27110d6be036f3ede5160d1c,3,7,0,7,2,2012-01-28 04:03:59,2012-01-28 00:53:38
7f133d37b5e8f9ea27110d6be036f3ede5160d1c...334885c18e28770ac8853f02c36dfe1b06935d69,3,21,8,29,4,2012-01-28 04:03:59,2012-01-28 01:25:21
334885c18e28770ac8853f02c36dfe1b06935d69...55401609c34500602358564f71b69d4b973b0384,1,12,9,21,3,2012-01-28 04:03:59,2012-01-28 03:52:42
55401609c34500602358564f71b69d4b973b0384...a3a8aee0fee96b6007181488471726de89e004ef,1,17,16,33,4,2012-01-28 04:49:25,2012-01-28 04:49:25
a028b9d9dedb5bd6078b49d1d0c39c03e4b65fa6...5e7daaaff33482ee6571a3a8a9c5b99bfa428732,12,425,221,646,87,2012-01-28 04:59:08,2012-01-20 02:32:44
5e7daaaff33482ee6571a3a8a9c5b99bfa428732...fc738af5d0227f6b345b258e7ea667005b29e579,1,178,181,359,37,2012-01-28 04:59:08,2012-01-27 20:46:57
fc738af5d0227f6b345b258e7ea667005b29e579...da9dfc03a616582413524636dd4c9a644cbdea0e,1,1,1,2,1,2012-01-28 06:57:07,2012-01-28 06:53:59
da9dfc03a616582413524636dd4c9a644cbdea0e...18a390505276a21bb4c2b43c9d61b96dab822fcc,1,18,4,22,6,2012-01-28 06:57:07,2012-01-28 06:54:30
18a390505276a21bb4c2b43c9d61b96dab822fcc...b367f4a6e146fc5d7bf6e2e57aeb01f887e11756,8,41,7,48,9,2012-01-28 07:19:48,2012-01-28 07:19:33
b367f4a6e146fc5d7bf6e2e57aeb01f887e11756...f2e6838691b4e0faf861fdbca4005f8ffb670159,6,41,20,61,12,2012-01-28 08:10:35,2012-01-28 08:10:35
b367f4a6e146fc5d7bf6e2e57aeb01f887e11756...118a217fde87cd68b35005b5d768b7c00be09489,1,5,0,5,1,2012-01-28 07:37:37,2012-01-28 07:37:37
118a217fde87cd68b35005b5d768b7c00be09489...c616e4fb8b19401844a2625c652119d4229ac2be,2,17,9,26,8,2012-01-28 08:09:17,2012-01-28 08:08:11
b12465ffff2a2bf181a05f7907995b235002020b...fbf143a7e6990691c47167b30de622d214b1e717,2,4,10,14,4,2012-01-29 02:38:44,2012-01-29 02:38:44
fbf143a7e6990691c47167b30de622d214b1e717...0fa1d39cf7227881f23b671fd127b118cab17eba,4,58,90,148,19,2012-01-30 20:03:06,2012-01-30 20:03:06
0fa1d39cf7227881f23b671fd127b118cab17eba...44fb1d215055069805bb0c60946e87ffa10da1b2,2,4,3,7,2,2012-01-30 20:03:18,2012-01-30 20:03:18
44fb1d215055069805bb0c60946e87ffa10da1b2...93ff43bb78ce7f461fa4c2986f5a2142f31f9324,1,0,3,3,1,2012-01-30 20:42:23,2012-01-30 20:42:23
db627bf6eb558767280137e6847194ca46dd5093...2b521b72be6706a5bc2541a1feeae13ba0d44e75,1,4,4,8,3,2012-01-31 00:04:43,2012-01-31 00:04:43
2b521b72be6706a5bc2541a1feeae13ba0d44e75...b024390adff3c9b806510c5a64cac08d640e4982,1,2,1,3,1,2012-01-31 00:04:52,2012-01-31 00:04:52
b024390adff3c9b806510c5a64cac08d640e4982...8e4dede50268544d33da0be6a8ea9db3033ed0fd,3,4,4,8,3,2012-01-31 01:25:13,2012-01-31 01:25:13
8e4dede50268544d33da0be6a8ea9db3033ed0fd...36ee0d7dbabd2ccb3e2980f461d0d16a09e99f8c,1,3,1,4,1,2012-02-01 05:34:53,2012-02-01 05:34:53
36ee0d7dbabd2ccb3e2980f461d0d16a09e99f8c...16315ee3b19e3bd9cf8da43620d1a79424e660f4,3,4,4,8,3,2012-02-01 05:46:06,2012-02-01 05:46:06
16315ee3b19e3bd9cf8da43620d1a79424e660f4...c1d81b9f712f692fb951f92fb6d4ae0185d793ed,1,1,1,2,1,2012-02-03 00:46:43,2012-02-02 22:48:48
c1d81b9f712f692fb951f92fb6d4ae0185d793ed...6851bf66ae730923375fa90e4e0502c7a3cdf98e,8,138,87,225,39,2012-02-03 00:46:43,2012-02-01 01:05:25
6851bf66ae730923375fa90e4e0502c7a3cdf98e...0b3907a476ecfc5d4965d806102481d61f9c9722,22,3747,0,3747,18,2012-02-03 01:20:07,2012-02-03 01:20:07
0b3907a476ecfc5d4965d806102481d61f9c9722...32d1e985a610de1da9ed98d525e89258776913ee,2,5,3,8,2,2012-02-03 01:26:04,2012-02-03 01:26:04
32d1e985a610de1da9ed98d525e89258776913ee...42f82d9f6319ca0ef7ea3ec66ca9901b1897c701,2,6,2,8,2,2012-02-03 02:12:20,2012-02-03 02:12:20
42f82d9f6319ca0ef7ea3ec66ca9901b1897c701...6a0831d9b006b8cfdf9c9e5d53df0af0db21a5c9,7,24,20,44,12,2012-02-07 02:17:53,2012-02-07 02:06:15
6a0831d9b006b8cfdf9c9e5d53df0af0db21a5c9...289818615c17e2dc35273e5bffa5a41b4d8a98f8,3,34,0,34,3,2012-02-07 02:58:31,2012-02-07 02:58:31
289818615c17e2dc35273e5bffa5a41b4d8a98f8...8def45079a6ca95e131ef8f2e4fb241f25e1c81c,2,51,10,61,11,2012-02-07 07:15:31,2012-02-01 06:58:56
8def45079a6ca95e131ef8f2e4fb241f25e1c81c...bd02b31a559f97f92751402d416946746404cbd3,4,11,3,14,4,2012-02-07 07:15:31,2012-02-01 23:08:06
bd02b31a559f97f92751402d416946746404cbd3...cf4cab282e56b3e5ed60294074226d0c2918cf88,3,33,11,44,15,2012-02-07 07:15:31,2012-02-02 03:32:21
cf4cab282e56b3e5ed60294074226d0c2918cf88...68511f2dc452c76b9b5e93973293dcf916b3c0d6,5,94,16,110,9,2012-02-07 07:15:31,2012-02-02 07:42:13
68511f2dc452c76b9b5e93973293dcf916b3c0d6...03d06a33b10c2071f3d06776e140609b73f0dc2d,1,9,1,10,3,2012-02-07 07:15:31,2012-02-03 01:38:14
03d06a33b10c2071f3d06776e140609b73f0dc2d...6f3cd0324c8538dd3d1533ab6067e4980172ea2c,1,2,2,4,2,2012-02-07 07:15:31,2012-02-03 01:39:57
6f3cd0324c8538dd3d1533ab6067e4980172ea2c...6623c245eb5dadd52552d64d9b054bab48e9c648,2,70,4,74,5,2012-02-07 07:15:31,2012-02-03 01:41:08
6623c245eb5dadd52552d64d9b054bab48e9c648...453cffe99aad7e68020d30e62ca32f463f8580b6,1,2,6,8,3,2012-02-07 07:15:31,2012-02-03 01:40:33
453cffe99aad7e68020d30e62ca32f463f8580b6...c1c8f6f7fe0fecbf7affe412d36f3874b7dd3797,1,33,40,73,10,2012-02-07 07:15:31,2012-02-07 02:35:27
c1c8f6f7fe0fecbf7affe412d36f3874b7dd3797...88feb09b3045102c73a3654ca03e09ec80053d26,1,40,11,51,11,2012-02-07 07:15:31,2012-02-07 07:06:41
477dd7eed856a86723ab77d7e10343ed1f8b0a64...f1368be4d8bff0a4c9b57c87da42aa2a208e74f6,2,161,172,333,32,2012-02-07 20:02:34,2012-02-07 17:11:48
f1368be4d8bff0a4c9b57c87da42aa2a208e74f6...476db8cccb46ec978c60e2bf8e58e19b45f06629,2,9,9,18,9,2012-02-07 20:06:51,2012-02-07 20:06:51
476db8cccb46ec978c60e2bf8e58e19b45f06629...7a88230e48620bc0362a90b83357efa7120de40d,1,1,0,1,1,2012-02-07 22:51:35,2012-02-07 22:50:52
7a88230e48620bc0362a90b83357efa7120de40d...d23b7ff1976dd1c2e032abd6676d8986ed45e8ab,2,123,72,195,14,2012-02-08 21:04:51,2012-02-07 22:51:33
d23b7ff1976dd1c2e032abd6676d8986ed45e8ab...acd3e24eec605db5c7ceef60816d2b7c7f180ae3,2,35,19,54,11,2012-02-08 21:10:58,2012-02-07 23:20:38
acd3e24eec605db5c7ceef60816d2b7c7f180ae3...08fa853fca1706a9bc69edd62188d5d4e8f322de,2,18,6,24,5,2012-02-08 21:11:14,2012-02-07 23:57:17
08fa853fca1706a9bc69edd62188d5d4e8f322de...9273b9f69d24d90b92fd2986375d83c2a0679346,2,127,85,212,25,2012-02-08 21:15:16,2012-02-08 01:00:55
9273b9f69d24d90b92fd2986375d83c2a0679346...c84e8d572f91895b27dd411bd7baf316c1f17e92,1,1,1,2,1,2012-02-08 21:15:16,2012-02-07 23:57:46
4a393185193e11a127a2a6e446e3f759fe6b7ed9...23354ffcab35d352c5813d97f3d216c7649129eb,1,75,0,75,1,2012-02-09 06:44:43,2012-02-09 06:44:43
23354ffcab35d352c5813d97f3d216c7649129eb...4abfc271288d5b148364d7aaa8577a5e9a48acde,1,4,9,13,5,2012-02-09 06:48:45,2012-02-09 06:48:45
4abfc271288d5b148364d7aaa8577a5e9a48acde...99d3c6cdf5f0b68c6243a6ac55dc51b307bbd529,2,13,4,17,7,2012-02-09 22:08:38,2012-02-09 22:08:38
99d3c6cdf5f0b68c6243a6ac55dc51b307bbd529...93cce72a65bdb56b80efcd983bc87b1824bfa7f7,3,4,4,8,3,2012-02-09 23:02:04,2012-02-09 23:02:04
93cce72a65bdb56b80efcd983bc87b1824bfa7f7...048f39ca237ce8c15038bd9395203dc1620cc851,1,1,1,2,1,2012-02-09 23:03:57,2012-02-09 23:03:35
048f39ca237ce8c15038bd9395203dc1620cc851...755541f55a6cea87769b92974e7fce35b03a7369,1,4,2,6,2,2012-02-09 23:07:03,2012-02-09 23:07:03
755541f55a6cea87769b92974e7fce35b03a7369...6c7a31b1fbd5e6e80fc3b553970f7b8bb1a7c46c,1,8,0,8,2,2012-02-10 01:23:33,2012-02-10 01:23:07
6c7a31b1fbd5e6e80fc3b553970f7b8bb1a7c46c...5f27e47c9f03c6ed2ac4110c86d6ea46aa8056eb,4,726,633,1359,123,2012-02-10 04:02:23,2012-02-09 04:49:48
5f27e47c9f03c6ed2ac4110c86d6ea46aa8056eb...51d43b1feb27a4b9307ed6f584180e51ef2c4e42,2,184,98,282,33,2012-02-10 05:36:38,2012-02-10 05:36:38
51d43b1feb27a4b9307ed6f584180e51ef2c4e42...611883731186747be89604746722edd72b086eeb,2,64,9,73,13,2012-02-10 06:27:48,2012-02-10 06:27:48
611883731186747be89604746722edd72b086eeb...8eeba106c59a89185e3baa586762d05759850a3a,1,1,1,2,1,2012-02-10 21:14:16,2012-02-10 21:14:16
8eeba106c59a89185e3baa586762d05759850a3a...b84f048c75a3428ceeaa8fa9df653a7dd0d75e12,8,33,33,66,29,2012-02-10 23:43:12,2012-02-10 23:43:12
b84f048c75a3428ceeaa8fa9df653a7dd0d75e12...3e3b522fdee7dece54cbcd791822a899996b1477,1,2,1,3,1,2012-02-13 22:06:37,2012-02-13 22:06:37
3e3b522fdee7dece54cbcd791822a899996b1477...f2cd91ef6b8445af96a6c259f06fa970388745ef,5,861,379,1240,226,2012-02-13 22:55:07,2012-02-13 22:55:07
f2cd91ef6b8445af96a6c259f06fa970388745ef...587913154c4d642a6abd3651a394f0ae5c272cf4,2,40,31,71,14,2012-02-14 04:08:07,2012-02-14 04:08:07
587913154c4d642a6abd3651a394f0ae5c272cf4...e1a9fb82b92646f01d2ab2cbe408643d333f2acf,1,10,7,17,8,2012-02-14 17:33:25,2012-02-14 17:33:25
e1a9fb82b92646f01d2ab2cbe408643d333f2acf...2ed2e47c84bc1612da9ff44583881919eca4b265,2,4,14,18,2,2012-02-15 01:24:07,2012-02-15 01:24:07
2ed2e47c84bc1612da9ff44583881919eca4b265...2461bdd3ddb790c8ccec8495443fdda33782a664,1,8,3,11,5,2012-02-15 02:00:49,2012-02-13 22:25:03
2461bdd3ddb790c8ccec8495443fdda33782a664...63f893e4077f06e200aa9efa87e021171eabc8f0,1,2,3,5,3,2012-02-15 02:00:49,2012-02-09 04:40:05
63f893e4077f06e200aa9efa87e021171eabc8f0...c37b498436ddf0eb895ef721a477241c6925ef14,2,2,2,4,2,2012-02-15 02:00:49,2012-02-09 04:41:28
c37b498436ddf0eb895ef721a477241c6925ef14...577c7791301c10de868edc584a5ab4a29bf4cb02,1,0,1,1,1,2012-02-15 02:00:49,2012-02-09 04:48:24
577c7791301c10de868edc584a5ab4a29bf4cb02...7738236ed598af2b534595e1a214661d8b821049,1,0,10,10,1,2012-02-15 02:00:49,2012-02-09 05:37:29
7738236ed598af2b534595e1a214661d8b821049...02278b3b5e9cc51d13536b7299115fabc91e1433,2,2007,0,2007,2,2012-02-15 02:00:49,2012-02-13 22:50:22
02278b3b5e9cc51d13536b7299115fabc91e1433...91f479e9d4e9a49a87b40c17a0ce2d3732d4f9ac,4,138,177,315,73,2012-02-15 02:00:49,2012-02-10 07:36:10
91f479e9d4e9a49a87b40c17a0ce2d3732d4f9ac...19dc92a6c876b365288d4f11d4c54f30cfd7708a,1,58,26,84,18,2012-02-15 02:00:50,2012-02-14 03:50:15
19dc92a6c876b365288d4f11d4c54f30cfd7708a...a0156989bbfd1c0e302b20a24ff9484a0c4e7bb9,1,1,6,7,3,2012-02-15 02:00:50,2012-02-14 03:56:35
a0156989bbfd1c0e302b20a24ff9484a0c4e7bb9...ff25333349bb8db1ab2182fe2fd5a02b896493e2,1,2,7,9,1,2012-02-15 02:00:50,2012-02-14 05:15:59
ff25333349bb8db1ab2182fe2fd5a02b896493e2...b1d4bc85e461a4e6a9a8936aaa62fb81d90b917a,2,4,3,7,2,2012-02-15 02:00:50,2012-02-14 05:44:36
b1d4bc85e461a4e6a9a8936aaa62fb81d90b917a...0fed828024aa175113f67d8f2a8255fac83bd7d6,3,25,14,39,12,2012-02-15 02:00:50,2012-02-14 23:47:08
0fed828024aa175113f67d8f2a8255fac83bd7d6...dfd094e6c21042207179b601ce514dd4fe09875d,2,2,2,4,2,2012-02-15 02:00:50,2012-02-14 23:47:23
dfd094e6c21042207179b601ce514dd4fe09875d...42a29bd1777725445c031d1e96922ec3db9ba10c,2,3,3,6,2,2012-02-15 02:00:50,2012-02-14 03:53:16
42a29bd1777725445c031d1e96922ec3db9ba10c...573fbfff8ef027d33973ec716b55edd59d875b24,1,21,21,42,14,2012-02-15 02:00:50,2012-02-15 01:59:19
573fbfff8ef027d33973ec716b55edd59d875b24...d820a7f8b881acd7f7bb97ef2f3d73e1fa8165dc,1,7,2,9,1,2012-02-15 02:00:50,2012-02-15 02:00:05
7e3b895c69f4d2ba4b1ba83549df13145a6eddfb...a7c11b167e0474f56e2bb388c0b3c0323991bcf6,1,2,1,3,1,2012-02-15 08:15:50,2012-02-15 08:15:50
a7c11b167e0474f56e2bb388c0b3c0323991bcf6...47c7a23bf282036a213611b62b403e73daab4485,2,204,186,390,53,2012-02-15 17:04:04,2012-02-14 17:27:52
47c7a23bf282036a213611b62b403e73daab4485...7b2f2f3683b83508f5e414d5541528b8ca32f569,1,11,2,13,3,2012-02-16 01:38:13,2012-02-16 01:37:49
7b2f2f3683b83508f5e414d5541528b8ca32f569...7269e01ebd2a2c5723fe8dcd246f86ed89de2d04,1,113,64,177,11,2012-02-16 07:05:00,2012-02-16 06:54:19
7269e01ebd2a2c5723fe8dcd246f86ed89de2d04...eaaedd3b437fb3da9dbd299204da4a7cd8ac57eb,2,14,2,16,2,2012-02-16 07:36:17,2012-02-16 07:36:17
eaaedd3b437fb3da9dbd299204da4a7cd8ac57eb...5cd46e7f3eaba017882af96100bb2b050a11be91,2,13,0,13,2,2012-02-16 23:13:00,2012-02-16 23:13:00
5cd46e7f3eaba017882af96100bb2b050a11be91...70fdc5a0a2ec973d50dc7c615c6c99520ebc9b55,3,21,4,25,3,2012-02-16 23:24:36,2012-02-16 23:24:24
70fdc5a0a2ec973d50dc7c615c6c99520ebc9b55...abd2097f5522482abe2c7d70afb81b0c162a81be,3,4,4,8,3,2012-02-17 02:36:56,2012-02-17 02:36:24
70fdc5a0a2ec973d50dc7c615c6c99520ebc9b55...4e552ec514c28c6334603efa769a696b605b31f3,1,7,2,9,3,2012-02-17 00:24:58,2012-02-17 00:24:58
4e552ec514c28c6334603efa769a696b605b31f3...c309647c0c240e07598d95453279565f063037b8,1,4,1,5,1,2012-02-17 00:25:12,2012-02-17 00:25:12
c309647c0c240e07598d95453279565f063037b8...1ce3f3b8125ad35183f5972fd3c88a2ef70cf156,1,9,0,9,1,2012-02-17 01:50:54,2012-02-17 01:50:54
4818cc0bcabaab27bcdd0a249dc69ce02dd179be...f31226e388ed36a1702b30e4fa089f23e1cfe69a,11,145,143,288,126,2012-02-17 06:41:16,2012-02-16 23:49:26
f31226e388ed36a1702b30e4fa089f23e1cfe69a...d3eec5b9200aea74809390d4aa8736174f5eac89,2,22,12,34,9,2012-02-17 06:41:16,2012-02-16 23:58:29
d3eec5b9200aea74809390d4aa8736174f5eac89...908bfa0ba2fad6647569f1a94e8d65bd5817e889,5,16,6,22,5,2012-02-17 06:41:16,2012-02-17 00:29:09
908bfa0ba2fad6647569f1a94e8d65bd5817e889...5d069169a98ff6b1131e2ab242509f60838a700f,10,458,242,700,26,2012-02-17 07:07:00,2012-02-17 06:35:10
5d069169a98ff6b1131e2ab242509f60838a700f...03f332d584bbe83f1f99cc983777b369d5d183b3,7,49,63,112,11,2012-02-17 07:07:00,2012-02-17 07:02:06
03f332d584bbe83f1f99cc983777b369d5d183b3...23f4bd6fc48fc066452f510b5d022d0049ab96e9,2,5,5,10,5,2012-02-17 07:07:00,2012-02-17 07:05:16
23f4bd6fc48fc066452f510b5d022d0049ab96e9...6fa852fdb7847ac62390eccba498fdbc7a52bfcb,6,82,3,85,12,2012-02-17 09:02:28,2012-02-17 07:47:19
6fa852fdb7847ac62390eccba498fdbc7a52bfcb...3e47029a610867d8039fcaeb66735f01d4b21e6c,19,52,209,261,30,2012-02-17 09:02:34,2012-02-17 08:32:10
3e47029a610867d8039fcaeb66735f01d4b21e6c...c88dc05ff3cd8850fa6dcb1523032cb6ae16945a,2,36,13,49,13,2012-02-17 09:02:51,2012-02-17 08:58:21
c88dc05ff3cd8850fa6dcb1523032cb6ae16945a...7a8e7f5ea345fbbceabbdcbfdb01fdbd11b9314f,4,4,2,6,4,2012-02-17 09:33:18,2012-02-17 09:33:18
7a8e7f5ea345fbbceabbdcbfdb01fdbd11b9314f...bd1e4eb8580db493349b78a053ab5d2531fc17c0,6,130,0,130,5,2012-02-17 09:58:15,2012-02-17 09:58:15
54ddf0c28003a5e3fee1db90fd31bc50acb83a9c...5385c4a35870d7f2be3902d82591a5abde44c047,1,1,1,2,1,2012-02-18 04:48:17,2012-02-18 04:48:17
5385c4a35870d7f2be3902d82591a5abde44c047...1d3154bd54b4b542483e1a5c7be746693a0a982a,1,8,8,16,8,2012-02-19 22:44:32,2012-02-19 22:44:32
1d3154bd54b4b542483e1a5c7be746693a0a982a...08c3d134658a1aa775995bd885b00c18a9cb0fef,1,3,2,5,2,2012-02-21 23:25:34,2012-02-21 23:25:34
1d3154bd54b4b542483e1a5c7be746693a0a982a...6acaeb0ee6d56ef172a680690a8b4ec0806ec854,2,190,130,320,21,2012-02-21 06:12:31,2012-02-21 06:12:31
6acaeb0ee6d56ef172a680690a8b4ec0806ec854...8cf92b18efbee10d0995f5d07473520b6290e8a0,4,131,28,159,25,2012-02-21 07:58:59,2012-02-21 07:58:59
8cf92b18efbee10d0995f5d07473520b6290e8a0...e0722bedf828150b262c51f9920221bd3c28996e,7,203,12,215,15,2012-02-21 09:40:15,2012-02-21 09:40:15
e0722bedf828150b262c51f9920221bd3c28996e...1c8e498e1ec95eebfcd0bf1c9ade3ccc3f0d7bab,1,1,1,2,1,2012-02-23 09:00:02,2012-02-21 09:40:15
1c8e498e1ec95eebfcd0bf1c9ade3ccc3f0d7bab...e8e2d956a2573e508570aa4f10f65afc7fcba564,1,19,8,27,4,2012-02-23 09:00:25,2012-02-23 08:50:15
72fda4871af1ec7258c7769f03281b246d598669...58a2d651261de8e594087ac0c7f1c99eaf5dd940,22,18,45,63,26,2012-02-23 10:21:10,2012-02-23 10:20:49
58a2d651261de8e594087ac0c7f1c99eaf5dd940...3d8b3b6e1dd190c962496f1e639ad7983c4d58d9,5,184,3,187,7,2012-02-23 11:44:41,2012-02-23 11:44:41
3d8b3b6e1dd190c962496f1e639ad7983c4d58d9...97c3e50379084e5aed7e872c85fe17671d28e62c,15,250,116,366,53,2012-02-23 14:08:09,2012-02-23 13:55:31
97c3e50379084e5aed7e872c85fe17671d28e62c...09f210c9e46b1021f142323fb73e47cc491d53aa,3,5,5,10,6,2012-02-23 21:14:06,2012-02-14 00:21:31
09f210c9e46b1021f142323fb73e47cc491d53aa...9d3b86fa44dbe1a35b8b7eed84f193b92470f3ef,1,2,0,2,2,2012-02-23 22:46:42,2012-02-23 15:22:18
9d3b86fa44dbe1a35b8b7eed84f193b92470f3ef...c22899697648b24bd174905284bd07a357c40a03,1,1,1,2,1,2012-02-23 23:05:17,2012-02-23 23:04:46
c22899697648b24bd174905284bd07a357c40a03...f41d692cf59c3c9c0237b56ace770a2862e6dc1b,13,363,90,453,50,2012-02-29 08:42:38,2012-02-29 05:53:28
f41d692cf59c3c9c0237b56ace770a2862e6dc1b...16b2de8e8c4b985330cf0968afd2684dc855ca39,4,78,11,89,9,2012-02-29 09:08:22,2012-02-29 09:08:22
16b2de8e8c4b985330cf0968afd2684dc855ca39...4f04e0fb6a4b89f5ebad55d5f92edd183b1f0d69,1,3,1,4,1,2012-02-29 09:47:42,2012-02-29 09:47:42
4f04e0fb6a4b89f5ebad55d5f92edd183b1f0d69...72e37d87484ffb4833c339e11212186d9d2670fd,5,39,16,55,12,2012-02-29 10:04:33,2012-02-29 10:04:33
72e37d87484ffb4833c339e11212186d9d2670fd...5cf9351ecd5314c3476da9c7c45e658548faeeac,8,178,22,200,21,2012-02-29 12:36:51,2012-02-29 12:36:51
980868bc1b56e08a983494b3c03af3fe0f4995e9...5aeff801c3e3c653d5424b5bfc12a34f09f87a56,1,3,3,6,3,2012-02-29 21:16:16,2012-02-29 21:16:16
5aeff801c3e3c653d5424b5bfc12a34f09f87a56...cb887f5a9b66325581d9e63c3f2b32bca524868b,5,359,226,585,60,2012-03-01 00:08:58,2012-02-17 23:46:27
cb887f5a9b66325581d9e63c3f2b32bca524868b...b35af422c605611c2f6e0c8111912a69b707c8e0,1,1,11,12,2,2012-03-01 00:08:58,2012-02-25 18:16:18
b35af422c605611c2f6e0c8111912a69b707c8e0...c0b3df5a9185d623c6fe2bf011c1ff91450f1649,2,69,9,78,8,2012-03-01 00:08:58,2012-02-24 02:02:09
c0b3df5a9185d623c6fe2bf011c1ff91450f1649...8a8e4025104a4e78d45f118f4dd014b493428583,3,1,10,11,4,2012-03-01 00:08:59,2012-02-22 01:03:49
8a8e4025104a4e78d45f118f4dd014b493428583...3f1ff26e432c57d828dd8502ebf53c5b47c02071,3,10,22,32,4,2012-03-01 00:08:59,2012-02-23 22:36:36
3f1ff26e432c57d828dd8502ebf53c5b47c02071...d5fd6e8738f4b156c2f39a945ea949fa07f0e299,1,6,26,32,4,2012-03-01 00:08:59,2012-02-25 23:28:32
d5fd6e8738f4b156c2f39a945ea949fa07f0e299...55c9a27d946659d38986dc505d596d39524abb56,1,1,1,2,1,2012-03-01 00:09:00,2012-03-01 00:07:35
26d75bef7eaf65761697116103cc72afdf7f3d4d...68345e7c06d79c7d0766de7ad9a312a7fcc51893,2,115,83,198,17,2012-03-01 07:38:12,2012-03-01 07:38:12
68345e7c06d79c7d0766de7ad9a312a7fcc51893...e85226f21f2a2fb4ce236717c5bcc6a8ff0d36df,2,53,26,79,22,2012-03-01 10:37:00,2012-03-01 08:02:29
e85226f21f2a2fb4ce236717c5bcc6a8ff0d36df...ff9eaea2b8e03b4b88f6b18d0c1d181e11e302fb,1,54,46,100,10,2012-03-01 10:37:00,2012-03-01 08:09:23
ff9eaea2b8e03b4b88f6b18d0c1d181e11e302fb...d8b01cb7fbbda9a07ad890e82841c0a45e866e56,1,130,123,253,3,2012-03-01 10:37:00,2012-03-01 08:13:04
d8b01cb7fbbda9a07ad890e82841c0a45e866e56...071e055e7c565ab7d3e9b8c7438f01c78dda3572,1,69,62,131,5,2012-03-01 10:37:01,2012-03-01 08:19:47
071e055e7c565ab7d3e9b8c7438f01c78dda3572...5bfc4c472b40a06ca7caa1e2f18e897f2b0c9b5c,1,35,17,52,12,2012-03-01 10:37:01,2012-03-01 08:37:42
5bfc4c472b40a06ca7caa1e2f18e897f2b0c9b5c...c8b5052adddeb303dc5d5f3250e4ffbcd7f551a5,1,69,66,135,5,2012-03-01 10:37:01,2012-03-01 08:59:57
c8b5052adddeb303dc5d5f3250e4ffbcd7f551a5...605838fbfafd34415a7667a9c34b2632d04f0dec,1,8,8,16,4,2012-03-01 10:37:01,2012-03-01 09:04:57
605838fbfafd34415a7667a9c34b2632d04f0dec...a87c077f220811a8fa5ff92cf2134fec275886f3,1,96,84,180,11,2012-03-01 10:37:01,2012-03-01 09:42:35
a87c077f220811a8fa5ff92cf2134fec275886f3...671b1833a8e70d9ff55911d52b228516504003db,1,39,25,64,19,2012-03-01 10:37:01,2012-03-01 09:56:11
671b1833a8e70d9ff55911d52b228516504003db...363fb714430c06f00b89c603ed200f4b49ab2047,1,63,49,112,22,2012-03-01 10:37:01,2012-03-01 10:07:07
363fb714430c06f00b89c603ed200f4b49ab2047...1353d48c72517d68070eafac48dcbf9ba6ac6b9a,1,77,26,103,18,2012-03-01 10:37:01,2012-03-01 10:36:34
1353d48c72517d68070eafac48dcbf9ba6ac6b9a...3f51c557a594687e23779f4818e6370d3cbe0796,1,43,21,64,4,2012-03-01 11:04:35,2012-03-01 11:04:35
3f51c557a594687e23779f4818e6370d3cbe0796...8fc57d02fb7e0fa70184035d381fdb82897c03b1,2,18,2,20,6,2012-03-01 11:28:18,2012-03-01 11:28:18
8fc57d02fb7e0fa70184035d381fdb82897c03b1...e48f335e94844808f908432a24e8adb73815cf38,2,56,7,63,9,2012-03-01 11:56:10,2012-03-01 11:56:10
562a1a1122413d687b4742761ad67d8f38ef3f17...79aabd797bc44b3883fc690abe06ef3086d02bfa,2,26,20,46,13,2012-03-01 13:11:56,2012-03-01 13:11:56
79aabd797bc44b3883fc690abe06ef3086d02bfa...ddfbf236ce747606ac72cea3816bb4a315be0709,4,70,49,119,11,2012-03-02 01:25:36,2012-03-02 01:24:13
ddfbf236ce747606ac72cea3816bb4a315be0709...224f48cc816fce4a876ffa9e0f00f3ef320238b2,3,44,46,90,12,2012-03-02 03:37:05,2012-03-02 01:55:15
224f48cc816fce4a876ffa9e0f00f3ef320238b2...86951aa743cf2a968e3fede31b410c33fea141d7,3,50,18,68,14,2012-03-02 03:40:44,2012-03-02 03:40:44
9a61fb355404ccdf490c1d03261951f3d82639ce...60913bfd6fed6835bf54cd1e7a992f53e3104e03,4,123,58,181,29,2012-03-02 09:41:06,2012-03-02 08:01:07
60913bfd6fed6835bf54cd1e7a992f53e3104e03...bc69d57e167f6f0ff80ef614f2d555bc66c31573,2,14,9,23,8,2012-03-02 10:32:32,2012-03-02 10:32:32
bc69d57e167f6f0ff80ef614f2d555bc66c31573...a0877e26be05af217c43f1bc5f0362ed7c9ab47d,2,4,4,8,4,2012-03-02 11:18:18,2012-03-02 11:18:18
a0877e26be05af217c43f1bc5f0362ed7c9ab47d...c2302c9e46116d3082a0bc0763c2957385b7c08f,3,19,21,40,14,2012-03-02 11:27:55,2012-03-02 11:27:55
c2302c9e46116d3082a0bc0763c2957385b7c08f...cab5afbb91a31fd65199c98fca00ca8359d07b2c,13,664,664,1328,329,2012-03-02 11:57:30,2012-03-02 11:57:30
cab5afbb91a31fd65199c98fca00ca8359d07b2c...601f20553e199dcbf2d4c7ed58812b6a8c0c36d0,1,69,100,169,22,2012-03-02 12:22:57,2012-03-02 12:12:54
601f20553e199dcbf2d4c7ed58812b6a8c0c36d0...74dbbf3419bcf9228e30bd0e463b7293f10de53d,1,30,27,57,14,2012-03-02 12:43:03,2012-03-02 12:35:33
74dbbf3419bcf9228e30bd0e463b7293f10de53d...0822bd410faf8a2d1e23f3e5fc785ad80aa4d258,4,77,74,151,14,2012-03-02 13:08:06,2012-03-02 13:01:44
0822bd410faf8a2d1e23f3e5fc785ad80aa4d258...7729b7d887ecce57822311e7ecf88464a646eaea,1,19,22,41,19,2012-03-02 13:13:41,2012-03-02 13:13:41
7729b7d887ecce57822311e7ecf88464a646eaea...76c57526f7a65a0b2e392c3608c4be35df786815,13,45,46,91,39,2012-03-02 13:22:40,2012-03-02 13:22:40
ab7c06bade29e6700676b71196c4fd17f3a80588...dd6f013e9bf297616468b6737f03fa503b120c4a,5,117,44,161,21,2012-03-06 23:44:41,2012-03-03 07:54:02
dd6f013e9bf297616468b6737f03fa503b120c4a...d2baaedc9df7b0b7c4b60130a1c71b6e3b2636da,5,7,7,14,7,2012-03-06 23:44:41,2012-03-03 08:19:36
d2baaedc9df7b0b7c4b60130a1c71b6e3b2636da...14d41036f43fd4efa79db41bf35aff9d7be26651,14,45,37,82,22,2012-03-06 23:44:42,2012-03-03 08:39:15
14d41036f43fd4efa79db41bf35aff9d7be26651...3dc8dc2887fe2a1bd807ad0a6cfd3d3e4c6cb0d3,9,236,108,344,40,2012-03-06 23:44:42,2012-03-04 05:37:06
3dc8dc2887fe2a1bd807ad0a6cfd3d3e4c6cb0d3...25e82a2cff9e96d48e6db592b4aab13ff1605e4d,1,6,2,8,2,2012-03-06 23:45:22,2012-03-05 22:21:44
25e82a2cff9e96d48e6db592b4aab13ff1605e4d...ff1ec8bc141eb13f795f618136dafc8d30c81074,1,4,4,8,4,2012-03-06 23:45:24,2012-03-06 00:14:02
ff1ec8bc141eb13f795f618136dafc8d30c81074...10236609f4468d2f8815daf68867d31f813bdadf,1,3,1,4,3,2012-03-06 23:45:24,2012-03-06 04:58:17
10236609f4468d2f8815daf68867d31f813bdadf...435cb6e50f8402fa9cf6c37d3dbee7135e78ed85,1,48,34,82,10,2012-03-07 01:55:38,2012-03-07 01:47:34
435cb6e50f8402fa9cf6c37d3dbee7135e78ed85...ffd044b11d28775ae501ccaca3b79d640723eacc,1,8,2,10,4,2012-03-07 01:58:56,2012-03-07 01:58:34
ffd044b11d28775ae501ccaca3b79d640723eacc...a0d4947366208836cfc302d174a5db52af92b15b,1,13,5,18,7,2012-03-07 02:04:55,2012-03-07 02:04:55
a0d4947366208836cfc302d174a5db52af92b15b...21adb18ec62a61248e42c8a8fe7abc1ed922c378,3,127,0,127,5,2012-03-07 05:23:48,2012-03-07 05:23:48
21adb18ec62a61248e42c8a8fe7abc1ed922c378...47047621c9fea70d262c0b5e2908a5510d0842ae,1,60,26,86,15,2012-03-07 05:24:28,2012-03-07 05:24:28
47047621c9fea70d262c0b5e2908a5510d0842ae...734704205d1187f488a7146dbc9a112795b274d3,1,27,0,27,4,2012-03-07 07:18:41,2012-03-07 06:08:46
10236609f4468d2f8815daf68867d31f813bdadf...d65e5ed05829fe24496f622d1a3d3e7393ba8850,1,1,1,2,1,2012-03-06 23:59:49,2012-02-17 23:34:31
d65e5ed05829fe24496f622d1a3d3e7393ba8850...bbc167efc95b6ce57c0e733fe3b26d63c26a5e0c,1,52,1,53,2,2012-03-06 23:59:49,2012-02-17 05:31:38
bbc167efc95b6ce57c0e733fe3b26d63c26a5e0c...6be6c248afa6bc9a66aaaf5fe30da72d4df63c9c,1,23,3,26,4,2012-03-06 23:59:49,2012-02-17 07:14:58
6be6c248afa6bc9a66aaaf5fe30da72d4df63c9c...1a34cbdc99cc1597d1831a2ae0d1c5aa1d6e392e,1,9,3,12,2,2012-03-06 23:59:49,2012-02-17 23:44:52
1a34cbdc99cc1597d1831a2ae0d1c5aa1d6e392e...1c72f2ed907ec4a3f93a98ec7732d42e62ce961d,2,2,2,4,2,2012-03-06 23:59:49,2012-02-17 23:44:08
1c72f2ed907ec4a3f93a98ec7732d42e62ce961d...9bbe6af4a4c6d2874e2e4d8be3005c39ef9dcbf2,2,53,34,87,6,2012-03-06 23:59:50,2012-02-18 00:21:08
9bbe6af4a4c6d2874e2e4d8be3005c39ef9dcbf2...5656ae2687decc01adaeb4739463af74f18bbb40,1,11,1,12,1,2012-03-06 23:59:50,2012-02-18 00:51:38
5656ae2687decc01adaeb4739463af74f18bbb40...9c07d34428fbd246f62d884cf59bde968206e3d4,25,1037,0,1037,24,2012-03-06 23:59:50,2012-02-21 22:44:40
9c07d34428fbd246f62d884cf59bde968206e3d4...6037802e53b9f3b4488fc52431a98530286c0efb,18,0,966,966,18,2012-03-06 23:59:50,2012-02-21 22:48:20
6037802e53b9f3b4488fc52431a98530286c0efb...ba34c25de18ea6e2531c5e3ea74aa1d5e36d8fdf,4,26,1,27,5,2012-03-06 23:59:50,2012-02-21 22:55:00
ba34c25de18ea6e2531c5e3ea74aa1d5e36d8fdf...95b80fc61df1244608cd0e6713111fbeb6516e6f,2,676,37,713,6,2012-03-06 23:59:50,2012-02-21 22:56:48
95b80fc61df1244608cd0e6713111fbeb6516e6f...708b10953c50fcea94a8e26fdd56df217ce1f276,1,12,7,19,2,2012-03-06 23:59:50,2012-02-21 22:59:19
708b10953c50fcea94a8e26fdd56df217ce1f276...e29b00bf7a64383d83657fe1420339edc9aa3e29,2,26,25,51,4,2012-03-06 23:59:50,2012-02-21 22:25:49
e29b00bf7a64383d83657fe1420339edc9aa3e29...41fb1f643bc5958a3390df9d3ef480ca018c00fa,2,2,1,3,2,2012-03-06 23:59:50,2012-02-21 23:30:00
41fb1f643bc5958a3390df9d3ef480ca018c00fa...8fb4b674b5e3c33f80cb7e8c4d5f7ef9ba7e5c6b,1,3,2,5,3,2012-03-06 23:59:50,2012-02-21 23:33:17
8fb4b674b5e3c33f80cb7e8c4d5f7ef9ba7e5c6b...2a406ff0ff0f4d868769c0363de0426d4c8fa3a6,1,9,0,9,1,2012-03-06 23:59:50,2012-02-22 04:46:37
2a406ff0ff0f4d868769c0363de0426d4c8fa3a6...df92eb4af5974525bcf3c2af84778d98f9381c45,3,46,0,46,3,2012-03-06 23:59:50,2012-02-22 05:57:09
df92eb4af5974525bcf3c2af84778d98f9381c45...b9637bbeb52f1405d5705c8cca92da62e03c6f39,2,162,49,211,12,2012-03-06 23:59:50,2012-02-23 05:03:24
b9637bbeb52f1405d5705c8cca92da62e03c6f39...c242531e1424c3cbb770a0b7654f7d2507399024,2,5,0,5,2,2012-03-06 23:59:50,2012-02-23 05:24:23
c242531e1424c3cbb770a0b7654f7d2507399024...50efb009946cb736b83e3411116163cf56d57c2b,1,8,2,10,2,2012-03-06 23:59:50,2012-02-23 05:41:47
50efb009946cb736b83e3411116163cf56d57c2b...2eb3f09e177d6c1fff05144ca50fd5daab09ffb6,2,2,2,4,2,2012-03-06 23:59:50,2012-02-25 00:03:27
2eb3f09e177d6c1fff05144ca50fd5daab09ffb6...97380110140221540a729a57c374b6302554bd23,2,2,0,2,2,2012-03-06 23:59:50,2012-02-25 00:04:30
97380110140221540a729a57c374b6302554bd23...06fe111bb68698fa10363026c1641977ec0460af,1,26,0,26,1,2012-03-06 23:59:50,2012-02-25 02:13:47
06fe111bb68698fa10363026c1641977ec0460af...e83acb4aa2a678206e74dfb3e5c7fbee7006920f,2,186,52,238,14,2012-03-06 23:59:50,2012-02-25 00:04:57
e83acb4aa2a678206e74dfb3e5c7fbee7006920f...929d56a8a331ae4a44cece8a8b652048665c4b94,2,14,8,22,8,2012-03-06 23:59:51,2012-02-28 06:54:54
929d56a8a331ae4a44cece8a8b652048665c4b94...444faba4e82f36b609578cb8b6a24a3ecb969558,2,9,8,17,6,2012-03-06 23:59:51,2012-02-28 23:15:59
444faba4e82f36b609578cb8b6a24a3ecb969558...fb00497dd41b5950ae7e8f6e799e593c351aa7f8,1,7,0,7,1,2012-03-06 23:59:51,2012-02-29 05:29:22
fb00497dd41b5950ae7e8f6e799e593c351aa7f8...452795f1731f49ff702323609bc224697063aad9,1,20,23,43,4,2012-03-06 23:59:51,2012-02-29 05:30:15
452795f1731f49ff702323609bc224697063aad9...48bfdc6bd457420a0e0ea7de70a80f55d788f778,1,5,0,5,2,2012-03-06 23:59:51,2012-02-29 07:39:57
48bfdc6bd457420a0e0ea7de70a80f55d788f778...afd5ea38fb0bedd12ece28a3a86493b36388bc88,2,2,2,4,2,2012-03-06 23:59:51,2012-02-29 08:56:59
afd5ea38fb0bedd12ece28a3a86493b36388bc88...7227e9d880112e4b94b182b797bc4819a1e98ec4,1,1,1,2,1,2012-03-06 23:59:51,2012-02-29 08:57:16
7227e9d880112e4b94b182b797bc4819a1e98ec4...f94199e54b2cf03560ea056850a65ea5145f50d1,1,15,0,15,1,2012-03-06 23:59:51,2012-03-01 02:30:07
f94199e54b2cf03560ea056850a65ea5145f50d1...7b2f0682c77a02ac9f4c8a0e46fb6aaa7ba56387,3,7,7,14,6,2012-03-06 23:59:51,2012-03-03 05:32:54
7b2f0682c77a02ac9f4c8a0e46fb6aaa7ba56387...23aebb53101c6db5b3f7641571d23f76d0a218dd,1,2,2,4,1,2012-03-06 23:59:51,2012-03-06 00:48:17
23aebb53101c6db5b3f7641571d23f76d0a218dd...0f49ed440deff1fcf892e6c69d1b4f149e21c57a,2,4,4,8,4,2012-03-06 23:59:51,2012-03-06 04:19:22
0f49ed440deff1fcf892e6c69d1b4f149e21c57a...f7824d096b5fa1bfa78b2fe39e675bbb53dbbd77,2,2,2,4,2,2012-03-06 23:59:51,2012-02-25 06:14:54
f7824d096b5fa1bfa78b2fe39e675bbb53dbbd77...3a62cb15cdd2dc16e8e19966f1814aa645e08c1c,2,21,17,38,16,2012-03-07 02:34:21,2012-03-07 01:24:51
2704a3894c32a0438c81e5cd0bf0e30b100d893a...ec25f76866734dc1d14cd65167105415c1840362,6,9,9,18,7,2012-03-07 02:36:31,2012-03-07 01:53:33
ec25f76866734dc1d14cd65167105415c1840362...0a7312755c723857cd6e2b32c7b8902b513b2a88,1,1,1,2,1,2012-03-07 02:55:33,2012-03-07 02:55:33
8746fb46359db05828e6ac96ce7b268808ba79ba...f0e67690768e84ab8e091d68944c28c03fabe25c,1,3,2,5,1,2012-03-07 07:57:34,2012-03-07 07:57:34
f0e67690768e84ab8e091d68944c28c03fabe25c...168bc8e57088c7fc90bd67aa310c0d3517043cec,2,4,4,8,2,2012-03-07 08:24:53,2012-03-07 08:24:53
168bc8e57088c7fc90bd67aa310c0d3517043cec...dc880b1d1e07a2b66f6ee9b5cf64c5ae1064458f,3,11,1,12,3,2012-03-07 09:47:35,2012-03-07 09:47:35
dc880b1d1e07a2b66f6ee9b5cf64c5ae1064458f...c327f75f68c928bf513f61d5993a79b769f94c82,1,2,0,2,2,2012-03-07 10:27:33,2012-03-07 10:27:33
c327f75f68c928bf513f61d5993a79b769f94c82...827113943803518481408654618d99bd1e08339d,1,2,2,4,2,2012-03-08 00:03:40,2012-03-08 00:02:44
827113943803518481408654618d99bd1e08339d...330fcc1e50c92a21b5c1eb913a6539e74dfc7d6e,1,1,1,2,1,2012-03-08 00:35:38,2012-03-08 00:35:38
330fcc1e50c92a21b5c1eb913a6539e74dfc7d6e...5b00c13d82a844237ef983d3c8af3d82ba596a1a,1,0,3,3,1,2012-03-08 00:37:17,2012-03-08 00:37:17
5b00c13d82a844237ef983d3c8af3d82ba596a1a...97d17379b31f8129bde83ead53e878a778a5fe8d,1,1,1,2,1,2012-03-08 18:16:59,2012-03-08 18:16:59
5b00c13d82a844237ef983d3c8af3d82ba596a1a...df8460130f8810ef877c3167c12f49a4561ed574,1,6,1,7,1,2012-03-08 02:18:30,2012-03-08 02:08:59
b3310fcc3cde91eef6ffa667d26e50e7ce0b93bb...d6939c8382c761aa6feb834922b58f57c222ad27,1,4,5,9,1,2012-03-09 01:04:49,2012-03-09 01:04:49
d6939c8382c761aa6feb834922b58f57c222ad27...d20b040e2cf1c06ef219e367c9e5008811e5c6da,1,2,2,4,2,2012-03-09 01:05:06,2012-03-09 01:05:06
d20b040e2cf1c06ef219e367c9e5008811e5c6da...922ff16118adce76895b2e96d9c16a4f8085c7e8,1,2,1,3,1,2012-03-09 02:39:48,2012-03-09 02:39:48
922ff16118adce76895b2e96d9c16a4f8085c7e8...25122880a3d73069fef62ee17765f4318153d5a9,1,4,2,6,2,2012-03-09 02:40:19,2012-03-09 02:40:19
25122880a3d73069fef62ee17765f4318153d5a9...d216630d0edec8cf5c0734e2ab6f702fb9aa4cb3,3,168,150,318,6,2012-03-09 23:30:53,2012-03-09 23:30:53
d216630d0edec8cf5c0734e2ab6f702fb9aa4cb3...86ed80d5811db37362373da70166c3186f1a5980,2,120,100,220,22,2012-03-10 00:55:21,2012-03-10 00:55:21
86ed80d5811db37362373da70166c3186f1a5980...c537b9de0302a431b8709579954f16878c8f920e,1,49,0,49,1,2012-03-10 02:43:38,2012-03-10 02:43:38
03071baeab1424ce03e58b93df9f5a7703d63f08...07aa35658791cdba83c2a92edff3d09e3b8d85b5,1,69,68,137,34,2012-03-13 04:14:55,2012-03-13 04:14:36
07aa35658791cdba83c2a92edff3d09e3b8d85b5...56d2ac669cd89e67f270c04f6c2f2542ecb60343,5,0,0,0,0,2012-03-13 04:23:19,2012-03-13 04:23:19
56d2ac669cd89e67f270c04f6c2f2542ecb60343...e0f7c6dd3723e25d0fce5eedd7ea6e6ce42f15d0,11,0,0,0,0,2012-03-13 04:36:52,2012-03-13 04:36:52
e0f7c6dd3723e25d0fce5eedd7ea6e6ce42f15d0...26a9236160051600da6558e22d494ebb7c9ff34b,5,103,46,149,21,2012-03-13 07:00:19,2012-03-13 07:00:19
26a9236160051600da6558e22d494ebb7c9ff34b...bb575138e5c8945fefbcd0432265e1091e583dcb,1,8,4,12,1,2012-03-14 23:30:58,2012-03-14 23:30:06
bb575138e5c8945fefbcd0432265e1091e583dcb...d318a1c1350922e640d6e143719c6de4e51ac925,3,31,1,32,4,2012-03-15 02:28:22,2012-03-15 02:28:22
d318a1c1350922e640d6e143719c6de4e51ac925...ef46d1ea5804a550ff5f715a15a36243440feab4,10,68,62,130,34,2012-03-16 09:55:14,2012-03-15 03:20:19
ef46d1ea5804a550ff5f715a15a36243440feab4...784529a9af86b32045d4d17c575ac073323a064f,2,29,8,37,5,2012-03-16 09:55:14,2012-03-15 09:34:21
784529a9af86b32045d4d17c575ac073323a064f...c9b14233bbab7694897afd43e53654e9983724aa,1,6,0,6,3,2012-03-16 09:55:14,2012-03-15 09:49:47
c9b14233bbab7694897afd43e53654e9983724aa...7be206b11a7694d9770dd58ba0198831af90552e,2,210,90,300,37,2012-03-16 09:55:14,2012-03-15 07:54:43
7be206b11a7694d9770dd58ba0198831af90552e...6de5ab62ce82dd0fb967d8d4dc9d1a44ceefd3ec,7,429,386,815,62,2012-03-16 09:55:14,2012-03-16 03:28:32
6de5ab62ce82dd0fb967d8d4dc9d1a44ceefd3ec...413c0778b52fce4f87e6ad3b3935e1ca40f8d4f0,4,99,99,198,4,2012-03-16 09:55:14,2012-03-16 09:22:47
413c0778b52fce4f87e6ad3b3935e1ca40f8d4f0...176dd68199d2b00e205885357c11d90e7240e8a6,2,13,0,13,4,2012-03-16 09:55:14,2012-03-16 09:40:44
176dd68199d2b00e205885357c11d90e7240e8a6...6ed6fa75b5731fc418f3ba6a25a33f23e47e9fd4,2,10,0,10,2,2012-03-16 09:55:14,2012-03-16 09:42:54
6ed6fa75b5731fc418f3ba6a25a33f23e47e9fd4...c6cedac7eb7c3bdb73e67a6cebb8a4f68f6a4c46,4,65,2,67,7,2012-03-16 09:55:14,2012-03-16 09:43:20
c6cedac7eb7c3bdb73e67a6cebb8a4f68f6a4c46...8cdadb376216a4fe142fe68a6a79ad4441a718f4,4,8,9,17,4,2012-03-16 09:55:14,2012-03-16 09:50:18
2eea42433e96bf6373a0159fe5c000ca9aa7f2db...0187ee6db47ffc3cb05738d2f4f7e15747e873f0,1,9,4,13,3,2012-03-16 22:00:34,2012-03-16 03:32:26
0187ee6db47ffc3cb05738d2f4f7e15747e873f0...d7dd1d9408b12a69e4edfa6d2fc4e22379feeaa1,1,1,1,2,1,2012-03-16 22:55:57,2012-03-16 22:55:57
d7dd1d9408b12a69e4edfa6d2fc4e22379feeaa1...b3fc3150d4afcce5399e046bc1244996ba0e77e0,7,12,11,23,9,2012-03-17 01:26:19,2012-03-17 01:25:16
b3fc3150d4afcce5399e046bc1244996ba0e77e0...3edf56e7af0112994385c4c597713c1f2c4615a1,1,2,3,5,1,2012-03-17 01:26:19,2012-03-17 00:48:45
3edf56e7af0112994385c4c597713c1f2c4615a1...3b520997b185011acfc8d9de72bceceaed203c4d,1,57,7,64,3,2012-03-17 04:11:07,2012-03-17 04:09:33
3b520997b185011acfc8d9de72bceceaed203c4d...a00ee6357492756ecd435c7746d8d24d5f0064fc,1,111,0,111,1,2012-03-17 04:11:08,2012-03-17 00:30:50
a00ee6357492756ecd435c7746d8d24d5f0064fc...4bfc287e5def4e0a1f47d8ad9c71566eaaacf029,1,57,34,91,8,2012-03-17 04:11:08,2012-03-17 01:34:28
4bfc287e5def4e0a1f47d8ad9c71566eaaacf029...c946fc177fb6afae17c7a0eaac0051f46b2ce996,1,1,2,3,2,2012-03-17 06:33:49,2012-03-17 06:33:49
c946fc177fb6afae17c7a0eaac0051f46b2ce996...5c72fcaacc11f23363748ca3af8fde961bf210e9,2,12,6,18,2,2012-03-17 06:36:33,2012-03-17 06:36:33
1961ba0d0416ca21822c4cf8abf9527cf1a99e32...ad69114d0ba6840f2baf6dd380c4630f19283de7,1,1,1,2,1,2012-03-19 21:25:22,2012-03-19 21:25:22
ad69114d0ba6840f2baf6dd380c4630f19283de7...6c716ca6dfaaabbd1fef442cbff5b5650c85e856,1,2,1,3,1,2012-03-19 21:26:07,2012-03-19 21:26:07
6c716ca6dfaaabbd1fef442cbff5b5650c85e856...1f36a7eda37dd6c9129433c64400997067c99f6a,1,2,2,4,1,2012-03-20 00:05:33,2012-03-20 00:05:26
1f36a7eda37dd6c9129433c64400997067c99f6a...df3726d848cf2fd4143ee1f4645592bde509f3f0,2,15,9,24,9,2012-03-20 06:00:16,2012-03-20 05:21:41
df3726d848cf2fd4143ee1f4645592bde509f3f0...6795c65d9c741e611526eacfea0a14b2bcc3ec1b,1,6,0,6,1,2012-03-20 06:00:16,2012-03-20 05:21:56
6795c65d9c741e611526eacfea0a14b2bcc3ec1b...7377ce2041145cf1cd7b728f47ade3d5da8168aa,21,2304,1806,4110,303,2012-03-20 23:55:30,2012-03-12 00:06:05
7377ce2041145cf1cd7b728f47ade3d5da8168aa...c511a6fb9dc76ff7899fb68c3620dddc8bbb137a,1,13,0,13,1,2012-03-20 23:55:30,2012-03-19 23:54:38
c511a6fb9dc76ff7899fb68c3620dddc8bbb137a...a59f501b37e1533e3e8c9f22ea5061432488f02c,7,807,839,1646,156,2012-03-20 23:55:34,2012-03-20 03:48:50
7fa1fc572bc8d5c672d0094b13e792d7d8487dd8...2355a7a88bc55e68984f19f594beea7e920ae388,1,1,1,2,1,2012-03-20 23:57:39,2012-03-20 23:57:39
2355a7a88bc55e68984f19f594beea7e920ae388...76fd14132aa84e12d07c37722c56872565dc359b,2,6,2,8,3,2012-03-21 00:00:11,2012-03-20 20:55:59
76fd14132aa84e12d07c37722c56872565dc359b...f1ec9c148f1954990ccac27cff12693dd38ea8a3,6,9,9,18,7,2012-03-21 00:01:25,2012-03-21 00:01:25
f1ec9c148f1954990ccac27cff12693dd38ea8a3...f36dac2fa5908c334597bde6e809dbfeec1cb487,1,0,0,0,0,2012-03-21 00:22:51,2012-03-21 00:22:51
f36dac2fa5908c334597bde6e809dbfeec1cb487...0ff47c4d746199e78e141c6006e025ec5b27a566,1,0,1,1,1,2012-03-21 00:29:25,2012-03-21 00:29:11
0ff47c4d746199e78e141c6006e025ec5b27a566...01c6e08b93d8c3fae6d658ab84b496abc40f78be,1,5,0,5,1,2012-03-22 02:41:06,2012-03-22 02:40:56
01c6e08b93d8c3fae6d658ab84b496abc40f78be...39224837ec93bce83e9df8f58c2d04765318530e,10,1294,83,1377,33,2012-03-29 00:57:29,2012-03-21 22:13:31
002f8a61df1db2ce16279af9c10f367072d9af00...4f0c7d061d898ebcd49fae88f2070c30aa75cc9f,1,5,9,14,5,2012-03-29 01:26:15,2012-03-26 19:15:09
4f0c7d061d898ebcd49fae88f2070c30aa75cc9f...fb9376759adb7dda54cddb0bf5517bc05e5f3119,3,38,2,40,4,2012-03-29 01:26:15,2012-03-27 01:17:28
fb9376759adb7dda54cddb0bf5517bc05e5f3119...27a15af421f30a5e9a4524969049eecb8063b9b1,2,2,2,4,2,2012-03-29 01:26:15,2012-03-29 01:10:00
27a15af421f30a5e9a4524969049eecb8063b9b1...5a1ecf6d163b4624ddece0a498ef6dba47973963,5,20,3,23,6,2012-03-29 01:26:15,2012-03-29 01:10:36
5a1ecf6d163b4624ddece0a498ef6dba47973963...48947a46bf7204367dcd3294c93d55e2f36e01eb,2,1,1,2,1,2012-03-30 23:26:04,2012-03-30 23:19:42
a43976c6724e595e2d4e6d42d5cd5f06abe2e240...8209ff545cd4a6f33b2aad934895c5b76b4437c7,3,60,58,118,17,2012-04-03 23:19:30,2012-04-03 23:19:30
8209ff545cd4a6f33b2aad934895c5b76b4437c7...675a08f868e999a5e8002fd51f74392a91597b61,1,2,2,4,2,2012-04-04 03:44:20,2012-04-04 03:44:20
675a08f868e999a5e8002fd51f74392a91597b61...89ce396ae531499b97be681e60b0172733fc8f43,17,2572,1656,4228,208,2012-04-04 05:10:20,2012-02-02 03:47:38
89ce396ae531499b97be681e60b0172733fc8f43...3d935b6dab7cbaa98ea4edc7195f3b853af0e2bd,7,531,293,824,73,2012-04-04 05:10:21,2012-03-26 18:25:13
3d935b6dab7cbaa98ea4edc7195f3b853af0e2bd...82ac8e324e3239ec4505e7b6ca635ffe3ba912c9,2,93,13,106,7,2012-04-04 05:10:21,2012-03-29 01:11:21
82ac8e324e3239ec4505e7b6ca635ffe3ba912c9...d73c18aae5a68ca487f5f88d08125fa0a748d559,2,36,1,37,3,2012-04-04 05:10:21,2012-03-30 08:19:32
d73c18aae5a68ca487f5f88d08125fa0a748d559...8f693a317577c2ed23fcfbef5d4b393d6b8e3c3a,1,1,1,2,1,2012-04-04 05:10:21,2012-03-30 02:14:35
8f693a317577c2ed23fcfbef5d4b393d6b8e3c3a...f6a5c903e044f37c2aaae16ba8d4209e7b7ff30d,1,55,68,123,12,2012-04-04 05:30:17,2012-04-03 03:02:08
f6a5c903e044f37c2aaae16ba8d4209e7b7ff30d...ee3d306adc04f5a071a9ca5be7c092abbcbd1fc5,9,100,95,195,46,2012-04-04 05:30:54,2012-04-04 04:09:37
ee3d306adc04f5a071a9ca5be7c092abbcbd1fc5...70a1fd6acb9f65535139d754dd0bfd982f4e24d0,1,1,1,2,1,2012-04-04 05:30:56,2012-04-04 04:16:57
70a1fd6acb9f65535139d754dd0bfd982f4e24d0...eab71e3bbb9cbeff21d5df3a87f33d8276d3981c,2,14,29,43,8,2012-04-04 05:30:56,2012-04-04 04:28:59
eab71e3bbb9cbeff21d5df3a87f33d8276d3981c...3dc7c83da014fb480bf1b8ea450d9e6d8784e4fd,2,6,6,12,6,2012-04-04 05:30:56,2012-04-04 04:39:56
b0f7e18901ed98e96636c14496ea48cd7b31c56d...ee1d25f4992bf42942869e0a9931fa0501379f5d,5,151,34,185,26,2012-04-04 05:37:11,2012-03-22 05:21:58
ee1d25f4992bf42942869e0a9931fa0501379f5d...bf04fccb72a6915698d0b617c7981d5c0c5a4b85,9,479,120,599,33,2012-04-04 05:37:11,2012-03-17 08:54:21
bf04fccb72a6915698d0b617c7981d5c0c5a4b85...4dc8944fb446080a4f54908fa53f6cd7de9f3cfe,2,10,6,16,7,2012-04-04 05:37:11,2012-03-26 16:56:09
4dc8944fb446080a4f54908fa53f6cd7de9f3cfe...39256dc52f8069e44dc51fec7ab6a6b0416209b1,1,4,6,10,3,2012-04-04 05:37:12,2012-03-27 00:42:30
39256dc52f8069e44dc51fec7ab6a6b0416209b1...4f89af1aaa28e5ca3ddebc9262b0bb8054281af4,1,181,22,203,5,2012-04-04 05:37:12,2012-03-27 00:43:33
4f89af1aaa28e5ca3ddebc9262b0bb8054281af4...550fabf052ef309d9761a717606b3aa740373fcd,5,446,4,450,6,2012-04-04 05:37:12,2012-03-28 02:02:06
550fabf052ef309d9761a717606b3aa740373fcd...dede19395d06f71e85683d958adca1c559bf532a,1,0,4,4,1,2012-04-04 05:37:12,2012-03-29 02:50:44
dede19395d06f71e85683d958adca1c559bf532a...9ec8922817ee4535ff31bfa7035ba23e3bf6d4d0,1,2,5,7,3,2012-04-04 05:37:12,2012-03-29 18:48:16
9ec8922817ee4535ff31bfa7035ba23e3bf6d4d0...f2d55ccd701d95557fb637720ef69ecc1d5881e3,1,6,1,7,1,2012-04-04 05:37:12,2012-03-29 20:10:37
f2d55ccd701d95557fb637720ef69ecc1d5881e3...c09190366e7780cafadd17394a4558bdd2def27e,1,31,10,41,10,2012-04-04 05:37:12,2012-03-29 23:41:44
c09190366e7780cafadd17394a4558bdd2def27e...5c43f21372e6a2c01694b3cb178202decbf1914e,1,2,2,4,2,2012-04-04 05:37:12,2012-03-29 23:47:29
5c43f21372e6a2c01694b3cb178202decbf1914e...81c1de24e3909c832dd3525b40ae4e6bdf1314cb,1,24,10,34,1,2012-04-04 05:37:12,2012-03-30 00:05:13
81c1de24e3909c832dd3525b40ae4e6bdf1314cb...a3ea86a4c655398fb26387df9bb72815c32031ea,1,9,0,9,1,2012-04-04 05:37:12,2012-04-03 05:15:16
a3ea86a4c655398fb26387df9bb72815c32031ea...dc2902dde000a49c4bd0996e1cac70ecc03bb5af,1,6,3,9,3,2012-04-04 05:37:12,2012-04-04 04:09:53
dc2902dde000a49c4bd0996e1cac70ecc03bb5af...04d8b284e0a8a77777edbf6213dbf4926d4c0108,1,4,2,6,3,2012-04-04 05:37:12,2012-04-04 04:44:19
04d8b284e0a8a77777edbf6213dbf4926d4c0108...d56725dd6a7efbc4b5953eb0d381ac0957abf100,4,2,10,12,3,2012-04-04 05:37:12,2012-04-04 04:52:21
d56725dd6a7efbc4b5953eb0d381ac0957abf100...ad4f4ffa5af7084ca27cab1289ea3c838aa212e4,1,1,6,7,3,2012-04-04 05:37:12,2012-04-04 04:57:40
1f021cf670cae968a0bca9537c121f782ece5311...df8567dba38f415fcae3134a8a8ac4a22375914d,2,19,4,23,9,2012-04-04 05:40:36,2012-03-28 23:25:19
df8567dba38f415fcae3134a8a8ac4a22375914d...29471cb4b8c1c1f164fce6a8e830d0c7424dbfe5,1,5,1,6,2,2012-04-04 05:40:36,2012-03-29 00:36:49
2d78774a04b6c1dc2b3d6ee96b86fce8568c8cc5...91c3d01f44cac7a3138ef34284b2c25e15ec2f16,1,7,28,35,4,2012-04-04 06:46:43,2012-04-04 06:46:43
91c3d01f44cac7a3138ef34284b2c25e15ec2f16...852c3349bf0a8ea1b10e6e9573f9f394ec821ee8,2,31,1,32,2,2012-04-04 23:20:15,2012-04-04 23:05:57
852c3349bf0a8ea1b10e6e9573f9f394ec821ee8...5d0388c5b8c9525ca073040aa120d68c8b7268ec,4,70,1279,1349,22,2012-04-05 00:14:50,2012-04-05 00:14:50
5d0388c5b8c9525ca073040aa120d68c8b7268ec...42f908a73cb628e48548bd84b9feccae0fa682ab,2,4,4,8,4,2012-04-05 00:16:35,2012-04-05 00:13:48
42f908a73cb628e48548bd84b9feccae0fa682ab...62e2b1974673615b889ee46dd90823d8f983a727,1,2,4,6,1,2012-04-05 00:47:40,2012-04-05 00:47:13
62e2b1974673615b889ee46dd90823d8f983a727...6c32d547accf40c6f44ace12f88b9f675e0476c7,1,5,8,13,7,2012-04-05 00:57:59,2012-04-05 00:57:59
6c32d547accf40c6f44ace12f88b9f675e0476c7...21708cab77cf49715df94f33e170e669736c0996,3,169,117,286,29,2012-04-05 01:07:26,2012-04-04 21:24:34
21708cab77cf49715df94f33e170e669736c0996...419ee84ef1da183aac152f4d3df431277dc5322c,6,9,9,18,7,2012-04-05 01:33:54,2012-04-05 01:33:54
419ee84ef1da183aac152f4d3df431277dc5322c...69cd6a646cd1dbb3f65d4c7da742a7dbd9bbb099,2,88,49,137,20,2012-04-05 18:01:27,2012-04-05 18:01:27
69cd6a646cd1dbb3f65d4c7da742a7dbd9bbb099...f743bac7d6de6f9e399a445dd63f2245669b25f8,4,164,178,342,52,2012-04-05 19:28:43,2012-04-05 19:28:43
f743bac7d6de6f9e399a445dd63f2245669b25f8...714b5d2837a2cdff986123a6594fe4e50eacb8a2,2,45,31,76,19,2012-04-05 22:04:33,2012-04-05 22:04:33
714b5d2837a2cdff986123a6594fe4e50eacb8a2...2093fa8928c25779a7130493ad92ae23dd5be3d5,3,36,35,71,16,2012-04-05 22:34:13,2012-04-05 22:34:13
2093fa8928c25779a7130493ad92ae23dd5be3d5...117e9e04675447eed977820f88621b09a0c72858,6,148,126,274,52,2012-04-05 23:47:04,2012-04-05 23:47:04
117e9e04675447eed977820f88621b09a0c72858...4433e78b1c3f97ba4f82bad5191a830f28e9142a,3,17,9,26,7,2012-04-06 00:20:06,2012-04-06 00:20:06
eef4357e0fcf233461f95672c474a8ac09b7beba...536bf59c1c6e7b9020e93602011728bc38642efc,2,55,16,71,7,2012-04-06 00:47:15,2012-04-06 00:31:47
eb53189eeebfd801d1b894c8956b7012e30b0448...028f052f24056958bf6618f5dcc1e954e078ac78,1,4,1,5,2,2012-04-06 00:51:48,2012-04-06 00:31:41
028f052f24056958bf6618f5dcc1e954e078ac78...f894cce90772d91c774cc10573377729a02e34e6,1,3,4,7,2,2012-04-06 00:51:48,2012-04-06 00:31:52
f894cce90772d91c774cc10573377729a02e34e6...365325457809fdbc6aa475adc2ec5f7028c13894,2,2,2,4,2,2012-04-06 00:51:48,2012-04-06 00:32:18
13cc68e3be366a106fd3a4386a443e403735d077...81ba92c207af5f32d9b225af6c60575cb4a894a4,1,1,1,2,1,2012-04-06 01:15:33,2012-04-06 01:15:33
81ba92c207af5f32d9b225af6c60575cb4a894a4...848ae0470e8f22dcef7e724a1be3adae6a785bd6,3,7,3,10,2,2012-04-06 05:22:39,2012-04-06 05:22:39
848ae0470e8f22dcef7e724a1be3adae6a785bd6...149438466a3f6d8ec3902bd90a268ee227ca2162,2,59,0,59,2,2012-04-06 07:51:26,2012-04-06 07:51:26
6f63d5dea56e421b899631afe94b9d09f24f155f...6e5ccb8fdac4465e7d5f6bfd543fc10259d9b772,1,1,1,2,1,2012-04-06 21:25:58,2012-04-06 21:25:28
6e5ccb8fdac4465e7d5f6bfd543fc10259d9b772...1a503d1abf42abf39e7dd056f9f6497a3d15d3c4,1,32,1,33,4,2012-04-06 23:36:39,2012-04-06 23:36:39
1a503d1abf42abf39e7dd056f9f6497a3d15d3c4...6bed8754d49f98d929edce3de280b1e7c65e69b0,1,26,22,48,4,2012-04-07 00:41:09,2012-04-06 23:04:50
6bed8754d49f98d929edce3de280b1e7c65e69b0...c0111811c4df741c845bc28354b3f77c86f58868,1,19,1,20,3,2012-04-07 00:41:10,2012-04-07 00:30:29
d1d69cc35900a2bfa39e4af8d95822231266c21d...e805d56e430eaaba92b23e81f5bdbddeb097db22,2,0,30,30,2,2012-04-08 03:00:18,2012-04-08 03:00:18
e805d56e430eaaba92b23e81f5bdbddeb097db22...edea43ee9b0db16475199ee402b7a6c849244e8d,2,0,9,9,2,2012-04-08 03:07:55,2012-04-08 03:07:55
edea43ee9b0db16475199ee402b7a6c849244e8d...4cca9a8082c400ea0df5f9a2e802b4a1947491ce,1,16,1,17,2,2012-04-08 17:13:57,2012-04-08 17:13:57
4cca9a8082c400ea0df5f9a2e802b4a1947491ce...616999615e54af5980234ec7435dd998254156de,2,2,0,2,1,2012-04-09 18:24:11,2012-04-09 18:24:11
616999615e54af5980234ec7435dd998254156de...d7e35f3597db43ed348a739dc53846a6e6a848c3,1,1,0,1,1,2012-04-09 21:05:22,2012-04-09 21:05:22
d7e35f3597db43ed348a739dc53846a6e6a848c3...150a11bfa86ccd37b5df6651aa61f4d720ee6a8d,9,56,100,156,20,2012-04-09 22:00:21,2012-04-09 21:09:27
150a11bfa86ccd37b5df6651aa61f4d720ee6a8d...486a63f41b01b1ca518be6f7f8787e0536100b5c,3,315,1282,1597,15,2012-04-09 22:34:20,2012-04-09 22:34:20
486a63f41b01b1ca518be6f7f8787e0536100b5c...3dcfe65854a35e9b8a8b3125620ab4c5c30fdca7,1,26,9,35,8,2012-04-10 01:32:17,2012-04-10 01:32:17
3dcfe65854a35e9b8a8b3125620ab4c5c30fdca7...dbd7b1e71b26fcdde0e61f82cb40cf3a680b386f,1,7,3,10,3,2012-04-10 05:00:34,2012-04-10 05:00:34
dbd7b1e71b26fcdde0e61f82cb40cf3a680b386f...e89ba2c262a715a07db1483bb55019d38ec6cd84,6,9,9,18,7,2012-04-10 06:31:31,2012-04-10 06:31:31
e89ba2c262a715a07db1483bb55019d38ec6cd84...fab90d53ce11e6079a92d8651a5ebd11f623c2b3,2,2,2,4,2,2012-04-10 08:09:13,2012-04-10 08:09:13
fab90d53ce11e6079a92d8651a5ebd11f623c2b3...3de4aa72c085425b5504412f5b0b2c60462dc44f,1,11,8,19,2,2012-04-10 08:25:59,2012-04-10 08:25:09
3de4aa72c085425b5504412f5b0b2c60462dc44f...b6187909cc399d4306219b0bc9f08d9d9f535879,4,41,83,124,14,2012-04-10 11:34:05,2012-04-10 11:32:18
b6187909cc399d4306219b0bc9f08d9d9f535879...133338ac39c293ec2b1664282232d557bdce54ce,2,13,6,19,5,2012-04-10 18:08:41,2012-04-10 18:08:41
133338ac39c293ec2b1664282232d557bdce54ce...e0e696387d4ae2115b9b9ace07a1ba2fcf291184,1,3,6,9,3,2012-04-10 19:01:54,2012-04-10 19:01:54
e0e696387d4ae2115b9b9ace07a1ba2fcf291184...6934fb2efb208288aedb35a1b2056c1a680ebe14,1,19,19,38,5,2012-04-10 19:04:00,2012-04-10 19:03:36
6934fb2efb208288aedb35a1b2056c1a680ebe14...0a0a4bbb8705a942836b46570556ddcbd3f1a3fb,1,1,1,2,1,2012-04-10 19:06:41,2012-04-10 19:06:41
133338ac39c293ec2b1664282232d557bdce54ce...13e494cc23b658eb517170393078195504799256,11,174326,0,174326,10,2012-04-10 18:10:47,2012-01-09 19:28:43
13e494cc23b658eb517170393078195504799256...b40c23ec90b4bf52d11be545887dae8f01fe95e5,3,35,7,42,9,2012-04-10 18:10:47,2012-04-10 03:49:10
b40c23ec90b4bf52d11be545887dae8f01fe95e5...3c638d8f75b286001ebe09a543526d63650da4c0,4,35,13,48,9,2012-04-10 18:10:47,2012-04-10 04:34:46
3c638d8f75b286001ebe09a543526d63650da4c0...bba2469278bd6a2a24b9fd86e43a27b5f231c7e9,4,38,2,40,6,2012-04-10 18:10:47,2012-04-10 05:26:19
bba2469278bd6a2a24b9fd86e43a27b5f231c7e9...95cd398e073105f312097ac070752537a974d5a4,3,37,22,59,18,2012-04-10 18:10:47,2012-04-10 17:52:50
95cd398e073105f312097ac070752537a974d5a4...e23b309ceebc1145bda520112d464fab219c9170,3,17,5,22,5,2012-04-10 18:24:49,2012-04-10 18:23:17
926f70bf8222a0926690ad1be62bf4fff250640f...390317935e56f40d306a74f2b57ca3c828475733,1,0,4,4,1,2012-04-10 19:14:29,2012-04-10 19:14:29
390317935e56f40d306a74f2b57ca3c828475733...ca5990f476475f3f194d085ff9eb7115c6cef0ed,6,9,9,18,7,2012-04-10 19:19:47,2012-04-10 19:19:47
ca5990f476475f3f194d085ff9eb7115c6cef0ed...7ff1093eba53e3581278319c5194e2dc04d42314,1,5,0,5,2,2012-04-16 10:23:41,2012-04-16 10:23:41
ca5990f476475f3f194d085ff9eb7115c6cef0ed...c2d6608242bd5d3ab841f95a7664d875502e3d32,1,2,2,4,2,2012-04-16 10:21:10,2012-04-16 10:21:10
ca5990f476475f3f194d085ff9eb7115c6cef0ed...6d57f14ec65301fd83ac791846865812b0209036,1,7,0,7,1,2012-04-15 00:05:58,2012-04-15 00:05:58
ca5990f476475f3f194d085ff9eb7115c6cef0ed...b30a3d563490f481f117c62fc87933ff940890d3,1,2,2,4,2,2012-04-13 23:37:42,2012-04-13 23:37:42
ca5990f476475f3f194d085ff9eb7115c6cef0ed...a4f656c8dd287166d5ddb6614fce0cbf75277624,1,1,1,2,1,2012-04-13 17:38:16,2012-04-13 17:38:16
ca5990f476475f3f194d085ff9eb7115c6cef0ed...5b61091665fa2ed9599076df2ab59720f167502c,1,1,1,2,1,2012-04-12 05:25:06,2012-04-12 05:25:06
ca5990f476475f3f194d085ff9eb7115c6cef0ed...6a50711cc5022181f7a395eb951f71a367ebff0d,1,0,1,1,1,2012-04-11 21:07:32,2012-04-11 21:07:32
6a50711cc5022181f7a395eb951f71a367ebff0d...95e32f069d065c3c5e84c02afa765d67cb7fd027,2,9,7,16,5,2012-04-11 21:20:13,2012-04-11 21:20:13
95e32f069d065c3c5e84c02afa765d67cb7fd027...54c1525667f7f0e06f2e0e09b09de34ab7f6f5eb,1,1,1,2,1,2012-04-11 21:35:39,2012-04-11 21:35:39
54c1525667f7f0e06f2e0e09b09de34ab7f6f5eb...d1b7c603600d966768d5eb5e276f57c15f5fe66f,1,19,10,29,1,2012-04-11 22:01:52,2012-04-11 22:01:52
d1b7c603600d966768d5eb5e276f57c15f5fe66f...2866c154fe3980cc8d6d323920cd6ce81f33b2be,1,0,17,17,5,2012-04-11 22:02:09,2012-04-11 22:02:09
2866c154fe3980cc8d6d323920cd6ce81f33b2be...4d1689bb4df5260a0985bd423b9a100d7cd718a3,1,24,36,60,6,2012-04-11 22:14:53,2012-04-11 22:14:53
4d1689bb4df5260a0985bd423b9a100d7cd718a3...fe7a6f68396492829e1d2bf2525c7628c8c8d94e,1,32,28,60,14,2012-04-11 23:02:19,2012-04-11 23:02:19
fe7a6f68396492829e1d2bf2525c7628c8c8d94e...bc2555457827b61160844c9b38ffb1a2d7644582,1,6,6,12,3,2012-04-12 03:59:37,2012-04-11 19:33:24
bc2555457827b61160844c9b38ffb1a2d7644582...6042b91a9ca75fc47b2477e613da093f1c9b943e,1,3,1,4,1,2012-04-13 00:55:36,2012-04-13 00:55:36
ca5990f476475f3f194d085ff9eb7115c6cef0ed...db2cf9eca172bb16b0231c8b0ba7dfd138841dee,1,1,0,1,1,2012-04-11 12:53:23,2012-04-11 12:53:23
ca5990f476475f3f194d085ff9eb7115c6cef0ed...d136f904d528b2e3173f501e77dc73da11e8cb62,1,2,0,2,2,2012-04-11 12:47:33,2012-04-11 12:47:33
32266f5d099c912eaec480c0d987fc9ddf2eb2de...e2eadee1d412885a701f2f7b25222d3762f696e2,1,1,1,2,1,2012-04-19 08:57:09,2012-04-12 11:33:09
a461d55b962606c4aa8f5fd3dbd2ef8cc5a785d9...7f25cd8a2baae0dce2ceb443afc064890109567e,1,109,2,111,5,2012-04-16 22:29:55,2012-04-16 22:28:52
6042b91a9ca75fc47b2477e613da093f1c9b943e...9ebb67a02c94596a754426ec08e4d5cf3eb1841c,1,1,1,2,1,2012-04-19 17:18:48,2012-04-13 04:35:54
6042b91a9ca75fc47b2477e613da093f1c9b943e...3f3e014071d703b11c5e8df946fc0e3a3c857c21,1,9,5,14,1,2012-04-14 00:27:45,2012-04-14 00:27:45
3f3e014071d703b11c5e8df946fc0e3a3c857c21...b123748709c549f49a5421dc4ca1e37ede575464,1,1,1,2,1,2012-04-14 05:00:10,2012-04-14 05:00:10
7a05b1337aec9d06863440d5b73e90bd2a07fb26...2edb152d8aa11de013097efa378a27e15591da37,1,14,7,21,6,2012-04-19 19:18:05,2012-04-19 19:16:16
2edb152d8aa11de013097efa378a27e15591da37...adbd44491c0426d3ca3ec1487f039b4f440c584f,2,37,26,63,12,2012-04-19 19:58:46,2012-04-19 19:58:46
adbd44491c0426d3ca3ec1487f039b4f440c584f...47b9ae1f98aeb708fc9a859652147a1423afff28,1,17,0,17,1,2012-04-19 20:46:20,2012-04-19 20:45:35
7f25cd8a2baae0dce2ceb443afc064890109567e...27227084cce247b3cf2a7661251a1348e86f70b7,2,75,3,78,9,2012-04-16 22:33:45,2012-04-16 00:38:46
0f4fa81d774d1bab5f8f423605e4cb4295178500...29019d58435ca8de06b5628ea681d4e146a42d0b,1,654,516,1170,223,2012-04-17 06:07:48,2012-04-17 06:07:48
b123748709c549f49a5421dc4ca1e37ede575464...6915b603be8250e92f993a1e14ff90822d70c6fe,1,5,5,10,4,2012-04-16 21:50:48,2012-04-15 04:15:07
6915b603be8250e92f993a1e14ff90822d70c6fe...5fd063558f16cf3cab917275153c2cc6bf2b7070,1,1,1,2,1,2012-04-16 22:00:01,2012-04-16 22:00:01
b123748709c549f49a5421dc4ca1e37ede575464...37781a5e47835c9313c6181e1664669eb9135c0b,4,10,10,20,10,2012-04-16 06:10:12,2012-04-16 06:10:12
47b9ae1f98aeb708fc9a859652147a1423afff28...a6da0da86283d2e3323197c66b1dcbf76ef4d0e7,2,35,25,60,4,2012-04-19 22:39:00,2012-04-19 21:32:59
a6da0da86283d2e3323197c66b1dcbf76ef4d0e7...c70c96c628da524f81376262045281b56d9a4faf,4,44,36,80,15,2012-04-19 22:39:00,2012-04-19 21:58:34
c70c96c628da524f81376262045281b56d9a4faf...3afa5fd9ca926112679e723ba48a3c20af748a71,3,26,10,36,8,2012-04-19 22:39:00,2012-04-19 22:35:24
70b1b8182d7a6ff2df12610424060abfb621c9cb...19691480715db25a49e818ee7abd7bd86e019d82,1,0,1,1,1,2012-04-16 22:56:32,2012-04-16 22:56:32
632dfe332301ae55f3755d99344572cc0cb12c63...d734492e594cec15cc879c5437c75ce0c143c99a,5,2,4,6,5,2012-04-18 03:02:00,2012-04-17 00:09:09
d734492e594cec15cc879c5437c75ce0c143c99a...ce1f551a868d943ae7f2a6b18b696420948f1ec2,1,1,1,2,1,2012-04-18 03:13:22,2012-04-18 03:09:43
ce1f551a868d943ae7f2a6b18b696420948f1ec2...b7d9397f45734987fa65c25bc1305d6809823d0e,1,1,0,1,1,2012-04-18 03:13:22,2012-04-17 20:06:52
b7d9397f45734987fa65c25bc1305d6809823d0e...4bd98aa38a9cd6010e93ba0d3ad4b8c60ae6bffe,7,54,13,67,14,2012-04-18 03:13:22,2012-04-17 21:46:01
4bd98aa38a9cd6010e93ba0d3ad4b8c60ae6bffe...a7725473e1716562f1cb07102d5db28548fcebed,1,3,0,3,1,2012-04-18 03:13:22,2012-04-17 22:46:43
a7725473e1716562f1cb07102d5db28548fcebed...b3bdb878959c42ffd4bad78bb3f070984103defb,1,20,9,29,5,2012-04-18 03:13:22,2012-04-17 23:15:37
b3bdb878959c42ffd4bad78bb3f070984103defb...e68f9d113cfe1d0e088a56be92517551913f2978,3,0,326,326,2,2012-04-18 06:30:30,2012-04-18 04:48:13
e68f9d113cfe1d0e088a56be92517551913f2978...d7fe7c95cbf37dae1d2bef47982532dde553b17a,1,7,2,9,1,2012-04-19 01:23:18,2012-04-18 22:27:51
88923f208bfae36d8ba1ca6b39a7fc159506fc14...ddc2b0e5dd39051ce8a60dd1b4da3da7f2038cfc,1,1,3,4,2,2012-04-19 23:07:04,2012-04-19 23:07:04
ddc2b0e5dd39051ce8a60dd1b4da3da7f2038cfc...4889a6d18eb3e83f2436eee938f028d34f1dc8bc,3,8,9,17,5,2012-04-19 23:15:54,2012-04-19 23:14:36
4889a6d18eb3e83f2436eee938f028d34f1dc8bc...53ffdefa3e7f3549d6d890c390c1c6d3925bc8a7,1,1,1,2,1,2012-04-20 06:24:51,2012-04-20 06:24:51
53ffdefa3e7f3549d6d890c390c1c6d3925bc8a7...387f45cb7e5355a035b63b7a1c583192b85268ca,1,6,5,11,3,2012-04-20 06:25:11,2012-04-20 06:25:11
e1a557f1c077866ee78152da54894b235f3f70cb...0f2673ff9c9c3ec15df25f79907d62cec5363058,6,749,0,749,6,2012-04-19 02:43:27,2012-04-17 00:09:54
0f2673ff9c9c3ec15df25f79907d62cec5363058...cde4a4abd2114d6974ca46c3b7fbb99608fa3415,3,132,0,132,3,2012-04-19 03:46:47,2012-04-19 01:09:57
387f45cb7e5355a035b63b7a1c583192b85268ca...e7a29036c342aeb8c7df66185b5fd3f90f2b0602,1,11,9,20,8,2012-04-20 20:16:28,2012-04-20 20:16:28
387f45cb7e5355a035b63b7a1c583192b85268ca...0a7a51d468e96fb082f1291087cec836866d0547,6,122,1,123,6,2012-04-20 09:21:11,2012-04-20 09:21:11
0a7a51d468e96fb082f1291087cec836866d0547...bac8c52e00477fdc6dfd1c71d8596a26d54aad9c,2,2,1,3,2,2012-04-20 20:10:22,2012-04-20 20:10:22
bac8c52e00477fdc6dfd1c71d8596a26d54aad9c...10fd13ce464de5cef4e302c2b556a030709303da,1,1,1,2,1,2012-04-20 21:25:05,2012-04-20 21:25:05
10fd13ce464de5cef4e302c2b556a030709303da...5ad54a8f0430c34791c14238a10c9c788b33c2af,1,1,1,2,1,2012-04-20 22:33:36,2012-04-20 22:33:36
5ad54a8f0430c34791c14238a10c9c788b33c2af...a1e05e4c25e76aad553962b5fcf602280f8b682f,1,2,1,3,1,2012-04-20 22:36:09,2012-04-20 22:35:49
a1e05e4c25e76aad553962b5fcf602280f8b682f...e5e1669bd11aa5386b46d119955bdc3525ca3964,4,39,46,85,12,2012-04-20 23:16:23,2012-04-20 23:16:23
7d269cd9bff8884ebfaefddf712b33ac29c0d6a4...d28ed897a544378b51deb2fbb74ba0356158082e,1,2,2,4,2,2012-04-19 04:40:48,2012-04-15 14:46:58
d26258533227912fc7844602cec8a8166103109d...4764dcc85979747de288d4645aaecc03d69ffea6,1,1264,339,1603,1,2012-04-20 23:37:51,2012-04-20 21:54:19
4764dcc85979747de288d4645aaecc03d69ffea6...c266ce317097704b366699b11f10d14cf16a5bb7,2,20,16,36,6,2012-04-20 23:37:51,2012-04-20 21:58:36
c266ce317097704b366699b11f10d14cf16a5bb7...a4715865150fbd619243cb278256f9251cdeb3fc,1,1,0,1,1,2012-04-20 23:37:51,2012-04-20 22:00:49
10cdd666e863b4aab74f7133d3c06f6605b45edc...e5fce5bb0a524182d9829347685a388b82e92a1e,2,2,1,3,2,2012-04-21 00:18:20,2012-04-21 00:18:20
e5fce5bb0a524182d9829347685a388b82e92a1e...bec7f523129e75768d0db602a11b90cf73864ca2,7,10,10,20,8,2012-04-21 00:19:06,2012-04-21 00:19:06
bec7f523129e75768d0db602a11b90cf73864ca2...c1badda2f0934eea0ff7cab599caeb78f78597b0,1,0,4,4,1,2012-04-22 17:26:56,2012-04-22 17:25:52
c1badda2f0934eea0ff7cab599caeb78f78597b0...753d139325a98085ce963e19ed595eb49e2c8bdb,2,27,7,34,4,2012-04-22 20:06:18,2012-04-22 20:06:18
753d139325a98085ce963e19ed595eb49e2c8bdb...893cfafd90a403acf6caf43576636dd65fbfb67b,1,2,0,2,1,2012-04-22 22:47:45,2012-04-22 21:37:39
893cfafd90a403acf6caf43576636dd65fbfb67b...2a622830a05ac3f51cc6d980d50a9572dc797ab3,5,6402,0,6402,3,2012-04-22 22:47:46,2012-04-22 21:38:14
2a622830a05ac3f51cc6d980d50a9572dc797ab3...a6a51cac4f123934c5be7acd3cdf6fa91947905e,1,28,0,28,1,2012-04-22 22:47:46,2012-04-22 21:38:26
a6a51cac4f123934c5be7acd3cdf6fa91947905e...1e0beee9171db8f319b6f1a0a020526535462832,1,11,8,19,2,2012-04-25 19:03:51,2012-04-25 19:03:51
1e0beee9171db8f319b6f1a0a020526535462832...02abc5711e00ad8a4cac7f71d9e6ce058cd88f1f,1,0,17,17,2,2012-04-25 19:04:07,2012-04-25 19:04:07
02abc5711e00ad8a4cac7f71d9e6ce058cd88f1f...c24f891f8559efd31b6d17d533f4cfae89d7bc07,2,21,0,21,2,2012-04-26 02:39:21,2012-04-26 02:39:21
753d139325a98085ce963e19ed595eb49e2c8bdb...d86a6b1ced78baa9c763b34633ef062a75217ea6,3,38,10,48,6,2012-04-22 22:24:30,2012-04-22 22:24:30
d86a6b1ced78baa9c763b34633ef062a75217ea6...9d5d6f2a521294f74f710a0ab628c68ba4972c6d,1,136,5,141,2,2012-04-23 20:11:50,2012-04-20 18:42:01
9d5d6f2a521294f74f710a0ab628c68ba4972c6d...361f22f124960cb9584a6c16c3f851305dcdce16,2,8,6,14,6,2012-04-23 20:12:04,2012-04-23 20:09:57
361f22f124960cb9584a6c16c3f851305dcdce16...1b7f542f11d1c8401583bda44fdfe9580925610a,1,1,2,3,2,2012-04-24 00:43:50,2012-04-14 16:04:47
1b7f542f11d1c8401583bda44fdfe9580925610a...00117e6fdabae6966f50244a74cda55a6b15e153,1,1,1,2,1,2012-04-24 00:50:29,2012-04-12 06:13:36
00117e6fdabae6966f50244a74cda55a6b15e153...f00a8a21fbeb878a00a52a1ce80d6e24b46252a3,1,1,1,2,1,2012-04-24 02:49:53,2012-04-24 02:49:53
4c1f0d57e02b2f9b79447dae11f5ea191288d6e2...d89fb3542ab2ed8ff7b0825dd30ca2d4c64cd979,1,2,2,4,2,2012-04-26 17:40:07,2012-04-26 17:40:07
f00a8a21fbeb878a00a52a1ce80d6e24b46252a3...8906a2a50bc3daa4147a0cc92d924b11f8febba6,1,0,42,42,1,2012-04-24 03:22:05,2012-04-24 03:22:05
8906a2a50bc3daa4147a0cc92d924b11f8febba6...d80978edebb3598672775f8d33350fac66f3ad19,1,15,15,30,8,2012-04-24 03:45:05,2012-04-24 03:45:05
d80978edebb3598672775f8d33350fac66f3ad19...82e0a7b4b9dcf87274b4e9892e7fcdd5398b675f,3,360,180,540,87,2012-04-24 04:45:02,2012-04-24 04:06:13
82e0a7b4b9dcf87274b4e9892e7fcdd5398b675f...cd6cbb2397ab459154f2d30a63c78bb3578cb1ce,1,2,2,4,2,2012-04-24 04:45:02,2012-04-24 04:07:26
cd6cbb2397ab459154f2d30a63c78bb3578cb1ce...89166c50fb8923bfa7218c10ba0d4b231f5351f5,1,699,427,1126,185,2012-04-24 04:45:02,2012-04-24 04:09:50
89166c50fb8923bfa7218c10ba0d4b231f5351f5...2887771f4aa39e4065c43f485f308e23e5a4aec7,1,4,3,7,3,2012-04-24 04:45:02,2012-04-24 04:19:30
2887771f4aa39e4065c43f485f308e23e5a4aec7...96fa3dd365faa70369d2b6e4c29f83e3b76a360b,2,2,2,4,2,2012-04-24 04:45:42,2012-04-24 03:45:22
d89fb3542ab2ed8ff7b0825dd30ca2d4c64cd979...2614ad84bdd4f5141389672746ff740e70190168,1,15,0,15,1,2012-04-26 18:18:06,2012-04-24 00:09:51
2614ad84bdd4f5141389672746ff740e70190168...7e8279f245f671a2a356afbaa0bb5fa48838d8bc,2,9,5,14,3,2012-04-26 18:18:06,2012-04-24 16:28:16
7e8279f245f671a2a356afbaa0bb5fa48838d8bc...bb2a6834af5dc9bd1c0a4e33c567311453ce7699,1,6,5,11,3,2012-04-26 18:18:06,2012-04-25 07:44:07
bb2a6834af5dc9bd1c0a4e33c567311453ce7699...4af0a8b9f729da0b3273340c2140b4c29d340a7d,2,12,17,29,8,2012-04-26 18:18:06,2012-04-23 20:24:17
4af0a8b9f729da0b3273340c2140b4c29d340a7d...365cd81f5578ff6d443e7d4ac656134df3a308d6,2,65,61,126,17,2012-04-26 18:18:06,2012-04-23 23:50:40
365cd81f5578ff6d443e7d4ac656134df3a308d6...ffd02bf1aac244d365c2647bbe5ee440cf9dfbe6,3,103,96,199,22,2012-04-26 18:18:06,2012-04-24 00:20:42
ffd02bf1aac244d365c2647bbe5ee440cf9dfbe6...7fdea86f45fcf53041ab0f7e5ffa48968c8677ef,1,3,27,30,3,2012-04-26 18:18:06,2012-04-24 01:48:31
7fdea86f45fcf53041ab0f7e5ffa48968c8677ef...c676cce0574ec3ffd10b3075844346ca60bd1533,2,27,27,54,18,2012-04-26 18:18:06,2012-04-24 15:39:01
c676cce0574ec3ffd10b3075844346ca60bd1533...7ffb59fa6121bd9c98085640991d2364e30058f5,1,71,65,136,4,2012-04-26 18:18:06,2012-04-24 15:52:35
7ffb59fa6121bd9c98085640991d2364e30058f5...49f2d6a90e197416e13e89e8fe620f98043187f5,2,16,8,24,3,2012-04-26 18:18:06,2012-04-24 17:35:27
49f2d6a90e197416e13e89e8fe620f98043187f5...d4e2bd647584115a1194141948789843e2ae4a6e,1,16,17,33,3,2012-04-26 18:18:07,2012-04-24 20:07:57
d4e2bd647584115a1194141948789843e2ae4a6e...3a09e65cb0cfbeb5c4ee0c952b1c97382f5243ac,1,3,3,6,3,2012-04-26 18:18:07,2012-04-25 00:09:21
3a09e65cb0cfbeb5c4ee0c952b1c97382f5243ac...69efcbbbc6784aa06e3118d2ec743034f1976dd2,1,6,1,7,3,2012-04-26 18:18:07,2012-04-25 00:19:23
69efcbbbc6784aa06e3118d2ec743034f1976dd2...4583a9e3f108f91607c3045388c514bda53ffe14,1,2,2,4,2,2012-04-26 18:18:07,2012-04-25 00:51:50
4583a9e3f108f91607c3045388c514bda53ffe14...e533a1867e2d8537f4d397ce5ea42a8bb4eee711,3,86,15,101,16,2012-04-26 18:18:07,2012-04-25 02:36:41
e533a1867e2d8537f4d397ce5ea42a8bb4eee711...9e75e13c852e7c4e8df8acc86a9124420ceb8216,1,0,17,17,1,2012-04-26 18:18:07,2012-04-25 02:37:31
9e75e13c852e7c4e8df8acc86a9124420ceb8216...009c588ee34e7d0fc50bb4fde411fac533fc4f39,1,50,45,95,6,2012-04-26 18:18:07,2012-04-25 03:19:15
009c588ee34e7d0fc50bb4fde411fac533fc4f39...3cb5bf7c33a4703a3f3bdacd285a35b009f6447f,3,87,68,155,23,2012-04-26 18:18:08,2012-04-25 03:59:57
3cb5bf7c33a4703a3f3bdacd285a35b009f6447f...8db8b54d7c42fc850b3845987e9e86e6a510b98b,2,114,24,138,7,2012-04-26 18:18:08,2012-04-25 07:34:42
8db8b54d7c42fc850b3845987e9e86e6a510b98b...55dd0eb4940da7d3c22928e983b30d420a4f5f5f,1,30,0,30,3,2012-04-26 18:18:08,2012-04-25 07:52:44
55dd0eb4940da7d3c22928e983b30d420a4f5f5f...02469a8031a3345928cc354f3d65bbf7f07462f6,1,15,1,16,3,2012-04-26 18:18:08,2012-04-25 08:21:35
02469a8031a3345928cc354f3d65bbf7f07462f6...1b64089f5cd6510b211fdc34a61504f8ec966bf2,1,3,5,8,1,2012-04-26 18:18:08,2012-04-25 08:31:01
1b64089f5cd6510b211fdc34a61504f8ec966bf2...30d809c3f56989010506db6aa3ae444c13f08a4f,1,49,2,51,4,2012-04-26 18:51:36,2012-04-26 18:51:36
53e6a1b2dfb6af5dda4568d92a278b01869af64a...cf59a3609bf79f8bc6279d7897774993af8755ce,1,1,1,2,1,2012-04-25 01:45:24,2012-04-25 01:45:11
cf59a3609bf79f8bc6279d7897774993af8755ce...078cdaf441922c4d69c89acd0ee2d21f20d94daa,1,2,1,3,1,2012-04-25 06:03:43,2012-04-13 02:27:03
96fa3dd365faa70369d2b6e4c29f83e3b76a360b...8857ed9909c7fe1b9afd8cfb664775fb412c2ae3,1,6,0,6,1,2012-04-26 00:20:42,2012-04-25 04:25:31
8857ed9909c7fe1b9afd8cfb664775fb412c2ae3...07c307a2cc1228aa765b9bf0181b2086176b87f7,1,1,1,2,1,2012-04-26 00:20:43,2012-04-25 04:58:19
07c307a2cc1228aa765b9bf0181b2086176b87f7...54f6f01e48aaf4cb3f0bd4aabe48cf52101e9e93,2,378,79,457,91,2012-04-26 00:20:43,2012-04-25 05:24:16
54f6f01e48aaf4cb3f0bd4aabe48cf52101e9e93...1836fd02da51bcbe83c764ecbed2b8d67ddce5d5,1,2,0,2,1,2012-04-26 00:20:43,2012-04-26 00:14:19
1836fd02da51bcbe83c764ecbed2b8d67ddce5d5...88a70acac622f6034b536ac64718e58e27d0cd1d,2,2,2,4,2,2012-04-26 00:20:43,2012-04-25 04:26:22
b1ac0a739549dc174e4ae2861a9c4d21bf008f94...234827ba4496e7b8d7805c49d2bd478a807e015f,1,1,1,2,1,2012-04-26 22:22:12,2012-04-26 22:22:12
b1ac0a739549dc174e4ae2861a9c4d21bf008f94...7d0bcc294593e066caa56f33575caceba1d1323c,1,27,0,27,1,2012-04-26 20:25:14,2012-04-14 17:59:00
7d0bcc294593e066caa56f33575caceba1d1323c...2a4d4e5fa9bcb5afc92b68c5253524556105f3c3,3,33,0,33,3,2012-04-26 20:33:33,2012-04-26 20:33:33
2a4d4e5fa9bcb5afc92b68c5253524556105f3c3...717d710a3ba5ee4eb01552cc571dfdf1b5b5b68e,3,19,0,19,3,2012-04-26 21:40:07,2012-04-26 21:40:07
717d710a3ba5ee4eb01552cc571dfdf1b5b5b68e...c01f3fa30f7df5fa893563d5602cef42d3809394,1,13,0,13,1,2012-04-26 21:42:47,2012-04-26 21:42:47
c01f3fa30f7df5fa893563d5602cef42d3809394...eb8017096bb317aaf35ec05e87032c956464556a,3,60,0,60,3,2012-04-26 22:32:14,2012-04-26 22:32:14
eb8017096bb317aaf35ec05e87032c956464556a...05efb31504f0584fbcae86240b6420c87b400355,4,30,0,30,4,2012-04-27 00:43:35,2012-04-27 00:43:35
05efb31504f0584fbcae86240b6420c87b400355...896775cf439ad2ef505be3d0b7c68bad1b7e960d,2,2,2,4,4,2012-04-27 00:44:32,2012-04-27 00:44:32
078cdaf441922c4d69c89acd0ee2d21f20d94daa...b0af1751c7eb4de1b120923ab77e5b0c5faf1726,2,5,0,5,2,2012-04-25 20:35:26,2012-04-25 20:35:26
b0af1751c7eb4de1b120923ab77e5b0c5faf1726...1af36d26436f7883cc503cfddbcc317919ac738c,1,5,0,5,1,2012-04-25 22:26:59,2012-04-25 22:26:59
1af36d26436f7883cc503cfddbcc317919ac738c...840dc7d8a5ecb040f59464ae4de2728567b3a945,3,8,1,9,3,2012-04-26 00:36:45,2012-04-26 00:36:45
840dc7d8a5ecb040f59464ae4de2728567b3a945...70aab70addaa4dea792a76635e9ec5bb646107f2,3,32,0,32,3,2012-04-26 01:16:49,2012-04-26 01:16:49
078cdaf441922c4d69c89acd0ee2d21f20d94daa...6db9a51d752c28f188f31c62a769ad80677f6ca4,1,1,1,2,1,2012-04-25 10:05:13,2012-04-25 10:05:13
df13b724f8c45864c8633b4f6e9ace73903c3e0f...3dd57b3c62a7498be3ebfff5c7401410678d8a4b,1,6,0,6,1,2012-04-27 04:56:14,2012-04-27 04:56:14
3dd57b3c62a7498be3ebfff5c7401410678d8a4b...88481938a0b5e80cfd2e2ce84ed4dcc28eb60d28,1,10,10,20,2,2012-04-27 15:53:39,2012-04-11 05:09:47
88481938a0b5e80cfd2e2ce84ed4dcc28eb60d28...192537d0df912d1bbb6ed4da9c937bdcf46895a6,4,4,2,6,4,2012-04-27 17:21:21,2012-04-27 17:21:21
192537d0df912d1bbb6ed4da9c937bdcf46895a6...55af4717f1282fc9172974e2b32fb2e1b2dc52c4,1,15,0,15,1,2012-04-27 18:30:23,2012-04-27 18:30:23
55af4717f1282fc9172974e2b32fb2e1b2dc52c4...f1c61e12935b4718e34be5f63c62bed5dbbcf045,1,13,0,13,1,2012-04-27 20:41:23,2012-04-27 20:41:23
f1c61e12935b4718e34be5f63c62bed5dbbcf045...f3e0267e3bb4cce1dd0e1f3fd3cbec1412924cfd,2,11,1,12,5,2012-04-27 22:02:12,2012-04-27 22:01:54
b9c3a7fe737ef6144a9d293482b0f9a7f4fcb232...949ea34a85623f0779950f3b9569a36527e4d515,1,10,5,15,2,2012-05-30 22:31:06,2012-05-30 22:31:06
949ea34a85623f0779950f3b9569a36527e4d515...f6a292d7e6343212de8c096aa0acea24090031b5,1,1,1,2,1,2012-05-31 22:57:37,2012-05-31 22:57:37
f6a292d7e6343212de8c096aa0acea24090031b5...ed86eff71892e9375f99113f1e2b781f39059c71,1,3,0,3,1,2012-06-05 04:03:18,2012-06-04 20:01:05
ed86eff71892e9375f99113f1e2b781f39059c71...0e7f3c5223e72d731a8bafa4862b01e500a401cd,2,117,10,127,13,2012-06-05 04:21:27,2012-06-05 01:16:40
0e7f3c5223e72d731a8bafa4862b01e500a401cd...373c7039c5c44c7b63d7c318c51b0f99e8b2e2ed,5,86,0,86,5,2012-06-05 04:21:52,2012-06-05 01:17:07
373c7039c5c44c7b63d7c318c51b0f99e8b2e2ed...0dec81f85b907052138889235da2d88732000452,3,46,3,49,8,2012-06-05 04:22:04,2012-06-05 03:41:19
0dec81f85b907052138889235da2d88732000452...5b0346b34ceefa6eb889fa0e753cd7a3a6db69ac,1,1,4,5,1,2012-06-05 04:22:50,2012-06-05 03:46:07
5b0346b34ceefa6eb889fa0e753cd7a3a6db69ac...646765eeae1f8d660fb93820ca59e0431014b83b,1,1,1,2,1,2012-06-05 19:22:17,2012-06-05 19:22:17
646765eeae1f8d660fb93820ca59e0431014b83b...0dd3992c9410c57f92e59624714ff268db0bec9c,3,88,18,106,12,2012-06-05 23:13:46,2012-06-05 23:13:46
0dd3992c9410c57f92e59624714ff268db0bec9c...80bef5ea9bed63eb0a677057f35ed351920cca7f,4,20,19,39,4,2012-06-05 23:46:50,2012-06-05 23:46:50
80bef5ea9bed63eb0a677057f35ed351920cca7f...6a9e8f33cd3d2e8fd08d69458b174fd49a27c08b,1,1,0,1,1,2012-06-05 23:52:23,2012-06-05 23:52:23
6a9e8f33cd3d2e8fd08d69458b174fd49a27c08b...e655492f70bed1b2481845889028903492156516,1,1,1,2,1,2012-06-06 00:09:29,2012-06-03 03:34:35
e655492f70bed1b2481845889028903492156516...41e32e972fc2710483001903adfcd8e0fba6bced,1,19,0,19,1,2012-06-06 21:45:33,2012-06-06 21:45:33
f3e0267e3bb4cce1dd0e1f3fd3cbec1412924cfd...2ce1d03dbcead056a6d75fcbc17023ec17dabd4e,1,2,0,2,1,2012-04-27 23:51:32,2012-04-27 23:51:32
2ce1d03dbcead056a6d75fcbc17023ec17dabd4e...f212fa5fb9a6cb0faca78afa70baef99a2ad3c24,2,2,2,4,2,2012-04-27 23:51:51,2012-04-27 23:51:51
1765ef011a5a3838ca19e9125e9c9eb1c13f72fe...eca3b913754d293f346141a6fc034b8f3b87e84d,8,16,12,28,12,2012-06-07 04:26:20,2012-06-07 04:26:20
eca3b913754d293f346141a6fc034b8f3b87e84d...04b53bd64f322d34d9b6cb0d7a8310da3306a5fe,1,22,0,22,1,2012-06-08 21:23:30,2012-06-08 21:23:30
04b53bd64f322d34d9b6cb0d7a8310da3306a5fe...ba641f1e7a212bfa91bb99b4e1f5063e93bfcb6c,1,19,0,19,1,2012-06-09 02:53:01,2012-06-09 02:53:01
ba641f1e7a212bfa91bb99b4e1f5063e93bfcb6c...cc15021f9d74a4a0ae7cb84171e43ffa0acf842e,1,28,4,32,6,2012-06-09 03:06:29,2012-06-09 03:06:29
cc15021f9d74a4a0ae7cb84171e43ffa0acf842e...d08b53a93a80c4fe9a66b870e9c97122f42edbe2,7,131,14,145,17,2012-06-12 21:17:31,2012-06-12 21:03:35
d08b53a93a80c4fe9a66b870e9c97122f42edbe2...604977120488e2963abd82c4d9dffee85a5e711c,1,13,12,25,4,2012-06-14 03:12:08,2012-06-12 04:37:34
604977120488e2963abd82c4d9dffee85a5e711c...021cca9ca3db2d3f9a61012c36515c5611c50916,3,205,24,229,6,2012-06-16 21:46:45,2012-06-16 21:46:45
021cca9ca3db2d3f9a61012c36515c5611c50916...210d7e5b4bd416e8c2fad6316b01070a34b71c87,5,62,6,68,10,2012-06-18 20:30:45,2012-06-18 20:29:17
210d7e5b4bd416e8c2fad6316b01070a34b71c87...cab4054eb9fe1b44c9a8ae767adb136cfeebf7cb,1,1,1,2,1,2012-06-18 20:33:15,2012-06-13 18:40:14
cab4054eb9fe1b44c9a8ae767adb136cfeebf7cb...d4c4c8216ccf2db8fb3c30b60af9cc7edb83b842,1,21,0,21,1,2012-06-18 20:33:34,2012-06-14 03:54:34
d4c4c8216ccf2db8fb3c30b60af9cc7edb83b842...c935b918a14c9016cc26ab3a892c12436888f0c6,1,2,2,4,2,2012-06-18 20:42:10,2012-06-18 20:42:10
c935b918a14c9016cc26ab3a892c12436888f0c6...ce6c48144b590b1c8b46ddb0b2ed5ba976af26c2,4,31,4,35,7,2012-06-18 21:30:11,2012-06-18 21:30:11
ce6c48144b590b1c8b46ddb0b2ed5ba976af26c2...2e2ea18522398762d849d697d1289ba413f0f51f,3,37,18,55,14,2012-06-19 01:34:01,2012-06-19 01:34:01
2e2ea18522398762d849d697d1289ba413f0f51f...9d52461b67fa531d0a68c46c25e73b22774a3993,2,6,0,6,2,2012-06-19 19:37:26,2012-06-19 19:37:26
9d52461b67fa531d0a68c46c25e73b22774a3993...723a668efa475138363100585487d0ce114ba567,1,1,1,2,1,2012-06-19 19:44:45,2012-06-19 19:44:45
723a668efa475138363100585487d0ce114ba567...bdc9ad6f317db0843fce04ab5b234a99ca8e8dc6,1,6,0,6,2,2012-06-19 19:53:52,2012-06-19 19:53:34
bdc9ad6f317db0843fce04ab5b234a99ca8e8dc6...eb8a847c0627433e84e06f8d1094fc4b48a2698a,1,3,1,4,1,2012-06-20 00:01:25,2012-06-12 06:43:54
eb8a847c0627433e84e06f8d1094fc4b48a2698a...1f5726c478170e4ab266d00e7b184f9873deaa91,1,2,0,2,1,2012-06-20 01:06:07,2012-06-20 01:02:56
1f5726c478170e4ab266d00e7b184f9873deaa91...62ec81afda0bd31f02ead5ff2026537b5c6a6b2e,5,2402,1181,3583,1399,2012-06-20 01:40:49,2012-06-20 01:40:49
7334d7d20c2a7f9327890ece8dc5666a6486fb0c...bf46f04024251dea7a547c48d01d8032b7838d10,7,10,10,20,8,2012-04-28 01:03:26,2012-04-28 01:03:26
bf46f04024251dea7a547c48d01d8032b7838d10...523c60d63bb1322864595916f249ebc5432eddc4,2,30,4,34,3,2012-04-28 18:50:18,2012-04-28 18:50:18
523c60d63bb1322864595916f249ebc5432eddc4...ef9f956786d48a69d996718ad19546f7cb8777b4,7,10,10,20,8,2012-04-28 20:55:44,2012-04-28 20:55:44
62ec81afda0bd31f02ead5ff2026537b5c6a6b2e...b7632579296257c10bf640a5f00716c3d440de71,4,43,1,44,5,2012-06-20 07:08:35,2012-06-18 18:52:03
b7632579296257c10bf640a5f00716c3d440de71...9fa4b1f259e51d5e8b9660e1a867f84fe6197244,1,0,2,2,1,2012-06-20 07:08:35,2012-06-19 02:58:16
ef9f956786d48a69d996718ad19546f7cb8777b4...5b1c3bae4cc883bac1e7cc79ef045a344ec25284,1,6,0,6,3,2012-04-29 19:38:06,2012-04-29 19:38:06
5b1c3bae4cc883bac1e7cc79ef045a344ec25284...d78f64e8341909c712463b27a86048c64da04b37,1,99,6,105,3,2012-04-29 21:10:21,2012-04-29 21:10:21
d78f64e8341909c712463b27a86048c64da04b37...bbd1e37a53ce4989f0374e95a06ee3856a0d890f,1,21,3,24,4,2012-04-29 21:36:22,2012-04-29 21:36:22
1deafd1c02afbf21d1d60af34165ec10e74b110e...d320dc2858824bf4474428a9df7aead6ac4b0480,1,1,1,2,1,2012-06-21 01:16:19,2012-06-21 01:16:19
d320dc2858824bf4474428a9df7aead6ac4b0480...69f8121b8897b3d0d9287485291a7793da90199c,2,3,3,6,2,2012-06-25 21:00:30,2012-06-25 21:00:30
69f8121b8897b3d0d9287485291a7793da90199c...a39aabc25caa00a4ed44bcb9cff0813dc33a7c6c,1,1,1,2,1,2012-06-25 22:11:25,2012-06-25 22:11:25
363e341cdd3b456d3540a0789db1a173df06e9de...4d9112034661b43696a72db9ff29a6af1015447c,5,86,56,142,24,2012-04-30 16:32:15,2012-04-30 16:32:15
4d9112034661b43696a72db9ff29a6af1015447c...e90557a70eb4c9d75467f11939f8c366bc5c4cb9,1,23,15,38,15,2012-04-30 16:41:31,2012-04-30 16:41:31
e90557a70eb4c9d75467f11939f8c366bc5c4cb9...e1c2eb33b1e615611283230574f7a6b33f31305e,2,26,11,37,5,2012-04-30 17:24:02,2012-04-30 17:24:02
a39aabc25caa00a4ed44bcb9cff0813dc33a7c6c...b02f9857314fc1d0202bfefa2f1a59c2df5a1006,1,16,8,24,4,2012-06-26 22:44:22,2012-06-26 22:44:22
a39aabc25caa00a4ed44bcb9cff0813dc33a7c6c...a248f0ff2869eea8d0cb7ee30f747169460a71a2,3,45,16,61,5,2012-06-26 22:14:30,2012-06-23 04:01:42
a248f0ff2869eea8d0cb7ee30f747169460a71a2...e059442a7f37da0f1d57a7e248b3c5c086ff7131,2,86,0,86,2,2012-06-26 22:15:21,2012-06-26 05:22:36
e059442a7f37da0f1d57a7e248b3c5c086ff7131...801626695c9ba3163a4509f0556b2e510b70f1cc,1,16,9,25,4,2012-06-28 00:35:24,2012-06-28 00:35:24
801626695c9ba3163a4509f0556b2e510b70f1cc...2d619a4930955461cad9d62db5262bc19cde7338,1,1,1,2,1,2012-06-28 01:14:46,2012-06-28 01:14:46
2d619a4930955461cad9d62db5262bc19cde7338...2d329d7c44f99c9c7de29dabaabbfd24729a01f8,2,2,2,4,2,2012-06-28 01:17:10,2012-06-28 01:17:10
2d329d7c44f99c9c7de29dabaabbfd24729a01f8...430db59aecad073bcccdede60a34a9a8fa59f4cc,1,1,1,2,1,2012-06-29 02:05:15,2012-06-29 02:05:15
4967512a410e50ca27d3a801348d9679cae2113b...2ca10b188bdf3faee6473f310c9c4cda994583ee,1,19,0,19,1,2012-05-01 22:38:15,2012-05-01 22:37:21
4967512a410e50ca27d3a801348d9679cae2113b...d4e3aa2ffd52c40eaec93db56952d0ea697427cc,2,16,13,29,5,2012-05-01 21:24:45,2012-05-01 21:24:45
d4e3aa2ffd52c40eaec93db56952d0ea697427cc...93e793891c5164ba3db933349e5c4d7205872da6,1,18,2,20,3,2012-05-01 22:00:15,2012-05-01 22:00:15
93e793891c5164ba3db933349e5c4d7205872da6...54f70c25c43db0c18696d0d4a6873b6a910b38e5,3,38,26,64,11,2012-05-01 22:12:44,2012-05-01 22:12:07
63ff7a2b736d7291a55cd7049955b9e62031f004...eb25822679bdb8eb3c2bcfa316ee15e9317118f3,1,16,5,21,6,2012-07-03 00:53:25,2012-05-17 18:58:34
eb25822679bdb8eb3c2bcfa316ee15e9317118f3...bdcccfd32e115c8e1a39c0eddd9f468195f2f7c5,1,11,7,18,2,2012-07-03 00:53:36,2012-05-30 15:04:18
bdcccfd32e115c8e1a39c0eddd9f468195f2f7c5...682c1650c5524ecef24f3c12aa54c2a178efcd45,2,40,7,47,11,2012-07-03 01:21:53,2012-07-03 01:21:53
8913a2bdf4b809eeef252e74d986ebeae2746ef4...e2084ef02862ac8985751edcf0a5e363bc908114,3,62,37,99,4,2012-05-01 23:55:56,2012-05-01 22:47:26
e2084ef02862ac8985751edcf0a5e363bc908114...2cbff46b0b7133a39311f6572faa4d31b7dbdf15,1,5,1,6,1,2012-05-01 23:55:56,2012-05-01 23:38:22
2cbff46b0b7133a39311f6572faa4d31b7dbdf15...2d7197fe83572bfd1cde175d9f4eb1dcb9c7656d,8,40,46,86,18,2012-05-01 23:55:56,2012-05-01 23:54:59
682c1650c5524ecef24f3c12aa54c2a178efcd45...680220ecdf44a1181d2b12f584be92e589777920,1,7,1,8,3,2012-07-06 23:56:49,2012-07-06 23:56:49
682c1650c5524ecef24f3c12aa54c2a178efcd45...77959b1918882f6d9154c6f5185726f7a2f7c401,3,20,8,28,4,2012-07-05 06:06:17,2012-07-05 06:06:17
77959b1918882f6d9154c6f5185726f7a2f7c401...014884aa5c47a99c7beb56c8f7a93c726972aa1e,2,31,19,50,4,2012-07-05 06:40:09,2012-07-05 06:40:09
2d7197fe83572bfd1cde175d9f4eb1dcb9c7656d...cae584ff592e078c0e93f74a787e0858fdc3f218,2,16,8,24,8,2012-05-02 00:00:06,2012-04-30 17:54:30
cae584ff592e078c0e93f74a787e0858fdc3f218...8ae567fdea576d2e03ea6f9fb71555b076efe1b6,2,138,49,187,17,2012-05-02 00:00:06,2012-04-30 21:22:44
8ae567fdea576d2e03ea6f9fb71555b076efe1b6...b25959813dd1664630aa831484226a64dc60f30b,3,186,152,338,6,2012-05-02 00:00:06,2012-04-30 22:22:53
b25959813dd1664630aa831484226a64dc60f30b...9b700317715eae700432aeeb990e9d8b5e0c4e57,1,5,1,6,3,2012-05-02 00:00:06,2012-04-30 22:27:48
9b700317715eae700432aeeb990e9d8b5e0c4e57...850b53a4879a56b55a4cdfe4888165db30af8d59,2,256,149,405,25,2012-05-02 00:00:06,2012-05-01 04:58:44
850b53a4879a56b55a4cdfe4888165db30af8d59...ab1e4496b7d9b6296f82147b01edfafe6d8dc4ab,1,14,0,14,1,2012-05-02 00:00:06,2012-05-01 05:07:06
ab1e4496b7d9b6296f82147b01edfafe6d8dc4ab...54adb858d0fdf55c6259853d7c290da68bf95f09,2,2,2,4,2,2012-05-02 00:00:06,2012-05-01 19:07:26
54adb858d0fdf55c6259853d7c290da68bf95f09...7b5990090ef88c650cd15dafbb4cf52e5a8161a6,2,7,0,7,4,2012-05-02 00:00:06,2012-05-01 19:09:35
7b5990090ef88c650cd15dafbb4cf52e5a8161a6...d317e8ee0124ad1a141ca6becd106f2ac34848c4,3,128,69,197,6,2012-05-02 00:00:06,2012-05-01 21:06:14
d317e8ee0124ad1a141ca6becd106f2ac34848c4...06d5a0b59a0e96f4951c0585e59f57608b1a81da,1,28,2,30,2,2012-05-02 20:24:30,2012-05-02 20:24:30
680220ecdf44a1181d2b12f584be92e589777920...6081f174c2d49cc02d36715cce95bdfd2b621163,2,4,2,6,2,2012-07-10 00:02:01,2012-06-09 23:34:48
6081f174c2d49cc02d36715cce95bdfd2b621163...b2667bd5a972f84bc9cdb61ab0ab07caabedce7d,2,3,0,3,3,2012-07-10 00:02:01,2012-06-09 23:36:10
b2667bd5a972f84bc9cdb61ab0ab07caabedce7d...0a5192352aab6ced928f18c670423c1552240430,1,7,0,7,1,2012-07-10 00:02:01,2012-06-20 21:23:30
0a5192352aab6ced928f18c670423c1552240430...b0f3de7cb10ec1ad003cd5f2f8a2315f46f5622d,1,2,2,4,1,2012-07-10 00:11:17,2012-07-10 00:11:17
b0f3de7cb10ec1ad003cd5f2f8a2315f46f5622d...cf232430383da2afe1d9b25f1e406256b1e02d50,1,1,1,2,1,2012-07-10 00:18:00,2012-07-10 00:13:59
cf232430383da2afe1d9b25f1e406256b1e02d50...e3d970fd8241a6298da199e98c18e51e4b42ffb1,2,2,2,4,2,2012-07-10 00:18:05,2012-07-10 00:15:32
6ea51d83b5389355b3a030104d56947cc70a1eb1...25cb78e040a3cde1321bff73206f7bdca52e82e9,1,1,1,2,1,2012-05-02 21:26:06,2012-05-01 02:31:47
6ea51d83b5389355b3a030104d56947cc70a1eb1...ec834d80732224e2bf976ab04ccc27926cd2917e,1,4,0,4,1,2012-05-02 20:37:08,2012-04-27 00:28:46
ec834d80732224e2bf976ab04ccc27926cd2917e...276b221e5bddcdb51370932219add558d1b52e45,1,20,0,20,1,2012-05-02 23:41:50,2012-05-02 23:41:50
c046ddbd0c5e5a673bbde32635d6fa44634cf0db...ae55d9dd113fe739e8ba0fbeb063bebc7807944d,2,13,1,14,2,2012-07-10 02:33:25,2012-07-10 02:28:29
ae55d9dd113fe739e8ba0fbeb063bebc7807944d...c2bc63993da74b5053628d77a3e21816e96fa571,1,23,0,23,1,2012-07-10 03:06:17,2012-07-10 02:52:20
c2bc63993da74b5053628d77a3e21816e96fa571...4719433383dc82ee3a889f49be8f706ba4eb2243,1,5,4,9,2,2012-07-10 03:14:24,2012-07-10 03:14:10
a2a72ebe54124af8ec4c75f9521394d69f63b8e9...59d93e1bea8c87bd875439b0aa72fb1658757f1a,1,1,0,1,1,2012-08-21 21:58:49,2012-08-21 21:58:49
59d93e1bea8c87bd875439b0aa72fb1658757f1a...ff5fd84d0bba2df7ab05bf3f071a05bd39722414,1,2,0,2,1,2012-08-21 23:09:15,2012-08-21 23:09:15
25cb78e040a3cde1321bff73206f7bdca52e82e9...fd01cf84e0a7ef10d69bcc991ebdee908059f1bc,6,69,14,83,10,2012-05-03 04:17:33,2012-05-03 04:17:33
fd01cf84e0a7ef10d69bcc991ebdee908059f1bc...24b4a14489ed60a3040e41f6f32c177843a0f9ed,2,10,1,11,3,2012-05-03 16:29:43,2012-05-03 16:29:43
24b4a14489ed60a3040e41f6f32c177843a0f9ed...944e2437f69b18d664be4cace891493944c61b88,4,74,72,146,11,2012-05-04 02:42:38,2012-05-04 02:42:38
4719433383dc82ee3a889f49be8f706ba4eb2243...9d3161f3fb9f3ace7d6b8c240e0cf75120f117f4,3,126,20,146,14,2012-07-11 21:41:12,2012-07-11 20:55:51
9d3161f3fb9f3ace7d6b8c240e0cf75120f117f4...c0bb4e9ae8611a146c6d7916986265a0f2fdbbea,1,4,4,8,1,2012-07-11 21:42:36,2012-07-11 21:37:58
ed28e8f40308f467e47ae8f5327d0183aa16c42d...d4129975c137c50446dbb61c25d5aa7b1d7e4573,1,64,0,64,1,2012-05-04 03:58:58,2012-05-04 03:58:58
d4129975c137c50446dbb61c25d5aa7b1d7e4573...26cf9dce2bd31212da5a4a0dffc37e65d3753246,1,9,18,27,2,2012-05-05 21:39:07,2012-05-05 21:39:07
26cf9dce2bd31212da5a4a0dffc37e65d3753246...6cf6fab193d4ddcc9cdc64296e14ec9a5ed19288,2,6,10,16,4,2012-05-06 16:07:50,2012-05-06 16:07:50
6cf6fab193d4ddcc9cdc64296e14ec9a5ed19288...ee201b68d0754c2a2a84e6aafbde9cde6254acdf,2,8,8,16,6,2012-05-07 04:51:15,2012-05-07 04:51:15
ee201b68d0754c2a2a84e6aafbde9cde6254acdf...cb5c8279d076070e8a52d2be3dfed82f1472d580,1,2,0,2,1,2012-05-07 18:32:27,2012-05-07 18:32:27
085679702169c3aac27ed36d7ad09957606a74f0...20af33e4eadb0a0b5409029fb573eed82715ed8b,1,3,0,3,2,2012-07-12 00:29:30,2012-07-12 00:29:30
20af33e4eadb0a0b5409029fb573eed82715ed8b...cd3ca61ec345cfd4c983047018a91332e4cd3176,3,12,3,15,5,2012-07-12 03:50:36,2012-07-12 03:48:47
cd3ca61ec345cfd4c983047018a91332e4cd3176...26136a22a4b0e063c79b6870fa478918cb0462c9,1,29,1,30,4,2012-07-12 04:19:15,2012-07-12 03:14:35
26136a22a4b0e063c79b6870fa478918cb0462c9...564b292974db56b49dec0b3864bc3565e4895bc8,1,15,2,17,2,2012-07-12 06:03:26,2012-07-12 06:03:26
564b292974db56b49dec0b3864bc3565e4895bc8...bb3bc2049f44a4a6ba14fcbd9ba13ba4c889937f,1,1,1,2,1,2012-07-12 20:55:05,2012-07-12 20:55:05
bb3bc2049f44a4a6ba14fcbd9ba13ba4c889937f...fb3ccd732c627f4a2dcc13845d57980ce7ac1b69,1,3,3,6,3,2012-07-12 23:08:12,2012-07-12 23:08:12
fb3ccd732c627f4a2dcc13845d57980ce7ac1b69...75696a8d78962216045d05aacf8551528cc13acf,1,8,7,15,5,2012-07-12 23:57:09,2012-07-10 00:07:06
75696a8d78962216045d05aacf8551528cc13acf...c3ecb78a9c6724361afc89aa4fcf03d6f873e014,1,14,3,17,1,2012-07-12 23:57:09,2012-07-12 22:53:20
c3ecb78a9c6724361afc89aa4fcf03d6f873e014...d416362b83cadc08c090009815e7db9de8a80f1f,1,3,1,4,2,2012-07-13 00:11:40,2012-07-13 00:11:40
d416362b83cadc08c090009815e7db9de8a80f1f...53f4cd7354ad5dd14de5cf3f2dc274fa56165937,1,1,1,2,1,2012-07-13 02:43:54,2012-07-13 02:43:54
53f4cd7354ad5dd14de5cf3f2dc274fa56165937...d1e091cbc35f98abf2a670856683378329f19dee,1,2,2,4,2,2012-07-13 04:02:14,2012-07-13 04:02:14
d1e091cbc35f98abf2a670856683378329f19dee...32206de24360e43dba814744550777d1fe868c59,5,35,3,38,6,2012-07-13 05:07:27,2012-07-13 05:07:27
32206de24360e43dba814744550777d1fe868c59...7510b8430e2f22f8f396e853e0d243238e2bbc53,9,12,10,22,9,2012-07-13 05:10:40,2012-07-13 05:10:40
206f3dbfd83642712c0969867e3c579b60af7874...2b7557472dbd4fd27712b2c077476c6591cf496d,2,7,2,9,3,2012-08-30 04:26:39,2012-08-29 07:56:22
2b7557472dbd4fd27712b2c077476c6591cf496d...313d84d64d2c6d6effe4e39f34e02614d2ed75b4,1,32,0,32,1,2012-08-30 04:39:30,2012-08-30 04:39:30
6f8f08714b38390830e56c8727ea618045dde9b1...76984e87ac4d316fd93eef01695ef7fee50522ba,1,9,0,9,2,2012-08-28 20:11:07,2012-08-28 17:17:06
76984e87ac4d316fd93eef01695ef7fee50522ba...c758bbb16443a2e2fb41d2e1f035d74b45ae3692,2,33,32,65,4,2012-08-28 20:11:07,2012-08-28 17:24:33
c758bbb16443a2e2fb41d2e1f035d74b45ae3692...bdb89d8c558a1ed50be8cf9f4d051cf4f5a9cfcf,4,37,1,38,5,2012-08-28 20:11:07,2012-08-28 18:19:28
bdb89d8c558a1ed50be8cf9f4d051cf4f5a9cfcf...2fd4e4c5c1df6b45260cbc45c66b758c5548cd42,3,33,6,39,4,2012-08-28 20:11:07,2012-08-28 20:10:41
2fd4e4c5c1df6b45260cbc45c66b758c5548cd42...238cfd9a88a3a17ee09234dbc6876a549291f22a,2,4,4,8,4,2012-08-28 20:11:07,2012-08-28 20:10:50
238cfd9a88a3a17ee09234dbc6876a549291f22a...c42070451fef3518689b50e99106912e5ca5b1d3,3,80,8,88,8,2012-08-29 21:47:08,2012-08-29 21:47:08
c42070451fef3518689b50e99106912e5ca5b1d3...d1e56cd94fcfb03df12ad624ccf4b1b674e495c9,2,16,17,33,4,2012-08-29 22:38:49,2012-08-29 22:38:49
d1e56cd94fcfb03df12ad624ccf4b1b674e495c9...df7a24b6cc001a80464165d37b84d8a572bfaa1e,3,113,26,139,22,2012-08-29 23:37:26,2012-08-29 23:37:26
df7a24b6cc001a80464165d37b84d8a572bfaa1e...9c566c97888241958d51426e547c516a5b5cb6d9,2,94,13,107,3,2012-08-29 23:41:18,2012-08-29 23:39:54
9c566c97888241958d51426e547c516a5b5cb6d9...5b03c1f5fbee46d687cb86145679879a8ac177ec,2,56,10,66,5,2012-08-30 00:25:24,2012-08-30 00:25:24
5b03c1f5fbee46d687cb86145679879a8ac177ec...ee3bd696fe987abb2601d3afdc85b88c8cbb80ea,3,52,48,100,7,2012-08-30 01:00:17,2012-08-30 00:13:57
ee3bd696fe987abb2601d3afdc85b88c8cbb80ea...c839cc137c8dc5a3a0a788a3cdcfa2ec31eabf96,2,23,47,70,12,2012-08-30 01:00:17,2012-08-30 00:59:29
c839cc137c8dc5a3a0a788a3cdcfa2ec31eabf96...1de8e506a2a58ab164379c22bc954f5534dc5be5,2,75,5,80,8,2012-08-30 01:05:40,2012-08-30 01:05:10
1de8e506a2a58ab164379c22bc954f5534dc5be5...b557de261ecdd0975b773767d539000573353ac4,2,61,246,307,21,2012-08-30 02:04:37,2012-08-30 02:04:37
b557de261ecdd0975b773767d539000573353ac4...3423aee12cb3635839cc183487d9ed0e647728d1,1,28,2,30,2,2012-08-30 03:07:48,2012-08-30 03:07:48
3423aee12cb3635839cc183487d9ed0e647728d1...e4a5cb6db1e712ba0df0d54ed23f848d388a4957,1,17,1,18,1,2012-08-30 03:34:37,2012-08-30 03:34:37
cb5c8279d076070e8a52d2be3dfed82f1472d580...1fe02fd96a9be9360bae6f0db3143dcdf01ccce0,1,1,7,8,2,2012-05-07 21:03:06,2012-05-07 21:03:06
1fe02fd96a9be9360bae6f0db3143dcdf01ccce0...236e7a7dd75e4b420291d5cf19d38db5e079bfe6,2,2,2,4,2,2012-05-07 21:03:40,2012-05-07 21:03:40
7510b8430e2f22f8f396e853e0d243238e2bbc53...05c50867deb90a579b1bcb5639fd03adaecaeb8a,1,1,0,1,1,2012-08-02 19:14:04,2012-08-02 19:14:04
7510b8430e2f22f8f396e853e0d243238e2bbc53...deba0fb0f01bcc31b541b19d8d43107160610591,1,1,1,2,1,2012-07-13 20:00:12,2012-07-03 07:29:03
deba0fb0f01bcc31b541b19d8d43107160610591...9cea9aa20590e9f8aae26b434eb950bb783d31ca,1,19,2,21,3,2012-07-13 20:00:12,2012-07-12 22:12:29
9cea9aa20590e9f8aae26b434eb950bb783d31ca...473774b3231c44b87824887a0ebed6caf091c45c,1,2,0,2,1,2012-07-13 20:01:00,2012-07-13 00:13:01
473774b3231c44b87824887a0ebed6caf091c45c...0753581022f21e2bc6fd80e10783e630a60659ac,1,2,2,4,2,2012-07-16 19:27:38,2012-07-16 19:27:38
0753581022f21e2bc6fd80e10783e630a60659ac...3fdac8ba3268fafcb0736a8c11304f033f838cf7,1,2,1,3,1,2012-07-16 19:28:26,2012-07-16 19:28:26
313d84d64d2c6d6effe4e39f34e02614d2ed75b4...29a00b92c91cd48e95f21f8fec33775501894af8,1,1,1,2,1,2012-09-07 21:03:17,2012-09-07 21:03:17
313d84d64d2c6d6effe4e39f34e02614d2ed75b4...4664e0f5066a926172f3e81d336a8a4ee46c81b7,2,60,1,61,2,2012-08-30 18:42:46,2012-08-30 18:42:46
4664e0f5066a926172f3e81d336a8a4ee46c81b7...2430036f6c7e1e216278cf8492aec34328740353,1,22,0,22,1,2012-08-30 19:44:23,2012-08-30 19:44:23
2430036f6c7e1e216278cf8492aec34328740353...43e2562967b6e8291422fc5019326307b7942f4e,2,7,4,11,6,2012-08-30 20:26:04,2012-08-30 20:25:15
43e2562967b6e8291422fc5019326307b7942f4e...b3ed0493710af012e7e02d3c1752408593f2b5bd,1,18,10,28,1,2012-08-30 20:48:20,2012-08-30 20:48:20
b3ed0493710af012e7e02d3c1752408593f2b5bd...5d34cdf1d2b5b7885bee64b5cce81e8168f636a3,5,32,32,64,19,2012-08-30 22:05:41,2012-08-30 22:04:00
5d34cdf1d2b5b7885bee64b5cce81e8168f636a3...5a06b8ad124c2a9749b547f312aa09f8eebbd73e,2,71,79,150,21,2012-08-31 01:04:32,2012-08-31 01:04:32
5a06b8ad124c2a9749b547f312aa09f8eebbd73e...41136df9629176645fb64fb3bdd9f291f89aff61,1,4,0,4,2,2012-08-31 03:01:57,2012-08-31 03:01:57
41136df9629176645fb64fb3bdd9f291f89aff61...8f4045c1b9c39d42eb8ba6b0697065f7ad345b87,9,12,10,22,9,2012-08-31 04:00:42,2012-08-31 04:00:42
6b86b82883c3f5938119d115ac69d0d913dbbc23...e0b84cd87c6d69c6a406a6271068a4f99fe0bb2f,1,8,0,8,3,2012-08-30 04:02:31,2012-08-30 04:02:31
4c8fb7e56e1e9ea19f19607651934d734ea6d716...f95082d5196e18b4f0268ea7ba37f75d904a02ff,1,1,1,2,1,2012-05-08 22:39:14,2012-05-08 22:38:55
f95082d5196e18b4f0268ea7ba37f75d904a02ff...986ffbae49c12d1aa2b9dc85699fc4b792e3352d,4,44,28,72,18,2012-05-09 18:38:26,2012-05-09 18:38:26
986ffbae49c12d1aa2b9dc85699fc4b792e3352d...d0a1b43dc32357714fbb0f5cf13c245db1347c12,1,41,0,41,1,2012-05-09 23:58:59,2012-05-09 23:58:59
d0a1b43dc32357714fbb0f5cf13c245db1347c12...4f3d8151b631583845bac07cdc9e1b59dd1a4bb9,4,73,2,75,6,2012-05-10 06:55:02,2012-05-10 06:54:12
4f3d8151b631583845bac07cdc9e1b59dd1a4bb9...10092efab59f796e6716a765d10e057c25b22336,2,267,0,267,2,2012-05-11 01:53:00,2012-05-11 01:53:00
10092efab59f796e6716a765d10e057c25b22336...ffcf942447b5d2d3c34be6551fdb806ae9304230,1,8,8,16,1,2012-05-11 01:56:13,2012-05-11 01:56:13
ffcf942447b5d2d3c34be6551fdb806ae9304230...a8e3a266e493e9be77a59d86bb6ea3ecc43feb14,1,13,12,25,1,2012-05-11 19:36:41,2012-05-11 19:36:41
435aa6e0fc05348a7e4833efaa220340df6a3394...961e985801b1984d3e5a22b2c72878b19ed4ca77,1,4,0,4,1,2012-08-08 04:41:39,2012-08-08 04:41:39
961e985801b1984d3e5a22b2c72878b19ed4ca77...92b848fe1aff55658ae38d4e1b1aeb081370ca12,9,13,10,23,10,2012-08-08 06:02:12,2012-08-08 06:02:12
3fdac8ba3268fafcb0736a8c11304f033f838cf7...ac06cbb4b6c33ca913641bd35a3e492782c428ee,1,1,1,2,1,2012-07-18 03:23:33,2012-07-18 03:23:33
3fdac8ba3268fafcb0736a8c11304f033f838cf7...8036d1d4914589a6c62fadc5abad945b355f9ed3,2,393,348,741,67,2012-07-17 20:46:28,2012-06-08 19:02:23
8036d1d4914589a6c62fadc5abad945b355f9ed3...e47567a11e66e98c1416b627b6872a9e50256968,1,373,257,630,39,2012-07-17 20:46:28,2012-06-20 23:17:07
e47567a11e66e98c1416b627b6872a9e50256968...d4722ddfd779e4d612eae1f10f1fdfa7c031ec7c,2,59,114,173,18,2012-07-17 20:46:28,2012-06-26 03:56:49
d4722ddfd779e4d612eae1f10f1fdfa7c031ec7c...aafb5978b48d472580a2b72e0c1c2c7cf8534abb,4,419,530,949,82,2012-07-17 20:46:28,2012-06-30 05:54:23
aafb5978b48d472580a2b72e0c1c2c7cf8534abb...0b1384473d2ed702b066f2984bdbccabcc586111,2,61,8,69,9,2012-07-17 20:46:28,2012-07-03 01:53:43
0b1384473d2ed702b066f2984bdbccabcc586111...096f8e078ac64d48de9fa32be08540c5e4f31a44,2,1,1,2,1,2012-07-17 20:46:28,2012-07-03 02:01:35
096f8e078ac64d48de9fa32be08540c5e4f31a44...bca449879b9090e0a1d6f0a4ca265b516b121ff5,2,100,101,201,5,2012-07-17 20:46:29,2012-07-03 02:19:34
bca449879b9090e0a1d6f0a4ca265b516b121ff5...4edb813e7166072cd3f5b5967e7d38b1ee740661,1,4,12,16,4,2012-07-17 20:46:29,2012-07-03 02:50:57
4edb813e7166072cd3f5b5967e7d38b1ee740661...b809f4086753ad3c07cf047fb0c27ba9ce817028,2,83,0,83,2,2012-07-17 20:46:29,2012-07-03 04:17:29
b809f4086753ad3c07cf047fb0c27ba9ce817028...2379b0c1010e13a872fca845318fd82d8a403c5f,1,13,3,16,3,2012-07-17 20:46:29,2012-07-03 18:06:55
2379b0c1010e13a872fca845318fd82d8a403c5f...02284a672c578b8c1cb0add30930075970f22881,1,53,6,59,6,2012-07-17 20:46:29,2012-07-04 01:15:21
02284a672c578b8c1cb0add30930075970f22881...9a5bde6e0e247653a9676921a42b4ea8044b4981,3,62,20,82,16,2012-07-17 20:46:29,2012-07-05 23:50:32
9a5bde6e0e247653a9676921a42b4ea8044b4981...e7501784580ac1fe220ec938105780aee710639b,1,17,0,17,5,2012-07-17 20:46:29,2012-07-06 16:39:37
e7501784580ac1fe220ec938105780aee710639b...a1e90afd98bb0c16623c33ad328eebfa98500ddb,4,158,46,204,18,2012-07-17 20:46:30,2012-07-06 19:21:05
a1e90afd98bb0c16623c33ad328eebfa98500ddb...01e0a84e63e07746bd2931e7465771c51beac9cb,4,101,24,125,21,2012-07-17 20:46:30,2012-07-09 18:41:05
01e0a84e63e07746bd2931e7465771c51beac9cb...19ada8ad1681ad5f7add06ac186e8da5dad0113b,4,92,128,220,32,2012-07-17 20:46:30,2012-07-09 23:06:01
19ada8ad1681ad5f7add06ac186e8da5dad0113b...bd97b5e739ad86cb2d04b052572a6ca2c7acf870,2,75,36,111,18,2012-07-17 20:46:30,2012-07-09 23:40:41
bd97b5e739ad86cb2d04b052572a6ca2c7acf870...9d07be2a79724baf9f98ec7348ddb3c341d1e2a3,2,42,10,52,10,2012-07-17 20:46:30,2012-07-10 00:36:05
9d07be2a79724baf9f98ec7348ddb3c341d1e2a3...0471557c6701025a8ea7a5152d4eb28e52fd72fb,1,27,0,27,1,2012-07-17 20:46:30,2012-07-10 00:48:41
0471557c6701025a8ea7a5152d4eb28e52fd72fb...5370cb6100356405a680f5c9e1d9ce97382f883d,2,129,11,140,6,2012-07-17 20:46:30,2012-07-10 02:22:28
5370cb6100356405a680f5c9e1d9ce97382f883d...0719a88b80d6649bfa2b099839fece535f28675a,1,1,3,4,1,2012-07-17 20:46:30,2012-07-13 00:55:49
0719a88b80d6649bfa2b099839fece535f28675a...9ea0b8d95068f021fc6875c008f7837f687341f0,1,1,2,3,2,2012-07-17 20:46:30,2012-07-13 00:57:22
9ea0b8d95068f021fc6875c008f7837f687341f0...bc8a76c8f36f3fb994fa8417f33175f6e265b349,1,1,2,3,2,2012-07-17 20:46:30,2012-07-13 21:56:41
bc8a76c8f36f3fb994fa8417f33175f6e265b349...5855c9fcf41b57b15af4e19cdf5c5bdca2f68242,1,107,2,109,3,2012-07-17 20:46:31,2012-07-13 23:32:20
5855c9fcf41b57b15af4e19cdf5c5bdca2f68242...70ca9b98c8b2d3f391364762e074caa2da362a7d,1,39,1,40,3,2012-07-17 20:46:31,2012-07-16 17:59:44
70ca9b98c8b2d3f391364762e074caa2da362a7d...41bfedafe244eb0ab5c14373421f19722efa62e2,2,4,1,5,3,2012-07-17 22:14:54,2012-07-17 22:14:54
41bfedafe244eb0ab5c14373421f19722efa62e2...7ad1f5eff3c2bca109d37bdded1309fda7242263,7,194,46,240,10,2012-07-18 17:16:09,2012-07-18 17:16:09
7ad1f5eff3c2bca109d37bdded1309fda7242263...14ced70720bf1f6c45d6909f8a074efb57e0666c,6,251,26,277,7,2012-07-23 22:57:38,2012-07-23 22:57:38
14ced70720bf1f6c45d6909f8a074efb57e0666c...2e2ee290565ed1230d1ed02deb85ebc5328a4fbf,3,61,5,66,11,2012-07-23 23:30:28,2012-07-23 23:30:28
2e2ee290565ed1230d1ed02deb85ebc5328a4fbf...d1e87a2f2ea334c1a5afa858907b2eb2fc2e4f8b,2,59,21,80,8,2012-07-24 05:53:20,2012-07-24 05:53:20
d1e87a2f2ea334c1a5afa858907b2eb2fc2e4f8b...dd9ba59a24da77dcf229b6af7595da426a92ec08,1,1,1,2,1,2012-07-24 05:54:16,2012-07-24 05:54:16
dd9ba59a24da77dcf229b6af7595da426a92ec08...cc6ba5e3659c1cb101327a671493c157413dd032,2,76,22,98,8,2012-07-25 02:50:38,2012-07-25 02:50:38
cc6ba5e3659c1cb101327a671493c157413dd032...5c09c8b7c9cd91a8b5acff41152be14301caee77,2,28,21,49,7,2012-07-25 07:44:09,2012-07-25 07:44:01
5c09c8b7c9cd91a8b5acff41152be14301caee77...d8b340192f8c2e6c64670bc23a645ed90a1fdeb7,2,23,8,31,9,2012-07-26 17:24:49,2012-07-26 17:24:49
d8b340192f8c2e6c64670bc23a645ed90a1fdeb7...9d87a1468c362a55ef7cd3a9a27e1878408009a9,3,18,14,32,3,2012-07-26 17:34:11,2012-07-26 17:34:11
9d87a1468c362a55ef7cd3a9a27e1878408009a9...07029921bbcb33749007da6b0e80012b5620310c,5,20,4,24,5,2012-07-27 00:45:37,2012-07-27 00:45:37
07029921bbcb33749007da6b0e80012b5620310c...f61d15e3eba275b687997bd84d35ce15d4337597,2,131,0,131,2,2012-07-27 07:07:33,2012-07-27 07:07:33
f61d15e3eba275b687997bd84d35ce15d4337597...492bf11fcf94f02036efdfe022ab3ffac55258ce,1,1,1,2,1,2012-07-27 07:08:33,2012-07-27 07:08:33
492bf11fcf94f02036efdfe022ab3ffac55258ce...2f4e1d0586693bd28a7d40f3e99bf2211f06a89a,7,57,63,120,53,2012-07-27 20:40:33,2012-07-27 20:40:33
2f4e1d0586693bd28a7d40f3e99bf2211f06a89a...328a2af8331a0a15f8b9f435ef272ba64a5c9a90,17,199,13,212,17,2012-07-27 21:27:34,2012-07-27 21:27:34
328a2af8331a0a15f8b9f435ef272ba64a5c9a90...3dbccc131cfb2cc3a888703b4fa695d370df77ff,6,192,16,208,16,2012-07-27 22:32:51,2012-07-27 22:32:51
3dbccc131cfb2cc3a888703b4fa695d370df77ff...8d769cc54631bc570764e117f152b966bdada96d,3,1,312,313,4,2012-07-27 22:34:09,2012-07-27 22:34:09
8d769cc54631bc570764e117f152b966bdada96d...e6de65be763116f29b0541543b32da1e19a30a21,6,161,49,210,21,2012-07-28 00:46:56,2012-07-28 00:46:56
e6de65be763116f29b0541543b32da1e19a30a21...b9307480017088af9ffe684a7785fe801bcfe3ec,2,31,0,31,2,2012-07-28 01:08:48,2012-07-28 01:08:48
b9307480017088af9ffe684a7785fe801bcfe3ec...13dbbc7a554b3dfc31aef8e7ef656922b182ecf0,1,42,9,51,9,2012-07-28 01:46:29,2012-07-28 01:46:29
13dbbc7a554b3dfc31aef8e7ef656922b182ecf0...17a1d972092a5ae5a3e89a7ae2db463e7bd56086,5,124,14,138,14,2012-07-28 02:41:27,2012-07-28 02:41:27
17a1d972092a5ae5a3e89a7ae2db463e7bd56086...8ddf39f95c5b562a3a714484b1dff7294451e937,4,241,7,248,6,2012-07-28 03:25:38,2012-07-28 03:25:38
8ddf39f95c5b562a3a714484b1dff7294451e937...e3b4fd652b42057fdefa164c0f732136f3728da5,1,0,316,316,2,2012-07-28 03:29:12,2012-07-28 03:29:12
e3b4fd652b42057fdefa164c0f732136f3728da5...6dcef0ccac73ebb2659ae0dbd42cf566a1def4c9,1,2,2,4,2,2012-07-28 03:33:44,2012-07-28 03:33:44
6dcef0ccac73ebb2659ae0dbd42cf566a1def4c9...58ff74bfe7e7e573c0a9f03d4385dbe1f3305c24,2,54,39,93,13,2012-07-30 03:57:37,2012-07-30 03:57:37
58ff74bfe7e7e573c0a9f03d4385dbe1f3305c24...00f192b895494e09f4153bd43b84ffded30fb021,1,0,3,3,1,2012-07-30 17:51:23,2012-07-30 17:51:23
00f192b895494e09f4153bd43b84ffded30fb021...787b469e096d951da0368f3b12ea53ec57050eae,1,17,5,22,6,2012-07-30 18:08:39,2012-07-30 18:08:39
787b469e096d951da0368f3b12ea53ec57050eae...3d945ab22691533871b63580ce2d13d054acc9a3,1,2,2,4,2,2012-07-30 18:09:30,2012-07-30 18:09:30
3d945ab22691533871b63580ce2d13d054acc9a3...b3229fc4c2341ca22a44a788eb3d96fbec3dfb41,2,90,3,93,4,2012-07-30 18:33:32,2012-07-30 18:33:32
b3229fc4c2341ca22a44a788eb3d96fbec3dfb41...8e61005f3e38ad8fe78f2f14ba076df75945a5f7,6,499,357,856,27,2012-07-30 22:00:08,2012-07-30 22:00:08
8e61005f3e38ad8fe78f2f14ba076df75945a5f7...ee1fc4a6d7a7161f30178f1d883b8c923256c5c3,1,58,61,119,7,2012-07-31 01:10:48,2012-07-31 01:10:48
ee1fc4a6d7a7161f30178f1d883b8c923256c5c3...57e851787b12d644f7695dd788fddc220dc55e66,7,98,58,156,46,2012-07-31 01:58:00,2012-07-31 01:34:02
57e851787b12d644f7695dd788fddc220dc55e66...3b3567f86a12af43472fbe6dd3f5d231ea8bb3b4,3,106,43,149,20,2012-08-01 18:45:07,2012-08-01 18:45:07
3b3567f86a12af43472fbe6dd3f5d231ea8bb3b4...d1a91876c716de4ca88e8ac7461282105738e05d,1,36,60,96,7,2012-08-01 20:09:00,2012-08-01 20:09:00
d1a91876c716de4ca88e8ac7461282105738e05d...95aa00f0f2e31f77acfa3158f02d8e0bd31cd3f5,3,54,54,108,13,2012-08-01 22:08:49,2012-08-01 22:08:49
95aa00f0f2e31f77acfa3158f02d8e0bd31cd3f5...9bcebc0fd2a8e160feef01b4552e12fbb0fbe44e,1,152,7,159,10,2012-08-02 00:17:25,2012-08-02 00:17:25
9bcebc0fd2a8e160feef01b4552e12fbb0fbe44e...46238fd47371e2bcc05447e8b6ea658ff84ea79f,3,103,85,188,6,2012-08-02 01:34:32,2012-08-02 01:34:32
46238fd47371e2bcc05447e8b6ea658ff84ea79f...4fcd32766863b0c692d22a3dda2a385797918e66,3,643,533,1176,64,2012-08-02 04:13:55,2012-08-02 04:13:55
4fcd32766863b0c692d22a3dda2a385797918e66...1805a0b136b73a9f038e5b836d70abb83dba5a96,1,49,37,86,7,2012-08-02 18:17:54,2012-08-02 18:17:54
1805a0b136b73a9f038e5b836d70abb83dba5a96...1535b43d36e5ab50affdf1101ab09dfc092e9a58,1,0,1,1,1,2012-08-02 21:46:25,2012-08-02 21:46:25
1535b43d36e5ab50affdf1101ab09dfc092e9a58...a1ec9b425e2ffdc056324ac57ce7500d9b18d9d0,1,57,48,105,7,2012-08-02 22:27:03,2012-08-02 22:27:03
a1ec9b425e2ffdc056324ac57ce7500d9b18d9d0...65aef7c5a17833b582633bd749a2830adaa44245,1,301,4,305,6,2012-08-02 22:28:17,2012-08-02 21:44:27
65aef7c5a17833b582633bd749a2830adaa44245...9499911fe11ef2bf9e13bff229a6f7e575170e27,1,32,170,202,10,2012-08-02 22:42:39,2012-08-02 22:42:39
9499911fe11ef2bf9e13bff229a6f7e575170e27...e213c9c3ba573dbb54b2724efb941b2790ec2883,3,50,2,52,3,2012-08-02 22:58:32,2012-08-02 22:58:32
e213c9c3ba573dbb54b2724efb941b2790ec2883...cccc42075165311a55ae1a15c45ecec165fee7b0,1,8,8,16,6,2012-08-02 23:26:33,2012-08-02 23:26:33
cccc42075165311a55ae1a15c45ecec165fee7b0...0ad6393fb2c90af58e749c84c5a9fe658080a392,1,139,0,139,1,2012-08-03 00:31:40,2012-08-03 00:31:40
0ad6393fb2c90af58e749c84c5a9fe658080a392...4f52054cd95612f4bafe6cf7a916bbb8580193ea,5,707,157,864,12,2012-08-03 02:39:00,2012-08-03 02:39:00
4f52054cd95612f4bafe6cf7a916bbb8580193ea...e5d0bad8dd80633bc15b44400dd05be47e2c3594,3,122,124,246,6,2012-08-03 03:44:29,2012-08-03 03:44:15
e5d0bad8dd80633bc15b44400dd05be47e2c3594...646e37dc371cd7b73ff2855a228e498e1d530f3f,1,47,39,86,25,2012-08-03 04:15:01,2012-08-03 04:13:32
646e37dc371cd7b73ff2855a228e498e1d530f3f...8ccf953e7763050d14c200e43ba186439d6231e8,1,1,1,2,1,2012-08-03 04:15:01,2012-08-03 04:13:49
8ccf953e7763050d14c200e43ba186439d6231e8...a8e487be82226e581254dc6fb6f2a63eb478a38d,1,3,2,5,2,2012-08-03 05:32:11,2012-08-03 05:32:11
a8e487be82226e581254dc6fb6f2a63eb478a38d...9ea8c0d6e213193b470da7792d33f8cd85f8f04b,1,103,4,107,7,2012-08-03 06:17:25,2012-08-03 04:59:51
9ea8c0d6e213193b470da7792d33f8cd85f8f04b...66e3d6856d04a1c0197166a8a991af9c04a781dc,1,13,0,13,1,2012-08-03 06:36:50,2012-08-03 06:36:50
66e3d6856d04a1c0197166a8a991af9c04a781dc...24ca8017912fd11b7c0ea2e76258271d0cd1e971,1,7,1,8,2,2012-08-03 19:13:30,2012-08-03 06:36:50
24ca8017912fd11b7c0ea2e76258271d0cd1e971...132459117bc5be3ad6be00865da155aea0fcc58b,4,1430,1434,2864,20,2012-08-03 19:13:30,2012-08-03 19:13:23
132459117bc5be3ad6be00865da155aea0fcc58b...2dcbe587c571e714e1a5c1460738a92adf5578e9,3,7,8,15,7,2012-08-03 19:19:02,2012-08-03 19:19:02
2dcbe587c571e714e1a5c1460738a92adf5578e9...fb7410c8ec69009a0d1d281bfcdeabcc4332b896,6,5,105,110,7,2012-08-03 19:28:59,2012-08-03 19:28:59
fb7410c8ec69009a0d1d281bfcdeabcc4332b896...c6ec5b16732297c7f6e6a935c19533290d510c71,4,30,17,47,8,2012-08-03 19:53:03,2012-08-03 19:53:03
c6ec5b16732297c7f6e6a935c19533290d510c71...5654f7be08fdf76ff5bc60e0396afbef20e705af,2,86,33,119,28,2012-08-04 00:25:14,2012-08-04 00:25:14
5654f7be08fdf76ff5bc60e0396afbef20e705af...5941cc425c3925161aab122b13d19f79a790064f,1,1,1,2,1,2012-08-04 00:25:34,2012-08-04 00:23:50
5941cc425c3925161aab122b13d19f79a790064f...8396a373033b8a8a6105a0c3d67e6d46b8bfd83f,4,145,60,205,21,2012-08-04 04:29:56,2012-08-04 04:29:56
8396a373033b8a8a6105a0c3d67e6d46b8bfd83f...a59a6ca0fe24f14a9a26669f13b64200a284eea9,2,56,17,73,9,2012-08-04 05:05:51,2012-08-04 05:05:51
a59a6ca0fe24f14a9a26669f13b64200a284eea9...1483cc3b511b03e086e10781df1ff12d2be10eac,14,40,1597,1637,24,2012-08-04 06:30:15,2012-08-04 06:30:15
1483cc3b511b03e086e10781df1ff12d2be10eac...bc54cecb9e9ca224eb83105531638c0b77eb481f,1,24,44,68,4,2012-08-04 15:12:08,2012-08-04 15:12:08
bc54cecb9e9ca224eb83105531638c0b77eb481f...7598ce85a429e3d6414a7a21e7c1aad012cbbeb7,1,25,23,48,5,2012-08-04 15:24:45,2012-08-04 15:24:45
7598ce85a429e3d6414a7a21e7c1aad012cbbeb7...7b04b0c1c33821c0fe8ac17126b9c690ce014fbf,1,29,28,57,6,2012-08-04 15:33:50,2012-08-04 15:33:50
7b04b0c1c33821c0fe8ac17126b9c690ce014fbf...4aee952f73875126b9e0e3570fdd66292652845b,1,27,20,47,9,2012-08-04 15:45:56,2012-08-04 15:45:56
4aee952f73875126b9e0e3570fdd66292652845b...e1f44a5d0df53145e2353b8854903342d85752c9,1,17,10,27,5,2012-08-04 16:03:06,2012-08-04 16:03:06
e1f44a5d0df53145e2353b8854903342d85752c9...25533167d495b3551a7159195206e6fefc37bfc2,1,30,28,58,5,2012-08-04 16:29:13,2012-08-04 16:29:13
25533167d495b3551a7159195206e6fefc37bfc2...39e8818402ad063767227512e2354a03ab580af4,1,8,17,25,4,2012-08-04 16:34:55,2012-08-04 16:34:55
39e8818402ad063767227512e2354a03ab580af4...a40d5b93dba51e834581e4a27c309c3499343675,1,18,15,33,3,2012-08-04 16:46:42,2012-08-04 16:46:42
a40d5b93dba51e834581e4a27c309c3499343675...c298d031a0409bf64fc1eb2e825d4d93420547f5,1,120,102,222,3,2012-08-04 17:08:39,2012-08-04 17:06:39
c298d031a0409bf64fc1eb2e825d4d93420547f5...58a9c65ac2a4dbbb550b46801ef8c4148b36aa99,1,12,16,28,6,2012-08-04 17:14:15,2012-08-04 17:14:15
58a9c65ac2a4dbbb550b46801ef8c4148b36aa99...5edbfe958d353fedc0ff20d19504a31d6fc29c39,1,18,37,55,8,2012-08-04 17:22:04,2012-08-04 17:20:45
5edbfe958d353fedc0ff20d19504a31d6fc29c39...f3b491fab6707c1b2397154b89f0590f3fec340d,2,47,29,76,28,2012-08-05 05:57:00,2012-08-05 05:57:00
f3b491fab6707c1b2397154b89f0590f3fec340d...4e43f59c74876bea562a34ad7131346d61e98d18,5,87,76,163,19,2012-08-05 06:21:40,2012-08-05 06:21:40
4e43f59c74876bea562a34ad7131346d61e98d18...92a2391b6cf8c76a919e545d5a0271cd89975327,1,11,5,16,5,2012-08-05 06:27:32,2012-08-05 06:27:32
92a2391b6cf8c76a919e545d5a0271cd89975327...9c389453b689530285848233d6ffe184aeee6e7e,2,75,54,129,23,2012-08-05 07:24:55,2012-08-05 07:24:55
9c389453b689530285848233d6ffe184aeee6e7e...a2e9358eecbff95bc6696551607d49f7004f5b9a,2,193,0,193,4,2012-08-05 08:47:12,2012-08-05 08:47:12
a2e9358eecbff95bc6696551607d49f7004f5b9a...4760a5fbfa5ba2f701ee68731351cbe4da426ed0,2,64,68,132,25,2012-08-05 09:25:53,2012-08-05 09:25:53
4760a5fbfa5ba2f701ee68731351cbe4da426ed0...8273c2727b490b79a3796e978067566470ba0b80,2,4,6,10,4,2012-08-05 09:34:01,2012-08-05 09:34:01
8273c2727b490b79a3796e978067566470ba0b80...5e8b033f612c2722f736f3c8287316939a11c9f8,6,177,177,354,109,2012-08-07 01:38:43,2012-08-07 01:38:43
5e8b033f612c2722f736f3c8287316939a11c9f8...6b8a775f83073aab81ed8f028748c7b01a57994c,2,73,1,74,6,2012-08-07 13:27:53,2012-08-07 13:27:53
6b8a775f83073aab81ed8f028748c7b01a57994c...a9dac1f0aa56fbd1a83aa7e9e0bde1a61b748726,1,79,66,145,18,2012-08-07 23:36:57,2012-08-07 23:05:13
a9dac1f0aa56fbd1a83aa7e9e0bde1a61b748726...14704f846843396d3b5e6778c54d27bfff9a8eb7,1,34,38,72,19,2012-08-07 23:59:23,2012-08-07 23:59:23
14704f846843396d3b5e6778c54d27bfff9a8eb7...de53ca9205f01ec54d38afe4f74c313584540903,1,10,2,12,2,2012-08-08 02:40:48,2012-08-08 02:40:48
de53ca9205f01ec54d38afe4f74c313584540903...14b8f526fb8570f6919d3b21e6c8f8c11b94f205,3,45,48,93,21,2012-08-08 05:30:58,2012-08-08 05:30:58
14b8f526fb8570f6919d3b21e6c8f8c11b94f205...4ab40534fe4f42037251ee5e31072e74565d96cd,2,134,119,253,32,2012-08-08 17:55:28,2012-08-08 17:51:58
4ab40534fe4f42037251ee5e31072e74565d96cd...f3a66b59f2541bf4e8cb8fa791411d89e22b0ff6,1,2,1,3,1,2012-08-08 21:37:25,2012-08-08 21:37:25
f3a66b59f2541bf4e8cb8fa791411d89e22b0ff6...88d13f1862da779bcb08e3fbf9e265ae9d29f8cb,3,88,9,97,16,2012-08-08 21:39:14,2012-08-08 21:39:14
88d13f1862da779bcb08e3fbf9e265ae9d29f8cb...212b4b940ed0be3e84ba4eb8259bc6913375e0a6,1,26,7,33,3,2012-08-08 22:04:48,2012-08-08 22:02:44
212b4b940ed0be3e84ba4eb8259bc6913375e0a6...7411ae058f05aef2bd020bcc85e9e3bb580bd846,1,1,8,9,4,2012-08-08 22:20:55,2012-08-08 22:19:50
7411ae058f05aef2bd020bcc85e9e3bb580bd846...7ba39d96cb52ffa4d11cad7a662aaa6d2adbf918,2,167,90,257,15,2012-08-08 23:08:12,2012-08-08 23:08:12
7ba39d96cb52ffa4d11cad7a662aaa6d2adbf918...f766cf29fc140ffaeff735f1e155ff31d13c7ae3,7,175,22,197,11,2012-08-09 00:05:56,2012-08-09 00:05:36
f766cf29fc140ffaeff735f1e155ff31d13c7ae3...a44b9205a0deb80d7bd1d05f068bb97eda9ff6a5,4,115,63,178,17,2012-08-09 00:12:34,2012-08-09 00:04:07
a44b9205a0deb80d7bd1d05f068bb97eda9ff6a5...4ec97272b539fd72cbf3f87e4f6c4af498fb059f,2,32,3,35,6,2012-08-09 00:25:28,2012-08-09 00:25:28
4ec97272b539fd72cbf3f87e4f6c4af498fb059f...42356f717164d725f888866231211c274a7d8e6a,1,0,0,0,0,2012-08-09 00:36:07,2012-08-09 00:36:07
42356f717164d725f888866231211c274a7d8e6a...07113b62769bed286b24d2d63f7c9e0b55e63300,3,17,2,19,3,2012-08-09 00:51:04,2012-08-09 00:51:04
07113b62769bed286b24d2d63f7c9e0b55e63300...80c5e2a5caa078f2516b530560764d1a23f2d9b9,2,31,18,49,8,2012-08-09 01:22:54,2012-08-09 01:19:07
80c5e2a5caa078f2516b530560764d1a23f2d9b9...b4ccc65f54624eeb2de4d2ddf4c5ce15273a23f6,3,36,8,44,8,2012-08-09 01:23:54,2012-08-09 01:23:25
b4ccc65f54624eeb2de4d2ddf4c5ce15273a23f6...05444bbce50d6ed7fe038ab4af0c4db7fc680cf7,3,21,4,25,5,2012-08-09 01:55:43,2012-08-09 01:55:15
05444bbce50d6ed7fe038ab4af0c4db7fc680cf7...1cd8e1bef6b7709df1a7b463a675b7e6b61267e0,1,20,0,20,5,2012-08-09 02:20:41,2012-08-09 02:20:41
1cd8e1bef6b7709df1a7b463a675b7e6b61267e0...64bc13ef5b33d6db4315e307ab30247406088742,1,1,1,2,1,2012-08-09 19:43:15,2012-08-09 19:43:15
64bc13ef5b33d6db4315e307ab30247406088742...b7e122ef40e755c71d501ded34658ca383970230,1,0,7,7,3,2012-08-09 20:27:17,2012-08-09 20:27:17
b7e122ef40e755c71d501ded34658ca383970230...aebbd14c40db3d16ea2cca0a255dfa0f45e231c5,2,26,12,38,6,2012-08-09 20:40:49,2012-08-09 20:40:49
aebbd14c40db3d16ea2cca0a255dfa0f45e231c5...f35c6c140501960713de11d8f49cbc57cdc37eae,1,6,1,7,1,2012-08-09 21:49:56,2012-08-09 21:49:56
f35c6c140501960713de11d8f49cbc57cdc37eae...900695b68ccf6d7e40390df0ba12ab4480dc5871,4,20,12,32,4,2012-08-09 22:37:00,2012-08-09 22:37:00
900695b68ccf6d7e40390df0ba12ab4480dc5871...cad497de08d2a3737a534bf2696dfa8a84fe65c5,3,59,1,60,4,2012-08-09 22:46:56,2012-08-09 22:46:56
cad497de08d2a3737a534bf2696dfa8a84fe65c5...d696b9a611d0cc812689716318cd8f4cc0109fba,2,91,61,152,12,2012-08-10 00:48:50,2012-08-10 00:48:50
d696b9a611d0cc812689716318cd8f4cc0109fba...2242419ff6fb79280c3515c3c30e6865e15c18e6,2,38,24,62,5,2012-08-10 01:32:11,2012-08-10 01:32:06
2242419ff6fb79280c3515c3c30e6865e15c18e6...3e75ed625ab7b127e508da4748894f52b27f6249,2,7,1,8,2,2012-08-10 01:59:34,2012-08-10 00:57:32
3e75ed625ab7b127e508da4748894f52b27f6249...fe1e65cd9df746f4d0fec1f3ce1e2564dd651934,1,3,4,7,1,2012-08-10 01:59:34,2012-08-10 01:37:32
fe1e65cd9df746f4d0fec1f3ce1e2564dd651934...effc8cb42a6d6fde1596a073783c1245298f6a5f,2,31,7,38,4,2012-08-10 02:21:58,2012-08-10 01:49:22
effc8cb42a6d6fde1596a073783c1245298f6a5f...b7a29d5f8f0a81dd68b73b59fe00b708dfc4db13,1,8,7,15,5,2012-08-10 03:58:25,2012-08-10 03:58:25
b7a29d5f8f0a81dd68b73b59fe00b708dfc4db13...be3790ca5e78217bdcd2c4f9518c19f91718c878,1,10,0,10,1,2012-08-10 04:09:01,2012-08-10 04:09:01
be3790ca5e78217bdcd2c4f9518c19f91718c878...eff18190b0fba52a47be6d1cd0776c8fc90a7b17,4,7226,1,7227,6,2012-08-10 10:28:09,2012-08-10 10:28:09
eff18190b0fba52a47be6d1cd0776c8fc90a7b17...bc8aadff7c8b10f099aaf73c1610bf60aeccefc1,2,9,2,11,4,2012-08-10 10:38:06,2012-08-10 10:38:06
bc8aadff7c8b10f099aaf73c1610bf60aeccefc1...00e2788edb160ae17c2d409fc15a7b42989556b5,2,67,0,67,7,2012-08-10 19:05:37,2012-08-10 19:05:04
00e2788edb160ae17c2d409fc15a7b42989556b5...1ceca3eaef08222b7228dd41f6a4640a9d1d3c28,6,107,25,132,16,2012-08-10 19:53:14,2012-08-10 19:50:18
1ceca3eaef08222b7228dd41f6a4640a9d1d3c28...fec60a5ea9642ec4a35a43efed6ab7acab55f58d,5,65,39,104,21,2012-08-10 23:37:47,2012-08-10 23:37:47
fec60a5ea9642ec4a35a43efed6ab7acab55f58d...efaa885a7b65fc68080bda0c84fbbad534eedb1b,1,47,16,63,6,2012-08-11 03:17:37,2012-08-11 03:17:32
efaa885a7b65fc68080bda0c84fbbad534eedb1b...0a198d839dbc3e2dfebf6d069bcde9373ecb7547,1,4,4,8,3,2012-08-12 18:44:03,2012-08-12 18:44:03
0a198d839dbc3e2dfebf6d069bcde9373ecb7547...ded6c4901bdfdf0ed183caf9bb8f374810be5ba9,4,43,9,52,13,2012-08-13 17:02:43,2012-08-13 17:02:11
ded6c4901bdfdf0ed183caf9bb8f374810be5ba9...2ddf2b1f83f41ca6bca5d2045f2e15757cb23c80,5,154,4,158,7,2012-08-13 17:45:04,2012-08-13 17:45:04
2ddf2b1f83f41ca6bca5d2045f2e15757cb23c80...bfa08c964ebaac23e7b77fa4605129b94061c833,2,31,2,33,2,2012-08-13 19:40:54,2012-08-13 19:40:54
bfa08c964ebaac23e7b77fa4605129b94061c833...a17b2e4bf2805a78bbedfc2dc4bcee3dabd25d93,3,102,1,103,3,2012-08-13 19:41:20,2012-08-13 19:41:20
a17b2e4bf2805a78bbedfc2dc4bcee3dabd25d93...c9a80490fc52031b3185c463682ab4ee6bf4493a,2,18,3,21,6,2012-08-13 21:08:33,2012-08-13 19:53:07
c9a80490fc52031b3185c463682ab4ee6bf4493a...7f8bda273779de48352cc8140effc607cc691607,1,0,2,2,1,2012-08-13 21:18:09,2012-08-13 21:18:09
7f8bda273779de48352cc8140effc607cc691607...81912496f601b36f153fc361467e10847801536c,2,7,2,9,3,2012-08-13 21:22:11,2012-08-13 21:22:11
2ac2ffd4275ffb858328800de2cda572c2d1b565...26035a73b88b5da9d589f2c3f55e422f327cbd36,1,40,28,68,11,2012-09-09 00:46:23,2012-09-09 00:46:23
8f4045c1b9c39d42eb8ba6b0697065f7ad345b87...58c03ad5da319ef2a111a33fb1493c0fc7c5b9a7,1,3,3,6,3,2012-09-21 23:59:03,2012-09-21 23:58:17
8f4045c1b9c39d42eb8ba6b0697065f7ad345b87...233626de8602149594ad7a86d7961f3a42195a88,5,54,26,80,10,2012-09-06 17:20:22,2012-09-05 22:54:51
233626de8602149594ad7a86d7961f3a42195a88...6cc67f43738943aa54107033081b758f9df5d747,1,2,2,4,2,2012-09-06 19:13:30,2012-09-06 19:13:30
6cc67f43738943aa54107033081b758f9df5d747...5697cc568b91681728e8d3c033ce56d7bbd9b758,1,9,0,9,1,2012-09-06 23:51:47,2012-09-06 23:51:47
8f4045c1b9c39d42eb8ba6b0697065f7ad345b87...01548403d0cccb3460281400b30544b34cb100e4,2,2,2,4,2,2012-08-31 20:58:19,2012-08-31 20:58:06
01548403d0cccb3460281400b30544b34cb100e4...a8e963d8ca45c2d39e85ab0c21f28b8f6fbf63c2,1,22,40,62,11,2012-08-31 20:58:19,2012-08-31 20:57:15
a8e963d8ca45c2d39e85ab0c21f28b8f6fbf63c2...70e82dd5f95c87813cea8658ed9c693eaa4b7f3a,8,18,18,36,17,2012-08-31 21:04:06,2012-08-31 21:04:06
70e82dd5f95c87813cea8658ed9c693eaa4b7f3a...44f3e94c7f7d547a1b4f3f0e1768b41bc32832e2,1,3,3,6,3,2012-08-31 21:05:51,2012-08-31 21:05:51
44f3e94c7f7d547a1b4f3f0e1768b41bc32832e2...8d759523da0a18514a433b458974bf72efc50308,1,1,0,1,1,2012-08-31 21:46:28,2012-08-31 21:46:28
8d759523da0a18514a433b458974bf72efc50308...a0f64a317a95206b85f5a7662eb3d519d62faf08,1,1,50,51,1,2012-08-31 21:48:15,2012-08-31 21:44:36
a0f64a317a95206b85f5a7662eb3d519d62faf08...73ba7d1db1cd9d9021d08b7f2e67e41a6a1c7d1a,2,81,0,81,2,2012-09-01 02:08:57,2012-09-01 02:08:57
73ba7d1db1cd9d9021d08b7f2e67e41a6a1c7d1a...9add20292d1251868278ab650252ac3bbbed3495,1,6,17,23,11,2012-09-01 02:18:49,2012-09-01 02:18:49
9add20292d1251868278ab650252ac3bbbed3495...64bd3f782dc38b8a0d9575e632fffd14c593f2d7,2,55,32,87,22,2012-09-05 04:26:09,2012-09-05 03:19:00
64bd3f782dc38b8a0d9575e632fffd14c593f2d7...fe836775fd89b92910fb21bf67879233adc2ebfa,1,1,1,2,1,2012-09-05 04:26:09,2012-09-05 03:19:43
fe836775fd89b92910fb21bf67879233adc2ebfa...9e5c1fc15e08ec151c2f0706acc7d87781e468e5,1,1,1,2,1,2012-09-05 04:26:09,2012-09-05 04:21:12
9e5c1fc15e08ec151c2f0706acc7d87781e468e5...4498058a627721969f4032896c530ce5f933a035,1,4,2,6,3,2012-09-05 05:55:04,2012-09-05 05:55:04
4498058a627721969f4032896c530ce5f933a035...b672b780d8b725c354a024d0c83ce6a393c52f09,2,2,2,4,2,2012-09-07 02:44:23,2012-09-07 02:44:23
a8e3a266e493e9be77a59d86bb6ea3ecc43feb14...654579b2a2ec4efd7183267c86e0782ccec27251,1,115,70,185,5,2012-05-11 19:37:06,2012-05-04 23:02:19
654579b2a2ec4efd7183267c86e0782ccec27251...e64e756eb8b15fe24309cc23d0a04d77f0992d0b,3,150,19,169,12,2012-05-11 19:37:06,2012-05-07 20:47:00
e64e756eb8b15fe24309cc23d0a04d77f0992d0b...a288e9a26c3875fb0d1687c52b123c37c524d136,4,182,11,193,13,2012-05-11 19:37:07,2012-05-07 22:12:06
a288e9a26c3875fb0d1687c52b123c37c524d136...feed0fce0fc083eacfd949045f5dc95d6428502b,5,159,52,211,26,2012-05-11 19:37:07,2012-05-08 02:11:23
feed0fce0fc083eacfd949045f5dc95d6428502b...e7b3dd9e2eba3e1aef04511f0109ad4e9521326d,2,1,281,282,5,2012-05-11 19:37:07,2012-05-08 02:16:50
e7b3dd9e2eba3e1aef04511f0109ad4e9521326d...f024b233b53269a759859051a00fa0204e086cde,1,23,1,24,2,2012-05-11 19:37:07,2012-05-08 06:56:30
f024b233b53269a759859051a00fa0204e086cde...871c2b3dd1167d36b1b5e9bec9a0f9e6aca00763,2,31,9,40,10,2012-05-11 19:37:07,2012-05-08 22:54:50
871c2b3dd1167d36b1b5e9bec9a0f9e6aca00763...cd74df4470c814291d10f503825962f9f3612d50,4,207,3,210,4,2012-05-11 19:37:08,2012-05-09 18:13:31
cd74df4470c814291d10f503825962f9f3612d50...a458293c9aafb118090f4806287e60878dd5cbb7,2,16,7,23,11,2012-05-11 19:37:08,2012-05-09 18:17:33
a458293c9aafb118090f4806287e60878dd5cbb7...a1ec70698229ccd26685f736e2479d4f68be0620,4,98,362,460,13,2012-05-11 19:37:08,2012-05-09 18:34:50
a1ec70698229ccd26685f736e2479d4f68be0620...727f75928307303032f4422969d045f02546cb25,6,164,153,317,24,2012-05-11 19:37:08,2012-05-09 19:11:35
727f75928307303032f4422969d045f02546cb25...3011a9a338ca5b9d782fdf9fb2b6e26ade808f21,2,12,11,23,11,2012-05-11 19:37:08,2012-05-09 19:19:00
3011a9a338ca5b9d782fdf9fb2b6e26ade808f21...93f08e684c6583c736ccbe454465c65f9e3e17b4,2,210,189,399,20,2012-05-11 19:37:09,2012-05-09 22:05:13
93f08e684c6583c736ccbe454465c65f9e3e17b4...405be310c2f7dc93bc5af026447a86477b59d56d,2,156,155,311,39,2012-05-11 19:37:09,2012-05-09 23:23:02
405be310c2f7dc93bc5af026447a86477b59d56d...1744cb8af998936d42172da979bf8f86c54c88c0,4,6,8,14,5,2012-05-11 19:37:09,2012-05-10 00:04:20
1744cb8af998936d42172da979bf8f86c54c88c0...1df3de2d5da15b9bd5450ee82a48e39feca8727d,4,112,19,131,19,2012-05-11 19:37:09,2012-05-10 01:49:09
1df3de2d5da15b9bd5450ee82a48e39feca8727d...316fcbb7a130fa04147495f28d2e907b18362e61,3,39,4,43,8,2012-05-11 19:37:09,2012-05-10 02:13:22
316fcbb7a130fa04147495f28d2e907b18362e61...a09c946ea2dbbfd65f1fe4ea45d49f27e1c17f10,4,107,81,188,24,2012-05-11 19:37:10,2012-05-10 19:00:48
a09c946ea2dbbfd65f1fe4ea45d49f27e1c17f10...6ea4976d1917216dd0b772f5a3c1274a5e8b41ea,1,6,0,6,1,2012-05-11 19:37:10,2012-05-10 21:42:44
6ea4976d1917216dd0b772f5a3c1274a5e8b41ea...4c38c567c75ff3578ef33b9f4f19504ec94d1f32,2,1,14,15,2,2012-05-11 19:37:10,2012-05-10 21:47:39
4c38c567c75ff3578ef33b9f4f19504ec94d1f32...2738e7798af494478d303e324cbf16cd025a0856,1,3,4,7,1,2012-05-11 19:37:10,2012-05-10 21:53:02
2738e7798af494478d303e324cbf16cd025a0856...fbb0188d0e0b12044bda344f529fa44a2ec7653d,1,3,0,3,1,2012-05-11 19:37:10,2012-05-10 22:08:51
fbb0188d0e0b12044bda344f529fa44a2ec7653d...370cb47eb5508e16815e2b092c083788594a096e,2,18,7,25,10,2012-05-11 19:37:11,2012-05-10 23:02:55
370cb47eb5508e16815e2b092c083788594a096e...8bd3ebc50b9a205655780279f14dcbf976535ed4,2,7,10,17,5,2012-05-11 19:37:11,2012-05-10 23:07:21
8bd3ebc50b9a205655780279f14dcbf976535ed4...fe3bbee30552f6677d0527e04e1f24e21814aa30,3,112,33,145,17,2012-05-11 19:37:11,2012-05-11 00:38:29
fe3bbee30552f6677d0527e04e1f24e21814aa30...7f5cd5c4e8f98da223d56cd7c2535b6154542f18,1,27,0,27,4,2012-05-11 19:37:11,2012-05-11 01:11:14
7f5cd5c4e8f98da223d56cd7c2535b6154542f18...e4af13ab57049da08bfcf2ab8402557e969cabf6,1,6,0,6,1,2012-05-11 19:37:11,2012-05-11 01:19:31
e4af13ab57049da08bfcf2ab8402557e969cabf6...15d38fefcd832aa0aae320e08e32476b622c8498,1,45,0,45,1,2012-05-11 19:37:12,2012-05-11 18:19:49
15d38fefcd832aa0aae320e08e32476b622c8498...1a1499253a5f72f7c962feebc7335a46c1fc0f62,1,3,2,5,1,2012-05-11 19:37:12,2012-05-11 19:19:58
92b848fe1aff55658ae38d4e1b1aeb081370ca12...cb95d44cb39bedfffcd41dedfbfb5243b1af7809,1,1,1,2,1,2012-08-14 17:54:30,2012-08-14 17:54:30
cb95d44cb39bedfffcd41dedfbfb5243b1af7809...b21da0f274a59424b38573dfef43938582951350,2,41,1,42,2,2012-08-15 02:41:24,2012-07-05 01:44:58
ac06cbb4b6c33ca913641bd35a3e492782c428ee...a2d5bfa6dbbecff94877142a57bb212aa7f2a590,1,16,15,31,2,2012-07-21 02:35:48,2012-06-11 22:45:26
ac06cbb4b6c33ca913641bd35a3e492782c428ee...139a4c33fd42e3343557cb5f207c9dc057162a25,12,27,14,41,16,2012-07-18 04:00:29,2012-07-18 04:00:29
81912496f601b36f153fc361467e10847801536c...ab7d547d26fdf8e074ae42ff73c51560a0b0853a,2,52,0,52,2,2012-08-13 22:04:42,2012-08-11 04:14:00
ab7d547d26fdf8e074ae42ff73c51560a0b0853a...7f8e4ae67b29ca5797e02d29f38801c130a03160,2,25,9,34,3,2012-08-13 22:04:42,2012-08-11 04:31:42
7f8e4ae67b29ca5797e02d29f38801c130a03160...c57945d88f010a57a903cf8a974a9249be320b8e,1,3,3,6,3,2012-08-14 03:43:10,2012-08-14 03:43:10
26035a73b88b5da9d589f2c3f55e422f327cbd36...97dc9a145055218b7a16d0957a99008ab3c783b2,8,32,28,60,27,2012-09-10 20:56:33,2012-09-10 20:56:22
97dc9a145055218b7a16d0957a99008ab3c783b2...d310d836e463238398770309b67d6bd03e860d2c,7,74,6,80,13,2012-09-10 22:09:03,2012-09-10 21:22:48
d310d836e463238398770309b67d6bd03e860d2c...0df05377976f6a74b1c7579606be961c146a970e,2,65,23,88,13,2012-09-10 23:00:25,2012-09-10 23:00:25
0df05377976f6a74b1c7579606be961c146a970e...132f635e285153e955bb6e54f5e8e5dd67a4ac99,1,2,0,2,1,2012-09-12 19:23:41,2012-09-12 19:23:41
26035a73b88b5da9d589f2c3f55e422f327cbd36...43a356a0be142d87cf4fccf38ab0f74af8037e5e,3,38,4,42,3,2012-09-10 18:59:18,2012-09-10 18:59:18
43a356a0be142d87cf4fccf38ab0f74af8037e5e...0924c54f56c3684b78965a77d92f17f9d31ab9b5,1,98,1,99,6,2012-09-11 21:55:55,2012-09-11 21:55:55
0924c54f56c3684b78965a77d92f17f9d31ab9b5...64b8f77f055a4e600d1b0ccb0425ba89027d7198,2,27,9,36,3,2012-09-11 22:57:04,2012-09-11 22:57:04
64b8f77f055a4e600d1b0ccb0425ba89027d7198...951d62f401adc2e252fd90b4cb51662a288461e1,2,28,15,43,6,2012-09-11 23:33:23,2012-09-11 23:33:23
24377fc980ed0f3f502c5e538a8a873ba354f512...d51d060f83c21a5581d3676df008529249895fc8,1,4,1,5,1,2012-09-10 23:56:22,2012-09-10 20:26:16
d51d060f83c21a5581d3676df008529249895fc8...74aca65c95d90d68925e5674d303bd13d4dfb04f,16,9,9,18,10,2012-09-11 05:59:32,2012-09-11 05:59:32
74aca65c95d90d68925e5674d303bd13d4dfb04f...a5a3d3a94a0c35bbea7f81752e72edd3190e4842,12,5,5,10,5,2012-09-11 18:03:50,2012-09-11 18:03:50
879bee2f50c8d80aba6ee88b2fe749de9c7e17b0...6c6fa5a6b1cf3bb7aa7828070199e0a3deaed4c6,1,3,1,4,1,2012-09-24 17:41:14,2012-09-24 17:41:14
6c6fa5a6b1cf3bb7aa7828070199e0a3deaed4c6...a0252d6fbeaf9386ba6ab8af2b786c1721db7ce3,2,2,2,4,2,2012-09-24 18:41:22,2012-09-24 18:41:22
a0252d6fbeaf9386ba6ab8af2b786c1721db7ce3...1168a70e3e6d706e7bb6978c3466a1f37e60f3b6,3,97,5,102,8,2012-09-24 19:06:19,2012-09-24 18:56:57
1168a70e3e6d706e7bb6978c3466a1f37e60f3b6...4b25e2d82d5f4d1dd953bcdfc0a1753061b9436f,1,3,1,4,1,2012-09-24 19:12:42,2012-09-24 19:12:42
4b25e2d82d5f4d1dd953bcdfc0a1753061b9436f...12e4c1b157cbe10547d2cdf7ba1200b2d9367e18,1,1,1,2,1,2012-09-25 00:54:25,2012-09-25 00:54:25
12e4c1b157cbe10547d2cdf7ba1200b2d9367e18...65aaa2e991a8fb9667b6c6594523ff0e33a1455b,1,1,1,2,1,2012-09-25 01:11:24,2012-09-25 01:11:24
65aaa2e991a8fb9667b6c6594523ff0e33a1455b...deafbf4a3ded4b209c871f4ce56e6097f028787d,1,50,4,54,4,2012-09-25 03:01:24,2012-09-24 21:06:27
deafbf4a3ded4b209c871f4ce56e6097f028787d...0565593da538523607d1c2e4300ae1175ebb9555,1,28,8,36,4,2012-09-25 03:01:24,2012-09-25 02:46:52
c7584cdc7554b2a75c965fe9b54fb71d66fbe8af...bccc870ac48d7a7d6a3dbf6003b7e0ef1eabbdbc,1,4,4,8,3,2012-09-07 04:12:30,2012-09-06 20:00:13
bccc870ac48d7a7d6a3dbf6003b7e0ef1eabbdbc...b0dbd1cb7fa2e60704961b9ddf2c80449c090f38,1,3,1,4,1,2012-09-07 05:13:53,2012-09-07 05:13:53
b0dbd1cb7fa2e60704961b9ddf2c80449c090f38...6121400983cc692eddb1acf27ed1df5257fc1842,1,6,0,6,1,2012-09-07 05:40:49,2012-09-07 05:40:49
6121400983cc692eddb1acf27ed1df5257fc1842...1cfc9f6df24372a1f89b0b43860502df615d9a46,2,2,2,4,2,2012-09-07 05:41:33,2012-09-07 05:41:33
c514341df823ad47ed51ecb65563e290589a41b4...02cf89a54b43102fbaf68657b7671e7f2791ea78,2,3,1,4,2,2012-09-04 21:03:47,2012-09-04 21:03:47
02cf89a54b43102fbaf68657b7671e7f2791ea78...a7beebcd177a415464b2abdfedb4606d5ca7704c,1,1,1,2,1,2012-09-06 19:33:59,2012-09-06 19:33:59
5de6052a2e8e166dc17a6d7c96b879070c41e555...369ae7f917c77c7fcccc8203deaaaac84db9e8df,1,6,2,8,2,2012-05-11 20:08:38,2012-05-11 20:08:38
b21da0f274a59424b38573dfef43938582951350...7e872afa88f88ee742dccd859febe2fd2dbb543c,1,1,1,2,1,2012-08-16 04:03:00,2012-08-16 04:03:00
b21da0f274a59424b38573dfef43938582951350...1f1f555b00eff9601b3349468422ebb5658ddd42,2,29,4,33,5,2012-08-15 04:23:44,2012-08-15 04:23:44
1f1f555b00eff9601b3349468422ebb5658ddd42...d8cc5f282a50dd34d5c7cbdb5190de585bae1935,2,5,2,7,2,2012-08-15 04:47:53,2012-08-15 04:47:53
d8cc5f282a50dd34d5c7cbdb5190de585bae1935...d5e0b577fdb7b5ee47216d5be5fbdd086ad1f244,1,1,3,4,1,2012-08-22 05:35:43,2012-08-22 05:35:43
d5e0b577fdb7b5ee47216d5be5fbdd086ad1f244...8bd27f992f06b097258da21dd26ac0efb642d4fd,1,14,0,14,1,2012-08-22 05:36:52,2012-08-22 05:36:52
8bd27f992f06b097258da21dd26ac0efb642d4fd...a7bbb8c2a216de5d76677d5c499d6227d63bfca5,1,3,0,3,1,2012-08-22 05:37:21,2012-08-22 05:37:21
01c7afea5fe0fac2c7a212669302b6754b3502a0...4301dffc5fdcf9cab79c460b3c76860f72382312,2,10,8,18,4,2012-08-14 18:28:42,2012-08-14 18:28:42
4301dffc5fdcf9cab79c460b3c76860f72382312...5d8038cae16d1bed39757535cb15b9aeef9369ab,1,0,39,39,1,2012-08-16 02:06:13,2012-08-11 05:07:31
5d8038cae16d1bed39757535cb15b9aeef9369ab...0241f84b565a0b98519dc6abdffc4e89440a1fed,10,276,141,417,23,2012-08-16 03:42:50,2012-08-16 03:42:50
0241f84b565a0b98519dc6abdffc4e89440a1fed...7c89eb8eca9dfd026ab0e2b87bfc78a8c50dccf6,1,1,1,2,1,2012-08-16 03:55:13,2012-08-16 03:55:13
7c89eb8eca9dfd026ab0e2b87bfc78a8c50dccf6...fc85b3a24395bc708898813e6b6ea4b85b9067fc,1,9,9,18,6,2012-08-16 04:43:33,2012-08-16 04:43:33
0019e5f716809be759e501b12eccd295c4397016...9186c63b73840cfcc7aefae06da3fe0ff5246be6,11,430,62,492,56,2012-08-10 03:37:29,2012-08-06 23:12:06
9186c63b73840cfcc7aefae06da3fe0ff5246be6...da9d89dce23dd49bf3f1073340586d307f9e83e4,3,17,5,22,8,2012-08-10 03:37:29,2012-08-07 17:48:51
da9d89dce23dd49bf3f1073340586d307f9e83e4...9d2cdb801345a239094efdabef1483254d66eb0c,1,4,1,5,1,2012-08-10 03:37:29,2012-08-07 18:54:38
9d2cdb801345a239094efdabef1483254d66eb0c...d46a4d7a7682b4bc263e11532e515fa8eb625aa2,1,1,1,2,1,2012-08-10 03:37:29,2012-08-09 02:13:34
d46a4d7a7682b4bc263e11532e515fa8eb625aa2...6a3124becb3fdba6b5a2d92d66accf1216bf9bda,5,93,2,95,5,2012-08-10 03:37:29,2012-08-08 03:23:05
6a3124becb3fdba6b5a2d92d66accf1216bf9bda...856adb90da46db6fc1fc4e7f24784b55d9f7c1a8,11,214,28,242,40,2012-08-10 03:37:29,2012-08-08 23:01:06
856adb90da46db6fc1fc4e7f24784b55d9f7c1a8...6e51f5145728558de31833c438446536545be0ef,2,48,11,59,6,2012-08-10 03:37:30,2012-08-09 19:33:47
6e51f5145728558de31833c438446536545be0ef...fdce0472e03dbd8e3ed898068c831bf6a14cac65,3,18,8,26,6,2012-08-12 20:03:55,2012-08-12 20:03:55
fdce0472e03dbd8e3ed898068c831bf6a14cac65...1113b3a21ec2671013e536205b40fda7ef52a759,6,74,61,135,33,2012-08-13 21:15:03,2012-08-13 21:13:45
1113b3a21ec2671013e536205b40fda7ef52a759...9eff2a109b98963100b22378e9ca58bc824304d6,5,159,66,225,10,2012-08-15 21:52:55,2012-08-15 05:54:32
9eff2a109b98963100b22378e9ca58bc824304d6...3e3f00f07d21a2b1381e5193f7236e84f43299a7,4,207,60,267,30,2012-08-15 22:50:17,2012-08-15 22:50:17
3e3f00f07d21a2b1381e5193f7236e84f43299a7...53e8c2029b079496647c3a873b9a91181fd9d342,7,165,14,179,20,2012-08-16 17:23:03,2012-08-16 16:44:28
53e8c2029b079496647c3a873b9a91181fd9d342...9ba1884352f99aeb1dd0a69308753fc8dd826b77,4,72,0,72,7,2012-08-16 18:27:19,2012-08-16 18:27:19
9ba1884352f99aeb1dd0a69308753fc8dd826b77...8bfb4498cb4b69b5a0dedd658559ccbbc3d8a49c,1,4,0,4,1,2012-08-16 18:44:50,2012-08-16 18:44:50
8bfb4498cb4b69b5a0dedd658559ccbbc3d8a49c...0d350f2d5bc650bbfc1beb8f2f9a3e88faebb27e,9,31,52,83,27,2012-08-17 22:27:02,2012-08-16 21:50:56
0d350f2d5bc650bbfc1beb8f2f9a3e88faebb27e...d79da9b1b455c46533ca04ac03284b497b1b1f51,5,64,6,70,9,2012-08-17 22:27:02,2012-08-16 23:07:19
a2d5bfa6dbbecff94877142a57bb212aa7f2a590...0f1816181c94eba8630bbff48c8fb45be8b31630,1,1,1,2,1,2012-08-03 00:57:02,2012-07-30 18:15:37
a2d5bfa6dbbecff94877142a57bb212aa7f2a590...36aec6e4c1238774abad3265aa094113173bdf98,1,1,0,1,1,2012-07-26 21:26:51,2012-07-26 21:26:43
a2d5bfa6dbbecff94877142a57bb212aa7f2a590...b7c393a9fee4a503354041b962078a3609ec0c36,2,36,0,36,2,2012-07-24 00:57:09,2012-05-17 18:26:19
b7c393a9fee4a503354041b962078a3609ec0c36...55b6bb0deaf965b7fed9760ced8b7ed2f2cd62f5,9,342,110,452,47,2012-07-24 00:57:09,2012-05-23 17:42:15
55b6bb0deaf965b7fed9760ced8b7ed2f2cd62f5...cc3a163db626343cd466f23c95976c6f103ef42d,4,152,11,163,16,2012-07-24 00:57:09,2012-05-23 17:57:59
cc3a163db626343cd466f23c95976c6f103ef42d...414f5e52fbc222b32a26e47ed1bd5dfdaea3ea82,1,22,10,32,1,2012-07-24 00:57:09,2012-05-23 20:22:26
414f5e52fbc222b32a26e47ed1bd5dfdaea3ea82...f1acf247bf29c05f248c5862b26a6dfcea35d2ac,1,70,28,98,6,2012-07-24 00:57:09,2012-05-25 05:26:40
f1acf247bf29c05f248c5862b26a6dfcea35d2ac...3a26b18a3fd7b0a2cb93b0c5ca1ea7ad937109d2,5,243,8,251,16,2012-07-24 00:57:09,2012-05-26 03:46:55
3a26b18a3fd7b0a2cb93b0c5ca1ea7ad937109d2...4d257aa545385b8f062dd0348c1972dfde426040,2,14,14,28,6,2012-07-24 00:57:09,2012-05-26 10:03:32
4d257aa545385b8f062dd0348c1972dfde426040...301a339eef2dbc86707417df79423b4b6c6e1039,2,3,1,4,3,2012-07-24 00:57:09,2012-05-30 17:49:01
301a339eef2dbc86707417df79423b4b6c6e1039...f8a0d5a95c6d7923804d548be1aa37129d82425d,5,240,0,240,5,2012-07-24 00:57:09,2012-06-11 22:45:26
f8a0d5a95c6d7923804d548be1aa37129d82425d...10654b997a6989369ead58f210b7a61210cc78df,8,88,2,90,13,2012-07-24 00:57:10,2012-06-11 22:47:32
10654b997a6989369ead58f210b7a61210cc78df...c00f2e35514c23e4249d7feb8c3f1fbb2c51cf16,14,227,27,254,39,2012-07-24 00:57:10,2012-06-12 19:40:28
c00f2e35514c23e4249d7feb8c3f1fbb2c51cf16...24ca78cb5d808e9771d4cd43fd9c574711ef988c,1,3,1,4,2,2012-07-24 00:57:10,2012-06-12 04:09:27
24ca78cb5d808e9771d4cd43fd9c574711ef988c...d6bc56d2553f5270b089f0337ba0e6190bfc68de,7,213,179,392,38,2012-07-24 00:57:10,2012-06-12 22:08:11
d6bc56d2553f5270b089f0337ba0e6190bfc68de...2fc45793ee0e345fcd5f850cc6165905623bf793,23,472,249,721,44,2012-07-24 00:57:10,2012-06-12 22:08:11
2fc45793ee0e345fcd5f850cc6165905623bf793...2657787fd7ed6b20c5515225aa47531e0f17022b,8,73,59,132,9,2012-07-24 00:57:10,2012-06-13 21:22:23
2657787fd7ed6b20c5515225aa47531e0f17022b...9e369b960475ab2d8d4374d2731ebf052563f94e,7,74,14,88,20,2012-07-24 00:57:10,2012-06-14 00:06:36
9e369b960475ab2d8d4374d2731ebf052563f94e...bbf10bdd14fdfdf3891c6225e57b24b9bc82a1ba,3,39,21,60,8,2012-07-24 00:57:10,2012-06-14 05:56:56
bbf10bdd14fdfdf3891c6225e57b24b9bc82a1ba...c1a399dc382e717b296ff7f02484a59d045dc904,5,38,14,52,11,2012-07-24 00:57:10,2012-06-14 06:41:41
c1a399dc382e717b296ff7f02484a59d045dc904...1fed5b43aa2d4734b45211ae3185d5161930de4e,1,2,2,4,2,2012-07-24 00:57:10,2012-06-14 16:42:14
1fed5b43aa2d4734b45211ae3185d5161930de4e...e421762307c91a27953a2e97e05b7d081d6a7459,7,8,8,16,8,2012-07-24 00:57:10,2012-06-15 03:44:56
e421762307c91a27953a2e97e05b7d081d6a7459...6e0276fb732f29260aa45e5c1a75be84f0bb2e7e,3,13,7,20,8,2012-07-24 00:57:10,2012-06-15 04:33:19
6e0276fb732f29260aa45e5c1a75be84f0bb2e7e...0b1708d9fc2da9b1a1c0855fdaa6d41b44575da8,1,2,1,3,1,2012-07-24 00:57:10,2012-06-15 04:40:30
0b1708d9fc2da9b1a1c0855fdaa6d41b44575da8...44751cebc520702719cdd4adccc9e0306734b2ee,3,22,5,27,7,2012-07-24 00:57:10,2012-06-15 20:11:02
44751cebc520702719cdd4adccc9e0306734b2ee...0d886d6c24a98c3fdbfff14f3f073be6d12e673e,4,3,7,10,4,2012-07-24 00:57:10,2012-06-15 20:36:01
0d886d6c24a98c3fdbfff14f3f073be6d12e673e...a73715491ba0187fd4438643eb286e9631acc519,9,119,77,196,29,2012-07-24 00:57:10,2012-06-15 20:45:36
a73715491ba0187fd4438643eb286e9631acc519...aeb733b3e385535d23f802c7ab3acccfc5ced007,17,170,131,301,38,2012-07-24 00:57:10,2012-06-15 22:38:18
aeb733b3e385535d23f802c7ab3acccfc5ced007...4a8542e63079ef50b40c37061c144ae47fa92611,5,47,33,80,18,2012-07-24 00:57:11,2012-06-15 23:10:42
4a8542e63079ef50b40c37061c144ae47fa92611...f018551e97ed7d57049bbcb0477244b44ab88201,1,0,0,0,0,2012-07-24 00:57:11,2012-06-15 23:16:06
f018551e97ed7d57049bbcb0477244b44ab88201...490e7a29e7ecc1355b6e061773552252b55973d1,6,2,2,4,2,2012-07-24 00:57:11,2012-06-15 23:26:08
490e7a29e7ecc1355b6e061773552252b55973d1...efc9fe0b9fb96bddd94ece672c68abb62452f2c0,6,10,16,26,6,2012-07-24 00:57:11,2012-06-15 23:46:51
efc9fe0b9fb96bddd94ece672c68abb62452f2c0...630ee422423f5f6b9d283f4af4c07d44404ab4ba,2,4,3,7,2,2012-07-24 00:57:11,2012-06-15 23:47:18
630ee422423f5f6b9d283f4af4c07d44404ab4ba...7071f947741a0f896ae35860b9501d92b4c8bc3f,2,45,1,46,2,2012-07-24 00:57:11,2012-06-16 00:16:34
7071f947741a0f896ae35860b9501d92b4c8bc3f...dd48fbcbc2a51314be425efc759a1886e32fbea3,4,5,5,10,5,2012-07-24 00:57:11,2012-06-16 00:41:14
dd48fbcbc2a51314be425efc759a1886e32fbea3...e99f3519ccf9e803fc523b080927f6f05be3e24b,1,4,2,6,3,2012-07-24 00:57:11,2012-06-16 00:52:56
e99f3519ccf9e803fc523b080927f6f05be3e24b...576a0f5fdc8f90c260ddfbb5a66172734f6864b4,1,1,1,2,1,2012-07-24 00:57:11,2012-06-16 05:26:50
576a0f5fdc8f90c260ddfbb5a66172734f6864b4...f963e1251aae60d198fec4a09a9879d67d207b19,2,1,9,10,2,2012-07-24 00:57:11,2012-06-19 02:54:30
f963e1251aae60d198fec4a09a9879d67d207b19...0e31087c5435bd77e56cda3a4bd0dbc6a765d4ff,1,15,3,18,7,2012-07-24 00:57:11,2012-06-27 02:58:48
0e31087c5435bd77e56cda3a4bd0dbc6a765d4ff...b227d59b54e1edd56d75f7e3dce98aacec79b106,8,740,68,808,19,2012-07-24 00:57:11,2012-07-07 08:40:16
b227d59b54e1edd56d75f7e3dce98aacec79b106...e71a8c8e9c846a8da337663016f62c5f9d5aade9,2,3,0,3,2,2012-07-24 00:57:11,2012-07-07 11:40:27
e71a8c8e9c846a8da337663016f62c5f9d5aade9...9db26049d1f9c187f498788b74b0de98b62a1fa7,2,23,1,24,4,2012-07-24 00:57:11,2012-07-09 21:57:42
9db26049d1f9c187f498788b74b0de98b62a1fa7...1773c91c5022e7b9ec6809e2bbc11717b57bc2d8,2,20,8,28,6,2012-07-24 00:57:11,2012-07-09 22:29:41
1773c91c5022e7b9ec6809e2bbc11717b57bc2d8...cbce421b982c43ff0bf8d9f9ba15af749199ddf2,3,90,51,141,4,2012-07-24 00:57:11,2012-07-09 23:51:16
cbce421b982c43ff0bf8d9f9ba15af749199ddf2...1ac09575bcd33822c9ae8ac755fd841c7cb004c6,2,68,76,144,11,2012-07-24 00:57:11,2012-07-10 02:07:11
1ac09575bcd33822c9ae8ac755fd841c7cb004c6...132231d68884b35fde77d3020766e838734e9099,4,73,53,126,8,2012-07-24 00:57:12,2012-07-10 19:23:51
132231d68884b35fde77d3020766e838734e9099...74ad9390dbd062a16d265fa5e60c0830c1e11c14,1,2,1,3,1,2012-07-24 00:57:12,2012-07-10 19:26:43
74ad9390dbd062a16d265fa5e60c0830c1e11c14...556aba22ac0f2d799c90caceb981c41359248642,2,11,2,13,5,2012-07-24 00:57:12,2012-07-10 20:32:39
556aba22ac0f2d799c90caceb981c41359248642...33817f235ba98a233908ca681269f77ddcf0a6fc,1,2,1,3,2,2012-07-24 00:57:12,2012-07-10 23:01:58
33817f235ba98a233908ca681269f77ddcf0a6fc...ce4179416f0f9235380ec42787f5a0eb756c5f83,1,98,95,193,68,2012-07-24 00:57:12,2012-07-10 23:06:35
ce4179416f0f9235380ec42787f5a0eb756c5f83...f5317b3823295e2664043fb41e60da2c7bf7b058,1,0,2,2,1,2012-07-24 00:57:12,2012-07-10 23:11:27
f5317b3823295e2664043fb41e60da2c7bf7b058...4417dad58411764b4aa8f44f4cbb88515702b01b,3,38,8,46,8,2012-07-24 00:57:12,2012-07-10 23:11:53
4417dad58411764b4aa8f44f4cbb88515702b01b...0586320be73f273e9eab4b17cbe03de2f5ec87cc,3,124,2,126,3,2012-07-24 00:57:12,2012-07-11 00:42:00
0586320be73f273e9eab4b17cbe03de2f5ec87cc...e11655a65a85bfa85efac32123b3658478fedbc8,4,25,6,31,8,2012-07-24 00:57:12,2012-07-11 01:04:53
e11655a65a85bfa85efac32123b3658478fedbc8...8f3dc9fa98d21708e9d2031f63651c9245ede6b0,1,13,11,24,1,2012-07-24 00:57:12,2012-07-11 01:15:34
8f3dc9fa98d21708e9d2031f63651c9245ede6b0...0c0345cc587246720e397b5d568c08fd6262b8d9,2,7,4,11,3,2012-07-24 00:57:12,2012-07-11 01:17:50
0c0345cc587246720e397b5d568c08fd6262b8d9...a0f564f9ef5137dc1695db3c782819d47be4b5e3,1,10,3,13,4,2012-07-24 00:57:12,2012-07-11 03:43:37
a0f564f9ef5137dc1695db3c782819d47be4b5e3...d160097b8143bfbffae75a965df34cfda1ec0bd0,4,95,0,95,4,2012-07-24 00:57:12,2012-06-27 08:52:24
d160097b8143bfbffae75a965df34cfda1ec0bd0...edd7f078a59ea6f2c0c6e131640822c1f5738326,2,19,0,19,3,2012-07-24 00:57:12,2012-06-27 08:52:45
edd7f078a59ea6f2c0c6e131640822c1f5738326...67b9ee0d1097f7ddbc8ff1d4979939a6a371e35e,1,27,17,44,8,2012-07-24 00:57:12,2012-07-19 21:00:54
67b9ee0d1097f7ddbc8ff1d4979939a6a371e35e...2cdf596bfca1a411b71ca71865787048b9832305,5,1894,0,1894,5,2012-07-24 00:59:09,2012-06-29 06:17:35
2cdf596bfca1a411b71ca71865787048b9832305...e1e636ba21ffb40b1d29ba2bc3d0a550eda4abc9,9,495,21,516,21,2012-07-24 00:59:09,2012-07-19 01:21:15
e1e636ba21ffb40b1d29ba2bc3d0a550eda4abc9...15a46e03efe6e360e0cee7275bb4509508e3b7ca,12,254,114,368,40,2012-07-24 01:38:04,2012-07-23 23:07:03
15a46e03efe6e360e0cee7275bb4509508e3b7ca...758c1caa85f1ab2b5e2fa6e4d428d824441d3ea3,6,51,57,108,51,2012-07-24 01:38:04,2012-07-20 23:27:28
758c1caa85f1ab2b5e2fa6e4d428d824441d3ea3...a07411e69d7339ef10ac2792b8b749e65e907b10,7,371,139,510,35,2012-07-24 05:49:07,2012-07-17 22:33:44
951d62f401adc2e252fd90b4cb51662a288461e1...a43c8b1d6ad713be3dc0ea287a7047e3b59a35a9,1,6,0,6,1,2012-09-12 00:14:07,2012-09-12 00:14:07
a43c8b1d6ad713be3dc0ea287a7047e3b59a35a9...9cbd1fc888dbeb28e01c3a7dc995a93680cadcaf,1,1,1,2,1,2012-09-12 23:58:28,2012-09-12 23:58:28
9cbd1fc888dbeb28e01c3a7dc995a93680cadcaf...e05e938d70f90fa82787db1e91fc8ba2f119bf6e,1,3,0,3,1,2012-09-13 00:09:31,2012-09-13 00:09:31
e05e938d70f90fa82787db1e91fc8ba2f119bf6e...123f17833e3c7ee6417ab76085e97c13f18ed570,1,1,1,2,1,2012-09-14 02:24:39,2012-09-13 00:30:46
123f17833e3c7ee6417ab76085e97c13f18ed570...216b3f312eda6056a15348c7a29e49116aa74d2d,1,2,0,2,1,2012-09-14 18:32:28,2012-09-14 18:32:28
216b3f312eda6056a15348c7a29e49116aa74d2d...0ed8555690ed74afb16b7ea93d8e531a560b47a1,2,19,14,33,5,2012-09-15 00:09:37,2012-09-15 00:04:07
951d62f401adc2e252fd90b4cb51662a288461e1...99e8bacdb3f940d1be9886bd819a7acd2ec3ca67,8,1612,0,1612,8,2012-09-11 23:49:46,2012-09-06 06:34:32
99e8bacdb3f940d1be9886bd819a7acd2ec3ca67...d17d38600d2e5628fba4690f56de7d6e4dc0bff7,3,21,10,31,6,2012-09-11 23:49:46,2012-09-06 06:50:58
d17d38600d2e5628fba4690f56de7d6e4dc0bff7...6f46d17a54ba598dbcda727076d7782deb5ce344,1,1,1,2,1,2012-09-11 23:49:46,2012-09-06 07:18:55
6f46d17a54ba598dbcda727076d7782deb5ce344...cad29bd0b103317909e6c7c854dd019af0acec16,1,4,2,6,3,2012-09-11 23:49:46,2012-09-06 07:58:23
cad29bd0b103317909e6c7c854dd019af0acec16...194d3151f3bf3372d1b12956bdf5f802957156a0,1,52,50,102,12,2012-09-11 23:49:46,2012-09-06 08:05:21
194d3151f3bf3372d1b12956bdf5f802957156a0...ce65ffede8d1e72ffc40894cd4a30a486ea32173,2,14,14,28,4,2012-09-11 23:49:46,2012-09-06 08:05:31
ce65ffede8d1e72ffc40894cd4a30a486ea32173...cbfad7f578b41ecaf26a64a844d2551b800e6a4d,2,18,3,21,7,2012-09-11 23:49:46,2012-09-06 09:13:11
cbfad7f578b41ecaf26a64a844d2551b800e6a4d...1fc75baa0acdbcca7b4212dd3712221c69fc5df1,1,22,6,28,2,2012-09-11 23:49:47,2012-09-06 09:14:50
1fc75baa0acdbcca7b4212dd3712221c69fc5df1...48c62ea850437181a7a13f35339315cd1b339850,2,7,5,12,5,2012-09-11 23:49:47,2012-09-06 09:42:00
48c62ea850437181a7a13f35339315cd1b339850...42675e5c0296030699b99620d9bd3d1c7847af02,2,2,2,4,2,2012-09-11 23:49:47,2012-09-06 09:46:16
42675e5c0296030699b99620d9bd3d1c7847af02...b869ecbd80d588d4c4ca1c904cc2b31d08574574,3,374,380,754,4,2012-09-11 23:49:47,2012-09-06 09:57:52
b869ecbd80d588d4c4ca1c904cc2b31d08574574...82323d61f307b26e20d3712c2390bb9f4263827c,2,34,7,41,7,2012-09-11 23:49:47,2012-09-06 10:17:57
82323d61f307b26e20d3712c2390bb9f4263827c...6dccc293bacd114c309ab7b64346d82e9d311683,1,4,0,4,1,2012-09-11 23:49:47,2012-09-06 10:19:53
6dccc293bacd114c309ab7b64346d82e9d311683...120b5cf0f8572e5028b60a8c1f52e4133fb15ada,1,2,0,2,1,2012-09-11 23:49:47,2012-09-06 19:49:14
120b5cf0f8572e5028b60a8c1f52e4133fb15ada...a0bb26e735940146ef60bfb567c7f0ebfa52cbda,2,12,0,12,2,2012-09-11 23:49:47,2012-09-06 19:49:22
a0bb26e735940146ef60bfb567c7f0ebfa52cbda...996da3b01f9f3c04e7d212f965b150f2859db241,1,141,2,143,1,2012-09-11 23:49:47,2012-09-06 22:11:39
996da3b01f9f3c04e7d212f965b150f2859db241...ef62683280a27c0ec91d15ea63ff16e8dba12f7d,1,1,1,2,1,2012-09-11 23:49:47,2012-09-06 22:11:46
ef62683280a27c0ec91d15ea63ff16e8dba12f7d...d6370e762acba03d28f601f73147cfa97142c6de,3,78,53,131,33,2012-09-11 23:49:47,2012-09-07 21:15:04
d6370e762acba03d28f601f73147cfa97142c6de...c63278332b7f65d867e1faae1db26f0f19932479,2,21,26,47,13,2012-09-11 23:49:47,2012-09-07 21:20:45
c63278332b7f65d867e1faae1db26f0f19932479...fb183e1e5cc19f38ccacfd91c90a3bc97ceb66b5,1,3,3,6,1,2012-09-11 23:49:47,2012-09-08 01:44:21
fb183e1e5cc19f38ccacfd91c90a3bc97ceb66b5...f1379b8ec94a06248a35cced0d67ac03e41ff85a,3,8,13,21,6,2012-09-11 23:49:47,2012-09-08 02:31:22
f1379b8ec94a06248a35cced0d67ac03e41ff85a...5af09e5d9752d132136da4e08660481df6f35ec4,1,18,25,43,7,2012-09-11 23:49:47,2012-09-08 03:34:00
5af09e5d9752d132136da4e08660481df6f35ec4...907ad8990bdc35dbba91a011edf4b1beb7d79103,1,28,0,28,2,2012-09-11 23:49:47,2012-09-08 03:48:47
907ad8990bdc35dbba91a011edf4b1beb7d79103...447fef8f0ef696cf657d79ba5da32de9552058c7,3,14,11,25,12,2012-09-11 23:49:47,2012-09-08 04:00:55
447fef8f0ef696cf657d79ba5da32de9552058c7...23f6e753af2e8cbb5f675351334fe60653a20fbb,2,6,12,18,6,2012-09-11 23:49:48,2012-09-08 16:53:05
23f6e753af2e8cbb5f675351334fe60653a20fbb...faac13b290ad7f3784307b5028385b9d99918f07,1,29,3,32,2,2012-09-11 23:49:48,2012-09-08 17:01:54
faac13b290ad7f3784307b5028385b9d99918f07...b2345a5329ae293758af84c65b01ed96ff41d7d7,1,65,1,66,2,2012-09-11 23:49:48,2012-09-08 17:56:15
b2345a5329ae293758af84c65b01ed96ff41d7d7...c859dad1a46dde70515d2b409f57cb7f7b0542df,1,221,58,279,16,2012-09-11 23:49:48,2012-09-09 21:49:55
c859dad1a46dde70515d2b409f57cb7f7b0542df...c27a6b34ece70cdb6aaf36a199dec07183708c17,4,119,20,139,19,2012-09-11 23:49:48,2012-09-10 05:35:22
c27a6b34ece70cdb6aaf36a199dec07183708c17...9f2b4eb0364b33cc565facd01436001ef350f042,1,70,4,74,4,2012-09-11 23:49:48,2012-09-10 18:40:19
9f2b4eb0364b33cc565facd01436001ef350f042...940955a71d788c45f9f2ca61a11e83704dfd4254,1,1,1,2,1,2012-09-11 23:49:48,2012-09-10 18:40:31
940955a71d788c45f9f2ca61a11e83704dfd4254...1043248092677fa02d05cceb66e1986d1ccce887,1,106,8,114,6,2012-09-11 23:49:48,2012-09-10 22:20:34
1043248092677fa02d05cceb66e1986d1ccce887...027f41e8c66493a979c025a1e02c34481ac3f628,1,1,1,2,1,2012-09-11 23:49:48,2012-09-10 22:20:45
027f41e8c66493a979c025a1e02c34481ac3f628...a6bd5747b27459ca43107003f9fb3c1e2089bc20,4,84,77,161,21,2012-09-12 01:03:29,2012-09-12 01:01:50
a6bd5747b27459ca43107003f9fb3c1e2089bc20...132b4897afe6bb877f1bb949b884e83cbcbf54bc,2,368,354,722,120,2012-09-12 02:38:27,2012-09-12 02:36:47
132b4897afe6bb877f1bb949b884e83cbcbf54bc...2b41592236f5e63549e714b52c6d532c3c694a50,2,52,68,120,25,2012-09-12 02:59:52,2012-09-12 02:59:52
2b41592236f5e63549e714b52c6d532c3c694a50...b34ed9eb6e94e7e29728927c01e346cfc684647f,3,34,28,62,18,2012-09-12 03:29:34,2012-09-12 03:26:25
b34ed9eb6e94e7e29728927c01e346cfc684647f...c44592d074e2ff64369109302db1336d0de04de3,2,107,103,210,37,2012-09-12 04:01:37,2012-09-12 04:00:01
c44592d074e2ff64369109302db1336d0de04de3...98859f68744d87374610f1e8ea0b2d65e284b024,2,79,91,170,12,2012-09-12 04:20:36,2012-09-12 04:20:36
98859f68744d87374610f1e8ea0b2d65e284b024...9d55f11b694a9b173ef2ae35e5fe3ae46c23f6ba,2,24,16,40,4,2012-09-12 04:30:36,2012-09-12 04:30:36
9d55f11b694a9b173ef2ae35e5fe3ae46c23f6ba...79ce16bfe90291c7365c6eef7f5e70e8acd3130d,2,36,30,66,18,2012-09-12 04:51:06,2012-09-12 04:51:06
79ce16bfe90291c7365c6eef7f5e70e8acd3130d...d2c99c490a404d47aa33a3160fa312dd3df547b8,2,5,1,6,4,2012-09-12 04:54:10,2012-09-12 04:54:10
d2c99c490a404d47aa33a3160fa312dd3df547b8...ef3e4f41b8541aa553195c745c14dbc014f0c9a4,1,78,67,145,26,2012-09-12 18:09:30,2012-09-12 18:09:30
ef3e4f41b8541aa553195c745c14dbc014f0c9a4...6e5e7497f0635179f06bafe4d8d6fc0b3d5193bc,5,117,104,221,44,2012-09-12 20:04:19,2012-09-12 20:04:19
6e5e7497f0635179f06bafe4d8d6fc0b3d5193bc...3197dd241cb6fe1795d44995348f02780eb7b501,1,4,0,4,1,2012-09-12 20:11:54,2012-09-12 20:11:54
3197dd241cb6fe1795d44995348f02780eb7b501...ce2a41c1c30b8aaaca89916ce9f6312544a3c1ab,3,56,58,114,11,2012-09-12 20:42:54,2012-09-12 20:42:54
ce2a41c1c30b8aaaca89916ce9f6312544a3c1ab...603ad14570b1103f7835275c60638685d7e43217,3,14,18,32,13,2012-09-12 20:55:36,2012-09-12 20:55:36
603ad14570b1103f7835275c60638685d7e43217...34b4ebbf224ca829144e18d0a74b2053a1247ef7,4,58,73,131,15,2012-09-12 21:11:28,2012-09-12 21:11:28
34b4ebbf224ca829144e18d0a74b2053a1247ef7...39056590d4f67e628f5dd79eafa8b4449565d5fb,3,68,80,148,20,2012-09-12 21:31:47,2012-09-12 21:31:47
39056590d4f67e628f5dd79eafa8b4449565d5fb...76cac261008e02808af1cfce62260dc26d71d2dd,1,11,11,22,3,2012-09-12 21:34:50,2012-09-12 21:34:50
76cac261008e02808af1cfce62260dc26d71d2dd...25b564014a23653eae7d26da3ecb904b1e47e0ef,1,0,2,2,1,2012-09-12 21:39:28,2012-09-12 21:39:28
25b564014a23653eae7d26da3ecb904b1e47e0ef...f9cfe9701f1cfd6aecc8b00aa61fa490536c35ce,4,35,20,55,14,2012-09-12 21:48:32,2012-09-12 21:48:32
f9cfe9701f1cfd6aecc8b00aa61fa490536c35ce...f9dba29b2de28f55c256fe865be284d6b5c7ed40,2,48,25,73,24,2012-09-12 21:54:58,2012-09-12 21:54:31
f9dba29b2de28f55c256fe865be284d6b5c7ed40...4ee4e2451cfaf5c232fb10034da68d1cc64552dc,3,102,80,182,10,2012-09-12 22:15:05,2012-09-12 22:15:05
4ee4e2451cfaf5c232fb10034da68d1cc64552dc...7c3815fa278e059928273f1ce96727d47ad704ee,2,19,16,35,10,2012-09-12 22:41:52,2012-09-12 22:41:52
7c3815fa278e059928273f1ce96727d47ad704ee...128392ccea98e35d49272a64cdcccf6c857f6368,3,135,81,216,4,2012-09-12 23:26:10,2012-09-12 23:26:10
128392ccea98e35d49272a64cdcccf6c857f6368...c3477ec91c0c2fcbc9d3f77c09a0652ef6d7894a,3,68,73,141,31,2012-09-12 23:34:41,2012-09-12 23:34:41
c3477ec91c0c2fcbc9d3f77c09a0652ef6d7894a...90e516d7c9c88b70b0fd5b2978ec5fe98cc404a0,2,11,3,14,3,2012-09-12 23:59:24,2012-09-12 23:59:24
0565593da538523607d1c2e4300ae1175ebb9555...a9dfc0322bd9a6683ae3ed500a55b3672915cd26,1,5,5,10,1,2012-09-26 00:52:42,2012-09-26 00:02:20
a9dfc0322bd9a6683ae3ed500a55b3672915cd26...a016e83754da6987f4952b41f93203359c04625e,1,1,10,11,1,2012-09-26 01:26:06,2012-09-26 01:26:06
a016e83754da6987f4952b41f93203359c04625e...094546d53bdf77168647a19cebd35a90c8e6cb02,2,7,1,8,2,2012-09-27 18:10:28,2012-09-27 18:10:28
094546d53bdf77168647a19cebd35a90c8e6cb02...bc3778c17fce40d8483e11566405b4eac28fa035,1,1,1,2,1,2012-09-27 19:34:48,2012-09-27 16:12:58
bc3778c17fce40d8483e11566405b4eac28fa035...c4f977588a9666538f928ae82b32beffd9c86cd7,3,22,117,139,7,2012-09-27 19:39:01,2012-09-27 16:35:22
c4f977588a9666538f928ae82b32beffd9c86cd7...1426432da8c78377445b31f36e28918e074870bd,2,2,2,4,2,2012-09-27 19:39:01,2012-09-27 16:36:23
1426432da8c78377445b31f36e28918e074870bd...20f8da21c5cc268f8cce20055275638bde0570ab,1,1,1,2,1,2012-09-27 20:02:43,2012-09-27 20:02:43
20f8da21c5cc268f8cce20055275638bde0570ab...09eda1e30a4046d454c6d790c6f3a2c5b6a688f9,2,2,2,4,2,2012-09-27 20:03:45,2012-09-27 20:03:45
09eda1e30a4046d454c6d790c6f3a2c5b6a688f9...ef874ae15d1bb0dc8e434d0e2442abbe009b09b6,1,7,0,7,1,2012-09-27 20:38:29,2012-09-27 20:38:29
0565593da538523607d1c2e4300ae1175ebb9555...eaf146cc2e984c8c94b4160725cd0c7ee4efcf27,4,63,0,63,5,2012-09-25 03:17:19,2012-09-25 02:59:22
eaf146cc2e984c8c94b4160725cd0c7ee4efcf27...d22e1e6dcdc31ce42a65f0e348cee5094c4c5ea2,2,1,8,9,4,2012-09-25 03:25:03,2012-09-25 02:59:30
d22e1e6dcdc31ce42a65f0e348cee5094c4c5ea2...fe096edf23563dd842558ae0df663dcb39b1f136,5,75,104,179,27,2012-09-25 03:36:19,2012-09-25 03:36:19
fe096edf23563dd842558ae0df663dcb39b1f136...07c72f28c9e435ebe640707d131f60e2d3f7ed5c,1,3,3,6,2,2012-09-28 02:26:22,2012-09-28 02:26:22
07c72f28c9e435ebe640707d131f60e2d3f7ed5c...1920122ddd5e28f4000b164ed37e1a2a055b57b7,5,46,47,93,9,2012-09-28 02:34:59,2012-09-28 02:34:59
1920122ddd5e28f4000b164ed37e1a2a055b57b7...0adc89e736163f9bd7539705c4cbf85dd85d62ef,1,0,4,4,1,2012-09-28 20:16:00,2012-09-28 20:16:00
0adc89e736163f9bd7539705c4cbf85dd85d62ef...b995d4751a05f791b682a46cb272ae61c265f713,7,5,8,13,7,2012-09-28 20:23:30,2012-09-28 20:23:30
b995d4751a05f791b682a46cb272ae61c265f713...c9f51e3b84142d6b8d51b3abe8549b124591eb18,1,8,0,8,1,2012-09-28 21:09:00,2012-09-28 21:09:00
c9f51e3b84142d6b8d51b3abe8549b124591eb18...1e823080543df61aa631bb4a3463934e8daba1f6,5,15,9,24,6,2012-09-29 20:24:46,2012-09-29 20:24:46
3aa17a39cfdec6d3f345714698c3953c0182d29e...c3bb216466d11a819e6be283b5a9f2bc7007c3d0,1,15,0,15,2,2012-09-07 17:55:17,2012-09-07 17:55:17
369ae7f917c77c7fcccc8203deaaaac84db9e8df...44cd072c775256fcb01b8d5e0fea9ade96ce2166,1,57,46,103,15,2012-05-13 04:58:46,2012-05-12 16:43:34
44cd072c775256fcb01b8d5e0fea9ade96ce2166...39c4bdb72fd0499502e5f9eb8e20d7d4d57859f8,1,30,26,56,17,2012-05-13 04:58:50,2012-05-12 16:59:31
39c4bdb72fd0499502e5f9eb8e20d7d4d57859f8...dd0afc32bd7d3c931e43a7fafc69c89bc5df5ed0,1,87,90,177,47,2012-05-13 05:09:08,2012-05-12 17:32:07
dd0afc32bd7d3c931e43a7fafc69c89bc5df5ed0...e3c69efda378640aa015cf0b56aaff2617dbd5b7,1,21,10,31,1,2012-05-13 05:09:12,2012-05-12 17:37:29
e3c69efda378640aa015cf0b56aaff2617dbd5b7...58c66a4a98a8d517febdca6987333b934b6448a9,1,3,1,4,3,2012-05-13 05:13:44,2012-05-13 05:12:57
58c66a4a98a8d517febdca6987333b934b6448a9...95b35239eb3ce32b24c7735d05b882a18f7b26e7,1,72,73,145,15,2012-05-13 06:08:01,2012-05-13 06:08:01
7e872afa88f88ee742dccd859febe2fd2dbb543c...4e68bdd0e9b44ae2ecb1b60f0294a079f1bb60b1,2,5,2,7,3,2012-08-17 02:44:31,2012-08-17 02:44:31
4e68bdd0e9b44ae2ecb1b60f0294a079f1bb60b1...eae1e2b21365cbdd06e208fa81f7d16df5af7c0d,1,4,3,7,4,2012-08-17 21:00:45,2012-08-17 20:50:14
7e872afa88f88ee742dccd859febe2fd2dbb543c...f18b58763b3005e2e82bd46f65bec83341924e90,8,117,24,141,14,2012-08-16 06:28:51,2012-08-16 04:51:29
f18b58763b3005e2e82bd46f65bec83341924e90...e9956ee8e8cb7e7957cc6061ea9fdca7380d478f,4,29,1,30,4,2012-08-16 06:28:51,2012-08-16 05:30:15
e9956ee8e8cb7e7957cc6061ea9fdca7380d478f...b3ada2cf4f25f26964fbca0e47466f603b24c447,5,42,2,44,5,2012-08-16 06:28:51,2012-08-16 06:26:39
b3ada2cf4f25f26964fbca0e47466f603b24c447...1df6b74ada92a7c4cfa0f398486893d2b07d7148,6,27,25,52,19,2012-08-17 04:16:31,2012-08-17 04:16:31
1df6b74ada92a7c4cfa0f398486893d2b07d7148...f7afc0b5f318b69bd6484d120f14a00b44dbd8d8,1,2,0,2,1,2012-08-17 04:52:14,2012-08-17 04:52:14
d4558fd8a08a805445c36e7c3163c8c6227151f3...62b5f1c7ba87759d0e426b676c639406c20a1a43,1,9,4,13,4,2012-11-03 17:25:52,2012-11-03 17:25:52
62b5f1c7ba87759d0e426b676c639406c20a1a43...aaf5c633c14acb047fecfa0deb66ba4158e39882,1,2,2,4,2,2012-11-04 03:10:22,2012-11-04 03:10:22
aaf5c633c14acb047fecfa0deb66ba4158e39882...c27941589c30ca1755f41ac4e1a63326d5a8f114,2,8,2,10,3,2012-11-05 18:09:17,2012-11-05 08:08:11
c27941589c30ca1755f41ac4e1a63326d5a8f114...f58cbc620a2758b54cb28f56ef396e213dc1da9f,6,3126,2,3128,6,2012-11-05 18:40:51,2012-11-05 18:40:51
f58cbc620a2758b54cb28f56ef396e213dc1da9f...bad0726a993376343f79acfa6eac69728bf55f0a,2,3,3,6,3,2012-11-05 18:51:41,2012-11-05 18:51:41
fc85b3a24395bc708898813e6b6ea4b85b9067fc...8d2971a373e9d59083d325792097b853e1c589f4,2,30,20,50,17,2012-08-20 21:23:27,2012-08-20 21:23:27
8d2971a373e9d59083d325792097b853e1c589f4...f70aa390bbeb0f0c52f89dadf9b127b4f5bebf65,1,12,2,14,3,2012-08-21 06:22:30,2012-08-21 06:22:30
f70aa390bbeb0f0c52f89dadf9b127b4f5bebf65...a326aa367f2e63cd68339dab9e637cc704dfecaf,2,5,4,9,3,2012-08-21 06:22:53,2012-08-21 06:22:53
a326aa367f2e63cd68339dab9e637cc704dfecaf...7eb81ebffbe78f644f83306dd67df3ecd5be2b2b,2,21,8,29,7,2012-08-21 06:42:00,2012-08-21 06:42:00
7eb81ebffbe78f644f83306dd67df3ecd5be2b2b...32239218c918dffc5bf05bf0a5c76858a67df5e4,2,8,16,24,6,2012-08-21 07:11:39,2012-08-21 07:11:39
32239218c918dffc5bf05bf0a5c76858a67df5e4...e3c3fc6674e5bab671a6901eb1065631234f8c13,1,1,1,2,1,2012-08-22 18:19:27,2012-08-22 18:19:27
e3c3fc6674e5bab671a6901eb1065631234f8c13...2283e3e76fe86032265fc40bec96f3bc2392f2c0,1,3,3,6,3,2012-08-22 19:11:55,2012-08-22 19:11:55
2283e3e76fe86032265fc40bec96f3bc2392f2c0...4794ebc4471e2532c522ada53d64e886f07cedc2,1,5,3,8,2,2012-08-22 21:30:09,2012-08-22 21:30:09
4794ebc4471e2532c522ada53d64e886f07cedc2...a995e364bf207d7f390cf4a1e46c7b4ecd33a08c,2,43,10,53,8,2012-08-22 22:02:31,2012-08-22 21:33:50
a995e364bf207d7f390cf4a1e46c7b4ecd33a08c...0efe0e26d37fa08d419926b4ab3ecd8de5e34853,2,58,0,58,5,2012-08-22 22:15:41,2012-08-22 22:15:41
0efe0e26d37fa08d419926b4ab3ecd8de5e34853...b379b03f708625e21389cf17d24ab1fef33dcacb,3,66,16,82,14,2012-08-22 22:44:51,2012-08-22 22:44:51
b379b03f708625e21389cf17d24ab1fef33dcacb...c149a107353093ae0a4a386185394efe62e06cd1,5,101,19,120,9,2012-08-22 23:21:52,2012-08-22 23:21:52
c149a107353093ae0a4a386185394efe62e06cd1...9fe768989fd3f43f43447dbc30c8702a35d3070d,6,96,96,192,78,2012-08-22 23:58:48,2012-08-22 23:53:14
9fe768989fd3f43f43447dbc30c8702a35d3070d...379f6080434ba2d647972174362376f2fab27b48,5,83,79,162,34,2012-08-23 01:14:15,2012-08-23 01:14:15
379f6080434ba2d647972174362376f2fab27b48...0ddc169a9cc4e5641e2da4b88fcd6cb6e2dd4a2e,2,60,4,64,8,2012-08-23 01:40:47,2012-08-23 01:40:47
0ddc169a9cc4e5641e2da4b88fcd6cb6e2dd4a2e...1ca5357b28fa2a433a9eeb45144747c6a5c449b5,2,14,13,27,13,2012-08-23 02:41:06,2012-08-23 02:41:06
1ca5357b28fa2a433a9eeb45144747c6a5c449b5...99c0bfc54822737cecc8f9efc3536d8d636db77b,3,107,51,158,6,2012-08-23 18:58:14,2012-08-23 18:58:14
99c0bfc54822737cecc8f9efc3536d8d636db77b...2255c613834495df87e19bf80fe63b261b00fe72,3,13,13,26,13,2012-08-23 19:17:53,2012-08-23 19:17:53
2255c613834495df87e19bf80fe63b261b00fe72...9005cf34a0efeedfb339bbb7fd6ef7de6cb37def,2,4,4,8,4,2012-08-23 19:23:07,2012-08-23 19:23:07
fc85b3a24395bc708898813e6b6ea4b85b9067fc...0045e19e39025f965a1faf90a39480ee868ad3c8,3,291,27,318,17,2012-08-16 05:21:06,2012-08-04 10:44:46
0045e19e39025f965a1faf90a39480ee868ad3c8...0a645d8867fc50ac291c9a245077d2dc334a40ad,1,10,14,24,3,2012-08-16 05:21:06,2012-08-05 07:54:47
0a645d8867fc50ac291c9a245077d2dc334a40ad...b6b78bdffff21d2d206f8484446aa35f914fcf29,1,10,0,10,1,2012-08-16 05:21:06,2012-08-10 01:22:18
b6b78bdffff21d2d206f8484446aa35f914fcf29...13cb8d821726290d69a25f48e93f5c3be818ae67,7,339,203,542,39,2012-08-16 10:35:07,2012-08-16 10:35:07
13cb8d821726290d69a25f48e93f5c3be818ae67...60ffa8bc11514d95adc8b6dc133dcdaf377febde,1,3,3,6,1,2012-08-16 10:36:43,2012-08-16 10:36:43
60ffa8bc11514d95adc8b6dc133dcdaf377febde...ff2f7d8d2039a22bbc3954219450717779e54faf,5,131,79,210,33,2012-08-18 04:46:10,2012-08-18 04:46:10
910adda358669f51a9c1fe699972022f8063b6bf...41dff26890afd3c3f372ba78df07a1c61566241e,6,42,36,78,19,2012-08-17 23:33:00,2012-08-17 23:33:00
41dff26890afd3c3f372ba78df07a1c61566241e...1c6a31c67a056bd00ddd70c3acc4fe0e0b55b750,4,3,21,24,6,2012-08-18 00:02:06,2012-08-18 00:02:06
1c6a31c67a056bd00ddd70c3acc4fe0e0b55b750...c3b018b3c6c83ec450c9b348c30e7f1f93651343,2,17,5,22,2,2012-08-18 00:52:24,2012-08-18 00:52:24
c3b018b3c6c83ec450c9b348c30e7f1f93651343...729e45003b25d40a02905da9e1255af8b86de654,1,1,1,2,1,2012-08-18 00:53:01,2012-08-18 00:53:01
729e45003b25d40a02905da9e1255af8b86de654...410a8fcaead2375ccf888e9dc9852ab8d88a6de2,1,4,1,5,1,2012-08-23 05:32:26,2012-08-23 05:32:26
0f1816181c94eba8630bbff48c8fb45be8b31630...dc34cff99086218aed5809e792a1ec1fe063c3e2,3,82,0,82,3,2012-08-03 05:21:13,2012-07-25 02:34:14
dc34cff99086218aed5809e792a1ec1fe063c3e2...78c47533b5e86e5c36e739c2f9d44c3f5b77e50d,3,35,0,35,3,2012-08-03 05:21:13,2012-08-03 05:20:46
78c47533b5e86e5c36e739c2f9d44c3f5b77e50d...0d27fa40f223dac1a552562f3ba6c7f780bb1ba4,1,3,0,3,1,2012-08-03 05:39:28,2012-08-03 05:39:28
0d27fa40f223dac1a552562f3ba6c7f780bb1ba4...7632dc03866a5887d4a6d9a7c1f90fc4058682ef,1,19,21,40,3,2012-08-03 06:06:41,2012-08-03 06:06:41
7632dc03866a5887d4a6d9a7c1f90fc4058682ef...81cb0239f062e9be76fac925d915821b9cc856ad,1,22,8,30,7,2012-08-04 01:11:25,2012-08-04 01:11:25
81cb0239f062e9be76fac925d915821b9cc856ad...ee7fc09c164b30f52eab238a533ad2f026c76c59,1,4,3,7,1,2012-08-04 01:12:59,2012-08-04 01:12:59
ee7fc09c164b30f52eab238a533ad2f026c76c59...24c2fe9d7f0b63170ff48d5a7ce0b50053fac78c,1,10,0,10,2,2012-08-04 02:06:14,2012-08-04 02:06:14
24c2fe9d7f0b63170ff48d5a7ce0b50053fac78c...33d53847c0bc8111294c0291070e1b964df3428a,4,9,2,11,5,2012-08-04 02:49:05,2012-08-04 02:49:05
33d53847c0bc8111294c0291070e1b964df3428a...07c703270cfec335747168af9151e0f90f5574c5,1,15,14,29,5,2012-08-04 03:59:38,2012-08-04 03:59:38
07c703270cfec335747168af9151e0f90f5574c5...0397945fd8f8379c65e7d79405a22e5c9c45f110,2,16,11,27,4,2012-08-04 05:00:25,2012-08-04 05:00:25
0397945fd8f8379c65e7d79405a22e5c9c45f110...f55a824f2c2d0b3c3d6a8b42d63aeb03a6e25fce,2,23,14,37,5,2012-08-06 23:33:14,2012-08-06 23:33:14
a07411e69d7339ef10ac2792b8b749e65e907b10...a1e71d820f6902e74e70ffc912f3a195c4446d32,9,140,21,161,15,2012-08-03 03:14:23,2012-08-01 05:41:57
a07411e69d7339ef10ac2792b8b749e65e907b10...a0b5bcffe31367e71a31426b793a2d1f03ffa7a4,1,3,3,6,2,2012-07-30 07:27:53,2012-07-30 07:27:53
0ed8555690ed74afb16b7ea93d8e531a560b47a1...3a1e9112293f4bb299e0e4278b31405680b3aa70,7,273,0,273,7,2012-09-17 21:59:42,2012-09-17 21:59:42
3a1e9112293f4bb299e0e4278b31405680b3aa70...e05a08c53c3beba9dcf844a502d5c967d3a82554,5,120,44,164,25,2012-09-17 23:05:00,2012-09-17 23:05:00
e05a08c53c3beba9dcf844a502d5c967d3a82554...268e4bc230aaaabfab61c3218ea2f63115d8b3c3,2,270,0,270,2,2012-09-25 03:37:09,2012-09-25 03:37:09
268e4bc230aaaabfab61c3218ea2f63115d8b3c3...225b2f7496252b3778d97ccbd29baa327715bbe4,3,1,71,72,7,2012-09-25 03:45:13,2012-09-25 03:45:13
225b2f7496252b3778d97ccbd29baa327715bbe4...f42a4cfef932f1c3ca34565feeab6ab1b2c07a87,2,201,14,215,19,2012-10-10 22:40:36,2012-10-10 22:40:36
0ed8555690ed74afb16b7ea93d8e531a560b47a1...f340c35c02e7f01670e4bba8e7c762127498bfd2,10,244,10,254,12,2012-09-15 01:38:29,2012-08-17 02:41:36
afc7e90d204cb8b56e17284b4ac402f5406342df...a4c4fabbbd4a07e597a9670e57688f15c1ff041e,4,8,5,13,5,2012-09-19 18:42:34,2012-09-19 18:42:34
68dafc94c5f1eb6cf2350ee74e9f65130f665bc5...c2649982797bf448fa4d1837e70c503d4b003875,2,24,2,26,6,2012-10-21 04:08:00,2012-10-21 04:08:00
95965528ad67aada99a57603d5053bf94156a731...57c3c2a50d851db60db2715bebd3c04034ad6b22,1,4,5,9,2,2012-10-04 21:05:06,2012-10-04 21:01:58
57c3c2a50d851db60db2715bebd3c04034ad6b22...afcafe1eb571241871eda698b7ba6b71774828aa,1,17,31,48,6,2012-10-04 21:08:13,2012-09-29 00:49:08
afcafe1eb571241871eda698b7ba6b71774828aa...7a25d86dc07296ee0670c7997fb95eedc61bdc58,1,1,3,4,2,2012-10-05 01:28:12,2012-10-05 01:28:02
ef874ae15d1bb0dc8e434d0e2442abbe009b09b6...4e15995e4f10589af5fff872fb4d43efc76f0cff,3,12,2,14,5,2012-09-27 21:31:21,2012-09-27 21:31:21
f3f64922c4faf93e51329d6bbe091e3647dd47ae...3201fe5180831303e67f8ffcf596603f6e757f64,3,166,88,254,16,2012-09-30 04:33:19,2012-09-30 04:33:19
3201fe5180831303e67f8ffcf596603f6e757f64...6686d40526c38e84ca638fa443beb9ca72777972,3,155,29,184,26,2012-09-30 07:42:04,2012-09-30 07:42:04
6686d40526c38e84ca638fa443beb9ca72777972...8f23d526180f1686377c12f816dcfa3e0611813c,5,0,0,0,0,2012-09-30 22:04:55,2012-09-30 22:04:55
8f23d526180f1686377c12f816dcfa3e0611813c...9dce7c7cfa85f9f0a5d289eb9878759eac8451da,1,5,5,10,4,2012-09-30 22:05:32,2012-09-30 22:05:32
9dce7c7cfa85f9f0a5d289eb9878759eac8451da...be6b876d535db774b128dbde75269b9a6c42c58a,1,1,1,2,1,2012-09-30 22:30:59,2012-09-30 22:30:59
be6b876d535db774b128dbde75269b9a6c42c58a...998ad47b2108005c9682bbf9e265b215d703a645,1,1,1,2,1,2012-10-01 17:13:44,2012-10-01 17:13:44
998ad47b2108005c9682bbf9e265b215d703a645...afff7677b59d2743c5e18bda08f5277e72d272ac,2,54,52,106,6,2012-10-01 19:28:09,2012-10-01 19:28:09
afff7677b59d2743c5e18bda08f5277e72d272ac...be4da5fba4caf68fff93eefcb45cd349e39e374d,3,26,37,63,8,2012-10-01 20:45:54,2012-10-01 20:45:54
be4da5fba4caf68fff93eefcb45cd349e39e374d...8d32db1e0db44ba06915b5c1994b05b30ef13486,1,43,0,43,1,2012-10-02 00:57:02,2012-10-02 00:57:02
8d32db1e0db44ba06915b5c1994b05b30ef13486...547c93e4653943e8294dba1d9fd69815679b5fe9,1,3,3,6,2,2012-10-02 00:58:33,2012-10-02 00:58:33
547c93e4653943e8294dba1d9fd69815679b5fe9...d7f45f9d86e7c337f547162b2d9de4ec94e24ca6,1,9,10,19,4,2012-10-02 01:06:58,2012-10-02 01:06:58
d7f45f9d86e7c337f547162b2d9de4ec94e24ca6...088c33c3f3b696f3de260a003cc7e3845c50ef7e,1,1,1,2,1,2012-10-02 01:07:14,2012-10-02 01:07:14
1e721bf2eef3b059d26f3feb58fc2ac18b4a4d7f...68625577429938aa691136f643ed80e147e6d667,2,86,91,177,18,2012-05-13 19:57:01,2012-05-13 19:57:01
68625577429938aa691136f643ed80e147e6d667...5e5769490ad34d7e4f4323e684464724be0ceed4,1,9,10,19,6,2012-05-15 22:18:11,2012-05-15 22:17:46
5e5769490ad34d7e4f4323e684464724be0ceed4...a013be09654b45954de60ad1b0c6c6cc55754496,1,5,7,12,4,2012-05-16 04:21:43,2012-05-16 04:21:43
a013be09654b45954de60ad1b0c6c6cc55754496...cf685eb58da86ca03b5bc89a03b27dcd944ae450,1,1,0,1,1,2012-05-16 06:01:43,2012-05-16 06:01:27
cf685eb58da86ca03b5bc89a03b27dcd944ae450...62794338c48d45a398d143332be575f75dfac4cd,1,1,1,2,1,2012-05-16 19:12:06,2012-05-16 19:12:06
62794338c48d45a398d143332be575f75dfac4cd...0172f9870a8b3085c9d774e4af57fd328c60a19d,5,67,13,80,10,2012-05-16 19:37:53,2012-05-16 19:37:53
0172f9870a8b3085c9d774e4af57fd328c60a19d...fe5d57b7b9f7b4fd52d841651800fb51099b9ae4,1,1,1,2,1,2012-05-16 19:38:42,2012-05-16 19:38:42
fe5d57b7b9f7b4fd52d841651800fb51099b9ae4...4ac26ecc49541f8e46da2e7b80a86dc467af5c73,1,7,0,7,1,2012-05-16 19:52:47,2012-05-16 19:52:47
4ac26ecc49541f8e46da2e7b80a86dc467af5c73...201d146816288801fad2e0a53a834e4fb51a28e1,1,4,1,5,1,2012-05-16 20:20:42,2012-05-16 20:20:42
201d146816288801fad2e0a53a834e4fb51a28e1...1cba2f21f059117ee5046a6f5bb8b3e9a2cf03a3,1,1,1,2,1,2012-05-16 22:31:27,2012-05-16 22:31:27
1cba2f21f059117ee5046a6f5bb8b3e9a2cf03a3...cff1cb607759d71822d7276958d50cd01897fef8,1,44,21,65,8,2012-05-16 23:08:45,2012-05-16 23:08:45
cff1cb607759d71822d7276958d50cd01897fef8...401a2f05fd5fb1fb91ddc837e46ca37c7081c2a7,7,10,10,20,8,2012-05-17 01:01:36,2012-05-17 01:01:36
401a2f05fd5fb1fb91ddc837e46ca37c7081c2a7...5105de0159f95ab7d2758498c1201cdebdd1575f,1,3,0,3,1,2012-05-17 01:16:59,2012-05-17 01:16:59
46d296450c2f222a582373e13599b9628d3314c6...e86d28235455eec20fd70d359243edc0074759e0,7,168,10,178,9,2012-08-17 21:23:19,2012-08-17 02:41:36
bad0726a993376343f79acfa6eac69728bf55f0a...5ccacd1fbd226292b68abb52317a13c611e65751,5,85,77,162,64,2012-11-05 19:19:23,2012-10-28 08:23:45
5ccacd1fbd226292b68abb52317a13c611e65751...7d8f744f157871e5849deeffb3651334b771762e,3,32,36,68,13,2012-11-05 19:36:47,2012-11-05 19:36:24
410a8fcaead2375ccf888e9dc9852ab8d88a6de2...03b77061342373f683097cca5e4e7d1f626a891e,14,488,1,489,16,2012-08-24 19:19:37,2012-07-29 22:37:29
03b77061342373f683097cca5e4e7d1f626a891e...ca609e5918ccefbed5eeea7c431e3ffded4f9d87,2,6,0,6,3,2012-08-24 19:19:37,2012-07-30 00:39:35
ca609e5918ccefbed5eeea7c431e3ffded4f9d87...107051a3f379093645b574b2751d9a3b02bbfc4c,1,7,7,14,7,2012-08-24 19:19:37,2012-07-30 00:45:42
107051a3f379093645b574b2751d9a3b02bbfc4c...08a53cabcad1b9683dfc91bf58b6c3d120afe079,1,19,31,50,8,2012-08-24 19:19:37,2012-07-30 00:53:57
08a53cabcad1b9683dfc91bf58b6c3d120afe079...7dfb385fc3f228b381daa3ec7fe4bf0653e7c6fd,1,27,27,54,4,2012-08-24 19:19:37,2012-07-30 00:57:47
7dfb385fc3f228b381daa3ec7fe4bf0653e7c6fd...2915d907e10dda39937497de5b6231ef939ff1fb,1,4,0,4,1,2012-08-24 19:19:37,2012-07-30 01:06:41
2915d907e10dda39937497de5b6231ef939ff1fb...1bffb63b63a021f2d2b990b1db1295893b07bc09,2,2,3,5,2,2012-08-24 19:19:38,2012-07-30 01:20:00
1bffb63b63a021f2d2b990b1db1295893b07bc09...42ca4de679b3c8f7736c9af12736ff5c7d01eaa5,2,13,9,22,9,2012-08-24 19:19:38,2012-07-30 01:32:33
42ca4de679b3c8f7736c9af12736ff5c7d01eaa5...5f9485d1330ca21464a124718d652281acf94dc4,1,2,2,4,1,2012-08-24 19:19:38,2012-07-30 02:26:38
5f9485d1330ca21464a124718d652281acf94dc4...9c8fd2958e1f1bade4d7c8c7d5c2fe9ec1978135,4,29,51,80,12,2012-08-24 19:20:57,2012-08-01 10:09:41
9c8fd2958e1f1bade4d7c8c7d5c2fe9ec1978135...7d7ac074df8248264e4c66d3aee3568a319aae6f,1,10,5,15,2,2012-08-24 19:20:59,2012-08-02 04:31:57
7d7ac074df8248264e4c66d3aee3568a319aae6f...98eaf61bef760cc1ee0c7d59ab26fc79d18a9590,2,11,11,22,11,2012-08-24 19:20:59,2012-08-02 04:35:56
98eaf61bef760cc1ee0c7d59ab26fc79d18a9590...63eeec47081cf7eee44e477e93cefcecbf517900,7,86,111,197,7,2012-08-24 19:21:53,2012-08-02 05:02:07
63eeec47081cf7eee44e477e93cefcecbf517900...ca40bf2875d288953ae953bb580c724efd2e9e1f,1,4,4,8,4,2012-08-24 19:21:56,2012-08-02 05:04:56
ca40bf2875d288953ae953bb580c724efd2e9e1f...6141c032eeba1bbabc2f5ef27efab36321dcc9d1,9,8,30,38,12,2012-08-24 19:23:00,2012-08-02 05:12:20
6141c032eeba1bbabc2f5ef27efab36321dcc9d1...2acd9e17e3fa85682741e24cb026aab9d556f07f,9,7,49,56,9,2012-08-24 19:23:02,2012-08-02 05:40:26
2acd9e17e3fa85682741e24cb026aab9d556f07f...19f043583d8d7159e6ca7a842b20e33ea6ff0a76,2,3,44,47,3,2012-08-24 19:23:42,2012-08-02 05:53:31
19f043583d8d7159e6ca7a842b20e33ea6ff0a76...30b6b314484d6a32fd3d069c0fb3e3a9946d868d,7,58,6,64,7,2012-08-24 19:23:44,2012-08-02 06:07:20
30b6b314484d6a32fd3d069c0fb3e3a9946d868d...bba4685269b0dc675c644a4732f08034a95a88ef,14,17,17,34,17,2012-08-24 19:23:44,2012-08-02 06:11:13
bba4685269b0dc675c644a4732f08034a95a88ef...d7b2278630313ca55e5b2ac5f7a1da2f6518572d,1,5,4,9,2,2012-08-24 19:24:17,2012-08-02 06:19:22
d7b2278630313ca55e5b2ac5f7a1da2f6518572d...768af064ba5a0b0f672d9b7aafafb5e9c8dc3d39,6,10,10,20,10,2012-08-24 19:24:18,2012-08-02 06:33:03
768af064ba5a0b0f672d9b7aafafb5e9c8dc3d39...380910d72f18345409bb72d1fb0b8ab199e0b5a1,5,15,31,46,6,2012-08-24 19:24:19,2012-08-02 07:00:32
380910d72f18345409bb72d1fb0b8ab199e0b5a1...2259ea6e08dee43001cf7a98d2a28ee06d28886a,3,51,56,107,11,2012-08-24 19:24:52,2012-08-02 08:18:45
2259ea6e08dee43001cf7a98d2a28ee06d28886a...e14e7b7b82a7cd40210b5a5f63d6d604e262230a,3,8,9,17,8,2012-08-24 19:24:53,2012-08-14 05:36:25
e14e7b7b82a7cd40210b5a5f63d6d604e262230a...a352ff25246c69862b480d826f93918d93313450,3,1,12,13,3,2012-08-24 19:24:53,2012-08-14 06:21:23
a352ff25246c69862b480d826f93918d93313450...56399c27559355207e7335c929f056d8a2a67cf7,11,35,17,52,19,2012-08-24 19:24:54,2012-08-14 07:39:51
56399c27559355207e7335c929f056d8a2a67cf7...6b914593aeeb6878c02ca8cd745256a69b5da8e7,1,2,1,3,1,2012-08-24 19:24:54,2012-08-16 01:05:12
6b914593aeeb6878c02ca8cd745256a69b5da8e7...98c364338f12f3eeaa573210aa09e935b71fbd6a,12,146,135,281,51,2012-08-24 19:25:28,2012-08-18 08:09:16
98c364338f12f3eeaa573210aa09e935b71fbd6a...9844a169e7c7e69ef503c8bcc1f66ebec05de6bb,3,34,18,52,19,2012-08-24 19:25:31,2012-08-18 08:58:13
9844a169e7c7e69ef503c8bcc1f66ebec05de6bb...8fa9ff0114b5d975ba3ab3513b31f9eb221d84ec,1,2,1,3,1,2012-08-24 19:25:31,2012-08-18 20:38:37
8fa9ff0114b5d975ba3ab3513b31f9eb221d84ec...4bb3072361f0deddcf2668ada5b9511ca861f765,3,36,36,72,4,2012-08-24 19:25:31,2012-08-21 07:35:43
4bb3072361f0deddcf2668ada5b9511ca861f765...3be22008f08ae470e49a5d4f1c2c09b98e82ef95,1,0,3,3,1,2012-08-24 19:25:31,2012-08-21 07:53:08
3be22008f08ae470e49a5d4f1c2c09b98e82ef95...8297e395108d9d8ff33039efec8fce23990c9ec4,3,24,34,58,3,2012-08-24 19:25:31,2012-08-21 08:03:24
8297e395108d9d8ff33039efec8fce23990c9ec4...0405b2e2e10d09b0b8baa4e7207dfd0a52c2fb5a,4,20,18,38,10,2012-08-24 19:25:31,2012-08-21 23:27:41
0405b2e2e10d09b0b8baa4e7207dfd0a52c2fb5a...5d6230fb59977a0adfc13c1695fbc9a735051bd6,5,5,6,11,5,2012-08-24 19:25:31,2012-08-22 04:15:57
5d6230fb59977a0adfc13c1695fbc9a735051bd6...b6ec3d59d472eb821d63942e1267bda0cbed0045,2,118,14,132,10,2012-08-24 19:25:31,2012-08-22 05:13:16
b6ec3d59d472eb821d63942e1267bda0cbed0045...a2eda047feab6d156b708848234295eb356bd680,12,149,126,275,74,2012-08-24 19:25:31,2012-08-23 05:02:40
a2eda047feab6d156b708848234295eb356bd680...b9c3805f62ead7893527c38d7d19d788c04c22c1,6,36,21,57,22,2012-08-24 19:25:31,2012-08-24 19:15:24
2809b9b27d69b5296bd8847597d70cf1701607b0...f5415248cb65498b913cde9e5e47e925924d1e7c,1,2,2,4,2,2012-08-06 23:54:13,2012-08-06 23:54:13
d17ddc93ac667b4273dd68ff3a9b501e4e4c8d7c...c499f7c9dae9c3ab19bcfdbcff3dc49ff68469dc,2,13,3,16,4,2012-08-20 22:37:16,2012-08-20 22:07:32
c499f7c9dae9c3ab19bcfdbcff3dc49ff68469dc...005413b3dc709b50ec9970279f4613442a01a24b,1,1,1,2,1,2012-08-20 23:06:32,2012-08-20 23:06:32
f340c35c02e7f01670e4bba8e7c762127498bfd2...f46dfc27174e072ed94923da6f704a8b694f96b9,1,10,12,22,3,2012-09-15 05:43:35,2012-09-15 05:43:35
f46dfc27174e072ed94923da6f704a8b694f96b9...755b1bcfa2f3be361347693b5c1962d3b14532d8,2,18,12,30,4,2012-09-15 20:34:04,2012-09-15 20:34:04
755b1bcfa2f3be361347693b5c1962d3b14532d8...8bd77fab4b8f0c679db4041d158bec2bc11efd73,1,1,1,2,1,2012-09-16 01:32:06,2012-09-16 01:32:06
8bd77fab4b8f0c679db4041d158bec2bc11efd73...6a4f20ae5575ac1073f723d68510730ca8c8af32,1,7,3,10,2,2012-09-16 02:10:09,2012-09-14 23:32:45
6a4f20ae5575ac1073f723d68510730ca8c8af32...dcd26415fe3b526d72137dfc67091ac5ea4108dc,3,21,13,34,7,2012-09-16 07:34:37,2012-09-16 07:21:20
dcd26415fe3b526d72137dfc67091ac5ea4108dc...5d9ff8046104f6a72ef31d616dd7b57a72dd7c5f,5,8,41,49,10,2012-09-16 07:34:54,2012-09-16 07:28:43
5d9ff8046104f6a72ef31d616dd7b57a72dd7c5f...8e5e0b623a8dfaff4b29150c709bf6d61f776f2a,1,21,0,21,1,2012-09-16 07:49:09,2012-09-16 07:47:25
8e5e0b623a8dfaff4b29150c709bf6d61f776f2a...10fdc9b261dcc1c9bb43e7300db7296c298a9e3d,2,29,0,29,2,2012-09-16 08:09:36,2012-09-16 08:09:36
10fdc9b261dcc1c9bb43e7300db7296c298a9e3d...e8256ef866effb8d24e81ec0672869de45df13ec,2,14,2,16,2,2012-09-16 08:22:21,2012-09-16 08:22:21
e8256ef866effb8d24e81ec0672869de45df13ec...ffd6461e58aa6c12f52b9d307475ad7adbc5beaa,1,1,2,3,2,2012-09-16 08:30:16,2012-09-16 08:30:16
f340c35c02e7f01670e4bba8e7c762127498bfd2...763a442da59ce8a9bf9b1b3889578018a3b3f7a4,3,45,2,47,5,2012-09-15 01:40:18,2012-09-15 01:40:18
886d657afeccb1ef5c352ac20a348cddfa1e824a...de413efe500174999211eff318ad65eb34794d74,11,40,58,98,11,2012-09-19 23:19:54,2012-09-19 23:19:54
de413efe500174999211eff318ad65eb34794d74...e1a7c2ff465aed7216651586f83aa38fd0155f10,1,4,2,6,2,2012-09-20 14:33:08,2012-09-20 14:33:08
e1a7c2ff465aed7216651586f83aa38fd0155f10...4b8a68800052ac7bc3ef2ace3c6495122602ccf9,2,2,2,4,2,2012-09-20 19:05:51,2012-09-20 19:04:00
4b8a68800052ac7bc3ef2ace3c6495122602ccf9...b0d181dbcc1e22ec9b425af2366fa6bf7f37cd2b,4,28,2,30,5,2012-09-20 22:07:52,2012-09-20 22:07:52
af741cc245c88bff81889c14855484fa53b0397a...102880a306b1ea1b967f7a9ad208d3fa30e3a268,7,20,20,40,20,2012-09-17 22:08:40,2012-09-17 21:46:06
102880a306b1ea1b967f7a9ad208d3fa30e3a268...e9dcfff310c5ab2e8b968bd2b7319d3c32e3c2a1,1,6,6,12,6,2012-09-19 19:01:25,2012-09-19 19:01:25
e9dcfff310c5ab2e8b968bd2b7319d3c32e3c2a1...c322737de733b37ca6959a9be679a88f9f6b213a,1,1,1,2,1,2012-09-20 21:19:40,2012-09-20 21:19:40
16cf8a26218ae4650eb36b25ee55c2b5f6a71a31...68db80f5002aee8b94e4e6aa2099a746a8267f17,8,10,10,20,8,2012-11-27 16:43:29,2012-11-27 16:43:29
68db80f5002aee8b94e4e6aa2099a746a8267f17...0757e96e6d6a0ed22ecc1d015145baf7df742a06,1,13,4,17,5,2012-11-27 16:45:01,2012-11-24 00:49:23
0757e96e6d6a0ed22ecc1d015145baf7df742a06...6635ae1007c18690757f3a3106e92ebe241af9b8,1,4,0,4,1,2012-11-27 16:46:09,2012-11-27 16:46:09
3367cf0840be366f10da0d19586dd692aa4ecafc...7bfa178bbdb8b745a4f78418049743007866d9d5,2,27,25,52,11,2012-12-03 20:02:12,2012-12-03 20:02:12
074b2b6a8844c6b6049174b07e965169ae1456f9...c084e35282a6a75c62f9ceec7e6de45163bc95de,2,11,11,22,11,2012-10-17 23:22:20,2012-10-15 04:11:34
c084e35282a6a75c62f9ceec7e6de45163bc95de...4ca931aed865cacebdf3e656dd940a3185dc85d1,1,1,1,2,1,2012-10-19 00:00:31,2012-10-19 00:00:31
4ca931aed865cacebdf3e656dd940a3185dc85d1...6e15cc15628a216056f7e9a2db828098464e3016,1,5,4,9,1,2012-10-19 02:57:53,2012-10-19 02:57:53
6e15cc15628a216056f7e9a2db828098464e3016...d40be780fbcbdb370914403259a3f7ac99e0b075,1,26,0,26,1,2012-10-20 07:31:16,2012-10-20 07:31:16
d40be780fbcbdb370914403259a3f7ac99e0b075...893e37f4d7d034171055998119b49f94cc3de8a4,3,31,0,31,3,2012-10-20 07:56:42,2012-10-20 07:56:42
893e37f4d7d034171055998119b49f94cc3de8a4...7c0da2c1b41dfd98984387a4e5f2208561dd1acb,1,2,2,4,1,2012-10-20 08:26:03,2012-10-20 08:26:03
7c0da2c1b41dfd98984387a4e5f2208561dd1acb...1c70dcef66985551576daedab50f632b9b98e319,2,5,6,11,3,2012-10-23 17:57:05,2012-10-23 17:57:05
1c70dcef66985551576daedab50f632b9b98e319...21902a4ed2e4c4ba4f97d9e83c884de48b4850a2,1,3,1,4,2,2012-10-23 18:00:19,2012-10-23 18:00:19
21902a4ed2e4c4ba4f97d9e83c884de48b4850a2...4c5a4acb02e9484b03256ec046afb426bec38453,1,4,3,7,1,2012-10-23 22:52:31,2012-10-23 22:22:30
4c5a4acb02e9484b03256ec046afb426bec38453...101cbf3cb6bc47adc761aa842846e1c3b889ac64,1,1,1,2,1,2012-10-25 22:28:49,2012-10-25 22:28:49
101cbf3cb6bc47adc761aa842846e1c3b889ac64...ea192438d1c1d421ef6c65b2a03ada30d49d6d35,1,4,2,6,2,2012-10-27 19:12:59,2012-10-27 19:12:59
ea192438d1c1d421ef6c65b2a03ada30d49d6d35...6307faafef750b1993b4a11d3edac665ffe4cce5,1,6,0,6,1,2012-10-27 19:17:46,2012-10-27 19:17:38
6307faafef750b1993b4a11d3edac665ffe4cce5...dee48f736a74eb0ecf171195cbf6a04b225c2fe1,1,5,0,5,1,2012-10-29 18:56:14,2012-10-29 18:56:14
dee48f736a74eb0ecf171195cbf6a04b225c2fe1...32035e80391623fcc93ea0c775a9af02d8b4d7ac,3,92,78,170,9,2012-10-29 19:21:34,2012-10-29 18:54:10
32035e80391623fcc93ea0c775a9af02d8b4d7ac...1c9a5f9f6f3383391e2701a869a518eb8c61f51b,2,13,7,20,7,2012-10-29 19:43:44,2012-10-29 19:43:44
1c9a5f9f6f3383391e2701a869a518eb8c61f51b...476ff29464ecf54ccd07db177455e085ef6e2130,1,8,5,13,3,2012-10-30 02:12:15,2012-10-30 02:12:15
476ff29464ecf54ccd07db177455e085ef6e2130...0f6733fe3cec72d2cba83ea4b54ac98f011e4fe4,1,2,2,4,2,2012-10-30 02:13:01,2012-10-30 02:13:01
7a25d86dc07296ee0670c7997fb95eedc61bdc58...f36fc90c07f315be36d6cdd076a5658c5eccc3f0,2,4,0,4,2,2012-10-05 05:02:24,2012-10-05 05:02:24
4e15995e4f10589af5fff872fb4d43efc76f0cff...bee8bcf4826b6a38e610d0bb60b5b427ae7d9176,1,2,20,22,3,2012-09-28 07:14:41,2012-09-28 07:11:51
bee8bcf4826b6a38e610d0bb60b5b427ae7d9176...ac9f553d0759c901a8718c72d50de87681063567,3,24,19,43,13,2012-09-28 07:19:54,2012-09-28 07:19:54
ac9f553d0759c901a8718c72d50de87681063567...80dbb2e7a619b5462462f504d8102892db4110cf,1,1,1,2,1,2012-09-28 14:37:13,2012-09-28 14:37:13
80dbb2e7a619b5462462f504d8102892db4110cf...8ff16d3b04771520b259da50d608c73049023f7a,1,2,2,4,1,2012-09-28 18:42:57,2012-09-28 18:42:57
8ff16d3b04771520b259da50d608c73049023f7a...2495cb2f58c80f8517c4d9e76f47809a2f3942bc,3,37,26,63,8,2012-09-28 18:57:48,2012-09-28 18:57:48
2495cb2f58c80f8517c4d9e76f47809a2f3942bc...4dcdeb44350e2a547d6f924dacaeeaa98d1fc672,1,3,1,4,1,2012-09-28 19:39:03,2012-09-28 19:39:03
4dcdeb44350e2a547d6f924dacaeeaa98d1fc672...caecb40f1a94bd304a69cb4e95dc42a882f2c6fb,1,9,7,16,3,2012-09-28 23:14:10,2012-09-28 23:14:10
088c33c3f3b696f3de260a003cc7e3845c50ef7e...5eb81e920d9ee14e7b0bdeefd5659831f5507c24,9,13,10,23,9,2012-10-02 01:25:18,2012-10-02 01:25:18
5105de0159f95ab7d2758498c1201cdebdd1575f...dd95b830e49131dd96a7084c023630b2b9af8c56,1,6,2,8,3,2012-05-25 18:37:24,2012-05-25 18:37:24
5105de0159f95ab7d2758498c1201cdebdd1575f...1c0d784e5d731aafc868e32b157341c2b9eca914,1,2,1,3,1,2012-05-17 02:15:47,2012-05-17 02:15:47
1c0d784e5d731aafc868e32b157341c2b9eca914...ac487445f5f5a21419484c3c4e991db704e4f6ff,1,6,0,6,1,2012-05-17 19:00:24,2012-05-17 19:00:24
ac487445f5f5a21419484c3c4e991db704e4f6ff...a1a6414c1a8bf222735b604c978ad438b16c5f06,2,39,0,39,7,2012-05-23 04:32:15,2012-05-23 04:32:15
c020d4a9241fe3b49e26a3589d6b94b3ef6a90be...ed0c21ad378aec817c10e2f5e7653e87fd41f9f6,1,1,1,2,1,2012-11-05 20:18:11,2012-11-05 20:18:11
ed0c21ad378aec817c10e2f5e7653e87fd41f9f6...89730bcfcb7d4872392f739bd816818ab756e0de,1,1,1,2,1,2012-11-05 21:34:21,2012-11-05 21:34:21
89730bcfcb7d4872392f739bd816818ab756e0de...cb464b7ee47be0d9b8426dce71859326643c1632,3,18,0,18,3,2012-11-05 22:04:48,2012-11-05 22:04:48
cb464b7ee47be0d9b8426dce71859326643c1632...c8a9bc9e5af0174f2deac9373a90d01da6b7dd97,2,3,3,6,3,2012-11-05 22:55:55,2012-11-05 22:55:55
c8a9bc9e5af0174f2deac9373a90d01da6b7dd97...a5cc93ee55901335ebf849d343b4f81e2603b9ba,8,0,85,85,8,2012-11-05 23:24:08,2012-11-05 23:24:08
a5cc93ee55901335ebf849d343b4f81e2603b9ba...e4d237f59ac30a06e5052d3db423387e5bedfc9b,1,1,3,4,2,2012-11-06 03:01:58,2012-11-06 03:01:58
e4d237f59ac30a06e5052d3db423387e5bedfc9b...e8f1510aed60ad5494d047888ee567aa2769dfee,1,2,2,4,2,2012-11-06 04:58:25,2012-11-06 04:58:25
e8f1510aed60ad5494d047888ee567aa2769dfee...e6a9ad67463594894ee1fd34ef3d854e98beb8d6,1,11,0,11,1,2012-11-07 22:45:55,2012-11-07 22:45:55
e6a9ad67463594894ee1fd34ef3d854e98beb8d6...0092a560f26c4499149e0aefa2268e7ed6f0c4b1,3,8,6,14,4,2012-11-09 01:26:27,2012-11-07 22:08:47
0092a560f26c4499149e0aefa2268e7ed6f0c4b1...ead2a14945a2e63c38c3a080f7c91b9efbbe4292,1,2,1,3,1,2012-11-09 19:17:59,2012-11-09 00:09:22
ead2a14945a2e63c38c3a080f7c91b9efbbe4292...ea4d04c58b5d1ecfa7c3d19966c7217f0e9e9795,2,17,0,17,2,2012-11-10 00:22:17,2012-11-10 00:22:17
ea4d04c58b5d1ecfa7c3d19966c7217f0e9e9795...a87c6580d5c206f4efbb91b268b8c9584e7737f7,1,1,0,1,1,2012-11-10 00:23:18,2012-11-09 01:43:08
a87c6580d5c206f4efbb91b268b8c9584e7737f7...4f952daba6cc10da75bb8fa9d149dd3d204de806,2,11,3,14,3,2012-11-10 01:28:47,2012-11-10 01:28:47
4f952daba6cc10da75bb8fa9d149dd3d204de806...298823686f5207010dd17c2a928c7ede5e53a475,1,2,1,3,1,2012-11-14 00:35:36,2012-11-14 00:35:36
298823686f5207010dd17c2a928c7ede5e53a475...e5769d7a2adf963ed7854a3e043bd89dd7400e17,3,6,8,14,4,2012-11-14 02:40:18,2012-11-12 19:51:24
e5769d7a2adf963ed7854a3e043bd89dd7400e17...ea3afdb35a9b5ec38af025b42fb557e0a5b94324,1,4,0,4,1,2012-11-14 21:41:57,2012-11-14 21:41:57
ea3afdb35a9b5ec38af025b42fb557e0a5b94324...54b1411b7243979a26da0c4818e06936eea66fea,1,3,0,3,3,2012-11-14 22:31:02,2012-11-14 22:31:02
54b1411b7243979a26da0c4818e06936eea66fea...3e2de505b02173e06df9e85ba35c665f0f453189,1,22,9,31,6,2012-11-15 00:29:01,2012-11-15 00:29:01
3e2de505b02173e06df9e85ba35c665f0f453189...ac4b0d687be610294aa0687f8bb68350e8f62643,2,124,9,133,10,2012-11-15 02:10:08,2012-11-03 04:01:41
ac4b0d687be610294aa0687f8bb68350e8f62643...c947cbf1b306ad1146f3260ef7e49c093e15d9d8,4,138,0,138,4,2012-11-15 02:10:08,2012-11-06 03:29:13
c947cbf1b306ad1146f3260ef7e49c093e15d9d8...f8c54c404618e8af77b50f67ea068166ebf0babe,30,1795,1227,3022,344,2012-11-15 02:10:08,2012-11-06 16:56:34
f8c54c404618e8af77b50f67ea068166ebf0babe...11fe37a0071f12b75eea82aa736db066e595b989,4,15,1,16,9,2012-11-15 02:15:25,2012-11-14 03:34:20
11fe37a0071f12b75eea82aa736db066e595b989...c7710ccd3ec7a0b2100892e5af6460af616fa886,3,182,0,182,3,2012-11-15 20:33:49,2012-11-11 01:17:41
c7710ccd3ec7a0b2100892e5af6460af616fa886...41b0c28807510d797e5b57e8155e738f81b17de1,3,247,207,454,55,2012-11-15 20:33:49,2012-11-09 00:26:58
41b0c28807510d797e5b57e8155e738f81b17de1...183653e381ff05d8ce7dee8a16c2c9eb0502ac9a,3,459,95,554,33,2012-11-15 20:47:40,2012-11-14 03:27:53
183653e381ff05d8ce7dee8a16c2c9eb0502ac9a...48a74d70a8552d7bd0019e393ede4f6b46601be8,2,65,27,92,22,2012-11-15 23:45:47,2012-11-15 23:15:30
9e341f95e892a3eda693378315631196287ffc85...3fccd63b0b6831bdcdf9073d5f84c7ff4167a6da,1,1,1,2,1,2012-08-28 22:00:09,2012-08-28 22:00:09
ffd6461e58aa6c12f52b9d307475ad7adbc5beaa...2c62b1df938bd591c0a360ef7d3a4bc6b3f3e87f,4,2509,1273,3782,674,2012-09-16 19:10:21,2012-09-14 22:07:32
2c62b1df938bd591c0a360ef7d3a4bc6b3f3e87f...6df0e5b88fcdd6cadc24dd99925b4ddc8bfe1af6,1,22,6,28,2,2012-09-17 18:47:46,2012-09-06 09:14:50
6df0e5b88fcdd6cadc24dd99925b4ddc8bfe1af6...e80066a9efabdb949ac4e7675213c35aa0a90abd,2,7,7,14,6,2012-09-17 18:47:46,2012-09-16 12:53:47
e80066a9efabdb949ac4e7675213c35aa0a90abd...3364cb7b64d50f8da0f80f972431214b903b1449,2,53,32,85,5,2012-09-17 18:47:46,2012-09-16 13:42:21
ffd6461e58aa6c12f52b9d307475ad7adbc5beaa...d78481c1ceea86b39cdafad8cc718b3d9d611f48,3,64,52,116,13,2012-09-16 09:48:20,2012-09-16 09:28:41
d78481c1ceea86b39cdafad8cc718b3d9d611f48...16777fc5e64d8b6287f0049c14aa20328f8618a4,1,21,20,41,10,2012-09-16 09:48:23,2012-09-16 09:32:57
16777fc5e64d8b6287f0049c14aa20328f8618a4...b070f5cf49440d221b97c1dd6c9d7b3520d4d074,2,13,5,18,2,2012-09-16 09:48:23,2012-09-16 09:42:01
b070f5cf49440d221b97c1dd6c9d7b3520d4d074...3094db17ff04dc8b2cb7490361d7f77b8a720355,1,5,11,16,3,2012-09-16 09:48:23,2012-09-16 09:43:09
3094db17ff04dc8b2cb7490361d7f77b8a720355...9d89feb9ab384717d73724fb9ef1517422d6d559,1,6,23,29,6,2012-09-16 09:51:22,2012-09-16 09:51:22
9d89feb9ab384717d73724fb9ef1517422d6d559...26acda1e4f31f03b9aee251132cab525cd1278a3,1,4,14,18,4,2012-09-16 09:54:02,2012-09-16 09:54:02
26acda1e4f31f03b9aee251132cab525cd1278a3...efce49331bfb032398a1352c37cee3ef9a4ae81c,1,1,0,1,1,2012-09-16 09:55:48,2012-09-16 09:55:48
efce49331bfb032398a1352c37cee3ef9a4ae81c...d07c760a0dc932cb50851d4270ca88423e370dc6,1,11,10,21,4,2012-09-16 10:09:44,2012-09-16 10:09:44
d07c760a0dc932cb50851d4270ca88423e370dc6...fb765dd5f3d573a19d9e2a3f204bd3f201c822bc,2,31,27,58,4,2012-09-16 11:07:49,2012-09-16 11:07:49
fb765dd5f3d573a19d9e2a3f204bd3f201c822bc...b11ec664e81f6d3725000ec845c2b2cd7c676365,1,25,24,49,3,2012-09-16 11:44:21,2012-09-16 11:08:01
b11ec664e81f6d3725000ec845c2b2cd7c676365...c96ee60132eb8a2e277fafb45ae984a147947568,1,5,1,6,1,2012-09-16 11:44:37,2012-09-16 11:23:19
c96ee60132eb8a2e277fafb45ae984a147947568...bb9f1fe94a010c6c73c1c284fb2d4a8842830a4b,2,36,34,70,6,2012-09-16 11:44:37,2012-09-16 11:23:38
bb9f1fe94a010c6c73c1c284fb2d4a8842830a4b...d8de162bbc5d56efd4c83167444ceadafa7c8e4a,2,2,6,8,4,2012-09-16 11:44:37,2012-09-16 11:37:20
d8de162bbc5d56efd4c83167444ceadafa7c8e4a...dcf87f1ffb7c98dacd47809812787b24c5ff854f,1,55,41,96,12,2012-09-16 12:27:48,2012-09-16 12:27:48
dcf87f1ffb7c98dacd47809812787b24c5ff854f...dcb399533fd4b13f4080f55be09517f97f59541f,1,1,1,2,1,2012-09-16 21:19:06,2012-09-16 21:19:06
d715a5ff74292b4c60a58567697e9cc819c791aa...b112cf8f924203b627c29c45bbba8faf839e062f,2,2,4,6,3,2012-09-21 04:22:34,2012-09-21 04:22:34
ee922de1c2f131b45df795da2bc08c8d47ade09e...08fecae1b9832c3d43a1a894c52d9f40dcc22dee,1,0,1,1,1,2012-09-21 18:00:33,2012-09-21 18:00:33
08fecae1b9832c3d43a1a894c52d9f40dcc22dee...cac7f14059e5e3a20361b7b560d4587f67a6d6e1,7,24,24,48,22,2012-09-21 21:14:41,2012-09-19 18:47:10
cac7f14059e5e3a20361b7b560d4587f67a6d6e1...b7974887bf3685637327da62c108693d3620a5f9,9,73,23,96,18,2012-09-21 21:14:42,2012-09-18 05:36:05
b7974887bf3685637327da62c108693d3620a5f9...3e650e786ec956de11c659d1d2ce2d0178b26f24,5,66,117,183,29,2012-09-21 21:14:42,2012-09-18 06:45:10
3e650e786ec956de11c659d1d2ce2d0178b26f24...c50cd1defa94fb8b21d036e7f26bcb9a14b800bc,2,108,4,112,4,2012-09-21 21:14:42,2012-09-20 20:39:31
c50cd1defa94fb8b21d036e7f26bcb9a14b800bc...b01cb66029bc5f83bb14421e1da3d20ee3fbb0db,34,504,126,630,81,2012-09-21 21:42:59,2012-09-18 19:21:40
b01cb66029bc5f83bb14421e1da3d20ee3fbb0db...69110dec0f90877a9294057a4572876d0dae37e0,7,98,47,145,22,2012-09-21 21:42:59,2012-09-21 05:11:11
9e540d84790e246b37f90854f03ddfd2068065f6...35df034a7d28e6d7d38628cb12d6a37d5f4e64e3,1,3,0,3,1,2012-11-20 23:14:58,2012-11-20 23:14:58
35df034a7d28e6d7d38628cb12d6a37d5f4e64e3...8d9420d25584c4c125ca596dd5faa8700c8f461a,1,4,5,9,4,2012-11-20 23:16:47,2012-11-20 23:16:47
8d9420d25584c4c125ca596dd5faa8700c8f461a...9b8eb41f0476d7355673844cd55dd6cbaea67a3a,1,20,0,20,1,2012-11-21 03:31:29,2012-11-21 03:31:29
9b8eb41f0476d7355673844cd55dd6cbaea67a3a...95f0278cb98268b3e972dbabd0b3974bc44a96dc,1,3,3,6,3,2012-11-22 03:42:10,2012-11-22 03:42:10
95f0278cb98268b3e972dbabd0b3974bc44a96dc...ad7098307dc1d50f78ba01dee3d441294878604c,1,3,3,6,2,2012-11-22 04:50:48,2012-11-22 04:50:48
ad7098307dc1d50f78ba01dee3d441294878604c...48ef995206fc86d17cc46db3d77a74c31f766bd2,1,1,1,2,1,2012-11-22 04:51:13,2012-11-22 04:51:13
9e540d84790e246b37f90854f03ddfd2068065f6...ab861b52e7857a5c532bb73c747e18082ae6091e,3,72,0,72,3,2012-11-20 22:10:50,2012-05-21 11:25:21
ab861b52e7857a5c532bb73c747e18082ae6091e...d3fdf08b93225c03bb4551a24fcba038c0aaa3db,2,358,13,371,9,2012-11-20 22:10:50,2012-06-03 03:43:00
d3fdf08b93225c03bb4551a24fcba038c0aaa3db...b4ff5cabcfaa197f9a2e959c9ab00535032d860c,1,2,0,2,2,2012-11-20 22:10:50,2012-06-04 15:00:45
b4ff5cabcfaa197f9a2e959c9ab00535032d860c...39ffdaf100906a3018d767bd77229ad1d291236c,4,515,128,643,66,2012-11-20 22:18:02,2012-11-20 22:18:02
39ffdaf100906a3018d767bd77229ad1d291236c...1dfcc0f9da5e6a9cce9dd124412adcef947c0745,1,72,89,161,5,2012-11-20 22:31:52,2012-11-20 22:31:52
682a88396195be69e5dbd5d76e8438d8d8d1c7aa...b6ac7a2a14a0348412734e1a9a7d8db83f5b09f6,1,1,1,2,1,2012-12-03 21:25:23,2012-12-03 21:25:07
b6ac7a2a14a0348412734e1a9a7d8db83f5b09f6...27113a392dd976cb47480135bb8ebbb8863b0003,2,8,3,11,3,2012-12-03 21:34:59,2012-12-03 21:34:59
27113a392dd976cb47480135bb8ebbb8863b0003...31be7d61beda1ca186f634415d6de0f8f7bce8ff,1,7,0,7,2,2012-12-03 22:53:42,2012-12-03 22:53:42
31be7d61beda1ca186f634415d6de0f8f7bce8ff...c3ffb54cc2cf6271bd08b97db08374030c2969ef,3,37,14,51,10,2012-12-04 06:10:42,2012-11-05 22:43:14
c3ffb54cc2cf6271bd08b97db08374030c2969ef...240d6e64f7852f26547a29e81fd5d481fe08b103,8,49,34,83,16,2012-12-04 06:10:43,2012-11-20 22:49:33
240d6e64f7852f26547a29e81fd5d481fe08b103...59c79edeee35f7e90a5494d25ddfa2f41e05f01c,1,13,7,20,3,2012-12-04 06:10:43,2012-12-04 03:47:14
59c79edeee35f7e90a5494d25ddfa2f41e05f01c...5efd9ff4b2a01e09336e322e96b2e9ab288db209,1,2,2,4,2,2012-12-04 06:10:43,2012-12-04 06:09:21
5efd9ff4b2a01e09336e322e96b2e9ab288db209...be5b53b157541fa57c2543720d44d123a20fb711,1,1,1,2,1,2012-12-04 06:10:43,2012-12-04 06:09:44
0f6733fe3cec72d2cba83ea4b54ac98f011e4fe4...40010607af1652fa884e5ebeeea686a52e74fbab,1,11,12,23,3,2012-10-30 02:14:22,2012-10-20 18:05:40
40010607af1652fa884e5ebeeea686a52e74fbab...2b72391ccf1a6a8978b3061e8d4fd397ce23bfab,1,3,2,5,2,2012-10-30 02:14:22,2012-10-28 16:10:48
2b72391ccf1a6a8978b3061e8d4fd397ce23bfab...cb0d7238a12b74f63c4aaf5844bcba54b62d2d72,1,12,4,16,4,2012-10-30 02:14:22,2012-10-30 02:11:13
08a0eda83e47d7ddf9aa1d83d7f1586db602b0a6...20e29d2851fb9b9fc4f2b4b8e534d0727b75e2bf,9,28,27,55,27,2012-10-05 22:26:22,2012-10-05 22:26:22
86cdbe4d71d2b73b5734fb04b6469126ed08e04e...9251edbf8d2a8e7cffdafe17f59f2469feaddb93,5,280,88,368,14,2012-10-06 21:42:59,2012-10-06 21:17:48
687407a4d3be776635d3b59242e8304d9e29abdb...c0815f5061d9c552419cb5036d4a9b2748e8514e,2,4,0,4,2,2012-09-28 02:34:36,2012-09-28 00:17:28
c0815f5061d9c552419cb5036d4a9b2748e8514e...5def0ac65ff3460015e12399fbff642a5e9321b0,2,54,8,62,6,2012-09-28 02:34:36,2012-09-26 22:35:25
5def0ac65ff3460015e12399fbff642a5e9321b0...72b327f196b705c294ba623eb859b6ca5e3dad94,4,6,50,56,7,2012-09-28 02:34:36,2012-09-26 23:55:46
72b327f196b705c294ba623eb859b6ca5e3dad94...101acac9a3818f94ed8401da0e99e18e14230b60,4,68,2,70,6,2012-09-28 02:34:36,2012-09-27 02:51:01
101acac9a3818f94ed8401da0e99e18e14230b60...d2616308361203215c122f962ae9a5c763b5ca09,5,14,6,20,3,2012-09-28 02:34:37,2012-09-27 05:31:58
d2616308361203215c122f962ae9a5c763b5ca09...c06b9ae042ae3708dd5133bcd1e60d4f442f1e9e,2,2,2,4,2,2012-10-01 21:45:06,2012-10-01 21:45:06
c06b9ae042ae3708dd5133bcd1e60d4f442f1e9e...4c31671117dca06bfeb92aef1c00d234e3d744e3,1,4,3,7,4,2012-10-01 23:39:19,2012-10-01 23:39:19
71851fef89d7f1bbaa2d6f726ed0b9811e0b6082...5fc19ef9a43bafddff36686b51876940db6ddfcc,1,12,0,12,1,2012-10-03 05:08:15,2012-10-03 05:08:15
5fc19ef9a43bafddff36686b51876940db6ddfcc...290dc70766043f2b71d964db78f09319e16a7e5e,1,1,1,2,1,2012-10-03 05:56:41,2012-10-03 05:08:30
a1a6414c1a8bf222735b604c978ad438b16c5f06...435afed69aed3876fadb0a1f53788c210f3e7210,1,235,0,235,1,2012-05-23 04:33:44,2012-05-16 19:14:44
435afed69aed3876fadb0a1f53788c210f3e7210...70b186753f0f0f81be5aa25ab23905012ca09265,1,33,371,404,42,2012-05-23 04:33:44,2012-05-16 22:28:32
70b186753f0f0f81be5aa25ab23905012ca09265...f2cf1a126d6849bc0c9853489ba4f7c756598d7b,1,323,0,323,4,2012-05-23 04:33:44,2012-05-21 22:56:13
f2cf1a126d6849bc0c9853489ba4f7c756598d7b...0c89dfa9d6089b9ed1a3ccce828d91681b46d38a,1,58,1,59,3,2012-05-23 04:33:44,2012-05-21 23:33:10
0c89dfa9d6089b9ed1a3ccce828d91681b46d38a...4b2e763cae39a862898df1e3937b96e1c51cd059,5,0,146,146,1,2012-05-23 04:33:44,2012-05-21 23:33:32
4b2e763cae39a862898df1e3937b96e1c51cd059...59977ed0e0ed29ff7dc6b64e39cb76566073d330,1,29,106,135,30,2012-05-23 04:33:44,2012-05-22 00:05:18
48a74d70a8552d7bd0019e393ede4f6b46601be8...5b35785253a453849a049f8cfbe190ffaa39f4bd,1,15,15,30,5,2012-11-16 04:44:02,2012-11-12 23:14:15
5b35785253a453849a049f8cfbe190ffaa39f4bd...eee0f744d497bf24db8578a95aa71d9753123b5c,1,1,1,2,1,2012-11-16 04:44:54,2012-11-12 23:31:40
eee0f744d497bf24db8578a95aa71d9753123b5c...34b7bdbbacb85b6ac066e965866fb54ab20c8c8b,3,1116,693,1809,294,2012-11-16 04:44:56,2012-11-12 23:34:05
34b7bdbbacb85b6ac066e965866fb54ab20c8c8b...d2b5daef2e298944a6f520a9b7f561493aaa3afa,3,515,368,883,198,2012-11-16 04:44:56,2012-11-12 23:46:06
d2b5daef2e298944a6f520a9b7f561493aaa3afa...2a68982e87e3d3f32263792b66fbd34381834177,3,6,487,493,4,2012-11-16 04:44:56,2012-11-13 00:17:35
2a68982e87e3d3f32263792b66fbd34381834177...dc62e2cef0886fb0225aed7831a507a2442459d9,2,4088,4009,8097,651,2012-11-16 04:44:56,2012-11-13 00:27:29
dc62e2cef0886fb0225aed7831a507a2442459d9...10c2a20e11873de3a95af89c7cc1326b97e98aea,2,2,2,4,2,2012-11-16 04:44:56,2012-11-13 00:35:39
10c2a20e11873de3a95af89c7cc1326b97e98aea...03bbf28dcf80c981bcf29d490e7f5451468fb193,1,5,0,5,1,2012-11-16 04:44:57,2012-11-13 01:03:11
03bbf28dcf80c981bcf29d490e7f5451468fb193...80b30a5dc214a1f7188b2827bc1bb4fe0bd26b49,1,10,4,14,4,2012-11-16 04:44:57,2012-11-15 07:16:43
80b30a5dc214a1f7188b2827bc1bb4fe0bd26b49...12c338be73ea62b05a95f6898656e02df781b3d2,2,12,13,25,6,2012-11-16 04:44:57,2012-11-16 02:20:31
12c338be73ea62b05a95f6898656e02df781b3d2...d1ce91d48ea0b424b1a8102a73efe38ad8d2dda3,2,81,29,110,28,2012-11-16 04:44:57,2012-11-16 04:18:43
3364cb7b64d50f8da0f80f972431214b903b1449...5e622215ba099ba557832b8c2efeae1a9e97aa74,40,239,223,462,171,2012-09-17 21:26:45,2012-09-15 22:20:56
301b03b7d5612441c99e310a0e6f96930f670114...6ac7b274101b80c998bd4be6e634d9a5f61926a1,2,4,4,8,4,2012-09-18 01:04:16,2012-09-18 01:04:16
69110dec0f90877a9294057a4572876d0dae37e0...1a5cd631f6845798487ea903c4391a6fcc954524,2,20,1,21,3,2012-09-24 23:03:00,2012-09-24 23:03:00
1a5cd631f6845798487ea903c4391a6fcc954524...0b2548a9466091dd553f0f45adfd40f695d6ce69,1,4,4,8,2,2012-09-24 23:07:02,2012-09-24 23:07:02
0b2548a9466091dd553f0f45adfd40f695d6ce69...55e291e671108114b717f2e02d707d207b1e1d4c,8,165,0,165,8,2012-09-25 02:57:06,2012-09-25 02:56:16
55e291e671108114b717f2e02d707d207b1e1d4c...6da48338852d5c7899b5b3433cf3c0fc280d8f9a,2,13,13,26,3,2012-09-27 18:19:10,2012-09-27 18:19:10
6d1c0a7c934ef702cc7e8a68adb20e3fbafdad04...7f89f059e520a2019e42334b1bc5d4b1169fba4e,1,135,1,136,2,2012-11-28 18:48:16,2012-11-16 13:16:24
7f89f059e520a2019e42334b1bc5d4b1169fba4e...f080fb20e4292854e2e8f47a466cb3730002eab7,1,89,1,90,4,2012-11-28 18:48:16,2012-11-16 14:32:14
f080fb20e4292854e2e8f47a466cb3730002eab7...129154695455282a2013ed33c64a0785c7c491db,1,14,1,15,4,2012-11-28 18:48:17,2012-11-16 15:11:23
129154695455282a2013ed33c64a0785c7c491db...eca9d705ae80d2a69cc7ca1acc505ef59f23d1e3,2,25,6,31,6,2012-11-28 18:48:17,2012-11-16 16:25:32
eca9d705ae80d2a69cc7ca1acc505ef59f23d1e3...4acd2551e4afb1c91ae9d384511ca1608b9a6428,1,12,18,30,7,2012-11-28 18:53:32,2012-11-28 18:53:32
4acd2551e4afb1c91ae9d384511ca1608b9a6428...add592a32efbac5cccd787497876a63f77708a91,1,7,0,7,1,2012-11-28 19:01:30,2012-11-28 19:01:30
add592a32efbac5cccd787497876a63f77708a91...401c0cfa2178786f97a74d6a25bfcc227888b3b7,1,5,1,6,1,2012-11-28 21:22:29,2012-11-28 21:22:29
401c0cfa2178786f97a74d6a25bfcc227888b3b7...3a3126568a83db593f19891feabdf898e7a6471b,2,6,6,12,5,2012-11-28 21:27:20,2012-11-28 21:27:20
3a3126568a83db593f19891feabdf898e7a6471b...6ccd7b4bb1116b91dc16b4a18cc40caeb5b01c80,1,10,3,13,2,2012-11-29 02:30:04,2012-11-29 02:22:32
6ccd7b4bb1116b91dc16b4a18cc40caeb5b01c80...1cbfe4e361465de8a69868913ee9424963dca6f7,1,1,2,3,2,2012-11-29 02:39:25,2012-11-29 02:39:25
1cbfe4e361465de8a69868913ee9424963dca6f7...8ee9959a8eec85f8bcba5073ab0df57b61896644,1,1,1,2,1,2012-11-30 00:19:03,2012-11-30 00:19:03
8ee9959a8eec85f8bcba5073ab0df57b61896644...a4db69aca2a2da467b522bef142dc1ad0f468f84,1,1,1,2,1,2012-11-30 00:24:14,2012-11-30 00:24:14
48ef995206fc86d17cc46db3d77a74c31f766bd2...44b4c9ed6178b0a81164807ef3bb2377b947033e,2,25,5,30,6,2012-11-23 00:54:07,2012-11-23 00:41:56
44b4c9ed6178b0a81164807ef3bb2377b947033e...ae492fc7932e75097252275dce42ed7ed9e742a7,2,9,2,11,3,2012-11-23 00:54:07,2012-11-23 00:53:13
48ef995206fc86d17cc46db3d77a74c31f766bd2...30230c00e150762054f437d68e55cf6aa04e828b,1,24,0,24,3,2012-11-22 04:53:03,2012-11-22 04:53:03
be5b53b157541fa57c2543720d44d123a20fb711...362f0eb075c4d932a0cd3f4419f2929e7521c799,2,98,10,108,9,2012-12-04 22:47:40,2012-11-28 01:45:40
362f0eb075c4d932a0cd3f4419f2929e7521c799...723154e47241f22ba0d88e1f92121326d7dce6fa,4,189,59,248,23,2012-12-04 22:47:40,2012-11-26 19:19:27
723154e47241f22ba0d88e1f92121326d7dce6fa...442b86eebd25d2aa4fd6b61849780a6f069845e6,4,107,11,118,9,2012-12-04 22:47:40,2012-11-28 18:34:17
442b86eebd25d2aa4fd6b61849780a6f069845e6...77f926639ba6324097c84281ebcd78c2a5195c92,1,2,2,4,1,2012-12-04 22:47:40,2012-12-04 22:24:52
77f926639ba6324097c84281ebcd78c2a5195c92...c941363d64131c55e9dcd5668312abb2f6d68095,1,1,1,2,1,2012-12-04 22:47:40,2012-12-04 22:45:27
c941363d64131c55e9dcd5668312abb2f6d68095...b4fae6212bd5ed94b360f4488133c238d5480de5,2,19,19,38,16,2012-12-05 01:21:16,2012-12-05 01:21:16
dcdc8c020de87b8fb140744ddb0181aed1bd7c9a...8f83b2c32e5e0b8fe1d89e26983799b8517cdc41,23,135,121,256,98,2012-10-30 22:53:49,2012-10-30 14:59:49
8f83b2c32e5e0b8fe1d89e26983799b8517cdc41...ef7d5f6b801e27b4a7279d7e02fb716c4dda68f3,1,1,1,2,1,2012-10-30 23:00:44,2012-10-30 23:00:44
9251edbf8d2a8e7cffdafe17f59f2469feaddb93...f244f98f0e6c598dc1a3bef0892eb16805e4ea9a,4,6109,1,6110,5,2012-10-08 16:41:59,2012-10-08 16:27:47
f244f98f0e6c598dc1a3bef0892eb16805e4ea9a...2fdadceb36ee350335739d40962d36153d48870e,1,2,1,3,1,2012-10-08 17:18:04,2012-10-08 17:18:04
2fdadceb36ee350335739d40962d36153d48870e...d38df9958d44de321635e8530b16d95697edb63c,1,4,4,8,1,2012-10-08 21:20:46,2012-10-08 21:20:46
d38df9958d44de321635e8530b16d95697edb63c...5da14c9d8985f2d3efbb638bec950a96bdcc3eb8,2,3,1,4,2,2012-10-08 21:21:51,2012-10-08 21:21:51
5da14c9d8985f2d3efbb638bec950a96bdcc3eb8...5081247082885bb49889483cffade76885524446,7,73,33,106,22,2012-10-08 22:37:15,2012-10-08 22:37:15
5081247082885bb49889483cffade76885524446...ea2d2bbd216b7af1dc6cfd59c725fbbd56c0abf0,2,1,4,5,3,2012-10-09 16:41:01,2012-10-09 16:41:01
ea2d2bbd216b7af1dc6cfd59c725fbbd56c0abf0...099afb821d6d5f69eca3b222a26548baa1ae0995,3,23,19,42,13,2012-10-09 16:52:24,2012-10-09 16:52:24
41cc24d9e7842b0f05f60d9c08a2e8fffd4ed37d...c27cd57c288f4052302ee0ac3935da0c47fb114f,1,3,7,10,3,2012-10-06 18:20:24,2012-10-06 18:20:24
c27cd57c288f4052302ee0ac3935da0c47fb114f...204a675104645947c7b5e65b50be1b61551811aa,1,5,11,16,3,2012-10-06 18:30:48,2012-10-06 18:30:48
204a675104645947c7b5e65b50be1b61551811aa...8b160a1c8d0c3ce4b0a3bc6d59e94611acb1d826,1,1,1,2,1,2012-10-07 11:06:27,2012-10-07 11:06:14
8b160a1c8d0c3ce4b0a3bc6d59e94611acb1d826...5a01d9fe4d0869f388e651f48a9e51913950ca38,7,42,42,84,24,2012-10-08 16:17:54,2012-10-05 18:49:55
5a01d9fe4d0869f388e651f48a9e51913950ca38...c80c5b867471f5b5ed30e8966e162d80b6cacc98,2,4,3,7,4,2012-10-08 16:18:55,2012-10-05 18:57:32
c80c5b867471f5b5ed30e8966e162d80b6cacc98...7b758a0c9bc6a9c001cdea34ab87f7000731aef6,13,84,103,187,27,2012-10-08 16:18:55,2012-10-06 01:57:29
7b758a0c9bc6a9c001cdea34ab87f7000731aef6...779c2a50361a858b2e0824ad656bd991198a9a61,4,19,25,44,17,2012-10-08 16:18:55,2012-10-06 02:09:50
779c2a50361a858b2e0824ad656bd991198a9a61...f13c9d18fce224bba6ea7340243fce7b1b2c42a3,3,43,45,88,31,2012-10-08 16:18:55,2012-10-07 05:23:20
f13c9d18fce224bba6ea7340243fce7b1b2c42a3...1816a1ba74a780f21d272a1f9fb17e618b52a993,1,4,0,4,2,2012-10-08 17:42:39,2012-10-08 17:42:31
1816a1ba74a780f21d272a1f9fb17e618b52a993...147ef71195bceac78a81d17bf9a89b246eafaa85,22,1143,1061,2204,78,2012-10-09 02:38:20,2012-10-08 20:26:50
147ef71195bceac78a81d17bf9a89b246eafaa85...46fbe872d244b6ffe0f3dafa8be7e691b6b37eb3,1,2,1,3,1,2012-10-09 02:38:20,2012-10-09 00:46:18
46fbe872d244b6ffe0f3dafa8be7e691b6b37eb3...3c3540497c4a28148ec5cd1bcefe8257fd86fb1c,2,15,0,15,2,2012-10-09 02:38:20,2012-10-09 01:32:36
3c3540497c4a28148ec5cd1bcefe8257fd86fb1c...37201062e1233ee6cb4627016303e40d1ad3fa4a,2,8,4,12,3,2012-10-09 03:53:49,2012-10-09 03:53:30
37201062e1233ee6cb4627016303e40d1ad3fa4a...3b41434e23a994e1ce857a529decae23fa838ed1,8,18,26,44,17,2012-10-09 04:41:14,2012-10-09 04:41:14
290dc70766043f2b71d964db78f09319e16a7e5e...6cdab77381324519b40be0aff846565e21f8e547,2,269,115,384,70,2012-10-03 05:56:41,2012-10-02 06:17:57
6cdab77381324519b40be0aff846565e21f8e547...9fe341e3710385427089aa557a112376d76db2f5,1,169,158,327,4,2012-10-03 05:56:41,2012-10-03 00:18:20
9fe341e3710385427089aa557a112376d76db2f5...e5bf91fc24c37b0e716f3b7c36a65f9db5ba81f7,2,58,33,91,12,2012-10-03 05:56:42,2012-10-03 00:21:17
e5bf91fc24c37b0e716f3b7c36a65f9db5ba81f7...d759f93e5754d27a9cfe5b6b86f4a71e6b850165,1,33,47,80,11,2012-10-03 05:56:42,2012-10-03 00:39:19
d759f93e5754d27a9cfe5b6b86f4a71e6b850165...b2801f4c028779705978eb999e038ff1c53d8020,5,55,19,74,13,2012-10-03 06:17:53,2012-10-03 03:04:37
b2801f4c028779705978eb999e038ff1c53d8020...0b1c7d10b0793198b38b51f17faf775bfe3bdf42,3,7,10,17,6,2012-10-03 06:17:53,2012-10-03 04:31:45
5a70d0d6e35239c50dafaada319e3c2dee7dad1c...aebb9a21aa7e5e260249bdefe6b0609c2e0d6e89,1,22,1,23,2,2012-05-23 19:59:47,2012-05-23 19:59:47
aebb9a21aa7e5e260249bdefe6b0609c2e0d6e89...57b13fd1741485bda139818e5f3f69bc17cfb4f8,2,105,37,142,17,2012-05-23 21:41:22,2012-05-23 21:02:00
57b13fd1741485bda139818e5f3f69bc17cfb4f8...8991c8bb251e4dcfacb215bd43e701dc0b24acac,1,2,0,2,2,2012-05-25 02:40:27,2012-05-25 02:40:27
8991c8bb251e4dcfacb215bd43e701dc0b24acac...0815cc11e9dda448bb0ca41a9cc63b7f42f248a3,1,0,6,6,1,2012-05-25 03:07:49,2012-05-25 03:07:38
0815cc11e9dda448bb0ca41a9cc63b7f42f248a3...a1ec3937fc652b933cffd459f2328d9322e405f3,1,8,2,10,3,2012-05-25 03:42:15,2012-05-25 03:42:15
a1ec3937fc652b933cffd459f2328d9322e405f3...86e3eacaed050243deaa10dde4cfb93c86fbf0de,1,9,5,14,2,2012-05-25 18:51:04,2012-05-25 18:00:47
26ce169c882ef0d96186b8c72698c395201df90f...42fa76ccc15db212268f0dce15e3f671f4c992db,7,321,0,321,7,2012-11-16 06:56:59,2012-10-31 06:26:16
42fa76ccc15db212268f0dce15e3f671f4c992db...0619101839210ead7c2ec61cf99fb38da25fa611,1,4,2,6,1,2012-11-16 07:09:21,2012-11-16 07:09:21
5e622215ba099ba557832b8c2efeae1a9e97aa74...efd5560b0f0dee496bc7f2d6a0f3d3ef8ba4518a,2,80,34,114,12,2012-09-17 21:42:27,2012-09-17 21:30:55
efd5560b0f0dee496bc7f2d6a0f3d3ef8ba4518a...f1a932c1df58efa480dedd9bc85d289953a651ea,1,6,0,6,1,2012-09-17 21:42:27,2012-09-17 21:31:31
f1a932c1df58efa480dedd9bc85d289953a651ea...d50654bbee25f8d94729548e87032936baf92cd9,1,12,12,24,12,2012-09-17 21:42:28,2012-09-17 21:31:40
d50654bbee25f8d94729548e87032936baf92cd9...660882eb4e48e0ce1346982c78f8b451d158057d,3,3,1,4,3,2012-09-17 21:42:28,2012-09-17 21:35:01
660882eb4e48e0ce1346982c78f8b451d158057d...ce4e415bb7f495171c428598c35685f5e775ff3e,3,9,6,15,4,2012-09-17 21:42:28,2012-09-17 21:42:14
5154eafce19eb01c50f1a2aa6244a945bcf7ad09...071b86900a1a917ac6e93451fa7c92691d6873cb,1,0,2,2,1,2013-01-08 06:14:04,2013-01-08 06:14:04
a4db69aca2a2da467b522bef142dc1ad0f468f84...3262492f8d99eda1a0aa20ad379cf5c02a93ba0a,1,1,1,2,1,2012-11-30 00:26:01,2012-11-30 00:26:01
3262492f8d99eda1a0aa20ad379cf5c02a93ba0a...c09aaa7908c2b61db1316e8cdb2f7c3f411d2856,2,2,2,4,2,2012-11-30 00:26:25,2012-11-30 00:26:25
ae492fc7932e75097252275dce42ed7ed9e742a7...2d04e07b7abeb7ea24cce91bb7fb2fd2984e61bb,1,1,1,2,1,2012-11-23 16:03:31,2012-11-23 16:03:31
2d04e07b7abeb7ea24cce91bb7fb2fd2984e61bb...d073e5ddfccf8bd22fc3c248de76dcfafb34664a,1,13,4,17,5,2012-11-24 00:49:23,2012-11-24 00:49:23
d073e5ddfccf8bd22fc3c248de76dcfafb34664a...965d96615a1170c3235f944eecb2293e29afad24,1,2,1,3,2,2012-11-24 21:42:23,2012-11-24 21:36:55
965d96615a1170c3235f944eecb2293e29afad24...87ef7b692a5aa3ea379c584bd9878475a465627f,1,1,1,2,1,2012-11-26 01:25:31,2012-11-26 01:25:31
87ef7b692a5aa3ea379c584bd9878475a465627f...e8826efb1ec25eb1724e624ce0c209b7908f57b4,2,50,6,56,6,2012-11-26 20:14:51,2012-11-26 20:14:08
b4fae6212bd5ed94b360f4488133c238d5480de5...ab0eb2c090576bbe47ac36a7388f8dc13c69d928,1,10,0,10,1,2012-12-06 03:45:01,2012-12-06 03:45:01
ab0eb2c090576bbe47ac36a7388f8dc13c69d928...6902c2a2caa40fd7330da93f71b545d561fb8346,1,1,1,2,1,2012-12-06 03:46:49,2012-12-06 03:46:49
6902c2a2caa40fd7330da93f71b545d561fb8346...103757bb8928f1d8ffba3043ad80440ea42a73cb,1,4,3,7,2,2012-12-06 03:49:35,2012-12-06 03:49:35
103757bb8928f1d8ffba3043ad80440ea42a73cb...cdbfb84759940b7a7c74f9a3e0f77065f1a45072,2,3,2,5,3,2012-12-06 03:51:56,2012-12-06 03:43:56
cdbfb84759940b7a7c74f9a3e0f77065f1a45072...3f8f9465a4ac7f3ce65d2193ea3aaa01ccf9cbd5,1,6,4,10,1,2012-12-06 05:56:57,2012-12-06 05:56:57
3f8f9465a4ac7f3ce65d2193ea3aaa01ccf9cbd5...f40d60c093ebf263956a0a93e3a5eb70cc4eee63,1,0,1,1,1,2012-12-06 19:53:37,2012-12-06 19:53:37
634fb11f9a7b1ee7361cc7db92664efb68920c1e...cf1e7fa669020ba87c8986dafbedc139dc0af359,6,5,5,10,2,2012-10-31 19:07:06,2012-10-31 19:07:06
2b18b89dadcb17cd1f70839b4ce3ec2273d360c4...da46549d149b3203f52cfd835f350463eb2e2673,3,6,2,8,3,2012-10-10 07:19:25,2012-10-10 07:19:25
da46549d149b3203f52cfd835f350463eb2e2673...d1e3e2475a6bcd1836b02258902dacc6459a455c,1,1,1,2,1,2012-10-10 07:25:50,2012-10-10 07:25:26
e733b17d6a6f3af4b4819c3700d593ea925a7ed5...d4e4a6300a7fd94ca2c1f1bf9c2f5c43951875b6,7,192,122,314,46,2012-10-09 04:59:14,2012-10-07 07:10:36
d4e4a6300a7fd94ca2c1f1bf9c2f5c43951875b6...1333b9308aefebb187a2b1bd4c04195fe765d644,5,75,57,132,27,2012-10-09 05:29:28,2012-10-07 11:05:03
1333b9308aefebb187a2b1bd4c04195fe765d644...e8e880566ea7fb255d4b658f893ef0c3243df393,1,6,0,6,1,2012-10-09 05:29:28,2012-10-08 18:09:16
e8e880566ea7fb255d4b658f893ef0c3243df393...8d21e2c5b7c1ff318d0cdccd79a12f80859771e1,3,35,34,69,11,2012-10-09 05:29:28,2012-10-08 18:57:13
8d21e2c5b7c1ff318d0cdccd79a12f80859771e1...c394f9a54435584449d68b8b2965075f6ec777fd,1,3,3,6,3,2012-10-09 05:29:28,2012-10-09 03:58:27
c394f9a54435584449d68b8b2965075f6ec777fd...ef70084e83b5fc04e9e6d4003bb43450f1cb64e7,1,11,7,18,6,2012-10-09 05:29:28,2012-10-09 05:20:09
ef70084e83b5fc04e9e6d4003bb43450f1cb64e7...139b611b8b0545a48324ee5dfd86c501f379fc55,2,3,3,6,2,2012-10-09 05:56:12,2012-10-09 05:56:12
139b611b8b0545a48324ee5dfd86c501f379fc55...2caff12c36fb4f8b723c12c1daec3d13a710cf88,3,15,3,18,6,2012-10-09 06:08:53,2012-10-09 06:08:53
2caff12c36fb4f8b723c12c1daec3d13a710cf88...200089e1b6dd2d77d62c288fcfadd891185d8d3a,1,2,0,2,1,2012-10-09 06:30:14,2012-10-09 06:30:14
200089e1b6dd2d77d62c288fcfadd891185d8d3a...38fb1dfd01033359d09e117d38dd178c197b4878,3,78,21,99,14,2012-10-09 06:39:48,2012-10-09 06:18:39
38fb1dfd01033359d09e117d38dd178c197b4878...ae46f89bc208df80793d0b82ef96c1a886b3314c,1,1,1,2,1,2012-10-09 14:41:17,2012-10-09 14:41:17
ae46f89bc208df80793d0b82ef96c1a886b3314c...dffed84155838879c323855e6c04323762c206ff,3,51,2,53,4,2012-10-09 18:18:03,2012-10-09 18:18:03
dffed84155838879c323855e6c04323762c206ff...9e09d64831ec40eb937cbd81da2d0284e933e3ab,8,93,93,186,90,2012-10-09 19:00:25,2012-10-09 19:00:25
9e09d64831ec40eb937cbd81da2d0284e933e3ab...cd55add975db994af2d46e8e9c3eab2c5885b18c,1,4,4,8,2,2012-10-09 23:05:12,2012-10-09 23:05:12
cd55add975db994af2d46e8e9c3eab2c5885b18c...649b4f5154549310ea1b203ee2ec251c31c504d3,1,25,0,25,1,2012-10-09 23:05:56,2012-10-09 23:05:56
649b4f5154549310ea1b203ee2ec251c31c504d3...fbdf164251bf3cf6a8c34e1b96f74f12a38fe297,16,91,97,188,68,2012-10-09 23:12:45,2012-10-09 22:21:54
fbdf164251bf3cf6a8c34e1b96f74f12a38fe297...205a491b5d513a8c21625edae7fcfa4959c5d9d7,1,5,21,26,1,2012-10-09 23:26:10,2012-10-09 23:24:46
205a491b5d513a8c21625edae7fcfa4959c5d9d7...ff359a73c67557f41bc14564bb734c2c80bc6446,3,41,3,44,6,2012-10-10 00:02:01,2012-10-10 00:01:12
ff359a73c67557f41bc14564bb734c2c80bc6446...a61b24bd1cdb827981cf0f204b138828dcb8df86,1,27,0,27,3,2012-10-10 00:23:51,2012-10-10 00:23:27
a61b24bd1cdb827981cf0f204b138828dcb8df86...78779f3ca401659a508259161280e2398cb87b13,7,46,30,76,22,2012-10-10 01:52:15,2012-10-10 01:51:26
78779f3ca401659a508259161280e2398cb87b13...dd77a26acc039c314dab16b83d82728600568de6,16,24,24,48,20,2012-10-10 02:18:02,2012-10-10 02:18:02
dd77a26acc039c314dab16b83d82728600568de6...14f975ea30a704ae9f23b3c0befa02c235b126f5,6,94,37,131,27,2012-10-10 03:02:52,2012-10-09 09:44:44
14f975ea30a704ae9f23b3c0befa02c235b126f5...accd41bddf388e68c9ba166383333ffc43b5849f,6,29,28,57,9,2012-10-10 03:04:19,2012-10-09 08:56:10
accd41bddf388e68c9ba166383333ffc43b5849f...7d368a3f6ed27f5664c3703c4f204fba5f90140b,2,26,5,31,5,2012-10-10 03:04:19,2012-10-09 22:35:54
7d368a3f6ed27f5664c3703c4f204fba5f90140b...df622401b46614397b8ddc4611d4d59c88396281,7,37,35,72,26,2012-10-10 03:11:15,2012-10-10 03:11:15
df622401b46614397b8ddc4611d4d59c88396281...cbf06a5679ee52eabacc7d36a3c5d1a7ffd94677,3,3,3,6,3,2012-10-10 03:13:59,2012-10-10 03:13:59
cbf06a5679ee52eabacc7d36a3c5d1a7ffd94677...c5044e57cd464765baa87489fba29b4485145319,1,8,1,9,1,2012-10-10 03:18:19,2012-10-10 03:18:19
c5044e57cd464765baa87489fba29b4485145319...4cc5be00c002fb77115a558e1669115fe1f2dfc9,2,16,2,18,2,2012-10-10 03:23:39,2012-10-10 03:23:39
4cc5be00c002fb77115a558e1669115fe1f2dfc9...b5aa098c899a74c72653ecab87f6b4375e75e449,1,0,4,4,2,2012-10-10 03:25:29,2012-10-10 03:25:29
b5aa098c899a74c72653ecab87f6b4375e75e449...168be9f059f7e4d39d8cf035a5492e06763d6df5,1,1,1,2,1,2012-10-10 04:14:47,2012-10-10 04:14:47
168be9f059f7e4d39d8cf035a5492e06763d6df5...7757cc0659ed08fd3471dc48d0f43c2277f561e1,2,10,3,13,5,2012-10-10 04:52:52,2012-10-10 04:52:52
7757cc0659ed08fd3471dc48d0f43c2277f561e1...a6e71dcde689e090258ad983dd82718577c88082,2,10,5,15,4,2012-10-10 05:14:03,2012-10-10 05:14:03
a6e71dcde689e090258ad983dd82718577c88082...002768d72a19973366c34ff857bef0133c8aad37,1,19,7,26,2,2012-10-10 05:28:31,2012-10-10 05:28:31
002768d72a19973366c34ff857bef0133c8aad37...1311f9d8cc5c1aacf4d0cb0f0907f46a09c52157,1,1,1,2,1,2012-10-10 05:44:24,2012-10-10 05:04:45
1311f9d8cc5c1aacf4d0cb0f0907f46a09c52157...5c8c22c9c72bfe351d6f0b8a3af1599ee813be6d,2,65,38,103,11,2012-10-10 05:44:25,2012-10-10 03:43:39
5c8c22c9c72bfe351d6f0b8a3af1599ee813be6d...5fd3c7ce71bcd7323edfa6ba545fb366d8a410af,15,85,85,170,66,2012-10-10 05:44:25,2012-10-10 05:05:19
5fd3c7ce71bcd7323edfa6ba545fb366d8a410af...bbf9ae0c2b5bdbe22bc6f4719bb1f1ab4ffd5ada,1,9,42,51,9,2012-10-10 06:12:16,2012-10-10 05:49:57
bbf9ae0c2b5bdbe22bc6f4719bb1f1ab4ffd5ada...9b9d07d773b9ccef5eb7c05897d5a10a98f535a1,7,72,25,97,10,2012-10-10 06:12:16,2012-10-09 22:36:41
9b9d07d773b9ccef5eb7c05897d5a10a98f535a1...e38cefbc0466167e4bf5a19010f8ba1a1e4aca62,1,1,0,1,1,2012-10-10 06:26:27,2012-10-10 06:26:27
e38cefbc0466167e4bf5a19010f8ba1a1e4aca62...0f50a1ea9b4e2dcb5c770d2e4fcca91961c4935c,1,1,1,2,1,2012-10-10 06:52:34,2012-10-10 06:52:19
4003a6f9e993996e87511a37c7a6cd3de11272b4...1eceed28f9e866a23decf5c76ba25889ef90aa6a,39,315,315,630,247,2012-10-03 06:18:57,2012-10-01 20:44:14
1eceed28f9e866a23decf5c76ba25889ef90aa6a...75c69301c0e61df2e8f47190a6a6615a26e0cce1,3,3,4,7,4,2012-10-03 06:18:57,2012-10-01 20:53:42
75c69301c0e61df2e8f47190a6a6615a26e0cce1...9392fbb51dddbbc96c6000e31f94535541eb6bf9,5,21,21,42,19,2012-10-03 06:18:57,2012-10-01 22:44:14
9392fbb51dddbbc96c6000e31f94535541eb6bf9...0e5b8083b5ffd11bec06494eb8068d174d954451,2,3,3,6,3,2012-10-03 06:18:57,2012-10-01 22:49:39
0e5b8083b5ffd11bec06494eb8068d174d954451...7cbd9fd243824d377958897dc04221789f459901,6,14,14,28,12,2012-10-03 06:18:57,2012-10-01 22:54:55
7cbd9fd243824d377958897dc04221789f459901...3d791cce6bb5dc51b9249c4258e1d349d668778a,3,3,3,6,3,2012-10-03 06:18:58,2012-10-01 22:57:15
3d791cce6bb5dc51b9249c4258e1d349d668778a...dd640729ff8d9ec3548c6e693c656b11ead89c14,3,5,5,10,5,2012-10-03 06:18:58,2012-10-01 23:12:59
dd640729ff8d9ec3548c6e693c656b11ead89c14...ccb79ff0d9df92a494dd97850d20949774f466d9,3,5,5,10,5,2012-10-03 06:18:58,2012-10-01 23:20:57
ccb79ff0d9df92a494dd97850d20949774f466d9...12934c96a99bc64bdaa57b6b5a0bb9548413d617,6,1,26,27,7,2012-10-03 06:18:58,2012-10-03 05:15:54
86e3eacaed050243deaa10dde4cfb93c86fbf0de...561496ba64b5558c47fc4dbe3b29b762617f2b22,2,107,79,186,7,2012-05-25 23:07:14,2012-05-23 17:18:12
561496ba64b5558c47fc4dbe3b29b762617f2b22...7aacb4e5e8a91cb844f15d7ed354bb5098284436,1,11,2,13,4,2012-05-25 23:07:14,2012-05-23 17:37:19
7aacb4e5e8a91cb844f15d7ed354bb5098284436...a3b86b1c5ef5e3d6ea0f1423201a76ea902473fc,1,1,1,2,1,2012-05-25 23:07:14,2012-05-23 17:38:41
a3b86b1c5ef5e3d6ea0f1423201a76ea902473fc...9ce0a6d572c7cd41758cef3401be066fc796ed90,4,145,4,149,6,2012-05-25 23:08:41,2012-05-23 18:30:39
9ce0a6d572c7cd41758cef3401be066fc796ed90...06b1be40524baf71ea9bec5733aa9c448f3c5598,1,7,0,7,1,2012-05-25 23:08:48,2012-05-23 21:54:25
06b1be40524baf71ea9bec5733aa9c448f3c5598...59cb217a5679e79f9c8bcf97f7af62b012c0cff9,2,94,24,118,25,2012-05-25 23:08:52,2012-05-25 21:51:17
0619101839210ead7c2ec61cf99fb38da25fa611...1852834ef7915e2f95411a75aa60dc65643133b3,1,1,2,3,1,2012-11-16 07:53:45,2012-11-16 07:53:45
1852834ef7915e2f95411a75aa60dc65643133b3...0af26570c3c5c313550d14161d62093134b09326,10,122,34,156,36,2012-11-17 01:24:45,2012-11-15 04:41:12
0af26570c3c5c313550d14161d62093134b09326...637692db31e6537304eb814e6d5e5457dd74daca,1,22,0,22,1,2012-11-18 01:46:57,2012-11-18 01:46:57
637692db31e6537304eb814e6d5e5457dd74daca...5b066c77a0b2922320e6ce26b9e14491f8f440fe,1,0,1,1,1,2012-11-18 01:53:00,2012-11-18 01:53:00
5b066c77a0b2922320e6ce26b9e14491f8f440fe...1da3ef978a73ade7900876f0d8b7e95766ba8478,1,22,5,27,4,2012-11-20 03:34:26,2012-11-20 03:34:26
1da3ef978a73ade7900876f0d8b7e95766ba8478...974f0be4a47aff38410e266deaf62ddda12b8e17,1,5,0,5,1,2012-11-20 04:01:48,2012-11-20 03:57:57
974f0be4a47aff38410e266deaf62ddda12b8e17...dcdd6da47fd2d093ba585e667bb3473c02b27bfb,1,2,0,2,1,2012-11-20 04:28:41,2012-11-20 04:28:41
dcdd6da47fd2d093ba585e667bb3473c02b27bfb...f4573dbb1b68accf345c0badada7f83cba00dba3,1,11,0,11,1,2012-11-20 04:34:48,2012-11-20 04:34:48
0619101839210ead7c2ec61cf99fb38da25fa611...83386b23d9820270e3fc5e13629263b9f1c456ce,9,15,10,25,9,2012-11-16 07:14:19,2012-11-16 07:14:19
83386b23d9820270e3fc5e13629263b9f1c456ce...56f66e8c277eb951630a7d5598f94e5c0bd9bbfa,1,56,1,57,2,2012-11-16 08:16:38,2012-11-16 08:16:38
56f66e8c277eb951630a7d5598f94e5c0bd9bbfa...3f17883ed161aefd2104745321fa4d0cca87d686,1,72,48,120,1,2012-11-16 19:21:42,2012-11-16 19:21:42
3f17883ed161aefd2104745321fa4d0cca87d686...6c19b05d05f0df4167ccb78c9419a7146eb578eb,1,7,5,12,2,2012-11-16 20:17:31,2012-11-16 20:17:31
6c19b05d05f0df4167ccb78c9419a7146eb578eb...e93e35ce08c7246d1d3fab6becb0c4bd22f7979e,2,18,18,36,6,2012-11-17 00:57:16,2012-11-17 00:57:16
e93e35ce08c7246d1d3fab6becb0c4bd22f7979e...646b3576cd140c2ebd6cc005eec6b69600d3f0bd,10,122,34,156,36,2012-11-17 01:25:52,2012-11-15 04:41:12
646b3576cd140c2ebd6cc005eec6b69600d3f0bd...1eec537e12ad93e28240578c74929409f7154fa0,1,50,51,101,9,2012-11-17 03:26:15,2012-11-17 02:04:31
1eec537e12ad93e28240578c74929409f7154fa0...c1c1fd9b8fa846f6fa72f26e2d8032c9720ce414,2,83,9,92,3,2012-11-17 05:07:51,2012-11-17 05:07:51
c1c1fd9b8fa846f6fa72f26e2d8032c9720ce414...5a668893f5c67ca643c328c44569400db0ebbb39,2,8,6,14,5,2012-11-19 21:06:00,2012-11-19 21:06:00
5a668893f5c67ca643c328c44569400db0ebbb39...46c14a74052da02494d386216b1c768316c30826,1,12,6,18,7,2012-11-19 22:18:04,2012-11-19 22:18:04
46c14a74052da02494d386216b1c768316c30826...49758b50d7f3cac962352aac1d37ba88817c038c,1,1,1,2,1,2012-11-19 22:18:26,2012-11-19 22:18:26
49758b50d7f3cac962352aac1d37ba88817c038c...3b97c9199f734eabcd1f492efdd48d0578b0bfa4,1,3,6,9,3,2012-11-19 22:49:45,2012-11-19 22:49:45
3b97c9199f734eabcd1f492efdd48d0578b0bfa4...738e8f43faeec797dddce2fcd73a1f22cdb2351f,2,16,5,21,5,2012-11-20 00:42:17,2012-11-20 00:42:17
738e8f43faeec797dddce2fcd73a1f22cdb2351f...59bab69fcc0b284a291f35de610b7c3afb07517d,1,22,5,27,4,2012-11-20 03:34:42,2012-11-20 03:34:26
59bab69fcc0b284a291f35de610b7c3afb07517d...7cc88dc75e4d3196166c6edd83661b33a8fe86ec,1,2,0,2,1,2012-11-20 04:29:02,2012-11-20 04:28:41
7cc88dc75e4d3196166c6edd83661b33a8fe86ec...426a72fe24e2bd2ac04ce9cd31844a5ce67437e5,1,10,3,13,4,2012-11-20 04:33:39,2012-11-20 04:33:08
426a72fe24e2bd2ac04ce9cd31844a5ce67437e5...ba76b0fd6da3df16c5acdbf7f4478e150d9e5b02,1,4,2,6,1,2012-11-20 05:08:41,2012-11-20 05:08:41
ce4e415bb7f495171c428598c35685f5e775ff3e...374dd8f39bf24dd459f43041c54675af864bac6f,1,5,0,5,1,2012-09-17 22:03:06,2012-09-17 22:03:06
92b0036cf11b3a8371bbcbd9fcf5ce1a261520f6...36f55a55b6531577bdfcdd630b7bac798b39fd0c,2,39,9,48,13,2012-10-05 08:08:03,2012-10-05 07:51:19
36f55a55b6531577bdfcdd630b7bac798b39fd0c...a49685a1ec9bf32ae3cadffa832b80b1115d494f,1,1,1,2,1,2012-10-05 08:12:55,2012-10-05 08:12:55
a49685a1ec9bf32ae3cadffa832b80b1115d494f...750629c7181ebf779a1c65b86dd1458442eb9538,2,44,30,74,18,2012-10-05 18:17:12,2012-10-05 18:17:12
3753c989fd6c26406409b4b27f86ac9331e38346...1535fe3437de5f33923a0d0d617dc4054f2d9071,9,19,10,29,9,2013-02-15 00:49:06,2013-02-15 00:49:06
1535fe3437de5f33923a0d0d617dc4054f2d9071...ec852121ffbced2629e818bb5d0ccc22afe55169,2,170,17,187,17,2013-02-15 00:49:39,2013-02-14 23:18:31
ec852121ffbced2629e818bb5d0ccc22afe55169...aaa86c3e2d226ca93a1dd54b8bde1a827b7dd28f,1,24,3,27,2,2013-02-15 00:51:26,2013-02-14 17:44:59
1c80429e06ac15b0f4a6c2ab6dcb474886b96557...81be8c0d1b69e9509ef88dbe680f622aa57d304a,1,1,0,1,1,2013-01-09 03:38:55,2013-01-09 03:38:55
81be8c0d1b69e9509ef88dbe680f622aa57d304a...d17fb77189b7bca46ec1e2ba3c9c2cac714873e8,1,1,1,2,1,2013-01-09 04:35:11,2012-12-15 22:44:34
d17fb77189b7bca46ec1e2ba3c9c2cac714873e8...40e92ee0436ca94e1681b03c05ec8afc20f846cf,1,1,1,2,1,2013-01-09 04:35:53,2012-12-24 02:08:41
40e92ee0436ca94e1681b03c05ec8afc20f846cf...0c64008499f0f1d173d20975d9295e22335efc55,9,0,0,0,0,2013-01-09 04:52:30,2013-01-09 04:41:22
ad9390ff6fc04e75953eedc058cdb254271e6c94...3f0a5a3489aa53a6a3e0c2fe7c7dea464437aed0,2,2,2,4,2,2012-12-02 20:43:50,2012-12-02 08:43:21
e8826efb1ec25eb1724e624ce0c209b7908f57b4...99b659a810f1dac2cba531823cbcbf739aa1d9b9,3,14,4,18,5,2012-11-27 02:28:07,2012-11-27 02:28:07
f40d60c093ebf263956a0a93e3a5eb70cc4eee63...cc2dcd573dc4f94d4d6617cb132b57dcd6de7af7,1,36,20,56,13,2012-12-06 22:21:42,2012-11-29 18:15:48
cc2dcd573dc4f94d4d6617cb132b57dcd6de7af7...196d52eeae9706d98a891cffba1f80ecb2c92134,1,11,2,13,4,2012-12-06 22:21:42,2012-11-29 18:16:33
196d52eeae9706d98a891cffba1f80ecb2c92134...29a0391c3284e819306cdd44338a714fffbd3361,3,62,12,74,19,2012-12-06 22:21:42,2012-11-30 01:13:52
29a0391c3284e819306cdd44338a714fffbd3361...24e70fda2175175e89451f0e8937a02005f7e929,3,45,26,71,17,2012-12-06 22:21:42,2012-11-30 23:10:31
24e70fda2175175e89451f0e8937a02005f7e929...4d5498424a7ec3b019a6b5d920695724daaa3f84,2,17,17,34,12,2012-12-06 22:21:42,2012-12-01 01:05:05
4d5498424a7ec3b019a6b5d920695724daaa3f84...fb1d2b319aaa5e9a9f42cb4bfda06b7d73c5cf5b,4,48,22,70,13,2012-12-06 22:21:42,2012-12-03 23:35:18
fb1d2b319aaa5e9a9f42cb4bfda06b7d73c5cf5b...8769274e763dc0a71f9c10ad3c0ac73dffbd3b40,2,36,12,48,14,2012-12-06 22:21:42,2012-12-04 20:08:11
8769274e763dc0a71f9c10ad3c0ac73dffbd3b40...67c37b9d4146ed6bc22f6e44aa72a939e0b5e939,1,0,1,1,1,2012-12-06 22:21:42,2012-12-04 20:27:41
67c37b9d4146ed6bc22f6e44aa72a939e0b5e939...dc47e4304c9e1069ddcf09874b8522128b41c809,1,8,4,12,5,2012-12-06 22:21:42,2012-12-06 00:22:24
dc47e4304c9e1069ddcf09874b8522128b41c809...836fd21a13869358363f83408112cdfd0f9b1d47,1,7,0,7,1,2012-12-06 22:21:42,2012-12-06 00:54:26
836fd21a13869358363f83408112cdfd0f9b1d47...57ff26497d0e510804807067890aa70a348b52c8,1,4,0,4,1,2012-12-06 22:21:42,2012-12-06 00:58:04
57ff26497d0e510804807067890aa70a348b52c8...0531db7dcbeeca9a05c5e5ba7ba66f57a3303a27,5,29,22,51,14,2012-12-06 22:21:42,2012-12-06 18:50:02
0531db7dcbeeca9a05c5e5ba7ba66f57a3303a27...3f8b7c9b781c0aeb45321a907ff0af11a81d87bc,1,4,5,9,4,2012-12-06 22:21:42,2012-12-06 19:14:09
3f8b7c9b781c0aeb45321a907ff0af11a81d87bc...ad564f26aa237df0514722203b25dfad2503f0e4,1,1,1,2,1,2012-12-06 22:21:42,2012-12-06 19:26:13
ad564f26aa237df0514722203b25dfad2503f0e4...ad45a0854b1ead94cd5149f064ff8d38b9f12459,2,9,4,13,4,2012-12-06 22:21:42,2012-12-06 21:50:03
ad45a0854b1ead94cd5149f064ff8d38b9f12459...16fff9ea48526e112ab8a25c5a5d681c2b66b21d,2,4,2,6,2,2012-12-06 22:21:42,2012-12-06 22:14:15
16fff9ea48526e112ab8a25c5a5d681c2b66b21d...325b93e6eaa98fc29db3f2c9828dee7fc5939db3,1,1,1,2,1,2012-12-06 22:28:27,2012-12-06 22:28:27
17150f47bf020b91cdc4fbdf4a776b439c2428ee...c0ed858419684658920239ed7749c57443aa5a72,3,14,0,14,3,2012-12-07 21:34:40,2012-12-07 21:34:40
cf1e7fa669020ba87c8986dafbedc139dc0af359...7350a5396f0b12f51bc8ef44030202f1eecaee18,1,8,3,11,3,2012-11-01 16:46:38,2012-11-01 16:46:38
d1e3e2475a6bcd1836b02258902dacc6459a455c...1c6c2e13988a98671d5f24eb1ccecbfb05833ce8,1,1,1,2,1,2012-10-10 07:56:11,2012-10-10 07:56:11
1c6c2e13988a98671d5f24eb1ccecbfb05833ce8...6f522147bb674c59e0bd5490098a018d5611da08,1,1,1,2,1,2012-10-10 17:48:34,2012-10-10 17:48:34
6f522147bb674c59e0bd5490098a018d5611da08...59eb095b30d890b1eaf282b8bf67ca062ef3c170,1,2,2,4,2,2012-10-10 20:11:37,2012-10-10 20:11:37
59eb095b30d890b1eaf282b8bf67ca062ef3c170...a4639df317d84f2ab2f13b70d2413e1beb24f0e7,1,34,0,34,1,2012-10-10 21:11:54,2012-10-10 20:34:06
a4639df317d84f2ab2f13b70d2413e1beb24f0e7...f63daf37235e8ada73762aadc2591464f191f5e9,2,41,2,43,3,2012-10-10 21:11:54,2012-10-10 21:04:40
f63daf37235e8ada73762aadc2591464f191f5e9...59b0b1fbc2eeb55744e96336477b0611e6754b8b,1,4,2,6,3,2012-10-10 21:30:54,2012-10-10 21:30:54
59b0b1fbc2eeb55744e96336477b0611e6754b8b...3cf7dce666d8e99f759eb0700ed5a702fb4a51bc,2,2,2,4,2,2012-10-10 23:57:39,2012-10-10 23:57:39
3cf7dce666d8e99f759eb0700ed5a702fb4a51bc...4bef61162d36d725edec3a0c53b41b756a25a2f9,1,2,1,3,1,2012-10-11 00:06:11,2012-10-11 00:06:11
d1e3e2475a6bcd1836b02258902dacc6459a455c...60c16d76b6ad480fa6fe3aebcce8ec89f924ad3a,1,97,19,116,9,2012-10-10 07:46:06,2012-10-10 07:24:44
60c16d76b6ad480fa6fe3aebcce8ec89f924ad3a...1cb52b7c8a3b5d5d2dae596ca0b7e73d63122fdc,1,92,162,254,30,2012-10-10 22:25:34,2012-10-10 11:10:30
1cb52b7c8a3b5d5d2dae596ca0b7e73d63122fdc...bfe79d7a455f733645fd472f73debb5fdf452140,1,3,2,5,3,2012-10-10 22:26:25,2012-10-10 12:02:35
bfe79d7a455f733645fd472f73debb5fdf452140...b4ae34661b00f5ee1d625d24274942a4c6e68268,1,64,20,84,10,2012-10-10 23:59:50,2012-10-10 23:59:50
cc95a7c1b4b2b78591fa96ce5c51003a9d17ed8f...7490854b64cd7e20cf491c4fb8c5b7c612e5bf70,1,1,1,2,1,2012-10-03 23:38:47,2012-10-03 23:38:47
7490854b64cd7e20cf491c4fb8c5b7c612e5bf70...507792523a6c99a19f6ba6057aa7c7d54d801102,1,1,0,1,1,2012-10-03 23:50:13,2012-10-03 23:50:13
507792523a6c99a19f6ba6057aa7c7d54d801102...e0da63b45fc7a3c924bf13cbfd0e0ca991a793d1,2,64,96,160,16,2012-10-04 20:52:03,2012-10-04 00:42:22
e0da63b45fc7a3c924bf13cbfd0e0ca991a793d1...5e754e93a9f46cee3b203ef99302d4e77d12a605,1,5,2,7,2,2012-10-04 21:36:30,2012-10-04 21:36:30
5e754e93a9f46cee3b203ef99302d4e77d12a605...f6e15a5dd759b49050bc41e6cd6fac78a6c4a544,1,2,5,7,2,2012-10-05 02:57:39,2012-10-05 02:57:39
374dd8f39bf24dd459f43041c54675af864bac6f...036916fb31678c13762bb9bebafbfe7ee10858a6,1,56,0,56,1,2012-09-17 22:19:12,2012-09-17 22:18:59
036916fb31678c13762bb9bebafbfe7ee10858a6...7ffd598e2617976f318b45c88e5af2eaa0bc6372,1,3,4,7,2,2012-09-17 22:20:54,2012-09-17 22:20:54
7ffd598e2617976f318b45c88e5af2eaa0bc6372...b54daf2c740247567f8584d3d46d9d2823e03191,1,27,26,53,9,2012-09-17 23:07:54,2012-09-17 23:07:54
b54daf2c740247567f8584d3d46d9d2823e03191...30d20ea8db672554f5fa4aff4d948ee6d4f0a774,1,1,1,2,1,2012-09-18 01:31:37,2012-09-18 01:31:37
b0b3f3546fd54e0d8a65c7c1b41ed997e090fade...ace38c5ab247080797f1cdea8f2fdd5d337a68be,1,2,2,4,2,2012-10-05 21:17:56,2012-10-05 21:17:56
ace38c5ab247080797f1cdea8f2fdd5d337a68be...b2112ac57f13533eadb7037f4f50740523136888,3,66,22,88,22,2012-10-06 02:42:08,2012-10-06 02:42:08
b2112ac57f13533eadb7037f4f50740523136888...04e2baa6143d6daffc5a25082443d0e1bc478a58,3,42,13,55,12,2012-10-06 03:21:04,2012-09-27 04:05:45
04e2baa6143d6daffc5a25082443d0e1bc478a58...4dc19aea14d4ca984893d46f17de7d552af0f576,1,11,32,43,4,2012-10-06 03:21:04,2012-09-27 04:18:51
4dc19aea14d4ca984893d46f17de7d552af0f576...a5cc807b88231c94055d17b7638122d8b8c203f2,1,2,2,4,1,2012-10-06 03:26:01,2012-10-06 03:26:01
7677944d3d25e62131ced12161d2fcd723c25f27...8a69e74a5dc03193bb35b1bedf02577a139b6311,2,8,0,8,3,2013-02-14 03:04:50,2013-02-14 03:04:50
0c64008499f0f1d173d20975d9295e22335efc55...30bcbd8b58e4879ce236c874c8b1c97e0fe811aa,1,1,2,3,2,2013-01-09 05:04:57,2013-01-02 13:24:59
30bcbd8b58e4879ce236c874c8b1c97e0fe811aa...e474302fbab888a0281811be648c9331b9b86092,1,1,0,1,1,2013-01-09 05:04:57,2013-01-02 14:09:56
99b659a810f1dac2cba531823cbcbf739aa1d9b9...aa35967021939a42a7d266dd83b70952e55ce1d1,2,23,5,28,5,2012-11-27 04:45:15,2012-11-27 02:17:50
9902ea7c2b447a60bc3b1b2e09adff7ed3636ce7...8916b1cd02d4ad2b4b0c9e270a02cdc2f0ae47ef,1,23,7,30,6,2012-12-07 00:45:01,2012-12-05 19:11:48
8916b1cd02d4ad2b4b0c9e270a02cdc2f0ae47ef...7289950b54bd4e113e5fc14e4ae35e5ee424c761,4,49,24,73,11,2012-12-07 00:45:01,2012-12-06 03:15:51
8cb7925e78ed17509888a187d6894750eb80ff3d...999a68df7c42bcf40ba87861e5a891ba3440c932,2,58,26,84,7,2012-12-08 01:24:39,2012-12-08 01:24:39
2bd1a7d2e54210b18fe30f34f2f71b0bc10a3ef3...ac001dbad0e86aee0f3e3177029fe61277f71120,1,2,2,4,2,2012-11-01 20:16:50,2012-11-01 20:16:50
ac001dbad0e86aee0f3e3177029fe61277f71120...953e509d8dd46e4f8bb64b23f2c0c69b53efa0e2,3,25,1,26,5,2012-11-01 20:30:05,2012-11-01 20:30:05
953e509d8dd46e4f8bb64b23f2c0c69b53efa0e2...ae68aa22e6e9ef9ad015d7a5e5c60c3c82f8f62a,3,10,4,14,3,2012-11-02 01:15:31,2012-11-02 01:15:31
ae68aa22e6e9ef9ad015d7a5e5c60c3c82f8f62a...70c5f07201ae9f212f001e7a8c2fa9e407b5e28f,1,1,1,2,1,2012-11-02 16:09:42,2012-11-02 09:46:49
70c5f07201ae9f212f001e7a8c2fa9e407b5e28f...a432c243aa1ba7375bc671cb9fc1e01e1505cae3,2,3,1,4,2,2012-11-02 16:12:22,2012-11-02 16:12:22
a432c243aa1ba7375bc671cb9fc1e01e1505cae3...ab8c03e6f74f4bd0c95da2affbf83573b2a15408,6,429,226,655,62,2012-11-02 19:10:47,2012-10-31 16:55:43
ab8c03e6f74f4bd0c95da2affbf83573b2a15408...b1eb334d4185771c0aa897b993384c9657b24027,6,68,54,122,21,2012-11-02 19:20:22,2012-11-01 04:31:04
4bef61162d36d725edec3a0c53b41b756a25a2f9...dd9d213a30508c05c194a3f00dc8bc36267acdaa,1,43,0,43,1,2012-10-11 00:16:20,2012-10-11 00:15:14
dd9d213a30508c05c194a3f00dc8bc36267acdaa...2c6f991228dd1cf39c4829ff6e9a8fdd620d988d,5,5,5,10,5,2012-10-11 00:27:00,2012-10-11 00:27:00
2c6f991228dd1cf39c4829ff6e9a8fdd620d988d...98111eb6c9c5341173ff61dec06c0253179b3288,1,7,3,10,1,2012-10-11 04:42:39,2012-10-11 04:41:47
98111eb6c9c5341173ff61dec06c0253179b3288...65872c3c1c5c44927ab1d1463c6ecb73f429778e,2,15,2,17,3,2012-10-11 04:54:11,2012-10-11 04:53:08
65872c3c1c5c44927ab1d1463c6ecb73f429778e...00eda434206aba34e91ccde25019c2b035b3c746,17,85,101,186,50,2012-10-11 04:55:02,2012-10-10 22:44:58
00eda434206aba34e91ccde25019c2b035b3c746...d5ccedf8c12dd285d44292a20dfeaff45d5b75a1,5,453,0,453,5,2012-10-11 05:16:07,2012-10-11 05:16:07
9078c0eeb4b2ef826d06056a7856562b40de18b1...14ba414da36ca6f9fbc4bd01cb0cdd86bcfee6b1,1,47,18,65,14,2012-10-11 00:39:29,2012-10-11 00:39:29
f6e15a5dd759b49050bc41e6cd6fac78a6c4a544...1c9d4a7492f5850c2eb0c4d2b58dbad9ee10effb,5,270,115,385,47,2012-10-05 19:30:27,2012-10-05 06:19:20
f6e15a5dd759b49050bc41e6cd6fac78a6c4a544...a0049073a8fc18a4aa76644b18f2466075a61bbb,1,1,1,2,1,2012-10-05 06:52:19,2012-10-05 06:52:19
f6e15a5dd759b49050bc41e6cd6fac78a6c4a544...a1c93b60430a93917ccb32635bf14d47cdaf885b,3,9,9,18,9,2012-10-05 06:51:31,2012-10-05 06:51:31
f6e15a5dd759b49050bc41e6cd6fac78a6c4a544...1517de2edf5341ef20e14ed1162b98190e2a812c,1,3,0,3,1,2012-10-05 06:22:51,2012-10-05 06:22:51
1517de2edf5341ef20e14ed1162b98190e2a812c...a083486c621a13c8d558647b2aa800e5fd5e1b59,2,19,8,27,4,2012-10-05 06:25:37,2012-10-05 06:25:37
30d20ea8db672554f5fa4aff4d948ee6d4f0a774...18b55d05c0b70cca488e7ad5e090e32999713626,1,0,6,6,1,2012-09-18 01:39:01,2012-09-18 01:35:18
18b55d05c0b70cca488e7ad5e090e32999713626...e50d71a208d1234ec6a2fc7cdcec4f5e541c66b6,1,14,1,15,3,2012-09-18 01:39:35,2012-09-18 01:38:31
e50d71a208d1234ec6a2fc7cdcec4f5e541c66b6...9285bd9cabebf184a08e27e795f6016283ba3350,2,2,2,4,2,2012-09-18 01:51:21,2012-09-18 01:51:21
2d8b41a87cec884489ead138b5dfea31487363f3...95edb83518ca6d60fa9d00920a9a9455435bcdff,6,488,477,965,129,2013-03-13 11:32:53,2013-03-13 08:17:41
95edb83518ca6d60fa9d00920a9a9455435bcdff...373183b3ae78736ae5d203fb3941a9df21b4d9c7,2,49,6,55,6,2013-03-14 23:30:33,2013-03-14 06:24:16
657c101b2b6b4953d232625c2b8f2e5850228fc6...9fd43419fae63c3b4506a011ab614ad1c52ff276,3,22,4,26,4,2013-02-15 20:05:09,2013-02-15 19:59:55
9fd43419fae63c3b4506a011ab614ad1c52ff276...2983419e5f99aed9d840cd336b0aeda9e6f5a421,4,92,19,111,14,2013-02-16 00:59:42,2013-02-16 00:59:42
2983419e5f99aed9d840cd336b0aeda9e6f5a421...a8fb7b4316c7858e3388c0dca4b2ab1758e008d0,8,249,47,296,19,2013-02-16 02:20:17,2013-02-15 02:51:49
a8fb7b4316c7858e3388c0dca4b2ab1758e008d0...74921182b58122521ba4aa08bf9c1c19fd82e4f6,4,100,57,157,18,2013-02-16 02:23:17,2013-02-16 01:39:11
74921182b58122521ba4aa08bf9c1c19fd82e4f6...76162f9b06080eac7cca5cd2fab6fb746208a083,2,48,55,103,17,2013-02-16 02:23:18,2013-02-16 02:16:44
8896281b057c9af30858254de79b7b2161128438...1e22db062d0f2f04648fbc0b2d21c9bc3fc7de19,1,18,2,20,1,2013-02-14 22:21:08,2013-02-14 17:44:59
1e22db062d0f2f04648fbc0b2d21c9bc3fc7de19...b2738e2346f4abe0628202ee77414dac4636443e,1,8,3,11,3,2013-02-14 22:29:05,2013-02-14 22:29:05
e1b07e484864c614667ac7c4b031015aee4a0380...cc53ff3ac0963f03c8a44e0952461a9e7827a058,3,83,13,96,15,2013-02-14 02:56:20,2013-02-14 02:56:20
cc53ff3ac0963f03c8a44e0952461a9e7827a058...07656a249ee4686f47dbb9aaac52e57006423943,1,207,0,207,1,2013-02-14 23:34:53,2013-02-14 23:34:53
07656a249ee4686f47dbb9aaac52e57006423943...6e40ecfc8eeb45378a8ffa140e3472ecbe6d6727,1,24,5,29,3,2013-02-14 23:46:05,2013-02-14 23:46:05
6e40ecfc8eeb45378a8ffa140e3472ecbe6d6727...b4984368bd8e1ab9e0ada7114a3f95dd17a777e0,1,3,0,3,1,2013-02-14 23:49:23,2013-02-14 23:49:23
b4984368bd8e1ab9e0ada7114a3f95dd17a777e0...3698c640b8156c93e3dc66a994ba2fc7a4b6ced0,1,34,15,49,5,2013-02-15 01:04:26,2013-02-15 01:04:26
3698c640b8156c93e3dc66a994ba2fc7a4b6ced0...f11271dd4b09f5517ec430afb6da88fbc09e4032,3,6,5,11,4,2013-02-15 01:05:51,2013-02-15 01:05:41
f11271dd4b09f5517ec430afb6da88fbc09e4032...88b88e4947f62e188b3e96c8ce284854d827b640,1,25,18,43,9,2013-02-15 02:18:35,2013-02-15 02:18:35
918113ee4cac346df5a9e52e5bec12580dffd203...aec2e586d8b00e12897d74467346e3dfa7423ec3,1,57,67,124,6,2013-01-09 06:51:40,2013-01-09 01:46:58
aec2e586d8b00e12897d74467346e3dfa7423ec3...6e5dd0b9487e75afc3ee76884f43b9ef301a8529,2,15,11,26,10,2013-01-11 23:06:02,2013-01-11 23:06:02
7289950b54bd4e113e5fc14e4ae35e5ee424c761...9bc802b3f6b9c6f9ee0d0e7199652e3516bed483,3,86,1,87,4,2012-12-07 19:27:18,2012-12-05 00:35:04
d5ccedf8c12dd285d44292a20dfeaff45d5b75a1...173d4e46d76fb4e5f42c0bd6a2b0037811e057ef,1,2,1,3,1,2012-10-11 05:27:12,2012-10-11 05:27:06
173d4e46d76fb4e5f42c0bd6a2b0037811e057ef...2c90528ea537c77e601355c946b0ab0d46eaf749,1,5,0,5,1,2012-10-11 06:30:45,2012-10-11 06:30:45
483e8d0876acbd955868a261cca6d7eeb99bdda6...1f21659f96224641e3f42e4a83d3e1271559a82e,1,5,5,10,3,2012-10-12 04:59:10,2012-10-11 01:55:09
1f21659f96224641e3f42e4a83d3e1271559a82e...6cbf57bef68220b3556a99aab348d84c352fa5f6,2,7,18,25,8,2012-10-12 04:59:10,2012-10-11 20:42:12
6cbf57bef68220b3556a99aab348d84c352fa5f6...8e9b9560c5a28c69b9310535df40ac916633576a,1,2,1,3,1,2012-10-12 04:59:10,2012-10-11 20:49:40
8e9b9560c5a28c69b9310535df40ac916633576a...9332139c0f25b63ffaab12e5be4c42040e3de5da,1,2,0,2,2,2012-10-12 04:59:10,2012-10-11 21:09:31
9332139c0f25b63ffaab12e5be4c42040e3de5da...2ebde329e8284558f3fe2bb62147a6628d0e1a00,1,3,5,8,5,2012-10-12 04:59:10,2012-10-11 22:11:48
2ebde329e8284558f3fe2bb62147a6628d0e1a00...54260392c0c890410c2139a80e42ad071dc1b5be,1,8,14,22,8,2012-10-12 04:59:10,2012-10-11 22:19:23
54260392c0c890410c2139a80e42ad071dc1b5be...60e6e09c548f5539ccaef16cb7eafe750caf82d2,1,2,37,39,3,2012-10-12 05:18:11,2012-10-11 22:29:25
60e6e09c548f5539ccaef16cb7eafe750caf82d2...776c482ac555a2e956b608bbadb93159d95b29be,1,2,3,5,3,2012-10-12 05:21:30,2012-10-11 22:48:15
776c482ac555a2e956b608bbadb93159d95b29be...58eb6f77f3ef9972af396dd52f5e57862135e8db,4,14,13,27,13,2012-10-12 05:21:30,2012-10-11 22:58:24
58eb6f77f3ef9972af396dd52f5e57862135e8db...ec281e3e902fa1e24d7204a6595525e66f3b8b06,1,1,1,2,1,2012-10-12 05:21:30,2012-10-11 23:01:36
ec281e3e902fa1e24d7204a6595525e66f3b8b06...ad750d9f5e1da027a109ffb2f3d975ea4add3106,1,80,80,160,23,2012-10-12 05:21:30,2012-10-11 23:09:57
ad750d9f5e1da027a109ffb2f3d975ea4add3106...0735b2156a0ec40504998de468c4bf197cfc138a,2,23,9,32,2,2012-10-12 05:21:30,2012-10-11 23:20:38
0735b2156a0ec40504998de468c4bf197cfc138a...3bf8040fe72cc47d7d15dc17d7904cb52f2aa7a9,1,9,11,20,1,2012-10-12 05:21:30,2012-10-11 23:49:25
3bf8040fe72cc47d7d15dc17d7904cb52f2aa7a9...3ceb78ae67329493011a72986d58b8bf788399c2,2,2,12,14,2,2012-10-12 05:21:30,2012-10-12 00:39:42
3ceb78ae67329493011a72986d58b8bf788399c2...a274c844fe9910c649ee402fc8bfdd878b9bcbe2,2,10,10,20,9,2012-10-12 05:21:31,2012-10-12 00:53:45
a274c844fe9910c649ee402fc8bfdd878b9bcbe2...2d7ad7931e3d9855e45d2d126dc4b087d9558447,3,24,9,33,7,2012-10-12 05:21:31,2012-10-12 01:44:22
2d7ad7931e3d9855e45d2d126dc4b087d9558447...e0d9e3f756e3509f4e35c1ac003feb9678adf291,1,2,0,2,1,2012-10-12 05:21:31,2012-10-12 03:05:58
e0d9e3f756e3509f4e35c1ac003feb9678adf291...17a31c9910ffc659ebaaf5b8e3bf8a1871d2e55c,1,3,3,6,3,2012-10-12 05:21:31,2012-10-12 05:06:56
17a31c9910ffc659ebaaf5b8e3bf8a1871d2e55c...4bd42ffd80a2ef8c257ed074bed4bde648f50e46,1,1,0,1,1,2012-10-12 05:21:31,2012-10-12 05:10:51
4bd42ffd80a2ef8c257ed074bed4bde648f50e46...a32e97793b3cc71cf3723a01a9f7c2a37ecca5e5,1,2,2,4,1,2012-10-12 05:37:27,2012-10-12 05:37:27
3147c168cd47c9e9faede0fa461cb860939b5649...7ff08603a9b0912927df1a3f4621b3b245be3f4a,1,7,1,8,1,2012-09-18 05:17:32,2012-09-18 05:15:05
76162f9b06080eac7cca5cd2fab6fb746208a083...ac7afdbf5343764ed3cc4636ccce125b4a1c660b,8,10,10,20,8,2013-02-19 18:31:42,2013-02-18 22:23:11
ac7afdbf5343764ed3cc4636ccce125b4a1c660b...eaf08ef7ccb6e10b238e76a967aeff437db22469,1,5,0,5,2,2013-02-19 18:31:59,2013-02-18 22:31:25
eaf08ef7ccb6e10b238e76a967aeff437db22469...96f2ca7d0b4e2c50848bb1ba576f5efdf6e25533,1,6,6,12,4,2013-02-19 18:32:16,2013-02-19 18:18:29
96f2ca7d0b4e2c50848bb1ba576f5efdf6e25533...9509fd6ba848891a281ffae8e0ef883b62eb8ecb,1,3,2,5,2,2013-02-19 18:56:48,2013-02-19 18:56:48
9509fd6ba848891a281ffae8e0ef883b62eb8ecb...21d0552d38db79740eb545d589467ced2d5cedca,1,1,1,2,1,2013-02-20 18:49:25,2013-02-20 18:48:26
21d0552d38db79740eb545d589467ced2d5cedca...4f0a24d9f18c10fabc77b5f86c52a4b787b5a43a,2,2,2,4,2,2013-02-20 20:12:52,2013-02-20 20:12:52
4f0a24d9f18c10fabc77b5f86c52a4b787b5a43a...2202188e71c4d7538dec384c248e0e1c4ccad35f,1,10,0,10,1,2013-02-21 21:26:16,2013-02-21 21:26:09
2202188e71c4d7538dec384c248e0e1c4ccad35f...68617a4cd54109880176c35ab8f437d2a15d9b51,1,2,0,2,1,2013-02-21 22:07:05,2013-02-21 22:07:05
76162f9b06080eac7cca5cd2fab6fb746208a083...a2c9561ce20e7911f22e5487961dfbf350149c79,8,10,10,20,8,2013-02-18 22:23:11,2013-02-18 22:23:11
a2c9561ce20e7911f22e5487961dfbf350149c79...f932d63443ef08a106a3002e85775402cbac42df,1,5,0,5,2,2013-02-18 22:31:25,2013-02-18 22:31:25
f932d63443ef08a106a3002e85775402cbac42df...f741531c01ee5d36ae8e3d6ac6f25b6bed6aade0,1,6,6,12,4,2013-02-19 18:18:29,2013-02-19 18:18:29
f741531c01ee5d36ae8e3d6ac6f25b6bed6aade0...462f989c2eeb4355b307a441a155880ca888b385,1,3,2,5,2,2013-02-19 18:57:11,2013-02-19 18:56:48
462f989c2eeb4355b307a441a155880ca888b385...fb65a1ea54440ea5c116358630dcace2fcb52087,2,2,1,3,2,2013-02-20 00:30:37,2013-02-20 00:30:37
fb65a1ea54440ea5c116358630dcace2fcb52087...cb22989d2c597ba30b107d904c00987fb800c041,1,1,1,2,1,2013-02-20 00:31:13,2013-02-20 00:29:51
cb22989d2c597ba30b107d904c00987fb800c041...5876bc6910d885b77f890c4593d80b7b2751ac9d,3,4,2,6,3,2013-02-20 00:42:59,2013-02-20 00:42:59
5876bc6910d885b77f890c4593d80b7b2751ac9d...f3c3d5cc29d8296be9ba8e191f1927d235786d3b,1,1,1,2,1,2013-02-20 01:41:56,2013-02-20 01:41:56
f3c3d5cc29d8296be9ba8e191f1927d235786d3b...c911cd9ef49ed96f04476e6f2062cec389491e38,6,30,20,50,16,2013-02-20 22:52:28,2013-02-20 22:52:01
c911cd9ef49ed96f04476e6f2062cec389491e38...036c471b2d3d46aeea8d806a0707c26f5b0d67b0,1,6,6,12,2,2013-02-20 23:32:17,2013-02-20 23:32:17
036c471b2d3d46aeea8d806a0707c26f5b0d67b0...a920d568ecd0ea80490f685e523ccde7ee44ad1c,2,8,8,16,5,2013-02-21 00:33:27,2013-02-21 00:33:27
a920d568ecd0ea80490f685e523ccde7ee44ad1c...fbb4e03f5e770e0ba4881ad85314004775a6f088,1,1,1,2,1,2013-02-21 00:48:10,2013-02-17 03:41:45
fbb4e03f5e770e0ba4881ad85314004775a6f088...2f803607c14d94f6d34b0d37913cdfb62125fcde,1,1,1,2,1,2013-02-21 00:55:50,2013-02-21 00:55:50
2f803607c14d94f6d34b0d37913cdfb62125fcde...dba23bd29c7d3e6323968cc5d2dd97b02246c3ee,7,61,7,68,13,2013-02-21 01:56:39,2013-02-21 01:56:39
dba23bd29c7d3e6323968cc5d2dd97b02246c3ee...e6d7278927e5d13a2733eaf1da866b49484d5a07,1,14,0,14,1,2013-02-21 02:17:42,2013-02-21 02:17:03
e6d7278927e5d13a2733eaf1da866b49484d5a07...307d38e68911f2c0f53b201d3ba7b511384ddcc8,1,66,33,99,13,2013-02-21 09:08:34,2013-02-21 09:08:34
307d38e68911f2c0f53b201d3ba7b511384ddcc8...00cc07cc75eff321593507c094ad5f750a5800c9,1,2,1,3,1,2013-02-21 20:45:20,2013-02-21 20:45:20
00cc07cc75eff321593507c094ad5f750a5800c9...7b1bf062b9545466c7adc2d39a82a92994ccd3ba,1,2,2,4,2,2013-02-21 22:58:24,2013-02-21 22:54:48
76162f9b06080eac7cca5cd2fab6fb746208a083...aefe645f6cfd7a5efe2f17f9ea60780dda65c64e,6,125,56,181,32,2013-02-18 20:09:03,2013-02-18 01:29:03
aefe645f6cfd7a5efe2f17f9ea60780dda65c64e...5c0dc811ec19bf32f44bf91aa81c5771023eaddb,3,37,38,75,13,2013-02-18 20:09:03,2013-02-18 08:32:13
5c48f097c5a50d4e5fc4c972677fec71d894caf3...18035641f5bf23b6ac2bcbfef377b26d0515a5ec,2,170,17,187,17,2013-02-15 00:38:44,2013-02-14 23:18:31
9f22ca14fd76d4a1f72db41db15beb8b69fefce0...6da6cb4e7e13551712b15a63c0c16d450aaebfbe,1,20,0,20,1,2013-02-15 02:52:58,2013-02-15 02:52:58
6da6cb4e7e13551712b15a63c0c16d450aaebfbe...5235bbac2b360b72c0116c43f73bfa2526750888,1,23,12,35,4,2013-02-15 03:03:37,2013-02-15 03:03:37
5235bbac2b360b72c0116c43f73bfa2526750888...a832d274cb4f827035886dc0edfd7a6a13d1a323,1,7,1,8,1,2013-02-15 03:08:06,2013-02-15 03:08:06
6e5dd0b9487e75afc3ee76884f43b9ef301a8529...ec6c4cd55a5804784d314790136e0d7e849b70f6,1,9,2,11,1,2013-01-12 00:55:41,2013-01-10 02:49:07
ec6c4cd55a5804784d314790136e0d7e849b70f6...84b32f32418dc96e65b0587299fe6117f7505eae,1,69,0,69,1,2013-01-12 00:55:41,2013-01-12 00:55:31
6e5dd0b9487e75afc3ee76884f43b9ef301a8529...5ceac0a6409204edb13a339d2665778d840c3367,4,110,2,112,5,2013-01-11 23:14:38,2012-12-11 01:14:04
5ceac0a6409204edb13a339d2665778d840c3367...83100111ceca808b583ac6e250d6178f6f6b3f43,2,159,7,166,15,2013-01-11 23:14:38,2012-12-11 20:20:21
83100111ceca808b583ac6e250d6178f6f6b3f43...fa319acff1260bab9947ee8b794c2e47a9b38d27,2,247,28,275,20,2013-01-11 23:14:38,2012-12-12 00:41:14
fa319acff1260bab9947ee8b794c2e47a9b38d27...7a20fcd19d4c40817e13d37953ffbda62f82ef33,2,25,17,42,15,2013-01-11 23:14:38,2012-12-12 01:26:56
7a20fcd19d4c40817e13d37953ffbda62f82ef33...e58a5775eec012a09f766ff8190db28f2089b480,2,19,2,21,2,2013-01-11 23:14:38,2012-12-12 18:18:14
e58a5775eec012a09f766ff8190db28f2089b480...1a65f0dae2b3176135ed0248ddbc2b935abc7223,2,64,64,128,40,2013-01-11 23:14:38,2012-12-12 22:06:42
1a65f0dae2b3176135ed0248ddbc2b935abc7223...fd370bab3791b666a12e2833f95f21f1fe8a60e6,1,120,173,293,22,2013-01-11 23:14:38,2012-12-12 22:48:06
fd370bab3791b666a12e2833f95f21f1fe8a60e6...cf727bcd1f36b11869590535d61016ace9067072,2,16,6,22,7,2013-01-11 23:14:38,2012-12-12 22:48:58
cf727bcd1f36b11869590535d61016ace9067072...5bc5126684813a4da684c201ea0fa6348e09e25f,2,19,14,33,12,2013-01-11 23:14:38,2012-12-12 23:00:10
5bc5126684813a4da684c201ea0fa6348e09e25f...a4746b8436db0a62d0a9bfbec329c0abdccd0aff,1,1,1,2,1,2013-01-11 23:14:39,2012-12-12 23:05:20
a4746b8436db0a62d0a9bfbec329c0abdccd0aff...284a9b3b7b97ad71c4779faf8f0a7bb77639e1a7,2,110,63,173,22,2013-01-11 23:14:39,2012-12-13 00:50:20
284a9b3b7b97ad71c4779faf8f0a7bb77639e1a7...ca282c0a2fa604400927a03d26af84168d0902a8,2,6,1,7,5,2013-01-11 23:14:39,2012-12-13 01:01:42
ca282c0a2fa604400927a03d26af84168d0902a8...a5c7d9ae64a932bc02b98de250571c9cad412a5f,2,10,8,18,5,2013-01-11 23:14:39,2012-12-13 01:10:59
a5c7d9ae64a932bc02b98de250571c9cad412a5f...b29a445d05d81aa1f5f994425ee71620b9a2cd64,4,183,60,243,36,2013-01-11 23:14:39,2012-12-13 21:07:37
b29a445d05d81aa1f5f994425ee71620b9a2cd64...6a5a562854779a65c9cf4325509bb541d346d4ae,1,49,48,97,30,2013-01-11 23:14:39,2012-12-13 21:29:52
6a5a562854779a65c9cf4325509bb541d346d4ae...67c105acf1864f130f9f384fefd461d79494dd0c,1,1,1,2,1,2013-01-11 23:14:39,2012-12-13 21:35:25
67c105acf1864f130f9f384fefd461d79494dd0c...76d25a497c1bf9a260fee6dcca82a6d045d87a44,3,49,35,84,10,2013-01-11 23:14:39,2012-12-13 21:48:03
76d25a497c1bf9a260fee6dcca82a6d045d87a44...0bca4504df21c8dfc22378a5d57a879c49c8ca54,1,1,0,1,1,2013-01-11 23:14:40,2012-12-13 21:52:36
0bca4504df21c8dfc22378a5d57a879c49c8ca54...586e0d9c2a73d82edb27a62e6dc5ba6ccdd09507,2,2,2,4,3,2013-01-11 23:14:40,2012-12-13 22:05:05
586e0d9c2a73d82edb27a62e6dc5ba6ccdd09507...9af6aeebb76946f037cfc11f813793bc29d40823,1,9,3,12,6,2013-01-11 23:14:40,2012-12-13 22:22:30
9af6aeebb76946f037cfc11f813793bc29d40823...e67e5b8d7cd08752afa7f687e711060aae1228c3,1,1,6,7,1,2013-01-11 23:14:40,2012-12-13 22:43:33
e67e5b8d7cd08752afa7f687e711060aae1228c3...ae32d50116b8d528985e68ba367d8e03a949e038,1,22,0,22,1,2013-01-11 23:14:40,2012-12-14 00:12:39
ae32d50116b8d528985e68ba367d8e03a949e038...264f012c0088b1d7be9dbe2bcb7129799844f087,1,14,24,38,5,2013-01-11 23:14:40,2012-12-14 23:32:28
264f012c0088b1d7be9dbe2bcb7129799844f087...4fff1dd393e18c2ff44b44991e6228e4b0b606cd,1,27,22,49,2,2013-01-11 23:14:40,2012-12-15 00:02:53
4fff1dd393e18c2ff44b44991e6228e4b0b606cd...f0bbd0c21989be301e3ab628e947c8ab31138b65,3,78,68,146,36,2013-01-11 23:14:40,2012-12-15 01:17:13
f0bbd0c21989be301e3ab628e947c8ab31138b65...85aa541e101298eb3289e42889ae7a2e16ac8716,1,12,2,14,2,2013-01-11 23:15:17,2012-12-17 21:34:07
85aa541e101298eb3289e42889ae7a2e16ac8716...2be434cbbad9b21fe20a8bf8c1496c0931913e6d,5,126,36,162,25,2013-01-11 23:15:26,2012-12-17 23:39:49
2be434cbbad9b21fe20a8bf8c1496c0931913e6d...ba1bc521cf81c611cb20b0f7a0e771492f396399,2,10,12,22,10,2013-01-11 23:15:26,2012-12-18 01:07:35
ba1bc521cf81c611cb20b0f7a0e771492f396399...beefb493fdd3804bf35d739f637d2355ab8429aa,6,102,115,217,51,2013-01-11 23:15:26,2012-12-18 20:19:25
beefb493fdd3804bf35d739f637d2355ab8429aa...cb02151e1d2f5ff15b04a5fb171081739d9e97ac,4,34,29,63,12,2013-01-11 23:15:26,2012-12-18 22:01:46
cb02151e1d2f5ff15b04a5fb171081739d9e97ac...8f103f599498e336bae8ffa623a1987899bba194,2,124,1,125,4,2013-01-11 23:15:26,2012-12-19 01:25:52
8f103f599498e336bae8ffa623a1987899bba194...db814213d2aea059a56000a698b6aa7d541772ae,1,32,8,40,3,2013-01-11 23:15:26,2012-12-19 01:48:44
db814213d2aea059a56000a698b6aa7d541772ae...dad8becca0f599e24dfc3786450dc838b8c0a07e,1,46,35,81,10,2013-01-11 23:15:27,2012-12-19 01:57:16
dad8becca0f599e24dfc3786450dc838b8c0a07e...c30f61e6277ffb35b9a84e15524ab4ada0638f4a,3,151,1,152,4,2013-01-11 23:15:27,2012-12-19 18:55:32
c30f61e6277ffb35b9a84e15524ab4ada0638f4a...2edf3e821f1b5aaca42d328482c0eec73dc85e8f,2,27,15,42,10,2013-01-11 23:15:27,2012-12-19 19:59:07
2edf3e821f1b5aaca42d328482c0eec73dc85e8f...b2793d83d0b6e648e758f70ad358e24923829b63,1,15,24,39,12,2013-01-11 23:15:27,2012-12-19 20:16:30
b2793d83d0b6e648e758f70ad358e24923829b63...0675764ac1aef8aae615adef25eede8808531078,1,1,1,2,1,2013-01-11 23:15:27,2012-12-19 22:25:50
0675764ac1aef8aae615adef25eede8808531078...8a7812c0a4a6836c4be8954d3b847de801903a03,3,91,157,248,30,2013-01-11 23:15:27,2012-12-19 22:58:31
8a7812c0a4a6836c4be8954d3b847de801903a03...237c0ba8c96c820728566016c8de1f0cff584af8,1,14,21,35,12,2013-01-11 23:15:27,2012-12-19 23:08:35
237c0ba8c96c820728566016c8de1f0cff584af8...6d03df174a11a88961d1eab9a03dbfe754bece55,1,3,0,3,1,2013-01-11 23:15:27,2012-12-20 18:34:47
6d03df174a11a88961d1eab9a03dbfe754bece55...977b1d6aebff6f201379f4255fa54f6feaeb4f69,5,95,38,133,19,2013-01-11 23:15:27,2012-12-20 19:34:05
977b1d6aebff6f201379f4255fa54f6feaeb4f69...0c98b3167a2ce55516307867a059988b7cda6906,10,275,45,320,17,2013-01-11 23:15:28,2012-12-21 02:58:50
0c98b3167a2ce55516307867a059988b7cda6906...a7bef9c9c5388220a621ac7eed0745bef87ca690,2,60,65,125,38,2013-01-11 23:15:28,2012-12-21 21:40:32
a7bef9c9c5388220a621ac7eed0745bef87ca690...32c647e32ace628fd7d528d5a2b1bc1ac92e9a07,4,31,29,60,10,2013-01-11 23:15:28,2012-12-21 22:26:48
32c647e32ace628fd7d528d5a2b1bc1ac92e9a07...0f7442b57c9245f3cb02c13778918b64adcb4f2e,1,2,2,4,2,2013-01-11 23:15:28,2013-01-02 21:57:31
0f7442b57c9245f3cb02c13778918b64adcb4f2e...f6d0073eba5d8328036b82e12d924ec9fb9685b9,1,1,1,2,1,2013-01-11 23:15:28,2013-01-09 22:12:27
0988203ca16997941e8117a1078bd354d81cd3e3...c87b00f0c93e08a5c95201479026eb1034bab49f,2,3,1,4,2,2012-12-07 21:40:23,2012-12-07 21:40:23
10c55031c62d8ad87ce68f67ceb5cc0342b6e9dc...66c830ec7b25870e2b2dcca851f3f1f3ad86c6ed,2,103,12,115,10,2012-12-11 01:18:50,2012-12-11 01:18:50
66c830ec7b25870e2b2dcca851f3f1f3ad86c6ed...4a8c0ac562c3016819a0d1423cb82eb9f3dc641c,6,64,0,64,5,2012-12-11 01:19:28,2012-12-11 01:19:28
4a8c0ac562c3016819a0d1423cb82eb9f3dc641c...f3e09057b6a705f739d8ecdf30470410c9ad623e,4,8221,1,8222,5,2012-12-11 02:07:46,2012-10-08 16:27:47
f3e09057b6a705f739d8ecdf30470410c9ad623e...875f9cc388b29f1b721125d7dd59738064f5ac48,2,5,5,10,2,2012-12-11 02:41:49,2012-12-11 02:41:49
875f9cc388b29f1b721125d7dd59738064f5ac48...e8f68758edf92af8bef7b304eff795255aea085d,2,1477,0,1477,2,2012-12-11 04:41:55,2012-12-11 04:41:55
e8f68758edf92af8bef7b304eff795255aea085d...cf794da7e9c4a5be2c4b6b656a78d5a5e444137b,2,186,101,287,64,2012-12-11 19:44:06,2012-12-11 19:44:06
cf794da7e9c4a5be2c4b6b656a78d5a5e444137b...9da193ab79bfbf9ecabd2d9c3e961ad835552a0c,2,2,13,15,5,2012-12-12 00:11:56,2012-12-12 00:11:56
9da193ab79bfbf9ecabd2d9c3e961ad835552a0c...13d438f14177d9f62ef9ad50f5f907faf548340f,4,75,15,90,16,2012-12-12 00:58:38,2012-12-12 00:58:38
13d438f14177d9f62ef9ad50f5f907faf548340f...11a7ac81447b78ac35e5208bb81b041288e721c5,2,21,17,38,10,2012-12-12 01:10:50,2012-12-12 01:10:50
11a7ac81447b78ac35e5208bb81b041288e721c5...659ce1cb8838ebbd9c44422de4166bfcc3aedd7c,3,51,30,81,8,2012-12-12 01:36:00,2012-12-12 01:36:00
2c90528ea537c77e601355c946b0ab0d46eaf749...3f596faf018dc68bf56b0d66faefda4b7fa21c20,1,56,56,112,2,2012-10-11 22:01:15,2012-10-07 05:27:05
3f596faf018dc68bf56b0d66faefda4b7fa21c20...e2023399aa4f189b51455b8a1d765f368fcfe089,3,529,2,531,12,2012-10-11 22:01:15,2012-10-07 05:28:23
e2023399aa4f189b51455b8a1d765f368fcfe089...5097fc283c366f596c231eef7b8b7ce89e17212b,3,154,12,166,20,2012-10-11 22:01:15,2012-10-08 02:02:20
5097fc283c366f596c231eef7b8b7ce89e17212b...17030e572c26459717b5e1033112e14b7426405a,2,118,100,218,28,2012-10-11 22:01:16,2012-10-09 04:15:00
17030e572c26459717b5e1033112e14b7426405a...99e1ed82c7710b1c8ff383c29db66bbcf72839fd,3,170,79,249,28,2012-10-11 22:01:31,2012-10-09 08:29:52
99e1ed82c7710b1c8ff383c29db66bbcf72839fd...78b262741f3950a07465496b3bec4cc550ec57ef,3,122,169,291,75,2012-10-11 22:01:38,2012-10-11 04:16:20
78b262741f3950a07465496b3bec4cc550ec57ef...ec54838d950d9fd045a4217616a5357dfe792f88,2,26,0,26,3,2012-10-11 22:01:39,2012-10-11 21:53:00
ec54838d950d9fd045a4217616a5357dfe792f88...3b0732fc1dc6201129b62a8eec351d4969ffe530,3,13,0,13,3,2012-10-11 22:01:39,2012-10-11 21:58:40
3b0732fc1dc6201129b62a8eec351d4969ffe530...3dd36e656f0cca3cb802baa5e88346a721cfab86,1,3,0,3,1,2012-10-11 22:01:39,2012-10-11 22:00:12
f3bdf087c1bdba5bce50ad1af20ccadc09a1b968...2fa08731fa9942f9ab2f14dd33391e16e850904e,1,1,1,2,1,2012-10-12 05:44:41,2012-10-12 05:44:41
2fa08731fa9942f9ab2f14dd33391e16e850904e...17322ba63c7c6673c8d5b134f7c0597cfb7bc336,1,2,2,4,1,2012-10-12 05:59:56,2012-10-12 05:59:56
17322ba63c7c6673c8d5b134f7c0597cfb7bc336...639f4dd5bf11aca7eb1719618ff4533692df49aa,1,11,12,23,3,2012-10-12 06:23:57,2012-10-12 06:23:57
639f4dd5bf11aca7eb1719618ff4533692df49aa...6d6aecc8a4da7f642581c27e2f4313688c861c7a,1,3,0,3,1,2012-10-12 06:57:07,2012-10-12 06:57:07
7ff08603a9b0912927df1a3f4621b3b245be3f4a...8a724d14283ef54debc2862de819fd48bddaec1d,1,2,0,2,1,2012-09-18 06:33:08,2012-09-18 06:33:08
8a724d14283ef54debc2862de819fd48bddaec1d...8ddcc21a0e50c286dba677495b7db1d23157d264,8,10,10,20,8,2012-09-18 06:38:51,2012-09-18 06:38:51
8ddcc21a0e50c286dba677495b7db1d23157d264...d1467c983d4a529bf4c5000b268504d5a589f772,8,10,10,20,8,2012-09-18 17:21:26,2012-09-18 17:21:26
d1467c983d4a529bf4c5000b268504d5a589f772...7f14281cfab40ea4cb4771688deace229ffc2665,1,8,10,18,4,2012-09-18 17:29:35,2012-09-18 17:28:33
7f14281cfab40ea4cb4771688deace229ffc2665...f40b7b03c000e019b4d345e8ac705c3844524425,8,10,10,20,8,2012-09-18 17:49:40,2012-09-18 06:38:51
f40b7b03c000e019b4d345e8ac705c3844524425...1caf2da2b5b9e7ecf4c2552475869825ccd86389,6,18,20,38,14,2012-09-18 18:23:49,2012-09-18 18:23:49
1caf2da2b5b9e7ecf4c2552475869825ccd86389...58af66a11021068a08a02c3bb924ab93af8d2e63,1,3,0,3,1,2012-09-18 20:30:41,2012-09-18 20:30:41
58af66a11021068a08a02c3bb924ab93af8d2e63...1cf759ed7ed284dc3d7a227e4d8fe3a390669a9f,1,1,0,1,1,2012-09-18 22:01:12,2012-09-18 22:01:12
1cf759ed7ed284dc3d7a227e4d8fe3a390669a9f...a0ded8c3d0cb09dc852d0772243b0705b852a878,1,2,1,3,2,2012-09-18 22:01:28,2012-09-18 22:01:28
a0ded8c3d0cb09dc852d0772243b0705b852a878...7b036318e784aecf5380f0d4ff756ef6fcad8bde,1,2,2,4,2,2012-09-18 22:02:07,2012-09-18 22:02:07
f07715dc70de16a7aab84e56ab0c6cbd9c1f9dc6...5da1e35410c6c85a461e2885c54696f37a7ca36e,2,26,1,27,4,2013-04-01 21:32:58,2013-04-01 21:30:28
dcb7ccd2caf00515a52403861f6fe92e6abd556a...e15c49d0dee30b00124e84a1c1ad157aad5e8ad6,1,2,2,4,1,2013-03-13 23:09:12,2013-03-05 03:32:20
e15c49d0dee30b00124e84a1c1ad157aad5e8ad6...12fa62e33f2460f0fcd79d4f0e0da95245eabc11,1,1,1,2,1,2013-03-13 23:09:12,2013-03-05 03:38:10
12fa62e33f2460f0fcd79d4f0e0da95245eabc11...cf2423f6ab9c511be0263e60479c62d825cd2ec1,1,2,0,2,1,2013-03-13 23:09:12,2013-03-05 15:59:50
cf2423f6ab9c511be0263e60479c62d825cd2ec1...5e107051b2f7c2139db93cee67773f3f2fda841e,3,3,3,6,3,2013-03-13 23:09:12,2013-03-06 04:20:28
5e107051b2f7c2139db93cee67773f3f2fda841e...bfb7ed2e30b2cce81e7c6553950bceaca08f6694,7,10,25,35,14,2013-03-13 23:09:12,2013-03-06 04:28:34
bed981f4b0e36099cc681c2739fedb858a6ac1bd...7ad9944598e97df067edaba69af04e79aee2450d,2,23,2,25,5,2013-02-22 01:21:18,2013-02-22 01:21:18
7ad9944598e97df067edaba69af04e79aee2450d...d923e9e92b53ed0a6e14e592f3b01a5472673861,1,2,1,3,1,2013-02-22 01:24:37,2013-02-22 01:24:37
039fdf3f5d221dd5c5c1fc518b5e5409b2d1967a...cc27c50339628abe12fddf6b41c119e8740a537c,1,55,9,64,9,2013-02-15 04:14:49,2013-02-13 13:35:43
cc27c50339628abe12fddf6b41c119e8740a537c...148670cfc67c1a07126f9d3f6dce07c7f5e13d5b,1,1,1,2,1,2013-02-15 04:14:49,2013-02-14 12:04:42
148670cfc67c1a07126f9d3f6dce07c7f5e13d5b...33a4cd617be7f1f4e62ea9899760aca4aa4f5362,1,50,1,51,9,2013-02-15 05:50:17,2013-02-15 05:50:17
3ff567eda245c0f18291acf01d6ee18104f43022...448da70a58b5f814cbe72751b1c45742b80e4a87,1,18,0,18,1,2013-01-12 02:32:52,2013-01-12 02:32:52
448da70a58b5f814cbe72751b1c45742b80e4a87...435c664c8bc61f0f1877aba765bbf3a105d518cc,1,1,1,2,1,2013-01-12 22:32:27,2013-01-06 19:26:42
435c664c8bc61f0f1877aba765bbf3a105d518cc...27d30736608ad9c63901ddf408bf53a2f1ca5a7e,12,301,181,482,47,2013-01-15 22:07:03,2013-01-11 23:42:56
f6d0073eba5d8328036b82e12d924ec9fb9685b9...cf18b14900b0219f5c53e482a96864ad745353c6,3,168,37,205,15,2013-01-11 23:15:28,2012-12-22 04:44:28
cf18b14900b0219f5c53e482a96864ad745353c6...a27191d7e0e0be8441c438dedb1b1d12b68e1fed,5,64,9,73,11,2013-01-11 23:15:28,2012-12-22 05:23:36
a27191d7e0e0be8441c438dedb1b1d12b68e1fed...81451ae015201f33bbd6c0ceef4291564c9f89d4,2,69,6,75,8,2013-01-11 23:15:28,2012-12-30 19:58:46
81451ae015201f33bbd6c0ceef4291564c9f89d4...04bf7d381f96a65554a4e5ef6b76622d38e8ecb9,4,51,1,52,4,2013-01-11 23:15:29,2012-12-30 23:43:53
04bf7d381f96a65554a4e5ef6b76622d38e8ecb9...c6cc6fe969abcd8625dc5fcf1f9b84ca082a1aaf,7,79,27,106,24,2013-01-11 23:15:29,2012-12-31 02:49:04
c6cc6fe969abcd8625dc5fcf1f9b84ca082a1aaf...206a4d86b4bb8d258d6ff5c704e3bae2369c92d0,5,57,25,82,32,2013-01-11 23:15:29,2012-12-31 19:05:14
206a4d86b4bb8d258d6ff5c704e3bae2369c92d0...d5a54c89204d72040a9d37e0dcbd58675e3fb430,4,17,6,23,8,2013-01-11 23:15:29,2012-12-31 22:51:04
d5a54c89204d72040a9d37e0dcbd58675e3fb430...a8791b577a81b7cda17b0c3d83893506fbeb0c5a,1,5,0,5,1,2013-01-11 23:15:29,2012-12-31 23:05:01
a8791b577a81b7cda17b0c3d83893506fbeb0c5a...c64011c32939b7c4fdf79ef30ce6ef5b79e19605,5,78,63,141,14,2013-01-11 23:15:29,2013-01-02 23:42:51
c64011c32939b7c4fdf79ef30ce6ef5b79e19605...1dbf8eae9ee387cdcb382bfa50b58c3cf303c535,10,53,45,98,39,2013-01-11 23:15:29,2013-01-03 02:52:24
1dbf8eae9ee387cdcb382bfa50b58c3cf303c535...9c6b838f8c1309e61f262fe26a0d58b8336f64b8,5,124,69,193,57,2013-01-11 23:15:29,2013-01-04 22:45:04
9c6b838f8c1309e61f262fe26a0d58b8336f64b8...a991ad9ea126963e6215cf1c0578a5800e5d67a0,2,4,3,7,4,2013-01-11 23:15:29,2013-01-04 23:18:23
a991ad9ea126963e6215cf1c0578a5800e5d67a0...5002e003afbaf4177fc3b41dfc366a504a886ee4,9,85,78,163,35,2013-01-11 23:15:30,2013-01-05 02:34:17
5002e003afbaf4177fc3b41dfc366a504a886ee4...58e7139d4759ac2bd12d32d82f5ad1f715c25348,6,21,15,36,16,2013-01-11 23:15:30,2013-01-05 02:55:41
58e7139d4759ac2bd12d32d82f5ad1f715c25348...ee41a46beb3b94eda05be03cece16bc126729ea0,3,81,19,100,11,2013-01-11 23:15:30,2013-01-08 00:10:40
ee41a46beb3b94eda05be03cece16bc126729ea0...9d32646668da2ef7a33e509580bdc24efb15d7e2,4,14,1,15,5,2013-01-11 23:15:30,2013-01-08 00:52:37
9d32646668da2ef7a33e509580bdc24efb15d7e2...c577723699926d88e360ac5e4fad99d36bf5e7a8,13,167,187,354,83,2013-01-11 23:15:30,2013-01-08 23:55:06
c577723699926d88e360ac5e4fad99d36bf5e7a8...7348deeecd3c86984e73c9f672f5791fe31ff8b7,4,83,4,87,11,2013-01-11 23:15:30,2013-01-09 01:56:40
7348deeecd3c86984e73c9f672f5791fe31ff8b7...cb13af6a01d4a16e5a09adeec5001be745e8ef3c,10,168,62,230,38,2013-01-11 23:15:30,2013-01-09 21:26:55
cb13af6a01d4a16e5a09adeec5001be745e8ef3c...879705d6051b63a219406de6957c4aa909a4b5fe,1,3,3,6,2,2013-01-11 23:15:30,2013-01-09 21:53:01
c87b00f0c93e08a5c95201479026eb1034bab49f...f78e46607cf15a7273ac780086a071f4cea092df,1,1,0,1,1,2012-12-07 21:43:05,2012-12-07 21:43:05
f78e46607cf15a7273ac780086a071f4cea092df...85b502c2962c75867cb98875fd8cbf8339e6afaa,2,4,1,5,2,2012-12-08 01:56:23,2012-12-08 01:56:23
060f46e652d273990239d5df3e2eb1226134f678...09ed9ffeea620c22753bc4f445f8495a9d70530c,2,11,1,12,4,2012-10-12 01:50:06,2012-10-12 01:50:06
09ed9ffeea620c22753bc4f445f8495a9d70530c...ed89815a3388ca5ec72cad3ca95e25ccbd21ed07,5,34,6,40,6,2012-10-12 02:50:09,2012-10-12 02:50:09
ed89815a3388ca5ec72cad3ca95e25ccbd21ed07...ea83ef4174e7ae0f0c3a7d0eb66adeec3f945780,2,11,7,18,6,2012-10-12 04:54:56,2012-10-12 04:45:18
ea83ef4174e7ae0f0c3a7d0eb66adeec3f945780...92ac9f1309fac562723de6fc3abfd606f7123c50,2,20,13,33,4,2012-10-12 04:55:09,2012-10-12 04:53:54
6d6aecc8a4da7f642581c27e2f4313688c861c7a...bae1a59af66f689e106e1600cc1f4ecc417892db,13,107,13,120,20,2012-10-12 07:50:35,2012-10-12 07:50:35
bae1a59af66f689e106e1600cc1f4ecc417892db...c7b5f51420017e66e1f0e72ff29aa1e51a57bb37,3,36,36,72,5,2012-10-12 21:55:32,2012-10-12 21:55:32
c7b5f51420017e66e1f0e72ff29aa1e51a57bb37...ada7d811124319e4aa89f84e7228055ae779b456,2,3,2,5,2,2012-10-12 22:20:27,2012-10-12 22:20:27
6d6aecc8a4da7f642581c27e2f4313688c861c7a...f0f35650fa1259e496b29de677ed2c360a608a08,1,1,1,2,1,2012-10-12 07:29:03,2012-10-08 06:26:50
f0f35650fa1259e496b29de677ed2c360a608a08...e8fa501fae57824ad2a95fa868e485b3bd754d8b,1,19,2,21,2,2012-10-12 07:29:03,2012-10-11 23:30:10
e8fa501fae57824ad2a95fa868e485b3bd754d8b...0195b291e100049edba2a60d387192a96f1a3832,2,196,21,217,17,2012-10-12 07:29:03,2012-10-12 07:26:35
7b036318e784aecf5380f0d4ff756ef6fcad8bde...f0fd0c476c39cd052627bf19f2c2bb1054b161ff,1,1,1,2,1,2012-09-18 22:54:19,2012-09-18 22:54:19
f0fd0c476c39cd052627bf19f2c2bb1054b161ff...125cf2153d3e86a960d4377c7b687d32ebbcb70d,1,1,0,1,1,2012-09-18 23:41:09,2012-09-18 23:41:09
125cf2153d3e86a960d4377c7b687d32ebbcb70d...e27304c999d99eba462e12081dc789a201484d10,1,6,1,7,1,2012-09-19 20:50:06,2012-09-19 20:50:06
e27304c999d99eba462e12081dc789a201484d10...2768abd5c39b9f6f11b325206047d21cba0807fe,1,7,4,11,3,2012-09-21 00:04:50,2012-09-21 00:04:50
dcb26e182b08fd586d0066b387acf9695eb83f1a...000842d4bc04c91437ade7a165d3e568ac27e097,2,49,6,55,6,2013-03-14 06:24:16,2013-03-14 06:24:16
000842d4bc04c91437ade7a165d3e568ac27e097...e92522c28394311d1df5d8cc81e7b3795559e36b,1,1,1,2,1,2013-03-14 07:27:42,2013-03-14 07:27:25
d923e9e92b53ed0a6e14e592f3b01a5472673861...e4bd63b39755cee7ebfb76236fa2234355d9eac5,2,35,2,37,3,2013-02-22 21:02:50,2013-02-22 21:02:50
e4bd63b39755cee7ebfb76236fa2234355d9eac5...a39401add166adb3283e663b08ebb8c49115be8e,2,6,3,9,4,2013-02-22 21:14:21,2013-02-22 21:14:21
a39401add166adb3283e663b08ebb8c49115be8e...a102deee809f34f61ac45a87939b8497a8b6b03e,1,3,4,7,3,2013-02-22 21:26:09,2013-02-22 21:26:09
a102deee809f34f61ac45a87939b8497a8b6b03e...8a5db13f903fe82e9ef9a9ea60ec4def9d960d08,2,56,0,56,2,2013-02-22 22:04:33,2013-02-22 22:04:33
8a5db13f903fe82e9ef9a9ea60ec4def9d960d08...a0c3ff709a85ec4e2b5abb945095d8ce5092514c,3,8,3,11,5,2013-02-22 22:28:05,2013-02-22 22:27:51
d923e9e92b53ed0a6e14e592f3b01a5472673861...9c55aeeb973d7cd241c2a66dde76f9e0450bf999,7,349,0,349,7,2013-02-22 02:41:53,2013-02-14 20:06:19
9c55aeeb973d7cd241c2a66dde76f9e0450bf999...6bea9656d63a926e22dd1868b92b3e822aa1ab27,2,11,5,16,5,2013-02-22 02:41:53,2013-02-15 12:46:01
6bea9656d63a926e22dd1868b92b3e822aa1ab27...6ed6e8ce172c7a94964db7a2568906da84946d15,4,30,24,54,15,2013-02-22 02:41:53,2013-02-16 01:18:11
6ed6e8ce172c7a94964db7a2568906da84946d15...1bbbe2901f1897483b2779adae2eefad04aaddcb,1,1,1,2,1,2013-02-22 02:41:53,2013-02-16 01:31:59
1bbbe2901f1897483b2779adae2eefad04aaddcb...1be9a4989cb28fafda03d10da4f0406e67cf830a,3,2,1,3,2,2013-02-22 02:41:53,2013-02-11 18:40:16
1be9a4989cb28fafda03d10da4f0406e67cf830a...2500312cd5a927a449c4bb2b7b91bc07759d65f5,4,67,16,83,15,2013-02-22 02:41:53,2013-02-20 14:21:47
2500312cd5a927a449c4bb2b7b91bc07759d65f5...43282254a13f2abe66931d21871465edb8c32346,1,1,1,2,1,2013-02-22 02:41:53,2013-02-21 12:53:19
43282254a13f2abe66931d21871465edb8c32346...87eb5c708ac1cba058e9366b49bfb64d67ab4649,1,33,24,57,7,2013-02-22 02:41:53,2013-02-21 14:49:41
87eb5c708ac1cba058e9366b49bfb64d67ab4649...f72f366e201afb34452d922e186446d9b2d2cbaa,2,89,35,124,3,2013-02-23 02:38:41,2013-02-23 00:23:48
27d30736608ad9c63901ddf408bf53a2f1ca5a7e...3a99938dff34906af36f5681507ae9baf7122e71,3,6,5,11,4,2013-01-16 15:47:57,2013-01-16 15:47:57
3a99938dff34906af36f5681507ae9baf7122e71...6785ac2d8784ddc6364cf3d2ff1018f4c23bcf8a,2,2,2,4,2,2013-01-16 15:48:39,2013-01-16 15:48:39
6785ac2d8784ddc6364cf3d2ff1018f4c23bcf8a...56412f259fd43954dc78ef509c47cda614dad2d7,1,1,0,1,1,2013-01-16 15:52:18,2013-01-16 15:52:18
56412f259fd43954dc78ef509c47cda614dad2d7...f80a20cecf1901067be6a719ca50f117b230d467,2,2,2,4,2,2013-01-16 15:54:15,2013-01-16 15:54:15
f80a20cecf1901067be6a719ca50f117b230d467...2aa92b2ed3ced032dc60021d23c159910c154d45,10,20,21,41,15,2013-01-16 16:34:30,2013-01-16 16:16:20
2aa92b2ed3ced032dc60021d23c159910c154d45...21db9164d4345be162591c9c3428c302956c8b4c,1,4,1,5,2,2013-01-16 20:12:28,2013-01-16 20:12:28
21db9164d4345be162591c9c3428c302956c8b4c...24d652af3e32425f31202aa28f51634c01c3e341,1,1,7,8,2,2013-01-16 20:12:42,2013-01-16 20:12:42
4de5ca9bb6b796448e612e8c25d082ec24884f36...5c56645a966d1f460b085f82b10627668ae1b7f8,3,93,27,120,30,2013-01-11 23:15:31,2013-01-10 19:26:29
5c56645a966d1f460b085f82b10627668ae1b7f8...5e425cdf42d8d64cf44091930c08d7cc2252fa5e,2,1,2,3,2,2013-01-11 23:15:31,2013-01-10 20:06:17
5e425cdf42d8d64cf44091930c08d7cc2252fa5e...2310214a6a4374937fb45caae75856263c818193,1,23,11,34,8,2013-01-11 23:15:31,2013-01-10 07:31:21
2310214a6a4374937fb45caae75856263c818193...d438058ba8d54115feb00618d89ffe3a24225faa,1,54,49,103,16,2013-01-11 23:15:31,2013-01-10 20:12:29
d438058ba8d54115feb00618d89ffe3a24225faa...88259d7e87d09917b4e037ac30cf38f579e2c142,3,107,15,122,22,2013-01-11 23:15:31,2013-01-10 20:36:34
88259d7e87d09917b4e037ac30cf38f579e2c142...cd37da895e112acfe3020cd4796b99a22927191b,4,49,3,52,6,2013-01-11 23:15:31,2013-01-10 22:50:56
cd37da895e112acfe3020cd4796b99a22927191b...2168944ab4b08ce919c916de07a177b62babfa5c,2,17,15,32,13,2013-01-11 23:15:31,2013-01-10 23:07:41
2168944ab4b08ce919c916de07a177b62babfa5c...b35e38f13355a93e2d23ff405d38fed46a640bbf,3,69,11,80,8,2013-01-11 23:15:31,2013-01-10 23:30:01
b35e38f13355a93e2d23ff405d38fed46a640bbf...20afc8e5f3117d85f07bf636c33440cea7c98654,2,71,6,77,4,2013-01-11 23:15:32,2013-01-10 23:56:53
20afc8e5f3117d85f07bf636c33440cea7c98654...b7739f211cf77900f35bba18b51f58504e859d79,2,5,0,5,2,2013-01-11 23:15:32,2013-01-11 00:04:58
b7739f211cf77900f35bba18b51f58504e859d79...ef96d307a2be195197bd4ae4a7a6333a73bb844e,1,26,16,42,8,2013-01-11 23:15:32,2013-01-11 00:05:15
ef96d307a2be195197bd4ae4a7a6333a73bb844e...f4494aa5d73c03b43ad6b46c95a76f5318b1142a,1,39,22,61,6,2013-01-11 23:15:32,2013-01-11 18:28:45
f4494aa5d73c03b43ad6b46c95a76f5318b1142a...cfea6b74cadf4f0c921397d5fe0cdfe0bc06590c,4,191,0,191,5,2013-01-11 23:53:02,2013-01-11 23:53:02
cfea6b74cadf4f0c921397d5fe0cdfe0bc06590c...19735d8276c27d68edfd62cdb82e78cc37a0562a,9,233,206,439,13,2013-01-12 00:50:35,2013-01-12 00:50:35
19735d8276c27d68edfd62cdb82e78cc37a0562a...cdc2707b30aaf92d39441d0ee73b8fe050ad74cc,13,89,78,167,51,2013-01-12 01:53:00,2013-01-12 01:53:00
cdc2707b30aaf92d39441d0ee73b8fe050ad74cc...157eb741484255788b5f9a7a3a44340f64ee51a2,8,70,69,139,16,2013-01-14 21:09:26,2013-01-14 21:09:26
157eb741484255788b5f9a7a3a44340f64ee51a2...add54848afecc08e701c2f408dd437f6f467a4a0,3,172,65,237,12,2013-01-14 23:50:00,2013-01-14 23:50:00
add54848afecc08e701c2f408dd437f6f467a4a0...651f3a599c95e8b04ad30c74fdbc79b00c9f31fe,3,65,55,120,29,2013-01-15 01:50:28,2013-01-15 01:50:28
651f3a599c95e8b04ad30c74fdbc79b00c9f31fe...3efe6365ce8b3694b72a85acc0ba8385cf9edb21,2,53,9,62,9,2013-01-15 19:58:33,2013-01-15 19:58:33
3efe6365ce8b3694b72a85acc0ba8385cf9edb21...f112b3a20c54bcd3994408a0be0f51568e568fb1,1,20,14,34,6,2013-01-15 22:07:33,2013-01-15 22:07:33
85b502c2962c75867cb98875fd8cbf8339e6afaa...8eacb1ab9f3e0d268f584b6b606b73db5f0d3da9,1,1,1,2,1,2012-12-08 02:03:52,2012-12-08 02:03:52
8eacb1ab9f3e0d268f584b6b606b73db5f0d3da9...5e6bd79321e86bd9ab4d4f2fc38ba64159e77671,3,15,15,30,10,2012-12-10 05:23:49,2012-12-10 05:23:49
5e6bd79321e86bd9ab4d4f2fc38ba64159e77671...28a136d7c2a28ba5d196c85785d769958f6dff89,3,74,20,94,7,2012-12-10 19:42:18,2012-12-10 19:42:18
28a136d7c2a28ba5d196c85785d769958f6dff89...a13328b7f4e8c9942cb5a2f5ca0f312b174e726a,1,11,1,12,2,2012-12-10 20:29:26,2012-12-07 04:50:16
a13328b7f4e8c9942cb5a2f5ca0f312b174e726a...96cd1faf6ba06776e919538a0608d58702fd064b,2,29,2,31,3,2012-12-10 23:16:23,2012-12-10 23:15:26
bc6e80073ad428c1244fb185cd3da0ee797abf50...6d06e5486c850bcfd28a4a91b0a64c37b11402f9,1,4,4,8,4,2012-10-12 23:28:39,2012-10-12 23:06:37
6d06e5486c850bcfd28a4a91b0a64c37b11402f9...ebf930425be3416a3f9fbb8b72cb2fc2dd26aa9f,1,25,11,36,9,2012-10-12 23:28:39,2012-10-12 23:22:18
ebf930425be3416a3f9fbb8b72cb2fc2dd26aa9f...4d3b4ae5cf33af115a37498d7a4d028acfd27443,2,2,2,4,2,2012-10-12 23:34:45,2012-10-12 23:34:45
4d3b4ae5cf33af115a37498d7a4d028acfd27443...d442f8750aa4406d145ef58cf5316e5651ed3a70,1,1,1,2,1,2012-10-12 23:48:04,2012-10-12 23:41:43
d442f8750aa4406d145ef58cf5316e5651ed3a70...a6ef06a275fd4f79101b194ad7dbb785036de51f,1,1,1,2,1,2012-10-12 23:48:04,2012-10-12 23:43:14
a6ef06a275fd4f79101b194ad7dbb785036de51f...bc9944e97b11085887e177edac54c828bc367b9f,3,7,7,14,3,2012-10-13 00:25:52,2012-10-13 00:25:52
bc9944e97b11085887e177edac54c828bc367b9f...dc33f7c7a3a94d0db4b838fe22c256c56b497351,1,17,10,27,4,2012-10-13 00:30:16,2012-10-13 00:15:58
dc33f7c7a3a94d0db4b838fe22c256c56b497351...a5879bad8fac17116cd8fcafa145f1c6c5688d53,1,7,0,7,1,2012-10-13 00:30:16,2012-10-13 00:26:03
a5879bad8fac17116cd8fcafa145f1c6c5688d53...e7a1d27e53b123cc94366b85b8faa834df82ad3d,1,13,5,18,5,2012-10-13 00:30:16,2012-10-13 00:29:53
e7a1d27e53b123cc94366b85b8faa834df82ad3d...09a4f4ce56f57465ea0e39208b8464013ddacead,2,2,2,4,2,2012-10-13 01:00:29,2012-10-13 01:00:08
6265b9fac512ff7fca1accfc0100c5e05c779b73...32edb4043f70f5b20a6ea7d858d6c440cd1aa97a,7,12,12,24,10,2012-10-12 16:38:20,2012-10-12 16:38:20
32edb4043f70f5b20a6ea7d858d6c440cd1aa97a...bf8890ffa26b7f9a8a0c797714e9c24f25ceb80a,2,34,1,35,2,2012-10-12 21:42:39,2012-10-12 21:40:22
d87a6384e1170bbff45d98997a343e0d39c4db66...c44c092e39c5453f8adbe4ea6b83ace614e576bd,4,9,3,12,6,2013-04-04 21:22:04,2013-04-04 21:21:04
c44c092e39c5453f8adbe4ea6b83ace614e576bd...e5a8e33dfa5b9ddd2e20f0296e6b694dc2e372ec,1,2,0,2,1,2013-04-04 22:45:57,2013-04-04 22:45:57
e0f1ae70debccc09b58a9b51f8f7950fd802ab12...c8d3e0dd8954c72cdd631b14cbe89fa5dd93dd0b,1,85,64,149,5,2013-03-15 05:20:30,2013-03-15 05:20:30
e92522c28394311d1df5d8cc81e7b3795559e36b...00c3f488370ebc0f8dce241e1b4045622e67ac0b,1,6,3,9,2,2013-03-14 22:04:35,2013-03-14 22:04:35
e92522c28394311d1df5d8cc81e7b3795559e36b...d58d5f7e800a86b729f768ace29472d6115bf525,8,10,10,20,8,2013-03-14 18:12:15,2013-03-14 18:12:15
d58d5f7e800a86b729f768ace29472d6115bf525...e5fb32dfab2351b7424a114de63826ea08aa0c51,1,9,0,9,1,2013-03-14 19:07:17,2013-03-14 19:07:17
e5fb32dfab2351b7424a114de63826ea08aa0c51...45fef52095bb6726cc1b2f05008ad891c446100a,1,5,5,10,2,2013-03-14 19:12:24,2013-03-14 19:12:24
a0c3ff709a85ec4e2b5abb945095d8ce5092514c...404ec3c998ec443bd55b41b172e85b4aab019ab9,1,0,2,2,1,2013-02-23 00:21:06,2013-02-23 00:21:06
a0c3ff709a85ec4e2b5abb945095d8ce5092514c...cc5ef1b90d56b38e1af1d1a17a535685e910153e,5,76,6,82,9,2013-02-23 00:14:41,2013-02-23 00:14:41
cc5ef1b90d56b38e1af1d1a17a535685e910153e...82945945b7159eeb6bb95a768de4cf903d918804,1,5,5,10,3,2013-02-25 18:39:24,2013-02-25 18:39:24
0a3c7e58674bc55f79785e9e660d895ae217251a...b2bf406e55d3ac1f98624ad992b4a18f4c160466,1,30,2,32,3,2013-03-07 00:41:56,2013-03-07 00:41:56
c054d165895ca851effee404aab00fed1897d759...a8349f39735d14f8f3b98232b43afe08ad1f47c1,1,1,1,2,1,2013-01-19 03:04:32,2013-01-18 15:48:40
a8349f39735d14f8f3b98232b43afe08ad1f47c1...9e66735cecf3900f7af36acd57a489cbc40478f3,3,442,158,600,148,2013-01-19 03:05:02,2013-01-16 10:06:10
9e66735cecf3900f7af36acd57a489cbc40478f3...cb78d24ee361848cabd884cf0c3bdcba3eb1449f,1,8,2,10,2,2013-01-19 03:05:15,2013-01-18 23:14:31
cb78d24ee361848cabd884cf0c3bdcba3eb1449f...a404490ceb3d1a3db5f4dce7c8f1ae1d918cec95,1,22,8,30,7,2013-01-25 23:56:19,2012-12-29 23:05:33
a404490ceb3d1a3db5f4dce7c8f1ae1d918cec95...06f1308b4be2fbceb3b776a44be186cb6fd5141f,1,18,24,42,7,2013-01-25 23:57:34,2013-01-25 23:57:34
06f1308b4be2fbceb3b776a44be186cb6fd5141f...2551d880143ffca5bcd7ef1794d02dd77928bf35,1,2,2,4,2,2013-01-26 00:29:30,2013-01-26 00:29:30
2551d880143ffca5bcd7ef1794d02dd77928bf35...d2319bc134f94c99435bc84a4c3ada658b4bd2e4,3,27,2,29,6,2013-01-26 02:48:04,2013-01-26 02:47:27
d2319bc134f94c99435bc84a4c3ada658b4bd2e4...674574564329d5a5da4b17bbb1b8d89127600c2d,4,20,18,38,9,2013-01-26 02:48:04,2013-01-16 23:20:17
674574564329d5a5da4b17bbb1b8d89127600c2d...1fa2006eb76f5eba06e7dc2e376f48f837585cd1,1,1,1,2,1,2013-01-28 21:39:47,2013-01-23 05:42:07
1fa2006eb76f5eba06e7dc2e376f48f837585cd1...b2cc217cfb34994bc18bd2b1d39f7fb4964ab22d,1,4,7,11,5,2013-01-28 21:40:02,2013-01-28 21:39:07
c054d165895ca851effee404aab00fed1897d759...bbb127c3caa026d9deb5f145227573ea3eaccdef,4,110,2,112,5,2013-01-17 20:23:19,2012-12-11 01:14:04
bbb127c3caa026d9deb5f145227573ea3eaccdef...fbc787cd1d5224a141ba0715392e0387f4fd1fac,2,159,7,166,15,2013-01-17 20:23:22,2012-12-11 20:20:21
fbc787cd1d5224a141ba0715392e0387f4fd1fac...81940c9859f58bceb7bc70655bb6144b091f7cf9,2,247,28,275,20,2013-01-17 20:23:23,2012-12-12 00:41:14
81940c9859f58bceb7bc70655bb6144b091f7cf9...6cc809b9562b32a867be122fdcb68fd06f358a8b,2,25,17,42,15,2013-01-17 20:23:23,2012-12-12 01:26:56
6cc809b9562b32a867be122fdcb68fd06f358a8b...1f122da21e7904710812d4f7cb7bc58170690898,2,19,2,21,2,2013-01-17 20:23:23,2012-12-12 18:18:14
1f122da21e7904710812d4f7cb7bc58170690898...9c96cf67189aad53c9f1c11cea0483cf3db39879,2,64,64,128,40,2013-01-17 20:23:23,2012-12-12 22:06:42
9c96cf67189aad53c9f1c11cea0483cf3db39879...c915c375c7eb0f324409647ea98f8fb41a8d7917,1,120,173,293,22,2013-01-17 20:23:23,2012-12-12 22:48:06
c915c375c7eb0f324409647ea98f8fb41a8d7917...36fe3033cbd4938e509f5bc0fa214a8c8fba72d3,2,16,6,22,7,2013-01-17 20:23:23,2012-12-12 22:48:58
36fe3033cbd4938e509f5bc0fa214a8c8fba72d3...ec8b46033a5ff0916b451d13eed2e121bb468371,2,19,14,33,12,2013-01-17 20:23:23,2012-12-12 23:00:10
ec8b46033a5ff0916b451d13eed2e121bb468371...070bfc72bac7e14787e484b7f2e2d04e0d6edfbe,1,1,1,2,1,2013-01-17 20:23:23,2012-12-12 23:05:20
070bfc72bac7e14787e484b7f2e2d04e0d6edfbe...cc2a5d3ffb3cbcbc449f21b3cebe09aa20ec54b1,2,110,63,173,22,2013-01-17 20:23:23,2012-12-13 00:50:20
cc2a5d3ffb3cbcbc449f21b3cebe09aa20ec54b1...6873f4acc13f20d1126f1213bbcfddff58ac4ee7,2,6,1,7,5,2013-01-17 20:23:23,2012-12-13 01:01:42
6873f4acc13f20d1126f1213bbcfddff58ac4ee7...052e393203a205d4388d07b81ac522cae64ed6fb,2,10,8,18,5,2013-01-17 20:23:23,2012-12-13 01:10:59
052e393203a205d4388d07b81ac522cae64ed6fb...a9104afe5bf7d7a3d21f2719742005650bedbe6f,4,183,60,243,36,2013-01-17 20:23:24,2012-12-13 21:07:37
a9104afe5bf7d7a3d21f2719742005650bedbe6f...e4395720f30320288e0853d94255f204a1305e77,1,49,48,97,30,2013-01-17 20:23:24,2012-12-13 21:29:52
e4395720f30320288e0853d94255f204a1305e77...8b44dc17579ecce1044a3acef1dae8d11d87c1ea,1,1,1,2,1,2013-01-17 20:23:24,2012-12-13 21:35:25
8b44dc17579ecce1044a3acef1dae8d11d87c1ea...0e786a41c8df1665d34dc37f3fd97d4ae3e63799,3,49,35,84,10,2013-01-17 20:23:24,2012-12-13 21:48:03
0e786a41c8df1665d34dc37f3fd97d4ae3e63799...4a1db97dc80816887b0c57c6521fadc68e035dd0,1,1,0,1,1,2013-01-17 20:23:24,2012-12-13 21:52:36
4a1db97dc80816887b0c57c6521fadc68e035dd0...8f64942dac74e6ffd78afda4e974ca10c4e7a8f0,2,2,2,4,3,2013-01-17 20:23:24,2012-12-13 22:05:05
8f64942dac74e6ffd78afda4e974ca10c4e7a8f0...001cbcb33755d4a5ecc6d1ae87b8259098b72d99,1,9,3,12,6,2013-01-17 20:23:24,2012-12-13 22:22:30
001cbcb33755d4a5ecc6d1ae87b8259098b72d99...c5659b6b5a6198250c18c3ac4a0a8fdeb145cf7a,1,1,6,7,1,2013-01-17 20:23:24,2012-12-13 22:43:33
c5659b6b5a6198250c18c3ac4a0a8fdeb145cf7a...e2129a8559977e6b50a8e199a192aa50dd9a55c1,1,22,0,22,1,2013-01-17 20:23:24,2012-12-14 00:12:39
e2129a8559977e6b50a8e199a192aa50dd9a55c1...c2e80dbdac0fb6a950eb3bbbe4163dc52af5bd94,1,14,24,38,5,2013-01-17 20:23:24,2012-12-14 23:32:28
c2e80dbdac0fb6a950eb3bbbe4163dc52af5bd94...677a43fe196d81ff175142d56ede0403f4cfd078,1,27,22,49,2,2013-01-17 20:23:24,2012-12-15 00:02:53
677a43fe196d81ff175142d56ede0403f4cfd078...daa559366ce257038a9983f28ed42469cc542fac,3,79,69,148,36,2013-01-17 20:24:28,2012-12-15 01:17:13
daa559366ce257038a9983f28ed42469cc542fac...5bf45d1ec6c21f418a8416b05c5b8b0f6ee1659c,5,126,36,162,25,2013-01-17 20:25:01,2012-12-17 23:39:49
5bf45d1ec6c21f418a8416b05c5b8b0f6ee1659c...91b1f3b15c1dccbddb4cb396f77c08611da08eac,2,10,12,22,10,2013-01-17 20:25:01,2012-12-18 01:07:35
91b1f3b15c1dccbddb4cb396f77c08611da08eac...a93567eed11da072f72d454fffa7249a6e7c97e5,6,102,115,217,51,2013-01-17 20:25:01,2012-12-18 20:19:25
a93567eed11da072f72d454fffa7249a6e7c97e5...a709cfb4ec95f988433bc8e0d2b1bd38310d2126,4,34,29,63,12,2013-01-17 20:25:01,2012-12-18 22:01:46
a709cfb4ec95f988433bc8e0d2b1bd38310d2126...f2209076e1258dd061e4552bcb85123c538a8092,2,60,65,125,38,2013-01-17 20:25:52,2012-12-21 21:40:32
f2209076e1258dd061e4552bcb85123c538a8092...48203263e3dd284926ee37c9caec64e811bf08e4,2,24,7,31,4,2013-01-17 20:29:05,2012-12-21 22:26:48
48203263e3dd284926ee37c9caec64e811bf08e4...2f57c233215afb5858fbe96dcfc16429157f7a33,1,2,2,4,2,2013-01-17 20:29:07,2013-01-02 21:57:31
2f57c233215afb5858fbe96dcfc16429157f7a33...933fe4c6fc02f9b00769a7ef598781996e59f95a,1,1,1,2,1,2013-01-17 20:29:07,2013-01-09 22:12:27
933fe4c6fc02f9b00769a7ef598781996e59f95a...5454ccbd9fd3c01c4a4a30d8add4cce71f479a63,3,168,37,205,15,2013-01-17 20:29:49,2012-12-22 04:44:28
5454ccbd9fd3c01c4a4a30d8add4cce71f479a63...3b16ca8aa6e58c76d62d53a98cc526f8b1b03562,5,64,9,73,11,2013-01-17 20:29:51,2012-12-22 05:23:36
3b16ca8aa6e58c76d62d53a98cc526f8b1b03562...1de0a87b8414e3f003c3fe11c04c50725d216619,2,69,6,75,8,2013-01-17 20:29:51,2012-12-30 19:58:46
1de0a87b8414e3f003c3fe11c04c50725d216619...33e0a52c5ca68a29c275b96359db751087b9c068,4,51,1,52,4,2013-01-17 20:30:24,2012-12-30 23:43:53
33e0a52c5ca68a29c275b96359db751087b9c068...432e8ccd98099c5d1e864cfa6e2c609d2852a21d,7,79,27,106,24,2013-01-17 20:30:25,2012-12-31 02:49:04
432e8ccd98099c5d1e864cfa6e2c609d2852a21d...f8fefe7aae47ad56a33bf069a4f54b1c89db6ec4,4,57,26,83,29,2013-01-17 20:39:57,2012-12-31 19:05:14
f8fefe7aae47ad56a33bf069a4f54b1c89db6ec4...5d93d60aa69be566a0e87cabc155469569ad8b7b,4,17,6,23,8,2013-01-17 20:41:18,2012-12-31 22:51:04
5d93d60aa69be566a0e87cabc155469569ad8b7b...05d0e200cad1962073d62eeb972d15f8b76b2d33,1,5,0,5,1,2013-01-17 20:41:20,2012-12-31 23:05:01
05d0e200cad1962073d62eeb972d15f8b76b2d33...9e130bb398eccce7281213501b166a24572194b9,4,78,62,140,13,2013-01-17 20:42:05,2013-01-02 23:42:51
9e130bb398eccce7281213501b166a24572194b9...701d76fe61f03c9dd1fe7fcf068d313a11365035,9,50,44,94,37,2013-01-17 20:42:33,2013-01-03 02:52:24
701d76fe61f03c9dd1fe7fcf068d313a11365035...3068fd1a36390035bd969ff4b2eba007dd13c46a,5,124,69,193,57,2013-01-17 20:42:34,2013-01-04 22:45:04
3068fd1a36390035bd969ff4b2eba007dd13c46a...76dba0150defa499358ef7d359f7abda27799deb,2,4,3,7,4,2013-01-17 20:42:34,2013-01-04 23:18:23
76dba0150defa499358ef7d359f7abda27799deb...e831608f86baa81537e21bd9d3028ddf27b1a340,8,39,77,116,33,2013-01-17 20:46:41,2013-01-05 02:34:17
e831608f86baa81537e21bd9d3028ddf27b1a340...2b7751fa5c95995dae5b106db5189ef31b25086c,6,63,13,76,14,2013-01-17 20:47:25,2013-01-05 02:55:41
2b7751fa5c95995dae5b106db5189ef31b25086c...c305ac8d226106170ae38d55d9585fcdcb21848d,3,81,19,100,11,2013-01-17 20:47:27,2013-01-08 00:10:40
c305ac8d226106170ae38d55d9585fcdcb21848d...e1f15e7c7f95ef091d04905d25fde54b93fc2c48,4,14,1,15,5,2013-01-17 20:47:27,2013-01-08 00:52:37
e1f15e7c7f95ef091d04905d25fde54b93fc2c48...3331e1f7d3493589308a9b8de0ba5a57b8ad6d02,12,166,187,353,80,2013-01-17 20:49:48,2013-01-08 23:55:06
3331e1f7d3493589308a9b8de0ba5a57b8ad6d02...5b4910c965f34c56b8ac6a129d73a1b012c1b057,4,83,4,87,11,2013-01-17 20:49:52,2013-01-09 01:56:40
5b4910c965f34c56b8ac6a129d73a1b012c1b057...c99c816331ae17074087d143d45d4f1f479bc34c,10,167,62,229,38,2013-01-17 20:51:56,2013-01-09 21:26:55
c99c816331ae17074087d143d45d4f1f479bc34c...7a75b8418a6166f7d14163ec5c4c725b914d3961,1,3,3,6,2,2013-01-17 20:51:57,2013-01-09 21:53:01
7a75b8418a6166f7d14163ec5c4c725b914d3961...4740d17e1d8fc91bcb540a4ec98558399bd4c10c,3,93,27,120,30,2013-01-17 20:51:57,2013-01-10 19:26:29
4740d17e1d8fc91bcb540a4ec98558399bd4c10c...3de2dbe4d98f05d7b8bc5d60d0d7740e7a082001,2,1,2,3,2,2013-01-17 20:51:58,2013-01-10 20:06:17
3de2dbe4d98f05d7b8bc5d60d0d7740e7a082001...ca0719b22d34f4919a27c60987a011a6a314e695,1,23,11,34,8,2013-01-17 20:51:58,2013-01-10 07:31:21
ca0719b22d34f4919a27c60987a011a6a314e695...258a64d751b1aee7b2746c36c815b84094cf3d44,1,54,49,103,16,2013-01-17 20:51:58,2013-01-10 20:12:29
258a64d751b1aee7b2746c36c815b84094cf3d44...751fe0e144a01ed5733c44a823c61d1ec38a19c5,3,107,15,122,22,2013-01-17 20:51:58,2013-01-10 20:36:34
751fe0e144a01ed5733c44a823c61d1ec38a19c5...8ae6e71715a65e907500c410436ef0200f04b028,4,49,3,52,6,2013-01-17 20:51:58,2013-01-10 22:50:56
8ae6e71715a65e907500c410436ef0200f04b028...950f1e0213f89f0334c33eb17a4b30ac32fc1cec,4,191,0,191,5,2013-01-17 20:51:58,2013-01-11 23:53:02
950f1e0213f89f0334c33eb17a4b30ac32fc1cec...9fe782ab15a226f6305c69449a32790a4788f7b8,9,233,206,439,13,2013-01-17 20:51:58,2013-01-12 00:50:35
9fe782ab15a226f6305c69449a32790a4788f7b8...be8c94c8997aec9eb4b9f22546b14940c0f705cb,12,79,68,147,43,2013-01-17 20:55:41,2013-01-12 01:53:00
be8c94c8997aec9eb4b9f22546b14940c0f705cb...24c4b0615db34cd2109ef7f8580fb39fb10d1170,6,67,66,133,13,2013-01-17 20:56:12,2013-01-14 21:09:26
24c4b0615db34cd2109ef7f8580fb39fb10d1170...20145a7f42aca1c1484a0c7bd6a1325a8da3f9a8,3,172,65,237,12,2013-01-17 20:56:13,2013-01-14 23:50:00
20145a7f42aca1c1484a0c7bd6a1325a8da3f9a8...deb06b627efc339d67989944b579b7cf1086133d,3,65,55,120,29,2013-01-17 20:56:13,2013-01-15 01:50:28
deb06b627efc339d67989944b579b7cf1086133d...4f7808084582112a6e1ebe0f75d58e19463322ce,2,6,12,18,7,2013-01-17 20:56:14,2013-01-16 21:12:12
4f7808084582112a6e1ebe0f75d58e19463322ce...86e4f9b00f58d31fc054d358c8b9316ba56e3c46,3,27,1,28,3,2013-01-17 20:56:14,2013-01-16 21:38:11
86e4f9b00f58d31fc054d358c8b9316ba56e3c46...f3d5ba81e72f47e3be113f63fcb80dd55876a61d,5,21,14,35,10,2013-01-17 21:27:51,2013-01-17 21:07:24
f3d5ba81e72f47e3be113f63fcb80dd55876a61d...89433b592403947d8e813932118088c3f6a2fe25,7,251,26,277,13,2013-01-18 07:58:22,2013-01-18 07:58:22
89433b592403947d8e813932118088c3f6a2fe25...65bec10df56f8bc01781c434ae1f21c70d7febbd,8,237,127,364,18,2013-01-22 06:59:16,2013-01-22 06:59:16
65bec10df56f8bc01781c434ae1f21c70d7febbd...378e7c9fe50bb912962ed6e9e0114b39e272ed42,1,4,3,7,4,2013-01-22 19:05:52,2013-01-22 19:05:52
378e7c9fe50bb912962ed6e9e0114b39e272ed42...9506846da726d8256f6ff3cf9da03b0c5ecea8ea,1,8,17,25,4,2013-01-22 19:53:27,2013-01-22 19:53:27
9506846da726d8256f6ff3cf9da03b0c5ecea8ea...7b5d3887466f17c206b79db9963619cb0d7db495,2,22,33,55,8,2013-01-22 22:26:43,2013-01-22 22:26:43
7b5d3887466f17c206b79db9963619cb0d7db495...c10c7f7c9131ff7c45342cf11c8f51085cbbcf71,6,117,2,119,9,2013-01-24 22:47:37,2013-01-24 22:47:37
c10c7f7c9131ff7c45342cf11c8f51085cbbcf71...f65b5c738d416ab188ebc39fcde5fdad932ec502,4,177,4,181,9,2013-01-26 00:07:14,2013-01-26 00:07:14
f65b5c738d416ab188ebc39fcde5fdad932ec502...06c0d7b216bbf0f665db52ea8a22278c7b486697,1,3,9,12,6,2013-01-26 00:09:04,2013-01-26 00:09:04
06c0d7b216bbf0f665db52ea8a22278c7b486697...5e400d373bc178a4a727ba0e7416233e64bfcf9d,1,289,0,289,1,2013-01-28 23:25:16,2013-01-28 23:25:16
5e400d373bc178a4a727ba0e7416233e64bfcf9d...19849adbe49a0e991f1555b2d8f39b841cfaccb4,1,11,0,11,1,2013-01-28 23:26:04,2013-01-28 23:26:04
19849adbe49a0e991f1555b2d8f39b841cfaccb4...3991827a9d579284b84299481fdb6c7a830980af,3,170,116,286,16,2013-01-29 01:23:39,2013-01-29 01:23:39
96cd1faf6ba06776e919538a0608d58702fd064b...11f98e0748a11b05e9132848c7a1437aa6761f47,5,395,0,395,5,2012-12-10 23:27:09,2012-12-10 23:27:09
09a4f4ce56f57465ea0e39208b8464013ddacead...1e057908dfd4b0dc65cb21d9f640faa2088598f1,2,161,155,316,13,2012-10-13 01:16:16,2012-10-13 01:14:48
1e057908dfd4b0dc65cb21d9f640faa2088598f1...f786845ccac9b9a0ef1278b29421b228b4b08d6d,2,35,26,61,9,2012-10-13 03:03:31,2012-10-13 03:03:31
f786845ccac9b9a0ef1278b29421b228b4b08d6d...e202827ac247635f124bec0ecb1d91797bb6b189,1,21,11,32,5,2012-10-13 04:06:59,2012-10-13 04:06:44
09a4f4ce56f57465ea0e39208b8464013ddacead...f41e1b358c1309d9718c97aad3816ffbb07e307b,9,7495,0,7495,9,2012-10-13 01:01:06,2012-10-12 21:28:12
f41e1b358c1309d9718c97aad3816ffbb07e307b...13622e50478cf7281d59c0065e8d8796af989451,1,1,1,2,1,2012-10-13 01:01:06,2012-10-12 21:35:42
13622e50478cf7281d59c0065e8d8796af989451...2d9b06c07e7d001f7332395c7022537fa73e4d00,1,1,1,2,1,2012-10-13 01:01:06,2012-10-13 00:58:16
2d9b06c07e7d001f7332395c7022537fa73e4d00...c41a334a5f8d7c18a8100c241306e47073c8e6f1,3,7,2,9,3,2012-10-13 01:01:07,2012-10-13 00:59:49
c41a334a5f8d7c18a8100c241306e47073c8e6f1...d8e473701d22b0d302501c594e0d99960f10f8e9,3,48,36,84,19,2012-10-13 05:42:07,2012-10-13 05:42:07
d8e473701d22b0d302501c594e0d99960f10f8e9...8064812225f0bd2d859e689c2c8d80c2cee14d1e,1,6,6,12,4,2012-10-13 06:18:09,2012-10-13 06:18:09
8064812225f0bd2d859e689c2c8d80c2cee14d1e...3293ee0410ae2d553ab244eb1736feb72b4518b1,1,4,0,4,1,2012-10-13 06:21:59,2012-10-13 06:21:59
3293ee0410ae2d553ab244eb1736feb72b4518b1...e606a9b20a858e98b480387bad08db7736a9b698,1,10,3,13,4,2012-10-13 07:03:17,2012-10-13 07:03:17
e606a9b20a858e98b480387bad08db7736a9b698...40c1104bbb3ed447ea4eb68ab628a28bb9142260,4,8,3,11,4,2012-10-13 20:19:43,2012-10-13 20:19:43
40c1104bbb3ed447ea4eb68ab628a28bb9142260...f112ffac6b444d5b33dca66a4a3343a16d2cb91b,2,8,1,9,2,2012-10-13 20:24:23,2012-10-13 20:24:23
f112ffac6b444d5b33dca66a4a3343a16d2cb91b...ae6838dce4be4be8a1447da7bccbc063687d9cf5,4,8,3,11,5,2012-10-14 06:02:07,2012-10-14 06:02:07
ae6838dce4be4be8a1447da7bccbc063687d9cf5...17bf9cc5c843445c23df03b0278c9438fc130509,1,1,1,2,1,2012-10-14 07:24:27,2012-10-14 07:24:27
17bf9cc5c843445c23df03b0278c9438fc130509...e17412a18d7f6d670a37c6db53856063cd7f651b,4,95,21,116,23,2012-10-15 01:35:36,2012-10-15 01:35:36
e17412a18d7f6d670a37c6db53856063cd7f651b...d4b9da1d291dfddccde3e651daafbdb69b5de4c8,1,0,0,0,0,2012-10-15 02:12:51,2012-10-15 02:12:51
d4b9da1d291dfddccde3e651daafbdb69b5de4c8...e9a1bd0091fd27f295f13c41a59c32f57314eeed,5,7052,0,7052,5,2012-10-15 02:59:53,2012-10-15 02:59:53
e9a1bd0091fd27f295f13c41a59c32f57314eeed...dd0115424723c97eddf417da9d6e4fc88608760e,2,1,7034,7035,2,2012-10-15 03:00:04,2012-10-15 03:00:04
dd0115424723c97eddf417da9d6e4fc88608760e...7a3dbea1d06f16dc724688a86fc0878365a6c90d,1,7,11,18,4,2012-10-15 04:09:12,2012-10-15 04:09:12
7a3dbea1d06f16dc724688a86fc0878365a6c90d...631bc8352b9df9a37c0f6b6a2e24a92c633b588a,5,125,52,177,19,2012-10-15 06:36:32,2012-10-15 03:33:19
631bc8352b9df9a37c0f6b6a2e24a92c633b588a...807a46791f6ad22d7f6e62018deddc5841b30269,3,144,82,226,39,2012-10-15 06:38:46,2012-10-15 06:35:41
807a46791f6ad22d7f6e62018deddc5841b30269...c8be9ec0d9221f5679d8a6c9a9cfb17f884cf0ca,1,1,1,2,1,2012-10-15 16:24:45,2012-10-15 16:24:45
1dfc7171f237a029cca74cbf25024acbf6ed5b75...2ffb185e47f77a41ee0a794f225155fe9356bc78,1,4,2,6,1,2013-04-24 17:33:51,2013-04-24 16:44:38
2ffb185e47f77a41ee0a794f225155fe9356bc78...0bb71ff8711edef4bed73c5d0c1a750367afa882,1,5,1,6,2,2013-04-24 17:34:05,2013-04-24 16:55:59
0bb71ff8711edef4bed73c5d0c1a750367afa882...0dad6e4dc4ba9dd5137c34220c6ca91b8ad254a8,1,4,0,4,1,2013-04-24 17:35:36,2013-04-24 17:01:23
0dad6e4dc4ba9dd5137c34220c6ca91b8ad254a8...21ae0ebeb86f9452756081f526ba1912d0aa7c25,1,5,0,5,2,2013-04-24 17:36:20,2013-04-24 17:04:41
21ae0ebeb86f9452756081f526ba1912d0aa7c25...29ddfc6f3c6b41a694111780ede1400639db1b0c,1,10,6,16,4,2013-04-24 17:46:44,2013-04-24 17:46:44
1dfc7171f237a029cca74cbf25024acbf6ed5b75...b4d96d57957d0f990fd5e9752f0428235a2c102c,1,4,2,6,1,2013-04-24 16:44:38,2013-04-24 16:44:38
b4d96d57957d0f990fd5e9752f0428235a2c102c...e43c94ee2e993c40721956c481d6fcc3485c3093,1,5,1,6,2,2013-04-24 16:56:02,2013-04-24 16:55:59
880005816100f0b817f05d3c401f29e5f14fa643...977d34c1f3ffc8872725cf48edfacf606ff28ff0,1,2,2,4,2,2013-04-08 18:17:07,2013-04-08 18:17:07
977d34c1f3ffc8872725cf48edfacf606ff28ff0...af89ff5000d3949ec3291c0ec819477f39c4afd1,2,59,53,112,6,2013-04-08 21:47:25,2013-04-08 21:47:25
e5a8e33dfa5b9ddd2e20f0296e6b694dc2e372ec...c786d2483403aaaed13d1cb59d7b8816986b8b19,2,30,5,35,7,2013-04-06 06:10:52,2013-04-05 17:03:03
c786d2483403aaaed13d1cb59d7b8816986b8b19...57c14264fce28583139d06c894a72b8626ff27f3,1,4,0,4,1,2013-04-07 23:06:00,2013-04-07 22:14:22
57c14264fce28583139d06c894a72b8626ff27f3...dc783ba4b1bea5f315d080dbb42472c3c1cb0027,1,5,0,5,1,2013-04-07 23:09:07,2013-04-07 23:09:07
dc783ba4b1bea5f315d080dbb42472c3c1cb0027...b9044595618c25e345b22f755ca6ad80f711963f,1,13,0,13,1,2013-04-08 14:04:33,2013-04-08 14:04:33
b9044595618c25e345b22f755ca6ad80f711963f...505ade3025fafebcee39d5e11ff89a575166e4bd,2,8,1,9,3,2013-04-08 16:58:09,2013-04-08 16:58:09
e5a8e33dfa5b9ddd2e20f0296e6b694dc2e372ec...524f5320b6b54c91c648fe2c6b7d51640f6a67e5,3,43,16,59,3,2013-04-06 01:19:59,2013-04-05 10:42:38
524f5320b6b54c91c648fe2c6b7d51640f6a67e5...6773df4b56b4e6f857a159b197d2551fa7b0181e,1,14,14,28,1,2013-04-06 01:19:59,2013-04-05 20:32:11
6773df4b56b4e6f857a159b197d2551fa7b0181e...fd6896a52904774e4c0ac2130b9abd553b698611,2,90,26,116,19,2013-04-06 01:19:59,2013-04-06 00:47:53
fd6896a52904774e4c0ac2130b9abd553b698611...18855c11594405cabb006af6da024e7f64bbfa59,4,99,42,141,14,2013-04-06 01:19:59,2013-04-06 01:18:57
18855c11594405cabb006af6da024e7f64bbfa59...61f59d693ddd0c0d9b6d2a684fc7a8aa93c4ac26,1,6,0,6,1,2013-04-06 01:22:50,2013-04-06 01:22:50
e5a8e33dfa5b9ddd2e20f0296e6b694dc2e372ec...8131a4160c480f97a69387c646927674aac648c6,1,15,6,21,8,2013-04-05 04:47:09,2013-04-05 04:47:09
c1ece21051ec44e8ea72aa7a75648610bb1dfbcd...5f7cd81eebb4cdf10d8e3f864ac5ee37464f6578,2,6,1,7,2,2013-03-12 05:34:05,2013-03-12 05:34:05
b2cc217cfb34994bc18bd2b1d39f7fb4964ab22d...5a54a5c79f71b7449c58d7ee809086bc0a542a15,4,5,5,10,5,2013-01-30 17:55:47,2013-01-30 17:55:47
3991827a9d579284b84299481fdb6c7a830980af...a03b09bbcd0708ee6fb309c1705b0572788f953a,1,77,14,91,18,2013-01-29 23:38:54,2013-01-29 23:38:54
a03b09bbcd0708ee6fb309c1705b0572788f953a...d9400b6e1bc45fdc053809313304509f96bbe614,1,36,10,46,11,2013-01-30 00:46:24,2013-01-30 00:46:24
3991827a9d579284b84299481fdb6c7a830980af...ed0e84c4c8519b0a0cbd34662ce26c1c789fa918,2,20,1,21,2,2013-01-29 01:32:00,2013-01-28 22:16:56
ed0e84c4c8519b0a0cbd34662ce26c1c789fa918...afbebfe9772e33a39fced650aaf6045b77b4f6a2,1,22,30,52,4,2013-01-29 06:33:51,2013-01-29 06:33:51
e3631254015d44296ff2d5cc06656431be5f37d2...8e06069b2a9c6862661a23ba31db3d22b7a1122e,2,6,12,18,7,2013-01-16 21:12:12,2013-01-16 21:12:12
a91211b77680d2d70ed20828c54004c7b5ff6464...a0dbb1b289a58f77c015ffe252a4382a33e6a8a6,3,27,1,28,3,2013-01-16 21:38:11,2013-01-16 21:38:11
a0dbb1b289a58f77c015ffe252a4382a33e6a8a6...42fd9027e1ae1869cd1f3289aab7c6e971c4299f,4,203,8,211,8,2013-01-16 22:39:18,2013-01-16 22:39:18
42fd9027e1ae1869cd1f3289aab7c6e971c4299f...7c7ff4f010ec7c95c56135010f9ef12f0e80f790,2,31,1,32,3,2013-01-16 23:18:47,2013-01-16 23:18:47
7c7ff4f010ec7c95c56135010f9ef12f0e80f790...ac90976a3281d582e15a4da45777ac76aab588f9,1,30,0,30,1,2013-01-17 05:29:14,2013-01-17 05:29:14
11f98e0748a11b05e9132848c7a1437aa6761f47...ae07218515a84ee2bb5e9df1226620c2fde897e1,7,66,65,131,10,2012-12-11 08:17:28,2012-12-11 08:17:28
ae07218515a84ee2bb5e9df1226620c2fde897e1...e2743eeab040920478d23307ec473a4001d645a3,1,21,0,21,1,2012-12-12 20:05:52,2012-12-09 18:10:19
e2743eeab040920478d23307ec473a4001d645a3...da4699288da28fd9af524804ff4c52a212735469,1,21,13,34,6,2012-12-12 20:17:53,2012-12-12 20:17:53
11f98e0748a11b05e9132848c7a1437aa6761f47...440d386ba135fafe550d6c73a542a4fb92f02ade,1,15,7,22,6,2012-12-11 05:07:13,2012-12-11 05:07:13
440d386ba135fafe550d6c73a542a4fb92f02ade...0b1ced1aa26f78102513cce21b277164cce781d9,1,1,1,2,1,2012-12-12 01:00:11,2012-12-12 01:00:11
e202827ac247635f124bec0ecb1d91797bb6b189...2033728f29e186a508dd3c2f8c2bee7bda747d96,2,9,4,13,3,2012-10-13 05:42:54,2012-10-13 05:42:41
e202827ac247635f124bec0ecb1d91797bb6b189...6dfb9761044cb47856d76036566c53af56c4bb6b,9,12,10,22,9,2012-10-13 04:17:18,2012-10-13 04:17:18
6dfb9761044cb47856d76036566c53af56c4bb6b...4039920f8384f30ee8b624ac851dcb7639b3548a,1,2,2,4,2,2012-10-13 22:11:05,2012-10-13 22:11:05
4039920f8384f30ee8b624ac851dcb7639b3548a...7df9322289c947b97e26d56d6298a305f486b2b0,1,2,3,5,2,2012-10-13 22:19:44,2012-10-13 22:19:44
7df9322289c947b97e26d56d6298a305f486b2b0...de864adddc99f6ffeaa5ef08fabae7f5c91701b5,1,6,5,11,1,2012-10-14 02:44:19,2012-10-09 11:08:13
de864adddc99f6ffeaa5ef08fabae7f5c91701b5...0a89f9408d003af65cf0ace3f332346d74b85a92,16,90,91,181,67,2012-10-14 04:31:55,2012-10-14 03:39:24
0a89f9408d003af65cf0ace3f332346d74b85a92...91c76dcc3a628a6c0c3dcdfc4f239ee93131ad38,1,2,2,4,1,2012-10-14 04:36:17,2012-10-14 03:41:34
91c76dcc3a628a6c0c3dcdfc4f239ee93131ad38...5143581658fc72d1dfa63aa3554bd37336d3748a,1,52,35,87,16,2012-10-15 17:09:37,2012-10-15 17:09:37
5143581658fc72d1dfa63aa3554bd37336d3748a...ef8e61fca0718c1cea6ccde8f459e8aa50b6d1ed,3,39,25,64,13,2012-10-15 17:49:20,2012-10-15 17:22:58
70b4cbcf363b66e5866e25577ac8d8c8f8c8917d...f119348d9cda7d764a35165984775cc6e0fb06d7,1,1,2,3,1,2012-10-15 17:52:18,2012-10-15 17:52:18
f119348d9cda7d764a35165984775cc6e0fb06d7...5b3293192f3cd278050dbad85be00827324cf9ea,5,46,15,61,14,2012-10-16 02:38:15,2012-10-16 02:38:15
5b3293192f3cd278050dbad85be00827324cf9ea...4e7246320e6fa1cd46afe360908a78b63dc68a25,2,13,5,18,6,2012-10-16 03:25:57,2012-10-16 03:25:57
1e9b9480d171114e0bb4c09f31ccc9afac74a898...bfe4b72ebec4367eaddcdf0887fcf5e649d9dcb8,2,2,2,4,2,2013-04-26 03:28:24,2013-04-26 03:28:24
29ddfc6f3c6b41a694111780ede1400639db1b0c...088db861fc0f030f8ad28bc580848d6a14e92385,1,3,3,6,1,2013-05-04 16:44:18,2013-04-23 18:14:26
088db861fc0f030f8ad28bc580848d6a14e92385...c6dd83bff5e25b57320f89a8d7985b57eb3c6706,1,20,1,21,1,2013-05-04 16:44:25,2013-05-03 20:42:40
29ddfc6f3c6b41a694111780ede1400639db1b0c...97b4ed263d2a0a036d9d8ab581dffe998fee928f,7,11,9,20,8,2013-04-24 18:10:16,2013-04-24 18:10:16
cd6427fa5c16d3d2e0dbcd3e6ab54566e5403dfe...bd421582b8a7322bee21ca78a204673da26d5ccb,1,3,0,3,1,2013-04-24 17:01:23,2013-04-24 17:01:23
bd421582b8a7322bee21ca78a204673da26d5ccb...356301f7d01251e8c1f1629242292b96a5fb35f2,1,3,0,3,1,2013-04-24 17:04:41,2013-04-24 17:04:41
356301f7d01251e8c1f1629242292b96a5fb35f2...1a7c2d81fd7a909db5b4c1d1a00ff6c8675bfcfc,1,7,8,15,1,2013-04-24 18:50:50,2013-04-24 18:50:50
0b51590f3d7f95727c4e04d5b2955cca355d133d...eb90df2f8dabd51d64270ddfa005a69a987963cb,1,41,42,83,4,2013-04-16 20:34:22,2013-04-16 20:34:22
af89ff5000d3949ec3291c0ec819477f39c4afd1...438bd6f6940dbc8364638165c970f950df59bb82,9,14,25,39,4,2013-04-09 00:58:35,2013-03-28 12:34:32
438bd6f6940dbc8364638165c970f950df59bb82...e710338a9490adbcfd0519d8dbfe1d3b34cb4ab9,2,1,1,2,1,2013-04-09 00:58:35,2013-03-28 12:36:34
e710338a9490adbcfd0519d8dbfe1d3b34cb4ab9...71dd67b90d50998acda6223a15252a005dec7627,3,314,3,317,4,2013-04-09 00:58:35,2013-03-28 13:14:02
71dd67b90d50998acda6223a15252a005dec7627...2bcd692b54075be7eaf55d804c5f018c5b15f3f5,1,23,17,40,3,2013-04-09 00:58:35,2013-03-28 13:26:36
2bcd692b54075be7eaf55d804c5f018c5b15f3f5...07af6a4243ea0638a3c2f5cb667500e7426dcebe,1,2,2,4,2,2013-04-09 00:58:35,2013-03-28 13:31:30
07af6a4243ea0638a3c2f5cb667500e7426dcebe...993b361b178f7468eb6f20b1b72ca530c67f0640,6,13,13,26,13,2013-04-09 00:58:35,2013-03-28 13:36:03
993b361b178f7468eb6f20b1b72ca530c67f0640...0fbb20e9be0340c55b6fee07d657480ecd9b5045,5,37,5,42,10,2013-04-09 00:58:35,2013-03-28 19:32:12
0fbb20e9be0340c55b6fee07d657480ecd9b5045...e2ac47b4514c480bc04507e1157ec01affde5ba5,5,78,62,140,7,2013-04-09 00:58:35,2013-03-30 01:24:03
e2ac47b4514c480bc04507e1157ec01affde5ba5...272710b1a8b25729c8aeb55ce35501fb34cc964d,5,290,410,700,36,2013-04-09 00:58:35,2013-04-01 19:08:41
272710b1a8b25729c8aeb55ce35501fb34cc964d...cb92684e50b354566bbe290829d38c332387bc25,7,136,114,250,36,2013-04-09 00:58:36,2013-04-02 00:02:56
cb92684e50b354566bbe290829d38c332387bc25...7112a8eb4bd7355ef8b3e90468a4a88411a4c9a2,1,52,0,52,1,2013-04-09 00:58:36,2013-04-02 01:07:31
7112a8eb4bd7355ef8b3e90468a4a88411a4c9a2...0fde3825e3e1aa6229b24ab7a58cca04599fef5a,2,43,36,79,25,2013-04-09 00:58:36,2013-04-04 21:19:51
0fde3825e3e1aa6229b24ab7a58cca04599fef5a...fe6f40774d68fbb333bb90a2e772f938940045a6,2,14,8,22,2,2013-04-09 01:39:17,2013-04-09 01:39:17
fe6f40774d68fbb333bb90a2e772f938940045a6...0a3146d88dab68137160367d9c8da18e4e29cc9a,6,57,51,108,29,2013-04-09 18:56:22,2013-04-09 18:56:22
505ade3025fafebcee39d5e11ff89a575166e4bd...055cd82f2e73011026047d6db6bde6c8846d6fdc,1,1,1,2,1,2013-04-08 17:05:14,2013-04-08 17:05:14
055cd82f2e73011026047d6db6bde6c8846d6fdc...a163c78dd08de63157bf05f60526d338db444d2b,8,10,20,30,8,2013-04-08 17:42:07,2013-04-08 17:42:07
bcc675e40a802907ae65d3510b9c0a4309f21320...3c16c146d3b93d208bf14f8e44196c56da98f1c0,1,18,1,19,1,2013-02-25 20:20:56,2013-02-24 10:54:48
3c16c146d3b93d208bf14f8e44196c56da98f1c0...939aef972ff171c4ce552f1fb6a2876d56843815,1,12,15,27,4,2013-02-25 20:29:20,2013-02-25 20:29:20
939aef972ff171c4ce552f1fb6a2876d56843815...5bdb378f8df3336fbd793afb7042c302b4be83a6,2,4,2,6,3,2013-02-25 21:41:13,2013-02-25 20:27:25
cc6d08b94fd8915ce78fc02fa7997cbf83a1bbac...6616d9aac618878421f4db0e70cae5d7a37f4cb4,3,4,4,8,3,2013-01-31 19:59:01,2013-01-31 19:59:01
3de4f2d34c5ef44c615029defa8884213245fe0b...62e83ec2bc6036ef88b48e9ccfec6467ece33369,4,54,35,89,23,2013-01-30 06:36:13,2013-01-29 21:57:57
f2478405366649357e057a07b047ea71e9851dba...06a3e237305292b7a796dbddc8f0eceec8b59c04,4,23,10,33,4,2012-12-12 20:53:39,2012-12-12 01:27:37
06a3e237305292b7a796dbddc8f0eceec8b59c04...7724c7ef7f1f5580e10fcd20722b9b16228d20cd,2,8,14,22,7,2012-12-12 20:53:39,2012-12-12 01:58:42
7724c7ef7f1f5580e10fcd20722b9b16228d20cd...69459b8c704c237c7f00f66cdde145230e0f393a,1,1,0,1,1,2012-12-12 20:53:39,2012-12-12 19:48:44
69459b8c704c237c7f00f66cdde145230e0f393a...cd250f094509fa99f707bb35dc612aa800156ff4,2,12,6,18,4,2012-12-12 20:55:44,2012-12-12 20:54:48
ef8e61fca0718c1cea6ccde8f459e8aa50b6d1ed...a7a4e1b50cceec2dfaeb89251c6c21ee49eb73bd,1,2,8,10,1,2012-10-15 17:57:34,2012-10-15 17:57:34
a7a4e1b50cceec2dfaeb89251c6c21ee49eb73bd...72731ddda0464627c2d04d709f8fd0e09eec4262,15,90,98,188,38,2012-10-15 18:16:53,2012-10-15 18:16:53
72731ddda0464627c2d04d709f8fd0e09eec4262...1fe86fa93a8fe1835878dadccdc3856d1e696ed7,1,7,0,7,1,2012-10-15 18:21:21,2012-10-15 18:21:21
1fe86fa93a8fe1835878dadccdc3856d1e696ed7...ddf870717b5a39398511ea6ac76be38334448330,2,10,10,20,2,2012-10-15 18:27:01,2012-10-15 18:27:01
ddf870717b5a39398511ea6ac76be38334448330...dc632fcfa148310a84ba53948f7c8ff2817f104a,1,2,2,4,2,2012-10-15 18:29:19,2012-10-15 18:29:19
dc632fcfa148310a84ba53948f7c8ff2817f104a...4d4b504e172ba6a6d2826fdcbb5e4da0d337951d,1,13,6,19,3,2012-10-15 18:37:06,2012-10-15 18:37:06
4d4b504e172ba6a6d2826fdcbb5e4da0d337951d...a9af320aba335a25eb3202a562f8af029fcf042b,1,1,1,2,1,2012-10-15 18:38:00,2012-10-15 18:38:00
a9af320aba335a25eb3202a562f8af029fcf042b...907b6ee91ab14eba4b7073e158d63bc4f94bdee9,2,12,2,14,3,2012-10-15 18:55:31,2012-10-15 18:55:31
907b6ee91ab14eba4b7073e158d63bc4f94bdee9...b59ab5dfa5db3bff0a0eaeae6963f445d9425d87,1,1,1,2,1,2012-10-15 18:56:38,2012-10-15 18:56:38
b59ab5dfa5db3bff0a0eaeae6963f445d9425d87...54cc29997820555cc5a7215b80de61fc69e1acd4,1,3,2,5,1,2012-10-15 18:59:50,2012-10-15 18:59:50
54cc29997820555cc5a7215b80de61fc69e1acd4...7d4d5e3a53f46f8d072566a5b2fa06e2d3a0bbec,1,4,8,12,2,2012-10-15 19:04:27,2012-10-15 19:04:27
7d4d5e3a53f46f8d072566a5b2fa06e2d3a0bbec...033dbee8897c3ae94ac8bb4efdf091a160b78ae4,1,2,2,4,1,2012-10-15 19:04:51,2012-10-15 19:04:51
033dbee8897c3ae94ac8bb4efdf091a160b78ae4...10bad07074d3e1d329aca1b8faa83778f583ec82,1,6,6,12,1,2012-10-15 19:08:31,2012-10-15 19:08:31
10bad07074d3e1d329aca1b8faa83778f583ec82...28ebec8b0f9674e3ad3e03dc5a5e63fa8cf85b73,1,4,3,7,1,2012-10-15 19:13:53,2012-10-15 19:13:53
28ebec8b0f9674e3ad3e03dc5a5e63fa8cf85b73...072e117122825f151dfe34800baf018efdf5359c,2,12,9,21,5,2012-10-15 19:18:24,2012-10-15 19:18:24
072e117122825f151dfe34800baf018efdf5359c...2a1754f69cd089ad3b6e446c1827cca2ca4c80f4,1,2,1,3,1,2012-10-15 19:19:35,2012-10-15 19:19:35
2a1754f69cd089ad3b6e446c1827cca2ca4c80f4...b6d7d7817c341cb273f42a9b2a1d19ad59781964,1,2,2,4,2,2012-10-15 20:52:44,2012-10-15 20:52:44
b6d7d7817c341cb273f42a9b2a1d19ad59781964...ea992c61f62d083cb2ef5ddef4a168ac5f5b99a0,1,3,4,7,2,2012-10-15 21:00:23,2012-10-15 21:00:23
ea992c61f62d083cb2ef5ddef4a168ac5f5b99a0...6ea9c0631f168939c115b85eefdee383f09803bf,1,6,6,12,2,2012-10-15 22:01:04,2012-10-15 22:01:04
6ea9c0631f168939c115b85eefdee383f09803bf...b9a3f34377f2ff75afc608d20e36e477cfa01f8c,2,663,664,1327,201,2012-10-15 22:03:25,2012-10-15 22:03:25
b9a3f34377f2ff75afc608d20e36e477cfa01f8c...14e164567246bb44b70a1dd663d900529774bda7,1,2,2,4,2,2012-10-15 22:20:52,2012-10-15 22:20:52
14e164567246bb44b70a1dd663d900529774bda7...9669e5f6de760c0dc8805dffa7465ae0f8f7fac7,1,1,1,2,1,2012-10-15 22:22:38,2012-10-15 22:22:38
9669e5f6de760c0dc8805dffa7465ae0f8f7fac7...ac2262db726782928745b753958c4eae9df7512e,1,1,1,2,1,2012-10-15 22:46:09,2012-10-15 22:46:09
ac2262db726782928745b753958c4eae9df7512e...b53e2dcbb9284eb5aeb970b388412b58c5e2a5e3,1,1,1,2,1,2012-10-15 22:46:49,2012-10-15 22:46:49
b53e2dcbb9284eb5aeb970b388412b58c5e2a5e3...6e58cf7dae8ee5b65c831341f91249eea26791ec,8,117,11,128,20,2012-10-15 22:57:12,2012-10-15 21:42:19
6e58cf7dae8ee5b65c831341f91249eea26791ec...e3a1f7f4284f307cf910504f36febc010c83aa0e,4,24,22,46,13,2012-10-15 23:12:09,2012-10-15 23:12:09
e3a1f7f4284f307cf910504f36febc010c83aa0e...2e7697e9a04bb4263320fe4e56addbdca9b96dfe,1,14,6,20,5,2012-10-15 23:15:58,2012-10-15 23:06:20
2e7697e9a04bb4263320fe4e56addbdca9b96dfe...93090b846cb76aab8c63cfb91382950bad2dfa9a,2,2,2,4,2,2012-10-15 23:18:25,2012-10-15 23:18:25
93090b846cb76aab8c63cfb91382950bad2dfa9a...ef634e216e1b1c475d9a135c5f65d4da7313b4e8,1,1,1,2,1,2012-10-15 23:19:18,2012-10-15 23:19:02
ef634e216e1b1c475d9a135c5f65d4da7313b4e8...8d1e4afc0e314e90c01865070dda1205eaa815b9,1,10,9,19,4,2012-10-15 23:26:07,2012-10-15 23:26:07
8d1e4afc0e314e90c01865070dda1205eaa815b9...8460c028b902801f8843036713d8b0bd347e7e19,3,145,139,284,6,2012-10-15 23:33:29,2012-10-15 23:33:29
8460c028b902801f8843036713d8b0bd347e7e19...c86a4724f3e18df6298cc1039b1c19e0c720c4cb,1,2,9,11,2,2012-10-15 23:34:23,2012-10-15 23:33:45
c86a4724f3e18df6298cc1039b1c19e0c720c4cb...fe70fbd60b9b961846b2b9d4074743df39943a64,1,4,1,5,2,2012-10-15 23:46:39,2012-10-15 23:46:39
fe70fbd60b9b961846b2b9d4074743df39943a64...ad1656b2cf516dda4f5df5a3cd8536676fb68037,5,7052,0,7052,5,2012-10-15 23:48:23,2012-10-15 02:59:53
ad1656b2cf516dda4f5df5a3cd8536676fb68037...0bfbbc13c2a6ffe096b76140a417021bad8bff05,1,1,1,2,1,2012-10-15 23:51:49,2012-10-15 23:51:49
0bfbbc13c2a6ffe096b76140a417021bad8bff05...957c2860402ff2b82f5ebcb5f578cfcdc93c06df,1,32,0,32,1,2012-10-15 23:56:35,2012-10-15 23:56:35
957c2860402ff2b82f5ebcb5f578cfcdc93c06df...b1852a376e01842ac39b68638d9b8ab59e7d0efd,1,3,0,3,1,2012-10-16 00:19:42,2012-10-16 00:19:42
b1852a376e01842ac39b68638d9b8ab59e7d0efd...02f7512da6b0a965c5d0b6845003fb5b1fcb3fc0,1,1,1,2,1,2012-10-16 00:29:47,2012-10-16 00:29:47
02f7512da6b0a965c5d0b6845003fb5b1fcb3fc0...2bd3cb727b5e6b2dc0b88e48979cf3f08f72f3db,2,2,2,4,2,2012-10-16 00:29:56,2012-10-16 00:29:56
2bd3cb727b5e6b2dc0b88e48979cf3f08f72f3db...b0f4db8d0f616e2d31af8cb2ce19c2adbd28028e,1,12,4,16,3,2012-10-16 00:35:07,2012-10-16 00:35:07
b0f4db8d0f616e2d31af8cb2ce19c2adbd28028e...18324749cb7906abfea221b5822741bdd8eab0f1,1,1,1,2,1,2012-10-16 00:36:00,2012-10-16 00:36:00
18324749cb7906abfea221b5822741bdd8eab0f1...2533e2beca9400889ecdb90a2e9e9e7c94663fc3,1,3,3,6,1,2012-10-16 00:38:19,2012-10-16 00:38:19
2533e2beca9400889ecdb90a2e9e9e7c94663fc3...85403c26d20d4478f89877fba8c903cf42d041b3,1,3,0,3,1,2012-10-16 00:43:31,2012-10-16 00:43:31
85403c26d20d4478f89877fba8c903cf42d041b3...c5af2098dac708989361b2ef7196d8182446d3ca,1,1,1,2,1,2012-10-16 00:44:52,2012-10-16 00:44:52
c5af2098dac708989361b2ef7196d8182446d3ca...f00836846294c38e1716454ace4e8d92166719b9,1,40,0,40,3,2012-10-16 00:46:34,2012-10-16 00:40:29
f00836846294c38e1716454ace4e8d92166719b9...cd486910f323eeefc2584bdcae608bcc14d37619,1,1,1,2,1,2012-10-16 00:52:04,2012-10-16 00:49:46
cd486910f323eeefc2584bdcae608bcc14d37619...523e7e9f98ae15f13c7ed7957fdd93b093ec9e85,1,0,2,2,1,2012-10-16 00:55:21,2012-10-16 00:55:21
523e7e9f98ae15f13c7ed7957fdd93b093ec9e85...a3385ba9e08224168d7f3f0c610778613655d3bb,1,18,2,20,3,2012-10-16 01:19:07,2012-10-16 01:19:07
a3385ba9e08224168d7f3f0c610778613655d3bb...bdd5c556662bcb3c13b5baf025b5d710209e7949,1,25,1,26,3,2012-10-16 01:39:29,2012-10-16 01:39:29
bdd5c556662bcb3c13b5baf025b5d710209e7949...630ba60a5d432544a41410b346145144a287e004,1,15,19,34,2,2012-10-16 03:46:26,2012-10-16 03:46:26
630ba60a5d432544a41410b346145144a287e004...bcab93c9d14b8886b26bed32d67dcf384dd746b3,1,1,1,2,1,2012-10-16 03:58:43,2012-10-16 03:58:43
bcab93c9d14b8886b26bed32d67dcf384dd746b3...b1216c460ab929465220736ec31f4376f33239e5,1,1,1,2,1,2012-10-16 05:12:49,2012-10-16 05:12:49
8d46cae54f5f6ab1375bec53828e95ff0cca87bf...0c9268cb2d0e987dfe2f81ac94b0ac0ac70c1153,1,16,10,26,3,2012-10-16 06:49:57,2012-10-16 04:51:24
0c9268cb2d0e987dfe2f81ac94b0ac0ac70c1153...0ca1386c106a9f6f0469d63c7734b42486a8e2ef,3,72,69,141,10,2012-10-16 06:49:58,2012-10-16 06:49:29
0ca1386c106a9f6f0469d63c7734b42486a8e2ef...4dee258b8ed24ae10eda800ba76d747888ccdcf2,5,224,229,453,63,2012-10-16 11:27:02,2012-10-16 11:17:36
4dee258b8ed24ae10eda800ba76d747888ccdcf2...45955d3ad350635ecf006b9c9e16e8f8346b3c28,1,0,0,0,0,2012-10-16 11:29:47,2012-10-16 11:29:47
45955d3ad350635ecf006b9c9e16e8f8346b3c28...15c6fe4220d2377e9cedee4d57d16873afa257df,1,5,12,17,2,2012-10-16 13:08:02,2012-10-16 13:08:02
3ff6df2e9e416200f2d40048fc62748113964621...b8886b3935a1cb5079389a2a6216c4dbfa1bffa6,3,45,12,57,12,2013-04-24 22:27:17,2013-04-09 22:18:00
b8886b3935a1cb5079389a2a6216c4dbfa1bffa6...1ef5cfceb14fe174605556bec3629a7c392c4d43,2,2,2,4,2,2013-04-24 22:27:17,2013-04-24 22:27:10
1ef5cfceb14fe174605556bec3629a7c392c4d43...c6c24dffb58e16657017aa936ca6f87de8de5e83,1,4,3,7,1,2013-04-24 22:34:58,2013-04-24 22:34:58
eb90df2f8dabd51d64270ddfa005a69a987963cb...311837cdf4c3daa98182e58e8606100839825bfc,1,60,0,60,1,2013-04-18 02:22:38,2013-04-12 15:17:57
311837cdf4c3daa98182e58e8606100839825bfc...4ca4859c45bb53304fefc74663677dad86bd0e42,1,105,42,147,7,2013-04-18 02:22:39,2013-04-12 15:57:13
4ca4859c45bb53304fefc74663677dad86bd0e42...6ebee578d610aa1a3ee9d19ebc2ebd9d68f5c6b8,4,542,509,1051,49,2013-04-18 02:22:39,2013-04-15 01:10:39
6ebee578d610aa1a3ee9d19ebc2ebd9d68f5c6b8...8432577f003c1cc510584b87a81a12d274d49c54,4,23,7,30,8,2013-04-18 02:22:39,2013-04-16 17:33:49
8432577f003c1cc510584b87a81a12d274d49c54...aa91dff1bf52a5af9bcf364cb0b2d0f1cb549a19,2,17,11,28,10,2013-04-18 02:24:32,2013-04-17 21:13:19
aa91dff1bf52a5af9bcf364cb0b2d0f1cb549a19...68e4ecfc184b7c0ef704d718a61bb8b8a0d8f57c,3,23,5,28,7,2013-04-18 02:24:35,2013-04-17 23:15:44
68e4ecfc184b7c0ef704d718a61bb8b8a0d8f57c...11fb1714365d4a60c55fbcf68a632a7ec33249e0,3,12,2,14,6,2013-04-18 02:24:35,2013-04-18 02:21:49
7a5ea822c937854fdf119771b3258600179371f4...eb982e75669190fc7dd5f63e84376cca3b6eb12c,1,29,0,29,1,2013-04-09 21:23:52,2013-03-21 02:46:42
eb982e75669190fc7dd5f63e84376cca3b6eb12c...72abc7af92533b7b56857972e218d64412437a8d,1,1,1,2,1,2013-04-09 21:23:52,2013-03-21 02:48:47
72abc7af92533b7b56857972e218d64412437a8d...5280a91547f6339963a0b361098b7377cf01e9eb,1,4,0,4,1,2013-04-09 22:02:41,2013-04-09 22:02:41
a162d7c4d301c6d72ee8ed64fd4acc414cdd9dcc...83b99f8c8a513970fb856da36f0345288604d680,2,84,0,84,2,2013-03-16 01:57:01,2013-03-16 01:57:01
a162d7c4d301c6d72ee8ed64fd4acc414cdd9dcc...d97b0b6e0d3cbe568ffbfd6b66efb20f11c5fdcb,1,8,0,8,1,2013-03-15 22:42:05,2013-03-15 22:42:05
5bdb378f8df3336fbd793afb7042c302b4be83a6...df5606363269928f1167114982e48fe74098190e,1,0,1,1,1,2013-02-26 00:41:10,2013-02-26 00:41:03
5bdb378f8df3336fbd793afb7042c302b4be83a6...58fde14bea6516a9cc4882a4f1ed4641c6680129,2,175,169,344,17,2013-02-26 00:15:43,2013-02-26 00:15:43
58fde14bea6516a9cc4882a4f1ed4641c6680129...f6aabffab3652bb9dbf2efb370013d2941a51d95,22,506,512,1018,439,2013-02-26 01:52:51,2013-02-26 01:52:51
f6aabffab3652bb9dbf2efb370013d2941a51d95...29c88795c65b87bac33d44a92744744d360e7abe,1,8,0,8,1,2013-02-26 02:01:04,2013-02-26 02:01:04
29c88795c65b87bac33d44a92744744d360e7abe...30af8389fb395e2056ef1bfae7cd396672d5b201,1,1,0,1,1,2013-02-26 02:25:18,2013-02-26 02:25:18
30af8389fb395e2056ef1bfae7cd396672d5b201...3a9de7b737d76373cfbdd9cfaf86191a7b32d598,1,96,0,96,1,2013-02-26 06:15:55,2013-02-26 06:15:55
3a9de7b737d76373cfbdd9cfaf86191a7b32d598...98d5eb6785bd131af39c98ea887d7c1b362611c7,1,4,1,5,1,2013-02-26 07:38:04,2013-02-26 07:38:04
98d5eb6785bd131af39c98ea887d7c1b362611c7...9c35a03d198a8cf5dc5e2822b4f936afed3a40f6,3,233,182,415,63,2013-02-28 23:36:09,2013-02-28 22:36:37
9c35a03d198a8cf5dc5e2822b4f936afed3a40f6...416f1d6e77b75a1824de017565cb1ae8643e1c26,2,18,34,52,10,2013-02-28 23:53:33,2013-02-28 23:53:33
416f1d6e77b75a1824de017565cb1ae8643e1c26...457de14998b301bd8a7b332665d1c7b1007069a5,11,48,48,96,42,2013-03-01 00:06:31,2013-03-01 00:06:31
457de14998b301bd8a7b332665d1c7b1007069a5...447f5a6686287d8ce79048e1c593391bb03e5880,5,54,54,108,43,2013-03-01 00:11:38,2013-03-01 00:11:38
447f5a6686287d8ce79048e1c593391bb03e5880...f8212a5330de8139d02dd3090a955d14583b3287,1,10,3,13,3,2013-03-01 00:25:08,2013-03-01 00:23:03
f8212a5330de8139d02dd3090a955d14583b3287...87964fe689f719c4db00503a240e65ba275e6573,5,25,12,37,13,2013-03-02 02:20:06,2013-03-02 02:20:06
65840c115277043d60f8f2e3adc5a8ca366b6c12...81de2e700b5429eb57504528f61653438e70e0cc,1,4,2,6,2,2013-03-12 05:47:31,2013-03-12 05:47:31
81de2e700b5429eb57504528f61653438e70e0cc...b27dd1b8d26d5ab6a74dfa3a880f793a55b8997e,1,8,6,14,3,2013-03-12 05:54:07,2013-03-12 05:54:07
6616d9aac618878421f4db0e70cae5d7a37f4cb4...d71e31b5b50ee3dfb98512155af49a97d0edc491,1,9,4,13,2,2013-01-31 20:24:42,2013-01-31 20:24:42
62e83ec2bc6036ef88b48e9ccfec6467ece33369...f8bfb06001614646ecf63e89dcde303dd7b5de05,4,29,4,33,5,2013-01-30 20:07:04,2013-01-30 20:07:04
62e83ec2bc6036ef88b48e9ccfec6467ece33369...322e65bbe6b35e50de0ed43dfaa5aba8f4a3fe5f,4,2,74,76,7,2013-01-30 06:43:53,2013-01-30 01:51:24
322e65bbe6b35e50de0ed43dfaa5aba8f4a3fe5f...99bceb936e4336da312a8e99c03eb95c3319bbd8,2,50,3,53,5,2013-01-30 06:43:53,2013-01-30 02:23:56
99bceb936e4336da312a8e99c03eb95c3319bbd8...25c7ad226266ad45fcc7988ffee2a40b89dacbff,4,16,35,51,13,2013-01-30 07:07:13,2013-01-30 07:07:13
25c7ad226266ad45fcc7988ffee2a40b89dacbff...e10cba88cb4df8ec1ba7791e42c2e4e4ccdd8288,1,1,5,6,2,2013-01-30 17:48:47,2013-01-30 17:48:47
cd250f094509fa99f707bb35dc612aa800156ff4...033fd00a58b7b428392d3f643d40a86d6b18c02e,1,1,0,1,1,2012-12-13 00:06:21,2012-12-13 00:06:21
033fd00a58b7b428392d3f643d40a86d6b18c02e...6c9cd218a91cd5dbf2aa4a14fb9a4617b75c6ae6,2,2,2,4,2,2012-12-13 00:06:31,2012-12-13 00:06:31
b1216c460ab929465220736ec31f4376f33239e5...985baa5b69864a960bb5215b292aaa70792ed01f,1,23,7,30,5,2012-10-16 05:32:29,2012-10-16 05:32:29
985baa5b69864a960bb5215b292aaa70792ed01f...9cc1caa8cac5ff6cf4f0bdcab05863ececab68b3,1,31,5,36,3,2012-10-16 06:28:56,2012-10-16 06:28:56
9cc1caa8cac5ff6cf4f0bdcab05863ececab68b3...55ed0c3ba444d09e602f01d0da5af144af983dfd,2,107,59,166,7,2012-10-16 06:47:57,2012-10-16 06:43:11
55ed0c3ba444d09e602f01d0da5af144af983dfd...aad875d303868b3b28122df0d4ad4001289579fa,1,49,45,94,34,2012-10-16 06:53:11,2012-10-16 06:52:47
aad875d303868b3b28122df0d4ad4001289579fa...14375f34b757f2e8e60e85ac8233e72dec2d45c1,1,1,1,2,1,2012-10-16 06:59:50,2012-10-16 06:59:50
14375f34b757f2e8e60e85ac8233e72dec2d45c1...ba732370f7c0ed11991e0c4429a3dcbfb8205825,1,3,3,6,2,2012-10-16 07:04:19,2012-10-16 07:04:19
ba732370f7c0ed11991e0c4429a3dcbfb8205825...b936654bcd82bb218789a13d48c0d4b9abb4fd9c,2,23,22,45,6,2012-10-16 07:27:08,2012-10-16 06:49:53
b936654bcd82bb218789a13d48c0d4b9abb4fd9c...2238b42fb940458894e164333e85776f9b59d8f4,1,28,21,49,8,2012-10-16 08:05:46,2012-10-16 08:05:46
2238b42fb940458894e164333e85776f9b59d8f4...f1895ba2eb9d6ca72e617ee0ac570ed2124b8735,6,4,86,90,13,2012-10-16 11:19:24,2012-10-16 11:17:18
f1895ba2eb9d6ca72e617ee0ac570ed2124b8735...bf656fb5d6c5d936a5245df84f9f81ee556b88ea,1,3,0,3,2,2012-10-16 17:03:39,2012-10-16 17:03:39
7b03dfc43c773519d429a9e3ae120648accdca66...2f11def1fbb5d7d92c60f360d63fc5fc7558145e,1,6,6,12,6,2012-10-16 17:55:45,2012-10-16 17:40:38
2f11def1fbb5d7d92c60f360d63fc5fc7558145e...2b621521799856d8b24df1a4fb029c9defb989bb,3,28,0,28,4,2012-10-16 17:58:49,2012-10-16 17:37:15
2b621521799856d8b24df1a4fb029c9defb989bb...a65a57de69c8127f11caa625c93469e00f1f2343,1,3,3,6,3,2012-10-16 19:07:43,2012-10-16 19:07:43
a65a57de69c8127f11caa625c93469e00f1f2343...62dc41f15a82156e2aa2cea5e819c516fed449b0,1,1,1,2,1,2012-10-16 20:09:15,2012-10-16 20:08:41
62dc41f15a82156e2aa2cea5e819c516fed449b0...a4c0727132492dc8cb65c94fd1566f3013ea5d72,2,6,2,8,3,2012-10-16 20:47:29,2012-10-16 20:47:04
a4c0727132492dc8cb65c94fd1566f3013ea5d72...e55d70c743b3077ebecf4c7ee2218c93289fda97,1,1,1,2,1,2012-10-16 21:35:39,2012-10-16 21:35:39
e55d70c743b3077ebecf4c7ee2218c93289fda97...5e3f00c0846cf9b4e9c1b3c048e83bbc546afdea,1,1,1,2,1,2012-10-17 00:56:12,2012-10-17 00:56:12
5e3f00c0846cf9b4e9c1b3c048e83bbc546afdea...4dfb8601510bdd2927df07a3bd04e540b3f2548c,1,4,1,5,1,2012-10-17 01:53:29,2012-10-17 01:53:29
4dfb8601510bdd2927df07a3bd04e540b3f2548c...d00f6e8bdeda2425c45ebb0d66796596a8fcc003,3,13,24,37,5,2012-10-17 18:36:33,2012-10-17 18:36:33
d00f6e8bdeda2425c45ebb0d66796596a8fcc003...24ada7fecbfbb414e6d79187528ee605f3784d83,1,13,9,22,1,2012-10-17 19:28:34,2012-10-17 19:28:34
24ada7fecbfbb414e6d79187528ee605f3784d83...0427e3c3646edbd2bcf956abb268e096ce4190d5,1,3,3,6,1,2012-10-17 20:19:52,2012-10-17 20:19:52
a33fcf6d8cef8486ffd4bce549645624fb23a0e3...1b88047966cb63bdc816eb670d3d4d341537e548,1,1,1,2,1,2013-05-15 22:10:28,2013-05-15 22:02:07
1b88047966cb63bdc816eb670d3d4d341537e548...f87f0bd52565031d3cf99a654e9adc4662a49eb9,2,4,7,11,2,2013-05-15 22:10:30,2013-05-15 22:06:51
f87f0bd52565031d3cf99a654e9adc4662a49eb9...75ab6e61fab557285fadec66238988f230313168,1,1,1,2,1,2013-05-15 22:28:59,2013-05-15 22:28:59
f20c76725c6611f31d598223cf34a67d455e41e9...c69ab5d350dae66672558056ebeab8dec8c37554,11,51,28,79,18,2013-04-30 18:43:30,2013-04-25 19:48:02
c69ab5d350dae66672558056ebeab8dec8c37554...5d04576b914e3fea8a3f1c4dd336408c07844319,1,1,1,2,1,2013-04-30 18:43:30,2013-04-25 21:04:26
5d04576b914e3fea8a3f1c4dd336408c07844319...be8dc471139662ea18a771d36017fa8c50252881,8,17,26,43,15,2013-04-30 18:43:30,2013-04-30 18:42:46
be8dc471139662ea18a771d36017fa8c50252881...91c273fa417a30a1012451e3fb2bbd50270a60d5,1,9,0,9,4,2013-05-02 23:38:44,2013-05-02 23:38:44
37bc8491b88585e4619c9e91e369518000f1c715...fb61e884dbf4fa3edde6895385fac58339bf78b8,4,35,9,44,13,2013-04-24 22:53:19,2013-04-23 22:58:40
fb61e884dbf4fa3edde6895385fac58339bf78b8...47ba95dfc4a0848c77d1a562d7c1f404e3de8657,1,5,4,9,1,2013-04-25 17:58:27,2013-04-25 17:58:27
47ba95dfc4a0848c77d1a562d7c1f404e3de8657...4a32bb81f3d59195f9e52ba31fa4f97d307c164c,3,8,8,16,7,2013-04-25 20:47:03,2013-04-25 20:47:03
4a32bb81f3d59195f9e52ba31fa4f97d307c164c...c9e9c73da70d606716216216fea6220c12aa465e,1,3,0,3,1,2013-04-25 20:47:55,2013-04-25 20:47:55
c04a76456076e8b7715e53f660297a9e3a1c5938...f67db983c3d60aae446658cc4b203444ab03567a,29,746,118,864,112,2013-04-19 02:17:53,2013-04-11 00:32:46
f67db983c3d60aae446658cc4b203444ab03567a...6776c354b80e25ff5445dc627d826ecf42bdfd87,3,92,0,92,3,2013-04-19 02:17:53,2013-04-17 18:54:54
6776c354b80e25ff5445dc627d826ecf42bdfd87...f72a7223c516a9fb24d29918d66fe3ac6c785c2f,4,88,8,96,10,2013-04-19 02:17:53,2013-04-18 00:45:38
f72a7223c516a9fb24d29918d66fe3ac6c785c2f...e9e558cd984cdc1025947d68b9d1ebd05c3e28bf,2,3,2,5,4,2013-04-19 02:17:53,2013-04-18 00:46:53
e9e558cd984cdc1025947d68b9d1ebd05c3e28bf...296d4f5ccfff9c7c7f9edcabd6b86b3dcbd07058,2,27,3,30,2,2013-04-19 02:17:53,2013-04-18 00:59:45
296d4f5ccfff9c7c7f9edcabd6b86b3dcbd07058...c12f3851d111f60ea018aa50fb881e20df13a5ca,1,1,0,1,1,2013-04-19 02:30:44,2013-04-19 02:30:44
c12f3851d111f60ea018aa50fb881e20df13a5ca...45dea05b21a1960fb5e2be8d20530dabdaa1aded,1,2,3,5,1,2013-04-19 03:38:16,2013-04-19 03:38:16
45dea05b21a1960fb5e2be8d20530dabdaa1aded...9f4f8b29582a05238429e02f68d4285bb4fe46e3,1,13,15,28,3,2013-04-19 04:22:14,2013-04-19 04:22:14
46822597b79b93385ae500bd61927e577cf90ad9...757cc15c479cefd55e160a412a858d82f7b36c54,2,6,2,8,4,2013-04-09 22:13:46,2013-04-04 00:16:48
757cc15c479cefd55e160a412a858d82f7b36c54...3392aaa1fe54382069ca172fe2bbc44818c52bec,1,3,1,4,2,2013-04-09 22:15:58,2013-04-09 22:15:58
9fcbcbd19170cafe8462f8c82d0112abd9f76cb9...70f1412c0a8ce4fab1f667b2f3e9b766c8791389,1,1,1,2,1,2013-03-18 17:22:37,2013-03-18 17:22:37
70f1412c0a8ce4fab1f667b2f3e9b766c8791389...331177d002e750c22f94eb5077903ab6702fc223,1,8,2,10,1,2013-03-18 22:26:55,2013-03-18 22:26:55
331177d002e750c22f94eb5077903ab6702fc223...1bc0a0cff8fc6221a8feabcb586b77fa871b192a,1,15,7,22,2,2013-03-19 03:53:55,2013-03-19 03:53:55
1bc0a0cff8fc6221a8feabcb586b77fa871b192a...b475c953584e2e183d417bc17ad8bcb7357ac480,1,1,7,8,2,2013-03-19 18:23:10,2013-03-19 18:23:10
df5606363269928f1167114982e48fe74098190e...344a3bb003b30bbcd862365143435b147bd9eea8,2,21,3,24,2,2013-02-27 00:33:38,2013-02-27 00:33:38
344a3bb003b30bbcd862365143435b147bd9eea8...21d0f3d75fec4924b3b32a4662f5b0a122ff4e94,1,2,0,2,1,2013-02-27 00:34:14,2013-02-27 00:34:14
21d0f3d75fec4924b3b32a4662f5b0a122ff4e94...dd59b98475508cb8b31251327dc05d222b55b6f6,1,4,2,6,3,2013-02-27 00:51:45,2013-02-27 00:51:45
dd59b98475508cb8b31251327dc05d222b55b6f6...727061188949ba59547cfdf72d55c182ba658ac5,1,1,1,2,1,2013-02-27 23:01:54,2013-02-27 00:51:42
df5606363269928f1167114982e48fe74098190e...8124c3fb624e2e8ecbfa4600e2a24ba9fff61539,8,103,4,107,8,2013-02-26 01:00:12,2013-02-26 00:40:28
8124c3fb624e2e8ecbfa4600e2a24ba9fff61539...afaab6db58c8849f53bacc74c99331b6b44d1a97,1,9,1,10,4,2013-02-26 01:00:12,2013-02-26 00:59:11
afaab6db58c8849f53bacc74c99331b6b44d1a97...f862303136dfbec678fde41af40141c20911e93b,1,12,0,12,1,2013-02-26 01:19:37,2013-02-26 01:19:37
f862303136dfbec678fde41af40141c20911e93b...8962afe04ef9cfc8c07b911a9db0ca43c0437963,2,10,4,14,5,2013-02-26 23:50:25,2013-02-26 23:50:25
8962afe04ef9cfc8c07b911a9db0ca43c0437963...8d66c65560b652b82c769e2e61c4bbc14749ba88,1,1,0,1,1,2013-02-27 00:08:27,2013-02-27 00:08:27
8d66c65560b652b82c769e2e61c4bbc14749ba88...8d704c28279b3cbad28e416ba9ed9f772bab5b88,1,3,1,4,2,2013-02-27 18:59:13,2013-02-27 18:59:13
8d704c28279b3cbad28e416ba9ed9f772bab5b88...5cd0eb5dc8f89960d9c13f853850243ed4dad643,5,94,7,101,17,2013-02-28 06:10:47,2013-02-28 06:10:47
5cd0eb5dc8f89960d9c13f853850243ed4dad643...0ea9027109a83b99bba798d311cb5f1d01a07dbf,1,19,13,32,7,2013-03-01 05:20:20,2013-03-01 05:20:20
0ea9027109a83b99bba798d311cb5f1d01a07dbf...c9638e1a99efb59ecf7ee39aefa86fa15432ddd4,1,1,1,2,1,2013-03-01 16:30:10,2013-03-01 16:30:10
c9638e1a99efb59ecf7ee39aefa86fa15432ddd4...e2a323bf89a0f265ad55c9868c630a0e7e1017f5,2,5,10,15,3,2013-03-02 02:13:32,2013-03-02 02:13:32
e2a323bf89a0f265ad55c9868c630a0e7e1017f5...42154be021bfb3c819b0a9dde95b8f8f0d26ed67,3,15,8,23,10,2013-03-02 03:35:33,2013-03-02 03:35:33
42154be021bfb3c819b0a9dde95b8f8f0d26ed67...98325eeac9c7a6463649db958920237444e94df8,1,4,1,5,1,2013-03-03 03:26:48,2013-03-03 03:26:48
98325eeac9c7a6463649db958920237444e94df8...87205cf9c0169d6e4b4f30494cf03edc73607f91,1,2,2,4,2,2013-03-03 03:49:18,2013-03-03 03:49:18
87205cf9c0169d6e4b4f30494cf03edc73607f91...c194b9a98ffd6c77384d2e27b7385ea1d6a3228c,1,2,0,2,1,2013-03-05 22:31:46,2013-03-05 22:31:46
c194b9a98ffd6c77384d2e27b7385ea1d6a3228c...29e5452f8ed9d504b98c762cf223ff5834a3cc11,1,1,1,2,1,2013-03-06 22:00:02,2013-03-06 22:00:02
b27dd1b8d26d5ab6a74dfa3a880f793a55b8997e...26ac481c3f511f3b595c9266bf40377d3fc676e5,2,12,9,21,6,2013-03-12 06:08:54,2013-03-12 05:42:01
26ac481c3f511f3b595c9266bf40377d3fc676e5...0d3be813577d7fe1c516b5062b44d19836fea856,4,40,31,71,13,2013-03-12 06:08:54,2013-03-12 06:07:38
b27dd1b8d26d5ab6a74dfa3a880f793a55b8997e...4fa14fa1ce310d8d68544396e541fa0353043d4c,2,2,2,4,2,2013-03-12 05:55:53,2013-03-12 05:55:53
4fa14fa1ce310d8d68544396e541fa0353043d4c...ef05f8ccc9203974d709f9048ab682d5a88cc531,1,1,1,2,1,2013-03-12 05:56:50,2013-03-12 05:56:50
d71e31b5b50ee3dfb98512155af49a97d0edc491...0fcb503fa45f6cb2d9a8782b5c867f0740957576,1,2,2,4,1,2013-02-01 19:15:59,2013-01-20 22:12:36
0fcb503fa45f6cb2d9a8782b5c867f0740957576...48010de100b81ab491c8e845dc5a48ebe7f65452,1,9,1,10,1,2013-02-01 19:20:22,2013-02-01 19:20:22
0e8e2ff95a0b93d5023f735e21b048128b7dd834...4b9d41e1a199d896bf9b7ee2d92fd5fc1ce74a03,4,79,474,553,40,2013-01-31 21:26:35,2013-01-31 21:25:43
d74ec8cc121db281862e95f450388f844c924188...3f2aad7c0e8febf80925b747fab49c1c9171e094,10,73,74,147,49,2013-01-30 21:34:58,2013-01-30 19:57:16
3f2aad7c0e8febf80925b747fab49c1c9171e094...be8f12bad13f4d41750e973961ee7e51cfdcee3c,2,37,2,39,3,2013-01-31 00:22:31,2013-01-31 00:19:05
be8f12bad13f4d41750e973961ee7e51cfdcee3c...91db907af35665c3e80ed9d51c6016c947638439,1,34,36,70,16,2013-01-31 00:52:16,2013-01-31 00:52:16
91db907af35665c3e80ed9d51c6016c947638439...1c08c06d6796a0bc33c2449d04141e6b29b01696,2,100,26,126,26,2013-01-31 01:07:09,2013-01-31 01:06:21
1c08c06d6796a0bc33c2449d04141e6b29b01696...99ad7d41d4454f7551468b3c30d5748a891ffc94,1,15,13,28,10,2013-01-31 02:22:15,2013-01-31 02:22:15
99ad7d41d4454f7551468b3c30d5748a891ffc94...d8b137df769935ee10ca5f1d9d2bcb5e603c543b,3,2,2,4,2,2013-01-31 02:25:01,2013-01-31 02:25:01
d8b137df769935ee10ca5f1d9d2bcb5e603c543b...42a4d8537bdd70506c323efb22ffee495aeddd05,2,10,12,22,11,2013-01-31 18:22:12,2013-01-31 18:22:12
5a053a039ff44c18a50b6a49de9707c93412a54b...d85497a275cf98d27544cc2bb7846d02fa72e9f4,1,1,1,2,1,2012-12-13 00:16:02,2012-12-13 00:16:02
0a5a2f05b688b07369a51383f26a3dc4dc3d275c...d38034f35d90b2a922886b85a07fe9175bf51c06,1,1,1,2,1,2013-05-15 22:02:07,2013-05-15 22:02:07
d38034f35d90b2a922886b85a07fe9175bf51c06...3f9e08cbbbbb751ec29c0eef3c94979336eb606b,2,4,7,11,2,2013-05-15 22:06:51,2013-05-15 22:06:51
91c273fa417a30a1012451e3fb2bbd50270a60d5...cc57b443d4214ff876fbf26c2d3fd5816cc76de8,2,2,2,4,2,2013-05-04 00:10:33,2013-05-04 00:10:33
cc57b443d4214ff876fbf26c2d3fd5816cc76de8...310defcefc4765998bf7638871c09d532ff9a4a4,1,1,1,2,1,2013-05-04 00:13:19,2013-05-04 00:13:19
310defcefc4765998bf7638871c09d532ff9a4a4...9e0e7e1138776b0452f2b2ad946dcdc6a6b0045c,1,1,1,2,1,2013-05-04 00:35:38,2013-05-04 00:35:38
1fefb9593d69835453f17e73d57a3281bc2f64dc...eecc97715feecdaae054d85d1d40ec32f1b1bb1b,3,44,11,55,12,2013-04-25 21:18:36,2013-04-25 21:15:42
7e4d947ca9fc069368b23d4081d59a569162c56f...b6282eadd9f49e058f42ff95cb8f118035dcb624,7,73,8,81,12,2013-04-19 18:38:09,2013-04-18 01:56:47
b6282eadd9f49e058f42ff95cb8f118035dcb624...e144b4e246816a246ca805b041edeea42fe8ab89,1,2,1,3,2,2013-04-19 18:38:09,2013-04-18 02:15:11
e144b4e246816a246ca805b041edeea42fe8ab89...54916ce535071a70551f2b79bebcef2859b36a26,1,6,7,13,1,2013-04-19 18:38:09,2013-04-18 02:23:39
54916ce535071a70551f2b79bebcef2859b36a26...a72134fd80ac802d04d05d8fd36fb9d3cd1f225b,8,105,53,158,14,2013-04-19 18:38:09,2013-04-18 17:42:16
a72134fd80ac802d04d05d8fd36fb9d3cd1f225b...a5af1d6b8c422f791d1cc1b3307f0ceb93555f18,1,0,4,4,1,2013-04-19 18:38:10,2013-04-19 18:37:53
a5af1d6b8c422f791d1cc1b3307f0ceb93555f18...c9bacb897e6c15c256656999268c0dfcc038e01b,1,2,0,2,1,2013-04-19 18:42:19,2013-04-19 18:42:19
1c5f93aef500a73f2d79684aaa762e5828a5c68a...9a9e61433362200f8eed0a4f0a2411024cccfc80,4,30,25,55,12,2013-04-09 22:38:05,2013-04-09 22:34:00
9a9e61433362200f8eed0a4f0a2411024cccfc80...6ca49a6d03a3cdedea9ca4c2814caf91615ec832,1,2,0,2,1,2013-04-09 22:41:20,2013-04-09 22:41:20
6ca49a6d03a3cdedea9ca4c2814caf91615ec832...6414dd4e6f7e94981ec2592531606c6ec083d4a8,1,2,2,4,1,2013-04-09 22:51:12,2013-04-09 22:51:12
8b363fe7283e7e79524bb43cef754fc9fd308bd6...a5bac3dd6c038db73d63255852e9d7d2bb996251,2,41,0,41,2,2013-03-18 19:01:17,2013-03-18 19:01:17
a5bac3dd6c038db73d63255852e9d7d2bb996251...37ace36ac95b8c5c080546ffd5d70e2b7f2c100f,1,14,11,25,2,2013-03-18 21:49:36,2013-03-18 21:49:36
b475c953584e2e183d417bc17ad8bcb7357ac480...cb12b195823cde79b760f5f925bb6939d73046cc,1,37,0,37,2,2013-03-19 22:11:01,2012-12-14 00:25:09
cb12b195823cde79b760f5f925bb6939d73046cc...25c3a683faa5d8c8afd98e113912af6705b4a0b2,39,0,0,0,0,2013-03-19 22:11:01,2012-12-14 02:06:08
25c3a683faa5d8c8afd98e113912af6705b4a0b2...58c6f55676f98da5e4bac1afea0b299e82bbe19e,16,322,113,435,59,2013-03-19 22:11:01,2012-12-14 03:05:26
58c6f55676f98da5e4bac1afea0b299e82bbe19e...21cd1bee2f59c19380e0a2e6c303edb354cb20e3,1,0,0,0,0,2013-03-19 22:11:01,2012-12-15 00:16:30
21cd1bee2f59c19380e0a2e6c303edb354cb20e3...067ec181391b095cc2eaef313e77769d8b41e0ae,2,31,18,49,6,2013-03-19 22:11:01,2012-12-15 00:18:03
067ec181391b095cc2eaef313e77769d8b41e0ae...55349ca97424755df753830d2e5daaa7aff304d7,1,1,4,5,1,2013-03-19 22:11:01,2012-12-15 01:26:42
55349ca97424755df753830d2e5daaa7aff304d7...460911c4064e3392f254e1b627ff1f7ef99cd72f,1,1,9,10,1,2013-03-19 22:11:01,2012-12-15 01:45:26
460911c4064e3392f254e1b627ff1f7ef99cd72f...1bb59b22d8d45cf00201c85c679c4e2e5e558589,1,1,1,2,1,2013-03-19 22:11:01,2012-12-18 03:36:06
1bb59b22d8d45cf00201c85c679c4e2e5e558589...b145dc48de4471c96a9efa1232bcdaea306b9169,1,1,1,2,1,2013-03-19 22:11:01,2012-12-18 03:42:25
b145dc48de4471c96a9efa1232bcdaea306b9169...8527cf2739d10af8fa88ba709790f27f6fa7a8fe,4,48,43,91,11,2013-03-19 22:11:01,2012-12-18 03:43:24
8527cf2739d10af8fa88ba709790f27f6fa7a8fe...a107739c84e2462496fcabfcc085a79c444115f4,1,22,31,53,10,2013-03-19 22:11:01,2012-12-21 05:35:22
a107739c84e2462496fcabfcc085a79c444115f4...d01c00657274ca6ae2b35188477d8adc91a22514,1,3,18,21,6,2013-03-19 22:11:01,2012-12-21 05:55:59
d01c00657274ca6ae2b35188477d8adc91a22514...1de7926e1d182bd71fe0a2d6c238218b209aa24a,1,0,3,3,2,2013-03-19 22:11:02,2012-12-21 06:09:12
1de7926e1d182bd71fe0a2d6c238218b209aa24a...6e25474b31d483064fe6758ebef0debae55df62e,2,10,10,20,2,2013-03-19 22:11:02,2012-12-21 06:19:20
6e25474b31d483064fe6758ebef0debae55df62e...528f156ea88f51346bf9047b287b49171e0fd3e3,2,3,6,9,5,2013-03-19 22:11:02,2012-12-21 06:35:39
528f156ea88f51346bf9047b287b49171e0fd3e3...3e0534a9dfb8daa582f9dd29866fa96ca23d4502,12,146,125,271,48,2013-03-19 22:11:02,2012-12-22 05:39:11
3e0534a9dfb8daa582f9dd29866fa96ca23d4502...a7ab8da940af4f54e81f011d276f23fade6f9845,1,1,2,3,1,2013-03-19 22:11:02,2012-12-27 09:24:26
a7ab8da940af4f54e81f011d276f23fade6f9845...62b5e87cce084977882804a7337793f4fa3e410f,5,48,3,51,16,2013-03-19 22:11:02,2012-12-27 09:54:04
62b5e87cce084977882804a7337793f4fa3e410f...b25934b71b663f6e195f35a69cc93156a2f5e6a2,1,0,5,5,1,2013-03-19 22:11:02,2012-12-28 01:45:39
b25934b71b663f6e195f35a69cc93156a2f5e6a2...b812d6e9ec5882c4296e475b746e1233ac9d0aca,7,36,31,67,11,2013-03-19 22:11:02,2012-12-28 23:27:06
b812d6e9ec5882c4296e475b746e1233ac9d0aca...72a1bbb101c80450e6712e78624e75b965021732,2,5,2,7,3,2013-03-19 22:11:02,2013-01-02 23:05:24
72a1bbb101c80450e6712e78624e75b965021732...b2bd0eb9b08f24b4d805c5a4f622da31f11124d5,4,53,23,76,14,2013-03-19 22:11:02,2013-01-03 00:09:05
b2bd0eb9b08f24b4d805c5a4f622da31f11124d5...87024ac5fec5e35cf1a91e049ea434144f5561e0,4,24,4,28,5,2013-03-19 22:11:02,2013-01-03 00:27:31
87024ac5fec5e35cf1a91e049ea434144f5561e0...99f80949ac0ae2a4673f9432cc015f0deeb2ae99,2,28,19,47,7,2013-03-19 22:11:02,2013-01-03 00:54:45
99f80949ac0ae2a4673f9432cc015f0deeb2ae99...36ab0f7ba183f77749de1e7da503fe59f44d4dc9,6,107,50,157,11,2013-03-19 22:11:02,2013-01-03 02:16:07
36ab0f7ba183f77749de1e7da503fe59f44d4dc9...63d69a4a848098f54ba21088f83d09a7083e1825,2,26,20,46,11,2013-03-19 22:11:03,2013-01-03 21:37:16
63d69a4a848098f54ba21088f83d09a7083e1825...56e08b073ee63c4025c012da52e2ecd965d8815e,2,21,2,23,2,2013-03-19 22:11:03,2013-01-03 22:43:45
56e08b073ee63c4025c012da52e2ecd965d8815e...40ef67fc93e55522af0456169dc6f2d640e6e83b,3,80,52,132,22,2013-03-19 22:11:03,2013-01-03 23:26:53
40ef67fc93e55522af0456169dc6f2d640e6e83b...665f5ee9e4d8ea03598278e7fa7e87a04c228c9e,1,1,1,2,1,2013-03-19 22:11:03,2013-01-03 23:37:26
665f5ee9e4d8ea03598278e7fa7e87a04c228c9e...9af19b3c101cb7b5d2aa59479861071c8edcabf7,1,1,1,2,1,2013-03-19 22:11:03,2013-01-04 01:58:24
9af19b3c101cb7b5d2aa59479861071c8edcabf7...9f4702a04409e147d60f2302d8be5655adb39e9a,7,87,82,169,27,2013-03-19 22:11:03,2013-01-08 02:47:05
9f4702a04409e147d60f2302d8be5655adb39e9a...ecce7f00c63ea6e279bee492a72f7d7210a759b3,1,2,2,4,2,2013-03-19 22:11:03,2013-01-08 03:43:30
ecce7f00c63ea6e279bee492a72f7d7210a759b3...5352db933a06f65339bd559a330251f0cafd1cce,15,641,162,803,34,2013-03-19 22:11:03,2013-01-16 20:45:49
5352db933a06f65339bd559a330251f0cafd1cce...dceef1461c74b7f4ccf9b451db655b68ea2fb09f,3,3,5,8,4,2013-03-19 22:11:03,2013-01-17 00:00:37
dceef1461c74b7f4ccf9b451db655b68ea2fb09f...30c61be11ce2bcf4899ccd102d86444861b765de,2,3,0,3,2,2013-03-19 22:11:03,2013-01-17 00:51:46
30c61be11ce2bcf4899ccd102d86444861b765de...8998633f3cd69f8a477b32af3716b7298eaec110,16,109,17,126,20,2013-03-19 22:11:03,2013-01-17 22:02:58
8998633f3cd69f8a477b32af3716b7298eaec110...69d0632db80bcfa5a31f04b8e8d37794a40e81fe,4,32,29,61,26,2013-03-19 22:11:03,2013-01-18 22:31:28
69d0632db80bcfa5a31f04b8e8d37794a40e81fe...5cde1226d022c5e2d1ff596157805a2081535b0e,2,33,13,46,11,2013-03-19 22:11:03,2013-01-19 01:08:47
5cde1226d022c5e2d1ff596157805a2081535b0e...78ca755d3d6ddf7e86454627f65871270918f9eb,26,74,60,134,35,2013-03-19 22:11:04,2013-01-19 02:11:53
78ca755d3d6ddf7e86454627f65871270918f9eb...5baac15fc045dac637a48b31d88d2982f477d484,12,247,170,417,53,2013-03-19 22:11:04,2013-01-22 18:40:26
5baac15fc045dac637a48b31d88d2982f477d484...cda70deb6bcc715bfb718e45c0644d78267a2b1a,2,8,9,17,9,2013-03-19 22:11:04,2013-01-23 05:16:54
cda70deb6bcc715bfb718e45c0644d78267a2b1a...19b8b32dc601fa0fdf010624d3ae7b68640d0136,3,0,6,6,3,2013-03-19 22:11:04,2013-01-23 05:28:30
19b8b32dc601fa0fdf010624d3ae7b68640d0136...65e8b864219bb32256c221e30e1e965c17dfdda0,2,35,34,69,23,2013-03-19 22:11:04,2013-01-23 06:16:05
65e8b864219bb32256c221e30e1e965c17dfdda0...401e29083cb711cd361dbcc2dac9749a5cdd1980,1,18,10,28,7,2013-03-19 22:11:04,2013-01-23 07:04:04
401e29083cb711cd361dbcc2dac9749a5cdd1980...6c33bd911c7152d39307199d8222fef98cc7ebc1,3,76,34,110,15,2013-03-19 22:11:04,2013-01-23 20:11:20
6c33bd911c7152d39307199d8222fef98cc7ebc1...e89c907f7e8a5addc98e2a4c81e83f39af547cd1,4,4,4,8,4,2013-03-19 22:11:04,2013-01-23 22:11:48
e89c907f7e8a5addc98e2a4c81e83f39af547cd1...5a0a4f5ab01721219d6eb349cc0d2b4bacfc67db,25,217,141,358,65,2013-03-19 22:11:04,2013-01-24 05:20:25
5a0a4f5ab01721219d6eb349cc0d2b4bacfc67db...49fccc593a39217550d6979f48e62abfb80276c4,1,2,1,3,2,2013-03-19 22:11:04,2013-01-24 18:38:03
49fccc593a39217550d6979f48e62abfb80276c4...f31457a017499b9091fe0b6166a0c2bdb21f23d5,2,16,1,17,4,2013-03-19 22:11:04,2013-01-24 22:56:13
f31457a017499b9091fe0b6166a0c2bdb21f23d5...4e1d357f880f6da987c2c78af522ac8b69c913aa,1,1,1,2,1,2013-03-19 22:11:04,2013-01-25 19:31:31
4e1d357f880f6da987c2c78af522ac8b69c913aa...1c4970f36a1d1c84be6f85020832c2a18f424eb4,2,31,0,31,7,2013-03-19 22:11:04,2013-01-26 05:32:05
1c4970f36a1d1c84be6f85020832c2a18f424eb4...b35d7ff03acb77fb6a98bf55fb69377f1d2eb5e3,2,3,1,4,2,2013-03-19 22:11:05,2013-01-26 06:03:03
b35d7ff03acb77fb6a98bf55fb69377f1d2eb5e3...185cd61447f12083afb4084212a8e35565c20f11,2,11,6,17,5,2013-03-19 22:11:05,2013-01-26 06:08:47
185cd61447f12083afb4084212a8e35565c20f11...7a41a1ab4e4e2e9a64f3bfa6c04d9e0f35d1401e,1,0,0,0,0,2013-03-19 22:11:05,2013-01-29 17:51:21
7a41a1ab4e4e2e9a64f3bfa6c04d9e0f35d1401e...caadc55c801c7db3dfecf67a3d30e0c2bc6fc880,1,1,1,2,1,2013-03-19 22:11:05,2013-01-29 23:01:10
caadc55c801c7db3dfecf67a3d30e0c2bc6fc880...274e1dc921cd644624912ff8a56dc9a7883d5fc9,1,17,0,17,1,2013-03-19 22:11:05,2013-01-29 23:24:55
274e1dc921cd644624912ff8a56dc9a7883d5fc9...7284ed009e25e652d70e7c90e0d41f938f6c4303,1,0,26,26,1,2013-03-19 22:11:05,2013-01-29 23:32:37
7284ed009e25e652d70e7c90e0d41f938f6c4303...575e1945284e1848a2abe1ba41e0272d805f43ff,2,47,0,47,2,2013-03-19 22:11:05,2013-01-30 00:46:54
575e1945284e1848a2abe1ba41e0272d805f43ff...e81a4fe934aa897a6d4387d2722e12b5a9631610,1,11,0,11,3,2013-03-19 22:11:05,2013-01-30 07:49:55
e81a4fe934aa897a6d4387d2722e12b5a9631610...060d50a32a754ce0a2c62446ec3a04b9bddf0731,1,9,4,13,2,2013-03-19 22:11:05,2013-02-04 20:56:03
060d50a32a754ce0a2c62446ec3a04b9bddf0731...afd509446890bbe137c0a5e7ae5ded469ad9d003,13,80,19,99,34,2013-03-19 22:11:05,2013-02-05 07:33:33
afd509446890bbe137c0a5e7ae5ded469ad9d003...d50ccd2dbc1f99c5dffaa4da375c1617e55279a3,1,1,0,1,1,2013-03-19 22:11:05,2013-02-06 17:37:12
d50ccd2dbc1f99c5dffaa4da375c1617e55279a3...3543004d9194c2556c6a58ef540cadf8b924dad1,7,67,51,118,40,2013-03-19 22:11:05,2013-02-06 18:29:09
3543004d9194c2556c6a58ef540cadf8b924dad1...2ee683ec6821d1ed6fee086de994d0145052756b,8,17,16,33,8,2013-03-19 22:11:05,2013-02-08 00:14:46
2ee683ec6821d1ed6fee086de994d0145052756b...cb64708cae8a1bcf3bb137401958449aa041d8c3,4,10,9,19,9,2013-03-19 22:11:05,2013-02-08 00:33:20
cb64708cae8a1bcf3bb137401958449aa041d8c3...e76e76dd66dd2a691c511efeffcc42e8fd74246a,2,39,0,39,2,2013-03-19 22:11:06,2013-02-08 00:59:29
e76e76dd66dd2a691c511efeffcc42e8fd74246a...452f71d7cf397e0982c072d2cd138fb2e4f43ae2,1,57,0,57,1,2013-03-19 22:11:06,2013-02-08 19:05:36
452f71d7cf397e0982c072d2cd138fb2e4f43ae2...8158acfe376f9ae74dc30523c76964330de68658,3,113,1,114,3,2013-03-19 22:11:06,2013-02-08 19:20:03
8158acfe376f9ae74dc30523c76964330de68658...7344ba52d8c7139d5011d49e99ae4a30a08acac3,1,29,29,58,3,2013-03-19 22:11:06,2013-02-08 19:49:41
7344ba52d8c7139d5011d49e99ae4a30a08acac3...dea41c3e015883ecc96e401f00f8e864a8cac9e4,1,25,2,27,3,2013-03-19 22:11:06,2013-02-08 20:33:55
dea41c3e015883ecc96e401f00f8e864a8cac9e4...a60dfc1684a70bc5902d2bb3b69f2c239aa0358b,1,10,0,10,3,2013-03-19 22:11:06,2013-02-08 21:50:18
a60dfc1684a70bc5902d2bb3b69f2c239aa0358b...9245b9692a07375da8a7cc553425e727db5689c6,1,3,1,4,2,2013-03-19 22:11:06,2013-02-09 00:03:52
9245b9692a07375da8a7cc553425e727db5689c6...abd8ad7c5012a6df88c4685e2124826fda1e69d1,10,220,175,395,30,2013-03-19 22:11:06,2013-02-11 23:25:47
abd8ad7c5012a6df88c4685e2124826fda1e69d1...51212a3129b89272fe11837e6b60573e73348936,3,85,68,153,16,2013-03-19 22:11:06,2013-02-12 01:46:02
51212a3129b89272fe11837e6b60573e73348936...c9e8dbd0ace5a4396acd094925f98ac78ad8fb19,1,8,3,11,2,2013-03-19 22:11:06,2013-02-12 01:58:52
c9e8dbd0ace5a4396acd094925f98ac78ad8fb19...3be4c74ac90660d1f3df5d92c0188dbd2a90bfb5,1,2,1,3,2,2013-03-19 22:11:06,2013-02-12 02:28:21
3be4c74ac90660d1f3df5d92c0188dbd2a90bfb5...d730b9f658f673d5ba45ec3cab3dcc77221878f5,6,93,3,96,9,2013-03-19 22:11:06,2013-02-12 06:49:54
d730b9f658f673d5ba45ec3cab3dcc77221878f5...8fdb40c58bf49f81787d89f04c0a4c19e134cfb3,3,49,12,61,11,2013-03-19 22:11:07,2013-02-12 07:46:59
8fdb40c58bf49f81787d89f04c0a4c19e134cfb3...4bae4116e9a9a7b8e4ba69d9e57f68d21d716647,3,26,4,30,7,2013-03-19 22:11:07,2013-02-12 18:22:58
4bae4116e9a9a7b8e4ba69d9e57f68d21d716647...662754a27d70b77f459c991629f3f3e9e4b11a5c,4,23,23,46,18,2013-03-19 22:11:07,2013-02-13 21:50:25
662754a27d70b77f459c991629f3f3e9e4b11a5c...54859e86d6bf384c13a4fd6c27d31e9f9bc71de2,3,61,44,105,12,2013-03-19 22:11:07,2013-02-13 22:48:06
54859e86d6bf384c13a4fd6c27d31e9f9bc71de2...1b3c83977c6be6766a2e68d9064443e9e7783d17,2,3,2,5,3,2013-03-19 22:11:07,2013-02-13 23:40:58
1b3c83977c6be6766a2e68d9064443e9e7783d17...00c539196175471acc2bbd53f479317aa0b0199b,1,3,38,41,2,2013-03-19 22:11:07,2013-02-14 00:06:05
00c539196175471acc2bbd53f479317aa0b0199b...28af50e403c2567ba66f5497575514774f46023c,2,19,5,24,6,2013-03-19 22:11:07,2013-02-14 00:14:20
28af50e403c2567ba66f5497575514774f46023c...55bfce0de28fbf20740c762867d8f1836299ebca,4,61,19,80,14,2013-03-19 22:11:07,2013-02-14 22:03:51
55bfce0de28fbf20740c762867d8f1836299ebca...d34b4b8d293822240e1e218df4cc1848c94cc5f5,1,0,2,2,2,2013-03-19 22:11:07,2013-02-15 02:33:37
d34b4b8d293822240e1e218df4cc1848c94cc5f5...8057ff07c26a37c1e746aecb35da4f34a3cbb574,1,1,1,2,1,2013-03-19 22:11:07,2013-02-15 03:13:33
8057ff07c26a37c1e746aecb35da4f34a3cbb574...1196c6a247f18b6dca2793006f290162717c2520,1,1,1,2,1,2013-03-19 22:11:07,2013-02-15 03:14:15
1196c6a247f18b6dca2793006f290162717c2520...fe003150bc5c27531a55f1c2fb47cac4763164ce,1,18,3,21,1,2013-03-19 22:11:07,2013-02-15 19:46:14
fe003150bc5c27531a55f1c2fb47cac4763164ce...84927fab91309c697a10bd8fae97c257e947cd0c,3,42,14,56,4,2013-03-19 22:11:07,2013-02-19 23:53:23
84927fab91309c697a10bd8fae97c257e947cd0c...850aea71aee8e83e8cdf230bf8df4a49e1c31b30,3,38,48,86,9,2013-03-19 22:11:08,2013-02-20 03:34:24
850aea71aee8e83e8cdf230bf8df4a49e1c31b30...4aa1201d9f620e569718519dcc0dcba3893365fe,8,234,15,249,16,2013-03-19 22:11:08,2013-02-20 22:32:31
4aa1201d9f620e569718519dcc0dcba3893365fe...f6234b2aa9e56337c02ff75b4528a15e62e417b4,1,4,0,4,1,2013-03-19 22:11:08,2013-02-21 04:38:08
f6234b2aa9e56337c02ff75b4528a15e62e417b4...089c6fad21364b854a3be13d4c8d5ab5918cbfbf,1,0,18,18,1,2013-03-19 22:11:08,2013-02-21 06:21:28
089c6fad21364b854a3be13d4c8d5ab5918cbfbf...2db2392b102e978ba024392aabeaebcf2633da7e,1,13,0,13,2,2013-03-19 22:11:08,2013-02-25 21:59:46
2db2392b102e978ba024392aabeaebcf2633da7e...ee1d36adc39dce1dfa63c337319cf40120f22b61,1,11,1,12,2,2013-03-19 22:11:08,2013-02-27 19:46:55
ee1d36adc39dce1dfa63c337319cf40120f22b61...b8612d7c84aed03075da2aeb74f34212346c4294,1,2,2,4,1,2013-03-19 22:11:08,2013-02-27 19:47:58
b8612d7c84aed03075da2aeb74f34212346c4294...3b6c1bc741560516d170cf86bc8e453aaca0452c,2,5,5,10,5,2013-03-19 22:11:08,2013-03-01 19:37:18
3b6c1bc741560516d170cf86bc8e453aaca0452c...40df77249898e110bfb704c3e079730b46692801,2,28,2,30,15,2013-03-19 22:11:08,2013-02-21 06:19:48
40df77249898e110bfb704c3e079730b46692801...37de5dae21fabb3a7f84c858c1fb44a4579325bb,1,7,0,7,1,2013-03-19 22:11:08,2013-02-22 22:03:05
37de5dae21fabb3a7f84c858c1fb44a4579325bb...5580dd901a180f59faca3a056ba1385e7be6eb75,6,84,34,118,22,2013-03-19 22:11:08,2013-02-22 22:34:23
5580dd901a180f59faca3a056ba1385e7be6eb75...d4660e6d5f87ebc2431a6387146e0ad2ae6e396c,1,4,3,7,2,2013-03-19 22:11:08,2013-02-25 22:22:05
d4660e6d5f87ebc2431a6387146e0ad2ae6e396c...c2a1012fddb1d6c678e3d8f2e27735600fca9841,6,10,10,20,10,2013-03-19 22:11:08,2013-02-25 22:34:25
c2a1012fddb1d6c678e3d8f2e27735600fca9841...86962e30a80e209a414957671a34a89b4e667110,3,42,47,89,16,2013-03-19 22:11:08,2013-02-25 22:58:13
86962e30a80e209a414957671a34a89b4e667110...bba7bda2201342af281e6aceaedb3586b8e6231c,1,0,2,2,1,2013-03-19 22:11:09,2013-02-25 23:03:55
bba7bda2201342af281e6aceaedb3586b8e6231c...5aabe7a85f8a1b9840cfbefb0969462463313c1f,1,7,4,11,4,2013-03-19 22:11:09,2013-02-26 00:32:19
5aabe7a85f8a1b9840cfbefb0969462463313c1f...fcaac0a86caba0ffe2aadde7d1cda811b5751cf2,1,1,1,2,1,2013-03-19 22:11:09,2013-02-26 00:32:24
fcaac0a86caba0ffe2aadde7d1cda811b5751cf2...dcc44529ad4df1a043686cc77008b945d91a9bc7,1,6,4,10,1,2013-03-19 22:11:09,2013-02-26 00:32:46
dcc44529ad4df1a043686cc77008b945d91a9bc7...c6a4b63e987ea425f2bff1a74cb03e8cc56ef1d5,2,15,6,21,5,2013-03-19 22:11:09,2013-02-26 01:47:54
c6a4b63e987ea425f2bff1a74cb03e8cc56ef1d5...a5dc7de519fb772ebd84c232f357a3e935c2bfc9,1,22,20,42,8,2013-03-19 22:11:09,2013-02-26 02:00:09
a5dc7de519fb772ebd84c232f357a3e935c2bfc9...64976872e9edced84f18f6b0a3b64a28b25eac09,6,9,9,18,9,2013-03-19 22:11:09,2013-02-26 02:51:41
64976872e9edced84f18f6b0a3b64a28b25eac09...431ff65731c3c4843ccff8d799b8f76ba055b301,1,10,5,15,4,2013-03-19 22:11:09,2013-02-26 02:56:19
431ff65731c3c4843ccff8d799b8f76ba055b301...794a05b7e6cdad077de638b9cab7d6b1e1ca522d,23,142,266,408,87,2013-03-19 22:11:09,2013-02-26 23:35:28
794a05b7e6cdad077de638b9cab7d6b1e1ca522d...a798fb25ab032ab7b0c09fa9305248a0bddac7bf,1,2,0,2,1,2013-03-19 22:11:09,2013-03-02 02:46:45
a798fb25ab032ab7b0c09fa9305248a0bddac7bf...c421a22457a5b594cdb846ac1a5d7f0b2ecb9450,1,10,3,13,8,2013-03-19 22:11:09,2013-03-02 05:04:15
c421a22457a5b594cdb846ac1a5d7f0b2ecb9450...a919cb34999bb96fcc649a8a3257b01bee6b6011,2,5,2,7,3,2013-03-19 22:11:09,2013-03-02 05:15:57
a919cb34999bb96fcc649a8a3257b01bee6b6011...dfd837934e7bffdbec0a7c8dd3e3172f202ce0f5,1,1,6,7,1,2013-03-19 22:11:09,2013-03-02 05:20:33
dfd837934e7bffdbec0a7c8dd3e3172f202ce0f5...bd6ed0a85d723e7698749d13a0e44aaac650d5ce,1,9,4,13,2,2013-03-19 22:11:10,2013-03-02 05:33:12
bd6ed0a85d723e7698749d13a0e44aaac650d5ce...942b8d3880a64ad614281c52124336f21ed0be81,7,53,17,70,19,2013-03-19 22:11:10,2013-03-02 06:27:33
942b8d3880a64ad614281c52124336f21ed0be81...7c390c66512943e6770bdc00d7fb315e5af5f77a,1,0,0,0,0,2013-03-19 22:11:10,2013-03-04 06:52:58
7c390c66512943e6770bdc00d7fb315e5af5f77a...63af805c02194ee4dc76026e90f0ccf3ae5fe86c,2,90,0,90,2,2013-03-19 22:11:10,2013-03-04 07:12:57
63af805c02194ee4dc76026e90f0ccf3ae5fe86c...40717f1f2061fb7aff2753f6dc7283d82f081594,3,17,7,24,5,2013-03-19 22:11:10,2013-03-05 06:51:27
40717f1f2061fb7aff2753f6dc7283d82f081594...fbfe6547c64d4022f8b067f18d1d6a5d14285cf8,1,5,1,6,1,2013-03-19 22:11:10,2013-03-05 18:20:52
fbfe6547c64d4022f8b067f18d1d6a5d14285cf8...81db8fd5c02542ed0c1e80e07e301021203c8254,1,6,17,23,2,2013-03-19 22:11:10,2013-03-05 18:33:52
81db8fd5c02542ed0c1e80e07e301021203c8254...1eafa07ecd912786fa02f23164287ffea7b7d0ca,3,22,0,22,5,2013-03-19 22:11:10,2013-03-05 19:01:11
1eafa07ecd912786fa02f23164287ffea7b7d0ca...f202c09a2e28ea7305e675f01693de56720c9cab,2,25,11,36,7,2013-03-19 22:11:10,2013-03-05 19:11:48
f202c09a2e28ea7305e675f01693de56720c9cab...aa105b7c8a84da8b9f5ffc0fdf9c0938d79a2d1f,1,1,1,2,1,2013-03-19 22:11:10,2013-03-05 19:33:03
aa105b7c8a84da8b9f5ffc0fdf9c0938d79a2d1f...00d250c376116fc09c690ff9c3d1c60968dd2fac,5,34,56,90,8,2013-03-19 22:11:10,2013-03-05 19:55:23
00d250c376116fc09c690ff9c3d1c60968dd2fac...8e06811e50aaf6083c408f33c9c83b832e8894fd,1,1,1,2,1,2013-03-19 22:11:10,2013-03-05 20:49:41
8e06811e50aaf6083c408f33c9c83b832e8894fd...947ddc73668863b2ab2a90e8dba895fb93438273,1,8,3,11,5,2013-03-19 22:11:10,2013-03-05 21:32:04
947ddc73668863b2ab2a90e8dba895fb93438273...db9747cb39a004e177f8f085d9b98431ddfb8857,1,3,2,5,2,2013-03-19 22:11:11,2013-03-05 22:29:28
db9747cb39a004e177f8f085d9b98431ddfb8857...31de9f8a21a247f33c4ac5464f2154e4298dbac2,1,12,0,12,1,2013-03-19 22:11:11,2013-03-05 22:45:43
31de9f8a21a247f33c4ac5464f2154e4298dbac2...948cf0e2f1adc90ff99adff13d497bad7ffbb894,2,27,244,271,14,2013-03-19 22:11:11,2013-03-05 23:03:46
948cf0e2f1adc90ff99adff13d497bad7ffbb894...776bdb7190939c103275882ec13cc396f591aa0c,2,39,42,81,3,2013-03-19 22:11:11,2013-03-05 23:27:40
776bdb7190939c103275882ec13cc396f591aa0c...528527a2de1c329e3c47cd704595497afa4f66f9,1,1,1,2,1,2013-03-19 22:11:11,2013-03-05 23:48:48
528527a2de1c329e3c47cd704595497afa4f66f9...24f19ce2d8f8bd0437e0c97bd7f8dd52f3010259,1,19,9,28,7,2013-03-19 22:11:11,2013-03-06 00:05:55
24f19ce2d8f8bd0437e0c97bd7f8dd52f3010259...732cfbb88dc1fa9c6fa217af4aed520acc4982b4,1,1,1,2,1,2013-03-19 22:11:11,2013-03-06 00:07:05
732cfbb88dc1fa9c6fa217af4aed520acc4982b4...7d928d7a63f0bc0a87d93b29a27edef8bc496624,1,15,4,19,6,2013-03-19 22:11:11,2013-03-06 00:28:07
7d928d7a63f0bc0a87d93b29a27edef8bc496624...6443d7ba064f7fd423fda13d738c279a9438f859,3,12,24,36,9,2013-03-19 22:11:11,2013-03-06 00:33:02
6443d7ba064f7fd423fda13d738c279a9438f859...db7cfbaff81a7f4a7a1aff6b896849c0812e6f74,1,7,4,11,5,2013-03-19 22:11:11,2013-03-06 00:50:47
db7cfbaff81a7f4a7a1aff6b896849c0812e6f74...a38c5504b051c1547a45a68fd159a769784b1337,1,2,2,4,1,2013-03-19 22:11:11,2013-03-06 00:37:03
a38c5504b051c1547a45a68fd159a769784b1337...c5ed11cfe54b0d3dd4e1f0c40ac515116f0a8c9a,1,4,2,6,4,2013-03-19 22:11:11,2013-03-06 00:59:05
c5ed11cfe54b0d3dd4e1f0c40ac515116f0a8c9a...1a08a0f26d01b48d037c49586665acfc3e4029df,1,5,1,6,1,2013-03-19 22:11:11,2013-03-06 00:55:37
1a08a0f26d01b48d037c49586665acfc3e4029df...5f168a2a4a384d5e8239a2a4d7efed1c48837deb,3,50,24,74,23,2013-03-19 22:11:11,2013-03-06 20:11:32
5f168a2a4a384d5e8239a2a4d7efed1c48837deb...d0656b285f56c30598433806bbaa4f21e78a2754,1,35,22,57,4,2013-03-19 22:11:12,2013-03-06 20:33:57
d0656b285f56c30598433806bbaa4f21e78a2754...3b2aee46f74e1949419673f174c43d938728ca84,1,1,0,1,1,2013-03-19 22:11:12,2013-03-06 20:36:44
3b2aee46f74e1949419673f174c43d938728ca84...95db2bb00bcc31d06c3161a40657932656c61b44,1,3,2,5,3,2013-03-19 22:11:12,2013-03-06 20:44:36
95db2bb00bcc31d06c3161a40657932656c61b44...7fc3b10568756f75f7e2e9154652f48cb3f4d430,1,4,1,5,2,2013-03-19 22:11:12,2013-03-06 21:13:57
7fc3b10568756f75f7e2e9154652f48cb3f4d430...d729cd84e99676194935913971839fc4e3b48f0e,5,21,21,42,17,2013-03-19 22:11:12,2013-03-06 22:37:49
d729cd84e99676194935913971839fc4e3b48f0e...71cc2e61f52fdfe9b36dd712940f3e138d255f34,1,2,1,3,2,2013-03-19 22:11:12,2013-03-06 23:42:18
71cc2e61f52fdfe9b36dd712940f3e138d255f34...c2c5ff5fef9b52d489b9ca83f66325d648704b54,1,6,3,9,3,2013-03-19 22:11:12,2013-03-07 00:09:42
c2c5ff5fef9b52d489b9ca83f66325d648704b54...bf8816733082ca761f50da41f12fa8c88d351668,1,2,2,4,2,2013-03-19 22:11:12,2013-03-07 00:24:49
bf8816733082ca761f50da41f12fa8c88d351668...54d74d3742a6cb3a04880a00f755fee6791ef6cc,1,0,1,1,1,2013-03-19 22:11:12,2013-03-07 00:25:34
54d74d3742a6cb3a04880a00f755fee6791ef6cc...986e435e4714cb8651e82cdd6a9aac29e8a9afcc,1,0,1,1,1,2013-03-19 22:11:12,2013-03-07 00:35:55
986e435e4714cb8651e82cdd6a9aac29e8a9afcc...cdaac4c8bf88396fdc5b8a32a9c60a38f64b8f8a,1,36,6,42,4,2013-03-19 22:11:12,2013-03-07 00:40:11
cdaac4c8bf88396fdc5b8a32a9c60a38f64b8f8a...bd2e6bc5b71f5498f5630ecb000ef4e4b116b1ef,1,2,0,2,1,2013-03-19 22:11:12,2013-03-07 00:55:15
bd2e6bc5b71f5498f5630ecb000ef4e4b116b1ef...f3d391180d1c5929d6d7c04179da6872c3f8492b,1,3,0,3,1,2013-03-19 22:11:12,2013-03-07 00:54:16
f3d391180d1c5929d6d7c04179da6872c3f8492b...72de0602180357306e8e20d4dfa90456c95b7ad3,5,35,24,59,26,2013-03-19 22:11:13,2013-03-07 01:16:28
72de0602180357306e8e20d4dfa90456c95b7ad3...11f4c133fe021374055ed3970d0a9c9c5a9d468a,1,1,1,2,1,2013-03-19 22:11:13,2013-03-07 03:32:29
11f4c133fe021374055ed3970d0a9c9c5a9d468a...2787c6dad0ac8eb5bf084198dc161a11e443507f,39,44,236,280,35,2013-03-19 22:11:13,2013-03-07 04:08:31
2787c6dad0ac8eb5bf084198dc161a11e443507f...6e41827f35c41f06e53733a58c247e83ffc87fb8,1,11,8,19,4,2013-03-19 22:11:13,2013-03-07 04:23:55
6e41827f35c41f06e53733a58c247e83ffc87fb8...def09c9ac447573372afaa4c2a279a5e2d753149,2,6,6,12,6,2013-03-19 22:11:13,2013-03-07 04:27:41
def09c9ac447573372afaa4c2a279a5e2d753149...94c1d3bebefad3803f3b0f4ccbf57270ace562e9,1,4,1,5,1,2013-03-19 22:11:13,2013-03-07 04:28:53
94c1d3bebefad3803f3b0f4ccbf57270ace562e9...e49f60f9548ca7b28807a34b482bd312f1faea0d,1,1,1,2,1,2013-03-19 22:11:13,2013-03-07 04:35:29
e49f60f9548ca7b28807a34b482bd312f1faea0d...6c49cba26b2267edc6ded61ab789b6dc91321f18,2,10,9,19,8,2013-03-19 22:11:13,2013-03-07 07:30:31
6c49cba26b2267edc6ded61ab789b6dc91321f18...1e56a0dfe657041732f10486a62937a5fd1c6c42,1,2,2,4,1,2013-03-19 22:11:13,2013-03-07 07:57:23
1e56a0dfe657041732f10486a62937a5fd1c6c42...c4266f0ab2d2da1ee78c42273e4edca354f749ee,1,1,0,1,1,2013-03-19 22:11:13,2013-03-07 07:57:32
c4266f0ab2d2da1ee78c42273e4edca354f749ee...ee10b47da79ac7ebb83387b0f3a85f43ef176da7,1,3,6,9,3,2013-03-19 22:11:13,2013-03-07 08:06:19
ee10b47da79ac7ebb83387b0f3a85f43ef176da7...ebe5ef3ceffdefe48b37725899039e5c85b555b0,1,1,0,1,1,2013-03-19 22:11:13,2013-03-07 18:36:08
ebe5ef3ceffdefe48b37725899039e5c85b555b0...d36ac07d3fd4dda5b9d6d1b5ecd8fc07af35d253,1,0,0,0,0,2013-03-19 22:11:14,2013-03-07 18:41:32
d36ac07d3fd4dda5b9d6d1b5ecd8fc07af35d253...5849629e0e0139d13d29f241afdbf3afaa0f632e,1,30,12,42,10,2013-03-19 22:11:14,2013-03-07 19:16:03
5849629e0e0139d13d29f241afdbf3afaa0f632e...d7de90d35385f25ede0c5aa9d5e82f49423dec35,1,5,2,7,1,2013-03-19 22:11:14,2013-03-07 19:26:45
d7de90d35385f25ede0c5aa9d5e82f49423dec35...cb43b5252e16634d898997fb0c8adee24b0ef014,1,9,7,16,6,2013-03-19 22:11:14,2013-03-07 19:43:51
cb43b5252e16634d898997fb0c8adee24b0ef014...03b573d195bd8fb8664c006f043f7ee8449f8252,2,13,9,22,2,2013-03-19 22:11:14,2013-03-07 20:02:02
03b573d195bd8fb8664c006f043f7ee8449f8252...63a7b4faa12040f0426304bf740b2133ac06a3db,3,11,0,11,5,2013-03-19 22:11:14,2013-03-07 20:21:56
63a7b4faa12040f0426304bf740b2133ac06a3db...962bce4410092cefbf45179ee9a7463ab4b4222c,1,7,7,14,4,2013-03-19 22:11:14,2013-03-07 20:46:50
962bce4410092cefbf45179ee9a7463ab4b4222c...c27beab095ad3f27335e023d169c5a44e462cd9e,1,3,1,4,1,2013-03-19 22:11:14,2013-03-07 20:48:54
c27beab095ad3f27335e023d169c5a44e462cd9e...46b43fe634ed1310b455987da85e5f71bbcc08e1,4,81,3,84,7,2013-03-19 22:11:14,2013-03-07 21:57:21
46b43fe634ed1310b455987da85e5f71bbcc08e1...3c0d1d7ccf1a79de0332f09545618f74c00e4074,1,0,34,34,1,2013-03-19 22:11:14,2013-03-08 23:33:24
3c0d1d7ccf1a79de0332f09545618f74c00e4074...2b86472804b715b3b2a1dc903d78d77d5e721c04,1,11,0,11,1,2013-03-19 22:11:14,2013-03-09 00:19:02
2b86472804b715b3b2a1dc903d78d77d5e721c04...25ac684588637a245c40ccb9e9ba09da35dddece,1,1,0,1,1,2013-03-19 22:11:14,2013-03-12 05:03:42
25ac684588637a245c40ccb9e9ba09da35dddece...faa181897378ca51027e6007a44acfcac55e6f97,1,2,2,4,2,2013-03-19 22:11:14,2013-03-12 06:42:59
faa181897378ca51027e6007a44acfcac55e6f97...3c8f0b5949e0362c40aba52ad2ad6ba1ddd27570,9,26,16,42,16,2013-03-19 22:11:14,2013-03-12 08:51:20
3c8f0b5949e0362c40aba52ad2ad6ba1ddd27570...5a5204e3a468b7b498baefb259c88a63b23699cf,93,7350,7668,15018,787,2013-03-19 22:13:53,2013-03-12 21:04:05
5a5204e3a468b7b498baefb259c88a63b23699cf...599c6edef85e54cbd68ec7550545446ef7214be8,2,3,5,8,2,2013-03-19 22:13:53,2013-03-12 22:05:42
599c6edef85e54cbd68ec7550545446ef7214be8...c768db3c30c51c62556879c6494baf75eec5e0f5,1,4,1,5,2,2013-03-19 22:13:53,2013-03-12 22:07:50
c768db3c30c51c62556879c6494baf75eec5e0f5...b88bc0b9e727d7bce356210e5b6888f072ba3c07,1,2,1,3,2,2013-03-19 22:13:53,2013-03-12 22:29:47
b88bc0b9e727d7bce356210e5b6888f072ba3c07...4fd0d8c25d82b7a21e6659a81f33f3b3a76867ae,7,58,58,116,38,2013-03-19 22:13:53,2013-03-12 22:36:07
4fd0d8c25d82b7a21e6659a81f33f3b3a76867ae...7201296bca1fea5269fa103705ca33a3950abe28,1,2,1,3,1,2013-03-19 22:13:54,2013-03-12 22:55:19
7201296bca1fea5269fa103705ca33a3950abe28...7b12e007e7a28e27f7fe0d3621fba38080e6b744,1,0,2,2,1,2013-03-19 22:13:54,2013-03-12 22:55:26
7b12e007e7a28e27f7fe0d3621fba38080e6b744...a0e9fc3979ffbfc8d0195c2d95f11ae2d94e7d27,19,19,0,19,19,2013-03-19 22:13:54,2013-03-12 23:05:49
a0e9fc3979ffbfc8d0195c2d95f11ae2d94e7d27...5eb56c6da4243e076fc27b2926257932985362a4,2,10,3,13,4,2013-03-19 22:13:54,2013-03-12 23:06:05
5eb56c6da4243e076fc27b2926257932985362a4...6e2fa5f837f8cb55cc1542bcbd040704365b912f,1,0,70,70,1,2013-03-19 22:13:54,2013-03-12 23:11:54
6e2fa5f837f8cb55cc1542bcbd040704365b912f...8262117bbbe29c09844cc5baebae7436b842e3b8,1,0,193,193,1,2013-03-19 22:13:54,2013-03-12 23:12:26
8262117bbbe29c09844cc5baebae7436b842e3b8...c1f2379710e8d44a806c9e17583f0d6bb2b609d6,1,5,1,6,2,2013-03-19 22:13:54,2013-03-12 23:26:20
c1f2379710e8d44a806c9e17583f0d6bb2b609d6...8b336574ed570ed314c2b2cc9ecba9e36761546c,1,3,1,4,2,2013-03-19 22:13:54,2013-03-12 23:34:11
8b336574ed570ed314c2b2cc9ecba9e36761546c...62a8dd2e38263bae6516c26862f0758abeb8174d,2,1,2,3,2,2013-03-19 22:13:54,2013-03-12 23:49:42
62a8dd2e38263bae6516c26862f0758abeb8174d...8982c7fa3acf02afa003bb836f82155a4ec6f167,1,6,5,11,3,2013-03-19 22:13:54,2013-03-13 00:08:01
8982c7fa3acf02afa003bb836f82155a4ec6f167...d311ad96c47c56046346f84c548491b473598d66,2,4,20,24,3,2013-03-19 22:13:54,2013-03-13 02:06:42
d311ad96c47c56046346f84c548491b473598d66...7b58495472e50a9711a84eaa75daee8b0b4fdbd3,1,1,0,1,1,2013-03-19 22:13:54,2013-03-13 02:18:09
7b58495472e50a9711a84eaa75daee8b0b4fdbd3...cd1d89e8a271c84b1af3e6f70c04676281d43a60,1,2,3,5,2,2013-03-19 22:13:54,2013-03-15 00:12:31
cd1d89e8a271c84b1af3e6f70c04676281d43a60...3c642e25ed945b6996a5f7c28a0fac78968fde66,5,114,16,130,11,2013-03-19 22:13:54,2013-03-15 00:34:21
3c642e25ed945b6996a5f7c28a0fac78968fde66...e858d221dc46fa8da4ca0329eca77e0c3e46c5e4,1,1,1,2,1,2013-03-19 22:13:55,2013-03-15 00:39:51
e858d221dc46fa8da4ca0329eca77e0c3e46c5e4...14b9f23433297bf244f9c9588ea975c5db6bbd9e,1,2,2,4,2,2013-03-19 22:13:55,2013-03-15 00:42:10
14b9f23433297bf244f9c9588ea975c5db6bbd9e...a136425a67338b8e9d4be151bf399e80a2ba4355,1,8,6,14,3,2013-03-19 22:13:55,2013-03-15 00:50:36
a136425a67338b8e9d4be151bf399e80a2ba4355...d9874785d996bd527d731d9096d1721d6277953a,1,1,1,2,1,2013-03-19 22:13:55,2013-03-15 00:52:19
d9874785d996bd527d731d9096d1721d6277953a...66d3b6571f070c5f0eb6a446e6d0c4d297fa7a37,1,1,0,1,1,2013-03-19 22:13:55,2013-03-15 00:54:26
66d3b6571f070c5f0eb6a446e6d0c4d297fa7a37...37e6cd7ac88833bde32d177597e90f6b044efb0f,1,1,1,2,1,2013-03-19 22:13:55,2013-03-15 00:57:56
37e6cd7ac88833bde32d177597e90f6b044efb0f...fa5b8290581e4cb9f1fe84172157252f09ff8c18,1,6,0,6,1,2013-03-19 22:13:55,2013-03-15 05:33:13
fa5b8290581e4cb9f1fe84172157252f09ff8c18...e16c62f5045f8e52d3155f49683d38ce8cd43b32,1,15,0,15,1,2013-03-19 22:13:55,2013-03-15 05:45:49
e16c62f5045f8e52d3155f49683d38ce8cd43b32...6f692daa1011d3b1d16d0c1edd9841ba702f4f77,1,38,13,51,9,2013-03-19 22:13:55,2013-03-15 06:08:00
6f692daa1011d3b1d16d0c1edd9841ba702f4f77...e6837b652c8b727180d244284bf5ba2bcb894f8d,2,25,26,51,10,2013-03-19 22:13:55,2013-03-18 18:53:59
e6837b652c8b727180d244284bf5ba2bcb894f8d...b4d6a4c43e87f4d7ba29ee1a6d51e9afd4da8292,2,16,24,40,7,2013-03-19 22:13:55,2013-03-18 19:25:17
b4d6a4c43e87f4d7ba29ee1a6d51e9afd4da8292...6229252bfb6711115c77acfc4603af33cd4654bd,5,46,32,78,17,2013-03-19 22:13:55,2013-03-18 20:34:57
6229252bfb6711115c77acfc4603af33cd4654bd...ada631af0828e53d18ed752c0fb29d2850edd860,1,6,6,12,3,2013-03-19 22:13:55,2013-03-18 22:28:01
ada631af0828e53d18ed752c0fb29d2850edd860...0aec831ea46d06280a5f2badedb72fa912edb929,1,7,7,14,3,2013-03-19 22:13:55,2013-03-19 01:39:14
0aec831ea46d06280a5f2badedb72fa912edb929...a9ea7498b3932de0deb190bec66ae3fd6203b50e,5,155,105,260,56,2013-03-19 22:13:56,2013-03-19 20:30:05
a9ea7498b3932de0deb190bec66ae3fd6203b50e...8d1ed09df93ecc1b4e80849aca7ad06836469dc9,1,12,5,17,4,2013-03-19 22:13:56,2013-03-19 22:10:06
8d1ed09df93ecc1b4e80849aca7ad06836469dc9...fa0c307c84b837d450389d926362c705b38545af,1,13,13,26,11,2013-03-19 22:13:56,2013-03-19 22:10:21
fa0c307c84b837d450389d926362c705b38545af...8a79edb43b2ba66a4f8e2764afcf5347ffdf092b,70,157,158,315,90,2013-03-20 01:19:31,2013-03-19 23:29:18
8a79edb43b2ba66a4f8e2764afcf5347ffdf092b...5583dc12ede569f67357110d9d10bdd26462d67b,1,6,3,9,2,2013-03-20 01:19:45,2013-03-20 00:02:51
5583dc12ede569f67357110d9d10bdd26462d67b...257f5b8c2da83a1c707e84ed20dff07a17eb3e1b,1,1,1,2,1,2013-03-20 01:19:52,2013-03-20 00:04:14
257f5b8c2da83a1c707e84ed20dff07a17eb3e1b...0825b3d7a2dd561b727652e9c5591b76f85c127f,3,6,6,12,6,2013-03-20 01:19:56,2013-03-20 00:10:28
0825b3d7a2dd561b727652e9c5591b76f85c127f...4f763db5b010ad73fcfa900800b8388a64b0ed69,2,10,3,13,5,2013-03-20 01:20:02,2013-03-20 00:49:25
4f763db5b010ad73fcfa900800b8388a64b0ed69...5c184d07595186b9e2f666166addc2073d7d657b,1,1,1,2,1,2013-03-20 01:46:26,2013-03-20 01:46:26
5c184d07595186b9e2f666166addc2073d7d657b...10c995c549e161f4cad6a1618800e71003532da9,1,122,125,247,57,2013-03-20 02:27:21,2013-03-20 02:27:21
10c995c549e161f4cad6a1618800e71003532da9...fd6234525ea3762201472c455b9acee9b33f45d0,2,20,20,40,5,2013-03-20 02:32:39,2013-03-20 02:32:39
fd6234525ea3762201472c455b9acee9b33f45d0...623ad4ae5fce89109f78c23e297f6c63ed1611c0,4,26,26,52,22,2013-03-20 02:36:10,2013-03-20 02:36:10
623ad4ae5fce89109f78c23e297f6c63ed1611c0...4ebb21c4390cfe3592679299c07d6f94392cd9e3,1,3,2,5,3,2013-03-20 02:39:02,2013-03-20 02:39:02
4ebb21c4390cfe3592679299c07d6f94392cd9e3...781eb54a5be59ff5ca8b5592d8edf98cc6243ffd,1,11,8,19,3,2013-03-20 02:42:08,2013-03-20 02:42:08
781eb54a5be59ff5ca8b5592d8edf98cc6243ffd...764b4860eaeebedb6f56bc5c72f1aeb744bbcd99,2,48,32,80,19,2013-03-20 02:56:15,2013-03-20 02:56:15
764b4860eaeebedb6f56bc5c72f1aeb744bbcd99...b7bec5a39114e7fb0affa53aebfaa9a86d217be2,3,3,3,6,3,2013-03-20 03:22:01,2013-03-20 03:22:01
b7bec5a39114e7fb0affa53aebfaa9a86d217be2...83907a9f5b9561e5001d94f79efe8de2a2cd7623,1,9,9,18,1,2013-03-20 03:31:48,2013-03-20 03:31:48
83907a9f5b9561e5001d94f79efe8de2a2cd7623...c08b54492e024de8e032022329c8fc3bf53bf0dc,1,1,1,2,1,2013-03-20 03:31:50,2013-03-20 03:31:50
c08b54492e024de8e032022329c8fc3bf53bf0dc...b1b707546d1de266422a2d92bda9003d61967c31,4,60,33,93,12,2013-03-20 05:34:44,2013-03-20 05:34:44
b1b707546d1de266422a2d92bda9003d61967c31...7712b3a077f8f5f0ceb1a1e8222f05ec19168a99,3,36,22,58,6,2013-03-20 06:25:21,2013-03-20 06:25:21
7712b3a077f8f5f0ceb1a1e8222f05ec19168a99...487ce383fe28d89b9142deeefe62a9a170951c74,1,19,4,23,3,2013-03-20 06:39:18,2013-03-20 06:39:18
487ce383fe28d89b9142deeefe62a9a170951c74...245c8b5d106db6201b9e392614d83151471e28c1,1,99,99,198,3,2013-03-20 06:42:07,2013-03-20 06:42:07
245c8b5d106db6201b9e392614d83151471e28c1...dd6bf35b8083719b7272d113c3a7c745f8e1372a,4,17,17,34,12,2013-03-20 06:45:06,2013-03-20 06:45:06
dd6bf35b8083719b7272d113c3a7c745f8e1372a...570b3567f9387f78ecc6c8a1a12173dd15928099,6,14,11,25,10,2013-03-20 06:49:44,2013-03-20 06:49:44
570b3567f9387f78ecc6c8a1a12173dd15928099...54109036969981c13db606f12fe70b8f077f5478,1,10,1,11,2,2013-03-20 07:02:55,2013-03-20 07:02:55
54109036969981c13db606f12fe70b8f077f5478...652b9b9209705e8eb84ac935b63acdba112bcca1,3,25,13,38,9,2013-03-20 07:22:39,2013-03-20 07:22:39
652b9b9209705e8eb84ac935b63acdba112bcca1...9898e7cff69da6b7e9bef2bf7cd12b1ba9d624b9,1,1,3,4,1,2013-03-20 07:23:32,2013-03-20 07:23:32
9898e7cff69da6b7e9bef2bf7cd12b1ba9d624b9...1b679236cb278f9f3800fb72b5f0f1a59142d308,4,9,128,137,9,2013-03-20 07:32:00,2013-03-20 07:32:00
727061188949ba59547cfdf72d55c182ba658ac5...78aa38ed8f34a48d1b6354d32488a03196e02e1c,1,1,1,2,1,2013-02-27 23:39:54,2013-02-25 17:14:13
78aa38ed8f34a48d1b6354d32488a03196e02e1c...ff381e925f1585318fb22f8a156035e2a48e26f3,1,2,1,3,1,2013-02-27 23:40:37,2013-02-27 23:40:37
abc441f22af1ed4efa3f2abca1d25ba38965e282...4f3645ee3719bda1fe73777d44452c7474734560,1,24,4,28,6,2013-03-05 02:09:04,2013-03-05 02:09:04
4f3645ee3719bda1fe73777d44452c7474734560...7e90bc92686e1b614b08fb891870fa0cdc05a41b,2,87,119,206,9,2013-03-05 02:09:13,2013-03-05 02:09:13
7e90bc92686e1b614b08fb891870fa0cdc05a41b...548b3945d26d08cb7574026fbebba4ddf794ef90,1,2,103,105,3,2013-03-05 02:45:05,2013-03-05 02:45:05
885ba59cbdf2bb54f4567ae468657063f6cd4f32...a6380750a24deb59665cfd82448d23ae19f6c550,3,30,40,70,15,2013-03-12 08:40:09,2013-03-12 08:40:09
df93f65bb3635ae39f82a9bff433b4263ee4dc26...514bf7380715dd8fa87e75947055986d954cedc7,2,13,18,31,6,2013-02-01 20:21:08,2013-02-01 20:21:08
d2f1744c876c52cee32fab41a49b6eb8a5a6d378...455fcaa14d4796ff945ca8f761c26f3e83831911,1,22,21,43,9,2013-01-31 21:48:39,2013-01-31 21:48:14
455fcaa14d4796ff945ca8f761c26f3e83831911...39f4b5edc22b06996fac0fe3b29ad46f7352a7a4,1,9,58,67,2,2013-01-31 21:54:14,2013-01-31 21:54:14
39f4b5edc22b06996fac0fe3b29ad46f7352a7a4...dc33617804e8d558a9fd24c68ffc0876fa431268,1,7,2,9,2,2013-01-31 22:08:22,2013-01-31 22:08:22
dc33617804e8d558a9fd24c68ffc0876fa431268...5b4cf240f05d4476d42acd31e28da173a86869d2,1,8,2,10,2,2013-01-31 22:10:54,2013-01-31 22:10:54
5b4cf240f05d4476d42acd31e28da173a86869d2...3d2573ecabddc35967ca29a0952a4d937daf59f6,1,21,1,22,9,2013-01-31 22:21:40,2013-01-31 22:21:40
3d2573ecabddc35967ca29a0952a4d937daf59f6...4599e0313387142d7f7169bf9405d8d3f9b42e34,1,9,18,27,4,2013-02-01 19:45:53,2013-02-01 19:45:53
c8c5fdbf0d5c2a591209fd50bf6b9a9030f39365...6fee95fc348772ac75482d7a31673434882bf7b2,2,12,3,15,2,2012-12-13 06:01:09,2012-12-13 06:01:09
6fee95fc348772ac75482d7a31673434882bf7b2...1070a682fd651ffd35a13b8193de899c8ec61f1b,2,1,1,2,1,2012-12-14 01:49:09,2012-12-14 01:49:09
1070a682fd651ffd35a13b8193de899c8ec61f1b...836c80ef67f4b334474e3726c08674d60bcd7a9c,1,3,0,3,1,2012-12-14 17:34:33,2012-12-14 17:34:33
836c80ef67f4b334474e3726c08674d60bcd7a9c...02c092e140adca82ce587edf092f1767665d2a0b,1,3,2,5,1,2012-12-14 17:43:50,2012-12-14 17:43:50
02c092e140adca82ce587edf092f1767665d2a0b...7fb8f22a64a6e081ae47d887f88ba3772ca89172,1,6,3,9,1,2012-12-14 17:46:48,2012-12-14 17:46:48
7fb8f22a64a6e081ae47d887f88ba3772ca89172...3d870954ca5b63ab0037c1ca41085cab579bcd0e,2,17,5,22,6,2012-12-14 23:14:04,2012-12-14 23:13:15
3d870954ca5b63ab0037c1ca41085cab579bcd0e...f68a8a34316724d2afc4fac4e333358bba2e968f,1,2,0,2,1,2012-12-17 18:06:48,2012-12-17 18:06:48
9bb2b5447e845c4f483df5e9b42a2c1de5ab909b...7684c726c84bdf6c83a95c090ea9ce0e51afeb84,1,2,1,3,1,2013-07-19 18:12:18,2013-07-19 17:23:15
7684c726c84bdf6c83a95c090ea9ce0e51afeb84...d0ae0a86eaa832cf2b68c0c885485c1bf72965a4,1,3,3,6,3,2013-07-19 18:12:18,2013-07-19 17:53:47
d0ae0a86eaa832cf2b68c0c885485c1bf72965a4...abe145736d0c6362a76b5d985d166fbe41c426b2,5,5,5,10,5,2013-07-19 18:13:17,2013-07-19 17:55:24
abe145736d0c6362a76b5d985d166fbe41c426b2...18168429d831eb2a799e7d69902eaf03fb3aacbb,1,4,0,4,1,2013-07-19 18:13:17,2013-07-19 18:08:09
18168429d831eb2a799e7d69902eaf03fb3aacbb...ab0e8e770ef5ccd25c8fbd0886683adcb6510ca3,2,2,2,4,2,2013-07-19 18:52:04,2013-07-19 18:51:58
ab0e8e770ef5ccd25c8fbd0886683adcb6510ca3...e8af79e15196f0be29698038c3e1f393239b5da2,5,5,5,10,5,2013-07-19 19:09:01,2013-07-19 19:08:53
e8af79e15196f0be29698038c3e1f393239b5da2...6d6a0977e2c2aea1698c129cb86a3fdb94937fc9,2,5,3,8,3,2013-07-19 22:32:57,2013-07-19 22:32:57
6d6a0977e2c2aea1698c129cb86a3fdb94937fc9...614ab6a172afd4747a13c812f499a36129e21248,5,5,5,10,5,2013-07-19 22:54:21,2013-07-19 22:54:21
9bb2b5447e845c4f483df5e9b42a2c1de5ab909b...09aa00494a14c284af7ea48d6fbd892bd1b1abd8,2,2,1,3,2,2013-07-19 00:08:26,2013-07-19 00:08:26
09aa00494a14c284af7ea48d6fbd892bd1b1abd8...62236997ce7b1d1446d030ded12e55848f31f624,1,1,1,2,1,2013-07-19 00:09:44,2013-07-19 00:09:44
62236997ce7b1d1446d030ded12e55848f31f624...b0ad2d2b7cc97ed92a69c4e6d143dc29886fad25,2,2,2,4,2,2013-07-19 19:26:54,2013-07-19 19:26:54
b0ad2d2b7cc97ed92a69c4e6d143dc29886fad25...55e244bc5d76ef773dea5ed1cb0b8665ec9776c3,2,2,1,3,2,2013-07-29 19:39:44,2013-07-29 19:39:44
55e244bc5d76ef773dea5ed1cb0b8665ec9776c3...90c2e22fb38fd917ab4f94d1e5e6e38fa2d63a95,1,1,1,2,1,2013-08-07 23:02:50,2013-08-07 23:01:06
8ac7d47463ed877c66759bd4f57e95e9b17c161a...b7754f8c288949edc03df5b45fa6c7aecd56156a,54,420,467,887,100,2013-05-18 01:00:35,2013-05-06 22:37:01
b7754f8c288949edc03df5b45fa6c7aecd56156a...107a06fd8c504dad2eb2385b5d61b3a91e3573d3,9,118,97,215,10,2013-05-18 01:00:35,2013-05-06 23:10:18
107a06fd8c504dad2eb2385b5d61b3a91e3573d3...b239f08ad7bba9fdfb87d6b7b75d158be06c2f6f,9,147,138,285,9,2013-05-18 01:00:35,2013-05-06 23:28:58
b239f08ad7bba9fdfb87d6b7b75d158be06c2f6f...9b1b6da9ff020ffdf8e90e3f648848c0fa59bd72,10,155,122,277,13,2013-05-18 01:00:35,2013-05-06 23:44:58
9b1b6da9ff020ffdf8e90e3f648848c0fa59bd72...8f2eb9b48195f5bc393f46b18ba2e7fb00725381,9,112,91,203,10,2013-05-18 01:00:35,2013-05-07 00:09:43
8f2eb9b48195f5bc393f46b18ba2e7fb00725381...d57f7047f4388c67ed34d2aca13aabd54f8753e5,9,122,101,223,10,2013-05-18 01:00:35,2013-05-07 00:43:50
d57f7047f4388c67ed34d2aca13aabd54f8753e5...00efa2fe51ac4b7e07d31b5b8840aef0fc635424,25,134,87,221,81,2013-05-18 01:00:35,2013-05-07 19:27:46
00efa2fe51ac4b7e07d31b5b8840aef0fc635424...a3f493bb79c97db1e8c8d88bba57b71eec9424ab,8,39,2,41,10,2013-05-18 04:01:14,2013-05-07 21:42:15
a3f493bb79c97db1e8c8d88bba57b71eec9424ab...44ac53f8199509183a1b3dc0fa4eb578f5e2e905,13,34,15,49,15,2013-05-18 04:01:14,2013-05-18 01:25:26
44ac53f8199509183a1b3dc0fa4eb578f5e2e905...3123d78adf6653137b4fb74a28be1ae0be942f8c,1,7,0,7,1,2013-05-18 04:29:12,2013-05-18 04:29:12
70af63b286a144daa584000ed9d679ae8b6ee53f...028062bef4ba263c792315fdc96b02f15502f67a,2,4,3,7,2,2013-05-06 19:12:46,2013-05-06 19:12:46
028062bef4ba263c792315fdc96b02f15502f67a...98c5efd8f16b92bf0855fbf43016a7475ee33943,1,1,0,1,1,2013-05-06 19:13:02,2013-05-06 19:13:02
98c5efd8f16b92bf0855fbf43016a7475ee33943...3952be8183864360621d8c31d340a7fc733ee99d,3,19,2,21,4,2013-05-06 22:38:20,2013-05-06 22:37:17
3952be8183864360621d8c31d340a7fc733ee99d...c39e44e6402ed410cd370eba62ca2a214098881b,2,7,7,14,6,2013-05-06 22:50:42,2013-05-06 22:50:42
c39e44e6402ed410cd370eba62ca2a214098881b...1f7627582b92477bd1b4485163c6de3c8f51be95,4,41,4,45,6,2013-05-06 23:04:18,2013-04-27 13:11:09
eecc97715feecdaae054d85d1d40ec32f1b1bb1b...c83fcbb5caa33eca2425b90b4642e4efa6df62d2,2,4,4,8,2,2013-04-25 21:20:29,2013-04-21 17:40:50
c83fcbb5caa33eca2425b90b4642e4efa6df62d2...8b047447fc3e0b54b9d713253d5a0d7db248e550,2,11,0,11,2,2013-04-25 21:24:13,2013-04-25 21:24:13
c9bacb897e6c15c256656999268c0dfcc038e01b...03085e8842e38f50e70bdf569b9059dcb4d29264,2,17,18,35,5,2013-04-22 22:39:41,2013-04-19 21:05:17
03085e8842e38f50e70bdf569b9059dcb4d29264...6e924979be81ca2993775f5f4ce972204dcb90b6,3,88,41,129,12,2013-04-22 22:39:53,2013-04-22 18:15:28
6e924979be81ca2993775f5f4ce972204dcb90b6...a66816635120bbb407c9ed11129485f74d8643ec,1,1,2,3,1,2013-04-22 22:40:04,2013-04-22 19:30:50
a66816635120bbb407c9ed11129485f74d8643ec...f6028b1578dee5698b0ab3b801bdafd3701ac5f2,6,154,152,306,33,2013-04-22 22:40:04,2013-04-22 19:33:37
f6028b1578dee5698b0ab3b801bdafd3701ac5f2...b8b8f1b6f4fa75f159d3e930203c4941af8fc88c,1,14,16,30,2,2013-04-22 22:40:04,2013-04-22 22:31:14
6414dd4e6f7e94981ec2592531606c6ec083d4a8...a3a75e396109dfdc4dc75837bd732a2b4e98f806,2,7530,6118,13648,533,2013-04-09 22:57:00,2013-04-07 01:58:25
a3a75e396109dfdc4dc75837bd732a2b4e98f806...1a636a41e04fc82eb37773512546321b2213b5ff,1,4,1,5,1,2013-04-09 22:57:00,2013-04-09 22:38:52
3a69e609b94609050b93e995bcf1ade8e344de15...7eb4dbe7c2ba1da4d65e7f75ec29b7da7bac120f,2,2,2,4,2,2013-03-20 07:44:16,2013-03-20 07:44:16
7eb4dbe7c2ba1da4d65e7f75ec29b7da7bac120f...212e3f2e8c9a4e5de6be4846cb4279fa3a93a14a,2,5,1,6,2,2013-03-20 19:10:07,2013-03-20 19:10:07
212e3f2e8c9a4e5de6be4846cb4279fa3a93a14a...2f1ef40f795639d20db062a9b9a4cd99204672b0,1,6,3,9,5,2013-03-20 19:34:54,2013-03-20 19:34:54
58f243869ca5947a7ea6412dfcaa26b604b1ef78...4bf1b76a71c7665fb9443708f01a6b9b9f1ddd26,1,1,1,2,1,2013-03-14 10:50:36,2013-03-14 10:50:36
4bf1b76a71c7665fb9443708f01a6b9b9f1ddd26...30643c5008f0e12d8fe6cee0ade214950c635f0c,2,12,0,12,2,2013-03-14 13:03:39,2013-03-14 13:03:39
30643c5008f0e12d8fe6cee0ade214950c635f0c...0ead1fbf4123d270e164a38d5734298dc053addd,1,1,1,2,1,2013-03-14 13:32:06,2013-03-14 13:32:06
58f243869ca5947a7ea6412dfcaa26b604b1ef78...88f2969fa2dbebe5ae28082b1bc2e90121e7697a,4,22,6,28,11,2013-02-28 19:02:25,2013-02-28 19:01:09
88f2969fa2dbebe5ae28082b1bc2e90121e7697a...307172885ab7c8a935b0fdc5741457e31c135875,2,6,28,34,8,2013-02-28 21:19:58,2013-02-28 21:18:51
307172885ab7c8a935b0fdc5741457e31c135875...a60f4eeddd5255cda5769f47d874d67117de21de,1,1,1,2,1,2013-02-28 22:37:23,2013-02-28 08:17:28
a60f4eeddd5255cda5769f47d874d67117de21de...bf81b0a1dedc2a8316b8e266d5b3d9e910cee735,1,9,0,9,1,2013-03-01 16:42:57,2013-03-01 16:34:14
bf81b0a1dedc2a8316b8e266d5b3d9e910cee735...e5a0734fa40dc6ab9b9cfeeb75f94bb3c29df523,2,6,4,10,2,2013-03-01 16:42:57,2013-03-01 16:42:04
e5a0734fa40dc6ab9b9cfeeb75f94bb3c29df523...105cb9e67f3083047b408e30f04f0de22ebeb2ca,1,15,2,17,1,2013-03-02 02:43:20,2013-03-02 02:43:20
105cb9e67f3083047b408e30f04f0de22ebeb2ca...0c75a19774e46d0dca8107970426875a40120c14,1,8,1,9,1,2013-03-02 03:18:42,2013-03-02 02:51:20
0c75a19774e46d0dca8107970426875a40120c14...82d5d0e1904c0a352a0155974d251b0979c3f927,1,7,5,12,2,2013-03-03 02:04:10,2013-02-28 06:53:03
82d5d0e1904c0a352a0155974d251b0979c3f927...a08e28b6bd26b1476d24a81540c5c8f95ce40a00,1,1,1,2,1,2013-03-03 02:08:16,2013-03-03 02:08:16
833769c97da0b8831ef03a7e3dcb682b6319be14...ad12bc6576407300ba6679c84ee51f658c79888d,1,4,4,8,3,2013-03-05 23:46:16,2013-03-05 23:46:16
ad12bc6576407300ba6679c84ee51f658c79888d...150a048137fe9463ae0019d4ff25b9ac36d8fff6,2,143,40,183,24,2013-03-06 00:14:41,2013-03-06 00:14:41
150a048137fe9463ae0019d4ff25b9ac36d8fff6...32ee127fe3486b0dd6dfbde65bcb047e61e80c88,1,72,1,73,3,2013-03-06 00:43:44,2013-03-06 00:43:44
32ee127fe3486b0dd6dfbde65bcb047e61e80c88...f378b145bf6a5108491425d9b4f1d8f75f08bff3,1,8,11,19,2,2013-03-06 10:23:56,2013-03-06 10:23:56
f378b145bf6a5108491425d9b4f1d8f75f08bff3...d70a56f6d7329468d44ff7b0278e096783a8febd,4,90,49,139,32,2013-03-06 18:19:52,2013-03-06 18:19:52
d70a56f6d7329468d44ff7b0278e096783a8febd...56a05e285d970630659acea2eb4b8dfa059db9b7,2,20,34,54,12,2013-03-06 18:45:09,2013-03-06 18:45:09
56a05e285d970630659acea2eb4b8dfa059db9b7...5714225039ed7d7efb3da9ec79dbc920dc5a4ffa,1,18,19,37,4,2013-03-06 18:56:49,2013-03-06 18:56:49
5714225039ed7d7efb3da9ec79dbc920dc5a4ffa...96ef17eceda411d12f0990045106515ce00405d1,2,35,9,44,9,2013-03-06 19:37:33,2013-03-06 19:37:33
96ef17eceda411d12f0990045106515ce00405d1...20612a17f96587dd0d73143379149a60871de0fd,2,67,9,76,4,2013-03-06 20:03:45,2013-03-06 20:03:45
20612a17f96587dd0d73143379149a60871de0fd...6fb7df9f98fa1240870f66d244751020fa26d017,1,5,1,6,2,2013-03-07 01:35:57,2013-03-07 01:35:57
6fb7df9f98fa1240870f66d244751020fa26d017...a0f0f64b7f5fef02d0e964fdff59f72e18e5edc2,3,290,80,370,24,2013-03-07 01:36:05,2013-03-07 01:36:05
a0f0f64b7f5fef02d0e964fdff59f72e18e5edc2...b38ec5513da64a08084244c67febf4a4275342a4,2,3,0,3,3,2013-03-07 03:14:01,2013-03-07 03:14:01
b38ec5513da64a08084244c67febf4a4275342a4...334f172cacfd496da9d97397fe1d1d06e2b3961b,9,125,189,314,66,2013-03-08 01:44:21,2013-03-08 01:44:07
334f172cacfd496da9d97397fe1d1d06e2b3961b...9c932dadced9ae9a5d291ad10841ee2dc5f49971,3,149,10,159,6,2013-03-08 04:51:08,2013-03-08 04:51:08
9c932dadced9ae9a5d291ad10841ee2dc5f49971...6974cfb7b4b413d223b75b06f20cfaa9a784af01,1,4,1,5,2,2013-03-08 06:01:30,2013-03-08 06:01:30
6974cfb7b4b413d223b75b06f20cfaa9a784af01...717ed1f6f95369d6dca78254da189d5d01a9ed35,5,99,127,226,44,2013-03-08 07:10:44,2013-03-08 07:10:44
717ed1f6f95369d6dca78254da189d5d01a9ed35...2d35276f4c7adc9e3eca27c61024ad8023b8f235,3,158,44,202,12,2013-03-08 08:49:43,2013-03-08 08:49:30
2d35276f4c7adc9e3eca27c61024ad8023b8f235...e9dcb927fbdb3d5d3ae55dd54a54c89fe9de1b1d,2,5,5,10,5,2013-03-08 09:42:09,2013-03-08 09:42:09
e9dcb927fbdb3d5d3ae55dd54a54c89fe9de1b1d...69ee6af08a8524fe6fb9790d84e8eddd5ed71ace,3,43,43,86,25,2013-03-08 20:06:05,2013-03-08 20:06:05
abe3ee9cbe08802ea7fcd6d3458b90c24c442074...a3287a6f4098e4b38e5d7a583c7954200da428fe,1,3,0,3,1,2013-03-12 17:45:31,2013-03-12 17:45:31
514bf7380715dd8fa87e75947055986d954cedc7...b013c573eab8c6007d9914cbbd074aeed2789488,1,18,0,18,1,2013-02-01 23:07:51,2013-01-17 18:01:57
b013c573eab8c6007d9914cbbd074aeed2789488...fb3aafc794c9e7cf7fe3f044fb8e7b4ebb414fb1,1,15,13,28,4,2013-02-01 23:22:01,2013-02-01 23:22:01
e1aa360b988f9496b27255fc5007c9c6c92ce977...39fa69e90cd459b06848973daf9c15f1c4272d8e,1,1,1,2,1,2013-02-02 00:44:05,2013-02-02 00:44:05
39fa69e90cd459b06848973daf9c15f1c4272d8e...78b5ee5e7d13650ef1440ce4b33c3a3eed6a9625,1,6,4,10,4,2013-02-02 01:43:44,2013-02-02 01:40:59
78b5ee5e7d13650ef1440ce4b33c3a3eed6a9625...90afe9e9d55c2721ee478fa761674f28dcc6b52e,4,68,30,98,22,2013-02-04 21:20:21,2013-02-04 21:20:21
90afe9e9d55c2721ee478fa761674f28dcc6b52e...d92628020f23d0058024a0ce25866d3977b01545,5,95,71,166,39,2013-02-04 22:42:45,2013-02-04 22:41:25
d92628020f23d0058024a0ce25866d3977b01545...a866689c6a3ebd18d09deb8a258992eaa8c8e845,2,20,4,24,5,2013-02-05 00:12:49,2013-02-05 00:12:49
a866689c6a3ebd18d09deb8a258992eaa8c8e845...1ca1f565d14f207ba4be0221406f59d8a579c108,4,35,32,67,22,2013-02-05 01:03:29,2013-02-05 01:03:29
f68a8a34316724d2afc4fac4e333358bba2e968f...aee54f3ac057c176c0ade7842a88db564a95e4b4,2,49,3,52,8,2012-12-17 22:44:02,2012-12-12 06:30:28
aee54f3ac057c176c0ade7842a88db564a95e4b4...0faaa07c777e59f9bad7d65ed3b2b4021db2c039,2,14,5,19,2,2012-12-17 22:44:02,2012-12-15 02:52:27
0faaa07c777e59f9bad7d65ed3b2b4021db2c039...2d9e8a8fd62a79069af0dfa1bf7ffb925a80ea17,1,126,116,242,5,2012-12-17 22:44:02,2012-12-12 06:33:37
2d9e8a8fd62a79069af0dfa1bf7ffb925a80ea17...33fa24e912ba61796aade4432644286741016cf4,2,10,2,12,4,2012-12-17 22:44:02,2012-12-15 03:50:32
33fa24e912ba61796aade4432644286741016cf4...ac81438f74ceb5f801c76c55441c8813a03a5948,1,47,25,72,15,2012-12-17 22:44:02,2012-12-16 01:32:25
ac81438f74ceb5f801c76c55441c8813a03a5948...e32502c20c48b602bc437853f69787d0b51c6276,1,4,0,4,1,2012-12-17 22:44:02,2012-12-17 17:53:21
2e78d0d110443ac6fb9471e6be1c136f15f03fd2...58cdf660a3887554a7fcad16f87228464847313c,3,15,4,19,5,2013-07-27 03:19:55,2013-07-27 03:04:47
614ab6a172afd4747a13c812f499a36129e21248...9f0e498155bf163183409c748c73589cc19232b7,5,10,4,14,6,2013-10-21 04:53:07,2013-10-21 04:53:07
9f0e498155bf163183409c748c73589cc19232b7...2e7e82eab61dea426b433d81029aa0b096f0657a,1,20,3,23,3,2013-10-21 20:53:16,2013-06-10 23:22:08
2e7e82eab61dea426b433d81029aa0b096f0657a...860183532e5d56355c4def7340513f3335e1681d,2,17,15,32,14,2013-10-21 21:14:01,2013-10-04 22:47:55
41b04fc4add14b390ffe3a82a922ca7922b7067e...e0ef4d4ce9cc69f2fbfb05f8d1f42c2708cd940a,1,7,8,15,2,2013-06-10 21:01:17,2013-06-10 21:01:07
e0ef4d4ce9cc69f2fbfb05f8d1f42c2708cd940a...b61eea15097f38880cfa9e5ac5c92c6bd30c0731,1,9,3,12,2,2013-06-10 21:01:18,2013-06-10 20:30:22
41b04fc4add14b390ffe3a82a922ca7922b7067e...3c5c9579dfdec4b1705ec2fba317e5308b120299,1,2,2,4,2,2013-06-10 19:32:58,2013-06-10 19:32:58
3c5c9579dfdec4b1705ec2fba317e5308b120299...e72c7472a8af66b74b92126815c776d0f929f9f2,1,41,0,41,1,2013-06-10 20:18:32,2013-06-10 20:18:32
e72c7472a8af66b74b92126815c776d0f929f9f2...acf2f716a18716442474cb0e44f1b149c5f0fdcd,1,1,1,2,1,2013-06-10 21:37:40,2013-06-10 21:37:40
acf2f716a18716442474cb0e44f1b149c5f0fdcd...4e4e5add87c357f0f0d0ad8add6dd03c1655e39d,1,1,1,2,1,2013-06-10 22:47:56,2013-06-10 22:47:01
4e4e5add87c357f0f0d0ad8add6dd03c1655e39d...870b0c5065356993a44785194da9756e697cdf35,3,3,3,6,3,2013-06-10 22:52:30,2013-06-10 22:52:30
870b0c5065356993a44785194da9756e697cdf35...1ae01d3149b0c8b96684392b10cce115eb72d803,1,5,1,6,2,2013-06-10 22:53:50,2013-06-10 22:53:50
1ae01d3149b0c8b96684392b10cce115eb72d803...664fca93e26676d5be50b5fb49e248bae5e6e782,1,20,3,23,3,2013-06-10 23:22:08,2013-06-10 23:22:08
7dfa3b5f580d1c79956fc6eafeb6c639ed264d36...9822ace0466aad4ab3cbf4e22315b8179c2a550c,2,5,2,7,3,2013-05-21 04:47:59,2013-05-21 04:47:59
9822ace0466aad4ab3cbf4e22315b8179c2a550c...24e38c75c67da56f03b1eb8770d99920a6a139b4,1,1,1,2,1,2013-05-21 20:35:29,2013-05-21 20:30:35
24e38c75c67da56f03b1eb8770d99920a6a139b4...9557a8b0ab6feaef6e80992b012a234b96829ccd,2,2,2,4,2,2013-05-22 03:02:33,2013-05-22 03:02:33
1f7627582b92477bd1b4485163c6de3c8f51be95...6c8a4b590bac4548cb253f583f8dc74a34c13b2a,6,38,34,72,31,2013-05-06 23:14:32,2013-04-25 01:09:09
6c8a4b590bac4548cb253f583f8dc74a34c13b2a...74a3c77a9f8b93fa1f6872a1be82f6907e017720,1,3,0,3,1,2013-05-06 23:16:15,2013-05-06 23:16:15
10600ef684a24776c389a476d3f5edee781d76bb...b9693f4e1e11f8536a36a4c09e00a4049a79041d,11,64,31,95,20,2013-04-25 21:39:45,2013-04-25 21:39:45
894eea9e2516c2779e522c78d1745ba92bacea94...11550d154c4c68eeff4a0b82f9fda2c51c015bc6,1,3,0,3,1,2013-04-22 22:42:45,2013-04-22 22:42:45
11550d154c4c68eeff4a0b82f9fda2c51c015bc6...fe57ab10c78e00923ab2ad055b7568eb819ea3eb,1,1,6,7,1,2013-04-22 23:04:23,2013-04-22 23:04:20
73afb30fb3efd71abaf7268d870381d2f0aad43e...308395da460c6a94e88df1dd901b622f520eed86,2,8,3,11,4,2013-04-09 23:03:57,2013-04-09 23:03:57
2f1ef40f795639d20db062a9b9a4cd99204672b0...eeab9aa6f655a350217a37e4973cf72fc64f9bab,1,4,2,6,3,2013-03-20 20:27:47,2013-03-20 20:27:47
2f1ef40f795639d20db062a9b9a4cd99204672b0...62884e8cbeafaf5ac95c367a9564d8675975bbe5,7,97,1,98,7,2013-03-20 20:22:58,2013-02-26 00:40:28
62884e8cbeafaf5ac95c367a9564d8675975bbe5...bc587d7f4b3e10a53a14e2402a47773c8af3b57a,1,9,1,10,4,2013-03-20 20:22:59,2013-02-26 00:59:11
bc587d7f4b3e10a53a14e2402a47773c8af3b57a...250ab97561182de5af14e1a2baadf8adc4c4ec42,1,12,0,12,1,2013-03-20 20:22:59,2013-02-26 01:19:37
250ab97561182de5af14e1a2baadf8adc4c4ec42...cbf663be81970f6afaef08b151ce925701cff0a3,2,10,4,14,5,2013-03-20 20:22:59,2013-02-26 23:50:25
cbf663be81970f6afaef08b151ce925701cff0a3...4deddb6c248e1320b75797d162ea8a5d58f8c7f5,1,1,0,1,1,2013-03-20 20:22:59,2013-02-27 00:08:27
4deddb6c248e1320b75797d162ea8a5d58f8c7f5...1a2fa293078c19476aef0d5d2341d0f234623541,1,3,1,4,2,2013-03-20 20:22:59,2013-02-27 18:59:13
1a2fa293078c19476aef0d5d2341d0f234623541...a67578d2cfd53b3ae99179525f106a6032eec1a3,5,94,7,101,17,2013-03-20 20:22:59,2013-02-28 06:10:47
a67578d2cfd53b3ae99179525f106a6032eec1a3...9b8415d113eb5304e39cc0d67788ee8bebc4083e,1,19,13,32,7,2013-03-20 20:22:59,2013-03-01 05:20:20
9b8415d113eb5304e39cc0d67788ee8bebc4083e...dca5741e66988762995e9ca9dd8721ebbb85f59c,1,1,1,2,1,2013-03-20 20:22:59,2013-03-01 16:30:10
dca5741e66988762995e9ca9dd8721ebbb85f59c...e552dc5f04672431ad2df433080c3ed7c1a00ca0,2,5,10,15,3,2013-03-20 20:22:59,2013-03-02 02:13:32
e552dc5f04672431ad2df433080c3ed7c1a00ca0...faf906c3f7e8b245fff17dc643c27c184938dce8,2,12,6,18,8,2013-03-20 20:22:59,2013-03-02 03:35:33
faf906c3f7e8b245fff17dc643c27c184938dce8...2333be9d4ca01260f14fb9e6cf0d96198f36a9c8,1,4,1,5,1,2013-03-20 20:22:59,2013-03-03 03:26:48
2333be9d4ca01260f14fb9e6cf0d96198f36a9c8...3268dd261e323624dd0c3b11ca95769e29f6352d,1,2,2,4,2,2013-03-20 20:22:59,2013-03-03 03:49:18
3268dd261e323624dd0c3b11ca95769e29f6352d...dd3face09495ec7ac5be077834b391b850597d19,1,2,0,2,1,2013-03-20 20:22:59,2013-03-05 22:31:46
dd3face09495ec7ac5be077834b391b850597d19...a738b6b775ecf6687f75900850130499dd35b79a,1,1,1,2,1,2013-03-20 20:23:00,2013-03-06 22:00:02
a738b6b775ecf6687f75900850130499dd35b79a...e19b121c3da5a8479e8cfdb512e5c8085d893839,2,2,0,2,2,2013-03-20 20:23:00,2013-03-19 01:37:30
e19b121c3da5a8479e8cfdb512e5c8085d893839...79132b44497e4d31f097c32ffb27efa97875beb0,1,0,1,1,1,2013-03-20 20:23:00,2013-03-19 02:10:54
79132b44497e4d31f097c32ffb27efa97875beb0...bee0aaf173e1c80f36847e32b0c57cbc7578b822,1,1,1,2,1,2013-03-20 20:23:00,2013-03-20 19:29:06
bee0aaf173e1c80f36847e32b0c57cbc7578b822...93b81a8ebdd447752eccdbce2847be31919ed7d0,3,85,82,167,16,2013-03-21 00:24:50,2013-03-21 00:24:50
93b81a8ebdd447752eccdbce2847be31919ed7d0...c33a4420f026eefbb910bffa83ba16549233cd38,5,0,0,0,0,2013-03-21 00:25:46,2013-03-21 00:25:46
c33a4420f026eefbb910bffa83ba16549233cd38...c5203777422229f931d6883da501bc139bcb2215,1,2,2,4,2,2013-03-21 00:27:23,2013-03-21 00:27:23
a08e28b6bd26b1476d24a81540c5c8f95ce40a00...fa4c81071d8aa2225e8edb6a7531cabe84f52b74,4,33,21,54,8,2013-03-03 02:48:08,2013-03-02 11:27:10
fa4c81071d8aa2225e8edb6a7531cabe84f52b74...898f552f293a71872f1a461d80f092caca719a66,2,2,2,4,2,2013-03-03 02:48:08,2013-03-02 19:55:45
898f552f293a71872f1a461d80f092caca719a66...fde627cc3418138e5fbc0aff23ceef37a7b330c0,2,2,2,4,2,2013-03-03 02:49:57,2013-03-03 02:49:57
fde627cc3418138e5fbc0aff23ceef37a7b330c0...b520c171424e90caba8fb8a4e885c3e3508a8637,1,3,0,3,1,2013-03-03 05:10:01,2013-03-03 05:10:01
c65dcb629edd3608549ac885af05497460524c60...b9c3e1fa30753b86c13fdc2601fc6253129c970c,5,11,11,22,11,2013-03-08 20:50:46,2013-03-08 20:50:46
b9c3e1fa30753b86c13fdc2601fc6253129c970c...980b1795586178d9e9c84c4f5c27be9d784cb8af,1,0,2,2,1,2013-03-08 20:52:20,2013-03-08 20:52:20
980b1795586178d9e9c84c4f5c27be9d784cb8af...934322f2d46c956605fed81cb54c8486ded9078f,2,6,7,13,4,2013-03-08 21:38:55,2013-03-08 21:38:55
934322f2d46c956605fed81cb54c8486ded9078f...8f3b0a279fb5557bc760c8a4f9bb6c7272f33d04,3,31,19,50,17,2013-03-11 19:06:50,2013-03-11 19:06:50
8f3b0a279fb5557bc760c8a4f9bb6c7272f33d04...a18a92e65f0dad78c9423b3449083ee09dadabd1,19,77,77,154,73,2013-03-11 19:17:39,2013-03-11 19:17:39
a3287a6f4098e4b38e5d7a583c7954200da428fe...575320b9291fc7624243a4ac9241702ec058574e,4,30,4,34,5,2013-03-12 21:12:56,2013-03-12 20:36:45
575320b9291fc7624243a4ac9241702ec058574e...1a68026aa38015c3162caee4589ec094309989e1,6,557,555,1112,137,2013-03-13 11:44:47,2013-03-13 08:17:41
1a68026aa38015c3162caee4589ec094309989e1...a158e3f901e56bd1de1af5036e9f4b49399bd170,2,116,72,188,34,2013-03-13 12:52:58,2013-03-13 12:50:39
a158e3f901e56bd1de1af5036e9f4b49399bd170...854bca2faef689853201725fc3725d5336b0a71d,1,0,9,9,1,2013-03-13 13:03:59,2013-03-13 13:03:59
a3287a6f4098e4b38e5d7a583c7954200da428fe...c699f9fef43836eac6bf53c9f8055824196edc1a,8,10,10,20,8,2013-03-12 17:46:19,2013-03-12 17:46:19
c699f9fef43836eac6bf53c9f8055824196edc1a...5f21cffde4927a429b95f465a28b10bb3b6d4704,1,2,0,2,1,2013-03-12 17:54:26,2013-03-12 17:54:26
5f21cffde4927a429b95f465a28b10bb3b6d4704...67d8f829a2499aa33c00347a2c1734a860413b03,4,30,4,34,5,2013-03-12 20:36:45,2013-03-12 20:36:45
67d8f829a2499aa33c00347a2c1734a860413b03...e03d35460d752b30f668f5f0e6ffa71cb677ee2f,2,23,14,37,9,2013-03-13 01:04:41,2013-03-13 01:04:41
e03d35460d752b30f668f5f0e6ffa71cb677ee2f...9d03ddaf8677513a37cce723c988f1088547d986,1,0,1,1,1,2013-03-13 01:07:36,2013-03-13 01:07:36
9d03ddaf8677513a37cce723c988f1088547d986...322699e420a47588f743bfa59f5a4bc66f0b0015,1,20,0,20,1,2013-03-13 01:18:33,2013-03-13 01:18:33
322699e420a47588f743bfa59f5a4bc66f0b0015...070d6f7ca9dca1f303d9a51cdb44c84c20705a63,6,557,555,1112,137,2013-03-13 11:52:59,2013-03-13 08:17:41
070d6f7ca9dca1f303d9a51cdb44c84c20705a63...db66fdeb28748232fe20f600726289547c1741a1,1,4,1,5,1,2013-03-13 12:03:04,2013-03-13 12:03:04
db66fdeb28748232fe20f600726289547c1741a1...9e73d68566aadaa49a77fa6e8436d8508dd3ec69,1,11,0,11,1,2013-03-13 12:43:05,2013-03-13 12:43:05
6c849f72a2b0bc31004bab44f9d476bdc80711a4...031d4dc103d655ca94a1540a1d8a8512f4523ae6,3,63,21,84,9,2013-02-01 23:24:45,2013-02-01 23:21:25
031d4dc103d655ca94a1540a1d8a8512f4523ae6...d76562f0fbb5838cc652e29acd2d16936decbe73,1,1,2,3,2,2013-02-01 23:24:45,2013-02-01 23:24:30
c10dd19b9f462c45906e56a0bdced1cbefd7f16e...bd94569d863bf2832807187ea8fa0d45ae289e95,1,10,6,16,2,2012-12-17 22:53:40,2012-11-01 10:20:56
bd94569d863bf2832807187ea8fa0d45ae289e95...7b8682b3fbda4a780d8309a10aeeeb34d4140b9b,1,34,0,34,1,2012-12-17 22:53:40,2012-12-12 19:59:21
7b8682b3fbda4a780d8309a10aeeeb34d4140b9b...4c78d3dc5116d4fbf1f146019ef425e6f2f1a50a,1,16,12,28,2,2012-12-17 22:53:40,2012-12-12 20:00:38
4c78d3dc5116d4fbf1f146019ef425e6f2f1a50a...48423c21d0481709e45d9f80f0a03b38c84ae070,2,5,5,10,5,2012-12-17 22:53:40,2012-12-15 04:05:22
d17795971cf2d55532bf7b9d00d0c925dec22014...6b9bfe8b5ace6418b557775d274ce88485b670af,2,2,2,4,2,2013-08-27 02:34:19,2013-08-15 19:20:29
6b9bfe8b5ace6418b557775d274ce88485b670af...5784c811aee9e8da0133113073879fe37eb5c79d,1,1,1,2,1,2013-08-27 02:34:24,2013-08-20 18:14:44
5784c811aee9e8da0133113073879fe37eb5c79d...a79db877a4badec4777a74efdb729fb94fdac84a,1,3,1,4,1,2013-08-27 02:34:32,2013-08-19 23:25:46
a79db877a4badec4777a74efdb729fb94fdac84a...70a691661d59bd6b781fc0f6a4d86f573d46d5d3,1,6,2,8,3,2013-08-27 02:34:39,2013-08-20 18:37:11
70a691661d59bd6b781fc0f6a4d86f573d46d5d3...9847720a3b79c2d25573347d982c34c13779f26d,8,31,16,47,10,2013-08-27 02:35:41,2013-08-20 04:47:34
9847720a3b79c2d25573347d982c34c13779f26d...99d29cc9d2386cb63e13ba25720c2b9870710197,2,6,0,6,2,2013-08-27 02:51:38,2013-08-20 05:15:52
99d29cc9d2386cb63e13ba25720c2b9870710197...2c68882fffc47e92aa237ec96f9620cf469e5b16,1,1,1,2,1,2013-08-27 02:51:38,2013-08-20 18:08:50
2c68882fffc47e92aa237ec96f9620cf469e5b16...61d9510ef173e902c4b1ac4d2233efc7da95c753,2,9,1,10,2,2013-08-27 02:51:39,2013-08-20 02:51:01
61d9510ef173e902c4b1ac4d2233efc7da95c753...7f73833991c6e3c37a72787200beb0395a604d94,1,1,1,2,1,2013-08-27 02:51:39,2013-08-27 02:28:25
7f73833991c6e3c37a72787200beb0395a604d94...bab5c1685da9de7bc7573b4806fde1828ea65c07,1,1,1,2,1,2013-08-27 02:51:39,2013-08-20 17:52:45
bab5c1685da9de7bc7573b4806fde1828ea65c07...0e70184fd071271d590b150c41d14f3c99db4c7d,1,1,1,2,1,2013-08-27 02:51:39,2013-08-14 20:57:02
0e70184fd071271d590b150c41d14f3c99db4c7d...f6b0bab5179623334306375caf1139b25fb202d8,2,56,8,64,3,2013-08-27 02:51:39,2013-08-14 20:38:43
f6b0bab5179623334306375caf1139b25fb202d8...6a4216f16fe2c469e63fe5876e2f733ef771389a,1,1,1,2,1,2013-08-27 02:51:39,2013-08-14 23:52:39
8160ce549b3e1aa17f9162b203ef5aabfb84f88b...9948ba715d4d5dc3a6f69b3de6df3f6e84297e07,1,2,10,12,1,2013-08-21 21:21:29,2013-08-21 21:21:29
9948ba715d4d5dc3a6f69b3de6df3f6e84297e07...14da1c3ad298d869f8ac86e963ec617cf53bbacd,1,1,1,2,1,2013-08-21 21:28:33,2013-08-21 21:28:33
14da1c3ad298d869f8ac86e963ec617cf53bbacd...aa291537a4af652a13a784d0b0ed9de42aac3ffd,1,3,3,6,3,2013-08-21 21:28:50,2013-08-21 21:28:50
bd7e0d768c791d693d88022b65cb23ec52f05932...d5a1295977da80368fdf205f299878f29ab5de00,1,5,1,6,1,2013-07-19 23:49:40,2013-07-19 23:49:40
d5a1295977da80368fdf205f299878f29ab5de00...96d5ce2fa4424df18524c3d1e799772fc114c63d,1,2,0,2,1,2013-07-22 18:58:33,2013-07-22 18:58:33
96d5ce2fa4424df18524c3d1e799772fc114c63d...2e79a3145e1e6f260f21f61fb29e147b40da2f1f,1,12,0,12,4,2013-07-22 22:08:08,2013-07-22 22:08:08
2e79a3145e1e6f260f21f61fb29e147b40da2f1f...a27e6239b965e49fdd26fae787a099e3373d90ef,1,1,0,1,1,2013-07-22 22:14:11,2013-07-22 22:14:11
a27e6239b965e49fdd26fae787a099e3373d90ef...732847436b84cd37205404fd090b01dfc6d59264,1,5,0,5,1,2013-07-22 22:32:02,2013-07-22 22:31:49
732847436b84cd37205404fd090b01dfc6d59264...d5ed4fd87854a70c6738bac5094856657d427902,1,15,9,24,2,2013-07-22 23:58:44,2013-07-22 23:58:44
d5ed4fd87854a70c6738bac5094856657d427902...2d8b96c946d77a71d6a48a3fce3f16f099a9d8c7,1,7,1,8,3,2013-07-23 01:14:52,2013-07-23 01:14:31
2d8b96c946d77a71d6a48a3fce3f16f099a9d8c7...2d2da146d91762e4f5080fe7dd88b8a796233f20,1,2,2,4,1,2013-07-23 01:24:31,2013-07-23 01:24:31
2d2da146d91762e4f5080fe7dd88b8a796233f20...902d3b5f1c37ee8402bea0e37fc860e5699cad81,1,2,1,3,1,2013-07-23 05:46:34,2013-07-23 04:17:34
902d3b5f1c37ee8402bea0e37fc860e5699cad81...f46d94cffda2bf2d7a8f4a01c3b3e6beefd6b9b7,2,15,3,18,5,2013-07-23 18:43:03,2013-07-23 18:43:03
f46d94cffda2bf2d7a8f4a01c3b3e6beefd6b9b7...095e81a0b6202c0a80b9ab90898d3595c0d06e55,1,7,5,12,2,2013-07-23 19:35:57,2013-07-23 19:35:57
095e81a0b6202c0a80b9ab90898d3595c0d06e55...d65cf0307bce767f2d16e5d52611c6b3087be53d,1,0,2,2,2,2013-07-24 00:58:44,2013-07-24 00:58:44
0ecf4650d004e67ea97efceb5b754382798e281a...f060d1808ad0e468e49d5a93b6de94c16623d2c8,1,70,2,72,3,2013-06-17 22:41:05,2013-06-15 02:13:59
f060d1808ad0e468e49d5a93b6de94c16623d2c8...2e9aecdf841de3ec92c5b9a8dac3b1188f7e71bd,1,16,12,28,9,2013-06-18 01:02:38,2013-06-18 01:02:38
2e9aecdf841de3ec92c5b9a8dac3b1188f7e71bd...0bf4594a207e3cf64c0be146f2562639273876e9,3,15,8,23,3,2013-06-18 01:12:32,2013-06-18 01:12:32
99ce3fa4f32221c02c6cb772694cdd8d5b78b198...226c19ba6a77ab81d39cf081a07fc9fe8f062289,1,1,1,2,1,2013-06-10 19:23:36,2013-06-10 19:23:36
9557a8b0ab6feaef6e80992b012a234b96829ccd...46b75bcd180c97f1ccf12f92b8d2d30cafb1c38e,2,4,2,6,2,2013-05-23 04:30:02,2013-05-11 10:36:30
aa83b9d800fc72ddec47b4470845dfbd91df8164...8e0cf9cfa86b16f2d57d5ec7d9fa367a17c299d4,2,92,9,101,3,2013-05-07 03:31:20,2013-04-20 16:39:45
8e0cf9cfa86b16f2d57d5ec7d9fa367a17c299d4...2e9ad511d897939c70e33deea42ec6161815d064,2,56,62,118,13,2013-05-07 03:46:07,2013-05-07 03:46:07
2e9ad511d897939c70e33deea42ec6161815d064...48774f7aac0d54f03caee0984e3c1564d117aa61,2,13,23,36,6,2013-05-07 04:00:21,2013-05-07 04:00:21
48774f7aac0d54f03caee0984e3c1564d117aa61...69644fdf01a5e0c5fe7ece321fa1e088628ea0df,1,3,1,4,2,2013-05-07 04:01:23,2013-05-07 04:01:23
b9693f4e1e11f8536a36a4c09e00a4049a79041d...a15d1ecdee1fd951fdee3d628fd1322938d69b4b,8,95,89,184,11,2013-04-25 23:43:39,2013-04-23 18:27:44
a15d1ecdee1fd951fdee3d628fd1322938d69b4b...209dbf2fc7e3c1b3d9c5910f3340d605d8f22f04,1,1,0,1,1,2013-04-25 23:48:26,2013-04-25 23:48:26
209dbf2fc7e3c1b3d9c5910f3340d605d8f22f04...8781477e645a9f96b000d7b639f92afc0a811a23,3,14,2,16,3,2013-04-25 23:48:34,2013-04-25 23:48:34
fe57ab10c78e00923ab2ad055b7568eb819ea3eb...fc81e29f3e4384396dae0e309448a122b35802ff,1,7,3,10,1,2013-04-23 20:25:24,2013-04-23 20:25:24
fe57ab10c78e00923ab2ad055b7568eb819ea3eb...b4ec1ef0635783db212c6e93c2d250f69395e318,1,1,1039,1040,1,2013-04-22 23:16:23,2013-04-22 23:16:23
308395da460c6a94e88df1dd901b622f520eed86...0ba549d403376edf49329e7d877d8895f01c796e,1,1,1,2,1,2013-04-10 00:15:35,2013-04-09 23:40:07
0ba549d403376edf49329e7d877d8895f01c796e...04a5678c20c2937f1a46e3c5e1fca046406f61a4,1,2,2,4,2,2013-04-10 02:27:24,2013-04-10 02:26:21
04a5678c20c2937f1a46e3c5e1fca046406f61a4...1fc7d7f94dd68323f6c40e11adeeebdb3caec9f9,2,17,5,22,3,2013-04-10 17:29:09,2013-04-10 00:01:49
1fc7d7f94dd68323f6c40e11adeeebdb3caec9f9...47e4005cc02007b37c03c840906694822db4eedb,1,8,0,8,1,2013-04-10 17:29:09,2013-04-10 00:09:33
47e4005cc02007b37c03c840906694822db4eedb...8350f52b9d25ddfa6489faddc02433031c2682ea,1,26,1,27,3,2013-04-11 04:20:31,2013-04-11 04:13:55
8350f52b9d25ddfa6489faddc02433031c2682ea...9b2b6f219dd87a6eb066c349d603fbeb4446a6fc,2,14,8,22,4,2013-04-11 22:56:06,2013-04-11 22:56:06
9b2b6f219dd87a6eb066c349d603fbeb4446a6fc...654923abaec1d5f2471123c021f320ee4b436bab,3,42,20,62,11,2013-04-11 23:03:23,2013-04-11 23:02:41
654923abaec1d5f2471123c021f320ee4b436bab...d1dd8a8e4ded2806c868a63aeee5cff81cf1579d,3,68,51,119,4,2013-04-12 00:11:45,2013-04-12 00:11:45
308395da460c6a94e88df1dd901b622f520eed86...2f7b913254e63004b67c59f56a2e8348271a2a73,2,17,5,22,3,2013-04-10 00:01:49,2013-04-10 00:01:49
2f7b913254e63004b67c59f56a2e8348271a2a73...78749138e28a2358c24a943a3e1d5cc4e4f8ad88,1,8,0,8,1,2013-04-10 00:09:33,2013-04-10 00:09:33
eeab9aa6f655a350217a37e4973cf72fc64f9bab...4ff1764380d520b234424d9bcda6a389e5d3840a,2,22,3,25,2,2013-03-21 00:29:06,2013-03-21 00:29:06
bfcee2bb4ec19baf61fb552a338d3db8ac5cd291...8c6960b8dbfa4918d4582b89d15ba29a0be9975f,1,2,2,4,2,2013-03-04 01:32:11,2013-03-04 01:32:11
463c6c1b0b96e073c1229b0ccbe90d3f3c37fa49...96d05d741f65f7a1321b3c0f40457f638d4cc4b7,12,74,74,148,50,2013-03-11 19:37:25,2013-03-11 19:37:25
96d05d741f65f7a1321b3c0f40457f638d4cc4b7...0f598403b56ad77aec8831f8f3a0fcb81566d937,1,3,1,4,1,2013-03-11 20:05:34,2013-03-11 20:05:25
854bca2faef689853201725fc3725d5336b0a71d...017ee5eac51ba90ecb318a72097921068b0166a6,2,12,11,23,6,2013-03-13 13:08:52,2013-03-13 13:08:00
d76562f0fbb5838cc652e29acd2d16936decbe73...8faeb1e303a4e6a912eed2571d7239b293e79a43,1,2,2,4,1,2013-02-02 07:53:32,2013-01-29 03:00:09
c47666811002d50cf083fe4a63388eae95359263...dd459e10a3047e2bb3e232ec46ae3f42c687ce56,1,1,3,4,2,2013-02-05 02:18:40,2013-02-05 02:18:40
dd459e10a3047e2bb3e232ec46ae3f42c687ce56...8b737a7e39bebe19fc57eb2ca1eca64c95fbab64,4,64,87,151,23,2013-02-05 22:26:32,2013-02-05 22:26:23
8b737a7e39bebe19fc57eb2ca1eca64c95fbab64...656e74d657808ed592565287073d9ce20260a495,1,6,4,10,1,2013-02-05 23:52:02,2013-02-05 23:52:02
656e74d657808ed592565287073d9ce20260a495...2c9017f162eb913b9de0972e534e511beb22787b,3,27,28,55,15,2013-02-06 00:09:38,2013-02-06 00:08:54
2c9017f162eb913b9de0972e534e511beb22787b...d3d267d95b9f7b662c463ee43a54490ac76c01a8,1,0,13,13,1,2013-02-06 00:15:51,2013-02-06 00:15:51
eaff6f3b004fa6cc02e8379f41f95db81c0822fc...4c2bc76c7ecaef8ba1b30d137bf1aaa94a3395cf,2,0,7,7,2,2013-02-05 01:47:06,2013-02-05 01:47:06
4c2bc76c7ecaef8ba1b30d137bf1aaa94a3395cf...55a90e1a70a884d4db2246a0d976ddcac1c14b09,1,5,2,7,1,2013-02-05 02:13:50,2013-02-05 02:13:50
6deacbcfc16fa07e51f5be8632ed667b63f235bb...fcfc7dd4c1ef807d947674b8d5aa7ddcaba4e322,1,7,0,7,1,2012-12-18 03:56:54,2012-12-18 03:56:54
fcfc7dd4c1ef807d947674b8d5aa7ddcaba4e322...7f55a7e928095ee60b022b67ed72ab0a3cecf1e0,2,2,2,4,2,2012-12-18 03:57:26,2012-12-18 03:57:26
6a4216f16fe2c469e63fe5876e2f733ef771389a...d1bbfd41494399d9ed2551e6f383a25a581adceb,2,4,2,6,2,2014-10-28 20:11:13,2014-10-28 20:11:13
6a4216f16fe2c469e63fe5876e2f733ef771389a...fab6f3fe5d14d492b1a199bc401cdab1e596a10a,1,19,0,19,1,2013-08-27 03:30:41,2013-08-27 03:30:41
fab6f3fe5d14d492b1a199bc401cdab1e596a10a...61f84eb7e7296795bceb404efd5e2f3ddd174e0e,2,6,2,8,3,2013-08-28 03:17:59,2013-08-28 03:17:59
61f84eb7e7296795bceb404efd5e2f3ddd174e0e...cdb6f90b6617df84cb1cef58f5b911fcb1ee58f7,2,5,2,7,2,2013-08-28 03:28:09,2013-08-15 00:03:45
cdb6f90b6617df84cb1cef58f5b911fcb1ee58f7...5d4849d3615dd54bea836b60ca792f8b5dbe21d7,1,1,1,2,1,2013-08-28 03:28:56,2013-08-28 03:28:56
5d4849d3615dd54bea836b60ca792f8b5dbe21d7...16b8f0b0b6ff49533597d0ec63063d37808c02bd,4,4,4,8,4,2013-08-28 21:13:09,2013-08-28 21:13:09
a1a984709939b1e3232da2b30b73c652c8ffe974...f350edeb7df6d1c045a17fe781f11f84f573dc05,2,56,8,64,3,2013-08-14 20:38:43,2013-08-14 20:38:43
f350edeb7df6d1c045a17fe781f11f84f573dc05...f3b2063eb7869abd37ac6dbb5021caf9ea694a10,1,1,1,2,1,2013-08-14 20:57:02,2013-08-14 20:57:02
d8364af7654bf24052c9a1a3edfa7c482c8c0122...c4f52b7551d999796e3ccf6ddf22c467e700b89b,1,2,3,5,2,2013-08-21 22:19:05,2013-08-21 22:19:05
d65cf0307bce767f2d16e5d52611c6b3087be53d...9251942b9a2e05421c8810da8f688502c12ffb6b,1,2,2,4,2,2013-07-24 05:28:28,2013-06-25 06:04:30
9251942b9a2e05421c8810da8f688502c12ffb6b...65c288bdb830537d99940e9c941866c6bb7df8a4,6,36,0,36,6,2013-07-24 05:28:28,2013-06-25 06:05:24
0bf4594a207e3cf64c0be146f2562639273876e9...5953c3796d1b37e68d04f1dbc9c965f0797c80d9,2,64,55,119,38,2013-06-18 05:58:36,2013-06-18 05:07:34
5953c3796d1b37e68d04f1dbc9c965f0797c80d9...64ab1aadbce5172779d9b06771201ab1cdc7624e,1,3,1,4,4,2013-06-18 05:58:37,2013-06-18 05:29:23
64ab1aadbce5172779d9b06771201ab1cdc7624e...11a7d8d07abbaf6388342d2756d751def6ba049e,1,248,187,435,16,2013-06-18 05:58:37,2013-06-18 05:57:58
11a7d8d07abbaf6388342d2756d751def6ba049e...5b1cf081585f267eb859236c415074e661a4867e,1,4,0,4,1,2013-06-19 03:09:00,2013-06-19 03:09:00
5b1cf081585f267eb859236c415074e661a4867e...3e1820d288b38535003017de551bcf086b0c89ac,2,45,35,80,10,2013-06-19 03:33:55,2013-06-19 03:33:55
e07445cd7503ef683a74b15264adc4e61700bb61...b9e96ab2b7560b32c6df9b692ce85a24334dd524,2,7,6,13,3,2013-06-11 03:55:37,2013-06-11 03:55:37
b9e96ab2b7560b32c6df9b692ce85a24334dd524...a578cb0c7575128e12cd6e9a36287cc673111d4f,1,27,4,31,1,2013-06-11 05:17:37,2013-06-11 05:17:37
a578cb0c7575128e12cd6e9a36287cc673111d4f...e838349cca618474fa5140ae4fc293e8a0897bec,1,1,1,2,1,2013-06-11 05:21:07,2013-06-11 05:21:07
e838349cca618474fa5140ae4fc293e8a0897bec...f87a0ce09efd1b5af79a8641ff506fe22929d0b2,1,1,1,2,1,2013-06-11 05:44:16,2013-06-11 05:44:16
f87a0ce09efd1b5af79a8641ff506fe22929d0b2...bcbd6e1b70026dd3b905e5cc6129fd4150e9ed5b,2,59,19,78,9,2013-06-13 01:08:34,2013-06-13 01:08:34
bcbd6e1b70026dd3b905e5cc6129fd4150e9ed5b...a41573f59f906035e7b195e614bbcfffeb7501aa,2,18,12,30,6,2013-06-13 02:01:12,2013-06-13 02:01:12
a41573f59f906035e7b195e614bbcfffeb7501aa...5ba4f9f194325175545f73da5eecff2fab1d44aa,1,4,2,6,3,2013-06-13 02:16:50,2013-06-13 02:16:50
5ba4f9f194325175545f73da5eecff2fab1d44aa...c5740b6c6903799314e02b5faff641aef6c3cb9b,1,1,1,2,1,2013-06-13 18:17:26,2013-06-13 18:14:38
c5740b6c6903799314e02b5faff641aef6c3cb9b...fc74cfba155ba5b72a553f5db4ee88e5d54f5c72,1,0,153,153,1,2013-06-13 18:17:26,2013-06-13 18:15:59
fc74cfba155ba5b72a553f5db4ee88e5d54f5c72...213cd94129a40408e89446a4f600a9b1b738c44c,5,42,19,61,12,2013-06-13 23:22:32,2013-06-06 01:03:59
213cd94129a40408e89446a4f600a9b1b738c44c...bd53fbe089c8d98f3d73d83c367c067348292683,8,163,30,193,25,2013-06-13 23:22:32,2013-06-06 23:57:09
bd53fbe089c8d98f3d73d83c367c067348292683...66695a75d06468d99c36b245fa7c7f46c545660f,8,30,14,44,16,2013-06-13 23:22:32,2013-06-10 21:28:48
66695a75d06468d99c36b245fa7c7f46c545660f...69d51abd4c1f31e00f4ef1fd5a665b34a6c34a49,1,1,1,2,1,2013-06-13 23:22:32,2013-06-11 19:21:22
69d51abd4c1f31e00f4ef1fd5a665b34a6c34a49...2e608e3abf106cb204606060d93d729e23a3ef82,11,96,73,169,49,2013-06-13 23:23:24,2013-06-13 23:17:51
2e608e3abf106cb204606060d93d729e23a3ef82...aa4fe7ec175d5ab7931a65a32ce1777e93910551,1,1,11,12,3,2013-06-13 23:24:08,2013-06-13 23:24:08
aa4fe7ec175d5ab7931a65a32ce1777e93910551...719e4c47009332e9a9ba900b718dd0eb4a84aee9,1,1,1,2,1,2013-06-14 00:44:15,2013-06-14 00:44:15
719e4c47009332e9a9ba900b718dd0eb4a84aee9...1957c4e1d3352fe2618b65ee04010a838bae9e8c,2,1,1,2,1,2013-06-14 01:05:05,2013-06-14 00:47:55
1957c4e1d3352fe2618b65ee04010a838bae9e8c...6eeec293981ac889432c9f2598308f01952fe289,2,9,10,19,5,2013-06-14 01:05:05,2013-06-14 01:04:11
6eeec293981ac889432c9f2598308f01952fe289...0ccba277cf9aa0903b4cfdf34e4023217ffa4df3,1,1,1,2,1,2013-06-14 01:28:04,2013-06-14 01:28:04
0ccba277cf9aa0903b4cfdf34e4023217ffa4df3...b50a1bf12fb463499937a31d3586b2716e6b3d95,17,346,105,451,50,2013-06-14 05:53:25,2013-05-16 00:09:36
b50a1bf12fb463499937a31d3586b2716e6b3d95...1f3a69d7eba9bb3b55959b817e62a6572ad781fd,3,13,4,17,6,2013-06-14 15:40:26,2013-06-14 15:40:26
1f3a69d7eba9bb3b55959b817e62a6572ad781fd...3fa0b533cc505d528d9cba9b7fff8ec08a512914,2,173537,173539,347076,4,2013-06-14 18:09:57,2013-06-14 18:09:57
3fa0b533cc505d528d9cba9b7fff8ec08a512914...42e015d2c07d2b9085bafd51f691bacaa108a578,1,0,1,1,1,2013-06-14 18:12:30,2013-06-14 18:11:47
42e015d2c07d2b9085bafd51f691bacaa108a578...ea82e7c4b4afdf65650423454c36f6c4b49e3dc0,27,36,21,57,19,2013-06-14 18:12:31,2013-06-11 04:29:00
ea82e7c4b4afdf65650423454c36f6c4b49e3dc0...6108cc298c56eb01aa1b72da92847564eaf79710,1,7,1,8,2,2013-06-14 19:25:45,2013-06-14 19:25:45
6108cc298c56eb01aa1b72da92847564eaf79710...8f193b2cc0b6f9fa2807b9a813899833614ff548,1,6,3,9,3,2013-06-14 20:29:55,2013-06-14 20:29:55
8f193b2cc0b6f9fa2807b9a813899833614ff548...9bafe2f8813e86c4ac6e6e8ac3f08c5cbdc9e6e1,3,33,28,61,4,2013-06-14 21:04:55,2013-06-14 21:04:55
691158c6bcd852d082f38d2438b6d3dd2827d43c...1ad813951bbaee348022dba1e59093cd6028203b,3,71,33,104,6,2013-05-23 04:34:39,2013-05-11 12:37:48
1ad813951bbaee348022dba1e59093cd6028203b...1a77d78f0521e55f448c11b0f73ff95b881e5e53,1,5,1,6,1,2013-05-23 04:42:02,2013-05-23 04:42:02
28fbbc8c3df2fed7418316a80e6dc8b1e294b5e3...99d5be0079ca74062f878b330e4099496844de64,7,61,55,116,24,2013-05-09 18:17:36,2013-05-09 18:17:36
99d5be0079ca74062f878b330e4099496844de64...5b2240df4f951f95b3433572fd5d40c376deb038,1,23,5,28,2,2013-05-09 18:50:56,2013-05-09 18:36:14
5b2240df4f951f95b3433572fd5d40c376deb038...0893b8258c0b7525e649a1ecf2ec83b2282775e1,2,46,3,49,4,2013-05-09 18:59:02,2013-05-07 00:05:53
0893b8258c0b7525e649a1ecf2ec83b2282775e1...7f970513e559cad08db0c4fc6d3e6c9d23e22d29,2,14,2,16,3,2013-05-10 01:24:23,2013-05-09 19:09:56
7f970513e559cad08db0c4fc6d3e6c9d23e22d29...d985ca6919e6c1df9f3226ba687a2039e2aa25fe,1,6,1,7,2,2013-05-10 01:42:24,2013-05-10 01:42:24
d985ca6919e6c1df9f3226ba687a2039e2aa25fe...cb3bcc6b61f0e22b5fabc5f7a3617b46c864f112,2,23,3,26,4,2013-05-10 02:01:43,2013-05-10 02:01:43
cb3bcc6b61f0e22b5fabc5f7a3617b46c864f112...318886171797b06833e0b5781211cad71eb8f6d7,1,1,20,21,3,2013-05-10 05:13:54,2013-05-10 05:13:54
318886171797b06833e0b5781211cad71eb8f6d7...4284a5ed1de19d1f4fee2df6acb8ed53ba31f4fb,1,8,6,14,2,2013-05-10 22:00:29,2013-05-10 22:00:29
4284a5ed1de19d1f4fee2df6acb8ed53ba31f4fb...8c99176477269acd9375b92aa68e2dc3f9aed02a,1,28,17,45,6,2013-05-11 02:17:43,2013-05-11 02:17:43
8c99176477269acd9375b92aa68e2dc3f9aed02a...e0573b61b5cb3b72e7cfa6cfe7c222815c437643,1,3,2,5,1,2013-05-11 04:04:50,2013-05-11 04:04:50
e0573b61b5cb3b72e7cfa6cfe7c222815c437643...9b74af5b2a77f1cda68d5ad70e68d300d21fab02,1,2,1,3,1,2013-05-11 04:37:17,2013-05-11 04:37:17
1529bfa36ceae3bec68a941ac2f0e9b98fd064a4...f4808b5a688cb6cebd4e1ccefab7768b6d81d38c,1,17,2,19,2,2013-04-25 23:50:33,2013-04-16 21:25:40
f4808b5a688cb6cebd4e1ccefab7768b6d81d38c...3e7d38ee9ad0b0d127614c330d6b226616196e37,1,1,1,2,1,2013-04-25 23:50:33,2013-04-17 12:50:44
3e7d38ee9ad0b0d127614c330d6b226616196e37...734a82fa5842674d0d112322c006e688cdcb8ff7,1,3,1,4,1,2013-04-25 23:51:20,2013-04-25 23:51:20
d1dd8a8e4ded2806c868a63aeee5cff81cf1579d...d098b99bd8502ce4dbac8327f3cabcd60acb9fa8,1,16,7,23,2,2013-04-12 17:56:52,2013-04-12 17:56:52
d098b99bd8502ce4dbac8327f3cabcd60acb9fa8...c059c384fdf9e7169f25cc36d86fbc0ed0a9da83,1,3,3,6,1,2013-04-12 18:28:30,2013-04-12 18:27:57
c059c384fdf9e7169f25cc36d86fbc0ed0a9da83...266431293b1db743c1c5d687714aa78f152056ea,1,5,0,5,1,2013-04-12 19:25:08,2013-04-12 19:25:08
266431293b1db743c1c5d687714aa78f152056ea...168433beacec7b7b575b3708f57fa67a8ab19135,1,1,1,2,1,2013-04-12 20:21:31,2013-04-12 20:21:12
168433beacec7b7b575b3708f57fa67a8ab19135...7a05b7f1a418b74bd55f20086bff2dc3d93a34da,1,0,1,1,1,2013-04-12 20:58:01,2013-04-12 20:58:01
7a05b7f1a418b74bd55f20086bff2dc3d93a34da...06252771137598e916faa4a733060d0539dd0276,3,10,0,10,3,2013-04-13 02:48:39,2013-04-13 02:48:39
06252771137598e916faa4a733060d0539dd0276...93497be27f3e7fee0bdde39daa8c907bee214f0b,1,19,8,27,7,2013-04-13 03:42:17,2013-04-13 03:42:17
a1e73444f1e57d2e4fff15d9f1151278ceeee34a...9fbe8e1599dd89ea7ce46f80a18eb58a5390a8b0,4,14,13,27,15,2013-03-21 00:56:04,2013-03-21 00:56:04
9fbe8e1599dd89ea7ce46f80a18eb58a5390a8b0...ac378fcefcf4c0fb50b83bc88117f849d55725c3,1,1,3,4,1,2013-03-21 01:03:07,2013-03-21 01:03:07
ac378fcefcf4c0fb50b83bc88117f849d55725c3...5e1794b8a1990f571960fbb14316df0f884052bc,1,2,2,4,2,2013-03-21 02:58:31,2013-03-21 02:58:31
5e1794b8a1990f571960fbb14316df0f884052bc...4d5fa270eea1104abd14b26c1ab22e9846630f19,1,14,5,19,3,2013-03-21 06:39:15,2013-03-21 06:39:15
4d5fa270eea1104abd14b26c1ab22e9846630f19...d714d1f79211f984e10582eb7a5d8a544a37e694,2,67,29,96,18,2013-03-21 08:14:06,2013-03-21 07:27:06
d714d1f79211f984e10582eb7a5d8a544a37e694...aad4b377be77deaced20dde42b53bfc1401e1d85,1,7,3,10,1,2013-03-21 08:29:46,2013-03-21 08:29:46
8c6960b8dbfa4918d4582b89d15ba29a0be9975f...03025db527b6167b4e8e3179919efa221f7a6f19,1,4,9,13,3,2013-03-04 20:24:04,2013-02-26 22:55:04
03025db527b6167b4e8e3179919efa221f7a6f19...93af9a2a038c313b2ad00df2b203137a34239d19,1,2,0,2,1,2013-03-04 20:46:33,2013-03-04 20:46:33
9ffdc444878d26f733fd4d9a41523034632f66ba...a23d85c103d349f08157f2712e13c60580eb8fde,1,10,6,16,2,2013-03-13 14:14:55,2013-03-13 14:14:55
a23d85c103d349f08157f2712e13c60580eb8fde...8a88fee134ee077f3e41d76c04253b6b4cc7c42f,1,0,1,1,1,2013-03-13 19:01:39,2013-03-13 19:01:39
8a88fee134ee077f3e41d76c04253b6b4cc7c42f...a19c4df24d7d3453519f7452d3df9cd7ca6b6292,1,9,1,10,1,2013-03-13 19:12:38,2013-03-13 19:12:38
8faeb1e303a4e6a912eed2571d7239b293e79a43...6b8ca56a417761bca527dcdb189ba6f492598df6,1,1,1,2,1,2013-02-02 23:57:28,2013-02-02 23:57:28
d62c8b53a44aead99f2e4a5e843dd36607958911...0077bbbb65656efe9fc45e77a9d0b6800d8bc5f9,1,27,39,66,5,2013-02-06 00:27:59,2013-02-06 00:27:59
0077bbbb65656efe9fc45e77a9d0b6800d8bc5f9...25fa54cbaeffa1b00fadba4673325ca2c56aa611,6,10,4,14,6,2013-02-06 00:36:39,2013-02-06 00:34:42
25fa54cbaeffa1b00fadba4673325ca2c56aa611...b8c448665351c3d9a7d436432f2769349f5f5d7c,2,3,6,9,2,2013-02-06 00:36:40,2013-02-06 00:35:00
b8c448665351c3d9a7d436432f2769349f5f5d7c...19868587fcf9dedb4f70b0194209e05e7202866c,1,5,3,8,3,2013-02-06 00:42:18,2013-02-06 00:42:18
19868587fcf9dedb4f70b0194209e05e7202866c...18d4a6ea4b0f5a89a743cfe110014082e1428463,1,0,14,14,1,2013-02-06 00:57:26,2013-02-06 00:57:02
18d4a6ea4b0f5a89a743cfe110014082e1428463...38db5ddc1dda1b3269748620fac20890b3cd154d,3,50,51,101,38,2013-02-06 22:23:47,2013-02-06 22:23:47
38db5ddc1dda1b3269748620fac20890b3cd154d...2abce8caf854572c939297f133a3c2d066ccef7f,1,19,3,22,6,2013-02-06 22:39:40,2013-02-06 22:39:40
2abce8caf854572c939297f133a3c2d066ccef7f...747a6ce20c83defdba6975b768dae4c12209e81a,5,42,15,57,16,2013-02-07 00:17:53,2013-02-07 00:17:53
747a6ce20c83defdba6975b768dae4c12209e81a...c6f72b612fd0a9663944b853797afc44ae9e62d6,3,102,32,134,16,2013-02-07 02:37:33,2013-02-07 02:37:33
c6f72b612fd0a9663944b853797afc44ae9e62d6...515b04f13cc8b8d90030b5ccc045d735837bee6b,1,3,3,6,2,2013-02-07 02:39:57,2013-02-07 02:39:57
4c1c6c1ca52641cbcad97c4b94a4420e96e71a21...2d2aaa80823c14ec1e7d02bad4ef26cdd9d71809,2,18,5,23,8,2012-12-18 05:35:12,2012-12-18 05:03:56
2d2aaa80823c14ec1e7d02bad4ef26cdd9d71809...e9913d2055ec450236701ac48161c38d801412ae,2,45,43,88,16,2012-12-18 07:39:13,2012-12-18 07:39:06
e9913d2055ec450236701ac48161c38d801412ae...8ad174eeadb5c74a362e4092afb36dfb663e2f5d,1,18,4,22,5,2012-12-18 18:19:53,2012-12-18 18:19:53
8ad174eeadb5c74a362e4092afb36dfb663e2f5d...e0532012f6c4c6cc1b3dac8e667cb77fbf6e6ea0,3,26,30,56,14,2012-12-18 23:35:35,2012-12-18 22:47:27
e0532012f6c4c6cc1b3dac8e667cb77fbf6e6ea0...326b316d3657d9341a977152f01e02c1fcf795ba,2,49,0,49,2,2012-12-19 00:10:36,2012-12-19 00:00:07
326b316d3657d9341a977152f01e02c1fcf795ba...27382c62eecd72665194374bff28859f94e7ec98,1,604,600,1204,71,2012-12-19 00:49:51,2012-12-13 19:33:36
27382c62eecd72665194374bff28859f94e7ec98...a744cbd9e82486a184af895fde192a8de5b057b1,1,5,0,5,1,2012-12-19 22:19:14,2012-12-19 22:19:14
a744cbd9e82486a184af895fde192a8de5b057b1...821a2370821335ef6b772231e07c4131d3cd7b93,1,7,7,14,3,2012-12-20 01:23:56,2012-12-20 01:23:56
9c53643113a986144a215f0fcafe4f89651ef25e...e082d9745a1e6db128a905bfb5cca7167897c35d,1,1,1,2,1,2013-08-31 17:03:41,2013-08-31 17:03:41
16b8f0b0b6ff49533597d0ec63063d37808c02bd...dd39e1efaf66dd133fbf1c4ced3981cc05ff8817,7,10,6,16,7,2013-10-21 04:44:21,2013-10-21 04:44:21
f3b2063eb7869abd37ac6dbb5021caf9ea694a10...50e2f4c07c5ffc3981928a624d9f37a6ce1e0e1b,1,1,1,2,1,2013-08-14 23:52:39,2013-08-14 23:52:39
50e2f4c07c5ffc3981928a624d9f37a6ce1e0e1b...f598d40c8bc73f0d6b3080c9ff3907d100b3cea5,2,5,2,7,2,2013-08-15 00:03:45,2013-08-15 00:03:45
f3b2063eb7869abd37ac6dbb5021caf9ea694a10...b501ce6e4bd366965787ee24bf4ddc6548920a33,4,96,31,127,34,2013-08-14 23:33:03,2013-07-16 00:52:50
b501ce6e4bd366965787ee24bf4ddc6548920a33...3a5cf5f612f3a4e79f982995e538ff69fafefb6b,1,30,15,45,12,2013-08-14 23:33:03,2013-07-16 01:01:56
3a5cf5f612f3a4e79f982995e538ff69fafefb6b...90af1cb440060576009b072dc6815bf28ed75d5a,3,58,2,60,7,2013-08-14 23:33:04,2013-07-16 01:23:01
90af1cb440060576009b072dc6815bf28ed75d5a...e57fcd74518757eda16cdf9df22a253945139513,3,97,53,150,25,2013-08-14 23:33:04,2013-07-16 06:21:55
e57fcd74518757eda16cdf9df22a253945139513...d7b0de246c6d15cb43af86cb4e3209a58e5bb633,48,1515,1488,3003,94,2013-08-15 04:56:38,2013-08-15 04:56:05
d7b0de246c6d15cb43af86cb4e3209a58e5bb633...17843a86025c83b259a4f02ad10761a4f4182a32,15,122,59,181,31,2013-08-15 22:02:43,2013-08-15 22:02:43
17843a86025c83b259a4f02ad10761a4f4182a32...4b4732db7597133edff1e50448ae575b6f920db2,13,568,446,1014,104,2013-08-16 07:23:19,2013-08-16 07:23:19
4b4732db7597133edff1e50448ae575b6f920db2...c394ce734592b09b5e66ba19826add984af34c24,15,93,133,226,83,2013-08-16 23:59:47,2013-08-16 23:59:47
c4f52b7551d999796e3ccf6ddf22c467e700b89b...c4203e35000e308c95ded657cbf5fd64fc1b3ff3,1,1,1,2,1,2013-08-27 02:28:25,2013-08-27 02:28:25
c4f52b7551d999796e3ccf6ddf22c467e700b89b...49fd20d0fe3d20241f821d65c67c9eca674244d4,4,660,0,660,4,2013-08-27 00:42:34,2013-08-27 00:42:34
49fd20d0fe3d20241f821d65c67c9eca674244d4...8c9a6dd340c45340b81aa1afd520e24d889ad3d6,1,4574,4225,8799,776,2013-08-27 05:38:06,2013-08-27 05:38:06
8c9a6dd340c45340b81aa1afd520e24d889ad3d6...5e2a5fdc53f045f8d06fbac861a8483d4d930c68,2,327,47,374,22,2013-08-27 05:38:24,2013-08-27 05:38:24
5e2a5fdc53f045f8d06fbac861a8483d4d930c68...3867c69e56ddc0971fe43a09c9341ba35507d4de,2,81,18,99,26,2013-08-27 06:15:01,2013-08-27 06:15:01
3867c69e56ddc0971fe43a09c9341ba35507d4de...fbce5c79fd2d04652067ad1f55e481979ffe2c4d,1,2,1,3,1,2013-08-27 06:18:16,2013-08-27 06:18:16
fbce5c79fd2d04652067ad1f55e481979ffe2c4d...a842d575ce8b6672f9192cd18ef4a0985dae1292,8,281,45,326,31,2013-08-28 00:18:20,2013-08-28 00:18:20
a842d575ce8b6672f9192cd18ef4a0985dae1292...fee94a706d989af5eff8a0b73ba90836edd79011,3,45,2,47,3,2013-08-28 20:28:39,2013-08-28 20:28:39
fee94a706d989af5eff8a0b73ba90836edd79011...9062fa10247c79b0855664078209d5691df95ec7,2,166,1,167,5,2013-08-28 22:12:55,2013-08-28 22:12:55
9062fa10247c79b0855664078209d5691df95ec7...8af99767c2c93fda9b3947b9bfa80a77aa7c3089,1,34,8,42,5,2013-08-29 01:39:13,2013-08-29 01:39:13
8af99767c2c93fda9b3947b9bfa80a77aa7c3089...b557c65460cce44c89064b1e17f2ec992b1798f9,2,117,0,117,4,2013-08-30 02:52:03,2013-08-30 02:52:03
b557c65460cce44c89064b1e17f2ec992b1798f9...f0c5fe13135180eea4db88e5cdc6e6e5433ceb3f,2,78,0,78,2,2013-08-30 03:23:25,2013-08-30 03:23:25
f0c5fe13135180eea4db88e5cdc6e6e5433ceb3f...faa60df20ef713199d423e07da610048a2dba1f6,3,182,26,208,15,2013-08-31 05:51:35,2013-08-31 05:51:35
faa60df20ef713199d423e07da610048a2dba1f6...92afed39226a1e502c42c560e0ae7c5dc8001cc3,3,179,9,188,11,2013-08-31 20:19:03,2013-08-31 20:19:03
92afed39226a1e502c42c560e0ae7c5dc8001cc3...16d823dce518d831c90666e4da2b87bb30d6e46a,2,111,12,123,14,2013-09-02 20:14:25,2013-09-02 20:14:25
16d823dce518d831c90666e4da2b87bb30d6e46a...12a17d3bfe80af4cc78417971c22687f5578185c,1,86,68,154,2,2013-09-02 20:26:38,2013-09-02 20:26:38
12a17d3bfe80af4cc78417971c22687f5578185c...e104d43021bac4cbaf0681ff6cad743063e2e97e,3,69,9,78,9,2013-09-02 21:45:19,2013-09-02 21:45:19
e104d43021bac4cbaf0681ff6cad743063e2e97e...07738efc198e5ae183fe4a27402bd3bcd2e55880,2,32,2,34,4,2013-09-02 21:59:50,2013-09-02 21:59:50
07738efc198e5ae183fe4a27402bd3bcd2e55880...bca0d2ec1e0f302d332b1e94d62ef774724c0f71,2,35,3,38,7,2013-09-02 22:37:35,2013-09-02 22:37:35
bca0d2ec1e0f302d332b1e94d62ef774724c0f71...a5bada71a8ca36548771e307b259f0b1d716769b,3,65,8,73,8,2013-09-03 01:40:55,2013-09-03 01:40:46
a5bada71a8ca36548771e307b259f0b1d716769b...930700f68c5d2ece214e4f8f78c1b05b9401b5dc,2,141,3,144,13,2013-09-04 01:25:32,2013-09-04 01:25:32
930700f68c5d2ece214e4f8f78c1b05b9401b5dc...b2696e9a7c03edc691517e876552037fbb6bd7d7,3,126,31,157,21,2013-09-04 02:51:04,2013-09-04 02:51:04
b2696e9a7c03edc691517e876552037fbb6bd7d7...1c223b36060d78fccf08fe54cec7392a9bb49d2a,2,51,21,72,6,2013-09-04 03:09:25,2013-09-04 03:09:25
1c223b36060d78fccf08fe54cec7392a9bb49d2a...296686f81ee1d285d2d8ba2429b1bc77ca6c8703,2,20,2,22,5,2013-09-09 17:45:34,2013-09-09 17:45:34
c4f52b7551d999796e3ccf6ddf22c467e700b89b...3d62d51ae37429f45488f360f0a18bd7e8c21b8f,3,138,0,138,3,2013-08-22 22:53:03,2013-08-22 18:34:13
3d62d51ae37429f45488f360f0a18bd7e8c21b8f...54b63d937bb5b9af95c0c746d79f694949abfe96,3,13,7,20,5,2013-08-30 22:43:15,2013-08-30 22:43:15
54b63d937bb5b9af95c0c746d79f694949abfe96...4b6be0cd1612b5f3529e99dfb232046ac9293ad7,2,15,9,24,5,2013-08-31 02:53:25,2013-08-31 02:53:25
4b6be0cd1612b5f3529e99dfb232046ac9293ad7...5570d2c7b9a6dfad7ae6a6b97534841d3db58102,2,3,3,6,2,2013-09-04 00:16:22,2013-09-04 00:16:22
5570d2c7b9a6dfad7ae6a6b97534841d3db58102...e862bc2d2380665aae93fa28288708156fa55a62,1,33,8,41,11,2013-09-05 19:04:54,2013-09-05 19:04:54
e862bc2d2380665aae93fa28288708156fa55a62...c7d933c80eae217223491d3c40f03f08bb7e925c,4,132,83,215,17,2013-09-07 01:33:32,2013-09-07 01:33:32
c7d933c80eae217223491d3c40f03f08bb7e925c...7ed93424425286ad1e1ac0f6c446e386d05e851f,2,2,2,4,2,2013-09-11 18:49:50,2013-09-11 18:49:50
7ed93424425286ad1e1ac0f6c446e386d05e851f...84cd4e9395ea0894bf37e61596577c2e20659a82,3,10,19,29,8,2013-09-18 19:13:41,2013-09-18 19:13:41
84cd4e9395ea0894bf37e61596577c2e20659a82...317988b250dbb993090f4ced428e81aaa30c558a,1,8,1,9,2,2013-09-18 22:44:04,2013-09-18 01:43:31
317988b250dbb993090f4ced428e81aaa30c558a...e3793ae07924e6dfdd0744870aede4fa3187b73b,1,1,1,2,1,2013-09-19 22:05:20,2013-09-19 22:05:20
e3793ae07924e6dfdd0744870aede4fa3187b73b...28ab3e89471681fb41e51ce25703b2c82d44f6ef,1,1,1,2,1,2013-10-01 22:18:15,2013-10-01 22:14:09
28ab3e89471681fb41e51ce25703b2c82d44f6ef...b0cf554640b285ba0d0018c4ab639255675f5283,1,2,1,3,1,2013-10-02 00:37:19,2013-09-23 22:53:47
b0cf554640b285ba0d0018c4ab639255675f5283...bc16973839832c971e8cfdc38f0227e44982dc5a,1,1,1,2,1,2013-10-04 23:24:29,2013-10-04 23:24:29
bc16973839832c971e8cfdc38f0227e44982dc5a...fb5e41e748abe159c05b0e9ee747c91b8ac3251f,1,11,4,15,6,2013-10-09 20:53:01,2013-10-09 20:53:01
fb5e41e748abe159c05b0e9ee747c91b8ac3251f...22cebe3d260a8057177776a4a9ac94c178e5a2d3,1,1,1,2,1,2013-10-10 21:50:36,2013-10-10 21:50:36
22cebe3d260a8057177776a4a9ac94c178e5a2d3...baa6aa56a04138ee6699f32883668a5f94a8bc72,7,31,6,37,7,2013-10-22 00:07:01,2013-10-21 04:44:21
baa6aa56a04138ee6699f32883668a5f94a8bc72...65261eda42bfb52d650f4ae5a7e61c477670f5c7,2,7,1,8,3,2013-10-22 00:08:39,2013-10-18 20:28:25
65261eda42bfb52d650f4ae5a7e61c477670f5c7...3c1007c6bb2266531b1585ae2e297da6d437dfdc,1,15,10,25,12,2013-10-31 18:27:05,2013-10-31 01:44:47
55e5e3b9c4988805816741fcb4046a68f5703abd...951fc87213cbbba1c9253c95227f44c40a845230,1,3,1,4,2,2013-07-24 05:50:07,2013-07-15 23:03:50
951fc87213cbbba1c9253c95227f44c40a845230...732482b5ea204885d21dc78d27098ffa5ef09f6f,1,5,0,5,1,2013-07-24 05:50:07,2013-07-16 17:56:08
e03ec98359e8a5737a9634ae147293b34d4753ac...972e295df6f73abf47740e689a69e0486934b47a,1,1,0,1,1,2013-06-20 01:04:20,2013-06-20 01:04:20
7dcb53c4bd16b948377c9e8dc813e55c91fe1199...4fe321bba7e82b6161132617853b0a6e20eef66d,1,5,6,11,3,2013-06-18 05:48:45,2013-06-18 05:48:45
4fe321bba7e82b6161132617853b0a6e20eef66d...ed6adc370a4d36a7ad8a8f46c87f5438689da603,5,67,61,128,12,2013-06-18 06:37:08,2013-06-18 06:26:41
ed6adc370a4d36a7ad8a8f46c87f5438689da603...760289a4372cec3847b68745d4da444999c675fe,1,3,3,6,2,2013-06-18 16:51:00,2013-06-18 16:51:00
760289a4372cec3847b68745d4da444999c675fe...b68483e31bedbf41e3ec9b1295014db356a1bf0b,5,18,0,18,5,2013-06-18 16:59:42,2013-06-18 16:59:42
9bafe2f8813e86c4ac6e6e8ac3f08c5cbdc9e6e1...c444451279fcd3a98480034265c8106fea4df928,2,22,1,23,2,2013-06-14 22:30:25,2013-06-14 19:23:50
c444451279fcd3a98480034265c8106fea4df928...985cea327735a2de42bee46d6da05ad4f5eb97ff,2,2,3,5,3,2013-06-14 22:30:25,2013-06-14 22:30:19
bd5568389843bc51fe9c7fc033a2423454aa1b25...d53799d7a5d46eeeb3e5d5b287c549e3c53457b5,1,2,2,4,1,2013-05-23 04:42:51,2013-05-11 19:03:45
9b74af5b2a77f1cda68d5ad70e68d300d21fab02...bc2be8bb58a40bb99322f2bc5545a5e4338b23d6,2,7,5,12,5,2013-05-14 02:10:10,2013-05-12 08:31:39
bc2be8bb58a40bb99322f2bc5545a5e4338b23d6...d36de8253dee61b6e1a504a97233f5834621ab9d,2,22,1,23,4,2013-05-14 06:50:53,2013-05-14 04:41:38
d36de8253dee61b6e1a504a97233f5834621ab9d...ded617f0c8eca7c7319f00a54cebe0d35fb0b99b,2,5,24,29,4,2013-05-14 18:46:32,2013-05-14 18:16:37
ded617f0c8eca7c7319f00a54cebe0d35fb0b99b...3090e86c251690433b099e650052da646952d11e,1,21,0,21,1,2013-05-14 18:46:32,2013-05-14 18:43:44
3090e86c251690433b099e650052da646952d11e...1a3aa2531226c5465b28f032ed23c52af580f070,1,4,2,6,2,2013-05-14 19:32:47,2013-05-14 19:32:47
1a3aa2531226c5465b28f032ed23c52af580f070...43548bc8c41d197e5ff1bdd78d802f8cf4b7169d,3,21,6,27,8,2013-05-15 05:58:17,2013-05-15 05:58:17
9b74af5b2a77f1cda68d5ad70e68d300d21fab02...3f36763f2925d368af7f93ed15e73437c64af89d,2,7,5,12,5,2013-05-12 08:31:39,2013-05-12 08:31:39
3f36763f2925d368af7f93ed15e73437c64af89d...8dbee56e77d9069a43672e4f6b7f94aa1daee90b,68,68,0,68,68,2013-05-13 17:57:37,2013-05-13 17:36:47
a3a5a9bfbd4ae2e153b25efb88261aa8e1ec8117...e6ff44477b74f9fd7d0d335a0065f488ab173848,1,5,1,6,3,2013-04-25 23:52:06,2013-04-17 21:28:11
e6ff44477b74f9fd7d0d335a0065f488ab173848...0b74f9b8fa0d6f679932de9114cacbaeba9de9c8,1,3,1,4,2,2013-04-25 23:52:06,2013-04-18 02:19:07
0b74f9b8fa0d6f679932de9114cacbaeba9de9c8...17d81e64bc94da404d00cba2cc5291a3f9a40496,1,4,0,4,1,2013-04-25 23:52:06,2013-04-18 03:14:23
17d81e64bc94da404d00cba2cc5291a3f9a40496...bd0b88caed7b8e03da4948deb97a935d963f6e94,1,3,3,6,1,2013-04-26 00:06:06,2013-04-26 00:06:06
bd0b88caed7b8e03da4948deb97a935d963f6e94...ed4a962655b6b87433bb87995807335fc993db39,1,3,1,4,2,2013-04-26 00:07:16,2013-04-26 00:07:16
93497be27f3e7fee0bdde39daa8c907bee214f0b...66d4bbc42829137b0ea8dc0d0eeda8bfc37453e3,1,1,1,2,1,2013-04-14 03:16:28,2013-04-14 03:08:41
66d4bbc42829137b0ea8dc0d0eeda8bfc37453e3...ee03cfc1f8538a0c4c68ea7cf6e6c84f44de809b,1,1,1,2,1,2013-04-14 03:16:28,2013-04-14 03:12:39
aad4b377be77deaced20dde42b53bfc1401e1d85...db2037978c7582b025187ba055ba4ce40a1c4378,1,3,0,3,1,2013-03-21 18:33:42,2013-03-21 18:33:42
db2037978c7582b025187ba055ba4ce40a1c4378...3aa9e1a36acdf8fee46e956c8bf24443bbe66fc0,5,54,40,94,25,2013-03-21 18:36:27,2013-03-21 18:35:06
3aa9e1a36acdf8fee46e956c8bf24443bbe66fc0...03d51034384d817c84697533e521768c254aa769,1,20,9,29,4,2013-03-21 20:49:16,2013-03-21 20:49:16
03d51034384d817c84697533e521768c254aa769...cfacac8b7a0f24e3da727ff5186fd8eba9f1dd17,1,3,5,8,2,2013-03-21 20:59:28,2013-03-21 20:58:51
aad4b377be77deaced20dde42b53bfc1401e1d85...4c65071c42970d1ef20a39dc76b3b84d2799de1c,2,7,6,13,5,2013-03-21 08:41:37,2013-03-21 08:41:37
93af9a2a038c313b2ad00df2b203137a34239d19...12a123c4662d0ef1df8f4dbc379f801c4542f535,2,6,3,9,4,2013-03-04 22:08:44,2013-03-04 22:08:44
420e50996b02a12a8341e8717ee4aaaee9c6ea3a...b24317b3ef5f4c49e10f4bba9484594c5e549e27,2,16,4,20,6,2013-02-05 00:23:11,2013-02-05 00:23:11
420e50996b02a12a8341e8717ee4aaaee9c6ea3a...012e1947be8ce177ab145e43262ff23b83419ed5,2,321,351,672,19,2013-02-04 22:32:12,2012-11-14 17:21:30
012e1947be8ce177ab145e43262ff23b83419ed5...269219254756dcada1ae9cd3567b4fe85d5db2ab,2,209,174,383,47,2013-02-04 22:32:12,2012-12-17 18:52:24
269219254756dcada1ae9cd3567b4fe85d5db2ab...0567a730b1bf09ae8076f0e6422c1854668e8b9d,1,265,271,536,50,2013-02-04 22:32:12,2012-12-18 04:07:00
0567a730b1bf09ae8076f0e6422c1854668e8b9d...3bdf41add159bf4b71b79c9fa7f29642731ba09f,3,58,66,124,3,2013-02-05 00:42:18,2013-02-05 00:42:18
62bcab56d1a29cdb8b00165c00f0b93e303219bd...e2ddf0aeadc1b0814c32db1d382f697493d9c81b,1,5,1,6,2,2013-02-07 21:47:52,2013-02-07 21:47:52
e2ddf0aeadc1b0814c32db1d382f697493d9c81b...97cbc5a50e541284870aef0099e872eeb2cba66f,1,0,4,4,1,2013-02-07 21:49:10,2013-02-07 21:49:10
97cbc5a50e541284870aef0099e872eeb2cba66f...557dd363f4f864afe53b1467cf3865d0eb7d1f9e,3,62,62,124,6,2013-02-07 22:52:18,2013-02-07 22:52:18
557dd363f4f864afe53b1467cf3865d0eb7d1f9e...9b3cd467d0c5812af808c82e5cd2bddf9897748e,3,51,27,78,14,2013-02-07 23:41:20,2013-02-07 23:41:20
9b3cd467d0c5812af808c82e5cd2bddf9897748e...db917f4741703f878391a52fd2e49e7714683939,6,170,22,192,18,2013-02-07 23:43:28,2013-02-07 22:29:52
821a2370821335ef6b772231e07c4131d3cd7b93...13074d58b9ca5a1851f49c25ec754afa7ca7b9d4,13,11,2413,2424,13,2012-12-21 19:20:01,2012-12-21 19:20:01
13074d58b9ca5a1851f49c25ec754afa7ca7b9d4...321581dc8ae903f7e1c4cded2e1870195114cd5e,1,1,1,2,1,2012-12-23 20:34:59,2012-12-23 20:34:59
821a2370821335ef6b772231e07c4131d3cd7b93...0368441833c9e693f92d00f73fdd924651563ed3,5,7,28,35,8,2012-12-21 02:03:00,2012-12-21 02:03:00
0368441833c9e693f92d00f73fdd924651563ed3...3732f0e7c03fb5cc6c050ea28958086a6bc73379,6,318,5,323,9,2012-12-21 04:07:51,2012-12-21 04:07:51
3732f0e7c03fb5cc6c050ea28958086a6bc73379...e67d2059ef88c97d3fe947f77587b3779fc32f21,1,2,2,4,2,2012-12-21 05:41:13,2012-12-21 05:36:04
e67d2059ef88c97d3fe947f77587b3779fc32f21...b50c98fdc1f5aff9c9d0d99ac3978bf0f338fe36,1,13,7,20,2,2012-12-21 05:41:42,2012-12-21 05:41:42
b50c98fdc1f5aff9c9d0d99ac3978bf0f338fe36...cd9dadbfb1f61d65e86a36c368ab1f49d22df707,2,56,0,56,2,2012-12-21 06:25:16,2012-12-21 06:24:49
cd9dadbfb1f61d65e86a36c368ab1f49d22df707...452c5a139fa94073034cfdfe625a108deffa70c9,2,23,3,26,4,2012-12-21 06:56:55,2012-12-21 06:56:55
452c5a139fa94073034cfdfe625a108deffa70c9...a0605983bc5f4b8affa6b1d7835fb23280965328,1,13,7,20,3,2012-12-22 05:22:04,2012-12-22 05:21:57
e2fd3fcad31b3a9e2c9f80d16260f9cd606741bd...b242f20ffee9188efa632061b86a5f8aea72dcda,2,19,14,33,7,2013-10-17 23:36:13,2013-10-17 23:36:13
b242f20ffee9188efa632061b86a5f8aea72dcda...8e2cd47c388250dca862d9333604c1946d985e0e,1,1,1,2,1,2013-10-18 18:50:52,2013-10-10 23:16:43
687f989f18349cc77b5b00f25f88fb3f6bb4af01...995ccae9678ac6dd38e93292cf5c3afd291ee39b,1,1,1,2,1,2013-10-10 23:16:43,2013-10-10 23:16:43
1c8a5169edb72eca7af7cc04d014d2b0a887017c...ba34b2550bf4b73bb13e0ef79367ed18c79833c4,2,4,1,5,3,2013-09-04 23:31:52,2013-08-27 21:19:04
f598d40c8bc73f0d6b3080c9ff3907d100b3cea5...89844e72185993956ecd78f656132a9d25d32e56,8,155,71,226,13,2013-08-15 00:46:22,2013-08-03 00:34:10
89844e72185993956ecd78f656132a9d25d32e56...11fccbe013f0843aa2c65850af47dadde73e1285,5,80,72,152,14,2013-08-15 00:46:22,2013-08-05 22:07:27
11fccbe013f0843aa2c65850af47dadde73e1285...a3e519610989d9383d51fc579e069524f80d78ee,3,31,50,81,16,2013-08-15 00:46:22,2013-08-06 00:13:40
a3e519610989d9383d51fc579e069524f80d78ee...dfa46b141c0e0ec8a16d9caefb9d1413c371a508,1,8,0,8,1,2013-08-15 00:46:22,2013-08-06 22:23:49
dfa46b141c0e0ec8a16d9caefb9d1413c371a508...663cc1ba01486bbeefedb8f4f884664d87d7564c,4,51,47,98,11,2013-08-15 00:46:22,2013-08-07 21:09:36
663cc1ba01486bbeefedb8f4f884664d87d7564c...dde80aac91a42608b65570b2bde5b4833bbbd98b,2,0,4,4,4,2013-08-15 00:46:23,2013-08-07 21:38:29
dde80aac91a42608b65570b2bde5b4833bbbd98b...8b50d3b3d7a6fbcced8bf6b61a98f23ff3003836,1,1,1,2,1,2013-08-15 00:46:23,2013-08-08 00:13:45
8b50d3b3d7a6fbcced8bf6b61a98f23ff3003836...6db81808fad88d30dbbe22729b6aac835564910c,3,12,6,18,7,2013-08-15 00:46:23,2013-08-12 19:34:25
6db81808fad88d30dbbe22729b6aac835564910c...3df06fc1b9f015205b993f586de83f20d917af2a,3,7,4,11,3,2013-08-15 00:46:23,2013-08-12 21:08:35
3df06fc1b9f015205b993f586de83f20d917af2a...53cb4a11c5f756ae054ad49ff95f6cefae8f7f2b,3,6,2,8,4,2013-08-15 00:46:23,2013-08-12 23:28:56
53cb4a11c5f756ae054ad49ff95f6cefae8f7f2b...bc815ac5e7c81b77e5419bf3c1dd90d9a142cd07,1,1,1,2,1,2013-08-15 00:46:23,2013-08-13 00:24:11
bc815ac5e7c81b77e5419bf3c1dd90d9a142cd07...19ba844f1432ea3f7be61a569d72f67b8e9b5478,9,18,18,36,16,2013-08-15 00:46:23,2013-08-15 00:45:41
83c0ae78736b053af3b3971465fc701b4db94f07...457938954ce5882d1ca88291dcc23e93cedf8c55,1,0,376,376,1,2013-09-10 01:46:09,2013-09-10 01:46:09
457938954ce5882d1ca88291dcc23e93cedf8c55...7d5e3821ef0a5dc2abc052e555fed1b456bd5a20,5,33,17,50,18,2013-09-10 02:00:23,2013-09-10 02:00:23
7d5e3821ef0a5dc2abc052e555fed1b456bd5a20...3b917d849522bd6ffa0be8534618a84413746e4e,1,0,1,1,1,2013-09-11 16:25:05,2013-09-11 16:25:05
652eb0cb894ed8582d3b080f469c133459a41cb0...a7a2cb49158b3cbc96dc46eb9b485ee398e43ff3,2,32,8,40,12,2013-11-01 01:07:27,2013-11-01 00:50:34
fc2ec5f637ca70e457de97877ace8caa9ea3bc62...6e86bb40962150e3ca347c04a01dffddc8312a89,1,1,1,2,1,2013-07-24 05:58:01,2013-07-24 05:58:01
972e295df6f73abf47740e689a69e0486934b47a...49e98134fda0f81948cb71b6081ac4c417713f99,1,15,0,15,1,2013-06-25 22:09:49,2013-06-25 22:09:49
b68483e31bedbf41e3ec9b1295014db356a1bf0b...3ca046729afe75ef149012e9e566a335716a0ae1,10,106,36,142,33,2013-06-18 20:55:28,2013-06-18 20:53:46
3ca046729afe75ef149012e9e566a335716a0ae1...a97138f04f6635d2d1aa8b880ac6c99778bb1007,2,8,2,10,2,2013-06-19 00:13:06,2013-06-19 00:13:06
a97138f04f6635d2d1aa8b880ac6c99778bb1007...7a0c3b7ad856762efac97d90fbc3f3aabb6ddd8a,6,28,15,43,10,2013-06-19 00:58:06,2013-06-19 00:58:06
7a0c3b7ad856762efac97d90fbc3f3aabb6ddd8a...164f8921b5dceb933e810f1b0ea37d4ec106c545,4,2,20,22,4,2013-06-19 01:02:23,2013-06-19 01:02:23
ea48bf81bffa5959f25432cb0cd2f5cdcea78398...df9ceed07eea412b2c65ffa2d50984cdea8d5673,2,3,3,6,3,2013-06-14 23:30:47,2013-06-14 23:30:47
df9ceed07eea412b2c65ffa2d50984cdea8d5673...f5502640548de762f1ad4549a1a1818bfe9d7586,1,6,1,7,1,2013-06-14 23:39:42,2013-06-14 23:25:57
f5502640548de762f1ad4549a1a1818bfe9d7586...ce813b496a164b548f4801f9b7a9c433d0aba597,1,16,21,37,4,2013-06-14 23:39:42,2013-06-14 23:31:35
ce813b496a164b548f4801f9b7a9c433d0aba597...160a9a2b0674622c9c9504df7fc5a2b94c9b502d,1,3,2,5,2,2013-06-14 23:39:42,2013-06-14 23:33:39
160a9a2b0674622c9c9504df7fc5a2b94c9b502d...790deed8b4110180ddd1ac1eab24f5fae80c7141,2,28,40,68,17,2013-06-15 00:01:47,2013-06-15 00:01:36
4e05cc65c1c2702b0a63166e0cfc44bd668f853a...4a99d1b3ee1bcdd57125d82939d32c6143ecd0d1,10,319,30,349,15,2013-05-23 04:46:49,2013-05-07 18:44:53
4a99d1b3ee1bcdd57125d82939d32c6143ecd0d1...bb4afdff5ba6daf1e6c7b6d0a21d7471f421cbb6,5,0,0,0,0,2013-05-23 04:58:43,2013-05-23 04:58:43
bb4afdff5ba6daf1e6c7b6d0a21d7471f421cbb6...65636b5996be5f26c33ab35cc674c0e83d80b630,1,2,0,2,1,2013-05-23 05:02:13,2013-05-23 05:02:13
43548bc8c41d197e5ff1bdd78d802f8cf4b7169d...93af3ab238c782209fb836ef38dd61bb006691a2,1,4,3,7,1,2013-05-15 18:14:59,2013-05-15 18:14:59
93af3ab238c782209fb836ef38dd61bb006691a2...b237ace7de9401a28080d9816fac8f65ddb00a51,1,1,1,2,1,2013-05-15 18:35:14,2013-05-15 18:35:14
b237ace7de9401a28080d9816fac8f65ddb00a51...9386af8ac7b9ce0b1532bd8a785cecf1577b4d1e,1,4,5,9,2,2013-05-15 18:40:54,2013-05-15 18:40:54
9386af8ac7b9ce0b1532bd8a785cecf1577b4d1e...2fb44613ce6ee818408ce4020a07ace4483f1e72,4,4,4,8,4,2013-05-15 18:52:09,2013-05-15 18:52:09
2fb44613ce6ee818408ce4020a07ace4483f1e72...546f4e5fb93699983aee11ef01510b29cf09b354,1,1,1,2,1,2013-05-15 18:55:31,2013-05-15 18:55:31
43548bc8c41d197e5ff1bdd78d802f8cf4b7169d...36415677561fcd906c1ce872b21fa220620474ff,1,3,0,3,1,2013-05-15 06:02:34,2013-05-15 06:02:34
8dbee56e77d9069a43672e4f6b7f94aa1daee90b...8bf2e0edae455d1b9b6729c4cad713a36db17ef5,5,5,0,5,5,2013-05-14 01:16:14,2013-05-14 01:16:14
8bf2e0edae455d1b9b6729c4cad713a36db17ef5...773a86c80c80ab3bb83b51b926ce3b2498d390d5,2,22,1,23,4,2013-05-14 06:45:21,2013-05-14 04:41:38
773a86c80c80ab3bb83b51b926ce3b2498d390d5...6063ca90ef9c24fbbaf1a48ecf5a85c3d36e65f6,1,0,1,1,1,2013-05-14 17:48:33,2013-05-14 17:48:33
6063ca90ef9c24fbbaf1a48ecf5a85c3d36e65f6...4c2e1ef1b6ab7232208d604c51dc8eca52e85084,2,5,24,29,4,2013-05-14 18:32:53,2013-05-14 18:16:37
4c2e1ef1b6ab7232208d604c51dc8eca52e85084...1fc2dabf6d0e837f847e7b32ca284348b1238ed5,1,21,0,21,1,2013-05-14 18:44:22,2013-05-14 18:43:44
1fc2dabf6d0e837f847e7b32ca284348b1238ed5...afe5867f6870c127d336e0debbd21c466300ca29,1,4,2,6,2,2013-05-14 19:32:55,2013-05-14 19:32:47
afe5867f6870c127d336e0debbd21c466300ca29...a14b278a29ab009c97c36bd34b2897429569ed9a,1,14,4,18,1,2013-05-14 21:14:38,2013-05-14 21:14:07
8dbee56e77d9069a43672e4f6b7f94aa1daee90b...6f05a29f0b791d7e0c4a0493d8f17754e329e393,4,9,36,45,13,2013-05-13 18:49:45,2013-04-26 17:40:40
6f05a29f0b791d7e0c4a0493d8f17754e329e393...6b48e8bd8ab6f728101a0f0defad91caf3eccf64,69,1006,90,1096,115,2013-05-13 18:51:50,2013-04-02 20:20:38
6b48e8bd8ab6f728101a0f0defad91caf3eccf64...4838e5a365c139a32d2272d275330ecd9f9eda3e,1,446,43,489,24,2013-05-13 18:51:50,2013-04-02 20:52:14
4838e5a365c139a32d2272d275330ecd9f9eda3e...471ffd430b888a0c977b773d135a27f5d6666632,1,275,408,683,51,2013-05-13 18:51:50,2013-04-02 21:12:03
471ffd430b888a0c977b773d135a27f5d6666632...c9b988cc62befee6c48e372f7b377e2611185c37,1,13,12,25,8,2013-05-13 18:51:50,2013-04-02 21:13:32
c9b988cc62befee6c48e372f7b377e2611185c37...28cf05e2d7ac581fcc57b4281682e1dfcc3c89d8,1,2,2,4,2,2013-05-13 18:51:50,2013-04-02 21:14:26
28cf05e2d7ac581fcc57b4281682e1dfcc3c89d8...1ed8392a31188c9a9df0d97cf194b1b70c2f475f,1,2,7,9,3,2013-05-13 18:51:50,2013-04-02 21:15:14
1ed8392a31188c9a9df0d97cf194b1b70c2f475f...5b6bc3f29c9d06cee8c0dbc957ed29cf6b69044c,1,20,19,39,7,2013-05-13 18:51:50,2013-04-02 21:19:46
5b6bc3f29c9d06cee8c0dbc957ed29cf6b69044c...bff6101ad5b413aa4c445b0edefe0abcc218415e,1,2,1,3,1,2013-05-13 18:51:50,2013-04-02 21:22:11
bff6101ad5b413aa4c445b0edefe0abcc218415e...3fcde01908290941f912a4f8c768a621f8ac8356,1,13,9,22,1,2013-05-13 18:51:51,2013-04-02 21:26:39
3fcde01908290941f912a4f8c768a621f8ac8356...c628854bc8153b0d15d103085e34a2ee861a7aff,1,24,9,33,13,2013-05-13 18:51:51,2013-04-02 21:42:14
c628854bc8153b0d15d103085e34a2ee861a7aff...ede68cd02740ea726b807a1cf1c09d9bd2d42b56,2,39,45,84,5,2013-05-13 18:51:51,2013-04-02 22:18:49
ede68cd02740ea726b807a1cf1c09d9bd2d42b56...347efb362331d84e3195bb46515eb936bf87ee73,1,4,1,5,1,2013-05-13 18:51:51,2013-04-02 22:22:20
347efb362331d84e3195bb46515eb936bf87ee73...5b2523aa18d8a8ca2bad808b114e2c1ad15ad7f7,2,66,51,117,16,2013-05-13 18:51:51,2013-04-03 02:20:54
5b2523aa18d8a8ca2bad808b114e2c1ad15ad7f7...bb07daa25ec76b3227740decbf6eb68f650db0b9,3,85,88,173,10,2013-05-13 18:51:51,2013-04-03 02:35:19
bb07daa25ec76b3227740decbf6eb68f650db0b9...a7eae9eb7146c9dd335787253d638a0ccdb65443,2,18,21,39,17,2013-05-13 18:51:51,2013-04-03 02:47:51
a7eae9eb7146c9dd335787253d638a0ccdb65443...562490b7767c2f8b34481dba67d4ad5ad4e7a59f,6,32,26,58,25,2013-05-13 18:51:51,2013-04-03 03:11:36
562490b7767c2f8b34481dba67d4ad5ad4e7a59f...67356c0988dc6ae9fe938fe23ec0d331ae1c6524,4,38,27,65,23,2013-05-13 18:51:51,2013-04-03 03:24:10
67356c0988dc6ae9fe938fe23ec0d331ae1c6524...64a01102dac2d8308c183e38abeb5e77ee5f9b3d,2,45,58,103,11,2013-05-13 18:51:51,2013-04-03 03:46:12
64a01102dac2d8308c183e38abeb5e77ee5f9b3d...0823323cbecd7a4d4a42bf48742a07f21721173d,2,25,37,62,20,2013-05-13 18:51:51,2013-04-03 03:56:37
0823323cbecd7a4d4a42bf48742a07f21721173d...43c29fbd0b615d8baab079bbd7a71b6e38cc9ab3,7,220,213,433,12,2013-05-13 18:51:51,2013-04-03 23:29:13
43c29fbd0b615d8baab079bbd7a71b6e38cc9ab3...54e43f511eab7fd3c605813d7656597d5611a2a2,1,43,31,74,9,2013-05-13 18:51:51,2013-04-03 23:42:00
54e43f511eab7fd3c605813d7656597d5611a2a2...57db17dde0706095d4622abe9a8cf020987c823c,3,7,7,14,6,2013-05-13 18:51:52,2013-04-03 23:50:07
57db17dde0706095d4622abe9a8cf020987c823c...1266e5278eb0deaf804dcb5ed5aeb8b67bb03ef2,6,217,230,447,132,2013-05-13 18:51:52,2013-04-04 00:40:36
1266e5278eb0deaf804dcb5ed5aeb8b67bb03ef2...aaa0e9be5d088379a921430701d57ed07102df95,5,133,133,266,87,2013-05-13 18:51:52,2013-04-04 01:04:13
aaa0e9be5d088379a921430701d57ed07102df95...7477cd48fd21f70a35eb325fdb65ac68a7b51d38,2,32,31,63,22,2013-05-13 18:51:52,2013-04-04 06:17:29
7477cd48fd21f70a35eb325fdb65ac68a7b51d38...45217c41f36465ab2d0268b1bd1d664446fce79a,1,7,2,9,3,2013-05-13 18:51:52,2013-04-04 06:36:28
45217c41f36465ab2d0268b1bd1d664446fce79a...24682fd7f44fd48c3a0744fa2ee2deded038901d,7,802,331,1133,38,2013-05-13 18:51:52,2013-04-04 10:51:08
24682fd7f44fd48c3a0744fa2ee2deded038901d...78a31231cd886dae435834905684a8ed920ee783,3,3,3,6,3,2013-05-13 18:51:52,2013-04-04 11:00:25
78a31231cd886dae435834905684a8ed920ee783...9d8354b4293822042ba6851a5ef938d3881d6dfd,2,104,116,220,24,2013-05-13 18:51:52,2013-04-04 12:07:31
9d8354b4293822042ba6851a5ef938d3881d6dfd...cb064eca31bee1ded893fb0c19d8e49afaabd03a,7,827,504,1331,163,2013-05-13 18:51:52,2013-04-05 09:20:29
cb064eca31bee1ded893fb0c19d8e49afaabd03a...6fc6bf1dca08accb168d12aeb4f4a447162743e2,3,614,596,1210,73,2013-05-13 18:51:52,2013-04-06 04:59:12
6fc6bf1dca08accb168d12aeb4f4a447162743e2...b2b8e4c2f45a02a85084a19edcf986049c32dd34,2,60,53,113,11,2013-05-13 18:51:52,2013-04-06 05:45:49
b2b8e4c2f45a02a85084a19edcf986049c32dd34...4a92dff8dae1014ec317ab39e8914692bdab6f41,4,226,140,366,44,2013-05-13 18:51:52,2013-04-06 09:40:03
4a92dff8dae1014ec317ab39e8914692bdab6f41...e26732d3dd9a17970bf74a15aa4022a645457396,6,497,211,708,80,2013-05-13 18:51:52,2013-04-12 13:17:13
e26732d3dd9a17970bf74a15aa4022a645457396...503a84a3aaf18639477244f633eb1df7dea1fcad,5,551,107,658,53,2013-05-13 18:51:53,2013-04-16 11:21:28
503a84a3aaf18639477244f633eb1df7dea1fcad...f102598c6fc1f3ad34fc9fcf2b1f7b49d8ada198,1,1,3,4,2,2013-05-13 18:51:53,2013-04-16 11:21:41
f102598c6fc1f3ad34fc9fcf2b1f7b49d8ada198...4eec2ec057f59ea081a078db1b1c4def69ad5c58,1,30,3,33,5,2013-05-13 18:51:53,2013-04-16 11:22:07
4eec2ec057f59ea081a078db1b1c4def69ad5c58...78212bff0e04cee576c3eb1764f98bf8d134268d,1,0,1,1,1,2013-05-13 18:51:53,2013-04-17 01:56:24
78212bff0e04cee576c3eb1764f98bf8d134268d...2c1b297dc126f4ff9092b92fc4fa14fcb8e718d8,5,206,45,251,19,2013-05-13 18:51:53,2013-04-17 01:58:15
2c1b297dc126f4ff9092b92fc4fa14fcb8e718d8...54ca2a4463ac64ea8e23129185e27f0bd7ec9303,2,22,9,31,7,2013-05-13 18:51:53,2013-04-17 02:49:09
54ca2a4463ac64ea8e23129185e27f0bd7ec9303...302d625cba7b964a04e913ad6dc9f26aa0285da0,3,3,3,6,3,2013-05-13 18:51:53,2013-04-17 04:10:25
302d625cba7b964a04e913ad6dc9f26aa0285da0...9931898d22c2ce88f6dfbfa66122ff1849cfdcc6,4,35,19,54,10,2013-05-13 18:51:53,2013-04-17 05:07:51
9931898d22c2ce88f6dfbfa66122ff1849cfdcc6...d5e0313ff7e2c60a1176884b8b1006b2b70e7a2a,1,3,0,3,1,2013-05-13 18:51:53,2013-04-17 06:09:55
d5e0313ff7e2c60a1176884b8b1006b2b70e7a2a...675027fe93e0f23081a2b6c96070f11fc9853412,2,31,3,34,6,2013-05-13 18:51:53,2013-04-17 06:10:33
675027fe93e0f23081a2b6c96070f11fc9853412...8f42ce1434e29a00d8aa54b06018b5c20bd51f12,7,499,75,574,71,2013-05-13 18:52:42,2013-04-18 05:39:26
8f42ce1434e29a00d8aa54b06018b5c20bd51f12...11819d4344bf876119c9d40f8c9f5208b4db3537,3,48,20,68,9,2013-05-13 18:52:42,2013-04-18 07:25:27
11819d4344bf876119c9d40f8c9f5208b4db3537...a61fd1bf1447066c95cf8c9d5ae4463f3ebcc68e,1,3,4,7,3,2013-05-13 18:52:42,2013-04-18 07:52:12
a61fd1bf1447066c95cf8c9d5ae4463f3ebcc68e...193adbea59832fd8359424a304af052c3fb283e2,1,17,7,24,10,2013-05-13 18:52:43,2013-04-18 08:09:22
193adbea59832fd8359424a304af052c3fb283e2...c599601ccf5bf9853e3373d63d339daf704fc266,4,408,146,554,53,2013-05-13 18:52:43,2013-04-21 13:07:03
c599601ccf5bf9853e3373d63d339daf704fc266...20efd73f98234340bed107c46680310b1f54e3f3,3,403,86,489,24,2013-05-13 18:52:43,2013-04-22 14:26:36
20efd73f98234340bed107c46680310b1f54e3f3...d99dac599a8478f883f99d186ddb50ea4194e523,1,1,1,2,1,2013-05-13 18:52:43,2013-04-22 14:33:21
d99dac599a8478f883f99d186ddb50ea4194e523...ec0f3ff5956f73a99837072f78d928a119a4bd4b,5,131,54,185,28,2013-05-13 18:52:43,2013-04-22 17:27:17
ec0f3ff5956f73a99837072f78d928a119a4bd4b...d5660c3938b6e30fa108772c3f859e9b741bb737,19,296,115,411,41,2013-05-13 18:52:43,2013-04-22 23:14:41
d5660c3938b6e30fa108772c3f859e9b741bb737...8c72a28e35c1d20290042fe7b5ba92459cc8c7dd,7,51,28,79,8,2013-05-13 18:52:43,2013-04-22 23:22:30
8c72a28e35c1d20290042fe7b5ba92459cc8c7dd...4bff34a680dda5b9b0a8dbce80c8128dcc3f6212,8,74,46,120,8,2013-05-13 18:52:43,2013-04-22 23:36:55
4bff34a680dda5b9b0a8dbce80c8128dcc3f6212...dae3ddf50b6173b93a5213fb09292f4dc4011f46,6,61,29,90,6,2013-05-13 18:52:43,2013-04-22 23:45:43
dae3ddf50b6173b93a5213fb09292f4dc4011f46...ed18c6ffb56d841954514655bfa0df95547db64d,14,1256,336,1592,152,2013-05-13 18:52:43,2013-04-23 19:47:12
ed18c6ffb56d841954514655bfa0df95547db64d...49ddf192b3eecc9ba4db8b900ca25c16be5bc5ba,2,97,31,128,17,2013-05-13 18:53:50,2013-04-25 09:28:10
49ddf192b3eecc9ba4db8b900ca25c16be5bc5ba...5ec1d9997c6361823347399968ffb4e2150df4ca,3,16,12,28,9,2013-05-13 18:53:50,2013-04-25 23:55:47
5ec1d9997c6361823347399968ffb4e2150df4ca...42bd977ab73859cf1d936e3e8dce62bb954468fb,1,9,1,10,3,2013-05-13 18:53:51,2013-04-26 00:01:15
42bd977ab73859cf1d936e3e8dce62bb954468fb...1fd27e9534e619126d2b06c46e8b0b04283b009e,1,32,11,43,17,2013-05-13 18:53:51,2013-04-26 00:21:52
1fd27e9534e619126d2b06c46e8b0b04283b009e...3abacc44f19408b35b159ae2e21dc8c9f242d2fa,3,25,23,48,12,2013-05-13 18:53:51,2013-04-26 03:01:51
3abacc44f19408b35b159ae2e21dc8c9f242d2fa...90d32630cc60fe387013957b1537334ced4d1c29,3,220,218,438,36,2013-05-13 18:53:51,2013-04-26 04:07:43
90d32630cc60fe387013957b1537334ced4d1c29...607e637b225b4676f8d364ee90cf3992799d60aa,5,90,14,104,13,2013-05-13 18:53:51,2013-04-26 04:35:22
607e637b225b4676f8d364ee90cf3992799d60aa...3ed917dc2158a14349c43bd791f848269a09b370,1,6,0,6,1,2013-05-13 18:54:19,2013-04-26 18:12:38
3ed917dc2158a14349c43bd791f848269a09b370...b4353f653c123d5debbf1e02aee692dc2e31b083,1,0,0,0,0,2013-05-13 18:54:20,2013-04-26 18:26:11
b4353f653c123d5debbf1e02aee692dc2e31b083...84baa67186b9868256de78aac8aa41d0cc378eeb,2,2,1,3,2,2013-05-13 18:54:20,2013-04-26 19:28:32
84baa67186b9868256de78aac8aa41d0cc378eeb...0f3ab1af6be68596bcffdf30543d149c8de7b80c,3,15,15,30,13,2013-05-13 18:54:20,2013-04-29 12:21:34
0f3ab1af6be68596bcffdf30543d149c8de7b80c...1049c2d7d271ed0d24f9e1d21c1edf0301b5ca3d,8,21,1,22,18,2013-05-13 18:54:20,2013-04-29 12:45:32
1049c2d7d271ed0d24f9e1d21c1edf0301b5ca3d...9dd512e7691598e4f58fbe72db2770d1a609fc33,2,7,23,30,6,2013-05-13 18:54:20,2013-04-29 12:49:10
9dd512e7691598e4f58fbe72db2770d1a609fc33...ff09e101eea8d3a28bca8efb6d5e61b773066b03,1,10,0,10,1,2013-05-13 18:54:20,2013-04-29 13:37:05
ff09e101eea8d3a28bca8efb6d5e61b773066b03...78d8f615644a3052abfde9f6d14953b089af8d46,2,0,2,2,2,2013-05-13 18:54:20,2013-04-29 16:06:30
78d8f615644a3052abfde9f6d14953b089af8d46...1f0587886c3ffb60a1b1218ab8151cd27fc1ddad,8,39,24,63,14,2013-05-13 18:55:11,2013-04-29 16:43:54
1f0587886c3ffb60a1b1218ab8151cd27fc1ddad...c62727a25ce9cdf433bc3c6d510b4a99e561c93d,1,18,2,20,2,2013-05-13 18:55:11,2013-04-29 19:30:11
c62727a25ce9cdf433bc3c6d510b4a99e561c93d...077b695ac19e1dfd584ff30ff7cb80090ae934d9,1,60,0,60,2,2013-05-13 18:55:11,2013-04-29 19:35:27
077b695ac19e1dfd584ff30ff7cb80090ae934d9...98470216331991255a0e139038c20fc98f12311a,1,9,7,16,2,2013-05-13 18:55:11,2013-04-29 19:48:12
98470216331991255a0e139038c20fc98f12311a...bb0e000175d8ded44bb59669c9c0508f2cd5112c,1,7,1,8,2,2013-05-13 18:55:12,2013-04-29 20:15:21
bb0e000175d8ded44bb59669c9c0508f2cd5112c...27b617ce926798673d9092f8da5d7010dccf8a0b,1,1,1,2,1,2013-05-13 18:55:12,2013-04-29 20:15:57
27b617ce926798673d9092f8da5d7010dccf8a0b...3a7268b336de4e14905fa8511b4368d6a36ed3e0,1,10,6,16,4,2013-05-13 18:55:12,2013-04-29 23:20:59
3a7268b336de4e14905fa8511b4368d6a36ed3e0...c6b68b2125492fbea4020b44b566adfe6e817ac8,1,1,1,2,1,2013-05-13 18:55:12,2013-04-30 06:11:17
c6b68b2125492fbea4020b44b566adfe6e817ac8...02e1b3b1c7278bb44f1368f5ebc804e6f0010b5d,11,186,29,215,42,2013-05-13 18:56:51,2013-04-30 19:28:52
02e1b3b1c7278bb44f1368f5ebc804e6f0010b5d...6d85b03c905f2e8a590d4f500977af96f44a2118,1,1,1,2,1,2013-05-13 18:56:51,2013-04-30 20:08:07
6d85b03c905f2e8a590d4f500977af96f44a2118...a780f9f4277357afd85b8e214f082b8a4ebd9dce,1,5,21,26,5,2013-05-13 18:56:51,2013-04-30 20:16:10
a780f9f4277357afd85b8e214f082b8a4ebd9dce...a08b0b62f19875d3c7ad18611faeab98ee30fab7,1,4,2,6,2,2013-05-13 18:56:51,2013-04-30 21:47:08
a08b0b62f19875d3c7ad18611faeab98ee30fab7...dc68b20b694f668f5b16be2273c8bfc9d9d87894,1,116,56,172,16,2013-05-13 18:56:51,2013-05-01 01:22:13
dc68b20b694f668f5b16be2273c8bfc9d9d87894...0b2d536e3889bb61be134fae980b194c9562f4c3,5,67,42,109,30,2013-05-13 18:56:51,2013-05-01 02:39:36
0b2d536e3889bb61be134fae980b194c9562f4c3...a4c7adfcec79460a4bf1a0663a256b6cfe6ef9b7,1,5,7,12,1,2013-05-13 18:56:51,2013-05-01 02:41:54
a4c7adfcec79460a4bf1a0663a256b6cfe6ef9b7...b76de57830c754d28c678ee0eb7329dab8ba37e8,3,73,9,82,12,2013-05-13 18:56:51,2013-05-01 02:56:48
b76de57830c754d28c678ee0eb7329dab8ba37e8...f73714cadc48da0575c683dc9da513301982839a,2,138,4,142,12,2013-05-13 18:56:51,2013-05-01 07:15:36
f73714cadc48da0575c683dc9da513301982839a...b3a5c26847e6a8b782c5112a83c2f4ab34125b04,3,4,4,8,4,2013-05-13 18:56:51,2013-05-01 07:27:00
b3a5c26847e6a8b782c5112a83c2f4ab34125b04...c4293fcdecc58e4cc56b2456751eb6aff14ad434,1,119,47,166,12,2013-05-13 18:56:51,2013-05-01 10:11:55
c4293fcdecc58e4cc56b2456751eb6aff14ad434...2e5652b1048d7ad8f36a2a5143d0bd0c64d83067,1,10,2,12,1,2013-05-13 18:56:51,2013-05-01 02:19:18
2e5652b1048d7ad8f36a2a5143d0bd0c64d83067...7f08cbbeafee4c138bf35b401d7fa2ffdaf859fd,1,0,1,1,1,2013-05-13 18:56:51,2013-05-01 10:13:55
7f08cbbeafee4c138bf35b401d7fa2ffdaf859fd...2a7f5525263ae42136697726ff3b79481d60a1ea,1,30,11,41,5,2013-05-13 18:56:52,2013-05-01 10:34:33
2a7f5525263ae42136697726ff3b79481d60a1ea...437b174b16cb4939dc0af298e83ed738934be0e7,2,84,9,93,7,2013-05-13 18:57:21,2013-04-30 21:55:40
437b174b16cb4939dc0af298e83ed738934be0e7...133b66c940229b39d0c69718c599d7ef6ae4c042,1,16,2,18,4,2013-05-13 18:57:34,2013-04-30 23:02:15
133b66c940229b39d0c69718c599d7ef6ae4c042...4ca5b0ebe75373318f61c85222b0543c276e0c65,2,210,12,222,5,2013-05-13 18:57:34,2013-05-01 00:27:42
4ca5b0ebe75373318f61c85222b0543c276e0c65...91f5d3c132e246a5bf203a345c924efac9eb249c,1,2,2,4,1,2013-05-13 18:57:47,2013-05-01 02:17:59
91f5d3c132e246a5bf203a345c924efac9eb249c...8ec4e07961be32cf2d8c4f80b4247efa2f7ccbbc,4,17,11,28,7,2013-05-13 18:57:47,2013-05-01 02:44:20
8ec4e07961be32cf2d8c4f80b4247efa2f7ccbbc...fcdd29adfdfea3a80f867a50f4a08f1e66112cfe,1,6,1,7,1,2013-05-13 18:57:47,2013-05-01 02:54:36
fcdd29adfdfea3a80f867a50f4a08f1e66112cfe...ab3c30f577bca60104b14b20ffeb8879b0a3b3d2,2,3,2,5,3,2013-05-13 18:57:48,2013-05-01 08:35:06
ab3c30f577bca60104b14b20ffeb8879b0a3b3d2...5d4a34dce68c33cfa8ce43d4fc8c9662a02a65b8,1,21,19,40,3,2013-05-13 18:57:48,2013-05-01 12:16:33
5d4a34dce68c33cfa8ce43d4fc8c9662a02a65b8...524daf43792893a4bd5aa735aa61f94c4889223c,1,3,2,5,2,2013-05-13 18:57:48,2013-05-01 12:17:03
524daf43792893a4bd5aa735aa61f94c4889223c...f479226cfac98439a6a1ec71c5bef4dfb0d5f82a,1,1,1,2,1,2013-05-13 18:57:48,2013-05-01 12:18:14
f479226cfac98439a6a1ec71c5bef4dfb0d5f82a...0f0901ec0718043d1ae543768e4906dd7d8b3f00,2,21,10,31,2,2013-05-13 18:58:43,2013-05-01 12:20:17
0f0901ec0718043d1ae543768e4906dd7d8b3f00...37e02c5e38a97f0f7f79df746e0eab5dfe4972d4,1,3,2,5,3,2013-05-13 18:58:43,2013-05-01 21:43:54
37e02c5e38a97f0f7f79df746e0eab5dfe4972d4...b9179fa2d3b35afb915668c8a344733c0435d497,1,11,2,13,1,2013-05-13 18:58:43,2013-05-01 21:52:34
b9179fa2d3b35afb915668c8a344733c0435d497...b51865acacdff8b7789c2899d2057b27c99945f4,2,42,10,52,7,2013-05-13 18:58:57,2013-05-01 23:05:31
b51865acacdff8b7789c2899d2057b27c99945f4...1383e3b5e0e47e2d7f7f8c5667b1fe3f8d0aa7f9,1,1,1,2,1,2013-05-13 18:58:57,2013-05-02 01:03:35
1383e3b5e0e47e2d7f7f8c5667b1fe3f8d0aa7f9...55201636478a785b290526046ce452fd08083639,1,11,7,18,4,2013-05-13 18:58:57,2013-05-02 01:03:59
55201636478a785b290526046ce452fd08083639...beeaac05b9629f0c8aaf61f2dd52b47da58cbc53,1,2,1,3,1,2013-05-13 18:58:57,2013-05-02 02:08:07
beeaac05b9629f0c8aaf61f2dd52b47da58cbc53...258f6f45023235f410c12bd70e3087c349359e49,1,1,1,2,1,2013-05-13 18:58:57,2013-05-02 02:09:40
258f6f45023235f410c12bd70e3087c349359e49...735aa6be2d1b434620def969c0e6154fdf72a705,3,14,6,20,8,2013-05-13 18:58:57,2013-05-03 20:45:12
735aa6be2d1b434620def969c0e6154fdf72a705...ae43e039f3e85e772439e09353d13a839e99aa2e,1,1,1,2,1,2013-05-13 18:58:57,2013-05-06 18:15:01
ae43e039f3e85e772439e09353d13a839e99aa2e...4a9c1444f9a2ecc29cf6597f462e14845754232d,1,2,2,4,2,2013-05-13 18:58:57,2013-05-06 21:33:53
4a9c1444f9a2ecc29cf6597f462e14845754232d...3aa28e54ab81f545b24c57d7b10b642a75486e2c,4,5,4,9,5,2013-05-13 18:58:57,2013-05-06 21:52:58
3aa28e54ab81f545b24c57d7b10b642a75486e2c...31bd79c54b3bdea9a213513cf6d81f8dc54939af,1,9,6,15,4,2013-05-13 18:58:57,2013-05-08 23:22:23
31bd79c54b3bdea9a213513cf6d81f8dc54939af...2d827e74fc2aa9b1aca4c87c9956f0d59d4a2bd1,21,505,530,1035,50,2013-05-13 18:58:58,2013-05-09 00:31:52
2d827e74fc2aa9b1aca4c87c9956f0d59d4a2bd1...5be28a3eaa51cb36c6a43405a66c31afad46e7f3,15,15,113,128,31,2013-05-13 19:03:56,2013-05-13 19:03:56
5be28a3eaa51cb36c6a43405a66c31afad46e7f3...d156f080af9fefce82252c0920f7acab15aa4315,3,16,13,29,9,2013-05-15 03:13:55,2013-05-15 03:13:55
d156f080af9fefce82252c0920f7acab15aa4315...fe16cc9f37c0a347849a7c35df88119b42f15d71,5,71,3,74,7,2013-05-15 03:26:41,2013-05-14 20:34:47
fe16cc9f37c0a347849a7c35df88119b42f15d71...627f346b955fb7b558d0dff4f677554d6336290f,11,311,74,385,25,2013-05-15 21:54:35,2013-05-15 21:53:41
627f346b955fb7b558d0dff4f677554d6336290f...2c91d596552fe3af7f1a0a1e832b849f9199b5c7,3,34,22,56,9,2013-05-15 22:58:57,2013-05-15 22:58:57
2c91d596552fe3af7f1a0a1e832b849f9199b5c7...e2940e343e020a520fc2fdd0ec26932596ee845c,1,25,12,37,5,2013-05-15 23:19:28,2013-05-15 23:19:28
e2940e343e020a520fc2fdd0ec26932596ee845c...fbaa8bf8450e824ae827d2a7187c9578ed22f9d5,3,9,4,13,5,2013-05-16 02:14:43,2013-05-16 01:47:23
fbaa8bf8450e824ae827d2a7187c9578ed22f9d5...9c63c1c05d499ded479f631759e13376cc223857,2,0,11,11,2,2013-05-16 02:14:43,2013-05-16 02:14:13
9c63c1c05d499ded479f631759e13376cc223857...f0875d1d259cbf6bed9872ae0a1d3909c535ad1b,3,7,21,28,4,2013-05-16 02:16:50,2013-05-16 02:16:06
f0875d1d259cbf6bed9872ae0a1d3909c535ad1b...d36a8f3c9157a23d1ee105b6fde7af03723b9a1d,1,1,3,4,1,2013-05-16 20:32:25,2013-05-16 20:32:25
d36a8f3c9157a23d1ee105b6fde7af03723b9a1d...cfa11f0035bd80dd170f1073a4f174a7814a138b,1,4,1,5,2,2013-05-16 20:32:35,2013-05-16 20:32:35
cfa11f0035bd80dd170f1073a4f174a7814a138b...e87412e7ee6996ca59afcbe295a3a137a19a03bd,2,2,7,9,4,2013-05-16 20:33:39,2013-05-16 19:13:11
e87412e7ee6996ca59afcbe295a3a137a19a03bd...d475b1f72f0e74f87fd39e026862b63cf4b3efc8,1,1,0,1,1,2013-05-17 16:47:00,2013-05-17 16:47:00
d475b1f72f0e74f87fd39e026862b63cf4b3efc8...957729c8cefced583fff43af0b7508ea1a5ef1d5,7,45,20,65,20,2013-05-18 01:19:20,2013-05-17 19:35:35
957729c8cefced583fff43af0b7508ea1a5ef1d5...9feabf41c21427b4b5f71da02f2742e1479c0a75,3,16,10,26,10,2013-05-18 05:43:56,2013-05-17 19:37:20
9feabf41c21427b4b5f71da02f2742e1479c0a75...067ac21371ee461dc110d1ba828a29c52604ae5a,6,327,0,327,6,2013-05-18 05:43:56,2013-05-17 17:15:08
067ac21371ee461dc110d1ba828a29c52604ae5a...372a16e6ce83176451146f980e737f15a60c531f,8,192,161,353,25,2013-05-18 05:43:56,2013-05-18 01:21:32
372a16e6ce83176451146f980e737f15a60c531f...07c5d2bb6559b262e81e20eecd88a00ee4837e4d,1,6,4,10,4,2013-05-18 05:43:56,2013-05-18 01:47:11
07c5d2bb6559b262e81e20eecd88a00ee4837e4d...75c0c43c4709ecb2d705a0fb55cd17c0e539877f,1,0,1,1,1,2013-05-18 05:43:56,2013-05-18 05:39:14
75c0c43c4709ecb2d705a0fb55cd17c0e539877f...d716da774669448746e784affaf3061350c5743e,2,30,23,53,7,2013-05-21 01:13:30,2013-05-21 01:13:30
d716da774669448746e784affaf3061350c5743e...b56d4fad2454921ceaebcdcbc9522e8ab35c2444,1,1,0,1,1,2013-05-21 03:22:37,2013-05-21 03:22:24
9d778f5f34cd156fbb3134a3a2ceb52a564b5ad5...777e36650d30f4faae62fc5c5a38d3b9ede80f23,5,14,11,25,11,2013-04-16 02:46:15,2013-04-15 23:30:36
777e36650d30f4faae62fc5c5a38d3b9ede80f23...ac1e62ac308632ea9e7f26bcb039dc45f1625340,5,5,5,10,5,2013-04-16 06:35:44,2013-04-16 06:35:44
ac1e62ac308632ea9e7f26bcb039dc45f1625340...835ced78d7f2f397dd38c0b6858677ed16e01e68,1,2,0,2,1,2013-04-16 06:38:30,2013-04-16 06:38:30
835ced78d7f2f397dd38c0b6858677ed16e01e68...1d8d1cdf8019cccffc0b05ef99d5032c69f6b4cc,2,4,3,7,3,2013-04-16 07:04:52,2013-04-16 07:04:52
1d8d1cdf8019cccffc0b05ef99d5032c69f6b4cc...922e348145a397888c422bd8daec6ad8104dc1ca,1,2,1,3,1,2013-04-16 19:42:44,2013-04-16 19:42:44
922e348145a397888c422bd8daec6ad8104dc1ca...f8c561140f69ea993fc460bedd5d11677b621c72,5,5,5,10,5,2013-04-16 19:51:51,2013-04-16 19:51:51
ee03cfc1f8538a0c4c68ea7cf6e6c84f44de809b...a9272a6cbf9e939dd4ff36b3c5af44d3aa97156b,8,111,72,183,20,2013-04-14 03:16:28,2013-04-14 03:12:58
a9272a6cbf9e939dd4ff36b3c5af44d3aa97156b...7c12ba95d941d6405357c11990322690b8e8ce87,1,3,0,3,1,2013-04-14 03:23:44,2013-04-14 03:23:44
7c12ba95d941d6405357c11990322690b8e8ce87...17246ff23d0f14bbcb3666eb06ffb8f56a85ce7c,1,4,1,5,1,2013-04-14 03:39:55,2013-04-14 03:39:55
17246ff23d0f14bbcb3666eb06ffb8f56a85ce7c...075e68c6c3794188a0a0ebca04093352dd4c9020,1,2,0,2,1,2013-04-14 03:47:13,2013-04-14 03:47:13
075e68c6c3794188a0a0ebca04093352dd4c9020...cbadead8c7fb6044893096928f2be795ee8f0ab2,1,8,2,10,2,2013-04-14 07:29:53,2013-04-14 07:29:53
cfacac8b7a0f24e3da727ff5186fd8eba9f1dd17...df5d2800aea87fe8420e67875c62143d2734f577,12,46,80,126,45,2013-03-21 21:09:40,2013-03-18 21:35:46
df5d2800aea87fe8420e67875c62143d2734f577...c61b7969fc4f1df3014bd0448bf41bbae2d496c5,1,37,37,74,16,2013-03-21 21:09:40,2013-03-21 01:44:31
c61b7969fc4f1df3014bd0448bf41bbae2d496c5...0fe094f530cef7178b4bc5576ab9ba1581ef4293,1,1,1,2,1,2013-03-21 21:09:40,2013-03-21 01:51:08
0fe094f530cef7178b4bc5576ab9ba1581ef4293...1a6686ac9db8efe7aca5d4c14a769a4085a10e3d,1,5,0,5,1,2013-03-21 21:09:40,2013-03-21 21:03:18
1a6686ac9db8efe7aca5d4c14a769a4085a10e3d...440ca35d39396d63e13e98ae17c14e8a39a3aaa0,1,140,140,280,20,2013-03-21 21:12:11,2013-03-21 21:12:11
12a123c4662d0ef1df8f4dbc379f801c4542f535...3fb2434d7155df8938106f656c17db8cb85dea87,5,112,10,122,10,2013-03-05 02:09:44,2013-02-20 20:12:21
3fb2434d7155df8938106f656c17db8cb85dea87...26430d117bd05a29aa5848d37950d655596172d5,6,65,41,106,18,2013-03-05 02:30:38,2013-03-05 02:30:38
baceda9d65f43f97e9ad0b491906a55302bd001f...a0678185531819ceeca3dae6d5d7f8702aaff4fb,3,49,6,55,8,2013-02-05 02:11:03,2013-02-03 07:11:26
a0678185531819ceeca3dae6d5d7f8702aaff4fb...cde1f010ae4bc236849819482d311cd944594112,1,0,1,1,1,2013-02-05 20:07:48,2013-02-05 02:19:31
cde1f010ae4bc236849819482d311cd944594112...02ae0734d0eaea53b0a74c55359f04350514f3f0,1,5187,1756,6943,355,2013-02-05 23:37:52,2013-02-05 23:37:52
02ae0734d0eaea53b0a74c55359f04350514f3f0...5177e0ba1f1d2b68370fb7c376cb3cb6dce21766,2,45,4,49,2,2013-02-06 00:12:24,2013-02-06 00:12:24
bb8e6ba94d185d86c758f8d63ecd8afc4473f8c7...5a3922b0c9db73abd5c532f831890081d60689d9,1,0,2,2,1,2013-02-13 21:12:16,2013-02-13 21:11:52
3c067d627682b280e1ec8a089e05721505e4814d...40bfd2e36086648aa248e72c25a990d8a6365b1e,5,79,39,118,14,2013-02-09 02:41:41,2013-02-09 02:41:41
40bfd2e36086648aa248e72c25a990d8a6365b1e...db535c93f31a4cd82ceecae16b54126aa5a94272,3,34,13,47,5,2013-02-12 04:11:05,2013-02-12 04:11:05
db535c93f31a4cd82ceecae16b54126aa5a94272...00213077088c3a0000f9b2075c26be79d5ea9981,1,103,66,169,10,2013-02-12 19:40:43,2013-02-12 05:03:24
00213077088c3a0000f9b2075c26be79d5ea9981...77ac4163742679434a36be4132971077a4c8af0a,4,12,27,39,8,2013-02-13 01:18:09,2013-02-13 01:18:09
77ac4163742679434a36be4132971077a4c8af0a...14c0228361a829aa51b38dd7aec06d2e79a740fc,3,19,18,37,16,2013-02-13 01:40:03,2013-02-13 01:40:03
321581dc8ae903f7e1c4cded2e1870195114cd5e...79405a495d4acaffc56042f8f7e15b5b34b6171f,1,15,8,23,6,2012-12-27 01:50:15,2012-12-14 21:41:06
79405a495d4acaffc56042f8f7e15b5b34b6171f...1e09d4ee8d29b2f2dc53a29c723bbc94dab3038b,1,2,1,3,2,2012-12-27 02:06:39,2012-12-27 02:06:39
321581dc8ae903f7e1c4cded2e1870195114cd5e...cf4190e9c0edf692fb2b0cd16ffeb6e36351c42b,9,14,10,24,9,2012-12-23 20:36:05,2012-12-23 20:36:05
cf4190e9c0edf692fb2b0cd16ffeb6e36351c42b...41520a3df86d47b6bbc581dba0abb37c931bf80d,1,52,0,52,2,2012-12-24 19:06:49,2012-12-24 19:06:49
41520a3df86d47b6bbc581dba0abb37c931bf80d...32870ea93307e4bd10b6d54755f111f525ce34d9,1,12,2,14,5,2012-12-24 19:12:26,2012-11-13 23:31:19
32870ea93307e4bd10b6d54755f111f525ce34d9...06ddf733998f98dfb82a3cbdf69e0773e69e41ce,1,31,14,45,8,2012-12-24 19:29:03,2012-12-24 19:29:03
06ddf733998f98dfb82a3cbdf69e0773e69e41ce...47d5abb7d8a654879c6d47158568f47e1b1b9e80,1,1,3,4,2,2012-12-24 19:31:33,2012-12-24 19:31:33
47d5abb7d8a654879c6d47158568f47e1b1b9e80...64253bc47044ed776639ae044772c0841a7bf483,1,1,1,2,1,2012-12-27 07:30:26,2012-12-27 07:30:26
64253bc47044ed776639ae044772c0841a7bf483...26c7258027811228240797cea40df0e5cedc4460,3,30,3,33,8,2012-12-27 08:06:42,2012-12-27 07:36:19
26c7258027811228240797cea40df0e5cedc4460...d5e65dc2ce4e744caa77a675b69c22577f09d30e,1,36,0,36,1,2012-12-27 21:24:32,2012-12-27 21:24:32
ddb6262d97a52b488f09b3164fb255a18880e68d...86b978b0f371b2ca32a395f6f4c24bd3317566ea,2,8,4,12,3,2013-10-12 17:35:33,2013-10-12 17:35:33
995ccae9678ac6dd38e93292cf5c3afd291ee39b...287d43bd994e7f30cf8d8829c04e85aa5b85d0e7,1,56,1,57,2,2013-10-11 17:01:29,2013-10-11 17:01:29
287d43bd994e7f30cf8d8829c04e85aa5b85d0e7...135de89282e0d96230de18f1039b6964dbd199f8,1,18,75,93,6,2013-10-11 20:09:27,2013-10-11 20:09:27
135de89282e0d96230de18f1039b6964dbd199f8...085b9bb0e583c0599f1339e6fb44a427bdbc90a2,1,1,15,16,2,2013-10-11 20:11:22,2013-10-11 20:11:22
ba34b2550bf4b73bb13e0ef79367ed18c79833c4...afa8afd9a993c742be6bf38f23bb0e7858eea8fb,3,58,6,64,14,2013-09-11 20:44:12,2013-08-22 05:16:41
afa8afd9a993c742be6bf38f23bb0e7858eea8fb...7dfff264a325d96b861608588fbc40b9d2f2101a,3,44,0,44,7,2013-09-11 20:44:12,2013-08-22 05:50:55
7dfff264a325d96b861608588fbc40b9d2f2101a...3403b31c425802d21392755cece6dcbbacb01f96,3,33,9,42,7,2013-09-11 20:44:12,2013-08-23 05:36:34
3403b31c425802d21392755cece6dcbbacb01f96...12c0d8ef5e3ab64908d52c8fe32f48f1e96133d5,3,6,4,10,3,2013-09-11 20:44:12,2013-08-24 00:46:03
12c0d8ef5e3ab64908d52c8fe32f48f1e96133d5...4b7f052ce06e9fac45ca23c14642fd9d925d6619,1,13,7,20,5,2013-09-11 20:44:13,2013-08-24 01:05:23
4b7f052ce06e9fac45ca23c14642fd9d925d6619...1887d6960b14b90e4f0b47c8b332f3d050c67444,1,38,0,38,3,2013-09-11 20:44:13,2013-08-29 19:25:56
1887d6960b14b90e4f0b47c8b332f3d050c67444...d39726d737f5c4583c88005fc5f6e7189ad8e756,2,14,6,20,7,2013-09-11 20:44:13,2013-08-29 20:23:17
d39726d737f5c4583c88005fc5f6e7189ad8e756...d84334a34b154f391a158f9709adda63c0f2fe5b,5,67,14,81,22,2013-09-11 20:44:13,2013-08-29 22:44:59
d84334a34b154f391a158f9709adda63c0f2fe5b...2ebdeb0d957a6e5b1b150061d7c83fd2ac682aab,3,22,11,33,9,2013-09-11 20:44:13,2013-08-29 23:08:53
2ebdeb0d957a6e5b1b150061d7c83fd2ac682aab...8621c18bc1f47723e40826322bb327ae2ae3aba2,7,97,33,130,22,2013-09-11 20:44:13,2013-08-30 01:46:58
8621c18bc1f47723e40826322bb327ae2ae3aba2...10d49451d949919437dcccbfe4db5a81ccb27a49,3,58,13,71,11,2013-09-11 20:44:13,2013-08-31 01:06:49
10d49451d949919437dcccbfe4db5a81ccb27a49...e84f0adb7886d45d68cb4f195d967d4596ffdc75,4,75,21,96,14,2013-09-11 20:44:13,2013-08-31 01:09:02
e84f0adb7886d45d68cb4f195d967d4596ffdc75...21dd57c95dfd61eb9e2539ebdae08e86f393012f,2,9,5,14,4,2013-09-11 20:44:13,2013-09-03 02:04:01
21dd57c95dfd61eb9e2539ebdae08e86f393012f...09ba59c50b49e97f7d2d03097ec1277ba3b6d7a9,1,21,0,21,1,2013-09-11 20:44:13,2013-09-03 02:05:00
09ba59c50b49e97f7d2d03097ec1277ba3b6d7a9...dab6df0eb919d279617f047787e90ed729845a84,9,148,149,297,47,2013-09-11 20:44:13,2013-09-04 03:41:55
dab6df0eb919d279617f047787e90ed729845a84...4ebdbd9f77f5870441a72bb7c2c0b57f8897712c,1,3,2,5,3,2013-09-11 20:44:13,2013-09-04 17:43:47
4ebdbd9f77f5870441a72bb7c2c0b57f8897712c...d9093d6cf8933f26c47260968cb2846af78fe646,1,20,1,21,2,2013-09-11 20:44:14,2013-09-04 17:53:46
d9093d6cf8933f26c47260968cb2846af78fe646...0bc4bc9c26299085b0b5521dd1a1b7b1d67cad51,7,98,122,220,48,2013-09-11 20:44:27,2013-09-06 00:11:27
7b35442e9275792e6d9f2beacf4293d69c5091b6...0a9d59ed9917af0d31d1506641ad143823914cd1,2,2,2,4,2,2013-08-15 19:20:29,2013-08-15 19:20:29
d5da9341c1fa0b5d85b4ddac96a650321cde3783...1879d14df4491da9ea626581a870c2767d62df6f,3,21,16,37,10,2013-09-13 19:27:58,2013-09-13 19:27:58
1879d14df4491da9ea626581a870c2767d62df6f...61b86dbb436bd0a925cac5f15108511bcdaecd7e,1,4,1,5,1,2013-09-16 22:12:33,2013-09-16 22:12:33
61b86dbb436bd0a925cac5f15108511bcdaecd7e...3f176e2604186578eeddcda15332aa973f5df07a,7,37,45,82,15,2013-09-17 01:02:09,2013-09-17 01:02:09
3f176e2604186578eeddcda15332aa973f5df07a...6d09d6c0263c0b3434fce20d28e3a97df658c0b5,3,55,7,62,10,2013-09-17 03:37:50,2013-09-17 03:37:50
6d09d6c0263c0b3434fce20d28e3a97df658c0b5...4add01f9343f0eb91de0c0e16b40f1d3ad1610eb,6,102,41,143,24,2013-09-17 21:25:01,2013-09-17 21:25:01
4add01f9343f0eb91de0c0e16b40f1d3ad1610eb...0bf617ed47ff88bbd03623fdeea87ed4d81fc34b,2,10,1,11,3,2013-09-17 21:32:03,2013-09-17 21:32:03
0bf617ed47ff88bbd03623fdeea87ed4d81fc34b...4658b70d7eeed8161c2ad4a90a219a774d13a10b,2,20,0,20,3,2013-09-17 22:16:03,2013-09-17 22:16:03
4658b70d7eeed8161c2ad4a90a219a774d13a10b...af0aad1d45f8b72b416d56b19a2495c1ca95c0f7,5,56,6,62,10,2013-09-17 22:52:39,2013-09-17 22:52:39
af0aad1d45f8b72b416d56b19a2495c1ca95c0f7...c05201b83beee9c082b4df7218b1035c580036e8,1,8,0,8,1,2013-09-18 17:33:30,2013-09-18 17:33:30
c05201b83beee9c082b4df7218b1035c580036e8...665cfb269d7af46672d2355e76c28ce5fc13649d,1,1,1,2,1,2013-09-18 17:34:17,2013-09-18 17:34:17
665cfb269d7af46672d2355e76c28ce5fc13649d...01fd48cb884ca5c9c59136ffae4358f49680a34f,1,14,7,21,1,2013-09-18 20:51:04,2013-09-18 20:51:04
01fd48cb884ca5c9c59136ffae4358f49680a34f...4b690eb27145d5b47303a19651ca8e8ba6108510,1,5,4,9,3,2013-09-18 20:55:23,2013-09-18 20:55:23
4b690eb27145d5b47303a19651ca8e8ba6108510...e60da7acc1215766d35aa3517f400cc8f5301308,3,21,7,28,7,2013-09-18 22:49:03,2013-09-18 22:47:36
e60da7acc1215766d35aa3517f400cc8f5301308...b8159f852fef17406d2e6d7c2d685ba10dc579e1,2,6,6,12,2,2013-09-18 22:53:22,2013-09-18 22:53:22
b8159f852fef17406d2e6d7c2d685ba10dc579e1...13ee1dd825797578c6519b67a02738c132f3fe60,5,23,39,62,12,2013-09-18 23:09:58,2013-09-18 23:06:57
13ee1dd825797578c6519b67a02738c132f3fe60...e5b30daf8c885701c22b589446327b41cc6d074b,1,29,0,29,5,2013-09-19 01:15:03,2013-09-19 01:15:03
e5b30daf8c885701c22b589446327b41cc6d074b...3616a96053cb5624c4d2c654d7db928beaa30f01,1,0,2,2,1,2013-09-19 02:05:22,2013-09-19 02:05:22
3616a96053cb5624c4d2c654d7db928beaa30f01...bb0332ffac6fda8fd59ee88679235ea20a1c44e0,1,13,13,26,2,2013-09-19 02:22:13,2013-09-19 02:22:13
bb0332ffac6fda8fd59ee88679235ea20a1c44e0...4b30756de9be8def098c43fcc7b5598e37a1b9ba,1,8,7,15,5,2013-09-19 02:22:26,2013-09-19 02:22:18
4b30756de9be8def098c43fcc7b5598e37a1b9ba...b0a9278566c207f41c8ded8a2b454d7bfb0bbca2,1,2,1,3,1,2013-09-19 02:46:16,2013-09-19 02:46:16
a7a2cb49158b3cbc96dc46eb9b485ee398e43ff3...7994ccc1a85d2a5bd6e1519cd7feb2740a47b6bb,2,17,6,23,7,2013-11-01 01:08:56,2013-10-21 23:03:58
7994ccc1a85d2a5bd6e1519cd7feb2740a47b6bb...62374002aa621f895b99d20d207b31d224bbb65f,2,36,16,52,10,2013-11-01 01:08:56,2013-10-21 23:37:50
62374002aa621f895b99d20d207b31d224bbb65f...6a6ce2b751a94744cd94f64a3ec7376374d053ed,3,68,53,121,9,2013-11-01 16:57:41,2013-10-23 22:37:17
6e86bb40962150e3ca347c04a01dffddc8312a89...e471549677e2c5a7afd18b951a1fa9085d44a78b,1,284,346,630,42,2013-07-24 09:11:33,2013-07-24 09:11:33
e471549677e2c5a7afd18b951a1fa9085d44a78b...1ee45c4318d7cd5ea1820fa027f8ec842a75bf6c,1,2,0,2,1,2013-07-24 20:24:35,2013-07-24 20:24:35
1ee45c4318d7cd5ea1820fa027f8ec842a75bf6c...b68ce6604815a1f8a4b39d53cf299d43619f3212,1,11,1,12,1,2013-07-25 03:09:31,2013-07-25 03:09:31
b68ce6604815a1f8a4b39d53cf299d43619f3212...d1c481f71495b302e58c33bb24fb26903bbb18f2,1,23,0,23,1,2013-07-25 23:29:14,2013-07-25 23:29:10
6e86bb40962150e3ca347c04a01dffddc8312a89...1eb06d72c9bc2a80079ea6a9351f377f90222314,3,21,1,22,3,2013-07-24 06:14:57,2013-06-11 00:10:29
1eb06d72c9bc2a80079ea6a9351f377f90222314...a1859becb038b1c8ed767966a2d74faa460d9397,1,3,1,4,1,2013-07-24 06:14:59,2013-06-11 22:38:35
a1859becb038b1c8ed767966a2d74faa460d9397...1173696cb7af5892bfbf66ce5ecc764ce9a3aa94,1,20,0,20,1,2013-07-24 06:14:59,2013-06-12 21:43:38
1173696cb7af5892bfbf66ce5ecc764ce9a3aa94...e08ffc938fda52b1cbe441a0f9629de73b879aaa,1,1,1,2,1,2013-07-24 06:15:00,2013-06-13 20:10:25
e08ffc938fda52b1cbe441a0f9629de73b879aaa...115e146da5a4d4f6413df3cb8ea3a8fe5904610f,1,46,12,58,7,2013-07-24 06:15:00,2013-06-13 20:10:53
115e146da5a4d4f6413df3cb8ea3a8fe5904610f...d87acaefd739baee1f2b141275333e5da60970cb,3,15,2,17,5,2013-07-25 03:58:15,2013-07-24 16:32:45
d87acaefd739baee1f2b141275333e5da60970cb...ae57b2da8145b87a04fd707d4c7e1967649d6b97,2,12,1,13,2,2013-07-25 04:35:04,2013-07-25 04:35:04
ae57b2da8145b87a04fd707d4c7e1967649d6b97...a0e66e59c9b3f4d9c981bd00c8b838b39ab101bb,1,4,0,4,1,2013-07-25 04:37:57,2013-07-25 04:37:30
a0e66e59c9b3f4d9c981bd00c8b838b39ab101bb...fd8f2aa2a875e36285a297ee66183e720d947327,1,2,2,4,2,2013-07-25 22:49:47,2013-07-25 22:49:47
fd8f2aa2a875e36285a297ee66183e720d947327...2ceb6169ad4488b4620c1e2e28e25f52ca152204,1,11,1,12,3,2013-07-25 22:57:38,2013-07-25 22:57:38
2ceb6169ad4488b4620c1e2e28e25f52ca152204...7f0c471ed5c9809ac8b03fbe6f5c5d6be16dc552,4,20,33,53,10,2013-07-25 23:09:17,2013-07-25 23:09:17
49e98134fda0f81948cb71b6081ac4c417713f99...edaabfec29ff3b98c84f5853646c1dd21813d009,1,2,0,2,1,2013-06-25 22:24:25,2013-06-25 22:24:25
edaabfec29ff3b98c84f5853646c1dd21813d009...76ab959951fe6e52774e893c56f017f8d73c002d,2,11,3,14,4,2013-07-02 01:49:40,2013-07-02 01:48:09
16b20f401872522cbf336b68239516d209b82746...e66ad0a18245a9cd2f84f5dcd47dcb3e6b1fbe80,3,5,3,8,3,2013-06-19 19:22:39,2013-06-19 19:22:39
e66ad0a18245a9cd2f84f5dcd47dcb3e6b1fbe80...a38f19ad0538a81ad9ec59230656285a529f4a20,1,45,23,68,5,2013-06-19 19:33:01,2013-06-18 17:47:44
a38f19ad0538a81ad9ec59230656285a529f4a20...a4d9f295fe89ab3c06f1a3306dc9e71ff9506c1c,2,2,2,4,2,2013-06-20 06:14:58,2013-06-20 06:14:47
a4d9f295fe89ab3c06f1a3306dc9e71ff9506c1c...d40ff521ef5b592fca1d48220bc1d18bbeaa9491,6,109,24,133,23,2013-06-20 06:14:58,2013-06-20 06:14:03
d40ff521ef5b592fca1d48220bc1d18bbeaa9491...18ce0c63e9e53302eb8be53e480044983d74a73f,1,8,1,9,2,2013-06-20 15:50:35,2013-06-20 15:50:35
18ce0c63e9e53302eb8be53e480044983d74a73f...40078b8bee28a300ba895dfc220180f0b76b691b,5,7,3,10,5,2013-06-20 17:27:21,2013-06-20 17:27:21
40078b8bee28a300ba895dfc220180f0b76b691b...974bc116bec858f8b7bcd85f259b43d2d2e02bd2,3,88,84,172,14,2013-06-20 18:06:33,2013-06-20 17:52:34
974bc116bec858f8b7bcd85f259b43d2d2e02bd2...9bce443701199d5ae75346823bb39a26dbf688b8,1,12,4,16,1,2013-06-20 18:06:33,2013-06-20 18:01:43
9bce443701199d5ae75346823bb39a26dbf688b8...99f4ab7ebd4818cacdc0a3b40ee2a4113a100bf8,2,1,1,2,2,2013-06-20 18:09:35,2013-06-20 18:09:35
99f4ab7ebd4818cacdc0a3b40ee2a4113a100bf8...210f5f8539587307416a9e7fc1e7b6417bb2b612,1,3,0,3,2,2013-06-20 18:41:50,2013-06-20 18:39:28
210f5f8539587307416a9e7fc1e7b6417bb2b612...f6184261e12789dd2d4448c9592e0863775e7c4b,1,1,1,2,1,2013-06-23 05:04:48,2013-06-23 05:04:48
f6184261e12789dd2d4448c9592e0863775e7c4b...cebf6924bba4f3bb52555e72f68c346194ce2d15,9,18,3,21,11,2013-06-25 16:53:42,2013-06-25 16:53:42
cebf6924bba4f3bb52555e72f68c346194ce2d15...f04df9262ebac55f104b253a6cff03b868b025d8,1,2,2,4,2,2013-06-25 16:55:23,2013-06-25 16:55:23
790deed8b4110180ddd1ac1eab24f5fae80c7141...3c3461b75a00c3758c295beefa9b35bf839847bf,6,3980,0,3980,6,2013-06-17 21:01:48,2013-04-16 21:13:12
3c3461b75a00c3758c295beefa9b35bf839847bf...05cab0d66283437e4aae299ccb418733747a2981,3,3851,3852,7703,31,2013-06-17 21:01:48,2013-04-16 21:14:03
05cab0d66283437e4aae299ccb418733747a2981...325a3ac24ac08daacdc9cfdfc338e65372fa8034,3,4,4,8,3,2013-06-17 21:01:49,2013-04-16 21:14:34
325a3ac24ac08daacdc9cfdfc338e65372fa8034...a1b25894b8200f23dcfce068a9141620edbc4caa,2,97,1,98,2,2013-06-17 21:01:49,2013-04-16 21:14:58
a1b25894b8200f23dcfce068a9141620edbc4caa...bff87544d92acf11b256a3b19350183d37c61a3e,4,113,96,209,7,2013-06-17 21:01:49,2013-04-16 21:15:23
bff87544d92acf11b256a3b19350183d37c61a3e...27a76d66b2c664bce5ca4c9f175535cf68379def,1,19,13,32,15,2013-06-17 21:01:49,2013-04-16 21:15:49
27a76d66b2c664bce5ca4c9f175535cf68379def...f345e2da921ab92debee8ae9da84a908e2d4b0a5,6,37,11,48,11,2013-06-17 21:01:49,2013-04-16 21:16:28
f345e2da921ab92debee8ae9da84a908e2d4b0a5...8698ea5d360e027a736962c14dad78daff4db336,1,18,14,32,2,2013-06-17 21:01:49,2013-04-16 21:16:49
8698ea5d360e027a736962c14dad78daff4db336...25bddd9a23dda6b309804e052232b09637250f42,3,3,3,6,2,2013-06-17 21:01:49,2013-04-16 21:18:07
25bddd9a23dda6b309804e052232b09637250f42...52fda4960292423e4891cedd15e98298113fb47f,1,1,0,1,1,2013-06-17 21:01:49,2013-04-17 02:10:12
52fda4960292423e4891cedd15e98298113fb47f...f32e3cd87d35923d8961bf70d1dbf392ebf23b18,1,32,4,36,1,2013-06-17 21:01:49,2013-04-17 02:21:00
f32e3cd87d35923d8961bf70d1dbf392ebf23b18...2894a30eda1933a63dfe5d7c4595dd981e905da6,3,357,0,357,3,2013-06-17 21:01:49,2013-04-17 21:56:58
2894a30eda1933a63dfe5d7c4595dd981e905da6...40ede2204ea5a1ccfc9b1b86a249c4df98054a42,2,317,1,318,7,2013-06-17 21:01:49,2013-04-18 01:18:23
40ede2204ea5a1ccfc9b1b86a249c4df98054a42...a7878a9ba60c9c66d8c0f71e4fe497c0b393d855,2,100,65,165,33,2013-06-17 21:01:49,2013-04-18 02:21:18
a7878a9ba60c9c66d8c0f71e4fe497c0b393d855...3a504091d56ac2fa447495725f875d1a431268a3,1,1,0,1,1,2013-06-17 21:01:49,2013-04-18 02:44:55
3a504091d56ac2fa447495725f875d1a431268a3...dca027c7facbc40054c3bcb5e2e67c77c3fe1b65,1,2,2,4,2,2013-06-17 21:01:50,2013-04-18 18:24:46
dca027c7facbc40054c3bcb5e2e67c77c3fe1b65...350d0f5cfeb1a2c633682bcd6df20737ef4c77b4,8,756,0,756,8,2013-06-17 21:01:50,2013-04-18 18:48:34
350d0f5cfeb1a2c633682bcd6df20737ef4c77b4...f1a0fcd12c65795151d558eb43b46687fea29674,4,42,12,54,12,2013-06-17 21:01:50,2013-04-18 22:31:25
f1a0fcd12c65795151d558eb43b46687fea29674...9eced0a9507166b3c711bd58b6a64c7d9f27d315,2,140,1,141,2,2013-06-17 21:01:50,2013-04-23 03:39:33
9eced0a9507166b3c711bd58b6a64c7d9f27d315...949e277d8f3d11010adc94c9b5d07a4275b3fc28,1,8,1,9,2,2013-06-17 21:01:50,2013-04-27 00:37:06
949e277d8f3d11010adc94c9b5d07a4275b3fc28...cc3e06292e86df9f422b03b2cf2e23c29adf68ab,1,25,4,29,3,2013-06-17 21:01:50,2013-04-27 15:22:25
cc3e06292e86df9f422b03b2cf2e23c29adf68ab...dde555a7b8b44ad98866397bc3767d53d36cb902,2,35,27,62,11,2013-06-17 21:01:50,2013-05-13 17:22:40
dde555a7b8b44ad98866397bc3767d53d36cb902...d58e70610e768c21d36ef4f01eb3454a544d8ecf,2,30,39,69,10,2013-06-17 21:01:50,2013-05-13 18:53:28
d58e70610e768c21d36ef4f01eb3454a544d8ecf...e4c6eb7e79206411dbf0425cce4ddfc1d121b01b,2,44,13,57,11,2013-06-17 21:01:50,2013-05-13 21:46:02
e4c6eb7e79206411dbf0425cce4ddfc1d121b01b...e05ae7b7f8c3d538946f372edf1d26c4ee1f187a,1,196,0,196,2,2013-06-17 21:01:50,2013-05-17 17:06:42
e05ae7b7f8c3d538946f372edf1d26c4ee1f187a...4c1c9979c17ab5c29e362e695929aa557512733d,5,298,61,359,41,2013-06-17 21:01:50,2013-05-20 06:38:56
4c1c9979c17ab5c29e362e695929aa557512733d...35e75f38f443a992332320b1136bb4468090557b,3,200,86,286,42,2013-06-17 21:01:50,2013-05-20 17:10:14
35e75f38f443a992332320b1136bb4468090557b...e35df7d2a92a8e42ce4abd9c042a0d8ff0f09b2e,2,127,39,166,28,2013-06-17 21:01:51,2013-05-21 21:13:59
e35df7d2a92a8e42ce4abd9c042a0d8ff0f09b2e...497ce9f71f99c1e9026b859fde38be38b4710f96,2,4,3,7,3,2013-06-17 21:01:51,2013-05-21 21:22:03
497ce9f71f99c1e9026b859fde38be38b4710f96...a0468350eedaba3bfddfb8984237a1d6c49252bd,2,1,336,337,4,2013-06-17 21:01:51,2013-05-21 21:27:15
a0468350eedaba3bfddfb8984237a1d6c49252bd...d370dbaf76a0db836681f9a006c207af654b970f,1,5,0,5,3,2013-06-17 21:01:51,2013-05-28 00:55:29
d370dbaf76a0db836681f9a006c207af654b970f...762841cf0e4739f32da1c0525f3483eec5d38f0f,3,82,34,116,18,2013-06-17 21:01:51,2013-05-28 02:06:39
762841cf0e4739f32da1c0525f3483eec5d38f0f...19568674bd7738dafd07758877476d2fa35d42e0,1,2,1,3,1,2013-06-17 21:01:51,2013-05-28 03:17:43
19568674bd7738dafd07758877476d2fa35d42e0...31bc8c55a4f6a19e04fa990f21d0ec31782de287,1,14,12,26,10,2013-06-17 21:01:51,2013-05-28 03:18:00
31bc8c55a4f6a19e04fa990f21d0ec31782de287...e873e636fef3404d37530543a85ebd620becf1ba,1,37,27,64,16,2013-06-17 21:01:51,2013-05-28 17:29:15
e873e636fef3404d37530543a85ebd620becf1ba...9494860d824417727f843f5041cc46bd6cbd2b83,1,1,1,2,1,2013-06-17 21:01:51,2013-05-29 00:16:04
9494860d824417727f843f5041cc46bd6cbd2b83...c27ecae3aa587ca31b88883ef1d42d857f7f7ddb,2,57,15,72,18,2013-06-17 21:01:51,2013-06-10 20:30:42
c27ecae3aa587ca31b88883ef1d42d857f7f7ddb...e28f7f1646ea4afe5ccdb5ab2e6f623f33bc9ca6,2,64,100,164,24,2013-06-17 21:01:51,2013-06-10 21:30:23
e28f7f1646ea4afe5ccdb5ab2e6f623f33bc9ca6...a23522b22591074d609ce3945b3d3df0875ee67d,1,7,9,16,5,2013-06-17 21:01:51,2013-06-11 00:12:12
a23522b22591074d609ce3945b3d3df0875ee67d...25dafeb38f889602e989e44d4d5d9bb09483ceb5,2,93,13,106,10,2013-06-17 21:01:51,2013-06-11 03:55:41
25dafeb38f889602e989e44d4d5d9bb09483ceb5...5c975735dbe28d156fce8b8f903fae32b4a75fc9,2,301,51,352,17,2013-06-17 21:01:52,2013-06-11 22:15:16
5c975735dbe28d156fce8b8f903fae32b4a75fc9...c21fffe72a838fd71bb40d02c1df4c4762ef6782,2,82,9,91,9,2013-06-17 21:01:52,2013-06-12 17:04:10
c21fffe72a838fd71bb40d02c1df4c4762ef6782...febd7589819418e72d52e462f180b9883a32d578,1,1,1,2,1,2013-06-17 21:01:52,2013-06-12 17:07:44
febd7589819418e72d52e462f180b9883a32d578...1e102fdcbd146b80d57c31f5d9248f161d902893,1,25,1,26,1,2013-06-17 21:01:52,2013-06-12 17:14:25
1e102fdcbd146b80d57c31f5d9248f161d902893...a6e1619f2650af5053898d1213078ea42caa3074,2,64,23,87,16,2013-06-17 21:01:52,2013-06-12 20:39:54
a6e1619f2650af5053898d1213078ea42caa3074...3df9d66bb58e7c67b177bd3a6cb71f9f61b37da8,10,17,2,19,14,2013-06-17 21:01:52,2013-06-12 21:27:21
3df9d66bb58e7c67b177bd3a6cb71f9f61b37da8...6ef51852c37fc6ba2d1e8ef6cc889b019be09e5c,1,30,0,30,3,2013-06-17 21:01:52,2013-06-12 22:57:13
6ef51852c37fc6ba2d1e8ef6cc889b019be09e5c...8a31d50a2879cbbac9244af831f3464ce5bb065d,1,22,0,22,1,2013-06-17 21:01:52,2013-06-12 23:50:50
8a31d50a2879cbbac9244af831f3464ce5bb065d...1a9a5df8376e9b539c85bdc03c5c43b57be1cb31,3,53,30,83,14,2013-06-17 21:01:52,2013-06-13 22:53:47
1a9a5df8376e9b539c85bdc03c5c43b57be1cb31...eb040cdff50554117851145b800aaaa969cb237b,1,48,0,48,1,2013-06-17 21:01:52,2013-06-17 18:03:27
eb040cdff50554117851145b800aaaa969cb237b...cd8bf66822969c2c52370b83c901e5d33eff04be,1,7,0,7,1,2013-06-17 21:01:52,2013-06-17 18:03:49
cd8bf66822969c2c52370b83c901e5d33eff04be...7eefb313ef70d1bb6dc1045a40f3889e58ef2249,2,36,9,45,4,2013-06-17 21:01:52,2013-06-17 18:14:48
7eefb313ef70d1bb6dc1045a40f3889e58ef2249...23ff6fbe0662377af16e1a69ef74138be3919f68,2,84,11,95,8,2013-06-17 21:01:53,2013-06-17 19:05:12
23ff6fbe0662377af16e1a69ef74138be3919f68...630b3b8213739efc4c001207268f7e52409ac29d,1,0,68,68,1,2013-06-17 21:01:53,2013-06-17 19:18:01
630b3b8213739efc4c001207268f7e52409ac29d...cbfd6e5f61f417c0d6e7d68b8838aa615d210f5c,2,6,2,8,3,2013-06-17 21:01:53,2013-06-17 19:37:16
cbfd6e5f61f417c0d6e7d68b8838aa615d210f5c...efa83a516755b2983fff23782ae7c169b6e4e7ba,2,46,13,59,7,2013-06-17 21:01:53,2013-06-17 20:10:35
efa83a516755b2983fff23782ae7c169b6e4e7ba...8d92d53bf8bcc4850cbb18c193201a3027f5211e,2,89,15,104,13,2013-06-17 21:01:53,2013-06-17 20:46:08
8d92d53bf8bcc4850cbb18c193201a3027f5211e...e0816b5f34c401e01260377c997b720f9d6ee9c3,2,8,8,16,8,2013-06-17 21:01:53,2013-06-17 21:00:27
e0816b5f34c401e01260377c997b720f9d6ee9c3...db36afc1a4ef43da8576e74736c86c587a443be1,6,245,199,444,16,2013-06-17 21:49:51,2013-06-17 21:49:51
db36afc1a4ef43da8576e74736c86c587a443be1...8ffffaaeae624d2ee57d1b5b5500cea4f3cc5eda,2,3,1,4,2,2013-06-17 21:58:35,2013-06-17 21:58:35
8ffffaaeae624d2ee57d1b5b5500cea4f3cc5eda...3d8bcef5ac03b8d33fc5ce44719a95c9a03add7c,3,48,8,56,15,2013-06-17 23:35:23,2013-06-17 23:35:23
3d8bcef5ac03b8d33fc5ce44719a95c9a03add7c...de5b3b7b1ff07ed786341a265fe470942d142be5,1,0,190,190,2,2013-06-18 00:13:27,2013-06-18 00:13:27
de5b3b7b1ff07ed786341a265fe470942d142be5...49d5d8feab482e2f516acc410a736c2aa4825aa0,1,19,0,19,5,2013-06-18 00:17:31,2013-06-18 00:17:31
790deed8b4110180ddd1ac1eab24f5fae80c7141...422edbd4d91a88ce968386e1e0f7890064e94b94,1,1,1,2,1,2013-06-17 18:29:40,2013-06-17 18:29:40
422edbd4d91a88ce968386e1e0f7890064e94b94...4664722b71cbd5b362f48d33295e2e8e944f9133,1,22,12,34,4,2013-06-17 18:29:55,2013-06-17 18:29:55
4664722b71cbd5b362f48d33295e2e8e944f9133...4c88ed45f73449f84090a4aba1dfaaa1a129babc,2,3,5,8,3,2013-06-17 18:37:26,2013-06-17 18:37:26
4c88ed45f73449f84090a4aba1dfaaa1a129babc...fefd11493f67a805bfecc607a213174d4592849b,1,2,0,2,1,2013-06-17 18:48:28,2013-06-17 18:48:28
fefd11493f67a805bfecc607a213174d4592849b...7406c73b2ae7ade64eefbf044cd2879b945519d2,1,1,0,1,1,2013-06-17 21:26:21,2013-06-17 21:26:21
7406c73b2ae7ade64eefbf044cd2879b945519d2...a8910ffbf1281976439af64ca57a5674a3c093b3,1,7,1,8,1,2013-06-17 22:25:18,2013-06-17 18:54:22
1f78662c260e5be76bf45fbffb1d0e8b86049988...65a8832649cd4e49446f8c1b3492d38a142c135a,1,5,0,5,1,2013-05-23 05:41:08,2013-05-14 21:32:32
65a8832649cd4e49446f8c1b3492d38a142c135a...7aebc95f50868b570a4dc9d891c6d4c2106e1197,1,5,4,9,1,2013-05-23 05:42:00,2013-05-23 05:42:00
a14b278a29ab009c97c36bd34b2897429569ed9a...f89fc9e979104eb6c8f252c17da5fbd06f7d6109,5,41,11,52,20,2013-05-15 04:47:31,2013-05-15 04:42:16
b56d4fad2454921ceaebcdcbc9522e8ab35c2444...55fbfcb6f3e8194c61f77496c4e843fed952a3c7,1,1,1,2,1,2013-05-21 20:55:39,2013-05-21 20:55:39
55fbfcb6f3e8194c61f77496c4e843fed952a3c7...c9d71aa38fc0631f3ce49017200bd38d3bc2e5d1,1,8,0,8,1,2013-05-21 21:32:06,2013-05-21 21:30:41
c9d71aa38fc0631f3ce49017200bd38d3bc2e5d1...a959c011a8a2697702e7a14bca2fb6a4487696d3,1,13,0,13,1,2013-05-21 22:17:11,2013-05-21 22:17:11
a959c011a8a2697702e7a14bca2fb6a4487696d3...770948338bea9ef9b5c1c9c4446363ba595ddbe7,4,20,4,24,6,2013-05-21 22:19:01,2013-05-21 22:18:47
770948338bea9ef9b5c1c9c4446363ba595ddbe7...575dd33cae5bd475b82f93b9a1ee68f159c73a7e,1,1,1,2,1,2013-05-21 22:27:27,2013-05-21 22:26:43
575dd33cae5bd475b82f93b9a1ee68f159c73a7e...dfdbbe6f16031b4b04806e87d0a501aa01f14982,2,2,2,4,2,2013-05-21 22:42:30,2013-05-21 22:42:13
dfdbbe6f16031b4b04806e87d0a501aa01f14982...5a26bbf5021be44f947c44e379e3d9a5a440e3cb,1,2,0,2,2,2013-05-21 22:51:47,2013-05-21 22:51:47
5a26bbf5021be44f947c44e379e3d9a5a440e3cb...e5b0377e3f88da4c67f2846c44abcc3be2e5461c,1,3,2,5,1,2013-05-21 23:01:30,2013-05-21 23:00:36
e5b0377e3f88da4c67f2846c44abcc3be2e5461c...7510d202e8bff95b055cb829adc449f71150109e,2,7,6,13,4,2013-05-21 23:58:53,2013-05-21 23:57:45
b56d4fad2454921ceaebcdcbc9522e8ab35c2444...b1c3dc40bde25434e8df10a8097db0785758b6d8,1,7,9,16,6,2013-05-21 18:10:15,2013-05-17 02:16:43
b1c3dc40bde25434e8df10a8097db0785758b6d8...e91ec6b853e4415ec881f158fd777c3c040a8369,1,0,1,1,1,2013-05-21 18:10:15,2013-05-17 02:23:44
e91ec6b853e4415ec881f158fd777c3c040a8369...e6e509ad866b1161004bac73049d7019c52c5bd4,1,2,2,4,2,2013-05-21 18:10:15,2013-05-17 18:51:36
e6e509ad866b1161004bac73049d7019c52c5bd4...91e715b584ffcd4d2db4f952f7d7a0a7c03de4f5,1,9,6,15,6,2013-05-21 18:10:15,2013-05-21 03:52:11
91e715b584ffcd4d2db4f952f7d7a0a7c03de4f5...75d9f04c5d0b5eacff140306224bb01c2c682808,7,39,2,41,8,2013-05-21 18:10:15,2013-05-21 05:08:30
75d9f04c5d0b5eacff140306224bb01c2c682808...5c6617660d0efd3a7eb31a98b8ee231d4e3c2941,1,2,2,4,2,2013-05-21 18:10:16,2013-05-21 05:12:39
5c6617660d0efd3a7eb31a98b8ee231d4e3c2941...7a7312235226c552199eba118a10da45f0abe298,1,2,2,4,2,2013-05-21 18:10:16,2013-05-21 05:16:05
1d87453963b08b95f3daf35ce0cdb58ba3a317c5...1a340917e84be72dd1a8640d451324281f28d30e,10,455,372,827,57,2013-04-15 17:48:42,2013-04-11 07:36:47
1a340917e84be72dd1a8640d451324281f28d30e...9ca82daabba65934affadb8178d02e3429f1db98,1,6,19,25,2,2013-04-15 17:48:42,2013-04-15 02:17:02
9ca82daabba65934affadb8178d02e3429f1db98...778afd112d9024d0f7acea16e3e7b3776a5d2994,2,0,4,4,2,2013-04-15 17:48:42,2013-04-15 02:19:28
778afd112d9024d0f7acea16e3e7b3776a5d2994...28f9061555032d9fd91294d35d69657c6abf70d9,1,40,25,65,3,2013-04-15 17:48:42,2013-04-15 03:03:12
28f9061555032d9fd91294d35d69657c6abf70d9...274f7e35b2f86393e91ef8da9095073997c26aa2,1,6,0,6,1,2013-04-15 17:49:51,2013-04-15 17:44:46
1d87453963b08b95f3daf35ce0cdb58ba3a317c5...c1f1329101aad00b9105ddadf13760d94b4de96a,2,5,8,13,4,2013-04-15 06:16:15,2013-04-15 06:16:15
c1f1329101aad00b9105ddadf13760d94b4de96a...b9873f1c92500c455c1c4fe5e25be43396b8e290,1,2,9,11,3,2013-04-15 06:23:47,2013-04-15 06:23:47
243e088e9e7ed3ecad83dc556285b2e7df9ef782...9d9160ffdb283cb75c7e1c5a239cb8257f29ea24,1,3,0,3,1,2013-03-21 21:19:30,2013-03-21 21:19:30
06cd4a4227e852871fa13fd4cd1177d8a8db6daf...aa16a06d679a080b65174b63bbe4206e5ef0da30,1,93,34,127,16,2013-03-05 05:40:41,2013-03-05 05:40:41
aa16a06d679a080b65174b63bbe4206e5ef0da30...9154b5d3c40241f3f909c548bb80d3e07860e7f1,4,29,4,33,8,2013-03-05 06:19:11,2013-03-05 06:18:04
9154b5d3c40241f3f909c548bb80d3e07860e7f1...57b067b5bdbdbc5fe72e04aa80b340b0f080b8b5,1,1,1,2,1,2013-03-05 19:22:42,2013-03-04 19:54:53
57b067b5bdbdbc5fe72e04aa80b340b0f080b8b5...3dff27d7edfbecbc6c1c96e1c65449625b9c894a,1,3,0,3,1,2013-03-05 19:26:02,2013-03-05 19:26:02
5177e0ba1f1d2b68370fb7c376cb3cb6dce21766...6f8516d36b5498a5b2f58a34261cb2e5292a5d86,2,3,3,6,3,2013-02-06 01:15:04,2013-02-06 01:15:04
6f8516d36b5498a5b2f58a34261cb2e5292a5d86...adcae951ebeda8a95faf213b2aeee275b92219c0,1,21,8,29,4,2013-02-06 02:11:59,2013-02-06 02:11:59
adcae951ebeda8a95faf213b2aeee275b92219c0...05ac3ad75d9b6022a98ccc6e8c4a66eb80aa0962,1,7,2,9,1,2013-02-06 02:34:55,2013-02-06 02:34:55
1eecbb070e44c971c6c5a5df3f2088e9aff708e3...fdb1773d4a742431306104b37c0c83c08c920969,8,8,8,16,8,2013-02-13 07:38:22,2013-02-13 07:38:22
fdb1773d4a742431306104b37c0c83c08c920969...eb14cfceeb448ec77b013854abd604c5ab9f5b75,7,11,7,18,9,2013-02-13 07:44:04,2013-02-13 07:44:04
eb14cfceeb448ec77b013854abd604c5ab9f5b75...e95bcb870cac982e19807d8ee6854c542328f1d3,10,19,181,200,12,2013-02-13 07:49:43,2013-02-13 07:49:43
e95bcb870cac982e19807d8ee6854c542328f1d3...ed36db211d27755af84c551a476115644a6d7b33,2,3,15,18,5,2013-02-13 07:51:34,2013-02-13 07:51:34
ed36db211d27755af84c551a476115644a6d7b33...d2ae5f7e1cb7fae38a5941feac66c970cb4f1de4,27,79,79,158,61,2013-02-13 07:55:19,2013-02-13 07:55:19
d2ae5f7e1cb7fae38a5941feac66c970cb4f1de4...9b486b3c9b74f3ba603c2380db0c584b764fe96f,13,41,31,72,29,2013-02-13 08:08:50,2013-02-13 08:08:50
9b486b3c9b74f3ba603c2380db0c584b764fe96f...b3d1fe411206c7c97e5f8f033a7ca051a12cbd65,2,5,10,15,2,2013-02-13 08:10:26,2013-02-13 08:10:26
b3d1fe411206c7c97e5f8f033a7ca051a12cbd65...516f4dfaf704a23f6eddad3ae0faaddcdb324af3,6,35,56,91,10,2013-02-13 08:42:05,2013-02-13 08:27:04
516f4dfaf704a23f6eddad3ae0faaddcdb324af3...9a7ac87778bfc041d96ee5c7308cf8df9a6773ba,4,37,21,58,6,2013-02-13 08:42:05,2013-02-13 08:37:16
1e09d4ee8d29b2f2dc53a29c723bbc94dab3038b...28b42e924eff420e4decfe3e6fdf54427d7830ac,18,29,28,57,19,2012-12-27 07:04:14,2012-12-22 22:31:35
28b42e924eff420e4decfe3e6fdf54427d7830ac...423fc1d71ec64b2330c2822caef756d508a30367,3,26,1,27,3,2012-12-27 07:04:14,2012-12-26 01:33:15
423fc1d71ec64b2330c2822caef756d508a30367...bc242ccc863d71179773992c29e0702f7274edbb,1,11,11,22,1,2012-12-27 07:04:14,2012-12-26 01:33:39
bc242ccc863d71179773992c29e0702f7274edbb...2c195c0b0400ee5ed0274283368e52c5c41c3a1c,1,2,1,3,2,2012-12-27 07:04:14,2012-12-26 01:34:49
2c195c0b0400ee5ed0274283368e52c5c41c3a1c...a16dd5c1583d3b14ed1acbe14bb72d8e7f1f3408,1,4,11,15,1,2012-12-27 07:04:14,2012-12-26 02:20:22
a16dd5c1583d3b14ed1acbe14bb72d8e7f1f3408...15513fd96c0d6ee2795613c04c018b03fa267689,1,2,1,3,1,2012-12-27 07:04:14,2012-12-26 21:07:33
15513fd96c0d6ee2795613c04c018b03fa267689...6356b73ef8bdab6df67d87d1c11c494b9a6d5260,2,1,15,16,2,2012-12-27 07:04:14,2012-12-26 21:10:03
6356b73ef8bdab6df67d87d1c11c494b9a6d5260...09d5c94522ffbe65bb920edfae7055655910abba,2,33,11,44,3,2012-12-27 07:04:15,2012-12-26 23:59:52
09d5c94522ffbe65bb920edfae7055655910abba...8c8fdc93cbc1d3d1c0d7db6606df446f9ed9ddf2,1,3,2,5,2,2012-12-27 07:04:15,2012-12-27 00:03:35
8c8fdc93cbc1d3d1c0d7db6606df446f9ed9ddf2...d248f15a414f83d3c1eabc5e2ff6b5f6ec872f54,1,0,1,1,1,2012-12-27 07:04:15,2012-12-27 00:08:34
d248f15a414f83d3c1eabc5e2ff6b5f6ec872f54...a0b497e9260f8f3aa6fc6f12ce5017c8dd9bc0b9,11,49,51,100,13,2012-12-27 07:04:15,2012-12-27 05:15:37
a0b497e9260f8f3aa6fc6f12ce5017c8dd9bc0b9...de90c755516d4ae5ec83f9755aede8be36609a43,10,5,5,10,5,2012-12-27 07:04:15,2012-12-27 07:01:05
2987b210d22f106f90cb67ca8f1d3c7babe0b01b...a37f0707b597f9630015ce48dc4b63f35ed6f5d0,1,8,2,10,3,2012-12-27 21:40:27,2012-12-27 21:40:27
a37f0707b597f9630015ce48dc4b63f35ed6f5d0...e4befac16ffa5bf09c8a8ec75a19fab8f1d3e16c,1,17,0,17,4,2012-12-27 22:00:49,2012-12-27 22:00:49
e4befac16ffa5bf09c8a8ec75a19fab8f1d3e16c...8a2328b27f14e5fc63554ae07893a91176e089d9,2,2,1,3,2,2012-12-28 00:32:55,2012-12-28 00:32:55
ebfac861f11836d289eecbd1153f46474b4d2f26...7e91b37ccd65e46d4b26b8082fb5a619ae81a39b,1,1,1,2,1,2013-10-22 06:33:55,2013-10-22 06:33:55
4f79054b830d28b60b4fe97a0cc81bea3a66177e...fbfcb4859b80aa4c8d31b64f9cc995fb9f18a8f7,2,7,1,8,3,2013-10-18 20:28:25,2013-10-18 20:28:25
fbfcb4859b80aa4c8d31b64f9cc995fb9f18a8f7...5a8ab31f43aa1a9fcd99e28529de650f84c340d2,3,45,6,51,8,2013-10-18 21:59:27,2013-10-18 21:59:27
5a8ab31f43aa1a9fcd99e28529de650f84c340d2...dcfd00fe2f51852f68eb944c62b1ae6bb8f4933a,2,55,1,56,3,2013-10-18 22:39:47,2013-10-18 22:39:47
dcfd00fe2f51852f68eb944c62b1ae6bb8f4933a...ad64ec17b0cd7ce7e01f57235497675289b101d3,1,1,10,11,2,2013-10-18 23:00:41,2013-10-18 23:00:41
ad64ec17b0cd7ce7e01f57235497675289b101d3...606a94b41d9589aba906acb6f2ee254a8a784d0a,2,16,24,40,5,2013-10-18 23:18:24,2013-10-18 23:15:17
86b978b0f371b2ca32a395f6f4c24bd3317566ea...f731c906e36326ee9f4d1cddc5849741122945ba,1,1,1,2,1,2013-10-14 20:16:06,2013-10-14 20:16:06
f731c906e36326ee9f4d1cddc5849741122945ba...84a9b8a2b78fcc2217d3406939855f1ccdbeb557,2,80,6,86,3,2013-10-14 23:18:04,2013-10-14 23:18:04
86b978b0f371b2ca32a395f6f4c24bd3317566ea...8f23f54248100a61982979290864b843505a91a7,1,3,1,4,1,2013-10-14 19:33:16,2013-10-14 19:33:16
085b9bb0e583c0599f1339e6fb44a427bdbc90a2...6c0f7dff0230ab2cd2b8bfb7c05f4efe7f54ce54,1,30,7,37,9,2013-10-11 21:18:05,2013-10-11 21:18:05
aaf6c8a28ad205ac17f749d9856101570ebf4e3b...00a70b78998958e84def6fcc3fbbc11ec85225d6,1,4,0,4,1,2013-09-11 20:48:05,2013-09-11 20:48:05
00a70b78998958e84def6fcc3fbbc11ec85225d6...4714f892f56b71af1368faf95ff23f6c33bff729,2,10,0,10,2,2013-09-12 19:13:15,2013-09-05 21:29:19
4714f892f56b71af1368faf95ff23f6c33bff729...a174b549b95f1712a5f7809c0dd5f524884cf338,1,1,1,2,1,2013-09-12 19:31:54,2013-09-09 08:47:44
a174b549b95f1712a5f7809c0dd5f524884cf338...3665b31a82f8ded87656d2e79317cf243c40cccb,3,13,132,145,8,2013-09-12 20:55:15,2013-09-12 20:55:15
ed9cb03ac19f6441c7d3dd9554698821ef488fca...28ab8026fdf4a93262bff19081ef1b852b25ae10,1,1,2,3,2,2013-08-16 03:31:32,2013-08-16 00:23:47
28ab8026fdf4a93262bff19081ef1b852b25ae10...3d5c288b2bf356b7ac504f7b14bae2cd2d38ad24,1,1,2,3,1,2013-08-19 23:24:32,2013-08-19 23:24:32
3d5c288b2bf356b7ac504f7b14bae2cd2d38ad24...2fad88988ff8c0c31835d2e02cc7b075ab4e5213,1,3,1,4,1,2013-08-19 23:26:17,2013-08-19 23:25:46
2fad88988ff8c0c31835d2e02cc7b075ab4e5213...9b8d72392c906b5a82da96543c67d1bb436863f8,1,1,1,2,1,2013-08-20 02:18:26,2013-08-20 02:18:26
9b8d72392c906b5a82da96543c67d1bb436863f8...dff1310cc4135b1f442126a3412537ca6c1751ec,2,22,3,25,4,2013-08-20 02:27:58,2013-08-20 02:27:58
dff1310cc4135b1f442126a3412537ca6c1751ec...30b08fc01286fd92f5570e5eb54849d46c8f1726,2,9,1,10,2,2013-08-20 02:51:01,2013-08-20 02:51:01
30b08fc01286fd92f5570e5eb54849d46c8f1726...3cfeed5b5bf022c7f99906d11777c6ba3cce0118,8,31,16,47,10,2013-08-20 05:00:37,2013-08-20 04:47:34
3cfeed5b5bf022c7f99906d11777c6ba3cce0118...00884756993234ce3d42f24170f06d58d9682e0f,2,6,0,6,2,2013-08-20 05:15:52,2013-08-20 05:15:52
00884756993234ce3d42f24170f06d58d9682e0f...d567bbdaf31a28a63fac31a3dc03fa971a53942a,1,1,1,2,1,2013-08-20 17:52:45,2013-08-20 17:52:45
d567bbdaf31a28a63fac31a3dc03fa971a53942a...8b13f53cf41bff51d7ed9137ecd0a23615beb9e7,1,1,1,2,1,2013-08-20 18:08:50,2013-08-20 18:08:50
8b13f53cf41bff51d7ed9137ecd0a23615beb9e7...bfc7f22dc0dd418faa482f12c23656b07fa5a9db,1,1,1,2,1,2013-08-20 18:14:44,2013-08-20 18:14:44
bfc7f22dc0dd418faa482f12c23656b07fa5a9db...008c1cf7f242625bdcb744826a891761d8485bac,1,6,2,8,3,2013-08-20 18:37:11,2013-08-20 18:37:11
008c1cf7f242625bdcb744826a891761d8485bac...1e9a61eff6be580853355395cef9683735c502d1,1,2,1,3,1,2013-08-20 21:48:22,2013-08-20 21:48:22
b0a9278566c207f41c8ded8a2b454d7bfb0bbca2...a6b612e33cdaeb9c511f0b7a10fcf665e7230f49,1,2,0,2,1,2013-09-19 03:01:51,2013-09-19 03:01:51
a6b612e33cdaeb9c511f0b7a10fcf665e7230f49...443c9de2fd4e713f788c6cecdb553103ac134ef4,1,1,0,1,1,2013-09-19 22:55:32,2013-09-19 22:55:32
443c9de2fd4e713f788c6cecdb553103ac134ef4...82951a2038ed5f7529209e35b6625ed4d2d9b9c4,1,2,0,2,1,2013-09-19 23:03:39,2013-09-19 23:03:39
82951a2038ed5f7529209e35b6625ed4d2d9b9c4...13d1cde4cab772436fe22080ce3b8d44adb6c8b1,1,1,1,2,1,2013-10-01 18:15:10,2013-10-01 18:15:10
13d1cde4cab772436fe22080ce3b8d44adb6c8b1...66e56cdd146790d72059c01f1cfa2cf5de9390e3,2,4,1,5,2,2013-10-02 19:31:46,2013-10-02 19:31:46
66e56cdd146790d72059c01f1cfa2cf5de9390e3...4f564062a0613697ffbb9a2961b4f4e758d89753,3,4,2,6,3,2013-10-02 21:00:36,2013-10-02 21:00:36
b0a9278566c207f41c8ded8a2b454d7bfb0bbca2...08a5af39529b0591d651e0ed610db8ddbec42761,4,13,13,26,12,2013-09-19 02:50:07,2013-09-19 02:26:55
d1c481f71495b302e58c33bb24fb26903bbb18f2...fbcf4650686cd1a5564de1b54232c7079c1e7469,3,21,1,22,3,2013-07-25 23:55:59,2013-06-11 00:10:29
fbcf4650686cd1a5564de1b54232c7079c1e7469...f6c6f891c5f129a45dd4109932ae40a892a51a03,1,3,1,4,1,2013-07-25 23:55:59,2013-06-11 22:38:35
f6c6f891c5f129a45dd4109932ae40a892a51a03...b434d19bd8cf600a7fd15108b810e0932a439805,1,20,0,20,1,2013-07-25 23:55:59,2013-06-12 21:43:38
b434d19bd8cf600a7fd15108b810e0932a439805...bf02edaae7c8b3dc56ca0c7a252b61db2521d816,1,1,1,2,1,2013-07-25 23:55:59,2013-06-13 20:10:25
bf02edaae7c8b3dc56ca0c7a252b61db2521d816...af7e208bd2d6fb2c0aa05dc2f13d200f89fd9761,1,46,12,58,7,2013-07-25 23:55:59,2013-06-13 20:10:53
af7e208bd2d6fb2c0aa05dc2f13d200f89fd9761...853bdb4df21d2de19fde10fb35e91efd2104f152,3,15,2,17,5,2013-07-25 23:55:59,2013-07-24 16:32:45
853bdb4df21d2de19fde10fb35e91efd2104f152...475af49b27c93273142268dae7c772206ad4c4c2,2,12,1,13,2,2013-07-25 23:55:59,2013-07-25 04:35:04
475af49b27c93273142268dae7c772206ad4c4c2...da09ebf774ec575e91512bf02c55dafc3728a4e9,1,4,0,4,1,2013-07-25 23:55:59,2013-07-25 04:37:30
da09ebf774ec575e91512bf02c55dafc3728a4e9...2e7c6f1bd03ecfdaa18b00ee71f36609e6a12bb9,1,2,2,4,2,2013-07-25 23:55:59,2013-07-25 22:49:47
2e7c6f1bd03ecfdaa18b00ee71f36609e6a12bb9...f9c06d8116f646156471bc9e4f3bd31a75c92b14,1,11,1,12,3,2013-07-25 23:55:59,2013-07-25 22:57:38
f9c06d8116f646156471bc9e4f3bd31a75c92b14...9098c94bf1e02e050c72f8268152729601c355cc,4,20,33,53,10,2013-07-25 23:55:59,2013-07-25 23:09:17
76ab959951fe6e52774e893c56f017f8d73c002d...31ea1c8d08b9de41da0f71bf1f187c394b4d781c,2,2,2,4,2,2013-07-02 17:52:17,2013-07-02 17:52:05
31ea1c8d08b9de41da0f71bf1f187c394b4d781c...55c5a79126205744f0381babbabab546ee70bfc5,2,7,6,13,6,2013-07-10 02:17:07,2013-07-10 02:17:07
55c5a79126205744f0381babbabab546ee70bfc5...af12337dbb9e07c682798a765847c976a7733e6b,2,36,10,46,13,2013-07-10 02:31:24,2013-07-10 02:31:24
a63638266ebefac83ac6eef7d1a4fabd7aaf4789...d82bb3a8c1d09f7919bd8dfb60385d2043382846,3,9,9,18,3,2013-06-26 17:43:24,2013-06-26 17:37:55
d82bb3a8c1d09f7919bd8dfb60385d2043382846...11c8fcd341706fedd8ab1a42dde7f9e182b36e0d,1,3,1,4,2,2013-06-26 19:26:11,2013-06-26 19:10:49
11c8fcd341706fedd8ab1a42dde7f9e182b36e0d...e33694874d684467c70edfaf91eed661667d295f,10,70,26,96,27,2013-06-26 19:26:12,2013-06-26 19:05:52
e33694874d684467c70edfaf91eed661667d295f...7e4f720e8edcc859ede51f465e32912793ea8e14,3,126,58,184,20,2013-06-26 19:34:42,2013-06-26 19:34:42
7e4f720e8edcc859ede51f465e32912793ea8e14...91307018349f53267cd6674125c58743c7c43ff3,2,7,3,10,3,2013-06-26 19:46:57,2013-06-26 19:46:57
49d5d8feab482e2f516acc410a736c2aa4825aa0...c41babfdd71f67aec26b21fff4cdfe9e42070863,1,3,0,3,1,2013-06-18 00:36:25,2013-06-18 00:36:25
49d5d8feab482e2f516acc410a736c2aa4825aa0...dc75e8877bdc31641118c88362c66b5d4034ad4c,4,19,18,37,12,2013-06-18 00:18:38,2013-06-13 18:11:51
dc75e8877bdc31641118c88362c66b5d4034ad4c...6c118d97f0d9811331781a025907e6487a9c564a,2,3,1,4,3,2013-06-18 00:18:38,2013-06-17 22:05:16
3d0a551be347bf59ea83da7a62353db5f954a59b...cac2368d201eca584f2b5c54afb10b3b30e3cbe9,1,5,1,6,1,2013-05-23 05:42:55,2013-05-16 14:36:47
cac2368d201eca584f2b5c54afb10b3b30e3cbe9...28ea851c2aad0095fb16230c66973339783a567c,1,3,0,3,1,2013-05-23 05:45:06,2013-05-23 05:45:06
4616ac47fdb4718f754deb15686682dc19137371...8eeb9e97ef082a55837de4d597ff046db7e33699,2,7,1,8,2,2013-05-22 00:11:37,2013-05-22 00:11:20
8eeb9e97ef082a55837de4d597ff046db7e33699...6a05987abb11c8d84c141ed804674f62d8ebcb63,1,3,3,6,1,2013-05-22 00:15:38,2013-05-22 00:15:11
6a05987abb11c8d84c141ed804674f62d8ebcb63...f634817b79da49a0b46f2e018933190b2aae48a9,1,11,6,17,5,2013-05-22 00:54:51,2013-05-22 00:54:23
f634817b79da49a0b46f2e018933190b2aae48a9...560302954bef05cfccba58befab05d770a823bce,1,2,2,4,1,2013-05-22 01:03:41,2013-05-22 00:19:08
560302954bef05cfccba58befab05d770a823bce...2aec63463ba939204313d997c7010432be40e374,3,14,12,26,7,2013-05-22 01:03:41,2013-05-22 01:02:32
93a6fafc3b34890daeccaafbe62ef9f9817f556d...6873c91424aaac9e652e792822f3d9816cfd304d,5,23,4,27,6,2013-04-15 17:52:01,2013-04-08 23:06:35
6873c91424aaac9e652e792822f3d9816cfd304d...939f3ff016a472bd425beb2b694283e8dda17606,1,8,7,15,4,2013-04-15 18:54:59,2013-04-15 18:54:59
9d9160ffdb283cb75c7e1c5a239cb8257f29ea24...2696cb441ea03ee7b80020e0cb900d4dc61ef311,3,20,12,32,12,2013-03-21 22:49:45,2013-03-21 22:49:45
9d9160ffdb283cb75c7e1c5a239cb8257f29ea24...37e518c11557737250ff6362160b74a26828c583,2,93,59,152,20,2013-03-21 22:16:47,2013-03-21 19:38:12
37e518c11557737250ff6362160b74a26828c583...425278ad35a196f8ceb73a225503e0d20762b705,1,1,1,2,1,2013-03-21 22:16:47,2013-03-21 20:15:33
425278ad35a196f8ceb73a225503e0d20762b705...664b98ba5e3f83ed3956f62219540b0bfc608c2d,2,30,2,32,4,2013-03-21 22:16:48,2013-03-21 21:05:26
664b98ba5e3f83ed3956f62219540b0bfc608c2d...3cac15d23ec7276ef60bf9ffba465f2e71d2ccf3,2,15,2,17,4,2013-03-21 22:16:48,2013-03-21 21:50:23
3cac15d23ec7276ef60bf9ffba465f2e71d2ccf3...e070bf2771b2852365594bbbf47e18c0c15162e1,2,20,0,20,3,2013-03-21 22:33:44,2013-03-21 22:33:44
e070bf2771b2852365594bbbf47e18c0c15162e1...eb72c0ee40462adcc78fcb6bc93f8a35ff2c7e47,1,25,0,25,1,2013-03-21 22:47:14,2013-03-21 22:47:14
eb72c0ee40462adcc78fcb6bc93f8a35ff2c7e47...c6f0e74136a48da8c336d4f06f8c330e7e6f9061,4,11,12,23,10,2013-03-21 22:59:24,2013-03-21 22:59:24
c6f0e74136a48da8c336d4f06f8c330e7e6f9061...c489d44517c5e5bf5304a640826f6807592e3632,1,22,16,38,4,2013-03-21 23:10:14,2013-03-21 23:10:14
c489d44517c5e5bf5304a640826f6807592e3632...065ca60eecb1fb1691f7d787768e5dc61c74a43d,1,1,1,2,1,2013-03-22 17:54:16,2013-03-22 17:54:16
065ca60eecb1fb1691f7d787768e5dc61c74a43d...ea311b1c56291509f8d8bc796d725994817db3f0,1,3,13,16,3,2013-03-22 20:28:49,2013-03-22 20:28:49
ea311b1c56291509f8d8bc796d725994817db3f0...74e10e96affb8c2486fcd3ba68d98500e8ed36d7,3,13,2,15,5,2013-03-22 21:19:43,2013-03-22 21:18:33
74e10e96affb8c2486fcd3ba68d98500e8ed36d7...bef03af0b27dc0eb5f50b27539417702ad493e38,1,7,6,13,5,2013-03-22 22:06:37,2013-03-22 21:57:36
3dff27d7edfbecbc6c1c96e1c65449625b9c894a...01bbc58b11b50bbcc60b4389c72cb5119d85bd7d,1,28,14,42,8,2013-03-06 07:59:19,2013-03-06 07:59:19
01bbc58b11b50bbcc60b4389c72cb5119d85bd7d...ece35ebb46b5212b6606456ce7ea037271711102,1,12,6,18,12,2013-03-06 23:08:24,2013-03-06 23:08:24
ece35ebb46b5212b6606456ce7ea037271711102...ca7c56c530cb04122f1a1155f31dd369e86e76a6,2,20,4,24,3,2013-03-06 23:59:45,2013-03-06 23:54:23
ca7c56c530cb04122f1a1155f31dd369e86e76a6...63869d033023081fcd34ec7366062b9099de4e8e,2,12,0,12,2,2013-03-07 00:51:31,2013-03-07 00:49:02
453679da6ef0e25db2fb9b4ccf860951805de0ca...64d1361cf972821c0833df2558573b31b96c811c,1,41,0,41,1,2013-02-06 06:27:26,2013-02-06 06:27:26
64d1361cf972821c0833df2558573b31b96c811c...6e645071dc19979674bd5eb93457d6342c777dd7,1,4,8,12,5,2013-02-06 19:50:35,2013-02-06 19:50:35
6e645071dc19979674bd5eb93457d6342c777dd7...de6a08d09ef3e4156cdf93a6cea6b2241e3647d3,3,5,6,11,4,2013-02-06 22:08:39,2013-02-06 22:08:39
de6a08d09ef3e4156cdf93a6cea6b2241e3647d3...d1de04dbea8e81510304d14594c1a666e384dcc6,1,7,0,7,1,2013-02-06 22:25:22,2013-02-06 22:25:22
df7d6906e9eed099c37667c46e603629ee3275fd...732e948de7a3e5a652f949cc2ccd9745c7b2d60f,2,3,1,4,2,2013-02-13 08:46:12,2013-02-13 08:46:12
732e948de7a3e5a652f949cc2ccd9745c7b2d60f...82e2098102dd35ed25c13ebf54b41dba52e50041,2,8,8,16,5,2013-02-13 19:03:54,2013-02-13 19:03:54
82e2098102dd35ed25c13ebf54b41dba52e50041...e12c6fd89afecce8179ab82021f5a475a025cf9d,1,18,0,18,1,2013-02-13 21:56:52,2013-02-13 21:56:52
e12c6fd89afecce8179ab82021f5a475a025cf9d...2185b21be531fecb893f77e73542acfb4427dcf8,1,3,3,6,1,2013-02-13 22:41:31,2013-02-13 22:41:31
2185b21be531fecb893f77e73542acfb4427dcf8...806ffc6b60e57d609f76f0e92866861e71a5e38b,2,9,6,15,4,2013-02-13 22:46:27,2013-02-13 22:46:27
806ffc6b60e57d609f76f0e92866861e71a5e38b...8cf0d8f9b33a03df627093358d74574f43ae9af1,3,8,4,12,4,2013-02-13 23:02:06,2013-02-13 23:02:06
7c007a76de3872671ac17ba25a7baa559e82a48c...b5ae25ac3fa01dafc2eb9e5a2f6fcf0d5ce15add,3,24,8,32,13,2012-12-27 09:00:17,2012-12-26 20:06:01
b5ae25ac3fa01dafc2eb9e5a2f6fcf0d5ce15add...d62942627e691a32e4f1483cf934327dc51abc53,1,2,0,2,1,2012-12-27 09:00:17,2012-12-26 21:33:06
d62942627e691a32e4f1483cf934327dc51abc53...7cd4082457c83292c7b4d124e9156987c080c67e,2,0,4,4,2,2012-12-27 09:00:17,2012-12-27 08:50:05
4c5ea61beb8fdfb744f8916fcd7eefff385142ce...617d3b720718045c7da8798366a2a964bc393136,1,3,0,3,1,2012-12-29 00:00:50,2012-12-29 00:00:50
617d3b720718045c7da8798366a2a964bc393136...45a19ee918e55f36d5a8b420967aba4b6ba1a8fc,2,48,32,80,13,2012-12-29 21:28:17,2012-12-29 21:28:17
45a19ee918e55f36d5a8b420967aba4b6ba1a8fc...1c47ffa07f5a25af14726016e4d0b23a1e8502a0,1,3,0,3,2,2012-12-31 09:54:54,2012-12-31 09:54:54
1c47ffa07f5a25af14726016e4d0b23a1e8502a0...dd5bf80f5bf627a3ab19fcf37b4c207134b1d66f,1,7,4,11,3,2012-12-31 19:48:44,2012-12-31 19:48:44
dd5bf80f5bf627a3ab19fcf37b4c207134b1d66f...238a7858e5393a209bc8d70c171f445d2bc52ce6,1,1,1,2,1,2012-12-31 20:24:29,2012-12-31 20:24:29
238a7858e5393a209bc8d70c171f445d2bc52ce6...eee3352675fefd0df4c520e0ddae06461df0316a,1,3,2,5,2,2012-12-31 20:36:44,2012-12-31 20:36:44
eee3352675fefd0df4c520e0ddae06461df0316a...dea8fc6d4d868d1b691c48dbe6258e050ec9f778,1,1,0,1,1,2012-12-31 20:43:15,2012-12-31 20:43:15
dea8fc6d4d868d1b691c48dbe6258e050ec9f778...6c04fab3664b7041957f61c6890b7aa47105bc5c,1,3,3,6,3,2012-12-31 20:49:28,2012-12-31 20:49:28
6c04fab3664b7041957f61c6890b7aa47105bc5c...45b7ff1c7853727ed2ca86a10f8a9e73fc34e9ab,1,2,0,2,1,2013-01-02 00:42:42,2013-01-02 00:42:42
45b7ff1c7853727ed2ca86a10f8a9e73fc34e9ab...66b0e7caff682d17381cfd6cd5fd181126cd0884,1,6,3,9,2,2013-01-02 20:08:39,2013-01-02 20:08:39
66b0e7caff682d17381cfd6cd5fd181126cd0884...4f8032e57760eb0786df54c188787bf6fe646934,1,1,1,2,1,2013-01-02 21:54:34,2013-01-02 21:54:34
4f8032e57760eb0786df54c188787bf6fe646934...8231783d225eb01fa0c45fd2ff704a6b472dcc84,1,2,0,2,1,2013-01-02 22:11:24,2013-01-02 22:11:24
8231783d225eb01fa0c45fd2ff704a6b472dcc84...f3940cab781ceaaa494f3be2e60b098f198300a6,1,5,5,10,3,2013-01-03 01:26:59,2013-01-03 01:18:35
f3940cab781ceaaa494f3be2e60b098f198300a6...2d7d419ef8f03540de9da874b9626e6789c99760,1,4,0,4,1,2013-01-03 01:48:43,2013-01-03 01:48:43
2d7d419ef8f03540de9da874b9626e6789c99760...bc9e6997d4444b242e9ef4772cf0797c41d3bc8c,1,36,54,90,11,2013-01-03 02:38:11,2013-01-03 02:38:11
bc9e6997d4444b242e9ef4772cf0797c41d3bc8c...fb24d39cbad1d073ac3e5ed43e4277bc284a6a9c,1,9,7,16,3,2013-01-03 08:40:08,2013-01-03 08:40:08
fb24d39cbad1d073ac3e5ed43e4277bc284a6a9c...203a82d9b977c61ac0f20a0028caf27be6baa646,1,28,31,59,5,2013-01-03 17:29:52,2013-01-03 17:29:52
203a82d9b977c61ac0f20a0028caf27be6baa646...95974f82fbc419a52c71c0de92a59b277b8c45b0,3,23,10,33,7,2013-01-03 18:16:21,2013-01-03 18:16:21
86a52e61428f5dcd9e75eb1de0e303caf0c26a22...3d34e5b5ef3204013d269709b673842054bfd542,1,2,0,2,1,2013-11-26 23:37:00,2013-11-26 23:34:03
3d34e5b5ef3204013d269709b673842054bfd542...444c56f1bdf5e5bc0ae7d2e020720f9ac6a1d422,1,1,1,2,1,2013-11-26 23:44:44,2013-11-26 23:44:44
2b4fb9b37d5e09c956f1e54a8d9e0b6f8af633bb...daf0a4801a5081293935f05993f76cf059e117fb,1,20,26,46,9,2013-10-22 23:10:57,2013-10-22 23:10:57
daf0a4801a5081293935f05993f76cf059e117fb...9ab15d4c291f78f643208562a1afd38ae962c88a,1,2,0,2,1,2013-10-22 23:59:06,2013-10-22 23:59:06
606a94b41d9589aba906acb6f2ee254a8a784d0a...67a7c2786bcd82ea8c048ca25bbf53a70e32d7b3,1,5,3,8,2,2013-10-19 08:03:50,2013-10-19 08:03:50
67a7c2786bcd82ea8c048ca25bbf53a70e32d7b3...219056f0e83b16d9d52a1c631220ceac95496cdd,1,5,0,5,1,2013-10-19 08:09:49,2013-10-19 08:09:49
606a94b41d9589aba906acb6f2ee254a8a784d0a...8c441d1a309c9e28e888a4084efce240d7757146,7,7,8,15,7,2013-10-18 23:36:35,2013-10-18 23:36:35
8f23f54248100a61982979290864b843505a91a7...0151b3188deebadbca498972bfffff40653ca223,1,1,1,2,1,2013-10-15 01:22:02,2013-10-14 20:16:06
0151b3188deebadbca498972bfffff40653ca223...3aca36aac4bfbf0d2f5a5ed34b777c79e2be691e,2,80,6,86,3,2013-10-15 01:22:02,2013-10-14 23:18:04
3aca36aac4bfbf0d2f5a5ed34b777c79e2be691e...71ea032cd99c5850e1e85177ff1c18a8f70effd3,2,11,1,12,4,2013-10-15 01:26:20,2013-10-15 01:26:20
71ea032cd99c5850e1e85177ff1c18a8f70effd3...432907133449460e6c5f612cdce0abb06da2e02b,1,2,1,3,1,2013-10-16 21:59:38,2013-10-16 21:59:38
432907133449460e6c5f612cdce0abb06da2e02b...2c8422e441de36704243f72cf3a9e270c3e9c5cf,1,6,0,6,1,2013-10-18 05:48:07,2013-10-18 05:47:58
2c8422e441de36704243f72cf3a9e270c3e9c5cf...de3757480673ef0f07ed46f269eb0402f29f53fc,1,2,0,2,1,2013-10-18 06:17:07,2013-10-18 06:17:07
8f23f54248100a61982979290864b843505a91a7...ea8c8af701e8a33ba1f7f5859907e8d9bd135dcb,6,1047,0,1047,6,2013-10-14 21:17:36,2013-09-23 03:28:11
ea8c8af701e8a33ba1f7f5859907e8d9bd135dcb...c08b5e7b35eb56ed78cd68ae4a6df350801574da,2,70,75,145,11,2013-10-14 21:17:36,2013-09-23 04:54:50
c08b5e7b35eb56ed78cd68ae4a6df350801574da...a48262a74664525a0bd6ec35914643a5c24a20f5,3,129,2,131,4,2013-10-14 21:17:36,2013-09-23 05:14:53
a48262a74664525a0bd6ec35914643a5c24a20f5...4dbf1bff46c15d88e77b57cb6eef0a25e65abb9d,1,1,2,3,1,2013-10-14 21:17:36,2013-09-23 05:16:03
4dbf1bff46c15d88e77b57cb6eef0a25e65abb9d...40438fa3ba9181e02561ab6b18c4edf12fe6ac1e,1,3,8,11,3,2013-10-14 21:17:36,2013-09-23 05:17:08
40438fa3ba9181e02561ab6b18c4edf12fe6ac1e...3faecc4148b13ce9c0c34f1bdc53a95792585f63,2,22,5,27,5,2013-10-14 21:17:36,2013-09-23 05:22:24
3faecc4148b13ce9c0c34f1bdc53a95792585f63...dbc195c3857486d3c8ceda235ec4ccc972980c38,2,9,2,11,4,2013-10-14 21:17:36,2013-09-23 05:26:51
dbc195c3857486d3c8ceda235ec4ccc972980c38...e7a249762113530df659d7dbe265c686d6161d3e,2,80,30,110,6,2013-10-14 21:17:36,2013-09-23 03:52:00
e7a249762113530df659d7dbe265c686d6161d3e...a45c3e22befcca34a324829538d7a67eecf375a4,1,3,3,6,2,2013-10-14 21:17:36,2013-10-07 14:42:52
a45c3e22befcca34a324829538d7a67eecf375a4...436ba88f96e9133d06f84de1f01dd95c169eb552,2,8,2,10,3,2013-10-14 21:17:37,2013-10-07 17:23:43
436ba88f96e9133d06f84de1f01dd95c169eb552...d7a34089e0fc609433ada60dfc88a6b2d1c2649a,5,726,673,1399,219,2013-10-14 21:17:37,2013-10-14 21:15:52
9a923b448d4628d9729c10126860c95b0f4c47a7...c11a08586314a89a429e4f159affd46c6bbc4f24,3,3,3,6,3,2013-10-11 21:49:56,2013-10-11 21:49:56
c11a08586314a89a429e4f159affd46c6bbc4f24...a0f76c8c74dad04cfb79a7263e913597d3635140,1,1,1,2,1,2013-10-11 21:55:30,2013-10-11 21:55:30
a0f76c8c74dad04cfb79a7263e913597d3635140...4788427f9de7feb533ef206810fed5710a013a52,1,4,3,7,2,2013-10-23 05:02:47,2013-10-23 05:02:47
4788427f9de7feb533ef206810fed5710a013a52...df5dc5c5bec4a6081ec9159fdca84978a13ea7c9,2,5,1,6,2,2013-10-23 05:11:33,2013-10-23 05:11:33
df5dc5c5bec4a6081ec9159fdca84978a13ea7c9...849e4e015d15f2ecdc0d3add2c7d9a09a86842b6,1,1,7,8,4,2013-10-23 06:04:57,2013-10-23 06:04:57
849e4e015d15f2ecdc0d3add2c7d9a09a86842b6...347fb5ca017f370f846f9b7153229f9f67c8c972,1,6,5,11,2,2013-10-28 21:18:59,2013-10-28 21:18:59
347fb5ca017f370f846f9b7153229f9f67c8c972...3b0dad79b0a66d0ee78dea44cec9a7a3980d368e,2,0,10,10,2,2013-10-28 21:19:53,2013-10-28 21:19:53
3b0dad79b0a66d0ee78dea44cec9a7a3980d368e...379cc79ea9fdfe3d5cb1da4f569d07c7f454df8c,8,1,645,646,8,2013-10-28 21:22:55,2013-10-28 21:21:34
3665b31a82f8ded87656d2e79317cf243c40cccb...8df6553ce2e26ec0a3b29c6186c1f2f6c506f428,7,24,7,31,9,2013-09-12 21:29:50,2013-09-08 20:27:08
8df6553ce2e26ec0a3b29c6186c1f2f6c506f428...d4186524b85395813a777444229e64d48fefa546,1,14,8,22,4,2013-09-12 21:29:50,2013-09-08 21:05:30
d4186524b85395813a777444229e64d48fefa546...c66b8e3db5a541c8388d773261dc6fc5f2e55fee,2,3,6,9,4,2013-09-12 21:29:50,2013-09-12 21:05:39
c66b8e3db5a541c8388d773261dc6fc5f2e55fee...259fb036c8b083a1387b26a38474094e4ff0c7d9,1,1,1,2,1,2013-09-12 21:29:50,2013-09-12 21:23:31
6f02ee60980bf8e58d9494d23d64aa9e0068b540...9547ac2b9f45829c8e61d4e701af2d64cd99dd8c,1,5,5,10,5,2013-08-21 01:31:08,2013-08-21 01:31:08
4f564062a0613697ffbb9a2961b4f4e758d89753...9ea6c7a424e205aaf6634f52ca6a20f24e93896c,6,17,13,30,8,2013-10-02 22:04:35,2013-10-02 20:53:06
9ea6c7a424e205aaf6634f52ca6a20f24e93896c...44769e6ec0b27cadc2a7d7642e0c10fae32cfe75,1,15,3,18,4,2013-10-02 22:04:45,2013-10-02 21:14:11
42e9d79152aa9c7e77de942038b09a5cc616f3f6...8f27d2cd58411ebe413f11409644ae99beb894ee,3,21,12,33,14,2013-11-04 18:06:16,2013-11-04 18:06:16
8f27d2cd58411ebe413f11409644ae99beb894ee...3fc7d35f41a49abe5267032b7f4e77ccb99b4206,2,27,9,36,5,2013-11-04 20:39:42,2013-11-04 20:39:42
3fc7d35f41a49abe5267032b7f4e77ccb99b4206...bb15c15f30c0d57a82ba986de83802ba74f2f8ec,2,40,1,41,5,2013-11-04 23:39:37,2013-11-04 23:39:37
42e9d79152aa9c7e77de942038b09a5cc616f3f6...662410e885898a6730060aef8a151a54e63c7fe0,3,28,8,36,8,2013-11-02 01:48:19,2013-11-02 01:48:19
8c652721702a559692875cdba677ec3bc61de674...8d66f18cbb44e6a0aa5fc21ec41be2147bd46ffa,1,1,3,4,1,2013-07-26 01:25:13,2013-07-26 01:23:15
8d66f18cbb44e6a0aa5fc21ec41be2147bd46ffa...556f6aa979db9c854c3359d6bb9228ca7c1d42c7,1,2,1,3,1,2013-07-26 01:49:54,2013-07-26 01:49:54
af12337dbb9e07c682798a765847c976a7733e6b...4e0d656e5cbe4e280ce0fcf2e9ddc5d6f76ad3e1,3,7,2,9,3,2013-07-10 03:33:12,2013-07-09 22:40:31
4e0d656e5cbe4e280ce0fcf2e9ddc5d6f76ad3e1...79f5671495e98afc69b94a6e36d0743cb19708bc,1,2,2,4,1,2013-07-11 20:28:16,2013-07-11 20:28:16
79befd4df97d9638a4530d9c562211e2636262db...e49c434599b3d31ff02325f3601416f742988f55,6,85,0,85,6,2013-07-02 05:50:57,2013-07-01 23:10:15
e49c434599b3d31ff02325f3601416f742988f55...d1735fbe144a158552733a04e38cba6f5dbf0e1f,3,152,0,152,4,2013-07-02 05:50:57,2013-07-01 23:40:33
d1735fbe144a158552733a04e38cba6f5dbf0e1f...659954bd4b31ac94b44d35a9f50ef17b91e90775,3,110,3,113,5,2013-07-02 05:50:57,2013-07-02 00:12:16
659954bd4b31ac94b44d35a9f50ef17b91e90775...b96926b0e12c6b895577048d7ab91c3e7146fd33,1,6,1,7,2,2013-07-02 05:50:57,2013-07-02 00:15:57
b96926b0e12c6b895577048d7ab91c3e7146fd33...e15831ad94bbcabdd743b0616e8c3a56f0cc520c,2,19,14,33,13,2013-07-02 05:50:57,2013-07-02 00:27:47
e15831ad94bbcabdd743b0616e8c3a56f0cc520c...c378858672f9f76364b9b2500e78d3b57ab6fb43,2,3,2,5,2,2013-07-02 05:50:57,2013-07-02 00:30:26
c378858672f9f76364b9b2500e78d3b57ab6fb43...0652b2180e57985d39a36b614c15bfd7e9e90c61,1,7,0,7,2,2013-07-02 05:50:57,2013-07-02 00:45:14
0652b2180e57985d39a36b614c15bfd7e9e90c61...717372168fae42e99ec82f176e0618fb374d2cea,5,20,54,74,5,2013-07-02 05:50:57,2013-07-02 02:00:15
717372168fae42e99ec82f176e0618fb374d2cea...d2ab75c38e172aeb0765142b2a45125c1d1493b9,4,37,3,40,6,2013-07-02 05:50:57,2013-07-02 03:56:15
d2ab75c38e172aeb0765142b2a45125c1d1493b9...353e0ea383cdd9dea7972311deb0ad31c6335cd7,3,57,55,112,10,2013-07-02 05:50:58,2013-07-02 02:01:14
353e0ea383cdd9dea7972311deb0ad31c6335cd7...09c9133038bf4ae43cab3897a0859952bf647ed7,1,10,0,10,1,2013-07-02 05:50:58,2013-07-02 04:19:20
09c9133038bf4ae43cab3897a0859952bf647ed7...f1aaa5227a4aa180ba329aa22901e69a413539ef,4,4,4,8,4,2013-07-02 05:50:58,2013-07-02 04:29:35
f1aaa5227a4aa180ba329aa22901e69a413539ef...8686a9e5920540e90eafac6b6bfa2b2fc0eeab10,1,14,5,19,3,2013-07-02 05:50:58,2013-07-02 04:43:29
8686a9e5920540e90eafac6b6bfa2b2fc0eeab10...d64e16f72ef199485291dafa4551f2f58dae9b73,1,0,240,240,1,2013-07-02 05:50:58,2013-07-02 04:44:26
d64e16f72ef199485291dafa4551f2f58dae9b73...bf8b7e50c31a1ac41cf7a21006cede4673eb0dbe,3,36,27,63,6,2013-07-02 05:50:58,2013-07-02 04:58:00
bf8b7e50c31a1ac41cf7a21006cede4673eb0dbe...38462b596ef6c76d87713846e3c60f170f4b2e18,2,13,13,26,4,2013-07-02 05:50:58,2013-07-02 05:36:10
38462b596ef6c76d87713846e3c60f170f4b2e18...0e549a47edf585d2d79c08b06d8284b6ebc8d82c,2,15,1,16,3,2013-07-02 05:50:58,2013-07-02 05:50:26
1919705e40b70b523f3c29c31c236502b6b3beb2...09e468ebc536514f3eb8b262dc62f7260a4d8f84,1,2,1,3,1,2013-06-27 17:11:57,2013-06-27 17:11:57
09e468ebc536514f3eb8b262dc62f7260a4d8f84...86669dc44c9365a734290c3f5f53a7137f8aeabe,1,1,1,2,1,2013-06-27 18:44:02,2013-06-27 18:44:02
1e854ebb31ec0c3e57d569e9f32871d818bf58ea...53affec8696bd4e036bdc471e71f5726dbcf5d60,2,18,11,29,6,2013-06-25 23:00:13,2013-06-25 23:00:13
53affec8696bd4e036bdc471e71f5726dbcf5d60...8aed126bad56e0e98a8bf338ff588fef77bf98c1,2,53,24,77,23,2013-06-27 17:44:55,2013-06-27 17:44:55
8aed126bad56e0e98a8bf338ff588fef77bf98c1...c6a5c89a74a9814298aee03e49b0abd8a0ef23bc,1,18,8,26,8,2013-06-27 21:37:11,2013-06-27 21:37:11
c6a5c89a74a9814298aee03e49b0abd8a0ef23bc...f1853086ed6adf75b9eb54649b5c002964151d09,1,15,5,20,3,2013-06-27 22:23:46,2013-06-27 22:23:46
f1853086ed6adf75b9eb54649b5c002964151d09...317fc8abeed619a2058282015fd5b0dc46053f8e,3,24,26,50,11,2013-07-01 22:31:44,2013-07-01 22:31:44
317fc8abeed619a2058282015fd5b0dc46053f8e...42bc63dc91e9a203be7975cf2d2dd9a333f15212,4,8,14,22,8,2013-07-01 22:33:46,2013-07-01 22:33:46
42bc63dc91e9a203be7975cf2d2dd9a333f15212...0263ca729961e86947829b41254ea763c4c5a324,2,2,3,5,2,2013-07-01 22:37:41,2013-07-01 22:37:41
0263ca729961e86947829b41254ea763c4c5a324...55e9e7e441698ad6d9e41dbcc6966b37ba962af5,5,133,26,159,21,2013-07-02 00:53:24,2013-07-02 00:53:24
c41babfdd71f67aec26b21fff4cdfe9e42070863...06fad56c5ade2f0c47b3415d8e85a4dcc64d6ef6,6,36,19,55,20,2013-06-18 16:40:22,2013-06-18 16:40:22
37fecbd324867da9b80383f6c134d257b187bc38...a59f9aa945b702807b8f200a8a8506e32f586160,1,0,1,1,1,2013-05-23 05:54:37,2013-05-23 05:54:37
a59f9aa945b702807b8f200a8a8506e32f586160...4890e48d60c791ee47ba6dfa8b8f21d145c5130f,1,2,2,4,2,2013-05-24 21:36:41,2013-05-23 17:55:12
4890e48d60c791ee47ba6dfa8b8f21d145c5130f...67f5efeea28ba5128db6cdbb1d58b4b45ef4cc8a,1,3,3,6,2,2013-05-24 22:14:26,2013-05-19 17:10:36
2aec63463ba939204313d997c7010432be40e374...0866b1581447dc06674f0d0eec5e8445894a5f7a,12,207,3,210,15,2013-05-22 18:35:33,2013-05-20 23:22:48
0866b1581447dc06674f0d0eec5e8445894a5f7a...c06ed089fff394f5e2d1fe78ba096e36de5f70cb,1,1,1,2,1,2013-05-22 18:35:33,2013-05-21 00:17:11
c06ed089fff394f5e2d1fe78ba096e36de5f70cb...5b419582d06d441a190da4fc3f1533909d4f76ae,1,0,25,25,1,2013-05-22 18:35:33,2013-05-21 18:32:24
5b419582d06d441a190da4fc3f1533909d4f76ae...701fbc58dd4a2e0c022d78a611497bf18b9b7fa1,1,3,0,3,1,2013-05-22 18:35:33,2013-05-21 18:36:21
701fbc58dd4a2e0c022d78a611497bf18b9b7fa1...157a5a04cedd195f6d7ba5414d993dd682464bdd,6,5,4,9,3,2013-05-22 18:35:33,2013-05-22 18:18:36
939f3ff016a472bd425beb2b694283e8dda17606...dc887a40c8303eb5ec1a20ac20ba9cebd432d9e5,1,2,2,4,2,2013-04-15 21:12:56,2013-04-15 21:12:56
dc887a40c8303eb5ec1a20ac20ba9cebd432d9e5...7825ae7845026302ff0d6cb47d8b60ca63f2d43b,1,13,3,16,4,2013-04-15 22:10:07,2013-04-15 21:59:03
7825ae7845026302ff0d6cb47d8b60ca63f2d43b...49822939c2e7050f0e9eb9d5f9c12608c16d5842,1,3,13,16,4,2013-04-15 23:54:48,2013-04-15 23:54:48
49822939c2e7050f0e9eb9d5f9c12608c16d5842...583508e10d726c75a375825877afcec541516616,2,24,5,29,2,2013-04-16 00:49:12,2013-04-16 00:24:05
bef03af0b27dc0eb5f50b27539417702ad493e38...357d35d19a28fcb5298020d124021104a826a17e,2,15,0,15,2,2013-03-22 22:09:35,2013-03-22 21:50:38
357d35d19a28fcb5298020d124021104a826a17e...a6f01b6c92c1d502e73e27436e4e478eeb883032,1,4,1,5,1,2013-03-22 22:09:35,2013-03-22 21:51:27
63869d033023081fcd34ec7366062b9099de4e8e...9334bb97cad61fd885dcb69fafa962d5e60ff788,2,0,3,3,2,2013-03-07 03:44:54,2013-03-07 03:44:54
9334bb97cad61fd885dcb69fafa962d5e60ff788...0da938955c88517801d8926384ef6fdd2cc57fa7,2,44,17,61,10,2013-03-07 04:04:45,2013-03-07 04:04:25
d1de04dbea8e81510304d14594c1a666e384dcc6...7ca41e4a3c03c4dd89c3add875fb8263e297b9a0,4,87,3,90,5,2013-02-07 03:39:31,2013-01-30 13:27:53
7ca41e4a3c03c4dd89c3add875fb8263e297b9a0...719f2e10dcfaae8a8e7c4681874163c04bf98505,1,7,5,12,3,2013-02-07 03:39:31,2013-02-06 00:34:43
719f2e10dcfaae8a8e7c4681874163c04bf98505...68049c276d1f903711f2bbd8afd749b9d76911aa,5,38,77,115,5,2013-02-07 03:39:31,2013-02-06 00:36:25
68049c276d1f903711f2bbd8afd749b9d76911aa...38c5795c711bf8aec0d8449eef4d12aa2ca88707,2,2,3,5,2,2013-02-07 03:39:31,2013-02-07 03:37:20
297f20d0d81e26c74fd5708d5aa006e2301b1f8d...3bada2a9f972e47c1fb2eb8621c7e233dc451d7d,3,28,8,36,10,2012-12-28 23:58:41,2012-12-28 23:58:41
46e772c0ef7a81bd27e62030c177d8c4e60c5a6a...f54b85cd479f59f3a01f3adbb0458a784fbf22f0,1,3,1,4,2,2013-01-03 18:40:17,2013-01-03 18:40:17
f54b85cd479f59f3a01f3adbb0458a784fbf22f0...25af4e5cdbcc9518be50ebe5196a6f45a91afc88,2,12,2,14,3,2013-01-03 22:56:02,2013-01-03 22:56:02
25af4e5cdbcc9518be50ebe5196a6f45a91afc88...fd13a9b899aca004e8b7baf44c91b84fabaaa40b,1,2,2,4,2,2013-01-03 22:56:45,2013-01-03 22:56:45
fd13a9b899aca004e8b7baf44c91b84fabaaa40b...a9a7179ebf6242ef450711d5c058e86b81ace807,1,12,12,24,2,2013-01-03 23:33:42,2013-01-03 23:33:42
fc432d1465f98387c542376a118b9c08a4d7552a...515e6f28158ded457891df3441420d5ab480da5c,1,1,1,2,1,2013-12-20 21:51:28,2013-12-17 22:05:44
515e6f28158ded457891df3441420d5ab480da5c...995d7282786c899765f90f227f9cc01f0e485f3a,1,47,20,67,5,2013-12-20 21:51:28,2013-12-20 01:25:02
995d7282786c899765f90f227f9cc01f0e485f3a...96c907654418b2b9fb12e26575fc4621ba8c5751,1,7,0,7,3,2013-12-20 21:51:28,2013-12-20 02:19:15
96c907654418b2b9fb12e26575fc4621ba8c5751...508ad66513cc09ff1b44cf3323d1150c3e62321f,2,12,9,21,4,2013-12-20 21:51:29,2013-12-20 21:35:29
508ad66513cc09ff1b44cf3323d1150c3e62321f...c5eefd9504ef9bb415d8f7324e988753b9af5b00,1,10,0,10,1,2013-12-20 21:51:29,2013-12-20 21:45:27
c5eefd9504ef9bb415d8f7324e988753b9af5b00...d98b7ed423731874b255ec1c2df682a995181bbb,1,3,1,4,3,2013-12-20 21:51:29,2013-12-20 21:47:13
d98b7ed423731874b255ec1c2df682a995181bbb...51ad916cafdc78212731345e25d85b61dc66f22d,2,5,3,8,3,2013-12-20 21:53:08,2013-12-20 21:53:08
51ad916cafdc78212731345e25d85b61dc66f22d...42069551405ed7fe9759a8c4a293751f904a75db,1,1,1,2,1,2013-12-20 21:58:30,2013-12-20 21:58:30
42069551405ed7fe9759a8c4a293751f904a75db...5cae2c426a3b599dcd492e2d4514ef22c16b8d84,1,1,1,2,1,2013-12-20 22:21:59,2013-12-20 02:14:22
5cae2c426a3b599dcd492e2d4514ef22c16b8d84...6fc8332c99872b09d8ef416e0b80436bfe3ef662,5,5,5,10,5,2013-12-20 22:23:11,2013-12-20 22:23:11
fa067789de6263eb9ea915942a840234291820ea...2946346c38c27d46bb76ccfa00b1a7b8ddd78653,1,2,4,6,2,2013-11-05 05:11:20,2013-11-04 08:37:57
2946346c38c27d46bb76ccfa00b1a7b8ddd78653...fefe536dc0a4233477a9ab4799b4afd934585005,2,2,1,3,2,2013-11-05 05:15:26,2013-11-05 05:15:26
fefe536dc0a4233477a9ab4799b4afd934585005...47e6f5e3811f7d106537167d645047bac8315593,1,6,6,12,1,2013-11-05 08:53:07,2013-11-05 08:53:07
47e6f5e3811f7d106537167d645047bac8315593...f0103b3416c16ebc0f0e5479dbb0e44d6820431b,1,1,1,2,1,2013-11-05 08:57:45,2013-11-05 08:57:45
9ab15d4c291f78f643208562a1afd38ae962c88a...9e7b4bd21360aedceefad6d316f33a79a781f09b,1,18,8,26,10,2013-10-23 00:58:07,2013-10-23 00:58:07
9e7b4bd21360aedceefad6d316f33a79a781f09b...5884d0b2d1129097aba83c91558fbb830286a6fa,1,1,0,1,1,2013-10-23 01:23:35,2013-10-23 01:20:38
9ab15d4c291f78f643208562a1afd38ae962c88a...da4ed0697c21d8e2f57ac81237e6dc46dde7148d,3,138,0,138,3,2013-10-23 00:42:55,2013-08-22 18:34:13
da4ed0697c21d8e2f57ac81237e6dc46dde7148d...334fbd23f03f7d10e398db37b3635cd899c9f36a,3,13,7,20,5,2013-10-23 00:42:55,2013-08-30 22:43:15
334fbd23f03f7d10e398db37b3635cd899c9f36a...37ad55aaea7f2976a9338a6d1a83089f2ab5cb08,2,15,9,24,5,2013-10-23 00:42:55,2013-08-31 02:53:25
37ad55aaea7f2976a9338a6d1a83089f2ab5cb08...e14b18eb09b87b44eef2af7b40aeca9bc18c6e19,2,3,3,6,2,2013-10-23 00:42:55,2013-09-04 00:16:22
e14b18eb09b87b44eef2af7b40aeca9bc18c6e19...4e16bf498eb98f3c4004a016a2eb71968e4ca57d,1,33,8,41,11,2013-10-23 00:42:55,2013-09-05 19:04:54
4e16bf498eb98f3c4004a016a2eb71968e4ca57d...4abd2a2d6c8ca0e6a0345fa1f3291e93b982528e,4,132,83,215,17,2013-10-23 00:42:55,2013-09-07 01:33:32
4abd2a2d6c8ca0e6a0345fa1f3291e93b982528e...7445056f43a5ab6833e7ed6e75bdfcc82e3c7bfa,2,2,2,4,2,2013-10-23 00:42:55,2013-09-11 18:49:50
7445056f43a5ab6833e7ed6e75bdfcc82e3c7bfa...3f4fc7a9ccfb98bd599a1a9f6fbcb0f6d3360f66,2,10,8,18,7,2013-10-23 00:43:34,2013-09-18 19:13:41
3f4fc7a9ccfb98bd599a1a9f6fbcb0f6d3360f66...c6748f97922b2d177f3dadadab95dfc5200c8504,1,8,1,9,2,2013-10-23 00:43:34,2013-09-18 01:43:31
c6748f97922b2d177f3dadadab95dfc5200c8504...a31f380687785da06a85d25f21cd8ba7b0c13bf8,1,1,1,2,1,2013-10-23 00:43:35,2013-09-19 22:05:20
a31f380687785da06a85d25f21cd8ba7b0c13bf8...41303e7a13e3702fb2a8cc7b6326d3d1a3bf7c81,1,1,1,2,1,2013-10-23 00:43:35,2013-10-04 23:24:29
41303e7a13e3702fb2a8cc7b6326d3d1a3bf7c81...98bba8c0397e071013e10fdcd0e9f6267128c935,1,11,4,15,6,2013-10-23 00:43:35,2013-10-09 20:53:01
98bba8c0397e071013e10fdcd0e9f6267128c935...de8e3154b2162e051fb418b6b4c6c185c4d2db49,1,1,1,2,1,2013-10-23 00:43:35,2013-10-10 21:50:36
de8e3154b2162e051fb418b6b4c6c185c4d2db49...7ff9ba88a68c806033ee8ea5b7cd2dff93c82e5b,1,25,0,25,1,2013-10-23 00:50:00,2013-10-21 04:44:21
7ff9ba88a68c806033ee8ea5b7cd2dff93c82e5b...65928bbbebee551a605c7d82b66200d112c3f5d2,1,3,0,3,1,2013-10-23 00:50:30,2013-10-18 20:28:25
65928bbbebee551a605c7d82b66200d112c3f5d2...87562f0ccd5e29338a5a9cb2e065313238321965,1,20,0,20,5,2013-10-24 23:17:41,2013-10-24 23:17:41
87562f0ccd5e29338a5a9cb2e065313238321965...87e5324a8e5fdeb5bfd617f72bebaaf9e552de44,3,18,8,26,6,2013-10-24 23:40:08,2013-10-24 23:40:08
87e5324a8e5fdeb5bfd617f72bebaaf9e552de44...aadc52922398b8bdad05e6d55782c37664d78753,1,15,15,30,2,2013-10-25 18:51:41,2013-10-25 18:51:41
aadc52922398b8bdad05e6d55782c37664d78753...43fddf982b56d320c377f1fb22db40834a3f8d20,1,2,1,3,2,2013-10-25 18:52:51,2013-10-25 18:52:51
379cc79ea9fdfe3d5cb1da4f569d07c7f454df8c...066955252fb9eff4b8306704f4a2d0ddf5054f0c,2,140,0,140,2,2013-10-29 01:37:55,2013-10-29 01:37:24
066955252fb9eff4b8306704f4a2d0ddf5054f0c...03312eb0a0e724b462b50e1a3168cd45e0e733ed,1,147,21,168,12,2013-10-29 02:32:32,2013-10-29 02:32:32
03312eb0a0e724b462b50e1a3168cd45e0e733ed...b85ae3ccc64c977263f3dee4f206a49489e2fb4e,1,31,14,45,9,2013-10-29 03:15:03,2013-10-29 03:15:03
b85ae3ccc64c977263f3dee4f206a49489e2fb4e...c2da2dac1de39206eb2ad33376d089d6c2ff30b4,3,66,15,81,16,2013-10-30 01:25:18,2013-10-30 01:25:18
c2da2dac1de39206eb2ad33376d089d6c2ff30b4...0f7a261da41ab3d683c7560479ab716f2c6a390e,2,99,18,117,13,2013-10-30 02:03:48,2013-10-30 02:03:48
0f7a261da41ab3d683c7560479ab716f2c6a390e...de71913aa87966c50c2c9d104a9c5b2c16771e3d,2,92,51,143,16,2013-10-30 02:31:32,2013-10-30 02:31:32
de71913aa87966c50c2c9d104a9c5b2c16771e3d...91eedfb8ec42a6de22b42aa5eb3e221ec346b042,2,65,3,68,12,2013-10-30 03:08:15,2013-10-30 03:08:15
91eedfb8ec42a6de22b42aa5eb3e221ec346b042...1241d2f9c88e85396c91e1c0b7d008e9c6ae4aec,1,21,0,21,4,2013-11-01 20:59:44,2013-11-01 20:59:44
1241d2f9c88e85396c91e1c0b7d008e9c6ae4aec...bfc0ce6798bc39a0c2407550ab86e300f24ed77b,4,184,3,187,7,2013-11-01 22:22:42,2013-11-01 22:22:42
bfc0ce6798bc39a0c2407550ab86e300f24ed77b...09fa915fb0474d4dd38b885b9f3a692017fe6e23,4,179,8,187,6,2013-11-01 23:41:50,2013-11-01 23:41:50
09fa915fb0474d4dd38b885b9f3a692017fe6e23...dd4d1c930b8d93bd329aea8969cb9658d6a6d973,3,224,71,295,23,2013-11-02 02:25:37,2013-11-02 02:25:37
dd4d1c930b8d93bd329aea8969cb9658d6a6d973...6970e75f19a9616a161bb422ec275c36fd1e8677,2,0,984,984,3,2013-11-04 18:37:28,2013-11-04 18:37:28
6970e75f19a9616a161bb422ec275c36fd1e8677...a6ca1b3925e1b8d277d74716ad0f0d67a4c2787c,3,221,26,247,21,2013-11-04 23:50:08,2013-11-04 23:50:08
a6ca1b3925e1b8d277d74716ad0f0d67a4c2787c...016fbf7709af8f2d755719aedef4b889884d70f5,1,2,0,2,2,2013-11-04 23:50:47,2013-11-04 23:50:47
016fbf7709af8f2d755719aedef4b889884d70f5...4086612e3167a3cad90996f28e7a8fa229387355,2,270,0,270,2,2013-11-05 04:45:35,2013-11-05 04:45:35
4086612e3167a3cad90996f28e7a8fa229387355...c0186ebd8f1fbe39ec0508a857cf65a35788387f,1,30,0,30,1,2013-11-05 21:39:01,2013-11-05 21:39:01
379cc79ea9fdfe3d5cb1da4f569d07c7f454df8c...cab8ae4e8fb6a4100c9fe3df241b672bafec080a,7,134,27,161,19,2013-10-28 23:45:26,2013-10-24 01:02:47
cab8ae4e8fb6a4100c9fe3df241b672bafec080a...df7ff020cf8e15cb87ebc453e579c58dc1fb53af,1,4,0,4,1,2013-10-29 00:36:32,2013-10-29 00:36:28
df7ff020cf8e15cb87ebc453e579c58dc1fb53af...8e3b1e0e3e733afc4277233a3c39f397bba0632b,2,110,1,111,4,2013-10-29 23:03:27,2013-10-29 23:03:27
280a9f7179f25262ea76cf15c0653a8bce91defb...b8c8b33fff72a25543d4dda2958b3ec3741394af,4,375,0,375,4,2013-09-13 09:43:34,2013-09-13 09:43:34
280a9f7179f25262ea76cf15c0653a8bce91defb...2e10d43041be13eb19269f7341cd74ebfca0f30d,1,49,0,49,1,2013-09-13 08:51:24,2013-09-09 18:48:39
2e10d43041be13eb19269f7341cd74ebfca0f30d...27fd0d506636687c72e7dd860752cd6ada2bb0bb,1,42,69,111,6,2013-09-13 08:51:24,2013-09-09 22:16:23
27fd0d506636687c72e7dd860752cd6ada2bb0bb...b24066d47785e33f7c4f0567930befbaa4b9cf85,1,14,1,15,1,2013-09-13 08:51:24,2013-09-09 22:33:44
b24066d47785e33f7c4f0567930befbaa4b9cf85...f6e307e644223fa3bf90a1c09699a6997075da85,1,2,2,4,2,2013-09-13 08:51:24,2013-09-10 03:43:46
f6e307e644223fa3bf90a1c09699a6997075da85...83136f64aad53aa70058ae3f59137f674535f488,1,6,0,6,1,2013-09-13 08:51:24,2013-09-10 09:54:53
83136f64aad53aa70058ae3f59137f674535f488...05a3a22a6b94e520dffe3385887204c8e3eb3c61,1,7,5,12,3,2013-09-13 08:51:24,2013-09-11 00:05:20
05a3a22a6b94e520dffe3385887204c8e3eb3c61...a6643812a85e0feec9e6a76535cac8d7f69b4d8f,1,3,1,4,1,2013-09-13 08:51:24,2013-09-11 00:12:01
a6643812a85e0feec9e6a76535cac8d7f69b4d8f...eb5d426a7c7abab87557ecba4c13614997091e80,1,1,1,2,1,2013-09-13 08:51:25,2013-09-11 00:13:48
eb5d426a7c7abab87557ecba4c13614997091e80...26422809776068bfa163b56877da5e39eecf2fd7,1,26,30,56,3,2013-09-13 08:51:25,2013-09-13 08:35:05
26422809776068bfa163b56877da5e39eecf2fd7...6c448a213f3b222d41420a1fe331b58f421decb1,1,5,0,5,1,2013-09-13 22:41:53,2013-09-13 22:41:53
6c448a213f3b222d41420a1fe331b58f421decb1...4ed373b2b40179c4784cee3908ad95ab4754e470,1,2,2,4,2,2013-09-13 22:59:36,2013-09-13 22:59:36
4ed373b2b40179c4784cee3908ad95ab4754e470...4345fdbd4b8179fc52becfb32028d52bae4f3d4b,1,3,3,6,2,2013-09-13 23:00:08,2013-09-13 23:00:08
4345fdbd4b8179fc52becfb32028d52bae4f3d4b...48eea25d272dd41ccb315d93574b2365aff09230,1,3,0,3,1,2013-09-16 18:04:08,2013-09-16 18:04:08
227aee3985a9edc34690585b327f9784e678b91d...b24e54e3bfb51deb05141e6662373eca4d2538d5,1,4,0,4,1,2013-10-03 05:12:24,2013-10-03 05:12:24
b24e54e3bfb51deb05141e6662373eca4d2538d5...8633f030e7622cbdb023a1c3b69693e76640fc67,1,1,1,2,1,2013-10-03 05:13:06,2013-10-03 05:13:06
8633f030e7622cbdb023a1c3b69693e76640fc67...8f75185feac47683cd8dbdfb088235bcaf452bf8,2,2,2,4,2,2013-10-03 05:13:23,2013-10-03 05:13:23
8f75185feac47683cd8dbdfb088235bcaf452bf8...165594c239037161bc4856844eb27e9fbfcf2960,2,8,6,14,4,2013-10-03 17:16:06,2013-10-02 22:17:40
165594c239037161bc4856844eb27e9fbfcf2960...1cbd3861fae1a7e082fa52e541552ade5f61b24e,1,10,1,11,1,2013-10-03 17:16:06,2013-10-03 17:15:01
1cbd3861fae1a7e082fa52e541552ade5f61b24e...179177d25b0db4ba89442369926a1ce62dae6424,1,4,0,4,1,2013-10-03 18:32:21,2013-10-03 18:30:42
179177d25b0db4ba89442369926a1ce62dae6424...6ccb6862a977f5b71e98aba4b0a8164485aa3f18,5,16,11,27,7,2013-10-03 20:44:46,2013-10-03 20:44:46
6ccb6862a977f5b71e98aba4b0a8164485aa3f18...072517d788d12496223afbb936468fced577f215,1,7,0,7,1,2013-10-03 20:56:43,2013-10-03 20:56:43
072517d788d12496223afbb936468fced577f215...119682c8ec26e84e63e3e62bf0510d515aa78d97,3,4,19,23,5,2013-10-03 21:55:44,2013-10-03 21:55:44
119682c8ec26e84e63e3e62bf0510d515aa78d97...3b3a51f6e565118c44a763b6ad48ab30ed7c7a6b,1,19,0,19,1,2013-10-03 21:55:59,2013-10-03 21:55:59
3b3a51f6e565118c44a763b6ad48ab30ed7c7a6b...a010bc946f5876e29a7a68f998cfdc009b97c341,1,9,2,11,4,2013-10-03 22:41:20,2013-10-03 22:41:20
a010bc946f5876e29a7a68f998cfdc009b97c341...6e5d73d1815f63d8c20e5d1e3c7e6f27b1026ab9,1,2,8,10,2,2013-10-03 23:22:37,2013-10-03 21:08:19
6e5d73d1815f63d8c20e5d1e3c7e6f27b1026ab9...c7dcc75d70008d88a79e93468d46c27ccbeda95b,1,1,2,3,1,2013-10-03 23:22:37,2013-10-03 22:59:35
c7dcc75d70008d88a79e93468d46c27ccbeda95b...d978f6639bdec6f36222bed42899b006d74fcc46,1,1,1,2,1,2013-10-03 23:22:38,2013-10-03 23:01:02
d978f6639bdec6f36222bed42899b006d74fcc46...09ffdff30b04f9e26c8b8b74d2b99daf5496e9b5,2,0,233,233,3,2013-10-03 23:22:38,2013-10-03 23:03:34
09ffdff30b04f9e26c8b8b74d2b99daf5496e9b5...d35461a4fd471d3660ead7ccd398af8019662b0f,4,71,0,71,4,2013-10-03 23:22:38,2013-10-03 23:04:18
d35461a4fd471d3660ead7ccd398af8019662b0f...7e5dcedb3007848c70948bf4d63c1efadf05442b,1,12,9,21,3,2013-10-03 23:22:38,2013-10-03 23:20:14
7e5dcedb3007848c70948bf4d63c1efadf05442b...932075eacb70381fc40f7903251ef95126ca08e5,5,94,14,108,19,2013-10-04 19:36:52,2013-10-04 19:36:52
932075eacb70381fc40f7903251ef95126ca08e5...ccdeb0c141840fe5335a5fe3133a0f7a7acbf77a,2,34,0,34,2,2013-10-04 20:09:21,2013-10-04 20:09:21
ccdeb0c141840fe5335a5fe3133a0f7a7acbf77a...17129ee45a1b40e2f584324e1a61afbe3d8a54e5,4,52,21,73,14,2013-10-04 20:56:03,2013-10-04 20:55:55
17129ee45a1b40e2f584324e1a61afbe3d8a54e5...25764255ff68be224c4ab5069e1235b258ca943d,5,149,29,178,14,2013-10-04 22:29:37,2013-10-04 22:28:22
25764255ff68be224c4ab5069e1235b258ca943d...d31b82e4dbeed1f9a49c7295ee99bd4639694ca8,1,18,1,19,5,2013-10-04 22:40:43,2013-10-04 22:40:28
d31b82e4dbeed1f9a49c7295ee99bd4639694ca8...f72e0fdeb9babf0ca95f5713e4c0f0b36570cd9c,1,1,1,2,1,2013-10-04 22:40:47,2013-10-04 22:40:47
f72e0fdeb9babf0ca95f5713e4c0f0b36570cd9c...8736e25a41c40443c35154e5eca3dbad6ba27316,1,3,0,3,1,2013-10-05 03:02:06,2013-10-05 03:02:06
8736e25a41c40443c35154e5eca3dbad6ba27316...1d721aba43c4f2f74c80da53bd4196c03a73f48b,1,2,3,5,2,2013-10-05 03:09:04,2013-10-05 03:09:04
1d721aba43c4f2f74c80da53bd4196c03a73f48b...71feaaaf8bad1c71b53f023da6d7ad518f0e2fac,1,10,0,10,1,2013-10-05 03:41:58,2013-10-05 03:41:58
71feaaaf8bad1c71b53f023da6d7ad518f0e2fac...c7c10c7abe802c1c597a4c53f72c8b25637fd9fe,2,16,0,16,2,2013-10-05 03:55:48,2013-10-05 03:55:48
c7c10c7abe802c1c597a4c53f72c8b25637fd9fe...1af3de105c5f1e466891547b97ea3c1e60bf4185,1,0,4,4,1,2013-10-05 05:20:52,2013-10-05 05:14:08
1af3de105c5f1e466891547b97ea3c1e60bf4185...2c727f0dbca983e2dbd66d92f074f91ed5a3c4b5,1,1,1,2,1,2013-10-05 05:20:53,2013-10-05 05:14:29
2c727f0dbca983e2dbd66d92f074f91ed5a3c4b5...599778a791929bb3b36e0590987eb86d66082b2a,4,150,15,165,7,2013-10-05 05:21:58,2013-10-05 05:16:41
599778a791929bb3b36e0590987eb86d66082b2a...67844275b3c15b08ce927d8fb456e5dad25dc22e,3,57,51,108,19,2013-10-05 05:40:34,2013-10-05 05:40:34
67844275b3c15b08ce927d8fb456e5dad25dc22e...2bca593ee3d04daa8e199393748e672cce56b968,1,1,1,2,1,2013-10-05 05:52:14,2013-10-05 05:52:14
2bca593ee3d04daa8e199393748e672cce56b968...c9bcc67dfba3a09789026341a757c7e72972bed1,1,0,4,4,1,2013-10-05 18:16:17,2013-10-05 18:16:17
c9bcc67dfba3a09789026341a757c7e72972bed1...5eeabd985cfb78e2dbdf064bae3da336bf7b5845,1,2,3,5,2,2013-10-05 22:14:26,2013-10-05 22:14:26
5eeabd985cfb78e2dbdf064bae3da336bf7b5845...7cebd55c7f0a659ca919ff0476a128761d2eec43,3,133,40,173,7,2013-10-05 23:57:15,2013-10-05 23:57:15
7cebd55c7f0a659ca919ff0476a128761d2eec43...287f7ab1f329485b7deb1d192acbf10572b5cabb,2,78,15,93,8,2013-10-06 01:01:18,2013-10-06 01:01:18
287f7ab1f329485b7deb1d192acbf10572b5cabb...5a99b948d287b7c0725eac0edf493e2828885b14,1,1,1,2,1,2013-10-06 01:17:17,2013-10-06 01:17:17
2445a2c2cb903f1ff9eb4057f53f8680ff3f3055...2b00ed90bdf096da1eed7307a39ea7914e782af5,1,67,0,67,1,2013-10-02 22:05:48,2013-10-02 22:05:48
bb15c15f30c0d57a82ba986de83802ba74f2f8ec...8d7a3f65915e87bffa612ca72daae3a5821db577,1,8,2,10,4,2013-11-05 06:09:45,2013-11-05 06:09:45
556f6aa979db9c854c3359d6bb9228ca7c1d42c7...3d1c09794f7d87c136dac5ab33ab6cf7b4f9e049,108,913,644,1557,543,2013-07-26 01:54:40,2013-07-20 08:41:05
3d1c09794f7d87c136dac5ab33ab6cf7b4f9e049...d2024ccee11081c89cbffcf3d42d0ab98a8790c5,68,237,219,456,192,2013-07-26 01:54:40,2013-07-20 14:18:51
d2024ccee11081c89cbffcf3d42d0ab98a8790c5...25a3afff544fa9e21d85126cbc1bd6e5a7f05f58,18,62,78,140,29,2013-07-26 01:54:40,2013-07-24 01:08:36
25a3afff544fa9e21d85126cbc1bd6e5a7f05f58...9f38258b54926e820be787798fcf1755bc84e947,162,189,333,522,339,2013-07-26 01:54:40,2013-07-24 02:21:29
9f38258b54926e820be787798fcf1755bc84e947...75cad725e2519b1e48c2cc86e872f5042348b535,2,47,161,208,40,2013-07-26 01:54:40,2013-07-24 02:45:35
75cad725e2519b1e48c2cc86e872f5042348b535...0cbbfb4d5e1f56b1536f6b202d0f18e40599fb55,1,1,1,2,1,2013-07-26 01:54:40,2013-07-24 02:46:09
0cbbfb4d5e1f56b1536f6b202d0f18e40599fb55...060151dd8187f6c1c190733ba79e8fbfe14bbe41,26,60,66,126,52,2013-07-26 01:54:40,2013-07-24 03:17:12
060151dd8187f6c1c190733ba79e8fbfe14bbe41...1e36cdb784c26153cd35bb1ff6d14c977914326e,6,10,8,18,6,2013-07-26 01:54:41,2013-07-24 07:22:18
1e36cdb784c26153cd35bb1ff6d14c977914326e...23d73f07321068d4580885ecec04fb734c5dd4fd,3,5,5,10,5,2013-07-26 01:54:41,2013-07-24 07:26:38
23d73f07321068d4580885ecec04fb734c5dd4fd...95c8384e3bcd930f6f5bc329d1408c1ef6e651c2,3,13,42,55,10,2013-07-26 01:54:41,2013-07-24 07:35:46
95c8384e3bcd930f6f5bc329d1408c1ef6e651c2...5e9d030f139b9a383ba87b00f254944c9ddde9f7,2,2,2,4,2,2013-07-26 01:54:41,2013-07-24 07:41:22
5e9d030f139b9a383ba87b00f254944c9ddde9f7...ccd697c08f7277e6a24127a01601aa55805dd090,1,1,1,2,1,2013-07-26 01:54:41,2013-07-24 07:42:34
ccd697c08f7277e6a24127a01601aa55805dd090...863d0c40b3c1e307d16761148e035ae0ba7089d8,2,13,12,25,7,2013-07-26 01:54:41,2013-07-24 18:08:36
863d0c40b3c1e307d16761148e035ae0ba7089d8...99a0273fb736d97e522a8bcdc1e1e524a13be2e7,1,4,0,4,1,2013-07-26 01:54:41,2013-07-24 18:35:56
99a0273fb736d97e522a8bcdc1e1e524a13be2e7...a57a40ea2cf9a237ded47cdf374341f0a0506719,32,265,242,507,38,2013-07-26 01:54:41,2013-07-24 18:54:07
a57a40ea2cf9a237ded47cdf374341f0a0506719...9755f547a20ce2a394a4d9fdf61931f3e42c599f,1,2,2,4,2,2013-07-26 01:54:41,2013-07-24 20:34:49
9755f547a20ce2a394a4d9fdf61931f3e42c599f...37e2cc4deede5aa5cf9f47bbd14c5b1d981a0892,5,15,13,28,7,2013-07-26 01:54:41,2013-07-24 19:51:52
37e2cc4deede5aa5cf9f47bbd14c5b1d981a0892...cbcafd0c208f8458f1e734f4b23dc405a2ec775b,5,21,17,38,9,2013-07-26 01:54:42,2013-07-24 20:31:42
cbcafd0c208f8458f1e734f4b23dc405a2ec775b...fa2749813989275ebe42fa323fa76cc2ca158116,15,63,81,144,24,2013-07-26 01:54:42,2013-07-24 20:46:53
fa2749813989275ebe42fa323fa76cc2ca158116...db51a3a14c1b7eec46389b99b3360b02514bf407,17,50,101,151,18,2013-07-26 01:54:42,2013-07-25 02:42:33
db51a3a14c1b7eec46389b99b3360b02514bf407...ce16794cbb610764752da82e54118be802330f9d,9,48,55,103,16,2013-07-26 01:54:42,2013-07-25 02:55:05
ce16794cbb610764752da82e54118be802330f9d...a5c061ecdedacd205ca15d3c8c33492a40db97aa,25,89,85,174,72,2013-07-26 01:54:42,2013-07-25 03:13:17
a5c061ecdedacd205ca15d3c8c33492a40db97aa...e4c568b1e1905062c5b3a2cf69784ff6fc8ad404,15,192,156,348,68,2013-07-26 01:54:42,2013-07-25 05:05:10
e4c568b1e1905062c5b3a2cf69784ff6fc8ad404...bc8f251cd19a507f3cd959bbdee259a8a8442ed2,1,0,2,2,1,2013-07-26 01:54:42,2013-07-25 05:46:40
bc8f251cd19a507f3cd959bbdee259a8a8442ed2...3a7eac6dcaea065ebc8cd74d45fdeccacf811176,10,31,21,52,18,2013-07-26 01:54:42,2013-07-25 05:54:47
3a7eac6dcaea065ebc8cd74d45fdeccacf811176...d387e043eae4d30ab2dc9136ba916e38692dc3ea,35,85,85,170,71,2013-07-26 01:54:42,2013-07-25 06:03:24
d387e043eae4d30ab2dc9136ba916e38692dc3ea...2894252578e787fb3e70402319a85a382df9b700,1,1,1,2,1,2013-07-26 01:54:43,2013-07-25 06:04:07
2894252578e787fb3e70402319a85a382df9b700...ae6f226425cdcf978b3f20aff9034bf8423959ab,1,4,2,6,1,2013-07-26 01:54:43,2013-07-25 06:29:28
ae6f226425cdcf978b3f20aff9034bf8423959ab...0faf93b1809290146708846a06214722c0c872d5,1,1,1,2,1,2013-07-26 01:54:43,2013-07-25 06:35:08
0faf93b1809290146708846a06214722c0c872d5...691bd63f9cb90a53f5ab38d636cfe1df8c152f3d,1,1,1,2,1,2013-07-26 01:54:43,2013-07-25 06:35:21
691bd63f9cb90a53f5ab38d636cfe1df8c152f3d...4b3cb9d30580e2b8f8b688f358c777b9619a6263,52,63,63,126,54,2013-07-26 01:54:43,2013-07-26 01:47:08
4b3cb9d30580e2b8f8b688f358c777b9619a6263...1cafd859841350e24aaa32cfc32fd723c83e7b72,7,11,12,23,11,2013-07-26 01:54:43,2013-07-26 01:52:57
36275c570cec37aa313405e98e62f676ebeb717c...cbda2bbae1a0a982ca74f5df9a7804b766367717,1,18,0,18,1,2013-07-12 21:51:11,2013-07-12 21:51:11
cbda2bbae1a0a982ca74f5df9a7804b766367717...3311517ecf5b69a287193d47c8b134e5d50a75ba,1,5,1,6,1,2013-07-12 21:59:40,2013-07-12 21:52:32
3311517ecf5b69a287193d47c8b134e5d50a75ba...d2eb68c60b02e698d7eab3c516b6ddd0b0806286,1,1,1,2,1,2013-07-12 23:00:53,2013-07-12 23:00:53
d2eb68c60b02e698d7eab3c516b6ddd0b0806286...7617d8931aec153fd4148c16af5f98262ededaa4,3,6,1,7,4,2013-07-13 00:36:40,2013-07-13 00:36:40
7617d8931aec153fd4148c16af5f98262ededaa4...4cd63ca3707701edeb20d036659184951fbfd2af,1,1,1,2,1,2013-07-13 03:25:21,2013-07-10 11:11:00
4cd63ca3707701edeb20d036659184951fbfd2af...8326941c52d853b2021e071bd754c6d7d685d0a3,1,1,1,2,1,2013-07-13 03:25:37,2013-07-10 11:15:01
8326941c52d853b2021e071bd754c6d7d685d0a3...31dc4d3df82237ed4257c42abe2b107ebad9901b,1,3,0,3,1,2013-07-13 03:25:44,2013-07-10 11:16:40
31dc4d3df82237ed4257c42abe2b107ebad9901b...7b6533864320334346c05fcabc4bc5966433495f,1,2,2,4,2,2013-07-13 03:26:03,2013-07-12 00:10:36
a3cdb118469b7837531911330f758de9a9d48038...f471d0eaa93c55f1e7944896274ca34448fdf632,1,13,0,13,3,2013-07-10 04:52:38,2013-07-10 04:52:38
f471d0eaa93c55f1e7944896274ca34448fdf632...6ff3afd164aae65b9c2f8fe8ba7657ec82b5376c,2,16,3,19,4,2013-07-10 18:06:39,2013-07-10 18:06:02
6e8668d52fe0c38605060da0d86665e5f45cbd41...1ed49bb4ee34e55320d18f5bc18d4c0087bd0d12,1,6,2,8,4,2013-07-02 21:02:10,2013-07-02 21:01:52
1ed49bb4ee34e55320d18f5bc18d4c0087bd0d12...ce401d6e4806d2c0ca50c0aefdbaedaeaab62448,1,1,1,2,1,2013-07-02 21:50:04,2013-07-02 21:49:17
ce401d6e4806d2c0ca50c0aefdbaedaeaab62448...e2951cca6cc03d090d530219ccae470c4a606513,11,29,29,58,19,2013-07-02 22:11:45,2013-07-02 22:11:45
e2951cca6cc03d090d530219ccae470c4a606513...d8a955b98908aeacef249c24172fb8fb28d2ed2d,1,1,1,2,1,2013-07-02 22:18:01,2013-07-02 22:17:42
d8a955b98908aeacef249c24172fb8fb28d2ed2d...053db8e9e9cf03ec2a9a7f31c0497682094190d2,11,98,79,177,22,2013-07-02 23:15:12,2013-07-02 22:54:35
053db8e9e9cf03ec2a9a7f31c0497682094190d2...1f26045fe01496eb770255041151906cd80541ce,4,19,15,34,10,2013-07-02 23:15:12,2013-07-02 23:03:30
1f26045fe01496eb770255041151906cd80541ce...e38bf5e1ab416894b5bd146895454773945c0183,2,16,17,33,9,2013-07-02 23:15:12,2013-07-02 23:11:34
e38bf5e1ab416894b5bd146895454773945c0183...c4609fc04c82d0c2f62019964baf06f8ffcc7933,2,10,8,18,5,2013-07-02 23:15:12,2013-07-02 23:14:54
c4609fc04c82d0c2f62019964baf06f8ffcc7933...e4fd5d0a4868ee9ddf17258b3e4a8d743128211f,1,2,0,2,1,2013-07-02 23:21:33,2013-07-02 23:21:33
e4fd5d0a4868ee9ddf17258b3e4a8d743128211f...a753284c6df9f785f7fa0d23b947187dfcf42a8e,1,10,1,11,1,2013-07-02 23:41:10,2013-07-02 23:41:10
a753284c6df9f785f7fa0d23b947187dfcf42a8e...12a93615cfda92ca7650ffe4d717d92d4877fbf4,1,7,6,13,5,2013-07-03 02:50:38,2013-07-03 02:50:38
21ed1bdbe03507796dee785732526855aa4ce9e5...7bfa8b9c88a1f50c187c53f2fedde3be2a11aaef,3,23,9,32,4,2013-07-02 02:54:09,2013-07-02 02:54:09
7bfa8b9c88a1f50c187c53f2fedde3be2a11aaef...9d79d39124d4533befafcfe4156ee8ec2549c775,2,220,211,431,34,2013-07-02 19:40:26,2013-07-02 19:40:26
9d79d39124d4533befafcfe4156ee8ec2549c775...0052cb9670645fb1d647fd57356be8ef0abe89ca,4,252,2,254,4,2013-07-04 03:31:06,2013-07-04 03:31:06
0052cb9670645fb1d647fd57356be8ef0abe89ca...98012974b18a411a4181d6b0fea27354d073133d,1,10,1,11,5,2013-07-04 22:35:00,2013-07-04 22:35:00
98012974b18a411a4181d6b0fea27354d073133d...0d39d0a18b54c5420b70af92ffe67bed33b46420,4,106,0,106,6,2013-07-04 23:54:53,2013-07-04 23:54:53
0d39d0a18b54c5420b70af92ffe67bed33b46420...bec3e5e4a55cdd3ce9e6697344674068bbfaae1c,1,83,0,83,1,2013-07-05 00:52:59,2013-07-05 00:52:59
bec3e5e4a55cdd3ce9e6697344674068bbfaae1c...733fb08e1c572c1c9185a1d8520091ee85eac140,1,2,2,4,2,2013-07-05 22:39:44,2013-07-05 22:39:44
733fb08e1c572c1c9185a1d8520091ee85eac140...c3118bbcc52a5034c17fc2ceeb6a44bf01ed280e,1,4574,4225,8799,776,2013-07-05 22:40:01,2013-07-05 22:40:01
c3118bbcc52a5034c17fc2ceeb6a44bf01ed280e...fbcd67ac44011883964a933a34f6277b5232c1e9,2,10,6,16,3,2013-07-05 22:40:23,2013-07-05 22:40:23
fbcd67ac44011883964a933a34f6277b5232c1e9...26ef5c06cc71052c79a3a5a099cea533c9397f39,4,132,2,134,8,2013-07-05 22:43:24,2013-07-05 22:43:24
26ef5c06cc71052c79a3a5a099cea533c9397f39...ff8673f59412c4f5040709d4f3495e2829694f2e,3,491,160,651,16,2013-07-07 22:10:18,2013-07-07 22:10:18
ff8673f59412c4f5040709d4f3495e2829694f2e...02fd4dc15db1dac523cb305d97f1275ac0f06dbe,1,68,7,75,6,2013-07-07 23:43:58,2013-07-07 23:43:40
02fd4dc15db1dac523cb305d97f1275ac0f06dbe...f21b0d98ac62419befdcd47c98c1e8e7f29d37e5,3,92,14,106,15,2013-07-08 00:13:18,2013-07-08 00:13:18
f21b0d98ac62419befdcd47c98c1e8e7f29d37e5...c70717e03257b85b1c514b7f54736aac16c1119f,2,1,1,2,1,2013-07-08 00:21:17,2013-07-08 00:21:17
c70717e03257b85b1c514b7f54736aac16c1119f...e0603d8326e02a2362066832c5e3b2cee36000a7,2,108,16,124,9,2013-07-08 01:22:02,2013-07-08 01:22:02
e0603d8326e02a2362066832c5e3b2cee36000a7...10b463352e8aa688b4f2e1ac6203b4f517a54711,2,76,59,135,26,2013-07-08 01:52:34,2013-07-08 01:52:34
10b463352e8aa688b4f2e1ac6203b4f517a54711...8e2260a7fdf5bd8b6a83227d781efffd864c6518,2,2,1,3,2,2013-07-08 02:00:52,2013-07-08 02:00:52
8e2260a7fdf5bd8b6a83227d781efffd864c6518...5f5ede78e0fcea8d67324388c22d47ed9aba1830,1,11,1,12,1,2013-07-08 02:08:03,2013-07-08 02:08:03
5f5ede78e0fcea8d67324388c22d47ed9aba1830...1b276afc49cabc05f83f5921ba8b40785b15b1b8,4,53,11,64,6,2013-07-08 02:25:19,2013-07-08 02:25:19
1b276afc49cabc05f83f5921ba8b40785b15b1b8...2bcecf5de0f73fb6249e717cd7a6b9aee8b56679,1,29,10,39,5,2013-07-08 02:52:36,2013-07-08 02:52:36
2bcecf5de0f73fb6249e717cd7a6b9aee8b56679...4ec6f22683e5a4e19be6108d1bde0d7e9fac428f,1,2,1,3,1,2013-07-08 02:53:09,2013-07-08 02:53:09
4ec6f22683e5a4e19be6108d1bde0d7e9fac428f...18cd889c54218e5efcf97d4f10291b0cd1b2114c,5,150,22,172,10,2013-07-08 18:21:06,2013-07-08 18:21:06
18cd889c54218e5efcf97d4f10291b0cd1b2114c...f894d150531ba6347e9f6649741e788380d3eebf,2,44,28,72,9,2013-07-08 19:04:00,2013-07-08 19:04:00
f894d150531ba6347e9f6649741e788380d3eebf...f0a662f7a48836f93cc8abeceafddcd416426add,4,311,57,368,19,2013-07-09 03:13:57,2013-07-09 03:13:57
f0a662f7a48836f93cc8abeceafddcd416426add...934e4378d83881fb1fedfa0b201b7bf0b645b747,2,24,9,33,7,2013-07-09 04:03:18,2013-07-09 04:03:18
934e4378d83881fb1fedfa0b201b7bf0b645b747...d00ca62a22102e89fd01882b45a80435b4524e90,1,61,46,107,13,2013-07-09 18:04:25,2013-07-09 18:04:25
d00ca62a22102e89fd01882b45a80435b4524e90...7bc15f2030500f15b04d786c01492ff7c6b8a1f6,5,225,139,364,21,2013-07-09 22:47:39,2013-07-09 22:47:39
7bc15f2030500f15b04d786c01492ff7c6b8a1f6...3b4cfd9482902d450ff919c36cde60cee34f0eed,7,65,15,80,15,2013-07-10 00:10:47,2013-07-10 00:02:53
3b4cfd9482902d450ff919c36cde60cee34f0eed...7230c2f54349bedae3e7162158ece6a8e1ee4ff6,3,11,4,15,7,2013-07-10 00:11:57,2013-07-10 00:11:05
7230c2f54349bedae3e7162158ece6a8e1ee4ff6...e48f4684cb19a876de7cfa081347d004bccb9859,3,18,1,19,3,2013-07-10 00:38:43,2013-07-10 00:38:43
e48f4684cb19a876de7cfa081347d004bccb9859...0299cdd1b89fc8d681af3b9083566d4f2d56086c,1,0,91,91,1,2013-07-10 00:50:53,2013-07-10 00:50:53
0299cdd1b89fc8d681af3b9083566d4f2d56086c...2eac5707575b9d47973362e8f5734dd0cade025c,5,46,51,97,23,2013-07-10 01:01:50,2013-07-10 00:54:31
2eac5707575b9d47973362e8f5734dd0cade025c...7d1d8069d6bde1c0e1205c130c560df36c523f43,2,12,5,17,2,2013-07-10 01:02:51,2013-07-10 01:02:51
7d1d8069d6bde1c0e1205c130c560df36c523f43...16624569ecf34337b17e9222b31201265be04a15,5,53,13,66,6,2013-07-10 02:07:17,2013-07-10 02:06:49
86669dc44c9365a734290c3f5f53a7137f8aeabe...7046d4cc9115743331c74c3cae9d3d4f84c80445,4,76,7,83,7,2013-06-28 21:55:47,2013-06-19 18:19:04
7046d4cc9115743331c74c3cae9d3d4f84c80445...e6078ba108f9d7b94a9cf541658a86142f0fb942,1,1,1,2,1,2013-06-28 21:55:47,2013-06-28 21:53:43
f6b644cc0df70b1174eb3b6f7aae6d9285d7a4fe...a872fe9565f7d54eea7c50841730ab83b42b7782,1,5,4,9,3,2013-06-20 23:25:21,2013-06-20 23:25:21
a872fe9565f7d54eea7c50841730ab83b42b7782...e7451a406f23c7b1490d63e0061df13b9c4984ee,2,91,89,180,17,2013-06-24 21:45:25,2013-06-24 21:45:25
e7451a406f23c7b1490d63e0061df13b9c4984ee...fbfd3fb824b85a2d23cacbe3caa9b831e1f099a8,2,16,1,17,4,2013-06-24 21:51:17,2013-06-24 21:51:17
fbfd3fb824b85a2d23cacbe3caa9b831e1f099a8...6551e3a366ea3691aed62121b80820fe6fe91831,5,28,25,53,17,2013-06-25 12:08:14,2013-06-25 12:08:14
6551e3a366ea3691aed62121b80820fe6fe91831...62fb1f4bf2d6e4ac5bd572a3db5b89b6d233cc08,1,2,2,4,2,2013-06-25 12:57:58,2013-06-25 12:57:58
62fb1f4bf2d6e4ac5bd572a3db5b89b6d233cc08...ae295659d0585593adde88db2e98aedec601eabd,2,25,6,31,5,2013-06-25 19:13:42,2013-06-25 19:13:42
ae295659d0585593adde88db2e98aedec601eabd...b3b2c269363979306d2c3ddbc8da4187289c129b,4,24,24,48,16,2013-06-25 20:41:29,2013-06-25 20:41:29
67f5efeea28ba5128db6cdbb1d58b4b45ef4cc8a...7e9f36a583635e913e350d13e9a4e645fc6689bc,2,48,2,50,3,2013-05-24 22:31:11,2013-05-24 20:49:10
7e9f36a583635e913e350d13e9a4e645fc6689bc...a90b3218546572f5417af97db3afd3e672732746,3,10,9,19,6,2013-05-24 22:34:15,2013-05-24 22:34:15
d5680c6a3716025d955d25a9afcdb52bc931ab30...18050d9471236d10d48e60c767297c55fa6aeb84,3,14,12,26,14,2013-09-25 22:44:12,2013-09-25 22:44:12
18050d9471236d10d48e60c767297c55fa6aeb84...399028eb53b41b5d1bb3cd645bc6f292a35a729d,2,18,1,19,4,2013-09-26 01:13:46,2013-09-26 01:13:46
399028eb53b41b5d1bb3cd645bc6f292a35a729d...86565853b15307d248a964b4bdc85390f0f5d630,1,0,3,3,1,2013-09-26 01:19:59,2013-09-26 01:19:59
86565853b15307d248a964b4bdc85390f0f5d630...0286395700d4e2abcacb1fb34ae89254d4adde48,1,15,1,16,2,2013-09-26 21:22:23,2013-09-26 21:22:23
0286395700d4e2abcacb1fb34ae89254d4adde48...1964d2e88ec52b53561cd7d9ccc82651a42b2336,1,17,2,19,5,2013-09-26 21:48:13,2013-09-26 21:48:13
1964d2e88ec52b53561cd7d9ccc82651a42b2336...58ad24d9328863c79120a4ffd006468f073bd705,1,78,73,151,5,2013-09-26 21:48:53,2013-09-26 21:48:53
58ad24d9328863c79120a4ffd006468f073bd705...3f6c14aedfb97ac264f4ad738c221467ce0928c9,1,2,2,4,2,2013-09-27 19:37:22,2013-09-27 19:37:22
3f6c14aedfb97ac264f4ad738c221467ce0928c9...1dd83b1d2c5f5d72e009c83aea900536cf5465bf,1,81,81,162,5,2013-09-27 20:18:09,2013-09-27 20:18:09
1dd83b1d2c5f5d72e009c83aea900536cf5465bf...e1aa2450e9ad4c0bb4c7ae7f6987af9352b3aa99,1,12,12,24,2,2013-09-27 20:38:50,2013-09-27 20:38:50
e1aa2450e9ad4c0bb4c7ae7f6987af9352b3aa99...d8d9206f4b630f4956f5a3ad3a66a65282c19d5e,2,5,17,22,6,2013-09-27 20:53:09,2013-09-27 20:53:09
d8d9206f4b630f4956f5a3ad3a66a65282c19d5e...db03f574a3f77ca73c3f74a6b025cc2d8efdd2b6,3,25,5,30,7,2013-09-27 21:46:10,2013-09-27 21:46:10
db03f574a3f77ca73c3f74a6b025cc2d8efdd2b6...ff143f94b77125cf5fd2fd743ffc637afa17ed66,1,1,1,2,1,2013-09-27 21:58:59,2013-09-27 21:58:59
ff143f94b77125cf5fd2fd743ffc637afa17ed66...bc3ea63752a7f7d94efd35c0265f34a9a646639b,1,2,1,3,1,2013-09-27 22:10:18,2013-09-27 22:10:18
bc3ea63752a7f7d94efd35c0265f34a9a646639b...2b082db1a8a1d2d13bca11eec1c9e7c9b17658d6,1,118,87,205,12,2013-09-27 22:10:34,2013-09-27 21:55:46
2b082db1a8a1d2d13bca11eec1c9e7c9b17658d6...e56428dceba6d51f3ce6aaaef552e1eff8dcef6b,1,32,30,62,13,2013-09-27 23:06:28,2013-09-27 23:06:28
e56428dceba6d51f3ce6aaaef552e1eff8dcef6b...2b4d4974fa1a54afa74886a98b1f832138c3ed64,1,2,2,4,2,2013-09-27 23:07:55,2013-09-27 23:07:55
2b4d4974fa1a54afa74886a98b1f832138c3ed64...6494ec563fba223c3f168019d9fd459600e511fc,6,76,60,136,27,2013-09-28 01:50:39,2013-09-28 01:50:39
6494ec563fba223c3f168019d9fd459600e511fc...3e87c8f9d556351bd0e6ead91078ded4e485ced3,2,39,3,42,4,2013-09-28 01:54:50,2013-09-28 00:53:06
3e87c8f9d556351bd0e6ead91078ded4e485ced3...2724bd0d84c27952f43f67c10c352752c02c1529,4,147,8,155,10,2013-09-28 02:10:09,2013-09-28 01:53:23
2724bd0d84c27952f43f67c10c352752c02c1529...22d3a56b813fa28ba219e69da86b103412dae545,1,0,7,7,1,2013-09-28 02:13:42,2013-09-28 02:13:42
22d3a56b813fa28ba219e69da86b103412dae545...6329cedc51a9f48bf7e00876e1b82c09330b3536,1,8,3,11,3,2013-09-28 02:41:24,2013-09-28 02:41:24
6329cedc51a9f48bf7e00876e1b82c09330b3536...f7d33c734d029af6069a2d42e667043e6da1ce52,4,195,11,206,10,2013-09-29 06:03:47,2013-09-29 05:58:19
f7d33c734d029af6069a2d42e667043e6da1ce52...7cba2923f55e7ca674dd7bd9561e3f2a441b0634,1,34,1,35,2,2013-09-29 06:14:37,2013-09-29 06:14:37
7cba2923f55e7ca674dd7bd9561e3f2a441b0634...dd44f6b165acbf21b6c36fe4ca4c6484a3220394,1,36,56,92,31,2013-09-30 18:06:16,2013-09-30 18:06:16
dd44f6b165acbf21b6c36fe4ca4c6484a3220394...1bbb34e6023ad99442df12e865c0d22e39b9dbbc,1,3,8,11,6,2013-09-30 18:21:11,2013-09-30 18:21:11
9d72fb5b8659f06db80d88095881ba6c46c480ee...4ecd7c32b4eb169fe71bc26709bd15baa231d5b7,1,5,0,5,1,2013-05-22 18:40:52,2013-05-22 18:40:52
4ecd7c32b4eb169fe71bc26709bd15baa231d5b7...77092dfe1d04265fd8054bf4a1700d18e855cdc6,2,37,14,51,8,2013-05-22 18:43:57,2013-05-22 18:42:33
77092dfe1d04265fd8054bf4a1700d18e855cdc6...1be18e2538c8a4c302545bd6b38bf5b66126433a,1,11,8,19,5,2013-05-22 20:22:07,2013-05-22 20:22:07
1be18e2538c8a4c302545bd6b38bf5b66126433a...3daf6a733b050182833f2f5f9902a3e25b68ff21,2,27,17,44,6,2013-05-22 21:08:28,2013-05-22 21:08:28
3daf6a733b050182833f2f5f9902a3e25b68ff21...6773112254cfd75d95c74c5897b9ad537192edef,2,8,4,12,3,2013-05-22 22:22:01,2013-05-22 22:22:01
6773112254cfd75d95c74c5897b9ad537192edef...f6f69abd0b6a87fcc39f78dda9e619908011f50a,3,11,24,35,7,2013-05-22 23:36:10,2013-05-22 23:36:10
f6f69abd0b6a87fcc39f78dda9e619908011f50a...92406c1e3ec0ef6080cd6233d6192424116bd795,1,0,1,1,1,2013-05-23 00:36:08,2013-05-23 00:30:11
92406c1e3ec0ef6080cd6233d6192424116bd795...d0f042eb82d58f2e2de9decb439793f65678097d,1,30,1,31,2,2013-05-23 00:36:08,2013-05-23 00:31:23
d0f042eb82d58f2e2de9decb439793f65678097d...5a84a01d17c568f69fd4f449c6873c0ccaa1ff23,1,1,1,2,1,2013-05-23 01:13:16,2013-05-23 01:13:16
5a84a01d17c568f69fd4f449c6873c0ccaa1ff23...d57b2e2b4d77253559bbb5beb80dfce51bddf9f6,2,21,19,40,3,2013-05-23 01:13:36,2013-05-23 01:13:36
d57b2e2b4d77253559bbb5beb80dfce51bddf9f6...361d1219341ddcb2e16baac892e34a7ab44a0150,1,20,13,33,9,2013-05-23 18:04:19,2013-05-23 18:04:19
361d1219341ddcb2e16baac892e34a7ab44a0150...8db6438fb59acee7bcab7664e3cbb54aec65ec9c,1,28,1,29,2,2013-05-23 19:11:21,2013-05-23 18:56:08
8db6438fb59acee7bcab7664e3cbb54aec65ec9c...bab43785d880f9c307a220980de58d31206505f6,1,1,1,2,1,2013-05-23 19:16:13,2013-05-23 19:16:13
bab43785d880f9c307a220980de58d31206505f6...8098dbdc030554d78548bfc3c2be052fc35bc717,1,2,1,3,2,2013-05-23 20:43:50,2013-05-23 20:43:50
8098dbdc030554d78548bfc3c2be052fc35bc717...359464c97b20769f4446ca7819cec4e758e11a8f,1,24,12,36,8,2013-05-23 23:14:20,2013-05-23 23:14:20
359464c97b20769f4446ca7819cec4e758e11a8f...2cd6b2a7b20efb4b37182754a98be9d2328a2230,2,55,2,57,4,2013-05-24 18:07:13,2013-05-24 16:44:45
2cd6b2a7b20efb4b37182754a98be9d2328a2230...82c6efb5dd36015f1e391f04668302598030a30a,1,11,8,19,7,2013-05-24 22:07:20,2013-05-24 22:07:20
82c6efb5dd36015f1e391f04668302598030a30a...9631221336496348893e96bf33ceddbfbf9a66cd,1,2,2,4,2,2013-05-24 22:09:04,2013-05-24 22:09:04
9631221336496348893e96bf33ceddbfbf9a66cd...e3a33ec0ddb266882990bb46b484f45e7ebd5a62,1,9,9,18,7,2013-05-24 22:13:28,2013-05-24 22:13:28
e3a33ec0ddb266882990bb46b484f45e7ebd5a62...9234205af3a13e1e8ada90340127b9e1e7d012c8,1,2,5,7,1,2013-05-24 22:39:37,2013-05-24 22:39:37
9234205af3a13e1e8ada90340127b9e1e7d012c8...1651ecbbd6eb6f8a2f152cf7aa7d9bf4be9c20af,1,8,3,11,4,2013-05-24 23:22:43,2013-05-24 23:22:43
1651ecbbd6eb6f8a2f152cf7aa7d9bf4be9c20af...5545a62985c6e56d6ec2e7568c23dbbfa70f4709,2,102,76,178,48,2013-05-24 23:27:21,2013-04-06 04:33:20
5545a62985c6e56d6ec2e7568c23dbbfa70f4709...285b09818a819fccd36edb6fbee614f90e914297,1,2,3,5,2,2013-05-24 23:27:26,2013-04-06 04:36:29
285b09818a819fccd36edb6fbee614f90e914297...f8f1eb3cb057f8e2d30439b885207070b590cdc9,1,5,0,5,4,2013-05-28 18:01:31,2013-05-28 18:01:12
f8f1eb3cb057f8e2d30439b885207070b590cdc9...1a35b699e2dd8fc7c03972909a180285bffd7bd6,1,1,1,2,1,2013-05-28 18:01:58,2013-05-28 18:00:57
1a35b699e2dd8fc7c03972909a180285bffd7bd6...74308f7d81d6e795e4ec2b07f2c1c90f3e402fa2,1,1,0,1,1,2013-05-28 19:12:42,2013-05-28 19:12:42
74308f7d81d6e795e4ec2b07f2c1c90f3e402fa2...6299f69754f8b4eab9e92b9751474390f6bdd5f4,8,77,45,122,23,2013-05-28 19:14:11,2013-05-24 23:53:01
583508e10d726c75a375825877afcec541516616...2294da1297423147011ffd8441092026abdcd26a,1,42,41,83,4,2013-04-16 18:13:32,2013-04-16 18:13:32
583508e10d726c75a375825877afcec541516616...21b1b1242741513112031f8c54366fd1d166ba38,2,2,2,4,2,2013-04-16 16:47:05,2013-04-06 02:24:35
21b1b1242741513112031f8c54366fd1d166ba38...81c5e19b2d3fbcaba8dcb6b483169acb78f43b4a,2,102,76,178,48,2013-04-16 16:47:05,2013-04-06 04:33:20
81c5e19b2d3fbcaba8dcb6b483169acb78f43b4a...7aea849ce7427edbcbf46da7adb8dbcd126e4637,1,2,3,5,2,2013-04-16 16:47:05,2013-04-06 04:36:29
7aea849ce7427edbcbf46da7adb8dbcd126e4637...10a59dcaf2935311c55c94f68291fa58d797be90,2,9,4,13,2,2013-04-16 16:47:05,2013-04-09 01:17:10
10a59dcaf2935311c55c94f68291fa58d797be90...4b388d39e238a6c087884687de93b31782838981,2,14,4,18,5,2013-04-16 16:47:06,2013-04-15 21:59:03
4b388d39e238a6c087884687de93b31782838981...2357a9329e4327165e7343cb62f9e7d433e28b57,1,4,2,6,2,2013-04-16 16:47:06,2013-04-16 16:38:10
2357a9329e4327165e7343cb62f9e7d433e28b57...8f74d64614d6c7b49b5803142980361ce75e5f9b,1,2,2,4,2,2013-04-16 16:47:06,2013-04-16 16:46:46
8f74d64614d6c7b49b5803142980361ce75e5f9b...59ca390b75b9d09a3b859b652f6ba0d722dc1881,3,4,4,8,4,2013-04-16 17:58:09,2013-04-16 17:58:09
59ca390b75b9d09a3b859b652f6ba0d722dc1881...fd4de69e712fc24b9c54a6bb5b88003e8e591aa7,2,3,3,6,3,2013-04-17 19:42:43,2013-04-17 19:42:43
9dcedace31fb49fedc2c08ab44c65894bc8b8cd2...f05064aa7760583adb12dcf4e7a1491cc6d7051f,1,4,1,5,2,2013-03-22 22:14:11,2013-03-22 22:14:11
f05064aa7760583adb12dcf4e7a1491cc6d7051f...2aec0f636cd4a78eaa15cc38bd8de0e8a6216921,2,68,32,100,27,2013-03-22 23:01:21,2013-03-22 23:01:21
0da938955c88517801d8926384ef6fdd2cc57fa7...a6b03d0ded3e0efbc462330bbd86691a68ce89b1,2,3,3,6,3,2013-03-07 08:13:37,2013-03-07 08:13:37
a6b03d0ded3e0efbc462330bbd86691a68ce89b1...8b536c1f5a73710681540e4e30be6bb1ce90584c,1,0,6,6,1,2013-03-07 08:25:24,2013-03-07 08:25:24
8b536c1f5a73710681540e4e30be6bb1ce90584c...551a31712bcf6294b1b15bd9da792d1347154c92,1,5,1,6,1,2013-03-07 08:25:45,2013-03-07 08:25:45
551a31712bcf6294b1b15bd9da792d1347154c92...52173e30cfec3295cb5aa16a291f829c02a4a50b,1,1,1,2,1,2013-03-07 08:33:04,2013-03-07 08:33:04
52173e30cfec3295cb5aa16a291f829c02a4a50b...7022916fb4a6f895e93c74b5b831bc4f1ba2c231,1,101,75,176,47,2013-03-07 16:15:25,2013-03-07 16:15:25
7022916fb4a6f895e93c74b5b831bc4f1ba2c231...62fc2625d0b0597150a06055ada5129ee8cbc53c,1,6,0,6,1,2013-03-07 16:21:44,2013-03-07 16:21:44
0da938955c88517801d8926384ef6fdd2cc57fa7...e2bdb409105fb2a67819251d2563e4158539bd36,1,27,0,27,1,2013-03-07 04:05:40,2013-03-07 04:05:40
66c94bfed60514acc19b4b0829c989a3a50d793a...d4534c5f1521c6f5b402ab3286410adad3fe4042,3,7,4,11,5,2013-02-08 04:39:05,2013-02-07 17:15:25
3bada2a9f972e47c1fb2eb8621c7e233dc451d7d...577e1b6b12a8c47673aa3de53cb98bf377bd58f6,2,40,0,40,2,2013-01-03 02:07:58,2013-01-03 01:39:25
577e1b6b12a8c47673aa3de53cb98bf377bd58f6...5eae5eae4c18183ed91249c13a27796dd061ec89,2,37,2,39,2,2013-01-03 02:10:48,2013-01-03 02:05:01
a9a7179ebf6242ef450711d5c058e86b81ace807...864371f9abe93fd91be948e89a17c594973f52b4,9,15,10,25,9,2013-01-08 18:40:52,2013-01-08 18:40:52
864371f9abe93fd91be948e89a17c594973f52b4...2d27799008fb87a06d4119c48097aa382d230b61,1,0,2,2,1,2013-01-08 18:41:01,2013-01-08 06:14:04
cbde5bd4875524f3ade7f3baef417a43ec1b9474...4af3116d3faa3c4416dcfa49e32ea1d73dc15dc5,1,1,1,2,1,2014-02-07 07:59:20,2014-02-07 07:59:20
b684ca9554d2184665772f740bdd569be24bb3f7...f0f7ae2d16260e671252a29f34736aa2c7f0bfc5,1,2,0,2,1,2013-12-17 20:12:20,2013-12-17 18:49:27
f0103b3416c16ebc0f0e5479dbb0e44d6820431b...9a47e73392c4c13b5171a36c5a5735b1b8ee8d2b,12,334,0,334,12,2013-11-05 23:41:23,2013-10-28 21:04:19
9a47e73392c4c13b5171a36c5a5735b1b8ee8d2b...971d93ae24cfa32a94d8c3b3f23b2829a80ff9c2,3,127,94,221,21,2013-11-05 23:41:23,2013-09-21 23:12:39
971d93ae24cfa32a94d8c3b3f23b2829a80ff9c2...28aa83d77422da5f74cf2b4c9c5d89c77f31463a,3,5,0,5,3,2013-11-05 23:41:23,2013-10-23 06:20:23
28aa83d77422da5f74cf2b4c9c5d89c77f31463a...4500a1aa6daaf7b38705ef03fa0c99c8fdafa2be,4,12,53,65,4,2013-11-05 23:41:24,2013-11-05 23:29:31
5884d0b2d1129097aba83c91558fbb830286a6fa...9b58e3a21cfc38966af6a4fb1c9898b175eb8488,1,32,18,50,1,2013-10-23 05:00:24,2013-10-23 05:00:24
5884d0b2d1129097aba83c91558fbb830286a6fa...7dabf1437d488216f470da30d5f854dff6ff0034,3,74,0,74,5,2013-10-23 01:23:41,2013-08-14 20:36:44
7dabf1437d488216f470da30d5f854dff6ff0034...4d5dddb086acba7e263dfc7480717149593b41b8,3,116,63,179,20,2013-10-23 01:23:41,2013-08-15 02:08:47
4d5dddb086acba7e263dfc7480717149593b41b8...9e3541e25efc27863d8f44f2e1b9e3bae259caae,1,61,50,111,4,2013-10-23 01:23:41,2013-08-15 02:49:18
9e3541e25efc27863d8f44f2e1b9e3bae259caae...3b7f11131c3e6e311938d74b7a8cbeb192a9b857,1,110,87,197,7,2013-10-23 01:23:41,2013-08-15 03:36:53
3b7f11131c3e6e311938d74b7a8cbeb192a9b857...600b5c9fa4030b94afa60cb02efbfe2a43c476d3,2,63,4,67,11,2013-10-23 01:23:41,2013-08-18 18:51:45
600b5c9fa4030b94afa60cb02efbfe2a43c476d3...3d0ba3b1058ca852508c142663940f4d35247853,1,69,1,70,7,2013-10-23 01:23:41,2013-08-19 23:24:05
3d0ba3b1058ca852508c142663940f4d35247853...dfc7d6ac771a9746991b9ad780346aeb1505a147,1,16,10,26,4,2013-10-23 01:23:41,2013-08-20 03:05:15
dfc7d6ac771a9746991b9ad780346aeb1505a147...481547465fac5819b01a52a6aa6f0e750b744649,3,70,8,78,8,2013-10-23 01:23:41,2013-08-20 03:23:52
481547465fac5819b01a52a6aa6f0e750b744649...b4013ce3de4b8bb35d0b3df0c846c4e7f4097b80,2,94,23,117,10,2013-10-23 01:23:42,2013-08-20 04:22:08
b4013ce3de4b8bb35d0b3df0c846c4e7f4097b80...bfc4a96e1d19f8350dbeb793b1b047d39b30c37c,1,6,2,8,1,2013-10-23 01:23:42,2013-08-20 05:29:08
bfc4a96e1d19f8350dbeb793b1b047d39b30c37c...475e0fb068d7b0e3db399b43f1530a9ffc70adc1,1,106,31,137,7,2013-10-23 01:23:42,2013-09-11 00:20:40
475e0fb068d7b0e3db399b43f1530a9ffc70adc1...5987770d6c3e8eb76f62ac7fd835f917a6d061bb,1,4,0,4,1,2013-10-23 01:23:42,2013-09-11 18:17:37
5987770d6c3e8eb76f62ac7fd835f917a6d061bb...b41340ea851633d8cfa569b3c5c5b88c8782bcc5,1,15,13,28,7,2013-10-23 01:23:42,2013-09-12 18:18:11
b41340ea851633d8cfa569b3c5c5b88c8782bcc5...6293eb404e5c09f535f11d5efb450ce008e7b42f,1,44,65,109,10,2013-10-23 01:23:42,2013-09-13 03:49:37
6293eb404e5c09f535f11d5efb450ce008e7b42f...e7ccb1f15672d6ae8abddd1004e412ba5145bd11,1,8,6,14,4,2013-10-23 01:23:42,2013-09-13 04:17:26
e7ccb1f15672d6ae8abddd1004e412ba5145bd11...00063c17771b4a973f6a1dadcabaacc0aee8594f,1,2,1,3,2,2013-10-23 01:23:42,2013-09-13 04:25:58
00063c17771b4a973f6a1dadcabaacc0aee8594f...1d7dee2346224add42b028c3f3971112ec7fda4f,2,9,5,14,4,2013-10-23 01:23:42,2013-09-13 05:09:04
1d7dee2346224add42b028c3f3971112ec7fda4f...bfc2449324badd2163bac22b2d0422d3927dd0ef,1,1,0,1,1,2013-10-23 01:23:42,2013-09-14 00:13:06
bfc2449324badd2163bac22b2d0422d3927dd0ef...64a494ffa770020801040371d10b1102f1e5a633,1,21,18,39,10,2013-10-23 01:23:42,2013-09-14 00:14:12
64a494ffa770020801040371d10b1102f1e5a633...3d4c456d16e1c69471ee049b53a16aa1dabb974a,3,69,9,78,8,2013-10-23 01:23:42,2013-09-18 01:34:57
3d4c456d16e1c69471ee049b53a16aa1dabb974a...aa288329896d462474c62bc2fcc9a54151f3b521,4,43,3,46,5,2013-10-23 01:23:42,2013-09-18 20:41:24
aa288329896d462474c62bc2fcc9a54151f3b521...23fa0385eba31459a9847d8e4776f34db9bd93ab,1,4,3,7,3,2013-10-23 01:23:43,2013-09-18 20:58:13
23fa0385eba31459a9847d8e4776f34db9bd93ab...3908c7d16263a7523e21afb57dcc7825a3be23f7,3,169,159,328,6,2013-10-23 01:23:43,2013-09-19 00:18:34
3908c7d16263a7523e21afb57dcc7825a3be23f7...0b7fb674df9df488bf17e687a8f7b663e08bfa2d,3,82,69,151,24,2013-10-23 01:23:43,2013-09-19 01:51:35
0b7fb674df9df488bf17e687a8f7b663e08bfa2d...e926cf3068a36e747e747a685886138e527ca923,2,68,22,90,9,2013-10-23 01:23:43,2013-09-19 17:23:43
e926cf3068a36e747e747a685886138e527ca923...1c0bef7087e05a3e55513ac131478cda38288d7c,1,1,1,2,1,2013-10-23 01:23:43,2013-09-19 17:26:55
1c0bef7087e05a3e55513ac131478cda38288d7c...90fb7b2304a830362d25e2f197932bd6b3091ced,1,24,1,25,3,2013-10-23 01:23:43,2013-09-19 17:59:11
90fb7b2304a830362d25e2f197932bd6b3091ced...6730a270c3e08bbfb08c404b8aaf2e5d9c93ef0d,2,26,18,44,10,2013-10-23 01:23:43,2013-09-20 23:20:23
6730a270c3e08bbfb08c404b8aaf2e5d9c93ef0d...c722168fba1d0770633f1847ccc2f73278bd9e92,1,13,7,20,2,2013-10-23 01:23:43,2013-09-20 23:34:07
c722168fba1d0770633f1847ccc2f73278bd9e92...feef527f2ef52ccd77b23567a65053e6a083103e,1,1,1,2,1,2013-10-23 01:23:43,2013-10-03 21:56:38
feef527f2ef52ccd77b23567a65053e6a083103e...4f9c817d7d62558c046deec0496154515491df64,1,37,0,37,1,2013-10-23 01:23:43,2013-10-03 23:12:27
4f9c817d7d62558c046deec0496154515491df64...ab4b795b84cc1d92f83a9d9dd853c635a16d9a2e,2,47,11,58,2,2013-10-23 01:23:43,2013-10-04 00:28:04
ab4b795b84cc1d92f83a9d9dd853c635a16d9a2e...77f0588dc7b90901eaa1abf0c25ccf82db5ef4c3,1,21,0,21,1,2013-10-23 01:23:43,2013-10-04 00:43:49
77f0588dc7b90901eaa1abf0c25ccf82db5ef4c3...853a2e7b08b1b9b1deefa96bae0a2bb009499d30,1,2,1,3,1,2013-10-23 01:23:43,2013-10-04 02:38:33
853a2e7b08b1b9b1deefa96bae0a2bb009499d30...8154c1b3c5bf63ba8fd2a09a3a58a4de4426bf4e,1,82,61,143,12,2013-10-23 01:23:44,2013-10-08 01:09:53
8154c1b3c5bf63ba8fd2a09a3a58a4de4426bf4e...af0395253602e200cb181d54eaa40f26df11b4ce,1,7,7,14,7,2013-10-23 01:23:44,2013-10-08 01:13:17
af0395253602e200cb181d54eaa40f26df11b4ce...9a8a1f7f59477089dff68b7a57bdd16d6250752a,2,15,9,24,6,2013-10-23 01:23:44,2013-10-08 01:17:09
9a8a1f7f59477089dff68b7a57bdd16d6250752a...3ce02762d4061f2e51dbf6702be77704d9e0093b,2,2,0,2,2,2013-10-23 01:23:44,2013-10-08 01:19:10
3ce02762d4061f2e51dbf6702be77704d9e0093b...53c460a35d38a977f216d3039934924dfc2c68a2,1,2,2,4,1,2013-10-23 01:23:44,2013-10-08 01:20:47
53c460a35d38a977f216d3039934924dfc2c68a2...5f2b961bc888d76baff1137427994070e95c400b,1,2,0,2,1,2013-10-23 01:23:44,2013-10-08 03:51:47
5f2b961bc888d76baff1137427994070e95c400b...6c528f0e8fb10b2e872d3d659903259720b3abeb,1,1,0,1,1,2013-10-23 01:23:44,2013-10-08 03:56:20
6c528f0e8fb10b2e872d3d659903259720b3abeb...b79ce96db8b019f61cad57ccc1ae9eb25316ae64,2,20,3,23,3,2013-10-23 01:23:44,2013-10-09 22:02:02
b79ce96db8b019f61cad57ccc1ae9eb25316ae64...b8b0ddb0a0e8341cda67ba04a54cbf26638a835b,2,9,1,10,3,2013-10-23 01:23:44,2013-10-09 22:06:55
b8b0ddb0a0e8341cda67ba04a54cbf26638a835b...af5e03d5649ce8b867c7d4dbbe558dad1e3836cf,1,5,6,11,2,2013-10-23 01:23:44,2013-10-09 22:24:00
af5e03d5649ce8b867c7d4dbbe558dad1e3836cf...b6bc4a0cf9997e6aad5946c789b98f71565d8657,1,28,17,45,3,2013-10-23 01:23:44,2013-10-09 22:52:38
b6bc4a0cf9997e6aad5946c789b98f71565d8657...f129847a4925f7505d7e4337c2f9cf6a26c42856,1,5,5,10,3,2013-10-23 01:23:44,2013-10-10 20:54:56
f129847a4925f7505d7e4337c2f9cf6a26c42856...dc9386504b1793126c8cb0c46150fd1477f19061,1,3,1,4,2,2013-10-23 01:23:45,2013-10-10 21:28:56
dc9386504b1793126c8cb0c46150fd1477f19061...32988a1825d9caddf0edd323be54102439cd4b75,1,1,1,2,1,2013-10-23 01:23:45,2013-10-10 22:08:32
32988a1825d9caddf0edd323be54102439cd4b75...c00bc727e4d5f38d6d6a76eec127116cb75011f1,3,10,2,12,3,2013-10-23 01:23:45,2013-10-10 22:01:30
c00bc727e4d5f38d6d6a76eec127116cb75011f1...84ca3f220f122591efa140bb3b2d02047b4d3f46,1,18,0,18,1,2013-10-23 01:23:45,2013-10-10 22:12:21
84ca3f220f122591efa140bb3b2d02047b4d3f46...95c4fd29f045f4bb2585a5ebc25f272075a87d2b,1,5,4,9,3,2013-10-23 01:23:45,2013-10-10 22:30:51
95c4fd29f045f4bb2585a5ebc25f272075a87d2b...ab887b2e90addf81c9fce0f19a299efb9167e807,1,10,0,10,1,2013-10-23 01:23:45,2013-10-10 23:09:02
ab887b2e90addf81c9fce0f19a299efb9167e807...fdf05675885a3fceca487578cfdc7ca4ad7202f1,1,3,1,4,1,2013-10-23 01:23:45,2013-10-10 23:59:44
fdf05675885a3fceca487578cfdc7ca4ad7202f1...6bae2e6c8d900e631a18f2f0e7973f06e33860cc,2,4,3,7,2,2013-10-23 01:23:45,2013-10-11 00:09:43
6bae2e6c8d900e631a18f2f0e7973f06e33860cc...465b2c6b2cc16fe2272275fd4a5ea57df2ba15f4,1,7,2,9,1,2013-10-23 01:23:45,2013-10-11 00:16:36
465b2c6b2cc16fe2272275fd4a5ea57df2ba15f4...12be2ed2aaacf909770a79bae2767a6c1a781008,4,9,4,13,7,2013-10-23 01:23:45,2013-10-11 22:35:26
12be2ed2aaacf909770a79bae2767a6c1a781008...2750aa786ff22eec0bb0b4be4822a85313704f6c,2,75,60,135,13,2013-10-23 01:23:45,2013-10-10 01:13:11
2750aa786ff22eec0bb0b4be4822a85313704f6c...9547eb572319cd4085fd433a73c731caca425588,1,18,6,24,7,2013-10-23 01:23:45,2013-10-16 21:12:07
9547eb572319cd4085fd433a73c731caca425588...6e6bf392ddfdd90d8a35e96438d31522b42fe890,1,12,4,16,4,2013-10-23 01:23:46,2013-10-16 21:21:01
6e6bf392ddfdd90d8a35e96438d31522b42fe890...8313148d191d9ba4136ce9a2d21e81625a3afa86,1,7,4,11,4,2013-10-23 01:23:46,2013-10-18 22:10:36
8313148d191d9ba4136ce9a2d21e81625a3afa86...4bc1495a381484d20edf1667df4bbf0a92976c65,1,3,1,4,1,2013-10-23 01:23:46,2013-10-18 22:53:19
4bc1495a381484d20edf1667df4bbf0a92976c65...ed4d437793d56a6dd86f084f42a3487ade14a052,1,20,11,31,5,2013-10-23 01:23:46,2013-10-19 07:01:17
ed4d437793d56a6dd86f084f42a3487ade14a052...bc3f39be44b2118e34e965b0107696cbb50947d4,1,18,5,23,6,2013-10-23 01:23:46,2013-10-19 07:24:12
bc3f39be44b2118e34e965b0107696cbb50947d4...790d39ed1c6f652ba5c62f7d906b3ff683d37e82,1,1,0,1,1,2013-10-23 01:23:46,2013-10-22 00:53:15
790d39ed1c6f652ba5c62f7d906b3ff683d37e82...6fc743f3e18bbb7dd051481603df1dba643e8210,1,5,2,7,2,2013-10-23 01:23:46,2013-10-22 01:59:34
6fc743f3e18bbb7dd051481603df1dba643e8210...df006872d4ddb4ba791f8b35b93a6ff407f05a4c,1,6,2,8,2,2013-10-23 01:23:46,2013-10-22 02:00:02
df006872d4ddb4ba791f8b35b93a6ff407f05a4c...7a77e780c7d1a05015c72a49863f9edaa1156cb8,1,14,4,18,2,2013-10-23 01:23:46,2013-10-22 07:27:08
7a77e780c7d1a05015c72a49863f9edaa1156cb8...9d3be6721d14ed9102d1d3ff1b1f097f89a32d5e,1,20,5,25,8,2013-10-23 01:23:46,2013-10-22 07:28:35
9d3be6721d14ed9102d1d3ff1b1f097f89a32d5e...c3f800318d0f6784fbcf98c7523bfb845fad80f4,1,15,16,31,14,2013-10-23 01:23:46,2013-10-22 07:42:14
c3f800318d0f6784fbcf98c7523bfb845fad80f4...46efe82971131c85486ae09ad2c62e66e77f1335,1,4,0,4,2,2013-10-23 01:23:46,2013-10-22 23:24:54
46efe82971131c85486ae09ad2c62e66e77f1335...7fe8d7f3e1d0d067f74aa9ad055089166bdaa8f3,3,92,38,130,23,2013-10-23 01:23:53,2013-09-21 23:12:39
7fe8d7f3e1d0d067f74aa9ad055089166bdaa8f3...7bb332ff07326781222ad5b1aed4cbdeb38a1675,1,2,1,3,1,2013-10-23 01:23:53,2013-09-22 00:20:00
7bb332ff07326781222ad5b1aed4cbdeb38a1675...2abf46d7983a117b84ccf58e4e563a4e6f1e3900,1,2,2,4,1,2013-10-23 01:23:53,2013-09-22 00:40:59
2abf46d7983a117b84ccf58e4e563a4e6f1e3900...92ddb8464812d2681e3b0b70f2ee011de75e6860,1,1,1,2,1,2013-10-23 01:23:53,2013-09-22 00:45:50
92ddb8464812d2681e3b0b70f2ee011de75e6860...0a7b510f0a5d1188d2aff8018a6d496e4f07bcb4,1,2,2,4,2,2013-10-23 01:23:53,2013-09-22 02:14:26
0a7b510f0a5d1188d2aff8018a6d496e4f07bcb4...1d7f86fde98e64f3686e1e92dd593e608abf1666,1,1,1,2,1,2013-10-23 01:23:53,2013-09-22 03:29:48
1d7f86fde98e64f3686e1e92dd593e608abf1666...79a53a6a884d18582a8cdc57c59f14bb45b8d97a,1,2,2,4,1,2013-10-23 01:23:53,2013-09-22 05:40:28
79a53a6a884d18582a8cdc57c59f14bb45b8d97a...c6d6e3eec81a6202286f12617a5884ed4712ed25,2,75,112,187,15,2013-10-23 01:23:53,2013-09-22 09:38:28
c6d6e3eec81a6202286f12617a5884ed4712ed25...04edd55280f12f7f8bdbce2a5850b4b2d7cc1252,1,18,8,26,6,2013-10-23 01:23:53,2013-09-23 02:57:04
04edd55280f12f7f8bdbce2a5850b4b2d7cc1252...3259b96118f4b1e4e23101f44ef10f7f35a7406d,1,2,2,4,2,2013-10-23 01:23:53,2013-09-23 02:57:21
3259b96118f4b1e4e23101f44ef10f7f35a7406d...8e0a7b471d8b34a5153d347a8caa3c6db765d404,1,11,4,15,1,2013-10-23 01:23:53,2013-09-23 04:46:36
8e0a7b471d8b34a5153d347a8caa3c6db765d404...e4c385b1593cdb71aa2cfb01056da10d5d02a8f4,1,2,2,4,2,2013-10-23 01:23:54,2013-09-24 02:19:05
e4c385b1593cdb71aa2cfb01056da10d5d02a8f4...b80ef9cb1c264186a9089a357729b3423c582650,2,28,31,59,10,2013-10-23 04:44:57,2013-10-23 04:44:57
b80ef9cb1c264186a9089a357729b3423c582650...39f6d37197dffec9e1f5325d7a7f31dfd002c5ac,1,2,1,3,2,2013-10-23 05:25:51,2013-10-23 05:25:51
c0186ebd8f1fbe39ec0508a857cf65a35788387f...bcbf3c1e5606c70a83984528d8eab9c7faa2bae5,6,2600,0,2600,6,2013-11-05 22:59:37,2013-10-20 21:54:25
bcbf3c1e5606c70a83984528d8eab9c7faa2bae5...dfb9c6d55dadc64640742ffaa991874f6ec421d8,5,97,4,101,6,2013-11-05 22:59:37,2013-10-20 23:02:03
dfb9c6d55dadc64640742ffaa991874f6ec421d8...aed3036f0d6c9c767bcbcd8d4a74d8cc1bc37708,3,47,2,49,5,2013-11-05 22:59:37,2013-10-20 23:39:52
aed3036f0d6c9c767bcbcd8d4a74d8cc1bc37708...59c413c5cc4f0e312162f087d8e52141ab19461f,2,67,5,72,8,2013-11-05 22:59:37,2013-10-21 00:17:31
59c413c5cc4f0e312162f087d8e52141ab19461f...31d377f27905a2e0b4090a932d94d6de79f57ab5,2,154,19,173,12,2013-11-05 22:59:37,2013-10-21 15:23:06
31d377f27905a2e0b4090a932d94d6de79f57ab5...4cd28cc940d952c4a0faa4525d21f42542643a84,1,1,1,2,1,2013-11-05 22:59:37,2013-10-21 20:21:43
4cd28cc940d952c4a0faa4525d21f42542643a84...c5a0a25b1732a8bb9caacd5a1d1e1416c92140f8,4,63,2,65,5,2013-11-05 22:59:37,2013-10-21 20:32:58
c5a0a25b1732a8bb9caacd5a1d1e1416c92140f8...f25c5bd32e3a36340277c7b346aeb036859861c8,2,297,3,300,6,2013-11-05 22:59:38,2013-10-22 03:23:55
8e3b1e0e3e733afc4277233a3c39f397bba0632b...aca97bd7fb2d04484b42b3f377b62d7f5cab5bd3,3,103,29,132,22,2013-11-01 07:57:05,2013-11-01 07:57:05
aca97bd7fb2d04484b42b3f377b62d7f5cab5bd3...79f56a8c90041875adc8b7a1431eceba94a925c2,1,21,1,22,7,2013-11-01 08:31:06,2013-11-01 08:31:06
79f56a8c90041875adc8b7a1431eceba94a925c2...85ec1c0ae01361b99137c46430b92994732dc6dd,2,37,65,102,23,2013-11-01 21:05:17,2013-11-01 21:05:17
85ec1c0ae01361b99137c46430b92994732dc6dd...1e796316788109d4b504464a8271a8dd3d045d8f,1,0,12,12,8,2013-11-01 22:55:33,2013-11-01 22:55:33
1e796316788109d4b504464a8271a8dd3d045d8f...9c612cec999df4a3ea42eb6265dc1a2c90e60e31,1,20,18,38,11,2013-11-01 22:56:17,2013-11-01 22:56:17
9c612cec999df4a3ea42eb6265dc1a2c90e60e31...d1601461bac4705e17ab29b5acda91dbe1a75b20,1,54,28,82,11,2013-11-01 22:56:54,2013-11-01 22:56:54
d1601461bac4705e17ab29b5acda91dbe1a75b20...cb9e6c6651b362e26158d1be18c48185e99cbd01,1,11,0,11,3,2013-11-01 23:03:32,2013-11-01 23:03:32
cb9e6c6651b362e26158d1be18c48185e99cbd01...c764a5bad06f3707abc687859da8d22efbc3b618,1,2,2,4,2,2013-11-01 23:32:33,2013-11-01 23:32:33
c764a5bad06f3707abc687859da8d22efbc3b618...c39644a9889da9f1b9445f0bb125a7b775f7ebe3,1,16,5,21,4,2013-11-01 23:44:46,2013-11-01 23:44:46
c39644a9889da9f1b9445f0bb125a7b775f7ebe3...2e00078934330e7ae38ee887c76afa9c5d5387b4,2,106,74,180,21,2013-11-02 01:04:11,2013-11-02 01:04:11
8e3b1e0e3e733afc4277233a3c39f397bba0632b...fd23051c3d8d37aab37bba6bbb5a01dd11d69a24,1,10,0,10,1,2013-10-30 23:26:14,2013-10-30 23:26:14
fd23051c3d8d37aab37bba6bbb5a01dd11d69a24...8be473df8995d07317129a8afdfcc53f75bce01b,1,7,3,10,2,2013-11-01 23:50:09,2013-11-01 23:50:09
9e2d6ed76939894c8353c5251f08661baa43e6b6...d5ce2502f6c67b5e8ce4b724a61553cf240367e8,1,21,9,30,3,2013-09-19 20:54:33,2013-09-19 17:22:36
9e2d6ed76939894c8353c5251f08661baa43e6b6...ec9a8ef03793acc1f9d25d6d0cf5771d95b6224e,7,171,0,171,7,2013-09-18 19:05:49,2013-09-18 19:05:49
2378cbfbdcfe9241a959b40bbce94d97fcd569d7...3f93c386ce2f7abbc8e1abedfd9fbb93c640b20b,1,1,1,2,1,2013-10-07 17:28:23,2013-10-07 17:28:23
3f93c386ce2f7abbc8e1abedfd9fbb93c640b20b...84873c8a22cb2e04fb8269d66047ed978282f201,4,80,14,94,9,2013-10-07 17:45:13,2013-10-07 17:45:13
84873c8a22cb2e04fb8269d66047ed978282f201...d8a70707e61a10c9f23d5427013ab8c81264bbe8,1,1,1,2,1,2013-10-07 18:13:30,2013-10-07 18:13:30
d8a70707e61a10c9f23d5427013ab8c81264bbe8...f8e3e5a7e2d431ed30f1dd31f52d8e0c2a4747e0,4,14,123,137,6,2013-10-07 18:16:58,2013-10-07 18:15:31
f8e3e5a7e2d431ed30f1dd31f52d8e0c2a4747e0...96af53db962a951a55114d798cc060731c649da8,1,2,0,2,2,2013-10-07 18:27:20,2013-10-07 18:27:20
96af53db962a951a55114d798cc060731c649da8...7a112872fd901cf56410e4080c91678709f88863,6,75,22,97,17,2013-10-07 21:27:20,2013-10-07 21:27:20
7a112872fd901cf56410e4080c91678709f88863...b88e40b0b73f81df9fb2ec7ca1d7188b608b6b3d,4,42,5,47,8,2013-10-07 22:37:56,2013-10-07 22:37:56
b88e40b0b73f81df9fb2ec7ca1d7188b608b6b3d...9500f5ffa44a66a4a2b4b38847ce4169c87a1aee,1,12,3,15,2,2013-10-07 22:39:25,2013-10-07 22:39:25
9500f5ffa44a66a4a2b4b38847ce4169c87a1aee...80d7be7b2c9ec900147eacbea2458d6f16d9d9a0,1,3,2,5,2,2013-10-07 22:50:45,2013-10-07 21:18:29
80d7be7b2c9ec900147eacbea2458d6f16d9d9a0...fcba1fb2644b0e31ede5748bef78cc8a90c9f846,1,2,2,4,1,2013-10-07 22:50:45,2013-10-07 22:12:44
fcba1fb2644b0e31ede5748bef78cc8a90c9f846...01ce66310e8fa40e0c3407085de6f7d01d975170,4,33,262,295,31,2013-10-07 22:50:46,2013-10-07 21:26:45
01ce66310e8fa40e0c3407085de6f7d01d975170...36da3238c58510ebe2c3cf461b7869e8f9fd6eb7,1,2,2,4,2,2013-10-07 22:50:46,2013-10-07 22:38:42
36da3238c58510ebe2c3cf461b7869e8f9fd6eb7...a39a8bd1ac4ab84945fd1fd956bd9a7ae529170f,4,15,14,29,9,2013-10-07 22:50:47,2013-10-07 22:50:26
6dfe0cdf42382a05109e3432b478cd327199730e...109b397b79ddd556ab62fcc5d27cebc31419c91c,1,3,3,6,2,2013-11-08 00:13:58,2013-11-08 00:13:58
4e407693875d91cf903ffe004eaefecd886fad42...3dd8c230b3046246042d3dde794e3a48035c3367,1,8,9,17,6,2013-07-26 18:25:50,2013-06-08 05:06:02
3dd8c230b3046246042d3dde794e3a48035c3367...26163ce69e1d8edc77152ef091a078dc66f290d6,1,5,7,12,3,2013-07-26 21:38:28,2013-07-26 21:38:22
26163ce69e1d8edc77152ef091a078dc66f290d6...307789a2610d1badbf08d6eee8cf6fafc967a031,2,36,3,39,2,2013-07-26 23:51:50,2013-07-26 23:35:35
7b6533864320334346c05fcabc4bc5966433495f...ec6abfb2f97d426b4f36b6d7cea7be785864eb7e,1,17,2,19,2,2013-07-15 18:19:51,2013-07-15 18:19:51
ec6abfb2f97d426b4f36b6d7cea7be785864eb7e...296ca6f0c001e20472ab922a2317dc207dd80429,1,2,0,2,1,2013-07-15 18:27:48,2013-07-15 18:27:48
296ca6f0c001e20472ab922a2317dc207dd80429...02a123a47c161d44a82c520b91063701b27f8ff8,3,33,1,34,8,2013-07-15 19:36:02,2013-07-15 19:36:02
02a123a47c161d44a82c520b91063701b27f8ff8...71065615bec742e2d3d7cb645c6d1121d814210c,1,1,1,2,1,2013-07-15 19:45:21,2013-07-15 19:45:21
71065615bec742e2d3d7cb645c6d1121d814210c...2b80e5b97348d103ed286523372cba08138db358,2,22,5,27,4,2013-07-15 20:25:26,2013-07-15 20:25:26
2b80e5b97348d103ed286523372cba08138db358...a77932e34bb02e950e719f06076d0b5346555e46,1,1,1,2,1,2013-07-15 20:29:18,2013-07-15 20:29:18
a77932e34bb02e950e719f06076d0b5346555e46...690da6a53590f8cc7282ec3e708632ee3a945d3c,1,3,1,4,1,2013-07-15 22:06:01,2013-07-15 22:04:01
690da6a53590f8cc7282ec3e708632ee3a945d3c...c185b2bed6b5673b9098caba7d93fd58d30227ba,2,11,6,17,4,2013-07-16 01:04:48,2013-07-16 01:04:48
c185b2bed6b5673b9098caba7d93fd58d30227ba...096a6efddd226cb614b47af85124f6b9ff7f4ac6,1,5,4,9,3,2013-07-16 01:23:54,2013-07-16 01:23:54
096a6efddd226cb614b47af85124f6b9ff7f4ac6...068f0abb50b870efbcf5943f03eed5dfe9e190a4,1,1,0,1,1,2013-07-16 03:23:00,2013-07-13 17:42:39
068f0abb50b870efbcf5943f03eed5dfe9e190a4...6a1b5d3032bfba28a3ff84c9eed92540064d366f,7,7,17,24,10,2013-07-16 04:39:03,2013-07-16 04:36:50
6a1b5d3032bfba28a3ff84c9eed92540064d366f...c51ea9c9c099e101dee6a23224e8fad58c594afa,1,2,2,4,2,2013-07-16 04:49:08,2013-07-16 04:48:13
c51ea9c9c099e101dee6a23224e8fad58c594afa...eb1e15e45782dab27e49217f21838ae59008f658,2,66,8,74,12,2013-07-16 05:21:57,2013-07-16 05:21:57
eb1e15e45782dab27e49217f21838ae59008f658...5c3b769e4469936e549a28b07888e2a46f2751b6,3,132,94,226,59,2013-07-16 05:31:07,2013-07-16 04:58:56
5c3b769e4469936e549a28b07888e2a46f2751b6...c37ed42b80fc295af4f4e26eca0324cbeb738bfd,2,6,4,10,4,2013-07-16 16:16:32,2013-07-16 16:14:04
c37ed42b80fc295af4f4e26eca0324cbeb738bfd...1597f3da82715fed7b34d9295667846114b113b0,1,24,10,34,7,2013-07-16 16:51:05,2013-07-16 16:51:05
1597f3da82715fed7b34d9295667846114b113b0...4afb7129f03a1667a2d746656b0b343270e9e5c8,2,2,0,2,2,2013-07-16 19:48:26,2013-07-16 19:25:56
4afb7129f03a1667a2d746656b0b343270e9e5c8...575de93b1f0cb93892002ff7f33c6b14151f7d69,1,1,1,2,1,2013-07-16 19:48:26,2013-07-16 19:47:54
575de93b1f0cb93892002ff7f33c6b14151f7d69...e18e2435b32b8b15ca3e2c0a71ac365dacdf550f,1,0,10,10,1,2013-07-16 20:47:52,2013-07-16 20:45:06
6ff3afd164aae65b9c2f8fe8ba7657ec82b5376c...ad0917855d6bef334a8446375282c6cfa9d23879,2,21,10,31,4,2013-07-10 18:54:54,2013-07-09 22:04:52
ad0917855d6bef334a8446375282c6cfa9d23879...58e68cfc0afb1087d6882375150ebcdec05827ce,1,13,0,13,1,2013-07-10 18:54:54,2013-07-09 22:20:55
58e68cfc0afb1087d6882375150ebcdec05827ce...c61c3c5d61adc5f26b760adc0fdfdb8e7293239f,2,14,14,28,4,2013-07-10 18:54:54,2013-07-10 18:40:20
65d8bd9588199f5360df5d2c9c9b11c3c9bf7994...a669b6f0ce0055991256a6d39ee2fc4a13eaf434,3,43,7,50,9,2013-07-10 10:35:25,2013-07-10 10:35:25
a669b6f0ce0055991256a6d39ee2fc4a13eaf434...9944ffdbc8781da191c9bfae1025808d964982b6,1,35,3,38,5,2013-07-10 10:46:36,2013-07-10 10:46:36
9944ffdbc8781da191c9bfae1025808d964982b6...220b0d2c9118d8638934097bc0f7f7bffc424379,1,1,1,2,1,2013-07-10 11:11:00,2013-07-10 11:11:00
220b0d2c9118d8638934097bc0f7f7bffc424379...ca525ae57b06132ffa934a95aea1393aa34797e9,1,1,1,2,1,2013-07-10 11:15:01,2013-07-10 11:15:01
ca525ae57b06132ffa934a95aea1393aa34797e9...e7cf7d50f65bff5bb3102ccc24050e36531e0281,1,3,0,3,1,2013-07-10 11:19:20,2013-07-10 11:16:40
e7cf7d50f65bff5bb3102ccc24050e36531e0281...02fd3646bc0fcfe98318bb04ec241281fd93630c,3,54,8,62,7,2013-07-10 11:31:46,2013-07-10 11:31:46
02fd3646bc0fcfe98318bb04ec241281fd93630c...3b3bf33dc80ccac930b19ea75204301134812832,2,30,78,108,4,2013-07-10 11:46:34,2013-07-10 11:46:34
3b3bf33dc80ccac930b19ea75204301134812832...d3eb97ccc84d0d9c157b49f4716e94775169904f,2,63,0,63,3,2013-07-10 12:29:55,2013-07-10 12:29:55
d3eb97ccc84d0d9c157b49f4716e94775169904f...344f878cb818e80f54de5637dc4937b09ec4eeef,3,48,54,102,17,2013-07-10 12:44:58,2013-07-10 12:44:58
344f878cb818e80f54de5637dc4937b09ec4eeef...03d4a3a68bda0580603f06db9f08009d17f15de9,1,0,10,10,1,2013-07-10 12:47:01,2013-07-10 12:47:01
03d4a3a68bda0580603f06db9f08009d17f15de9...6a1dfd0e27b89fd61f5b542b2b042955c8522ad4,2,42,18,60,11,2013-07-10 13:06:56,2013-07-10 13:05:24
6a1dfd0e27b89fd61f5b542b2b042955c8522ad4...fa4e20a935117ea470f1678a5f71d6cde9c8ec88,2,26,22,48,8,2013-07-10 13:21:33,2013-07-10 13:21:33
fa4e20a935117ea470f1678a5f71d6cde9c8ec88...4572631e7cf441ecc3a28b25caf1c3873d731464,2,54,36,90,16,2013-07-10 13:47:48,2013-07-10 13:47:48
4572631e7cf441ecc3a28b25caf1c3873d731464...70c2de783c08ba86d3b4adcb8213817011e56de6,3,20,15,35,7,2013-07-10 13:57:58,2013-07-10 13:57:58
70c2de783c08ba86d3b4adcb8213817011e56de6...d293760c40160bf06b19bdb71c7f85c64883cad6,3,20,16,36,10,2013-07-11 18:00:39,2013-07-11 18:00:39
d293760c40160bf06b19bdb71c7f85c64883cad6...97b803a291b0ce3cbc63f62fc091e639ded1fd0a,1,7,8,15,7,2013-07-11 19:41:00,2013-07-11 19:41:00
97b803a291b0ce3cbc63f62fc091e639ded1fd0a...3e9ae4573ece408dba982a2b2769b4f5c92bc814,4,101,54,155,19,2013-07-11 20:56:30,2013-07-11 20:56:30
3e9ae4573ece408dba982a2b2769b4f5c92bc814...be78be3a8b1775104e0e53397f28bc90a745b0a6,3,87,11,98,12,2013-07-11 22:56:45,2013-07-11 22:56:45
be78be3a8b1775104e0e53397f28bc90a745b0a6...ec6f50bd690076cbb7039e38255ecef5e9a764f1,1,2,2,4,2,2013-07-12 00:10:36,2013-07-12 00:10:36
ec6f50bd690076cbb7039e38255ecef5e9a764f1...b2c791df334afec5ee6a3ca1f3a86d187864547c,1,29,12,41,10,2013-07-12 00:11:10,2013-07-12 00:11:10
b2c791df334afec5ee6a3ca1f3a86d187864547c...6993c661d54329c76d7f52ba1e4c67f4ef73558f,1,1,0,1,1,2013-07-12 00:25:22,2013-07-12 00:25:22
6993c661d54329c76d7f52ba1e4c67f4ef73558f...19b416971c3233300e35acb05705909d165bebe7,1,7,1,8,1,2013-07-12 00:30:09,2013-07-12 00:30:09
19b416971c3233300e35acb05705909d165bebe7...b94b3f7bd4d28a2e1841e3268f6ef8877879931c,1,4,1,5,1,2013-07-12 00:32:09,2013-07-12 00:32:09
b94b3f7bd4d28a2e1841e3268f6ef8877879931c...26aea9063c5552306b26aecfd2757cd2294b4fd8,1,13,1,14,1,2013-07-12 00:41:01,2013-07-12 00:41:01
12a93615cfda92ca7650ffe4d717d92d4877fbf4...658a966003b5bdfc5e9a855dd979c2370e37ad17,3,44,1,45,4,2013-07-08 16:47:20,2013-06-05 18:17:42
658a966003b5bdfc5e9a855dd979c2370e37ad17...af801545bf30bf3e5f1f48726d7075b793be4721,1,8,3,11,2,2013-07-08 16:47:20,2013-06-07 17:11:10
af801545bf30bf3e5f1f48726d7075b793be4721...58be4bb5842759e289388abc3cee5e0da75de0d1,1,46,0,46,1,2013-07-08 16:47:21,2013-06-11 03:02:45
58be4bb5842759e289388abc3cee5e0da75de0d1...ed47b5f7c82ef4ef47e56d29849049e4d575333a,4,102,34,136,10,2013-07-08 16:47:21,2013-06-25 23:38:40
ed47b5f7c82ef4ef47e56d29849049e4d575333a...71af4bc4906d91753b80d925ae710e2eb638af74,2,7,24,31,5,2013-07-08 16:47:21,2013-06-25 23:39:47
71af4bc4906d91753b80d925ae710e2eb638af74...3e6fc3be0585ee111c6b46036f9bf0822168e885,4,73,36,109,29,2013-07-08 16:47:21,2013-06-26 02:12:16
3e6fc3be0585ee111c6b46036f9bf0822168e885...4a93bdae682afc6fa949803ad9ba2986e1193dc6,5,18,27,45,9,2013-07-08 16:48:47,2013-06-26 04:39:43
4a93bdae682afc6fa949803ad9ba2986e1193dc6...40f1b52c2c2b4d37ca3a912ddb56ceb51763acb0,1,2,2,4,1,2013-07-08 16:49:04,2013-06-27 00:31:05
40f1b52c2c2b4d37ca3a912ddb56ceb51763acb0...ca497d544097d384792805e2e47e600b777a5083,2,32,13,45,3,2013-07-08 16:49:04,2013-06-28 23:58:40
ca497d544097d384792805e2e47e600b777a5083...ad97d4df447bf83dfde41251a9609b23e8a6b5cf,6,73,34,107,27,2013-07-08 16:49:04,2013-06-29 06:16:38
bd03d52cd04489269c5b50926746143970ca7079...56359db24dac5763e50c65ba5fe71172bd96ad2b,2,2,2,4,2,2013-06-28 23:03:09,2013-06-27 18:59:05
56359db24dac5763e50c65ba5fe71172bd96ad2b...1f2a770117ee2c70cb11469e2347ee15fd59d0a5,1,2,1,3,1,2013-06-28 23:32:27,2013-06-28 22:54:43
47ecc3c1b47712a2c9013ed0bbec4f9f3509e65a...357ec8e8b8070b2a2a4612cb626776e7f14e8058,1,3,1,4,1,2013-05-25 02:01:28,2013-05-25 02:01:28
ea63ea560f025d40659b6f9dfe60b87bb41f3aa9...e1dd2b40f84ed9a8a88edda628e628f0cdcac7f2,1,5,11,16,5,2013-09-30 22:41:47,2013-09-30 22:41:47
e1dd2b40f84ed9a8a88edda628e628f0cdcac7f2...f397295b8a3596771341550ce0367c47174700ad,1,3,0,3,1,2013-09-30 22:47:40,2013-09-30 22:47:40
f397295b8a3596771341550ce0367c47174700ad...bad2102c060060789d5012e77c0e3493b61a402a,1,3,1,4,1,2013-10-01 17:12:02,2013-10-01 17:12:02
bad2102c060060789d5012e77c0e3493b61a402a...dc8e948cb1f8d08217ad47a103e68f87f412197e,2,156,75,231,37,2013-10-01 18:39:46,2013-10-01 18:36:56
dc8e948cb1f8d08217ad47a103e68f87f412197e...1002650fcda437bfb2ee3e670d349436c5770060,1,12,6,18,3,2013-10-01 18:48:45,2013-10-01 18:48:45
1002650fcda437bfb2ee3e670d349436c5770060...cfd5861c8d429e081a866b39432e5d2034fc0610,3,23,18,41,14,2013-10-02 01:26:41,2013-10-02 01:22:43
cfd5861c8d429e081a866b39432e5d2034fc0610...6ae90f4d6730b998dfc3c36dcb8449d98e245a84,1,4,4,8,4,2013-10-02 02:02:05,2013-10-02 02:02:05
6ae90f4d6730b998dfc3c36dcb8449d98e245a84...f9fda934ec9ff633ec535ae412429c6e76729d61,2,14,0,14,5,2013-10-02 05:16:32,2013-10-02 05:16:32
f9fda934ec9ff633ec535ae412429c6e76729d61...47b6af30a5b773b8ac6d082356adad53a319382f,1,40,34,74,19,2013-10-02 17:31:30,2013-10-02 17:31:30
47b6af30a5b773b8ac6d082356adad53a319382f...44d399456ea5ee326deefc1cd6b0a32efd5ebd0a,3,22,16,38,13,2013-10-02 17:51:14,2013-10-02 17:51:14
44d399456ea5ee326deefc1cd6b0a32efd5ebd0a...b29a31746fb56414d0c12e0163e7056b36b0d76c,1,26,27,53,4,2013-10-02 17:55:12,2013-10-02 17:55:12
b29a31746fb56414d0c12e0163e7056b36b0d76c...d0af2d8c918f203a0c5d332e5c5280f7cb74873c,1,2,0,2,1,2013-10-02 18:07:41,2013-10-02 18:07:41
d0af2d8c918f203a0c5d332e5c5280f7cb74873c...e8c8252b2a34d0167110d4d898dc25c17ea8b864,1,1,1,2,1,2013-10-02 18:15:00,2013-10-02 18:15:00
e8c8252b2a34d0167110d4d898dc25c17ea8b864...dec262b2394113ce7c2879aa9c6eceadd74bd1ee,3,68,21,89,15,2013-10-02 19:17:04,2013-10-02 19:17:04
dec262b2394113ce7c2879aa9c6eceadd74bd1ee...86492eececb81ac5054eb2118b447e7f0e01daed,1,16,19,35,1,2013-10-02 19:47:50,2013-10-02 19:47:50
6299f69754f8b4eab9e92b9751474390f6bdd5f4...00d4bd1ab59de7438c3f0a1603b827389912a8c5,2,7,7,14,6,2013-05-28 22:02:21,2013-05-28 22:01:50
2aec0f636cd4a78eaa15cc38bd8de0e8a6216921...72482ec07c3fa3f24be13db2eb0fd241d8b4e661,2,21,5,26,4,2013-03-22 23:07:42,2013-03-20 22:45:32
72482ec07c3fa3f24be13db2eb0fd241d8b4e661...1ef7e770b0d31f422864246aae5c4df7e8a33186,2,23,16,39,7,2013-03-22 23:07:42,2013-03-22 08:07:42
1ef7e770b0d31f422864246aae5c4df7e8a33186...c905c7b0018bd3d549e0e048292fa51e6424e20e,3,10,20,30,9,2013-03-22 23:52:35,2013-03-22 23:23:03
7228a8f7a1488b83c97e70e5389794e7a52d42dc...aa663f9fc75d196d2eb1a76f19e2a79b2cf0b53f,1,75,101,176,47,2013-03-09 19:43:01,2013-03-09 19:43:01
aa663f9fc75d196d2eb1a76f19e2a79b2cf0b53f...0bac1b3e2d356c16d806c4c2bfc763d56cb9f67c,1,0,1,1,1,2013-03-09 19:48:26,2013-03-09 19:48:26
7228a8f7a1488b83c97e70e5389794e7a52d42dc...6f059f0508f59d8794a1352ae957ffe87994b0b0,1,5,5,10,4,2013-03-08 06:03:41,2013-03-08 01:44:41
6f059f0508f59d8794a1352ae957ffe87994b0b0...39fe1509e152e2598d5c628bed25a1a0db51f526,1,1,1,2,1,2013-03-08 06:03:41,2013-03-08 05:59:20
7228a8f7a1488b83c97e70e5389794e7a52d42dc...1307b8c4a9a255b80f3f675c2920441424751da3,3,66,20,86,24,2013-03-08 00:09:18,2013-03-08 00:09:18
1307b8c4a9a255b80f3f675c2920441424751da3...996fc144bfc7f8166fd785502e6fff2b31aa659f,4,54,5,59,11,2013-03-09 00:33:12,2013-03-09 00:33:12
996fc144bfc7f8166fd785502e6fff2b31aa659f...b38579fd13826ac6e5fc210f1d71d37c33f4df5a,1,16,0,16,4,2013-03-09 01:24:03,2013-03-09 01:24:03
b38579fd13826ac6e5fc210f1d71d37c33f4df5a...6b35610d227c452281bbf16cc114e132551940f8,1,2,3,5,2,2013-03-09 02:28:26,2013-03-09 02:28:26
6b35610d227c452281bbf16cc114e132551940f8...184438d9a74ce32e938fdf751769d75412fbe967,1,4,5,9,3,2013-03-09 03:01:08,2013-03-09 03:01:08
184438d9a74ce32e938fdf751769d75412fbe967...a4cbb0d8ef4170beb5c1372517f2b71af153bd8c,1,23,6,29,8,2013-03-09 06:41:24,2013-03-09 06:41:24
7228a8f7a1488b83c97e70e5389794e7a52d42dc...0b700b286a6bc29dd2d4d8e8403533c8cd846bf2,1,12,3,15,2,2013-03-07 22:59:24,2013-02-28 23:58:09
c208f68060c9a611d5f130abff8b74b216108b96...4f2d725d3f068f58f94979f3b5601778fa6e705e,4,29,16,45,12,2013-02-09 01:51:33,2013-01-31 22:37:48
c208f68060c9a611d5f130abff8b74b216108b96...1385137f01563d00fb091062d466bee355e34dae,9,15,10,25,9,2013-02-08 06:49:56,2013-02-08 06:49:56
36bad38aa029c8e431c12b06070b36de05131d2d...caa528733d469d53604abf76a14f0f98368f98cf,1,2,2,4,2,2013-12-20 22:33:09,2013-12-20 22:33:09
caa528733d469d53604abf76a14f0f98368f98cf...7341966f49da15302968678446bbbda8181e2db7,1,2,1,3,1,2013-12-20 22:34:06,2013-12-20 22:34:06
7341966f49da15302968678446bbbda8181e2db7...c37d009d96feef10d975c80ee643944f003e42d3,7,26,23,49,13,2013-12-23 20:53:58,2013-12-16 15:51:51
c37d009d96feef10d975c80ee643944f003e42d3...178734b66d7ce9d059cbbe8bdb2788ab541a8632,1,7,1,8,3,2013-12-23 23:17:36,2013-12-23 23:17:36
178734b66d7ce9d059cbbe8bdb2788ab541a8632...c0e169dd6217ac11aac80f7cd5e0132d47ded47d,2,8,15,23,7,2013-12-24 01:16:27,2013-12-24 01:16:27
f0f7ae2d16260e671252a29f34736aa2c7f0bfc5...fa25bcafb48fc168c516f916924a8bb37a84ee90,1,1,1,2,1,2013-12-18 01:00:48,2013-12-17 22:05:44
fa25bcafb48fc168c516f916924a8bb37a84ee90...ebb729f0f69867747aaa9db5dcbce84741a1999d,1,10,0,10,1,2013-12-18 02:35:31,2013-12-18 02:35:31
ebb729f0f69867747aaa9db5dcbce84741a1999d...0f4a21f89fcc1fd4b9391e0b8bd380c3923ad80c,4,13,8,21,4,2013-12-18 03:05:25,2013-12-18 02:55:28
0f4a21f89fcc1fd4b9391e0b8bd380c3923ad80c...2b36c8be335c20f00054be74d4fae756dac74074,1,9,0,9,1,2013-12-19 21:33:18,2013-12-19 21:32:19
2b36c8be335c20f00054be74d4fae756dac74074...39e3f1ee1af9d7de2a9cf6a779a53f80d6430c4c,2,4,0,4,2,2013-12-19 23:07:39,2013-12-19 23:07:39
39e3f1ee1af9d7de2a9cf6a779a53f80d6430c4c...eeae8ad11ee0b6585262fec853c6db11464007c4,1,1,2,3,1,2013-12-19 23:14:16,2013-12-19 23:14:16
eeae8ad11ee0b6585262fec853c6db11464007c4...0db5b9393a121dc1d142cd85f8e99c6350ed9740,1,2,1,3,1,2013-12-19 23:46:44,2013-12-19 23:46:44
5f23b5e5af2956c84543b7b021b1d384a5d6a678...80c7749c34f7f3dc7a3b4f407b128139d7bde1ca,3,92,38,130,23,2013-11-05 23:47:10,2013-09-21 23:12:39
80c7749c34f7f3dc7a3b4f407b128139d7bde1ca...7c6073a9f5de2109db6e468ceff69a6d5aab9944,1,2,1,3,1,2013-11-05 23:47:10,2013-09-22 00:20:00
7c6073a9f5de2109db6e468ceff69a6d5aab9944...6a78254ddc307b6c09b4264837a7ce3430c3f6f5,1,2,2,4,2,2013-11-05 23:48:56,2013-09-22 02:14:26
6a78254ddc307b6c09b4264837a7ce3430c3f6f5...8bf8162c7a5546c453e19d5fcd05a03739d55738,1,6,15,21,8,2013-11-06 02:23:03,2013-11-06 00:05:40
8bf8162c7a5546c453e19d5fcd05a03739d55738...f688a5445620f718bd66e3b22528b22f03fee0e1,1,0,1,1,1,2013-11-06 02:23:03,2013-11-06 00:11:02
f688a5445620f718bd66e3b22528b22f03fee0e1...fd7ffb442057bbb6f6e31901f1661ea3493b3a20,2,13,8,21,6,2013-11-06 02:24:29,2013-11-06 02:06:35
fd7ffb442057bbb6f6e31901f1661ea3493b3a20...a4df4a792cd5730ddcccadca8f80541f802855ac,1,9,0,9,1,2013-11-06 07:12:50,2013-11-06 04:51:21
a4df4a792cd5730ddcccadca8f80541f802855ac...c1d2c31b90142491ff78a7c156629bd4c7db1236,5,12,32,44,7,2013-11-06 07:13:01,2013-11-06 07:07:54
9b58e3a21cfc38966af6a4fb1c9898b175eb8488...dd47801e2aee140b80fa77f18b8e6f3588d507fc,10,148,1,149,19,2013-10-23 05:36:47,2013-01-15 23:30:16
dd47801e2aee140b80fa77f18b8e6f3588d507fc...679100f1ba75c839a7a58cbbd6db7d232a1b9bc7,1,6,0,6,1,2013-10-23 05:36:53,2013-10-23 05:36:53
9b58e3a21cfc38966af6a4fb1c9898b175eb8488...b57f1c4d65298a6223384b0536239d934ba20bc1,8,145,1,146,17,2013-10-23 05:28:37,2013-01-15 23:30:16
2922fd963a682b52866a578f98fc02074f1545e4...497bb38c61b9bccff27bb09af613cbaefa109682,3,17,7,24,8,2013-11-07 01:52:52,2013-11-07 01:52:52
497bb38c61b9bccff27bb09af613cbaefa109682...08d5a15995f0c15f206ab90354b976590f6d8195,8,236,92,328,25,2013-11-07 09:11:17,2013-11-07 09:11:17
08d5a15995f0c15f206ab90354b976590f6d8195...01e63482ee06280ca28f99dab1f1aba69ce795c6,1,10,2,12,3,2013-11-07 18:15:59,2013-11-07 18:15:59
01e63482ee06280ca28f99dab1f1aba69ce795c6...2c7cd543ee5498a3592ff2b9207220a66d94cf43,6,62,31,93,12,2013-11-07 18:43:36,2013-11-07 18:43:36
2c7cd543ee5498a3592ff2b9207220a66d94cf43...19e767ec6e5d02e5bfd4c55b491585c7b73ba5ef,3,39,1,40,3,2013-11-07 21:31:52,2013-11-07 21:31:52
19e767ec6e5d02e5bfd4c55b491585c7b73ba5ef...1c5cfb5a236b57176a0f1d95a2e66c90460fe1d6,6,129,22,151,20,2013-11-08 00:39:29,2013-11-08 00:39:29
1c5cfb5a236b57176a0f1d95a2e66c90460fe1d6...4c5b4775bab47aabedb2fa0a440d459f9771dd64,4,76,2,78,8,2013-11-08 01:17:16,2013-11-08 01:17:16
4c5b4775bab47aabedb2fa0a440d459f9771dd64...10e8897941c7f0667f010e0183e47e4cdabcbb86,2,186,192,378,23,2013-11-08 01:33:10,2013-11-08 01:33:10
10e8897941c7f0667f010e0183e47e4cdabcbb86...3ff8d1e7fac9e39475277558e0a83c733051e43d,3,17,2,19,4,2013-11-08 01:39:23,2013-11-08 01:39:23
3ff8d1e7fac9e39475277558e0a83c733051e43d...30593a734a004c43a16f80cc140c8b94b345afab,3,25,3,28,7,2013-11-08 02:11:22,2013-11-08 02:11:22
30593a734a004c43a16f80cc140c8b94b345afab...d6429121f75469617a3d71e66f6128cfc67e9614,2,23,0,23,2,2013-11-08 02:11:33,2013-11-08 02:11:33
d6429121f75469617a3d71e66f6128cfc67e9614...066a6d9f1ff62bb9ecb7fa9bde48562ce1030ec2,5,37,20,57,16,2013-11-08 06:49:31,2013-11-08 06:49:31
066a6d9f1ff62bb9ecb7fa9bde48562ce1030ec2...c1c1866e70d267b10ee1877dcfdea8beaa80596c,6,75,2,77,10,2013-11-08 21:33:00,2013-11-08 21:33:00
c1c1866e70d267b10ee1877dcfdea8beaa80596c...47a72b548cf5aa4aea29c6c229440decdb2fc28e,1,31,1,32,4,2013-11-08 23:18:45,2013-11-08 23:18:45
47a72b548cf5aa4aea29c6c229440decdb2fc28e...1f829c0528414d4874e8071d6ec5b2bbb1d7033f,4,137,61,198,30,2013-11-09 02:22:06,2013-11-09 02:22:06
b0a1d0a0fa6b71a204db7d024033c31435408557...bf5525bbd616c3aadb30cce6036846f406d5287a,1,36,27,63,3,2013-11-05 04:26:29,2013-11-05 04:26:29
bf5525bbd616c3aadb30cce6036846f406d5287a...415d1e5c9acf25fd5e8c124dd856dbf68fa1a79e,1,26,27,53,2,2013-11-05 04:29:02,2013-11-05 04:29:02
415d1e5c9acf25fd5e8c124dd856dbf68fa1a79e...2be2aa6194ead65929e1a7e13be65becaa49225b,1,11,10,21,11,2013-11-05 23:10:49,2013-11-05 23:10:49
2be2aa6194ead65929e1a7e13be65becaa49225b...feee1eacd6da24a71adc7d564a5f3b268a4f10bc,2,2,2,4,2,2013-11-05 23:15:09,2013-11-05 23:15:09
feee1eacd6da24a71adc7d564a5f3b268a4f10bc...1dea49dbb804f8c76dddd46ebef29316867db72b,5,101,93,194,68,2013-11-07 00:57:35,2013-11-07 00:57:35
1dea49dbb804f8c76dddd46ebef29316867db72b...e5328b2f13d4ce0d4cb319774e02c10719791099,1,21,2,23,4,2013-11-07 17:45:11,2013-11-07 17:45:11
e5328b2f13d4ce0d4cb319774e02c10719791099...d6859d170d08cadede0dda528a53c48481d54949,1,12,5,17,3,2013-11-07 18:36:17,2013-11-07 18:36:17
d6859d170d08cadede0dda528a53c48481d54949...48df6cee3f6abc36dc366cfc4540d670af305a25,4,13,3,16,4,2013-11-08 21:51:33,2013-11-08 21:51:33
48df6cee3f6abc36dc366cfc4540d670af305a25...aee3c43c0fb6a42b3c0270121818d99def1dc3be,3,36,1,37,3,2013-11-08 22:25:12,2013-11-08 22:24:22
aee3c43c0fb6a42b3c0270121818d99def1dc3be...dfbefca7948f27f8d19d684e0229225a13753db1,2,49,17,66,16,2013-11-08 23:26:20,2013-11-08 23:26:20
dfbefca7948f27f8d19d684e0229225a13753db1...e05cde2cb584f383ca2203d330dfb5df3eaaf08f,1,16,12,28,4,2013-11-08 23:40:46,2013-11-08 23:40:46
d5ce2502f6c67b5e8ce4b724a61553cf240367e8...8afa4f2c9e70bf812a1f0689212955e3a00c6023,1,1,1,2,1,2013-09-23 17:49:53,2013-09-13 17:47:14
d5ce2502f6c67b5e8ce4b724a61553cf240367e8...9bc7e564d180afcaaff3f1d54967d2cf0600c431,3,74,0,74,5,2013-09-19 20:54:45,2013-08-14 20:36:44
9bc7e564d180afcaaff3f1d54967d2cf0600c431...660b1dac37e6dea5021d14b62560d85b760ff66a,3,113,56,169,22,2013-09-19 20:54:46,2013-08-15 02:08:47
660b1dac37e6dea5021d14b62560d85b760ff66a...b2d69b4de940c708a7885b5b8fa0ffe051b0a1ff,1,62,51,113,4,2013-09-19 20:54:46,2013-08-15 02:49:18
b2d69b4de940c708a7885b5b8fa0ffe051b0a1ff...6cf2386b92dbb2e1c7ebe4702047418586f7e78a,1,99,76,175,7,2013-09-19 20:54:46,2013-08-15 03:36:53
6cf2386b92dbb2e1c7ebe4702047418586f7e78a...3088a7754c965ef3daf4b0b202c524f4e652201c,2,62,4,66,11,2013-09-19 20:54:46,2013-08-18 18:51:45
3088a7754c965ef3daf4b0b202c524f4e652201c...de817bcce459aec9771d86692d52c880acadc5c6,1,69,1,70,7,2013-09-19 20:54:46,2013-08-19 23:24:05
de817bcce459aec9771d86692d52c880acadc5c6...ea57e1f2eb57760b15aa2dfbd245b64862952490,1,16,10,26,4,2013-09-19 20:54:46,2013-08-20 03:05:15
ea57e1f2eb57760b15aa2dfbd245b64862952490...423573ad749169cfadac15e22b6f51055f73c882,3,70,8,78,8,2013-09-19 20:54:46,2013-08-20 03:23:52
423573ad749169cfadac15e22b6f51055f73c882...848a59517e00676884462151305f792df517d3b4,2,94,23,117,10,2013-09-19 20:54:46,2013-08-20 04:22:08
848a59517e00676884462151305f792df517d3b4...196df25d0b510052c99f046c7a896a7fc9e7305b,1,6,2,8,1,2013-09-19 20:54:46,2013-08-20 05:29:08
196df25d0b510052c99f046c7a896a7fc9e7305b...a7f89cd9a4e55453dbbc51dbc6114fdb82d659f7,1,106,31,137,7,2013-09-19 20:54:46,2013-09-11 00:20:40
a7f89cd9a4e55453dbbc51dbc6114fdb82d659f7...f6d41aaf795382771a911f7aa7bd6104e50767c3,1,4,0,4,1,2013-09-19 20:54:46,2013-09-11 18:17:37
f6d41aaf795382771a911f7aa7bd6104e50767c3...97606a46127185b1edd27b0236bc4ef56282583b,1,15,13,28,7,2013-09-19 20:54:46,2013-09-12 18:18:11
97606a46127185b1edd27b0236bc4ef56282583b...f93a65c8a0524da4621cc2dc8c41776614c102ed,1,44,65,109,10,2013-09-19 20:54:46,2013-09-13 03:49:37
f93a65c8a0524da4621cc2dc8c41776614c102ed...6283cc1c65d5aea85a10c9c4ab3ab03543504927,1,8,6,14,4,2013-09-19 20:54:46,2013-09-13 04:17:26
6283cc1c65d5aea85a10c9c4ab3ab03543504927...dec72aa9883390aacbeaaaed8669dd3e54a41658,1,2,1,3,2,2013-09-19 20:54:47,2013-09-13 04:25:58
dec72aa9883390aacbeaaaed8669dd3e54a41658...2aeac315612ec2def2c707b11c780992d6d82a99,2,9,5,14,4,2013-09-19 20:54:47,2013-09-13 05:09:04
2aeac315612ec2def2c707b11c780992d6d82a99...1769a64f84898ffd135afbeb4134953b23c05a90,1,1,0,1,1,2013-09-19 20:54:47,2013-09-14 00:13:06
1769a64f84898ffd135afbeb4134953b23c05a90...9361903159bad5d8342cdc70fc8862b7b6a1a44e,1,21,18,39,10,2013-09-19 20:54:47,2013-09-14 00:14:12
9361903159bad5d8342cdc70fc8862b7b6a1a44e...ba4737c8768c2136bb1209dd38e183cd4f2e9a5c,3,69,9,78,8,2013-09-19 20:54:47,2013-09-18 01:34:57
ba4737c8768c2136bb1209dd38e183cd4f2e9a5c...76ca9d8ab03eb4471475e7e0bb74645b3301d064,4,43,3,46,5,2013-09-19 20:54:47,2013-09-18 20:41:24
76ca9d8ab03eb4471475e7e0bb74645b3301d064...a0857dd3fbadc3f649f70bcc5a5daf56092aa76a,1,4,3,7,3,2013-09-19 20:54:47,2013-09-18 20:58:13
a0857dd3fbadc3f649f70bcc5a5daf56092aa76a...766b8094ec4aadd13cc71553380cb91931062953,3,169,159,328,6,2013-09-19 20:54:47,2013-09-19 00:18:34
766b8094ec4aadd13cc71553380cb91931062953...ecb792225c2fe7403a81d2351e7a9810a181fd80,3,82,69,151,24,2013-09-19 20:54:47,2013-09-19 01:51:35
ecb792225c2fe7403a81d2351e7a9810a181fd80...a37de53df311ff96d53fe8c41744915c8b598ecf,2,68,22,90,9,2013-09-19 20:54:47,2013-09-19 17:23:43
a37de53df311ff96d53fe8c41744915c8b598ecf...0aee25bafc16984f94329202f4886a0ce8581632,1,1,1,2,1,2013-09-19 20:54:47,2013-09-19 17:26:55
0aee25bafc16984f94329202f4886a0ce8581632...2ac06a0abfbc85ebb3c4abd201ae39c571f30ba2,1,24,1,25,3,2013-09-19 20:54:47,2013-09-19 17:59:11
2ac06a0abfbc85ebb3c4abd201ae39c571f30ba2...1120303fe3fed50c68045ef1608cadb1791b29f5,3,92,38,130,23,2013-09-21 23:13:04,2013-09-21 23:12:39
1120303fe3fed50c68045ef1608cadb1791b29f5...e02009c5a2f61d93750dcec5025b7a2c120211a4,1,1,1,2,1,2013-09-21 23:45:02,2013-09-21 23:45:02
e02009c5a2f61d93750dcec5025b7a2c120211a4...4b39a885ce24165d7165553accdea496b538edf2,1,2,1,3,1,2013-09-22 00:20:00,2013-09-22 00:20:00
4b39a885ce24165d7165553accdea496b538edf2...12ee6f43abdc61a39da31b0ec459551a1f0a9289,1,2,2,4,1,2013-09-22 00:40:59,2013-09-22 00:40:59
12ee6f43abdc61a39da31b0ec459551a1f0a9289...c2780079a0f0f4e5c3239038f43ad950b1226a26,1,1,1,2,1,2013-09-22 00:45:50,2013-09-22 00:45:50
c2780079a0f0f4e5c3239038f43ad950b1226a26...3851ebd0cdc4deb15f8b4b83f20af153f7dc8a52,1,2,2,4,2,2013-09-22 02:14:26,2013-09-22 02:14:26
3851ebd0cdc4deb15f8b4b83f20af153f7dc8a52...1c5d9e9c9bf89a82575207925bd7e9139e0f0b69,1,1,1,2,1,2013-09-22 03:29:48,2013-09-22 03:29:48
1c5d9e9c9bf89a82575207925bd7e9139e0f0b69...a5ad23b32f1fba7a63b8e16f5c6529b84fa00893,1,2,2,4,1,2013-09-22 05:40:28,2013-09-22 05:40:28
a5ad23b32f1fba7a63b8e16f5c6529b84fa00893...6654e680412c3ad687f7bf617f3ff03c18a5c93a,2,75,112,187,15,2013-09-22 09:38:28,2013-09-22 09:38:28
6654e680412c3ad687f7bf617f3ff03c18a5c93a...2d519bad542e31adf86e08b0109f01ae2475c240,1,18,8,26,6,2013-09-23 02:57:04,2013-09-23 02:57:04
2d519bad542e31adf86e08b0109f01ae2475c240...71d4d38e6c8e9bb834e58bb7cef6457f3c970b62,1,2,2,4,2,2013-09-23 02:57:21,2013-09-23 02:57:21
71d4d38e6c8e9bb834e58bb7cef6457f3c970b62...269767b114892a5766c23f49206c799a1a2fffb7,1,11,4,15,1,2013-09-23 04:46:36,2013-09-23 04:46:36
70f222d54445de14a117c1a4c3733d5500891bac...2af0c6c6016d08acfc3e90c67ed7176154f7b365,1,1,1,2,1,2013-10-07 23:17:09,2013-10-07 23:17:09
2af0c6c6016d08acfc3e90c67ed7176154f7b365...1a1f083186ceb78024f6cca97a35bd12974abc0c,2,3,3,6,3,2013-10-08 00:21:02,2013-10-07 23:27:34
1a1f083186ceb78024f6cca97a35bd12974abc0c...8df574c68a23efb184df2d30c88e841e9655eafc,1,3,2,5,3,2013-10-08 22:02:52,2013-10-08 22:02:52
8df574c68a23efb184df2d30c88e841e9655eafc...d1e6bd1a4f046dd8327c408e4be95832b5fb5ccf,2,19,8,27,7,2013-10-09 02:02:42,2013-10-09 02:02:42
d1e6bd1a4f046dd8327c408e4be95832b5fb5ccf...11aa6c65e2e2ba3a20a39d60ee1342836b140e39,2,12,6,18,3,2013-10-09 02:03:09,2013-10-09 02:03:09
11aa6c65e2e2ba3a20a39d60ee1342836b140e39...e350782fce61eeb379b66bbabb717cfb9a4d99c2,1,9,1,10,1,2013-10-10 00:20:18,2013-10-10 00:20:18
e350782fce61eeb379b66bbabb717cfb9a4d99c2...1c37ac1a982f967bbd1feac67661f584272e8032,2,79,50,129,12,2013-10-10 21:54:12,2013-10-10 21:54:12
1c37ac1a982f967bbd1feac67661f584272e8032...64c2e86b2cd0cb1103fbbab47c510f94735bc346,1,4,3,7,3,2013-10-10 22:20:09,2013-10-09 07:23:37
64c2e86b2cd0cb1103fbbab47c510f94735bc346...df657e0af6c8b110f54d62e876fc4a3be43bc187,3,3,11,14,4,2013-10-10 22:20:09,2013-10-10 19:24:51
df657e0af6c8b110f54d62e876fc4a3be43bc187...cdd07f9accf68057b4cfae933a9ad999049cd24c,1,5,7,12,1,2013-10-10 22:20:10,2013-10-10 19:27:22
cdd07f9accf68057b4cfae933a9ad999049cd24c...05985f50c1f3b862e887b87f8d0a59f2125f3d44,3,23,4,27,3,2013-10-10 22:20:10,2013-10-10 22:19:25
05985f50c1f3b862e887b87f8d0a59f2125f3d44...21180a20e9e7c2fa21b814f216805ad935e2ae56,1,3,2,5,2,2013-10-10 22:32:58,2013-10-10 22:32:15
21180a20e9e7c2fa21b814f216805ad935e2ae56...e10145d14cdf454df8d25f75587d1c158db9a2f3,2,9,8,17,5,2013-10-10 23:04:17,2013-10-10 23:04:17
e10145d14cdf454df8d25f75587d1c158db9a2f3...f4bf7aad80f2131f81a12cf5cc66072a0abb40b1,1,4,0,4,1,2013-10-10 23:08:00,2013-10-10 23:07:51
109b397b79ddd556ab62fcc5d27cebc31419c91c...54f58d9c6190d29d98eecfa5b9e49025d3b3df51,1,1,1,2,1,2013-11-08 05:50:23,2013-10-22 06:33:55
54f58d9c6190d29d98eecfa5b9e49025d3b3df51...4cb8d1ed66e75b3993282b9daecbbc1c16454943,1,10,4,14,3,2013-11-08 05:53:25,2013-11-01 21:30:42
4cb8d1ed66e75b3993282b9daecbbc1c16454943...28f6cd4d46dcecba3ba89caf86582c1df1be14f2,1,3,2,5,2,2013-11-08 05:53:25,2013-11-01 22:59:16
28f6cd4d46dcecba3ba89caf86582c1df1be14f2...8d975aba9f98fab144d2fb0b085286e9090f1e6b,1,3,0,3,1,2013-11-08 05:53:25,2013-11-01 22:59:42
8d975aba9f98fab144d2fb0b085286e9090f1e6b...6ef6b2954e766e8d0be0501b5d45832084a432eb,1,2,2,4,2,2013-11-08 05:53:26,2013-11-04 05:44:01
6ef6b2954e766e8d0be0501b5d45832084a432eb...784bcbbbb75f0e8b2db16212e0587f1a1ce34377,2,20,6,26,5,2013-11-08 05:53:26,2013-11-04 06:09:17
784bcbbbb75f0e8b2db16212e0587f1a1ce34377...bafb1fcea607f46982b714be19d58a5ba64c4be4,1,3,3,6,2,2013-11-08 05:53:26,2013-11-04 06:21:35
bafb1fcea607f46982b714be19d58a5ba64c4be4...8c4d23f8668b517609f2d3462b5a13595c18f19f,1,4,4,8,2,2013-11-08 05:53:26,2013-11-04 20:01:00
8c4d23f8668b517609f2d3462b5a13595c18f19f...7a5b6efe5e972165e479d1c567212cb7c9766a57,1,1,1,2,1,2013-11-08 05:53:26,2013-11-04 20:14:21
7a5b6efe5e972165e479d1c567212cb7c9766a57...3706573e05031f46130aeed2ebd9d42b955de4c6,1,2,4,6,2,2013-11-08 05:53:26,2013-11-04 08:37:57
3706573e05031f46130aeed2ebd9d42b955de4c6...0f15a1da077c23ab82e265ee2c38960ed241f300,2,2,1,3,2,2013-11-08 05:53:26,2013-11-05 05:15:26
0f15a1da077c23ab82e265ee2c38960ed241f300...5b08b349ba8ab927f9e0c707ecb45e3e9facc2cf,1,6,6,12,1,2013-11-08 05:53:27,2013-11-05 08:53:07
5b08b349ba8ab927f9e0c707ecb45e3e9facc2cf...62599ee73a29ec83f1a43199d900d6946887985e,1,1,1,2,1,2013-11-08 05:53:27,2013-11-05 08:57:45
62599ee73a29ec83f1a43199d900d6946887985e...d012e112db5e7787f01079e266013ba75a1d7b63,1,28,17,45,7,2013-11-08 05:53:27,2013-11-05 23:11:17
d012e112db5e7787f01079e266013ba75a1d7b63...69c98bce6333b25d96873d1c2f77be28ed49edac,4,138,7,145,10,2013-11-08 05:53:27,2013-11-06 01:44:29
69c98bce6333b25d96873d1c2f77be28ed49edac...4526fc1332fb2e153f87e84956c6e495f351d10e,1,81,11,92,6,2013-11-08 05:53:27,2013-11-06 03:54:45
4526fc1332fb2e153f87e84956c6e495f351d10e...ed562094bd73b46cd584209d48908e59f35a2d51,1,29,0,29,1,2013-11-08 05:53:27,2013-11-06 04:32:30
ed562094bd73b46cd584209d48908e59f35a2d51...a389b900dc9c0e437c2c73d2383da19312a4b919,1,112,8,120,5,2013-11-08 05:53:27,2013-11-06 07:18:07
a389b900dc9c0e437c2c73d2383da19312a4b919...1eb41268de0a0799a6d0283e04b2844d9495166d,1,23,24,47,19,2013-11-08 05:53:27,2013-11-06 08:52:19
1eb41268de0a0799a6d0283e04b2844d9495166d...34c1d917242b85da8db3e17280da6703bb924131,1,1,0,1,1,2013-11-08 05:53:27,2013-11-07 05:18:16
34c1d917242b85da8db3e17280da6703bb924131...e1d667beb72a3bb9f43f4846853ac7d56e9403a7,2,232,217,449,10,2013-11-08 05:53:28,2013-11-07 18:28:10
e1d667beb72a3bb9f43f4846853ac7d56e9403a7...9fd537279ee1059728cbea90a99a422158ec0089,2,108,24,132,12,2013-11-08 05:53:28,2013-11-07 19:44:39
9fd537279ee1059728cbea90a99a422158ec0089...7dbf287fd7ca21865469f44262dc2d348e136764,1,68,47,115,14,2013-11-08 05:53:28,2013-11-07 22:59:44
7dbf287fd7ca21865469f44262dc2d348e136764...a2d06a1e5c99bf33120574ade2317c5994f75878,1,50,15,65,13,2013-11-08 05:53:28,2013-11-07 23:42:29
a2d06a1e5c99bf33120574ade2317c5994f75878...fd9a97511baffd5db1475ae0a33d67ef49473db0,1,2,2,4,2,2013-11-08 05:53:28,2013-11-08 04:22:25
fd9a97511baffd5db1475ae0a33d67ef49473db0...82f6357e70704d76a8a490007931f501644484f3,1,1,1,2,1,2013-11-08 05:53:28,2013-11-08 04:36:04
82f6357e70704d76a8a490007931f501644484f3...8cad80c3dc4b608741948f8b8465ba1e2cee743d,1,23,7,30,4,2013-11-08 05:53:28,2013-11-08 04:43:40
8cad80c3dc4b608741948f8b8465ba1e2cee743d...a883322419a2c599eba9fee7cd5984188dfb446f,1,19,26,45,9,2013-11-08 07:17:23,2013-11-08 07:17:00
a883322419a2c599eba9fee7cd5984188dfb446f...08c4a3c9cdc07db1c9d8391b07e1d2c8f44588fb,1,85,51,136,12,2013-11-08 11:19:02,2013-11-08 11:19:02
08c4a3c9cdc07db1c9d8391b07e1d2c8f44588fb...fb0f5f131875ee2f3f65089f8c3f8a040349165a,2,27,5,32,7,2013-11-08 18:27:16,2013-11-08 18:27:16
fb0f5f131875ee2f3f65089f8c3f8a040349165a...d224828d214a7b8a03c28b65a0aa7c105bde0c5f,1,4,5,9,4,2013-11-08 18:29:21,2013-11-08 18:29:21
d224828d214a7b8a03c28b65a0aa7c105bde0c5f...6d82b723cf1a7c8dcf117c73f45432a07b27e24d,3,35,40,75,9,2013-11-08 18:29:40,2013-11-08 18:29:40
6d82b723cf1a7c8dcf117c73f45432a07b27e24d...3eb24292c034ac7ae3b4b11e34dc5c18ba7cf318,1,2,0,2,1,2013-11-08 19:16:06,2013-11-08 19:16:04
3eb24292c034ac7ae3b4b11e34dc5c18ba7cf318...ff3511953f0366ba7946bc73815f54305fabbbc1,1,15,6,21,3,2013-11-08 19:30:31,2013-11-08 19:30:31
ff3511953f0366ba7946bc73815f54305fabbbc1...b4bebe1b640bcaa2f410e5d6970af6e8e8f3b93d,10,243,4,247,12,2013-11-09 02:59:03,2013-11-09 02:59:03
b4bebe1b640bcaa2f410e5d6970af6e8e8f3b93d...b65815d191ee76127b271abceb1cb539aaedfb61,1,16,6,22,3,2013-11-10 11:34:18,2013-11-10 11:33:58
b65815d191ee76127b271abceb1cb539aaedfb61...d573464f92594a301a94aebeabd9898c6ee7e0aa,8,54,26,80,14,2013-11-20 19:26:51,2013-11-20 19:26:51
d573464f92594a301a94aebeabd9898c6ee7e0aa...2e7023d1e87d33747d36d8c9af681eb8cebe11a8,1,6,4,10,4,2013-11-20 19:31:49,2013-11-20 01:46:18
2e7023d1e87d33747d36d8c9af681eb8cebe11a8...301aa8402130e232bd5fad11784b21ef9ac90693,6,161,0,161,6,2013-11-20 23:48:12,2013-11-20 23:48:12
301aa8402130e232bd5fad11784b21ef9ac90693...c2ee85b080e545e8f745902b52a032e58e82d1fd,1,1,1,2,1,2013-11-21 17:40:18,2013-11-21 17:40:18
c2ee85b080e545e8f745902b52a032e58e82d1fd...2970b5a2239144d41214942ef0ffbf1809f83d15,1,4,0,4,1,2013-11-21 17:41:06,2013-11-21 17:41:06
2970b5a2239144d41214942ef0ffbf1809f83d15...b7fa35eb7192d5ead51dd66214986469c31f8027,1,9,3,12,2,2013-11-21 22:04:03,2013-11-21 22:04:03
b7fa35eb7192d5ead51dd66214986469c31f8027...64da32ea515e2b3e2c37da3bcc1b8b7a0699b123,1,7,6,13,1,2013-11-22 03:20:34,2013-11-22 03:20:34
64da32ea515e2b3e2c37da3bcc1b8b7a0699b123...cd6770eb8110ade055fd189ac00bf3bfe8632a61,2,14,114,128,12,2013-12-03 16:56:37,2013-12-03 16:39:21
307789a2610d1badbf08d6eee8cf6fafc967a031...4e222d8e26377b6dc91fe6732bc5c82ca0fbe06e,32,160,13,173,32,2013-07-27 02:02:12,2013-07-27 01:41:56
4e222d8e26377b6dc91fe6732bc5c82ca0fbe06e...7f545db79e766c851f59bf0529052afce2cf6163,1,1,1,2,1,2013-07-27 02:04:13,2013-07-27 02:04:13
7f545db79e766c851f59bf0529052afce2cf6163...19012cf58a7a5d8d0707009e400bd6f3b9fdb7e5,1,2,1,3,2,2013-07-27 02:33:25,2013-07-27 02:33:25
19012cf58a7a5d8d0707009e400bd6f3b9fdb7e5...af061120444687289efba5a6b5f5300749e96c90,5,8,12,20,8,2013-07-27 02:34:45,2013-07-27 02:34:45
af061120444687289efba5a6b5f5300749e96c90...03105fd4950dc4c46645ee5cc38212796228f3f4,1,1,0,1,1,2013-07-27 02:34:59,2013-07-27 02:34:59
e18e2435b32b8b15ca3e2c0a71ac365dacdf550f...1b4ee9c90f254dd9a1df9cac649e419669a10198,1,12,8,20,3,2013-07-16 22:12:56,2013-07-16 21:41:26
e18e2435b32b8b15ca3e2c0a71ac365dacdf550f...5e74644ab963be49e7305d680d02d4aa6b6317d7,1,5,2,7,2,2013-07-16 21:42:32,2013-07-16 21:41:26
5e74644ab963be49e7305d680d02d4aa6b6317d7...02a3db6fb344f5cbf506964885062fbfcae2556d,1,11,10,21,4,2013-07-16 22:10:06,2013-07-16 22:10:06
a3422328685a1d783ff8568d64f8e08485f6d9cc...c50134beaf2f2e1ebedf2ae4474a2e51cdf020e4,1,10,5,15,4,2013-07-14 00:34:35,2013-07-14 00:34:35
c50134beaf2f2e1ebedf2ae4474a2e51cdf020e4...f658983622fd3d88e91ac5ea453a9065982ea0f7,1,137,0,137,1,2013-07-14 00:35:27,2013-07-14 00:35:27
f658983622fd3d88e91ac5ea453a9065982ea0f7...01bf367b65ef34752c898729749d6f6b898bd7c4,1,1,1,2,1,2013-07-14 00:39:50,2013-07-14 00:39:50
01bf367b65ef34752c898729749d6f6b898bd7c4...ccde6a051f2dc1214c5af161b00524d739bdbeac,15,80,78,158,32,2013-07-14 18:11:24,2013-07-14 18:11:24
ccde6a051f2dc1214c5af161b00524d739bdbeac...a116be3f83158f1bed48666f6af9687465e67bae,2,50,35,85,25,2013-07-16 17:22:36,2013-07-16 17:22:36
a116be3f83158f1bed48666f6af9687465e67bae...9c8106360a6e30cff4f8113a1b603a0bd8db6a1a,1,2,0,2,1,2013-07-16 18:34:29,2013-07-16 18:34:29
9c8106360a6e30cff4f8113a1b603a0bd8db6a1a...14f6574135a8b53f2ad83d466b6b647e6727bd1d,3,157,64,221,20,2013-07-17 00:31:09,2013-07-17 00:31:09
1a40e238d223cdd5ec64b53ab5bf9770b18900f2...924448fdf9161b7faf80cf14797a9d117b8e6ebe,1,2,0,2,1,2013-07-10 18:58:12,2013-07-10 18:58:12
924448fdf9161b7faf80cf14797a9d117b8e6ebe...82552022d8c866c72de197a1d5c6d409d39db2ef,4,178,14,192,10,2013-07-10 19:42:29,2013-06-21 01:48:09
2142d97dd30234c30d8b30010e895a968f25ef88...ab8a83f078cb045bb3a9efede29b8ec64ed3b11b,3,78,33,111,20,2013-07-08 18:23:53,2013-06-24 20:32:06
ab8a83f078cb045bb3a9efede29b8ec64ed3b11b...8bce08db3e5173cc49b7e0f9ebb70c7612aa27bd,1,1,1,2,1,2013-07-08 18:23:53,2013-06-25 17:44:17
8bce08db3e5173cc49b7e0f9ebb70c7612aa27bd...1ee24a4fcbad62f016e26024dc1a4ba56bf6bbdf,1,9,4,13,5,2013-07-08 18:23:53,2013-06-25 17:51:52
1ee24a4fcbad62f016e26024dc1a4ba56bf6bbdf...09fcab2cf859e0f8ce8979420b140ff153dacb87,2,25,25,50,13,2013-07-08 18:23:53,2013-06-26 18:30:19
09fcab2cf859e0f8ce8979420b140ff153dacb87...3f8998d95654e4b485a0280226622a40ce3d838a,2,4,5,9,3,2013-07-08 18:23:53,2013-06-26 19:15:09
3f8998d95654e4b485a0280226622a40ce3d838a...cf6eb7221f52b5c9c28a6aa3ba9f5b3a78cad496,2,10,24,34,8,2013-07-08 18:23:53,2013-06-28 02:04:14
cf6eb7221f52b5c9c28a6aa3ba9f5b3a78cad496...5993609bd370f580ae25af33a47ba25f7f8a848d,2,31,25,56,19,2013-07-08 18:25:07,2013-06-28 05:45:04
5993609bd370f580ae25af33a47ba25f7f8a848d...6340bcc121e8f8dbdfab0602798863505d45f949,1,3,1,4,1,2013-07-08 18:25:07,2013-07-08 18:06:45
6340bcc121e8f8dbdfab0602798863505d45f949...5979a518a9357160d95a5a499fc81624d8f071aa,1,1,0,1,1,2013-07-08 18:25:07,2013-07-08 18:18:35
5979a518a9357160d95a5a499fc81624d8f071aa...fffe315c0740a759649ef372d39b9bad9987457b,1,3,2,5,1,2013-07-08 19:00:49,2013-07-08 19:00:49
1f2a770117ee2c70cb11469e2347ee15fd59d0a5...698de75b129945bb4be8c539b0251a2e65d4ec94,1,42,10,52,12,2013-06-28 23:32:36,2013-06-28 22:48:12
698de75b129945bb4be8c539b0251a2e65d4ec94...ec34962e6f8af893fc4bd26943a819d16e48eb48,1,2,2,4,2,2013-06-28 23:32:36,2013-06-28 23:06:28
ec34962e6f8af893fc4bd26943a819d16e48eb48...2b2e60bbad9a444fa19b81e640ca42e266564211,1,9,4,13,4,2013-06-28 23:32:36,2013-06-28 23:09:22
2b2e60bbad9a444fa19b81e640ca42e266564211...b8bb929e791c1e91036e2296b10b98b178072005,1,13,18,31,9,2013-06-28 23:32:36,2013-06-28 23:11:55
b8bb929e791c1e91036e2296b10b98b178072005...9293e7164ab8dde8c3eb8e2909796e518a7f05b3,1,18,5,23,6,2013-06-28 23:32:36,2013-06-28 23:18:04
9293e7164ab8dde8c3eb8e2909796e518a7f05b3...3c4d0a11f36b33aedc5f09e0822a30e77540c558,3,9,0,9,3,2013-06-28 23:39:45,2013-06-28 23:39:45
3c4d0a11f36b33aedc5f09e0822a30e77540c558...50392a5a17bfeaf9f705bc31c91873a709dc4841,1,2,0,2,1,2013-07-01 20:01:34,2013-07-01 20:01:34
357ec8e8b8070b2a2a4612cb626776e7f14e8058...15e190f073ba19af94b17f668a3e3e63459ceb58,2,102,76,178,48,2013-05-28 19:15:47,2013-04-06 04:33:20
15e190f073ba19af94b17f668a3e3e63459ceb58...8e630c6b8de31a6720821ea9101193b0d1412b72,1,2,3,5,2,2013-05-28 19:15:52,2013-04-06 04:36:29
8e630c6b8de31a6720821ea9101193b0d1412b72...34c42d76b5e0a749616328bdeb5d4d13b11cd932,6,42,31,73,18,2013-05-28 19:23:11,2013-05-24 23:53:01
34c42d76b5e0a749616328bdeb5d4d13b11cd932...043b6530d7d52f1dd91deeca8c20760fba2c856e,1,1,1,2,1,2013-05-28 19:23:42,2013-05-28 19:23:42
7f64c726f7ae526a86a415256a0d48f48e7dad36...89df75b15e0298d2e82a2e65341780d55b034cae,2,6,3,9,3,2013-10-02 23:12:13,2013-10-02 23:12:13
89df75b15e0298d2e82a2e65341780d55b034cae...0e2d56d382db715045f8af1a48d7dbbc1af7eb42,1,11,7,18,5,2013-10-03 03:28:07,2013-10-03 03:28:07
0e2d56d382db715045f8af1a48d7dbbc1af7eb42...c20db8d3287e2fe19a026bad75659105454cf06f,4,40,5,45,5,2013-10-03 04:21:10,2013-10-03 04:21:10
c20db8d3287e2fe19a026bad75659105454cf06f...d3ec00c3ef077d172fc10de6864803a2b91ca519,3,310,256,566,38,2013-10-03 06:00:23,2013-10-03 06:00:23
d3ec00c3ef077d172fc10de6864803a2b91ca519...5f84141145b407ad9686776315fe9e0d281fa6e1,1,25,25,50,4,2013-10-03 15:38:10,2013-10-03 15:36:23
5f84141145b407ad9686776315fe9e0d281fa6e1...a39ff3cc145c33624abde9bdffdf86848e178e69,1,3,0,3,1,2013-10-03 17:00:08,2013-10-03 17:00:08
a39ff3cc145c33624abde9bdffdf86848e178e69...82579293f3752782969afa014e52b9526f7a878c,3,7,9,16,3,2013-10-03 17:16:07,2013-10-03 17:16:07
7f64c726f7ae526a86a415256a0d48f48e7dad36...420be7abc67711ea2ce1f70a89a564fa74d4f1e0,2,34,1,35,4,2013-10-02 22:34:49,2013-09-24 22:13:04
420be7abc67711ea2ce1f70a89a564fa74d4f1e0...49aec0c2d483e02de537f5e760b359082988f78d,2,25,17,42,9,2013-10-02 22:34:49,2013-09-25 00:00:07
49aec0c2d483e02de537f5e760b359082988f78d...83a944fdb486348b312ee9d1d10e0e4923cd01bd,2,32,23,55,20,2013-10-02 22:47:49,2013-09-25 15:18:16
83a944fdb486348b312ee9d1d10e0e4923cd01bd...6158599ab4b34d38e55adb76ff9c0541d6eed3ef,1,7,0,7,1,2013-10-02 22:47:59,2013-09-25 17:27:53
6158599ab4b34d38e55adb76ff9c0541d6eed3ef...cd3edc6a2b609862c6ecf0ce9c49a60af2f1d86e,1,3,3,6,3,2013-10-02 22:47:59,2013-09-25 17:29:13
cd3edc6a2b609862c6ecf0ce9c49a60af2f1d86e...5888a9b114fc85b6ce15fa51233deb72222d9f25,1,34,32,66,20,2013-10-02 22:47:59,2013-09-25 18:14:04
5888a9b114fc85b6ce15fa51233deb72222d9f25...0587f3293b4a0c441ac58c88539af04fbecfbad1,3,21,3,24,5,2013-10-02 22:48:00,2013-09-25 18:43:36
0587f3293b4a0c441ac58c88539af04fbecfbad1...1de8d392b6f6cc3c88daf9de84e26bf7c5cbd996,2,16,1,17,2,2013-10-02 22:48:00,2013-09-26 01:07:06
1de8d392b6f6cc3c88daf9de84e26bf7c5cbd996...fb7309881ddb7e6c4c58edf57536595d0d8fe167,4,453,0,453,4,2013-10-02 22:48:00,2013-09-27 19:38:49
fb7309881ddb7e6c4c58edf57536595d0d8fe167...a1a555558a6a02ba7e7f2b997c6716b863577f99,1,1,0,1,1,2013-10-02 22:48:00,2013-09-27 21:24:24
a1a555558a6a02ba7e7f2b997c6716b863577f99...d68661192f9f9b034fd8e4d284498a26a58ddb65,3,36,5,41,9,2013-10-02 22:48:00,2013-09-27 21:54:56
d68661192f9f9b034fd8e4d284498a26a58ddb65...b5230e6fee347901bf0e5a79e56d64ca132489e6,1,1,1,2,1,2013-10-02 22:48:00,2013-09-27 21:59:51
b5230e6fee347901bf0e5a79e56d64ca132489e6...8fa42acdbe18a0c954e67918a5323bb48110b542,1,2,2,4,2,2013-10-02 22:48:00,2013-09-27 22:02:17
8fa42acdbe18a0c954e67918a5323bb48110b542...a5534ca414bd5ce23a7edbb47e0686a52c50c12c,2,32,6,38,4,2013-10-02 22:48:00,2013-09-27 22:53:25
a5534ca414bd5ce23a7edbb47e0686a52c50c12c...9b8971ede65c9755f4662c58628137c8454aeb56,2,6,5,11,4,2013-10-02 22:48:00,2013-09-27 23:58:38
9b8971ede65c9755f4662c58628137c8454aeb56...3f976e874f0e34e06f5c6e8ab240f73e2c1a64f7,1,1,1,2,1,2013-10-02 22:48:00,2013-09-28 00:14:40
3f976e874f0e34e06f5c6e8ab240f73e2c1a64f7...3e6da8b2666532c0f9fd7bc5c05a6a295aa606e7,2,9,1,10,3,2013-10-02 22:48:00,2013-09-28 00:35:07
3e6da8b2666532c0f9fd7bc5c05a6a295aa606e7...638dd0566b389e9ed9d627c06c72c75768f39ab1,4,33,4,37,6,2013-10-02 22:48:00,2013-09-28 01:00:27
638dd0566b389e9ed9d627c06c72c75768f39ab1...e127ed25aaa53b299d3f40828e0648de8ac41ec6,1,2,0,2,1,2013-10-02 22:48:01,2013-09-28 02:59:30
e127ed25aaa53b299d3f40828e0648de8ac41ec6...f902d6f55edb06da094b81281270c8868bbd339b,3,4,23,27,5,2013-10-02 22:48:01,2013-09-30 22:16:26
f902d6f55edb06da094b81281270c8868bbd339b...56aeac63ddd2a7e703c78cb63b71e5601df629b9,1,1,1,2,1,2013-10-02 22:48:01,2013-09-30 22:33:31
56aeac63ddd2a7e703c78cb63b71e5601df629b9...9e898fe1e975877595fe1df8b2a96f7db18a0854,2,7,0,7,2,2013-10-02 22:48:01,2013-09-30 22:46:31
9e898fe1e975877595fe1df8b2a96f7db18a0854...aacd87505ea5b69927b5fa6a9943c160d3354cb1,1,41,20,61,1,2013-10-02 23:39:41,2013-10-02 23:39:41
aacd87505ea5b69927b5fa6a9943c160d3354cb1...1e103b8e46bb9022492ec0d600ca05bdfa2d6027,1,8,7,15,1,2013-10-03 02:12:35,2013-10-03 01:37:38
1e103b8e46bb9022492ec0d600ca05bdfa2d6027...b58c85f323953567d9c88ecf57f984ee86f8344a,1,8,7,15,4,2013-10-03 02:19:51,2013-10-03 02:19:51
b58c85f323953567d9c88ecf57f984ee86f8344a...cd500b036cb46f7d44f54b91750d249da51287b3,1,16,0,16,3,2013-10-03 20:43:13,2013-10-03 20:43:13
cd500b036cb46f7d44f54b91750d249da51287b3...43aa4de53002905f20963bdce6ffe42956869e69,1,29,0,29,1,2013-10-03 21:11:29,2013-10-03 21:11:29
43aa4de53002905f20963bdce6ffe42956869e69...3b26a51296bb563571ffd19cc17897a032d64c14,1,1,2,3,1,2013-10-03 21:13:51,2013-10-03 21:13:51
3b26a51296bb563571ffd19cc17897a032d64c14...7c9122ef09cadeca9b14783454a0bed796b44ee5,2,2,4,6,2,2013-10-07 21:30:54,2013-10-07 21:30:54
7c9122ef09cadeca9b14783454a0bed796b44ee5...d1518f4f17924f7760f2a8ae53d584b0fee32559,4,11,5,16,5,2013-10-07 23:07:45,2013-10-07 21:45:00
d1518f4f17924f7760f2a8ae53d584b0fee32559...24b3ca13e1c0bbb4ad1e7acc9bf2e7194d9f25a7,3,19,1,20,4,2013-10-07 23:50:27,2013-10-07 23:19:45
8a7b1ddf35748bc0b14c4e8414aa22f2d7c5f08a...d757b366d28d5d842bcb0fae96ffe8961aa7f055,21,33,15,48,27,2013-05-28 22:52:50,2013-05-28 22:52:50
d757b366d28d5d842bcb0fae96ffe8961aa7f055...729e53171d9b4a7a14e219b832ad2b5717883a12,12,18,18,36,12,2013-05-28 22:56:58,2013-05-28 22:56:58
90e97f8345cd065ba04c27b44ebc5289092a7dd3...8703e5d99af2ed2d5f75e3535611dff40a5616b0,1,5,4,9,4,2013-05-28 23:33:46,2013-05-28 23:33:46
8703e5d99af2ed2d5f75e3535611dff40a5616b0...cc4c762afb4ca965eae3444a9cf8103ab1e8f83b,1,1,1,2,1,2013-05-29 02:41:30,2013-05-29 02:41:30
cc4c762afb4ca965eae3444a9cf8103ab1e8f83b...35363b4516885b57b01c85bb8bce89ea97ab300e,1,1,4,5,3,2013-05-29 03:18:54,2013-05-29 03:18:54
35363b4516885b57b01c85bb8bce89ea97ab300e...80830ec2fe703ed845340a3389a465e05f0209bf,1,9,4,13,5,2013-05-29 03:19:28,2013-05-29 03:19:28
80830ec2fe703ed845340a3389a465e05f0209bf...0070812fba3958a7da3ce867380d2af1f2e4abd0,1,1,1,2,1,2013-05-29 17:44:12,2013-05-29 17:44:12
0070812fba3958a7da3ce867380d2af1f2e4abd0...50bd0ab0bc0d9effbdd37ab721faf5e60eca31ed,1,10,3,13,7,2013-05-29 18:31:39,2013-05-29 18:31:39
50bd0ab0bc0d9effbdd37ab721faf5e60eca31ed...a3447577ecd950d1180e7b48204aa3ba60decfca,2,3,3,6,3,2013-05-29 19:30:31,2013-05-29 19:02:31
a3447577ecd950d1180e7b48204aa3ba60decfca...410c5722bfd07a01b569567d8c8712d00587f26b,2,31,4,35,3,2013-05-29 19:30:41,2013-05-29 19:19:41
410c5722bfd07a01b569567d8c8712d00587f26b...f75730e3c4d790b53effeafda7df0f37e5408b45,1,7,0,7,1,2013-05-29 19:30:54,2013-05-29 19:29:19
f75730e3c4d790b53effeafda7df0f37e5408b45...5596dcf40f20092d3620c622177c93bec8a64ef4,2,7,2,9,3,2013-05-29 19:39:21,2013-05-29 19:39:21
5596dcf40f20092d3620c622177c93bec8a64ef4...48c1b9bb483f19410e7308c49de4c8dd9534c8a7,2,7,3,10,2,2013-05-29 20:40:06,2013-05-29 20:40:06
48c1b9bb483f19410e7308c49de4c8dd9534c8a7...34157ebce491fccff693ca4cf572e081b16c0615,2,8,11,19,9,2013-05-29 21:10:29,2013-05-29 21:10:29
34157ebce491fccff693ca4cf572e081b16c0615...31e742e745127f57b9587526a2da6b48a05b46d1,1,18,12,30,5,2013-05-29 22:29:10,2013-05-29 22:28:19
31e742e745127f57b9587526a2da6b48a05b46d1...fc3a5c14d1aaf3eabd653a9c08e041611b0fbde8,1,29,16,45,6,2013-05-30 01:08:44,2013-05-30 01:08:44
fc3a5c14d1aaf3eabd653a9c08e041611b0fbde8...9a4948d8edc226ab906a433959a905a18e33a1c9,2,9,0,9,3,2013-05-30 01:28:26,2013-05-30 01:27:46
9a4948d8edc226ab906a433959a905a18e33a1c9...c3513374bb1ba0941dce5d47d572755b7f118e85,1,6,4,10,1,2013-05-30 18:21:09,2013-05-30 17:38:41
c3513374bb1ba0941dce5d47d572755b7f118e85...ddd33534b1c2360e6c211bf68ee388e5e3be1a7f,1,5,10,15,3,2013-05-30 21:46:29,2013-05-30 21:46:09
ddd33534b1c2360e6c211bf68ee388e5e3be1a7f...808c3c8f283c250fa0d7d22f9d8b998425217eb2,2,26,14,40,7,2013-05-30 22:04:48,2013-05-30 19:55:13
808c3c8f283c250fa0d7d22f9d8b998425217eb2...878ca94a72046dfeb5375ca8b352fad781592596,1,3,0,3,1,2013-05-30 22:07:01,2013-05-30 22:07:01
878ca94a72046dfeb5375ca8b352fad781592596...ca8b0408ef90cdd5bad794e64b904d65043befa1,1,3,0,3,1,2013-05-30 22:15:07,2013-05-30 22:15:07
ca8b0408ef90cdd5bad794e64b904d65043befa1...f260ce2887240ef58eacdd7d9146dbd59bf4eef0,2,24,10,34,9,2013-05-30 22:20:50,2013-05-30 22:20:50
f260ce2887240ef58eacdd7d9146dbd59bf4eef0...61327d97ce811b23f936bb9bdcf12967904aabee,3,130,29,159,17,2013-05-31 01:02:46,2013-05-17 18:20:28
61327d97ce811b23f936bb9bdcf12967904aabee...0665b33d4f808332e64214aba6800452b5900fca,1,1,1,2,1,2013-05-31 17:52:58,2013-05-31 17:52:58
0665b33d4f808332e64214aba6800452b5900fca...7d4ee2209e196519eac515abf907f751854412ec,1,14,3,17,3,2013-05-31 18:28:26,2013-05-31 18:28:26
7d4ee2209e196519eac515abf907f751854412ec...51db0d26468d2e2707442ad7e72dae2eac29d4ef,2,8,4,12,5,2013-05-31 23:21:57,2013-05-31 23:21:57
51db0d26468d2e2707442ad7e72dae2eac29d4ef...3b52f10e7acc8460a3854cd6ab2f80c7b3b29449,1,1,1,2,1,2013-06-03 17:04:02,2013-06-03 17:04:02
3b52f10e7acc8460a3854cd6ab2f80c7b3b29449...9588e4002eb9e285d6d860d3c5b18cac94788c7c,1,14,8,22,4,2013-06-03 17:08:43,2013-06-03 17:08:43
9588e4002eb9e285d6d860d3c5b18cac94788c7c...e682c979770e35c6c4f9d0f9aaf7c3198cf548c3,2,17,11,28,13,2013-06-03 17:41:12,2013-06-03 17:41:12
e682c979770e35c6c4f9d0f9aaf7c3198cf548c3...5e2bf58c3e006ee193e470f8c239138f9154db9b,1,1,1,2,1,2013-06-04 01:01:28,2013-06-04 01:01:28
5e2bf58c3e006ee193e470f8c239138f9154db9b...fb159e270f11fb8ea07923821d96543ba7aaa6a4,2,8,5,13,6,2013-06-04 17:57:02,2013-06-04 17:55:46
fb159e270f11fb8ea07923821d96543ba7aaa6a4...a840d29f60085fa99166b1b9de38c4c2cf419853,3,35,12,47,8,2013-06-06 01:45:09,2013-06-06 01:45:09
a840d29f60085fa99166b1b9de38c4c2cf419853...4c55a2623e77e17cf71c38836bf33f5953d21dbe,1,2,0,2,1,2013-06-06 03:57:49,2013-06-06 03:57:49
4c55a2623e77e17cf71c38836bf33f5953d21dbe...c701291e94b5aec68f162574b2d4be681f9a3d61,1,3,3,6,2,2013-06-06 04:09:01,2013-06-06 04:09:01
c701291e94b5aec68f162574b2d4be681f9a3d61...5c080445326c69ef0ace0c7a97800c702b84b956,1,14,0,14,1,2013-06-06 04:49:23,2013-06-06 04:49:23
5c080445326c69ef0ace0c7a97800c702b84b956...e25f2f594a23a348cd1e9e86d79b3ec264cd322d,1,6,10,16,5,2013-06-06 07:38:14,2013-06-06 06:46:14
e25f2f594a23a348cd1e9e86d79b3ec264cd322d...d0a000a15ba59de5eca4a1f4461e29facb378594,1,8,1,9,1,2013-06-06 07:45:22,2013-06-06 07:45:22
d0a000a15ba59de5eca4a1f4461e29facb378594...91550319866f586ce70fa0e725abc010e2eb9a45,1,3,4,7,3,2013-06-07 00:49:38,2013-06-07 00:49:38
91550319866f586ce70fa0e725abc010e2eb9a45...32fe325d490a467ea4551e3af2039faf3b88d5a1,4,132,16,148,12,2013-06-07 04:33:43,2013-06-07 02:38:31
32fe325d490a467ea4551e3af2039faf3b88d5a1...8c835c8207abfd2fae683d3f439cd8a486bd083a,1,3,3,6,2,2013-06-07 05:18:08,2013-06-07 05:18:08
8c835c8207abfd2fae683d3f439cd8a486bd083a...9abf2251c614c42a3cf8398eb3fbd570979243c5,1,1,1,2,1,2013-06-07 05:19:26,2013-06-07 05:19:26
9abf2251c614c42a3cf8398eb3fbd570979243c5...4ccc3ddf5bd0ec0aca56eebaf776ad8d5875d0e9,1,1,1,2,1,2013-06-07 05:21:24,2013-06-07 05:21:24
4ccc3ddf5bd0ec0aca56eebaf776ad8d5875d0e9...7714ea04b937bb7ad3a547196fc58f3c67cf0b84,1,2,1,3,1,2013-06-07 19:42:14,2013-06-07 19:42:07
c299785b86d9cc33536e3ab9441fe79cacbafc95...485d9633478435b3943611adf57b2b9f6dd5a3bd,1,4,2,6,2,2013-03-23 00:07:23,2013-03-23 00:07:23
485d9633478435b3943611adf57b2b9f6dd5a3bd...9f397fbbdca89a5c84d4f3a896ab3113b777f64b,1,3,0,3,1,2013-03-23 00:16:00,2013-03-23 00:16:00
9f397fbbdca89a5c84d4f3a896ab3113b777f64b...d9667c97618a0bf64c53dd0e579a5ac90280df42,2,2,2,4,2,2013-03-23 01:22:52,2013-03-19 22:00:22
d9667c97618a0bf64c53dd0e579a5ac90280df42...6af118529cd229ce1dda4174dc749c87c0aa34e1,1,3,2,5,1,2013-03-23 02:09:42,2013-03-23 02:08:42
6af118529cd229ce1dda4174dc749c87c0aa34e1...d5c85ec5c4c4325837086278d06b423d938beb79,8,302,56,358,16,2013-03-23 02:15:18,2013-03-23 00:00:21
d5c85ec5c4c4325837086278d06b423d938beb79...9a38eb2b56f991a48dbfd0161133dd76d49cee12,1,10,4,14,4,2013-03-23 05:00:14,2013-03-23 05:00:14
9a38eb2b56f991a48dbfd0161133dd76d49cee12...18a0e0ab72aedc4fdc6388d8c320c7674764fda4,2,80,26,106,18,2013-03-23 05:34:03,2013-03-23 05:34:03
18a0e0ab72aedc4fdc6388d8c320c7674764fda4...001476036cc83b4289617f60e90b0548bced2cef,1,10,10,20,7,2013-03-23 05:37:34,2013-03-23 05:37:14
001476036cc83b4289617f60e90b0548bced2cef...c05b0dd652dbc614bb389295532441697d3252b3,1,2,3,5,2,2013-03-23 06:39:10,2013-03-23 06:38:57
c05b0dd652dbc614bb389295532441697d3252b3...8ebcca8f6d0ca3b40d8fdfb9bf0c196362873d5d,4,137,154,291,4,2013-03-23 06:47:33,2013-03-23 06:28:55
8ebcca8f6d0ca3b40d8fdfb9bf0c196362873d5d...27923d8b24f7ae52d57df1e6e0039f77f15b2af1,11,6,6,12,6,2013-03-23 06:52:54,2013-03-23 06:52:45
27923d8b24f7ae52d57df1e6e0039f77f15b2af1...661484fe1442bd249cbc7a617c003a6264f77e30,1,1,1,2,1,2013-03-23 20:01:53,2013-03-23 18:21:05
0bac1b3e2d356c16d806c4c2bfc763d56cb9f67c...5eaf672c1562ce4cc069464b75c36829c277d4ec,2,22,0,22,2,2013-03-11 22:27:34,2013-03-11 22:27:34
5eaf672c1562ce4cc069464b75c36829c277d4ec...17c21705a70232a277f64b2603d0e0ad029531e2,1,9,3,12,3,2013-03-12 00:09:29,2013-03-12 00:09:29
17c21705a70232a277f64b2603d0e0ad029531e2...bf0b8f961f22cf6a5252b355426d1ae0c156cbeb,2,15,7,22,3,2013-03-12 00:38:13,2013-03-12 00:38:13
0bac1b3e2d356c16d806c4c2bfc763d56cb9f67c...71f54afccda4a538aa279f52946e09bcb81fafbb,7,128,0,128,7,2013-03-10 22:10:22,2013-03-10 22:10:22
71f54afccda4a538aa279f52946e09bcb81fafbb...6508299f78ef7ba9ad6f9157e3b8e03b3ec2bdb8,3,11,9,20,4,2013-03-10 22:14:31,2013-03-10 22:14:31
6508299f78ef7ba9ad6f9157e3b8e03b3ec2bdb8...4cd49f0d5fb62589da5a2c59e92c523d4900c97b,2,6,1,7,3,2013-03-10 22:23:52,2013-03-10 22:23:52
4cd49f0d5fb62589da5a2c59e92c523d4900c97b...429aa690a42e8f0f9282ca4a63bff052e45ea25e,1,7,1,8,1,2013-03-12 03:52:52,2013-03-12 03:52:52
429aa690a42e8f0f9282ca4a63bff052e45ea25e...080ea928b8631dde9a19ca14dce738c268e2321c,1,2,0,2,1,2013-03-12 04:03:16,2013-03-12 04:03:16
2b4fb43bda5055098f86000e1936062f3ff45fbe...00eedc65983f7582cd06a30c81002e27cd03c10a,3,79,9,88,16,2013-03-10 02:03:10,2013-03-10 02:03:10
00eedc65983f7582cd06a30c81002e27cd03c10a...0ee4446315e6d82e8cc80007c8e529778d2b6239,2,30,12,42,6,2013-03-10 21:48:42,2013-03-10 21:48:42
0ee4446315e6d82e8cc80007c8e529778d2b6239...71ad7790ff7b2de1a5d95d5b3f713a27aa816c07,1,6,0,6,1,2013-03-11 19:34:22,2013-03-11 19:34:22
71ad7790ff7b2de1a5d95d5b3f713a27aa816c07...1653c091e702bcf84cef1be2acc07baf7151b4c6,9,89,89,178,69,2013-03-11 22:49:17,2013-03-11 22:49:17
1653c091e702bcf84cef1be2acc07baf7151b4c6...1c4041ee7109f3ddf5aa9deaf39b51c3c5d1ad79,2,43,9,52,7,2013-03-12 00:52:38,2013-03-12 00:52:38
4f2d725d3f068f58f94979f3b5601778fa6e705e...d1c780e7f90e4b98abdbed60098907f527a8845d,2,3,3,6,3,2013-02-09 05:11:50,2013-02-08 17:00:22
38bd2c98bfa9add29eebf0615b8c69a8c32cd5bd...ce84c228e0ca9b96bf26f11867eea2447dcd0c8f,1,4,2,6,2,2014-02-25 04:52:55,2014-02-25 04:52:55
ce84c228e0ca9b96bf26f11867eea2447dcd0c8f...0aa0bf0ade3ddf895c52717cff87970a8bf15f31,1,15,2,17,4,2014-02-25 08:28:48,2014-02-25 08:28:48
0aa0bf0ade3ddf895c52717cff87970a8bf15f31...787e91f26c7c3c239dc801b6a9c1d89490d74236,1,0,2,2,1,2014-02-25 18:09:13,2014-02-24 19:57:59
787e91f26c7c3c239dc801b6a9c1d89490d74236...02325f6e3cd89cce03c0d28a8ca4c5f3bbcbaf46,1,36,0,36,1,2014-02-25 22:48:31,2014-02-25 22:47:58
02325f6e3cd89cce03c0d28a8ca4c5f3bbcbaf46...f778a2c0fc3cb4d3c1c9575c881be965af77ff2f,1,21,1,22,1,2014-02-25 23:08:15,2014-02-25 23:08:15
f778a2c0fc3cb4d3c1c9575c881be965af77ff2f...3e76fc9de417c1553d811817a3cd215003f61f24,1,56,33,89,12,2014-02-25 23:09:25,2014-02-25 23:09:25
0db5b9393a121dc1d142cd85f8e99c6350ed9740...a21f0d2e582a9cdbde61b67345dd36cd4b1527a7,1,4,1,5,1,2013-12-20 00:54:03,2013-12-08 07:46:13
a21f0d2e582a9cdbde61b67345dd36cd4b1527a7...6844cb2615b0020c5bcb445bc50a1c04e9ae9460,3,9,0,9,3,2013-12-20 01:00:38,2013-12-20 01:00:38
6844cb2615b0020c5bcb445bc50a1c04e9ae9460...f65b1cd2ae88fde77be6ec64d363971d38acf0c0,1,1,3,4,1,2013-12-20 01:00:58,2013-12-20 01:00:58
305a406de63152a3c42080020897289963bbcbe2...e0afb8e391bc1cfc3056c1ca65b0daa289db9321,2,24,13,37,17,2013-12-17 21:52:57,2013-12-17 21:52:57
e0afb8e391bc1cfc3056c1ca65b0daa289db9321...6ff52b89f4bd6eb6cedac074662d896940633871,1,1,1,2,1,2013-12-17 22:12:51,2013-12-17 22:12:51
6ff52b89f4bd6eb6cedac074662d896940633871...84cb3ae916172f30c8e0eb89a338ae6a724d4d77,1,1,1,2,1,2013-12-17 23:52:46,2013-12-17 23:52:46
84cb3ae916172f30c8e0eb89a338ae6a724d4d77...ec86a2dcc5761578ac402bb567791d74e38fc5a4,1,0,2,2,1,2013-12-18 00:44:33,2013-12-18 00:44:33
ec86a2dcc5761578ac402bb567791d74e38fc5a4...e61e4487f9df24e838c19330c1c545b9dd13fe6e,1,2,1,3,2,2013-12-18 02:27:17,2013-12-18 02:27:17
e61e4487f9df24e838c19330c1c545b9dd13fe6e...ddb0f6170ffda51d1e672845d1745abd426749ab,1,5,5,10,1,2013-12-18 02:32:51,2013-12-18 02:32:51
ddb0f6170ffda51d1e672845d1745abd426749ab...b1a9457be1fc5f240da7b723b83fd838cad7563e,2,6,4,10,4,2013-12-18 02:44:26,2013-12-18 02:43:10
b1a9457be1fc5f240da7b723b83fd838cad7563e...5102db333532a3199770f3c8e58b1127955dbc47,2,7,2,9,3,2013-12-18 03:10:01,2013-12-18 03:10:01
5102db333532a3199770f3c8e58b1127955dbc47...9ddb32628043f8fd3db14e4896600320648b846c,2,42,0,42,2,2013-12-18 03:24:52,2013-12-18 03:24:52
9ddb32628043f8fd3db14e4896600320648b846c...30a4b2b7d463ac22980661a23eec0e4743a52d20,2,28,6,34,8,2013-12-18 20:09:35,2013-12-18 20:09:35
5d6408146c16f2637cfd6506e5b0c5f97296c4e5...3f262692d08dc690861ad6570cdf77c9f63d4cfb,1,9,6,15,6,2013-11-11 20:33:58,2013-11-11 20:33:58
3f262692d08dc690861ad6570cdf77c9f63d4cfb...dcc68f579699627711524b1b69f56b5bc4f9b7cd,1,1,1,2,1,2013-11-12 02:15:52,2013-11-12 01:18:00
679100f1ba75c839a7a58cbbd6db7d232a1b9bc7...21afac1e2dbf3e65e0c58d28ca9ef7e4ca6d0af6,1,36,0,36,19,2013-10-23 16:47:32,2013-10-23 06:12:16
21afac1e2dbf3e65e0c58d28ca9ef7e4ca6d0af6...0d6922c9016667fcc5c1ffa3e2f42462d48e2596,1,2,2,4,1,2013-10-24 18:18:59,2013-10-24 18:18:59
0d6922c9016667fcc5c1ffa3e2f42462d48e2596...5afd0d5fb1144ba7f91267a9fc474218ef1f8ca4,2,12,2,14,3,2013-10-29 18:11:05,2013-10-29 18:10:27
679100f1ba75c839a7a58cbbd6db7d232a1b9bc7...9d2c7f43e2cbd583a378dc4eb37167039a16406f,3,74,0,74,5,2013-10-23 06:07:29,2013-08-14 20:36:44
9d2c7f43e2cbd583a378dc4eb37167039a16406f...8f82f79e4cf142bdd15115f6525b5bcd6ac0b258,3,116,63,179,20,2013-10-23 06:07:29,2013-08-15 02:08:47
8f82f79e4cf142bdd15115f6525b5bcd6ac0b258...969c5c424754243665af69578db50bdca9622876,1,61,50,111,4,2013-10-23 06:07:30,2013-08-15 02:49:18
969c5c424754243665af69578db50bdca9622876...be2d4510f23e09a364836a2949228aee9779a9a0,1,110,87,197,7,2013-10-23 06:07:30,2013-08-15 03:36:53
be2d4510f23e09a364836a2949228aee9779a9a0...ad4c397213fcf04bff56878f28a36f6a28db509a,2,63,4,67,11,2013-10-23 06:07:30,2013-08-18 18:51:45
ad4c397213fcf04bff56878f28a36f6a28db509a...ffcdff13ca47c024b1e45df5ab1fca3c28ad9989,1,69,1,70,7,2013-10-23 06:07:30,2013-08-19 23:24:05
ffcdff13ca47c024b1e45df5ab1fca3c28ad9989...7de6274540f604c8420fe10846d884b40d63a951,1,16,10,26,4,2013-10-23 06:07:30,2013-08-20 03:05:15
7de6274540f604c8420fe10846d884b40d63a951...a964863f2e9efd646fd3ae9d5d5cadb262f8d541,3,70,8,78,8,2013-10-23 06:07:30,2013-08-20 03:23:52
a964863f2e9efd646fd3ae9d5d5cadb262f8d541...2f87fd648d554292b9ff107019d6a64924706b90,2,94,23,117,10,2013-10-23 06:07:30,2013-08-20 04:22:08
2f87fd648d554292b9ff107019d6a64924706b90...2d77a034df2e0edbd164dfa3a6ffb30e81fda721,1,6,2,8,1,2013-10-23 06:07:30,2013-08-20 05:29:08
2d77a034df2e0edbd164dfa3a6ffb30e81fda721...7bc64091996ecaee6f8f448ed94a4d0d916a6633,1,106,31,137,7,2013-10-23 06:07:30,2013-09-11 00:20:40
7bc64091996ecaee6f8f448ed94a4d0d916a6633...84242156b0ef7ba2d6f23c2c8c1d06e23fdf9054,1,4,0,4,1,2013-10-23 06:07:30,2013-09-11 18:17:37
84242156b0ef7ba2d6f23c2c8c1d06e23fdf9054...f9d695f95482edcbd6dee05b6f0621b623999b15,1,15,13,28,7,2013-10-23 06:07:30,2013-09-12 18:18:11
f9d695f95482edcbd6dee05b6f0621b623999b15...59eedf3c5a9ac64c303bb78a30a65033e01cc8cc,1,44,65,109,10,2013-10-23 06:07:30,2013-09-13 03:49:37
59eedf3c5a9ac64c303bb78a30a65033e01cc8cc...a41e254acdaa5384e4bcad417323dd09b1a530f3,1,8,6,14,4,2013-10-23 06:07:31,2013-09-13 04:17:26
a41e254acdaa5384e4bcad417323dd09b1a530f3...c2e115e9a9ff0754df5854f4985226f0419d44cd,1,2,1,3,2,2013-10-23 06:07:31,2013-09-13 04:25:58
c2e115e9a9ff0754df5854f4985226f0419d44cd...8836d7242bf90a74d1ab69a13580a2c7d4f1d1e7,2,9,5,14,4,2013-10-23 06:07:31,2013-09-13 05:09:04
8836d7242bf90a74d1ab69a13580a2c7d4f1d1e7...5c31b8a79de8133fbd3e10c0d27004585407e864,1,1,0,1,1,2013-10-23 06:07:31,2013-09-14 00:13:06
5c31b8a79de8133fbd3e10c0d27004585407e864...32d45296b089e1286c147a6657a1e392963ec699,1,21,18,39,10,2013-10-23 06:07:31,2013-09-14 00:14:12
32d45296b089e1286c147a6657a1e392963ec699...2c61940fb834988b20df986ac111c309b04ea967,3,69,9,78,8,2013-10-23 06:07:31,2013-09-18 01:34:57
2c61940fb834988b20df986ac111c309b04ea967...d79cf5a8481dea633bedeb97892333e8e99df8f4,4,43,3,46,5,2013-10-23 06:07:31,2013-09-18 20:41:24
d79cf5a8481dea633bedeb97892333e8e99df8f4...d201b0b82d738f2e66b384e0312f0a247ce5c523,1,4,3,7,3,2013-10-23 06:07:31,2013-09-18 20:58:13
d201b0b82d738f2e66b384e0312f0a247ce5c523...0e3a9ae4d7790360e055976c411a5a0a47a07286,3,169,159,328,6,2013-10-23 06:07:31,2013-09-19 00:18:34
0e3a9ae4d7790360e055976c411a5a0a47a07286...240f3f84619fae62d5a9add40168fab0ac8eab15,3,82,69,151,24,2013-10-23 06:07:31,2013-09-19 01:51:35
240f3f84619fae62d5a9add40168fab0ac8eab15...3a0af0745e4c89e91837f34605a68f701029015d,2,68,22,90,9,2013-10-23 06:07:31,2013-09-19 17:23:43
3a0af0745e4c89e91837f34605a68f701029015d...827a53de1f490b08426f83427692aa1f7af5df18,1,1,1,2,1,2013-10-23 06:07:31,2013-09-19 17:26:55
827a53de1f490b08426f83427692aa1f7af5df18...74a4e77684128b0252c850cdb40e2e2b86860a1c,1,24,1,25,3,2013-10-23 06:07:32,2013-09-19 17:59:11
74a4e77684128b0252c850cdb40e2e2b86860a1c...a6ac8c8efca6a4500716144e4c72e0c50e31c47c,2,26,18,44,10,2013-10-23 06:07:32,2013-09-20 23:20:23
a6ac8c8efca6a4500716144e4c72e0c50e31c47c...86ab8325e1cf1e64f2fe7f2ad5392ddd1a6b1eaf,1,13,7,20,2,2013-10-23 06:07:32,2013-09-20 23:34:07
86ab8325e1cf1e64f2fe7f2ad5392ddd1a6b1eaf...c2850e9c3d96440579373cc8751c0a26e93c2310,1,1,1,2,1,2013-10-23 06:07:32,2013-10-03 21:56:38
c2850e9c3d96440579373cc8751c0a26e93c2310...4f53530d944615beef5dc8457347daff9c7565e9,1,37,0,37,1,2013-10-23 06:07:32,2013-10-03 23:12:27
4f53530d944615beef5dc8457347daff9c7565e9...b44f8899f553d1b7a9501a123668ae4a7d494bcd,2,47,11,58,2,2013-10-23 06:07:32,2013-10-04 00:28:04
b44f8899f553d1b7a9501a123668ae4a7d494bcd...7b6c4d78c7df69cc7fc3fdf43058a1df87a02454,1,21,0,21,1,2013-10-23 06:07:32,2013-10-04 00:43:49
7b6c4d78c7df69cc7fc3fdf43058a1df87a02454...5951b87a5e04a467aee5274a5ad1c85be4aecc3e,1,2,1,3,1,2013-10-23 06:07:32,2013-10-04 02:38:33
5951b87a5e04a467aee5274a5ad1c85be4aecc3e...edb65c6b211292501729950ea3a5016c3b84b5e1,1,82,61,143,12,2013-10-23 06:07:32,2013-10-08 01:09:53
edb65c6b211292501729950ea3a5016c3b84b5e1...5f7fb7f53cfd15817ffe88e7281702f1f3716715,1,7,7,14,7,2013-10-23 06:07:32,2013-10-08 01:13:17
5f7fb7f53cfd15817ffe88e7281702f1f3716715...271031df6876690b5dbcb0f808b6add2049e2b44,2,15,9,24,6,2013-10-23 06:07:32,2013-10-08 01:17:09
271031df6876690b5dbcb0f808b6add2049e2b44...0633d3ec8f1e955e914857e791484d4e0771ff1a,2,2,0,2,2,2013-10-23 06:07:33,2013-10-08 01:19:10
0633d3ec8f1e955e914857e791484d4e0771ff1a...a9f7f20e72453fc4e86f581ebe9734ef4bafd81c,1,2,2,4,1,2013-10-23 06:07:33,2013-10-08 01:20:47
a9f7f20e72453fc4e86f581ebe9734ef4bafd81c...9e15d8b766957c68d57880fdb39d24599cc78a39,1,2,0,2,1,2013-10-23 06:07:33,2013-10-08 03:51:47
9e15d8b766957c68d57880fdb39d24599cc78a39...1cd2d3697feeb41d91bd6d1ce66b30ad73de914e,1,1,0,1,1,2013-10-23 06:07:33,2013-10-08 03:56:20
1cd2d3697feeb41d91bd6d1ce66b30ad73de914e...4b6b0af798d516899629d92ee181a47080caf887,2,20,3,23,3,2013-10-23 06:07:33,2013-10-09 22:02:02
4b6b0af798d516899629d92ee181a47080caf887...2944b78f45e7682ccd9558e63c2587b41429b78c,2,9,1,10,3,2013-10-23 06:07:33,2013-10-09 22:06:55
2944b78f45e7682ccd9558e63c2587b41429b78c...b41f670c54f38f96261eb47186fee8a13aa9db2f,1,5,6,11,2,2013-10-23 06:07:33,2013-10-09 22:24:00
b41f670c54f38f96261eb47186fee8a13aa9db2f...15ee6dabcffc1757d65ac5eef83a42d36b7b464d,1,28,17,45,3,2013-10-23 06:07:33,2013-10-09 22:52:38
15ee6dabcffc1757d65ac5eef83a42d36b7b464d...dcaed90d166b6d5854021a195c4ee04b8576acf2,1,5,5,10,3,2013-10-23 06:07:33,2013-10-10 20:54:56
dcaed90d166b6d5854021a195c4ee04b8576acf2...4ca9ff5e427c02e81423d0cae03fc3e03750b4ef,1,3,1,4,2,2013-10-23 06:07:33,2013-10-10 21:28:56
4ca9ff5e427c02e81423d0cae03fc3e03750b4ef...9d2149baac15a7bdeeb06eb086873b362818f9e4,1,1,1,2,1,2013-10-23 06:07:33,2013-10-10 22:08:32
9d2149baac15a7bdeeb06eb086873b362818f9e4...755b81685317368d0a1932c1bb1f478f39b17149,3,10,2,12,3,2013-10-23 06:07:34,2013-10-10 22:01:30
755b81685317368d0a1932c1bb1f478f39b17149...0b3a2a47534d0f68162f44f10d46f48446626b4a,1,18,0,18,1,2013-10-23 06:07:34,2013-10-10 22:12:21
0b3a2a47534d0f68162f44f10d46f48446626b4a...2b1a901a5f30acbe78a222d38f46833865164ff3,1,5,4,9,3,2013-10-23 06:07:34,2013-10-10 22:30:51
2b1a901a5f30acbe78a222d38f46833865164ff3...0b6c715d8aabfa5bde57887df5d0b73598f0d829,1,10,0,10,1,2013-10-23 06:07:34,2013-10-10 23:09:02
0b6c715d8aabfa5bde57887df5d0b73598f0d829...efbf8bb876123c2a626f95133483d2a7384f2fa8,1,3,1,4,1,2013-10-23 06:07:34,2013-10-10 23:59:44
efbf8bb876123c2a626f95133483d2a7384f2fa8...e233c4d5b6a4c443bbb84360438a55419a21bff4,2,4,3,7,2,2013-10-23 06:07:34,2013-10-11 00:09:43
e233c4d5b6a4c443bbb84360438a55419a21bff4...ddd87f4ea3856578917641e4f0b526261bf81a01,1,7,2,9,1,2013-10-23 06:07:34,2013-10-11 00:16:36
ddd87f4ea3856578917641e4f0b526261bf81a01...f77d5d046880973a438ad88ca65b4af47d1927ca,4,9,4,13,7,2013-10-23 06:07:34,2013-10-11 22:35:26
9038333ec2ba490ba576f0f5ac8a7e5cf04ac1f0...4e99aad43c6d00def6d744b2e2992a7e0d497c10,1,15,2,17,3,2013-11-10 22:57:05,2013-11-10 22:57:05
e05cde2cb584f383ca2203d330dfb5df3eaaf08f...644c2a05674281bdb112e083dd06f0c766199da9,1,1,1,2,1,2013-11-12 01:18:00,2013-11-12 01:18:00
644c2a05674281bdb112e083dd06f0c766199da9...6ad03e0dc9dabf741739378e82c40552484f8b78,1,7,3,10,3,2013-11-12 03:11:47,2013-11-12 03:11:47
6ad03e0dc9dabf741739378e82c40552484f8b78...f1b77fec966c8c97d53628bfd79196afb0c99498,3,68,51,119,10,2013-11-12 03:44:43,2013-11-12 03:44:43
8afa4f2c9e70bf812a1f0689212955e3a00c6023...35e8a048349e42883ab3afb8d9a79362f5e9ebd4,1,2,1,3,1,2013-09-23 22:53:47,2013-09-23 22:53:47
35e8a048349e42883ab3afb8d9a79362f5e9ebd4...4f4e5342eb6767f3837d43689f9618b46345e8a1,1,63,160,223,37,2013-09-24 00:30:34,2013-09-24 00:30:34
8afa4f2c9e70bf812a1f0689212955e3a00c6023...129a0cd302a842ec1c05bb7aebcd6d9020c8e8a0,4,130,95,225,21,2013-09-23 18:56:15,2013-09-21 23:12:39
129a0cd302a842ec1c05bb7aebcd6d9020c8e8a0...51f7eb948952169dffd0f52dbd8d0d3a0bf44049,1,2,2,4,2,2013-09-24 02:19:05,2013-09-24 02:19:05
56ec768f2faf00d2c9920642a03f744df7091514...33538697270b9fc514d10e52c09feac306ed80e1,1,13,0,13,2,2013-12-05 03:10:03,2013-12-05 03:10:03
3e2fde9cbe478a058744447d6a40162cc83bbd0f...a5fe1207a44ab0a3f533d63360018783b29b1903,1,45,45,90,24,2013-11-18 23:26:57,2013-11-18 23:26:57
98d587d2490f137df3d825d3a5af2222f467adc1...03e0ca8a49b518ad26ebb6e6a8df99f3e2b8d6a6,1,0,11,11,1,2013-07-27 02:38:44,2013-07-27 02:38:28
03e0ca8a49b518ad26ebb6e6a8df99f3e2b8d6a6...d9b1172116b915aea58fda5f8782f60a50edddc0,1,6,1,7,2,2013-07-27 02:42:46,2013-07-27 02:42:46
d9b1172116b915aea58fda5f8782f60a50edddc0...c74e969892e62a8294e6464d48d26d594ee8c8e8,1,3,33,36,2,2013-07-29 17:16:56,2013-07-27 05:08:14
c74e969892e62a8294e6464d48d26d594ee8c8e8...e3c18578e348058db6b8f9ad0b3991af4067501b,3,34,11,45,6,2013-07-29 17:57:06,2013-07-29 17:53:05
e3c18578e348058db6b8f9ad0b3991af4067501b...127fdb3f7cb9bce6f8aff6aa77db1b4fbc12353c,1,1,1,2,1,2013-07-29 18:12:30,2013-07-29 18:12:30
127fdb3f7cb9bce6f8aff6aa77db1b4fbc12353c...d21d0bffffca4e9855048f2b816f37ea9b224c26,1,1,1,2,1,2013-07-29 18:14:31,2013-07-29 18:14:31
d21d0bffffca4e9855048f2b816f37ea9b224c26...3b03386b63275747f9518fba7b7beec488be54df,1,1,1,2,1,2013-07-29 18:35:25,2013-07-29 18:35:25
3b03386b63275747f9518fba7b7beec488be54df...3e76c40ccebb6afebacb891d8094d0a39b088d02,3,11,4,15,3,2013-07-29 18:54:52,2013-07-29 18:54:52
3e76c40ccebb6afebacb891d8094d0a39b088d02...12970342012db3c9c0ead39e0ef9aeb03b818327,1,1,1,2,1,2013-07-29 19:38:49,2013-07-29 19:38:49
12970342012db3c9c0ead39e0ef9aeb03b818327...f7d991cc87fa3ed32123a7ca910a13a3ebd5c786,2,45,19,64,13,2013-07-29 19:43:02,2013-07-29 18:33:19
f7d991cc87fa3ed32123a7ca910a13a3ebd5c786...a9b59ea8672e53f06fd35492884e6bd62a2f65b9,2,10,2,12,3,2013-07-29 19:43:02,2013-07-29 19:41:28
a9b59ea8672e53f06fd35492884e6bd62a2f65b9...b857eb50ab83f6216ce38f2a8eca88b470794b72,1,2,0,2,1,2013-07-29 19:43:50,2013-07-29 19:43:50
b857eb50ab83f6216ce38f2a8eca88b470794b72...541c68a251b1c1abee1929477feedafea2402985,3,8,4,12,4,2013-07-29 20:41:01,2013-07-29 20:39:23
541c68a251b1c1abee1929477feedafea2402985...1202b781ef69609142dbb1860b1af038264b6dc5,4,53,60,113,43,2013-07-29 22:39:50,2013-07-29 22:35:10
1202b781ef69609142dbb1860b1af038264b6dc5...e3ab617f5f53902de96d7a14e91bfce568f27561,1,1,1,2,1,2013-07-29 23:14:59,2013-07-29 23:14:59
e3ab617f5f53902de96d7a14e91bfce568f27561...3fa2a8c0b0fce7fdafa1bb9624509eb09e2d86ab,1,1,2,3,1,2013-07-29 23:30:21,2013-07-29 23:30:21
3fa2a8c0b0fce7fdafa1bb9624509eb09e2d86ab...0c7954b4761731df415cf48cf46ee39436126de9,3,4,8,12,5,2013-07-29 23:48:22,2013-07-29 23:48:22
0c7954b4761731df415cf48cf46ee39436126de9...97eca2bd7c154d5c8c8f6ceab3d74b68578abb74,5,21,16,37,13,2013-07-30 00:11:42,2013-07-30 00:11:42
97eca2bd7c154d5c8c8f6ceab3d74b68578abb74...b04818221e26f86bf0279d33841cbd2e1620c444,1,1,1,2,1,2013-07-30 01:07:12,2013-07-30 01:07:12
b04818221e26f86bf0279d33841cbd2e1620c444...719bbb115b517b9da45dcbbfa5a064681180ac4b,2,5,10,15,6,2013-07-30 06:21:08,2013-07-30 06:21:08
719bbb115b517b9da45dcbbfa5a064681180ac4b...a319aa7f9e21671bc73de1f19d7b257d3dbbb753,1,3,1,4,2,2013-07-30 06:40:55,2013-07-30 06:40:55
a319aa7f9e21671bc73de1f19d7b257d3dbbb753...1d568abc9cf452d3a8bfa03ead683bf003e0d4f7,1,3,4,7,1,2013-07-30 06:44:41,2013-07-30 06:44:41
1d568abc9cf452d3a8bfa03ead683bf003e0d4f7...fbfd21c07bce83a0252f42d071862be228b340bd,1,7,3,10,6,2013-07-30 08:00:01,2013-07-30 08:00:01
fbfd21c07bce83a0252f42d071862be228b340bd...62626bf33d741a7f11d48bae1553ecb5825a7113,1,16,2,18,6,2013-07-30 18:15:15,2013-07-30 18:15:15
62626bf33d741a7f11d48bae1553ecb5825a7113...9b24174e08952e68d5b2a192ee5c6ba8a6cf677a,1,7,1,8,2,2013-07-30 18:16:44,2013-07-30 18:16:44
1b4ee9c90f254dd9a1df9cac649e419669a10198...737bbc7f123171f5594a8021e99846f050c4eccb,3,23,8,31,5,2013-07-16 22:59:55,2013-07-15 23:09:16
759ae2c1d7c69f4898d6072d75c94504e335c8a3...332e1417f3ab0c489e7e55d23b1a400c57958e13,5,12,15,27,6,2013-07-17 00:49:57,2013-07-17 00:49:57
332e1417f3ab0c489e7e55d23b1a400c57958e13...8018394b8b2789d9b5d878483bb3ea9315fccfc7,4,33,18,51,16,2013-07-17 00:59:49,2013-07-17 00:59:49
82552022d8c866c72de197a1d5c6d409d39db2ef...013c9f82e7a27ae723d0765d794807854e832791,3,34,3,37,7,2013-07-12 17:11:27,2013-06-13 23:58:43
013c9f82e7a27ae723d0765d794807854e832791...2a0f7afa7d92055b827a875ca8ca7b32a31bab56,1,1,0,1,1,2013-07-12 17:11:28,2013-06-14 03:48:27
2a0f7afa7d92055b827a875ca8ca7b32a31bab56...685a4ffdcf1a926c1fe8c7c87dc48c7bcf5a6304,3,196,56,252,51,2013-07-12 17:11:28,2013-06-14 03:51:17
685a4ffdcf1a926c1fe8c7c87dc48c7bcf5a6304...cab8230a0271367563b39a1630b889d1b0b794e0,1,1,1,2,1,2013-07-12 17:11:28,2013-07-02 03:35:06
cab8230a0271367563b39a1630b889d1b0b794e0...14b337ad5d6f24e7d217b8027ace2f0425360275,3,4,4,8,4,2013-07-12 17:11:28,2013-07-02 05:24:57
14b337ad5d6f24e7d217b8027ace2f0425360275...32aa96c2323075300e3cbd58c726a09790bade53,1,5,0,5,1,2013-07-12 17:11:28,2013-07-09 00:33:14
32aa96c2323075300e3cbd58c726a09790bade53...91142a56365c70de2a4e1b2cca5cea85336ea2a8,1,1,1,2,1,2013-07-12 17:11:28,2013-07-09 00:34:22
91142a56365c70de2a4e1b2cca5cea85336ea2a8...30f82aa5bf229cfb5536ae05ae0cf303f6b968e9,1,7,7,14,5,2013-07-12 17:11:28,2013-07-09 01:00:23
30f82aa5bf229cfb5536ae05ae0cf303f6b968e9...b9bf08b45a6dd2598380d1ad61be8c279ac74ace,1,3,7,10,3,2013-07-12 17:11:28,2013-07-09 01:05:05
b9bf08b45a6dd2598380d1ad61be8c279ac74ace...09cb871d15780d6764e4eddcad46bc373f67cb68,2,30,11,41,4,2013-07-12 17:11:28,2013-07-09 01:24:26
09cb871d15780d6764e4eddcad46bc373f67cb68...36454824ac29e5ae992c2ba9b4d8391f59b81260,1,0,1,1,1,2013-07-12 17:11:28,2013-07-09 01:24:37
36454824ac29e5ae992c2ba9b4d8391f59b81260...366d4439d81240942ad69d611cd08e17cae071cc,1,33,22,55,7,2013-07-12 17:11:28,2013-07-09 02:02:30
366d4439d81240942ad69d611cd08e17cae071cc...e61c64e26b4cf948ae5518877932b2359c515b33,2,3,5,8,4,2013-07-12 17:11:29,2013-07-09 02:07:30
e61c64e26b4cf948ae5518877932b2359c515b33...0ceb174ae065428b289d6f7288350a7b5d2ed523,2,45,26,71,14,2013-07-12 17:11:29,2013-07-09 02:47:17
0ceb174ae065428b289d6f7288350a7b5d2ed523...cb4db20d708eb6db1aa53fa1ba60df82ca435057,1,31,8,39,7,2013-07-12 17:11:29,2013-07-09 02:55:40
cb4db20d708eb6db1aa53fa1ba60df82ca435057...d05e83d958d669f0fc16eca37706ad0e647975ac,2,14,10,24,9,2013-07-12 17:11:29,2013-07-09 03:32:31
d05e83d958d669f0fc16eca37706ad0e647975ac...7456124102974b5b8a044b4103a9bfecde1d31a9,3,37,9,46,10,2013-07-12 17:11:29,2013-07-09 03:53:41
7456124102974b5b8a044b4103a9bfecde1d31a9...b3e752c86c2d2a8a6cf4c5f9d504d8db8c482be2,3,114,124,238,40,2013-07-12 17:11:29,2013-07-09 05:30:02
b3e752c86c2d2a8a6cf4c5f9d504d8db8c482be2...f0673cef7e6eab5d192c22ff9958a26fe3179380,1,9,5,14,1,2013-07-12 17:11:29,2013-07-09 05:31:01
f0673cef7e6eab5d192c22ff9958a26fe3179380...34d563a7edc8d483835565b29ff817d57ed7cee6,1,2,2,4,2,2013-07-12 17:11:29,2013-07-09 05:49:56
34d563a7edc8d483835565b29ff817d57ed7cee6...5b8e1c17f3eeaedc95569a2bdf9db41697501b1a,4,82,41,123,9,2013-07-12 17:11:29,2013-07-09 06:28:15
5b8e1c17f3eeaedc95569a2bdf9db41697501b1a...f786fd6fa50c29b80b78b2ab0258f709fa9aa033,3,96,61,157,23,2013-07-12 17:11:29,2013-07-09 17:42:25
f786fd6fa50c29b80b78b2ab0258f709fa9aa033...7ef61492da14495052f0a3a4e41413e05d425173,3,28,39,67,17,2013-07-12 17:11:29,2013-07-09 18:07:13
7ef61492da14495052f0a3a4e41413e05d425173...31e560e8ca3a780f8d526e368470b29f5bbd3088,1,35,2,37,4,2013-07-12 17:11:30,2013-07-09 18:44:01
31e560e8ca3a780f8d526e368470b29f5bbd3088...c329ebf90d953429503e286d7d7205aa284de21e,2,22,2,24,3,2013-07-12 17:11:30,2013-07-09 19:45:15
c329ebf90d953429503e286d7d7205aa284de21e...af01be5004cb3d652f8b7e08458abd310dda2f43,1,28,2,30,1,2013-07-12 17:11:30,2013-07-09 20:34:39
af01be5004cb3d652f8b7e08458abd310dda2f43...040d97d6c0fdd9ab3886545721cfdc65fcfab000,1,1,0,1,1,2013-07-12 17:11:30,2013-07-09 20:41:34
040d97d6c0fdd9ab3886545721cfdc65fcfab000...d823e57049b5697b68934a5ebb10f9499d1379ca,3,97,198,295,23,2013-07-12 17:11:30,2013-07-09 21:10:00
d823e57049b5697b68934a5ebb10f9499d1379ca...4e18439ae6b69663c73b92674296d7272a20020f,5,176,54,230,33,2013-07-12 17:11:30,2013-07-09 21:59:14
4e18439ae6b69663c73b92674296d7272a20020f...df5d48c9af7846f14717fc5a826bc1f2e0e33355,1,2,3,5,3,2013-07-12 17:11:30,2013-07-10 07:48:12
df5d48c9af7846f14717fc5a826bc1f2e0e33355...a13f330983eea393e079387c69ef373d1ad4a332,4,27,44,71,27,2013-07-12 17:11:30,2013-07-10 07:48:30
a13f330983eea393e079387c69ef373d1ad4a332...96a1f43a3c4ee00ae4b5450a19dce6f57e449408,1,5,1,6,1,2013-07-12 17:11:30,2013-07-10 07:50:00
96a1f43a3c4ee00ae4b5450a19dce6f57e449408...01a1bc8d6b50011a254daa64582f39ae9ce8f243,2,9,5,14,5,2013-07-12 17:11:30,2013-07-10 18:00:04
01a1bc8d6b50011a254daa64582f39ae9ce8f243...269434a44b9c36dafed68d1ab36d6a0cbd64e97a,6,39,153,192,37,2013-07-12 17:11:31,2013-07-10 18:24:34
269434a44b9c36dafed68d1ab36d6a0cbd64e97a...be0611d262feb3bdaa74bff3d243f247934a5585,1,33,14,47,9,2013-07-12 17:11:31,2013-07-10 19:00:33
be0611d262feb3bdaa74bff3d243f247934a5585...56f663ea67897f718038c506d5faaa575b38042a,1,8,3,11,2,2013-07-12 17:11:31,2013-07-10 20:30:38
56f663ea67897f718038c506d5faaa575b38042a...85ae17ae0f3a72283f047aa841ebb1d329848331,2,54,23,77,11,2013-07-12 17:11:31,2013-07-10 21:02:42
85ae17ae0f3a72283f047aa841ebb1d329848331...faf49921bed26de75c709a1682d3e1dc75d02b17,4,24,22,46,13,2013-07-12 17:11:31,2013-07-10 23:23:05
faf49921bed26de75c709a1682d3e1dc75d02b17...89e2fb1df1e4972aa93174a3be501bf6b0c21272,1,22,18,40,5,2013-07-12 17:11:31,2013-07-10 23:39:20
89e2fb1df1e4972aa93174a3be501bf6b0c21272...a8ccc8786d84e9e6fbab48644e3e05e454133c00,1,1,0,1,1,2013-07-12 17:11:31,2013-07-10 23:40:59
a8ccc8786d84e9e6fbab48644e3e05e454133c00...81e456ae8171984df958a723ecc65657c2e4b42d,2,30,29,59,8,2013-07-12 17:11:31,2013-07-11 00:24:56
81e456ae8171984df958a723ecc65657c2e4b42d...3fb6a8c602fdbeff9c85aa1b8b13617d6e222aff,1,9,0,9,1,2013-07-12 17:11:31,2013-07-11 18:24:12
3fb6a8c602fdbeff9c85aa1b8b13617d6e222aff...177a5684c9f9336acd178373b857420deb1c1c3f,8,139,63,202,42,2013-07-12 17:11:31,2013-07-11 21:17:17
177a5684c9f9336acd178373b857420deb1c1c3f...3205e33537153f35211dedaeae4abe9a846aeac3,5,86,95,181,16,2013-07-12 17:11:31,2013-07-11 22:21:08
3205e33537153f35211dedaeae4abe9a846aeac3...4308b7c063fb308f50ff6ee85676d07a6b7fa3be,4,85,84,169,21,2013-07-12 17:11:31,2013-07-11 23:59:46
4308b7c063fb308f50ff6ee85676d07a6b7fa3be...6eb9cdb69f7a461934b9182b73a1d788e4bde0b3,3,18,6,24,11,2013-07-12 17:11:32,2013-07-12 00:24:47
6eb9cdb69f7a461934b9182b73a1d788e4bde0b3...73478a49f0ba9619d0c07b210abff5158b079be8,2,10,1,11,2,2013-07-12 17:11:32,2013-07-12 00:37:30
73478a49f0ba9619d0c07b210abff5158b079be8...b9f343f8b4f07420a9e921614ba69f5ea3bc0856,3,31,16,47,11,2013-07-12 17:11:32,2013-07-12 16:54:32
b9f343f8b4f07420a9e921614ba69f5ea3bc0856...7b85bbf99a4c9899eda06251be2c5323d7e99d5c,1,1,1,2,1,2013-07-12 17:13:02,2013-07-12 17:13:02
756f01d311512b895dd2c3851b678e811346ae42...b12686c91e251d3e07067e7dd83f5ae5e44f4fcc,1,1,1,2,1,2013-07-08 19:10:05,2013-07-08 19:10:05
b12686c91e251d3e07067e7dd83f5ae5e44f4fcc...f6320da259e78071b2f646c0e87bd0f651fed844,1,1,1,2,1,2013-07-08 19:17:33,2013-07-08 19:17:33
f6320da259e78071b2f646c0e87bd0f651fed844...9495307fd86da98c2348a67d93bd9bb03977d65b,1,3,0,3,1,2013-07-08 20:23:35,2013-07-08 20:23:35
043b6530d7d52f1dd91deeca8c20760fba2c856e...7d24fbd4c0b8149d1e71e10ed86661d1de589f1d,1,4,0,4,1,2013-05-28 19:26:11,2013-05-28 19:26:11
82579293f3752782969afa014e52b9526f7a878c...d5159ae81b2d5b7b39b1dfa340a7e14eecaeb343,2,12,18,30,9,2013-10-03 20:56:03,2013-10-02 20:41:22
d5159ae81b2d5b7b39b1dfa340a7e14eecaeb343...b5286b941a77a1bdd57abb1ea01385eeaa62f7ea,14,452,399,851,63,2013-10-03 20:56:03,2013-10-03 01:50:27
b5286b941a77a1bdd57abb1ea01385eeaa62f7ea...6f94e8dbd08ae7548f13b29295c6732bba59f1ad,1,12,0,12,8,2013-10-03 20:56:03,2013-10-03 01:59:41
6f94e8dbd08ae7548f13b29295c6732bba59f1ad...a7007ec12bcb2f10936477d9db7552bf9a4bb058,1,12,11,23,12,2013-10-03 20:56:03,2013-10-03 18:48:19
a7007ec12bcb2f10936477d9db7552bf9a4bb058...9609fa2313febbeb61a94c864f7a1192da03f0c1,1,3,2,5,1,2013-10-03 20:56:03,2013-10-03 18:59:47
9609fa2313febbeb61a94c864f7a1192da03f0c1...3afe10d947ae8c957867648a01f340615efb27ac,1,3,3,6,2,2013-10-03 20:56:03,2013-10-03 19:00:09
799dd35319177cd3c3502e366f4b955925ea59bd...6ca55ec1890def2241e081ddcdf3291b92c125e5,1,3,0,3,3,2013-10-08 04:53:56,2013-10-07 22:04:42
6ca55ec1890def2241e081ddcdf3291b92c125e5...2deb0e9b625ff0a9cc66c09af4a14f2ac1dcc365,2,205,126,331,51,2013-10-08 04:53:56,2013-10-07 22:05:55
2deb0e9b625ff0a9cc66c09af4a14f2ac1dcc365...bc8406d8a0b681eee2c2ef7755528d983dbb988b,1,1,0,1,1,2013-10-08 04:53:56,2013-10-07 22:06:45
bc8406d8a0b681eee2c2ef7755528d983dbb988b...f9504f215e5722b78461cf9a62e6f0564afb5fdb,2,11,7,18,5,2013-10-08 04:53:57,2013-10-07 22:47:09
f9504f215e5722b78461cf9a62e6f0564afb5fdb...9bad3afcfb79c2d54737de9a07a8f7f056485185,1,9,1,10,2,2013-10-08 04:53:57,2013-10-08 01:51:01
9bad3afcfb79c2d54737de9a07a8f7f056485185...468eb6a1bfaae7644fe4f0a5939d98b69cf1494b,1,1,1,2,1,2013-10-08 04:53:57,2013-10-08 01:51:34
468eb6a1bfaae7644fe4f0a5939d98b69cf1494b...b09f206753c6450bdf7178b788d218fc5b3b4feb,2,8,1,9,3,2013-10-08 04:53:57,2013-10-08 04:38:38
b09f206753c6450bdf7178b788d218fc5b3b4feb...e5dd8f4f8ed2b46268776ff0aae77c3569f785f2,2,31,23,54,3,2013-10-08 06:33:04,2013-10-08 06:33:04
e5dd8f4f8ed2b46268776ff0aae77c3569f785f2...28082f33e12956996adbb1991add8750582b689b,3,57,47,104,19,2013-10-08 07:10:33,2013-10-08 07:10:33
661484fe1442bd249cbc7a617c003a6264f77e30...b1a27cd90cc5e9b6e9482f7ebd54883d2dbb8a99,2,5,1,6,2,2013-03-23 20:07:22,2013-03-23 18:32:33
b1a27cd90cc5e9b6e9482f7ebd54883d2dbb8a99...d5bfc0a3f31d27dd7e525682ba567501e53a532e,1,2,6,8,3,2013-03-23 20:07:22,2013-03-23 18:37:09
d5bfc0a3f31d27dd7e525682ba567501e53a532e...e0d6c7d65833f080edd30899972e842a566fca55,1,6,0,6,1,2013-03-23 20:07:22,2013-03-23 18:51:24
e0d6c7d65833f080edd30899972e842a566fca55...2790b90f4b6b587bbd857f47c51151825b8ca581,1,5,1,6,1,2013-03-23 20:11:51,2013-03-23 20:09:49
294111f92b1f595a12b6173ea68aec201e94b8c7...107cb7e2ffa00af1e084adea60314e30f14c6667,1,1,1,2,1,2013-03-12 01:14:36,2013-03-12 01:14:36
107cb7e2ffa00af1e084adea60314e30f14c6667...f484f4e433f714e4b6b15ecdd882ba1d955c8e94,1,1,1,2,1,2013-03-12 01:17:07,2013-03-12 01:17:07
f484f4e433f714e4b6b15ecdd882ba1d955c8e94...94883aef0e42a170011048054f13aecf5cc5d3d3,1,12,4,16,4,2013-03-12 02:52:22,2013-03-12 02:51:07
94883aef0e42a170011048054f13aecf5cc5d3d3...2a1f48bb7f0519e8ca3287c2e554012baa28ac9d,1,6,3,9,2,2013-03-12 03:01:57,2013-03-12 03:01:57
2a1f48bb7f0519e8ca3287c2e554012baa28ac9d...c44d169628bd50d7df000baa878bde70d55f3187,1,21,17,38,3,2013-03-12 03:13:28,2013-03-12 03:13:28
c44d169628bd50d7df000baa878bde70d55f3187...02959efba818b596993c526e87e304cd52859c85,2,8,3,11,5,2013-03-12 03:28:09,2013-03-12 03:28:09
68474b25aea6c804b3a499e577e93e0904c016d7...5f9eba5f79fc988a61be60d21c6b414195c0a288,1,27,20,47,20,2013-03-12 04:09:59,2013-03-12 04:08:22
5fb45bcd0f9dd20219fc9d79a6ebce60d181c6f6...bc83e8c76c36ba6869f395aaa8cbba81dc14ee20,1,1,1,2,1,2013-02-11 19:34:22,2013-02-11 19:34:22
b4988e3bd948b054d5b3853dad396dee9137bf80...6a5a0c01e282606737c44af974fb56e97e13fc37,1,26,2,28,2,2013-02-12 01:29:54,2013-02-12 01:29:54
6a5a0c01e282606737c44af974fb56e97e13fc37...76b7a3a0540b2be826dda4899f24dfbdf3c77d8c,1,36,9,45,9,2013-02-12 08:52:47,2013-02-12 08:52:47
76b7a3a0540b2be826dda4899f24dfbdf3c77d8c...3fda3bd9caf6d9ee3e1e40a6bc1785dee6dfec8e,1,48,47,95,9,2013-02-12 20:38:08,2013-02-12 19:50:33
3fda3bd9caf6d9ee3e1e40a6bc1785dee6dfec8e...edb6ccce5666b275f1f33ac7af43a309045471ff,1,2,0,2,1,2013-02-12 20:39:02,2013-02-12 20:39:02
edb6ccce5666b275f1f33ac7af43a309045471ff...cb1eb96b9e6efe8901b1594be093769968ac01ba,2,1,1,2,1,2013-02-12 22:35:17,2013-02-12 22:35:17
cb1eb96b9e6efe8901b1594be093769968ac01ba...78eb2a32d6277eeb16123932e655c9a7c8a76426,2,5,1,6,2,2013-02-12 22:36:04,2013-02-12 22:36:04
78eb2a32d6277eeb16123932e655c9a7c8a76426...4bccce090abab5eb8f77d0fba5bf307c732e97d3,3,451,206,657,175,2013-02-13 00:33:51,2013-02-13 00:32:07
4bccce090abab5eb8f77d0fba5bf307c732e97d3...ff430bc2871ef1d262212d38ac99f8bc1e46a3aa,1,1,1,2,1,2013-02-13 02:13:35,2013-02-12 16:41:06
ff430bc2871ef1d262212d38ac99f8bc1e46a3aa...f70a7b974e11f4420cffcde9c5744f64295123ef,1,3,3,6,2,2013-02-13 03:00:43,2013-02-13 03:00:43
f70a7b974e11f4420cffcde9c5744f64295123ef...a2a2b56b9b0b9b3242d9664d7cf62f6d61de661a,1,38,28,66,21,2013-02-13 07:39:20,2013-02-13 07:39:20
a2a2b56b9b0b9b3242d9664d7cf62f6d61de661a...562eb0a54a786b6597a17d1c9a5dff8e250cc002,1,1,1,2,1,2013-02-13 18:28:49,2013-02-13 18:28:07
562eb0a54a786b6597a17d1c9a5dff8e250cc002...7d2f35b962beb71574ea0e457d634c89f76ef076,1,2,2,4,2,2013-02-13 18:30:49,2013-02-13 18:30:49
7d2f35b962beb71574ea0e457d634c89f76ef076...30fe79bf1b9d2f1afb734afc2b6c2f9aba2e7b8c,1,6,6,12,5,2013-02-13 20:20:02,2013-02-13 20:19:44
30fe79bf1b9d2f1afb734afc2b6c2f9aba2e7b8c...8307460df890756dcada8a9cb409bcd97deb881f,2,16,4,20,6,2013-02-13 21:50:52,2013-02-05 00:23:11
8307460df890756dcada8a9cb409bcd97deb881f...edda1f908c504b3926031496d4103072b6676192,1,4,2,6,2,2013-02-13 21:57:36,2013-02-13 21:57:36
4a0d1b7363156090d87782cc20e98491798720bb...825082b3a81051f4c6d45fd698c6fbd4d8711da8,1,1,1,2,1,2014-02-27 07:49:18,2014-02-27 07:49:18
825082b3a81051f4c6d45fd698c6fbd4d8711da8...35c1a5fc457c6f2dd747875498420c959b719d0d,1,10,2,12,2,2014-02-27 07:57:18,2014-02-27 07:57:18
35c1a5fc457c6f2dd747875498420c959b719d0d...9d5782b9a064255a32c5b91e5193813dc8a73c59,1,3,2,5,1,2014-02-27 15:56:19,2014-02-27 15:56:19
9d5782b9a064255a32c5b91e5193813dc8a73c59...bc4524b54410379be0455c19d0bd1668a3cb3c3b,1,15,11,26,2,2014-02-27 15:56:36,2014-02-27 15:56:36
bc4524b54410379be0455c19d0bd1668a3cb3c3b...9c1dc8782cbd2c535261216073f0bf9a178dd42f,1,13,5,18,6,2014-02-27 16:09:31,2014-02-27 16:09:31
3e76fc9de417c1553d811817a3cd215003f61f24...6897d515e1ccb5313ae08705ff39077c5a54533e,2,9,5,14,3,2014-02-26 21:34:24,2014-02-26 21:34:24
6897d515e1ccb5313ae08705ff39077c5a54533e...e981b0c6297a0e57d3a39a27371af7eda1e338b0,1,2,0,2,2,2014-02-26 22:26:13,2014-02-26 22:26:13
e74aaee5615fc14df492f1262672ddccf72c7109...412f89a352e1e55ea036e544d419c7ce0c1800aa,1,4,3,7,1,2013-12-27 06:59:05,2013-12-27 06:57:52
412f89a352e1e55ea036e544d419c7ce0c1800aa...252caab5c1e4b8ad2c0ed269a63ec90e54e61975,1,14,0,14,1,2013-12-30 00:42:08,2013-12-30 00:42:08
ee581ccbedd55273a1ae497c50396dbd2b41aeeb...0c975bea03863b105fd6d4d3d7b4ff6364101258,1,13,7,20,1,2013-12-26 23:29:26,2013-12-26 23:29:26
0c975bea03863b105fd6d4d3d7b4ff6364101258...bf970344435da2c1c255f50001292d98b11870cc,1,6,12,18,4,2013-12-26 23:48:09,2013-12-26 23:48:09
0cf747101f151823d41d3a300df9a45b1faaf8da...3f12f77a3f6a0bc1309ea30124a36567ddd42bde,2,34,14,48,6,2013-12-20 01:13:28,2013-12-20 01:13:28
3f12f77a3f6a0bc1309ea30124a36567ddd42bde...7424bb63cd741fb6a75cbb0885a394bc5194fad5,1,47,20,67,5,2013-12-20 01:49:53,2013-12-20 01:25:02
dcc68f579699627711524b1b69f56b5bc4f9b7cd...aab65f43d8e872e300a2dc18ce4d2782c9a37209,1,64,32,96,14,2013-11-12 07:34:47,2013-11-12 07:34:25
aab65f43d8e872e300a2dc18ce4d2782c9a37209...b20c2c6ef6b49cf2fe9cbef53838ac12180ec362,1,9,0,9,1,2013-11-13 02:02:58,2013-11-01 21:08:19
5afd0d5fb1144ba7f91267a9fc474218ef1f8ca4...21b5e2acd84f778e96b84c95dfda6c1fa32bf23a,1,2,2,4,2,2013-11-04 05:44:01,2013-11-04 05:44:01
21b5e2acd84f778e96b84c95dfda6c1fa32bf23a...ac376b6db84dd814171204c0eac0e4657ea562be,2,20,6,26,5,2013-11-04 06:09:17,2013-11-04 06:09:17
ac376b6db84dd814171204c0eac0e4657ea562be...7c036de1e4a8c8fdbbdb206b4e8dd156dc1a78fb,1,3,3,6,2,2013-11-04 06:21:35,2013-11-04 06:21:35
f77d5d046880973a438ad88ca65b4af47d1927ca...d93b3d01cd25764b2f59eb3a3bb189613e8552e7,3,92,38,130,23,2013-10-23 21:16:12,2013-09-21 23:12:39
d93b3d01cd25764b2f59eb3a3bb189613e8552e7...4cc9f799604a3ff4536b45c8d4560bc044d091e0,1,2,1,3,1,2013-10-23 21:16:12,2013-09-22 00:20:00
4cc9f799604a3ff4536b45c8d4560bc044d091e0...333a4b1e131488ed6312b5c0e70f214cdcf17bf8,1,2,2,4,1,2013-10-23 21:16:12,2013-09-22 00:40:59
333a4b1e131488ed6312b5c0e70f214cdcf17bf8...e5e0f085a04588c3655b48687f908fc74ecd18d1,1,1,1,2,1,2013-10-23 21:16:12,2013-09-22 00:45:50
e5e0f085a04588c3655b48687f908fc74ecd18d1...cbdb8cfa73fe78e1c8812589be74c1b6196c7e66,1,2,2,4,2,2013-10-23 21:16:12,2013-09-22 02:14:26
cbdb8cfa73fe78e1c8812589be74c1b6196c7e66...a66467782e799d7c972b8ed626742c999f3bed5c,1,1,1,2,1,2013-10-23 21:16:12,2013-09-22 03:29:48
a66467782e799d7c972b8ed626742c999f3bed5c...5e14c967b0ad9055f4bb5a002d8cdfbaf20e6c27,1,2,2,4,1,2013-10-23 21:16:12,2013-09-22 05:40:28
5e14c967b0ad9055f4bb5a002d8cdfbaf20e6c27...ec437718e5495100c6df81eef0e67355d1d1008c,2,75,112,187,15,2013-10-23 21:16:12,2013-09-22 09:38:28
ec437718e5495100c6df81eef0e67355d1d1008c...ceb464a1d752350aeb87ff88261a572dc9134fa1,1,18,8,26,6,2013-10-23 21:16:12,2013-09-23 02:57:04
ceb464a1d752350aeb87ff88261a572dc9134fa1...fb145c8384db12fd0f804fcc2647815ef7dae6c1,1,2,2,4,2,2013-10-23 21:16:12,2013-09-23 02:57:21
fb145c8384db12fd0f804fcc2647815ef7dae6c1...2ac023321e9073936b9c2e60166275ca81ff28e6,1,11,4,15,1,2013-10-23 21:16:12,2013-09-23 04:46:36
2ac023321e9073936b9c2e60166275ca81ff28e6...03c3aa8305a87cda96ec8fd9e44313db5f871e2d,1,2,2,4,2,2013-10-23 21:16:12,2013-09-24 02:19:05
03c3aa8305a87cda96ec8fd9e44313db5f871e2d...7de350f25af313f8fa80d2f2cbde00882f94ee5c,2,28,31,59,10,2013-10-23 21:16:12,2013-10-23 04:44:57
7de350f25af313f8fa80d2f2cbde00882f94ee5c...d8437903244d8b76e1ee63135805bdd1fc1178a9,1,2,1,3,2,2013-10-23 21:16:12,2013-10-23 05:25:51
d8437903244d8b76e1ee63135805bdd1fc1178a9...4cf6d911aa9b915d7a8c56b4ae097e6473ad0065,3,5,0,5,3,2013-10-23 21:16:13,2013-10-23 06:20:23
f77d5d046880973a438ad88ca65b4af47d1927ca...3b38a46cb507f0935225c6e5b592cdbe4aedd819,2,75,60,135,13,2013-10-23 06:07:34,2013-10-10 01:13:11
3b38a46cb507f0935225c6e5b592cdbe4aedd819...1a5591837807dbc21a28866a2628ce8f98d76c36,1,18,6,24,7,2013-10-23 06:07:34,2013-10-16 21:12:07
1a5591837807dbc21a28866a2628ce8f98d76c36...cc776184e1265c6715f1d8442283e7ae7e58dd33,1,12,4,16,4,2013-10-23 06:07:34,2013-10-16 21:21:01
cc776184e1265c6715f1d8442283e7ae7e58dd33...41ea89ffe9c79f5907e544e81d5750ecb7bafa07,1,7,4,11,4,2013-10-23 06:07:35,2013-10-18 22:10:36
41ea89ffe9c79f5907e544e81d5750ecb7bafa07...4a79611b63c4550f55b255c3ae6b94e6e67ce0d9,1,3,1,4,1,2013-10-23 06:07:35,2013-10-18 22:53:19
4a79611b63c4550f55b255c3ae6b94e6e67ce0d9...71f6d5ba5a28416924ecd94ad2e819ac22111b37,1,20,11,31,5,2013-10-23 06:07:35,2013-10-19 07:01:17
71f6d5ba5a28416924ecd94ad2e819ac22111b37...c847c63e4357a517c1b56234871b21e683bca5de,1,18,5,23,6,2013-10-23 06:07:35,2013-10-19 07:24:12
c847c63e4357a517c1b56234871b21e683bca5de...1724b4b6f8c491d72fa08f90222d716c5b9011eb,1,1,0,1,1,2013-10-23 06:07:35,2013-10-22 00:53:15
1724b4b6f8c491d72fa08f90222d716c5b9011eb...18050411b01e6ea15fd8e8ae03281fe282227bf7,1,5,2,7,2,2013-10-23 06:07:35,2013-10-22 01:59:34
18050411b01e6ea15fd8e8ae03281fe282227bf7...73f2ed798e5f78c08e4221f3b39bb19e31ec10d5,1,6,2,8,2,2013-10-23 06:07:35,2013-10-22 02:00:02
73f2ed798e5f78c08e4221f3b39bb19e31ec10d5...523160b2cd23385feed610b0c823670fd3d5faad,1,14,4,18,2,2013-10-23 06:07:35,2013-10-22 07:27:08
523160b2cd23385feed610b0c823670fd3d5faad...f4d337adee19014aa45775808c79223bed1ac2db,1,20,5,25,8,2013-10-23 06:07:35,2013-10-22 07:28:35
f4d337adee19014aa45775808c79223bed1ac2db...ba88ae15d5fe29300ea21bb82a9241fe26e6d1ba,1,15,16,31,14,2013-10-23 06:07:35,2013-10-22 07:42:14
ba88ae15d5fe29300ea21bb82a9241fe26e6d1ba...4f3c216c45aa8eff0e9a4227ca733b7909abf5d2,1,4,0,4,2,2013-10-23 06:07:35,2013-10-22 23:24:54
4f3c216c45aa8eff0e9a4227ca733b7909abf5d2...626941de716f7f26b4e98eb0594f8f6ee0cc5f1c,2,9,0,9,4,2013-10-23 06:16:52,2013-10-23 06:16:52
fb6f8183b80111c0bbea41cf7e06bb9bd40f86df...90026c85af2e008dfee2897c3608041182a21122,2,59,2,61,4,2013-11-12 18:10:16,2013-11-12 18:10:16
90026c85af2e008dfee2897c3608041182a21122...3eed7c9c18a8695b1c4baf1c83086d6778ed5baf,10,185,20,205,21,2013-11-12 19:35:09,2013-11-12 19:35:09
c9a79c1593299a0cc93913ae063e8a58f417bf3e...b872dd1fc9cd748c156f68b8c9f154e8e445b067,1,1,0,1,1,2013-11-12 06:13:34,2013-11-12 06:13:34
b872dd1fc9cd748c156f68b8c9f154e8e445b067...2d130aaf982d1751eccdcd4e1d98646315720239,1,4,0,4,1,2013-11-12 22:16:46,2013-11-12 18:57:26
2d130aaf982d1751eccdcd4e1d98646315720239...84b123ef4481164fa4d8d9a380cc5c5957ea08df,8,13,13,26,13,2013-11-13 03:15:47,2013-11-13 03:15:47
4f4e5342eb6767f3837d43689f9618b46345e8a1...63589300fedfec044c80d19f0da07ad88c54d772,2,21,3,24,4,2013-09-24 22:20:08,2013-09-24 00:47:29
4f4e5342eb6767f3837d43689f9618b46345e8a1...7e8c2f9405b4ce06a047878123cb0b0ce70e62c1,1,9,0,9,1,2013-09-24 00:49:59,2013-09-24 00:49:07
a812601ca696983a56da45acc7ffda9849667fa6...9fc73eee9f12da59f4bb172a165a22e7caf4e1c8,1,4,3,7,1,2013-12-05 06:29:27,2013-12-05 06:29:27
9fc73eee9f12da59f4bb172a165a22e7caf4e1c8...9ea14032826f1ccec44832b2ca9d0bfe0df5efff,12,79,83,162,20,2013-12-06 23:12:05,2013-12-06 22:01:25
9ea14032826f1ccec44832b2ca9d0bfe0df5efff...7a9e5c6d1f100c73d96fa9f9ca8c28b6c5710851,4,7,24,31,5,2013-12-06 23:13:39,2013-12-06 23:12:28
7a9e5c6d1f100c73d96fa9f9ca8c28b6c5710851...bd1708ab061ac7f3f8e7218a876e19eb1c47a7de,1,1,1,2,1,2013-12-06 23:13:54,2013-12-06 23:13:54
bd1708ab061ac7f3f8e7218a876e19eb1c47a7de...7142c1667eb3ce2ff5eb4ffa518e272dcbdb1e4b,1,1,1,2,1,2013-12-06 23:17:07,2013-12-06 23:17:07
7142c1667eb3ce2ff5eb4ffa518e272dcbdb1e4b...e46264d28354f20ba7c23841b8d76fcb2e487243,6,22,22,44,18,2013-12-07 00:00:25,2013-12-07 00:00:25
e46264d28354f20ba7c23841b8d76fcb2e487243...91c995a243d5c210b38e39922e67153efd96aeca,3,5,28,33,4,2013-12-07 00:37:51,2013-12-07 00:37:51
9b24174e08952e68d5b2a192ee5c6ba8a6cf677a...da3cd5d09e1dc1ff9404c6bb67ca41eb315011bf,1,18,0,18,2,2013-07-30 18:23:07,2013-07-20 00:19:23
255c12616083e3c197fb90b4a1a587ac9940308d...57f6d25ef28f08dca938fc93a81815ee7aa3abac,1,1,1,2,1,2013-07-17 01:43:58,2013-07-17 00:28:03
57f6d25ef28f08dca938fc93a81815ee7aa3abac...6970a89ee0c96e08d2317792e8acb0669090d65a,12,171,48,219,32,2013-07-17 01:45:56,2013-07-16 16:46:45
737bbc7f123171f5594a8021e99846f050c4eccb...dcd740c35d9fae693ba6e6bfb7e87740005e9f14,2,3,3,6,3,2013-07-16 23:43:31,2013-07-16 23:06:08
737bbc7f123171f5594a8021e99846f050c4eccb...400de11891452e983b7ba0ce5eab5a7613dd0cf9,1,2,1,3,2,2013-07-16 23:06:08,2013-07-16 23:06:08
400de11891452e983b7ba0ce5eab5a7613dd0cf9...a9cfdfe64919cedc648a7169092a5c275fa0fb10,1,1,2,3,1,2013-07-16 23:07:45,2013-07-16 23:07:45
347ace2a1d403345fc87ecb30cade5f2323e6729...bfe8e47331dda456e56260ab039241be8e82c9f0,1,1,1,2,1,2013-07-17 02:08:13,2013-07-17 02:08:13
bfe8e47331dda456e56260ab039241be8e82c9f0...3a5b5e28c8a33a7732e2d7d053dab2fefbce8090,1,3,2,5,1,2013-07-17 02:35:16,2013-07-17 02:35:16
3a5b5e28c8a33a7732e2d7d053dab2fefbce8090...7a1b5fe8cd9b8e97378d6e579c0228459738b148,1,8,8,16,8,2013-07-17 02:35:45,2013-07-17 02:35:45
7a1b5fe8cd9b8e97378d6e579c0228459738b148...23fa59bd77f6562afc7c6ea0fe8454a8301610e7,3,7,2,9,3,2013-07-17 02:45:56,2013-07-17 02:45:56
23fa59bd77f6562afc7c6ea0fe8454a8301610e7...12e2af21d34dca1f8dccadea5c5a049f0da6b87e,1,25,7,32,3,2013-07-17 03:31:34,2013-07-17 03:31:34
12e2af21d34dca1f8dccadea5c5a049f0da6b87e...1a70c41c3f1057356d2c68dafa7bfa531e561de8,7,124,76,200,36,2013-07-23 23:17:27,2013-07-23 23:17:27
1a70c41c3f1057356d2c68dafa7bfa531e561de8...29f2adee7064669522867a807af7ab6007968bfe,1,33,8,41,2,2013-07-23 23:29:48,2013-07-23 23:29:48
29f2adee7064669522867a807af7ab6007968bfe...1d9874d659043dc5e8c00da487559547e1a92c77,4,595,0,595,4,2013-07-24 08:47:24,2013-07-24 08:47:24
1d9874d659043dc5e8c00da487559547e1a92c77...32354095a7195d8c0e9572046542a4131ac70aef,1,704,1,705,4,2013-07-24 21:06:22,2013-07-24 21:06:22
32354095a7195d8c0e9572046542a4131ac70aef...46dcffc5db87333922f93f88e74cc895c75f378a,6,857,2,859,8,2013-07-24 22:13:26,2013-07-24 22:13:26
46dcffc5db87333922f93f88e74cc895c75f378a...4935843374a600a6255631fa17ecb56485d4438f,7,208,102,310,20,2013-07-25 00:55:29,2013-07-25 00:55:29
4935843374a600a6255631fa17ecb56485d4438f...ac26dd5a4f42808dd406671e03470edb7eed9adc,3,301,110,411,13,2013-07-25 05:40:09,2013-07-25 05:40:09
ac26dd5a4f42808dd406671e03470edb7eed9adc...320fc842e8a1f8aa6b1fb4ad7ffec4f96ab7de6e,7,165,33,198,24,2013-07-25 06:58:19,2013-07-25 06:58:19
320fc842e8a1f8aa6b1fb4ad7ffec4f96ab7de6e...a5cd67dc9c0112233ff7c18c09d3b5ccbb449462,3,110,89,199,33,2013-07-25 07:55:41,2013-07-25 07:55:41
a5cd67dc9c0112233ff7c18c09d3b5ccbb449462...df3939bf2d7e76023d4f7086f33fa83660e5c9b4,29,1735,1735,3470,176,2013-07-25 08:32:18,2013-07-25 08:32:07
df3939bf2d7e76023d4f7086f33fa83660e5c9b4...c91307e32e5cd56a37d316af29a6e7005aec912f,10,162,69,231,40,2013-07-25 11:07:55,2013-07-25 11:07:55
c91307e32e5cd56a37d316af29a6e7005aec912f...95c4a2124cc63584836dde0cb3a36a3df6f9b6d5,6,20,15,35,9,2013-07-25 12:22:03,2013-07-25 12:22:03
95c4a2124cc63584836dde0cb3a36a3df6f9b6d5...5789577c9512a1c9c391dbed6a35909772c1eb1b,5,37,76,113,10,2013-07-25 13:07:08,2013-07-25 13:07:08
5789577c9512a1c9c391dbed6a35909772c1eb1b...59003439437d5f9b24ed56a60284515f696005d0,4,57,65,122,9,2013-07-25 14:08:07,2013-07-25 14:08:07
59003439437d5f9b24ed56a60284515f696005d0...265e58495e5a728388a14034a455082cf146f39a,2,28,2,30,3,2013-07-25 14:38:47,2013-07-25 14:38:47
265e58495e5a728388a14034a455082cf146f39a...98f43889c427cda5668ab2ca7d61df16914c77b8,2,29,3,32,3,2013-07-25 14:57:26,2013-07-25 14:57:26
98f43889c427cda5668ab2ca7d61df16914c77b8...5467c1a63b6ddf75a824df2f232c87aac56f0c2d,6,42,18,60,10,2013-07-25 15:23:53,2013-07-25 15:23:53
5467c1a63b6ddf75a824df2f232c87aac56f0c2d...ec3491974b39e2369231f47d9d6d09c4f04b35e5,2,70,0,70,2,2013-07-25 16:00:01,2013-07-25 16:00:01
ec3491974b39e2369231f47d9d6d09c4f04b35e5...a696612369e578d3c0922e87b7a7c8a73555a769,1,1,0,1,1,2013-07-25 16:29:26,2013-07-25 16:29:26
a696612369e578d3c0922e87b7a7c8a73555a769...9bec3bfac996cd601de4c63e92f4933efdd54eda,5,48,7,55,9,2013-07-25 17:10:41,2013-07-25 17:10:41
9bec3bfac996cd601de4c63e92f4933efdd54eda...e9c460da865472c6bbc514bf556ec7d0b1a2f9c6,2,29,17,46,4,2013-07-25 17:48:35,2013-07-25 17:48:35
e9c460da865472c6bbc514bf556ec7d0b1a2f9c6...92843948f67afb8eb199ed256609cc6365a88bf2,2,24,16,40,7,2013-07-30 23:12:29,2013-07-30 23:12:29
92843948f67afb8eb199ed256609cc6365a88bf2...8f4e563a86646a0112a6e942534ec36de0dfb929,1,1,1,2,1,2013-07-30 23:19:34,2013-07-30 23:19:34
8f4e563a86646a0112a6e942534ec36de0dfb929...e15ab4fc21a3c46ceab9f102897999cb7ed3ada5,1,1,1,2,1,2013-07-31 00:10:03,2013-07-31 00:03:03
e15ab4fc21a3c46ceab9f102897999cb7ed3ada5...a130725a557f8c5c5a24400d8b3bb04ce0e52239,2,28,37,65,9,2013-07-31 00:10:03,2013-07-31 00:09:33
a130725a557f8c5c5a24400d8b3bb04ce0e52239...2d1bc3960456de91fceecbba11298699790c9f71,2,5,172,177,7,2013-07-31 02:39:52,2013-07-31 02:39:52
2d1bc3960456de91fceecbba11298699790c9f71...28a3a536bfca7e5d830321b1b57228ee21ee2393,2,37,28,65,9,2013-07-31 03:04:02,2013-07-31 03:04:02
28a3a536bfca7e5d830321b1b57228ee21ee2393...b0e10cf3d5c2a5a340bbcab314d9a728e2ded498,1,291,0,291,1,2013-07-31 19:48:17,2013-07-31 19:48:17
b0e10cf3d5c2a5a340bbcab314d9a728e2ded498...316925d3ac475d2b502fa55b5ee82dced65df2dd,1,3,82,85,2,2013-07-31 19:48:49,2013-07-31 19:48:49
316925d3ac475d2b502fa55b5ee82dced65df2dd...6434c40c39ed4f3e9a4c1050856b61bf191c24ba,1,51,0,51,2,2013-07-31 20:12:53,2013-07-31 20:12:53
6434c40c39ed4f3e9a4c1050856b61bf191c24ba...9c1d3cd1d1f2f1b5ba162dd69ddb297e06d2dde3,3,27,23,50,7,2013-07-31 23:27:55,2013-07-31 23:27:55
9c1d3cd1d1f2f1b5ba162dd69ddb297e06d2dde3...a2436c62e58333f85374a0a34af6fea57865a36c,1,2252,0,2252,1,2013-07-31 23:50:55,2013-07-31 23:50:55
a2436c62e58333f85374a0a34af6fea57865a36c...64b95a47d4652c8fab56ec4f691d444b6d75827b,1,288,237,525,24,2013-08-01 00:10:08,2013-08-01 00:10:08
3e2eb429ed09e9179920d5d7f30caa600fc8d4ac...cf6a737a1e7a4ca1e743377823d66263555b6e44,1,6,2,8,4,2013-07-12 19:37:19,2013-07-12 19:37:19
cf6a737a1e7a4ca1e743377823d66263555b6e44...b0b8b08b2f3d25973e9bca229df59c6eed0d5635,1,21,15,36,6,2013-07-12 20:29:08,2013-07-12 20:29:08
9495307fd86da98c2348a67d93bd9bb03977d65b...00c27969c61797ad1b3e49c9f9cdc04d891779dd,1,12,1,13,3,2013-07-09 00:21:41,2013-07-04 01:11:25
402b24c4711989d602ead3dbd39d08e5028f91ff...e43f873f6b39e4d64318a7c503539da42aaac642,1,1,1,2,1,2013-05-28 20:26:15,2013-05-28 20:26:15
992c4379050a5d3d15b610fec774061874915758...2fd6a2b4d2d87070586ba2e69015f7baec76e01a,1,14,12,26,10,2013-10-03 22:16:43,2013-10-03 22:16:43
2fd6a2b4d2d87070586ba2e69015f7baec76e01a...d0a6105272cd6e95fb25e2dedaca0ae9bd53b4d3,2,7,1,8,2,2013-10-03 22:38:08,2013-10-03 22:38:08
9eda3f97079c45bc9e0434a2a5bf7c043b418a84...9f2188b5da4e2b55857bd1548833e0f36077d357,1,1,4,5,2,2013-10-08 07:42:52,2013-10-08 07:42:52
d2b7b63c86e2b86a5f3e51cb3c0776c5474920ca...2601075b3380a6488e8fe6adc45fcbf840d5897f,1,3,1,4,2,2013-03-25 20:42:59,2013-03-25 20:42:59
2601075b3380a6488e8fe6adc45fcbf840d5897f...f146c7383c1d78eedd5de37e9721b0b18ed0f2c3,1,7,2,9,3,2013-03-25 22:22:15,2013-03-25 22:22:15
f146c7383c1d78eedd5de37e9721b0b18ed0f2c3...2dcef81a7c4d4834da3dcc04ae6afdd0384df1c1,1,8,0,8,1,2013-03-26 00:20:17,2013-03-26 00:20:17
2dcef81a7c4d4834da3dcc04ae6afdd0384df1c1...2c8f7d5d87fe3319e0a0e039c1e848c0016cb931,6,130,0,130,6,2013-03-26 04:19:33,2013-03-26 04:19:30
2c8f7d5d87fe3319e0a0e039c1e848c0016cb931...d90f422b43b83896f299e3f456617501b435b224,1,1,1,2,1,2013-03-26 04:25:05,2013-03-26 04:25:05
d90f422b43b83896f299e3f456617501b435b224...f7dbbca72f6557aafa8438ac20f75f9db09ba38c,1,6,2,8,2,2013-03-26 05:07:57,2013-03-26 05:07:57
f7dbbca72f6557aafa8438ac20f75f9db09ba38c...fe58789d8f5c03f9c49ffb62f675fe7dfca1ce9a,1,4,2,6,2,2013-03-26 18:13:55,2013-03-26 18:13:55
d2b7b63c86e2b86a5f3e51cb3c0776c5474920ca...9005b3cae16a663bdcf1923ee04ad7ff142b1565,3,331,0,331,3,2013-03-24 21:40:36,2013-03-24 21:40:36
9005b3cae16a663bdcf1923ee04ad7ff142b1565...45da03ed20ad384b65febe118567ff878725eb3d,6,128,0,128,6,2013-03-24 21:41:55,2013-03-24 21:41:55
45da03ed20ad384b65febe118567ff878725eb3d...1e76a0efbbe1b7feab714f745ff8777344876217,4,7,22,29,8,2013-03-25 17:40:04,2013-03-24 22:16:07
bc83e8c76c36ba6869f395aaa8cbba81dc14ee20...38eb75c4f83bd64b5bb674317180374f70b71fe7,60,8453,9296,17749,62,2013-02-13 00:04:18,2013-02-13 00:04:18
bc83e8c76c36ba6869f395aaa8cbba81dc14ee20...c27bfeb9525c75637dff5d92be14c8ff9157137d,1,48,47,95,9,2013-02-12 19:50:33,2013-02-12 19:50:33
886c38bd34ea795a5886297d4c6300816bc85770...4215e3d98b1b29f291e2c477550e00b2557c22ad,1,35,0,35,3,2014-03-30 23:43:30,2014-03-30 20:55:09
4215e3d98b1b29f291e2c477550e00b2557c22ad...bc16dabdf684d96779b12bc72fa87665d12b900a,4,34,2,36,4,2014-03-30 23:43:37,2014-03-30 22:45:47
bc16dabdf684d96779b12bc72fa87665d12b900a...a9254d7a606abd6c008078582ff16394a6f4ac41,2,13,7,20,6,2014-03-31 01:33:39,2014-03-31 01:33:39
a5601ecd1953896804f05773b7755337799724e3...4ca31f1dead420af27f17faac03cb996a3112ce0,3,1,87,88,3,2014-03-25 22:56:11,2014-03-25 22:56:11
4ca31f1dead420af27f17faac03cb996a3112ce0...73cf568af1485928ea4dde2b791828bb733b52c4,3,0,38,38,3,2014-03-25 22:59:13,2014-03-25 22:59:13
73cf568af1485928ea4dde2b791828bb733b52c4...e7c2cb5c0012867370294fdefe6d52e4bbc6c663,3,1,28,29,3,2014-03-25 22:59:44,2014-03-25 22:59:44
e7c2cb5c0012867370294fdefe6d52e4bbc6c663...5252692de530c0a17b906d92db5a76e3eb436ecc,3,5,5,10,5,2014-03-25 23:02:40,2014-03-25 23:02:40
5252692de530c0a17b906d92db5a76e3eb436ecc...952fb4d01b6861a048dfe055f1cdaf2ed3ca663e,3,80,91,171,20,2014-03-26 00:07:24,2014-03-26 00:07:24
952fb4d01b6861a048dfe055f1cdaf2ed3ca663e...b50733414aa736985d683bcac2535fdc3ae5bf5c,1,8,0,8,1,2014-03-26 00:48:50,2014-03-26 00:48:42
b50733414aa736985d683bcac2535fdc3ae5bf5c...748c4db7a36c6b3730fbf6d74ca9b53b35f9cfa4,24,31,6930,6961,34,2014-03-26 02:09:56,2014-03-26 02:09:27
748c4db7a36c6b3730fbf6d74ca9b53b35f9cfa4...6971f90c0bb04834a0ba4382f7f11bbdedcfc3ff,11,3,2003,2006,13,2014-03-26 02:18:45,2014-03-26 02:18:45
6971f90c0bb04834a0ba4382f7f11bbdedcfc3ff...3f62fab4f240b49ac2b7e09c860c79d46aa34862,3,0,281,281,3,2014-03-26 02:19:41,2014-03-26 02:19:41
3f62fab4f240b49ac2b7e09c860c79d46aa34862...c47e898070f028f45d2eb93b7dffcf21558f6806,5,1,7,8,5,2014-03-26 02:27:17,2014-03-26 02:27:17
c47e898070f028f45d2eb93b7dffcf21558f6806...28ad0a45eb5aaaf7d55dfdd8494d06c2b6d3ef70,5,82,46,128,6,2014-03-26 02:46:27,2014-03-26 02:46:23
a45ef07a4439bd7f6a761c8c2fe314c2dbc6fe88...88310fcf9a0b1dea417845d9482916dde3264898,1,1,3,4,1,2014-03-18 22:18:41,2014-03-18 22:18:41
88310fcf9a0b1dea417845d9482916dde3264898...e42176101a429059cca5b688ad01ff463101f550,1,1,1,2,1,2014-03-18 22:25:17,2014-03-18 22:25:17
e42176101a429059cca5b688ad01ff463101f550...138b42057ee1ec7cf5af74d0a2649d067d587fad,1,7,0,7,1,2014-03-19 18:57:35,2014-03-19 18:57:35
138b42057ee1ec7cf5af74d0a2649d067d587fad...3f3608170bbbac25836eda89d3f2e53ecd6f0da2,2,3,3,6,3,2014-03-20 00:01:37,2014-03-12 18:17:26
3f3608170bbbac25836eda89d3f2e53ecd6f0da2...30c23ec8b6a4120a8bf4847f2af51e7b3ffc25b4,1,1,1,2,1,2014-03-20 00:05:10,2014-03-20 00:05:10
30c23ec8b6a4120a8bf4847f2af51e7b3ffc25b4...9961cef505ea8d0c1a1d44cd861ff72ef370e286,1,2,2,4,2,2014-03-20 00:09:33,2014-03-20 00:09:33
9961cef505ea8d0c1a1d44cd861ff72ef370e286...63974c9be02eb707dcb2b46436bdd5066f994516,2,3,2,5,2,2014-03-20 00:26:49,2014-03-20 00:25:22
63974c9be02eb707dcb2b46436bdd5066f994516...fc3cbd668930763c9ce1dea538f46134c9f622a7,1,0,23,23,1,2014-03-20 14:21:11,2014-03-20 14:20:00
9c1dc8782cbd2c535261216073f0bf9a178dd42f...d049bf75063e952e02b7bd719f575072147071e8,9,128,136,264,24,2014-02-27 23:20:43,2014-02-25 04:22:49
9c1dc8782cbd2c535261216073f0bf9a178dd42f...088f5659d7f0022140e6e5b73166c04a615852c6,8,113,134,247,23,2014-02-27 17:56:39,2014-02-25 04:22:49
088f5659d7f0022140e6e5b73166c04a615852c6...0ff6e62a2afe92a180cb38949d65dbb20029f4f7,3,17,4,21,5,2014-02-27 17:56:39,2014-02-27 01:51:22
5671eaa2b77eae2c63f6c179b65ade1e85211a63...73ccf5c5229038eaea8b2ac1b9cdf503078e6287,1,3,0,3,2,2014-02-26 22:27:47,2014-02-26 22:27:47
73ccf5c5229038eaea8b2ac1b9cdf503078e6287...0a5398f52418364525788fc487dc4dba69353075,1,22,1,23,2,2014-02-26 23:11:32,2014-02-26 20:22:35
0a5398f52418364525788fc487dc4dba69353075...7d8c99a12961a7c004178ab81cac05a1ff29f0c6,2,11,6,17,5,2014-02-26 23:11:33,2014-02-26 23:11:11
7d8c99a12961a7c004178ab81cac05a1ff29f0c6...208bbea9aa1f1c3d7a9863e958edf8b74eaa3595,3,33,28,61,9,2014-02-27 05:16:02,2014-02-27 05:16:02
208bbea9aa1f1c3d7a9863e958edf8b74eaa3595...8efff3ebb79c04b213e2541ddaf91150ce6a307f,3,17,10,27,5,2014-02-27 19:41:46,2014-02-27 19:38:42
252caab5c1e4b8ad2c0ed269a63ec90e54e61975...f32c1ca419bf71bb37f295056fb5232b6449f67c,3,166,46,212,17,2013-12-31 00:04:05,2013-12-19 01:36:39
f32c1ca419bf71bb37f295056fb5232b6449f67c...c94760a0f4d8c8b0f47d3fca02f6cd7a55556789,1,1,1,2,2,2013-12-31 00:04:06,2013-12-25 03:04:44
c94760a0f4d8c8b0f47d3fca02f6cd7a55556789...aea6d0cca9b2c2cf4052bfb87ace6d604b27187f,3,102,103,205,4,2013-12-31 00:04:06,2013-12-25 03:07:19
aea6d0cca9b2c2cf4052bfb87ace6d604b27187f...447a6b3e0d56810b9da7615f8113734a9d4ec40c,1,7,8,15,4,2013-12-31 00:04:06,2013-12-26 19:46:25
447a6b3e0d56810b9da7615f8113734a9d4ec40c...c85c70f0719b2e11e17121e962f1bc56e09b2958,5,42,28,70,29,2013-12-31 00:04:06,2013-12-26 20:48:55
c85c70f0719b2e11e17121e962f1bc56e09b2958...466664c1213b78614456ef107131216eebc409a0,1,19,10,29,3,2013-12-31 00:04:06,2013-12-26 20:58:56
466664c1213b78614456ef107131216eebc409a0...373413b5501eaba3f86681cc4ddb6fe663c7c0fd,2,10,0,10,2,2013-12-31 00:04:06,2013-12-26 21:02:37
373413b5501eaba3f86681cc4ddb6fe663c7c0fd...2263cd49b438e2518b4dd7c9c32ef34ae5fc44db,2,8,2,10,4,2013-12-31 00:04:06,2013-12-26 21:08:19
2263cd49b438e2518b4dd7c9c32ef34ae5fc44db...6eac02e9bc018e0a04edec0829dfeeab9332faf2,1,19,13,32,14,2013-12-31 00:04:06,2013-12-26 22:39:01
6eac02e9bc018e0a04edec0829dfeeab9332faf2...92b2c80be5e033ed489981a0f824484072283d4a,1,4,4,8,4,2013-12-31 00:04:06,2013-12-26 22:48:10
92b2c80be5e033ed489981a0f824484072283d4a...621fa164cdf722a274fe2015243365a427d89611,2,30,18,48,9,2013-12-31 00:04:06,2013-12-26 22:55:27
621fa164cdf722a274fe2015243365a427d89611...9a8d3c42c01e9bec09a058a46ee3925fc45c4996,2,15,1,16,2,2013-12-31 00:04:07,2013-12-27 23:24:01
9a8d3c42c01e9bec09a058a46ee3925fc45c4996...ff83533efd1992028133ccedb1f3abebc3977cb9,1,3,3,6,3,2013-12-31 00:04:07,2013-12-27 23:29:43
ff83533efd1992028133ccedb1f3abebc3977cb9...f444571930b7f7429af0fbb4a7a6130a4c60f768,2,53,28,81,9,2013-12-31 00:04:07,2013-12-27 23:48:05
f444571930b7f7429af0fbb4a7a6130a4c60f768...f617d6e6bc83a16b2d0b8de2e1105a0c87e51209,1,57,22,79,14,2013-12-31 00:04:07,2013-12-28 00:09:50
f617d6e6bc83a16b2d0b8de2e1105a0c87e51209...61c51387a8cc01cab76ecca1b5029a3a944ec208,1,6,23,29,3,2013-12-31 00:04:07,2013-12-28 00:12:28
61c51387a8cc01cab76ecca1b5029a3a944ec208...ef92b6c5114d99a5b8d0ce86f1775eb36544f5a4,1,0,2,2,2,2013-12-31 00:04:07,2013-12-28 00:13:54
ef92b6c5114d99a5b8d0ce86f1775eb36544f5a4...ce54fa1d3b7000a3cac05963e0fe310dbec996a4,1,2,4,6,1,2013-12-31 00:04:07,2013-12-28 00:18:10
ce54fa1d3b7000a3cac05963e0fe310dbec996a4...75f1a6dc01bc1ab80f94232e7ed60d09b6e0a99c,2,89,24,113,19,2013-12-31 00:04:07,2013-12-28 00:51:22
75f1a6dc01bc1ab80f94232e7ed60d09b6e0a99c...bb85b79a5ed298004f2c575b4bf88ec958f668b7,2,32,11,43,8,2013-12-31 00:04:07,2013-12-28 01:08:15
bb85b79a5ed298004f2c575b4bf88ec958f668b7...366e5a5f68c6f3aaeea6ccd3ce4a5c4dc2ad9c7d,2,43,24,67,10,2013-12-31 00:04:07,2013-12-28 06:06:24
366e5a5f68c6f3aaeea6ccd3ce4a5c4dc2ad9c7d...20e1fba38c9f9fd96b7b9222f81ed2d2ea137f8a,2,45,16,61,4,2013-12-31 00:04:07,2013-12-28 06:14:59
20e1fba38c9f9fd96b7b9222f81ed2d2ea137f8a...d243d30768bf18fafa7e93c951b3e2b73711d1ce,2,63,53,116,9,2013-12-31 00:04:08,2013-12-28 06:17:44
d243d30768bf18fafa7e93c951b3e2b73711d1ce...fdd16c6530615eef0513788dbdf769663dd606de,2,17,13,30,3,2013-12-31 00:04:08,2013-12-28 06:25:25
fdd16c6530615eef0513788dbdf769663dd606de...90e94c8af11efe38ce96cd6ba8ac0e8178107813,2,40,0,40,2,2013-12-31 00:04:08,2013-12-28 06:51:20
90e94c8af11efe38ce96cd6ba8ac0e8178107813...d863883e9fcc33eaf686c606c6d3d2b6e1c222d1,2,22,1,23,3,2013-12-31 00:04:08,2013-12-29 06:22:38
d863883e9fcc33eaf686c606c6d3d2b6e1c222d1...38a9b08ff62779cf19b65066570dfac960c9c260,1,38,5,43,6,2013-12-31 00:04:08,2013-12-29 07:39:14
38a9b08ff62779cf19b65066570dfac960c9c260...a72c2b89a87dece2937c523d03ebbb6b70ea7dfc,2,15,1,16,3,2013-12-31 00:04:08,2013-12-29 07:47:15
a72c2b89a87dece2937c523d03ebbb6b70ea7dfc...dafcd0d52c8f85034bae97e2c76c459172010765,1,28,9,37,5,2013-12-31 00:04:08,2013-12-29 07:55:07
dafcd0d52c8f85034bae97e2c76c459172010765...1a8a45e6b98b855f43258856fcda703e22ce7f16,2,39,4,43,6,2013-12-31 00:04:08,2013-12-30 01:18:00
1a8a45e6b98b855f43258856fcda703e22ce7f16...c71c5598dbf733d162a0d8be74a7cec7d30cb365,2,52,1,53,3,2013-12-31 00:04:08,2013-12-30 06:35:59
c71c5598dbf733d162a0d8be74a7cec7d30cb365...60cd9a67ba008f1f73aec3653ae0a0e74c62f5c4,2,41,5,46,6,2013-12-31 00:04:08,2013-12-30 07:12:28
60cd9a67ba008f1f73aec3653ae0a0e74c62f5c4...a8d10b9a02446b7527330cadb62ac0f2d7f9338a,5,62,29,91,24,2013-12-31 00:04:08,2013-12-30 07:41:55
a8d10b9a02446b7527330cadb62ac0f2d7f9338a...2cc3bf8635299b4f19d880c47e1712cb8e792434,2,15,27,42,14,2013-12-31 00:04:09,2013-12-30 22:16:12
2cc3bf8635299b4f19d880c47e1712cb8e792434...a2dba04d782b73fb374b1cbbb56016eb51cefc16,2,126,320,446,15,2013-12-31 00:04:09,2013-12-30 23:03:25
a2dba04d782b73fb374b1cbbb56016eb51cefc16...9b9f34bb04b538090aab9bf53363839a120e8ec5,6,59,45,104,38,2013-12-31 00:04:09,2013-12-31 00:03:16
9b9f34bb04b538090aab9bf53363839a120e8ec5...df3223cc05e862320f5ef98d1936d4f5956cf4eb,4,123,103,226,57,2013-12-31 08:01:44,2013-12-31 00:28:31
df3223cc05e862320f5ef98d1936d4f5956cf4eb...bea993e1cc9d1171ecab10507b0008f0dfaf99a2,1,4,4,8,4,2013-12-31 08:13:04,2013-12-31 08:13:04
bea993e1cc9d1171ecab10507b0008f0dfaf99a2...3e6ef8580eeb99714aa164a1da8e8823409e661c,1,0,3,3,1,2013-12-31 20:00:16,2013-12-31 20:00:16
3e6ef8580eeb99714aa164a1da8e8823409e661c...87a71a9298bb3788813cf8e9f44082e3f756fba5,2,18,28,46,6,2013-12-31 20:13:15,2013-12-31 20:13:15
87a71a9298bb3788813cf8e9f44082e3f756fba5...5aa5a5c05e26f883555e2ae7be2d014d6744be3c,3,15,16,31,10,2013-12-31 20:46:28,2013-12-31 20:46:28
5aa5a5c05e26f883555e2ae7be2d014d6744be3c...2f9aecc77d12bfb464751f2fb5cbe869f678d303,2,76,46,122,10,2013-12-31 21:08:17,2013-12-31 21:08:17
2f9aecc77d12bfb464751f2fb5cbe869f678d303...e3c8bf65ab00cd379c8dd5a029d309a68a450e09,1,286,267,553,13,2013-12-31 21:22:34,2013-12-31 21:20:06
e3c8bf65ab00cd379c8dd5a029d309a68a450e09...b80d0df73631b865cb5592c2b47a60f92278c5af,5,33,31,64,28,2013-12-31 21:26:38,2013-12-31 21:26:38
b80d0df73631b865cb5592c2b47a60f92278c5af...e762fbc04564eeb1abb9220b1a674dba416a92c5,3,151,130,281,76,2013-12-31 21:51:36,2013-12-31 21:51:36
e762fbc04564eeb1abb9220b1a674dba416a92c5...a5cd5eb43542c35b92fefcfbb7bdd338205318b8,1,7,0,7,1,2013-12-31 21:55:20,2013-12-31 21:55:20
b9f63839e61c6aabee56722c65736f2ebd059978...d7702c88d76430ca461d6eda8e523595156043f6,1,1,1,2,1,2013-12-20 02:13:31,2013-12-20 02:13:31
d7702c88d76430ca461d6eda8e523595156043f6...56229c9bc93804a92708840ddeb9916516bbdfe2,1,5,4,9,2,2013-12-20 06:36:31,2013-12-20 06:36:31
7424bb63cd741fb6a75cbb0885a394bc5194fad5...4294d40220d506a55a4fc404ffa1be732b33064f,1,1,1,2,1,2013-12-20 02:14:22,2013-12-20 02:14:22
4294d40220d506a55a4fc404ffa1be732b33064f...c0626667ec9439f571347ac2287ae70dccf8d474,1,7,0,7,3,2013-12-20 02:21:20,2013-12-20 02:19:15
7f855b11f45c7bbf1f5a827a98d5e7c430cdfea0...5b017ece38bdac8704f228cc04f23ef55e5a0b7b,4,148,0,148,4,2013-12-24 04:08:59,2013-12-24 04:08:59
7f855b11f45c7bbf1f5a827a98d5e7c430cdfea0...112e4ccfdc0031ce16c619bc574df0da2eeae4c9,7,87,5,92,10,2013-12-20 04:00:45,2013-12-20 04:00:45
7f855b11f45c7bbf1f5a827a98d5e7c430cdfea0...aa693123e0b67fc9bf84dff04e85ff5a542bbc9a,8,95,1,96,8,2013-12-20 03:25:51,2013-12-20 03:25:51
b20c2c6ef6b49cf2fe9cbef53838ac12180ec362...088b6d37ac7f7f457f1cea7e10249be45f398e66,2,4,3,7,3,2013-11-13 09:08:49,2013-11-13 09:08:49
626941de716f7f26b4e98eb0594f8f6ee0cc5f1c...b6427f02c46ecc10ee4a54085def76cee1743cd5,1,11,8,19,2,2013-10-25 07:17:18,2013-10-25 03:09:30
b6427f02c46ecc10ee4a54085def76cee1743cd5...3960baeeaa0d331b9321cd235b23f662547b6f1d,2,24,3,27,6,2013-10-25 07:18:40,2013-10-25 00:04:04
3960baeeaa0d331b9321cd235b23f662547b6f1d...a006040e55172989fa655a89e26d0b6ade09b721,1,1,1,2,1,2013-10-25 07:18:45,2013-10-25 03:09:21
a006040e55172989fa655a89e26d0b6ade09b721...a35e7bf269b47bb499704d2c640a5640a93b5448,1,5,2,7,3,2013-10-25 07:20:34,2013-10-25 07:20:34
a35e7bf269b47bb499704d2c640a5640a93b5448...3cce9518a9d2e2eff304c9a70a08c2f14fa8c822,2,47,53,100,11,2013-10-25 07:29:37,2013-10-25 07:29:37
3cce9518a9d2e2eff304c9a70a08c2f14fa8c822...4dd4119556c35b377a5b3902af17736e33845b2c,1,0,5,5,1,2013-10-25 21:54:00,2013-10-25 21:54:00
4dd4119556c35b377a5b3902af17736e33845b2c...f48f92c1e8c20dc1fc08d53a70235badf25b2ab5,2,16,20,36,16,2013-10-25 22:45:51,2013-10-25 22:45:51
f48f92c1e8c20dc1fc08d53a70235badf25b2ab5...2742db83008db335af4c14829f7c5f49c8620e56,1,6,7,13,2,2013-10-26 00:25:19,2013-10-26 00:25:19
2742db83008db335af4c14829f7c5f49c8620e56...a6d99ce92557c69bd7c27d838512894ccd476414,3,86,84,170,15,2013-10-26 00:26:11,2013-10-26 00:26:11
a6d99ce92557c69bd7c27d838512894ccd476414...bf991e22fb273e2daf3e4ea058454471c09f3e51,3,92,38,130,23,2013-10-26 03:26:53,2013-09-21 23:12:39
bf991e22fb273e2daf3e4ea058454471c09f3e51...cbc19e45e0de8a00f36cf318ab8767f1a0ec9ce5,1,2,1,3,1,2013-10-26 03:26:53,2013-09-22 00:20:00
cbc19e45e0de8a00f36cf318ab8767f1a0ec9ce5...a2ffc8485b43bb3e055ae1241e2858a7502af9a3,1,2,2,4,1,2013-10-26 03:26:53,2013-09-22 00:40:59
a2ffc8485b43bb3e055ae1241e2858a7502af9a3...ae907a29d422bca405a9780c025b526408c1b92a,1,1,1,2,1,2013-10-26 03:26:53,2013-09-22 00:45:50
ae907a29d422bca405a9780c025b526408c1b92a...0538b6e1526803ba93494b30411de8f79b82b7d1,1,2,2,4,2,2013-10-26 03:26:53,2013-09-22 02:14:26
0538b6e1526803ba93494b30411de8f79b82b7d1...db80fb517b4a0c507fe3cb1d4eff08b351b31895,1,1,1,2,1,2013-10-26 03:26:53,2013-09-22 03:29:48
db80fb517b4a0c507fe3cb1d4eff08b351b31895...5fca5f553c4119ec8399e127bec0b4ab8ed84cff,1,2,2,4,1,2013-10-26 03:26:53,2013-09-22 05:40:28
5fca5f553c4119ec8399e127bec0b4ab8ed84cff...b758c98493865a7d90d4b543ec893132061b5c6f,2,75,112,187,15,2013-10-26 03:26:53,2013-09-22 09:38:28
b758c98493865a7d90d4b543ec893132061b5c6f...4708067ed8cec62cc04cac8aaceac48fef2aaec5,1,18,8,26,6,2013-10-26 03:26:54,2013-09-23 02:57:04
4708067ed8cec62cc04cac8aaceac48fef2aaec5...97a168deff1d4a0a9d93a7b42b875548595fd9e6,1,2,2,4,2,2013-10-26 03:26:54,2013-09-23 02:57:21
97a168deff1d4a0a9d93a7b42b875548595fd9e6...7bc568a050cf2c9835281a48454a31313dacbcd1,1,11,4,15,1,2013-10-26 03:26:54,2013-09-23 04:46:36
7bc568a050cf2c9835281a48454a31313dacbcd1...9da8ac3af9075c2e715626c893ed03a820f567f8,1,2,2,4,2,2013-10-26 03:26:54,2013-09-24 02:19:05
9da8ac3af9075c2e715626c893ed03a820f567f8...5192d1cc9ce2cd4f6612ecf7ac770c10c537e3d2,2,28,31,59,10,2013-10-26 03:26:54,2013-10-23 04:44:57
5192d1cc9ce2cd4f6612ecf7ac770c10c537e3d2...8c59ab7e47864e1496d15e5b57c20467c224b550,1,2,1,3,2,2013-10-26 03:26:54,2013-10-23 05:25:51
8c59ab7e47864e1496d15e5b57c20467c224b550...eeeb0acee8fa92b632379fc305a481117e3ca2d4,3,5,0,5,3,2013-10-26 03:26:54,2013-10-23 06:20:23
626941de716f7f26b4e98eb0594f8f6ee0cc5f1c...57d60c1c76d0360fa7481fd63fa6422697e72fc9,3,92,38,130,23,2013-10-23 06:19:31,2013-09-21 23:12:39
57d60c1c76d0360fa7481fd63fa6422697e72fc9...b07bab3d81a89df767a0d0568792b63939a60798,1,2,1,3,1,2013-10-23 06:19:31,2013-09-22 00:20:00
b07bab3d81a89df767a0d0568792b63939a60798...43570ac538dc7492947bad1bb6b805467621cb7c,1,2,2,4,1,2013-10-23 06:19:31,2013-09-22 00:40:59
43570ac538dc7492947bad1bb6b805467621cb7c...1657d65e64b44e8e1e95b4e982d5ba2f20f0b1c9,1,1,1,2,1,2013-10-23 06:19:31,2013-09-22 00:45:50
1657d65e64b44e8e1e95b4e982d5ba2f20f0b1c9...f3530af2aa31005272906cd71b3a60aa74152c31,1,2,2,4,2,2013-10-23 06:19:31,2013-09-22 02:14:26
f3530af2aa31005272906cd71b3a60aa74152c31...3fadf89241599f3af964bb1b155e525f0041b63b,1,1,1,2,1,2013-10-23 06:19:31,2013-09-22 03:29:48
3fadf89241599f3af964bb1b155e525f0041b63b...8b084a2f532b0acc64e527033060411bbfb30380,1,2,2,4,1,2013-10-23 06:19:31,2013-09-22 05:40:28
8b084a2f532b0acc64e527033060411bbfb30380...8b8c164047447615f84b4eeed5b3a097c0a96bd5,2,75,112,187,15,2013-10-23 06:19:31,2013-09-22 09:38:28
8b8c164047447615f84b4eeed5b3a097c0a96bd5...95b8c4502854d0b003730c3964e0165e83f1d99e,1,18,8,26,6,2013-10-23 06:19:31,2013-09-23 02:57:04
95b8c4502854d0b003730c3964e0165e83f1d99e...677f9cdded9bba2e0e9ec7eb056b18891a7e9953,1,2,2,4,2,2013-10-23 06:19:31,2013-09-23 02:57:21
677f9cdded9bba2e0e9ec7eb056b18891a7e9953...42b78aac6987987e0631752bceb68b854664d89b,1,11,4,15,1,2013-10-23 06:19:31,2013-09-23 04:46:36
42b78aac6987987e0631752bceb68b854664d89b...773fb702443706717c2f0f3e564c4b34c905516d,1,2,2,4,2,2013-10-23 06:19:32,2013-09-24 02:19:05
773fb702443706717c2f0f3e564c4b34c905516d...6a540411bbfab766d16f72536b401ab62de4f6f3,2,28,31,59,10,2013-10-23 06:19:32,2013-10-23 04:44:57
6a540411bbfab766d16f72536b401ab62de4f6f3...c5c13171052f464f3778f30d6c7b68091da963f8,1,2,1,3,2,2013-10-23 06:19:32,2013-10-23 05:25:51
c5c13171052f464f3778f30d6c7b68091da963f8...cd5f4700889bda30d8c5ed53490c2fb342de46ee,3,5,0,5,3,2013-10-23 06:20:23,2013-10-23 06:20:23
62722927371df44fda96a1126d84df201d9d4b5f...d81814e2195f7242bdcd61e4775350586da758ff,3,20,7,27,3,2013-11-13 03:27:12,2013-11-13 03:27:12
d81814e2195f7242bdcd61e4775350586da758ff...b899c5411fb2770805b20587a604b875a049a32d,1,6,8,14,1,2013-11-13 04:00:28,2013-11-13 04:00:28
84b123ef4481164fa4d8d9a380cc5c5957ea08df...6be1f39c4f0e48250d59a815af85dfcd036ac18a,1,23,16,39,3,2013-11-13 21:59:53,2013-11-13 21:59:53
6be1f39c4f0e48250d59a815af85dfcd036ac18a...aeac511774890c577118c2762a870a7df3aade24,1,5,0,5,2,2013-11-13 22:00:40,2013-11-13 22:00:40
aeac511774890c577118c2762a870a7df3aade24...bb959da9c7f02af04c32c5c3c35c815413a9f75e,3,7,9,16,8,2013-11-13 22:01:36,2013-11-13 22:01:36
bb959da9c7f02af04c32c5c3c35c815413a9f75e...c1396baedd85a6953698dbd05e5cc194be64dc21,3,28,1,29,3,2013-11-13 22:04:47,2013-11-13 22:04:47
1eca8f4a5501bd64e91dbe977b4b0d054b32b66b...9368852bdcb783e4663fb9c1875c2d7dd5c3b938,1,2,2,4,1,2013-09-24 23:31:44,2013-09-24 23:31:44
1eca8f4a5501bd64e91dbe977b4b0d054b32b66b...fc44123f9f38aad79998b7f90a2b1141f80a15bf,2,41,33,74,27,2013-09-24 22:58:05,2013-09-23 23:35:37
fc44123f9f38aad79998b7f90a2b1141f80a15bf...c2902c31e9bdf338f11953845aa417efaad20814,2,27,7,34,7,2013-09-24 22:58:05,2013-09-24 00:44:34
c2902c31e9bdf338f11953845aa417efaad20814...2b3f37de7c6b5e14c8fb646367d16507d38e7851,2,14,4,18,6,2013-09-24 23:08:40,2013-09-24 23:08:40
2b3f37de7c6b5e14c8fb646367d16507d38e7851...e13cf5138c398d2c00cb6eabf48a1b22cb2e2880,1,3,0,3,1,2013-09-24 23:11:29,2013-09-24 23:11:29
7e8c2f9405b4ce06a047878123cb0b0ce70e62c1...ca080b147701bf2171b99336690514cb70d12ae7,2,2,2,4,2,2013-09-24 03:53:09,2013-09-24 03:53:09
ca080b147701bf2171b99336690514cb70d12ae7...6452c8b173123f26c2442bdcc7a08cd44e9ba089,1,4,0,4,1,2013-09-24 05:50:43,2013-09-24 05:50:43
91c995a243d5c210b38e39922e67153efd96aeca...4cf87fbcc5ad970559f249ced2514085caccded9,6,133,43,176,15,2013-12-09 07:03:30,2013-12-09 06:47:42
ac8c1eb34ce54639e17ee8769dcd9f0a8e18000c...3320156d7b790a6b09884b1e1624036ab6d5dfc4,1,0,51,51,1,2013-11-19 00:59:32,2013-11-19 00:59:32
3320156d7b790a6b09884b1e1624036ab6d5dfc4...60f88dcc0f6f3284fca096d54e84053003771baf,1,1,1,2,1,2013-11-19 01:03:41,2013-11-13 01:11:01
60f88dcc0f6f3284fca096d54e84053003771baf...661e697cbb753a195905aac88002b4c0d16c0e43,1,6,6,12,4,2013-11-19 01:06:53,2013-11-19 01:06:53
661e697cbb753a195905aac88002b4c0d16c0e43...8ca70e9d3a65dfc761df322a70df4b303d3accf0,1,0,1,1,1,2013-11-19 01:30:00,2013-11-16 09:44:25
8ca70e9d3a65dfc761df322a70df4b303d3accf0...b01bef022a1670192e3ef9b649cdade45d5e8e47,1,8,71,79,4,2013-11-19 02:01:38,2013-11-19 02:01:38
b01bef022a1670192e3ef9b649cdade45d5e8e47...a2b0ffff1b39a6975426f07e912ab226e74c1098,1,12,2,14,3,2013-11-19 02:28:12,2013-11-19 02:12:31
a1c6cd02f6c41105340356dec320f6d9c7ea19c1...36492a23acb3f1277a84be522ea3aeb01fbfe4f9,1,38,46,84,16,2013-07-30 20:55:55,2013-07-30 20:55:55
36492a23acb3f1277a84be522ea3aeb01fbfe4f9...3ce09d8371bab94412f61a13693dc52702e9b4d3,1,32,20,52,4,2013-07-30 21:24:32,2013-07-30 21:24:32
3ce09d8371bab94412f61a13693dc52702e9b4d3...a86a00b11937882f8a3c4f570813505dcf16a661,1,5,1,6,2,2013-07-30 21:31:08,2013-07-30 21:31:08
a86a00b11937882f8a3c4f570813505dcf16a661...98db63dd1bab50dd48d98091895e34425a226e1d,1,21,3,24,6,2013-07-30 21:44:30,2013-07-30 21:44:30
98db63dd1bab50dd48d98091895e34425a226e1d...2a750e64decd923beec7e62492216651c286fe00,2,6,6,12,3,2013-07-30 22:32:06,2013-07-30 22:32:06
2a750e64decd923beec7e62492216651c286fe00...b5c907b03435a8fdb38c17b8cd12112276620952,1,0,1,1,1,2013-07-30 22:37:06,2013-07-30 22:37:06
b5c907b03435a8fdb38c17b8cd12112276620952...c9aa2ac16bd2f8c23328080fc8558d2bb650ecd7,1,1,1,2,1,2013-07-31 02:17:55,2013-07-31 02:17:55
c9aa2ac16bd2f8c23328080fc8558d2bb650ecd7...9fba51960c79e5c84b8a5eded5cfcaa9ccabfcb2,3,28,18,46,18,2013-07-31 02:43:40,2013-07-31 02:43:33
9fba51960c79e5c84b8a5eded5cfcaa9ccabfcb2...c11a791eb255cab11d278bab2b6b9ecc4574a668,1,1,1,2,1,2013-07-31 02:48:34,2013-07-31 02:48:34
c11a791eb255cab11d278bab2b6b9ecc4574a668...5d65352c476739edff9b538103038d64d07a8852,1,1,1,2,1,2013-07-31 02:58:41,2013-07-31 02:58:41
5d65352c476739edff9b538103038d64d07a8852...ae965f1aa15cc6befb2ba07c116f9844d679d0ce,1,6,1,7,2,2013-07-31 03:00:15,2013-07-25 21:54:15
ae965f1aa15cc6befb2ba07c116f9844d679d0ce...097b26151872db16261c6ece19bc3129851c03cf,1,1,5,6,2,2013-07-31 05:49:57,2013-07-31 05:48:42
6970a89ee0c96e08d2317792e8acb0669090d65a...f7fb9742b36841d0ec616d219f4e7c59a653f6ba,1,31,3,34,4,2013-07-17 06:47:58,2013-07-17 03:01:28
f7fb9742b36841d0ec616d219f4e7c59a653f6ba...83ab263a88b45fac60ef9c3e064102923896ccda,1,17,11,28,4,2013-07-17 06:48:03,2013-07-17 04:25:56
83ab263a88b45fac60ef9c3e064102923896ccda...b3130558d2356a17f2327775aaf857d128f111ae,3,102,23,125,14,2013-07-17 06:48:10,2013-07-17 06:26:56
b3130558d2356a17f2327775aaf857d128f111ae...869bc23c25478b2bb51603292849b11dddd01ae7,4,58,61,119,52,2013-07-17 07:01:05,2013-07-17 00:23:13
869bc23c25478b2bb51603292849b11dddd01ae7...9538bec6852814c61bee2f8a62f263465c0f558e,5,210,246,456,58,2013-07-17 07:01:06,2013-07-17 03:32:22
9538bec6852814c61bee2f8a62f263465c0f558e...1e002707a254fea8f3370d676b70a352075d8b9c,2,8,8,16,6,2013-07-17 07:02:58,2013-07-17 07:02:58
1e002707a254fea8f3370d676b70a352075d8b9c...058f883a35a2a78bcbfdaec09051a770d53f98fd,1,33,21,54,8,2013-07-17 07:30:48,2013-07-17 07:25:41
058f883a35a2a78bcbfdaec09051a770d53f98fd...4da6391ba5e9b6792c0a7c76d227c6b563889191,1,8,1,9,1,2013-07-17 18:05:31,2013-07-17 18:05:31
4da6391ba5e9b6792c0a7c76d227c6b563889191...b7f6a093a49c990c9f1e491f7b30bcce7363cf27,1,5,3,8,2,2013-07-17 18:43:23,2013-07-17 18:41:48
b7f6a093a49c990c9f1e491f7b30bcce7363cf27...625aed5ea36e0516a0fb88fc00e3d4dc28a61304,3,16,13,29,6,2013-07-17 18:48:10,2013-07-17 18:47:45
625aed5ea36e0516a0fb88fc00e3d4dc28a61304...46871d3fa609963232d1e3fc4a3cc310a22f0d68,1,4,13,17,5,2013-07-17 19:10:25,2013-07-17 19:10:25
46871d3fa609963232d1e3fc4a3cc310a22f0d68...88d12e76e62c728e1b55460a2a642dd09726f167,2,67,47,114,35,2013-07-17 19:21:38,2013-07-17 19:21:38
88d12e76e62c728e1b55460a2a642dd09726f167...d16f90623842530936a89e8e89bea5844106da07,1,1,1,2,1,2013-07-17 19:22:16,2013-07-17 19:22:16
d16f90623842530936a89e8e89bea5844106da07...ecf859e2a791eb570e9e786fe22f2776314035ec,1,2,0,2,1,2013-07-17 21:10:26,2013-07-17 21:10:26
ecf859e2a791eb570e9e786fe22f2776314035ec...7da056199586485c5ec85da79ae630f9aa28524c,1,7,1,8,1,2013-07-17 22:23:56,2013-07-17 22:23:01
7da056199586485c5ec85da79ae630f9aa28524c...fc307660acbcaf9f8d61e0796adb1f5a7b861482,1,9,0,9,1,2013-07-18 02:57:40,2013-07-18 02:57:40
fc307660acbcaf9f8d61e0796adb1f5a7b861482...f29e4a37c919172ccc04ac56426c6f96a99d6701,1,1,2,3,1,2013-07-18 15:06:27,2013-07-18 15:06:27
f29e4a37c919172ccc04ac56426c6f96a99d6701...59bec95724aeda7577b190da9ed910bde97fd44e,1,7,1,8,1,2013-07-18 17:17:49,2013-07-18 17:17:49
59bec95724aeda7577b190da9ed910bde97fd44e...c1667c7d0c24f282b522f9217c115099599785c5,9,82,21,103,15,2013-07-18 17:31:52,2013-07-18 17:31:52
c1667c7d0c24f282b522f9217c115099599785c5...99560c7d34ffacfc66781b238b9498a75b15501f,1,1,1,2,1,2013-07-18 17:42:14,2013-07-18 17:42:14
99560c7d34ffacfc66781b238b9498a75b15501f...2f6a5b21934efb6e5155a6c7f180719158de6be7,1,2,5,7,1,2013-07-18 18:40:13,2013-07-18 18:39:42
2f6a5b21934efb6e5155a6c7f180719158de6be7...74da4b1adb78fc7165caf5e8b5a35df073a23df5,2,2,3,5,2,2013-07-18 19:40:16,2013-07-18 19:40:16
74da4b1adb78fc7165caf5e8b5a35df073a23df5...9e6653d3ba48a261be25b934303f226b88dd15c9,1,1,1,2,1,2013-07-19 01:08:12,2013-07-19 01:08:12
9e6653d3ba48a261be25b934303f226b88dd15c9...ee60b7bcae26c1e74092e4032b43d381fa6d10a0,1,36,9,45,15,2013-07-19 06:46:31,2013-07-19 06:46:31
ee60b7bcae26c1e74092e4032b43d381fa6d10a0...15c396b6868da897ceac8ddeba147e85363be119,1,1,1,2,1,2013-07-19 17:08:10,2013-07-19 17:08:10
15c396b6868da897ceac8ddeba147e85363be119...46180063c71d7025a27e413188df89e4d116a418,1,1,1,2,1,2013-07-19 17:13:05,2013-07-19 17:13:05
46180063c71d7025a27e413188df89e4d116a418...94810814d63d0ac97d1e3eaa49ce4bc7c072acb5,1,0,1,1,1,2013-07-19 17:42:56,2013-07-19 17:42:56
94810814d63d0ac97d1e3eaa49ce4bc7c072acb5...d0b7b41860ed65c8b1b53fb378e0869b1fa68107,1,2,2,4,2,2013-07-19 18:26:22,2013-07-19 18:26:22
d0b7b41860ed65c8b1b53fb378e0869b1fa68107...237f6da87e0c0a745d35243831971a11b2ceebbd,4,19,4,23,6,2013-07-19 18:27:55,2013-07-19 18:27:55
64b95a47d4652c8fab56ec4f691d444b6d75827b...a1404b7a70427d911ade99b94524e5b589a8ac46,2,10,246,256,2,2013-08-01 23:27:49,2013-08-01 23:27:49
a1404b7a70427d911ade99b94524e5b589a8ac46...11feb8800a312428a6960a16f454e69b1f148bde,2,38,19,57,6,2013-08-01 23:37:06,2013-08-01 23:27:59
11feb8800a312428a6960a16f454e69b1f148bde...e85f20be8ee5b093b81d9c63ebe869e2e35a3d1e,2,9,5,14,2,2013-08-01 23:46:20,2013-08-01 23:41:11
e85f20be8ee5b093b81d9c63ebe869e2e35a3d1e...a588f82a013e0a684f8a1753f2ff91967d4b789a,1,1,1,2,1,2013-08-02 00:00:47,2013-08-02 00:00:47
4e931f5a867e7b380daf531cb9a89a937b006414...3550a9f2db3f3988cbee60a0a02cde2e9ff2946f,1,3,0,3,1,2013-07-09 05:00:38,2013-07-08 23:55:56
3550a9f2db3f3988cbee60a0a02cde2e9ff2946f...0ab16fd9cdae9e63149af22e448770610dccb1b7,1,1,0,1,1,2013-07-09 05:00:38,2013-07-09 04:59:50
0ab16fd9cdae9e63149af22e448770610dccb1b7...2e44b70cb70306c085c0f800ce92daf9751747c8,1,2,1,3,1,2013-07-09 05:00:38,2013-07-09 05:00:18
2e44b70cb70306c085c0f800ce92daf9751747c8...18384d197c76f253e2244e1bfda656bc887eb70e,7,19,19,38,15,2013-07-09 18:21:54,2013-07-09 18:21:39
18384d197c76f253e2244e1bfda656bc887eb70e...037b6e52e3889019a76ce7527a0c83c3ef94fbd0,1,2,2,4,2,2013-07-09 18:33:37,2013-07-09 18:33:37
037b6e52e3889019a76ce7527a0c83c3ef94fbd0...ec743652ac6464b7478672dc0e38231deafa032e,1,3,5,8,4,2013-07-09 19:41:41,2013-07-09 19:41:13
ec743652ac6464b7478672dc0e38231deafa032e...6ce0d28ce66834238c176f33e1d6c53167bdb5df,1,3,4,7,1,2013-07-09 19:45:31,2013-07-09 19:45:31
6ce0d28ce66834238c176f33e1d6c53167bdb5df...bf1c57d153caa47f0a05fdeb7c976a5a82e3c541,1,5,3,8,2,2013-07-09 23:00:43,2013-07-09 23:00:43
e43f873f6b39e4d64318a7c503539da42aaac642...75149b75f3cbab3000aabb3d6e7c6caf652aea01,3,5,3,8,3,2013-05-28 21:17:53,2013-05-28 21:15:31
d0a6105272cd6e95fb25e2dedaca0ae9bd53b4d3...664339fdb342a5620af407fc480fd5dcb4dd2706,6,6,6,12,6,2013-10-03 22:52:19,2013-10-02 17:34:49
664339fdb342a5620af407fc480fd5dcb4dd2706...c03879f7804edc0944f746f61b9e3580c5dc9650,3,112,80,192,38,2013-10-03 22:52:19,2013-10-02 18:09:39
c03879f7804edc0944f746f61b9e3580c5dc9650...26af82fcf0deb20e06f55798491ca1daf5c356df,10,31,16,47,12,2013-10-03 22:52:19,2013-10-02 18:33:35
26af82fcf0deb20e06f55798491ca1daf5c356df...60d55667631541693fa2703affe615a355a40df7,1,8,11,19,3,2013-10-03 22:52:19,2013-10-02 18:37:02
60d55667631541693fa2703affe615a355a40df7...85a42e908c506fb0ce363a184ac4088911d11d18,1,0,2,2,1,2013-10-03 22:52:19,2013-10-02 19:05:22
85a42e908c506fb0ce363a184ac4088911d11d18...000c5f3a9b41023502265a3c48f28a15181b91bf,1,1,1,2,1,2013-10-03 22:52:19,2013-10-02 19:44:38
000c5f3a9b41023502265a3c48f28a15181b91bf...ceb37b48c6fe48c84af3f547f8f7bb181d9dcbc6,8,50,30,80,27,2013-10-03 22:52:19,2013-10-03 19:27:43
ceb37b48c6fe48c84af3f547f8f7bb181d9dcbc6...0f0542efb1754b9412b7d79733f25c6a2f950528,4,5,15,20,6,2013-10-03 22:52:20,2013-10-03 20:48:55
0f0542efb1754b9412b7d79733f25c6a2f950528...6528f9eef7732181652d8d04ff746e88036123ea,2,24,14,38,9,2013-10-03 22:52:20,2013-10-03 21:17:51
6528f9eef7732181652d8d04ff746e88036123ea...ee220b1da71ada62b1d664b67c0ec3a9542276a9,1,1,1,2,1,2013-10-03 22:52:20,2013-10-03 21:48:06
ee220b1da71ada62b1d664b67c0ec3a9542276a9...741ad1d1d650c32f07cadd82cbb8ffb61b387004,1,1,1,2,1,2013-10-03 22:52:20,2013-10-03 21:50:42
741ad1d1d650c32f07cadd82cbb8ffb61b387004...8062d65730ad09edda445440ce279fb40e08c18f,1,1,1,2,1,2013-10-03 23:59:44,2013-10-03 23:59:44
8062d65730ad09edda445440ce279fb40e08c18f...14e93abce3cdbfc64319321d568b0f2fbcc49752,3,4,3,7,3,2013-10-04 00:06:55,2013-10-04 00:06:55
9f2188b5da4e2b55857bd1548833e0f36077d357...2f42f21dafac1b7df7d8438af2cfdc61efdef003,2,4,3,7,2,2013-10-09 00:41:08,2013-10-08 23:31:36
2f42f21dafac1b7df7d8438af2cfdc61efdef003...4e922fd709e2f8586ba8a6c811b4d90c4bb4f9d3,1,8,3,11,2,2013-10-09 04:30:39,2013-10-09 04:30:39
4e922fd709e2f8586ba8a6c811b4d90c4bb4f9d3...b44f0a61df930855669f1dfad01b86931b4a8b83,1,11,2,13,3,2013-10-09 05:01:40,2013-10-09 04:12:03
b44f0a61df930855669f1dfad01b86931b4a8b83...abd966909993782d288efd543ddabfc07c985665,2,7,0,7,3,2013-10-09 05:01:40,2013-10-09 04:22:06
abd966909993782d288efd543ddabfc07c985665...cd0b6eb22f50643d94a894a696e3b8eb92d5f8c3,1,3,18,21,2,2013-10-09 05:01:40,2013-10-09 04:28:37
cd0b6eb22f50643d94a894a696e3b8eb92d5f8c3...35cee2d4ea3d07fb73468fb6719e6ab8023972bf,1,32,10,42,10,2013-10-09 05:01:40,2013-10-09 05:00:12
35cee2d4ea3d07fb73468fb6719e6ab8023972bf...8883056bf77febfef6c287dc57d5f2d9128000ff,1,1,1,2,1,2013-10-09 16:59:24,2013-10-09 08:38:22
8883056bf77febfef6c287dc57d5f2d9128000ff...de05d27cf381ccfcc4b96ae120d71f49f81e0907,4,46,33,79,21,2013-10-09 19:00:23,2013-10-09 18:59:18
fe58789d8f5c03f9c49ffb62f675fe7dfca1ce9a...c443011e4604e291a0e07a50aace45839c27f4c3,1,14,2,16,1,2013-03-26 21:32:31,2013-03-25 14:33:32
c443011e4604e291a0e07a50aace45839c27f4c3...a2485a85fc893525e63d24e96d38d975db70e11c,1,1,7,8,1,2013-03-26 21:32:31,2013-03-26 21:17:16
c27bfeb9525c75637dff5d92be14c8ff9157137d...99ebc78d7a5a3ff9a2927085deffc44030460b8f,3,139,41,180,25,2013-02-12 20:35:30,2013-02-06 20:27:45
99ebc78d7a5a3ff9a2927085deffc44030460b8f...93b31e563c78e53dd2fa472ba3f2953be7d5cd5f,3,15,22,37,10,2013-02-12 20:35:30,2013-02-07 14:15:20
7dab23c3ce5c122515e2f6c8273efc9a5870fea3...05c4edf9f77dffb8a89202af620dcad67c77aec7,13,349,9,358,27,2014-03-31 03:03:28,2014-02-25 23:53:42
05c4edf9f77dffb8a89202af620dcad67c77aec7...0ac3bf9d4b9fd0e56edd4653b4fb671e7dc141ea,6,18,0,18,1,2014-03-31 03:03:29,2014-03-04 01:08:55
0ac3bf9d4b9fd0e56edd4653b4fb671e7dc141ea...865eb3001515296e80b4ddff78743e916b3157f5,6,101,118,219,30,2014-03-31 03:03:29,2014-03-04 17:19:12
865eb3001515296e80b4ddff78743e916b3157f5...8709365598599990fad349757c276b949ac8cdb0,8,51,24,75,27,2014-03-31 03:03:29,2014-03-18 00:18:24
8709365598599990fad349757c276b949ac8cdb0...6f4f723c6af0ef5c8b65f87e69c308ee6d08ee36,6,44,44,88,27,2014-03-31 03:03:29,2014-03-19 23:04:22
6f4f723c6af0ef5c8b65f87e69c308ee6d08ee36...197552ae9b1c87393d50c3b59410a41185b77c1a,1,13,0,13,1,2014-03-31 04:43:58,2014-03-31 04:43:58
197552ae9b1c87393d50c3b59410a41185b77c1a...cb5556f7d222af727bf741c4666c15e8cb31e03a,1,1,1,2,1,2014-03-31 05:02:55,2014-03-31 05:02:55
cb5556f7d222af727bf741c4666c15e8cb31e03a...7f44bdf0c8312fe4c7659c9503f38f62149ef0c7,2,5,2,7,2,2014-03-31 05:18:34,2014-03-31 05:18:34
7f44bdf0c8312fe4c7659c9503f38f62149ef0c7...2216f6d05f7d628c11fecfe70a6a7626b88c24bc,3,15,7,22,3,2014-03-31 05:53:41,2014-03-31 05:19:15
2216f6d05f7d628c11fecfe70a6a7626b88c24bc...a690cacc63948690dbad009f757ec7c77c20d2b5,1,8,1,9,1,2014-03-31 06:52:42,2014-03-31 06:25:26
350f4e5bbdc3e24d8f47f8a2010ecb58923feb85...c5f288be38fc885e9ead6166d08dbea9bbd4999a,2,7,4,11,3,2014-03-28 00:22:18,2014-03-28 00:22:18
c5f288be38fc885e9ead6166d08dbea9bbd4999a...45ac9b1a6d9cfce3b41bea679d7a615d85992abf,5,36,203,239,11,2014-03-30 19:15:23,2014-03-30 18:50:19
28ad0a45eb5aaaf7d55dfdd8494d06c2b6d3ef70...90882aa13645e70e1127d972eb96a7fbaa2ef8e8,1,0,1,1,1,2014-03-26 20:37:26,2014-03-26 00:08:11
90882aa13645e70e1127d972eb96a7fbaa2ef8e8...a965a117d2c7c15c6aee08e5ad10a297c5fee480,1,1,1,2,2,2014-03-26 20:37:26,2014-03-26 00:10:10
a965a117d2c7c15c6aee08e5ad10a297c5fee480...f3000b69bbd8d8a9f3956a72bec40a99909117b7,4,118,3,121,7,2014-03-26 20:37:26,2014-03-26 00:55:10
f3000b69bbd8d8a9f3956a72bec40a99909117b7...85c3e124dadc54194601db5f26e149c6e29f568f,1,1,1,2,1,2014-03-26 20:43:54,2014-03-26 20:43:54
85c3e124dadc54194601db5f26e149c6e29f568f...6a8f738ffb2daafc2a069742552f236b6775a1a1,1,18,18,36,8,2014-03-26 20:54:54,2014-03-26 20:54:54
6a8f738ffb2daafc2a069742552f236b6775a1a1...10b5c88f4ed004c2de4bc10f5fccc33a0d28d8ae,6,0,116,116,6,2014-03-26 21:23:04,2014-03-26 21:23:04
28ad0a45eb5aaaf7d55dfdd8494d06c2b6d3ef70...ef20fd5f7526fc1c65719b489c4e4a9a738b88dc,50,9083,103,9186,45,2014-03-26 19:02:09,2014-03-26 19:02:09
fc3cbd668930763c9ce1dea538f46134c9f622a7...64f0c73b6b8caa01b4b2b70afb5126a0e3ac9823,2,30,7,37,4,2014-03-21 00:05:04,2014-03-08 17:07:49
64f0c73b6b8caa01b4b2b70afb5126a0e3ac9823...a6e9ae392b49bab93236fad9d6072da99dbdc63b,3,11,7,18,6,2014-03-21 00:05:04,2014-03-14 13:14:44
a6e9ae392b49bab93236fad9d6072da99dbdc63b...f2a2b2eb74ea7ccae6e9706c741d018c3d03825c,1,7,12,19,3,2014-03-21 00:05:04,2014-03-14 13:19:54
d049bf75063e952e02b7bd719f575072147071e8...dcf806f852dcc6e9a6041b1d9a8f028abbf7e581,1,1,1,2,1,2014-02-28 19:52:44,2014-02-28 19:52:44
dcf806f852dcc6e9a6041b1d9a8f028abbf7e581...45db64d4bf8f994fa53f6d50a4f1f480c8eeaf93,2,4,1,5,2,2014-02-28 19:58:29,2014-02-28 19:58:29
45db64d4bf8f994fa53f6d50a4f1f480c8eeaf93...3ebc9aba60fea68a095aec6b4f2adb51ce46e6a4,1,1,1,2,1,2014-02-28 19:59:03,2014-02-28 19:59:03
3ebc9aba60fea68a095aec6b4f2adb51ce46e6a4...bd05fdb2c5dba32529311369b263d4bbfacf1931,4,27,3,30,6,2014-03-01 07:13:11,2014-03-01 07:12:36
bd05fdb2c5dba32529311369b263d4bbfacf1931...89a96084b864b2bdc64f16a95baa03f4796412bc,1,1,0,1,1,2014-03-01 07:15:33,2014-03-01 07:15:33
d049bf75063e952e02b7bd719f575072147071e8...d50049777fb3c0500da2ea2484173fa8bcfbc086,7,317,7,324,15,2014-02-28 10:03:02,2014-02-28 10:03:02
d249fbd07bfcbfd3b5fb99ab7560d016fd591428...15a4cac27c6bf41f24fecec0d4f764a56135009c,1,1,1,2,1,2014-02-26 23:58:08,2014-02-26 23:58:08
15a4cac27c6bf41f24fecec0d4f764a56135009c...af08231656987d32699d9dfb1305930e373224c7,1,53,27,80,13,2014-02-27 00:33:27,2014-02-27 00:32:19
af08231656987d32699d9dfb1305930e373224c7...7948c0f38b65cab02fae0f3369449d30d74e1b05,1,63,7,70,3,2014-02-27 01:09:16,2014-02-27 01:09:16
7948c0f38b65cab02fae0f3369449d30d74e1b05...b3548e54378433ff67e5dbf2b7cfc922290bda1b,4,34,10,44,6,2014-02-27 02:44:24,2014-02-27 02:44:24
b3548e54378433ff67e5dbf2b7cfc922290bda1b...85ba085c78c3f3b185af063642a459bcab9c9007,1,5,1,6,3,2014-02-27 02:45:25,2014-02-27 02:45:25
85ba085c78c3f3b185af063642a459bcab9c9007...a96243e746682559d8b03597108ebdaf4e3c43f1,3,14,19,33,11,2014-02-28 22:16:10,2014-02-28 22:01:19
a96243e746682559d8b03597108ebdaf4e3c43f1...c14e41a0d7440fd4f41f3b2201d8b5b6900d56b1,1,25,0,25,1,2014-02-28 22:22:30,2014-02-28 22:22:30
c14e41a0d7440fd4f41f3b2201d8b5b6900d56b1...571ba01f16cb554e04bd54c538b591ad374e34b9,1,4,4,8,3,2014-02-28 22:25:33,2014-02-28 22:25:33
571ba01f16cb554e04bd54c538b591ad374e34b9...29ebdbfeae0fef98ceb0e563da11b66384eaced1,1,20,0,20,3,2014-02-28 22:34:44,2014-02-28 22:34:44
29ebdbfeae0fef98ceb0e563da11b66384eaced1...c615ec11efef3dd78c29b31339284fa48fc989fb,1,2,2,4,2,2014-03-01 00:51:09,2014-03-01 00:51:09
c615ec11efef3dd78c29b31339284fa48fc989fb...1fef6e5662c556bf6a294465b6583aa231060817,1,24,28,52,3,2014-03-01 02:18:09,2014-03-01 02:18:09
1fef6e5662c556bf6a294465b6583aa231060817...6c595e7b8d206bad7b4b3f482be5f1023d43904c,1,0,2,2,1,2014-03-01 05:42:51,2014-02-27 05:53:07
6c595e7b8d206bad7b4b3f482be5f1023d43904c...e4c5f6ac97580fbb269c63549efd23a8e9b12447,1,107,0,107,1,2014-03-01 09:13:00,2014-03-01 09:13:00
9b2b61281043835263edbb031b5853d490cbf748...d8999c1300a710476d359d2c4b0c6362537bdc5e,1,7,0,7,1,2014-03-03 23:04:29,2014-03-03 23:04:29
d8999c1300a710476d359d2c4b0c6362537bdc5e...f6c766ae06b024b05c296d31194444c32c6994a8,13,244,230,474,46,2014-03-03 23:51:35,2014-02-28 22:06:09
f6c766ae06b024b05c296d31194444c32c6994a8...5e85c32ea6fa35c51781838cb15294027828a49f,5,11,12,23,8,2014-03-03 23:51:35,2014-02-28 22:55:23
5e85c32ea6fa35c51781838cb15294027828a49f...57f11cb96132c9ed35535e703885b562f33ab00c,16,70,91,161,62,2014-03-03 23:51:35,2014-03-03 21:30:25
57f11cb96132c9ed35535e703885b562f33ab00c...2e57a7439d2c9e96cb95f95cc660edb0437543b6,1,6,28,34,4,2014-03-04 19:23:56,2014-03-04 19:23:56
2e57a7439d2c9e96cb95f95cc660edb0437543b6...f302d25dc1b01647c6755322f8a79124560d7426,2,38,0,38,2,2014-03-04 23:32:19,2014-03-04 23:32:19
f302d25dc1b01647c6755322f8a79124560d7426...8d77b770fb7939d24f2a832eff88de3970d6e90b,2,13,3,16,2,2014-03-04 23:40:23,2014-03-04 23:40:23
8d77b770fb7939d24f2a832eff88de3970d6e90b...d27fa802b71403843c437efc9bd071a2ff091d37,6,41,36,77,31,2014-03-05 04:08:22,2014-03-05 04:08:22
cc7249985d00b85995b319560958fa5aecf5c1f4...63b13ff6650096c3ec213217d7f9327a6edbd3b8,1,13,2,15,2,2014-01-02 23:37:19,2014-01-02 23:37:19
63b13ff6650096c3ec213217d7f9327a6edbd3b8...b383f2cd6a20ab21a1957afe08c0c7e53c79ea48,2,41,27,68,16,2014-01-02 23:37:49,2014-01-02 23:37:49
b383f2cd6a20ab21a1957afe08c0c7e53c79ea48...e48f08cefc518f50de71383f623556bce445fe80,1,10,4,14,2,2014-01-03 00:46:23,2014-01-03 00:46:23
e48f08cefc518f50de71383f623556bce445fe80...cf78cefc8b71cc095887690e84780ee440f7d2f7,5,139,90,229,57,2014-01-03 01:34:04,2014-01-03 01:34:04
cf78cefc8b71cc095887690e84780ee440f7d2f7...7d448eb0d880d6b2154954f092e2d1ed26babfa3,1,7,1,8,2,2014-01-03 01:58:07,2014-01-03 01:58:07
7d448eb0d880d6b2154954f092e2d1ed26babfa3...a1627071a7d0e42e9a716c1996994d864adf4da5,1,37,11,48,9,2014-01-03 05:41:49,2014-01-03 05:35:00
a1627071a7d0e42e9a716c1996994d864adf4da5...31d89599a72cb6d9583b19b5b3003abe083365cc,1,7,7,14,4,2014-01-03 05:41:49,2014-01-03 05:40:14
31d89599a72cb6d9583b19b5b3003abe083365cc...02aad697d7b22d01de904e97b56baa0244864233,1,1,2,3,1,2014-01-03 05:42:51,2014-01-03 05:42:51
02aad697d7b22d01de904e97b56baa0244864233...a8d1798e880256b0ea0374b75371e8d0df4488e1,1,4,4,8,1,2014-01-03 05:45:13,2014-01-03 05:45:13
a8d1798e880256b0ea0374b75371e8d0df4488e1...0f7e0b54ca30bf7867095a3b3ca1daa4c1d13559,3,10,8,18,5,2014-01-03 05:47:24,2014-01-03 05:47:24
0f7e0b54ca30bf7867095a3b3ca1daa4c1d13559...b2e3b08248b61328f4d373014aea8a52f8bf332d,4,82,95,177,29,2014-01-03 06:07:37,2014-01-03 06:07:37
b2e3b08248b61328f4d373014aea8a52f8bf332d...5c9e58f2af5b0304ef2fc6b603c3fab80bc45291,2,50,38,88,20,2014-01-03 06:38:50,2014-01-03 06:38:50
5c9e58f2af5b0304ef2fc6b603c3fab80bc45291...e3e9cca12a7f6786d154416482051047f2d49d4a,4,80,22,102,20,2014-01-03 07:00:18,2014-01-03 07:00:18
e3e9cca12a7f6786d154416482051047f2d49d4a...2063999ce05df92bad420ebb63e6db5cd56b4fa2,2,16,8,24,5,2014-01-03 07:36:26,2014-01-03 07:36:26
2063999ce05df92bad420ebb63e6db5cd56b4fa2...82739804b8a482f96d8fcee48954c61ea63a7a09,2,29,10,39,9,2014-01-03 07:49:51,2014-01-03 07:49:51
56229c9bc93804a92708840ddeb9916516bbdfe2...5e4607badb672807b5dad5bced5db72e6a53fec4,7,2387,1635,4022,56,2013-12-29 14:04:42,2013-12-29 14:04:42
5e4607badb672807b5dad5bced5db72e6a53fec4...db1278b296e47e5eca7084f921f0c456b4125839,1,1,0,1,1,2013-12-29 14:09:06,2013-12-29 14:09:06
db1278b296e47e5eca7084f921f0c456b4125839...aee56f0523f35fe2ea0eb94d0f8fddce50df1af3,5,202,123,325,75,2013-12-30 05:12:14,2013-12-30 05:12:14
aee56f0523f35fe2ea0eb94d0f8fddce50df1af3...4fc8c0d1f38bd7efe2ceaec4f032b55abd69ed7d,13,550,490,1040,145,2013-12-30 13:16:21,2013-12-30 13:16:21
4fc8c0d1f38bd7efe2ceaec4f032b55abd69ed7d...02227a79d2bd480bfff399ae221d14df7d05ad59,6,114,107,221,19,2013-12-30 13:39:14,2013-12-30 13:39:14
02227a79d2bd480bfff399ae221d14df7d05ad59...9db5fec7112adc3533392a89d4d23714eaa97e8a,13,590,596,1186,61,2013-12-30 14:11:04,2013-12-30 14:00:21
9db5fec7112adc3533392a89d4d23714eaa97e8a...95e39591657ee51d7e3f0056608cc969af29cff0,15,79,77,156,72,2013-12-30 14:20:49,2013-12-30 14:20:49
95e39591657ee51d7e3f0056608cc969af29cff0...5230e79c627959e4d27abb0185e505b1fe135040,3,4,8,12,5,2013-12-30 15:01:38,2013-12-30 14:26:59
5230e79c627959e4d27abb0185e505b1fe135040...16b9b23f310355898217e4bc98bdc446b46f3bf8,1,520,520,1040,41,2013-12-30 15:02:03,2013-12-30 15:02:03
16b9b23f310355898217e4bc98bdc446b46f3bf8...88ea71f4c2bc74d7a445ea8fd5a436a45f4ac923,8,29,29,58,26,2013-12-30 15:04:45,2013-12-30 15:04:45
88ea71f4c2bc74d7a445ea8fd5a436a45f4ac923...dbfecc184a5436a1c3f2ffc2d2dd3829b7ccc4e8,3,222,224,446,40,2013-12-30 23:44:21,2013-12-30 23:44:21
dbfecc184a5436a1c3f2ffc2d2dd3829b7ccc4e8...515213e536e19503cf0ff13a8c181944cc573bf5,3,23,2,25,11,2013-12-30 23:58:36,2013-12-30 23:58:36
515213e536e19503cf0ff13a8c181944cc573bf5...f7d795b969637c4eb6a130298af302b52f26d27e,1,4,4,8,4,2013-12-31 02:06:48,2013-12-31 02:06:48
f7d795b969637c4eb6a130298af302b52f26d27e...4ce06b9a91e295f0630a8bb50b9c11fc8a3c1791,8,108,114,222,60,2013-12-31 02:07:08,2013-12-31 02:07:08
4ce06b9a91e295f0630a8bb50b9c11fc8a3c1791...ddfbda704653024181a4467f8a41ce63e985c083,8,10,10,20,7,2013-12-31 02:41:35,2013-12-31 02:41:35
ddfbda704653024181a4467f8a41ce63e985c083...471e396ea712095db94dacd2562ee623e0f3b557,8,9,9,18,7,2013-12-31 02:50:07,2013-12-31 02:50:07
471e396ea712095db94dacd2562ee623e0f3b557...7b185ae42617498ab999dcbf5a0028c7954d6407,4,7,5,12,6,2013-12-31 02:55:48,2013-12-31 02:55:48
7b185ae42617498ab999dcbf5a0028c7954d6407...9951236f1ad50ff7395fa9025050e4157e529b1e,1,647,472,1119,132,2013-12-31 08:26:01,2013-12-31 08:24:37
9951236f1ad50ff7395fa9025050e4157e529b1e...6d66715d9870b06b28c54473641e381fcd47c98e,1,148,133,281,48,2013-12-31 10:09:56,2013-12-31 10:09:56
6d66715d9870b06b28c54473641e381fcd47c98e...3b5381d7bcd359294831d31e6f1c8411ff2a70af,1,195,168,363,38,2013-12-31 11:25:17,2013-12-31 11:25:17
3b5381d7bcd359294831d31e6f1c8411ff2a70af...b0d53e46e55e4f77c8e37efbaf56679f4bf50072,1,38,72,110,11,2013-12-31 11:32:01,2013-12-31 11:32:01
b0d53e46e55e4f77c8e37efbaf56679f4bf50072...dde0c00b127de3ba6b3bb632d0969bf06ee1cae8,3,213,105,318,21,2014-01-01 02:24:02,2014-01-01 02:21:29
dde0c00b127de3ba6b3bb632d0969bf06ee1cae8...608123d886f1ed848de42d8860bafe48eb4a0bff,10,693,348,1041,107,2014-01-02 19:26:51,2014-01-02 19:26:51
608123d886f1ed848de42d8860bafe48eb4a0bff...c6a9db450d1b3b50322bca83989688cd4fe2aab6,2,105,43,148,45,2014-01-02 20:33:23,2014-01-02 20:33:23
c6a9db450d1b3b50322bca83989688cd4fe2aab6...535cc9544685ef6370f460e29cb5c5b0e2a20510,4,73,43,116,31,2014-01-04 02:20:07,2014-01-04 02:20:07
535cc9544685ef6370f460e29cb5c5b0e2a20510...088d70da36c460a81d0eb25a06f68ca92dad4af8,8,1091,1073,2164,26,2014-01-04 04:36:13,2014-01-04 04:35:50
088d70da36c460a81d0eb25a06f68ca92dad4af8...63f5ec6388f31d267429db7340bae842dcd295ca,2,1,7,8,3,2014-01-04 06:03:18,2014-01-04 06:03:18
63f5ec6388f31d267429db7340bae842dcd295ca...75220055756dfebc202e8f95493b78a5044b093c,4,285,246,531,63,2014-01-04 12:08:54,2014-01-04 12:08:54
75220055756dfebc202e8f95493b78a5044b093c...4ccfa114c8c065f3ee373e009b4bb77e956b751a,4,43,40,83,16,2014-01-07 06:16:13,2014-01-07 06:16:13
4ccfa114c8c065f3ee373e009b4bb77e956b751a...dbe6edf11c92f973d628e44ddde71afc69e43da1,3,10,20,30,8,2014-01-07 06:28:29,2014-01-07 06:23:56
dbe6edf11c92f973d628e44ddde71afc69e43da1...f2a1d9c71c39f5d7c9dde67cb220daf3490b8c7d,5,7,8,15,6,2014-01-07 06:42:29,2014-01-07 06:42:29
f2a1d9c71c39f5d7c9dde67cb220daf3490b8c7d...9813345e1568f494682c5f59ecd168cb6d6e8baa,9,93,81,174,57,2014-01-07 07:30:19,2014-01-07 07:30:19
9813345e1568f494682c5f59ecd168cb6d6e8baa...a5658ade21ef83b2187d7d9c0e79a538b36f0fc8,4,21,28,49,14,2014-01-07 22:46:39,2014-01-07 22:46:39
a5658ade21ef83b2187d7d9c0e79a538b36f0fc8...be0a11802dfbe1cc0067eca0ea7a94ba9b3b7d5e,5,166,74,240,54,2014-01-08 00:55:58,2014-01-08 00:55:58
be0a11802dfbe1cc0067eca0ea7a94ba9b3b7d5e...04b2957670aa6aacfd99d32749d5607cd79d87d1,4,350,215,565,42,2014-01-08 02:52:59,2014-01-08 02:52:59
04b2957670aa6aacfd99d32749d5607cd79d87d1...a1decc47af58857ea76f1c251308b32b667e3f19,3,50,36,86,42,2014-01-08 03:04:48,2014-01-08 03:04:48
a1decc47af58857ea76f1c251308b32b667e3f19...8bded5c44fe014284f3d7fe03fd3b306cae32382,6,153,94,247,26,2014-01-08 06:58:00,2014-01-08 06:58:00
8bded5c44fe014284f3d7fe03fd3b306cae32382...b72a7e2e83340ca23da0d24bde4f701331a3d5b4,3,56,30,86,15,2014-01-08 07:19:32,2014-01-08 07:19:32
b72a7e2e83340ca23da0d24bde4f701331a3d5b4...054ab2da94a21273a9a36618c514d999b8f5a983,3,17,15,32,5,2014-01-08 07:50:25,2014-01-08 07:50:25
054ab2da94a21273a9a36618c514d999b8f5a983...b940e06006e6b0dbaa1e7bf04e884d8770b5de1f,6,136,63,199,30,2014-01-09 01:18:32,2014-01-09 01:18:32
b940e06006e6b0dbaa1e7bf04e884d8770b5de1f...8b7475a8a615d16a57db5301ec1bf5b8849ca98a,2,63,40,103,16,2014-01-09 02:14:04,2014-01-09 02:14:04
8b7475a8a615d16a57db5301ec1bf5b8849ca98a...1bf1c094ce7aed21c8244b3f06d56903dc7a6fe8,6,518,64,582,11,2014-01-09 10:47:17,2014-01-09 10:47:17
1bf1c094ce7aed21c8244b3f06d56903dc7a6fe8...ea14611031442185b746adddd2787d0b0d4827bd,1,1,1,2,1,2014-01-15 22:30:31,2014-01-15 22:30:31
ea14611031442185b746adddd2787d0b0d4827bd...1d39c2fb5e19895d872948077bf7fc8f5b783ffc,1,47,20,67,5,2014-01-16 18:36:59,2014-01-16 18:36:59
1d39c2fb5e19895d872948077bf7fc8f5b783ffc...aa68610b467f560b2024515b6d3ae52c958a9bdf,1,7,0,7,3,2014-01-16 18:42:54,2014-01-16 18:42:32
aa68610b467f560b2024515b6d3ae52c958a9bdf...4f5d1147719941843b90ea28fd1d58b4f94bb230,1,3,1,4,3,2014-01-16 18:43:58,2014-01-16 18:43:58
56229c9bc93804a92708840ddeb9916516bbdfe2...b196ba4800745e5d47e231aa1bb16c3c496633af,1,4,3,7,1,2013-12-20 19:06:27,2013-12-20 19:06:27
c0626667ec9439f571347ac2287ae70dccf8d474...d84fe821196185e87fa0f87d3d5d73078d705c70,1,13,0,13,2,2013-12-20 02:54:27,2013-12-20 02:54:27
5b017ece38bdac8704f228cc04f23ef55e5a0b7b...7710a77270d56dde0e979b5f3d182d237a3034c2,3,219,0,219,5,2014-01-03 00:56:31,2014-01-03 00:56:31
7710a77270d56dde0e979b5f3d182d237a3034c2...a6b3a431b2cd6d62f8d1a6a47fd03c90614c95ad,4,48,6,54,9,2014-01-04 01:27:17,2014-01-04 01:27:17
a6b3a431b2cd6d62f8d1a6a47fd03c90614c95ad...47596a28ad6c646da51ccd391f2e9b802076c4bb,1,7,1,8,3,2014-01-05 18:30:44,2014-01-05 18:30:44
47596a28ad6c646da51ccd391f2e9b802076c4bb...e04edf1ca0e0f2e6250c91dc86c63cf04eefb3d3,1,11,1,12,1,2014-01-06 01:29:01,2014-01-06 01:29:01
e04edf1ca0e0f2e6250c91dc86c63cf04eefb3d3...2577b87cb113e32ce07b745e3f09dfa7cc513570,1,1,1,2,1,2014-01-06 19:39:42,2014-01-06 19:39:42
2577b87cb113e32ce07b745e3f09dfa7cc513570...df0e4141934a1934dd0078f95b958021b1681c2d,6,133,105,238,44,2014-01-06 21:48:31,2014-01-06 21:48:31
df0e4141934a1934dd0078f95b958021b1681c2d...b42112e3e652920cb92fc53ed4d2a8005d840f00,4,7,3,10,4,2014-01-06 22:37:13,2014-01-06 22:37:13
b42112e3e652920cb92fc53ed4d2a8005d840f00...1f25f2a8244cd544f3a98e37b3610ae44f724f35,2,28,22,50,8,2014-01-06 23:01:15,2014-01-06 23:01:15
1f25f2a8244cd544f3a98e37b3610ae44f724f35...27118d4b5a81cddaff753b137b927fbf023621b7,1,14,2,16,1,2014-01-06 23:41:51,2014-01-06 23:40:57
27118d4b5a81cddaff753b137b927fbf023621b7...fe08fa74710c914b22adf54713ede159b6106761,2,23,2,25,2,2014-01-06 23:54:23,2014-01-06 23:54:23
fe08fa74710c914b22adf54713ede159b6106761...95130ad760967e0532c07a911fa51a8ef9e3af4e,1,15,17,32,5,2014-01-07 00:05:27,2014-01-07 00:05:20
95130ad760967e0532c07a911fa51a8ef9e3af4e...b9877c7a53383fee91ac3050714c41daa5ec7b82,1,6,0,6,1,2014-01-07 01:26:31,2014-01-07 01:25:57
b9877c7a53383fee91ac3050714c41daa5ec7b82...32b60177a197de9d1d8455305d502edf6cd47e79,1,0,6,6,1,2014-01-07 01:34:42,2014-01-07 01:34:34
32b60177a197de9d1d8455305d502edf6cd47e79...40d4d9cd847b29f55ec7b7fc9bb61eaeebb52a11,3,153,6,159,4,2014-01-07 05:25:40,2014-01-07 05:25:40
40d4d9cd847b29f55ec7b7fc9bb61eaeebb52a11...f50e0a4973173f582ac4362d9ade4e4f9720508c,1,47,44,91,8,2014-01-07 05:29:10,2014-01-07 05:29:10
f50e0a4973173f582ac4362d9ade4e4f9720508c...5ed450921da2cfeb105f75abeb621ac77d81c335,1,7,5,12,4,2014-01-07 05:38:39,2014-01-07 05:38:39
5ed450921da2cfeb105f75abeb621ac77d81c335...2e88f7a758f7ad5e951d5f2ed532750289b8bef8,3,170,68,238,38,2014-01-07 11:00:10,2014-01-07 10:59:52
5b017ece38bdac8704f228cc04f23ef55e5a0b7b...c017828cb81487516f56e03e1bb982673def1d19,1,16,0,16,2,2013-12-28 20:13:00,2013-12-28 20:13:00
c1396baedd85a6953698dbd05e5cc194be64dc21...8cec2d75ef99e30b6b8f890c22aecf26a23ba3c7,2,4,8,12,3,2013-11-13 22:09:22,2013-11-13 19:46:05
8cec2d75ef99e30b6b8f890c22aecf26a23ba3c7...0980ea3955d1b55bc58adcac421ae399687e84c1,2,63,58,121,13,2013-11-14 19:25:25,2013-11-14 19:13:07
0980ea3955d1b55bc58adcac421ae399687e84c1...6960293862b80eacbb3a02fd6c0e303b0ebb9ac6,2,13,24,37,8,2013-11-14 19:29:53,2013-11-14 19:29:53
6960293862b80eacbb3a02fd6c0e303b0ebb9ac6...47d92b7dd76dbdd93889c96e55c6a343b93d000e,2,24,13,37,8,2013-11-14 19:35:00,2013-11-14 19:35:00
47d92b7dd76dbdd93889c96e55c6a343b93d000e...b31d3fdeae3a118d948f203b96dafed58294e4a4,1,7,0,7,1,2013-11-14 19:37:18,2013-11-14 19:37:18
9368852bdcb783e4663fb9c1875c2d7dd5c3b938...411c6cf8f4868d1b7e1762a67213b0974a3e8818,6,13,9,22,9,2013-09-25 00:13:37,2013-09-23 21:58:21
411c6cf8f4868d1b7e1762a67213b0974a3e8818...fa4509f81b34cec8cbc5975491e0961800de7e1a,2,15,5,20,6,2013-09-25 00:13:37,2013-04-15 21:59:03
fa4509f81b34cec8cbc5975491e0961800de7e1a...d1cf1bd2e389e0ab8db80de5f9e48331241fb719,1,1,1,2,1,2013-09-25 00:13:37,2013-09-24 02:30:32
d1cf1bd2e389e0ab8db80de5f9e48331241fb719...5f146a9d72392809488f1b04ba42f35c66a9bc63,1,34,55,89,11,2013-09-25 00:13:38,2013-09-24 06:29:34
5f146a9d72392809488f1b04ba42f35c66a9bc63...dd7172ab7fc7141b68b766cf5c600efb0dde2739,1,5,1,6,1,2013-09-25 00:13:38,2013-09-24 07:35:15
dd7172ab7fc7141b68b766cf5c600efb0dde2739...ca1fb6788abbc03cf5f3f5265c71a716c5a248c0,1,27,0,27,3,2013-09-25 00:13:38,2013-09-25 00:12:39
ca1fb6788abbc03cf5f3f5265c71a716c5a248c0...6c1f92e89156e529b2da3555d65eb9094ff4e9d9,5,6,6,12,6,2013-09-25 06:31:47,2013-09-25 06:31:47
6c1f92e89156e529b2da3555d65eb9094ff4e9d9...25aae35422c668e14bb02faf069cf52f3b0f500e,1,1,1,2,1,2013-09-25 08:57:50,2013-09-25 08:57:50
9368852bdcb783e4663fb9c1875c2d7dd5c3b938...99b9ec2da5a75c954fa5b6b73361b0176869d29e,3,60,6,66,6,2013-09-25 00:10:29,2013-09-25 00:10:29
99b9ec2da5a75c954fa5b6b73361b0176869d29e...41247305db798cab408f85b57e88a1efd254fefa,3,126,4,130,5,2013-09-25 00:59:59,2013-09-25 00:59:59
41247305db798cab408f85b57e88a1efd254fefa...220676600e904507910bde0c2cd9ddc286b74450,3,97,29,126,12,2013-09-25 02:06:27,2013-09-25 02:05:32
220676600e904507910bde0c2cd9ddc286b74450...0e988fcf5a1acebcdbdca347cd721e5a4a542743,1,14,0,14,1,2013-09-25 02:13:01,2013-09-25 02:13:01
d1be6dde3560207dad2adce588d20bfc0553ee03...bd73b312554563145cfaa240b288e6e99919c2d8,1,2,0,2,1,2013-09-24 17:48:55,2013-09-24 17:48:55
bd73b312554563145cfaa240b288e6e99919c2d8...33153624f69bf85af90c6642075c0e01c904a200,3,36,3,39,4,2013-09-24 19:00:26,2013-09-24 19:00:15
d9215a640bb527f6da8d7ab3bbf27a95373fddab...3d29f1f018fac39fdd8faf6b816c91459daf32f3,1,2,2,4,2,2013-12-11 00:54:12,2013-12-11 00:54:12
3d29f1f018fac39fdd8faf6b816c91459daf32f3...740e0ff1a03decc2ed672ab1c7334d28e78233c6,1,4,1,5,1,2013-12-11 00:54:24,2013-12-11 00:54:24
740e0ff1a03decc2ed672ab1c7334d28e78233c6...71fbcb4f28ddecdb8c228ccb2c563fddc4464a55,1,3,1,4,1,2013-12-11 01:01:13,2013-12-11 01:01:13
71fbcb4f28ddecdb8c228ccb2c563fddc4464a55...2cb44c898f232052a1bc9777a955c4bee98bbf13,1,15,1,16,1,2013-12-11 02:26:38,2013-12-11 02:26:38
d9215a640bb527f6da8d7ab3bbf27a95373fddab...a74e3517056e526c00938f68028b24a506d62e20,4,146,21,167,17,2013-12-07 03:10:15,2013-11-30 09:28:08
a74e3517056e526c00938f68028b24a506d62e20...c3c86a1b304ca1f0dd9f32159f05a024923547f9,1,14,11,25,3,2013-12-07 03:10:15,2013-11-30 10:15:00
c3c86a1b304ca1f0dd9f32159f05a024923547f9...107485d6998e4d716a31e305671ddcf0b044646b,1,1,1,2,1,2013-12-07 03:10:16,2013-11-30 10:18:49
107485d6998e4d716a31e305671ddcf0b044646b...a95f9eb48079c7914225e7f6893421110722f883,6,714,379,1093,91,2013-12-07 03:22:10,2013-12-01 12:33:56
a95f9eb48079c7914225e7f6893421110722f883...d897249251d9cb3edffdd2e047087e403dd8ebb6,1,15,2,17,3,2013-12-07 03:22:17,2013-12-06 07:17:44
d897249251d9cb3edffdd2e047087e403dd8ebb6...48b44f33e1c4db292d2add319990ae1c22180580,12,171,113,284,48,2013-12-07 03:22:17,2013-12-06 10:37:58
48b44f33e1c4db292d2add319990ae1c22180580...5e1299f48f4744e6e4a55ea1732362618ab319cc,1,3,5,8,5,2013-12-07 05:57:25,2013-12-07 05:57:25
5e1299f48f4744e6e4a55ea1732362618ab319cc...89d6260a848e6e10f0a3b3efabe695d9069602a2,3,57,0,57,6,2013-12-08 04:20:53,2013-12-08 04:20:24
89d6260a848e6e10f0a3b3efabe695d9069602a2...d168857ab67d87341a859fea572369cc1594a94f,5,117,30,147,28,2013-12-08 13:58:08,2013-12-08 13:58:08
d168857ab67d87341a859fea572369cc1594a94f...cbafd31eae261c49aaf541b986dd3adee66b2b61,1,7,9,16,3,2013-12-09 07:54:14,2013-12-09 07:54:14
cbafd31eae261c49aaf541b986dd3adee66b2b61...3f849d5c6400803b49359d598cdb982b501877d2,1,1,1,2,1,2013-12-09 07:54:44,2013-12-09 07:54:44
3f849d5c6400803b49359d598cdb982b501877d2...14337d416c46d5cc70225857870b67e9e23ceeec,3,82,60,142,11,2013-12-09 12:18:54,2013-12-09 12:18:54
14337d416c46d5cc70225857870b67e9e23ceeec...9d90a453cb4eb50d64b13f951d268d1ceae62fdd,2,2,4,6,5,2013-12-09 18:01:53,2013-12-09 18:01:53
9d90a453cb4eb50d64b13f951d268d1ceae62fdd...dab8795459893c3c40694b3fd034ac9f5e9e95e8,1,210,66,276,9,2013-12-10 07:21:13,2013-12-10 07:21:13
dab8795459893c3c40694b3fd034ac9f5e9e95e8...95667c3a103b89198e4bf051fe4acce701c9c25b,1,41,8,49,13,2013-12-11 00:57:46,2013-12-11 00:57:46
95667c3a103b89198e4bf051fe4acce701c9c25b...0ff03113f43c00cd86a1517f2a294ad0107e5870,1,48,69,117,18,2013-12-11 01:10:16,2013-12-11 01:09:24
0ff03113f43c00cd86a1517f2a294ad0107e5870...de55d6264580d0448776bc4985fb387b9d059593,1,17,12,29,11,2013-12-11 04:16:58,2013-12-11 04:16:58
de55d6264580d0448776bc4985fb387b9d059593...ff4e229b4a6b3ba21a375e7bc5762c4924501cbc,1,47,32,79,30,2013-12-11 04:53:21,2013-12-11 04:53:21
ff4e229b4a6b3ba21a375e7bc5762c4924501cbc...410a585d7628b86478794fccce96cea399be060e,5,325,130,455,41,2013-12-11 12:26:01,2013-12-11 12:26:01
410a585d7628b86478794fccce96cea399be060e...7d7474aacb1943d0dc93f5ad912142b8529d20fe,1,3,2,5,2,2013-12-11 12:51:21,2013-12-11 12:51:21
7d7474aacb1943d0dc93f5ad912142b8529d20fe...f590c2567a69b6aade6b107ca23789d6c100a87b,1,4,1,5,1,2013-12-11 13:54:47,2013-12-11 13:54:47
f590c2567a69b6aade6b107ca23789d6c100a87b...ad680517eed36aec340a9bb5d4523ef8d10a7e0d,1,0,5,5,1,2013-12-11 13:57:20,2013-12-11 13:57:20
a2b0ffff1b39a6975426f07e912ab226e74c1098...7d25bd1f87f2156899ff54695d0863bce40d1bb8,10,121,53,174,17,2013-11-19 09:34:53,2013-11-07 19:55:00
7d25bd1f87f2156899ff54695d0863bce40d1bb8...e48fa460bc0aca50b3af7fc4d1b24123c2f08f90,5,103,91,194,12,2013-11-19 09:34:53,2013-11-07 22:05:07
e48fa460bc0aca50b3af7fc4d1b24123c2f08f90...a741726dfcd0bda1cbd80b337af6624683a08cac,1,1,2,3,1,2013-11-19 09:34:53,2013-11-07 22:18:17
a741726dfcd0bda1cbd80b337af6624683a08cac...cbc28e1c7ff70db19a73c162ead567629608f73a,3,42,9,51,8,2013-11-19 09:34:53,2013-11-08 17:55:01
cbc28e1c7ff70db19a73c162ead567629608f73a...d8935bdbcb00f1b403293a3087d6af8648ffecd4,2,90,5,95,2,2013-11-19 09:34:53,2013-11-08 18:47:36
d8935bdbcb00f1b403293a3087d6af8648ffecd4...572fc333c7251f0ff1be2668f9ba80c31abe8936,4,32,10,42,7,2013-11-19 09:34:53,2013-11-08 20:46:21
572fc333c7251f0ff1be2668f9ba80c31abe8936...e27e2d8c828257a2dbe39b4b8bcd8a8e32eaf2bd,5,168,140,308,18,2013-11-19 09:34:53,2013-11-11 21:50:59
e27e2d8c828257a2dbe39b4b8bcd8a8e32eaf2bd...456e6916be799c004590ef710748b6125f9ebcb5,3,16,21,37,9,2013-11-19 09:34:53,2013-11-11 23:03:55
456e6916be799c004590ef710748b6125f9ebcb5...6239d388efa3dc700093df631f3dbea9dd583894,4,77,58,135,10,2013-11-19 09:34:53,2013-11-12 15:59:37
6239d388efa3dc700093df631f3dbea9dd583894...78b9a47fcb75a7662b1012524b62de950a8052bc,1,1,1,2,1,2013-11-19 09:34:54,2013-11-12 16:28:14
78b9a47fcb75a7662b1012524b62de950a8052bc...8c0e02635b7be2119e098360d20ac5bf474d92ec,2,63,1,64,5,2013-11-19 09:34:54,2013-11-12 20:15:09
8c0e02635b7be2119e098360d20ac5bf474d92ec...8d3929e450c686fe176074491a588935913c1d91,1,3,3,6,1,2013-11-19 09:34:54,2013-11-12 20:23:40
8d3929e450c686fe176074491a588935913c1d91...15f5ca3d7e17510db991547cdc02b6bd8881e7d8,3,8,19,27,7,2013-11-19 09:34:54,2013-11-13 20:57:30
15f5ca3d7e17510db991547cdc02b6bd8881e7d8...a2c4a787430617387c83e87f13a3498acef87b45,5,23,7,30,7,2013-11-19 09:34:54,2013-11-13 21:32:51
a2c4a787430617387c83e87f13a3498acef87b45...005e4a2e85e9725a697e8c3321acd16535a46c69,1,0,2,2,1,2013-11-19 09:34:54,2013-11-13 21:42:33
005e4a2e85e9725a697e8c3321acd16535a46c69...22f9183c6b5e7a827e9a266ebafb2fbb2128f4ce,2,1,3,4,2,2013-11-19 09:34:54,2013-11-14 19:45:18
22f9183c6b5e7a827e9a266ebafb2fbb2128f4ce...3245f0d9d679f78b8b65a5066266e29ed7658c8c,1,4,0,4,1,2013-11-19 09:34:54,2013-11-14 20:02:06
3245f0d9d679f78b8b65a5066266e29ed7658c8c...4951520d55c8ac3d32978b680492f8f49e766658,1,7,1,8,2,2013-11-19 10:16:48,2013-11-19 10:16:48
4951520d55c8ac3d32978b680492f8f49e766658...32000d4c5eef81a3bd12ecb661cc6d1285fd3a40,2,8,3,11,2,2013-11-19 10:20:47,2013-11-19 10:20:47
097b26151872db16261c6ece19bc3129851c03cf...8202e86a6ae9e0cc79b0aa41a82aa44d054ec89f,1,2,0,2,1,2013-08-01 02:25:44,2013-08-01 02:25:44
097b26151872db16261c6ece19bc3129851c03cf...49105c337aa9f81d8e3839803a6d7b83c93df2ba,2,44,4,48,5,2013-07-31 10:22:07,2013-07-31 09:50:30
44aa79120f787b34f42ac84b176a8f126392beb5...235ff2e285579ba6f6fcf4bf99a8b0c58a14b80b,1,159,82,241,16,2013-08-02 17:40:04,2013-08-02 17:39:21
235ff2e285579ba6f6fcf4bf99a8b0c58a14b80b...cb0b888bc5a4dcc41d738fb655b9f190260db361,1,1,1,2,1,2013-08-02 21:05:09,2013-08-02 21:05:09
cb0b888bc5a4dcc41d738fb655b9f190260db361...c0014dfda9069d971072a5bf3ff2bbe5bde48c3e,1,31,18,49,6,2013-08-02 22:40:39,2013-08-02 22:40:33
c0014dfda9069d971072a5bf3ff2bbe5bde48c3e...cc2123f5a989f9d8bae8f6ca9fe9e1911756e1c0,6,91,9,100,10,2013-08-06 00:33:27,2013-08-06 00:33:27
cc2123f5a989f9d8bae8f6ca9fe9e1911756e1c0...41e2b8ec767b54d4704e027190d29ee8e2511cb9,1,5,6,11,2,2013-08-06 22:21:25,2013-08-06 22:21:25
41e2b8ec767b54d4704e027190d29ee8e2511cb9...f896cda673dc1e32d03fe5ea7ede99b232cbfb90,1,3,3,6,3,2013-08-06 22:21:57,2013-08-06 22:21:57
f896cda673dc1e32d03fe5ea7ede99b232cbfb90...aac5a0c5d8ec07d661ff05a7a15df2dc6f53b153,9,212,61,273,18,2013-08-12 20:41:33,2013-08-07 18:31:40
aac5a0c5d8ec07d661ff05a7a15df2dc6f53b153...fe63aa08f9e2ca710ba8577b27e87d1d7163274b,1,21,9,30,5,2013-08-12 20:41:33,2013-08-07 23:40:31
fe63aa08f9e2ca710ba8577b27e87d1d7163274b...e1e2bc19c803ea79f3d43d40c4cbe5a8360e03e9,3,7,1,8,4,2013-08-12 20:41:33,2013-08-07 23:41:04
e1e2bc19c803ea79f3d43d40c4cbe5a8360e03e9...13246407585a6f2a2e58c1a1643246263421674f,1,5,5,10,3,2013-08-12 20:42:16,2013-08-08 06:26:23
13246407585a6f2a2e58c1a1643246263421674f...32fdb184fb99f99d28874f4d5701b0425b58e1de,2,2,2,4,2,2013-08-12 20:42:22,2013-08-08 06:40:44
32fdb184fb99f99d28874f4d5701b0425b58e1de...90aea32a75781412d54f2aa105855359b0c2345b,7,177,172,349,22,2013-08-12 20:48:51,2013-08-08 16:58:40
90aea32a75781412d54f2aa105855359b0c2345b...b5e483f0f88417fbd86b17e5e33b580de39a74aa,3,8,10,18,3,2013-08-12 20:48:53,2013-08-08 17:02:14
b5e483f0f88417fbd86b17e5e33b580de39a74aa...04dc8bd67eccb7f8c3254ee40ba8cc90f2956776,1,18,14,32,4,2013-08-12 20:48:53,2013-08-08 22:32:12
04dc8bd67eccb7f8c3254ee40ba8cc90f2956776...74232c0d7bc9f1758610604526a48cbb06ea10a8,1,14,7,21,6,2013-08-12 20:49:16,2013-08-08 22:33:01
74232c0d7bc9f1758610604526a48cbb06ea10a8...838cd5ce0696d0002a1c1f456bd69c66c2a3cc4a,2,15,8,23,5,2013-08-12 20:49:18,2013-08-08 23:06:12
838cd5ce0696d0002a1c1f456bd69c66c2a3cc4a...241b51b47e5405c720e9e00b12b54b407eadd647,1,1,0,1,1,2013-08-12 20:49:18,2013-08-08 23:14:10
241b51b47e5405c720e9e00b12b54b407eadd647...c55cba9962498b62d1116711d3b00f6143ef0f57,6,95,12,107,18,2013-08-12 21:07:29,2013-08-08 23:31:18
c55cba9962498b62d1116711d3b00f6143ef0f57...3e7b7e040ed79b920ef6df828e107d121eb62c4b,1,12,1,13,1,2013-08-12 21:07:41,2013-08-12 20:36:45
3e7b7e040ed79b920ef6df828e107d121eb62c4b...f5e36e146338208dc7841c169876c3c8cf07cc9c,1,0,2,2,1,2013-08-12 21:07:41,2013-08-12 21:05:03
f5e36e146338208dc7841c169876c3c8cf07cc9c...435cd81c1dc5970ac53acfc18fd8195105a82c33,1,1,1,2,1,2013-08-13 03:02:49,2013-08-13 03:02:49
de6543b7124ef2e32813e15fb8926a5065f90750...debbaa2db2375836aa3a00bf0ffd3407942607fc,2,19,3,22,3,2013-05-30 18:49:28,2013-05-30 18:49:28
debbaa2db2375836aa3a00bf0ffd3407942607fc...d27a3b4aa6beae7e51d7a8c35b85ec02c4487b44,2,2,2,4,2,2013-05-30 18:53:36,2013-05-30 18:53:36
248139c2bcd2e90134e7b1b76e8c305aafa5ec35...7864aa77a1303ec23fd37f20ca7bcb9548962b86,1,37,10,47,10,2013-10-04 02:46:10,2013-10-04 02:46:10
7864aa77a1303ec23fd37f20ca7bcb9548962b86...6a836cca941b3638f827f2b694d84f614610ca0b,1,4,73,77,3,2013-10-04 16:31:58,2013-10-04 16:31:58
6a836cca941b3638f827f2b694d84f614610ca0b...94c7833c82ac6ab62c36b4a39ee315199233aef9,5,7,156,163,8,2013-10-04 16:46:48,2013-10-04 16:46:48
94c7833c82ac6ab62c36b4a39ee315199233aef9...95d8bde496898d25e1a8ff80b4b34bf16bec9e61,1,2,0,2,1,2013-10-04 16:52:00,2013-10-04 16:52:00
95d8bde496898d25e1a8ff80b4b34bf16bec9e61...6fcff6d85d0eea6397c6084a26d932797522a050,2,19,0,19,3,2013-10-04 19:41:45,2013-10-04 19:41:45
6fcff6d85d0eea6397c6084a26d932797522a050...38ed624909a8ec0857178033f5dff595cce16086,1,6,1,7,1,2013-10-04 19:46:17,2013-10-04 19:46:17
38ed624909a8ec0857178033f5dff595cce16086...52e59350dba4add4df4e2490f82878127f299288,1,15,16,31,4,2013-10-04 19:47:16,2013-10-04 19:47:16
3798826ac2fb87efa49684a6ed6345e6767790de...c4b1e6b32453f30a5dc55df47dbc15b4e9434f4c,2,4,3,7,2,2013-10-08 23:31:36,2013-10-08 23:31:36
c4b1e6b32453f30a5dc55df47dbc15b4e9434f4c...0be428b7311eed1687d16d5304c9de249e33efe4,1,2,3,5,3,2013-10-09 00:14:32,2013-10-09 00:14:32
0be428b7311eed1687d16d5304c9de249e33efe4...93c23470aabc9cc6b467bd06e75a32da401cd030,4,8,4,12,4,2013-10-09 02:58:48,2013-10-09 02:58:48
93c23470aabc9cc6b467bd06e75a32da401cd030...57c87a403d15cfeeb2c326318f1e19b5c7ece11e,7,7,7,14,7,2013-10-09 03:03:02,2013-10-09 03:03:02
57c87a403d15cfeeb2c326318f1e19b5c7ece11e...1214eec099d4b77556d2263b0031f8faaf5b964b,6,6,6,12,6,2013-10-09 06:34:43,2013-10-09 06:34:43
1214eec099d4b77556d2263b0031f8faaf5b964b...31669c7dd53150db0e9fbfb67b6fed526c44cd08,1,1,1,2,1,2013-10-09 16:58:08,2013-10-09 08:38:22
31669c7dd53150db0e9fbfb67b6fed526c44cd08...5453ca480e5c2933fbadf3dad795ef984fbd7eb4,2,2,1,3,2,2013-10-09 16:58:57,2013-10-09 16:58:57
5453ca480e5c2933fbadf3dad795ef984fbd7eb4...008b46ac49735577c05a18f0c56252b37fdea486,1,37,32,69,14,2013-10-10 03:38:58,2013-10-10 03:38:58
008b46ac49735577c05a18f0c56252b37fdea486...b9562447bd5e676d237dd7a80f13b7b3c2783a1b,2,8,3,11,3,2013-10-10 03:58:03,2013-10-10 03:58:03
b9562447bd5e676d237dd7a80f13b7b3c2783a1b...82067795f620530bad162d1c431110799ceaa5f8,1,3,4,7,1,2013-10-10 19:45:40,2013-10-10 19:44:36
82067795f620530bad162d1c431110799ceaa5f8...f1ca859790556e1a7c8a31b99f48c26e3a094200,1,2,0,2,1,2013-10-10 19:45:40,2013-10-10 19:45:22
f1ca859790556e1a7c8a31b99f48c26e3a094200...06b9beab3afdd5706c3a0c8742f78351fa077f96,5,5,5,10,5,2013-10-10 19:45:40,2013-10-10 19:44:18
06b9beab3afdd5706c3a0c8742f78351fa077f96...3733ab1c72b46bad0044cf9e85eec98273aca834,1,2,1,3,2,2013-10-10 19:58:05,2013-10-10 19:58:05
8d9854fd5d87f05655d52e179282c00a46a1beb8...54b756782c5d76d7265ec0dbdf8b03cc48e8e743,1,0,2,2,1,2013-03-26 21:45:35,2013-03-25 13:35:53
358b13fbb9b79a78ba89b262b755b47fa6d6e632...124d05488b76c0cba03df14765a263297b80a1d1,3,451,206,657,175,2013-02-13 00:32:07,2013-02-13 00:32:07
b6501d4ebe4b191731c860cd3defa33ee2ae2fb7...a9f65f0759ba87ab0eae86028f851e562757d6f7,1,1,1,2,1,2014-04-22 01:45:21,2013-05-12 20:43:27
a9f65f0759ba87ab0eae86028f851e562757d6f7...3740d42f2d3aef3ab3d3882358ee278afcdf38d3,1,5,0,5,1,2014-04-22 01:50:44,2014-04-22 01:50:44
3740d42f2d3aef3ab3d3882358ee278afcdf38d3...ce201682f0efaf48104082ad8e628a615d9ec385,1,8,0,8,1,2014-04-22 02:17:51,2014-04-22 02:17:46
ce201682f0efaf48104082ad8e628a615d9ec385...3229f24ad029867de35d7300e4c56df19c09ff34,2,13,3,16,3,2014-04-22 02:28:21,2014-04-22 02:27:27
c918bae9ab292567255d9dac0eac78838f58eb8e...241ba37f6672a4f5917184d17a8050e16b1f923b,1,5,1,6,1,2014-04-01 01:41:24,2014-04-01 01:41:24
241ba37f6672a4f5917184d17a8050e16b1f923b...3e76ad794659208307c5534b1ae00ef59abec1d3,9,17,10,27,9,2014-04-01 02:52:02,2014-04-01 02:46:41
3e76ad794659208307c5534b1ae00ef59abec1d3...d287d36bac859391c66dd06d2bb0a191e4fd4688,1,2,0,2,2,2014-04-01 03:03:01,2014-04-01 03:03:01
d287d36bac859391c66dd06d2bb0a191e4fd4688...f36abc946e6623881274e90769e8ff8ef953e52e,2,95,53,148,13,2014-04-02 00:21:24,2014-04-02 00:21:24
f36abc946e6623881274e90769e8ff8ef953e52e...e91fea7512584fdf4efa7eb7e17199179904b1db,10,0,4156,4156,10,2014-04-02 16:56:33,2014-04-01 22:20:08
e91fea7512584fdf4efa7eb7e17199179904b1db...6454067e66d6bf4958ba466d44542db138e149d7,5,10,5,15,5,2014-04-02 16:56:33,2014-04-01 22:20:32
6454067e66d6bf4958ba466d44542db138e149d7...f05e93afdedaade530a609d5ef6e99af6c0e04cc,2,24,13,37,7,2014-04-02 18:52:58,2014-03-31 23:56:38
f05e93afdedaade530a609d5ef6e99af6c0e04cc...a61dd5c9f346a82ade5a0106fb55411c38b6ad6c,2,8,5,13,3,2014-04-03 02:38:33,2014-03-20 20:58:24
a61dd5c9f346a82ade5a0106fb55411c38b6ad6c...82aa3485acfa7ed25bbab3d5ba2b53a67e2e9893,2,10,8,18,3,2014-04-03 03:27:54,2014-04-03 02:43:29
82aa3485acfa7ed25bbab3d5ba2b53a67e2e9893...34056440275394c97880ca7083aa5eb3fb116d78,4,73,6,79,11,2014-04-03 04:16:59,2014-04-03 04:01:35
34056440275394c97880ca7083aa5eb3fb116d78...8805281798753e044f5487c2da2c3d3aec6acf87,1,13,3,16,4,2014-04-03 16:26:46,2014-04-03 16:26:42
c918bae9ab292567255d9dac0eac78838f58eb8e...b2193f5fa7385e0fb31299853283546141799d8d,2,5,3,8,4,2014-03-31 09:09:32,2014-03-31 09:09:32
b2193f5fa7385e0fb31299853283546141799d8d...c9f0f10130c29aa32ece6443926a625a0c661eae,2,34,0,34,2,2014-04-11 09:26:18,2014-04-11 09:26:18
10b5c88f4ed004c2de4bc10f5fccc33a0d28d8ae...cb80bb9f0dc960b3c2c7b5442f65d984185a52e4,2,4,1,5,2,2014-03-26 21:27:46,2014-03-26 21:27:13
cb80bb9f0dc960b3c2c7b5442f65d984185a52e4...f0d6c15583929bf437cd9f61278d3339ccf79999,1,2,1,3,1,2014-03-26 21:38:11,2014-03-26 21:38:11
83230f55bb63eacf2d19e1e8e4a6512932f7d4a2...b6a51bc54f8ef5bddb9435301029b47f11680df7,50,103,9083,9186,45,2014-03-26 21:22:35,2014-03-26 21:22:35
5b4ecd9a71a6e59e6d4a15fbecba9fd2636ae31f...2e66a7f1a05d59e043a269bd20fd07aa5bfeab12,2,40,104,144,12,2014-03-21 16:03:20,2014-02-15 00:15:35
2e66a7f1a05d59e043a269bd20fd07aa5bfeab12...b79294a690c91b1ce3f97695b8a0bff3845ae1a9,1,9,6,15,8,2014-03-21 16:03:20,2014-03-18 17:07:09
b79294a690c91b1ce3f97695b8a0bff3845ae1a9...b3e342ec7ef6d248dd5a00fca086d7d94cb54cc0,1,0,1,1,1,2014-03-21 16:03:20,2014-03-20 04:31:11
b3e342ec7ef6d248dd5a00fca086d7d94cb54cc0...051faf8895c15bbd6bb192ae3f3f200306e67e91,1,19,2,21,1,2014-03-21 16:03:21,2014-03-20 05:01:48
051faf8895c15bbd6bb192ae3f3f200306e67e91...efd044a00429bd7891d6428b617c28a732468e53,1,31,5,36,6,2014-03-21 16:03:21,2014-03-20 05:02:13
efd044a00429bd7891d6428b617c28a732468e53...e999ac782e2ecdcbaddf1798468a9a38aecf2832,1,20,15,35,7,2014-03-21 16:14:41,2014-03-21 16:14:41
89a96084b864b2bdc64f16a95baa03f4796412bc...f933b7f97f3b8ae36e75a368dbfc22de28d8e5c8,1,4,4,8,2,2014-03-03 03:12:03,2014-03-03 02:30:26
f933b7f97f3b8ae36e75a368dbfc22de28d8e5c8...a2d73ca9bfcd319dec905f35f157d74a73328093,1,4,4,8,2,2014-03-03 23:35:43,2014-03-03 23:35:43
a2d73ca9bfcd319dec905f35f157d74a73328093...06267daa93f95b1be99c1e5685d9a3d7d9350974,1,7,0,7,1,2014-03-04 04:55:37,2014-03-04 04:55:37
06267daa93f95b1be99c1e5685d9a3d7d9350974...e356c23fdbc114e3662e1938c4d91494bf8ad368,1,3,0,3,1,2014-03-04 05:11:57,2014-02-24 20:08:30
e356c23fdbc114e3662e1938c4d91494bf8ad368...f97b00f7ee7d2cb6592b4d69ead9cd68173c4b28,1,1,1,2,1,2014-03-04 05:13:51,2014-03-04 05:13:51
f97b00f7ee7d2cb6592b4d69ead9cd68173c4b28...51148c84df8285b0e44ed7bbcd53063fe61f9b18,2,135,89,224,38,2014-03-04 05:21:39,2014-02-24 21:55:36
d50049777fb3c0500da2ea2484173fa8bcfbc086...94f5efc893a482dc82472e3ce09ffd38b2e06363,1,2,1,3,1,2014-02-28 22:49:25,2014-02-28 22:49:25
94f5efc893a482dc82472e3ce09ffd38b2e06363...811f831ddcc65a106c97a13dc7787d274eacf70f,4,108,1,109,5,2014-02-28 23:28:55,2014-02-28 23:28:55
d50049777fb3c0500da2ea2484173fa8bcfbc086...83b67094ea81e27f945dd136b5e49ce954ddceb6,2,13,6,19,8,2014-02-28 20:02:37,2014-02-28 20:02:37
83b67094ea81e27f945dd136b5e49ce954ddceb6...c742c2590930494ec4a97c161a7e2323abb150e5,1,1,1,2,1,2014-02-28 22:53:46,2014-02-28 22:53:46
c742c2590930494ec4a97c161a7e2323abb150e5...e462df2e726bcf0e4a12e07f8ac690a7f0fcfff0,2,109,79,188,22,2014-03-04 19:34:26,2014-03-04 19:34:26
084ee3bf4fb2e58af8717fa1e09e43b43399f3b2...cf4d9ad175e05b2825f737d217bc89801c4ae104,1,1,1,2,1,2014-03-07 00:51:26,2014-03-07 00:51:26
cf4d9ad175e05b2825f737d217bc89801c4ae104...c04fb531561f5cb698dec21189a1b6f79dab6a98,1,4,2,6,1,2014-03-07 00:52:00,2014-03-07 00:52:00
feac6f03e33c960c08e1cdfba6a965b685370ac8...4f7d14c1f29088fbe1eb26bd22e5ba0d7aac5385,1,1,1,2,1,2014-01-04 01:19:59,2014-01-04 01:19:59
b296dcbdf28c846ad6d62686b9e13f81973e44d4...83fde36e00fb4cf17145b2045e2f61ec04dc61e7,1,15,4,19,3,2014-01-03 02:23:56,2014-01-03 02:23:34
83fde36e00fb4cf17145b2045e2f61ec04dc61e7...85d8d5300c8a548f99d199a918f4c86d129c81fa,1,22,9,31,1,2014-01-03 21:42:02,2014-01-03 21:27:14
85d8d5300c8a548f99d199a918f4c86d129c81fa...f4e3a08baeecc9a5e0febab3aa58a9c9bc4c0295,1,15,4,19,3,2014-01-03 22:31:18,2014-01-03 22:31:18
44341f4ff9fc8d52cfca5dc1eb20ccf234f787bd...be96c4a11083033747232fd9c3254326d9fda6af,1,2,2,4,2,2014-01-16 19:00:04,2014-01-16 19:00:04
be96c4a11083033747232fd9c3254326d9fda6af...01e211fc05c8081665198915df46556040304f60,2,28,30,58,7,2014-01-21 01:44:16,2014-01-16 19:24:37
01e211fc05c8081665198915df46556040304f60...ac52f0eaf4a0a2ea8466b94d323cb8b05a7118a4,1,83,9,92,20,2014-01-21 01:44:47,2014-01-21 01:44:47
ac52f0eaf4a0a2ea8466b94d323cb8b05a7118a4...0c69701a321af2d4066509d0a00e98838b87a512,4,61,22,83,20,2014-01-22 10:54:10,2014-01-22 10:54:10
0c69701a321af2d4066509d0a00e98838b87a512...abb54f7ec0aacf5fdfc61a60699c802add3488ba,4,116,81,197,10,2014-01-22 22:15:24,2014-01-22 22:15:24
abb54f7ec0aacf5fdfc61a60699c802add3488ba...539024c771f8e96cdd47bfb5088685a5bd25c6c0,5,77,26,103,19,2014-01-22 23:23:19,2014-01-22 23:23:19
539024c771f8e96cdd47bfb5088685a5bd25c6c0...a88ee7f84dcc063ae48d3b645c48bd4f27c2a03e,4,87,15,102,12,2014-01-24 02:16:19,2014-01-24 02:16:19
a88ee7f84dcc063ae48d3b645c48bd4f27c2a03e...bb7369314b9af3a1c60f7ab26767d374b82ba791,8,261,57,318,37,2014-01-24 04:02:35,2014-01-24 04:02:35
bb7369314b9af3a1c60f7ab26767d374b82ba791...826a035c1f2f1499200da87bd33fa06f0aab922c,6,159,10,169,18,2014-01-24 04:57:50,2014-01-24 04:57:50
826a035c1f2f1499200da87bd33fa06f0aab922c...b460fe8029230f7838cce2075af1990754f4da8e,3,219,131,350,46,2014-01-24 07:33:28,2014-01-24 07:33:28
b460fe8029230f7838cce2075af1990754f4da8e...abc007f58cd9467277eba2add51cbba2b7af1699,2,44,4,48,7,2014-01-24 10:11:45,2014-01-24 10:11:45
abc007f58cd9467277eba2add51cbba2b7af1699...ba37c7df7162e004804c5f16082654fd70ca38c6,1,5,0,5,1,2014-01-27 01:40:27,2014-01-27 01:40:27
ba37c7df7162e004804c5f16082654fd70ca38c6...c53e85d3330dceebd2bca412d4f528dee258c13b,4,192,19,211,12,2014-01-27 04:15:34,2014-01-27 04:15:34
c53e85d3330dceebd2bca412d4f528dee258c13b...89d778a622558efa3c3875a253f2f74469668b1c,3,57,24,81,15,2014-01-27 04:48:20,2014-01-27 04:48:20
89d778a622558efa3c3875a253f2f74469668b1c...170861a358cb2dea053cad9d885d87f13c1cbee3,2,48,28,76,23,2014-01-27 05:08:59,2014-01-27 05:08:59
170861a358cb2dea053cad9d885d87f13c1cbee3...35c208b5b9b664ea43468b2fe514cfa45801ec98,8,213,67,280,33,2014-01-27 06:27:15,2014-01-27 06:27:15
35c208b5b9b664ea43468b2fe514cfa45801ec98...8c4d68ee282cb80c12935f102ab234408c59a535,3,33,14,47,10,2014-01-27 08:08:36,2014-01-27 08:08:36
8c4d68ee282cb80c12935f102ab234408c59a535...32f27919421b3f57d2dbae189e178a272d25adb6,6,130,46,176,23,2014-01-27 09:13:18,2014-01-27 09:13:18
32f27919421b3f57d2dbae189e178a272d25adb6...5f7393b3a4c23c0c0b50e91079fa653ecfca6184,12,152,45,197,29,2014-01-27 10:31:39,2014-01-27 10:31:39
5f7393b3a4c23c0c0b50e91079fa653ecfca6184...83183a98d0c33e7c728178a1f7c8761b89056991,2,0,18,18,5,2014-01-27 10:34:53,2014-01-27 10:34:53
83183a98d0c33e7c728178a1f7c8761b89056991...b3a113e699977e641f93c4a2aa404f76ced7c9f9,34,764,699,1463,27,2014-01-27 13:22:01,2014-01-27 13:22:01
b3a113e699977e641f93c4a2aa404f76ced7c9f9...b26ccb914eebcfb360edeef1a6336e21795c3a16,35,139,158,297,59,2014-01-27 14:02:01,2014-01-27 14:02:01
b26ccb914eebcfb360edeef1a6336e21795c3a16...cdc894a0aa67e342b7d604499ba65f1318e1a56d,5,53,48,101,10,2014-01-27 15:02:38,2014-01-27 15:02:38
cdc894a0aa67e342b7d604499ba65f1318e1a56d...fd5073888a99d4c46e2468b336ae0fa1469ad723,37,27,59,86,16,2014-01-29 00:00:46,2014-01-29 00:00:46
fd5073888a99d4c46e2468b336ae0fa1469ad723...377d940ba050c05e57e4190b130bbd467ad81e4a,9,232,25,257,27,2014-01-29 03:36:04,2014-01-29 03:36:04
377d940ba050c05e57e4190b130bbd467ad81e4a...e1994f6eceff00fbf024a1d138bf2e756eefdbce,15,223,52,275,40,2014-01-29 10:02:17,2014-01-29 10:02:17
e1994f6eceff00fbf024a1d138bf2e756eefdbce...b7d84a93e75cccef90a1617114b9c69e3a7add68,2,6,5,11,5,2014-01-29 11:35:11,2014-01-29 11:35:11
b196ba4800745e5d47e231aa1bb16c3c496633af...2ed30c5387cb276c8a91d6fcddc56c3a1ab0a46c,3,58,20,78,7,2013-12-24 01:18:47,2013-12-24 00:47:31
e3578c6c30a3e0d218cb42c9ce2d6c785e775ef4...4e8d8589232bd8c7eb1105840e679bbc7a231680,1,45,39,84,6,2014-01-07 12:37:14,2014-01-07 12:32:17
4e8d8589232bd8c7eb1105840e679bbc7a231680...32849891baa885c4c7880292c86c5a0bb5cad387,1,2,1,3,1,2014-01-07 12:40:34,2014-01-07 12:40:34
32849891baa885c4c7880292c86c5a0bb5cad387...5dbeb2b911e0d356e08b823d2271b42eed44aa06,1,1,1,2,1,2014-01-07 12:40:53,2014-01-07 12:40:53
5dbeb2b911e0d356e08b823d2271b42eed44aa06...4b9230b0758359caf801ad4cccfd9744ba36d21d,5,288,70,358,13,2014-01-07 18:15:07,2014-01-07 18:14:32
4b9230b0758359caf801ad4cccfd9744ba36d21d...b9455835c31a8c26dc0732561f2ce442f58e63f9,1,6,0,6,1,2014-01-08 19:24:11,2014-01-08 19:24:11
b9455835c31a8c26dc0732561f2ce442f58e63f9...d6583a14e632b66e02c8f077b0de21f275668d3e,1,0,0,0,0,2014-01-08 19:28:05,2014-01-08 19:28:05
d6583a14e632b66e02c8f077b0de21f275668d3e...45494d22a0c247bb588d73370e9ea4aa60b92cb7,1,2,0,2,1,2014-01-08 19:28:38,2014-01-08 19:28:38
45494d22a0c247bb588d73370e9ea4aa60b92cb7...7e7f29c550e238e40466c192be88d037db2a2947,2,6,2,8,2,2014-01-08 21:09:57,2014-01-08 21:09:57
7e7f29c550e238e40466c192be88d037db2a2947...cd6387cc02ca120bf0d5de17a853cede331834b4,6,123,175,298,90,2014-01-10 04:23:35,2014-01-10 04:23:35
cd6387cc02ca120bf0d5de17a853cede331834b4...fa356ec797d45eb6265f254a82aac877e2e59e17,2,45,11,56,12,2014-01-10 20:44:42,2014-01-10 20:19:59
fa356ec797d45eb6265f254a82aac877e2e59e17...07a74ca03fa9b30e035c1bbcde2bc62eb1b1ef1a,1,19,1,20,1,2014-01-10 20:56:17,2014-01-10 20:56:17
07a74ca03fa9b30e035c1bbcde2bc62eb1b1ef1a...9cd2349d08651abe11b8c82ccdf94d72e9873c38,2,12,4,16,4,2014-01-10 22:38:14,2014-01-10 22:38:00
9cd2349d08651abe11b8c82ccdf94d72e9873c38...d1f366b30b829371798ca8f0fc1289cfd56f16f6,2,1,1,2,1,2014-01-12 06:06:09,2014-01-12 06:06:09
d1f366b30b829371798ca8f0fc1289cfd56f16f6...56e94821e32db5f7beebe5e272cb016fc53e03c9,3,66,16,82,11,2014-01-13 21:04:27,2014-01-13 21:04:27
56e94821e32db5f7beebe5e272cb016fc53e03c9...06c0a9d8aab00d40a8a72b7571ab415a4d162dec,1,12,0,12,1,2014-01-15 00:39:54,2014-01-15 00:39:54
06c0a9d8aab00d40a8a72b7571ab415a4d162dec...da2a17f80df9b211bbaabb23160e506aaf1ede06,2,44,4,48,6,2014-01-15 03:29:55,2014-01-15 03:29:55
73931f399f9d9d6f31d13590c9a77d98cf4d7cfd...66cbdb26367d49350234becc89268d0e55514a69,3,12,0,12,3,2014-03-07 23:55:14,2014-03-07 23:54:17
73931f399f9d9d6f31d13590c9a77d98cf4d7cfd...c41af501ea107af37daa1b748c830578b0d46db1,9,172,176,348,19,2014-03-07 17:22:26,2014-03-06 00:19:57
c41af501ea107af37daa1b748c830578b0d46db1...fe51d10a1019b481fe2a68a0b14570dbdd273314,10,59,36,95,36,2014-03-07 17:22:35,2014-03-06 00:33:35
fe51d10a1019b481fe2a68a0b14570dbdd273314...6ee7ef85817be162a66893bbc9b20bd1b5a542bf,1,46,0,46,1,2014-03-07 17:22:35,2014-03-07 17:21:06
6ee7ef85817be162a66893bbc9b20bd1b5a542bf...ba1ebcdd95c8b8477cfaf8f847d4c10b0bde90b7,1,0,1,1,1,2014-03-08 04:55:42,2014-03-08 04:55:42
ba1ebcdd95c8b8477cfaf8f847d4c10b0bde90b7...18783aab07e60e517c79084c5543b69e8ead92c0,8,254,110,364,32,2014-03-08 05:01:11,2014-03-08 05:01:11
03774e4f3bdade5131bb60251eda360192181c87...9761b3ae1ee3de70ab425ff702e3c299f660b256,1,100,0,100,1,2013-11-15 02:09:57,2013-11-15 02:09:57
9761b3ae1ee3de70ab425ff702e3c299f660b256...7e0d254afacd5af1779773a6d2502c2124a373cb,1,22,14,36,14,2013-11-15 03:05:42,2013-11-15 03:05:42
7e0d254afacd5af1779773a6d2502c2124a373cb...9032d13355bdbd8fc8840eba11a84c96a1dc7346,1,3,3,6,3,2013-11-15 03:11:10,2013-11-15 03:11:10
9032d13355bdbd8fc8840eba11a84c96a1dc7346...d9db8d81a0efd7c980b09a3c816ec26edf6e50ee,2,152,0,152,2,2013-11-19 18:52:08,2013-11-19 18:52:08
d9db8d81a0efd7c980b09a3c816ec26edf6e50ee...af8f5aa7fe2c7f5bbdc1ec2f3db2f8068066e943,4,89,45,134,22,2013-11-19 19:47:49,2013-11-19 19:47:49
af8f5aa7fe2c7f5bbdc1ec2f3db2f8068066e943...db8943050eab36bb18e3d63a4e34d388aea4e05b,1,4,4,8,4,2013-11-22 03:22:38,2013-11-22 03:22:38
db8943050eab36bb18e3d63a4e34d388aea4e05b...ae7ac181fc0368f60ef7849496f9b5ed615458f1,3,187,3,190,6,2013-11-22 23:03:11,2013-11-22 23:03:11
ae7ac181fc0368f60ef7849496f9b5ed615458f1...cf9fdafd27944f5d6ee759dd55529ac5611d67db,4,29,1,30,6,2013-11-22 23:03:34,2013-11-22 23:03:34
cf9fdafd27944f5d6ee759dd55529ac5611d67db...c239bf6529e7b7ed301c7ea61d9f0bebd4655e97,1,6,1,7,2,2013-11-22 23:53:51,2013-11-22 23:53:51
c239bf6529e7b7ed301c7ea61d9f0bebd4655e97...8ce5e59c71fb1a38092f4a199c12fc9f9b3981b6,1,1,0,1,1,2013-11-22 23:55:42,2013-11-22 23:55:42
8ce5e59c71fb1a38092f4a199c12fc9f9b3981b6...406cd97330efd5ac064d40f145573cf66854260c,4,17,15,32,12,2013-11-22 23:56:23,2013-11-22 23:56:23
406cd97330efd5ac064d40f145573cf66854260c...6349647c7d080c5101c8a3ba9078890f4efff19c,2,113,4,117,7,2013-11-23 00:26:47,2013-11-23 00:26:12
6349647c7d080c5101c8a3ba9078890f4efff19c...c21a0fd2615749b3e6d07f3d017dfc153df82fa2,1,5,1,6,3,2013-11-23 00:43:55,2013-11-23 00:43:55
c21a0fd2615749b3e6d07f3d017dfc153df82fa2...edd4313b52bf3d85540b2c6a3a8992135f52745c,1,16,2,18,4,2013-11-23 03:01:17,2013-11-23 01:12:11
edd4313b52bf3d85540b2c6a3a8992135f52745c...5baf76429f7c746b42db9033a87b03b37ef625c3,3,18,14,32,7,2013-11-23 03:01:17,2013-11-23 03:00:44
b31d3fdeae3a118d948f203b96dafed58294e4a4...c6a4fbbdf7fa078cbdafd18c84f039d0a79f396f,1,10,10,20,4,2013-11-21 19:36:06,2013-11-21 19:36:06
c6a4fbbdf7fa078cbdafd18c84f039d0a79f396f...cc2dce836da6376fc649bf9e589144737b5ba2d3,1,3,2,5,3,2013-11-22 18:27:31,2013-11-22 18:27:31
cc2dce836da6376fc649bf9e589144737b5ba2d3...6452379c68ccd1acbb6fe25cd3c6b07638231f08,1,1,1,2,1,2013-11-22 19:01:07,2013-11-22 19:01:07
6452379c68ccd1acbb6fe25cd3c6b07638231f08...6c173bb67bac3e5d2254f9cbbeb826a2ec9726b5,3,63,102,165,30,2013-11-23 03:10:21,2013-11-23 03:10:21
6c173bb67bac3e5d2254f9cbbeb826a2ec9726b5...e850fd33a3eba416f4f7d80804022842a389ae56,3,13,2,15,4,2013-11-23 03:23:54,2013-11-23 03:22:39
b31d3fdeae3a118d948f203b96dafed58294e4a4...8df5e74df99a5ac694322752c500413cf97b698c,1,6,2,8,2,2013-11-15 19:55:49,2013-11-13 02:38:06
8df5e74df99a5ac694322752c500413cf97b698c...3b7a65d50472e4077906d2425db1148020050c84,1,6,2,8,1,2013-11-15 19:55:49,2013-11-15 19:48:49
3063bfda1e9a8411eacfaaa563c78af6570a42d3...ad705d5ee08c1a72f4b23b90b1dcf638504a0229,1,1,1,2,1,2013-09-25 09:32:45,2013-09-25 02:15:25
ad705d5ee08c1a72f4b23b90b1dcf638504a0229...a3d539ed0bab7b8fa0f72cb7daf6467ba0aec17c,1,5,3,8,1,2013-09-25 18:39:24,2013-09-25 18:39:24
a3d539ed0bab7b8fa0f72cb7daf6467ba0aec17c...569e92201a939ff838255a7fb09c16d0dabae861,1,5,0,5,1,2013-09-25 18:57:57,2013-09-25 18:57:49
569e92201a939ff838255a7fb09c16d0dabae861...5889adea901ab017748ea6a0bfdb7437e0db0a7a,2,6,6,12,3,2013-09-25 19:14:58,2013-09-25 19:13:03
33153624f69bf85af90c6642075c0e01c904a200...269ff0cdb1f0e9dc38e6101d187f9a5bd9344fbf,1,2,0,2,1,2013-09-26 22:15:40,2013-03-21 01:37:20
269ff0cdb1f0e9dc38e6101d187f9a5bd9344fbf...4375c015e8880d9ee811d543f410f1c2d804e8ce,2,1,12,13,2,2013-09-26 22:39:00,2013-09-26 22:39:00
4375c015e8880d9ee811d543f410f1c2d804e8ce...7a498ba9160400c2fa33c895b2ea6523eb2bcfea,1,1,1,2,1,2013-09-26 22:41:52,2013-09-26 22:41:52
15730a89ce89882fc1292c38d944bd7fe7cab493...43dd92dd715398e97e83a23057ef9d854dd91408,1,2,1,3,1,2013-12-13 01:42:54,2013-12-13 01:42:36
43dd92dd715398e97e83a23057ef9d854dd91408...bbc310477769b5504cf51b824f7d83265e8739e6,1,9,4,13,4,2013-12-13 02:44:43,2013-12-13 02:41:18
72d3e080675ba7e6b3c50733886fe3690e6d277b...f4a41a1726ee3b733a7816fb1ba7e5c19494f91d,1,1,0,1,1,2013-11-19 19:31:25,2013-11-19 19:31:25
f4a41a1726ee3b733a7816fb1ba7e5c19494f91d...8531977bc2525a70d50c3d0e5da2450a1aaff671,1,3,7,10,3,2013-11-21 00:06:19,2013-11-21 00:06:19
8531977bc2525a70d50c3d0e5da2450a1aaff671...d564ab4b99ebd3bca264f463907e038da706eb1f,4,17,3,20,5,2013-11-21 18:14:03,2013-11-21 18:05:43
8202e86a6ae9e0cc79b0aa41a82aa44d054ec89f...5b76eb7a85f4fb815d76ec7df4ff0799aa7c54ef,1,193,0,193,1,2013-08-01 05:56:38,2013-07-31 06:40:07
5b76eb7a85f4fb815d76ec7df4ff0799aa7c54ef...4dc5aaf683951e4ce6821170d03bdf56b98cfaab,1,231,271,502,3,2013-08-01 05:56:38,2013-07-31 07:21:13
4dc5aaf683951e4ce6821170d03bdf56b98cfaab...5ac411652ab2d1d7c0552a3627ea82c1c6f13a4e,1,7,3,10,2,2013-08-01 05:56:38,2013-07-31 07:24:37
5ac411652ab2d1d7c0552a3627ea82c1c6f13a4e...ad5b20990eac0171cdba5be78b655b211ec2da6e,2,106,131,237,32,2013-08-01 05:56:38,2013-07-31 20:51:43
ad5b20990eac0171cdba5be78b655b211ec2da6e...3f5edbfae95f6bfbca25d1b1fff8e10380278fc3,3,4,22,26,8,2013-08-01 05:56:38,2013-07-31 21:15:08
3f5edbfae95f6bfbca25d1b1fff8e10380278fc3...ea22b3ab02be8460977188696845d65edf1f44cd,5,135,201,336,67,2013-08-01 05:56:38,2013-07-31 22:02:14
ea22b3ab02be8460977188696845d65edf1f44cd...f84fc21e8fb4203447db1b8c872c20c20cc60042,4,136,237,373,25,2013-08-01 05:56:38,2013-07-31 23:48:37
f84fc21e8fb4203447db1b8c872c20c20cc60042...1b82376b4b0d26f552b388f45f1c547e0cf7f445,5,150,98,248,33,2013-08-01 05:56:57,2013-08-01 00:35:01
1b82376b4b0d26f552b388f45f1c547e0cf7f445...1a5d695ee433922c62d9b63789fffcbce5c46af9,3,11,4,15,5,2013-08-01 05:56:57,2013-08-01 00:43:05
1a5d695ee433922c62d9b63789fffcbce5c46af9...a2803fd111cbde09a1d40a0d29f8e5ecec97ab45,1,3,2,5,2,2013-08-01 05:56:57,2013-08-01 01:02:10
a2803fd111cbde09a1d40a0d29f8e5ecec97ab45...52948bed50f0d6dbc014725bba67e8a8967f6590,1,1,1,2,1,2013-08-01 05:56:57,2013-08-01 01:14:03
52948bed50f0d6dbc014725bba67e8a8967f6590...fac5e219fd9cf1fc06c7e5842f9d1933533e8f53,1,5,2,7,3,2013-08-01 05:56:58,2013-08-01 05:44:57
fac5e219fd9cf1fc06c7e5842f9d1933533e8f53...974de6bac3b5a23f8fc90b5504642813a08f66c0,1,1,1,2,1,2013-08-01 05:59:46,2013-08-01 05:59:46
974de6bac3b5a23f8fc90b5504642813a08f66c0...625d98768f242b487ac8835452198ede93521b42,1,1,1,2,1,2013-08-01 06:17:52,2013-08-01 06:17:52
625d98768f242b487ac8835452198ede93521b42...1d45b0bfa88f7aa55e2ff8603e8ba145b6c0b4c6,2,36,54,90,12,2013-08-01 06:26:51,2013-08-01 06:26:51
1d45b0bfa88f7aa55e2ff8603e8ba145b6c0b4c6...f276b3414857df3333b635b2ad9534666a3e8139,2,10,0,10,2,2013-08-01 06:50:31,2013-08-01 06:50:31
8202e86a6ae9e0cc79b0aa41a82aa44d054ec89f...0b2dd4f9aec6d3fdbdbcc5c059479161c7182f84,1,24,0,24,1,2013-08-01 02:34:47,2013-07-31 23:04:29
0b2dd4f9aec6d3fdbdbcc5c059479161c7182f84...248ff08b0c8ff97c22c386b83c5e025ab309e0d9,1,9,1,10,2,2013-08-01 03:08:26,2013-08-01 03:08:26
248ff08b0c8ff97c22c386b83c5e025ab309e0d9...6010f11b6df979478d0a6752fa47f6e6c45fdf77,1,1,1,2,1,2013-08-02 01:22:42,2013-08-02 01:22:42
6010f11b6df979478d0a6752fa47f6e6c45fdf77...bf308cf560cf202d9ea22b6b403c106ccd857261,1,2,0,2,1,2013-08-02 17:47:08,2013-08-02 17:47:08
bf308cf560cf202d9ea22b6b403c106ccd857261...38a974f9af4217de6293dbb7406c7630b67b44cc,1,7,7,14,7,2013-08-02 17:47:54,2013-08-02 17:47:54
38a974f9af4217de6293dbb7406c7630b67b44cc...4368dd90cb35233fcf551096cef34358bdeba2f3,1,4,0,4,1,2013-08-02 17:49:20,2013-08-02 17:49:20
4368dd90cb35233fcf551096cef34358bdeba2f3...4d44a4df66d240ea44d9c09892d7736fc6214089,1,3,3,6,3,2013-08-02 18:32:58,2013-08-02 18:32:58
8eefdbfc41a47b0025504662d1d8d01508ea5106...3a80e209573390d6ce1a32c35425c28a17732872,7,2391,0,2391,7,2013-08-14 01:48:29,2013-08-14 01:48:29
3a80e209573390d6ce1a32c35425c28a17732872...880b1a34887775a912f95985cfbb4ddf12274d28,1,8,15,23,2,2013-08-14 02:24:04,2013-08-14 02:24:04
880b1a34887775a912f95985cfbb4ddf12274d28...b43024358eecf0f58c0225d32fcdadd6c80a7898,6,18,38,56,12,2013-08-15 03:53:33,2013-08-15 03:53:33
b43024358eecf0f58c0225d32fcdadd6c80a7898...6c79f105c1525c1ed9d5ed8de460a6ee078c48c7,1,2,2,4,2,2013-08-15 17:02:24,2013-08-15 17:02:24
6c79f105c1525c1ed9d5ed8de460a6ee078c48c7...6e9b34c4e89243736133ae9bc564c5ea253465b4,1,146,131,277,10,2013-08-15 23:23:50,2013-08-15 23:23:50
6e9b34c4e89243736133ae9bc564c5ea253465b4...5b801b027a3472943df96b116619a0c11001d085,2,70,41,111,16,2013-08-16 02:01:08,2013-08-16 02:01:08
d27a3b4aa6beae7e51d7a8c35b85ec02c4487b44...5e7138d49e578e1553d3e66c00a77ab7c7422cac,1,20,0,20,3,2013-06-07 05:58:21,2013-06-07 05:58:21
d27a3b4aa6beae7e51d7a8c35b85ec02c4487b44...f613f85ba90b43d049063327c367376989b344c9,1,7,5,12,2,2013-05-30 18:57:17,2013-05-30 18:57:17
f613f85ba90b43d049063327c367376989b344c9...6d4ebcb885fa4a807b11df40f5fcc722eb1101d8,1,1,1,2,1,2013-05-30 21:05:22,2013-05-30 21:05:22
6d4ebcb885fa4a807b11df40f5fcc722eb1101d8...637686986ef3c675d8aeb66176ba4e7d626c6587,1,4,5,9,3,2013-05-31 20:02:20,2013-05-31 20:02:20
637686986ef3c675d8aeb66176ba4e7d626c6587...6edeacf29e3300b40f67693103958b633152a344,4,4,4,8,4,2013-05-31 20:02:41,2013-05-31 20:02:32
6edeacf29e3300b40f67693103958b633152a344...20a1f88993279b8bdc9550b67e40fe06534b00e4,1,1,1,2,1,2013-05-31 20:05:07,2013-05-31 20:05:07
52e59350dba4add4df4e2490f82878127f299288...c604a8dd808d967873c6b00b0983e5ca106a93d3,2,17,15,32,14,2013-10-04 22:49:27,2013-10-04 22:47:55
c604a8dd808d967873c6b00b0983e5ca106a93d3...c2b2deb0d60f88d1cf9407b43f32567b25593fd5,1,5,2,7,3,2013-10-05 01:19:57,2013-10-05 01:19:57
52e59350dba4add4df4e2490f82878127f299288...234ae59840629c1a4b8f3f7beab13138a4b2cca4,1,2,0,2,1,2013-10-04 20:25:19,2013-10-04 20:25:19
234ae59840629c1a4b8f3f7beab13138a4b2cca4...a4d96c68b27302002271a182219c21e2abf843de,1,1,1,2,1,2013-10-04 21:19:45,2013-10-04 21:19:45
a4d96c68b27302002271a182219c21e2abf843de...35fc8bf5f545948f2905f775fd7ab66bb1cbd1ab,2,17,15,32,14,2013-10-04 22:47:55,2013-10-04 22:47:55
35fc8bf5f545948f2905f775fd7ab66bb1cbd1ab...82994d06e49ed6cc25476b94bf8396e6265513a3,1,14,7,21,2,2013-10-05 00:55:08,2013-10-05 00:55:08
82994d06e49ed6cc25476b94bf8396e6265513a3...77d50e4f3d79ec86c85a0e9be2ab81ea72b891b1,1,5,2,7,3,2013-10-05 01:21:18,2013-10-05 01:19:57
3733ab1c72b46bad0044cf9e85eec98273aca834...d05560d12f124894731ad843b4769e6ff33a6201,1,47,40,87,14,2013-10-11 23:31:40,2013-10-11 17:01:29
d05560d12f124894731ad843b4769e6ff33a6201...47babd170fd702b155f68395a855681f9df3b4cc,2,5,4,9,3,2013-10-12 00:12:10,2013-10-12 00:02:42
47babd170fd702b155f68395a855681f9df3b4cc...cb1d30c7e87cd342f7f637acd2c3e2a3472b9c82,2,6,1,7,2,2013-10-12 00:19:27,2013-10-12 00:19:27
cb1d30c7e87cd342f7f637acd2c3e2a3472b9c82...ca0e7c3c075105790d905e79a9b9f809260c4f93,1,1,1,2,1,2013-10-12 01:20:06,2013-10-12 01:20:06
ca0e7c3c075105790d905e79a9b9f809260c4f93...958a5475132ba24490bcaada9cd41ec1aa8ed17a,4,4,4,8,4,2013-10-12 01:43:13,2013-10-12 01:43:13
3733ab1c72b46bad0044cf9e85eec98273aca834...28ada68c666beb1ad9b3d13945d1a52469ea11a9,2,2,2,4,2,2013-10-10 22:54:12,2013-10-10 22:54:12
28ada68c666beb1ad9b3d13945d1a52469ea11a9...067a96e2c1c32ee680f4ba48ad802f5278ac084c,3,9,4,13,3,2013-10-10 23:56:17,2013-10-10 23:56:17
067a96e2c1c32ee680f4ba48ad802f5278ac084c...8bb02c50d457f226ccec35220f86a29483d724ac,2,3,3,6,3,2013-10-11 03:47:29,2013-10-11 03:47:29
8bb02c50d457f226ccec35220f86a29483d724ac...0538cca561c48115d1d5150954a23f4770d275e2,2,5,2,7,2,2013-10-11 04:37:30,2013-10-11 04:37:30
0538cca561c48115d1d5150954a23f4770d275e2...f21ed5fee58f8b4da9d218e12b89c038f87b272f,4,4,7,11,4,2013-10-11 05:51:17,2013-10-11 05:51:17
f21ed5fee58f8b4da9d218e12b89c038f87b272f...80d13693f33d54b75018db69fdb57bc5ebccb772,1,1,1,2,1,2013-10-11 08:05:53,2013-10-11 08:05:53
80d13693f33d54b75018db69fdb57bc5ebccb772...75f48eafec1ad9de70bee4a85c9c229ae18f120b,1,1,1,2,1,2013-10-11 08:14:24,2013-10-11 08:14:24
75f48eafec1ad9de70bee4a85c9c229ae18f120b...d535bb5445345c807b904f230a771bc6db13ae06,2,21,2,23,3,2013-10-11 13:43:44,2013-10-11 13:43:44
5f37a9d50e326126cf472ae657b2b54e3445dee3...4e63cc21e6dda48d1fd93774b94b1e2c63e4ae01,1,7,5,12,1,2013-03-27 18:20:05,2013-03-27 18:20:05
4e63cc21e6dda48d1fd93774b94b1e2c63e4ae01...67f73430228d689e3d36c7ffdc3a480ae7dd5439,1,1,1,2,1,2013-03-27 22:13:48,2013-03-27 22:13:48
67f73430228d689e3d36c7ffdc3a480ae7dd5439...6aa855fbe036fc6adc4c2542b94c9c9cacf41aca,1,0,1,1,1,2013-03-28 01:56:23,2013-03-28 01:56:23
6aa855fbe036fc6adc4c2542b94c9c9cacf41aca...76f611789eb1937a7c896a9921c0d39d52c8ab88,2,38,0,38,3,2013-03-28 05:22:42,2013-03-28 02:17:26
124d05488b76c0cba03df14765a263297b80a1d1...dc9f69d39feb00fdeff5b175d50763faeb3705eb,1,1,1,2,1,2013-02-13 02:16:02,2013-02-12 16:41:06
3229f24ad029867de35d7300e4c56df19c09ff34...7db8e5a0748a38cfdb320dca6115051b0fc58221,12,1856,0,1856,12,2014-04-22 04:00:41,2014-04-22 04:00:41
7db8e5a0748a38cfdb320dca6115051b0fc58221...d77539de3a6d43a03e7e4c5ae045d1610d8ee919,11,909,912,1821,12,2014-04-22 04:41:49,2014-04-22 04:41:49
d77539de3a6d43a03e7e4c5ae045d1610d8ee919...483cc1761683c1a64b11e380a03473af198bee06,1,1,2,3,2,2014-04-22 04:48:44,2014-04-22 04:48:44
483cc1761683c1a64b11e380a03473af198bee06...f376029ee63c4dd43fee897fbe0918b17643ae47,2,246,220,466,25,2014-04-22 14:31:49,2014-04-22 14:31:49
f376029ee63c4dd43fee897fbe0918b17643ae47...7a8622eb26b01938afec37184fbb4f6a156ae24b,1,1,1,2,2,2014-04-22 14:38:31,2014-04-22 14:38:31
7a8622eb26b01938afec37184fbb4f6a156ae24b...ec760982c45f7aada166356ec0a6734f82b5af33,1,8,4,12,5,2014-04-22 14:46:23,2014-04-22 14:46:23
ec760982c45f7aada166356ec0a6734f82b5af33...43d672bd6a917f018f8a234877105606cec24fbf,26,759,1114,1873,97,2014-04-22 20:47:57,2014-04-22 20:47:57
43d672bd6a917f018f8a234877105606cec24fbf...1e7b91feaabeefed2c3ccfd0d28ec422074f2223,9,100,74,174,41,2014-04-22 22:55:56,2014-04-22 22:55:56
1e7b91feaabeefed2c3ccfd0d28ec422074f2223...8edb5c2da0fa9437e8647ead4a3d3c2087d7dee2,9,44,29,73,21,2014-04-23 07:47:57,2014-04-23 07:47:57
8edb5c2da0fa9437e8647ead4a3d3c2087d7dee2...54ce3ce4b3a4916fc1bd898f4393a04bef5422dd,1,18,51,69,9,2014-04-24 15:46:31,2014-04-24 15:46:31
54ce3ce4b3a4916fc1bd898f4393a04bef5422dd...a2552be8f8c0525d027529f6728aa25bc96d6872,10,171,143,314,85,2014-04-24 17:18:02,2014-04-24 17:18:02
a2552be8f8c0525d027529f6728aa25bc96d6872...d96ee0eab256ec129bfef49fdc632de335394069,6,190,154,344,11,2014-04-24 19:24:03,2014-04-24 19:24:03
d96ee0eab256ec129bfef49fdc632de335394069...5daecb549e9a9c2f5bd8c36beec4815bf996e662,2,18,3,21,4,2014-04-24 19:33:19,2014-04-24 19:33:19
5daecb549e9a9c2f5bd8c36beec4815bf996e662...fc64081c5228f2f53042c85107ad8fe81534bdb9,8,53,51,104,44,2014-04-24 20:23:01,2014-04-24 20:23:01
fc64081c5228f2f53042c85107ad8fe81534bdb9...e431f1adbd2683dbee27fd1c0906578e493f300f,1,92,15,107,4,2014-04-24 20:54:54,2014-04-24 20:54:54
e431f1adbd2683dbee27fd1c0906578e493f300f...5c1cf98698f373224554338c9b72dea1a49e1658,3,195,177,372,10,2014-04-24 21:17:59,2014-04-24 21:17:59
5c1cf98698f373224554338c9b72dea1a49e1658...d575b5d94609b7a72326fc443ae800b17afc2624,8,148,95,243,38,2014-04-24 21:28:20,2014-04-24 21:28:20
d575b5d94609b7a72326fc443ae800b17afc2624...9c637cf9bb51536704e89712badf3a5c3ccc56c2,2,38,2,40,8,2014-04-24 22:40:28,2014-04-24 22:40:28
9c637cf9bb51536704e89712badf3a5c3ccc56c2...1d2125512cf010194e4fc44dc4ea410ab7bd92a1,4,224,13,237,8,2014-04-24 23:13:24,2014-04-24 23:13:24
1d2125512cf010194e4fc44dc4ea410ab7bd92a1...09bfbe700c3eb1b8e3fe55d36f32e15090a3d383,1,3,1,4,1,2014-04-25 00:33:55,2014-04-25 00:33:55
09bfbe700c3eb1b8e3fe55d36f32e15090a3d383...5546e085330009b25880b01eea97d5faaeaf7b57,1,32,0,32,5,2014-04-25 03:57:01,2014-04-25 03:57:01
5546e085330009b25880b01eea97d5faaeaf7b57...84cd599af932abfa63608ef59ed12dd9cb1dfd17,1,15,0,15,1,2014-04-25 03:57:10,2014-04-25 03:57:10
84cd599af932abfa63608ef59ed12dd9cb1dfd17...c4e4a64e412b77dc8753466e03d93976538c1b9c,1,1,4,5,2,2014-04-25 04:30:29,2014-04-25 04:30:21
c4e4a64e412b77dc8753466e03d93976538c1b9c...9e28a52187cc039f12e12fe499d8801e057beb00,2,19,1,20,7,2014-04-25 04:57:48,2014-04-25 04:57:48
9e28a52187cc039f12e12fe499d8801e057beb00...8f2d0310ffb20930123755f3088a42bc2d90a609,1,1,1,2,1,2014-04-26 18:30:20,2014-04-26 18:30:20
8f2d0310ffb20930123755f3088a42bc2d90a609...30db75351ff8f1003106db64dccdecbd88f80101,3,463,218,681,46,2014-04-26 18:30:37,2014-04-26 18:30:37
30db75351ff8f1003106db64dccdecbd88f80101...db6202c69ca333ce51cbce8c77e33b14050c2918,2,412,111,523,15,2014-04-28 02:16:47,2014-04-28 02:16:47
db6202c69ca333ce51cbce8c77e33b14050c2918...55814cab4cdc15f3adaca751669284609951563d,5,420,370,790,39,2014-04-28 16:29:31,2014-04-28 16:29:31
55814cab4cdc15f3adaca751669284609951563d...620adfb141bc0bd03fbab4795ab0eee3cce40801,2,194,25,219,24,2014-04-28 17:36:15,2014-04-28 17:36:15
620adfb141bc0bd03fbab4795ab0eee3cce40801...bce67e48c38f66f01f4c348da71361195ce376eb,6,54,16,70,14,2014-04-29 00:28:35,2014-04-29 00:28:35
bce67e48c38f66f01f4c348da71361195ce376eb...310dcc55287dc4fad13014db55942c9100a29d09,2,87,9,96,6,2014-04-29 00:56:42,2014-04-29 00:56:42
310dcc55287dc4fad13014db55942c9100a29d09...e9c388933feb0f0447c59a0d0f016640a84a1ed4,6,450,11,461,10,2014-04-29 18:05:03,2014-04-29 18:05:03
e9c388933feb0f0447c59a0d0f016640a84a1ed4...95cb338314e9ee2bd798f6177cf88e51be05ccfc,2,26,4,30,6,2014-04-29 18:16:43,2014-04-29 18:16:43
95cb338314e9ee2bd798f6177cf88e51be05ccfc...a1123715b6314513cb1257c382abda0044bde324,2,2,2,4,2,2014-04-29 18:19:24,2014-04-29 18:19:24
a1123715b6314513cb1257c382abda0044bde324...b8f7f1d093bf280d48d6a39df970ea7dc85e97af,4,22,4,26,8,2014-05-01 07:13:07,2014-05-01 07:13:07
b8f7f1d093bf280d48d6a39df970ea7dc85e97af...5d09079393ef6dc7f629be8e40353814f72b43fb,4,379,377,756,4,2014-05-04 02:05:36,2014-05-04 02:05:20
5d09079393ef6dc7f629be8e40353814f72b43fb...91f279859c2392e22c0e56ee7439b3cb702dddd7,1,2,0,2,1,2014-05-04 02:21:28,2014-05-04 02:21:28
91f279859c2392e22c0e56ee7439b3cb702dddd7...9a048a5c282d49f83b8c1be9a91dcdc4572864c7,3,52,3,55,6,2014-05-04 16:29:47,2014-05-04 16:28:53
9a048a5c282d49f83b8c1be9a91dcdc4572864c7...892e52734d95cc2afef3359254e298f622d482fd,3,76,77,153,3,2014-05-04 18:02:39,2014-05-04 18:02:39
892e52734d95cc2afef3359254e298f622d482fd...756c954f96400db17d5c243d3460195e5f84ae93,5,7,7,14,7,2014-05-04 18:04:51,2014-05-04 18:04:51
756c954f96400db17d5c243d3460195e5f84ae93...1b6a06615ee6c0232b5dd65585f0365560311c59,6,331,7,338,15,2014-05-05 22:52:58,2014-05-05 22:52:58
1b6a06615ee6c0232b5dd65585f0365560311c59...c1ea733f7f7d71a0f7263dc7bf23657396e1bd50,1,6,6,12,3,2014-05-06 01:34:39,2014-05-06 01:34:39
c1ea733f7f7d71a0f7263dc7bf23657396e1bd50...6591df68061fa754d18cfaf4a330ad8b1fbdc02c,1,19,19,38,18,2014-05-06 01:44:20,2014-05-06 01:44:20
6591df68061fa754d18cfaf4a330ad8b1fbdc02c...2cd5227af5a3cd9e8b51a3a75bca7a585a5d5b70,3,57,31,88,13,2014-05-06 02:52:48,2014-05-06 02:52:48
2cd5227af5a3cd9e8b51a3a75bca7a585a5d5b70...1669783a8626f3a088472d9895e2ece9061e6ff5,3,28,1,29,3,2014-05-06 03:19:00,2014-05-06 03:19:00
1669783a8626f3a088472d9895e2ece9061e6ff5...bed3d1ed3dcb9e4f77ffb2012715b5ed2f6efec5,4,36,2,38,5,2014-05-06 15:59:47,2014-05-06 15:59:47
bed3d1ed3dcb9e4f77ffb2012715b5ed2f6efec5...d4f03d4249b153e3bb02be3db2418417f4d6c95c,2,37,10,47,6,2014-05-06 19:02:19,2014-05-06 19:02:19
d4f03d4249b153e3bb02be3db2418417f4d6c95c...8bc0fa2e6bb1012a89498fb3e33c3040319d17a7,1,6,2,8,2,2014-05-06 19:10:53,2014-05-06 19:10:53
8bc0fa2e6bb1012a89498fb3e33c3040319d17a7...71a432d049f25b4487f9b094822cc5bd7036d519,1,13,0,13,4,2014-05-06 19:24:34,2014-05-06 19:24:34
71a432d049f25b4487f9b094822cc5bd7036d519...eb34ed8a25c3bdf789368d68e54e21ef09b1c8d8,1,4,1,5,2,2014-05-06 20:49:43,2014-05-06 20:49:43
eb34ed8a25c3bdf789368d68e54e21ef09b1c8d8...01942e55c6b92c7831d8c48c38a3e468167f631e,1,5,3,8,2,2014-05-06 20:52:14,2014-05-06 20:52:14
01942e55c6b92c7831d8c48c38a3e468167f631e...aa2603ec9de185508a245106befe54ced053a7ae,2,5,5,10,4,2014-05-06 21:04:56,2014-05-06 21:04:56
aa2603ec9de185508a245106befe54ced053a7ae...ea93529b7a19adbd657657c82ce1f15080fe853f,1,31,0,31,5,2014-05-06 21:20:08,2014-05-06 21:20:08
ea93529b7a19adbd657657c82ce1f15080fe853f...e5768a3c716d9b9ca8defbf75052bb0553287a86,1,5,10,15,4,2014-05-06 21:21:19,2014-05-06 21:21:19
e5768a3c716d9b9ca8defbf75052bb0553287a86...bc4339c1dc94da7b1b590d2db6596aa4bbfbbb59,6,61,362,423,35,2014-05-06 21:30:48,2014-05-06 21:30:48
bc4339c1dc94da7b1b590d2db6596aa4bbfbbb59...60a4b0ac1996cab20e7a53e1387ffa75b8dba850,2,67,0,67,2,2014-05-07 00:24:11,2014-05-07 00:24:11
60a4b0ac1996cab20e7a53e1387ffa75b8dba850...bee046de6437548183ad4e824172c6fcb90cbb7a,2,21,5,26,7,2014-05-07 00:47:13,2014-05-07 00:47:13
bee046de6437548183ad4e824172c6fcb90cbb7a...21e76e013b333763a56ac004caea9676ef5feebc,12,123,115,238,27,2014-05-13 04:23:08,2014-05-13 04:23:08
21e76e013b333763a56ac004caea9676ef5feebc...a7f65bb04b892615c2f2a522437adb55ad5b3bbf,1,4,4,8,2,2014-05-13 17:27:51,2014-05-13 17:27:43
a7f65bb04b892615c2f2a522437adb55ad5b3bbf...38f5932b81e87b123a126c06239c4850f6487380,6,56,21,77,17,2014-05-14 01:02:24,2014-05-14 01:02:24
38f5932b81e87b123a126c06239c4850f6487380...1592d58dfb6d7c94c1762462219955d84d966b05,1,14,1,15,1,2014-05-14 01:15:29,2014-05-14 01:15:29
1592d58dfb6d7c94c1762462219955d84d966b05...86570b221879e476a8309cca958577e69fdf95fa,6,83,14,97,13,2014-05-15 00:59:37,2014-05-15 00:59:37
86570b221879e476a8309cca958577e69fdf95fa...fd66def6f7103417c0defe6ed6b1eba73682d23e,5,49,16,65,14,2014-05-15 19:48:23,2014-05-15 19:48:23
fd66def6f7103417c0defe6ed6b1eba73682d23e...cf408de3bcdfa3df789058afe6569f2cba838fcb,1,1,1,2,1,2014-05-19 00:11:10,2014-05-19 00:11:10
cf408de3bcdfa3df789058afe6569f2cba838fcb...7768cb0611978b50dbd7442ddd966ad457064900,8,97,101,198,97,2014-05-27 20:26:56,2014-05-27 20:26:56
e9c9b8270e26c84f515fdefe927538d45b7e7e29...9f6734dfa462a3947c3a5477fd862dc44ca5cc46,1,4,0,4,1,2014-04-03 20:22:37,2014-04-03 20:22:37
9f6734dfa462a3947c3a5477fd862dc44ca5cc46...266095c913ec4d252482bd1734cc7c001625270f,2,2,1,3,2,2014-04-03 20:28:44,2014-04-03 20:21:11
266095c913ec4d252482bd1734cc7c001625270f...db8c05bd6207c998dc68812e60eeb2389e281150,1,1,1,2,1,2014-04-03 21:26:06,2014-04-03 21:26:03
db8c05bd6207c998dc68812e60eeb2389e281150...f1f29d2e1325b1193d25ff5c9a4c0b63d0a4a8b2,1,8,1,9,2,2014-04-03 23:51:21,2014-04-03 23:51:21
f1f29d2e1325b1193d25ff5c9a4c0b63d0a4a8b2...da0138c72aba95f6ff7d6ab198e51e56b467bb29,2,15,4,19,2,2014-04-03 23:59:02,2014-04-03 23:58:41
da0138c72aba95f6ff7d6ab198e51e56b467bb29...bae16dd7629f578126330fd3b025bb34c49e56ab,1,1,1,2,1,2014-04-04 00:25:14,2014-04-01 11:38:19
bae16dd7629f578126330fd3b025bb34c49e56ab...c65038c04a4046d2ef41897de74936642085cb26,1,2,1,3,1,2014-04-04 01:42:38,2014-04-04 01:40:39
c65038c04a4046d2ef41897de74936642085cb26...61a1bb5e149677b23ccb828c6dbe6df2f7d6b6a1,1,7,4,11,3,2014-04-04 01:42:38,2014-04-04 01:42:14
61a1bb5e149677b23ccb828c6dbe6df2f7d6b6a1...0930e5f246e3438775e726fce36d4f3d5fbbe35d,2,2,2,4,2,2014-04-04 02:03:50,2014-04-04 02:03:37
0930e5f246e3438775e726fce36d4f3d5fbbe35d...83799bb7f22c59e369b203ce3eb282a7d80f3bd0,1,1,1,2,1,2014-04-04 03:27:18,2014-04-04 03:27:01
83799bb7f22c59e369b203ce3eb282a7d80f3bd0...9c592185542fd10a81804b65fb0f33ab7afca960,1,3,3,6,3,2014-04-04 18:53:12,2014-04-04 18:52:55
9c592185542fd10a81804b65fb0f33ab7afca960...3d7448bccea772e21730c56b5da5fbcb9e7fe847,1,1,0,1,1,2014-04-06 22:36:05,2014-04-06 22:36:05
3d7448bccea772e21730c56b5da5fbcb9e7fe847...498e5722300e20a015db96bbce447883e456fe39,1,4,0,4,4,2014-04-08 03:09:30,2014-04-08 03:09:08
e7a85a39b6803c72a3241f6b6aa455d42eb09f6f...25e016e6a1078fa4b435e80a938d27dd48824020,1,1,1,2,1,2014-04-15 02:31:00,2014-04-15 02:31:00
25e016e6a1078fa4b435e80a938d27dd48824020...2f5792acdbceac4d6c0d3ca6197d480fbca03d3b,3,123,77,200,48,2014-04-15 22:29:39,2014-04-15 22:28:04
f0d6c15583929bf437cd9f61278d3339ccf79999...5fcae3cd269b0d5c415053442e9e0179fe519549,1,0,9,9,1,2014-03-26 21:50:07,2014-03-26 21:25:17
5fcae3cd269b0d5c415053442e9e0179fe519549...1d9c2443e8a6c367d56c1528698159d3d4ecb55d,2,12,2,14,3,2014-03-26 22:02:34,2014-03-26 22:02:34
1d9c2443e8a6c367d56c1528698159d3d4ecb55d...8ef35b7bfd77d2a9a769eea65bd5a47007e5119b,1,11,2,13,2,2014-03-27 00:31:42,2014-03-27 00:31:42
8ef35b7bfd77d2a9a769eea65bd5a47007e5119b...f58754cb01d4a6eacfd93fffa3040bd710af86fe,1,32,9,41,5,2014-03-27 02:10:46,2014-03-27 02:10:46
f58754cb01d4a6eacfd93fffa3040bd710af86fe...ea10dfc545eda35ad758f2296e5c3dc4b262f784,3,56,139,195,27,2014-03-27 02:38:02,2014-03-27 02:38:02
ea10dfc545eda35ad758f2296e5c3dc4b262f784...321f1c752fb0def2102b7e1e6bb64d00c80082fe,1,72,0,72,1,2014-03-27 03:16:26,2014-03-27 03:16:26
321f1c752fb0def2102b7e1e6bb64d00c80082fe...acb54beff8b9d419e0049d3570467c6c3f350eee,2,4,0,4,3,2014-03-27 03:19:05,2014-03-27 03:19:05
acb54beff8b9d419e0049d3570467c6c3f350eee...9cb2131bb63e32428dd8018882a8ef84d502e371,1,21,4,25,2,2014-03-27 03:33:56,2014-03-27 03:33:56
9cb2131bb63e32428dd8018882a8ef84d502e371...6b9c74561fdb3214297303ccc618a08bd67a2941,2,22,3,25,3,2014-03-27 03:34:31,2014-03-27 03:34:31
6b9c74561fdb3214297303ccc618a08bd67a2941...27ec7b15193405467a5227854efb8dd0201a49b9,1,1,1,2,1,2014-03-27 03:41:58,2014-03-27 03:41:58
27ec7b15193405467a5227854efb8dd0201a49b9...dc71bd2143ded5b45b94ddcead6a7809544a5eec,4,2,10,12,4,2014-03-27 03:55:02,2014-03-27 03:55:02
51148c84df8285b0e44ed7bbcd53063fe61f9b18...c0447737ec725e316e5d1d543f797456b4db7524,1,9,10,19,3,2014-03-04 05:55:58,2014-03-04 05:55:58
c0447737ec725e316e5d1d543f797456b4db7524...f079efe48b285bd5b75732e3bbd8b0347331df3d,1,5,11,16,5,2014-03-04 06:00:31,2014-03-03 16:49:38
f079efe48b285bd5b75732e3bbd8b0347331df3d...f9c947a7497de122288f2db2f5bd429a5c5f47e9,1,7,0,7,1,2014-03-04 06:17:40,2014-03-04 06:17:32
f9c947a7497de122288f2db2f5bd429a5c5f47e9...8924417e23efb986984c5b77f5e1b6b8ea706591,1,11,3,14,2,2014-03-04 06:41:33,2014-03-04 06:41:33
8924417e23efb986984c5b77f5e1b6b8ea706591...a1fed0caaa8d0dcae70754130648611cb8d28f8d,1,7,0,7,1,2014-03-04 06:49:49,2014-03-04 06:49:49
a1fed0caaa8d0dcae70754130648611cb8d28f8d...6069da6427824d529759fbe733b972dbbb0e4ff5,1,9,4,13,4,2014-03-04 07:15:30,2014-03-04 07:15:19
6069da6427824d529759fbe733b972dbbb0e4ff5...0791b31b3015122a113f403db56af5b9545f330e,2,4,2,6,3,2014-03-04 07:15:41,2014-03-04 05:38:37
51148c84df8285b0e44ed7bbcd53063fe61f9b18...663898f80b72a696c9770e0e04e1795cb5da1130,2,4,2,6,3,2014-03-04 05:38:37,2014-03-04 05:38:37
6dff2725e1e8136aed964fc72acc47322254c048...ef70c87fc9fe29c318b71a38aa5bb2bc8b621fba,3,29,33,62,14,2014-03-05 10:16:26,2014-03-05 10:16:26
ef70c87fc9fe29c318b71a38aa5bb2bc8b621fba...8fea9b2adfd154e07c10d548d0d9cb02d843fb7b,1,1,1,2,1,2014-03-05 10:19:51,2014-03-05 10:19:51
8fea9b2adfd154e07c10d548d0d9cb02d843fb7b...fec53d61364d3198877d8e8621bac2a94006d0aa,3,15,8,23,6,2014-03-05 19:00:12,2014-03-05 18:58:03
fec53d61364d3198877d8e8621bac2a94006d0aa...ca47c01b9be324dfeedd71a37ece447930e83473,1,1,2,3,1,2014-03-05 21:58:45,2014-03-05 21:58:45
ca47c01b9be324dfeedd71a37ece447930e83473...ea64ed1dabc1ed8f5edf3dd823829d1b816c6f0c,1,6,0,6,3,2014-03-05 22:01:12,2014-03-05 22:01:12
ea64ed1dabc1ed8f5edf3dd823829d1b816c6f0c...fdc7209dff5cca9849bdb19da4f538e8bdf85607,2,23,10,33,7,2014-03-05 22:01:41,2014-03-05 21:32:31
fdc7209dff5cca9849bdb19da4f538e8bdf85607...6843ad9f025d1cd87e41c59fd900bc85ea10b693,1,2,6,8,2,2014-03-05 22:03:24,2014-03-05 22:03:24
6843ad9f025d1cd87e41c59fd900bc85ea10b693...1edd64307c52cefadcb062056753fbbd59514ed0,1,3,2,5,1,2014-03-05 22:11:18,2014-03-05 22:11:18
1edd64307c52cefadcb062056753fbbd59514ed0...7a25afcc7537c95cd28525b768fc04faa38a131e,2,6,1,7,2,2014-03-05 22:13:51,2014-03-05 22:13:20
7a25afcc7537c95cd28525b768fc04faa38a131e...d0e96b7eb6997e876b74c1314e1082fb46cd2d9d,1,40,30,70,13,2014-03-05 22:25:15,2014-03-05 22:25:15
d0e96b7eb6997e876b74c1314e1082fb46cd2d9d...6f42a3f9d02b0c0cde557de98169ccbe67a4ecdf,1,7,4,11,1,2014-03-05 22:27:58,2014-03-05 22:27:58
6f42a3f9d02b0c0cde557de98169ccbe67a4ecdf...984b1d40966167155aa44107786e780a8bef9987,1,0,3,3,1,2014-03-05 22:29:23,2014-03-05 22:29:23
984b1d40966167155aa44107786e780a8bef9987...11a1981dee4a586e6d892468aef7c698a14dad76,2,9,1,10,2,2014-03-05 22:32:49,2014-03-05 22:32:49
11a1981dee4a586e6d892468aef7c698a14dad76...56e236daef0ef3df5474edb7dce371413630c1b3,1,3,1,4,1,2014-03-05 23:13:34,2014-03-05 23:13:34
56e236daef0ef3df5474edb7dce371413630c1b3...6eff081da143537413910a043cecb20c74a3ce7b,1,4,1,5,1,2014-03-05 23:14:05,2014-03-05 23:13:30
53f2b73d6f05d024bc855f09f81370fdbe79b845...57104f6a8da109e2ab648318e2e50e4171a2a1d3,2,23,10,33,7,2014-03-05 21:32:31,2014-03-05 21:32:31
57104f6a8da109e2ab648318e2e50e4171a2a1d3...46964c77e64621408849bcfdd3da7fd89d42975e,1,1,1,2,1,2014-03-10 22:54:43,2014-03-10 22:54:43
46964c77e64621408849bcfdd3da7fd89d42975e...b25d765b3ef4da96bbd66dab52f3b353f4894b9f,1,0,17,17,1,2014-03-10 22:55:37,2014-03-10 22:55:37
53f2b73d6f05d024bc855f09f81370fdbe79b845...468f32bd8063fcc67a38480fb19c06ef4e89da53,7,128,0,128,7,2014-03-05 07:08:38,2014-03-05 07:08:38
468f32bd8063fcc67a38480fb19c06ef4e89da53...5a84f0978ba1b7ecf33bae2e2c86f761679bfeca,7,65,0,65,7,2014-03-05 07:34:06,2014-03-05 07:34:06
5a84f0978ba1b7ecf33bae2e2c86f761679bfeca...9dd40fa1db1cf47c234be11f8750203daf6cd9f9,2,40,34,74,14,2014-03-05 09:25:51,2014-03-05 09:25:51
9dd40fa1db1cf47c234be11f8750203daf6cd9f9...7ff45403dddf0d7119c54f3999a0395a34fee3e0,1,43,13,56,3,2014-03-05 10:02:22,2014-03-05 10:02:22
7ff45403dddf0d7119c54f3999a0395a34fee3e0...84512af013d0c9e0efc0e6cfb4545a6e27ecf020,1,40,1,41,1,2014-03-05 10:34:37,2014-03-05 10:34:37
84512af013d0c9e0efc0e6cfb4545a6e27ecf020...23cbfe42f1dcc62cd12d1bd614ada7bb76280427,2,34,9,43,12,2014-03-05 20:07:58,2014-03-05 20:07:58
23cbfe42f1dcc62cd12d1bd614ada7bb76280427...ada1093e05d307ed8d8bf8d9bc0dbddb545f19e2,1,27,1,28,3,2014-03-05 20:08:32,2014-03-05 20:08:32
ada1093e05d307ed8d8bf8d9bc0dbddb545f19e2...f1efc54b38f110fee13156dc1e97be0ffbef3ac5,2,4,2,6,3,2014-03-05 20:09:48,2014-03-05 20:09:48
f1efc54b38f110fee13156dc1e97be0ffbef3ac5...b58838cd8fe7faf859d1867ae5f5675f2e40a865,1,1,1,2,1,2014-03-05 20:10:23,2014-03-05 20:10:23
b58838cd8fe7faf859d1867ae5f5675f2e40a865...879dd14d8dc990f4726172296a2befc8c8a40810,2,23,5,28,6,2014-03-05 20:20:20,2014-03-05 20:20:20
879dd14d8dc990f4726172296a2befc8c8a40810...2641df3ffd21675a9ad50c67fb69f30582ed45b1,1,17,10,27,2,2014-03-05 20:31:15,2014-03-05 20:31:15
2641df3ffd21675a9ad50c67fb69f30582ed45b1...256d2e074e2759178c5cbbbb4f13730308b8869f,1,21,11,32,6,2014-03-05 21:42:32,2014-03-05 21:42:32
256d2e074e2759178c5cbbbb4f13730308b8869f...2b8577c4633fcae3cadb8b356cc2f473e06ad18d,2,27,11,38,8,2014-03-05 22:11:00,2014-03-05 22:11:00
2b8577c4633fcae3cadb8b356cc2f473e06ad18d...80cc9df0b8ecb2db793ee7fd0b992dde80763c50,1,9,1,10,6,2014-03-05 22:13:09,2014-03-05 22:13:09
80cc9df0b8ecb2db793ee7fd0b992dde80763c50...94f4b65b4753a2d13d9a4636a52b54c17b59d5c9,1,13,3,16,4,2014-03-05 23:16:28,2014-03-05 23:16:28
94f4b65b4753a2d13d9a4636a52b54c17b59d5c9...6aa73f428991e77744c1223d38266ab901199613,1,13,1,14,3,2014-03-06 03:23:20,2014-03-06 01:04:42
6aa73f428991e77744c1223d38266ab901199613...5b0af6d5d32f3658c596e8bde681c8aee51f041f,1,53,14,67,10,2014-03-06 03:23:26,2014-03-06 03:23:26
4f7d14c1f29088fbe1eb26bd22e5ba0d7aac5385...c74dd9aa622fd5e9ea9b2decbe56fdae6969c92d,1,1,1,2,1,2014-01-06 23:14:39,2014-01-06 23:13:48
4f7d14c1f29088fbe1eb26bd22e5ba0d7aac5385...ef763011bfb889488a55892b3a5d39021ffa093c,1,12,14,26,3,2014-01-06 20:14:16,2013-11-18 17:55:08
ef763011bfb889488a55892b3a5d39021ffa093c...ae48127e4f68db22eb3f0bf3e59a9e93bd9354d3,2,55,4,59,7,2014-01-06 20:14:16,2013-11-18 23:26:08
ae48127e4f68db22eb3f0bf3e59a9e93bd9354d3...b628a71beaf29b9b76648dd876050a1071b6def2,3,95,40,135,13,2014-01-06 20:14:16,2014-01-04 02:34:38
b628a71beaf29b9b76648dd876050a1071b6def2...6d1bde1c12b557406e5a43be8e88499cfabcfe30,2,19,40,59,7,2014-01-06 20:14:17,2014-01-06 20:04:15
8152969597d39cfc3778a0a614add6601d4e14d3...8d6e2c72e5ef076606b345145b11bcd09bfc891b,1,1,1,2,1,2014-01-08 19:36:09,2014-01-08 19:31:31
8d6e2c72e5ef076606b345145b11bcd09bfc891b...bd9e5d805776448fe435ba8e002dc7cb7a8578a6,2,5,2,7,2,2014-01-08 22:42:01,2014-01-08 22:42:01
bd9e5d805776448fe435ba8e002dc7cb7a8578a6...1ee8f2aff6aef7599e5a12f134bf1048ea166c1e,3,6,3,9,3,2014-01-09 01:06:15,2014-01-08 19:26:57
a49e7def5e407e8dee6d87c5f7f4ac9b316f7e65...b42a29f6289adef9c6f400cd3b3375e4a1954936,1,2,3,5,2,2014-01-30 19:02:04,2014-01-30 19:02:04
b42a29f6289adef9c6f400cd3b3375e4a1954936...ed72f1807e28e2788b615cd8cc771bf8e88f89ed,2,2,2,4,2,2014-01-30 19:10:59,2014-01-30 19:10:59
ed72f1807e28e2788b615cd8cc771bf8e88f89ed...736cac2e423c80865cf8b7a0406951b54a683803,2,12,4,16,4,2014-01-30 19:30:55,2014-01-30 19:30:55
736cac2e423c80865cf8b7a0406951b54a683803...4b29c4040d061b08bd148e6f6f6fbc10810084f9,1,1,0,1,1,2014-01-30 19:36:48,2014-01-30 19:36:48
4b29c4040d061b08bd148e6f6f6fbc10810084f9...6f7a6d82c7d21de0ac36b11b53af52229168cc25,1,1,2,3,2,2014-01-30 19:39:19,2014-01-30 19:39:19
6f7a6d82c7d21de0ac36b11b53af52229168cc25...5ca01e736a0916fbdf3d7edce051be54e53de261,1,0,1,1,1,2014-01-31 00:13:14,2014-01-31 00:13:14
5ca01e736a0916fbdf3d7edce051be54e53de261...57095409fb933d54e8033f89eac786665b8c4726,1,5,1,6,2,2014-01-31 00:46:28,2014-01-31 00:46:28
57095409fb933d54e8033f89eac786665b8c4726...46482f51fb8e87d2c62dedfc5e343d053b721fd1,1,1,1,2,1,2014-01-31 00:47:00,2014-01-31 00:47:00
46482f51fb8e87d2c62dedfc5e343d053b721fd1...fb84f4c48b35c997212260f52dacc6a17631efd7,1,1,1,2,1,2014-01-31 00:54:14,2014-01-31 00:54:05
fb84f4c48b35c997212260f52dacc6a17631efd7...f5f42e96d5ad00dac131166c56b8380888dd8b25,1,2,1,3,1,2014-01-31 01:12:22,2014-01-31 01:12:22
f5f42e96d5ad00dac131166c56b8380888dd8b25...00a3dbeb5d2ef22a793c667950c7ad150524ff64,1,0,7,7,2,2014-01-31 01:17:18,2014-01-31 01:17:18
00a3dbeb5d2ef22a793c667950c7ad150524ff64...5323dbef3f27b83fe0f6a29c4354a6315d65397e,1,2,5,7,3,2014-01-31 01:23:58,2014-01-31 01:23:58
5323dbef3f27b83fe0f6a29c4354a6315d65397e...c26a5e13b8a67ad5f416928f60db1413ea8cd91b,1,1,1,2,1,2014-01-31 01:31:40,2014-01-31 01:31:40
c26a5e13b8a67ad5f416928f60db1413ea8cd91b...42ddda33b5335bded258c3bfccefa2125aefd351,1,0,1,1,1,2014-01-31 01:47:31,2014-01-31 01:47:31
42ddda33b5335bded258c3bfccefa2125aefd351...36c1db9e03b1677a8638678b6a80e954a86eec13,1,7,9,16,7,2014-01-31 03:05:31,2014-01-31 02:53:54
36c1db9e03b1677a8638678b6a80e954a86eec13...a20d1bd7f15f8fa089ad7af62eabb3ec5d49c54d,1,1,2,3,1,2014-01-31 18:51:11,2014-01-31 18:51:11
a20d1bd7f15f8fa089ad7af62eabb3ec5d49c54d...ddf38a72acd3b065a22db6f40916f1b5ccda15b2,1,1,1,2,2,2014-01-31 18:59:27,2014-01-31 18:59:27
ddf38a72acd3b065a22db6f40916f1b5ccda15b2...d954baeaac7ad596386a52cdaa02680f5632c6bb,2,8,4,12,3,2014-01-31 19:16:00,2014-01-31 19:16:00
d954baeaac7ad596386a52cdaa02680f5632c6bb...53220acc72770d8c3ff5fb916d745d0a54c3595c,1,2,1,3,1,2014-01-31 20:18:55,2014-01-31 20:18:55
53220acc72770d8c3ff5fb916d745d0a54c3595c...f782a514424dcdfe2ece77ca9036ec4685918681,1,2,1,3,1,2014-01-31 20:24:46,2014-01-31 20:24:46
f782a514424dcdfe2ece77ca9036ec4685918681...13b84e5c800e18ac39695a891db51460e4803553,1,3,1,4,2,2014-01-31 21:43:30,2014-01-31 21:43:30
13b84e5c800e18ac39695a891db51460e4803553...fd9c0c86410282969d3a3e7c3a9cc5e11580f884,1,1,1,2,1,2014-02-03 18:04:24,2014-02-03 18:04:24
fd9c0c86410282969d3a3e7c3a9cc5e11580f884...f36dc758b82b238666da7cf9f7f958fc5cdd156e,4,128,112,240,17,2014-02-03 18:27:08,2014-02-03 18:27:08
f36dc758b82b238666da7cf9f7f958fc5cdd156e...f6022a57c898ae735938b8eae1b0ab5243179229,3,21,8,29,7,2014-02-03 18:36:50,2014-02-03 18:36:50
f6022a57c898ae735938b8eae1b0ab5243179229...576573f68878164054a7c79bbcd78ce46fe0fe75,1,3,3,6,3,2014-02-03 18:39:48,2014-02-03 18:39:48
576573f68878164054a7c79bbcd78ce46fe0fe75...14bd4fb592560b9ac5437f802228b66dc5d82137,1,1,1,2,1,2014-02-03 18:41:55,2014-02-03 18:41:55
14bd4fb592560b9ac5437f802228b66dc5d82137...4155bd237262297d4612014943d243d7138123f8,1,6,8,14,2,2014-02-03 19:11:28,2014-02-03 19:11:28
4155bd237262297d4612014943d243d7138123f8...211021c24c1ee84e711f3b99434fcf76829fdc8a,2,34,13,47,4,2014-02-03 19:21:18,2014-02-03 19:21:18
211021c24c1ee84e711f3b99434fcf76829fdc8a...5d11ee54c27b8f7411ad8e476276cf142a7fecac,2,21,8,29,3,2014-02-03 19:39:30,2014-02-03 19:39:30
5d11ee54c27b8f7411ad8e476276cf142a7fecac...20860eb8f628385b7158fc966431062cac5c8722,1,3,3,6,3,2014-02-04 00:55:38,2014-02-04 00:53:00
20860eb8f628385b7158fc966431062cac5c8722...55928eae0ad19002ebbf1d2c60c7863610bbc1bc,1,1,1,2,1,2014-02-04 01:16:52,2014-02-04 01:16:52
55928eae0ad19002ebbf1d2c60c7863610bbc1bc...9c6ce921ac35a65e3f2567e4cce5a2f25be00aeb,1,1,1,2,1,2014-02-04 01:33:11,2014-02-04 01:33:11
9c6ce921ac35a65e3f2567e4cce5a2f25be00aeb...e595045fd667ee4a1afb8880f73f46a01bcae8e0,1,6,2,8,1,2014-02-04 19:23:56,2014-02-04 19:23:56
1c5f93322ffb7861e679b52d8c0084a934aae192...484ac965e7a2d1cbc70f0cfd359896ed8c827bad,2,8,15,23,7,2013-12-27 19:28:37,2013-12-24 01:16:27
484ac965e7a2d1cbc70f0cfd359896ed8c827bad...241ff9fa89a16dada67344707d77aa1b3719cb22,1,1,1,2,1,2013-12-28 17:39:40,2013-12-28 17:39:40
241ff9fa89a16dada67344707d77aa1b3719cb22...4484a28d629d8cd145b909782743d509ecdd089b,1,3,1,4,3,2013-12-30 23:03:00,2013-12-30 22:24:45
4484a28d629d8cd145b909782743d509ecdd089b...b44855d70d82309d5c8ddda2cc23e1fa9f885e3a,1,3,1,4,1,2014-01-01 02:38:03,2014-01-01 02:38:03
b44855d70d82309d5c8ddda2cc23e1fa9f885e3a...fde0a90b9bfd05c931ac0acc4652634864d91e21,1,6,2,8,2,2014-01-02 22:45:43,2014-01-02 22:45:43
da2a17f80df9b211bbaabb23160e506aaf1ede06...bc48deb9f95f41f69a067defc86ed7b340c2aebf,4,179,14,193,36,2014-01-16 00:55:02,2014-01-16 00:55:02
bc48deb9f95f41f69a067defc86ed7b340c2aebf...ede2e80d4828ba53764514d81270b305eb5582c2,22,76,80,156,77,2014-01-20 08:03:01,2014-01-18 02:22:59
ede2e80d4828ba53764514d81270b305eb5582c2...04ec0136740c85d3c5271cd0faef8e82c7d2509d,3,14,2,16,3,2014-01-20 08:14:17,2014-01-20 07:54:04
da2a17f80df9b211bbaabb23160e506aaf1ede06...9f6e51ebc1dca74545ab1c5855b35eba6e108e27,1,6,6,12,1,2014-01-15 14:22:18,2014-01-15 14:20:33
9f6e51ebc1dca74545ab1c5855b35eba6e108e27...df6e954b4edb7759a01f32525862955a4f0b7810,1,10,10,20,10,2014-01-15 14:22:18,2014-01-15 14:22:07
df6e954b4edb7759a01f32525862955a4f0b7810...3a99ea672bf61daa2ae5578c6b97def1b2d08f22,1,34,25,59,6,2014-01-15 15:26:40,2014-01-15 15:26:40
3a99ea672bf61daa2ae5578c6b97def1b2d08f22...cf9bc604b832995d2ff229063c5e8d5c758dee4a,4,261,251,512,13,2014-01-15 18:17:41,2014-01-15 18:17:41
cf9bc604b832995d2ff229063c5e8d5c758dee4a...f2676d90fc44b2858709be00c9cfcefb750addd0,5,83,5,88,10,2014-01-15 19:05:41,2014-01-14 22:52:00
66cbdb26367d49350234becc89268d0e55514a69...9a7dfca06d8db6d54c64936c63dc7d9c75a68591,1,4,2,6,1,2014-03-09 02:04:49,2014-03-09 02:04:49
e850fd33a3eba416f4f7d80804022842a389ae56...e14351c538ede3fe8f274f428e5930ff271280f1,5,68,703,771,38,2013-11-24 01:09:56,2013-11-24 01:05:19
e14351c538ede3fe8f274f428e5930ff271280f1...abc948604483477d8ea480a27816361943e4fc90,1,2,1,3,1,2013-11-24 01:12:49,2013-11-24 01:12:49
5889adea901ab017748ea6a0bfdb7437e0db0a7a...2413a8d3ed5ffb10e7deb20c3e6292b96e4a2a0e,5,109,57,166,14,2013-09-25 22:53:04,2013-09-24 18:35:12
ab87768a7e5bb339859d229742cd13450ef4ec1f...3a1e25f6476c0ae155a7ddbd1694a1bfd829ae22,2,23,0,23,2,2013-12-14 02:17:32,2013-12-14 02:17:32
3a1e25f6476c0ae155a7ddbd1694a1bfd829ae22...e63837d0aa1c5d4eb945fbd5fc8d87211ce27785,1,16,9,25,4,2013-12-14 02:18:23,2013-12-14 02:18:23
ab87768a7e5bb339859d229742cd13450ef4ec1f...ae2404d1f34c5ef6c7e12a83920ec539d80ebed6,1,3,2,5,2,2013-12-13 05:52:36,2013-12-13 05:52:36
ae2404d1f34c5ef6c7e12a83920ec539d80ebed6...4ba6d3f08d9f387b5e83daa11c7ea0e2e8c4b754,1,2,2,4,2,2013-12-13 07:34:22,2013-12-13 07:34:22
4ba6d3f08d9f387b5e83daa11c7ea0e2e8c4b754...1ab704be4542a54e7acf6c15635e069c1fb4af40,1,1,2,3,1,2013-12-13 07:35:09,2013-12-13 07:35:09
1ab704be4542a54e7acf6c15635e069c1fb4af40...685431fb20a2af8bcd5a8f76540f4f19d0e75443,1,2,2,4,1,2013-12-13 07:35:52,2013-12-13 07:35:52
d564ab4b99ebd3bca264f463907e038da706eb1f...5803dfbf2f241a3c2e6c0cd088f941de634166ca,4,26,19,45,9,2013-11-22 00:31:49,2013-11-22 00:31:49
5803dfbf2f241a3c2e6c0cd088f941de634166ca...f25b733bc6159d3f054223660cf17e95324e8ceb,6,22,22,44,20,2013-11-22 00:34:07,2013-11-22 00:34:07
7d4cf4ae791fbbd9ba74202cb9af33dd12b229c8...940a8f32500a58a0ef4f914bf5ccfff4d35218a5,1,11,2,13,3,2013-08-01 07:15:41,2013-07-30 22:34:35
940a8f32500a58a0ef4f914bf5ccfff4d35218a5...8aa63bcb3a5732fe30aa846f3b603a83738a282c,2,21,11,32,5,2013-08-01 07:29:14,2013-08-01 07:29:14
5b801b027a3472943df96b116619a0c11001d085...afc2759e01bc763419cdb04b865fa44b30f34111,2,87,52,139,7,2013-08-16 22:50:21,2013-08-16 22:50:21
afc2759e01bc763419cdb04b865fa44b30f34111...db187d85e26f8052d3ccf6dbdb19900e0db55534,1,1,1,2,1,2013-08-20 22:38:08,2013-08-20 22:38:08
db187d85e26f8052d3ccf6dbdb19900e0db55534...bfb2df622600e33a1fa2ad9e05987a19bbf1abda,1,5,38,43,3,2013-08-21 18:56:58,2013-08-21 18:56:58
bfb2df622600e33a1fa2ad9e05987a19bbf1abda...02a067d5c2b96254beb99d47292bee0eb558f19c,2,96,273,369,34,2013-08-24 02:12:46,2013-08-24 02:12:46
02a067d5c2b96254beb99d47292bee0eb558f19c...0e9d11131a7a4e0cf7b831eb7a87d2ed0b9584fc,1,32,17,49,2,2013-08-26 02:10:33,2013-08-26 01:48:17
0e9d11131a7a4e0cf7b831eb7a87d2ed0b9584fc...08822cb2d6538ee03d0dd735135db3e236d5bfda,4,134,137,271,30,2013-08-26 03:26:31,2013-08-26 03:26:31
08822cb2d6538ee03d0dd735135db3e236d5bfda...2ff37d14f3a35a764ec49b556e7827937dec6a74,6,136,194,330,45,2013-08-26 20:59:00,2013-08-26 20:59:00
5b801b027a3472943df96b116619a0c11001d085...16a351369bcba23878ae88fe13e84909485aee02,4,25,134,159,16,2013-08-16 22:47:06,2013-08-16 22:47:06
16a351369bcba23878ae88fe13e84909485aee02...8a8640010d117db6c9109ab6cd0883fc711bb82b,2,8,7,15,7,2013-09-12 18:53:52,2013-09-12 18:53:52
8a8640010d117db6c9109ab6cd0883fc711bb82b...a58a8ee5d42ee5ed3d149980a22dbc5e81b9d50a,3,1,2261,2262,3,2013-10-15 03:01:14,2013-10-15 03:01:14
20a1f88993279b8bdc9550b67e40fe06534b00e4...55dd8a03044f2ad071ed46c3f27c92959f0b1f73,5,5,5,10,5,2013-06-06 05:13:02,2013-06-06 05:13:02
55dd8a03044f2ad071ed46c3f27c92959f0b1f73...659cc1403bf83cbfc5d3f8b889646b29120129f1,2,8,1,9,2,2013-06-07 04:48:48,2013-06-07 04:48:48
659cc1403bf83cbfc5d3f8b889646b29120129f1...5beeaab6824700c1bf6461d6def2ee70babc4410,1,1,1,2,1,2013-06-10 18:34:35,2013-06-10 18:34:35
5beeaab6824700c1bf6461d6def2ee70babc4410...299543da7893523f40727cfa4b3d3600c6a5a0d9,5,5,5,10,5,2013-06-10 18:48:00,2013-06-10 18:48:00
20a1f88993279b8bdc9550b67e40fe06534b00e4...9e5bcd479e06b0e1f6234847c2950e4104cfdfe3,1,1,1,2,1,2013-06-05 02:01:01,2013-06-05 02:01:01
c2b2deb0d60f88d1cf9407b43f32567b25593fd5...bda5113fa5bb529a4c8be1811adef9df3a37fddb,1,3,2,5,2,2013-10-07 21:18:29,2013-10-07 21:18:29
bda5113fa5bb529a4c8be1811adef9df3a37fddb...b414cd15bbe01f94e2e2ad1a138e6dc0f0c09373,1,2,2,4,1,2013-10-07 22:12:44,2013-10-07 22:12:44
958a5475132ba24490bcaada9cd41ec1aa8ed17a...f4e21c0d375acc7fb7294c29a394f0968eefb3de,7,12,6,18,8,2013-10-21 05:02:25,2013-10-21 05:02:25
f4e21c0d375acc7fb7294c29a394f0968eefb3de...d687d974a038e2baa95bc8539fbdb2927e2b2326,2,11,2,13,5,2013-10-21 22:25:34,2013-10-21 22:25:34
d687d974a038e2baa95bc8539fbdb2927e2b2326...11a10421f7064f9c637d3090c2aa84a50cc583f9,5,5,5,10,5,2013-10-21 23:48:38,2013-10-21 23:48:38
76f611789eb1937a7c896a9921c0d39d52c8ab88...034a6b862d1920ae89c1f6b29be79e04b4fad90d,3,95,65,160,6,2013-03-29 18:52:32,2013-03-27 22:38:30
034a6b862d1920ae89c1f6b29be79e04b4fad90d...6b383db4052ef5da007a7f1e60e49dc597691c99,2,8,20,28,5,2013-03-29 18:52:32,2013-03-27 22:42:33
6b383db4052ef5da007a7f1e60e49dc597691c99...99ba22d2c4e6c102b10d954ce46aa046718d6f56,6,18,13,31,12,2013-03-29 18:52:32,2013-03-27 23:52:48
99ba22d2c4e6c102b10d954ce46aa046718d6f56...3c8f21a4091ed2a654d5c7f1902120f03018d948,9,52,33,85,21,2013-03-29 18:52:32,2013-03-28 00:32:51
3c8f21a4091ed2a654d5c7f1902120f03018d948...4e199eb07f4fd59c7fb13324f932a065c58029d8,1,24,12,36,12,2013-03-29 18:52:32,2013-03-28 01:04:06
4e199eb07f4fd59c7fb13324f932a065c58029d8...734c185a89532d1458ba5a919ec822b03ee0e4c5,7,15,9,24,15,2013-03-29 18:52:33,2013-03-28 01:14:34
734c185a89532d1458ba5a919ec822b03ee0e4c5...08efe4809094852dacb1777c730201511d278a7d,1,8,0,8,2,2013-03-29 18:52:33,2013-03-28 01:21:38
08efe4809094852dacb1777c730201511d278a7d...02b91c3dc4e08e902dfb48578d75f2bc3534baee,1,2,1,3,1,2013-03-29 18:52:33,2013-03-28 01:25:02
02b91c3dc4e08e902dfb48578d75f2bc3534baee...ace7b7f56c6de4aad64377e4fab17c06096d9504,1,3,3,6,1,2013-03-29 18:52:33,2013-03-28 01:27:21
ace7b7f56c6de4aad64377e4fab17c06096d9504...40d21e54a92480db9ba0574d7d744b1f51be4556,1,1,1,2,1,2013-03-29 18:52:33,2013-03-28 01:55:44
40d21e54a92480db9ba0574d7d744b1f51be4556...5c366a34fe62156e06c65b444548475d3b080e7c,7,72,41,113,21,2013-03-29 18:52:33,2013-03-28 02:36:44
5c366a34fe62156e06c65b444548475d3b080e7c...71b6708c66127733f13abc83f40f51168fe28ed5,4,29,45,74,18,2013-03-29 18:52:33,2013-03-28 02:42:42
71b6708c66127733f13abc83f40f51168fe28ed5...19521f56f34c88a5b6c751043218354530882b63,2,3,2,5,2,2013-03-29 18:52:33,2013-03-28 03:20:18
19521f56f34c88a5b6c751043218354530882b63...111582d7574d55899f73c6a574a03e83f56261df,2,2,8,10,3,2013-03-29 18:52:33,2013-03-28 03:53:01
111582d7574d55899f73c6a574a03e83f56261df...0eff9604fc60432f03324c060e02ad8a0117103a,4,5,4,9,4,2013-03-29 18:52:33,2013-03-28 04:34:19
0eff9604fc60432f03324c060e02ad8a0117103a...06f911a327a6d89ce082023bf1b2fd03701feab3,1,6,15,21,7,2013-03-29 18:52:33,2013-03-28 04:35:55
06f911a327a6d89ce082023bf1b2fd03701feab3...1dda5a05a32257f416e2642c1c8351eb4208e026,1,1,0,1,1,2013-03-29 18:52:33,2013-03-28 04:50:13
1dda5a05a32257f416e2642c1c8351eb4208e026...250b9b98265a5a21988bb06ecffad6cc658e592d,3,160,65,225,24,2013-03-29 18:52:33,2013-03-28 06:21:01
250b9b98265a5a21988bb06ecffad6cc658e592d...ab96ca29e8dc8e982f0fed57058986a7f2b2634e,1,6,7,13,4,2013-03-29 18:52:33,2013-03-28 06:41:54
ab96ca29e8dc8e982f0fed57058986a7f2b2634e...b38bfe299dd9167c16f37c47f3319288f821d22b,1,1,0,1,1,2013-03-29 18:52:33,2013-03-28 06:56:24
b38bfe299dd9167c16f37c47f3319288f821d22b...8d8bacd9a9265661b2aca35d9910a7f82321b7a0,5,181,54,235,23,2013-03-29 18:52:34,2013-03-28 21:04:41
8d8bacd9a9265661b2aca35d9910a7f82321b7a0...d8179cd25521b16da49ed2bfd407e71b0aa38780,2,5,1,6,3,2013-03-29 18:52:34,2013-03-28 23:24:26
d8179cd25521b16da49ed2bfd407e71b0aa38780...1ceef40beb57f0ec41972a5838d439103f36aaa3,3,13,16,29,7,2013-03-29 18:52:34,2013-03-28 23:24:43
1ceef40beb57f0ec41972a5838d439103f36aaa3...068774147c48bdc7061fb81a5f62adfef5c7de96,2,2,2,4,2,2013-03-29 18:52:34,2013-03-28 23:50:54
068774147c48bdc7061fb81a5f62adfef5c7de96...513a6f2571ebabf0489f2769cb9ad380f0103bf2,2,3,3,6,3,2013-03-29 18:52:34,2013-03-29 00:20:59
513a6f2571ebabf0489f2769cb9ad380f0103bf2...c5d9ae151a01d6117826f12d32d5f6e9e71ba249,1,3,0,3,1,2013-03-29 18:52:34,2013-03-29 00:48:00
c5d9ae151a01d6117826f12d32d5f6e9e71ba249...6935f63b2c41f311f4308f056049e9e54e5343d1,1,17,16,33,13,2013-03-29 18:52:34,2013-03-29 00:58:43
6935f63b2c41f311f4308f056049e9e54e5343d1...331654c0b8e88caa5d47cb9bb96d744d44ff9455,1,42,46,88,18,2013-03-29 18:52:34,2013-03-29 01:36:52
331654c0b8e88caa5d47cb9bb96d744d44ff9455...b6e4398aef433fa29aa7faead68f735fe0658ba3,1,2,2,4,1,2013-03-29 18:52:34,2013-03-29 17:47:39
b6e4398aef433fa29aa7faead68f735fe0658ba3...e0725400316ece7e8e717c3623dd1c3d1fc0bc31,4,90,43,133,25,2013-03-29 22:40:26,2013-03-29 22:40:26
e0725400316ece7e8e717c3623dd1c3d1fc0bc31...526320ca0558ede0ebc227a803d2e9f5717199b1,1,2,2,4,2,2013-03-29 23:09:14,2013-03-29 23:09:14
526320ca0558ede0ebc227a803d2e9f5717199b1...c28c7db3e090005b217126cd1e4b8c449f6ddcb2,1,2,3,5,1,2013-03-29 23:23:14,2013-03-29 23:23:14
c28c7db3e090005b217126cd1e4b8c449f6ddcb2...8c8fea17c474f9fd829b60008e9034f7e0e5b32b,1,1,0,1,1,2013-03-29 23:23:24,2013-03-29 23:23:24
8c8fea17c474f9fd829b60008e9034f7e0e5b32b...4df4a5e03c2b476c0efb7025d338d8612dc2a9e5,1,2,1,3,2,2013-03-29 23:26:51,2013-03-29 23:26:51
dc9f69d39feb00fdeff5b175d50763faeb3705eb...f2d9792f906174c04262160e6da66da4da74c03f,8,179,15,194,10,2013-02-13 13:12:59,2013-02-12 15:36:24
399629e941b088bbfce7bf902915491e04e43de4...f90e09fbe5bf648bffb3c485eded138dea1df2dd,2,25,11,36,5,2014-05-27 07:36:50,2014-05-27 07:36:50
399629e941b088bbfce7bf902915491e04e43de4...ec170b7c3c950d9e1bfea5776edaa64db174ebc1,1,11,0,11,1,2014-05-10 01:34:39,2014-05-10 01:34:39
399629e941b088bbfce7bf902915491e04e43de4...32496511bbd6a6819d260993af8e4df3532347f6,1,2,2,4,2,2014-05-09 21:17:47,2014-05-08 00:46:08
32496511bbd6a6819d260993af8e4df3532347f6...0fa591bc5f3702bfc72387ba4e31a6b2d0a76217,6,13,12,25,6,2014-05-09 21:18:11,2014-05-06 03:49:38
0fa591bc5f3702bfc72387ba4e31a6b2d0a76217...247ab62ebb50b66114488f56203c5a4bc4442c97,2,7,1,8,2,2014-05-09 21:21:06,2014-05-08 18:16:20
247ab62ebb50b66114488f56203c5a4bc4442c97...cdbc135e7c28f1af120bb43d5efeb2d41d119af6,1,7,0,7,1,2014-05-09 21:23:36,2014-05-09 21:23:36
cdbc135e7c28f1af120bb43d5efeb2d41d119af6...ac3086cdb54d72b2fdc2aa7a770dbac9a800aa23,1,1,1,2,1,2014-05-09 21:54:38,2014-05-09 21:54:38
ac3086cdb54d72b2fdc2aa7a770dbac9a800aa23...5dc48badef7e2e01e68c332b77399ef9c9550eed,2,6,5,11,3,2014-05-13 00:01:34,2014-05-12 23:54:12
5dc48badef7e2e01e68c332b77399ef9c9550eed...1b1a4d7c259313ebf01030d9a9bac8885a27cb42,2,2,2,4,2,2014-05-13 00:09:41,2014-05-13 00:09:41
1b1a4d7c259313ebf01030d9a9bac8885a27cb42...1b1892fadd683ac558924f100a7bdd791fdd242d,5,5,5,10,5,2014-05-13 00:14:40,2014-05-13 00:14:40
af28185676a9013fd235d567dbf948a334208f54...7c813691f2b37221b46dfa72b0a15cd751998f3b,1,1,1,2,1,2014-04-30 18:55:45,2014-04-30 18:55:45
7c813691f2b37221b46dfa72b0a15cd751998f3b...e117e7025583603399ea31a3f5331c27880eb22a,1,1,0,1,1,2014-04-30 21:03:36,2014-04-30 21:03:36
e117e7025583603399ea31a3f5331c27880eb22a...09f7cff07657c2372ad11467e290be78a4b6026a,1,1,1,2,1,2014-04-30 21:45:20,2014-04-30 21:45:20
09f7cff07657c2372ad11467e290be78a4b6026a...5137250aeed29cb1a8c56bfe143dbd344cdf9728,1,8,2,10,2,2014-05-01 00:35:04,2014-05-01 00:35:04
3df4e95845a6b30a61eb0694da1626bb3da1b4d3...13197be1368d80fa5b6dba77720bf6e80e3ca497,1,1,1,2,1,2014-05-27 20:59:25,2014-05-27 20:59:25
13197be1368d80fa5b6dba77720bf6e80e3ca497...6665735bb0bd0d94ae209c879c034f49e7c7925e,1,4,6,10,4,2014-05-27 21:20:26,2014-05-27 21:20:26
6665735bb0bd0d94ae209c879c034f49e7c7925e...e728fb344b29d21508f777df6e4e4eadac555bc8,3,36,8,44,6,2014-05-27 22:53:22,2014-05-27 22:53:22
e728fb344b29d21508f777df6e4e4eadac555bc8...acb772c6cb796605a12d8845dba1602ec737b7fa,4,46,22,68,22,2014-05-28 22:50:06,2014-05-28 22:50:06
acb772c6cb796605a12d8845dba1602ec737b7fa...97be62f7c2d9f4c664804b8f4e4a1a8d8f712e65,4,16,18,34,15,2014-05-29 21:18:40,2014-05-29 21:18:40
97be62f7c2d9f4c664804b8f4e4a1a8d8f712e65...0d36793c8d0b167dd911ca7bfdebe71af369ee54,1,6,3,9,1,2014-05-29 21:31:05,2014-05-29 21:31:05
0d36793c8d0b167dd911ca7bfdebe71af369ee54...b1781939a93d6eb123d1d6d6bd4c8944b1aacb8f,1,1,1,2,1,2014-06-02 18:28:42,2014-06-02 18:28:42
498e5722300e20a015db96bbce447883e456fe39...4a1a6816d30fe47c049d5735ec22747b73fa434e,2,3,2,5,3,2014-04-08 05:50:43,2014-04-08 05:50:43
4a1a6816d30fe47c049d5735ec22747b73fa434e...714e513b99006e413b2651e8fbc2b7cad756da39,6,7,6,13,6,2014-04-08 05:56:41,2014-04-08 05:56:41
714e513b99006e413b2651e8fbc2b7cad756da39...4b49b0614bcc056c363fbe8ce48dac46890f0d2f,4,49,49,98,8,2014-04-08 08:02:46,2014-04-08 08:00:24
498e5722300e20a015db96bbce447883e456fe39...1d3b7f9c69d060c784e91cc3f664bae62c609b25,2,2,2,4,2,2014-04-08 05:33:09,2014-04-08 05:23:41
1d3b7f9c69d060c784e91cc3f664bae62c609b25...be4d30628896a539ba97a4ded3feb24e60b752c9,2,50,28,78,5,2014-04-08 05:33:13,2014-04-08 05:24:23
2f5792acdbceac4d6c0d3ca6197d480fbca03d3b...89b087efb4dda6ee303fa16bce4226d37f714326,1,7,0,7,1,2014-04-16 06:22:06,2014-04-10 04:27:33
89b087efb4dda6ee303fa16bce4226d37f714326...5676dab4cc2d3f703386a14bf3ebdb1eac3c6838,2,3,3,6,3,2014-04-16 06:36:01,2014-04-16 06:36:01
5676dab4cc2d3f703386a14bf3ebdb1eac3c6838...a01833f74c560c6b3329b8b14e179c2617a09db8,1,4,2,6,3,2014-04-16 15:01:25,2014-04-16 14:56:10
a01833f74c560c6b3329b8b14e179c2617a09db8...93154e2221fdbfc55805b645ae9143e6f8f1bc30,1,2,2,4,2,2014-04-16 15:01:25,2014-04-16 14:57:30
93154e2221fdbfc55805b645ae9143e6f8f1bc30...440ca4cd4d2039b1704788e9e8fa35e079d538ba,1,1,1,2,1,2014-04-16 21:18:32,2014-04-16 21:18:32
440ca4cd4d2039b1704788e9e8fa35e079d538ba...f41223ba38385f7a59c88f158d626c21cfb3c70b,1,1,1,2,1,2014-04-16 21:24:13,2014-04-16 00:52:24
f41223ba38385f7a59c88f158d626c21cfb3c70b...797a080e7f4988cf4d9a0d1749266446ea96e99c,3,47,1,48,3,2014-04-17 10:00:05,2014-04-17 08:34:56
797a080e7f4988cf4d9a0d1749266446ea96e99c...ca46407e5d082067716400ec8cb3f00dae2f2905,3,42,21,63,6,2014-04-17 10:00:05,2014-04-17 09:57:56
2f5792acdbceac4d6c0d3ca6197d480fbca03d3b...f68fe75ded906610be4aefe9cf921e8e8032f7a0,4,42,2,44,10,2014-04-15 23:58:10,2014-04-15 23:58:10
dc71bd2143ded5b45b94ddcead6a7809544a5eec...42f5ff1fb9e33bc4dc73e2d8e3616521547761d4,4,10,2,12,4,2014-03-27 03:57:58,2014-03-27 03:57:58
4d45f2426057d882a225fe7fc57eba45f1d4cd26...65dc0ef6d502f1d85fead3571785d26a01197c4e,3,97,72,169,44,2014-03-22 12:15:21,2014-03-22 08:59:05
65dc0ef6d502f1d85fead3571785d26a01197c4e...d2264fffe02abb07e327e999b05b1b94d18b35da,6,486,1,487,6,2014-03-22 12:15:21,2014-03-22 12:02:41
d2264fffe02abb07e327e999b05b1b94d18b35da...40b3aa3b1d64049cf2388632c9443ce33f399e92,1,52,28,80,18,2014-03-23 08:46:16,2014-03-23 08:46:16
40b3aa3b1d64049cf2388632c9443ce33f399e92...2058753dd911c46a37a1a590d867acba4545c63b,1,24,0,24,1,2014-03-24 04:12:20,2014-03-24 04:12:20
6eff081da143537413910a043cecb20c74a3ce7b...52afbd41b56907c2da66f2353909b4add724a64e,1,60,0,60,2,2014-03-06 02:34:59,2014-03-06 02:34:59
6eff081da143537413910a043cecb20c74a3ce7b...5fbfdf3909669cb02c764c2f8849f3dfcaca0e13,1,1,0,1,1,2014-03-05 23:16:43,2014-03-05 23:16:43
5fbfdf3909669cb02c764c2f8849f3dfcaca0e13...afb0f1021097ee1b2e044651506c3abc18eab3a6,1,18,1,19,2,2014-03-06 02:30:39,2014-03-06 02:30:39
b25d765b3ef4da96bbd66dab52f3b353f4894b9f...2601b3b8ead169d9779e1644660f12835651c639,4,91,69,160,44,2014-03-11 18:50:03,2014-03-01 08:04:22
2601b3b8ead169d9779e1644660f12835651c639...ee7230dadd3b047259d3f0fc26273362673e8392,4,30,29,59,10,2014-03-11 18:50:03,2014-03-02 02:27:39
ee7230dadd3b047259d3f0fc26273362673e8392...95e4cad3c64ece9bea85de35cb217315a71dabc7,1,7,1,8,1,2014-03-11 18:50:03,2014-03-01 04:54:25
95e4cad3c64ece9bea85de35cb217315a71dabc7...ed470555268ab6c0e4842c855f60656a48af31e3,1,151,59,210,8,2014-03-11 18:50:03,2014-03-02 02:47:42
ed470555268ab6c0e4842c855f60656a48af31e3...0876ed46a2ad4ca50507c171d07ad0556a8613bf,1,72,23,95,12,2014-03-11 18:50:03,2014-03-02 04:06:08
0876ed46a2ad4ca50507c171d07ad0556a8613bf...bf32d79227f51c653f0ca77183aab94143235efb,1,26,0,26,1,2014-03-11 18:50:03,2014-03-05 20:15:12
bf32d79227f51c653f0ca77183aab94143235efb...de9d28adccafefbd064da63de0eb76fa41bd98b0,2,7,2,9,2,2014-03-11 18:50:03,2014-03-05 20:29:54
de9d28adccafefbd064da63de0eb76fa41bd98b0...e71027cb230d82653fa4684b2d1dfcac55f69b4d,1,14,0,14,3,2014-03-11 18:50:03,2014-03-05 20:33:48
e71027cb230d82653fa4684b2d1dfcac55f69b4d...571dce65a97d95bc782bf455ba1b29e2df03c564,2,21,2,23,4,2014-03-11 18:50:03,2014-03-05 20:43:33
571dce65a97d95bc782bf455ba1b29e2df03c564...102a03c1009bc5846d1b5c9d273a3ad8fbdcac79,1,11,3,14,1,2014-03-11 18:54:00,2014-03-11 18:54:00
102a03c1009bc5846d1b5c9d273a3ad8fbdcac79...2f4ccb76d13bcae67f7796be42ff1a8ce0e47890,1,15,14,29,12,2014-03-11 19:22:51,2014-03-11 19:22:45
2f4ccb76d13bcae67f7796be42ff1a8ce0e47890...70cbca849a3e6fa781e546457276606e387c41da,1,3,0,3,1,2014-03-11 23:02:56,2014-03-11 23:02:56
70cbca849a3e6fa781e546457276606e387c41da...f986a7c9fdb773b1a4e1b3a3876a33dc8ed8a095,1,6,0,6,1,2014-03-12 08:11:11,2014-03-12 08:11:11
30e69b7254a6e2971c179debe9da533275c2a36b...a4016e106e4c6942726967d93d290121388943b9,3,170,47,217,21,2014-03-07 00:15:38,2014-03-07 00:15:38
30e69b7254a6e2971c179debe9da533275c2a36b...bda396d42a34c1e164297f5f5515a7f5f67a8c11,2,50,45,95,11,2014-03-06 21:52:19,2014-03-06 21:52:19
bda396d42a34c1e164297f5f5515a7f5f67a8c11...d1b9b962abad61be10b6a7aa0b11e742603a2ecb,3,16,12,28,8,2014-03-06 22:20:35,2014-03-06 22:20:35
d1b9b962abad61be10b6a7aa0b11e742603a2ecb...085dd0b8dd9986c221d3f35cc7d2ad4202951560,1,50,20,70,14,2014-03-06 23:30:57,2014-03-06 23:30:57
085dd0b8dd9986c221d3f35cc7d2ad4202951560...9a39dac02d379090762765759fe6db8527b5947b,1,1,1,2,1,2014-03-06 23:31:38,2014-03-06 23:31:38
c74dd9aa622fd5e9ea9b2decbe56fdae6969c92d...8800564e8009a8894ee6aa6dd7efdc606faa3572,5,53,37,90,14,2014-01-07 01:02:04,2014-01-07 00:59:48
8800564e8009a8894ee6aa6dd7efdc606faa3572...add4f6e0155faa31e1e2a67454a423c387fab709,6,48,7,55,10,2014-01-07 05:16:23,2014-01-07 01:54:16
6a399dcaf018d75ab5171046614aee424c523136...0b76997e3dc815fdd02466786c059ebd811cd0e0,1,8,5,13,3,2014-01-09 23:17:37,2014-01-09 23:17:37
0b76997e3dc815fdd02466786c059ebd811cd0e0...e445a4af6aaa39aabce12edbe4a2a93fc30e6745,1,21,8,29,3,2014-01-10 00:57:49,2014-01-10 00:57:49
f2053a94cacb56a75ac1e9c34dbc90c919f7af8c...7c02e4a59dd2d80de8ec0c541575ced25290e5fb,4,4,4,8,4,2014-02-05 01:46:19,2014-02-05 01:46:19
7c02e4a59dd2d80de8ec0c541575ced25290e5fb...bea6b0b515d239c20044938f4b068547bcfb8cc1,1,4,0,4,1,2014-02-05 02:02:22,2014-02-05 02:02:22
bea6b0b515d239c20044938f4b068547bcfb8cc1...7bf9d0a0d357c5b62e7276172e1575222669309f,1,0,9,9,1,2014-02-05 02:02:55,2014-02-05 02:02:55
7bf9d0a0d357c5b62e7276172e1575222669309f...42b5b76000ee461bd59ec097ca9f0f005ba5865d,1,4,0,4,2,2014-02-05 02:06:22,2014-02-05 02:06:22
42b5b76000ee461bd59ec097ca9f0f005ba5865d...47cf0f476d8a7affa06297f8c20049cd236523ec,3,10,110,120,12,2014-02-05 02:14:51,2014-02-05 02:13:16
47cf0f476d8a7affa06297f8c20049cd236523ec...fd0f2312b2efc97b05130f7ec339d6fff1225b3a,1,3,2,5,2,2014-02-05 04:23:17,2014-02-05 04:22:17
fd0f2312b2efc97b05130f7ec339d6fff1225b3a...c3872d1dd610d95420f13ba5c197fa515c239e99,2,10,12,22,5,2014-02-05 23:52:05,2014-02-05 21:50:17
c3872d1dd610d95420f13ba5c197fa515c239e99...160c5cb9eb1fe480bf33569e461220ef092cc184,1,19,17,36,6,2014-02-05 23:52:05,2014-02-05 22:09:41
160c5cb9eb1fe480bf33569e461220ef092cc184...7bc61a347ccd4f35304f62f384f2ff51b7d70862,2,33,9,42,9,2014-02-05 23:52:05,2014-02-05 22:15:41
7bc61a347ccd4f35304f62f384f2ff51b7d70862...d218256a137cfe317f9cd4141c1bcc5ad1a29e5d,2,16,0,16,2,2014-02-05 23:52:05,2014-02-05 22:22:44
d218256a137cfe317f9cd4141c1bcc5ad1a29e5d...9ea312c10038ba23bf0ce35ff5234dbd7cb27b17,1,14,0,14,2,2014-02-05 23:52:05,2014-02-05 22:35:29
9ea312c10038ba23bf0ce35ff5234dbd7cb27b17...65addc22d6b1f163341048dab76b3cdd5bbcdde6,4,31,19,50,8,2014-02-05 23:52:05,2014-02-05 23:02:40
65addc22d6b1f163341048dab76b3cdd5bbcdde6...afdce8cccd59d094a18bb8e6b6f4746b905f3bd5,2,88,4,92,12,2014-02-05 23:52:05,2014-02-05 23:51:00
afdce8cccd59d094a18bb8e6b6f4746b905f3bd5...365db0e8be14a7ab72b1d57fb1abb69cf4190f34,1,0,13,13,1,2014-02-05 23:54:08,2014-02-05 23:54:08
365db0e8be14a7ab72b1d57fb1abb69cf4190f34...120fa974176ca6927368faa089d9dcd790a44698,1,1,1,2,1,2014-02-06 01:03:11,2014-02-06 01:03:11
120fa974176ca6927368faa089d9dcd790a44698...8ea77b5ea9b876ceb5b3073911f5cdc1babd2ff1,1,1,1,2,1,2014-02-06 01:03:27,2014-02-06 01:03:27
8ea77b5ea9b876ceb5b3073911f5cdc1babd2ff1...4f417b402a139730dbec58c1b6e08231f1d7f10c,2,48,20,68,18,2014-02-06 16:02:00,2014-02-06 07:01:31
4f417b402a139730dbec58c1b6e08231f1d7f10c...a4a83c1b31a67fd983fca4603a028bac5ed34a1b,1,10,4,14,8,2014-02-06 16:02:00,2014-02-06 07:01:48
a4a83c1b31a67fd983fca4603a028bac5ed34a1b...aabed4665cf80f6ead83eecd25856e47f672d4bf,2,18,7,25,5,2014-02-06 18:14:32,2014-02-06 18:14:32
aabed4665cf80f6ead83eecd25856e47f672d4bf...37ccddede2f903ced0310ce05c142ade880a7996,2,14,0,14,3,2014-02-06 19:19:09,2014-02-06 19:17:12
37ccddede2f903ced0310ce05c142ade880a7996...3aec2ab85fc9d56338d4817e258ed95ec987b38c,1,4,1,5,1,2014-02-06 19:22:57,2014-02-06 19:07:22
3aec2ab85fc9d56338d4817e258ed95ec987b38c...fa31ea5616dcfa588f4f7f96674ce4bbb8cc1765,1,1,2,3,1,2014-02-06 19:26:18,2014-02-06 19:25:46
fa31ea5616dcfa588f4f7f96674ce4bbb8cc1765...7f2eccecda9c7022f41611470039121e7cf2cbfa,2,14,4,18,6,2014-02-06 20:00:49,2014-02-06 20:00:49
7f2eccecda9c7022f41611470039121e7cf2cbfa...b75da89d09cf72a1714ebef4580e422131182ed5,4,14,4,18,5,2014-02-06 20:18:49,2014-02-06 20:18:49
b75da89d09cf72a1714ebef4580e422131182ed5...a74855d50a9fe2262c19f91ea50595de07f610b7,2,5,3,8,3,2014-02-06 20:32:07,2014-02-06 20:32:07
a74855d50a9fe2262c19f91ea50595de07f610b7...17040baf7ede5c9ae1e217f01d88e17b4916a488,1,6,4,10,1,2014-02-06 20:32:16,2014-02-06 20:32:16
17040baf7ede5c9ae1e217f01d88e17b4916a488...53da5183899211811254121fcb6844ffee4a446f,1,1,2,3,2,2014-02-06 20:39:50,2014-02-06 20:39:50
53da5183899211811254121fcb6844ffee4a446f...d7bbc4fdf2e0ab9f59ba762809a16d6ad6271f73,1,1,1,2,1,2014-02-06 20:47:16,2014-02-06 20:47:16
d7bbc4fdf2e0ab9f59ba762809a16d6ad6271f73...9e9de95cd58fbd476a6fe0b8eeafbe9cb9879019,2,11,1,12,3,2014-02-06 21:27:19,2014-02-06 21:27:19
9e9de95cd58fbd476a6fe0b8eeafbe9cb9879019...67bc21c0a9a76f7cd56fcd75986f3453e9919da4,2,7,2,9,3,2014-02-06 21:30:09,2014-02-06 21:30:09
67bc21c0a9a76f7cd56fcd75986f3453e9919da4...210ce19da9e6608bdc38575b313b7b46043af206,1,4,0,4,1,2014-02-06 21:34:21,2014-02-06 21:34:21
210ce19da9e6608bdc38575b313b7b46043af206...57dfff558744c4c49268cad836550419014a8bf5,1,2,1,3,1,2014-02-06 21:42:17,2014-02-06 21:42:17
57dfff558744c4c49268cad836550419014a8bf5...f82cc15083d1e59207f09cba309ebcf8fd453b99,1,2,1,3,1,2014-02-06 21:45:36,2014-02-06 21:45:36
f82cc15083d1e59207f09cba309ebcf8fd453b99...56bdb2f446674954f398316542b3c777f1d00ce1,1,8,6,14,3,2014-02-07 19:56:30,2014-02-07 19:51:10
56bdb2f446674954f398316542b3c777f1d00ce1...525ff8e342c06f0a84a4dcf0c12bb0b7f742bc1d,1,1,1,2,1,2014-02-07 19:58:20,2014-02-07 19:58:20
b3e31fc968a34bddbb10f6efa0d5f0627933ed2a...6a4fb19a8082e68d9d1b81650c0c904af8d9984e,1,2,2,4,2,2014-01-20 22:07:45,2014-01-20 22:07:45
6a4fb19a8082e68d9d1b81650c0c904af8d9984e...0a6e9c984f04b747652275e080017560c46c8d8a,1,2,1,3,1,2014-01-20 22:17:29,2014-01-20 22:17:29
0a6e9c984f04b747652275e080017560c46c8d8a...f440a117efd7ff6828c136706f483daf1bcb2f63,2,4,2,6,3,2014-01-20 22:24:28,2014-01-20 22:24:28
f440a117efd7ff6828c136706f483daf1bcb2f63...b2522aa1b480b2a13130050873aa37efae8ca46d,3,208,145,353,10,2014-01-20 23:52:12,2014-01-20 23:51:30
b2522aa1b480b2a13130050873aa37efae8ca46d...7be02508673955e261aab26373bffd26ad617222,2,35,6,41,8,2014-01-21 03:19:07,2014-01-21 03:19:07
7be02508673955e261aab26373bffd26ad617222...d0388dc30b0ccb6251922af2e1a680791ef14b13,2,23,68,91,3,2014-01-21 03:48:24,2014-01-21 03:48:24
d0388dc30b0ccb6251922af2e1a680791ef14b13...0a93fa46b95773d35a39b396edf9b3928b0b2765,1,110,95,205,7,2014-01-21 20:28:23,2014-01-21 20:28:23
0a93fa46b95773d35a39b396edf9b3928b0b2765...91cce88c912386cc632db6f39d2cf9f64d763534,1,8,0,8,1,2014-01-23 00:34:45,2014-01-22 23:43:35
91cce88c912386cc632db6f39d2cf9f64d763534...ae67643a3f2de0dd9fb8db7f7bd8e1c6fe2ba285,3,24,28,52,8,2014-01-23 00:34:56,2014-01-21 21:53:57
ae67643a3f2de0dd9fb8db7f7bd8e1c6fe2ba285...23405cd5d4ff59e0fcf6c81355ae497a31f0a32e,1,4,0,4,1,2014-01-23 03:35:44,2014-01-23 03:35:42
23405cd5d4ff59e0fcf6c81355ae497a31f0a32e...fc955af5c0f1c0f308d914a9663d759afe49254f,2,24,6,30,7,2014-01-24 04:45:09,2014-01-24 04:45:03
ac58f6d8b72b7317b5cae7fb537a410d94df7394...f97708bf193cb169d34204d5ab787105095877ab,1,13,8,21,4,2014-03-10 21:31:12,2014-03-10 21:31:12
2f0d6e0213876730b25f63044ff226541e7d9085...5096457c610dd1bf7fbab8c59c8ef4fe95f207b0,3,141,17,158,19,2013-11-25 18:57:31,2013-11-25 18:57:31
5096457c610dd1bf7fbab8c59c8ef4fe95f207b0...0b14f53ef3f4743314f115f392dfa46a5d1fda19,3,2,2,4,2,2013-11-25 20:58:13,2013-11-25 20:58:13
0b14f53ef3f4743314f115f392dfa46a5d1fda19...e946d414e1a9b6d4468d6a7cdeefae4f6215110f,1,1,1,2,1,2013-11-25 22:18:08,2013-11-25 22:17:47
e946d414e1a9b6d4468d6a7cdeefae4f6215110f...3b7ab39154e8f3b635a5cfc76ce88a3ade6fd852,2,103,0,103,8,2013-11-26 01:43:37,2013-11-26 01:43:37
3b7ab39154e8f3b635a5cfc76ce88a3ade6fd852...cb633fa8535d2d8e0d428a19d8749a5eb7a7d6a9,2,11,4,15,2,2013-11-26 01:48:19,2013-11-26 01:48:19
cb633fa8535d2d8e0d428a19d8749a5eb7a7d6a9...61b7443b58e6c25acb9cd08ddecbd9f8557dc5a4,1,58,22,80,4,2013-11-26 02:08:58,2013-11-26 02:08:58
61b7443b58e6c25acb9cd08ddecbd9f8557dc5a4...78533c48b79099640449300719d59de60dc1b1ee,1,18,3,21,5,2013-11-26 04:27:20,2013-11-26 04:27:20
78533c48b79099640449300719d59de60dc1b1ee...838bf87031ea8bb89806952a89e41e50657b4f3d,1,93,34,127,9,2013-11-26 05:47:16,2013-11-26 05:47:16
838bf87031ea8bb89806952a89e41e50657b4f3d...905aa4ff24e686631a3cd9ea2627cab953fa9419,2,4,11,15,2,2013-11-26 05:52:13,2013-11-26 05:52:13
abc948604483477d8ea480a27816361943e4fc90...f8024b49a8a1db17d3c6c111eb66cf828203fe5d,1,2,2,4,1,2013-12-02 22:11:32,2013-12-02 22:11:32
f8024b49a8a1db17d3c6c111eb66cf828203fe5d...e315bb9f03fe49f1f869e0015f3c6f562f0ebca2,2,33,1,34,2,2013-12-02 23:14:00,2013-12-02 23:13:50
e315bb9f03fe49f1f869e0015f3c6f562f0ebca2...5c92119fc6b32560e2fb178bd10da4b6228441d6,2,8,4,12,3,2013-12-02 23:54:40,2013-12-02 23:54:40
04e34670bf50580be45891850975abd84b1be4db...79d900cf65900c382bdc13d209e139a6b40e75aa,2,0,2,2,2,2013-09-26 05:35:41,2013-09-26 05:34:56
79d900cf65900c382bdc13d209e139a6b40e75aa...a6db08ce8d14edf65e355c9f307b5b8eb8afad47,1,12,13,25,2,2013-09-26 06:00:32,2013-09-26 06:00:32
a6db08ce8d14edf65e355c9f307b5b8eb8afad47...fcf6fdaa71803d9beb51d7c9965e356673df04cc,1,1,1,2,1,2013-09-26 06:28:15,2013-09-26 06:28:15
fcf6fdaa71803d9beb51d7c9965e356673df04cc...0559491e875a64d773a4fdc61857f455e30117a3,2,26,3,29,6,2013-09-26 18:36:36,2013-09-26 18:33:42
0559491e875a64d773a4fdc61857f455e30117a3...bad4c097c24eaf13d0045898c85b94669fc99003,1,1,1,2,1,2013-09-26 19:06:11,2013-09-24 19:31:21
bad4c097c24eaf13d0045898c85b94669fc99003...c8308cdf9fcdf49bb91011e0b7ac9071a79f565d,1,1,0,1,1,2013-09-26 20:48:01,2013-09-26 20:48:01
04e34670bf50580be45891850975abd84b1be4db...115164e4af84095e9399f4f04458906801ac8b85,1,4,0,4,1,2013-09-26 04:36:27,2013-08-18 01:35:40
115164e4af84095e9399f4f04458906801ac8b85...d855e58f9220e8ee772c1b414777282291bff084,5,41,4,45,5,2013-09-26 21:50:55,2013-09-26 03:41:37
ad5f3fff45a2aa21906444f92bc0fa451ef52b5b...4aa5eb181aa05b0d342aa1748171b8b22d7f1e58,1,30,7,37,7,2013-12-15 03:42:20,2013-12-15 03:42:20
4aa5eb181aa05b0d342aa1748171b8b22d7f1e58...9780c5b8af7e5b94dd236ec403db10e9e919a1cc,1,9,5,14,2,2013-12-16 04:22:10,2013-12-16 04:22:10
9780c5b8af7e5b94dd236ec403db10e9e919a1cc...63c7aecbda74ba2a7ac7ef887714c4b6a27df042,1,1,1,2,1,2013-12-16 22:32:33,2013-12-16 22:32:33
63c7aecbda74ba2a7ac7ef887714c4b6a27df042...c1f9b423c5f2419a7ade18f7507b654176c53c85,1,5,3,8,2,2013-12-17 00:16:53,2013-12-16 03:10:20
ed5971b08efdc477e873958cc9863fd2b01da079...4a8bbce814eff74881871e25a28e1a6b4670c802,1,1,0,1,1,2013-11-22 00:52:23,2013-11-22 00:52:23
4a8bbce814eff74881871e25a28e1a6b4670c802...b2b5e323eb9c0fd06cbead7eb8fb8866cec9c0b0,1,2,1,3,1,2013-11-26 01:16:57,2013-11-26 01:16:57
b2b5e323eb9c0fd06cbead7eb8fb8866cec9c0b0...db59ab13c1ce0700bdc0cdf423fb66b3b2be2226,1,16,1,17,1,2013-11-26 23:05:18,2013-11-26 22:58:05
db59ab13c1ce0700bdc0cdf423fb66b3b2be2226...7372c4cd055a6dd3eadf69946819f0bd6c7c6a9d,1,2,0,2,1,2013-11-26 23:34:03,2013-11-26 23:34:03
7372c4cd055a6dd3eadf69946819f0bd6c7c6a9d...e58156bd588419cdf8a72945b0fcd6dae7d5586a,1,31,6,37,3,2013-11-27 23:28:28,2013-11-27 23:28:09
2c356d2b15259a6ee297cb3a4880745157a7c652...360e654f63b155492c561cc6eaa9e76be42a7be6,1,8,5,13,1,2013-08-01 19:17:45,2013-08-01 19:17:45
11a10421f7064f9c637d3090c2aa84a50cc583f9...7e39e8ca8fe5302be9e866c967eafcc4d8ba5a19,1,20,26,46,9,2013-11-01 21:26:40,2013-10-22 23:10:57
7e39e8ca8fe5302be9e866c967eafcc4d8ba5a19...8fe59c741de1feb7294021847061464d67eb0eba,1,18,8,26,10,2013-11-01 21:26:48,2013-10-23 00:58:07
8fe59c741de1feb7294021847061464d67eb0eba...c2d1b397914a1da72d8b6bcfc967f441ab416f12,1,1,0,1,1,2013-11-01 21:27:08,2013-10-23 01:20:38
c2d1b397914a1da72d8b6bcfc967f441ab416f12...b55eb265d485220d865dbe21a43df08397b8bb8e,1,10,0,10,1,2013-11-01 21:30:42,2013-11-01 21:30:42
b55eb265d485220d865dbe21a43df08397b8bb8e...faeca0871116ad76bca81204249555f80bf40c61,1,3,2,5,2,2013-11-01 22:59:16,2013-11-01 22:59:16
faeca0871116ad76bca81204249555f80bf40c61...f8bd4910b2acf436f9c40fd1d2694ee2aa2d9e3c,1,3,0,3,1,2013-11-01 22:59:42,2013-11-01 22:59:42
f8bd4910b2acf436f9c40fd1d2694ee2aa2d9e3c...3dedfc6083d4cddaa2a8e217ac8a5aa3a3cc85fe,1,4,4,8,2,2013-11-04 20:01:00,2013-11-04 20:01:00
3dedfc6083d4cddaa2a8e217ac8a5aa3a3cc85fe...317d471693fce6bdfa8f5b3a366f04f63e867602,1,1,1,2,1,2013-11-04 20:14:21,2013-11-04 20:14:21
317d471693fce6bdfa8f5b3a366f04f63e867602...8ab1e9631a8e87486b64890c109ab4dfbdfb0f31,1,1,1,2,1,2013-11-04 23:15:19,2013-11-04 23:15:19
02ce3241851423308d72ec4761aa783c47f8ced8...8e550dfe9aad90f53f37dcdfd5122ac2271ea251,1,2,0,2,2,2013-03-30 01:03:02,2013-03-30 01:03:02
8e550dfe9aad90f53f37dcdfd5122ac2271ea251...8ed6e807717f040263f4d265f688bda9a16e51be,4,74,30,104,9,2013-03-30 01:30:17,2013-03-30 01:30:17
8ed6e807717f040263f4d265f688bda9a16e51be...de753799badba784ed181a0b2d0eb5a2a8d14ce1,1,1,1,2,1,2013-03-30 01:54:35,2013-03-30 01:54:35
de753799badba784ed181a0b2d0eb5a2a8d14ce1...55fbe16acf958b0767020785a409ff491fc22a2a,1,1,1,2,1,2013-03-30 04:45:53,2013-03-30 04:45:53
55fbe16acf958b0767020785a409ff491fc22a2a...912e36ad3fa4bb422468ac2ed887e9161cc90301,1,3,2,5,2,2013-03-30 05:21:04,2013-03-30 05:21:04
912e36ad3fa4bb422468ac2ed887e9161cc90301...fe1d61db4077675bf8d6d9a21731c1215aee75ed,1,31,15,46,9,2013-03-30 05:27:51,2013-03-30 05:27:51
fe1d61db4077675bf8d6d9a21731c1215aee75ed...081a517baab1f2d0fd7c693bfb5d3a12669013e5,1,2,4,6,1,2013-03-30 05:37:27,2013-03-30 05:37:27
081a517baab1f2d0fd7c693bfb5d3a12669013e5...e989706d51fba7e8d7b06d0d670699b65081b4b1,1,17,11,28,5,2013-03-30 05:41:57,2013-03-30 05:41:57
e989706d51fba7e8d7b06d0d670699b65081b4b1...d9af3c210d7333b513aea2e9b6e088d7e7526d80,1,1,1,2,1,2013-03-30 05:43:38,2013-03-30 05:43:38
d9af3c210d7333b513aea2e9b6e088d7e7526d80...88dedc5503c3c24f665e9e13fd3e558685968b1f,1,2,4,6,3,2013-03-30 05:49:53,2013-03-30 05:49:53
88dedc5503c3c24f665e9e13fd3e558685968b1f...421bd951c77fad18447af3b5d40297773d0ef76c,1,1,2,3,2,2013-03-30 05:57:12,2013-03-30 05:57:12
ec4b9fb3e8be597b4de13f6aa8621f237135a5d8...e4ebeda1759118a6ac5e7ff3d2ffae97e0d3898a,2,6,1,7,3,2014-05-27 23:09:57,2014-05-27 22:59:38
e4ebeda1759118a6ac5e7ff3d2ffae97e0d3898a...b63328c4e95e4d3438c57f058c96a6f4103f669b,4,109,6,115,10,2014-05-27 23:43:44,2014-05-27 23:40:12
c8bfff8959d6676721fbdf8dd100d3857ad664f1...910f75f35946d86db690abab28e4f9868f2776ba,3,16,1,17,3,2014-05-13 18:27:19,2014-05-13 18:27:19
de9188f1e8a80aa5179e9c12c902be04bee6a237...9187c554c02a8dd01fc6a2cb7447cc51f4362adb,3,33,23,56,12,2014-05-01 20:57:35,2014-05-01 20:57:35
9187c554c02a8dd01fc6a2cb7447cc51f4362adb...f2e2a781ccdab271b02ceb0a7267f2e7274a8d97,7,12,13,25,9,2014-05-02 17:59:37,2014-05-02 17:59:37
f2e2a781ccdab271b02ceb0a7267f2e7274a8d97...0c479a238bdfb1928228f0fa6e748fc49251a6c8,6,13,12,25,6,2014-05-06 03:51:15,2014-05-06 03:49:38
0c479a238bdfb1928228f0fa6e748fc49251a6c8...74bcb916b4805e76ca1ca7bd03cb555444d8fe08,2,10,0,10,2,2014-05-06 21:11:40,2014-05-06 21:11:40
74bcb916b4805e76ca1ca7bd03cb555444d8fe08...e5b5858203ab726d09086e707392c4e6aff6ab86,1,22,12,34,6,2014-05-07 03:24:57,2014-05-07 03:22:51
e5b5858203ab726d09086e707392c4e6aff6ab86...08cf1e097411df48fcb37defd772dc6bb47094ca,1,0,11,11,1,2014-05-08 00:31:29,2014-05-08 00:31:29
08cf1e097411df48fcb37defd772dc6bb47094ca...50b7f1292298b219779c7f03538e818b768b6eea,1,2,2,4,2,2014-05-08 00:46:08,2014-05-08 00:46:08
50b7f1292298b219779c7f03538e818b768b6eea...3431c66c1648161dd1072aa50df52e61967c7d99,11,11,11,22,11,2014-05-08 00:51:09,2014-05-04 20:31:03
3431c66c1648161dd1072aa50df52e61967c7d99...d22a10cf1c87d9e96a7b62c1bcc048bcb72a059d,1,1,1,2,1,2014-05-08 00:55:07,2014-05-04 21:00:07
d22a10cf1c87d9e96a7b62c1bcc048bcb72a059d...819bdb31b0bd22e04e5bffb1b5719938777340d3,1,1,1,2,1,2014-05-08 00:55:08,2014-05-04 21:11:27
819bdb31b0bd22e04e5bffb1b5719938777340d3...27d9959326c244f37e00e85cac17f910bbf090fc,1,1,0,1,1,2014-05-08 01:04:29,2014-05-08 01:04:29
5137250aeed29cb1a8c56bfe143dbd344cdf9728...94074c0dcdb902ef575834604eabe003ad692435,2,4,3,7,3,2014-05-01 01:03:53,2014-04-29 23:18:47
94074c0dcdb902ef575834604eabe003ad692435...314c8a1a3464e368aef4ce17172af83e11a52515,3,15,12,27,9,2014-05-01 01:03:53,2014-04-30 18:45:30
314c8a1a3464e368aef4ce17172af83e11a52515...000c71ec303358ecf414ea354cbe776be3418a54,2,8,4,12,4,2014-05-01 01:03:53,2014-04-30 20:35:37
000c71ec303358ecf414ea354cbe776be3418a54...e0fcd2c2ed0eec9c6f3dc9d07fb70cc0bc78655b,3,11,9,20,5,2014-05-01 01:03:54,2014-05-01 01:02:53
fe13c30bfdd3e0f1ae1c9ee51c0c3d38ae35c27c...a8869d07ec4fc7771b82e83d632023a331be076a,2,22,2,24,2,2014-04-22 22:52:52,2014-04-22 22:52:52
a8869d07ec4fc7771b82e83d632023a331be076a...3ad2a70a03228a9a7681dc64fd7d286c6accaee6,3,4,4,8,3,2014-04-23 04:29:32,2014-04-23 04:29:32
3ad2a70a03228a9a7681dc64fd7d286c6accaee6...471f09cbce1e8cf49d69a1d20fef47d42f9bdb97,1,4,2,6,1,2014-04-23 04:39:46,2014-04-23 04:39:46
471f09cbce1e8cf49d69a1d20fef47d42f9bdb97...d7a4e65226a7fa585c41a04991a59ef3c6741e3c,2,78,14,92,15,2014-04-23 19:53:12,2014-04-23 19:53:12
d7a4e65226a7fa585c41a04991a59ef3c6741e3c...47b022841b40f5ca37adccc778ade373559519e5,11,560,56,616,65,2014-04-23 23:05:32,2014-04-23 23:04:15
55363a9b86c26d9d1804d9e828b576e6d12179c5...20f2ec4226ad54e6723edfd8f9fddb704c7866ee,2,11,19,30,9,2014-04-22 18:41:55,2014-04-22 18:41:55
20f2ec4226ad54e6723edfd8f9fddb704c7866ee...326180ce0a07984e821001f7aede652a76cc68a6,2,11,11,22,9,2014-04-22 18:44:13,2014-04-22 18:44:13
b1781939a93d6eb123d1d6d6bd4c8944b1aacb8f...47211cb46d19b4e78eefc74775710cf885da22b9,1,16,12,28,6,2014-06-03 23:57:47,2014-06-03 23:54:56
b1781939a93d6eb123d1d6d6bd4c8944b1aacb8f...d6adffff8b648db21532ca33e7c5a7d50e14f421,3,22,12,34,7,2014-06-03 22:14:29,2014-06-03 22:12:40
9cee4d226562c03bf0e27f8ab5016b0adcd3d279...34581338f0c4cf29643d35a1a6909e457180b35d,1,0,118,118,1,2014-04-09 06:53:05,2014-04-09 06:53:05
34581338f0c4cf29643d35a1a6909e457180b35d...cef1ae8d8835928985762c6914c3579a295f4f7f,2,58,55,113,5,2014-04-09 18:57:56,2014-04-09 18:32:37
cef1ae8d8835928985762c6914c3579a295f4f7f...204a2c7eb53d8ec3d64f3bd207c21f7e412d01eb,1,60,21,81,7,2014-04-09 18:57:56,2014-04-09 18:56:22
204a2c7eb53d8ec3d64f3bd207c21f7e412d01eb...0fb3c916efbceee285d76582d2d6a896680a5e77,1,1,1,2,1,2014-04-09 18:57:56,2014-04-09 18:56:48
0fb3c916efbceee285d76582d2d6a896680a5e77...5345a0c78a66da60bd9b9595c9f469bd208587f2,1,1,0,1,1,2014-04-10 17:16:01,2014-04-10 17:16:01
5345a0c78a66da60bd9b9595c9f469bd208587f2...f63aeee8ebf8a289e2b35df309ca090e6826cd4d,1,1,1,2,1,2014-04-10 21:38:31,2014-04-10 21:38:31
f63aeee8ebf8a289e2b35df309ca090e6826cd4d...e91713d909740d35e162a120a635b3d09775a4cd,2,8,2,10,4,2014-04-10 21:54:58,2014-04-10 21:48:29
e91713d909740d35e162a120a635b3d09775a4cd...42bfb46e46ffce2b76b5528e828d4712b3e6bf9f,2,2,2,4,2,2014-04-10 23:56:31,2014-04-09 22:15:37
42bfb46e46ffce2b76b5528e828d4712b3e6bf9f...24a0006c1452bdba877e0cca7d591f6cc02ed50e,3,48,8,56,7,2014-04-10 23:56:31,2014-04-10 00:52:55
24a0006c1452bdba877e0cca7d591f6cc02ed50e...1d5da6b4390512857f222f3e8959dc5dda505093,3,394,143,537,51,2014-04-10 23:56:31,2014-04-03 02:45:23
1d5da6b4390512857f222f3e8959dc5dda505093...72c9657b0e8a7b209ded1df67f22dd80e2fab0a2,6,127,1,128,6,2014-04-10 23:56:32,2014-04-10 04:43:09
72c9657b0e8a7b209ded1df67f22dd80e2fab0a2...d2fd710b66ffc6d8d8f5dd3af50ac2d2c6b8f224,2,13,1,14,5,2014-04-10 23:58:33,2014-04-10 20:23:12
d2fd710b66ffc6d8d8f5dd3af50ac2d2c6b8f224...25cef61447e1871babb046c2508852c2916abc74,1,6,1,7,1,2014-04-11 00:06:54,2014-04-11 00:06:54
9cee4d226562c03bf0e27f8ab5016b0adcd3d279...d365f052f5042e7b6242e2f9f4d39b7f24a61123,36,568,103,671,110,2014-04-08 22:57:58,2014-04-08 22:43:24
d365f052f5042e7b6242e2f9f4d39b7f24a61123...83af2e2179a58b9f65a4c8e076bf8db656a82970,25,188,90,278,50,2014-04-10 18:26:44,2014-04-10 17:36:35
83af2e2179a58b9f65a4c8e076bf8db656a82970...6329d7f2d06276f68ab4821bd8070f15d92d7e39,2,53,17,70,6,2014-04-10 22:29:12,2014-04-10 22:29:12
f7bbbe8ff72e58127f8e6e35625830049f6d8ceb...e544a8e03aeccb1cb1907a04c0444c013760bd78,13,45,20,65,19,2014-04-17 23:12:16,2014-01-29 07:07:49
e544a8e03aeccb1cb1907a04c0444c013760bd78...9e42f5b37ae69e7614724a7a4b69d66cf3abdc68,1,12,3,15,1,2014-04-17 23:12:24,2014-02-12 07:29:26
9e42f5b37ae69e7614724a7a4b69d66cf3abdc68...cc667a487f0f32cf592df14aae80f45d0b3b6d84,1,3,3,6,2,2014-04-17 23:12:24,2014-04-17 23:08:44
cc667a487f0f32cf592df14aae80f45d0b3b6d84...28b204f3657b2af55b0706122053e9a3e3729a6d,1,3,0,3,1,2014-04-17 23:12:24,2014-04-17 23:10:18
42f5ff1fb9e33bc4dc73e2d8e3616521547761d4...4a328d0004f9d788c416edd7cbe2d551d607d19d,1,1,1,2,1,2014-03-27 16:30:46,2014-03-27 16:30:46
4a328d0004f9d788c416edd7cbe2d551d607d19d...c89f5fd03045f619a0b3c752cbc11d81bc6cbf4c,1,2,2,4,2,2014-03-27 17:02:57,2014-03-27 17:02:57
c89f5fd03045f619a0b3c752cbc11d81bc6cbf4c...172f709a5ff5f1186455604b90d8b45d64cba8f9,3,32,11,43,6,2014-03-27 18:10:30,2014-03-27 17:57:55
3b21c2d9a70b98a94182ade4ba5a76b1ddd4c46d...4a3b24af3d836600f8a5fd038e4f99c96c66d119,1,4,1,5,1,2014-05-02 21:28:52,2014-05-02 21:28:52
cdaa8aa2301bde0954b0fe24125aba5067b87733...4be28c1ca374381758f53ad353e8a5d154bd12b8,1,1,0,1,1,2014-03-21 22:34:58,2014-03-21 22:34:58
4be28c1ca374381758f53ad353e8a5d154bd12b8...0197ff0bfc3c26854210480e4a45c33dacbb561f,1,47,26,73,9,2014-03-24 21:44:07,2014-03-24 21:44:07
0197ff0bfc3c26854210480e4a45c33dacbb561f...d3f768717ac745a75bbe23444e2159c121777673,2,32,0,32,4,2014-03-24 21:56:38,2014-03-24 21:56:38
d3f768717ac745a75bbe23444e2159c121777673...8ad25b5a6fa41802fa61b055c4c63fcd7569df5c,1,1,0,1,1,2014-03-25 05:34:51,2014-03-25 05:34:51
8ad25b5a6fa41802fa61b055c4c63fcd7569df5c...3f6ee74abdef40503d9e194c34fdc96d101608c9,1,3,3,6,3,2014-03-25 16:57:43,2014-03-25 16:57:43
3f6ee74abdef40503d9e194c34fdc96d101608c9...4368309b3f810b4031b3d86a609d89b0a18c5f25,2,130,110,240,12,2014-03-25 17:04:42,2014-03-25 16:59:50
4368309b3f810b4031b3d86a609d89b0a18c5f25...074f140ca747a2b2deb3dc4a1bc64ca051f4e242,1,8,4,12,4,2014-03-25 17:09:28,2014-03-25 17:08:11
074f140ca747a2b2deb3dc4a1bc64ca051f4e242...2e0b54e038ee8c14c29fead973f5087b1b220393,4,100,31,131,19,2014-03-25 17:59:51,2014-03-25 17:59:51
2e0b54e038ee8c14c29fead973f5087b1b220393...a9c47e466215fe43f4628647f0cf3fe9974d3af1,1,5,2,7,1,2014-03-25 18:14:12,2014-03-25 18:14:12
a9c47e466215fe43f4628647f0cf3fe9974d3af1...f9357c077514853ce49ae40415e254965f6bf6c5,2,4,3,7,4,2014-03-26 21:35:09,2014-03-26 21:35:09
f9357c077514853ce49ae40415e254965f6bf6c5...06e4f062b9f2c028dbfb95ed8006ad1c087f785f,1,9,2,11,3,2014-03-26 21:43:17,2014-03-26 21:43:17
06e4f062b9f2c028dbfb95ed8006ad1c087f785f...55d8e03978e738ae652a7cc6cf1cbe1e0b32ad3c,1,2,0,2,1,2014-03-26 22:06:14,2014-03-26 22:06:14
3fe2045b6d1f7f522e1001f351b9f8982db0d18a...98b6ff0b50a9eb73edfd0bf2c20aa9501fb645a8,1,5,1,6,3,2014-03-06 07:43:32,2014-03-06 07:43:32
afb0f1021097ee1b2e044651506c3abc18eab3a6...8c234d5fd1763b64c7fffd7162e0c2f955bfab47,3,40,18,58,17,2014-03-06 02:52:24,2014-03-05 23:53:28
8c234d5fd1763b64c7fffd7162e0c2f955bfab47...3aea55d2d85f5ac4d0e3b39df6788c4a5f04a7a6,1,13,0,13,5,2014-03-06 02:52:24,2014-03-06 00:42:50
3aea55d2d85f5ac4d0e3b39df6788c4a5f04a7a6...c339c6b516e6d8494028210cf01c8ff37c7f462c,2,83,32,115,15,2014-03-06 02:52:24,2014-03-06 02:51:00
c339c6b516e6d8494028210cf01c8ff37c7f462c...c84d83a3aee65e3530d041554228f77e2e5c8b9d,1,1,1,2,1,2014-03-06 03:32:17,2014-03-06 03:32:17
c84d83a3aee65e3530d041554228f77e2e5c8b9d...c26bbcda883f879a1b089a2912ad42cc1473ab02,3,119,53,172,12,2014-03-06 07:26:23,2014-03-06 07:26:23
c26bbcda883f879a1b089a2912ad42cc1473ab02...7ee9a90e8acb4b51741dc166d51f63b388b0b407,2,21,0,21,6,2014-03-06 07:33:06,2014-03-06 07:05:25
7ee9a90e8acb4b51741dc166d51f63b388b0b407...9648654eb3e3c5d1e27a1d4a91a587b982e2863a,2,21,7,28,5,2014-03-06 07:33:06,2014-03-06 07:23:47
9648654eb3e3c5d1e27a1d4a91a587b982e2863a...c268e36505d96b4bb8ac30e85a108b645560d380,2,15,0,15,2,2014-03-06 07:33:06,2014-03-06 07:27:53
c268e36505d96b4bb8ac30e85a108b645560d380...dc9861e4d74c2c952bc581c95126caf32413eb1b,1,1,1,2,1,2014-03-06 07:41:11,2014-03-06 07:41:11
67da1aa8c39172df033970a2d132f6306160b55c...01aec7a4720ec359a313675709b3a10bcd2794be,9,153,61,214,20,2014-03-12 18:16:07,2014-03-12 18:16:07
01aec7a4720ec359a313675709b3a10bcd2794be...4786cc0d195cc24cc44459164724451b0b5db3cb,1,13,3,16,4,2014-03-12 20:26:45,2014-03-12 20:26:45
4786cc0d195cc24cc44459164724451b0b5db3cb...e9d7ba92eeb6974e3a07cab42839ec7bfc833308,9,138,107,245,18,2014-04-03 00:03:49,2014-04-03 00:03:49
e9d7ba92eeb6974e3a07cab42839ec7bfc833308...53a7e818dc3d6829e3f931e36f7e2896c8be2e09,1,1,0,1,1,2014-04-03 20:10:24,2014-04-03 20:10:24
f0b692679e055af83f7d4ce4dbe798a6ae27acdc...af4bf909fd8878a30a5bf4f1804f579acfbb0317,1,2,1,3,1,2014-03-11 08:37:58,2014-03-11 08:37:58
af4bf909fd8878a30a5bf4f1804f579acfbb0317...6625462ec27a3e99e70cf029ce39e9bc2568f909,1,4,0,4,1,2014-03-11 08:43:46,2014-03-11 08:43:46
6625462ec27a3e99e70cf029ce39e9bc2568f909...59a03b6e65b3d24a84e6b8279d051ec15932353a,1,11,6,17,3,2014-03-12 07:32:52,2014-03-12 07:32:52
59a03b6e65b3d24a84e6b8279d051ec15932353a...d920f4c7e24a274f7ee30ccc3d0a3a83759303c8,3,75,14,89,6,2014-03-12 09:41:30,2014-03-12 09:41:30
d920f4c7e24a274f7ee30ccc3d0a3a83759303c8...14856d5600fc8212ce6187ffe560abed1d67698f,2,3,3,6,3,2014-03-12 22:53:03,2014-03-12 22:51:10
14856d5600fc8212ce6187ffe560abed1d67698f...e67b56ee538700a20467e6a9270264dd1718293e,1,1,1,2,1,2014-03-12 23:51:49,2014-03-12 23:51:49
e67b56ee538700a20467e6a9270264dd1718293e...0a5d1050273c34cc0797a44349f7dbc75170bc21,2,10,7,17,4,2014-03-12 23:59:08,2014-03-12 23:59:08
93c831b74e26bc177941802014473c36dc70b8ec...b9370da58d61e09207214540f049cfef56eb1e12,1,4,4,8,1,2014-03-11 01:46:31,2014-03-11 01:43:51
b9370da58d61e09207214540f049cfef56eb1e12...b2bb353a10e20102f6864653c92f50c4e58e91f7,4,29,9,38,7,2014-03-13 21:06:24,2014-03-13 21:06:24
b2bb353a10e20102f6864653c92f50c4e58e91f7...1d3a840372a1d1db6e212d38621288b6cc42a1c7,1,9,9,18,9,2014-03-13 21:45:29,2014-03-13 21:45:29
1d3a840372a1d1db6e212d38621288b6cc42a1c7...b97d9e143a718a4b4ef47b65295236b714165509,3,12,29,41,10,2014-03-17 22:09:52,2014-03-17 22:09:52
b97d9e143a718a4b4ef47b65295236b714165509...6282e42b1dcf9ad6964d416d794ff9c1b05a6f39,2,57,0,57,2,2014-03-17 22:24:14,2014-03-17 22:24:14
9a39dac02d379090762765759fe6db8527b5947b...42b317f4dbdde085dc3a02bab015b0e764ff31c5,1,23,11,34,11,2014-03-07 00:20:22,2014-03-07 00:20:22
42b317f4dbdde085dc3a02bab015b0e764ff31c5...8049f8175811c0744b19685710fb0abb5a7eff72,1,10,1,11,2,2014-03-07 00:21:17,2014-03-07 00:21:17
add4f6e0155faa31e1e2a67454a423c387fab709...f7c3e7621c5ec95c56bd1802013cbe4f55da6764,1,2,2,4,1,2014-01-08 00:29:49,2013-12-26 06:32:29
f7c3e7621c5ec95c56bd1802013cbe4f55da6764...cc1d47b5c5950e9b40da5c92c7504fa01034af07,1,2,1,3,1,2014-01-08 00:34:25,2014-01-08 00:34:18
d19e1f7b3d18f550f84a9c15c1599aeaf5fdb9c0...4b34feb0a9569312277565b3875369d2833e8aa2,1,1,1,2,1,2014-01-11 00:44:45,2014-01-11 00:44:45
93836e7ef322c01e2496287d4e130df430581f15...aa4df6f274954b8d8df29144eee4a7336b6dabef,3,4,2,6,4,2014-02-08 01:55:46,2014-02-08 01:55:46
aa4df6f274954b8d8df29144eee4a7336b6dabef...b02857e4f2f64634d4a2a6efd239597151f03b3d,3,25,3,28,7,2014-02-08 02:10:01,2014-02-08 02:10:01
b02857e4f2f64634d4a2a6efd239597151f03b3d...153d84cb9f939351ad96431de7414819ee8c2a9a,2,7,6,13,5,2014-02-08 02:26:29,2014-02-08 02:24:50
153d84cb9f939351ad96431de7414819ee8c2a9a...4f71c565316af4070b6e901c69f3ca07e2a42808,1,4,6,10,4,2014-02-08 03:00:04,2014-02-08 02:58:15
4f71c565316af4070b6e901c69f3ca07e2a42808...1d391ee7a9760a964faf09c5cb29a59369f777fe,1,1,2,3,2,2014-02-08 03:02:22,2014-02-08 03:02:22
1d391ee7a9760a964faf09c5cb29a59369f777fe...38734b94e60896bf1ecdf5fbd7e71d0ad626d0b2,1,16,9,25,9,2014-02-09 00:25:29,2014-02-09 00:21:42
38734b94e60896bf1ecdf5fbd7e71d0ad626d0b2...5ecbbd65e15c6655f6c8cdea11c28f3e05793a9e,1,62,2,64,3,2014-02-09 01:26:26,2014-02-09 01:26:26
5ecbbd65e15c6655f6c8cdea11c28f3e05793a9e...b771f4042e1000983630ac1fa21151d6def31e12,3,102,45,147,15,2014-02-10 01:15:26,2014-02-10 01:14:53
b771f4042e1000983630ac1fa21151d6def31e12...4a9ae7ae19ee01e3441e54d8ace5e30d30acc870,1,6,3,9,4,2014-02-10 01:22:14,2014-02-10 01:22:14
4a9ae7ae19ee01e3441e54d8ace5e30d30acc870...d68df9bb40df5399a8329cdbfdd472c5f6ddaa60,1,10,8,18,5,2014-02-10 23:30:01,2014-02-10 23:30:01
d68df9bb40df5399a8329cdbfdd472c5f6ddaa60...b04281763e8af3cec2dd708f43f763ec9d775185,1,10,1,11,2,2014-02-11 03:12:52,2014-02-10 23:24:48
b04281763e8af3cec2dd708f43f763ec9d775185...d7cc7142d088825fb93b5edde4fc62c8448167ec,2,65,31,96,35,2014-02-11 03:12:52,2014-02-10 23:57:19
d7cc7142d088825fb93b5edde4fc62c8448167ec...5306fee89d844ca88c385e62e721457dc57009b3,1,4,1,5,1,2014-02-11 03:25:45,2014-02-11 03:25:45
5306fee89d844ca88c385e62e721457dc57009b3...212d380d85aba66933d7b61897bc34c2f8afa34e,1,1,1,2,1,2014-02-11 03:26:02,2014-02-11 03:26:02
212d380d85aba66933d7b61897bc34c2f8afa34e...b38322e72e38a319548bdd5834cb129cb403a0ec,1,133,0,133,1,2014-02-11 06:31:54,2014-02-11 06:31:54
b38322e72e38a319548bdd5834cb129cb403a0ec...c300f50fab56c8c39503f84b46fe0983cba89cf0,1,0,1,1,1,2014-02-11 06:33:33,2014-02-11 06:33:33
c300f50fab56c8c39503f84b46fe0983cba89cf0...58a27d123c3402629b9d136164a609259c2b0e96,5,78,10,88,16,2014-02-11 08:17:22,2014-02-11 07:49:52
58a27d123c3402629b9d136164a609259c2b0e96...aee1fb9dec31f33be88a0c4093ce3a62ba914842,1,19,3,22,4,2014-02-11 08:26:51,2014-02-11 08:26:51
aee1fb9dec31f33be88a0c4093ce3a62ba914842...10badc34e9e22fca2a467140ab345e2f3d3e6de3,1,1,1,2,2,2014-02-11 08:29:09,2014-02-11 08:28:53
10badc34e9e22fca2a467140ab345e2f3d3e6de3...4518d8c53b04ced1e2c0b6642a63fd7ae9e0e3fa,1,2,2,4,2,2014-02-11 08:32:27,2014-02-11 08:32:27
4518d8c53b04ced1e2c0b6642a63fd7ae9e0e3fa...9303f6914b79424ad0139c9e143a0dd4690e914e,1,3,0,3,1,2014-02-11 08:35:04,2014-02-11 08:35:04
9303f6914b79424ad0139c9e143a0dd4690e914e...132ab0c81b572e58424efc9c347287d11f252fa1,1,3,2,5,3,2014-02-11 08:44:36,2014-02-11 08:44:36
132ab0c81b572e58424efc9c347287d11f252fa1...923887b73145dfc8b0f6e42780e1487c87eb6dec,1,3,3,6,3,2014-02-11 08:48:42,2014-02-11 08:48:42
923887b73145dfc8b0f6e42780e1487c87eb6dec...ea6173d1fe05f74c1e4efe321b89a8448f4726b9,1,8,3,11,3,2014-02-11 09:00:54,2014-02-11 09:00:54
ea6173d1fe05f74c1e4efe321b89a8448f4726b9...408f9c6068f8f5aae25ef4f7b15fc9acdfaa9566,1,6,1,7,4,2014-02-11 09:02:50,2014-02-11 09:02:50
408f9c6068f8f5aae25ef4f7b15fc9acdfaa9566...1588ed51c496a73105ec080f440c2e5c43510b7b,2,1,2,3,2,2014-02-11 09:17:52,2014-02-11 09:15:45
1588ed51c496a73105ec080f440c2e5c43510b7b...691cb3fb576024af9b2839c6132cc995663faf35,1,11,9,20,4,2014-02-11 09:21:09,2014-02-11 09:21:09
691cb3fb576024af9b2839c6132cc995663faf35...26c871146638439d6c8e23fa16ae415451d04966,1,2,2,4,2,2014-02-11 09:30:22,2014-02-11 09:30:22
26c871146638439d6c8e23fa16ae415451d04966...2d12715a57d319154abe3fcb0bd4931ad9716967,1,5,3,8,4,2014-02-11 09:48:01,2014-02-11 09:47:15
2d12715a57d319154abe3fcb0bd4931ad9716967...b80136c981c140530800eeefa76a8685e408010e,1,28,0,28,2,2014-02-11 18:45:05,2014-02-11 18:45:05
b80136c981c140530800eeefa76a8685e408010e...c4315d38fb45b7d5c819b698c0a573bd5105c55a,2,31,6,37,8,2014-02-11 19:15:41,2014-02-11 19:15:41
c4315d38fb45b7d5c819b698c0a573bd5105c55a...1f8fa55c69009e07d706cd4ad95e340ca6b8acbf,8,12,12,24,12,2014-02-11 19:20:21,2014-02-11 19:20:21
1f8fa55c69009e07d706cd4ad95e340ca6b8acbf...cc6c05128e2141d7222781f0ea7340c8cf045444,1,12,0,12,1,2014-02-11 19:36:47,2014-02-11 19:36:47
cc6c05128e2141d7222781f0ea7340c8cf045444...c14cc0e6cac77415dcd893f3b55ae410e0052a38,1,60,16,76,4,2014-02-11 22:43:07,2014-02-11 22:43:07
c14cc0e6cac77415dcd893f3b55ae410e0052a38...6f74596ab066b12186fa62d4fd8c5e0ac5202a8b,2,75,46,121,16,2014-02-11 23:12:52,2014-02-11 23:12:52
6f74596ab066b12186fa62d4fd8c5e0ac5202a8b...33827039c548958ce0704cae6d6138d0e922f644,1,2,1,3,1,2014-02-11 23:37:14,2014-02-11 20:00:16
33827039c548958ce0704cae6d6138d0e922f644...d54aae78f8972a7b001b83251c9b239c70243a8d,3,5,2,7,3,2014-02-12 00:16:36,2014-02-12 00:16:36
d54aae78f8972a7b001b83251c9b239c70243a8d...1eaf4a5501e01ee56febf1e501ebd3a403db09f9,2,3,3,6,3,2014-02-12 01:56:28,2014-02-12 01:56:28
1eaf4a5501e01ee56febf1e501ebd3a403db09f9...76464f647d9ec84cfd2e0b2d547d91aaf1f8ce37,4,167,27,194,14,2014-02-12 19:22:57,2014-02-12 19:22:57
76464f647d9ec84cfd2e0b2d547d91aaf1f8ce37...16b786ad63b67835897dac6636247799a0056661,1,7,7,14,5,2014-02-12 19:46:58,2014-02-12 19:46:58
16b786ad63b67835897dac6636247799a0056661...20800f4be734098b9f760343271b52be185e3c12,1,20,17,37,4,2014-02-12 20:27:03,2014-02-12 20:13:17
20800f4be734098b9f760343271b52be185e3c12...e073cc129889b3ddc2188713d96177a46adcc4ff,1,6,8,14,3,2014-02-12 23:18:22,2014-02-12 23:18:22
fc955af5c0f1c0f308d914a9663d759afe49254f...0e0d8f218c808f00231b33d9250c020a4f4f0146,1,10,4,14,3,2014-01-26 03:41:21,2014-01-26 03:41:21
fc955af5c0f1c0f308d914a9663d759afe49254f...a9c4dfaecd22e29a0d7c8173f6b16adfd51ec332,7,295,284,579,37,2014-01-24 21:22:11,2014-01-24 21:22:02
a9c4dfaecd22e29a0d7c8173f6b16adfd51ec332...b9378d02b7f193b220967fa0c214fea9b509ae41,1,0,1,1,1,2014-01-26 01:52:37,2014-01-26 01:52:37
b9378d02b7f193b220967fa0c214fea9b509ae41...adcff727e4327f8e9dd39b5795161ab49456bdae,1,3,3,6,3,2014-01-26 03:37:32,2014-01-26 03:37:32
6cfa2d65d82017b02f78e876436e67a585d256db...0fb7ba1e77343db1db9ce2cbb4794ea78f4e9999,3,2,26,28,4,2013-12-03 19:18:02,2013-12-03 19:18:02
0fb7ba1e77343db1db9ce2cbb4794ea78f4e9999...09bd6728a0329579f854a0d3b667eafd8c671fd0,1,7,3,10,4,2013-12-03 19:18:29,2013-12-03 19:18:00
09bd6728a0329579f854a0d3b667eafd8c671fd0...87e1c347a682dc5cadddd1320085568b6f448ab1,1,10,7,17,2,2013-12-03 19:49:33,2013-12-03 19:49:06
87e1c347a682dc5cadddd1320085568b6f448ab1...87d781ad766132354ff635d2c436093ff81eee0e,1,16,5,21,3,2013-12-03 19:57:45,2013-12-03 19:57:25
87d781ad766132354ff635d2c436093ff81eee0e...fdffc95ab80a6a954d1a9319b99060e8dc503feb,1,8,3,11,2,2013-12-03 19:57:45,2013-12-03 19:57:35
fdffc95ab80a6a954d1a9319b99060e8dc503feb...c876ff3c470acf603ae432d9d3631276a6792b46,1,6,0,6,1,2013-12-03 20:27:03,2013-12-03 20:27:03
c876ff3c470acf603ae432d9d3631276a6792b46...ccd3e185fc43169e8461a9863cb3726218967fc7,4,146,11,157,15,2013-12-03 22:23:18,2013-12-03 22:23:18
ccd3e185fc43169e8461a9863cb3726218967fc7...fbf6821fb67ca59f178cafd6d7c951c04c53a8b6,1,36,15,51,12,2013-12-04 00:23:04,2013-12-04 00:23:04
fbf6821fb67ca59f178cafd6d7c951c04c53a8b6...2da5121104d5cc1d8248c34ef65f8fba0aab2264,3,58,0,58,3,2013-12-04 22:43:30,2013-12-04 22:43:30
2da5121104d5cc1d8248c34ef65f8fba0aab2264...d0d465077c561d45142d89236711c9632db8e69a,6,2296,25,2321,12,2013-12-04 23:39:17,2013-12-04 23:39:17
d0d465077c561d45142d89236711c9632db8e69a...0c3fd4524666258e50339bd7eac206d6a3b9b82b,1,13,4,17,3,2013-12-05 00:45:22,2013-12-05 00:45:10
0c3fd4524666258e50339bd7eac206d6a3b9b82b...03e556a00f0fa5ce3a7a28f253a5d13b27f42149,1,35,29,64,3,2013-12-05 05:16:55,2013-12-05 05:15:29
03e556a00f0fa5ce3a7a28f253a5d13b27f42149...e3b6743f59c4e7c7c2b67736e7fb238f3de47815,6,127,2,129,6,2013-12-05 05:22:30,2013-12-05 05:22:30
e3b6743f59c4e7c7c2b67736e7fb238f3de47815...a2d3b2778722af2b9e5e7f386be0f22cd409f1ac,1,1,0,1,1,2013-12-05 05:29:18,2013-12-05 05:29:18
a2d3b2778722af2b9e5e7f386be0f22cd409f1ac...9359c85d7df8f997bdcab8aeecb9d35168a32e42,2,10,12,22,6,2013-12-05 05:46:57,2013-12-05 05:45:33
9359c85d7df8f997bdcab8aeecb9d35168a32e42...b619a5b1becc70ff94ebf492581b57b7dca9ab3f,2,63,3,66,6,2013-12-05 19:55:57,2013-12-05 19:55:57
b619a5b1becc70ff94ebf492581b57b7dca9ab3f...197a812a47a53a0236e0758355625ff3f4c9e0d8,5,73,21,94,17,2013-12-05 23:43:06,2013-12-05 23:41:20
197a812a47a53a0236e0758355625ff3f4c9e0d8...54ead3fca2714aa2432988938885b81841fc2fdf,2,89,5,94,3,2013-12-06 00:31:59,2013-12-05 22:51:57
54ead3fca2714aa2432988938885b81841fc2fdf...6397fec3dcc522ba578c6c4dba3fa6ff9f2eb3a3,6,44,176,220,18,2013-12-06 00:31:59,2013-12-06 00:06:20
6397fec3dcc522ba578c6c4dba3fa6ff9f2eb3a3...c940ca91e6d67ee0c0a00517287afb0fa22ba86e,1,2,4,6,2,2013-12-06 00:52:43,2013-12-06 00:52:36
c940ca91e6d67ee0c0a00517287afb0fa22ba86e...da89dcf93bf5f0537045a04b18e382175447d2e2,1,0,7,7,2,2013-12-06 01:10:59,2013-12-06 01:10:59
da89dcf93bf5f0537045a04b18e382175447d2e2...37fb37895b92d908b86f95c2ab03a9449383266b,1,0,3,3,1,2013-12-06 01:37:52,2013-12-06 01:36:41
37fb37895b92d908b86f95c2ab03a9449383266b...b180a8e6506f9ccf6f852728c7539c1840454e1c,1,28,6,34,7,2013-12-06 01:41:10,2013-12-06 01:37:06
b180a8e6506f9ccf6f852728c7539c1840454e1c...3e398ab4f96db719cb24ee0052ef46cea0896ca7,1,1,1,2,1,2013-12-06 01:43:38,2013-12-06 01:43:38
3e398ab4f96db719cb24ee0052ef46cea0896ca7...7e5d64b43089c73ce971c56f53e363e1d873601c,1,3,2,5,2,2013-12-06 06:14:23,2013-12-06 06:14:23
7e5d64b43089c73ce971c56f53e363e1d873601c...4bdb1c7fda79826bee33023a2bb754a076588508,3,40,43,83,9,2013-12-06 07:07:51,2013-12-06 07:07:51
4bdb1c7fda79826bee33023a2bb754a076588508...b3a2d6d99dc1c5604f83ee49ee703bd2c4074331,1,2,2,4,2,2013-12-06 07:31:57,2013-12-06 07:31:37
b3a2d6d99dc1c5604f83ee49ee703bd2c4074331...0a05648393157e0974f598bd47f4be950bf6231e,3,27,13,40,3,2013-12-06 07:56:48,2013-12-06 07:56:48
0a05648393157e0974f598bd47f4be950bf6231e...49270ee27425146e3d406f50b7ce2766e4bb8b31,1,1,1,2,1,2013-12-06 07:57:48,2013-12-06 07:57:48
49270ee27425146e3d406f50b7ce2766e4bb8b31...49b1bfbeb5f5d614c058f60c4cd75c585835fc34,1,1,1,2,1,2013-12-06 08:01:07,2013-12-06 08:01:07
49b1bfbeb5f5d614c058f60c4cd75c585835fc34...7e838c042901ec562ffd311a8ec2fc42a630534a,1,11,0,11,1,2013-12-06 08:13:53,2013-12-06 08:13:43
7e838c042901ec562ffd311a8ec2fc42a630534a...47953854bb5650455e5d536c3ba20767d84d50ce,7,7,10,17,7,2013-12-06 08:32:12,2013-12-06 08:32:12
47953854bb5650455e5d536c3ba20767d84d50ce...7dc913723d7f30cf8fdbb0a35b6ac0fb44e75946,13,79,2288,2367,33,2013-12-06 09:12:25,2013-12-06 09:12:25
7dc913723d7f30cf8fdbb0a35b6ac0fb44e75946...2e4199e9ee9819fd119299e69b2a2bd53fa164a6,9,422,725,1147,58,2013-12-06 09:19:22,2013-12-06 09:19:22
2e4199e9ee9819fd119299e69b2a2bd53fa164a6...0c087cc84adf7fefeca5e138dd9c8099e215f3ff,3,5,7,12,6,2013-12-06 09:22:02,2013-12-06 09:22:02
0c087cc84adf7fefeca5e138dd9c8099e215f3ff...1952a61c535f4ecb106719bfaa5dfb58ed2061b3,8,36,47,83,35,2013-12-06 09:27:07,2013-12-06 09:27:07
1952a61c535f4ecb106719bfaa5dfb58ed2061b3...99a8a7b9a7492d76fe8da18bcf736f02882eefc3,3,29,7,36,5,2013-12-06 09:30:50,2013-12-06 09:30:50
99a8a7b9a7492d76fe8da18bcf736f02882eefc3...18113d2194de9fdfd9b4db5d1e985352a0e80eb3,6,35,35,70,31,2013-12-06 09:35:12,2013-12-06 09:33:28
c6b8c651a4bc1a99fb0fc78cdf2ebc6d68676a28...7bf11e35a6c1ca5996802a43b3a2b6c61475e031,3,39,16,55,17,2013-09-27 21:36:26,2013-07-27 03:43:20
7bf11e35a6c1ca5996802a43b3a2b6c61475e031...9e0897aecd41109e71c8c148364b4f9bd1b4ccb6,1,3,2,5,2,2013-09-27 21:36:26,2013-08-30 20:56:53
9e0897aecd41109e71c8c148364b4f9bd1b4ccb6...400778a55960f67de4178f0916fe166bd5666c26,2,20,15,35,10,2013-09-27 21:36:26,2013-09-26 03:16:19
400778a55960f67de4178f0916fe166bd5666c26...eda50d2d1ed65ff40f0b85f8dc089d2c50ff6dd9,1,3,0,3,1,2013-09-27 21:38:47,2013-09-27 21:38:47
c6b8c651a4bc1a99fb0fc78cdf2ebc6d68676a28...ba224fdf0e732646afd379160f16f42ff064e087,7,120,73,193,17,2013-09-27 02:42:16,2013-09-27 02:42:16
ba224fdf0e732646afd379160f16f42ff064e087...ce13aa2ecd92963142c217af982d9bbd1bcfaabc,6,17,17,34,17,2013-09-27 06:01:50,2013-09-27 06:01:50
546c344b3da719bd2553599d3e6fd1e3541fe6c4...373bc2ceecea8ff6c385216632b16d861023e0c3,1,2,1,3,1,2013-12-17 06:03:50,2013-12-17 06:03:50
373bc2ceecea8ff6c385216632b16d861023e0c3...3003f4634736f04f8a40a1af7b45ab919c79db3f,1,8,4,12,2,2013-12-18 06:23:24,2013-12-18 06:23:24
3003f4634736f04f8a40a1af7b45ab919c79db3f...a314eb7d62c27b59e1364d6794ffc6f00566c2d0,4,45,74,119,22,2013-12-18 23:36:04,2013-12-18 23:35:26
a314eb7d62c27b59e1364d6794ffc6f00566c2d0...48521f9d18738a1511d98ae3809f5e1c57180727,2,14,0,14,2,2013-12-19 00:41:32,2013-12-19 00:05:11
48521f9d18738a1511d98ae3809f5e1c57180727...81f8659d21471d73d12d7c985f2369150c7109e1,1,12,2,14,2,2013-12-19 02:33:19,2013-12-19 02:27:09
81f8659d21471d73d12d7c985f2369150c7109e1...27c364a21a327aa79d7916766982d2c10d3b18bc,1,9,0,9,1,2013-12-19 21:32:19,2013-12-19 21:32:19
e58156bd588419cdf8a72945b0fcd6dae7d5586a...d1767da26de2a7d690f6621264d3af90164a714e,2,33,27,60,7,2013-12-02 22:21:29,2013-12-02 22:18:53
d1767da26de2a7d690f6621264d3af90164a714e...bc3b42a941e9aca1e1b627694e432ce4378ddd16,1,13,7,20,6,2013-12-02 23:15:06,2013-12-02 23:15:06
bc3b42a941e9aca1e1b627694e432ce4378ddd16...b1cc446fc846330ba2a34c98bfba8361cec99b61,2,2,2,4,2,2013-12-03 00:25:40,2013-12-03 00:25:40
b1cc446fc846330ba2a34c98bfba8361cec99b61...0a4663bafd408dd4ea68633fbffd7e4a7724d8a5,1,1,1,2,1,2013-12-03 00:49:09,2013-12-03 00:49:09
0a4663bafd408dd4ea68633fbffd7e4a7724d8a5...c066b90e1cd6e9fbe14b022d99988a6c7c816bbf,1,4,0,4,1,2013-12-03 00:59:50,2013-12-03 00:59:50
c066b90e1cd6e9fbe14b022d99988a6c7c816bbf...8ab66ff2557a34eb0eeeef5a12e9f444ac6032bb,2,30,27,57,3,2013-12-03 01:15:37,2013-12-02 23:57:09
8ab66ff2557a34eb0eeeef5a12e9f444ac6032bb...cd873c0e4771ae82266fa8336c9c6920ce00d7e0,2,1,2,3,2,2013-12-03 01:15:37,2013-12-03 00:10:18
e58156bd588419cdf8a72945b0fcd6dae7d5586a...04b39b0d301f8bd5f7e6dd3e3358667957886be5,4,176,0,176,12,2013-11-28 04:01:29,2013-11-14 17:48:05
04b39b0d301f8bd5f7e6dd3e3358667957886be5...d888cab5e646ac1a9c940febe9d5e57e66c1f365,4,82,108,190,22,2013-11-28 04:01:29,2013-11-15 14:36:27
d888cab5e646ac1a9c940febe9d5e57e66c1f365...02c4ff36dff91e4a45c4f52a43480d788771f640,2,12,9,21,4,2013-11-28 04:01:29,2013-11-15 14:52:18
02c4ff36dff91e4a45c4f52a43480d788771f640...42f0eef9dac17b3a198382aba7b8b4279ce8f5f1,2,13,17,30,11,2013-11-28 04:01:29,2013-11-15 20:56:33
42f0eef9dac17b3a198382aba7b8b4279ce8f5f1...10ddcdd1e7a95cbf89a9671bc5ac70192a427043,1,68,67,135,2,2013-11-28 04:01:29,2013-11-19 16:35:46
10ddcdd1e7a95cbf89a9671bc5ac70192a427043...f80e7b56d4eac9076a24f56796c88c1878f6bd45,1,7,5,12,4,2013-11-28 04:01:29,2013-11-19 16:49:53
f80e7b56d4eac9076a24f56796c88c1878f6bd45...b2bb2c0dab6e1cdc210fdb1132ed98abd3e6d506,1,12,7,19,4,2013-11-28 04:01:30,2013-11-19 17:11:53
b2bb2c0dab6e1cdc210fdb1132ed98abd3e6d506...d3234aa9730c50058962249626aaae8c839fb943,10,137,63,200,22,2013-11-28 04:01:30,2013-11-19 20:40:58
d3234aa9730c50058962249626aaae8c839fb943...1034e5c8a16222129a8251de0b4659d1eedab757,3,46,1,47,3,2013-11-28 04:01:30,2013-11-19 21:51:35
1034e5c8a16222129a8251de0b4659d1eedab757...17674196c80fdc2018013270772f4c44fca4735d,4,44,28,72,14,2013-11-28 04:01:30,2013-11-20 21:13:03
17674196c80fdc2018013270772f4c44fca4735d...0672d20d8922a3ec2922ceaad8637b89b0093718,2,7,7,14,7,2013-11-28 04:01:30,2013-11-20 21:21:50
0672d20d8922a3ec2922ceaad8637b89b0093718...33d572a0c2912fc196f1ada1ac29e931f977e096,3,28,14,42,7,2013-11-28 04:01:30,2013-11-20 22:28:45
33d572a0c2912fc196f1ada1ac29e931f977e096...f8a1641517cf830c4bd1685681b81367fe6416ac,1,2,1,3,1,2013-11-28 04:01:30,2013-11-20 23:32:41
f8a1641517cf830c4bd1685681b81367fe6416ac...5496a4c5144ebd2a72a80e9ecbfa076adba7e080,1,1,1,2,1,2013-11-28 04:01:30,2013-11-21 00:10:53
5496a4c5144ebd2a72a80e9ecbfa076adba7e080...f6a5b7734fab247fc6f62c0b3d0b5d5d3ebd73de,1,147,70,217,16,2013-11-28 04:01:30,2013-11-21 18:03:04
f6a5b7734fab247fc6f62c0b3d0b5d5d3ebd73de...bcac2bd11e72d4f5b4a4307b17719d35d89260db,2,8,8,16,5,2013-11-28 04:01:30,2013-11-23 18:04:58
bcac2bd11e72d4f5b4a4307b17719d35d89260db...76ae509760648d59806373de3dab1c3061ac69b9,5,43,1,44,5,2013-11-28 04:01:30,2013-11-23 18:34:31
76ae509760648d59806373de3dab1c3061ac69b9...c713a664c7d4f8f95c1c11b62d01e81b1e52728c,3,78,49,127,10,2013-11-28 04:01:31,2013-11-25 16:42:07
c713a664c7d4f8f95c1c11b62d01e81b1e52728c...1f3b7cb1326794bf39629e899ed6b1a16fc26885,9,23,43,66,12,2013-11-28 04:01:31,2013-11-25 18:19:56
1f3b7cb1326794bf39629e899ed6b1a16fc26885...7d9f60b07b828f548966b44e22bb6aa5be13c1c7,12,212,196,408,41,2013-11-28 04:01:31,2013-11-26 16:32:26
7d9f60b07b828f548966b44e22bb6aa5be13c1c7...09521e9b0c06cbf4a30e03d4b0102bb6825c9689,1,10,19,29,9,2013-12-03 07:23:08,2013-12-03 07:23:08
09521e9b0c06cbf4a30e03d4b0102bb6825c9689...a899d2c54de8b15df988d8155c45e71e035db2b5,1,4,8,12,4,2013-12-03 10:48:41,2013-12-03 10:40:17
360e654f63b155492c561cc6eaa9e76be42a7be6...ecd94142c8ab4776d0963c0c6c3ba63b53f76f1f,2,18,2,20,7,2013-08-01 19:17:58,2013-08-01 18:13:02
ecd94142c8ab4776d0963c0c6c3ba63b53f76f1f...17699eb399977a9cb0b00fac3063bd4e447fac2a,2,108,111,219,32,2013-08-01 19:17:58,2013-08-01 18:59:52
17699eb399977a9cb0b00fac3063bd4e447fac2a...2c33d54e5eb855f27bf24b05ddaae0b9f4c57247,1,1,1,2,1,2013-08-01 19:17:58,2013-08-01 19:03:58
2c33d54e5eb855f27bf24b05ddaae0b9f4c57247...8de4b48d61902fca803b8fc5562ab579cb148de8,1,17,14,31,9,2013-08-01 19:17:58,2013-08-01 19:07:05
8de4b48d61902fca803b8fc5562ab579cb148de8...e4837216024dca3514dfa8eb010c24cdccdd49d9,2,20,1,21,5,2013-08-01 19:41:49,2013-08-01 19:41:49
273c08fd7cd452f22ff6ce1273f631a97be4e613...af8ddf5811ecf13a5a6b6455e23be46e5e0af087,1,5,5,10,5,2013-03-30 06:07:50,2013-03-30 06:07:50
af8ddf5811ecf13a5a6b6455e23be46e5e0af087...59f55f9a8cf54a3977ce1c1c75f872e0fbfbde15,1,1,18,19,1,2013-03-30 06:44:58,2013-03-30 06:44:58
59f55f9a8cf54a3977ce1c1c75f872e0fbfbde15...bce332dbbbea660c5044bd3821412730267b6587,1,2,1,3,1,2013-03-30 06:50:56,2013-03-30 06:50:56
bce332dbbbea660c5044bd3821412730267b6587...4b91013be8ea6de144af220b4e5407ebfb3c9810,1,2,0,2,1,2013-03-30 07:08:22,2013-03-30 07:08:22
4b91013be8ea6de144af220b4e5407ebfb3c9810...1c36bbaa79d76efd4817c5e1faeeed0c9429e0a3,1,6,2,8,1,2013-03-30 07:08:34,2013-03-30 07:08:34
1c36bbaa79d76efd4817c5e1faeeed0c9429e0a3...1e2a40ef2bab5134ff2d6d813cd3ea5a0822a748,1,7,5,12,1,2013-03-30 07:47:52,2013-03-30 07:47:52
1e2a40ef2bab5134ff2d6d813cd3ea5a0822a748...894dfdc54673566f24d745ad92d20d95c418d92c,1,6,0,6,1,2013-03-30 07:48:00,2013-03-30 07:48:00
894dfdc54673566f24d745ad92d20d95c418d92c...f3821b06f32a012533ebef8c147c66c267c4df04,1,0,4,4,4,2013-03-30 07:53:29,2013-03-30 07:53:08
f3821b06f32a012533ebef8c147c66c267c4df04...d65551a6870b1c19095d9b99c5c86d20722dfc37,1,1,4,5,1,2013-03-31 00:50:19,2013-03-31 00:50:19
d65551a6870b1c19095d9b99c5c86d20722dfc37...c7e55825371e7770068d6624a399daae0b314fe6,1,5,0,5,2,2013-03-31 00:50:30,2013-03-31 00:50:30
c7e55825371e7770068d6624a399daae0b314fe6...32593f3940d67a5973390cecbebc73c14cafdc9d,1,18,14,32,12,2013-03-31 00:54:49,2013-03-31 00:54:49
32593f3940d67a5973390cecbebc73c14cafdc9d...69b19330a244e231f0240aaa93737a756ca62989,1,1,1,2,1,2013-03-31 00:58:04,2013-03-31 00:58:04
b63328c4e95e4d3438c57f058c96a6f4103f669b...c4cd9987722075a4105b730c4ea96100d11a5f5c,1,3,4,7,2,2014-05-28 00:32:04,2014-05-28 00:32:04
b63328c4e95e4d3438c57f058c96a6f4103f669b...bd4a8735bd5cea78dfabcf9283e6322702b11eb7,7,160,5,165,10,2014-05-28 00:17:24,2014-05-16 01:06:55
bd4a8735bd5cea78dfabcf9283e6322702b11eb7...a012866fa96ebd02d61968a56b92fd948e4007c1,8,87,55,142,41,2014-05-28 20:48:27,2014-05-28 20:48:27
a012866fa96ebd02d61968a56b92fd948e4007c1...4b6d3b2681ecddae3dba0e2b89e55368afa845c0,8,18,6,24,10,2014-05-28 21:37:12,2014-05-28 21:34:36
4b6d3b2681ecddae3dba0e2b89e55368afa845c0...432cda8eb76ebe6040c42274462f8ce4fcff3b76,3,1,1,2,1,2014-05-28 21:47:22,2014-05-28 21:47:22
432cda8eb76ebe6040c42274462f8ce4fcff3b76...16b4c383d50f4e41591e6008234441c1e790c8a5,4,47,0,47,4,2014-05-28 21:56:37,2014-05-28 21:56:37
16b4c383d50f4e41591e6008234441c1e790c8a5...22177781bb970db4427d0963d56be001618ff3b9,1,17,10,27,2,2014-05-28 22:00:38,2014-05-28 22:00:38
22177781bb970db4427d0963d56be001618ff3b9...4a8c76051fa2efbdf318119baa17642d2625dbf9,3,30,3,33,5,2014-05-28 22:44:42,2014-05-28 22:44:42
4a8c76051fa2efbdf318119baa17642d2625dbf9...3bc7141c34ffd9fba0d118b2b1732ad4c7eeff39,8,9,19,28,6,2014-05-29 22:02:40,2014-05-29 22:02:40
910f75f35946d86db690abab28e4f9868f2776ba...aa0552d847717e251068098d19038b8e2c2629a1,1,2,2,4,1,2014-05-21 00:32:04,2014-05-16 18:09:37
aa0552d847717e251068098d19038b8e2c2629a1...10d8894842c6d49aa045bce158627f175a3c6aa6,1,2,1,3,1,2014-05-21 00:32:15,2014-05-17 16:50:53
10d8894842c6d49aa045bce158627f175a3c6aa6...32fc06e7f86b5f7b18226aa25d38d25af0461f9e,1,2,2,4,1,2014-05-21 00:32:25,2014-05-18 08:39:53
32fc06e7f86b5f7b18226aa25d38d25af0461f9e...cc79a7cc0a2cbe688b9d567e6f0cad2a33f7b42f,1,4,0,4,1,2014-05-21 00:34:41,2014-05-20 17:08:04
cc79a7cc0a2cbe688b9d567e6f0cad2a33f7b42f...c0cc0ece2f14a31e6f1b4136aa38cfa36dd8e2a2,1,6,0,6,1,2014-05-21 00:35:50,2014-05-21 00:35:50
c0cc0ece2f14a31e6f1b4136aa38cfa36dd8e2a2...1a9509650ae7ef5701c9d6ec56bbd4a479251e68,1,1,0,1,1,2014-05-21 00:35:57,2014-05-20 18:38:05
1a9509650ae7ef5701c9d6ec56bbd4a479251e68...7fd89078e5bad9c14ad0f7e58dd14c4d8e9fd35c,1,2,0,2,1,2014-05-21 00:36:41,2014-05-21 00:36:41
7fd89078e5bad9c14ad0f7e58dd14c4d8e9fd35c...22f4ca0c214338e776e65a016b25e40a235f82b3,1,3,0,3,1,2014-05-21 02:43:21,2014-05-21 02:43:21
22f4ca0c214338e776e65a016b25e40a235f82b3...db4c344e838df0a770c2aca752786e337f5c41ac,1,2,1,3,1,2014-05-21 17:39:22,2014-05-21 17:39:22
db4c344e838df0a770c2aca752786e337f5c41ac...6189a9253662718c58401e7095edafd70dc3a072,1,2,2,4,1,2014-05-21 18:08:46,2014-05-21 18:08:46
6189a9253662718c58401e7095edafd70dc3a072...107e9087577821fb93d51712770ee83636b29eb4,1,2,2,4,1,2014-05-21 18:21:01,2014-05-21 18:21:01
107e9087577821fb93d51712770ee83636b29eb4...f3ae43a194bf80b41839b9507f32d12a7e4226c4,1,1,1,2,1,2014-05-22 03:28:34,2014-05-21 23:19:43
f3ae43a194bf80b41839b9507f32d12a7e4226c4...1e882d786d0717b12c04c74c2e8b8341e913f380,1,2,0,2,1,2014-05-22 03:30:02,2014-05-22 03:30:02
1e882d786d0717b12c04c74c2e8b8341e913f380...560ba659e1fe3ced7aab3b9790b2adbe7c8cbc60,3,77,7,84,4,2014-05-22 03:40:40,2014-05-21 02:21:30
560ba659e1fe3ced7aab3b9790b2adbe7c8cbc60...ca12a9842d15cef3e25d68b09108a6a3e184fa69,3,10,3,13,4,2014-05-22 04:10:03,2014-05-22 04:10:03
ca12a9842d15cef3e25d68b09108a6a3e184fa69...110ba942ee391165995c09c5ab6b47d5e5cfc3a1,1,2,3,5,1,2014-05-22 16:27:08,2014-05-22 16:27:08
110ba942ee391165995c09c5ab6b47d5e5cfc3a1...c0722aac30fc494ff99cbb98aa55246bd18a0b6e,7,7,7,14,7,2014-05-22 16:48:54,2014-05-22 16:48:54
bfeabbc5b070eeacf2b41f997f4e622af347ea3d...9f477e974d9e7d2bb4f871622c5aa17bd741abd2,1,2,3,5,1,2014-05-15 00:20:50,2014-05-15 00:20:50
27d9959326c244f37e00e85cac17f910bbf090fc...4afa54ca5af80e2214e998e2a48de1dcb59c4fc6,3,43,2,45,6,2014-05-08 19:12:45,2014-05-06 04:36:48
4afa54ca5af80e2214e998e2a48de1dcb59c4fc6...a8673d01cd395d516539f91c2a8112bde89c8fd6,4,50,3,53,10,2014-05-08 19:12:45,2014-05-06 05:22:45
a8673d01cd395d516539f91c2a8112bde89c8fd6...c044786e2fd9a1cb52cb138bc2f3d64b9426fac2,4,4,2,6,4,2014-05-08 19:12:45,2014-05-08 15:45:54
c044786e2fd9a1cb52cb138bc2f3d64b9426fac2...fe52538881cb9325e6fdcbdbfdf0fc0e6299f333,1,7,0,7,1,2014-05-08 19:14:30,2014-05-08 19:14:30
b48266bf743fc8002f8d4961c4c7a1cddd72bdb8...5e0845a4367ca363f1d3d1367550bd9c9957abeb,3,28,5,33,8,2014-05-01 06:01:53,2014-05-01 06:01:53
5e0845a4367ca363f1d3d1367550bd9c9957abeb...853aa3f1d569680db5b9054e52c0c85303a07550,4,22,44,66,8,2014-05-01 06:32:24,2014-04-22 20:55:21
853aa3f1d569680db5b9054e52c0c85303a07550...482d9a78d7a0a13d0e90c84e8dcf0f51d5735455,1,94,40,134,11,2014-05-01 06:32:24,2014-04-24 22:33:43
482d9a78d7a0a13d0e90c84e8dcf0f51d5735455...af7ed1edc03739ea1d6568bff47151e8c2900644,1,7,0,7,1,2014-05-01 06:34:47,2014-05-01 06:34:47
47b022841b40f5ca37adccc778ade373559519e5...ab08191ac3c2f48c122d9c90acb34d3aed55bc28,5,52,10,62,9,2014-04-24 02:37:03,2014-04-22 17:55:47
ab08191ac3c2f48c122d9c90acb34d3aed55bc28...a496fcab4cfa6598da2e583e59725ec1e5e003fd,1,2,0,2,1,2014-04-24 02:37:03,2014-04-24 02:35:23
47211cb46d19b4e78eefc74775710cf885da22b9...fdcd43d0579dcaa9460641ba4623731fcaee3006,1,91,122,213,25,2014-06-06 18:28:56,2014-06-06 18:28:56
47211cb46d19b4e78eefc74775710cf885da22b9...d3c7b92d806234c8657708718b1745c693c6e4f4,1,120,2,122,4,2014-06-06 06:30:31,2014-06-06 06:29:11
d3c7b92d806234c8657708718b1745c693c6e4f4...e5118295d39f3183f55956026f1e5f457a0520bd,1,6,2,8,1,2014-06-06 18:15:46,2014-06-06 18:15:46
66b73e170e2f8275f1c5ebd417f0b1bbf1ac24ee...92a7e9a30d67d8f0a3c6dd5be13e5fa6ddc76759,1,4,4,8,1,2014-04-21 18:17:13,2014-04-21 18:17:13
92a7e9a30d67d8f0a3c6dd5be13e5fa6ddc76759...f8036fc1f4494ade188288d9e06fd2a342a8f7e5,1,1,0,1,1,2014-04-21 18:17:37,2014-04-21 18:17:37
f8036fc1f4494ade188288d9e06fd2a342a8f7e5...a7a21e53659e5eb2688a1c14ca081601917e0e09,1,5,4,9,4,2014-04-21 18:19:03,2014-04-21 18:19:03
a7a21e53659e5eb2688a1c14ca081601917e0e09...4c8567067639daca72704bb3b71a3f6d06720c5d,1,8,12,20,2,2014-04-21 18:40:38,2014-04-21 18:40:38
4c8567067639daca72704bb3b71a3f6d06720c5d...54f6d3654ae5fa0feedca97aa26888ca54bdf8a5,3,27,24,51,10,2014-04-22 17:28:27,2014-04-22 17:28:27
54f6d3654ae5fa0feedca97aa26888ca54bdf8a5...24e42e715b418f1d507ca84438bf0bbdae497841,1,10,28,38,9,2014-04-22 18:23:34,2014-04-22 18:23:34
24e42e715b418f1d507ca84438bf0bbdae497841...739cb078f79295e485284f95c6031b10d8a43c94,1,29,0,29,1,2014-04-22 18:24:06,2014-04-22 18:24:06
172f709a5ff5f1186455604b90d8b45d64cba8f9...3ad16722828ad351e1bfd2ace2718d3e0008c677,3,11,8,19,6,2014-04-21 21:26:40,2014-04-21 21:20:24
3ad16722828ad351e1bfd2ace2718d3e0008c677...dd7c90d3aebbb376364288a8b602226e40d7396c,7,7,7,14,7,2014-04-21 21:47:00,2014-04-21 21:47:00
dd7c90d3aebbb376364288a8b602226e40d7396c...41d36b671a2bbe3538b353738b2186607c3024c7,1,2,5,7,2,2014-04-21 21:50:56,2014-04-21 21:50:56
41d36b671a2bbe3538b353738b2186607c3024c7...700673592ce95fdcc8faea4302a7308ad9a8763e,1,3,0,3,1,2014-04-21 21:51:59,2014-04-21 21:51:59
700673592ce95fdcc8faea4302a7308ad9a8763e...0e5e38f0066f3b85a3e3264ea6e0fc7c299982c1,6,6,6,12,6,2014-04-21 22:21:25,2014-04-21 22:21:25
0e5e38f0066f3b85a3e3264ea6e0fc7c299982c1...25e3428132ea29293f9bb283c3dc58e6f075c275,1,3,0,3,1,2014-04-21 22:21:53,2014-04-21 22:21:53
172f709a5ff5f1186455604b90d8b45d64cba8f9...13561c0c133e99b9037602f2c464e4125f11e715,1,1,0,1,1,2014-03-27 18:38:08,2014-03-27 18:37:16
13561c0c133e99b9037602f2c464e4125f11e715...aa903dc6be7db7940bf238fef78c8aa0575a62ad,1,5,1,6,2,2014-03-27 19:59:21,2014-03-27 19:59:21
aa903dc6be7db7940bf238fef78c8aa0575a62ad...b0ef1ce9a127fd314fdaeb18a5a66e241d03a186,7,7,7,14,7,2014-03-27 22:46:26,2014-03-27 22:46:00
14c27ca95307ad71639285c2ccae1f6d52c5d42b...62428987290c8f61ec984156b84717e57f742653,1,216,64,280,61,2014-03-27 06:29:03,2014-03-27 06:29:03
62428987290c8f61ec984156b84717e57f742653...add97c528098d1d16705eccc56a92f63ab3eb1cb,3,32,11,43,6,2014-03-27 18:08:18,2014-03-27 17:57:55
add97c528098d1d16705eccc56a92f63ab3eb1cb...cf14b70ea2f10aaa56ac46b0b412a637eed07a37,1,1,0,1,1,2014-03-27 18:37:16,2014-03-27 18:37:16
cf14b70ea2f10aaa56ac46b0b412a637eed07a37...f2b2d304bfe578652072a57ee48f7cd6d1213ff5,1,1,3,4,1,2014-03-27 21:35:55,2014-03-27 21:35:55
f2b2d304bfe578652072a57ee48f7cd6d1213ff5...ad5db65236fc00e36521d9b046706b94e46d651a,1,7,1,8,1,2014-03-27 21:39:08,2014-03-27 21:39:08
ad5db65236fc00e36521d9b046706b94e46d651a...3b8b43a9368533586eb3cbbdc4247259285af77d,1,5,5,10,3,2014-03-27 21:41:30,2014-03-27 21:41:30
aa89173f8523c652af074adc3dd95b9c6c263804...e872bc72e3e236b75364e6de78cfc1f04396f5bd,3,58,2,60,6,2014-03-24 17:36:18,2014-03-24 17:14:26
e872bc72e3e236b75364e6de78cfc1f04396f5bd...bdbd6a2484e161f99367d8b09b999f6d81b8b01d,1,1,0,1,1,2014-03-24 17:42:06,2014-03-24 17:42:06
6ccde87f56f434790bea723d2539ce14b9449f7f...a3701b7c941919dc8ed48c0c3ad4008780171703,2,45,25,70,8,2014-05-03 00:04:53,2014-05-03 00:04:53
a3701b7c941919dc8ed48c0c3ad4008780171703...9281f3128c77e65f2b092b6f4a1cc2e1d42cf36e,1,12,0,12,1,2014-05-03 00:25:21,2014-05-03 00:25:21
9281f3128c77e65f2b092b6f4a1cc2e1d42cf36e...714f98f9feefe0fd9d99f6a277408711e8fc7dce,1,2,0,2,1,2014-05-03 00:52:27,2014-05-03 00:52:27
714f98f9feefe0fd9d99f6a277408711e8fc7dce...031890d2c5a32f3951b28a8418eb54e5fa80df60,158,212,197,409,180,2014-05-04 23:56:58,2014-05-03 23:29:15
031890d2c5a32f3951b28a8418eb54e5fa80df60...2eac771902eb54eed31a91e9f73bd9d8d42c0009,5,95,71,166,33,2014-05-04 23:59:15,2014-05-04 23:59:15
2eac771902eb54eed31a91e9f73bd9d8d42c0009...6d7e097fc0421cb8dcebbdb2f4aad15782f64408,2,69,2,71,7,2014-05-05 21:56:44,2014-05-05 21:56:44
6d7e097fc0421cb8dcebbdb2f4aad15782f64408...603ec3a97915d921abd684f690ad20c3b8138a26,2,76,0,76,2,2014-05-05 22:33:00,2014-05-05 22:33:00
603ec3a97915d921abd684f690ad20c3b8138a26...9d70ff64c9da01d920d85e6809e7d4a57d744a3a,15,202,93,295,49,2014-05-06 02:18:34,2014-05-06 02:18:34
9d70ff64c9da01d920d85e6809e7d4a57d744a3a...4ebfb41352742acf66079c15300135835bfa7a6b,1,1,1,2,1,2014-05-06 03:00:28,2014-05-06 03:00:28
4ebfb41352742acf66079c15300135835bfa7a6b...e3abdab5013e90b6e0b959f9733c673cdc627a94,1,2,1,3,1,2014-05-06 03:03:27,2014-05-06 03:03:27
e3abdab5013e90b6e0b959f9733c673cdc627a94...9cc56aab9716d6b288d181c44f00909c3449f27e,3,39,22,61,10,2014-05-06 20:41:57,2014-05-06 20:41:57
9cc56aab9716d6b288d181c44f00909c3449f27e...d2d82556f3fcdffa63f817e9599aae7edc6ce75c,1,1,0,1,1,2014-05-06 20:42:18,2014-05-06 20:42:18
d2d82556f3fcdffa63f817e9599aae7edc6ce75c...e76aa1bab71b18e1d254474a3da7615257b1dbd1,1,49,11,60,5,2014-05-06 21:15:54,2014-05-06 21:15:54
e76aa1bab71b18e1d254474a3da7615257b1dbd1...3795a6b0e2a5fb2a3888ce5a48c9e1c45b89c2fe,2,5,5,10,4,2014-05-06 21:48:01,2014-05-06 21:46:28
3795a6b0e2a5fb2a3888ce5a48c9e1c45b89c2fe...f5838dbf075d33e14a12e8b16998c218a798250f,1,2,2,4,2,2014-05-06 22:30:28,2014-05-06 22:30:28
f5838dbf075d33e14a12e8b16998c218a798250f...fc3b3fd7c4ba5814722f919b08f352dd21b481fd,1,41,37,78,5,2014-05-06 23:41:20,2014-05-06 23:41:20
fc3b3fd7c4ba5814722f919b08f352dd21b481fd...4c84c93bb34452d5b8858040d0134f444b887940,1,6,1,7,2,2014-05-07 00:04:00,2014-05-07 00:04:00
4c84c93bb34452d5b8858040d0134f444b887940...d399fe70cb1b77a5758b156ee70f8a7612a685cc,3,223,68,291,20,2014-05-07 01:46:52,2014-05-07 01:46:52
1213dcffa9f68f31dbd78205284067126844729d...1b66658e092fd34de957f0d017922fa84a1a42e5,9,13,5,18,10,2014-04-25 00:13:11,2014-04-25 00:08:27
1b66658e092fd34de957f0d017922fa84a1a42e5...d45858bb900c7eeca5052954994efb566be38dba,1,2,2,4,2,2014-04-25 00:19:07,2014-04-25 00:19:07
d45858bb900c7eeca5052954994efb566be38dba...63cfa0b9baed72b29c0685bb8d81772fedcb8078,1,0,6,6,1,2014-04-25 21:38:06,2014-04-25 21:38:06
63cfa0b9baed72b29c0685bb8d81772fedcb8078...46bb4276ed94dc544b1f67524440cba91c9a0c6f,1,53,3,56,3,2014-04-26 02:12:05,2014-04-26 02:12:05
46bb4276ed94dc544b1f67524440cba91c9a0c6f...c77b28ed32ca87487beb01f9cb4d399db134e45d,3,51,13,64,12,2014-05-06 00:14:38,2014-05-06 00:14:38
c77b28ed32ca87487beb01f9cb4d399db134e45d...8932dc2077a7d08f4931ea2a8b0841aeec3d71d2,4,91,55,146,33,2014-05-07 01:53:52,2014-05-07 01:53:52
8932dc2077a7d08f4931ea2a8b0841aeec3d71d2...3a61c50e979606d312354812fab0cb8aea30ac75,2,42,21,63,10,2014-05-07 22:58:37,2014-05-07 22:58:37
3a61c50e979606d312354812fab0cb8aea30ac75...002138bee66faba74b2a98dcd1d1c5117b7774ee,2,9,2,11,5,2014-05-08 22:11:15,2014-05-08 22:02:31
002138bee66faba74b2a98dcd1d1c5117b7774ee...05b4d5e36810eaacb8d256fe97fecfb9bf8ddd69,1,1,1,2,1,2014-05-08 23:05:55,2014-05-08 23:05:55
05b4d5e36810eaacb8d256fe97fecfb9bf8ddd69...c2829941e7580ff85119e9a66e1f5ed2dd58b001,1,1,1,2,1,2014-05-08 23:13:15,2014-05-08 23:13:15
fbde0a00a7a160e583ce00f71f846a504fd089ad...3d3bdd4f50502be547db928f143e60d514e8c2a3,48,484,387,871,189,2014-04-25 00:02:46,2014-04-25 00:02:46
3d3bdd4f50502be547db928f143e60d514e8c2a3...c84c8d6097d833eb39d2bdbf7511d25381892127,106,12117,1969,14086,108,2014-04-25 01:18:21,2014-04-25 01:18:21
c84c8d6097d833eb39d2bdbf7511d25381892127...5cda5f1877b28ffc5dd6564353bf6d9bd5a404fa,6,53,21,74,28,2014-04-25 03:04:41,2014-04-25 03:04:41
5cda5f1877b28ffc5dd6564353bf6d9bd5a404fa...2107fc4d9a9d863962a44e54f3f22155b14db5c0,4,0,168,168,4,2014-04-25 21:26:48,2014-04-25 21:26:48
2107fc4d9a9d863962a44e54f3f22155b14db5c0...10d2047d121a005afd9be9b436619a3dd7143220,107,16,12300,12316,113,2014-04-25 22:01:20,2014-04-25 22:01:20
10d2047d121a005afd9be9b436619a3dd7143220...23ad149a78044e7e727fb5a3e6f0f2bbd930005b,155,15358,1,15359,155,2014-04-25 22:06:45,2014-04-25 22:06:45
23ad149a78044e7e727fb5a3e6f0f2bbd930005b...0d7de14f2c27c3c128a4dbf39c52d267c1f5b1a6,9,143,4,147,19,2014-04-26 01:37:19,2014-04-26 00:10:26
0d7de14f2c27c3c128a4dbf39c52d267c1f5b1a6...e615d27f0e29f919313497e389c70996c959c5a0,5,45,115,160,43,2014-04-28 23:02:46,2014-04-28 23:02:46
e615d27f0e29f919313497e389c70996c959c5a0...1fc5280e15439006fe99544b300b6be2890046a4,6,62,6,68,11,2014-04-28 23:45:44,2014-04-28 23:45:44
1fc5280e15439006fe99544b300b6be2890046a4...4702e9ff167051829f4cdb70ea329ebe36e386f5,4,13,14,27,6,2014-04-29 00:17:05,2014-04-29 00:17:05
4702e9ff167051829f4cdb70ea329ebe36e386f5...f9bd956ee9de5f17910259d99e76e2fbf7739402,7,106,30,136,26,2014-04-29 02:53:26,2014-04-29 02:53:26
f9bd956ee9de5f17910259d99e76e2fbf7739402...51ff16aac3472d17d9e89ed562096c8eeebf69b3,1,5,8,13,1,2014-04-29 02:58:04,2014-04-29 02:58:04
51ff16aac3472d17d9e89ed562096c8eeebf69b3...3cbcf0543812b8b78250ec5be859ddf5f3adc60d,8,0,123,123,8,2014-04-29 02:59:59,2014-04-29 02:59:59
55d8e03978e738ae652a7cc6cf1cbe1e0b32ad3c...5f4b44316dae09942be3c883118dc0d6b82b9fba,7,84,21,105,28,2014-03-28 18:12:35,2014-03-28 18:12:35
5f4b44316dae09942be3c883118dc0d6b82b9fba...2a833a224de32a977a279ddcb415e642c4b3c248,7,21,84,105,28,2014-03-30 07:54:50,2014-03-30 07:54:50
2a833a224de32a977a279ddcb415e642c4b3c248...a6152c392c972a0080fa3b8371f9de3ca79aaa9c,1,2,2,4,2,2014-03-31 03:30:08,2014-03-31 03:24:13
a6152c392c972a0080fa3b8371f9de3ca79aaa9c...8382013dd749a2bbe84df41d3c68a44646ed8ec8,1,28,15,43,6,2014-03-31 03:38:53,2014-03-31 03:24:41
55d8e03978e738ae652a7cc6cf1cbe1e0b32ad3c...e3f11c733a5c4a2c24a38c319e12ebf32e68c4fa,2,53,21,74,13,2014-03-27 04:37:13,2014-03-27 04:37:13
e3f11c733a5c4a2c24a38c319e12ebf32e68c4fa...d572363d62e2b54f82e6afbc956e95c9c4861929,3,104,32,136,21,2014-03-27 20:48:18,2014-03-27 20:48:18
d572363d62e2b54f82e6afbc956e95c9c4861929...7f814871d5c52d225d5598102133ca0388bd1fc5,1,13,2,15,3,2014-03-27 21:23:23,2014-03-27 21:23:23
7f814871d5c52d225d5598102133ca0388bd1fc5...9def0fafd74045da30af508cbb9c3aa318b6d651,1,5,1,6,3,2014-03-28 05:16:07,2014-03-28 05:16:07
9def0fafd74045da30af508cbb9c3aa318b6d651...bdc3257d6e303cedb66afbd617b43912aa6a25e7,3,14,16,30,15,2014-03-28 05:48:30,2014-03-28 05:16:28
bdc3257d6e303cedb66afbd617b43912aa6a25e7...86835b521b4250f176a13e5477a439bcceae65c5,1,1,2,3,1,2014-03-28 05:53:43,2014-03-28 05:53:43
dc9861e4d74c2c952bc581c95126caf32413eb1b...f48456c770b1ccad5e39bea1917de07b566f8684,1,1,1,2,1,2014-03-06 07:57:11,2014-03-06 07:57:11
749d9668170459461f217715cad35b7edb45d68c...7a85b92a09fd0cd6379612bc6d0e9e07985c9e9d,2,31,7,38,8,2014-03-13 00:27:51,2014-01-24 20:21:39
7a85b92a09fd0cd6379612bc6d0e9e07985c9e9d...0b9368e6ce2c1fb39d637ed6ece022d68db22496,2,21,11,32,11,2014-03-13 00:27:51,2014-03-07 01:10:46
0b9368e6ce2c1fb39d637ed6ece022d68db22496...6f6528143dc02d2b64ace1605be52adefde39389,1,2,0,2,1,2014-03-13 00:49:18,2014-03-13 00:49:18
53a7e818dc3d6829e3f931e36f7e2896c8be2e09...d6a611f8d52f10a2b3c26d64d4cd20f9f8bc484b,2,2,1,3,2,2014-04-03 20:21:11,2014-04-03 20:21:11
d6a611f8d52f10a2b3c26d64d4cd20f9f8bc484b...25ce6bc4f89074067e47b48f6b6bfbc516434156,4,88,17,105,8,2014-04-04 22:26:33,2014-04-04 22:26:33
25ce6bc4f89074067e47b48f6b6bfbc516434156...75cf184a76dd67d6e9828a1418d7a5a671cf1e3b,1,10,10,20,9,2014-04-04 22:33:47,2014-04-04 22:33:47
75cf184a76dd67d6e9828a1418d7a5a671cf1e3b...7168410d5458dcafaaf930a61491ba8edb5b37bb,2,5,5,10,5,2014-04-18 22:53:31,2014-04-18 22:53:31
d8575d0a24e76c2ee4ea57628e7c1896fe686303...75b34dff392c7c85f1c9165627e35db38cee3603,2,140,55,195,8,2014-03-18 03:22:22,2014-03-18 03:22:22
75b34dff392c7c85f1c9165627e35db38cee3603...42258895bed775eb8442be3544a971321840227f,1,25,8,33,5,2014-03-18 03:37:10,2014-03-18 03:37:10
42258895bed775eb8442be3544a971321840227f...af9bc84eccd67b33e6bfb49f4b664ff9d2f55a84,2,93,0,93,2,2014-03-18 21:32:07,2014-03-18 21:32:07
af9bc84eccd67b33e6bfb49f4b664ff9d2f55a84...20db762c6d829677b429d8f7a5f5f11a91a7c742,1,18,12,30,10,2014-03-18 21:38:40,2014-03-18 21:38:40
20db762c6d829677b429d8f7a5f5f11a91a7c742...53c83be0b87ff07f0ba8abc6809d423b1f2f53dc,4,17,21,38,7,2014-03-18 21:59:42,2014-03-18 21:59:42
8049f8175811c0744b19685710fb0abb5a7eff72...96e04e079c400012d8b7d23164722095020a6fc1,1,0,2,2,1,2014-03-07 00:38:50,2014-03-07 00:38:50
e9f9ec246fac43a6a3c836df29bfd91be2cd0cd9...ce77adc22ecbc433c25d3a82eef07e4f4a865bbf,1,0,2,2,1,2014-01-08 01:00:18,2014-01-08 01:00:18
ce77adc22ecbc433c25d3a82eef07e4f4a865bbf...53de3f21ba8921ac3c613e6abdddff2630364874,1,22,15,37,2,2014-01-08 01:15:06,2014-01-08 01:15:06
c124419bd23543bbe6aca8d89a43e42aa71334c2...7a5892bab0c473771c855c3afd6be2dc2639036d,1,2,2,4,1,2014-01-17 00:09:58,2014-01-17 00:09:58
7a5892bab0c473771c855c3afd6be2dc2639036d...e79ad2f309907864d0626941c1c1dc39de307404,1,14,2,16,3,2014-01-22 01:02:03,2014-01-22 00:37:38
0e0d8f218c808f00231b33d9250c020a4f4f0146...63319c8e6d8f7077657ede0ed9d0750d8f5bd56e,2,95,0,95,2,2014-01-26 19:52:26,2013-12-21 11:31:13
63319c8e6d8f7077657ede0ed9d0750d8f5bd56e...1223783e14f39374ec0e0a4a3b7b74c5aa4c0627,1,16,9,25,2,2014-01-26 19:52:26,2013-12-21 11:33:17
1223783e14f39374ec0e0a4a3b7b74c5aa4c0627...72a5d4282cc270b84bcb29d921ffd17f2786a979,2,34,16,50,4,2014-01-26 19:52:26,2014-01-24 10:05:15
72a5d4282cc270b84bcb29d921ffd17f2786a979...70aa9486346231a6ce2c607bb19f0c1c62abf4ab,3,31,1,32,4,2014-01-26 19:52:26,2013-12-21 16:57:48
70aa9486346231a6ce2c607bb19f0c1c62abf4ab...d46a5e11b1ffe4e49ee4f908e5a28a1a74114c5b,2,5,2,7,2,2014-01-26 19:52:27,2014-01-24 17:46:51
635b2c3910e02da86d9aef03d9abe2136a09f613...8cafffa82d4b63a9c585ca6893135fa022f4635a,6,56,0,56,6,2014-01-26 03:44:47,2014-01-26 03:44:47
8cafffa82d4b63a9c585ca6893135fa022f4635a...74d2730cf5436fb557ee43b700cf0fb31dc9f722,2,61,56,117,19,2014-01-26 04:18:34,2014-01-26 04:18:34
74d2730cf5436fb557ee43b700cf0fb31dc9f722...a3caf4a09ed0f60e9f358987f02cde56f9c75a15,2,25,6,31,2,2014-01-26 04:56:15,2014-01-26 04:56:15
0722127a8ab6a41fc8178d5e8df0407946b33a63...fb3c71a1414eeafbac9585ef444c5c4a20872b1f,1,0,2,2,1,2013-12-06 23:15:02,2013-12-06 23:14:42
fb3c71a1414eeafbac9585ef444c5c4a20872b1f...6c0908f5ab89b92ee80eb99586ef98f14fae7601,1,21,0,21,2,2013-12-07 01:27:08,2013-12-07 01:27:08
6c0908f5ab89b92ee80eb99586ef98f14fae7601...0ec049008bb4643caea6f3b45f47217259d4ba3a,3,85,7,92,7,2013-12-07 18:02:25,2013-12-07 18:02:05
0ec049008bb4643caea6f3b45f47217259d4ba3a...f3715306e185226b50f71adaaa836d82df930bba,2,61,4,65,6,2013-12-07 18:35:36,2013-12-07 18:35:36
f3715306e185226b50f71adaaa836d82df930bba...d304ebf865d1aaf4f4393bcbdad64b53b37eabcd,2,2,1,3,2,2013-12-07 20:27:22,2013-12-07 20:27:22
d304ebf865d1aaf4f4393bcbdad64b53b37eabcd...1d251574b755ddb07145fe50fce442bc1a371454,1,1,2,3,2,2013-12-07 20:39:32,2013-12-07 20:39:32
746e3abcbde61ad99c65a4951b8f3af4f9fdb317...fe661eeb61792c9e53eaade8f176383e3f7c11d2,3,123,11,134,7,2013-12-03 02:53:04,2013-12-03 02:52:06
1582372d5c25f7227002cf720be4ea6f3228f9ff...3177d9ad416ae97a98a2b8c4b2b40a9fc03f6b9c,8,125,73,198,18,2013-09-27 22:06:43,2013-09-27 02:42:16
27c364a21a327aa79d7916766982d2c10d3b18bc...c19d80a2711f26a7dc8dc504d99bb9ee86cffe9c,2,2,1,3,2,2013-12-20 02:10:25,2013-12-20 02:10:25
c19d80a2711f26a7dc8dc504d99bb9ee86cffe9c...a0efdc3ea52223212c0dd984cc61af87f42b3bcb,2,3,1,4,3,2013-12-20 02:10:40,2013-12-20 02:10:40
a0efdc3ea52223212c0dd984cc61af87f42b3bcb...121044de14a812e1083c03b56e0e3a49c9a8a651,2,138,0,138,2,2013-12-24 02:04:18,2013-12-24 02:04:18
121044de14a812e1083c03b56e0e3a49c9a8a651...801fcd789ff465b6f9244fc652e6c5e86a2b9e1a,2,8,15,23,7,2013-12-24 02:05:02,2013-12-24 01:16:27
801fcd789ff465b6f9244fc652e6c5e86a2b9e1a...9a67fb2f65781436dab10c56b5bbc24203f88134,1,8,2,10,2,2013-12-26 18:42:04,2013-12-26 18:42:04
27c364a21a327aa79d7916766982d2c10d3b18bc...943600df9b48899874c17f908c54cdbf95db9103,1,4,4,8,2,2013-12-19 23:42:33,2013-12-19 23:42:33
cd873c0e4771ae82266fa8336c9c6920ce00d7e0...e11228a3f8c8abf810b46406c58d22ddcf489668,1,24,9,33,5,2013-12-03 01:50:30,2013-12-03 01:50:30
a899d2c54de8b15df988d8155c45e71e035db2b5...50870590e2460faa1c2f702b5d9a69d447e1d380,2,7,1,8,3,2013-12-03 11:13:13,2013-12-03 11:13:13
50870590e2460faa1c2f702b5d9a69d447e1d380...c99b0f4475c910d08a5311a0e2ae98e4a078df1c,3,2,2,4,3,2013-12-03 11:29:29,2013-12-03 11:29:29
c99b0f4475c910d08a5311a0e2ae98e4a078df1c...1c3877eeb6628e913e5bfae281e51443a1a41c40,5,16,9,25,10,2013-12-03 11:49:34,2013-12-03 11:49:34
1c3877eeb6628e913e5bfae281e51443a1a41c40...76808dfce298f4e104f2caea9af10390f657071e,4,5,5,10,5,2013-12-03 11:57:28,2013-12-03 11:57:28
76808dfce298f4e104f2caea9af10390f657071e...eb591c417225fdb9224ea8ff191b857977ee9aeb,3,30,56,86,16,2013-12-04 09:47:50,2013-12-04 09:47:50
eb591c417225fdb9224ea8ff191b857977ee9aeb...6a308d1c972390ac1b5612a14c78d1d8a1a09c85,8,124,122,246,77,2013-12-04 10:10:47,2013-12-04 10:10:47
6a308d1c972390ac1b5612a14c78d1d8a1a09c85...842b6fec1b67bbd3a73f3760f8cd629058673239,1,5,0,5,1,2013-12-04 10:25:53,2013-12-04 10:25:53
a899d2c54de8b15df988d8155c45e71e035db2b5...fbab994430baef05dc6eb6c57276a1d5385c600b,2,15,0,15,4,2013-12-03 10:49:08,2013-12-03 09:12:10
1ace15543224d609accd4a3596aad0628e749ae8...e823b1e54af990aad627963241d7e4ad24da67e4,1,13,7,20,4,2013-08-01 23:11:06,2013-08-01 23:10:56
69b19330a244e231f0240aaa93737a756ca62989...36f870a6ab164c74741ad3342d9ae70bfac1ec2f,3,88,22,110,27,2013-04-01 06:01:44,2013-04-01 06:01:44
36f870a6ab164c74741ad3342d9ae70bfac1ec2f...a4118483250697a6274f99bcc574876ab2173f13,2,13,3,16,3,2013-04-01 06:13:14,2013-04-01 06:13:14
a4118483250697a6274f99bcc574876ab2173f13...3f8a41d9465bb29a3254ff51f99adc051e6d4ebc,1,7,3,10,4,2013-04-01 16:58:10,2013-04-01 16:58:10
3f8a41d9465bb29a3254ff51f99adc051e6d4ebc...72e744ca5a8399e26ec1e8151b01d9dac92b3437,3,10,7,17,5,2013-04-01 17:31:07,2013-04-01 17:31:07
72e744ca5a8399e26ec1e8151b01d9dac92b3437...4e70a1db66627bc6696b708019f0041e3badc9c9,1,2,1,3,1,2013-04-01 17:39:51,2013-04-01 17:39:51
4e70a1db66627bc6696b708019f0041e3badc9c9...441059692fabc7670892104a958c237eae646628,1,8,0,8,1,2013-04-01 17:41:51,2013-04-01 17:41:51
441059692fabc7670892104a958c237eae646628...028333f12b5ae2231c38f2f699a6d1d3666fc37d,1,42,2,44,4,2013-04-01 18:55:41,2013-04-01 18:55:41
028333f12b5ae2231c38f2f699a6d1d3666fc37d...d5cdc2b48adf6525211b23e7cac0f47d24f90847,3,13,9,22,6,2013-04-01 19:07:51,2013-04-01 19:07:51
d5cdc2b48adf6525211b23e7cac0f47d24f90847...f53cabc1e092e41cbaef44bc8c5c26bbfd8112e0,1,2,2,4,1,2013-04-01 19:14:31,2013-04-01 19:14:31
f53cabc1e092e41cbaef44bc8c5c26bbfd8112e0...43f6ea8a801a562313121244ac60c9e104c79970,5,5,5,10,5,2013-04-01 19:17:25,2013-04-01 19:17:25
43f6ea8a801a562313121244ac60c9e104c79970...8d220f6b4668fc39b156cc82f53fd8878c2f30d6,1,4,1,5,1,2013-04-01 19:27:20,2013-04-01 19:27:20
8d220f6b4668fc39b156cc82f53fd8878c2f30d6...c07f2946b88010e2742ebcf7e331b6d496bf03c0,2,11,5,16,4,2013-04-01 19:31:14,2013-04-01 19:31:14
69b19330a244e231f0240aaa93737a756ca62989...ccd09e285fd31ea3dd00e7e86fbd88821704dfce,3,105,23,128,28,2013-03-31 17:39:22,2013-03-31 17:39:22
ccd09e285fd31ea3dd00e7e86fbd88821704dfce...9deb5a5c85765c73cc661f53c0a66e2d64d506bd,2,26,37,63,14,2013-04-01 05:44:27,2013-04-01 05:44:27
9deb5a5c85765c73cc661f53c0a66e2d64d506bd...ff752cf17f765fb5fe532335d55af314609baa4f,1,8,1,9,1,2013-04-01 05:54:03,2013-04-01 05:54:03
ff752cf17f765fb5fe532335d55af314609baa4f...33c0797dcf9c26a3ca56fa3d6b3b54b709914fd1,1,9,21,30,1,2013-04-01 06:00:37,2013-04-01 06:00:37
69b19330a244e231f0240aaa93737a756ca62989...d2b8d8aad20b38dcb03e039b3e55ddd2e8731aed,1,31,14,45,9,2013-03-31 01:37:55,2013-03-31 01:37:55
d2b8d8aad20b38dcb03e039b3e55ddd2e8731aed...0d3e73e7ce567a25bd2d65bd92aa488d36d720af,1,14,9,23,1,2013-03-31 03:37:20,2013-03-31 01:52:51
c4cd9987722075a4105b730c4ea96100d11a5f5c...24e3c3e0e1d363b28e87cfd2d2e499048d4f8091,3,81,16,97,7,2014-05-28 19:12:15,2014-05-28 18:58:28
c4cd9987722075a4105b730c4ea96100d11a5f5c...18768e59d8023325905ccabbafead4ef9a704c58,1,6,2,8,2,2014-05-28 18:56:09,2014-05-28 18:51:47
c4cd9987722075a4105b730c4ea96100d11a5f5c...8fe4f57921c1dbe053a6dd0cd48889a0bebb9511,1,17,1,18,5,2014-05-28 17:35:53,2014-05-28 17:35:53
c4cd9987722075a4105b730c4ea96100d11a5f5c...f7b6aa47a6d23c39cb1698305aaeca487c8adc0c,2,14,4,18,3,2014-05-28 03:23:04,2014-05-28 03:23:04
f7b6aa47a6d23c39cb1698305aaeca487c8adc0c...ab6091ef43608af744c5c90de89f28afc4646c6c,1,5,0,5,1,2014-06-10 22:11:23,2014-06-10 22:11:23
d0abad9d66f03578dc1622b2208a0dc8775a720c...782c1afbd311ca0b70e99cf4ff5525174108edb5,1,9,0,9,1,2014-05-29 22:42:35,2014-05-29 22:42:35
782c1afbd311ca0b70e99cf4ff5525174108edb5...95c3ff365b2b31b98c101e9a7fb4f03927a1698d,3,21,5,26,7,2014-05-30 00:53:50,2014-05-10 12:26:41
95c3ff365b2b31b98c101e9a7fb4f03927a1698d...0da78aa3f0b7a16f02c72750eef68e7da262ef7d,1,1,1,2,1,2014-05-30 00:53:50,2014-05-10 12:29:50
0da78aa3f0b7a16f02c72750eef68e7da262ef7d...e444ad134bbaf936b300f8bbfbd9f61a1494489c,1,25,0,25,1,2014-05-30 00:53:50,2014-05-10 13:01:12
e444ad134bbaf936b300f8bbfbd9f61a1494489c...284f71666d472815b6b86f659063ac9966b7ffe1,3,8,21,29,6,2014-05-30 00:53:50,2014-05-30 00:47:47
284f71666d472815b6b86f659063ac9966b7ffe1...0d81b25aeb4fff49398b55087d10ce3613783376,1,2,2,4,2,2014-05-30 00:53:50,2014-05-30 00:52:47
0d81b25aeb4fff49398b55087d10ce3613783376...58ea689c83e980c21d1f9e8b82b278f736951894,1,4,1,5,2,2014-05-30 00:53:50,2014-05-30 00:53:43
9f477e974d9e7d2bb4f871622c5aa17bd741abd2...b46edf3c95c5a1c4ed102f99fe1e2fb3063e8040,2,37,1,38,6,2014-05-15 20:41:37,2014-04-25 04:53:06
b46edf3c95c5a1c4ed102f99fe1e2fb3063e8040...871277addee416f3773ad6a43633775d745e9f81,1,1,1,2,1,2014-05-15 20:46:40,2014-05-15 20:46:40
871277addee416f3773ad6a43633775d745e9f81...9ebf963be6826fd30573edd276bd6a170baae144,2,38,0,38,2,2014-05-15 20:55:55,2014-05-15 20:55:55
3c6b0ab73e1b853b4b4d597fdb10eb54a69591ff...5358af451cf073e538aad35bf752e2845010be20,1,8,5,13,2,2014-05-08 23:21:05,2014-05-08 23:21:05
5358af451cf073e538aad35bf752e2845010be20...1cfd91aaea9c234092605c30704fbc222247665f,1,27,24,51,4,2014-05-09 00:27:43,2014-05-09 00:27:43
682dd7895a71baed1b9ee24845efb7d2629699cc...9fb63da3c7a2898b0ace22107c7268bb984e69bb,4,65,5,70,8,2014-04-24 17:06:39,2014-04-24 16:56:42
9fb63da3c7a2898b0ace22107c7268bb984e69bb...cbd55698fd3374ed0fc5f4e902983de09dabb466,3,86,32,118,19,2014-04-24 20:45:55,2014-04-23 21:07:02
cbd55698fd3374ed0fc5f4e902983de09dabb466...41b5b95b3857e00d72da5fb25e0cc266266a4180,2,8,1,9,6,2014-04-24 21:01:34,2014-04-24 20:37:35
41b5b95b3857e00d72da5fb25e0cc266266a4180...4777e64336d3ca7c4baf61c549c14b742913fda2,2,50,20,70,17,2014-04-24 21:01:39,2014-04-24 20:28:53
4777e64336d3ca7c4baf61c549c14b742913fda2...c35593c5745310440b8f697f56f430b9609ee520,1,12,6,18,1,2014-04-24 21:13:05,2014-04-24 21:13:05
c35593c5745310440b8f697f56f430b9609ee520...bdcbe7fd4de37bdb433c6277f4de4926aa93aced,1,2,1,3,1,2014-04-24 22:30:05,2014-04-24 22:30:05
bdcbe7fd4de37bdb433c6277f4de4926aa93aced...42a65d07637adc92c8f40997eedf54d1ff0c34df,1,7,7,14,3,2014-04-24 22:31:31,2014-04-24 22:31:31
da4004880dac5bc70aefda384a5d261caa77985c...5fb16bcf36b55421da1a71a423c0cb2f0f86eb8d,2,4,4,8,3,2014-06-06 18:40:47,2014-06-06 18:40:47
5fb16bcf36b55421da1a71a423c0cb2f0f86eb8d...86cf6d08db59905c22ee57626bb9c984a72f2246,1,2,2,4,1,2014-06-06 18:45:33,2014-06-06 18:45:33
86cf6d08db59905c22ee57626bb9c984a72f2246...0e881d28a16b084565d817051401a846a3710a16,2,30,0,30,2,2014-06-06 18:46:09,2014-06-06 18:44:52
f68908b330ffac4bceea7a3584222804fe8e50fb...298e386aba22490eb3785b49998692b6f3579bc2,1,4,0,4,1,2014-04-17 23:24:02,2014-04-17 23:24:02
298e386aba22490eb3785b49998692b6f3579bc2...57ccb51881894ca4e1b1fd132fc28820ef5cb2e6,1,8,47,55,6,2014-04-17 23:26:16,2014-04-17 23:25:57
57ccb51881894ca4e1b1fd132fc28820ef5cb2e6...0a6e398b2e188802e2d82e8f0cd121d26b361410,1,2,0,2,1,2014-04-17 23:44:42,2014-04-17 23:43:34
90edfc8e71f1b6ff43b48435b48495870d99c320...74e80436874d38325ca2041d6a1caa0c9aa7ed28,4,206,69,275,13,2014-03-24 20:47:56,2014-03-18 16:36:00
74e80436874d38325ca2041d6a1caa0c9aa7ed28...3054b09790c2af74a511e17d2dc338370e053abc,1,13,7,20,2,2014-03-24 20:47:56,2014-03-19 04:12:40
3054b09790c2af74a511e17d2dc338370e053abc...d5af69eca601308c6a26dc277d0ab70b6bc5e8a6,1,11,0,11,2,2014-03-24 20:54:05,2014-03-24 20:54:05
a03ff1b6143e087f2e9c26e039acc92fc7df18a5...2b27950619f8f4170854cd4a43846168defb271c,1,23,0,23,1,2014-04-17 23:58:08,2014-04-17 23:55:57
2b27950619f8f4170854cd4a43846168defb271c...8a7e510081a2705eefacffb22db691ec57dc487a,1,3,0,3,1,2014-04-17 23:58:21,2014-04-17 23:56:54
8a7e510081a2705eefacffb22db691ec57dc487a...2194fc5fb6ca0a20d676ab459eac1250d7ee20f1,2,23,1,24,3,2014-04-18 20:05:06,2014-04-18 19:44:37
2194fc5fb6ca0a20d676ab459eac1250d7ee20f1...a4a66aeede5734bc0437f351a9987e2885ea8640,2,5,5,10,4,2014-04-18 20:43:51,2014-04-18 20:43:51
a4a66aeede5734bc0437f351a9987e2885ea8640...9b8bd31a7b6c857e5d8fc0393982e6e6b2973eb0,5,62,12,74,21,2014-04-18 21:15:14,2014-04-18 21:15:14
9b8bd31a7b6c857e5d8fc0393982e6e6b2973eb0...3fc4a30bfeebc3d69f52f0a9a0048706aa46a6e1,1,10,1,11,2,2014-04-18 21:39:31,2014-04-18 21:39:31
3fc4a30bfeebc3d69f52f0a9a0048706aa46a6e1...afd9640bb6349a886a0046ad6d254db1fcc97311,1,1,2,3,1,2014-04-18 21:39:50,2014-04-18 21:39:50
afd9640bb6349a886a0046ad6d254db1fcc97311...76ded8feb27a0d83f0b1857aa07e3a7c3d00c7d3,16,234,169,403,39,2014-04-18 22:09:59,2014-04-17 16:30:19
d399fe70cb1b77a5758b156ee70f8a7612a685cc...6569f50df147a12cc5f07daa0830290094036918,4,268,177,445,31,2014-05-07 18:51:16,2014-05-07 18:51:16
6569f50df147a12cc5f07daa0830290094036918...b4bd24b11357de24fe0bff10641808604b880fb0,1,13,3,16,4,2014-05-07 20:42:36,2014-05-07 20:42:36
b4bd24b11357de24fe0bff10641808604b880fb0...8986edc5d00da6e4206fd8b0935c7a0bde6d5d99,1,1,0,1,1,2014-05-07 20:55:31,2014-05-07 20:55:31
8986edc5d00da6e4206fd8b0935c7a0bde6d5d99...5e72f55eb2dcd1a120e85970fa50ffb1fd72dd00,4,65,38,103,17,2014-05-07 21:12:25,2014-05-07 21:12:25
5e72f55eb2dcd1a120e85970fa50ffb1fd72dd00...b710088247df27cdefccf2b0a82279c3ec90057f,2,15,12,27,6,2014-05-07 21:45:55,2014-05-07 21:45:55
b710088247df27cdefccf2b0a82279c3ec90057f...55f996fc6cdab971bf2a4332a355a55df95f0916,4,77,24,101,11,2014-05-07 22:44:11,2014-05-07 22:44:11
55f996fc6cdab971bf2a4332a355a55df95f0916...8b0050ac5b9d61e7bb47fbe5bbc7f5b4a0fe3afa,1,21,3,24,5,2014-05-08 05:49:14,2014-05-08 05:49:14
8b0050ac5b9d61e7bb47fbe5bbc7f5b4a0fe3afa...4de82af7088a47be58f0e9edf05667a5620fa2d3,3,40,6,46,9,2014-05-08 06:53:35,2014-05-08 06:53:35
4de82af7088a47be58f0e9edf05667a5620fa2d3...472036f755b1793c7c06744a539c5ce1389d6c4c,1,2,0,2,2,2014-05-08 07:01:41,2014-05-08 07:01:41
d399fe70cb1b77a5758b156ee70f8a7612a685cc...7ec7cb4d97cbbc94953059bab16fe902de9ed25a,4,59,2,61,6,2014-05-07 18:27:25,2014-05-07 18:27:25
7ec7cb4d97cbbc94953059bab16fe902de9ed25a...332e531a9836c391fe059a76a35ac1e51694db74,3,21,2,23,5,2014-05-08 19:07:03,2014-05-08 19:07:03
332e531a9836c391fe059a76a35ac1e51694db74...7dd6fa1478c85d0b5f0c523875c6368a02d91ae0,1,1,1,2,1,2014-05-08 19:35:45,2014-05-08 19:35:45
7dd6fa1478c85d0b5f0c523875c6368a02d91ae0...f664bff44ad56ebb6dc0d2bfdc44c6a9d479258e,1,8,5,13,2,2014-05-08 23:38:50,2014-05-08 23:21:05
f664bff44ad56ebb6dc0d2bfdc44c6a9d479258e...0d767e746f70c1fd290305b703b1c4960d5cdc26,1,28,0,28,1,2014-05-08 23:38:51,2014-05-08 23:38:35
0d767e746f70c1fd290305b703b1c4960d5cdc26...a1c619568879a39f2417d313489e419c6cb6e51b,1,4,2,6,2,2014-05-09 01:56:03,2014-05-09 01:56:03
a1c619568879a39f2417d313489e419c6cb6e51b...14f6570d73e1f940f514f8c1c22c36cd874d1435,3,68,16,84,11,2014-05-09 18:25:42,2014-05-09 18:25:27
14f6570d73e1f940f514f8c1c22c36cd874d1435...4bb7bb816133769b318c7de1ecf1c5b843ac4cfa,1,1,1,2,1,2014-05-12 18:02:39,2014-05-12 18:02:39
4bb7bb816133769b318c7de1ecf1c5b843ac4cfa...4997d57b5bd0633126de02871aec44f97bb8c5ca,3,7,0,7,6,2014-05-12 18:02:49,2014-05-12 18:02:49
4997d57b5bd0633126de02871aec44f97bb8c5ca...d2f27edba97747b68ba1b9a76c4b8b949c9a84f2,2,107,129,236,14,2014-05-12 20:04:46,2014-05-12 20:04:46
d2f27edba97747b68ba1b9a76c4b8b949c9a84f2...2da8567df73d21481f32e5bda6aca3cc50a75bbb,2,29,8,37,10,2014-05-12 20:49:35,2014-05-12 20:49:35
2da8567df73d21481f32e5bda6aca3cc50a75bbb...1afad16528cbc26f8444624152da80e76d101a49,1,1,1,2,1,2014-05-12 23:06:05,2014-05-12 23:06:05
1afad16528cbc26f8444624152da80e76d101a49...5d67910ce82e9de384b82ee6867bcf1d2af94e6d,1,17,3,20,4,2014-05-12 23:24:04,2014-05-12 23:08:00
5d67910ce82e9de384b82ee6867bcf1d2af94e6d...a51b4697aea2cb4466b4aba1cdcbfce7b4904b47,3,52,14,66,8,2014-05-12 23:24:36,2014-05-12 23:08:40
a51b4697aea2cb4466b4aba1cdcbfce7b4904b47...6696e2751e4ce145366d2433e51bad4c70d12ff8,3,7,7,14,6,2014-05-12 23:45:49,2014-05-12 23:45:49
6696e2751e4ce145366d2433e51bad4c70d12ff8...573ef7489f4c7cb67b60a7e6c8d60dd77a71752f,2,16,3,19,8,2014-05-13 18:58:31,2014-05-13 18:58:31
c2829941e7580ff85119e9a66e1f5ed2dd58b001...028248f849a3dcce310ca74f91d2798a60c781a0,2,16,2,18,3,2014-05-09 19:12:13,2014-05-09 19:12:13
028248f849a3dcce310ca74f91d2798a60c781a0...aa656ae8facc2cddabb35d9a8031b6ddd43f0c15,3,25,11,36,11,2014-05-09 21:23:20,2014-05-09 21:23:20
8382013dd749a2bbe84df41d3c68a44646ed8ec8...9f3ff7da0f732d1d531ee4be6227108495aa0da4,2,104,1,105,6,2014-03-31 03:39:38,2014-03-28 17:49:52
9f3ff7da0f732d1d531ee4be6227108495aa0da4...077437bea6cbf12d9d281808b09cfa1e4ee84f0a,1,8,18,26,5,2014-03-31 03:39:39,2014-03-28 18:18:40
077437bea6cbf12d9d281808b09cfa1e4ee84f0a...8d0f57ef598941807ac039d353717e6a7b6c3023,1,3,1,4,1,2014-03-31 03:39:39,2014-03-28 19:34:45
8d0f57ef598941807ac039d353717e6a7b6c3023...601393d90faa03e407fc1ab8c923a7252db53216,1,4,2,6,2,2014-03-31 03:39:39,2014-03-28 19:35:30
601393d90faa03e407fc1ab8c923a7252db53216...f55c501ae9984ec0920484b33de3d8f503152966,1,3,2,5,1,2014-03-31 03:39:39,2014-03-28 19:36:30
f55c501ae9984ec0920484b33de3d8f503152966...58e4a31df8702c83ffe7f14046b632734d646194,1,3,3,6,1,2014-03-31 03:39:39,2014-03-28 20:51:23
58e4a31df8702c83ffe7f14046b632734d646194...9d174696e73841dd0b12409680031dff5824f5b1,1,0,5,5,1,2014-03-31 03:39:39,2014-03-28 20:52:26
9d174696e73841dd0b12409680031dff5824f5b1...af195e2f488ee89c4283fa26c2a72de54f19019b,1,51,16,67,5,2014-03-31 03:39:39,2014-03-28 22:45:06
af195e2f488ee89c4283fa26c2a72de54f19019b...1b66cf60d749afe9c623ca72bee4188751208140,1,77,5,82,6,2014-03-31 03:39:39,2014-03-28 22:45:30
1b66cf60d749afe9c623ca72bee4188751208140...62153ce0b079ed7cbda47a3256b82db2876623ec,1,0,25,25,1,2014-03-31 03:39:39,2014-03-30 16:01:42
62153ce0b079ed7cbda47a3256b82db2876623ec...ae506b67071325402afb96b4235bb3bca032cddb,6,13,28,41,18,2014-03-31 03:40:31,2014-03-30 16:07:53
ae506b67071325402afb96b4235bb3bca032cddb...e3b9c09319330f74d6045b82729e298a3be1579d,1,0,15,15,1,2014-03-31 03:40:31,2014-03-30 16:18:56
e3b9c09319330f74d6045b82729e298a3be1579d...2ca550ae6ea754767677d2639c66e5648bcadd4b,1,6,4,10,4,2014-03-31 04:55:52,2014-03-31 04:55:52
44449954c3a3ddaf1f31de0878b1456891957540...ba4877904172ce22754502f6beb63b84126f0df9,4,36,16,52,13,2014-03-06 09:25:47,2014-03-06 09:25:47
f48456c770b1ccad5e39bea1917de07b566f8684...6f6f18671510505bc0f55df25684ff041a0ea138,1,2,2,4,2,2014-03-06 09:24:06,2014-03-06 09:24:06
b4520c84dea4bfc08254a323d76cdbdd2cd37132...1f276e7ff83d557d1e876a827d32a9f9e7dc9eb5,1,2,2,4,2,2014-03-13 17:59:19,2014-03-13 17:59:19
1f276e7ff83d557d1e876a827d32a9f9e7dc9eb5...d737c06fc66017139de4c0f7080e1de1083c30c5,1,3,4,7,2,2014-03-13 18:03:13,2014-03-13 18:03:13
d737c06fc66017139de4c0f7080e1de1083c30c5...dd4a4f0734b1eb7119060b0b1909044d8760ceb1,1,1,1,2,1,2014-03-13 18:04:27,2014-03-13 18:04:27
dd4a4f0734b1eb7119060b0b1909044d8760ceb1...a46f5591a62d061af8547cca44aa7d93c1b7887f,1,13,6,19,2,2014-03-14 00:22:53,2014-03-14 00:22:53
a46f5591a62d061af8547cca44aa7d93c1b7887f...fcf08c966a60196d5eb640f97fb98e40a058ad5f,1,2,2,4,1,2014-03-14 00:27:36,2014-03-04 21:49:40
fcf08c966a60196d5eb640f97fb98e40a058ad5f...22854bee9b14e1aff884b1877fc84639b3ea328d,2,5,4,9,3,2014-03-14 00:38:20,2014-03-05 06:38:07
22854bee9b14e1aff884b1877fc84639b3ea328d...adf3f6553fc7de5b37cf15dfe74f8da393979d5e,1,8,3,11,2,2014-03-14 00:38:20,2014-03-05 06:28:07
adf3f6553fc7de5b37cf15dfe74f8da393979d5e...728ce8d251fb8c05fb3e7da3028e3a896bddd334,1,3,0,3,1,2014-03-14 00:38:20,2014-03-14 00:35:56
728ce8d251fb8c05fb3e7da3028e3a896bddd334...f91d8707787f70f045d10223370bba1137c56e80,1,2,9,11,1,2014-03-14 02:46:01,2014-03-14 02:46:01
f91d8707787f70f045d10223370bba1137c56e80...b855f2d7c5c1757fea11253ffb376b1077157f3f,1,9,2,11,1,2014-03-14 03:41:47,2014-03-14 03:41:47
b855f2d7c5c1757fea11253ffb376b1077157f3f...0d4b220111e083d90360e8b794e2ce3fe7c7cc29,1,3,0,3,1,2014-03-14 19:19:44,2014-03-14 19:19:44
0d4b220111e083d90360e8b794e2ce3fe7c7cc29...0a5800eb67f5789d4d6b2786af5999b20b9a07e0,1,42,5,47,7,2014-03-14 23:29:24,2014-03-14 23:29:24
ddf8a0c8dc576b4fa8b9fd8a3a75fb20acd98fbb...a251255001d1a289c7beb2d570ba866d4cda262e,16,169,234,403,39,2014-04-21 20:39:36,2014-04-21 18:56:06
a251255001d1a289c7beb2d570ba866d4cda262e...8c3855031519c3b6d6a4a54337bb67e26f2053ff,16,29,19,48,16,2014-04-21 20:39:36,2014-04-21 20:35:54
53c83be0b87ff07f0ba8abc6809d423b1f2f53dc...2f7724ac2a0df960b686f18bcd42616488f4aaa2,2,21,0,21,2,2014-03-19 04:53:07,2014-03-19 04:53:07
2f7724ac2a0df960b686f18bcd42616488f4aaa2...fba5d95cfea3a2581fd3998cce181c1cd1734f07,2,1,5,6,2,2014-03-19 20:36:45,2014-03-19 20:36:45
fba5d95cfea3a2581fd3998cce181c1cd1734f07...6e945e29e797fd4064ce25bc087936d391fe7d3a,2,41,0,41,2,2014-03-20 16:38:35,2014-03-20 16:38:35
6e945e29e797fd4064ce25bc087936d391fe7d3a...c910fce4c625da442371066d90d990fa49a2b193,3,46,93,139,19,2014-03-20 16:39:13,2014-03-20 16:39:13
c910fce4c625da442371066d90d990fa49a2b193...2b10bf37940d8575d880934d08cbe93b231adec0,1,0,200,200,2,2014-03-20 17:25:39,2014-03-20 17:25:39
2b10bf37940d8575d880934d08cbe93b231adec0...adbadbfbc6490067b3b8de4d9fe57d6dd08d4bd4,2,53,18,71,9,2014-03-20 20:39:54,2014-03-20 20:39:54
adbadbfbc6490067b3b8de4d9fe57d6dd08d4bd4...3eb4e97112ec4f9d7fc18acbc79e52cb95f21769,1,12,9,21,8,2014-03-20 21:14:54,2014-03-20 21:14:54
53c83be0b87ff07f0ba8abc6809d423b1f2f53dc...2192a81f664a5298b2b570e64a1aa7861b89f5a2,6,122,103,225,21,2014-03-19 01:36:41,2014-03-18 04:56:52
2192a81f664a5298b2b570e64a1aa7861b89f5a2...837090884114ca2321b26e6376995550a6d087c4,1,36,14,50,6,2014-03-19 17:12:34,2014-03-19 17:12:34
837090884114ca2321b26e6376995550a6d087c4...69c1d708afaaeaff0d4544e221aa963e683cfc07,2,3,1,4,2,2014-03-19 18:13:16,2014-03-19 18:13:16
69c1d708afaaeaff0d4544e221aa963e683cfc07...73f3fe7235da31b8d310af61470062d4619938e9,1,23,16,39,4,2014-03-21 00:54:53,2014-03-21 00:54:53
73f3fe7235da31b8d310af61470062d4619938e9...661ce2a807ab5b215b128e96b1c13902634708f9,2,6,6,12,2,2014-03-21 18:35:20,2014-03-21 18:35:20
661ce2a807ab5b215b128e96b1c13902634708f9...6584f2bd47eaee9c8c6ed97f09b9e73315cdc6ca,1,3,1,4,1,2014-03-21 18:42:09,2014-03-21 18:42:09
6584f2bd47eaee9c8c6ed97f09b9e73315cdc6ca...8b49746f06379375595e3b27c3b4ed148cc00c48,1,2,6,8,4,2014-03-21 18:59:01,2014-03-21 18:50:54
8b49746f06379375595e3b27c3b4ed148cc00c48...e077e138e6c4ee2cd5c05eaae725dbaabd51110c,1,2,2,4,1,2014-03-21 19:24:41,2014-03-21 19:24:41
40637078ace1030a4fd37ff12c61b2e0b40ff282...876276418a1fe24e8c75f9de6ecb502282d9c927,4,4,4,8,5,2014-03-07 02:02:14,2014-03-07 02:02:14
53de3f21ba8921ac3c613e6abdddff2630364874...c6bea042b7a0a39bea6dfa529cfb3a1ac0fe3d15,1,2,2,4,1,2014-01-08 01:23:34,2014-01-03 13:34:43
c6bea042b7a0a39bea6dfa529cfb3a1ac0fe3d15...8a3f24765b4413d2ce7179ba2906332f2693cb36,1,1,1,2,1,2014-01-08 01:23:49,2014-01-08 01:23:49
e79ad2f309907864d0626941c1c1dc39de307404...4e85255a387d130aa8c376723aa0e6c37ab69714,5,17,12,29,9,2014-01-22 22:59:19,2014-01-22 22:59:19
4e85255a387d130aa8c376723aa0e6c37ab69714...87074a73891bdc776d078f80244d922fb23f0020,1,9,7,16,3,2014-01-23 19:22:27,2014-01-23 19:22:27
1bd0d4764a9ed8909d44b02871b55a0d440ace57...28227b783cdf8f78ff59bc3596789a8bd4edf3dd,2,5,2,7,3,2014-02-14 02:48:07,2014-02-14 01:38:51
1bd0d4764a9ed8909d44b02871b55a0d440ace57...a4e5a07cab630f7f32b5824baf3f72eb2c4b52a7,1,2,1,3,1,2014-02-13 19:48:01,2014-02-13 19:48:01
a4e5a07cab630f7f32b5824baf3f72eb2c4b52a7...6cf1a76332385192b21753953adcbd4dbda74c07,1,136,37,173,22,2014-02-13 21:07:37,2014-02-13 19:48:24
6471dce8fa4a0b90c29ab81229e777388a6782a9...43cb4f8cc8c6fdeeb519d386ec0cc361f2382be2,3,7,7,14,7,2014-01-27 22:44:19,2014-01-26 05:26:04
43cb4f8cc8c6fdeeb519d386ec0cc361f2382be2...54a2423acb5a841fff9b9a489093a2602a598e32,1,1,1,2,1,2014-01-27 22:44:19,2014-01-27 21:55:31
54a2423acb5a841fff9b9a489093a2602a598e32...7c58b08f5361fcedc3e7ed8155fbd85d28cab981,1,1,1,2,1,2014-01-27 22:44:19,2014-01-27 21:55:54
7c58b08f5361fcedc3e7ed8155fbd85d28cab981...599ac1663275f153341405230d84dd033eaf89b0,10,168,26,194,21,2014-01-27 22:44:19,2014-01-27 22:39:35
599ac1663275f153341405230d84dd033eaf89b0...b26f0271a0672881731ba340cb83aa9bef9072db,5,12,12,24,10,2014-01-27 22:44:19,2014-01-27 22:41:24
5038c63d08833569decc04de0e688902ea345ae6...89b11490d694d4441bdd73e2783a70ac7a633e6c,1,1,1,2,1,2014-01-27 23:27:32,2014-01-26 19:35:53
1d251574b755ddb07145fe50fce442bc1a371454...87921cf178275bce80f613e83f41a41935981d69,22,789,787,1576,95,2013-12-10 06:23:27,2013-12-10 06:23:27
87921cf178275bce80f613e83f41a41935981d69...cb2d331dbfdef0887424eee555ab0a66679ef303,7,16,167,183,14,2013-12-10 06:52:20,2013-12-10 06:52:20
cb2d331dbfdef0887424eee555ab0a66679ef303...556870983e8a32c7a7c5fa48ff0a21cd5c9ca15a,10,76,103,179,30,2013-12-10 07:12:12,2013-12-10 07:12:12
556870983e8a32c7a7c5fa48ff0a21cd5c9ca15a...e954329334944ce36985f4a6e43456e9ba8abb17,3,27,27,54,19,2013-12-10 07:22:51,2013-12-10 07:22:51
e954329334944ce36985f4a6e43456e9ba8abb17...54ef42a8f8b0da533063a1b378fea8b722ebdc3f,1,23,0,23,1,2013-12-10 07:31:04,2013-12-10 07:31:04
54ef42a8f8b0da533063a1b378fea8b722ebdc3f...01adc79763e365dbb6a595a130bcc2d353a64fbe,2,16,1,17,2,2013-12-10 07:35:30,2013-12-10 07:35:30
01adc79763e365dbb6a595a130bcc2d353a64fbe...b5b292ddf6b022d5d4de94bb8057bdd5f3785eda,7,52,16,68,16,2013-12-10 19:30:17,2013-12-10 19:30:17
b5b292ddf6b022d5d4de94bb8057bdd5f3785eda...c7dab4859a436692b7488546f6b968b991db615c,1,56,0,56,1,2013-12-10 19:47:33,2013-12-10 19:47:33
3177d9ad416ae97a98a2b8c4b2b40a9fc03f6b9c...d4d7ebb78318ff74a45d5c08662ca08091654560,2,41,33,74,27,2013-09-28 00:00:22,2013-09-23 23:35:37
d4d7ebb78318ff74a45d5c08662ca08091654560...3e1afb78501dcade1a57c71d7acc821939ee8122,2,27,7,34,7,2013-09-28 00:00:22,2013-09-24 00:44:34
3e1afb78501dcade1a57c71d7acc821939ee8122...7f490a4081c70fe504567826a3b4884b691e21c8,2,14,4,18,6,2013-09-28 00:00:22,2013-09-24 23:08:40
7f490a4081c70fe504567826a3b4884b691e21c8...b86ba7e3dad23411559a29ebab4c678ae97f393c,1,3,0,3,1,2013-09-28 00:00:49,2013-09-24 23:11:29
e11228a3f8c8abf810b46406c58d22ddcf489668...4ea191e452bfc104d5a9805a622bf37ac9a2c405,2,6,5,11,3,2013-12-03 03:12:09,2013-12-03 03:12:09
842b6fec1b67bbd3a73f3760f8cd629058673239...5cef548ef457616454d6c7ce446984b756f665d0,1,2,2,4,1,2013-12-04 22:11:27,2013-12-04 19:56:37
5cef548ef457616454d6c7ce446984b756f665d0...8dd9443fa3b5ccb47ef68d4a33877ff1f5d1ebcd,1,9,6,15,1,2013-12-04 22:11:27,2013-12-04 20:09:07
8dd9443fa3b5ccb47ef68d4a33877ff1f5d1ebcd...1f4cd80d53df00919543a9b50daf5c7d0bc28139,3,7,4,11,4,2013-12-05 04:43:58,2013-12-05 04:43:58
1f4cd80d53df00919543a9b50daf5c7d0bc28139...5d5e0cc22e316efbc14a224427e5a7d0e50f447d,1,1,1,2,1,2013-12-05 04:44:56,2013-12-05 04:44:56
5d5e0cc22e316efbc14a224427e5a7d0e50f447d...43281234fe8a5d583210041cdcaaf8e4e4a4a266,1,2,2,4,2,2013-12-05 04:54:11,2013-12-05 04:54:11
43281234fe8a5d583210041cdcaaf8e4e4a4a266...f5be26597ecb6c77a53d8c0f6c32848fab87451f,1,13,4,17,2,2013-12-05 04:54:36,2013-12-05 04:54:36
f5be26597ecb6c77a53d8c0f6c32848fab87451f...d64aae3be6495a7eccfbaa3c3995659079616046,3,18,5,23,5,2013-12-05 05:10:09,2013-12-05 05:10:09
d64aae3be6495a7eccfbaa3c3995659079616046...609c40cf6f10d8d45d1e26d6636546f6f80808fb,2,45,7,52,6,2013-12-05 05:52:45,2013-12-05 05:52:45
e823b1e54af990aad627963241d7e4ad24da67e4...9c3cd308517efe7ac86cbabca861dea46c7286fb,1,40,1,41,3,2013-08-02 01:12:27,2013-08-02 01:12:27
e823b1e54af990aad627963241d7e4ad24da67e4...7db4b8eaf0fb6d67f335f4b7f9aa19652a7d7564,1,31,13,44,6,2013-08-02 00:43:13,2013-08-02 00:42:20
7db4b8eaf0fb6d67f335f4b7f9aa19652a7d7564...1cd8931eff11e6393086af76a44dd2e39a9de21f,1,4,2,6,2,2013-08-02 06:56:33,2013-08-02 06:56:33
1cd8931eff11e6393086af76a44dd2e39a9de21f...ec05981a1a76e3f76ed58b8e06f1227846f1e3a1,1,17,8,25,4,2013-08-02 19:37:44,2013-08-02 19:37:44
ec05981a1a76e3f76ed58b8e06f1227846f1e3a1...cd3d87625f7ddc2cc8f9d474576bbc03514e2ce3,1,1,1,2,1,2013-08-02 19:41:29,2013-08-02 19:41:29
cd3d87625f7ddc2cc8f9d474576bbc03514e2ce3...1023a97e07d70f436a4fba41c42b4bb66073180e,2,34,0,34,3,2013-08-02 21:22:00,2013-08-02 21:15:34
1023a97e07d70f436a4fba41c42b4bb66073180e...86022fb06eae0a89500a92c6f55126e3162a66cd,1,5,0,5,2,2013-08-02 21:25:03,2013-08-02 21:20:38
86022fb06eae0a89500a92c6f55126e3162a66cd...ffc31748f5dd2e81e475889c440f9ce2ddd8c996,1,1,1,2,1,2013-08-02 21:25:03,2013-08-02 21:20:59
ffc31748f5dd2e81e475889c440f9ce2ddd8c996...67129c7e7076b93b81b7393ed840fee23319d3ad,1,4,6,10,2,2013-08-02 22:22:49,2013-08-02 22:22:49
67129c7e7076b93b81b7393ed840fee23319d3ad...580de65f62a76a550e8deb261df0816f7a515f72,2,11,11,22,3,2013-08-05 20:26:43,2013-08-05 20:26:43
580de65f62a76a550e8deb261df0816f7a515f72...e16738e92004e04086f4baea3fa007a8123843df,1,16,6,22,3,2013-08-05 23:14:59,2013-08-05 23:14:59
c07f2946b88010e2742ebcf7e331b6d496bf03c0...3b137562c6f2a243befdbf79ddfb9dd575fc43f9,1,1,1,2,1,2013-04-01 22:03:28,2013-04-01 22:03:28
3b137562c6f2a243befdbf79ddfb9dd575fc43f9...8d5c72095c401a45857f6f59f19bb971871cdb11,1,1,1,2,1,2013-04-01 22:29:23,2013-04-01 22:29:23
8d5c72095c401a45857f6f59f19bb971871cdb11...aaae84aa60457d543814830c72cac6e35b2b6e88,2,6,6,12,3,2013-04-01 22:29:50,2013-04-01 22:29:50
aaae84aa60457d543814830c72cac6e35b2b6e88...37efbe767a1073912f45fd82deface72f5b4389c,1,8,0,8,1,2013-04-01 22:38:10,2013-04-01 22:38:10
37efbe767a1073912f45fd82deface72f5b4389c...7a732d7bbe36558b24acb378dbd96a32ddf1ee6d,1,6,5,11,3,2013-04-01 23:00:05,2013-04-01 23:00:05
c07f2946b88010e2742ebcf7e331b6d496bf03c0...beca43e6e8f988da0186891320f13f3f346df5d5,4,29,3,32,7,2013-04-01 21:29:16,2013-03-29 18:04:49
beca43e6e8f988da0186891320f13f3f346df5d5...2c9af3e5b584e020f4cf780b2d7e6780d1d5fd0f,3,23,19,42,4,2013-04-01 21:29:16,2013-04-01 21:27:32
2c9af3e5b584e020f4cf780b2d7e6780d1d5fd0f...a51250f88130487fe1e3ad5b512c750acc496643,2,3,8,11,5,2013-04-01 21:29:16,2013-04-01 21:28:37
24e3c3e0e1d363b28e87cfd2d2e499048d4f8091...ba1450ced5a1334fb320e748219b4dfab9365c77,1,2,2,4,1,2014-05-29 04:01:46,2014-05-27 20:46:50
ba1450ced5a1334fb320e748219b4dfab9365c77...af9192d8c02d4ebda4651deb87ce95e7368f0110,4,36,5,41,10,2014-05-29 04:01:46,2014-05-27 21:10:54
588d0497acbd9a5bcbb222c73e84370d290ca64b...65b76b2bc91ef1c5c1218722c557ab208f28d80c,4,77,4,81,7,2014-06-02 20:51:13,2014-05-30 21:11:25
05bfdc297ed2bc30d2c873857928bc41e2e5dda2...1ce98b5e025af40f39b1f39c8eef85a2de5d690a,1,2,0,2,1,2014-06-10 22:39:06,2014-06-10 22:39:06
1ce98b5e025af40f39b1f39c8eef85a2de5d690a...31a0db621fbbc3dc2cd8c9eb0640789d0299a276,1,3,0,3,1,2014-06-10 23:04:19,2014-06-10 23:04:19
31a0db621fbbc3dc2cd8c9eb0640789d0299a276...b3d7434e0635620bc6f1fd4f913670bdd56b36b6,2,1,6,7,2,2014-06-10 23:40:26,2014-05-28 17:49:48
b3d7434e0635620bc6f1fd4f913670bdd56b36b6...4acfc5c6fffee42842b074ae36c5b3b1b739cf99,1,18,11,29,8,2014-06-10 23:59:51,2014-06-04 06:32:51
0787e2f5d8453ca7ef3df02b2ddc02878dfaa4cd...897cc78d8454996cb743efb1829263159cbdcb05,1,2,1,3,2,2014-06-23 23:36:16,2014-06-23 23:35:55
897cc78d8454996cb743efb1829263159cbdcb05...72c3646cfe9213d20daa533581527ab0c92db77c,1,1,2,3,1,2014-06-23 23:38:35,2014-06-23 23:38:35
72c3646cfe9213d20daa533581527ab0c92db77c...c5292257533fd899dde0d4f3849864d23090c26e,1,1,1,2,1,2014-06-24 15:33:30,2014-06-24 15:33:02
c5292257533fd899dde0d4f3849864d23090c26e...7106caef4910749e048594f6a447013bff5314bc,2,5,8,13,2,2014-07-07 18:44:10,2014-07-07 18:44:10
7106caef4910749e048594f6a447013bff5314bc...5b80ea33b94acf1265dac057cf55f168249f94c5,2,19,1,20,5,2014-07-09 01:40:10,2014-07-09 00:59:31
5b80ea33b94acf1265dac057cf55f168249f94c5...121a4adff2b9f315b6f6dae9501d69f27aa09934,2,2,2,4,2,2014-07-09 01:55:21,2014-07-09 01:55:21
bf8426322c8ac57dc81714bef095830447e2eaf0...1492da8ed4cc7ab1edf1c6a70f63a2ac312c9871,1,1,1,2,1,2014-05-22 19:10:26,2014-05-22 19:10:26
1492da8ed4cc7ab1edf1c6a70f63a2ac312c9871...7fab1715eeddfa4f87fd8285bad9f25f08ac0d7b,1,2,1,3,1,2014-05-22 19:26:54,2014-05-22 19:26:54
7fab1715eeddfa4f87fd8285bad9f25f08ac0d7b...98d81904f16fa5a60df96f335b2a5845719088ec,1,1,1,2,1,2014-05-22 22:24:43,2014-05-16 01:10:50
98d81904f16fa5a60df96f335b2a5845719088ec...21bc8be7dfd23b6ae6cce54df3a13ebfe2fa9d09,1,2,1,3,1,2014-05-22 22:43:26,2014-05-22 22:43:26
21bc8be7dfd23b6ae6cce54df3a13ebfe2fa9d09...816641caad004537f268ce42151aed289e40a7a4,1,2,2,4,2,2014-05-22 22:57:54,2014-05-20 18:08:34
816641caad004537f268ce42151aed289e40a7a4...c2e075393f63dfcc5378098c7a04aa57cc10ee5b,1,0,1,1,1,2014-05-22 23:06:26,2014-05-22 09:49:21
c2e075393f63dfcc5378098c7a04aa57cc10ee5b...2c7e71b47d158bc2581d8eaac1803b8e2ce25b08,2,13,7,20,5,2014-05-23 02:32:41,2014-05-22 00:26:18
2c7e71b47d158bc2581d8eaac1803b8e2ce25b08...875274d2a4ad8f5f25e0754503b3e374d0790b1c,1,5,1,6,2,2014-05-24 00:15:35,2014-05-24 00:15:35
875274d2a4ad8f5f25e0754503b3e374d0790b1c...00157d8aed23fc290fb985fef73b1c293fa24e63,1,1,1,2,1,2014-05-24 00:53:35,2014-05-24 00:53:35
00157d8aed23fc290fb985fef73b1c293fa24e63...2e7940865813a425dc8e1340a3dcf85c1eda9c18,1,4,0,4,1,2014-05-24 01:08:13,2014-05-24 01:08:13
a416ef847b3f4bbf7720ccbe5e946333a453833e...a3d71cae7458e462daa621493b1c8bf78d4ea265,1,2,2,4,1,2014-05-16 18:09:37,2014-05-16 18:09:37
a3d71cae7458e462daa621493b1c8bf78d4ea265...78b280ef88aef02d96691b5ecf514ecbf6123957,1,27,12,39,6,2014-05-17 00:46:05,2014-05-16 19:40:01
78b280ef88aef02d96691b5ecf514ecbf6123957...e86578e52b473394fb7e1acddec1584cfd095ad1,1,2,1,3,1,2014-05-17 16:51:08,2014-05-17 16:50:53
e86578e52b473394fb7e1acddec1584cfd095ad1...6f8e18b5d7dee3867bdf838771bd3c3a7bb004c5,1,2,2,4,1,2014-05-18 08:39:53,2014-05-18 08:39:53
6f8e18b5d7dee3867bdf838771bd3c3a7bb004c5...9c4e305178388b39dc887716f9ccace7e774d20a,2,2,10,12,3,2014-05-18 19:42:37,2014-05-18 19:42:37
1cfd91aaea9c234092605c30704fbc222247665f...829325928e704f46addc6cbd0b383262b7823c0a,1,13,18,31,2,2014-05-09 00:58:41,2014-05-05 12:38:20
829325928e704f46addc6cbd0b383262b7823c0a...d6e53c0428e37e4e8571fdf2f7808e11e2ff4e71,1,6,10,16,3,2014-05-09 01:00:35,2014-05-09 01:00:35
42a65d07637adc92c8f40997eedf54d1ff0c34df...6b67cd04491d45bbde94e20a70d64e3d9571e9ac,1,10,2,12,1,2014-04-24 23:33:11,2014-04-24 23:32:38
6b67cd04491d45bbde94e20a70d64e3d9571e9ac...239ad550682ad84b041f787083bbdd1cff9eb330,1,26,22,48,12,2014-04-25 00:34:02,2014-04-25 00:34:02
239ad550682ad84b041f787083bbdd1cff9eb330...ef2412dcec4053bc57adde12070cecdc2308529d,1,4,0,4,2,2014-04-25 00:45:01,2014-04-25 00:44:21
ef2412dcec4053bc57adde12070cecdc2308529d...7e6366c481561763ebc1767ca5d5eb851e45c64c,1,1,1,2,1,2014-04-25 00:45:01,2014-04-25 00:44:38
7e6366c481561763ebc1767ca5d5eb851e45c64c...4ada4d4963fc3ef31f8b68ca7e429e91a9f5fc1b,1,4,3,7,2,2014-04-25 00:48:51,2014-04-25 00:46:59
4ada4d4963fc3ef31f8b68ca7e429e91a9f5fc1b...ff7fc769d9d617312610c719197802f000a2f136,1,4,2,6,1,2014-04-25 01:55:54,2014-04-25 01:49:26
ff7fc769d9d617312610c719197802f000a2f136...9b41237f694fa2b0095ba6abdc387890900c1f32,1,1,1,2,1,2014-04-25 01:58:41,2014-04-25 01:58:41
9b41237f694fa2b0095ba6abdc387890900c1f32...788b5254fbd6bb55793ba607403833fe59deb6f5,2,10,2,12,2,2014-04-25 05:00:20,2014-04-25 04:50:39
0e881d28a16b084565d817051401a846a3710a16...daa2447c58192b492fc9b5277652739d28ddba15,1,1,0,1,1,2014-06-06 18:52:50,2014-06-06 18:52:50
daa2447c58192b492fc9b5277652739d28ddba15...af32d49c2b56486ff37311794232f289e90ad974,2,0,28,28,2,2014-06-06 18:57:27,2014-06-06 18:57:27
0e881d28a16b084565d817051401a846a3710a16...e1aef1a2f80ee5a1abb64ac2c6eed7543025828b,1,5,14,19,5,2014-06-06 18:47:56,2014-06-06 18:40:45
e1aef1a2f80ee5a1abb64ac2c6eed7543025828b...98f646a270a228282ad199cea05b77a2072648c1,1,2,1,3,1,2014-06-06 18:59:49,2014-06-06 18:59:49
ddaf139b66f52e65a79f49fcb6fb1d188d9bf58a...b2632d45c57e5031f29bc87f2eb05044a64e4afb,9,179,123,302,30,2014-03-25 03:10:39,2014-03-18 04:56:52
76ded8feb27a0d83f0b1857aa07e3a7c3d00c7d3...cbbb8b45186ea4b774d3d4dcfd09aa9e90bb3534,4,67,8,75,11,2014-04-22 05:12:58,2014-04-22 05:12:58
76ded8feb27a0d83f0b1857aa07e3a7c3d00c7d3...95aaa99312d19e5d7fac866dead4d484b000131b,4,31,4,35,6,2014-04-19 07:29:34,2014-04-19 07:21:01
95aaa99312d19e5d7fac866dead4d484b000131b...568b0f929ca513c33f6d1347d6bd5461ae3587cc,2,5,4,9,2,2014-04-21 00:23:03,2014-04-21 00:23:03
472036f755b1793c7c06744a539c5ce1389d6c4c...726dceeaa7522a66fa3a215b1433547377d12d6c,1,6,6,12,1,2014-05-09 21:57:24,2014-05-09 21:57:24
573ef7489f4c7cb67b60a7e6c8d60dd77a71752f...0060a670888126bf924eacf0289f6daaaed8c1a2,1,3,1,4,1,2014-05-13 21:30:12,2014-05-13 21:30:12
bf0874fbb4e730731a843e1303c75a490fc10a45...19afa9d527d98ee3507abd02ea528f92da036494,1,1,1,2,1,2014-05-10 02:07:28,2014-05-10 02:07:28
19afa9d527d98ee3507abd02ea528f92da036494...2aa839aca88805343d596da75687d4352bb7ade3,1,19,5,24,8,2014-05-11 08:15:48,2014-05-11 08:15:48
2aa839aca88805343d596da75687d4352bb7ade3...8f9d81e0f3f33d598654a1e1fd0d803f10a8f6e4,1,15,9,24,8,2014-05-11 08:39:21,2014-05-11 08:39:21
c2edefa9d0f4051d988941c33bcdd99ceb2087a6...f2d397285764d8ed515af2a4c4968cdae7daca16,19,985,54,1039,42,2014-05-09 22:15:45,2014-05-09 22:15:45
f2d397285764d8ed515af2a4c4968cdae7daca16...229802020e59ba00a874ec87c429bee004793d87,12,0,11719,11719,12,2014-05-09 22:16:18,2014-05-09 22:16:18
229802020e59ba00a874ec87c429bee004793d87...9e6295be9532ab615bed3de2ff1780c351343a12,13,11720,0,11720,13,2014-05-09 22:18:17,2014-05-09 22:18:17
9e6295be9532ab615bed3de2ff1780c351343a12...0aef33f24b7b6ebdb9dfb21850b2d4c0b0c9ba98,1,4,9,13,3,2014-05-09 22:53:14,2014-05-09 22:53:14
0aef33f24b7b6ebdb9dfb21850b2d4c0b0c9ba98...e0efa3576319b9a2806af124f54df17524bd7ba9,2,10,3,13,4,2014-05-09 23:02:01,2014-05-09 23:02:01
e0efa3576319b9a2806af124f54df17524bd7ba9...e6256cb59a8f796d0705bf381c3ef9cda53ce1ed,3,53,52,105,36,2014-05-09 23:26:53,2014-05-09 23:26:53
e6256cb59a8f796d0705bf381c3ef9cda53ce1ed...3d39d5852e69daa8fa9635546ecd9b9c324ebc86,2,2,1,3,2,2014-05-09 23:50:35,2014-05-09 23:50:35
3d39d5852e69daa8fa9635546ecd9b9c324ebc86...c501754c5c73f091a158bf11234513de793416b5,1,30,10,40,9,2014-05-10 00:10:18,2014-05-10 00:10:18
c501754c5c73f091a158bf11234513de793416b5...0b98b861648954feac54f84efe6c7e201132edc1,2,23,1,24,3,2014-05-10 00:11:34,2014-05-10 00:11:27
0b98b861648954feac54f84efe6c7e201132edc1...90a5b87a00a06789ee2ff2726ad2a8797e07597b,2,10,6,16,3,2014-05-10 00:21:19,2014-05-10 00:21:19
90a5b87a00a06789ee2ff2726ad2a8797e07597b...beb0e59b9d0feef68a57b72fb6cc14e7278865c4,157,165,4264,4429,905,2014-05-10 00:36:25,2014-05-10 00:36:25
beb0e59b9d0feef68a57b72fb6cc14e7278865c4...47834a4f6e176ecfab79979712a865ba96069203,5,245,0,245,5,2014-05-10 00:44:36,2014-05-10 00:44:36
47834a4f6e176ecfab79979712a865ba96069203...7baba38398ca87c4484198fdfcfa935ba5ffb6a2,2,36,14,50,13,2014-05-10 01:37:33,2014-05-10 01:37:33
b3a8944167a3212895d0f07ebc74c2170f28bf90...29d8883a359fddf4559d4b280c41b35f8c32869f,2,22,3,25,6,2014-04-01 03:12:09,2014-04-01 03:12:09
29d8883a359fddf4559d4b280c41b35f8c32869f...419a343b8109c2d0a8aa2f5926c21f2f614fd8a7,1,7,7,14,5,2014-04-01 04:27:58,2014-04-01 04:27:58
419a343b8109c2d0a8aa2f5926c21f2f614fd8a7...c375b58c6bdcb1ef37d2a3a7cfcf16dd6db2fe05,1,3,2,5,1,2014-04-01 04:28:32,2014-04-01 04:28:32
c375b58c6bdcb1ef37d2a3a7cfcf16dd6db2fe05...9c3d6e03f9e241d29431a05a0fe225e54a3738fa,2,4,11,15,5,2014-04-01 04:31:04,2014-04-01 04:31:04
9c3d6e03f9e241d29431a05a0fe225e54a3738fa...1989702e074b50dcd54e601c986bf4533dcda55b,2,40,11,51,7,2014-04-01 04:32:39,2014-04-01 04:32:39
1989702e074b50dcd54e601c986bf4533dcda55b...877be7b33e585b88106fa19232c0c0897c75ba88,1,33,23,56,10,2014-04-01 05:09:58,2014-04-01 05:09:58
877be7b33e585b88106fa19232c0c0897c75ba88...3e60740952760adac6d792e9ba432e3a1a5840ce,1,23,33,56,10,2014-04-01 05:12:27,2014-04-01 05:12:20
3e60740952760adac6d792e9ba432e3a1a5840ce...42ef8d3714fb054e0c336601ac6490934c01d446,1,5,5,10,4,2014-04-01 05:14:21,2014-04-01 05:14:21
42ef8d3714fb054e0c336601ac6490934c01d446...01ea1feee03821002e42e58aaf6f8794dd7d39e7,1,2,15,17,3,2014-04-01 17:57:52,2014-04-01 17:57:52
01ea1feee03821002e42e58aaf6f8794dd7d39e7...65e17f5d6d67d4d1de8aab5de90a70ed900d7c57,1,1,1,2,1,2014-04-01 18:12:48,2014-04-01 18:12:48
65e17f5d6d67d4d1de8aab5de90a70ed900d7c57...c443cee5cd86dbc20ab3cfb1617c3da38d6cf862,2,61,14,75,10,2014-04-02 21:26:30,2014-04-02 21:04:57
c443cee5cd86dbc20ab3cfb1617c3da38d6cf862...b0939512c05164c72e73154c9f6953063ee24596,1,25,7,32,4,2014-04-03 19:29:47,2014-04-03 19:10:36
b0939512c05164c72e73154c9f6953063ee24596...7d1538e45da48503ca8039f4f00a68c64d189904,1,4,1,5,1,2014-04-03 19:30:19,2014-04-03 19:30:19
7d1538e45da48503ca8039f4f00a68c64d189904...ab0c0fa1ade6caa715667b4f18f59435e1eb128c,2,3,2,5,2,2014-04-03 20:46:57,2014-04-03 19:30:37
ab0c0fa1ade6caa715667b4f18f59435e1eb128c...290c711940f5a4f5f3bbe8c773be801480ea27a2,1,1,0,1,1,2014-04-03 20:49:05,2014-04-03 20:49:05
290c711940f5a4f5f3bbe8c773be801480ea27a2...95ce273b0fe7bbaa5e02d0cea58da86cf8979581,3,140,97,237,27,2014-04-04 01:39:29,2014-04-03 21:54:55
95ce273b0fe7bbaa5e02d0cea58da86cf8979581...fb26f842c7a82ff4e2da69fac3b90e17391e3804,1,1,1,2,1,2014-04-05 01:41:51,2014-04-04 00:18:56
fb26f842c7a82ff4e2da69fac3b90e17391e3804...0530d57e11e2a0cf397740c3696585b0e4fbf990,1,1,1,2,1,2014-04-05 01:41:51,2014-04-04 01:05:30
0530d57e11e2a0cf397740c3696585b0e4fbf990...9fe9c97f1cba0824f9c28b0d4e1654882001fe0f,1,115,139,254,18,2014-04-05 01:42:23,2014-04-04 23:49:34
9fe9c97f1cba0824f9c28b0d4e1654882001fe0f...5b11956bed634436fa6958105c5fef1a8803c0e7,3,14,0,14,3,2014-04-05 01:42:23,2014-04-04 23:54:40
5b11956bed634436fa6958105c5fef1a8803c0e7...016915f6f9fbfbe4f9ad9996759f7a9fc6b860ef,2,4,2,6,3,2014-04-05 01:42:23,2014-04-05 00:14:14
016915f6f9fbfbe4f9ad9996759f7a9fc6b860ef...36a1d4edccf29a8fb896eac802dfd643ec8668e5,1,5,1,6,2,2014-04-05 01:42:23,2014-04-05 00:40:11
36a1d4edccf29a8fb896eac802dfd643ec8668e5...271228ceb793999a9a3f210bd1ae15cb0cb2c32b,3,17,3,20,12,2014-04-05 01:42:23,2014-04-05 01:29:58
271228ceb793999a9a3f210bd1ae15cb0cb2c32b...78683884bbb04bfbda51222463b47ecaaad2207e,1,2,0,2,1,2014-04-05 01:42:23,2014-04-05 01:38:37
78683884bbb04bfbda51222463b47ecaaad2207e...77358ba28b9a01a297ed5ab56bde101a62af85e6,4,12,6,18,10,2014-04-05 02:28:28,2014-04-05 02:28:28
77358ba28b9a01a297ed5ab56bde101a62af85e6...8a96a1c25a09412ec0cafc242e53abbe0525ffc3,7,244,283,527,176,2014-04-07 22:25:30,2014-04-07 22:25:30
8a96a1c25a09412ec0cafc242e53abbe0525ffc3...2a3b409d57ca6006d59ed18867d4f6611e8b692b,6,34,24,58,14,2014-04-08 06:37:08,2014-04-08 06:37:08
2a3b409d57ca6006d59ed18867d4f6611e8b692b...1f56378759a719a4974d8851e41834f8a661e1f0,1,31,12,43,5,2014-04-08 07:03:31,2014-04-08 07:03:31
1f56378759a719a4974d8851e41834f8a661e1f0...d853241a974e10749d6c3d77185f1fd237437777,2,24,25,49,18,2014-04-08 19:39:42,2014-04-08 19:39:42
d853241a974e10749d6c3d77185f1fd237437777...9423e3dfcb2ef3034b620ea2da6aac9d28591321,3,11,20,31,12,2014-04-09 16:55:29,2014-04-09 16:55:29
9423e3dfcb2ef3034b620ea2da6aac9d28591321...3ccd318aef1b16f8cca92bbc8a01fde9f108e7b7,3,18,18,36,15,2014-04-09 17:06:23,2014-04-09 17:06:23
3ccd318aef1b16f8cca92bbc8a01fde9f108e7b7...691cc90176c9ecd2b8df97766e9d1dcd1333b73a,10,460,357,817,95,2014-04-10 18:24:05,2014-04-10 18:24:05
691cc90176c9ecd2b8df97766e9d1dcd1333b73a...431bed15954d686c4bd225f5a87e7d155d013408,7,50,55,105,37,2014-04-10 20:51:07,2014-04-10 20:51:07
431bed15954d686c4bd225f5a87e7d155d013408...fd6bc5cc3510c6125297a4253d86f89796bf7879,3,19,26,45,8,2014-04-10 21:09:46,2014-04-10 21:09:46
fd6bc5cc3510c6125297a4253d86f89796bf7879...2d288cbcab7cc96152e9823d1a795853ac28ccf0,1,0,1,1,1,2014-04-10 21:16:23,2014-04-10 21:16:23
2d288cbcab7cc96152e9823d1a795853ac28ccf0...833d8b362051776bdd03024db5676d3ad9e928bf,35,82,0,82,35,2014-04-10 22:04:38,2014-04-10 22:04:38
833d8b362051776bdd03024db5676d3ad9e928bf...4aa99b15180e189abc1034fc6a733c43a9173f9d,1,30,43,73,18,2014-04-11 02:17:05,2014-04-11 02:17:05
4aa99b15180e189abc1034fc6a733c43a9173f9d...f4ea519165eb805b2ddd35fb177d0090aae1ed3b,6,14,1,15,6,2014-04-11 02:48:19,2014-04-11 02:48:19
f4ea519165eb805b2ddd35fb177d0090aae1ed3b...2db52b9bd959f064d9db7f2b51344743f6aa216f,5,32,35,67,25,2014-04-11 03:28:04,2014-04-11 03:28:04
2db52b9bd959f064d9db7f2b51344743f6aa216f...63c0261f692bbfc292052c8304f7625b47224587,3,7,2,9,7,2014-04-11 04:23:43,2014-04-11 04:23:43
63c0261f692bbfc292052c8304f7625b47224587...6276fd9269151185cec5573a23a1630dbc2f89c9,2,5,4,9,2,2014-04-11 05:32:06,2014-04-11 05:32:06
6276fd9269151185cec5573a23a1630dbc2f89c9...8b4bd56b6ff6e5d5584e8295c9131215605be63f,1,1,1,2,1,2014-04-11 05:52:34,2014-04-11 05:52:34
8b4bd56b6ff6e5d5584e8295c9131215605be63f...7d52e483d1ed3e76630dbe1dc7e856b8f8811bb4,3,0,6,6,3,2014-04-11 05:59:22,2014-04-11 05:59:22
7d52e483d1ed3e76630dbe1dc7e856b8f8811bb4...5bbe6f0d5e700451e66e9807eb94bccb55ff4b76,1,0,2,2,1,2014-04-11 06:03:03,2014-04-11 06:03:03
5bbe6f0d5e700451e66e9807eb94bccb55ff4b76...62f5f1205d19ce30e5313655dc3583cc49654ca4,5,19,28,47,13,2014-04-11 06:21:11,2014-04-11 06:21:11
62f5f1205d19ce30e5313655dc3583cc49654ca4...6245e996665b74ab6802760581e51001b4c9bcdb,1,1,2,3,2,2014-04-11 20:55:23,2014-04-11 20:55:23
6245e996665b74ab6802760581e51001b4c9bcdb...eee6fba8e20c853e052ac3255f3d2e0fd6b83aa9,3,11,3,14,5,2014-04-11 21:55:04,2014-04-11 21:55:04
c8e0a077323a084e9972a0dca29274858a653f37...ffd36a6eab46a0f2f0ec1f9144fd3d6e0aeaa874,3,22,13,35,10,2014-03-06 09:50:06,2014-03-06 09:50:06
ffd36a6eab46a0f2f0ec1f9144fd3d6e0aeaa874...5a23c59d744935023d90a01ae60b913e5e651a93,1,10,0,10,1,2014-03-06 09:54:10,2014-03-06 09:54:10
5a23c59d744935023d90a01ae60b913e5e651a93...c685e7bb48b21596d5bb182d88a8843d8712f157,3,2,5,7,3,2014-03-06 09:54:54,2014-03-06 09:54:54
c685e7bb48b21596d5bb182d88a8843d8712f157...ff4009e40f4a6b5cc8c3147c55417fbf36038523,1,49,0,49,1,2014-03-06 09:57:11,2014-03-06 09:57:11
0a5800eb67f5789d4d6b2786af5999b20b9a07e0...22f2c6e4df761a240f86b620aabd7d12bb9b8d38,1,67,36,103,36,2014-03-15 00:04:31,2014-03-14 23:52:04
22f2c6e4df761a240f86b620aabd7d12bb9b8d38...9e6c07c57fdc43bdb64b4784cfbb7e34affc47f1,1,10,0,10,1,2014-03-15 00:04:31,2014-03-14 23:53:09
9e6c07c57fdc43bdb64b4784cfbb7e34affc47f1...c9c75fee846313ab900440ef6fc0f4947ad26586,3,22,1,23,5,2014-03-15 00:04:31,2014-03-14 23:59:47
3eb4e97112ec4f9d7fc18acbc79e52cb95f21769...b13e2b09d815fc7f5082400bbb54675647326c63,3,9,11,20,6,2014-03-21 21:44:50,2014-03-21 21:44:50
3eb4e97112ec4f9d7fc18acbc79e52cb95f21769...295268fb8c98d53e8a7c9bcb87a6f3b69c7d22c0,3,22,1,23,4,2014-03-21 01:02:41,2014-03-21 01:01:48
295268fb8c98d53e8a7c9bcb87a6f3b69c7d22c0...3d42ae9a5afe023e555fbef54bfc6ef2a5e01cf2,1,9,4,13,2,2014-03-21 06:59:11,2014-03-21 06:59:11
3d42ae9a5afe023e555fbef54bfc6ef2a5e01cf2...726e90930ea15a214d0f1c5b49335c8a40752c54,2,7,0,7,2,2014-03-21 07:12:54,2014-03-21 07:12:54
726e90930ea15a214d0f1c5b49335c8a40752c54...f12845fc338870c821b8f1cb1d0172828c60a9e4,2,58,45,103,2,2014-03-21 07:13:24,2014-03-21 07:13:24
f12845fc338870c821b8f1cb1d0172828c60a9e4...54e43e71519ad29039409deb5489758ecf4ba71d,1,6,2,8,2,2014-03-21 09:18:05,2014-03-21 09:18:05
54e43e71519ad29039409deb5489758ecf4ba71d...7e49210eec54a5671b77ad414851ca42bc2767de,1,25,24,49,6,2014-03-21 09:53:34,2014-03-21 09:53:34
7e49210eec54a5671b77ad414851ca42bc2767de...09b9b4adba91d05c06d5980d596c1b725b90d7bf,5,67,18,85,19,2014-03-21 10:54:28,2014-03-21 10:54:28
09b9b4adba91d05c06d5980d596c1b725b90d7bf...9ef97fc297c4d8e0d311cab1dbbc6b1d69b398bc,3,44,32,76,17,2014-03-22 05:08:02,2014-03-22 05:07:48
9ef97fc297c4d8e0d311cab1dbbc6b1d69b398bc...dd6a2a2e5ed788c6caa7930d52d8e831321b0913,4,49,2,51,4,2014-03-22 06:05:45,2014-03-22 06:05:45
dd6a2a2e5ed788c6caa7930d52d8e831321b0913...c2d985c23543ae858b09f674aa999d3134ea449a,4,5,5,10,5,2014-03-22 07:35:26,2014-03-22 07:35:26
c2d985c23543ae858b09f674aa999d3134ea449a...cc4865c1144c822fed262985319f1771e4cbaebf,2,2,2,4,2,2014-03-22 07:35:51,2014-03-22 07:35:51
cc4865c1144c822fed262985319f1771e4cbaebf...4ba1abb79e53ac0858d2be335b78250d4d469a6b,8,27,25,52,18,2014-03-22 07:47:02,2014-03-22 07:47:02
876276418a1fe24e8c75f9de6ecb502282d9c927...fb4ee1acd3b6cd04d39a0ed697cc08a012d54caa,3,14,14,28,6,2014-03-07 02:30:02,2014-03-07 02:30:02
876276418a1fe24e8c75f9de6ecb502282d9c927...435d63c645ff174135417eb38be6eea0b959ead9,1,24,23,47,5,2014-03-07 02:08:02,2014-03-07 01:59:17
435d63c645ff174135417eb38be6eea0b959ead9...b8341fb024c2af55135d934056de566a64fd8252,1,17,1,18,2,2014-03-07 02:24:52,2014-03-07 02:24:21
1dc7ccee0fcc6aa18225d9d86ed7e9c1873686b6...bab936eac99004b6cd14b4ed8b279862e2d7e606,4,60,6,66,10,2014-01-08 04:17:47,2014-01-08 04:17:47
bab936eac99004b6cd14b4ed8b279862e2d7e606...6a6df0bff72098b19651f0c7efad83e375bbe6cc,1,4,0,4,1,2014-01-08 05:17:36,2014-01-08 05:17:36
6a6df0bff72098b19651f0c7efad83e375bbe6cc...837f842e7b229a351917f6285477e0cd299aa7c5,2,93,2,95,6,2014-01-08 06:53:36,2014-01-08 06:53:36
8ec472d554f43f9e400c53959782fbce13909220...b67c35ded53ca9ede6315c1f33c3735a089775cb,18,114,89,203,33,2014-01-29 07:55:23,2014-01-29 07:55:23
b67c35ded53ca9ede6315c1f33c3735a089775cb...707e0fa78b55edd69e42871b10a51ca58277e0ce,4,35,9,44,6,2014-01-29 21:29:44,2014-01-27 20:29:16
707e0fa78b55edd69e42871b10a51ca58277e0ce...5c1c72b7fdff0aa01dec3c21e4652396549e0f2a,1,1,0,1,1,2014-01-29 21:29:44,2014-01-29 01:39:24
5c1c72b7fdff0aa01dec3c21e4652396549e0f2a...cecb7dc81e9ed86d396de4a56a510cb6441a3336,1,0,6,6,1,2014-01-29 21:29:44,2014-01-29 02:01:07
cecb7dc81e9ed86d396de4a56a510cb6441a3336...07ca1ec9bf0a5f978c4578e8296500b632f8b117,1,18,2,20,2,2014-01-29 21:29:44,2014-01-29 20:32:12
07ca1ec9bf0a5f978c4578e8296500b632f8b117...52d8a0e7d085ee7bdf04b3a8899cb86e99ad7a82,1,0,1,1,1,2014-01-29 21:29:44,2014-01-29 21:19:52
28227b783cdf8f78ff59bc3596789a8bd4edf3dd...9eca81985b861a65a3754ba128fbebb7dac33fb9,1,2,1,3,2,2014-02-14 02:48:18,2014-02-14 00:46:23
9eca81985b861a65a3754ba128fbebb7dac33fb9...84e1d5f7cd59beadf88fc2f19c2842eb31785026,1,85,0,85,2,2014-02-14 02:48:19,2014-02-14 00:46:35
84e1d5f7cd59beadf88fc2f19c2842eb31785026...4ce13da40620e44619e94ff6c7c07ff6f1998c06,1,3,1,4,3,2014-02-14 02:48:19,2014-02-14 01:50:09
6cf1a76332385192b21753953adcbd4dbda74c07...954aafa44d3c86d85282c818611bfc8f6e666c15,4,313,73,386,8,2014-02-13 22:57:08,2014-02-13 22:57:08
6cf1a76332385192b21753953adcbd4dbda74c07...f4d5e44e752f178a9f69e306fd143ce3f66fe3d0,2,5,1,6,2,2014-02-13 22:39:11,2014-02-13 22:39:11
36ab81daa31cf7d5dc9c5117df4700a4b761f9ce...a538501efe52ecb4cf2e38740aa810322501afeb,4,37,47,84,16,2014-01-30 02:32:47,2014-01-30 02:32:47
a538501efe52ecb4cf2e38740aa810322501afeb...a7575b2d2ef6d8645a0d66ad391dcfb659f989c8,1,0,1,1,1,2014-02-02 03:43:50,2014-02-02 03:43:50
a7575b2d2ef6d8645a0d66ad391dcfb659f989c8...ad5c294624fea1112fb2fdcf4ae70b30e872d366,1,1,1,2,1,2014-02-02 03:44:19,2014-02-02 03:44:19
ad5c294624fea1112fb2fdcf4ae70b30e872d366...45b5885def3c80c241483b033fdeb89739f85a27,3,71,47,118,16,2014-02-02 03:58:13,2014-02-02 03:58:13
45b5885def3c80c241483b033fdeb89739f85a27...ae21a7e4ddaa1b8d34e6d44c1ba3c10d62522604,1,1,0,1,1,2014-02-02 06:26:36,2014-02-02 06:26:36
ae21a7e4ddaa1b8d34e6d44c1ba3c10d62522604...135aefbdee388b8d14a8cb8c3056501d66cd85db,5,131,139,270,30,2014-02-02 20:26:48,2014-02-02 20:26:48
135aefbdee388b8d14a8cb8c3056501d66cd85db...04138ce2067d2cae6f2e813824a0d615a56b4859,6,79,10,89,10,2014-02-04 01:32:14,2014-02-04 01:32:14
bcad63a0276b0a338908956d0ef621d4afb40231...35341b44b467d5ce628b20a4e84c0f70673bcd49,8,80,26,106,23,2013-12-10 20:57:42,2013-12-10 20:57:42
35341b44b467d5ce628b20a4e84c0f70673bcd49...0f26061cc45617e2753d9c4d1df0e869ba406f9a,5,75,22,97,19,2013-12-11 03:43:09,2013-12-11 03:43:09
0f26061cc45617e2753d9c4d1df0e869ba406f9a...b4cd5ec4bd70fa606a4e5726284a462bd7422c0c,2,15,4,19,3,2013-12-11 03:50:11,2013-12-11 03:50:11
b4cd5ec4bd70fa606a4e5726284a462bd7422c0c...683fa46ab4c28f318ca7358448c53ac17d6893e9,7,94,40,134,22,2013-12-11 22:33:21,2013-12-11 22:33:21
683fa46ab4c28f318ca7358448c53ac17d6893e9...989cf2ab19dc90967616cc46e4e2182594dd87f5,1,2,1,3,1,2013-12-11 22:59:10,2013-12-11 22:59:10
989cf2ab19dc90967616cc46e4e2182594dd87f5...45bd7f9e730173c3c875870545b6d07240193647,7,82,0,82,7,2013-12-11 22:59:55,2013-12-11 22:59:49
45bd7f9e730173c3c875870545b6d07240193647...5dcb59b8902e53e3894c91d7ca9252ec11cca19b,1,2,2,4,1,2013-12-11 23:05:48,2013-12-11 23:05:48
5dcb59b8902e53e3894c91d7ca9252ec11cca19b...218caaf004ea561be3a539ffdc507a86ec176ac6,3,14,9,23,9,2013-12-11 23:25:11,2013-12-11 23:25:11
218caaf004ea561be3a539ffdc507a86ec176ac6...b9bb01e5372d9f5765ab5ccf6f793a692caee9f0,3,22,9,31,5,2013-12-12 03:11:21,2013-12-12 03:11:21
b9bb01e5372d9f5765ab5ccf6f793a692caee9f0...250aa0a8ed06b8524861a5be1f2c866e16487e0e,5,83,2,85,6,2013-12-12 03:55:04,2013-12-12 03:55:04
250aa0a8ed06b8524861a5be1f2c866e16487e0e...734fecc5467c5bdf33fdbee3f0cd5bda61dbe05b,4,12,12,24,5,2013-12-12 04:10:05,2013-12-12 04:10:05
734fecc5467c5bdf33fdbee3f0cd5bda61dbe05b...b20119775f92e95074a65130091e78d05b259df0,12,8,9,17,7,2013-12-12 04:14:26,2013-12-12 04:14:26
b20119775f92e95074a65130091e78d05b259df0...90f656ea6272531bf92f9b11be251be475e6d953,5,226,224,450,9,2013-12-12 04:42:14,2013-12-12 04:42:14
90f656ea6272531bf92f9b11be251be475e6d953...15f56b49986f708689313417e49e21fd4fc0beff,12,55,25,80,11,2013-12-12 05:41:38,2013-12-12 05:41:17
15f56b49986f708689313417e49e21fd4fc0beff...30a61b4026c103cc0dafb20814741a65c37d8dc2,2,2,4,6,3,2013-12-12 05:57:13,2013-12-12 05:57:13
30a61b4026c103cc0dafb20814741a65c37d8dc2...7fadc298287c516d19b4c08f7a73b29a3862a86c,8,85,18,103,14,2013-12-12 06:32:48,2013-12-12 06:28:33
7fadc298287c516d19b4c08f7a73b29a3862a86c...7dab61e50a2c566f72e40c75e1ee2fb4b70f95bc,1,2,1,3,2,2013-12-12 07:03:09,2013-12-12 07:03:09
7dab61e50a2c566f72e40c75e1ee2fb4b70f95bc...22306dbc11289b36df8b906e011ca7a60531dd58,1,3,2,5,3,2013-12-12 07:03:26,2013-12-12 07:03:26
22306dbc11289b36df8b906e011ca7a60531dd58...8ff25966a7d6e10264e8f6d388ebd282333645d8,1,16,2,18,1,2013-12-12 07:03:41,2013-12-12 07:03:41
8ff25966a7d6e10264e8f6d388ebd282333645d8...225b8c6265cde8aed2c78adb478eb021dc9e71fb,1,2,1,3,1,2013-12-12 07:09:12,2013-12-12 07:09:12
225b8c6265cde8aed2c78adb478eb021dc9e71fb...b8e601ccce50a62156066430fc7b12fa05337b0b,2,8,11,19,8,2013-12-13 01:23:43,2013-12-13 01:23:43
e6023214d8e7bcc6db60e82eca751d1c1695a3ad...4893fe048c556a196c146b074fc2fb45b55734df,12,419,14,433,14,2013-09-29 01:44:04,2013-08-14 04:50:45
4893fe048c556a196c146b074fc2fb45b55734df...e6300461b1c0b1c53344882ef5d75c450a923f00,6,37,30,67,12,2013-09-29 01:44:04,2013-08-31 01:32:20
e6300461b1c0b1c53344882ef5d75c450a923f00...a102872a963e367962f91291a37b0fff7df1e38e,10,277,101,378,40,2013-09-29 01:44:04,2013-09-11 00:08:42
a102872a963e367962f91291a37b0fff7df1e38e...9d1e3dbd562541164fc1f2d6b3e6fbe32b968223,4,39,24,63,19,2013-09-29 01:44:31,2013-09-13 18:19:44
e6023214d8e7bcc6db60e82eca751d1c1695a3ad...7735e4fe89ea664f0e77835885b2fd9b9174284c,5,32,3,35,18,2013-09-28 01:55:36,2013-09-28 01:55:36
7735e4fe89ea664f0e77835885b2fd9b9174284c...5c1372c535afe88ef34ef9a1dfd7537d894eea23,4,103,59,162,42,2013-09-30 07:37:32,2013-09-30 07:37:32
4ea191e452bfc104d5a9805a622bf37ac9a2c405...df95f1e91473b95c017145c71eb67fd033e3ae5f,2,32,1,33,2,2013-12-03 21:39:50,2013-12-03 21:39:50
df95f1e91473b95c017145c71eb67fd033e3ae5f...6582a8860815a10af79cb888be96b58792f4c5e4,2,30,24,54,7,2013-12-03 22:49:38,2013-12-03 19:52:16
4ea191e452bfc104d5a9805a622bf37ac9a2c405...ca590bd775988f91edee05c521470a74bc8295f9,2,30,24,54,7,2013-12-03 19:52:16,2013-12-03 19:52:16
4ea191e452bfc104d5a9805a622bf37ac9a2c405...4d2097912d3034d416e540ea44cb5af79e374569,3,74,0,74,5,2013-12-03 03:17:24,2013-08-14 20:36:44
4d2097912d3034d416e540ea44cb5af79e374569...878dfe9a1f4badae84feefba389ac2c9ac245118,3,116,63,179,20,2013-12-03 03:17:24,2013-08-15 02:08:47
878dfe9a1f4badae84feefba389ac2c9ac245118...a832b11211cf7bc6c2148ce29e14b0c8248d2be9,1,61,50,111,4,2013-12-03 03:17:24,2013-08-15 02:49:18
a832b11211cf7bc6c2148ce29e14b0c8248d2be9...66376562612c99b0ed303affdd714e42fd590d4b,1,110,87,197,7,2013-12-03 03:17:24,2013-08-15 03:36:53
66376562612c99b0ed303affdd714e42fd590d4b...123c06ac3f6fe2d6337ba78b190a3ab21e5f22a5,2,63,4,67,11,2013-12-03 03:17:24,2013-08-18 18:51:45
123c06ac3f6fe2d6337ba78b190a3ab21e5f22a5...ba63548d4d6be25ac203dc4cd02f7c579e51cfa2,1,69,1,70,7,2013-12-03 03:17:25,2013-08-19 23:24:05
ba63548d4d6be25ac203dc4cd02f7c579e51cfa2...cae886b2f0d245d3f8888ccfb0b42eff0345ee5a,1,16,10,26,4,2013-12-03 03:17:25,2013-08-20 03:05:15
cae886b2f0d245d3f8888ccfb0b42eff0345ee5a...1c8c7d171cf4fa32c1aa63edfc71ee89481db871,3,70,8,78,8,2013-12-03 03:17:25,2013-08-20 03:23:52
1c8c7d171cf4fa32c1aa63edfc71ee89481db871...abcc7d9bb92b8c7299c96fe3d22047883d917c75,2,94,23,117,10,2013-12-03 03:17:25,2013-08-20 04:22:08
abcc7d9bb92b8c7299c96fe3d22047883d917c75...c4c98371943cfaa373cd0c54a480ca579714d32b,1,6,2,8,1,2013-12-03 03:17:25,2013-08-20 05:29:08
c4c98371943cfaa373cd0c54a480ca579714d32b...d3d285426d54b20facc6c6c9994fe20544d4e60a,1,106,31,137,7,2013-12-03 03:17:25,2013-09-11 00:20:40
d3d285426d54b20facc6c6c9994fe20544d4e60a...ffc70c1611335382029644916c7b93048ccf4c01,1,4,0,4,1,2013-12-03 03:17:25,2013-09-11 18:17:37
ffc70c1611335382029644916c7b93048ccf4c01...0344e946fd898321218764e1500da5019eee2c1b,1,15,13,28,7,2013-12-03 03:17:26,2013-09-12 18:18:11
0344e946fd898321218764e1500da5019eee2c1b...a93f742b3aaeb8f4af3cd1c149fa126393bea712,1,44,65,109,10,2013-12-03 03:17:26,2013-09-13 03:49:37
a93f742b3aaeb8f4af3cd1c149fa126393bea712...5a4ae936aa06e3d48aa5e170f73cd462fa8d1ccf,1,8,6,14,4,2013-12-03 03:17:26,2013-09-13 04:17:26
5a4ae936aa06e3d48aa5e170f73cd462fa8d1ccf...5ffb4a9a1552fe1b50fa6e2837575e02ae5f96a3,1,2,1,3,2,2013-12-03 03:17:26,2013-09-13 04:25:58
5ffb4a9a1552fe1b50fa6e2837575e02ae5f96a3...c9c465bcfb7a3d4ca4f8219da8a636d7c665cfe1,2,9,5,14,4,2013-12-03 03:17:26,2013-09-13 05:09:04
c9c465bcfb7a3d4ca4f8219da8a636d7c665cfe1...4f23be316855517ee538465378e3af2d443e9c01,1,1,0,1,1,2013-12-03 03:17:26,2013-09-14 00:13:06
4f23be316855517ee538465378e3af2d443e9c01...6905807375d6eb7a56e6b30a3a182a2a39177623,1,21,18,39,10,2013-12-03 03:17:26,2013-09-14 00:14:12
6905807375d6eb7a56e6b30a3a182a2a39177623...85ada6a874d6ec4ce145240fcc75d74f094e04a8,3,69,9,78,8,2013-12-03 03:17:26,2013-09-18 01:34:57
85ada6a874d6ec4ce145240fcc75d74f094e04a8...33528ddbc388e2147a7e7f0089fa8a67253238d0,4,43,3,46,5,2013-12-03 03:17:27,2013-09-18 20:41:24
33528ddbc388e2147a7e7f0089fa8a67253238d0...0017eacbe91d776499c19007df858e208bf52b12,1,4,3,7,3,2013-12-03 03:17:27,2013-09-18 20:58:13
0017eacbe91d776499c19007df858e208bf52b12...c5c19114ab3d05e571c958a3a6f47eff8b2c8cf5,3,169,159,328,6,2013-12-03 03:17:27,2013-09-19 00:18:34
c5c19114ab3d05e571c958a3a6f47eff8b2c8cf5...fbfda21dfbe5778f1e4813e54eac69afb597f67e,3,82,69,151,24,2013-12-03 03:17:27,2013-09-19 01:51:35
fbfda21dfbe5778f1e4813e54eac69afb597f67e...ff000110a01aa72c183f14f739e6e2806f96f2e1,2,68,22,90,9,2013-12-03 03:17:27,2013-09-19 17:23:43
ff000110a01aa72c183f14f739e6e2806f96f2e1...ab34a277fc1fdb438f551a5b415ace0b919c1d3d,1,1,1,2,1,2013-12-03 03:17:27,2013-09-19 17:26:55
ab34a277fc1fdb438f551a5b415ace0b919c1d3d...cd0bdecaecdbccb775d1721bc7115ca8517db086,1,24,1,25,3,2013-12-03 03:17:27,2013-09-19 17:59:11
cd0bdecaecdbccb775d1721bc7115ca8517db086...40befb802366b8cfe5550746ccd1183d4f74c82b,2,26,18,44,10,2013-12-03 03:17:28,2013-09-20 23:20:23
40befb802366b8cfe5550746ccd1183d4f74c82b...9cbb5946c4f43aa40b5d433645c861a9216a8c3c,1,13,7,20,2,2013-12-03 03:17:28,2013-09-20 23:34:07
9cbb5946c4f43aa40b5d433645c861a9216a8c3c...7f85f38110e2b53347e332e7d2b4af3adbd2d831,1,1,1,2,1,2013-12-03 03:17:28,2013-10-03 21:56:38
7f85f38110e2b53347e332e7d2b4af3adbd2d831...dbbda54c682e0952a1f2b1edde36f402d0ca607c,1,37,0,37,1,2013-12-03 03:17:28,2013-10-03 23:12:27
dbbda54c682e0952a1f2b1edde36f402d0ca607c...c3c79a94eae44175a96f36dc3b8a05041e47570b,2,47,11,58,2,2013-12-03 03:17:28,2013-10-04 00:28:04
c3c79a94eae44175a96f36dc3b8a05041e47570b...480c353c65dd3e1c5516ec8b1967ac22b481f25e,1,21,0,21,1,2013-12-03 03:17:28,2013-10-04 00:43:49
480c353c65dd3e1c5516ec8b1967ac22b481f25e...11bf813f90c0629900bc44e2a959b333fd9214cf,1,2,1,3,1,2013-12-03 03:17:28,2013-10-04 02:38:33
11bf813f90c0629900bc44e2a959b333fd9214cf...a8201cc17e64f083bd35a4e53c05b9c4dff03c48,1,82,61,143,12,2013-12-03 03:17:29,2013-10-08 01:09:53
a8201cc17e64f083bd35a4e53c05b9c4dff03c48...441279eb131806bd01e7a816cb52c6c9604800b8,1,7,7,14,7,2013-12-03 03:17:29,2013-10-08 01:13:17
441279eb131806bd01e7a816cb52c6c9604800b8...7d1ab347886b7ca6509aecd7eb4365cbcfb2faf8,2,15,9,24,6,2013-12-03 03:17:29,2013-10-08 01:17:09
7d1ab347886b7ca6509aecd7eb4365cbcfb2faf8...badf20c35aeda2eeec20306fbfa76993a65e80a9,2,2,0,2,2,2013-12-03 03:17:29,2013-10-08 01:19:10
badf20c35aeda2eeec20306fbfa76993a65e80a9...16ac0d7ba27756b3d3978b006db42c3658baf317,1,2,2,4,1,2013-12-03 03:17:29,2013-10-08 01:20:47
16ac0d7ba27756b3d3978b006db42c3658baf317...10f3e9c90ffa589870f371d0efa8e09f204e59df,1,2,0,2,1,2013-12-03 03:17:29,2013-10-08 03:51:47
10f3e9c90ffa589870f371d0efa8e09f204e59df...df73dca22293c06ba28fbce36a3ce511b72f9b6a,1,1,0,1,1,2013-12-03 03:17:29,2013-10-08 03:56:20
df73dca22293c06ba28fbce36a3ce511b72f9b6a...2dc25d77aed7b759ebf76a2e1adbac300f936577,2,20,3,23,3,2013-12-03 03:17:30,2013-10-09 22:02:02
2dc25d77aed7b759ebf76a2e1adbac300f936577...a75470bcf310890c2d6edbf8c2720763ed4feac4,2,9,1,10,3,2013-12-03 03:17:30,2013-10-09 22:06:55
a75470bcf310890c2d6edbf8c2720763ed4feac4...b5d9df66c1a265b64d49f3c16367a7dbd76b7bee,1,5,6,11,2,2013-12-03 03:17:30,2013-10-09 22:24:00
b5d9df66c1a265b64d49f3c16367a7dbd76b7bee...1c17d8af44819e77c22c7e4faa170ea2ac59a237,1,28,17,45,3,2013-12-03 03:17:30,2013-10-09 22:52:38
1c17d8af44819e77c22c7e4faa170ea2ac59a237...7fc451da3ec1f8bbef33169182ae8e8b5bc49809,1,5,5,10,3,2013-12-03 03:17:30,2013-10-10 20:54:56
7fc451da3ec1f8bbef33169182ae8e8b5bc49809...37120d186c2aacb5ab83f80c4e110e770901cb76,1,3,1,4,2,2013-12-03 03:17:30,2013-10-10 21:28:56
37120d186c2aacb5ab83f80c4e110e770901cb76...3c39614e50a3eb3a130c015a52186fc315713540,1,1,1,2,1,2013-12-03 03:17:30,2013-10-10 22:08:32
3c39614e50a3eb3a130c015a52186fc315713540...75f60372037dc260b1b9cfcef512686c3a18516a,3,10,2,12,3,2013-12-03 03:17:30,2013-10-10 22:01:30
75f60372037dc260b1b9cfcef512686c3a18516a...12f5f4e87ecd5cddb65f80f5265cd5b78945f2ab,1,18,0,18,1,2013-12-03 03:17:31,2013-10-10 22:12:21
12f5f4e87ecd5cddb65f80f5265cd5b78945f2ab...3dc3ad9997775c87200c03015ba6f833b640a1d9,1,5,4,9,3,2013-12-03 03:17:31,2013-10-10 22:30:51
3dc3ad9997775c87200c03015ba6f833b640a1d9...0ddf232773eb887c6af9f54707806b0c2eb09153,1,10,0,10,1,2013-12-03 03:17:31,2013-10-10 23:09:02
0ddf232773eb887c6af9f54707806b0c2eb09153...acb6decb6a2b2383fd2db17ff8aa350a5741f053,1,3,1,4,1,2013-12-03 03:17:31,2013-10-10 23:59:44
acb6decb6a2b2383fd2db17ff8aa350a5741f053...81d77f916ba1d0b8c017db205eb5c675f6eb2d1f,2,4,3,7,2,2013-12-03 03:17:31,2013-10-11 00:09:43
81d77f916ba1d0b8c017db205eb5c675f6eb2d1f...73b45f2fa2b4abcb2e88a0e319d722b50a319bda,1,7,2,9,1,2013-12-03 03:17:31,2013-10-11 00:16:36
73b45f2fa2b4abcb2e88a0e319d722b50a319bda...f24be0684f5b7cc2b209b59a82277a5792d970c7,4,9,4,13,7,2013-12-03 03:17:31,2013-10-11 22:35:26
f24be0684f5b7cc2b209b59a82277a5792d970c7...aae9fc23db74663fc2a7411888a50b21da12db61,2,75,60,135,13,2013-12-03 03:17:32,2013-10-10 01:13:11
aae9fc23db74663fc2a7411888a50b21da12db61...599a2f928e3793dd65b8d3c079aed84d3db62a71,1,18,6,24,7,2013-12-03 03:17:32,2013-10-16 21:12:07
599a2f928e3793dd65b8d3c079aed84d3db62a71...19e41af82a42d04e9bb987ef3aa545e6174c21b1,1,12,4,16,4,2013-12-03 03:17:32,2013-10-16 21:21:01
19e41af82a42d04e9bb987ef3aa545e6174c21b1...0d45c5f0098c48133d184f2072a2fc240c716146,1,7,4,11,4,2013-12-03 03:17:32,2013-10-18 22:10:36
0d45c5f0098c48133d184f2072a2fc240c716146...bcbc73bc4add9f5a61b678981c160055c6113056,1,3,1,4,1,2013-12-03 03:17:32,2013-10-18 22:53:19
bcbc73bc4add9f5a61b678981c160055c6113056...f797a49beb1837939133da6af553a39d0ce2136f,1,20,11,31,5,2013-12-03 03:17:32,2013-10-19 07:01:17
f797a49beb1837939133da6af553a39d0ce2136f...9cc8ca6c2bbebabcaac7fff901d32ee230662c26,1,18,5,23,6,2013-12-03 03:17:32,2013-10-19 07:24:12
9cc8ca6c2bbebabcaac7fff901d32ee230662c26...b4a598b3e523149a30bed1377369d69dbf5122eb,1,1,0,1,1,2013-12-03 03:17:33,2013-10-22 00:53:15
b4a598b3e523149a30bed1377369d69dbf5122eb...6ff2c1c9ce656aec32e4e264ccf07a742bd9801d,1,5,2,7,2,2013-12-03 03:17:33,2013-10-22 01:59:34
6ff2c1c9ce656aec32e4e264ccf07a742bd9801d...3960fcc96393266bf6eeed998ff0e197ac42a338,1,6,2,8,2,2013-12-03 03:17:33,2013-10-22 02:00:02
3960fcc96393266bf6eeed998ff0e197ac42a338...2f1ebbbcc7c82857d9ece9039902e9faa3196678,1,14,4,18,2,2013-12-03 03:17:33,2013-10-22 07:27:08
2f1ebbbcc7c82857d9ece9039902e9faa3196678...24913f862b3d03024feef8c5905d3a1dd6d5ba95,1,20,5,25,8,2013-12-03 03:17:33,2013-10-22 07:28:35
24913f862b3d03024feef8c5905d3a1dd6d5ba95...2f5ed9a3d336a24a7ae5fa6199c4b892f12c9eb9,1,15,16,31,14,2013-12-03 03:17:33,2013-10-22 07:42:14
2f5ed9a3d336a24a7ae5fa6199c4b892f12c9eb9...c7329ff617356e73e8847e3bca39031f414a1a83,1,4,0,4,2,2013-12-03 03:17:33,2013-10-22 23:24:54
c7329ff617356e73e8847e3bca39031f414a1a83...2d170a09712942cbff3ed6071b6c8ea859989f16,2,9,0,9,4,2013-12-03 03:17:34,2013-10-23 06:16:52
2d170a09712942cbff3ed6071b6c8ea859989f16...5aecf9cbf4629367b45b1fa1a29a1cd61de3ddc0,1,11,8,19,2,2013-12-03 03:17:34,2013-10-25 03:09:30
5aecf9cbf4629367b45b1fa1a29a1cd61de3ddc0...2e5f96a8675623817d4ee18607eee988f24b29f7,2,24,3,27,6,2013-12-03 03:17:34,2013-10-25 00:04:04
2e5f96a8675623817d4ee18607eee988f24b29f7...062b475134c69f6878e8348a5fd37328bbc32311,1,1,1,2,1,2013-12-03 03:17:34,2013-10-25 03:09:21
062b475134c69f6878e8348a5fd37328bbc32311...60f7aa75cde8d968f3707e9cc3c876935bfd239f,1,5,2,7,3,2013-12-03 03:17:34,2013-10-25 07:20:34
60f7aa75cde8d968f3707e9cc3c876935bfd239f...70a28a62290adfd305cf4fa09d548bf2a9091d42,2,47,53,100,11,2013-12-03 03:17:34,2013-10-25 07:29:37
70a28a62290adfd305cf4fa09d548bf2a9091d42...a5d805e63307227ad880d95b37addf32f68805fd,1,0,5,5,1,2013-12-03 03:17:34,2013-10-25 21:54:00
a5d805e63307227ad880d95b37addf32f68805fd...2fb5e6601065b9b79f041c5fea999da3c546391c,2,16,20,36,16,2013-12-03 03:17:34,2013-10-25 22:45:51
2fb5e6601065b9b79f041c5fea999da3c546391c...81c23f4baab1a09833391a1c8821948a6099f248,1,6,7,13,2,2013-12-03 03:17:35,2013-10-26 00:25:19
81c23f4baab1a09833391a1c8821948a6099f248...74b4bd2bd6ecded6de90ed4f6ce2f2938ddc40c9,3,86,84,170,15,2013-12-03 03:17:35,2013-10-26 00:26:11
74b4bd2bd6ecded6de90ed4f6ce2f2938ddc40c9...adb46face09b979e4a0c72e236ec1b7baad8bc56,2,7,7,14,5,2013-12-03 03:17:35,2013-10-28 21:44:27
adb46face09b979e4a0c72e236ec1b7baad8bc56...111de8d803ac416f392ab350975f13dcb593eaf4,2,23,3,26,4,2013-12-03 03:17:35,2013-10-28 21:45:29
111de8d803ac416f392ab350975f13dcb593eaf4...008c74df4b2aeaec62e0a3869136b647068d919c,3,9,7,16,6,2013-12-03 03:17:35,2013-10-28 22:45:58
008c74df4b2aeaec62e0a3869136b647068d919c...e793c9d948f13eb0a95a1512dd4de8a0c787eebe,1,3,6,9,1,2013-12-03 03:17:35,2013-10-30 00:14:16
e793c9d948f13eb0a95a1512dd4de8a0c787eebe...2bbd69ad2ce6469300034563413e9d1b36f22002,1,30,0,30,1,2013-12-03 03:17:35,2013-10-30 00:16:05
2bbd69ad2ce6469300034563413e9d1b36f22002...8a00f1d713e8a67d6da453e257aee0ccdf55821f,1,4,5,9,5,2013-12-03 03:17:36,2013-10-30 04:37:06
8a00f1d713e8a67d6da453e257aee0ccdf55821f...5f1b721823f960f0b40c902676c88216d278d861,1,6,2,8,1,2013-12-03 03:17:36,2013-10-28 21:30:50
5f1b721823f960f0b40c902676c88216d278d861...034d2e628b662864c09d04bb22b1b753aeaf62e7,1,2,2,4,2,2013-12-03 03:17:36,2013-11-05 23:30:06
034d2e628b662864c09d04bb22b1b753aeaf62e7...8a4b58d987f3cc464e054e32598eabb6974fd341,1,4,1,5,3,2013-12-03 03:17:36,2013-11-06 00:58:58
9c3cd308517efe7ac86cbabca861dea46c7286fb...9deb7bc94447f341e3c416ded793d4e1542cfa99,1,1,1,2,1,2013-08-02 21:29:36,2013-08-02 21:29:36
9c3cd308517efe7ac86cbabca861dea46c7286fb...21bff7415dfae70bfc05848b4f1b1e2ca072e9ee,1,2,0,2,1,2013-08-02 01:12:55,2013-08-02 01:12:55
21bff7415dfae70bfc05848b4f1b1e2ca072e9ee...392daa0a995bdb3d88c6b476d058bbb3596d7bd1,2,36,5,41,8,2013-08-02 17:59:41,2013-08-02 17:59:41
392daa0a995bdb3d88c6b476d058bbb3596d7bd1...af5efd29963906b18c690e0a35168911ed2c9aac,1,6,0,6,1,2013-08-02 18:18:31,2013-08-02 18:18:31
af5efd29963906b18c690e0a35168911ed2c9aac...e712d78cfb5984a29a22d56279ceffdfa17d7982,2,7,2,9,3,2013-08-02 18:19:08,2013-08-02 18:19:08
e712d78cfb5984a29a22d56279ceffdfa17d7982...8e4be18c8838dc2f34189b4d120516c5d38e56e2,1,3,2,5,2,2013-08-02 18:22:03,2013-08-02 18:21:55
8e4be18c8838dc2f34189b4d120516c5d38e56e2...558bcb8877573cf832203972fea749f18ff4f851,1,3,2,5,2,2013-08-02 18:40:55,2013-08-02 18:40:55
558bcb8877573cf832203972fea749f18ff4f851...0e785039ae30161ccdaa601ffcf3919c5f14731c,1,4,2,6,3,2013-08-02 18:47:59,2013-08-02 18:47:59
0e785039ae30161ccdaa601ffcf3919c5f14731c...aa6315e1092f2af406829812fc6d43b460ea1300,1,4,17,21,5,2013-08-02 20:46:54,2013-08-02 20:46:54
aa6315e1092f2af406829812fc6d43b460ea1300...6e67c755e176428d4fcc29042feced511c7eea77,1,1,1,2,1,2013-08-02 20:47:10,2013-08-02 20:47:10
6e67c755e176428d4fcc29042feced511c7eea77...c22f681d9ce3400601d799838655718b92de1ccb,1,6,2,8,2,2013-08-02 21:57:30,2013-08-02 21:57:30
c22f681d9ce3400601d799838655718b92de1ccb...c3d1f7bbd221e2877c35b050ce526583ae2ff667,5,57,26,83,16,2013-08-02 22:16:53,2013-08-02 22:16:53
c3d1f7bbd221e2877c35b050ce526583ae2ff667...063c4462635541c49d85a09236a2e8a8548127b1,2,2,2,4,2,2013-08-02 23:29:10,2013-08-02 23:29:10
063c4462635541c49d85a09236a2e8a8548127b1...5bd85ccc3770c0c5aba70f57b8af8c30108db052,1,23,4,27,5,2013-08-02 23:53:55,2013-08-02 23:53:55
5bd85ccc3770c0c5aba70f57b8af8c30108db052...c1f8c7f0e52cdbce74d867818f7985a864af5225,1,9,2,11,1,2013-08-03 00:09:43,2013-08-03 00:09:43
56c1eb3ee8a5311f3d82fcee559b5ee3a2369e80...06a7b0b7aeb76c1b47dc7c0daa2e176ce8c4e379,1,92,0,92,3,2013-08-07 00:59:17,2013-08-07 00:59:17
06a7b0b7aeb76c1b47dc7c0daa2e176ce8c4e379...57581c8e65c6bb2742de80480fd9f022a0d86105,1,15,1,16,1,2013-08-07 01:18:45,2013-08-07 01:18:45
57581c8e65c6bb2742de80480fd9f022a0d86105...aa2e9cd4891cb2881990e31d054a11793dcdc0d7,1,2,2,4,2,2013-08-07 07:08:59,2013-08-07 07:08:59
aa2e9cd4891cb2881990e31d054a11793dcdc0d7...679c4579fb6ff893811029e968ed50f7be956b86,1,41,0,41,1,2013-08-07 07:35:23,2013-08-07 07:35:23
679c4579fb6ff893811029e968ed50f7be956b86...3c69aa1076ffa4e50287bf8901401f74e488b7c8,1,1,1,2,1,2013-08-07 07:36:44,2013-08-07 07:36:44
3c69aa1076ffa4e50287bf8901401f74e488b7c8...0305887561a6958e8955eb866f2e491dafeaf787,1,28,0,28,1,2013-08-07 07:47:48,2013-08-07 07:47:48
0305887561a6958e8955eb866f2e491dafeaf787...febee2138c017a04e1c92cc1fce3f171a6d99534,1,16,0,16,1,2013-08-07 18:49:09,2013-08-07 18:49:09
febee2138c017a04e1c92cc1fce3f171a6d99534...dab1d19e616b508b588189b2a943b5b73fc41bff,3,6,8,14,5,2013-08-07 19:54:37,2013-08-07 19:54:37
dab1d19e616b508b588189b2a943b5b73fc41bff...ba5b7d107c4d6a45e7e9a053eda6d107f684a245,1,2,2,4,2,2013-08-07 20:47:56,2013-08-07 20:47:56
ba5b7d107c4d6a45e7e9a053eda6d107f684a245...e82d19811530a06bfd93ec9d1f7f450140d32d84,1,28,9,37,12,2013-08-07 23:34:13,2013-08-07 23:34:13
e82d19811530a06bfd93ec9d1f7f450140d32d84...5c10da1ef8c067d7f992df9b68acd93c16abafb3,1,1,1,2,1,2013-08-08 00:05:03,2013-08-08 00:05:03
5c10da1ef8c067d7f992df9b68acd93c16abafb3...2545ecd4307e460a30326d1a20c9ed316aab8a95,2,93,4,97,2,2013-08-08 00:54:55,2013-08-08 00:54:55
2545ecd4307e460a30326d1a20c9ed316aab8a95...c11ce5570d901879df3b72aad0fff61fe587a6e9,1,24,7,31,5,2013-08-14 22:19:50,2013-08-14 22:19:50
c11ce5570d901879df3b72aad0fff61fe587a6e9...4173bb13fd5a7a3c67a523a8fe101d56f8e061db,1,5,3,8,2,2013-08-15 00:30:39,2013-08-14 22:21:20
4173bb13fd5a7a3c67a523a8fe101d56f8e061db...d4088000106ee11b0bcfe278c550fae69bf67637,1,90,0,90,1,2013-08-15 01:20:52,2013-08-15 01:20:52
d4088000106ee11b0bcfe278c550fae69bf67637...492bf58b083f8521c4a90a5f76efe18cd98f8f94,1,3,1,4,1,2013-08-15 21:33:59,2013-08-15 21:33:59
56c1eb3ee8a5311f3d82fcee559b5ee3a2369e80...723e4b5b505b8fedf6030ae28d47a81fcfd36781,6,22,11,33,11,2013-08-06 18:37:05,2013-07-27 01:17:39
723e4b5b505b8fedf6030ae28d47a81fcfd36781...017407301dade46d8412bab2a60419e3eb4c6bfb,1,4,2,6,1,2013-08-06 18:59:06,2013-08-06 18:59:06
017407301dade46d8412bab2a60419e3eb4c6bfb...d70c3d54e03ac7d8ef64e706cdf83507c39770f9,2,6,3,9,3,2013-08-06 19:16:11,2013-08-06 19:16:11
d70c3d54e03ac7d8ef64e706cdf83507c39770f9...6e565bf26e13c25b0279274f5fbed90970a4db5d,1,1,1,2,1,2013-08-06 19:53:33,2013-08-06 19:53:33
4d8f388183d7d6d980290fdf1af5417dbafaa2b8...d4ed669544e5509d3b45bfc7b7a4c2d44288f45a,2,15,8,23,4,2013-04-02 00:01:25,2013-04-02 00:01:25
d4ed669544e5509d3b45bfc7b7a4c2d44288f45a...9a0fd7f5d71229cc8f205f67d58969fa1412750c,1,17,15,32,10,2013-04-02 00:14:28,2013-04-02 00:11:35
9a0fd7f5d71229cc8f205f67d58969fa1412750c...d7c25052a53bd91f58c4e16510b5b6c1bac27d17,1,5,1,6,1,2013-04-02 00:19:08,2013-04-02 00:19:08
d7c25052a53bd91f58c4e16510b5b6c1bac27d17...841b0d35887e302268872014e87d8f7016346896,1,1,1,2,1,2013-04-02 02:10:31,2013-04-02 02:10:31
841b0d35887e302268872014e87d8f7016346896...10364ede518fec71ead930365b461c76896da646,3,45,38,83,30,2013-04-02 03:21:12,2013-04-02 03:13:46
10364ede518fec71ead930365b461c76896da646...7554fc1d340478f1388abe4741798c9a2d6bb14a,1,2,2,4,2,2013-04-02 03:21:12,2013-04-02 03:17:42
7554fc1d340478f1388abe4741798c9a2d6bb14a...24b153ea857af708cac43a69936272ec3afd5d32,6,42,5,47,8,2013-04-02 05:47:20,2013-04-02 05:47:20
0ecc7dac1627befdb71cb26c91677e9bddf39faf...213da739897d66948ae4b0a88d1f81af4f7ac398,1,9,0,9,3,2014-05-29 19:07:52,2014-05-29 19:07:52
0ecc7dac1627befdb71cb26c91677e9bddf39faf...cfa29769e04c0cad8728f413776d33a688a8ff48,1,12,10,22,7,2014-05-29 04:03:50,2014-05-15 15:12:15
cfa29769e04c0cad8728f413776d33a688a8ff48...c827d00c11735629895d4a972eda06f36964d369,1,18,3,21,2,2014-05-29 04:03:50,2014-05-19 21:38:54
c827d00c11735629895d4a972eda06f36964d369...bec17a6ccbede8af45d49c042e240f1f91333ce6,1,1,19,20,2,2014-05-29 04:03:50,2014-05-19 21:39:35
bec17a6ccbede8af45d49c042e240f1f91333ce6...33ddc92ffc1527ed83550588334383bb553b1e3b,1,65,38,103,8,2014-05-29 04:03:51,2014-05-27 18:46:10
33ddc92ffc1527ed83550588334383bb553b1e3b...4436cc4ad1f41c5356018143ed567b9e11caa622,1,26,18,44,8,2014-05-29 17:00:11,2014-05-29 15:44:29
4436cc4ad1f41c5356018143ed567b9e11caa622...9c5764fc832c23c06a3555f973cdf4753c755506,1,1,0,1,1,2014-05-29 17:02:09,2014-05-29 17:02:09
17c58f67065a1040591baba5a53fab8ac8b39989...b7c547f0901248cce3feefdf604f128142cccc23,1,2,1,3,1,2014-06-02 21:00:51,2014-06-02 21:00:51
b7c547f0901248cce3feefdf604f128142cccc23...bceab2cbb67a523c0db7e45b4e5e0e3a0782778d,3,51,14,65,9,2014-06-02 21:06:11,2014-05-22 01:01:36
bceab2cbb67a523c0db7e45b4e5e0e3a0782778d...f8cabb4cfa18024e3eb234aaeb93462f24862148,3,9,11,20,5,2014-06-02 21:06:11,2014-05-22 01:59:36
f8cabb4cfa18024e3eb234aaeb93462f24862148...e6271d6a7dcca6f67d2a2966c1acbf024522932e,1,4,2,6,1,2014-06-02 21:15:17,2014-06-02 21:07:39
e6271d6a7dcca6f67d2a2966c1acbf024522932e...a40a6273953c0e18eddcd67919754814461c5dd4,1,0,1,1,1,2014-06-02 21:15:17,2014-06-02 21:14:15
4acfc5c6fffee42842b074ae36c5b3b1b739cf99...ab5c2513cd807f22866caa5a014b82e6ae8d96bd,1,8,0,8,1,2014-06-11 00:05:28,2014-06-06 11:52:43
ab5c2513cd807f22866caa5a014b82e6ae8d96bd...31a5f4014ff9180b5bc25551df314cc4b36e2a08,1,10,3,13,2,2014-06-11 00:10:34,2014-06-11 00:10:34
e6c8cabad65f451cb9d0884c4eeb5a5658867d6c...902de60d486934820a7e18e77017fc7e888b7ea6,1,1,0,1,1,2014-07-30 16:38:48,2014-07-30 16:38:30
1c12b1a49f27c6cea6169feae00c89b6fb9fc3f8...e551266c264032c3ebd5f28ab5dadd93a0546d8c,1,4,1,5,3,2014-06-23 23:35:07,2014-06-23 23:35:07
e551266c264032c3ebd5f28ab5dadd93a0546d8c...969009460cf165b299e5bff97117f3d75d02b4b6,1,2,1,3,2,2014-06-23 23:35:55,2014-06-23 23:35:55
969009460cf165b299e5bff97117f3d75d02b4b6...51e1429d86042f77006e1a6a81c0d4a1f9765009,1,1,2,3,1,2014-06-23 23:39:27,2014-06-23 23:38:35
51e1429d86042f77006e1a6a81c0d4a1f9765009...5da79a13d61179ab13bcfe3be77c6057a2357c4e,1,208,227,435,29,2014-06-24 03:03:44,2014-06-24 01:36:09
2e7940865813a425dc8e1340a3dcf85c1eda9c18...5bc49dafae61d2121c0539b4ee1dcf0f18e59bd3,2,21,3,24,12,2014-05-26 07:11:14,2014-05-05 07:42:01
5bc49dafae61d2121c0539b4ee1dcf0f18e59bd3...0ee98024816f4efa2846938b682d0cc3f78ed061,1,61,0,61,1,2014-05-26 07:11:14,2014-05-05 07:55:31
0ee98024816f4efa2846938b682d0cc3f78ed061...9d56bd2644860f66e449b0ff155cfe4d1b53c605,1,28,6,34,8,2014-05-26 07:11:14,2014-05-05 08:02:47
9d56bd2644860f66e449b0ff155cfe4d1b53c605...b992d9a9f4e6218616d0f513b9280c0463f8f7ee,1,14,8,22,4,2014-05-26 07:11:14,2014-05-09 06:03:48
b992d9a9f4e6218616d0f513b9280c0463f8f7ee...ce951d8d0923f45c3c680a8524e708d41f1e9cb3,1,5,5,10,5,2014-05-26 07:11:14,2014-05-09 06:04:40
ce951d8d0923f45c3c680a8524e708d41f1e9cb3...c168a6eb7e0ce81b6c73ccbb1d9d17c0c22030e5,2,5,8,13,4,2014-05-26 07:17:57,2014-05-26 07:17:57
9c4e305178388b39dc887716f9ccace7e774d20a...70d98d2484f208937e70fd58f80c5fedbac68edb,1,11,19,30,8,2014-05-19 21:09:38,2014-05-16 18:15:50
eac8f504b140f14b4416c63312c28a4f84bd2cbb...4928ed61d1b51b25502e493b0467deb209ee47a5,2,4,1,5,2,2014-05-09 21:14:22,2014-05-08 18:16:20
4928ed61d1b51b25502e493b0467deb209ee47a5...5fe931056b810359922311a4dcc218d198da5044,1,6,0,6,2,2014-05-09 23:30:23,2014-05-09 23:30:05
788b5254fbd6bb55793ba607403833fe59deb6f5...3eeb7e61bd8d422a08bf36d94b48085be6553b59,1,1,1,2,1,2014-04-29 23:25:38,2014-04-17 01:23:18
3eeb7e61bd8d422a08bf36d94b48085be6553b59...64e02f2f56d1588d9daad09634d579eb61bf91ab,1,2,2,4,2,2014-04-29 23:49:48,2014-04-23 02:37:15
788b5254fbd6bb55793ba607403833fe59deb6f5...e4c17ef07bc71e3f39c8082560056e6006102420,1,0,2,2,1,2014-04-26 01:50:16,2014-04-26 01:50:16
e4c17ef07bc71e3f39c8082560056e6006102420...dd7d8fea60dfef6971ce77e998ad9f3e74d69a6f,1,17,3,20,6,2014-04-26 01:54:52,2014-04-26 01:54:52
dd7d8fea60dfef6971ce77e998ad9f3e74d69a6f...406e3de77e5a250c8c823571130a07c00363d43b,1,8,2,10,2,2014-04-26 02:02:12,2014-04-26 02:01:40
406e3de77e5a250c8c823571130a07c00363d43b...0a5297d39ba414793a9efb099f822c6eaadef926,1,1,1,2,1,2014-04-26 21:46:32,2014-04-26 21:38:38
0a5297d39ba414793a9efb099f822c6eaadef926...e48a3e557fbf0a61b4a9e657ab1e205ec7e9ed16,2,8,37,45,3,2014-04-28 19:17:00,2014-04-28 19:16:22
e48a3e557fbf0a61b4a9e657ab1e205ec7e9ed16...d45414154dc441d798f62a003d4a6d4a61eec203,1,4,23,27,4,2014-04-28 20:54:08,2014-04-28 20:54:08
d45414154dc441d798f62a003d4a6d4a61eec203...5a646fe79641747612d4a7c9328248bdedbd8cb3,1,50,46,96,33,2014-04-28 23:03:55,2014-04-28 21:07:39
5a646fe79641747612d4a7c9328248bdedbd8cb3...6ce2c131d31d8784544b3d4adb28c0a7d2125e55,1,16,13,29,7,2014-04-28 23:04:50,2014-04-28 23:02:15
6ce2c131d31d8784544b3d4adb28c0a7d2125e55...2fdae0f132c4676152d7214b65f504f58eb79da6,1,15,15,30,3,2014-04-28 23:11:53,2014-04-28 23:11:53
2fdae0f132c4676152d7214b65f504f58eb79da6...8b634a96f9d76dd27d76e0f27d1d4ca304cdcc10,1,12,3,15,4,2014-04-28 23:23:42,2014-04-28 23:23:42
8b634a96f9d76dd27d76e0f27d1d4ca304cdcc10...31a9b47bc6408e5a82059156b6cc59abd536bbaa,1,18,5,23,4,2014-04-29 03:51:49,2014-04-29 03:51:49
31a9b47bc6408e5a82059156b6cc59abd536bbaa...9ab335baff77d543b02a2d41edd069f7749cf9c2,1,10,6,16,2,2014-04-29 20:59:51,2014-04-29 20:59:23
9ab335baff77d543b02a2d41edd069f7749cf9c2...2b8f2cc566cfaf3369f17b1da9ec60f601587b91,1,19,11,30,4,2014-04-29 21:30:34,2014-04-29 21:20:51
2b8f2cc566cfaf3369f17b1da9ec60f601587b91...e7f955f809e4ff47a79e94314dd0dd8fedd9c0ea,1,4,1,5,1,2014-04-29 22:00:55,2014-04-29 22:00:55
e7f955f809e4ff47a79e94314dd0dd8fedd9c0ea...30b937365fac81a62c05081c61e2e891cab69f98,1,6,1,7,1,2014-04-30 02:56:11,2014-04-30 02:56:11
30b937365fac81a62c05081c61e2e891cab69f98...9b6d020e914f1a7abffb1af03eb2bf9cb016181d,1,7,0,7,1,2014-04-30 06:24:52,2014-04-30 06:02:09
9b6d020e914f1a7abffb1af03eb2bf9cb016181d...2ee6fa383cee82de613ce425435b0773866de5b3,1,85,0,85,2,2014-04-30 06:25:43,2014-04-30 06:25:43
2ee6fa383cee82de613ce425435b0773866de5b3...bea8e9c5d083ff353334dd5211b2a7e4d051da67,1,1,1,2,1,2014-04-30 06:26:35,2014-04-30 06:26:35
af32d49c2b56486ff37311794232f289e90ad974...cff3b175c07b250a2c0e773cec6c2ded314df3e0,1,5,14,19,5,2014-06-06 19:07:50,2014-06-06 18:40:45
cff3b175c07b250a2c0e773cec6c2ded314df3e0...d8c442faff307cdbb994ffa8174e55360f65f590,1,2,1,3,1,2014-06-06 19:07:50,2014-06-06 18:59:49
568b0f929ca513c33f6d1347d6bd5461ae3587cc...6b95113d99f664f99946260f94838c6b3d5021e6,4,150,0,150,5,2014-04-21 00:28:55,2014-04-21 00:16:39
6b95113d99f664f99946260f94838c6b3d5021e6...af7aab41b675594fdb0bc57a636c30dc3d9ed6bc,1,0,2,2,2,2014-04-22 04:55:59,2014-04-22 04:55:59
af7aab41b675594fdb0bc57a636c30dc3d9ed6bc...775ff19345667318667f615bfc331fd043d60669,1,24,15,39,4,2014-04-22 04:56:16,2014-04-22 04:56:16
775ff19345667318667f615bfc331fd043d60669...c445b571349b4584cd5653e030cc7f370fd473ef,1,5,5,10,4,2014-04-22 05:11:02,2014-04-22 05:11:02
c445b571349b4584cd5653e030cc7f370fd473ef...c68c77d51788822f4c528393072e072a3f6968df,1,4,0,4,1,2014-04-22 16:44:21,2014-04-22 16:44:21
2b059fc311ae9a714f16c2927b2e95f7e9513c16...c5307a4be42544a37eef0fc54daf8c3c68e9944a,1,2,1,3,1,2014-05-12 18:48:41,2014-05-12 18:48:41
c5307a4be42544a37eef0fc54daf8c3c68e9944a...4a8710b25081f0ea67089332b4b35ac9c300a59f,1,17,4,21,4,2014-05-12 20:06:26,2014-05-12 20:06:26
4a8710b25081f0ea67089332b4b35ac9c300a59f...61a083a2d55924c0d9aea9ebe7a7a7c350e417a9,3,18,23,41,10,2014-05-12 20:22:44,2014-05-12 20:22:44
61a083a2d55924c0d9aea9ebe7a7a7c350e417a9...324db2aeaff0fcbd691ed4dd367997d46b0dd7d0,1,41,43,84,12,2014-05-12 22:23:16,2014-05-12 22:23:16
607875b7b08ee8f4539d40bf459417d9c9814ce0...d51da1bdd1af92769266585ee9256578c3423e97,1,15,2,17,2,2014-05-13 22:04:12,2014-05-13 22:04:12
d51da1bdd1af92769266585ee9256578c3423e97...81ece3d76af8cce07d1b15a3f160768619a44922,1,2,2,4,2,2014-05-13 22:08:57,2014-05-13 22:08:57
81ece3d76af8cce07d1b15a3f160768619a44922...67352e18d49d2ba77294f43522bd4b945ad2a58b,1,0,1,1,1,2014-05-13 22:24:44,2014-05-13 22:24:44
67352e18d49d2ba77294f43522bd4b945ad2a58b...c369761fe5bfe528450c2c1d68eec774b78e6c4b,3,21,15,36,14,2014-05-13 22:49:20,2014-05-13 22:48:55
c369761fe5bfe528450c2c1d68eec774b78e6c4b...048cb5be36394ea1ae26042b8daa4484579192bd,1,1,0,1,1,2014-05-14 05:02:52,2014-05-14 05:02:52
048cb5be36394ea1ae26042b8daa4484579192bd...4f0bb7faeb72439696d761d2e9a699c3feda0f14,2,46,10,56,9,2014-05-14 05:53:17,2014-05-14 05:53:17
4f0bb7faeb72439696d761d2e9a699c3feda0f14...a9c944c4d907c04d24d1768523ca879f2ac01563,1,23,12,35,3,2014-05-14 17:25:38,2014-05-14 17:25:38
a9c944c4d907c04d24d1768523ca879f2ac01563...35bad76bc5be2b672f8b0b3bb7e0ca8fc4e5fb0f,8,222,83,305,35,2014-05-14 18:40:43,2014-05-14 00:03:20
35bad76bc5be2b672f8b0b3bb7e0ca8fc4e5fb0f...32d7bf6b2f4be9ad88998aa8261d31d34f340a54,2,77,29,106,11,2014-05-14 20:37:12,2014-05-14 19:38:08
32d7bf6b2f4be9ad88998aa8261d31d34f340a54...00df10d8a6c8c3d6fe34599b438b4c62d98ab45d,1,36,0,36,1,2014-05-14 21:05:19,2014-05-14 21:05:19
00df10d8a6c8c3d6fe34599b438b4c62d98ab45d...5abfe1933d5bc0054943f50f073434c271f263fe,1,3,4,7,3,2014-05-14 21:07:11,2014-05-14 21:07:11
5abfe1933d5bc0054943f50f073434c271f263fe...9f51a408ed9ebf5df1eb2d2211d0bdbcec4d03bc,2,7,9,16,3,2014-05-14 21:08:25,2014-05-14 21:08:25
9f51a408ed9ebf5df1eb2d2211d0bdbcec4d03bc...89b0161001c3c0456ff69750e9057dd68f864f99,1,3,3,6,3,2014-05-15 20:34:32,2014-05-15 20:34:32
89b0161001c3c0456ff69750e9057dd68f864f99...333d241c38bc09e4867d7822c072423cc2aee0a3,1,5,2,7,2,2014-05-15 20:40:08,2014-05-15 20:40:08
333d241c38bc09e4867d7822c072423cc2aee0a3...9871c3021986d3219cae096836986d1d53fc53a6,1,1,1,2,1,2014-05-15 20:50:21,2014-05-15 20:50:21
9871c3021986d3219cae096836986d1d53fc53a6...98d9a56a6216f29fc55a1c2973871ee0f4caa138,5,81,26,107,27,2014-05-16 01:16:30,2014-05-16 01:13:41
98d9a56a6216f29fc55a1c2973871ee0f4caa138...a6cf0db7be171816ed1d4bbb0e00d753154e9b80,2,4,4,8,4,2014-05-16 01:23:34,2014-05-16 01:23:34
a6cf0db7be171816ed1d4bbb0e00d753154e9b80...85ac69ca939f3be805b9a400ba0e7daafa3dfe98,1,3,13,16,3,2014-05-16 01:36:42,2014-05-16 01:36:42
85ac69ca939f3be805b9a400ba0e7daafa3dfe98...63b35f1bbc20edcdf6dd45daa0e0b787a678cc69,1,4,0,4,1,2014-05-16 17:42:00,2014-05-16 17:42:00
63b35f1bbc20edcdf6dd45daa0e0b787a678cc69...daa5889c38449a1e2e2204cce80ed2e872f4827c,2,2,13,15,6,2014-05-16 17:42:30,2014-05-16 17:42:30
daa5889c38449a1e2e2204cce80ed2e872f4827c...1fe9b29d35a1e8d234a8fe6517292cc82d520fee,2,17,5,22,7,2014-05-16 18:00:26,2014-05-16 18:00:26
1fe9b29d35a1e8d234a8fe6517292cc82d520fee...0760ffbc369c5dbaa1424546d6d71cc270c3c66e,1,11,1,12,2,2014-05-16 18:39:00,2014-05-16 18:39:00
0760ffbc369c5dbaa1424546d6d71cc270c3c66e...7065cc50f6007d829aeafc3ca1ebbe8a6f60ef5e,2,32,11,43,10,2014-05-16 19:01:16,2014-05-16 19:01:16
7065cc50f6007d829aeafc3ca1ebbe8a6f60ef5e...49704826893f00a663b66db570367b766166023b,2,16,2,18,3,2014-05-19 21:38:44,2014-05-19 21:38:44
49704826893f00a663b66db570367b766166023b...99d0c54dd8f08d2d86122cdcb6716c655e05dddc,1,7,5,12,7,2014-05-19 22:48:25,2014-05-19 22:48:25
99d0c54dd8f08d2d86122cdcb6716c655e05dddc...dc9d50cf56273c918aa903c2c2e3883980e3139b,1,2,15,17,4,2014-05-19 23:03:52,2014-05-19 23:03:52
dc9d50cf56273c918aa903c2c2e3883980e3139b...52e74df7b1c8ac958c0f10c6ad576a7a0a6e3a76,2,116,0,116,2,2014-05-19 23:10:23,2014-05-19 23:07:39
52e74df7b1c8ac958c0f10c6ad576a7a0a6e3a76...1c866f34bd66fafa7846e5981f908c7531139d28,4,22,11,33,12,2014-05-19 23:49:58,2014-05-19 23:49:58
1c866f34bd66fafa7846e5981f908c7531139d28...630a3eb79400b58023ea8052cb33547ee869212f,1,9,27,36,6,2014-05-20 00:13:58,2014-05-20 00:13:58
630a3eb79400b58023ea8052cb33547ee869212f...3e88f04d1f1954913576ad47fa6cc3d02b67d317,1,14,0,14,1,2014-05-20 00:20:55,2014-05-20 00:20:55
3e88f04d1f1954913576ad47fa6cc3d02b67d317...b0d9061ca7151550a8f2a18a29274fe449bf5b92,1,21,12,33,8,2014-05-20 00:39:04,2014-05-20 00:39:04
b0d9061ca7151550a8f2a18a29274fe449bf5b92...9146cf3c76c7b6dcccf75d66df37aaff32875899,2,2,2,4,2,2014-05-20 01:00:31,2014-05-20 01:00:31
9146cf3c76c7b6dcccf75d66df37aaff32875899...b2aaf88e9260bd86f9a8977ed375a6ec4b401d6a,3,17,7,24,9,2014-05-20 02:57:28,2014-05-20 02:43:53
b2aaf88e9260bd86f9a8977ed375a6ec4b401d6a...22efb2460635a142a6a945645640298d1de18906,1,17,9,26,7,2014-05-20 02:57:28,2014-05-20 02:49:28
22efb2460635a142a6a945645640298d1de18906...3d3ce33d32c1c812b2dd8d63393e507df0f451c5,3,2,3,5,3,2014-05-20 02:57:29,2014-05-20 02:54:25
3d3ce33d32c1c812b2dd8d63393e507df0f451c5...ea5e6d075c60ef87a309d9318fb5761bac5a2cf2,3,5,2,7,3,2014-05-20 03:12:50,2014-05-20 03:12:50
ea5e6d075c60ef87a309d9318fb5761bac5a2cf2...5710fe876ce850af702188e7428362fd6e354f10,6,43,13,56,16,2014-05-20 04:12:32,2014-05-20 03:45:41
5710fe876ce850af702188e7428362fd6e354f10...23ca9b66b810203c95d9a649806423b9c2a1a93b,2,5,1,6,3,2014-05-20 17:32:07,2014-05-20 17:32:07
23ca9b66b810203c95d9a649806423b9c2a1a93b...943d00646fbf5acfe4825ce4a035b3e7c087a5a0,4,22,128,150,5,2014-05-20 17:50:53,2014-05-20 17:47:20
943d00646fbf5acfe4825ce4a035b3e7c087a5a0...8e2c97cd58a365b44fc9810ad67341559aabca08,2,4,2,6,3,2014-05-20 18:09:53,2014-05-20 18:09:53
8e2c97cd58a365b44fc9810ad67341559aabca08...135deb16ae2fb670947d28fae976ded016b84f30,1,1,0,1,1,2014-05-20 18:14:29,2014-05-20 18:14:29
135deb16ae2fb670947d28fae976ded016b84f30...9b2c11f9ced05f25a94ff17510b3dfa220247dc5,1,4,0,4,1,2014-05-20 18:16:24,2014-05-20 18:16:24
9e3d6fc5cf6a3ce24cdec81428db30a28ca2b49d...624ddcb655b7c7835fd80fd051bac9501d251ee4,1,0,4,4,1,2014-05-13 21:30:22,2014-05-13 21:30:22
eee6fba8e20c853e052ac3255f3d2e0fd6b83aa9...641c99d7a9d07eeb1eafa58c86ecd0e59abb4b70,2,3,12,15,10,2014-04-16 05:00:57,2014-04-16 05:00:57
641c99d7a9d07eeb1eafa58c86ecd0e59abb4b70...693c41493dd6f9542d9d3aad566f9ae88d400f27,4,2,8,10,5,2014-04-16 05:09:53,2014-04-16 05:09:53
693c41493dd6f9542d9d3aad566f9ae88d400f27...228cf6f71ffe0198edc21e73cec5815b10c1ccbc,1,30,27,57,8,2014-04-17 18:10:30,2014-04-17 18:10:30
eee6fba8e20c853e052ac3255f3d2e0fd6b83aa9...b8c9222a273fda2b4416e6e8f9b620d3a8948325,15,211,1,212,15,2014-04-15 04:23:12,2014-04-15 04:23:12
b8c9222a273fda2b4416e6e8f9b620d3a8948325...e4c7c28a6a858e1408c52efcfca5cce5a245eb22,5,142,45,187,19,2014-04-15 05:31:36,2014-04-15 05:31:36
e4c7c28a6a858e1408c52efcfca5cce5a245eb22...2f990d85f5c446d13cc9c8f80e4161524792dfcd,2,7,6,13,8,2014-04-16 04:53:22,2014-04-16 04:53:22
b161d3c0ecd143878298581f1b37b9fd89f04d44...76f03776b684d46d75686d7ad8de0444c17887c5,2,23,17,40,5,2014-03-15 00:08:44,2014-03-15 00:08:44
76f03776b684d46d75686d7ad8de0444c17887c5...21e7c961b422010755ddfba9899c96c7eae28e9b,3,41,18,59,4,2014-03-15 00:23:06,2014-03-15 00:23:06
4ba1abb79e53ac0858d2be335b78250d4d469a6b...1fcb33e61b68fc0ee5f5504edb88ff11decb6186,1,11,1,12,4,2014-03-22 16:57:46,2014-03-22 16:57:46
ccd6c00544ea9c077b0770878d1a1de29ed6c928...0ec8100ddc85ee604e21f7b0e70740575d1715ea,2,3,3,6,3,2014-03-07 02:35:05,2014-03-07 02:34:40
0ec8100ddc85ee604e21f7b0e70740575d1715ea...3ffc8ab7cf6b188fe7a58881bb3bab2554b61b21,2,0,0,0,0,2014-03-07 02:45:23,2014-03-07 02:45:23
3ffc8ab7cf6b188fe7a58881bb3bab2554b61b21...37facf275468a4632a422041d7a63a2fa79457fa,1,1,1,2,1,2014-03-07 02:45:35,2014-03-07 02:45:35
37facf275468a4632a422041d7a63a2fa79457fa...c4319a40b23f2ca5b3875ab24b6fbb018a8a4836,2,0,0,0,0,2014-03-07 02:56:34,2014-03-07 02:56:34
c4319a40b23f2ca5b3875ab24b6fbb018a8a4836...cd059761a71e87758aaef540838134eaf13494a1,1,8,6,14,2,2014-03-07 03:00:52,2014-03-07 03:00:52
cd059761a71e87758aaef540838134eaf13494a1...4e39ce1627c400e36879d8c901b57ba9bfc707a3,1,8,8,16,8,2014-03-07 03:05:55,2014-03-07 02:50:10
4e39ce1627c400e36879d8c901b57ba9bfc707a3...bc48b764873562806bda80173fede84b37c18a17,1,2,1,3,1,2014-03-07 03:09:01,2014-03-07 03:08:08
bc48b764873562806bda80173fede84b37c18a17...38f7ea542677c7a3a7cd3e832c5e98d3ba64b743,2,3,1,4,2,2014-03-07 03:28:48,2014-03-07 03:28:48
38f7ea542677c7a3a7cd3e832c5e98d3ba64b743...112b2f99a44d43c7c378d77c1edcaa9dcb6a919e,1,16,3,19,5,2014-03-07 03:42:01,2014-03-07 03:40:01
112b2f99a44d43c7c378d77c1edcaa9dcb6a919e...c3471f4a78c82c2a41ce3f9ae322a79e2f66d293,1,3,1,4,2,2014-03-07 03:45:17,2014-03-07 03:45:17
c3471f4a78c82c2a41ce3f9ae322a79e2f66d293...63f13fbb87c7837df983fe49b39d4108da9977bd,3,45,51,96,20,2014-03-07 05:56:47,2014-03-07 05:56:47
63f13fbb87c7837df983fe49b39d4108da9977bd...b4df32387584ba2d6cac5110aacbcaa562eef54f,3,17,6,23,7,2014-03-07 06:17:18,2014-03-07 06:17:18
b4df32387584ba2d6cac5110aacbcaa562eef54f...8f51bc3bcc51aacf78db2b4a77f5b92b7ab686cc,1,119,0,119,1,2014-03-07 06:57:25,2014-03-07 06:57:25
8f51bc3bcc51aacf78db2b4a77f5b92b7ab686cc...a983a28d0a54bb55fbebf22caf393321f6036b90,1,8,7,15,2,2014-03-07 07:03:30,2014-03-07 02:45:53
a983a28d0a54bb55fbebf22caf393321f6036b90...17c145675ff120bd756af4263c9918663d70585f,1,49,12,61,5,2014-03-07 07:04:10,2014-03-07 02:32:45
17c145675ff120bd756af4263c9918663d70585f...d4f95d2c0cc73717e6092f7d3c293ac3c21d98fe,3,47,17,64,10,2014-03-07 07:04:10,2014-03-07 04:56:47
d4f95d2c0cc73717e6092f7d3c293ac3c21d98fe...a13e53a06c966157a65a12f2a750aa05022bc629,1,6,4,10,1,2014-03-07 07:44:26,2014-03-07 07:44:26
a13e53a06c966157a65a12f2a750aa05022bc629...2764d02ab5e783ab50ef32035bd9a9ac32c571ca,2,40,12,52,7,2014-03-07 08:14:13,2014-03-07 08:14:13
2764d02ab5e783ab50ef32035bd9a9ac32c571ca...856e66526829d9edda4f421243c8a8dbaf024d56,1,33,1,34,2,2014-03-07 08:15:14,2014-03-07 08:14:48
856e66526829d9edda4f421243c8a8dbaf024d56...fb150e03bec2871f1d753a6bfb9a73081375ecf9,1,17,0,17,1,2014-03-07 08:17:19,2014-03-07 08:10:06
fb150e03bec2871f1d753a6bfb9a73081375ecf9...926305bae0a772ff1018abeb9fa7b2d15fc98fb6,2,14,1,15,3,2014-03-07 08:17:19,2014-03-07 08:11:51
926305bae0a772ff1018abeb9fa7b2d15fc98fb6...2a2bebfd5579928714078055232974cd579236d5,2,30,23,53,3,2014-03-07 09:18:09,2014-03-07 08:07:24
2a2bebfd5579928714078055232974cd579236d5...4d114ef61743a8b82346810be7c38a70985dd01b,42,53,11,64,42,2014-03-07 09:33:37,2014-03-07 09:33:37
4d114ef61743a8b82346810be7c38a70985dd01b...7919804bfd80e32e24b85d6455566786d9554a60,4,179,10,189,19,2014-03-07 09:34:58,2014-03-07 09:34:58
7919804bfd80e32e24b85d6455566786d9554a60...8deaa02b275f141f05956a97fe439fedd8746da9,1,1,1,2,1,2014-03-07 09:36:30,2014-03-07 09:36:30
8deaa02b275f141f05956a97fe439fedd8746da9...a8015903609fce7be97f5b3d2206f9aed71517b1,1,2,1,3,2,2014-03-07 10:06:12,2014-03-07 10:06:12
a8015903609fce7be97f5b3d2206f9aed71517b1...70c6707d6217d1a034fbf84f2aba000086c3cb64,1,7,3,10,3,2014-03-07 10:27:11,2014-03-07 10:27:11
70c6707d6217d1a034fbf84f2aba000086c3cb64...3b50eb0b164d35711d287fd65bcf71083302c49c,1,1,1,2,1,2014-03-07 10:30:05,2014-03-07 10:30:05
3b50eb0b164d35711d287fd65bcf71083302c49c...dfa497188d703571632bea489165a16236ae1b03,5,141,44,185,21,2014-03-07 10:32:54,2014-03-07 09:58:24
dfa497188d703571632bea489165a16236ae1b03...f26c8f42e54bb56d9dfefb316ea0e9bdb0cb69b8,1,3,1,4,1,2014-03-07 16:54:43,2014-03-07 16:53:09
f26c8f42e54bb56d9dfefb316ea0e9bdb0cb69b8...78497c0b6bbdacd429e2b10d10304f716a66510f,3,17,11,28,8,2014-03-07 19:18:36,2014-03-07 19:18:36
78497c0b6bbdacd429e2b10d10304f716a66510f...07c016c595146e4bbe59fdb951982a965fe95cd4,2,90,23,113,7,2014-03-07 19:24:22,2014-03-07 19:23:54
07c016c595146e4bbe59fdb951982a965fe95cd4...66b72536950715d569688ee5030d1e34f93b13e4,63,96,34,130,63,2014-03-07 20:00:20,2014-03-07 19:57:57
66b72536950715d569688ee5030d1e34f93b13e4...4b83a1ed18af04d033e7c049b14e59b6b9648036,4,167,26,193,34,2014-03-07 20:00:20,2014-03-07 19:59:23
4b83a1ed18af04d033e7c049b14e59b6b9648036...5e2b655dc53534d67e8364f396f0654a85e30d18,3,8,6,14,7,2014-03-07 20:06:23,2014-03-07 20:06:05
5e2b655dc53534d67e8364f396f0654a85e30d18...f34be8de6a92c33b983e7b6441c2993415588828,1,13,4,17,2,2014-03-07 20:35:14,2014-03-07 20:26:54
f34be8de6a92c33b983e7b6441c2993415588828...b216de95550aadd9781538a737df5ba8fa98cc77,1,24,7,31,12,2014-03-07 20:36:45,2014-03-07 20:36:45
b216de95550aadd9781538a737df5ba8fa98cc77...50fc8053b11293d83db6f151e76ccfd0097538a0,1,2,2,4,2,2014-03-07 20:46:37,2014-03-07 20:46:37
837f842e7b229a351917f6285477e0cd299aa7c5...56d60907cc96eb5953aade03da1f70400356310e,1,12,14,26,3,2014-01-09 06:21:38,2013-11-18 17:55:08
56d60907cc96eb5953aade03da1f70400356310e...44629cf80055a84f2ee55377dec795b363790659,3,102,17,119,13,2014-01-09 06:21:38,2013-11-18 23:26:08
837f842e7b229a351917f6285477e0cd299aa7c5...2a6f0a8b5c0b87457d1107f6cd14587afc1d90b9,3,952,812,1764,113,2014-01-08 20:21:12,2013-12-30 19:29:01
2a6f0a8b5c0b87457d1107f6cd14587afc1d90b9...dfa0952d3f8752fa3c5b94f2e784a984605824d9,1,46,49,95,8,2014-01-08 20:22:17,2014-01-07 15:23:50
dfa0952d3f8752fa3c5b94f2e784a984605824d9...80c7c9a11749504de3d703aac9e8e3154bf2d566,4,432,0,432,4,2014-01-08 20:29:14,2014-01-08 20:29:14
80c7c9a11749504de3d703aac9e8e3154bf2d566...39b68a52b92a98da821a09bd34f5e7c7b7aa3fc2,1,150,143,293,24,2014-01-08 20:46:18,2014-01-08 20:46:18
39b68a52b92a98da821a09bd34f5e7c7b7aa3fc2...c4ee43e67faf7a16603efc005183ecacba55fed7,6,71,59,130,65,2014-01-08 21:10:59,2014-01-08 21:10:59
36ff205437d00719b0a806c042be22acda2c2a00...bed799f240325282a7a0506c2aed1ea0e3566065,1,9,9,18,4,2014-01-30 20:16:51,2014-01-30 20:15:42
bed799f240325282a7a0506c2aed1ea0e3566065...990450c2a6afdaa9db3357d0c0414e4a5c0918fb,12,65,65,130,65,2014-01-31 02:08:56,2014-01-31 00:26:57
fbda101599a3d4c21b71fe9d3aa0ee9b7d1d8d6d...db7e3873905115491d1b04b9cd4a5d59864595f1,2,2,2,4,2,2014-02-14 03:09:23,2014-02-14 03:09:23
db7e3873905115491d1b04b9cd4a5d59864595f1...8fd5369f58077202c9e308cc6f8c77409c52f178,2,5,4,9,5,2014-02-14 03:11:29,2014-02-14 00:33:55
8fd5369f58077202c9e308cc6f8c77409c52f178...52639e62bb1ae2d01f36bfc3b2898d9ffb9e26fe,4,39,32,71,23,2014-02-14 03:11:30,2014-02-14 00:34:44
52639e62bb1ae2d01f36bfc3b2898d9ffb9e26fe...2586a50cd0421361011826628ed8e82cce06bca4,6,53,54,107,52,2014-02-14 03:11:30,2014-02-14 00:01:01
2586a50cd0421361011826628ed8e82cce06bca4...c0ac1ce11e69c39b22c1aa95a4edde4af320f15e,1,12,7,19,7,2014-02-14 03:11:30,2014-02-14 02:25:05
c0ac1ce11e69c39b22c1aa95a4edde4af320f15e...0ea4acc2080eb8afaffc80859eb29e2215df496d,1,6,2,8,2,2014-02-14 03:11:30,2014-02-14 02:39:31
0ea4acc2080eb8afaffc80859eb29e2215df496d...a3931f3f15136b4577c08f40a92a7a5846b747b3,1,1,1,2,1,2014-02-14 03:11:30,2014-02-14 03:07:15
a3931f3f15136b4577c08f40a92a7a5846b747b3...1752ceeb677ba9df597c7c6b82dbc9b05d045900,1,31,0,31,7,2014-02-14 03:11:30,2014-02-14 03:07:35
1752ceeb677ba9df597c7c6b82dbc9b05d045900...7318071327697078ae8728fabfa1de2f1852287c,1,1,1,2,1,2014-02-14 03:11:30,2014-02-14 03:10:10
7318071327697078ae8728fabfa1de2f1852287c...553bf14c780bd1d580e5ce62767cd1f01ad79b7a,1,0,5,5,1,2014-02-14 03:13:32,2014-02-14 03:10:44
553bf14c780bd1d580e5ce62767cd1f01ad79b7a...ccb3f08b51b4cc95de789116fb877f248f9a0ca4,1,1,1,2,1,2014-02-14 03:37:55,2014-02-14 03:14:31
ccb3f08b51b4cc95de789116fb877f248f9a0ca4...1f7fa9e4c46219a22833e843fe392b7e2d0cc93b,1,15,0,15,1,2014-02-14 03:37:55,2014-02-14 03:20:48
1f7fa9e4c46219a22833e843fe392b7e2d0cc93b...20a8e679f71e3a346381339d9ab2bb8d63ca4305,2,17,11,28,6,2014-02-14 03:37:55,2014-02-14 03:25:11
20a8e679f71e3a346381339d9ab2bb8d63ca4305...9d8f95d82b93b4ad77154876afc99a41d3ac782c,1,2,2,4,1,2014-02-14 04:25:45,2014-02-14 03:19:20
9d8f95d82b93b4ad77154876afc99a41d3ac782c...1a3116fe8d9c47363a73e9a87649e9a2c8b91e42,1,6,0,6,1,2014-02-14 04:25:45,2014-02-14 03:20:44
1a3116fe8d9c47363a73e9a87649e9a2c8b91e42...055426a44992e1819ee78a43a4cd909f061b2044,2,2,1,3,2,2014-02-14 04:25:45,2014-02-14 03:25:26
055426a44992e1819ee78a43a4cd909f061b2044...c9ad8e9ec9c211d1e29929dbce03c5c46f3ebd34,1,1,1,2,1,2014-02-14 04:25:45,2014-02-14 04:25:16
dee3799c4a2179fccf30f2f877c9a00e1033efce...9fa73a3d258c826b70c497f0e4d38c575aecaffc,2,44,52,96,16,2014-02-04 07:43:04,2014-02-04 07:43:04
9fa73a3d258c826b70c497f0e4d38c575aecaffc...0ba04e70785577164c1719d1f8a0f29e936d0cac,1,3,3,6,2,2014-02-04 07:43:36,2014-02-04 07:43:36
0ba04e70785577164c1719d1f8a0f29e936d0cac...307eb044683767dcc82860e38b11d43aaba8634b,3,333,248,581,3,2014-02-06 07:05:08,2014-02-06 07:05:08
307eb044683767dcc82860e38b11d43aaba8634b...2b536f309fae3fddf8ffebbffdf2e90e0c9bb6bd,1,7,7,14,7,2014-02-06 07:05:26,2014-02-06 07:05:26
2b536f309fae3fddf8ffebbffdf2e90e0c9bb6bd...951b07c7c0b51918cfe43b5640f918c959f29deb,3,14,1,15,4,2014-02-06 07:06:18,2014-02-06 07:06:18
951b07c7c0b51918cfe43b5640f918c959f29deb...41113920c2b686d67357c3835db1135ff35dae5d,1,25,0,25,1,2014-02-06 07:34:39,2014-02-06 07:34:39
41113920c2b686d67357c3835db1135ff35dae5d...e055347a6f4c96f876e7d0b813b63f4f6742dc61,1,1,1,2,1,2014-02-06 07:35:57,2014-02-06 07:35:57
e055347a6f4c96f876e7d0b813b63f4f6742dc61...31bc21f96f3b9b46824f610f94940c3d4139f545,4,22,32,54,21,2014-02-07 04:24:58,2014-02-07 04:21:01
31bc21f96f3b9b46824f610f94940c3d4139f545...ef56dfa514bdadff75220d5e327ffe6adb8c4dd6,1,37,43,80,6,2014-02-07 06:50:45,2014-02-07 06:50:45
1ec9b1da710da0fe7fe52a1569556017e782e4b4...ad99de94569dcb191a09076ae97a7523649fc909,2,32,0,32,2,2013-12-13 18:29:57,2013-12-13 18:29:45
ad99de94569dcb191a09076ae97a7523649fc909...adcc85b50adaeba9fa6f413cad638822a007a949,2,2,0,2,2,2013-12-13 22:47:19,2013-12-13 22:47:19
adcc85b50adaeba9fa6f413cad638822a007a949...5bd19e7c77a0d4cf9d9e7f2de11ac384407ab971,1,9,3,12,5,2013-12-13 22:52:31,2013-12-13 22:52:21
5bd19e7c77a0d4cf9d9e7f2de11ac384407ab971...8436e2435fc90f0afcd9793e515c044a11758b0a,2,20,12,32,3,2013-12-13 23:33:09,2013-12-13 23:32:03
8436e2435fc90f0afcd9793e515c044a11758b0a...43ce351eaea6bd9c0a802fe937f100a607134caa,2,50,2,52,3,2013-12-14 00:32:32,2013-12-14 00:32:32
43ce351eaea6bd9c0a802fe937f100a607134caa...a68b04e02d2e9f53ac6f19e6cc38d84095e98c2d,1,1,0,1,1,2013-12-14 01:19:04,2013-12-14 01:18:53
a68b04e02d2e9f53ac6f19e6cc38d84095e98c2d...f53e1a74d62976bcf20445d643a5403fd1f753f1,1,30,4,34,6,2013-12-14 01:33:57,2013-12-14 01:33:47
f53e1a74d62976bcf20445d643a5403fd1f753f1...43beb6ff3b07f938938a5065ed353c1a0e1d5599,1,5,1,6,2,2013-12-14 01:42:46,2013-12-14 01:42:46
43beb6ff3b07f938938a5065ed353c1a0e1d5599...b482c449d30f65ce2859e16d04eb28b123cc1fe3,3,26,0,26,3,2013-12-14 01:51:20,2013-12-14 01:47:50
b482c449d30f65ce2859e16d04eb28b123cc1fe3...4498cd9de82d6d0a8384f80d7c262bc7b41ed884,2,64,1,65,2,2013-12-16 18:40:01,2013-12-16 18:29:31
4498cd9de82d6d0a8384f80d7c262bc7b41ed884...14866d7568869e2c668680c2d4d472c3512ee74f,7,49,44,93,17,2013-12-16 23:17:00,2013-12-16 23:17:00
14866d7568869e2c668680c2d4d472c3512ee74f...1af05181e47fcf2e3630389091a0c37e429e2d85,1,37,0,37,1,2013-12-16 23:30:37,2013-12-16 23:30:37
1af05181e47fcf2e3630389091a0c37e429e2d85...784a2b7b2f696cbd5417634e8e73e8b91dca140e,1,2,1,3,1,2013-12-17 00:07:41,2013-12-17 00:03:48
784a2b7b2f696cbd5417634e8e73e8b91dca140e...bca3b7563e7d35963273f3022989b60fd2f454ac,1,2,2,4,1,2013-12-17 00:23:13,2013-12-17 00:23:13
3590eb134595bf4a37c879cff319f4fb2f01ea77...ab59ae2bcba622e8faa10e70ca2cc1c9d72fdc29,1,4,0,4,1,2013-09-29 01:53:40,2013-09-29 01:53:40
6582a8860815a10af79cb888be96b58792f4c5e4...18704dccaaf233392772f2a2c7575b1cea2f57d8,1,2,2,4,1,2013-12-04 18:40:49,2013-12-04 18:40:25
18704dccaaf233392772f2a2c7575b1cea2f57d8...a3abdfe8f9faed12536f6a02286a9be48056a9ff,1,1,2,3,2,2013-12-05 05:27:06,2013-12-05 05:27:06
a3abdfe8f9faed12536f6a02286a9be48056a9ff...43648de7e54d557ad032f3f4eb4ec3dbf1c4bc93,1,2,2,4,2,2013-12-05 06:05:28,2013-12-05 06:05:28
8a4b58d987f3cc464e054e32598eabb6974fd341...77b5631f4256d41e1b19fba8e3bcaa2ef3b74881,3,95,95,190,3,2013-12-03 03:17:36,2013-11-08 00:31:14
77b5631f4256d41e1b19fba8e3bcaa2ef3b74881...254d7695bc2d644027be0588fba54c1ddf13d287,1,51,34,85,5,2013-12-03 03:17:36,2013-11-08 00:32:57
254d7695bc2d644027be0588fba54c1ddf13d287...132221262c5a08605f806cd809c594f287b9880a,1,63,33,96,7,2013-12-03 03:17:36,2013-11-04 20:38:05
132221262c5a08605f806cd809c594f287b9880a...0ee8f954522dd0728c947f3375d811b312676d5a,1,17,0,17,1,2013-12-03 03:17:37,2013-11-04 20:44:13
0ee8f954522dd0728c947f3375d811b312676d5a...5851f19a7a4cb7f78f161c748714b8f652ee6bc6,1,19,11,30,5,2013-12-03 03:17:37,2013-11-04 21:42:01
5851f19a7a4cb7f78f161c748714b8f652ee6bc6...562b9823a821f609edcca83c115d277c84c87354,2,37,6,43,9,2013-12-03 03:17:37,2013-11-04 23:16:05
562b9823a821f609edcca83c115d277c84c87354...31345957225ad2c5489aa4f0273e37ed9f1bf892,1,84,0,84,1,2013-12-03 03:17:37,2013-11-04 23:16:34
31345957225ad2c5489aa4f0273e37ed9f1bf892...3bf1e6a1a8a51085f4418b041da04ccf6e9bf8cc,2,3,3,6,2,2013-12-03 03:17:37,2013-11-04 23:52:17
3bf1e6a1a8a51085f4418b041da04ccf6e9bf8cc...24d1b31f52ad5c837d6e6b93298920f455b1de0e,1,6,5,11,6,2013-12-03 03:17:37,2013-11-04 23:52:35
24d1b31f52ad5c837d6e6b93298920f455b1de0e...ba674e98e887d6c9abbd5203fa8f34b28f62ab76,1,95,1,96,1,2013-12-03 03:17:37,2013-11-04 23:52:49
ba674e98e887d6c9abbd5203fa8f34b28f62ab76...13a98748a186d2534fd0bf742f9c620460b44912,1,16,7,23,4,2013-12-03 03:17:37,2013-11-05 01:46:52
13a98748a186d2534fd0bf742f9c620460b44912...c1268579685485666a67b46a2eb540f82224712f,1,15,13,28,6,2013-12-03 03:17:38,2013-11-05 02:13:13
c1268579685485666a67b46a2eb540f82224712f...3a8c36e1de4ef43836d4802425a8519360544361,1,28,1,29,4,2013-12-03 03:17:38,2013-11-06 02:25:58
3a8c36e1de4ef43836d4802425a8519360544361...afb2aaece7af64a24354e01b675acff583636732,1,1,3,4,2,2013-12-03 03:17:38,2013-11-06 02:29:03
afb2aaece7af64a24354e01b675acff583636732...74c9373d3ab26975671b2560101d97ede5a006f5,2,37,0,37,2,2013-12-03 03:17:38,2013-11-11 19:43:06
74c9373d3ab26975671b2560101d97ede5a006f5...b1f8930630f12f0bed03032a0136670506158f65,1,1,1,2,1,2013-12-03 03:17:38,2013-11-11 19:43:41
b1f8930630f12f0bed03032a0136670506158f65...a39ce59c355af0de1abfeab31db6e60f550f1405,1,22,0,22,2,2013-12-03 03:17:38,2013-11-11 19:54:43
a39ce59c355af0de1abfeab31db6e60f550f1405...891e3324eab57ab7abb4678141cf16bb759c2ef9,1,3,4,7,4,2013-12-03 03:17:38,2013-11-20 00:13:11
891e3324eab57ab7abb4678141cf16bb759c2ef9...a8fd4eefb5319a3392ed89041f9f4c639315b15b,2,2,2,4,2,2013-12-03 03:17:39,2013-11-20 00:14:15
a8fd4eefb5319a3392ed89041f9f4c639315b15b...d5ea98799d381051d70e5810fbcdce8c0aeb05c0,1,36,0,36,2,2013-12-03 03:17:39,2013-11-20 00:19:17
d5ea98799d381051d70e5810fbcdce8c0aeb05c0...cc260af22d927d201797faa16382c732564181a5,1,9,1,10,2,2013-12-03 03:17:39,2013-11-20 00:46:08
cc260af22d927d201797faa16382c732564181a5...b3cd37af59fc48b1b22e5c08d4c3ed05af782a4e,1,4,4,8,3,2013-12-03 03:17:39,2013-11-20 02:12:33
bfb8fd34a96e4763194bdbb911c031950dea7b50...3a267f1fdca0b4978af6ae077f0c54e05ea2084e,1,4,3,7,1,2013-08-04 03:04:16,2013-08-04 03:04:16
c1f8c7f0e52cdbce74d867818f7985a864af5225...70883fdc425d434535bf841bbe39cff12a530ec4,1,0,10,10,1,2013-08-03 00:13:49,2013-08-03 00:13:49
70883fdc425d434535bf841bbe39cff12a530ec4...ce73cfaa7ac7471c096a2e71aa4e553175a2c116,4,4,4,8,4,2013-08-03 01:15:29,2013-08-03 01:15:29
ce73cfaa7ac7471c096a2e71aa4e553175a2c116...cd5044b6f368611edaeda5a5210681318a5a89a8,2,2,2,4,2,2013-08-03 01:17:38,2013-08-03 01:17:38
cd5044b6f368611edaeda5a5210681318a5a89a8...997fbf33f67277b98181197969c9c0e66743fabc,2,2,4,6,2,2013-08-03 01:41:15,2013-08-03 01:41:15
997fbf33f67277b98181197969c9c0e66743fabc...f872459c489a7a04d9ea5ee11195c37360ea37da,1,4,2,6,2,2013-08-03 06:19:05,2013-08-03 06:19:05
f872459c489a7a04d9ea5ee11195c37360ea37da...cda92d79fa496c16e67d287ac8360f321411e4af,1,2,0,2,1,2013-08-06 03:18:51,2013-08-06 03:18:51
6e565bf26e13c25b0279274f5fbed90970a4db5d...6decfd43d628b8d29c9c43245270f8c0f3065767,2,5,3,8,3,2013-08-06 19:58:29,2013-07-13 06:37:08
6decfd43d628b8d29c9c43245270f8c0f3065767...9d577ae58c9424c4d698d11229cbc31f24240940,1,3,2,5,2,2013-08-06 19:58:29,2013-08-06 02:51:17
24b153ea857af708cac43a69936272ec3afd5d32...9e318c7a93b3d09d2dbbab26667d36451096704f,1,1,1,2,1,2013-04-02 11:15:22,2013-04-02 11:15:22
9e318c7a93b3d09d2dbbab26667d36451096704f...73100e07ec04681797459d68caf0f302c770119e,1,3,1,4,3,2013-04-02 18:27:25,2013-04-02 18:26:51
73100e07ec04681797459d68caf0f302c770119e...df67b99b3d54d43a60a44048acbdda4bf6326f5b,2,14,8,22,9,2013-04-02 19:31:13,2013-04-02 19:31:13
df67b99b3d54d43a60a44048acbdda4bf6326f5b...1803a5a423121e3daad97d9eabcfd80b30d0d809,1,7,0,7,1,2013-04-02 22:57:09,2013-04-02 22:57:09
1803a5a423121e3daad97d9eabcfd80b30d0d809...895ef390148639c2f48498ae6f42698e9dab77df,2,7,3,10,5,2013-04-03 20:03:00,2013-04-03 20:03:00
895ef390148639c2f48498ae6f42698e9dab77df...7d5c1d72cddb4e1f56495df0ab0cdf49834c0fc8,1,4,1,5,2,2013-04-03 20:29:09,2013-04-03 20:29:09
7d5c1d72cddb4e1f56495df0ab0cdf49834c0fc8...3f73d8545e396192bd666af19ec2628287b9144c,4,19,1,20,4,2013-04-03 23:18:28,2013-04-03 23:18:28
3f73d8545e396192bd666af19ec2628287b9144c...974583d9a61ceae90c394d30683fcc19cbe8257b,5,5,5,10,5,2013-04-04 00:00:32,2013-04-04 00:00:32
974583d9a61ceae90c394d30683fcc19cbe8257b...0b83b4b08f6d2143bc50a9e330e602158ae23b05,1,5,8,13,3,2013-04-04 02:56:06,2013-04-04 02:56:06
0b83b4b08f6d2143bc50a9e330e602158ae23b05...643f5fac051099b6df4b241bcba106d0d9345891,5,16,3,19,5,2013-04-04 04:14:25,2013-04-04 04:14:25
643f5fac051099b6df4b241bcba106d0d9345891...bb9e78f562d1b93a82bb8ca254d3714f82abb677,1,1,1,2,1,2013-04-04 04:16:23,2013-04-04 04:16:23
bb9e78f562d1b93a82bb8ca254d3714f82abb677...2ab85a16c38d94bf67757874c8bd227762413678,1,3,0,3,1,2013-04-04 04:39:27,2013-04-04 04:39:27
0b61d878dac178f616dd1c9ecb0b47887aa2238f...b464ebcd60d761541db4139699dc5a6f2b103994,1,53,111,164,19,2013-04-02 05:59:56,2013-04-02 05:59:56
b464ebcd60d761541db4139699dc5a6f2b103994...36c00427ca09a14bf776448f7015f281fff676ec,1,1,1,2,1,2013-04-02 21:53:10,2013-04-02 21:53:10
36c00427ca09a14bf776448f7015f281fff676ec...fa5770ec7410170e95ae9d6fd3a6d785a95fdbd6,4,143,118,261,7,2013-04-03 00:24:47,2013-04-03 00:24:47
6940c9837cdc666fd64910cc89c400ee1846471b...3dfcb42eac34f40b6611a0a0a780b9210467ccb2,1,6,3,9,2,2014-06-03 16:58:39,2014-06-03 00:33:26
3dfcb42eac34f40b6611a0a0a780b9210467ccb2...a2d8a975bc83c0c9ec5128d5b97fc1c2b1ae5af9,1,16,12,28,6,2014-06-03 23:54:56,2014-06-03 23:54:56
2a8da041e7771a0b09034aed3faa7ee38a6c8f76...f65451e196b4115034e01a2c75d8c4b902fb310b,3,15,9,24,9,2014-06-11 00:28:17,2014-06-03 23:56:46
f65451e196b4115034e01a2c75d8c4b902fb310b...89d8f411567e43b398b3334966f3708c3895288a,1,72,11,83,3,2014-06-11 03:59:19,2014-06-11 03:59:19
89d8f411567e43b398b3334966f3708c3895288a...5e0c9923d441bef51f208db49b1f2c9debd90381,2,13,2,15,10,2014-06-11 04:10:50,2014-06-11 04:10:50
902de60d486934820a7e18e77017fc7e888b7ea6...af2387808a32cacb9f137d62796944807e5bc066,2,15,10,25,4,2014-08-05 20:31:06,2014-08-05 20:29:38
3ad5ff6c9091aae3624e3e4ced2d0fc6d0d8e067...19e0f116dac92a8721237e00fc465cda821094a1,1,3,1,4,2,2014-07-30 21:03:14,2014-07-30 16:30:31
3ad5ff6c9091aae3624e3e4ced2d0fc6d0d8e067...33eee2c25acc353d5ca6922e56c782d4cee2a9cc,1,1,5,6,2,2014-07-30 16:37:48,2014-07-30 16:37:48
33eee2c25acc353d5ca6922e56c782d4cee2a9cc...dd82a8bcd55af2f1fda8b6b9c67f757ff180ad4f,1,1,0,1,1,2014-07-30 16:38:30,2014-07-30 16:38:30
dd82a8bcd55af2f1fda8b6b9c67f757ff180ad4f...c3508acc07a60c3fb07770cb608792d0766c53d0,4,53,5,58,8,2014-07-30 21:36:20,2014-07-29 16:44:12
c3508acc07a60c3fb07770cb608792d0766c53d0...4e6efe91a5fa390da56708e11af34b54f7ce784d,1,71,1,72,9,2014-07-30 21:37:00,2014-07-29 16:44:50
4e6efe91a5fa390da56708e11af34b54f7ce784d...3163112235b3d294bca151b2477ceab71a41f402,1,9,1,10,1,2014-07-30 21:37:11,2014-07-29 16:47:11
3163112235b3d294bca151b2477ceab71a41f402...706fc7ebe77afc60a5b5967f753c4f16761b1a39,3,12,1,13,6,2014-07-30 21:37:18,2014-07-29 16:49:03
706fc7ebe77afc60a5b5967f753c4f16761b1a39...812a3af2cd0b44cb5f4e9192ead1b7dd0c252208,1,26,5,31,6,2014-07-30 21:37:27,2014-07-29 16:50:15
812a3af2cd0b44cb5f4e9192ead1b7dd0c252208...f2184d3dbe47a3be0e7edc09df73ddaeef05da81,1,9,4,13,4,2014-07-30 21:43:19,2014-07-30 18:55:10
5da79a13d61179ab13bcfe3be77c6057a2357c4e...b249f77b21fc2d3b79bbe4f7733a3b9186ee0102,1,4,0,4,1,2014-06-24 05:28:01,2014-06-24 04:59:28
b249f77b21fc2d3b79bbe4f7733a3b9186ee0102...da356dad0f7b621aab4c2b34f287aeaca798b425,1,1,1,2,1,2014-06-24 15:33:02,2014-06-24 15:33:02
da356dad0f7b621aab4c2b34f287aeaca798b425...53c3143285e035dd3039ff92323f68ce5f9c59df,1,4,0,4,1,2014-06-24 16:29:52,2014-06-24 16:29:52
53c3143285e035dd3039ff92323f68ce5f9c59df...9a100f0dcaf6ad65490042aa5287f0d534b790f1,1,1,1,2,1,2014-06-25 04:21:35,2014-06-25 04:21:35
9a100f0dcaf6ad65490042aa5287f0d534b790f1...6d2408f52b174372294f8e1584acb3a24f83e467,1,7,0,7,1,2014-06-25 21:56:37,2014-06-25 21:55:01
6d2408f52b174372294f8e1584acb3a24f83e467...8b74a7d253f86fc8e2c102c79aa1b093804cf4b3,1,1,1,2,1,2014-06-26 06:51:33,2014-06-26 06:51:33
5a85e2f24c25abab278b5af2477418c7f7bdfc47...459b1a588e6ead9a001502ea9e3e12b5a2b90915,5,22,16,38,14,2014-06-24 00:10:02,2014-06-24 00:10:02
459b1a588e6ead9a001502ea9e3e12b5a2b90915...25222d727eaf0af67aed838e001defc6ceffa73b,1,2,1,3,1,2014-06-24 03:09:20,2014-06-24 03:09:20
25222d727eaf0af67aed838e001defc6ceffa73b...a8b9087807490a255c088a0af9aafc80524dddae,1,4,4,8,4,2014-06-24 05:24:44,2014-06-24 02:35:44
a8b9087807490a255c088a0af9aafc80524dddae...98bd2895fa1c41199b35611828e7f9e136991c9d,1,1,0,1,1,2014-06-24 05:24:44,2014-06-24 02:43:59
98bd2895fa1c41199b35611828e7f9e136991c9d...e0852a59285bc2a6c831a80e8d18eff5d5db05fc,9,23,26,49,26,2014-06-24 05:24:44,2014-06-24 02:54:13
e0852a59285bc2a6c831a80e8d18eff5d5db05fc...6219e299d55f52f5b5f05139d25d031ac1d4ef69,1,1,1,2,1,2014-06-24 05:24:44,2014-06-24 04:13:54
6219e299d55f52f5b5f05139d25d031ac1d4ef69...5cbba1c5067605288521d4697407442f7fcc6255,1,1,1,2,1,2014-06-24 05:24:44,2014-06-24 04:14:05
5cbba1c5067605288521d4697407442f7fcc6255...14aa7c4bf4aa7d364e1faafd55244b8cb91a047d,1,7,1,8,1,2014-06-24 05:24:45,2014-06-24 04:14:29
14aa7c4bf4aa7d364e1faafd55244b8cb91a047d...90539864eaede199f2960620b2256bba146e55e1,1,4,0,4,1,2014-06-24 05:24:45,2014-06-24 04:59:28
90539864eaede199f2960620b2256bba146e55e1...377235732e52c8bf7b512be589b1d0a39bfb9024,1,1,1,2,1,2014-06-24 05:24:45,2014-06-24 05:08:30
377235732e52c8bf7b512be589b1d0a39bfb9024...867884f3aa41db7472e5d401f029d44f9fb47941,1,1,1,2,1,2014-06-24 05:24:45,2014-06-24 05:09:08
867884f3aa41db7472e5d401f029d44f9fb47941...ef9be46be7e84827696e9c0a025361a038cea57e,1,1,1,2,1,2014-06-24 05:24:45,2014-06-24 05:09:24
ef9be46be7e84827696e9c0a025361a038cea57e...bc7d7be58f06480233f7239bd425a1d20d2f70c3,2,49,25,74,11,2014-06-24 05:24:45,2014-06-24 02:36:48
bc7d7be58f06480233f7239bd425a1d20d2f70c3...b125db06024b97d50a61c1dccf3441ac35410ca2,1,11,1,12,2,2014-06-24 05:43:46,2014-06-24 05:43:46
b125db06024b97d50a61c1dccf3441ac35410ca2...1beb5ffe0955f6dd46eabcecd80c8584120df50e,2,1,3,4,2,2014-06-24 22:12:33,2014-06-24 22:12:33
1beb5ffe0955f6dd46eabcecd80c8584120df50e...7f4cc3299acab417290805ba0ac64684630b229d,1,1,1,2,1,2014-06-24 22:20:44,2014-06-24 22:20:44
7f4cc3299acab417290805ba0ac64684630b229d...2db65c09a74196ef7a660f5e0f822635d811d1f1,1,1,5,6,2,2014-06-24 22:50:26,2014-06-24 21:48:03
2db65c09a74196ef7a660f5e0f822635d811d1f1...2df9602911cc5f30f67c8e0f6a11bdbf6ee381c1,1,12,21,33,2,2014-06-24 22:58:19,2014-06-24 22:51:15
2df9602911cc5f30f67c8e0f6a11bdbf6ee381c1...cffc1ed1ccaf65d4ad520484c7abf8026af8aefd,2,6,3,9,4,2014-06-24 23:11:30,2014-06-24 23:11:30
cffc1ed1ccaf65d4ad520484c7abf8026af8aefd...5578a57a8ed98c0e8a5a90712224ec99e22dcebd,1,22,16,38,9,2014-06-24 23:21:02,2014-06-24 23:21:02
5578a57a8ed98c0e8a5a90712224ec99e22dcebd...c2ccbd5f8bd3f6a1b7bac53acc029d3f39892023,3,17,2,19,4,2014-06-24 23:25:41,2014-06-24 23:25:17
c2ccbd5f8bd3f6a1b7bac53acc029d3f39892023...f7defb2c0d84ad7b8055abbbc5caf10c03c793b7,2,6,1,7,2,2014-06-24 23:28:32,2014-06-24 23:26:00
f7defb2c0d84ad7b8055abbbc5caf10c03c793b7...efc81f242e546bd8784ebe60831a171303a5d288,1,1,0,1,1,2014-06-24 23:30:25,2014-06-24 23:29:27
efc81f242e546bd8784ebe60831a171303a5d288...6283a7e89bae2b9fb5419b999f753a5a92d7f943,1,14,0,14,3,2014-06-24 23:38:06,2014-06-24 23:38:06
6283a7e89bae2b9fb5419b999f753a5a92d7f943...4a5023501482928987524107ef8b4a11faeb7610,1,18,0,18,1,2014-06-24 23:49:19,2014-06-24 23:49:19
4a5023501482928987524107ef8b4a11faeb7610...9a9c8dc3dbf808f64121637e65aaea5c0549df8c,1,14,4,18,6,2014-06-25 00:22:44,2014-06-24 23:27:05
9a9c8dc3dbf808f64121637e65aaea5c0549df8c...d0d5805cb6ea288a391bc9534148ba33d7ca0edc,2,9,16,25,10,2014-06-25 00:22:59,2014-06-25 00:18:25
d0d5805cb6ea288a391bc9534148ba33d7ca0edc...860261d62cb22dd7a2e9eaa63ab7c624e19f54c6,1,17,13,30,2,2014-06-25 00:22:59,2014-06-25 00:19:23
860261d62cb22dd7a2e9eaa63ab7c624e19f54c6...1d97cf70e418a1fdc0f0ada92915494c1b55cea7,1,1,1,2,1,2014-06-25 00:22:59,2014-06-25 00:20:05
1d97cf70e418a1fdc0f0ada92915494c1b55cea7...e1129710a7b967a5fad7819b917e8da915fec027,1,1,10,11,3,2014-06-25 00:22:59,2014-06-25 00:20:59
e1129710a7b967a5fad7819b917e8da915fec027...2ea86e8ef7bd3ade44ee860c51a29a8d96bd2ae3,1,10,5,15,3,2014-06-25 00:52:09,2014-06-25 00:51:49
2ea86e8ef7bd3ade44ee860c51a29a8d96bd2ae3...946eaae045ef277a3e05756e23f05b5fe8170cfc,1,9,3,12,2,2014-06-25 01:03:50,2014-06-25 01:03:50
946eaae045ef277a3e05756e23f05b5fe8170cfc...d212a629a90a197876a4fbf4dbef1e941b8100f4,1,1,2,3,1,2014-06-25 01:24:49,2014-06-25 01:24:49
d212a629a90a197876a4fbf4dbef1e941b8100f4...7920d77249b75d704530dac58c14b1c92f27a76d,1,1,1,2,1,2014-06-25 02:19:25,2014-06-25 02:18:18
7920d77249b75d704530dac58c14b1c92f27a76d...a8676061e54abd396c7b4e55a78124322d29591d,2,18,13,31,8,2014-06-25 03:13:07,2014-06-25 03:02:51
095b3a26c6365011aa3fcad56bb23dfd462016ad...1c42080ab358d957d0c2ba7ad967b9d91ce4c831,1,9,5,14,5,2014-06-23 22:04:10,2014-06-23 22:04:10
1c42080ab358d957d0c2ba7ad967b9d91ce4c831...87123cc63a9acba64856216e09e5f0367e962699,6,2,16,18,6,2014-06-23 22:13:00,2014-06-23 22:13:00
87123cc63a9acba64856216e09e5f0367e962699...d16e94945e9114ba3831aed2240f5b03db28a25a,4,74,24,98,18,2014-06-23 22:58:07,2014-06-23 22:58:07
d16e94945e9114ba3831aed2240f5b03db28a25a...ed862ddc2e3a516d8d5e451962df22b210760b02,2,55,22,77,22,2014-06-23 23:25:45,2014-06-23 23:25:45
ed862ddc2e3a516d8d5e451962df22b210760b02...8b747e60c9110d7b528ee61192dc938b9c5b997b,1,70,74,144,7,2014-06-23 23:47:15,2014-06-23 23:47:15
8b747e60c9110d7b528ee61192dc938b9c5b997b...a5b51c4f599669d176c7c7fd9666fa59b5ed9e62,1,2,0,2,1,2014-06-23 23:51:06,2014-06-23 23:51:06
a5b51c4f599669d176c7c7fd9666fa59b5ed9e62...d2e8596bb2519e4ffe9da6d4956ba968c0f79beb,1,290,277,567,19,2014-06-24 00:54:01,2014-06-24 00:54:01
2e02a19ac5e220b1f00e1185f35e162a3c74eb96...d40889aff9c3ddd5f1bb87f70898337543517943,1,0,2,2,1,2014-05-20 17:06:55,2014-05-20 17:06:55
d40889aff9c3ddd5f1bb87f70898337543517943...c0491e2aa72e305d65c05a13db3f23280fffb6b9,1,4,0,4,1,2014-05-20 17:08:04,2014-05-20 17:08:04
c0491e2aa72e305d65c05a13db3f23280fffb6b9...cad083107cc5abfe448eff5bc314466c4c07008a,1,6,0,6,1,2014-05-20 17:10:38,2014-05-20 17:10:38
cad083107cc5abfe448eff5bc314466c4c07008a...0a4b7b55cc80ef6099b6b5e093736f773aa3e20a,1,1,0,1,1,2014-05-20 18:38:05,2014-05-20 18:38:05
5fe931056b810359922311a4dcc218d198da5044...758a2d260ebf4c14593243e047f62a7bcfe4b5ec,1,4,0,4,1,2014-05-12 20:53:38,2014-05-12 20:53:38
5fe931056b810359922311a4dcc218d198da5044...b8ef9b24184477cd72e72e3c65e6377dd47df943,2,8,2,10,3,2014-05-12 18:41:14,2014-05-12 18:41:14
bea8e9c5d083ff353334dd5211b2a7e4d051da67...965e3f6dec71241bdb3bff5ae3dd25e4b9e611b6,1,2,0,2,1,2014-04-30 18:46:12,2014-04-30 18:46:12
bea8e9c5d083ff353334dd5211b2a7e4d051da67...cb6113170f251d8e679f48c13f434ecd78ddecf9,11,151,27,178,34,2014-04-30 17:08:16,2014-04-25 04:46:33
8ece3d7eac5c20904fb8580c5b7117ef8626e78f...51858c10d018d202290d00922dd3aa3086f33576,3,15,8,23,7,2014-06-06 19:27:48,2014-06-06 19:27:16
51858c10d018d202290d00922dd3aa3086f33576...bcbd3b3810b6fe15e70e3197cbf9830a585d2621,1,27,13,40,7,2014-06-06 19:30:18,2014-06-06 19:29:57
e4000c6808215d6eb614326e61ff6163248f6a89...9c177fbecce69a4f8ea472de20857220ab934437,1,2,2,4,2,2014-05-13 00:14:32,2014-05-13 00:14:32
9c177fbecce69a4f8ea472de20857220ab934437...552fc249f22b23f2e4bbb384b3ecb0b13e18d865,1,1,1,2,1,2014-05-13 00:21:16,2014-05-13 00:21:16
552fc249f22b23f2e4bbb384b3ecb0b13e18d865...add4b7363a5c22fc6316b3f7cbe96139c292a3c2,1,4,0,4,1,2014-05-13 00:24:50,2014-05-13 00:24:50
add4b7363a5c22fc6316b3f7cbe96139c292a3c2...de2a13a99fee6ba7e563b788e7b7b3882fecc52e,4,41,53,94,23,2014-05-13 00:30:15,2014-05-13 00:30:15
de2a13a99fee6ba7e563b788e7b7b3882fecc52e...ce73d8855b22e7eddf5c56116b004607ca173798,5,147,135,282,15,2014-05-13 01:05:13,2014-05-13 01:05:13
ce73d8855b22e7eddf5c56116b004607ca173798...3f7c958329e9539c74b3f0b698be37558517a34e,1,7,0,7,3,2014-05-13 01:05:34,2014-05-13 01:05:34
3f7c958329e9539c74b3f0b698be37558517a34e...932504917252e9d1ea827ae68fe574e6f23ce142,1,3,1,4,1,2014-05-13 02:05:29,2014-05-13 02:04:21
932504917252e9d1ea827ae68fe574e6f23ce142...dd983629200e77d6b5cedce6e2da7dda67d7a61e,1,161,0,161,1,2014-05-13 02:05:29,2014-05-13 02:04:44
dd983629200e77d6b5cedce6e2da7dda67d7a61e...81724216c8de09df5ac615097af0e9a03a55c1bf,1,1,1,2,1,2014-05-13 18:44:14,2014-05-13 18:44:14
9b2c11f9ced05f25a94ff17510b3dfa220247dc5...7339d0e33f3c812d1b230faa489c154c32c2feb8,4,34,28,62,18,2014-05-21 19:38:17,2014-05-21 19:38:17
7339d0e33f3c812d1b230faa489c154c32c2feb8...6f3504a2d3739debcbc9cc4c0afcce8b94e07f5d,12,517,346,863,89,2014-05-21 22:42:12,2014-05-21 22:42:12
6f3504a2d3739debcbc9cc4c0afcce8b94e07f5d...f70099c992c257ca01be0207e44804c0457e26af,4,12,15,27,9,2014-05-22 00:41:18,2014-05-22 00:41:18
f70099c992c257ca01be0207e44804c0457e26af...9e04e2dc3503dc2a64c1d77aa4b40afaae7ea912,7,266,134,400,78,2014-05-23 21:07:48,2014-05-23 21:07:48
9e04e2dc3503dc2a64c1d77aa4b40afaae7ea912...b0b40a2dce26826a310d2a04efaf213a304ce323,2,31,42,73,10,2014-05-23 22:16:42,2014-05-23 22:16:42
b0b40a2dce26826a310d2a04efaf213a304ce323...e49818458b119a89bea29f34c5a477ff3fc70f3a,1,63,11,74,16,2014-05-23 23:16:31,2014-05-23 23:16:31
e49818458b119a89bea29f34c5a477ff3fc70f3a...209fa3a59bf5de0899cb8a796eccff40a20b8bf5,4,38,26,64,18,2014-05-26 02:13:15,2014-05-26 02:13:15
209fa3a59bf5de0899cb8a796eccff40a20b8bf5...264d9d803984e7e10748b11ccd0bf721fa673fc6,1,31,60,91,13,2014-05-26 02:29:00,2014-05-26 02:29:00
264d9d803984e7e10748b11ccd0bf721fa673fc6...e71782a5983884a2d9e494b83b121d14cf33cbb7,2,76,97,173,22,2014-05-26 03:00:28,2014-05-26 03:00:28
e71782a5983884a2d9e494b83b121d14cf33cbb7...05bb7e40017fddfd62d3461c5a3bd55770837050,2,17,9,26,3,2014-05-26 03:13:40,2014-05-26 03:13:40
05bb7e40017fddfd62d3461c5a3bd55770837050...38b2d0a5146f8fcd13ff385ab7741d98132442f3,1,0,1,1,1,2014-05-26 03:33:38,2014-05-26 03:33:38
38b2d0a5146f8fcd13ff385ab7741d98132442f3...c02ebfbd4824eca36eeac3aa20a9c62126b230a0,2,15,14,29,8,2014-05-26 04:10:17,2014-05-26 04:10:17
c02ebfbd4824eca36eeac3aa20a9c62126b230a0...5f10cb37a2c7949d3743e205d377d99ed6335c2c,3,11,37,48,12,2014-05-26 04:44:09,2014-05-26 04:44:09
5f10cb37a2c7949d3743e205d377d99ed6335c2c...f562c1f3b899bcaabeb7896e49d4e90124998f04,1,62,60,122,10,2014-05-27 17:01:41,2014-05-27 17:01:41
f562c1f3b899bcaabeb7896e49d4e90124998f04...5f8b1be152c4c4b4a2f8130e0c211a0cd0a300ca,3,421,329,750,27,2014-05-27 19:17:57,2014-05-27 19:17:57
5f8b1be152c4c4b4a2f8130e0c211a0cd0a300ca...b97f7c5a768eca41ea9a3dcb392e44cd5d91747e,12,107,75,182,54,2014-05-27 23:07:43,2014-05-27 23:07:43
b97f7c5a768eca41ea9a3dcb392e44cd5d91747e...f8442fd356b9d07e9892b461a0d1480cb94469ca,1,43,50,93,16,2014-05-27 23:26:07,2014-05-27 23:26:07
9b2c11f9ced05f25a94ff17510b3dfa220247dc5...8bc973364526449a94d9bde16c099cd1617bf80e,3,78,30,108,16,2014-05-20 18:51:46,2014-05-20 18:51:46
8bc973364526449a94d9bde16c099cd1617bf80e...fa280a364dd8e58ab9be0b799373ef0d7db54e1f,2,80,67,147,16,2014-05-20 22:38:53,2014-05-20 22:38:53
fa280a364dd8e58ab9be0b799373ef0d7db54e1f...84e7342e82f399b5a2841158360b8b328b92d505,4,36,27,63,19,2014-05-21 00:08:44,2014-05-21 00:08:44
84e7342e82f399b5a2841158360b8b328b92d505...5954086e7ad20c62ee5409c29af497e8c9f2e539,1,0,5,5,3,2014-05-21 01:33:13,2014-05-21 01:33:13
5954086e7ad20c62ee5409c29af497e8c9f2e539...8bdcdbc518d1484b7bd89b039b687a9e944aeb9f,10,216,126,342,30,2014-05-21 01:58:15,2014-05-21 01:58:15
a9a6d199b34aa44e1b382708717498f692a92525...5504a01076a9729e8740df4194a2a0e7f8eeb609,4,93,3,96,13,2014-04-18 18:59:52,2014-04-17 21:03:12
5504a01076a9729e8740df4194a2a0e7f8eeb609...9f543d4d03a416b94a1e8e5bdfbb3d7ef2257ced,43,759,0,759,43,2014-04-22 01:16:31,2014-04-22 01:16:31
9f543d4d03a416b94a1e8e5bdfbb3d7ef2257ced...29f221691932c8cb503495f7a342ef30eeb8b0df,21,567,86,653,77,2014-04-22 02:02:30,2014-04-22 02:02:30
29f221691932c8cb503495f7a342ef30eeb8b0df...1f3daac20c18b28ac9af618acc96d9a164b99b01,28,1027,0,1027,28,2014-04-22 02:03:09,2014-04-22 02:03:09
1f3daac20c18b28ac9af618acc96d9a164b99b01...7e97bef5aafee657b6a8bbcf0212088f30713e15,6,56,100,156,43,2014-04-22 20:11:48,2014-04-22 20:11:48
7e97bef5aafee657b6a8bbcf0212088f30713e15...5fa2ba7df67425f60c5975e621d5f727f1d82edf,8,60,67,127,14,2014-04-22 21:42:38,2014-04-22 21:42:38
5fa2ba7df67425f60c5975e621d5f727f1d82edf...ca2f2d54e5b73d691611ae50a24ae92f31c180de,3,22,38,60,13,2014-04-23 22:35:20,2014-04-23 22:35:20
21e7c961b422010755ddfba9899c96c7eae28e9b...ac9d47040e2782b76343fdcdbebdca8635dfa036,2,16,13,29,9,2014-03-15 01:00:48,2014-03-15 01:00:48
ac9d47040e2782b76343fdcdbebdca8635dfa036...4e19bf5e1d3e195e6fe54bdccfb4e6ddc0bd5c8c,1,1,1,2,1,2014-03-15 01:50:48,2014-03-12 20:17:27
4e19bf5e1d3e195e6fe54bdccfb4e6ddc0bd5c8c...85c7fa93e6940e2b524aaf1511fc34cd516041c5,1,1,1,2,1,2014-03-15 01:50:48,2014-03-12 20:53:08
85c7fa93e6940e2b524aaf1511fc34cd516041c5...ff8abb4b0467b808e64a66ecc0e50d2a01335c8c,7,17,0,17,12,2014-03-15 01:50:48,2014-03-12 20:55:26
ff8abb4b0467b808e64a66ecc0e50d2a01335c8c...70689568f6282d3b4959ff627dfbef6cc80bffbf,1,4,3,7,1,2014-03-15 01:50:48,2014-03-15 01:48:19
21e7c961b422010755ddfba9899c96c7eae28e9b...a582b516c42fca03938f232e3463a4ab02386c12,1,1,1,2,1,2014-03-15 00:59:34,2014-03-12 20:17:27
a582b516c42fca03938f232e3463a4ab02386c12...45cfbff4a6e783fdd40913b088b6ec84029477b6,1,1,1,2,1,2014-03-15 00:59:35,2014-03-12 20:53:08
45cfbff4a6e783fdd40913b088b6ec84029477b6...9c7c206beeb5374ef82eebb2b2ef1ff730240e78,7,17,0,17,12,2014-03-15 00:59:35,2014-03-12 20:55:26
9c7c206beeb5374ef82eebb2b2ef1ff730240e78...4f6282da547d41ca6b6fe3db5dc401e41b1243c9,1,4,3,7,1,2014-03-15 01:48:36,2014-03-15 01:48:19
1fcb33e61b68fc0ee5f5504edb88ff11decb6186...a1d1549d778275d829553c509ed7800c5e1701df,2,24,0,24,2,2014-03-23 16:10:04,2014-03-23 16:10:04
a1d1549d778275d829553c509ed7800c5e1701df...480016ea8b92e94a9356ca6c0cf6ef86a935ffe3,2,30,6,36,4,2014-03-23 16:53:53,2014-03-23 16:53:53
50fc8053b11293d83db6f151e76ccfd0097538a0...9e296801ce6eb805241447e26e8e004ec72804a9,4,230,3,233,6,2014-03-12 07:10:31,2014-03-12 07:10:31
9e296801ce6eb805241447e26e8e004ec72804a9...0664f1882535806603709334498a8a056273e8c4,1,141,0,141,2,2014-03-13 02:51:08,2014-03-13 02:51:08
0664f1882535806603709334498a8a056273e8c4...9a629e1cef7278bb694f3a1ead344f6e1f3877ad,2,11,7,18,6,2014-03-13 21:05:32,2014-03-13 21:05:32
9a629e1cef7278bb694f3a1ead344f6e1f3877ad...21a325f2589acafcf4ff3564f329e45ddd4d1572,4,52,213,265,22,2014-03-14 01:50:42,2014-03-14 01:50:42
21a325f2589acafcf4ff3564f329e45ddd4d1572...56f4a5c05ded2ef6989ae23b3d17a0a1ef81d60d,1,11,0,11,1,2014-03-14 21:32:34,2014-03-14 21:32:34
56f4a5c05ded2ef6989ae23b3d17a0a1ef81d60d...c5b250ed141fcb22fa2e21b3223c4537139cf6cf,1,5,1,6,1,2014-03-14 22:16:26,2014-03-14 22:16:26
c5b250ed141fcb22fa2e21b3223c4537139cf6cf...091a7c4a995e36e1b8430b85796bcc3710b0026e,1,2,2,4,2,2014-03-14 22:17:17,2014-03-14 22:17:17
091a7c4a995e36e1b8430b85796bcc3710b0026e...f27ae7bbf79d66def592f379d3cf9383c97632d0,2,65,5,70,8,2014-03-14 22:17:39,2014-03-14 22:17:39
f27ae7bbf79d66def592f379d3cf9383c97632d0...f2d52b129ff7165ac340279b4139d3f55e4a5e10,1,2,1,3,2,2014-03-15 01:51:58,2014-03-15 01:51:58
f2d52b129ff7165ac340279b4139d3f55e4a5e10...7e59359f322001ff41dc0a0584c4f387199eaff1,1,2,0,2,1,2014-03-15 01:52:55,2014-03-15 01:52:55
7e59359f322001ff41dc0a0584c4f387199eaff1...cbdb70cc7e71744a0e8a56591b5e76ea36bca2d5,1,4,0,4,1,2014-03-17 22:47:23,2014-03-17 22:47:23
cbdb70cc7e71744a0e8a56591b5e76ea36bca2d5...06ffd9e90a5040390ac9897e0af9bb6675fbde84,1,26,0,26,1,2014-03-17 22:47:40,2014-03-17 22:47:40
06ffd9e90a5040390ac9897e0af9bb6675fbde84...37645636554fa86452a0f80b5d86ab855985350f,1,59,28,87,10,2014-03-17 22:48:18,2014-03-17 22:48:18
37645636554fa86452a0f80b5d86ab855985350f...8c098d3d39fa075433e0dee28de5748f9a7a7f94,1,3,1,4,2,2014-03-18 01:01:11,2014-03-18 01:01:11
8c098d3d39fa075433e0dee28de5748f9a7a7f94...c841fb2b05a589b1adf9dd9ed63ea5280e4a4afd,1,1,1,2,1,2014-03-18 01:06:41,2014-03-18 01:06:41
c841fb2b05a589b1adf9dd9ed63ea5280e4a4afd...51366473b3e8e7542a1296ed0b735ccb338f352c,1,12,1,13,3,2014-03-18 05:02:43,2014-03-18 05:02:43
51366473b3e8e7542a1296ed0b735ccb338f352c...20927cf7938f67427f0d5ca5ba5f9730e319bbf7,1,5,0,5,1,2014-03-18 05:13:46,2014-03-18 05:13:46
20927cf7938f67427f0d5ca5ba5f9730e319bbf7...5384d192c5ea1a8f48f66d151cc6ff7a595b3cbd,1,5,0,5,1,2014-03-18 18:52:53,2014-03-18 18:52:53
5384d192c5ea1a8f48f66d151cc6ff7a595b3cbd...fa95c1781c28b5041872500e800829e808306b93,2,43,2,45,3,2014-03-18 23:28:26,2014-03-18 23:28:26
fa95c1781c28b5041872500e800829e808306b93...f99c8f0e1d6f70aa8127aeae4ba924d4a7e45729,2,11,7,18,6,2014-03-18 23:41:08,2014-03-18 23:41:08
f99c8f0e1d6f70aa8127aeae4ba924d4a7e45729...76bacdb8b4b915c13b370f0ccbe87845d217e821,1,4,1,5,1,2014-03-19 00:06:20,2014-03-19 00:06:20
76bacdb8b4b915c13b370f0ccbe87845d217e821...8fcc9e41b93b2c5cff9fe26faa821f960988ce9c,1,39,1,40,2,2014-03-19 00:06:39,2014-03-19 00:06:39
8fcc9e41b93b2c5cff9fe26faa821f960988ce9c...cdcdc9f2c43395746af21228c4a1079c18fef7e4,1,1,1,2,1,2014-03-19 00:12:11,2014-03-19 00:12:11
cdcdc9f2c43395746af21228c4a1079c18fef7e4...1dab1ad302ba6ce744bb10210c00f6d5bed97f98,3,12,4,16,4,2014-03-19 00:21:18,2014-03-19 00:21:18
1dab1ad302ba6ce744bb10210c00f6d5bed97f98...651fd17a84fc639cdfdafb5f7192cbf17f16f0a9,1,1,1,2,1,2014-03-19 18:18:36,2014-03-19 18:18:36
651fd17a84fc639cdfdafb5f7192cbf17f16f0a9...820caef3089849e279ab0c5c70524befa82abecf,2,11,1,12,2,2014-03-19 21:38:52,2014-03-19 21:38:52
820caef3089849e279ab0c5c70524befa82abecf...4728d61b8113f6aacbba914038d71ad671f9d1dd,3,104,44,148,11,2014-03-20 01:45:50,2014-03-20 01:45:50
4728d61b8113f6aacbba914038d71ad671f9d1dd...f572bee1f6d71804cc3146bc61931cf180f65b2b,2,23,7,30,7,2014-03-20 02:15:48,2014-03-20 02:15:48
f572bee1f6d71804cc3146bc61931cf180f65b2b...cfd0d1f6782e1f1376172f0aa77abac17a124bba,3,8471,0,8471,3,2014-03-26 21:38:56,2014-03-26 21:38:56
cfd0d1f6782e1f1376172f0aa77abac17a124bba...e10e9cca04446b25ef01d964455afbf7de48fc33,2,33,1,34,6,2014-03-31 20:39:30,2014-03-31 20:39:30
e10e9cca04446b25ef01d964455afbf7de48fc33...37a611eb382ef2d0b6dcbc6b4d829f9b3ec0c9f7,1,2,2,4,1,2014-03-31 20:43:07,2014-03-31 20:43:07
37a611eb382ef2d0b6dcbc6b4d829f9b3ec0c9f7...67365b4ae00db1e741d5b9e52c776ba4d8c64b3c,1,1,1,2,1,2014-03-31 20:48:26,2014-03-31 20:48:26
67365b4ae00db1e741d5b9e52c776ba4d8c64b3c...fc2f068b5729991f7f48781490cb999cce14fb0e,2,24,10,34,10,2014-03-31 21:17:53,2014-03-31 21:17:53
fc2f068b5729991f7f48781490cb999cce14fb0e...54e5e83ec3459d8ea37ffbd3a37ff816cce29e6d,2,24,12,36,7,2014-03-31 21:43:21,2014-03-31 21:43:21
54e5e83ec3459d8ea37ffbd3a37ff816cce29e6d...b2aa2b536c2a69b754ff02430cd27ff8cca17ab7,1,14,1,15,1,2014-03-31 22:32:14,2014-03-31 22:32:14
b2aa2b536c2a69b754ff02430cd27ff8cca17ab7...dcf23ff3cac12b7db880203cc2ee813be1d07a05,2,16,2,18,3,2014-04-01 00:39:41,2014-04-01 00:39:41
dcf23ff3cac12b7db880203cc2ee813be1d07a05...3a6f41438346eb7e3f13708416ae4bfda9e793b5,1,4,1,5,2,2014-04-01 01:00:17,2014-04-01 01:00:17
3a6f41438346eb7e3f13708416ae4bfda9e793b5...a0894315a3934f0774fff085077f1f07adf265d3,1,3,3,6,1,2014-04-02 21:38:55,2014-03-28 20:51:23
a0894315a3934f0774fff085077f1f07adf265d3...a481b3aa33b7b4ab561a30f90455a1171e1de134,2,31,19,50,9,2014-04-02 21:39:55,2014-04-02 21:39:55
a481b3aa33b7b4ab561a30f90455a1171e1de134...894fdd256478c7cc8003185273b47f6ea61bda5a,3,36,16,52,13,2014-04-04 00:48:42,2014-04-04 00:48:42
894fdd256478c7cc8003185273b47f6ea61bda5a...54c53c1a7ea2c7424009545a1e1daa3682aedfba,4,1451,15,1466,10,2014-04-04 23:34:53,2014-04-04 23:34:53
54c53c1a7ea2c7424009545a1e1daa3682aedfba...ea63b0a1d7a64d18df479f4b2a12db8655aa9699,2,16,8,24,4,2014-04-05 00:48:53,2014-04-05 00:48:53
ea63b0a1d7a64d18df479f4b2a12db8655aa9699...9ff5ea82057abb9e135b3eeceecb70af8619813e,4,142,11,153,16,2014-04-05 02:56:15,2014-04-05 02:56:15
9ff5ea82057abb9e135b3eeceecb70af8619813e...07621e3c25d84063741136783e34c79c1981e5de,4,69,28,97,21,2014-04-07 22:16:35,2014-04-07 22:16:35
07621e3c25d84063741136783e34c79c1981e5de...9ccaa5c2e9403e49575e7da4cc5caf031c71dd72,2,11,15,26,7,2014-04-09 02:26:18,2014-04-09 02:26:18
9ccaa5c2e9403e49575e7da4cc5caf031c71dd72...d3686619053bbd54810f6ba661504a56b8288314,1,12,7,19,6,2014-04-09 22:44:03,2014-04-09 22:44:03
d3686619053bbd54810f6ba661504a56b8288314...2a6da0322a3cc1d931e1c28a026e75b0f85a26d0,1,8,3,11,3,2014-04-10 00:28:06,2014-04-10 00:28:06
2a6da0322a3cc1d931e1c28a026e75b0f85a26d0...c6e5435d0a00e52d635aa9f4dc28c72c6e658d44,1,6,9,15,5,2014-04-10 00:33:05,2014-04-10 00:05:40
c6e5435d0a00e52d635aa9f4dc28c72c6e658d44...1e3dfa3c7abc3a71e073c2c4d1b9a393dbd50234,1,5,6,11,2,2014-04-10 00:53:44,2014-04-10 00:53:44
1e3dfa3c7abc3a71e073c2c4d1b9a393dbd50234...4c1bb8f4e51a9f56d57016783a9dcec404c30a5a,1,3,1,4,2,2014-04-10 01:23:11,2014-04-10 01:10:08
4c1bb8f4e51a9f56d57016783a9dcec404c30a5a...b73d670f358ef43ab9a4674f6235c3b0273e1719,1,8,0,8,4,2014-04-16 23:26:06,2014-04-16 23:26:06
50fc8053b11293d83db6f151e76ccfd0097538a0...1669a2bd773089cf0a4dba60da5bd2219805726a,3,20,10,30,9,2014-03-07 22:57:59,2014-03-07 22:57:59
6ca5b987fa45636f0677c0b85515fc2f4da34926...d9d4f2139e13c2ff6f35b5c910c00cc156b2c172,1,4,0,4,1,2014-01-09 06:24:01,2014-01-09 06:24:01
d9d4f2139e13c2ff6f35b5c910c00cc156b2c172...32768a8c057e6871e774aec92351e88cc33e2bd4,1,1,1,2,1,2014-01-09 20:47:14,2014-01-09 20:47:14
c4ee43e67faf7a16603efc005183ecacba55fed7...438ca659169d53ceaa827d9887464e64ad55b083,1,3,0,3,1,2014-01-09 05:44:16,2014-01-09 05:44:16
438ca659169d53ceaa827d9887464e64ad55b083...697b62a06f3a9932c80af6cca3dc4e169aa08a68,1,3,0,3,1,2014-01-13 22:27:35,2014-01-13 22:27:35
c4ee43e67faf7a16603efc005183ecacba55fed7...620d52f76786b2ee8caa48efbcd90921e67ca3c1,4,32,11,43,13,2014-01-08 21:28:20,2014-01-08 21:28:20
990450c2a6afdaa9db3357d0c0414e4a5c0918fb...2907e65e33efabeb1fa1e9ae2abe013206254000,1,1,0,1,1,2014-01-31 19:47:45,2014-01-31 19:47:31
990450c2a6afdaa9db3357d0c0414e4a5c0918fb...bf0fd32754f335b367829bc7bb4fb23a0bafae8a,2,171,138,309,43,2014-01-31 06:20:59,2014-01-31 06:20:10
bf0fd32754f335b367829bc7bb4fb23a0bafae8a...8960b70031d91b09eb63b83e666557878757282f,2,36,33,69,14,2014-01-31 06:57:18,2014-01-31 06:57:18
8960b70031d91b09eb63b83e666557878757282f...13f5d182a3e27954cbcc15ae9269bd667af21111,1,26,21,47,5,2014-01-31 22:50:39,2014-01-31 20:18:31
13f5d182a3e27954cbcc15ae9269bd667af21111...1215b7d10d59d8c1987a4300c1225796ab912a2e,1,1,1,2,1,2014-02-02 21:37:39,2014-02-02 21:37:39
1215b7d10d59d8c1987a4300c1225796ab912a2e...868859428edb96f1f821640ca12504a928635213,1,33,10,43,8,2014-02-02 21:37:57,2014-02-02 21:37:57
0c429763214c6cb7081f67ea4c1ca27681101210...53e87bc58bec1e1c23ecf033f78a6480cc826a2c,4,49,46,95,36,2014-02-14 04:40:43,2014-02-14 04:35:30
53e87bc58bec1e1c23ecf033f78a6480cc826a2c...a3829ab5d8e979b8955b753f86d9e2d1138d1f9f,1,3,4,7,4,2014-02-14 04:41:27,2014-02-14 04:36:54
a3829ab5d8e979b8955b753f86d9e2d1138d1f9f...33da8066ec0c98c9b50ed32809e3242907177502,1,2,0,2,1,2014-02-14 04:42:14,2014-02-14 04:42:14
33da8066ec0c98c9b50ed32809e3242907177502...ccfd57f62754f98c058bec9b356219a5cf664ffe,1,7,11,18,3,2014-02-14 04:43:49,2014-02-14 04:43:49
ccfd57f62754f98c058bec9b356219a5cf664ffe...66a5429fc7d18810a2b9d9d0ab54fa4cdc05c9ca,1,4,4,8,4,2014-02-14 04:46:20,2014-02-14 04:46:20
66a5429fc7d18810a2b9d9d0ab54fa4cdc05c9ca...06ff4d27fbaa017fef658eba66a19a42893be4fd,1,7,6,13,6,2014-02-14 05:11:25,2014-02-14 05:11:25
06ff4d27fbaa017fef658eba66a19a42893be4fd...51e5d197e6a7c8a11d2e61d76a3ecd2bfc7aea46,1,1,1,2,1,2014-02-14 05:20:41,2014-02-14 05:20:41
51e5d197e6a7c8a11d2e61d76a3ecd2bfc7aea46...d5a587cf1c0ee59777683838c3cb99b6a6713ee6,1,4,2,6,2,2014-02-14 05:23:44,2014-02-14 05:23:44
d5a587cf1c0ee59777683838c3cb99b6a6713ee6...eb570e686b40fb4336ac852d8e6cfb572e5ad5f9,1,1,1,2,1,2014-02-14 05:23:59,2014-02-14 05:23:59
eb570e686b40fb4336ac852d8e6cfb572e5ad5f9...e0719ecca23fea1a336ae143454fc752686b1690,3,69,42,111,24,2014-02-14 07:12:43,2014-02-14 07:12:43
f728523599f0156fbd2b60505ed5cce26aaa17bc...6d0348da5d46fa03a63ee651462fd61764eac479,5,63,26,89,17,2014-01-29 06:53:31,2014-01-29 06:53:31
6d0348da5d46fa03a63ee651462fd61764eac479...4676a71af0d2b3f3d012af882cb0a94f95977c92,2,18,6,24,5,2014-01-29 18:30:55,2014-01-29 18:30:55
4676a71af0d2b3f3d012af882cb0a94f95977c92...da3c410f56849c548e594f8d969ac510ac57d74a,1,4,0,4,1,2014-01-29 19:16:29,2014-01-29 19:16:29
1ea406b4f3d85f9893900b80ab0c5d9c0a467146...042fef5af4dd4c41db531352f15457fb90d23628,5,35,150,185,17,2014-02-07 23:03:48,2014-02-07 23:03:48
042fef5af4dd4c41db531352f15457fb90d23628...73090253483576ad05d07058f523ad2cae0677d9,8,0,0,0,0,2014-02-07 23:04:42,2014-02-07 23:04:42
73090253483576ad05d07058f523ad2cae0677d9...1d24565fb5ed6a5571cd6c037f1a60a092be8eaa,1,4,1,5,1,2014-02-10 08:49:15,2014-02-10 08:49:15
1d24565fb5ed6a5571cd6c037f1a60a092be8eaa...bf3e0cdf24818fb64b0958f6f1c7b46b935cc275,4,306,9,315,10,2014-02-20 05:35:46,2014-02-19 19:46:41
bf3e0cdf24818fb64b0958f6f1c7b46b935cc275...ea5050497da1d24194c44c5d27a91e9979e839ba,1,2,2,4,2,2014-02-20 19:50:12,2014-02-20 19:50:12
8bba018bf3515c1c23b4cfea1ab866068a5cc59a...c67aca3dbf44c05d730e574d59932ecc1bea1a6d,1,1,1,2,1,2013-12-17 01:09:57,2013-12-17 01:09:57
c67aca3dbf44c05d730e574d59932ecc1bea1a6d...bedf5a803c71a350f9eba238886f89afd3e98a33,1,9,9,18,9,2013-12-17 02:17:41,2013-12-17 02:17:41
bedf5a803c71a350f9eba238886f89afd3e98a33...daa6f0eb7e1c2396d7a9eae8f77a95e5ceb37399,1,4,1,5,1,2013-12-17 02:24:01,2013-12-17 02:24:01
daa6f0eb7e1c2396d7a9eae8f77a95e5ceb37399...49bc199c95d7003a0239990d4dc69503c8946ca0,2,14,9,23,8,2013-12-17 03:46:35,2013-12-17 03:46:35
49bc199c95d7003a0239990d4dc69503c8946ca0...c463d341d7aeaedb31c5c8b60ad5efd7241b3837,4,4,14,18,4,2013-12-17 04:07:23,2013-12-17 04:01:30
c463d341d7aeaedb31c5c8b60ad5efd7241b3837...cb8c0fc6e1c8c5c21ec96eb68487ec4c7c35da88,2,53,50,103,19,2013-12-17 04:07:23,2013-12-17 04:02:08
cb8c0fc6e1c8c5c21ec96eb68487ec4c7c35da88...3f87154068bf1b9705c6f907c5bc9bf64b5e925d,2,37,9,46,8,2013-12-17 04:07:23,2013-12-17 04:07:08
ab59ae2bcba622e8faa10e70ca2cc1c9d72fdc29...f0e273eaf0246993867e2f6faf621841863ff2f5,2,17,9,26,7,2013-09-30 22:32:34,2013-09-30 22:31:04
f0e273eaf0246993867e2f6faf621841863ff2f5...b28c81724101f84547c6c6b9c203353f2e05fbb7,1,2,2,4,2,2013-09-30 22:41:53,2013-09-30 22:41:53
b28c81724101f84547c6c6b9c203353f2e05fbb7...60dd2c89ffb1f32b7d2d8c14a94cefb26c51aeca,1,6,4,10,3,2013-10-01 00:59:07,2013-10-01 00:59:07
60dd2c89ffb1f32b7d2d8c14a94cefb26c51aeca...008d28c03a4d735c9d42d13c382f566e02fd5994,1,3,0,3,1,2013-10-01 01:04:24,2013-10-01 01:04:24
008d28c03a4d735c9d42d13c382f566e02fd5994...3a8fc57a24b6abb1e136ab1aecdaf3a43c456eff,1,1,1,2,1,2013-10-01 01:11:47,2013-10-01 01:11:47
3a8fc57a24b6abb1e136ab1aecdaf3a43c456eff...c9ba1b3ec9218c90896256ea0c87d7200e70a7a4,1,5,4,9,3,2013-10-01 02:17:59,2013-10-01 00:34:25
c9ba1b3ec9218c90896256ea0c87d7200e70a7a4...81d9fdf4e37c783b7cb773e600138bf3227bb4f1,1,80,13,93,10,2013-10-01 02:19:04,2013-10-01 01:15:26
52ff2df3234c553ed9aebfa7cb2705adaf9dc386...fb2886d88ad2b9dbaf086b9abdca5e72de439bb4,1,5,0,5,1,2013-12-03 23:27:47,2013-12-03 23:27:47
fb2886d88ad2b9dbaf086b9abdca5e72de439bb4...eeea007645541514b5666d1d24dc32b92cb59800,1,4,9,13,3,2013-12-04 01:28:56,2013-12-04 01:28:07
eeea007645541514b5666d1d24dc32b92cb59800...1b27b7cf14f58c1f90e2380ed5c5c3aa568a2196,1,6,0,6,1,2013-12-04 01:30:16,2013-12-04 01:30:16
1b27b7cf14f58c1f90e2380ed5c5c3aa568a2196...534efb51e412f3c89da65f76fdf48ea57e94c84e,2,16,10,26,4,2013-12-04 02:16:24,2013-12-04 02:16:24
534efb51e412f3c89da65f76fdf48ea57e94c84e...643fbad4dc0cc94eb920d2dc20976e5a439abaa7,1,3,3,6,2,2013-12-04 19:56:21,2013-12-04 19:56:21
643fbad4dc0cc94eb920d2dc20976e5a439abaa7...38e83bb13957f2bd785ba91d86b4536b3935fe5a,3,25,1,26,4,2013-12-04 20:40:09,2013-12-04 20:40:09
38e83bb13957f2bd785ba91d86b4536b3935fe5a...880cf37a3f101c6aa36e8e3b77b5b8901cf3893a,4,13,1,14,4,2013-12-04 20:46:47,2013-12-04 20:46:47
880cf37a3f101c6aa36e8e3b77b5b8901cf3893a...593d980ba69a37e02d470cbbe152f205913ea4d2,2,13,4,17,4,2013-12-04 20:54:27,2013-12-04 20:54:27
3a06be789ef30c8795c7835a327f40777d94d494...e9e39d2cb2f6b37d27c30bae822a0a511327e8e3,2,5,5,10,4,2013-12-03 03:17:39,2013-11-20 02:29:51
e9e39d2cb2f6b37d27c30bae822a0a511327e8e3...2527766ad61828c0bad1703c937e70c88d9b94c5,3,123,123,246,3,2013-12-03 03:17:39,2013-11-20 05:41:47
2527766ad61828c0bad1703c937e70c88d9b94c5...1d3d38d6b1fa6ef5b9e0f5be8773b04500895458,8,178,136,314,25,2013-12-03 03:17:40,2013-11-20 07:10:52
1d3d38d6b1fa6ef5b9e0f5be8773b04500895458...9d5905896360d9531c5c893b66ab5294d22f6274,10,401,268,669,77,2013-12-03 03:17:40,2013-11-21 23:35:53
9d5905896360d9531c5c893b66ab5294d22f6274...de5a92d51f38eb1f54f4d248f8e385203d0ce1c9,1,9,0,9,2,2013-12-03 03:17:40,2013-11-25 19:18:52
de5a92d51f38eb1f54f4d248f8e385203d0ce1c9...b9511cad19d22eca965a3d26a3cb61bc28b56075,3,46,19,65,15,2013-12-03 03:17:40,2013-11-25 20:37:17
b9511cad19d22eca965a3d26a3cb61bc28b56075...604a48f64fea265aabe835c1fb9ec5d32841f8d1,4,242,29,271,35,2013-12-03 03:17:40,2013-11-07 01:19:26
604a48f64fea265aabe835c1fb9ec5d32841f8d1...9a24e33002ed2c8c2d093f9872ca6cccc9cc2ac7,1,1,6,7,2,2013-12-03 03:17:40,2013-11-25 21:25:24
9a24e33002ed2c8c2d093f9872ca6cccc9cc2ac7...58e1749104b29c0bc53b129e4b1617efcf41a41b,2,19,15,34,6,2013-12-03 03:17:40,2013-11-26 19:33:27
58e1749104b29c0bc53b129e4b1617efcf41a41b...8f664a1236d103da1a5adbbc2f09feca00ee79a8,3,88,57,145,34,2013-12-03 03:17:41,2013-11-26 20:01:37
8f664a1236d103da1a5adbbc2f09feca00ee79a8...3a73ccdc38aad28c564842cba99008eda1786353,1,4,1,5,2,2013-12-03 03:17:41,2013-11-26 21:24:15
3a73ccdc38aad28c564842cba99008eda1786353...f50f88f83d8c46d582aba00bcf233cbacd0dfe96,1,24,19,43,6,2013-12-03 03:17:41,2013-11-26 21:28:45
f50f88f83d8c46d582aba00bcf233cbacd0dfe96...5953b30897d32724ee001f3937418b8a383f78e9,3,35,13,48,13,2013-12-03 03:17:41,2013-11-26 22:35:04
5953b30897d32724ee001f3937418b8a383f78e9...2a4189a32a4012536cdbc00f45ea5e2e29af03c6,7,662,656,1318,12,2013-12-03 03:17:41,2013-11-26 23:38:52
2a4189a32a4012536cdbc00f45ea5e2e29af03c6...97043de7e408d4cd312ed2c201a91ceed1f3a13c,2,2,2,4,2,2013-12-03 03:17:41,2013-11-27 00:19:09
97043de7e408d4cd312ed2c201a91ceed1f3a13c...67f9ce8b8435b83754600bc1c79e3fa97b153553,1,32,58,90,18,2013-12-03 03:17:41,2013-11-27 00:27:19
67f9ce8b8435b83754600bc1c79e3fa97b153553...4fa09c32cdc5a63ade9038f0e773f8ddfe35fc58,3,186,187,373,3,2013-12-03 03:17:42,2013-11-27 00:31:18
4fa09c32cdc5a63ade9038f0e773f8ddfe35fc58...a6fc84aed8b2f2223fb00c2e3dc06274a3b0999f,1,3,8,11,3,2013-12-03 03:17:42,2013-11-27 00:36:52
a6fc84aed8b2f2223fb00c2e3dc06274a3b0999f...cf665da9d4fc21eb1c861346255d26e4c7fbb1f8,1,3,5,8,2,2013-12-03 03:17:42,2013-11-27 00:41:58
cf665da9d4fc21eb1c861346255d26e4c7fbb1f8...16cc4edc07cae007b4240500a90cc87c5255179e,3,235,209,444,55,2013-12-03 03:17:42,2013-11-27 01:05:43
16cc4edc07cae007b4240500a90cc87c5255179e...aeac87285e95f08e1a9ca88db94e8841f022bdd8,6,52,55,107,29,2013-12-03 03:17:42,2013-11-27 01:16:24
aeac87285e95f08e1a9ca88db94e8841f022bdd8...4ff3004e3caf25facbbb77b2e2910b05552054d4,6,255,252,507,13,2013-12-03 03:17:42,2013-11-27 01:32:38
4ff3004e3caf25facbbb77b2e2910b05552054d4...9abfffbb66060a927a5f763c672f57ae1d29b4ea,3,2,2,4,1,2013-12-03 03:17:42,2013-11-27 01:33:46
9abfffbb66060a927a5f763c672f57ae1d29b4ea...1189a7ae42baf4c0a5ed3e34fac641ed5ee18d57,3,172,162,334,22,2013-12-03 03:17:43,2013-11-27 01:43:29
1189a7ae42baf4c0a5ed3e34fac641ed5ee18d57...5314ffedd3de5298e5150aab25e9081b5c6d233f,2,32,1,33,2,2013-12-03 21:51:35,2013-12-03 21:39:50
5314ffedd3de5298e5150aab25e9081b5c6d233f...001d2811d22c25adf5a43d24888d9f9500afb777,2,26,0,26,3,2013-12-03 22:59:22,2013-12-03 22:59:22
7e9eb48a9fa5f04ac60fe91f7820f80ca8f40e10...39b879d1e6ee0e0543b51061493f2c4c5a172cdd,1,5,1,6,2,2013-08-06 23:45:05,2013-08-06 23:45:05
39b879d1e6ee0e0543b51061493f2c4c5a172cdd...83a34947ee4943887fd301d47cfc3dbbd165e9d1,1,11,14,25,9,2013-08-07 19:11:39,2013-08-07 19:11:39
83a34947ee4943887fd301d47cfc3dbbd165e9d1...1be3c1e5471c2dd2452eb02bb92aa9ea8beaf749,2,2,5,7,2,2013-08-07 21:38:35,2013-08-07 21:38:35
1be3c1e5471c2dd2452eb02bb92aa9ea8beaf749...e47c14d481ad78ca00a9a2800f527104000a83a9,1,2,2,4,2,2013-08-08 04:14:11,2013-08-08 04:13:58
e47c14d481ad78ca00a9a2800f527104000a83a9...431d880160758d4becc447126f7190b460b4967f,1,443,23,466,13,2013-08-08 06:18:13,2013-08-07 22:18:11
431d880160758d4becc447126f7190b460b4967f...1e749672c7a94b41d54823b6ed658a5b6855a6e5,1,23,23,46,16,2013-08-08 06:55:39,2013-08-08 06:55:39
1e749672c7a94b41d54823b6ed658a5b6855a6e5...6b85ce5cf8aec358adde2c9ed14661527a7a3967,1,1,1,2,1,2013-08-08 23:22:45,2013-08-08 23:22:45
6b85ce5cf8aec358adde2c9ed14661527a7a3967...fd17e3337ab8ae6eee08c2a6e45fe9abce7b5d70,1,4,1,5,1,2013-08-08 23:39:21,2013-08-08 23:39:21
fd17e3337ab8ae6eee08c2a6e45fe9abce7b5d70...49939f90e56e849145b62bf9a7328ca8436f6634,1,35,0,35,2,2013-08-09 03:14:45,2013-08-09 03:14:45
49939f90e56e849145b62bf9a7328ca8436f6634...e2344a2a07d5320abc07d04c99018aafe37e895f,3,10,10,20,7,2013-08-10 00:52:25,2013-08-10 00:32:44
e2344a2a07d5320abc07d04c99018aafe37e895f...ac0bbd99e0bf7608c4a91912ab8042900a651cca,1,99,45,144,20,2013-08-10 00:52:25,2013-08-09 18:53:25
ac0bbd99e0bf7608c4a91912ab8042900a651cca...fca48342ad5ed4b31844089c318c82416ed8fa01,1,1,1,2,1,2013-08-12 20:06:25,2013-08-12 20:06:25
dfd2068d4f8dacaacb1d98b89566ab72b8838438...e7bb166a02152ec07040ecd7e345274f6406e461,1,11,0,11,1,2013-08-06 22:24:06,2013-08-06 22:23:57
e7bb166a02152ec07040ecd7e345274f6406e461...a9a99ceafd60687cb061c00a87cbadb43a84dd32,1,8,5,13,2,2013-08-06 22:55:06,2013-08-06 22:55:06
2ab85a16c38d94bf67757874c8bd227762413678...73e6d4eb4c707123215355b6d1cc9b1ca4f8cdd2,1,1,1,2,1,2013-04-04 06:55:36,2013-03-25 07:20:37
73e6d4eb4c707123215355b6d1cc9b1ca4f8cdd2...f8c6caf42d10fad83c86dd1128fcb19e9e9cdca5,1,1,1,2,1,2013-04-04 06:56:09,2013-04-04 06:56:09
fa5770ec7410170e95ae9d6fd3a6d785a95fdbd6...9ba35e7b79bb669288888d3e57dfa811572a3a7a,1,4,4,8,4,2013-04-04 07:02:58,2013-04-04 07:02:58
fa5770ec7410170e95ae9d6fd3a6d785a95fdbd6...ce1b99a74fa61b2d4d7036e5b6ccf91cbbee1e0a,18,999,125,1124,61,2013-04-03 00:28:15,2013-02-04 18:59:23
a2d8a975bc83c0c9ec5128d5b97fc1c2b1ae5af9...58a14da1a1928bcf40e3ee2acf57b0f2a561dfa3,4,33,26,59,23,2014-06-04 16:35:23,2014-05-29 23:54:40
5e0c9923d441bef51f208db49b1f2c9debd90381...03aadebf558b17f0e2ea0f5a40dcfd773be63e33,1,6,2,8,3,2014-06-11 19:30:30,2014-06-11 19:30:30
5e0c9923d441bef51f208db49b1f2c9debd90381...81dbf20ea3a1a0ddc79cf10076a6816b1babed10,1,7,0,7,4,2014-06-11 17:11:20,2014-06-11 17:11:20
81dbf20ea3a1a0ddc79cf10076a6816b1babed10...8b9a61b39c27c1e5449a1004bbaaf06d7f8bfd1a,1,6,11,17,5,2014-06-11 22:13:27,2014-06-10 21:58:34
8b9a61b39c27c1e5449a1004bbaaf06d7f8bfd1a...e43d13e9f0b5dddfc193226fffab4ec30232c2e8,1,81,61,142,20,2014-06-12 00:46:46,2014-06-12 00:46:46
e43d13e9f0b5dddfc193226fffab4ec30232c2e8...2554228e493876272d7a36173acad5d02448bfda,1,12,12,24,9,2014-06-12 00:50:38,2014-06-12 00:50:38
75937b99a99c047da23e40643240f5e255819e1e...22c9ac644d14ef456158aa789f7b97ed54ded003,1,9,9,18,6,2014-08-26 18:55:12,2014-08-26 17:10:59
22c9ac644d14ef456158aa789f7b97ed54ded003...e8437bd91b5e58db72a891f8507d7501f83af6f1,1,2,3,5,1,2014-08-26 18:55:26,2014-08-26 18:53:52
e8437bd91b5e58db72a891f8507d7501f83af6f1...35d816a36347e9f4d21d0c57a0f894cb848203f0,1,1,1,2,1,2014-08-27 00:46:49,2014-08-26 22:58:52
35d816a36347e9f4d21d0c57a0f894cb848203f0...1ad3dd17af7e7bc8973b1dc0169b88f59e5f2c9e,1,2,1,3,1,2014-08-27 00:46:52,2014-08-26 23:28:07
1ad3dd17af7e7bc8973b1dc0169b88f59e5f2c9e...5d4a93d6277f1c6a5058bc2d9f7edb29688c660e,1,1,2,3,1,2014-08-27 03:43:21,2014-08-27 03:43:21
5d4a93d6277f1c6a5058bc2d9f7edb29688c660e...7358986f131648ee61b1f4e9bf93aa2267454294,1,1,1,2,1,2014-08-27 03:43:22,2014-08-27 03:43:22
7358986f131648ee61b1f4e9bf93aa2267454294...c2c67b128e119959dba9f73d48424831527e5876,1,12,9,21,6,2014-08-27 03:45:07,2014-08-27 03:45:07
c2c67b128e119959dba9f73d48424831527e5876...4bb1c3f6cefd947bf593d923e3dd7b626dc5c448,3,91,23,114,6,2014-08-27 03:49:11,2014-08-27 00:04:06
4bb1c3f6cefd947bf593d923e3dd7b626dc5c448...2e870042d391a80f06b3e0f29c1b1c01e1f37b55,1,2,0,2,2,2014-08-27 03:49:11,2014-08-27 00:53:23
2e870042d391a80f06b3e0f29c1b1c01e1f37b55...64ecaaf13642ec0ec80750e8eb32d45b7ef53faa,1,1,1,2,1,2014-08-27 03:49:11,2014-08-27 01:19:24
64ecaaf13642ec0ec80750e8eb32d45b7ef53faa...43e01c09eb9ba890a51721901b7ceb66d3322dc8,11,172,135,307,57,2014-08-27 04:54:48,2014-08-27 03:26:23
43e01c09eb9ba890a51721901b7ceb66d3322dc8...6a6837e32c0ef014bcef51ca387170ccd9ca852f,1,4,2,6,1,2014-08-27 05:16:09,2014-08-27 05:16:09
6a6837e32c0ef014bcef51ca387170ccd9ca852f...8373507288160bd97ff3b54d2a8f564d53940688,1,7,0,7,1,2014-08-27 05:23:11,2014-08-27 05:16:03
8373507288160bd97ff3b54d2a8f564d53940688...3564c3ac4e6915e57827eee54470681e610b13c3,3,42,0,42,3,2014-08-27 06:04:29,2014-08-27 06:01:48
3564c3ac4e6915e57827eee54470681e610b13c3...a5eea24d4781fe1a05b7094ede783366b18c7aa1,1,9,13,22,1,2014-08-27 06:05:59,2014-08-27 06:04:03
a5eea24d4781fe1a05b7094ede783366b18c7aa1...9c9eadc079aeb59f7ab2ac97ca650e668fabc5a0,1,1,0,1,1,2014-08-27 06:16:03,2014-08-27 06:15:38
9c9eadc079aeb59f7ab2ac97ca650e668fabc5a0...07d9a5e36c7c1d0ad5faa43017c0c88f51b39bea,1,13,3,16,1,2014-08-27 06:35:28,2014-08-27 06:24:51
07d9a5e36c7c1d0ad5faa43017c0c88f51b39bea...273b70bea48a189bd73d7b0fbf45d8d4f0da5a6a,7,119,72,191,25,2014-08-27 06:56:51,2014-08-27 06:56:51
6d57079bd0fe2bc00392afd999f5eeb97e9627ce...b85e3e1c5efeff31048ae3e3bc0fc9bf7fd5ecbf,1,3,0,3,1,2014-07-30 23:22:58,2014-07-30 23:22:58
b85e3e1c5efeff31048ae3e3bc0fc9bf7fd5ecbf...7c4af8d12fd627995f3a4aeb789b0d0247a5031d,1,4,2,6,1,2014-07-30 23:51:12,2014-07-30 23:51:12
8b74a7d253f86fc8e2c102c79aa1b093804cf4b3...b76f3e67c880c132895975a963745f61ebab8fac,8,174,19,193,11,2014-06-26 22:08:41,2014-06-19 18:23:50
b76f3e67c880c132895975a963745f61ebab8fac...1c90d0410c55dfc9e83aa1cba3b6ebc23c377b9e,6,12,12,24,10,2014-06-26 22:08:41,2014-06-23 23:48:48
1c90d0410c55dfc9e83aa1cba3b6ebc23c377b9e...68b4c1862725d7f85d5fcd48b6de26f86893cad3,7,106,30,136,22,2014-06-26 22:08:41,2014-06-24 01:44:29
68b4c1862725d7f85d5fcd48b6de26f86893cad3...130d1a61fb6667f7bee340358e3c2263ab060592,1,0,138,138,1,2014-06-26 22:08:41,2014-06-24 01:47:01
130d1a61fb6667f7bee340358e3c2263ab060592...afff81ffc5620ad71f3b15339d7b1be353516548,3,259,163,422,15,2014-06-26 22:08:41,2014-06-25 21:19:39
afff81ffc5620ad71f3b15339d7b1be353516548...53936d30624cc7e746a1c86289af050425acbfb0,1,43,40,83,2,2014-06-26 22:08:41,2014-06-26 21:46:53
53936d30624cc7e746a1c86289af050425acbfb0...168f21654c012ee102a4e8b81ddef1cb199b5bcc,2,7,6,13,4,2014-06-26 22:15:24,2014-06-26 22:15:24
0a1a01a584bba2af1a56d951bb6425a6c5e17158...ccfbb2910d29f1b96d5e714257882a1e4df756a8,5,35,15,50,18,2014-06-24 07:27:34,2014-06-24 07:27:34
ccfbb2910d29f1b96d5e714257882a1e4df756a8...867fb617fbb26a6538b5b706e2801bb37ffa9246,1,0,1,1,1,2014-06-24 07:27:57,2014-06-24 07:27:57
0a1a01a584bba2af1a56d951bb6425a6c5e17158...c8265be3f27eb2a27e20f78b39d08e9daba18d4f,15,437,407,844,47,2014-06-24 06:46:52,2014-06-24 05:14:21
c8265be3f27eb2a27e20f78b39d08e9daba18d4f...06af1799cab4c437fe982bc89d671addd8700ecf,2,53,47,100,8,2014-06-24 07:01:16,2014-06-24 07:01:16
06af1799cab4c437fe982bc89d671addd8700ecf...b6e5513a783ae70a4487b24a54e0aa60ead859ba,14,46,78,124,35,2014-06-24 07:15:56,2014-06-24 07:15:56
a8676061e54abd396c7b4e55a78124322d29591d...6f9276855969e02091622c0e25ccdc06bbb43232,2,38,1,39,7,2014-06-25 18:12:12,2014-06-19 02:47:23
6f9276855969e02091622c0e25ccdc06bbb43232...4b58ba4d9996dfd68f70951d56e398e794a18b08,13,206,87,293,23,2014-06-25 18:12:12,2014-06-25 02:36:34
4b58ba4d9996dfd68f70951d56e398e794a18b08...e1d4140f35b7d411dc22369605ece5b92f24ac8a,1,2,1,3,1,2014-06-25 18:12:12,2014-06-25 02:45:12
e1d4140f35b7d411dc22369605ece5b92f24ac8a...e4ecda9fe8d2fd08afb4f014bf998ba3ba37340a,2,9,1,10,2,2014-06-25 18:12:12,2014-06-25 02:45:25
e4ecda9fe8d2fd08afb4f014bf998ba3ba37340a...f761e898c84d58c2cfe8bc0aeb547d6386d39799,4,55,31,86,12,2014-06-25 18:12:12,2014-06-25 03:23:41
f761e898c84d58c2cfe8bc0aeb547d6386d39799...e525cb51bb31e1b3c1b2ce89f3a70584403a4f7b,1,1,0,1,1,2014-06-25 18:12:12,2014-06-25 03:23:49
e525cb51bb31e1b3c1b2ce89f3a70584403a4f7b...01b73cafce9894c7ae08b42193f8034b8c3b189d,1,0,2,2,1,2014-06-25 18:12:12,2014-06-25 03:25:19
01b73cafce9894c7ae08b42193f8034b8c3b189d...e8b1fddc4e5cd1130ef7f6514c655768cbed4b0f,2,4,2,6,3,2014-06-25 18:12:12,2014-06-25 16:52:47
e8b1fddc4e5cd1130ef7f6514c655768cbed4b0f...1a3fd674969cefa73b1c77e10d677f5c18aeae9a,1,13,1,14,4,2014-06-25 18:12:12,2014-06-25 17:33:14
1a3fd674969cefa73b1c77e10d677f5c18aeae9a...3036b6b686703ed80b7af228621a69d3aab56f7c,2,9,3,12,4,2014-06-25 18:12:12,2014-06-25 17:51:06
a8676061e54abd396c7b4e55a78124322d29591d...bc15625b6634c427810665a9e4bf38177963b846,22,22,22,44,22,2014-06-25 03:13:07,2014-06-24 17:12:42
0a4b7b55cc80ef6099b6b5e093736f773aa3e20a...04e2a74c400888983f7d8429885f6ddc53d3505b,8,193,145,338,17,2014-05-20 19:06:10,2014-05-20 19:06:10
04e2a74c400888983f7d8429885f6ddc53d3505b...5a9a8a84521a3c07e6401ac6476b57eab9a92208,1,0,10,10,1,2014-05-20 19:17:13,2014-05-20 19:17:13
cb6113170f251d8e679f48c13f434ecd78ddecf9...87510807e8a975b28357ba3153b4cc13619ad760,1,1,1,2,1,2014-04-30 21:32:24,2014-04-30 18:55:45
87510807e8a975b28357ba3153b4cc13619ad760...05c7a1662cd85fc2138e977b37f9e4275ba745d4,1,1,0,1,1,2014-04-30 21:32:36,2014-04-30 21:03:36
05c7a1662cd85fc2138e977b37f9e4275ba745d4...671e526bc2cb102ad6c5e484e008291e0ed78f97,1,1,1,2,1,2014-04-30 21:45:59,2014-04-30 21:45:20
671e526bc2cb102ad6c5e484e008291e0ed78f97...673a285dfc40aa34993ec3342d068b7ac16fbc0d,2,34,5,39,2,2014-04-30 22:53:59,2014-04-30 22:53:59
673a285dfc40aa34993ec3342d068b7ac16fbc0d...d1b58e57dd8608a3f06d27127298d1623523e70b,1,1,1,2,1,2014-05-01 06:29:23,2014-05-01 06:29:23
d1b58e57dd8608a3f06d27127298d1623523e70b...1d4004650fd7c4389acc40a573abee2199a55ca9,3,34,5,39,8,2014-05-01 07:17:11,2014-05-01 06:01:53
1d4004650fd7c4389acc40a573abee2199a55ca9...56050500e436dc89577af3256fd0b45d7ecfde64,1,6,1,7,1,2014-05-01 16:51:55,2014-05-01 16:51:55
56050500e436dc89577af3256fd0b45d7ecfde64...63b3119127201a64eedaa1472230199d0ade9298,2,13,1,14,2,2014-05-01 18:49:07,2014-05-01 18:38:02
63b3119127201a64eedaa1472230199d0ade9298...d59f0263630751c1badad184f0043a5ed389a192,1,1,1,2,1,2014-05-01 19:17:06,2014-05-01 19:17:06
d59f0263630751c1badad184f0043a5ed389a192...629423d514034bad55435583a4ee7049277c31fd,2,11,2,13,3,2014-05-01 19:17:24,2014-05-01 19:17:24
629423d514034bad55435583a4ee7049277c31fd...53c4a32d7e9214f0408f3b34277fe5235534a4e7,7,7,7,14,7,2014-05-01 19:31:27,2014-05-01 19:31:27
cb6113170f251d8e679f48c13f434ecd78ddecf9...2978ceb96d9a9527c74d0839920c2f9b49bcb5b5,3,23,2,25,4,2014-04-30 17:21:40,2014-04-30 17:21:40
2978ceb96d9a9527c74d0839920c2f9b49bcb5b5...9cd32c85ecbd687f0a9bfc120487c41413a94187,1,2,1,3,1,2014-04-30 17:23:01,2014-04-30 17:23:01
9cd32c85ecbd687f0a9bfc120487c41413a94187...68f442584123e4cc8dfdf52ccd7dc401dff5ba69,1,3,1,4,1,2014-04-30 17:28:40,2014-04-30 17:28:40
68f442584123e4cc8dfdf52ccd7dc401dff5ba69...4b6d88828e91a6ee520c0db435e78956ecc51422,1,2,2,4,1,2014-04-30 17:47:37,2014-04-30 17:47:37
4b6d88828e91a6ee520c0db435e78956ecc51422...532e9f32a8b09da01cdd7fc1b997656c03aa2f18,7,7,7,14,7,2014-04-30 18:02:18,2014-04-30 18:02:18
ba0770a908c393564937c7f7b2a1f2c78ebf8b41...13d25197f53626ce28c80840cd14dd9e7f7136a3,1,4,7,11,2,2014-06-06 21:08:29,2014-06-06 21:05:54
13d25197f53626ce28c80840cd14dd9e7f7136a3...783514511f2ccc6c8f0f5e862adf1afdf6be778b,1,6,33,39,3,2014-06-06 21:20:56,2014-06-06 21:20:56
783514511f2ccc6c8f0f5e862adf1afdf6be778b...ec64edcd1ffc766122dd9a2458062224d343aaa3,1,23,17,40,7,2014-06-06 21:46:53,2014-06-06 21:46:53
ec64edcd1ffc766122dd9a2458062224d343aaa3...49fcddb76f527bff372a789eb69e584314c02d50,3,18,14,32,6,2014-06-06 21:50:25,2014-06-06 21:50:25
49fcddb76f527bff372a789eb69e584314c02d50...4dc2cb6e3175062090e256e56722bc549466be79,3,20,551,571,5,2014-06-06 22:20:29,2014-06-06 22:19:31
4dc2cb6e3175062090e256e56722bc549466be79...a4888f18fbd26c3dbab2e98ca7e3d2590c74f105,1,89,0,89,2,2014-06-06 23:02:44,2014-06-06 23:02:44
a4888f18fbd26c3dbab2e98ca7e3d2590c74f105...32596145b6f169ca9bf7e0a07558e504b6d78a20,1,1,1,2,1,2014-06-06 23:31:04,2014-06-06 23:31:04
32596145b6f169ca9bf7e0a07558e504b6d78a20...75deaa14a86ba78b4f1825f54bf74981cf147a09,1,11,0,11,1,2014-06-08 16:30:34,2014-06-08 16:30:34
75deaa14a86ba78b4f1825f54bf74981cf147a09...1365e63ff8c72506d3c0cc3a2fcc1f989aeff2ca,4,21,21,42,7,2014-06-09 19:18:48,2014-06-09 19:18:48
1365e63ff8c72506d3c0cc3a2fcc1f989aeff2ca...adcf6c853c9ba76ca1b313d2ceb78ffd742ae08b,1,4,1,5,2,2014-06-09 19:32:32,2014-06-09 19:32:32
adcf6c853c9ba76ca1b313d2ceb78ffd742ae08b...9108c5debd22d6f443d22e32b131ae93dd23fa41,5,98,66,164,37,2014-06-09 21:02:46,2014-06-09 21:02:46
9108c5debd22d6f443d22e32b131ae93dd23fa41...142af3a38fb4e7553699c62ca4249f8002ffd0f8,1,18,2,20,3,2014-06-09 21:29:29,2014-06-09 21:29:29
142af3a38fb4e7553699c62ca4249f8002ffd0f8...f687e4198f1137573d3ff77c47657d9948fd76d8,4,68,7,75,7,2014-06-09 21:55:11,2014-06-09 21:55:11
f687e4198f1137573d3ff77c47657d9948fd76d8...4e8472e9707c18b7bbbd98c08c21308efdadd239,4,41,45,86,17,2014-06-09 23:35:24,2014-06-09 23:35:24
4e8472e9707c18b7bbbd98c08c21308efdadd239...a13476f1951221141f446122daccacd944e66f6c,1,4,1,5,1,2014-06-10 00:13:07,2014-06-10 00:13:07
a13476f1951221141f446122daccacd944e66f6c...63b608a6a26e267615c111fe67a452e4edce28aa,10,117,188,305,70,2014-06-10 02:56:28,2014-06-10 02:56:28
5ebbbdbc63ea488557f7668f07d562ae26b02638...831967dd605dca40f06f23adedafa89d2c7ef08d,4,48,6,54,9,2014-05-28 23:10:29,2014-05-28 23:10:29
831967dd605dca40f06f23adedafa89d2c7ef08d...2ddc63e538732f4c31e5ea949beb35b31df16aaa,3,18,4,22,8,2014-05-29 01:16:12,2014-05-29 01:16:12
2ddc63e538732f4c31e5ea949beb35b31df16aaa...dd3b1605f96d368ff3749ee4529a688870ddfef3,4,17,13,30,11,2014-05-29 02:05:27,2014-05-29 02:05:27
dd3b1605f96d368ff3749ee4529a688870ddfef3...7af3ba9a8291bdfacaef355bdba80a8c858d2f28,3,40,1,41,4,2014-05-29 21:32:56,2014-05-29 21:32:56
7af3ba9a8291bdfacaef355bdba80a8c858d2f28...814d0abc1fb2275cfb93ca8bfe49e9050404ecaa,2,19,7,26,6,2014-05-29 23:06:00,2014-05-29 23:06:00
814d0abc1fb2275cfb93ca8bfe49e9050404ecaa...614b7d8246fc74bff5c60e0dd1911a59c7097f63,3,41,28,69,9,2014-05-30 00:10:25,2014-05-30 00:10:25
614b7d8246fc74bff5c60e0dd1911a59c7097f63...1cf0655da4f43ba3309e73ec6e624ae6b75f3b5e,9,84,60,144,40,2014-05-31 01:32:49,2014-05-31 01:32:49
1cf0655da4f43ba3309e73ec6e624ae6b75f3b5e...0ca66e07614bea792b9d55553fb717c13f21a49d,4,31,23,54,19,2014-06-03 21:37:11,2014-06-03 21:37:11
0ca66e07614bea792b9d55553fb717c13f21a49d...31ca57e84368cec9a7c3557ecfce8505bebd29da,1,3,0,3,1,2014-06-03 21:39:30,2014-06-03 21:39:30
31ca57e84368cec9a7c3557ecfce8505bebd29da...3f5ea39a48a91a23e8bf7d14e77133a17813b86a,1,4,4,8,4,2014-06-03 22:13:10,2014-06-03 22:13:10
8bdcdbc518d1484b7bd89b039b687a9e944aeb9f...d176828d2aa79eafbcfeefe345ac5bfbba298e7c,4,34,28,62,18,2014-05-27 23:50:16,2014-05-21 19:38:17
d176828d2aa79eafbcfeefe345ac5bfbba298e7c...71917200b792cd444cd7bf8cc75ca146f21e7bf7,1,1,3,4,1,2014-05-28 19:06:04,2014-05-28 19:06:04
8bdcdbc518d1484b7bd89b039b687a9e944aeb9f...07c36f16b18781bbd4bac3aacb1a5e213f0a7246,1,23,0,23,1,2014-05-27 04:46:40,2014-05-27 04:46:40
70689568f6282d3b4959ff627dfbef6cc80bffbf...0aa9af3dfc6460291bbb37f5f39408cacd09be61,1,18,6,24,6,2014-03-17 18:10:06,2014-03-17 18:10:06
70689568f6282d3b4959ff627dfbef6cc80bffbf...0bb6b0bb4ce9d0e9a83aabdcad36792b5d381c2c,2,8,1,9,2,2014-03-17 04:18:29,2014-03-17 04:18:29
0bb6b0bb4ce9d0e9a83aabdcad36792b5d381c2c...82fd3201a1227bc0b604ff449cf960f30e0e3eb8,1,5,5,10,5,2014-03-17 05:46:02,2014-03-17 05:46:02
82fd3201a1227bc0b604ff449cf960f30e0e3eb8...4b2696eda4553a08878c55cf7fb2c93f2c762d7f,1,2,1,3,1,2014-03-17 07:05:26,2014-03-17 07:05:26
70689568f6282d3b4959ff627dfbef6cc80bffbf...c2195d71e64c62a6e7cda7c06f369e5a7f03b067,1,15,7,22,3,2014-03-17 02:19:35,2014-03-01 03:07:35
c2195d71e64c62a6e7cda7c06f369e5a7f03b067...8aaa522d0755d5fc576917a97dc22ab5d021c92d,1,2,0,2,1,2014-03-17 02:19:35,2014-03-17 00:03:18
8aaa522d0755d5fc576917a97dc22ab5d021c92d...f825e091b97a1fc978d80fe383fe47c998bc9e20,4,117,23,140,12,2014-03-17 02:19:35,2014-03-17 00:22:00
f825e091b97a1fc978d80fe383fe47c998bc9e20...9900c10be2737a7f1435c9bdca1d3f4b00a20b70,2,60,4,64,5,2014-03-17 02:19:35,2014-03-17 01:39:03
9900c10be2737a7f1435c9bdca1d3f4b00a20b70...243deeb410d4207116447d8d5b1008f8bada8e67,4,48,4,52,6,2014-03-17 02:19:35,2014-03-17 02:09:51
243deeb410d4207116447d8d5b1008f8bada8e67...e01b662eb8bd666e80ef29d1c11508a154050127,2,37,27,64,10,2014-03-17 02:19:35,2014-03-17 02:18:45
e01b662eb8bd666e80ef29d1c11508a154050127...24ee309fc72c3fdc70c93bb6513a73e7248d7692,1,99,95,194,12,2014-03-17 08:08:29,2014-03-17 08:08:29
24ee309fc72c3fdc70c93bb6513a73e7248d7692...205b88ae5696685cc09dd5c7d5411cadd785c193,1,15,10,25,2,2014-03-17 08:14:14,2014-03-17 08:14:14
205b88ae5696685cc09dd5c7d5411cadd785c193...599b237b050aa53bfd158fb1d7f45379202ef28b,5,18,22,40,12,2014-03-17 08:24:23,2014-03-17 08:24:23
480016ea8b92e94a9356ca6c0cf6ef86a935ffe3...30cd85f95159e506c83d88b739a94d77362cbef7,2,2,1,3,2,2014-03-24 20:20:40,2014-03-24 20:20:40
b73d670f358ef43ab9a4674f6235c3b0273e1719...a70065c324ccc491fef379ceaf925145dbc78e78,6,454,146,600,53,2014-04-22 20:54:44,2014-04-14 05:59:45
a70065c324ccc491fef379ceaf925145dbc78e78...431ece4712a9f7ea454d68f1c82e261934c5f1ca,1,3,3,6,3,2014-04-22 20:54:55,2014-04-22 20:50:35
431ece4712a9f7ea454d68f1c82e261934c5f1ca...b196de66b108c74088a26cfda1f2bdbbfb64261a,1,11,0,11,2,2014-04-22 20:54:55,2014-04-22 20:51:11
b73d670f358ef43ab9a4674f6235c3b0273e1719...0d86ff93563cc52f7dd3e86010e8955b8913ae27,1,5,0,5,1,2014-04-21 21:08:28,2014-04-21 21:08:28
1669a2bd773089cf0a4dba60da5bd2219805726a...3e25c903d6fcb9a3a1d80c5e2a3715d0507a3aa2,1,5,5,10,2,2014-03-12 19:05:28,2014-03-12 19:05:16
1669a2bd773089cf0a4dba60da5bd2219805726a...3f8beb093586237a98226917b9cff08130eeaf8a,10,9,20,29,19,2014-03-11 21:42:42,2014-03-07 21:48:51
3f8beb093586237a98226917b9cff08130eeaf8a...5f0d1714ebfd3da4a2067614b37d40f4d9977dfd,10,489,154,643,86,2014-03-12 01:10:28,2014-03-12 01:10:28
5f0d1714ebfd3da4a2067614b37d40f4d9977dfd...839c928925b344175ad80265f193e11b1a80b599,1,23,15,38,8,2014-03-12 03:35:38,2014-03-12 03:35:38
839c928925b344175ad80265f193e11b1a80b599...3273897a718f6a8a3b89e3df667313e67cf5f076,11,51,82,133,49,2014-03-12 04:27:13,2014-03-12 04:27:13
3273897a718f6a8a3b89e3df667313e67cf5f076...149f81f7272fef94b598bdad5751be830441ca00,2,9,5,14,2,2014-03-12 04:32:35,2014-03-12 04:32:35
149f81f7272fef94b598bdad5751be830441ca00...6ef6addab9a4ff26dc4e894772768a70e8226938,1,52,44,96,9,2014-03-12 04:59:31,2014-03-12 04:59:31
6ef6addab9a4ff26dc4e894772768a70e8226938...cfd0474f75a35fc3d44dcf7c509c838a7495e789,1,6,2,8,1,2014-03-12 05:04:12,2014-03-12 05:04:12
cfd0474f75a35fc3d44dcf7c509c838a7495e789...a87b0502b089d05152941598829ec88b65a6ecdc,3,40,29,69,16,2014-03-12 18:19:16,2014-03-12 18:19:16
a87b0502b089d05152941598829ec88b65a6ecdc...70b24926f3016e7fd8b53538e3084994ae482c52,8,59,52,111,40,2014-03-12 18:57:08,2014-03-12 18:57:08
70b24926f3016e7fd8b53538e3084994ae482c52...78315cb37ee7539dc93683818b6519b27e5f23fa,2,2,11,13,2,2014-03-12 19:13:51,2014-03-12 19:13:51
78315cb37ee7539dc93683818b6519b27e5f23fa...806b740a6bf26356c6e2ad47a0a482595a0305c2,1,0,1,1,1,2014-03-12 19:15:58,2014-03-12 19:15:58
806b740a6bf26356c6e2ad47a0a482595a0305c2...a8788a8084ec3eba0c0417c30ab13cbdd985ebf5,3,21,12,33,8,2014-03-12 21:56:08,2014-03-12 21:56:08
a8788a8084ec3eba0c0417c30ab13cbdd985ebf5...985ffea9faa7feb31ae44f3e8ade889d5eb42ac1,26,401,298,699,93,2014-03-13 02:02:47,2014-03-13 02:02:01
985ffea9faa7feb31ae44f3e8ade889d5eb42ac1...537cbf32abbb95ba7a54ac0652f315101e1cb434,3,171,107,278,43,2014-03-13 04:04:52,2014-03-13 04:04:52
537cbf32abbb95ba7a54ac0652f315101e1cb434...949361bae07f4f5a1c52909011241a43f6eea816,8,121,578,699,41,2014-03-13 05:18:39,2014-03-13 05:18:39
949361bae07f4f5a1c52909011241a43f6eea816...5d41a15a340caccc5354b8e4a356cebc50065b10,3,1862,0,1862,3,2014-03-13 20:52:51,2014-03-13 20:52:51
5d41a15a340caccc5354b8e4a356cebc50065b10...79b4a6babc8f360b98fe3e4e82255fd74777e0fd,2,408,299,707,31,2014-03-13 22:09:59,2014-03-13 22:09:59
79b4a6babc8f360b98fe3e4e82255fd74777e0fd...1bf4ffba803f95f9383f5d2ed5929726b659670c,4,1036,2966,4002,75,2014-03-14 00:39:08,2014-03-14 00:39:08
1bf4ffba803f95f9383f5d2ed5929726b659670c...0f47a7d5c6c139d6e940438a06ea04148c9d32d9,3,119,100,219,15,2014-03-14 01:58:37,2014-03-14 01:58:37
0f47a7d5c6c139d6e940438a06ea04148c9d32d9...a1d3f4db44c576b30066c6a3790d1bcf5d6e0fcd,4,221,163,384,47,2014-03-14 04:20:30,2014-03-14 04:20:30
a1d3f4db44c576b30066c6a3790d1bcf5d6e0fcd...242620166314b93f7484beb1476d57e72b4c4a75,6,61,36,97,35,2014-03-14 04:42:32,2014-03-14 04:42:32
242620166314b93f7484beb1476d57e72b4c4a75...688f7b364331fbf34d67901fbe40a5dcbcbabb26,12,30,30,60,27,2014-03-14 04:47:12,2014-03-14 04:47:12
688f7b364331fbf34d67901fbe40a5dcbcbabb26...2d0472f08d51733ade85f41d2458a94efbf09bea,3,2,2,4,2,2014-03-14 04:48:22,2014-03-14 04:48:22
2d0472f08d51733ade85f41d2458a94efbf09bea...6c993f1ea214fa7e99fc43435a2ecca8a6dbc0a3,12,379,122,501,75,2014-03-14 08:14:47,2014-03-14 08:14:47
6c993f1ea214fa7e99fc43435a2ecca8a6dbc0a3...4565c2d262bb5dce73db67befa1bc7439f7f46af,13,82,44,126,39,2014-03-15 00:25:40,2014-03-15 00:25:40
4565c2d262bb5dce73db67befa1bc7439f7f46af...adccdaf399ce78d423e178fd1edfb293b70e580e,3,3,4,7,4,2014-03-15 00:28:18,2014-03-15 00:28:18
adccdaf399ce78d423e178fd1edfb293b70e580e...c63d3386add420fbb0a36ef96c4445ee0cb90a25,2,94,22,116,15,2014-03-17 21:47:58,2014-03-17 21:47:58
c63d3386add420fbb0a36ef96c4445ee0cb90a25...18af114204d055d730d6dce7ffba33238dc3d2d6,7,64,21,85,18,2014-03-18 00:17:13,2014-03-18 00:17:13
18af114204d055d730d6dce7ffba33238dc3d2d6...30dad184b74391122a61836a0182558ee8235d69,7,34,16,50,19,2014-03-18 00:57:14,2014-03-18 00:57:14
30dad184b74391122a61836a0182558ee8235d69...3465baf8af4b235d7c6dad140374da4fc8f8de14,5,50,60,110,32,2014-03-18 05:44:51,2014-03-18 05:44:51
3465baf8af4b235d7c6dad140374da4fc8f8de14...8f394328ac8677611b4cf9eae63d0bc282a17d40,3,85,61,146,23,2014-03-18 06:51:41,2014-03-18 06:51:41
8f394328ac8677611b4cf9eae63d0bc282a17d40...cf14b92e4c08defc0fa2631713e5faf1c536e89e,1,2,1,3,2,2014-03-18 07:37:13,2014-03-18 07:37:13
cf14b92e4c08defc0fa2631713e5faf1c536e89e...c987e5ccedbf649dafe95d66d686bba7fc2734a1,1,1,0,1,1,2014-03-18 07:37:38,2014-03-18 07:37:38
c987e5ccedbf649dafe95d66d686bba7fc2734a1...5d315f9f691cb81d29ec6a01acd6fd92b3c884f7,5,250,170,420,47,2014-03-18 18:18:17,2014-03-18 07:08:26
5d315f9f691cb81d29ec6a01acd6fd92b3c884f7...4f84ac57bafa9cd73659ef02204c9cc87144a4a1,5,42,22,64,13,2014-03-18 23:24:45,2014-03-18 23:24:45
4f84ac57bafa9cd73659ef02204c9cc87144a4a1...6ac5296289e16f940ada528c3575eaf4727f296b,5,93,110,203,40,2014-03-19 01:22:13,2014-03-19 01:22:13
6ac5296289e16f940ada528c3575eaf4727f296b...180751d7bf9c0961b75ade47c3dc36484a6a2c04,5,12,12,24,10,2014-03-20 18:21:18,2014-03-20 18:21:18
180751d7bf9c0961b75ade47c3dc36484a6a2c04...da7400aca52b47ace1b23266ae058a91032494a6,3,4,4,8,4,2014-03-20 19:29:16,2014-03-20 18:54:51
da7400aca52b47ace1b23266ae058a91032494a6...60ffe51f227c1b7be940f8016a8a3bcb43a89a01,7,93,71,164,40,2014-03-20 19:31:55,2014-03-20 19:30:03
60ffe51f227c1b7be940f8016a8a3bcb43a89a01...54452766310a8053f05116a9129e02156ec0fe67,2,5,5,10,6,2014-03-20 23:05:12,2014-03-20 23:05:12
1669a2bd773089cf0a4dba60da5bd2219805726a...e42632b4e55cd66311277f2f14899acb469299db,3,10,6,16,9,2014-03-11 21:06:59,2014-03-07 21:11:00
32768a8c057e6871e774aec92351e88cc33e2bd4...bc736e4695bc85ab1a1f01723e33a5ff1685c2c0,2,522,676,1198,2,2014-01-13 19:50:53,2014-01-13 19:50:53
bc736e4695bc85ab1a1f01723e33a5ff1685c2c0...9c1943c46750e3414df319f45b536c2a84f2fa10,1,9,2,11,2,2014-01-13 19:51:21,2014-01-13 19:51:21
9c1943c46750e3414df319f45b536c2a84f2fa10...8699a3af94dc497f15f5e3da3f3b4ce5e6fab1af,2,28,28,56,12,2014-01-14 04:26:51,2014-01-14 04:26:51
32768a8c057e6871e774aec92351e88cc33e2bd4...f89941412aeb26d46fcbdcec75b9f2ff9066de94,3,81,19,100,17,2014-01-12 04:36:01,2014-01-12 04:36:01
f89941412aeb26d46fcbdcec75b9f2ff9066de94...189845f1fba51d291484efeff9a99944380adba1,3,11,5,16,6,2014-01-12 04:43:36,2014-01-12 04:43:36
189845f1fba51d291484efeff9a99944380adba1...bdf6fd248574997f2d5da462d031a57139d135bd,1,3,4,7,2,2014-01-14 02:27:58,2014-01-14 02:27:58
2907e65e33efabeb1fa1e9ae2abe013206254000...dd6d6a702b2bd709999642ea170f423ad49b4653,1,3,0,3,1,2014-02-02 23:31:58,2014-02-02 23:31:58
dd6d6a702b2bd709999642ea170f423ad49b4653...5899848bb4277dc647586b136dc51120056ce073,1,0,15,15,1,2014-02-03 18:36:33,2014-02-03 18:36:33
5899848bb4277dc647586b136dc51120056ce073...6fb0f13108145a8e3a4e6b8cd38b543b0a8f2b61,2,15,6,21,3,2014-02-03 19:53:03,2014-02-03 19:45:34
2907e65e33efabeb1fa1e9ae2abe013206254000...066ac986dbfce5f1033924efdfea3cead0845234,1,18,4,22,6,2014-01-31 23:36:45,2014-01-22 20:54:54
066ac986dbfce5f1033924efdfea3cead0845234...3e21edb5789c9d0b9cba461916427bdab3d1c83a,1,57,0,57,2,2014-01-31 23:36:45,2014-01-27 22:59:35
1a421a88054c1e1e840ca8e0dcc9afb8720bd694...be0bce89c1015c3c4bb3a86adcc97abf3f056071,1,4,2,6,2,2014-02-14 08:24:49,2014-02-03 07:31:08
be0bce89c1015c3c4bb3a86adcc97abf3f056071...ea793cb9064543842eb7be5457bc8e3813b0d5e4,6,52,0,52,6,2014-02-14 08:24:49,2014-02-14 08:17:08
ea793cb9064543842eb7be5457bc8e3813b0d5e4...d4328d89b9d66997949844390a4da5cf230b7ccf,1,2,0,2,1,2014-02-14 08:24:50,2014-02-14 08:20:12
ea5050497da1d24194c44c5d27a91e9979e839ba...6c835722b67918f1cd1550d522711bdb37f8a8b4,1,23,15,38,12,2014-02-21 18:04:15,2014-02-21 18:04:15
6c835722b67918f1cd1550d522711bdb37f8a8b4...43858de596bd0eca5c75576ae8005e634a442183,2,11,7,18,2,2014-02-22 01:17:00,2014-02-22 01:17:00
43858de596bd0eca5c75576ae8005e634a442183...517da63f4147dc6876988d1dc05aacc5d658e799,1,4,1,5,1,2014-02-22 01:43:18,2014-02-22 01:43:18
517da63f4147dc6876988d1dc05aacc5d658e799...da4d0146988a45f7bf44406242ef2d054016a577,1,4,0,4,1,2014-02-22 03:21:14,2014-02-22 03:21:14
da4d0146988a45f7bf44406242ef2d054016a577...fbc2c7620e1834f732a42791667c6aa1b1f0499b,1,17,4,21,5,2014-02-22 03:22:45,2014-02-22 03:22:45
fbc2c7620e1834f732a42791667c6aa1b1f0499b...20bb8562f25747c138d2c26ca5d80e5229a5558b,1,4,13,17,2,2014-02-22 03:44:26,2014-02-22 03:44:26
20bb8562f25747c138d2c26ca5d80e5229a5558b...793dca0c524c1382b63cd747aaf5813ad05dd9a2,2,4,3,7,4,2014-02-22 03:58:53,2014-02-22 03:58:53
793dca0c524c1382b63cd747aaf5813ad05dd9a2...0bf8e3d9a58a16e49246506835ff59009400a785,1,46,40,86,8,2014-02-24 23:04:34,2014-02-24 23:04:34
0bf8e3d9a58a16e49246506835ff59009400a785...8f16d8e3db5256bc3d0f6d7432061a25ed309aeb,1,9,12,21,2,2014-02-24 23:27:23,2014-02-24 23:27:23
8f16d8e3db5256bc3d0f6d7432061a25ed309aeb...af682984a20d351b5cb4c7383f03c2857919b901,2,3,1,4,2,2014-02-24 23:28:16,2014-02-24 23:26:46
af682984a20d351b5cb4c7383f03c2857919b901...4b14c59f636d5dd6a4eee24bbe9d6bae440228cf,1,14,7,21,6,2014-02-25 00:40:04,2014-02-25 00:40:04
4b14c59f636d5dd6a4eee24bbe9d6bae440228cf...faf717fcf8fecfacbaa0a0468afd6bfac400e13f,1,1,1,2,1,2014-02-25 06:22:28,2014-02-25 06:22:28
faf717fcf8fecfacbaa0a0468afd6bfac400e13f...8082a15050d4aba6658a9d76b3bf20df5376a6e9,1,1,1,2,1,2014-02-25 06:23:02,2014-02-25 06:23:02
8082a15050d4aba6658a9d76b3bf20df5376a6e9...60a43a9f4a429af33b59291749b1d876f1609c3a,4,88,113,201,79,2014-02-25 06:44:53,2014-02-25 06:38:06
60a43a9f4a429af33b59291749b1d876f1609c3a...4d6a001e247e5c4661775e66765a1862c75c5c78,1,5,9,14,1,2014-02-25 18:16:46,2014-02-25 18:16:46
4d6a001e247e5c4661775e66765a1862c75c5c78...89b94eca551b576b2204647244e4b741d802357a,1,9,5,14,4,2014-02-25 21:34:52,2014-02-25 21:32:34
89b94eca551b576b2204647244e4b741d802357a...ed8e8d94e0cff166d99e365d0e38f2a2dc3d28c4,1,2,2,4,1,2014-02-25 21:34:52,2014-02-25 21:33:11
ed8e8d94e0cff166d99e365d0e38f2a2dc3d28c4...71f8494edcb47c110cb6673f5122250fe67d67f8,1,3,4,7,4,2014-02-25 23:11:12,2014-02-25 21:51:00
ea5050497da1d24194c44c5d27a91e9979e839ba...2534da0bab260c449f2d577846a627936889c0bc,1,34,10,44,11,2014-02-21 00:57:24,2013-12-21 11:29:26
2534da0bab260c449f2d577846a627936889c0bc...dfca9b4bb47d7b7745130982b7bc6cc3713cf4b2,2,59,52,111,18,2014-02-21 00:57:24,2014-01-24 09:40:46
dfca9b4bb47d7b7745130982b7bc6cc3713cf4b2...affa2cdf9c0ce0fd36544ce20187309a23cf449d,1,3,4,7,2,2014-02-21 00:57:24,2014-01-24 10:18:18
affa2cdf9c0ce0fd36544ce20187309a23cf449d...33c96ef319d0083c7628ad3d18d947e151537737,2,11,3,14,3,2014-02-21 00:58:48,2014-01-28 22:50:20
33c96ef319d0083c7628ad3d18d947e151537737...df082bbff6ed86bebcf0b0c3549b4e0efb74c262,1,9,5,14,4,2014-02-21 00:58:48,2014-01-28 22:50:47
df082bbff6ed86bebcf0b0c3549b4e0efb74c262...883e2f0000c320b015a97587a20b2c62a3efc407,1,3,3,6,2,2014-02-21 00:59:56,2014-01-28 22:51:06
883e2f0000c320b015a97587a20b2c62a3efc407...fe430f32f2167cf91d5700cfdf6a4daebcc5fd7f,1,1,1,2,1,2014-02-21 17:46:53,2014-02-21 17:46:53
81d9fdf4e37c783b7cb773e600138bf3227bb4f1...da6bc1d835583871db99f1e92ef1f128d8e2fd31,5,289,4,293,8,2013-10-02 18:43:44,2013-06-08 20:20:06
da6bc1d835583871db99f1e92ef1f128d8e2fd31...0d8bfbae8a6db367d1975e744ef7e54ffa296571,4,110,178,288,21,2013-10-02 19:01:21,2013-10-01 18:57:53
0d8bfbae8a6db367d1975e744ef7e54ffa296571...c3fb7741f6aa0d30deb9a941e495287b0f21ec12,2,58,0,58,4,2013-10-02 19:01:24,2013-10-01 21:21:35
c3fb7741f6aa0d30deb9a941e495287b0f21ec12...937bce6e5d4cbb133bc5e0797171e7cf0c14fe85,1,2,2,4,2,2013-10-02 19:01:24,2013-10-01 21:30:37
937bce6e5d4cbb133bc5e0797171e7cf0c14fe85...998e8059933fc609b02bc3a2e7f5da911b95dfbf,2,8,4,12,4,2013-10-02 19:01:24,2013-10-02 18:39:13
81d9fdf4e37c783b7cb773e600138bf3227bb4f1...b9d8fffddf43c0dd73adcbf9eb3df2c07ed09b37,1,1,1,2,1,2013-10-01 22:14:09,2013-10-01 22:14:09
b9d8fffddf43c0dd73adcbf9eb3df2c07ed09b37...53756bd80b11736eca3963ea26ba6eee62798f8a,1,17,5,22,6,2013-10-02 00:10:04,2013-10-02 00:05:17
53756bd80b11736eca3963ea26ba6eee62798f8a...bd77b172bd8c225a1252e41d21ed65868feacc4d,5,10,10,20,7,2013-10-02 00:14:30,2013-10-02 00:14:30
bd77b172bd8c225a1252e41d21ed65868feacc4d...c396f990b434f31df9d0a74dfee870fe27c24e16,1,2,2,4,1,2013-10-02 00:29:26,2013-10-02 00:29:26
c396f990b434f31df9d0a74dfee870fe27c24e16...009bd2dce2b0fc25a27a911e81387bc1d501ce72,1,4,0,4,1,2013-10-02 01:13:55,2013-10-02 01:13:55
009bd2dce2b0fc25a27a911e81387bc1d501ce72...dd842072b18e8b41dd981968d47f911adb00180c,1,33,0,33,1,2013-10-02 01:26:13,2013-10-02 01:26:13
bc8d745d4672324450600c3fd9e02dd60d3181bb...e63177346ac957321edeacfa8e59d802c317c390,4,176,0,176,12,2013-12-05 21:11:38,2013-11-14 17:48:05
e63177346ac957321edeacfa8e59d802c317c390...e7f28645cdfb6d639bf5f179f9d2b40c2d89e39f,4,82,108,190,22,2013-12-05 21:11:38,2013-11-15 14:36:27
e7f28645cdfb6d639bf5f179f9d2b40c2d89e39f...2ae1ea495f8cc649afa2454b2f5fbd41a42b5fcc,2,12,9,21,4,2013-12-05 21:11:38,2013-11-15 14:52:18
2ae1ea495f8cc649afa2454b2f5fbd41a42b5fcc...0e4ba1580de091e11c6c82db5c8d1de1c85f8d27,2,13,17,30,11,2013-12-05 21:11:38,2013-11-15 20:56:33
0e4ba1580de091e11c6c82db5c8d1de1c85f8d27...92df70cb4887cbe58a29b3137dfd20d88ea85f99,1,68,67,135,2,2013-12-05 21:11:39,2013-11-19 16:35:46
92df70cb4887cbe58a29b3137dfd20d88ea85f99...2f1ddc0e816e3082485125235f17420ca4f572f9,1,7,5,12,4,2013-12-05 21:11:39,2013-11-19 16:49:53
2f1ddc0e816e3082485125235f17420ca4f572f9...e7ef2a2406a5c0c8f747dfe62199d93760497134,1,12,7,19,4,2013-12-05 21:11:39,2013-11-19 17:11:53
e7ef2a2406a5c0c8f747dfe62199d93760497134...ccaeef516fcd7aa4a97b5446f1d06450d995fe37,10,137,63,200,22,2013-12-05 21:11:39,2013-11-19 20:40:58
ccaeef516fcd7aa4a97b5446f1d06450d995fe37...8644363f1a1b1ae7ad4dc278f111bb1ffa20efd8,3,46,1,47,3,2013-12-05 21:11:39,2013-11-19 21:51:35
8644363f1a1b1ae7ad4dc278f111bb1ffa20efd8...41f44b1ad6fc5818656768d61329427d3bc44ed0,4,44,28,72,14,2013-12-05 21:11:39,2013-11-20 21:13:03
41f44b1ad6fc5818656768d61329427d3bc44ed0...6462e2dae976588648f364faa3d239fee2da61f2,2,7,7,14,7,2013-12-05 21:11:39,2013-11-20 21:21:50
6462e2dae976588648f364faa3d239fee2da61f2...badb6e9d30bae0eb3b536addc926d6b8884a5f0a,3,28,14,42,7,2013-12-05 21:11:39,2013-11-20 22:28:45
badb6e9d30bae0eb3b536addc926d6b8884a5f0a...72eded7e2f1086900c3541d4f9969e5ae6a0620d,1,2,1,3,1,2013-12-05 21:11:39,2013-11-20 23:32:41
72eded7e2f1086900c3541d4f9969e5ae6a0620d...819019f08f9b599e1f7e5b38e3f203298b2dbf57,1,1,1,2,1,2013-12-05 21:11:40,2013-11-21 00:10:53
819019f08f9b599e1f7e5b38e3f203298b2dbf57...67a589be8b103d55104f74e3dbccf9ab883552e5,1,147,70,217,16,2013-12-05 21:11:40,2013-11-21 18:03:04
67a589be8b103d55104f74e3dbccf9ab883552e5...26e9fad0965a2f2d3597fda98c93f5943f826c4e,2,8,8,16,5,2013-12-05 21:11:40,2013-11-23 18:04:58
26e9fad0965a2f2d3597fda98c93f5943f826c4e...c1d97fde7cbaa0921c3bcfbaea294f0c2673fccb,5,43,1,44,5,2013-12-05 21:11:40,2013-11-23 18:34:31
c1d97fde7cbaa0921c3bcfbaea294f0c2673fccb...62fe9c62e5bd44e9c4f70caff8717d02382763e1,3,78,49,127,10,2013-12-05 21:11:40,2013-11-25 16:42:07
62fe9c62e5bd44e9c4f70caff8717d02382763e1...614d91b6b02bf34a334c76928a8fdd1d10ea3f88,9,22,43,65,12,2013-12-05 21:14:06,2013-11-25 18:19:56
614d91b6b02bf34a334c76928a8fdd1d10ea3f88...46afaec2151f7995a9754a2b7b604d4a738b2db9,12,212,196,408,41,2013-12-05 21:14:09,2013-11-26 16:32:26
46afaec2151f7995a9754a2b7b604d4a738b2db9...1bd29762062be2e088384a7cea8b073ec219cf13,1,10,19,29,9,2013-12-05 21:14:09,2013-12-03 07:23:08
1bd29762062be2e088384a7cea8b073ec219cf13...d1cb3742f38f81f34034e74f7d6d3c4034c651fd,1,4,8,12,4,2013-12-05 21:14:09,2013-12-03 10:40:17
d1cb3742f38f81f34034e74f7d6d3c4034c651fd...3229b3657845413beaeaf238d0e959b5b5b2444a,2,7,1,8,3,2013-12-05 21:14:09,2013-12-03 11:13:13
3229b3657845413beaeaf238d0e959b5b5b2444a...9181de2d1eb8f284dfa5396b407100f90c3be9a2,3,2,2,4,3,2013-12-05 21:14:10,2013-12-03 11:29:29
9181de2d1eb8f284dfa5396b407100f90c3be9a2...f328079780ff4c9dd2c77e23f07938d0a66970bc,5,16,9,25,10,2013-12-05 21:14:10,2013-12-03 11:49:34
f328079780ff4c9dd2c77e23f07938d0a66970bc...91ad6c0189f39e58f09cda830308162f36ef384f,4,5,5,10,5,2013-12-05 21:14:10,2013-12-03 11:57:28
91ad6c0189f39e58f09cda830308162f36ef384f...a3bbb6dfa129b52a909356f2d65f35128a3e6cf5,3,30,56,86,16,2013-12-05 21:14:10,2013-12-04 09:47:50
a3bbb6dfa129b52a909356f2d65f35128a3e6cf5...76c78645ffef31ca8730c889b410ecb8dc9250af,8,124,122,246,77,2013-12-05 21:14:10,2013-12-04 10:10:47
76c78645ffef31ca8730c889b410ecb8dc9250af...bd978adcbd95e72cc51bbaa7ddcb445134e7b379,1,5,0,5,1,2013-12-05 21:14:10,2013-12-04 10:25:53
bd978adcbd95e72cc51bbaa7ddcb445134e7b379...e253ecd46a8185d7bb2e92eed20da7983ce55b95,1,2,2,4,1,2013-12-05 21:14:10,2013-12-04 19:56:37
e253ecd46a8185d7bb2e92eed20da7983ce55b95...79f845f7352eaacc63d580171d014386db1739d4,1,9,6,15,1,2013-12-05 21:14:10,2013-12-04 20:09:07
79f845f7352eaacc63d580171d014386db1739d4...496936d21adf74332cc0ba3c16fc544f86e55167,3,7,4,11,4,2013-12-05 21:14:10,2013-12-05 04:43:58
496936d21adf74332cc0ba3c16fc544f86e55167...0a0059d0818c7b48531abab1688555870f737f6e,1,1,1,2,1,2013-12-05 21:14:10,2013-12-05 04:44:56
0a0059d0818c7b48531abab1688555870f737f6e...d4761610da08e7f93d33296fff6f55353c8bd7d0,1,2,2,4,2,2013-12-05 21:14:11,2013-12-05 04:54:11
d4761610da08e7f93d33296fff6f55353c8bd7d0...8ca859b786061453c44c11ebaad52fe4f90cdebc,1,13,4,17,2,2013-12-05 21:14:11,2013-12-05 04:54:36
8ca859b786061453c44c11ebaad52fe4f90cdebc...8f05510b59028ecedcb16f0f5a9ac96b72486e34,3,18,5,23,5,2013-12-05 21:14:11,2013-12-05 05:10:09
8f05510b59028ecedcb16f0f5a9ac96b72486e34...6a2c952cd56df2df85c843e8ee92b062589b3625,2,45,7,52,6,2013-12-05 21:14:11,2013-12-05 05:52:45
fca48342ad5ed4b31844089c318c82416ed8fa01...6fffbec675a872fce82eb8274c37ad656317177b,1,1,1,2,1,2013-08-13 00:03:08,2013-08-13 00:03:08
6fffbec675a872fce82eb8274c37ad656317177b...f2b9d0ccc187b1bdb45a19bce6bf1c20f0953bee,1,41,26,67,11,2013-08-13 00:12:54,2013-08-13 00:12:54
f2b9d0ccc187b1bdb45a19bce6bf1c20f0953bee...7c10ac4fb52cf10e38bb1b084b1ac1a43d6f76cf,2,63,8,71,4,2013-08-13 00:45:45,2013-08-12 22:31:07
7c10ac4fb52cf10e38bb1b084b1ac1a43d6f76cf...dba5933651b4f9497da5bceeec159567b7bb8f11,4,55,82,137,27,2013-08-13 01:05:34,2013-08-12 22:22:38
dba5933651b4f9497da5bceeec159567b7bb8f11...b6a67875e6ebcf4ad55fac6e3bbb65003994a1f8,1,12,6,18,1,2013-08-13 01:10:28,2013-08-13 01:09:54
b6a67875e6ebcf4ad55fac6e3bbb65003994a1f8...5413cddac9a057e4d65f28b7f76d6c15e0d54191,1,1,1,2,1,2013-08-13 01:36:12,2013-08-13 01:36:12
5413cddac9a057e4d65f28b7f76d6c15e0d54191...66f55ca64bd0d1ce004da70aec8339d03beda564,1,6,0,6,1,2013-08-13 05:23:24,2013-08-13 05:23:24
66f55ca64bd0d1ce004da70aec8339d03beda564...bfe4d2e8e680040d65eef452b64e7123ade39adb,1,1,1,2,1,2013-08-13 05:29:09,2013-08-13 05:29:09
bfe4d2e8e680040d65eef452b64e7123ade39adb...dd416e69ed600d59aef1af279c679fe4c0b1281f,1,2,0,2,1,2013-08-13 06:31:26,2013-08-13 06:30:26
dd416e69ed600d59aef1af279c679fe4c0b1281f...2471dcba7e089b05c0a2c53d2a23831e40f789a3,2,2,2,4,2,2013-08-13 06:40:32,2013-08-13 06:40:32
2471dcba7e089b05c0a2c53d2a23831e40f789a3...673b8462b12f80dbae0cadbab187c6544a56f37e,2,274,39,313,13,2013-08-13 08:32:23,2013-08-13 08:31:57
673b8462b12f80dbae0cadbab187c6544a56f37e...f5531b41a6ad7c34a3e73abb696f3179bb5d312d,3,52,51,103,22,2013-08-13 16:25:47,2013-08-13 16:25:47
f5531b41a6ad7c34a3e73abb696f3179bb5d312d...fb508ae12a43116328c8cddabf4981ba88e1b0c1,1,2,2,4,2,2013-08-14 19:57:43,2013-08-14 19:57:43
fb508ae12a43116328c8cddabf4981ba88e1b0c1...9ee1572097e6ae4d3e7651f2b33f0d0840ab6a17,1,5,3,8,1,2013-08-14 20:13:29,2013-08-14 20:13:29
9ee1572097e6ae4d3e7651f2b33f0d0840ab6a17...cf1ab2e76121bc74bc6fc813e7332ae6029ddd65,1,1,1,2,1,2013-08-14 20:15:00,2013-08-14 20:15:00
cf1ab2e76121bc74bc6fc813e7332ae6029ddd65...21df324a1dd640d90e136b6cdf2086bdd1c24129,5,5,5,10,5,2013-08-14 20:30:46,2013-08-14 20:30:46
fca48342ad5ed4b31844089c318c82416ed8fa01...e7168e6c2728712220c7c101219478a8694a7a5e,3,54,81,135,26,2013-08-12 22:22:38,2013-08-12 22:22:38
e7168e6c2728712220c7c101219478a8694a7a5e...39218170a75a9750b736371a8c6a1027ec3ef0b7,1,1,1,2,1,2013-08-12 22:30:26,2013-08-12 22:30:26
a9a99ceafd60687cb061c00a87cbadb43a84dd32...63327b507587dd00fc7b7c650521f028accf83fb,1,26,4,30,5,2013-08-07 20:53:13,2013-08-07 20:41:22
63327b507587dd00fc7b7c650521f028accf83fb...b7d810cbc6688d2b49e6c9facfd4a1d022901fc1,1,1,1,2,1,2013-08-07 22:05:00,2013-08-07 22:05:00
b7d810cbc6688d2b49e6c9facfd4a1d022901fc1...ca067ad816856e2ac3efbd4ca3e62822b0b7a371,1,4,3,7,2,2013-08-08 01:38:57,2013-08-08 01:38:57
ca067ad816856e2ac3efbd4ca3e62822b0b7a371...afa7cb6159cef2f071f72bda52bdb14c159c1d72,1,8,2,10,3,2013-08-12 19:20:23,2013-08-12 19:20:23
282e3585cf9609563ec34371a7f01365978993ba...817597eb0175039742d60681824f2f0fc5cd2221,3,5,7,12,4,2013-04-04 07:26:17,2013-04-04 07:15:42
817597eb0175039742d60681824f2f0fc5cd2221...8b7f400e698dd6340c00de6465f9eca72d86289b,2,3,41,44,2,2013-04-04 18:50:25,2013-04-04 18:50:25
8b7f400e698dd6340c00de6465f9eca72d86289b...1c8a66724270aa69a54f9b013874ad8a22189c74,5,5,5,10,5,2013-04-04 19:08:38,2013-04-04 19:08:38
5f222e60cc92b9427024b13fe74d145adbedb0b8...1e4838ccd38c2df142591a67d675ac38eb8a5630,1,11,0,11,1,2014-06-05 01:19:03,2014-06-05 01:19:03
1e4838ccd38c2df142591a67d675ac38eb8a5630...6394261d51e61b85299b83fdf8d74b069619edc7,1,21,9,30,4,2014-06-05 01:57:15,2014-06-05 01:57:15
6394261d51e61b85299b83fdf8d74b069619edc7...b5a0613f85002ee35732c01a27c0d9b1901ed0de,9,61,53,114,26,2014-06-05 20:18:51,2014-05-21 21:43:21
b5a0613f85002ee35732c01a27c0d9b1901ed0de...df2820ffd92bb39d71ed55d884e149fa52b1a376,1,62,41,103,6,2014-06-05 20:18:51,2014-05-23 04:04:16
df2820ffd92bb39d71ed55d884e149fa52b1a376...0f82f8406af420bd7d644d6801a203c663f0fb2c,1,0,1,1,1,2014-06-05 21:44:13,2014-06-05 21:44:13
0f82f8406af420bd7d644d6801a203c663f0fb2c...e3cfccb20602efb3265c413dc3882e35f54b108c,2,10,44,54,7,2014-06-06 01:14:25,2014-06-06 00:45:50
e3cfccb20602efb3265c413dc3882e35f54b108c...5f0067c4f82ed2dd6ab5b1c21b2479a8da94363a,2,8,1,9,2,2014-06-06 01:20:51,2014-06-06 01:20:51
5f0067c4f82ed2dd6ab5b1c21b2479a8da94363a...65b1eadf5376c404f8d6aed248097e3377a6196d,1,1,1,2,1,2014-06-06 01:31:20,2014-06-06 01:31:20
03aadebf558b17f0e2ea0f5a40dcfd773be63e33...c87613378b2e39cf6c88d03e1fe67934618912d1,1,6,11,17,5,2014-06-11 22:09:40,2014-06-10 21:58:34
c87613378b2e39cf6c88d03e1fe67934618912d1...83132a921f659a9abccea0e853437c5f5932a70d,1,1,1,2,1,2014-06-12 00:25:31,2014-06-12 00:25:31
83132a921f659a9abccea0e853437c5f5932a70d...8d1086aa7453aa8617365b2f8a2028e58600c3cb,1,10,0,10,1,2014-06-13 02:14:49,2014-06-13 02:14:49
8d1086aa7453aa8617365b2f8a2028e58600c3cb...eb4ad2c56643f1b4e7619e62208f57c36aa1d64f,2,0,83,83,2,2014-06-13 02:19:36,2014-06-13 02:19:13
eb4ad2c56643f1b4e7619e62208f57c36aa1d64f...cde31045a2a5547ec8ddd463f2a308e4422a1c18,1,5,2,7,1,2014-06-13 21:58:58,2014-06-13 21:51:36
cde31045a2a5547ec8ddd463f2a308e4422a1c18...f6b8549adcf51d70316355ad6e67c1ded9da5876,1,2,1,3,1,2014-06-13 22:23:25,2014-06-13 22:23:25
f6b8549adcf51d70316355ad6e67c1ded9da5876...4a5f2d544c2da561c4dc60605b736bc40d22d5fd,1,1,1,2,1,2014-06-13 22:28:07,2014-06-13 22:28:07
c5e5305a3b40b4486598c2a0f3569229e61b92b4...16be6bfff2d9e36ec9d927a0bee5d3a780c323f2,2,6,0,6,4,2014-06-11 19:09:10,2014-06-11 19:09:10
16be6bfff2d9e36ec9d927a0bee5d3a780c323f2...d80452e50b8dd14d841052da8ac12ed879cade3e,1,3,3,6,3,2014-06-11 19:13:20,2014-06-11 19:13:04
d80452e50b8dd14d841052da8ac12ed879cade3e...41800b2dbf1400960e2f1715c614070dea7086a8,3,714,683,1397,6,2014-06-11 19:27:31,2014-06-11 19:26:56
2554228e493876272d7a36173acad5d02448bfda...0950952c26bf018bbfc8930d36c115fc72007ca6,2,29,16,45,7,2014-06-13 03:24:19,2014-06-11 19:17:31
0950952c26bf018bbfc8930d36c115fc72007ca6...15804badf468b95b144727da484595ef1d26e36b,1,1,1,2,1,2014-06-13 03:24:19,2014-06-11 20:51:30
15804badf468b95b144727da484595ef1d26e36b...4f20802cf9476fae94629946667672eb39535405,1,25,16,41,17,2014-06-13 03:24:20,2014-06-11 22:06:39
4f20802cf9476fae94629946667672eb39535405...961965a7c5812ea323afb26c442c0d57232da3bf,1,1,1,2,1,2014-06-13 03:24:20,2014-06-11 22:25:34
961965a7c5812ea323afb26c442c0d57232da3bf...a6ecfb3825da96b27424bff00a4766a16313f3e0,2,8,1,9,2,2014-06-13 03:24:20,2014-06-12 06:11:01
273b70bea48a189bd73d7b0fbf45d8d4f0da5a6a...6b7a99101da6b441037b81de69e819c02134182c,1,22,0,22,1,2014-08-27 09:36:11,2014-08-27 09:36:11
6b7a99101da6b441037b81de69e819c02134182c...68c8a841555d5394bdc92ba805209c7708fcc966,1,87,69,156,5,2014-08-27 19:20:40,2014-08-27 19:17:22
68c8a841555d5394bdc92ba805209c7708fcc966...f1a7455d4cf85ad9f05c7f6b686f0fdbf1d2ec1f,5,175,129,304,9,2014-08-27 19:25:45,2014-08-27 03:24:37
f1a7455d4cf85ad9f05c7f6b686f0fdbf1d2ec1f...947dad28383066ef8a44ad462aed3da1000da3f6,1,5,0,5,1,2014-08-27 19:26:49,2014-08-27 19:26:49
947dad28383066ef8a44ad462aed3da1000da3f6...1b639e5853add3696d72a8c51fde5db65265189c,8,9,12,21,9,2014-08-27 21:28:03,2014-08-27 21:28:03
1b639e5853add3696d72a8c51fde5db65265189c...02e10f45328295c301dea08d4a892956a3dbea72,1,2,2,4,2,2014-08-27 22:03:25,2014-08-27 22:03:25
02e10f45328295c301dea08d4a892956a3dbea72...980e50ad0f96629663b27a270b2db130c5612ce8,12,17,17,34,17,2014-08-27 22:03:37,2014-08-27 22:03:37
980e50ad0f96629663b27a270b2db130c5612ce8...6cafa333452ec873135dde4c142b62a74b31ad63,1,2,2,4,2,2014-08-27 22:11:24,2014-08-27 22:11:24
6cafa333452ec873135dde4c142b62a74b31ad63...b0e0ccb5a4f555332a52e51d5f62ccb1ae99794e,7,7,7,14,7,2014-08-27 22:16:49,2014-08-27 22:16:49
b0e0ccb5a4f555332a52e51d5f62ccb1ae99794e...526f2149e0f12284c0bf5594a3bbc02e50171cf0,1,2,120,122,2,2014-08-27 22:17:10,2014-08-27 22:17:10
526f2149e0f12284c0bf5594a3bbc02e50171cf0...d374e5193a34342cb06c7c962018ec9115257da0,1,1,1,2,1,2014-08-27 22:51:17,2014-08-27 22:51:17
d374e5193a34342cb06c7c962018ec9115257da0...8e6b2faeca79ef84dbc0edc1a2fec5eb0f29b3b5,13,18,18,36,18,2014-08-27 22:52:21,2014-08-27 22:52:21
2732de966d73bf13141d4033962d56effd6ae32d...0a585e75026d0f855199dfd5fba212f55c1ab606,1,1,1,2,1,2014-08-26 15:55:46,2014-08-26 15:55:46
0a585e75026d0f855199dfd5fba212f55c1ab606...24b468fe88548c04ebe33478d0436198fec00577,1,9,9,18,6,2014-08-26 17:10:59,2014-08-26 17:10:59
24b468fe88548c04ebe33478d0436198fec00577...118ba8c01a408784dd25f2f0364c47aeaf97eaf7,1,2,3,5,1,2014-08-26 18:53:52,2014-08-26 18:53:52
522bcd81f63e9abc63766c8d47c67674ab47ca44...31a64e605a999568a98d4773ea3b6bc23d7a292a,2,41,92,133,21,2014-08-07 19:07:39,2014-08-07 19:07:39
31a64e605a999568a98d4773ea3b6bc23d7a292a...80396bd563ead4cbe4d3f51cf9c46e63fd551a7a,2,31,31,62,19,2014-08-07 21:32:06,2014-08-07 21:32:06
80396bd563ead4cbe4d3f51cf9c46e63fd551a7a...e2121168273c2117efdb9f737c92ef64f284f1a9,1,1,1,2,1,2014-08-07 21:34:57,2014-08-07 21:34:43
e2121168273c2117efdb9f737c92ef64f284f1a9...86ef1b5c8398aae9337eee11a3cc0c2e476a158f,1,2,0,2,1,2014-08-07 21:41:30,2014-08-07 21:41:30
86ef1b5c8398aae9337eee11a3cc0c2e476a158f...3bee8039eb5fc1d01a70d04f3b5652756ec0e5da,1,61,61,122,1,2014-08-07 22:26:55,2014-08-07 22:26:55
3bee8039eb5fc1d01a70d04f3b5652756ec0e5da...18e14e8e343cde0c0496fce9bfee6550a05007b9,1,61,61,122,1,2014-08-07 22:51:40,2014-08-07 22:51:40
18e14e8e343cde0c0496fce9bfee6550a05007b9...f3b9c7261b25d3780060ba047af691f71ca7ebe4,1,2,1,3,1,2014-08-07 23:18:14,2014-08-07 23:18:14
5675d3e29ac23a4b115e9af1e85f0323b6e55f0b...d7b403b5b696f6ae82522c64c8ec3cdb8c0d368d,1,3,3,6,2,2014-08-07 21:33:33,2014-07-27 02:17:58
d7b403b5b696f6ae82522c64c8ec3cdb8c0d368d...2d5c481e4913db716468c5bb37b5302eaa2de54a,3,8,6,14,7,2014-08-07 21:36:50,2014-08-07 21:35:10
2d5c481e4913db716468c5bb37b5302eaa2de54a...d8551ef6563baaebbbe8066c7dc424892e1465da,1,0,1,1,1,2014-08-07 21:37:26,2014-08-07 21:37:26
d8551ef6563baaebbbe8066c7dc424892e1465da...afd77b4d0efae7034799ee65ec2c11985f93d710,1,2,2,4,2,2014-08-07 21:41:47,2014-08-07 21:41:47
afd77b4d0efae7034799ee65ec2c11985f93d710...ce19e517e3b924e70afa58fa63971a74e49ddc0a,1,1,1,2,1,2014-08-07 21:44:55,2014-08-07 21:44:55
ce19e517e3b924e70afa58fa63971a74e49ddc0a...ed6e9be0d62834c22ebc8f4084fb5412a08a39c7,1,1,1,2,1,2014-08-07 21:50:25,2014-08-07 21:49:55
ed6e9be0d62834c22ebc8f4084fb5412a08a39c7...671c82e6180752e7d4f56c0336b2600b0b12d305,6,60,50,110,21,2014-08-07 23:27:23,2014-08-07 23:27:23
671c82e6180752e7d4f56c0336b2600b0b12d305...4cd1ea5d1f142a2cd72cf43f29d0a1521e1d8e41,4,19,7,26,8,2014-08-08 00:07:54,2014-08-08 00:06:13
4cd1ea5d1f142a2cd72cf43f29d0a1521e1d8e41...861c7557045d1e42fa399976dd9fe3be8271ad0d,1,4,1,5,4,2014-08-08 00:41:14,2014-08-08 00:41:14
861c7557045d1e42fa399976dd9fe3be8271ad0d...f1f94d71515adcde92fd71707c9a7366eee57352,1,1,0,1,1,2014-08-08 05:30:59,2014-08-08 05:30:59
f1f94d71515adcde92fd71707c9a7366eee57352...6dd5dc84f5428e5e6497b0aef7a7f89fc29c993a,5,40,43,83,11,2014-08-08 05:57:49,2014-08-08 05:57:49
6dd5dc84f5428e5e6497b0aef7a7f89fc29c993a...59257989e5402a5a355ba0ef07ad73e9e8502796,2,18,0,18,4,2014-08-08 06:37:01,2014-08-08 06:08:59
59257989e5402a5a355ba0ef07ad73e9e8502796...d2f950b594d31dad4d035821e1b6a996f3521d5d,1,1,1,2,2,2014-08-08 06:37:23,2014-08-08 06:37:23
d2f950b594d31dad4d035821e1b6a996f3521d5d...1a531aa3634acbc22de48ecb03bbb3115c2b4fb2,1,3,3,6,3,2014-08-08 07:04:14,2014-08-08 07:04:14
1a531aa3634acbc22de48ecb03bbb3115c2b4fb2...f4eefa1f0447e64fe63d257640be9a50a757f10e,7,7,7,14,7,2014-08-08 07:06:55,2014-08-08 07:05:40
f4eefa1f0447e64fe63d257640be9a50a757f10e...4d1f7b58d06cc32fb1ec1d9f5b18400bb0df210d,1,1,1,2,1,2014-08-08 07:30:36,2014-08-08 07:30:36
7c4af8d12fd627995f3a4aeb789b0d0247a5031d...bf0e0b61df4b5fd07f054cb51ca02aa092dbc88e,1,2,1,3,2,2014-07-31 22:05:56,2014-07-31 22:05:56
9a1551400016ffb7fddd8f409b09951e68ff288e...93483d12170b9a7d7bda29c5669f787fc3487fdb,1,6,6,12,4,2014-06-27 17:53:56,2014-06-27 17:53:56
93483d12170b9a7d7bda29c5669f787fc3487fdb...01cf5c6fd5236b96fe5d978314947d4546c7d679,1,1,1,2,1,2014-06-27 20:39:33,2014-06-27 20:39:33
01cf5c6fd5236b96fe5d978314947d4546c7d679...d17c190c52062540a2e96cb4d777cb135f6c20e7,1,5,5,10,3,2014-06-27 20:42:05,2014-06-27 20:40:03
d17c190c52062540a2e96cb4d777cb135f6c20e7...fe5ff812e4176bda95ff0f9c0954414edd7e64f4,1,1,1,2,1,2014-06-27 22:31:01,2014-06-27 22:30:50
fe5ff812e4176bda95ff0f9c0954414edd7e64f4...135b0b56e90e63f7a1ddb685eb0b5dd5a5ffbe21,1,1,1,2,1,2014-06-27 23:37:14,2014-06-27 23:37:14
135b0b56e90e63f7a1ddb685eb0b5dd5a5ffbe21...6bf6480569df0164eb5be52f728a14ccd07e4621,1,24,9,33,2,2014-06-27 23:48:20,2014-06-27 23:48:20
867fb617fbb26a6538b5b706e2801bb37ffa9246...e9e7237e8f495d78b25f1b933c168e1392f962e0,6,104,41,145,6,2014-06-26 00:07:32,2014-06-25 02:22:12
e9e7237e8f495d78b25f1b933c168e1392f962e0...33cd3a534444a5686b815bd3fca8c9c93e46e832,4,31,24,55,4,2014-06-27 20:40:06,2014-06-27 20:40:06
33cd3a534444a5686b815bd3fca8c9c93e46e832...c0edd2d6991aa99c5dc7ea08bd01f9a9c1f53fe4,3,26,18,44,13,2014-06-27 21:03:23,2014-06-27 21:03:23
c0edd2d6991aa99c5dc7ea08bd01f9a9c1f53fe4...5e0e227eb472c0d1105d60966ffb500cc8ba0fe8,1,0,15,15,1,2014-06-27 21:11:02,2014-06-27 21:10:58
867fb617fbb26a6538b5b706e2801bb37ffa9246...1f36fc19825e0fef1689e9ed882127d38d6ac07a,2,145,0,145,2,2014-06-24 19:16:19,2014-06-24 19:15:50
1f36fc19825e0fef1689e9ed882127d38d6ac07a...4cfe3838aa1b248f0cb0b8c6f12134e8860819ee,2,46,0,46,2,2014-06-24 20:49:45,2014-06-24 20:49:45
4cfe3838aa1b248f0cb0b8c6f12134e8860819ee...6ef7a1ca9e7805429e80afcb231c091c2b71e0a2,1,47,10,57,10,2014-06-24 21:17:44,2014-06-24 21:17:44
6ef7a1ca9e7805429e80afcb231c091c2b71e0a2...4984471983c56e3cd7730c690d28868cce61a582,3,43,11,54,9,2014-06-24 21:18:00,2014-06-24 21:18:00
4984471983c56e3cd7730c690d28868cce61a582...613189a4bc872fbc8e8146c4836b13b7c927d9d2,3,15,15,30,12,2014-06-24 22:06:04,2014-06-24 22:06:04
613189a4bc872fbc8e8146c4836b13b7c927d9d2...b152f98cb997fda99906b1903db6fb6b01680a5f,2,68,23,91,17,2014-06-24 22:06:27,2014-06-24 22:06:27
b152f98cb997fda99906b1903db6fb6b01680a5f...5965007d3d6d6865cf59c8445ba43cdd39290814,1,22,6,28,6,2014-06-24 22:34:21,2014-06-24 22:34:03
5965007d3d6d6865cf59c8445ba43cdd39290814...dcca743938712f621babc6d6206888ca2855bde9,1,41,17,58,12,2014-06-24 23:03:08,2014-06-24 23:03:08
dcca743938712f621babc6d6206888ca2855bde9...ecc392e662a1d1cb878a048d8d5978ac8d78787c,3,108,20,128,9,2014-06-26 00:57:25,2014-06-26 00:57:25
ecc392e662a1d1cb878a048d8d5978ac8d78787c...7eecf9a9ffac7f369ee8669af79b97bb175bb6b3,2,29,9,38,4,2014-06-26 01:08:41,2014-06-26 01:08:41
7eecf9a9ffac7f369ee8669af79b97bb175bb6b3...2bef2924a4d598839b2da8df5c7ecefd4f1ad510,3,8,4,12,5,2014-06-26 16:51:13,2014-06-26 16:51:13
2bef2924a4d598839b2da8df5c7ecefd4f1ad510...3480c67077814623ea98c72d43f27f9cea070e0f,4,50,34,84,11,2014-06-26 17:25:57,2014-06-26 17:25:57
3480c67077814623ea98c72d43f27f9cea070e0f...51a6445e11233391c6deede43663aaad26c11401,3,98,96,194,4,2014-06-26 17:32:07,2014-06-26 17:32:07
51a6445e11233391c6deede43663aaad26c11401...d7ef9efe12bf991abd6dce899abdca88ec324776,4,106,7,113,8,2014-06-26 22:14:08,2014-06-26 22:14:08
d7ef9efe12bf991abd6dce899abdca88ec324776...c01a9df8de2e1ae6422471fc92e5904b26eb7db6,5,23,10,33,11,2014-06-26 22:54:40,2014-06-26 22:54:40
c01a9df8de2e1ae6422471fc92e5904b26eb7db6...85b80d326619f1ad0cd0e237579a0ee6454bc1b5,6,179,19,198,19,2014-06-27 01:23:31,2014-06-27 01:23:31
85b80d326619f1ad0cd0e237579a0ee6454bc1b5...42c790e7972aa7d6c1faa79fe4815da3a367ef72,2,17,10,27,7,2014-06-27 01:58:36,2014-06-27 01:58:36
42c790e7972aa7d6c1faa79fe4815da3a367ef72...a4481cb6f555bcc8eb804e2cfd381bcfaf273ce7,1,1,1,2,1,2014-06-27 02:22:28,2014-06-27 02:22:28
a4481cb6f555bcc8eb804e2cfd381bcfaf273ce7...63a99da4d205c104869c24dbf065e3f964beafd5,2,2,2,4,2,2014-06-27 02:55:29,2014-06-27 02:55:29
63a99da4d205c104869c24dbf065e3f964beafd5...6be2b61bc4245c9a3ac667bbb8642794edce2733,1,4,4,8,3,2014-06-27 03:10:31,2014-06-27 03:10:31
6be2b61bc4245c9a3ac667bbb8642794edce2733...3dfde416e6d9b69c993e1897d561f2150b29aeb0,1,11,9,20,6,2014-06-27 03:29:35,2014-06-27 03:29:35
3dfde416e6d9b69c993e1897d561f2150b29aeb0...e3c53695d90e16f4b15270acd727dadcf44800fe,3,103,69,172,6,2014-06-27 16:34:01,2014-06-27 16:31:28
e3c53695d90e16f4b15270acd727dadcf44800fe...5c71982cf3a4aa4f074523ebf303d9b980ae6562,1,31,2,33,2,2014-06-27 19:49:06,2014-06-27 19:49:06
5c71982cf3a4aa4f074523ebf303d9b980ae6562...aacb940591bacd68a45490ffc3f3338e2cc9aff1,4,87,21,108,10,2014-06-28 04:45:01,2014-06-28 04:43:34
aacb940591bacd68a45490ffc3f3338e2cc9aff1...6caa66adee88be55c53cede088c0efb01e8510e0,1,8,3,11,2,2014-06-29 00:06:58,2014-06-29 00:06:49
6caa66adee88be55c53cede088c0efb01e8510e0...fea642cd965b30ed15454af4cfe4cfab4bbf1d5b,1,7,7,14,7,2014-06-30 01:59:42,2014-06-30 01:59:42
fea642cd965b30ed15454af4cfe4cfab4bbf1d5b...6459385fc0f5164d0104eb99f66a6f6dd6d090d4,4,129,119,248,28,2014-06-30 21:51:29,2014-06-30 21:51:29
6459385fc0f5164d0104eb99f66a6f6dd6d090d4...bac6974298fa620cfab22e331e810e611d652ff8,1,15,0,15,1,2014-06-30 22:05:35,2014-06-30 22:05:35
bac6974298fa620cfab22e331e810e611d652ff8...9dd5fac49c95000c2ffa4d31893578adb340f0d3,7,74,76,150,11,2014-06-30 22:36:33,2014-06-30 22:36:33
9dd5fac49c95000c2ffa4d31893578adb340f0d3...ab4bb8f9932c9314285c22f3fe5b0ef98c775f20,9,41,121,162,29,2014-06-30 22:45:12,2014-06-30 22:45:12
ab4bb8f9932c9314285c22f3fe5b0ef98c775f20...d6bd5654ce35c8c36e25f73824691703c7c1f898,5,53,25,78,16,2014-06-30 23:11:18,2014-06-30 23:11:09
d6bd5654ce35c8c36e25f73824691703c7c1f898...b2d620955b61140a306f5997bc6401e2a6d86c74,5,36,12,48,11,2014-06-30 23:37:13,2014-06-30 23:37:13
b2d620955b61140a306f5997bc6401e2a6d86c74...e0d6a2ef00e56f19e12872e670f00f47ce812d33,5,103,23,126,17,2014-07-01 00:49:03,2014-07-01 00:49:03
e0d6a2ef00e56f19e12872e670f00f47ce812d33...d1246f13ab563cb4d1060e9d921aa862cdecd641,2,19,15,34,11,2014-07-01 01:08:45,2014-07-01 01:08:45
d1246f13ab563cb4d1060e9d921aa862cdecd641...5c6f99b0925525ea286b58e34a35f7e0e5e3c5f9,1,1,1,2,1,2014-07-01 01:52:36,2014-07-01 01:52:36
5c6f99b0925525ea286b58e34a35f7e0e5e3c5f9...c885ef3e15c5293c437db381aba67f62e88e1538,1,1,1,2,1,2014-07-01 01:58:31,2014-07-01 01:57:42
c885ef3e15c5293c437db381aba67f62e88e1538...0766b13ba818d4321853d28f9ddc5a76aa59c5ce,2,9,1,10,2,2014-07-01 02:13:10,2014-07-01 02:13:10
0766b13ba818d4321853d28f9ddc5a76aa59c5ce...bc01e49b3a5f516c7f17ed8845db8226c2838bd9,1,3,1,4,2,2014-07-01 02:15:20,2014-07-01 02:15:20
bc01e49b3a5f516c7f17ed8845db8226c2838bd9...7aeb7b5cd40c73358c8a0c74b610c55ab49a6a7f,2,45,1,46,3,2014-07-01 02:16:52,2014-07-01 02:14:03
7aeb7b5cd40c73358c8a0c74b610c55ab49a6a7f...925d8b3c7778e20abfb7cd1b7f9cea2776722b6b,2,9,8,17,4,2014-07-01 02:19:45,2014-07-01 02:19:23
925d8b3c7778e20abfb7cd1b7f9cea2776722b6b...8f8957ce85dd6c7050c8d7f4cec166739d7e0605,1,0,0,0,0,2014-07-01 02:22:14,2014-07-01 02:21:59
8f8957ce85dd6c7050c8d7f4cec166739d7e0605...2d361b219f1f5f65b825dc575e43f3dab7013e10,1,1,1,2,1,2014-07-01 02:35:07,2014-07-01 02:35:07
2d361b219f1f5f65b825dc575e43f3dab7013e10...7d7f1cafcb3cce16e1d99edb800689ce805b18f5,2,32,9,41,7,2014-07-01 02:38:59,2014-07-01 02:38:41
7d7f1cafcb3cce16e1d99edb800689ce805b18f5...ecefa13e850e68ce761d2a54de97a0f051525fcf,1,8,4,12,2,2014-07-01 02:50:23,2014-07-01 02:50:23
ecefa13e850e68ce761d2a54de97a0f051525fcf...ab21aa2e7cd851830237b6dfceaa57d26f3d9435,4,24,2,26,5,2014-07-01 02:50:32,2014-07-01 02:50:11
ab21aa2e7cd851830237b6dfceaa57d26f3d9435...31a6cec54b854c25735d25436d26ffd85187ccde,3,16,6,22,4,2014-07-01 03:01:25,2014-07-01 03:01:25
2c99cdc883f3cfac6c9d36d5023a897aefbcfa4f...6ce6a3ec3fcac2d7adfae58eb02010e43dbf3836,1,1,1,2,1,2014-06-25 18:31:17,2014-06-25 18:31:17
6ce6a3ec3fcac2d7adfae58eb02010e43dbf3836...aef7993c852e987875bafd56e9f82c62db006314,2,21,4,25,7,2014-06-25 18:42:49,2014-06-25 18:38:33
aef7993c852e987875bafd56e9f82c62db006314...8d6ffd57f2bfb6201260142cc0984f86aee926cb,1,2,4,6,3,2014-06-25 18:50:38,2014-06-25 18:50:38
8d6ffd57f2bfb6201260142cc0984f86aee926cb...8a5869df926f084f02915aa0eedec18e9dc99279,1,7,0,7,1,2014-06-25 21:56:18,2014-06-25 21:55:01
8a5869df926f084f02915aa0eedec18e9dc99279...b2dd824fc02f03762af63a86afc383b9a582d16d,3,24,4,28,6,2014-06-25 22:59:40,2014-06-25 22:59:30
b2dd824fc02f03762af63a86afc383b9a582d16d...b062d5b16e4b45a02222a3b4f32e2c2ca7a324a4,1,1,1,2,1,2014-06-25 23:11:12,2014-06-25 23:11:12
b062d5b16e4b45a02222a3b4f32e2c2ca7a324a4...382be787107279669a6b022a62236fc426584c37,2,27,29,56,19,2014-06-26 00:33:55,2014-06-25 23:47:31
382be787107279669a6b022a62236fc426584c37...18e5bd3b6c57967c3624b644e19e3eb8528ad1a0,4,18,3,21,5,2014-06-26 02:16:56,2014-06-26 02:12:42
18e5bd3b6c57967c3624b644e19e3eb8528ad1a0...c93391532b8912fc180690356cfe5cc8444f7f84,1,9,3,12,3,2014-06-26 02:43:19,2014-06-26 02:43:19
c93391532b8912fc180690356cfe5cc8444f7f84...624571ba20c84d1fa1d52b0c383f2f97a246e3bf,2,4,2,6,2,2014-06-26 02:47:17,2014-06-26 02:47:17
624571ba20c84d1fa1d52b0c383f2f97a246e3bf...5cee6120f25150e7044e32cb1340f664249242a4,2,14,3,17,3,2014-06-26 03:03:40,2014-06-26 03:03:40
5cee6120f25150e7044e32cb1340f664249242a4...efd5a6de69651566f1ef76d72b41f14890948b76,1,4,0,4,1,2014-06-26 03:41:43,2014-06-26 03:41:43
efd5a6de69651566f1ef76d72b41f14890948b76...ff59e1c5b017eb9b36f0c9b6360fdcc4b7de543d,1,1,1,2,1,2014-06-26 05:16:11,2014-06-26 05:16:11
ff59e1c5b017eb9b36f0c9b6360fdcc4b7de543d...ee462d49b78e12a9158636a92bb208f2eae4a802,1,5,2,7,2,2014-06-26 05:16:25,2014-06-25 23:16:56
ee462d49b78e12a9158636a92bb208f2eae4a802...125a2ba76f3477a3c642f3659723b5874e15c137,1,3,0,3,1,2014-06-26 05:16:25,2014-06-26 05:14:03
125a2ba76f3477a3c642f3659723b5874e15c137...ecff10c23ee8a1e4d3c21fc6615b6518dcaae969,7,88,54,142,32,2014-06-26 05:16:55,2014-06-26 05:15:41
ecff10c23ee8a1e4d3c21fc6615b6518dcaae969...881381479be392d75e5c330049e35be9f3361868,1,1,0,1,1,2014-06-26 05:24:59,2014-06-26 05:24:59
881381479be392d75e5c330049e35be9f3361868...7d9a2ff6f3ed19b53102408ac52df4bd3681000d,5,74,36,110,13,2014-06-26 05:44:13,2014-06-26 05:43:59
7d9a2ff6f3ed19b53102408ac52df4bd3681000d...822f8fa2da7f6b41bde6ec6d23283fcfec55ec21,3,126,89,215,24,2014-06-26 06:36:03,2014-06-26 06:36:03
822f8fa2da7f6b41bde6ec6d23283fcfec55ec21...8ce251c46e6c004b17840ce5f000936056cd6c82,1,35,12,47,4,2014-06-26 07:38:49,2014-06-26 07:38:49
8ce251c46e6c004b17840ce5f000936056cd6c82...6d4767d471a21bdf0b8ff89365538d218a070852,2,2,2,4,2,2014-06-26 20:52:26,2014-06-26 20:52:26
7cd433a2694b30eac2049f6a00cc0b852b537efa...a5e07f836611178abba37a744ed683c53571aa45,1,1,0,1,1,2014-05-21 18:43:06,2014-05-21 18:42:45
a5e07f836611178abba37a744ed683c53571aa45...df9af60fe2a96b4816920d7ebaa2d30e3faf0352,1,1,0,1,1,2014-05-21 18:58:20,2014-05-21 18:58:20
df9af60fe2a96b4816920d7ebaa2d30e3faf0352...91aa5204ed55535ef3a386a1edba24d1ae05490a,5,60,1,61,5,2014-05-21 21:12:58,2014-05-21 18:47:44
91aa5204ed55535ef3a386a1edba24d1ae05490a...4fd4383bc0e2c66cbdc3e2eab9a3922a86a7b3b4,2,9,2,11,3,2014-05-21 21:12:58,2014-05-21 21:05:22
4fd4383bc0e2c66cbdc3e2eab9a3922a86a7b3b4...4ac2c4476d6f626fe4365497df38e2bc36ba7df7,1,3,0,3,1,2014-05-21 21:15:57,2014-05-21 21:15:57
4ac2c4476d6f626fe4365497df38e2bc36ba7df7...29602725ffced81a6e4b8aa919a8dd90b5dd5d38,3,6,5,11,6,2014-05-21 23:18:59,2014-05-21 23:18:59
29602725ffced81a6e4b8aa919a8dd90b5dd5d38...2db7490db5a0efde738c58c920e002b28a34234c,1,1,1,2,1,2014-05-21 23:19:43,2014-05-21 23:19:43
5c23ec2e36e3f30ec87f49348eb82608189b2d06...8e464ec2c23f37f2b864a3c9c73c52c8acfe2ab1,1,12,1,13,1,2014-06-10 03:13:46,2014-06-10 03:13:46
8e464ec2c23f37f2b864a3c9c73c52c8acfe2ab1...9048528fd8500a8fd13def0e5969db22ebafdb9b,2,9,5,14,4,2014-06-10 03:47:22,2014-06-10 03:47:22
9048528fd8500a8fd13def0e5969db22ebafdb9b...8d51b2092870dc6f1e94233c570e1d54c66112ca,4,145,20,165,18,2014-06-16 22:31:24,2014-06-16 22:31:24
8d51b2092870dc6f1e94233c570e1d54c66112ca...beb51fab1ca8bed01952902a447cc1a91568072d,2,8,2,10,3,2014-06-18 00:32:29,2014-06-04 03:56:41
beb51fab1ca8bed01952902a447cc1a91568072d...690d6d5ab22a9412c489f2b24f1a8bcd44d9d478,7,45,1339,1384,10,2014-06-19 19:09:16,2014-06-19 19:08:27
690d6d5ab22a9412c489f2b24f1a8bcd44d9d478...ff0708bb39f90d7d024e34b27bb03d07fcb1fbe7,1,1,1,2,1,2014-06-20 17:04:00,2014-06-20 17:04:00
ff0708bb39f90d7d024e34b27bb03d07fcb1fbe7...91de0eff62dd371d148be9ae40712c28e60739fd,5,30,37,67,19,2014-06-20 22:24:54,2014-06-20 22:24:54
91de0eff62dd371d148be9ae40712c28e60739fd...0436c1ce20a647197c03ef50511f31e5bb6e9803,1,15,13,28,3,2014-06-21 00:53:06,2014-06-21 00:53:06
0436c1ce20a647197c03ef50511f31e5bb6e9803...5dbd5218f32542efe42e20a9cf23d3c799ecbe62,1,5,5,10,5,2014-06-21 02:29:53,2014-06-21 02:29:53
5dbd5218f32542efe42e20a9cf23d3c799ecbe62...e4d9d32a716f52ad9bafa44bdb91078efa2aad91,1,4,7,11,4,2014-06-21 22:54:18,2014-06-21 22:54:18
e4d9d32a716f52ad9bafa44bdb91078efa2aad91...84b17ba5dba39d78b711e281ced4cda66460830e,1,5,5,10,3,2014-06-21 22:58:28,2014-06-21 22:58:28
84b17ba5dba39d78b711e281ced4cda66460830e...c0cc41b8acdf71c81939257cf110fc5248e827c1,1,1,1,2,1,2014-06-22 01:15:27,2014-06-22 01:15:27
c0cc41b8acdf71c81939257cf110fc5248e827c1...9a5e856bdff7200761b1285be04d090262233754,1,23,23,46,2,2014-06-22 01:15:48,2014-06-22 01:15:48
9a5e856bdff7200761b1285be04d090262233754...72d9cb9b900893aecef92801f9c43b7dc303500d,2,25,3,28,3,2014-06-22 01:16:12,2014-06-22 01:16:12
72d9cb9b900893aecef92801f9c43b7dc303500d...a72c497276fb02596d1b06f86fd8c477265155b3,3,5,5,10,4,2014-06-22 01:19:09,2014-06-22 01:19:09
a72c497276fb02596d1b06f86fd8c477265155b3...99d6545d701fd33c74e6255d0282935f29e0ca44,2,2,32,34,3,2014-06-22 01:20:36,2014-06-22 01:20:36
99d6545d701fd33c74e6255d0282935f29e0ca44...0940e4dde87f66312e51915c92b7ff069f15c4c4,3,10,51,61,11,2014-06-22 01:21:50,2014-06-22 01:21:50
0940e4dde87f66312e51915c92b7ff069f15c4c4...1ebafb4d8c9f6e283e9b1bd0ef582da2c2aea24c,4,4,505,509,5,2014-06-22 01:25:57,2014-06-22 01:25:44
1ebafb4d8c9f6e283e9b1bd0ef582da2c2aea24c...15d23022b2ac96587c3e337fceab17b715d2b2ff,9,4,2340,2344,9,2014-06-22 01:34:18,2014-06-22 01:34:18
15d23022b2ac96587c3e337fceab17b715d2b2ff...14d64c6cfb2336267cfda89ebe4bd332ba569a47,3,3,239,242,3,2014-06-23 17:19:18,2014-06-23 17:19:18
471cc487e6ad4e70cc7a8e907215e396b110713c...7e2b8fc33bab2dc87f8d33294372c6573f49938f,5,45,21,66,21,2014-06-04 00:19:28,2014-06-04 00:19:28
7e2b8fc33bab2dc87f8d33294372c6573f49938f...393da3c07341b4168af35115556e15cc5b5860d2,1,0,1,1,1,2014-06-05 22:11:08,2014-06-05 22:11:08
393da3c07341b4168af35115556e15cc5b5860d2...eb749a7fb18418b9c042deda509ae7526cb238f9,1,22,16,38,6,2014-06-06 05:07:23,2014-06-04 21:15:00
eb749a7fb18418b9c042deda509ae7526cb238f9...e6ada9952663b3287c39846fc3bd3c37097fed27,2,69,7,76,7,2014-06-06 05:07:23,2014-06-04 21:59:45
e6ada9952663b3287c39846fc3bd3c37097fed27...2b424e96e5f51cb15550f31bfb61977469443753,2,76,30,106,30,2014-06-06 05:07:24,2014-06-05 22:32:48
2b424e96e5f51cb15550f31bfb61977469443753...799c20007cc88497c226332f58c2b65070a48bd0,1,29,41,70,9,2014-06-06 22:56:58,2014-06-06 22:56:58
799c20007cc88497c226332f58c2b65070a48bd0...0633b4855ddad656638415e2b4b3dbe9399f585f,1,14,4,18,2,2014-06-07 23:49:56,2014-06-07 23:49:56
0633b4855ddad656638415e2b4b3dbe9399f585f...a2c0b34ed81e232d90ed7c40cf52d59107a2c5b4,1,1,0,1,1,2014-06-09 20:43:12,2014-06-05 01:13:17
a2c0b34ed81e232d90ed7c40cf52d59107a2c5b4...20ef85f9c9892a7b02c0e7fa94f506f54ac8f529,1,1,1,2,1,2014-06-09 20:50:34,2014-06-09 20:50:34
20ef85f9c9892a7b02c0e7fa94f506f54ac8f529...cbf0850ca7b16ea1b6b5a827dfc7072aacd49de0,3,19,4,23,3,2014-06-09 21:04:37,2014-06-09 21:04:37
71917200b792cd444cd7bf8cc75ca146f21e7bf7...f8a1d52a33e2201eddc4c3c12fa0a63e2e6fdbae,1,24,3,27,3,2014-05-29 03:58:27,2014-05-29 03:58:27
f8a1d52a33e2201eddc4c3c12fa0a63e2e6fdbae...fe36e7e473cb44f6cf69cb657125779f1b8049b3,3,22,1,23,5,2014-05-29 15:23:29,2014-05-29 03:59:16
ebc6ac4c9d6cbe5175d4daed71251ed79ab09233...0a2b213682ccf3f2641316e44088ec4a99062698,4,32,25,57,11,2014-03-17 19:35:19,2014-03-17 18:35:29
0a2b213682ccf3f2641316e44088ec4a99062698...3da9c7db897594abf382919de34139b7cf723e2c,6,6,6,12,6,2014-03-18 07:59:03,2014-03-18 07:59:03
3da9c7db897594abf382919de34139b7cf723e2c...668f23f548ddc08dfe8af9f621ab9e8c43c4efea,2,6,2,8,3,2014-03-18 08:06:10,2014-03-18 08:06:10
668f23f548ddc08dfe8af9f621ab9e8c43c4efea...d97409a17dd86712f04c5a84a69df07a6a15a551,1,7,3,10,2,2014-03-18 08:22:43,2014-03-18 08:22:43
d97409a17dd86712f04c5a84a69df07a6a15a551...79ad5437c70c1d1930793e534dc664ac287914fe,1,5,0,5,1,2014-03-18 08:28:10,2014-03-18 08:28:10
79ad5437c70c1d1930793e534dc664ac287914fe...d3295f1f410cf3b51ef58a2eb34b5afb40955e02,3,9,28,37,7,2014-03-18 20:46:24,2014-03-18 20:46:24
d3295f1f410cf3b51ef58a2eb34b5afb40955e02...294a945e17720925f94be17ea99e197ba3b64da2,1,2,2,4,1,2014-03-18 21:02:22,2014-03-18 21:02:22
294a945e17720925f94be17ea99e197ba3b64da2...79551f0aa6e981732b988347961aeed6fcd86123,1,8,0,8,1,2014-03-18 21:08:30,2014-03-18 21:08:08
79551f0aa6e981732b988347961aeed6fcd86123...398d543cdd55899ef2c53b381f0c9be6b434bd5f,1,1,1,2,1,2014-03-18 21:12:38,2014-03-18 21:12:38
398d543cdd55899ef2c53b381f0c9be6b434bd5f...e699743d6d56bf8346bb4043a5cc5642394da5fb,4,4,4,8,4,2014-03-18 21:13:48,2014-03-18 21:13:48
4b2696eda4553a08878c55cf7fb2c93f2c762d7f...9968f19f8aa47ecb1eec1bc90fe7a96164281126,1,15,7,22,3,2014-03-17 09:17:05,2014-03-01 03:07:35
9968f19f8aa47ecb1eec1bc90fe7a96164281126...8822386d7b32f5a9397d7dc23b3063dc423307af,1,2,0,2,1,2014-03-17 09:17:06,2014-03-17 00:03:18
8822386d7b32f5a9397d7dc23b3063dc423307af...17ec29603cad54c41298df2178c895428cd9f568,4,117,23,140,12,2014-03-17 09:17:06,2014-03-17 00:22:00
17ec29603cad54c41298df2178c895428cd9f568...125051f2f8df931badb94c004d8c54e9b0cf7f21,2,60,4,64,5,2014-03-17 09:17:06,2014-03-17 01:39:03
125051f2f8df931badb94c004d8c54e9b0cf7f21...29cfa27ef3c1496170c251053955cf5bcd5439fb,4,48,4,52,6,2014-03-17 09:17:06,2014-03-17 02:09:51
29cfa27ef3c1496170c251053955cf5bcd5439fb...8488047c13047a22867cd737f3ddcf75bbee59f4,2,37,27,64,10,2014-03-17 09:17:06,2014-03-17 02:18:45
8488047c13047a22867cd737f3ddcf75bbee59f4...d4241aa998a11c2cf9ebeb9fa9e4c6c3a7bcbc40,1,99,95,194,12,2014-03-17 09:17:06,2014-03-17 08:08:29
d4241aa998a11c2cf9ebeb9fa9e4c6c3a7bcbc40...cda515249186e3cc05079ebf86473fff4556ba23,1,15,10,25,2,2014-03-17 09:17:06,2014-03-17 08:14:14
cda515249186e3cc05079ebf86473fff4556ba23...15fa6b2ab7b8820dd61448aa35ff295f9ccd834c,5,18,22,40,12,2014-03-17 09:17:06,2014-03-17 08:24:23
15fa6b2ab7b8820dd61448aa35ff295f9ccd834c...17297d98d7c5757f5168c0cb22a6b2e2017c2d02,2,7,5,12,4,2014-03-17 09:17:06,2014-03-17 09:16:16
17297d98d7c5757f5168c0cb22a6b2e2017c2d02...93e1969560f8bcdfcfffbf125507320acaced049,1,8,0,8,1,2014-03-17 09:56:07,2014-03-17 09:56:07
30cd85f95159e506c83d88b739a94d77362cbef7...b777b04a66e98b90f8541e19a7e8106d3e90b1d1,1,7,4,11,3,2014-03-24 21:24:03,2014-03-24 21:24:03
b777b04a66e98b90f8541e19a7e8106d3e90b1d1...883188dc70b5e792be0d231ff24e39954fc5a7d9,1,4,7,11,3,2014-03-24 21:37:28,2014-03-24 21:37:28
883188dc70b5e792be0d231ff24e39954fc5a7d9...5a1edba2ef73e79e5e29ab8ae513925938fc1e78,6,44,5,49,8,2014-03-25 00:45:05,2014-03-25 00:40:02
6e3aeaf26998ac90fccbb8a6bc5185eca87ff6f2...6dc90e73eb165e56ec7b35a54c1b2c5c0fa8956a,1,86,0,86,1,2014-04-22 21:21:51,2014-04-22 21:21:51
6dc90e73eb165e56ec7b35a54c1b2c5c0fa8956a...6597ce4585bef567e55e8cd60035ad61a3fcb7c9,3,79,37,116,15,2014-04-23 04:12:43,2014-04-23 04:12:43
6597ce4585bef567e55e8cd60035ad61a3fcb7c9...d084409eaa42e6394e1b18d7ac6e14d76a7d031d,1,38,15,53,6,2014-04-24 01:57:44,2014-04-24 01:57:44
3c1a06f033f082191cc026f71ea304963bf1c920...0f3dff7866228c81d721d859a6f376eff97dca4c,1,4,0,4,1,2014-01-15 21:05:43,2014-01-15 21:05:43
0f3dff7866228c81d721d859a6f376eff97dca4c...4cf8b41d5df73b4b51bf8921070720a856e8efc5,1,1,1,2,1,2014-01-15 22:32:43,2014-01-13 19:01:31
4cf8b41d5df73b4b51bf8921070720a856e8efc5...c8acc109f8f41d572e8745f16e542454bbd486c7,2,22,4,26,12,2014-01-15 23:50:17,2014-01-15 23:50:17
c8acc109f8f41d572e8745f16e542454bbd486c7...9513c4229144691988debf4cfee15c26c6986c16,7,163,122,285,85,2014-01-17 06:33:24,2014-01-17 00:56:54
f0983a0ddee078db577bb15f52bf833750990824...72cc8603b513b72332b615ed0c115c9d2534be75,1,1,0,1,1,2014-02-14 09:00:12,2014-02-14 09:00:12
72cc8603b513b72332b615ed0c115c9d2534be75...c5efe36bced47653e8726d41d25349603cac01c4,1,22,18,40,6,2014-02-14 09:06:18,2014-02-14 09:06:18
c5efe36bced47653e8726d41d25349603cac01c4...73a7a09ebec23faee36e675b5c6857b7d14c81df,3,53,53,106,37,2014-02-14 18:01:14,2014-02-14 17:32:56
73a7a09ebec23faee36e675b5c6857b7d14c81df...e1548ed0cd3d22b306968e818f131a21e1387f58,2,161,1,162,2,2014-02-14 22:58:59,2014-02-14 22:58:59
e1548ed0cd3d22b306968e818f131a21e1387f58...708a81865448f5581ddda24f7a1001e4d9f97d6c,1,1,1,2,1,2014-02-14 23:01:22,2014-02-14 23:01:22
708a81865448f5581ddda24f7a1001e4d9f97d6c...c847142344a9fa43bfaa010ab29c25a2bcc0c076,1,1,1,2,1,2014-02-14 23:02:51,2014-02-14 23:02:51
c847142344a9fa43bfaa010ab29c25a2bcc0c076...c248fcd673dd75572783fafa79d082c4412fc19a,1,2,1,3,1,2014-02-14 23:03:39,2014-02-14 23:03:39
c248fcd673dd75572783fafa79d082c4412fc19a...75fbb90e8a2df775d9a33b8147ac10d80f2f8e2d,1,0,1,1,1,2014-02-15 01:14:11,2014-02-15 01:14:11
75fbb90e8a2df775d9a33b8147ac10d80f2f8e2d...f0b633e785dda941cd2cf3f58b94759248c9dc63,1,115,19,134,9,2014-02-15 01:51:02,2014-02-15 01:49:05
f0b633e785dda941cd2cf3f58b94759248c9dc63...b04aa12d39735df7dc8e1240b1bd45a38b898438,8,15,10,25,12,2014-02-15 01:59:59,2014-02-15 01:59:59
b04aa12d39735df7dc8e1240b1bd45a38b898438...bc0b1ce53c56564c369b81591ea8c2c41b6525ec,4,34,33,67,33,2014-02-15 02:30:15,2014-02-15 02:03:48
f21e63b4954d7b09d0ab24300c25ae136edcf731...69ba8feabd84453276df56bb371cac6fe77b3a68,5,70,70,140,5,2014-02-01 18:10:47,2014-02-01 18:10:47
69ba8feabd84453276df56bb371cac6fe77b3a68...e8dcd0d70780efbbaa6b3906c7826a3f32cb4ce0,1,0,5,5,1,2014-02-04 07:22:01,2014-02-04 07:22:01
dd842072b18e8b41dd981968d47f911adb00180c...5c08d1c70e0d5588578ddaf8dbed850c4b1aa5b8,2,45,39,84,17,2013-10-02 18:35:51,2013-09-20 19:28:51
5c08d1c70e0d5588578ddaf8dbed850c4b1aa5b8...e69cb036d01712808975f8630a1a8bb7a6757e69,1,1,1,2,1,2013-10-02 18:35:51,2013-09-20 19:37:46
e69cb036d01712808975f8630a1a8bb7a6757e69...be8ac4387fa7ffea3a5f8d2047b10dffb80b0818,5,11,10,21,7,2013-10-02 18:35:51,2013-09-23 17:04:41
be8ac4387fa7ffea3a5f8d2047b10dffb80b0818...d123e731ccf2e84fe4f1092f8e18532015838dd2,3,65,25,90,14,2013-10-02 18:36:25,2013-09-23 17:46:03
d123e731ccf2e84fe4f1092f8e18532015838dd2...7782d7c95f413b5aec5988fded0f0698371e3662,3,42,4,46,5,2013-10-02 18:36:25,2013-09-25 03:34:48
7782d7c95f413b5aec5988fded0f0698371e3662...f67cf78b2d3d2b576e7c0e2c90f02659f169c9a9,3,26,0,26,4,2013-10-02 18:37:27,2013-09-29 03:58:03
f67cf78b2d3d2b576e7c0e2c90f02659f169c9a9...ae6ab2d77503be44724227e1d7a288b8e70f66af,2,2,2,4,2,2013-10-02 18:37:27,2013-09-30 17:36:17
ae6ab2d77503be44724227e1d7a288b8e70f66af...e6e4c8a94edeae62732857f38c0afeaa716a57d7,2,18,9,27,7,2013-10-02 18:37:27,2013-10-02 18:34:17
b5cd66dedd014a8df7990f9160284c78103ef955...6eccf8cbbb074bd750851a3f75595011aa7533ed,2,12,2,14,5,2013-12-06 01:52:35,2013-12-06 01:51:26
6eccf8cbbb074bd750851a3f75595011aa7533ed...d16cd33242b23a86f4ccf6cb23002d9ba5f4eddd,1,3,3,6,1,2013-12-06 21:38:51,2013-12-06 21:38:51
d16cd33242b23a86f4ccf6cb23002d9ba5f4eddd...5a8fcee9570a31d3bb8caea38e5485e55d0c6ed0,1,3,1,4,1,2013-12-06 21:39:07,2013-11-26 08:30:34
5a8fcee9570a31d3bb8caea38e5485e55d0c6ed0...51b786c64c5a3be76f498a21df710350784a61eb,1,2,2,4,1,2013-12-06 21:40:59,2013-12-06 21:40:59
51b786c64c5a3be76f498a21df710350784a61eb...1eff62f0f3f449c4d852e572a3a4a7224d7ace84,1,1,1,2,1,2013-12-06 22:10:19,2013-12-06 22:10:19
1eff62f0f3f449c4d852e572a3a4a7224d7ace84...b556a474d3a704bc3065552e9c8513eef32d0cd0,1,3,1,4,1,2013-12-06 22:12:18,2013-12-04 10:53:39
afa7cb6159cef2f071f72bda52bdb14c159c1d72...cd8248cb33163954dd5af674d022b7f476e2b8cb,1,6,0,6,1,2013-08-12 21:35:29,2013-08-12 21:35:29
cd8248cb33163954dd5af674d022b7f476e2b8cb...2e7845af8024a7c64270f27fff9156e982de34bb,2,63,8,71,4,2013-08-13 00:41:00,2013-08-12 22:31:07
2e7845af8024a7c64270f27fff9156e982de34bb...d9da7b8f0337fb740e1f0d7f1e1ee8a809f809f5,1,2,0,2,1,2013-08-13 06:30:26,2013-08-13 06:30:26
afa7cb6159cef2f071f72bda52bdb14c159c1d72...654d6a51b2445c7af0e9788609e12c425331a908,1,29,1,30,2,2013-08-12 21:03:34,2013-08-12 21:03:34
65b1eadf5376c404f8d6aed248097e3377a6196d...d86ef2ce2395ee878c7a0608fe7528d7a7ff6ffa,2,33,20,53,10,2014-06-10 19:17:26,2014-06-10 19:17:26
d86ef2ce2395ee878c7a0608fe7528d7a7ff6ffa...9eb90b40faedcabf0e78931bb095b3b471c2c5ca,2,10,12,22,4,2014-07-09 19:41:47,2014-07-09 19:41:47
65b1eadf5376c404f8d6aed248097e3377a6196d...6be92962b3f657004761f832c5f2fd35c7b5b713,1,47,11,58,6,2014-06-09 21:52:26,2014-06-09 21:52:26
6be92962b3f657004761f832c5f2fd35c7b5b713...76cb9bd36fb940fe1ab627e1b8b515eb72e8b5fe,1,8,4,12,5,2014-06-09 21:55:27,2014-06-09 21:55:27
76cb9bd36fb940fe1ab627e1b8b515eb72e8b5fe...ef3eaa427a606b4e789346b2ad035db2dfd34731,2,17,2,19,3,2014-06-09 22:27:17,2014-06-09 22:27:17
ef3eaa427a606b4e789346b2ad035db2dfd34731...e2ac94b89d7568b98d474b8decc47cdf44818c8c,1,23,22,45,4,2014-06-09 22:53:17,2014-06-02 22:09:34
e2ac94b89d7568b98d474b8decc47cdf44818c8c...6aba501e46d3daac9da102cca8cb1409eaf8f379,1,4,4,8,3,2014-06-10 01:10:02,2014-06-10 01:10:02
6aba501e46d3daac9da102cca8cb1409eaf8f379...f6cb154770274d37165d035b52f976852bc73588,4,40,2,42,5,2014-06-10 02:13:23,2014-06-10 02:01:08
4a5f2d544c2da561c4dc60605b736bc40d22d5fd...1180597f0628487d5d33c9182fb345adc403d6ee,6,7,7,14,7,2014-06-17 01:17:21,2014-06-16 18:48:26
4a5f2d544c2da561c4dc60605b736bc40d22d5fd...c8a5800cf04502d59a746f29c3d5f5ef1a5a1462,1,4,1,5,1,2014-06-15 22:55:09,2014-06-15 22:55:09
c8a5800cf04502d59a746f29c3d5f5ef1a5a1462...d59ab1850d1196bc57be63e88137d9a637ad3809,1,10,6,16,6,2014-06-15 23:02:22,2014-06-15 23:02:22
d59ab1850d1196bc57be63e88137d9a637ad3809...36004dc4351f643de409be715096214b489da1bb,1,3,2,5,2,2014-06-17 02:20:19,2014-06-17 02:20:19
36004dc4351f643de409be715096214b489da1bb...f6084927f9c8166301a46f065d6fb32615df8c9c,1,3,2,5,2,2014-06-17 02:22:10,2014-06-17 02:22:10
f6084927f9c8166301a46f065d6fb32615df8c9c...21c4caf2f703f182cb79956edd2c23c762bf20c3,1,1,1,2,1,2014-06-17 02:22:33,2014-06-17 02:22:33
21c4caf2f703f182cb79956edd2c23c762bf20c3...7258643fbf9d0adb41ca6eb6391a92ff44028b49,1,4,2,6,2,2014-06-17 02:32:58,2014-06-17 02:32:58
7258643fbf9d0adb41ca6eb6391a92ff44028b49...4dfcba8bdc8e64a1a5becf2d088dc8527bdd0dc5,1,3,2,5,1,2014-06-17 02:36:52,2014-06-17 02:36:52
157ffd75821bcac9a46927fd0a4e8b33cb011185...82a9c34154eb236ccb3973581d70facd77b80104,1,1,1,2,1,2014-06-11 19:34:21,2014-06-11 19:34:21
82a9c34154eb236ccb3973581d70facd77b80104...6dee09d8d4f8d1f1d10d1c0c5e67f89b20541473,1,31,273,304,3,2014-06-11 20:18:15,2014-06-11 20:18:15
6dee09d8d4f8d1f1d10d1c0c5e67f89b20541473...5da7a763a91ed1229249ce367368d8fbe6c124a5,1,267,0,267,1,2014-06-11 20:36:02,2014-06-11 20:36:02
5da7a763a91ed1229249ce367368d8fbe6c124a5...d3ca5b0497924d4b141a34f75fcc5a0e8a647879,4,20,5,25,7,2014-06-11 21:41:46,2014-06-11 21:22:41
d3ca5b0497924d4b141a34f75fcc5a0e8a647879...a33517f984c91aacd4c4c2dc96cfe74de64fb658,1,2,2,4,2,2014-06-11 21:41:46,2014-06-11 21:24:13
a33517f984c91aacd4c4c2dc96cfe74de64fb658...9450c1c913474cb4869e71a45805b69185fe14d1,1,2,2,4,2,2014-06-11 21:41:46,2014-06-11 21:40:12
9450c1c913474cb4869e71a45805b69185fe14d1...23a031ff2e04c4c7e3f946621f3722ca565dc6cf,1,19,9,28,7,2014-06-11 22:22:57,2014-06-11 22:22:57
23a031ff2e04c4c7e3f946621f3722ca565dc6cf...1ce571ed921ba1b865bab3dc8e0bd64afa44f204,1,8,3,11,2,2014-06-11 22:29:39,2014-06-11 22:29:39
1ce571ed921ba1b865bab3dc8e0bd64afa44f204...d62e95a030cf4b0321350ff88fa1e244517212e4,1,3,4,7,1,2014-06-11 22:30:57,2014-06-11 22:30:16
d62e95a030cf4b0321350ff88fa1e244517212e4...f9e73da247ce2e00e0a6283e260996c147afb1d8,1,0,1,1,1,2014-06-11 22:32:12,2014-06-11 22:32:12
f9e73da247ce2e00e0a6283e260996c147afb1d8...bb0dfc112f5b71f195b8a75f37b2a72417262a4d,4,299,251,550,12,2014-06-11 23:13:41,2014-06-11 23:13:41
bb0dfc112f5b71f195b8a75f37b2a72417262a4d...f66e357353788b8acd67ad18780b1b72a8a26de6,4,60,21,81,10,2014-06-12 00:12:43,2014-06-12 00:12:43
f66e357353788b8acd67ad18780b1b72a8a26de6...55a1eba1dc47b31ff8ecb0af3569e88152be7c7b,1,0,51,51,2,2014-06-12 00:15:27,2014-06-12 00:15:27
55a1eba1dc47b31ff8ecb0af3569e88152be7c7b...1e011e1ae982c3a90652b6f9e1a03f135331719a,3,38,21,59,6,2014-06-12 00:37:04,2014-06-12 00:37:04
1e011e1ae982c3a90652b6f9e1a03f135331719a...e41f2238a4f593b78ed9e60e19a4bcb028d46f93,1,3,2,5,1,2014-06-12 01:06:38,2014-06-12 01:06:38
e41f2238a4f593b78ed9e60e19a4bcb028d46f93...8603c66b12e673c49968328e93021bc194066c41,2,27,6,33,13,2014-06-12 01:23:12,2014-06-12 01:23:12
8603c66b12e673c49968328e93021bc194066c41...562cc18ac867e668b960d22ff9a2058bc8e9d7b7,2,9,8,17,3,2014-06-12 03:08:35,2014-06-12 03:08:35
562cc18ac867e668b960d22ff9a2058bc8e9d7b7...a4ee2a841f99e65d47acfe4fb2a01869d81e24b3,2,11,6,17,5,2014-06-12 03:14:30,2014-06-12 03:14:30
a4ee2a841f99e65d47acfe4fb2a01869d81e24b3...a710408b1c35ea81e6ec155aa04e1337efc84eb4,3,20,8,28,8,2014-06-12 05:40:07,2014-06-12 05:40:07
a710408b1c35ea81e6ec155aa04e1337efc84eb4...3ddf41e8512f67088bfe8d1031674a5450a0fed1,2,177,2,179,5,2014-06-12 19:39:16,2014-06-12 19:39:16
3ddf41e8512f67088bfe8d1031674a5450a0fed1...663de9c75c3633c30d38fe2d07c71797a98966c8,1,110,9,119,11,2014-06-12 21:43:40,2014-06-12 21:43:40
663de9c75c3633c30d38fe2d07c71797a98966c8...5fd8dbaeaa2f785d76d2487213a78ef33bdaebef,3,91,0,91,3,2014-06-12 23:40:38,2014-06-12 19:15:07
5fd8dbaeaa2f785d76d2487213a78ef33bdaebef...7e80ad2ddfbd52565d8f3453b9923a7bfbe91988,3,30,8,38,7,2014-06-12 23:53:16,2014-06-12 23:53:16
7e80ad2ddfbd52565d8f3453b9923a7bfbe91988...ae9f28ad2d8b48f3dcf9c5b003649a23825a2470,1,2,1,3,1,2014-06-13 22:40:30,2014-06-13 22:40:30
ae9f28ad2d8b48f3dcf9c5b003649a23825a2470...7a23a2c988809dfe4ec644ea178e15a88b0b5e1c,2,47,49,96,9,2014-06-13 23:21:35,2014-06-13 23:21:35
7a23a2c988809dfe4ec644ea178e15a88b0b5e1c...7beedc48c7e76af510dead82657549799f92b9c0,1,3,4,7,3,2014-06-13 23:24:41,2014-06-13 23:24:41
7beedc48c7e76af510dead82657549799f92b9c0...d2ed5ab48d26a52b8258752472857acffa38b257,7,16,13,29,15,2014-06-13 23:28:37,2014-06-13 00:52:46
d2ed5ab48d26a52b8258752472857acffa38b257...07206eaecd0ed9025aea5bad387ff2ccacc2ab0b,2,7,1,8,2,2014-06-14 00:14:42,2014-06-14 00:14:42
07206eaecd0ed9025aea5bad387ff2ccacc2ab0b...2412a3493fe08153d7478e250973614bc6c9115f,2,6,1,7,2,2014-06-14 00:31:48,2014-06-14 00:31:48
2412a3493fe08153d7478e250973614bc6c9115f...3b160318446c9108dc8c0b10c41f84b6a52547a2,2,3,3,6,3,2014-06-14 00:39:36,2014-06-14 00:39:03
3b160318446c9108dc8c0b10c41f84b6a52547a2...d2aadf4e54f042ac392d5d6f7f7bab69e57f17c5,2,49,22,71,3,2014-06-14 01:01:18,2014-06-14 01:01:18
d2aadf4e54f042ac392d5d6f7f7bab69e57f17c5...c57280a01672a85e79720341c8e5773ea8e2ad58,2,31,17,48,10,2014-06-14 01:23:05,2014-06-14 01:21:03
c57280a01672a85e79720341c8e5773ea8e2ad58...73a39de634a884a5fc8ce3250983d7eef6f63c7d,2,84,59,143,11,2014-06-15 23:29:03,2014-06-14 01:32:39
73a39de634a884a5fc8ce3250983d7eef6f63c7d...9244e13626f4a0cabb9bd72494c52553545a4134,2,26,7,33,4,2014-06-15 23:29:03,2014-06-15 23:28:56
9244e13626f4a0cabb9bd72494c52553545a4134...012a27fd87d2a678454494ce58cbdce076c8b2d3,2,115,40,155,17,2014-06-16 01:39:02,2014-06-16 01:39:02
012a27fd87d2a678454494ce58cbdce076c8b2d3...b734baf6183c1b0d45230427a2a24c606de97d2d,2,22,5,27,3,2014-06-16 01:43:48,2014-06-16 01:43:48
b734baf6183c1b0d45230427a2a24c606de97d2d...e32ed6860ef2474b5fb88cb278da51462cdb3cff,3,34,8,42,9,2014-06-16 01:54:53,2014-06-16 01:54:53
e32ed6860ef2474b5fb88cb278da51462cdb3cff...74917e623db605680ab221ffd55a2e877246e424,4,5,196,201,10,2014-06-16 03:22:14,2014-06-16 03:22:14
74917e623db605680ab221ffd55a2e877246e424...a9fb0072b7336a940ac772b8d6882551f76370e8,1,12,0,12,4,2014-06-16 21:01:53,2014-05-14 18:59:03
a9fb0072b7336a940ac772b8d6882551f76370e8...6ea5ab0ed11455654e30319543d0292edce8752f,5,26,7,33,11,2014-06-16 21:02:47,2014-05-14 18:59:43
6ea5ab0ed11455654e30319543d0292edce8752f...69cd9ccd8cc4eeebcc42f01c666b9a118121cd28,2,0,2,2,2,2014-06-16 21:06:16,2014-06-16 21:06:16
69cd9ccd8cc4eeebcc42f01c666b9a118121cd28...6f637b6b4792d23e8754cebeab7fa5e7dd7a1ee5,1,1,1,2,1,2014-06-16 21:28:29,2014-06-16 21:28:29
6f637b6b4792d23e8754cebeab7fa5e7dd7a1ee5...8ff8040924b5404a5aee0ad567ec20e63806ce56,3,29,62,91,13,2014-06-16 21:38:47,2014-06-16 21:38:21
8ff8040924b5404a5aee0ad567ec20e63806ce56...4ef69db606562dfcc85020b13ed67e89b0116908,2,24,19,43,6,2014-06-16 21:49:13,2014-06-16 20:42:28
4ef69db606562dfcc85020b13ed67e89b0116908...f6847a2b52f7d7a1053b8effad70ba2ea43a03b1,1,3,5,8,4,2014-06-16 21:49:13,2014-06-16 20:43:55
f6847a2b52f7d7a1053b8effad70ba2ea43a03b1...7f2ec589b9beae622a50e093bbb7479dcf9bae96,1,1,3,4,2,2014-06-16 21:49:13,2014-06-16 20:49:19
7f2ec589b9beae622a50e093bbb7479dcf9bae96...f190d83731afa2e8030641111046b64f637ce734,1,6,9,15,1,2014-06-16 21:49:13,2014-06-16 20:54:43
f190d83731afa2e8030641111046b64f637ce734...60059c2bd10fa629bf30d9d2c16a01c379d86c57,1,14,5,19,6,2014-06-16 21:49:13,2014-06-16 20:59:59
60059c2bd10fa629bf30d9d2c16a01c379d86c57...9bc1589a1cd272ebf784a09f800e91b7e392d56c,1,16,11,27,7,2014-06-16 21:49:13,2014-06-16 20:51:29
9bc1589a1cd272ebf784a09f800e91b7e392d56c...dce4307dd160cd9f734ae4f940f06848d502dd8e,1,4,0,4,1,2014-06-16 21:49:13,2014-06-16 21:48:19
dce4307dd160cd9f734ae4f940f06848d502dd8e...722a99bb09b6cfb1900eaf8b91d81cc8c3d293f0,1,1,4,5,1,2014-06-16 21:49:36,2014-06-16 21:49:22
722a99bb09b6cfb1900eaf8b91d81cc8c3d293f0...10f427f8acd3da6e71b6e52a8581e37ac716b1d3,1,6,1,7,2,2014-06-16 22:45:15,2014-06-16 22:45:15
10f427f8acd3da6e71b6e52a8581e37ac716b1d3...600ae65304c4af1119055cbb308dea2535f24a1d,5,22,17,39,9,2014-06-16 23:33:07,2014-06-16 22:00:10
600ae65304c4af1119055cbb308dea2535f24a1d...6226860b58b73ab80edc1587d7ffa1630844eaf4,1,0,1,1,1,2014-06-17 00:27:14,2014-06-17 00:27:07
6226860b58b73ab80edc1587d7ffa1630844eaf4...bb77100672292481c348437b022d10d64d50a096,2,2,2,4,2,2014-06-17 04:03:07,2014-06-17 04:03:07
bb77100672292481c348437b022d10d64d50a096...b0f5ce0991b485cc177c6f1a053cb62038b4122c,1,20,7,27,11,2014-06-17 04:35:42,2014-06-17 04:34:18
b0f5ce0991b485cc177c6f1a053cb62038b4122c...fb709c9563ffb5f56b612e12de3e502aac745b36,159,0,11474,11474,159,2014-06-17 05:11:31,2014-06-17 05:11:19
fb709c9563ffb5f56b612e12de3e502aac745b36...15389fa740d2729bc3453098e8ecc4784ffdc84c,5,51,12,63,13,2014-06-17 06:06:10,2014-06-17 06:06:10
15389fa740d2729bc3453098e8ecc4784ffdc84c...d083f4aaf6f33f481ef634fc142047c95474b428,2,14,16,30,12,2014-06-17 16:40:59,2014-06-17 00:43:01
d083f4aaf6f33f481ef634fc142047c95474b428...f2501469b9261962b6711842c24a8d00cc6d6272,1,1,1,2,1,2014-06-17 16:40:59,2014-06-17 00:43:53
f2501469b9261962b6711842c24a8d00cc6d6272...a2663aeaafe3564ce855724053d3301665ca2229,2,2,1,3,2,2014-06-17 16:45:01,2014-06-17 16:44:48
a2663aeaafe3564ce855724053d3301665ca2229...2e5adc2659e1cbdf2fa2c740acd491e378645221,19,288,183,471,54,2014-06-17 21:26:29,2014-06-17 01:24:23
2e5adc2659e1cbdf2fa2c740acd491e378645221...848a5a2a38ad480ab12676e2f3ffdb850212461d,1,4,2,6,1,2014-06-17 21:56:14,2014-06-17 21:56:14
848a5a2a38ad480ab12676e2f3ffdb850212461d...15401c028b33e14a96509e93f81f7fb1dbd68dd7,1,15,3,18,1,2014-06-17 22:10:57,2014-06-17 22:10:04
15401c028b33e14a96509e93f81f7fb1dbd68dd7...b4bb435cce8b06de6f01f949e80d1fddf6469e3e,1,1,1,2,1,2014-06-17 22:28:19,2014-06-17 22:28:19
58182f2009de02c7182a7ac011f0bfb7a0203b80...dd034b3f0b1d67b24613b8f865dc317d67a0bc1c,1,24,5,29,1,2014-06-13 16:44:29,2014-06-12 22:16:26
c6401c692e60349108e3d92b4e9d2bee2f3ddebc...a30b811aa9b8d8498d8410fb812e4578fc93509a,1,15,3,18,2,2014-08-28 00:08:20,2014-08-28 00:06:48
cc16bcafe3f09cd0d100f72dbad9816adf83895e...922e1099a7ffb4e86996caf4d8dad6e2f817e32b,2,69,0,69,2,2014-08-27 15:54:18,2014-05-29 17:43:49
922e1099a7ffb4e86996caf4d8dad6e2f817e32b...a5d60f443f53547259de1aff6bbe77cea463c33b,1,79,1,80,2,2014-08-27 15:54:18,2014-05-30 21:29:20
a5d60f443f53547259de1aff6bbe77cea463c33b...a023e4b60c094984a0edfd890db7508b5909167b,1,1,1,2,1,2014-08-27 15:54:18,2014-08-01 18:40:35
a023e4b60c094984a0edfd890db7508b5909167b...554c5f81b6538c9877025dd14ec8624528dcdd94,1,27,6,33,5,2014-08-27 15:54:18,2014-08-01 19:06:20
554c5f81b6538c9877025dd14ec8624528dcdd94...aa0998750f56eaff2af7ac86b11f38bbb4d01eaf,1,147,0,147,1,2014-08-27 15:54:18,2014-08-01 19:06:52
aa0998750f56eaff2af7ac86b11f38bbb4d01eaf...96019ffe6691b35cf0c4c91bc3b2566b3f959c82,1,6,1,7,1,2014-08-27 15:54:18,2014-08-02 00:03:32
96019ffe6691b35cf0c4c91bc3b2566b3f959c82...d785da8dcd795ff1252b44511536c0d8fd667203,1,1,3,4,1,2014-08-27 15:54:18,2014-08-02 00:03:47
d785da8dcd795ff1252b44511536c0d8fd667203...2e7e9fbb9eab29aa1228e919a6b10d03f22009a8,1,3,0,3,3,2014-08-27 15:54:18,2014-08-02 00:06:17
2e7e9fbb9eab29aa1228e919a6b10d03f22009a8...a15b9ed7ae54b17cd06d03b91a6cd816beb2c69f,1,147,2,149,4,2014-08-27 15:54:18,2014-08-02 00:06:33
a15b9ed7ae54b17cd06d03b91a6cd816beb2c69f...c07f940ec28fff0538620917d316a569b9d29be8,1,0,7,7,7,2014-08-27 15:54:19,2014-08-02 00:09:54
c07f940ec28fff0538620917d316a569b9d29be8...f1e03a65398ccc32276ac4f85f8d909f74f5e7df,1,0,4,4,1,2014-08-27 15:54:19,2014-08-20 00:08:19
f1e03a65398ccc32276ac4f85f8d909f74f5e7df...5c884cbe117eb58d2f0ac485c82e3fb5f0b770db,2,0,91,91,4,2014-08-27 15:54:19,2014-08-20 00:08:29
5c884cbe117eb58d2f0ac485c82e3fb5f0b770db...1c991ee8b57007b6ff5fc559a18d020e64ce27d6,2,20,10,30,10,2014-08-27 15:54:19,2014-08-20 00:17:32
1c991ee8b57007b6ff5fc559a18d020e64ce27d6...f17be05c79162f65f72b7b0271c1bf1cfff228d2,1,48,35,83,14,2014-08-27 15:54:19,2014-08-20 00:44:17
f17be05c79162f65f72b7b0271c1bf1cfff228d2...f7c4e8a3b40502ca55365f566119933ff9286ea6,3,85,104,189,22,2014-08-27 15:54:19,2014-08-25 22:17:55
118ba8c01a408784dd25f2f0364c47aeaf97eaf7...f529220330a6ec6391e9bbc2ce91e430a0358187,1,1,1,2,1,2014-08-26 22:58:52,2014-08-26 22:58:52
f481e66ff1a8e79a95a8501dbad0b05e80ff922d...c256adaaa99d5f8242bd73cfadba381741499c15,1,0,290,290,1,2014-08-11 18:20:44,2014-08-11 18:20:44
c256adaaa99d5f8242bd73cfadba381741499c15...68725d55417c6fe49410cc17f67104e45e7a7664,1,2,1,3,1,2014-08-11 21:46:48,2014-08-11 21:46:48
4d1f7b58d06cc32fb1ec1d9f5b18400bb0df210d...a3e1ed79ffe155017d745bb368ef319ede99dcf5,1,2,2,4,1,2014-08-08 17:30:22,2014-08-08 17:30:22
a3e1ed79ffe155017d745bb368ef319ede99dcf5...1f6f15dc208dcb43a79184e768b71eefa204314e,3,95,90,185,25,2014-08-11 00:27:22,2014-08-11 00:27:22
1f6f15dc208dcb43a79184e768b71eefa204314e...c6aa178f22a294b6fef26cb578078c4270ec2d4f,1,1,1,2,1,2014-08-11 00:35:56,2014-08-11 00:35:56
c6aa178f22a294b6fef26cb578078c4270ec2d4f...64d939acb2566b94b55bc0c1f82b4fc6c6dc0db0,25,747,491,1238,167,2014-08-11 21:06:28,2014-08-08 18:10:37
bf0e0b61df4b5fd07f054cb51ca02aa092dbc88e...93b7a6fb1098ea5bf7147bb9b9cbbc170becf456,2,22,0,22,2,2014-08-01 02:58:16,2014-08-01 02:58:16
93b7a6fb1098ea5bf7147bb9b9cbbc170becf456...80b09735071e0b522be0fd63d84b9e523b70f490,1,7,3,10,4,2014-08-01 21:58:11,2014-08-01 21:58:11
80b09735071e0b522be0fd63d84b9e523b70f490...6166abde14b3c49cfb22fdbdca38b933f7275805,1,77,66,143,5,2014-08-01 21:59:48,2014-08-01 21:59:48
6166abde14b3c49cfb22fdbdca38b933f7275805...e7250a045fd3c6b817eb7562eb97032511a52d88,2,1,28,29,2,2014-08-01 22:01:26,2014-08-01 22:01:26
e7250a045fd3c6b817eb7562eb97032511a52d88...112198f3e8c7e1a4915065bdb2959c2553c40c92,1,2,2,4,2,2014-08-01 23:40:33,2014-08-01 23:39:43
112198f3e8c7e1a4915065bdb2959c2553c40c92...6345d92f0757043814d121e3a0431214d2cfe3ef,1,22,18,40,2,2014-08-01 23:44:04,2014-07-19 01:13:27
6345d92f0757043814d121e3a0431214d2cfe3ef...4b7adf83973c221eaefdaff76c735fb199263154,1,2,2,4,1,2014-08-02 00:04:24,2014-08-02 00:04:24
4b7adf83973c221eaefdaff76c735fb199263154...5ff811731050f7718a08b7199baa120e75c42e5b,2,4,6,10,3,2014-08-05 02:06:15,2014-08-05 02:06:15
5ff811731050f7718a08b7199baa120e75c42e5b...835eb66377c01f5dfbe247e56800e5f79978376f,1,1,1,2,1,2014-08-05 19:56:07,2014-08-05 19:56:07
26006d53dc25578c9fa4fb7794849a29095e1314...c5acfdf8c12b9c791bd4fb004e12df4b438a6f32,1,1,1,2,1,2014-07-31 02:24:47,2014-07-31 02:24:47
c5acfdf8c12b9c791bd4fb004e12df4b438a6f32...e59fb948b5fe2ef36af1fdfd4585f7413cd860ea,1,5,1,6,1,2014-07-31 02:24:55,2014-07-31 02:24:55
e59fb948b5fe2ef36af1fdfd4585f7413cd860ea...b11a623193456f98cd1d48141b4b2f58648e7c90,2,10,3,13,3,2014-07-31 03:38:27,2014-07-31 03:38:27
b11a623193456f98cd1d48141b4b2f58648e7c90...06a7dc90b54e2f22c575a9c17b850b99bad11966,20,331,158,489,88,2014-07-31 05:16:21,2014-07-31 04:00:33
6bf6480569df0164eb5be52f728a14ccd07e4621...8380beb8b8ac77e215a48c4d40564923c46ed4a7,1,1,1,2,1,2014-07-01 22:16:15,2014-07-01 22:16:15
8380beb8b8ac77e215a48c4d40564923c46ed4a7...6169bab86a45fd2c0beafe74e05b77f36c26182d,1,1,1,2,1,2014-07-01 23:19:55,2014-07-01 23:19:55
6169bab86a45fd2c0beafe74e05b77f36c26182d...d1698c43a60e8b130ef56c32505d19a15e283f7e,1,1,1,2,1,2014-07-02 01:42:42,2014-07-02 01:42:20
d1698c43a60e8b130ef56c32505d19a15e283f7e...90ddfdf135d43ac754894d90c208ac7b707e7b79,1,1,1,2,1,2014-07-03 21:20:51,2014-07-03 21:20:51
90ddfdf135d43ac754894d90c208ac7b707e7b79...d962d498c8a9e2c0ef3a81a62f0956b655fd1432,2,5,8,13,2,2014-07-07 18:45:03,2014-07-07 18:44:10
d962d498c8a9e2c0ef3a81a62f0956b655fd1432...478899c4d307576a95f35917df82a47e95d28013,2,19,1,20,5,2014-07-09 01:40:26,2014-07-09 00:59:31
478899c4d307576a95f35917df82a47e95d28013...ecb366f62e1a6cff3edeec25b84a8c74f10ab82b,2,2,2,4,2,2014-07-09 01:56:02,2014-07-09 01:55:21
ecb366f62e1a6cff3edeec25b84a8c74f10ab82b...3d058ad5ab5ff5379f0451d50cdba11f4ad4aead,3,43,1,44,4,2014-07-09 18:40:22,2014-06-20 18:08:57
3d058ad5ab5ff5379f0451d50cdba11f4ad4aead...59d3e31e1359f3c91a7b95f32eea9070f55bbc84,2,23,4,27,2,2014-07-09 22:01:31,2014-07-08 02:49:53
b21d87d142b3449e81335f63f1d522547693d34c...1ba01a4b191477e49cb94a6baa87ffe62eed64a8,3,0,474,474,3,2014-07-01 03:16:26,2014-07-01 03:16:26
1ba01a4b191477e49cb94a6baa87ffe62eed64a8...bae3b16ebcf4aa2f51c994adf1d3743ef343e7ce,3,41,46,87,3,2014-07-01 03:22:24,2014-07-01 03:22:24
bae3b16ebcf4aa2f51c994adf1d3743ef343e7ce...217313f04a31830802fb4def5addc97cc72b7d26,1,1,3,4,1,2014-07-01 03:27:42,2014-07-01 03:27:42
217313f04a31830802fb4def5addc97cc72b7d26...3d12c6dbfa4b61a880afc7fc9ff48025dc62568e,2,81,81,162,37,2014-07-01 03:28:02,2014-07-01 03:26:04
3d12c6dbfa4b61a880afc7fc9ff48025dc62568e...e4ca96af57ed155fe49c04467ede0c92f8846350,3,194,138,332,40,2014-07-01 17:18:56,2014-07-01 17:18:56
e4ca96af57ed155fe49c04467ede0c92f8846350...8c8887da7c5c0fb920a171a60bdfb8ce869ef6c4,1,10,10,20,8,2014-07-01 17:20:06,2014-07-01 17:20:06
8c8887da7c5c0fb920a171a60bdfb8ce869ef6c4...284529992ed06e5c4e4cbd874ef09d97a1e76296,2,12,3,15,2,2014-07-01 17:25:48,2014-07-01 17:25:48
284529992ed06e5c4e4cbd874ef09d97a1e76296...026216c38962c46d8cf6e4cd3ef433e58cf8ed98,1,1,1,2,1,2014-07-01 17:29:07,2014-07-01 17:29:07
026216c38962c46d8cf6e4cd3ef433e58cf8ed98...f93a570d27e40ad72fee9789e62d6d42e789dfcf,1,71,70,141,40,2014-07-01 17:34:26,2014-07-01 17:34:26
f93a570d27e40ad72fee9789e62d6d42e789dfcf...734816c7d7727dbe16d7ceef830e23fd0ba8d562,3,32,13,45,7,2014-07-01 17:57:46,2014-07-01 17:57:46
734816c7d7727dbe16d7ceef830e23fd0ba8d562...511e5ed64a1984b08c06a35561fda9996f21f342,2,3,3,6,3,2014-07-01 18:01:55,2014-07-01 18:01:55
6d4767d471a21bdf0b8ff89365538d218a070852...c6a94b7f1957eafef8008df66fd54ac33fc9d21a,2,9,7,16,5,2014-06-26 20:53:13,2014-06-25 04:17:54
c6a94b7f1957eafef8008df66fd54ac33fc9d21a...d346df0d5dde33a3ae1b84b848c248c7a3bee52a,1,5,1,6,2,2014-06-26 20:53:13,2014-06-26 06:18:48
d346df0d5dde33a3ae1b84b848c248c7a3bee52a...c0c7ecea480591ca24d4fd763d846619951a3e1d,2,3,6,9,4,2014-06-26 20:53:13,2014-06-26 06:18:56
c0c7ecea480591ca24d4fd763d846619951a3e1d...bfdc92dfac368d8fc506a441cabb51f475c828fe,17,90,5,95,18,2014-06-26 20:53:14,2014-06-26 06:26:02
bfdc92dfac368d8fc506a441cabb51f475c828fe...af7c8a3e6ef681d3022b8b5769a6b7929ace822c,2,1,4,5,2,2014-06-26 20:53:14,2014-06-26 06:49:36
af7c8a3e6ef681d3022b8b5769a6b7929ace822c...f2e1ef9946895cdbd8a1162f30d07ac41ae52744,1,4,1,5,1,2014-06-26 20:53:14,2014-06-26 18:57:54
f2e1ef9946895cdbd8a1162f30d07ac41ae52744...16a44ed9cf0407fdd66e36b536df9d7fe1970025,1,1,2,3,1,2014-06-26 20:53:14,2014-06-26 19:05:25
16a44ed9cf0407fdd66e36b536df9d7fe1970025...439f7d7231c3dbfba743c2676c30f5362a782d4d,1,1,1,2,1,2014-06-26 21:23:41,2014-06-26 21:07:31
2db7490db5a0efde738c58c920e002b28a34234c...278368692a03c0c9c4da5ffc131a0cc31586076b,2,49,14,63,8,2014-05-22 01:01:36,2014-05-22 01:01:36
278368692a03c0c9c4da5ffc131a0cc31586076b...d5a5ce49be9c30055c3d887d0cb57e8070ac5b94,3,9,11,20,5,2014-05-22 01:59:36,2014-05-22 01:59:36
cbf0850ca7b16ea1b6b5a827dfc7072aacd49de0...158357c545081a1f0ad225ed318a3f58bde49676,1,55,46,101,2,2014-06-09 21:19:03,2014-06-09 21:19:03
cbf0850ca7b16ea1b6b5a827dfc7072aacd49de0...f71643761ebee406e43da94ad1138e4424788049,1,1,1,2,2,2014-06-09 21:11:49,2014-06-09 21:11:49
5486fd0b337bdcfdb1b8e63dc34dce33e5e4d123...da96352c6588e010e78107a61ae2fb439a624abd,1,18,6,24,6,2014-03-17 19:11:21,2014-03-17 18:10:06
5a1edba2ef73e79e5e29ab8ae513925938fc1e78...592b539732ae5e73a3b5f5f9516df740ab0b8444,1,1,1,2,1,2014-03-25 22:02:03,2014-03-25 22:02:03
9513c4229144691988debf4cfee15c26c6986c16...3d8add8d9d94b98e4cb67c49e3f61a0c695ada20,1,23,0,23,1,2014-01-17 21:28:13,2014-01-06 22:38:47
3d8add8d9d94b98e4cb67c49e3f61a0c695ada20...80b8fcae2afc3d805220ba37a298a51748ad6cd8,1,13,4,17,4,2014-01-17 21:28:14,2014-01-09 22:29:35
80b8fcae2afc3d805220ba37a298a51748ad6cd8...d02617589403feca368f15532b5f6f21d25d6352,2,58,12,70,12,2014-01-17 21:28:14,2014-01-09 22:30:18
d02617589403feca368f15532b5f6f21d25d6352...4f0d2c9a04a2b11d0332fb3da506a658d44eefdc,1,27,8,35,4,2014-01-17 21:28:14,2014-01-09 23:53:11
4f0d2c9a04a2b11d0332fb3da506a658d44eefdc...cebd83e1fa333e74565a3e9d729469051dfaaeb8,1,4,2,6,1,2014-01-17 21:28:14,2014-01-09 23:53:42
cebd83e1fa333e74565a3e9d729469051dfaaeb8...3470d00dbc2951fe1467bc850a444aaf79bc47c1,2,16,5,21,5,2014-01-17 21:28:14,2014-01-10 04:33:55
3470d00dbc2951fe1467bc850a444aaf79bc47c1...0cfefa63d1320d1f5c25255eefd3296fbba04527,1,6,0,6,1,2014-01-17 21:28:14,2014-01-10 04:41:54
0cfefa63d1320d1f5c25255eefd3296fbba04527...ccdbe31356c675c0f66084cd8ed99dceb1e4ce65,2,15,4,19,5,2014-01-17 21:28:14,2014-01-11 01:51:54
ccdbe31356c675c0f66084cd8ed99dceb1e4ce65...7a528be92d884e73b0f528725412d3c199564350,3,36,12,48,12,2014-01-17 21:28:14,2014-01-16 00:09:10
bc0b1ce53c56564c369b81591ea8c2c41b6525ec...c09d5e1578adb43212f1b1bb6a774961f7d2009e,1,1,1,2,1,2014-02-15 02:46:57,2014-02-15 02:44:56
bc0b1ce53c56564c369b81591ea8c2c41b6525ec...cf2de810ce2daeaea88aea8b1dfe6687eba83ddd,1,1,1,2,1,2014-02-15 02:44:56,2014-02-15 02:44:56
cf2de810ce2daeaea88aea8b1dfe6687eba83ddd...87f22606ff19adc610eab93d30bb2a8e07a7b0a3,6,75,48,123,42,2014-02-15 22:46:59,2014-02-15 22:46:59
87f22606ff19adc610eab93d30bb2a8e07a7b0a3...9694b585df1eff7cca637fdb97732c2961af07e1,1,3,1,4,1,2014-02-15 23:19:18,2014-02-15 23:19:18
9694b585df1eff7cca637fdb97732c2961af07e1...4cfd34d1e973593401d0ae4ede5dfb8bbd7a461b,1,2,2,4,2,2014-02-17 01:58:15,2014-02-17 01:58:15
4cfd34d1e973593401d0ae4ede5dfb8bbd7a461b...b4c78fce39e1ea1a30113e6f2d87733d46f3cf8e,5,5,5,10,5,2014-02-17 18:02:54,2014-02-17 18:02:54
b4c78fce39e1ea1a30113e6f2d87733d46f3cf8e...927b0a06fc9b78d8b8b032981619885050928d3d,1,1,1,2,1,2014-02-17 18:07:44,2014-02-17 18:07:44
927b0a06fc9b78d8b8b032981619885050928d3d...bdd9e7e4b409268443796c1961ce7f7031b090b2,1,66,20,86,7,2014-02-17 18:52:42,2014-02-17 18:52:42
bdd9e7e4b409268443796c1961ce7f7031b090b2...2ef499f583b008363a1304426365efb50bd15b11,1,56,34,90,8,2014-02-17 19:10:53,2014-02-17 19:10:53
2ef499f583b008363a1304426365efb50bd15b11...784a14de5b28158cef3bfc393d1acf95c93a1853,1,55,0,55,1,2014-02-17 19:47:58,2014-02-17 19:47:58
784a14de5b28158cef3bfc393d1acf95c93a1853...e6f6fce4a2d5da33ff03dd34dbea6d633a4475d6,3,31,0,31,3,2014-02-17 23:18:08,2014-02-17 23:17:07
e6f6fce4a2d5da33ff03dd34dbea6d633a4475d6...418f560c4698fee423b44b254eebc76e60f459cd,1,3,1,4,1,2014-02-17 23:18:50,2014-02-17 23:18:50
418f560c4698fee423b44b254eebc76e60f459cd...b0efd08c5ded16dd3c29a779588f7aeabe4822d0,2,14,2,16,4,2014-02-17 23:38:55,2014-02-17 23:35:50
b0efd08c5ded16dd3c29a779588f7aeabe4822d0...3d5feb053549fda82f56684304c6fde87bc1821a,3,12,5,17,5,2014-02-17 23:49:45,2014-02-17 23:48:29
3d5feb053549fda82f56684304c6fde87bc1821a...39b61b4a417df16415a2cdee330067e002371075,1,1,0,1,1,2014-02-17 23:53:23,2014-02-17 23:53:23
39b61b4a417df16415a2cdee330067e002371075...8b25a5b045f244af9deeeb1ac28a0f9013b5c535,8,113,0,113,9,2014-02-18 03:48:20,2014-02-18 03:47:27
8b25a5b045f244af9deeeb1ac28a0f9013b5c535...977156db7fa723d06f5532fc1e7977ecb2ef8732,1,0,2,2,1,2014-02-18 03:48:43,2014-02-18 03:48:43
977156db7fa723d06f5532fc1e7977ecb2ef8732...64ce16830656b27830e55523bf3686adb96b70c5,2,8,3,11,5,2014-02-18 04:02:47,2014-02-18 04:01:27
64ce16830656b27830e55523bf3686adb96b70c5...a2355179dee1b4e1a3e32c1719742b16e83087d1,1,1,0,1,1,2014-02-18 04:03:24,2014-02-18 04:03:24
a2355179dee1b4e1a3e32c1719742b16e83087d1...b983537592f0471782a2d84eef21fbb9de32236c,1,3,5,8,3,2014-02-18 07:12:45,2014-02-04 21:31:55
b983537592f0471782a2d84eef21fbb9de32236c...79b03cd8b4ed834d324bb7cde57565d2021f5a8c,7,158,185,343,31,2014-02-18 07:12:45,2014-02-04 21:32:03
79b03cd8b4ed834d324bb7cde57565d2021f5a8c...b8250ecf66bcb5eec802c298f8e74af4857feafb,1,13,5,18,1,2014-02-18 07:12:45,2014-01-28 05:55:36
b8250ecf66bcb5eec802c298f8e74af4857feafb...9905a881f1113bfcb5ed7f248d7fbad9c14cc85a,1,0,3,3,1,2014-02-18 19:04:21,2014-02-18 05:47:32
9905a881f1113bfcb5ed7f248d7fbad9c14cc85a...c06b991b9072702dc7a345f570679b24bde0c41e,1,2,2,4,2,2014-02-18 19:04:21,2014-02-18 19:03:54
c06b991b9072702dc7a345f570679b24bde0c41e...ec63838822a00dcc4f7626a5a981f3ac62f5591d,5,40,3,43,8,2014-02-18 23:41:40,2014-02-18 23:34:13
ec63838822a00dcc4f7626a5a981f3ac62f5591d...5308ee7fbb1d1c843bd2dafd8a9c6b54aa4fb3e0,2,6570,6022,12592,1275,2014-02-18 23:47:42,2014-02-18 23:38:34
5308ee7fbb1d1c843bd2dafd8a9c6b54aa4fb3e0...a719db82908aa2cb5ac2e492519b264bb7583600,2,15,15,30,13,2014-02-18 23:47:48,2014-02-18 23:39:42
a719db82908aa2cb5ac2e492519b264bb7583600...0c62b815e7712f4d640be0014fc02ed823aacac0,3,694,521,1215,3,2014-02-18 23:47:54,2014-02-18 23:40:48
0c62b815e7712f4d640be0014fc02ed823aacac0...15602cbe165fd42d43e5b4efc87e6b829a33d05c,1,6,0,6,2,2014-02-19 06:18:11,2014-02-19 00:14:52
15602cbe165fd42d43e5b4efc87e6b829a33d05c...e3675cb040be67ac6f48da40248bfcedee0ac14a,2,2,2,4,2,2014-02-19 07:45:26,2014-02-19 07:22:49
e3675cb040be67ac6f48da40248bfcedee0ac14a...7e6505cf0a49789cf91b39e281df1c952dcde4ae,4,151,76,227,18,2014-02-19 07:45:26,2014-02-19 07:44:54
7e6505cf0a49789cf91b39e281df1c952dcde4ae...6b5dd8f61a77fa942890425728d09af5d92d2355,1,22,0,22,1,2014-02-19 07:45:26,2014-02-19 07:45:06
6b5dd8f61a77fa942890425728d09af5d92d2355...77b3d03b8fe5834572976d7804bc383f8d37f597,1,1,1,2,1,2014-02-19 18:20:02,2014-02-19 18:20:02
77b3d03b8fe5834572976d7804bc383f8d37f597...8f9f793c32840ad1cb01b68bf87fca989816fef2,2,97,5,102,3,2014-02-19 19:33:13,2014-02-19 19:25:22
e8dcd0d70780efbbaa6b3906c7826a3f32cb4ce0...e08aa89ca5b55b4737feadbea8b55b55832c9d67,1,3,3,6,2,2014-02-04 08:13:05,2014-02-04 07:43:36
90aac0ab5aaf5193bc9587c3c89beb533c07a2d7...8d9f97f358f650f37324c0c867272a019fd91787,1,4,1,5,1,2013-10-02 18:43:16,2013-10-02 18:43:16
b556a474d3a704bc3065552e9c8513eef32d0cd0...30e709006eaa8d3c7de286398cd0510951a046b7,1,1,1,2,1,2013-12-06 22:16:46,2013-12-05 10:47:10
30e709006eaa8d3c7de286398cd0510951a046b7...1ebcd8481199414b428ac21a528241c3b400826d,1,15,0,15,2,2013-12-06 22:27:12,2013-12-06 22:27:12
d9da7b8f0337fb740e1f0d7f1e1ee8a809f809f5...d477c8d03bb078f7e8e85dbe4b51db7ae5689573,1,9,2,11,4,2013-08-14 17:26:02,2013-08-14 17:24:37
f6cb154770274d37165d035b52f976852bc73588...b567046300c78d9b1d5f5b5f32c75bee6e20cc2f,10,289,254,543,78,2014-06-10 03:42:48,2014-05-31 17:28:29
b567046300c78d9b1d5f5b5f32c75bee6e20cc2f...644dde0382e77c21efbfc273018076be3e52c55c,1,1,1,2,1,2014-06-10 03:42:48,2014-05-31 20:30:32
644dde0382e77c21efbfc273018076be3e52c55c...ef697a6fa7b7ed5cacafea2be3231d9de4151380,7,73,438,511,38,2014-06-10 03:42:49,2014-06-02 23:42:12
ef697a6fa7b7ed5cacafea2be3231d9de4151380...338ede126602d5195b57febadad0416b8a36ea1c,2,12,12,24,11,2014-06-10 03:42:49,2014-06-04 14:55:03
338ede126602d5195b57febadad0416b8a36ea1c...254075587c6a726a19e5ad58a5f9f38441d14a75,7,98,27,125,20,2014-06-10 03:42:49,2014-06-04 22:06:00
254075587c6a726a19e5ad58a5f9f38441d14a75...55cecde4043dcfe37d355928a19b4c58a402eaaf,1,3,1,4,1,2014-06-10 03:42:49,2014-06-04 22:23:35
55cecde4043dcfe37d355928a19b4c58a402eaaf...e1669f464ca6bb8edf6a6f4f26209009b9e26ad0,3,102,55,157,37,2014-06-10 03:42:49,2014-06-05 01:24:42
e1669f464ca6bb8edf6a6f4f26209009b9e26ad0...d61a676ac3c98cbc6776b49275b0d29b5ce4cbcd,1,3,1,4,2,2014-06-10 03:43:40,2014-06-10 03:43:40
71d228f14fa720b623b8f782f3ca650945431f80...0a7b1b6acbc6f68701bf13e93a6495a60c9ba611,3,78,0,78,3,2014-06-17 19:26:48,2014-06-17 19:26:48
0a7b1b6acbc6f68701bf13e93a6495a60c9ba611...25dc9d93f4802972fcec6cf4a54e3e64bd845106,1,3,0,3,1,2014-06-17 20:49:21,2014-06-17 20:49:21
25dc9d93f4802972fcec6cf4a54e3e64bd845106...759d5797ad3ad78cc33ed1b530e7ce219c8b13fe,1,1,1,2,1,2014-06-17 20:55:53,2014-06-17 20:55:53
759d5797ad3ad78cc33ed1b530e7ce219c8b13fe...722b666ab652ced399987e6a4c527be9496f17e8,2,13,10,23,11,2014-06-18 23:12:10,2014-06-11 10:39:36
722b666ab652ced399987e6a4c527be9496f17e8...5b2c55fe330c345b44ee9d2bb2f44ed6d094b16e,1,6,0,6,1,2014-06-18 23:15:43,2014-06-18 23:15:43
5b2c55fe330c345b44ee9d2bb2f44ed6d094b16e...d180f9b02a131cd8eefe783c34d1e36e2f7287ef,1,1,1,2,1,2014-06-18 23:53:59,2014-06-18 23:53:59
d180f9b02a131cd8eefe783c34d1e36e2f7287ef...4bec4877e37ea5548c72636825b0579d404ccecb,4,31,6,37,6,2014-06-19 00:05:05,2014-06-19 00:02:03
4bec4877e37ea5548c72636825b0579d404ccecb...3c6c8e591ce4592aaf5350b3375e35435f843667,2,3,2,5,2,2014-06-19 00:38:05,2014-06-19 00:36:51
3c6c8e591ce4592aaf5350b3375e35435f843667...b31629de4ef44784d9da481275d252f4b7b18136,1,1,1,2,1,2014-06-19 01:35:12,2014-06-19 01:35:12
b31629de4ef44784d9da481275d252f4b7b18136...4f75911a0ade8179c40755c88abb41095f3a39ea,1,5,0,5,1,2014-06-20 18:53:51,2014-06-20 18:53:51
4f75911a0ade8179c40755c88abb41095f3a39ea...35f1dc45dd602514771697a2e45e71e6841682ed,2,16,4,20,3,2014-06-20 19:13:04,2014-06-20 19:13:04
35f1dc45dd602514771697a2e45e71e6841682ed...2ea77a940902146d91c854440f49ca847a6cde3f,2,7,2,9,3,2014-06-20 19:17:58,2014-06-20 19:17:58
b4bb435cce8b06de6f01f949e80d1fddf6469e3e...62004c0994134c910d0508595461a8dc72fd8946,1,6,2,8,2,2014-06-18 00:27:09,2014-06-11 21:14:57
62004c0994134c910d0508595461a8dc72fd8946...7f6ea3ddc2f12ad34f5e10cc8174e4341016ffc1,1,14,33,47,3,2014-06-18 00:27:09,2014-06-11 21:44:03
7f6ea3ddc2f12ad34f5e10cc8174e4341016ffc1...70b0115c890731c387abe08d55bce4f288ca17da,1,2,6,8,1,2014-06-18 00:27:09,2014-06-11 21:44:24
70b0115c890731c387abe08d55bce4f288ca17da...16cca651369d2e770cd2df001dbdb4dbac83ef91,1,9,0,9,1,2014-06-18 00:27:09,2014-06-11 21:44:35
16cca651369d2e770cd2df001dbdb4dbac83ef91...bc99786c91a4f9fcdddb48650e2ba078d76f5410,1,3,3,6,2,2014-06-18 00:27:10,2014-06-11 22:05:38
bc99786c91a4f9fcdddb48650e2ba078d76f5410...13ddd795e5765424ada5651922153367c85c6aa7,2,8,20,28,8,2014-06-18 00:27:10,2014-06-12 00:31:44
13ddd795e5765424ada5651922153367c85c6aa7...f10a3dda926757244bc06ea33abf9f19b30353e9,1,1,6,7,2,2014-06-18 00:27:10,2014-06-12 00:35:09
f10a3dda926757244bc06ea33abf9f19b30353e9...734768ce9e9ce35d8e5cf5767712d88a3287eb74,4,35,20,55,22,2014-06-18 00:27:10,2014-06-12 01:01:49
dd034b3f0b1d67b24613b8f865dc317d67a0bc1c...566302f1cb8d20acbc84e7b293cde153d584c03e,1,4,4,8,4,2014-06-14 21:23:08,2014-06-14 21:23:08
566302f1cb8d20acbc84e7b293cde153d584c03e...7336bf901bba49f8447d57ffaefc5d5837bbc2ac,2,9,2,11,9,2014-06-17 01:15:38,2014-06-17 01:13:00
7336bf901bba49f8447d57ffaefc5d5837bbc2ac...6b486301602b44201aee9752ec721fb4d979dde2,3,78,0,78,3,2014-06-17 21:02:17,2014-06-17 19:26:48
6b486301602b44201aee9752ec721fb4d979dde2...c25017edf07e507556c45787aaac2d986fc7ad33,1,3,0,3,1,2014-06-17 21:02:22,2014-06-17 20:49:21
c25017edf07e507556c45787aaac2d986fc7ad33...ae0fab33d2b560b78f2429154c11a5ec7a276a3d,1,1,1,2,1,2014-06-17 21:02:26,2014-06-17 20:55:53
ae0fab33d2b560b78f2429154c11a5ec7a276a3d...40e45cab001e58835ff10e045a72bbead1c28c18,1,20,3,23,2,2014-06-17 22:33:00,2014-06-17 22:33:00
40e45cab001e58835ff10e045a72bbead1c28c18...b84c7662f3adebb6067e5d4eb434bdd4a6538a6c,3,41,10,51,11,2014-06-17 23:58:54,2014-06-17 23:58:54
b84c7662f3adebb6067e5d4eb434bdd4a6538a6c...7d9c1da4447cb199eae9831660e3b7be650efe21,1,5,5,10,2,2014-06-18 04:09:14,2014-06-18 04:09:14
7d9c1da4447cb199eae9831660e3b7be650efe21...86aeec461ae1a129acf86ccce1d006bc29bb78f2,1,2,2,4,1,2014-06-18 05:32:21,2014-06-18 05:32:21
dd034b3f0b1d67b24613b8f865dc317d67a0bc1c...14f91d48c2017105fdd2fd7838c1f1a97dc659c0,7,21,16,37,19,2014-06-13 23:54:22,2014-06-13 23:54:22
e8ff8c8f0a590fb6ab923863cb95b82ab4b7f7d5...6fd2a7e7c9571b7aa1bf61198d79d320ecb99d28,1,1,1,2,1,2014-09-08 15:19:50,2014-09-08 05:42:03
6ca6641a349bebc60eb0ba04ec5a3219f767f8fa...590a733cd818d36c1972f392c3d53db5e6904926,1,1,0,1,1,2014-09-05 21:55:31,2014-09-05 21:55:31
590a733cd818d36c1972f392c3d53db5e6904926...497e47ca5b08981b393774c54cad8dc36c7085a2,2,2,2,4,4,2014-09-05 22:31:06,2014-09-05 22:31:06
497e47ca5b08981b393774c54cad8dc36c7085a2...663d78363659c852d2052f47555fecf6f3223ed5,1,4,1,5,2,2014-09-05 22:35:51,2014-09-05 22:34:58
663d78363659c852d2052f47555fecf6f3223ed5...e9f7f5a267a5adc42273caf11867f1aad9e81253,1,19,2,21,3,2014-09-05 22:55:32,2014-09-05 22:51:49
e9f7f5a267a5adc42273caf11867f1aad9e81253...c65f00887b4c5d685f7de79ac70da180d15d93bc,1,2,2,4,2,2014-09-05 23:25:04,2014-09-05 23:24:21
c65f00887b4c5d685f7de79ac70da180d15d93bc...f590ad3e1b6cf272fb89e9283c5c9407eddf12ea,1,17,8,25,1,2014-09-05 23:44:21,2014-09-02 23:19:33
f590ad3e1b6cf272fb89e9283c5c9407eddf12ea...398bd6f4b38a5dd74fdd32b58579e979e9020a7c,3,32,7,39,6,2014-09-05 23:45:40,2014-09-04 18:12:58
398bd6f4b38a5dd74fdd32b58579e979e9020a7c...c38f21fb382421cb5cd8468ad07f2771e8adc044,1,2,2,4,1,2014-09-05 23:45:49,2014-09-04 18:25:40
c38f21fb382421cb5cd8468ad07f2771e8adc044...79b52f32ec3939eb2522482b84e1bfeaa8a6eede,1,0,17,17,2,2014-09-05 23:45:56,2014-08-07 22:24:51
79b52f32ec3939eb2522482b84e1bfeaa8a6eede...2bc2a8f210188f27181a3a030dc8030fa933672e,3,15,3,18,5,2014-09-05 23:46:09,2014-09-04 23:47:18
2bc2a8f210188f27181a3a030dc8030fa933672e...b83d21d94daf4c8f2b3080952695a7ff737600b7,1,29,4,33,4,2014-09-05 23:46:19,2014-09-05 04:38:03
b83d21d94daf4c8f2b3080952695a7ff737600b7...93d39a22ad76f5e04b81f422910d9c1369d13770,1,5,1,6,1,2014-09-05 23:46:25,2014-09-05 05:07:22
186579ea5eb14bfa086444e38c16a8d28780f9fa...6432b493e339b6e52c96064376bc4bf39fe53c1b,3,15,3,18,5,2014-09-04 23:56:49,2014-09-04 23:47:18
2baaa8c98704cc4b4e848e34d97d5029f6d3e5de...28ec9e62d278e82e1c187c8f89ba376b6a0c04f3,1,8,5,13,4,2014-08-28 01:56:32,2014-08-28 01:44:15
83f3e53183f5c59f0039de7ba894a8468024b71f...d059106bba5e2fe2b1a3722f64249d945a9b0b98,1,0,22,22,1,2014-08-27 15:56:34,2014-08-27 15:56:34
d059106bba5e2fe2b1a3722f64249d945a9b0b98...3ce808aae5003f6cf0e1f1c78765a090821807a3,5,175,129,304,9,2014-08-27 16:46:36,2014-08-27 03:24:37
f529220330a6ec6391e9bbc2ce91e430a0358187...86ff4a0637e3dd7c166b636a87dd0644e40df796,1,2,1,3,1,2014-08-26 23:28:07,2014-08-26 23:28:07
02fccd56d8fd70837407a325c1a6724682f57329...8aa9d858d09e305656dfb678bd199393cd61ba56,1,0,1,1,1,2014-08-26 19:35:03,2014-08-26 19:35:03
8aa9d858d09e305656dfb678bd199393cd61ba56...5eae6f409e80dde882dca78d6c1529801daf3c6c,4,2,26,28,5,2014-08-26 21:12:30,2014-08-26 21:12:30
5eae6f409e80dde882dca78d6c1529801daf3c6c...c93ac97c10af723a90cfa630eeb02bfef5ec3884,8,24,51,75,20,2014-08-26 22:53:24,2014-08-26 22:53:05
68725d55417c6fe49410cc17f67104e45e7a7664...33440ebd7af1bd7fb2fc9f7ac34f336881ebeecb,4,68,0,68,4,2014-08-11 23:11:06,2014-08-11 23:11:06
68725d55417c6fe49410cc17f67104e45e7a7664...7140234ff8d00f0ec44b4fc9493805dac28ffb16,2,107,52,159,24,2014-08-11 22:10:32,2014-08-11 22:09:45
7140234ff8d00f0ec44b4fc9493805dac28ffb16...dc21684cb6e809e97e8e0291a8527f15901355a2,1,1,1,2,1,2014-08-11 22:16:30,2014-08-11 22:16:30
dc21684cb6e809e97e8e0291a8527f15901355a2...f5cde69fed01ceffcc039dfc344ecd7068d62e93,1,7,8,15,5,2014-08-11 22:16:59,2014-08-11 22:16:52
f5cde69fed01ceffcc039dfc344ecd7068d62e93...934cc4f817bef9aa67307c8e5354da9561f3f6de,1,6,1,7,3,2014-08-11 22:22:41,2014-08-11 22:22:41
7035b91249e1907eb7cbf5c4cb93569d5d3c50c0...8019ec5ded7e482c8da4cd979915615f682c77de,1,1,1,2,1,2014-08-09 01:17:30,2014-08-09 01:17:30
8019ec5ded7e482c8da4cd979915615f682c77de...4771a65cddd5c5e20cde9d22adc4969abdd65322,5,9,12,21,10,2014-08-10 16:13:17,2014-08-10 16:13:17
4771a65cddd5c5e20cde9d22adc4969abdd65322...57ade381c9a4cb3a1498753418b78c832162aa61,5,7,7,14,7,2014-08-10 16:23:08,2014-08-10 16:23:08
57ade381c9a4cb3a1498753418b78c832162aa61...fa1d30f02d268d53fa82e827fd3cf3debfac1b13,7,31,35,66,26,2014-08-11 19:43:48,2014-08-11 19:43:48
fa1d30f02d268d53fa82e827fd3cf3debfac1b13...7ca944e66532199d7e23c700f644d924587e90e2,8,126,69,195,16,2014-08-11 21:24:07,2014-08-11 21:24:07
7ca944e66532199d7e23c700f644d924587e90e2...307b9a95041b86b4eb8fa103149cb435871acc20,9,34,34,68,31,2014-08-11 21:38:46,2014-08-11 21:38:46
64d939acb2566b94b55bc0c1f82b4fc6c6dc0db0...3656356f22f4514afdfa9532ae9ce03bd1e24ca0,1,15,0,15,1,2014-08-11 21:59:15,2014-08-11 21:55:47
3656356f22f4514afdfa9532ae9ce03bd1e24ca0...01b0b0ebd4fa856da47ed82d4b14e3640e7fb902,10,199,0,199,11,2014-08-12 18:46:57,2014-08-12 18:46:57
01b0b0ebd4fa856da47ed82d4b14e3640e7fb902...436f29ec9f6da8115218d4e9ca14f8576783952d,7,12,15,27,9,2014-08-12 21:54:56,2014-08-12 21:54:56
436f29ec9f6da8115218d4e9ca14f8576783952d...66f21a64a2174e10fcf303643c4fd2118608cc97,1,2,2,4,2,2014-08-12 21:57:36,2014-08-12 21:57:36
66f21a64a2174e10fcf303643c4fd2118608cc97...0822033ca549716e5ff98cebfbb35ae061f5e56e,4,82,12,94,16,2014-08-12 22:56:24,2014-08-12 22:23:33
0822033ca549716e5ff98cebfbb35ae061f5e56e...4378d9f5d06d333a4e0546a2583b61c6931ff8f8,1,12,2,14,2,2014-08-12 23:24:57,2014-08-12 23:24:57
4378d9f5d06d333a4e0546a2583b61c6931ff8f8...adb3a65b96607c46281924d703dded94c807d3e4,5,5,5,10,5,2014-08-12 23:27:51,2014-08-12 23:27:51
adb3a65b96607c46281924d703dded94c807d3e4...8d204f5510668e6d3d72c7e0416c1a54d17069b5,1,3,1,4,1,2014-08-12 23:37:19,2014-08-12 23:37:19
8d204f5510668e6d3d72c7e0416c1a54d17069b5...9a92c6d0d418ae3229581b94d4155905367b36b1,1,15,0,15,1,2014-08-12 23:59:15,2014-08-12 23:51:15
9a92c6d0d418ae3229581b94d4155905367b36b1...f7179bec654f87c60276211c36f779a20d4cc3f7,1,208,206,414,32,2014-08-13 17:13:40,2014-08-13 17:13:40
f7179bec654f87c60276211c36f779a20d4cc3f7...a152d97beccbeb3ca451e68a44f0d92d8b26d8ee,3,13,8,21,6,2014-08-13 17:18:20,2014-08-13 17:18:20
a152d97beccbeb3ca451e68a44f0d92d8b26d8ee...c671555cfe6c1b597f96782625e023d68338084b,2,35,13,48,12,2014-08-13 19:56:04,2014-08-13 19:56:04
c671555cfe6c1b597f96782625e023d68338084b...390f449fe6a2ed08b12b11eba696ca85e9962668,1,1,1,2,1,2014-08-13 20:27:51,2014-08-13 18:39:32
390f449fe6a2ed08b12b11eba696ca85e9962668...6839b6c6b9b59cbe2224ff205c2b3e6e657012fa,1,2,2,4,2,2014-08-13 20:27:51,2014-08-13 18:30:57
6839b6c6b9b59cbe2224ff205c2b3e6e657012fa...889cc75a1d1f3d4dc175482ad555c83586641487,1,3,2,5,1,2014-08-13 20:56:42,2014-08-13 20:56:42
889cc75a1d1f3d4dc175482ad555c83586641487...aff7dfdb50cdf9a9a1772efebf404d590aa8937c,4,14,6,20,6,2014-08-13 20:57:08,2014-08-13 20:55:08
aff7dfdb50cdf9a9a1772efebf404d590aa8937c...f9131da440bbe9851067bcd03f6cda802e31866c,1,13,4,17,3,2014-08-13 21:45:27,2014-08-13 21:01:30
f9131da440bbe9851067bcd03f6cda802e31866c...dfd1fbcb22c77f803ac7f90f10fe61c7431457e3,3,9,4,13,5,2014-08-13 21:45:27,2014-08-13 21:45:14
835eb66377c01f5dfbe247e56800e5f79978376f...3d75f53149183d0ec60ccdf33faf75fcb8d6729c,1,13,3,16,4,2014-08-05 21:50:21,2014-08-05 21:50:21
1d17caeeafa1c67510a487affec3ed933dc005e3...d7594fd72d3743d60d78f2ed0b0a17cfa3ee6b04,1,5,2,7,2,2014-07-31 22:16:52,2014-07-31 22:16:52
d7594fd72d3743d60d78f2ed0b0a17cfa3ee6b04...9d5aa280c30df3e0d1d0799fab8a3c9304034e2b,1,1,1,2,1,2014-08-01 07:13:08,2014-08-01 07:13:08
9d5aa280c30df3e0d1d0799fab8a3c9304034e2b...581b51afcc48d67142fce396a176c41508368e9c,4,16,8,24,4,2014-08-01 22:29:19,2014-08-01 22:29:19
581b51afcc48d67142fce396a176c41508368e9c...7d05640ea04f814ea2b5c3354445973a42f6fcde,17,196,121,317,56,2014-08-05 02:03:05,2014-08-01 22:31:27
06a7dc90b54e2f22c575a9c17b850b99bad11966...8bcbd65344b0014aedeb700db17ad7f1c8e013a6,20,231,153,384,106,2014-07-31 21:12:15,2014-07-31 20:48:50
8bcbd65344b0014aedeb700db17ad7f1c8e013a6...cee6d7401ee52d4e5e28d2db388bdba9f9021138,1,1,1,2,1,2014-07-31 21:12:21,2014-07-31 20:56:19
06a7dc90b54e2f22c575a9c17b850b99bad11966...1976d4f4f1e978b4b4495cc0d574b32d61d2c715,1,3,3,6,3,2014-07-31 20:53:40,2014-07-31 07:20:33
1976d4f4f1e978b4b4495cc0d574b32d61d2c715...722ebace9adc1c2f6b55ad5fb91818bedb386955,1,5,0,5,1,2014-07-31 20:53:40,2014-07-31 19:14:01
e970d5381d5c555c89c5aa839bb2db4abc00fd01...ef70b6bfd2685d71e72d86f9c4a024ebbbd5899a,1,1,1,2,1,2014-07-10 23:31:12,2014-07-03 22:46:46
ef70b6bfd2685d71e72d86f9c4a024ebbbd5899a...4079791530f6439d7c28abc027996032965f4c24,1,3,0,3,1,2014-07-10 23:31:12,2014-07-10 23:29:37
dfbbde4aa7112d0c99cabc8efbe4ec5db12e6fcc...88447c91afb96bffbc1111c6740883cd4509f5ea,1,6,0,6,1,2014-07-01 20:59:41,2014-07-01 20:59:41
88447c91afb96bffbc1111c6740883cd4509f5ea...e27e398e635712d22a91b187aeac42fe2b04306c,2,50,5,55,8,2014-07-01 23:19:53,2014-07-01 23:19:53
e27e398e635712d22a91b187aeac42fe2b04306c...e92d718eff88d40cee36b048f5e77c7a115f0436,1,2,0,2,1,2014-07-03 02:26:12,2014-07-03 02:26:12
e92d718eff88d40cee36b048f5e77c7a115f0436...b475572638e5cdd97e6fe9cda61a4961231ca926,1,1,1,2,1,2014-07-03 03:39:49,2014-07-03 03:39:49
b475572638e5cdd97e6fe9cda61a4961231ca926...d023201742384d992f95483069e9446b9c66f0f2,3,41,45,86,4,2014-07-03 04:12:23,2014-07-03 03:43:10
d023201742384d992f95483069e9446b9c66f0f2...ff0a819ace479225b829ca18ff953d6430a04637,1,2,2,4,2,2014-07-03 04:12:29,2014-07-03 03:43:15
ff0a819ace479225b829ca18ff953d6430a04637...34d30f52ce137ca018fe02ca3cac2d6d0a0f064e,3,24,11,35,9,2014-07-03 04:12:29,2014-07-03 03:44:14
34d30f52ce137ca018fe02ca3cac2d6d0a0f064e...9237396478f8fb17e7d8cfef36188ba198a369e9,1,4,2,6,2,2014-07-03 04:12:29,2014-07-03 04:04:42
9237396478f8fb17e7d8cfef36188ba198a369e9...babc38ced030c715eaf2b82f1f4acc6725a7cb43,2,17,1,18,4,2014-07-03 04:13:26,2014-07-03 04:08:39
babc38ced030c715eaf2b82f1f4acc6725a7cb43...beed9644f98e93c62d3e65a6b7942e27b0ad473d,2,13,4,17,5,2014-07-03 20:19:32,2014-07-03 20:19:32
beed9644f98e93c62d3e65a6b7942e27b0ad473d...1a8136e4efccf4db41649f726f32d92a2cc4fca7,2,81,0,81,2,2014-07-03 21:46:06,2014-07-03 21:46:06
1a8136e4efccf4db41649f726f32d92a2cc4fca7...4c8223c6f48ce272dc23a928010147f91ad310b1,2,55,6,61,3,2014-07-03 23:53:13,2014-07-03 23:53:13
4c8223c6f48ce272dc23a928010147f91ad310b1...d52b5813eecc2326fc341b7f895e505a3a100562,4,0,91,91,4,2014-07-04 17:04:03,2014-07-04 17:04:03
d52b5813eecc2326fc341b7f895e505a3a100562...1a201660531a70091a7b22813c931cc47ebe6ddb,1,12,5,17,6,2014-07-07 18:30:26,2014-07-07 18:30:26
1a201660531a70091a7b22813c931cc47ebe6ddb...072ef0a23df2d57f02cffe3b865e4355e7bc14e6,2,66,0,66,2,2014-07-07 18:56:11,2014-07-07 18:56:11
072ef0a23df2d57f02cffe3b865e4355e7bc14e6...d8c36e46056db95efe16b3f0e8a183b513acb4fb,2,66,6,72,6,2014-07-07 19:24:06,2014-07-07 19:24:06
d8c36e46056db95efe16b3f0e8a183b513acb4fb...db366194089922cc83956a2c52dd9e7f550ddb19,1,1455,1455,2910,1,2014-07-07 22:57:01,2014-07-07 22:57:01
db366194089922cc83956a2c52dd9e7f550ddb19...5f5623a05df19d2c6e5a9e7cf59916867aba9fcb,2,5,3,8,3,2014-07-07 23:23:14,2014-07-07 23:23:14
5f5623a05df19d2c6e5a9e7cf59916867aba9fcb...8afc41f0eff3282b8b6382a5f85ff566855b90ab,2,16,22,38,9,2014-07-08 19:18:13,2014-07-08 19:18:13
8afc41f0eff3282b8b6382a5f85ff566855b90ab...fe1cd72a8eae69fa395b0e9f000a2ed502e30925,3,23,5,28,7,2014-07-08 20:13:05,2014-07-08 20:13:05
fe1cd72a8eae69fa395b0e9f000a2ed502e30925...379dcab8f24cfd0dbd0c0877725acf5132f60efd,1,40,40,80,2,2014-07-08 20:16:02,2014-07-08 20:16:02
379dcab8f24cfd0dbd0c0877725acf5132f60efd...1dbe352aa39a72be89c6388c8d1bf43b458dcbc6,1,46,1,47,2,2014-07-08 21:01:32,2014-07-08 21:01:32
1dbe352aa39a72be89c6388c8d1bf43b458dcbc6...3a2207a5c485b402bae3a218311d4909cae91cff,1,2,1,3,2,2014-07-10 00:30:40,2014-07-10 00:30:40
3a2207a5c485b402bae3a218311d4909cae91cff...2c3899f0e8dac80cc92b67deda145e52f13aa03e,1,3,3,6,1,2014-07-10 00:31:38,2014-07-10 00:31:38
2c3899f0e8dac80cc92b67deda145e52f13aa03e...3cc4e230ff63b81b9e2cf5b11cb641f3d1856895,1,8,1,9,1,2014-07-10 21:01:34,2014-07-10 21:01:34
3cc4e230ff63b81b9e2cf5b11cb641f3d1856895...750d2aa86116af596cdd5cd7bec6530e6be68bd7,3,260,211,471,6,2014-07-10 21:02:14,2014-07-10 21:02:14
28281f98b54c257c3e907d0f7095cf260bb7a989...aa3f67a62d5e4f12ffeb3cda02f617454d140531,8,2,1069,1071,11,2014-07-01 19:03:45,2014-07-01 19:03:45
aa3f67a62d5e4f12ffeb3cda02f617454d140531...2cc3db0fe0027093b2317a8b6c6d416baf6ff832,1,0,2,2,1,2014-07-01 19:32:00,2014-07-01 19:32:00
2cc3db0fe0027093b2317a8b6c6d416baf6ff832...f2c925d8c1d7dee84fe5810585e1f6e13557a8f4,4,64,64,128,12,2014-07-01 19:36:30,2014-07-01 19:36:30
f2c925d8c1d7dee84fe5810585e1f6e13557a8f4...43c4ec922c40a9f489e533f914c879d52ac661db,1,2,2,4,2,2014-07-01 19:39:31,2014-07-01 19:39:20
43c4ec922c40a9f489e533f914c879d52ac661db...4a6f8ed93637bc65204d7dc785320711f2b25f17,1,0,4,4,1,2014-07-01 19:39:47,2014-07-01 19:39:47
4a6f8ed93637bc65204d7dc785320711f2b25f17...e31127251b53fdc889e02cbf29a81d278001693e,3,177,183,360,6,2014-07-01 19:42:33,2014-07-01 19:42:33
59acafbb6f3a16dd72681bcda3dd29ae760cc229...6bcd277c64a755be9a18ea0c4b32cb379e3fa8cd,2,3,2,5,2,2014-06-26 22:30:25,2014-06-26 22:28:41
6bcd277c64a755be9a18ea0c4b32cb379e3fa8cd...94aab913f10bec9abf415d3dee99f33c3a05dc11,8,130,129,259,12,2014-06-27 00:32:17,2014-06-27 00:31:45
a9035630517dd3dfcac5e10cc59e81e50e82c886...b4e9adc663e2f4402b5107ed7d16b38c76c89922,2,58,5,63,4,2014-06-09 23:58:22,2014-06-09 22:19:57
b4e9adc663e2f4402b5107ed7d16b38c76c89922...7098c6826004c7be95d76a99eeee4f9049de371c,4,72,0,72,5,2014-06-09 23:58:22,2014-06-09 23:16:03
7098c6826004c7be95d76a99eeee4f9049de371c...febef90803dd36bceb8deac6d8490874d8266759,4,50,31,81,9,2014-06-09 23:58:22,2014-06-09 23:29:01
febef90803dd36bceb8deac6d8490874d8266759...7dbbc87fef8b7370f547aa681662e35e07a259cf,1,46,53,99,44,2014-06-10 00:00:47,2014-06-10 00:00:47
7dbbc87fef8b7370f547aa681662e35e07a259cf...84b2212b06544f925af7e440127154d899c5d43b,4,33,79,112,12,2014-06-10 00:29:00,2014-06-10 00:29:00
da96352c6588e010e78107a61ae2fb439a624abd...8a16f50138f1a64abeb4d6b0660f123793c757a1,4,32,25,57,11,2014-03-17 22:49:27,2014-03-17 18:35:29
2a8105a6aac30cbf4cf3fb89d19055ef71b06aa6...1c7e222c638b3ac94522b5ddeceb3f2f685693f5,1,49,31,80,7,2014-01-21 22:02:23,2014-01-21 22:02:23
1c7e222c638b3ac94522b5ddeceb3f2f685693f5...1be7e5a900642683b5fd3da94247c8650253640e,1,3,0,3,1,2014-01-22 22:17:19,2014-01-22 22:17:19
1be7e5a900642683b5fd3da94247c8650253640e...9971e5b298fc85911af2db5fc63b25e037fdc7b3,2,14,6,20,6,2014-01-22 23:29:13,2014-01-22 23:29:13
2a8105a6aac30cbf4cf3fb89d19055ef71b06aa6...45ccc12970d4ff8efe8c0042b5c4f255950f885b,2,42,61,103,25,2014-01-21 21:57:52,2014-01-17 23:37:12
45ccc12970d4ff8efe8c0042b5c4f255950f885b...16b23ecb3862ff4b8bbe3e0f8bc42cbad7923493,1,35,0,35,1,2014-01-22 02:17:08,2014-01-22 02:11:53
16b23ecb3862ff4b8bbe3e0f8bc42cbad7923493...4c3c1389eff6fa57e6f8e1eca6789c5e3a396c76,1,18,0,18,5,2014-01-22 02:51:08,2014-01-22 01:29:53
c09d5e1578adb43212f1b1bb6a774961f7d2009e...3eb4a1339d72c0f74d5a441e51da9b8395ec86ed,1,1,1,2,1,2014-02-17 07:09:37,2014-02-15 01:38:44
3eb4a1339d72c0f74d5a441e51da9b8395ec86ed...764b41adf4a667894b26459cedfd6cc01a084605,3,31,0,31,3,2014-02-17 23:17:07,2014-02-17 23:17:07
764b41adf4a667894b26459cedfd6cc01a084605...d8617769482feec87aa22cae3c2dd6cb5cb44d1c,2,14,2,16,4,2014-02-17 23:38:44,2014-02-17 23:35:50
d8617769482feec87aa22cae3c2dd6cb5cb44d1c...6b122ab51b2a26d44a6409615e99a5fcf2fb4e3f,3,12,5,17,5,2014-02-17 23:49:34,2014-02-17 23:48:29
6b122ab51b2a26d44a6409615e99a5fcf2fb4e3f...fb20ee822a6104edacac4916f42ec448eb61d3f0,1,3,5,8,3,2014-02-18 00:10:10,2014-02-04 21:31:55
fb20ee822a6104edacac4916f42ec448eb61d3f0...4541f72279838dd7178898b6efbc29250e413838,7,158,185,343,31,2014-02-18 00:10:10,2014-02-04 21:32:03
8f9f793c32840ad1cb01b68bf87fca989816fef2...3caa824b32c8ba7196af9e63068862d43f769a0f,3,21,13,34,6,2014-02-20 06:03:14,2014-02-20 06:03:14
3caa824b32c8ba7196af9e63068862d43f769a0f...7b9ca3d0ccf334a350102c09b71206f896966704,1,4,2,6,2,2014-02-20 07:56:10,2014-02-20 07:56:10
6bcaaf9116af6a4ffa97977b05dac6442cf035de...76bf0be8ca68f80063b23a2924e25e6c57cccfc7,1,21,22,43,3,2013-12-07 02:32:25,2013-12-07 02:32:25
76bf0be8ca68f80063b23a2924e25e6c57cccfc7...163dccf5e7f0f34a074a62e05300b0e7b7b0497a,1,4,5,9,3,2013-12-07 02:36:54,2013-12-07 02:36:54
1638ca0e1bac646a190ca4b827c2248602eb8b72...dbca6908f36c590d0d50dc67d653ae12935d12b5,1,1,1,2,1,2014-06-10 16:45:03,2014-06-06 14:41:02
dbca6908f36c590d0d50dc67d653ae12935d12b5...5ab3fbc17eb2ea4b5729d57aaecbd5449b3b9a73,3,103,19,122,14,2014-06-10 18:05:43,2014-06-10 18:05:43
5ab3fbc17eb2ea4b5729d57aaecbd5449b3b9a73...c346568cefede0452d662f68e046e947631e8d64,2,91,53,144,24,2014-06-10 18:33:33,2014-06-10 18:33:33
9a70a221c0669439dfb5f55f6afeb1b90b6acb3e...b7526b41be9446f2617c4b8a2ebc04708acdb461,1,68,70,138,48,2014-06-18 00:33:55,2014-06-17 22:54:26
b7526b41be9446f2617c4b8a2ebc04708acdb461...e6985c39f273c6a98ecbc9311a68dd02a402205f,1,45,44,89,32,2014-06-18 00:33:55,2014-06-17 23:10:21
e6985c39f273c6a98ecbc9311a68dd02a402205f...2dfe97ee328f52fd3ad8275bb79d1cfcd8c168a1,1,2,2,4,2,2014-06-18 00:33:55,2014-06-17 23:12:29
2dfe97ee328f52fd3ad8275bb79d1cfcd8c168a1...87eb6977a745cddc1fd37f110f996ac539231f9e,2,32,32,64,24,2014-06-18 00:33:56,2014-06-17 23:20:19
87eb6977a745cddc1fd37f110f996ac539231f9e...0a66d06dbf9885f15fe54958bff5ce4a0a324d8b,2,7,74,81,3,2014-06-18 00:33:56,2014-06-17 23:22:57
0a66d06dbf9885f15fe54958bff5ce4a0a324d8b...f88b1f0595aba8049a60cfdb2e913622d37035bf,2,112,111,223,69,2014-06-18 00:33:56,2014-06-17 23:34:05
f88b1f0595aba8049a60cfdb2e913622d37035bf...77a9579d66fa3f32b199810f33c25c0676f941b9,3,63,38,101,27,2014-06-18 00:33:56,2014-06-17 23:56:32
77a9579d66fa3f32b199810f33c25c0676f941b9...fb20f60dcfd1c204e3215127c2c5145c5d95eb9e,1,29,29,58,18,2014-06-18 00:35:55,2014-06-18 00:35:55
fb20f60dcfd1c204e3215127c2c5145c5d95eb9e...4f3aa0fc532b612aa902802d305d06ff1ad88eef,11,29,23,52,16,2014-06-18 00:48:08,2014-06-18 00:48:08
4f3aa0fc532b612aa902802d305d06ff1ad88eef...975a25508d19d20c27e3315d42c42a1af0631957,6,19,14,33,12,2014-06-18 00:51:36,2014-06-18 00:51:36
975a25508d19d20c27e3315d42c42a1af0631957...8c107a9ea70264a7e8fbd5f85a5b945186fcff7f,1,3,4,7,4,2014-06-18 01:27:23,2014-06-18 01:27:23
8c107a9ea70264a7e8fbd5f85a5b945186fcff7f...d1f5acdb08b7e5b3b5dd025d83c5cff2b889aef1,1,2,2,4,2,2014-06-18 01:41:59,2014-06-18 01:41:59
d1f5acdb08b7e5b3b5dd025d83c5cff2b889aef1...6782711c6963cba11b717237aa7588d740848075,1,12,1,13,3,2014-06-18 02:23:39,2014-06-18 02:20:07
86aeec461ae1a129acf86ccce1d006bc29bb78f2...80ee5c19eec8c19ecb3fe0c700ef3d2a86c5a19b,1,3,0,3,1,2014-06-19 16:40:28,2014-06-19 16:40:28
80ee5c19eec8c19ecb3fe0c700ef3d2a86c5a19b...b845f8e7ebb8c69f7e4a02f1684ebc777077c66e,1,33,21,54,7,2014-06-19 16:51:33,2014-06-19 16:51:33
86aeec461ae1a129acf86ccce1d006bc29bb78f2...dc2b03aee634cf5b99cb6023b957707b41ff91d6,3,49,2,51,4,2014-06-19 00:03:46,2014-06-18 23:45:47
dc2b03aee634cf5b99cb6023b957707b41ff91d6...4ec9cb5847be61226538c066523d42bc2d143fd8,1,1,0,1,1,2014-06-20 19:08:08,2014-06-20 19:08:08
4ec9cb5847be61226538c066523d42bc2d143fd8...085441524fc3f4badbbee1dfe825fe3128dc95ef,5,56,37,93,24,2014-06-20 19:34:23,2014-06-20 19:34:23
6c22fa7547f72a09ee038f7ec03b4d2dd0ab829c...5fe0937aa688c2b529f5d5af51d2dd90b97ed3bd,7,7,7,14,7,2014-09-15 22:55:19,2014-09-15 22:55:19
5fe0937aa688c2b529f5d5af51d2dd90b97ed3bd...d73bd2add41b95f06796e24f6b3b352eeda973a3,1,8,0,8,1,2014-09-15 22:57:55,2014-09-15 22:57:55
d73bd2add41b95f06796e24f6b3b352eeda973a3...e8a1287f2a990a4e6de90302d9cb0c4cde0a00ed,1,6,0,6,1,2014-09-15 23:02:27,2014-09-15 23:02:27
e8a1287f2a990a4e6de90302d9cb0c4cde0a00ed...5b823875c56c985589fd467e0cdbb3fb1a354409,1,1,1,2,1,2014-09-15 23:04:04,2014-09-15 23:04:04
5b823875c56c985589fd467e0cdbb3fb1a354409...dd61c40bbcabf245a8d763c50e1004d8a899ea30,5,5,5,10,5,2014-09-15 23:07:26,2014-09-15 23:07:26
dd61c40bbcabf245a8d763c50e1004d8a899ea30...113be020e21810b204ef5048f83a857d25929190,1,1,1,2,1,2014-09-15 23:45:10,2014-09-15 23:45:10
113be020e21810b204ef5048f83a857d25929190...a089d97048367454ddeddc8230311436d162a6fe,3,9,9,18,9,2014-09-15 23:46:42,2014-09-15 23:46:42
a089d97048367454ddeddc8230311436d162a6fe...7299bac40f6c0aeadb148b019a5c4e0a0ba0d4ac,10,35,35,70,35,2014-09-15 23:49:00,2014-09-15 23:49:00
0f7ae4b0f7d2f89bfc7bc0039257de5f27ae76b7...f6cec67c500aa58e662fd2c9da5f00d40c3a979e,1,2,2,4,2,2014-09-07 05:28:09,2014-09-07 05:28:09
5ca8d5207098cb36f5ed811a39df053133141ada...3e5e8dcdec637b2d023fb2467dcecbfc32aab2ee,1,1,1,2,1,2014-09-06 00:40:46,2014-09-06 00:40:46
3e5e8dcdec637b2d023fb2467dcecbfc32aab2ee...cbe38f62856f757b5fac0ba42bd82b71de1f98cd,1,11,5,16,2,2014-09-06 00:52:53,2014-09-05 21:54:23
cbe38f62856f757b5fac0ba42bd82b71de1f98cd...3decef135ad453837104fff0562226e63d681442,14,14,14,28,14,2014-09-06 00:55:37,2014-09-06 00:55:37
3decef135ad453837104fff0562226e63d681442...c5950f7361e34736c07a6b8ccd731e9349469cfc,1,3,2,5,1,2014-09-06 14:52:39,2014-09-06 14:52:11
c5950f7361e34736c07a6b8ccd731e9349469cfc...05b2765d61f0ba9f4d9a8069840ee25b960628ed,1,58,51,109,14,2014-09-06 15:02:26,2014-09-06 15:02:18
05b2765d61f0ba9f4d9a8069840ee25b960628ed...df8774a7f23987450fde87065d19304a3093c2c1,2,15,12,27,10,2014-09-06 16:21:52,2014-09-06 16:21:52
6432b493e339b6e52c96064376bc4bf39fe53c1b...b66f22b0ed851f615b1cf2e79630493612620465,1,29,4,33,4,2014-09-05 04:38:03,2014-09-05 04:38:03
b66f22b0ed851f615b1cf2e79630493612620465...cf4477ff27cba9f8a8f63ec2f435969af0b6707c,1,5,1,6,1,2014-09-05 05:07:22,2014-09-05 05:07:22
cf4477ff27cba9f8a8f63ec2f435969af0b6707c...11e434e2c07f349c69f76ab5b6e472af5d5eeab6,1,0,0,0,0,2014-09-05 05:12:45,2014-09-05 05:12:45
11e434e2c07f349c69f76ab5b6e472af5d5eeab6...97be584775c2a066a8100a666efcb7ce7026e04d,1,6,0,6,1,2014-09-05 16:58:59,2014-09-05 16:58:59
6432b493e339b6e52c96064376bc4bf39fe53c1b...1dd43672d6fed22d1e3b1f2709ddb86850dd0387,8,187,23,210,47,2014-09-05 02:20:39,2014-09-05 02:20:39
1dd43672d6fed22d1e3b1f2709ddb86850dd0387...1402fdd3f612862d7db41055dc50ce8d03aa7a6f,5,11,4,15,9,2014-09-05 02:29:58,2014-09-05 02:29:58
1402fdd3f612862d7db41055dc50ce8d03aa7a6f...cb5c2c543de1aa49ac099c85f6ddc580edacabfd,5,12,9,21,7,2014-09-05 02:54:56,2014-09-05 02:54:56
cb5c2c543de1aa49ac099c85f6ddc580edacabfd...586b6e27124b7f1cd9d1268876b7859a6b15a33f,15,288,36,324,70,2014-09-05 04:42:03,2014-09-05 04:42:03
586b6e27124b7f1cd9d1268876b7859a6b15a33f...aeff585f79853ad8d5adf2b83f716ca36331a4a2,6,66,14,80,16,2014-09-05 16:31:41,2014-09-05 16:31:41
aeff585f79853ad8d5adf2b83f716ca36331a4a2...f1085bdb83c4cd710bd585b18a0bbc763eb55d90,4,41,6,47,10,2014-09-05 16:41:05,2014-09-05 16:41:05
f1085bdb83c4cd710bd585b18a0bbc763eb55d90...443fd8874bb8d9718faf2cfcadc66d52628e7550,6,25,8,33,10,2014-09-05 16:56:22,2014-09-05 16:56:22
443fd8874bb8d9718faf2cfcadc66d52628e7550...ba0b2f003cdf6e2943693b25023b8839781758d0,1,39,26,65,3,2014-09-05 17:36:25,2014-09-05 17:36:25
ba0b2f003cdf6e2943693b25023b8839781758d0...ef14f531ae762f945684ffef4f824ca6c3bdf070,5,6,5,11,5,2014-09-05 18:52:59,2014-09-05 18:52:59
ef14f531ae762f945684ffef4f824ca6c3bdf070...2c969270ea4141ac671b51497fccc22628636836,10,131,17,148,21,2014-09-05 21:37:28,2014-09-05 21:37:28
58869b050bf5cdc77991505b10c46112d85aff24...8e7cd297bf5addd96ffba9b5309e471ffb8fe79a,8,622,593,1215,79,2014-08-28 02:45:49,2014-08-28 02:45:49
8e7cd297bf5addd96ffba9b5309e471ffb8fe79a...41910019e1e6d80cd1c5a431ffe961e0a11bc14a,59,482,344,826,337,2014-08-28 03:05:22,2014-08-28 03:05:22
41910019e1e6d80cd1c5a431ffe961e0a11bc14a...d224143c54521ada598a239d07a1d1b5e20a5a93,9,125,125,250,84,2014-08-28 03:20:53,2014-08-28 03:20:53
d224143c54521ada598a239d07a1d1b5e20a5a93...5458c985f5e9e4947173b9bab7293c37160b6e53,3,21,21,42,5,2014-08-28 03:25:35,2014-08-28 03:25:35
5458c985f5e9e4947173b9bab7293c37160b6e53...ca4ff126f2baab7cd3278fd45f1961f832fae8f1,2,1,141,142,3,2014-08-28 04:06:30,2014-08-28 04:06:30
58869b050bf5cdc77991505b10c46112d85aff24...c21ed42a33ba1acc5db215444c7fd015adde9bf4,1,0,1,1,1,2014-08-28 02:36:57,2014-08-28 02:36:23
27d48b4edefe7b53e8f3dc207196756664b61b5a...a8a13a9de82f745a78704a49d50088dba447371f,1,1,1,2,1,2014-08-28 02:13:52,2014-08-28 02:13:52
a8a13a9de82f745a78704a49d50088dba447371f...093c98cad04d547dbbaa651ba4403c17c41a912e,1,12,2,14,2,2014-08-28 02:23:00,2014-08-28 02:23:00
3ce808aae5003f6cf0e1f1c78765a090821807a3...d0c842a26f1492e3c55ef0d009de541b427f3723,1,1,1,2,1,2014-08-27 21:47:22,2014-08-27 21:47:22
3ce808aae5003f6cf0e1f1c78765a090821807a3...e7be8d744467c7b2428fcfe711669b89d3a2ec75,2,35,0,35,2,2014-08-27 19:33:04,2014-08-27 19:33:04
e7be8d744467c7b2428fcfe711669b89d3a2ec75...4eeca1dd88f0a62fabc59cbf60b2c8e2b62033f8,3,28,17,45,11,2014-08-27 20:41:23,2014-08-27 20:41:23
4eeca1dd88f0a62fabc59cbf60b2c8e2b62033f8...fdd6beab2fc388e4421d054cb15964ea43b2fe6c,2,11,9,20,2,2014-08-28 14:52:42,2014-08-28 14:52:42
3ce808aae5003f6cf0e1f1c78765a090821807a3...5c4beef09209c2106b94bd2d7afddbafcd304439,1,87,69,156,5,2014-08-27 19:17:22,2014-08-27 19:17:22
86ff4a0637e3dd7c166b636a87dd0644e40df796...38d6525cea541d5e7c982c66aab37b8f728ef0a7,3,91,23,114,6,2014-08-27 00:04:42,2014-08-27 00:04:06
38d6525cea541d5e7c982c66aab37b8f728ef0a7...28e2719ae5e4b6df607b5702d819ceeb4fa42fb1,1,2,0,2,2,2014-08-27 00:53:23,2014-08-27 00:53:23
28e2719ae5e4b6df607b5702d819ceeb4fa42fb1...f89e633553bac394cf28a98e1e141ad10f316054,1,1,1,2,1,2014-08-27 01:19:24,2014-08-27 01:19:24
5de1e758b56ab041d522994754323173366e7a41...d37dafe0f83ed9bb32c7034f6a35a81178d81ffe,8,10,10,20,9,2014-08-26 23:15:34,2014-08-26 23:15:34
33440ebd7af1bd7fb2fc9f7ac34f336881ebeecb...9a2ae6ec595742adbe30cd505ca95d2fe2f30cfc,1,13,10,23,11,2014-08-11 23:12:11,2014-08-11 23:12:11
934cc4f817bef9aa67307c8e5354da9561f3f6de...297568daff538a5fbf347642b72d08493ca01e16,1,2,1,3,2,2014-08-11 23:14:14,2014-08-11 23:13:53
dae543946cc3b475aa25929e2b8b6fa43fa041ec...ebff9b3bdf18cdd15c45c0af0aa34968440c27e5,3,15,9,24,10,2014-08-11 22:39:40,2014-08-11 22:39:40
ebff9b3bdf18cdd15c45c0af0aa34968440c27e5...83073cd1ebf40966b035eac657aeb51f0e5c5f0c,8,102,102,204,24,2014-08-12 18:07:26,2014-08-12 18:07:26
83073cd1ebf40966b035eac657aeb51f0e5c5f0c...0f905100d36e64d2f8971a7eb22abe0615bfd214,4,47,40,87,20,2014-08-12 18:49:03,2014-08-12 18:48:55
0f905100d36e64d2f8971a7eb22abe0615bfd214...10fe009db8fe7f0f2eb07a712917935f61f73e81,4,71,67,138,21,2014-08-12 20:37:35,2014-08-12 20:37:35
10fe009db8fe7f0f2eb07a712917935f61f73e81...28da81fd49c923978510ae603d86fd238c04e08d,2,5,5,10,5,2014-08-12 20:57:33,2014-08-12 20:57:33
28da81fd49c923978510ae603d86fd238c04e08d...8ed48c457dab2bd287ef1c91d67f87fe5f06eb5b,3,9,9,18,9,2014-08-12 21:05:56,2014-08-12 21:05:56
8ed48c457dab2bd287ef1c91d67f87fe5f06eb5b...f35ce021965f937d963e9ae68b4684d0bcc0ae6c,5,28,28,56,27,2014-08-13 21:33:05,2014-08-13 21:33:05
f35ce021965f937d963e9ae68b4684d0bcc0ae6c...b5507c33a77b6ed3500a740c9fa48f40d54fdf09,2,34,2,36,3,2014-08-13 22:02:11,2014-08-13 22:02:11
b5507c33a77b6ed3500a740c9fa48f40d54fdf09...4d9f4ebd355f2ba10d5c5142cb77328b90fd024a,5,97,83,180,33,2014-08-14 00:22:07,2014-08-14 00:22:07
4d9f4ebd355f2ba10d5c5142cb77328b90fd024a...ffd4a61227a7b01d775e27bdc0c2d3d01e088a62,5,45,33,78,27,2014-08-14 20:21:44,2014-08-14 20:21:44
ffd4a61227a7b01d775e27bdc0c2d3d01e088a62...5f252370fe3e4cb6fe25fbc0cc1148e7b309bff8,3,38,22,60,11,2014-08-14 20:31:39,2014-08-14 20:29:29
5f252370fe3e4cb6fe25fbc0cc1148e7b309bff8...03def4bebaaf51115342090361212c80028ca751,4,42,15,57,15,2014-08-14 21:17:43,2014-08-14 21:17:43
03def4bebaaf51115342090361212c80028ca751...aa0211a63c18ff4c6ba34d9e3ee10235d0947ba6,4,163,2,165,4,2014-08-15 03:13:48,2014-08-15 03:13:48
aa0211a63c18ff4c6ba34d9e3ee10235d0947ba6...275d2812020296042d52ce982f1ee6610f8167f0,1,4,0,4,1,2014-08-15 18:22:42,2014-08-15 18:22:42
275d2812020296042d52ce982f1ee6610f8167f0...577ff39c03d9c089390734981a21a1fe6478e815,1,1,0,1,1,2014-08-15 19:23:55,2014-08-15 19:23:55
577ff39c03d9c089390734981a21a1fe6478e815...f362f949afbb8b2a67fdd5e9539effe0a8963bfc,6,35,22,57,14,2014-08-15 23:17:23,2014-08-15 23:17:23
dfd1fbcb22c77f803ac7f90f10fe61c7431457e3...4ac78a36467255a0f31ca576eda8269641793972,7,12,12,24,11,2014-08-13 22:39:03,2014-08-13 22:39:03
4ac78a36467255a0f31ca576eda8269641793972...25328f129882ff024a6c415f6a0f5551bb7c7084,1,1,0,1,1,2014-08-13 23:00:16,2014-08-13 23:00:10
25328f129882ff024a6c415f6a0f5551bb7c7084...4e37f90a353b283e4dbd23d60cd65daa767772c0,1,1,1,2,1,2014-08-13 23:12:03,2014-08-13 23:12:03
4e37f90a353b283e4dbd23d60cd65daa767772c0...c9476a350fe1a5664a33a91ae60e050f752f5db1,3,14,13,27,5,2014-08-14 00:36:12,2014-08-14 00:19:32
3d75f53149183d0ec60ccdf33faf75fcb8d6729c...c2b42613e2e82efa755f4445d4a792ba57ff1878,3,14,15,29,9,2014-08-06 00:30:54,2014-07-29 21:35:41
c2b42613e2e82efa755f4445d4a792ba57ff1878...22d4c48188a33975044e6546a8e8be6ab1e1413e,14,239,235,474,37,2014-08-06 23:05:27,2014-08-06 23:05:27
845286b9251c2914e9fd130dc4390f95596002f1...62db7b694c4cbf06a44da740ac6e09c3b187a607,1,7,0,7,1,2014-08-05 20:17:26,2014-08-05 20:17:26
62db7b694c4cbf06a44da740ac6e09c3b187a607...ad708ca5699719acbc00a73dd2d77a43cf7c7681,1,1,1,2,1,2014-08-05 20:31:24,2014-08-05 20:31:24
ad708ca5699719acbc00a73dd2d77a43cf7c7681...80a87f7f666b334e9b31bb63f56a78b4f8d38083,1,9,0,9,1,2014-08-05 21:16:52,2014-08-05 21:16:52
80a87f7f666b334e9b31bb63f56a78b4f8d38083...0422dfb5c6957c5fd08602c9c37fc15168dcee82,1,7,6,13,3,2014-08-05 22:48:27,2014-08-05 22:48:27
0422dfb5c6957c5fd08602c9c37fc15168dcee82...59e5b031f8508550076e5ec745c568359df31731,1,64,51,115,14,2014-08-05 22:49:46,2014-08-05 22:49:46
7d05640ea04f814ea2b5c3354445973a42f6fcde...07852ebcbec97e9d076188029448e470a8017a58,1,1,1,2,1,2014-08-05 03:38:33,2014-08-05 03:38:33
07852ebcbec97e9d076188029448e470a8017a58...ddc3657e4f4de6a5a20867b95a38c376bda7b9e2,10,69,88,157,30,2014-08-05 04:32:22,2014-08-05 04:17:07
ddc3657e4f4de6a5a20867b95a38c376bda7b9e2...98a9b5b31ac388e4be66437185e74161bf0a40d3,2,39,42,81,11,2014-08-05 20:10:55,2014-08-03 08:25:20
98a9b5b31ac388e4be66437185e74161bf0a40d3...5e4c8cd27640629d0d6125a411f7d0aaa7cf5147,2,57,6,63,10,2014-08-05 20:10:55,2014-08-05 18:01:42
5e4c8cd27640629d0d6125a411f7d0aaa7cf5147...64ddf8a9797309d356ee926703ae54c9fbef56bb,2,4,5,9,4,2014-08-05 20:10:56,2014-08-05 18:04:15
64ddf8a9797309d356ee926703ae54c9fbef56bb...bcf85a42b935e72f6cf453c6664e8b4902b53051,1,1,1,2,1,2014-08-05 20:10:56,2014-08-05 18:13:56
bcf85a42b935e72f6cf453c6664e8b4902b53051...ecaa9e02313ac4364fdde90a244e44e1cb8b797f,1,3,3,6,1,2014-08-05 20:10:56,2014-08-05 18:19:47
ecaa9e02313ac4364fdde90a244e44e1cb8b797f...82323fcfa935c05ed3b163e382103fa074312e92,1,0,1,1,1,2014-08-05 20:10:56,2014-08-05 20:06:43
7d05640ea04f814ea2b5c3354445973a42f6fcde...774fa48d340159a03b81dbb813380537a087e28a,4,4,40,44,5,2014-08-05 02:21:48,2014-08-05 02:21:48
774fa48d340159a03b81dbb813380537a087e28a...c6bcce0a555109cc1a613154abde7ab40e537439,2,12,5,17,4,2014-08-05 02:25:36,2014-08-05 02:25:36
c6bcce0a555109cc1a613154abde7ab40e537439...2b3f0fd21208573e0da9f1bb92ae90bf76fb6b71,1,1,13,14,6,2014-08-05 02:31:43,2014-08-05 02:31:43
2b3f0fd21208573e0da9f1bb92ae90bf76fb6b71...c6120ee030ca2b6ab6be5cede29fd5a2ef5fca49,1,26,23,49,6,2014-08-05 03:47:05,2014-08-05 03:47:05
09faa5371a2299029c98dc8f96afff6fd44fafa6...8adb56b2b34a28c5657072afc7fa1a1a4e1f3c44,1,1,1,2,1,2014-07-31 21:33:23,2014-07-31 21:33:23
591263fbf1c3cadf15e572d2a22461cad2f00825...c18ea3c721c66edc47f7fa258a4baf4366b50e6e,1,3,0,3,2,2014-07-11 15:29:07,2014-07-11 15:04:35
c18ea3c721c66edc47f7fa258a4baf4366b50e6e...d56d9daed983c1358a4cdd571e51f22ff0d8d0e6,1,23,11,34,6,2014-07-11 15:29:07,2014-07-11 15:28:24
d56d9daed983c1358a4cdd571e51f22ff0d8d0e6...a186c961cfaec5b56488c10b50d1aa35772e8185,1,1,1,2,1,2014-07-11 23:18:41,2014-07-11 20:33:38
a186c961cfaec5b56488c10b50d1aa35772e8185...3b86b5c11f2d4068eabd2dd5c393016d6e1fccc4,1,1,0,1,1,2014-07-13 18:30:32,2014-07-13 18:28:55
3b86b5c11f2d4068eabd2dd5c393016d6e1fccc4...57465b00c28bc78bdaac36afdd881dad252f9e16,4,66,4,70,4,2014-07-13 18:30:32,2014-07-13 18:29:55
57465b00c28bc78bdaac36afdd881dad252f9e16...2ac9da43f9524a9df07dcf19b511f2a63e16fbde,2,32,21,53,10,2014-07-14 20:44:41,2014-07-14 20:42:50
2ac9da43f9524a9df07dcf19b511f2a63e16fbde...c1795221ac907c6aaa17839ed8d9a57e72b0b48d,1,12,1,13,2,2014-07-14 21:21:57,2014-07-14 21:21:57
c1795221ac907c6aaa17839ed8d9a57e72b0b48d...82368547365c6c218327e40697c5be0b7f18ff0a,5,75,21,96,10,2014-07-14 21:58:07,2014-07-14 18:15:20
82368547365c6c218327e40697c5be0b7f18ff0a...019736096be79e69635702a6d84af9f36c581a85,1,1,1,2,1,2014-07-14 22:28:03,2014-07-14 22:28:03
019736096be79e69635702a6d84af9f36c581a85...924f379870dbea6df0dd82fe5f123ebb23c2b802,1,14,7,21,5,2014-07-14 23:36:28,2014-07-14 23:35:44
924f379870dbea6df0dd82fe5f123ebb23c2b802...6112c2ddc1875e2e0600d28970c6b430240843e4,1,7,1,8,1,2014-07-15 01:00:29,2014-07-15 00:59:36
6112c2ddc1875e2e0600d28970c6b430240843e4...ab9cae612332a52feb9866de3979221a50faf3f7,1,1,1,2,1,2014-07-15 03:04:12,2014-07-15 02:57:42
ab9cae612332a52feb9866de3979221a50faf3f7...12c60075a214505e3683b499c07f186dc229cb10,1,1,1,2,1,2014-07-15 20:31:52,2014-07-15 20:27:32
12c60075a214505e3683b499c07f186dc229cb10...2a382cfb8cd449f0ad847eb3ccdb4b2556d861ac,1,3,1,4,1,2014-07-15 20:33:00,2014-07-15 20:32:22
2a382cfb8cd449f0ad847eb3ccdb4b2556d861ac...b5cbca980e3459b3883ee3bdacddfca60d32ccd9,2,37,5,42,9,2014-07-15 21:20:44,2014-07-15 21:20:27
b5cbca980e3459b3883ee3bdacddfca60d32ccd9...4f15a3d70254a03b5b4356bd596f52811280b599,1,5,1,6,3,2014-07-15 22:33:09,2014-07-15 22:33:09
4f15a3d70254a03b5b4356bd596f52811280b599...01d538fc3789fc1dbbece744a65ba9f40bf664a5,1,2,1,3,1,2014-07-15 23:45:32,2014-07-15 23:45:32
01d538fc3789fc1dbbece744a65ba9f40bf664a5...8e93519f5cd57d8c0ae6e1289ca3c88f2de132c8,4,36,3,39,7,2014-07-16 00:10:46,2014-07-16 00:10:46
94aab913f10bec9abf415d3dee99f33c3a05dc11...8571143d8d5d17190a218596de913ba577bb8850,1,3,3,6,3,2014-06-28 00:47:26,2014-06-28 00:47:26
8571143d8d5d17190a218596de913ba577bb8850...29f99597c99c68d484382a870cf2ebeb1fe97c90,1,4,1,5,2,2014-06-28 00:49:06,2014-06-28 00:49:06
29f99597c99c68d484382a870cf2ebeb1fe97c90...1009e0ec2a242e2728589d47e3739718a5f77f95,1,4,4,8,3,2014-06-30 22:25:19,2014-06-30 21:56:53
1009e0ec2a242e2728589d47e3739718a5f77f95...ba2c483af546bf8b0b61d7f172b4785c52940feb,1,1,1,2,1,2014-06-30 22:25:31,2014-06-30 22:04:49
ba2c483af546bf8b0b61d7f172b4785c52940feb...fee935e24a862251d5e336a1ee0e5906eedb02d8,2,41,24,65,6,2014-06-30 22:25:43,2014-06-30 22:24:10
fee935e24a862251d5e336a1ee0e5906eedb02d8...499ca1ff23dc47629151da63c4e29610f0241e36,1,7,0,7,1,2014-06-30 23:53:42,2014-06-27 21:24:07
499ca1ff23dc47629151da63c4e29610f0241e36...e6328a094f684cafa3433883b918c31067808a31,1,11,4,15,1,2014-06-30 23:53:42,2014-06-27 21:24:22
e6328a094f684cafa3433883b918c31067808a31...abd8f59bf67dc1462d49f0027dcf8c72329f95dd,1,1,1,2,1,2014-06-30 23:53:43,2014-06-27 21:26:38
abd8f59bf67dc1462d49f0027dcf8c72329f95dd...f980ceb6855072f369a496745f16831a76bc1365,1,1,0,1,1,2014-06-30 23:53:43,2014-06-27 22:11:13
f980ceb6855072f369a496745f16831a76bc1365...594a825b669d5f247f0d5b76dbd3bb4347d97463,2,13,4,17,4,2014-06-30 23:53:43,2014-06-27 22:14:31
594a825b669d5f247f0d5b76dbd3bb4347d97463...469ecda93cf248796d63b3114dc013cba61be4ec,1,3,0,3,1,2014-07-01 05:05:58,2014-07-01 00:48:27
469ecda93cf248796d63b3114dc013cba61be4ec...085f6bf5813360ce81a7eba4315f5b610ab96a07,5,143,93,236,39,2014-07-01 05:05:58,2014-07-01 04:11:51
085f6bf5813360ce81a7eba4315f5b610ab96a07...f3096d1cef56de5aa72c95ad59a625cff3305ac4,1,6,1,7,2,2014-07-01 05:10:45,2014-07-01 05:10:45
f3096d1cef56de5aa72c95ad59a625cff3305ac4...a0d7d04592cce699edd1811aa951ebfaa5ed59d3,1,2,2,4,2,2014-07-01 05:11:31,2014-07-01 05:11:31
a0d7d04592cce699edd1811aa951ebfaa5ed59d3...9333b4612efb6f8d5cfca3d8b99f9f81925c908f,1,1,1,2,1,2014-07-01 05:11:44,2014-07-01 05:11:44
9333b4612efb6f8d5cfca3d8b99f9f81925c908f...f4c5c5cb94fd18018afb1d3076d4a450b6932f06,1,1,0,1,1,2014-07-01 05:13:39,2014-07-01 05:13:39
f4c5c5cb94fd18018afb1d3076d4a450b6932f06...0da301c637eb21b3e5cd34c5c01bedbbccef20f9,2,2,2,4,2,2014-07-01 20:33:39,2014-07-01 20:32:02
94aab913f10bec9abf415d3dee99f33c3a05dc11...9e3695ce4453b16e8036c33553e1f6c5fb166819,2,3,1,4,2,2014-06-27 20:36:42,2014-06-27 20:36:42
9e3695ce4453b16e8036c33553e1f6c5fb166819...6d6e3a12f6a35f9646eb7a8431d025afdffbc112,1,3,3,6,3,2014-07-01 20:05:45,2014-06-28 00:47:26
6d6e3a12f6a35f9646eb7a8431d025afdffbc112...b5f8566cdc88ffbf8072e4e67c557a01c4000f12,1,4,1,5,2,2014-07-01 20:05:45,2014-06-28 00:49:06
b5f8566cdc88ffbf8072e4e67c557a01c4000f12...83787c9b461611cd0edbeaed20c0b1ff94126877,1,4,4,8,3,2014-07-01 20:05:45,2014-06-30 21:56:53
83787c9b461611cd0edbeaed20c0b1ff94126877...4e2e4d430ce4e2bda94dd42602a42ce05cba8dc1,1,1,1,2,1,2014-07-01 20:05:45,2014-06-30 22:04:49
4e2e4d430ce4e2bda94dd42602a42ce05cba8dc1...a19802696cacf71409019fc0e06ed04908252cfd,2,41,24,65,6,2014-07-01 20:05:45,2014-06-30 22:24:10
a19802696cacf71409019fc0e06ed04908252cfd...a2db1d031266a0d62f41b403fc8c26cbb6aab04f,1,7,0,7,1,2014-07-01 20:05:46,2014-06-27 21:24:07
a2db1d031266a0d62f41b403fc8c26cbb6aab04f...d03325edfd593d7610ea2503d233e134c6cbf289,1,11,4,15,1,2014-07-01 20:05:46,2014-06-27 21:24:22
d03325edfd593d7610ea2503d233e134c6cbf289...0b6a611957ff76ffa4ef87fb46cb2e2af626485b,1,1,1,2,1,2014-07-01 20:05:46,2014-06-27 21:26:38
0b6a611957ff76ffa4ef87fb46cb2e2af626485b...ca6a45c22afbca01688b8b409dea2e895c17739d,1,1,0,1,1,2014-07-01 20:05:46,2014-06-27 22:11:13
ca6a45c22afbca01688b8b409dea2e895c17739d...8d7f5c243369f8bec1db8f09f2f53f1a736ca7ff,2,13,4,17,4,2014-07-01 20:05:46,2014-06-27 22:14:31
8d7f5c243369f8bec1db8f09f2f53f1a736ca7ff...251a7bc16af666831d09b57bbfef74c658f43484,1,3,0,3,1,2014-07-01 20:05:46,2014-07-01 00:48:27
251a7bc16af666831d09b57bbfef74c658f43484...510bdfea5543b8201740de7211903b0f29750d22,5,143,93,236,39,2014-07-01 20:05:46,2014-07-01 04:11:51
510bdfea5543b8201740de7211903b0f29750d22...971cbefbac92546558df3b19c41edc07de13c38b,1,6,1,7,2,2014-07-01 20:05:46,2014-07-01 05:10:45
971cbefbac92546558df3b19c41edc07de13c38b...9daaf11e000728ac47af124a880b2028d3f38b32,1,2,2,4,2,2014-07-01 20:05:46,2014-07-01 05:11:31
9daaf11e000728ac47af124a880b2028d3f38b32...427b5de0093a1625ceefd6fddf3999a6814e445a,1,1,1,2,1,2014-07-01 20:05:46,2014-07-01 05:11:44
427b5de0093a1625ceefd6fddf3999a6814e445a...a94fe4fe225d1b8ba3b80af135898876c0e6e54f,1,1,0,1,1,2014-07-01 20:05:46,2014-07-01 05:13:39
a94fe4fe225d1b8ba3b80af135898876c0e6e54f...c57ef461ade6adcf018e1abc1557941d0858993b,1,1,1,2,1,2014-07-01 20:06:57,2014-07-01 20:06:57
c57ef461ade6adcf018e1abc1557941d0858993b...3247e8a8357eb275e7b680f122aa6d034a2f33ab,1,1,1,2,1,2014-07-01 20:18:46,2014-07-01 20:18:46
84b2212b06544f925af7e440127154d899c5d43b...ab839d4520d7af47bc2ff82da220f674468241d8,7,269,37,306,23,2014-06-10 23:57:06,2014-06-10 23:57:06
ab839d4520d7af47bc2ff82da220f674468241d8...b01f51703549eed5b805751335d559c869ae5d79,1,2,0,2,1,2014-06-11 01:05:03,2014-06-11 01:05:03
b01f51703549eed5b805751335d559c869ae5d79...a1b3014e36260c9b0d05f9b1e5066e00066101c4,4,106,131,237,13,2014-06-11 01:08:50,2014-06-11 01:06:07
a1b3014e36260c9b0d05f9b1e5066e00066101c4...286023adfe90dd96326cca3777e754d60855b8a1,4,35,35,70,13,2014-06-11 01:09:56,2014-06-11 01:09:56
286023adfe90dd96326cca3777e754d60855b8a1...31d62a5094e800670e48c83a74de089447b41403,1,0,60,60,1,2014-06-11 01:50:41,2014-06-11 01:50:41
31d62a5094e800670e48c83a74de089447b41403...6d3257909dead9d228fac752ff2fb286fce6b4d6,19,158,36,194,38,2014-06-11 02:13:48,2014-06-11 02:13:48
6d3257909dead9d228fac752ff2fb286fce6b4d6...d422da35845d8641e09a093b4f70190e8b5f95e6,4,58,50,108,14,2014-06-11 02:25:38,2014-06-11 02:25:38
d422da35845d8641e09a093b4f70190e8b5f95e6...553af3515b87d0d82b84b203e323bee21e3e51f5,5,87,28,115,29,2014-06-11 05:05:52,2014-06-11 05:05:05
84b2212b06544f925af7e440127154d899c5d43b...213b665c6a746741b318625d57079e4a362a56d8,5,284,93,377,49,2014-06-10 23:52:33,2014-06-10 23:52:33
213b665c6a746741b318625d57079e4a362a56d8...27c08c74fc7fd96f4dbacfb55a1bf23c75ed1bd0,5,36,13,49,21,2014-06-11 00:33:12,2014-06-11 00:33:12
27c08c74fc7fd96f4dbacfb55a1bf23c75ed1bd0...3905575bc8e1448366526a239d37199165110edf,3,12,5,17,5,2014-06-11 02:34:07,2014-06-11 02:34:07
3905575bc8e1448366526a239d37199165110edf...c37fe9f1a19a1f3ff9e0c7ab1437253686e06982,3,37,138,175,26,2014-06-11 19:32:36,2014-06-11 19:32:36
c37fe9f1a19a1f3ff9e0c7ab1437253686e06982...749cd163caa78c5cbd84f7580cffd57351d7a851,4,5,22,27,9,2014-06-11 19:37:06,2014-06-11 19:37:06
749cd163caa78c5cbd84f7580cffd57351d7a851...e2a84a4fe6e0ef4fdcd89c748aa3eb9afebfd705,5,27,22,49,21,2014-06-11 20:28:47,2014-06-11 20:28:47
e2a84a4fe6e0ef4fdcd89c748aa3eb9afebfd705...e98cdcdfd858b4154f07fe2007b3d16b48c53c38,1,1,1,2,1,2014-06-11 22:14:36,2014-06-11 22:14:36
e98cdcdfd858b4154f07fe2007b3d16b48c53c38...5a1f178e21058ed49541e68ec9f3cb95d016ac69,1,2,1,3,1,2014-06-11 22:17:09,2014-06-11 22:17:09
5a1f178e21058ed49541e68ec9f3cb95d016ac69...823679d39e91a41af8db453f1bd0f196e2f7c260,3,18,33,51,15,2014-06-11 22:46:24,2014-06-11 22:46:24
823679d39e91a41af8db453f1bd0f196e2f7c260...7bd0c26ce78f1b3113335653e53f786576a8aa36,1,4,1,5,3,2014-06-11 22:51:11,2014-06-11 22:48:52
8a16f50138f1a64abeb4d6b0660f123793c757a1...7839c26cef0d95b792e679bb39d53b2710defeef,2,70,3,73,3,2014-03-18 01:07:29,2014-03-18 01:06:47
7839c26cef0d95b792e679bb39d53b2710defeef...67d42747edef751525f3aaa34b347e598a016e74,1,13,11,24,5,2014-03-18 16:47:07,2014-03-18 16:47:07
67d42747edef751525f3aaa34b347e598a016e74...7ea715173c226bf6f9089ccb41dff9f608ef5efa,1,2,20,22,3,2014-03-18 16:47:25,2014-03-18 16:47:25
2952edc73a3b6dd9feb76afb6e1c4d5d54458337...8b28f1fab629b0950dfec412dd57033be78687d0,1,12,16,28,8,2014-01-23 01:45:24,2014-01-23 01:45:24
4541f72279838dd7178898b6efbc29250e413838...10cdd65f2cc1d1067ce7bc685a8857bd0812b038,1,13,5,18,1,2014-02-18 02:49:52,2014-01-28 05:55:36
4541f72279838dd7178898b6efbc29250e413838...859ff555fe440b2e3dec914e9ac2f99f57322168,4,239,40,279,31,2014-02-18 00:10:18,2014-02-05 22:33:11
859ff555fe440b2e3dec914e9ac2f99f57322168...ad0c88f07183eaef7a1b3d5ada6e1fffbd6edc38,1,15,8,23,8,2014-02-18 00:10:18,2014-02-12 00:45:47
ad0c88f07183eaef7a1b3d5ada6e1fffbd6edc38...b8429fa0b18cf68573441d97c64a7fbb8cd1b139,1,1,0,1,1,2014-02-18 00:10:18,2014-02-12 05:57:49
b8429fa0b18cf68573441d97c64a7fbb8cd1b139...818a770ed93d02c8a930b8fd4aaf6cb93df20888,1,2,2,4,2,2014-02-18 00:10:18,2014-02-12 05:58:09
818a770ed93d02c8a930b8fd4aaf6cb93df20888...c389dadc460728c5618fea75b2bca1415f2ae472,1,4,3,7,3,2014-02-18 00:10:19,2014-02-12 05:59:13
c389dadc460728c5618fea75b2bca1415f2ae472...7493890bb2855affbd2d7e71e4dd6a490380035e,2,8,8,16,7,2014-02-18 00:10:19,2014-02-12 07:27:07
7493890bb2855affbd2d7e71e4dd6a490380035e...4e095325cd38c074efc5a1ca1fb6d4e5720bdc70,1,4,4,8,4,2014-02-18 00:10:19,2014-02-12 08:13:20
4e095325cd38c074efc5a1ca1fb6d4e5720bdc70...690f7c485bce0e1686e3fb5bff71c0caa0d24be1,1,77,0,77,1,2014-02-18 00:10:19,2014-02-12 08:14:16
690f7c485bce0e1686e3fb5bff71c0caa0d24be1...cfadc51b91c9682d904a363b56dc314dc5282a4e,2,55,4,59,5,2014-02-18 00:10:19,2014-02-12 09:44:51
cfadc51b91c9682d904a363b56dc314dc5282a4e...8be6928b4c74ea29986caa7762157769ebb9b2fb,1,15,2,17,3,2014-02-18 00:10:19,2014-02-13 01:34:44
8be6928b4c74ea29986caa7762157769ebb9b2fb...3ac9cf88b74842d965a41932d1108b2f06d3eaa7,2,7,5,12,5,2014-02-18 00:10:19,2014-02-13 05:12:33
3ac9cf88b74842d965a41932d1108b2f06d3eaa7...10d97c70c50e3aa7e73115556fa43cd57eeade42,2,53,11,64,16,2014-02-18 00:10:19,2014-02-15 02:58:19
10d97c70c50e3aa7e73115556fa43cd57eeade42...92d38af16dc4d199f95f8e9201be32eeb60b38ee,1,6,0,6,1,2014-02-18 00:10:19,2014-02-15 09:32:05
92d38af16dc4d199f95f8e9201be32eeb60b38ee...1071b37ed445225c19f9ff96dac7f95e8632fbd5,1,8,11,19,8,2014-02-18 00:10:19,2014-02-17 21:47:26
1071b37ed445225c19f9ff96dac7f95e8632fbd5...5b0663993abf2eac076ba162f3db75c0721f4bf1,1,3,8,11,2,2014-02-18 00:10:19,2014-02-17 21:47:38
5b0663993abf2eac076ba162f3db75c0721f4bf1...8b931e64d6dbe811e4cc48472625b9551e91d216,1,36,21,57,5,2014-02-18 00:10:19,2014-02-17 23:00:51
8b931e64d6dbe811e4cc48472625b9551e91d216...a5ddd71b1d14c70123875a7e6cb78ab1b07c6cc9,1,7,2,9,2,2014-02-18 00:10:20,2014-02-17 23:05:18
a5ddd71b1d14c70123875a7e6cb78ab1b07c6cc9...c03701ef1c98838a52d6030ea7cf334612dc32dc,2,4,5,9,5,2014-02-18 01:01:10,2014-02-18 01:01:10
c03701ef1c98838a52d6030ea7cf334612dc32dc...07a18984b15a581e07ae4efcba01ee8b6dba2a38,1,25,10,35,12,2014-02-18 01:25:01,2014-02-18 01:25:01
07a18984b15a581e07ae4efcba01ee8b6dba2a38...f336c61eda75174e75879af2132c62071b64d8aa,1,13,3,16,4,2014-02-18 01:30:46,2014-02-18 01:30:46
f336c61eda75174e75879af2132c62071b64d8aa...e4eb3e3c75d525d8e2d878f97b1b5c87f303dc28,1,1,1,2,1,2014-02-18 01:49:39,2014-02-18 01:49:39
99cb0d491edf714ae6ba9d621202f7480f9456b2...f5ed36293b01ef8e75822dd2171e46cdc3a10e3c,2,50,25,75,19,2014-02-17 00:24:15,2014-02-17 00:24:15
f5ed36293b01ef8e75822dd2171e46cdc3a10e3c...d393ce1c7dd3a94511f593e88ab709b3d9457e5a,2,57,45,102,28,2014-02-17 00:45:50,2014-02-17 00:45:50
d393ce1c7dd3a94511f593e88ab709b3d9457e5a...2a5425fcb657558babfafc4fc1074667c211cbaa,3,13,10,23,9,2014-02-17 00:57:04,2014-02-17 00:52:00
2a5425fcb657558babfafc4fc1074667c211cbaa...bda36d7732677c42549f4eac2e02853c259bb924,1,5,1,6,1,2014-02-17 01:04:00,2014-02-17 01:04:00
bda36d7732677c42549f4eac2e02853c259bb924...645e23c73a18cf232c272aebe5bb7c92e3d1474a,1,3,1,4,1,2014-02-17 01:29:37,2014-02-17 01:29:37
f19331fc44a75f05a48c4e76fdd5e6156ccb702e...dc4eb4c49613f5407f63dea9eac1415484905878,1,7,11,18,4,2014-02-20 08:03:15,2014-02-20 08:01:19
2ef965f34ecfa7f55e1e8d5724a28bfa8c8c609e...2f6bb62170fe8f491180804fc4d38f04de448dc4,1,2,2,4,2,2014-02-19 23:49:06,2014-02-19 23:49:06
2f6bb62170fe8f491180804fc4d38f04de448dc4...2ff0fa38ed9fe75f053ae461ef41899c1eb9ca71,1,2,1,3,1,2014-02-19 23:49:46,2014-02-19 23:49:46
2ff0fa38ed9fe75f053ae461ef41899c1eb9ca71...1f8760acfcc87022aa77913fec1e7901ac0481a5,1,1,1,2,1,2014-02-19 23:52:31,2014-02-19 23:52:31
1f8760acfcc87022aa77913fec1e7901ac0481a5...023276cd50e9f0be817870b34da711b2b79ddf21,1,14,1,15,2,2014-02-19 23:52:57,2014-02-19 23:52:57
023276cd50e9f0be817870b34da711b2b79ddf21...0663aaa435b4c3446260b685bc0dddced97e2d0c,1,2,1,3,1,2014-02-20 01:04:22,2014-02-20 01:04:22
0663aaa435b4c3446260b685bc0dddced97e2d0c...829dfdac681fe242668f4f7e8af5d6152e9fa5c5,2,13,5,18,4,2014-02-20 03:35:19,2014-02-20 03:21:30
829dfdac681fe242668f4f7e8af5d6152e9fa5c5...eee4c0c9e783ad1a618a01931ffe8570603db5c6,1,54,0,54,2,2014-02-20 03:36:54,2014-02-20 03:36:54
163dccf5e7f0f34a074a62e05300b0e7b7b0497a...9fefc349e02fd7455aa91f7f6331604ec5e7aa31,2,7,2,9,4,2013-12-09 21:56:04,2013-12-09 21:56:04
163dccf5e7f0f34a074a62e05300b0e7b7b0497a...51b3cef688571c2e0c8b6d41acfaa690d38d8368,7,8,16,24,9,2013-12-07 06:41:46,2013-12-07 06:41:46
51b3cef688571c2e0c8b6d41acfaa690d38d8368...ead40e18d304d6e10c2f5a18d3471523fefd2bef,4,261,36,297,42,2013-12-07 06:42:36,2013-12-07 06:42:36
ead40e18d304d6e10c2f5a18d3471523fefd2bef...88d58a0efe9eda8b0df510f6abc500d0e91b8794,1,2,0,2,1,2013-12-07 06:43:05,2013-12-07 06:43:05
c346568cefede0452d662f68e046e947631e8d64...f0ab5802544b91682cc35d66a845a176e3c1dc3e,1,6,11,17,5,2014-06-10 21:58:34,2014-06-10 21:58:34
c346568cefede0452d662f68e046e947631e8d64...832f3bab0208db9a27837d6da08472d550d020ba,2,82,0,82,2,2014-06-10 21:51:58,2014-06-10 21:51:39
0fff6352068e20a0609d330e09bf1d30eab7c9e7...2d449ca7522be93f1e8143f4ad9aacf2efa54b4b,1,1,1,2,1,2014-06-18 02:41:23,2014-06-18 02:41:23
2d449ca7522be93f1e8143f4ad9aacf2efa54b4b...73e737d30f33975dce0ba2e951f28323bd4444a7,5,42,32,74,12,2014-06-19 01:54:00,2014-06-19 01:54:00
73e737d30f33975dce0ba2e951f28323bd4444a7...00490f97dd177071c19c4bf852e3dd6c4e860aa1,1,45,24,69,2,2014-06-19 02:36:07,2014-06-19 02:36:07
00490f97dd177071c19c4bf852e3dd6c4e860aa1...285a3ef8d4fa692902c0a6a9c85993996d707daa,1,1,2,3,1,2014-06-19 05:10:24,2014-06-19 05:10:24
285a3ef8d4fa692902c0a6a9c85993996d707daa...8018f38f8bb47cf0e30bd8020e1ceb1d89c338a3,1,4,2,6,3,2014-06-20 22:11:36,2014-06-20 22:11:36
b845f8e7ebb8c69f7e4a02f1684ebc777077c66e...02c0c4de68d96f0060318caca94f4dc2c3f6ea61,3,37,7,44,7,2014-06-20 20:28:23,2014-06-20 20:28:23
02c0c4de68d96f0060318caca94f4dc2c3f6ea61...42b0cad48f28348fa980753321d1fc2292c83282,3,15,26,41,13,2014-06-20 21:06:37,2014-06-20 20:51:57
b845f8e7ebb8c69f7e4a02f1684ebc777077c66e...79c5e305996a4a61a4d43cbbfe81fd8c28b40c3e,3,33,4,37,6,2014-06-20 01:05:45,2014-06-20 01:05:45
79c5e305996a4a61a4d43cbbfe81fd8c28b40c3e...ed7a3cd1511761ae51b3a1c475aa223af73ecc11,3,20,19,39,11,2014-06-20 18:58:28,2014-06-20 18:57:34
7b1cddad0ca419a5000dc46aea2e677328ab0413...69455d4df7f66fd600bc353a8b112fce40c8e93e,1,1,1,2,1,2014-06-22 15:27:42,2014-06-22 15:27:42
69455d4df7f66fd600bc353a8b112fce40c8e93e...2b87aa1f00a347778ce3f0938231b196e59e5afb,1,14,7,21,4,2014-06-22 23:31:13,2014-06-22 23:31:13
2b87aa1f00a347778ce3f0938231b196e59e5afb...fba413d5976afcd97ff22bf47577b437575744df,3,20,6,26,6,2014-06-23 15:04:59,2014-06-23 15:04:59
fba413d5976afcd97ff22bf47577b437575744df...5cba1289e83e3a1ddd06d459bb62798dd6bbf6f0,7,7,7,14,7,2014-06-23 15:13:51,2014-06-23 15:13:51
e1691e013e40920bf5d77a453495c6ade1a5f00a...792edd288b1464e84e43f9f722e468e316985731,2,32,14,46,14,2014-09-18 00:53:29,2014-09-16 03:42:24
792edd288b1464e84e43f9f722e468e316985731...851d3e40859a12069202b4ff43b3f69134447fe8,1,3,2,5,2,2014-09-18 00:55:06,2014-09-18 00:55:06
851d3e40859a12069202b4ff43b3f69134447fe8...489d4c4c6de782ee7f53a7fe8077fa603fb70853,1,2,2,4,2,2014-09-18 00:59:18,2014-09-18 00:59:18
489d4c4c6de782ee7f53a7fe8077fa603fb70853...e52d2bb8dc1408952fe1d1aeab7cc8e9a0fbe5dd,1,1,1,2,1,2014-09-18 01:03:09,2014-09-18 01:03:09
e52d2bb8dc1408952fe1d1aeab7cc8e9a0fbe5dd...2a0bd1175aaa613e116c05d0965f414d1fc9b3fa,1,1,1,2,1,2014-09-18 01:26:05,2014-09-18 01:26:05
2a0bd1175aaa613e116c05d0965f414d1fc9b3fa...c78effee6f1ccc61c2852ad122144235726ef62c,1,1,1,2,1,2014-09-18 02:55:04,2014-09-18 02:55:04
c78effee6f1ccc61c2852ad122144235726ef62c...31925e1b66fdbb8808e26a11bb8c33b8874f7bfd,2,2,2,4,2,2014-09-18 03:00:23,2014-09-18 03:00:23
31925e1b66fdbb8808e26a11bb8c33b8874f7bfd...15460e83bfb4cb520e0b8bc9c40d6d76f232c202,5,5,5,10,5,2014-09-18 03:04:25,2014-09-18 03:04:25
f6cec67c500aa58e662fd2c9da5f00d40c3a979e...b8ef6e360374c75ae93000fa99dff777aa137886,1,1,1,2,1,2014-09-08 05:42:03,2014-09-08 05:42:03
ac1898b3131062d732ef9da04703a324d61076cb...e5bdd127cfc6556936817af699e570b703c2ddb6,1,1,1,2,1,2014-09-09 04:29:14,2014-09-09 04:27:07
e5bdd127cfc6556936817af699e570b703c2ddb6...fb3fb5de03650b24e5aebb91d934119a075df791,7,7,7,14,7,2014-09-09 14:52:41,2014-09-09 14:52:41
fb3fb5de03650b24e5aebb91d934119a075df791...3548f64b839cf275efb3ddcba9297383506bc953,4,0,284,284,4,2014-09-09 15:30:15,2014-09-09 15:30:15
3548f64b839cf275efb3ddcba9297383506bc953...8a8df1f89db28ee77074aa851a50d4800ce9e61a,10,52,30,82,23,2014-09-09 17:37:07,2014-09-09 17:37:07
8a8df1f89db28ee77074aa851a50d4800ce9e61a...1971765628ecd9e5f314efc46444bd1586fe9eed,1,1,3,4,1,2014-09-09 17:41:37,2014-09-09 17:41:37
1971765628ecd9e5f314efc46444bd1586fe9eed...1307d4b01581b37b7bd58653aba5e1d4109e88bb,1,5,0,5,1,2014-09-09 18:08:02,2014-09-09 18:08:02
1307d4b01581b37b7bd58653aba5e1d4109e88bb...b40a53ac914030ff93fa5338b9a1b92ff0a2e547,1,14,0,14,1,2014-09-09 18:08:18,2014-09-09 18:08:18
b40a53ac914030ff93fa5338b9a1b92ff0a2e547...3f680f76a422107c25f1934b8ccb6fd9aee1b471,5,5,5,10,5,2014-09-09 18:11:38,2014-09-09 18:11:38
3f680f76a422107c25f1934b8ccb6fd9aee1b471...b795137fcf5d5dca2f56bb011e1da0b64952bc6f,1,1,1,2,1,2014-09-09 21:01:48,2014-09-09 21:01:48
b795137fcf5d5dca2f56bb011e1da0b64952bc6f...3445a2712c162f9ebc9f78b6867590e8f9d43649,1,1,1,2,1,2014-09-09 21:02:03,2014-09-09 21:02:03
3445a2712c162f9ebc9f78b6867590e8f9d43649...1c6efabc456e0c7a1ee0497583c40941e5f3ad0c,1,3,2,5,1,2014-09-09 21:03:28,2014-09-09 21:03:28
1c6efabc456e0c7a1ee0497583c40941e5f3ad0c...58b5d1f6db87b19442eb2a18624975b8773420ac,2,13,5,18,4,2014-09-09 21:04:35,2014-09-09 21:04:35
58b5d1f6db87b19442eb2a18624975b8773420ac...7ccec45494926eb85c64f34d3316ab4e6bfe394b,1,15,15,30,9,2014-09-09 21:05:22,2014-09-09 21:05:22
7ccec45494926eb85c64f34d3316ab4e6bfe394b...404f1cc17ece5752de7c9d1b9626a1c055ef3629,1,2,2,4,2,2014-09-09 23:41:06,2014-09-09 23:41:06
404f1cc17ece5752de7c9d1b9626a1c055ef3629...e192a9da67b9ff28c8bfefbdc8d74ed3f38a7e18,1,2,2,4,2,2014-09-10 01:26:30,2014-09-10 01:26:30
e192a9da67b9ff28c8bfefbdc8d74ed3f38a7e18...4b0660934648ff19db30803f5faf84bedfe2c5d2,1,1,1,2,1,2014-09-10 01:40:28,2014-09-10 01:40:28
4b0660934648ff19db30803f5faf84bedfe2c5d2...2375220191925f0cc37fbbb4ab829f85d95b24a2,1,1,1,2,1,2014-09-10 01:52:08,2014-09-10 01:52:08
2375220191925f0cc37fbbb4ab829f85d95b24a2...63381e5ee4f52062c6ba5c0f271e88efd7f59c36,4,4,4,8,4,2014-09-10 01:59:17,2014-09-10 01:59:17
63381e5ee4f52062c6ba5c0f271e88efd7f59c36...f4e100dc146d233521e2084c7457dd4e32c53c0f,1,6,1,7,1,2014-09-10 04:28:08,2014-09-10 04:28:08
f4e100dc146d233521e2084c7457dd4e32c53c0f...26eb9f0736ad60f6121a83ddee11125728842932,1,7,5,12,2,2014-09-10 18:22:12,2014-09-10 18:19:51
26eb9f0736ad60f6121a83ddee11125728842932...3b5c2537be75ea4d308798bc67fd9fb9d21a9995,2,18,0,18,2,2014-09-10 22:42:07,2014-09-10 21:38:30
3b5c2537be75ea4d308798bc67fd9fb9d21a9995...79da5dc9b820b4b6e69e9f8cf72d7c6ac631297f,2,3,2,5,3,2014-09-10 22:42:16,2014-09-10 21:43:25
79da5dc9b820b4b6e69e9f8cf72d7c6ac631297f...2c692668ca872c41cbc86ff8f9eac309b1deb496,1,8,0,8,1,2014-09-10 22:42:25,2014-09-10 22:27:54
2c692668ca872c41cbc86ff8f9eac309b1deb496...21fe416bff3913f6209b9c587c0e7ae34332c045,1,1,1,2,1,2014-09-10 22:42:32,2014-09-10 22:28:46
21fe416bff3913f6209b9c587c0e7ae34332c045...4698181afa7bdc0a3644aafb65452631f47f105c,1,45,0,45,5,2014-09-10 22:44:54,2014-09-10 06:28:28
4698181afa7bdc0a3644aafb65452631f47f105c...ac617110eaf0e2f92b088492f169ae234fbf50ae,4,25,6,31,8,2014-09-10 22:45:50,2014-09-10 16:16:03
ac617110eaf0e2f92b088492f169ae234fbf50ae...5934ecd5776df984acd1b8f60288f35c085104de,1,2,0,2,1,2014-09-10 22:46:04,2014-09-10 16:22:11
5934ecd5776df984acd1b8f60288f35c085104de...7c666f929e1611667a9c2a812b1d45e84169eb92,2,8,2,10,2,2014-09-10 22:46:32,2014-09-10 16:28:56
7c666f929e1611667a9c2a812b1d45e84169eb92...0c3e0e786a820e9e6b6f5b6a2d1583c5235a4f1d,2,6,4,10,4,2014-09-10 22:47:17,2014-09-10 16:46:30
0c3e0e786a820e9e6b6f5b6a2d1583c5235a4f1d...4f19ac1d9f90e574176c78d05abe22a14bc937fb,1,3,0,3,1,2014-09-10 22:47:50,2014-09-10 16:54:26
4f19ac1d9f90e574176c78d05abe22a14bc937fb...2efcf789bd5e41919df98c1bbda3008117a48c74,1,0,5,5,1,2014-09-10 22:47:56,2014-09-10 20:36:27
2efcf789bd5e41919df98c1bbda3008117a48c74...4b40e5982dfdfc63c34879889450fd98bdb6bdda,3,28,5,33,6,2014-09-10 22:48:20,2014-09-10 22:37:10
ac1898b3131062d732ef9da04703a324d61076cb...6bbffaae5ad15dbd76dfdf9a237ef21a6f91036f,7,74,123,197,24,2014-09-09 01:06:03,2014-09-09 01:06:03
6bbffaae5ad15dbd76dfdf9a237ef21a6f91036f...8643e52801244ab3cdd0e87b6d3f9ad3e043498d,2,2,2,4,2,2014-09-09 06:15:12,2014-09-09 06:15:12
8643e52801244ab3cdd0e87b6d3f9ad3e043498d...51b588b40e6e4f4bbdd0862b01c857c74a1ced04,2,4,2,6,3,2014-09-09 07:04:48,2014-09-09 07:04:48
51b588b40e6e4f4bbdd0862b01c857c74a1ced04...2d6d04c80e70a8a3b63304764d19d87b4cb90d2e,1,28,27,55,12,2014-09-09 07:05:12,2014-09-09 07:05:12
2d6d04c80e70a8a3b63304764d19d87b4cb90d2e...fa593653b627eee05cea8bcd2697d383eec0b162,1,1,1,2,1,2014-09-09 07:54:47,2014-09-09 07:54:47
fa593653b627eee05cea8bcd2697d383eec0b162...a9b8213ec49395f731cad61dc5dfec8f71f6dbaf,1,1,1,2,1,2014-09-09 22:01:27,2014-09-09 22:01:27
a9b8213ec49395f731cad61dc5dfec8f71f6dbaf...10599e5bc508d14e6f5adb55bf0a51230712fbf5,3,74,8,82,12,2014-09-09 22:56:11,2014-09-09 22:53:53
10599e5bc508d14e6f5adb55bf0a51230712fbf5...ec30f42945904e79a549c9e592f5f8b5b54e42e0,2,6,2,8,2,2014-09-09 23:19:03,2014-09-09 05:20:10
ec30f42945904e79a549c9e592f5f8b5b54e42e0...939bf1bc07f314c90b02d56586555b402c898045,1,7,3,10,3,2014-09-09 23:38:11,2014-09-09 23:38:11
939bf1bc07f314c90b02d56586555b402c898045...ec02f2281f940c7be7e5ecf6d68d3fcfb83f5fcc,1,15,9,24,4,2014-09-09 23:56:10,2014-09-09 23:56:10
ec02f2281f940c7be7e5ecf6d68d3fcfb83f5fcc...dfcaa3fdc884432e21e24a3da1c4293067691b56,1,7,4,11,1,2014-09-10 00:37:33,2014-09-10 00:37:33
ac1898b3131062d732ef9da04703a324d61076cb...4ca704f93f22300499b09e0d83e457a1a85e54e6,3,217,0,217,9,2014-09-08 16:14:21,2014-09-08 16:14:21
511ddb479b59df638a0e66ea24326ae169cfc08e...80da41c048a7f31f1d259100808c765e00934632,1,4,1,5,1,2014-09-05 18:06:52,2014-09-05 18:06:52
511ddb479b59df638a0e66ea24326ae169cfc08e...378a244dfa47d112e8972923ae458eab30e62ead,1,1,2,3,1,2014-09-05 17:35:48,2014-09-05 00:17:20
378a244dfa47d112e8972923ae458eab30e62ead...2f58a24e0fa32d56a4fa716f37bca3aad9841550,11,88,35,123,22,2014-09-05 17:35:48,2014-09-05 00:14:05
6f829b32a9d20680aff7930b19feba4d9ae575fd...0772306c2d967f8c20504fc21cdfd65b7dd171af,5,12,4,16,5,2014-09-06 01:47:58,2014-09-06 01:47:58
0772306c2d967f8c20504fc21cdfd65b7dd171af...cd5b9874171c6598e2b7dbd99c9c1a7c571e6433,9,53,2612,2665,15,2014-09-06 02:04:54,2014-09-06 02:04:54
ca4ff126f2baab7cd3278fd45f1961f832fae8f1...a3cec3b6dc3a59cfbf265949d8b08ef974da7afc,4,62,54,116,4,2014-08-28 04:14:34,2014-08-28 04:14:07
a3cec3b6dc3a59cfbf265949d8b08ef974da7afc...27ac79925db23f4a4b8d58a0539634127a72e47c,1,1,0,1,1,2014-08-28 05:03:30,2014-08-28 05:03:30
422b4fa36de874dd27f3a795580c88f90af73cec...c689f14cf14d22598f25ebc25e9b34440f4cdacb,1,1,1,2,1,2014-08-28 01:50:11,2014-08-28 01:50:11
422b4fa36de874dd27f3a795580c88f90af73cec...fc1b3e596e670afef83093ddd1e13326764ff7b7,1,8,3,11,4,2014-08-27 22:56:07,2014-08-27 19:00:56
fc1b3e596e670afef83093ddd1e13326764ff7b7...d5e3b2691a08d652f39ce9e174955fa06d1f9421,2,15,2,17,2,2014-08-27 22:56:07,2014-08-27 19:18:53
d5e3b2691a08d652f39ce9e174955fa06d1f9421...1b9f57322b4865b9f83aaac2947e026153bf9069,3,121,24,145,7,2014-08-27 22:56:08,2014-08-27 19:19:33
1b9f57322b4865b9f83aaac2947e026153bf9069...3e999c4f691b1834ed6b626480f8f7b6cf39d5b2,1,3,1,4,2,2014-08-27 22:56:08,2014-08-27 20:53:02
75427d70ce4458e2060a5cb925a24e02ffc45364...124b0d869ed5adc933a5c678f76a276881bd0820,15,15,15,30,15,2014-08-27 20:41:07,2014-08-27 20:39:14
124b0d869ed5adc933a5c678f76a276881bd0820...bd86ed345042e71eb6505b32f2dd912282863df4,3,21,4,25,7,2014-08-27 22:33:00,2014-08-27 22:33:00
bd86ed345042e71eb6505b32f2dd912282863df4...dbbb6b136c0cbc27bdcbf0ba1a2d64f4a9506afd,1,0,1,1,1,2014-08-27 22:39:35,2014-08-27 22:39:35
dbbb6b136c0cbc27bdcbf0ba1a2d64f4a9506afd...1bb44c3cd1624f9d056d14564e27d6bb09463202,1,70,26,96,7,2014-08-27 22:40:57,2014-08-27 22:38:02
1bb44c3cd1624f9d056d14564e27d6bb09463202...d101f933050498d93f79b12896a28ff2e2e62ac8,1,15,3,18,2,2014-08-28 00:09:22,2014-08-28 00:06:48
d101f933050498d93f79b12896a28ff2e2e62ac8...d14d2c74b0b571c17bdb951fdae646944b97dac3,4,4,4,8,4,2014-08-28 00:18:48,2014-08-28 00:18:48
d14d2c74b0b571c17bdb951fdae646944b97dac3...579396329a9aeafac458761770cdcb8a5bf87fc3,9,79,76,155,25,2014-08-28 06:17:33,2014-08-28 06:09:52
579396329a9aeafac458761770cdcb8a5bf87fc3...91b193d5fb236811c1a9373c349c4655f33bd100,2,20,0,20,3,2014-08-28 19:34:53,2014-08-28 19:34:53
91b193d5fb236811c1a9373c349c4655f33bd100...0af50c04ef52154aae1df3f4e81afd081eff8445,11,89,87,176,51,2014-08-28 20:35:26,2014-08-28 20:34:49
0af50c04ef52154aae1df3f4e81afd081eff8445...3f821867d0bd86633da9e2db40d42ad445b16597,2,7,3,10,3,2014-08-28 22:31:07,2014-08-28 22:31:07
3f821867d0bd86633da9e2db40d42ad445b16597...50a5d7f7f89bee348bbdeaea3555c072280fd6b8,2,88,7,95,45,2014-08-28 22:34:34,2014-08-28 22:34:01
50a5d7f7f89bee348bbdeaea3555c072280fd6b8...54155531a157b73037d4737da9c6778f4ba91e81,4,3,1,4,3,2014-08-28 23:00:19,2014-08-28 23:00:19
54155531a157b73037d4737da9c6778f4ba91e81...81e216c599fd588d1b3d14734e69e1aedde3164a,1,7,1,8,1,2014-08-28 23:10:05,2014-08-28 23:10:05
5bcc6fbf84b2ffa7815652c61aabe6213f084a21...40dc5e77357fd65c8161690726fddb257f816112,9,72,22,94,27,2014-08-27 18:17:40,2014-08-27 18:17:40
40dc5e77357fd65c8161690726fddb257f816112...d057ec4a3a5253005e8a7420784dd6298e4f3e74,8,31,12,43,15,2014-08-27 19:51:59,2014-08-27 19:51:59
d057ec4a3a5253005e8a7420784dd6298e4f3e74...b89d48e2aac5e6605ef27c933d486bca6e75bd63,1,31,0,31,1,2014-08-27 21:26:36,2014-08-27 21:26:36
b89d48e2aac5e6605ef27c933d486bca6e75bd63...9f65ec1ba0191d6f96ac65027aa638007520b025,1,115,0,115,1,2014-08-27 21:41:51,2014-08-27 21:41:51
9f65ec1ba0191d6f96ac65027aa638007520b025...29ff6a8d99b4a52ef1c03d5845287a5989b96c77,3,17,2,19,3,2014-08-27 21:46:55,2014-08-27 21:46:55
f89e633553bac394cf28a98e1e141ad10f316054...5a3774c758ddc7a2ac8fc086119526dd89ba5b3f,1,7,0,7,1,2014-08-27 05:16:03,2014-08-27 05:16:03
5a3774c758ddc7a2ac8fc086119526dd89ba5b3f...a038ef99e840569c896ae34ee5b2e3ee96e88019,1,9,13,22,1,2014-08-27 06:04:03,2014-08-27 06:04:03
a038ef99e840569c896ae34ee5b2e3ee96e88019...d7636ebda05f00ff8c979b74fd67a0c8dc9388b3,1,1,0,1,1,2014-08-27 06:16:31,2014-08-27 06:15:38
f89e633553bac394cf28a98e1e141ad10f316054...c76f506496c94760d705a5b9eeb11b2af9d663de,5,175,129,304,9,2014-08-27 03:24:37,2014-08-27 03:24:37
8ab5f4f927f0b406bff69cce1841b6749f954c97...47c5e638b95a266a7466305c9ef937a3df0e6d48,4,202,2386,2588,28,2014-08-27 04:34:42,2014-08-27 04:34:42
47c5e638b95a266a7466305c9ef937a3df0e6d48...f2cab6651bbdde2d05a70dc420a73644611e14d6,2,2261,0,2261,2,2014-08-27 04:35:20,2014-08-27 04:35:20
f2cab6651bbdde2d05a70dc420a73644611e14d6...30323f9f676444d7df22cff5e1613f411f5700bb,2,0,2261,2261,2,2014-08-27 04:41:29,2014-08-27 04:41:29
30323f9f676444d7df22cff5e1613f411f5700bb...e50f71f404894cb40b5c72a3c0c054bc01e1eb39,4,2386,202,2588,28,2014-08-27 04:41:39,2014-08-27 04:41:39
e50f71f404894cb40b5c72a3c0c054bc01e1eb39...601fd6df5e0fcf04452934beed5a5b95b04b6b4d,4,116,7,123,7,2014-08-27 17:04:53,2014-08-27 17:04:53
c178b3de8a6b2bee5bf6ea88fa71d59e6360e877...c22de092e9c5435cbdaa18ef5c27117b2d7ccba4,3,3,9,12,3,2014-08-26 23:31:58,2014-08-26 23:31:58
c22de092e9c5435cbdaa18ef5c27117b2d7ccba4...28f8c0c9ef873c6920a2e2d5ad40229cb553796b,9,59,59,118,34,2014-08-27 00:26:03,2014-08-27 00:26:03
28f8c0c9ef873c6920a2e2d5ad40229cb553796b...dd77f94035037fa40875a8be9a3a6350de2fefb7,1,1,1,2,1,2014-08-27 00:30:18,2014-08-27 00:30:18
dd77f94035037fa40875a8be9a3a6350de2fefb7...bdb9ddfaaefa1a8ac2c47ba0dde20e4cde641b5a,2,6,6,12,6,2014-08-27 00:32:15,2014-08-27 00:32:15
bdb9ddfaaefa1a8ac2c47ba0dde20e4cde641b5a...01775074928cfe06f9276ea7cfae5583adad2ab9,4,19,18,37,13,2014-08-27 00:37:52,2014-08-27 00:37:52
01775074928cfe06f9276ea7cfae5583adad2ab9...d660ffd290e32b5a37b48ead9272b0f08b370350,16,83,102,185,61,2014-08-27 21:42:59,2014-08-27 21:42:59
5e967da62020f644508d3fa5cd5ce9d3d895aa4f...b7564b80ad2542c2138abdf9a23782649987cf5d,1,1,1,2,1,2014-08-11 23:12:47,2014-08-11 23:12:47
ea3eee950cdbe329a397809332ce6a0eb4b6cdbe...a3f99bbb9f3258900328b535db573d95f57102d5,4,62,0,62,4,2014-08-12 00:41:25,2014-08-12 00:41:25
a3f99bbb9f3258900328b535db573d95f57102d5...0c062381eeea4caa0dc366c440bf241d9c58c9c9,4,42,10,52,7,2014-08-12 01:05:39,2014-08-12 01:05:21
0c062381eeea4caa0dc366c440bf241d9c58c9c9...97fa38df7bce7247cd9dfd822f1cd54691a386aa,1,4,0,4,1,2014-08-12 01:06:46,2014-08-12 01:06:46
97fa38df7bce7247cd9dfd822f1cd54691a386aa...25b4db225e5e6f62ef429e3aa897bb1192a9e2c4,2,20,24,44,8,2014-08-12 02:23:34,2014-08-12 02:23:34
25b4db225e5e6f62ef429e3aa897bb1192a9e2c4...289abce37bd8ee8293683c40a6385f31289fa30f,1,1,2,3,2,2014-08-12 02:25:19,2014-08-12 02:25:19
289abce37bd8ee8293683c40a6385f31289fa30f...ff81c5fa83b304ffa4304a0d7be8a3042b4c64aa,2,44,19,63,6,2014-08-12 03:18:20,2014-08-12 03:18:20
ff81c5fa83b304ffa4304a0d7be8a3042b4c64aa...078ca9a0eb3821f61b525a52e677cef95247507a,1,7,3,10,1,2014-08-12 03:21:43,2014-08-12 03:21:43
1f5fc9d89a61342d6ae99e7bcc16683a6c6ce557...be0e2a0139534a719bfa9802bba2b3da4863c6cb,4,19,18,37,10,2014-08-17 19:04:25,2014-08-17 19:04:25
be0e2a0139534a719bfa9802bba2b3da4863c6cb...dee86be33ef6f38b62418a6642047f3eb5abfd90,6,399,73,472,46,2014-08-18 21:32:27,2014-08-18 21:32:27
dee86be33ef6f38b62418a6642047f3eb5abfd90...f9b59995da23c23ea9fd65be5d4735740504b632,3,87,29,116,11,2014-08-18 23:32:58,2014-08-18 23:32:58
f9b59995da23c23ea9fd65be5d4735740504b632...e10e9209423b681e08a57299cbc15e1abfd44543,7,63,12,75,17,2014-08-19 00:05:37,2014-08-19 00:05:37
e10e9209423b681e08a57299cbc15e1abfd44543...715d0474cf64fbc901b0cbab2f7baee36fa5c18b,3,60,0,60,3,2014-08-19 00:27:02,2014-08-19 00:27:02
715d0474cf64fbc901b0cbab2f7baee36fa5c18b...27c544ee0595c3bfbc7cd46f728e5280375b7cf7,1,1,1,2,1,2014-08-19 00:34:25,2014-08-19 00:34:25
27c544ee0595c3bfbc7cd46f728e5280375b7cf7...f5883827ae4670010c77e4e804bf731a2d1ad9be,4,15,15,30,14,2014-08-19 00:34:35,2014-08-19 00:34:35
f5883827ae4670010c77e4e804bf731a2d1ad9be...d0004c117e9f5bfbd66caeded16eac3cb91e78af,1,1,1,2,1,2014-08-19 00:36:04,2014-08-19 00:36:04
c9476a350fe1a5664a33a91ae60e050f752f5db1...9a1cb5d296477382153cb41f068c72f6d278c33c,2,23,1,24,4,2014-08-14 00:48:28,2014-08-14 00:48:19
9a1cb5d296477382153cb41f068c72f6d278c33c...b6955a389992f640e7dc5fb0ec5f7312cd9efe20,21,186,153,339,111,2014-08-14 01:11:46,2014-08-13 20:50:44
b6955a389992f640e7dc5fb0ec5f7312cd9efe20...9e55a23541e7c60af5b921a29b5366f07180757e,6,81,19,100,12,2014-08-14 01:11:46,2014-08-13 22:59:48
9e55a23541e7c60af5b921a29b5366f07180757e...ebab3ec9023ac2f9ddc789fe61cf5c9a99f1e423,1,17,11,28,2,2014-08-14 01:11:46,2014-08-13 23:14:46
ebab3ec9023ac2f9ddc789fe61cf5c9a99f1e423...2755f95bb636429645e75a6e2e7e04ce3dcb86c8,5,36,37,73,12,2014-08-14 01:11:46,2014-08-13 23:37:03
2755f95bb636429645e75a6e2e7e04ce3dcb86c8...f946ff905416b6cded198e8945cc2dd651e13118,10,87,38,125,29,2014-08-14 01:11:46,2014-08-14 00:26:19
f946ff905416b6cded198e8945cc2dd651e13118...7743a55bba186af54f4e66c0b5985e24dad9d1ba,3,62,78,140,17,2014-08-14 01:11:46,2014-08-14 00:39:42
7743a55bba186af54f4e66c0b5985e24dad9d1ba...925758603e9ff98fb37de0cfb6b2849647bf537d,1,26,3,29,9,2014-08-14 01:11:46,2014-08-14 00:56:44
925758603e9ff98fb37de0cfb6b2849647bf537d...c9488c74d0b0789e00fd13c0eef3b1f270de7a60,1,1,1,2,1,2014-08-14 01:11:46,2014-08-14 01:10:58
c9488c74d0b0789e00fd13c0eef3b1f270de7a60...2a598ef56c8012c472f2dec00a6cf53e8fe188c4,2,2,2,4,2,2014-08-14 01:15:47,2014-08-14 01:15:47
2a598ef56c8012c472f2dec00a6cf53e8fe188c4...e3771dd09809ac0bfe80a6804b2d44f18791858c,1,8,0,8,1,2014-08-14 01:33:32,2014-08-14 01:33:32
e9b9132a04706c4db432faeba0309191e71f9f4f...6dabb68925a7e87261b329c5ac2564806e4ff66c,1,1,1,2,1,2014-08-13 22:08:10,2014-08-13 22:08:10
6dabb68925a7e87261b329c5ac2564806e4ff66c...8a343acf6825148255e9d6988a10424778c87b0f,1,1,1,2,1,2014-08-13 22:11:59,2014-08-13 22:11:59
59e5b031f8508550076e5ec745c568359df31731...9d182cdcec33d74d930a25648801fd170e7ba610,1,22,32,54,9,2014-08-05 23:53:50,2014-08-05 23:30:37
9d182cdcec33d74d930a25648801fd170e7ba610...504b2817934bbe76a9d736d184de22d142326e10,1,13,7,20,4,2014-08-05 23:57:36,2014-08-05 23:55:03
504b2817934bbe76a9d736d184de22d142326e10...b889939200a0cce5dd74a0c8f5aa12d4c0063e64,2,19,17,36,10,2014-08-06 00:03:41,2014-08-06 00:03:36
b889939200a0cce5dd74a0c8f5aa12d4c0063e64...d88a96fe87f05e28d4b0b24fd8f86722bf108f9c,3,15,10,25,5,2014-08-06 00:32:33,2014-08-06 00:17:50
d88a96fe87f05e28d4b0b24fd8f86722bf108f9c...2aa9fe6600ff5f224c8fa7f4c3386af3ce832a7c,3,31,14,45,11,2014-08-06 00:32:33,2014-08-06 00:30:30
2aa9fe6600ff5f224c8fa7f4c3386af3ce832a7c...85d9c89eb95b0b6c1b449adfbb1af87b9156e003,1,4,1,5,1,2014-08-06 00:32:33,2014-08-06 00:31:01
85d9c89eb95b0b6c1b449adfbb1af87b9156e003...332215ae7dbba0061edbe4f6489b799673a87ca4,5,34,6,40,9,2014-08-06 00:59:38,2014-08-06 00:59:38
332215ae7dbba0061edbe4f6489b799673a87ca4...ab5347d7fa2e0cf9fec56a0d9ab44e861d7ca1bf,1,10,4,14,3,2014-08-06 01:42:56,2014-08-06 01:42:56
ab5347d7fa2e0cf9fec56a0d9ab44e861d7ca1bf...46db0ccc71963055cf55db5a50ef4847cbaed510,1,33,2,35,3,2014-08-06 01:53:28,2014-08-06 01:53:28
46db0ccc71963055cf55db5a50ef4847cbaed510...a6b44f77f8c5ef9fa3ed1c9b5564891d57d22545,1,1,1,2,1,2014-08-06 01:54:20,2014-08-06 01:54:09
a6b44f77f8c5ef9fa3ed1c9b5564891d57d22545...f8234543bd7f68991d339ccde2d8683dbe326b2f,1,2,2,4,2,2014-08-06 02:00:55,2014-08-06 02:00:55
f8234543bd7f68991d339ccde2d8683dbe326b2f...563860c7699eb3d4291833aa98d40be17fab0915,11,11,11,22,11,2014-08-06 02:03:16,2014-08-06 02:03:16
563860c7699eb3d4291833aa98d40be17fab0915...1ec20b23209a2eedc14c8548100a2c40bf3a715f,2,5,3,8,5,2014-08-06 02:22:11,2014-08-06 02:22:11
1ec20b23209a2eedc14c8548100a2c40bf3a715f...5cf1f875d211deb636af94f2f6a569027d479353,1,14,5,19,6,2014-08-06 02:39:29,2014-08-06 02:39:29
5cf1f875d211deb636af94f2f6a569027d479353...a785fc835e6f724c9c520483622c4e09838bd2fe,2,2,2,4,2,2014-08-06 02:43:37,2014-08-06 02:43:37
a785fc835e6f724c9c520483622c4e09838bd2fe...0024267750a5b5c61ad47427debd05d0cb132fb6,1,7,0,7,1,2014-08-06 02:49:53,2014-08-06 02:49:53
0024267750a5b5c61ad47427debd05d0cb132fb6...ce2fe073d2e823f4abd6202d67bc03d9585f123f,1,2,4,6,2,2014-08-06 02:51:18,2014-08-06 02:51:18
ce2fe073d2e823f4abd6202d67bc03d9585f123f...fb4fd954c52290d66b958d6d56918ae952fdbdaa,1,0,2,2,1,2014-08-06 02:52:13,2014-08-06 02:52:13
fb4fd954c52290d66b958d6d56918ae952fdbdaa...6ae4536bc1d246bcd096e6752540bd7fd45b7a74,1,15,0,15,1,2014-08-06 03:06:16,2014-08-06 03:06:16
6ae4536bc1d246bcd096e6752540bd7fd45b7a74...51fc5e62c54179802e474a1e217236649cd0fd5e,4,12,15,27,10,2014-08-06 03:10:00,2014-08-06 03:10:00
51fc5e62c54179802e474a1e217236649cd0fd5e...97ec098cb638864742574b51ea6ace02ab5b4553,2,3,3,6,2,2014-08-06 03:11:40,2014-08-06 03:11:40
97ec098cb638864742574b51ea6ace02ab5b4553...aa04916489c368c4dd6054a70980003097a60848,2,106,16,122,4,2014-08-06 03:33:43,2014-08-06 03:33:43
aa04916489c368c4dd6054a70980003097a60848...f1aed579ae3fa8fa0a90fea77e2504bd4639f70a,1,14,14,28,11,2014-08-06 03:39:34,2014-08-06 03:39:34
f1aed579ae3fa8fa0a90fea77e2504bd4639f70a...cf7b78a83b064484f7b6276c9debba41a2a42cac,1,25,0,25,3,2014-08-06 18:28:59,2014-08-06 18:28:59
cf7b78a83b064484f7b6276c9debba41a2a42cac...92323ad56989a5f37688d4ea30193ed37b6d5d1e,3,3,2,5,3,2014-08-06 18:30:37,2014-08-06 18:30:37
92323ad56989a5f37688d4ea30193ed37b6d5d1e...7c0673a7a94c084c297b3f48b6bb7625115984b6,1,1,1,2,1,2014-08-06 18:59:12,2014-08-06 18:59:12
7c0673a7a94c084c297b3f48b6bb7625115984b6...87852025fd4dfd68e46aa25a64553fe4e0ca6ed7,1,3,3,6,3,2014-08-06 20:40:52,2014-08-06 20:40:44
87852025fd4dfd68e46aa25a64553fe4e0ca6ed7...3f185485a5e07ec3d067aa3aafd51906a3bb8733,1,1,4,5,2,2014-08-06 21:06:43,2014-08-06 21:04:05
3f185485a5e07ec3d067aa3aafd51906a3bb8733...941c3b98f4a6dfb6484e8bd60f35c3550b0369cd,2,0,266,266,2,2014-08-06 21:06:43,2014-08-06 21:05:56
941c3b98f4a6dfb6484e8bd60f35c3550b0369cd...54c33aeaaedcbd72a553891f4dca931203aacf6f,2,2,2,4,2,2014-08-06 21:07:16,2014-08-06 21:07:16
54c33aeaaedcbd72a553891f4dca931203aacf6f...88fb0bbf2c10f6a0c3536b9ff6bafe92c536e02c,1,1,1,2,1,2014-08-06 21:23:27,2014-08-06 21:23:27
88fb0bbf2c10f6a0c3536b9ff6bafe92c536e02c...091d1af5eca8aa46c4472e469de5cbfabf2df4d9,1,2,3,5,2,2014-08-06 22:13:59,2014-08-06 22:13:59
091d1af5eca8aa46c4472e469de5cbfabf2df4d9...ceeba150447395b6e3a2da52acfe7e92c6daa818,1,1,1,2,1,2014-08-06 22:20:04,2014-08-06 21:44:59
ceeba150447395b6e3a2da52acfe7e92c6daa818...757e96695ae0365beb8a7776700cac54e0e1087d,1,28,28,56,10,2014-08-06 22:29:45,2014-08-06 22:29:45
757e96695ae0365beb8a7776700cac54e0e1087d...215a6a15c2edc7e0cd94cb2356c71cead8ee366d,1,0,2,2,1,2014-08-06 22:41:09,2014-08-06 22:41:09
215a6a15c2edc7e0cd94cb2356c71cead8ee366d...215872fea274fdbdc8481573c1f2df9324ca684b,2,18,0,18,2,2014-08-06 23:02:33,2014-08-06 23:02:33
215872fea274fdbdc8481573c1f2df9324ca684b...67de025b6f67d0090c5c6b39ccb74d7ae6862add,2,2,2,4,2,2014-08-06 23:03:35,2014-08-06 23:03:35
67de025b6f67d0090c5c6b39ccb74d7ae6862add...92cf32a49ac5c2ea7cfcdc949cf5bb3f9ec9c1f7,1,2,1,3,1,2014-08-06 23:05:34,2014-08-06 23:05:34
92cf32a49ac5c2ea7cfcdc949cf5bb3f9ec9c1f7...0bbebe26fe7a088ffe75090eaf8208662c42ebe6,1,2,2,4,1,2014-08-07 00:01:00,2014-08-07 00:00:53
0bbebe26fe7a088ffe75090eaf8208662c42ebe6...4d288bd39b00d629b7d9d80e7adc013b38062ca4,3,55,35,90,15,2014-08-07 00:36:12,2014-08-07 00:36:12
4d288bd39b00d629b7d9d80e7adc013b38062ca4...52230a8d793e5a3aab7c17a0e457d0bb02632457,3,19,12,31,11,2014-08-07 02:56:48,2014-08-07 02:52:11
52230a8d793e5a3aab7c17a0e457d0bb02632457...9c7fd931f8a833a57b30bce3e6472d2c01418e5d,4,20,20,40,20,2014-08-07 02:56:48,2014-08-07 02:55:58
9c7fd931f8a833a57b30bce3e6472d2c01418e5d...00b8ce07f39f892a2b372fdb87aa6424d76c4e75,1,2,1,3,2,2014-08-07 03:14:54,2014-08-07 03:14:54
00b8ce07f39f892a2b372fdb87aa6424d76c4e75...b2b689b2f88eed4e26fda0fdb974d1736de67e3b,2,11,3,14,4,2014-08-07 03:33:02,2014-08-07 03:33:02
b2b689b2f88eed4e26fda0fdb974d1736de67e3b...4b7601aa92f34c859ca703c76e37da02551995b5,1,0,4,4,2,2014-08-07 03:44:41,2014-08-07 03:44:41
4b7601aa92f34c859ca703c76e37da02551995b5...ecdc772f283846f4bf6863139d8a92d4ac0e7198,1,7,5,12,3,2014-08-07 04:23:18,2014-08-07 04:23:18
8e93519f5cd57d8c0ae6e1289ca3c88f2de132c8...87688f1a19085a2374fcb1535d071c83a21ecd3c,1,34,15,49,12,2014-07-16 01:01:39,2014-07-16 00:57:22
87688f1a19085a2374fcb1535d071c83a21ecd3c...88acf81b0816be13f0ce355dcaec1341b8bc307a,3,10,8,18,9,2014-07-16 01:22:43,2014-07-16 01:22:16
8e93519f5cd57d8c0ae6e1289ca3c88f2de132c8...69c4fd00377058d21b53a47cc632060e2fe9ee93,1,63,1,64,5,2014-07-16 00:31:48,2014-07-15 23:43:43
69c4fd00377058d21b53a47cc632060e2fe9ee93...66468bdc0aafb605d1a46191741b0ced58cbc0c1,1,0,7,7,1,2014-07-24 22:32:16,2014-07-24 22:32:16
66468bdc0aafb605d1a46191741b0ced58cbc0c1...11be2d62673bc9ec4f900e02b298024b90c9ff14,1,17,2,19,10,2014-07-25 18:26:45,2014-07-25 18:26:45
0da301c637eb21b3e5cd34c5c01bedbbccef20f9...eb04e791e6f42f29ea514b8cf04b9722246db736,2,3,1,4,2,2014-07-01 22:15:06,2014-06-27 20:36:42
eb04e791e6f42f29ea514b8cf04b9722246db736...97364d007ba27623b1f6545fc5e840c7e02867a3,1,1,1,2,1,2014-07-01 22:15:06,2014-07-01 20:06:57
97364d007ba27623b1f6545fc5e840c7e02867a3...1c9e0c47212065db76b5979732ec4f848be7cd19,1,1,1,2,1,2014-07-01 22:15:06,2014-07-01 20:18:46
0da301c637eb21b3e5cd34c5c01bedbbccef20f9...80df89cafd8a917fafa0d4f762f0ebee909a1cb3,1,2,0,2,1,2014-07-01 20:34:18,2014-07-01 20:34:18
80df89cafd8a917fafa0d4f762f0ebee909a1cb3...ddba5d4a3f31b9c99e449b4a6c55c27a0fd902a4,10,84,124,208,34,2014-07-01 21:09:44,2014-07-01 20:56:17
ddba5d4a3f31b9c99e449b4a6c55c27a0fd902a4...a92a62acc1ed6976007bec51df3f78e720b8e587,3,45,25,70,8,2014-07-01 21:57:42,2014-07-01 21:21:50
a92a62acc1ed6976007bec51df3f78e720b8e587...7bfa2dacb5b7d552859239eb68f735dc0f85f6b4,5,119,26,145,9,2014-07-01 23:18:36,2014-07-01 23:18:36
56380fe30adbf8cf5f2a51aecbe90876d17f0931...1fade7fe6245f253ce5ddc5c285dc188feca914d,1,4,0,4,1,2014-03-18 16:51:26,2014-03-18 16:51:26
1fade7fe6245f253ce5ddc5c285dc188feca914d...406d8d6b81f7b2ef723a872f2c8173e16ae383e0,1,6,0,6,2,2014-03-18 20:49:00,2014-03-18 20:49:00
8b28f1fab629b0950dfec412dd57033be78687d0...4f34ac0d6e90064a226751339b4cb253ffbbf750,1,11,15,26,7,2014-01-23 20:09:40,2014-01-22 20:35:38
4f34ac0d6e90064a226751339b4cb253ffbbf750...8354fe403b92328688a7c6cb735ca64737590a2e,1,1,1,2,1,2014-01-23 20:09:40,2014-01-23 00:12:33
8354fe403b92328688a7c6cb735ca64737590a2e...a7d10d650d856b1a1c18e9b5cddb72d42679e418,8,10,136,146,8,2014-01-23 20:15:29,2014-01-23 20:15:29
a7d10d650d856b1a1c18e9b5cddb72d42679e418...d4e0cff766ac0309df44f33ed0b90d6d7fb7a98e,1,5,1,6,1,2014-01-23 20:23:16,2014-01-23 20:23:16
d4e0cff766ac0309df44f33ed0b90d6d7fb7a98e...90b7489e7f0c2d126ba33f5a5b8da6c3a866731d,1,12,2,14,3,2014-01-23 21:40:02,2014-01-23 21:40:02
90b7489e7f0c2d126ba33f5a5b8da6c3a866731d...97ec2d39481a962f168b7e788f0ae4643c436102,1,19,47,66,5,2014-01-23 22:40:21,2014-01-23 22:40:21
10cdd65f2cc1d1067ce7bc685a8857bd0812b038...54694a6c2a6aaf6485d2a8962a638aae3532e9c3,3,110,10,120,12,2014-02-18 03:32:49,2014-02-18 03:32:49
54694a6c2a6aaf6485d2a8962a638aae3532e9c3...fde0717d5d0e8e05a0edd97a2a35268f4225a019,1,6,0,6,1,2014-02-18 03:33:35,2014-02-18 03:33:35
fde0717d5d0e8e05a0edd97a2a35268f4225a019...5eef5fcfd3c1141b81adf33c22f80f801a41537c,1,10,30,40,9,2014-02-18 03:34:02,2014-02-18 03:34:02
5eef5fcfd3c1141b81adf33c22f80f801a41537c...91832f8b1a8833cdb3f280af512e307ba2147316,1,7,13,20,6,2014-02-18 03:36:05,2014-02-18 03:36:05
91832f8b1a8833cdb3f280af512e307ba2147316...9f93b95f5389e80d6a044f751634c88409f6f358,1,1,1,2,1,2014-02-18 03:39:38,2014-02-18 03:39:38
9f93b95f5389e80d6a044f751634c88409f6f358...993fbc90cbdf3326219b061ab11c01e302699fe5,6,33,0,33,6,2014-02-18 03:46:29,2014-02-18 03:46:29
e4eb3e3c75d525d8e2d878f97b1b5c87f303dc28...3871c92181f549eeb93df36b613c3f331e309f78,1,14,5,19,3,2014-02-19 00:37:31,2014-02-19 00:37:31
3871c92181f549eeb93df36b613c3f331e309f78...6144213649c91bf176f7cfd23ca4344a7d9b5276,1,25,1,26,6,2014-02-19 00:38:03,2014-02-19 00:38:03
6144213649c91bf176f7cfd23ca4344a7d9b5276...23ec5007e98638877d6ed44a3f9f5a368aa2f349,1,16,9,25,9,2014-02-19 20:44:19,2014-02-19 20:44:19
23ec5007e98638877d6ed44a3f9f5a368aa2f349...9ccdc0b80c6ddc6526f7ce3bad09c5c67dccd6dc,1,12,9,21,9,2014-02-22 04:02:19,2014-02-22 03:47:23
9ccdc0b80c6ddc6526f7ce3bad09c5c67dccd6dc...622d61f0a7b977b6a6b09d6be6e07f4213d4ad66,1,9,9,18,8,2014-02-22 04:03:22,2014-02-22 04:03:22
622d61f0a7b977b6a6b09d6be6e07f4213d4ad66...9d4783e4fc6bb9f4dc5f60d9ecd4b2a31a62155d,1,5,2,7,3,2014-02-24 01:51:51,2014-02-24 01:51:51
9d4783e4fc6bb9f4dc5f60d9ecd4b2a31a62155d...f0d13f6678ee1fff0f25a26d6489756efd458822,1,20,9,29,3,2014-02-24 01:52:17,2014-02-24 01:52:17
f0d13f6678ee1fff0f25a26d6489756efd458822...90ba50acb74470d76b58b7aa5bd8531e0343bfd1,1,29,9,38,10,2014-02-24 02:19:57,2014-02-24 02:19:57
90ba50acb74470d76b58b7aa5bd8531e0343bfd1...7c202f6004bc697261cf58d126eb12009f62f4f5,1,5,4,9,3,2014-02-24 04:03:38,2014-02-24 04:03:38
7c202f6004bc697261cf58d126eb12009f62f4f5...90a0c2d5c2a3f9df98122bc90525f722c6043fd8,1,15,4,19,5,2014-02-24 08:25:38,2014-02-24 08:25:38
90a0c2d5c2a3f9df98122bc90525f722c6043fd8...036dc4885edcf429490609c036034d6ffdc08ac7,1,15,3,18,6,2014-02-24 08:26:11,2014-02-24 08:26:11
e4eb3e3c75d525d8e2d878f97b1b5c87f303dc28...8cad412ea199242943b943d0fc9dd72d1b9e778d,3,57,0,57,2,2014-02-18 23:27:48,2014-02-17 23:50:50
8cad412ea199242943b943d0fc9dd72d1b9e778d...7f2c6bb09b75e6e943fc5bfabd523766627529c2,1,158,18,176,7,2014-02-18 23:27:48,2014-02-18 04:47:41
7f2c6bb09b75e6e943fc5bfabd523766627529c2...678d607332622ca28fd0449e5e320b3cdd974fb1,1,12,4,16,3,2014-02-18 23:27:48,2014-02-18 05:18:03
678d607332622ca28fd0449e5e320b3cdd974fb1...70a4d6cba1a256b773cb788e9f9c537b13ff3a9f,2,31,0,31,2,2014-02-18 23:27:48,2014-02-18 05:18:29
70a4d6cba1a256b773cb788e9f9c537b13ff3a9f...3c4af7cd8f792b1ef8702c1d18f2cc62236f14b8,1,3,3,6,3,2014-02-18 23:27:48,2014-02-18 05:19:13
3c4af7cd8f792b1ef8702c1d18f2cc62236f14b8...4dfb2fee4dfbfa1c43bebd5c01a60b579827ead1,5,82,1,83,6,2014-02-18 23:27:48,2014-02-18 08:32:23
4dfb2fee4dfbfa1c43bebd5c01a60b579827ead1...d59200f9517b4f20a86cb612c1bf4210c5fd56f6,1,2,2,4,2,2014-02-18 23:27:48,2014-02-18 22:39:58
d59200f9517b4f20a86cb612c1bf4210c5fd56f6...4631f2437760af5265a092da5eebd871d74da871,2,12,14,26,11,2014-02-18 23:27:48,2014-02-18 23:26:44
4631f2437760af5265a092da5eebd871d74da871...b76fd3c3af3eaad18ad2007971852a40aa915f1c,4,20,20,40,16,2014-02-20 21:47:22,2014-02-20 21:46:39
b76fd3c3af3eaad18ad2007971852a40aa915f1c...b4e94c3b2a5095fbee9f1e22a5b8dc56ad33d780,1,21,0,21,1,2014-02-20 22:04:27,2014-02-20 22:04:27
b4e94c3b2a5095fbee9f1e22a5b8dc56ad33d780...3fa5fd9342f3e5b81c270ed10a7bfc0d854ce6d5,1,1,1,2,1,2014-02-20 22:05:12,2014-02-20 22:05:12
3fa5fd9342f3e5b81c270ed10a7bfc0d854ce6d5...8c079efcdac835aeda67175a22c9c82dc46195dc,5,92,70,162,7,2014-02-21 00:00:08,2014-02-21 00:00:08
8c079efcdac835aeda67175a22c9c82dc46195dc...939d8d7e7f8f10bfbaba3f4c5758aba526ab82dd,2,4,2,6,2,2014-02-21 00:29:01,2014-02-21 00:29:01
939d8d7e7f8f10bfbaba3f4c5758aba526ab82dd...cd918bbf17f34e29c8044d9ada4708a64def419c,2,17,22,39,13,2014-02-21 01:13:52,2014-02-21 01:13:52
cd918bbf17f34e29c8044d9ada4708a64def419c...006e307f1542b97c254fac7e0b4e8e7fa410f453,1,17,1,18,6,2014-02-21 05:38:09,2014-02-21 05:38:09
006e307f1542b97c254fac7e0b4e8e7fa410f453...19eeff650a29369fed01e8f036fb2d67467ff56a,1,1,3,4,1,2014-02-21 05:45:28,2014-02-21 05:45:28
19eeff650a29369fed01e8f036fb2d67467ff56a...d87b18a56e23cf1d9ac8fbdbdeb78db5dbe1d8bb,1,2,1,3,1,2014-02-21 06:38:56,2014-02-21 06:38:56
d87b18a56e23cf1d9ac8fbdbdeb78db5dbe1d8bb...7bad26e79613c5d912ed086d32e30bb53f3cfc59,1,1,4,5,1,2014-02-21 22:25:06,2014-02-21 22:25:06
7bad26e79613c5d912ed086d32e30bb53f3cfc59...503c5f263f07d4fa8598234bba6022ff4565ef37,1,3,0,3,1,2014-02-21 22:27:32,2014-02-21 22:27:20
503c5f263f07d4fa8598234bba6022ff4565ef37...e853ced77c5f42eeba06149b3525ddc0a54a346d,1,10,6,16,5,2014-02-21 22:35:01,2014-02-21 22:35:01
e853ced77c5f42eeba06149b3525ddc0a54a346d...74553efa304f32bed43f8b5cbbee0116640e2c36,1,6,6,12,3,2014-02-21 22:35:55,2014-02-21 22:35:55
74553efa304f32bed43f8b5cbbee0116640e2c36...b01ed021eaee519c035b707cfdfb77501e32a7bb,2,43,0,43,2,2014-02-22 01:48:22,2014-02-22 01:48:22
b01ed021eaee519c035b707cfdfb77501e32a7bb...133428e6e513ff358b41a2a8e32e1aed8448c087,1,4,2,6,4,2014-02-22 01:48:37,2014-02-22 01:48:37
133428e6e513ff358b41a2a8e32e1aed8448c087...1dc172696f10fb99f51f292b0da6ca645a7e4aed,1,2,2,4,3,2014-02-22 02:12:35,2014-02-22 02:12:35
1dc172696f10fb99f51f292b0da6ca645a7e4aed...f38294b17301be7b7c3f0da0498cf6ea62f107dd,1,9,7,16,2,2014-02-22 02:19:13,2014-02-22 02:19:13
f38294b17301be7b7c3f0da0498cf6ea62f107dd...a6410c4af750c1027756c1822c515de0bdccf8e7,1,12,0,12,1,2014-02-22 02:23:58,2014-02-22 02:23:58
a6410c4af750c1027756c1822c515de0bdccf8e7...97f7ccfa63b5418495b88155efd20be3ff77095e,1,17,10,27,12,2014-02-25 04:22:24,2014-02-25 04:22:24
97f7ccfa63b5418495b88155efd20be3ff77095e...9451416f2767314266e024638bf23db472eec444,3,17,16,33,8,2014-02-25 04:29:39,2014-02-25 04:28:45
9451416f2767314266e024638bf23db472eec444...6dfd5bfc29c3e30ff6787772c438207dc0f5c72a,1,22,1,23,4,2014-02-25 05:25:17,2014-02-25 05:25:17
6dfd5bfc29c3e30ff6787772c438207dc0f5c72a...a51bc653727b3f4fdd7e7c4bc7279999aecd6896,1,21,0,21,1,2014-02-25 07:58:25,2014-02-25 07:55:16
a51bc653727b3f4fdd7e7c4bc7279999aecd6896...7bd160192c7d7f2b81bf9c616f50f015a9e83425,2,2,4,6,2,2014-02-25 07:58:31,2014-02-25 07:55:35
dc4eb4c49613f5407f63dea9eac1415484905878...e4c02a5e3ae283c1dc5e4f111221f0c1f8c18f0e,1,11,14,25,3,2014-02-20 18:49:20,2014-02-20 18:49:20
e4c02a5e3ae283c1dc5e4f111221f0c1f8c18f0e...36b7cd776d2c27506d2ff8f2fb07f4f4821dddef,1,6,0,6,2,2014-02-20 19:04:53,2014-02-20 19:04:53
36b7cd776d2c27506d2ff8f2fb07f4f4821dddef...6ca69af94e967b76e9a4b8068403e0c682f03103,1,4,2,6,1,2014-02-20 19:32:19,2014-02-20 19:32:19
6ca69af94e967b76e9a4b8068403e0c682f03103...9aa4e5398414fc3e1d522261f6d8f67bdae6e61a,1,4,3,7,3,2014-02-20 19:47:53,2014-02-20 19:47:53
857b4e0a4c724fcb579a8c5a0c9a415c9e63c9ef...89b1a730025bf8494e851d0cf36a4c218149fcef,1,2,0,2,1,2014-02-20 07:43:18,2014-02-20 07:43:18
89b1a730025bf8494e851d0cf36a4c218149fcef...cebffa7848add77893cc433acf4ab7c243f635db,1,4,1,5,1,2014-02-20 07:43:35,2014-02-20 07:43:35
cebffa7848add77893cc433acf4ab7c243f635db...ab3577d3d54f0b840248b43c956363ece5b60d08,2,5,5,10,4,2014-02-20 07:44:04,2014-02-20 07:44:04
9fefc349e02fd7455aa91f7f6331604ec5e7aa31...db624dd162c81392a35d09c30eba64974fd1641f,2,2,2,4,2,2013-12-10 20:45:53,2013-12-10 19:37:43
db624dd162c81392a35d09c30eba64974fd1641f...1b08ac2d9d9f1c7eab8708d4d50ee7eaf64324cb,3,6,7,13,4,2013-12-10 23:27:40,2013-12-10 23:27:40
1b08ac2d9d9f1c7eab8708d4d50ee7eaf64324cb...24a80d49b16fe4cc5a3b68d3dbee61e4bf7edfbe,1,1,0,1,1,2013-12-10 23:36:46,2013-12-10 23:36:46
24a80d49b16fe4cc5a3b68d3dbee61e4bf7edfbe...f9b394de4f5092f092348da20c126e4e799e10d6,1,1,0,1,1,2013-12-11 01:47:49,2013-12-11 01:47:49
f9b394de4f5092f092348da20c126e4e799e10d6...82d5fcabf8eef684596dd34c927b65dca0615960,3,127,0,127,4,2013-12-11 03:05:02,2013-12-11 03:02:34
82d5fcabf8eef684596dd34c927b65dca0615960...b4c14af03296fadac5c947de40eb154e8e16a280,1,5,3,8,3,2013-12-11 03:09:41,2013-12-11 03:09:41
8018f38f8bb47cf0e30bd8020e1ceb1d89c338a3...ce4f2d65f681a0bcefd0e5b60482a4598f637118,7,95,103,198,20,2014-06-21 00:09:06,2014-06-18 22:07:40
ce4f2d65f681a0bcefd0e5b60482a4598f637118...f52c975de1bf748db239ed52eb4f604966a6ce1c,3,97,34,131,7,2014-06-21 01:12:40,2014-06-21 01:12:40
f52c975de1bf748db239ed52eb4f604966a6ce1c...58a4be8094561be217bca8fab0e368f021d779c7,2,10,7,17,6,2014-06-21 04:43:28,2014-06-21 04:43:28
58a4be8094561be217bca8fab0e368f021d779c7...2a93777d7310f0508df4fba1e3ceffd4252a93c6,2,64,28,92,11,2014-06-21 05:48:00,2014-06-21 05:48:00
2a93777d7310f0508df4fba1e3ceffd4252a93c6...60cff13f059bcdaa39742b8f3169fca076aaf711,1,1,1,2,1,2014-06-21 05:49:37,2014-06-21 05:49:37
60cff13f059bcdaa39742b8f3169fca076aaf711...04e9c6016f19918e3e88d70656add82df32f1425,1,1,9,10,2,2014-06-21 06:15:34,2014-06-21 06:15:34
04e9c6016f19918e3e88d70656add82df32f1425...508dd29ac54a1001024f86418c54f8e08a5dd289,1,47,22,69,5,2014-06-23 19:31:59,2014-06-23 19:31:59
508dd29ac54a1001024f86418c54f8e08a5dd289...946008da392ce112a51b57298caa8c88b27c7f5c,1,28,7,35,4,2014-06-23 20:54:28,2014-06-23 20:54:28
8018f38f8bb47cf0e30bd8020e1ceb1d89c338a3...fe8ca792eead2b485f0cd2700ff14354e0c62f08,4,87,93,180,16,2014-06-20 22:13:35,2014-06-18 22:07:40
fe8ca792eead2b485f0cd2700ff14354e0c62f08...be15b56e9e52dd79e69153c82c6dbb5912802901,1,1,1,2,1,2014-06-20 22:43:10,2014-06-20 22:35:43
be15b56e9e52dd79e69153c82c6dbb5912802901...0622d99ddf6f0360ee24f9367563f78c56e29642,1,1,1,2,1,2014-06-20 22:43:11,2014-06-20 22:42:45
0622d99ddf6f0360ee24f9367563f78c56e29642...ef20180d8a741eb1b1c18a2f94df5529704e03da,2,2,2,4,2,2014-06-20 22:43:11,2014-06-18 22:37:35
42b0cad48f28348fa980753321d1fc2292c83282...137129b35804ff7011fa271b374436282a24ab53,4,139,25,164,9,2014-06-20 23:22:38,2014-06-19 21:45:49
137129b35804ff7011fa271b374436282a24ab53...84774800b8a4ec8fe9a0f9a9ac571e83d23eb039,1,2,0,2,1,2014-06-20 23:22:38,2014-06-19 21:47:49
84774800b8a4ec8fe9a0f9a9ac571e83d23eb039...924f51a0ed02ad1ed46d170fc9b3d46ffad24fa2,2,76,53,129,5,2014-06-20 23:22:38,2014-06-19 22:10:40
924f51a0ed02ad1ed46d170fc9b3d46ffad24fa2...76cfdd44a62fe852b29faef670794a42d4d718c4,1,1,14,15,2,2014-06-20 23:22:38,2014-06-20 23:11:18
76cfdd44a62fe852b29faef670794a42d4d718c4...ea231729de3f2b3a0b73cf845dc9c5673c05acd3,2,53,76,129,5,2014-06-20 23:22:38,2014-06-20 23:11:59
ea231729de3f2b3a0b73cf845dc9c5673c05acd3...367516a966d8e154be1c558d0596cfddffc6d2c8,1,1,0,1,1,2014-06-20 23:22:38,2014-06-20 23:16:37
367516a966d8e154be1c558d0596cfddffc6d2c8...abd92999a4470efc4ee0abfafa6b251e1863517e,1,1,1,2,1,2014-06-20 23:44:12,2014-06-20 23:44:12
fe20554f862b1388e36c2bcc59f4847aa5376b74...75a1fce5483dfab12fccc61f64ea786f2d868bd0,1,8,0,8,1,2014-09-18 03:48:59,2014-09-18 03:48:39
19b8c0012cde746c4162344bd2f393e846fb6ac8...27be0694758a2ce88c84f59b99bc86d88ecde879,3,146,2,148,7,2014-09-16 06:02:08,2014-09-16 06:02:00
27be0694758a2ce88c84f59b99bc86d88ecde879...f96aadc3e17ca8fc53dcb5f98cb65e645a6b6a21,1,1,8,9,1,2014-09-16 06:04:40,2014-09-16 06:04:40
f96aadc3e17ca8fc53dcb5f98cb65e645a6b6a21...c9697bd6d8d0b9d4cced57b8f410c9daa98c10df,2,74,1,75,3,2014-09-16 06:43:56,2014-09-16 06:43:56
bceb814328f42fc776640fb9e9c99e133baa1f3c...99897764f7149905a18ca411189f4a98a825e3f0,1,1,1,2,1,2014-09-08 22:29:25,2014-09-07 04:35:26
99897764f7149905a18ca411189f4a98a825e3f0...65ae5935846139a11efed6d1829c6cc998ce6a59,1,1,1,2,1,2014-09-08 22:53:44,2014-09-08 14:52:39
65ae5935846139a11efed6d1829c6cc998ce6a59...d6957bad00fc2e7ea90b2b2d3477aa7a737cecd7,2,2,2,4,2,2014-09-09 01:45:30,2014-09-09 01:45:30
d6957bad00fc2e7ea90b2b2d3477aa7a737cecd7...1c432f7d0355c20820bf8c536054d650324e3aed,1,44,29,73,6,2014-09-09 02:05:16,2014-09-09 02:02:03
1c432f7d0355c20820bf8c536054d650324e3aed...7282c0ee5b4727027a13bce811273947ef7fe7a0,1,1,1,2,1,2014-09-09 04:28:41,2014-09-09 04:27:07
74cf848f2da91bb3a2d1cce410acaf987ea00c3b...9f62ff547ff188f0fd9ed5c826b2b9b39943230c,2,2,2,4,2,2014-09-08 17:02:41,2014-09-08 17:02:41
9f62ff547ff188f0fd9ed5c826b2b9b39943230c...211157df3b91973258f78628d84c29a45a0b9765,1,16,14,30,5,2014-09-08 17:07:45,2014-09-08 17:07:45
211157df3b91973258f78628d84c29a45a0b9765...8ee024d10ba3897937cdc25441206b44f5fb2769,9,47,25,72,25,2014-09-09 18:38:41,2014-09-09 18:38:41
4ca704f93f22300499b09e0d83e457a1a85e54e6...4c4317badf264889f7c1b1a84e95f15b8c399454,1,1,1,2,1,2014-09-09 14:14:58,2014-09-09 14:14:58
4c4317badf264889f7c1b1a84e95f15b8c399454...05b84fcc5e7ca8dc0004963d37fc5caf4414eda0,2,8,2,10,4,2014-09-09 14:26:20,2014-09-09 14:26:20
4ca704f93f22300499b09e0d83e457a1a85e54e6...efdb867ff4d5ee74fa1fefb89daf35b298ff96cc,1,84,0,84,5,2014-09-08 18:32:03,2014-09-08 18:32:03
efdb867ff4d5ee74fa1fefb89daf35b298ff96cc...1e1a8f724bca4467b76d3557885bc932d68dcae4,4,35,12,47,12,2014-09-08 22:58:26,2014-09-08 22:58:26
c6a9c4abb0d9a565bd3934c392eeeb4f009f58fc...080f6627e9bb90254848fad0214b4b48d2d2006d,1,1,1,2,1,2014-09-05 21:51:47,2014-09-05 21:51:47
c6a9c4abb0d9a565bd3934c392eeeb4f009f58fc...b46e66e3ea9702e254951efb3c06ea8e5787201a,11,92,35,127,22,2014-09-05 18:48:21,2014-09-05 18:35:53
ab0e177561553f396d25c784fe98b6f1fc467470...2b680d087cd2bb6cb8a70fadd850b044e9fe0d34,2,18,1,19,3,2014-08-28 17:12:09,2014-08-28 17:12:09
ab0e177561553f396d25c784fe98b6f1fc467470...aef29845c5538763a53d3ee17546a9fb9173f234,1,1,0,1,1,2014-08-28 05:08:29,2014-08-28 05:07:19
81e216c599fd588d1b3d14734e69e1aedde3164a...2fd00e58ba651c58b5705ce462c6e018e5249119,46,664,230,894,100,2014-08-29 00:25:13,2014-08-06 20:36:02
2fd00e58ba651c58b5705ce462c6e018e5249119...ef25e736d55a322f27a37c557540ea0930cd83f2,7,135,69,204,15,2014-08-29 00:25:13,2014-08-29 00:24:58
ef25e736d55a322f27a37c557540ea0930cd83f2...9ba7a6f117acfd7b18dec2b2cb0cc538fd97c487,5,132,82,214,33,2014-08-29 04:37:52,2014-08-29 04:37:52
9ba7a6f117acfd7b18dec2b2cb0cc538fd97c487...2de255f99264444a5cacfd7be23fe1bc73aa7b3f,1,3,2,5,3,2014-08-29 18:41:02,2014-08-29 18:41:02
81e216c599fd588d1b3d14734e69e1aedde3164a...5de5ba462bdbfaa73c437e0a4fee5cc6c5dc0cf6,1,15,9,24,9,2014-08-29 00:10:03,2014-08-29 00:10:03
5de5ba462bdbfaa73c437e0a4fee5cc6c5dc0cf6...02164d5cc8cd2a7c4058cec258d7af295b88b284,3,39,9,48,5,2014-08-29 00:10:24,2014-08-29 00:10:24
02164d5cc8cd2a7c4058cec258d7af295b88b284...a65f825d4f1b4d8cf20ec3867c9389dbd3d2d4af,2,3,3,6,3,2014-08-29 00:42:14,2014-08-29 00:42:14
a65f825d4f1b4d8cf20ec3867c9389dbd3d2d4af...02755faf0df28829e37a1acd5100dfa614009a0c,1,6,1,7,1,2014-08-29 00:49:42,2014-08-29 00:49:42
02755faf0df28829e37a1acd5100dfa614009a0c...76f0836e3752f6270fb9be84dacabe502375edc2,1,7,2,9,1,2014-08-29 01:07:34,2014-08-29 01:07:34
237cc6b84dd71e3f0369ef685ad424512af1360d...bfdee38b0781e93fe767ad23efc3cca23eb1fdbe,1,13,4,17,6,2014-08-27 22:44:23,2014-08-27 22:44:23
bfdee38b0781e93fe767ad23efc3cca23eb1fdbe...56cb304895a6d22e19167893c2f5e26e3fa6791e,5,11,9,20,9,2014-08-27 23:01:38,2014-08-27 23:01:38
56cb304895a6d22e19167893c2f5e26e3fa6791e...4e1111f6fa18b4ddcfe8335cdd4a5cc948a3533e,2,14,14,28,5,2014-08-27 23:03:37,2014-08-27 23:02:02
4e1111f6fa18b4ddcfe8335cdd4a5cc948a3533e...a0fe0c8ad6c69d639f3fd3c7d44d26d06e41a0c1,3,7,5,12,3,2014-08-28 03:28:05,2014-08-28 03:28:05
a0fe0c8ad6c69d639f3fd3c7d44d26d06e41a0c1...d2eaa25d924dbe50e41a8b46352b2e615cfd29ca,3,18,19,37,6,2014-08-28 04:01:51,2014-08-28 04:01:51
078ca9a0eb3821f61b525a52e677cef95247507a...e533ca9aad230a71d466448e5262c3929529e4bd,3,19,15,34,5,2014-08-12 04:26:24,2014-08-12 04:26:24
078ca9a0eb3821f61b525a52e677cef95247507a...4cbf255a53e83b781d22280b3ce465c36c8fc557,2,10,0,10,2,2014-08-12 04:08:32,2014-08-12 04:08:32
4cbf255a53e83b781d22280b3ce465c36c8fc557...64472ce8951d6a9e1b0df382190a5f6e7986adff,2,13,10,23,3,2014-08-12 04:24:12,2014-08-12 04:24:12
cc0c833610a473676f12ddf8e21c940d51ce9ccd...bbb5fac38c8d26f97b4978a9c64360af69964a1f,2,48,0,48,2,2014-08-24 16:07:13,2014-08-24 16:07:13
bbb5fac38c8d26f97b4978a9c64360af69964a1f...60c894f2a6e90481240ca8e3210a2366ce0e0f46,1,2,2,4,2,2014-08-24 16:09:42,2014-08-24 16:09:42
60c894f2a6e90481240ca8e3210a2366ce0e0f46...6945e82d4a139d58023f0e36cf811c0ca233bfc5,1,1,1,2,1,2014-08-26 19:33:03,2014-08-26 19:33:03
e3771dd09809ac0bfe80a6804b2d44f18791858c...9c1afcf0b9a60e3f6bd9b40d2577cc638db60bd7,2,10,3,13,3,2014-08-14 18:34:27,2014-08-14 18:34:27
e3771dd09809ac0bfe80a6804b2d44f18791858c...56ff54b0859f2655a05937264be114bb53f146fb,7,9,7,16,8,2014-08-14 17:15:47,2014-08-14 17:15:47
66e8f13ea969cbd40cfee21c6e1b24bf08012c02...0a5e481bf7e59f14c9e26c7699e67d45db12df62,2,43,41,84,8,2014-08-14 02:01:12,2014-08-14 02:01:12
0a5e481bf7e59f14c9e26c7699e67d45db12df62...46ca86c70169b36e87682fbef257a3c5d61f830c,4,18,29,47,8,2014-08-14 20:01:13,2014-08-14 20:01:13
46ca86c70169b36e87682fbef257a3c5d61f830c...bc8c366a781ebd918642ef9e6136eeeb786d750e,1,3,4,7,2,2014-08-14 21:31:18,2014-08-14 21:31:18
bc8c366a781ebd918642ef9e6136eeeb786d750e...348d765f65a4a806522ba68234aa1e526af76d53,3,35,24,59,9,2014-08-15 00:00:12,2014-08-15 00:00:12
348d765f65a4a806522ba68234aa1e526af76d53...5fbe4aea66a23bd2af6e70ef379852a61c8b6250,4,66,27,93,16,2014-08-15 03:32:41,2014-08-15 03:32:41
5fbe4aea66a23bd2af6e70ef379852a61c8b6250...09cd163a2b3cb0b97265241bfa0fac8a46c6bab0,4,32,44,76,13,2014-08-15 04:01:31,2014-08-15 04:01:31
09cd163a2b3cb0b97265241bfa0fac8a46c6bab0...43e699464dcd140e7b700695313ea7930aa164a5,1,28,15,43,7,2014-08-15 04:25:25,2014-08-15 04:25:25
43e699464dcd140e7b700695313ea7930aa164a5...9f55598050f4bf7e629fd5894a495b1d87e45db2,1,8,5,13,1,2014-08-15 04:30:00,2014-08-15 04:30:00
9f55598050f4bf7e629fd5894a495b1d87e45db2...eec07f72bb143d41ba1d40e03abe19d3a8e03365,2,6,9,15,2,2014-08-15 04:33:26,2014-08-15 04:33:26
eec07f72bb143d41ba1d40e03abe19d3a8e03365...e51302801807dfb348271e86175837fa4a90a27f,1,2,0,2,1,2014-08-15 04:39:14,2014-08-15 04:39:14
e51302801807dfb348271e86175837fa4a90a27f...6bf696c9bd4f624158319cb8235bc52d424c4865,1,4,1,5,2,2014-08-15 07:36:07,2014-08-15 07:36:07
6bf696c9bd4f624158319cb8235bc52d424c4865...0c96583889ed7c967774926804e9a3e5ef7dd934,1,2,1,3,2,2014-08-15 18:42:25,2014-08-15 18:42:16
0c96583889ed7c967774926804e9a3e5ef7dd934...606f0c6d86241efaaf3ecae1c196adb68eb97376,1,1,2,3,2,2014-08-15 18:43:24,2014-08-15 18:43:24
606f0c6d86241efaaf3ecae1c196adb68eb97376...bee8d6b8c0c9fb243b527d1d12edca6be301b5bb,1,4,2,6,1,2014-08-15 20:32:58,2014-08-15 20:32:58
bee8d6b8c0c9fb243b527d1d12edca6be301b5bb...b876ac153253b2613bf3490ce97dd1889106880f,2,17,5,22,5,2014-08-15 20:52:43,2014-08-15 20:52:43
b876ac153253b2613bf3490ce97dd1889106880f...b4abcf1a95ee61e0fc12fe9e08f09d0c16c921c0,7,35,0,35,7,2014-08-15 21:35:58,2014-08-15 21:35:58
b4abcf1a95ee61e0fc12fe9e08f09d0c16c921c0...e3ae279a6040287f8e4e11a614bd97d165eeec69,2,38,5,43,6,2014-08-15 21:46:45,2014-08-15 21:43:31
e3ae279a6040287f8e4e11a614bd97d165eeec69...963a16f5f1502036544909bf5d9dbbe2c63b790d,1,0,14,14,1,2014-08-15 21:48:25,2014-08-15 21:48:21
963a16f5f1502036544909bf5d9dbbe2c63b790d...c2775554409ede98b5d59dbb8fa9f3fd264efbad,2,3,6,9,3,2014-08-15 22:57:53,2014-08-15 22:57:53
c2775554409ede98b5d59dbb8fa9f3fd264efbad...c463a6247783092961c0f180df9da02e554fa335,1,2,1,3,1,2014-08-15 23:06:07,2014-08-15 23:06:07
c463a6247783092961c0f180df9da02e554fa335...c826e96b28e0c3d101a822df8e7660d80b482dd7,1,6,6,12,1,2014-08-15 23:06:20,2014-08-15 23:06:20
c826e96b28e0c3d101a822df8e7660d80b482dd7...26982d13fcb4deac3f4684bc4f6626935d338b8b,2,2,4,6,4,2014-08-15 23:31:13,2014-08-15 23:30:56
26982d13fcb4deac3f4684bc4f6626935d338b8b...2f6b98734230f6686cec5257ae6ad089fcaae613,1,16,23,39,4,2014-08-15 23:43:04,2014-08-15 23:32:59
2f6b98734230f6686cec5257ae6ad089fcaae613...fcdeda957dabc72f816cbd1e91403c3b8bda1d34,1,14,0,14,1,2014-08-15 23:43:04,2014-08-15 23:42:25
fcdeda957dabc72f816cbd1e91403c3b8bda1d34...5a12a741cc86fa9076a821112b607c33470da9f8,1,3,3,6,3,2014-08-15 23:43:04,2014-08-15 23:42:47
5a12a741cc86fa9076a821112b607c33470da9f8...8b473497c227cce1b261a69ef7321680e95e4c3a,1,23,19,42,6,2014-08-16 00:37:14,2014-08-16 00:37:14
8b473497c227cce1b261a69ef7321680e95e4c3a...88edda5557675897b94d546882b126953515992b,7,70,41,111,13,2014-08-16 00:38:16,2014-08-16 00:38:16
88edda5557675897b94d546882b126953515992b...d3ab04a305834d8fc0613bf50fd3d96eb4dac1a6,1,4,2,6,1,2014-08-16 00:38:37,2014-08-16 00:38:37
d3ab04a305834d8fc0613bf50fd3d96eb4dac1a6...caf9bc5a4383d36382c66e8f972b22e1b7bf7503,7,827,25,852,8,2014-08-16 22:57:34,2014-08-16 22:57:34
caf9bc5a4383d36382c66e8f972b22e1b7bf7503...416657736c2329dbd990b1067d7ee264d4f29942,1,1,1,2,1,2014-08-16 22:59:40,2014-08-16 22:59:40
416657736c2329dbd990b1067d7ee264d4f29942...64aa3dd5f395a09fcf3ffc18b2c225b88fb27d73,4,14,3,17,5,2014-08-16 23:08:30,2014-08-16 23:08:30
64aa3dd5f395a09fcf3ffc18b2c225b88fb27d73...18b1184fe9d6ccd236d880340c2d14edccc23db7,2,93,30,123,10,2014-08-17 00:36:41,2014-08-17 00:36:41
18b1184fe9d6ccd236d880340c2d14edccc23db7...9e390b54dba90370ee75530c760d3123cac05db2,4,23,2,25,4,2014-08-17 07:35:32,2014-08-17 07:35:32
9e390b54dba90370ee75530c760d3123cac05db2...6b2faeaf156466f832c7efe76cc12f5687aeab42,2,3,2,5,3,2014-08-17 07:41:56,2014-08-17 07:41:56
6b2faeaf156466f832c7efe76cc12f5687aeab42...bce62a3dc2bc8bcb3dbda0412fd045f9977eba8a,1,20,8,28,1,2014-08-17 08:56:16,2014-08-17 08:56:16
bce62a3dc2bc8bcb3dbda0412fd045f9977eba8a...c6047a9cdf03a4ad39fa5dc71f66cfc0f73c214b,5,50,26,76,14,2014-08-18 21:07:40,2014-08-18 21:07:40
c6047a9cdf03a4ad39fa5dc71f66cfc0f73c214b...48d3a01e2d45c983bf27cb933d33f6c394ba7464,1,2,2,4,1,2014-08-18 22:14:39,2014-08-18 22:14:39
48d3a01e2d45c983bf27cb933d33f6c394ba7464...7860026066e2964259426af2d541d9cf31c50de4,1,15,4,19,3,2014-08-18 22:21:36,2014-08-18 22:21:36
7860026066e2964259426af2d541d9cf31c50de4...3a675a7af3421e44e87f10683d3d45a7f99197c2,4,40,14,54,9,2014-08-18 22:27:24,2014-08-18 22:26:36
3a675a7af3421e44e87f10683d3d45a7f99197c2...22637331b00e10c6a0749e155ef613c91c08ad50,2,12,10,22,5,2014-08-18 22:38:26,2014-08-18 22:38:26
22637331b00e10c6a0749e155ef613c91c08ad50...0498fe90b0af5207bd9e1a297101bde7a5f3908e,1,10,0,10,1,2014-08-18 23:01:59,2014-08-18 23:01:13
0498fe90b0af5207bd9e1a297101bde7a5f3908e...ff1a6c05b6f4e345243fba9d236958ae6106292c,1,9,4,13,2,2014-08-18 23:04:10,2014-08-18 23:04:10
8a343acf6825148255e9d6988a10424778c87b0f...1b118dc804034ca16b5a83d57238e4e49e21ccd7,1,4,0,4,1,2014-08-13 22:54:50,2014-08-13 22:54:50
8a343acf6825148255e9d6988a10424778c87b0f...fdad2c4995094495bf26fe5e662b54d1e0b2a035,1,1,1,2,1,2014-08-13 22:24:41,2014-08-13 22:24:41
fdad2c4995094495bf26fe5e662b54d1e0b2a035...9a92b198a8023c7f4dfe2dd1d1dfb881efb6d2a8,1,2,2,4,2,2014-08-13 22:27:36,2014-08-13 22:26:54
9a92b198a8023c7f4dfe2dd1d1dfb881efb6d2a8...10c3426cb9eabf66ec70293a57b03e12f185805c,2,5,0,5,3,2014-08-13 22:44:01,2014-08-13 22:44:01
10c3426cb9eabf66ec70293a57b03e12f185805c...4349eb089bfbf822631bc337a5d74a8201fc8d73,1,1,0,1,1,2014-08-13 22:56:50,2014-08-13 22:56:50
9f2ee36e60cabbdee0d53aefc272760ccbec9f00...3c7ed69f6be029f003b025f7478c75f4c4ed9032,3,9,6,15,6,2014-08-06 20:51:31,2014-08-06 20:51:31
3c7ed69f6be029f003b025f7478c75f4c4ed9032...2feef6ec9ff6bc2fbe6526b4a617bfd4c8cd067b,1,1,1,2,1,2014-08-06 21:56:36,2014-08-06 21:56:36
2feef6ec9ff6bc2fbe6526b4a617bfd4c8cd067b...b8179787f09e80ef35ca372810561ea7b5270e71,1,16,2,18,2,2014-08-06 21:58:49,2014-08-06 21:58:49
b8179787f09e80ef35ca372810561ea7b5270e71...dbe4abd3a43021e14a87b9dbfdcfcfcf8cc91f1d,1,4,6,10,4,2014-08-06 22:36:59,2014-08-06 22:36:59
dbe4abd3a43021e14a87b9dbfdcfcfcf8cc91f1d...a0c0c75e621a947b122c2d9a05aae54719143293,1,12,5,17,3,2014-08-06 22:54:11,2014-08-06 22:54:11
a0c0c75e621a947b122c2d9a05aae54719143293...59782157db250c3d6531305523d8df003c56a917,1,71,0,71,1,2014-08-06 23:00:15,2014-08-06 23:00:06
59782157db250c3d6531305523d8df003c56a917...f1f21fcb61832d7fd961c2217bc3ca988272ecac,2,8,2,10,2,2014-08-07 00:18:14,2014-08-06 23:04:14
f1f21fcb61832d7fd961c2217bc3ca988272ecac...bfd1c25fb4b9b241cd3bb68d860495350915d242,4,58,7,65,10,2014-08-07 00:50:25,2014-08-07 00:50:25
bfd1c25fb4b9b241cd3bb68d860495350915d242...e261cfe600bd2273a6bad4c35b634ec4e7c8d964,1,1,1,2,1,2014-08-07 01:00:40,2014-08-07 01:00:40
e261cfe600bd2273a6bad4c35b634ec4e7c8d964...ff178480071c976aa55633bf6d9d403baa5b8880,1,9,1,10,1,2014-08-07 20:13:40,2014-08-07 20:13:40
ff178480071c976aa55633bf6d9d403baa5b8880...d569896436e085ea14ef900247e429c62b437f34,1,11,0,11,1,2014-08-07 20:58:45,2014-08-07 20:58:45
d569896436e085ea14ef900247e429c62b437f34...901c5b8ec756245e2402e316bb7a01983119ffed,1,3,0,3,1,2014-08-07 21:00:04,2014-08-07 21:00:04
901c5b8ec756245e2402e316bb7a01983119ffed...98cf0ae6e930bb0459a272af3fa008cbdf48ff1e,4,154,119,273,26,2014-08-07 21:30:24,2014-08-07 20:10:50
98cf0ae6e930bb0459a272af3fa008cbdf48ff1e...9b82aff6bac606c50af2ab752b57c71f1c5fddca,4,100,62,162,22,2014-08-07 21:30:24,2014-08-07 21:30:12
9b82aff6bac606c50af2ab752b57c71f1c5fddca...ade8382504e9705e878b4ad701ed3e0698f2e7cf,1,0,84,84,1,2014-08-07 21:35:04,2014-08-07 21:35:04
ade8382504e9705e878b4ad701ed3e0698f2e7cf...10f7bdbf3d5356cfca8db49df1feab4ca168d8cb,1,3,1,4,1,2014-08-07 22:58:14,2014-08-07 22:58:14
10f7bdbf3d5356cfca8db49df1feab4ca168d8cb...525471aa3d01e4800206398d084039d244184ae8,1,1,4,5,2,2014-08-07 23:39:54,2014-08-06 21:04:05
525471aa3d01e4800206398d084039d244184ae8...5d1970dd9d733a510c78d2d70ae8a25d23ed9940,4,110,80,190,16,2014-08-07 23:52:32,2014-08-07 23:52:32
5d1970dd9d733a510c78d2d70ae8a25d23ed9940...ac9aebe0776d90674273134ec3274851c366a4ca,1,9,1,10,1,2014-08-08 00:06:37,2014-08-08 00:06:37
ac9aebe0776d90674273134ec3274851c366a4ca...803ae5bec44e742a0ecc960bd592cd94c0630c18,7,118,40,158,28,2014-08-08 00:10:10,2014-08-07 23:54:13
803ae5bec44e742a0ecc960bd592cd94c0630c18...4ed38d240375588008d329234bee6adcddd67c69,5,19,16,35,15,2014-08-08 00:10:10,2014-08-08 00:09:58
4ed38d240375588008d329234bee6adcddd67c69...6a0ffb8991d4879ec6e749e8ea6be699ce1bba0b,2,29,9,38,9,2014-08-08 00:50:12,2014-08-08 00:50:12
6a0ffb8991d4879ec6e749e8ea6be699ce1bba0b...702e9d717d84825641bd7bbdb19e2e4f0578e024,1,6,2,8,3,2014-08-08 01:00:18,2014-08-08 01:00:18
702e9d717d84825641bd7bbdb19e2e4f0578e024...091cddaf0024ff040c96d580f5110c1ddfdcc0de,2,44,32,76,19,2014-08-08 18:37:33,2014-08-08 18:37:33
091cddaf0024ff040c96d580f5110c1ddfdcc0de...cb492c449e76bf28281640e0d281bdb51adc4906,2,10,9,19,5,2014-08-08 18:40:15,2014-08-08 18:40:15
cb492c449e76bf28281640e0d281bdb51adc4906...8013702b071349d577e53b79817e85a0d80d0d06,2,60,55,115,11,2014-08-08 19:00:39,2014-08-08 19:00:39
8013702b071349d577e53b79817e85a0d80d0d06...e18418bb79f29e03bf560c861b818ae7f969be01,2,5,0,5,3,2014-08-08 20:46:54,2014-08-08 20:46:54
e18418bb79f29e03bf560c861b818ae7f969be01...85a1233a873f63ad2abe6c8c595dde4b58e72ec1,5,56,27,83,24,2014-08-08 22:03:52,2014-08-08 22:03:52
85a1233a873f63ad2abe6c8c595dde4b58e72ec1...207378bc837adeef68b563ce57a2d603451935b0,3,35,16,51,15,2014-08-09 00:04:28,2014-08-09 00:04:28
207378bc837adeef68b563ce57a2d603451935b0...d815e35bf2bec1a8f634e714ae6f69f946d4f62f,3,27,7,34,9,2014-08-09 00:20:54,2014-08-09 00:20:54
d815e35bf2bec1a8f634e714ae6f69f946d4f62f...dc66bf7c7ecfa780e035af943aaddec5ad4deb7a,2,7,20,27,7,2014-08-09 00:35:34,2014-08-09 00:35:34
dc66bf7c7ecfa780e035af943aaddec5ad4deb7a...c475c78e210046c2780788e1a5e05a19d4132f7c,1,5,3,8,2,2014-08-09 00:58:57,2014-08-09 00:58:57
c475c78e210046c2780788e1a5e05a19d4132f7c...bdcf0d1889a22e0d416d9e942de5203f53a3c885,1,2,2,4,2,2014-08-09 01:03:43,2014-08-09 01:03:43
88acf81b0816be13f0ce355dcaec1341b8bc307a...90dd0fb05a09ec36cf6b430b6f88d7ff746e8288,4,326,217,543,31,2014-07-16 22:48:20,2014-07-16 19:18:29
88acf81b0816be13f0ce355dcaec1341b8bc307a...31fc5b0887df79eb363d32cec827dfdf263f386c,1,8,0,8,2,2014-07-16 21:04:12,2014-07-16 21:04:07
31fc5b0887df79eb363d32cec827dfdf263f386c...2e191e0b09736111b8530643063d9aa1561dee80,2,56,0,56,2,2014-07-16 22:06:20,2014-07-16 22:06:13
2e191e0b09736111b8530643063d9aa1561dee80...61667d6d9409223eb73b77933221c2b1051c32a0,1,41,62,103,6,2014-07-16 23:07:18,2014-07-16 20:49:16
61667d6d9409223eb73b77933221c2b1051c32a0...c05ae240af3870de0b743289d174ebcba3ed82ed,2,72,18,90,3,2014-07-16 23:07:18,2014-07-16 20:47:18
c05ae240af3870de0b743289d174ebcba3ed82ed...c8d7821deb271a2c7747151ddf59701a4b11a90d,1,0,4,4,1,2014-07-16 23:28:54,2014-07-16 23:28:02
bfe791ab2721df3f76e6968f84a508a08cb0cf6c...9a34a7c3ab6d5c49e24a38d854a33715be7882a3,2,3,1,4,2,2014-07-01 23:26:48,2014-07-01 23:26:48
9a34a7c3ab6d5c49e24a38d854a33715be7882a3...ff3c9746f0ee204f18ba3c29e4b3defd0aa6bd00,9,343,18,361,25,2014-07-02 01:12:07,2014-07-02 01:12:07
7645cb399e2981eccc54d43fe2456926d45a0e6f...8eca012c32802abb7f877809c7ae83ad6e0eca41,3,10,14,24,4,2014-01-24 05:28:21,2014-01-24 05:28:21
8eca012c32802abb7f877809c7ae83ad6e0eca41...d868325b8339c64b56b236f903f7a4f5d4c7a24b,1,64,57,121,2,2014-01-24 05:53:51,2014-01-24 05:45:57
d868325b8339c64b56b236f903f7a4f5d4c7a24b...fca2966676e45e126d36534c9541c58527fa3efc,6,22,51,73,17,2014-01-24 07:13:42,2014-01-24 07:13:42
fca2966676e45e126d36534c9541c58527fa3efc...d30bb79498c2167f4b2b69590fe6dee51dc594da,2,38,6,44,5,2014-01-24 07:23:30,2014-01-24 07:23:30
52f24fb225519091d24d8e5a1131c436ddc56d0b...fb9592a93dc8aaaf181038d1f34ebc1f1daf2f53,2,8,3,11,5,2014-02-18 04:01:53,2014-02-18 04:01:27
aab7e3e79404c2de50523f7b94be5b19d18f1594...b8c8d87d5fec8a681ea8e73026551f242dbf0349,1,2,6,8,2,2014-02-25 08:28:23,2014-02-21 00:37:35
b8c8d87d5fec8a681ea8e73026551f242dbf0349...db28492e6bd99aa138e0c7d4a1ce15fe4661f13b,1,1,1,2,1,2014-02-25 08:45:22,2014-02-25 08:45:22
db28492e6bd99aa138e0c7d4a1ce15fe4661f13b...4657f8c1df75b388003a2aef42754d7a57acb17c,3,7,48,55,6,2014-02-25 08:51:00,2014-02-25 08:51:00
4657f8c1df75b388003a2aef42754d7a57acb17c...be7038e1e8a22c77f22943acd1a571af4af28c5f,1,13,5,18,11,2014-02-25 09:11:35,2014-02-25 09:11:35
be7038e1e8a22c77f22943acd1a571af4af28c5f...b082f1847a77e2a58aa1bbed1e7e9dc765674476,1,1,0,1,1,2014-02-25 18:00:27,2014-02-25 18:00:27
b082f1847a77e2a58aa1bbed1e7e9dc765674476...3355ba7e85db7f504bafb310e760c66a43e66c22,1,4,1,5,2,2014-02-25 19:25:19,2014-02-24 20:08:41
3355ba7e85db7f504bafb310e760c66a43e66c22...6ad69c52ae6cfc032e8a4032dc872b2ca8162c15,1,1,0,1,1,2014-02-25 19:25:19,2014-02-24 20:10:15
6ad69c52ae6cfc032e8a4032dc872b2ca8162c15...76ffc74e0efb96971499ed8c05a88e250b757478,1,1,0,1,1,2014-02-25 19:26:38,2014-02-25 19:26:38
76ffc74e0efb96971499ed8c05a88e250b757478...370ee125a9252d747a7edd975c7c32f6de12ab87,1,4,3,7,2,2014-02-25 19:37:01,2014-02-25 19:37:01
370ee125a9252d747a7edd975c7c32f6de12ab87...b23a26fbbd1e5449e422661a11e5dfcf23f0b88c,1,15,0,15,10,2014-02-25 19:49:54,2014-02-25 19:49:54
b23a26fbbd1e5449e422661a11e5dfcf23f0b88c...4b955b5afc6407c3e05ab67eff3756f03e1c55dc,1,6,12,18,6,2014-02-26 06:45:29,2014-02-26 06:45:29
4b955b5afc6407c3e05ab67eff3756f03e1c55dc...afc58bcac6f43f3d1631c682e2eb21e308e759ab,1,1,1,2,1,2014-02-26 07:15:02,2014-02-26 07:15:02
afc58bcac6f43f3d1631c682e2eb21e308e759ab...a0cc339b6d5171345493379aefd5d547848d5c8b,1,5,4,9,3,2014-02-26 07:19:20,2014-02-26 07:19:20
a0cc339b6d5171345493379aefd5d547848d5c8b...2f4dac064e7895787a4f7cc0d6c9896cb8289a45,1,3,5,8,5,2014-02-26 07:22:59,2014-02-26 07:22:59
2f4dac064e7895787a4f7cc0d6c9896cb8289a45...a94bb6d88310008bbd1c0c31f5a8b36f444f8909,1,4,8,12,5,2014-02-26 07:26:29,2014-02-26 07:26:29
a94bb6d88310008bbd1c0c31f5a8b36f444f8909...de9bb4bfc4e6051988099bcd2356e72cf407582a,1,13,8,21,3,2014-02-26 23:53:48,2014-02-26 23:53:48
de9bb4bfc4e6051988099bcd2356e72cf407582a...078c00563ab212e2454b7c64b45378d9636b4413,1,37,11,48,5,2014-02-26 23:54:37,2014-02-26 23:54:37
9610e0703cd6c9c4835c896de7df2f45afa5a1fa...67b6adc801a4d439a88824d236ae456423f91d53,2,11,7,18,2,2014-02-20 22:34:22,2014-02-20 22:34:22
67b6adc801a4d439a88824d236ae456423f91d53...2e9755a75f10335a60ad1438fe2c4587b68fff33,1,8,11,19,2,2014-02-20 23:27:44,2014-02-20 22:15:30
2e9755a75f10335a60ad1438fe2c4587b68fff33...4d682e3a1c6533c964bfe44ec1e43a93ac192e0d,6,0,161,161,6,2014-02-20 23:32:42,2014-02-20 23:01:02
4d682e3a1c6533c964bfe44ec1e43a93ac192e0d...54074fdac77801c41887d0ad45fd19aaeda4bb4d,1,15,2,17,3,2014-02-20 23:35:38,2014-02-20 23:34:36
54074fdac77801c41887d0ad45fd19aaeda4bb4d...9669bbe368cb72d4fdf6ed5d63932b148008562f,2,2,2,4,2,2014-02-21 01:25:14,2014-02-21 00:53:27
e6ad11883d7e587c6aaf5a78a62efb4e5031d798...89ec9ddf6296b6a0ac04acb221f765c16002e8b6,1,1,1,2,1,2013-12-11 06:13:12,2013-12-11 06:13:12
89ec9ddf6296b6a0ac04acb221f765c16002e8b6...b611db51c2505453ba0ada39d52ab05a5795f295,2,103,11,114,18,2013-12-11 08:15:09,2013-12-08 21:47:51
b611db51c2505453ba0ada39d52ab05a5795f295...3dd3bd3bcabf3881b804c7bced0394200b15f204,2,66,14,80,6,2013-12-11 08:15:09,2013-12-10 20:44:50
3dd3bd3bcabf3881b804c7bced0394200b15f204...878cd8d4ae4ad28d7aa925242d950a73d06c2aae,1,4,3,7,1,2013-12-11 08:34:16,2013-12-11 08:34:16
878cd8d4ae4ad28d7aa925242d950a73d06c2aae...28b8c541a9d7a9cf328021bdad9224bd85357ed7,2,43,1,44,3,2013-12-11 08:53:55,2013-12-11 08:53:55
28b8c541a9d7a9cf328021bdad9224bd85357ed7...dddc4739ccebfe692082fa026b4a0bf82e15e46c,2,40,2,42,7,2013-12-11 11:18:43,2013-12-11 11:18:43
dddc4739ccebfe692082fa026b4a0bf82e15e46c...49b7e4529529e924d9c45a62a707fbeb6f0a6c1d,2,3,2,5,2,2013-12-11 11:26:13,2013-12-11 11:26:13
49b7e4529529e924d9c45a62a707fbeb6f0a6c1d...23fb2e3b4bc64ca60b79617d2a0746290a5afa7b,1,1,1,2,1,2013-12-11 18:57:00,2013-12-11 10:18:22
23fb2e3b4bc64ca60b79617d2a0746290a5afa7b...28f3ec0073969296751bd3525b5b21458e458fb4,1,1,0,1,1,2013-12-11 18:57:47,2013-12-11 18:57:47
28f3ec0073969296751bd3525b5b21458e458fb4...ff7c35c5a3781bce67c4c0a6c2f69b1cf717ad82,5,145,43,188,21,2013-12-11 21:50:24,2013-12-11 21:50:24
ff7c35c5a3781bce67c4c0a6c2f69b1cf717ad82...8c5ebca0d9e4feb0ac3b46edee89cce3d92f8e88,1,8,5,13,4,2013-12-11 23:07:15,2013-12-11 23:07:15
8c5ebca0d9e4feb0ac3b46edee89cce3d92f8e88...8de5ebfc6fda4865a13b6dbc3367a761ed98baed,1,1,1,2,1,2013-12-12 01:04:06,2013-12-12 01:04:06
8de5ebfc6fda4865a13b6dbc3367a761ed98baed...8de0ae58dc42ffb1e2e85022913995ec3f168905,1,1,1,2,1,2013-12-12 01:42:04,2013-12-12 01:42:04
8de0ae58dc42ffb1e2e85022913995ec3f168905...13c9de24b3e697688f0283cafcfc8a088e3db01a,4,10,3,13,4,2013-12-12 01:48:58,2013-12-12 01:48:30
13c9de24b3e697688f0283cafcfc8a088e3db01a...930727d426a0ccdefbb381e57a615c31adc4922c,1,42,29,71,24,2013-12-12 02:23:40,2013-12-12 02:23:40
930727d426a0ccdefbb381e57a615c31adc4922c...506fb6a552feb86a2525ee1aa98f915f79aaff84,3,5,5,10,5,2013-12-12 02:57:30,2013-12-12 02:57:30
39990a342484e2432c6eeef2fd2a16df665e6363...70e2acdcca264a4e58203e537028368aabcf614e,2,3,3,6,3,2014-09-26 23:42:40,2014-09-26 23:40:16
7bbc58066516a6ab36707b88612ecb164c3dc526...3dadc0512d8784cc9298272335f1d3791c4874b5,1,8,0,8,1,2014-09-18 03:48:39,2014-09-18 03:48:39
3dadc0512d8784cc9298272335f1d3791c4874b5...d8377487dc3a44fc2f482ed49059cc1427bd9b73,16,479,317,796,128,2014-09-18 07:12:30,2014-09-18 07:12:22
d8377487dc3a44fc2f482ed49059cc1427bd9b73...64a624ae5c36a30c10e20216400f7e751d4963b2,3,10,1,11,3,2014-09-18 18:55:58,2014-09-18 18:55:02
c9697bd6d8d0b9d4cced57b8f410c9daa98c10df...81caacec4c9b32d763df8674d229bd95d9cdaeb4,1,1,1,2,1,2014-09-16 18:13:31,2014-09-16 18:13:31
81caacec4c9b32d763df8674d229bd95d9cdaeb4...857b380416b3cf0edcc0190beb978086eede57f0,3,8,18,26,3,2014-09-16 20:52:33,2014-09-16 20:52:33
e742697675b734d021277b333ababa9151f52b8e...d5108ee1945cae443395eb3dd807da89a82b47c6,5,8,298,306,16,2014-09-09 20:06:57,2014-09-09 20:06:57
d852bb927fafc45ec1be5c9d2105f4b4baf14218...cf955a20e53e9dac61660a1f7ee4d3aa3603024b,2,18,280,298,11,2014-09-08 18:05:35,2014-09-08 18:04:47
cf955a20e53e9dac61660a1f7ee4d3aa3603024b...920882ea7bd8a81e37f4fa11edb43f5ecc7f0617,4,1024,2,1026,7,2014-09-10 00:28:49,2014-09-10 00:28:49
920882ea7bd8a81e37f4fa11edb43f5ecc7f0617...a6ca093c714e1bec6207ccdd9bff41a1218d20a3,2,16,2,18,5,2014-09-10 00:30:20,2014-09-10 00:30:20
a6ca093c714e1bec6207ccdd9bff41a1218d20a3...86454f9210ae8bf284fdddf4531f924a37552948,8,347,1311,1658,50,2014-09-12 02:54:22,2014-09-12 02:54:22
86454f9210ae8bf284fdddf4531f924a37552948...6cc7eee173f7f15a8721d476eefa9bd17ccb6dd5,7,84,149,233,41,2014-09-12 21:07:01,2014-09-12 21:07:01
6cc7eee173f7f15a8721d476eefa9bd17ccb6dd5...5ae302315ed3a4be34bfcdd28b19b9715a55e8eb,1,6,4,10,3,2014-09-14 18:22:22,2014-09-14 18:22:22
5ae302315ed3a4be34bfcdd28b19b9715a55e8eb...0ad00839f5452c073aefb2f40ffcde4628966908,4,179,61,240,25,2014-09-15 15:49:36,2014-09-15 15:49:36
0ad00839f5452c073aefb2f40ffcde4628966908...355e74d3751f7992bb1e8c253e7815bb65960af1,1,3,3,6,3,2014-09-15 19:13:20,2014-09-15 19:13:20
355e74d3751f7992bb1e8c253e7815bb65960af1...2d46eeef2b851303e3f01b7f87ee00772619d246,1,4,0,4,2,2014-09-15 19:13:52,2014-09-15 19:13:52
2d46eeef2b851303e3f01b7f87ee00772619d246...870d1ce06d15fbdac1519bf0b6225b64759ea7d5,2,26,19,45,2,2014-09-16 14:11:37,2014-09-16 14:11:37
fb4fbea3a8e51b1e4b969cc1a86f3f3375cd3ce1...e8befb9a5011e9089fecd4090139cf3d64f84d31,1,1,1,2,1,2014-09-10 22:52:21,2014-09-10 22:52:21
e8befb9a5011e9089fecd4090139cf3d64f84d31...76b5f053f1467016948e6696a2640389840b4e08,1,4,4,8,4,2014-09-10 22:56:21,2014-09-10 22:56:21
76b5f053f1467016948e6696a2640389840b4e08...d1dbadb2f9566ebf35f13f4cbfab3096acd54400,1,5,4,9,5,2014-09-10 23:24:47,2014-09-10 23:24:47
d1dbadb2f9566ebf35f13f4cbfab3096acd54400...26d7398db5080cd3c9bf1280613e94e7dd2b0ae1,1,5,5,10,1,2014-09-10 23:48:28,2014-09-10 23:48:28
05b84fcc5e7ca8dc0004963d37fc5caf4414eda0...9ebd90bddc7cd3061632d3e5e108e18786a63987,3,66,12,78,12,2014-09-09 14:55:37,2014-09-09 14:55:37
853ef8535c857adf5d3fbf6c6c3b6661be790ef1...53e240c70ee3603ea17c3658dfb49e3554cae860,1,11,5,16,2,2014-09-05 21:54:23,2014-09-05 21:54:23
53e240c70ee3603ea17c3658dfb49e3554cae860...fe436f2c8af8ff5a235d7acf3ffeee78a3c842e7,1,1,5,6,1,2014-09-05 23:52:05,2014-09-05 23:52:05
fe436f2c8af8ff5a235d7acf3ffeee78a3c842e7...8dbdadf2c727ab87cf0ce50fbcb478366175a872,2,4,4,8,4,2014-09-06 00:02:27,2014-09-01 00:22:40
e2dc9968658560723c08d3738ddc41b615991f23...975c004867a8f389b94ce4584975eec67b983b72,1,1,1,2,1,2014-08-28 17:29:10,2014-08-28 17:29:10
975c004867a8f389b94ce4584975eec67b983b72...171c2dea4919d50084b090b83c67da272b42e501,1,1,1,2,1,2014-08-28 17:35:40,2014-08-28 17:35:40
171c2dea4919d50084b090b83c67da272b42e501...864fffc9e9cc6ed2b8a2d5a30d99857f757dadf3,42,42,42,84,42,2014-08-28 18:00:35,2014-08-28 18:00:08
864fffc9e9cc6ed2b8a2d5a30d99857f757dadf3...827360189cde1aa7ea4b57ecf42b43c6e6311e8d,1,1,1,2,1,2014-08-28 18:09:13,2014-08-28 18:09:13
827360189cde1aa7ea4b57ecf42b43c6e6311e8d...18c917b44fdc1e7ee3c30873ad695ce1bf98aaab,1,1,1,2,1,2014-08-28 18:35:30,2014-08-28 18:35:30
18c917b44fdc1e7ee3c30873ad695ce1bf98aaab...c080a59b3db816b8eef77a2d7bafbff780c2e4b5,1,1,1,2,1,2014-08-28 18:36:26,2014-08-28 18:36:26
e2dc9968658560723c08d3738ddc41b615991f23...52db2174a51487c06241e0ecef22e562586f49d3,2,15,15,30,8,2014-08-28 17:28:34,2014-08-28 17:28:34
aef29845c5538763a53d3ee17546a9fb9173f234...87bac7820df0aafb4cb8eb86e17a5a24cec4512a,1,1,3,4,2,2014-08-28 05:54:35,2014-08-28 05:53:44
345d49f15a0e211ac8b4441fbc5022733273b8c9...d821f2f7d3058297fe454398d624bb6e534d04e6,1,1,1,2,1,2014-08-29 18:53:30,2014-08-29 18:53:19
d821f2f7d3058297fe454398d624bb6e534d04e6...52db5b6f53ef1e13a51dd252d12b942d15c740bb,1,2,1,3,1,2014-08-29 18:57:59,2014-08-29 18:57:59
fca5c382d5c25e23c962755e08a1ce7230df6e20...2c741b0a34bc122cfbf0860c15e7c116d64fbfd5,1,0,4,4,1,2014-08-29 07:27:26,2014-08-29 07:27:26
2c741b0a34bc122cfbf0860c15e7c116d64fbfd5...1078a6eeb44e838dd5df1c86d3114d4abb33fe74,1,2,2,4,2,2014-08-29 07:43:07,2014-08-29 07:43:07
1078a6eeb44e838dd5df1c86d3114d4abb33fe74...a02cb37ca7757d33f1430042503f34e8289ffebd,1,2,0,2,2,2014-08-29 08:19:33,2014-08-29 08:19:33
8345de74e93c52fe6c9d36fe0645a3802ed7916a...c9857ea642f70a3ae61a07b0fdd7cf85197f8f42,10,38,39,77,39,2014-08-28 05:43:28,2014-08-28 05:43:28
c9857ea642f70a3ae61a07b0fdd7cf85197f8f42...384c98b88d9ca98f142b06b2bad9d532da6cf673,1,5,4,9,1,2014-08-28 05:57:21,2014-08-28 05:57:21
384c98b88d9ca98f142b06b2bad9d532da6cf673...743396a0ce5f25150f6e08bd7cc74674dcf46efb,4,5,11,16,6,2014-08-28 05:58:09,2014-08-28 05:58:09
743396a0ce5f25150f6e08bd7cc74674dcf46efb...d951e45a1be803b140670a38f4f3150112034c78,3,64,47,111,6,2014-08-28 07:31:23,2014-08-28 07:31:23
d951e45a1be803b140670a38f4f3150112034c78...cecf89516eeadccc6746c12d577b3da8835a67ec,3,20,20,40,13,2014-08-28 07:53:22,2014-08-28 07:53:22
cecf89516eeadccc6746c12d577b3da8835a67ec...c081213fc918694a425a587968af580a5c4ee175,3,59,92,151,25,2014-08-28 09:28:16,2014-08-28 09:28:16
c081213fc918694a425a587968af580a5c4ee175...26bb071967a01350a4f105f2a30844e00302cd6d,1,0,12,12,1,2014-08-28 09:28:41,2014-08-28 09:28:41
26bb071967a01350a4f105f2a30844e00302cd6d...4b1958de0a5013b0aeb13f3bd9e500e735bbfb97,2,10,9,19,4,2014-08-28 09:36:00,2014-08-28 09:36:00
4b1958de0a5013b0aeb13f3bd9e500e735bbfb97...db17540f2f4940bfdb7d1a868be4f27c55a18607,4,14,23,37,8,2014-08-28 09:46:13,2014-08-28 09:46:13
db17540f2f4940bfdb7d1a868be4f27c55a18607...1dedd893877d8d01176dc52356479d9ad0d541eb,14,386,365,751,118,2014-08-28 11:11:25,2014-08-28 11:11:25
69f80bbb42360f3de6169e439dc17c2835d8ff34...6acde3e4e33d89d77359fa4a3af3319532674ae8,5,62,28,90,4,2014-08-12 04:27:00,2014-08-12 04:27:00
6acde3e4e33d89d77359fa4a3af3319532674ae8...01c7c89f5de5cf4541e1f235e2bbde8ffecffba3,1,2,0,2,1,2014-08-12 04:30:18,2014-08-12 04:30:18
01c7c89f5de5cf4541e1f235e2bbde8ffecffba3...f12e89155f059029da5c0106670082d51779103b,1,8,0,8,1,2014-08-12 04:43:19,2014-08-12 04:43:19
f12e89155f059029da5c0106670082d51779103b...841a223d0b13da0879c96a163b690038309f4b18,1,23,23,46,23,2014-08-12 04:44:48,2014-08-12 04:44:48
841a223d0b13da0879c96a163b690038309f4b18...8f30d7779d1f2c39b88c0fbf10907e6aa9fe2ce4,4,93,65,158,12,2014-08-12 05:53:08,2014-08-12 05:53:08
8f30d7779d1f2c39b88c0fbf10907e6aa9fe2ce4...77735628def01dd1e8e2cf42e4975ca358ec6aa7,1,13,5,18,6,2014-08-12 06:26:18,2014-08-12 06:26:18
987b5dd42d11d61237fe9a962934c91803ea432e...a9db15a9e66d5b580edb37ffa9ff20b7e135c566,18,18,18,36,18,2014-08-14 19:02:08,2014-08-14 18:53:15
a9db15a9e66d5b580edb37ffa9ff20b7e135c566...cf17ef3bf436912c3bed2dedf9573950926c41c6,3,44,14,58,5,2014-08-14 21:29:18,2014-08-14 21:24:20
cf17ef3bf436912c3bed2dedf9573950926c41c6...401cee2ef6e118fc3ee36e25759b1e6da19a1ae3,4,9,21,30,5,2014-08-14 23:12:05,2014-08-14 23:12:05
401cee2ef6e118fc3ee36e25759b1e6da19a1ae3...29357964dc5f5fc45f2c98c4f6e1b70a098ea493,1,8,0,8,2,2014-08-14 23:15:23,2014-08-14 23:15:23
29357964dc5f5fc45f2c98c4f6e1b70a098ea493...924195b22491885d3cc32335c96d7c2b52d1be20,3,24,24,48,21,2014-08-14 23:17:00,2014-08-14 23:17:00
924195b22491885d3cc32335c96d7c2b52d1be20...44bcae916df56babc73f48cb39c81e840732131f,3,111,85,196,10,2014-08-14 23:24:16,2014-08-14 23:24:16
44bcae916df56babc73f48cb39c81e840732131f...5c5c5308de8057a217031095e908f116c90dd5a6,1,1,1,2,1,2014-08-14 23:37:47,2014-08-14 23:37:47
5c5c5308de8057a217031095e908f116c90dd5a6...aa8e2371944280bcb36ccf411659bb2fa10497a3,1,10,14,24,9,2014-08-14 23:38:25,2014-08-14 23:38:25
aa8e2371944280bcb36ccf411659bb2fa10497a3...98b2885e853139ab64eddec00b7700313cca331b,7,7,9,16,8,2014-08-15 14:21:24,2014-08-15 14:21:24
ff1a6c05b6f4e345243fba9d236958ae6106292c...c268a2ada7510546f32afdea484e992fb99d14a8,3,111,42,153,22,2014-08-18 23:40:30,2014-08-18 23:40:30
c268a2ada7510546f32afdea484e992fb99d14a8...3753687c045f40834fa1f4e0a949840b3ac8dc84,1,1,1,2,1,2014-08-18 23:42:37,2014-08-18 23:42:37
3753687c045f40834fa1f4e0a949840b3ac8dc84...adfc7d1d76c787bd1cb08e1dd12e5022fb022179,3,17,35,52,9,2014-08-19 00:27:15,2014-08-19 00:27:15
adfc7d1d76c787bd1cb08e1dd12e5022fb022179...26145c5bd9e8ab58cb3b15f124f51d387831c81d,1,4,4,8,4,2014-08-19 00:28:56,2014-08-19 00:28:56
26145c5bd9e8ab58cb3b15f124f51d387831c81d...d7cd40a3180088f208bc0eba2a75af40b5593fd4,1,4,4,8,4,2014-08-19 00:46:32,2014-08-19 00:46:32
d7cd40a3180088f208bc0eba2a75af40b5593fd4...fc6488fee1eb7872a7979c9bf729b3c61f3fc4bf,4,25,17,42,14,2014-08-19 00:56:48,2014-08-19 00:56:48
ff1a6c05b6f4e345243fba9d236958ae6106292c...bbbf3ee3187abe8148a028520196256b0ba953f7,1,13,0,13,1,2014-08-18 23:05:36,2014-08-18 23:05:36
bbbf3ee3187abe8148a028520196256b0ba953f7...f59d03a3c4007d2edc140e1c3e6e10f49aad8262,1,2,1,3,2,2014-08-18 23:59:28,2014-08-18 23:59:28
f59d03a3c4007d2edc140e1c3e6e10f49aad8262...3c97f02509aa3248ac51f27ba987a35b4ca45569,2,9,4,13,3,2014-08-19 00:02:58,2014-08-19 00:02:58
3c97f02509aa3248ac51f27ba987a35b4ca45569...cd1d592f87c6c8dfb1bb8dffa2cc716516bc0808,1,6,6,12,2,2014-08-19 00:11:39,2014-08-19 00:11:39
cd1d592f87c6c8dfb1bb8dffa2cc716516bc0808...63a00c9c9697baad8f37c6418ef68b6dd0e12162,1,2,3,5,3,2014-08-19 00:13:36,2014-08-19 00:13:36
63a00c9c9697baad8f37c6418ef68b6dd0e12162...d6071c121c7c8dea6eb796e9c831ba8c2f40fdb2,1,1,1,2,1,2014-08-19 00:15:34,2014-08-19 00:15:34
d6071c121c7c8dea6eb796e9c831ba8c2f40fdb2...2bc8b0559645fcba02785b89834280e4dc62601f,1,1,1,2,1,2014-08-19 00:16:31,2014-08-19 00:16:31
2bc8b0559645fcba02785b89834280e4dc62601f...2dd1434f3f7715e1ab2813af350a2bf9b80e58f5,1,2,0,2,1,2014-08-19 01:34:01,2014-08-19 01:34:01
2dd1434f3f7715e1ab2813af350a2bf9b80e58f5...e59bf43470eb7bb0c43ded665c4a48269f427dc8,1,2,0,2,1,2014-08-19 02:01:06,2014-08-19 02:01:06
ef42676caef3cfb60ecc0f5963ec43c9b6b63d0b...9e44f25cf578134115aebbdeaf7f74ca2e119887,4,56,15,71,9,2014-08-14 00:15:25,2014-08-14 00:15:25
9e44f25cf578134115aebbdeaf7f74ca2e119887...0abd01b7ee0964879cbdf5b111883886c13f59f7,1,1,1,2,1,2014-08-14 00:16:19,2014-08-14 00:16:19
0abd01b7ee0964879cbdf5b111883886c13f59f7...171655df33f3c1dd6afcb65575e432c1193e5690,1,2,1,3,1,2014-08-14 00:22:09,2014-08-14 00:22:09
171655df33f3c1dd6afcb65575e432c1193e5690...86d34d4031ff18c37b9c5621fe16a59174038031,1,1,1,2,1,2014-08-14 00:25:27,2014-08-14 00:25:27
c8d7821deb271a2c7747151ddf59701a4b11a90d...2995424b452a8a112fc1215268a358cf55afbc6f,4,53,5,58,8,2014-07-17 20:34:38,2014-07-17 20:34:38
2995424b452a8a112fc1215268a358cf55afbc6f...d6ab7ee700f83c8dc6bb73ce4596f57295435b56,1,2,2,4,1,2014-07-17 21:01:27,2014-07-17 21:01:27
c8d7821deb271a2c7747151ddf59701a4b11a90d...8e005cadd397c30e03fbd9bea22c599fa40ccf72,2,58,2,60,3,2014-07-17 03:13:25,2014-07-17 03:13:25
ff3c9746f0ee204f18ba3c29e4b3defd0aa6bd00...13be093e8cfb8f382380ecac7739f11dd1b5219b,3,26,6,32,7,2014-07-02 18:08:15,2014-07-02 18:08:15
13be093e8cfb8f382380ecac7739f11dd1b5219b...4efc03a5f8418961a1f43dac3876907448af4151,1,2,9,11,1,2014-07-02 18:32:31,2014-07-02 18:32:31
4efc03a5f8418961a1f43dac3876907448af4151...1be32f2af7300a1856d1d2822a87428f6d2037cd,1,4,15,19,2,2014-07-03 19:35:55,2014-07-03 19:35:55
ff3c9746f0ee204f18ba3c29e4b3defd0aa6bd00...d136d3a41a1fe986fcaca3246d6987e9bd08b66c,1,4,4,8,4,2014-07-02 02:49:43,2014-07-02 01:41:36
d30bb79498c2167f4b2b69590fe6dee51dc594da...291c2ecad72fb15c555186061f4987b8616a44c8,2,2,3,5,2,2014-01-27 17:52:50,2014-01-27 17:52:50
291c2ecad72fb15c555186061f4987b8616a44c8...8f4963ecd202635610272ffdf8bff2a1b6ea0806,2,2,5,7,2,2014-01-27 21:52:54,2014-01-27 21:52:54
fb9592a93dc8aaaf181038d1f34ebc1f1daf2f53...67cadc67e1d3ce5f341ec7c06ba21fcb807b6d1d,2,6570,6022,12592,1275,2014-02-18 23:38:34,2014-02-18 23:38:34
67cadc67e1d3ce5f341ec7c06ba21fcb807b6d1d...592a82be766905f4034a3f5fdabdc331c580e8a0,2,15,15,30,13,2014-02-18 23:39:42,2014-02-18 23:39:42
592a82be766905f4034a3f5fdabdc331c580e8a0...960e17eadf5511e450e892486a89a97ef32ae4f6,3,694,521,1215,3,2014-02-18 23:40:48,2014-02-18 23:40:48
960e17eadf5511e450e892486a89a97ef32ae4f6...fc55d028ea351f6a8d62fb33a52665c8097e5064,1,6,0,6,2,2014-02-19 00:14:52,2014-02-19 00:14:52
fc55d028ea351f6a8d62fb33a52665c8097e5064...45043c6996c9a8d48d2f38585f2c9598f952772c,1,3,5,8,1,2014-02-19 01:33:09,2014-02-18 21:07:40
45043c6996c9a8d48d2f38585f2c9598f952772c...c9d6784ab0e429ec165e6aac1ca6fcf4ee064f03,1,1,1,2,1,2014-02-20 19:56:24,2014-02-20 19:56:24
c9d6784ab0e429ec165e6aac1ca6fcf4ee064f03...98de5ffefe50e01b932ee061474ef0836be1c9ee,1,8,11,19,2,2014-02-20 22:17:06,2014-02-20 22:15:30
98de5ffefe50e01b932ee061474ef0836be1c9ee...980a669c456e824646275868e636578d6c89bd2f,1,2,1,3,1,2014-02-20 22:57:57,2014-02-20 22:57:57
980a669c456e824646275868e636578d6c89bd2f...b426ce8dde7058154105edb2112f4f92a0674906,1,2,6,8,2,2014-02-21 00:37:35,2014-02-21 00:37:35
fb9592a93dc8aaaf181038d1f34ebc1f1daf2f53...8b0b176766f81a94cf3c653726bd1d9f84765971,2,20,1,21,2,2014-02-18 22:25:34,2014-02-18 21:15:49
8b0b176766f81a94cf3c653726bd1d9f84765971...a74b2efd74c3753cac5b1905cdb2833632b85ea0,1,13,3,16,4,2014-02-18 22:35:33,2014-02-18 22:35:33
a74b2efd74c3753cac5b1905cdb2833632b85ea0...9ef3cc7747d08715e549f530ef193424f72a71f8,1,16,2,18,2,2014-02-18 22:42:50,2014-02-18 22:42:50
fb9592a93dc8aaaf181038d1f34ebc1f1daf2f53...c0d5fed96c8e976aa7565ccdae3246f07148bc4b,1,26,26,52,2,2014-02-18 22:03:06,2014-02-18 22:03:06
c0d5fed96c8e976aa7565ccdae3246f07148bc4b...dd2b5ce7299b6f0296122f66ed988955e5e942c1,2,19,1,20,3,2014-02-18 22:17:41,2014-02-18 22:17:41
dd2b5ce7299b6f0296122f66ed988955e5e942c1...653045ffec060855ae9d01ddcedbe13216fddf3e,3,12,7,19,9,2014-02-18 22:47:52,2014-02-18 22:18:07
653045ffec060855ae9d01ddcedbe13216fddf3e...bee4fbbd247c0fcd5a5bb1d11ee19d24c5ab9419,3,41,9,50,8,2014-02-18 22:48:29,2014-02-18 22:48:29
bee4fbbd247c0fcd5a5bb1d11ee19d24c5ab9419...97d2264a3aebd0bf5aeea48cbb7ea11bd7f45fec,1,11,2,13,4,2014-02-18 23:38:26,2014-02-18 23:38:26
97d2264a3aebd0bf5aeea48cbb7ea11bd7f45fec...96e3273f284d175142c786a024afbbceef6e83b1,3,41,24,65,11,2014-02-18 23:43:55,2014-02-18 23:43:55
96e3273f284d175142c786a024afbbceef6e83b1...d3291f723431aec31adec8ce6a00399559de7458,1,1,1,2,1,2014-02-18 23:44:09,2014-02-18 23:44:09
d3291f723431aec31adec8ce6a00399559de7458...d1d714ec66aeb5ecae1130da1d9e5a39268318d0,6,187,81,268,18,2014-02-19 01:25:19,2014-02-19 01:25:19
d1d714ec66aeb5ecae1130da1d9e5a39268318d0...31b387b775f0fecd16d1f8f8ea0438afea902b1f,1,3,3,6,3,2014-02-19 20:34:08,2014-02-19 20:34:08
31b387b775f0fecd16d1f8f8ea0438afea902b1f...92abbf2f5c4ad2ee0c5ba0f8ea9a968a62ef43cf,1,3,2,5,3,2014-02-19 20:34:33,2014-02-19 20:34:33
92abbf2f5c4ad2ee0c5ba0f8ea9a968a62ef43cf...c8e75d9afc9b5c45c0ef914e0c28644ec55843c5,1,2,5,7,5,2014-02-19 22:46:28,2014-02-19 22:46:28
c8e75d9afc9b5c45c0ef914e0c28644ec55843c5...423ae65d93c184c677d4653a4ae90fa1df3daa6f,1,8,3,11,2,2014-02-19 22:47:54,2014-02-19 22:47:54
9669bbe368cb72d4fdf6ed5d63932b148008562f...58dc0ee3bb6ad1cd5b161cb85facfa34a5696519,1,7,2,9,1,2014-02-21 03:32:16,2014-02-21 03:32:16
58dc0ee3bb6ad1cd5b161cb85facfa34a5696519...0eaa021f4cd9d0b92c1c359f1f93dd8e741d0c7f,1,5,2,7,1,2014-02-21 17:05:51,2014-02-21 17:05:51
506fb6a552feb86a2525ee1aa98f915f79aaff84...09d129b7996fc0524745d110cf361e7c0cf8faff,1,11,1,12,1,2013-12-13 07:53:26,2013-12-12 07:57:09
09d129b7996fc0524745d110cf361e7c0cf8faff...a244430f31dad5b3299e3b55e99fdc0daed016c0,2,118,3,121,5,2013-12-13 07:53:44,2013-12-12 02:11:20
a244430f31dad5b3299e3b55e99fdc0daed016c0...5ebf0f2ec34b4f981ff0e9e26a6a490acd856040,1,9,2,11,3,2013-12-13 07:54:22,2013-12-12 22:39:18
5ebf0f2ec34b4f981ff0e9e26a6a490acd856040...a5d5a03189300db0c50df29bed211e6a9a21e6f3,2,10,9,19,5,2013-12-13 07:54:32,2013-12-12 23:17:32
a5d5a03189300db0c50df29bed211e6a9a21e6f3...71ca231c2b0c352a1e298b91218b6dea1c5b2b8b,1,4,11,15,2,2013-12-13 07:54:46,2013-12-13 00:10:41
71ca231c2b0c352a1e298b91218b6dea1c5b2b8b...a536b64c82070428b105ac685920ec7ca47ad9d1,1,3,3,6,3,2013-12-13 07:55:02,2013-12-13 00:20:27
a536b64c82070428b105ac685920ec7ca47ad9d1...9d5fb4d1e10d0510a7555f2780d72b3d428a3848,5,5,5,10,5,2013-12-13 10:19:13,2013-12-13 10:19:13
9d5fb4d1e10d0510a7555f2780d72b3d428a3848...de6fb4276da05da6cb3b5920001a790d4c2b33d4,1,1,1,2,1,2013-12-13 10:19:34,2013-12-13 10:19:34
506fb6a552feb86a2525ee1aa98f915f79aaff84...04fddf3a7738d1140ec6acba731cffe5adc7c152,1,7,7,14,4,2013-12-12 04:38:51,2013-12-12 04:38:51
04fddf3a7738d1140ec6acba731cffe5adc7c152...dacc53f16e88d9177433406e9718045bb01ed443,1,11,1,12,1,2013-12-12 07:57:09,2013-12-12 07:57:09
dacc53f16e88d9177433406e9718045bb01ed443...738ffe50a13dc227b5cdd25d5a7b1686bb950212,2,12,3,15,3,2013-12-12 08:21:57,2013-12-12 07:37:16
738ffe50a13dc227b5cdd25d5a7b1686bb950212...c58d4d158b8439ef80535370c9980eca5fdebd12,2,118,3,121,5,2013-12-12 08:21:58,2013-12-12 02:11:20
c58d4d158b8439ef80535370c9980eca5fdebd12...7e02b83708dcca0f9662af2242573269a2c2e835,1,25,3,28,5,2013-12-12 08:38:20,2013-12-12 08:38:20
7e02b83708dcca0f9662af2242573269a2c2e835...0e21a3804354ad511b60e805793282562fed5a5d,1,9,2,11,3,2013-12-12 22:39:18,2013-12-12 22:39:18
0e21a3804354ad511b60e805793282562fed5a5d...d5d11f7897533b3d0c9144af24613a15940118b5,2,10,9,19,5,2013-12-12 23:24:33,2013-12-12 23:17:32
d5d11f7897533b3d0c9144af24613a15940118b5...7d490a5bec3397d13c2023007c3252c70da7918e,2,19,8,27,6,2013-12-13 00:02:02,2013-12-13 00:02:02
7d490a5bec3397d13c2023007c3252c70da7918e...0944988adf64f43cbbd94b583319b22a198b8391,1,9,0,9,1,2013-12-13 00:05:29,2013-12-12 23:55:06
0944988adf64f43cbbd94b583319b22a198b8391...00dea841b26cede3a3e5f11a4b9a77c1923c3e52,1,4,11,15,2,2013-12-13 00:10:41,2013-12-13 00:10:41
00dea841b26cede3a3e5f11a4b9a77c1923c3e52...8e31d09c667646569f3ee0d9212153afaf7570e0,1,3,3,6,3,2013-12-13 00:20:27,2013-12-13 00:20:27
8e31d09c667646569f3ee0d9212153afaf7570e0...0d5060eb6a1a9115515c98c0d03a2f2aec6bb458,3,49,0,49,6,2013-12-13 00:30:04,2013-12-13 00:27:17
0d5060eb6a1a9115515c98c0d03a2f2aec6bb458...f2e3481db3c50c7dd1384977981bbaf633bd0b47,2,7,1,8,2,2013-12-13 00:47:37,2013-12-13 00:47:37
5ef6ad652b5799850c4a28f937dc457db2fc8a27...8baa97271f117bf06e3dd2e695e526965e4e7967,1,1,1,2,1,2014-10-01 06:29:01,2014-10-01 06:29:01
dd7635af6e2bef30a4fd03d3faf14aa1c72aab08...6041122944f48c12d068fc4dc4ca65edb36ee892,3,24,3,27,5,2014-09-26 21:01:19,2014-09-26 21:01:19
6041122944f48c12d068fc4dc4ca65edb36ee892...a8d77fb91a82b6cc68749bfe507a2d4c40255c24,1,2,2,4,1,2014-09-26 21:23:57,2014-09-26 21:23:57
a8d77fb91a82b6cc68749bfe507a2d4c40255c24...1797d28d0e28d4b94391d404c2cae648b7ce328b,2,18,2,20,4,2014-09-26 21:36:40,2014-09-26 21:36:40
1797d28d0e28d4b94391d404c2cae648b7ce328b...f510cd01742101a0060d09398abe1a722caa6d68,2,4,3,7,4,2014-09-26 21:42:12,2014-09-26 21:42:12
f510cd01742101a0060d09398abe1a722caa6d68...03aba01581331aa89f0880fe7e909487fe42034e,1,5,1,6,1,2014-09-26 23:20:26,2014-09-26 23:18:45
03aba01581331aa89f0880fe7e909487fe42034e...0c9199683e8751e0c4c7473609153255fda9af45,1,0,9,9,1,2014-09-26 23:29:33,2014-09-26 23:27:06
0c9199683e8751e0c4c7473609153255fda9af45...89c575242a3664dac56aae54ce3f3626d57ce18d,1,5,3,8,1,2014-09-26 23:32:20,2014-09-26 23:32:20
89c575242a3664dac56aae54ce3f3626d57ce18d...8937af09cf0cb4d0db0a9a035f993b7763b32b0a,1,3,1,4,2,2014-09-26 23:39:59,2014-09-26 23:39:59
8937af09cf0cb4d0db0a9a035f993b7763b32b0a...db675cac3350598be756fc8ae8a65fd5ead06c5b,2,3,3,6,3,2014-09-26 23:40:16,2014-09-26 23:40:16
db675cac3350598be756fc8ae8a65fd5ead06c5b...dd9a51624d94ccf1f76ff14dad6bde29b86bc501,7,49,48,97,14,2014-09-27 01:08:09,2014-09-27 01:08:09
dd9a51624d94ccf1f76ff14dad6bde29b86bc501...7b9022076727e952ec2a3e092efae3f8e6c14e32,1,36,46,82,14,2014-09-27 06:01:56,2014-09-27 05:52:22
7b9022076727e952ec2a3e092efae3f8e6c14e32...54f267a5773f0fb889a47c96e465c5668e9a0bfb,2,39,0,39,2,2014-09-27 06:03:20,2014-09-27 06:03:20
54f267a5773f0fb889a47c96e465c5668e9a0bfb...d23c70a7d6fafea3bfc5fbbfe4f6076b7564c401,1,4,2,6,3,2014-09-29 13:58:09,2014-09-24 23:40:45
d23c70a7d6fafea3bfc5fbbfe4f6076b7564c401...120e82665e2c1ab4aa2ea245ae8ddca5d50564a9,1,9,1,10,4,2014-09-29 13:58:09,2014-09-24 23:50:16
64a624ae5c36a30c10e20216400f7e751d4963b2...9c99638c7fedde9255990a32a623de42671d19f7,8,171,67,238,35,2014-09-19 23:56:24,2014-09-19 06:48:14
9c99638c7fedde9255990a32a623de42671d19f7...e1311c407c10d658f61169bb4fb17d5ee3c160e5,4,35,3,38,6,2014-09-19 23:56:25,2014-09-19 20:41:01
e1311c407c10d658f61169bb4fb17d5ee3c160e5...717d9a0198820fe9ddd5a5520fefb963146828d1,1,2,2,4,2,2014-09-19 23:56:25,2014-09-19 20:47:37
717d9a0198820fe9ddd5a5520fefb963146828d1...4ab2bd4ee43d5b8ea4f09122a140cf51dd491d06,1,9,4,13,2,2014-09-19 23:56:25,2014-09-19 22:27:57
4ab2bd4ee43d5b8ea4f09122a140cf51dd491d06...9963a8bcf35d00dd7b400650591210610feca40d,15,1384,462,1846,375,2014-09-19 23:56:25,2014-09-19 22:34:42
9963a8bcf35d00dd7b400650591210610feca40d...5abc41222cdcb97acd4f79828d5fabde3ce29a06,1,4,1,5,1,2014-09-19 23:56:25,2014-09-19 23:04:29
5abc41222cdcb97acd4f79828d5fabde3ce29a06...db11a5de0b258a09b942d1e35607e4eeb4975d21,4,24,7,31,9,2014-09-19 23:56:25,2014-09-19 23:16:02
db11a5de0b258a09b942d1e35607e4eeb4975d21...cdb840a577f999672518f0150587fcbc627bec2d,2,4,3,7,3,2014-09-20 00:06:44,2014-09-19 23:20:58
cdb840a577f999672518f0150587fcbc627bec2d...ebabe84d13f62a4aaba7383826df76ee2f8f1f16,1,1,0,1,1,2014-09-20 00:06:44,2014-09-19 23:51:09
ebabe84d13f62a4aaba7383826df76ee2f8f1f16...7d171be03bc94c2c7a675c2b16f42c98149c5dac,1,1,0,1,1,2014-09-20 00:06:45,2014-09-19 23:52:46
7d171be03bc94c2c7a675c2b16f42c98149c5dac...98ffa7d6d35e5741fdb8b4eda0b4cbeab4390e33,1,1,1,2,1,2014-09-20 00:22:59,2014-09-20 00:22:30
98ffa7d6d35e5741fdb8b4eda0b4cbeab4390e33...6b3a1c217b6397803da8c84e73d3693a7048320f,1,10,6,16,6,2014-09-20 00:24:45,2014-09-20 00:16:02
6b3a1c217b6397803da8c84e73d3693a7048320f...e1d6167be18415ee9c45dc7eebe0cbc4cae5b4f1,1,4,3,7,2,2014-09-20 00:24:45,2014-09-20 00:24:36
e1d6167be18415ee9c45dc7eebe0cbc4cae5b4f1...25961fef6343437be62f00148db692066065d25d,1,6,10,16,6,2014-09-20 00:26:02,2014-09-20 00:26:02
25961fef6343437be62f00148db692066065d25d...e5dcef91278a5582e4888625ba1b4487f3c3c3c6,2,41,39,80,38,2014-09-20 00:26:48,2014-09-20 00:26:35
e5dcef91278a5582e4888625ba1b4487f3c3c3c6...3b84a63fc2e6af04bebebc93e7a7592be09be16e,1,11,3,14,4,2014-09-20 01:04:06,2014-09-20 01:04:06
3b84a63fc2e6af04bebebc93e7a7592be09be16e...6fec720a2a6b01f25166520705ec48bc46d97e96,1,6,1,7,3,2014-09-20 01:15:18,2014-09-20 01:15:18
6fec720a2a6b01f25166520705ec48bc46d97e96...d64f157f865201e5543214fff9da850e629c4c9d,2,4,4,8,3,2014-09-20 01:23:44,2014-09-19 23:27:48
d64f157f865201e5543214fff9da850e629c4c9d...298f68458063ed912e7f44028f55061d1edf0211,2,3,2,5,3,2014-09-20 01:24:05,2014-09-20 01:23:54
298f68458063ed912e7f44028f55061d1edf0211...099cb726ee9430de89b93cd4b51bbd51061f1f08,1,2,2,4,2,2014-09-20 01:41:19,2014-09-20 01:41:19
099cb726ee9430de89b93cd4b51bbd51061f1f08...b97032b85e32e3f0cd21f1b85f4bea66cc0964e0,1,3,3,6,3,2014-09-20 01:41:52,2014-09-20 01:41:52
b97032b85e32e3f0cd21f1b85f4bea66cc0964e0...30442946cf43ad22cfac499f04e154be5889ef2d,1,1,1,2,1,2014-09-20 01:42:47,2014-09-20 01:42:06
30442946cf43ad22cfac499f04e154be5889ef2d...2c6e615d1728e8fb3796664775e91f5081862232,2,6,1,7,2,2014-09-20 01:42:48,2014-09-20 01:42:25
857b380416b3cf0edcc0190beb978086eede57f0...af3f987699b65faba4b988bd68343b4167531a46,7,178,4,182,24,2014-09-23 00:27:00,2014-09-23 00:27:00
af3f987699b65faba4b988bd68343b4167531a46...72ae4a1b4c8f071a2eaba50209a1a1490518fecd,1,8,2,10,1,2014-09-23 03:58:32,2014-09-23 03:58:32
72ae4a1b4c8f071a2eaba50209a1a1490518fecd...6e09c52c805c4d3d7c8ea050542dd7c31437e32f,1,4,1,5,1,2014-09-23 03:59:23,2014-09-23 03:59:23
6e09c52c805c4d3d7c8ea050542dd7c31437e32f...07c700a178e965eacc9327d9141ad755088cfc76,1,2,1,3,1,2014-09-23 04:02:34,2014-09-23 04:02:34
07c700a178e965eacc9327d9141ad755088cfc76...d534efd921188a71488877a7f5fd0ffabde1fed4,1,1,1,2,1,2014-09-23 04:02:49,2014-09-23 04:02:49
d534efd921188a71488877a7f5fd0ffabde1fed4...53365a45f4dd2638bad22f182d4b24f6b1b63939,1,7,0,7,7,2014-09-23 04:02:59,2014-09-23 04:02:59
53365a45f4dd2638bad22f182d4b24f6b1b63939...7f8bd587bf28bec5e1bd6a16c96a1f47e7542ff8,1,9,4,13,2,2014-09-23 04:36:22,2014-09-23 04:36:22
7f8bd587bf28bec5e1bd6a16c96a1f47e7542ff8...a0624614d32903fed3486c3b2679767b9f46b2f2,1,1,1,2,1,2014-09-23 04:36:57,2014-09-23 04:36:57
a0624614d32903fed3486c3b2679767b9f46b2f2...c97b0b91cf7de92295b23fe9fd61bd5692970098,1,12,1,13,3,2014-09-23 04:37:18,2014-09-23 04:37:18
c97b0b91cf7de92295b23fe9fd61bd5692970098...6f81041090ec4dfe8f961de68aa30498a893442e,1,17,1,18,3,2014-09-23 04:38:06,2014-09-23 04:37:38
6f81041090ec4dfe8f961de68aa30498a893442e...8f0f924e15b18b0adddf489b014b7baa27e128c8,3,27,3,30,6,2014-09-23 04:43:40,2014-09-23 04:42:13
8f0f924e15b18b0adddf489b014b7baa27e128c8...a8982664c138a883fed7f44aac075df9b4719c62,3,8,13,21,6,2014-09-23 04:52:47,2014-09-23 04:52:47
a8982664c138a883fed7f44aac075df9b4719c62...7cb0f847a5243fe258f91d9535050c0ce3be8afd,3,5,7,12,6,2014-09-23 04:54:40,2014-09-23 04:54:40
7cb0f847a5243fe258f91d9535050c0ce3be8afd...abb6ffa66a11a8c4b7161bfd8c5d12f55fe874f5,2,2,3,5,2,2014-09-23 04:56:21,2014-09-23 04:56:21
abb6ffa66a11a8c4b7161bfd8c5d12f55fe874f5...cf68cd755f1cc0fdaa153be06ed42e7ce4d36e80,1,1,1,2,1,2014-09-23 06:27:08,2014-09-23 06:27:08
cf68cd755f1cc0fdaa153be06ed42e7ce4d36e80...e0b452b5c80da8c8a9fc5bd8e8eaecf615f08fa0,3,10,6,16,6,2014-09-23 17:22:11,2014-09-23 17:22:11
e0b452b5c80da8c8a9fc5bd8e8eaecf615f08fa0...1de88191c9933420fda1718a8e237d02192f8bfe,2,3,2,5,2,2014-09-23 17:26:24,2014-09-23 17:26:24
1de88191c9933420fda1718a8e237d02192f8bfe...0a9cacaccf4bb77cccc86062bfffc02d893050be,2,5,4,9,3,2014-09-25 18:38:48,2014-09-25 18:38:48
0a9cacaccf4bb77cccc86062bfffc02d893050be...59ed6e5fc410a0a58a119c0cebae11d507c6152f,1,1,1,2,1,2014-09-25 18:45:38,2014-09-25 18:45:38
857b380416b3cf0edcc0190beb978086eede57f0...3404a250d5ddcbe451148ea607edb54a8c1cb211,1,3,2,5,2,2014-09-16 23:38:44,2014-09-16 23:38:36
3404a250d5ddcbe451148ea607edb54a8c1cb211...0ac18551663876920d4cf7bca36a6b63efbd8d68,2,32,14,46,14,2014-09-17 00:52:40,2014-09-16 03:42:24
0ac18551663876920d4cf7bca36a6b63efbd8d68...a3a63fc5575fa4b33dfad63346e270f61212885a,1,1,1,2,1,2014-09-17 01:01:05,2014-09-17 00:52:56
894638cec760bd9980b59aac851df3255df05d1f...2adb8749ec2ad75d2a86ede78bc9f6d0fe1e41f6,3,110,87,197,23,2014-09-16 15:28:47,2014-09-16 15:28:47
2adb8749ec2ad75d2a86ede78bc9f6d0fe1e41f6...e6b413a5e90446b0199581ee38ed4f523750a8b7,1,7,7,14,3,2014-09-16 20:09:46,2014-09-16 20:09:46
e6b413a5e90446b0199581ee38ed4f523750a8b7...23c0c77ef71456821c598dde4a81193476c632a2,1,2,1,3,2,2014-09-17 23:16:42,2014-09-17 23:16:10
23c0c77ef71456821c598dde4a81193476c632a2...5173bfe881f1eb85fcd1b47b2c30cdf1b9513457,1,6,4,10,6,2014-09-18 00:41:24,2014-09-18 00:41:24
5173bfe881f1eb85fcd1b47b2c30cdf1b9513457...b4db01bdc6a9b3b9d2394c01d4fe294b6e05a65f,1,119,141,260,47,2014-09-19 19:48:14,2014-09-19 19:48:14
b4db01bdc6a9b3b9d2394c01d4fe294b6e05a65f...73aff98b64b0d1831a0e40e0f787f35d36efeca9,3,9,54,63,4,2014-09-19 21:34:15,2014-09-19 21:34:15
73aff98b64b0d1831a0e40e0f787f35d36efeca9...e3149896dd6fd90297848aff10472bcd692acc8c,1,4,6,10,1,2014-09-19 21:35:06,2014-09-19 21:35:06
e3149896dd6fd90297848aff10472bcd692acc8c...b9fdf30ef7e4d48abed89e5d781de45192f5b470,1,5,3,8,3,2014-09-19 21:35:41,2014-09-19 21:35:41
b9fdf30ef7e4d48abed89e5d781de45192f5b470...0e20ec695b89791d998e58c8f04a00b63e0cf782,1,2,6,8,1,2014-09-19 21:36:05,2014-09-19 21:36:05
0e20ec695b89791d998e58c8f04a00b63e0cf782...d2d04c6bf38657b836ea9f996f2d8964963a9b8c,1,1,0,1,1,2014-09-19 21:36:34,2014-09-19 21:36:34
d2d04c6bf38657b836ea9f996f2d8964963a9b8c...e432c1583c51905626982ab8637733343e5080a5,1,4,5,9,3,2014-09-19 21:37:29,2014-09-19 21:37:29
e432c1583c51905626982ab8637733343e5080a5...bac8ec4ea375dfbd908875e03566d92c21346202,1,30,30,60,3,2014-09-19 21:44:40,2014-09-19 21:44:40
bac8ec4ea375dfbd908875e03566d92c21346202...9149dd9fc8e460ef88dbc6d2c0c5b512996ed0a8,1,0,2,2,1,2014-09-19 21:45:15,2014-09-19 21:45:15
9149dd9fc8e460ef88dbc6d2c0c5b512996ed0a8...01428bc2a0525088c19f715104961c9e2dca0e93,3,71,206,277,32,2014-09-20 01:25:53,2014-09-20 01:25:53
01428bc2a0525088c19f715104961c9e2dca0e93...4970b87bcfe3760d704415d8123d0de856199ded,2,9,21,30,10,2014-09-22 16:21:49,2014-09-22 16:21:49
4970b87bcfe3760d704415d8123d0de856199ded...70ab0e907c3efd0223426f9d69ccb76f1bbebfb9,1,3,3,6,3,2014-09-22 17:21:55,2014-09-22 17:21:55
70ab0e907c3efd0223426f9d69ccb76f1bbebfb9...6cedadc4a546f608feea94a34ff8c4c29db3ebdb,1,3,1,4,1,2014-09-22 17:22:27,2014-09-22 17:22:27
6cedadc4a546f608feea94a34ff8c4c29db3ebdb...cbb2ec6ff214d0be293b272c20f0f020a1f6226a,1,1,1,2,1,2014-09-22 17:27:42,2014-09-22 17:27:42
cbb2ec6ff214d0be293b272c20f0f020a1f6226a...1d47b57338dca70d77889da4e56a648e282d0627,1,1,0,1,1,2014-09-22 17:40:49,2014-09-22 17:40:49
1d47b57338dca70d77889da4e56a648e282d0627...8de48f61fe53ebaae0bcae2e54ad847a0a061383,1,13,9,22,4,2014-09-22 17:57:56,2014-09-22 17:57:56
8de48f61fe53ebaae0bcae2e54ad847a0a061383...1f0aa1d54ed10ddf414c081be7a9bd7144288394,1,7,1,8,4,2014-09-22 19:09:46,2014-09-22 19:09:46
d5108ee1945cae443395eb3dd807da89a82b47c6...05507080f628b80b2da87c900a06451ca1ba1f60,2,6,4,10,4,2014-09-10 16:46:30,2014-09-10 16:46:30
d5108ee1945cae443395eb3dd807da89a82b47c6...4106491efefdc9510d8279d649d1596a325b1ea4,1,45,0,45,5,2014-09-10 06:28:28,2014-09-10 06:28:28
4106491efefdc9510d8279d649d1596a325b1ea4...0f9427e0b25db1312d03f74ab37339322a5552b1,5,30,6,36,10,2014-09-10 16:16:03,2014-09-10 16:16:03
0f9427e0b25db1312d03f74ab37339322a5552b1...ddd86b00dd979c5018e3cba99c7a9397d1910e20,1,2,0,2,1,2014-09-10 16:22:11,2014-09-10 16:22:11
ddd86b00dd979c5018e3cba99c7a9397d1910e20...4b90199024d899a6f399d0ed5d579a87228d4d4f,2,8,2,10,2,2014-09-10 16:28:56,2014-09-10 16:28:56
4b90199024d899a6f399d0ed5d579a87228d4d4f...53e81e89bcbf78b89a18adf762c8b14d00841b15,1,0,5,5,1,2014-09-10 20:36:27,2014-09-10 20:36:27
d5108ee1945cae443395eb3dd807da89a82b47c6...df51260143e03c6037a98605e733edd75054b8ac,1,7,3,10,2,2014-09-09 22:52:43,2014-07-30 13:13:13
df51260143e03c6037a98605e733edd75054b8ac...955e3a881aafcedb0c0ceae61798942837503b76,1,18,13,31,4,2014-09-09 23:57:19,2014-09-09 23:57:19
955e3a881aafcedb0c0ceae61798942837503b76...03a53fef6328882ad2a2c2df8f9c140219c9a6b7,1,13,3,16,4,2014-09-10 00:25:18,2014-09-10 00:23:01
c3e2fedfb2aea4c20df2c71cd2567955d387e827...16a8b2731c2b560d67d09afcc35c6c4b89143d98,1,1,1,2,1,2014-09-11 01:10:17,2014-09-11 01:10:17
16a8b2731c2b560d67d09afcc35c6c4b89143d98...ca0354f6cbd12c3e41063ba7b868ba0f3fd418aa,1,0,6,6,1,2014-09-11 01:15:21,2014-09-11 01:15:21
ca0354f6cbd12c3e41063ba7b868ba0f3fd418aa...b7dbc9da6253657b3c38363e8a91959fa93e8593,1,16,0,16,2,2014-09-11 01:24:16,2014-09-11 01:23:15
b7dbc9da6253657b3c38363e8a91959fa93e8593...3dcc186914e6a7908c4cd14fe2fbe5cb20277412,1,2,2,4,2,2014-09-11 01:27:54,2014-09-11 01:27:54
3dcc186914e6a7908c4cd14fe2fbe5cb20277412...94f4dfaaec2e7be9c2d10c0f67de78eb9897d342,1,19,9,28,4,2014-09-11 01:39:55,2014-09-11 01:39:55
94f4dfaaec2e7be9c2d10c0f67de78eb9897d342...89824f6e260a9f17ca836566a2506c65ab91c0ce,1,1,1,2,1,2014-09-11 01:42:28,2014-09-11 01:41:02
89824f6e260a9f17ca836566a2506c65ab91c0ce...0ba9ec8e4e8c604f510220aed5eb0f12c50f4073,1,1,1,2,1,2014-09-11 01:47:41,2014-09-11 01:47:16
0ba9ec8e4e8c604f510220aed5eb0f12c50f4073...777f6c92d076befa190c30fa08c14c0df27a88d1,1,1,1,2,1,2014-09-11 01:53:06,2014-09-11 01:53:06
777f6c92d076befa190c30fa08c14c0df27a88d1...47b43dfb863a4d1791e334ca83c6448aebf1d5b6,1,7,1,8,2,2014-09-11 01:53:56,2014-09-11 01:53:37
47b43dfb863a4d1791e334ca83c6448aebf1d5b6...daea8b7cd9e13f0ca6fd4a33853377cc05226513,5,4,9,13,5,2014-09-11 01:59:54,2014-09-11 01:59:54
daea8b7cd9e13f0ca6fd4a33853377cc05226513...52d66644e9d23a92c0905d2b5ba28b1e403ef691,6,7,7,14,7,2014-09-11 02:01:53,2014-09-11 02:01:53
52d66644e9d23a92c0905d2b5ba28b1e403ef691...6d4ac7b8dbda86f93408ac87749d8d25f57d6f91,1,1,1,2,1,2014-09-11 04:07:43,2014-09-11 04:07:43
6d4ac7b8dbda86f93408ac87749d8d25f57d6f91...1e8204a6b3308c78c94a91343dfaf6d24b721974,1,30,7,37,8,2014-09-11 18:03:15,2014-09-11 17:56:21
1e8204a6b3308c78c94a91343dfaf6d24b721974...419d58de21f0507176ac5f0e9078060edaa7a8e4,1,2,2,4,2,2014-09-11 18:08:20,2014-09-11 18:08:20
419d58de21f0507176ac5f0e9078060edaa7a8e4...ac3f5c41f48e771b6108e1425f368adc04f7689f,1,4,0,4,1,2014-09-11 18:17:02,2014-09-11 18:17:02
ac3f5c41f48e771b6108e1425f368adc04f7689f...893f412bb3e9dae04752472170ce9369b7c2bae6,1,1,1,2,1,2014-09-11 18:21:37,2014-09-11 18:21:37
893f412bb3e9dae04752472170ce9369b7c2bae6...3bc183bb70b82aa4bbf9f3fa6c9f16ba3c7f9752,1,11,0,11,1,2014-09-11 19:07:03,2014-09-11 18:55:15
3bc183bb70b82aa4bbf9f3fa6c9f16ba3c7f9752...a32724c3b116193297e74dfe220aafd13a6d981f,1,10,0,10,1,2014-09-11 19:36:37,2014-09-11 19:36:37
a32724c3b116193297e74dfe220aafd13a6d981f...377100897f0b3aa3e06733976bfef3f3148fed25,1,3,0,3,3,2014-09-11 19:36:59,2014-09-11 19:36:59
377100897f0b3aa3e06733976bfef3f3148fed25...21e1fdae427ce3e7154984a5e686203f58cdf94b,1,13,0,13,1,2014-09-11 20:19:31,2014-09-11 20:19:31
21e1fdae427ce3e7154984a5e686203f58cdf94b...689a3d7a7d635c9329aedcadd29a85c1778d08e6,1,3,0,3,1,2014-09-11 20:44:31,2014-09-11 20:44:31
689a3d7a7d635c9329aedcadd29a85c1778d08e6...041dc7e5f82a73dfbd7cb97f4ba8eeef73840a81,1,568,47,615,42,2014-09-11 21:38:41,2014-09-11 20:18:28
041dc7e5f82a73dfbd7cb97f4ba8eeef73840a81...f729ac094acf0227fa3f4f3fb3d9397741889131,1,15,0,15,1,2014-09-11 21:43:20,2014-09-11 21:43:20
f729ac094acf0227fa3f4f3fb3d9397741889131...fde605eb18e528c4d44aac4d77cb01000a2a6872,2,80,0,80,8,2014-09-11 21:52:11,2014-09-11 21:51:54
fde605eb18e528c4d44aac4d77cb01000a2a6872...c1d6c9aded933f9a340899cd72b4d19e157501b3,2,28,17,45,7,2014-09-11 21:55:36,2014-09-11 21:52:57
c1d6c9aded933f9a340899cd72b4d19e157501b3...f564bcec0f6d03ef94c28dbafa7a2b1cab1b217f,1,5,1,6,1,2014-09-11 22:11:29,2014-09-11 22:11:08
f564bcec0f6d03ef94c28dbafa7a2b1cab1b217f...824098a08123505f8657130f22e95fb3ac6d4035,2,1,9,10,5,2014-09-11 22:14:41,2014-09-11 22:14:41
824098a08123505f8657130f22e95fb3ac6d4035...5067f472696ced8dd77c3089d3726c642a918967,1,1,1,2,1,2014-09-11 22:17:03,2014-09-11 22:16:53
5067f472696ced8dd77c3089d3726c642a918967...88bf4ce81083472fdb4a91e78e8b8d4746f57f46,1,7,1,8,4,2014-09-11 22:30:39,2014-09-11 22:30:39
88bf4ce81083472fdb4a91e78e8b8d4746f57f46...dcf3539f7ddb99bce869379e35d38a9b5c8bbba6,1,0,19,19,1,2014-09-11 22:31:02,2014-09-11 22:31:02
dcf3539f7ddb99bce869379e35d38a9b5c8bbba6...2c34dd70da4eeea4743469d9684aa24dab5e78b2,1,12,4,16,5,2014-09-11 22:31:29,2014-09-11 22:31:29
2c34dd70da4eeea4743469d9684aa24dab5e78b2...b1d04b7d0680b70ab97542699df8c30f628d90ed,1,1,1,2,1,2014-09-11 22:50:30,2014-09-11 22:50:30
b1d04b7d0680b70ab97542699df8c30f628d90ed...5fae8faeb06259c96566469ef14e181c78cea07b,2,2,2,4,2,2014-09-11 22:53:32,2014-09-11 22:53:32
5fae8faeb06259c96566469ef14e181c78cea07b...81fd7d63542c3836bb020993720a5eb7df0ace5b,1,1,1,2,1,2014-09-11 23:12:29,2014-09-11 23:12:29
81fd7d63542c3836bb020993720a5eb7df0ace5b...2c4a10921a60e68e7dfed4d9bb653d5e0edf7ede,1,5,5,10,3,2014-09-11 23:14:10,2014-09-11 23:13:37
2c4a10921a60e68e7dfed4d9bb653d5e0edf7ede...dedf0f83fddc19203fcd0fa5ba222fc28fed1267,1,2,2,4,2,2014-09-11 23:19:37,2014-09-11 23:18:33
dedf0f83fddc19203fcd0fa5ba222fc28fed1267...e37c9534130d2cb58f8aa3b9cf0f79081f9ef3d1,1,2,1,3,1,2014-09-11 23:38:30,2014-09-11 23:38:30
e37c9534130d2cb58f8aa3b9cf0f79081f9ef3d1...5dca0bb99a1586afed209aeff4422451c1034239,2,21,18,39,6,2014-09-11 23:43:02,2014-09-11 23:37:12
5dca0bb99a1586afed209aeff4422451c1034239...d36909a4893d8c87e0a90e3bd98f102c44df7890,5,5,6,11,6,2014-09-12 00:35:06,2014-09-12 00:35:06
d36909a4893d8c87e0a90e3bd98f102c44df7890...10587fb5ae7d12754c2e2ea877403cf95f747ff3,1,3,1,4,2,2014-09-12 00:45:12,2014-09-12 00:44:53
10587fb5ae7d12754c2e2ea877403cf95f747ff3...7a459a3cc8b5b7bc16bfd66a03d4329f543270c5,2,2,2,4,2,2014-09-12 00:56:53,2014-09-12 00:56:53
7a459a3cc8b5b7bc16bfd66a03d4329f543270c5...1ac14fe616a1418af8f1168a45065cdb34a278e9,1,1,1,2,1,2014-09-12 00:58:28,2014-09-12 00:58:28
1ac14fe616a1418af8f1168a45065cdb34a278e9...5a5abaca0f1386e1e1b83e923d516fcb3e53e2bf,1,2,1,3,1,2014-09-12 18:18:35,2014-09-12 18:18:35
5a5abaca0f1386e1e1b83e923d516fcb3e53e2bf...7b09674fb4fc3a9ee5210acca181245c31e9e24a,1,6,1,7,1,2014-09-12 20:14:38,2014-09-12 20:14:38
7b09674fb4fc3a9ee5210acca181245c31e9e24a...549a13a690dbf486f5ceaef87c8b57aa7e84c215,1,1,2,3,2,2014-09-14 16:07:31,2014-09-14 16:07:21
549a13a690dbf486f5ceaef87c8b57aa7e84c215...fc01e11e5f590cac73cc73f89387c5b1b600151f,1,19,4,23,1,2014-09-14 16:16:00,2014-09-14 16:16:00
fc01e11e5f590cac73cc73f89387c5b1b600151f...68e08d0a387df917ea3637dc837672e6657631b3,1,5,5,10,3,2014-09-15 03:31:43,2014-09-15 03:31:43
accbd29b080529b80fe1861090667780ed9894d7...36db11a63d4def984b9ed5845ded6411701935ba,1,1,1,2,1,2014-09-09 15:12:29,2014-09-09 15:12:29
36db11a63d4def984b9ed5845ded6411701935ba...742603f9499b89d068e2e52e2f9da5cb3fa7a717,1,10,2,12,2,2014-09-09 15:19:15,2014-09-09 15:19:15
742603f9499b89d068e2e52e2f9da5cb3fa7a717...452da56297390cbc37d8c2a810ff097fee61ba08,1,8,2,10,2,2014-09-09 15:51:50,2014-09-09 15:23:17
452da56297390cbc37d8c2a810ff097fee61ba08...801b9648155e7aa3f9c7787328d35a95e881f312,1,26,0,26,2,2014-09-09 19:34:07,2014-09-09 19:34:07
801b9648155e7aa3f9c7787328d35a95e881f312...d7824753580f323c483cd7c9960fa415d8c0f9ae,1,1,1,2,1,2014-09-09 19:35:05,2014-09-09 19:35:05
d7824753580f323c483cd7c9960fa415d8c0f9ae...5a5888ec52036054c71dbdc3939f655239a9fe9c,1,8,5,13,2,2014-09-09 19:55:16,2014-09-09 19:55:16
5a5888ec52036054c71dbdc3939f655239a9fe9c...1103261918c51d7e14ab0b5575713d1cf6aa2dd1,1,6,3,9,1,2014-09-09 19:59:42,2014-09-09 19:59:42
1103261918c51d7e14ab0b5575713d1cf6aa2dd1...2fc07ee80194944e00ee01aec4cf497ba4fb082e,1,3,3,6,2,2014-09-09 20:02:32,2014-09-09 20:02:32
2fc07ee80194944e00ee01aec4cf497ba4fb082e...a1ec61dec01e6efa20ed1c792fe48dd72d83c130,1,1,2,3,2,2014-09-09 20:06:58,2014-09-09 20:06:58
a1ec61dec01e6efa20ed1c792fe48dd72d83c130...ffc69aa0105c329c62e88a2d1d1ece4d00618775,1,9,0,9,1,2014-09-09 20:17:53,2014-09-09 20:17:53
ffc69aa0105c329c62e88a2d1d1ece4d00618775...8c1b8154fe3bc30af69918d89e481c76a23304f1,1,3,0,3,1,2014-09-09 20:58:37,2014-09-09 20:58:37
8c1b8154fe3bc30af69918d89e481c76a23304f1...04e5bc700c3dee7fe5a5229c3137a7f552e7f475,1,1,1,2,1,2014-09-09 20:58:54,2014-09-09 20:58:54
04e5bc700c3dee7fe5a5229c3137a7f552e7f475...b504fa8afaaff5020b1ddba5203377d95feafa78,1,9,0,9,2,2014-09-09 20:59:10,2014-09-09 20:59:10
402f4f656c481088394e68654ac2b8475225090a...debb13fdb66ce1ba1b0eac77851ae04c8843cd05,6,494,441,935,72,2014-09-06 01:21:24,2014-09-06 01:21:24
c080a59b3db816b8eef77a2d7bafbff780c2e4b5...6f72a3c64927a2698f38eea6acae78912c1c175f,1,4,4,8,3,2014-08-28 19:04:27,2014-08-28 19:02:53
c080a59b3db816b8eef77a2d7bafbff780c2e4b5...3d10208869a65e21fd23519817ee3a8f0509e496,1,2,1,3,1,2014-08-28 18:38:00,2014-08-28 18:35:26
3d10208869a65e21fd23519817ee3a8f0509e496...ab5432a99e858fe0bd1d82f09c2c1ac51b819138,1,1,1,2,1,2014-08-28 18:40:47,2014-08-28 18:40:33
52db2174a51487c06241e0ecef22e562586f49d3...be8c503760fe3590904ab331a259641bbfa73d2e,24,85,76,161,10,2014-08-28 18:14:40,2014-08-28 18:14:40
be8c503760fe3590904ab331a259641bbfa73d2e...d3d7f0478f8cc8f78007c6db7eba27f7d67afb40,15,15,15,30,15,2014-08-28 18:32:24,2014-08-28 18:32:24
d3d7f0478f8cc8f78007c6db7eba27f7d67afb40...d1c0004060250dae8914fc90996b398b31e89e32,1,2,2,4,1,2014-08-28 18:45:40,2014-08-28 18:45:40
52db2174a51487c06241e0ecef22e562586f49d3...40b9b80cf42b79a53b0bc11c820e095cd7c4ef53,1,1,1,2,1,2014-08-28 17:36:08,2014-08-28 17:35:40
40b9b80cf42b79a53b0bc11c820e095cd7c4ef53...34231601cc9ef72cb8395b2a804edd3bac2f54ae,1,4,4,8,3,2014-08-28 19:02:53,2014-08-28 19:02:53
a81fbf483efa4f40ea2d382f0c7275d408536e96...546b969e9a61f65552431b76b0d0af74864d3530,1,33,7,40,4,2014-08-28 22:44:14,2014-08-28 22:44:14
546b969e9a61f65552431b76b0d0af74864d3530...29811f2255614b57e535f6d2ad23fa8eec3731df,1,12,12,24,8,2014-08-29 17:38:01,2014-08-29 17:38:01
a81fbf483efa4f40ea2d382f0c7275d408536e96...c5a643c9f04b423fdbacb8c57b0ed7ee467eccf6,1,9,0,9,1,2014-08-28 16:09:46,2014-08-28 16:09:46
c5a643c9f04b423fdbacb8c57b0ed7ee467eccf6...24ea12b1e182dc3e269994b5ac9a6cde3985fa50,2,15,2,17,3,2014-08-28 16:16:31,2014-08-28 16:16:31
24ea12b1e182dc3e269994b5ac9a6cde3985fa50...b9e357bc8f1c9a4a649a54bfaf8f2a977e18806e,1,7,8,15,1,2014-08-28 16:21:26,2014-08-28 16:21:26
b9e357bc8f1c9a4a649a54bfaf8f2a977e18806e...c1f081d2b12a4863f93ead64333d670e44e9b99f,1,34,0,34,1,2014-08-28 18:16:57,2014-08-28 18:16:57
a81fbf483efa4f40ea2d382f0c7275d408536e96...3f6ad09361cbb233b591dcde5c2fd74326f74d13,1,1,1,2,1,2014-08-28 16:03:34,2014-08-28 16:03:03
611298fb50554b81a1889314ce8745b0b12b2f9d...ab6b92fd66f8daddad88c981120238afdf81abf1,11,0,179,179,11,2014-08-29 22:22:12,2014-08-29 22:21:50
611298fb50554b81a1889314ce8745b0b12b2f9d...65b8cc98821bd8c80e215523c8148f9ac0ff0574,11,0,179,179,11,2014-08-29 22:21:50,2014-08-29 22:21:50
65b8cc98821bd8c80e215523c8148f9ac0ff0574...71aeda7606cd34cec5c52918f1e80e0e8b546e6b,1,4,0,4,1,2014-09-02 17:16:27,2014-09-02 17:16:27
71aeda7606cd34cec5c52918f1e80e0e8b546e6b...8cc0eb623c032c1257ecb6008b285fc0283a4ca9,2,2,2,4,1,2014-09-02 17:35:21,2014-09-02 17:34:38
611298fb50554b81a1889314ce8745b0b12b2f9d...08249e079720eb16c1950f47a2ef8f69221e9df1,2,11,9,20,8,2014-08-29 22:17:49,2014-08-29 22:17:49
08249e079720eb16c1950f47a2ef8f69221e9df1...dd024fa690f66416b2f31b3af7eaf9401a2f915f,1,6,6,12,5,2014-08-29 22:27:12,2014-08-29 22:27:12
dd024fa690f66416b2f31b3af7eaf9401a2f915f...a9d544ec6b6981a88d1d90097271e8086116b631,2,5,4,9,3,2014-08-29 22:35:56,2014-08-29 22:35:56
a9d544ec6b6981a88d1d90097271e8086116b631...96cfa5a7bdda1b8f9c3dc3514755389781c34c0b,1,0,1,1,1,2014-08-29 22:36:53,2014-08-29 22:36:53
96cfa5a7bdda1b8f9c3dc3514755389781c34c0b...d18923d26e9419eb41067fc935ffee671dc6b722,1,1,1,2,1,2014-08-29 22:59:49,2014-08-29 22:59:49
d18923d26e9419eb41067fc935ffee671dc6b722...6e17faa5a7dcecf3e071890fb708242c36c60f99,2,31,20,51,10,2014-08-29 23:10:14,2014-08-29 23:10:14
77735628def01dd1e8e2cf42e4975ca358ec6aa7...97007f24414085a4507d5fbad12d3e8088e24d5f,1,17,0,17,1,2014-08-12 20:56:25,2014-08-12 20:46:11
97007f24414085a4507d5fbad12d3e8088e24d5f...c889dfdc76daad2d42cc7469fc35033cdf1fcc6a,1,23,8,31,2,2014-08-13 00:17:41,2014-08-13 00:17:41
c889dfdc76daad2d42cc7469fc35033cdf1fcc6a...3f04a82ea44af1aef860d960536fbab2002cea44,1,1,0,1,1,2014-08-13 00:24:51,2014-08-13 00:24:51
3f04a82ea44af1aef860d960536fbab2002cea44...32ae280f22ab030f48808cf1ec9e8ca28f5375b2,1,1,1,2,1,2014-08-13 21:29:34,2014-08-13 21:29:34
32ae280f22ab030f48808cf1ec9e8ca28f5375b2...0ed5ba1ed9269af69dc360ada85bdfcd5d77790a,1,1,1,2,1,2014-08-13 23:08:43,2014-08-13 23:08:43
77735628def01dd1e8e2cf42e4975ca358ec6aa7...f5263689cfbcc65034abb66b29e687ed23f6a588,1,2,1,3,1,2014-08-12 18:52:44,2014-08-12 18:52:44
f5263689cfbcc65034abb66b29e687ed23f6a588...1902bcf88568e033371d3958f045a119548524ac,1,9,1,10,2,2014-08-12 19:07:53,2014-08-12 19:07:53
1902bcf88568e033371d3958f045a119548524ac...1caeb96d87669cdc86936b51244f32560ce99108,1,33,19,52,3,2014-08-12 21:27:16,2014-08-12 21:27:16
1caeb96d87669cdc86936b51244f32560ce99108...a6efccf515b1be9db602703ed0d2f39dcc963f27,2,5,5,10,5,2014-08-12 21:30:20,2014-08-12 21:30:20
a6efccf515b1be9db602703ed0d2f39dcc963f27...bd9aeef429ce976fab884aea6c2f11beb155b917,1,21,17,38,3,2014-08-12 21:39:43,2014-08-12 21:39:43
bd9aeef429ce976fab884aea6c2f11beb155b917...468f299c69adbdc9158b9bc4d2f13fd37ba9cb2c,1,2,2,4,2,2014-08-12 21:44:18,2014-08-12 21:44:18
468f299c69adbdc9158b9bc4d2f13fd37ba9cb2c...53f6e0890f7a8b41d75dce0b430cbc1e3ee88eac,1,8,1,9,3,2014-08-12 22:23:27,2014-08-12 22:23:27
53f6e0890f7a8b41d75dce0b430cbc1e3ee88eac...3930b9c26fe6102257675d6355704a14f8731b77,1,1,1,2,1,2014-08-12 22:26:02,2014-08-12 22:26:02
3930b9c26fe6102257675d6355704a14f8731b77...89b530db99da8ca643bcbb67e8c1f8c99505d1f7,2,10,0,10,2,2014-08-12 22:47:55,2014-08-12 22:47:55
89b530db99da8ca643bcbb67e8c1f8c99505d1f7...221a9b1bcb751081a68d8479a6e8e3cb404c9eab,1,1,1,2,1,2014-08-12 22:50:09,2014-08-12 22:50:09
221a9b1bcb751081a68d8479a6e8e3cb404c9eab...0cf7aad90fdb15fca89897dfc7b23dd82d4c5ff0,1,1,1,2,1,2014-08-13 00:12:19,2014-08-13 00:12:19
0cf7aad90fdb15fca89897dfc7b23dd82d4c5ff0...93e923e8d0f2c8f005d5e2270f2da2959bd7cc7b,1,3,1,4,1,2014-08-13 00:29:14,2014-08-13 00:29:14
93e923e8d0f2c8f005d5e2270f2da2959bd7cc7b...565468e04252e4a8caaf82454bb139d3704c742a,1,49,51,100,22,2014-08-13 00:31:37,2014-08-13 00:31:37
565468e04252e4a8caaf82454bb139d3704c742a...b391aca855aee8e073895192dd4d9e4836fb2308,1,3,3,6,1,2014-08-13 00:52:41,2014-08-13 00:52:41
b391aca855aee8e073895192dd4d9e4836fb2308...c47996b35c1ac40ebb47634600a146aa9a1e9b2f,1,1,1,2,1,2014-08-13 00:53:50,2014-08-13 00:53:50
c47996b35c1ac40ebb47634600a146aa9a1e9b2f...35f966285abfb06b097ad53cdd36cf7d8bdeb675,1,1,1,2,1,2014-08-13 01:08:39,2014-08-13 01:08:39
35f966285abfb06b097ad53cdd36cf7d8bdeb675...ff7e7bb93f660f19e42ffa8825a661d0a113790b,1,1,1,2,1,2014-08-13 21:10:03,2014-08-13 21:10:03
ff7e7bb93f660f19e42ffa8825a661d0a113790b...67f564827b30a31f04c37bc04adb62e3845f94f2,1,1,1,2,1,2014-08-13 21:11:00,2014-08-13 21:11:00
98b2885e853139ab64eddec00b7700313cca331b...328ecb4d9830e4d7201ad591a5fe93164c711a62,3,18,4,22,6,2014-08-15 18:27:22,2014-08-15 18:27:16
328ecb4d9830e4d7201ad591a5fe93164c711a62...c2cf67179f56e73bc2084a80ec632edd0876545a,1,2,1,3,1,2014-08-15 18:50:31,2014-08-15 18:48:51
c2cf67179f56e73bc2084a80ec632edd0876545a...c3f76886639d5450b41d86201dc5077e26e107ba,1,2,0,2,1,2014-08-15 19:01:25,2014-08-15 19:01:20
c3f76886639d5450b41d86201dc5077e26e107ba...c708cd681372aa05e8ad78df9d89249272bd07e9,2,4,3,7,3,2014-08-15 19:11:42,2014-08-15 15:08:41
c708cd681372aa05e8ad78df9d89249272bd07e9...5dc428a9157b39bdb47540ae1f680ba819725cd8,1,15,2,17,2,2014-08-15 19:11:42,2014-08-15 19:10:26
5dc428a9157b39bdb47540ae1f680ba819725cd8...bc6239dfc198efbba60e4702793b59ceeaed2dee,19,19,19,38,19,2014-08-15 19:34:47,2014-08-15 19:24:06
bc6239dfc198efbba60e4702793b59ceeaed2dee...da08cc421e669d6fb1e04f427fb1e3c8abe4f79c,2,4,7,11,4,2014-08-15 22:59:14,2014-08-15 22:57:53
da08cc421e669d6fb1e04f427fb1e3c8abe4f79c...67aee54c6a5b3bbcca767a04afc183c9c3265fe1,2,2,4,6,4,2014-08-15 23:30:56,2014-08-15 23:30:56
67aee54c6a5b3bbcca767a04afc183c9c3265fe1...7e44526ab903db58e0e9783607cc9a07e6d05041,2,64,0,64,2,2014-08-16 00:12:46,2014-08-16 00:12:29
7e44526ab903db58e0e9783607cc9a07e6d05041...66ea15a9f3ee6ed56653f009f48ea827bfbea53e,2,36,1,37,4,2014-08-16 00:53:07,2014-08-16 00:52:03
66ea15a9f3ee6ed56653f009f48ea827bfbea53e...45de1ee51bd0a77dabe2386c2b472413f66ce560,1,8,2,10,2,2014-08-16 04:41:11,2014-08-16 04:41:11
45de1ee51bd0a77dabe2386c2b472413f66ce560...e06c091652aa9176e8604ec1ade7f919f921534a,1,8,5,13,2,2014-08-16 04:46:13,2014-08-16 04:46:13
e06c091652aa9176e8604ec1ade7f919f921534a...f39a820d961eb10c2d8a552a8c4c2cef95735c5e,4,38,10,48,10,2014-08-16 05:12:04,2014-08-16 05:12:04
f39a820d961eb10c2d8a552a8c4c2cef95735c5e...56f96cc6df2685e6eb2d2fbb036be6affcabf7d1,3,100,22,122,7,2014-08-16 05:42:09,2014-08-16 05:42:09
56f96cc6df2685e6eb2d2fbb036be6affcabf7d1...1e384092c3626fcddf5c2e3f00f5d06612c80181,1,1,1,2,1,2014-08-16 17:03:32,2014-08-16 08:42:28
1e384092c3626fcddf5c2e3f00f5d06612c80181...eb0626a0a7654241870d8f948bdde64f197a5831,1,1,1,2,1,2014-08-16 17:04:00,2014-08-16 17:02:39
eb0626a0a7654241870d8f948bdde64f197a5831...04ba193ee43d9678914c538d6fc3a2d302104e6b,1,1,0,1,1,2014-08-16 17:23:18,2014-08-16 17:08:14
04ba193ee43d9678914c538d6fc3a2d302104e6b...149fbe942cac7a0fb2e3eb721e51dc8b3af8ad6f,1,1,1,2,1,2014-08-16 17:23:35,2014-08-16 17:23:35
149fbe942cac7a0fb2e3eb721e51dc8b3af8ad6f...0c9d5337aaa4e0d4c455bc4fa1a75db6367c0596,1,2,2,4,2,2014-08-16 18:04:43,2014-08-16 18:03:37
0c9d5337aaa4e0d4c455bc4fa1a75db6367c0596...7981f17af16eb4756f96c3a364dc1ca51573f92f,1,37,5,42,4,2014-08-16 18:04:43,2014-08-16 18:03:57
7981f17af16eb4756f96c3a364dc1ca51573f92f...b5715a96210121c2d1a1642e3140612e18e4681a,1,3,3,6,3,2014-08-16 18:21:45,2014-08-16 18:21:45
b5715a96210121c2d1a1642e3140612e18e4681a...8a262adc975969b5fe77e0d90dd57cd29c4d7c91,1,10,3,13,2,2014-08-16 23:07:28,2014-08-16 23:07:28
8a262adc975969b5fe77e0d90dd57cd29c4d7c91...e897539adbdd04432f9853284a5f5731aed9994f,1,7,0,7,1,2014-08-17 03:39:24,2014-08-17 03:39:08
98b2885e853139ab64eddec00b7700313cca331b...a9250b0c98f67d9baa2ba47f27dde6c439766cfe,2,4,3,7,3,2014-08-15 15:08:41,2014-08-15 15:08:41
a4c0c417aaed21e218b1c9f16d09903f8cd3e0fd...d28c01b22cbae6b8b8ea12d7df031162a67d03c4,1,4,0,4,1,2014-08-19 02:28:42,2014-08-19 02:28:42
d28c01b22cbae6b8b8ea12d7df031162a67d03c4...2fdfc1f9c25e62f9a3fd5aa177802c4662b4b75f,2,6,4,10,4,2014-08-19 02:59:57,2014-08-19 02:59:57
2fdfc1f9c25e62f9a3fd5aa177802c4662b4b75f...88150834c76f2ca37c3f0c9d62b492417416a85f,1,0,2,2,1,2014-08-19 06:16:46,2014-08-19 06:16:46
88150834c76f2ca37c3f0c9d62b492417416a85f...2d98dcdf4d205d6c9b692f2083f2aa7817738847,1,2,30,32,4,2014-08-19 17:48:06,2014-08-19 17:48:06
2d98dcdf4d205d6c9b692f2083f2aa7817738847...fbc6d4cdab08a4dbbaf77c125482f25a98f98bf8,2,150,88,238,29,2014-08-20 05:03:06,2014-08-20 05:03:06
fbc6d4cdab08a4dbbaf77c125482f25a98f98bf8...6b4a8339db33e0832915e637e5d7ccf2c5ab1b1b,1,1,1,2,2,2014-08-20 05:15:58,2014-08-20 05:15:58
6b4a8339db33e0832915e637e5d7ccf2c5ab1b1b...9c113ddb79ef63e1a317373e36c2f731940417ce,2,4,3,7,3,2014-08-20 05:47:53,2014-08-20 05:47:53
9c113ddb79ef63e1a317373e36c2f731940417ce...ee5b1d42e04953491bd19a6541c77ca01aca5886,1,1,1,2,1,2014-08-20 05:55:01,2014-08-20 05:55:01
ee5b1d42e04953491bd19a6541c77ca01aca5886...8907c2349d1db649e90ce8863ab70eb9af5b1ba8,4,21,2,23,4,2014-08-20 07:40:17,2014-08-20 07:40:17
8907c2349d1db649e90ce8863ab70eb9af5b1ba8...0f9239b6054798e6bba38738417af6a92404be6c,1,1,0,1,1,2014-08-20 07:41:29,2014-08-20 07:41:29
0f9239b6054798e6bba38738417af6a92404be6c...1b96d8a8c3f3fa28a42cd71cf8a4f370943e645f,1,1,1,2,1,2014-08-20 07:43:59,2014-08-20 07:43:59
1b96d8a8c3f3fa28a42cd71cf8a4f370943e645f...88ed2422a61a1dc5f949a695010c8000de678ca3,3,34,20,54,14,2014-08-20 08:23:38,2014-08-20 08:23:38
88ed2422a61a1dc5f949a695010c8000de678ca3...a9f5287744b0ddabad74c4b1e603305660440b72,1,0,1,1,1,2014-08-20 08:27:09,2014-08-20 08:27:09
a9f5287744b0ddabad74c4b1e603305660440b72...b1abfb4072d331ff381a5da538048c50d1d1ad8f,1,32,35,67,13,2014-08-20 17:44:18,2014-08-20 17:44:18
b1abfb4072d331ff381a5da538048c50d1d1ad8f...3e1eb1e438e3481e1fc4ee1366d7d80c0dbbf9bc,2,13,49,62,3,2014-08-20 17:54:00,2014-08-20 17:54:00
3e1eb1e438e3481e1fc4ee1366d7d80c0dbbf9bc...af20c5b7751ee6fec27fb9cd0b97c287010c8fef,1,5,11,16,6,2014-08-20 18:08:25,2014-08-20 18:08:25
af20c5b7751ee6fec27fb9cd0b97c287010c8fef...524363e38c06ea9b963e075f941f49f7696d432f,2,16,8,24,7,2014-08-20 18:08:48,2014-08-20 18:08:48
524363e38c06ea9b963e075f941f49f7696d432f...800eea7b9f16c375374eefc2e07b10c77710202c,2,10,13,23,4,2014-08-20 18:34:37,2014-08-20 18:34:37
800eea7b9f16c375374eefc2e07b10c77710202c...a521f28eb8f08b0b20421e978246d3723e1b640e,1,3,3,6,1,2014-08-20 20:16:33,2014-08-20 20:16:33
a521f28eb8f08b0b20421e978246d3723e1b640e...654c7b4bc88b801fda446ee76e9d0b72205a1a8f,1,7,0,7,1,2014-08-20 20:20:17,2014-08-20 20:20:17
8e005cadd397c30e03fbd9bea22c599fa40ccf72...effd3c1524bffc72160dcd325622e2303e744372,3,21,60,81,13,2014-07-18 23:07:02,2014-06-19 21:15:34
effd3c1524bffc72160dcd325622e2303e744372...99bef77c9b5ebb48c3b3b85005c7f2473b4730df,1,10,0,10,1,2014-07-18 23:10:33,2014-07-18 23:10:33
8e005cadd397c30e03fbd9bea22c599fa40ccf72...0ba651a79bd35574151b4ff1e4e4bf9b8f20fe02,1,8,6,14,2,2014-07-18 02:10:54,2014-07-18 02:10:54
0ba651a79bd35574151b4ff1e4e4bf9b8f20fe02...d3d3e129ed0b68278fabb26e19eaee0afba540c8,1,62,0,62,2,2014-07-18 17:09:50,2014-07-18 17:09:50
d3d3e129ed0b68278fabb26e19eaee0afba540c8...c287a6b3ab0907fb690be63bb1ab0002a2157870,2,4,0,4,3,2014-07-18 17:22:49,2014-07-18 17:22:49
c287a6b3ab0907fb690be63bb1ab0002a2157870...2c76a9e8868e03930a2abfebf073b70a644beb42,1,4,1,5,1,2014-07-18 23:25:33,2014-07-18 23:25:33
2c76a9e8868e03930a2abfebf073b70a644beb42...7ba1d231938e4e981ef5030c08d1cfdbd1a14cb6,1,4,5,9,3,2014-07-18 23:46:16,2014-07-18 23:46:16
7ba1d231938e4e981ef5030c08d1cfdbd1a14cb6...105c7686280deea8264852fc9bec07d1b9b15e96,1,4,0,4,1,2014-07-19 00:10:29,2014-07-19 00:10:29
105c7686280deea8264852fc9bec07d1b9b15e96...c52ca68ea2e73af261034a36ee91322132a542c1,1,6,2,8,3,2014-07-20 00:04:29,2014-07-20 00:04:29
c52ca68ea2e73af261034a36ee91322132a542c1...d3eae5a2e8166c0108e536595c20aa7d70ad35bc,1,0,1,1,1,2014-07-21 04:16:33,2014-07-21 04:16:33
d3eae5a2e8166c0108e536595c20aa7d70ad35bc...78d08b5537235f63cb40e538952568dd3e892ab6,2,18,49,67,3,2014-07-21 17:56:08,2014-07-21 17:50:32
78d08b5537235f63cb40e538952568dd3e892ab6...9c37a006539c29d757794b3305c20aedd03103a2,1,0,4,4,1,2014-07-21 18:07:13,2014-07-21 18:07:13
9c37a006539c29d757794b3305c20aedd03103a2...f0fd348afeb771deb5d8801282884bab47499941,1,26,1,27,2,2014-07-25 01:30:43,2014-07-25 01:30:43
f0fd348afeb771deb5d8801282884bab47499941...fa28ac2cbc57a77b0fdd65a5e1f7db207974f406,1,3,0,3,1,2014-07-25 01:34:34,2014-07-25 01:34:34
d136d3a41a1fe986fcaca3246d6987e9bd08b66c...d7e4a1001553b0f2c032995b4719bfffac7302dc,1,14,1,15,2,2014-07-02 23:47:17,2014-07-01 22:16:18
d7e4a1001553b0f2c032995b4719bfffac7302dc...22c6d152e6f57380a02d3d84d4c67d342b4900d2,1,1,8,9,2,2014-07-02 23:47:17,2014-07-02 23:47:07
22c6d152e6f57380a02d3d84d4c67d342b4900d2...d8d1d1b41f76b1bc2cadbca757c1a797dd633967,2,44,1,45,2,2014-07-03 04:48:19,2014-07-03 04:48:07
d8d1d1b41f76b1bc2cadbca757c1a797dd633967...ff68931a511fd1cd07ac1dcecbf8535738fea004,3,17,15,32,8,2014-07-03 21:18:55,2014-07-02 18:08:15
ff68931a511fd1cd07ac1dcecbf8535738fea004...7e103cd2edb153785001f083af5a65c4455bec4b,1,5,1,6,2,2014-07-03 22:03:25,2014-07-03 22:03:25
d136d3a41a1fe986fcaca3246d6987e9bd08b66c...8fd64fefeefe84986dabe2ca284a45f38df0e5da,4,60,87,147,14,2014-07-02 02:49:43,2014-07-02 02:46:20
830aa7036c39aa416307042029f60933bc22a047...6300a723818b107464a9223b3f8b5e27bb626504,1,1,2,3,2,2014-01-27 22:02:01,2013-12-07 20:39:32
6300a723818b107464a9223b3f8b5e27bb626504...30374854f08924480f9ece16f0ab788d4ec9cc64,1,4574,4225,8799,776,2014-01-27 22:08:22,2013-08-27 05:38:06
30374854f08924480f9ece16f0ab788d4ec9cc64...b71d938f9de3f02e7dba7c79f6aea97e010105fe,1,4,0,4,1,2014-01-27 22:09:21,2014-01-27 22:09:21
b71d938f9de3f02e7dba7c79f6aea97e010105fe...91c4d3d8a2a50b6476dd026505da96e6485988ba,1,2,1,3,1,2014-01-27 22:15:53,2013-12-17 00:03:48
91c4d3d8a2a50b6476dd026505da96e6485988ba...f8f94c711841bb2b751b0f508f975f057349ba46,1,2,2,4,1,2014-01-27 22:15:53,2013-12-17 00:23:13
f8f94c711841bb2b751b0f508f975f057349ba46...3104ddb6e51794754cbce48b0c2be62bb073d0a9,1,1,1,2,1,2014-01-27 22:17:31,2014-01-27 22:17:31
3104ddb6e51794754cbce48b0c2be62bb073d0a9...c5e90053f29f209dbfe381622d980bcb107a5464,1,2,1,3,1,2014-01-27 23:22:55,2014-01-27 23:22:55
423ae65d93c184c677d4653a4ae90fa1df3daa6f...32ad71e50e5406fa3553e6185cb3deb77fde8e3d,1,24,10,34,5,2014-02-20 00:24:16,2014-02-19 23:15:30
aa7b89db792f5b730a2dc01face2294f19c0eea3...8f2a0abe313bd68c6a70ba0c42c1f7d40e05db12,1,1,2,3,1,2014-02-21 18:09:11,2014-02-21 18:09:11
8f2a0abe313bd68c6a70ba0c42c1f7d40e05db12...222ac4ca65703ad17bffae4b079d4dc705fd6a00,2,2,0,2,2,2014-02-21 18:22:03,2014-02-21 18:22:03
222ac4ca65703ad17bffae4b079d4dc705fd6a00...e04d3f36d218a74afc94b8b8e7ef4718e607f768,2,3,3,6,2,2014-02-21 19:39:37,2014-02-21 19:39:37
e04d3f36d218a74afc94b8b8e7ef4718e607f768...1528f1c92275d3cb5a3322a6e24d553775ed34f7,5,5,5,10,5,2014-02-21 19:49:36,2014-02-21 19:49:36
1528f1c92275d3cb5a3322a6e24d553775ed34f7...203917df1e22686d476400b58ed065361a83de41,1,1,1,2,1,2014-02-21 22:50:44,2014-02-21 22:50:44
203917df1e22686d476400b58ed065361a83de41...3cd00c89af91171a8ec52d26de060af3a8cff807,3,23,1,24,5,2014-02-21 23:00:33,2014-02-21 23:00:33
3cd00c89af91171a8ec52d26de060af3a8cff807...cde758c7ef9a10fe41b04f4840ac8110c71e529e,1,1,1,2,1,2014-02-21 23:26:52,2014-02-21 23:26:33
cde758c7ef9a10fe41b04f4840ac8110c71e529e...27e5b772495fd22872194f02bb51303692df9c54,6,6,6,12,6,2014-02-21 23:54:04,2014-02-21 23:54:04
27e5b772495fd22872194f02bb51303692df9c54...dd7fb37a406b27bc1cee101699c6171e1a339377,1,3,0,3,1,2014-02-22 01:34:35,2014-02-22 01:34:24
dd7fb37a406b27bc1cee101699c6171e1a339377...e7a0db4a7226bebbde3a3edab369d044ff9f5c7c,1,3,3,6,1,2014-02-22 06:18:38,2014-02-22 06:18:29
e7a0db4a7226bebbde3a3edab369d044ff9f5c7c...99386b07c85e29fd7a4c339e61355df58383d399,1,113,97,210,17,2014-02-22 07:06:58,2014-02-22 07:06:58
99386b07c85e29fd7a4c339e61355df58383d399...22db047be7aaa0cb8705ca236da5d75cc4717920,2,15,0,15,4,2014-02-22 07:19:13,2014-02-22 07:19:13
22db047be7aaa0cb8705ca236da5d75cc4717920...bbc8fe2809a2548647c88afb6ec76f39e1307a5c,1,5,4,9,3,2014-02-22 21:27:41,2014-02-22 21:27:41
bbc8fe2809a2548647c88afb6ec76f39e1307a5c...d6f04ba5dd4d34691af2be1db1f74093b43f84c6,1,2,1,3,2,2014-02-23 01:45:24,2014-02-23 01:45:24
d6f04ba5dd4d34691af2be1db1f74093b43f84c6...fecc24627124dbafc49ae2068cdc3b68bbdce239,1,143,1,144,7,2014-02-23 22:10:48,2014-02-23 22:10:48
fecc24627124dbafc49ae2068cdc3b68bbdce239...afcd1ae5a5746887c6f130936397c50ab07e68c6,1,1,1,2,1,2014-02-24 00:39:58,2014-02-24 00:39:58
afcd1ae5a5746887c6f130936397c50ab07e68c6...9e8a1f2771a56bc9e74b1e0dce2c33ad99ed309b,1,1,1,2,1,2014-02-24 00:40:41,2014-02-24 00:40:41
9e8a1f2771a56bc9e74b1e0dce2c33ad99ed309b...c75969e769d2ccb7e02054f29c6de36e339df042,2,74,65,139,35,2014-02-24 01:25:01,2014-02-24 01:25:01
c75969e769d2ccb7e02054f29c6de36e339df042...ff5d9f39727af88f1ac9ea30484404db3884aef3,1,60,59,119,16,2014-02-24 02:29:17,2014-02-24 02:29:17
ff5d9f39727af88f1ac9ea30484404db3884aef3...7a1c2f87bd6af1a509970b8eba2fea8559f1303c,1,1,1,2,1,2014-02-24 02:59:07,2014-02-24 02:59:07
7a1c2f87bd6af1a509970b8eba2fea8559f1303c...1e36f52a8bd3976ac6a2683e426f8ff90da5922a,1,1,1,2,1,2014-02-24 02:59:51,2014-02-24 02:59:51
1e36f52a8bd3976ac6a2683e426f8ff90da5922a...dd4741502711a88a7917739c8e6c16b0b1fa3e1c,2,10,1,11,2,2014-02-24 03:00:58,2014-02-24 02:59:58
dd4741502711a88a7917739c8e6c16b0b1fa3e1c...48cfc719efd7093ed3f7acd02cb093ef8e6bc5e4,1,1,1,2,1,2014-02-24 03:46:29,2014-02-24 03:46:29
48cfc719efd7093ed3f7acd02cb093ef8e6bc5e4...686996fb8186bcf944ca091a4d0cb3728be6c5ed,1,1,1,2,1,2014-02-24 04:51:10,2014-02-24 04:51:10
686996fb8186bcf944ca091a4d0cb3728be6c5ed...f8eec237a6d109503d9efbd28cff3bc52571f4f7,1,2,1,3,1,2014-02-24 20:42:51,2014-02-24 20:42:51
f8eec237a6d109503d9efbd28cff3bc52571f4f7...fabd6c6246c3f5b9951d4fc9501f031becbd9165,1,2,2,4,2,2014-02-24 21:42:14,2014-02-24 21:42:14
de6fb4276da05da6cb3b5920001a790d4c2b33d4...fd215633cc32498b7b189716c1fedac514d40ea4,2,4,4,8,4,2013-12-16 01:16:59,2013-12-13 00:43:12
fd215633cc32498b7b189716c1fedac514d40ea4...8b37c0084d18f47c50169464807b277e7b48b5f3,2,19,8,27,6,2013-12-16 01:17:09,2013-12-13 00:02:02
8b37c0084d18f47c50169464807b277e7b48b5f3...20e8e4241c68d526257515f9f83412d615df86d6,2,50,14,64,4,2013-12-16 01:17:17,2013-12-13 11:46:11
20e8e4241c68d526257515f9f83412d615df86d6...2f745bb52f010c487027406a621e76705878b525,1,25,3,28,5,2013-12-16 01:17:25,2013-12-12 08:38:20
2f745bb52f010c487027406a621e76705878b525...2991ac931221dc43b11444ebea189e854944628d,2,12,3,15,3,2013-12-16 01:17:33,2013-12-12 07:37:16
2991ac931221dc43b11444ebea189e854944628d...9dfa0ee95f98b792c3d8895ec8634aea6535a7d6,1,7,7,14,4,2013-12-16 01:17:41,2013-12-12 04:38:51
9dfa0ee95f98b792c3d8895ec8634aea6535a7d6...a6c8b5eef3f67b712fc010fb6b4def497b028573,2,3,4,7,2,2013-12-16 03:40:57,2013-12-16 03:40:57
a6c8b5eef3f67b712fc010fb6b4def497b028573...cce9d36dfaa3b50a894db4ed267a8ae2e5ba87a0,1,9,0,9,1,2013-12-17 01:42:49,2013-12-12 23:55:06
cce9d36dfaa3b50a894db4ed267a8ae2e5ba87a0...e042e5a85a0fb38b51637aee2715564272ec1fdc,1,24,13,37,6,2013-12-17 01:42:51,2013-12-16 23:14:43
e042e5a85a0fb38b51637aee2715564272ec1fdc...2859e30e60dd740d77e005d1df4b3815bef1231f,1,10,6,16,6,2013-12-17 04:25:48,2013-12-17 04:25:48
2859e30e60dd740d77e005d1df4b3815bef1231f...46fb7b6d214c089984a26be6c8558be2e0b0e4da,1,15,4,19,6,2013-12-17 04:40:34,2013-12-17 04:40:34
46fb7b6d214c089984a26be6c8558be2e0b0e4da...a0734bfe58970547781090ead70ff9bd914130df,2,7,3,10,3,2013-12-17 09:43:20,2013-12-17 09:42:49
a0734bfe58970547781090ead70ff9bd914130df...9cb6df57fb9537ce2cbee868efbb684772f56b98,1,3,2,5,1,2013-12-17 09:51:49,2013-12-17 09:51:49
9cb6df57fb9537ce2cbee868efbb684772f56b98...4771b7173446eec9c2fbb94ef8b5d5ca6437c2c3,2,2,2,4,2,2013-12-17 18:48:54,2013-12-17 18:48:54
4771b7173446eec9c2fbb94ef8b5d5ca6437c2c3...8bd400e56065b0f2d61e18dd220becb6a2bf7ac8,3,5,6,11,4,2013-12-17 18:54:33,2013-12-17 18:49:35
8bd400e56065b0f2d61e18dd220becb6a2bf7ac8...dbdab6a15657b15b8bd4d4af76d16c746c96051c,1,3,3,6,3,2013-12-17 19:00:07,2013-12-17 19:00:07
dbdab6a15657b15b8bd4d4af76d16c746c96051c...b6c7d424bc73456b64180d730272a9ed18562359,5,5,5,10,5,2013-12-17 19:08:19,2013-12-17 19:08:19
de6fb4276da05da6cb3b5920001a790d4c2b33d4...dbc405b5f72e94f8affa73c46775d602de8f5cc8,2,34,14,48,4,2013-12-13 11:46:11,2013-12-13 11:46:11
dbc405b5f72e94f8affa73c46775d602de8f5cc8...ed060c893f2f6e1669772dfa2a6c8f97b467a90a,1,22,6,28,2,2013-12-13 23:53:47,2013-12-13 23:53:47
f2e3481db3c50c7dd1384977981bbaf633bd0b47...6a9a797e83135026a11eed4cb80b2b47ea32d0a8,2,4,4,8,4,2013-12-13 17:40:25,2013-12-13 00:43:12
8baa97271f117bf06e3dd2e695e526965e4e7967...41ca7ae719f328851323b76ef90549ba55726602,1,0,3,3,1,2014-10-01 06:40:59,2014-10-01 06:40:59
41ca7ae719f328851323b76ef90549ba55726602...9dd097257296affa5e409f6d2b85a778eea59efb,2,1,3,4,3,2014-10-02 23:14:27,2014-10-02 23:14:27
120e82665e2c1ab4aa2ea245ae8ddca5d50564a9...0f4f77f8a20f34a035cfd2bce57041bfe170877f,1,5,2,7,1,2014-09-29 19:15:13,2014-09-29 19:10:11
120e82665e2c1ab4aa2ea245ae8ddca5d50564a9...e3328023d6b62e41629b9f1c6e10b2525c6eff30,6,179,4,183,20,2014-09-29 17:38:49,2014-09-19 18:44:51
2c6e615d1728e8fb3796664775e91f5081862232...c5f87bc3e0087d6e28e44fbdcbd33b429435c965,1,1,0,1,1,2014-09-20 01:57:18,2014-09-20 01:57:13
c5f87bc3e0087d6e28e44fbdcbd33b429435c965...cfefbcf28f364377b74344e2b35a042c30f77b24,1,1,1,2,1,2014-09-20 02:10:37,2014-09-20 02:09:46
cfefbcf28f364377b74344e2b35a042c30f77b24...8e9dbe6513bc950d2bb48511fc7106260f197182,2,21,17,38,5,2014-09-20 02:34:14,2014-09-20 02:34:04
8e9dbe6513bc950d2bb48511fc7106260f197182...06434cfefb308f8f49deaf06735f72b40da09f2e,1,2,3,5,1,2014-09-20 02:39:30,2014-09-20 02:39:30
06434cfefb308f8f49deaf06735f72b40da09f2e...18ffeafe20d52c943f0237cb4141d94cad58c6d2,1,1,1,2,1,2014-09-20 02:42:01,2014-09-20 02:42:01
18ffeafe20d52c943f0237cb4141d94cad58c6d2...27a1a66039938c0eb74ffdfad0576f58a621aac0,1,4,0,4,1,2014-09-20 02:49:23,2014-09-20 02:48:12
27a1a66039938c0eb74ffdfad0576f58a621aac0...9c5abcc8fad6762a6e1661847ec11497717e5f00,1,2,1,3,2,2014-09-20 02:53:16,2014-09-20 02:53:16
9c5abcc8fad6762a6e1661847ec11497717e5f00...e76d6dc7872caa6caef0b5d41a74d73203d4518c,1,4,0,4,1,2014-09-20 03:00:19,2014-09-20 03:00:19
e76d6dc7872caa6caef0b5d41a74d73203d4518c...0403d545c7169ef8746b17706a1228f2de2e9e82,1,4,2,6,2,2014-09-20 03:02:25,2014-09-20 03:02:17
0403d545c7169ef8746b17706a1228f2de2e9e82...292b1077598a67a6bb4901059ddbff11f110da51,4,13,5,18,4,2014-09-20 03:08:47,2014-09-20 01:51:07
292b1077598a67a6bb4901059ddbff11f110da51...4d572fcc1d013286744cb624efa7744e194f977f,1,8,0,8,4,2014-09-20 03:17:58,2014-09-20 03:17:58
4d572fcc1d013286744cb624efa7744e194f977f...715c13ff7c4c3282c8adc5941894a33a48014c4f,1,1,1,2,1,2014-09-20 03:21:31,2014-09-20 03:21:31
715c13ff7c4c3282c8adc5941894a33a48014c4f...d26387fdd7b645b14488f09d0ea78bb8f7200d2c,1,17,0,17,17,2014-09-20 03:45:07,2014-09-20 03:45:07
d26387fdd7b645b14488f09d0ea78bb8f7200d2c...7e50a51d2b42dfb47402b38cf7d55e00f6ac0c3d,1,6,0,6,1,2014-09-20 03:48:21,2014-09-20 03:46:16
7e50a51d2b42dfb47402b38cf7d55e00f6ac0c3d...78f36994e332fe1eb80eb70eaa01fdca87155b82,1,1,1,2,1,2014-09-20 03:48:21,2014-09-20 03:47:14
2c6e615d1728e8fb3796664775e91f5081862232...d20ec8390b474323c73ea133b6047d507e7a8413,4,13,5,18,4,2014-09-20 01:52:11,2014-09-20 01:51:07
277e19fb4f9bdc37c4bba7f79d1982352bc22f2c...bc8010514d7e6d1e729f862202a7b90c10eef1f4,8,171,67,238,35,2014-09-19 06:48:21,2014-09-19 06:48:14
bc8010514d7e6d1e729f862202a7b90c10eef1f4...6aec260018525960ea48700259ab0f9046f3b4dc,1,2,0,2,1,2014-09-19 19:14:15,2014-09-19 19:12:19
6aec260018525960ea48700259ab0f9046f3b4dc...f61638ca0a0ef2a5a22ad5bfa65057ecd9acf98c,4,35,3,38,6,2014-09-19 20:41:01,2014-09-19 20:41:01
f61638ca0a0ef2a5a22ad5bfa65057ecd9acf98c...c35f4c51dc310610846fc33fa6ac711495200c96,1,2,2,4,2,2014-09-19 20:47:37,2014-09-19 20:47:37
c35f4c51dc310610846fc33fa6ac711495200c96...4ec807f79bfa1f1ab8bff2302baba2956235083d,1,9,4,13,2,2014-09-19 22:27:57,2014-09-19 22:27:57
9460dcf9f824c29ad2bb5c02776eed375a46c2de...0f8ea3597e17cc79969e56d8fff6d6d315743017,1,8,7,15,2,2014-09-25 19:22:40,2014-09-25 19:21:04
a3a63fc5575fa4b33dfad63346e270f61212885a...e7cf0401775c4c1f1a6e4946281964c12f5ddc60,19,103,104,207,86,2014-09-18 00:24:25,2014-09-18 00:24:25
e7cf0401775c4c1f1a6e4946281964c12f5ddc60...855284559a05abf259470d632f1c33022bb4b63f,5,105,0,105,5,2014-09-19 00:29:04,2014-09-19 00:29:04
855284559a05abf259470d632f1c33022bb4b63f...e42ad696df7c3247f2bb48150491b41576b11b05,1,6,1,7,2,2014-09-19 00:34:56,2014-09-19 00:34:56
e42ad696df7c3247f2bb48150491b41576b11b05...bc10c537c757b89a1a36e64c9172b9cba4f65f85,1,2,2,4,2,2014-09-19 00:47:03,2014-09-19 00:47:03
bc10c537c757b89a1a36e64c9172b9cba4f65f85...9a95568f407112ef60f5854ef4486326b5a8e280,6,8,8,16,9,2014-09-19 00:49:36,2014-09-19 00:49:36
32a0178e883af6e0c2591c200480ce79c1b9bda1...9fba2ee766faa06c4b0d399fa8b30f5030deeeb3,6,18,18,36,18,2014-09-23 03:04:34,2014-09-23 03:04:34
9fba2ee766faa06c4b0d399fa8b30f5030deeeb3...2465991e9260ef0ef3f5ca29d812eb6b41c01383,2,1,11,12,3,2014-09-23 03:56:52,2014-09-23 03:56:52
2465991e9260ef0ef3f5ca29d812eb6b41c01383...8bb4904f21fa500bd95b2f33361e8b32386320af,1,2,2,4,1,2014-09-23 14:12:12,2014-09-23 14:12:12
8bb4904f21fa500bd95b2f33361e8b32386320af...6ca8ec715cab90e424585fda96edfcb9d9e2c9de,1,0,1,1,1,2014-09-23 15:42:30,2014-09-23 15:42:30
6ca8ec715cab90e424585fda96edfcb9d9e2c9de...3d86dc57848f78c08211407590cda5014efd0346,1,1,1,2,1,2014-09-23 15:43:06,2014-09-23 15:43:06
3d86dc57848f78c08211407590cda5014efd0346...1abe4998430204084a03892c8431bc83c4479cc0,1,6,4,10,4,2014-09-23 15:43:54,2014-09-23 15:43:54
1abe4998430204084a03892c8431bc83c4479cc0...e48ec74b7158a3255739fd490c4e34c17e6741f9,1,18,14,32,6,2014-09-23 15:45:55,2014-09-23 15:45:55
e48ec74b7158a3255739fd490c4e34c17e6741f9...ae9254e95706ada1de5ac943175a9217496256a0,1,0,1,1,1,2014-09-23 16:43:27,2014-09-23 16:43:27
ae9254e95706ada1de5ac943175a9217496256a0...c8aa8484388af02898b94ddc3f3811011ec3100f,1,0,6,6,1,2014-09-23 16:44:16,2014-09-23 16:44:16
c8aa8484388af02898b94ddc3f3811011ec3100f...f2df23dbeb222ee8e4126b084cf4d81cf7e322fe,1,3,5,8,4,2014-09-23 18:17:36,2014-09-23 18:17:36
f2df23dbeb222ee8e4126b084cf4d81cf7e322fe...2572ef9cf257ad6bb7b0ebb8f100d16141c3afd6,2,6,2,8,3,2014-09-23 18:38:50,2014-09-23 18:38:50
2572ef9cf257ad6bb7b0ebb8f100d16141c3afd6...dfa6f892e21791048f2133d47a2fb6b2180acdd6,1,3,3,6,3,2014-09-23 19:38:09,2014-09-23 19:38:09
970706385e6522acaaf1a7602c36a64fcc5c4c5d...c69447b03ce5e30b21ebb763bbdc7f3d340551b7,1,3,0,3,1,2014-09-10 16:54:26,2014-09-10 16:54:26
8ea02e67e3acb4e7457768909ca3ff8746fcc87a...4c2a8877e873c40b543a3bfd85017b9948af2fcd,2,23,5,28,4,2014-09-10 22:37:10,2014-09-10 22:37:10
68e08d0a387df917ea3637dc837672e6657631b3...6878e79e0a7bd233dd1faacbccbfb512b0bc70b4,4,34,7,41,6,2014-09-15 17:37:24,2014-09-15 17:37:24
6878e79e0a7bd233dd1faacbccbfb512b0bc70b4...a7a630fe1a930baf9cf2b1172837544de2af4a0d,5,14,9,23,8,2014-09-15 19:48:51,2014-09-15 19:48:51
68e08d0a387df917ea3637dc837672e6657631b3...d1c634830247d9a06a9e402a29593c0025531a40,1,2,0,2,1,2014-09-15 17:30:32,2014-09-15 17:30:32
d1c634830247d9a06a9e402a29593c0025531a40...7b0ca9341398033d660c36f003384487d20169ff,1,3,3,6,3,2014-09-15 17:58:16,2014-09-15 17:58:16
7b0ca9341398033d660c36f003384487d20169ff...46885c82ffedcef66bf42d6f36f8954adf02f7dd,1,13,3,16,2,2014-09-15 18:17:39,2014-09-15 18:17:39
46885c82ffedcef66bf42d6f36f8954adf02f7dd...b06d63977f83212e73000d86044a906d4f83fbfa,1,7,3,10,3,2014-09-15 18:19:17,2014-09-15 18:19:17
b06d63977f83212e73000d86044a906d4f83fbfa...024548ca3c2d233e7626f1da873d739a3268307f,1,0,4,4,1,2014-09-15 18:24:53,2014-09-15 18:24:53
024548ca3c2d233e7626f1da873d739a3268307f...49cd50d00579e6b7098e4d3fd7acfe376cbcc1b1,1,2,2,4,2,2014-09-15 18:25:22,2014-09-15 18:25:22
49cd50d00579e6b7098e4d3fd7acfe376cbcc1b1...833c6f5b4fe65cc1ec60dae2dac2e1dc5d7fad2a,37,38,40,78,39,2014-09-15 18:36:57,2014-09-15 18:34:53
833c6f5b4fe65cc1ec60dae2dac2e1dc5d7fad2a...d19f2bf49b98cb32c5bfd442767a3f954dcd1085,3,3,3,6,3,2014-09-15 19:05:03,2014-09-15 19:05:03
d19f2bf49b98cb32c5bfd442767a3f954dcd1085...6a7d1023719d64547ac3b8811882c56eb177e6dd,1,1,1,2,1,2014-09-15 19:34:19,2014-09-15 19:34:19
6a7d1023719d64547ac3b8811882c56eb177e6dd...f70dd67c12176471412cced501943f58e454106a,3,30,20,50,14,2014-09-15 19:37:41,2014-09-15 19:37:41
f70dd67c12176471412cced501943f58e454106a...12ad0a3d46f54e7746bac3bd1f74edef9221ecb8,10,145,117,262,71,2014-09-15 21:10:36,2014-09-15 21:10:36
b504fa8afaaff5020b1ddba5203377d95feafa78...138219e4c76b4c13dedffd5fb64fb43211f4ff42,1,0,7,7,1,2014-09-10 22:23:28,2014-09-10 22:23:28
138219e4c76b4c13dedffd5fb64fb43211f4ff42...a20c98f392cb62d94a59846e933edd717bbad615,1,4,4,8,4,2014-09-10 22:23:45,2014-09-10 22:23:45
a20c98f392cb62d94a59846e933edd717bbad615...f3b1ea27873aa5e5e25b49e5e09cb86b61909552,1,2,1,3,1,2014-09-10 22:26:57,2014-09-10 22:26:57
f3b1ea27873aa5e5e25b49e5e09cb86b61909552...ab0f57b6368decf2c963b98944c0f2ef75038a41,2,7,3,10,2,2014-09-10 22:34:58,2014-09-10 22:34:58
9d83e2a62dd62b7f1ffa3d5396c1f72d0c60f353...2dc2bf59ae965e46b9417edce860ee0fd1e5bb98,1,25,4,29,4,2014-09-07 01:29:56,2014-09-07 01:29:56
932ab597b0f064a61a30be7634011a338d98641a...ca8ae9462da9184391832526edbed20e21bf2eaa,4,4,3,7,4,2014-08-28 19:13:55,2014-08-28 19:13:15
ca8ae9462da9184391832526edbed20e21bf2eaa...4ee13d6aaba80b21a49c9e0af3702624ea6efe3f,1,1,1,2,1,2014-08-28 19:31:10,2014-08-28 19:31:10
4ee13d6aaba80b21a49c9e0af3702624ea6efe3f...6f6630d616d968499162acaff09c575ac2c689ff,3,3,3,6,3,2014-08-28 19:37:04,2014-08-28 19:37:04
d1c0004060250dae8914fc90996b398b31e89e32...c24e96ff83f556496f8d979ee7a203133868837d,1,4,4,8,3,2014-08-28 20:25:01,2014-08-28 19:02:53
c24e96ff83f556496f8d979ee7a203133868837d...6c3b37d8f8bda065663c679b22bf75f24b83da84,1,1,1,2,1,2014-08-28 20:40:29,2014-08-28 20:40:29
d1c0004060250dae8914fc90996b398b31e89e32...3189a364e962a210fd91972c67512ad38ac32416,55,137,128,265,40,2014-08-28 19:53:34,2014-08-28 19:53:34
3189a364e962a210fd91972c67512ad38ac32416...d0a0c177c9b194e6d2f620c9385cc574102d4e36,4,4,4,8,4,2014-08-29 00:11:58,2014-08-29 00:11:58
34231601cc9ef72cb8395b2a804edd3bac2f54ae...0bf177ca0be492ae8dd4cc72e27ea96a00e4ec35,8,148,29,177,33,2014-08-29 18:07:13,2014-08-29 18:07:13
0bf177ca0be492ae8dd4cc72e27ea96a00e4ec35...e0990957e189266e1f4752c7e15fc7902081e903,1,33,7,40,4,2014-08-29 18:18:07,2014-08-28 22:44:14
e0990957e189266e1f4752c7e15fc7902081e903...16b4003f24342b98a14c65f919e9bf5dc3dee74a,1,12,12,24,8,2014-08-29 18:18:14,2014-08-29 17:38:01
16b4003f24342b98a14c65f919e9bf5dc3dee74a...18e414caea48595fb69a4b87a10de4a500529006,1,0,12,12,2,2014-08-29 18:46:39,2014-08-29 18:46:17
34231601cc9ef72cb8395b2a804edd3bac2f54ae...a8b9cf2122e9e59c142d0573b7103910126be061,1,1,1,2,1,2014-08-29 09:21:21,2014-08-29 09:21:21
a8b9cf2122e9e59c142d0573b7103910126be061...902308af39907800e41fcba0d543e77359d0a5fa,1,1,1,2,1,2014-08-29 09:22:30,2014-08-29 09:22:30
9bbdc8249416725daa2ab123d014be6d344f99ec...171df064fb86c15fc2c347130b2609ac41871f84,3,23,22,45,11,2014-08-29 16:25:28,2014-08-29 16:23:58
171df064fb86c15fc2c347130b2609ac41871f84...562d496acc979327fa4ad32796bf7ba4ecacf06d,1,33,7,40,4,2014-08-29 18:19:11,2014-08-28 22:44:14
562d496acc979327fa4ad32796bf7ba4ecacf06d...03dc1046095fda429830df450d9c62393c929a44,1,12,12,24,8,2014-08-29 18:19:15,2014-08-29 17:38:01
88f42c04a0c2a4aefc3f12e153e7703ec91b0c71...2b1e5b80b83746b089671ec09c3708c13c44d76c,1,0,7,7,1,2014-08-30 01:06:23,2014-08-30 01:06:23
2b1e5b80b83746b089671ec09c3708c13c44d76c...0b6cf4f2ca0b50f92fe2a916fa93205a79a78c06,2,10,1,11,2,2014-08-30 01:55:54,2014-08-30 01:55:54
8cc0eb623c032c1257ecb6008b285fc0283a4ca9...3916991bc2ae7c96c9dbdd5293dfa4f4a72e7a32,4,45,2,47,4,2014-09-03 02:42:39,2014-09-03 02:42:39
3916991bc2ae7c96c9dbdd5293dfa4f4a72e7a32...9472d7deeaeb4d7691f236d4e9f8bb9c188dffbc,1,9,3,12,1,2014-09-04 20:44:42,2014-09-04 20:44:42
8cc0eb623c032c1257ecb6008b285fc0283a4ca9...c1baf7a928a483fd9086a37619514dcb2c6f928d,1,17,8,25,1,2014-09-02 23:20:31,2014-09-02 23:19:33
c1baf7a928a483fd9086a37619514dcb2c6f928d...0134e6a2d903bac468f2917aee75819aba2e7747,1,1,1,2,1,2014-09-03 00:47:49,2014-09-03 00:47:49
67f564827b30a31f04c37bc04adb62e3845f94f2...a7cb7410bf963bee715fc282de3db679bc577315,2,2,2,4,2,2014-08-13 21:28:53,2014-08-13 21:28:53
67f564827b30a31f04c37bc04adb62e3845f94f2...350584cb02cd9127f75090f0e5349afefb9f7708,1,10,2,12,1,2014-08-13 21:18:41,2014-08-13 21:18:41
e897539adbdd04432f9853284a5f5731aed9994f...6aae5086e5c6f0aa7fc19a08ae35a0564854c874,2,8,2,10,2,2014-08-18 03:15:32,2014-08-18 03:15:32
6aae5086e5c6f0aa7fc19a08ae35a0564854c874...2115eed79a34bad82e0acbd3ed249a59b419ce7b,1,2,12,14,2,2014-08-18 03:16:54,2014-08-18 03:16:54
2115eed79a34bad82e0acbd3ed249a59b419ce7b...b4039173a6947748fcd7fa71d2d507add0b2565c,1,5,2,7,3,2014-08-18 03:19:57,2014-08-18 03:19:57
b4039173a6947748fcd7fa71d2d507add0b2565c...87b3748ec5d82a711837a8ee7dffd54dac940d12,2,12,6,18,6,2014-08-18 03:30:34,2014-08-18 03:30:34
87b3748ec5d82a711837a8ee7dffd54dac940d12...3b3e8d7b933f4b6d0bf8cc5e49601e459910afac,6,87,106,193,28,2014-08-18 04:34:57,2014-08-18 04:04:54
3b3e8d7b933f4b6d0bf8cc5e49601e459910afac...9427c803e158b02f1878b7f41f5c6b8bf5a1d88a,1,1,1,2,1,2014-08-18 06:12:03,2014-08-18 06:12:03
9427c803e158b02f1878b7f41f5c6b8bf5a1d88a...acd5e0b04c209b1a02a386cb53854b7557a9b60d,1,1,2,3,1,2014-08-18 06:33:06,2014-08-18 06:33:06
acd5e0b04c209b1a02a386cb53854b7557a9b60d...08a6fa99fde286279498d6fab9959361b69a3ff3,5,17,19,36,17,2014-08-18 06:37:38,2014-08-18 06:37:38
08a6fa99fde286279498d6fab9959361b69a3ff3...73b33ee4da5bf3d9509ed07f55a359c65774f01d,1,5,0,5,1,2014-08-18 07:28:23,2014-08-18 07:28:23
73b33ee4da5bf3d9509ed07f55a359c65774f01d...4af87eadb1cf19dec994c7a5bdbb168263ced2ee,3,24,24,48,21,2014-08-18 07:28:37,2014-08-18 07:28:37
4af87eadb1cf19dec994c7a5bdbb168263ced2ee...558fb92651abc7f7ef58712f1934d82adb59a60c,1,2,0,2,1,2014-08-18 07:31:12,2014-08-18 07:31:12
558fb92651abc7f7ef58712f1934d82adb59a60c...4ac638d60b5e5ff6b7a59ef9f01a073b13ece24a,1,0,1,1,1,2014-08-18 07:32:15,2014-08-18 07:32:15
4ac638d60b5e5ff6b7a59ef9f01a073b13ece24a...9ed6204acca5419cdb43360d2ee2a534c093e0f9,2,0,4,4,2,2014-08-18 07:37:14,2014-08-18 07:37:14
9ed6204acca5419cdb43360d2ee2a534c093e0f9...b1b1520f3e5b32e06d8042032675cef6620118bf,24,0,1463,1463,23,2014-08-18 07:40:00,2014-08-18 07:40:00
b1b1520f3e5b32e06d8042032675cef6620118bf...f3085db2d274e5ba3475f9e719ff8bc953d18c37,1,14,2,16,3,2014-08-18 22:10:15,2014-08-18 22:10:15
f3085db2d274e5ba3475f9e719ff8bc953d18c37...9054effdeba75aed9d45aa47d489b3b7c7bb813a,4,48,30,78,16,2014-08-19 00:09:04,2014-08-19 00:09:04
9054effdeba75aed9d45aa47d489b3b7c7bb813a...196089ae331e8beb589b429b5b4badc1fc9f5ed9,2,27,3,30,8,2014-08-19 02:13:06,2014-08-19 02:13:06
196089ae331e8beb589b429b5b4badc1fc9f5ed9...883fc8516dc1ced843ea10108a1db9911893cf33,1,3,0,3,1,2014-08-19 03:10:52,2014-08-19 03:10:52
883fc8516dc1ced843ea10108a1db9911893cf33...69cf01a138bcc353d45c923aef00dafaff5dc97c,1,15,12,27,1,2014-08-19 03:11:47,2014-08-19 03:11:47
69cf01a138bcc353d45c923aef00dafaff5dc97c...d8ff20103ddc37c1409ce7ce512f06aadbf6bf33,8,8,8,16,8,2014-08-19 03:48:43,2014-08-19 03:48:43
d8ff20103ddc37c1409ce7ce512f06aadbf6bf33...84955c7ff4f031ea8c964d12be5b4e076a70466e,1,1,3,4,1,2014-08-19 17:39:56,2014-08-19 17:39:56
84955c7ff4f031ea8c964d12be5b4e076a70466e...187c86b3e5c64d3cab3b096633900c9f99532aa7,1,16,3,19,4,2014-08-19 17:56:19,2014-08-19 17:56:19
187c86b3e5c64d3cab3b096633900c9f99532aa7...63f984c5e501e7b48a8136f7ae59197d1a1216b0,1,4,2,6,2,2014-08-19 18:08:13,2014-08-19 18:08:13
654c7b4bc88b801fda446ee76e9d0b72205a1a8f...27a70db9220addc95435cacf0490d333b8f69e18,2,2,0,2,2,2014-08-20 20:25:17,2014-08-20 20:25:17
654c7b4bc88b801fda446ee76e9d0b72205a1a8f...b9e48d945afd0797bb45a0beadc41d412e5514db,1,8,8,16,4,2014-08-20 20:22:10,2014-08-20 20:19:40
d2f94579c060d4446ac3e64933c0623e147e9f01...d075b6dfd30eddc44668b10c96d051234f4c50d3,2,19,6,25,5,2014-07-18 23:35:39,2014-07-18 23:35:39
d075b6dfd30eddc44668b10c96d051234f4c50d3...39fc2ac12c248c191143ece6937b0795acd863e0,3,27,20,47,4,2014-07-18 23:45:16,2014-07-18 23:45:16
39fc2ac12c248c191143ece6937b0795acd863e0...114d8f920b34f3d38d9a7e48ca53e75901bc73db,1,1,1,2,1,2014-07-18 23:48:35,2014-07-11 00:53:21
114d8f920b34f3d38d9a7e48ca53e75901bc73db...0c89b03930b49b7f564f40ac2c10d9b9d782559e,1,1,1,2,1,2014-07-18 23:52:08,2014-07-13 15:27:14
0c89b03930b49b7f564f40ac2c10d9b9d782559e...1df5157cae6a7286959f99aa4c174513f47e9d6d,1,2,2,4,2,2014-07-18 23:58:27,2014-07-15 23:50:31
fa28ac2cbc57a77b0fdd65a5e1f7db207974f406...631e9aab73554eb57bc8f84c91d50f05ae41bd1c,1,1,0,1,1,2014-07-25 05:21:46,2014-07-25 05:21:46
631e9aab73554eb57bc8f84c91d50f05ae41bd1c...abbf3c78fac5b188789eb07b55540f57e3a3ab4c,1,1,1,2,1,2014-07-25 15:20:33,2014-07-25 15:20:33
abbf3c78fac5b188789eb07b55540f57e3a3ab4c...adeb649bf684d5166b4444883d8b08785c0ffd49,3,32,1,33,3,2014-07-25 20:57:47,2014-07-25 20:57:47
adeb649bf684d5166b4444883d8b08785c0ffd49...c715613e483302421982112f3404b94036d81685,1,8,1,9,1,2014-07-25 21:11:39,2014-07-25 21:04:11
c715613e483302421982112f3404b94036d81685...0cc2624c5936bedbb5d6dc055cdd87956ae58512,3,94,7,101,3,2014-07-25 21:23:44,2014-07-25 21:20:33
0cc2624c5936bedbb5d6dc055cdd87956ae58512...416b0170d7ca27814d7f02d3851c4ee40922465a,1,1,5,6,1,2014-07-25 22:01:00,2014-07-25 22:01:00
fa28ac2cbc57a77b0fdd65a5e1f7db207974f406...11f1afee4b11da1e381efd236866ae63128dabef,4,109,23,132,10,2014-07-25 04:54:05,2014-07-25 04:36:14
7e103cd2edb153785001f083af5a65c4455bec4b...4ff1452452dfc4b80fcf8aba73014f0a45139097,4,48,11,59,15,2014-07-08 00:26:23,2014-07-08 00:26:23
4ff1452452dfc4b80fcf8aba73014f0a45139097...b9a714f028a1766a76d6898c31787157b22a7534,88,77,274,351,138,2014-07-08 03:50:50,2014-07-08 03:50:50
b9a714f028a1766a76d6898c31787157b22a7534...1d946bc040b6a4936aac762ab1602b0dc6fdff61,2,19,1,20,5,2014-07-09 00:59:31,2014-07-09 00:59:31
1d946bc040b6a4936aac762ab1602b0dc6fdff61...9d68ac4568a6f70f2452a2e4703f048e8fdfcc9e,2,29,5,34,8,2014-07-09 05:41:21,2014-07-08 22:39:37
9d68ac4568a6f70f2452a2e4703f048e8fdfcc9e...a6858083d4df5258f713fc97dd51d06653fbe89c,1,14,4,18,5,2014-07-09 05:41:21,2014-07-08 22:46:59
a6858083d4df5258f713fc97dd51d06653fbe89c...8ed9d3459cdf79c206e375be43914d625755edaf,12,117,60,177,48,2014-07-09 05:41:21,2014-07-09 05:40:57
8ed9d3459cdf79c206e375be43914d625755edaf...f230eba62b0951223720229ec03f9684918e6cc2,18,644,202,846,89,2014-07-09 17:31:44,2014-06-10 23:52:33
f230eba62b0951223720229ec03f9684918e6cc2...4b88e70629d96d1832376e21c4d043b714271558,4,15,20,35,11,2014-07-09 17:31:44,2014-07-03 23:25:14
4b88e70629d96d1832376e21c4d043b714271558...8943649402cd20ce2be1895332474546800dd111,1,52,46,98,7,2014-07-09 17:31:44,2014-07-03 23:36:38
8943649402cd20ce2be1895332474546800dd111...ee0b9eea514da17d6f161d3d3572185b10cecd2b,2,43,2,45,3,2014-07-09 17:31:44,2014-07-07 18:22:32
ee0b9eea514da17d6f161d3d3572185b10cecd2b...0fc0fce64acae5c0e8ed7227976580b388b9bcfe,5,92,85,177,23,2014-07-09 17:53:21,2014-07-09 17:53:21
0fc0fce64acae5c0e8ed7227976580b388b9bcfe...01102d2d4481a7ccc1a2b4d59cfb54165045f589,4,7,6,13,5,2014-07-09 21:32:59,2014-07-09 21:17:22
01102d2d4481a7ccc1a2b4d59cfb54165045f589...7d61ae9f33a573f33901969b7542592d7c71bd6a,1,15,0,15,3,2014-07-09 21:33:44,2014-07-09 21:33:44
7d61ae9f33a573f33901969b7542592d7c71bd6a...015e505ec9939dfcfb75fe4a798ff74af7ffd491,1,0,0,0,0,2014-07-09 22:54:56,2014-07-09 22:54:56
015e505ec9939dfcfb75fe4a798ff74af7ffd491...9d7609f6a9c494d8d29436110a7a89b85d2e49f8,3,67,7,74,9,2014-07-10 22:09:33,2014-07-10 22:07:34
9d7609f6a9c494d8d29436110a7a89b85d2e49f8...989c263d1a811e184792e57ca3e5c56416dbf0be,1,23,27,50,9,2014-07-10 22:25:33,2014-07-10 22:25:33
989c263d1a811e184792e57ca3e5c56416dbf0be...8f4ee123aece7ebed42e2db99f3db71ea347769f,2,3,3,6,2,2014-07-11 01:12:47,2014-07-11 01:12:47
7e103cd2edb153785001f083af5a65c4455bec4b...fe63d2ae0953173174ac2f1f9a2d7415ce1256de,18,644,202,846,89,2014-07-03 22:08:52,2014-06-10 23:52:33
fe63d2ae0953173174ac2f1f9a2d7415ce1256de...8d1461e9c6e2e34b1cb581166558f524784fa3b1,4,15,20,35,11,2014-07-03 23:25:14,2014-07-03 23:25:14
8d1461e9c6e2e34b1cb581166558f524784fa3b1...3ca912dd1c18d968e2c9911a6aecba18dff95956,1,52,46,98,7,2014-07-03 23:36:38,2014-07-03 23:36:38
3ca912dd1c18d968e2c9911a6aecba18dff95956...6ac00b598c4afacbca0b6497c1365f96f8e0bbaa,2,43,2,45,3,2014-07-07 18:22:48,2014-07-07 18:22:32
c5e90053f29f209dbfe381622d980bcb107a5464...20766ac05e6df8a4762c5bd7706fb77e07bb7453,1,28,0,28,1,2014-01-27 23:25:19,2014-01-27 22:26:12
20766ac05e6df8a4762c5bd7706fb77e07bb7453...b5a14c5d307a7a0912294fa08e315123d9faceac,8,174,20,194,19,2014-01-27 23:25:19,2014-01-27 22:26:38
b5a14c5d307a7a0912294fa08e315123d9faceac...d577b05136842b1ede298a0a15fae5599ac18a2b,8,89,97,186,15,2014-01-28 00:22:30,2014-01-28 00:22:30
fabd6c6246c3f5b9951d4fc9501f031becbd9165...42ff994a098d528966409fa3478ebbe0c4ac310f,1,4,2,6,2,2014-02-26 16:23:31,2014-02-25 04:52:55
fabd6c6246c3f5b9951d4fc9501f031becbd9165...d32d2de1d6ec49749005e6b8526970586a2edf41,3,7,4,11,4,2014-02-24 21:48:24,2014-02-24 21:48:24
d32d2de1d6ec49749005e6b8526970586a2edf41...fd7eaf45d0bfd857e7afd868bf17c5439c99d9bf,6,6,6,12,6,2014-02-24 22:02:33,2014-02-24 22:02:33
6a9a797e83135026a11eed4cb80b2b47ea32d0a8...b7188769f25f1e313c950d249a8c046d6b77ce4c,1,0,48,48,1,2013-12-13 18:03:35,2013-12-09 17:16:06
b7188769f25f1e313c950d249a8c046d6b77ce4c...a951ab2fee5efb92d4866bad83a2ea91bb668882,1,69,1,70,3,2013-12-13 18:03:35,2013-12-09 19:19:04
a951ab2fee5efb92d4866bad83a2ea91bb668882...19964b351c05a60c189a5687c158505fe372d103,2,6,3,9,6,2013-12-13 18:03:35,2013-12-09 21:02:28
19964b351c05a60c189a5687c158505fe372d103...7da8004ddfb1d4d049ae6d7770694208ca759ec1,3,20,8,28,13,2013-12-13 18:03:35,2013-12-11 22:50:43
7da8004ddfb1d4d049ae6d7770694208ca759ec1...9373bce6381fac314d445cc5189fea967e9c3a00,2,28,1,29,3,2013-12-13 18:03:35,2013-12-11 23:04:28
9373bce6381fac314d445cc5189fea967e9c3a00...57c4c075d3e6f7944cb27800a896ab814cffde77,1,0,1,1,1,2013-12-13 18:03:35,2013-12-11 23:06:19
57c4c075d3e6f7944cb27800a896ab814cffde77...276034617afea0ca7d65a31113a871e7b29b59f3,4,35,4,39,10,2013-12-13 18:03:35,2013-12-13 00:51:32
276034617afea0ca7d65a31113a871e7b29b59f3...4ab6f8ee88adaf948f8824f0f0447628d22c1008,3,31,5,36,8,2013-12-13 18:03:35,2013-12-13 01:12:05
4ab6f8ee88adaf948f8824f0f0447628d22c1008...5750dcd7c6b30304215e1d2a70516fcebe516231,3,10,5,15,4,2013-12-13 18:03:36,2013-12-13 01:18:07
5750dcd7c6b30304215e1d2a70516fcebe516231...8e9ad07a09361cab19fe4292e6f14abd5b904469,1,1,2,3,1,2013-12-13 18:46:20,2013-12-13 18:46:20
8e9ad07a09361cab19fe4292e6f14abd5b904469...d62969fbce2bd1bf1836c09b45b890508c61d748,2,4,5,9,4,2013-12-13 19:53:02,2013-12-13 19:53:02
d62969fbce2bd1bf1836c09b45b890508c61d748...73f6d3c81c80221523c1919d66b6459b8cf96e5f,5,46,37,83,15,2013-12-13 21:22:01,2013-12-13 21:21:37
73f6d3c81c80221523c1919d66b6459b8cf96e5f...7449577ef411ac04ca719a4e46200cff1abb5b36,4,13,5,18,4,2013-12-13 22:40:10,2013-12-13 22:40:10
2ff683768d07010d490e0db8845d54b05ca1e265...d2b009f8e9f7c6d850078c4cac2a02f925c5f58a,1,2,3,5,2,2014-10-01 17:35:42,2014-10-01 17:35:42
d2b009f8e9f7c6d850078c4cac2a02f925c5f58a...51500e2be6841fa9547d4ca10ea49c8aa8764cbb,1,35,33,68,2,2014-10-01 17:36:39,2014-10-01 17:36:39
51500e2be6841fa9547d4ca10ea49c8aa8764cbb...8ae8925ce59ff84757aad55a2b3d52c3d4d73b95,1,1,1,2,1,2014-10-01 17:37:06,2014-10-01 17:37:06
8ae8925ce59ff84757aad55a2b3d52c3d4d73b95...0d0b2c02d5d9f92fd2b3236628b00246cd7619b6,1,18,10,28,4,2014-10-01 17:42:44,2014-10-01 17:42:44
0d0b2c02d5d9f92fd2b3236628b00246cd7619b6...4905dfd1880e76dce1154951da17b812f9ce7471,1,2,2,4,2,2014-10-01 17:50:54,2014-10-01 17:50:54
4905dfd1880e76dce1154951da17b812f9ce7471...47a46ae9ff7515f3cbdde08af20013eb8120aa3f,1,6,4,10,4,2014-10-01 17:51:12,2014-10-01 17:51:12
47a46ae9ff7515f3cbdde08af20013eb8120aa3f...ce58042b3d4fb2cffb1e401c9fa7b89e49f2dba0,3,20,0,20,3,2014-10-01 18:21:22,2014-10-01 18:21:22
0f4f77f8a20f34a035cfd2bce57041bfe170877f...3a08be805548b43d69a8675c3f1d1859649ee40a,1,7,1,8,1,2014-09-29 21:14:57,2014-09-23 22:43:33
3a08be805548b43d69a8675c3f1d1859649ee40a...4f13b2b89b7fdae8b0e37fb86fb909f89bb42c02,1,2,3,5,2,2014-09-29 21:14:57,2014-09-23 22:51:06
5aa76db4df8b5e89ea83224c2fbae8fe6ae79ef2...59b93e87929e67c0065664133c56112fc1e8f3cc,2,44,13,57,11,2014-09-29 21:13:54,2014-09-29 21:13:54
59b93e87929e67c0065664133c56112fc1e8f3cc...81dee7f52656efe61f09238857b15193a16ca9ef,3,49,26,75,17,2014-09-29 22:35:29,2014-09-29 22:35:29
81dee7f52656efe61f09238857b15193a16ca9ef...72f492c56fe0dca6d6e4099969d47c62a69c76d1,1,2,0,2,1,2014-09-29 23:01:58,2014-09-29 23:01:58
72f492c56fe0dca6d6e4099969d47c62a69c76d1...8beecd4238c3e7888277f69e48452d29781f0b08,1,17,0,17,1,2014-10-01 01:57:35,2014-10-01 01:57:35
5aa76db4df8b5e89ea83224c2fbae8fe6ae79ef2...3693db856247219a9e119014892c55b6ea9a4828,1,5,2,7,1,2014-09-29 19:15:38,2014-09-29 19:10:11
3693db856247219a9e119014892c55b6ea9a4828...26feea9275bbba0d7b3fceedd10298e5deb81f08,1,5,1,6,1,2014-09-29 19:57:46,2014-09-29 19:57:09
26feea9275bbba0d7b3fceedd10298e5deb81f08...84485a17a7a70eef84d46fee26555197cefcd306,1,4,0,4,1,2014-09-29 19:59:15,2014-09-29 19:59:15
e50fab39a0fef5ba04be3956225ffdf3d3a56050...e9a88b00b9cdd35eb281c7113fcaa5155f006ea3,7,465,169,634,67,2014-09-29 14:57:51,2014-09-29 14:57:35
e9a88b00b9cdd35eb281c7113fcaa5155f006ea3...2175da218bd695b0b185d018f54ca121a5fc59a0,2,7,4,11,3,2014-09-29 15:09:37,2014-09-29 15:09:37
2175da218bd695b0b185d018f54ca121a5fc59a0...98d4d3a96cdc07911658f706ac94d0221d969290,1,6,4,10,2,2014-09-29 15:15:15,2014-09-29 15:15:15
98d4d3a96cdc07911658f706ac94d0221d969290...cba3a2abff0c28e821b3b47a18ae57a34d1b873e,1,8,0,8,1,2014-09-29 15:44:07,2014-09-29 15:44:07
cba3a2abff0c28e821b3b47a18ae57a34d1b873e...1875f53e4c222b61b64567c1791bc931f3cb46b9,1,1,0,1,1,2014-09-29 15:48:08,2014-09-29 15:48:08
1875f53e4c222b61b64567c1791bc931f3cb46b9...6d5884ebca20e0ea2f042a110e762ebc83e4bd58,2,44,17,61,21,2014-09-29 15:59:07,2014-09-29 15:59:07
6d5884ebca20e0ea2f042a110e762ebc83e4bd58...018a9dbedf49f31b45fbf376244e4ec1fa109df7,1,14,27,41,7,2014-09-29 16:06:15,2014-09-29 16:06:15
018a9dbedf49f31b45fbf376244e4ec1fa109df7...043a0b8f3f0263c55ee8a1d8c2e04ddb3402810b,1,5,2,7,1,2014-09-29 16:08:00,2014-09-29 16:08:00
043a0b8f3f0263c55ee8a1d8c2e04ddb3402810b...beacafec0de96ec492092e98b9fddc96877bd661,2,4,4,8,3,2014-09-29 16:11:56,2014-09-29 16:11:56
beacafec0de96ec492092e98b9fddc96877bd661...f37fe22535de08250a0bb5bcadb3573c096ded97,1,2,2,4,2,2014-09-29 16:12:56,2014-09-29 16:12:56
f37fe22535de08250a0bb5bcadb3573c096ded97...331200b08a8397ad711282acf787c79097b88859,1,10,4,14,4,2014-09-29 16:16:06,2014-09-29 16:16:06
331200b08a8397ad711282acf787c79097b88859...e71bff8b9a1d8e6b323c6ee3d87acaf60f22dc64,1,1,0,1,1,2014-09-29 16:56:05,2014-09-29 16:55:42
e71bff8b9a1d8e6b323c6ee3d87acaf60f22dc64...113fc4cea2832159237bde27f7710137e20e0777,1,1,1,2,1,2014-09-29 19:00:47,2014-09-29 19:00:47
113fc4cea2832159237bde27f7710137e20e0777...9f8f9a93912474642ec3f7724125d12a9846ab1b,1,9,5,14,5,2014-09-29 21:48:52,2014-09-29 21:48:52
9f8f9a93912474642ec3f7724125d12a9846ab1b...96a72349c510693fd61eab107fa8dda5db226bd3,1,3,1,4,2,2014-09-29 21:58:56,2014-09-29 21:58:56
96a72349c510693fd61eab107fa8dda5db226bd3...83518116e85a1c36496050954d3b14e8aebe468f,1,1,1,2,1,2014-09-29 22:00:01,2014-09-29 22:00:01
83518116e85a1c36496050954d3b14e8aebe468f...1ab17b6aa8509fa69daf4aab92c9422a050ba094,8,107,94,201,61,2014-09-29 22:04:10,2014-09-29 22:00:28
1ab17b6aa8509fa69daf4aab92c9422a050ba094...f682a2db8e09637034cee4be673edb93a05cda6c,1,3,1,4,1,2014-09-29 22:06:21,2014-09-29 22:05:08
f682a2db8e09637034cee4be673edb93a05cda6c...6a25779f6b4d1135f267e9207e4882dbd427a34c,1,82,4,86,5,2014-09-29 23:20:55,2014-09-29 23:20:55
6a25779f6b4d1135f267e9207e4882dbd427a34c...4e8285fd93253695949297e39ef77d5a0b58492f,1,2,1,3,1,2014-09-30 00:26:08,2014-09-30 00:26:08
4e8285fd93253695949297e39ef77d5a0b58492f...4ad1525337624a0cdd2bed5f7baae7d605a78259,1,40,36,76,21,2014-09-30 02:10:44,2014-09-30 02:07:55
4ad1525337624a0cdd2bed5f7baae7d605a78259...8ce15905c27a912eb375195b908372b2c4f9c02c,3,25,16,41,11,2014-09-30 05:16:31,2014-09-29 23:24:42
8ce15905c27a912eb375195b908372b2c4f9c02c...f4563457e85f682c3f828594af43ca984dda4b45,3,55,97,152,25,2014-09-30 05:16:32,2014-09-30 05:08:32
f4563457e85f682c3f828594af43ca984dda4b45...b5ec4a81b1f53caa985e7c7f9aaebbcd110f6ca1,1,51,11,62,15,2014-09-30 16:02:33,2014-09-30 16:00:53
b5ec4a81b1f53caa985e7c7f9aaebbcd110f6ca1...7de1033f53a1787f68e2374bb3ce05455c3d2298,1,11,2,13,3,2014-09-30 16:02:33,2014-09-30 16:01:38
7de1033f53a1787f68e2374bb3ce05455c3d2298...6451f45d0962f4de4f36b1fc70a7e5bd0a7a3cc4,1,109,55,164,24,2014-09-30 16:37:07,2014-09-30 16:37:07
6451f45d0962f4de4f36b1fc70a7e5bd0a7a3cc4...29f44d08aa8870fd5c23a05d834fcb5c7b165f72,1,3,1,4,1,2014-09-30 17:18:29,2014-09-30 17:18:29
29f44d08aa8870fd5c23a05d834fcb5c7b165f72...6feeed3cf1f60bed7fcc5ed16eb8de9e2293192d,1,7,4,11,4,2014-09-30 18:15:31,2014-09-30 18:15:31
6feeed3cf1f60bed7fcc5ed16eb8de9e2293192d...f0a12fd37d6d14efea4909ef26a4777ac2e05ae7,3,55,34,89,6,2014-09-30 18:45:58,2014-09-30 18:45:58
f0a12fd37d6d14efea4909ef26a4777ac2e05ae7...3d17a05af06aaa636946f780eaba75991cfb5177,1,1,1,2,1,2014-09-30 22:19:03,2014-09-30 18:33:12
3d17a05af06aaa636946f780eaba75991cfb5177...cd43315e76ff9ae6ceeab1db4788a5aea342b31f,1,68,5,73,3,2014-09-30 23:18:20,2014-09-30 21:51:50
78f36994e332fe1eb80eb70eaa01fdca87155b82...220cc69e316da39f3693ad7dbca44a5ad2651e86,45,46,46,92,46,2014-09-20 04:16:14,2014-09-20 04:16:14
220cc69e316da39f3693ad7dbca44a5ad2651e86...c8f4152f040aa35e42aef7ced6afdeef40cd1c7b,1,1,1,2,1,2014-09-20 04:47:05,2014-09-20 04:47:05
c8f4152f040aa35e42aef7ced6afdeef40cd1c7b...3ad9ab61e9fb2c2f33a4d72d707a6c8665cf8d0a,2,2,2,4,2,2014-09-20 04:49:45,2014-09-20 04:49:45
3ad9ab61e9fb2c2f33a4d72d707a6c8665cf8d0a...35513fd745362340367e9366d50720de57f8e5c3,2,2,5,7,2,2014-09-20 05:24:01,2014-09-20 05:24:01
35513fd745362340367e9366d50720de57f8e5c3...ce9f3e0205a8f0f10a0f57d2419001ca0f6bfe5b,1,1,1,2,1,2014-09-20 05:27:55,2014-09-20 05:27:55
ce9f3e0205a8f0f10a0f57d2419001ca0f6bfe5b...5d8fb6d05b91e06a942cb767f4273fe8c7a80aa5,4,5,4,9,4,2014-09-20 05:34:39,2014-09-20 05:34:39
5d8fb6d05b91e06a942cb767f4273fe8c7a80aa5...3c9d7e26d05ecae0332207a88770ddf57dc42015,1,1,1,2,1,2014-09-20 05:36:30,2014-09-20 05:36:30
3c9d7e26d05ecae0332207a88770ddf57dc42015...811455ab14278948ce567864ca0a8c72ff303f28,2,2,2,4,2,2014-09-20 05:37:05,2014-09-20 05:37:05
811455ab14278948ce567864ca0a8c72ff303f28...64c63820a038e1f05df4776a6403a4841f8ec025,1,1,1,2,1,2014-09-21 17:18:26,2014-09-21 17:17:54
64c63820a038e1f05df4776a6403a4841f8ec025...559983ea0784abb202f326af08a2f9622584c308,1,1,1,2,1,2014-09-21 18:37:34,2014-09-21 18:37:23
559983ea0784abb202f326af08a2f9622584c308...d1b23fbece6cfaee270e7ee0d888fbee43942984,3,3,3,6,3,2014-09-21 18:51:14,2014-09-21 18:51:14
d1b23fbece6cfaee270e7ee0d888fbee43942984...e35e64b30c5fb3d1b2cf39f4a1166ef840ae0c46,2,45,45,90,23,2014-09-23 04:57:23,2014-09-23 04:57:23
e35e64b30c5fb3d1b2cf39f4a1166ef840ae0c46...cbe4d6dd6db1d8f764761e0dbb7097cdfef9e941,3,3,3,6,3,2014-09-23 05:07:33,2014-09-23 05:07:33
cbe4d6dd6db1d8f764761e0dbb7097cdfef9e941...c740a5c02ab87ac3d726990138e6eda6f89310c4,1,58,0,58,1,2014-09-23 06:49:21,2014-09-23 06:49:21
c740a5c02ab87ac3d726990138e6eda6f89310c4...0c35bff3e20e728ba79a17985cd847bd4536c6ed,2,5,3,8,2,2014-09-23 17:58:40,2014-09-23 17:58:40
0c35bff3e20e728ba79a17985cd847bd4536c6ed...782c0ac1bbb9f37525d699bfdefa2798a3c27cba,2,116,35,151,5,2014-09-23 22:19:20,2014-09-23 21:35:48
782c0ac1bbb9f37525d699bfdefa2798a3c27cba...b659994295efd52d6556b312afe282b913b191ac,1,80,0,80,5,2014-09-24 05:05:45,2014-09-24 05:05:45
b659994295efd52d6556b312afe282b913b191ac...42550da8a5ffc4100842ecec7acc0eefd192aa56,2,7,1,8,5,2014-09-24 06:07:41,2014-09-24 06:07:41
4ec807f79bfa1f1ab8bff2302baba2956235083d...b062ada0cf01db48ded857c4bb93f03e3114bac2,2,4,2,6,2,2014-09-19 23:27:48,2014-09-19 23:27:48
4ec807f79bfa1f1ab8bff2302baba2956235083d...30f4fa2cbec52c952c9f7620f1ab9e27a362639b,15,1384,462,1846,375,2014-09-19 22:52:23,2014-09-19 22:34:42
30f4fa2cbec52c952c9f7620f1ab9e27a362639b...19b5b342360acb8e225ee13c6344dcf31fadab0c,1,4,1,5,1,2014-09-19 23:04:29,2014-09-19 23:04:29
19b5b342360acb8e225ee13c6344dcf31fadab0c...79e0d5dda9a83a2f2348c6fadfd65177ee1e63db,4,24,7,31,9,2014-09-19 23:16:02,2014-09-19 23:16:02
79e0d5dda9a83a2f2348c6fadfd65177ee1e63db...b9713a02f7094ecedc099dffe5643b549a6fc4ec,2,4,3,7,3,2014-09-19 23:20:58,2014-09-19 23:20:58
b9713a02f7094ecedc099dffe5643b549a6fc4ec...e54fc3ac035e950621779890d8bc3b8729b59cb5,1,1,0,1,1,2014-09-19 23:51:09,2014-09-19 23:51:09
e54fc3ac035e950621779890d8bc3b8729b59cb5...244358791ab9993d63ec6808c83eb751915a8b1c,1,1,0,1,1,2014-09-19 23:52:46,2014-09-19 23:52:46
a5ea577287a9e13577cd39735aa6c2a7986d6b1f...54c159c07c1fadd16ff9de895914def14d353094,1,6,0,6,1,2014-09-25 22:18:48,2014-09-25 22:18:27
c69447b03ce5e30b21ebb763bbdc7f3d340551b7...b6004b19a3ffb5ccfc869aa87c86345c21ee818e,2,18,0,18,2,2014-09-10 21:38:30,2014-09-10 21:38:30
b6004b19a3ffb5ccfc869aa87c86345c21ee818e...9d5629e86117f53a8a0d8c31886c2e736f0211d7,2,3,2,5,3,2014-09-10 21:43:25,2014-09-10 21:43:25
9d5629e86117f53a8a0d8c31886c2e736f0211d7...3aeca8d4618dddd774fc8e1fa96d31c078e73c75,1,8,0,8,1,2014-09-10 22:27:54,2014-09-10 22:27:54
3aeca8d4618dddd774fc8e1fa96d31c078e73c75...8e6f9ab3cc7b45a12e234390e40a3690fd122624,1,1,1,2,1,2014-09-10 22:28:46,2014-09-10 22:28:46
c69447b03ce5e30b21ebb763bbdc7f3d340551b7...97481ebf649aa88d4994dc47e9c95d798126027d,2,9,4,13,5,2014-09-10 19:04:01,2014-09-10 19:03:08
1c20a0413efbdd205b758d18f4515b2f940f348b...7038f3437e8c3e3edbdc6f90c651342aaec855e9,2,54,32,86,10,2014-09-10 22:53:23,2014-09-09 04:31:59
7038f3437e8c3e3edbdc6f90c651342aaec855e9...8f29056b4c6c225f332a3a3abdb6889f909d3b0f,9,131,44,175,35,2014-09-10 22:53:23,2014-09-09 07:19:12
8f29056b4c6c225f332a3a3abdb6889f909d3b0f...390b6394b5f05d3a634028549061b51a061106ae,13,61,52,113,43,2014-09-10 22:53:23,2014-09-09 08:51:18
390b6394b5f05d3a634028549061b51a061106ae...ab72ed0619c4e6c57fc8c3a0f467605ae696e09c,1,13,3,16,4,2014-09-10 22:53:23,2014-09-09 21:51:06
ab72ed0619c4e6c57fc8c3a0f467605ae696e09c...69f637c8e598a8acb5e9e3b73d15641b79885a57,4,68,54,122,29,2014-09-10 22:53:23,2014-09-09 23:38:54
69f637c8e598a8acb5e9e3b73d15641b79885a57...f02314f66ed3a5184399360fc77ce3fab2e6441a,3,30,7,37,9,2014-09-10 22:53:23,2014-09-10 22:53:13
f02314f66ed3a5184399360fc77ce3fab2e6441a...100ab98160d192f219e73fffc84748379edd6288,1,40,39,79,4,2014-09-10 22:57:43,2014-09-10 22:57:43
100ab98160d192f219e73fffc84748379edd6288...7af9519dc42f0a0a5e3de71298eb2870847ad14e,3,56,41,97,8,2014-09-10 23:17:25,2014-09-10 23:17:25
7af9519dc42f0a0a5e3de71298eb2870847ad14e...8f60d6fe3ec6f9771b0b975d1b78920af23d5e9d,2,6,8,14,4,2014-09-10 23:25:04,2014-09-10 23:23:22
8f60d6fe3ec6f9771b0b975d1b78920af23d5e9d...a1e1da9d19b2529b87287203dc9de7bd1083ffe6,1,3,8,11,1,2014-09-10 23:31:29,2014-09-10 23:31:29
a1e1da9d19b2529b87287203dc9de7bd1083ffe6...b50a69be48aa414ada8920ed60206a7b74a50d8b,1,1,1,2,1,2014-09-11 00:18:13,2014-09-05 23:51:22
b50a69be48aa414ada8920ed60206a7b74a50d8b...9afa9af8850209060bd70b8b2f9d98288903ec75,1,13,3,16,1,2014-09-11 00:37:47,2014-09-11 00:37:43
9afa9af8850209060bd70b8b2f9d98288903ec75...3379a1353316440c04c09ff2763b8fcb10c0faf3,1,1,1,2,1,2014-09-11 00:40:15,2014-09-11 00:38:31
3379a1353316440c04c09ff2763b8fcb10c0faf3...6998b1a7471c6ea58a54b8fc63bf8c0cb1551234,1,1,4,5,1,2014-09-11 00:43:02,2014-09-11 00:42:13
6998b1a7471c6ea58a54b8fc63bf8c0cb1551234...1cb07f5c6cf2f2e3bd63e35bc5c22ae8769f9f69,1,0,9,9,1,2014-09-11 00:49:53,2014-09-10 18:37:50
1cb07f5c6cf2f2e3bd63e35bc5c22ae8769f9f69...186fa26eff4f6b1b79bc9698c31f892dcd5dc94e,1,25,25,50,2,2014-09-11 02:30:28,2014-09-11 02:30:28
186fa26eff4f6b1b79bc9698c31f892dcd5dc94e...e8ab6cd9db9914ee50d498c3dd7b514e0532815a,1,1,1,2,1,2014-09-11 03:11:11,2014-09-11 03:11:11
ab0f57b6368decf2c963b98944c0f2ef75038a41...d851397dd08d4b412a78a980ca39e72ab6ff6ad4,1,11,2,13,1,2014-09-10 22:52:23,2014-09-10 22:52:23
d851397dd08d4b412a78a980ca39e72ab6ff6ad4...861697ea28e5c67e08e61db8252423a36403ba45,1,2,2,4,1,2014-09-10 22:53:27,2014-09-10 22:53:27
861697ea28e5c67e08e61db8252423a36403ba45...0860b3626d6405c0ae440c50f53bd820eab7d50a,1,2,1,3,1,2014-09-10 23:03:42,2014-09-10 23:03:42
0860b3626d6405c0ae440c50f53bd820eab7d50a...2116f5bf53e4cbbdd1bdfac023a16625e7c892b9,1,3,0,3,1,2014-09-10 23:09:21,2014-09-10 23:09:21
2116f5bf53e4cbbdd1bdfac023a16625e7c892b9...14270c290e67b22f80ba5cd818c3a4e5eb56c4fb,1,2,2,4,2,2014-09-10 23:19:27,2014-09-10 23:19:27
3cd1d64de751c93787e2bdf0f8cf25a2b936a290...676c3ea1b6641e5eb6714212ae2635c5840b6d67,2,2,1,3,2,2014-09-30 21:55:42,2014-09-30 18:33:12
676c3ea1b6641e5eb6714212ae2635c5840b6d67...364efde3af0031edf9d1369a205a38a08729a3d2,1,2,1,3,2,2014-09-30 22:32:39,2014-09-30 22:32:39
364efde3af0031edf9d1369a205a38a08729a3d2...11c0577f1d2934f96566a40c883cfc09b59ee959,1,2,2,4,2,2014-09-30 22:45:46,2014-09-30 22:45:19
03dc1046095fda429830df450d9c62393c929a44...1e8c6179ed1b74b4cb3996b8058acab860b2fd9f,1,42,3,45,2,2014-08-29 22:44:46,2014-08-29 22:44:46
a6c4ed6e6e49a93428561db1939f069bcfdb5dc8...da3c39e8a5822f46118f18f3b61b5232dd692e4b,1,2,2,4,2,2014-09-02 21:29:51,2014-09-02 21:29:51
da3c39e8a5822f46118f18f3b61b5232dd692e4b...f3d0c24d2e25e10295cc2421ca70c90e548ee480,1,23,12,35,2,2014-09-02 21:57:33,2014-09-02 21:55:58
f3d0c24d2e25e10295cc2421ca70c90e548ee480...fc56f795d6e9619d406c926bcf325c57105d2dd6,23,23,23,46,23,2014-09-02 21:57:33,2014-09-02 21:57:10
fc56f795d6e9619d406c926bcf325c57105d2dd6...3df58956e1656ade890ef3bc3821c97f842987b6,1,3,2,5,1,2014-09-02 21:59:22,2014-09-02 21:59:22
3df58956e1656ade890ef3bc3821c97f842987b6...b500d410e5b8ec5ead78e18a799174c4b7abd7c1,2,76,60,136,30,2014-09-03 18:53:44,2014-09-03 18:53:44
b500d410e5b8ec5ead78e18a799174c4b7abd7c1...ea3a60007958b61595da374ed7f0675c139c1957,1,0,2,2,1,2014-09-03 23:45:09,2014-09-03 23:16:58
ea3a60007958b61595da374ed7f0675c139c1957...ddf0493ad37b187485f458c5a586124a2399796e,1,1,0,1,1,2014-09-04 23:43:59,2014-09-04 23:43:01
ddf0493ad37b187485f458c5a586124a2399796e...5faa9b4a9001cb47d621897b77568c1b65a57177,1,30,4,34,4,2014-09-05 17:28:35,2014-09-04 17:39:37
0134e6a2d903bac468f2917aee75819aba2e7747...79e57dda910cab70508f0b2254e15856eea631fa,1,0,2,2,1,2014-09-08 13:49:53,2014-09-08 13:49:53
79e57dda910cab70508f0b2254e15856eea631fa...f874da11abb15cab392ebc0592ae516f9bcc8cea,2,345,0,345,2,2014-09-08 14:05:32,2014-09-08 14:05:14
0134e6a2d903bac468f2917aee75819aba2e7747...57ed0b0c8a43cbf92ed3b637920903aa236146b9,1,0,1,1,1,2014-09-03 17:34:51,2014-09-03 17:34:51
0134e6a2d903bac468f2917aee75819aba2e7747...d1e048c412e7e87920817dcc44597e9472e01e20,1,1,1,2,1,2014-09-03 08:55:09,2014-09-03 08:55:09
0134e6a2d903bac468f2917aee75819aba2e7747...33ddd230f75748733e401072c0e74603be068701,5,14,3,17,5,2014-09-03 02:55:31,2014-09-03 02:55:31
33ddd230f75748733e401072c0e74603be068701...e0f96cce55504bd846db6ab28d5bbf689558c85e,3,9,1,10,3,2014-09-03 03:04:17,2014-09-03 03:04:17
e0f96cce55504bd846db6ab28d5bbf689558c85e...afef45585d92cb24cfd824c00f9fda53be5ac522,5,48,37,85,11,2014-09-03 03:16:15,2014-09-03 03:16:15
afef45585d92cb24cfd824c00f9fda53be5ac522...1c308e031055338ef51f10e4c02487e9261fe01d,3,22,7,29,5,2014-09-03 17:32:26,2014-09-03 17:32:26
1c308e031055338ef51f10e4c02487e9261fe01d...a269f4f05bc276f64cf02aba4bef6e0ea5b5d06f,1,3,4,7,1,2014-09-03 17:37:40,2014-09-03 17:37:40
a269f4f05bc276f64cf02aba4bef6e0ea5b5d06f...20dee1166442c0a5542e0034e381d485c377bff7,3,120,111,231,7,2014-09-06 01:35:28,2014-09-06 01:35:28
20dee1166442c0a5542e0034e381d485c377bff7...985b267195175d9af1a17c1b8df3fe393f09cff0,4,8,3,11,4,2014-09-06 01:38:53,2014-09-06 01:38:53
63f984c5e501e7b48a8136f7ae59197d1a1216b0...b29a4cc439d1d2af0c9a06ed3a47a249a3ef77b2,8,209,123,332,49,2014-08-19 19:32:16,2014-08-19 03:17:02
b29a4cc439d1d2af0c9a06ed3a47a249a3ef77b2...52e3eafa5cab4352d20e4845e9723e78b69e3347,7,106,6,112,9,2014-08-19 19:32:16,2014-08-19 19:31:40
52e3eafa5cab4352d20e4845e9723e78b69e3347...fceacf2885965df2a91d6ed6d58797b5d4e9d262,5,10,5,15,6,2014-08-19 19:41:00,2014-08-19 19:38:36
4cdea317c980ad5a998dd9a3ee6e2b511c661174...152c4b1dc043bca8dcd72da53eaa621548351852,1,5,2,7,2,2014-08-21 03:08:47,2014-08-21 03:08:47
152c4b1dc043bca8dcd72da53eaa621548351852...b167e174ecc25782002960e6d6b03c9773683b25,3,36,0,36,3,2014-08-21 03:09:06,2014-08-21 03:09:06
4cdea317c980ad5a998dd9a3ee6e2b511c661174...dafe967d3789d8373a12729579c9ffbbda252094,2,24,0,24,3,2014-08-20 20:30:44,2014-08-20 20:30:21
dafe967d3789d8373a12729579c9ffbbda252094...4cce2974d7f1f49f585e56b81a771eadd0e4c748,1,18,11,29,4,2014-08-20 20:34:38,2014-08-20 20:34:38
4cce2974d7f1f49f585e56b81a771eadd0e4c748...60da6831105c91cbd7bfe64e37af82ce802be1cd,1,6,2,8,1,2014-08-20 20:40:27,2014-08-20 20:39:53
60da6831105c91cbd7bfe64e37af82ce802be1cd...83c3aeebc3ab258ac52d9889a83cea89e9861da6,1,1,1,2,1,2014-08-20 20:43:29,2014-08-20 20:43:29
83c3aeebc3ab258ac52d9889a83cea89e9861da6...da403083626c0c0b189ced3f90ede9b51dd83de5,1,4,5,9,5,2014-08-20 20:48:43,2014-08-20 20:48:43
da403083626c0c0b189ced3f90ede9b51dd83de5...a669c2d0ed1cb649be13274867a10f42df68f781,4,18,11,29,8,2014-08-20 20:54:14,2014-08-20 20:53:25
a669c2d0ed1cb649be13274867a10f42df68f781...5fbc4b9fd5e1ee3988db0e2516154f741593c6df,1,1,1,2,1,2014-08-20 21:13:35,2014-08-20 21:13:28
5fbc4b9fd5e1ee3988db0e2516154f741593c6df...99978c74aa2d35e55a83cbcbf1ddcddb80812a85,1,2,3,5,2,2014-08-20 22:23:12,2014-08-20 22:23:12
99978c74aa2d35e55a83cbcbf1ddcddb80812a85...b0867b60e9f69bbdb5d5b8eb13ec110178d0fe88,1,78,7,85,3,2014-08-20 22:27:58,2014-08-20 22:27:58
b0867b60e9f69bbdb5d5b8eb13ec110178d0fe88...2c401964ab33a9ea4b1fdbb45996ea456b46101d,3,0,17,17,3,2014-08-20 22:30:54,2014-08-20 22:30:54
2c401964ab33a9ea4b1fdbb45996ea456b46101d...5c72e513ac27e5f78d22c8ec341864d81c9418a2,1,2,0,2,2,2014-08-20 22:37:46,2014-08-20 22:37:46
5c72e513ac27e5f78d22c8ec341864d81c9418a2...ef359e2d69cefc698de455d73f4ad8723b47e8e7,1,3,0,3,1,2014-08-20 22:51:06,2014-08-20 22:51:06
1df5157cae6a7286959f99aa4c174513f47e9d6d...be73e042a1bad00cd5218a1910223b772013148f,4,30,3,33,8,2014-07-22 01:34:28,2014-05-15 19:08:31
1df5157cae6a7286959f99aa4c174513f47e9d6d...ac87de15d8567a195b1016a5b6e44b8a48f7b46c,1,26,5,31,6,2014-07-19 07:31:54,2014-07-19 07:31:54
416b0170d7ca27814d7f02d3851c4ee40922465a...1ac501784a4435079df8723260a152871f65e2c2,2,60,0,60,2,2014-07-25 22:05:38,2014-07-25 22:04:42
1ac501784a4435079df8723260a152871f65e2c2...6ec8f05e4c7abc45ee37417a3d74ca45cc9dc0fc,3,54,2,56,8,2014-07-25 23:07:16,2014-07-25 23:06:45
6ec8f05e4c7abc45ee37417a3d74ca45cc9dc0fc...df6e70320a658db1591b871bc433ca0de6f60964,1,3,1,4,1,2014-07-25 23:14:25,2014-07-25 23:14:25
df6e70320a658db1591b871bc433ca0de6f60964...0f1e310a10f63c7422c13c42260cc3c35370dfad,2,10,1,11,4,2014-07-25 23:19:47,2014-07-25 22:38:07
0f1e310a10f63c7422c13c42260cc3c35370dfad...189116a65b9d15f11e9073ba414a32055b5ebdb9,1,4,3,7,2,2014-07-25 23:19:47,2014-07-25 23:14:34
189116a65b9d15f11e9073ba414a32055b5ebdb9...1b866b729d969025b71909d39579fd3d7b4a48ec,2,18,17,35,4,2014-07-26 00:24:32,2014-07-26 00:24:32
1b866b729d969025b71909d39579fd3d7b4a48ec...75c30ef073b864779762aa804b65a29cd52f0070,4,49,1,50,4,2014-07-28 19:23:54,2014-07-28 19:23:54
75c30ef073b864779762aa804b65a29cd52f0070...34bfcffa8296be366911c31aad35ad404e4051fb,1,11,11,22,6,2014-07-28 20:28:02,2014-07-28 20:28:02
34bfcffa8296be366911c31aad35ad404e4051fb...9bb83c4d4418286e700c17793336d490eadd9e41,1,3,2,5,2,2014-07-28 21:20:23,2014-07-28 21:20:23
9bb83c4d4418286e700c17793336d490eadd9e41...8dbda26c32f83a96dcb912f1d96a9a34bd9f827a,2,6,5,11,3,2014-07-28 22:13:10,2014-07-28 22:13:10
8dbda26c32f83a96dcb912f1d96a9a34bd9f827a...452ae36c683f17e6029a7e9b7aca539de3a0751b,1,12,5,17,6,2014-07-28 23:28:16,2014-07-28 23:27:49
452ae36c683f17e6029a7e9b7aca539de3a0751b...cd8bd67ff86f42ba2188c719311c1912a71490ae,1,14,0,14,3,2014-07-29 17:18:40,2014-07-29 17:18:40
cd8bd67ff86f42ba2188c719311c1912a71490ae...1b9bb206cd229fe1639d9c1f94455865000ba5c3,1,1,1,2,1,2014-07-29 17:54:21,2014-07-29 17:54:21
1b9bb206cd229fe1639d9c1f94455865000ba5c3...6efb7c85ccff82ddd54a9b67eacef74540906937,7,7,7,14,7,2014-07-29 21:34:19,2014-07-29 21:34:19
416b0170d7ca27814d7f02d3851c4ee40922465a...beb561f343025d4faa1ba1b1f647e2a280a98e37,2,22,0,22,2,2014-07-25 22:01:42,2014-07-25 22:01:42
8f4ee123aece7ebed42e2db99f3db71ea347769f...ec142b369d0ae7aedbc1da751497539b27414304,2,28,0,28,1,2014-07-12 00:02:17,2014-07-12 00:02:17
ec142b369d0ae7aedbc1da751497539b27414304...127e1f5a79f122a09ada27d93563fabbb6b06992,3,45,10,55,7,2014-07-15 00:50:22,2014-07-15 00:50:22
127e1f5a79f122a09ada27d93563fabbb6b06992...f1ba1bad3d513d542fc452e5ecce6b5f79bd8d33,4,30,5,35,6,2014-07-15 01:20:05,2014-07-15 01:20:05
f1ba1bad3d513d542fc452e5ecce6b5f79bd8d33...e4a40e2971c52689aa7a05610a159658a235010e,1,1,1,2,1,2014-07-15 17:13:26,2014-07-15 17:13:26
e4a40e2971c52689aa7a05610a159658a235010e...9dcc3647238db142c939d7eabab91f404668a783,1,12,1,13,3,2014-07-15 17:23:33,2014-07-15 17:23:33
9dcc3647238db142c939d7eabab91f404668a783...b4e3947aa63873f4a9eee96c5bdf537f6530c9dc,3,19,6,25,6,2014-07-15 17:51:58,2014-07-15 17:51:58
b4e3947aa63873f4a9eee96c5bdf537f6530c9dc...abfc8961a32c52b8c2a7a3f1464d1cf0164baba2,3,91,26,117,8,2014-07-15 23:57:37,2014-07-15 23:57:37
abfc8961a32c52b8c2a7a3f1464d1cf0164baba2...cf1d45fa82c95abaa38441fd690c4abffffdadcb,4,33,4,37,8,2014-07-16 00:19:08,2014-07-16 00:19:08
cf1d45fa82c95abaa38441fd690c4abffffdadcb...738c27ad8d40a0e96695237350729cf4cc89b8cc,6,49,6,55,6,2014-07-16 01:34:43,2014-07-16 01:34:43
8f4ee123aece7ebed42e2db99f3db71ea347769f...7eb0e6c91b8391a0f37d1786537dac063bb47994,6,53,32,85,33,2014-07-11 21:04:59,2014-07-02 03:09:35
7eb0e6c91b8391a0f37d1786537dac063bb47994...6ecb62556734714b505a82f9e732106703ff98b8,4,73,6,79,7,2014-07-11 21:04:59,2014-07-02 03:45:13
6ecb62556734714b505a82f9e732106703ff98b8...474ed021f25040c80501b4c387f448a7077998ea,1,35,5,40,6,2014-07-11 21:04:59,2014-07-08 01:32:30
474ed021f25040c80501b4c387f448a7077998ea...ee3cad314fb3769b1543735f3e31400c58709c5a,1,70,1,71,4,2014-07-11 21:04:59,2014-07-08 19:02:58
ee3cad314fb3769b1543735f3e31400c58709c5a...77219309a1472a6028411d8a78432e8b7ce9fdc9,6,59,105,164,26,2014-07-11 21:04:59,2014-07-08 22:24:41
77219309a1472a6028411d8a78432e8b7ce9fdc9...7034ccdb78739e05ed41828ca030b77476b1911a,1,44,0,44,1,2014-07-11 21:04:59,2014-07-09 00:06:09
7034ccdb78739e05ed41828ca030b77476b1911a...0869b93392a642c0a0ac4b060e6ca504525b2b0c,8,234,112,346,44,2014-07-11 21:05:00,2014-07-10 23:45:25
0869b93392a642c0a0ac4b060e6ca504525b2b0c...31fed527513d7edd9f1621e3d9a2fef7b8bb6c46,6,3,21,24,13,2014-07-11 21:05:00,2014-07-10 23:52:36
31fed527513d7edd9f1621e3d9a2fef7b8bb6c46...2148497ddeb7686642b3ce793d5efc5a6522bd39,4,20,9,29,10,2014-07-11 21:05:00,2014-07-11 02:25:11
2148497ddeb7686642b3ce793d5efc5a6522bd39...3d7d47c3ea16a6fb8d91019b329a2e2014d950b9,3,6,7,13,4,2014-07-11 21:05:00,2014-07-11 19:23:52
3d7d47c3ea16a6fb8d91019b329a2e2014d950b9...4e6254f93a9612b712ad349321ece0178592e7d6,1,7,1,8,2,2014-07-14 18:33:10,2014-07-14 18:33:10
4e6254f93a9612b712ad349321ece0178592e7d6...b5b55bb792b500a6647577839565aa911cbe25f5,2,179,0,179,2,2014-07-14 21:14:50,2014-07-14 21:14:40
b5b55bb792b500a6647577839565aa911cbe25f5...f28d0cdf32acf2513aed3d0541b9b49ff4d6fee4,2,179,71,250,21,2014-07-14 22:25:49,2014-07-14 22:23:22
f28d0cdf32acf2513aed3d0541b9b49ff4d6fee4...1478e434f47837dafc32adea281b7062156d48fd,2,21,4,25,5,2014-07-15 18:10:38,2014-07-15 18:10:38
1478e434f47837dafc32adea281b7062156d48fd...894d147d765b1060bc4d6f77d58ce2f53bf25f1b,1,40,22,62,10,2014-07-15 22:37:38,2014-07-15 22:37:38
894d147d765b1060bc4d6f77d58ce2f53bf25f1b...c27f894aaae10a8f0674ee77362751863c391a01,2,3,94,97,6,2014-07-15 23:11:41,2014-07-15 23:11:41
c27f894aaae10a8f0674ee77362751863c391a01...9cd77dbd146d2d4a7a442b47586942b32b714d4c,2,15,9,24,10,2014-07-16 22:43:27,2014-07-16 22:43:27
9cd77dbd146d2d4a7a442b47586942b32b714d4c...a614d917c0b6c825ad3f060f7a7853b3d2d080b6,1,6,0,6,1,2014-07-17 23:28:04,2014-07-17 23:28:04
a614d917c0b6c825ad3f060f7a7853b3d2d080b6...156e26a1992147191d6d24c6d960a9e482263218,2,94,3,97,6,2014-07-18 00:05:41,2014-07-18 00:05:41
156e26a1992147191d6d24c6d960a9e482263218...e8c1df5002b4e4936c89b39ad3170382314e3b0d,1,1,0,1,1,2014-07-19 01:59:48,2014-07-19 01:59:48
c18f7339bfea91d934bf497134a19133bd005f36...f53bf0ab822ce5ed1977000c501230ba917683c5,2,5,1,6,2,2014-01-28 00:29:59,2014-01-28 00:29:59
f53bf0ab822ce5ed1977000c501230ba917683c5...204959b5092265455abc2482d17622a8aa3d7b9c,1,1,1,2,1,2014-01-28 00:30:43,2014-01-28 00:30:43
42ff994a098d528966409fa3478ebbe0c4ac310f...729f4123f1b8967302c6aef824593fcfa78ab71a,2,9,5,14,3,2014-02-26 21:48:36,2014-02-26 21:34:24
729f4123f1b8967302c6aef824593fcfa78ab71a...0eccd1f2f49f674ba6e9f31a378fa17bc205d3df,1,11,1,12,1,2014-02-26 21:51:38,2014-02-26 21:51:38
0eccd1f2f49f674ba6e9f31a378fa17bc205d3df...3caa3b9e9c4cb1741034e07e4d50f300c4dbefaf,2,5,5,10,3,2014-02-26 21:51:58,2014-02-26 21:51:58
f92cb7d05def64df8caf58dd16279177c0acb9e2...001d2df9682ef4579e0b486ec77af402a5b21a62,2,50,14,64,4,2013-12-13 23:56:06,2013-12-13 11:46:11
001d2df9682ef4579e0b486ec77af402a5b21a62...cb4a278d4bffbc1fd2f61b40de29cdc5509d90e6,3,0,55,55,6,2013-12-14 01:53:52,2013-12-14 01:53:52
cb4a278d4bffbc1fd2f61b40de29cdc5509d90e6...37c63ffae72c250b22a9142f74a6bac7836403a6,4,15,9,24,6,2013-12-16 20:14:01,2013-12-16 20:06:52
37c63ffae72c250b22a9142f74a6bac7836403a6...e6c87236a6286664e43b75235be419ef0229ebcc,1,24,13,37,6,2013-12-16 23:14:43,2013-12-16 23:14:43
1391fa618143ebc34c5db11e0c3d8b161542efbc...ac893c9af4b4143360421a2858ff6f42c0f8e442,5,18,11,29,8,2014-10-28 17:41:05,2014-10-28 17:33:53
ac893c9af4b4143360421a2858ff6f42c0f8e442...c2882a2e2e4bd5c6f27d8203f65544666f5d84be,2,8,0,8,2,2014-10-28 17:44:36,2014-10-28 17:44:36
101b96bdcca94d51ac3a20cf0859b03b8ed8a903...3ff1ca06b891cd7284eb0d31aa2508fb5606da6e,2,2,2,4,2,2014-10-13 23:08:47,2014-10-13 23:07:23
3ff1ca06b891cd7284eb0d31aa2508fb5606da6e...d46e14a0aaa39e7bc34f3ded487cd8c0d7136b70,1,7,3,10,3,2014-10-13 23:24:32,2014-10-13 23:23:59
ce58042b3d4fb2cffb1e401c9fa7b89e49f2dba0...3c1a2fe9ca69a56aec2685ee57d2e7ac0837ba7b,3,138,82,220,14,2014-10-01 19:18:04,2014-10-01 19:18:04
3c1a2fe9ca69a56aec2685ee57d2e7ac0837ba7b...6be55e61bf0a9b7a1691dc64bcdc09153207ad80,4,128,11,139,14,2014-10-01 21:42:30,2014-10-01 21:42:06
6be55e61bf0a9b7a1691dc64bcdc09153207ad80...90a24c9bd8e0dfa7bf19d3eeaa567fe33e2a5ade,4,145,66,211,9,2014-10-01 22:18:38,2014-10-01 22:18:38
90a24c9bd8e0dfa7bf19d3eeaa567fe33e2a5ade...c1a567d7c534334f4fa1fe3fa28131339bc95489,1,1,0,1,1,2014-10-02 01:33:43,2014-10-01 19:07:11
c1a567d7c534334f4fa1fe3fa28131339bc95489...3b86a3c7a3cdb2ee5765db5a2c7cb6e3fb84532c,1,27,1,28,1,2014-10-02 01:33:43,2014-10-01 20:51:55
3b86a3c7a3cdb2ee5765db5a2c7cb6e3fb84532c...29f2682fe00793b909a1a841d1e2398f18e19ed9,2,23,21,44,5,2014-10-02 01:33:43,2014-10-01 20:23:35
29f2682fe00793b909a1a841d1e2398f18e19ed9...0e5150cd745d65c50fa43d0f3b87468c00a50a87,1,11,14,25,4,2014-10-02 01:33:43,2014-10-01 20:51:33
0e5150cd745d65c50fa43d0f3b87468c00a50a87...423e2c212b6a1284599f28a382d01cc7bc6907d5,1,2,2,4,2,2014-10-02 01:33:43,2014-10-01 20:58:50
423e2c212b6a1284599f28a382d01cc7bc6907d5...fd24de9cebc9f387578116f504156bb3df493b23,1,4,4,8,1,2014-10-02 01:33:43,2014-10-01 21:37:31
fd24de9cebc9f387578116f504156bb3df493b23...fb56aec96fbb6e2dce8ef01e63cf26a3a7f8b72b,3,12,3,15,5,2014-10-02 01:33:43,2014-10-01 21:41:13
fb56aec96fbb6e2dce8ef01e63cf26a3a7f8b72b...7866e9386f0601d86b455d4a741958db021378c3,1,1,0,1,1,2014-10-02 01:33:43,2014-10-01 22:19:49
7866e9386f0601d86b455d4a741958db021378c3...21adbca461a61462163f35f85d63add6c8535864,5,253,151,404,24,2014-10-02 01:33:43,2014-10-01 22:56:16
21adbca461a61462163f35f85d63add6c8535864...e7dd646da5d7b25715a752085523639401fb770f,2,4,4,8,4,2014-10-02 01:42:27,2014-10-02 01:42:27
e7dd646da5d7b25715a752085523639401fb770f...f1fb54e5edf91edea5bea71f8b2c05390c9b170c,1,1,1,2,1,2014-10-02 22:53:29,2014-10-02 22:53:29
f1fb54e5edf91edea5bea71f8b2c05390c9b170c...afad6e0e43063e35d265dd53eec53fa0aff192a3,2,182,20,202,15,2014-10-03 04:08:57,2014-10-03 04:08:57
ce58042b3d4fb2cffb1e401c9fa7b89e49f2dba0...cb9e38a7e647e16b88d1f2f7488099eb28a83b0f,1,1,0,1,1,2014-10-01 19:07:11,2014-10-01 19:07:11
cb9e38a7e647e16b88d1f2f7488099eb28a83b0f...074d08c8af7a03f8ea0d00edd86a3373b5be1daf,1,27,1,28,1,2014-10-01 20:51:55,2014-10-01 20:51:55
074d08c8af7a03f8ea0d00edd86a3373b5be1daf...4279394d3e601f6ff3453953041ed064cdd9f522,2,23,21,44,5,2014-10-01 21:48:18,2014-10-01 20:23:35
4279394d3e601f6ff3453953041ed064cdd9f522...0f795ed9730af84181e4dbb1a41502931bcdd42b,1,11,14,25,4,2014-10-01 21:48:18,2014-10-01 20:51:33
0f795ed9730af84181e4dbb1a41502931bcdd42b...800f9df98aa82dc76a967f854234834da520a7ad,1,2,2,4,2,2014-10-01 21:48:18,2014-10-01 20:58:50
800f9df98aa82dc76a967f854234834da520a7ad...fa201908a32eb635b9eebb7f13431ade8c8d01e9,1,4,4,8,1,2014-10-01 21:48:18,2014-10-01 21:37:31
fa201908a32eb635b9eebb7f13431ade8c8d01e9...92e5c48567d85c3df9b48fde71911caa7a989d0c,3,12,3,15,5,2014-10-01 21:48:18,2014-10-01 21:41:13
92e5c48567d85c3df9b48fde71911caa7a989d0c...eb830870467747aaf95e32c90e24efd476a800db,3,35,12,47,7,2014-10-02 00:02:37,2014-10-01 23:42:14
eb830870467747aaf95e32c90e24efd476a800db...55621b5a85a143dd22522f1d91d4c41cf555a6be,1,17,16,33,2,2014-10-02 07:43:42,2014-10-02 07:43:42
870a85a3dc9d6679462ec67b98019a6eabcdabeb...b7b9a530389afbf90295f3361d15c5393f305c73,1,1,1,2,1,2014-09-29 21:21:55,2014-09-24 23:33:58
07987a009db771e78a4cd49bc9d51a9342bb49fe...2368138e3b2857c065be9dfb7085531ce5c75db4,1,21,9,30,6,2014-10-01 02:16:10,2014-10-01 02:16:10
2368138e3b2857c065be9dfb7085531ce5c75db4...e9a76d00c7d7b6b82d8271a13e2c9707585aaf89,1,1,0,1,1,2014-10-01 02:17:40,2014-10-01 02:17:40
e9a76d00c7d7b6b82d8271a13e2c9707585aaf89...4d8e54fe4f9d0f04b082d246b801a57a52559e4a,3,6,9,15,7,2014-10-01 02:25:35,2014-10-01 02:25:35
4d8e54fe4f9d0f04b082d246b801a57a52559e4a...dd83854552e854aee667b5d3c8052e128410145b,1,21,27,48,9,2014-10-01 02:30:42,2014-10-01 02:30:42
fff18dc595f9e3676e93ebab331b1bec9bdcc133...653c886ff3948d2ad77b8e9b08bd3910754c50ce,3,8,8,16,6,2014-09-29 20:35:44,2014-09-18 19:50:12
c67de0830a0fa31e502ac9ce4177d7a0fce13626...5f886d33466cc81b8d1531b61d9cd1a3b81d09c5,3,18,17,35,17,2014-09-30 23:36:33,2014-09-30 23:36:33
5f886d33466cc81b8d1531b61d9cd1a3b81d09c5...f5f9b47da827c538a9127d1270b05cf5fe2b6cca,1,10,0,10,1,2014-09-30 23:49:00,2014-09-30 23:49:00
4e78ed48737f7403dee20436b96563136edfbaef...6ca66b25be6eb2af98310855cc2463f9e6bd2ff5,1,1,1,2,1,2014-09-21 17:17:54,2014-09-21 17:17:54
6ca66b25be6eb2af98310855cc2463f9e6bd2ff5...a881c29e1ce5d8dc274de13674ea5a49876c4516,1,1,1,2,1,2014-09-21 18:38:05,2014-09-21 18:37:23
a881c29e1ce5d8dc274de13674ea5a49876c4516...49564070e67581fa50dc593bf04fd14e5074529e,1,3,1,4,1,2014-09-22 19:00:34,2014-09-22 18:58:49
49564070e67581fa50dc593bf04fd14e5074529e...44ea500c7bcc887dd7dfb8c323906f91ce611511,1,1,1,2,1,2014-09-22 19:27:50,2014-09-17 16:15:31
42550da8a5ffc4100842ecec7acc0eefd192aa56...a401cd834ab299156b3974e0d6723b3acc5e3d94,1,1,1,2,1,2014-09-25 00:35:14,2014-09-25 00:34:40
a401cd834ab299156b3974e0d6723b3acc5e3d94...0d128ffbb5dcd9d61895cdbdc4bd39e320527912,2,13,10,23,6,2014-09-25 00:47:18,2014-09-25 00:44:44
0d128ffbb5dcd9d61895cdbdc4bd39e320527912...620dde5306044db09c99545205ffb151178beac4,1,1,1,2,1,2014-09-25 00:53:37,2014-09-25 00:53:37
620dde5306044db09c99545205ffb151178beac4...573f8815319396991eb9fa4e334a4b581fbd4b61,1,1,3,4,1,2014-09-25 01:29:33,2014-09-25 01:28:36
573f8815319396991eb9fa4e334a4b581fbd4b61...88936518d83d5d67876a4927e7d7dedd6f02145d,2,76,5,81,6,2014-09-25 02:23:55,2014-09-25 02:23:55
88936518d83d5d67876a4927e7d7dedd6f02145d...3278265b523a4c8d0553c36e87a3148cca7250eb,2,49,5,54,9,2014-09-25 03:52:22,2014-09-25 03:52:22
3278265b523a4c8d0553c36e87a3148cca7250eb...6feb5da9485e773fb0ebc542d1bb8185c1451d1d,2,16,3,19,3,2014-09-25 04:07:09,2014-09-25 04:07:09
6feb5da9485e773fb0ebc542d1bb8185c1451d1d...245059ef49ba069709378dca20a1b71daaec7e01,2,2,20,22,3,2014-09-25 04:28:36,2014-09-25 04:28:36
245059ef49ba069709378dca20a1b71daaec7e01...58c110499ec176cb3a83dae5bbc3b153598608be,2,31,13,44,6,2014-09-25 05:35:05,2014-09-25 05:35:05
42550da8a5ffc4100842ecec7acc0eefd192aa56...c496bd716bacc24413cb4f948931eb73eb1309a0,2,83,0,83,3,2014-09-24 23:16:39,2014-09-24 23:16:39
c496bd716bacc24413cb4f948931eb73eb1309a0...2a71dbfc41ae0f81e7d625f2327e926266f8349f,2,13,10,23,6,2014-09-25 00:44:44,2014-09-25 00:44:44
2a71dbfc41ae0f81e7d625f2327e926266f8349f...cb0811a10acab05528c5404b5ccc708bf7cf238b,1,2,2,4,2,2014-09-25 01:30:41,2014-09-25 01:30:41
cb0811a10acab05528c5404b5ccc708bf7cf238b...8fe23b418b3c3cad690ea3171bb64a8fac711576,5,65,32,97,13,2014-09-25 06:19:59,2014-09-25 06:19:59
54c159c07c1fadd16ff9de895914def14d353094...af3fe5624bf29b0cf92a86dd866e346204d956a2,2,39,20,59,11,2014-09-25 22:30:17,2014-09-24 21:21:31
af3fe5624bf29b0cf92a86dd866e346204d956a2...4b739b0684e24fe0efd4fc037e4ddab69324af8e,5,51,0,51,5,2014-09-25 22:30:17,2014-09-25 17:29:13
4b739b0684e24fe0efd4fc037e4ddab69324af8e...2f47a81395322de022af9680470d3ef4a3e74133,2,5,5,10,2,2014-09-25 22:30:17,2014-09-25 22:21:45
78bb8399d2e16f285d81cfb3d86367d0ccb8ab08...48264ccafdcdfe6ff88b59ea8fc5631210d79818,19,636,549,1185,102,2014-09-25 21:56:15,2014-09-25 21:56:15
48264ccafdcdfe6ff88b59ea8fc5631210d79818...8e9eb877016ca68e21694c5229984f65f545a090,1,4,0,4,1,2014-09-25 21:57:42,2014-09-25 21:57:42
e8ab6cd9db9914ee50d498c3dd7b514e0532815a...ce4a3359fe3479bed818dd68ea0ee50e17a0f22a,2,78,5,83,6,2014-09-11 05:39:39,2014-09-11 05:39:16
ce4a3359fe3479bed818dd68ea0ee50e17a0f22a...8fda0a0e1b02bc73b8b35f44e5050c5518f4062b,1,1,1,2,1,2014-09-11 16:34:46,2014-09-11 16:34:46
8fda0a0e1b02bc73b8b35f44e5050c5518f4062b...d223c21ae8e339bf43a304ca7892105a365a13c8,4,239,4,243,11,2014-09-11 17:11:15,2014-09-11 17:11:15
e8ab6cd9db9914ee50d498c3dd7b514e0532815a...5a92e9cbcd400f0482e2662d27e6e048fc0f1671,1,8,2,10,2,2014-09-11 03:11:42,2014-09-10 02:41:02
5a92e9cbcd400f0482e2662d27e6e048fc0f1671...c17afb3ce70bd01c4fa56ee9b424456b1f929898,3,81,17,98,29,2014-09-11 03:11:42,2014-09-10 03:36:14
c17afb3ce70bd01c4fa56ee9b424456b1f929898...4131adca1ba15b7153d801849faee892bb8345c5,1,186,175,361,12,2014-09-11 03:11:42,2014-09-10 23:14:06
4131adca1ba15b7153d801849faee892bb8345c5...c8f02c62a0d8eaba0db6f37ace773cf87a85959a,3,18,4,22,4,2014-09-11 03:11:42,2014-09-11 02:41:27
c8f02c62a0d8eaba0db6f37ace773cf87a85959a...4181058eb63fbfd0e535d2d8b5936d1b011d9d9f,1,5,0,5,2,2014-09-11 03:11:42,2014-09-11 02:42:51
4181058eb63fbfd0e535d2d8b5936d1b011d9d9f...11d6138a1141c3b7f1b2affd52a20c469ff24500,1,3,4,7,1,2014-09-11 03:11:43,2014-09-11 02:49:23
11d6138a1141c3b7f1b2affd52a20c469ff24500...27a339ed81e85d2bafb9d67160892851775170db,1,2,0,2,1,2014-09-11 03:19:23,2014-09-11 03:19:23
27a339ed81e85d2bafb9d67160892851775170db...017b416681eeac3495d9624ea4e078ecab7651a2,2,19,4,23,3,2014-09-11 03:22:39,2014-09-11 03:22:39
3613ea03661ea084f3427a2381f0037eb20a5802...65491b75810fa5f963be53cf9ab11e5f80bdfb05,1,1,1,2,1,2014-08-29 00:17:44,2014-08-29 00:17:44
3bec66979a008870a0e1052401776d28fb60a1c7...eb1345efb3e9de9cbff98aa9693c98437b19d27d,1,1,0,1,1,2014-08-29 21:47:48,2014-08-29 21:47:48
eb1345efb3e9de9cbff98aa9693c98437b19d27d...ddb7285fbd97b7e9ac4adfedde7b2510f0a6069d,1,1,1,2,1,2014-08-29 22:21:26,2014-08-29 22:21:26
ddb7285fbd97b7e9ac4adfedde7b2510f0a6069d...dc1eca1768ed80648e2249741445d9cb1c9ac316,2,2,2,4,2,2014-08-29 22:30:02,2014-08-29 22:29:53
dc1eca1768ed80648e2249741445d9cb1c9ac316...230bebfd822e5a00da2748db4588725c68cddea3,1,2,2,4,3,2014-08-29 22:41:59,2014-08-29 22:41:59
230bebfd822e5a00da2748db4588725c68cddea3...c21f49c6e398dac9d4342d090cbafe13d439b80a,2,6,0,6,2,2014-08-29 23:20:42,2014-08-29 23:20:42
c21f49c6e398dac9d4342d090cbafe13d439b80a...7ee8d36456886e233538e9a89166c91479cd6634,1,6,0,6,1,2014-08-29 23:21:03,2014-08-29 23:20:40
7ee8d36456886e233538e9a89166c91479cd6634...e4c1e1839234f54734c92fd37aace584dd7f9dc8,1,1,1,2,1,2014-08-29 23:29:45,2014-08-29 23:29:14
e4c1e1839234f54734c92fd37aace584dd7f9dc8...2374ce38df115c38cfea1452c928b5a5e5cb5849,1,6,0,6,1,2014-08-29 23:29:45,2014-08-29 23:29:30
2374ce38df115c38cfea1452c928b5a5e5cb5849...f6b9a4bd2182c2517daaf8519d551d78a3094385,1,7,7,14,3,2014-08-30 00:13:26,2014-08-30 00:13:26
f6b9a4bd2182c2517daaf8519d551d78a3094385...16635af69f2ecf348a2fbe05cf87de9c0461ff88,1,19,18,37,9,2014-08-30 20:03:48,2014-08-30 20:03:48
a351edbd2ccb71909e8edc8a73910596e62c6fd0...6cc93c11a381af4a0f00172d0f28d8032d864185,2,3,3,6,4,2014-09-05 00:15:50,2014-09-05 00:15:50
211b523623b34df45e2286f8f2407ac92d037719...5eee458a0cfdb41b9b2aa233c7be9cf3bf3da716,1,30,21,51,9,2014-09-03 19:01:04,2014-09-03 19:01:04
5eee458a0cfdb41b9b2aa233c7be9cf3bf3da716...620b095ec872ab1ca1b1e062b40b5081fd2b21c9,1,23,12,35,2,2014-09-03 19:07:33,2014-09-02 21:55:58
620b095ec872ab1ca1b1e062b40b5081fd2b21c9...d0747212207f49ac4c8dcea449a9dca3183fda6c,1,1,1,2,1,2014-09-03 19:31:54,2014-09-03 19:31:54
fceacf2885965df2a91d6ed6d58797b5d4e9d262...9fefcb2a6ff00e3067659549b77e388557f33e2b,2,3,3,6,2,2014-08-19 19:58:32,2014-08-19 19:58:32
9fefcb2a6ff00e3067659549b77e388557f33e2b...ec3ecb35236915979e80a7463055cb88c02116f9,2,3,13,16,3,2014-08-19 21:10:00,2014-08-19 21:10:00
cd7e94a9ad4f2d098c68a9c09805a3ad89d864bd...d98161a22ac108690d03a250173f968dee03b34f,3,17,0,17,3,2014-08-21 03:15:47,2014-08-21 03:15:47
d98161a22ac108690d03a250173f968dee03b34f...28df4f7258df6930b0fa5892becde4c8962c6017,1,13,0,13,1,2014-08-21 04:01:26,2014-08-21 04:01:26
ef359e2d69cefc698de455d73f4ad8723b47e8e7...c18188722c5ffb3d0116724fc8bd35954ae7f547,3,17,0,17,3,2014-08-21 00:17:19,2014-08-21 00:17:19
be73e042a1bad00cd5218a1910223b772013148f...265e4e6814daa4e4747a26842edf550024139d94,1,1,0,1,1,2014-07-22 01:40:57,2014-06-12 07:21:51
265e4e6814daa4e4747a26842edf550024139d94...6b26cb1e8ea2220a67a33bbe9761a5bd355e4a68,1,2,2,4,2,2014-07-22 01:41:27,2014-07-22 01:41:27
996d34713998f1e8c04fe1a1d90aea39567c90ec...e82be799be088c4e4cfe34e304f2ad78c43edb50,4,4,4,8,4,2014-07-21 23:23:47,2014-07-21 23:20:30
e82be799be088c4e4cfe34e304f2ad78c43edb50...ab804499caf4b793451be4d13e99ed1bac59c47d,2,8,0,8,3,2014-07-21 23:38:39,2014-07-21 23:38:39
ab804499caf4b793451be4d13e99ed1bac59c47d...9dbc64ef06aefb354cdd622e6a5409495da2bd6e,4,7,4,11,7,2014-07-21 23:46:04,2014-07-21 23:46:04
9dbc64ef06aefb354cdd622e6a5409495da2bd6e...5918a51fef3583333bf214ef8118c41ca8c12f5c,3,37,14,51,15,2014-07-22 01:00:22,2014-07-22 00:56:11
5918a51fef3583333bf214ef8118c41ca8c12f5c...fa97fc74b2f27a962b5fc795ca61cf5d6a82c00f,1,2,2,4,2,2014-07-22 03:35:58,2014-07-22 03:08:20
fa97fc74b2f27a962b5fc795ca61cf5d6a82c00f...eb70a7c299879d8d97b3bb09dd2d651988e2d214,1,31,13,44,14,2014-07-22 21:24:17,2014-07-22 21:24:17
eb70a7c299879d8d97b3bb09dd2d651988e2d214...b863106075e375bff030276b73eabd2a1413d893,1,0,4,4,1,2014-07-22 23:30:13,2014-07-22 23:29:44
b863106075e375bff030276b73eabd2a1413d893...c1a5443ba79f01393a9cfabebc7d8a10c0c72222,2,2,2,4,2,2014-07-23 00:14:02,2014-07-23 00:13:43
c1a5443ba79f01393a9cfabebc7d8a10c0c72222...cbc12117a6d694ed4d91f35a0db0c2e51cfb6ee6,1,1,1,2,1,2014-07-23 00:37:53,2014-07-23 00:37:53
cbc12117a6d694ed4d91f35a0db0c2e51cfb6ee6...1e1f4b2e8a6969d6abf9684377610dd322b208da,8,129,61,190,54,2014-07-23 01:40:25,2014-07-23 01:40:25
1e1f4b2e8a6969d6abf9684377610dd322b208da...61bf03c8d38a5f987b4f469952d3f00bcb60e36e,1,1,1,2,1,2014-07-23 07:04:04,2014-07-23 06:06:02
61bf03c8d38a5f987b4f469952d3f00bcb60e36e...0f0c7b17099d8ce50e5d4d259c38efa7bf2d1cae,1,2,0,2,2,2014-07-23 07:04:17,2014-07-23 06:58:57
0f0c7b17099d8ce50e5d4d259c38efa7bf2d1cae...1e83c641838c39e9937a3faaa6e99dc20b0fa628,2,141,14,155,15,2014-07-23 19:40:51,2014-07-23 19:40:51
1e83c641838c39e9937a3faaa6e99dc20b0fa628...67c47a9086ff954f9880ea93eab4370b2721ac88,1,1,1,2,1,2014-07-23 20:56:37,2014-07-23 20:56:37
67c47a9086ff954f9880ea93eab4370b2721ac88...bfc0c46f20a3a258288d5de80862fe067136047b,1,47,19,66,5,2014-07-23 22:53:51,2014-07-23 22:38:54
bfc0c46f20a3a258288d5de80862fe067136047b...5ff34557a1ca063a3bc377acccd2d25b3c4be65d,4,26,5,31,5,2014-07-23 23:36:18,2014-07-23 23:36:07
5ff34557a1ca063a3bc377acccd2d25b3c4be65d...c7a1fdfead88743153c38d5a33008e57473495d4,1,7,1,8,1,2014-07-24 00:42:27,2014-07-24 00:42:27
c7a1fdfead88743153c38d5a33008e57473495d4...d66da2575be6dbd96ecb4ef42a557cdfad75a237,1,19,6,25,4,2014-07-24 00:50:59,2014-07-23 23:17:54
d66da2575be6dbd96ecb4ef42a557cdfad75a237...e92bc5b14195870b81cde41c1c873cc719de0613,3,14,3,17,5,2014-07-24 00:50:59,2014-07-23 23:19:13
e92bc5b14195870b81cde41c1c873cc719de0613...3dcd7e90662d23f3d9904f3b7b1dae4daac138d0,1,13,11,24,2,2014-07-24 00:51:00,2014-07-23 23:41:56
3dcd7e90662d23f3d9904f3b7b1dae4daac138d0...d0a81689f321ae42596c58e5a548969bd6ded44a,2,3,3,6,3,2014-07-24 00:51:00,2014-07-24 00:32:48
ac87de15d8567a195b1016a5b6e44b8a48f7b46c...f0d49522b3744ab89d79e3194318a3fb69ff4543,1,4,0,4,2,2014-07-20 20:17:53,2014-07-20 20:17:53
f0d49522b3744ab89d79e3194318a3fb69ff4543...5c98f8fbd0576badbd5a00432e70e813a7867e06,1,1,1,2,1,2014-07-20 22:08:21,2014-07-20 22:08:21
5c98f8fbd0576badbd5a00432e70e813a7867e06...1f1107261b3c87c0afca3d6c116887535f68c010,1,16,2,18,3,2014-07-20 22:36:11,2014-07-20 22:35:42
ac87de15d8567a195b1016a5b6e44b8a48f7b46c...98dd4b250da2074c297e5a3bf85d0739512d936f,1,4,0,4,1,2014-07-19 11:36:16,2014-07-19 11:36:16
98dd4b250da2074c297e5a3bf85d0739512d936f...3a1a575c54d5fce12580b58060c190317eed7624,1,1,1,2,1,2014-07-20 17:16:56,2014-07-20 17:16:56
738c27ad8d40a0e96695237350729cf4cc89b8cc...319ec389164ea0f8b7a183e4d27c8aa15d39f26f,3,31,90,121,14,2014-07-17 22:18:37,2014-07-17 22:18:37
319ec389164ea0f8b7a183e4d27c8aa15d39f26f...0a64950d6a50bf0abe48fd30240a031dfda77b6e,1,16,0,16,1,2014-07-17 22:41:39,2014-07-16 01:35:19
0a64950d6a50bf0abe48fd30240a031dfda77b6e...8bb675c0b6cceba2ed7e31f6f856c893cfb19faf,11,78,10,88,15,2014-07-17 22:41:39,2014-07-17 22:41:32
8bb675c0b6cceba2ed7e31f6f856c893cfb19faf...e404e2eb95309d15e4e0ae8e3fa36278aaf22613,3,25,3,28,5,2014-07-17 23:45:20,2014-07-17 23:45:20
e404e2eb95309d15e4e0ae8e3fa36278aaf22613...b33422fe830f12496a225e5c0b1971e8fb9eecd7,2,4,3,7,3,2014-07-18 02:36:23,2014-07-18 02:36:23
b33422fe830f12496a225e5c0b1971e8fb9eecd7...3b4c9098a9c5b5d2ecfa92faf54316ec2e0a6ab6,3,133,3,136,7,2014-07-21 21:05:45,2014-07-21 21:05:45
738c27ad8d40a0e96695237350729cf4cc89b8cc...c3891fc8231069d7c050bf2c039bc855aa523578,8,104,87,191,44,2014-07-16 21:24:59,2014-07-16 18:34:55
c3891fc8231069d7c050bf2c039bc855aa523578...50ec6b68ea2a73010817499422f83055bff5aa22,12,120,70,190,35,2014-07-17 23:11:52,2014-07-17 23:11:52
50ec6b68ea2a73010817499422f83055bff5aa22...fb5cf61a8eaef315016020ffea1dfd92985f0a6f,13,126,45,171,42,2014-07-18 03:53:47,2014-07-18 03:53:47
fb5cf61a8eaef315016020ffea1dfd92985f0a6f...fba32514e309e970f58f8e44c6c313ff743258c4,8,103,45,148,27,2014-07-18 23:42:42,2014-07-18 23:42:42
fba32514e309e970f58f8e44c6c313ff743258c4...03c5c425f85e494a8323944c7e698b33cf80f652,15,56,68,124,56,2014-07-19 01:59:00,2014-07-19 01:59:00
03c5c425f85e494a8323944c7e698b33cf80f652...91f7765226a664a74e821c419a4fb1e2c6070300,1,0,3,3,1,2014-07-19 02:03:43,2014-07-19 02:03:43
91f7765226a664a74e821c419a4fb1e2c6070300...1b0ba45d08b31fb3d8dd292139a4eee3381874e7,2,10,1,11,4,2014-07-22 02:28:47,2014-07-22 02:28:47
1b0ba45d08b31fb3d8dd292139a4eee3381874e7...d24886bd8dd07b6f0de93ff718b7e3a28adeee27,1,1,0,1,1,2014-07-22 18:44:33,2014-07-22 18:44:23
d24886bd8dd07b6f0de93ff718b7e3a28adeee27...1f12fb47b03dd1ca55bff439b3ed3c8065a09a96,1,16,0,16,1,2014-07-22 18:50:05,2014-07-22 18:50:05
1f12fb47b03dd1ca55bff439b3ed3c8065a09a96...37ee04427ade620794737a0965dee739c5c3aecc,2,3,3,6,3,2014-07-22 18:51:04,2014-07-22 18:49:56
37ee04427ade620794737a0965dee739c5c3aecc...9eb728a7e8b344029b0bad32d100da931c0cb1d3,1,1,0,1,1,2014-07-22 18:51:04,2014-07-22 18:50:17
b64a644671e9f34898603e09567acfda7cac49fc...6a726e58433a6e639b9610372afe0906441c3b1d,2,11,12,23,2,2014-07-22 20:42:07,2014-07-22 20:42:07
6a726e58433a6e639b9610372afe0906441c3b1d...e222e69ccaccbade8c9c2ca2e6565b7aed65c4ee,2,11,7,18,3,2014-07-22 20:56:47,2014-07-22 20:56:47
e222e69ccaccbade8c9c2ca2e6565b7aed65c4ee...f278422835b30524b660281620c5784d5daf24c2,3,12,11,23,7,2014-07-22 20:57:37,2014-07-22 20:42:32
f278422835b30524b660281620c5784d5daf24c2...e79580cd80204d05e6115345d4f36ad33532b0fc,3,6,9,15,4,2014-07-22 20:57:37,2014-07-22 20:57:06
e79580cd80204d05e6115345d4f36ad33532b0fc...33775847677dcda9606d3db3d4dbb1ec42419a39,3,36,32,68,23,2014-07-22 22:59:41,2014-07-22 22:59:41
33775847677dcda9606d3db3d4dbb1ec42419a39...4f3dc51119351faafb36f3177a8b44c8fa0bd36a,3,50,7,57,11,2014-07-23 01:15:07,2014-07-23 01:15:07
4f3dc51119351faafb36f3177a8b44c8fa0bd36a...4f7bbd47dfc0199cdef177cf471a770f908577c3,1,8,0,8,1,2014-07-23 01:20:13,2014-07-23 01:20:13
4f7bbd47dfc0199cdef177cf471a770f908577c3...5a6a89578e103588a4f589d058861fc1e7e16371,1,33,2,35,9,2014-07-23 02:12:34,2014-07-23 02:11:20
5a6a89578e103588a4f589d058861fc1e7e16371...d4d391f50ac5fb5a79ad96db462411de2c22a8c4,1,2,2,4,2,2014-07-23 02:25:23,2014-07-23 02:25:23
d4d391f50ac5fb5a79ad96db462411de2c22a8c4...46ecdff6d03c96185d3c92fd5045967b763d879c,2,30,11,41,10,2014-07-23 03:00:20,2014-07-23 03:00:20
46ecdff6d03c96185d3c92fd5045967b763d879c...72c3df7c89771e0e12a62875b4a9d86dc53a6259,5,52,40,92,11,2014-07-23 18:13:15,2014-07-23 18:13:15
72c3df7c89771e0e12a62875b4a9d86dc53a6259...10d17b12afcd43f5a4d1bd1e41e353215764f51f,1,8,2,10,2,2014-07-23 18:19:19,2014-07-23 18:19:19
10d17b12afcd43f5a4d1bd1e41e353215764f51f...3866b6cb986d402a5cde0c8462d7f4e33e344866,1,4,1,5,2,2014-07-23 18:21:19,2014-07-23 18:21:19
3866b6cb986d402a5cde0c8462d7f4e33e344866...c4d4a97272a88aae09a73135e5eb703d1677f4ce,3,62,22,84,13,2014-07-23 22:57:33,2014-07-23 22:57:33
c4d4a97272a88aae09a73135e5eb703d1677f4ce...fd67786c9e44e9e5f7ae59ca99e428bd088d453e,5,17,0,17,7,2014-07-24 00:46:00,2014-07-24 00:46:00
fd67786c9e44e9e5f7ae59ca99e428bd088d453e...13c0d3e0ed92f4e066ebca09cb66d80c2cb38fc6,1,11,0,11,1,2014-07-24 23:02:37,2014-07-24 23:02:37
13c0d3e0ed92f4e066ebca09cb66d80c2cb38fc6...5649b0347fd6a9c9019f19e5674f74e6795fa0d8,4,78,61,139,40,2014-07-25 00:39:11,2014-07-25 00:39:11
5649b0347fd6a9c9019f19e5674f74e6795fa0d8...e2bd2a3d420841803b972035dedbc86d28a84f0a,3,72,2,74,6,2014-07-25 00:41:20,2014-07-25 00:41:20
e2bd2a3d420841803b972035dedbc86d28a84f0a...4ca9c9818c3d3826ee61ca557bf7971bc4ddaede,1,66,24,90,14,2014-07-25 17:51:11,2014-07-25 17:51:11
204959b5092265455abc2482d17622a8aa3d7b9c...390dafea01381d375be21f0bd126ddc7fd0a0582,2,67,68,135,2,2014-01-28 05:18:24,2014-01-28 05:18:24
390dafea01381d375be21f0bd126ddc7fd0a0582...ed83f00fc108b1c61ddd06c1b4362b3ffc6fd055,3,36,9,45,9,2014-01-28 05:19:32,2014-01-28 05:19:32
ed83f00fc108b1c61ddd06c1b4362b3ffc6fd055...782ff1bcaee22dc2cd8e1dda6bdb7b2932d632a1,2,3,3,6,3,2014-01-28 05:40:24,2014-01-28 05:23:07
782ff1bcaee22dc2cd8e1dda6bdb7b2932d632a1...980b70596d323f818156b0749f5998268b384e2e,1,13,5,18,1,2014-01-28 05:56:17,2014-01-28 05:55:36
980b70596d323f818156b0749f5998268b384e2e...a65b978972d6f2111254c19fc5b6a1b6b53b43e6,1,72,79,151,22,2014-01-28 05:57:00,2014-01-25 01:04:13
3caa3b9e9c4cb1741034e07e4d50f300c4dbefaf...d398fb2ce133993b2604ed09b476e4a747d219c4,6,8,8,16,7,2014-06-18 05:54:53,2014-06-16 18:48:26
3caa3b9e9c4cb1741034e07e4d50f300c4dbefaf...b0d86e535c394d1725f7b9ba6692e5587375325f,6,6,6,12,6,2014-02-27 01:48:17,2014-02-27 01:48:17
6a71f362812edd4a3093ea5e6f4d369a14de9acd...9376c631be5e425ef0c2c706f2ca69fb71310923,1,1,0,1,1,2014-10-28 18:34:30,2014-10-28 18:34:30
9376c631be5e425ef0c2c706f2ca69fb71310923...b60bc258dad8204ffd949586cd82017c4840d970,1,1,1,2,1,2014-10-28 22:00:14,2014-10-28 20:44:15
b60bc258dad8204ffd949586cd82017c4840d970...efaf0d54b9958345edf351022fea1b16f32e8541,1,5,1,6,3,2014-10-28 22:41:37,2014-10-28 21:24:18
d46e14a0aaa39e7bc34f3ded487cd8c0d7136b70...348f9e7247e32eae02e7f93242c6fe947659bede,1,349,211,560,25,2014-10-14 20:06:38,2014-10-14 20:06:38
348f9e7247e32eae02e7f93242c6fe947659bede...6fa31d2f601f4832798d48dc1fce131c3bdb6d9b,2,2,2,4,2,2014-10-14 20:08:20,2014-10-14 20:08:20
6fa31d2f601f4832798d48dc1fce131c3bdb6d9b...10beafc3001679ff602817a518cca2dbb2c8a623,1,0,44,44,1,2014-10-14 20:11:03,2014-10-14 20:11:03
10beafc3001679ff602817a518cca2dbb2c8a623...63de045e62b4e97e5da17be94135d2ecf9f7b4cc,6,72,90,162,22,2014-10-14 20:26:53,2014-10-14 20:26:53
63de045e62b4e97e5da17be94135d2ecf9f7b4cc...4585960bb2f09ed0640cb7fd979e7aac30402968,1,12,12,24,2,2014-10-14 20:28:17,2014-10-14 20:28:17
4585960bb2f09ed0640cb7fd979e7aac30402968...0221b444e96bf0e9e7aca78dba35d5dec29f3f7a,1,44,33,77,8,2014-10-14 20:40:11,2014-10-14 20:40:11
0221b444e96bf0e9e7aca78dba35d5dec29f3f7a...a2ea5c353bcb0e70e14f088565aed231009b1325,1,6,1,7,2,2014-10-14 20:40:29,2014-10-14 20:40:29
a2ea5c353bcb0e70e14f088565aed231009b1325...6ceee6e53d6752a3f785c2fa07cefe04f5bfce95,1,2,0,2,1,2014-10-14 20:40:56,2014-10-14 20:40:56
6ceee6e53d6752a3f785c2fa07cefe04f5bfce95...f35f40b87f00bcc82d4739b349b78899afd1d3d3,1,18,6,24,9,2014-10-14 20:48:23,2014-10-14 20:48:23
f35f40b87f00bcc82d4739b349b78899afd1d3d3...ec825f42a486a259e192e8f5dcb745e62f676f3e,1,6,68,74,8,2014-10-14 20:54:21,2014-10-14 20:54:21
ec825f42a486a259e192e8f5dcb745e62f676f3e...710909558b9b24555ea0033b0fa53904e7ef6fc8,1,2,0,2,2,2014-10-14 20:55:28,2014-10-14 20:55:28
710909558b9b24555ea0033b0fa53904e7ef6fc8...a82c7e1322b50ff8a7f58c35d7c8456f7ff2fe0e,1,33,18,51,22,2014-10-14 21:13:51,2014-10-14 21:13:51
a82c7e1322b50ff8a7f58c35d7c8456f7ff2fe0e...17820ee418cea731a6c6b39daa4600669eb1e640,1,1,1,2,2,2014-10-14 21:16:27,2014-10-14 21:16:27
17820ee418cea731a6c6b39daa4600669eb1e640...75495841a8063bbe41b7ced44f60b0745807f9f9,2,134,134,268,2,2014-10-15 14:53:13,2014-10-15 14:53:13
75495841a8063bbe41b7ced44f60b0745807f9f9...d0727d4e3af26cfbb9a57eead65ba64a9e8744b0,1,107,103,210,3,2014-10-15 14:56:43,2014-10-15 14:56:43
d0727d4e3af26cfbb9a57eead65ba64a9e8744b0...de2bbb7952e2b195720feb92527bde61070b37e9,6,119,54,173,34,2014-10-15 16:02:08,2014-10-15 16:02:08
de2bbb7952e2b195720feb92527bde61070b37e9...98ccd092659966be9c03383884880d9e8a3fce80,1,1,17,18,4,2014-10-15 16:33:28,2014-10-15 16:33:28
98ccd092659966be9c03383884880d9e8a3fce80...f2ea4c29f1906db0a619615814f82b720a3c6d8e,2,58,196,254,26,2014-10-15 17:49:30,2014-10-15 17:49:30
f2ea4c29f1906db0a619615814f82b720a3c6d8e...2438e3e65922320fda1b86300cfc3a6b3bacd160,3,60,44,104,24,2014-10-15 21:10:16,2014-10-15 21:00:36
2438e3e65922320fda1b86300cfc3a6b3bacd160...cea748a5b9692bd4ff6c7a7ea19135655716d54d,1,4,0,4,3,2014-10-15 21:13:06,2014-10-15 21:13:06
cea748a5b9692bd4ff6c7a7ea19135655716d54d...310cb57b2eab52665ab6708eded8236dad78c0c3,1,8,6,14,3,2014-10-16 01:38:06,2014-10-16 01:38:06
d46e14a0aaa39e7bc34f3ded487cd8c0d7136b70...4462c18964168ce40ae5ba18be68e8e6f5a1122a,2,3,3,6,3,2014-10-13 23:27:05,2014-10-01 08:33:31
4462c18964168ce40ae5ba18be68e8e6f5a1122a...6c793b427cd270493950504924630aaafa839625,1,1,1,2,1,2014-10-13 23:42:04,2014-10-02 23:15:01
6c793b427cd270493950504924630aaafa839625...16e9196a8ea3003e7314ecb19b037bca219daea9,1,1,0,1,1,2014-10-14 00:07:14,2014-10-14 00:06:58
16e9196a8ea3003e7314ecb19b037bca219daea9...364b09ffda7ae4db5f31dc8dc9961cef50bfd641,1,20,0,20,1,2014-10-14 00:20:50,2014-10-14 00:20:50
364b09ffda7ae4db5f31dc8dc9961cef50bfd641...ba41957243f28af624dca5fc8881f5ef9bb99800,1,37,0,37,1,2014-10-14 00:25:35,2014-10-14 00:25:35
ba41957243f28af624dca5fc8881f5ef9bb99800...dbef8b72471ba234d1f52910f4609c8bfbce9ca5,1,1,1,2,1,2014-10-14 00:26:09,2014-10-14 00:25:38
dbef8b72471ba234d1f52910f4609c8bfbce9ca5...4d64c493d65d33dca2669a54831526e3a6b48f11,1,1138,0,1138,1,2014-10-14 00:29:10,2014-10-14 00:28:23
4d64c493d65d33dca2669a54831526e3a6b48f11...441d35dc38154672ae575b689a236d6864addf67,1,1,0,1,1,2014-10-14 00:30:42,2014-10-05 12:25:50
441d35dc38154672ae575b689a236d6864addf67...51a23fc346191267baf9f57620720ada72d64088,10,70,74,144,22,2014-10-14 00:30:50,2014-10-13 23:24:43
51a23fc346191267baf9f57620720ada72d64088...8f3966fbf4207cab9f46e470e3103502a9cce453,3,6,6,12,6,2014-10-14 00:36:40,2014-10-14 00:36:21
8f3966fbf4207cab9f46e470e3103502a9cce453...504574876e2b171e4a6f26cfece91790cffc6600,1,2,2,4,2,2014-10-14 00:40:54,2014-10-07 09:42:25
504574876e2b171e4a6f26cfece91790cffc6600...3c98e47709a2ba8b15f2829bc4027168d998e003,1,2,2,4,2,2014-10-14 00:43:39,2014-10-14 00:43:22
3c98e47709a2ba8b15f2829bc4027168d998e003...3ec522f9e4f4f9a49b7cb1ce7612cbe20a8f0a5e,1,2,0,2,1,2014-10-14 00:49:06,2014-10-14 00:48:37
3ec522f9e4f4f9a49b7cb1ce7612cbe20a8f0a5e...98f5445f37c10b6747f485e9d491b2ccfa9d510e,1,7,3,10,1,2014-10-14 00:50:13,2014-10-14 00:50:13
6a031c1daf55468ccef0df241206d9da9194da30...36cde0a160f6b5f65f735d05fc5c25bf5ad9de29,2,7,5,12,6,2014-10-03 04:29:39,2014-10-03 04:29:39
36cde0a160f6b5f65f735d05fc5c25bf5ad9de29...84c186676840e6f048c97c2f96ecadab4c6ca42e,1,6,2,8,1,2014-10-03 04:54:54,2014-10-03 04:54:03
84c186676840e6f048c97c2f96ecadab4c6ca42e...6b417cc4931cd11c1ce56d47bb62f2cef54274e9,2,69,10,79,5,2014-10-03 05:23:22,2014-10-03 05:23:22
6b417cc4931cd11c1ce56d47bb62f2cef54274e9...ef46eeb1bead8bad308ea660a1265699835cfa30,2,5,2,7,3,2014-10-03 05:30:04,2014-10-03 05:30:04
ef46eeb1bead8bad308ea660a1265699835cfa30...13353132ec7937fade8462835fb95e53dc2cf57a,2,23,4,27,2,2014-10-03 05:42:47,2014-10-03 05:42:47
13353132ec7937fade8462835fb95e53dc2cf57a...e4b0cd4910f6d542a1f09627594ac0ee7f0d9456,1,4,4,8,4,2014-10-03 05:45:50,2014-10-03 05:45:50
e4b0cd4910f6d542a1f09627594ac0ee7f0d9456...98b507ca5bd9da0017482d42b088282a89e9c018,2,3,3,6,3,2014-10-03 05:48:03,2014-10-03 05:48:03
98b507ca5bd9da0017482d42b088282a89e9c018...beafe491c42c6fc490a828a2b775e23d7472c171,1,18,0,18,2,2014-10-03 05:57:45,2014-10-03 05:57:45
beafe491c42c6fc490a828a2b775e23d7472c171...83743846d971925f0b90b36f5354c477ff183800,1,1,1,2,1,2014-10-03 06:03:43,2014-10-03 06:03:43
83743846d971925f0b90b36f5354c477ff183800...b4d0bb593bccd9eb372e9fbdadebd45275407eb3,1,8,5,13,3,2014-10-03 06:43:43,2014-10-03 06:43:43
b4d0bb593bccd9eb372e9fbdadebd45275407eb3...a263e08651b4f2e126646f7a34f2f5bf2d43c681,1,79,6,85,6,2014-10-03 14:36:50,2014-10-03 07:01:46
a263e08651b4f2e126646f7a34f2f5bf2d43c681...f1c8d558188bfebbab02dd086e973d80e38f3b73,1,188,154,342,12,2014-10-03 14:38:10,2014-10-03 14:36:11
f1c8d558188bfebbab02dd086e973d80e38f3b73...288035cbeed56568e68414070e11a44dbc009539,1,20,13,33,2,2014-10-03 14:46:11,2014-10-03 14:46:11
288035cbeed56568e68414070e11a44dbc009539...3f95047e1662f2459e217819d5ace445bc9027b9,1,5,10,15,7,2014-10-03 14:48:25,2014-10-03 14:48:25
3f95047e1662f2459e217819d5ace445bc9027b9...34f6c1be27d47a3eb8da1d2c3577b1623a7c5da5,1,3,6,9,4,2014-10-03 14:49:08,2014-10-03 14:49:08
34f6c1be27d47a3eb8da1d2c3577b1623a7c5da5...49455afd4dc13e73768d7f9e1b9c36c1bc48e31e,1,4,0,4,2,2014-10-03 14:53:04,2014-10-03 14:53:04
49455afd4dc13e73768d7f9e1b9c36c1bc48e31e...c50bdca142a6532683215956c73c4d92baff5f91,4,47,5,52,10,2014-10-03 15:07:45,2014-10-03 15:07:45
c50bdca142a6532683215956c73c4d92baff5f91...d42030989de134021bfc8002aebe4c131d482293,2,3,1,4,2,2014-10-03 19:07:39,2014-10-03 19:07:39
1abc78c6fe8f74f32bc4f786a9022ed6c7a51ed2...0365d1230b9e98474ff2f6f655e879dde432a4fb,1,1,1,2,1,2014-10-02 22:24:06,2014-10-02 22:24:06
b7b9a530389afbf90295f3361d15c5393f305c73...5b2c7e6ddc8111b172f93c748c1e6427dc8f5101,1,2,6,8,1,2014-09-29 21:24:55,2014-09-25 04:56:56
15d74d67a86dc3b6787819752d08d97db302b537...6982aa41956f62059503f1d57f9f993dd7cd54b3,2,6,1,7,2,2014-10-01 03:06:23,2014-10-01 01:19:58
6982aa41956f62059503f1d57f9f993dd7cd54b3...48914cc6cbf70720e0a5cad774980a79314f17f3,1,19,11,30,12,2014-10-01 03:06:23,2014-10-01 01:24:05
48914cc6cbf70720e0a5cad774980a79314f17f3...f0932db7e11b8709084e0abf5bc0dfba80c19455,1,24,1,25,2,2014-10-01 03:06:23,2014-10-01 03:05:44
f0932db7e11b8709084e0abf5bc0dfba80c19455...ef29e4abaedf383b7588ba0bd086616c314411f2,5,123,25,148,11,2014-10-01 03:53:33,2014-10-01 03:53:33
ef29e4abaedf383b7588ba0bd086616c314411f2...62b1c821855bb740e6abfb1e5c79d8d618a89d13,1,4,3,7,2,2014-10-01 03:53:50,2014-10-01 03:53:50
62b1c821855bb740e6abfb1e5c79d8d618a89d13...ef68181947c9e75a7a6d0e284f05a8f9a429655b,3,20,57,77,15,2014-10-01 04:25:14,2014-10-01 04:16:30
ef68181947c9e75a7a6d0e284f05a8f9a429655b...5c1bc191de604d353401ef712b0bdb8ccbb2c455,1,1,1,2,1,2014-10-01 05:06:00,2014-10-01 05:06:00
5c1bc191de604d353401ef712b0bdb8ccbb2c455...b5023c6541a803758e6f7d3c93fa3c75b9bf2429,1,1,1,2,1,2014-10-01 05:13:50,2014-10-01 05:13:09
b5023c6541a803758e6f7d3c93fa3c75b9bf2429...81565b1a6f4cb773f892487709935e1ecfd04c13,1,3,3,6,2,2014-10-01 05:28:30,2014-10-01 05:20:14
653c886ff3948d2ad77b8e9b08bd3910754c50ce...b0e8968b81f18437ca136cab4c4a5f58b12731b0,2,13,10,23,4,2014-09-29 21:10:20,2014-09-23 10:38:06
b0e8968b81f18437ca136cab4c4a5f58b12731b0...aa91cc4e6b25af942d5cd9414312ef3ddbf108f2,1,3,2,5,3,2014-09-29 23:18:38,2014-09-29 22:40:09
aa91cc4e6b25af942d5cd9414312ef3ddbf108f2...1cf9eef9d03ffe6811602695c3fe4812a4b790c5,1,7,2,9,1,2014-09-29 23:18:38,2014-09-29 22:43:28
1cf9eef9d03ffe6811602695c3fe4812a4b790c5...98eff9059e2acd5a03cd6dcfb3680cf3564cb614,14,35,35,70,35,2014-09-29 23:18:38,2014-09-29 23:07:10
98eff9059e2acd5a03cd6dcfb3680cf3564cb614...df6f93186b2e58c92f98ff322e3fcffd3a3b01a7,1,20,9,29,3,2014-09-29 23:18:38,2014-09-29 23:18:06
df6f93186b2e58c92f98ff322e3fcffd3a3b01a7...5e39040e418da92d4107fb0902998d809f597c76,1,33,8,41,6,2014-09-29 23:49:07,2014-09-29 23:49:07
f5f9b47da827c538a9127d1270b05cf5fe2b6cca...f24904b66c85fd17092a51f9874b38b1483bcddd,2,56,63,119,11,2014-10-02 09:18:12,2014-10-02 09:18:12
f24904b66c85fd17092a51f9874b38b1483bcddd...aa8eed5b44c082654ab4ec4eef3dd60ddb569e4c,2,13,3,16,4,2014-10-02 20:52:00,2014-10-02 20:52:00
aa8eed5b44c082654ab4ec4eef3dd60ddb569e4c...0e9150f374c0e53975ba5b9c8fc50a5b0f4ab6ee,1,1,1,2,1,2014-10-02 21:59:55,2014-10-02 21:59:55
0e9150f374c0e53975ba5b9c8fc50a5b0f4ab6ee...976b1fcda1f5f4a5ea544d3635177dd07b81f205,1,1,1,2,1,2014-10-02 22:21:11,2014-10-02 22:21:11
f5f9b47da827c538a9127d1270b05cf5fe2b6cca...09a6c8db97b4345ec7bf4b5a256a8e6ae75b7e48,3,13,0,13,3,2014-10-01 00:05:38,2014-10-01 00:05:04
09a6c8db97b4345ec7bf4b5a256a8e6ae75b7e48...b155e3a84d8cf90eeeda07f4e4c56f120386f2ef,1,239,1,240,2,2014-10-01 00:05:38,2014-10-01 00:05:19
b155e3a84d8cf90eeeda07f4e4c56f120386f2ef...8c77ab7192b74aa9bba7aff6cc486c59bb3ca0db,1,19,3,22,9,2014-10-01 00:48:32,2014-10-01 00:48:32
8c77ab7192b74aa9bba7aff6cc486c59bb3ca0db...a71f16be32317216c09d257dd1068865973ab424,3,15,0,15,3,2014-10-01 01:03:06,2014-10-01 01:02:38
a71f16be32317216c09d257dd1068865973ab424...aeee00b0cdc636b51ecd063896e874503083a0bd,2,15,0,15,2,2014-10-01 01:03:06,2014-10-01 01:02:51
aeee00b0cdc636b51ecd063896e874503083a0bd...c448c19936a406c91d39f13160b91e7c1343bb63,1,1,1,2,1,2014-10-01 01:32:32,2014-10-01 01:32:32
44ea500c7bcc887dd7dfb8c323906f91ce611511...6397b4918b7b2a731abb3c5b7b5e111f7914b61f,1,1,1,2,1,2014-09-23 06:06:37,2014-09-23 06:06:37
6397b4918b7b2a731abb3c5b7b5e111f7914b61f...6cbd06942c11db2309533cfaa64e8207dc3ee976,1,6,0,6,1,2014-09-23 07:12:03,2014-09-23 07:12:03
6cbd06942c11db2309533cfaa64e8207dc3ee976...e90baa1fccc5f298848d954d729e1c8d58b13b95,1,4,0,4,1,2014-09-23 07:16:37,2014-09-23 07:16:37
e90baa1fccc5f298848d954d729e1c8d58b13b95...b1e6a2a0aee2a7ad1652f6ff2059319176eea59a,3,86,54,140,31,2014-09-23 12:40:29,2014-09-23 12:40:29
1cf8b1d4d5c28b0ab49da8dee4d9d43980765229...64b0ea4f5b7bc42d13229d98ff3b571ab7dc305b,7,7,7,14,7,2014-09-25 06:41:17,2014-09-25 06:41:17
64b0ea4f5b7bc42d13229d98ff3b571ab7dc305b...7283735d00efcae5b127dd77df7cc8c0333513c6,1,1,1,2,1,2014-09-25 07:26:08,2014-09-25 07:26:08
7283735d00efcae5b127dd77df7cc8c0333513c6...020e1680f72e4d3ac6e73997d1a1a7f0d3719603,1,12,11,23,9,2014-09-25 18:30:00,2014-09-25 18:30:00
020e1680f72e4d3ac6e73997d1a1a7f0d3719603...1db094b411c0de5a80d8cf1082dac5fe9ec26273,5,32,65,97,13,2014-09-25 18:41:56,2014-09-25 18:41:56
1db094b411c0de5a80d8cf1082dac5fe9ec26273...3cb6ea87be80910e0d8ba7c3910713b94bbd29be,1,2,2,4,2,2014-09-25 18:42:07,2014-09-25 18:42:07
3cb6ea87be80910e0d8ba7c3910713b94bbd29be...648a4e2a09eb2bc6a350b058ba1f9d84abb09826,2,0,83,83,3,2014-09-25 18:42:16,2014-09-25 18:42:16
648a4e2a09eb2bc6a350b058ba1f9d84abb09826...5758bc8a2c2baf21e2cbc3e8339ecb41f9e6191a,2,2,2,4,2,2014-09-25 18:46:01,2014-09-25 18:41:45
5758bc8a2c2baf21e2cbc3e8339ecb41f9e6191a...90c5fc361986239f553a670b8a94db0e606ed8fa,1,1,1,2,1,2014-09-25 18:48:54,2014-09-25 18:48:54
90c5fc361986239f553a670b8a94db0e606ed8fa...e3c5743cec813cada3981586af9bd0545791a130,1,3,6,9,1,2014-09-25 21:57:39,2014-09-25 21:57:39
e3c5743cec813cada3981586af9bd0545791a130...41d8c711855f0fcae175d1de8346804cec395d41,1,4,1,5,1,2014-09-25 21:58:10,2014-09-25 21:58:10
41d8c711855f0fcae175d1de8346804cec395d41...1424e3ea4f34db68ca58cf24b9e31a14b1966bb0,2,1815,1815,3630,221,2014-09-25 22:34:25,2014-09-25 22:32:47
1424e3ea4f34db68ca58cf24b9e31a14b1966bb0...0e8f8e50396a4dfeb0c845bcd149f88febdf043e,1,1,1,2,1,2014-09-26 00:46:22,2014-09-26 00:46:22
0e8f8e50396a4dfeb0c845bcd149f88febdf043e...403cc2ff8c6115aa5d4fbb7f066f6f21ef5eb081,1,0,2,2,1,2014-09-26 01:10:02,2014-09-25 22:45:45
403cc2ff8c6115aa5d4fbb7f066f6f21ef5eb081...96cc3193a51a613d2555330042928c2a32e0fb13,4,29,7,36,6,2014-09-26 01:18:01,2014-09-26 01:13:59
96cc3193a51a613d2555330042928c2a32e0fb13...f53faf8c34a5e68ab6006d43f917182c19d68776,1,4,8,12,3,2014-09-26 01:24:24,2014-09-26 01:23:48
f53faf8c34a5e68ab6006d43f917182c19d68776...bab557d49bf417a59c464d63d28c9a226a7f6a75,44,44,44,88,44,2014-09-26 01:34:34,2014-09-26 01:31:59
bab557d49bf417a59c464d63d28c9a226a7f6a75...3dba734db44844789aeba155017b5a922cef393f,2,3,4,7,3,2014-09-26 01:42:41,2014-09-26 01:42:41
6efac4aafb644f93edb7d18fe82fd0580d280ca4...c592ec91adfa10cc87720e426cc17ca890deacd1,1,7,0,7,1,2014-09-25 22:33:32,2014-09-25 22:33:32
d223c21ae8e339bf43a304ca7892105a365a13c8...6b420acfead13d3860a82169847afa17608bbb52,1,8,2,10,2,2014-09-11 21:18:41,2014-09-10 02:41:02
6b420acfead13d3860a82169847afa17608bbb52...0eccb57f7a79bd4b31cae318ef3c3e9db521559f,3,81,17,98,29,2014-09-11 21:18:41,2014-09-10 03:36:14
0eccb57f7a79bd4b31cae318ef3c3e9db521559f...7e375f8457175b35bc3a1f04ec3c55bf9473484b,1,186,175,361,12,2014-09-11 21:18:42,2014-09-10 23:14:06
7e375f8457175b35bc3a1f04ec3c55bf9473484b...06c9bcca95a1eac2ac5ca0181e9ad25522ef1a72,3,18,4,22,4,2014-09-11 21:18:42,2014-09-11 02:41:27
06c9bcca95a1eac2ac5ca0181e9ad25522ef1a72...ca7e56fd01157e269d846112785abdb413c5dca2,1,5,0,5,2,2014-09-11 21:18:42,2014-09-11 02:42:51
ca7e56fd01157e269d846112785abdb413c5dca2...1355f59df2dda5a5dee62bfa3f2d4dbfa240119b,1,3,4,7,1,2014-09-11 21:18:42,2014-09-11 02:49:23
1355f59df2dda5a5dee62bfa3f2d4dbfa240119b...b0cc3bd155ba033a732f84c2ab67d768df080ce1,1,2,0,2,1,2014-09-11 21:18:42,2014-09-11 03:19:23
b0cc3bd155ba033a732f84c2ab67d768df080ce1...ae71b7857addbb1d122dc3c44d8a1f9f0028ae88,2,19,4,23,3,2014-09-11 21:18:42,2014-09-11 03:22:39
65491b75810fa5f963be53cf9ab11e5f80bdfb05...96952dda2b8b2bd5df8cf4556ebd8da2a535203a,65,299,264,563,241,2014-08-29 17:11:21,2014-08-29 17:11:21
96952dda2b8b2bd5df8cf4556ebd8da2a535203a...87b13e1b5a5e9d6f2b86c3d47a02a7fcce6562e4,15,116,105,221,69,2014-08-29 17:29:01,2014-08-29 17:29:01
87b13e1b5a5e9d6f2b86c3d47a02a7fcce6562e4...84f1fcace128207c5f6145a58d416af497f90334,22,112,109,221,77,2014-08-29 18:52:33,2014-08-29 18:52:33
84f1fcace128207c5f6145a58d416af497f90334...6b3d31ff5bb07a5fadbb5d22de0c7ca2492a16f5,62,230,265,495,215,2014-08-29 19:26:28,2014-08-29 19:26:28
6b3d31ff5bb07a5fadbb5d22de0c7ca2492a16f5...82d1db5107112dbc31bdcbbad60c6831ea1a7030,47,199,199,398,191,2014-08-29 19:28:32,2014-08-29 19:28:32
82d1db5107112dbc31bdcbbad60c6831ea1a7030...6cb69946ee7940217147ab195c443062c5083a51,1,16,0,16,3,2014-08-29 19:31:33,2014-08-29 19:31:33
6cb69946ee7940217147ab195c443062c5083a51...4328f9fb2351835538b38befc0a55e0b1ce53845,1,4,0,4,1,2014-08-29 19:33:23,2014-08-29 19:33:23
4328f9fb2351835538b38befc0a55e0b1ce53845...3a1af2a204cd2ade83d15497f7a86e903f56ffa4,1,1,0,1,1,2014-08-29 20:00:51,2014-08-29 20:00:51
3a1af2a204cd2ade83d15497f7a86e903f56ffa4...99ccb445ea00dfb9b99b32a0d06c1c6b34ff0550,2,2,1,3,2,2014-08-29 20:21:18,2014-08-29 20:21:18
16635af69f2ecf348a2fbe05cf87de9c0461ff88...e46cb230372ec423f673b755df6f43b58e0648ad,1,1,1,2,1,2014-09-01 06:45:24,2014-09-01 06:45:24
e46cb230372ec423f673b755df6f43b58e0648ad...808c90e3dbda2cc000b0603259cf197f3c618f4d,27,27,27,54,27,2014-09-01 07:16:00,2014-09-01 07:16:00
808c90e3dbda2cc000b0603259cf197f3c618f4d...fe558fd16b86c667ae1c7492315436b8a8e5e09b,1,1,1,2,1,2014-09-01 07:19:21,2014-09-01 07:19:21
fe558fd16b86c667ae1c7492315436b8a8e5e09b...87819dc7407c0b75c31155a7e4d3ad1f78b3117f,1,4,0,4,1,2014-09-02 17:18:37,2014-09-02 17:16:27
87819dc7407c0b75c31155a7e4d3ad1f78b3117f...173b7c8b98294d388cec5f4cc2141fd206fd15fb,2,2,2,4,1,2014-09-02 17:34:38,2014-09-02 17:34:38
16635af69f2ecf348a2fbe05cf87de9c0461ff88...624035fab8fb27b1d4f5d884518d92dd3d52e5e0,4,58,19,77,5,2014-08-30 22:11:01,2014-08-30 22:10:47
624035fab8fb27b1d4f5d884518d92dd3d52e5e0...45ca7f3defe3f9b502e0d9d43c2a0a20f3b18aae,2,2,2,4,2,2014-09-03 22:13:13,2014-09-03 22:13:13
45ca7f3defe3f9b502e0d9d43c2a0a20f3b18aae...b4592ea03da7c4c75938e79b7fe43c90cd3845a6,1,4,4,8,2,2014-09-03 22:18:41,2014-09-03 22:18:41
0b1d744731dc7fb4477331ebad5f5d62276000f1...5b8504efb2a02704ac6b3749e24f9348a00c07f5,1,0,2,2,1,2014-09-03 23:19:09,2014-09-03 23:16:58
5b8504efb2a02704ac6b3749e24f9348a00c07f5...4956f94b88ac528d34f26a38c48870109b262889,3,32,7,39,6,2014-09-04 18:13:04,2014-09-04 18:12:58
4956f94b88ac528d34f26a38c48870109b262889...5a8f843282d1eebdcc5a1a00511588a874332dc8,1,2,2,4,1,2014-09-04 18:25:40,2014-09-04 18:25:40
6d353044d48a2c5e87c65e57e0c9349e76400ee9...6e6a48a9135e7a578c8fbb010faf72851e4f92fb,1,2,2,4,2,2014-08-19 22:33:38,2014-08-19 22:33:38
6e6a48a9135e7a578c8fbb010faf72851e4f92fb...ff8498dd1b519bf2489e72430d47dc93e1ff8f36,1,12,5,17,5,2014-08-20 00:07:53,2014-08-20 00:07:53
5b0a398e846a1bc7c97b2da93207420599e111ac...b88df9943cfcff69358257487f1e741dfd3fa470,1,0,34,34,4,2014-08-25 17:59:54,2014-08-25 17:59:54
5b0a398e846a1bc7c97b2da93207420599e111ac...b78bca197eef226f11848150d1bdcb84d4416f5f,5,25,14,39,14,2014-08-21 04:19:50,2014-08-21 04:18:09
b78bca197eef226f11848150d1bdcb84d4416f5f...97b389b9d62aa82642e63a97e96caaf75af4303d,24,28,28,56,24,2014-08-21 04:37:56,2014-08-21 04:37:56
97b389b9d62aa82642e63a97e96caaf75af4303d...46ea7dcf30ad1cfa395ad8812e32d85210fd30de,24,28,28,56,24,2014-08-21 05:38:09,2014-08-21 05:38:09
46ea7dcf30ad1cfa395ad8812e32d85210fd30de...9c7d279dcf006a998e3d866ccb9b10e6756ca25c,4,41,27,68,29,2014-08-21 06:06:59,2014-08-21 06:06:59
9c7d279dcf006a998e3d866ccb9b10e6756ca25c...c05397be11abfa5a0fe447d844466b365f2333d0,24,28,28,56,24,2014-08-21 06:08:49,2014-08-21 06:08:49
c05397be11abfa5a0fe447d844466b365f2333d0...8d51254a2ca9d1aa90d070058693f275ca3dd691,1,7,6,13,4,2014-08-21 07:51:48,2014-08-21 07:51:48
8d51254a2ca9d1aa90d070058693f275ca3dd691...1d3f8bc14520eb354df01f9c40d2126e1fa7c507,1,4,2,6,2,2014-08-21 07:59:27,2014-08-21 07:58:35
1d3f8bc14520eb354df01f9c40d2126e1fa7c507...ab1db51f55fb35181f1d8917a726d7b392c73a9a,7,7,7,14,7,2014-08-21 08:05:40,2014-08-21 08:05:40
ab1db51f55fb35181f1d8917a726d7b392c73a9a...2c35df291b656a0078d6ee37b4be8cea8126c131,1,1,1,2,1,2014-08-21 08:43:36,2014-08-21 08:43:36
556c0e28e94b9351cbf0b28e80a71a4e35f1362a...3c0f3bac1472cc2048f3bf13fd97b2a1ff432f28,1,1,1,2,1,2014-07-22 10:37:01,2014-07-22 10:37:01
d0a81689f321ae42596c58e5a548969bd6ded44a...bc7b92a6438cf374922d551d38a8567158976359,3,5,29,34,8,2014-07-24 00:54:16,2014-07-23 03:42:05
bc7b92a6438cf374922d551d38a8567158976359...5e94e9e2d3f25172c1a5794d9f11f9ee27901bce,1,9,29,38,6,2014-07-24 00:54:16,2014-07-23 06:35:58
5e94e9e2d3f25172c1a5794d9f11f9ee27901bce...ff7a2fba923f5de7ac07b4a1ab8a9f8d4bdb5504,2,35,9,44,9,2014-07-24 00:54:16,2014-07-24 00:34:29
960f8907d370e85fb0c1e11f989942d09c9570e6...d2af5ea13bc4522c9cc8d15f64f7536b28bab657,1,32,0,32,1,2014-07-25 20:53:35,2014-07-25 20:53:35
d2af5ea13bc4522c9cc8d15f64f7536b28bab657...77fb55846bdfc2339c85a468067c04aef007f511,2,3,3,6,2,2014-07-25 22:17:21,2014-07-25 22:17:21
77fb55846bdfc2339c85a468067c04aef007f511...98e3a4be032586aa01f19157e2fb283010479c9b,1,0,1,1,1,2014-07-25 22:18:44,2014-07-25 22:18:44
98e3a4be032586aa01f19157e2fb283010479c9b...16db6d53632eabbfb7961c5a0cd0efd230afa5a3,1,3,2,5,1,2014-07-25 22:26:39,2014-07-25 22:26:39
16db6d53632eabbfb7961c5a0cd0efd230afa5a3...c4f1c8483338c19a141ab70fb1d5710b424fdcc3,1,8,14,22,5,2014-07-25 22:56:34,2014-07-25 22:56:34
c4f1c8483338c19a141ab70fb1d5710b424fdcc3...dd74ae7564f19155903a552350cc7a7bbce8f7b1,2,48,54,102,14,2014-07-26 00:06:37,2014-07-26 00:06:37
dd74ae7564f19155903a552350cc7a7bbce8f7b1...c6b6e71feddc7596587eb9024f69aa0897b0a024,8,162,155,317,17,2014-07-26 01:56:14,2014-07-26 01:56:14
c6b6e71feddc7596587eb9024f69aa0897b0a024...0848e6f82f5d357acb2b57340c01439aa55e62a4,4,20,16,36,6,2014-07-26 06:36:21,2014-07-26 06:36:21
0848e6f82f5d357acb2b57340c01439aa55e62a4...2dc153a4366b55366451f915337cc2d8e940caf7,1,14,4,18,1,2014-07-26 07:20:04,2014-07-26 07:20:04
2dc153a4366b55366451f915337cc2d8e940caf7...ae8c412c38f08ddcfde9a09ae048e5c5d2f0a59d,2,32,23,55,12,2014-07-28 18:57:28,2014-07-28 18:57:28
297b97659b0ca71dd2065242e6d455c7581f4667...cb2f2adb1bd1a88a9fd651fe797592e2cd725941,1,5,3,8,3,2014-01-28 18:11:27,2014-01-28 18:11:27
cb2f2adb1bd1a88a9fd651fe797592e2cd725941...604cd853f3c63b4f64161742bbc4767a310bbba9,2,4,6,10,2,2014-01-28 19:57:36,2014-01-28 19:57:36
efaf0d54b9958345edf351022fea1b16f32e8541...d5d97431e2bd83cf4b439f2051975ac763063209,1,2,2,4,1,2014-10-30 17:18:13,2014-10-30 09:53:16
d5d97431e2bd83cf4b439f2051975ac763063209...08cd4cbcbee368f43fb934d3225196f80fcce3c5,1,2,2,4,2,2014-11-07 22:51:27,2014-11-07 15:42:26
08cd4cbcbee368f43fb934d3225196f80fcce3c5...8b34d0008abd036b472108b18107fdd58b37f3ec,3,5,4,9,6,2014-12-04 20:11:47,2014-11-09 15:31:30
8b34d0008abd036b472108b18107fdd58b37f3ec...d6ec53b37d153eba5a4ce6629bcfd544263ddf7f,2,6,2,8,4,2014-12-04 20:16:49,2014-12-04 20:16:49
710fb1fa804aaa166a1e576eaa22f0d2ac95f413...c8d157b6fecf18358afd550e39771be84c9d0fe1,2,8,0,8,2,2014-10-28 17:47:16,2014-10-28 17:44:36
c8d157b6fecf18358afd550e39771be84c9d0fe1...19ead0ec1eaf7eab2524fb0af3b43c6837425405,1,2,2,4,1,2014-10-28 17:55:10,2014-10-28 17:55:10
98f5445f37c10b6747f485e9d491b2ccfa9d510e...bd9dcf9643d69243de5aad7e0a184583e391db70,1,1,1,2,1,2014-10-14 01:00:25,2014-10-13 11:44:33
bd9dcf9643d69243de5aad7e0a184583e391db70...619faab29f419170f15d82a72a9e7501c69d079a,1,1,1,2,1,2014-10-14 01:04:14,2014-10-14 01:04:14
d42030989de134021bfc8002aebe4c131d482293...3069788e018c22ae8f873eb0f8baac945519eecc,14,259,68,327,45,2014-10-03 19:11:44,2014-10-03 00:06:04
c98e6d8afb5166a5a2ee7b31d6c4a5d11b731b94...13cc3c3ad6d0fe2bbc60d9746d5d8e2ae1b0635a,2,1,3,4,3,2014-10-02 23:18:10,2014-10-02 23:14:27
13cc3c3ad6d0fe2bbc60d9746d5d8e2ae1b0635a...81b963d729fb61a81a2d5f5a4867835678dbf8b9,4,42,51,93,20,2014-10-02 23:47:02,2014-10-02 23:47:02
81b963d729fb61a81a2d5f5a4867835678dbf8b9...34b16d226ccd7dba9b20313ca413f8cb7335047b,1,2,2,4,2,2014-10-02 23:48:35,2014-10-02 23:48:35
34b16d226ccd7dba9b20313ca413f8cb7335047b...83a8c10a0a3396ac208fe44c804998b7beb4ba8d,2,2,2,4,2,2014-10-02 23:49:31,2014-10-02 23:49:31
83a8c10a0a3396ac208fe44c804998b7beb4ba8d...3641e48eb685c37d6dd0d6014d2f39a10a2b47d1,2,6,5,11,3,2014-10-03 00:24:22,2014-10-03 00:24:22
3641e48eb685c37d6dd0d6014d2f39a10a2b47d1...7d774565098a8f56d5f3e0e685cbf8c376dc2b5e,1,2,2,4,1,2014-10-03 00:31:03,2014-10-03 00:31:03
7d774565098a8f56d5f3e0e685cbf8c376dc2b5e...e0f8062c35b6397cf2f73d4cb733b4749e7a91ca,1,1,1,2,1,2014-10-03 00:31:32,2014-10-03 00:30:59
e0f8062c35b6397cf2f73d4cb733b4749e7a91ca...d3880241f5877af2225ed3c2cbbcf86f875d84fd,1,1,1,2,1,2014-10-03 00:34:53,2014-10-03 00:34:41
d3880241f5877af2225ed3c2cbbcf86f875d84fd...eda7709316baac6bb330a88ba0064d2e485aeb2a,2,19,7,26,4,2014-10-03 00:46:57,2014-10-03 00:46:57
eda7709316baac6bb330a88ba0064d2e485aeb2a...d5c2849fed5d4b7f39bacc4fce61ffa396b41ecf,1,1,1,2,1,2014-10-03 02:44:01,2014-10-03 02:44:01
67b71342e3451c25b58c12a13be4608f0c20c7f0...a272d3c6e9c5579764adb36c6b0d85f626977ce7,1,1,1,2,1,2014-09-29 22:01:06,2014-09-28 06:33:11
8bd7a14993c094d380ea158801492c83b9269cfa...b63d16667eac2a26fbdaf0526321e196751370d1,1,1,1,2,1,2014-09-30 02:01:05,2014-09-30 02:01:05
b63d16667eac2a26fbdaf0526321e196751370d1...d8ff8b626cafa84d695799a765f9b62e98ae7937,3,22,22,44,20,2014-09-30 02:09:05,2014-09-30 02:09:05
d8ff8b626cafa84d695799a765f9b62e98ae7937...5bc7851fd6620bf04c40714a3737b74ab7c59277,2,40,19,59,12,2014-09-30 03:03:39,2014-09-30 03:03:39
5e39040e418da92d4107fb0902998d809f597c76...257de8a62eccb82ab9ea7d7f3d3a71e4805c397d,5,120,53,173,31,2014-09-30 00:53:00,2014-09-26 01:02:18
257de8a62eccb82ab9ea7d7f3d3a71e4805c397d...c5fdf4556837859cfd1666aeb7ff217d89d56c29,3,144,44,188,17,2014-09-30 00:53:00,2014-09-29 18:18:11
c5fdf4556837859cfd1666aeb7ff217d89d56c29...e4cae7e105137f5e81795a18742470dc69aea94e,1,21,6,27,8,2014-09-30 00:53:01,2014-09-29 18:30:03
e4cae7e105137f5e81795a18742470dc69aea94e...3746f20e58ffa022d72ba3b1b8d2773d5bdbf9fe,1,1,1,2,1,2014-09-30 00:53:01,2014-09-29 18:39:24
3746f20e58ffa022d72ba3b1b8d2773d5bdbf9fe...f738340556b62b4ed2a81b1e5761a035715fec49,1,0,35,35,1,2014-09-30 00:53:01,2014-09-29 18:42:40
f738340556b62b4ed2a81b1e5761a035715fec49...1598e9c8267f580cb95747372bab9f693fa16e0d,1,2,1,3,1,2014-09-30 00:53:01,2014-09-29 18:50:36
1598e9c8267f580cb95747372bab9f693fa16e0d...1aa1b268b5b5e811d640c5ef088dd4a32538befb,1,19,21,40,2,2014-09-30 00:53:01,2014-09-29 18:51:09
1aa1b268b5b5e811d640c5ef088dd4a32538befb...8aeb0f7e44d68507e25ed1946adddcd3cdd31e3b,1,3,3,6,1,2014-09-30 00:53:01,2014-09-29 19:19:23
8aeb0f7e44d68507e25ed1946adddcd3cdd31e3b...1973971b205ddab7cfd441b175da4db4ef884a4a,1,66,0,66,1,2014-09-30 00:53:02,2014-09-29 19:19:43
1973971b205ddab7cfd441b175da4db4ef884a4a...56f5200078260917c7732118d8ddf5f8c02836c1,1,1,1,2,1,2014-09-30 00:53:02,2014-09-30 00:52:25
b1e6a2a0aee2a7ad1652f6ff2059319176eea59a...bc89e54d173be129d615323171fba409ba31cf09,1,2,1,3,1,2014-09-23 20:52:28,2014-09-23 20:52:28
bc89e54d173be129d615323171fba409ba31cf09...ffc65af2117536f5677f69495301ab8d5fff0dde,1,2,1,3,1,2014-09-23 21:21:14,2014-09-23 21:15:21
ffc65af2117536f5677f69495301ab8d5fff0dde...3377cca2f184ac63c880f585bb1a35e6b208195a,1,1,1,2,1,2014-09-23 21:22:20,2014-09-23 21:22:20
3377cca2f184ac63c880f585bb1a35e6b208195a...78d596998587bc97f3a55b4ad82b3564f2332773,1,0,1,1,1,2014-09-23 21:38:22,2014-09-23 21:37:42
78d596998587bc97f3a55b4ad82b3564f2332773...b19b269dc9613c4178c2a5bf037d57c84874b0e4,2,2,3,5,3,2014-09-23 22:00:43,2014-09-23 22:00:43
b1e6a2a0aee2a7ad1652f6ff2059319176eea59a...52360a91355a0a326ac9f3974a564a062f3d3cce,1,0,2,2,1,2014-09-23 18:36:45,2014-09-23 18:36:45
52360a91355a0a326ac9f3974a564a062f3d3cce...9055e8e0f2602d54d18ea9fa3a5c1a252f408942,1,9,9,18,3,2014-09-23 18:58:20,2014-09-23 18:57:10
9055e8e0f2602d54d18ea9fa3a5c1a252f408942...1f1ed7472493f9c2d326fe115a93eb0790e8b5ec,1,20,2,22,1,2014-09-23 19:29:50,2014-09-23 19:29:50
1f1ed7472493f9c2d326fe115a93eb0790e8b5ec...b76f81697666c9a8e6aed3b69a69c13542951d98,1,7,2,9,1,2014-09-23 20:51:46,2014-09-23 20:51:46
b76f81697666c9a8e6aed3b69a69c13542951d98...77649caa0aece4e7f3fa0e2f05f2e16b86f058e2,1,10,2,12,1,2014-09-23 21:35:34,2014-09-23 21:35:34
77649caa0aece4e7f3fa0e2f05f2e16b86f058e2...6663015cbd7ec339eab04ee2058a6fd2c4f5b186,1,1,0,1,1,2014-09-23 22:32:03,2014-09-23 22:32:03
6663015cbd7ec339eab04ee2058a6fd2c4f5b186...573f8462e53134db8e2744fef040e5e96592b382,2,14,3,17,4,2014-09-23 22:46:58,2014-09-23 22:46:58
573f8462e53134db8e2744fef040e5e96592b382...c1255aebd7426cb1bfb311beb6c1cdea6bb1188e,2,2,2,4,2,2014-09-23 22:48:03,2014-09-23 22:48:03
c1255aebd7426cb1bfb311beb6c1cdea6bb1188e...a2a1eef3bc66fbe33d1bd9e5e97e0f668705cacc,1,44,0,44,3,2014-09-24 00:04:16,2014-09-24 00:04:16
a2a1eef3bc66fbe33d1bd9e5e97e0f668705cacc...74c090e92a7ba44da34c76c798867159f090bcec,1,6,2,8,2,2014-09-24 00:26:28,2014-09-24 00:21:08
74c090e92a7ba44da34c76c798867159f090bcec...75a1c4c718687156e42f03c0864462d5f9933bf8,1,18,87,105,4,2014-09-24 00:36:56,2014-09-24 00:36:56
75a1c4c718687156e42f03c0864462d5f9933bf8...182b80734cfe1c08d13580fdef2e6d3e2827f508,1,13,7,20,3,2014-09-24 18:56:52,2014-09-24 18:56:52
182b80734cfe1c08d13580fdef2e6d3e2827f508...6f06298dbb408b57759e589f416c1264f45b9778,2,3,2,5,2,2014-09-24 19:02:34,2014-09-24 19:02:34
6f06298dbb408b57759e589f416c1264f45b9778...d02c7c9759d371ebdfa9f5f356f01fb5f7eea77a,1,7,0,7,1,2014-09-24 19:05:18,2014-09-24 19:05:18
d02c7c9759d371ebdfa9f5f356f01fb5f7eea77a...6faacb7fa34c75b53a7cf101cd2dcc2daa8bfd9b,1,13,0,13,2,2014-09-24 22:03:18,2014-09-24 21:58:47
6faacb7fa34c75b53a7cf101cd2dcc2daa8bfd9b...9fc5b15b2adaccd2e5d1708057af5395792e5088,3,31,14,45,16,2014-09-24 22:42:53,2014-09-24 22:42:53
9fc5b15b2adaccd2e5d1708057af5395792e5088...233d07c017b4e198d2062075fc32e19babe05ec3,1,7,4,11,3,2014-09-24 22:46:09,2014-09-24 22:46:09
233d07c017b4e198d2062075fc32e19babe05ec3...5beb6ef982772948aa526116665dcf90f77d50d0,1,11,8,19,5,2014-09-25 06:37:20,2014-09-25 06:37:20
5beb6ef982772948aa526116665dcf90f77d50d0...448ea0ea7fecff98916a95ae8fd33b55eead3f25,1,1,1,2,1,2014-09-25 06:38:18,2014-09-25 06:38:18
448ea0ea7fecff98916a95ae8fd33b55eead3f25...d68aa09c11bc3d846e3754244d8af761736b210e,3,13,48,61,8,2014-09-26 04:01:40,2014-09-26 04:01:40
d68aa09c11bc3d846e3754244d8af761736b210e...b392d7b7e025e21b43627bb7718b674cca6cddb3,1,1,1,2,1,2014-09-26 04:34:17,2014-09-26 04:34:17
b392d7b7e025e21b43627bb7718b674cca6cddb3...57e5cae447a77ffa74cb908aa09e3b9d670cef92,1,1,1,2,1,2014-09-26 05:44:09,2014-09-26 05:44:09
3dba734db44844789aeba155017b5a922cef393f...86c0b2b2aac88e8a32a474e0c7adf4e3ea125176,1,5,1,6,1,2014-09-30 23:16:21,2014-09-26 23:18:45
86c0b2b2aac88e8a32a474e0c7adf4e3ea125176...e540d72070f69d215b93589134ef8dbf9e7049a6,1,1,1,2,1,2014-09-30 23:16:26,2014-09-30 07:05:49
e540d72070f69d215b93589134ef8dbf9e7049a6...fcb3e09dd01ebd9fb4ab2c3c0d37185b83e82ccf,1,1,1,2,1,2014-09-30 23:16:31,2014-09-30 08:17:10
fcb3e09dd01ebd9fb4ab2c3c0d37185b83e82ccf...f6ffe668c4c6f361a8ba4cf0333d1ff2b1095eed,2,15,4,19,6,2014-09-30 23:16:38,2014-09-30 18:49:43
f6ffe668c4c6f361a8ba4cf0333d1ff2b1095eed...fdc4f350ceb3d0c3b86dc0e107816cfb33313596,1,2,2,4,2,2014-09-30 23:24:06,2014-09-30 23:24:06
fdc4f350ceb3d0c3b86dc0e107816cfb33313596...3664803d1a982f27a2dc0d41ba98dcfd7356d695,2,2,2,4,2,2014-09-30 23:37:00,2014-09-30 23:37:00
3664803d1a982f27a2dc0d41ba98dcfd7356d695...b20285e633d2ce6863d8dec41669df397df9e448,4,21,3,24,4,2014-10-01 01:10:41,2014-10-01 01:10:41
b20285e633d2ce6863d8dec41669df397df9e448...3c4e9e6a91be395bb980532d920ed4c14239fd4d,1,3,2,5,2,2014-10-01 01:13:54,2014-10-01 01:13:54
3c4e9e6a91be395bb980532d920ed4c14239fd4d...a31b44854b1ecf113f8aceb9245ddbc5719fcb53,1,1,0,1,1,2014-10-01 01:14:21,2014-10-01 01:14:21
3dba734db44844789aeba155017b5a922cef393f...098e95c4014e215c8c0edea0b5a910f3c2e67913,1,1,3,4,1,2014-09-26 02:21:22,2014-09-26 02:21:22
098e95c4014e215c8c0edea0b5a910f3c2e67913...4c0eaa4a57066da79e34ac5232dc1c6521418ffa,1,1,1,2,1,2014-09-26 02:26:30,2014-09-26 02:26:30
4c0eaa4a57066da79e34ac5232dc1c6521418ffa...e7e8669cf3238a89a0a07340636410201c07420f,4,24,24,48,18,2014-09-26 02:36:47,2014-09-26 02:36:47
e7e8669cf3238a89a0a07340636410201c07420f...0c3d8138cb723bb7d5691bd62496b35b5890c033,10,114,114,228,78,2014-09-26 02:39:26,2014-09-26 02:39:17
27af4c3da61638541b5ca14a91d03d9056ed5e5b...d5df1b9eb5d32bcb91baad764b59fcc25d936fe5,1,35,25,60,10,2014-09-11 22:57:22,2014-09-11 22:57:22
d5df1b9eb5d32bcb91baad764b59fcc25d936fe5...3e64bd78cd2e8428906bc590ae86fd7b49888b2a,1,4,0,4,3,2014-09-11 23:41:59,2014-09-11 21:41:11
3e64bd78cd2e8428906bc590ae86fd7b49888b2a...f7574429bdb5829b2682e77671d0ce80e93b0b63,1,1,1,2,1,2014-09-11 23:41:59,2014-09-11 23:40:44
f7574429bdb5829b2682e77671d0ce80e93b0b63...ba9ec26b97a67651fa1243968e1669ceb9087151,3,42,8,50,6,2014-09-12 19:27:52,2014-09-12 19:16:26
ba9ec26b97a67651fa1243968e1669ceb9087151...67b98ffeccc623acd0b6553f0375758cb9972b70,9,38,2,40,9,2014-09-12 19:31:36,2014-09-12 19:31:36
67b98ffeccc623acd0b6553f0375758cb9972b70...856110c4cec063b0932cfdd95879182e222900a2,3,63,30,93,22,2014-09-15 00:02:36,2014-09-15 00:02:10
856110c4cec063b0932cfdd95879182e222900a2...c246d04db141b16c9ba0030a6505d190d35f57c6,1,0,4,4,1,2014-09-15 02:09:15,2014-09-15 00:46:48
c246d04db141b16c9ba0030a6505d190d35f57c6...a4bc4c16e8fe9154114e9dbde163382d1c6df2d7,4,39,5,44,9,2014-09-15 02:09:37,2014-09-15 00:44:13
173b7c8b98294d388cec5f4cc2141fd206fd15fb...d80f35bdb05e3c5f8dc6f00f114cf3431cbe0f47,3,17,17,34,12,2014-09-03 17:17:13,2014-09-03 17:16:18
5a8f843282d1eebdcc5a1a00511588a874332dc8...aa3ceb466fb5b138ee9c8e7eec25c360d97dd66c,1,0,17,17,2,2014-09-04 22:57:32,2014-08-07 22:24:51
aa3ceb466fb5b138ee9c8e7eec25c360d97dd66c...aa7bc6b2b9286c1a17a1702fdf863e62bf5e25d6,1,4,26,30,3,2014-09-04 23:13:45,2014-09-04 23:13:45
aa7bc6b2b9286c1a17a1702fdf863e62bf5e25d6...04cc467582c6929097245ac58b117cb0c3739935,1,1,0,1,1,2014-09-04 23:43:01,2014-09-04 23:43:01
ff8498dd1b519bf2489e72430d47dc93e1ff8f36...5faf65e347dc073f64e7c7b065f5f3c243b41acd,1,7,4,11,3,2014-08-20 01:34:17,2014-08-20 01:34:17
5faf65e347dc073f64e7c7b065f5f3c243b41acd...8f724b5b6307d5fb4370ef12fa60d6e4f5960f71,1,1,1,2,1,2014-08-20 17:41:20,2014-08-20 17:41:20
ff8498dd1b519bf2489e72430d47dc93e1ff8f36...2866a2018f10e87c3e550a79c9961bb3e4c1cb90,4,4,4,8,4,2014-08-20 00:31:18,2014-08-20 00:31:18
2866a2018f10e87c3e550a79c9961bb3e4c1cb90...0df7bdc378f25e7b4f768e0f9087e2f69393135e,1,7,4,11,3,2014-08-20 01:38:36,2014-08-20 01:34:17
0df7bdc378f25e7b4f768e0f9087e2f69393135e...b28a84cca20b19377cfc9ccc6a3b12564db2caf4,3,9,3,12,3,2014-08-20 01:47:37,2014-08-20 01:35:10
b28a84cca20b19377cfc9ccc6a3b12564db2caf4...6f1c74465bae419ec0d098b93d851511fd326526,1,2,6,8,2,2014-08-20 02:34:26,2014-08-20 02:34:26
6f1c74465bae419ec0d098b93d851511fd326526...4ce288859673dcb424d4a765d998937b7dc6a558,1,1,1,2,1,2014-08-20 18:53:03,2014-08-20 17:41:20
4ce288859673dcb424d4a765d998937b7dc6a558...019d3d289ec29ce6ca72061f0e50b2b03afbbbc7,1,6,8,14,2,2014-08-20 22:20:22,2014-08-20 22:20:22
019d3d289ec29ce6ca72061f0e50b2b03afbbbc7...0bc445e8d21e9364984ed10d31c637c902dea5b5,5,208,26,234,18,2014-08-20 22:49:58,2014-08-20 22:46:17
0bc445e8d21e9364984ed10d31c637c902dea5b5...75df1097e06dc7faed95e3f83d357ff3de63872f,1,44,0,44,2,2014-08-20 23:19:24,2014-08-20 23:18:11
75df1097e06dc7faed95e3f83d357ff3de63872f...7946be9f9b75fa43e700f519cb0caa07a352aac9,1,1,2,3,2,2014-08-20 23:20:29,2014-08-20 23:20:29
7946be9f9b75fa43e700f519cb0caa07a352aac9...080f6f60dde001666b46ca389cdeb1292d8bfb4e,3,3,3,6,3,2014-08-21 00:14:57,2014-08-21 00:14:57
aacc382c98983cd1b87ef27074232fc13c362e1c...4f54e317256bc55d7ed4799f478a1c20106d7a93,2,34,0,34,2,2014-08-25 22:40:52,2014-08-25 22:38:36
4f54e317256bc55d7ed4799f478a1c20106d7a93...d7cc32ccd30e5f701dbf8b9a18591c4bd47133b9,1,25,2,27,2,2014-08-25 22:40:52,2014-08-25 22:39:04
d7cc32ccd30e5f701dbf8b9a18591c4bd47133b9...beb5b95312c59d48b70973d02ba935f1853dcd71,2,24,5,29,7,2014-08-25 22:40:52,2014-08-25 22:39:31
beb5b95312c59d48b70973d02ba935f1853dcd71...5d8d9e7ddff7bf41aa36ecd420959318c146013a,1,6,1,7,1,2014-08-26 03:02:05,2014-08-26 03:02:05
5d8d9e7ddff7bf41aa36ecd420959318c146013a...96e8bf59b395b6936ec8a0e50d1b145feffb64ae,1,1,1,2,1,2014-08-26 03:05:53,2014-08-26 03:05:53
96e8bf59b395b6936ec8a0e50d1b145feffb64ae...0f285d35967546030b4f30ccb6d3b8cd4756b4ae,1,1,1,2,1,2014-08-26 03:11:15,2014-08-26 03:11:15
0f285d35967546030b4f30ccb6d3b8cd4756b4ae...9353b0df4d3c826d8bc7b87711b8cdbff6122e04,1,5,5,10,4,2014-08-26 19:23:30,2014-08-26 19:22:08
9353b0df4d3c826d8bc7b87711b8cdbff6122e04...d5356443a075379e8544416a57c9c606d3d2f9e4,1,1,1,2,1,2014-08-26 22:03:19,2014-08-26 22:03:19
d5356443a075379e8544416a57c9c606d3d2f9e4...5178aa9c7f4376a05d2d2707216b9cfc67f05d65,1,1,1,2,1,2014-08-26 22:06:39,2014-08-26 22:06:39
5178aa9c7f4376a05d2d2707216b9cfc67f05d65...cd80c949369627f9a804c65f6f9833d331ff5f54,3,18,18,36,16,2014-08-26 22:13:22,2014-08-26 22:13:22
cd80c949369627f9a804c65f6f9833d331ff5f54...d4f8f8ce253868de6c1b86bdd7b0eeced18649ce,1,11,8,19,1,2014-08-26 23:04:26,2014-08-26 23:04:26
d4f8f8ce253868de6c1b86bdd7b0eeced18649ce...b2deab208c55870534f6b82e38c8db5ece6b5f5b,1,0,3,3,1,2014-08-27 00:18:52,2014-08-27 00:18:52
b2deab208c55870534f6b82e38c8db5ece6b5f5b...c8fd50c76f47e077d30ee3ac222bcd211ede0b22,1,8,0,8,2,2014-08-27 00:30:04,2014-08-27 00:30:04
c8fd50c76f47e077d30ee3ac222bcd211ede0b22...3413db8c262b315046a52de94ba54b0066375dd0,1,1,1,2,1,2014-08-27 00:31:49,2014-08-27 00:31:49
df38c100a9c880a3d4e3e041f7765673fb580695...027ec7f6129326c4fad681503e1dabdca1cfbd99,1,3,1,4,1,2014-08-21 03:59:23,2014-08-21 03:59:23
e78861b7d0dbb60e5e2bf59bab2cb06ce6596c04...47831e8744d2a5cc9d3def613d72bc5b9ed42822,1,5,5,10,2,2014-07-30 19:00:51,2014-07-30 19:00:51
47831e8744d2a5cc9d3def613d72bc5b9ed42822...693b78001c83d48ef31ea0fe432327f68ee16023,1,4,1,5,2,2014-07-30 23:21:13,2014-07-30 23:21:13
e78861b7d0dbb60e5e2bf59bab2cb06ce6596c04...b4e02f345a40db826ceae9da318f5532e8d6714e,1,14,0,14,3,2014-07-29 17:23:38,2014-07-29 17:18:40
b4e02f345a40db826ceae9da318f5532e8d6714e...0f3b16f9425f3ca3ff136a451dd2f32bdfa28416,1,484,439,923,65,2014-07-29 18:01:42,2014-07-29 18:01:42
e78861b7d0dbb60e5e2bf59bab2cb06ce6596c04...f686b355a43e7b66f0a7d93f83e69cbaca9460fe,4,53,5,58,8,2014-07-29 16:44:12,2014-07-29 16:44:12
f686b355a43e7b66f0a7d93f83e69cbaca9460fe...b3fc912f0c5c721c726d736c3daac79539c75ccb,1,71,1,72,9,2014-07-29 16:44:50,2014-07-29 16:44:50
b3fc912f0c5c721c726d736c3daac79539c75ccb...351aa13af51d3717b91fc4cce59f83e85c1c26d0,1,9,1,10,1,2014-07-29 16:47:11,2014-07-29 16:47:11
351aa13af51d3717b91fc4cce59f83e85c1c26d0...a2ffd73dd4ad1c3cfe6b0571dfa24aebc1b059d9,3,12,1,13,6,2014-07-29 16:49:03,2014-07-29 16:49:03
a2ffd73dd4ad1c3cfe6b0571dfa24aebc1b059d9...742b78586a0a416974b326ac7f214072bbe7d7a5,1,26,5,31,6,2014-07-29 16:50:20,2014-07-29 16:50:15
742b78586a0a416974b326ac7f214072bbe7d7a5...4e751c6424d10b1f462b28c4af4d9dc5221444cc,1,2,1,3,1,2014-07-29 18:16:53,2014-07-29 18:16:53
4e751c6424d10b1f462b28c4af4d9dc5221444cc...f3313c71df72bdc2c89163a30d7e64d023c9ee81,1,5,2,7,2,2014-07-29 19:33:30,2014-07-29 19:32:47
f3313c71df72bdc2c89163a30d7e64d023c9ee81...8c99b8079da82402b10b3d964b44da57c81630f2,1,1,0,1,1,2014-07-30 18:55:10,2014-07-30 18:55:10
8c99b8079da82402b10b3d964b44da57c81630f2...b6d66e2b43413738a1e0614ef2dcf33ba35b704d,1,2,2,4,2,2014-07-30 18:59:43,2014-07-30 18:59:43
b6d66e2b43413738a1e0614ef2dcf33ba35b704d...8ec9fa29e33a2c1783704fb8837c7a81c47c77af,1,6,2,8,1,2014-07-30 21:35:39,2014-07-30 21:35:39
e78861b7d0dbb60e5e2bf59bab2cb06ce6596c04...828a12b79b4760d2145b38425c162bf889441818,1,9,1,10,1,2014-07-23 22:24:18,2014-07-23 22:24:18
e78861b7d0dbb60e5e2bf59bab2cb06ce6596c04...3e7565ca0021af38601072208061978d2486943d,1,6,1,7,1,2014-07-23 17:48:12,2014-07-23 17:48:12
3e7565ca0021af38601072208061978d2486943d...93c499a92b76ab5ef77998d88ab2e61dfadee951,1,1,0,1,1,2014-07-23 18:35:25,2014-07-23 18:35:25
93c499a92b76ab5ef77998d88ab2e61dfadee951...7d1a63668996f91cea9abd650e1e29911963f487,3,9,8,17,3,2014-07-23 20:10:13,2014-07-23 20:10:13
7d1a63668996f91cea9abd650e1e29911963f487...286d651cc89c22621dda41e6f60423619ccb9dd4,1,5,1,6,5,2014-07-23 20:12:09,2014-07-23 20:12:09
053f26da5ea70c25d48ad16efe4029686760417b...a533f1ed5d76e70bbdebf8a18e181af73c45c318,2,72,28,100,9,2014-07-24 03:25:50,2014-07-24 03:03:32
a533f1ed5d76e70bbdebf8a18e181af73c45c318...a6db03f13124193379e93674dc596ba150bad566,3,0,3,3,3,2014-07-24 03:27:35,2014-07-24 03:27:35
a6db03f13124193379e93674dc596ba150bad566...9afd6f4cf9c799bc8d1bde885ca17b576e4f752b,3,23,15,38,9,2014-07-24 21:02:47,2014-07-24 21:02:47
9afd6f4cf9c799bc8d1bde885ca17b576e4f752b...335dc4a3121597c0f1ad940033a7dfe6bf73b420,3,14,3,17,4,2014-07-24 22:13:46,2014-07-24 01:46:46
335dc4a3121597c0f1ad940033a7dfe6bf73b420...4205a06ba283e402bb8429208165f33fdc36d1be,2,8,4,12,6,2014-07-24 22:13:47,2014-07-24 22:13:39
4205a06ba283e402bb8429208165f33fdc36d1be...a548efe175e709cb04da54510933b353709c1812,3,35,3,38,5,2014-07-24 22:26:55,2014-07-24 21:13:23
a548efe175e709cb04da54510933b353709c1812...a5ace22f6c91caccc50e2fdf4dd5f54d5b75edbd,1,2,1,3,1,2014-07-24 22:26:55,2014-07-24 21:46:02
a5ace22f6c91caccc50e2fdf4dd5f54d5b75edbd...74dea7e1ba05743782722ae6cba652ba0e2e061a,1,9,13,22,3,2014-07-24 22:26:55,2014-07-24 21:59:30
74dea7e1ba05743782722ae6cba652ba0e2e061a...591fa4efb48edde044918f9ecf9afc9f8cf2a331,1,12,8,20,6,2014-07-24 22:26:55,2014-07-24 22:20:15
591fa4efb48edde044918f9ecf9afc9f8cf2a331...5ec341c276812d10166eed6ced724215bcb5bae5,1,1,2,3,1,2014-07-24 22:26:55,2014-07-24 22:24:19
5ec341c276812d10166eed6ced724215bcb5bae5...e9d7969da871d352ea297b46c73f0bdcffd3c848,1,103,119,222,51,2014-07-24 22:47:24,2014-07-24 22:47:24
e9d7969da871d352ea297b46c73f0bdcffd3c848...6850b679e9369bf8a5f9422ba291882c6b8282de,5,49,40,89,22,2014-07-24 23:21:25,2014-07-24 23:13:27
6850b679e9369bf8a5f9422ba291882c6b8282de...1591e076e92d675e2ca98e0f881a70cd7a1ad3e7,2,5,5,10,5,2014-07-24 23:31:38,2014-07-24 23:31:38
1591e076e92d675e2ca98e0f881a70cd7a1ad3e7...ea7afca05f481508cbd683020d25a42ccd362261,1,2,1,3,1,2014-07-24 23:31:59,2014-07-24 23:31:59
ea7afca05f481508cbd683020d25a42ccd362261...21b8e452a7b6133d994832dd70f28f53b7e8d967,2,1,15,16,5,2014-07-24 23:41:35,2014-07-24 23:41:35
21b8e452a7b6133d994832dd70f28f53b7e8d967...7aec7d3801fd1915a847484eae695c6d2e4aafdb,1,18,8,26,4,2014-07-24 23:42:07,2014-07-24 23:42:07
7aec7d3801fd1915a847484eae695c6d2e4aafdb...ab7e9366e145afbcf0a1583417f7785aacb9bac6,1,2,2,4,2,2014-07-24 23:43:35,2014-07-24 23:43:35
ab7e9366e145afbcf0a1583417f7785aacb9bac6...a7cbc3bd87f444a0b3fbb2e451706ef610cbc2c5,2,13,8,21,5,2014-07-24 23:49:12,2014-07-24 23:49:12
a7cbc3bd87f444a0b3fbb2e451706ef610cbc2c5...020824d828b5b062b1401885894b3eab47cd8bf4,1,5,10,15,5,2014-07-24 23:52:23,2014-07-24 23:52:23
020824d828b5b062b1401885894b3eab47cd8bf4...4428f2b06db399cd069e9b38c5b23d2054a5f6ee,4,20,6,26,6,2014-07-25 00:12:14,2014-07-25 00:12:14
4428f2b06db399cd069e9b38c5b23d2054a5f6ee...af8c5324115d3d7b9ab9ae87c8b1a33ceb1b661e,1,13,8,21,7,2014-07-25 01:35:05,2014-07-25 01:35:05
af8c5324115d3d7b9ab9ae87c8b1a33ceb1b661e...83ac27f9c4efea77a4b415c9c6d14c635a037f92,4,35,15,50,10,2014-07-25 01:36:15,2014-07-25 01:36:15
83ac27f9c4efea77a4b415c9c6d14c635a037f92...a8e372221d9c8024796c9baa119f15d69a883486,1,3,3,6,1,2014-07-25 06:35:01,2014-07-25 06:34:43
0c66b87b566d04e67f578007197598632940f280...5e3c5333a0ec388d771f83ffb5ede58c3a69a801,2,13,1,14,2,2014-07-28 20:33:47,2014-07-28 20:33:47
5e3c5333a0ec388d771f83ffb5ede58c3a69a801...2e3b9be131e9bf088549c484ec5c590d5d3aa5b1,4,17,6,23,6,2014-07-28 21:17:38,2014-07-28 21:17:38
2e3b9be131e9bf088549c484ec5c590d5d3aa5b1...7700d350b29bde4614472a5b85d0d81cf3806ad9,1,6,1,7,4,2014-07-28 21:36:55,2014-07-28 21:36:55
7700d350b29bde4614472a5b85d0d81cf3806ad9...ecfa2e76da141817cdcef6b89606043c1550ec5e,1,0,43,43,1,2014-07-28 21:52:35,2014-07-28 21:52:35
ecfa2e76da141817cdcef6b89606043c1550ec5e...03fa26fc92607b7761f5b04aa19105d7fb8aff0d,4,88,25,113,11,2014-07-29 01:03:05,2014-07-29 01:03:05
03fa26fc92607b7761f5b04aa19105d7fb8aff0d...b1b20ec83a4633ba41dfcd4deee86678017d00c7,2,5,1,6,2,2014-07-29 01:53:14,2014-07-29 01:53:14
b1b20ec83a4633ba41dfcd4deee86678017d00c7...43fc2be1b9bf471ef00dc56cea150684b21466b6,3,97,62,159,16,2014-07-29 05:38:27,2014-07-29 05:31:08
43fc2be1b9bf471ef00dc56cea150684b21466b6...610fcef38885d03c1422d612f649c37afd5fa8b8,2,57,59,116,10,2014-07-29 06:10:30,2014-07-29 06:10:30
610fcef38885d03c1422d612f649c37afd5fa8b8...2a74a004db9c8fbb61e8866fa1dc7e6ab7fcd7a1,2,37,12,49,9,2014-07-29 06:39:56,2014-07-29 06:39:56
2a74a004db9c8fbb61e8866fa1dc7e6ab7fcd7a1...7438549268508c4c340b2013fbe50d7de0bdfad9,1,67,29,96,21,2014-07-29 08:57:18,2014-07-29 08:57:18
7438549268508c4c340b2013fbe50d7de0bdfad9...71966f407a651643424ba83d854c658e6a957542,6,138,102,240,42,2014-07-29 11:38:46,2014-07-29 11:38:46
71966f407a651643424ba83d854c658e6a957542...3ea5e6d03329a5957bc9b3a3744c1beea32230bc,5,116,223,339,39,2014-07-29 22:43:32,2014-07-29 22:43:32
3ea5e6d03329a5957bc9b3a3744c1beea32230bc...5e1c63b63bf84cba7b029769736586cfcd758a4c,3,24,14,38,11,2014-07-30 00:19:35,2014-07-30 00:19:35
5e1c63b63bf84cba7b029769736586cfcd758a4c...574d9398b2f27ff7588e322fb2b01113c1051167,2,3,3,6,4,2014-07-30 00:22:37,2014-07-30 00:22:37
574d9398b2f27ff7588e322fb2b01113c1051167...71f27982059cc73016adfef9284f8b97c71b9ef5,3,20,9,29,8,2014-07-30 05:45:50,2014-07-30 05:45:50
71f27982059cc73016adfef9284f8b97c71b9ef5...b14a3d13763f89586d31b1d3bcc6136490fabf34,1,10,7,17,2,2014-07-30 09:04:42,2014-07-30 09:04:42
604cd853f3c63b4f64161742bbc4767a310bbba9...cf3ffa88a9b81154dc8f46db9246c573942406f1,1,6,5,11,2,2014-01-28 23:12:14,2014-01-28 23:12:14
cf3ffa88a9b81154dc8f46db9246c573942406f1...c8a1df81a7517b0fbc856f002feb55638be35350,2,32,3,35,5,2014-01-28 23:41:53,2014-01-28 23:21:40
c8a1df81a7517b0fbc856f002feb55638be35350...4352b79502e12db36c1bec7c35d62478fe4480fb,1,13,15,28,10,2014-01-28 23:41:53,2014-01-28 23:28:26
4352b79502e12db36c1bec7c35d62478fe4480fb...9f253e6a0bcb9058c89c1c66ac755e092c8834cc,1,28,20,48,5,2014-01-29 01:44:48,2014-01-29 00:06:07
9f253e6a0bcb9058c89c1c66ac755e092c8834cc...25fd3a344cfc0264f0362cf23ef51bb042230966,1,18,13,31,13,2014-01-29 01:44:48,2014-01-29 00:48:13
25fd3a344cfc0264f0362cf23ef51bb042230966...764ceb6077d7aa76f11868beb9134522263fda8a,1,17,1,18,2,2014-01-29 01:44:48,2014-01-29 01:00:00
d6ec53b37d153eba5a4ce6629bcfd544263ddf7f...ecd0bdbe6d147865343ff9ed6d2a7ee8c78f1aa2,8,288,35,323,16,2014-12-05 20:22:09,2014-10-29 07:16:10
ecd0bdbe6d147865343ff9ed6d2a7ee8c78f1aa2...c2dcb5e1d25f90694fb5ea93dfbc47ef3017eac5,1,3,1,4,3,2014-12-05 23:43:37,2014-12-05 23:43:37
c2dcb5e1d25f90694fb5ea93dfbc47ef3017eac5...10bdd78c4cad2d1c4af7ea32cf029e8da1312abb,1,13,1,14,2,2014-12-05 23:59:30,2014-12-05 23:59:30
10bdd78c4cad2d1c4af7ea32cf029e8da1312abb...a7ec4df4dae055bda81bc3773b5e023c80dccbb7,1,3,1,4,1,2014-12-06 00:05:19,2014-12-06 00:04:51
a7ec4df4dae055bda81bc3773b5e023c80dccbb7...a6b6ae0a010383abf38feb31b4f49a963048b8d4,1,1,2,3,2,2014-12-06 00:10:02,2014-12-06 00:10:02
a6b6ae0a010383abf38feb31b4f49a963048b8d4...7f606183e3eda1ffe841220fbb2fa9f25b8d23d2,1,1,1,2,1,2014-12-06 00:16:38,2014-12-06 00:16:12
7f606183e3eda1ffe841220fbb2fa9f25b8d23d2...e6c6cd7f411f94171d5abd4b51b367ab8210e308,3,37,10,47,3,2014-12-07 01:16:38,2014-12-06 01:59:54
e6c6cd7f411f94171d5abd4b51b367ab8210e308...8a7c79a79d1908482c35a2a0996479baef32bce6,1,1,1,2,1,2014-12-07 01:16:46,2014-12-07 01:16:46
8a7c79a79d1908482c35a2a0996479baef32bce6...11ff1cfe2fd0307f622a86bc2e1b8ded64e655fd,1,65,42,107,16,2014-12-08 18:55:08,2014-12-08 00:34:27
11ff1cfe2fd0307f622a86bc2e1b8ded64e655fd...c1955407acc052f4d530ea30fe88adc74289d510,2,66,57,123,18,2014-12-08 18:55:09,2014-12-08 01:00:36
c1955407acc052f4d530ea30fe88adc74289d510...402fbca06ddd774aa25a6e0b3bd96c7979ed6771,1,7,9,16,3,2014-12-08 18:55:09,2014-12-08 18:43:04
402fbca06ddd774aa25a6e0b3bd96c7979ed6771...b08c5a1905eec3f827ddd73e3310c935112382fc,1,4,0,4,1,2014-12-08 18:55:09,2014-12-08 18:51:39
b08c5a1905eec3f827ddd73e3310c935112382fc...23ee0966a52996b8f6cee69f6f0990537231200f,1,5,4,9,3,2014-12-08 19:29:00,2014-12-08 19:29:00
23ee0966a52996b8f6cee69f6f0990537231200f...fd727ad200f55970a76e0f2d8ddc8812e20fd966,1,1,1,2,1,2014-12-08 19:34:34,2014-12-08 19:34:06
fd727ad200f55970a76e0f2d8ddc8812e20fd966...ad05c3a5205a7b7407274105199bbfaabbab4592,2,45,25,70,3,2014-12-08 21:22:07,2014-12-08 21:22:07
d6ec53b37d153eba5a4ce6629bcfd544263ddf7f...42fe3847a763f685849b30692dd9bd0458d3e074,1,8,2,10,3,2014-12-05 20:11:21,2014-12-05 20:11:21
42fe3847a763f685849b30692dd9bd0458d3e074...9bacc49a46cfa18d0fbe858aeb40e3e65af64ccc,2,10,4,14,3,2014-12-08 16:51:31,2014-12-08 16:51:23
9bacc49a46cfa18d0fbe858aeb40e3e65af64ccc...9a30d5cbeb12bc3b825d8cab0be678ca235a7606,1,34,0,34,5,2014-12-08 16:57:50,2014-12-08 16:57:50
9a30d5cbeb12bc3b825d8cab0be678ca235a7606...9fd826f436e1415cf242fa6fbffbf6b8181e68dd,1,1,1,2,1,2014-12-08 17:13:35,2014-12-08 17:13:35
9fd826f436e1415cf242fa6fbffbf6b8181e68dd...cbae209f785ea926e429043b4814d814b8130026,1,1,1,2,1,2014-12-08 18:23:23,2014-12-08 18:23:23
cbae209f785ea926e429043b4814d814b8130026...708d63bee582793a017d5e3a9a126031398d609e,1,5,0,5,5,2014-12-08 18:26:07,2014-12-08 18:26:07
708d63bee582793a017d5e3a9a126031398d609e...4064b6562c4afa335cebecd0411b0c4acd5bd5c4,1,2,0,2,1,2014-12-08 22:33:30,2014-12-08 22:33:30
4064b6562c4afa335cebecd0411b0c4acd5bd5c4...871e3d88f2ea1415b2bdb8abea6632a0e3f4515c,3,32,0,32,3,2014-12-09 02:33:22,2014-12-09 01:19:15
871e3d88f2ea1415b2bdb8abea6632a0e3f4515c...77a1257e519bb312fc8c5259e0c7013b7a63586a,1,1,1,2,1,2014-12-09 03:05:41,2014-12-09 03:05:41
77a1257e519bb312fc8c5259e0c7013b7a63586a...7545e05eb4f728b70d05a420c42d5bff4ab47b9e,2,2,2,4,2,2014-12-09 18:35:23,2014-12-09 18:35:23
7545e05eb4f728b70d05a420c42d5bff4ab47b9e...2cbad1fe9e56dd2353ec16ee8a66178fefab1ca6,1,1,1,2,1,2014-12-09 18:36:51,2014-12-09 18:36:51
2cbad1fe9e56dd2353ec16ee8a66178fefab1ca6...e73ae0e41c2bceb05fe3ef7f1ff32c6c8589beea,1,11,1,12,2,2014-12-09 19:42:41,2014-12-09 19:42:41
e73ae0e41c2bceb05fe3ef7f1ff32c6c8589beea...38cde607f5b8187799c816c9ec275f5571cbc7ba,1,1,1,2,1,2014-12-09 20:41:51,2014-12-09 20:41:21
38cde607f5b8187799c816c9ec275f5571cbc7ba...6211e1715013251b1eb92de6da16d8939b4651ce,1,1,1,2,1,2014-12-09 20:43:54,2014-12-09 20:43:54
6211e1715013251b1eb92de6da16d8939b4651ce...b4fbf0af441317c10bbd4d942a074973422ca571,12,20,22,42,21,2014-12-09 21:01:22,2014-12-09 21:01:22
f5af944073c3d1c68f5a0fd8a9ffb78e35ba8cad...45f305fef09991f34bbb84d486c905be380e677c,8,0,0,0,0,2014-10-28 22:48:11,2014-10-28 22:48:11
45f305fef09991f34bbb84d486c905be380e677c...69c92eb24a741054330496d415c0511ba8601c1a,1,4,2,6,2,2014-10-28 22:49:41,2014-10-28 22:49:41
69c92eb24a741054330496d415c0511ba8601c1a...c1df106bf04d629e3940010b8bba59f94d191e52,1,4,2,6,2,2014-10-28 22:51:36,2014-10-28 22:51:36
c1df106bf04d629e3940010b8bba59f94d191e52...c6ac5c6a3120e07af3c0158e1bb5e00910e603e6,2,42,0,42,2,2014-10-28 22:52:22,2014-10-28 22:52:22
19ead0ec1eaf7eab2524fb0af3b43c6837425405...5bbd908502c43b36a85888f5d747617859b3eeeb,1,1,1,2,1,2014-10-28 21:59:37,2014-10-28 20:44:15
5bbd908502c43b36a85888f5d747617859b3eeeb...6c118f3346e9039a204b3cd08830276ea2122e16,1,1,0,1,1,2014-10-28 21:59:55,2014-10-28 18:34:30
19ead0ec1eaf7eab2524fb0af3b43c6837425405...22253721a863e43728f9b66c8622f8b0dee5fe39,1,5,1,6,3,2014-10-28 21:24:18,2014-10-28 21:24:18
620c6cbe1b1fe649093acefef3545ab6d657e167...5661a590f297347cb2612ebe8bb92f4113b0f5dd,3,6,24,30,10,2014-10-14 01:37:23,2014-10-14 01:36:54
5661a590f297347cb2612ebe8bb92f4113b0f5dd...b90d87e56a95c6c5608d236bc31dbf6681a914df,3,53,0,53,3,2014-10-14 03:05:40,2014-10-14 03:05:40
b90d87e56a95c6c5608d236bc31dbf6681a914df...8fc4e3cfeb3090ae99ff2317760b00e0724407bd,1,1,2,3,2,2014-10-14 03:08:44,2014-10-14 03:08:44
8fc4e3cfeb3090ae99ff2317760b00e0724407bd...4b7312b5560ef531ee933b22d3efacea70f50f9f,1,1,1,2,1,2014-10-14 03:09:30,2014-10-14 03:09:30
4b7312b5560ef531ee933b22d3efacea70f50f9f...a0fe7cb0b9e9beccfafc46d0b015724415d6b30c,1,1,1,2,1,2014-10-14 03:10:36,2014-10-14 03:10:36
a0fe7cb0b9e9beccfafc46d0b015724415d6b30c...cdbc57c0cef10ac83f3827012c25e047b763bb0d,3,8,13,21,6,2014-10-14 03:21:23,2014-10-14 03:21:23
cdbc57c0cef10ac83f3827012c25e047b763bb0d...25205a2f61c102a2e11ab486dc034b8471efe176,4,41,0,41,4,2014-10-14 04:23:07,2014-10-14 04:23:07
25205a2f61c102a2e11ab486dc034b8471efe176...34505c8356c8654a9d375569f754f7cd575385cd,6,110,74,184,28,2014-10-14 04:54:04,2014-10-14 04:54:04
34505c8356c8654a9d375569f754f7cd575385cd...82297964afb5ee923c6aa8e711aad4560fb6c3f4,1,1,1,2,1,2014-10-14 05:00:18,2014-10-14 05:00:18
82297964afb5ee923c6aa8e711aad4560fb6c3f4...ebf14581a7abbe17a506ba56dd8e9d63ecb9f866,3,5,12,17,5,2014-10-14 05:33:05,2014-10-14 05:33:05
ebf14581a7abbe17a506ba56dd8e9d63ecb9f866...5d2f9fe640e5f7a4213bf187ff412275209f8d96,1,16,0,16,1,2014-10-14 05:49:56,2014-10-14 05:49:56
5d2f9fe640e5f7a4213bf187ff412275209f8d96...e52be2a2df5e45a8c8972e47134ce7b84580a3c7,1,1,1,2,1,2014-10-14 05:51:09,2014-10-14 05:51:09
6a532cd71d9de04048303ebdac5a0f80f323bc90...9922283515014162dcf6e827271754e725463820,5,81,65,146,16,2014-10-03 21:51:22,2014-10-03 21:51:22
9922283515014162dcf6e827271754e725463820...dc00523cc873acfba99f1140121289bc2d4d3b9c,1,2,2,4,2,2014-10-03 21:56:22,2014-10-03 20:34:40
dc00523cc873acfba99f1140121289bc2d4d3b9c...37eedc4bbe20d935337e4f2b31bb9857fbe86fa2,2,36,8,44,13,2014-10-03 22:28:00,2014-10-03 19:32:06
37eedc4bbe20d935337e4f2b31bb9857fbe86fa2...6307ace605c007fe114e8171fed0fe0d2ccbb39e,4,129,5,134,15,2014-10-03 22:28:00,2014-10-03 22:27:38
6307ace605c007fe114e8171fed0fe0d2ccbb39e...491925478ca6ecaacad5d69d136276bad45230d3,1,1,1,2,1,2014-10-03 22:36:40,2014-10-03 22:36:40
491925478ca6ecaacad5d69d136276bad45230d3...f3d83058a1122c753911e79e7cd83596534d39e1,1,1,0,1,1,2014-10-03 22:44:33,2014-10-03 22:44:33
a272d3c6e9c5579764adb36c6b0d85f626977ce7...8e2b5612a9d1c4d745dbf7a3bded43a27cc6fd2e,1,18,8,26,4,2014-09-30 01:09:28,2014-09-22 20:08:38
8e2b5612a9d1c4d745dbf7a3bded43a27cc6fd2e...381b2fa0990acc5924c8bb9c9817a73b1d8b3dfe,1,2,10,12,3,2014-09-30 01:27:49,2014-09-30 01:27:49
a272d3c6e9c5579764adb36c6b0d85f626977ce7...22d48ee0db4911ce60b98dbf0d0ba552b09599e8,1,120,0,120,3,2014-09-30 00:58:42,2014-09-25 01:24:33
22d48ee0db4911ce60b98dbf0d0ba552b09599e8...251763f2eb3bad06a55fc774525d25d59242c2a9,2,9,5,14,6,2014-09-30 00:58:42,2014-09-26 18:01:47
251763f2eb3bad06a55fc774525d25d59242c2a9...4ba382eff3ff296e7550197464fe969b3047e1ec,2,130,119,249,5,2014-09-30 01:47:18,2014-09-30 01:47:18
4ba382eff3ff296e7550197464fe969b3047e1ec...a72629c6ce35a45f081b26cb06397f8bede96dd9,1,1,1,2,2,2014-09-30 02:19:25,2014-09-30 02:06:25
a72629c6ce35a45f081b26cb06397f8bede96dd9...99f7c4cd66a63bbcb1d21135907bb1392f9eab8f,2,19,6,25,7,2014-09-30 02:27:49,2014-09-30 02:14:46
99f7c4cd66a63bbcb1d21135907bb1392f9eab8f...5a4d35184cc84713b3c18d110f3d835401fbedea,2,30,30,60,21,2014-09-30 02:50:24,2014-09-30 02:50:24
7e4848d9391b63d8a9be3af4b1f4f33353b1c04f...baa823995b9b36da3a0fb2662730c2f05a7ff17e,1,2,1,3,2,2014-09-30 03:10:57,2014-09-30 03:10:57
baa823995b9b36da3a0fb2662730c2f05a7ff17e...3fe1c063437435002b497eb317ad1a4a95b267ed,1,4,4,8,2,2014-09-30 03:31:15,2014-09-30 03:31:15
710790954f6c88f8e4fc9b241577e2b95a39ba1b...c62e3c20c1b7f37fbcb8f8829454fc4f1332cda4,1,18,8,26,4,2014-09-30 01:10:06,2014-09-22 20:08:38
c62e3c20c1b7f37fbcb8f8829454fc4f1332cda4...a403c54bf86d89d9f95c3169d88f087be349366d,1,2,10,12,3,2014-09-30 01:31:04,2014-09-30 01:27:49
a403c54bf86d89d9f95c3169d88f087be349366d...59db2ff04b3be1e46fca9419cb196222e7ba2c83,3,11,11,22,11,2014-09-30 01:38:52,2014-09-30 01:38:52
59db2ff04b3be1e46fca9419cb196222e7ba2c83...f53c12815e592f11ca783e5eed3203e041c86b72,6,179,4,183,20,2014-09-30 02:50:49,2014-09-19 18:44:51
b19b269dc9613c4178c2a5bf037d57c84874b0e4...452842e561a3ffcd094d5f011b97b4feb4b65597,1,1,1,2,1,2014-09-25 00:34:40,2014-09-25 00:34:40
b19b269dc9613c4178c2a5bf037d57c84874b0e4...a0c52510a9a7cc7245f68b614cba8fd57155b7c1,1,28,0,28,1,2014-09-24 19:14:17,2014-09-24 19:14:17
a0c52510a9a7cc7245f68b614cba8fd57155b7c1...a1dc3a0d5fcfcbc565a3ba9eb199a92b1dd091ad,1,21,5,26,1,2014-09-25 00:38:48,2014-09-25 00:38:48
a1dc3a0d5fcfcbc565a3ba9eb199a92b1dd091ad...8a799a6ea66e6288ef375c495d2bcae4174e23ad,1,60,60,120,11,2014-09-25 03:59:00,2014-09-25 03:59:00
8a799a6ea66e6288ef375c495d2bcae4174e23ad...4b4092f9e8d385451a8a2613a58b45320f5feb0a,1,16,8,24,8,2014-09-25 03:59:27,2014-09-25 03:59:27
4b4092f9e8d385451a8a2613a58b45320f5feb0a...04c3a0c8beff4e5de53c5896a2d780f90b5d2825,1,7,4,11,1,2014-09-25 04:36:53,2014-09-25 04:36:53
04c3a0c8beff4e5de53c5896a2d780f90b5d2825...b1f7132454391baf2788581b23a56e2133e45dff,1,39,0,39,3,2014-09-25 04:39:22,2014-09-25 04:39:22
b1f7132454391baf2788581b23a56e2133e45dff...732092287ccf25b7e4f363c73515be0e209cac4b,1,25,30,55,7,2014-09-25 04:39:36,2014-09-25 04:39:36
732092287ccf25b7e4f363c73515be0e209cac4b...fc3f3d5e6c5d3828c31a1d8d07ab522e64a5cf6b,5,83,44,127,22,2014-09-25 17:06:24,2014-09-25 17:06:24
fc3f3d5e6c5d3828c31a1d8d07ab522e64a5cf6b...5c8c6a9290eae0b6db6ca114ea807e2e4c9c2b75,1,8,16,24,8,2014-09-25 17:07:48,2014-09-25 17:07:48
5c8c6a9290eae0b6db6ca114ea807e2e4c9c2b75...408252e92da31c10be23fb6dc1065b9328509051,1,26,0,26,1,2014-09-25 17:08:31,2014-09-25 17:08:31
408252e92da31c10be23fb6dc1065b9328509051...21fb31507e7d10d532c49b1e894a87a4d3f92060,1,5,21,26,1,2014-09-25 17:09:38,2014-09-25 17:09:38
21fb31507e7d10d532c49b1e894a87a4d3f92060...92f75b19cb35a294b8b460f77377b3f8ec91aebf,1,13,2,15,4,2014-09-25 17:14:23,2014-09-25 17:14:23
92f75b19cb35a294b8b460f77377b3f8ec91aebf...3120eb0b4f40c542d40e5691b965cd39d907f8a9,5,27,42,69,18,2014-09-26 20:27:34,2014-09-26 20:27:34
3120eb0b4f40c542d40e5691b965cd39d907f8a9...570ce49e8c9ad968443afea9b88fba3ffb13344c,1,3,4,7,3,2014-09-26 20:40:03,2014-09-26 20:40:03
570ce49e8c9ad968443afea9b88fba3ffb13344c...9d65f9269982e066de112ccf7e22dfeb2528ba58,7,64,37,101,26,2014-09-26 21:00:45,2014-09-26 21:00:45
9d65f9269982e066de112ccf7e22dfeb2528ba58...422fffd1288ebc7d687b105dd3a943b4e583c4d6,3,19,23,42,14,2014-09-27 22:40:18,2014-09-27 22:40:18
422fffd1288ebc7d687b105dd3a943b4e583c4d6...681c4a4dec11ed66e37c8df55013d6e7548e2a5b,1,1,2,3,1,2014-09-27 22:42:00,2014-09-27 22:42:00
681c4a4dec11ed66e37c8df55013d6e7548e2a5b...b7ce12a958ea6e12ecd08ae5ead153b0a4064c6c,1,6,1,7,2,2014-09-27 22:45:46,2014-09-27 22:45:46
b19b269dc9613c4178c2a5bf037d57c84874b0e4...8895cc1bd8111bc740aa24265bc5d38cf6940337,1,1,1,2,1,2014-09-24 19:07:49,2014-09-24 19:07:49
8895cc1bd8111bc740aa24265bc5d38cf6940337...db10e231a42f763ce6b1af0b692fb6b459538829,3,39,13,52,9,2014-09-24 22:53:04,2014-09-23 13:15:33
db10e231a42f763ce6b1af0b692fb6b459538829...555bd231ebe51fd6eb5921be190a9e817aa754fb,1,7,6,13,7,2014-09-24 22:53:05,2014-09-24 18:13:13
555bd231ebe51fd6eb5921be190a9e817aa754fb...35601acd3674ad84eaef59b5b03dca5a104bc6e5,1,1,1,2,1,2014-09-24 22:53:05,2014-09-24 18:23:32
35601acd3674ad84eaef59b5b03dca5a104bc6e5...eae3f638f1a9cf7d3e3e316173adf47b40cb9c06,2,163,12,175,13,2014-09-24 22:53:05,2014-09-24 18:25:55
eae3f638f1a9cf7d3e3e316173adf47b40cb9c06...0e79787c175b07c68f6ddd8d55f6363a211a5e3e,3,18,7,25,10,2014-09-24 22:53:05,2014-09-24 18:41:16
0e79787c175b07c68f6ddd8d55f6363a211a5e3e...46a81c489d6093ec45786b3f4e6667333aa69c72,1,10,0,10,2,2014-09-24 22:53:05,2014-09-24 21:58:17
46a81c489d6093ec45786b3f4e6667333aa69c72...dee69bde0bbafca8c4720ce7a98fad7387f201c3,1,7,7,14,7,2014-09-25 00:02:20,2014-09-24 23:40:20
dee69bde0bbafca8c4720ce7a98fad7387f201c3...fe5c61104f9faf5915581ce5299a69fabc9d7bbc,3,14,1,15,3,2014-09-25 00:02:20,2014-09-24 23:39:33
fe5c61104f9faf5915581ce5299a69fabc9d7bbc...1d931be8a80f197162665b81fdd934e768f1f1fc,1,5,2,7,2,2014-09-25 00:17:33,2014-09-25 00:17:10
b19b269dc9613c4178c2a5bf037d57c84874b0e4...4bf93172b6e3f76c8b890ccf8dfbd3cc1aa4bafd,12,11,11,22,11,2014-09-24 02:17:03,2014-09-24 02:17:03
4bf93172b6e3f76c8b890ccf8dfbd3cc1aa4bafd...b312c1f6e6307aeddc0a704bae4c3dd29111e91b,14,51,51,102,44,2014-09-24 02:19:58,2014-09-24 02:19:58
b312c1f6e6307aeddc0a704bae4c3dd29111e91b...7cd12072eaca636e4c89165899be3a2775203a2d,18,130,130,260,119,2014-09-29 23:01:08,2014-09-29 23:01:08
7cd12072eaca636e4c89165899be3a2775203a2d...a3860bb11510af1606f33a286a33e6f9aaabf9d5,7,105,47,152,36,2014-09-30 00:12:00,2014-09-30 00:12:00
a3860bb11510af1606f33a286a33e6f9aaabf9d5...bc3bb9eae116b01987f1c3e11d6c3792e647874c,1,19,7,26,9,2014-09-30 00:56:36,2014-09-30 00:56:36
57e5cae447a77ffa74cb908aa09e3b9d670cef92...9600d92ca7ebecdf05577d692c1e4fe6effc2fb5,1,30,14,44,10,2014-09-27 00:21:48,2014-09-27 00:21:48
9600d92ca7ebecdf05577d692c1e4fe6effc2fb5...d4ae3172d3c37d8c90d3e3a8678cc3a962674791,1,5,2,7,2,2014-09-29 19:24:02,2014-09-29 19:24:02
57e5cae447a77ffa74cb908aa09e3b9d670cef92...2ada859d5e2236c7b618ac4eace9715a0a4758d5,1,16,10,26,11,2014-09-26 15:23:45,2014-09-26 15:23:45
2ada859d5e2236c7b618ac4eace9715a0a4758d5...4de9718c9a07b233113f87a8cb07fcb390b47704,1,13,9,22,8,2014-09-26 15:33:22,2014-09-26 15:33:22
4de9718c9a07b233113f87a8cb07fcb390b47704...977aef2488b400dc2ad004ed534b64df8fc5135c,1,1,1,2,1,2014-09-26 15:33:37,2014-09-26 15:33:37
977aef2488b400dc2ad004ed534b64df8fc5135c...c7b6a6c4b732a1a2f353b8fc36f2726cfe63d382,2,2,2,4,2,2014-09-26 15:35:28,2014-09-26 15:35:28
c7b6a6c4b732a1a2f353b8fc36f2726cfe63d382...2f34fd5201a89cac689b60512f5df13966173e4b,1,1,0,1,1,2014-09-26 15:49:37,2014-09-26 15:49:37
a31b44854b1ecf113f8aceb9245ddbc5719fcb53...934028786e746c0adac38cd0a635f48eab5217ab,4,24,24,48,18,2014-10-01 06:25:56,2014-10-01 06:25:56
a4bc4c16e8fe9154114e9dbde163382d1c6df2d7...e8a7e55d2bee499d528c8d938d8911b31ac06f6a,2,51,1,52,5,2014-09-15 21:32:11,2014-09-15 21:32:11
e8a7e55d2bee499d528c8d938d8911b31ac06f6a...b90d1c0f32bf49893f1315c21db8173332aa59bd,11,235,37,272,49,2014-09-15 23:45:05,2014-09-15 23:45:05
b90d1c0f32bf49893f1315c21db8173332aa59bd...54ce81d2b78099bd157ef819bb0a388664985d7e,1,14,3,17,5,2014-09-16 11:22:42,2014-09-16 11:22:42
54ce81d2b78099bd157ef819bb0a388664985d7e...dc721e14f82a4999487f565792dc67b68eb4744a,1,0,2,2,1,2014-09-16 11:23:03,2014-09-16 11:23:03
dc721e14f82a4999487f565792dc67b68eb4744a...eb08ea289d2eb1b50a615c365b353d7cdbbcb9af,1,2,2,4,2,2014-09-16 11:24:14,2014-09-16 11:24:14
eb08ea289d2eb1b50a615c365b353d7cdbbcb9af...c661d8f753cef2339094a35f57a6807c4d2f421e,1,55,1,56,3,2014-09-16 17:32:33,2014-09-16 17:32:33
c661d8f753cef2339094a35f57a6807c4d2f421e...9d7b26c600243aeedb4d4e5b706007e13294c1d9,1,16,2,18,3,2014-09-16 17:33:00,2014-09-16 17:33:00
9d7b26c600243aeedb4d4e5b706007e13294c1d9...e286e73bb140aa002445cc40f915da6741b8cc9d,1,1,1,2,1,2014-09-16 17:33:19,2014-09-16 17:33:19
e286e73bb140aa002445cc40f915da6741b8cc9d...e82db0625d36c4e048063d85c53080a1ba2e845a,5,49,16,65,17,2014-09-16 19:09:50,2014-09-16 19:09:50
e82db0625d36c4e048063d85c53080a1ba2e845a...575ffdbf22331903a6ca1515711eb2cd4470327e,1,4,21,25,2,2014-09-16 19:14:54,2014-09-16 19:14:54
575ffdbf22331903a6ca1515711eb2cd4470327e...46067b05c735c9de25b6dd403962afadaf554baf,1,6,13,19,2,2014-09-16 19:18:53,2014-09-16 19:18:53
46067b05c735c9de25b6dd403962afadaf554baf...0d956f0b0958a7f7cfa1026c2de7f85e11ca2f2c,1,18,0,18,3,2014-09-16 19:40:53,2014-09-16 19:40:53
0d956f0b0958a7f7cfa1026c2de7f85e11ca2f2c...c71313774280262a11e4b35aba073fe945e7e452,1,3,1,4,2,2014-09-16 19:41:43,2014-09-16 19:41:43
c71313774280262a11e4b35aba073fe945e7e452...7ae5d3c978b7cc42860929b5badca68892d98aeb,5,54,75,129,24,2014-09-16 20:41:33,2014-09-16 20:41:33
7ae5d3c978b7cc42860929b5badca68892d98aeb...fea1373190ebd3a79c98ae06ed893a0bf94a6e10,2,6,2,8,4,2014-09-16 20:46:47,2014-09-16 20:46:47
fea1373190ebd3a79c98ae06ed893a0bf94a6e10...47622e37f9fb7e1c345b5a09cd0ceb4d8175642d,3,86,44,130,9,2014-09-16 21:06:06,2014-09-16 21:06:06
47622e37f9fb7e1c345b5a09cd0ceb4d8175642d...c694402db22c12087b4090c780392445ef705636,2,32,4,36,6,2014-09-16 21:12:38,2014-09-16 21:12:38
c694402db22c12087b4090c780392445ef705636...b0273715ea35d81e060314f4e9b41f71d891569d,2,130,115,245,94,2014-09-16 21:28:21,2014-09-16 21:28:21
b0273715ea35d81e060314f4e9b41f71d891569d...c83fdfed4d1cd6d49abefe33fe149dc9199d09de,2,103,93,196,82,2014-09-16 21:38:04,2014-09-16 21:38:04
c83fdfed4d1cd6d49abefe33fe149dc9199d09de...91c4f855b04412b714172b41b6918e29c3378597,7,259,113,372,49,2014-09-17 21:47:16,2014-09-17 21:47:16
91c4f855b04412b714172b41b6918e29c3378597...89aac6d859ca67862f58d6799f1e5a2e73d0d49e,3,22,4,26,8,2014-09-18 12:44:33,2014-09-18 12:44:33
89aac6d859ca67862f58d6799f1e5a2e73d0d49e...2ff526db47f89424f581b9ba07c2746bcdf2a21a,1,6,1,7,2,2014-09-18 12:56:52,2014-09-18 12:54:59
2ff526db47f89424f581b9ba07c2746bcdf2a21a...0d5ad4a40d3be484eae0e09dbfdb095c182a6897,1,1,1,2,1,2014-09-18 13:21:33,2014-09-18 13:21:33
0d5ad4a40d3be484eae0e09dbfdb095c182a6897...fb5f2689d3f945f94e873974c9edc49199a204fc,2,44,6,50,9,2014-09-18 14:11:23,2014-09-18 14:10:40
fb5f2689d3f945f94e873974c9edc49199a204fc...138005e68d93cdb86a14e6ebec238eeb5463d02e,1,28,12,40,10,2014-09-18 14:23:17,2014-09-18 14:23:17
138005e68d93cdb86a14e6ebec238eeb5463d02e...fadd80ccb26f9f5d2f485cdd6dfd73eaba36f870,1,6,2,8,3,2014-09-18 14:25:37,2014-09-18 14:25:37
fadd80ccb26f9f5d2f485cdd6dfd73eaba36f870...3b8a1e69c73d2d66933f1139875a47318abee63a,1,4,2,6,2,2014-09-18 15:39:11,2014-09-18 15:39:11
3b8a1e69c73d2d66933f1139875a47318abee63a...ec310365c4b811e0ebdfd962bb8f9b9a60a4fbc7,7,19,47,66,28,2014-09-18 16:04:43,2014-09-18 16:04:43
ec310365c4b811e0ebdfd962bb8f9b9a60a4fbc7...b8a932b8412771040d804acc33234fd0a08801a5,9,323,142,465,97,2014-09-18 19:10:53,2014-09-18 19:10:53
b8a932b8412771040d804acc33234fd0a08801a5...fc76d2dc0afe82aecd80ad8510c3927d6d93abad,1,100,96,196,86,2014-09-18 20:28:17,2014-09-18 20:27:52
fc76d2dc0afe82aecd80ad8510c3927d6d93abad...25826b0e0f6cfe91b70830f6a3433311729cf3c9,1,4,0,4,2,2014-09-18 20:30:02,2014-09-18 20:28:53
25826b0e0f6cfe91b70830f6a3433311729cf3c9...8d6bcebf1a71e481e2359e5be7bf3bc458c63568,1,6,1,7,1,2014-09-18 20:30:18,2014-09-18 20:30:18
8d6bcebf1a71e481e2359e5be7bf3bc458c63568...b3f485b6300678603869ee81856be2a8aa9d1f7b,2,21,16,37,20,2014-09-19 13:31:43,2014-09-19 13:31:43
b3f485b6300678603869ee81856be2a8aa9d1f7b...9a8f98dd8c2cf5a539fb697afc3d546eb2d1043e,2,87,3,90,3,2014-09-19 14:30:00,2014-09-19 14:30:00
9a8f98dd8c2cf5a539fb697afc3d546eb2d1043e...71dc59da1152a47c2005564e5774766ae41e330b,3,135,57,192,32,2014-09-19 14:58:34,2014-09-19 14:45:24
71dc59da1152a47c2005564e5774766ae41e330b...34859463a76f51fd587b7e7759805540ed8225bd,1,32,11,43,4,2014-09-19 15:51:05,2014-09-19 15:51:05
34859463a76f51fd587b7e7759805540ed8225bd...07c76cdaf587408f49330cacf84246aca25c3702,2,39,15,54,5,2014-09-19 15:57:06,2014-09-19 15:57:06
07c76cdaf587408f49330cacf84246aca25c3702...596067bb382d5d145e8e6b870ac067f39a5dd8c8,1,0,6,6,2,2014-09-19 15:59:15,2014-09-19 15:59:15
596067bb382d5d145e8e6b870ac067f39a5dd8c8...c758e06bf90118c372026ea0498c4abcbefda5c9,5,61,34,95,23,2014-09-19 17:59:18,2014-09-19 17:59:18
c758e06bf90118c372026ea0498c4abcbefda5c9...70457e97f3afa4b4e776a275f213864c6b9056af,1,32,19,51,17,2014-09-19 18:00:03,2014-09-19 18:00:03
70457e97f3afa4b4e776a275f213864c6b9056af...486eea9278e10251071ad45e034583c2cde6f696,1,5,0,5,1,2014-09-19 18:00:28,2014-09-19 18:00:28
486eea9278e10251071ad45e034583c2cde6f696...8b03ef7c62be6b679d5e5731215df48b23196d65,1,1,1,2,1,2014-09-19 18:00:42,2014-09-19 18:00:42
8b03ef7c62be6b679d5e5731215df48b23196d65...d57ea735eb753187c4e452b7a8975b138f49a2b2,1,10,3,13,4,2014-09-19 18:00:59,2014-09-19 18:00:59
d57ea735eb753187c4e452b7a8975b138f49a2b2...cb3d188c05aec7cdfd63ae561636c8998bca07fa,1,10,5,15,5,2014-09-19 18:01:18,2014-09-19 18:01:18
cb3d188c05aec7cdfd63ae561636c8998bca07fa...d656f494c4209c493f7f22a70d38a56a3d6d2df6,1,0,1,1,1,2014-09-19 18:01:56,2014-09-19 18:01:56
d656f494c4209c493f7f22a70d38a56a3d6d2df6...b88fe52e0e168d69d7454ac194d9c221c6b8db8d,4,14,8,22,6,2014-09-19 18:07:58,2014-09-19 18:07:58
b88fe52e0e168d69d7454ac194d9c221c6b8db8d...1db1970ea0b5a7cfcc2122e2d5b11ae49f8d5301,1,5,1,6,2,2014-09-19 18:22:34,2014-09-19 18:22:34
1db1970ea0b5a7cfcc2122e2d5b11ae49f8d5301...c4fe99311c45777d374a9d8f6cf5d0c8cb0fdcf1,1,12,11,23,9,2014-09-19 21:26:58,2014-09-19 21:24:52
c4fe99311c45777d374a9d8f6cf5d0c8cb0fdcf1...6edd5479fb4dd3745abab7f6699fa9dccd18bd1f,1,19,6,25,6,2014-09-19 21:42:52,2014-09-19 21:42:52
a4bc4c16e8fe9154114e9dbde163382d1c6df2d7...2fc9a601dcbf22e7d0e654f4836158fd6d62b48b,1,0,15,15,1,2014-09-15 20:22:16,2014-09-15 20:22:16
d80f35bdb05e3c5f8dc6f00f114cf3431cbe0f47...dc15e59e715210e7818b1bc5dc06f19ac197a72c,1,30,10,40,7,2014-09-03 19:33:09,2014-09-03 19:33:09
dc15e59e715210e7818b1bc5dc06f19ac197a72c...9491b0cad81a00d10e4f0db5dd707eb69a9b78d8,1,10,1,11,4,2014-09-03 20:59:14,2014-09-03 20:59:14
d80f35bdb05e3c5f8dc6f00f114cf3431cbe0f47...60293005bd6cc3c6d56d7850e93c678c63c26394,3,4821,1,4822,3,2014-09-03 19:33:05,2014-09-03 19:31:05
080f6f60dde001666b46ca389cdeb1292d8bfb4e...d771fdbf2af59dd66a596153db8410edd0d9dd11,2,18,1,19,2,2014-08-21 03:54:58,2014-08-21 03:54:58
080f6f60dde001666b46ca389cdeb1292d8bfb4e...8f72c7ef89091087f73b503be7d819b8ce88762a,1,2,1,3,2,2014-08-21 02:07:39,2014-08-21 02:04:53
8f72c7ef89091087f73b503be7d819b8ce88762a...6f46e6e2cdd4825fcd77ed276cd1c490a5f952bf,1,0,44,44,2,2014-08-21 02:07:39,2014-08-21 02:04:58
6f46e6e2cdd4825fcd77ed276cd1c490a5f952bf...d02675afa90b6bae2fad8d3350773ccce1e44bd0,1,53,45,98,10,2014-08-21 02:07:42,2014-08-19 22:39:55
d02675afa90b6bae2fad8d3350773ccce1e44bd0...24efef89d83d8052414d0ad3f019ab6635f84869,3,85,69,154,35,2014-08-21 02:59:04,2014-08-21 02:59:04
a8e372221d9c8024796c9baa119f15d69a883486...5827607c48d0c1136f7adf41de97eb35814c09e9,3,80,58,138,12,2014-07-26 00:16:37,2014-07-26 00:16:37
5827607c48d0c1136f7adf41de97eb35814c09e9...cd6cbe9a7955cec8d5e6fe520f272a206a0f3134,2,4,1,5,2,2014-07-26 00:31:05,2014-07-26 00:31:05
a8e372221d9c8024796c9baa119f15d69a883486...59d38b28bb81606fee52c323ee52f70fcbe17d5e,3,13,11,24,6,2014-07-25 21:12:21,2014-07-25 21:12:21
59d38b28bb81606fee52c323ee52f70fcbe17d5e...4a231a4c76a55660b63c6f2db77e0872e93b7c17,1,40,9,49,7,2014-07-25 21:39:30,2014-07-25 21:39:30
4a231a4c76a55660b63c6f2db77e0872e93b7c17...c622fb4072ddf144cadb3ca6e8489a169f44d730,3,5,5,10,5,2014-07-25 21:40:43,2014-07-25 17:54:25
c622fb4072ddf144cadb3ca6e8489a169f44d730...a58f2c3bb2a974f9a95b63f65e1f202634703c01,2,28,9,37,4,2014-07-25 22:34:54,2014-07-25 22:34:54
a58f2c3bb2a974f9a95b63f65e1f202634703c01...6bb4b4de7b974215708f05cea26c07ba6687d20f,1,15,4,19,4,2014-07-25 23:10:08,2014-07-25 23:10:08
6bb4b4de7b974215708f05cea26c07ba6687d20f...9e65038d08e4ee89359cbe246f8723e359d0b058,1,1,1,2,1,2014-07-28 17:46:15,2014-07-28 17:46:15
9e65038d08e4ee89359cbe246f8723e359d0b058...0e74bdf7691a2ce91ce4260772b10e31af7ff46b,1,30,6,36,3,2014-07-28 22:07:38,2014-07-28 22:07:38
0e74bdf7691a2ce91ce4260772b10e31af7ff46b...b7fa7e24526cd91d565c9d20a8eb3da7db97331f,1,4,3,7,1,2014-07-28 23:07:41,2014-07-28 22:31:58
b7fa7e24526cd91d565c9d20a8eb3da7db97331f...5b69c7c25b1307016442bb8cebac394750a5c86a,1,8,2,10,3,2014-07-28 23:07:42,2014-07-28 22:37:30
5b69c7c25b1307016442bb8cebac394750a5c86a...3aff2199cc815060e21737074926d181a17f6852,1,1,1,2,1,2014-07-28 23:09:19,2014-07-28 23:09:09
3aff2199cc815060e21737074926d181a17f6852...55fe8a8aae5c53333edeeefeebe02f11c6af41d3,3,80,58,138,12,2014-07-29 00:12:26,2014-07-26 00:16:37
55fe8a8aae5c53333edeeefeebe02f11c6af41d3...b8ae210d9b3a1bac323aedcd69165fc0c7ce6832,2,4,1,5,2,2014-07-29 00:12:26,2014-07-26 00:31:05
b8ae210d9b3a1bac323aedcd69165fc0c7ce6832...c65a199c3cdd585fff3389b493197db409300f6c,2,18,12,30,7,2014-07-29 00:12:27,2014-07-28 22:05:55
c65a199c3cdd585fff3389b493197db409300f6c...381956d40beb040ac1c35f02790bdb7f933d3e69,1,7,3,10,4,2014-07-29 00:37:20,2014-07-29 00:36:30
381956d40beb040ac1c35f02790bdb7f933d3e69...cd57ac3535bda4119a62b5bb2cfa4d733a9193c2,6,59,29,88,26,2014-07-29 03:45:08,2014-07-29 03:24:07
cd57ac3535bda4119a62b5bb2cfa4d733a9193c2...30a397cde5383c1bd9b7c259cf4de2695cafd8f6,1,8,8,16,5,2014-07-30 00:19:31,2014-07-30 00:19:31
30a397cde5383c1bd9b7c259cf4de2695cafd8f6...c6ad06fe7781b5dc4e0f405a60c0cf5ac91c3ac5,1,3,3,6,2,2014-07-30 01:42:25,2014-07-30 01:42:25
c6ad06fe7781b5dc4e0f405a60c0cf5ac91c3ac5...950a3d9c1b3b43d4b2eae9021a3454ac23d1bb78,2,39,15,54,6,2014-07-30 01:57:59,2014-07-30 00:26:07
950a3d9c1b3b43d4b2eae9021a3454ac23d1bb78...81e4b51cf69113695d4f2b602340cd257eb34f92,1,3,2,5,1,2014-07-30 01:57:59,2014-07-30 01:27:27
81e4b51cf69113695d4f2b602340cd257eb34f92...70c0ff2c98f6b1b37201104aa9dcb735a327d423,1,34,16,50,4,2014-07-30 01:57:59,2014-07-30 01:52:46
70c0ff2c98f6b1b37201104aa9dcb735a327d423...43b04a12b2c614297aaafe13912ad3cd967b799d,2,19,1,20,5,2014-07-30 01:57:59,2014-07-30 01:57:17
43b04a12b2c614297aaafe13912ad3cd967b799d...d316eacab2c1925b753fadc0164cfe2c95963394,1,11,2,13,2,2014-07-30 04:19:43,2014-07-30 04:19:43
d316eacab2c1925b753fadc0164cfe2c95963394...0902f7e39a137027c5ad744331e8acbed04d94dd,4,23,22,45,19,2014-07-30 15:07:12,2014-07-30 15:07:12
0902f7e39a137027c5ad744331e8acbed04d94dd...26f9b283a51269857bb1113b1179387faf29f021,2,24,2,26,3,2014-07-30 22:44:12,2014-07-30 22:44:12
26f9b283a51269857bb1113b1179387faf29f021...f2ebbb1238396f075e09b06502c17aa9cd451b49,1,20,14,34,5,2014-07-30 22:58:12,2014-07-30 15:32:59
f2ebbb1238396f075e09b06502c17aa9cd451b49...a91ff48da5806c3844e67ad6c0f061d65143a335,1,1,1,2,1,2014-07-30 22:58:12,2014-07-30 22:47:42
a91ff48da5806c3844e67ad6c0f061d65143a335...0460c5015f88ce9d8357cc79108cd0b8c753d4a7,1,8,9,17,3,2014-07-30 23:01:32,2014-07-30 23:01:32
0460c5015f88ce9d8357cc79108cd0b8c753d4a7...2658a18a010a7cdb8c5b6e7d075a9f4de1168e7e,4,30,3,33,8,2014-07-30 23:23:17,2014-05-15 19:08:31
2658a18a010a7cdb8c5b6e7d075a9f4de1168e7e...9fd2214d89b31c229b3faa371f16e27a405a914e,1,1,0,1,1,2014-07-30 23:23:17,2014-06-12 07:21:51
9fd2214d89b31c229b3faa371f16e27a405a914e...e76332b10274560e473081d38c26fa033c2fd4ef,1,2,2,4,2,2014-07-30 23:23:17,2014-07-22 01:41:27
e76332b10274560e473081d38c26fa033c2fd4ef...114b36bbcbfc012f88bc0f7db1dd893ad07f9859,1,1,1,2,1,2014-07-30 23:23:17,2014-07-22 10:37:01
114b36bbcbfc012f88bc0f7db1dd893ad07f9859...135dd942aa6c7026529e32937862c378e518b716,1,5,5,10,2,2014-07-30 23:23:17,2014-07-30 19:00:51
135dd942aa6c7026529e32937862c378e518b716...d8e28eb74bd6ada4306b66dd256ff24a89786b1e,1,4,1,5,2,2014-07-30 23:23:17,2014-07-30 23:21:13
d8e28eb74bd6ada4306b66dd256ff24a89786b1e...30e02600b490ecd2976e72554cb0a3ffd7dcde3f,1,4,2,6,1,2014-07-30 23:55:49,2014-07-30 23:51:12
b14a3d13763f89586d31b1d3bcc6136490fabf34...cb16be87d06e9cee34201877ac6fbf5fa4b5cc6c,1,46,297,343,5,2014-08-06 18:08:59,2014-08-06 18:08:59
cb16be87d06e9cee34201877ac6fbf5fa4b5cc6c...5059a5655d4435b60eb825a7c4fc8fb8f40fb405,3,379,27,406,11,2014-08-06 19:08:48,2014-08-06 19:05:41
b14a3d13763f89586d31b1d3bcc6136490fabf34...d538d409722f0ee8d5c2cc3a00337878c6e278ef,1,36,0,36,1,2014-08-06 17:56:24,2014-08-06 17:56:24
d538d409722f0ee8d5c2cc3a00337878c6e278ef...8eb6337202b1ebd8c63d2f578ffc62d822b3b187,1,109,0,109,1,2014-08-06 21:24:48,2014-08-06 21:24:48
8eb6337202b1ebd8c63d2f578ffc62d822b3b187...7fcc41f1ed899a3da964ae8c085551544b9afde4,4,119,54,173,17,2014-08-07 18:00:29,2014-08-07 17:59:04
7fcc41f1ed899a3da964ae8c085551544b9afde4...8b4387982aa71035ec96c89b1612094f298157c1,2,2,2,4,2,2014-08-07 18:30:10,2014-08-07 18:30:10
764ceb6077d7aa76f11868beb9134522263fda8a...a4b9dd52f30eac37bb597aba97a40e5e7596192c,1,17,1,18,2,2014-01-29 21:17:34,2014-01-29 21:16:06
764ceb6077d7aa76f11868beb9134522263fda8a...98a35ab0001265a0813c63fb21bf09cf112fdb2f,1,63,15,78,11,2014-01-29 02:00:19,2014-01-29 01:37:38
ad05c3a5205a7b7407274105199bbfaabbab4592...ce1e323d34b07d77fd077f925515de1618ba5197,1,15,1,16,1,2014-12-11 08:20:27,2014-12-11 08:20:27
a9b013d22ecd636f034456fb1ad297477475f4a5...ace6ad8ed1a47e9553d0a95b367309d3ae009aaa,1,0,8,8,1,2014-12-09 21:16:05,2014-12-09 21:16:05
c6ac5c6a3120e07af3c0158e1bb5e00910e603e6...22895374601b7569924bf56de024593f98076f6f,7,95,34,129,15,2014-10-29 07:16:10,2014-10-29 07:16:10
22895374601b7569924bf56de024593f98076f6f...3b96bc9b080148ca5c780ba35307ea42e1e4b6d5,2,8,3,11,3,2014-10-29 07:19:30,2014-10-29 07:19:30
3b96bc9b080148ca5c780ba35307ea42e1e4b6d5...36c85ac34c5aef08239f8f295d327e2c3681a30d,1,2,2,4,2,2014-10-29 07:21:51,2014-10-29 07:21:51
36c85ac34c5aef08239f8f295d327e2c3681a30d...fa4f8a9ce0ad8aff85747bfbfdc4972501499e17,1,6,1,7,1,2014-10-29 07:25:08,2014-10-29 07:22:09
fa4f8a9ce0ad8aff85747bfbfdc4972501499e17...f4bbeeb454cbe5c5087f6e5a589620639c9f0e39,2,13,2,15,5,2014-10-29 07:25:08,2014-10-29 07:24:35
f4bbeeb454cbe5c5087f6e5a589620639c9f0e39...45f863992a17e368c72a0e8abd4d124f8e7bdbe9,4,66,21,87,6,2014-10-29 07:49:49,2014-10-29 07:49:49
45f863992a17e368c72a0e8abd4d124f8e7bdbe9...e6d81f3c1dd66bc52e19da011a702378ada571e5,2,115,8,123,10,2014-10-29 18:01:10,2014-10-29 18:01:10
e6d81f3c1dd66bc52e19da011a702378ada571e5...89990db0de2d6c5bf4faac61264b3c2f73ccd65e,1,47,38,85,12,2014-10-29 18:13:58,2014-10-29 18:13:58
89990db0de2d6c5bf4faac61264b3c2f73ccd65e...5075b368710a8426ef9e125908bb90a583ade109,1,3,0,3,1,2014-10-29 18:17:17,2014-10-29 18:17:17
5075b368710a8426ef9e125908bb90a583ade109...95600f805a30cff1aedb6727a80e4881323a1c29,3,11,11,22,12,2014-10-30 05:00:09,2014-10-30 05:00:09
03a27a4b549054bc043a96b8982abd5f2d5cda95...bd3b61a571a7e7294baac492c0e6cafc0189fc1f,1,2,1,3,1,2014-10-14 06:28:40,2014-10-14 06:28:26
bd3b61a571a7e7294baac492c0e6cafc0189fc1f...efa8a4553650483e4767ab4a8d989506b810d90b,1,1,1,2,1,2014-10-14 19:55:03,2014-10-14 19:55:03
efa8a4553650483e4767ab4a8d989506b810d90b...647f13cabb72c4d761fde442d4f202c1692a5073,2,4,3,7,3,2014-10-14 22:32:59,2014-10-14 22:32:59
647f13cabb72c4d761fde442d4f202c1692a5073...50c3c3e78b2cf26173ac2773afe0d758fed69114,3,74,37,111,23,2014-10-14 23:23:21,2014-10-14 23:23:02
50c3c3e78b2cf26173ac2773afe0d758fed69114...f83c08e8fa0411d0cf909e6da85129f430f4d475,6,370,105,475,32,2014-10-14 23:49:50,2014-10-14 23:49:50
f3d83058a1122c753911e79e7cd83596534d39e1...07f0c56a854f90ac66e091da09fcece063c51a4d,4,22,5,27,10,2014-10-03 22:46:43,2014-10-03 21:41:26
07f0c56a854f90ac66e091da09fcece063c51a4d...b4a0df4e7d564f4f46701cb29a24df1869d1f792,1,42,0,42,1,2014-10-03 22:46:43,2014-10-03 22:26:42
3fe1c063437435002b497eb317ad1a4a95b267ed...1ac45850de3e5e379d9e0211fc1ac8a09420a76f,78,2969,784,3753,72,2014-09-30 04:09:25,2014-09-30 04:09:25
3fe1c063437435002b497eb317ad1a4a95b267ed...86a811b5b29393143a34b866befe5c6227abe0c5,2,4,3,7,3,2014-09-30 03:40:25,2014-09-30 03:40:25
9608e6205019b69a302cde62e21fcae1c7d22e3d...bc9fb056b343d34fa8e33fbb27b15170a869c48f,3,6,6,12,5,2014-09-25 00:41:30,2014-09-25 00:31:39
47800298c6d570a840bf9e20cf899cd770b2fe46...5e02e2dade7a9781d6cce813e5c00c39f8338884,1,27,1,28,1,2014-10-01 22:19:19,2014-10-01 20:51:55
5e02e2dade7a9781d6cce813e5c00c39f8338884...166fe658d726da76726b1b0cec3dd25b19a20a38,2,2,2,4,2,2014-10-01 22:34:00,2014-10-01 22:34:00
166fe658d726da76726b1b0cec3dd25b19a20a38...0129c3f5acc192dba941533e45e934ee0abbbd3f,123,126,126,252,125,2014-10-01 22:43:05,2014-10-01 22:43:05
0129c3f5acc192dba941533e45e934ee0abbbd3f...18620e3ebeaafbd5d2c0124efa5f28d6b2e82ecc,1,1,1,2,1,2014-10-01 22:43:42,2014-10-01 22:43:42
18620e3ebeaafbd5d2c0124efa5f28d6b2e82ecc...f65da4a940643ba407fa4c02079f3bedeb594d33,1,2,1,3,2,2014-10-02 00:06:19,2014-09-30 22:32:39
f65da4a940643ba407fa4c02079f3bedeb594d33...1e53f6b59833496d0fd731b1f4dacac47501985d,122,122,122,244,122,2014-10-02 00:06:57,2014-10-02 00:06:57
1e53f6b59833496d0fd731b1f4dacac47501985d...42bdfde8cafda301c2470dcd67808083e7ed1c0d,3,35,12,47,7,2014-10-02 00:11:18,2014-10-01 23:42:14
42bdfde8cafda301c2470dcd67808083e7ed1c0d...3ac172427ef399c4d49c5eaf6d11dc553f76d774,1,2,2,4,2,2014-10-02 00:19:18,2014-10-02 00:19:18
3ac172427ef399c4d49c5eaf6d11dc553f76d774...c638b15fe519f33b2bfda4ae1269d77d4dba0cae,1,1,1,2,1,2014-10-02 00:34:44,2014-10-02 00:34:44
c638b15fe519f33b2bfda4ae1269d77d4dba0cae...f5b3b05522508b01439e0a8efed3c50290d304a4,1,1,1,2,1,2014-10-02 00:37:49,2014-10-02 00:37:49
f5b3b05522508b01439e0a8efed3c50290d304a4...d30ee0a69e37029e57f05bed064aa472615b5bc4,3,24,7,31,4,2014-10-02 03:08:43,2014-10-02 03:08:43
d30ee0a69e37029e57f05bed064aa472615b5bc4...c4115de3bc9b99efe4790e0932839d0a56333947,24,1,107,108,3,2014-10-02 03:48:37,2014-10-02 03:48:37
c4115de3bc9b99efe4790e0932839d0a56333947...e42e8f4b6d286dad88239dc603efb42481d05bb9,1,1,1,2,1,2014-10-02 03:50:39,2014-10-02 03:50:39
e42e8f4b6d286dad88239dc603efb42481d05bb9...2d9bb65433f82ca93965115f3f54214935e03c91,1,1,1,2,1,2014-10-02 22:51:22,2014-10-02 22:51:22
fa91505bb18bf5ad5e44d412f93a170001708310...b18d592042c7ab603fb8e4b9c4c9efa2a3d5807e,2,5,2,7,3,2014-09-04 00:18:33,2014-09-04 00:18:33
fa91505bb18bf5ad5e44d412f93a170001708310...5cf24a948dcf78baa01ac860d285d06a4d30e058,8,148,29,177,33,2014-09-03 21:55:44,2014-08-29 18:07:13
5cf24a948dcf78baa01ac860d285d06a4d30e058...bd63f59b92cd35d9af0970c70b16f2332f9ea650,1,0,12,12,2,2014-09-03 21:55:44,2014-08-29 18:46:17
bd63f59b92cd35d9af0970c70b16f2332f9ea650...2c6f2941683e5d8717e47a688ab7c9339aa5cb25,1,1,1,2,1,2014-09-03 23:50:26,2014-09-03 19:31:54
d771fdbf2af59dd66a596153db8410edd0d9dd11...4586d60e7d561f436e52f875e3a8106256a78084,1,2,1,3,2,2014-08-21 06:21:30,2014-08-21 02:04:53
4586d60e7d561f436e52f875e3a8106256a78084...7e32a1cba4663641d2697bc104f169441452ba52,1,0,44,44,2,2014-08-21 06:21:30,2014-08-21 02:04:58
7e32a1cba4663641d2697bc104f169441452ba52...8d72be167b690070f8d90bffeff0a44b1beb028a,1,53,45,98,10,2014-08-21 06:21:30,2014-08-19 22:39:55
8d72be167b690070f8d90bffeff0a44b1beb028a...eb101e90b84363f7b6e59a631ec075eb9763243b,3,85,69,154,35,2014-08-21 06:21:30,2014-08-21 02:59:04
eb101e90b84363f7b6e59a631ec075eb9763243b...e98cd49b3bf5e757f537320b72e39aa96149ef4a,5,45,11,56,13,2014-08-21 06:21:30,2014-08-21 04:00:49
e98cd49b3bf5e757f537320b72e39aa96149ef4a...6e325247d5ba3c8e086653fef249f7c96d49efd4,2,12,3,15,3,2014-08-21 06:21:30,2014-08-21 06:18:00
a4b9dd52f30eac37bb597aba97a40e5e7596192c...4facd57f5f704a541cb0f5f91cf12b94d7c171d3,1,3,2,5,3,2014-01-29 21:52:48,2014-01-17 10:21:56
4facd57f5f704a541cb0f5f91cf12b94d7c171d3...9b7ac6080bacc99776e64f9c390439768def00bb,1,2,0,2,1,2014-01-29 21:53:43,2014-01-29 21:53:43
9b7ac6080bacc99776e64f9c390439768def00bb...fb446cbe168f5c075d572531561818cffb3de80a,4,57,1,58,4,2014-01-29 22:32:13,2014-01-29 21:54:01
ace6ad8ed1a47e9553d0a95b367309d3ae009aaa...58321c3c58cd02ba19b806545cbbb2d87c31b8e4,1,0,6,6,1,2014-12-16 18:21:16,2014-12-14 09:04:47
58321c3c58cd02ba19b806545cbbb2d87c31b8e4...496d432856f75bf9d12d3af7aae5466f72da7064,1,2,2,4,2,2014-12-16 18:26:08,2014-12-07 17:31:09
ace6ad8ed1a47e9553d0a95b367309d3ae009aaa...ee912c025146cc00014112f6e9942807f39cf658,4,80,23,103,22,2014-12-10 07:02:40,2014-12-10 05:03:49
ee912c025146cc00014112f6e9942807f39cf658...8309fa6a02edb87312fdede1967e832a8dbd872f,4,97,1,98,4,2014-12-10 07:24:49,2014-12-10 07:24:25
8309fa6a02edb87312fdede1967e832a8dbd872f...64ad52b4e9b7fab105b24853eae5545d42e519c6,1,0,6,6,2,2014-12-10 18:59:32,2014-12-10 18:59:32
71652f9b9fe2c19f21f344292071827ba9b44a4a...0d33cbbfca6cc769ef6c634ca249ca40a1be6e52,1,0,8,8,1,2014-12-09 21:16:28,2014-12-09 21:16:05
b6c4d11f58727172758706c7825b0950b9ccb787...e496220bfd07810b6f20d61ccccb911468eb29c0,1,0,2,2,1,2014-10-29 00:34:12,2014-10-29 00:34:12
e496220bfd07810b6f20d61ccccb911468eb29c0...fb5ef8555ed3fe4ffd855679b83ba8853e62945e,1,2,3,5,3,2014-10-29 00:39:17,2014-10-29 00:32:25
fb5ef8555ed3fe4ffd855679b83ba8853e62945e...d4acbd93d5ea50e9dd60ceeb49c6df2bf96c82ba,1,5,1,6,3,2014-10-29 17:11:49,2014-10-29 17:10:19
d4acbd93d5ea50e9dd60ceeb49c6df2bf96c82ba...f97e374ac7cc2d7b7f6a4dc2ab5ea6989abd93ae,1,0,14,14,1,2014-10-30 01:10:49,2014-10-30 01:10:49
f97e374ac7cc2d7b7f6a4dc2ab5ea6989abd93ae...af44a73093dc59e3a51085aee94c0cb568ecc4ff,1,28,13,41,5,2014-10-30 01:33:57,2014-10-30 01:33:57
af44a73093dc59e3a51085aee94c0cb568ecc4ff...ca99f0506aba9715bed46f477c3192aa0142175b,1,0,7,7,1,2014-10-30 01:39:26,2014-10-30 01:39:26
ca99f0506aba9715bed46f477c3192aa0142175b...e4a10e5f11a8c98980e3c6f2f5d75952ef541df0,5,39,78,117,21,2014-10-30 01:51:02,2014-10-30 01:51:02
e4a10e5f11a8c98980e3c6f2f5d75952ef541df0...1ed619378f65a9ad6cec675b55a4540f3e0a9907,1,88,88,176,8,2014-10-30 01:52:07,2014-10-30 01:52:07
1ed619378f65a9ad6cec675b55a4540f3e0a9907...63e91e1f54c063ba52af24f660f6979ed4df251a,1,20,32,52,6,2014-10-30 02:04:36,2014-10-30 02:04:36
63e91e1f54c063ba52af24f660f6979ed4df251a...6382bd84745dc944eff9b3581221df7df25c1228,6,7,47,54,9,2014-10-30 02:10:05,2014-10-30 02:10:05
6382bd84745dc944eff9b3581221df7df25c1228...280d0afcfcb97d0b18f9b046d44c8a3d19045e9a,1,1,1,2,1,2014-10-30 02:12:32,2014-10-30 02:12:32
280d0afcfcb97d0b18f9b046d44c8a3d19045e9a...17f16160e51a6946f629222eeeeda498b3446495,3,4,15,19,5,2014-10-30 02:15:51,2014-10-30 02:15:51
17f16160e51a6946f629222eeeeda498b3446495...7ac4a838e36e49dbc9874db0d84e80ac400877c4,2,0,2,2,2,2014-10-30 02:25:13,2014-10-30 02:25:13
f83c08e8fa0411d0cf909e6da85129f430f4d475...650ca70fe660482f7064332d8501e2cd048a9ddc,1,5,0,5,1,2014-10-15 04:53:01,2014-10-15 04:53:01
650ca70fe660482f7064332d8501e2cd048a9ddc...f080d010a0bb0efef5a7002e4ccec6afa36434a4,1,13,0,13,1,2014-10-15 05:07:14,2014-10-15 05:07:14
f080d010a0bb0efef5a7002e4ccec6afa36434a4...52d90fa3167144c7f02451b1e20436c42d75dd5a,1,5,2,7,1,2014-10-15 20:23:06,2014-10-15 20:23:06
f83c08e8fa0411d0cf909e6da85129f430f4d475...ec18b34e4d5373c0a9ed52ac62787d3710184603,1,1,4,5,2,2014-10-15 04:10:02,2014-10-15 04:09:41
ec18b34e4d5373c0a9ed52ac62787d3710184603...301eb65637c61b39161f800f46ce2ac0f213edcc,10,3,44,47,11,2014-10-15 04:14:14,2014-10-15 04:11:26
5156af1a4bc6353f1d3f6ca737a8295d582999cf...7361a5de3ddecf26b0f465fa894f4d496950d59c,1,0,3,3,1,2014-10-03 22:49:04,2014-10-03 22:48:49
b94da112bbe55c5f2d50f6e9c08db54376c11ed5...f65873f315cd998db3a70e9a36a10883db94f263,1,1,1,2,1,2014-09-30 07:07:18,2014-09-30 07:05:49
f65873f315cd998db3a70e9a36a10883db94f263...69501a9eb3eb6c63fb925b2b0c9b29a50a1331b2,1,1,1,2,1,2014-09-30 18:23:09,2014-09-30 08:17:10
69501a9eb3eb6c63fb925b2b0c9b29a50a1331b2...a9ea64a7c30326324f4c4b84405642766fb4dea6,2,15,4,19,6,2014-09-30 18:49:43,2014-09-30 18:49:43
a9ea64a7c30326324f4c4b84405642766fb4dea6...3236121b0fcf71451bce07076d8a25280a0c1b66,1,1,1,2,1,2014-09-30 18:51:16,2014-09-30 04:57:19
3236121b0fcf71451bce07076d8a25280a0c1b66...f817b32852c6e5f3933e0269efd9ebf3b8f12fb2,2,2,2,4,3,2014-09-30 18:51:16,2014-09-30 06:01:33
f817b32852c6e5f3933e0269efd9ebf3b8f12fb2...cd55ca4b1c243db26943e7352f0e46082bec2e31,5,63,63,126,45,2014-09-30 18:51:16,2014-09-30 06:40:12
cd55ca4b1c243db26943e7352f0e46082bec2e31...14c0ec29f82a4128f14274ee7a195638e1dbfc93,1,20,0,20,1,2014-09-30 18:51:16,2014-09-30 06:41:17
14c0ec29f82a4128f14274ee7a195638e1dbfc93...bcacef436e903f313ef40f562df8e2e21dda3cb0,1,2,2,4,1,2014-09-30 18:51:16,2014-09-30 06:42:32
bcacef436e903f313ef40f562df8e2e21dda3cb0...ce1a405101e078b2f02f3cda9308b0cb76ae5636,122,122,122,244,122,2014-09-30 18:51:17,2014-09-30 06:44:50
ce1a405101e078b2f02f3cda9308b0cb76ae5636...75c09c49d3a8bff566ac55c52e75edfb5b6b5b3f,1,1,1,2,1,2014-09-30 18:51:17,2014-09-30 07:30:42
75c09c49d3a8bff566ac55c52e75edfb5b6b5b3f...7808258a10cbd99b48c63ae49507ac6e6d3d2f81,3,3,3,6,3,2014-09-30 18:51:17,2014-09-30 08:41:27
7808258a10cbd99b48c63ae49507ac6e6d3d2f81...0d4134250e6ecc0e88c41260c1bd7ff6fe2a8392,1,1,1,2,1,2014-09-30 18:51:17,2014-09-30 08:44:45
0d4134250e6ecc0e88c41260c1bd7ff6fe2a8392...6a35e05ba3c771bcd11f19198601a0b6215d2777,1,18,8,26,3,2014-09-30 18:51:17,2014-09-30 16:33:13
6a35e05ba3c771bcd11f19198601a0b6215d2777...383faa5cdb283201c46992150fee3af7e3d672ee,1,5,0,5,1,2014-09-30 19:22:09,2014-09-26 23:50:54
383faa5cdb283201c46992150fee3af7e3d672ee...69df87ce7d14aae94269cab878761a9bbf48e0c7,2,15,8,23,8,2014-09-30 19:22:09,2014-09-30 19:18:21
fc194393b27a65d319f74cbf030148c5c923b950...43c996cd13e4e57b8c82ce26c801c7c2a279d83e,1,1,1,2,1,2014-09-30 04:41:05,2014-09-30 04:41:05
4c0bcdccfe123e2cc98c4edc9394e2e6e515eff9...99a57a5e7c6ef5f95b690f2431049aacd6f71d62,1,1,1,2,1,2014-09-30 04:57:19,2014-09-30 04:57:19
99a57a5e7c6ef5f95b690f2431049aacd6f71d62...283b57894dd172ef60728416308d6b0c0cbd35c9,2,2,2,4,3,2014-09-30 06:01:33,2014-09-30 06:01:33
bc9fb056b343d34fa8e33fbb27b15170a869c48f...8407a81b16226c696dd16afa295bfba82563521c,1,0,1,1,1,2014-09-25 02:44:15,2014-09-25 02:44:15
bc9fb056b343d34fa8e33fbb27b15170a869c48f...e8ebfe8aaeb44c7dfa955043b3540081ec2c49f8,3,106,42,148,26,2014-09-25 01:52:54,2014-09-24 23:45:21
e8ebfe8aaeb44c7dfa955043b3540081ec2c49f8...a3f3b7b6902224ae83b9ab0c87ae2bf0b0bbadde,2,26,0,26,2,2014-09-25 02:04:17,2014-09-25 02:04:17
a3f3b7b6902224ae83b9ab0c87ae2bf0b0bbadde...22845b6f1110762ea77017401a1196c3a1403bcb,4,377,280,657,145,2014-09-25 05:02:57,2014-09-25 02:43:05
22845b6f1110762ea77017401a1196c3a1403bcb...170d0bc3bd2071527b7e33248a49cd12b7bc2cfe,3,103,83,186,17,2014-09-25 05:18:57,2014-09-25 05:18:57
6a2b92d6380aa649392ec1cafedc15e83a62e3ef...b8e0f5bb918c27d746405eabb856283f590a6979,1,60,1,61,1,2014-09-04 18:05:10,2014-09-04 18:04:16
b8e0f5bb918c27d746405eabb856283f590a6979...a282e1d81daa53db4dab777db02728c4e377ffc9,1,14,9,23,5,2014-09-04 18:10:32,2014-09-04 18:10:32
a282e1d81daa53db4dab777db02728c4e377ffc9...8d00dd273c66f944f250079591efe10999559e05,1,376,0,376,1,2014-09-04 18:19:28,2014-09-04 18:19:28
8d00dd273c66f944f250079591efe10999559e05...5aa3e2e1a77b959f259e99c3b0b147bf819e84a7,1,0,2,2,1,2014-09-04 18:29:16,2014-09-04 18:29:16
5aa3e2e1a77b959f259e99c3b0b147bf819e84a7...a00bfc7372fc82c18a7e08b317e7ae48d608ccaa,1,3,3,6,3,2014-09-04 18:31:10,2014-09-04 18:31:07
a00bfc7372fc82c18a7e08b317e7ae48d608ccaa...569431841ee1d4108e8f57baea2617284339d6ff,1,10,0,10,1,2014-09-04 18:34:44,2014-09-04 18:34:00
569431841ee1d4108e8f57baea2617284339d6ff...c31c3babd3283ba2dedec9c425b81601b860c31e,1,2,0,2,1,2014-09-04 18:37:52,2014-09-04 18:37:38
c31c3babd3283ba2dedec9c425b81601b860c31e...23b8e178ffc15ca75db4860805d5144464d30476,1,1,1,2,1,2014-09-04 18:39:31,2014-09-04 18:39:13
23b8e178ffc15ca75db4860805d5144464d30476...1a946cd326addcc9532661610fa5cf2359221519,3,3,3,6,3,2014-09-04 18:50:27,2014-09-04 18:50:27
1a946cd326addcc9532661610fa5cf2359221519...eeeec9ed9704191fa545eb0764e0c92aaa9b742c,1,43,36,79,25,2014-09-04 18:59:54,2014-09-04 18:59:36
eeeec9ed9704191fa545eb0764e0c92aaa9b742c...562065c5c437b1d980c35a022175afe1d645c2f1,1,9,9,18,5,2014-09-04 19:02:20,2014-09-04 19:02:20
562065c5c437b1d980c35a022175afe1d645c2f1...c885cfc7b6a874964f80f3a646742c742a21f1b6,1,6,11,17,3,2014-09-04 19:04:53,2014-09-04 19:04:53
c885cfc7b6a874964f80f3a646742c742a21f1b6...29017d9e9af2bd756ed4815ab2130bb10b9cbbcd,1,2,1,3,1,2014-09-04 19:08:41,2014-09-04 19:08:41
29017d9e9af2bd756ed4815ab2130bb10b9cbbcd...5405f98d17570cb3bd80880e3cb3861c69a4c1f1,1,12,9,21,3,2014-09-04 19:10:25,2014-09-04 19:10:25
5405f98d17570cb3bd80880e3cb3861c69a4c1f1...4bceab441b1939d1b6a6258249ad73a12f98898b,1,3,2,5,2,2014-09-04 19:13:30,2014-09-04 19:03:23
4bceab441b1939d1b6a6258249ad73a12f98898b...595b7cfdea68b9dd38386b2c0f96ac0a9477ef36,1,17,17,34,3,2014-09-04 19:21:34,2014-09-04 19:21:16
595b7cfdea68b9dd38386b2c0f96ac0a9477ef36...0d90426fac4d5baaf2b337c258000972d2761a72,1,1,1,2,1,2014-09-04 19:22:19,2014-09-04 19:22:19
0d90426fac4d5baaf2b337c258000972d2761a72...83341c5dabeb2433d29a2cdf6629859ae31bd5a0,1,1,1,2,1,2014-09-04 19:22:53,2014-09-04 19:22:53
83341c5dabeb2433d29a2cdf6629859ae31bd5a0...3d8bfb41edd753a3798c2ad316568a0f18f9e797,1,9,9,18,5,2014-09-04 19:26:58,2014-09-04 19:26:58
3d8bfb41edd753a3798c2ad316568a0f18f9e797...10b2c8ea2e9ff371d733fd6cf66e3c24c3fcd5a9,1,2,2,4,2,2014-09-04 19:34:48,2014-09-04 19:34:48
10b2c8ea2e9ff371d733fd6cf66e3c24c3fcd5a9...65c2b762bdc4d62bdb873fa75a36be1e39c19803,1,8,0,8,2,2014-09-04 21:48:07,2014-09-04 21:48:07
65c2b762bdc4d62bdb873fa75a36be1e39c19803...e46522c7c69fd5b5f885431795864cdce8c8141f,1,1,1,2,1,2014-09-04 22:30:43,2014-09-04 22:30:07
e46522c7c69fd5b5f885431795864cdce8c8141f...c23408bdd725fa8355be89718be7a71efedf2c2c,55,56,57,113,56,2014-09-04 22:41:39,2014-09-04 22:41:33
cd2f132491e3bf79f839ed0128b4b87b625a971b...4a44621e3b4fa89044d3c1ab269b48da601b8923,3,4,2,6,3,2014-08-21 18:52:29,2014-08-21 18:52:29
cd2f132491e3bf79f839ed0128b4b87b625a971b...db8de25e6080be00648a533c95a540aa045b99aa,1,4,3,7,4,2014-08-21 18:15:19,2014-08-21 18:15:19
f96d00932b8668d671628ec30c6e575318e4baa2...75fcdf5d3efc3c8afdb3e3aefac8d602d6b4adeb,7,244,562,806,59,2014-08-21 08:28:55,2014-08-21 07:33:00
fb446cbe168f5c075d572531561818cffb3de80a...5cfe47e1f6628f90b7609ba574d2f686d45f1699,1,8,2,10,3,2014-01-29 22:39:35,2014-01-29 22:36:36
5cfe47e1f6628f90b7609ba574d2f686d45f1699...a3b72132477c184ead49c1a538e6e2be000e969c,1,0,2,2,1,2014-01-29 22:39:35,2014-01-29 22:38:45
a3b72132477c184ead49c1a538e6e2be000e969c...df470136398047dc3194fb21f584617e1f4dbe3f,1,5,5,10,1,2014-01-29 22:48:38,2014-01-29 22:48:38
f9339a8f2676f0981fb9bc14680e5684b6b9d9c7...c9345ed4ea24c420593588998f605f942553a408,2,0,2,2,2,2014-12-09 22:04:42,2014-12-09 22:04:42
c9345ed4ea24c420593588998f605f942553a408...31a43fc019714e6c6c4b3858514c9fc337e5b112,3,0,3,3,3,2014-12-10 02:30:22,2014-12-10 02:30:22
31a43fc019714e6c6c4b3858514c9fc337e5b112...d3ff3954bfe6dd9a5592d8e69ecc6d97dbda1deb,4,13,38,51,14,2014-12-10 02:43:25,2014-12-10 02:43:25
d3ff3954bfe6dd9a5592d8e69ecc6d97dbda1deb...118e330cbaf23614d09c893d3a23d5847b4ee163,3,34,18,52,8,2014-12-10 03:38:09,2014-12-10 03:38:09
118e330cbaf23614d09c893d3a23d5847b4ee163...21a34a98b3059d3b66983c79ff882b0e63b50942,2,17,7,24,7,2014-12-10 03:52:03,2014-12-10 03:52:03
21a34a98b3059d3b66983c79ff882b0e63b50942...e7bfa5202ed1b0de4392f52a9d23b74f924b0b8a,10,15,15,30,11,2014-12-10 04:09:34,2014-12-10 04:09:34
e7bfa5202ed1b0de4392f52a9d23b74f924b0b8a...6ea8443f309da891c8b828e267f03c4415d65845,139,522,522,1044,384,2014-12-10 04:18:31,2014-12-10 04:18:31
6ea8443f309da891c8b828e267f03c4415d65845...44563f13b4a3b394f9c87bc2a38a9ce4b0fc4766,2,8,3,11,5,2014-12-10 04:33:06,2014-12-10 04:32:43
7ac4a838e36e49dbc9874db0d84e80ac400877c4...8bfa67b807fc0e82835340c3261df2a93b122c03,1,39,0,39,1,2014-11-07 22:32:03,2014-11-07 22:32:03
8bfa67b807fc0e82835340c3261df2a93b122c03...fa83ea75dcbcd11cc4a625164c890e37971306ff,1,75,30,105,8,2014-11-11 00:40:30,2014-11-11 00:40:30
fa83ea75dcbcd11cc4a625164c890e37971306ff...36585c2f97e746e108ce4c6a7d3849c018f1a3a6,1,19,12,31,9,2014-11-11 01:21:51,2014-11-11 01:21:51
36585c2f97e746e108ce4c6a7d3849c018f1a3a6...36a626e314b51402f0a8ac33570c330712a0060b,1,3,0,3,1,2014-11-11 01:47:08,2014-11-11 01:47:08
7ac4a838e36e49dbc9874db0d84e80ac400877c4...f8333123ba9c1a8ecf2b63a1cbe6fa844a681253,1,2,2,4,1,2014-10-30 17:17:53,2014-10-30 09:53:16
f8333123ba9c1a8ecf2b63a1cbe6fa844a681253...f3cc623615269f84a75f087534986e45b4b1df3a,1,3,2,5,3,2014-10-30 17:34:50,2014-10-30 17:34:50
e8adfb2e67f55361502a5c46bb95dd09f6dce007...998ca6debfccd7e10e8508b00c84cf2b8868b932,1,1,2,3,2,2014-10-15 17:53:53,2014-10-15 17:53:53
e8adfb2e67f55361502a5c46bb95dd09f6dce007...6b02e8ab90f8b91031125f74ba33c9b0ffeeeffc,1,75,11,86,5,2014-10-15 13:16:45,2014-09-30 21:51:50
7361a5de3ddecf26b0f465fa894f4d496950d59c...de6a037320949f7d21e345762f1d8b29fc148bda,2,90,74,164,14,2014-10-03 23:14:48,2014-10-03 23:13:12
de6a037320949f7d21e345762f1d8b29fc148bda...3f2ee65a3b8473c16188862c68994b4821392487,1,12,0,12,6,2014-10-04 00:09:00,2014-10-04 00:09:00
7361a5de3ddecf26b0f465fa894f4d496950d59c...1c38deb8f5a1335f449a3d1858e7e897c25bae3b,1,1,1,2,1,2014-10-03 23:08:54,2014-10-03 23:08:54
1c38deb8f5a1335f449a3d1858e7e897c25bae3b...e0897dbaa9ffc9172d87653e8456cfa728396e21,1,4,2,6,2,2014-10-03 23:11:46,2014-10-03 23:11:46
e0897dbaa9ffc9172d87653e8456cfa728396e21...0cf088b6cbb3f352b8d1b3ca822fa754e2e6c0cc,13,13,13,26,13,2014-10-03 23:13:08,2014-10-03 23:13:08
0cf088b6cbb3f352b8d1b3ca822fa754e2e6c0cc...321b76f2675267b0dc113d88a79fe86bfc7b91bd,2,3,1,4,2,2014-10-03 23:14:35,2014-10-03 23:14:35
321b76f2675267b0dc113d88a79fe86bfc7b91bd...eaa8dc7a3bbee6aff7f0e164ba2ade4f83c6e689,2,3,3,6,2,2014-10-03 23:51:29,2014-10-03 23:51:29
eaa8dc7a3bbee6aff7f0e164ba2ade4f83c6e689...054e7576a6be33e4602bb6c94f9c3239ce409d83,3,3,3,6,3,2014-10-03 23:52:01,2014-10-03 23:52:01
054e7576a6be33e4602bb6c94f9c3239ce409d83...b0a4556da72fd2209dec21545b0ffe55719ac7ba,1,1,1,2,1,2014-10-03 23:52:46,2014-10-03 23:52:46
c5e383efbaf00e79777d326ba0cb9ef62fb402fe...5e7c1a45d8f9ef0c33ea012a25b28a83b84a8391,1,6,0,6,1,2014-09-30 21:04:17,2014-09-30 21:04:17
5e7c1a45d8f9ef0c33ea012a25b28a83b84a8391...4aa42726a9aebf367afa6b84427113ee37c9ac32,1,1,1,2,1,2014-09-30 21:08:33,2014-09-30 21:08:33
5ca48d48ded6236c8ee3ec0d08ec37a3f5dc1913...6273527450a1e8fae1dde9aa9a899b32252b597c,1,2,2,4,1,2014-09-30 06:42:32,2014-09-30 06:42:32
5ca48d48ded6236c8ee3ec0d08ec37a3f5dc1913...e3e9d9e3d720b6f714acd4a08a2316a2cb5dc4e1,5,63,63,126,45,2014-09-30 06:40:12,2014-09-30 06:40:12
e3e9d9e3d720b6f714acd4a08a2316a2cb5dc4e1...c48a1284f8d3e1a6dd5c3e2b01166842d34f9293,1,20,0,20,1,2014-09-30 06:41:17,2014-09-30 06:41:17
c48a1284f8d3e1a6dd5c3e2b01166842d34f9293...eecc272e4ad9f7a0caaa579889a179bd7f39eec8,122,122,122,244,122,2014-09-30 06:44:50,2014-09-30 06:44:50
8407a81b16226c696dd16afa295bfba82563521c...32f6edc624dc9687b3b4e42567e9624b262dee74,24,6,63,69,11,2014-09-25 18:02:34,2014-09-25 18:02:34
32f6edc624dc9687b3b4e42567e9624b262dee74...75c473b255bbb61fcd26720a37af516841ed1f05,6,24,15,39,5,2014-09-25 20:51:03,2014-09-25 20:51:03
75c473b255bbb61fcd26720a37af516841ed1f05...8f707caad9e8a623d325632e7decb826e97eb2f1,2,1,2,3,2,2014-09-25 20:54:52,2014-09-25 20:51:03
c23408bdd725fa8355be89718be7a71efedf2c2c...4bf58c16a0aebd828b0dc3bfc3e90ba1aab9b52f,1,4,1,5,1,2014-09-05 18:30:54,2014-09-05 18:06:52
c23408bdd725fa8355be89718be7a71efedf2c2c...7164544dadd606d89c2a54207cc247172486c60a,1,1,2,3,1,2014-09-04 23:07:16,2014-09-04 23:07:16
7164544dadd606d89c2a54207cc247172486c60a...ca526df381db49c097eefcca03a7a9c9f7c05d5a,15,137,128,265,67,2014-09-04 23:13:59,2014-09-04 23:13:59
ca526df381db49c097eefcca03a7a9c9f7c05d5a...78577b26a2df48916831c65f24f43ea725e6f13d,9,314,29,343,18,2014-09-04 23:43:55,2014-09-04 23:43:42
9ca9e5eadef3561186cd66d585a8172b606681dc...13aab9244cabc41214475dac6c222529ae016d15,1,4,3,7,4,2014-08-21 23:41:53,2014-08-21 18:15:19
75fcdf5d3efc3c8afdb3e3aefac8d602d6b4adeb...374c1cda45f88a3f0e16b3da28f1eb807812cc62,2,12,23,35,8,2014-08-21 09:40:02,2014-08-21 09:26:16
374c1cda45f88a3f0e16b3da28f1eb807812cc62...13f82bb09d2f6f1a10d9c983f8d41dca87c77f0c,6,62,155,217,24,2014-08-21 17:45:44,2014-08-21 17:45:44
13f82bb09d2f6f1a10d9c983f8d41dca87c77f0c...f1a50bbc935b79de010575b2389bdfffaf4be72a,1,1,1,2,1,2014-08-21 17:48:20,2014-08-21 17:48:20
f1a50bbc935b79de010575b2389bdfffaf4be72a...ff3d3d0e8210ce416bd8648c6117a2b474190156,1,0,62,62,3,2014-08-21 17:51:00,2014-08-21 17:51:00
ff3d3d0e8210ce416bd8648c6117a2b474190156...05b6277c97b90d6ec185bb2e30bb9a2897eb7ccd,1,1,6,7,4,2014-08-21 17:52:05,2014-08-21 17:52:05
05b6277c97b90d6ec185bb2e30bb9a2897eb7ccd...aa53f0bfd225ff9e749cb96569e4ab22a502d9c1,1,36,62,98,14,2014-08-21 18:31:27,2014-08-21 18:24:53
aa53f0bfd225ff9e749cb96569e4ab22a502d9c1...c926cf01f074b63a13307d4e49731fb1182c7f40,2,21,10,31,6,2014-08-21 18:39:01,2014-08-21 18:39:01
c926cf01f074b63a13307d4e49731fb1182c7f40...625a87fe19a3eac7adb095fadb67b96dcc621ca0,3,4,2,6,3,2014-08-21 19:01:23,2014-08-21 18:52:29
df470136398047dc3194fb21f584617e1f4dbe3f...9318b4c250e8523801578c85afbf51852ea1fdd4,1,3,4,7,2,2014-01-30 19:05:22,2014-01-30 19:05:22
f1a493aa042be7bd5f569f1f7402d0e15af1f558...99126905f2272d8841cd704a1bfe7c5a985a741a,1,0,1,1,1,2015-01-12 20:15:03,2014-12-03 23:45:25
99126905f2272d8841cd704a1bfe7c5a985a741a...cd014c76004ed86f4d305a3c0c1a079a45118144,1,12,1,13,5,2015-01-12 20:31:01,2014-12-13 14:38:43
cd014c76004ed86f4d305a3c0c1a079a45118144...ec52288f5ecb95a01fa3bbc069c07aeb409db518,1,5,1,6,1,2015-01-12 20:32:22,2015-01-12 20:31:32
6320acabc46bd6832d2f6db943b69a0634d6b6f9...9b00c9436c88928ce94470630de571897b95c91c,1,1,1,2,1,2014-12-19 19:51:16,2014-12-19 19:51:16
9b00c9436c88928ce94470630de571897b95c91c...19733f19d7a137ffb2466755ebb8f453203551e3,1,2,2,4,1,2014-12-19 22:05:51,2014-12-19 20:32:45
19733f19d7a137ffb2466755ebb8f453203551e3...beaf067540cff02d7d84765c4a23821fa51ab4be,1,1,1,2,1,2014-12-19 22:08:26,2014-12-19 22:08:11
beaf067540cff02d7d84765c4a23821fa51ab4be...5a70151a57cc69867ef8abf8fa2f46ea4860fe65,1,1,1,2,1,2014-12-21 01:23:57,2014-12-20 08:04:49
5a70151a57cc69867ef8abf8fa2f46ea4860fe65...9d4175b2b45520103640abdfdd75d17c62faefb2,3,0,3,3,3,2014-12-21 04:30:17,2014-12-21 04:30:17
9d4175b2b45520103640abdfdd75d17c62faefb2...00a7da3dd06be16f3cc8ebe79911642297bf853c,1,4,3,7,2,2014-12-21 04:38:25,2014-12-21 04:38:25
00a7da3dd06be16f3cc8ebe79911642297bf853c...fcf8f6616d980f19374be809fccca90f565e3172,1,2,2,4,2,2014-12-22 02:00:13,2014-12-22 02:00:13
fcf8f6616d980f19374be809fccca90f565e3172...508472eb8ac62dcb457244d9bb98e4f2ef3befc8,1,1,1,2,1,2014-12-22 17:39:23,2014-12-22 17:39:23
508472eb8ac62dcb457244d9bb98e4f2ef3befc8...f5f136adc98a61c201c9d53288acb104f8e3ac50,4,65,13,78,8,2014-12-22 20:19:59,2014-12-22 20:19:59
44563f13b4a3b394f9c87bc2a38a9ce4b0fc4766...3b89779736867f24d77faecd15d41bc4fdb2c927,1,77,33,110,9,2014-12-12 06:32:43,2014-12-12 06:32:43
3b89779736867f24d77faecd15d41bc4fdb2c927...e4a984fb6fb7d24fb9aad597b64abe46d66d9370,1,1,1,2,1,2014-12-12 19:13:45,2014-12-12 19:13:45
44563f13b4a3b394f9c87bc2a38a9ce4b0fc4766...d7d51f9dac79580fd5a4030b59fe5fed90e534bc,7,96,87,183,28,2014-12-10 22:42:18,2014-12-10 22:41:06
d7d51f9dac79580fd5a4030b59fe5fed90e534bc...0ed8a9b32d8bce241220a31e4874ac62217baeab,8,8,8,16,8,2014-12-10 22:50:11,2014-12-10 22:50:11
0ed8a9b32d8bce241220a31e4874ac62217baeab...ace8430567dd8187387d38d4fd5e8c12a853500a,1,79,59,138,17,2014-12-10 23:26:41,2014-12-10 23:26:41
ace8430567dd8187387d38d4fd5e8c12a853500a...1e5b7437a5a47a24508e36659a346424d82a8d80,11,184,76,260,40,2014-12-11 03:03:05,2014-12-11 02:05:08
1e5b7437a5a47a24508e36659a346424d82a8d80...16af5c4756359049a1b7e625a13b6abb5121eb11,1,11,1,12,1,2014-12-11 20:40:03,2014-12-11 20:33:55
16af5c4756359049a1b7e625a13b6abb5121eb11...141acd42007bc9559058c5c2f09d5abfb1d198da,1,14,9,23,8,2014-12-11 20:41:25,2014-12-11 20:41:25
141acd42007bc9559058c5c2f09d5abfb1d198da...576ad32eb2e005229cf200c82586a6bb19dba88c,1,3,0,3,2,2014-12-11 20:48:57,2014-12-11 20:43:38
576ad32eb2e005229cf200c82586a6bb19dba88c...38c28c14bc55a6cb5fcc8f3c1e948c0e4ee4edba,2,5,7,12,4,2014-12-11 21:44:03,2014-12-11 21:36:11
38c28c14bc55a6cb5fcc8f3c1e948c0e4ee4edba...92dd5e1e719f5c021f8ca621722219fcd849be0e,1,7,0,7,1,2014-12-11 22:12:51,2014-12-11 22:12:51
92dd5e1e719f5c021f8ca621722219fcd849be0e...51b2c7b9971975cf3bfba3b036b28c12692dfac6,1,32,26,58,7,2014-12-11 22:20:13,2014-12-11 22:20:13
51b2c7b9971975cf3bfba3b036b28c12692dfac6...bc53d5f1e43238db9ced144493154a9225a5a33b,16,54,62,116,45,2014-12-11 22:40:16,2014-12-11 22:38:38
bc53d5f1e43238db9ced144493154a9225a5a33b...79527ccd9c7166d688a6f1e4cb0af8d79f87c08d,14,94,4,98,14,2014-12-12 05:31:41,2014-12-12 05:31:41
79527ccd9c7166d688a6f1e4cb0af8d79f87c08d...809b2b69f5121b2903ea9715ce301cc13c09bcd3,8,67,7,74,17,2014-12-12 06:26:29,2014-12-12 05:46:30
809b2b69f5121b2903ea9715ce301cc13c09bcd3...89a441eeded4c2246fa0c4e0ab8501d8e377d1b0,2,22,13,35,7,2014-12-12 06:36:45,2014-12-12 06:36:45
4d01b62dcce3ef4a93bf6e960b5ac98131deb2f1...794ad564df92033419dc8e6e8d87c660f5c2c146,1,2,1,3,1,2014-11-11 19:00:33,2014-11-11 19:00:33
794ad564df92033419dc8e6e8d87c660f5c2c146...c67527b4728b2744449e8c5b92d38f36a16c4eb9,4,7,19,26,5,2014-11-11 19:28:16,2014-11-11 19:28:16
c67527b4728b2744449e8c5b92d38f36a16c4eb9...d6aedb8e1db30fc14719b77cc26c9754f1a311fe,1,1,0,1,1,2014-11-11 21:59:23,2014-11-11 21:59:23
d6aedb8e1db30fc14719b77cc26c9754f1a311fe...340077dd36cacf00666abe8251be4fbfdeb8e921,4,256,6,262,7,2014-11-11 22:33:46,2014-11-11 22:33:46
340077dd36cacf00666abe8251be4fbfdeb8e921...b283ce1b398d14cc1344de18d245f13fbd9b7b3d,3,12,10,22,11,2014-11-11 23:34:13,2014-11-11 23:19:39
b283ce1b398d14cc1344de18d245f13fbd9b7b3d...e99a2ba0f46541657e575493d85ac8c9bd9547cc,1,1,1,2,1,2014-11-11 23:40:05,2014-11-11 23:40:05
e99a2ba0f46541657e575493d85ac8c9bd9547cc...e5deb811bb0b208e0e6e4047c7d7ec95123248fd,1,0,3,3,2,2014-11-12 03:10:29,2014-11-12 03:10:29
e5deb811bb0b208e0e6e4047c7d7ec95123248fd...13964699b2d3071088d3d3fa7597fd167d2a4f11,2,5,2,7,2,2014-11-12 03:36:03,2014-11-12 03:36:03
f3cc623615269f84a75f087534986e45b4b1df3a...25951b3fb8faa3b5287eb686c2e2ed262c019ec2,2,31,2,33,7,2014-10-30 19:08:15,2014-10-30 05:19:31
f3cc623615269f84a75f087534986e45b4b1df3a...175b0ebe4a0c564aa1c2c24d51562b659410e3c5,7,10,8,18,7,2014-10-30 18:32:22,2014-10-30 18:32:11
175b0ebe4a0c564aa1c2c24d51562b659410e3c5...7622d549f3d781f56591684674ed46b31b0df795,1,7,0,7,1,2014-10-30 18:41:46,2014-10-30 18:41:46
7622d549f3d781f56591684674ed46b31b0df795...912f08ec029b161b3aeee16eedd0497645345c62,1,3,0,3,1,2014-10-30 18:45:22,2014-10-30 18:45:22
912f08ec029b161b3aeee16eedd0497645345c62...9aaf31efd40618517a7b96263c4e1e5a810df998,2,2,1,3,2,2014-10-30 18:57:47,2014-10-30 18:57:47
9aaf31efd40618517a7b96263c4e1e5a810df998...d2d4fb2a309b645fd61365788316e5f7bb5f5cb2,3,3,3,6,3,2014-10-30 19:02:05,2014-10-30 19:01:10
d2d4fb2a309b645fd61365788316e5f7bb5f5cb2...ad43759269abb0cfa53ff29f31d17e150120b37d,4,5,4,9,4,2014-10-30 19:05:31,2014-10-30 19:05:31
ad43759269abb0cfa53ff29f31d17e150120b37d...b537c0c54b8dc3582a3778cb902782f35dc3e99f,2,3,2,5,2,2014-10-30 19:08:51,2014-10-30 19:08:51
b537c0c54b8dc3582a3778cb902782f35dc3e99f...f06838d8a6a0d6ab87052f1cf775482355c381e1,2,2,1,3,2,2014-10-30 19:13:46,2014-10-30 19:12:41
f06838d8a6a0d6ab87052f1cf775482355c381e1...2f371add25a63180ee723006786525f5701debf2,2,2,1,3,2,2014-10-30 19:20:55,2014-10-30 19:20:55
2f371add25a63180ee723006786525f5701debf2...badd3a0e10e63258bb535289062bad5a1fa27aae,2,2,1,3,2,2014-10-30 19:26:08,2014-10-30 19:26:08
badd3a0e10e63258bb535289062bad5a1fa27aae...ca7567babe53bb8a6fa298ce366892efadb9feb9,2,2,2,4,2,2014-10-30 19:28:56,2014-10-30 19:28:46
ca7567babe53bb8a6fa298ce366892efadb9feb9...d5f9941bdf182ad2fd9ebc848ee017db14df0d26,2,3,2,5,2,2014-10-30 19:30:24,2014-10-30 19:30:24
d5f9941bdf182ad2fd9ebc848ee017db14df0d26...6816ad3f331bfbaac62fcf87e37e8907e8220313,2,3,2,5,2,2014-10-30 19:31:40,2014-10-30 19:31:40
6816ad3f331bfbaac62fcf87e37e8907e8220313...b291326d55cd2365e9fcf0958ce4a52396bf503f,2,4,4,8,2,2014-10-30 19:35:14,2014-10-30 19:35:14
b291326d55cd2365e9fcf0958ce4a52396bf503f...a9e0efcb90a7e4c6d9f8a6cc31e6a3c9ffd9678b,2,61,30,91,11,2014-10-30 21:38:12,2014-10-30 21:38:12
a9e0efcb90a7e4c6d9f8a6cc31e6a3c9ffd9678b...1241b5295f0031de1f688ae9c4d01083202f2c26,4,46,46,92,34,2014-10-30 22:11:42,2014-10-30 22:11:42
998ca6debfccd7e10e8508b00c84cf2b8868b932...b1ee71579430473d8f2902f2dc9b8ead8d70ebd4,1,27,23,50,7,2014-10-15 21:12:42,2014-10-15 21:12:42
c44ab4bac618aa5587f2965f11ee3b947adce5fc...0edd309a19567fd8f5b4b5052bd08b6ebccffb73,3,4,1,5,4,2014-10-16 05:18:21,2014-10-16 05:18:21
c44ab4bac618aa5587f2965f11ee3b947adce5fc...9c3e29c663f8648a1d3e8c34123569132a47c42f,2,32,4,36,7,2014-10-15 21:22:44,2014-10-15 16:26:54
9c3e29c663f8648a1d3e8c34123569132a47c42f...864af5061b3076e93af3a0bc53a42ab62a9313b8,2,10,12,22,4,2014-10-15 21:22:44,2014-10-15 21:22:01
3f2ee65a3b8473c16188862c68994b4821392487...e0c35cc28e3a4acdd89c36017d62d243eea10ec2,1,1,1,2,1,2014-10-04 01:05:59,2014-10-04 01:05:59
e0c35cc28e3a4acdd89c36017d62d243eea10ec2...0ee76cf5f7f38b8fbcaf282673704767c6af047f,1,1,0,1,1,2014-10-04 01:27:14,2014-10-04 01:27:14
0ee76cf5f7f38b8fbcaf282673704767c6af047f...246a3026a3c3143297e2b14faaa078bb8f25538f,1,1,1,2,1,2014-10-04 01:45:15,2014-10-04 01:45:15
246a3026a3c3143297e2b14faaa078bb8f25538f...0c7a12d482bb5d394564fd40defba6d60298119d,1,1,1,2,1,2014-10-04 02:40:40,2014-10-04 02:21:50
0c7a12d482bb5d394564fd40defba6d60298119d...94074d597260ef18b2b0b8a1657ad18d2ad03cdc,3,64,16,80,12,2014-10-04 04:06:22,2014-10-04 04:06:22
71c8fc6ab9e9b62fc3430f121f4b7dfa0e7bf5e0...2dad47677df66f090b7a77b233f8b06cc07da85c,1,1,1,2,1,2014-09-30 07:30:42,2014-09-30 07:30:42
71c8fc6ab9e9b62fc3430f121f4b7dfa0e7bf5e0...c72dd30b1dc6674adc526cc36acc72e61a74b6e2,1,1,1,2,1,2014-09-30 07:07:34,2014-09-30 07:05:49
4bf58c16a0aebd828b0dc3bfc3e90ba1aab9b52f...16ff10c96bdd7a370985bf48f672ba8e394437b0,4,30,2,32,9,2014-09-06 20:05:19,2014-09-06 20:01:02
16ff10c96bdd7a370985bf48f672ba8e394437b0...6d883482cd16fa9a5abae5b8821e1744d0a1b233,2,10,1,11,2,2014-09-06 20:50:18,2014-09-06 20:50:18
6d883482cd16fa9a5abae5b8821e1744d0a1b233...0fba72f9db7d210bf1b816dff031f5f305627c75,1,2,1,3,1,2014-09-06 21:23:27,2014-09-06 21:23:27
0fba72f9db7d210bf1b816dff031f5f305627c75...3351183d8a3e59688cdc4ae2b60865ef26a8d717,6,6,6,12,6,2014-09-06 21:27:26,2014-09-06 21:27:26
625a87fe19a3eac7adb095fadb67b96dcc621ca0...e859266aaf8bfd357bd709e927496c9e2c527859,7,37,37,74,28,2014-08-21 20:41:29,2014-08-21 20:13:39
e859266aaf8bfd357bd709e927496c9e2c527859...c89ff1fa25c62ffd09db756e2c37504b405b4e05,1,3,1,4,1,2014-08-21 20:49:36,2014-08-21 20:49:36
c89ff1fa25c62ffd09db756e2c37504b405b4e05...d81bbefa224c660e75bdb0757a5e03d837e83527,1,2,1,3,1,2014-08-21 22:00:12,2014-08-21 22:00:12
d81bbefa224c660e75bdb0757a5e03d837e83527...7f0e7eee67981aeea054ffdd78c2589175355a7a,1,1,1,2,1,2014-08-21 22:00:48,2014-08-21 22:00:48
7f0e7eee67981aeea054ffdd78c2589175355a7a...2f73eebf0a622e55d41fb3787bf84c60a92b754a,1,1,1,2,1,2014-08-21 22:01:58,2014-08-21 22:01:58
2f73eebf0a622e55d41fb3787bf84c60a92b754a...c68e1489bd68482db363e5662e8a701fe1296f3d,1,13,8,21,5,2014-08-21 22:06:46,2014-08-21 22:06:46
c68e1489bd68482db363e5662e8a701fe1296f3d...5bc415c51ab388bbf4a022bb5661c6b1774942cd,7,150,43,193,14,2014-08-21 23:21:12,2014-08-21 23:21:12
5bc415c51ab388bbf4a022bb5661c6b1774942cd...24538205976100abeeb48786f82453085a8946fa,1,1,1,2,1,2014-08-21 23:42:46,2014-08-21 23:42:46
24538205976100abeeb48786f82453085a8946fa...d6855456a26a42dc90b0225f6bd0355009b2e536,3,51,20,71,12,2014-08-21 23:48:13,2014-08-21 23:48:13
d6855456a26a42dc90b0225f6bd0355009b2e536...a9c740165c842f966e50110a4af8a2dddfdcec7d,1,12,0,12,1,2014-08-21 23:52:02,2014-08-21 23:52:02
a9c740165c842f966e50110a4af8a2dddfdcec7d...5d5d1876da8aa414f14e364a7984e59cd1575b2e,3,131,174,305,6,2014-08-22 00:00:21,2014-08-22 00:00:21
5d5d1876da8aa414f14e364a7984e59cd1575b2e...628be93f612aa6da3dd964c81953b48ad0b341c7,1,3,3,6,3,2014-08-22 00:09:23,2014-08-22 00:09:23
628be93f612aa6da3dd964c81953b48ad0b341c7...bc1520cbdd44273da00f99a1c21858b57a0c8980,1,10,11,21,7,2014-08-22 00:09:36,2014-08-22 00:09:36
bc1520cbdd44273da00f99a1c21858b57a0c8980...e36c4184abda86f5190963aae24323ed9b532d2c,1,3,1,4,2,2014-08-22 00:46:51,2014-08-22 00:43:31
e36c4184abda86f5190963aae24323ed9b532d2c...5295907f994539589b41ce0863267e0095c55c53,1,3,7,10,4,2014-08-22 00:47:00,2014-08-22 00:27:06
5295907f994539589b41ce0863267e0095c55c53...ceb8be57761677e85485a928839115a130ff0c33,3,25,11,36,12,2014-08-22 00:53:37,2014-08-22 00:53:37
9318b4c250e8523801578c85afbf51852ea1fdd4...21cd9172fe12fe8b1c92009a1beedf1f1e6ccbf9,1,0,2,2,1,2014-02-04 03:06:26,2014-02-04 03:06:26
9318b4c250e8523801578c85afbf51852ea1fdd4...b32e1d3c78456062ae3d83c32e7735ef211e2051,2,4,1,5,2,2014-02-04 01:41:02,2014-02-04 01:41:02
3347604325f785526259c55eba572f72971c85ce...52affebcb87d3fe5612661be773e0a91b6fc0ab9,1,8,7,15,2,2015-01-24 01:07:16,2015-01-24 01:06:44
52affebcb87d3fe5612661be773e0a91b6fc0ab9...f2f0482c690b5819767423af0b47ea3e7c5a8a61,1,1,12,13,5,2015-02-24 20:18:10,2015-02-24 20:18:10
995a57d0c28eae9037f2b1f56e85b8b563e5bf0b...6cac0513d508809b0abda3e0f40d5c412ab0cb47,1,13,1,14,3,2014-12-27 00:22:19,2014-12-27 00:22:19
6cac0513d508809b0abda3e0f40d5c412ab0cb47...904325f129ea2268d63a1cc6feba44d059aa7cf5,1,10,4,14,2,2014-12-27 00:30:14,2014-12-27 00:30:14
904325f129ea2268d63a1cc6feba44d059aa7cf5...d0311c6f8629fbf7ef82d196e1bd24f4f04ebf8a,2,36,10,46,4,2014-12-27 00:49:25,2014-12-27 00:49:25
d0311c6f8629fbf7ef82d196e1bd24f4f04ebf8a...059fc88ff938e4109f55d0927dc71e257790ce6c,2,26,18,44,2,2014-12-29 06:19:37,2014-12-21 18:33:09
059fc88ff938e4109f55d0927dc71e257790ce6c...bab6ac5ef79ceb6b125c10610a0287c04660b58e,1,2,2,4,2,2014-12-29 21:47:24,2014-12-28 19:03:05
bab6ac5ef79ceb6b125c10610a0287c04660b58e...c004cb9356edc533b0c42fc9991943b9ee4633bd,1,4,2,6,1,2014-12-30 01:27:13,2014-12-30 01:27:13
c004cb9356edc533b0c42fc9991943b9ee4633bd...da4ae8b3a88c2405a8a9b5862d42698a27049997,2,4,3,7,4,2014-12-30 01:32:35,2014-12-30 01:32:35
da4ae8b3a88c2405a8a9b5862d42698a27049997...c16a8e86f63dcd02307c3557bf6c99697c73f7b6,1,1,1,2,1,2014-12-30 01:41:57,2014-12-30 01:00:50
c16a8e86f63dcd02307c3557bf6c99697c73f7b6...e93f8bbc2a77c7155166e0484a38491496e52c8f,2,3,3,6,2,2014-12-30 01:41:57,2014-12-30 01:25:02
e93f8bbc2a77c7155166e0484a38491496e52c8f...e6499b2304dda9f91492d9bc2ee1c36f0157bda6,2,1,2,3,2,2014-12-30 01:41:57,2014-12-30 01:39:59
e6499b2304dda9f91492d9bc2ee1c36f0157bda6...0514be4689c3b022a9c9881204169b2e6825e00a,2,3,3,6,2,2015-01-02 05:21:37,2015-01-02 05:21:37
0514be4689c3b022a9c9881204169b2e6825e00a...315fa640eafbf651168492f22adbb9736659816a,1,68,68,136,68,2015-01-02 22:39:32,2015-01-02 22:39:32
315fa640eafbf651168492f22adbb9736659816a...a6dc912afb6dfb9586447f0a22211fe2881e3f0a,1,4,5,9,4,2015-01-03 04:54:54,2015-01-03 04:54:54
f5f136adc98a61c201c9d53288acb104f8e3ac50...d155e46627b4807ed28e6f6df47644becd48bd8b,1,1,7,8,1,2014-12-22 21:42:39,2014-12-22 20:12:17
d155e46627b4807ed28e6f6df47644becd48bd8b...5baf7fb850bef6a908ec4ae9003b3bfdfcc3ff6d,1,1,1,2,1,2014-12-22 21:43:33,2014-12-22 20:17:45
5baf7fb850bef6a908ec4ae9003b3bfdfcc3ff6d...2b72e1226679d36c6120aa20f1f2060ea2d5afde,1,1,1,2,1,2014-12-22 21:43:33,2014-12-22 20:37:47
2b72e1226679d36c6120aa20f1f2060ea2d5afde...f729b2612416f00059c11cc0be83f1556acd2023,1,1,1,2,1,2014-12-22 21:43:45,2014-12-22 21:43:45
f729b2612416f00059c11cc0be83f1556acd2023...ed7822bcdc6549007bf03a7ee7124154a147de8e,1,2,2,4,2,2014-12-22 21:55:50,2014-12-22 21:55:50
ed7822bcdc6549007bf03a7ee7124154a147de8e...2eff7cce5214482eaccfcaf809279f6ad43121c9,3,3,3,6,3,2014-12-22 21:59:59,2014-12-22 21:59:59
2eff7cce5214482eaccfcaf809279f6ad43121c9...f193f211d3b7f655ffd5d003243841b13c180434,1,1,1,2,1,2014-12-22 22:15:43,2014-12-22 22:15:43
f193f211d3b7f655ffd5d003243841b13c180434...d6854bfe6548405b205923d03750821124edf255,1,1,1,2,1,2014-12-22 22:17:47,2014-12-22 22:17:37
d6854bfe6548405b205923d03750821124edf255...bc5a323141b795f49abf88090c2de0af450c4160,2,4,2,6,2,2014-12-22 22:55:31,2014-12-22 22:55:31
bc5a323141b795f49abf88090c2de0af450c4160...9954b73cfb524310c2403e437b41989c3966968e,1,1,1,2,1,2014-12-23 00:15:40,2014-12-23 00:15:40
9954b73cfb524310c2403e437b41989c3966968e...276658e899d7dab11cb5c4285742a97ba1aa229c,5,6,6,12,5,2014-12-25 10:49:18,2014-12-25 10:49:18
276658e899d7dab11cb5c4285742a97ba1aa229c...a09d6c833bd7eecf929eb2c6ded1fe51c251a1e4,1,43,2,45,3,2014-12-26 18:17:31,2014-12-26 18:17:31
a09d6c833bd7eecf929eb2c6ded1fe51c251a1e4...fb21c645d2322ce20fe3ff67aa38de623dc5489d,1,15,4,19,4,2014-12-27 06:37:56,2014-12-27 06:37:56
fb21c645d2322ce20fe3ff67aa38de623dc5489d...016a88c002ebf30b8b9fb8daed17749a142ac5e4,1,50,26,76,10,2015-01-23 23:28:58,2015-01-23 23:28:58
016a88c002ebf30b8b9fb8daed17749a142ac5e4...4ff0a5711ea9a641cf4d5c02c9d25a901b6e48c2,1,3,0,3,1,2015-01-23 23:30:16,2015-01-23 23:30:16
4ff0a5711ea9a641cf4d5c02c9d25a901b6e48c2...47150e02a3d0d4e462c3302f4a025b23f19c97af,5,13,6,19,8,2015-01-24 00:03:08,2015-01-24 00:03:08
47150e02a3d0d4e462c3302f4a025b23f19c97af...eed629b503d6cbf5df0eedf6f9b406b95c55b820,1,1,1,2,1,2015-02-11 20:24:17,2015-02-11 20:24:17
eed629b503d6cbf5df0eedf6f9b406b95c55b820...2966337ea70d26e20b44eb46c5c636f723555dc8,2,7,4,11,2,2015-02-11 20:31:38,2015-02-11 20:31:38
2966337ea70d26e20b44eb46c5c636f723555dc8...e14be5f80bd96728782555a7d3919bd89583e3af,1,1,1,2,1,2015-02-11 23:40:02,2015-02-11 23:40:02
e14be5f80bd96728782555a7d3919bd89583e3af...c3615d68988017ad12ef5b77ced36c698a40e032,1,1,0,1,1,2015-02-11 23:56:34,2015-02-11 23:56:34
c3615d68988017ad12ef5b77ced36c698a40e032...6c57bc2cfc1eb8cb081e48caf67a5fc54fc936a7,1,1,1,2,1,2015-02-14 20:44:05,2015-02-14 20:44:05
6c57bc2cfc1eb8cb081e48caf67a5fc54fc936a7...772e87a3555fb08c3d288b4792174e5fe12d09e5,1,2,1,3,2,2015-02-16 19:58:38,2015-02-16 19:58:38
772e87a3555fb08c3d288b4792174e5fe12d09e5...3ea31603656b25b7d8a6903f432a4d321067cc8a,1,1,1,2,1,2015-02-16 19:59:26,2015-02-16 19:59:26
3ea31603656b25b7d8a6903f432a4d321067cc8a...fc07a67704d2bad7c330bd20cc91cf1b6b449875,1,1,1,2,1,2015-02-16 20:04:37,2015-02-16 20:04:37
fc07a67704d2bad7c330bd20cc91cf1b6b449875...51a0263d4b247dadf3716b362d5cc52a9d171ab1,1,1,1,2,1,2015-02-16 20:05:43,2015-02-16 20:05:43
51a0263d4b247dadf3716b362d5cc52a9d171ab1...f8b07186d0fd33a5cb74bbc0b90d83dbb8f1feeb,1,1,1,2,1,2015-02-16 20:07:45,2015-02-16 20:07:45
f8b07186d0fd33a5cb74bbc0b90d83dbb8f1feeb...d4f3c211e60405ca1e27c38acd3ff14fcbd4a862,1,1,1,2,1,2015-02-16 20:08:46,2015-02-16 20:08:46
d4f3c211e60405ca1e27c38acd3ff14fcbd4a862...b7c86152d478e5ea98f1157118287bba07206e33,1,26,0,26,1,2015-02-16 22:03:25,2015-02-16 21:54:56
92a6adf5aff5da92ebbdf78281febccfd40e83ad...a5bdf481dfece9ebc57107d71be478f9b48cbd1e,1,33,26,59,3,2015-01-21 01:37:41,2015-01-17 12:26:11
a5bdf481dfece9ebc57107d71be478f9b48cbd1e...68608e6aecf47a2f9a3579b0b7c442880e1dc193,1,10,8,18,3,2015-01-21 01:37:41,2015-01-21 01:35:44
89a441eeded4c2246fa0c4e0ab8501d8e377d1b0...43037f7c3735009f8dfb36f5340159a762b63e24,2,2,2,4,2,2014-12-12 22:40:11,2014-12-12 22:39:55
89a441eeded4c2246fa0c4e0ab8501d8e377d1b0...a46737b375d85d7e6f4749e8ee7c9bdc267c8b53,1,3,3,6,3,2014-12-12 14:03:10,2014-12-12 14:03:10
89a441eeded4c2246fa0c4e0ab8501d8e377d1b0...73b809c122b2ae92a9403d30183056104f709e3e,123,123,123,246,123,2014-12-12 06:44:41,2014-12-12 06:44:41
73b809c122b2ae92a9403d30183056104f709e3e...fd79f43f4b518c0f6ab790ed578b099593179bce,1,7,2,9,3,2014-12-12 15:37:57,2014-12-12 15:37:57
fd79f43f4b518c0f6ab790ed578b099593179bce...e4b32c9dc53b683748dd85e929cb0b90a8f3cded,2,2,2,4,2,2014-12-12 15:53:45,2014-12-12 15:53:45
e4b32c9dc53b683748dd85e929cb0b90a8f3cded...f1c0654e33e7f0b0101cdb770908bf426fe1c80f,1,8,1,9,1,2014-12-13 01:36:29,2014-12-13 01:36:29
f1c0654e33e7f0b0101cdb770908bf426fe1c80f...c120069ff64f5032285b1c881a300066d52c03f0,2,2,2,4,2,2014-12-13 01:38:27,2014-12-13 01:38:27
c120069ff64f5032285b1c881a300066d52c03f0...56ceae09aadc3968ca86d3053c81bf664b911fda,1,44,2,46,5,2014-12-13 02:19:53,2014-12-13 02:19:53
56ceae09aadc3968ca86d3053c81bf664b911fda...0f00c9e482b24a26c04c10725819633362e7a637,3,140,5,145,6,2014-12-15 21:13:15,2014-12-12 22:34:49
0f00c9e482b24a26c04c10725819633362e7a637...651348f6f50fa9d14e265d8b8ac8aafd1a392181,1,8,5,13,4,2014-12-15 21:13:16,2014-12-15 16:54:59
651348f6f50fa9d14e265d8b8ac8aafd1a392181...e8bef27a5e4f643db7c6047a7a37bd1f71c28a84,1,5,2,7,1,2014-12-16 02:12:53,2014-12-16 02:12:53
e8bef27a5e4f643db7c6047a7a37bd1f71c28a84...f5dc40765c3aa876f8fbe42c7835643359918ecc,5,5,5,10,5,2014-12-16 02:51:25,2014-12-15 22:42:52
f5dc40765c3aa876f8fbe42c7835643359918ecc...bd3e276f3315766d3955f5db04fc40f049602ecf,1,1,1,2,1,2014-12-16 06:51:30,2014-12-16 06:51:30
bd3e276f3315766d3955f5db04fc40f049602ecf...fe8297697be446e6df39df2d8301f943cdf58c74,1,16,1,17,2,2014-12-17 01:07:03,2014-12-16 07:07:40
fe8297697be446e6df39df2d8301f943cdf58c74...1307132c25d87472c9fd898303b915a2eb13b791,2,3,3,6,3,2014-12-17 01:09:59,2014-12-16 23:26:18
1307132c25d87472c9fd898303b915a2eb13b791...07f6cf41fbe81c619105f855d5a13e4114b3b6c0,1,16,4,20,5,2014-12-17 01:10:50,2014-12-17 00:23:12
07f6cf41fbe81c619105f855d5a13e4114b3b6c0...5924a6a1406ad9e6893433979923652eb0515a23,1,11,8,19,3,2014-12-17 01:11:09,2014-12-17 01:04:53
5924a6a1406ad9e6893433979923652eb0515a23...747dd88bbf2cf7d44bb6fe5bcc63a65ba5ef390b,3,29,1,30,5,2014-12-17 01:16:02,2014-12-16 21:53:20
747dd88bbf2cf7d44bb6fe5bcc63a65ba5ef390b...d9feb32148d828871abded4703fe46a0522d9d85,2,16,1,17,4,2014-12-17 01:16:13,2014-12-16 21:16:34
d9feb32148d828871abded4703fe46a0522d9d85...d7006103975e05cd46f6ff627bb54dca40d507af,2,15,5,20,2,2014-12-17 01:16:26,2014-12-16 21:24:39
d7006103975e05cd46f6ff627bb54dca40d507af...6c43678bc059520279de876330eb7084bca53656,3,20,3,23,6,2014-12-17 01:46:26,2014-12-17 01:45:51
6c43678bc059520279de876330eb7084bca53656...b492b71b605607e2e67dc95457be5b616a2a8940,3,11,21,32,4,2014-12-17 05:08:26,2014-12-17 05:08:26
b492b71b605607e2e67dc95457be5b616a2a8940...8f9bb8da176d77199da7056fa8f6f87cdc205636,1,0,13,13,2,2014-12-17 07:36:38,2014-12-17 07:36:38
8f9bb8da176d77199da7056fa8f6f87cdc205636...31bd507b11e164e409e06cc147b3bba878c44591,5,32,47,79,22,2014-12-17 07:46:26,2014-12-17 07:44:12
31bd507b11e164e409e06cc147b3bba878c44591...dc24e7b7d735df4d439761011e45ab5c4daa4945,3,77,41,118,12,2014-12-17 07:59:59,2014-12-17 07:59:59
dc24e7b7d735df4d439761011e45ab5c4daa4945...d090f55b4bf0f3d9e657ec6b28dbe3afa0e82c5f,1,16,11,27,3,2014-12-17 08:05:50,2014-12-17 08:05:50
d090f55b4bf0f3d9e657ec6b28dbe3afa0e82c5f...7239b4051ce214879632d55a7fe42ab868309727,7,7,7,14,7,2014-12-17 08:22:47,2014-12-17 08:19:58
7239b4051ce214879632d55a7fe42ab868309727...cb33da85364a1f9b7de6ea2f2c178e0ba0e223f9,1,3,3,6,1,2014-12-17 08:36:22,2014-12-17 08:36:22
cb33da85364a1f9b7de6ea2f2c178e0ba0e223f9...0c8edc1511803ddc6570948fdfef8aa9ae0f8323,1,42,132,174,12,2014-12-17 19:16:41,2014-12-17 19:16:41
0c8edc1511803ddc6570948fdfef8aa9ae0f8323...3ace90ccc7c57608bea4a96ace6dc2debd92d57b,1,0,4,4,1,2014-12-17 20:03:00,2014-12-17 20:03:00
3ace90ccc7c57608bea4a96ace6dc2debd92d57b...becfb57a15c906f24e9aa6b00c2ad9bd7c40157b,1,11,20,31,5,2014-12-17 21:00:01,2014-12-17 21:00:01
becfb57a15c906f24e9aa6b00c2ad9bd7c40157b...e4fd1134a1ea97d7d5b4ee1c5bdc959338e0f9dc,1,34,20,54,8,2014-12-17 21:46:11,2014-12-17 21:46:11
e4fd1134a1ea97d7d5b4ee1c5bdc959338e0f9dc...356d6b91ff9ea7ee18cb837886862e92480daf2c,1,1,4,5,1,2014-12-17 21:55:41,2014-12-17 21:55:41
356d6b91ff9ea7ee18cb837886862e92480daf2c...4723a310ab593bc0bad1d4d17a97353d7bf89571,2,2,2,4,2,2014-12-17 22:41:12,2014-12-17 22:37:38
4723a310ab593bc0bad1d4d17a97353d7bf89571...934bfca426e3673a1a97aca742011e0b9a89b7c3,1,23,19,42,2,2014-12-18 02:17:58,2014-12-18 02:17:58
934bfca426e3673a1a97aca742011e0b9a89b7c3...6527e669ab8339d4fbb9333d54ec3f71a9472238,1,28,17,45,8,2014-12-18 02:21:45,2014-12-18 02:21:45
6527e669ab8339d4fbb9333d54ec3f71a9472238...2dc8464cf7f8bae7f3bcbbc3e71925343aa702cc,1,2,2,4,1,2014-12-18 04:31:55,2014-12-18 04:30:53
2dc8464cf7f8bae7f3bcbbc3e71925343aa702cc...37781be2e0e4e1b1409fba5d1c89b5cae8c0ea3c,1,20,14,34,11,2014-12-18 09:34:47,2014-12-18 09:34:47
37781be2e0e4e1b1409fba5d1c89b5cae8c0ea3c...cfe07d898c17208b5fcf52510612f0c799c80666,1,9,1,10,1,2014-12-18 15:56:06,2014-12-18 15:55:43
13964699b2d3071088d3d3fa7597fd167d2a4f11...d0d0427212bd14dc53d6dd32d461e3265938bb04,1,1,3,4,2,2014-11-12 03:55:28,2014-11-12 03:55:28
d0d0427212bd14dc53d6dd32d461e3265938bb04...c7b8439eff0e3140185a2365640085687fceec31,1,4,4,8,3,2014-11-12 03:56:00,2014-11-12 03:56:00
13964699b2d3071088d3d3fa7597fd167d2a4f11...4c26f3fab472999588816e82e2c81f4de668a304,1,8,0,8,1,2014-11-12 03:45:44,2014-11-12 03:39:35
4c26f3fab472999588816e82e2c81f4de668a304...d95bec120e82f7088a8d088edca2fd2d0dfd70e1,1,0,0,0,2,2014-11-12 03:45:44,2014-11-12 03:45:05
25951b3fb8faa3b5287eb686c2e2ed262c019ec2...56d53e6a6ee520b8251faa8a242d4bcc93fcd79a,2,24,2,26,4,2014-10-31 04:49:20,2014-10-31 04:49:20
56d53e6a6ee520b8251faa8a242d4bcc93fcd79a...6600c1dfe0c78a048fcf50f4de7c6aaa33a9a4e1,1,18,0,18,1,2014-11-01 02:36:47,2014-11-01 02:36:47
6600c1dfe0c78a048fcf50f4de7c6aaa33a9a4e1...322e5843d270471db9f0b9c486bd6cf008658301,1,1,1,2,1,2014-11-01 04:21:27,2014-11-01 04:21:27
322e5843d270471db9f0b9c486bd6cf008658301...47f265f3688124a6add3037adb5596eec92c37ec,1,19,2,21,2,2014-11-01 04:29:03,2014-11-01 04:29:03
47f265f3688124a6add3037adb5596eec92c37ec...67bf49d5ddd7ef3f3f796e7d8683e344b5bc5539,1,14,4,18,9,2014-11-01 04:29:34,2014-11-01 04:29:34
67bf49d5ddd7ef3f3f796e7d8683e344b5bc5539...ae9dfbc822f8305d74a79752deebd2a42df92950,1,12,0,12,2,2014-11-01 04:30:34,2014-11-01 04:30:34
25951b3fb8faa3b5287eb686c2e2ed262c019ec2...c2a4134d975f6ffaccb3d7615204faef8e265de5,7,10,8,18,7,2014-10-30 22:12:28,2014-10-30 18:32:11
c2a4134d975f6ffaccb3d7615204faef8e265de5...a6cce36f8d17cc08858d9d8d7ca67ae1e3d93b85,1,7,0,7,1,2014-10-30 22:12:28,2014-10-30 18:41:46
a6cce36f8d17cc08858d9d8d7ca67ae1e3d93b85...4d2499ed7db89690d35fd937730790139710b206,1,3,0,3,1,2014-10-30 22:12:28,2014-10-30 18:45:22
4d2499ed7db89690d35fd937730790139710b206...5db7b27153dbbec4cc1908838c8a3e69f1a3e4a5,2,2,1,3,2,2014-10-30 22:12:28,2014-10-30 18:57:47
5db7b27153dbbec4cc1908838c8a3e69f1a3e4a5...d4feca7703fae1fbad5a456364b9708ec206c84e,3,3,3,6,3,2014-10-30 22:12:28,2014-10-30 19:01:10
d4feca7703fae1fbad5a456364b9708ec206c84e...92b1bf1369e1487719ceea41d697e893bf16316a,4,5,4,9,4,2014-10-30 22:12:29,2014-10-30 19:05:31
92b1bf1369e1487719ceea41d697e893bf16316a...5d84fd2b7c84332f7ccb6e466aa0d472f34cca19,2,3,2,5,2,2014-10-30 22:12:29,2014-10-30 19:08:51
5d84fd2b7c84332f7ccb6e466aa0d472f34cca19...80f8eec669cce853a35d70338e6417c7a9eb7144,2,2,1,3,2,2014-10-30 22:12:29,2014-10-30 19:12:41
80f8eec669cce853a35d70338e6417c7a9eb7144...8b9771420b25b9391ac8de051f063583c6cd8942,2,2,1,3,2,2014-10-30 22:12:29,2014-10-30 19:20:55
8b9771420b25b9391ac8de051f063583c6cd8942...66bd8173822af7d4e3dd049fa4d8a3f943de4f54,2,2,1,3,2,2014-10-30 22:12:29,2014-10-30 19:26:08
66bd8173822af7d4e3dd049fa4d8a3f943de4f54...d91667a941f4bf2e40f81617cabccd98d24b380e,2,2,2,4,2,2014-10-30 22:12:29,2014-10-30 19:28:46
d91667a941f4bf2e40f81617cabccd98d24b380e...fc375be7c8a0b31ce117c61a28156f6138a62764,2,3,2,5,2,2014-10-30 22:12:29,2014-10-30 19:30:24
fc375be7c8a0b31ce117c61a28156f6138a62764...e79e04fd608b041bc0c975b9493624e6e3cf09b3,2,3,2,5,2,2014-10-30 22:12:29,2014-10-30 19:31:40
e79e04fd608b041bc0c975b9493624e6e3cf09b3...34aac459a0c9ecbc75e50cd22cf70a9f3d2981d5,2,4,4,8,2,2014-10-30 22:12:30,2014-10-30 19:35:14
34aac459a0c9ecbc75e50cd22cf70a9f3d2981d5...d5afd1b6a99958b7e2db74584384ada73e7ae4bb,2,61,30,91,11,2014-10-30 22:12:30,2014-10-30 21:38:12
d5afd1b6a99958b7e2db74584384ada73e7ae4bb...f64e36988852ed3810b3f7a7e4477b9af08d0c43,4,46,46,92,34,2014-10-30 22:12:30,2014-10-30 22:11:42
8950baaf4bfd89856be762cd7d5203f3c50c0606...5c570d16ab965599a20d2dec60c76767a40dfea4,8,196,0,196,8,2014-10-16 06:07:24,2014-10-16 06:07:24
5c570d16ab965599a20d2dec60c76767a40dfea4...f72561b8c60b57c90695e3622d137d8caf686d35,2,15,27,42,11,2014-10-16 06:08:10,2014-10-16 06:08:10
f72561b8c60b57c90695e3622d137d8caf686d35...abb14d7e0a97c9bac42990fad5c08f665467c74a,1,0,1,1,1,2014-10-16 06:08:35,2014-10-16 06:08:35
abb14d7e0a97c9bac42990fad5c08f665467c74a...4efaf9fb85da085fd5a58eced3309ad0fa3a24d5,2,0,7,7,2,2014-10-16 06:08:56,2014-10-16 06:08:56
4efaf9fb85da085fd5a58eced3309ad0fa3a24d5...a6dccf74e9a14680c908489f264424996a5d9153,26,3746,3672,7418,26,2014-10-16 07:34:11,2014-10-16 07:34:11
a6dccf74e9a14680c908489f264424996a5d9153...759979fd4fcad19a24d0882764d2c1ca3f9f53f7,10,2,200,202,13,2014-10-16 07:38:45,2014-10-16 07:38:45
759979fd4fcad19a24d0882764d2c1ca3f9f53f7...7963a84807664bb146f2f8aff36fbaf21efa2906,1,2,2,4,1,2014-10-16 17:20:48,2014-10-16 17:20:48
864af5061b3076e93af3a0bc53a42ab62a9313b8...e781bf77a0f1b0c2619aa788d9103972712badb2,7,172,49,221,55,2014-10-16 18:00:28,2014-10-16 18:00:28
e781bf77a0f1b0c2619aa788d9103972712badb2...3c1a222b4ae76b9646cca537195e370b49d8206f,4,2,49,51,7,2014-10-16 18:17:15,2014-10-16 18:17:15
3c1a222b4ae76b9646cca537195e370b49d8206f...fb655a4b9373998f7c4aecd370b194391980e462,1,19,20,39,9,2014-10-16 18:58:00,2014-10-16 18:44:01
fb655a4b9373998f7c4aecd370b194391980e462...87bc3c093f7a96eb86634faaab4867f8a2df318e,1,13,11,24,10,2014-10-16 18:58:00,2014-10-16 18:47:39
87bc3c093f7a96eb86634faaab4867f8a2df318e...70412daf8741e8945b63fc942f68aca3249d2242,1,5,5,10,4,2014-10-16 18:58:00,2014-10-16 18:48:05
70412daf8741e8945b63fc942f68aca3249d2242...1cb81ce62747d048603310788e7204711a9f7b91,1,12,27,39,7,2014-10-16 18:58:00,2014-10-16 18:50:53
1cb81ce62747d048603310788e7204711a9f7b91...ee8a7675c1be9505618aa7d676c31124ee467b08,1,5,12,17,2,2014-10-16 18:58:00,2014-10-16 18:54:27
ee8a7675c1be9505618aa7d676c31124ee467b08...adc1fed1e663f74216f3e6f44f2b1c4e881280a6,2,36,8,44,6,2014-10-16 19:17:10,2014-10-16 18:58:52
adc1fed1e663f74216f3e6f44f2b1c4e881280a6...7e8f509426f6d44e86427138a24736542d4fe98f,3,16,14,30,3,2014-10-16 20:34:33,2014-10-16 20:34:33
7e8f509426f6d44e86427138a24736542d4fe98f...6fb37c11610c7339329e502d80701d8b7bb7927e,1,0,5,5,2,2014-10-16 21:05:54,2014-10-16 21:05:54
6fb37c11610c7339329e502d80701d8b7bb7927e...644dc224ae9c2bc20c5a871c75c6c28b3c57388f,1,2,3,5,2,2014-10-16 21:09:46,2014-10-16 21:09:46
644dc224ae9c2bc20c5a871c75c6c28b3c57388f...35509626bf6b201884527842ffbb6a1b2ce21d27,1,5,6,11,3,2014-10-16 21:11:11,2014-10-16 21:11:11
35509626bf6b201884527842ffbb6a1b2ce21d27...d7735e99a3092f81aed043026274fba701fbfe22,5,26,4,30,5,2014-10-16 21:17:12,2014-10-16 21:17:12
d7735e99a3092f81aed043026274fba701fbfe22...24264deba9113961c98ab7c12334812d1436f89b,2,12,32,44,8,2014-10-16 21:23:17,2014-10-16 21:23:17
24264deba9113961c98ab7c12334812d1436f89b...577c8c8d7fc9b0955d173b3ad3f59777aab8bac7,2,49,1,50,7,2014-10-16 21:36:26,2014-10-16 21:36:26
577c8c8d7fc9b0955d173b3ad3f59777aab8bac7...ff2628e69ec9f0ca145b5c626a1307c505b1e1b7,1,2,4,6,2,2014-10-16 21:37:01,2014-10-16 21:37:01
ff2628e69ec9f0ca145b5c626a1307c505b1e1b7...269f8c0be6fc957cf953affc6b36ac4a25c82ed7,1,1,1,2,1,2014-10-16 21:50:24,2014-10-16 21:50:24
269f8c0be6fc957cf953affc6b36ac4a25c82ed7...99cd053c728654dafae2de29031befe51614882e,6,26,8,34,12,2014-10-16 22:28:10,2014-10-16 22:28:10
864af5061b3076e93af3a0bc53a42ab62a9313b8...a3323287d64a8291edc72f4263002cb7e4128244,1,96,94,190,19,2014-10-15 21:39:31,2014-10-15 21:39:31
a3323287d64a8291edc72f4263002cb7e4128244...a957f173d55ec7e4d4d7d494c37aca0adeb52eb1,1,22,2,24,1,2014-10-15 22:19:09,2014-10-15 22:18:50
a957f173d55ec7e4d4d7d494c37aca0adeb52eb1...3c1c7862939965958ae02d44133cb264c4754390,1,5,0,5,1,2014-10-16 00:00:46,2014-10-16 00:00:46
3c1c7862939965958ae02d44133cb264c4754390...e01ca1b13a2543c2838de8af0506e8c1e7cc628f,1,5,0,5,2,2014-10-16 00:39:00,2014-10-16 00:39:00
e01ca1b13a2543c2838de8af0506e8c1e7cc628f...98429c23381d47cd08b295e4294b81c28c6a053a,1,1,1,2,1,2014-10-16 01:08:20,2014-10-16 01:08:20
98429c23381d47cd08b295e4294b81c28c6a053a...884eb80263c06fc0ab39967253af87305598a209,1,1,1,2,1,2014-10-16 01:42:27,2014-10-16 01:42:06
884eb80263c06fc0ab39967253af87305598a209...a8bcb24fcb6901740bf308fe9970c0d5c5338968,1,13,4,17,2,2014-10-16 01:54:56,2014-10-16 01:54:56
a8bcb24fcb6901740bf308fe9970c0d5c5338968...5eb6b2deecef97d5829502d0b4c67adeb876dec7,1,1,1,2,1,2014-10-16 01:55:17,2014-10-16 01:55:17
5eb6b2deecef97d5829502d0b4c67adeb876dec7...11abe0cfb783f73d6b5a281430ef1bb9c99460c6,1,4,3,7,2,2014-10-16 02:03:42,2014-10-16 02:03:42
11abe0cfb783f73d6b5a281430ef1bb9c99460c6...30a1ac4a89243e341ada27f42ce89a14069eaf0d,1,4,2,6,2,2014-10-16 03:59:48,2014-10-16 03:59:48
94074d597260ef18b2b0b8a1657ad18d2ad03cdc...858479af6bdd8d22c0f511fe81a98c0ae289beb2,1,5,2,7,2,2014-10-04 14:06:53,2014-10-04 14:06:53
858479af6bdd8d22c0f511fe81a98c0ae289beb2...abc12875b1c5fb54c67d5901aace3a08b406be48,1,22,5,27,5,2014-10-04 18:02:10,2014-10-04 18:02:10
abc12875b1c5fb54c67d5901aace3a08b406be48...5e2cb2bfc56ba366a53327d7bd1fc6ac669d36a8,1,5,24,29,20,2014-10-05 00:16:03,2014-10-05 00:16:03
5e2cb2bfc56ba366a53327d7bd1fc6ac669d36a8...b2a69271bd25c9e8b1a9dcfacb54033bd5c63d60,1,5,5,10,1,2014-10-06 18:09:05,2014-10-06 18:09:05
b2a69271bd25c9e8b1a9dcfacb54033bd5c63d60...5f0ffbfb10f0325c0ff9ef7ea9d44ab3aba42551,1,29,41,70,12,2014-10-06 18:09:26,2014-10-06 18:09:26
5f0ffbfb10f0325c0ff9ef7ea9d44ab3aba42551...9f04fa28a6dc91b7f4f1d853652433be107321d8,1,15,11,26,8,2014-10-06 18:30:23,2014-10-06 18:30:23
4c3cd91bced52be9653220f6007c6bdd9fa55342...d5b9b6d65d6edabd24a8241c42b88a429c01fd6f,5,5,5,10,5,2014-10-04 04:12:30,2014-10-04 04:12:30
d5b9b6d65d6edabd24a8241c42b88a429c01fd6f...67fbec2263ec20f8d089af4ffea781c82c226882,32,135,75,210,20,2014-10-04 04:25:24,2014-10-04 04:25:24
67fbec2263ec20f8d089af4ffea781c82c226882...76348d36ffbf38347f7087ee6a2496652456ae56,1,1,1,2,1,2014-10-04 04:25:35,2014-10-04 04:25:35
76348d36ffbf38347f7087ee6a2496652456ae56...8b0d3eceb4a62f7a4275a36b344fc7f94628422e,1,1,1,2,1,2014-10-04 04:28:08,2014-10-04 04:28:08
8b0d3eceb4a62f7a4275a36b344fc7f94628422e...37de748a093129e3c1befa05d57930cf7b3392ec,1,1,1,2,1,2014-10-04 04:30:15,2014-10-04 04:30:15
37de748a093129e3c1befa05d57930cf7b3392ec...943d8178ccdd03837000b71996b756e5be2f5899,1,6,1,7,1,2014-10-04 05:25:27,2014-10-04 05:25:16
943d8178ccdd03837000b71996b756e5be2f5899...3c02bd8b4c8b9ab0c18c4fa63eb10303959fc503,2,2,2,4,2,2014-10-04 05:26:30,2014-10-04 05:26:30
3c02bd8b4c8b9ab0c18c4fa63eb10303959fc503...d2b5b2e479e17efdc27fd7f302b8960cdd4e0195,1,1,1,2,1,2014-10-04 05:40:28,2014-10-04 05:40:28
b68b1b30d4f8685cb16ab9c32899f7cc5eab6807...ad2dbcfbe0ea199497cd5c8dba284a3d1eba7a3b,3,3,3,6,3,2014-09-30 08:42:17,2014-09-30 08:41:27
ad2dbcfbe0ea199497cd5c8dba284a3d1eba7a3b...1f3538e982af7347598bbd7acacceb726053a82a,1,1,1,2,1,2014-09-30 08:44:45,2014-09-30 08:44:45
1f3538e982af7347598bbd7acacceb726053a82a...44ae2cbea9341d5763adaefd0328f1ae9fd04eac,1,18,8,26,3,2014-09-30 16:33:13,2014-09-30 16:33:13
44ae2cbea9341d5763adaefd0328f1ae9fd04eac...7e6ea64e07ab4e995dd19934ec47730a8e9bcb9e,1,1,1,2,1,2014-09-30 18:51:05,2014-09-30 08:17:10
7e6ea64e07ab4e995dd19934ec47730a8e9bcb9e...d794aa6335f4603ad280a76839c39f11455be548,2,15,4,19,6,2014-09-30 18:51:05,2014-09-30 18:49:43
d794aa6335f4603ad280a76839c39f11455be548...274497d0839f098be4205abb78932883d72d9155,2,15,8,23,8,2014-09-30 19:24:11,2014-09-30 19:18:21
274497d0839f098be4205abb78932883d72d9155...b4a063c53ca03d63aa21ea53469127ac5c6ef8ab,1,6,0,6,2,2014-09-30 19:28:59,2014-09-30 04:43:40
b4a063c53ca03d63aa21ea53469127ac5c6ef8ab...264b9efb2def12bf974b4ca1263df15a7751b1a9,1,130,115,245,11,2014-09-30 19:28:59,2014-09-30 19:28:06
264b9efb2def12bf974b4ca1263df15a7751b1a9...1337b84466a9933c7e0f1cc6c9b34934ef2d20a6,1,1,1,2,1,2014-09-30 19:39:44,2014-09-30 19:39:25
1337b84466a9933c7e0f1cc6c9b34934ef2d20a6...a1ab53d2c16ecf59ddf84b1c249a7ca44f8a421a,1,54,65,119,12,2014-09-30 19:41:31,2014-09-30 19:39:38
3351183d8a3e59688cdc4ae2b60865ef26a8d717...3b1651b82bae53133ca1c882c3dfcbe4ef8192c2,1,9,2,11,1,2014-09-06 21:57:48,2014-09-06 21:57:48
3b1651b82bae53133ca1c882c3dfcbe4ef8192c2...9db3ec88d7b4117156b2447cedb2e4e4e9ac5f53,6,35,33,68,16,2014-09-07 00:14:07,2014-09-07 00:14:07
9db3ec88d7b4117156b2447cedb2e4e4e9ac5f53...6c4b344a07724fbeec2b0cc51788b2267409fe4a,4,284,0,284,4,2014-09-07 00:27:25,2014-09-07 00:22:27
6c4b344a07724fbeec2b0cc51788b2267409fe4a...e00b2ec43818687489674ff8b41dba1c0fcddb42,15,152,128,280,68,2014-09-07 01:09:13,2014-09-07 01:09:13
f986056d0c867358e496de1dc708f2a239111c3a...5853f2aefdec693a93a13baa96724c0369e7c088,2,53,8,61,11,2014-08-22 15:55:32,2014-08-14 14:32:08
5853f2aefdec693a93a13baa96724c0369e7c088...98ed3e5c1eccc2922f65c86a33f49058ccaf43a5,1,2,0,2,1,2014-08-22 15:56:46,2014-08-22 15:56:46
ceb8be57761677e85485a928839115a130ff0c33...0c2dd7aff4469cdb22e10d18e12c0b21abe845b0,1,1,1,2,1,2014-08-22 01:23:37,2014-08-21 17:03:42
0c2dd7aff4469cdb22e10d18e12c0b21abe845b0...81a0a0c7e2a433f930020992ba0942517de94e5d,6,45,31,76,15,2014-08-22 01:23:38,2014-08-21 22:15:59
81a0a0c7e2a433f930020992ba0942517de94e5d...1852e7b2c05cbc18ee83af1eb5f484d74762732c,2,63,60,123,16,2014-08-22 01:23:38,2014-08-22 01:23:03
1852e7b2c05cbc18ee83af1eb5f484d74762732c...3c6c51acd19755d9582d7eae6f544d518202c673,1,1,1,2,1,2014-08-22 01:31:46,2014-08-22 01:31:46
3c6c51acd19755d9582d7eae6f544d518202c673...5fbb8bc9f1492fc656603d6a61b2669271131252,1,6,3,9,1,2014-08-22 01:45:08,2014-08-22 01:44:57
5fbb8bc9f1492fc656603d6a61b2669271131252...53a844770fb83a00a3129c76b9ac1b44230a1ba2,6,6,6,12,6,2014-08-22 01:45:08,2014-08-22 00:59:56
21cd9172fe12fe8b1c92009a1beedf1f1e6ccbf9...d1331e9c7a4acf94cf536e6947e02444f10652b1,4,30,11,41,13,2014-02-04 09:06:59,2014-02-03 08:39:09
21cd9172fe12fe8b1c92009a1beedf1f1e6ccbf9...ceea2a1cf26996c7e64f4107137ea6e9dbabb310,4,48,6,54,8,2014-02-04 05:58:26,2013-12-14 00:40:12
ceea2a1cf26996c7e64f4107137ea6e9dbabb310...21c8eaf8a5862457f7e70a00ab5a9d978cc3756c,1,7,1,8,2,2014-02-04 05:58:26,2013-12-14 01:04:37
21c8eaf8a5862457f7e70a00ab5a9d978cc3756c...9bad898e5973e46bf09b995579cdf3fad5c76fe0,1,3,1,4,1,2014-02-04 05:58:26,2013-12-14 01:51:55
9bad898e5973e46bf09b995579cdf3fad5c76fe0...355d7e8944bb7ea68054dfd5b5f1506d96f07479,1,20,4,24,3,2014-02-04 05:58:27,2014-01-03 23:40:58
355d7e8944bb7ea68054dfd5b5f1506d96f07479...e1f34d3ab423c2b24ca5b99d5db424e3d34fe87e,1,4,3,7,2,2014-02-04 05:58:27,2014-01-03 23:48:31
e1f34d3ab423c2b24ca5b99d5db424e3d34fe87e...65e01162a24a28ecf9887d70a70d8114bbae75bf,1,10,2,12,2,2014-02-04 05:58:27,2014-01-04 00:31:39
65e01162a24a28ecf9887d70a70d8114bbae75bf...0393315e29d65e0fad5af7e52bdebbe5807f4559,1,6,6,12,6,2014-02-04 05:58:27,2014-01-11 02:17:00
0393315e29d65e0fad5af7e52bdebbe5807f4559...2c018d5efc71ad02398beaaa9c3c16fa8a1244ad,2,4,4,8,4,2014-02-04 05:58:27,2014-01-11 02:17:14
2c018d5efc71ad02398beaaa9c3c16fa8a1244ad...b8d4e93166df54d32f65dd0b3a73f9a9df0439bd,1,6,0,6,1,2014-02-04 05:58:27,2014-01-13 18:46:36
b8d4e93166df54d32f65dd0b3a73f9a9df0439bd...dcecf0a76571bd78204b73907d824edbad9124e0,5,2305,38,2343,10,2014-02-04 05:58:27,2013-12-04 23:39:17
dcecf0a76571bd78204b73907d824edbad9124e0...44ffad379484b520147938e2d26e827aa00b1a4b,5,180,22,202,12,2014-02-04 05:58:27,2014-01-21 09:26:50
44ffad379484b520147938e2d26e827aa00b1a4b...b93fe02ef59c2fb891a1b910ac02a0facd30147d,1,56,13,69,11,2014-02-04 05:58:27,2014-01-27 00:28:22
b93fe02ef59c2fb891a1b910ac02a0facd30147d...11cc8bbff7e2f9f1e1d34579abd32bba8f5dbe90,1,0,1,1,1,2014-02-04 05:58:28,2014-01-27 00:29:14
11cc8bbff7e2f9f1e1d34579abd32bba8f5dbe90...1d576de990c3c06232ec2be1b4f9812bb4cc44c2,1,5,3,8,5,2014-02-04 05:58:28,2014-01-27 03:28:49
1d576de990c3c06232ec2be1b4f9812bb4cc44c2...6071b611d1e6c491db5bd70ad447ca06ef681efa,1,13,2,15,3,2014-02-04 05:58:28,2014-01-27 04:24:56
6071b611d1e6c491db5bd70ad447ca06ef681efa...98f49d71d01a28c7c222edf217985e6491dc8b80,1,8,8,16,7,2014-02-04 05:58:28,2014-01-27 04:25:12
98f49d71d01a28c7c222edf217985e6491dc8b80...7317188fed05a8543b58373f647e936f0d03aa73,2,104,4,108,3,2014-02-04 05:58:28,2014-01-27 08:36:53
7317188fed05a8543b58373f647e936f0d03aa73...2f78babda1f04a59b330003c30b79d8b542e14d8,3,27,7,34,9,2014-02-04 05:58:28,2014-01-27 08:37:10
2f78babda1f04a59b330003c30b79d8b542e14d8...ca71fc1920e12a62c0b19c7a099069f41caa2cc8,1,10,1,11,1,2014-02-04 05:58:28,2014-01-27 22:09:40
ca71fc1920e12a62c0b19c7a099069f41caa2cc8...ace1f018496af30eb9416c30f00edb39d145c8a3,1,9,4,13,3,2014-02-04 05:58:28,2014-01-27 22:13:01
ace1f018496af30eb9416c30f00edb39d145c8a3...57e670440a62258bf726bf751f101ed9d3d1ea30,4,9,1,10,6,2014-02-04 05:58:28,2013-09-27 08:27:53
57e670440a62258bf726bf751f101ed9d3d1ea30...a63a3b0057ee6a09dd92bcde371823bfae8a5a14,2,2,2,4,2,2014-02-04 05:58:28,2013-10-10 16:44:26
a63a3b0057ee6a09dd92bcde371823bfae8a5a14...69a208fe1e0b5163bb1b7e619b6e054c447672f2,1,2,1,3,1,2014-02-04 05:58:28,2014-01-27 23:16:47
69a208fe1e0b5163bb1b7e619b6e054c447672f2...0d7ef87732a625de473d88eee13842ec02e249ab,1,6,0,6,1,2014-02-04 05:58:29,2014-01-27 23:37:24
0d7ef87732a625de473d88eee13842ec02e249ab...efb700f4f951036f69f550a8aebd6428dca68d2d,1,6,6,12,5,2014-02-04 05:58:29,2014-02-03 21:51:04
efb700f4f951036f69f550a8aebd6428dca68d2d...830300cb2ecbe07b48433f04e3f2f7b16d7d4031,4,200,189,389,17,2014-02-04 05:58:29,2014-02-03 22:48:05
830300cb2ecbe07b48433f04e3f2f7b16d7d4031...99faeac0c76d4e718fee81ab3ffb03158867918f,2,31,9,40,8,2014-02-04 05:58:29,2014-02-01 01:31:57
99faeac0c76d4e718fee81ab3ffb03158867918f...cf11139f6cb80ee5b60de45e7f1d29ebae651ebc,8,49,11,60,16,2014-02-04 05:58:29,2014-02-01 01:32:48
cf11139f6cb80ee5b60de45e7f1d29ebae651ebc...17d6bbcee062034068471f23e1b252673205118b,1,3,0,3,2,2014-02-04 05:58:29,2014-02-01 01:44:20
17d6bbcee062034068471f23e1b252673205118b...a26822ec9684086114d4e8257b8b6c8471fe7e8b,4,40,42,82,23,2014-02-05 21:54:30,2014-02-05 21:54:30
a26822ec9684086114d4e8257b8b6c8471fe7e8b...6b9af2b058ce005d4af956b5161812d356aaa092,1,9,2,11,1,2014-02-05 21:54:51,2014-02-05 21:54:51
98a5522d6a368be29624f49975ef12e14cb0f017...84917c9fa90ba6ed816d45f34707c69e31d9698d,1,0,4,4,1,2014-02-05 00:24:56,2014-02-05 00:24:56
f2f0482c690b5819767423af0b47ea3e7c5a8a61...89381e98cd45f5b70cb606f6464ec36cf5af8376,1,7,4,11,5,2015-02-24 20:39:42,2015-02-05 16:55:49
89381e98cd45f5b70cb606f6464ec36cf5af8376...58c58b0320f533c2e48b0dbf95367884063a2758,2,2,2,4,2,2015-02-24 20:40:51,2015-02-24 20:40:51
58c58b0320f533c2e48b0dbf95367884063a2758...18c6183926b391bad801ea273739a080f2935ca7,1,7,0,7,1,2015-02-24 23:19:20,2015-02-24 23:19:20
18c6183926b391bad801ea273739a080f2935ca7...d1e76b52cbe7662e83f991587e7d82d180d70a34,5,5,5,10,5,2015-02-24 23:48:20,2015-02-24 23:48:20
d1e76b52cbe7662e83f991587e7d82d180d70a34...67a45935e066e6c75d400f9fcac14c4c5c3b1283,1,7,1,8,2,2015-02-25 00:24:42,2015-02-25 00:24:42
67a45935e066e6c75d400f9fcac14c4c5c3b1283...0b8a33282eb464ab5b902df5be176663556e35b4,2,3,2,5,2,2015-02-25 16:55:26,2015-02-25 16:55:21
0b8a33282eb464ab5b902df5be176663556e35b4...749ecb81addfef0abd7a24acdc0cdb3078b8107d,6,6,6,12,6,2015-02-25 17:32:21,2015-02-25 17:32:21
27f7daa7f8e42b381c5a9a174e027ada673635ad...fb8a79ba0f3124c33b9f52c2a02116814cf5649d,2,9,2,11,2,2015-01-21 06:47:25,2015-01-21 06:47:25
27f7daa7f8e42b381c5a9a174e027ada673635ad...e8b2a02accea1d0870f7bb454f17efaafba9b538,2,258,19,277,3,2015-01-21 06:03:21,2014-12-10 23:39:45
e8b2a02accea1d0870f7bb454f17efaafba9b538...30b86a805b11e3eb75f68bf62511b463bf56430f,1,21,0,21,1,2015-01-21 06:03:21,2014-12-10 23:58:32
30b86a805b11e3eb75f68bf62511b463bf56430f...b462b95111b41cfc52a0d9f42274e1c1ca899e1f,2,101,93,194,10,2015-01-21 06:03:21,2014-12-11 04:20:52
b462b95111b41cfc52a0d9f42274e1c1ca899e1f...fec2f8eaef794bb8ac0ba89c37a47d0e4580dc98,3,7,8,15,5,2015-01-21 06:03:21,2014-12-11 04:29:55
fec2f8eaef794bb8ac0ba89c37a47d0e4580dc98...6a534d7da12755db817495b51199a30603a24067,2,24,15,39,3,2015-01-21 06:03:21,2014-12-11 04:46:47
6a534d7da12755db817495b51199a30603a24067...7f9c8474f5c53767451b6a9939ab7742d9c0902c,3,14,6,20,3,2015-01-21 06:03:21,2014-12-11 04:58:58
7f9c8474f5c53767451b6a9939ab7742d9c0902c...07ef66151b2076e16501c9eb38297ea6395ecff6,1,55,19,74,4,2015-01-21 06:03:21,2014-12-11 08:41:00
07ef66151b2076e16501c9eb38297ea6395ecff6...844e273792badf78398ed170e480924e6cbe17e5,2,22,19,41,14,2015-01-21 06:03:22,2014-11-11 18:19:20
844e273792badf78398ed170e480924e6cbe17e5...d42833b3bb294ad6d3ca2e10fff9aae47c529339,1,12,0,12,1,2015-01-21 06:03:22,2014-12-11 04:20:16
d42833b3bb294ad6d3ca2e10fff9aae47c529339...c62a37c6b5d192be310a487e97b28689f7a8c498,6,7,7,14,7,2015-01-21 06:03:22,2014-11-11 18:50:43
c62a37c6b5d192be310a487e97b28689f7a8c498...ccd666dc6b3020aeebcb76383bd814b17a0eca28,3,15,10,25,12,2015-01-21 06:03:22,2014-11-11 23:19:39
ccd666dc6b3020aeebcb76383bd814b17a0eca28...c0640b3e2a51c30316265a4f883683574bfbf8b7,1,0,3,3,2,2015-01-21 06:03:22,2014-11-12 03:10:29
c0640b3e2a51c30316265a4f883683574bfbf8b7...82a37c2c7c447b607dd59ccd7c717fc549b66875,1,1,3,4,2,2015-01-21 06:03:22,2014-11-12 03:55:28
82a37c2c7c447b607dd59ccd7c717fc549b66875...149121f07f0f484e57291e736ce600c8eac25d75,3,561,0,561,3,2015-01-21 06:03:22,2014-11-19 16:02:22
149121f07f0f484e57291e736ce600c8eac25d75...2456bf97dcc201726f20710aa06582f5bf9d9663,1,59,0,59,1,2015-01-21 06:03:22,2014-11-19 16:12:42
2456bf97dcc201726f20710aa06582f5bf9d9663...76d49f28d2ff47f48b2cf186c4eba9d573a5c6e3,2,6,1,7,2,2015-01-21 06:03:22,2014-11-19 18:25:18
76d49f28d2ff47f48b2cf186c4eba9d573a5c6e3...494dd8de58037c0660cbf93507e233ff8298167d,1,5,3,8,1,2015-01-21 06:03:22,2014-11-19 19:29:55
494dd8de58037c0660cbf93507e233ff8298167d...82ae2e3febb23946df72f0a3f7284abd3b959876,1,2,1,3,1,2015-01-21 06:03:22,2014-12-02 02:39:53
82ae2e3febb23946df72f0a3f7284abd3b959876...1c6a11e243858e01b108a2eeb6301b273f746f1d,2,19,1,20,2,2015-01-21 06:03:23,2014-12-03 20:28:07
1c6a11e243858e01b108a2eeb6301b273f746f1d...c91bf26f70a79defbd224b9347e6d8a87fdcf39e,1,2,1,3,1,2015-01-21 06:03:23,2014-12-05 23:40:28
c91bf26f70a79defbd224b9347e6d8a87fdcf39e...a71bff887527b1259d0b9a66ecafb07ec4cffbc5,1,26,17,43,15,2015-01-21 06:03:23,2014-12-11 19:16:26
a71bff887527b1259d0b9a66ecafb07ec4cffbc5...407ad196d036809e3ef876fded8f86f59d627520,1,5,0,5,1,2015-01-21 06:03:23,2014-12-11 22:19:58
407ad196d036809e3ef876fded8f86f59d627520...44ef7680eda6b829f0cf6d6be49d9d62317e010f,1,1,1,2,1,2015-01-21 06:03:23,2014-12-11 22:42:00
44ef7680eda6b829f0cf6d6be49d9d62317e010f...ed30752377dc8ffef50a9ea3852bd8d2624930e1,1,1,0,1,1,2015-01-21 06:03:23,2014-12-11 23:02:58
ed30752377dc8ffef50a9ea3852bd8d2624930e1...27066a6ecfd6e4a81ba56d412846789d08bea3d5,3,12,8,20,9,2015-01-21 06:03:23,2014-12-11 23:20:32
27066a6ecfd6e4a81ba56d412846789d08bea3d5...ec85fabf660e69462ff00e67321d71dda7963b00,1,14,10,24,9,2015-01-21 06:03:23,2014-12-11 23:33:28
ec85fabf660e69462ff00e67321d71dda7963b00...9db7c37737f1decf95995241bc1ff4cb6d7b4e5e,1,0,1,1,1,2015-01-21 06:03:23,2014-12-11 23:39:51
9db7c37737f1decf95995241bc1ff4cb6d7b4e5e...70392aec79ebf012a24b9c0a30855df7757af1f3,2,10,3,13,3,2015-01-21 06:03:23,2014-12-12 01:26:23
70392aec79ebf012a24b9c0a30855df7757af1f3...78ddbd331a9a38ef4ed5c5ca8a41d57e5958657a,1,5,1,6,1,2015-01-21 06:03:23,2014-12-12 01:34:15
78ddbd331a9a38ef4ed5c5ca8a41d57e5958657a...219357098a73aae3c040239c9311086a989456b6,1,344,0,344,1,2015-01-21 06:03:24,2014-12-16 01:12:53
219357098a73aae3c040239c9311086a989456b6...2de6867f68e386e7ad769c313cf4bf86c4cae5b3,1,2,2,4,2,2015-01-21 06:03:24,2014-12-16 02:01:02
2de6867f68e386e7ad769c313cf4bf86c4cae5b3...6b145a594031eff1cdb2c4353118874a1c3f94b1,3,34,4,38,6,2015-01-21 06:03:24,2014-12-16 03:16:00
6b145a594031eff1cdb2c4353118874a1c3f94b1...8cafda074cb2f446f5956a6a546566499489cccf,2,26,31,57,14,2015-01-21 06:03:24,2014-12-16 03:34:07
8cafda074cb2f446f5956a6a546566499489cccf...9ed25775feedaa91bd8bd27444a65afcf346e986,2,9,9,18,6,2015-01-21 06:04:21,2014-12-16 03:47:52
9ed25775feedaa91bd8bd27444a65afcf346e986...727b48d3fa8ecf53777872308814bf74b663dcb1,2,5,2,7,3,2015-01-21 06:04:21,2014-12-16 04:14:14
727b48d3fa8ecf53777872308814bf74b663dcb1...4bfb2f77807571f577c3cb6a10247a2166fdca8e,1,45,37,82,27,2015-01-21 06:04:21,2014-12-16 04:25:01
4bfb2f77807571f577c3cb6a10247a2166fdca8e...ddfebbb1b597560f0053dc0b32104c82402130bd,1,4,4,8,4,2015-01-21 06:04:21,2014-12-16 07:34:59
ddfebbb1b597560f0053dc0b32104c82402130bd...459f20e3fab66caf104e63dba01cffe82f361fb0,1,19,13,32,6,2015-01-21 06:04:21,2014-12-16 07:49:18
459f20e3fab66caf104e63dba01cffe82f361fb0...387cc5cb5d8d23cae62ba821c7973095e39dd5cb,1,24,19,43,4,2015-01-21 06:04:21,2014-12-16 19:48:18
387cc5cb5d8d23cae62ba821c7973095e39dd5cb...e16e051090139a0710120bf1f9a2a9925f4240aa,1,4,2,6,1,2015-01-21 06:04:21,2014-12-16 19:52:34
e16e051090139a0710120bf1f9a2a9925f4240aa...baf410a2361f53a26bd3216c605d3d318bf47179,1,1,1,2,1,2015-01-21 06:04:22,2014-12-16 19:53:09
baf410a2361f53a26bd3216c605d3d318bf47179...2ad757275a681b981f649e452dde4e24a6f9daf6,1,5,3,8,1,2015-01-21 06:04:22,2014-12-16 20:07:27
2ad757275a681b981f649e452dde4e24a6f9daf6...5f1407aba9150291ee22cf8e17d2b0f3f4fb15c5,1,12,8,20,7,2015-01-21 06:04:22,2014-12-16 20:07:46
5f1407aba9150291ee22cf8e17d2b0f3f4fb15c5...1abcfb5d59b4e98d2db94466681f970190453bff,1,9,0,9,2,2015-01-21 06:04:22,2014-12-16 23:04:10
1abcfb5d59b4e98d2db94466681f970190453bff...d5a51292a45d0788722d009b163279b361268985,1,1,1,2,1,2015-01-21 06:04:22,2014-12-17 00:00:39
d5a51292a45d0788722d009b163279b361268985...68fc748dc1575b8c5a879c9cdd6111b5856def61,1,2,1,3,1,2015-01-21 06:04:22,2014-12-17 00:01:17
68fc748dc1575b8c5a879c9cdd6111b5856def61...40f572ebb11a17f497aedb20daa745728e2e2336,1,33,7,40,6,2015-01-21 06:04:22,2014-12-17 00:59:55
40f572ebb11a17f497aedb20daa745728e2e2336...8969d82e61d4e3c226ea65865c7790f3d9252ebc,2,65,2,67,2,2015-01-21 06:04:22,2014-12-17 02:12:37
8969d82e61d4e3c226ea65865c7790f3d9252ebc...ea3a316a7454b09f306f6ec0f36c1616772e515d,1,26,0,26,1,2015-01-21 06:04:22,2014-12-17 19:56:59
ea3a316a7454b09f306f6ec0f36c1616772e515d...60c0f5e3593ea3d72d3c26dd4d5fa4dfd0d9777a,1,17,12,29,1,2015-01-21 06:04:22,2014-12-17 20:05:49
60c0f5e3593ea3d72d3c26dd4d5fa4dfd0d9777a...a737d47aef08e6eea4cf9921f3c37fb2fb9eee47,1,3,1,4,1,2015-01-21 06:04:23,2014-12-17 20:08:55
a737d47aef08e6eea4cf9921f3c37fb2fb9eee47...bb032e7e1ea196c8cc0e360577b24d52711741f6,2,4,6,10,6,2015-01-21 06:04:23,2014-12-17 23:53:09
bb032e7e1ea196c8cc0e360577b24d52711741f6...15654758948cd4c39af122bb869109e9939552c7,4,46,11,57,17,2015-01-21 06:04:23,2014-12-17 23:36:54
15654758948cd4c39af122bb869109e9939552c7...deb03e39325c54d2f9f17756bad065d8185242d0,1,3,1,4,1,2015-01-21 06:04:23,2014-12-18 00:44:30
deb03e39325c54d2f9f17756bad065d8185242d0...c81896171fc109fb8b57e760725039b52b48a692,1,3,1,4,1,2015-01-21 06:04:23,2014-12-18 00:45:04
c81896171fc109fb8b57e760725039b52b48a692...afb27037bd3032dd5f05a2136fff199f95b463a2,1,13,9,22,8,2015-01-21 06:04:23,2014-12-18 01:38:22
afb27037bd3032dd5f05a2136fff199f95b463a2...3c8834ca8c17f4ab8679c61a0c468d6e6aa8aff0,1,10,8,18,7,2015-01-21 06:04:23,2014-12-18 01:43:13
3c8834ca8c17f4ab8679c61a0c468d6e6aa8aff0...d165837bd9e4af9200b86a935580b0600b53d08f,1,1,1,2,1,2015-01-21 06:04:23,2014-12-18 02:14:52
d165837bd9e4af9200b86a935580b0600b53d08f...1d8491d9167a1e0041e9b3b5db231ec1df40b188,2,31,3,34,2,2015-01-21 06:04:23,2014-12-18 00:58:42
1d8491d9167a1e0041e9b3b5db231ec1df40b188...63c98725b8b07edbfb3e32f936afb64666ddf364,1,3,3,6,2,2015-01-21 06:04:23,2014-12-18 01:03:42
63c98725b8b07edbfb3e32f936afb64666ddf364...67529cee6b54e40586e12dc1945e94d847c75a77,1,1,1,2,1,2015-01-21 06:04:23,2014-12-18 03:32:49
67529cee6b54e40586e12dc1945e94d847c75a77...296d765cca57d4a400f4f6834b164bc181a24267,3,26,0,26,3,2015-01-21 06:04:24,2014-12-19 00:08:45
296d765cca57d4a400f4f6834b164bc181a24267...9255e14d3f5cb1bfee1d1d3e103338c133f7314c,1,12,0,12,1,2015-01-21 06:04:24,2014-12-19 00:37:17
9255e14d3f5cb1bfee1d1d3e103338c133f7314c...517bd5ec5121cf5580a21568b2ff638f34111b83,1,17,4,21,3,2015-01-21 06:04:24,2014-12-19 00:10:03
517bd5ec5121cf5580a21568b2ff638f34111b83...3510ac3fd9d8bcb72890d7b45a9483807f82a3ea,1,9,6,15,4,2015-01-21 06:06:57,2014-12-19 00:10:26
3510ac3fd9d8bcb72890d7b45a9483807f82a3ea...23359c83efc612ef167c2fe97ab2e9c2b0810029,1,6,0,6,1,2015-01-21 06:06:57,2014-12-19 00:11:05
23359c83efc612ef167c2fe97ab2e9c2b0810029...efca9d5ce551317c86a32ccf8a114d08092f32cc,1,0,1,1,1,2015-01-21 06:06:57,2014-12-19 00:40:30
efca9d5ce551317c86a32ccf8a114d08092f32cc...ced465286a6ca9dd075f17f58479edea45b82c64,1,34,3,37,2,2015-01-21 06:06:57,2014-12-19 00:42:20
ced465286a6ca9dd075f17f58479edea45b82c64...06abed8fa49bfc9e319d5ee564f241bc9e31fbbf,1,8,0,8,2,2015-01-21 06:06:57,2014-12-19 18:56:29
06abed8fa49bfc9e319d5ee564f241bc9e31fbbf...83dd44bdd6b86417f8da3477764d6bbd03d52132,1,8,0,8,1,2015-01-21 06:06:57,2014-12-20 02:46:30
83dd44bdd6b86417f8da3477764d6bbd03d52132...04135ffa414a3fb55b94de8010499ab2797f07ed,1,83,0,83,1,2015-01-21 06:06:57,2014-12-20 02:46:50
04135ffa414a3fb55b94de8010499ab2797f07ed...508961f55b84789e3694aeab639214326f5744db,1,1,1,2,1,2015-01-21 06:06:57,2014-12-20 02:59:43
508961f55b84789e3694aeab639214326f5744db...0eea25ee56d96eb1042b8bc8d84feb44304c742b,1,6,6,12,3,2015-01-21 06:06:57,2014-12-20 03:05:18
0eea25ee56d96eb1042b8bc8d84feb44304c742b...3e2866c7ff857e56b7a34ca3c88bdad3eb37f408,1,2,2,4,2,2015-01-21 06:06:58,2014-12-20 03:21:31
3e2866c7ff857e56b7a34ca3c88bdad3eb37f408...f98c162dd183294f12d6c9caef0634fb26c0ec5c,1,14,12,26,7,2015-01-21 06:06:58,2014-12-20 04:28:20
f98c162dd183294f12d6c9caef0634fb26c0ec5c...c242524c2a41960221ac0cd14d38c41c6e4fb2e9,1,4,4,8,2,2015-01-21 06:06:58,2014-12-20 04:33:16
c242524c2a41960221ac0cd14d38c41c6e4fb2e9...c7675a0da33c312fff7ba468a31b1705b716deee,1,3,3,6,3,2015-01-21 06:06:58,2014-12-20 04:34:30
c7675a0da33c312fff7ba468a31b1705b716deee...f08b616d20579cf19e90eeba4cdde7b91259021c,1,4,2,6,2,2015-01-21 06:06:58,2014-12-20 04:46:57
f08b616d20579cf19e90eeba4cdde7b91259021c...555a3e5dd3ba87f1989426220d796f7fd8f47dfc,1,17,1,18,4,2015-01-21 06:06:58,2014-12-20 05:07:58
555a3e5dd3ba87f1989426220d796f7fd8f47dfc...c85a0e9a5a7b960b4f230cf821fac4df40346bc4,1,2,1,3,2,2015-01-21 06:06:58,2014-12-20 05:12:04
c85a0e9a5a7b960b4f230cf821fac4df40346bc4...ed5f19253f5dd19cb134687bf1693fbf41d490ad,1,13,3,16,5,2015-01-21 06:06:58,2015-01-06 01:55:22
ed5f19253f5dd19cb134687bf1693fbf41d490ad...7253c8ee9c11a599260715ce6affd4a5e0284cf9,1,1,1,2,1,2015-01-21 06:06:58,2015-01-07 18:02:35
7253c8ee9c11a599260715ce6affd4a5e0284cf9...ef60dbaccd798ffd7b54c000cc12aad8bcd28f81,2,4,1,5,2,2015-01-21 06:06:58,2015-01-07 18:34:09
ef60dbaccd798ffd7b54c000cc12aad8bcd28f81...af50216007d9f548448afffd1efb469978bc6ecd,1,3,0,3,2,2015-01-21 06:06:58,2015-01-07 18:52:45
af50216007d9f548448afffd1efb469978bc6ecd...3ca6ea08dd4fe7591aef959f191f23b1f600a9a5,2,41,0,41,2,2015-01-21 06:06:58,2015-01-07 20:31:35
3ca6ea08dd4fe7591aef959f191f23b1f600a9a5...d75a0ca12c146466df0ae317b2d4525434f6a620,1,0,5,5,1,2015-01-21 06:06:59,2015-01-08 18:12:24
d75a0ca12c146466df0ae317b2d4525434f6a620...ed2dead94a5496b2165690015b2e806730a99a75,2,25,6,31,6,2015-01-21 06:06:59,2015-01-08 18:57:36
ed2dead94a5496b2165690015b2e806730a99a75...1ba0e1b267dc982bd59b650a798a29c09a6dec65,3,6,3,9,3,2015-01-21 06:07:35,2015-01-08 22:23:20
1ba0e1b267dc982bd59b650a798a29c09a6dec65...6a734db97bc3060104a7a86cf4512f2ff8c887ae,1,120,0,120,1,2015-01-21 06:07:35,2015-01-09 05:08:00
6a734db97bc3060104a7a86cf4512f2ff8c887ae...08898db3b809d7b4c26997f97b9dd5da8e1d72ba,1,1,1,2,1,2015-01-21 06:08:14,2015-01-08 22:27:17
08898db3b809d7b4c26997f97b9dd5da8e1d72ba...bb21c1750fdb2f0e7bf90386277db3b673fc99d6,8,30,18,48,9,2015-01-21 06:08:14,2015-01-09 03:46:00
bb21c1750fdb2f0e7bf90386277db3b673fc99d6...c113cb283bb2b645bc64bf0467f2b442a6d5c3ae,1,16,11,27,10,2015-01-21 06:08:14,2015-01-09 03:54:52
c113cb283bb2b645bc64bf0467f2b442a6d5c3ae...a4084a95999b90771612a6aab0ee715e72ef9a0d,4,4,4,8,4,2015-01-21 06:08:14,2015-01-09 03:56:09
a4084a95999b90771612a6aab0ee715e72ef9a0d...15295f903370ee9415fb2352e91d618874afd21c,5,4,8,12,7,2015-01-21 06:08:15,2015-01-09 04:06:29
15295f903370ee9415fb2352e91d618874afd21c...977e3171fdd16e176e1fcb184bb353e8e84e36bf,5,5,4,9,5,2015-01-21 06:08:15,2015-01-09 04:26:26
977e3171fdd16e176e1fcb184bb353e8e84e36bf...07d84b2d95dd3e80c10f23e4a5d7fe06af024421,1,1,1,2,1,2015-01-21 06:08:15,2015-01-09 04:27:14
07d84b2d95dd3e80c10f23e4a5d7fe06af024421...0ef8b245d10845a58e25e9848a52344a3ba7d176,1,3,1,4,1,2015-01-21 06:08:15,2015-01-09 18:48:04
0ef8b245d10845a58e25e9848a52344a3ba7d176...b0a22a8b9847268d4481b2ee276bad1ac0171819,1,4,1,5,1,2015-01-21 06:08:15,2015-01-09 18:55:14
b0a22a8b9847268d4481b2ee276bad1ac0171819...d8b03cbfe4ecbe1c4321c384b24774071e20074d,1,6,0,6,1,2015-01-21 06:08:15,2015-01-09 19:41:17
d8b03cbfe4ecbe1c4321c384b24774071e20074d...ac5fbf2e9ccfa74149151afdeaae922960b15ee1,1,1,1,2,1,2015-01-21 06:08:15,2015-01-09 19:44:10
ac5fbf2e9ccfa74149151afdeaae922960b15ee1...369f2faf49cbde0ca469d9c0d34cf2d9781b4b93,2,31,2,33,2,2015-01-21 06:08:15,2015-01-09 20:09:33
369f2faf49cbde0ca469d9c0d34cf2d9781b4b93...2a958c6dcb371a3f6c4eb42bacc680863614f43a,1,2,1,3,1,2015-01-21 06:08:16,2015-01-09 22:07:19
2a958c6dcb371a3f6c4eb42bacc680863614f43a...cad703904393a6b298cc927528016dd3fce45831,1,1,1,2,1,2015-01-21 06:08:16,2015-01-09 22:08:21
cad703904393a6b298cc927528016dd3fce45831...979f05b244856fb9d175a76fbfb6e016e3837b7a,2,3,3,6,3,2015-01-21 06:08:16,2015-01-09 22:39:20
979f05b244856fb9d175a76fbfb6e016e3837b7a...8174951fdbceef3398e98a59df31b1bf043694e0,1,42,2,44,2,2015-01-21 06:08:16,2015-01-10 00:28:43
8174951fdbceef3398e98a59df31b1bf043694e0...06d6126e7e6fb6dd30c9b75179d83afade1e2812,2,11,4,15,3,2015-01-21 06:34:06,2015-01-10 03:47:23
06d6126e7e6fb6dd30c9b75179d83afade1e2812...e074fc3fe1da0519a478f7bdcf0226e0ba6615fc,1,1,2,3,1,2015-01-21 06:34:12,2015-01-12 19:47:04
e074fc3fe1da0519a478f7bdcf0226e0ba6615fc...b51b3276be30dc1e1d74e059e5680dcf98aaad0f,1,1,1,2,1,2015-01-21 06:34:12,2015-01-12 19:47:18
b51b3276be30dc1e1d74e059e5680dcf98aaad0f...f462bcac9ccbd2b52acc0ca533fb8751550059e9,1,3,0,3,1,2015-01-21 06:34:12,2015-01-12 19:53:37
f462bcac9ccbd2b52acc0ca533fb8751550059e9...a27a4543b3ca531ac6c1b59f21e5412458495a81,1,18,7,25,2,2015-01-21 06:34:13,2015-01-12 20:00:46
a27a4543b3ca531ac6c1b59f21e5412458495a81...4e5850cc8787f7b905eb97620cf3272158a91bb3,2,2,2,4,2,2015-01-21 06:34:13,2015-01-12 20:20:34
4e5850cc8787f7b905eb97620cf3272158a91bb3...208489f7a3c345c587b5ebc81dad997232cef26e,1,1,1,2,1,2015-01-21 06:34:13,2015-01-12 20:23:24
208489f7a3c345c587b5ebc81dad997232cef26e...b7fa778ac1bcf5b0c76a6a70b895083f1a33c27a,1,1,1,2,1,2015-01-21 06:34:13,2015-01-12 21:39:50
b7fa778ac1bcf5b0c76a6a70b895083f1a33c27a...cdd024869539475a3a1b0684d222a1af7bf5151f,1,15,4,19,2,2015-01-21 06:34:13,2015-01-12 21:40:01
cdd024869539475a3a1b0684d222a1af7bf5151f...e4d13a90d71dde0f288cb03f7475515c17737aaf,1,6,2,8,3,2015-01-21 06:34:13,2015-01-12 22:18:57
e4d13a90d71dde0f288cb03f7475515c17737aaf...f774ce8c742affdfd03767669277769dd3f8dd50,1,23,32,55,4,2015-01-21 06:34:13,2015-01-13 00:43:14
f774ce8c742affdfd03767669277769dd3f8dd50...3403c08de3fa9043c490f8c1a86019388f31a2bc,1,24,15,39,2,2015-01-21 06:34:13,2015-01-13 00:43:26
3403c08de3fa9043c490f8c1a86019388f31a2bc...860bbb365b2998b08b3c177fa29156923528dc8b,1,1,1,2,1,2015-01-21 06:34:14,2015-01-13 00:45:31
860bbb365b2998b08b3c177fa29156923528dc8b...f7048fef727426585cd6e6681e44d8fdc25f66b0,1,9,2,11,2,2015-01-21 06:34:14,2015-01-13 00:54:24
f7048fef727426585cd6e6681e44d8fdc25f66b0...e1bfc9e7f53deaf491c9dfe2e54c7820e9ccd2ec,1,1,1,2,1,2015-01-21 06:34:14,2015-01-12 22:26:56
e1bfc9e7f53deaf491c9dfe2e54c7820e9ccd2ec...f947457edfc1846090062efb18abe0a09ccbafcc,1,8,11,19,3,2015-01-21 06:34:14,2015-01-13 18:26:56
f947457edfc1846090062efb18abe0a09ccbafcc...934dd240c0602bc88e0e07be79d16124971ee656,1,7,3,10,5,2015-01-21 06:34:14,2015-01-13 19:30:06
934dd240c0602bc88e0e07be79d16124971ee656...fb68a1e0e36b6d98a5d885152db8f6538254e6fe,1,3,0,3,1,2015-01-21 06:34:14,2015-01-13 19:32:56
fb68a1e0e36b6d98a5d885152db8f6538254e6fe...d1bad698cefd84695ab0bc5c092ffb0a0abca2e2,1,3,3,6,3,2015-01-21 06:34:14,2015-01-13 21:15:10
d1bad698cefd84695ab0bc5c092ffb0a0abca2e2...02c0b8b0d4f06c0d8e66d4cb373de09e60e75f5b,1,1,1,2,1,2015-01-21 06:34:15,2015-01-13 21:55:11
02c0b8b0d4f06c0d8e66d4cb373de09e60e75f5b...5b60ea0d188e386a70fc1249423885f5c786ecb9,1,10,2,12,3,2015-01-21 06:34:15,2015-01-13 22:24:45
5b60ea0d188e386a70fc1249423885f5c786ecb9...b08b8e219a4ae0dac80ed5a6a49fdd606f537182,1,1,1,2,1,2015-01-21 06:34:15,2015-01-13 22:31:33
b08b8e219a4ae0dac80ed5a6a49fdd606f537182...aa8d701f76fc5dbe4a02634ab0eba281de4be626,1,5,0,5,1,2015-01-21 06:34:15,2015-01-13 22:33:36
aa8d701f76fc5dbe4a02634ab0eba281de4be626...0e69c587f347d7da997c764c2fdc66071c653662,2,2,2,4,2,2015-01-21 06:34:15,2015-01-13 23:15:04
0e69c587f347d7da997c764c2fdc66071c653662...6de253e556cd84d18942aa2ba72e276e4a6643bb,1,4,4,8,4,2015-01-21 06:34:15,2015-01-13 23:28:29
6de253e556cd84d18942aa2ba72e276e4a6643bb...3885adca749aa43ec4000897d235d01b05f6e4f2,2,158,97,255,6,2015-01-21 06:34:15,2015-01-14 00:25:00
3885adca749aa43ec4000897d235d01b05f6e4f2...11e70f85820241473c5db9d56398ea1283883161,2,97,158,255,6,2015-01-21 06:34:16,2015-01-14 00:37:41
11e70f85820241473c5db9d56398ea1283883161...c433229deda36f77ada944ce3b46eb3832e0bd87,2,158,97,255,6,2015-01-21 06:34:16,2015-01-14 00:41:09
c433229deda36f77ada944ce3b46eb3832e0bd87...211855587d47b8ea5fa5951b1259f930c213f649,1,4,4,8,2,2015-01-21 06:34:16,2015-01-14 00:51:15
211855587d47b8ea5fa5951b1259f930c213f649...3eba075d0a090b487ad0854c5aba3c536e0d167f,2,37,25,62,3,2015-01-21 06:34:16,2015-01-14 03:24:53
3eba075d0a090b487ad0854c5aba3c536e0d167f...b0b9a37dbbf0ce9d9a3a14fcf20e30a6ae100430,2,2,2,4,2,2015-01-21 06:34:16,2015-01-14 03:30:57
b0b9a37dbbf0ce9d9a3a14fcf20e30a6ae100430...8b1e9624d52463f5ffe6a202834cda9414b244a1,2,2,2,4,2,2015-01-21 06:34:16,2015-01-14 04:53:36
8b1e9624d52463f5ffe6a202834cda9414b244a1...55fbb82314b75ebb68a65abcbe6053ccc00981e1,1,4,4,8,2,2015-01-21 06:34:16,2015-01-14 21:47:59
55fbb82314b75ebb68a65abcbe6053ccc00981e1...c638eadc9aba746c243866c3492d9f615c9b742d,2,2,2,4,2,2015-01-21 06:34:16,2015-01-14 21:55:45
c638eadc9aba746c243866c3492d9f615c9b742d...5ffc39bdca6b50cfd2b439f5f85fd0306bbff1fb,1,2,2,4,2,2015-01-21 06:34:17,2015-01-14 22:06:54
5ffc39bdca6b50cfd2b439f5f85fd0306bbff1fb...f5913e0563c9dda75a76988cdb8b7eae122ffb94,2,4,1,5,2,2015-01-21 06:34:17,2015-01-14 22:10:59
f5913e0563c9dda75a76988cdb8b7eae122ffb94...a8306b0adc213247641c5a678554556214c8631f,1,1,1,2,1,2015-01-21 06:34:17,2015-01-14 22:11:14
a8306b0adc213247641c5a678554556214c8631f...4c12cf2e669f9600f5a5c17c61361ea7c65c61f3,2,4,1,5,2,2015-01-21 06:34:17,2015-01-14 22:20:54
4c12cf2e669f9600f5a5c17c61361ea7c65c61f3...c5521f81c0646e5d827e4185b69318321790e134,1,5,3,8,5,2015-01-21 06:34:17,2015-01-14 22:56:33
c5521f81c0646e5d827e4185b69318321790e134...a7816c235f7634a707e8a71ebf95da58e701acd9,1,2,2,4,1,2015-01-21 06:34:17,2015-01-14 22:59:36
a7816c235f7634a707e8a71ebf95da58e701acd9...a80e3af51096e40ca5932b417a0a57cb60697341,1,1,1,2,1,2015-01-21 06:34:17,2015-01-14 22:58:54
a80e3af51096e40ca5932b417a0a57cb60697341...85e4e3b8e2aab8fc75306af6b594b53afbdc4093,1,3,3,6,1,2015-01-21 06:34:18,2015-01-14 23:52:15
85e4e3b8e2aab8fc75306af6b594b53afbdc4093...2dac4a490a08fd66b474020dea2e38490ac0dd7d,2,4,4,8,2,2015-01-21 06:34:18,2015-01-14 23:57:19
2dac4a490a08fd66b474020dea2e38490ac0dd7d...361b99a7fd590612a7b9d984ffe8e242fde4c0ec,2,3,2,5,2,2015-01-21 06:34:18,2015-01-15 00:04:04
361b99a7fd590612a7b9d984ffe8e242fde4c0ec...9737b5b1ef589509e34879d47e384e48b00915d7,1,1,1,2,1,2015-01-21 06:34:18,2015-01-15 00:04:26
9737b5b1ef589509e34879d47e384e48b00915d7...802ba5c01432435c79442a840994f5c4cb36dbdd,3,3,3,6,3,2015-01-21 06:34:18,2015-01-15 00:09:05
802ba5c01432435c79442a840994f5c4cb36dbdd...0e69da5a89cf583e4d6cfe0a12502002ee4ee3f3,1,1,1,2,1,2015-01-21 06:34:18,2015-01-15 06:03:11
0e69da5a89cf583e4d6cfe0a12502002ee4ee3f3...f90a7ab0d0022748ab6b4649d772dabe3005ca9e,2,5,3,8,4,2015-01-21 06:34:18,2015-01-15 06:03:50
f90a7ab0d0022748ab6b4649d772dabe3005ca9e...6a0a0ccaea5d8f525d13bc14235b01d030435553,1,13,0,13,1,2015-01-21 06:34:18,2015-01-15 17:52:49
6a0a0ccaea5d8f525d13bc14235b01d030435553...0e724007ffa68c765aa08f4c0815725bfb96de4c,1,20,41,61,2,2015-01-21 06:34:19,2015-01-15 18:14:38
0e724007ffa68c765aa08f4c0815725bfb96de4c...349c7a8272e8e14d6db75f5e20f52e58bebf5631,1,1,1,2,1,2015-01-21 06:34:19,2015-01-15 18:19:54
349c7a8272e8e14d6db75f5e20f52e58bebf5631...aec7e4a9844900ad536464cd0e4eda8741ba1b6b,1,3,1,4,1,2015-01-21 06:34:19,2015-01-15 18:25:50
aec7e4a9844900ad536464cd0e4eda8741ba1b6b...8b36243375cd6de20a89fc10bf56b436e0dd7427,1,202,132,334,30,2015-01-21 06:34:19,2015-01-15 18:33:00
8b36243375cd6de20a89fc10bf56b436e0dd7427...c75a7b05ce0630b5260c2544e6c8128deafada3d,2,9,25,34,3,2015-01-21 06:34:19,2015-01-15 18:59:24
c75a7b05ce0630b5260c2544e6c8128deafada3d...a041ba71f44c8ca96c0d0497ad17c24e1ddb40df,1,10,9,19,8,2015-01-21 06:34:19,2015-01-15 18:59:57
a041ba71f44c8ca96c0d0497ad17c24e1ddb40df...2d7e1e869625f1a539783eadd0664846e9e185d1,1,0,4,4,1,2015-01-21 06:34:19,2015-01-15 19:03:36
2d7e1e869625f1a539783eadd0664846e9e185d1...f2459b4aa819cdfc2c63e2a888b58b34ee4c0a2c,1,1,1,2,1,2015-01-21 06:34:20,2015-01-15 19:06:15
f2459b4aa819cdfc2c63e2a888b58b34ee4c0a2c...84dcd9728cc69130b7a0de32ae05249000a784d3,3,4,4,8,3,2015-01-21 06:34:20,2015-01-15 19:26:06
84dcd9728cc69130b7a0de32ae05249000a784d3...dee47d5cff921fbf374ef1e90bf9df6bbf3e0aec,1,0,29,29,1,2015-01-21 06:34:20,2015-01-15 19:42:57
dee47d5cff921fbf374ef1e90bf9df6bbf3e0aec...edc1bc92f1f34068838c58bafbc33a11a5d98794,1,7,11,18,4,2015-01-21 06:34:20,2015-01-15 19:54:08
edc1bc92f1f34068838c58bafbc33a11a5d98794...eaa88cbe7ce4698c92e13a913bc6a4e0d3b04bd2,1,5,5,10,2,2015-01-21 06:34:20,2015-01-15 19:58:44
eaa88cbe7ce4698c92e13a913bc6a4e0d3b04bd2...9422164bba7a45daa63bffe43dd058b3b7e97b37,1,4,4,8,3,2015-01-21 06:34:20,2015-01-15 20:02:05
9422164bba7a45daa63bffe43dd058b3b7e97b37...2fb5de937aa9e31aaad9efb53f6bccca6267ffe6,1,1,3,4,2,2015-01-21 06:34:20,2015-01-15 20:04:08
2fb5de937aa9e31aaad9efb53f6bccca6267ffe6...25e37833cae4ef6955ebcf2428b56cc0606dfa99,1,6,8,14,2,2015-01-21 06:34:21,2015-01-15 20:27:04
25e37833cae4ef6955ebcf2428b56cc0606dfa99...2a53499fb50996a8967cc4c9c17604cd2e9ef9cb,1,3,5,8,2,2015-01-21 06:34:21,2015-01-15 20:27:53
2a53499fb50996a8967cc4c9c17604cd2e9ef9cb...f11446289456af95f1deaedd2806f91bdf2cee4a,1,3,3,6,2,2015-01-21 06:34:21,2015-01-15 23:55:38
f11446289456af95f1deaedd2806f91bdf2cee4a...5ce6224111ebca9b37463647403c5347ee295767,1,7,4,11,2,2015-01-21 06:34:21,2015-01-16 01:28:53
5ce6224111ebca9b37463647403c5347ee295767...45e8f40ecec98a69b2a5a2afeb68d13d84c548a3,1,9,3,12,2,2015-01-21 06:34:21,2015-01-16 01:45:44
45e8f40ecec98a69b2a5a2afeb68d13d84c548a3...7a9ccaa9db719c00f39e1652f059ff75fcb9fbcd,1,9,3,12,2,2015-01-21 06:34:21,2015-01-16 01:55:09
7a9ccaa9db719c00f39e1652f059ff75fcb9fbcd...50c50b4e500f7209305886eb9d68fb5cd1ca9e2f,1,5,1,6,1,2015-01-21 06:34:21,2015-01-16 02:28:32
50c50b4e500f7209305886eb9d68fb5cd1ca9e2f...f4a33c60eba369e8d9c2b3d1822ade0469049e5c,1,0,1,1,1,2015-01-21 06:34:21,2015-01-16 02:30:49
f4a33c60eba369e8d9c2b3d1822ade0469049e5c...d8dbd854cc289c409ead2851e891e6c29d16d695,1,1,1,2,1,2015-01-21 06:34:22,2015-01-16 02:40:38
d8dbd854cc289c409ead2851e891e6c29d16d695...0ac02cde617c79cc843364a27adabdb8743c4a0f,1,36,8,44,7,2015-01-21 06:34:22,2015-01-16 04:43:50
0ac02cde617c79cc843364a27adabdb8743c4a0f...0f25d9207c102baa9110ac0886f3e795a6f739d0,4,23,13,36,6,2015-01-21 06:34:22,2015-01-16 04:57:32
0f25d9207c102baa9110ac0886f3e795a6f739d0...d48bd819f190f6953355019c727d7fef6c0f72e4,1,32,0,32,1,2015-01-21 06:34:22,2015-01-16 17:51:02
d48bd819f190f6953355019c727d7fef6c0f72e4...c7b5aac10be550a65dfe3cc076f643990e3a9178,1,3,1,4,2,2015-01-21 06:34:22,2015-01-16 18:03:30
c7b5aac10be550a65dfe3cc076f643990e3a9178...42fe815e0f987c057f9f3d3346f852f43328a23f,1,0,1,1,1,2015-01-21 06:34:22,2015-01-16 18:17:58
42fe815e0f987c057f9f3d3346f852f43328a23f...8788b39b548ac17cd1df0c34ef802a953b2ebb67,2,20,1,21,2,2015-01-21 06:34:22,2015-01-16 18:18:12
8788b39b548ac17cd1df0c34ef802a953b2ebb67...74ecb02d13a9f1a1345ef60b225a278710cad05a,2,74,0,74,2,2015-01-21 06:34:23,2015-01-16 20:04:55
74ecb02d13a9f1a1345ef60b225a278710cad05a...b75ab23e27870d4882f1d7ff2014f6d3b32b07fe,1,7,5,12,6,2015-01-21 06:34:23,2015-01-16 20:07:40
b75ab23e27870d4882f1d7ff2014f6d3b32b07fe...1e81fc0dbd07d0d2cf2b71574b2ac95ff0095fb8,1,2,1,3,1,2015-01-21 06:34:23,2015-01-16 20:09:13
1e81fc0dbd07d0d2cf2b71574b2ac95ff0095fb8...1827131655a64b9cf9f2bf99774541bc73deb21a,2,5,5,10,3,2015-01-21 06:34:23,2015-01-16 22:14:41
1827131655a64b9cf9f2bf99774541bc73deb21a...9d1c10aae2e67a491fc8208d62d30a8380a34eeb,6,111,62,173,11,2015-01-21 06:34:23,2015-01-16 22:58:25
9d1c10aae2e67a491fc8208d62d30a8380a34eeb...ee33b9336fa50d20d91bfabed2399ae0981efda5,1,37,0,37,1,2015-01-21 06:34:23,2015-01-16 23:32:34
ee33b9336fa50d20d91bfabed2399ae0981efda5...6583c6d417ba5aa1d2750c75fa0e940cd9faaba0,1,4,2,6,5,2015-01-21 06:34:23,2015-01-16 23:28:08
6583c6d417ba5aa1d2750c75fa0e940cd9faaba0...5c2eb0761b1dcc38f47d8fa0785e94183e442f36,4,48,6,54,9,2015-01-21 06:34:24,2015-01-16 23:59:32
5c2eb0761b1dcc38f47d8fa0785e94183e442f36...86273d893084583f3c4451cae17a55173138b9f7,1,2,2,4,2,2015-01-21 06:34:24,2015-01-17 00:04:06
86273d893084583f3c4451cae17a55173138b9f7...f6c47040905eacff00be97797091426a1aecd335,1,2,2,4,2,2015-01-21 06:34:24,2015-01-17 00:17:39
f6c47040905eacff00be97797091426a1aecd335...5526f97d476a80ccf0d44dad2f9b392d1bc7bf7a,1,1,1,2,1,2015-01-21 06:34:24,2015-01-17 00:18:32
5526f97d476a80ccf0d44dad2f9b392d1bc7bf7a...c37342d5049fcc3e6731cdca44373eb543f5c4f5,24,24,24,48,24,2015-01-21 06:34:24,2015-01-17 00:28:08
c37342d5049fcc3e6731cdca44373eb543f5c4f5...c93fb243f2dfb3f7857c7b39d9538a38e8728b9e,1,1,1,2,1,2015-01-21 06:34:24,2015-01-17 00:29:35
c93fb243f2dfb3f7857c7b39d9538a38e8728b9e...86e0b125b22c32678c13d2b434e994e590defa89,1,19,2,21,5,2015-01-21 06:34:24,2015-01-17 00:53:10
86e0b125b22c32678c13d2b434e994e590defa89...25f3b9f3373a5b6cac86ae1fa3be20674341ae75,15,16,15,31,15,2015-01-21 06:34:25,2015-01-17 00:53:26
25f3b9f3373a5b6cac86ae1fa3be20674341ae75...abc75a36fdcea1693c453d4cbb5b98d5542a48be,1,2,1,3,1,2015-01-21 06:34:25,2015-01-17 00:56:19
abc75a36fdcea1693c453d4cbb5b98d5542a48be...e15b96b8eaedfe8f726b7e28f7eaab3da2f38ca9,1,1,1,2,1,2015-01-21 06:34:25,2015-01-17 00:58:56
e15b96b8eaedfe8f726b7e28f7eaab3da2f38ca9...4e867aa9195737e9843087b73b8479ed67e35d6e,1,2,1,3,1,2015-01-21 06:34:25,2015-01-17 01:00:43
4e867aa9195737e9843087b73b8479ed67e35d6e...e84fa64ac688ae9fcde845041d36f050cc2d942c,1,1,1,2,1,2015-01-21 06:34:25,2015-01-17 01:05:13
e84fa64ac688ae9fcde845041d36f050cc2d942c...bf124419d19c7236d9c29aab523dbc8c2a40f9d1,1,3,3,6,3,2015-01-21 06:34:25,2015-01-17 01:12:07
bf124419d19c7236d9c29aab523dbc8c2a40f9d1...7534e8f1a2851b5562b413623a1469b04881bc6c,1,2,3,5,2,2015-01-21 06:34:25,2015-01-17 01:33:58
7534e8f1a2851b5562b413623a1469b04881bc6c...0dfecf2f37a7e71a201e0a0ba5b324cc5e852dcf,5,17,9,26,9,2015-01-21 21:56:53,2015-01-20 18:53:32
0dfecf2f37a7e71a201e0a0ba5b324cc5e852dcf...ee7d0eda5843215c268cc33faf7219f69c5aab9f,4,5,19,24,7,2015-01-21 22:01:09,2015-01-21 22:01:09
ee7d0eda5843215c268cc33faf7219f69c5aab9f...7c59eac1a84b4111f1ca25f0826c32043fa15a11,1,3,2,5,1,2015-01-21 22:01:48,2015-01-21 22:01:48
7c59eac1a84b4111f1ca25f0826c32043fa15a11...27f249bfed2c0367970900256b5e767322d47bbe,123,128,125,253,125,2015-01-21 22:03:55,2015-01-21 22:03:55
27f249bfed2c0367970900256b5e767322d47bbe...2ddc9738b2eb5b7832f1c936a5f0dc337b32a358,1,2,1,3,1,2015-01-21 22:04:07,2015-01-20 21:29:50
2ddc9738b2eb5b7832f1c936a5f0dc337b32a358...2d7aa3f80e789348c8d5345f6af6c8d9300e0870,2,5,3,8,3,2015-01-21 22:04:07,2015-01-20 21:34:24
2d7aa3f80e789348c8d5345f6af6c8d9300e0870...c3428677b8483a68ecc2122d21e2922e1df483d0,1,1,1,2,1,2015-01-21 22:04:08,2015-01-20 19:18:00
c3428677b8483a68ecc2122d21e2922e1df483d0...1233e4e1976a674f6e60ae0668a999892547c4d7,1,1,1,2,2,2015-01-21 22:04:08,2015-01-20 22:20:10
1233e4e1976a674f6e60ae0668a999892547c4d7...a496aafdfb235b4539cfecb6b8aeb74b8250fb98,1,2,1,3,1,2015-01-21 22:04:08,2015-01-20 22:59:35
a496aafdfb235b4539cfecb6b8aeb74b8250fb98...35eb03b214a1a80b5a5c4f80dc44cdc8733e0f01,2,2,2,4,2,2015-01-21 22:04:08,2015-01-21 01:32:11
35eb03b214a1a80b5a5c4f80dc44cdc8733e0f01...2ca995870bd07616567283780a997ec5475c3ceb,3,7,11,18,5,2015-01-21 22:04:08,2015-01-21 01:45:20
2ca995870bd07616567283780a997ec5475c3ceb...36ef2e2e1bfb912fd0dda38b0664d095b6696318,2,2,2,4,2,2015-01-21 22:04:08,2015-01-21 03:23:23
36ef2e2e1bfb912fd0dda38b0664d095b6696318...6addf070b233245ed9d7d722cde96cdd8fe85a82,1,2,1,3,1,2015-01-21 22:04:08,2015-01-21 04:30:22
6addf070b233245ed9d7d722cde96cdd8fe85a82...49c9f9b77bf72aadbcc504c7904f921572f41f18,1,6,9,15,2,2015-01-21 22:04:08,2015-01-21 05:05:47
49c9f9b77bf72aadbcc504c7904f921572f41f18...0b4993ade118d07d130efe1bd7b2047cba0b507f,1,0,1,1,1,2015-01-21 22:04:08,2015-01-21 05:07:59
0b4993ade118d07d130efe1bd7b2047cba0b507f...ffe1353c557d919de81a2a12372448f347825ae2,1,0,1,1,1,2015-01-21 22:04:08,2015-01-21 05:08:45
ffe1353c557d919de81a2a12372448f347825ae2...5b5616d504d70f82ac726d270f0d6773f4a8dc87,1,1,1,2,1,2015-01-21 22:04:09,2015-01-21 05:13:10
5b5616d504d70f82ac726d270f0d6773f4a8dc87...6422b91fea72967e88b9adad42b214836f59c440,1,1,1,2,1,2015-01-21 22:04:09,2015-01-21 05:13:56
6422b91fea72967e88b9adad42b214836f59c440...c28d4a9c423dfb12fa248464f5a087a105b7e731,1,1,1,2,1,2015-01-21 22:04:09,2015-01-21 05:14:27
c28d4a9c423dfb12fa248464f5a087a105b7e731...a7eeda6be31e60e0943dcb3c16dcfe6f65243305,8,10,14,24,10,2015-01-21 22:04:09,2015-01-21 05:29:33
a7eeda6be31e60e0943dcb3c16dcfe6f65243305...363ad4e5b1ca34512cc61348f8d5a2f2c007865e,1,34,2,36,1,2015-01-21 22:04:09,2015-01-21 05:29:57
363ad4e5b1ca34512cc61348f8d5a2f2c007865e...575ce0a83a24975d2df9b756862d5702072703b4,1,4,0,4,1,2015-01-21 22:04:09,2015-01-21 05:36:12
575ce0a83a24975d2df9b756862d5702072703b4...bc65ad641b7ccb0c489694c5f9f018e3009611ed,1,4,4,8,4,2015-01-21 22:04:09,2015-01-21 05:38:31
bc65ad641b7ccb0c489694c5f9f018e3009611ed...d3c13104b670d638805e55fc3b21ff8f626c03aa,3,19,7,26,8,2015-01-21 22:04:09,2015-01-21 05:38:59
d3c13104b670d638805e55fc3b21ff8f626c03aa...2fd76f3e584e1858a4a27ef7b50a96d4db233d1d,1,5,1,6,1,2015-01-21 22:04:09,2015-01-21 05:43:20
2fd76f3e584e1858a4a27ef7b50a96d4db233d1d...5d45bd5da933e873092f15dea134a981c7764a5d,1,1,2,3,1,2015-01-21 22:04:09,2015-01-21 18:59:40
5d45bd5da933e873092f15dea134a981c7764a5d...e91bd2e49c7bf66ca780749218ef30c40117df89,1,0,2,2,2,2015-01-21 22:04:10,2015-01-21 21:41:46
e91bd2e49c7bf66ca780749218ef30c40117df89...35f19a25420cc7fc4fe20ce30273db9c0f53333e,2,2,2,4,2,2015-01-21 22:12:18,2015-01-21 22:12:18
35f19a25420cc7fc4fe20ce30273db9c0f53333e...8d2d031cbc5cb1c31dc765e7b4800044171b3cbd,1,2,2,4,2,2015-01-21 23:07:24,2015-01-21 22:36:59
8d2d031cbc5cb1c31dc765e7b4800044171b3cbd...4fa2aba5b87221725ff2af4f050b4758ff80e112,1,5,1,6,1,2015-01-22 03:16:05,2015-01-22 03:13:57
4fa2aba5b87221725ff2af4f050b4758ff80e112...33ecceee6ee90258ff2871fa53f050e28f18a0b5,1,1,1,2,1,2015-01-22 03:16:11,2015-01-22 03:16:11
33ecceee6ee90258ff2871fa53f050e28f18a0b5...e0d77754d77a7b443a5233cce66d07f0f768f33d,1,1,1,2,1,2015-01-22 03:17:47,2015-01-22 03:17:47
e0d77754d77a7b443a5233cce66d07f0f768f33d...0271352615bd8c9111b3dc2b29bd9f863db67753,1,47,45,92,4,2015-01-22 05:24:40,2015-01-22 05:24:40
0271352615bd8c9111b3dc2b29bd9f863db67753...1ca78dd7c9658607ff21bf1af1ddd145d9eb3da0,3,3,11,14,4,2015-01-22 05:25:01,2015-01-22 05:25:01
1ca78dd7c9658607ff21bf1af1ddd145d9eb3da0...9d31b0e913140b05d716cdc344b8fc96c258a98e,2,2,2,4,2,2015-01-22 05:25:53,2015-01-22 05:25:53
9d31b0e913140b05d716cdc344b8fc96c258a98e...78168b1ef25b2c1d0042c3529898cf32fcba46fb,2,2,2,4,2,2015-01-22 05:30:09,2015-01-22 05:30:09
78168b1ef25b2c1d0042c3529898cf32fcba46fb...3059961704438a50926a2e59df4b1f16e0aed893,2,6,1,7,2,2015-01-22 20:31:44,2015-01-22 20:31:44
3059961704438a50926a2e59df4b1f16e0aed893...07b03c566d673aa7ca55cf2be1d316eb2ccafc93,1,1,1,2,1,2015-01-22 20:35:24,2015-01-22 05:30:09
07b03c566d673aa7ca55cf2be1d316eb2ccafc93...b596de1273da00e8aa13c5c78ae0800336643c77,1,4,4,8,4,2015-01-22 20:35:24,2015-01-22 20:32:38
b596de1273da00e8aa13c5c78ae0800336643c77...ff9825f98519e2d1cce08b563d85468f58f651dc,2,2,2,4,2,2015-01-22 20:35:39,2015-01-22 20:35:39
ff9825f98519e2d1cce08b563d85468f58f651dc...8bbc0f7e742ac252c6cbfa34e703c0bbc5d3ef12,1,2,2,4,1,2015-01-22 20:56:25,2015-01-22 20:56:25
8bbc0f7e742ac252c6cbfa34e703c0bbc5d3ef12...b0723495daefd9fcee329c7c20511d030e7671c4,1,5,12,17,1,2015-01-22 20:58:01,2015-01-22 20:58:01
b0723495daefd9fcee329c7c20511d030e7671c4...39980b38bd477b555d8665b0ce257cd1cede2e77,1,1,1,2,1,2015-01-22 21:01:37,2015-01-22 21:01:37
39980b38bd477b555d8665b0ce257cd1cede2e77...0a76b65386a6669caa8aa7ceaf7ebbbdff7c647c,1,1,1,2,1,2015-01-22 21:42:42,2015-01-22 21:42:42
0a76b65386a6669caa8aa7ceaf7ebbbdff7c647c...cbdaadf14ca00c0aff0a41cebf9bdf22b7834d94,1,1,1,2,1,2015-01-22 21:44:12,2015-01-22 21:44:12
cbdaadf14ca00c0aff0a41cebf9bdf22b7834d94...c0bf6939a015adcd11a5985e8ef10be66d641769,1,1,1,2,1,2015-01-22 21:46:19,2015-01-22 21:46:19
a6dc912afb6dfb9586447f0a22211fe2881e3f0a...253ec1a9d06e36fccb142429d8261759e9a181f8,2,7,4,11,2,2015-01-05 17:51:38,2015-01-05 17:51:38
253ec1a9d06e36fccb142429d8261759e9a181f8...0a0dab917653fe397fbfb26f940820ce40d570a1,1,2,1,3,1,2015-01-05 17:54:41,2015-01-05 17:54:41
0a0dab917653fe397fbfb26f940820ce40d570a1...ddd2fe8e91ed0c5dbf0738922f3fb54336a805f1,4,36,34,70,42,2015-01-05 21:56:47,2015-01-03 03:18:43
ddd2fe8e91ed0c5dbf0738922f3fb54336a805f1...263ca9a69d7d4ff590ec0ff0a01f96956497ddad,1,10,9,19,10,2015-01-05 22:59:54,2015-01-05 22:59:54
263ca9a69d7d4ff590ec0ff0a01f96956497ddad...096df9d62dc9c3d560d31b546365f6bdab5a87dc,9,84,103,187,18,2015-01-05 23:48:32,2015-01-05 23:48:32
096df9d62dc9c3d560d31b546365f6bdab5a87dc...3c1fb598269d0292199bf83ac7c27d9f35f8882a,1,1,1,2,1,2015-01-07 18:59:25,2015-01-07 18:59:25
a6dc912afb6dfb9586447f0a22211fe2881e3f0a...31f364dfff789ffa18a068ecab149979da064a4d,3,61,59,120,7,2015-01-03 05:10:22,2015-01-03 05:10:22
37f32305912e31faa004e1c69a9905c2e363c275...5df8fd059614648864846a1fb949cf2b168a805f,1,1,1,2,1,2015-02-16 22:14:38,2015-02-16 22:14:38
5df8fd059614648864846a1fb949cf2b168a805f...5d175985844f08db926d8e5a43b1f41776bbbd14,4,10,19,29,4,2015-02-16 22:34:54,2015-02-16 22:34:54
5d175985844f08db926d8e5a43b1f41776bbbd14...5bd8d35b6816ec2e64026d0d77b1faa4a1984555,1,0,1,1,1,2015-02-16 23:13:41,2015-02-16 23:13:41
92c6e452cdbe15d4f763951f25f934c795543f5f...b420c8d6511e9420d8d4f756bfba9102c7d9f669,1,1,1,2,1,2015-01-21 01:45:03,2015-01-18 07:33:22
b420c8d6511e9420d8d4f756bfba9102c7d9f669...0cf3dbd3a9121571b367365ead374f26caf4ddab,1,5,3,8,2,2015-01-21 01:45:03,2015-01-21 01:44:55
43037f7c3735009f8dfb36f5340159a762b63e24...ddae20cb4bd1e894cde4d50cfc7f6ea6ad246a61,3,140,5,145,6,2014-12-15 16:17:50,2014-12-12 22:34:49
ddae20cb4bd1e894cde4d50cfc7f6ea6ad246a61...d3a06930a7dde37659360ed6b78d49e17a4cf29c,1,8,5,13,4,2014-12-15 16:54:59,2014-12-15 16:54:59
43037f7c3735009f8dfb36f5340159a762b63e24...29a33fc27f455d07cb307b6e4bcab067eeee1dc6,1,0,6,6,1,2014-12-14 09:04:47,2014-12-14 09:04:47
cfe07d898c17208b5fcf52510612f0c799c80666...d58bb59e482d7f0a854aefd0f657df8b67b51121,1,1,1,2,1,2014-12-18 18:11:44,2014-12-18 18:08:38
d58bb59e482d7f0a854aefd0f657df8b67b51121...8dc1567cc29833a26dbbed65203c6508c872a955,1,6,3,9,1,2014-12-18 18:15:12,2014-12-18 18:15:12
8dc1567cc29833a26dbbed65203c6508c872a955...62561227849e423149f0424e8cc15bf9e75fdd54,3,43,12,55,32,2014-12-18 18:44:24,2014-12-18 18:44:24
62561227849e423149f0424e8cc15bf9e75fdd54...b804b2cd55d0c5f0775fc9ae1d9de76661da02a6,2,2,3,5,2,2014-12-18 18:44:47,2014-12-18 18:44:47
b804b2cd55d0c5f0775fc9ae1d9de76661da02a6...7fb54a952a6b4f17f34aa7985be3e94c4098f5ce,1,0,1,1,1,2014-12-18 18:46:22,2014-12-18 18:46:22
7fb54a952a6b4f17f34aa7985be3e94c4098f5ce...28ae4d48c27673cac6154763fbef0e3c45d5454d,1,1,1,2,1,2014-12-18 18:46:44,2014-12-18 16:20:44
28ae4d48c27673cac6154763fbef0e3c45d5454d...c49e7f97a1594893ee779e14118f29ea5e79667e,1,1,1,2,1,2014-12-18 18:47:14,2014-12-18 18:47:14
c49e7f97a1594893ee779e14118f29ea5e79667e...589dbbabcbe53a2d8bbaa1a31e415ad45fdea958,1,1,1,2,1,2014-12-18 23:09:05,2014-12-18 23:09:05
589dbbabcbe53a2d8bbaa1a31e415ad45fdea958...7633de6efd63e04d9f760847aebf26cd3b2ff3e5,1,1,1,2,1,2014-12-19 00:11:23,2014-12-19 00:11:23
7633de6efd63e04d9f760847aebf26cd3b2ff3e5...533ff573ceee54743a4e6776be4e8a0e08a21ca5,1,2,2,4,1,2014-12-19 01:32:34,2014-12-19 01:32:34
533ff573ceee54743a4e6776be4e8a0e08a21ca5...3556010f5188fc1d2222d95dc8a9acf2f5253de2,1,2,2,4,2,2014-12-19 01:40:34,2014-12-19 01:40:34
3556010f5188fc1d2222d95dc8a9acf2f5253de2...49319507e91a2ba55b2b26eea2011f544fd67154,1,98,0,98,3,2014-12-19 02:12:41,2014-12-19 02:12:29
cfe07d898c17208b5fcf52510612f0c799c80666...67e510dd646faa3c70a9237a733444502dad0efc,1,1,1,2,1,2014-12-18 16:20:44,2014-12-18 16:20:44
5be23f5c67d85422335a3204ffd1b7aafd2ecd1a...f00519d43931074b3039f0b55210031699721b0a,1,2,1,3,1,2014-11-12 04:01:30,2014-11-12 04:01:30
f00519d43931074b3039f0b55210031699721b0a...b6456eeb4191cac4e9509cf33e05bca30db559e2,1,2,0,2,1,2014-11-12 04:02:52,2014-11-12 04:02:52
b6456eeb4191cac4e9509cf33e05bca30db559e2...aa37a240e95b6aa4741b5cfd4224390eb7cb5e6c,1,3,1,4,1,2014-11-12 19:45:11,2014-11-12 19:45:11
aa37a240e95b6aa4741b5cfd4224390eb7cb5e6c...660a8a33fdf7ad71aff451895ff875c31645c695,3,5,2,7,4,2014-11-12 20:02:26,2014-11-12 20:02:26
660a8a33fdf7ad71aff451895ff875c31645c695...6090e1aaec0e5adc1c425430503b6f8d7c3c611b,3,7,2,9,4,2014-11-12 20:17:27,2014-11-12 20:17:27
6090e1aaec0e5adc1c425430503b6f8d7c3c611b...eb54733a4afeeffa36f3721cdec6486d9bf5cff1,1,21,2,23,2,2014-11-12 21:49:53,2014-11-12 21:49:53
30fb11f1fa0227f1c0ec3eb30b7864ea3b2d210e...b1c0c5ef2e12a17eed88d935115d5ad3cc8d3614,1,39,0,39,1,2014-11-11 18:23:20,2014-11-07 22:32:03
b1c0c5ef2e12a17eed88d935115d5ad3cc8d3614...2a8e2c0dcc86caf89e2964315fade2500a5044f7,1,75,30,105,8,2014-11-11 18:23:21,2014-11-11 00:40:30
2a8e2c0dcc86caf89e2964315fade2500a5044f7...241facfa8d23b9fb906e0d11b55c9a5498d9e7c4,1,19,12,31,9,2014-11-11 18:23:21,2014-11-11 01:21:51
241facfa8d23b9fb906e0d11b55c9a5498d9e7c4...8bb504746ede291937b34278b1d1e5a3788f6a2f,1,3,0,3,1,2014-11-11 18:23:22,2014-11-11 01:47:08
8bb504746ede291937b34278b1d1e5a3788f6a2f...62001502048fd735787f2a2570af6a518d1cc8bd,2,35,19,54,15,2014-11-11 18:23:33,2014-11-11 18:19:20
62001502048fd735787f2a2570af6a518d1cc8bd...3914c044e32c00b5aea1429ab54b6acf6fbf78a0,1,347,1,348,1,2014-11-11 18:31:01,2014-11-11 18:31:01
3914c044e32c00b5aea1429ab54b6acf6fbf78a0...5033c4dc8cab303f0d92837b3c3bbe11a110c9ee,6,13,7,20,8,2014-11-11 18:50:43,2014-11-11 18:50:43
30fb11f1fa0227f1c0ec3eb30b7864ea3b2d210e...371a21d5bc456d618ec8f18ee28c9b597735cec0,3,4,40,44,3,2014-10-31 04:34:54,2014-10-31 04:34:54
371a21d5bc456d618ec8f18ee28c9b597735cec0...ca33c4111aacacddb53f7ea8b0566a7dab12280c,2,0,34,34,3,2014-10-31 04:38:58,2014-10-31 04:38:58
ca33c4111aacacddb53f7ea8b0566a7dab12280c...b5d2cce30887290ddb883af87fa2fe9fd5d032ad,9,235,334,569,97,2014-10-31 05:43:13,2014-10-31 05:43:13
b5d2cce30887290ddb883af87fa2fe9fd5d032ad...44832cbbdcfb1e5753f24edc55218f4fd3c467c1,13,48,9,57,35,2014-11-02 10:45:17,2014-11-02 10:44:19
44832cbbdcfb1e5753f24edc55218f4fd3c467c1...cc821809252c773860a1e3c803698b637fb8506c,2,3,0,3,3,2014-11-02 11:28:37,2014-11-02 11:28:37
cc821809252c773860a1e3c803698b637fb8506c...50e6d3143db8fc6e1fc3fb74da74b40c8dc7f3a4,2,5,1,6,5,2014-11-04 01:38:26,2014-11-04 01:38:26
50e6d3143db8fc6e1fc3fb74da74b40c8dc7f3a4...2964c68fcb2da6beb92bea0181fb261792b04a49,1,1,1,2,1,2014-11-04 18:31:24,2014-11-04 18:29:16
2964c68fcb2da6beb92bea0181fb261792b04a49...90caf16ee7c1382804f05d7a862c5647a4c0a1a8,1,2,3,5,3,2014-11-04 18:40:50,2014-11-04 18:40:50
90caf16ee7c1382804f05d7a862c5647a4c0a1a8...831ca7d20c485019420d57308c62ca8960e9aa8e,3,4,64,68,9,2014-11-04 18:47:34,2014-11-04 18:47:34
7963a84807664bb146f2f8aff36fbaf21efa2906...b824a155a5a535bd36008c5228f08163baad218e,1,12,7,19,1,2014-10-16 17:47:01,2014-10-16 17:47:01
b824a155a5a535bd36008c5228f08163baad218e...dcaefabc6c336e18b19f90de77a00fe4616b175a,3,68,57,125,21,2014-10-16 20:25:55,2014-10-16 19:31:59
da3cf01947da001052b9060c0a83501e943632d3...87bd6f87d59de9a0214d4dc9d66d7ad1b71e22d2,1,0,7,7,1,2014-10-06 18:59:34,2014-10-06 18:56:56
53a844770fb83a00a3129c76b9ac1b44230a1ba2...1ff35e49fb7bfb78cb47b1eb5f213ba70ab09626,2,9,1,10,3,2014-08-22 02:37:05,2014-08-22 02:37:05
1ff35e49fb7bfb78cb47b1eb5f213ba70ab09626...1843ba0cd688f707dc63a423cabfcf37ffe85966,1,1,1,2,1,2014-08-22 02:37:23,2014-08-22 02:37:23
1843ba0cd688f707dc63a423cabfcf37ffe85966...a4c5009cea21ebaba4565b4db98460ade2dbd891,1,6,4,10,3,2014-08-22 02:43:54,2014-08-22 02:43:54
a4c5009cea21ebaba4565b4db98460ade2dbd891...55d1901729219367a643ccc89a6e9635da880fe1,2,2,28,30,8,2014-08-22 06:20:17,2014-08-22 06:20:17
55d1901729219367a643ccc89a6e9635da880fe1...ff63e4fdb6c556f537496037c4c08674ee4503c5,3,3,3,6,3,2014-08-22 09:15:03,2014-08-22 09:15:03
ff63e4fdb6c556f537496037c4c08674ee4503c5...1ff2c3bae988efe78ce0ac10693399ca731fc77a,1,7,4,11,2,2014-08-22 19:41:16,2014-08-22 19:38:30
d1331e9c7a4acf94cf536e6947e02444f10652b1...ca7a6929d74c4a4b05961dbbcfce4f522ddc15e4,9,180,7,187,16,2014-02-04 09:08:36,2014-01-24 18:14:31
ca7a6929d74c4a4b05961dbbcfce4f522ddc15e4...09029be91729203446e9605854b4f29e742ca6fc,4,29,88,117,8,2014-02-04 09:08:36,2014-01-27 23:23:04
09029be91729203446e9605854b4f29e742ca6fc...46e74103831485dbf82f27038ea66368beb0f554,2,9,10,19,3,2014-02-04 09:28:36,2014-02-04 09:28:36
46e74103831485dbf82f27038ea66368beb0f554...4aae3c1bfefb7104111717bd3dd6e6b424ae78f1,1,3,0,3,1,2014-02-04 09:32:17,2014-02-04 09:32:17
ca164d477dd364dd835c13f0b630ef04c126e54d...23b75a20b1fe07790c8760b00ca4d7eacae2b51e,1,3,7,10,3,2014-02-06 06:21:44,2014-02-06 06:21:44
23b75a20b1fe07790c8760b00ca4d7eacae2b51e...59c3b468a76a13527bb5eb8553b0e5e3017afbbf,1,1,1,2,1,2014-02-07 19:41:28,2014-02-06 01:03:11
84917c9fa90ba6ed816d45f34707c69e31d9698d...df3230c1b3f29f7a8db045effe63d2e15ddaafd4,16,892,268,1160,84,2014-02-05 22:40:20,2014-02-05 22:22:15
c5c9e2e9b2743fd6fcd2508c3dc39769023d49ae...056fce508d99e5bc96984ba5b5b3c810e57c9fae,1,0,2,2,2,2015-03-03 22:00:00,2015-03-01 16:20:16
056fce508d99e5bc96984ba5b5b3c810e57c9fae...7d9afa31b725dec4560deaf9f10420ccab29f89d,3,21,0,21,3,2015-03-10 22:27:01,2015-03-06 03:26:17
e2b78cfd0b63c709ec81ea0e07655df8d9655b51...f146489c271aabdb9d7ccb01707682dae08146cf,2,14,5,19,11,2015-01-21 20:26:51,2015-01-21 20:26:51
f146489c271aabdb9d7ccb01707682dae08146cf...7576e0f3f60b7e9f33c9b95fdea58e43f2e9f92b,1,3,0,3,1,2015-01-22 04:11:22,2015-01-22 04:11:22
e2b78cfd0b63c709ec81ea0e07655df8d9655b51...fae2ef8d4b0339435cdccd58a4aa85b02a85b75d,3,235,0,235,3,2015-01-21 19:56:19,2014-12-22 03:34:58
fae2ef8d4b0339435cdccd58a4aa85b02a85b75d...4f983b15a17f0499fc497d23edfb8dd6a6972ddf,2,7,3,10,2,2015-01-21 19:56:20,2014-12-22 03:37:33
4f983b15a17f0499fc497d23edfb8dd6a6972ddf...2d660ab92a79bc285c184a4304545eb517e5bdbb,2,107,12,119,19,2015-01-21 19:56:20,2014-12-22 18:30:04
2d660ab92a79bc285c184a4304545eb517e5bdbb...6e28db2c9736c73227254788ac742fbcaf709afb,2,79,20,99,8,2015-01-21 19:56:20,2014-12-22 19:15:44
6e28db2c9736c73227254788ac742fbcaf709afb...6b2c9ef3d7b2d91da2be71b0a7cbcd3c6c3b2c12,1,28,0,28,3,2015-01-21 19:56:20,2014-12-22 19:52:39
6b2c9ef3d7b2d91da2be71b0a7cbcd3c6c3b2c12...fb43b2915463cb20aca1474d8224e1f5d46d110b,2,162,66,228,28,2015-01-21 19:56:20,2014-12-23 01:59:01
fb43b2915463cb20aca1474d8224e1f5d46d110b...66d07d40af1c12147df4c119d39d763591da2438,2,217,73,290,30,2015-01-21 19:56:20,2014-12-23 03:17:14
66d07d40af1c12147df4c119d39d763591da2438...0721dfadd2f6ae3348e7bc06bfbf91f0f2236e2e,2,18,18,36,14,2015-01-21 19:56:20,2014-12-23 03:26:49
0721dfadd2f6ae3348e7bc06bfbf91f0f2236e2e...5d48ec24878a8db9b0628ab86404ca7fa328dc3b,2,35,24,59,17,2015-01-21 19:56:21,2014-12-23 06:08:10
5d48ec24878a8db9b0628ab86404ca7fa328dc3b...3281ac7d9e86fbcfb51cfc985c18249ffed81ac7,2,146,53,199,14,2015-01-21 19:56:21,2014-12-23 22:32:46
3281ac7d9e86fbcfb51cfc985c18249ffed81ac7...6755bdaed3c2c3b268d3748f7e43681a71a58f71,2,101,4,105,6,2015-01-21 19:56:21,2014-12-23 23:16:42
6755bdaed3c2c3b268d3748f7e43681a71a58f71...aad244be7a84965da49ee4061cfc8634dfe4064e,2,72,10,82,4,2015-01-21 19:56:21,2014-12-24 20:20:17
aad244be7a84965da49ee4061cfc8634dfe4064e...1f930713cc8ba37cdfa3c347e61d6607432ed49c,2,168,110,278,31,2015-01-21 19:56:21,2014-12-26 13:41:19
1f930713cc8ba37cdfa3c347e61d6607432ed49c...fdd4d22c8dd65e4115628a14561bcd6dd28c812f,1,12,31,43,10,2015-01-21 19:56:21,2014-12-26 13:48:38
fdd4d22c8dd65e4115628a14561bcd6dd28c812f...f31f9c7bcb89e5511b3e2fbc144ad451c2ef85b2,2,97,4,101,6,2015-01-21 19:56:22,2014-12-26 14:26:31
f31f9c7bcb89e5511b3e2fbc144ad451c2ef85b2...b6ffa2b8086b9c51aff2115819e0dc89ba43b69c,1,40,38,78,20,2015-01-21 19:56:22,2014-12-26 17:23:43
b6ffa2b8086b9c51aff2115819e0dc89ba43b69c...0da6748f5a1321e9e895cc837e4e58b83b8d87b1,1,38,25,63,10,2015-01-21 19:56:22,2014-12-26 19:16:55
0da6748f5a1321e9e895cc837e4e58b83b8d87b1...9e55f9f7dc7aa1bdc35e65e21e651012208d7c9f,2,54,35,89,12,2015-01-21 19:56:22,2014-12-27 01:02:38
9e55f9f7dc7aa1bdc35e65e21e651012208d7c9f...08978834138b1e3220ea1f0068a08e054885a151,2,123,51,174,10,2015-01-21 19:56:22,2014-12-27 17:02:38
08978834138b1e3220ea1f0068a08e054885a151...7e826a33946b9eeaced69b80bd9bfeac0eeadd37,1,23,1,24,1,2015-01-21 19:56:22,2014-12-27 17:46:34
7e826a33946b9eeaced69b80bd9bfeac0eeadd37...fd8eb4028b6a760a2f4aecdedf568a91dff01774,1,15,0,15,1,2015-01-21 19:56:23,2014-12-27 18:23:44
fd8eb4028b6a760a2f4aecdedf568a91dff01774...3c5ec3767e95db0aa38576d57927b210e0d990c9,2,77,0,77,2,2015-01-21 19:56:23,2014-12-27 18:44:45
3c5ec3767e95db0aa38576d57927b210e0d990c9...110222323be7ef6b64df9d33fbac72536aa5d5bf,2,66,0,66,2,2015-01-21 19:56:23,2014-12-27 19:25:34
110222323be7ef6b64df9d33fbac72536aa5d5bf...6e6a5b0ab66d4a1624ca71bbe60abeb2b88a3143,2,264,0,264,2,2015-01-21 19:56:23,2014-12-27 23:07:34
6e6a5b0ab66d4a1624ca71bbe60abeb2b88a3143...50fda15c99fd405c05c62128e3c4558a1c3f8c30,2,206,3,209,5,2015-01-21 19:56:23,2014-12-28 00:28:54
50fda15c99fd405c05c62128e3c4558a1c3f8c30...bf218213f408d0b6f5982c3f6ea37c3aaf190ec2,2,126,0,126,2,2015-01-21 19:56:23,2014-12-28 04:32:41
bf218213f408d0b6f5982c3f6ea37c3aaf190ec2...212c4811f13f534519e1f4bc1ca1cd82db659c2a,2,194,0,194,2,2015-01-21 19:56:24,2014-12-29 19:57:46
212c4811f13f534519e1f4bc1ca1cd82db659c2a...aea2f86abe7e75bed59a754854ded2d947502ab2,4,17808,1,17809,4,2015-01-21 19:56:24,2015-01-02 17:06:18
aea2f86abe7e75bed59a754854ded2d947502ab2...881d5702e1d67ba7a4915ea8a9191f95995ea8d5,3,172,136,308,48,2015-01-21 19:56:24,2015-01-04 15:40:25
881d5702e1d67ba7a4915ea8a9191f95995ea8d5...a8a7902ad2275cae61124247e8aa19359a4704a3,2,73,0,73,3,2015-01-21 19:56:24,2015-01-05 03:18:22
a8a7902ad2275cae61124247e8aa19359a4704a3...12dab04277b14a24be9b6ceec077a864a6d541d4,4,448,176,624,37,2015-01-21 19:56:24,2015-01-06 00:32:12
12dab04277b14a24be9b6ceec077a864a6d541d4...f48e042a9e9daac2c8fde0ae4478b4214c2b198e,3,205,17828,18033,20,2015-01-21 19:56:25,2015-01-06 01:19:07
f48e042a9e9daac2c8fde0ae4478b4214c2b198e...a8268b659a956de6389648c8d53a62ffaedf851f,3,476,78,554,62,2015-01-21 19:56:25,2015-01-06 05:34:26
a8268b659a956de6389648c8d53a62ffaedf851f...7450ac3de954a6cdce8dffdea954f31175ade988,1,37,0,37,1,2015-01-21 19:56:25,2015-01-06 19:50:15
7450ac3de954a6cdce8dffdea954f31175ade988...2491ffd9aaddd79d137c6279b770e2929616ae3e,3,62,20,82,5,2015-01-21 19:56:25,2015-01-06 23:12:06
2491ffd9aaddd79d137c6279b770e2929616ae3e...402eab798308293b5d3d848873f9256abd52a61a,3,88,70,158,5,2015-01-22 00:03:44,2015-01-21 23:22:59
402eab798308293b5d3d848873f9256abd52a61a...a6aadfc3a5cc353305b1aa54592d999129de79e3,4,131,14,145,6,2015-01-22 01:14:12,2015-01-22 01:14:12
a6aadfc3a5cc353305b1aa54592d999129de79e3...68ca4da28329bda31c83b7a48d737ad6c152702f,2,31,15,46,15,2015-01-27 00:14:11,2015-01-27 00:14:11
68ca4da28329bda31c83b7a48d737ad6c152702f...43f33723a5797559ebe74697fb1d74a89e7c1fc0,1,50,1,51,2,2015-01-27 00:36:22,2015-01-27 00:36:22
43f33723a5797559ebe74697fb1d74a89e7c1fc0...d1cefb2c9bbc29e61797e9027229dc5cf559953c,1,11,1,12,1,2015-01-28 22:18:21,2015-01-28 22:18:21
d1cefb2c9bbc29e61797e9027229dc5cf559953c...a04fbe89d05aae82423ee45e7eb9bd31ff5a5e59,3,19,4,23,6,2015-01-28 22:31:36,2015-01-28 22:31:09
a04fbe89d05aae82423ee45e7eb9bd31ff5a5e59...3b2e1b7ab6797e3e345f768500f40eb6cf837d60,3,18,1,19,4,2015-01-28 23:29:40,2015-01-28 23:29:40
3b2e1b7ab6797e3e345f768500f40eb6cf837d60...a3b71cb5813105ca087416805804f14cfa61fb29,1,16,4,20,4,2015-01-28 23:30:26,2015-01-28 23:30:26
a3b71cb5813105ca087416805804f14cfa61fb29...712856b34981c790778a9affc90fb0825c5acd16,1,44,11,55,10,2015-01-28 23:42:50,2015-01-28 23:42:50
712856b34981c790778a9affc90fb0825c5acd16...2de487f6318ed3ed3f0a5924b0d9d9f86b0be9a2,2,139,118,257,23,2015-01-28 23:54:51,2015-01-28 23:54:51
2de487f6318ed3ed3f0a5924b0d9d9f86b0be9a2...ff4398fe1c16048ef2c82a574eda68e85ba87a03,7,651,225,876,16,2015-01-31 00:45:28,2015-01-31 00:45:28
ff4398fe1c16048ef2c82a574eda68e85ba87a03...719cd68f39a1d22cec0e2ed8dba3e64f5b927f3d,1,8,5,13,4,2015-01-31 01:13:14,2015-01-31 01:10:37
719cd68f39a1d22cec0e2ed8dba3e64f5b927f3d...a4d57d868e26cfe5d32e7b9ecf7ed0112d3be9cf,1,1,4,5,1,2015-01-31 01:16:19,2015-01-31 01:16:19
a4d57d868e26cfe5d32e7b9ecf7ed0112d3be9cf...6aa157ab06eac47a4f2f632766a51116860fddac,1,24,4,28,3,2015-01-31 01:47:18,2015-01-31 01:47:18
6aa157ab06eac47a4f2f632766a51116860fddac...8a8c7d6cabd3f8851a7b493716af7f19eb0bbf05,2,22,1,23,2,2015-01-31 01:55:15,2015-01-31 01:55:15
8a8c7d6cabd3f8851a7b493716af7f19eb0bbf05...3b41f812f815e03763b36eceaef910a4cc684f4b,1,8,4,12,4,2015-02-01 16:06:24,2015-02-01 16:06:00
3b41f812f815e03763b36eceaef910a4cc684f4b...296542138eb5d0ff2c307d6fa6013b2fb96a1f27,3,213,91,304,9,2015-02-01 16:06:25,2015-02-01 16:02:42
c0bf6939a015adcd11a5985e8ef10be66d641769...f428b55e20884949ae889c22b75f8ce253365a07,2,4,416,420,2,2015-01-23 00:12:07,2015-01-22 23:59:07
f428b55e20884949ae889c22b75f8ce253365a07...07fa40f20e280aa015659c4223e73e88cbe8bace,1,1,1,2,1,2015-01-27 19:35:04,2015-01-27 19:35:04
c0bf6939a015adcd11a5985e8ef10be66d641769...fc0cf0ac685d8a5b0d14a928c46c4f8664720c42,1,1,414,415,1,2015-01-22 23:59:07,2015-01-22 23:59:07
3c1fb598269d0292199bf83ac7c27d9f35f8882a...2ba39ce96aa45461bb473d4b0780169169e37ae1,1,1,1,2,1,2015-01-07 19:42:53,2015-01-07 19:42:53
2ba39ce96aa45461bb473d4b0780169169e37ae1...77ca0fe524668e8b2604573f870dee17a7426c62,1,7,10,17,5,2015-01-07 23:14:35,2015-01-07 23:14:35
77ca0fe524668e8b2604573f870dee17a7426c62...259f90bc5a1593677fa4f6a6ac49599c1170127d,7,1324,98,1422,25,2015-01-07 23:17:30,2015-01-07 23:16:29
259f90bc5a1593677fa4f6a6ac49599c1170127d...9b6087a099784dcb9fdd96b14ae1f0853df174b5,1,7,0,7,1,2015-01-07 23:40:38,2015-01-07 23:40:38
9b6087a099784dcb9fdd96b14ae1f0853df174b5...a559d708ab346d097a23f1e59b4e5d3e089fadfb,3,6,19,25,8,2015-01-07 23:52:06,2015-01-07 23:52:06
a559d708ab346d097a23f1e59b4e5d3e089fadfb...e072382438521813e5b61aa08116500bf85a73b1,2,3,3,6,3,2015-01-08 00:15:10,2015-01-08 00:15:10
e072382438521813e5b61aa08116500bf85a73b1...6f7636b4e6f71eef38760f44832e520ed5b00ecb,1,4,0,4,1,2015-01-08 01:07:41,2015-01-08 01:03:32
6f7636b4e6f71eef38760f44832e520ed5b00ecb...0b996ea9076f6caf3a60c2708b67efd63b2bc361,1,5,2,7,1,2015-01-08 01:10:13,2015-01-08 01:10:13
0b996ea9076f6caf3a60c2708b67efd63b2bc361...0daffe9bd8d5754b969974100b9bb535ad0bc5ca,1,0,5,5,1,2015-01-08 01:14:01,2015-01-08 01:14:01
0daffe9bd8d5754b969974100b9bb535ad0bc5ca...b1995fce130aff8ec6c72ddb170a9213fb5f8158,1,2,2,4,1,2015-01-08 03:04:54,2015-01-08 01:50:37
b1995fce130aff8ec6c72ddb170a9213fb5f8158...08e1b78e5822f4c97ca7b3a391c83905bab08840,1,4,0,4,1,2015-01-08 03:04:55,2015-01-08 01:51:09
08e1b78e5822f4c97ca7b3a391c83905bab08840...184ab3bde129b995d9b6825dbffc86dca23f9b18,4,125,58,183,22,2015-01-08 03:04:55,2015-01-08 02:00:17
184ab3bde129b995d9b6825dbffc86dca23f9b18...ed5fd8e6cf7a56eb67d7c1600e83775cfd326a9e,4,40,29,69,10,2015-01-08 03:04:55,2015-01-08 03:04:05
ed5fd8e6cf7a56eb67d7c1600e83775cfd326a9e...f9e22884dee710cfd83913a2e321e8d60a3416c4,1,1,1,2,1,2015-01-08 03:05:50,2015-01-08 03:05:50
f9e22884dee710cfd83913a2e321e8d60a3416c4...f51afe18f0f6b7c1ad88429b4b26c4935259c1f8,2,28,14,42,8,2015-01-08 03:27:09,2015-01-08 03:27:09
f51afe18f0f6b7c1ad88429b4b26c4935259c1f8...e885e783482b58ff28820a4d45a4522fbf77d4e9,8,148,108,256,32,2015-01-08 04:10:44,2015-01-08 04:10:44
e885e783482b58ff28820a4d45a4522fbf77d4e9...c99bad804b49f71172a5d023ad117b2a54e6e2e6,2,12,2,14,2,2015-01-08 04:14:42,2015-01-08 04:14:42
c99bad804b49f71172a5d023ad117b2a54e6e2e6...67bea9c102a88df2224341bab056cb8ce4a67f96,4,42,8,50,11,2015-01-08 20:08:13,2015-01-06 00:56:10
67bea9c102a88df2224341bab056cb8ce4a67f96...f61ada859df66c32e187dcf958b98ccee4f66d50,3,61,59,120,7,2015-01-08 20:28:25,2015-01-03 05:10:22
f61ada859df66c32e187dcf958b98ccee4f66d50...eb084ae60fb5fb8fd82e14fc82ac38954b672680,1,1,1,2,1,2015-01-08 21:38:17,2015-01-08 18:47:37
eb084ae60fb5fb8fd82e14fc82ac38954b672680...fe8a661e2f9e01a05ef6e72f7f892e3575c908bd,2,45,7,52,8,2015-01-08 21:38:17,2015-01-08 21:37:52
fe8a661e2f9e01a05ef6e72f7f892e3575c908bd...10698d5940afa3bf74d8f187300015333bfaa2a0,2,17,0,17,2,2015-01-08 21:46:59,2015-01-08 21:46:59
3c1fb598269d0292199bf83ac7c27d9f35f8882a...9c4c9817a013ae5acf332fd3fc5c7e34c8d71764,4,42,8,50,11,2015-01-07 19:15:33,2015-01-06 00:56:10
8e92b1173e74242e6eb8b85d0cb7df25ca3e4837...4a8e5fde080a20e6abc92823e2afed93f8f01d91,4,4,4,8,4,2015-02-16 23:25:25,2015-02-16 23:24:08
4a8e5fde080a20e6abc92823e2afed93f8f01d91...fb528874b3c8b330900b1a719791b8b8667d3cb7,1,1,2,3,2,2015-02-16 23:39:18,2015-02-16 23:39:18
fb528874b3c8b330900b1a719791b8b8667d3cb7...619642b55644bfa5fc1f7cfd8f017683c0a1feb6,1,4,4,8,2,2015-02-17 17:22:48,2015-02-14 04:40:44
619642b55644bfa5fc1f7cfd8f017683c0a1feb6...5efa6da74a72237f3d458660103bfade47145954,1,1,1,2,1,2015-02-17 17:25:18,2015-02-17 17:25:18
5efa6da74a72237f3d458660103bfade47145954...414b5e2206979c8fd030e64f7b53c84a7e7c90e9,1,1,1,2,1,2015-02-17 22:15:33,2015-02-17 22:15:10
414b5e2206979c8fd030e64f7b53c84a7e7c90e9...d48cbed92e4114279430de7bf51cfff72490b21d,1,2,0,2,1,2015-02-18 00:04:08,2015-02-18 00:04:08
d48cbed92e4114279430de7bf51cfff72490b21d...4a07d83f7d993f0a63f0beae2f8985e08398f9ee,1,1,0,1,1,2015-02-18 00:09:35,2015-02-18 00:09:35
4a07d83f7d993f0a63f0beae2f8985e08398f9ee...94683896b74869c12c5ebf11e09330619b749a9b,3,35,23,58,6,2015-02-18 00:36:39,2015-02-18 00:34:43
d3a06930a7dde37659360ed6b78d49e17a4cf29c...e7167e5257fc152af4723c051c53dec44a421dc5,53,949,839,1788,619,2014-12-15 23:32:06,2014-12-10 00:42:37
e7167e5257fc152af4723c051c53dec44a421dc5...a2e62e23b51988512e8b501f80b810ac4fb74699,1,3,0,3,2,2014-12-15 23:32:06,2014-12-15 23:20:40
a2e62e23b51988512e8b501f80b810ac4fb74699...d0aaa93519523acf4afd616a6a16a6f7a60a9a91,1,4,5,9,4,2014-12-15 23:57:05,2014-12-15 23:57:05
d0aaa93519523acf4afd616a6a16a6f7a60a9a91...e3636087bdee2a72565fb9efae5ee25260032231,1,12,11,23,8,2014-12-16 00:28:17,2014-12-16 00:27:04
6fba33b870b597975df30791594ebee62cffc2d8...b76801bf5e8349026fc1d3b4490a595213f74ffb,1,1,1,2,1,2014-12-19 08:20:02,2014-12-19 08:20:02
b76801bf5e8349026fc1d3b4490a595213f74ffb...e3b5a5f3ef90d3bab2317769dd93803b2c8bbb08,1,1,1,2,1,2014-12-19 18:15:30,2014-12-19 18:15:30
e3b5a5f3ef90d3bab2317769dd93803b2c8bbb08...6b204ca73afd48eab1b9c549f3c2d04c7328ce3f,122,122,122,244,122,2014-12-19 18:31:59,2014-12-19 18:31:59
6b204ca73afd48eab1b9c549f3c2d04c7328ce3f...8722ac60636828eb5739fa5d9378cecb0c443aaf,1,1,1,2,1,2014-12-19 18:32:31,2014-12-19 18:32:31
ed1e3f042018769940097e764563a270add4543e...40c645e48cbf3fc78d28d9ef3d78b95c0457ceee,3,6,7,13,7,2014-11-13 04:09:17,2014-11-13 04:09:17
40c645e48cbf3fc78d28d9ef3d78b95c0457ceee...e6b6a63e7419732c25feab4de2d256b17162bec1,2,5,3,8,4,2014-11-13 04:16:45,2014-11-13 04:16:45
e6b6a63e7419732c25feab4de2d256b17162bec1...127d3757a6748b87d82dc2fa14c500fcdb5e09f0,1,12,9,21,5,2014-11-13 05:54:47,2014-11-13 05:54:47
127d3757a6748b87d82dc2fa14c500fcdb5e09f0...4c378c9bf88d97d4547aa4b09ec98a4861d40e34,1,3,3,6,3,2014-11-13 05:55:30,2014-11-13 05:54:55
4c378c9bf88d97d4547aa4b09ec98a4861d40e34...d48cb6ee7cd0a7012ad90b14e3b8a6d191e68f12,3,14,4,18,5,2014-11-13 05:56:45,2014-11-13 05:56:26
d48cb6ee7cd0a7012ad90b14e3b8a6d191e68f12...8e96b957b058505823efd6d1ba19e779c4ead7bf,4,15,9,24,10,2014-11-13 06:28:10,2014-11-13 06:28:10
8e96b957b058505823efd6d1ba19e779c4ead7bf...3113acc73894991af2f3988ce14416af9ba24566,1,1,3,4,1,2014-11-13 20:34:32,2014-11-13 20:34:32
3113acc73894991af2f3988ce14416af9ba24566...c41413ba4ff85914d3b11810dae9f8397da2cdf6,1,2,1,3,1,2014-11-13 21:49:42,2014-11-13 21:49:42
c41413ba4ff85914d3b11810dae9f8397da2cdf6...d169680be596d29086c57032193c19a471c701f8,1,2,0,2,1,2014-11-13 21:50:27,2014-11-13 21:50:27
d169680be596d29086c57032193c19a471c701f8...47bf9f05d7219be1718b3ec80cfe19fa39181e9c,1,1,1,2,1,2014-11-13 23:57:12,2014-11-13 23:57:12
47bf9f05d7219be1718b3ec80cfe19fa39181e9c...d32b62576628bfaf75e10d8676493c30d6517a60,1,8,3,11,3,2014-11-14 00:39:54,2014-11-13 21:48:50
d32b62576628bfaf75e10d8676493c30d6517a60...7aefc3aaf0bd38e796a6f895b6e4337286bfe0ad,2,27,11,38,13,2014-11-14 00:39:56,2014-11-14 00:38:47
7aefc3aaf0bd38e796a6f895b6e4337286bfe0ad...ed1fe2f02764444d462904b630fab7d0a3e8030e,1,2,2,4,2,2014-11-14 01:39:54,2014-11-14 01:38:46
ed1fe2f02764444d462904b630fab7d0a3e8030e...bcfb83fb5e605a0d196f0d66fb1e5d36371ef194,2,2,2,4,2,2014-11-14 01:50:01,2014-11-14 01:49:33
831ca7d20c485019420d57308c62ca8960e9aa8e...e8430465e4e178d7b7a2ee080b8838a8460732fc,3,365,2,367,5,2014-11-06 04:07:05,2014-11-06 04:07:05
e8430465e4e178d7b7a2ee080b8838a8460732fc...5fc738ccbfb03904a9dc4d9c931e8eacc314fbc3,1,1,1,2,1,2014-11-06 04:09:00,2014-11-06 04:09:00
5fc738ccbfb03904a9dc4d9c931e8eacc314fbc3...a126b429fc948496fbb7e1a70bb72ddfd47b0daf,1,25,1,26,21,2014-11-06 04:28:57,2014-11-06 04:28:57
a126b429fc948496fbb7e1a70bb72ddfd47b0daf...57370435c2331407d4a4e48099e1132750a3211e,3,23,2,25,3,2014-11-08 00:36:27,2014-11-08 00:36:27
57370435c2331407d4a4e48099e1132750a3211e...3719494af310df55bbb69058cef0f80710615aba,2,5,1,6,2,2014-11-09 04:11:01,2014-11-09 04:06:07
3719494af310df55bbb69058cef0f80710615aba...1094c62e329e1ba0eacf546b1af4ca96e6c9ac01,3,9,63,72,9,2014-11-14 21:00:23,2014-11-14 21:00:23
831ca7d20c485019420d57308c62ca8960e9aa8e...00d6682e2347128cb4e5db94f40a7a1cfd43113f,1,2,2,4,2,2014-11-05 00:21:55,2014-11-05 00:21:55
00d6682e2347128cb4e5db94f40a7a1cfd43113f...6fbf762f8d584bf6135377fcf33bfec065c165fe,1,2,2,4,2,2014-11-05 00:33:08,2014-11-05 00:33:08
6fbf762f8d584bf6135377fcf33bfec065c165fe...1a2249d159a84ab190e105e3004cbe33a74b7cb2,5,56,81,137,18,2014-11-05 00:43:38,2014-11-05 00:43:38
1a2249d159a84ab190e105e3004cbe33a74b7cb2...fb4655dbeaaba8fead582784c5a91f94f9cc1888,1,4,6,10,2,2014-11-05 01:13:27,2014-11-05 01:13:27
fb4655dbeaaba8fead582784c5a91f94f9cc1888...5e1086775d1b92857416fa2b7c2e97da1659fa09,5,30,70,100,17,2014-11-05 01:34:54,2014-11-05 01:34:07
5e1086775d1b92857416fa2b7c2e97da1659fa09...4b2d0d5174e7802d57d67c530de0ff2b734c0986,1,10,10,20,6,2014-11-05 19:30:14,2014-11-05 19:30:14
4b2d0d5174e7802d57d67c530de0ff2b734c0986...02637a10ef16b209db8a63b3ea5924945ddfc2bc,1,0,2,2,1,2014-11-05 20:04:30,2014-11-05 20:04:30
02637a10ef16b209db8a63b3ea5924945ddfc2bc...2d83bad8f324bd25b884ee1cc2a3fd4924908072,1,2,1,3,1,2014-11-05 20:23:18,2014-11-05 20:23:18
2d83bad8f324bd25b884ee1cc2a3fd4924908072...6720d1c850c0f2f5f908612993187aec2c6cce1d,1,1,2,3,1,2014-11-05 20:25:23,2014-11-05 20:25:23
6720d1c850c0f2f5f908612993187aec2c6cce1d...f881b02f58f34b4c0b6c6e68fa7f186f96700802,1,17,0,17,1,2014-11-05 23:50:01,2014-11-05 23:48:26
f881b02f58f34b4c0b6c6e68fa7f186f96700802...e5380d06b734dbf38692d235814e14343051db7e,1,9,9,18,1,2014-11-06 01:09:42,2014-11-06 00:53:00
e5380d06b734dbf38692d235814e14343051db7e...06b5c1fb6b1d5d5a32cfecb0f1036af7ab44609a,1,1,11,12,2,2014-11-06 01:09:43,2014-11-06 00:53:33
06b5c1fb6b1d5d5a32cfecb0f1036af7ab44609a...cf271511cbb7f3cdb1b3328fed0cd78488f63dc8,1,2,2,4,2,2014-11-06 01:09:43,2014-11-06 00:59:32
cf271511cbb7f3cdb1b3328fed0cd78488f63dc8...d072249bdf35c930cca3f0e3f993a03e4c6bc38f,1,2,9,11,2,2014-11-06 01:09:43,2014-11-06 01:04:45
d072249bdf35c930cca3f0e3f993a03e4c6bc38f...30499812e7729affe1ff74dcc872003c148a2b4c,1,12,21,33,3,2014-11-06 01:53:16,2014-11-06 01:53:16
30499812e7729affe1ff74dcc872003c148a2b4c...130bf7795719b20c5cf956a031b2de1920dfcacc,1,5,0,5,1,2014-11-06 02:02:37,2014-11-06 02:02:37
9195b84c04574e50004f3dd4b25bf8e7ecdb2e43...c9511a61a392fb3262f02931d00329ba8e17fe58,1,8,9,17,3,2014-10-16 20:41:13,2014-10-16 20:41:13
f14d0366ba72411c9244f0c4569e4ee68b33b609...216c38e5de8838dff485b588a3146bfe5c357c35,1,196,88,284,1,2014-10-16 20:48:29,2014-10-16 20:48:29
216c38e5de8838dff485b588a3146bfe5c357c35...98e66a472b448fe147c1374354a89de5d85fc2bf,1,4,6,10,3,2014-10-16 20:55:19,2014-10-16 20:55:19
98e66a472b448fe147c1374354a89de5d85fc2bf...875f46352704906bb0a5d8e10ae66e4e000fd879,1,3,5,8,2,2014-10-16 20:57:16,2014-10-16 20:57:16
87bd6f87d59de9a0214d4dc9d66d7ad1b71e22d2...fb863f86021cf2739f90e7943af8470f7bdc62cd,1,9,1,10,1,2014-10-06 20:57:12,2014-10-06 20:56:20
fb863f86021cf2739f90e7943af8470f7bdc62cd...e9a352f22c178ab93b65d4e2cb09f06be7651978,1,19,16,35,3,2014-10-06 20:57:12,2014-10-06 20:56:57
e9a352f22c178ab93b65d4e2cb09f06be7651978...88a836383b9002069e2c71d60fe60887ea86d79d,2,13,4,17,4,2014-10-06 21:04:20,2014-10-06 21:04:20
88a836383b9002069e2c71d60fe60887ea86d79d...7890b14e4ed38389653f7347e737f02c89dbbdfe,1,1,1,2,1,2014-10-07 00:01:51,2014-10-07 00:01:51
87bd6f87d59de9a0214d4dc9d66d7ad1b71e22d2...ded0601d0a4634f68ad56807342ce253a2f7a36a,1,8,5,13,6,2014-10-06 20:44:32,2014-10-06 20:44:32
ded0601d0a4634f68ad56807342ce253a2f7a36a...ceda65f24be058157b31bde8a7ac8d3ea0bc71fc,2,205,102,307,40,2014-10-07 00:20:39,2014-10-07 00:20:39
ceda65f24be058157b31bde8a7ac8d3ea0bc71fc...0c641fd7b3c218a0a2e254ee84e2583b1b713df8,1,10,4,14,4,2014-10-07 22:09:33,2014-10-07 22:09:33
0c641fd7b3c218a0a2e254ee84e2583b1b713df8...4b1a781755b0f8c7497f351b8f81bf3e019f4459,2,22,8,30,7,2014-10-07 22:22:20,2014-10-07 22:22:20
4b1a781755b0f8c7497f351b8f81bf3e019f4459...746fd0f792126a68004cc6788d42a60b3a77dd7d,3,64,16,80,23,2014-10-07 22:59:05,2014-10-07 22:59:05
746fd0f792126a68004cc6788d42a60b3a77dd7d...d87a1fe1118714515b3a869d9debd9a0b834bcba,1,8,7,15,4,2014-10-08 01:59:58,2014-10-08 01:59:58
d87a1fe1118714515b3a869d9debd9a0b834bcba...9dcc5e8780f8a556e007800afe12079e51cb9ed6,1,9,5,14,6,2014-10-08 22:05:57,2014-10-08 22:05:57
a51212d75fae665cb3bdf183d43093087a36752d...a7f5f0fa15d05e54bdaa354e50e037b4b761aef5,1,1,1,2,1,2014-08-25 07:16:25,2014-08-24 20:56:17
a7f5f0fa15d05e54bdaa354e50e037b4b761aef5...7ce6278f978c07e7da84767fc641c6f02984d034,1,8,0,8,1,2014-08-25 15:30:09,2014-08-25 15:30:09
1ff2c3bae988efe78ce0ac10693399ca731fc77a...c4948d8dffdf0166f0266264f6ad7d7da7d769a6,4,23,16,39,18,2014-08-23 00:31:21,2014-08-23 00:31:21
c4948d8dffdf0166f0266264f6ad7d7da7d769a6...131b73bc7167656c51bd85be55ea8bbd6b9ae0c5,6,0,0,0,0,2014-08-23 00:33:36,2014-08-23 00:33:36
131b73bc7167656c51bd85be55ea8bbd6b9ae0c5...412033f7c434e7f144396e247dd7b70d1d42395b,1,20,10,30,2,2014-08-23 00:54:44,2014-08-23 00:54:44
412033f7c434e7f144396e247dd7b70d1d42395b...a8e8995c91066274d64177d996cbd05d6912c88c,4,19,17,36,10,2014-08-23 01:04:24,2014-08-23 01:04:24
59c3b468a76a13527bb5eb8553b0e5e3017afbbf...58b8b8373e91ba2986c6114aa6bc699918320f9d,1,7,0,7,1,2014-02-07 21:31:35,2014-02-07 21:31:35
8ea5618c53fbe83d6134f2b1d05859951343c871...d6dea52ce66ae3e30dd57486e05140156b7c90cb,3,2,4,6,6,2015-03-17 20:55:09,2015-03-17 20:55:09
acae4a576ed258fc7c8cfd32b39301efed2809f6...b3c49b5fa1e8a6c039cf3fe53a66c8fa88d930f0,1,8,4,12,1,2015-02-25 22:40:43,2015-02-25 22:40:43
b3c49b5fa1e8a6c039cf3fe53a66c8fa88d930f0...c69e990152d6f598ee12e684bc49e574a25bc3f8,1,4,0,4,1,2015-02-25 22:55:36,2015-02-25 22:44:49
c69e990152d6f598ee12e684bc49e574a25bc3f8...34c366faea108584aeff20203cc7ba6a95cf77b8,1,1,1,2,1,2015-02-25 22:55:36,2015-02-25 22:54:41
34c366faea108584aeff20203cc7ba6a95cf77b8...396bfac14c068deb23b25e0a894d4411904951dc,1,6,2,8,2,2015-02-25 23:06:52,2015-02-25 23:06:52
7576e0f3f60b7e9f33c9b95fdea58e43f2e9f92b...2a0d0dff3ffc0e0f00560c3a5c66571db4dbf8c7,1,4,4,8,2,2015-01-22 13:20:09,2015-01-22 12:39:13
c0b520404747a53104d05571fe9d81c691cd7c2a...18553dd07ee15a48b099c04ec33c2e6ec837d722,1,2,0,2,1,2015-02-01 20:23:37,2015-02-01 20:23:37
07fa40f20e280aa015659c4223e73e88cbe8bace...e92a1c0b3a8f32d4df2b2b1323484247da752469,2,10,5,15,6,2015-01-28 01:37:15,2015-01-28 01:37:15
e92a1c0b3a8f32d4df2b2b1323484247da752469...17b7822f0da69687973f6ea9718ce02c21b96b87,1,41,0,41,1,2015-01-28 22:35:42,2015-01-28 20:37:43
17b7822f0da69687973f6ea9718ce02c21b96b87...ecf7b0c4e132414a92dfa2b08e33f8b17d3e4bb0,2,5,9,14,4,2015-01-29 19:37:25,2015-01-29 19:12:03
ecf7b0c4e132414a92dfa2b08e33f8b17d3e4bb0...400f4a11ee7f8759e35787585a2705d34b9985a8,1,1,1,2,1,2015-01-29 19:48:13,2015-01-29 19:48:13
400f4a11ee7f8759e35787585a2705d34b9985a8...b1b303d1c7ed974672586699f9964204a73a9911,1,1,1,2,1,2015-01-29 20:18:36,2015-01-29 20:18:36
b1b303d1c7ed974672586699f9964204a73a9911...9b243922bc0b56a7843e602f41681ce5e3d30a16,1,1,1,2,1,2015-01-30 01:32:27,2015-01-30 01:32:00
9b243922bc0b56a7843e602f41681ce5e3d30a16...e8129ed443354ad3c381894667f79d0d715b5855,1,1,1,2,1,2015-01-30 01:33:42,2015-01-30 01:33:42
e8129ed443354ad3c381894667f79d0d715b5855...000467711baa2b0cae91ceb1016323811e95cf2b,2,2,2,4,2,2015-01-30 01:36:04,2015-01-30 01:36:04
000467711baa2b0cae91ceb1016323811e95cf2b...192a33e65b245e3339c7f7ae8c6b8df0500db621,2,7,6,13,6,2015-01-30 23:05:08,2015-01-30 23:03:55
192a33e65b245e3339c7f7ae8c6b8df0500db621...6989b53389bc0ef464b812af2d2fded8b2f9e028,1,1,1,2,1,2015-01-30 23:08:30,2015-01-30 23:08:30
6989b53389bc0ef464b812af2d2fded8b2f9e028...a319123fcd74399e4ba8dad7f880a5e658f4355f,1,1,0,1,1,2015-01-30 23:15:06,2015-01-30 23:15:06
a319123fcd74399e4ba8dad7f880a5e658f4355f...a81816298a6f60e1fae5292012eb5416b8dea5ea,2,17,3,20,2,2015-01-30 23:39:51,2015-01-30 23:39:51
a81816298a6f60e1fae5292012eb5416b8dea5ea...e2c358dd45a568902b58324a1e29e0c58b0faf41,2,24,4,28,7,2015-01-31 01:18:38,2015-01-31 01:18:38
e2c358dd45a568902b58324a1e29e0c58b0faf41...2216f889bdc8dae223972b03ce4ba64f5d084f2f,1,2,1,3,1,2015-02-02 18:15:10,2015-01-28 00:01:19
07fa40f20e280aa015659c4223e73e88cbe8bace...6c4f3f2051711d55229abf1195c2005e0adb31df,1,2,2,4,1,2015-01-27 23:58:25,2015-01-27 23:58:25
6c4f3f2051711d55229abf1195c2005e0adb31df...d8ac6ee1b90a6500926e1241bd340806637bc121,1,2,1,3,1,2015-01-28 00:01:19,2015-01-28 00:01:19
d8ac6ee1b90a6500926e1241bd340806637bc121...1fda929da494e2219aa26efa0dde5ced23e5d440,1,3,2,5,3,2015-01-28 00:03:49,2015-01-28 00:03:49
1fda929da494e2219aa26efa0dde5ced23e5d440...6b161267f323c2d5a5c196f16c826954b63c3130,1,3,3,6,3,2015-01-28 00:04:57,2015-01-28 00:04:57
6b161267f323c2d5a5c196f16c826954b63c3130...f1acf81098c884938f19b10c510a86ccfb431bec,2,20,20,40,15,2015-01-28 00:14:34,2015-01-28 00:14:34
f1acf81098c884938f19b10c510a86ccfb431bec...c831e27c917ae496815e1a2c2a77adb8f46d1f31,1,13,13,26,11,2015-01-28 00:18:27,2015-01-28 00:18:27
c831e27c917ae496815e1a2c2a77adb8f46d1f31...2f3d07df4d93a2ea59a05f13c20a94a42b4e25a8,1,4,4,8,3,2015-01-28 00:20:32,2015-01-28 00:20:32
2f3d07df4d93a2ea59a05f13c20a94a42b4e25a8...3edb9da23e98c20317bf699aee9c8bd7f69c5a4d,1,1,1,2,1,2015-01-28 00:22:24,2015-01-28 00:22:24
3edb9da23e98c20317bf699aee9c8bd7f69c5a4d...a5f5932db28d580c83b6ec2930b02b9569c5deff,1,1,1,2,1,2015-01-28 00:25:46,2015-01-28 00:25:46
a5f5932db28d580c83b6ec2930b02b9569c5deff...50fd3cef5f9262dcfc7c05049e83e4ed5f6454ff,1,1,0,1,1,2015-01-28 00:26:03,2015-01-28 00:26:03
50fd3cef5f9262dcfc7c05049e83e4ed5f6454ff...b18e6087a507820b94ea02b05ffc3eb8a1912b95,1,9,9,18,8,2015-01-28 00:26:18,2015-01-28 00:26:18
b18e6087a507820b94ea02b05ffc3eb8a1912b95...25352fc281fd9759e3b830f5348a35de945e601d,1,0,1,1,1,2015-01-28 00:26:31,2015-01-28 00:26:31
25352fc281fd9759e3b830f5348a35de945e601d...14598f1ca627e6c5f4badb745ee5b1a6eb18e71d,1,4,0,4,1,2015-01-28 00:27:53,2015-01-28 00:27:53
14598f1ca627e6c5f4badb745ee5b1a6eb18e71d...9e8e993b573b10a17bd15bb1519e7d3f21c0c328,1,10,9,19,2,2015-01-28 00:30:23,2015-01-28 00:30:23
9e8e993b573b10a17bd15bb1519e7d3f21c0c328...a03421095b1be4914c6ad26d33bf8f51ed5f8d6e,1,38,34,72,1,2015-01-28 00:37:05,2015-01-28 00:37:05
a03421095b1be4914c6ad26d33bf8f51ed5f8d6e...5ebea95b1f664f465a7569bf98a79892cf2108c6,1,6,2,8,1,2015-01-28 00:40:23,2015-01-28 00:40:23
5ebea95b1f664f465a7569bf98a79892cf2108c6...634c6d623b131d90a78557eb3c17b6f02de230bc,1,0,1,1,1,2015-01-28 00:43:15,2015-01-28 00:43:15
634c6d623b131d90a78557eb3c17b6f02de230bc...ebc04682c86f5ed152cbe83044164ae0b4036ca0,1,1,1,2,1,2015-01-28 21:25:01,2015-01-28 21:22:20
ebc04682c86f5ed152cbe83044164ae0b4036ca0...33e6b62a7dad17b57af785caf6f03d5a89c95884,1,6,4,10,6,2015-01-28 21:25:17,2015-01-28 21:22:37
33e6b62a7dad17b57af785caf6f03d5a89c95884...ea2a8bc4685194c033a074c6f634b100bc23d752,2,2,1,3,2,2015-01-28 21:26:41,2015-01-28 21:26:41
ea2a8bc4685194c033a074c6f634b100bc23d752...415ec102a20c64d9822141fa31da3d189bb9e0e5,1,4,1,5,1,2015-01-28 21:39:37,2015-01-28 21:39:37
415ec102a20c64d9822141fa31da3d189bb9e0e5...7f91cd13d22b576fbc9af709754fed99c4b03686,1,1,2,3,1,2015-01-29 00:28:36,2015-01-29 00:28:36
7f91cd13d22b576fbc9af709754fed99c4b03686...881f1c43dc608f0a8856ca370aba21c0e2b43932,1,1,1,2,1,2015-01-29 00:43:47,2015-01-29 00:43:47
881f1c43dc608f0a8856ca370aba21c0e2b43932...2f85ef8da23c9dae18ac6bf478941cba4130ac6d,1,52,26,78,2,2015-01-29 19:15:11,2015-01-29 17:45:44
2f85ef8da23c9dae18ac6bf478941cba4130ac6d...6b876c7265c2d9ebdbb2c904df8b276c8587200b,2,25,21,46,2,2015-01-29 19:15:15,2015-01-29 19:03:22
6b876c7265c2d9ebdbb2c904df8b276c8587200b...4b1f257e37ebd2bbce58958da9f05befa340fca8,2,52,9,61,4,2015-01-29 22:09:19,2015-01-29 20:36:50
4b1f257e37ebd2bbce58958da9f05befa340fca8...e82b9a0235235e6ea426f5e8ca41c5dd8f7e18b3,1,24,0,24,1,2015-01-29 22:12:35,2015-01-29 22:12:35
e82b9a0235235e6ea426f5e8ca41c5dd8f7e18b3...3d47829e87ff65952589ae8076253fb042701137,3,9,4,13,3,2015-01-29 22:27:42,2015-01-29 22:27:42
3d47829e87ff65952589ae8076253fb042701137...a7fb7b93a6be286917c668fd209390f2c731e8e6,2,1,255,256,2,2015-01-29 22:33:01,2015-01-29 22:33:01
a7fb7b93a6be286917c668fd209390f2c731e8e6...a82f8557ec04736728ac05ea84f3be6104c5b326,1,1,1,2,1,2015-01-30 01:32:00,2015-01-30 01:32:00
a82f8557ec04736728ac05ea84f3be6104c5b326...255739d5abfd94dfe48df1570b999dc1a8f69680,1,11,6,17,2,2015-01-30 19:00:04,2015-01-30 19:00:04
255739d5abfd94dfe48df1570b999dc1a8f69680...8c906954d375b0ce784fe739fb0980515488c5cb,1,0,21,21,2,2015-01-30 19:11:47,2015-01-30 19:11:47
8c906954d375b0ce784fe739fb0980515488c5cb...1a522e428db5bbdc7f5d7e845e8e3fad3dc6e6d7,1,3,1,4,1,2015-01-30 19:58:49,2015-01-30 19:58:49
1a522e428db5bbdc7f5d7e845e8e3fad3dc6e6d7...863aea7bcfb408162ba2bb288c98c496ae834de4,1,3,2,5,4,2015-01-30 19:59:04,2015-01-30 19:59:04
863aea7bcfb408162ba2bb288c98c496ae834de4...54f1a9a77012b530a76d58022110f181d31f1b60,1,1,1,2,1,2015-01-30 19:59:13,2015-01-30 19:59:13
54f1a9a77012b530a76d58022110f181d31f1b60...94721e818f8e7cfe7e05422c3a30dc60167de888,1,1,2,3,1,2015-01-30 20:00:32,2015-01-30 20:00:32
94721e818f8e7cfe7e05422c3a30dc60167de888...472cef6a64315acb6cfc5a3bf2ff927d4609e260,2,123,108,231,22,2015-01-30 23:44:51,2015-01-30 22:33:58
472cef6a64315acb6cfc5a3bf2ff927d4609e260...30148b58b774b90709cd2b838f3261e0b3c9ef6a,1,11,7,18,1,2015-01-30 23:44:55,2015-01-30 22:54:41
30148b58b774b90709cd2b838f3261e0b3c9ef6a...35d4223fcc8b86c5db4bab931167afab5a2f61f8,1,16,12,28,8,2015-01-30 23:44:56,2015-01-30 23:44:38
35d4223fcc8b86c5db4bab931167afab5a2f61f8...e1dc24a0456f9ea0390e9a6966e702190c5e87d4,1,2,0,2,1,2015-01-30 23:52:32,2015-01-30 23:52:32
e1dc24a0456f9ea0390e9a6966e702190c5e87d4...bc4696454a44b54f1c4e0eba8fa8f671251379a9,2,4,4,8,2,2015-02-02 18:08:05,2015-02-02 18:08:05
10698d5940afa3bf74d8f187300015333bfaa2a0...60ba1f403b8f231a71e65dac162127aa74e90c9e,4,8,42,50,11,2015-01-08 22:26:28,2015-01-08 22:26:28
60ba1f403b8f231a71e65dac162127aa74e90c9e...4381bb86ef2e6444bc5bea1f0dcf9cd9adba70e0,1,3,0,3,1,2015-01-09 01:25:41,2015-01-08 23:22:31
10698d5940afa3bf74d8f187300015333bfaa2a0...f8d262223530b8e072a52aac17733783adf9e786,4,116,4,120,8,2015-01-08 22:08:37,2015-01-08 22:08:37
f8d262223530b8e072a52aac17733783adf9e786...68e3cbe07f7007b143f50e93b97d108816f5c383,2,12,5,17,5,2015-01-08 23:33:55,2015-01-08 23:33:55
68e3cbe07f7007b143f50e93b97d108816f5c383...2fbb1b9cb5ddd32b9c57d566eb4c01fcf59b9dcf,3,187,1,188,4,2015-01-08 23:34:04,2015-01-08 23:34:04
2fbb1b9cb5ddd32b9c57d566eb4c01fcf59b9dcf...329227db539b1fc547a618e3d9026d5c6c6367d1,1,109,0,109,1,2015-01-09 00:25:42,2015-01-09 00:25:42
329227db539b1fc547a618e3d9026d5c6c6367d1...9d9dec602f4df9e7b06007c851d341526d12d7ad,4,82,133,215,31,2015-01-09 18:26:06,2015-01-09 18:26:06
94683896b74869c12c5ebf11e09330619b749a9b...d4d349ca96b57f4cbf36d84b41bcb3ca5bd70850,7,21,4,25,7,2015-02-18 02:01:01,2015-02-18 02:01:01
d4d349ca96b57f4cbf36d84b41bcb3ca5bd70850...181180df2fc62925a5e53a8cc10db9237066be2e,1,3,0,3,1,2015-02-18 02:03:57,2015-02-18 02:03:57
181180df2fc62925a5e53a8cc10db9237066be2e...17fc4982594399651d6cb5d3c46e3985a773ca9a,1,1,1,2,1,2015-02-18 02:39:20,2015-02-18 02:39:20
17fc4982594399651d6cb5d3c46e3985a773ca9a...f426f09abb4814bb9602e8264bca33f25e8fd979,1,4,0,4,1,2015-02-19 18:42:08,2015-02-19 18:42:08
f426f09abb4814bb9602e8264bca33f25e8fd979...05b6ddb8ed98dce66f69fa4a158a309ad3034e81,1,4,4,8,4,2015-02-22 20:34:13,2015-02-22 20:34:13
94683896b74869c12c5ebf11e09330619b749a9b...0230a60b18da3943652ffd8467acd053bf0ba3e3,7,21,4,25,7,2015-02-18 01:52:46,2015-02-17 21:48:17
68808ac288fa5acf9f0fc81c4de92c12a9a147a0...eb0f8802addd159be12f68c770633123a0e91be7,1,3,2,5,3,2014-12-16 01:21:25,2014-12-16 01:21:25
eb0f8802addd159be12f68c770633123a0e91be7...c373120de7562caf41e8d688e303169f3fa0447a,1,7,2,9,3,2014-12-16 01:29:49,2014-12-12 15:37:57
c373120de7562caf41e8d688e303169f3fa0447a...c853146b21a1bf742b5e79abb5bf13ae47446787,1,8,1,9,1,2014-12-16 01:29:49,2014-12-13 01:36:29
c853146b21a1bf742b5e79abb5bf13ae47446787...cf9ad04e1793855f3e9b373ff8dc1975dc19762e,1,1,1,2,1,2014-12-16 06:51:48,2014-12-16 06:51:48
cf9ad04e1793855f3e9b373ff8dc1975dc19762e...87f4189e11d83a3fee67bc4698605a9c42badf7b,1,16,1,17,2,2014-12-16 07:07:40,2014-12-16 07:07:40
87f4189e11d83a3fee67bc4698605a9c42badf7b...d37a2ab5c30a073808e274e8c759514e05b4d775,2,92,66,158,25,2014-12-16 07:55:34,2014-12-16 01:20:21
d37a2ab5c30a073808e274e8c759514e05b4d775...6b8a8ad9d87704c4d43d9c5e7380a6eef9c422b1,1,1,0,1,1,2014-12-16 17:32:37,2014-12-16 17:13:44
6b8a8ad9d87704c4d43d9c5e7380a6eef9c422b1...02e93d00d72f04e4398c12b14d9b445ef31401d6,1,8,5,13,4,2014-12-16 17:32:37,2014-12-16 17:27:44
02e93d00d72f04e4398c12b14d9b445ef31401d6...2a7cd3268d40da57f1c7756b3ff414f7324a5a45,2,41,50,91,15,2014-12-16 17:34:43,2014-12-16 17:13:26
2a7cd3268d40da57f1c7756b3ff414f7324a5a45...fc52c5fbf5abbfdab2f5133ffe1dca47f315f97c,1,17,20,37,10,2014-12-16 17:34:43,2014-12-16 17:31:03
9b697d0c7b4d5b9e0692c41fb91f850d9df2024d...7461cab72665e8dd198f97e370630f52fb2f9900,3,29,1,30,5,2014-12-16 21:55:28,2014-12-16 21:53:20
8722ac60636828eb5739fa5d9378cecb0c443aaf...f605377d8b2a8f6d4f24dd915daa1694957cc331,1,1,1,2,1,2014-12-22 20:26:35,2014-12-19 22:08:11
f605377d8b2a8f6d4f24dd915daa1694957cc331...301f73edecf90f2b314dc6f6afde7a7661d2226e,1,4,3,7,2,2014-12-22 20:26:58,2014-12-21 04:38:25
301f73edecf90f2b314dc6f6afde7a7661d2226e...63afb346c864a14541c3bf99799a549cc101013e,1,1,1,2,1,2014-12-22 20:27:03,2014-12-22 17:39:23
63afb346c864a14541c3bf99799a549cc101013e...5df873a4e062fd93347927e77571e25e314dc245,4,65,13,78,8,2014-12-22 20:27:55,2014-12-22 20:19:59
5df873a4e062fd93347927e77571e25e314dc245...36d49dc61e7a91ad3a0fed30242ad5b62290bb8c,1,10,0,10,1,2014-12-22 20:30:14,2014-12-22 20:30:14
36d49dc61e7a91ad3a0fed30242ad5b62290bb8c...837c5faddf9861bc4978a286ccdeaf312333dd0f,3,3,3,6,3,2014-12-22 20:33:14,2014-12-22 20:31:20
837c5faddf9861bc4978a286ccdeaf312333dd0f...2343c1253ef180666b7a959c0e08c4f145cc9f58,1,2,4,6,2,2014-12-22 21:32:21,2014-12-22 21:32:21
2343c1253ef180666b7a959c0e08c4f145cc9f58...2c50456cefb27d4635ee6474c10dbd92d9479651,2,2,2,4,2,2014-12-22 22:15:04,2014-12-22 22:15:04
2c50456cefb27d4635ee6474c10dbd92d9479651...94b58c17bcc4d6ba8b9007c457a4bfe60d0b8ddf,1,7,2,9,2,2014-12-22 23:23:34,2014-12-22 23:23:34
94b58c17bcc4d6ba8b9007c457a4bfe60d0b8ddf...4ece886c3677fd887ca46301af68bbf3c4d0f34e,3,3,3,6,3,2014-12-23 00:52:44,2014-12-23 00:48:24
4ece886c3677fd887ca46301af68bbf3c4d0f34e...27342dcbe4513873dd0ee6fa458ebdbbbbea4eec,1,1,0,1,1,2014-12-23 01:31:03,2014-12-23 01:31:03
27342dcbe4513873dd0ee6fa458ebdbbbbea4eec...8566ff30cd1756980660fee53f23d78cdf8f2f8b,1,1,1,2,1,2014-12-23 01:34:30,2014-12-23 01:34:30
8566ff30cd1756980660fee53f23d78cdf8f2f8b...9e58d3f045d3aa2dcd9f5f91c13f3ea24046554a,3,59,61,120,4,2014-12-23 01:41:31,2014-12-23 01:41:31
9e58d3f045d3aa2dcd9f5f91c13f3ea24046554a...e9e849f0f56b92de2d2d5a66d246fe532a17a5b9,9,281,261,542,25,2014-12-23 01:42:46,2014-12-23 01:42:46
8722ac60636828eb5739fa5d9378cecb0c443aaf...9717ba320033995eacb9f02de1e1b8accc2c7f19,3,59,61,120,4,2014-12-19 19:26:19,2014-12-19 19:26:19
9717ba320033995eacb9f02de1e1b8accc2c7f19...fc829ad525b27b36bd5179f471ce299aa57a0fc3,9,281,261,542,25,2014-12-19 19:31:38,2014-12-19 19:31:38
fc829ad525b27b36bd5179f471ce299aa57a0fc3...0befea50f263fc952d0ae22c9f5716cd99ce1cd1,10,0,163,163,10,2014-12-19 19:34:07,2014-12-19 19:34:07
bbc244d7e8d3b9a3a98d866ad952fbe0688ca490...b3b66dd89b155b160c0ec92dcb1d07d55ab0cb92,5,11,11,22,11,2014-11-14 21:30:49,2014-11-14 18:49:37
b3b66dd89b155b160c0ec92dcb1d07d55ab0cb92...9edc726c35e8afcbef73097f53892fb60db197da,1,37,11,48,5,2014-11-14 21:30:49,2014-11-14 21:30:34
9edc726c35e8afcbef73097f53892fb60db197da...dbe7d216845874326aff87b434d77cd19bec3659,3,43,20,63,15,2014-11-15 01:48:13,2014-11-15 01:47:18
dbe7d216845874326aff87b434d77cd19bec3659...f86a8548c86d8ed030a96900263a36f3c12ee07d,2,13,4,17,5,2014-11-15 01:49:14,2014-11-14 23:13:54
f86a8548c86d8ed030a96900263a36f3c12ee07d...de28149f0e9a10c8e6377124e7fb3f0f74c33492,4,7,4,11,5,2014-11-16 23:53:08,2014-11-16 23:53:08
de28149f0e9a10c8e6377124e7fb3f0f74c33492...3f06a7e397cafb1cd8cb5affcafaa4d5ad33af67,1,1,1,2,1,2014-11-17 00:06:27,2014-11-17 00:06:27
3f06a7e397cafb1cd8cb5affcafaa4d5ad33af67...31abac8b3c76daf6283c5568244f34029e158155,3,58,19,77,4,2014-11-17 19:31:54,2014-11-17 19:31:54
31abac8b3c76daf6283c5568244f34029e158155...6036d844ea799e8cd9c3ba0d80b26a1ae518ef8c,2,5,4,9,3,2014-11-17 19:49:36,2014-11-17 19:49:36
6036d844ea799e8cd9c3ba0d80b26a1ae518ef8c...a7f8099139324226afe17125f02cb42c974d7908,119,123,125,248,124,2014-11-17 19:57:36,2014-11-17 19:57:36
a7f8099139324226afe17125f02cb42c974d7908...444eb07fea9d6d610bd2d91b38b9816db3e6787c,6,6,6,12,6,2014-11-17 19:59:49,2014-11-17 19:59:49
444eb07fea9d6d610bd2d91b38b9816db3e6787c...fb296d3c5e6086d289cfb5e62ef2714bed362baa,3,3,2,5,3,2014-11-18 01:44:30,2014-11-18 01:44:30
fb296d3c5e6086d289cfb5e62ef2714bed362baa...735b85d6e6db21e08c5fd8959737693882266eba,2,2,2,4,2,2014-11-18 01:47:50,2014-11-18 01:47:50
735b85d6e6db21e08c5fd8959737693882266eba...3fe2354e5a32b9f1eed3a8a11226c9ee03e9f419,2,35,23,58,3,2014-11-18 04:43:13,2014-11-18 04:43:13
3fe2354e5a32b9f1eed3a8a11226c9ee03e9f419...63669949cbf654a0fe4f79c36611835798695ed4,3,12,3,15,3,2014-11-18 23:59:54,2014-11-18 23:59:54
63669949cbf654a0fe4f79c36611835798695ed4...5179087312d173fca822adca2aff2836a38f9321,3,12,2,14,3,2014-11-19 00:08:46,2014-11-19 00:08:46
5179087312d173fca822adca2aff2836a38f9321...3e61616feb7d4c25bab144b010c61b871e288531,2,8,3,11,2,2014-11-19 00:44:54,2014-11-19 00:44:54
3e61616feb7d4c25bab144b010c61b871e288531...065dc6cd91a6f3616ae3bd68fbdd53b028000134,1,2,0,2,1,2014-11-19 01:03:01,2014-11-19 01:03:01
065dc6cd91a6f3616ae3bd68fbdd53b028000134...75993b33308f3c6f2cb9ed6879eca0e641e45ce7,7,20,23,43,12,2014-11-19 01:34:40,2014-11-19 01:34:40
75993b33308f3c6f2cb9ed6879eca0e641e45ce7...c0312432b6df09d16ce9929a6dcb70623c7f7b7e,3,561,0,561,3,2014-11-19 16:02:22,2014-11-19 16:02:22
c0312432b6df09d16ce9929a6dcb70623c7f7b7e...60171ce5e87acc80b13de26fee4c209352c70ed8,1,1,1,2,1,2014-11-19 16:05:46,2014-11-19 16:05:46
60171ce5e87acc80b13de26fee4c209352c70ed8...b80ffbf63e426c56df7e25080f9b114b5181b944,1,59,0,59,1,2014-11-19 16:12:42,2014-11-19 16:12:42
b80ffbf63e426c56df7e25080f9b114b5181b944...50d3936b78a5e9d90572d096c8de541fcdefc1d5,1,1,1,2,1,2014-11-19 16:14:09,2014-11-19 16:14:09
50d3936b78a5e9d90572d096c8de541fcdefc1d5...48052303b44f5ca50505cf1500160e2cbe039a64,5,8,14,22,7,2014-11-19 16:21:40,2014-11-19 16:21:40
48052303b44f5ca50505cf1500160e2cbe039a64...d02e17d29a23e63fdb24ce6724f6fae2f25efbe8,1,1,1,2,1,2014-11-19 16:31:12,2014-11-19 16:31:12
d02e17d29a23e63fdb24ce6724f6fae2f25efbe8...c9494677fd9b5bd3f62a995c3974579b0c06e70c,1,5,1,6,1,2014-11-19 18:25:18,2014-11-19 18:25:18
c9494677fd9b5bd3f62a995c3974579b0c06e70c...82f7173223b5e37dc62c1f44cb5ee348f14d6912,3,3,3,6,3,2014-11-19 18:28:22,2014-11-19 18:28:22
82f7173223b5e37dc62c1f44cb5ee348f14d6912...66813549f85e9c8c86269f24b2db7945c49782fa,1,1,1,2,1,2014-11-19 18:29:41,2014-11-19 18:29:41
66813549f85e9c8c86269f24b2db7945c49782fa...84e773fdfbadf230a7c9d8bc884eebd87c197e02,1,16,6,22,5,2014-11-19 19:23:34,2014-11-19 19:23:34
84e773fdfbadf230a7c9d8bc884eebd87c197e02...2e4388ef70679201bf2d34293c95820010892d75,1,5,3,8,1,2014-11-19 19:29:55,2014-11-19 19:29:55
2e4388ef70679201bf2d34293c95820010892d75...8e0355780af80cb1a3e3bde51ecaa6b7401d9b90,3,6,6,12,6,2014-11-19 19:30:40,2014-11-19 19:30:40
8e0355780af80cb1a3e3bde51ecaa6b7401d9b90...39d399bcf6b6712556dd22803d32a989a70f924f,1,48,0,48,1,2014-11-25 04:48:58,2014-11-25 04:48:58
39d399bcf6b6712556dd22803d32a989a70f924f...01bb5f4ce4509bcb7d5a1bdf7f9b1e727ee56a83,3,3,4,7,4,2014-12-01 19:29:29,2014-11-19 20:12:43
01bb5f4ce4509bcb7d5a1bdf7f9b1e727ee56a83...cbb1c625bdb3dc2445ac1af47d40cbe01cf841bc,2,2,2,4,2,2014-12-01 19:29:29,2014-11-19 23:14:12
cbb1c625bdb3dc2445ac1af47d40cbe01cf841bc...ddb75d65ad752e6a1c1f598db625efb5f5ea4a95,1,8,3,11,1,2014-12-01 19:34:47,2014-12-01 19:34:47
ddb75d65ad752e6a1c1f598db625efb5f5ea4a95...b6b80f7a1950358accf59326e899dfb3a765d846,1,2,1,3,1,2014-12-01 19:39:46,2014-12-01 19:39:46
b6b80f7a1950358accf59326e899dfb3a765d846...7048f8a854b55da95ea5147cda37084574e12ff5,1,2,1,3,1,2014-12-02 02:40:27,2014-12-02 02:39:53
7048f8a854b55da95ea5147cda37084574e12ff5...712a3f1779365357ef5e7bc42bf93b0cc4be9701,121,121,121,242,121,2014-12-02 03:21:49,2014-12-01 21:15:07
712a3f1779365357ef5e7bc42bf93b0cc4be9701...eacd18d69e6683b20226cb7cc19690c170251782,2,2,2,4,2,2014-12-02 03:21:50,2014-12-01 21:19:42
eacd18d69e6683b20226cb7cc19690c170251782...78123b5d205e1da4a78a0d51c01ff1ae2e2a1f28,1,3,1,4,1,2014-12-02 18:52:53,2014-12-02 18:52:53
78123b5d205e1da4a78a0d51c01ff1ae2e2a1f28...d7dc173aec8ead16d4cc3b3be4a18f67842a3084,2,19,1,20,2,2014-12-03 21:52:56,2014-12-03 20:28:07
d7dc173aec8ead16d4cc3b3be4a18f67842a3084...b2a9f9c386da8e8ec678e57ca98c2d939bf48074,1,2,1,3,1,2014-12-05 23:40:28,2014-12-05 23:40:28
8fd3b98368d08e783031239b67e7391ab087a8da...f3c420e3502d35d6d29bc2c8d46f59f2e2cdef23,3,750,733,1483,8,2014-11-14 21:35:05,2014-11-14 21:35:05
130bf7795719b20c5cf956a031b2de1920dfcacc...5bb36203f3ef606b7ba6fc07c8bd356b1293920a,1,2,2,4,2,2014-11-06 20:43:52,2014-11-06 20:43:52
130bf7795719b20c5cf956a031b2de1920dfcacc...ed7a5823cd06e9bae250101d79f355a472b24902,1,1,1,2,1,2014-11-06 19:12:02,2014-11-06 19:05:05
ed7a5823cd06e9bae250101d79f355a472b24902...2539e7dd95ce3d67f093d6b5db2970067c32c73f,1,8,3,11,3,2014-11-06 19:12:11,2014-11-06 19:07:49
875f46352704906bb0a5d8e10ae66e4e000fd879...388f42eb49f2cdb22d114009984799de45767b6b,4,170,139,309,26,2014-10-16 21:25:02,2014-10-16 21:25:02
875f46352704906bb0a5d8e10ae66e4e000fd879...33a213f475cb4c8152bf4b641296ed55432c741c,1,1,1,2,1,2014-10-16 21:21:15,2014-10-16 21:21:15
7890b14e4ed38389653f7347e737f02c89dbbdfe...b9db7748348320f69fdb652a6522541651f1773b,4,9,7,16,8,2014-10-07 20:46:00,2014-10-07 20:46:00
7890b14e4ed38389653f7347e737f02c89dbbdfe...8f878896b9f68ef42ac07952ebe594dcf56614b0,1,14,13,27,6,2014-10-07 02:27:44,2014-10-07 02:27:44
8f878896b9f68ef42ac07952ebe594dcf56614b0...597b8e116d8bcd8ecfe460d5db92073c63ebc8d5,1,6,6,12,4,2014-10-07 02:31:20,2014-10-07 02:31:20
597b8e116d8bcd8ecfe460d5db92073c63ebc8d5...d2a2cb126822eb6b5801a79cf5418a742df6569d,1,1,1,2,1,2014-10-07 02:34:58,2014-10-07 02:34:58
d2a2cb126822eb6b5801a79cf5418a742df6569d...2f66c0e16c163f8b151383f279d096f456501ff4,1,8,8,16,4,2014-10-07 02:39:54,2014-10-07 02:39:54
2f66c0e16c163f8b151383f279d096f456501ff4...9475996686d157a3058ae62d5078077dd259aa9f,1,21,21,42,2,2014-10-07 02:44:11,2014-10-07 02:44:11
7890b14e4ed38389653f7347e737f02c89dbbdfe...94cbba6dad06b89630d18c10899343c53c46dc14,1,1,1,2,1,2014-10-07 00:37:33,2014-10-07 00:37:33
94cbba6dad06b89630d18c10899343c53c46dc14...94ab470b2f2ef5d995c51c071c09a4a07c0319b4,2,4,4,8,3,2014-10-07 04:18:51,2014-10-07 04:17:56
94ab470b2f2ef5d995c51c071c09a4a07c0319b4...1779d62281c4283a9d55c9703e6f54e52e78036a,6,80,78,158,11,2014-10-07 04:50:00,2014-10-07 04:42:21
7ce6278f978c07e7da84767fc641c6f02984d034...ec0d2bc8b5972d485c843f039423fc42f2f372d2,6,50,16,66,24,2014-08-26 02:37:47,2014-08-25 22:28:19
ec0d2bc8b5972d485c843f039423fc42f2f372d2...b7cc5228982cb3ac9ab50f83984c6b2024a30dbc,1,1,1,2,1,2014-08-26 03:05:40,2014-08-26 03:05:40
7ce6278f978c07e7da84767fc641c6f02984d034...0618c41dd6d2b1eb206c89811e46c1d03b0ca25c,6,252,52,304,6,2014-08-26 00:24:31,2014-08-26 00:24:31
0618c41dd6d2b1eb206c89811e46c1d03b0ca25c...72b73b801e9dc7526c2c9b3c039e2265fc4bc11c,1,11,0,11,1,2014-08-26 01:44:18,2014-08-26 01:44:18
72b73b801e9dc7526c2c9b3c039e2265fc4bc11c...59020e89894eab97c039a7d8c0b669eb9004cac4,1,17,3,20,8,2014-08-26 02:42:06,2014-08-26 02:42:06
59020e89894eab97c039a7d8c0b669eb9004cac4...b9885e77f439298b6f6a7e6b9cebc9350e7bdc8f,7,136,35,171,9,2014-08-26 02:57:47,2014-08-26 02:57:47
b9885e77f439298b6f6a7e6b9cebc9350e7bdc8f...aa43fb2f2f6ad09a8705f3f702e2a9ab3374f258,12,2666,40,2706,67,2014-08-26 03:54:28,2014-08-26 03:54:28
aa43fb2f2f6ad09a8705f3f702e2a9ab3374f258...8f23bed3de9cecef1b1f668bdc32b1db1cecbc8b,2,32,650,682,6,2014-08-26 03:56:49,2014-08-26 03:56:49
8f23bed3de9cecef1b1f668bdc32b1db1cecbc8b...d093710e45428e3b64b9a116137e06f6b5e6b843,4,240,4,244,9,2014-08-26 04:07:01,2014-08-26 04:07:01
d093710e45428e3b64b9a116137e06f6b5e6b843...3a6f9dbe4339bad136ea6e5ee1df1f6658c15517,5,297,40,337,48,2014-08-26 04:13:22,2014-08-26 04:13:22
3a6f9dbe4339bad136ea6e5ee1df1f6658c15517...538468f42b0fb1ef2e87c04ffec226c510bcce7d,6,814,11,825,22,2014-08-26 04:30:33,2014-08-26 04:30:33
538468f42b0fb1ef2e87c04ffec226c510bcce7d...3cf303d8ce2239270c5499f6e57ca433d3efe1cb,2,2,3018,3020,2,2014-08-26 04:37:12,2014-08-26 04:37:12
3cf303d8ce2239270c5499f6e57ca433d3efe1cb...dbaf42e6eab4145196d7dfa449c23fe7f391ad4b,8,78,24,102,19,2014-08-26 17:12:32,2014-08-26 17:12:32
dbaf42e6eab4145196d7dfa449c23fe7f391ad4b...61f709ac9b690382cc56d7779c7ef11b7a25a044,4,34,5,39,9,2014-08-26 17:18:36,2014-08-26 17:18:36
61f709ac9b690382cc56d7779c7ef11b7a25a044...45ad88bab757e7840b51f5e2a6a3f61c42eb8abc,15,363,50,413,72,2014-08-26 18:58:40,2014-08-26 18:58:40
45ad88bab757e7840b51f5e2a6a3f61c42eb8abc...5931697fa6c60aea913ee843d9a541bf44d37199,14,300,105,405,80,2014-08-26 23:00:01,2014-08-26 23:00:01
5931697fa6c60aea913ee843d9a541bf44d37199...a93cdf4666d83cfa59f0701d52d722bfdc2c659d,2,122,136,258,7,2014-08-26 23:52:15,2014-08-26 23:52:15
69b2618912131fa074c11a2627a8111e48d4a7bb...aa8e465b4e3434898f0f61e6dfe521aca0ccacb3,1,3,0,3,2,2014-08-23 01:24:42,2014-08-23 01:24:42
aa8e465b4e3434898f0f61e6dfe521aca0ccacb3...f9744e5d9304e89ac0f9255fa67f0ae365991946,2,5,2,7,2,2014-08-23 01:32:00,2014-08-23 01:32:00
f9744e5d9304e89ac0f9255fa67f0ae365991946...75310c9493748db38588c0ba993151c0ad6a354d,4,4,4,8,4,2014-08-23 02:07:01,2014-08-23 02:07:01
75310c9493748db38588c0ba993151c0ad6a354d...cf3753b244292169e4705259270b311074e09e7d,3,55,1,56,3,2014-08-23 02:34:12,2014-08-23 02:34:12
cf3753b244292169e4705259270b311074e09e7d...f37cfafd189319672836bb2d965b84511828ba34,1,1,1,2,1,2014-08-23 02:38:24,2014-08-23 02:38:24
f37cfafd189319672836bb2d965b84511828ba34...a1be4f5952300a3d91b139d41306d357a057f3fb,1,109,1,110,11,2014-08-23 04:03:19,2014-08-23 04:03:19
a1be4f5952300a3d91b139d41306d357a057f3fb...42cf334b9c1239ee4af262e77889781c6dc808c6,1,6,0,6,5,2014-08-23 04:08:11,2014-08-23 04:08:11
42cf334b9c1239ee4af262e77889781c6dc808c6...ce99e88ee790df0e4146e485bfe1eff3df969f80,1,4,4,8,2,2014-08-23 20:48:46,2014-08-23 20:48:46
ce99e88ee790df0e4146e485bfe1eff3df969f80...e07aedb0fad62fd2b9174ecac74d2feef36ee211,1,17,11,28,4,2014-08-23 22:05:59,2014-08-23 22:03:53
e07aedb0fad62fd2b9174ecac74d2feef36ee211...7c23ca5fde78a62897cfcc488b6e905763cebd47,1,5,9,14,1,2014-08-23 22:15:37,2014-08-23 22:15:37
7c23ca5fde78a62897cfcc488b6e905763cebd47...bc8d2e0459b53fe8b1c6e50a5dbf291ee6fd3b7e,1,21,15,36,4,2014-08-23 22:52:38,2014-08-23 22:52:38
bc8d2e0459b53fe8b1c6e50a5dbf291ee6fd3b7e...80d271fa24c58e688fe5824bbe664520a7db8dc6,2,9,9,18,9,2014-08-23 23:02:23,2014-08-23 22:56:39
80d271fa24c58e688fe5824bbe664520a7db8dc6...7fe36fb904100b1a47414b981551dc7e47a36f51,2,9,9,18,9,2014-08-23 23:06:32,2014-08-23 23:06:32
7fe36fb904100b1a47414b981551dc7e47a36f51...95cfa87de1a9dc3a30210391a64ebb4d9db0a685,1,3,5,8,2,2014-08-23 23:33:25,2014-08-23 23:33:25
95cfa87de1a9dc3a30210391a64ebb4d9db0a685...3f63c748acceb109aa53eff9dc56bb98675c00e4,1,12,1,13,2,2014-08-24 02:51:46,2014-08-24 02:51:46
3f63c748acceb109aa53eff9dc56bb98675c00e4...6154916bfdd0b5d7cb7589a9c9e9f7323d59e6d8,2,2,6,8,2,2014-08-24 03:32:32,2014-08-24 03:32:32
6154916bfdd0b5d7cb7589a9c9e9f7323d59e6d8...b96f455b8092ce0e2d3fd977a77a35c608937d35,4,157,138,295,19,2014-08-24 05:15:46,2014-08-24 05:15:46
b96f455b8092ce0e2d3fd977a77a35c608937d35...2f8e6d7af16dcd88ea54b1638f12e47cb748f9d7,2,31,9,40,5,2014-08-24 05:44:35,2014-08-24 05:44:35
2f8e6d7af16dcd88ea54b1638f12e47cb748f9d7...2e4893d8af420133da2733a3b9ffbab4b397bbb1,5,358,11,369,13,2014-08-24 10:02:09,2014-08-24 10:02:09
2e4893d8af420133da2733a3b9ffbab4b397bbb1...50bf28b1d08c230ebdb835bad0db48728a789393,5,66,35,101,27,2014-08-25 00:18:07,2014-08-25 00:18:07
58b8b8373e91ba2986c6114aa6bc699918320f9d...788a1b622abe6652a832e189fe3c025334828dd0,1,7,1,8,2,2014-02-10 23:37:42,2014-02-10 23:36:29
788a1b622abe6652a832e189fe3c025334828dd0...f5b4af815b4c22f14f994085b04814e564bd3072,1,1,1,2,1,2014-02-11 00:08:07,2014-01-28 10:27:02
f5b4af815b4c22f14f994085b04814e564bd3072...ace114a9856d38c6d37ebaf2af87a97be954e46b,1,1,1,2,1,2014-02-11 00:43:26,2014-02-11 00:43:26
ace114a9856d38c6d37ebaf2af87a97be954e46b...dae257b04f0533bcc737a86c598d4f61cdca7bb2,1,0,30,30,1,2014-02-12 22:07:39,2014-02-12 22:06:47
58b8b8373e91ba2986c6114aa6bc699918320f9d...d5b466efba11d2b80d787017145790ef61336e1b,1,4,7,11,4,2014-02-09 21:26:42,2014-02-09 21:26:42
c775e1e445896b01707bdd1c6fb793b29938a824...4c369c6a56515d254a569c154795995a759f6c88,3,4,2,6,6,2015-03-19 04:54:08,2015-03-19 04:54:08
4c369c6a56515d254a569c154795995a759f6c88...1f2b600735dccf7d08b818ee079b915f06b8a071,2,0,2,2,2,2015-03-19 05:16:30,2015-03-19 05:16:30
c775e1e445896b01707bdd1c6fb793b29938a824...e7a0906a489e74a2b6c79d05c7bc0bf0018ef3a1,1,27,0,27,1,2015-03-18 22:52:22,2015-03-18 22:52:22
21bdac87347e0c80bbdf4fdbca132ff80033b3f3...cca2ef2354a71af9202e710e05a175a7e22d468b,4,10,4,14,5,2015-03-17 20:55:44,2015-03-12 01:09:25
cca2ef2354a71af9202e710e05a175a7e22d468b...00047e185a6fef5a3ff928afd4d9c807aac636b5,2,0,3,3,3,2015-03-17 21:23:03,2015-03-17 21:22:34
00047e185a6fef5a3ff928afd4d9c807aac636b5...44a4604c8d9a0065f8614f8e11ddb04918132cc1,1,1,1,2,1,2015-03-17 21:45:22,2015-03-17 21:45:22
44a4604c8d9a0065f8614f8e11ddb04918132cc1...8ac310b9db204ccb74039b691aae6962d5799fe9,1,7,5,12,4,2015-03-17 22:20:16,2015-03-17 22:19:48
396bfac14c068deb23b25e0a894d4411904951dc...7a4dd5295c87ea2e607f46056f17a32226b03119,1,1,2,3,2,2015-02-26 03:32:13,2015-02-26 03:32:13
7a4dd5295c87ea2e607f46056f17a32226b03119...d1a783d6cfa7b3e168d13df62ef8b8b46835dd8b,1,5,1,6,1,2015-02-26 11:52:04,2015-02-26 11:52:04
d1a783d6cfa7b3e168d13df62ef8b8b46835dd8b...c8ebdd2473581713bd1dfa84b55938281bd8888e,3,3,5,8,3,2015-02-26 19:17:01,2015-02-26 19:17:01
396bfac14c068deb23b25e0a894d4411904951dc...bf63b6dbf8d2ea07323bf8ae5c4e62592649de94,1,12,1,13,2,2015-02-26 00:15:29,2015-02-26 00:15:29
bf63b6dbf8d2ea07323bf8ae5c4e62592649de94...ec9afe2c64d262e5ed126e37651f822f349e2e51,1,1,1,2,1,2015-02-26 00:35:19,2015-02-26 00:35:19
396bfac14c068deb23b25e0a894d4411904951dc...c47934eaf24d49ee8a82d8ef7730f355115697a4,1,14,0,14,1,2015-02-25 23:09:07,2015-02-25 23:09:07
c47934eaf24d49ee8a82d8ef7730f355115697a4...132102e9a5ecdc0115efb5dc19ff832045ac90e5,5,73,11,84,10,2015-02-26 19:30:15,2015-02-26 01:38:51
132102e9a5ecdc0115efb5dc19ff832045ac90e5...493717230ddc5a030c0bb31e15075763b56ffe34,1,15,3,18,5,2015-02-26 19:30:21,2015-02-26 19:26:56
493717230ddc5a030c0bb31e15075763b56ffe34...f90de50793d587d3b31d4a8084ad40a1e942edc3,1,14,4,18,2,2015-02-26 19:46:15,2015-02-26 19:46:15
f90de50793d587d3b31d4a8084ad40a1e942edc3...263c046be7868501fc380c31f139f37a192698cf,2,13,3,16,4,2015-02-26 19:46:56,2015-02-26 19:46:56
f7b76857bfb8483518044b52a195a9d968ea10e6...8f1de90afba4f3fadd99cc21de8e964bd3045e3f,1,1,1,2,1,2015-01-22 23:30:10,2015-01-17 16:59:22
8f1de90afba4f3fadd99cc21de8e964bd3045e3f...8ac477a19baef0dfc0f37937be221c31acc00a34,1,1,1,2,1,2015-01-23 20:07:30,2015-01-23 20:07:30
a50e12f5b0709565ef033f524d7d3122e4506670...287b18c91bee21cf6c921f1402e3951493643987,1,5,4,9,4,2015-02-02 21:27:31,2015-02-02 21:27:31
287b18c91bee21cf6c921f1402e3951493643987...8414c0c002c546114386d3fa9b69e086baedb6a9,1,45,23,68,10,2015-02-03 00:20:35,2015-02-03 00:20:35
8414c0c002c546114386d3fa9b69e086baedb6a9...b93738dae9ae72f132f1df2f0106e11559559541,2,7,7,14,8,2015-02-03 20:00:40,2015-02-03 20:00:40
b93738dae9ae72f132f1df2f0106e11559559541...d88d3d8587bdbfb0bdb18dbe0b759b85ad133122,2,21,10,31,5,2015-02-03 20:00:59,2015-02-03 20:00:59
d88d3d8587bdbfb0bdb18dbe0b759b85ad133122...ead0d8ea0b7d002b0cd0627fc74be5afb39cc6c7,1,31,13,44,6,2015-02-06 19:33:32,2015-02-06 19:33:32
ead0d8ea0b7d002b0cd0627fc74be5afb39cc6c7...47eeb6fd024b0db210852bcb00cb4a420a91e78c,1,3,6,9,2,2015-02-06 21:48:24,2015-02-06 21:48:24
47eeb6fd024b0db210852bcb00cb4a420a91e78c...b95135bf0552e8fb18c879fa99e924ff5ac89abb,1,0,76,76,12,2015-02-06 21:48:56,2015-02-06 21:48:56
b95135bf0552e8fb18c879fa99e924ff5ac89abb...a5df9f84abd3c9afce2cee6906de032da5a2cd47,5,748,591,1339,106,2015-02-07 04:47:31,2015-02-07 04:47:31
a5df9f84abd3c9afce2cee6906de032da5a2cd47...faa3fb07f4a2c5d02f8b46715c302aa907029baf,1,43,10,53,5,2015-02-07 05:03:23,2015-02-07 05:03:23
faa3fb07f4a2c5d02f8b46715c302aa907029baf...c0b0a6e92a9314f7cfdc89fbcc8b142ba7b135ee,2,15,4,19,5,2015-02-09 00:05:54,2015-02-09 00:05:54
c0b0a6e92a9314f7cfdc89fbcc8b142ba7b135ee...e5f73a36367f4e8c285747716e6b2ba79eec29b6,2,20,2,22,7,2015-02-09 16:29:11,2015-02-09 16:29:11
e5f73a36367f4e8c285747716e6b2ba79eec29b6...cf4e1bd4e0113027e878dcf8b2b3a542821937b8,1,7,0,7,1,2015-02-09 20:20:52,2015-02-09 20:20:52
cf4e1bd4e0113027e878dcf8b2b3a542821937b8...6f6ee635274bcd530004870bb4acd315e5e75a5e,4,421,141,562,11,2015-02-09 23:25:44,2015-02-09 23:25:31
6f6ee635274bcd530004870bb4acd315e5e75a5e...64e9eaea5b441b3cefb49fce4b46d333c35d9c3a,1,48,3,51,3,2015-02-09 23:39:32,2015-02-09 23:39:32
64e9eaea5b441b3cefb49fce4b46d333c35d9c3a...aa645f86a7d1faf7a1d64e23e855264f4fdbdda8,8,196,35,231,30,2015-02-10 01:12:24,2015-02-10 01:12:24
aa645f86a7d1faf7a1d64e23e855264f4fdbdda8...c06c94e76bf33944cc359f75c0a3c9fe743ca981,2,3,3,6,2,2015-02-10 01:20:09,2015-02-10 01:20:09
c06c94e76bf33944cc359f75c0a3c9fe743ca981...b77a2aa1f41f7ed0ce2e56ee76bb56376158932d,5,125,270,395,12,2015-02-10 04:23:19,2015-02-10 04:23:19
b77a2aa1f41f7ed0ce2e56ee76bb56376158932d...0cef7aef20b954e79356076d8f0310ed12eb731f,19,19,19,38,19,2015-02-10 05:16:25,2015-02-10 05:16:25
0cef7aef20b954e79356076d8f0310ed12eb731f...c0a9601abfeb006d50828df20ff51877762380ef,2,10,11,21,8,2015-02-10 05:54:57,2015-02-10 05:54:57
c0a9601abfeb006d50828df20ff51877762380ef...61f746989bbb67895ba901579744c6653aa831fb,19,19,19,38,19,2015-02-10 05:57:39,2015-02-10 05:57:39
61f746989bbb67895ba901579744c6653aa831fb...3ebeb5f0e6eab4e08b5ddd7771a34a257fe1180c,1,31,17,48,10,2015-02-26 04:14:40,2015-02-26 04:14:40
d7a8f44da920ae99af90dbe8db236c7e9b51baef...ed06b7585603e2bfa5dc78298821b187dfea0e68,3,47,0,47,3,2015-02-02 18:33:10,2015-02-02 18:28:13
ed06b7585603e2bfa5dc78298821b187dfea0e68...67a7a1be50598dde48e86f230bbf693d123d20e3,1,24,22,46,2,2015-02-02 18:49:36,2015-02-02 18:49:36
67a7a1be50598dde48e86f230bbf693d123d20e3...d174d0d134137dbf0c554bcd7a41bd211d5e75a7,2,3,2,5,3,2015-02-02 18:50:44,2015-02-02 18:50:44
d174d0d134137dbf0c554bcd7a41bd211d5e75a7...fe243a32689ba23da33c2348b515c566f22d1e00,2,5,1,6,3,2015-02-02 19:33:55,2015-02-02 19:33:55
fe243a32689ba23da33c2348b515c566f22d1e00...d69442177afcb27ce13f9eb30807daea90c1d507,1,1,1,2,1,2015-02-02 19:40:48,2015-02-02 19:40:48
d69442177afcb27ce13f9eb30807daea90c1d507...48f50e0f32a51f10b1f7f2b8a8c73c85dee7639f,1,1,3,4,2,2015-02-02 19:45:05,2015-02-02 19:44:33
48f50e0f32a51f10b1f7f2b8a8c73c85dee7639f...cbe5db42826bce225019e71ef4d7e6e6f46328c5,2,4,2,6,2,2015-02-02 21:23:27,2015-02-02 21:23:27
cbe5db42826bce225019e71ef4d7e6e6f46328c5...3c68cebf0de50f74efc3d9daf2c39733f0033d79,7,7,7,14,7,2015-02-02 21:38:01,2015-02-02 18:22:31
3c68cebf0de50f74efc3d9daf2c39733f0033d79...a4a764dcd1b404023fb1de5605d7415e5cc2f245,3,13,28,41,10,2015-02-02 21:38:01,2015-02-02 21:37:12
a4a764dcd1b404023fb1de5605d7415e5cc2f245...60c52bd2c82552fb7a143cdc7261c917b95e4373,4,432,0,432,4,2015-02-02 21:50:28,2014-01-08 20:29:14
60c52bd2c82552fb7a143cdc7261c917b95e4373...9e10649b18ae0d1de3071f766a4f215571b36037,1,1,1,2,1,2015-02-02 22:09:30,2015-02-02 22:09:30
9e10649b18ae0d1de3071f766a4f215571b36037...f4601b83555a40b52472463678e40e6eba071467,2,4,2,6,2,2015-02-02 22:12:10,2015-02-02 22:12:10
f4601b83555a40b52472463678e40e6eba071467...9243bfad3d38a1a3ee89d44908379125a3f392fb,4,18,14,32,9,2015-02-02 23:53:38,2015-02-02 22:10:25
9243bfad3d38a1a3ee89d44908379125a3f392fb...ce558849d36ddc914aac3fbcbb27dbdf45433bd8,1,0,4,4,1,2015-02-03 01:24:50,2015-02-03 01:24:50
ce558849d36ddc914aac3fbcbb27dbdf45433bd8...ffdb98b8f6beadc1dacac1c6068ad29eb03453ef,4,96,78,174,81,2015-02-03 02:06:58,2015-02-03 02:06:58
ffdb98b8f6beadc1dacac1c6068ad29eb03453ef...a46d590a96bc5ca6b968f1fc47245b6cd187e8f3,5,9,18,27,9,2015-02-03 03:10:09,2015-02-03 03:10:09
a46d590a96bc5ca6b968f1fc47245b6cd187e8f3...01518749b72ea7ae0925867dfd07b025ae4dd4dc,1,4,3,7,1,2015-02-03 03:28:00,2015-02-03 03:28:00
01518749b72ea7ae0925867dfd07b025ae4dd4dc...5c061025364ea98d2d67c7aad88c0fba8555cdf5,1,6,0,6,3,2015-02-03 03:45:19,2015-02-03 03:45:19
5c061025364ea98d2d67c7aad88c0fba8555cdf5...ec602d0695e50475cf27cbae2ac2040cb7ef2a6f,1,12,5,17,5,2015-02-03 04:12:26,2015-02-03 04:12:26
ec602d0695e50475cf27cbae2ac2040cb7ef2a6f...f4aa4f9037c07ab6e06d442e8303a831d5f50e94,2,2,2,4,2,2015-02-03 04:17:09,2015-02-03 04:17:09
f4aa4f9037c07ab6e06d442e8303a831d5f50e94...9ad75660e1224d4cf8572632e121d881f601af8d,2,82,34,116,34,2015-02-04 02:14:03,2015-02-04 02:14:03
9ad75660e1224d4cf8572632e121d881f601af8d...95dcc8cc587a4f666021bf8f0bc7d39bb1d0643a,1,1,1,2,1,2015-02-04 02:35:20,2015-02-04 02:35:20
95dcc8cc587a4f666021bf8f0bc7d39bb1d0643a...8232db93dc447b69dde5090007184146a8a0019c,2,4,4,8,4,2015-02-04 02:58:40,2015-02-04 02:58:40
8232db93dc447b69dde5090007184146a8a0019c...45e5f6e72122fd11b4943040357c4e1e9728472f,1,1,1,2,1,2015-02-04 03:04:32,2015-02-04 03:04:32
45e5f6e72122fd11b4943040357c4e1e9728472f...54878cc8fc1a5851690b5bcc50f676d527086f38,1,3,0,3,1,2015-02-04 20:28:32,2015-02-04 20:28:32
54878cc8fc1a5851690b5bcc50f676d527086f38...c41b111c377c6036aab5ec63b6cee4d6c8571fdb,1,13,1,14,1,2015-02-04 20:36:39,2015-02-04 20:36:39
c41b111c377c6036aab5ec63b6cee4d6c8571fdb...d459abd0bec8776f0b9976639ab51ef66b09a118,2,4,4,8,4,2015-02-04 20:44:03,2015-02-04 20:44:03
d459abd0bec8776f0b9976639ab51ef66b09a118...7b82a31b9b2cbe6797674ef8c26383237f5a8a5b,2,13,4,17,4,2015-02-04 21:08:04,2015-02-04 21:04:49
7b82a31b9b2cbe6797674ef8c26383237f5a8a5b...5570c31da74235eac8f6f2f18c403457d6c2ddb6,1,3,0,3,2,2015-02-04 21:25:20,2015-02-04 21:25:20
5570c31da74235eac8f6f2f18c403457d6c2ddb6...24830980d25d22a564d9de78ddea464e250076e8,4,39,19,58,13,2015-02-04 22:10:47,2015-02-04 22:05:45
24830980d25d22a564d9de78ddea464e250076e8...d574e5e1e2d5daa4eaf3b5c95cc86270e4fcd2b5,1,2,2,4,1,2015-02-04 22:19:54,2015-02-04 22:19:54
d574e5e1e2d5daa4eaf3b5c95cc86270e4fcd2b5...f2dd0e8c35da2b0dc6c2bbc32711d1ac596eefa4,1,7,0,7,1,2015-02-04 22:53:35,2015-02-04 22:50:04
f2dd0e8c35da2b0dc6c2bbc32711d1ac596eefa4...c70632af6b92d38d773fbcad26d11e508ab940dd,1,16,1,17,2,2015-02-04 23:21:06,2015-02-04 23:21:06
c70632af6b92d38d773fbcad26d11e508ab940dd...73341e6badff9d5cd59619334b6ea0c463bae247,2,2,2,4,2,2015-02-04 23:35:36,2015-02-04 23:35:36
bc4696454a44b54f1c4e0eba8fa8f671251379a9...eff9d45b61de9291311923a791be14cfb42e913c,1,1,3,4,2,2015-02-02 19:44:33,2015-02-02 19:44:33
eff9d45b61de9291311923a791be14cfb42e913c...843c280a5992d91a9a9e6cf1878d7296f88c5e8f,1,4,0,4,1,2015-02-04 20:05:27,2015-02-04 20:05:27
843c280a5992d91a9a9e6cf1878d7296f88c5e8f...447d9ec08c88c0e2cb78293e47c43e892da78e9c,1,2,2,4,2,2015-02-04 20:06:29,2015-02-04 20:06:29
447d9ec08c88c0e2cb78293e47c43e892da78e9c...3b934c063ab4452a7192626eb8603e1f09370b9c,1,9,12,21,1,2015-02-04 20:27:25,2015-02-04 20:25:21
3b934c063ab4452a7192626eb8603e1f09370b9c...c288fad54d3c7e0c55fd0179d0cddb2c2f715fbc,1,2,0,2,1,2015-02-04 20:29:12,2015-02-04 20:29:12
c288fad54d3c7e0c55fd0179d0cddb2c2f715fbc...4052b786910e889840a327f8aaf758a4e578432a,1,2,1,3,1,2015-02-04 20:51:57,2015-02-04 20:51:57
4052b786910e889840a327f8aaf758a4e578432a...9c20186729ae1e1ca65df434be445236e0266314,1,16,17,33,12,2015-02-04 20:57:17,2015-02-04 20:57:17
9c20186729ae1e1ca65df434be445236e0266314...1bd73d2cb31398c12aa213e74304027f1a653b2c,1,26,19,45,2,2015-02-04 21:07:57,2015-02-04 21:07:57
1bd73d2cb31398c12aa213e74304027f1a653b2c...b5e11f92c75f7c1a356f7095d3c843b79b3f78d4,3,26,30,56,10,2015-02-04 21:14:30,2015-02-02 21:37:12
b5e11f92c75f7c1a356f7095d3c843b79b3f78d4...77d266ad619215d5de4530fad89e41e186b9e3ac,1,31,20,51,9,2015-02-04 21:29:00,2015-02-04 21:29:00
77d266ad619215d5de4530fad89e41e186b9e3ac...22948862806da9ad92c4a2259c91195a931183b4,1,1,2,3,2,2015-02-04 21:30:06,2015-02-04 21:30:06
9e7a79074f99b7e6051c3bf07ca2a9c1f7e15501...4e3a8d95065887a41910509e82da58fe0bcfc3c9,1,30,22,52,16,2015-01-09 20:24:35,2015-01-09 20:24:35
4e3a8d95065887a41910509e82da58fe0bcfc3c9...132f316953bc047cc1301f8e9e591033112fcd9d,1,1,1,2,1,2015-01-09 22:38:25,2015-01-09 22:38:25
05b6ddb8ed98dce66f69fa4a158a309ad3034e81...be93ffc1d7e5ba82c65a98cc01f81c2c46ec9e51,4,33,14,47,11,2015-02-27 02:44:52,2015-02-27 02:44:52
be93ffc1d7e5ba82c65a98cc01f81c2c46ec9e51...996369e6a5b663e05bd8d8ad8910ddecfbe8ad92,1,14,2,16,5,2015-02-27 02:45:13,2015-02-27 02:45:13
05b6ddb8ed98dce66f69fa4a158a309ad3034e81...d0fc2a386f745e0e30caca561394bdd039546f8c,84,8617,42,8659,85,2015-02-24 01:16:54,2015-02-24 01:16:07
d0fc2a386f745e0e30caca561394bdd039546f8c...0eab851204334b7e0da2f29affb30c2065971504,1,3,1,4,1,2015-02-24 05:24:48,2015-01-11 21:35:27
0eab851204334b7e0da2f29affb30c2065971504...48ecdf1d542dc7671e3863d8d08a927e768cf532,1,11,4,15,2,2015-02-24 05:24:48,2015-01-11 22:20:00
48ecdf1d542dc7671e3863d8d08a927e768cf532...fa4e9c676efa74f268a0649ee09a6cfaf3f6e9ad,2,4,6,10,3,2015-02-24 05:24:49,2015-01-11 22:33:34
fa4e9c676efa74f268a0649ee09a6cfaf3f6e9ad...d49af044d24828456bbccea9021dd2a2df7f8815,1,1,1,2,1,2015-02-24 05:24:49,2015-01-18 20:31:39
d49af044d24828456bbccea9021dd2a2df7f8815...26fc3d6666d78ed99f71e1f2e2a6216782b60546,2,33,1,34,4,2015-02-24 05:35:50,2015-02-24 05:32:21
26fc3d6666d78ed99f71e1f2e2a6216782b60546...ee59870e066689e1b963938da643d8568dc4ff73,3,33,11,44,12,2015-02-24 05:42:13,2015-02-24 05:42:13
ee59870e066689e1b963938da643d8568dc4ff73...b5861c114ab2b8f76c36d9e4ed2ada84903732e4,8,128,41,169,20,2015-02-24 05:51:26,2015-01-29 23:54:56
b5861c114ab2b8f76c36d9e4ed2ada84903732e4...0e3c992fd8f178efd9e832038257ae36cec90351,3,14,31,45,12,2015-02-24 05:51:27,2015-02-03 04:15:31
7461cab72665e8dd198f97e370630f52fb2f9900...a16d0cb71a5c31df1e6def82273616300bcf2280,2,16,1,17,4,2014-12-16 22:22:23,2014-12-16 21:16:34
a16d0cb71a5c31df1e6def82273616300bcf2280...028360d2ad96cd7b854428bbbb24079d8bb95c42,2,15,5,20,2,2014-12-16 22:22:23,2014-12-16 21:24:39
5bb36203f3ef606b7ba6fc07c8bd356b1293920a...1b94d28d85a4dd78ff2108b6c214b1cf93bb90ac,1,1,1,2,1,2014-11-11 19:23:24,2014-11-11 19:23:24
5bb36203f3ef606b7ba6fc07c8bd356b1293920a...caae56a65665876926438f91faef01bff9f40232,5,64,1,65,6,2014-11-06 23:33:18,2014-11-06 23:33:18
3ef483621e64d3210e49313d26d31a7ba875b45f...beb09757c2577a045b35eca6def7f022bb342fe6,1,4,0,4,1,2014-11-06 22:28:38,2014-11-06 22:21:33
beb09757c2577a045b35eca6def7f022bb342fe6...12eb34debd1d6fda9b7f3f913c476c399be63b2f,1,11,3,14,5,2014-11-06 22:28:38,2014-11-06 22:21:51
5584bd346447007510ccd9df4de7c674f629b095...523ca13497605b212740f12de1539bc2b7fa2833,2,23,16,39,2,2014-10-16 21:29:29,2014-10-16 21:28:34
523ca13497605b212740f12de1539bc2b7fa2833...280d905db6ae3346899d83a5f00eea1d957f1df7,1,5,10,15,10,2014-10-16 21:32:17,2014-10-16 21:32:17
280d905db6ae3346899d83a5f00eea1d957f1df7...85bdcb7dcfd7909a2aae3849022a6ab7986e429e,1,2,2,4,2,2014-10-16 21:33:03,2014-10-16 21:33:03
85bdcb7dcfd7909a2aae3849022a6ab7986e429e...43f3167df8a132663012450ee0532f4e0a91de42,2,11,14,25,11,2014-10-16 21:37:04,2014-10-16 21:37:04
a1f9d3683608bf8531d7b99a4a06fd25a40f3863...ff947a2ac50b98a7398d47e0125e57621734d1dd,33,2623,111,2734,34,2014-10-07 23:49:54,2014-10-07 23:49:54
a1f9d3683608bf8531d7b99a4a06fd25a40f3863...ce15336d3ea90c54ca06fb4c9899c9f992898771,2,45,3,48,3,2014-10-07 20:53:25,2014-10-01 22:08:46
ce15336d3ea90c54ca06fb4c9899c9f992898771...8cf480abd60a20d84547b8301757ec8081ef8326,3,17,1,18,5,2014-10-07 20:53:25,2014-10-02 22:00:28
8cf480abd60a20d84547b8301757ec8081ef8326...87e3b14a8a61ab03cd7e8e872d010b489c317986,2,82,16,98,10,2014-10-07 20:53:25,2014-10-02 22:34:09
87e3b14a8a61ab03cd7e8e872d010b489c317986...9e6568a3e1e5cbfa0bec70c9efa81579470af202,1,2,2,4,2,2014-10-07 20:53:25,2014-09-28 18:17:45
9e6568a3e1e5cbfa0bec70c9efa81579470af202...ddc4bc744261ab696df8cdae0ea0341406963813,3,74,30,104,17,2014-10-07 20:53:25,2014-10-04 16:29:27
ddc4bc744261ab696df8cdae0ea0341406963813...ee65d216992bca5f01a00208161d27d582464894,2,25,9,34,5,2014-10-07 20:53:25,2014-10-07 06:08:05
ee65d216992bca5f01a00208161d27d582464894...c969263299f43c00af4eee8902e6fe372ec32d95,1,4,2,6,2,2014-10-07 20:53:25,2014-10-07 06:54:42
c969263299f43c00af4eee8902e6fe372ec32d95...afc45d8386eb3b9dabde3cc40c3a19ba49efd066,3,22,22,44,21,2014-10-07 20:53:25,2014-10-07 20:34:38
afc45d8386eb3b9dabde3cc40c3a19ba49efd066...8014a6be52af883bf683160852076f805135f195,2,2,2,4,2,2014-10-07 20:53:26,2014-10-07 20:37:26
8014a6be52af883bf683160852076f805135f195...e25670c9c5e94ac761a28e98ad5ebc353aafd047,1,11,6,17,1,2014-10-07 20:53:26,2014-10-07 20:43:18
1779d62281c4283a9d55c9703e6f54e52e78036a...13861d80e17a0923e7cd5b9b262b82e4bc1829e6,2,24,2,26,3,2014-10-07 06:26:55,2014-10-07 06:26:55
13861d80e17a0923e7cd5b9b262b82e4bc1829e6...497af45dd8b67494da6a6a600d2bae6365cc9826,1,2,2,4,2,2014-10-07 06:27:07,2014-10-07 06:27:07
497af45dd8b67494da6a6a600d2bae6365cc9826...ea0f431cb302b3c2ba2427fcc20a9eaa46af9045,1,13,1,14,2,2014-10-07 07:27:58,2014-10-07 07:27:58
ea0f431cb302b3c2ba2427fcc20a9eaa46af9045...08a0a599252d4bd5c33732bf4844039979bda950,1,6,2,8,3,2014-10-07 08:13:10,2014-10-07 08:13:10
08a0a599252d4bd5c33732bf4844039979bda950...c1ea124ca025578db2a7b1c7d52602651a2503d1,1,104,39,143,31,2014-10-07 15:36:36,2014-10-07 15:26:12
c1ea124ca025578db2a7b1c7d52602651a2503d1...6fd0b7f9da9ae4164dc58171792cc3d6860af0d0,1,30,36,66,14,2014-10-07 15:36:36,2014-10-07 15:30:48
6fd0b7f9da9ae4164dc58171792cc3d6860af0d0...a9d32c722a167d977a3e66ac1e534f8fa6d66545,1,4,0,4,2,2014-10-07 15:36:36,2014-10-07 15:36:20
a9d32c722a167d977a3e66ac1e534f8fa6d66545...f0155d2b3df7deb33522021741d7b1b42223d715,2,4,6,10,2,2014-10-07 18:45:52,2014-10-07 18:43:54
1779d62281c4283a9d55c9703e6f54e52e78036a...281c97890dbb5154b67904bf309225dcf312d3ff,2,45,3,48,3,2014-10-07 06:07:29,2014-10-01 22:08:46
281c97890dbb5154b67904bf309225dcf312d3ff...3b156fa331f9f856938670c6e58166459d841f67,3,17,1,18,5,2014-10-07 06:07:29,2014-10-02 22:00:28
3b156fa331f9f856938670c6e58166459d841f67...47c707bbf140b2f7e832b26032e8aca118fc4a5d,2,82,16,98,10,2014-10-07 06:07:29,2014-10-02 22:34:09
47c707bbf140b2f7e832b26032e8aca118fc4a5d...e3e0c3aafcb333c03101067f7b2a3d8e0e897ba9,1,2,2,4,2,2014-10-07 06:07:29,2014-09-28 18:17:45
e3e0c3aafcb333c03101067f7b2a3d8e0e897ba9...b469007d92f1cdf43b00603147c6736dcbf9681c,3,74,30,104,17,2014-10-07 06:07:29,2014-10-04 16:29:27
b469007d92f1cdf43b00603147c6736dcbf9681c...709c379f890ff38531a9d61efc3c280c877061b1,2,25,9,34,5,2014-10-07 06:55:42,2014-10-07 06:08:05
709c379f890ff38531a9d61efc3c280c877061b1...906f4b06920ac15879666ab28507e9ea8a1ac3cd,1,4,2,6,2,2014-10-07 06:57:04,2014-10-07 06:54:42
906f4b06920ac15879666ab28507e9ea8a1ac3cd...82d39508e6e4aec96099d016f79ffb18c9a065a8,3,22,22,44,21,2014-10-07 20:34:38,2014-10-07 20:34:38
82d39508e6e4aec96099d016f79ffb18c9a065a8...82da28b49c26d0d022d988f1078a8c6a9c8f1c59,2,2,2,4,2,2014-10-07 20:37:26,2014-10-07 20:37:26
82da28b49c26d0d022d988f1078a8c6a9c8f1c59...603584529dd7feade9c828d4a5673ed39135ba3e,1,11,6,17,1,2014-10-07 20:43:18,2014-10-07 20:43:18
7776e863334f8581485547b961a974089ec488b1...ea51b6a26abf4155ea9ce103af6261df6cd8954a,1,19,6,25,5,2014-10-08 22:55:07,2014-10-08 22:55:07
7776e863334f8581485547b961a974089ec488b1...1e3e65fbf53b6ff265a56907d328e9cbc29fb102,1,7,3,10,3,2014-10-08 22:26:36,2014-10-08 20:26:24
1e3e65fbf53b6ff265a56907d328e9cbc29fb102...2d73bc082f0daab0fb1a636183cf2a3dd588fcc3,1,15,15,30,15,2014-10-08 22:26:43,2014-10-08 18:50:21
2d73bc082f0daab0fb1a636183cf2a3dd588fcc3...c09f52d89b13e752e05da2871ba0590240ec869c,1,1,1,2,1,2014-10-08 22:26:49,2014-10-08 18:19:17
c09f52d89b13e752e05da2871ba0590240ec869c...9fd8b1cd47f6c9f03879427abf471f3d9be49738,1,4,4,8,2,2014-10-08 22:26:54,2014-10-08 18:09:02
9fd8b1cd47f6c9f03879427abf471f3d9be49738...d8923c5874afa2587a3db9166a5fb8adeec52b57,1,7,7,14,7,2014-10-08 22:27:03,2014-10-08 02:25:57
d8923c5874afa2587a3db9166a5fb8adeec52b57...d8bd9264d7ea5b3a1f09e110e507f996b9c88337,1,4,3,7,1,2014-10-08 22:27:11,2014-10-08 17:59:41
50bf28b1d08c230ebdb835bad0db48728a789393...08b262508298a0b9ce27f8f5883707815eaa2a73,15,40,40,80,35,2014-08-25 01:46:37,2014-08-25 01:46:37
08b262508298a0b9ce27f8f5883707815eaa2a73...d30efc2ae8c5b0061715a73bb14c5ea0eacee028,1,10,4,14,2,2014-08-25 02:01:24,2014-08-25 02:01:24
d30efc2ae8c5b0061715a73bb14c5ea0eacee028...ac7915b90b688a41dc12b9c1263876e077ff87c4,1,8,0,8,3,2014-08-25 02:31:33,2014-08-25 02:31:33
ac7915b90b688a41dc12b9c1263876e077ff87c4...24d844a808927bfe999fc7a97718f34e89bf6cc1,2,77,52,129,13,2014-08-25 02:51:41,2014-08-25 02:43:09
24d844a808927bfe999fc7a97718f34e89bf6cc1...9ee39f2807ef2afaf366410b492522966fb4f148,1,4,0,4,1,2014-08-25 02:54:44,2014-08-25 02:54:44
9ee39f2807ef2afaf366410b492522966fb4f148...d4280a22eb6b157fb5852502b12221ebf96e80d7,2,14,7,21,5,2014-08-25 03:18:43,2014-08-25 03:18:43
d4280a22eb6b157fb5852502b12221ebf96e80d7...0a47309ce642d68db7b3698812b6b2a324e190b6,1,1,1,2,1,2014-08-25 03:52:00,2014-08-25 03:52:00
0a47309ce642d68db7b3698812b6b2a324e190b6...a247b79aa1b031be54dd021ba689989d5ed5667b,3,3,3,6,3,2014-08-25 04:17:58,2014-08-25 04:17:58
a247b79aa1b031be54dd021ba689989d5ed5667b...0542a3a9ea655e9651ae1480bb5e482d553f7f01,4,5,5,10,5,2014-08-25 04:21:09,2014-08-25 04:21:09
0542a3a9ea655e9651ae1480bb5e482d553f7f01...15fae4ecf1eeba659143d7593b3cc86464d797d0,2,12,1,13,2,2014-08-25 06:55:09,2014-08-25 06:55:09
dae257b04f0533bcc737a86c598d4f61cdca7bb2...18ea49a8c283b52e8c5071dffdb6ed88d3d1ac71,3,110,0,110,3,2014-02-12 23:26:50,2014-01-09 21:41:00
18ea49a8c283b52e8c5071dffdb6ed88d3d1ac71...f8886744a109a0e88a04ecb5be12d1325a4d3a6e,3,38,1,39,4,2014-02-12 23:26:50,2014-01-04 00:03:59
f8886744a109a0e88a04ecb5be12d1325a4d3a6e...0be15bdf3ff04b4776107f5a5d5571dacb2d3c03,4,16,11,27,8,2014-02-12 23:26:50,2014-01-03 23:32:48
0be15bdf3ff04b4776107f5a5d5571dacb2d3c03...de294ddb1984f76278da86947b35525291fc5298,3,19,19,38,7,2014-02-12 23:26:50,2014-01-04 00:16:19
de294ddb1984f76278da86947b35525291fc5298...d1e03a58deea6045952daf4b65678ef327bcec68,1,10,4,14,4,2014-02-12 23:34:26,2014-02-12 23:34:26
d1e03a58deea6045952daf4b65678ef327bcec68...c16c1c1e1965520c55f545534be4475729015270,1,3,3,6,2,2014-02-12 23:35:03,2014-02-12 23:35:03
c16c1c1e1965520c55f545534be4475729015270...c51ea383de78cec2fe54ce4663c5ff57d42b9c6e,1,2,0,2,1,2014-02-12 23:36:06,2014-02-12 23:36:06
601f007922680f23d9af73966c3ad6057adaa7cd...64b401a91f3e31ebc1db8ef8a4ca8b7a6bf1330e,1,1,1,2,1,2015-03-19 02:19:58,2015-03-19 02:19:58
64b401a91f3e31ebc1db8ef8a4ca8b7a6bf1330e...548bfee09fb26ef07d50d39860777ba0f1621219,1,8,1,9,2,2015-03-19 02:50:22,2015-03-19 02:50:22
548bfee09fb26ef07d50d39860777ba0f1621219...f9ef109d88d829cd8ecac1d45b4d1b6c14363b46,1,1,1,2,1,2015-03-19 02:52:22,2015-03-19 02:52:22
f9ef109d88d829cd8ecac1d45b4d1b6c14363b46...25038261f8a69e1482329fa96a64a025ab4bfef4,1,1,1,2,1,2015-03-19 03:12:36,2015-03-19 03:12:36
8ac310b9db204ccb74039b691aae6962d5799fe9...d9926b516a36f4b0acfdb6850bdc1de4ef979867,7,436,0,436,7,2015-03-18 01:10:34,2015-03-18 01:10:34
d9926b516a36f4b0acfdb6850bdc1de4ef979867...b1348c2eadf3fc211a39c7563b8487d349ec746c,1,4,9,13,4,2015-03-18 01:13:47,2015-03-18 01:13:47
b1348c2eadf3fc211a39c7563b8487d349ec746c...4cdba9d840dfa123233b328ebee82a0aa5cacdbb,1,3,3,6,2,2015-03-18 01:15:13,2015-03-18 01:15:13
4cdba9d840dfa123233b328ebee82a0aa5cacdbb...f9f1d4797f4445c8d20ed9abdf6c8c9332016b68,1,7,8,15,2,2015-03-18 01:16:53,2015-03-18 01:16:53
f9f1d4797f4445c8d20ed9abdf6c8c9332016b68...785729711c28d0666a0ebf92388540bfb20afb09,1,15,1,16,2,2015-03-18 01:18:53,2015-03-18 01:18:53
785729711c28d0666a0ebf92388540bfb20afb09...b7c12b7580b9debf0ede1fe9909af2c1442cc7fa,10,265,67,332,14,2015-03-18 19:41:07,2015-03-18 19:41:07
b7c12b7580b9debf0ede1fe9909af2c1442cc7fa...d188ac8897746cafa5cd6dc8e480fdcd9eab26ba,1,0,2,2,1,2015-03-18 19:49:23,2015-03-18 19:49:23
d188ac8897746cafa5cd6dc8e480fdcd9eab26ba...d336cfe71d95c6915070cb644b7efe382371729e,1,2,0,2,1,2015-03-18 19:50:02,2015-03-18 19:50:02
d336cfe71d95c6915070cb644b7efe382371729e...37b855634f96d4d72a7fd2163d7fc0d92db20e83,1,1,1,2,1,2015-03-18 19:50:30,2015-03-18 19:50:30
023fe49a1bcee76947cb0395a0b5dd93d27b17f0...cfc4015f61a861c373bcd17b9eddd8696736d44f,1,14,0,14,1,2015-02-26 19:48:47,2015-02-25 23:09:07
cfc4015f61a861c373bcd17b9eddd8696736d44f...2f2ba3979ca109c32467a44400b31d6152b6a470,5,73,11,84,10,2015-02-26 19:48:47,2015-02-26 01:38:51
2f2ba3979ca109c32467a44400b31d6152b6a470...874b3ff74d0ce2119ae06a663cb9c5e7ef046e9c,1,15,3,18,5,2015-02-26 19:48:47,2015-02-26 19:26:56
874b3ff74d0ce2119ae06a663cb9c5e7ef046e9c...9129bd542174bead94384da047c5e3d34acad8be,1,14,4,18,2,2015-02-26 19:48:47,2015-02-26 19:46:15
9129bd542174bead94384da047c5e3d34acad8be...3e59a1bf8c029a980aecd1a50e9996faf61aa6be,2,13,3,16,4,2015-02-26 19:48:47,2015-02-26 19:46:56
312b6afbc614775de0534f8037efd21afeee2164...1d828b5a160e3d0a3c6a5dcb71c9e5e490cf6f3d,1,1,1,2,1,2015-02-27 22:33:15,2015-02-27 22:32:35
1d828b5a160e3d0a3c6a5dcb71c9e5e490cf6f3d...4265cf8c44036b7545b8d4d49659669af03f1705,1,5,14,19,3,2015-02-28 00:29:24,2015-02-28 00:29:24
4265cf8c44036b7545b8d4d49659669af03f1705...4af325b2221a50d34959d8f021be19d2d03197c5,1,34,0,34,1,2015-03-02 23:12:21,2015-03-02 23:12:21
4af325b2221a50d34959d8f021be19d2d03197c5...cbff5271314b683f2ab861201fb61d080920f93d,1,15,3,18,3,2015-03-03 00:01:31,2015-03-03 00:01:31
8ac477a19baef0dfc0f37937be221c31acc00a34...e08d6e8812ebfc86ecedf32b63811763d1f824e1,2,2,4,6,2,2015-01-26 21:43:13,2015-01-26 21:43:13
e08d6e8812ebfc86ecedf32b63811763d1f824e1...dbd6fdaaa0bed41565ec9ebeadae87219e67b69b,5,25,1,26,5,2015-01-26 21:50:59,2015-01-26 21:50:59
dbd6fdaaa0bed41565ec9ebeadae87219e67b69b...7c0bed72f456b2c4e66082e6f584187ef2c27095,5,295,136,431,10,2015-01-26 23:10:52,2015-01-26 23:10:52
7c0bed72f456b2c4e66082e6f584187ef2c27095...5756bcf674d422351de965f7d28c10d926f4b82e,1,53,1,54,4,2015-01-27 00:04:35,2015-01-27 00:04:35
8ac477a19baef0dfc0f37937be221c31acc00a34...be11590dbe1275e430fe637e51e27bd6d7587442,1,1,1,2,1,2015-01-24 00:33:10,2015-01-21 22:44:51
be11590dbe1275e430fe637e51e27bd6d7587442...2bd8eae66b0c13fc7deeeb473a71bd14bec90d9c,1,4,3,7,2,2015-01-24 00:33:10,2015-01-21 23:08:54
2bd8eae66b0c13fc7deeeb473a71bd14bec90d9c...d4e1f80bf737d18039a83e58b6468b3b772ffa59,1,5,1,6,2,2015-01-24 00:43:52,2015-01-24 00:43:52
d4e1f80bf737d18039a83e58b6468b3b772ffa59...806ecd827b0d9f1fa236125bf017e22123d7978a,1,4,2,6,1,2015-01-24 00:44:02,2015-01-24 00:44:02
806ecd827b0d9f1fa236125bf017e22123d7978a...71af635a2579f0ce9914951c3ce5455f21d482ca,1,4,3,7,1,2015-01-24 00:47:49,2015-01-24 00:47:49
71af635a2579f0ce9914951c3ce5455f21d482ca...6bb55160100920d58a26fbbb42493eefe09f5433,1,4,0,4,1,2015-01-24 00:49:19,2015-01-24 00:49:19
8ac477a19baef0dfc0f37937be221c31acc00a34...72887bb0ee95d3358846814f80117ec16b0c0eb9,1,4,3,7,1,2015-01-23 23:05:34,2015-01-23 23:05:34
72887bb0ee95d3358846814f80117ec16b0c0eb9...a769371e5b16d4b211d0b990e9b31343aa301563,2,39,17,56,7,2015-01-24 00:51:22,2015-01-23 23:45:42
a769371e5b16d4b211d0b990e9b31343aa301563...7ec339e5b822368a1c02d87b7d563bcf6541331a,2,29,0,29,2,2015-01-24 00:57:13,2015-01-24 00:57:13
7ec339e5b822368a1c02d87b7d563bcf6541331a...99ca826040f420db7093a0996cc393e2c5354ca3,3,34,24,58,16,2015-01-26 23:19:56,2015-01-26 23:19:56
99ca826040f420db7093a0996cc393e2c5354ca3...5862ec036336be1e7d341eec88742fc729cb452b,1,5,1,6,2,2015-01-26 23:52:44,2015-01-26 23:52:44
5862ec036336be1e7d341eec88742fc729cb452b...b0ecad0ce2e3a36e9bce59727fe5546911c4fd3f,2,11,2,13,2,2015-01-27 00:16:30,2015-01-27 00:16:07
b0ecad0ce2e3a36e9bce59727fe5546911c4fd3f...f2840103ca23dedd458524ad4e01609069ce28cb,2,60,0,60,4,2015-01-27 00:44:50,2015-01-27 00:41:18
f2840103ca23dedd458524ad4e01609069ce28cb...7201dbe84ce52fed065a05ea209ecd36f721d1f4,1,1,1,2,1,2015-01-28 18:06:38,2015-01-28 18:06:38
050fae168f012f0e256b46a1de77f9f06b26fe36...55c788a62ffe500d85166e64d7583d1c639110b4,1,3,3,6,2,2015-03-03 19:42:24,2015-03-03 19:42:24
55c788a62ffe500d85166e64d7583d1c639110b4...73306afa062dea6eb1c0308577f5bfdc119b9675,2,33,1,34,2,2015-03-03 19:45:44,2015-03-03 19:45:44
73306afa062dea6eb1c0308577f5bfdc119b9675...8c095667e8daa8502bebff3722abd94962f1b0ea,2,2,16,18,4,2015-03-03 19:56:17,2015-03-03 19:56:17
8c095667e8daa8502bebff3722abd94962f1b0ea...faa07c3e2961201bc5b6770da7c64f8e0d33f796,1,79,33,112,12,2015-03-03 20:47:47,2015-03-03 20:47:47
faa07c3e2961201bc5b6770da7c64f8e0d33f796...f97f8f516a3ad3b8a9c7de1cd164873673b1adf8,1,34,10,44,10,2015-03-03 21:06:55,2015-03-03 21:06:55
f97f8f516a3ad3b8a9c7de1cd164873673b1adf8...8f84a605232fe0c5fc66f49f7b22c03949156285,2,20,13,33,8,2015-03-04 17:11:57,2015-03-04 17:11:57
8f84a605232fe0c5fc66f49f7b22c03949156285...1a648cf4c4bab6bcc98e81f4d2d50fd30576dccd,1,100,44,144,15,2015-03-04 18:06:37,2015-03-04 18:06:37
1a648cf4c4bab6bcc98e81f4d2d50fd30576dccd...7ca88892e45c2e27acddf91ae06230827c278e42,1,3,1,4,1,2015-03-04 18:10:42,2015-03-04 18:10:42
7ca88892e45c2e27acddf91ae06230827c278e42...db1e2ec82391125146a06c5b35b82287725c4e8d,1,6,5,11,5,2015-03-04 18:55:23,2015-03-04 18:55:23
db1e2ec82391125146a06c5b35b82287725c4e8d...b4da76a7e868731a3933e98dabe7b89d57a06fa0,1,18,8,26,9,2015-03-04 22:22:45,2015-03-04 22:22:45
b4da76a7e868731a3933e98dabe7b89d57a06fa0...8789a91d5880d1c28db3823939e3178dd9d58009,2,24,8,32,6,2015-03-05 00:45:42,2015-03-05 00:45:42
8789a91d5880d1c28db3823939e3178dd9d58009...023d471831f2f440798418f7ccc2cd032c65d8d2,1,15,1,16,5,2015-03-05 01:46:14,2015-03-05 01:46:14
023d471831f2f440798418f7ccc2cd032c65d8d2...90c6b3e1bbddbc8694b00cb129aa80cc79694a6e,3,15,9,24,10,2015-03-05 16:23:24,2015-03-05 16:23:24
90c6b3e1bbddbc8694b00cb129aa80cc79694a6e...9869245b8e58f2475fa30004b83c7e7a100c6c7f,1,8,2,10,2,2015-03-05 16:48:09,2015-03-05 16:48:09
9869245b8e58f2475fa30004b83c7e7a100c6c7f...a84f89c0079e169dba70cf2b8bfb00c581ca74eb,2,0,4,4,2,2015-03-05 19:43:06,2015-03-05 19:43:06
a84f89c0079e169dba70cf2b8bfb00c581ca74eb...f34e06e69c139d46449fd29164bf1e7cf3bd064f,8,46,39,85,23,2015-03-05 19:43:31,2015-03-05 19:43:31
f34e06e69c139d46449fd29164bf1e7cf3bd064f...a5c08b57dec79e1eeae357f3fefe9c7a41df0777,3,19,19,38,12,2015-03-05 19:53:46,2015-03-05 19:53:46
a5c08b57dec79e1eeae357f3fefe9c7a41df0777...d34fc87d9b28125189fd48e03e7b83952142d1e7,1,9,9,18,4,2015-03-06 01:55:42,2015-03-06 01:55:42
d34fc87d9b28125189fd48e03e7b83952142d1e7...cc91f8e896eb716138bbae6c2dd20a561e8e547b,4,215,150,365,47,2015-03-06 02:59:51,2015-03-06 02:59:51
cc91f8e896eb716138bbae6c2dd20a561e8e547b...930a55f8559c16ebb61a22362ac8ecea159c32c1,1,90,89,179,35,2015-03-06 20:11:49,2015-03-06 20:11:49
930a55f8559c16ebb61a22362ac8ecea159c32c1...a78393b1e71628e804619db9aec21829a7971a07,4,74,10,84,13,2015-03-06 20:47:34,2015-03-06 20:47:34
a78393b1e71628e804619db9aec21829a7971a07...da14f8d9a2232233ffbaf0c2f3e4984099012fc9,1,1,1,2,1,2015-03-06 20:49:14,2015-03-06 20:49:14
da14f8d9a2232233ffbaf0c2f3e4984099012fc9...eda46a28247f828d66fef916fd7e74c195e03001,2,78,65,143,17,2015-03-06 23:53:31,2015-03-06 23:53:31
eda46a28247f828d66fef916fd7e74c195e03001...e27840aa24f63ba49cf9d6105bb6f61597d53216,1,19,0,19,2,2015-03-07 00:04:38,2015-03-07 00:04:38
e27840aa24f63ba49cf9d6105bb6f61597d53216...ade555d90333dcba7a4c678b2d26c69be37f09aa,2,20,10,30,7,2015-03-07 00:29:56,2015-03-07 00:29:56
ade555d90333dcba7a4c678b2d26c69be37f09aa...d9725e2361162c262cbb19c784074f17ac5b3471,1,42,2,44,3,2015-03-07 00:55:36,2015-03-07 00:55:36
d9725e2361162c262cbb19c784074f17ac5b3471...f3d3df862418f59295d57253ea2a70a1737b5d1b,1,1,1,2,1,2015-03-07 01:02:44,2015-03-07 01:02:44
a75cae93edbdc6c329bcebd3ab5210a5a4575dc5...75f344e6a1af0cbbb646198c6a82f5abc4808c85,1,2,2,4,2,2015-02-05 02:49:20,2015-02-05 02:49:00
75f344e6a1af0cbbb646198c6a82f5abc4808c85...49bd963f7c099256df020833c00261dd45a71723,1,1,1,2,1,2015-02-05 02:51:40,2015-02-05 02:51:40
49bd963f7c099256df020833c00261dd45a71723...fe7611b01b9fae38819dd82b8f8a1501d159752e,1,6,1,7,2,2015-02-05 03:01:18,2015-02-05 03:01:18
fe7611b01b9fae38819dd82b8f8a1501d159752e...152b9576a2c339888d6f51269f8a450b801dc021,1,2,1,3,1,2015-02-05 03:11:27,2015-02-05 03:11:27
152b9576a2c339888d6f51269f8a450b801dc021...367edfc60e1cd6c93cd63bbcd7ae1c1c8798d874,1,1,1,2,1,2015-02-05 03:15:39,2015-02-05 03:15:39
367edfc60e1cd6c93cd63bbcd7ae1c1c8798d874...c614ebd107e3c013e1ffe22a309e7dd6f3cbe2e9,5,20,13,33,9,2015-02-05 04:25:27,2015-02-05 04:18:29
c614ebd107e3c013e1ffe22a309e7dd6f3cbe2e9...d7b5eb3fbd6d1a2f8c66b6c526a1937896ae4c47,1,4,0,4,1,2015-02-05 04:44:10,2015-02-05 04:43:42
d7b5eb3fbd6d1a2f8c66b6c526a1937896ae4c47...2190a8c226e6be7c7eb9f37bbf4b1d210af6344a,1,1,1,2,1,2015-02-05 04:44:40,2015-02-05 04:44:40
2190a8c226e6be7c7eb9f37bbf4b1d210af6344a...824ec3a13f84b77a7ed7c9d698a9367cffe4161b,1,1,1,2,1,2015-02-05 04:54:12,2015-02-05 04:54:12
824ec3a13f84b77a7ed7c9d698a9367cffe4161b...32f34fb2af944a78d9501d045a56dda5f9a6dbcf,1,11,4,15,6,2015-02-05 07:52:43,2015-02-05 07:52:43
32f34fb2af944a78d9501d045a56dda5f9a6dbcf...59b1e145c67f01bf06abc3733e88025f6cd00557,15,119,75,194,72,2015-02-05 08:12:09,2015-02-05 08:10:38
59b1e145c67f01bf06abc3733e88025f6cd00557...23e249e3928056911ea8ced933940668c313fb52,4,5,5,10,5,2015-02-05 08:12:10,2015-02-05 08:11:33
b3cb7a49f7d2890002da067389872e1291ecf7a1...e0c24cf7e40dc9eb8d3c3e326df91afc6080d9d2,1,4,2,6,1,2015-02-04 22:33:08,2015-02-04 22:33:08
e0c24cf7e40dc9eb8d3c3e326df91afc6080d9d2...868ce3594eda94fef71429f9da58bdc6a3dbfc93,1,31,27,58,10,2015-02-04 22:33:17,2015-02-04 22:33:17
868ce3594eda94fef71429f9da58bdc6a3dbfc93...486495aed802f8e6b39a5102c898685cb530b612,6,6,12,18,6,2015-02-04 22:41:12,2015-02-04 22:39:01
132f316953bc047cc1301f8e9e591033112fcd9d...6dc8d5a0a82a481ca89680523959cf1f0287e3fc,1,4,1,5,1,2015-01-09 23:18:46,2014-11-06 04:00:03
6dc8d5a0a82a481ca89680523959cf1f0287e3fc...1f3741cba202e132fc68eca3bbf828b6b0d2b7b8,2,8,1,9,2,2015-01-09 23:31:30,2015-01-09 23:31:30
132f316953bc047cc1301f8e9e591033112fcd9d...e86101bf7b616a08b776da0ff39fc623e046c1e9,3,30,4,34,13,2015-01-09 23:13:36,2015-01-09 23:13:36
de052f11f835e3e7f3075b5b483186ba499ae10f...f6dfcc4032349576e91b7f7eb0f47e684989d307,1,1,1,2,1,2015-02-27 03:01:30,2015-02-27 03:01:30
f6dfcc4032349576e91b7f7eb0f47e684989d307...13e98f5a4ad85b6caf5dc3778f3e29aa3c500f30,3,10,19,29,4,2015-02-27 04:13:46,2015-02-27 04:13:46
13e98f5a4ad85b6caf5dc3778f3e29aa3c500f30...385a16ab1658203eb672d08f034d32a9dfdf9dfb,1,7,7,14,7,2015-02-27 19:44:04,2015-02-27 19:44:04
385a16ab1658203eb672d08f034d32a9dfdf9dfb...0c0cbe12be82318d75ae587c8dde67432ffa4354,2,3,4,7,3,2015-02-27 20:00:25,2015-02-27 19:34:58
7bfa78a7bf6549d2a370bb75be1d7b6e42a46212...c8c84f5a9c6ebf7a50de6d9b43c3d5ccce55cf49,23,6027,5428,11455,31,2015-02-25 04:01:07,2015-02-24 21:06:13
c8c84f5a9c6ebf7a50de6d9b43c3d5ccce55cf49...b6f9bf5976ba283d62c0c06b442da11e42000fbe,3,9,5,14,5,2015-02-25 05:01:13,2015-02-25 05:01:13
b6f9bf5976ba283d62c0c06b442da11e42000fbe...bafde7f94cd0f19a33f5243c57de19ce7ef541ac,2,3,3,6,3,2015-02-25 05:02:35,2015-02-25 05:02:35
bafde7f94cd0f19a33f5243c57de19ce7ef541ac...1aba87016273ab2a4ddb724f46205add5001ec3b,1,2,0,2,1,2015-02-25 05:06:38,2015-02-25 05:06:38
1aba87016273ab2a4ddb724f46205add5001ec3b...798e6c2e8babe6f6aa5e852f2c68d0ac735e7044,1,5,0,5,3,2015-02-25 05:09:25,2015-02-25 05:09:25
798e6c2e8babe6f6aa5e852f2c68d0ac735e7044...bf68f0f50ede8e9c37e9b835ed2ec58c42ce6e1a,1,0,558,558,1,2015-02-25 05:10:28,2015-02-25 05:10:28
bf68f0f50ede8e9c37e9b835ed2ec58c42ce6e1a...62ac82c8359dfdddde2b61882a5ddf29076bf8f8,15,15,15,30,15,2015-02-25 05:16:41,2015-02-25 05:11:31
62ac82c8359dfdddde2b61882a5ddf29076bf8f8...1448770bb0d0d1fb74587a529feff6784d959876,1,1,1,2,1,2015-02-25 05:18:47,2015-02-25 05:18:47
7bfa78a7bf6549d2a370bb75be1d7b6e42a46212...d0ddf5cd9b6b8771a1e9f9e5bb3f506bddfaabd7,1,4,4,8,4,2015-02-24 21:57:20,2015-02-21 01:44:55
d0ddf5cd9b6b8771a1e9f9e5bb3f506bddfaabd7...5cbe84e9175928f909afc9b78dc3060c89c6334f,1,3,6,9,1,2015-02-25 01:14:56,2015-02-25 01:14:01
f954b6109d44fd8e514872900704dd173574f6f5...98003cbc3dce537f21e761f83628dd2a954ee76a,1,3,0,3,1,2014-12-16 22:29:11,2014-12-16 22:29:11
98003cbc3dce537f21e761f83628dd2a954ee76a...f9b7fa19a61cb69aff81fcc80c467af296c24ca3,3,4,5,9,4,2014-12-17 00:24:58,2014-12-16 19:07:37
f9b7fa19a61cb69aff81fcc80c467af296c24ca3...3b569ab33d9a30a866a4680e229d3e78a064ae97,2,3,3,6,3,2014-12-17 00:25:25,2014-12-16 23:26:18
3b569ab33d9a30a866a4680e229d3e78a064ae97...c3a23698fe81fa5c6aa388d37a518418b0d5a9ab,1,16,4,20,5,2014-12-17 00:25:25,2014-12-17 00:23:12
c3a23698fe81fa5c6aa388d37a518418b0d5a9ab...b7c4ca6ac1ffde1f2d68b803975ff38cdd222464,1,17,40,57,19,2014-12-17 00:42:08,2014-12-17 00:42:08
b7c4ca6ac1ffde1f2d68b803975ff38cdd222464...64645d872731ae51504bbcfc7e9986b26603c1ca,1,11,8,19,3,2014-12-17 01:04:53,2014-12-17 01:04:53
64645d872731ae51504bbcfc7e9986b26603c1ca...06f65cff503750dac9486ffc70ca2d40e3182f6d,3,20,3,23,6,2014-12-17 01:46:59,2014-12-17 01:45:51
06f65cff503750dac9486ffc70ca2d40e3182f6d...74bf18809c4b77932081a68ceaf74cbea95e76c8,3,11,21,32,4,2014-12-17 05:09:29,2014-12-17 05:08:26
74bf18809c4b77932081a68ceaf74cbea95e76c8...542bc6455ec71a5bd1166efdbbfaf4264851b3e8,1,0,13,13,2,2014-12-17 08:13:06,2014-12-17 07:36:38
542bc6455ec71a5bd1166efdbbfaf4264851b3e8...f6f4803a9a65b714facfd30eeae0d5b820acac98,5,32,47,79,22,2014-12-17 08:13:07,2014-12-17 07:44:12
f6f4803a9a65b714facfd30eeae0d5b820acac98...6a55c35837fe2a9c92312fc99a16ea736421d1fc,3,77,41,118,12,2014-12-17 08:13:07,2014-12-17 07:59:59
6a55c35837fe2a9c92312fc99a16ea736421d1fc...bd54f09e4ce299035c2ad57e02f558d64f6b0a93,1,16,11,27,3,2014-12-17 08:14:25,2014-12-17 08:05:50
bd54f09e4ce299035c2ad57e02f558d64f6b0a93...972cb847ffca3f0535c3e50e9f8987ab2122a49e,1,3,3,6,1,2014-12-17 08:36:57,2014-12-17 08:36:22
972cb847ffca3f0535c3e50e9f8987ab2122a49e...c2ce95fd11ca37ca1a9e7d129a0b4d7768bab494,2,58,142,200,10,2014-12-17 17:50:54,2014-12-17 17:46:01
c2ce95fd11ca37ca1a9e7d129a0b4d7768bab494...6f41fe9b4d08c56eec4e2b708de808153b95678f,1,0,3,3,2,2014-12-17 17:55:00,2014-12-17 17:55:00
6f41fe9b4d08c56eec4e2b708de808153b95678f...745de90b4e59c6d77d95db44a89840bf132d19d2,1,11,20,31,5,2014-12-17 21:55:06,2014-12-17 21:00:01
745de90b4e59c6d77d95db44a89840bf132d19d2...9c2883695333d412e750d1e774dae92e4c04d66e,1,34,20,54,8,2014-12-17 21:59:20,2014-12-17 21:46:11
9c2883695333d412e750d1e774dae92e4c04d66e...53808bc684eb4f5ba8ebc0c3c2677762dac159a9,1,1,4,5,1,2014-12-17 22:06:32,2014-12-17 21:55:41
6f32ebc5858ff2bccb6db5c8cb6a4b725c6a534f...49533d35ca59b93e9bee19c6b9579f7792b4e452,1,5,1,6,1,2014-11-15 05:58:09,2014-11-15 05:58:09
49533d35ca59b93e9bee19c6b9579f7792b4e452...f8783d4461c2d0d7276f818c85d9ead42d23d334,3,16,30,46,9,2014-11-15 06:34:34,2014-11-15 06:34:34
f8783d4461c2d0d7276f818c85d9ead42d23d334...34b1f5b4282893aa9b1c5df4fee51eb6050b9bd6,1,11,0,11,1,2014-11-15 07:53:17,2014-11-15 07:53:17
34b1f5b4282893aa9b1c5df4fee51eb6050b9bd6...a11c8d8e09eb66b0f41196e1717e8dee603d0930,1,1,1,2,1,2014-11-17 01:50:52,2014-11-17 01:50:52
a11c8d8e09eb66b0f41196e1717e8dee603d0930...917ccbe967c8d04610fdfe4b06e8f4d9bf41bf1c,1,4,2,6,1,2014-11-17 16:42:29,2014-11-17 16:42:29
5253e2b9ac9142ef582a8951233d86bf32becdee...0d80637f054edfa98dc41c347c64b1368692bb16,2,10,61,71,8,2014-11-15 05:47:34,2014-11-15 05:47:34
dc36a14cd7dc4d6364869ac508a75ab8708b2584...8b0a745d3029ea2476b208690971762035533857,1,4,6,10,4,2014-11-11 19:59:38,2014-11-11 09:12:34
8b0a745d3029ea2476b208690971762035533857...352af3b8e02b1dcc7dd24dfde8f2cdbb513c541a,1,14,16,30,5,2014-11-12 00:48:19,2014-11-12 00:48:19
352af3b8e02b1dcc7dd24dfde8f2cdbb513c541a...4aa33782fa334c419de3cad8d32efd06cbff5611,2,52,28,80,8,2014-11-12 01:28:30,2014-11-12 01:27:50
4aa33782fa334c419de3cad8d32efd06cbff5611...c426ffe8995d28de03a6c65d26b66dffb104aff0,2,51,4,55,4,2014-11-12 02:08:49,2014-11-11 20:49:17
c426ffe8995d28de03a6c65d26b66dffb104aff0...3f4cf649b1d29297557aa54c39a47f66671ce7db,1,1,1,2,1,2014-11-12 22:18:42,2014-11-12 22:18:42
3f4cf649b1d29297557aa54c39a47f66671ce7db...d2881cfea22158de0ab7ba90538afb1a30856eaf,1,8,0,8,1,2014-11-12 23:28:44,2014-11-12 23:28:44
d2881cfea22158de0ab7ba90538afb1a30856eaf...be644e474ee4cac3c92807a04a7a47ba6ed23666,1,2,2,4,2,2014-11-12 23:31:10,2014-11-12 23:31:10
be644e474ee4cac3c92807a04a7a47ba6ed23666...d320f9c134bdcc0ea810915a88cea01d4ddf8d96,1,13,11,24,10,2014-11-12 23:41:26,2014-11-12 23:41:26
12eb34debd1d6fda9b7f3f913c476c399be63b2f...1ae869fdfa9f7c71fcf06a91a5cce40746751fc8,1,2,2,4,2,2014-11-07 22:52:57,2014-11-07 15:42:26
12eb34debd1d6fda9b7f3f913c476c399be63b2f...e014e6e2cb3771373680e17efee94617a42dd8c6,14,56,50,106,20,2014-11-07 00:25:45,2014-11-06 20:21:38
e014e6e2cb3771373680e17efee94617a42dd8c6...6130ffbb51f4bedfe90aebb139d81c495d7e9989,1,19,12,31,4,2014-11-07 00:25:51,2014-11-06 20:24:10
6130ffbb51f4bedfe90aebb139d81c495d7e9989...7a33a567d37609736420343ac4541ae72bb582eb,4,143,12,155,14,2014-11-07 00:25:51,2014-11-06 20:34:02
7a33a567d37609736420343ac4541ae72bb582eb...69e73f04186172fb132e805318bd38ef8fdd9e4a,2,28,88,116,18,2014-11-07 00:25:51,2014-11-06 22:06:38
69e73f04186172fb132e805318bd38ef8fdd9e4a...0f114c8fe411d4cb422cee55a66aa36f48b87f90,2,17,11,28,4,2014-11-07 00:25:51,2014-11-06 22:51:33
0f114c8fe411d4cb422cee55a66aa36f48b87f90...da1e47690e65b32679ac8e18aaa001f7db07b8c6,12,72,137,209,30,2014-11-07 03:33:57,2014-11-06 23:12:19
da1e47690e65b32679ac8e18aaa001f7db07b8c6...87085484428ce2d4b728dca53d47f0808ffb81a7,25,151,143,294,71,2014-11-07 03:34:18,2014-11-06 23:23:59
87085484428ce2d4b728dca53d47f0808ffb81a7...5bf810bc3573c67a383bd66cf47d14b786421b12,6,5,26,31,15,2014-11-07 03:34:20,2014-11-06 23:46:13
5bf810bc3573c67a383bd66cf47d14b786421b12...0f9f848910b5c48249924015504113b7ac74464a,1,28,34,62,12,2014-11-07 03:34:20,2014-11-06 23:53:09
0f9f848910b5c48249924015504113b7ac74464a...0ae13c709e3cf9de3defead0a9c3c2bba2ff2b9c,1,8,1,9,1,2014-11-07 03:34:21,2014-11-06 23:59:21
0ae13c709e3cf9de3defead0a9c3c2bba2ff2b9c...fb02e4e27f6cb758d8c81dbf2eaf0ae0bb926007,2,14,3,17,5,2014-11-07 03:34:21,2014-11-07 00:07:43
43f3167df8a132663012450ee0532f4e0a91de42...d38619ae9235f47f11d11568f236b244afb1fb63,1,126,104,230,19,2014-10-16 21:40:40,2014-10-16 21:40:40
43f3167df8a132663012450ee0532f4e0a91de42...d2b8606afd716b19071a0b76f7231ad1cd7dc0a0,2,1,28,29,4,2014-10-16 21:40:07,2014-10-16 21:39:39
6a700adce612c6eb590b5158cb473b239f69b20a...6a6bb529bbb372217f4def30dec81c1c9e356eea,1,1,1,2,1,2014-10-08 00:13:43,2014-10-08 00:13:37
b8df57c3a6d9da538c3d5c306af4d2bd1827e4c0...d83002cd64f422e8a10b1a67c6309a8ee88fc3a2,1,21,5,26,6,2014-10-07 21:16:06,2014-10-07 21:15:42
d83002cd64f422e8a10b1a67c6309a8ee88fc3a2...74101370771ab4b0bc4606dd6e7fbf3e91e044b8,1,4,1,5,4,2014-10-07 21:21:28,2014-10-07 21:21:28
74101370771ab4b0bc4606dd6e7fbf3e91e044b8...85a11d7ff9f27014984bb80b69941cb21dd6b17f,1,13,1,14,3,2014-10-07 21:36:07,2014-10-07 21:35:29
85a11d7ff9f27014984bb80b69941cb21dd6b17f...18f36bd3c4993f1e87ce3f143a94b872fbf88b14,1,11,1,12,2,2014-10-07 21:51:45,2014-10-07 21:48:04
18f36bd3c4993f1e87ce3f143a94b872fbf88b14...d9b91417c06baefb82e3bc5bc4dffe43bf628a25,2,31,21,52,8,2014-10-07 22:06:04,2014-10-07 22:04:07
d9b91417c06baefb82e3bc5bc4dffe43bf628a25...e32101edb159a45693ca60f418fcce73efdb21cf,1,20,10,30,4,2014-10-07 22:12:20,2014-10-07 22:11:59
e32101edb159a45693ca60f418fcce73efdb21cf...5d2bd77d96e2b958b6bb7a4a5baa1dca104c12a3,1,1,1,2,1,2014-10-07 22:19:02,2014-10-07 21:15:56
5d2bd77d96e2b958b6bb7a4a5baa1dca104c12a3...c99d7d42a6a2a5db95d26fae96032ac27f135573,1,4,0,4,1,2014-10-07 22:20:32,2014-10-07 22:19:34
c99d7d42a6a2a5db95d26fae96032ac27f135573...c19e133b8b7cf61b045f7e4b0838da3ed0932e33,2,8,2,10,4,2014-10-07 22:26:56,2014-10-07 22:26:15
c19e133b8b7cf61b045f7e4b0838da3ed0932e33...a22a5a3341cb8ddee720afe6ef137cfb557027be,1,3,1,4,2,2014-10-07 22:46:45,2014-10-07 22:36:07
a22a5a3341cb8ddee720afe6ef137cfb557027be...14f452e7338c34fa32e36acd0bf580825b7a60b7,1,1,1,2,1,2014-10-07 22:49:56,2014-10-07 22:49:35
a0a4c44fb4f723dc82c44599b06683189e1b9b50...6c8b0832d7429486829e54327ef9f4393630c3f2,1,72,2,74,4,2014-10-08 23:04:13,2014-10-08 23:03:29
6c8b0832d7429486829e54327ef9f4393630c3f2...1df375d3a21c6de42a54c83ce8130e979d2c2095,2,49,50,99,8,2014-10-09 00:21:44,2014-10-09 00:05:18
1df375d3a21c6de42a54c83ce8130e979d2c2095...e7820b5fbf7839003d95b61cd40cf911517d46ca,1,1,5,6,1,2014-10-09 00:25:48,2014-10-09 00:25:48
15fae4ecf1eeba659143d7593b3cc86464d797d0...2d5e3bb745f7287430ba1eb49d76a496295dc70b,1,8,0,8,1,2014-08-25 16:38:52,2014-08-25 15:30:09
2d5e3bb745f7287430ba1eb49d76a496295dc70b...175fd7c3b4212fdc077dc0a9955267c1c1e7ccc4,1,5,7,12,1,2014-08-25 16:42:21,2014-08-25 16:42:21
175fd7c3b4212fdc077dc0a9955267c1c1e7ccc4...25398a60ef80c66b440a07c5ff0dce644a3dc405,1,72,0,72,3,2014-08-25 17:57:58,2014-08-25 17:57:58
25398a60ef80c66b440a07c5ff0dce644a3dc405...8f0dc28c0d4df98336ac0c5db4eb7c613b00863f,2,7,4,11,6,2014-08-25 18:05:01,2014-08-25 18:05:01
8f0dc28c0d4df98336ac0c5db4eb7c613b00863f...5b92dfd85ff056da7663d2e6f78b5748fc7529e2,2,38,10,48,3,2014-08-25 18:17:57,2014-08-25 18:16:42
5b92dfd85ff056da7663d2e6f78b5748fc7529e2...231f74bbb68f66a4f9b7fb443c1a0e8148d53b32,1,12,24,36,1,2014-08-25 19:05:30,2014-08-25 19:05:30
231f74bbb68f66a4f9b7fb443c1a0e8148d53b32...0ce077f3508f14f244b779fc0b52bbffc690cb64,2,2,3,5,2,2014-08-25 19:07:15,2014-08-25 19:05:40
0ce077f3508f14f244b779fc0b52bbffc690cb64...d5e659b5e419e106582b5f384c1b0fabadb34604,1,5,2,7,1,2014-08-25 19:14:10,2014-08-25 19:14:10
d5e659b5e419e106582b5f384c1b0fabadb34604...4482427da5f2de8e8e77c39ec06aa977864c3570,1,2,2,4,2,2014-08-25 19:31:37,2014-08-25 19:31:37
4482427da5f2de8e8e77c39ec06aa977864c3570...2e259e61c2739dc11e9fd7d679f7a1807a4651c1,1,14,14,28,8,2014-08-25 20:47:08,2014-08-25 20:47:08
2e259e61c2739dc11e9fd7d679f7a1807a4651c1...b161bf1c41e97282f13c76d8ac5902d9d57bd840,1,8,0,8,1,2014-08-25 20:50:59,2014-08-25 20:49:57
b161bf1c41e97282f13c76d8ac5902d9d57bd840...106bde81632aebe2563528437186a21ef77cbbcb,4,26,17,43,7,2014-08-25 21:00:04,2014-08-25 20:57:58
106bde81632aebe2563528437186a21ef77cbbcb...6c7a29683c4de6e2b59714fc50afc9586fce796b,2,3,3,6,2,2014-08-25 21:06:50,2014-08-25 21:06:50
6c7a29683c4de6e2b59714fc50afc9586fce796b...ca7217bc18d19ca0d3504ffc0d6cfd567392d709,2,16,5,21,2,2014-08-25 21:13:05,2014-08-25 21:13:05
ca7217bc18d19ca0d3504ffc0d6cfd567392d709...02317e669fa4597f5fa7e23d91091a82f837091f,1,14,14,28,5,2014-08-25 21:16:18,2014-08-25 21:09:34
02317e669fa4597f5fa7e23d91091a82f837091f...0d7a99b03dee865003e62ca13eec15b32b17d29a,1,16,15,31,7,2014-08-25 21:16:18,2014-08-25 21:16:09
0d7a99b03dee865003e62ca13eec15b32b17d29a...f0890205aef83c5d65d94f2f033c9e08fce2f46e,2,3,3,6,2,2014-08-25 21:17:56,2014-08-25 21:13:51
f0890205aef83c5d65d94f2f033c9e08fce2f46e...59177d7ad5a1202db5610c2ffab27682a0d7bac5,1,119,3,122,2,2014-08-25 21:21:46,2014-08-25 21:21:46
59177d7ad5a1202db5610c2ffab27682a0d7bac5...5ab9a66b29145e04879e910d927b3aa3d44652a1,1,2,1,3,1,2014-08-25 21:32:25,2014-08-25 21:32:25
5ab9a66b29145e04879e910d927b3aa3d44652a1...4e017c59382b5017dbcbee7542f44f7989aaa9b6,2,5,4,9,3,2014-08-25 21:33:52,2014-08-25 21:33:52
4e017c59382b5017dbcbee7542f44f7989aaa9b6...25ca18a2662653a0903b50bbfa3b6aa0ff33c68a,1,2,2,4,2,2014-08-25 21:35:02,2014-08-25 21:35:02
f3b5aacb0dfc384249b4ab9353b5c4cd49e59c66...57779c7cbeab9efb62a2062f55505fc969796bcc,4,10,3,13,4,2014-02-12 23:47:06,2014-02-01 00:20:47
5b1b8e03b1468929b90a634095b0678168aa6a62...55348de0784d9c51da12c05a76ed74eb8064c0d9,1,3,0,3,1,2014-02-13 01:50:42,2014-02-13 01:24:10
c6cc72e6e87d8a5a9311e95d53424aa63bfd9da0...a4d85bb42cf25879f154fba5b647778f503984a4,1,1,1,2,1,2015-02-26 19:53:32,2015-02-26 19:53:32
a4d85bb42cf25879f154fba5b647778f503984a4...83c65e718f94f8940fa653a2218cbe2d61ec79ee,145,4,4,8,4,2015-02-26 20:09:30,2015-02-26 20:09:30
83c65e718f94f8940fa653a2218cbe2d61ec79ee...b587efdab5c42c94591cc4dbed2f7dc6dcf8fbd5,4,20,17,37,4,2015-02-26 22:10:39,2015-02-26 22:10:39
cbff5271314b683f2ab861201fb61d080920f93d...eeeb3d9f3a6b8953ad394f8858951750ed57e011,1,2,2,4,2,2015-03-03 00:27:15,2015-03-03 00:27:15
eeeb3d9f3a6b8953ad394f8858951750ed57e011...89e037325935ce8e0113278c703d8c763dd4f6e6,1,12,0,12,1,2015-03-03 00:34:04,2015-03-03 00:34:04
89e037325935ce8e0113278c703d8c763dd4f6e6...d8a3f9145b7766ac90ce3351e50120cd1b09ff13,5,209,98,307,84,2015-03-03 01:42:01,2015-03-03 01:42:01
d8a3f9145b7766ac90ce3351e50120cd1b09ff13...4de0ef6f61894de6449dc164a5d50930c818c4e3,1,1,1,2,1,2015-03-03 01:54:33,2015-03-03 01:54:33
4de0ef6f61894de6449dc164a5d50930c818c4e3...362757b9ba67c8a1f3ff5f980c0f92940640280b,1,1,0,1,1,2015-03-03 01:54:55,2015-03-03 01:54:55
362757b9ba67c8a1f3ff5f980c0f92940640280b...b53774637dc840f3776449b904c95abfe2e17e71,1,8,8,16,3,2015-03-03 03:37:34,2015-03-03 03:37:34
b53774637dc840f3776449b904c95abfe2e17e71...83232139512654dff358ceb001827d318e6cf06a,1,1,3,4,1,2015-03-03 05:55:00,2015-03-03 05:55:00
83232139512654dff358ceb001827d318e6cf06a...c4be008a70c7d31fd633f15c25f9400d44a68eb8,2,4,4,8,3,2015-03-03 17:56:23,2015-03-03 17:56:12
c4be008a70c7d31fd633f15c25f9400d44a68eb8...aa32cd1e2eb84740ff1693ea1a76eabb26c8a5ea,1,1,1,2,1,2015-03-03 18:09:21,2015-03-03 18:09:09
aa32cd1e2eb84740ff1693ea1a76eabb26c8a5ea...47f463d6b6dac6305fd9a02aea3c5d2e41492e72,1,6,2,8,1,2015-03-03 19:06:13,2015-03-03 19:06:13
47f463d6b6dac6305fd9a02aea3c5d2e41492e72...af50b4cc5b55a958607b427a8f35e33cb8967f30,3,441,405,846,20,2015-03-03 19:27:04,2015-02-24 17:09:32
af50b4cc5b55a958607b427a8f35e33cb8967f30...5dce3be167c2a626ad1c8a34fc8e564181e17dd0,1,34,5,39,5,2015-03-03 21:36:07,2015-02-25 06:05:09
5dce3be167c2a626ad1c8a34fc8e564181e17dd0...112cd395de99edbe33b04eeb980a0e6146d1658d,1,0,2,2,2,2015-03-03 21:59:33,2015-03-01 16:20:16
112cd395de99edbe33b04eeb980a0e6146d1658d...241565c40ba5f2d8775458bd76a07fb23d8a1910,1,1,1,2,1,2015-03-03 23:29:13,2015-03-03 23:28:33
241565c40ba5f2d8775458bd76a07fb23d8a1910...c47f0d8a677009a746ad4375cc4c826d771e07ae,1,1,1,2,1,2015-03-03 23:49:38,2015-03-03 23:49:38
8a39b84e49a4e327e7547f3b605752d405e42ef0...10173c0ca53cf323e189954e9b138be9a7f834c1,2,15,15,30,2,2015-01-24 00:58:33,2015-01-24 00:58:33
10173c0ca53cf323e189954e9b138be9a7f834c1...02f799e041501a34982ad77e34ac0c3eae6a24a8,1,8,7,15,2,2015-01-24 01:06:44,2015-01-24 01:06:44
06de4ae80349b739899cbe1bd78398c5ae0a9dd5...d2d05bedf586077bf4990c62b144435bffad8a8a,1,3,1,4,1,2015-01-28 18:15:23,2015-01-28 18:15:23
d2d05bedf586077bf4990c62b144435bffad8a8a...368e8798a79107b4269d5ba64ec02eb3ef0c1997,1,9,0,9,1,2015-01-28 18:21:24,2015-01-28 18:21:24
368e8798a79107b4269d5ba64ec02eb3ef0c1997...6b0f3d03b6d01ea7927df374fcc0b2b24753331d,1,4,3,7,1,2015-01-28 18:43:09,2015-01-28 18:43:09
6b0f3d03b6d01ea7927df374fcc0b2b24753331d...58d921e92620f220dc73d49792f791add873caaf,1,2,1,3,1,2015-01-28 19:06:28,2015-01-28 18:54:01
58d921e92620f220dc73d49792f791add873caaf...07dc77ee5cd327ed90503cd52507af2959bc2c01,1,1,1,2,1,2015-01-28 19:28:55,2015-01-28 19:28:55
07dc77ee5cd327ed90503cd52507af2959bc2c01...633cfc21ae05f175f4edc8a01beb9afcb5d4b52c,1,5,1,6,1,2015-01-28 19:31:53,2015-01-28 19:31:53
633cfc21ae05f175f4edc8a01beb9afcb5d4b52c...361a80c2434fa201cb1bf65365043a0269b16e54,10,44,395,439,28,2015-01-29 00:45:01,2015-01-29 00:28:31
361a80c2434fa201cb1bf65365043a0269b16e54...5e029ba736bcdcf9b2e6fb6a6919b42778487c34,5,213,29,242,14,2015-01-29 05:47:22,2015-01-29 05:46:59
5e029ba736bcdcf9b2e6fb6a6919b42778487c34...b6e804f5ef3d011f7dd53fab8dc210a2f9a695d1,2,13,3,16,3,2015-01-29 06:13:11,2015-01-29 06:13:11
b6e804f5ef3d011f7dd53fab8dc210a2f9a695d1...36dfb1dc832c678d4cc806e870f3136f715e223a,1,2,1,3,1,2015-01-29 06:14:57,2015-01-29 06:14:57
36dfb1dc832c678d4cc806e870f3136f715e223a...e2ad1fdbbfca316896eeccfad6af6e87ed2fc331,1,1,1,2,1,2015-01-29 06:18:10,2015-01-29 06:18:10
e2ad1fdbbfca316896eeccfad6af6e87ed2fc331...d047be739e974f7635a414a0df2e87f62e3f4302,1,1,1,2,1,2015-01-29 17:09:48,2015-01-29 17:09:48
d047be739e974f7635a414a0df2e87f62e3f4302...d75f1889d75efa6a40c5699746985ea956ce54ae,1,11,4,15,3,2015-01-29 17:24:35,2015-01-29 17:24:35
d75f1889d75efa6a40c5699746985ea956ce54ae...26ebc8219807f0a535ea7f3cba67933d366b0d6c,1,4,4,8,3,2015-01-29 19:41:00,2015-01-29 19:41:00
26ebc8219807f0a535ea7f3cba67933d366b0d6c...15b2569f79ec71e0b8e3efb3be9687facbb12574,6,12,6,18,6,2015-01-29 21:52:11,2015-01-29 21:52:11
f3d3df862418f59295d57253ea2a70a1737b5d1b...20e308163b8a135765f0d12bc2aa883a77d5ec04,1,1,1,2,1,2015-03-07 02:35:31,2015-03-07 02:35:31
20e308163b8a135765f0d12bc2aa883a77d5ec04...eb9698ae7ba65144d2a1d1d40c0dac22f8a8d14f,3,25584,0,25584,3,2015-03-07 02:42:50,2015-03-07 02:42:50
eb9698ae7ba65144d2a1d1d40c0dac22f8a8d14f...5810fd6c81d3bbdb6bb7be01f0628ea89df75a14,4,126,68,194,32,2015-03-10 05:20:34,2015-03-10 04:59:04
5810fd6c81d3bbdb6bb7be01f0628ea89df75a14...de5e67356add808c97c470d0ba8cdf17fb4db33e,2,75,22,97,15,2015-03-10 06:15:25,2015-03-10 06:15:25
de5e67356add808c97c470d0ba8cdf17fb4db33e...979554ab554c828de788436c10facab3c03b99a7,3,69,19,88,21,2015-03-10 06:44:47,2015-03-10 06:44:47
979554ab554c828de788436c10facab3c03b99a7...76cf2f28adcd6e66cfa0587f1a7f8b70a83e7e09,2,11,4,15,3,2015-03-10 06:50:48,2015-03-10 06:50:48
76cf2f28adcd6e66cfa0587f1a7f8b70a83e7e09...b68f91db994fc1e8df262222d7ba7f1ca62bddf7,1,1,1,2,1,2015-03-10 07:09:09,2015-03-10 07:09:09
b68f91db994fc1e8df262222d7ba7f1ca62bddf7...f0c817f4e46ce7ab40c704a6a9418f54b1801877,1,31,14,45,6,2015-03-10 07:23:10,2015-03-10 07:23:10
f0c817f4e46ce7ab40c704a6a9418f54b1801877...1a2953cf4d2e51aadef9814384f5f7579fec24ef,1,146,0,146,1,2015-03-10 07:50:12,2015-03-10 07:50:12
1a2953cf4d2e51aadef9814384f5f7579fec24ef...e6b0b999da542a388d98d4a171ac10219caa943d,1,20,2,22,1,2015-03-10 08:10:28,2015-03-10 08:10:28
e6b0b999da542a388d98d4a171ac10219caa943d...e7702f284eaa3375ba998af3f24a6af31c922922,2,8,8,16,8,2015-03-10 08:37:58,2015-03-10 08:37:58
e7702f284eaa3375ba998af3f24a6af31c922922...454af5d50777092fd8f3777ccb91a3132400efbd,3,12,6,18,6,2015-03-10 08:40:25,2015-03-10 08:40:25
23e249e3928056911ea8ced933940668c313fb52...2499daa4dd8b4760a5ed85fd57c54cb274ad6a9d,4,28,5,33,7,2015-02-06 01:32:36,2015-02-06 01:32:36
2499daa4dd8b4760a5ed85fd57c54cb274ad6a9d...1f3766a03ba9d0bbb5e5fe1cd1d7f1912863d65e,1,6,1,7,3,2015-02-06 02:08:35,2015-02-06 01:39:34
23e249e3928056911ea8ced933940668c313fb52...d4e90d500834e11e68e40e0dbb4904994ed1b5b8,2,28,8,36,9,2015-02-05 09:27:30,2015-02-05 09:08:09
d4e90d500834e11e68e40e0dbb4904994ed1b5b8...d3bf1c2cac6b8e7fa9ddb488c02c785a14a4be9f,1,48,12,60,5,2015-02-05 09:27:30,2015-02-05 09:26:51
d3bf1c2cac6b8e7fa9ddb488c02c785a14a4be9f...85dcd56628f64af99a43aa8ad78f78d96c155cd7,1,18,0,18,1,2015-02-05 18:56:25,2015-02-05 18:56:25
85dcd56628f64af99a43aa8ad78f78d96c155cd7...4d3938c5b0442c2afe09961a4d03b3a4e49e9351,2,5,1,6,4,2015-02-05 19:00:17,2015-02-05 19:00:17
4d3938c5b0442c2afe09961a4d03b3a4e49e9351...23c684ae5dfb1a701974e3eec032c54b95767d96,2,32,23,55,5,2015-02-05 19:38:10,2015-02-05 19:37:31
23c684ae5dfb1a701974e3eec032c54b95767d96...af0f1ba8049f9e096dcb0df846f4cc175159cf48,1,4,5,9,3,2015-02-05 19:49:39,2015-02-05 19:45:51
af0f1ba8049f9e096dcb0df846f4cc175159cf48...4220aed72fe9cdbdc10d676b2fc9c5fd59f2839d,1,3,3,6,3,2015-02-05 19:49:39,2015-02-05 19:49:22
4220aed72fe9cdbdc10d676b2fc9c5fd59f2839d...3cf16b9bf37cb20490992b475559b2f54acf7b1a,1,5,3,8,3,2015-02-05 19:51:07,2015-02-05 19:51:07
3cf16b9bf37cb20490992b475559b2f54acf7b1a...7e8e87308ccf03a114793deb095f22be6ebe0975,1,2,2,4,1,2015-02-05 19:52:31,2015-02-05 19:52:31
7e8e87308ccf03a114793deb095f22be6ebe0975...6622ac35e1ca2aac83fe1087d3aa0cdba1463100,1,2,1,3,1,2015-02-05 19:53:43,2015-02-05 19:53:43
6622ac35e1ca2aac83fe1087d3aa0cdba1463100...4e2671ec7bafcf7c8f6ccc20a12aa9951ee4c6cc,1,7,5,12,4,2015-02-05 20:00:17,2015-02-05 20:00:17
4e2671ec7bafcf7c8f6ccc20a12aa9951ee4c6cc...bc0dec8593586fe5df76fa99e04553cef57cf49c,1,1,1,2,1,2015-02-05 20:01:53,2015-02-05 20:01:53
bc0dec8593586fe5df76fa99e04553cef57cf49c...68565d4adece63fcceb3926a86e6d610cd84654a,1,1,1,2,1,2015-02-05 20:04:30,2015-02-05 20:04:30
68565d4adece63fcceb3926a86e6d610cd84654a...7b8147761b0f0ed0148c160b3052202f4f388ea0,1,5,3,8,2,2015-02-05 20:12:47,2015-02-05 20:12:47
7b8147761b0f0ed0148c160b3052202f4f388ea0...adc5e40fb74ad2f1b4bea172a1214d46d2e6686c,1,36,26,62,4,2015-02-05 22:05:17,2015-02-05 21:51:00
adc5e40fb74ad2f1b4bea172a1214d46d2e6686c...25e69e8492d5393b54f168678d7129b2245dbb9d,1,1,1,2,1,2015-02-05 22:05:17,2015-02-05 22:04:26
25e69e8492d5393b54f168678d7129b2245dbb9d...2c1e27d9731145ce0b65b293d6ee0251bbd1055e,1,11,0,11,1,2015-02-05 22:05:17,2015-02-05 22:04:59
2c1e27d9731145ce0b65b293d6ee0251bbd1055e...5fc10cd5cbaeb7d250ba9d33e7670d7527bb94c1,2,26,0,26,12,2015-02-05 22:51:05,2015-02-05 22:51:05
5fc10cd5cbaeb7d250ba9d33e7670d7527bb94c1...d9d8147a3d22a06d4510bbff396c55e2e01d1e49,3,17,11,28,7,2015-02-05 23:00:35,2015-02-05 23:00:35
d9d8147a3d22a06d4510bbff396c55e2e01d1e49...f4da8d49276c6952d1aa2608e66c666803a871b6,1,27,18,45,1,2015-02-05 23:09:11,2015-02-05 23:09:11
f4da8d49276c6952d1aa2608e66c666803a871b6...810eaa573d9488a63ca14336b75d7a7f6fa45345,1,1,0,1,1,2015-02-05 23:11:51,2015-02-05 23:11:51
810eaa573d9488a63ca14336b75d7a7f6fa45345...91667d927f6d68cecef34271c3f08076db213c80,1,7,2,9,2,2015-02-05 23:16:58,2015-02-05 23:16:58
91667d927f6d68cecef34271c3f08076db213c80...cbac505a12d0ca60fb1ce5fe2eb554a445e9b5c1,1,8,8,16,2,2015-02-05 23:19:53,2015-02-05 23:19:53
cbac505a12d0ca60fb1ce5fe2eb554a445e9b5c1...a470dc99c2a2757e72cea3d6f282e73b5fe41883,1,5,1,6,2,2015-02-05 23:31:50,2015-02-05 23:31:50
a470dc99c2a2757e72cea3d6f282e73b5fe41883...5948763bbbae288b7ff44174550484c6e3a81c61,7,66,23,89,17,2015-02-06 00:07:49,2015-02-06 00:07:49
5948763bbbae288b7ff44174550484c6e3a81c61...dff3bf1d43b80bafd91425058740a917460df5fd,1,2,4,6,2,2015-02-06 00:14:59,2015-02-06 00:14:59
dff3bf1d43b80bafd91425058740a917460df5fd...e6419e7cfe26cbda8b78e4f5ed413e6604f3f6c3,1,6,3,9,3,2015-02-06 00:17:53,2015-02-06 00:17:53
e6419e7cfe26cbda8b78e4f5ed413e6604f3f6c3...7ff1f6b2d21e038ba17131c5598a7560feb792e7,2,22,10,32,9,2015-02-06 00:25:44,2015-02-06 00:25:44
7ff1f6b2d21e038ba17131c5598a7560feb792e7...b0f51a62f3f78ce0541a389e8c044cc86907e86e,1,3,1,4,3,2015-02-06 00:27:29,2015-02-06 00:27:29
b0f51a62f3f78ce0541a389e8c044cc86907e86e...312d395daac43c8666aaef6a33454179ac9c0838,1,2,2,4,1,2015-02-06 00:29:49,2015-02-06 00:29:49
312d395daac43c8666aaef6a33454179ac9c0838...a04ac580e9c583c66f6e51f0fb1f55d6d0745363,2,369,417,786,16,2015-02-06 00:33:21,2015-02-06 00:33:21
a04ac580e9c583c66f6e51f0fb1f55d6d0745363...4eb73b3984f3b99da0a0ab5f448081254d58f396,5,5,6,11,6,2015-02-06 00:40:14,2015-02-06 00:40:14
4eb73b3984f3b99da0a0ab5f448081254d58f396...8c4925519a353cd64c0f38a7cd1349b2d736e2a8,1,1,1,2,1,2015-02-06 00:56:22,2015-02-06 00:56:22
8c4925519a353cd64c0f38a7cd1349b2d736e2a8...599f6b4f379188f180796aa9226af7defedc564b,2,9,4,13,5,2015-02-06 01:02:19,2015-02-06 01:02:19
13de1a81abf8a563eccac8feebde4d5a9e75b63d...27cf3f550b844e2c73391b2111007999f53e6db5,2,205,136,341,34,2015-02-05 00:39:36,2015-02-03 18:24:08
27cf3f550b844e2c73391b2111007999f53e6db5...75f86e16e4ade5f9edc95c14859ceb4be5d34b63,1,13,0,13,1,2015-02-05 00:39:40,2015-02-03 18:40:29
75f86e16e4ade5f9edc95c14859ceb4be5d34b63...5091b87c59c3ac06e483ac7e69d7b9b02aa1ef53,1,4,30,34,5,2015-02-05 00:39:40,2015-02-03 18:27:14
5091b87c59c3ac06e483ac7e69d7b9b02aa1ef53...dd4bbc28c04a9a0e2963d9c5b3b86793615c3f8e,1,29,7,36,7,2015-02-05 00:39:41,2015-02-04 22:16:26
dd4bbc28c04a9a0e2963d9c5b3b86793615c3f8e...5b6f4de2f4321f6a04e1a0d711ccdb6ce5656b2b,1,2,0,2,1,2015-02-05 00:39:41,2015-02-05 00:01:30
5b6f4de2f4321f6a04e1a0d711ccdb6ce5656b2b...0d865bc538bcdf39ee8591c02a65b4011e274c8e,1,1,1,2,1,2015-02-05 01:06:52,2015-02-05 01:04:28
1f3741cba202e132fc68eca3bbf828b6b0d2b7b8...d8c6aa5c829b45a4720e27112202900a1e68d279,1,20,2,22,2,2015-01-09 23:54:28,2015-01-09 23:50:40
1f3741cba202e132fc68eca3bbf828b6b0d2b7b8...5aba89119933676a854d97513ea3b435ff307a31,1,4,0,4,1,2015-01-09 23:49:04,2014-08-10 18:47:47
5aba89119933676a854d97513ea3b435ff307a31...f319109634f41892977e786ad184ec127868ffed,1,7,4,11,2,2015-01-09 23:49:04,2014-08-10 18:53:15
f319109634f41892977e786ad184ec127868ffed...056e0acbd0ef79c782376f890e1b0ac4dd2646ee,1,4,0,4,1,2015-01-09 23:49:04,2014-08-10 18:55:41
056e0acbd0ef79c782376f890e1b0ac4dd2646ee...9023cccc28e3606bd539aa2b7a1863125a3d2b73,3,16,10,26,4,2015-01-09 23:53:49,2015-01-09 23:53:49
1448770bb0d0d1fb74587a529feff6784d959876...bb10386326c3ca9a0c43538fc6a13097b7b8d3e1,1,2,2,4,2,2015-02-25 05:47:36,2015-02-25 05:47:36
5cbe84e9175928f909afc9b78dc3060c89c6334f...d5a278ddfca30fb8a591147a67fd7b146cb7a212,1,9,11,20,5,2015-02-25 02:02:21,2015-02-24 22:29:09
53808bc684eb4f5ba8ebc0c3c2677762dac159a9...b04509389e8ddef0551b3d1a2e0589b112beae53,1,12,2,14,2,2014-12-18 06:19:56,2014-12-18 04:56:42
917ccbe967c8d04610fdfe4b06e8f4d9bf41bf1c...728ac6938185f30ef89665c2eb4e28de5161a465,3,142,1,143,4,2014-11-18 03:17:23,2014-11-18 03:17:23
728ac6938185f30ef89665c2eb4e28de5161a465...b61ec1877f2c1c48b18b1c457b22321d55d0b0c1,1,44,7,51,5,2014-11-18 19:40:19,2014-11-18 19:40:19
b61ec1877f2c1c48b18b1c457b22321d55d0b0c1...8d610795fd0cd9bea946c1783e928d8fb71e9304,1,10,2,12,2,2014-11-18 19:46:08,2014-11-16 06:55:22
8d610795fd0cd9bea946c1783e928d8fb71e9304...3dafc2e80a7c37d819a409c3a09832d6a0e8e6e9,3,204,7,211,13,2014-11-18 22:20:28,2014-11-18 22:20:28
917ccbe967c8d04610fdfe4b06e8f4d9bf41bf1c...6b8221d0f9862f2d4d07db0600cec0486c104db3,1,2,1,3,1,2014-11-17 21:44:13,2014-10-23 16:28:29
6b8221d0f9862f2d4d07db0600cec0486c104db3...2548eba93ae059fbe095192c7544715afcfd0c39,3,13,9,22,7,2014-11-18 00:49:59,2014-11-18 00:48:53
2548eba93ae059fbe095192c7544715afcfd0c39...2cb7d51d2129249cab5dbde2345fea49c9ea1a9a,2,4,51,55,4,2014-11-18 01:11:32,2014-11-18 01:11:32
2cb7d51d2129249cab5dbde2345fea49c9ea1a9a...88477358ac44f7901eeb79d1ed583094c1eed5f6,2,3,1,4,2,2014-11-18 01:27:29,2014-11-18 01:14:33
88477358ac44f7901eeb79d1ed583094c1eed5f6...f404f282753fd4bb2f02b9761485dc7f7146aebf,1,2,9,11,2,2014-11-18 22:02:07,2014-11-18 22:02:07
f404f282753fd4bb2f02b9761485dc7f7146aebf...e281442835db7dce04ebda43f66381fb51235393,1,2,1,3,1,2014-11-18 22:28:28,2014-11-18 22:28:28
e281442835db7dce04ebda43f66381fb51235393...b1ba8c3a64a2f8845311be2a5902d727e99d36ac,1,1,1,2,1,2014-11-21 20:43:01,2014-11-21 20:43:01
b1ba8c3a64a2f8845311be2a5902d727e99d36ac...f15f56fff74f46a2e3a42ceb240f96ed08fb90f1,2,2,2,4,2,2014-11-22 01:37:15,2014-11-22 00:09:54
f15f56fff74f46a2e3a42ceb240f96ed08fb90f1...a1237ba1a8a14edb1682f144b0bdfcea1c27f526,1,1,1,2,1,2014-11-22 19:17:21,2014-11-22 19:17:21
d320f9c134bdcc0ea810915a88cea01d4ddf8d96...1956f7b9c7df0b44313d1195bc4a1a9bf40158a5,1,0,6,6,1,2014-11-12 23:57:59,2014-10-29 01:07:43
1956f7b9c7df0b44313d1195bc4a1a9bf40158a5...3a54db35c69fd6da923a9b30368a861bfd1f46bf,3,5,73,78,7,2014-11-12 23:58:00,2014-10-29 01:08:43
3a54db35c69fd6da923a9b30368a861bfd1f46bf...cea791f7c997ef413e5203ab3d600b7e3fef326d,1,17,29,46,4,2014-11-12 23:58:00,2014-10-29 01:09:08
cea791f7c997ef413e5203ab3d600b7e3fef326d...f9766a123f90dcca16b46a0ea2c5b7771c5c4f43,3,34,62,96,17,2014-11-12 23:58:00,2014-10-29 01:10:34
f9766a123f90dcca16b46a0ea2c5b7771c5c4f43...5eb32ab334a7f512d6b5149d765a9c47de8cc422,2,6,9,15,5,2014-11-13 00:14:45,2014-10-29 01:35:27
5eb32ab334a7f512d6b5149d765a9c47de8cc422...3a61be67ab5a10e2ed519159ea67585f7798d881,1,21,4,25,4,2014-11-13 00:14:45,2014-10-29 01:44:37
3a61be67ab5a10e2ed519159ea67585f7798d881...45eea35a9580f7fea519c602ac9c4ebbed98e9b0,1,4,0,4,2,2014-11-13 00:19:50,2014-11-13 00:19:50
1ae869fdfa9f7c71fcf06a91a5cce40746751fc8...9cab094f184c155d6065069d00062c6b298ff2ed,14,56,50,106,20,2014-11-08 00:45:57,2014-11-06 20:21:38
9cab094f184c155d6065069d00062c6b298ff2ed...acdf9d9c679965fe87f278d0da0f8e9501ffff91,1,19,12,31,4,2014-11-08 00:45:57,2014-11-06 20:24:10
acdf9d9c679965fe87f278d0da0f8e9501ffff91...4000dfb993a97c6741869b78ab64a9182aad659d,4,143,12,155,14,2014-11-08 00:45:58,2014-11-06 20:34:02
4000dfb993a97c6741869b78ab64a9182aad659d...6f9d9475cdf14dc4c297ec7d3cf7946d1faaa6e3,2,28,88,116,18,2014-11-08 00:45:58,2014-11-06 22:06:38
6f9d9475cdf14dc4c297ec7d3cf7946d1faaa6e3...f2bac4b7d453a8772aae071156b64031eede0ab2,2,17,11,28,4,2014-11-08 00:45:58,2014-11-06 22:51:33
f2bac4b7d453a8772aae071156b64031eede0ab2...97f6a0236e4db7faad88c8505f7f13ac33da11a1,12,72,137,209,30,2014-11-08 00:45:58,2014-11-06 23:12:19
97f6a0236e4db7faad88c8505f7f13ac33da11a1...170c0acad76cea287e67e46153964abcd75c63d9,25,151,143,294,71,2014-11-08 00:45:58,2014-11-06 23:23:59
170c0acad76cea287e67e46153964abcd75c63d9...4079c2276f3c5a396d9e22da562113ce588b8c39,6,5,26,31,15,2014-11-08 00:45:58,2014-11-06 23:46:13
4079c2276f3c5a396d9e22da562113ce588b8c39...3e985a83c75be53c2e20881dad2052d2a96ef793,1,28,34,62,12,2014-11-08 00:45:58,2014-11-06 23:53:09
3e985a83c75be53c2e20881dad2052d2a96ef793...a845e234a21cbbc8ab02c087cb05f9884a18234b,1,8,1,9,1,2014-11-08 00:45:59,2014-11-06 23:59:21
a845e234a21cbbc8ab02c087cb05f9884a18234b...d2d857090f3340004ad6d22ca0f073a2b0298e88,2,14,3,17,5,2014-11-08 00:45:59,2014-11-07 00:07:43
d2d857090f3340004ad6d22ca0f073a2b0298e88...807d61c63f761a01591dea6c323a9d1f528f5aaf,2,8,2,10,3,2014-11-08 00:45:59,2014-11-08 00:30:00
807d61c63f761a01591dea6c323a9d1f528f5aaf...4fa5ae7bcbb243333f2f278aef92808ff17884b1,5,13,12,25,11,2014-11-08 00:45:59,2014-11-08 00:33:29
fb02e4e27f6cb758d8c81dbf2eaf0ae0bb926007...801ad9c020c4c68a8019e29221e1766845dcc238,2,8,2,10,3,2014-11-08 00:30:00,2014-11-08 00:30:00
801ad9c020c4c68a8019e29221e1766845dcc238...c6fabdba6474b415a48b2e252947003776658fe8,5,13,12,25,11,2014-11-08 00:33:29,2014-11-08 00:33:29
fb02e4e27f6cb758d8c81dbf2eaf0ae0bb926007...507b8ba44ddbc5a275d97a7530e7f22ada3acf70,2,16,41,57,11,2014-11-07 06:57:50,2014-11-06 02:22:01
507b8ba44ddbc5a275d97a7530e7f22ada3acf70...18f3db19c1276f57a67207acb4dc44a809a11605,3,37,33,70,3,2014-11-07 06:57:50,2014-11-06 08:30:31
c654390dac0868aed4e9a3cc216afaab512320f1...691c8ffa3c78f3216e42f9b2ba381b17a2aece0e,22,111,101,212,29,2014-10-16 21:51:57,2014-10-16 21:51:57
6a6bb529bbb372217f4def30dec81c1c9e356eea...03a9c694518245bafbaf8a29a4fe81d320cc75ec,1,10,1,11,2,2014-10-08 00:20:49,2014-10-08 00:20:22
03a9c694518245bafbaf8a29a4fe81d320cc75ec...8d2fd2300582c10079b962feaca98ac8545f7983,2,7,1,8,2,2014-10-08 00:29:41,2014-10-08 00:22:27
6a6bb529bbb372217f4def30dec81c1c9e356eea...a8aafc92d7f5e3f0ab49cf3bf117d9e4331ce140,1,27,1,28,3,2014-10-08 00:14:56,2014-10-08 00:03:44
a8aafc92d7f5e3f0ab49cf3bf117d9e4331ce140...58711cc0dd7af11a877e52f5bdb5a69425318912,2,8,1,9,5,2014-10-08 00:15:52,2014-10-08 00:15:52
58711cc0dd7af11a877e52f5bdb5a69425318912...ec88cca14b7a955e3b4a9ac69344fa7643258c4c,6,36,183,219,20,2014-10-08 01:25:41,2014-10-08 00:28:21
ec88cca14b7a955e3b4a9ac69344fa7643258c4c...eb86448cdd85d7c1d22e9bd43dfb427ad86e3e9e,2,10,11,21,5,2014-10-08 01:25:41,2014-10-08 01:19:00
14f452e7338c34fa32e36acd0bf580825b7a60b7...1a73a4a6c39c81baadbaa731a9a161a2881d3f8c,33,2623,111,2734,34,2014-10-08 00:10:47,2014-10-07 23:49:54
14f452e7338c34fa32e36acd0bf580825b7a60b7...e0414f2ed50f8a0336603b13c0d147a9438ed2d4,9,246,41,287,43,2014-10-07 22:55:50,2014-10-07 21:59:13
e0414f2ed50f8a0336603b13c0d147a9438ed2d4...0aab8e9683b9ac9b8b8ce0bcafc7741bf94b2c00,2,17,0,17,2,2014-10-07 22:55:50,2014-10-07 22:09:11
0aab8e9683b9ac9b8b8ce0bcafc7741bf94b2c00...43eace5af85f79c29687612a02eff2366478ed40,4,14,4,18,6,2014-10-07 22:55:50,2014-10-07 22:41:33
43eace5af85f79c29687612a02eff2366478ed40...e784341cf5d65505ce52540b3ce279f4bd846329,2,3,7,10,5,2014-10-07 22:55:50,2014-10-07 22:43:33
e784341cf5d65505ce52540b3ce279f4bd846329...58c3a355e4f5a5f7c4c076d66fa96b50296fc871,1,18,3,21,3,2014-10-07 22:55:50,2014-10-07 22:55:05
58c3a355e4f5a5f7c4c076d66fa96b50296fc871...192aeed694251aed646bfc4e651443f76a641aa1,1,5,5,10,3,2014-10-07 23:07:25,2014-10-07 23:07:25
192aeed694251aed646bfc4e651443f76a641aa1...4aa895aa20a305989da30961e450808f4cbe7de5,1,2,0,2,2,2014-10-07 23:09:20,2014-10-07 23:08:52
4aa895aa20a305989da30961e450808f4cbe7de5...9d0f42a3eaf324804b2f9a157ea67826f2d8aecf,1,14,1,15,1,2014-10-07 23:10:15,2014-10-07 23:09:59
9d0f42a3eaf324804b2f9a157ea67826f2d8aecf...a824a86176c7c64e12297a46eb083803376ff67d,1,3,2,5,3,2014-10-07 23:19:09,2014-10-07 23:19:09
a824a86176c7c64e12297a46eb083803376ff67d...b29b473e3a901284f28448597521553c239d0594,1,1,1,2,1,2014-10-07 23:30:05,2014-10-07 23:07:19
b29b473e3a901284f28448597521553c239d0594...966431a4799b9f6e1838a8f90e654a0be61e1668,1,10,0,10,1,2014-10-07 23:30:05,2014-10-07 23:29:28
e7820b5fbf7839003d95b61cd40cf911517d46ca...d1ee2043f979c56d3229f364e1c3f3f65f2ab4da,3,40,2,42,7,2014-10-09 00:28:08,2014-10-09 00:27:28
d1ee2043f979c56d3229f364e1c3f3f65f2ab4da...659128025d924b9ba78f3eeec885047d7ebf6f51,1,1,1,2,2,2014-10-09 01:07:01,2014-10-09 01:06:52
659128025d924b9ba78f3eeec885047d7ebf6f51...a98c6d030a732739d9beecef474e4c90d495a2f2,3,62,34,96,17,2014-10-09 01:07:11,2014-10-07 22:43:35
25ca18a2662653a0903b50bbfa3b6aa0ff33c68a...581832d967b1c1aaf9f2e46b635343a71170a87d,1,22,8,30,2,2014-08-25 22:48:58,2014-08-25 21:52:01
25ca18a2662653a0903b50bbfa3b6aa0ff33c68a...8f097cbea735494c323b6cfa8c811e3e16e6f7d7,1,7,6,13,2,2014-08-25 22:42:59,2014-08-25 22:42:59
a38e946a3b42faf05fb94b2424b538c2a5910eef...0e48d5183dd8782abc0ab5190f2b5d03bf4e46e4,1,1,1,2,1,2014-02-13 00:06:39,2014-02-13 00:06:39
0e48d5183dd8782abc0ab5190f2b5d03bf4e46e4...72c626be61deed06f714afd8e82a50fa92767fd0,2,8,4,12,3,2014-02-13 00:14:28,2014-02-13 00:13:25
72c626be61deed06f714afd8e82a50fa92767fd0...3204ffa42b092c9a0f47b6621254652c773dc468,1,1,1,2,1,2014-02-13 00:14:42,2014-02-05 12:00:04
3204ffa42b092c9a0f47b6621254652c773dc468...47cb93671997031790ede24fc28a8c191e706ad9,1,1,1,2,1,2014-02-13 00:27:13,2014-02-13 00:27:13
47cb93671997031790ede24fc28a8c191e706ad9...181c68bae885d42bab0c410cb613130a03a65407,2,8,0,8,2,2014-02-13 00:41:52,2014-02-13 00:40:53
181c68bae885d42bab0c410cb613130a03a65407...57c863076a21443672426a69cec95e5415a2b6d6,1,2,2,4,2,2014-02-13 01:01:17,2014-02-10 00:30:34
b587efdab5c42c94591cc4dbed2f7dc6dcf8fbd5...a34702214979fd3e35f28e0647f178dd3b2049ba,2,68,17,85,7,2015-02-27 00:10:43,2015-02-27 00:10:43
a34702214979fd3e35f28e0647f178dd3b2049ba...9028eecff5369956ffe15025f1723e6dd109b155,1,24,16,40,13,2015-02-27 00:41:21,2015-02-27 00:41:21
9028eecff5369956ffe15025f1723e6dd109b155...f8957baf9688555c0908845b4e49dff2cc7e8f85,2,199,142,341,8,2015-03-04 02:38:40,2015-03-04 02:38:40
f8957baf9688555c0908845b4e49dff2cc7e8f85...dfc362336c0d5cb161848e9a6a86a53f4fd26c90,1,28,36,64,19,2015-03-05 00:01:44,2015-03-05 00:01:44
dfc362336c0d5cb161848e9a6a86a53f4fd26c90...e75ee3105276bb8fcb220b6f34b9fd23840d11ed,1,4,4,8,4,2015-03-05 01:00:03,2015-03-05 01:00:03
e75ee3105276bb8fcb220b6f34b9fd23840d11ed...5699bb94c0e0f3046cedf93ce9eb4a3a4af90b67,1,8,22,30,7,2015-03-05 01:46:20,2015-03-05 01:46:20
5699bb94c0e0f3046cedf93ce9eb4a3a4af90b67...81376507e5fc2d32d8002aaaac4a71925143cbea,1,8,7,15,6,2015-03-05 01:51:49,2015-03-05 01:51:49
81376507e5fc2d32d8002aaaac4a71925143cbea...50d3ce7419eae275f8246790d89059e06eb12571,1,1,1,2,1,2015-03-05 02:07:36,2015-03-05 02:07:36
50d3ce7419eae275f8246790d89059e06eb12571...ee400cd7f8b47b2ad7b676bb2c7574387e5f7938,1,1,1,2,1,2015-03-05 02:23:48,2015-03-05 02:23:48
ee400cd7f8b47b2ad7b676bb2c7574387e5f7938...bb2a6467019d91e20a5129187e8778ee6e519c27,3,79,50,129,19,2015-03-05 22:11:16,2015-03-05 22:11:16
bb2a6467019d91e20a5129187e8778ee6e519c27...4454c7e411d517e3537a74a158cad43359320915,2,2,2,4,2,2015-03-05 22:50:33,2015-03-05 22:50:33
4454c7e411d517e3537a74a158cad43359320915...a47e4e94395822a26e1f8fa9a1cb71244ae2384b,1,156,111,267,8,2015-03-06 03:44:40,2015-03-06 03:44:40
a47e4e94395822a26e1f8fa9a1cb71244ae2384b...ffab1eaecb49bc70335a778d0bf2d61a40985649,1,0,1,1,1,2015-03-06 04:50:21,2015-03-06 04:50:21
ffab1eaecb49bc70335a778d0bf2d61a40985649...080094049e93f950fdf3ab3bc016ca33dbb507c2,1,84,81,165,11,2015-03-06 05:42:04,2015-03-06 05:42:04
080094049e93f950fdf3ab3bc016ca33dbb507c2...b968eb21f193845e0747202c00854dad3373f166,1,4,4,8,3,2015-03-06 08:51:05,2015-03-06 08:51:05
c47f0d8a677009a746ad4375cc4c826d771e07ae...42b1e5250f29b41a9089d88ddb957f95825a8128,2,2,1,3,2,2015-03-04 20:08:20,2015-03-04 20:07:33
42b1e5250f29b41a9089d88ddb957f95825a8128...db3eff5413b8d0ad6923eb40876a312de09def75,2,6,2,8,2,2015-03-04 22:09:07,2015-03-04 22:09:07
c47f0d8a677009a746ad4375cc4c826d771e07ae...add32127fab695fedd804005842eb087e9cf06bc,1,8,0,8,2,2015-03-04 02:20:37,2015-03-04 02:20:37
add32127fab695fedd804005842eb087e9cf06bc...9c210f8bcb1fe1dd87b91f7f4bf39a70c9174379,4,47,2,49,4,2015-03-04 02:54:53,2015-03-04 02:51:37
9c210f8bcb1fe1dd87b91f7f4bf39a70c9174379...484372d3f5b6a949717a0e6644dacf6d4f5dd1ce,1,6,7,13,2,2015-03-04 05:09:18,2015-03-04 05:09:18
484372d3f5b6a949717a0e6644dacf6d4f5dd1ce...91a321fa4b247e1f20164b0e5da8bb81b99db9c9,3,15,21,36,5,2015-03-04 05:35:23,2015-03-04 05:35:23
91a321fa4b247e1f20164b0e5da8bb81b99db9c9...86aeee4a4bc2271108c46053a1da547e60d78f5f,1,6,2,8,1,2015-03-04 05:56:17,2015-03-04 05:56:17
86aeee4a4bc2271108c46053a1da547e60d78f5f...aa54ba1d13dc7c8c957d59aa6bbb832bac90af1f,1,8,2,10,2,2015-03-04 06:01:14,2015-03-04 06:01:14
aa54ba1d13dc7c8c957d59aa6bbb832bac90af1f...ff0f304096afdf214e26eb9d566bde584c64c1f3,8,8,8,16,8,2015-03-04 06:22:09,2015-03-04 06:22:09
ff0f304096afdf214e26eb9d566bde584c64c1f3...405009a2c3dcd3c1fe780adb2867d38a6a42fff1,5,16,18,34,16,2015-03-04 07:20:24,2015-03-04 07:18:41
405009a2c3dcd3c1fe780adb2867d38a6a42fff1...b73aca8acc7a7944e26eb3f01dc1bb8bdb9abb77,1,55,0,55,1,2015-03-04 19:32:57,2015-03-04 19:32:57
b73aca8acc7a7944e26eb3f01dc1bb8bdb9abb77...d1fb199435f7080dfbc5962bccbe0c04d0beaca2,6,6,6,12,6,2015-03-04 19:40:39,2015-03-04 19:40:39
d1fb199435f7080dfbc5962bccbe0c04d0beaca2...dac1f96825b2f86612430d0678982f59686d43e4,1,0,8,8,2,2015-03-04 19:40:51,2015-03-04 19:40:51
02f799e041501a34982ad77e34ac0c3eae6a24a8...3d5e81bf23c971e10c0c39c3ad6047c1047ab803,2,15,4,19,2,2015-01-26 22:57:42,2015-01-26 22:57:42
3d5e81bf23c971e10c0c39c3ad6047c1047ab803...c42ecf45afb6b19e5d002bf72767a10867509ba0,1,2,1,3,1,2015-01-26 23:10:15,2015-01-26 23:10:15
c42ecf45afb6b19e5d002bf72767a10867509ba0...0c7b6dd46015211df85e755fee960cc52d4ec976,1,4,0,4,1,2015-01-26 23:18:02,2015-01-26 23:18:02
02f799e041501a34982ad77e34ac0c3eae6a24a8...81cfe6ce658ac4e7c7d48c812797993132ff9e6f,1,1,1,2,1,2015-01-25 08:29:46,2015-01-25 08:29:46
02f799e041501a34982ad77e34ac0c3eae6a24a8...245cd70bf184b60ed64a25587fe527a10b60ce5e,1,69,26,95,14,2015-01-24 03:14:20,2015-01-24 03:12:21
245cd70bf184b60ed64a25587fe527a10b60ce5e...abc067c94e5937b36880c087cfd537892a52279d,2,63,40,103,19,2015-01-24 03:29:37,2015-01-24 03:29:37
abc067c94e5937b36880c087cfd537892a52279d...7705c253cb0e8e70e7be13f9bf8d5b14f7c00b74,1,5,0,5,1,2015-01-24 03:35:02,2015-01-24 03:35:02
15b2569f79ec71e0b8e3efb3be9687facbb12574...0e0dfed6a89897d15c008656321d49c5c5ba175c,15,2,559,561,23,2015-01-29 22:03:10,2015-01-28 23:13:58
0e0dfed6a89897d15c008656321d49c5c5ba175c...5cc93cea1af045069ee22a7765f8d40ebf15be21,3,15,513,528,17,2015-01-29 22:03:11,2015-01-28 23:20:43
5cc93cea1af045069ee22a7765f8d40ebf15be21...df37fe5a9dbcbf797a189b9b2f42b03e7bd72950,2,12,197,209,10,2015-01-29 22:03:11,2015-01-28 23:27:11
df37fe5a9dbcbf797a189b9b2f42b03e7bd72950...62037959fe53e1e415f20c7b19ec647081d8cd47,4,13,13,26,5,2015-01-29 22:03:11,2015-01-28 23:31:53
62037959fe53e1e415f20c7b19ec647081d8cd47...7c40c3c5a664692f86158c5a0d07ca2ed817a613,3,1,384,385,7,2015-01-29 22:03:11,2015-01-28 23:43:57
7c40c3c5a664692f86158c5a0d07ca2ed817a613...5990e71ddc0872756689ec51818002c98093a629,10,16,276,292,14,2015-01-29 22:03:20,2015-01-29 00:00:46
5990e71ddc0872756689ec51818002c98093a629...aff7f37d04e635ca16c3b1c8d04885f2d64d835c,4,0,257,257,4,2015-01-29 22:03:28,2015-01-29 00:03:16
aff7f37d04e635ca16c3b1c8d04885f2d64d835c...299f4136175476e1a7ec1d6f7b7a5dd1eebed234,16,6,261,267,17,2015-01-29 22:03:41,2015-01-29 00:28:58
6aad026dcf66d4e9f0b825f01f9b3f9deeaabb5e...050a17305b5c4ac1411a954c16a171f74bcbd07a,3,16,13,29,9,2015-03-10 09:04:13,2015-03-10 09:04:13
050a17305b5c4ac1411a954c16a171f74bcbd07a...8638954315bf925be0e0f3d9c7a242724d7b3f80,2,42,1,43,4,2015-03-10 09:32:12,2015-03-10 09:32:12
8638954315bf925be0e0f3d9c7a242724d7b3f80...740b0f8ff7cb0dd5f64365686b80048facfaf6f1,10,15,1070,1085,11,2015-03-10 09:46:16,2015-03-10 09:43:02
740b0f8ff7cb0dd5f64365686b80048facfaf6f1...a5bdd887feaf6ae99d9ba680f6409b53e35c388a,1,3,0,3,1,2015-03-10 09:49:20,2015-03-10 09:49:20
a5bdd887feaf6ae99d9ba680f6409b53e35c388a...c5b768c5acd2919298b226af110f04f601371657,1,167,163,330,17,2015-03-10 10:22:45,2015-03-10 10:22:45
c5b768c5acd2919298b226af110f04f601371657...284f4ad6aa87143af7157bad5a91d2fd154ca01b,1,28,29,57,8,2015-03-10 10:37:01,2015-03-10 10:37:01
284f4ad6aa87143af7157bad5a91d2fd154ca01b...3d64b13555340bbef9c98805beb4eff8770975b8,5,33,12,45,13,2015-03-10 10:50:41,2015-03-10 10:50:41
243958fe206d0eb5698b4df2a38a3d987120194e...ab61351b58fea7814e04dde694e70bbd178fecde,5,6,6,12,6,2015-03-07 01:33:42,2015-03-07 01:33:42
ab61351b58fea7814e04dde694e70bbd178fecde...f5aae1e392baa2d19f6ec4024117693b5ab7f700,1,1,1,2,1,2015-03-07 01:49:28,2015-03-07 01:49:28
599f6b4f379188f180796aa9226af7defedc564b...019f58cb904a4a2a248207c584453d1674b8b8c6,1,0,6,6,2,2015-02-06 03:49:25,2015-02-06 03:49:25
019f58cb904a4a2a248207c584453d1674b8b8c6...e55632a66b8fd3307bf41c84c721b761bba958ee,1,3,1,4,1,2015-02-06 03:51:40,2015-02-06 03:51:40
e55632a66b8fd3307bf41c84c721b761bba958ee...f525218ca9e69f9c4e5887729cd07c9fc07715a8,1,1,1,2,1,2015-02-06 03:52:20,2015-02-06 03:52:20
f525218ca9e69f9c4e5887729cd07c9fc07715a8...48db054307d1b21e8ed9aba6c73dd320bf04801a,1,6,5,11,4,2015-02-06 03:55:56,2015-02-06 03:55:56
48db054307d1b21e8ed9aba6c73dd320bf04801a...0c8e7baf301063dec7d9dec08a2cbfad61f842a5,2,19,7,26,8,2015-02-06 04:12:39,2015-02-06 04:12:39
599f6b4f379188f180796aa9226af7defedc564b...58a514d2abc7fbfdb35699d1f289ee841533d483,1,1,1,2,2,2015-02-06 01:14:55,2015-02-06 01:14:55
58a514d2abc7fbfdb35699d1f289ee841533d483...e70193442f0c1801230ca403c02d90ab77e83a1e,70,8909,0,8909,58,2015-02-09 19:25:57,2015-02-09 19:25:57
0d865bc538bcdf39ee8591c02a65b4011e274c8e...a03dc12be71d5cbeb0da6a9ee8146881193efefc,1,9,10,19,7,2015-02-05 16:57:11,2015-02-05 16:55:49
a03dc12be71d5cbeb0da6a9ee8146881193efefc...e27ca92451941caa35e58100a1bac536bcf37207,1,1,1,2,1,2015-02-05 23:26:40,2015-02-05 18:51:46
0d865bc538bcdf39ee8591c02a65b4011e274c8e...f9f4be4dc7abec7dae4abbed789f0cdefa7257ce,1,4,4,8,4,2015-02-05 01:34:50,2015-02-03 19:39:48
f9f4be4dc7abec7dae4abbed789f0cdefa7257ce...2d47fa01357bea59fe606c685c30ec5b8c05b128,1,2,2,4,2,2015-02-05 01:34:50,2015-02-03 03:08:05
2d47fa01357bea59fe606c685c30ec5b8c05b128...699ed4a245d6291ab78ac51564c7261426a024a0,1,1,1,2,1,2015-02-05 01:34:50,2015-01-27 16:10:01
699ed4a245d6291ab78ac51564c7261426a024a0...c8cd470444d93f7336f27bc6d17c2b70e7afcf36,5,8,8,16,6,2015-02-05 01:34:50,2015-02-04 02:39:22
c8cd470444d93f7336f27bc6d17c2b70e7afcf36...e51e289805643c07bf95e4e558792d84a198a799,3,13,9,22,7,2015-02-05 01:35:05,2015-02-03 16:20:10
e51e289805643c07bf95e4e558792d84a198a799...06f260e862c69790393a82107194da620f0b12f7,2,1,2,3,2,2015-02-05 01:35:06,2015-02-04 03:24:24
06f260e862c69790393a82107194da620f0b12f7...a04e5e6e51f764cf467b85bc593c3087d6903534,1,4,4,8,4,2015-02-05 01:37:32,2015-02-05 01:37:32
a04e5e6e51f764cf467b85bc593c3087d6903534...3d9aeb9868eeaa2ef20d24c8b426a065d36da933,1,14,3,17,1,2015-02-05 01:45:40,2015-02-05 01:44:05
3d9aeb9868eeaa2ef20d24c8b426a065d36da933...40810de6130120d7e4a1d498864eec3ad6186508,4,25,15,40,11,2015-02-05 05:59:29,2015-02-05 05:45:25
40810de6130120d7e4a1d498864eec3ad6186508...dbb441526f0c58aa0a8622e18006e9843e00d842,3,4,17,21,3,2015-02-06 00:09:44,2015-02-06 00:09:44
062a5a7ab0739e233538684d78501bfb9beece71...1f9648cd23e102038fb58bc7df76f3e83a710891,3,429,414,843,167,2015-01-10 00:36:58,2015-01-10 00:36:16
1f9648cd23e102038fb58bc7df76f3e83a710891...3447f853261cec455823716a60c78edfcce9d307,1,0,1,1,1,2015-01-10 00:42:41,2015-01-10 00:42:13
3447f853261cec455823716a60c78edfcce9d307...7bdc6ccdebd8c2342c09a3c20fad458696824946,5,222,151,373,53,2015-01-10 02:55:10,2015-01-10 02:55:10
7bdc6ccdebd8c2342c09a3c20fad458696824946...16e74a8fe0e4a7c497a51d922aab297ff4f75768,3,6,7,13,6,2015-01-10 03:07:05,2015-01-10 03:07:05
16e74a8fe0e4a7c497a51d922aab297ff4f75768...eeab7df2d120357e1c63214b3a46d5c3d7c96118,1,8,4,12,2,2015-01-11 00:42:54,2015-01-11 00:42:54
eeab7df2d120357e1c63214b3a46d5c3d7c96118...becc877b6b0faf7faea3cfcc769103818b460e08,1,1,1,2,1,2015-01-12 19:03:33,2015-01-12 19:03:13
becc877b6b0faf7faea3cfcc769103818b460e08...07c8373cd3bc739d449b01b29a9b243aa8a76661,1,0,1,1,1,2015-01-12 19:14:53,2014-12-03 23:45:25
07c8373cd3bc739d449b01b29a9b243aa8a76661...6bc6abee8552bb5b8054fa4337e80bb58031dcb5,1,2,2,4,1,2015-01-12 19:16:06,2014-12-04 02:15:55
6bc6abee8552bb5b8054fa4337e80bb58031dcb5...880661ee8c988bc007f43a6a07e324a4ba04ac90,2,7,1,8,3,2015-01-12 19:21:55,2015-01-12 19:21:36
880661ee8c988bc007f43a6a07e324a4ba04ac90...3a5a4dde6cec2b315c0c1c9dfd11eceb495e249a,1,0,1,1,1,2015-01-12 19:23:54,2014-12-05 16:24:33
80139982f5a82d0aa850e4d4f8785f2e86a1293b...cc93674277a5c79e5b24f12eda149768b58e8ef5,1,1,0,1,1,2015-02-25 05:50:05,2015-02-22 20:43:21
cc93674277a5c79e5b24f12eda149768b58e8ef5...5a0a0bc06126dc1e8ec3fad549c041539db61325,1,7,3,10,4,2015-02-25 05:52:31,2015-02-21 02:23:44
5a0a0bc06126dc1e8ec3fad549c041539db61325...1100dec36cc1bab4e6389805e21869aee0ff8c8a,1,5,4,9,3,2015-02-25 05:52:31,2015-02-25 05:38:55
1100dec36cc1bab4e6389805e21869aee0ff8c8a...650695f87899449423ede6f6b0b631da82c1a3ff,1,5,2,7,2,2015-02-25 06:04:55,2014-11-11 00:31:38
a1237ba1a8a14edb1682f144b0bdfcea1c27f526...7d1cb122fed2f0a458d288ff7f47e20e7a5f4274,1,24,0,24,1,2014-11-22 22:19:47,2014-11-11 09:05:36
7d1cb122fed2f0a458d288ff7f47e20e7a5f4274...db90bd69448b46047bf72818ba10294ec217a342,1,1,1,2,1,2014-11-22 22:20:10,2014-11-22 22:20:10
db90bd69448b46047bf72818ba10294ec217a342...cec75e527cb9979e21f9547bd163ad57811cc367,6,62,185,247,40,2014-11-22 22:20:39,2014-11-22 21:54:38
cec75e527cb9979e21f9547bd163ad57811cc367...fb6b39d956a89a4c28451a3d555aae5c81e018ad,1,3,4,7,2,2014-11-22 22:20:57,2014-11-22 22:18:53
e18c9afb86798a53910db048ddeca61d8852e2eb...e2f2a2238c39b14f61cd7bf27b166b30ad2cc1ca,1,8,0,8,1,2014-11-13 00:25:28,2014-11-13 00:25:28
e2f2a2238c39b14f61cd7bf27b166b30ad2cc1ca...a4b5c02721e72118adfc67187bb838bc94c7f521,1,1,1,2,1,2014-11-13 00:30:35,2014-11-13 00:30:35
a4b5c02721e72118adfc67187bb838bc94c7f521...399681e04f077a05361b25a6d69ee04405b97690,4,6,16,22,8,2014-11-13 01:13:41,2014-11-13 01:13:13
399681e04f077a05361b25a6d69ee04405b97690...b96c5d7962a9e59b9efaeb93eb81020e0548e378,1,1,1,2,1,2014-11-13 01:28:46,2014-11-13 01:28:46
650882765e06f41bc6a5e11b6b61e63ee6c8efbf...d6b3da53abb72482d9f880bc29eaf9623c9df269,1,5,0,5,2,2014-11-08 03:10:11,2014-11-08 03:03:24
691c8ffa3c78f3216e42f9b2ba381b17a2aece0e...b9356c62a8a4e4c04927edb6e90e2f80483e74a8,6,168,79,247,23,2014-10-16 22:28:43,2014-10-16 22:28:43
b9356c62a8a4e4c04927edb6e90e2f80483e74a8...ace6bd97da8c78958dad73d866711a7109f49ae4,46,1811,408,2219,42,2014-10-23 06:49:25,2014-10-23 06:49:25
ace6bd97da8c78958dad73d866711a7109f49ae4...ae7a0c6bb06bf840a3b9e9063113da698ec7d99d,31,60,40,100,15,2014-10-23 17:50:57,2014-10-23 17:50:57
ae7a0c6bb06bf840a3b9e9063113da698ec7d99d...c6c55c2e231d613cf4bf40526174cc968e9f45af,2,33,13,46,7,2014-10-23 18:00:01,2014-10-23 18:00:01
c6c55c2e231d613cf4bf40526174cc968e9f45af...9ad07f3ca9845895beb6334530245177ee4cb2e0,2,36,9,45,14,2014-10-23 18:26:44,2014-10-23 18:26:44
9ad07f3ca9845895beb6334530245177ee4cb2e0...51160f4e0b6972439ddcd338db76e523dec3f2a5,13,54,97,151,24,2014-10-23 20:39:12,2014-10-23 20:39:12
691c8ffa3c78f3216e42f9b2ba381b17a2aece0e...a75ba12c6b5011924cf498e5f586743f243886d5,2,39,1,40,2,2014-10-16 21:53:14,2014-10-16 21:52:25
a75ba12c6b5011924cf498e5f586743f243886d5...7bc75b7a636dbaa3ab580563140950a33c29d462,1,1,1,2,1,2014-10-16 21:54:39,2014-10-16 21:54:39
7bc75b7a636dbaa3ab580563140950a33c29d462...fcc5af209527021ad6f12491e160efbe70b3befd,1,0,2,2,1,2014-10-16 21:55:27,2014-10-16 21:54:17
fcc5af209527021ad6f12491e160efbe70b3befd...7f9e6841e7a40137af51a69164efd38cd6e9cc1d,2,39,0,39,2,2014-10-16 21:55:27,2014-10-16 21:55:13
7f9e6841e7a40137af51a69164efd38cd6e9cc1d...aa52136c8ef9cd269a36aafa2c366e7cd980e0f3,2,18,2,20,3,2014-10-16 22:08:38,2014-10-16 22:08:03
aa52136c8ef9cd269a36aafa2c366e7cd980e0f3...faacf4f40b06dac3e38d16f2fb9b7d635b261d98,1,115,97,212,18,2014-10-16 22:26:44,2014-10-16 22:25:09
faacf4f40b06dac3e38d16f2fb9b7d635b261d98...701db7cfcbc8c6475027942a712bc13f125b8007,8,198,68,266,32,2014-10-16 22:34:09,2014-10-16 22:34:09
701db7cfcbc8c6475027942a712bc13f125b8007...56ae0c576403361ba0d50b089e5f26013e32ef8c,1,24,22,46,10,2014-10-16 22:38:55,2014-10-16 22:37:33
56ae0c576403361ba0d50b089e5f26013e32ef8c...eb3355e52dc4c6f36864ce2fd98e4eebb0590f1b,1,13,11,24,4,2014-10-16 22:59:08,2014-10-16 22:42:39
eb3355e52dc4c6f36864ce2fd98e4eebb0590f1b...25c3d39fb8b548fdb63ebb71b657d6004bb6910a,2,14,3,17,2,2014-10-16 23:18:39,2014-10-16 23:18:39
25c3d39fb8b548fdb63ebb71b657d6004bb6910a...45925a7ef8d07e186108b0de65e00446b2cf428c,2,7,6,13,7,2014-10-16 23:24:14,2014-10-16 23:24:14
45925a7ef8d07e186108b0de65e00446b2cf428c...ff176f76f4020369b61baebff3b822048d9d7498,1,6,6,12,5,2014-10-16 23:37:42,2014-10-16 23:37:42
ff176f76f4020369b61baebff3b822048d9d7498...d63b88926db0a346eed96aac0349e162de466a2a,1,12,9,21,4,2014-10-16 23:57:37,2014-10-16 23:57:37
d63b88926db0a346eed96aac0349e162de466a2a...62e3c2c5006c55d656b1b7450adc01545a6d7a0e,2,5,8,13,5,2014-10-17 00:10:45,2014-10-16 22:41:36
62e3c2c5006c55d656b1b7450adc01545a6d7a0e...7c7ee4366ccb73707c1c4bfa27507c2ccc84c359,1,10,0,10,1,2014-10-17 00:14:09,2014-10-17 00:14:09
7c7ee4366ccb73707c1c4bfa27507c2ccc84c359...2d68d3e9efb3c29c6f310f1146d11b489beded39,1,0,11,11,1,2014-10-17 00:27:54,2014-10-17 00:27:54
2d68d3e9efb3c29c6f310f1146d11b489beded39...2fd65660d171ac16f300b9b138d19b20dd11bbcc,1,0,1,1,1,2014-10-17 00:32:25,2014-10-17 00:26:06
2fd65660d171ac16f300b9b138d19b20dd11bbcc...9c90e442819f1755d85fa596c21767b366afe4bb,1,15,4,19,3,2014-10-17 01:28:15,2014-10-17 01:28:00
9c90e442819f1755d85fa596c21767b366afe4bb...da4421f5116e28bdbb2fc84515bde3c2d95c4d0f,1,2,2,4,2,2014-10-17 01:34:32,2014-10-17 01:34:32
da4421f5116e28bdbb2fc84515bde3c2d95c4d0f...24f8f4e0a20f53214bb14a3d8bd2ced70028a6af,1,14,6,20,5,2014-10-17 02:30:23,2014-10-17 02:26:44
24f8f4e0a20f53214bb14a3d8bd2ced70028a6af...e3ac8882f57f648ce73c27bfb2d87f496ee6b489,2,24,18,42,13,2014-10-17 02:51:54,2014-10-17 02:51:54
e3ac8882f57f648ce73c27bfb2d87f496ee6b489...2e425df7cdee6f0057664dbfd507a125a59f31a8,2,16,12,28,4,2014-10-17 02:56:54,2014-10-17 02:55:15
2e425df7cdee6f0057664dbfd507a125a59f31a8...1126449baa8f426ac2fc420a4d90d6d7ace871f7,2,35,3,38,4,2014-10-17 06:12:55,2014-10-17 06:12:55
1126449baa8f426ac2fc420a4d90d6d7ace871f7...c45f959cbe5cec8bbbf8b3ccffa21ac90613d7aa,1,1,1,2,1,2014-10-17 06:16:00,2014-10-17 06:16:00
c45f959cbe5cec8bbbf8b3ccffa21ac90613d7aa...c4e1f5881aeb5ef9980ae41332219e2d77fa1ea7,1,6,1,7,2,2014-10-17 13:23:47,2014-10-17 13:23:47
c4e1f5881aeb5ef9980ae41332219e2d77fa1ea7...a3be9a0ac676b925f03243308c53b5e93caf6d2b,6,26,8,34,12,2014-10-17 13:26:47,2014-10-16 22:28:10
a3be9a0ac676b925f03243308c53b5e93caf6d2b...ee5e99d4061b119a3ef364caf4d456a9fdd68ba5,3,81,21,102,15,2014-10-17 14:15:20,2014-10-17 14:15:20
ee5e99d4061b119a3ef364caf4d456a9fdd68ba5...d6745d3873a040b5d06877fc404a7df2e415060d,1,13,2,15,6,2014-10-17 14:36:38,2014-10-17 14:36:38
d6745d3873a040b5d06877fc404a7df2e415060d...88f900509c915916a104a00a938c915cf4eaaab4,1,1,2,3,2,2014-10-17 14:36:58,2014-10-17 14:36:58
88f900509c915916a104a00a938c915cf4eaaab4...6375d30a4c8ea66ebef4ab2302bfc6a4b09c7ccd,1,7,6,13,4,2014-10-17 14:45:54,2014-10-17 14:45:54
8d2fd2300582c10079b962feaca98ac8545f7983...f78184c49794b920d21e7f2a990e01d63c30c754,1,27,1,28,3,2014-10-08 01:26:21,2014-10-08 00:03:44
f78184c49794b920d21e7f2a990e01d63c30c754...9bf291c8a045895ee5e2fa56a42e2047b0a63747,2,8,1,9,5,2014-10-08 01:26:21,2014-10-08 00:15:52
9bf291c8a045895ee5e2fa56a42e2047b0a63747...5590d194c5f21a41d87a74422a1c539b80af0b1f,6,36,183,219,20,2014-10-08 01:26:21,2014-10-08 00:28:21
5590d194c5f21a41d87a74422a1c539b80af0b1f...3faf1aa21e83ec78dd640c9a1c8f760ebe201cf1,2,10,11,21,5,2014-10-08 01:26:21,2014-10-08 01:19:00
1a73a4a6c39c81baadbaa731a9a161a2881d3f8c...ccc25260f6d1a9b5434095b9cc769d7790c8ba0b,52,748,2573,3321,40,2014-10-17 16:30:11,2014-10-17 16:30:11
1a73a4a6c39c81baadbaa731a9a161a2881d3f8c...a11f56fff8ed7ca918ba4877f801f0ffe25bd00f,1,2,0,2,2,2014-10-08 00:10:47,2014-10-07 23:08:52
a11f56fff8ed7ca918ba4877f801f0ffe25bd00f...dc50b779312befd062d6132167032b887ab77a63,1,14,1,15,1,2014-10-08 00:10:47,2014-10-07 23:09:59
dc50b779312befd062d6132167032b887ab77a63...8823367a0f0b950edfb16973aae54bc1103dba39,1,3,2,5,3,2014-10-08 00:10:47,2014-10-07 23:19:09
8823367a0f0b950edfb16973aae54bc1103dba39...913cda95f342a4d9e741fe377784666fcbd13714,1,1,1,2,1,2014-10-08 00:10:47,2014-10-07 23:07:19
913cda95f342a4d9e741fe377784666fcbd13714...95d73cca07b2b67ab7443313d68184b71a198d8a,1,10,0,10,1,2014-10-08 00:10:48,2014-10-07 23:29:28
95d73cca07b2b67ab7443313d68184b71a198d8a...938313e7bc6c5564af0a7960e2c32214887a8cba,1,2,2,4,2,2014-10-08 00:10:48,2014-10-07 23:57:30
938313e7bc6c5564af0a7960e2c32214887a8cba...64a49831f3152c39548410518adc80bd4cb08bf6,1,2,1,3,1,2014-10-08 00:10:48,2014-10-07 23:58:58
64a49831f3152c39548410518adc80bd4cb08bf6...a36b63b589af2a2f0b0d1790d758c568dd28a6cd,1,1,1,2,1,2014-10-08 00:10:48,2014-10-07 23:59:53
a36b63b589af2a2f0b0d1790d758c568dd28a6cd...698fbedb100aa5af8fa4039736565e92d90437f9,124,124,124,248,124,2014-10-08 00:10:48,2014-10-08 00:00:23
698fbedb100aa5af8fa4039736565e92d90437f9...2ab49825295b2a0fee2b970379cb75db304268f4,1,2,2,4,2,2014-10-08 00:10:48,2014-10-08 00:01:46
a98c6d030a732739d9beecef474e4c90d495a2f2...7f134bdfb4a1e95c74049c0039135610f6fd308a,2,2,6,8,2,2014-10-09 05:06:47,2014-10-09 02:48:57
7f134bdfb4a1e95c74049c0039135610f6fd308a...4a4e7c19ffc93ac8546d56dc70a48f1771ddb609,1,5,4,9,2,2014-10-09 05:06:47,2014-10-09 05:04:05
4a4e7c19ffc93ac8546d56dc70a48f1771ddb609...cca0112b990748ee2ca88165420e704b56b8efd1,2,2,9,11,3,2014-10-09 05:27:38,2014-10-09 05:18:15
cca0112b990748ee2ca88165420e704b56b8efd1...b8d927851a55713d1aa3037dfe681b8a27194c79,3,5,4,9,4,2014-10-09 05:31:37,2014-10-09 05:31:37
a98c6d030a732739d9beecef474e4c90d495a2f2...2c804e95932b0849ced22c84bf8f2ad802af54f6,1,1,1,2,1,2014-10-09 04:24:36,2014-10-09 04:24:36
2c804e95932b0849ced22c84bf8f2ad802af54f6...ea207bbbc34f5ca6815ca99a3b87db37dd307afc,2,10,12,22,2,2014-10-09 05:31:22,2014-10-09 05:31:22
04f515da8582796b080c1dbb00b6872b7ff2c6ea...6bc2cff03a67ddade76a844b8c574be664b15832,1,1,1,2,1,2014-10-09 17:24:11,2014-10-09 17:24:11
c4e819ef201320028b2db8eeba065aa778df5760...76961d61615c533791f8f9acc27cd316a017b6f7,1,16,4,20,2,2014-08-25 23:01:17,2014-08-25 23:00:41
76961d61615c533791f8f9acc27cd316a017b6f7...166583845e98cfa45087a0c78bab44052ac09c32,2,13,11,24,5,2014-08-25 23:42:41,2014-08-25 23:42:41
166583845e98cfa45087a0c78bab44052ac09c32...1eaf87b881b3e5db1f74ad355ae04f0bdcd1281d,1,1,1,2,1,2014-08-25 23:46:30,2014-08-25 23:46:30
1eaf87b881b3e5db1f74ad355ae04f0bdcd1281d...96e606ab89f61f321fd766a5bae5a94c8ca3e4a5,1,1,1,2,1,2014-08-25 23:47:37,2014-08-25 23:47:37
96e606ab89f61f321fd766a5bae5a94c8ca3e4a5...08f0a3bab077d2a07ab84ce71229fbfef9e23063,2,26,5,31,8,2014-08-26 00:25:08,2014-08-26 00:25:08
08f0a3bab077d2a07ab84ce71229fbfef9e23063...23a57a9648e28cc407aa6cafb3031857f073a968,1,1,1,2,1,2014-08-26 00:27:07,2014-08-26 00:27:07
23a57a9648e28cc407aa6cafb3031857f073a968...0bbdc175a5a4bf828dbbbe9d6ba8ef6d07bed5fa,1,6,0,6,1,2014-08-26 00:36:03,2014-08-26 00:36:03
0bbdc175a5a4bf828dbbbe9d6ba8ef6d07bed5fa...2ee41fda7489e5e3565a85566f37f7f1fd57281a,2,10,0,10,2,2014-08-26 00:38:27,2014-08-26 00:38:27
2ee41fda7489e5e3565a85566f37f7f1fd57281a...521f724e1631ea5a68653f361230c3022836ab44,2,4,120,124,4,2014-08-26 00:39:39,2014-08-26 00:39:39
521f724e1631ea5a68653f361230c3022836ab44...fa6e92410861913328805cb70dac61ef1aeae539,2,14,9,23,4,2014-08-26 02:11:35,2014-08-26 02:11:35
fa6e92410861913328805cb70dac61ef1aeae539...35d882f93524b013989d91db59efbe79721b37a9,1,1,1,2,1,2014-08-26 02:49:57,2014-08-26 02:49:57
35d882f93524b013989d91db59efbe79721b37a9...bfb8359499d006030f865b6b751a445564bf7e0c,2,10,3,13,2,2014-08-26 02:57:28,2014-08-26 02:57:28
bfb8359499d006030f865b6b751a445564bf7e0c...5c5092eeaeea6e6d1b57d594fcda16e6ebde1ec6,1,25,0,25,1,2014-08-26 04:05:12,2014-08-26 04:05:12
5c5092eeaeea6e6d1b57d594fcda16e6ebde1ec6...0562466ad4b37422c38934c9ca89c003d8b926c3,2,2,2,4,2,2014-08-26 04:21:43,2014-08-26 04:21:43
0562466ad4b37422c38934c9ca89c003d8b926c3...0030c3a1d7c3c7f6cd7b637c57da5f0e7ba47de3,3,4,4,8,4,2014-08-26 04:23:49,2014-08-26 04:23:49
0030c3a1d7c3c7f6cd7b637c57da5f0e7ba47de3...23f76f3cea2aba647bc43868d50f915fbe529734,1,1,1,2,1,2014-08-26 04:45:57,2014-08-26 04:45:57
23f76f3cea2aba647bc43868d50f915fbe529734...97e1dd425cf71623013e0669df42090644fc73e4,15,114,48,162,50,2014-08-26 05:25:31,2014-08-26 05:09:58
97e1dd425cf71623013e0669df42090644fc73e4...f7c6f505acac57b4a2158183a0d194da29059d45,2,10,3,13,3,2014-08-26 05:49:32,2014-08-26 05:49:32
f7c6f505acac57b4a2158183a0d194da29059d45...6cf7addcdc02bf8867da4dbf594151daee902f65,2,4,3,7,3,2014-08-26 05:50:33,2014-08-26 05:50:33
6cf7addcdc02bf8867da4dbf594151daee902f65...d4f14d93620e2158cde0544321f8867ea38e1154,1,124,5,129,1,2014-08-26 14:13:53,2014-08-26 14:13:53
d4f14d93620e2158cde0544321f8867ea38e1154...a998b3b97d4e7948c8fd4fee8640d9836939affc,2,3,3,6,3,2014-08-26 14:50:53,2014-08-26 14:50:53
a998b3b97d4e7948c8fd4fee8640d9836939affc...9a4a7f2b11b9adeed8f11f49115f5d1a2e53036f,2,6,1,7,2,2014-08-26 15:00:45,2014-08-26 15:00:45
9a4a7f2b11b9adeed8f11f49115f5d1a2e53036f...2f7436904368374f4c349eea30fcf8fa77ca7f1c,5,5,5,10,5,2014-08-26 15:07:13,2014-08-26 15:07:13
d50f904a29cbc437192c360a813a74099b76d470...8ea3712955a8cb685065bc29f8276c31d4d2d186,1,0,1,1,1,2015-03-04 23:45:29,2015-03-04 23:33:27
8ea3712955a8cb685065bc29f8276c31d4d2d186...419befbf5f42b69095454632618ea2cc64b9a6ef,2,1,6,7,2,2015-03-05 00:13:40,2015-03-05 00:13:40
0c7b6dd46015211df85e755fee960cc52d4ec976...a355dd213ddd7aa7278ed68c16b8fb01ca01fda7,4,43,3,46,12,2015-01-26 23:19:19,2015-01-26 23:19:19
a355dd213ddd7aa7278ed68c16b8fb01ca01fda7...5ca2fb0f3605859428b988561d2df47c7efd2ff5,2,14,6,20,4,2015-01-26 23:23:06,2015-01-26 23:23:06
fee892c43edde6f2115d9d72f2bc43c59f23fb77...074087be8afc56536c4953566b64129f3270f0c2,4,43,41,84,41,2015-01-27 22:17:41,2015-01-27 22:17:41
c0ea40230e146c6ecd27d1031c50cf2542b60eb7...dde3924c9d4628e5810a5828392c69260c6be571,2,77,61,138,14,2015-01-30 00:56:22,2015-01-29 23:12:51
dde3924c9d4628e5810a5828392c69260c6be571...dbea793f6a27778ebb3f136fc24c7800b6a2c155,1,7,0,7,2,2015-01-30 01:07:09,2015-01-30 01:07:09
dbea793f6a27778ebb3f136fc24c7800b6a2c155...8149538e9c3fa376642f19148956213247bfc956,1,7,2,9,3,2015-01-30 03:33:55,2015-01-30 03:33:55
c0ea40230e146c6ecd27d1031c50cf2542b60eb7...5556bb4d513fb1f6f2b708513e88497fe199dc21,2,45,33,78,14,2015-01-29 23:58:56,2015-01-29 23:12:51
8e75308c6fead4888eee8772746e96cdc746d6b4...c247e2526f2033aadfa73e2fb41ba2e122aeeb92,1,76,0,76,1,2015-03-10 22:04:42,2015-03-10 21:50:31
c247e2526f2033aadfa73e2fb41ba2e122aeeb92...7a61abdaedd99cd5c83c27d132b8ab7dea40a889,1,18,3,21,4,2015-03-10 22:13:10,2015-03-10 22:04:47
7a61abdaedd99cd5c83c27d132b8ab7dea40a889...49deaf1c5b395803207e8d5197d1ab7afebea2a7,1,20,10,30,6,2015-03-10 22:34:59,2015-03-10 22:34:59
8e75308c6fead4888eee8772746e96cdc746d6b4...be4f89667506587c446dbd2aba9e83e4883a2c94,1,0,29,29,1,2015-03-10 18:36:22,2015-03-10 18:36:03
be4f89667506587c446dbd2aba9e83e4883a2c94...02770db1474ba445ba9fac7b824a86e093b60b2e,1,7,0,7,1,2015-03-10 18:44:40,2015-03-10 18:44:01
02770db1474ba445ba9fac7b824a86e093b60b2e...dbfd1291c7617610519abeac6b67359b802b9cb0,3,33,24,57,9,2015-03-10 19:22:19,2015-03-10 19:19:07
dbfd1291c7617610519abeac6b67359b802b9cb0...78efe0b06bcd548970e17bc3f10203d4909ef169,1,7,2,9,2,2015-03-10 19:31:49,2015-03-10 19:31:49
78efe0b06bcd548970e17bc3f10203d4909ef169...f2dfcfd7e1b78483487e079318e539bd451ce375,1,0,1,1,1,2015-03-10 20:41:33,2015-03-08 07:10:46
f2dfcfd7e1b78483487e079318e539bd451ce375...f51a033e73bfad9ceb6439ef72bdc121590b3032,4,53,4,57,5,2015-03-10 20:47:14,2015-03-10 20:47:14
f51a033e73bfad9ceb6439ef72bdc121590b3032...0bf0f75c6dfbba7523e53fd08441911bcc4d16a5,1,1,1,2,1,2015-03-10 20:53:57,2015-03-09 05:13:52
0bf0f75c6dfbba7523e53fd08441911bcc4d16a5...67391d0bc9cb05af8bb5866c5d64cc28f568da3d,1,5,0,5,1,2015-03-10 20:53:57,2015-03-10 20:53:03
67391d0bc9cb05af8bb5866c5d64cc28f568da3d...08bc9ab002454957834588906bafb12e92c67cfc,2,11,6,17,6,2015-03-10 20:58:27,2015-03-10 20:58:05
08bc9ab002454957834588906bafb12e92c67cfc...f50f2b64c2bf2d4205b7de76d831d164f6019bac,1,5,1,6,1,2015-03-10 21:05:11,2015-03-09 12:19:27
f50f2b64c2bf2d4205b7de76d831d164f6019bac...f4c4b16d933244461d3d9cc6315adac879a3bef4,1,6,0,6,1,2015-03-10 21:05:11,2015-03-10 20:57:02
f4c4b16d933244461d3d9cc6315adac879a3bef4...0e53947a21473ac82027b6668b5eb4a2e7b8f08e,1,8,1,9,1,2015-03-10 21:34:05,2015-03-10 21:33:46
0e53947a21473ac82027b6668b5eb4a2e7b8f08e...0ba6d137ed5863771283808d8ed7fac1f63d4a54,3,21,0,21,3,2015-03-10 22:26:43,2015-03-06 03:26:17
3cd883bda448fb9b550df695d61f9ff56fb8ae83...695ed96a22120fd0767a3c193409b16144e32c39,1,1,1,2,1,2015-02-06 04:35:15,2015-02-06 04:34:40
695ed96a22120fd0767a3c193409b16144e32c39...bcf2b589467cc29820358811ee941d23f065fcdc,1,12,12,24,2,2015-02-06 04:39:06,2015-02-06 04:37:51
bcf2b589467cc29820358811ee941d23f065fcdc...15aa6495419d829bab5b840abc0a7e781ee57a9d,1,1,1,2,1,2015-02-06 04:40:31,2015-02-06 04:40:31
15aa6495419d829bab5b840abc0a7e781ee57a9d...2cc0d41ee259adc51b545788918d3af35b3b1298,1,6,5,11,4,2015-02-06 06:32:42,2015-02-06 06:32:42
2cc0d41ee259adc51b545788918d3af35b3b1298...6e5f034a0df9c00a394d2db771b8c2f08727536f,1,48,49,97,5,2015-02-06 06:39:32,2015-02-06 06:39:32
a3a2ad5edd1d7376942a6b331dd8a4546287e799...466559a8c41ff8b623f56d1a04037a0c5ad485a7,2,24,2,26,4,2015-02-09 20:10:44,2015-02-09 19:58:39
466559a8c41ff8b623f56d1a04037a0c5ad485a7...c99f9584c1ab6af9c2b64c04557abb3f4cf7e407,1,1,1,2,1,2015-02-09 20:10:44,2015-02-09 19:59:04
c99f9584c1ab6af9c2b64c04557abb3f4cf7e407...1cc23f8547ea59f8c0e4825ad49e22fb02f6d66c,1,1,1,2,1,2015-02-09 21:14:57,2015-02-09 21:14:57
1cc23f8547ea59f8c0e4825ad49e22fb02f6d66c...f29c954458d46f02164497b57697dc5f7a66b509,19,19,19,38,19,2015-02-09 21:23:24,2015-02-09 21:23:24
f29c954458d46f02164497b57697dc5f7a66b509...2eaa848bcc77e86c746bd1791c3a90f3e2f05257,5,11,5,16,5,2015-02-09 21:49:57,2015-02-09 21:49:57
2eaa848bcc77e86c746bd1791c3a90f3e2f05257...8ffa92c65409934fef01bbf976cd78c7a243eefa,1,1,1,2,1,2015-02-09 23:19:24,2015-02-09 23:19:07
3a5a4dde6cec2b315c0c1c9dfd11eceb495e249a...f12b08947aeb4e7956d55ee1d8edef16f729f7b1,3,26,27,53,3,2015-01-12 22:05:00,2014-12-14 15:04:16
f12b08947aeb4e7956d55ee1d8edef16f729f7b1...106337311e76cb1a31f74e5bf4ab792a758e7244,3,13,16,29,6,2015-01-12 22:06:29,2015-01-12 22:06:29
d4209aff0248fe628bc4297fafc6c08203969b94...9a4428bf6ec1b366e413ea31f0a0b08bd74b6fe8,2,2,12,14,2,2014-11-23 01:29:54,2014-11-23 01:29:54
b96c5d7962a9e59b9efaeb93eb81020e0548e378...bf47ae7a989be5dcf3efc57fb521d30fd327c933,1,2,2,4,2,2014-11-14 01:42:43,2014-11-14 01:38:46
d6b3da53abb72482d9f880bc29eaf9623c9df269...7f695a2c4a899c0744099ac60dfd4601b6117d76,3,6382,6382,12764,430,2014-11-14 22:40:20,2014-11-14 22:40:20
7f695a2c4a899c0744099ac60dfd4601b6117d76...95cdfc566232f98a1dd0ef7a5a3aa0020ca02bc1,1,7681,9851,17532,2,2014-11-15 00:26:57,2014-11-15 00:25:57
95cdfc566232f98a1dd0ef7a5a3aa0020ca02bc1...10fd23cc992737140119b2fca3781c0580785986,1,1,1,2,1,2014-11-15 00:28:47,2014-11-15 00:28:47
10fd23cc992737140119b2fca3781c0580785986...995b8477b433bb5cab5905d44e361d55b7a0b734,2,1583,1583,3166,419,2014-11-15 05:32:30,2014-11-15 05:32:30
d6b3da53abb72482d9f880bc29eaf9623c9df269...3444b9a6d369a6a1fa3d27bf3bd5d7930592c96e,14,42,206,248,38,2014-11-10 21:33:41,2014-11-10 21:30:11
3444b9a6d369a6a1fa3d27bf3bd5d7930592c96e...dde817ea1030882b96289d7f6f5d9c73d2c92cb5,1,4,4,8,2,2014-11-10 23:10:20,2014-11-10 23:10:20
dde817ea1030882b96289d7f6f5d9c73d2c92cb5...96bae0e077eef6230fc2f40dfa969f6231cc65cd,1,1,1,2,1,2014-11-11 00:25:14,2014-11-11 00:24:34
51160f4e0b6972439ddcd338db76e523dec3f2a5...2e90ec853a052d8fcbce48f4615aaa1383298c1d,5,211,159,370,84,2014-10-24 22:16:06,2014-10-24 22:16:06
c78e04645d970b455c0ef405889242ae9b8e6c47...b0dab99f9ab0fc69753c0bf31501fe20156b1641,1,1,1,2,1,2014-10-17 16:39:25,2014-10-17 16:39:25
b0dab99f9ab0fc69753c0bf31501fe20156b1641...1082efd0b20546582137030aeaf0cbaf5b7a05d1,1,1,1,2,1,2014-10-17 17:28:31,2014-10-17 17:28:31
1082efd0b20546582137030aeaf0cbaf5b7a05d1...b1fd5e31835a19ad1ba84c5b922a3e17870908e2,1,6,0,6,1,2014-10-17 17:30:51,2014-10-17 17:29:38
b1fd5e31835a19ad1ba84c5b922a3e17870908e2...e98431ce183a63b05e5dac4bbbb945197c74f3a2,1,3,3,6,2,2014-10-17 18:01:32,2014-10-17 17:43:06
e98431ce183a63b05e5dac4bbbb945197c74f3a2...cab3217eb0ff4cefadc5236bd3d427d45a49b8ef,1,2,1,3,1,2014-10-17 18:22:57,2014-10-17 18:22:46
abbda8285487ba00be7a453218b89e7aa432fd05...b40faa363c1fcfed4f01470f3d90b62f5fb41eb9,1,1,1,2,1,2014-10-08 01:43:43,2014-10-08 01:43:32
d74ba1a3e42d7996a79ebf040e5b71fead97a76e...75ef0202bfe468dc74ae3502d38853c0ca29e4e3,3,3,3,6,3,2014-10-08 05:30:52,2014-10-08 05:30:52
75ef0202bfe468dc74ae3502d38853c0ca29e4e3...74c8f252f574a55f04294723befabf2a92da707d,2,4,1,5,4,2014-10-08 20:49:24,2014-10-08 20:49:24
e1c745aab6c610ea72b0b2c66122ee70091c9550...cce79392710fe264d10066fa6139e3de744dc768,1,1,1,2,1,2014-10-09 18:27:44,2014-10-09 18:27:44
6bc2cff03a67ddade76a844b8c574be664b15832...e0876ece3a5df1cd8b85662c585c5ec219aff420,2,49,19,68,6,2014-10-09 18:45:43,2014-10-09 18:45:01
e0876ece3a5df1cd8b85662c585c5ec219aff420...5af5a98342bb2e209cd263edd20f229c9e0be2a9,2,6,2,8,3,2014-10-09 18:46:05,2014-10-09 18:35:04
5af5a98342bb2e209cd263edd20f229c9e0be2a9...bff1cec3dd37df3aa20d5236162431898497e6b0,1,1,1,2,1,2014-10-09 19:11:12,2014-10-09 18:51:50
bff1cec3dd37df3aa20d5236162431898497e6b0...9be657f8624399a27049e87503dcc2a9f774dd90,1,7,0,7,1,2014-10-09 19:30:57,2014-10-09 19:30:57
9be657f8624399a27049e87503dcc2a9f774dd90...bae041b39c5b287ea8da7cd56d6f90461a34490f,1,7,1,8,2,2014-10-09 22:22:19,2014-10-09 22:22:19
bae041b39c5b287ea8da7cd56d6f90461a34490f...96bccec0ac3e1bdc48590f9ea24b7713ca347383,2,38,3,41,3,2014-10-09 22:48:40,2014-10-09 20:28:24
419befbf5f42b69095454632618ea2cc64b9a6ef...85505e1082821a317432d3dc6de8b50c952bb8d7,1,24,17,41,3,2015-03-05 01:38:05,2015-03-05 01:38:05
419befbf5f42b69095454632618ea2cc64b9a6ef...2080923951a0900d16fa8ae49fac357af4f187d1,1,0,6,6,1,2015-03-05 01:18:48,2015-03-04 19:50:01
2080923951a0900d16fa8ae49fac357af4f187d1...e2fd3ae6d209238084b9b138f6be862e2bc96214,2,74,26,100,10,2015-03-05 01:18:48,2015-03-04 21:28:17
e2fd3ae6d209238084b9b138f6be862e2bc96214...d20306124a7b8f60150cff99ae356223ab368bdc,1,2,2,4,1,2015-03-05 01:18:48,2015-03-04 21:45:53
d20306124a7b8f60150cff99ae356223ab368bdc...eec489215e72591500b1b1a090a21134293fbca7,17,17,17,34,17,2015-03-05 01:18:48,2015-03-04 21:51:46
eec489215e72591500b1b1a090a21134293fbca7...1cb36460d3558541e52bae4f683d0af85293a454,2,12,3,15,4,2015-03-05 01:18:48,2015-03-05 01:17:39
72949bb27162a5b488611dd18174e9d5bdd20b00...c51eed9330822b65dbdac7171a95148b7b5bda95,4,42,0,42,4,2015-01-26 23:36:48,2015-01-26 23:33:14
074087be8afc56536c4953566b64129f3270f0c2...eeb95efaedfcbf2f7d5bb1d9bad984e470ed32e8,1,7,0,7,1,2015-01-28 01:45:22,2015-01-22 06:07:56
eeb95efaedfcbf2f7d5bb1d9bad984e470ed32e8...f8f90f949c441e88b73fdb8ed100162a2b5b8833,2,13,0,13,2,2015-01-28 01:48:33,2015-01-28 01:48:33
8149538e9c3fa376642f19148956213247bfc956...e7ee6184a65ed890c2f910dd451b1f15af572dfa,4,5,5,10,5,2015-02-01 20:53:03,2015-02-01 20:53:03
26ae0874e7fd14559b1c9065bcc634992699ffb8...a2f724fd47d0ba077d844a3398fb0820f62236bb,3,12,10,22,5,2015-03-10 22:48:06,2015-03-10 22:41:23
a2f724fd47d0ba077d844a3398fb0820f62236bb...7c16b916e420dabf0b7f36bd0077d5e5d490e83c,1,12,3,15,2,2015-03-10 22:48:06,2015-03-10 22:47:24
7c16b916e420dabf0b7f36bd0077d5e5d490e83c...79e0faf2d46486bbcdc9e8276c2f4380a4ab35ac,1,2,2,4,2,2015-03-11 23:38:31,2015-03-11 23:38:31
79e0faf2d46486bbcdc9e8276c2f4380a4ab35ac...498bacdb997f75aa7cc88bcb024fc2b153d8b11f,1,1,1,2,1,2015-03-12 00:15:52,2015-03-12 00:15:52
498bacdb997f75aa7cc88bcb024fc2b153d8b11f...43d6be67341910f1e753a8f5749f7566a6213be2,1,1,1,2,1,2015-03-12 00:46:16,2015-03-09 23:17:57
43d6be67341910f1e753a8f5749f7566a6213be2...55ab7f16c629fa578e1b143ebc29ba64140945e4,1,2,0,2,2,2015-03-12 00:46:16,2015-03-10 01:51:40
55ab7f16c629fa578e1b143ebc29ba64140945e4...34df2383627025901fd53245757b7b9dd4219dd2,1,0,124,124,1,2015-03-12 00:46:17,2015-03-11 03:54:22
34df2383627025901fd53245757b7b9dd4219dd2...ec026e3b609cde8af9f8874853cc8b9296d843d6,2,8,0,8,3,2015-03-12 00:46:17,2015-03-11 04:48:20
ec026e3b609cde8af9f8874853cc8b9296d843d6...9687e1a093aa170a996294f86089d5cc33cceaa7,3,31,44,75,17,2015-03-12 00:47:00,2015-03-12 00:45:19
9687e1a093aa170a996294f86089d5cc33cceaa7...b6c886e2d808b016b10972602aa968394e5e6652,2,41,29,70,13,2015-03-12 02:49:02,2015-03-12 02:49:02
b6c886e2d808b016b10972602aa968394e5e6652...b185e962b88f4652e999f82d9d1ddc21af36ed61,4,8,9,17,8,2015-03-12 03:03:24,2015-03-12 02:52:26
b185e962b88f4652e999f82d9d1ddc21af36ed61...f695f5e8a15f39c61af5b56c6eb0b438efe8e75a,1,3,11,14,3,2015-03-12 03:04:09,2015-03-12 03:03:45
f695f5e8a15f39c61af5b56c6eb0b438efe8e75a...ef1c13ea6a8b646960d74351331901822f383fba,1,2,2,4,2,2015-03-12 03:05:46,2015-03-12 03:05:23
ef1c13ea6a8b646960d74351331901822f383fba...36dc395dc8f44acbea0ab49d05dd15c03bb7cc29,1,4,3,7,3,2015-03-12 03:20:03,2015-03-12 03:20:03
36dc395dc8f44acbea0ab49d05dd15c03bb7cc29...be47860991d5f3a6bbf2846e6e15e4b8169c6c2e,1,5,5,10,3,2015-03-12 03:47:57,2015-03-12 03:47:57
be47860991d5f3a6bbf2846e6e15e4b8169c6c2e...13f5115dc43fd70d21b450f272b9a113f85f97ce,1,18,16,34,9,2015-03-12 04:17:43,2015-03-12 04:17:43
13f5115dc43fd70d21b450f272b9a113f85f97ce...d6c1a40e5d586cf11c246217271a59d9badf328a,1,2,1,3,1,2015-03-12 04:21:17,2015-03-12 04:21:17
d6c1a40e5d586cf11c246217271a59d9badf328a...516c883d407a6444b3d1905beb42ffa5d3dc9c52,1,1,1,2,1,2015-03-12 04:28:37,2015-03-12 04:28:37
516c883d407a6444b3d1905beb42ffa5d3dc9c52...869bf4405f98eb9f64aab18c2dc3ce624c129061,1,35,3,38,5,2015-03-12 04:31:20,2015-03-12 04:30:50
869bf4405f98eb9f64aab18c2dc3ce624c129061...b03eadc5b016f6733700e44b7abbc5a5eb4a81a0,1,1,1,2,1,2015-03-12 05:17:10,2015-03-12 05:17:10
6e5f034a0df9c00a394d2db771b8c2f08727536f...fca8a19b4c410bb0468789025ab5e37efd8dbbaf,1,4,4,8,4,2015-02-06 06:40:43,2015-02-03 19:39:48
fca8a19b4c410bb0468789025ab5e37efd8dbbaf...cf464883bec789254d34d5c341ee316b1a299e27,1,2,2,4,2,2015-02-06 06:40:43,2015-02-03 03:08:05
cf464883bec789254d34d5c341ee316b1a299e27...dbb595639e93eb01cc53e09761420000e4f9621b,1,1,1,2,1,2015-02-06 06:40:43,2015-01-27 16:10:01
dbb595639e93eb01cc53e09761420000e4f9621b...505a77ecad3973d73de92a789afe9b7dd352fe95,5,8,8,16,6,2015-02-06 06:40:43,2015-02-04 02:39:22
505a77ecad3973d73de92a789afe9b7dd352fe95...02d6b020a74605d72ce0a8972992c6bc88050708,2,2,10,12,2,2015-02-06 06:40:44,2015-02-05 17:16:53
02d6b020a74605d72ce0a8972992c6bc88050708...5d08559cc764ab48c303a88b3bbf8f5606b489b7,3,13,9,22,7,2015-02-06 06:40:44,2015-02-03 16:20:10
5d08559cc764ab48c303a88b3bbf8f5606b489b7...30481e10bb723bb324a7d4e1cc815febc7cea858,2,1,2,3,2,2015-02-06 06:40:44,2015-02-04 03:24:24
30481e10bb723bb324a7d4e1cc815febc7cea858...d9cfa85b48727dbdb443053d5003d94111865151,1,4,4,8,4,2015-02-06 06:40:44,2015-02-05 01:37:32
d9cfa85b48727dbdb443053d5003d94111865151...ceb07b254ecf4381f1a384214565edba4a807204,1,14,3,17,1,2015-02-06 06:40:44,2015-02-05 01:44:05
ceb07b254ecf4381f1a384214565edba4a807204...a83008ebb44a8d53f8e36790e77811d2eb9d3c23,4,15,18,33,11,2015-02-06 06:40:44,2015-02-05 05:45:25
a83008ebb44a8d53f8e36790e77811d2eb9d3c23...5936c0b3def55067b951e79bd8482cf639ff0e83,1,12,3,15,1,2015-02-06 06:40:44,2015-02-05 06:22:02
5936c0b3def55067b951e79bd8482cf639ff0e83...2e4d3f28334222268355bfb4849f408081ceb291,3,21,7,28,6,2015-02-06 06:40:45,2015-02-05 06:57:04
2e4d3f28334222268355bfb4849f408081ceb291...a8568eb9927826377f95c9be7d06394dba62fd21,1,34,1,35,3,2015-02-06 18:55:34,2015-02-06 18:55:34
8ffa92c65409934fef01bbf976cd78c7a243eefa...f51094f1da14718eef48277f261441b87a58c6b9,1,1,1,2,1,2015-02-10 02:16:26,2015-02-10 02:16:26
f51094f1da14718eef48277f261441b87a58c6b9...ad999ee0d8a9ba26620377c1d70c37cbe61efb0b,1,1,1,2,1,2015-02-10 02:16:57,2015-02-10 02:16:57
ad999ee0d8a9ba26620377c1d70c37cbe61efb0b...ab292eb2033fb918725f4b368f8b3d56b59b9008,2,8,6,14,2,2015-02-10 02:18:14,2015-02-10 02:18:14
ab292eb2033fb918725f4b368f8b3d56b59b9008...504e05326fc3c70dc097608279bec3db9c7c27c5,1,11,6,17,5,2015-02-10 06:31:10,2015-02-10 05:32:29
504e05326fc3c70dc097608279bec3db9c7c27c5...d747157806731cc8dd84df6c669fe26664c3c31e,1,4,0,4,1,2015-02-10 06:36:50,2015-02-10 06:36:50
8ffa92c65409934fef01bbf976cd78c7a243eefa...64099c349bfe9501683974588a647678baf16f56,1,57,32,89,5,2015-02-10 00:11:21,2015-02-10 00:11:21
64099c349bfe9501683974588a647678baf16f56...d589197f6bd4ee5f68e40766c332a816565967b5,2,45,0,45,5,2015-02-10 01:33:46,2015-02-10 00:35:11
d589197f6bd4ee5f68e40766c332a816565967b5...868c06c031f53c1fc4c3f617b20f05033235342c,7,29,10,39,14,2015-02-10 01:35:05,2015-02-10 01:31:29
868c06c031f53c1fc4c3f617b20f05033235342c...34f002611ec446b4f54ab58a6f723939c398d4d2,1,28,2,30,6,2015-02-10 05:55:23,2015-02-10 05:40:18
34f002611ec446b4f54ab58a6f723939c398d4d2...921bbed9ae4c376aad0e191120644a77846f73e0,1,96,0,96,1,2015-02-10 19:30:15,2015-02-10 19:27:01
921bbed9ae4c376aad0e191120644a77846f73e0...a58b604bbccd35b756be335884228b23c53ea166,1,3,0,3,1,2015-02-10 19:30:21,2015-02-10 19:30:21
c62e1c7cd6444d8438a97223bb09cf81ba38f19f...3372e660d0bebd0d94ad9bc55bc87212277c1913,1,1,1,2,1,2015-01-12 22:31:20,2014-11-17 14:11:16
3372e660d0bebd0d94ad9bc55bc87212277c1913...8cddf2db41f831d4e44e9cfe507f2a27db1d8abe,1,4,1,5,1,2015-01-12 22:36:37,2015-01-12 22:36:37
9a4428bf6ec1b366e413ea31f0a0b08bd74b6fe8...fee326899aced048666d302ba45a380a810793b6,1,0,2,2,1,2014-11-24 22:25:48,2014-11-24 22:25:48
fee326899aced048666d302ba45a380a810793b6...29fb67931b360c7a1bbbb6732927ea3163dc407e,1,39,43,82,8,2014-11-24 23:28:06,2014-11-24 23:28:06
29fb67931b360c7a1bbbb6732927ea3163dc407e...b132dcb677e30c0406afc833f5ab609d43bb0d73,1,26,15,41,9,2014-11-25 01:16:33,2014-11-25 01:16:33
9a4428bf6ec1b366e413ea31f0a0b08bd74b6fe8...39c799e47feca3c806c4081e81b9215d68f0264d,1,52,16,68,6,2014-11-24 13:49:36,2014-11-24 13:49:36
39c799e47feca3c806c4081e81b9215d68f0264d...d4dfc4cc8912eb80fbf3dfb16dc8ea50aba646ae,1,35,24,59,10,2014-12-08 21:35:26,2014-12-08 21:35:26
d4dfc4cc8912eb80fbf3dfb16dc8ea50aba646ae...ec7c7afba02a2d12fd43a40003b52f5b3bee6517,1,27,25,52,8,2014-12-08 23:42:00,2014-12-08 22:41:34
ec7c7afba02a2d12fd43a40003b52f5b3bee6517...6aff197c47a8c6f86422c6eb44f0572de75095be,1,6,3,9,4,2015-01-16 18:47:51,2015-01-16 18:47:51
6aff197c47a8c6f86422c6eb44f0572de75095be...c361b8eeeeea2642ada1692aa00bd7d924243d80,9,77,59,136,32,2015-01-16 19:29:22,2015-01-16 19:29:22
c361b8eeeeea2642ada1692aa00bd7d924243d80...e2d071f31c6e1e88eefb2a58c43d7f761a843864,1,5,5,10,2,2015-01-17 00:00:53,2015-01-17 00:00:53
e2d071f31c6e1e88eefb2a58c43d7f761a843864...9e7c14ac8117ade0fd358c5be1154729f0742e30,19,105,118,223,71,2015-01-17 00:36:23,2015-01-17 00:36:23
9e7c14ac8117ade0fd358c5be1154729f0742e30...9c4e227ae42d33865caec66a1ae112e51710f967,2,4,8,12,2,2015-01-17 00:40:24,2015-01-17 00:40:24
bf47ae7a989be5dcf3efc57fb521d30fd327c933...442274f266ebb689f1182f3817fcf25341799823,5,11,11,22,11,2014-11-14 18:21:34,2014-11-14 18:21:34
bf47ae7a989be5dcf3efc57fb521d30fd327c933...ad397c44b92e1de568ab63d86496643c0932d1d1,1,1,1,2,1,2014-11-14 10:56:08,2014-11-14 10:56:08
96bae0e077eef6230fc2f40dfa969f6231cc65cd...a45b367cc24d6e58da70a6757ee26dc63110105e,2,85,0,85,2,2014-11-11 19:06:11,2014-11-11 19:05:52
96bae0e077eef6230fc2f40dfa969f6231cc65cd...a7bd9a5162d14aee637c126f9c08721d26863827,1,4,6,10,4,2014-11-11 09:12:34,2014-11-11 09:12:34
40d18c195a52c3deb073b2124c0b44953a796bd5...e8d5493e3b5725d9f745331602dd2460618fc017,8,49,44,93,24,2014-10-25 02:15:44,2014-10-25 00:53:24
e8d5493e3b5725d9f745331602dd2460618fc017...5c1a210209f4fad4ff0e92d85c6ee806208b7564,2,25,17,42,10,2014-10-25 02:15:44,2014-10-25 01:55:48
5c1a210209f4fad4ff0e92d85c6ee806208b7564...10ed791597df85aa750954b40a3756c2adf5d7b9,3,11,2,13,3,2014-10-25 02:15:44,2014-10-25 02:01:00
10ed791597df85aa750954b40a3756c2adf5d7b9...1c4ef888ee83ac24190aeba5fa17df6ea434e7e3,1,2,1,3,2,2014-10-25 02:15:44,2014-10-25 02:15:26
1c4ef888ee83ac24190aeba5fa17df6ea434e7e3...8884e23ed8382f41ed6451acd77b3394018e36b1,1,2,2,4,2,2014-10-27 01:30:51,2014-10-27 01:30:51
8884e23ed8382f41ed6451acd77b3394018e36b1...37a124fafa4166ce66803354b6549d28cdd8416b,6,23,19,42,16,2014-10-27 02:25:31,2014-10-27 02:25:16
37a124fafa4166ce66803354b6549d28cdd8416b...11bfac6c043d38afa880bfd4c79177f9a6c7d111,1,3,3,6,1,2014-10-27 04:52:10,2014-10-27 04:52:10
11bfac6c043d38afa880bfd4c79177f9a6c7d111...3165e792f005b31e6cc89e8b86d550c48fdc6995,2,10,0,10,2,2014-10-27 04:55:29,2014-10-27 04:55:29
3165e792f005b31e6cc89e8b86d550c48fdc6995...eeeaa6362921243f2da68e013304231e527de610,4,13,6,19,5,2014-10-27 05:01:32,2014-10-27 05:01:32
eeeaa6362921243f2da68e013304231e527de610...86480f80673889bfa86e21fcbe3da5fe79cf0733,4,130,6,136,6,2014-10-27 08:10:28,2014-10-27 08:10:28
cab3217eb0ff4cefadc5236bd3d427d45a49b8ef...089eab67921a0de7b5a5f966d874b3974f6af75d,1,349,211,560,25,2014-10-17 18:27:12,2014-10-14 20:06:38
089eab67921a0de7b5a5f966d874b3974f6af75d...5562865287d7ed6e8cad69f26acf9d11e03d7564,2,2,2,4,2,2014-10-17 18:27:13,2014-10-14 20:08:20
5562865287d7ed6e8cad69f26acf9d11e03d7564...e02c254eabf4106aead92ccff723bee01710fd07,1,0,44,44,1,2014-10-17 18:27:13,2014-10-14 20:11:03
e02c254eabf4106aead92ccff723bee01710fd07...d1fdb06103c8f77d973782d338cd2a2d2168f94d,6,72,90,162,22,2014-10-17 18:27:13,2014-10-14 20:26:53
d1fdb06103c8f77d973782d338cd2a2d2168f94d...8436ee6a5db3c3e2d9520dc967c810e3a4dc3a33,1,12,12,24,2,2014-10-17 18:27:14,2014-10-14 20:28:17
8436ee6a5db3c3e2d9520dc967c810e3a4dc3a33...2381e22906aba8ca342bc0860ea3f697751cea2a,1,44,33,77,8,2014-10-17 18:27:14,2014-10-14 20:40:11
2381e22906aba8ca342bc0860ea3f697751cea2a...ecd1e19bb98b0ac98dee972f951270c420e852bc,1,6,1,7,2,2014-10-17 18:27:14,2014-10-14 20:40:29
ecd1e19bb98b0ac98dee972f951270c420e852bc...e279a442f4f44644d4c76135f0f041286d01da3f,1,2,0,2,1,2014-10-17 18:27:14,2014-10-14 20:40:56
e279a442f4f44644d4c76135f0f041286d01da3f...c24859de702f24169418184c897e4281a0020959,1,18,6,24,9,2014-10-17 18:27:15,2014-10-14 20:48:23
c24859de702f24169418184c897e4281a0020959...bbd7e0c8cbeb12ab55cedb01cdeea69bacbd4504,1,6,68,74,8,2014-10-17 18:27:15,2014-10-14 20:54:21
bbd7e0c8cbeb12ab55cedb01cdeea69bacbd4504...63ad52fb6b869309e6dd4ee7f592936082085819,1,2,0,2,2,2014-10-17 18:27:15,2014-10-14 20:55:28
63ad52fb6b869309e6dd4ee7f592936082085819...e8477f3a2cdc1aa7ed3c65df2f03b9bc364f0214,1,33,18,51,22,2014-10-17 18:27:15,2014-10-14 21:13:51
e8477f3a2cdc1aa7ed3c65df2f03b9bc364f0214...e7eff3e213b73f0a78e00dc81b53023de817cd83,1,1,1,2,2,2014-10-17 18:27:16,2014-10-14 21:16:27
e7eff3e213b73f0a78e00dc81b53023de817cd83...2f86bdf40651d29fa506db1187eb17dc2c6a4a22,2,134,134,268,2,2014-10-17 18:27:16,2014-10-15 14:53:13
2f86bdf40651d29fa506db1187eb17dc2c6a4a22...301357674f473fb9eecbd34a08642c743a407962,1,107,103,210,3,2014-10-17 18:27:16,2014-10-15 14:56:43
301357674f473fb9eecbd34a08642c743a407962...a68a12dd02aa5fb2d8987a2f0078f947f95f05c0,5,119,53,172,33,2014-10-17 18:27:17,2014-10-15 16:02:08
a68a12dd02aa5fb2d8987a2f0078f947f95f05c0...1b105953ddbe3c97b0fabf62ab85d312453f66dd,1,1,17,18,4,2014-10-17 18:27:17,2014-10-15 16:33:28
1b105953ddbe3c97b0fabf62ab85d312453f66dd...61cc351b955a680d483163fad1caf80ed41814f3,2,58,196,254,26,2014-10-17 18:27:17,2014-10-15 17:49:30
61cc351b955a680d483163fad1caf80ed41814f3...c325023f15279552b50b337e4a2ee0198f5ab315,3,60,44,104,24,2014-10-17 18:27:17,2014-10-15 21:00:36
c325023f15279552b50b337e4a2ee0198f5ab315...fc8ecc53d349da03dce34b6c70c2cf30e4b4350f,1,4,0,4,3,2014-10-17 18:27:18,2014-10-15 21:13:06
fc8ecc53d349da03dce34b6c70c2cf30e4b4350f...78ae5012a1a2e7ac83d673f02f6a08eb55eb5650,1,8,6,14,3,2014-10-17 18:27:18,2014-10-16 01:38:06
b40faa363c1fcfed4f01470f3d90b62f5fb41eb9...af71abfef156ba954d0d2cef84a0ec172eb5d94c,1,27,17,44,22,2014-10-08 15:04:08,2014-10-08 15:04:08
af71abfef156ba954d0d2cef84a0ec172eb5d94c...25d941690c20b7f1165d429c2b9166f5d46d1bae,1,3,0,3,2,2014-10-08 15:06:00,2014-10-08 15:06:00
25d941690c20b7f1165d429c2b9166f5d46d1bae...570644b58902ed9a6e5b8477692ed6564da5764a,1,1,1,2,1,2014-10-08 15:07:07,2014-10-08 15:07:07
570644b58902ed9a6e5b8477692ed6564da5764a...bb77c6e2102bc09fc618bd5801ebd7605dc3c54b,1,11,0,11,1,2014-10-08 15:11:03,2014-10-08 15:11:03
bb77c6e2102bc09fc618bd5801ebd7605dc3c54b...d4fd64da6a02c494f2f60b36257f4aafd3cb425c,1,2,1,3,1,2014-10-08 15:13:09,2014-10-08 15:13:09
d4fd64da6a02c494f2f60b36257f4aafd3cb425c...48e91ff9aa59850723fd620feeb64fecc4e27f88,1,1,1,2,1,2014-10-08 15:39:10,2014-10-08 15:39:10
48e91ff9aa59850723fd620feeb64fecc4e27f88...c88fffbc6a03f15df850b6eb940b85c026b6e166,1,5,0,5,1,2014-10-08 15:42:52,2014-10-08 15:42:52
74c8f252f574a55f04294723befabf2a92da707d...45a18297d1d41b34b2f66a3315d67b72ec92fd1f,3,30,5,35,3,2014-10-08 22:17:03,2014-10-08 22:17:03
74c8f252f574a55f04294723befabf2a92da707d...3f9f3e9c06d622c03bf45004d80850c62e830bc7,1,2,1,3,1,2014-10-08 21:05:53,2014-10-08 20:38:21
3f9f3e9c06d622c03bf45004d80850c62e830bc7...f1592ed5a2d8479a07a4be716bf4574f2cd96e9e,1,2,0,2,1,2014-10-08 21:05:59,2014-10-08 20:53:10
f1592ed5a2d8479a07a4be716bf4574f2cd96e9e...43106972b010bd5d5db85a928b53718afb870396,1,49,0,49,2,2014-10-08 21:06:19,2014-10-08 20:53:30
43106972b010bd5d5db85a928b53718afb870396...a4570b92df0d0f2e4b259df92de36adafef8df30,3,29,51,80,5,2014-10-08 21:26:38,2014-10-08 21:26:38
a4570b92df0d0f2e4b259df92de36adafef8df30...eb24eb59d4ad7cab55356ca7a0fd6f0584d905de,2,8,8,16,6,2014-10-08 21:47:42,2014-10-08 20:29:43
eb24eb59d4ad7cab55356ca7a0fd6f0584d905de...588bf284094e52da5b0d6e8d3c5a94ab45ecf82e,2,2,2,4,2,2014-10-08 21:48:51,2014-10-08 20:29:43
588bf284094e52da5b0d6e8d3c5a94ab45ecf82e...438a87802ee11b6bd2e7ca0f6ebd14c07e758c51,1,2,0,2,1,2014-10-08 21:49:03,2014-10-08 21:38:34
438a87802ee11b6bd2e7ca0f6ebd14c07e758c51...d25bfb7cd8541d092022c2f1c50b76a886f2e98f,1,6,1,7,1,2014-10-08 21:49:10,2014-09-30 19:42:17
cce79392710fe264d10066fa6139e3de744dc768...3dab2c9b50c0052a095b87a9200a74eddc5a4410,1,62,1,63,2,2014-10-09 19:27:02,2014-10-09 19:27:02
cce79392710fe264d10066fa6139e3de744dc768...0dc9149d85b5b26356be40429ad6808b89ed44ca,2,6,2,8,3,2014-10-09 18:46:14,2014-10-09 18:35:04
96bccec0ac3e1bdc48590f9ea24b7713ca347383...8391d54202b97e9ef5d4a7664ea8b05ea6702337,1,1,1,2,1,2014-10-10 03:35:05,2014-10-10 03:35:05
8391d54202b97e9ef5d4a7664ea8b05ea6702337...b2dea881d7f10bdad9e4a6236c016d96521ee6df,1,8,0,8,1,2014-10-10 09:55:09,2014-10-10 09:54:47
b2dea881d7f10bdad9e4a6236c016d96521ee6df...828debbeb4c93b0221f7600ce53b00c65886c692,1,5,0,5,1,2014-10-10 09:58:49,2014-10-10 09:58:49
828debbeb4c93b0221f7600ce53b00c65886c692...6c5f0b0252cbec837da4d0eb4cf04af0764b3f58,1,26,1,27,2,2014-10-10 12:33:06,2014-10-10 12:32:41
6c5f0b0252cbec837da4d0eb4cf04af0764b3f58...c721d6d89eb1c91bdcc95f6c6bd2aed3639fd24a,1,5,7,12,4,2014-10-10 13:59:12,2014-10-10 13:59:12
c721d6d89eb1c91bdcc95f6c6bd2aed3639fd24a...9118a448a513ddd8c196917e7121655b2dedf376,1,5,0,5,1,2014-10-10 15:26:15,2014-10-10 15:26:15
85505e1082821a317432d3dc6de8b50c952bb8d7...b595c5027f26f0e39f2b7c6371edd16fb8a90819,1,2,2,4,1,2015-03-05 02:54:03,2015-03-05 02:54:03
85505e1082821a317432d3dc6de8b50c952bb8d7...d96ddce36316dbc2a296013e2f69340ababe9b22,1,1,1,2,1,2015-03-05 02:18:13,2015-03-03 23:55:03
d96ddce36316dbc2a296013e2f69340ababe9b22...f18b1e8b60a4050f9f96bee165376070620d2974,3,27,21,48,21,2015-03-05 02:18:13,2015-03-03 23:55:56
f18b1e8b60a4050f9f96bee165376070620d2974...3a44443898da01d7999b361506ffd8c029372c85,3,18,0,18,4,2015-03-05 02:18:13,2015-03-04 00:04:28
3a44443898da01d7999b361506ffd8c029372c85...41671359a523436d6827f846beb3388c1a07ca78,9,9,145,154,10,2015-03-05 02:18:13,2015-03-04 00:10:28
41671359a523436d6827f846beb3388c1a07ca78...c584d9ed0eb00b4efa27967026167d516bbb02ea,3,40,10,50,10,2015-03-05 02:18:14,2015-03-04 23:58:24
c584d9ed0eb00b4efa27967026167d516bbb02ea...03e3ae0c6255dc37c837d21c75b4e46a5a84b30c,3,19,6,25,4,2015-03-05 02:18:14,2015-03-05 00:13:24
03e3ae0c6255dc37c837d21c75b4e46a5a84b30c...3c47fff4304c5fe70bad020ea1fa2842642c9cc1,2,23,1,24,3,2015-03-05 02:18:14,2015-03-05 00:19:09
3c47fff4304c5fe70bad020ea1fa2842642c9cc1...2b26f9d8345235f281d80eb84faa5a2f57ee36b2,6,41,20,61,17,2015-03-05 02:18:14,2015-03-05 00:57:40
2b26f9d8345235f281d80eb84faa5a2f57ee36b2...d69030ee0c32b007aa7576e44a34c0f64fc20aaf,1,25,30,55,8,2015-03-05 02:18:14,2015-03-05 01:58:07
d69030ee0c32b007aa7576e44a34c0f64fc20aaf...b69c7ab7d392bdaa43cd574aa5a6f056c8e2bfe1,1,1,0,1,1,2015-03-05 02:18:15,2015-03-05 02:03:42
b69c7ab7d392bdaa43cd574aa5a6f056c8e2bfe1...ccf56361e28e14eab599dffe9c4599081adbcbfa,3,49,1,50,3,2015-03-05 02:18:15,2015-03-05 02:11:50
ccf56361e28e14eab599dffe9c4599081adbcbfa...519244b6abf9f0b07f75773b4fc7d69cf3ab037f,1,11,0,11,1,2015-03-05 02:18:15,2015-03-05 02:14:17
c51eed9330822b65dbdac7171a95148b7b5bda95...5f1c8f2eeb3d4ec41a6a3c395fd39f4a659428b7,3,27,8,35,12,2015-01-26 23:54:47,2014-10-28 18:52:08
5f1c8f2eeb3d4ec41a6a3c395fd39f4a659428b7...1829cfee15076a91c87cf574da3a42b8f76117bc,1,0,5,5,1,2015-01-26 23:55:50,2015-01-26 23:55:50
1829cfee15076a91c87cf574da3a42b8f76117bc...e2706b1390d78e26cae302b18e18742ba7a59b1e,1,2,0,2,1,2015-01-26 23:57:10,2015-01-26 23:57:10
5c83a94edd883fb8ab68b2fe5538853576e85d6d...5269adefb13e11e87d7178089576866e5044b4b5,1,3,4,7,1,2015-01-28 01:59:40,2015-01-28 01:59:40
5269adefb13e11e87d7178089576866e5044b4b5...27714833906864bedd32dcf15eb7bdea3302d2fb,2,8,10,18,3,2015-01-28 02:44:03,2015-01-28 02:41:49
e7ee6184a65ed890c2f910dd451b1f15af572dfa...948d7e34da7ad190089ce8b66ec63346f9c0b9ff,1,0,5,5,1,2015-02-02 20:42:13,2015-02-02 20:42:13
948d7e34da7ad190089ce8b66ec63346f9c0b9ff...45752e3203ee2699d1990dd8e899761756058410,15,163,164,327,130,2015-02-02 21:13:31,2015-02-02 21:13:31
45752e3203ee2699d1990dd8e899761756058410...6705025880e06103caa06b2bd8aaf0a803c31c07,1,0,59,59,3,2015-02-02 21:20:45,2015-02-02 21:20:45
e7ee6184a65ed890c2f910dd451b1f15af572dfa...dea448ea7690ece7e4823eab65e63659ce486330,3,11,11,22,9,2015-02-02 17:09:14,2015-01-23 22:08:16
dea448ea7690ece7e4823eab65e63659ce486330...167a70c23e7490fbed2493a3ee20f089dacf1b51,1,4,0,4,1,2015-02-02 17:09:14,2015-01-23 22:18:56
167a70c23e7490fbed2493a3ee20f089dacf1b51...42534382cca101a9c8726e10020658716f8d5b2b,1,1,0,1,1,2015-02-02 17:09:14,2015-01-23 22:25:46
42534382cca101a9c8726e10020658716f8d5b2b...2fbf2c151df3c4db455774b7172496367dbd975d,1,31,32,63,9,2015-02-02 17:09:14,2015-01-23 22:29:52
2fbf2c151df3c4db455774b7172496367dbd975d...7fbe6522d510b0c7f3264690019b223f28b1c5f1,1,70,70,140,18,2015-02-02 17:09:14,2015-01-23 22:30:10
7fbe6522d510b0c7f3264690019b223f28b1c5f1...b02280fccb2793df881cddcf149bef665645d12e,1,10,1,11,2,2015-02-02 17:09:14,2015-01-26 20:18:24
b02280fccb2793df881cddcf149bef665645d12e...1e3a0ddbbbc2be11ec0a427728e56a9d8b26d62c,1,2,1,3,1,2015-02-02 17:09:14,2015-01-27 19:42:39
1e3a0ddbbbc2be11ec0a427728e56a9d8b26d62c...3409dfdf0e7f7d217cdd18c74d73b81a6d554572,3,4,4,8,3,2015-02-02 17:09:15,2015-01-30 17:54:37
3409dfdf0e7f7d217cdd18c74d73b81a6d554572...260cc3b06b7572823d4755f0c439c9bcd4f57c04,1,30,86,116,7,2015-02-02 17:09:15,2015-01-30 18:01:47
b03eadc5b016f6733700e44b7abbc5a5eb4a81a0...14887d8c9c129b14d8423b1d4c04f546f2573541,3,81,13,94,15,2015-03-12 18:02:09,2015-03-11 03:11:10
b03eadc5b016f6733700e44b7abbc5a5eb4a81a0...dd79aeabbc5106710e3164e6135fe6dc3232f886,5,5,5,10,5,2015-03-12 10:22:29,2015-03-12 10:22:29
07b6a2245a1e091830844881e7376c38adda3592...d02bfe1c8037ab5432fdcab376ca907826138410,1,13,3,16,6,2015-02-06 22:56:05,2015-02-06 22:38:53
07b6a2245a1e091830844881e7376c38adda3592...19080bd53de3e0954e17914410bcf3fa0fead9c8,6,197,179,376,12,2015-02-06 19:33:19,2015-02-06 19:18:41
19080bd53de3e0954e17914410bcf3fa0fead9c8...0ba325d1cad4635ad27082a0548b5659d8cf2740,1,1,0,1,1,2015-02-06 21:40:33,2015-02-06 21:40:33
0ba325d1cad4635ad27082a0548b5659d8cf2740...8fb583507fcb53dfba41934fccc58ffa7f65e8f8,4,28,5,33,7,2015-02-06 21:47:15,2015-02-06 01:32:36
8fb583507fcb53dfba41934fccc58ffa7f65e8f8...7b531c1ad58a2709bed00f99157fc8412cb7af9a,1,6,1,7,3,2015-02-06 21:47:37,2015-02-06 01:39:34
d747157806731cc8dd84df6c669fe26664c3c31e...15e87e33e815d93b230cb5e62a24149a8eec2495,3,25,18,43,19,2015-02-10 19:21:17,2015-02-10 19:21:17
15e87e33e815d93b230cb5e62a24149a8eec2495...4e31c079799e46e830c9528c6a58805e8627e052,4,7,5,12,6,2015-02-10 19:25:33,2015-02-10 19:24:14
4e31c079799e46e830c9528c6a58805e8627e052...7f6231f01d1e128584b461c6323bdbcf89115db4,1,5,6,11,2,2015-02-10 19:42:36,2015-02-10 19:38:59
7f6231f01d1e128584b461c6323bdbcf89115db4...23e71a764f958aacce8f50ff1a5fd37eb1ebcafd,2,5,2,7,4,2015-02-10 19:42:36,2015-02-10 19:42:16
23e71a764f958aacce8f50ff1a5fd37eb1ebcafd...08fccd4e273f539022366cd3bada7ac55e66f22a,1,32,25,57,12,2015-02-10 19:46:14,2015-02-10 19:44:32
08fccd4e273f539022366cd3bada7ac55e66f22a...1bd5ea4cc5f246656619cf30c0b870e3acba1a98,1,3,3,6,3,2015-02-10 19:54:43,2015-02-10 19:53:27
1bd5ea4cc5f246656619cf30c0b870e3acba1a98...b7979dde374be4b45dd8995816e1217a9e75e86f,1,10,0,10,1,2015-02-10 19:56:20,2015-02-10 19:56:20
d747157806731cc8dd84df6c669fe26664c3c31e...7436784e2e820835e1d321aac86a2f5fe7fb981e,1,6,6,12,5,2015-02-10 18:49:07,2015-02-10 18:49:07
7436784e2e820835e1d321aac86a2f5fe7fb981e...b9d4967628200c78d9f4c7ca7c2c4082421663ff,2,8,9,17,8,2015-02-10 19:02:28,2015-02-10 19:02:28
b9d4967628200c78d9f4c7ca7c2c4082421663ff...b5b78c5da8825694fd517aff29b82936e74df8eb,2,6,4,10,2,2015-02-10 20:53:33,2015-02-10 20:53:33
8339d5e799c16ed330e0491f2a809bcd0ce2e179...4f473ff2d2003b69d641aeadd9b9cd06883d4208,2,4,5,9,4,2015-01-13 17:34:50,2015-01-13 17:30:57
4f473ff2d2003b69d641aeadd9b9cd06883d4208...bb573f91197036df9f23ee83fec1e1f398f66e5a,3,3756,2,3758,5,2015-01-13 19:03:51,2015-01-13 19:03:51
bb573f91197036df9f23ee83fec1e1f398f66e5a...8e0bbec6f7df3db9aa2b642bb2111cd276a7d71e,1,4,4,8,4,2015-01-13 19:23:08,2015-01-12 22:35:11
8e0bbec6f7df3db9aa2b642bb2111cd276a7d71e...7f87518477c505c9d244bc9b83ba8cd464fe08f7,1,29,4,33,3,2015-01-13 21:42:45,2015-01-13 21:34:18
7f87518477c505c9d244bc9b83ba8cd464fe08f7...12d030dd5306d6700189192992a39babfdcaea23,22,2417,446,2863,76,2015-01-13 21:53:20,2015-01-13 20:38:33
12d030dd5306d6700189192992a39babfdcaea23...ba7480a3632448a3b17bcf44b1d3f3cb70cb9f91,2,210,61,271,43,2015-01-13 21:53:21,2015-01-07 18:54:42
ba7480a3632448a3b17bcf44b1d3f3cb70cb9f91...3c63838c9dacb0b3893278ed009dc537427f2e6e,1,0,3,3,1,2015-01-13 21:53:21,2015-01-07 19:05:54
3c63838c9dacb0b3893278ed009dc537427f2e6e...a66bb6b10db1f18650e53a21fffc76046e1476dd,3,64,14,78,9,2015-01-13 21:53:21,2015-01-09 02:30:39
a66bb6b10db1f18650e53a21fffc76046e1476dd...5bba62e1f254b99c281ed1c6e5a38d2b8d2d64e6,6,338,78,416,55,2015-01-13 21:53:21,2015-01-09 02:46:15
5bba62e1f254b99c281ed1c6e5a38d2b8d2d64e6...0f6c31cab71d7a3bf353f2a5e76724d8287b8ae6,26,1183,152,1335,136,2015-01-13 21:53:21,2015-01-12 18:27:33
0f6c31cab71d7a3bf353f2a5e76724d8287b8ae6...064580b5538a75af01e40a3e22e569528a5c7484,3,264,24,288,31,2015-01-13 21:53:21,2015-01-10 05:13:38
064580b5538a75af01e40a3e22e569528a5c7484...4f5fdbfac252864d899967936e6e72c40c812147,2,56,61,117,34,2015-01-13 21:53:21,2015-01-12 21:44:00
4f5fdbfac252864d899967936e6e72c40c812147...171b2c4eaf1254461f01fdec42a580aa55bd2119,1,4,3,7,3,2015-01-13 21:53:21,2015-01-12 22:11:49
171b2c4eaf1254461f01fdec42a580aa55bd2119...a43af0215206313b59c76d957ebe3851e0f80c2e,1,6,4,10,2,2015-01-13 21:53:21,2015-01-12 22:10:59
a43af0215206313b59c76d957ebe3851e0f80c2e...2d98e1e19532e0ed095d459992d1e36802bfb583,1,10,8,18,2,2015-01-13 21:53:22,2015-01-12 23:43:24
2d98e1e19532e0ed095d459992d1e36802bfb583...035e95d154fb849a6f459ba6174f648bdd5db0d2,1,1,20,21,1,2015-01-13 21:53:22,2015-01-13 00:27:33
035e95d154fb849a6f459ba6174f648bdd5db0d2...c2228e669dc7c30346f423e2b5f7c2477fab80f0,1,114,76,190,26,2015-01-13 21:53:22,2015-01-13 21:26:50
c2228e669dc7c30346f423e2b5f7c2477fab80f0...798c1635fcc7ec9fdf3517e84d33ef01244ed363,2,49,7,56,33,2015-01-13 21:53:22,2015-01-13 07:28:09
798c1635fcc7ec9fdf3517e84d33ef01244ed363...e4bd9b7a07147bb090004e5bb8418adda4e33fcf,3,7,11,18,5,2015-01-13 21:53:22,2015-01-13 21:52:22
e4bd9b7a07147bb090004e5bb8418adda4e33fcf...44f2305c8ecfde7c29ab684cedbc5fed71e5f995,1,0,1,1,1,2015-01-13 23:40:51,2015-01-13 23:40:51
44f2305c8ecfde7c29ab684cedbc5fed71e5f995...061c176f1df54eab3e540a3b21caf7c056bef6e2,1,1,1,2,1,2015-01-13 23:56:44,2015-01-13 23:54:48
061c176f1df54eab3e540a3b21caf7c056bef6e2...9ab74b60d4f99a82b108fbfc2765620d7bef4086,1,1,1,2,2,2015-01-14 00:05:18,2015-01-14 00:05:18
9ab74b60d4f99a82b108fbfc2765620d7bef4086...97d4dc54df2edb9b02811760fd7f4405f8b2f00c,1,1,4,5,1,2015-01-14 00:07:38,2015-01-13 15:10:43
97d4dc54df2edb9b02811760fd7f4405f8b2f00c...1c6856722c5168522cc36fca62811c961e6a804c,3,8,8,16,8,2015-01-14 00:28:14,2015-01-14 00:28:14
b132dcb677e30c0406afc833f5ab609d43bb0d73...1f31c224357a7c6232851a3600d40749ec2c590d,2,16,41,57,11,2014-11-25 17:06:08,2014-11-06 02:22:01
1f31c224357a7c6232851a3600d40749ec2c590d...0166cef1f0a96dd05aef0ed73d43db61a73e3a56,3,37,33,70,3,2014-11-25 17:06:08,2014-11-06 08:30:31
0166cef1f0a96dd05aef0ed73d43db61a73e3a56...261a93b3dd4c31c6d55fc6a4b4971386f24d4db2,4,20,99,119,5,2014-11-25 17:06:08,2014-11-07 22:56:33
261a93b3dd4c31c6d55fc6a4b4971386f24d4db2...46bb59c6872aecff8e307845acb5518a68e3d97d,1,24,72,96,5,2014-11-25 17:06:08,2014-11-07 23:06:07
46bb59c6872aecff8e307845acb5518a68e3d97d...c3cd93c9897dec9165519a214732c2d2df3101f7,3,12,6,18,5,2014-11-25 17:06:08,2014-11-07 23:12:03
c3cd93c9897dec9165519a214732c2d2df3101f7...da794ab5281689b372460622da0c91ce1d287983,2,28,111,139,16,2014-11-25 17:06:08,2014-11-07 23:24:12
da794ab5281689b372460622da0c91ce1d287983...8d7139e624920e13ab34e88dc56a1dc7c4cc08f8,6,167,11,178,13,2014-11-25 17:06:09,2014-11-08 01:35:56
8d7139e624920e13ab34e88dc56a1dc7c4cc08f8...f7ee343dcb65a333721d24715a937ab2b53fb717,1,19,3,22,4,2014-11-25 17:06:09,2014-11-08 02:10:26
f7ee343dcb65a333721d24715a937ab2b53fb717...964174249d41a26e789262cccbd9a77d182ddf48,4,68,1,69,7,2014-11-25 17:06:09,2014-11-08 02:56:42
964174249d41a26e789262cccbd9a77d182ddf48...e660b2d9d601b3dfa94ce41230360d4c84fbfeda,4,160,51,211,23,2014-11-25 17:06:09,2014-11-11 01:31:54
e660b2d9d601b3dfa94ce41230360d4c84fbfeda...d6cca3a89e688a4c702a25a3010c56167b5d9691,6,230,27,257,22,2014-11-25 17:06:09,2014-11-11 03:05:13
d6cca3a89e688a4c702a25a3010c56167b5d9691...23f5e354d066b0cbc57376e7b910ed5152b42693,4,1024,105,1129,32,2014-11-25 17:06:09,2014-11-11 04:36:19
23f5e354d066b0cbc57376e7b910ed5152b42693...090f131bc1f4d0b24b15d5deeb074666e3ad71a7,1,10,1,11,1,2014-11-25 17:06:10,2014-11-11 04:49:46
090f131bc1f4d0b24b15d5deeb074666e3ad71a7...685df046d080958a4c20723acf8268b7b93cf62d,4,77,6,83,17,2014-11-25 17:06:10,2014-11-11 05:43:42
685df046d080958a4c20723acf8268b7b93cf62d...4a516fef87cbe1a4e2091b0320cfa8c8012dc499,1,5,0,5,1,2014-11-25 17:06:10,2014-11-11 05:51:36
4a516fef87cbe1a4e2091b0320cfa8c8012dc499...715297531637751554952d32b114eb63a629084a,1,1,0,1,1,2014-11-25 17:06:10,2014-11-11 07:04:50
715297531637751554952d32b114eb63a629084a...db66d8d2b6a1da40554ad66085c0f3511837ef2e,2,0,3,3,3,2014-11-25 17:06:10,2014-11-11 07:05:14
db66d8d2b6a1da40554ad66085c0f3511837ef2e...63a3ec64c76ba3b10b4a594c94e4a924b4dc3771,1,2,23,25,1,2014-11-25 17:06:10,2014-11-11 07:05:29
63a3ec64c76ba3b10b4a594c94e4a924b4dc3771...ab4e3abc7b5cf5f7bd5a8f0a8d431a06bea10c6d,4,67,4,71,10,2014-11-25 17:06:11,2014-11-11 07:30:30
ab4e3abc7b5cf5f7bd5a8f0a8d431a06bea10c6d...16d8a8e301f9ef1e7b46a69fd99be6b0c8885994,5,31,119,150,19,2014-11-25 17:06:11,2014-11-11 07:47:01
16d8a8e301f9ef1e7b46a69fd99be6b0c8885994...8aefc5b46f3b2ea89499874afb62757ed6855163,6,84,34,118,31,2014-11-25 17:06:11,2014-11-11 08:25:07
8aefc5b46f3b2ea89499874afb62757ed6855163...a3e5e1b40d0e0a7e989f3ac977b0527bf8319e64,2,1,144,145,3,2014-11-25 17:06:11,2014-11-11 08:28:16
a3e5e1b40d0e0a7e989f3ac977b0527bf8319e64...3983cabb786851fc04fd66cd3c332474129f38ae,1,5,1,6,2,2014-11-25 17:06:11,2014-11-11 08:42:16
3983cabb786851fc04fd66cd3c332474129f38ae...ebf881894bad0b4aa9f8d84abb7ee462411525ee,3,20,8,28,12,2014-11-25 17:06:11,2014-11-11 09:05:51
ebf881894bad0b4aa9f8d84abb7ee462411525ee...431004c089f961b46599963aa2137f3bf4d714f7,1,1,11,12,4,2014-11-25 17:06:11,2014-11-11 09:06:52
431004c089f961b46599963aa2137f3bf4d714f7...4a4db617d328f495069df8925541a4b373feb8f0,1,1,1,2,1,2014-11-25 17:06:12,2014-11-12 00:59:17
4a4db617d328f495069df8925541a4b373feb8f0...14db1041ce555e121c956cf04b04d7697c22329b,2,34,27,61,4,2014-11-25 17:06:12,2014-11-12 01:30:01
14db1041ce555e121c956cf04b04d7697c22329b...17f5cf6273cfb653af9faa1103a828db7176b08a,6,173,280,453,46,2014-11-25 17:06:12,2014-11-12 20:20:01
17f5cf6273cfb653af9faa1103a828db7176b08a...f956f3b635d72c0e14092402ae383093e6cbc96d,1,0,7,7,1,2014-11-25 17:06:12,2014-11-12 21:27:20
f956f3b635d72c0e14092402ae383093e6cbc96d...a1268b8d6b7c36b07e028927a7a475e27f3124c3,4,19,35,54,14,2014-11-25 17:06:12,2014-11-12 21:46:49
a1268b8d6b7c36b07e028927a7a475e27f3124c3...1ea3a5c4a38c5aec39765a571120f6b3d4e53218,2,27,34,61,4,2014-11-25 17:06:12,2014-11-12 21:50:01
1ea3a5c4a38c5aec39765a571120f6b3d4e53218...e737ef4cfe00285c7569cb197989107df9519ebe,4,35,8,43,12,2014-11-25 17:06:13,2014-11-12 21:58:25
e737ef4cfe00285c7569cb197989107df9519ebe...7b529ba9c9480c0f36d87d1c8f7273581a6c615e,1,1,0,1,1,2014-11-25 17:06:13,2014-11-12 21:59:26
7b529ba9c9480c0f36d87d1c8f7273581a6c615e...738a4a00b8ce81ac3f56b33ddf76b46e286d50b2,1,4,2,6,3,2014-11-25 17:06:13,2014-11-12 23:42:25
738a4a00b8ce81ac3f56b33ddf76b46e286d50b2...bf619f2e8be2665e643854ddce0edeaabde382cf,1,4,4,8,4,2014-11-25 17:06:13,2014-11-13 01:00:19
bf619f2e8be2665e643854ddce0edeaabde382cf...83c7f578962ef21ca9a48fb375762c0d3ed98fb5,3,144,4,148,12,2014-11-25 17:06:13,2014-11-13 01:23:58
83c7f578962ef21ca9a48fb375762c0d3ed98fb5...0140b71665a4dcb09c3a306a01cfaf304ae9f595,2,109,15,124,8,2014-11-25 17:06:13,2014-11-13 03:02:27
0140b71665a4dcb09c3a306a01cfaf304ae9f595...8076eb2d7b22ee40702b9372d3b1bfd26a3f0d06,1,0,1,1,1,2014-11-25 17:06:13,2014-11-13 03:04:20
8076eb2d7b22ee40702b9372d3b1bfd26a3f0d06...ace2d7e7cd5b38031e46829a08d2f0ae7be6e6f7,1,36,4,40,6,2014-11-25 17:06:14,2014-11-13 03:10:27
ace2d7e7cd5b38031e46829a08d2f0ae7be6e6f7...bd4939e815e5981ed3607bf116bdbd988bb71bc0,3,77,47,124,48,2014-11-25 17:06:14,2014-11-13 03:31:59
bd4939e815e5981ed3607bf116bdbd988bb71bc0...8296f7f8b77015e67b07ba69739c5cb10a2cb65c,1,21,9,30,11,2014-11-25 17:06:14,2014-11-13 06:32:46
8296f7f8b77015e67b07ba69739c5cb10a2cb65c...8e484170ae40e2913fc9b5a669d236bfd1b58d6a,8,32,209,241,25,2014-11-25 17:06:14,2014-11-13 07:43:32
8e484170ae40e2913fc9b5a669d236bfd1b58d6a...0738e2ddb4f3b5395cdd183ad0b6fdcfa3f046c0,4,6,163,169,10,2014-11-25 17:06:14,2014-11-13 07:47:13
0738e2ddb4f3b5395cdd183ad0b6fdcfa3f046c0...ed4325aca5dfec0766e26ac13ea5162a360102ed,3,0,149,149,4,2014-11-25 17:06:14,2014-11-13 07:48:43
ed4325aca5dfec0766e26ac13ea5162a360102ed...1dd0926d27c31ee190f22fcdb7e886e6bf2894f6,1,2,3,5,2,2014-11-25 17:06:15,2014-11-13 07:49:29
1dd0926d27c31ee190f22fcdb7e886e6bf2894f6...ccfd41ba7a38abd2c2337d43f563fcff35e0b1ad,1,1,50,51,4,2014-11-25 17:06:15,2014-11-13 07:54:29
ccfd41ba7a38abd2c2337d43f563fcff35e0b1ad...ee649d3bdaa85c6b3c09edb68d96ccd443e436a6,12,234,1494,1728,65,2014-11-25 17:06:15,2014-11-13 08:02:33
ee649d3bdaa85c6b3c09edb68d96ccd443e436a6...e313b8e3d8645df3af6af090e5a426089733f398,1,3,36,39,2,2014-11-25 17:06:15,2014-11-13 08:08:41
e313b8e3d8645df3af6af090e5a426089733f398...e921b20caa0629bbc4e6d4c97f8be5fb3000df8c,6,9,163,172,8,2014-11-25 17:06:15,2014-11-13 08:14:08
e921b20caa0629bbc4e6d4c97f8be5fb3000df8c...c862b30e1e57421246a5d613cc00f103670a7211,1,0,23,23,3,2014-11-25 17:06:15,2014-11-13 08:16:51
c862b30e1e57421246a5d613cc00f103670a7211...490511a498101a654d1101af6c65d2e7df3f5a0d,3,4,17,21,6,2014-11-25 17:06:15,2014-11-13 08:19:14
490511a498101a654d1101af6c65d2e7df3f5a0d...438ddad7bc1e4b03849047b95a16346c5ab3947c,8,51,165,216,40,2014-11-25 17:06:16,2014-11-13 08:32:50
438ddad7bc1e4b03849047b95a16346c5ab3947c...8f6a7b757bee7e26299ffd1b14335f137c449354,3,0,8,8,3,2014-11-25 17:06:16,2014-11-13 08:34:49
8f6a7b757bee7e26299ffd1b14335f137c449354...88e4ecdc182a9d8796c916b28f9ae8af5430a6d3,1,28,50,78,10,2014-11-25 17:06:16,2014-11-13 08:45:39
88e4ecdc182a9d8796c916b28f9ae8af5430a6d3...79983892878a0cab6a5d4cb4726de8e5488cac2c,6,98,43,141,27,2014-11-25 17:06:16,2014-11-13 17:33:59
79983892878a0cab6a5d4cb4726de8e5488cac2c...0d36f83f907b3db4b19857c8e793272a3f290ef5,2,43,36,79,28,2014-11-25 17:06:16,2014-11-13 17:56:12
0d36f83f907b3db4b19857c8e793272a3f290ef5...ea7c60253fc27fb41bb5c53698cb083cb9099975,2,32,16,48,9,2014-11-25 17:06:16,2014-11-13 18:45:35
ea7c60253fc27fb41bb5c53698cb083cb9099975...7b952d50e9ca386cc5314fb7f81ef26d436e1a14,3,65,5,70,9,2014-11-25 17:06:17,2014-11-13 19:11:29
7b952d50e9ca386cc5314fb7f81ef26d436e1a14...9f8b533fcc1bc60cdc6cde61e166bd4c4835db53,3,24,14,38,9,2014-11-25 17:06:17,2014-11-13 19:28:33
9f8b533fcc1bc60cdc6cde61e166bd4c4835db53...e9a34062a86705f0b7c46203a682dd2203fc817d,2,314,1033,1347,3,2014-11-25 17:06:17,2014-11-13 19:42:36
e9a34062a86705f0b7c46203a682dd2203fc817d...055575a80c73ed0fcb44024c2a13705c44b3043c,6,113,35,148,25,2014-11-25 17:06:17,2014-11-13 20:16:40
055575a80c73ed0fcb44024c2a13705c44b3043c...a9a34117037a7dd933d294a6db79df77a1204b2c,11,70,70,140,40,2014-11-25 17:06:17,2014-11-13 23:40:42
a9a34117037a7dd933d294a6db79df77a1204b2c...4f1da93bc424f333139829bee277b1d5006e7dce,2,36,25,61,7,2014-11-25 17:06:17,2014-11-15 02:09:15
4f1da93bc424f333139829bee277b1d5006e7dce...4563258ec09234add38b5d3bb4238b9341137fc1,5,123,143,266,53,2014-11-25 17:06:17,2014-11-15 02:37:19
4563258ec09234add38b5d3bb4238b9341137fc1...5808c56af8730ec7a74a502c2fcdbde199d322e8,2,60,86,146,8,2014-11-25 17:06:18,2014-11-15 20:48:18
5808c56af8730ec7a74a502c2fcdbde199d322e8...c3b6ab1cf2dfec015d783de1d8775d817af27126,4,18,15,33,14,2014-11-25 17:06:18,2014-11-15 21:24:34
c3b6ab1cf2dfec015d783de1d8775d817af27126...19c9536bf50e64409a12903902e85a91e7fafa80,1,10,14,24,2,2014-11-25 17:06:18,2014-11-15 21:37:45
19c9536bf50e64409a12903902e85a91e7fafa80...f0ff76a24b0549bdc10df4adeff6431a0d3ebbc1,7,54,110,164,21,2014-11-25 17:06:18,2014-11-15 22:13:17
f0ff76a24b0549bdc10df4adeff6431a0d3ebbc1...266b75c33b4543765a3002ecc24437d6453a1b8a,1,3,3,6,3,2014-11-25 17:06:18,2014-11-15 22:23:45
266b75c33b4543765a3002ecc24437d6453a1b8a...a7c0cfdc77290733c99a75b366d111985f9b729d,1,8,0,8,2,2014-11-25 17:06:18,2014-11-15 22:26:37
a7c0cfdc77290733c99a75b366d111985f9b729d...c344278b96b6571a55ac7f887899046802b9e20f,4,48,46,94,15,2014-11-25 17:06:18,2014-11-15 22:40:24
c344278b96b6571a55ac7f887899046802b9e20f...e05692a8d226a4ad89f400070ce0c5f71b94722a,1,2,2,4,1,2014-11-25 17:06:19,2014-11-15 22:49:50
e05692a8d226a4ad89f400070ce0c5f71b94722a...2b818092ce636078e050610a5d11f58b840f73b6,3,81,66,147,24,2014-11-25 17:06:19,2014-11-16 02:19:57
2b818092ce636078e050610a5d11f58b840f73b6...45be10a5659fc6b082cd0996cbf5e561290ef95f,1,11,2,13,1,2014-11-25 17:06:19,2014-11-16 03:57:06
45be10a5659fc6b082cd0996cbf5e561290ef95f...637a3ec37b049eef490cb2b1b00f618b95797136,5,62,69,131,37,2014-11-25 17:06:19,2014-11-16 04:24:08
637a3ec37b049eef490cb2b1b00f618b95797136...f7f77b44cdb6e39cee7aecd45b218cf3d5a1af77,2,34,42,76,15,2014-11-25 17:06:19,2014-11-16 04:46:01
f7f77b44cdb6e39cee7aecd45b218cf3d5a1af77...3a38ef0369d64a335f45a96794361558f49cb2af,1,0,8,8,6,2014-11-25 17:06:19,2014-11-16 04:47:46
3a38ef0369d64a335f45a96794361558f49cb2af...83421c288ae96415f02360c76d8a9ae2f30357f4,3,0,18,18,3,2014-11-25 17:06:19,2014-11-16 06:55:08
83421c288ae96415f02360c76d8a9ae2f30357f4...7b256e58c2753476df30dfea724c3a2966203af0,1,85,52,137,29,2014-11-25 17:06:19,2014-11-16 07:24:52
7b256e58c2753476df30dfea724c3a2966203af0...2410cec49d49dcd37cb945775c1a268c54c27e27,2,39,12,51,10,2014-11-25 17:06:20,2014-11-16 19:58:46
2410cec49d49dcd37cb945775c1a268c54c27e27...1a9536baa2f55ebc8a199c8e1d46f7bbaa6e6416,4,242,214,456,44,2014-11-25 17:06:20,2014-11-16 21:47:43
1a9536baa2f55ebc8a199c8e1d46f7bbaa6e6416...f02336d0cd1adb4ad379ca07162a8bdc3988a55b,2,29,19,48,14,2014-11-25 17:06:20,2014-11-16 22:09:04
f02336d0cd1adb4ad379ca07162a8bdc3988a55b...45cc54fb63bbf956dec6109152b586ea9dbaf8eb,7,4,7,11,11,2014-11-25 17:06:20,2014-11-16 23:23:33
45cc54fb63bbf956dec6109152b586ea9dbaf8eb...5fcab5c42d900a19d47573aba3336e60b9c102fd,4,44,18,62,11,2014-11-25 17:06:20,2014-11-16 23:36:24
5fcab5c42d900a19d47573aba3336e60b9c102fd...1e7a4f3b08bb9df6a8ed0ec69844097e95b49ff6,2,25,37,62,10,2014-11-25 17:06:20,2014-11-17 00:13:23
1e7a4f3b08bb9df6a8ed0ec69844097e95b49ff6...bebab0851841aae72d738afbe15d572ec999cbf8,1,2,1,3,1,2014-11-25 17:06:21,2014-11-17 00:21:16
bebab0851841aae72d738afbe15d572ec999cbf8...6db0e3607a9cdb310319e8b8f37a8c34aed8daef,2,9,3,12,6,2014-11-25 17:06:21,2014-11-17 00:21:39
6db0e3607a9cdb310319e8b8f37a8c34aed8daef...d38fbdf903a987e7a017dc1d52d443d67dff5062,1,14,3,17,4,2014-11-25 17:06:21,2014-11-17 00:37:49
d38fbdf903a987e7a017dc1d52d443d67dff5062...12851424d4b02f7ef688e883d235d500e6f111b9,4,0,8,8,4,2014-11-25 17:06:21,2014-11-17 03:57:05
12851424d4b02f7ef688e883d235d500e6f111b9...645456b5b04efea1ae5f543b243b5fbfcfa4690a,1,16,95,111,13,2014-11-25 17:06:21,2014-11-17 04:14:01
645456b5b04efea1ae5f543b243b5fbfcfa4690a...20200f71302c07b9879a373b4d27760efb66ebff,3,94,53,147,22,2014-11-25 17:06:21,2014-11-17 05:37:10
20200f71302c07b9879a373b4d27760efb66ebff...ad789153229f26cb74a7a478fbab754ecd8277d2,4,44,88,132,14,2014-11-25 17:06:21,2014-11-17 06:01:22
ad789153229f26cb74a7a478fbab754ecd8277d2...3da57f75f9ae0b9630328fd29b8d4c6e37ae12d6,1,64,54,118,16,2014-11-25 17:06:21,2014-11-18 00:44:55
3da57f75f9ae0b9630328fd29b8d4c6e37ae12d6...6928c41fee7b70583a5723c10fef5fb930615330,1,64,62,126,6,2014-11-25 17:06:22,2014-11-18 01:50:08
6928c41fee7b70583a5723c10fef5fb930615330...a553048fe6fc71c42b612383f0690f9b705880b5,3,46,25,71,21,2014-11-25 17:06:22,2014-11-18 01:53:38
a553048fe6fc71c42b612383f0690f9b705880b5...61b1493ee9b3d5daa012633f10fe3811ecfe5b5d,4,104,347,451,25,2014-11-25 17:06:22,2014-11-18 03:43:50
61b1493ee9b3d5daa012633f10fe3811ecfe5b5d...f5ab70377ca40057ace25ce62827733a9fdff5eb,1,14,9,23,2,2014-11-25 17:06:22,2014-11-18 04:45:43
f5ab70377ca40057ace25ce62827733a9fdff5eb...fce3f4762bb36743bb272b810c0a358854ee0687,1,2,8,10,3,2014-11-25 17:06:22,2014-11-18 04:48:24
fce3f4762bb36743bb272b810c0a358854ee0687...d418e38e3ab01d1da226fde9d6fb7dcaf6280a89,1,0,2,2,1,2014-11-25 17:06:22,2014-11-18 06:44:41
d418e38e3ab01d1da226fde9d6fb7dcaf6280a89...1a4dcef219b50a570fb2be5571c2dbf4f015cdb7,4,34,31,65,16,2014-11-25 17:06:22,2014-11-18 21:38:25
1a4dcef219b50a570fb2be5571c2dbf4f015cdb7...4767b830d08167773df171db50b384d1b05336ca,1,17,2,19,1,2014-11-25 17:06:23,2014-11-18 21:45:57
4767b830d08167773df171db50b384d1b05336ca...d9ff79cd9cb395fb15fb5aa954d8941684ded9a9,2,40,16,56,14,2014-11-25 17:06:23,2014-11-18 22:39:27
d9ff79cd9cb395fb15fb5aa954d8941684ded9a9...11ab8edaa9c27db7ec2cda98428b925feefbc9a4,2,74,20,94,13,2014-11-25 17:06:23,2014-11-19 00:19:03
11ab8edaa9c27db7ec2cda98428b925feefbc9a4...e1572801d5910ebfb88eaccc4831cb9e0c77eebf,2,20,74,94,13,2014-11-25 17:06:23,2014-11-19 02:30:45
e1572801d5910ebfb88eaccc4831cb9e0c77eebf...e88f588cfcb4e9a69d91928e56b0c208005614d6,5,173,135,308,43,2014-11-25 17:06:23,2014-11-19 03:38:46
e88f588cfcb4e9a69d91928e56b0c208005614d6...b07c3578ac2795a10f875615977cdf66539f13ab,2,66,96,162,13,2014-11-25 17:06:23,2014-11-19 04:21:33
b07c3578ac2795a10f875615977cdf66539f13ab...275456054fe892ff40e1eb4e9aef5f8a2530be2a,4,38,13,51,11,2014-11-25 17:06:23,2014-11-19 18:52:54
275456054fe892ff40e1eb4e9aef5f8a2530be2a...7676e1d192c96ce3a29e852c8ff244fe03179368,3,4,4,8,4,2014-11-25 17:06:24,2014-11-19 19:42:05
7676e1d192c96ce3a29e852c8ff244fe03179368...06114d6983a6c7d1714b754dd7c2335a7b8a444a,8,286,267,553,66,2014-11-25 17:06:24,2014-11-22 03:03:30
06114d6983a6c7d1714b754dd7c2335a7b8a444a...bf7ffbad30c099ee086212b90703a247a707cbec,1,1,1,2,1,2014-11-25 17:06:24,2014-11-22 03:08:32
bf7ffbad30c099ee086212b90703a247a707cbec...960bd07e53950bab829614a0bd1ec0158c146eb4,1,14,11,25,6,2014-11-25 17:06:24,2014-11-22 04:14:26
960bd07e53950bab829614a0bd1ec0158c146eb4...c3b545b9aa123923779a341f54fa0bbdb40b57dd,2,25,16,41,10,2014-11-25 17:06:24,2014-11-22 04:20:10
c3b545b9aa123923779a341f54fa0bbdb40b57dd...ec6ddbd7b706cd32d2bc34c70109c7489df8d525,1,4,3,7,1,2014-11-25 17:06:24,2014-11-22 04:36:47
ec6ddbd7b706cd32d2bc34c70109c7489df8d525...47ddf01c7d6604db30cc1612c0143b30e72d4340,1,2,2,4,2,2014-11-25 17:06:24,2014-11-22 04:37:11
47ddf01c7d6604db30cc1612c0143b30e72d4340...c55c76280b67e245afbc83d40a81ef8f03b74435,4,65,43,108,36,2014-11-25 17:06:24,2014-11-22 08:08:30
c55c76280b67e245afbc83d40a81ef8f03b74435...17bcac2b447e6b0ed5567dd8f34b5972678bf6b1,1,1,1,2,1,2014-11-25 17:06:25,2014-11-22 18:35:57
17bcac2b447e6b0ed5567dd8f34b5972678bf6b1...8846a7acbd29e283c3f56b6dc84652f01110e602,1,0,1,1,1,2014-11-25 17:06:25,2014-11-22 18:51:32
8846a7acbd29e283c3f56b6dc84652f01110e602...27d67fe3798f11fa9952207264ac0a723176d17d,3,1,266,267,9,2014-11-25 17:06:25,2014-11-22 18:56:28
27d67fe3798f11fa9952207264ac0a723176d17d...30c80debcbb84e346d559da6e9797ff122d60ef7,1,0,10,10,1,2014-11-25 17:06:25,2014-11-22 21:13:12
30c80debcbb84e346d559da6e9797ff122d60ef7...dddf0b246e8ef320cfdadbb4843939f086686ab8,1,1,0,1,1,2014-11-25 17:06:25,2014-11-22 22:25:42
dddf0b246e8ef320cfdadbb4843939f086686ab8...cd625a3795dca96846ca633744bd463d779ca667,2,19,43,62,5,2014-11-25 17:06:25,2014-11-22 22:27:32
cd625a3795dca96846ca633744bd463d779ca667...602e6f553901f9c5dd1ba6f910ea0647957dca1d,2,23,6,29,8,2014-11-25 17:06:25,2014-11-22 22:52:47
602e6f553901f9c5dd1ba6f910ea0647957dca1d...59fefc00c2655925000401ba0502ec90f9f12315,1,1,0,1,1,2014-11-25 17:06:26,2014-11-22 23:43:23
59fefc00c2655925000401ba0502ec90f9f12315...380ab7c327fa0f2a6906999938798d09f0e1c51e,4,92,184,276,17,2014-11-25 17:06:26,2014-11-23 00:26:55
380ab7c327fa0f2a6906999938798d09f0e1c51e...2f7412573c1e76fe292ab75d8edfda4cee893b74,3,4,182,186,12,2014-11-25 17:06:26,2014-11-23 04:51:09
2f7412573c1e76fe292ab75d8edfda4cee893b74...aba516de9c35331072584be6a0a56390c3dda382,3,21,6,27,7,2014-11-25 17:06:26,2014-11-23 05:08:43
aba516de9c35331072584be6a0a56390c3dda382...ae819ab47f1058474d415f28fccc15f7e3e42b6c,2,133,135,268,20,2014-11-25 17:06:26,2014-11-23 05:42:32
ae819ab47f1058474d415f28fccc15f7e3e42b6c...1ad981ee1001cf0b9ca8d3f4c8c665bb87b27475,4,163,239,402,17,2014-11-25 17:06:26,2014-11-23 06:30:52
1ad981ee1001cf0b9ca8d3f4c8c665bb87b27475...de5f68cf704dda4f6187896f86e204ffbc0551e6,122,122,122,244,122,2014-11-25 17:06:26,2014-11-23 06:39:20
de5f68cf704dda4f6187896f86e204ffbc0551e6...a6add4ef3477c0062a7ae6d7303fe294bbe91f4d,3,8,6,14,7,2014-11-25 17:06:27,2014-11-23 06:55:20
a6add4ef3477c0062a7ae6d7303fe294bbe91f4d...75f628bab4d66be6d76b98ddb48655ca3c5f16f3,2,41,9,50,6,2014-11-25 17:06:27,2014-11-23 08:02:16
75f628bab4d66be6d76b98ddb48655ca3c5f16f3...8b953ece72e0e2fa0cb6b8725450e44504248a6d,1,1,1,2,1,2014-11-25 17:06:27,2014-11-23 08:03:56
8b953ece72e0e2fa0cb6b8725450e44504248a6d...3b7459e62a7e9cfd6315752bc0b7a42b3c8a2ba0,13,153,167,320,34,2014-11-25 17:06:27,2014-11-24 19:40:44
3b7459e62a7e9cfd6315752bc0b7a42b3c8a2ba0...3d8d5ce88cb4de75d93dd1ffee9813e5eaae00ff,2,14,7,21,6,2014-11-25 17:06:27,2014-11-24 19:58:58
3d8d5ce88cb4de75d93dd1ffee9813e5eaae00ff...cb7a18f89a4a60b5433592887098e4793c9433af,1,2,11,13,3,2014-11-25 17:06:27,2014-11-24 20:18:52
cb7a18f89a4a60b5433592887098e4793c9433af...a0c05857d97eb33ac82271085794579ab287570f,2,8,8,16,7,2014-11-25 17:06:28,2014-11-24 20:32:13
a0c05857d97eb33ac82271085794579ab287570f...46d31e1ce7ea604cfb27d217c26a9463f8ebc197,7,23,19,42,12,2014-11-25 17:06:28,2014-11-24 22:57:43
46d31e1ce7ea604cfb27d217c26a9463f8ebc197...7d856564fa4e130a219832d2d4afa54d1e7bc711,3,36,41,77,20,2014-11-25 17:06:28,2014-11-25 00:22:40
7d856564fa4e130a219832d2d4afa54d1e7bc711...4a5636b8fd70ab5913d3640e562cd9b7fe8e0f02,7,6,44,50,8,2014-11-25 17:06:28,2014-11-25 00:31:02
4a5636b8fd70ab5913d3640e562cd9b7fe8e0f02...02856bca84407176c0297fd0225655bcfe1bcf3b,4,43,10,53,10,2014-11-25 17:06:28,2014-11-25 01:27:33
02856bca84407176c0297fd0225655bcfe1bcf3b...5622d3384ecdb6a2f23190f3a7529eb77433edcb,2,27,34,61,21,2014-11-25 17:06:28,2014-11-25 01:44:55
5622d3384ecdb6a2f23190f3a7529eb77433edcb...3e1621cdf6cb73d8ea9842f5ed033820b07f907b,6,30,247,277,20,2014-11-25 17:06:28,2014-11-25 01:52:30
3e1621cdf6cb73d8ea9842f5ed033820b07f907b...b00043e92e883c75f4925d76068d25b203ae18b7,1,5,24,29,4,2014-11-25 17:06:29,2014-11-25 03:05:46
b00043e92e883c75f4925d76068d25b203ae18b7...c226c652e928d279fa1bf9f86683f56dd622f6b3,2,9,34,43,6,2014-11-25 17:06:29,2014-11-25 03:31:36
c226c652e928d279fa1bf9f86683f56dd622f6b3...48634b712443ec69c330eff10a0d59967c1a8e2f,1,5,7,12,5,2014-11-25 17:06:29,2014-11-25 04:23:45
48634b712443ec69c330eff10a0d59967c1a8e2f...f0ce81aaa20ac6b60d6ad7831a07eb6f76ac00c5,1,1,1,2,1,2014-11-25 17:06:29,2014-11-25 04:23:45
f0ce81aaa20ac6b60d6ad7831a07eb6f76ac00c5...1ccf81fea0c40b2fc995b2eb4a5c38ab43b16194,3,8,8,16,8,2014-11-25 17:06:29,2014-11-25 06:05:49
1ccf81fea0c40b2fc995b2eb4a5c38ab43b16194...e42e104bc22013eae30f642c7b26e333356bc89f,1,12,12,24,2,2014-11-25 17:06:29,2014-11-25 06:11:56
e42e104bc22013eae30f642c7b26e333356bc89f...1a56f3c55d78f0276bc13bbd412c15c94e30db24,3,110,153,263,51,2014-11-25 17:06:30,2014-11-25 06:40:15
1a56f3c55d78f0276bc13bbd412c15c94e30db24...9ea3b92cb4e015f31fcd6a783155966974e3f614,1,2,2,4,3,2014-11-25 17:06:30,2014-11-25 06:45:33
9ea3b92cb4e015f31fcd6a783155966974e3f614...d107d7292dd247b4b5b8235c1a14cb68dbcb8507,2,8,2,10,5,2014-11-25 17:06:30,2014-11-25 07:25:55
d107d7292dd247b4b5b8235c1a14cb68dbcb8507...4949c396ab38aa7392ff8f15d69d5237908c69b9,1,4,2,6,4,2014-11-25 17:06:30,2014-11-25 07:42:09
4949c396ab38aa7392ff8f15d69d5237908c69b9...f5901a74da6963c199302e1d0d689c77d37caa3d,2,43,47,90,25,2014-11-25 17:06:30,2014-11-25 08:08:19
f5901a74da6963c199302e1d0d689c77d37caa3d...d4c7bf202026d1b09b08315a5d5390ae204b6c8f,1,9,12,21,12,2014-11-25 17:06:30,2014-11-25 08:11:11
d4c7bf202026d1b09b08315a5d5390ae204b6c8f...0275afcfc95508a31dbcca4564b2c0af758330ca,1,6,2,8,1,2014-11-25 17:06:31,2014-11-25 16:33:35
0275afcfc95508a31dbcca4564b2c0af758330ca...ab6317a0ff6020d9d313c01e78d43c8b04859a89,1,0,123,123,1,2014-11-25 17:06:31,2014-11-25 16:33:58
ab6317a0ff6020d9d313c01e78d43c8b04859a89...8deba5c9bb092424e869d7cf075359b20a9d3e5c,2,0,5,5,2,2014-11-25 17:06:31,2014-11-25 16:34:32
8deba5c9bb092424e869d7cf075359b20a9d3e5c...f4e69b9e967bf7aefaaa149a943f1a76a5429d44,1,1,2,3,2,2014-11-25 17:06:31,2014-11-25 17:04:46
f4e69b9e967bf7aefaaa149a943f1a76a5429d44...d76f489b0f7360e6a5a329b5425e4d41342a9725,1,1,1,2,1,2014-11-25 17:12:19,2014-11-25 17:12:19
d76f489b0f7360e6a5a329b5425e4d41342a9725...1d4c3e7387c8c05dfe37bf4e72ce0bd013e57918,8,17,27,44,20,2014-11-25 17:35:34,2014-11-25 17:35:34
b132dcb677e30c0406afc833f5ab609d43bb0d73...86eddcb99ece879631cba3b3f6a735dfa7eb8738,7,139,120,259,52,2014-11-25 01:39:09,2014-11-24 21:13:52
442274f266ebb689f1182f3817fcf25341799823...14735344f4c337c8c5132b601c14655dbce6b166,5,11,11,22,11,2014-11-14 18:49:37,2014-11-14 18:49:37
5a70c72dd6a603d46c9de7553a3e8044d3019e00...847e64b02f7c15edcbd305838ef4a339e34fe406,1,8,4,12,4,2014-12-09 02:54:44,2014-12-09 02:54:15
847e64b02f7c15edcbd305838ef4a339e34fe406...4920ad1724854aeef5264e86a6d83fcd8f1e69b5,2,26,2,28,3,2014-12-09 06:02:50,2014-12-09 06:02:50
4920ad1724854aeef5264e86a6d83fcd8f1e69b5...70f257c0e439927dd13ef78a55dc162d22b6562c,2,27,3,30,8,2014-12-09 07:18:15,2014-12-09 06:51:18
70f257c0e439927dd13ef78a55dc162d22b6562c...ba89b7db60a78f3eb86956ee08ca30db0bd19c02,2,277,45,322,28,2014-12-09 18:38:28,2014-12-04 21:18:12
5a70c72dd6a603d46c9de7553a3e8044d3019e00...918a9e0a6b8962e676064e4f87db7061adf0f67a,1,26,7,33,3,2014-12-09 00:38:01,2014-12-09 00:38:01
918a9e0a6b8962e676064e4f87db7061adf0f67a...ebce6c46aabc703d59e470fe5292b7314a2ec9a6,2,16,0,16,2,2014-12-09 01:05:05,2014-12-09 01:05:05
ebce6c46aabc703d59e470fe5292b7314a2ec9a6...ab92f117ae60cbe3ff3bbd0a4f72910ca888b36c,5,49,10,59,10,2014-12-09 21:17:12,2014-12-09 21:14:17
5a70c72dd6a603d46c9de7553a3e8044d3019e00...0578255df2eab9a01b0f2a05e9cbbd6dcdac1ba5,2,252,45,297,28,2014-12-09 00:20:05,2014-12-04 21:18:12
86480f80673889bfa86e21fcbe3da5fe79cf0733...46dd7c736d0efb268eca03167b474f06db5f6845,7,47,11,58,12,2014-10-27 17:17:08,2014-10-27 17:17:08
86480f80673889bfa86e21fcbe3da5fe79cf0733...53c84e21d1b2d0fe9b0f0de244dba6fd45a1f4a3,2,25,21,46,13,2014-10-27 16:44:17,2014-10-27 16:44:17
5acd6529d96274c3a0e68837390cb9c3076c5f69...c838fbb4998d34b4bbe79b9ef5330c3042882fe3,1,40,0,40,1,2014-10-17 19:10:26,2014-10-17 19:09:01
c838fbb4998d34b4bbe79b9ef5330c3042882fe3...78b7896ea5ef2f03107d48352a15faf99b0c7b48,1,2,2,4,2,2014-10-17 19:49:49,2014-10-17 19:49:49
78b7896ea5ef2f03107d48352a15faf99b0c7b48...eed545e3135226f85c7f81728f589d7846672adc,1,1,1,2,1,2014-10-17 19:56:25,2014-10-17 19:55:50
eed545e3135226f85c7f81728f589d7846672adc...66261e0b5a2bb0cffb0812fb28019e1ab7304093,1,1,1,2,1,2014-10-17 20:24:43,2014-10-17 20:19:46
66261e0b5a2bb0cffb0812fb28019e1ab7304093...f82d8d24cc429a3f1b7e062756260b824767ae5f,1,4,2,6,3,2014-10-17 20:24:44,2014-10-17 20:22:16
f82d8d24cc429a3f1b7e062756260b824767ae5f...15375be8f8be8fd3467246d47848e3f89bc957de,1,1,1,2,1,2014-10-17 20:24:44,2014-10-17 20:23:44
15375be8f8be8fd3467246d47848e3f89bc957de...174a059904bb9670b7af5ba1151bb4d70159cda5,1,1,1,2,1,2014-10-17 20:37:04,2014-10-17 20:37:04
c88fffbc6a03f15df850b6eb940b85c026b6e166...19f845fccc9b0013ca561150d896709cda5553fa,2,25,2,27,6,2014-10-08 17:09:06,2014-10-08 17:02:35
19f845fccc9b0013ca561150d896709cda5553fa...f12fddb95d2f0e0a91a3d30e84cb343f582500ba,1,1,1,2,1,2014-10-08 17:11:12,2014-10-08 17:10:53
f12fddb95d2f0e0a91a3d30e84cb343f582500ba...32e192883e12a330becd97addbc45e5392cb8c8b,1,7,7,14,7,2014-10-08 18:01:18,2014-10-08 02:25:57
32e192883e12a330becd97addbc45e5392cb8c8b...842e3a290a7d867d699abf3c595672e68eec34e1,1,4,3,7,1,2014-10-08 18:01:18,2014-10-08 17:59:41
842e3a290a7d867d699abf3c595672e68eec34e1...0bd892a2617908b329375807f9db0aeda0b1c469,1,0,2,2,1,2014-10-08 18:07:32,2014-10-08 18:07:32
0bd892a2617908b329375807f9db0aeda0b1c469...149389d9323009b551d4c940346438a041ece0a5,1,4,4,8,2,2014-10-08 18:09:02,2014-10-08 18:09:02
149389d9323009b551d4c940346438a041ece0a5...6d1730562971ba6888724b862a5b9b23fb530aeb,1,1,1,2,1,2014-10-08 18:19:17,2014-10-08 18:19:17
6d1730562971ba6888724b862a5b9b23fb530aeb...8b86948d41c1a9a8bd19f9c3c13f1fa425585565,1,15,15,30,15,2014-10-08 18:50:21,2014-10-08 18:50:21
8b86948d41c1a9a8bd19f9c3c13f1fa425585565...e4244003cf722f4e2182c492c87106fcb245c4e5,1,7,3,10,3,2014-10-08 20:26:24,2014-10-08 20:26:24
e4244003cf722f4e2182c492c87106fcb245c4e5...2b280474cbcffa2fc0fc227aef29694d0c36ae04,2,8,8,16,6,2014-10-08 20:30:14,2014-10-08 20:29:43
2b280474cbcffa2fc0fc227aef29694d0c36ae04...a10b52549406a1388a7ad2a6673dfeaf6eeff04e,1,2,1,3,1,2014-10-08 21:04:38,2014-10-08 20:38:21
a10b52549406a1388a7ad2a6673dfeaf6eeff04e...d612b4e14c85edbd1a9aa9d0772197d8291defd2,1,2,0,2,1,2014-10-08 21:04:45,2014-10-08 20:53:10
d612b4e14c85edbd1a9aa9d0772197d8291defd2...aaa9bfb04860c3c97e48f4cf5ae78f8dd55f65b3,1,49,0,49,2,2014-10-08 21:05:02,2014-10-08 20:53:30
aaa9bfb04860c3c97e48f4cf5ae78f8dd55f65b3...89ea5afa83f363ca0fe492ea2b141f4cf18a7e66,2,2,2,4,2,2014-10-08 21:16:56,2014-10-08 20:29:43
89ea5afa83f363ca0fe492ea2b141f4cf18a7e66...bb29469856abe621275fe7bb520470a5ceb5edda,3,29,51,80,5,2014-10-08 21:28:24,2014-10-08 21:26:38
bb29469856abe621275fe7bb520470a5ceb5edda...299fde2be9a60644a0455d12fb401aee367df9de,1,2,0,2,1,2014-10-08 21:39:01,2014-10-08 21:38:34
299fde2be9a60644a0455d12fb401aee367df9de...a200043285e40be61ed3a1defa2dab0ee1dcfa0e,1,6,1,7,1,2014-10-08 21:44:45,2014-09-30 19:42:17
a200043285e40be61ed3a1defa2dab0ee1dcfa0e...d166119beb7738c75a8c815e2cf9f16be8f25970,1,72,2,74,4,2014-10-08 23:03:29,2014-10-08 23:03:29
c88fffbc6a03f15df850b6eb940b85c026b6e166...d9dbcbf5f31e21afc22bb705cb3eecf413809291,1,41,4,45,4,2014-10-08 16:26:42,2014-10-08 16:26:42
d9dbcbf5f31e21afc22bb705cb3eecf413809291...952e3181e5aef97c6003c6e05e67afd0dba02dfc,1,5,3,8,3,2014-10-08 16:28:53,2014-10-08 16:28:53
952e3181e5aef97c6003c6e05e67afd0dba02dfc...8112fb796f7feed49f917faa2ef23d7a03072dca,2,25,2,27,6,2014-10-08 17:08:44,2014-10-08 17:02:35
8112fb796f7feed49f917faa2ef23d7a03072dca...200bce88f51fd020a54c6175fa148a4e2613099c,3,81,5,86,8,2014-10-08 19:26:01,2014-10-08 19:26:01
200bce88f51fd020a54c6175fa148a4e2613099c...71998e08ec5ec4463d7f2b639e9f5313b6495d1f,3,80,1,81,4,2014-10-08 20:16:23,2014-10-08 20:16:23
71998e08ec5ec4463d7f2b639e9f5313b6495d1f...42049f5d1b1e8348e8bddfee44ad96c85672d7c4,1,47,8,55,7,2014-10-08 20:26:20,2014-10-08 20:26:20
3dc5537a40c4e91cb077f99febb87a92d503f4af...38b437b6764814f860727385eed9181a55f54eaf,6,149,2544,2693,12,2014-10-09 23:28:15,2014-10-09 23:28:15
3dc5537a40c4e91cb077f99febb87a92d503f4af...60a9da16067ee5f2e6b44bb46cd6db15d562784f,2,49,19,68,6,2014-10-09 19:28:42,2014-10-09 18:45:01
60a9da16067ee5f2e6b44bb46cd6db15d562784f...ab3643397299fd5e2f4df9de72c078affb6228b2,1,1,1,2,1,2014-10-09 19:28:42,2014-10-09 18:51:50
ab3643397299fd5e2f4df9de72c078affb6228b2...d07f4f1abf45e6a9553e34040203be4db30e4cf2,1,3,2,5,2,2014-10-09 20:13:45,2014-10-09 20:13:37
d07f4f1abf45e6a9553e34040203be4db30e4cf2...000af3ad2e8822e997a261fde09294bc7e265ff6,1,7,0,7,1,2014-10-09 21:28:31,2014-10-09 19:30:57
000af3ad2e8822e997a261fde09294bc7e265ff6...ce98ea08d5c866653ccc4ba1052a394fd4c830a3,1,7,1,8,2,2014-10-09 22:24:44,2014-10-09 22:22:19
ce98ea08d5c866653ccc4ba1052a394fd4c830a3...f00643dbaeacd1b237414c452ce22453a4b6d819,1,3,2,5,2,2014-10-09 23:26:19,2014-10-09 23:26:19
9118a448a513ddd8c196917e7121655b2dedf376...05d2c5edd77a9c23b665bc35a3f0bd66a70a0546,1,1,1,2,1,2014-10-10 22:59:32,2014-10-10 21:26:34
9118a448a513ddd8c196917e7121655b2dedf376...80b8d3e74c1ed70835126e6c079e0560ce7fbfe3,6,298,3,301,19,2014-10-10 22:30:43,2014-09-29 19:52:09
0fc25c2b272d4c65a57bcf5d744171caea4e12a4...8ae13018327b1921dfbef3c2ff85f5b54623fd34,3,3,3,6,3,2014-10-10 03:11:53,2014-10-10 03:11:53
8ae13018327b1921dfbef3c2ff85f5b54623fd34...3952dbfda5529307f1322f6178235bb49a960b1c,4,14,15,29,13,2014-10-10 03:26:47,2014-10-10 03:26:47
3952dbfda5529307f1322f6178235bb49a960b1c...a0bf883d93ee5410ec5256dbe3bfd51584e6fec4,2,2,2,4,2,2014-10-10 03:33:25,2014-10-10 03:33:25
a0bf883d93ee5410ec5256dbe3bfd51584e6fec4...7126e17109b1a5f4d3759b23175589f930d0eb5a,2,11,2,13,4,2014-10-10 04:20:14,2014-10-10 04:06:09
7126e17109b1a5f4d3759b23175589f930d0eb5a...141f3cdf3df5cf85b1ada83ad2cce3eb79538882,1,1,1,2,1,2014-10-10 04:53:29,2014-10-10 04:53:05
141f3cdf3df5cf85b1ada83ad2cce3eb79538882...99228d7c7b960205ec608c32fbf82e732ae697f8,1,2,0,2,1,2014-10-10 05:21:32,2014-10-10 05:21:32
99228d7c7b960205ec608c32fbf82e732ae697f8...cc3fbff888d219e5041213bbef0be7e4e361a74c,1,4,2,6,1,2014-10-10 05:31:15,2014-10-10 05:31:15
cc3fbff888d219e5041213bbef0be7e4e361a74c...94c79151fa08fd66e2008d0d2d95a8c8c286e152,1,1,1,2,1,2014-10-10 08:13:43,2014-10-10 08:13:43
94c79151fa08fd66e2008d0d2d95a8c8c286e152...4c082bb87a38014b05d4d4af53419de8bf487ac2,1,8,0,8,1,2014-10-10 09:55:38,2014-10-10 09:54:47
4c082bb87a38014b05d4d4af53419de8bf487ac2...c1cedff917ead7fc0a87c154634b7b6dc6b11423,1,5,0,5,1,2014-10-10 11:45:40,2014-10-10 09:58:49
c1cedff917ead7fc0a87c154634b7b6dc6b11423...50338758a425d5082f665591ed7ad53ee59b30cc,1,17,9,26,8,2014-10-10 20:55:28,2014-10-10 20:55:28
50338758a425d5082f665591ed7ad53ee59b30cc...4d41c4c7cd04be3136bbf876eb23bb1cac9c02b3,1,2,2,4,1,2014-10-10 21:36:43,2014-10-10 21:36:43
b595c5027f26f0e39f2b7c6371edd16fb8a90819...bb638b7694f7cb6f8739d0bc6d258dbdbbadba5d,2,12,8,20,7,2015-03-05 02:56:57,2015-03-03 00:54:22
bb638b7694f7cb6f8739d0bc6d258dbdbbadba5d...7c443e46de33ecb44b3bffa057da0a9db7a946cf,1,15,12,27,7,2015-03-05 03:38:45,2015-03-05 03:38:45
7c443e46de33ecb44b3bffa057da0a9db7a946cf...6ef63ce43de5854c95cce20baceb345e5ef52dd5,3,18,6,24,6,2015-03-05 03:47:06,2015-03-05 03:44:34
6ef63ce43de5854c95cce20baceb345e5ef52dd5...a656c2cbfbde80b206a4ddd2e29c74ce608442b7,4,44,21,65,14,2015-03-05 04:05:03,2015-03-05 04:01:05
b595c5027f26f0e39f2b7c6371edd16fb8a90819...eb7ff34df674af1b40304addaf15ee6428b8efd4,2,12,8,20,7,2015-03-05 02:54:32,2015-03-03 00:54:22
6705025880e06103caa06b2bd8aaf0a803c31c07...bd78bef9a45907a201a01acda3594db365a4e48b,1,6,2,8,2,2015-02-03 21:17:31,2015-02-03 21:17:31
bd78bef9a45907a201a01acda3594db365a4e48b...44bbd7f34c823e29bd5ed3d8ebeb0faefe883248,1,4,4,8,4,2015-02-03 21:22:28,2015-01-29 14:19:36
44bbd7f34c823e29bd5ed3d8ebeb0faefe883248...1880710079b4164ecfd49370b424ede62583c3fc,1,1,0,1,1,2015-02-03 21:24:40,2015-02-03 21:24:40
1880710079b4164ecfd49370b424ede62583c3fc...9d8acb61a12062d86ada91136bc771b6cbffc404,1,2,2,4,2,2015-02-04 04:04:08,2015-02-04 04:04:08
9d8acb61a12062d86ada91136bc771b6cbffc404...a56d73fdd4d7b900476f412dffe8805adb3af08b,1,3,2,5,1,2015-02-04 04:06:31,2015-02-04 04:06:31
6705025880e06103caa06b2bd8aaf0a803c31c07...bd6962df2f86ac7f1d11c0047dfba5ed91e14ffa,1,1,1,2,1,2015-02-03 15:53:31,2015-01-27 16:10:01
bd6962df2f86ac7f1d11c0047dfba5ed91e14ffa...a74c08188d9f9251e1800bb3a0ca51e081684fe9,2,3,3,6,2,2015-02-03 16:20:10,2015-02-03 16:20:10
050dd10ae798406cad7bde0aa458cfa274643b0a...1b761260c136b6a3221ec9383176460ef998828d,1,1,1,2,1,2015-03-12 19:26:46,2015-03-12 19:26:14
1b761260c136b6a3221ec9383176460ef998828d...8f3c305037300d6055ceab68721fb2bf98579426,1,1,1,2,1,2015-03-12 19:40:09,2015-03-12 19:36:56
8f3c305037300d6055ceab68721fb2bf98579426...89f86b1b7c05ae189f096defc19adf0d23011e72,1,2,1,3,2,2015-03-12 19:47:56,2015-03-12 19:46:46
89f86b1b7c05ae189f096defc19adf0d23011e72...6cb13b79c46750348f0d7a8b3d5f0449e26d2f04,1,2,2,4,1,2015-03-12 20:20:34,2015-03-12 20:20:24
6cb13b79c46750348f0d7a8b3d5f0449e26d2f04...0ef83caa74025cb6e60693b9d71e99fb7880d0f9,1,2,2,4,1,2015-03-12 20:28:41,2015-03-12 20:28:41
0ef83caa74025cb6e60693b9d71e99fb7880d0f9...d566d92b22c04d9b6288a84c997a073c486bf4da,5,3674,3668,7342,3,2015-03-12 23:24:05,2015-03-12 17:33:47
d566d92b22c04d9b6288a84c997a073c486bf4da...73129f74778098eda42344b96bc2ead7712524b0,1,20,0,20,1,2015-03-12 23:24:05,2015-03-12 21:43:15
73129f74778098eda42344b96bc2ead7712524b0...7c245285fe2fd996cdb1b17b5136b08fa1ca38b8,9,203,12,215,28,2015-03-12 23:24:05,2015-03-12 23:23:29
7b531c1ad58a2709bed00f99157fc8412cb7af9a...647bd169fe05d853f2c4ffb4fe3f346d4256f3b6,1,15,9,24,2,2015-02-06 21:53:34,2015-02-06 21:53:34
7b531c1ad58a2709bed00f99157fc8412cb7af9a...497340498f72efc54c341477e5e47433f33298a1,2,5,3,8,3,2015-02-06 21:53:24,2015-02-06 21:50:56
497340498f72efc54c341477e5e47433f33298a1...e6a26bded0d20f16f29952f65e84090899796287,1,1,1,2,1,2015-02-06 21:56:01,2015-02-06 21:56:01
e6a26bded0d20f16f29952f65e84090899796287...2f24eb418d8d505b8bd478a3c04f18f01d150170,1,2,2,4,2,2015-02-06 22:28:51,2015-02-06 22:03:25
2f24eb418d8d505b8bd478a3c04f18f01d150170...6aa9142e67bb520c1a08906d04572d36ed5ed83d,2,3,2,5,3,2015-02-06 22:49:23,2015-02-06 22:49:04
6aa9142e67bb520c1a08906d04572d36ed5ed83d...b276aa79ca1c7670c2ef2ba320f255964806211b,1,13,3,16,6,2015-02-06 22:57:40,2015-02-06 22:38:53
b276aa79ca1c7670c2ef2ba320f255964806211b...ff32eb57223d199771ff07732f3e802cebbd8d1e,1,16,9,25,2,2015-02-06 23:33:24,2015-02-06 21:53:34
ff32eb57223d199771ff07732f3e802cebbd8d1e...02038e70a61c0cd2cc35203ddb0c847c4620c27b,1,5,7,12,3,2015-02-07 00:50:11,2015-02-07 00:50:11
02038e70a61c0cd2cc35203ddb0c847c4620c27b...ce93b8f1083d436143fa5da7f8eabfd2ea241046,1,54,54,108,8,2015-02-07 01:14:22,2015-02-06 23:46:25
ce93b8f1083d436143fa5da7f8eabfd2ea241046...eaf11fa55e504a6d52724770127af6c42a1aa722,3,28,5,33,5,2015-02-07 02:05:16,2015-02-07 01:59:10
eaf11fa55e504a6d52724770127af6c42a1aa722...44d200d2590698823b310796b60645ff38126f60,1,3,2,5,1,2015-02-07 02:50:43,2015-02-07 02:50:43
44d200d2590698823b310796b60645ff38126f60...25d9ab8250f4a110bec585089b31146edfc3280a,1,6,1,7,2,2015-02-07 03:21:30,2015-02-07 03:12:15
25d9ab8250f4a110bec585089b31146edfc3280a...9166de39fe4163b0efaa0d63b931308eb5a11596,1,4,0,4,1,2015-02-07 08:01:20,2015-02-07 08:01:20
9166de39fe4163b0efaa0d63b931308eb5a11596...8e8ee3eca4d93e97cb2ba07543e57599b289c71c,1,1,1,2,2,2015-02-07 08:02:42,2015-02-07 08:02:42
8e8ee3eca4d93e97cb2ba07543e57599b289c71c...d07ff8e99cfde21cf113da13d35d387b0ed309a3,1,1,0,1,1,2015-02-07 16:54:44,2015-02-07 16:54:44
d07ff8e99cfde21cf113da13d35d387b0ed309a3...63d069e1380922ca8fd5e23b19ea1855bbd54603,1,8,7,15,1,2015-02-09 03:00:42,2015-02-07 19:45:03
63d069e1380922ca8fd5e23b19ea1855bbd54603...40575dde250d56b8a71ad2c21b2d09c3cf5e3d03,1,1,0,1,1,2015-02-09 03:02:12,2015-02-08 12:47:20
40575dde250d56b8a71ad2c21b2d09c3cf5e3d03...4ad860ca47071c167281888e984f15ba987355bd,5,10,14,24,5,2015-02-09 16:42:49,2015-02-09 16:42:49
4ad860ca47071c167281888e984f15ba987355bd...18692b672d0146a4aab124ef853fa9d6b9f212ba,1,10,7,17,2,2015-02-09 19:33:32,2015-02-09 19:33:00
18692b672d0146a4aab124ef853fa9d6b9f212ba...8c48196f4d90a1044b60fe33028dbcd80504ce51,1,6,4,10,4,2015-02-09 19:40:44,2015-02-09 19:40:44
b7979dde374be4b45dd8995816e1217a9e75e86f...7ae5678db2a29494b7e344ce795b527223ad2ad9,1,57,32,89,5,2015-02-10 20:16:01,2015-02-10 00:11:21
7ae5678db2a29494b7e344ce795b527223ad2ad9...a4626f1c8e3222a9bbed918c86772eba4511f522,2,45,0,45,5,2015-02-10 20:16:01,2015-02-10 00:35:11
a4626f1c8e3222a9bbed918c86772eba4511f522...56f21fc82eb63c7e61b0237ace392d42a8367840,7,29,10,39,14,2015-02-10 20:16:01,2015-02-10 01:31:29
56f21fc82eb63c7e61b0237ace392d42a8367840...cf363d8530774fdf8523d862a0dfd2faea3602c6,1,28,2,30,6,2015-02-10 20:16:01,2015-02-10 05:40:18
cf363d8530774fdf8523d862a0dfd2faea3602c6...9040c1461bad758d68bb2ba4fc778ae15137efdb,1,96,0,96,1,2015-02-10 20:16:01,2015-02-10 19:27:01
9040c1461bad758d68bb2ba4fc778ae15137efdb...d003c1311c7f82104ddde57c13ec7aa0256ece72,1,3,0,3,1,2015-02-10 20:16:01,2015-02-10 19:30:21
d003c1311c7f82104ddde57c13ec7aa0256ece72...50d5276ad0d57c2882fe66cacb847cd04304a092,1,15,14,29,5,2015-02-10 20:16:02,2015-02-10 20:00:20
50d5276ad0d57c2882fe66cacb847cd04304a092...b34027ec2537e41d330857301bacfe92c32d2188,1,7,17,24,3,2015-02-10 20:16:02,2015-02-10 20:05:20
b34027ec2537e41d330857301bacfe92c32d2188...7e533c6fb0cc824a8185ed433bb184439fd3e581,1,7,7,14,2,2015-02-10 20:16:02,2015-02-10 20:12:30
1c6856722c5168522cc36fca62811c961e6a804c...bfdad18487a169b562051c42ad89a9e71918b2e8,1,8,0,8,2,2015-01-14 00:33:56,2014-12-19 23:06:43
bfdad18487a169b562051c42ad89a9e71918b2e8...909cd7a99ff437c45fe97a60cc53b52d83b8a997,1,1,0,1,1,2015-01-14 00:33:56,2014-12-19 23:49:58
909cd7a99ff437c45fe97a60cc53b52d83b8a997...2aba1dce35d3aec15c9b6ea0e979b0b3c2359421,2,3,3,6,3,2015-01-14 00:35:39,2015-01-14 00:35:39
180586a115a24de1e4a0068c3a784a678c691539...48f8d7f89cdb540108adffa7c1b1fafa2e6ca0c1,2,12,2,14,2,2014-11-25 20:58:13,2014-11-25 16:47:05
ce4442bfbc22f2a013c25cf96332cb1234b94d6f...f39b55d540e34af979ea773a6dbee73207f295f5,5,21,70,91,8,2014-10-27 17:31:29,2014-10-27 17:31:29
174a059904bb9670b7af5ba1151bb4d70159cda5...3e788b9f871062ccd7b9618565720844e924c1b0,7,172,49,221,55,2014-10-17 20:47:17,2014-10-16 18:00:28
3e788b9f871062ccd7b9618565720844e924c1b0...618783b546481f182794920644a0934ee98ee71a,4,2,49,51,7,2014-10-17 20:47:17,2014-10-16 18:17:15
618783b546481f182794920644a0934ee98ee71a...d3d66052c6d44b752ff011c28f65b6f43c3af7cb,1,19,20,39,9,2014-10-17 20:47:17,2014-10-16 18:44:01
d3d66052c6d44b752ff011c28f65b6f43c3af7cb...fb6828fc32e52ef5e2e09d381b607a8c0d365f09,1,13,11,24,10,2014-10-17 20:47:18,2014-10-16 18:47:39
fb6828fc32e52ef5e2e09d381b607a8c0d365f09...bc863f223160f631b25a12f9cdd642d4e2aa2647,1,5,5,10,4,2014-10-17 20:47:18,2014-10-16 18:48:05
bc863f223160f631b25a12f9cdd642d4e2aa2647...41a05fcd9c49d1c680badbceda9e9ba4045550c4,1,12,27,39,7,2014-10-17 20:47:18,2014-10-16 18:50:53
41a05fcd9c49d1c680badbceda9e9ba4045550c4...41db23e6e5aee60d2c02137d426a40adfae5b0d8,1,5,12,17,2,2014-10-17 20:47:18,2014-10-16 18:54:27
41db23e6e5aee60d2c02137d426a40adfae5b0d8...58d35c515aaba240d850a7b9d4a5000ee2d614d4,2,36,8,44,6,2014-10-17 20:47:18,2014-10-16 18:58:52
58d35c515aaba240d850a7b9d4a5000ee2d614d4...c03f1d04d3495fa7b05e62e9de43ae8d723f6a2f,3,16,14,30,3,2014-10-17 20:47:18,2014-10-16 20:34:33
c03f1d04d3495fa7b05e62e9de43ae8d723f6a2f...297a56c42b823abf5efd17f2fd6581b8a0fb296a,1,0,5,5,2,2014-10-17 20:47:18,2014-10-16 21:05:54
297a56c42b823abf5efd17f2fd6581b8a0fb296a...0c018b7921f74b5e60814f6fb88be497b9da93a5,1,2,3,5,2,2014-10-17 20:47:18,2014-10-16 21:09:46
0c018b7921f74b5e60814f6fb88be497b9da93a5...2ac06e97c390107dfc5ad5b8ac29dafd0a00619b,1,5,6,11,3,2014-10-17 20:47:19,2014-10-16 21:11:11
2ac06e97c390107dfc5ad5b8ac29dafd0a00619b...2324f6f6efee4b2c2917643038674eaee590c9c4,5,26,4,30,5,2014-10-17 20:47:19,2014-10-16 21:17:12
2324f6f6efee4b2c2917643038674eaee590c9c4...829a1eb588485b9f673d95ad281ecab648650ece,2,12,32,44,8,2014-10-17 20:47:19,2014-10-16 21:23:17
829a1eb588485b9f673d95ad281ecab648650ece...2e01bde51f6d919a500f9bef5d8fbe545cdab9c3,2,50,1,51,7,2014-10-17 20:47:19,2014-10-16 21:36:26
2e01bde51f6d919a500f9bef5d8fbe545cdab9c3...49c9f42f39fa4038c29674fed1b285a9a02b5c85,1,2,4,6,2,2014-10-17 20:47:19,2014-10-16 21:37:01
49c9f42f39fa4038c29674fed1b285a9a02b5c85...2cd5b3f39b0bd822a89d6b6a17a7f5cbdab7f4db,1,1,1,2,1,2014-10-17 20:47:19,2014-10-16 21:50:24
2cd5b3f39b0bd822a89d6b6a17a7f5cbdab7f4db...cdbaca0b8bf877378c4079ee674a18007fd82b74,5,6,43,49,9,2014-10-17 20:47:19,2014-10-16 22:21:09
cdbaca0b8bf877378c4079ee674a18007fd82b74...fb21aa42b074ba48c86c4bc763942df7472c2ce9,3,4,17,21,4,2014-10-17 20:47:19,2014-10-16 22:30:24
fb21aa42b074ba48c86c4bc763942df7472c2ce9...37e71e16751e15274743662e2ba00ded91ad6eaa,1,2,2,4,2,2014-10-17 20:47:20,2014-10-16 22:36:10
37e71e16751e15274743662e2ba00ded91ad6eaa...871166db46afd22e2aa83bc14afe263b9a2a795a,1,3,1,4,1,2014-10-17 20:47:20,2014-10-16 22:35:17
871166db46afd22e2aa83bc14afe263b9a2a795a...8c034a2d7ff16936937ee1a07dbc266b2c23e005,4,8,8,16,8,2014-10-17 20:47:20,2014-10-16 22:41:12
8c034a2d7ff16936937ee1a07dbc266b2c23e005...4ec3cb2a5555db90d3c3795c9b16c34c7004736f,3,11,15,26,11,2014-10-17 20:47:20,2014-10-16 23:02:43
4ec3cb2a5555db90d3c3795c9b16c34c7004736f...a19141ac2f2526b49cdb3aacd14b10c6de014b1d,2,99,59,158,15,2014-10-17 20:47:20,2014-10-16 23:13:54
a19141ac2f2526b49cdb3aacd14b10c6de014b1d...fa11f97c1e92613daf38b9641cc130863351a670,1,8,4,12,2,2014-10-17 20:47:20,2014-10-16 23:32:47
fa11f97c1e92613daf38b9641cc130863351a670...c1753de1e8e8cd8745ff14097825504a57421a02,4,26,21,47,9,2014-10-17 20:47:20,2014-10-16 23:35:59
c1753de1e8e8cd8745ff14097825504a57421a02...149ca2ddc4313e25c05eab43548b11736972a32d,4,38,21,59,19,2014-10-17 20:47:20,2014-10-17 00:10:12
149ca2ddc4313e25c05eab43548b11736972a32d...db4ddb79891001d96b7172c3ec9110b6c89c67af,2,8,1,9,5,2014-10-17 20:47:21,2014-10-17 00:15:22
db4ddb79891001d96b7172c3ec9110b6c89c67af...da41eccf5887c98af00221d6c392c920178f96a6,1,6,2,8,4,2014-10-17 20:47:21,2014-10-17 01:50:17
da41eccf5887c98af00221d6c392c920178f96a6...d1c896724c8be7d828c9550e63206467ee2ce43e,4,21,5,26,7,2014-10-17 20:47:21,2014-10-17 12:54:21
d1c896724c8be7d828c9550e63206467ee2ce43e...96eebea575ab0d3ae10958d670b2029c9091d18f,2,1,2,3,2,2014-10-17 20:47:21,2014-10-17 16:40:30
96eebea575ab0d3ae10958d670b2029c9091d18f...87f4a7826fb41ac7140eebb210fff3fdb8d81b1e,3,31,8,39,11,2014-10-17 20:47:21,2014-10-17 16:52:22
87f4a7826fb41ac7140eebb210fff3fdb8d81b1e...102e6cacb8acae0f7222a61a6628999c951bee22,1,54,52,106,7,2014-10-17 20:47:21,2014-10-17 16:54:55
102e6cacb8acae0f7222a61a6628999c951bee22...44c7aa2d782a14c5b6242625280ac9b18b9d9b2e,1,3,2,5,1,2014-10-17 20:47:21,2014-10-17 16:56:03
44c7aa2d782a14c5b6242625280ac9b18b9d9b2e...a7c369284f12806873f1415247c1f00b88c0af86,5,9,27,36,10,2014-10-17 20:47:21,2014-10-17 17:13:51
a7c369284f12806873f1415247c1f00b88c0af86...2b5269c4bdc4db6146776aa2b24f1b2e7c2d3634,2,8,12,20,2,2014-10-17 20:47:22,2014-10-17 17:19:25
2b5269c4bdc4db6146776aa2b24f1b2e7c2d3634...46ed70027d73b82b2cf5cd690be78b8e578cfa02,2,50,111,161,30,2014-10-17 20:47:22,2014-10-17 17:29:11
46ed70027d73b82b2cf5cd690be78b8e578cfa02...4fcdd04d85ef072c97947ee6454146d9ac140533,3,17,17,34,18,2014-10-17 20:47:22,2014-10-17 17:23:30
4fcdd04d85ef072c97947ee6454146d9ac140533...601a91668df4298c8696c1cf650465697f14b556,1,2,4,6,2,2014-10-17 20:47:22,2014-10-17 17:24:56
601a91668df4298c8696c1cf650465697f14b556...d5657218d0fa0a47bfca1b7e55cec04316c320ff,4,43,32,75,34,2014-10-17 20:47:22,2014-10-17 17:31:38
d5657218d0fa0a47bfca1b7e55cec04316c320ff...945afe194a4ccc553f19bddcc0c6a0fa8f1076b0,1,15,6,21,2,2014-10-17 20:47:22,2014-10-17 18:13:54
945afe194a4ccc553f19bddcc0c6a0fa8f1076b0...cb9b06a9fda185e54bf5a4ce7c2358e3ffd70d66,1,1,0,1,1,2014-10-17 20:47:22,2014-10-17 18:17:26
cb9b06a9fda185e54bf5a4ce7c2358e3ffd70d66...58429a92f36462b65baff4fd45ee12a51f9a0723,1,38,37,75,2,2014-10-17 20:47:23,2014-10-17 18:26:23
58429a92f36462b65baff4fd45ee12a51f9a0723...82bdaf86b9163ea13c6415ed178ac52d8b56c10d,2,64,62,126,6,2014-10-17 20:47:23,2014-10-17 18:37:08
82bdaf86b9163ea13c6415ed178ac52d8b56c10d...cb3c1e5b0d0ec65cc0265ebd1bc83a4522723191,1,2,1,3,1,2014-10-17 20:47:23,2014-10-17 18:39:03
cb3c1e5b0d0ec65cc0265ebd1bc83a4522723191...468aeb25bf7e65a6d48864b8aef995890f897d9a,1,2,4,6,2,2014-10-17 20:47:23,2014-10-17 19:01:08
1b675f6fc61d21389273fe3ac792897c7058ccbf...a3f07028e2a148414e26ed651484c05086bb7f68,1,2,1,3,1,2014-10-09 23:35:11,2014-10-09 23:34:52
a3f07028e2a148414e26ed651484c05086bb7f68...cafb427aa7e5e40e579076edb2ff9a6d93b523da,11,11,11,22,11,2014-10-09 23:42:30,2014-10-09 22:36:52
cafb427aa7e5e40e579076edb2ff9a6d93b523da...5dc03c53ec675dcf0b49b04d60839a2f45a936fc,5,5,5,10,5,2014-10-09 23:45:54,2014-10-09 23:45:54
5dc03c53ec675dcf0b49b04d60839a2f45a936fc...ac7ed9627fdc96720622e464b30f51b7f8aab19e,1,1,1,2,1,2014-10-09 23:49:18,2014-10-09 23:49:18
ac7ed9627fdc96720622e464b30f51b7f8aab19e...18f77ab2ee5a3287caa12f01fe6c49031e22f76e,1,1,1,2,1,2014-10-09 23:52:49,2014-10-09 23:52:49
18f77ab2ee5a3287caa12f01fe6c49031e22f76e...f77570662c440eabd1756192e860b150e8f63465,1,1,1,2,1,2014-10-09 23:54:12,2014-10-09 23:54:12
f77570662c440eabd1756192e860b150e8f63465...07ee30ffed384d02817bcebdf94374d513d6ee34,1,32,9,41,8,2014-10-10 02:13:07,2014-10-10 01:39:35
07ee30ffed384d02817bcebdf94374d513d6ee34...0fc7f60dcc1dcb89b625ab3ac86bf16626df9fd9,2,61,0,61,2,2014-10-10 02:13:07,2014-10-10 02:04:30
0fc7f60dcc1dcb89b625ab3ac86bf16626df9fd9...b7782ca4550ce3af9318cd81d6f65e9d1d2eeb2f,1,17,18,35,2,2014-10-10 02:13:07,2014-10-10 02:12:59
b7782ca4550ce3af9318cd81d6f65e9d1d2eeb2f...f2b65cc0557c43b9ec116ee1d6bf219c8891e2d8,2,3,1,4,2,2014-10-10 02:46:09,2014-10-10 02:45:36
f2b65cc0557c43b9ec116ee1d6bf219c8891e2d8...7236af674cc65faf460a6cc75632b4833ade6ad4,2,38,3,41,3,2014-10-10 02:58:39,2014-10-09 20:28:24
4d41c4c7cd04be3136bbf876eb23bb1cac9c02b3...395438b2164d54197d264e4878c5c97012661afc,2,8,4,12,8,2014-10-11 00:29:00,2014-10-11 00:29:00
395438b2164d54197d264e4878c5c97012661afc...8e919e41b56f7a7212fdaf124df7ead1e20aca67,1,1,1,2,1,2014-10-11 02:48:13,2014-10-10 03:35:05
8e919e41b56f7a7212fdaf124df7ead1e20aca67...6bff6020bed9604bc4d10418c462c8aa38dbbcd3,1,5,0,5,1,2014-10-11 02:50:34,2014-10-10 15:26:15
4d41c4c7cd04be3136bbf876eb23bb1cac9c02b3...ac0014d852db311698273752dc662a8e17c8f04a,1,29,17,46,4,2014-10-10 21:46:51,2014-10-10 20:44:22
ac0014d852db311698273752dc662a8e17c8f04a...fb7921ade284e43c0697378da9c2df566032041c,5,80,8,88,9,2014-10-10 21:49:05,2014-10-10 21:06:15
a656c2cbfbde80b206a4ddd2e29c74ce608442b7...808c1b8c912c31739700ee5b90dcb54cd1ddd144,3,72,24,96,18,2015-03-06 01:46:31,2015-03-06 01:46:31
a656c2cbfbde80b206a4ddd2e29c74ce608442b7...9f0f91e85118bff81cf74d27aafffc26d033e778,1,4,1,5,2,2015-03-05 04:54:27,2015-03-05 04:54:27
9f0f91e85118bff81cf74d27aafffc26d033e778...6a22fc948ed63f5e8cda56335579c4f7c31763a1,1,0,3,3,1,2015-03-05 05:05:57,2015-03-05 05:05:57
6a22fc948ed63f5e8cda56335579c4f7c31763a1...63f89e56024526d2467d89501cea811660649ccd,4,33,12,45,10,2015-03-05 21:49:18,2015-03-05 21:33:32
7c245285fe2fd996cdb1b17b5136b08fa1ca38b8...a75b0a441a12e1c62a3e09a66ccf262e2ffea381,1,0,1,1,1,2015-03-13 00:21:30,2015-03-13 00:21:30
a75b0a441a12e1c62a3e09a66ccf262e2ffea381...e8e7ec43bfd666c8f5bc382d6b9fe380dd93dba2,1,6,0,6,1,2015-03-13 00:44:46,2015-03-13 00:44:46
e8e7ec43bfd666c8f5bc382d6b9fe380dd93dba2...9b9dfbbf35bdb0e93039e79c4643200120123576,1,0,74,74,1,2015-03-13 00:56:45,2015-03-13 00:56:25
9b9dfbbf35bdb0e93039e79c4643200120123576...83dc85478f892a9eb15b8261f865ee9a4ee6bab6,1,14,3,17,4,2015-03-13 01:12:01,2015-03-13 01:07:20
83dc85478f892a9eb15b8261f865ee9a4ee6bab6...6b40a2e2bb10e2b4a31557f5471881eaa0028869,2,34,3,37,5,2015-03-13 01:12:01,2015-03-13 01:10:36
59ac39ce81cac85cd733ec91f2be74b4d8251e59...19a8078cd62a5f71397773faac68379b557745a6,1,2,2,4,2,2015-02-10 20:26:34,2015-02-10 20:26:34
19a8078cd62a5f71397773faac68379b557745a6...dd5dc01e8105b177eb80abd24102a06d582f6910,1,1,1,2,1,2015-02-10 20:27:13,2015-02-10 20:26:12
dd5dc01e8105b177eb80abd24102a06d582f6910...9ef49c60dc1740ccc4f96bb6bdabeee6cafdf1a1,1,17,13,30,2,2015-02-10 20:28:25,2015-02-10 20:27:05
76a38e0100bd173416b7c9ce7f44f9e7641891f4...87e3c6499d5eacce62f10faefe9ce49c77bb03ee,1,4,1,5,3,2015-01-14 00:57:24,2014-12-22 16:12:24
87e3c6499d5eacce62f10faefe9ce49c77bb03ee...cb4f69a4dfef1955143eb58b6cc5d5255b4aaf73,1,1,1,2,1,2015-01-14 01:40:46,2015-01-14 01:39:48
cb4f69a4dfef1955143eb58b6cc5d5255b4aaf73...547e8f6111443fd9488413c3bee7d89696fbc51e,1,1,0,1,1,2015-01-14 02:00:06,2015-01-14 02:00:06
547e8f6111443fd9488413c3bee7d89696fbc51e...f8d6be9f966aa9a0520b9eaa0a8c69540d807695,1,1,1,2,1,2015-01-14 02:16:50,2015-01-14 02:16:42
48f8d7f89cdb540108adffa7c1b1fafa2e6ca0c1...ee47b47542c1e0fde98e60313edd1bf0f39cd9ee,5,126,63,189,19,2014-11-26 01:26:32,2014-11-26 01:26:32
ee47b47542c1e0fde98e60313edd1bf0f39cd9ee...8041b2f0d9df677ed8b692666b8b21ae6868a18f,1,7,6,13,3,2014-11-26 01:28:43,2014-11-26 01:28:43
8041b2f0d9df677ed8b692666b8b21ae6868a18f...bb23abb8455b645b4b82b617f9885eaa4cf155b7,3,22,7,29,6,2014-11-26 01:47:01,2014-11-26 01:47:01
bb23abb8455b645b4b82b617f9885eaa4cf155b7...14c62b95e17515a1033990773aed03fef8cdcdcf,3,5,36,41,9,2014-11-26 02:45:14,2014-11-26 02:18:16
14c62b95e17515a1033990773aed03fef8cdcdcf...80a5613abe627f97f653642fbc6002d54c3868f9,8,33,33,66,32,2014-11-26 02:46:43,2014-11-26 02:46:43
80a5613abe627f97f653642fbc6002d54c3868f9...8f01957731b58ce52d59d2bbe2557f07c35790a7,1,114,0,114,1,2014-11-26 20:20:15,2014-11-26 20:20:15
8f01957731b58ce52d59d2bbe2557f07c35790a7...f951d684f45d486caca686ef33f2871f3f5356d6,1,1,1,2,1,2014-12-01 20:26:02,2014-12-01 20:26:02
f951d684f45d486caca686ef33f2871f3f5356d6...e1e8670bb0dbe283f3a910465aa6dddb3caf3da8,6,118,25,143,31,2014-12-01 20:41:54,2014-12-01 20:41:31
e1e8670bb0dbe283f3a910465aa6dddb3caf3da8...75b4d0250811eaf3146442f26708c2779d8e2d26,3,152,46,198,30,2014-12-01 22:18:06,2014-12-01 22:11:20
75b4d0250811eaf3146442f26708c2779d8e2d26...a08591e07d257af6f99c313bca55ad856b77370b,2,47,7,54,9,2014-12-01 22:40:14,2014-12-01 22:40:14
a08591e07d257af6f99c313bca55ad856b77370b...21cd056338575c88663d357b981d6b323e135c2a,3,137,77,214,8,2014-12-01 23:06:05,2014-12-01 23:06:05
21cd056338575c88663d357b981d6b323e135c2a...75abea2c0fae0603eef3b85c69a91815d6ad738b,2,44,28,72,6,2014-12-01 23:43:50,2014-12-01 23:43:50
75abea2c0fae0603eef3b85c69a91815d6ad738b...9a604dafbd89cf6d4bbf1bbb7b2d2d735e63bdb7,1,10,8,18,1,2014-12-02 20:04:17,2014-12-02 20:04:17
9a604dafbd89cf6d4bbf1bbb7b2d2d735e63bdb7...f55ff9f9ba23b8510fbcb1293e299ca5fe2b2dfe,12,2250,26,2276,17,2014-12-17 04:21:50,2014-12-17 04:21:50
f55ff9f9ba23b8510fbcb1293e299ca5fe2b2dfe...d19e1c56daac057d841d9b37ec6e19bb0b57e84a,1,222,8,230,4,2014-12-17 17:22:42,2014-12-17 17:22:42
d19e1c56daac057d841d9b37ec6e19bb0b57e84a...7c86b6de11a38a193db48fd77974e767ce053be4,2,13,8,21,6,2014-12-17 23:04:24,2014-12-17 23:04:24
7c86b6de11a38a193db48fd77974e767ce053be4...0ab7fbb33278aa8ab0dc1e836a4eddb47d9ddb26,4,229,16,245,22,2014-12-20 00:53:33,2014-12-20 00:53:33
0ab7fbb33278aa8ab0dc1e836a4eddb47d9ddb26...c33d0a73b712969105b10690d1bf3cacb32af711,1,2,2,4,2,2014-12-20 00:54:30,2014-12-20 00:54:30
c33d0a73b712969105b10690d1bf3cacb32af711...a9d9dcc781675a9f7450667aa7280b05b4e34b44,1,71,194,265,5,2014-12-20 00:57:55,2014-12-20 00:57:55
a9d9dcc781675a9f7450667aa7280b05b4e34b44...c7f5626d2d1412d0e5bd6d28d9ae63c0163ed837,2,110,20,130,15,2014-12-20 07:53:58,2014-12-20 07:53:58
c7f5626d2d1412d0e5bd6d28d9ae63c0163ed837...7d196438a29fc02a9233e8819ba4895b7fa8dedc,3,12,11,23,8,2014-12-20 08:24:33,2014-12-20 08:24:33
7d196438a29fc02a9233e8819ba4895b7fa8dedc...0cf67918133cd094a88a809c8aff48c766a238fe,3,235,0,235,3,2014-12-22 03:34:58,2014-12-22 03:34:58
0cf67918133cd094a88a809c8aff48c766a238fe...6a541dcd6399b16b510336972ae01bc7e5743829,2,7,3,10,2,2014-12-22 03:37:33,2014-12-22 03:37:33
6a541dcd6399b16b510336972ae01bc7e5743829...43ab93128745e12ba3cfb6ead4a75b7c1aeca035,2,107,12,119,19,2014-12-22 18:30:04,2014-12-22 18:30:04
43ab93128745e12ba3cfb6ead4a75b7c1aeca035...052114087069be9e58f1611c1c38c5ce01cb9f17,2,79,20,99,8,2014-12-22 19:15:44,2014-12-22 19:15:44
052114087069be9e58f1611c1c38c5ce01cb9f17...34fd7c7742cd80fa69b85f138c2c18e47309ac8c,1,28,0,28,3,2014-12-22 19:52:39,2014-12-22 19:52:39
34fd7c7742cd80fa69b85f138c2c18e47309ac8c...74eb239c43ad9293b1c62f1288c04ec05463b9b1,2,162,66,228,28,2014-12-23 01:59:01,2014-12-23 01:59:01
74eb239c43ad9293b1c62f1288c04ec05463b9b1...2e865b72e24878f0d1bfba8a1fd9b517f13772c3,2,217,73,290,30,2014-12-23 03:17:14,2014-12-23 03:17:14
2e865b72e24878f0d1bfba8a1fd9b517f13772c3...e2164deec46704191884c59e36556efd7ab33aaf,2,18,18,36,14,2014-12-23 03:26:49,2014-12-23 03:26:49
e2164deec46704191884c59e36556efd7ab33aaf...419bbfe5337131f42dfa2d22861f1e2705c78f4d,2,35,24,59,17,2014-12-23 06:08:10,2014-12-23 06:08:10
419bbfe5337131f42dfa2d22861f1e2705c78f4d...5aa3947173ee5287126ec1bb39a2ee9d8a8eb707,2,146,53,199,14,2014-12-23 22:32:46,2014-12-23 22:32:46
5aa3947173ee5287126ec1bb39a2ee9d8a8eb707...7f8316b343f8927d5ceefe47611ad997762dc7f3,2,101,4,105,6,2014-12-23 23:16:42,2014-12-23 23:16:42
7f8316b343f8927d5ceefe47611ad997762dc7f3...afd2ea4d1bc83b92a3180f16b295ec7e73995e20,2,72,10,82,4,2014-12-24 20:20:17,2014-12-24 20:20:17
afd2ea4d1bc83b92a3180f16b295ec7e73995e20...e81ff89fa6d188a852ef3662520dff94e855c295,2,168,110,278,31,2014-12-26 13:41:19,2014-12-26 13:41:19
e81ff89fa6d188a852ef3662520dff94e855c295...bf8fb0c54de3eff5e0c3515e7030585e54e2e45e,1,12,31,43,10,2014-12-26 13:48:38,2014-12-26 13:48:38
bf8fb0c54de3eff5e0c3515e7030585e54e2e45e...98575d0097badce2a8b5c357c0e9174589d39b27,2,97,4,101,6,2014-12-26 14:26:31,2014-12-26 14:26:31
98575d0097badce2a8b5c357c0e9174589d39b27...1f44a34f3a3e800c82a9167e1ff98dafd70af23b,1,40,38,78,20,2014-12-26 17:23:43,2014-12-26 17:23:43
1f44a34f3a3e800c82a9167e1ff98dafd70af23b...fa2947ce8088dbbd0c6fd323a6c78bcbc2f5e183,1,38,25,63,10,2014-12-26 19:16:55,2014-12-26 19:16:55
fa2947ce8088dbbd0c6fd323a6c78bcbc2f5e183...28aa2883ccfc084cfbb3dbbd6bc3a97718efd4f8,2,54,35,89,12,2014-12-27 01:03:02,2014-12-27 01:02:38
28aa2883ccfc084cfbb3dbbd6bc3a97718efd4f8...2d5023c4fbdb1f350ff6d2473ba65e8349928535,2,123,51,174,10,2014-12-27 17:02:55,2014-12-27 17:02:38
2d5023c4fbdb1f350ff6d2473ba65e8349928535...db1520084446f9e33c29b43ef73cda42ddef7d20,1,23,1,24,1,2014-12-27 17:46:34,2014-12-27 17:46:34
db1520084446f9e33c29b43ef73cda42ddef7d20...81e91078da4f1179f0b76a55303f12f14d144603,1,15,0,15,1,2014-12-27 18:23:44,2014-12-27 18:23:44
81e91078da4f1179f0b76a55303f12f14d144603...1aee6e91155e8c4b61449cf512e75c6864917534,2,77,0,77,2,2014-12-27 18:44:45,2014-12-27 18:44:45
1aee6e91155e8c4b61449cf512e75c6864917534...5b08053cb3aa2bf7cd4e8e2c1abb63d16f4c8606,2,66,0,66,2,2014-12-27 19:25:34,2014-12-27 19:25:34
5b08053cb3aa2bf7cd4e8e2c1abb63d16f4c8606...51a51a83376dd2b4f56781cb0f756353c0eb4abd,2,264,0,264,2,2014-12-27 23:07:34,2014-12-27 23:07:34
51a51a83376dd2b4f56781cb0f756353c0eb4abd...05ba3d30047bede91dc180737fd1fa55eddd32be,2,206,3,209,5,2014-12-28 00:28:54,2014-12-28 00:28:54
05ba3d30047bede91dc180737fd1fa55eddd32be...62f6d0ea5c796543373891bb153d5f3fc978ea5c,1,1,1,2,1,2014-12-28 03:55:57,2014-12-28 03:55:57
62f6d0ea5c796543373891bb153d5f3fc978ea5c...4289bc53dcf65a828fdde79af40c98f6d3892d4a,2,126,0,126,2,2014-12-28 04:32:41,2014-12-28 04:32:41
4289bc53dcf65a828fdde79af40c98f6d3892d4a...ddbc95c76a1616348bfdc632f35e273bb9fa57cd,2,194,0,194,2,2014-12-29 19:57:46,2014-12-29 19:57:46
ddbc95c76a1616348bfdc632f35e273bb9fa57cd...10a24a7d1fc752229caf63810d13f74757ded8fa,4,17808,1,17809,4,2015-01-02 17:06:18,2015-01-02 17:06:18
10a24a7d1fc752229caf63810d13f74757ded8fa...2aadf6c31221964530705250fd7e2306a3132eb8,3,172,136,308,48,2015-01-04 15:40:25,2015-01-04 15:40:25
2aadf6c31221964530705250fd7e2306a3132eb8...38206ed3392eeee9688fe4bcb7c0755ae1d11854,2,73,0,73,3,2015-01-05 03:18:22,2015-01-05 03:18:22
38206ed3392eeee9688fe4bcb7c0755ae1d11854...9a6156f54187099052d0d6faca12746d32ca3082,4,448,176,624,37,2015-01-06 00:32:12,2015-01-06 00:32:12
9a6156f54187099052d0d6faca12746d32ca3082...d07ec2c20379185ed35d70ecf8ddac9556ae3c61,3,205,17828,18033,20,2015-01-06 01:19:07,2015-01-06 01:19:07
d07ec2c20379185ed35d70ecf8ddac9556ae3c61...54d8357216509bdee50a387f79a11dfe1a948840,3,476,78,554,62,2015-01-06 05:34:26,2015-01-06 05:34:26
54d8357216509bdee50a387f79a11dfe1a948840...690fbef854b6ee06d09df3b3293bdd30c1a99633,1,37,0,37,1,2015-01-06 19:50:15,2015-01-06 19:50:15
690fbef854b6ee06d09df3b3293bdd30c1a99633...5c7eb9ac6e37139067572cc8f7c0f04e52b3a715,3,62,20,82,5,2015-01-06 23:12:06,2015-01-06 23:12:06
5c7eb9ac6e37139067572cc8f7c0f04e52b3a715...7d04b25aec18867c83fc65f8bb80f2d411bfdb8b,4,52,63,115,20,2015-01-06 23:35:26,2015-01-06 23:35:26
48f8d7f89cdb540108adffa7c1b1fafa2e6ca0c1...b203cc3d26e75e35b4ecd2694b14ed2a5c968f58,1,1,1,2,1,2014-11-26 01:14:16,2014-11-26 01:14:16
b203cc3d26e75e35b4ecd2694b14ed2a5c968f58...c8b5e30984e884a7de727e82e7fc36f9e9037e2a,1,62,0,62,1,2014-11-26 01:56:59,2014-11-25 23:26:12
c8b5e30984e884a7de727e82e7fc36f9e9037e2a...fff79abea8654756b6be7ac3efbce4eda3e0fef6,1,3,60,63,3,2014-11-26 01:56:59,2014-11-25 23:28:57
fff79abea8654756b6be7ac3efbce4eda3e0fef6...f85c02ca8bf3e02c1291c88cac031445274c1449,1,40,0,40,1,2014-11-26 03:08:14,2014-11-25 22:14:13
f85c02ca8bf3e02c1291c88cac031445274c1449...b8cb7ee04f5f9ed524aa30289b845412d190492c,1,83,0,83,1,2014-11-26 03:08:14,2014-11-25 22:52:16
f39b55d540e34af979ea773a6dbee73207f295f5...d9c74da7016853d48da54835f0881cfd5787eee5,3,29,3,32,4,2014-10-27 18:01:41,2014-10-27 18:01:41
f39b55d540e34af979ea773a6dbee73207f295f5...bb20bec2a70e7602753e85ac6ebb8a2679e3e6d4,7,22,13,35,13,2014-10-27 17:56:16,2014-10-27 17:54:08
98ff998e1f2c5ac3a1807418c03602690bd8a10e...8952e0e5d12789e69513420f3aa98d6427707668,1,2,2,4,2,2014-10-17 20:52:06,2014-10-17 20:52:06
8952e0e5d12789e69513420f3aa98d6427707668...a9a2459548ae82fc87e3f31359867c4439ea5c0b,1,5,2,7,2,2014-10-17 21:34:39,2014-10-17 20:08:54
a9a2459548ae82fc87e3f31359867c4439ea5c0b...00658816b1238d92c37c0f847394803d27d6d2e2,2,16,9,25,4,2014-10-17 21:35:44,2014-10-17 04:42:52
00658816b1238d92c37c0f847394803d27d6d2e2...c1ee15e21e5fd2abf915b546ad659b14513fa3df,2,7,3,10,2,2014-10-17 21:43:33,2014-10-17 21:43:33
c1ee15e21e5fd2abf915b546ad659b14513fa3df...d274ad9cd4a1ebcc7321f5d338d31bbceb5aa65f,1,8,0,8,4,2014-10-17 21:55:16,2014-10-17 21:51:57
d274ad9cd4a1ebcc7321f5d338d31bbceb5aa65f...fd3b2b02960cf404b87a025a46a0ed6f0928b158,5,342,1,343,9,2014-10-17 22:24:31,2014-10-16 14:32:57
fd3b2b02960cf404b87a025a46a0ed6f0928b158...ca2322e05be9e79fb1c7e834865aeec18f8eb01f,4,19,0,19,4,2014-10-17 22:24:31,2014-10-16 19:01:54
16a1efc8f4740e5d193f1c9056bd34088238d4c1...f102432892fadf8818c303b3736c08eba4974a6d,3,17,17,34,17,2014-10-11 06:39:31,2014-10-11 06:39:31
f102432892fadf8818c303b3736c08eba4974a6d...99568e5d9bb25bdfe5a38685c2c2f3a094848757,1,2,2,4,2,2014-10-11 07:04:27,2014-10-11 07:04:27
99568e5d9bb25bdfe5a38685c2c2f3a094848757...91c6d70454ccfa00ce48cb6e7a2754b9620ca128,1,1,1,2,1,2014-10-11 07:17:22,2014-10-11 07:17:22
91c6d70454ccfa00ce48cb6e7a2754b9620ca128...39a40e688a3ccb623c69961214773be9c2691b75,1,6,2,8,3,2014-10-11 09:52:11,2014-10-11 09:52:11
39a40e688a3ccb623c69961214773be9c2691b75...7132c94e28cd84b35aef67700c25bb4e55df6205,1,2,0,2,1,2014-10-11 09:52:37,2014-10-11 09:52:37
7132c94e28cd84b35aef67700c25bb4e55df6205...fd31b828df7b3858b5f143f79a3cbf8126fc31aa,1,1,1,2,1,2014-10-11 10:19:44,2014-10-11 07:16:06
fd31b828df7b3858b5f143f79a3cbf8126fc31aa...a39f6bb35e45345482e4d7d0aa879deb8fd1aa90,5,63,7,70,6,2014-10-11 10:19:52,2014-10-11 08:36:04
a39f6bb35e45345482e4d7d0aa879deb8fd1aa90...21411b4114af9bdce954dcfabfda9cb42daceb3a,2,10,1,11,3,2014-10-11 10:32:04,2014-10-11 10:32:04
21411b4114af9bdce954dcfabfda9cb42daceb3a...ad6521ddc814a38483bdd29f9f9d7988d156ad6b,1,47,0,47,1,2014-10-11 10:43:40,2014-10-11 10:43:40
ad6521ddc814a38483bdd29f9f9d7988d156ad6b...11d43de2565ab4307264ce5bf61c40bd0d6ea918,1,4,0,4,1,2014-10-12 03:44:02,2014-10-12 03:44:02
11d43de2565ab4307264ce5bf61c40bd0d6ea918...4b1e713252beb7097e719ac61a266867af59a51a,1,0,2,2,1,2014-10-12 03:44:35,2014-10-12 03:44:35
4b1e713252beb7097e719ac61a266867af59a51a...270217b5660bc5c2ef6aa96ac7a9a5dc00591830,2,2,2,4,2,2014-10-12 07:01:51,2014-10-12 07:00:56
270217b5660bc5c2ef6aa96ac7a9a5dc00591830...4d2023e9b0c51db89c4e4642293ffece10242be9,1,4,1,5,1,2014-10-12 20:15:54,2014-10-12 20:15:54
4d2023e9b0c51db89c4e4642293ffece10242be9...9fbf759c43ca9f490c2867a416e91b1c81909440,1,1,1,2,1,2014-10-12 20:27:24,2014-10-12 20:27:24
9fbf759c43ca9f490c2867a416e91b1c81909440...dbc41759e0ee09b43311e3c1439da007371b69ec,1,2,2,4,1,2014-10-13 03:03:21,2014-10-13 03:03:21
dbc41759e0ee09b43311e3c1439da007371b69ec...9a6532c640421529b88720b75cef907dfcd6e3af,2,11,4,15,4,2014-10-13 06:08:26,2014-10-13 05:50:07
80eebe86bab029e06e87832985976da6ea5959d4...5b17ef1a303c2fe68d146619537dc986ec43fc9d,7,7,7,14,7,2014-10-11 03:37:54,2014-10-11 03:37:54
5b17ef1a303c2fe68d146619537dc986ec43fc9d...9a1f9621228738de46fd2b8715eeeff1480ffaf6,2,27,11,38,20,2014-10-12 06:47:49,2014-10-12 06:47:39
9a1f9621228738de46fd2b8715eeeff1480ffaf6...52f640fa6206f4b0275cc173283eebe7097f12a5,1,123,0,123,3,2014-10-12 07:25:54,2014-10-12 07:25:54
52f640fa6206f4b0275cc173283eebe7097f12a5...fbb15e7e3bd733c9647b5e3f1b2a9c3e02b254f6,1,4,1,5,1,2014-10-12 20:18:20,2014-10-12 20:15:54
fbb15e7e3bd733c9647b5e3f1b2a9c3e02b254f6...bb72d62ca8202c460b214d0b1d3effa740bafbe4,1,1,1,2,1,2014-10-12 20:28:41,2014-10-12 20:27:24
bb72d62ca8202c460b214d0b1d3effa740bafbe4...03b8e2b2ad8760f3d74201d298aed625a8917ed7,3,3,3,6,3,2014-10-12 20:53:01,2014-10-12 20:53:01
03b8e2b2ad8760f3d74201d298aed625a8917ed7...aeb5291953412f04e1942dfbf6106a1bfb09c820,1,78,64,142,15,2014-10-12 22:08:42,2014-10-12 22:08:42
aeb5291953412f04e1942dfbf6106a1bfb09c820...9d3b73c655aa746504c91263960060b123e315a6,1,66,49,115,11,2014-10-13 01:36:54,2014-10-13 01:36:54
9d3b73c655aa746504c91263960060b123e315a6...89b394d9744a6b6399b469c2801dee73264f4626,2,11,4,15,4,2014-10-13 05:50:27,2014-10-13 05:50:07
89b394d9744a6b6399b469c2801dee73264f4626...b16715989a486a4219954233a45345119692ae52,2,4,11,15,4,2014-10-13 06:08:41,2014-10-13 06:08:41
b16715989a486a4219954233a45345119692ae52...f2645c1ac95f86a1deaa61c5a484cec93bedf5de,3,7,7,14,3,2014-10-13 18:17:12,2014-10-13 18:17:12
f2645c1ac95f86a1deaa61c5a484cec93bedf5de...f286bef233628392f117b5f050d2779c240def71,3,8,15,23,7,2014-10-13 19:29:21,2014-10-13 19:29:21
f286bef233628392f117b5f050d2779c240def71...f5bf536de5ff620368d406b7d421be75386bbbf9,1,2,0,2,1,2014-10-13 20:22:49,2014-10-13 20:22:49
f5bf536de5ff620368d406b7d421be75386bbbf9...44b15960c808f2026d898b8269d788668aedc7c9,1,2,1,3,1,2014-10-13 20:28:37,2014-10-13 20:28:37
44b15960c808f2026d898b8269d788668aedc7c9...4a657a1bd0047f19f3d189c26f75042af7ff925b,1,1,1,2,1,2014-10-13 20:31:59,2014-10-13 20:31:59
4a657a1bd0047f19f3d189c26f75042af7ff925b...667f3b8a9196e12723c045124f93b3e63a9ada56,4,4,4,8,4,2014-10-13 20:35:03,2014-10-13 20:35:03
667f3b8a9196e12723c045124f93b3e63a9ada56...aac410cbb26d9afa2d476fad6231a0d31de96716,2,53,18,71,12,2014-10-13 20:55:36,2014-10-13 19:17:32
aac410cbb26d9afa2d476fad6231a0d31de96716...d00d4748377c91ebe07e5abf2ab504f77fdba8f2,1,1,1,2,1,2014-10-13 21:04:27,2014-10-13 21:04:27
d00d4748377c91ebe07e5abf2ab504f77fdba8f2...36da5aecb492fe479e56bfb87505bcaa1014ec82,125,126,126,252,126,2014-10-13 21:09:37,2014-10-13 21:09:37
36da5aecb492fe479e56bfb87505bcaa1014ec82...924cced1cbb1b21b62e859c9eb22c7a987e9f425,1,2,3,5,2,2014-10-13 21:11:11,2014-10-13 21:11:11
924cced1cbb1b21b62e859c9eb22c7a987e9f425...e65c1e02d7ecf97b76b677f1fce44326d8c5db1e,4,62,60,122,4,2014-10-13 21:47:07,2014-10-13 21:47:07
e65c1e02d7ecf97b76b677f1fce44326d8c5db1e...d10491c0b16e7ead82fb0b5e6e4a3b09db0ec71a,1,2,0,2,1,2014-10-13 21:48:19,2014-10-13 21:48:19
d10491c0b16e7ead82fb0b5e6e4a3b09db0ec71a...6b060010f63d6e814de799d5ad108f9fb6488024,19,300,288,588,23,2014-10-13 21:50:08,2014-10-13 21:50:08
63f89e56024526d2467d89501cea811660649ccd...98a21446cabed2863ed722f7efa2fba1ad71d37d,1,4,0,4,1,2015-03-05 23:49:05,2015-03-05 23:49:05
98a21446cabed2863ed722f7efa2fba1ad71d37d...9187dc21290b544d7a5f3242ad004248015dea6b,2,2,2,4,2,2015-03-05 23:54:37,2015-03-05 23:54:16
9187dc21290b544d7a5f3242ad004248015dea6b...905092d4b53499db28f53286dc0587a2835cba6a,1,2,1,3,1,2015-03-05 23:55:44,2015-03-05 23:55:24
905092d4b53499db28f53286dc0587a2835cba6a...36ff10c08cd2cbc4ae2295095d6340f88c5f8f83,3,20,10,30,3,2015-03-06 00:45:20,2015-03-05 23:11:18
36ff10c08cd2cbc4ae2295095d6340f88c5f8f83...2b466a9015c000987cb5332b9c9210b122917047,1,14,12,26,3,2015-03-06 00:45:21,2015-03-06 00:38:59
63f89e56024526d2467d89501cea811660649ccd...14520ad3530b0944a63acbccac50d43a5f1a46c1,4,42,8,50,11,2015-03-05 22:12:27,2015-03-05 22:07:22
14520ad3530b0944a63acbccac50d43a5f1a46c1...2fcd99349d338f34d93b3c4b14f6e9fe6dad5cfb,2,7,7,14,7,2015-03-05 22:41:19,2015-03-05 22:17:15
2fcd99349d338f34d93b3c4b14f6e9fe6dad5cfb...e48b80c6905a115b7182985eb3091dab3adea7d6,1,19,10,29,3,2015-03-05 22:50:33,2015-03-05 22:50:33
6b40a2e2bb10e2b4a31557f5471881eaa0028869...16d0fa2470db83e5f1b7d8c9d76ddfdd1e38db9f,1,4,0,4,1,2015-03-13 02:15:12,2015-03-13 02:14:29
16d0fa2470db83e5f1b7d8c9d76ddfdd1e38db9f...6797d91dabc04cc5c8e07e0b3d550045c552258e,1,1,1,2,1,2015-03-13 02:16:08,2015-03-13 02:16:08
6797d91dabc04cc5c8e07e0b3d550045c552258e...09a08d7edc27762255980d1f1fd7adfa5445f682,1,1,1,2,1,2015-03-13 02:18:43,2015-03-13 02:18:43
09a08d7edc27762255980d1f1fd7adfa5445f682...189d6f0986016150ea161accb4de98e27c86ef1e,1,1,1,2,1,2015-03-13 02:23:08,2015-03-13 02:23:08
cffd5cc78d5928f6e1637e4fdf3cca90c6b9488c...2e573373a5369aa9be55461fa6f11a3104d09882,1,3,3,6,2,2015-03-13 00:32:56,2015-03-13 00:32:56
2e573373a5369aa9be55461fa6f11a3104d09882...e946a798a111c72b43a7a367aaa8c6587a25fe3f,8,8,8,16,8,2015-03-13 00:40:03,2015-03-13 00:40:03
e946a798a111c72b43a7a367aaa8c6587a25fe3f...6c50dd6367dd4a7ad6a2009c6c9ffaea37e9d7ad,1,1,1,2,1,2015-03-13 00:42:34,2015-03-13 00:42:34
6c50dd6367dd4a7ad6a2009c6c9ffaea37e9d7ad...59ff1083e088aa19cb9aeaf88a06b4d1d1614ab8,1,1,1,2,1,2015-03-13 00:50:44,2015-03-13 00:50:44
9ef49c60dc1740ccc4f96bb6bdabeee6cafdf1a1...9a95c83b2aaba33f251f43df04c37906b9035e3b,3,17,12,29,7,2015-02-10 23:11:38,2015-02-10 23:11:38
9a95c83b2aaba33f251f43df04c37906b9035e3b...1e604a0941744a69f755e8e430a448a59755b5c0,2,0,9,9,2,2015-02-11 00:57:44,2015-02-11 00:57:44
1e604a0941744a69f755e8e430a448a59755b5c0...e146cd2d14e99cf0b29c27d049f4c2b0164b0e01,1,12,3,15,3,2015-02-11 01:01:12,2015-02-11 01:01:12
e146cd2d14e99cf0b29c27d049f4c2b0164b0e01...dbfc4c9de743b10ebc5d436193007ea88aefb90f,1,16,1,17,6,2015-02-11 02:11:44,2015-02-11 02:11:44
9ef49c60dc1740ccc4f96bb6bdabeee6cafdf1a1...e866f7ca8c3ccb6be217d470d3570558ffe6775c,5,7,6,13,7,2015-02-10 21:33:14,2015-02-10 21:33:14
f8d6be9f966aa9a0520b9eaa0a8c69540d807695...60883bc4d8540acd1bf1af9c91a891c7b346f9bd,2,3,3,6,3,2015-01-14 03:20:33,2015-01-14 03:20:33
60883bc4d8540acd1bf1af9c91a891c7b346f9bd...8243ba4ac12747f20b4ed32ad9979ced6bcf4462,1,1,1,2,1,2015-01-14 03:21:46,2015-01-14 03:21:46
8243ba4ac12747f20b4ed32ad9979ced6bcf4462...40fa95830fabd131a83f6e5c73b387c40772bde8,13,13,13,26,13,2015-01-14 03:30:27,2015-01-14 03:30:27
40fa95830fabd131a83f6e5c73b387c40772bde8...4c42a87721c4fa858bb01ee3e1f218f153e37313,2,4,1,5,2,2015-01-14 03:32:42,2015-01-14 03:32:42
4c42a87721c4fa858bb01ee3e1f218f153e37313...c2de48c90963dcf24785a73feb28add3327baf51,1,2,2,4,2,2015-01-14 04:00:44,2015-01-14 04:00:44
c2de48c90963dcf24785a73feb28add3327baf51...f446fbc292dde3359b74171580538f0b327422ba,1,7,8,15,2,2015-01-14 04:15:15,2015-01-14 04:15:15
f446fbc292dde3359b74171580538f0b327422ba...4ba315d2f61dbe63d9e4e8cdeb7109cb79ad4c96,1,7,6,13,6,2015-01-14 20:05:05,2015-01-14 03:12:17
4ba315d2f61dbe63d9e4e8cdeb7109cb79ad4c96...75dac55ad38b9b888109918de40a4af4530a346c,1,1,1,2,1,2015-01-14 20:06:26,2015-01-11 04:48:57
75dac55ad38b9b888109918de40a4af4530a346c...e5130bdceafd5da457cbe48997d0b59fd488c0ab,1,47,1,48,2,2015-01-14 20:06:34,2015-01-14 18:48:10
e5130bdceafd5da457cbe48997d0b59fd488c0ab...2e43b2bac90b122ddc17386631f7934ff5c67b80,1,2,1,3,1,2015-01-14 20:06:46,2015-01-14 18:52:33
2e43b2bac90b122ddc17386631f7934ff5c67b80...066e4fb435225eae605e528065225ca0f9676ea9,1,14,2,16,2,2015-01-14 20:21:18,2015-01-14 20:21:18
066e4fb435225eae605e528065225ca0f9676ea9...4957ba34bb528b5a5e786bab9edde81e0c829091,1,11,0,11,10,2015-01-14 21:21:02,2015-01-14 21:21:02
4957ba34bb528b5a5e786bab9edde81e0c829091...d663d846c0760ac175e1c5e4079bc1b63502b72e,1,0,52,52,2,2015-01-15 02:36:41,2015-01-15 02:36:18
d663d846c0760ac175e1c5e4079bc1b63502b72e...a1f8394750dfa56f9de3a4c9188f1109fa1d38ec,1,4,4,8,2,2015-01-15 02:37:24,2015-01-15 01:50:16
a1f8394750dfa56f9de3a4c9188f1109fa1d38ec...fbfd5c4664f5184e3e8bdab46e61191b71ecef1e,4,4,4,8,4,2015-01-15 18:50:09,2015-01-15 18:50:09
fbfd5c4664f5184e3e8bdab46e61191b71ecef1e...3eba43a42b7c197d110f01295d03f27e774ab146,1,0,28,28,2,2015-01-15 18:56:58,2015-01-15 18:56:58
3eba43a42b7c197d110f01295d03f27e774ab146...c123b89c4eaa485f9322a0fe0d4f080b2aaa7ac2,1,9,11,20,6,2015-01-15 19:22:56,2015-01-15 19:22:56
c123b89c4eaa485f9322a0fe0d4f080b2aaa7ac2...fe88795ef9d3bd7692c3ce1e776106485146d753,1,1,1,2,1,2015-01-15 21:20:14,2015-01-15 21:20:14
fe88795ef9d3bd7692c3ce1e776106485146d753...b5628f4b2312df50aca960ff6bbe26ddcf74dd1c,3,7,16,23,13,2015-01-17 00:50:51,2015-01-17 00:50:51
b5628f4b2312df50aca960ff6bbe26ddcf74dd1c...3a3ba627361923bed3dfa16edd22fa86cbcb1890,1,2,8,10,3,2015-01-20 17:53:29,2015-01-20 17:53:29
3a3ba627361923bed3dfa16edd22fa86cbcb1890...87a9c59c64c57233ca594014fee0c97669ce7fbb,2,28,25,53,13,2015-01-20 18:13:36,2015-01-20 18:13:36
87a9c59c64c57233ca594014fee0c97669ce7fbb...99124d881adc124d15ffec69f95b9fe42b40f41a,17,17,17,34,17,2015-01-20 18:25:22,2015-01-20 18:25:22
99124d881adc124d15ffec69f95b9fe42b40f41a...73a2f50d7d99b0407230edbce49c62e43b486e02,1,13,5,18,2,2015-01-20 21:23:45,2015-01-20 21:22:58
73a2f50d7d99b0407230edbce49c62e43b486e02...afb0915e68c363f101f03c14370167ddd716d103,1,8,7,15,4,2015-01-20 21:37:18,2015-01-20 21:37:18
afb0915e68c363f101f03c14370167ddd716d103...38e0e344c439f991eb5153c6ec694e5e1dd12e82,3,5,4,9,4,2015-01-20 21:50:34,2015-01-20 21:50:34
f8d6be9f966aa9a0520b9eaa0a8c69540d807695...9ce81d8f3b89c026f003a7f5cfe687cef80878ed,1,7,6,13,6,2015-01-14 03:12:17,2015-01-14 03:12:17
9ce81d8f3b89c026f003a7f5cfe687cef80878ed...bba83839183a98618dda08ad97f6d6b854d42125,1,1,1,2,1,2015-01-14 04:10:07,2015-01-11 04:48:57
bba83839183a98618dda08ad97f6d6b854d42125...7d3321b8ce9a84c607b8de0557d348a0e0e7b1ae,1,47,1,48,2,2015-01-14 18:48:10,2015-01-14 18:48:10
7d3321b8ce9a84c607b8de0557d348a0e0e7b1ae...eeb03d271ad023ab4a89470ae39e6edf6566e451,1,2,1,3,1,2015-01-14 18:52:33,2015-01-14 18:52:33
eeb03d271ad023ab4a89470ae39e6edf6566e451...25c11c69cf8f48d09c7901b299e87eba6bbe7776,1,4,4,8,2,2015-01-15 01:50:16,2015-01-15 01:50:16
25c11c69cf8f48d09c7901b299e87eba6bbe7776...4e1de9b56ac177d9113fc220a53236d7f1225d06,1,2,2,4,2,2015-01-15 02:35:33,2015-01-14 04:00:44
4e1de9b56ac177d9113fc220a53236d7f1225d06...be9ab672ce848bbcc71dcc7a65b0dfe36b0958cc,1,7,8,15,2,2015-01-15 02:35:43,2015-01-14 04:15:15
be9ab672ce848bbcc71dcc7a65b0dfe36b0958cc...d7bceb7d662ab9dbaf781151bcd97d0f256ab4d7,1,0,52,52,2,2015-01-15 02:36:18,2015-01-15 02:36:18
d7bceb7d662ab9dbaf781151bcd97d0f256ab4d7...c1556f250b04503d457d6796abaf9786b3b37f2e,1,1,1,2,1,2015-01-15 04:29:39,2015-01-15 04:29:23
c1556f250b04503d457d6796abaf9786b3b37f2e...2443d832265c7d1cfd48a4161455c9692342e6c2,1,14,1,15,2,2015-01-15 18:49:57,2015-01-15 16:14:29
2443d832265c7d1cfd48a4161455c9692342e6c2...c71e495e109e28b8b174728050780a49889221eb,2,3,3,6,2,2015-01-16 03:15:23,2015-01-16 03:15:06
c71e495e109e28b8b174728050780a49889221eb...3f98fe900adfeb55bad5c783fd97c3b25e597ed8,1,4,1,5,1,2015-01-16 16:33:13,2015-01-16 16:33:13
b8cb7ee04f5f9ed524aa30289b845412d190492c...ad03de15fcf9a030a519de0cd58f8fcf4b79885a,1,14,80,94,7,2014-11-26 05:01:49,2014-11-26 02:37:23
b8cb7ee04f5f9ed524aa30289b845412d190492c...9203b829466d93dbd9e97edc358f55fc2f6a5ac2,2,15,81,96,8,2014-11-26 04:51:57,2014-11-26 02:37:23
cd819513b5dac3d4188f89eb80e9e5d191de4cd4...29bc4216eb77c5e6b6803ad8123c594e3c03f811,3,15,12,27,3,2014-10-27 18:42:38,2014-10-27 18:42:38
ca2322e05be9e79fb1c7e834865aeec18f8eb01f...29194cef83d418227a8cc43e41b1539b13a6b68a,1,0,1,1,1,2014-10-17 23:08:02,2014-10-17 23:08:02
29194cef83d418227a8cc43e41b1539b13a6b68a...2b3a49ce1aaa4ad1caa0b1b177451c1a1a797b31,2,12,8,20,5,2014-10-17 23:32:18,2014-10-17 23:32:07
2b3a49ce1aaa4ad1caa0b1b177451c1a1a797b31...fe61a5e82f47b33930cc271571610dfa16f67a64,1,18,4,22,4,2014-10-18 00:30:23,2014-10-18 00:30:23
fe61a5e82f47b33930cc271571610dfa16f67a64...bb5c8250fb4bb63ac11512d2077c1f8ed3f66253,1,27,11,38,4,2014-10-18 00:48:34,2014-10-18 00:47:25
bb5c8250fb4bb63ac11512d2077c1f8ed3f66253...2a0ff3dad03175c00d66b02e2bbff2c1362f0c3d,1,1,1,2,1,2014-10-18 00:52:02,2014-10-18 00:52:02
2a0ff3dad03175c00d66b02e2bbff2c1362f0c3d...5bb1af29a35124233185eb7b1bc77025d59f33c0,1,1,5,6,2,2014-10-18 00:53:36,2014-10-18 00:53:19
5bb1af29a35124233185eb7b1bc77025d59f33c0...12cd9fc9cb4b165480604b306592579f02fcb1df,1,4,1,5,2,2014-10-18 01:25:58,2014-10-18 01:25:58
12cd9fc9cb4b165480604b306592579f02fcb1df...cda8e8b6e4032d6d3918797bbb4c427d8e095a9d,1,3,0,3,1,2014-10-18 01:26:41,2014-10-18 01:26:41
cda8e8b6e4032d6d3918797bbb4c427d8e095a9d...5075c5f6183bbbd903c666a83a5a0fee978083d7,1,9,7,16,2,2014-10-18 01:42:31,2014-10-18 01:40:51
5075c5f6183bbbd903c666a83a5a0fee978083d7...a75b0c9591c7874f05b2d0100cc1c27c8d334e21,1,2,2,4,2,2014-10-18 02:18:23,2014-10-18 02:18:23
a75b0c9591c7874f05b2d0100cc1c27c8d334e21...9ec9f08d26c10bb2bece3d149a3a2bc544a6d2c4,1,2,2,4,2,2014-10-18 02:39:15,2014-10-18 02:39:15
ca2322e05be9e79fb1c7e834865aeec18f8eb01f...84d3b2de4c65e64593da3ba92792f731c797a34d,1,2,2,4,2,2014-10-17 22:52:58,2014-10-17 22:52:58
84d3b2de4c65e64593da3ba92792f731c797a34d...1ae60a6088fff2a455ef0d9a4635c0fb2c57ca66,1,0,1,1,1,2014-10-17 23:08:25,2014-10-17 23:08:02
1ae60a6088fff2a455ef0d9a4635c0fb2c57ca66...827b206c025c9b6ba018cb58899c8aca730c6f90,17,17,17,34,17,2014-10-17 23:10:40,2014-10-17 23:10:40
827b206c025c9b6ba018cb58899c8aca730c6f90...ed7fcd4fd7035a63dc0f4e985e2f42fd77f1d94a,1,1,1,2,1,2014-10-17 23:19:38,2014-10-17 23:13:43
ed7fcd4fd7035a63dc0f4e985e2f42fd77f1d94a...0330190f35aec87c5d71e1d2314c5476c8945fda,2,12,8,20,5,2014-10-18 01:02:06,2014-10-17 23:32:07
0330190f35aec87c5d71e1d2314c5476c8945fda...828bd570045e3adc5c6c12f064507f4d72a63be9,1,18,4,22,4,2014-10-18 01:02:14,2014-10-18 00:30:23
828bd570045e3adc5c6c12f064507f4d72a63be9...5e61d60e48334021b179fe723431d45a40f07ada,1,27,11,38,4,2014-10-18 01:02:20,2014-10-18 00:47:25
5e61d60e48334021b179fe723431d45a40f07ada...d55f684ec428f51aaa2c5725ef852cdd8b3d7235,1,1,1,2,1,2014-10-18 01:02:25,2014-10-18 00:52:02
d55f684ec428f51aaa2c5725ef852cdd8b3d7235...aec9909e3725afbf84fc5ff1c076601355450891,1,1,5,6,2,2014-10-18 01:02:30,2014-10-18 00:53:19
aec9909e3725afbf84fc5ff1c076601355450891...865d826390c775bbb2b950a33ea60f457905cc29,1,1,1,2,1,2014-10-18 01:04:14,2014-10-18 01:04:14
865d826390c775bbb2b950a33ea60f457905cc29...49f5d41fd77b1916e4fb838c32ee0a99031b2864,1,1,1,2,1,2014-10-18 01:06:46,2014-10-18 01:06:46
49f5d41fd77b1916e4fb838c32ee0a99031b2864...6fffcda0698116f8487d234335fa14b20813cd73,1,2,2,4,2,2014-10-18 05:11:13,2014-10-18 02:18:23
6fffcda0698116f8487d234335fa14b20813cd73...d3ff26dd487598d8edd42c5fc9477653baa3c90a,1,2,2,4,2,2014-10-18 05:11:21,2014-10-18 02:39:15
d3ff26dd487598d8edd42c5fc9477653baa3c90a...6db7783470f5462bcef941cecebcdba36074c1e4,4,4,4,8,4,2014-10-18 05:17:06,2014-10-18 05:13:05
6db7783470f5462bcef941cecebcdba36074c1e4...9172a50b16859622a34e5c25e9e4c6c86c61dd76,1,0,1,1,1,2014-10-21 19:40:58,2014-10-14 09:50:44
9172a50b16859622a34e5c25e9e4c6c86c61dd76...e14cc7ab97fd6d1b8bf28ecb04680818f4f141b4,1,13,4,17,2,2014-10-21 19:41:18,2014-10-20 22:14:12
e14cc7ab97fd6d1b8bf28ecb04680818f4f141b4...a2218ce78639262b031c021193d4ec199eb0672b,5,25,22,47,16,2014-10-21 19:52:24,2014-10-20 21:59:31
a2218ce78639262b031c021193d4ec199eb0672b...a283d298e1227349e0a572756130fe2d4e5f6145,1,1,1,2,1,2014-10-21 19:55:47,2014-10-21 00:27:27
a283d298e1227349e0a572756130fe2d4e5f6145...caf9538b8dea671b178500cc8c031cb883b43527,1,11,2,13,2,2014-10-21 19:57:12,2014-10-17 23:06:26
caf9538b8dea671b178500cc8c031cb883b43527...a1feed1996207f0d5900f04b015f4b6b8448c68c,1,9,2,11,2,2014-10-21 19:57:17,2014-10-17 23:06:46
a1feed1996207f0d5900f04b015f4b6b8448c68c...5663d9efacf03da0312023d0c9f34cd7754e4ee5,1,1,1,2,1,2014-10-21 19:57:37,2014-10-20 18:20:50
5663d9efacf03da0312023d0c9f34cd7754e4ee5...cab1662f06f69fb5c2d60430b890d37b6a419b82,1,6,3,9,4,2014-10-21 19:57:56,2014-10-20 18:25:16
cab1662f06f69fb5c2d60430b890d37b6a419b82...b72652a762b946d8ae716758a02f88fd9a2b8cfe,2,30,1,31,14,2014-10-21 19:58:16,2014-10-18 17:57:49
b72652a762b946d8ae716758a02f88fd9a2b8cfe...13cba47aefc6314fb02b43501a87739bfc09bd9a,1,4,2,6,2,2014-10-21 19:58:42,2014-10-21 00:39:37
13cba47aefc6314fb02b43501a87739bfc09bd9a...96805aa8f8b0fd1b0ec12aebcae551b2e9e407b1,1,2,2,4,1,2014-10-21 19:58:56,2014-10-21 05:43:15
96805aa8f8b0fd1b0ec12aebcae551b2e9e407b1...5a522d0ce10a9a3896d9f7dbc1181ed221f085c0,1,1,1,2,1,2014-10-21 19:59:29,2014-10-21 05:39:44
5a522d0ce10a9a3896d9f7dbc1181ed221f085c0...4ee73424733b6b467d56080547f53665fd40d0a5,1,5,1,6,2,2014-10-21 20:00:48,2014-10-21 05:54:22
4ee73424733b6b467d56080547f53665fd40d0a5...b03d16d3617629a5ab7a357e08397b5bb8b34922,1,1,4,5,1,2014-10-21 20:00:48,2014-10-21 18:37:34
b03d16d3617629a5ab7a357e08397b5bb8b34922...339706882b22e9f9caa667638ac93d9aa343285d,1,1,1,2,1,2014-10-21 20:00:49,2014-10-21 18:39:49
339706882b22e9f9caa667638ac93d9aa343285d...9b60627a7b6fa7f6aab67cc99edfdb0c9919a2ee,1,70,70,140,58,2014-10-21 20:01:10,2014-10-21 00:59:35
9b60627a7b6fa7f6aab67cc99edfdb0c9919a2ee...bf9b8a94436c29bdb49d6a7ed6d62a82c15ef621,2,17,158,175,6,2014-10-21 20:01:21,2014-10-17 22:39:19
bf9b8a94436c29bdb49d6a7ed6d62a82c15ef621...8868fe981daf3e173e8ee28a2c03515418d1f9f2,2,29,96,125,17,2014-10-21 20:01:31,2014-10-21 02:31:46
8868fe981daf3e173e8ee28a2c03515418d1f9f2...2330e2255441705a2f5f3e313b98a388e76f8a3d,1,12,5,17,3,2014-10-22 17:09:08,2014-10-20 22:51:22
2330e2255441705a2f5f3e313b98a388e76f8a3d...a64565c370a297236034ea819d75d92b3399d731,1,21,5,26,5,2014-10-22 17:25:40,2014-10-20 18:41:23
a64565c370a297236034ea819d75d92b3399d731...ae098ae71aa694ea354b1d8f56c0926483ad11dd,1,5,0,5,1,2014-10-22 17:28:02,2014-10-20 19:24:16
ae098ae71aa694ea354b1d8f56c0926483ad11dd...f2aab4591e7c514f779c98e189de9f887f0b7b4a,2,8,3,11,6,2014-10-22 17:28:06,2014-10-20 21:23:35
f2aab4591e7c514f779c98e189de9f887f0b7b4a...1bb897bf4c4ce32494f2d4060b26528aa02292aa,1,11,0,11,1,2014-10-22 17:29:50,2014-10-20 22:47:29
1bb897bf4c4ce32494f2d4060b26528aa02292aa...becf6c4f4767d96a126f867c4eae8b1c431793c8,1,3,1,4,2,2014-10-22 17:29:50,2014-10-20 22:31:51
becf6c4f4767d96a126f867c4eae8b1c431793c8...3d9ffab7334ce16ab7c83fbf83acf562910c1a24,1,7,7,14,7,2014-10-22 17:29:50,2014-10-20 22:15:25
3d9ffab7334ce16ab7c83fbf83acf562910c1a24...912130d0d9781c191c8a6642d7eaced1c6ecc93d,1,24,21,45,3,2014-10-22 17:29:50,2014-10-20 21:57:56
912130d0d9781c191c8a6642d7eaced1c6ecc93d...6224a749d531efac99a3389d7b0c34d0be0404b9,1,3,4,7,3,2014-10-22 17:29:50,2014-10-20 21:48:23
6224a749d531efac99a3389d7b0c34d0be0404b9...314dcff249897484e636d5200c11f9aada5fe3af,1,1,0,1,1,2014-10-22 17:30:02,2014-10-21 20:49:44
314dcff249897484e636d5200c11f9aada5fe3af...11471a82c8e72a48432f3164871b1571a3f702aa,3,27,5,32,11,2014-10-22 17:31:17,2014-10-21 21:08:39
11471a82c8e72a48432f3164871b1571a3f702aa...74e413526a7ab5f59740a44d2c9dbed358d95023,1,3,1,4,2,2014-10-22 17:31:45,2014-10-21 21:31:18
74e413526a7ab5f59740a44d2c9dbed358d95023...6016854eb97e9aa984c1bd888341610cfa84aba1,1,3,0,3,2,2014-10-22 17:38:14,2014-10-21 21:44:00
6016854eb97e9aa984c1bd888341610cfa84aba1...3d9966cdd7146ac2ea2da1edc067c04e17e1e68d,1,1,1,2,1,2014-10-22 17:38:29,2014-10-21 22:11:37
3d9966cdd7146ac2ea2da1edc067c04e17e1e68d...42ebedb15b1cc845ec298500ab2d65e7e9b56998,1,1,0,1,1,2014-10-22 17:40:28,2014-10-21 22:39:07
42ebedb15b1cc845ec298500ab2d65e7e9b56998...ae9e4e87b9483ce35a51015325fad6ad18af970c,1,5,0,5,1,2014-10-22 17:40:28,2014-10-21 22:58:18
ae9e4e87b9483ce35a51015325fad6ad18af970c...d4e28c81e4a250d6e71e6c7a5d1da24250a87fe1,8,386,21,407,18,2014-10-22 17:40:33,2014-10-08 02:44:49
d4e28c81e4a250d6e71e6c7a5d1da24250a87fe1...fb2f5dcddd6df63308c30fadee75e88b863df1eb,1,2,1,3,1,2014-10-22 17:40:33,2014-10-21 23:56:45
fb2f5dcddd6df63308c30fadee75e88b863df1eb...37c7886cb158948ea676ad714e3811db47a3b860,1,2,0,2,1,2014-10-22 17:41:23,2014-10-22 00:03:46
37c7886cb158948ea676ad714e3811db47a3b860...31cd4823cecf49ac9bfccc89416f1c377176d6df,1,28,13,41,12,2014-10-22 17:48:40,2014-10-21 23:43:02
31cd4823cecf49ac9bfccc89416f1c377176d6df...5111cd10cc9ac4db003fc7401f284f7b60f387fb,1,5,5,10,2,2014-10-22 17:48:47,2014-10-22 17:48:18
5111cd10cc9ac4db003fc7401f284f7b60f387fb...1b50d72b09f5a7d41ae694365e3335d714751a71,1,2,2,4,1,2014-10-22 17:49:12,2014-10-22 00:51:16
1b50d72b09f5a7d41ae694365e3335d714751a71...065f447669754a7b6a0b7de435e7eba42f5301c2,1,44,8,52,5,2014-10-22 17:50:59,2014-10-22 03:11:34
065f447669754a7b6a0b7de435e7eba42f5301c2...d4a9f8c96e4e90e53729c690eebb983309d5f92e,1,2,2,4,2,2014-10-22 17:53:39,2014-10-22 05:36:44
d4a9f8c96e4e90e53729c690eebb983309d5f92e...bf227bd35d991a80e30969d5dd766d2d2654a430,1,8,5,13,5,2014-10-22 17:55:40,2014-10-22 16:37:09
bf227bd35d991a80e30969d5dd766d2d2654a430...d98c6eac8d53fc009eca76e915035f2632f19da3,1,2,5,7,1,2014-10-22 18:02:08,2014-10-22 03:28:04
d98c6eac8d53fc009eca76e915035f2632f19da3...4255e0b9e73e2bb37115ac26b7ac62f672e6ad2a,1,4,2,6,1,2014-10-22 18:02:08,2014-10-22 06:04:07
4255e0b9e73e2bb37115ac26b7ac62f672e6ad2a...4b576959f495c0594e18908a4cfb06e21744f517,1,355,105,460,49,2014-10-22 18:08:45,2014-10-22 16:57:19
4b576959f495c0594e18908a4cfb06e21744f517...5eedfe8baff75bc4ea4aa6c2f3aa487296423995,1,5,0,5,1,2014-10-22 18:10:11,2014-10-22 04:56:53
5eedfe8baff75bc4ea4aa6c2f3aa487296423995...48b50a8ae24d34e81c8ed78e2b53279e116fa1ce,2,71,31,102,9,2014-10-22 18:41:22,2014-10-22 00:06:43
48b50a8ae24d34e81c8ed78e2b53279e116fa1ce...8a2ed10e1473cf1b9d5b61be610ddc269e67dedc,1,2,4,6,2,2014-10-22 18:41:30,2014-10-22 17:03:42
8a2ed10e1473cf1b9d5b61be610ddc269e67dedc...1a75eb1357226502d827d0b4be9a1e5c6b77d4d7,5,76,15,91,14,2014-10-22 19:36:59,2014-10-22 00:49:42
1a75eb1357226502d827d0b4be9a1e5c6b77d4d7...868273b0745c6e931cfa90410f4efffb3d7918dd,1,1,1,2,1,2014-10-22 19:42:50,2014-10-22 19:24:44
868273b0745c6e931cfa90410f4efffb3d7918dd...b4fbfe016f3a0846d3216ba7be9f1e35e2eafc60,58,24,24,48,4,2014-10-22 19:43:02,2014-10-20 19:00:30
b4fbfe016f3a0846d3216ba7be9f1e35e2eafc60...34dda787aac0aed6df05fb7e82a10de4e4818dba,1,1,1,2,1,2014-10-22 19:49:49,2014-10-22 19:49:49
34dda787aac0aed6df05fb7e82a10de4e4818dba...6fc46976daae05fb62b1ed45df029d358d88966a,8,8,8,16,8,2014-10-22 19:58:12,2014-10-22 19:58:12
6fc46976daae05fb62b1ed45df029d358d88966a...e60f904eeff0534b4c763f3fe2534e16b3e8f0e1,1,2,2,4,2,2014-10-22 20:36:13,2014-10-22 17:47:10
e60f904eeff0534b4c763f3fe2534e16b3e8f0e1...dbd576689f4959cc957083bd6749636a3c3f5bf7,1,2,0,2,1,2014-10-22 20:36:13,2014-10-22 17:54:49
dbd576689f4959cc957083bd6749636a3c3f5bf7...96cfcb780b4e806be782211310c497750fd93f2a,1,3,1,4,1,2014-10-22 20:36:13,2014-10-22 17:59:11
96cfcb780b4e806be782211310c497750fd93f2a...0706e3fe6d80a98317262d4710c7da9a9998fe23,1,3,2,5,1,2014-10-22 20:36:29,2014-10-22 19:54:00
0706e3fe6d80a98317262d4710c7da9a9998fe23...d064d744a30f5100f5fe97dc695217a8c5c16d43,4,9,21,30,12,2014-10-22 20:37:08,2014-10-22 19:59:22
d064d744a30f5100f5fe97dc695217a8c5c16d43...da24f6cedd819976f27d058462fb878fdb46e1f6,1,4,2,6,2,2014-10-22 20:53:59,2014-10-22 20:51:06
da24f6cedd819976f27d058462fb878fdb46e1f6...9eb79d4c33e13b8562a939610beacd240b7ef414,1,1,1,2,1,2014-10-22 20:54:22,2014-10-22 20:54:22
9eb79d4c33e13b8562a939610beacd240b7ef414...fb0dc712e913a17f69db4cf4621ae28052284ef7,1,1,1,2,1,2014-10-22 20:58:48,2014-10-22 20:58:48
fb0dc712e913a17f69db4cf4621ae28052284ef7...cfe1e5d230405d738c9254164c6ffeddb9639186,4,160,157,317,6,2014-10-22 21:26:10,2014-10-22 20:43:43
cfe1e5d230405d738c9254164c6ffeddb9639186...d41ee867d1f3f889bac501662fbe00f2768ef426,1,2,2,4,2,2014-10-22 21:26:10,2014-10-22 21:25:50
d41ee867d1f3f889bac501662fbe00f2768ef426...0d64cad216aa0b731e7294bd95e6aa192391d212,1,2,2,4,2,2014-10-22 21:29:28,2014-10-22 21:29:28
0d64cad216aa0b731e7294bd95e6aa192391d212...16b0f3627c59b56f58622c97414bf0b5085c4b1e,3,29,23,52,10,2014-10-22 22:11:57,2014-10-22 22:11:57
16b0f3627c59b56f58622c97414bf0b5085c4b1e...440e3c17a5105326f5802c46a76e064f61f187de,1,2,2,4,2,2014-10-22 22:21:41,2014-10-22 22:21:41
440e3c17a5105326f5802c46a76e064f61f187de...b1d3dc23e97f2d81bfaec6d9b482507c13cb4bc6,1,4,2,6,2,2014-10-22 23:38:04,2014-10-22 23:38:04
b1d3dc23e97f2d81bfaec6d9b482507c13cb4bc6...546276fb85fc86afcaf41f2bbce92d35a0f3ea3c,1,9,15,24,8,2014-10-23 02:34:02,2014-10-23 02:16:16
9a6532c640421529b88720b75cef907dfcd6e3af...73ff027fec69d8f09982aa06969dc95c7eb39f45,1,4,0,4,2,2014-10-13 16:49:30,2014-10-13 16:49:30
73ff027fec69d8f09982aa06969dc95c7eb39f45...cb97ed238bb8c14a13edc6057f78f4dc8bbbe064,1,9,0,9,2,2014-10-13 16:56:03,2014-10-13 16:55:16
cb97ed238bb8c14a13edc6057f78f4dc8bbbe064...fc7c44dc1a325ad331d5e7077a97488e3ed8a5d6,1,17,2,19,3,2014-10-13 18:25:34,2014-10-13 17:02:51
fc7c44dc1a325ad331d5e7077a97488e3ed8a5d6...368cd01843f2a06db89b9d7c165dd89d6ba9676c,1,15,2,17,2,2014-10-13 18:25:34,2014-10-13 18:12:44
9a6532c640421529b88720b75cef907dfcd6e3af...739c3350f5e9ec8b0b6984e59d1c2c51fe7cef5a,124,124,124,248,124,2014-10-13 06:24:10,2014-10-13 06:24:10
739c3350f5e9ec8b0b6984e59d1c2c51fe7cef5a...aff2f036f9e52d297e8d9d781fbc4c8b88b45bff,1,2,4,6,2,2014-10-13 06:25:00,2014-10-13 06:25:00
2b466a9015c000987cb5332b9c9210b122917047...9f5a97b9f0a8558bf986e7a0cc4c386658719bf7,4,42,8,50,11,2015-03-06 00:54:58,2015-03-05 22:07:22
9f5a97b9f0a8558bf986e7a0cc4c386658719bf7...52e5e24327ee2f41d321660e9c8601b5c789120b,2,7,7,14,7,2015-03-06 00:54:58,2015-03-05 22:17:15
52e5e24327ee2f41d321660e9c8601b5c789120b...2f7c960195a04a9caeb139e8c936e94c60c2293d,1,19,10,29,3,2015-03-06 00:54:58,2015-03-05 22:50:33
2f7c960195a04a9caeb139e8c936e94c60c2293d...a8c4db15055569248faebbd8de57b70835eb35e7,1,12,0,12,2,2015-03-06 00:54:58,2015-03-06 00:54:49
189d6f0986016150ea161accb4de98e27c86ef1e...942db816cae847bb7a732c15e9f4237f19b3d1fd,2,3,1,4,2,2015-03-13 02:49:24,2015-03-13 02:49:01
942db816cae847bb7a732c15e9f4237f19b3d1fd...8bff26920676fc376d8665d79aae10deaee84f8a,2,3,2,5,2,2015-03-13 03:18:02,2015-03-13 03:12:49
8bff26920676fc376d8665d79aae10deaee84f8a...0f270c9f139d0f32ba64f4e68389bf714b1bf59b,1,1,1,2,1,2015-03-13 03:39:58,2015-03-13 03:39:36
0f270c9f139d0f32ba64f4e68389bf714b1bf59b...7b8748e11d47d6cf5e68c0e3749aa9e4221c80d1,1,10,2,12,1,2015-03-13 04:09:14,2015-03-13 04:09:14
ae4c02bd16ec22ff72b4e7ab747ae13ffeb26472...a73673dfd826f119522a4b7955a29c4bff807b2b,1,1,1,2,1,2015-03-13 01:34:58,2015-03-13 01:34:58
a73673dfd826f119522a4b7955a29c4bff807b2b...4194378eb8f66afea670ddddf5966effe1ab6429,1,1,1,2,1,2015-03-13 01:38:28,2015-03-13 01:38:28
4194378eb8f66afea670ddddf5966effe1ab6429...5bcc8414a0f67ce8ed1057822026aff17c368b5b,1,1,1,2,1,2015-03-13 01:42:54,2015-03-13 01:42:54
5bcc8414a0f67ce8ed1057822026aff17c368b5b...9a92d3166bd90c55f474227e8aa2a65ac1bb60a2,2,2,2,4,2,2015-03-13 01:45:55,2015-03-13 01:44:39
9a92d3166bd90c55f474227e8aa2a65ac1bb60a2...b2f0348b84bff5b76251262efb9cbeb5d0f8ace6,1,1,1,2,1,2015-03-13 01:51:16,2015-03-13 01:51:16
b2f0348b84bff5b76251262efb9cbeb5d0f8ace6...154e1397f08b0b5979f61ae8e70a2b918745eee1,1,1,1,2,1,2015-03-13 01:51:23,2015-03-13 01:51:23
c88e339b0c5bb35b7078f5827ed90dc152fb82a1...712225c77a1f6e06029d0042caf19f1d251ce781,1,4,3,7,3,2015-02-11 02:35:11,2015-02-11 02:35:11
712225c77a1f6e06029d0042caf19f1d251ce781...ecb10cbc9fa0e00114ab98eb2a3700f7711e3316,1,0,1,1,1,2015-02-11 03:07:42,2015-02-11 03:07:42
ecb10cbc9fa0e00114ab98eb2a3700f7711e3316...39435fffa6420a6cfa9567824107749ed7c9fedf,1,2,2,4,2,2015-02-11 16:53:17,2015-02-11 16:46:49
39435fffa6420a6cfa9567824107749ed7c9fedf...e698c5bf5a024cfaf32eb518a1b75b07ecdfa26a,2,23,0,23,2,2015-02-12 01:49:19,2015-02-12 01:46:56
e698c5bf5a024cfaf32eb518a1b75b07ecdfa26a...085e02d525157905feb59b9dccd42765733f1667,6,243,40,283,35,2015-02-12 02:10:33,2015-01-27 18:42:50
085e02d525157905feb59b9dccd42765733f1667...c0aab1e8d3a5f01b4bedaa1c63dea3fc8f3db9b7,11,305,2,307,13,2015-02-12 02:10:33,2015-01-26 18:55:20
c0aab1e8d3a5f01b4bedaa1c63dea3fc8f3db9b7...aa6e1b39092d8f9e36a7ba390cad600168fbe752,2,2,4,6,3,2015-02-12 03:40:40,2015-02-12 03:40:40
aa6e1b39092d8f9e36a7ba390cad600168fbe752...d117ba29f82e3b36e10a5bf064af53171e3b41d7,1,1,1,2,1,2015-02-12 18:09:11,2015-02-11 21:30:36
d117ba29f82e3b36e10a5bf064af53171e3b41d7...e62268609fa84bc9ed7cf893c53690421978915d,4,5763,5,5768,6,2015-02-12 18:27:48,2015-02-12 18:27:48
e62268609fa84bc9ed7cf893c53690421978915d...58cf006678c2e05383417aa2ea4064a64820fe5c,1,22,20,42,19,2015-02-12 21:53:00,2015-02-12 21:53:00
e866f7ca8c3ccb6be217d470d3570558ffe6775c...955fc1dfe84045d835650ea5b96ec6fdefe1de96,6,243,40,283,35,2015-02-12 02:08:17,2015-01-27 18:42:50
955fc1dfe84045d835650ea5b96ec6fdefe1de96...50175240a8bf095cbde2b33a04f4b07acad8432a,11,305,2,307,13,2015-02-12 02:09:07,2015-01-26 18:55:20
e866f7ca8c3ccb6be217d470d3570558ffe6775c...86d535faff79581399a6d2ef22f43d5229181e9e,1,2,1,3,1,2015-02-10 22:59:27,2015-02-04 15:13:03
86d535faff79581399a6d2ef22f43d5229181e9e...e25e46af442a43213d204a88fc6773ebc0674662,1,2,2,4,1,2015-02-10 23:01:04,2015-02-10 23:01:04
e25e46af442a43213d204a88fc6773ebc0674662...ac113d4d6dbbc23b396e3f1e73c4fcebbef914fb,9,103,89,192,18,2015-02-11 01:11:50,2015-02-11 01:11:21
38e0e344c439f991eb5153c6ec694e5e1dd12e82...4229de6eb69df84dfecc4833893f8767c25ec0ab,1,57,32,89,5,2015-02-10 01:41:03,2015-02-10 00:11:21
4229de6eb69df84dfecc4833893f8767c25ec0ab...7fb748818b0b9be65e79a361687c03f86a9f9fcd,2,45,0,45,5,2015-02-10 01:41:03,2015-02-10 00:35:11
7fb748818b0b9be65e79a361687c03f86a9f9fcd...103efcf01ad393838014e2d0fac323b8a1b67aa9,7,29,10,39,14,2015-02-10 01:41:03,2015-02-10 01:31:29
103efcf01ad393838014e2d0fac323b8a1b67aa9...ad7a66cc6ebbd810d0b081692fac3d99e06496db,6,8,7,15,6,2015-02-10 01:49:25,2015-02-10 01:43:01
ad7a66cc6ebbd810d0b081692fac3d99e06496db...9f6cfa8cc71de045d78bdf38ed238ce0a4564c17,1,28,2,30,6,2015-02-10 06:00:07,2015-02-10 05:40:18
9f6cfa8cc71de045d78bdf38ed238ce0a4564c17...4f329de33a4c39824506720bbd1cdadcb19dc250,3,3,3,6,3,2015-02-10 06:00:47,2015-02-10 06:00:47
4f329de33a4c39824506720bbd1cdadcb19dc250...4d574efa018196f6f30d11fb78b94d7b5be18d03,1,96,0,96,1,2015-02-10 20:17:19,2015-02-10 19:27:01
4d574efa018196f6f30d11fb78b94d7b5be18d03...06a83466731f1810d2ff12124ecbb34a675f2627,1,15,14,29,5,2015-02-10 20:17:19,2015-02-10 20:00:20
06a83466731f1810d2ff12124ecbb34a675f2627...3ff2818409b7c69cd3d311d98c44ee0a3c5f5ae5,1,7,17,24,3,2015-02-10 20:17:19,2015-02-10 20:05:20
3ff2818409b7c69cd3d311d98c44ee0a3c5f5ae5...1b60f4f592125ba778200db3ada33b61d0e9df8a,1,7,7,14,2,2015-02-10 20:17:19,2015-02-10 20:12:30
1b60f4f592125ba778200db3ada33b61d0e9df8a...410ddfff9ae050866ebbe22a8968282307afa0f7,3,3,3,6,3,2015-02-10 20:18:43,2015-02-10 20:18:43
38e0e344c439f991eb5153c6ec694e5e1dd12e82...4c41b886a404a0d386fd05004e093db6b82f36e5,3,12,12,24,11,2015-01-21 01:53:12,2015-01-21 01:53:12
4c41b886a404a0d386fd05004e093db6b82f36e5...1e062d9f82d4f7e163d4abf0d12ec434c30b9918,8,45,45,90,39,2015-01-21 01:57:11,2015-01-21 01:57:11
3f98fe900adfeb55bad5c783fd97c3b25e597ed8...1aba3a8e7ad8438c390249a31b27cf2d7562a3d5,5,45,41,86,22,2015-01-20 18:56:57,2015-01-15 15:41:56
1aba3a8e7ad8438c390249a31b27cf2d7562a3d5...c5bc843816f5b74d81a0a47f87c66ee90e0f3e95,55,83,11,94,58,2015-01-20 20:21:35,2015-01-20 20:21:35
c5bc843816f5b74d81a0a47f87c66ee90e0f3e95...18a3b1ee087aa0498a9af9ee92f555bee00ddeb6,1,1,0,1,1,2015-01-20 23:54:45,2015-01-20 23:54:45
18a3b1ee087aa0498a9af9ee92f555bee00ddeb6...7c087f7b76720fc1047b710c093e5b42338e9226,1,8,2,10,2,2015-01-21 00:00:27,2015-01-20 23:55:50
3f98fe900adfeb55bad5c783fd97c3b25e597ed8...87c8f4487af34c099578d04ec37ad37fa22e1a72,2,19,1,20,2,2015-01-17 00:35:31,2014-12-03 20:28:07
87c8f4487af34c099578d04ec37ad37fa22e1a72...a063ab9558c0d560d5541232c486a3a277a09517,1,3,3,6,2,2015-01-17 00:35:32,2014-12-07 16:14:59
a063ab9558c0d560d5541232c486a3a277a09517...c70101325663a054f490c244efb0fc664a97589d,1,4,4,8,3,2015-01-17 00:35:32,2014-12-07 16:17:31
ad03de15fcf9a030a519de0cd58f8fcf4b79885a...01a19bf1826532a524ae1b7a1f76174a6ba6a331,2,2,2,4,2,2014-11-26 05:45:08,2014-11-26 05:31:49
01a19bf1826532a524ae1b7a1f76174a6ba6a331...7b3f03f1521e38b20af3ac1d6aad8f2523631680,1,1,1,2,1,2014-11-26 16:58:11,2014-11-26 16:58:11
ad03de15fcf9a030a519de0cd58f8fcf4b79885a...9b8e441835c4c8e41f3c76f7e57a833d05c0bb15,1,1,1,2,1,2014-11-26 05:31:49,2014-11-26 05:31:49
ad03de15fcf9a030a519de0cd58f8fcf4b79885a...649df7b4abc693ba8b94ca08277f0a848091427b,2,2,2,4,2,2014-11-26 05:18:12,2014-11-26 05:06:59
29bc4216eb77c5e6b6803ad8123c594e3c03f811...e4ad00394fc04cbb82fd3cd5e2fc392a95d900a9,4,57,34,91,18,2014-10-27 19:32:03,2014-10-27 19:32:03
29bc4216eb77c5e6b6803ad8123c594e3c03f811...f193546168169dd1cc5a953e7809bae3577f2071,1,1,1,2,1,2014-10-27 18:55:02,2014-10-27 18:55:02
9ec9f08d26c10bb2bece3d149a3a2bc544a6d2c4...710e7fe405db7cea6cf81b0517ea74d4bcb02b18,1,22,14,36,9,2014-10-18 18:51:33,2014-10-18 18:45:26
710e7fe405db7cea6cf81b0517ea74d4bcb02b18...cafd46617659e1d5b650f57c8871beab5148ed0d,1,11,2,13,2,2014-10-19 22:00:16,2014-10-17 23:06:26
cafd46617659e1d5b650f57c8871beab5148ed0d...31ba603a997fdf07131256279cf84ace57239a86,1,9,2,11,2,2014-10-19 22:00:28,2014-10-17 23:06:46
9ec9f08d26c10bb2bece3d149a3a2bc544a6d2c4...bd9b9661d005d69cb463bed3d400bfbcc4e53ec7,2,30,1,31,14,2014-10-18 18:03:10,2014-10-18 17:57:49
546276fb85fc86afcaf41f2bbce92d35a0f3ea3c...de97e984f663e0ba7c62212f80008e64da537ccc,4,4,4,8,4,2014-10-23 18:06:43,2014-10-23 18:06:43
546276fb85fc86afcaf41f2bbce92d35a0f3ea3c...0b0dc46bdbd95352235d977f01e6a7de2a8b1700,2,59,2,61,5,2014-10-23 17:32:59,2014-10-21 23:29:22
0b0dc46bdbd95352235d977f01e6a7de2a8b1700...09264641c4d8103829c35a093a68ef42cde701a2,1,21,1,22,2,2014-10-23 17:33:27,2014-10-20 18:43:03
5d3cfa2d76cda7fcd501a3aed15c1f80e18a5616...4a5c980baad03adf19ef94f75644d1cfe6f8fafe,1,8,2,10,3,2015-03-06 01:09:36,2015-03-06 01:07:50
4a5c980baad03adf19ef94f75644d1cfe6f8fafe...c70ff63a2fce1a6d66ae6774a8ce62e7d9aa327a,1,1,1,2,1,2015-03-06 01:10:26,2015-03-06 01:10:26
7b8748e11d47d6cf5e68c0e3749aa9e4221c80d1...cdd666ddc0dea1c8719cf99cfc89fa6558105904,1,2,0,2,1,2015-03-13 05:31:52,2015-03-13 05:31:32
cdd666ddc0dea1c8719cf99cfc89fa6558105904...5d482fa93016e6d397ae701441e1cfe63a22596e,1,1,1,2,1,2015-03-13 05:37:54,2015-03-13 05:37:54
5a51cc0303dfc7b2ffb256e70260c937b51b220c...7578378bcacbaa63c6a17e5566c0fec525ae1c0a,1,1,1,2,1,2015-03-13 02:32:25,2015-03-13 02:32:25
7578378bcacbaa63c6a17e5566c0fec525ae1c0a...7b31048ec4b4ce388046decb7b67259452420538,1,1,1,2,1,2015-03-13 02:32:33,2015-03-13 02:32:33
7b31048ec4b4ce388046decb7b67259452420538...5db0628bba5707df720d5584474e6c4c734e0040,1,1,1,2,1,2015-03-13 02:38:20,2015-03-13 02:38:20
5db0628bba5707df720d5584474e6c4c734e0040...c1b2e484b22ea6bf1c821e159c2a94920e6d78d9,2,2,2,4,2,2015-03-13 03:12:49,2015-03-13 03:12:49
c1b2e484b22ea6bf1c821e159c2a94920e6d78d9...6515b412f69dcae7d17fd5bd2f8b9f352a099f4f,2,2,2,4,2,2015-03-13 03:19:46,2015-03-13 03:19:46
6515b412f69dcae7d17fd5bd2f8b9f352a099f4f...0b7e18e751872376d213f8cc4303dde9b2836e99,1,1,1,2,1,2015-03-13 03:22:39,2015-03-13 03:22:39
58cf006678c2e05383417aa2ea4064a64820fe5c...0a69d2559cb5e98993ce13fa424c57a810479547,1,189,73,262,57,2015-02-13 19:30:46,2015-02-13 19:30:20
0a69d2559cb5e98993ce13fa424c57a810479547...e7aab586c6bf1083886b098eddc4457e0bc8ce37,1,53,24,77,9,2015-02-13 20:21:25,2015-02-12 02:19:36
58cf006678c2e05383417aa2ea4064a64820fe5c...1ae4abc2d17f39f135b5e26aec6d06fb535cea31,1,23,2,25,4,2015-02-12 22:45:14,2015-01-26 20:37:56
1ae4abc2d17f39f135b5e26aec6d06fb535cea31...9389a9915cd23eb6c166b93c4441979e37ee120d,1,29,3,32,3,2015-02-12 22:45:14,2015-01-26 20:38:30
9389a9915cd23eb6c166b93c4441979e37ee120d...36d13b013b3c23a1ce6cf12676dd8c6f475937d6,2,4,4,8,4,2015-02-12 22:45:14,2015-01-26 21:46:54
36d13b013b3c23a1ce6cf12676dd8c6f475937d6...4ac08209127d7260f0711909706d06c540e67449,1,10,9,19,4,2015-02-12 22:45:14,2015-01-26 23:02:42
4ac08209127d7260f0711909706d06c540e67449...352dcfdf791e78b0016e2eadce48adc9b3bf01c5,2,47,0,47,2,2015-02-12 22:46:36,2015-01-27 01:22:34
352dcfdf791e78b0016e2eadce48adc9b3bf01c5...5f7311926e95849034475535e8b993e7c53fa337,1,16,3,19,1,2015-02-12 22:46:36,2015-01-27 01:45:12
5f7311926e95849034475535e8b993e7c53fa337...0fd90608be875bd172e2ab1aec8f2f0fa9b1dda2,5,148,33,181,15,2015-02-13 04:22:27,2015-02-13 04:22:27
0fd90608be875bd172e2ab1aec8f2f0fa9b1dda2...27fc41d53b200102e64f1b8ed9064b25692ede53,4,52,2,54,5,2015-02-13 05:28:44,2015-02-13 05:28:44
58cf006678c2e05383417aa2ea4064a64820fe5c...59c9c72450dc042d937630e3d521b66b65fdfa33,1,25,0,25,1,2015-02-12 22:10:29,2015-02-12 22:10:29
59c9c72450dc042d937630e3d521b66b65fdfa33...0af4a8ff7c0ba8da136c22ae7db02e439b170dbf,1,6,5,11,2,2015-02-24 18:55:43,2015-02-24 18:55:43
7c087f7b76720fc1047b710c093e5b42338e9226...41dc21bd6faa272c098cbd0d7a2e4b82f424b26f,5,32,17,49,16,2015-01-21 00:30:47,2015-01-21 00:30:47
7b3f03f1521e38b20af3ac1d6aad8f2523631680...bfffb986cbb909d5c190999e7e166062f9d74288,2,16,2,18,3,2014-11-26 17:24:35,2014-11-26 17:06:37
bfffb986cbb909d5c190999e7e166062f9d74288...289d92f2ec66f28c6b191d5028da24e9ef55ff72,4,64,36,100,10,2014-11-26 17:45:49,2014-11-26 17:45:49
289d92f2ec66f28c6b191d5028da24e9ef55ff72...1487d824be33b9ad45e012c23e96256e0979521d,4,101,69,170,9,2014-11-26 18:19:37,2014-11-26 18:19:37
1487d824be33b9ad45e012c23e96256e0979521d...f403b06799cb752ee0ad2190167999629a7337ee,1,1,1,2,1,2014-11-26 18:22:27,2014-11-26 18:22:27
994e06c4e58247c3f0b2d4f5a09c8107df719096...339af2a607f986a98ac3061f7600c35a4b280f2f,1,8,1,9,1,2014-10-27 19:32:20,2014-10-27 19:31:51
31ba603a997fdf07131256279cf84ace57239a86...627674e2aebe5e2c4a85b1f8203bc9a499dbe4ac,1,21,5,26,5,2014-10-20 18:41:23,2014-10-20 18:41:23
31ba603a997fdf07131256279cf84ace57239a86...f367804f1ec3ca00a41b0e638145b914d7a708a1,1,1,1,2,1,2014-10-20 18:21:29,2014-10-20 18:20:50
f367804f1ec3ca00a41b0e638145b914d7a708a1...e82286855ce4fc94eb10494d74d38f4f6806a5a4,1,6,3,9,4,2014-10-20 18:25:16,2014-10-20 18:25:16
e82286855ce4fc94eb10494d74d38f4f6806a5a4...077587e93425f7d7b3a041d7e108c430df789b16,1,4,2,6,3,2014-10-20 18:28:52,2014-10-20 18:28:19
1d82d11255983a0077b6e57d7569ef0a4abbc37d...cd2381e748554bd68da7fdf135e84468a2336594,1,1,1,2,1,2014-10-23 20:21:56,2014-10-23 20:09:38
cd2381e748554bd68da7fdf135e84468a2336594...46da3728836160faadeff9a3506f854c726eaff0,1,19,13,32,4,2014-10-23 20:35:46,2014-10-23 18:45:59
46da3728836160faadeff9a3506f854c726eaff0...14d2b4e8fe036fd02f95e7a4b43d20c29388422d,1,1,1,2,1,2014-10-23 20:35:46,2014-10-23 18:50:55
14d2b4e8fe036fd02f95e7a4b43d20c29388422d...b5f284305d23cb1456d425d8e25a4937947cfd7f,3,3,3,6,3,2014-10-23 21:06:15,2014-10-23 21:06:15
b5f284305d23cb1456d425d8e25a4937947cfd7f...9eb922e50e9414e09f11dffe35c1343668c62ea4,5,5,5,10,5,2014-10-23 21:08:25,2014-10-23 21:08:25
9eb922e50e9414e09f11dffe35c1343668c62ea4...f30f98bd364d85851cb7328437ddf3e36368e281,1,28,23,51,2,2014-10-23 21:48:28,2014-10-23 20:34:33
f30f98bd364d85851cb7328437ddf3e36368e281...5922fa0ff0cbdfb5616addd184c610967cf1b1c4,1,12,12,24,2,2014-10-23 21:48:28,2014-10-23 21:33:07
5922fa0ff0cbdfb5616addd184c610967cf1b1c4...9d0ab76b870faef527399db9b4baeab90b333e7b,1,2,1,3,2,2014-10-23 23:01:28,2014-10-23 22:51:50
9d0ab76b870faef527399db9b4baeab90b333e7b...aa82943a563177bf4fe04be3ba909b3a043597ee,28,17,1,18,3,2014-10-23 23:12:42,2014-10-22 21:15:17
aa82943a563177bf4fe04be3ba909b3a043597ee...4966e8c8426523577470471dddb9a1106080fa8b,1,2,1,3,1,2014-10-23 23:12:54,2014-10-23 08:43:49
4966e8c8426523577470471dddb9a1106080fa8b...5268acd35d0c74f3626e2a0ed9ad912961bf4981,1,7,6,13,2,2014-10-23 23:14:05,2014-10-23 20:53:53
5268acd35d0c74f3626e2a0ed9ad912961bf4981...0422d913dc974c132f747b36facec97f8ad63fd9,1,0,150,150,1,2014-10-23 23:15:18,2014-10-23 21:38:34
0422d913dc974c132f747b36facec97f8ad63fd9...711ab73daec85f750314233306901c0996067845,1,7,3,10,2,2014-10-23 23:15:45,2014-10-23 22:03:36
711ab73daec85f750314233306901c0996067845...82f996bced3e8c17f5157f6d761e7a9c5f071a48,1,1,1,2,1,2014-10-23 23:15:56,2014-10-23 22:28:28
82f996bced3e8c17f5157f6d761e7a9c5f071a48...55071b8f7322170bb853604a4112ad05bb1a9e91,1,1,0,1,1,2014-10-23 23:16:05,2014-10-23 22:36:36
55071b8f7322170bb853604a4112ad05bb1a9e91...77cc6e577a89ad26beb43ddfcbb7a57b225824b2,1,6,1,7,2,2014-10-23 23:16:14,2014-10-23 22:50:04
77cc6e577a89ad26beb43ddfcbb7a57b225824b2...a5aacef8eb9d448182380691dd2f1a2bfb53b914,1,1,1,2,1,2014-10-23 23:16:23,2014-10-23 22:53:13
a5aacef8eb9d448182380691dd2f1a2bfb53b914...feb9424bde77122ca888ba78995b3a1112f7873b,2,53,46,99,10,2014-10-23 23:25:11,2014-10-23 02:33:39
feb9424bde77122ca888ba78995b3a1112f7873b...d8ea600db518fa79593b8bc2923df108ad902b2c,1,4,7,11,2,2014-10-23 23:25:11,2014-10-23 02:48:19
d8ea600db518fa79593b8bc2923df108ad902b2c...27b328a893ddeda1ec7fc54a6925e5966d2df5af,1,2,1,3,1,2014-10-23 23:25:12,2014-10-23 03:03:41
27b328a893ddeda1ec7fc54a6925e5966d2df5af...df8ab1c453a798a37c3b9b68219897501a20fa8f,1,2,0,2,1,2014-10-23 23:25:12,2014-10-23 03:06:46
df8ab1c453a798a37c3b9b68219897501a20fa8f...7afc4552f781c182e1191ea2f84b9724f5872fcc,2,3,1,4,2,2014-10-23 23:25:12,2014-10-23 03:16:12
7afc4552f781c182e1191ea2f84b9724f5872fcc...9e03667a333fb3b10c4be379968e2def1de94d31,1,16,13,29,6,2014-10-23 23:25:28,2014-10-23 20:25:03
9e03667a333fb3b10c4be379968e2def1de94d31...b45ce4831724bc2fce9c6df8338e8d1651354c91,1,22,6,28,7,2014-10-23 23:25:33,2014-10-23 20:39:16
b45ce4831724bc2fce9c6df8338e8d1651354c91...74b0e27d4db095e9af36f66db743db063850f244,1,1,1,2,1,2014-10-23 23:25:40,2014-10-23 21:10:33
74b0e27d4db095e9af36f66db743db063850f244...7f1ff749b1bc5b6273d5317fdf02021749a40c5f,1,20,0,20,1,2014-10-23 23:26:14,2014-10-23 21:05:57
7f1ff749b1bc5b6273d5317fdf02021749a40c5f...9e4bf55fa304303fec3130d1c10a45a8a74a2dd5,1,4,4,8,4,2014-10-23 23:42:20,2014-10-23 23:42:20
9e4bf55fa304303fec3130d1c10a45a8a74a2dd5...7d9704c91a53dd967c137b4b1dddceda78b678ce,1,1,1,2,1,2014-10-23 23:50:54,2014-10-23 23:50:54
7d9704c91a53dd967c137b4b1dddceda78b678ce...0d4c0e38bf2304f9f4bd69f9e8a9e09b9bd3b200,1,1,1,2,1,2014-10-23 23:55:37,2014-10-23 23:55:37
0d4c0e38bf2304f9f4bd69f9e8a9e09b9bd3b200...54989c85bf1c9bfd8d065633c69b026332f4be9f,6,6,6,12,6,2014-10-23 23:59:11,2014-10-23 23:59:11
54989c85bf1c9bfd8d065633c69b026332f4be9f...f3f08f2c0b1ec7ad99e155834bdac683da841fc1,1,1,1,2,1,2014-10-24 00:24:05,2014-10-23 05:18:49
f3f08f2c0b1ec7ad99e155834bdac683da841fc1...efea9a38b1fd5adda3f21370b0c24fbd5678c8f4,1,26,0,26,1,2014-10-24 00:41:34,2014-10-24 00:41:34
efea9a38b1fd5adda3f21370b0c24fbd5678c8f4...2e1bbef32afe618456c8b09bd9b425dc1c2ead22,1,1,1,2,1,2014-10-24 02:43:20,2014-10-24 02:43:20
2e1bbef32afe618456c8b09bd9b425dc1c2ead22...825759825dbb4b3948ab00c939bb08a435f113a8,1,1,3,4,2,2014-10-24 17:24:06,2014-10-24 06:18:13
825759825dbb4b3948ab00c939bb08a435f113a8...157119445694f9c189e3750dd8f04016b40e8cf6,1,2,1,3,1,2014-10-24 17:31:01,2014-10-24 02:38:18
157119445694f9c189e3750dd8f04016b40e8cf6...81c0cc6ef100ab52fffffffa11a2c517c294beb4,1,9,10,19,1,2014-10-24 17:39:55,2014-10-23 23:48:20
81c0cc6ef100ab52fffffffa11a2c517c294beb4...3a2ae581236f64f9f07c8348c538866cf42bb5d9,2,3,7,10,3,2014-10-24 19:31:58,2014-10-24 18:31:23
3a2ae581236f64f9f07c8348c538866cf42bb5d9...b4f1fd9770bcb8cd76b15362aee48688727fe19a,1,1,1,2,1,2014-10-24 19:32:07,2014-10-24 17:22:54
b4f1fd9770bcb8cd76b15362aee48688727fe19a...f1ab1c299546c3bd3dcc2cdced346a82ce3d54a3,1,1,1,2,1,2014-10-24 19:32:13,2014-10-24 19:09:42
f1ab1c299546c3bd3dcc2cdced346a82ce3d54a3...7154c9dc16a463bce510adf58c332b35b2a512a4,1,12,0,12,1,2014-10-24 19:32:27,2014-10-24 18:51:45
7154c9dc16a463bce510adf58c332b35b2a512a4...af875523b4e2c7f77d0786c4838384da58cb8af0,1,3,4,7,2,2014-10-24 19:32:31,2014-10-24 19:07:21
af875523b4e2c7f77d0786c4838384da58cb8af0...7e656cb82075a0a7b9e3b6df2f5cbca659341368,1,1,1,2,1,2014-10-24 19:32:38,2014-10-24 19:06:15
7e656cb82075a0a7b9e3b6df2f5cbca659341368...7fc2d3465e18a051e8f8650532a1daa5e82f9424,1,6,1,7,1,2014-10-24 21:06:49,2014-10-24 20:21:18
7fc2d3465e18a051e8f8650532a1daa5e82f9424...7c8346224201540801db5e19f3cd23bd6ab2f32a,1,51,0,51,5,2014-10-24 21:08:36,2014-10-24 20:19:36
7c8346224201540801db5e19f3cd23bd6ab2f32a...ceba2e2498055e4d90274bc1889b7686c4d108a4,1,20,20,40,2,2014-10-24 21:10:08,2014-10-24 20:28:22
ceba2e2498055e4d90274bc1889b7686c4d108a4...3b4945bd4a2baeb7523c5ee102bd7c0c8e923052,7,26,16,42,16,2014-10-24 21:13:16,2014-10-24 02:48:04
3b4945bd4a2baeb7523c5ee102bd7c0c8e923052...81cb2169dd01ba4f605b6b6c893d809f460aa64f,1,1,1,2,1,2014-10-24 21:13:21,2014-10-24 02:54:53
81cb2169dd01ba4f605b6b6c893d809f460aa64f...864899f82d704052f85d39812ffb8a3b74f9c340,2,10,7,17,4,2014-10-24 21:13:26,2014-10-24 21:01:21
864899f82d704052f85d39812ffb8a3b74f9c340...3574910cb75b2d0f0b576762d128d540029e82c8,1,1,1,2,1,2014-10-24 21:39:16,2014-10-24 21:38:11
3574910cb75b2d0f0b576762d128d540029e82c8...036d10e0ad4b5510236456004a4daa0a15f342e9,1,1,1,2,1,2014-10-24 21:39:54,2014-10-24 21:39:54
036d10e0ad4b5510236456004a4daa0a15f342e9...fa3243bdd666a987cf18770fba85dde60d0f575c,3,3,3,6,3,2014-10-24 21:45:14,2014-10-24 21:45:14
fa3243bdd666a987cf18770fba85dde60d0f575c...1cbf4b32cacb8a5b26c1e6f4b0f748249f61de03,1,5,8,13,5,2014-10-24 23:33:58,2014-10-24 22:43:50
1cbf4b32cacb8a5b26c1e6f4b0f748249f61de03...91b4c5fc14bdec4e9474217592d7bded6604de04,1,1,1,2,1,2014-10-24 23:34:11,2014-10-24 22:14:50
91b4c5fc14bdec4e9474217592d7bded6604de04...98131a6db7c8150f9c5f3c15de38059bd081900b,1,23,2,25,2,2014-10-24 23:34:27,2014-10-24 23:13:06
98131a6db7c8150f9c5f3c15de38059bd081900b...e79f95e3ca8f2bf7813f61b023511025e900a5d9,5,5,5,10,5,2014-10-24 23:39:56,2014-10-24 23:39:56
e79f95e3ca8f2bf7813f61b023511025e900a5d9...ca4cac9d4796ae96bd116c36ca0624c0b61bb2c1,2,2,1,3,2,2014-10-28 00:01:35,2014-10-25 22:15:37
ca4cac9d4796ae96bd116c36ca0624c0b61bb2c1...068901ebb12c3c943e0c447eaaec29a9c69fa1eb,1,12,13,25,2,2014-10-28 00:02:30,2014-10-25 22:54:16
068901ebb12c3c943e0c447eaaec29a9c69fa1eb...f7638b6d51cf7406eee4300d200f2e76b387bdd2,1,1,1,2,1,2014-10-28 00:02:39,2014-10-25 23:57:35
f7638b6d51cf7406eee4300d200f2e76b387bdd2...470fe307e529b0f761a4e54156c33f8d0eed03b3,1,2,5,7,3,2014-10-28 00:03:22,2014-10-27 16:24:35
470fe307e529b0f761a4e54156c33f8d0eed03b3...f4ee4d2ba4135bca8a6ef41826d5b3731ff5e660,1,1,1,2,1,2014-10-28 00:06:06,2014-10-27 19:03:23
f4ee4d2ba4135bca8a6ef41826d5b3731ff5e660...3d2c0516ab409677c80c4c0d4b5092707578b2e5,4,60,5,65,5,2014-10-28 00:12:41,2014-10-27 18:23:57
3d2c0516ab409677c80c4c0d4b5092707578b2e5...a49179a14c186b1555773259fccb5924a0c56d49,1,11,5,16,4,2014-10-28 02:32:09,2014-10-28 00:37:19
a49179a14c186b1555773259fccb5924a0c56d49...5b5e8b8cd7b0becfe77f1788182028b863201027,1,3,1,4,1,2014-10-28 02:32:09,2014-10-28 02:26:34
5b5e8b8cd7b0becfe77f1788182028b863201027...78e45a77a15c73e6b020066afb71bbca811e1768,1,5,1,6,1,2014-10-28 02:34:08,2014-10-28 01:03:25
78e45a77a15c73e6b020066afb71bbca811e1768...7f80b1b7907680e38b1a8fa26c7c1fcf5ea2750b,1,18,7,25,5,2014-10-28 02:35:02,2014-10-28 01:35:26
7f80b1b7907680e38b1a8fa26c7c1fcf5ea2750b...48d57c4c9c692f92760bf8dca7a839cd40c99888,3,33,4,37,5,2014-10-28 02:35:12,2014-10-28 01:00:16
48d57c4c9c692f92760bf8dca7a839cd40c99888...d9f331176c5474f36233bfd02fe22b38389c2879,1,1,1,2,1,2014-10-28 02:40:08,2014-10-28 02:40:08
d9f331176c5474f36233bfd02fe22b38389c2879...6c8c67afe83e45be418055a3e2cd14d9ed437964,8,8,8,16,8,2014-10-28 03:03:42,2014-10-28 03:03:42
c70ff63a2fce1a6d66ae6774a8ce62e7d9aa327a...c96ea78794f707f21c6d463de738292cae272545,1,1,1,2,1,2015-03-06 01:12:20,2015-03-03 23:55:03
c96ea78794f707f21c6d463de738292cae272545...81d76fe9d0b5e04ca7fb53f2fb4b1ec8bccf5dfe,3,27,21,48,21,2015-03-06 01:12:35,2015-03-03 23:55:56
81d76fe9d0b5e04ca7fb53f2fb4b1ec8bccf5dfe...fa74e51102c2111f1fe05b05cb232d6d47bb80ff,3,18,0,18,4,2015-03-06 01:12:36,2015-03-04 00:04:28
fa74e51102c2111f1fe05b05cb232d6d47bb80ff...08c5bd0f83a35d083a832180a099eb94e2ab900a,9,9,145,154,10,2015-03-06 01:12:36,2015-03-04 00:10:28
08c5bd0f83a35d083a832180a099eb94e2ab900a...8dae78d48b80d7dab9154d912102a9ebb0a28f60,3,40,10,50,10,2015-03-06 01:12:36,2015-03-04 23:58:24
8dae78d48b80d7dab9154d912102a9ebb0a28f60...1002349edb890aefc8c978b8e849dc17e709904a,3,19,6,25,4,2015-03-06 01:12:36,2015-03-05 00:13:24
1002349edb890aefc8c978b8e849dc17e709904a...cfc1699b0c91b6d41bda5664b03c62843e4aa29e,2,23,1,24,3,2015-03-06 01:12:36,2015-03-05 00:19:09
cfc1699b0c91b6d41bda5664b03c62843e4aa29e...63a0076305b0f204d8acbd322bebd4ded9f2596d,6,41,20,61,17,2015-03-06 01:12:37,2015-03-05 00:57:40
63a0076305b0f204d8acbd322bebd4ded9f2596d...166840f8be41671fdbcb53e1c68604d25e7c17e6,1,25,30,55,8,2015-03-06 01:12:37,2015-03-05 01:58:07
166840f8be41671fdbcb53e1c68604d25e7c17e6...c4d9ba573c6a98c62451dde3f0cde98920d22ed2,1,1,0,1,1,2015-03-06 01:12:37,2015-03-05 02:03:42
c4d9ba573c6a98c62451dde3f0cde98920d22ed2...ef9671e705f10ceb80a854c72053b00d4057840f,3,49,1,50,3,2015-03-06 01:12:37,2015-03-05 02:11:50
ef9671e705f10ceb80a854c72053b00d4057840f...dc4a5e4bdec4d10728851aece2dba261c397c68f,1,11,0,11,1,2015-03-06 01:12:38,2015-03-05 02:14:17
5d482fa93016e6d397ae701441e1cfe63a22596e...6dede19a6000164a56b623bbc1a07fe7741c4eb9,2,17,0,17,2,2015-03-13 05:46:58,2015-03-13 05:46:40
6dede19a6000164a56b623bbc1a07fe7741c4eb9...171e10a87fa33e13db6af814d39b94a5237c3a9e,1,3,2,5,2,2015-03-13 05:59:28,2015-03-13 05:59:28
171e10a87fa33e13db6af814d39b94a5237c3a9e...9f15f41482a9b4999f60caeb750b2e53cd80d184,3,84,53,137,26,2015-03-13 13:37:06,2015-03-13 05:32:03
9f15f41482a9b4999f60caeb750b2e53cd80d184...1b85b8205e784f572b5402f07cfd311b4fb41a4b,5,365,295,660,65,2015-03-13 17:47:52,2015-03-13 17:47:52
1b85b8205e784f572b5402f07cfd311b4fb41a4b...6261fc2de7718f79b3f8f226cffe59f3e7267c8c,1,2,1,3,1,2015-03-13 18:28:48,2015-03-13 18:28:48
6261fc2de7718f79b3f8f226cffe59f3e7267c8c...0e0e8a39f11da87e460a1935d03d703b07ac3070,1,6,0,6,1,2015-03-14 19:32:54,2015-03-14 19:32:54
5ebc50600e08eff2e3271e33f029b95b8963758d...01b938cb6095ae9594b55d211c50da3ce78bb5fb,3,3,3,6,3,2015-03-13 04:38:26,2015-03-13 04:37:49
01b938cb6095ae9594b55d211c50da3ce78bb5fb...089ba7af63bc6230622e74143f693151571f0127,1,1,1,2,1,2015-03-13 04:43:39,2015-03-13 04:43:39
e7aab586c6bf1083886b098eddc4457e0bc8ce37...e9cf432b1df081fbfd75899081dcd10961519d04,10,13,13,26,11,2015-02-16 23:08:48,2015-02-16 23:08:48
e9cf432b1df081fbfd75899081dcd10961519d04...64494f8f4c9b0d060b5e44fbf4d5567d4883fde4,4,4,4,8,4,2015-02-16 23:23:31,2015-02-16 23:23:31
64494f8f4c9b0d060b5e44fbf4d5567d4883fde4...645e2a88c871e8fb141cabe6beabce3886bd45ff,2,2,2,4,2,2015-02-16 23:25:05,2015-02-16 23:23:49
645e2a88c871e8fb141cabe6beabce3886bd45ff...1459a9de03022869a1d9d99a246b5fe40c29526d,3,3,3,6,3,2015-02-16 23:42:45,2015-02-16 23:39:42
1459a9de03022869a1d9d99a246b5fe40c29526d...797a4140d479ad6f8c0bc996154403890a712ef8,107,108,107,215,107,2015-02-17 00:05:26,2015-02-16 23:55:39
797a4140d479ad6f8c0bc996154403890a712ef8...51f20d7339e243c8d8fe297f72162f2281c4f78d,3,3,3,6,3,2015-02-17 00:20:21,2015-02-17 00:18:23
51f20d7339e243c8d8fe297f72162f2281c4f78d...f0acc15db2238e5211ee67a9d2b0304629f1f8f3,115,115,115,230,115,2015-02-17 00:32:29,2015-02-17 00:32:29
f0acc15db2238e5211ee67a9d2b0304629f1f8f3...905aba68de50198a16927346dbddbc800f3497e2,116,116,116,232,116,2015-02-17 00:47:50,2015-02-17 00:47:50
905aba68de50198a16927346dbddbc800f3497e2...302819faa26de489f3b19a03d0ce7318c75d947a,117,117,117,234,117,2015-02-17 01:01:21,2015-02-17 01:01:21
302819faa26de489f3b19a03d0ce7318c75d947a...51119c2f71f2196e6beb29e912c9be1b125b4843,3,3,3,6,3,2015-02-19 18:42:50,2015-02-19 18:42:50
51119c2f71f2196e6beb29e912c9be1b125b4843...053c30056eec541c4339e9860e168e65a807bb6c,1,4,0,4,1,2015-02-19 18:55:11,2015-02-19 18:42:08
053c30056eec541c4339e9860e168e65a807bb6c...809effe7b0cd991884df8d60a7bf0e5e23a5bd71,3,3,3,6,3,2015-02-19 18:55:39,2015-02-19 18:55:39
e7aab586c6bf1083886b098eddc4457e0bc8ce37...04151aadaab1280d2bcacc9e8460108de0cf6828,1,2,2,4,2,2015-02-14 04:27:22,2015-02-14 04:27:22
04151aadaab1280d2bcacc9e8460108de0cf6828...d8634e0264bcf6e551c23d13956d2dc9dc57b7c7,3,6,8,14,8,2015-02-14 04:27:33,2015-02-14 04:27:33
d8634e0264bcf6e551c23d13956d2dc9dc57b7c7...61893dacf0c6020af8771c082eea68f6f0ce6ead,1,3,3,6,3,2015-02-14 04:35:40,2015-02-14 04:34:11
61893dacf0c6020af8771c082eea68f6f0ce6ead...a29f74874a756bc7eec556268383cfc4e7a72a50,1,2,0,2,1,2015-02-14 04:35:43,2015-02-14 04:34:17
a29f74874a756bc7eec556268383cfc4e7a72a50...68ba975d4578326351f05e4a8d2863392c3bc3f6,1,5,5,10,5,2015-02-14 04:36:45,2015-02-14 04:36:45
68ba975d4578326351f05e4a8d2863392c3bc3f6...eb4845439a13092d4096466d3699a08a31963b3f,1,0,3,3,2,2015-02-14 04:39:08,2015-02-14 04:39:08
27fc41d53b200102e64f1b8ed9064b25692ede53...9518c0b1424bd8a4d4a1e1bdfdcd2c7d13fbe6be,1,189,73,262,57,2015-02-13 19:30:20,2015-02-13 19:30:20
9518c0b1424bd8a4d4a1e1bdfdcd2c7d13fbe6be...c10e73299f8c69ec408d4b629c5829933c79d8f4,1,11,0,11,1,2015-02-13 22:59:42,2015-02-13 22:59:42
27fc41d53b200102e64f1b8ed9064b25692ede53...0c3b2cf1c543c0b92f88cb125b7e30f1c4f12075,2,19,1,20,6,2015-02-13 07:23:28,2015-02-13 07:23:28
47902dcac92c2a59fc18d0f5845629318f927748...4403a5bf7e817adc02cfbc56947b0c8a14b41b1d,2,2,12,14,2,2014-11-26 18:52:50,2014-11-26 18:47:26
339af2a607f986a98ac3061f7600c35a4b280f2f...9a60c8eede7b72e2d8ea0aded0d6872db4912005,2,4,2,6,3,2014-10-27 20:22:44,2014-10-27 20:22:44
9a60c8eede7b72e2d8ea0aded0d6872db4912005...03c603595e2a395854bc89cfbf62946dad504d35,1,1,2,3,2,2014-10-27 20:42:02,2014-10-27 20:42:02
03c603595e2a395854bc89cfbf62946dad504d35...02d16f9ab7b86aca2e7ed85381955c2e1195129f,3,18,12,30,6,2014-10-27 21:00:47,2014-10-27 21:00:47
339af2a607f986a98ac3061f7600c35a4b280f2f...95d81f682d28d0fa3a370820822a7d6723cac285,4,94,69,163,34,2014-10-27 20:03:47,2014-10-27 20:03:31
b3b54db3040f75d5e927bb839421de482f8f2285...830acf651c2cd71eacbaf8a1d5ad30d6911adddd,6,422,3,425,15,2014-10-20 18:44:09,2014-10-13 21:24:10
830acf651c2cd71eacbaf8a1d5ad30d6911adddd...f757ed925875348932e8528a96401d4290b96b55,1,10,0,10,2,2014-10-20 18:50:11,2014-10-20 18:44:32
f757ed925875348932e8528a96401d4290b96b55...6729b847e260f59d7c91246768529ec0f78b264c,58,24,24,48,4,2014-10-20 19:00:47,2014-10-20 19:00:30
6729b847e260f59d7c91246768529ec0f78b264c...8bd95ffe36b2a6fcf9d722efa5157dda5e219b4d,1,2,2,4,2,2014-10-20 19:02:29,2014-10-20 19:02:29
8bd95ffe36b2a6fcf9d722efa5157dda5e219b4d...17138b08054ba418cb4b99f8c01425970cdc714d,1,2,2,4,2,2014-10-20 19:05:44,2014-10-20 19:02:54
1e8ce2817039d9b19caaf1de30e6f96478b2b962...0fa886831453834f79e0af2581eb3c99b73758a5,1,4,0,4,2,2014-10-28 07:13:57,2014-10-28 07:13:57
0fa886831453834f79e0af2581eb3c99b73758a5...59f0a902f90d2660800aca9028fbc64d1b4076ed,1,37,23,60,9,2014-10-28 07:18:52,2014-10-28 07:18:52
59f0a902f90d2660800aca9028fbc64d1b4076ed...5267c5662271a6fc0d35041cce7d3184e4564a35,1,2,0,2,1,2014-10-28 07:38:13,2014-10-28 07:38:13
5267c5662271a6fc0d35041cce7d3184e4564a35...55825744045269f424de4fb9b3622189d02b1d6f,1,2,12,14,3,2014-10-28 07:56:06,2014-10-28 04:11:01
55825744045269f424de4fb9b3622189d02b1d6f...d783b40611dc298d61c5339be56bd562de1155c5,1,1,1,2,1,2014-10-28 07:56:17,2014-10-28 04:23:36
d783b40611dc298d61c5339be56bd562de1155c5...da2e72c35a1a92dde46bbd90a84b0125c73fc8d6,1,1,1,2,1,2014-10-28 07:56:32,2014-10-28 04:35:49
da2e72c35a1a92dde46bbd90a84b0125c73fc8d6...46f71f187dda51a02ab431b4b0e0d9c0d41e0033,233,5538,0,5538,93,2014-10-28 07:56:42,2014-10-28 04:55:09
46f71f187dda51a02ab431b4b0e0d9c0d41e0033...3a50054e202c313b0b7e657a84c54a9d634d17e6,1,3,0,3,1,2014-10-28 07:56:49,2014-10-28 04:57:32
3a50054e202c313b0b7e657a84c54a9d634d17e6...a1d7dba59951f13f1a82f51811bf811b40e44d73,27,0,0,0,0,2014-10-28 07:57:06,2014-10-28 05:00:26
a1d7dba59951f13f1a82f51811bf811b40e44d73...924a92fc4ea326b6728360f94560537d4c02368f,2,27,0,27,3,2014-10-28 07:58:06,2014-10-28 06:36:17
924a92fc4ea326b6728360f94560537d4c02368f...e50bd0d8c1ac40b30bb5408483e59ebf9f6580b9,1,13,0,13,3,2014-10-28 07:58:15,2014-10-28 07:08:05
e50bd0d8c1ac40b30bb5408483e59ebf9f6580b9...889c915aff7e5b5b43a355e60e6a4e0c8364c4c1,1,1,1,2,1,2014-10-28 07:59:00,2014-10-28 07:59:00
889c915aff7e5b5b43a355e60e6a4e0c8364c4c1...842bfac8df78d7a3ea0b9caec5ce76497a48afb8,4,4,4,8,4,2014-10-28 08:03:08,2014-10-28 08:03:08
842bfac8df78d7a3ea0b9caec5ce76497a48afb8...18851b51bc6d378d6aed7496cee1862f38d0e588,1,4,0,4,1,2014-10-28 08:56:55,2014-10-28 08:54:58
40ec4760f049b3a312b6b228aa4bf08f91f241aa...759510a5840346cad7eceddc9dc0008b3372170f,1,1,1,2,1,2015-03-06 01:30:20,2015-03-06 01:29:33
0e0e8a39f11da87e460a1935d03d703b07ac3070...269f32fec6a0fbf21917da71cb2a89bb8933c219,1,5,1,6,1,2015-03-16 23:18:02,2015-03-16 23:18:02
0e0e8a39f11da87e460a1935d03d703b07ac3070...55b8441df9914619f35f794d502f0c8f121d4763,1,6,6,12,5,2015-03-16 23:16:04,2015-03-16 23:16:04
439daae7468e14552dcfbd8177a5e952c5e6eb06...02b959363f74469139c913c1c39a3c3542a408f1,1,2,1,3,1,2015-03-13 18:32:12,2015-03-13 18:28:48
02b959363f74469139c913c1c39a3c3542a408f1...b415ecea8ddf5e37d38511452f4263269ffa468f,1,6,0,6,1,2015-03-13 18:42:34,2015-03-13 18:42:34
b415ecea8ddf5e37d38511452f4263269ffa468f...047e66efd265ac0a9feef0c7425217486013b7d2,2,17,0,17,2,2015-03-13 20:27:54,2015-03-13 05:46:40
047e66efd265ac0a9feef0c7425217486013b7d2...bfd273318028e8daaf935d128722a3f1a09dd172,1,3,2,5,2,2015-03-13 20:27:54,2015-03-13 05:59:28
bfd273318028e8daaf935d128722a3f1a09dd172...a9dcb3a9ef3c87be0359a76f59440409154bfb9d,1,1,1,2,1,2015-03-13 20:43:24,2015-03-13 20:42:33
a9dcb3a9ef3c87be0359a76f59440409154bfb9d...b24df9ddb825535f86fdb378c866e2bde60e0fc3,2,19,1,20,6,2015-03-13 21:04:01,2015-03-13 20:50:35
b24df9ddb825535f86fdb378c866e2bde60e0fc3...d4b0605a40fedce72ea7fb652ea6da372767cae8,1,3,2,5,1,2015-03-13 21:06:09,2015-03-13 21:06:09
d4b0605a40fedce72ea7fb652ea6da372767cae8...ea802cb3eb4eac984149ce74b23225a145bbf0fd,3,3,3,6,3,2015-03-13 21:11:39,2015-03-13 21:06:44
2305190c938bf3171177c711a1a31c56b4e502e4...26df98a8b04c6047b367c06bb8f69721ead58c4a,3,16,10,26,13,2015-02-13 23:22:02,2015-02-13 23:22:02
26df98a8b04c6047b367c06bb8f69721ead58c4a...50300ee8ca41375bc279972b7a47b2d0e9e544d4,1,4,4,8,4,2015-02-13 23:23:58,2015-02-13 23:23:47
50300ee8ca41375bc279972b7a47b2d0e9e544d4...b425f1c5bb68fc0064a7310018c0c509d9cc0fd1,1,3,0,3,1,2015-02-14 00:59:07,2015-02-14 00:59:07
b425f1c5bb68fc0064a7310018c0c509d9cc0fd1...ddb620ebe0db1564d43a516bc87791e69118cc36,1,15,0,15,1,2015-02-14 01:12:14,2015-02-14 01:12:14
ddb620ebe0db1564d43a516bc87791e69118cc36...9763a81effb980b9f5aa037cc5dec70fcdc35d49,2,42,0,42,2,2015-02-14 01:34:54,2015-02-14 01:34:54
9763a81effb980b9f5aa037cc5dec70fcdc35d49...c4ffbc6c7f546a982691a9abefd393962a6667df,1,2,1,3,1,2015-02-14 21:38:25,2015-02-14 21:38:25
c4ffbc6c7f546a982691a9abefd393962a6667df...1e2683ce1d4988f124d5f8814b0af155482f994a,11,13,13,26,12,2015-03-01 20:57:33,2015-03-01 20:39:33
4403a5bf7e817adc02cfbc56947b0c8a14b41b1d...187b0e00f2d4645781ea3f0e8de110780ba500c7,1,2,0,2,1,2014-11-26 19:23:18,2014-11-26 19:23:18
187b0e00f2d4645781ea3f0e8de110780ba500c7...c65b588dcde0e0b8db3fec74edd3dcb90184decc,1,1,1,2,1,2014-11-26 19:45:41,2014-11-26 19:45:41
c65b588dcde0e0b8db3fec74edd3dcb90184decc...2407adbecc1379cf63aebc6499738d0ee4c611a0,1,63,0,63,1,2014-11-26 20:48:46,2014-11-26 20:48:46
2407adbecc1379cf63aebc6499738d0ee4c611a0...0713b7c8d8bb41867c00f57eb5794da2eb314ec1,1,203,63,266,14,2014-11-26 20:48:53,2014-11-26 20:48:53
0713b7c8d8bb41867c00f57eb5794da2eb314ec1...de9536172e4f73fd1c4b0d2b21e907a8d693577c,5,144,71,215,31,2014-12-01 09:26:34,2014-12-01 03:45:42
de9536172e4f73fd1c4b0d2b21e907a8d693577c...7d4757b3ac71a178de55a918b052c63e945df9b2,13,236,177,413,47,2014-12-01 09:26:35,2014-12-01 05:18:07
7d4757b3ac71a178de55a918b052c63e945df9b2...fe40ee08e4a60b8ee0b3e0e0ee9a87fdfb523e55,2,40,79,119,7,2014-12-01 09:26:35,2014-12-01 05:50:03
fe40ee08e4a60b8ee0b3e0e0ee9a87fdfb523e55...03b3f941a38e9bb4c8572879849393d45672f940,1,44,11,55,4,2014-12-01 09:41:12,2014-12-01 06:06:21
03b3f941a38e9bb4c8572879849393d45672f940...b4a7f4018ed87d0a00d57d42e1df97db663a3624,1,0,20,20,1,2014-12-01 09:41:12,2014-12-01 06:08:18
b4a7f4018ed87d0a00d57d42e1df97db663a3624...44454ce480e10fdc932d923ab7d392378b80974f,12,0,377,377,11,2014-12-01 09:41:12,2014-12-01 06:10:42
44454ce480e10fdc932d923ab7d392378b80974f...ff3e4439d41569873607a44ae7a129e4dda7a05e,6,22,28,50,22,2014-12-01 09:41:13,2014-12-01 06:47:11
ff3e4439d41569873607a44ae7a129e4dda7a05e...d75aba324cf17fa7839e669dcc5d2401a42c0097,3,49,42,91,15,2014-12-01 09:41:13,2014-12-01 07:22:46
d75aba324cf17fa7839e669dcc5d2401a42c0097...bf00def694b35b7b38da2911c477270d1e09454d,6,47,39,86,21,2014-12-01 09:41:14,2014-12-01 07:43:22
bf00def694b35b7b38da2911c477270d1e09454d...e956a3b237720dec14474cfa38d2f7a02294d337,1,0,4,4,1,2014-12-01 09:41:27,2014-12-01 09:41:27
e956a3b237720dec14474cfa38d2f7a02294d337...dc97864e1638328b5fe01ad1e6ed0014793dd255,2,9,8,17,9,2014-12-01 18:29:33,2014-12-01 18:29:33
dc97864e1638328b5fe01ad1e6ed0014793dd255...c49a441d3d199a46db475bfb8c226a426bec3217,7,48,13,61,14,2014-12-01 22:43:15,2014-12-01 20:36:09
c49a441d3d199a46db475bfb8c226a426bec3217...04a65c19e419f9cea70724976afdf62b1c0afc1d,1,1,1,2,1,2014-12-02 01:00:06,2014-12-02 01:00:06
04a65c19e419f9cea70724976afdf62b1c0afc1d...06fbe35d461581638335e1c0e710bb046b1f8ee8,3,17,3,20,5,2014-12-02 01:42:13,2014-12-02 01:42:13
06fbe35d461581638335e1c0e710bb046b1f8ee8...ab3d6c5bfbcc1468e825ea4b387f576e2eee5667,6,21,15,36,10,2014-12-02 02:29:20,2014-12-02 02:29:20
ab3d6c5bfbcc1468e825ea4b387f576e2eee5667...050a01dcf24f60210092776fcc7c6eb5b99d84bb,2,5,3,8,3,2014-12-02 02:38:39,2014-12-02 02:38:39
050a01dcf24f60210092776fcc7c6eb5b99d84bb...701bf7872e40cf3755d5711eab43f056dbfb8176,1,0,1,1,1,2014-12-02 02:39:40,2014-12-02 02:39:40
701bf7872e40cf3755d5711eab43f056dbfb8176...3c1c568530d785c9ac06e564ea52eb8ce3da2afd,1,16,4,20,4,2014-12-02 03:03:10,2014-12-02 03:03:10
3c1c568530d785c9ac06e564ea52eb8ce3da2afd...2f90467da053e5885bf67efd514e557cf879e1f2,6,66,45,111,15,2014-12-02 03:20:28,2014-12-02 03:15:51
2f90467da053e5885bf67efd514e557cf879e1f2...a937aa606d777468e1ed6fea600b66914269c6c8,3,65,25,90,17,2014-12-02 03:48:06,2014-12-02 03:48:06
a937aa606d777468e1ed6fea600b66914269c6c8...ff7863d3e210b2fafb1b074c1f043383fc9c65e6,3,60,23,83,13,2014-12-02 23:21:36,2014-12-02 06:07:18
ff7863d3e210b2fafb1b074c1f043383fc9c65e6...14cdfa0e024e7e8cceb87e50b166277a7d4cfb83,2,28,40,68,9,2014-12-03 20:28:45,2014-12-03 20:28:45
14cdfa0e024e7e8cceb87e50b166277a7d4cfb83...021e9f767d35a6cf08bef8d95dc4e01ff7dd4480,4,30,7,37,12,2014-12-03 20:38:20,2014-12-03 20:37:01
4403a5bf7e817adc02cfbc56947b0c8a14b41b1d...c7d06b86c18c392af72113a8c5dd4ee9ad18f53e,3,2,4,6,3,2014-11-26 19:00:36,2014-11-26 19:00:36
a7e58cd1cbbe2ed5cd767bb259c3badf6ea0a00b...5ed24104ce8e675cff0a85a167a44da35e5e472c,2,45,20,65,3,2014-10-27 21:24:01,2014-10-27 21:24:01
5ed24104ce8e675cff0a85a167a44da35e5e472c...cae75404e5e306e3ed923dd9a55dd7518807f3af,2,7,7,14,6,2014-10-27 22:01:42,2014-10-27 22:01:42
cae75404e5e306e3ed923dd9a55dd7518807f3af...be1d5b0eae87a69cdcb361149b8a8b030afece24,3,44,1,45,3,2014-10-27 22:03:19,2014-10-27 05:55:23
be1d5b0eae87a69cdcb361149b8a8b030afece24...f8f5651f21a221ea6bb08573cb49bcef8b17af76,1,1,1,2,1,2014-10-27 22:10:46,2014-10-27 22:10:46
f8f5651f21a221ea6bb08573cb49bcef8b17af76...eeb62b782042926a53b427a04217e630bc7d2d10,2,69,40,109,2,2014-10-27 23:58:00,2014-10-27 23:55:16
eeb62b782042926a53b427a04217e630bc7d2d10...36d18f556bdd2d2c9e1c1b24d7c5e7c44adacaad,3,11,16,27,12,2014-10-28 00:15:32,2014-10-28 00:15:32
17138b08054ba418cb4b99f8c01425970cdc714d...453070bfdec4f8eeeaf54b34fd633949d7d5842b,1,18,6,24,7,2014-10-20 19:48:32,2014-10-20 19:43:47
453070bfdec4f8eeeaf54b34fd633949d7d5842b...2926fdafabd9fde832f9d3f3a77c7653a6f501ee,1,1,1,2,1,2014-10-20 19:49:34,2014-10-20 19:49:34
2926fdafabd9fde832f9d3f3a77c7653a6f501ee...42de8d455287264eaa3a4094094db85c1c5917a5,2,30,1,31,14,2014-10-20 20:50:40,2014-10-18 17:57:49
42de8d455287264eaa3a4094094db85c1c5917a5...f14d986074ce5e714302409418fc971c1ef302af,1,3,4,7,3,2014-10-20 21:48:23,2014-10-20 21:48:23
f14d986074ce5e714302409418fc971c1ef302af...bc68dfccb310ffe0a3f9ffa5910e6eab31b8a05c,1,24,21,45,3,2014-10-20 21:57:56,2014-10-20 21:57:56
bc68dfccb310ffe0a3f9ffa5910e6eab31b8a05c...e22702be4557df2539c646bd010484bdac747db7,5,25,22,47,16,2014-10-20 22:04:12,2014-10-20 21:59:31
e22702be4557df2539c646bd010484bdac747db7...85eebd807df01e23bfc532ca87a1591380bdbb3b,1,13,4,17,2,2014-10-20 22:14:41,2014-10-20 22:14:12
85eebd807df01e23bfc532ca87a1591380bdbb3b...32f3aeca09208d99d8bd658d9a8d9c4b007a31cb,1,7,7,14,7,2014-10-20 22:15:47,2014-10-20 22:15:25
32f3aeca09208d99d8bd658d9a8d9c4b007a31cb...b8478e859042a8aba311e69f9892ce2ca3e23835,1,3,1,4,2,2014-10-20 22:31:51,2014-10-20 22:31:51
17138b08054ba418cb4b99f8c01425970cdc714d...fd130fea0dfe2ab0c7dbb9fe0fd6ab0776125d25,1,5,0,5,1,2014-10-20 19:24:16,2014-10-20 19:24:16
fd130fea0dfe2ab0c7dbb9fe0fd6ab0776125d25...0b1040491eecd14fe5a9eab19a5db26fdb4e7c0d,2,8,3,11,6,2014-10-20 21:23:35,2014-10-20 21:23:35
7e2ee40d6d5c0f2e32d99c5af1056ba88e8233dc...5bb20e7875e3f68383aa339e4311dc1cd162b529,1,4,4,8,3,2014-10-28 09:30:56,2014-10-28 08:53:40
5bb20e7875e3f68383aa339e4311dc1cd162b529...920a7e59582f1494e2a6dd102a1e5ba0111a4b6f,1,19,1,20,3,2014-10-28 09:30:57,2014-10-28 09:30:46
920a7e59582f1494e2a6dd102a1e5ba0111a4b6f...1f73d9c06dd5e7596b06d44a47362450984c5fdd,1,1,1,2,1,2014-10-28 09:44:43,2014-10-28 09:44:43
1f73d9c06dd5e7596b06d44a47362450984c5fdd...5697e79004b731900499523583930907b472965a,1,2,2,4,2,2014-10-28 09:49:11,2014-10-28 09:49:04
5697e79004b731900499523583930907b472965a...b4c10d8f610417ff28d6805e9b1c9264011bc273,26,26,27,53,27,2014-10-28 09:49:54,2014-10-28 09:49:23
b4c10d8f610417ff28d6805e9b1c9264011bc273...fb7466078ec5da90321bdca3f08ddf085775e947,1,1,1,2,1,2014-10-28 15:57:07,2014-10-28 15:57:07
fb7466078ec5da90321bdca3f08ddf085775e947...78af6c5e515a9cc1fd32bb33cbc199d36c564f04,9,36,94,130,25,2014-10-28 17:24:25,2014-10-28 17:24:25
78af6c5e515a9cc1fd32bb33cbc199d36c564f04...d7090b11d82866268978b0c92f32038a0750e8cd,8,67,67,134,49,2014-10-28 17:25:28,2014-10-28 17:25:28
759510a5840346cad7eceddc9dc0008b3372170f...831bd3ff46544f7b1eaf88a24334256c8784d263,2,31,0,31,2,2015-03-06 01:35:22,2015-01-21 06:17:44
831bd3ff46544f7b1eaf88a24334256c8784d263...86bdb198ee692c8f40cdd122976516fb639431e4,1,3,0,3,1,2015-03-06 01:35:22,2015-03-06 01:31:59
86bdb198ee692c8f40cdd122976516fb639431e4...f76c1462c2a0ca49b8c697060e994f24119f6345,1,1,1,2,1,2015-03-06 01:35:54,2015-03-06 01:35:54
021e9f767d35a6cf08bef8d95dc4e01ff7dd4480...931edada9fbfe17b2d2e97b1587d5620b24dd687,2,6,1,7,2,2014-12-03 22:44:08,2014-10-26 11:47:51
931edada9fbfe17b2d2e97b1587d5620b24dd687...2a2bf8a4607de078174f8d6a9d2f7fcc2bdfa696,2,3,1,4,2,2014-12-03 22:46:05,2014-12-03 22:46:05
36d18f556bdd2d2c9e1c1b24d7c5e7c44adacaad...c14cd7e9079b22abfd05885e2dfade02855be81d,3,50,2,52,3,2014-10-28 00:37:25,2014-10-28 00:37:25
36d18f556bdd2d2c9e1c1b24d7c5e7c44adacaad...85836d8b0badbf56e1e5e76517e8fdd68fbbab3d,2,7,5,12,2,2014-10-28 00:16:45,2014-10-28 00:16:36
b8478e859042a8aba311e69f9892ce2ca3e23835...8299a9b57e53a316ae66e6e4074f2600b6ac400a,1,12,5,17,3,2014-10-20 22:59:37,2014-10-20 22:51:22
8299a9b57e53a316ae66e6e4074f2600b6ac400a...a776715dae47e03a97fdf096146c1ff3017670f3,1,1,3,4,2,2014-10-21 00:09:24,2014-10-21 00:07:51
a776715dae47e03a97fdf096146c1ff3017670f3...8040967e73919e57ac5bae80d9dcf3741f36ae45,1,0,1,1,1,2014-10-21 00:14:28,2014-10-14 09:50:44
8040967e73919e57ac5bae80d9dcf3741f36ae45...1042e00e16e2a95443672f83b8020700818b5ebc,1,1,1,2,1,2014-10-21 00:26:36,2014-10-14 17:00:22
1042e00e16e2a95443672f83b8020700818b5ebc...784e8fa29b06ff1f0ef7d611267770f8eba786b9,1,1,1,2,1,2014-10-21 00:31:21,2014-10-21 00:27:27
784e8fa29b06ff1f0ef7d611267770f8eba786b9...db35e648077ce028f0d665941ac9ee555854e7d4,1,4,2,6,2,2014-10-21 00:39:37,2014-10-21 00:39:37
db35e648077ce028f0d665941ac9ee555854e7d4...c2c92d9c445708e9e41fee3a17c8277d824ead77,1,1,1,2,1,2014-10-21 00:44:46,2014-10-17 07:50:03
c2c92d9c445708e9e41fee3a17c8277d824ead77...8d8589714fe42b3f6bf6d9992ac42b406cb050d1,1,1,1,2,1,2014-10-21 05:39:44,2014-10-21 05:39:44
8d8589714fe42b3f6bf6d9992ac42b406cb050d1...79aa54bcde0255acc0047d761e6fc59fa1ac5e46,1,2,2,4,1,2014-10-21 05:43:15,2014-10-21 05:43:15
79aa54bcde0255acc0047d761e6fc59fa1ac5e46...23eba80656aab410d0a19bdf2a7e77440a5f2e56,1,5,1,6,2,2014-10-21 05:55:36,2014-10-21 05:54:22
b8478e859042a8aba311e69f9892ce2ca3e23835...aaaa22b7ded94864b3ca9cd5fb53a961c92b169f,1,11,0,11,1,2014-10-20 22:47:29,2014-10-20 22:47:29
a6eb9c3dc437588ec4d06b7325e900e294d26031...9b5c7a81983c908287793be1f2a08e07dd55aa7f,1,1,0,1,1,2014-10-21 20:50:43,2014-10-21 20:49:44
9b5c7a81983c908287793be1f2a08e07dd55aa7f...420d6e59e2289ccb4986b877e7e766f203485e3b,3,27,5,32,11,2014-10-21 21:10:56,2014-10-21 21:08:39
420d6e59e2289ccb4986b877e7e766f203485e3b...14e6b8e29834a31b33dfce0e0837bf382c0fb6d1,1,6,4,10,2,2014-10-21 21:14:16,2014-10-21 21:14:16
14e6b8e29834a31b33dfce0e0837bf382c0fb6d1...88143939a6ce421fb71335c24b81d10e882a21ce,1,3,1,4,2,2014-10-21 21:31:18,2014-10-21 21:31:18
88143939a6ce421fb71335c24b81d10e882a21ce...4bbb03db2961dcdb0af1a8cbb3b79387a00ff3ab,1,3,0,3,2,2014-10-21 21:44:00,2014-10-21 21:44:00
4bbb03db2961dcdb0af1a8cbb3b79387a00ff3ab...b45bc06fff883493d76f28b9a2f273cff7c66f15,1,3,1,4,1,2014-10-21 21:49:16,2014-10-21 21:14:25
b45bc06fff883493d76f28b9a2f273cff7c66f15...f59aa4c0f39dcbe95acdec60d9ee5b686a0a12ca,1,1,1,2,1,2014-10-21 22:12:44,2014-10-21 22:11:37
d1fe97ccc0d503a1c4f73d4909543cfbac7efd54...7d39f9e7962d2cbbb684a58c5bd9b5ae8911e398,1,5,2,7,3,2015-03-06 01:44:33,2015-03-06 01:44:00
7d39f9e7962d2cbbb684a58c5bd9b5ae8911e398...6a52dd82e24a57688548de072acd11249ae2561c,1,7,6,13,3,2015-03-06 01:54:59,2015-03-06 01:54:59
6a52dd82e24a57688548de072acd11249ae2561c...3b565653732d3c532754977130fb2b32896ef100,1,4,4,8,4,2015-03-06 02:40:31,2015-03-06 02:39:59
9a29988016b405298fbfe2b8540a6aa3d8b518ad...d6af3605ca4af142f92fcf12545f709ebdcdb6d1,1,35,29,64,11,2015-03-17 07:37:58,2015-02-26 09:14:27
d6af3605ca4af142f92fcf12545f709ebdcdb6d1...1df8d15275a9c8d493b850ea850432775e04a4a7,2,50,8,58,11,2015-03-17 07:42:35,2015-03-17 07:42:35
1df8d15275a9c8d493b850ea850432775e04a4a7...41dc9b485590c5f4d0ad7757be54c9ebe7292396,2,19,0,19,2,2015-03-17 07:58:14,2015-03-17 07:58:14
41dc9b485590c5f4d0ad7757be54c9ebe7292396...a02f97c4b6bda52a82fc0756f33b3df5bcf02b8d,2,32,8,40,4,2015-03-17 08:25:58,2015-03-17 08:25:58
ff0eda3b0cd50b831a7a7a332f7d3a5ab2e7d0b6...d7396ffb1e5cac8d05bd043698a362c6e6d4521d,1,3,3,6,3,2014-12-03 22:56:55,2014-10-27 17:06:43
d7396ffb1e5cac8d05bd043698a362c6e6d4521d...062fbefa35ccef00bbc43e45572c3c49e2cbd3c5,1,10,4,14,3,2014-12-03 22:58:54,2014-12-03 22:58:54
062fbefa35ccef00bbc43e45572c3c49e2cbd3c5...3e08cdf0b8635366d21e7d628d09b8543abffa2c,1,1,1,2,1,2014-12-03 23:00:25,2014-12-03 23:00:25
86554c7e0344e7f1a1229c07cf935cfdf62dcf16...f1a0143d09d418344fbd37e3104e6b81a5e5adf1,1,6,2,8,1,2014-10-28 00:49:19,2014-10-28 00:49:19
f1a0143d09d418344fbd37e3104e6b81a5e5adf1...7eb8b2c38e6232d964162d5b273f114b0a38f6b8,3,51,2,53,4,2014-10-28 00:56:55,2014-10-28 00:56:55
7eb8b2c38e6232d964162d5b273f114b0a38f6b8...eae23d433a11c725c4abe0511afaf83bff05e8c0,1,7,7,14,2,2014-10-28 01:47:39,2014-10-28 01:47:39
eae23d433a11c725c4abe0511afaf83bff05e8c0...ee602e3992992a6d1d9ac82694db7d95be57b302,2,3,3,6,3,2014-10-28 01:49:10,2014-10-28 01:49:10
debbdd5f3884545a9e414b2b4d6ddeb642e9fd2b...e20572a8a7d43977166cd6966d2af9a51f92ac01,2,17,158,175,6,2014-10-21 16:07:32,2014-10-17 22:39:19
e20572a8a7d43977166cd6966d2af9a51f92ac01...fe487ef0a3b1926ad384b29bdf5f7139c169cb1f,2,29,96,125,17,2014-10-21 16:19:59,2014-10-21 02:31:46
fe487ef0a3b1926ad384b29bdf5f7139c169cb1f...1eaba883aeaeca14e4226154b6b45a116fdc155d,1,70,70,140,58,2014-10-21 17:56:03,2014-10-21 00:59:35
1eaba883aeaeca14e4226154b6b45a116fdc155d...397109b167a9cbe649aaca185d8a52f19f98997c,1,1,4,5,1,2014-10-21 18:37:34,2014-10-21 18:37:34
397109b167a9cbe649aaca185d8a52f19f98997c...1179d402ed06e37383c957dac032d727b48212fd,1,1,1,2,1,2014-10-21 18:39:49,2014-10-21 18:39:49
f59aa4c0f39dcbe95acdec60d9ee5b686a0a12ca...68406388a62e6ebafa701fd4f6ffc1e7d1e5679a,1,1,0,1,1,2014-10-21 22:39:07,2014-10-21 22:39:07
f59aa4c0f39dcbe95acdec60d9ee5b686a0a12ca...4669727a570aae0f854a5d8e7120227b68739116,1,270,40,310,37,2014-10-21 22:23:17,2014-10-17 16:34:00
4669727a570aae0f854a5d8e7120227b68739116...f9ff5dfab4cd13b13ba3ead9ef7baa97bc90e774,1,46,64,110,4,2014-10-21 22:23:17,2014-10-20 15:53:16
f9ff5dfab4cd13b13ba3ead9ef7baa97bc90e774...f89df5fb606ca6b950763c4f94084fc25a75fbe3,1,7,32,39,4,2014-10-21 22:23:17,2014-10-20 16:00:36
f89df5fb606ca6b950763c4f94084fc25a75fbe3...b0020c7470f719f794fba932a5ba3ecf0a29b7d1,1,2,2,4,1,2014-10-21 22:23:17,2014-10-20 18:53:24
b0020c7470f719f794fba932a5ba3ecf0a29b7d1...184d4094435577e1a6d915e9e93b391b448fe2ed,1,75,34,109,29,2014-10-21 22:23:18,2014-10-21 18:07:56
184d4094435577e1a6d915e9e93b391b448fe2ed...33e316e167c2874ed56ecb3bfac0418eb884c0bf,1,1,1,2,1,2014-10-21 22:23:18,2014-10-21 19:47:26
33e316e167c2874ed56ecb3bfac0418eb884c0bf...6f62b030e81e6a31011212096f955f7bbf4b21f4,1,4,0,4,1,2014-10-21 22:23:18,2014-10-21 19:47:51
6f62b030e81e6a31011212096f955f7bbf4b21f4...7a631ccc431de53599cd81a8d2bb599c7b5ad628,1,14,0,14,2,2014-10-21 22:23:18,2014-10-21 22:22:30
7a631ccc431de53599cd81a8d2bb599c7b5ad628...6006a4bd87fcdf79eae4526a90c1c6711226532c,1,4,0,4,1,2014-10-21 22:23:18,2014-10-21 22:22:51
3b565653732d3c532754977130fb2b32896ef100...82bbcd112ceea9fb4fe4e178db7c6e36a32467f1,1,18,18,36,6,2015-03-06 02:41:37,2015-03-06 02:12:44
82bbcd112ceea9fb4fe4e178db7c6e36a32467f1...456d06bde333c11ba9852ec8a333de95f267e79f,1,23,0,23,1,2015-03-06 02:41:37,2015-03-06 02:13:07
456d06bde333c11ba9852ec8a333de95f267e79f...3674c12fc7b5181b8f74165498cdc2257e102cfd,1,4,2,6,1,2015-03-06 02:41:38,2015-03-06 02:14:09
3674c12fc7b5181b8f74165498cdc2257e102cfd...16d516522fce5ddaf26b4305b5112f97bb52c54a,2,44,1,45,2,2015-03-06 02:41:38,2015-02-24 04:29:42
16d516522fce5ddaf26b4305b5112f97bb52c54a...cb7664c2205553395b88f4afcbcc4ca86e164f5c,2,46,43,89,26,2015-03-06 02:41:38,2015-03-06 02:31:44
cb7664c2205553395b88f4afcbcc4ca86e164f5c...3104115a30fc5023446bab17acba7992d1f996ba,1,5,0,5,1,2015-03-06 02:41:39,2015-03-06 02:40:26
07afc3380d3ed0d43aa9a9a6733fa9eb034c59b7...c06ee6d07c34359c21ee97d07959d1bc616bd870,2,2,3,5,4,2014-12-03 23:08:52,2014-12-03 23:08:52
c06ee6d07c34359c21ee97d07959d1bc616bd870...7358c61476db87ef43697851ab3b06cefe7e0f95,1,7,0,7,1,2014-12-03 23:13:27,2014-10-29 13:23:33
7358c61476db87ef43697851ab3b06cefe7e0f95...691404ed70a745fa1797afa6988676e1345c6ae1,1,1,1,2,1,2014-12-03 23:22:46,2014-11-03 10:37:32
691404ed70a745fa1797afa6988676e1345c6ae1...dc518bf3493ccc7d39b2f5e0db04afce987b8bb1,1,1,1,2,1,2014-12-03 23:57:12,2014-11-05 17:52:44
dc518bf3493ccc7d39b2f5e0db04afce987b8bb1...cffbc00a62b7502b384f5989a3511e87b9b7447b,1,1,2,3,2,2014-12-03 23:57:20,2014-11-06 13:18:26
ee602e3992992a6d1d9ac82694db7d95be57b302...088dee92b72a9ab53d00bf12b8b36d3a034f6bde,1,22,14,36,1,2014-10-28 04:27:39,2014-10-28 04:27:39
088dee92b72a9ab53d00bf12b8b36d3a034f6bde...f37e604b789e34970db5fe0740fb0745df36208f,1,2,2,4,1,2014-10-28 07:49:53,2014-10-28 07:49:53
f37e604b789e34970db5fe0740fb0745df36208f...ef093fa751b7e22f8697ff8921a0edd16f5a1e21,2,21,8,29,8,2014-10-28 08:21:59,2014-10-28 08:21:59
ef093fa751b7e22f8697ff8921a0edd16f5a1e21...e45110577d7d3b05fe3b81ae8de13b407b2c378b,1,5,0,5,1,2014-10-28 09:27:24,2014-10-28 09:27:24
68406388a62e6ebafa701fd4f6ffc1e7d1e5679a...5d9cde97bbc54fe66f4a8f9bf7323e8cc517f207,1,5,0,5,1,2014-10-21 22:58:18,2014-10-21 22:58:18
5d9cde97bbc54fe66f4a8f9bf7323e8cc517f207...97c85bc3da6f951369bb1553c95f79e0b0526d03,8,386,21,407,18,2014-10-21 22:59:40,2014-10-08 02:44:49
97c85bc3da6f951369bb1553c95f79e0b0526d03...b569095119672f9422e77435df5c8d8690a99dbc,2,12,7,19,9,2014-10-21 23:40:43,2014-10-21 23:40:22
b569095119672f9422e77435df5c8d8690a99dbc...139a7fd024ff681fc6c428bc77dda0a15be04f56,1,2,1,3,1,2014-10-21 23:58:03,2014-10-21 23:56:45
139a7fd024ff681fc6c428bc77dda0a15be04f56...a2f93852110903e82c756af212420ea71cb2400c,1,2,0,2,1,2014-10-22 00:03:56,2014-10-22 00:03:46
a2f93852110903e82c756af212420ea71cb2400c...a25173a71c26f89d9b4a12cde875f924c352626e,2,71,31,102,9,2014-10-22 00:07:45,2014-10-22 00:06:43
a25173a71c26f89d9b4a12cde875f924c352626e...2db8e7bc612fae3fca30553f36ecd08431a19c7b,1,7,18,25,5,2014-10-22 00:18:50,2014-10-22 00:03:48
2db8e7bc612fae3fca30553f36ecd08431a19c7b...5a2892a26c034a9135d7f9ac9e9dfd2f71d29b4e,1,28,13,41,12,2014-10-22 00:18:50,2014-10-21 23:43:02
5a2892a26c034a9135d7f9ac9e9dfd2f71d29b4e...f2378ce616edf9380457744a6ea7bb9fe58b8b7e,5,76,15,91,14,2014-10-22 00:49:48,2014-10-22 00:49:42
f2378ce616edf9380457744a6ea7bb9fe58b8b7e...7f2df72de2ef7ea184e2765800d9741db41a4369,1,2,2,4,1,2014-10-22 00:51:39,2014-10-22 00:51:16
7f2df72de2ef7ea184e2765800d9741db41a4369...678b510e4ccea3020d3899ae2e66122bdffe7a34,1,44,8,52,5,2014-10-22 03:11:34,2014-10-22 03:11:34
678b510e4ccea3020d3899ae2e66122bdffe7a34...b71d2751e5046ad4ec1310fc47274944268a12b2,1,2,5,7,1,2014-10-22 03:28:04,2014-10-22 03:28:04
68406388a62e6ebafa701fd4f6ffc1e7d1e5679a...b21d46cf83e7334097b2e0ad20c9aef2fa715bbc,8,386,21,407,18,2014-10-21 22:55:58,2014-10-08 02:44:49
46d6297f38de5da52d6df205e9d4c1d2d345d6a7...5c5af8bdff6a6f938aa2889fb09563685f04eeda,1,17,13,30,2,2015-03-06 02:45:27,2015-03-06 02:44:48
5c5af8bdff6a6f938aa2889fb09563685f04eeda...627f3be4f83e09ee205906ef8be6d775c11db720,2,2,2,4,2,2015-03-06 03:21:48,2015-03-06 03:21:48
627f3be4f83e09ee205906ef8be6d775c11db720...18e304b28cb5f4d92688b84051dc9b1ca6d8b9ca,2,5,2,7,2,2015-03-06 03:46:33,2015-03-06 03:46:33
18e304b28cb5f4d92688b84051dc9b1ca6d8b9ca...c914dc94cfbfa500ee13771cdb0f50f89e4fcc05,1,1,0,1,1,2015-03-06 03:47:11,2015-03-06 03:47:11
c914dc94cfbfa500ee13771cdb0f50f89e4fcc05...d7b7ab64746807c61484fcd3d15fc660bec6a18c,3,21,11,32,8,2015-03-06 03:56:41,2015-03-06 03:29:46
d7b7ab64746807c61484fcd3d15fc660bec6a18c...f65035e11ad6f1c6db07ea3a18d5e8c67abb5dfc,2,15,1,16,2,2015-03-06 03:56:42,2015-03-06 03:32:42
f65035e11ad6f1c6db07ea3a18d5e8c67abb5dfc...59a6bef4aac36ce8b2460667b4199fc4b0fc3e68,2,2,5,7,2,2015-03-06 03:58:51,2015-03-06 03:58:41
59a6bef4aac36ce8b2460667b4199fc4b0fc3e68...71b914a296ce7f919cd2c08228c046183e3d97a6,3,43,39,82,3,2015-03-06 04:04:58,2015-03-06 04:04:44
71b914a296ce7f919cd2c08228c046183e3d97a6...7820fd2014acb1ee4750702364e30ae470ee5787,1,4,0,4,1,2015-03-06 04:16:33,2015-03-06 04:16:33
7820fd2014acb1ee4750702364e30ae470ee5787...e6dd4888423012e89e21f2cf326fa659826df67f,1,5,1,6,1,2015-03-06 04:24:44,2015-03-06 04:24:44
e6dd4888423012e89e21f2cf326fa659826df67f...4a6dd52bca0b3894191e378eddea8016391a3a16,2,16,9,25,8,2015-03-06 05:07:14,2015-03-06 05:07:14
4a6dd52bca0b3894191e378eddea8016391a3a16...ef8bb3043e024088cf5116f1beb8f2b4985ffb02,1,104,75,179,25,2015-03-06 05:23:20,2015-03-06 04:46:22
ef8bb3043e024088cf5116f1beb8f2b4985ffb02...a7cb0a0918976ee061eb4a52a69ca2c9e4b5aecb,1,75,34,109,17,2015-03-06 05:23:20,2015-03-06 05:20:24
a7cb0a0918976ee061eb4a52a69ca2c9e4b5aecb...7e1ec96afd19cca2f3de4a54cfb27cf2b4cf15d4,1,10,1,11,2,2015-03-06 05:25:57,2015-03-06 05:25:57
7e1ec96afd19cca2f3de4a54cfb27cf2b4cf15d4...7ff27f4e17628a790d47bf7a52b189ba46a34559,5,12,11,23,9,2015-03-06 05:36:18,2015-03-06 05:36:18
7ff27f4e17628a790d47bf7a52b189ba46a34559...3ef568b4851d90c9e474b4611806ffb9373d68c3,1,7,6,13,2,2015-03-06 05:38:28,2015-03-06 05:38:28
3ef568b4851d90c9e474b4611806ffb9373d68c3...821882057ce4bb9d06279e0182536d34ffac3355,1,6,3,9,3,2015-03-06 05:50:08,2015-03-06 05:50:08
821882057ce4bb9d06279e0182536d34ffac3355...2288d76db184727dba7d7c8ec3164076ec547236,1,6,6,12,1,2015-03-06 05:56:40,2015-03-06 05:56:23
2288d76db184727dba7d7c8ec3164076ec547236...b2132ee983f3d52c261dda019ee299cdd9c724af,4,30,27,57,10,2015-03-06 06:20:26,2015-03-06 06:12:08
cffbc00a62b7502b384f5989a3511e87b9b7447b...e63ac7c0712db19a6a57e930cbf719264dd72de3,1,1,1,2,1,2014-12-04 14:23:58,2014-12-04 14:23:58
cffbc00a62b7502b384f5989a3511e87b9b7447b...4579bba67c50c55fc6e2ed2a55fdffef15ac46b5,1,1,1,2,1,2014-12-04 09:12:38,2014-12-04 09:12:38
b71d2751e5046ad4ec1310fc47274944268a12b2...f064c2d03fb063ef268582a46dfd66f4c6ea70a5,1,2,2,4,2,2014-10-22 05:36:44,2014-10-22 05:36:44
f064c2d03fb063ef268582a46dfd66f4c6ea70a5...011b14e949c69ab6de05551ae021421d58cd59da,1,8,5,13,5,2014-10-22 16:37:09,2014-10-22 16:37:09
011b14e949c69ab6de05551ae021421d58cd59da...8c99924685504e2689f158c5feb65544b7604696,1,355,105,460,49,2014-10-22 16:57:19,2014-10-22 16:57:19
8c99924685504e2689f158c5feb65544b7604696...e92f9b3ff948d402191da00d9618e0ec98893f21,1,2,4,6,2,2014-10-22 17:03:42,2014-10-22 17:03:42
e92f9b3ff948d402191da00d9618e0ec98893f21...620edd3f0c7562b9e39f572a8acb53093c98a37e,1,5,5,10,2,2014-10-22 17:48:18,2014-10-22 17:48:18
620edd3f0c7562b9e39f572a8acb53093c98a37e...5418f34887b46096b7f4c0373021ecfc6e2a180f,1,2,2,4,2,2014-10-22 17:55:12,2014-10-22 17:47:10
5418f34887b46096b7f4c0373021ecfc6e2a180f...46c77c142a9a562ddfdfc364ef56f25f7a574641,1,2,0,2,1,2014-10-22 17:55:12,2014-10-22 17:54:49
46c77c142a9a562ddfdfc364ef56f25f7a574641...da1b34c4492e1af3d4d218af12e47e817da85867,1,3,1,4,1,2014-10-22 17:59:11,2014-10-22 17:59:11
da1b34c4492e1af3d4d218af12e47e817da85867...5257732e479dddf6c025e87ab8a592b0f64fb16e,1,4,2,6,1,2014-10-22 17:59:42,2014-10-22 06:04:07
5257732e479dddf6c025e87ab8a592b0f64fb16e...ccbac61cf092e6046717dc760a0bc7daa67e2c1e,1,5,0,5,1,2014-10-22 18:09:20,2014-10-22 04:56:53
ccbac61cf092e6046717dc760a0bc7daa67e2c1e...dc0563c620701f88f08310486d056407d191e832,1,1,1,2,1,2014-10-22 19:25:29,2014-10-22 19:24:44
dc0563c620701f88f08310486d056407d191e832...eddc136fb8a75cc5d44a71a34657d40d40ba99f6,1,1,0,1,1,2014-10-22 19:25:29,2014-10-22 19:25:16
eddc136fb8a75cc5d44a71a34657d40d40ba99f6...83542e9650dac3a318de94977e744f820255b537,1,3,2,5,1,2014-10-22 20:05:19,2014-10-22 19:54:00
83542e9650dac3a318de94977e744f820255b537...480b05bc2c7adbe0693d52df1766a70868ebe848,4,9,21,30,12,2014-10-22 20:05:19,2014-10-22 19:59:22
480b05bc2c7adbe0693d52df1766a70868ebe848...da4d925a7c5eae8e09ced393808adcf93987f309,1,4,2,6,2,2014-10-22 20:51:06,2014-10-22 20:51:06
da4d925a7c5eae8e09ced393808adcf93987f309...0a7390232566ebf9478b30d0152ca9c5b9cac680,28,17,1,18,3,2014-10-22 21:15:46,2014-10-22 21:15:17
0a7390232566ebf9478b30d0152ca9c5b9cac680...069f2297d5bf7c7836c9105593515676557537e5,1,6,2,8,2,2014-10-22 21:55:49,2014-10-22 21:55:49
069f2297d5bf7c7836c9105593515676557537e5...d13057f4b2d7363358ae8c6278cc07871b3b6483,1,5,5,10,5,2014-10-22 23:16:21,2014-10-22 23:16:21
d13057f4b2d7363358ae8c6278cc07871b3b6483...d90511128b2091067f369439da02b216ba316579,1,9,15,24,8,2014-10-23 02:16:16,2014-10-23 02:16:16
d90511128b2091067f369439da02b216ba316579...2151fc1f4059beb941d3fc9024b2d19ed3e016c3,2,53,46,99,10,2014-10-23 02:33:39,2014-10-23 02:33:39
2151fc1f4059beb941d3fc9024b2d19ed3e016c3...501f08d0d8e509f56b99841ada89978171077e90,1,4,7,11,2,2014-10-23 02:48:19,2014-10-23 02:48:19
501f08d0d8e509f56b99841ada89978171077e90...339af7c22ea0ffd87fb5b820d69e23ae25434721,1,2,1,3,1,2014-10-23 03:03:41,2014-10-23 03:03:41
339af7c22ea0ffd87fb5b820d69e23ae25434721...10d43a974b352d70bef04fc1089088369bbb3941,1,2,0,2,1,2014-10-23 03:06:46,2014-10-23 03:06:46
10d43a974b352d70bef04fc1089088369bbb3941...4397580e88152646fa1fae5b8ea333de4bf02d78,2,3,1,4,2,2014-10-23 03:16:12,2014-10-23 03:16:12
4397580e88152646fa1fae5b8ea333de4bf02d78...e2086d4dbaee73c817ac3ccc7c854a7772193e1e,1,1,1,2,1,2014-10-23 05:18:49,2014-10-23 05:18:49
e2086d4dbaee73c817ac3ccc7c854a7772193e1e...6a9fae3339c1e9c035504de052043779543b5664,1,2,1,3,1,2014-10-23 08:43:49,2014-10-23 08:43:49
6a9fae3339c1e9c035504de052043779543b5664...1a4956e89aa5192f18bf32353f78a735d35c1890,1,21,1,22,2,2014-10-23 17:30:41,2014-10-20 18:43:03
1a4956e89aa5192f18bf32353f78a735d35c1890...70054e379d7c84de4fa219b7ef0b8b64a219ec2f,2,59,2,61,5,2014-10-23 17:31:22,2014-10-21 23:29:22
70054e379d7c84de4fa219b7ef0b8b64a219ec2f...2b3eed13f5d630a98255368ee95cd061cc97532e,4,160,157,317,6,2014-10-23 17:51:20,2014-10-22 20:43:43
2b3eed13f5d630a98255368ee95cd061cc97532e...e7308c8f84fdb2aa58300b700f4f314fa9efb879,1,2,2,4,2,2014-10-23 17:51:20,2014-10-22 21:25:50
e7308c8f84fdb2aa58300b700f4f314fa9efb879...2f4231aaf2cc024b93d298d075302dbbb95d8e41,1,2,2,4,2,2014-10-23 17:51:20,2014-10-22 21:29:28
2f4231aaf2cc024b93d298d075302dbbb95d8e41...8793d26d43abffdfe681d05d30dc9cf393ea80cc,3,29,23,52,10,2014-10-23 17:51:20,2014-10-22 22:11:57
8793d26d43abffdfe681d05d30dc9cf393ea80cc...9d1adbc4f383d21698aadce59794ab15bdbe92a2,1,2,2,4,2,2014-10-23 17:51:20,2014-10-22 22:21:41
9d1adbc4f383d21698aadce59794ab15bdbe92a2...0fb62f16863f735e10ce23f6dd556bc1eb2ac5d0,1,4,2,6,2,2014-10-23 17:51:20,2014-10-22 23:38:04
0fb62f16863f735e10ce23f6dd556bc1eb2ac5d0...61589d9b71979b517580f54757addc8b9752ef3a,1,1,1,2,1,2014-10-23 20:09:38,2014-10-23 20:09:38
61589d9b71979b517580f54757addc8b9752ef3a...41d9c06ae9e047a1cea86e49121390e5fdaa93ba,1,19,13,32,4,2014-10-23 20:23:02,2014-10-23 18:45:59
41d9c06ae9e047a1cea86e49121390e5fdaa93ba...5e881807fece0b44521f5ced70c528e7a4b9ae49,1,1,1,2,1,2014-10-23 20:23:02,2014-10-23 18:50:55
5e881807fece0b44521f5ced70c528e7a4b9ae49...4a149253c0592d5088bda4e9202d6ef8c416f4ba,1,16,13,29,6,2014-10-23 20:26:19,2014-10-23 20:25:03
4a149253c0592d5088bda4e9202d6ef8c416f4ba...edc0da84e78e875d74c65bd9c8b66d1c26f10e79,1,2,2,4,2,2014-10-23 20:26:19,2014-10-23 20:25:54
edc0da84e78e875d74c65bd9c8b66d1c26f10e79...b6e018bdcbe88a23ce30cb065a46eed2089a7d6f,1,1,1,2,1,2014-10-23 20:26:19,2014-10-23 20:26:09
b6e018bdcbe88a23ce30cb065a46eed2089a7d6f...0ceeb2e6c591d20ad0cbb3276e49d3862aa765cc,1,28,23,51,2,2014-10-23 20:38:11,2014-10-23 20:34:33
0ceeb2e6c591d20ad0cbb3276e49d3862aa765cc...73de0b983be47724f298bb7e3420b5b7830e0ec5,1,22,6,28,7,2014-10-23 20:40:29,2014-10-23 20:39:16
73de0b983be47724f298bb7e3420b5b7830e0ec5...de20ebaa1579c545cc2c3e34247e068665c8b92e,1,7,6,13,2,2014-10-23 20:53:53,2014-10-23 20:53:53
de20ebaa1579c545cc2c3e34247e068665c8b92e...82531999844a7624bb963e2ee19d7fa563065e98,1,1,1,2,1,2014-10-23 21:10:54,2014-10-23 21:10:33
b71d2751e5046ad4ec1310fc47274944268a12b2...97e482091e1be91cc2432df57a025f01b59718fb,1,5,0,5,1,2014-10-22 04:56:53,2014-10-22 04:56:53
b2132ee983f3d52c261dda019ee299cdd9c724af...80c45919b25839848100bda8ad240f842a3e8623,1,2,0,2,1,2015-03-06 07:25:52,2015-03-06 07:25:40
80c45919b25839848100bda8ad240f842a3e8623...4bab8566fdc04b70712908741c80483cea76ac46,1,5,5,10,5,2015-03-06 23:14:21,2015-03-06 23:14:21
b2132ee983f3d52c261dda019ee299cdd9c724af...ab7527cfbd4939743f79567ed312994ebc53decc,1,3,3,6,2,2015-03-06 06:26:25,2015-03-06 06:26:25
ab7527cfbd4939743f79567ed312994ebc53decc...873018df44335f9b3536ac67c7412ea24405d293,11,11,11,22,11,2015-03-06 06:30:22,2015-03-06 06:30:22
873018df44335f9b3536ac67c7412ea24405d293...4f3bdd29ae60baeffe496f9ebd8b37e8b4184e00,4,10,8,18,4,2015-03-06 06:51:17,2015-03-06 06:46:36
4f3bdd29ae60baeffe496f9ebd8b37e8b4184e00...af0469da3553fa4d53f4798dff52ae1c9777f69f,105,105,105,210,105,2015-03-06 06:54:07,2015-03-06 06:36:19
af0469da3553fa4d53f4798dff52ae1c9777f69f...10ee6aeb10e7dde3e2fcb595ad1d368d3a89aeba,2,2,2,4,2,2015-03-06 06:55:19,2015-03-06 06:55:19
10ee6aeb10e7dde3e2fcb595ad1d368d3a89aeba...2a88b4fcf03561dd4e090b856002b9f630f6441d,2,3,2,5,2,2015-03-06 07:04:28,2015-03-06 07:01:21
2a88b4fcf03561dd4e090b856002b9f630f6441d...0fc2261cfe9c5c1053df9b63bd618e709d3a9dc8,10,271,281,552,16,2015-03-06 07:23:21,2015-03-06 07:23:21
0fc2261cfe9c5c1053df9b63bd618e709d3a9dc8...90a39ef3bf3a9a446fbf7c6cc42f3940dc172b2e,1,2,0,2,1,2015-03-06 07:25:40,2015-03-06 07:25:40
90a39ef3bf3a9a446fbf7c6cc42f3940dc172b2e...56c735e3e9acf8dd172d7584f9a8ad99a5f9a486,1,2,1,3,1,2015-03-06 17:59:51,2015-03-06 17:59:51
7c7e52f2d2b0c98577f7b2a0f1cb180e664d522e...861fe1d502b8092e38a21483a387d872086b01d2,1,1,1,2,1,2014-12-04 17:21:48,2014-12-04 17:21:48
861fe1d502b8092e38a21483a387d872086b01d2...67d1ec6340b9e50c6723b55573a37598e874c3f6,3,5,4,9,6,2014-12-04 19:59:40,2014-11-09 15:31:30
67d1ec6340b9e50c6723b55573a37598e874c3f6...104636c6a7b7b88aafc4837bdd65b4d7490ee148,2,6,2,8,4,2014-12-04 20:17:13,2014-12-04 20:16:49
104636c6a7b7b88aafc4837bdd65b4d7490ee148...0011e00a7e0f14aa3e5f76e981461bcfea6de260,1,1,0,1,1,2014-12-04 23:37:52,2014-12-04 23:34:49
82531999844a7624bb963e2ee19d7fa563065e98...33d5effa577fe50f96c449575dbd1cc767631c80,1,18,0,18,1,2014-10-23 21:32:53,2014-10-23 21:32:53
33d5effa577fe50f96c449575dbd1cc767631c80...dcf7b27bf6314c96bcd680ded20ce90cf157ca9f,1,10,0,10,1,2014-10-23 21:38:09,2014-10-23 21:38:09
dcf7b27bf6314c96bcd680ded20ce90cf157ca9f...e4d055c7c2189540b72d6c8e385cc9b731aea89e,1,9,0,9,1,2014-10-23 21:45:26,2014-10-23 21:45:26
e4d055c7c2189540b72d6c8e385cc9b731aea89e...7774d1fa51086693a885c26e932d285438692aa8,1,14,0,14,1,2014-10-23 21:50:00,2014-10-23 21:50:00
7774d1fa51086693a885c26e932d285438692aa8...b219b8f75a99537afee6dc143add01677664315b,1,8,0,8,1,2014-10-23 21:58:44,2014-10-23 21:58:44
b219b8f75a99537afee6dc143add01677664315b...dda0c44b52b13a997bd3cf2b221fad8c6cc28c55,31,163,0,163,31,2014-10-23 22:06:33,2014-10-23 22:06:08
dda0c44b52b13a997bd3cf2b221fad8c6cc28c55...50d7f3b995ea36ead1bf67425a58ecc628386723,1,5,0,5,1,2014-10-23 22:07:06,2014-10-23 22:06:49
50d7f3b995ea36ead1bf67425a58ecc628386723...dbb1d36933c526813f2222a3a1b7504d766d819e,1,0,0,0,0,2014-10-23 22:22:48,2014-10-23 22:22:48
dbb1d36933c526813f2222a3a1b7504d766d819e...7712af3ba7f7cf6cac11ae47101098dff22e75fb,5,22,59,81,8,2014-10-23 23:43:18,2014-10-23 23:42:59
7712af3ba7f7cf6cac11ae47101098dff22e75fb...417bcdeafffbc6631e99b3f28b6360d7d0a42144,1,18,0,18,1,2014-10-24 00:39:19,2014-10-24 00:39:04
417bcdeafffbc6631e99b3f28b6360d7d0a42144...721fa0451b121a21e4b98bb87a21612d8560a893,15,202,14,216,17,2014-10-24 17:13:59,2014-10-24 17:13:50
721fa0451b121a21e4b98bb87a21612d8560a893...4b1bb9b3f4a0f6ad8a8a81000130318c2533f32d,1,48,3,51,3,2014-10-25 22:18:30,2014-10-25 22:18:30
4b1bb9b3f4a0f6ad8a8a81000130318c2533f32d...420f3a31fa056d74f96323d961e9a1309fc0aa50,1,5,2,7,2,2014-10-25 22:29:32,2014-10-25 22:29:32
420f3a31fa056d74f96323d961e9a1309fc0aa50...e4e0610da16cf9a99f25933f3c17a6bc2288845f,1,90,1102,1192,35,2014-10-27 13:06:07,2014-10-27 13:06:07
e4e0610da16cf9a99f25933f3c17a6bc2288845f...96b43c4b6373a8b3a139625ff373d7fd3294491a,1,0,12,12,3,2014-10-28 09:53:43,2014-10-28 09:53:43
96b43c4b6373a8b3a139625ff373d7fd3294491a...2ca942f9cb6fd6f2f75ab3d6fbb5c4147215a8f5,30,59,33,92,31,2014-10-28 09:54:45,2014-10-28 09:54:45
2ca942f9cb6fd6f2f75ab3d6fbb5c4147215a8f5...11400a59765eb7557d12bea0e27ba2b443886192,1,304,0,304,1,2014-10-28 16:30:03,2014-10-28 16:30:03
11400a59765eb7557d12bea0e27ba2b443886192...a6cbb5f264b79054aa84d43b663dbbcf7a42b9c0,1,5,3,8,2,2014-10-28 16:36:03,2014-10-28 16:36:03
82531999844a7624bb963e2ee19d7fa563065e98...719034798f79ef60942ba443ed4fb52ad60fbd51,1,1,0,1,1,2014-10-23 21:22:02,2014-10-23 21:19:12
719034798f79ef60942ba443ed4fb52ad60fbd51...df97dc27172b16cef3c5ab9feeed2edec6de6662,1,12,12,24,2,2014-10-23 21:33:07,2014-10-23 21:33:07
df97dc27172b16cef3c5ab9feeed2edec6de6662...3cab345625e626c96b4f8668973a0a8b6c5304ec,1,0,150,150,1,2014-10-23 21:38:34,2014-10-23 21:38:34
3cab345625e626c96b4f8668973a0a8b6c5304ec...57945ceb1b5be35ddbbc5f3e3d0de958593cf5dd,1,20,0,20,1,2014-10-23 21:50:34,2014-10-23 21:05:57
57945ceb1b5be35ddbbc5f3e3d0de958593cf5dd...41c793d570359b7e88bcc3b2301c74e215ede8d1,1,7,3,10,2,2014-10-23 22:03:48,2014-10-23 22:03:36
41c793d570359b7e88bcc3b2301c74e215ede8d1...fddfa7542179d2d77edf97df48e619fc66be9619,1,1,1,2,1,2014-10-23 22:28:28,2014-10-23 22:28:28
fddfa7542179d2d77edf97df48e619fc66be9619...4995bf3e49d6bdf1d1c2d5273d4775464c84ccf3,1,1,0,1,1,2014-10-23 22:36:36,2014-10-23 22:36:36
4995bf3e49d6bdf1d1c2d5273d4775464c84ccf3...f67d0733d94c2849c2027d487b363752d638fc5f,1,6,1,7,2,2014-10-23 22:50:04,2014-10-23 22:50:04
f67d0733d94c2849c2027d487b363752d638fc5f...75795b39b7b24b6e5d4415482d8d6a201730b9fc,1,1,1,2,1,2014-10-23 22:53:13,2014-10-23 22:53:13
75795b39b7b24b6e5d4415482d8d6a201730b9fc...c0f873641a77caf93801c8ac169ad0c61eb1a93d,1,2,1,3,2,2014-10-23 23:00:16,2014-10-23 22:51:50
c0f873641a77caf93801c8ac169ad0c61eb1a93d...3633c0ff60991c0147861f833dfee55d9b245d0a,1,5,1,6,1,2014-10-23 23:16:07,2014-10-23 23:14:49
3633c0ff60991c0147861f833dfee55d9b245d0a...b8630d7b66edfd424edb9871183af4816e872f6c,1,1,1,2,1,2014-10-23 23:17:55,2014-10-23 23:17:55
b8630d7b66edfd424edb9871183af4816e872f6c...2a95b3ff6ad115ee22dc006ca5f9c74ccec5d534,12,462,0,462,11,2014-10-23 23:24:34,2014-10-23 23:24:34
2a95b3ff6ad115ee22dc006ca5f9c74ccec5d534...aadbda5608cef54786745e07d0e3969a8aad3e50,1,9,10,19,1,2014-10-23 23:48:32,2014-10-23 23:48:20
aadbda5608cef54786745e07d0e3969a8aad3e50...2250426ddf26e966864a4d0e7963152a3634c359,1,4,4,8,4,2014-10-23 23:56:05,2014-10-23 23:42:20
2250426ddf26e966864a4d0e7963152a3634c359...876d222f11f0bf94f89ae6dc83ebca3706f84e00,1,1,1,2,1,2014-10-23 23:56:05,2014-10-23 23:50:54
876d222f11f0bf94f89ae6dc83ebca3706f84e00...9c09abaffa3bb9786526ed75d4c86fa07227051f,1,2,1,3,1,2014-10-24 02:38:18,2014-10-24 02:38:18
9c09abaffa3bb9786526ed75d4c86fa07227051f...eb65687f75e21f8fba2b83a40a80fd4df10ad91a,7,26,16,42,16,2014-10-24 02:48:04,2014-10-24 02:48:04
eb65687f75e21f8fba2b83a40a80fd4df10ad91a...4809f0a584c1949afb62ebaeac323517add9bba3,1,1,1,2,1,2014-10-24 02:54:53,2014-10-24 02:54:53
4809f0a584c1949afb62ebaeac323517add9bba3...4afefb6a504936d543b9cfbb156fd7959b2523f6,6,24,125,149,18,2014-10-24 04:21:23,2014-10-24 04:10:34
4afefb6a504936d543b9cfbb156fd7959b2523f6...44b457e4a2d08b1dc66d6c565a5d07da4441b122,1,1,1,2,1,2014-10-24 04:25:25,2014-10-24 04:25:25
44b457e4a2d08b1dc66d6c565a5d07da4441b122...879e18bb323617c9541c4321e456ccbbafbb7b2b,1,1,1,2,1,2014-10-24 04:26:36,2014-10-24 04:26:36
879e18bb323617c9541c4321e456ccbbafbb7b2b...cb6a37fe9600deeaf7e68c988ddb7e2b4709d776,1,2,2,4,1,2014-10-24 04:32:57,2014-10-24 04:32:57
cb6a37fe9600deeaf7e68c988ddb7e2b4709d776...4fa8d3e61c643ccbdce3c0268e7899d3aecbc4c9,1,18,2,20,1,2014-10-24 04:41:55,2014-10-24 04:41:55
4fa8d3e61c643ccbdce3c0268e7899d3aecbc4c9...ef68e0968fffc768358e811365d865f0f0b17c17,4,6,6,12,4,2014-10-24 04:48:40,2014-10-24 04:48:40
4bab8566fdc04b70712908741c80483cea76ac46...dab27824344e1167ab709e20a44efc7ee4afe59c,4,15,5,20,8,2015-03-15 06:04:09,2015-03-15 06:04:09
dab27824344e1167ab709e20a44efc7ee4afe59c...c8d02245e3864bdf723bba573a9b9e594ba2ea1a,4,80,5,85,12,2015-03-15 06:05:26,2015-03-15 06:05:26
c8d02245e3864bdf723bba573a9b9e594ba2ea1a...b3e1c4d89a9f73395a460f50137c0f4f9af72b50,3,25,23,48,7,2015-03-17 07:20:32,2015-03-17 07:20:32
4bab8566fdc04b70712908741c80483cea76ac46...eb33978b60ba6ebb170e5d5cf2c16fac0eec36d8,3,12,5,17,7,2015-03-09 19:05:02,2015-03-09 19:05:02
56c735e3e9acf8dd172d7584f9a8ad99a5f9a486...3cf30fbc1744da403c54a9a8d49cabfb79a95ae5,1,8,7,15,2,2015-03-09 18:38:41,2015-03-09 18:36:51
3cf30fbc1744da403c54a9a8d49cabfb79a95ae5...5c7873dfa8d419d150d51c3207313414fa0ed060,1,3,4,7,1,2015-03-09 21:21:37,2015-03-09 20:36:23
5c7873dfa8d419d150d51c3207313414fa0ed060...ed60db429c051bb6a919d1319cbdaa4ab1d84031,1,2,2,4,2,2015-03-09 21:21:37,2015-03-09 20:37:45
ed60db429c051bb6a919d1319cbdaa4ab1d84031...7b8714da6e6cfd878b813518e20b3a4c4eea48b3,2,0,60,60,4,2015-03-09 21:21:38,2015-03-09 20:39:44
7b8714da6e6cfd878b813518e20b3a4c4eea48b3...3752766ff5923abd423d01bdf84e4bd6512465b4,1,12,0,12,2,2015-03-09 21:21:38,2015-03-09 20:40:26
3752766ff5923abd423d01bdf84e4bd6512465b4...86003bc105c0669eccd045137cf4a913704dc1ca,1,0,8,8,1,2015-03-09 21:27:59,2015-03-09 21:27:59
86003bc105c0669eccd045137cf4a913704dc1ca...d571e556a35c7a494804af33b90d1a95b8117997,5,8,61,69,12,2015-03-09 22:10:26,2015-03-09 21:33:08
d571e556a35c7a494804af33b90d1a95b8117997...b21aac4c7217547d93fb9008c1f2921adbadd6ce,1,1,1,2,1,2015-03-09 22:39:22,2015-03-09 22:39:12
b21aac4c7217547d93fb9008c1f2921adbadd6ce...7733b584f1896bf865da2392342467a8908c6f78,1,17,11,28,4,2015-03-09 23:17:19,2015-03-01 23:53:18
7733b584f1896bf865da2392342467a8908c6f78...7fad3ed150ea168e71cf917a3e1057976fb8ddcb,1,4,0,4,1,2015-03-09 23:17:32,2015-03-09 23:17:32
7fad3ed150ea168e71cf917a3e1057976fb8ddcb...50534fa25264d713df1bb797375f5963e04600dd,1,1,1,2,1,2015-03-09 23:18:45,2015-03-09 23:17:57
50534fa25264d713df1bb797375f5963e04600dd...e7a9bdb5075d633556bcc50ff0e2353b1509059a,6,6,6,12,6,2015-03-09 23:20:50,2015-03-09 23:20:50
e7a9bdb5075d633556bcc50ff0e2353b1509059a...c72f20ccea7f6b02f1247c4ea56e8f124764a849,1,1,1,2,1,2015-03-10 00:14:44,2015-03-10 00:14:44
c72f20ccea7f6b02f1247c4ea56e8f124764a849...82e02c4cc43836f325c2877a7c916e380c7a619e,1,2,0,2,2,2015-03-10 01:51:40,2015-03-10 01:51:40
82e02c4cc43836f325c2877a7c916e380c7a619e...0a1dcee43ce54e3786d3f3b3c637751bf265a95c,1,5,3,8,3,2015-03-10 05:13:07,2015-03-10 05:13:07
0a1dcee43ce54e3786d3f3b3c637751bf265a95c...adc6d9969cd42e2871879bef3cb2c1640a6b6c1e,2,11,18,29,8,2015-03-10 05:30:44,2015-03-10 05:30:44
adc6d9969cd42e2871879bef3cb2c1640a6b6c1e...56b3dbd3b97543ac170b2c1ed24dab7db4dfcc3c,1,7,0,7,1,2015-03-10 18:44:56,2015-03-10 18:44:01
56b3dbd3b97543ac170b2c1ed24dab7db4dfcc3c...891a9c38939ecc62c3b616068aad66d525aa5ae7,4,4,4,8,4,2015-03-10 18:49:25,2015-03-10 18:49:25
891a9c38939ecc62c3b616068aad66d525aa5ae7...070ca69f9a6ab1095296fa0e4c371164a389bab9,3,52,0,52,3,2015-03-10 22:20:36,2015-03-10 20:47:14
070ca69f9a6ab1095296fa0e4c371164a389bab9...55e006dbf162a15263fc6d1deaebb6630246c572,1,1,1,2,1,2015-03-11 00:14:43,2015-03-11 00:14:43
55e006dbf162a15263fc6d1deaebb6630246c572...dc5573332f9e3ee23a47feb1fd5ef68aedf237bd,1,0,3,3,1,2015-03-11 00:31:19,2015-03-11 00:31:19
dc5573332f9e3ee23a47feb1fd5ef68aedf237bd...52d500e1236e554fa6573403929c79467413cc42,1,0,124,124,1,2015-03-11 03:54:22,2015-03-11 03:54:22
52d500e1236e554fa6573403929c79467413cc42...031237573a49acf03ecbe08ffffe6034a6c46bb0,2,8,0,8,3,2015-03-11 04:48:20,2015-03-11 04:48:20
031237573a49acf03ecbe08ffffe6034a6c46bb0...7ffc3a44b0f9d63ab23f528647f496d5a340c1a6,5,5,5,10,5,2015-03-11 05:00:24,2015-03-11 04:56:07
7ffc3a44b0f9d63ab23f528647f496d5a340c1a6...1b779a75458aca47290402a8e5c9fab61d62e150,1,5,4,9,4,2015-03-11 06:55:13,2015-03-11 06:55:13
1b779a75458aca47290402a8e5c9fab61d62e150...51b38a5a45c4999079079734ad28b2a46861e92e,1,13,1,14,2,2015-03-11 07:00:08,2015-03-11 07:00:08
51b38a5a45c4999079079734ad28b2a46861e92e...50de6f59f7fbd71b7263e1076562d35d79de7250,1,18,0,18,1,2015-03-11 17:30:54,2015-03-11 17:30:54
50de6f59f7fbd71b7263e1076562d35d79de7250...aca23adb7038db70266fb0a9cde2e16f266e1e51,4,28,9,37,10,2015-03-11 22:54:44,2015-03-11 22:51:49
aca23adb7038db70266fb0a9cde2e16f266e1e51...b652770229dc3edc8daacef041b9ab9aac5a0238,1,6,4,10,2,2015-03-11 23:30:57,2015-03-11 23:30:45
0011e00a7e0f14aa3e5f76e981461bcfea6de260...a34585b4b3a66df77cf2c5be18be9460d36fcd2e,5,5,0,5,5,2014-12-05 03:17:29,2014-12-05 03:17:29
a34585b4b3a66df77cf2c5be18be9460d36fcd2e...de183280831cf7b018f15c05423bc84d7d71548a,1,1,1,2,1,2014-12-05 03:22:10,2014-11-19 19:34:12
de183280831cf7b018f15c05423bc84d7d71548a...8c30bfbef482cf1a0e3933c6e895a97ba6e14089,1,0,1,1,1,2014-12-05 03:40:05,2014-12-05 03:40:05
8c30bfbef482cf1a0e3933c6e895a97ba6e14089...bf9b67e7568e44aaadb4ff09f031eee11ae81d59,1,1,1,2,1,2014-12-05 03:49:39,2014-11-22 18:00:33
bf9b67e7568e44aaadb4ff09f031eee11ae81d59...480d9634c6c57a994ea7f0447549ce5d5b705d3c,1,2,2,4,2,2014-12-05 03:50:34,2014-11-23 19:52:33
480d9634c6c57a994ea7f0447549ce5d5b705d3c...76745d27b26c2b706e7be00ee4955130e651e78c,1,3,0,3,1,2014-12-05 20:19:54,2014-12-05 20:19:15
76745d27b26c2b706e7be00ee4955130e651e78c...6493d6ae156d7092e09ba06825ae65b2a1e704c0,8,288,35,323,16,2014-12-05 21:16:57,2014-10-29 07:16:10
6493d6ae156d7092e09ba06825ae65b2a1e704c0...3e6f09f08b55143a3a7b40c700fc1e8e3b26170c,1,1,1,2,1,2014-12-05 23:31:39,2014-12-05 23:31:39
3e6f09f08b55143a3a7b40c700fc1e8e3b26170c...0cdc382a7210dca332c16c8ec20c9bfba9c61814,2,4,4,8,4,2014-12-05 23:32:57,2014-12-05 23:32:57
0cdc382a7210dca332c16c8ec20c9bfba9c61814...ea54ca9690210febc9c1ad1321559a2d30642cfb,1,3,1,4,3,2014-12-05 23:44:11,2014-12-05 23:43:37
ea54ca9690210febc9c1ad1321559a2d30642cfb...f41fecfe4b06a15a98b8e62ccd365f5d8d42b454,1,13,1,14,2,2014-12-06 00:00:23,2014-12-05 23:59:30
f41fecfe4b06a15a98b8e62ccd365f5d8d42b454...12820e0a5b1135c856798ac2844c79d9f3e45dd6,1,3,1,4,1,2014-12-06 00:04:51,2014-12-06 00:04:51
12820e0a5b1135c856798ac2844c79d9f3e45dd6...f927525dc8f0545852c0498a13e923c3445e551c,1,1,2,3,2,2014-12-06 00:11:01,2014-12-06 00:10:02
f927525dc8f0545852c0498a13e923c3445e551c...2d5979b27ef59aa01bebbac26ce4cb85b58a0257,1,1,1,2,1,2014-12-06 00:16:12,2014-12-06 00:16:12
2d5979b27ef59aa01bebbac26ce4cb85b58a0257...0e3e1a0e2d8ed793776151fa6c15070efc1f1f9f,1,1,1,2,1,2014-12-06 02:45:23,2014-12-06 02:45:23
0e3e1a0e2d8ed793776151fa6c15070efc1f1f9f...425ac62a1c206f10f98d73a91187cf9ea7324ea5,3,1,2,3,1,2014-12-06 02:50:10,2014-12-06 02:50:10
0011e00a7e0f14aa3e5f76e981461bcfea6de260...24a4ed9bdcfae8a049ea0c1bd02d27ce39d3f2cb,23,1373,890,2263,453,2014-12-05 01:56:04,2014-12-05 01:56:04
24a4ed9bdcfae8a049ea0c1bd02d27ce39d3f2cb...dd96477c51336b3971f65ae04fed122adb6428b1,1,21,39,60,14,2014-12-07 01:22:04,2014-12-07 01:22:04
dd96477c51336b3971f65ae04fed122adb6428b1...25dfd39ef13c125e3e4082ea01f4144bd223e473,7,35,31,66,26,2014-12-07 01:38:41,2014-12-07 01:38:41
25dfd39ef13c125e3e4082ea01f4144bd223e473...8bf5db2de081c2a2f36c232df50b9c088ac06436,6,12,15,27,11,2014-12-07 01:42:07,2014-12-07 01:42:07
8bf5db2de081c2a2f36c232df50b9c088ac06436...c9928d9c3a51ac855b5a4877085536801f773053,10,90,95,185,67,2014-12-07 02:32:40,2014-12-07 02:32:40
c9928d9c3a51ac855b5a4877085536801f773053...0b4cdc6e12cdfb6e4a7fa89d67795bc6425b4dd5,2,5,5,10,5,2014-12-07 02:42:36,2014-12-07 02:42:36
0b4cdc6e12cdfb6e4a7fa89d67795bc6425b4dd5...6bf699d5d9a9c662d05108ce56eeaeaad7febf82,3,3,3,6,3,2014-12-07 03:13:51,2014-12-07 03:13:51
6bf699d5d9a9c662d05108ce56eeaeaad7febf82...714ed749e72d31c6a98b94f27653d0814c69d2a0,1,8,2,10,1,2014-12-08 19:57:36,2014-12-08 19:57:36
714ed749e72d31c6a98b94f27653d0814c69d2a0...f4d9e5bff149eb02fbc182e9893d0dff9104ac8d,1,12,13,25,8,2014-12-08 21:57:24,2014-12-08 21:57:24
f4d9e5bff149eb02fbc182e9893d0dff9104ac8d...bcf6b200e1ab14c5aae62c3f7cd3349c42a027a4,3,29,19,48,17,2014-12-08 22:15:54,2014-12-08 22:15:54
bcf6b200e1ab14c5aae62c3f7cd3349c42a027a4...f3e3dc7bca29548b6d682a8bb0865ebce0fdceaf,4,9,10,19,8,2014-12-08 22:44:36,2014-12-08 22:44:36
f3e3dc7bca29548b6d682a8bb0865ebce0fdceaf...90859759137014b1475c6760343ddde0cfa7d103,1,9,5,14,2,2014-12-08 22:54:36,2014-12-08 22:54:36
90859759137014b1475c6760343ddde0cfa7d103...42b0d9247dbc088ccfc4eb703e2051f3107cba77,1,1,1,2,1,2014-12-09 02:30:52,2014-12-09 02:30:52
42b0d9247dbc088ccfc4eb703e2051f3107cba77...8d213d0cb02e214cd69e55954583a4e82c8dc4fe,2,10,18,28,5,2014-12-09 02:34:38,2014-12-09 02:34:38
8d213d0cb02e214cd69e55954583a4e82c8dc4fe...07ff83f2c92cd780dc18cb29e84aec114956f185,2,5,7,12,3,2014-12-09 02:37:49,2014-12-09 02:37:49
07ff83f2c92cd780dc18cb29e84aec114956f185...c8e2c9f9d9966a936138ab7edba79c9419207216,1,1,1,2,1,2014-12-09 02:44:28,2014-12-09 02:44:28
ab22135543a7e03f1636e4523423b6d9e0508cea...c2730e4ce6f0e94dcaa4f04859fc6ee3ceba0b5c,1,14,17,31,2,2014-10-28 16:55:18,2014-10-28 16:55:18
ef68e0968fffc768358e811365d865f0f0b17c17...0c576cd9169da52d8fb433cb7ef3d8ea975d04bb,1,42,0,42,2,2014-10-24 17:31:21,2014-10-24 17:31:21
0c576cd9169da52d8fb433cb7ef3d8ea975d04bb...29404ea07b7435756b336715d0571b16bd7cf652,1,6,4,10,2,2014-10-24 17:58:18,2014-10-24 17:58:18
29404ea07b7435756b336715d0571b16bd7cf652...3ebbbd775dd9d42cd381a7ee59a6e7dfdad3a649,1,14,9,23,4,2014-10-24 17:58:40,2014-10-24 17:58:40
3ebbbd775dd9d42cd381a7ee59a6e7dfdad3a649...e76dd6d869339b1bcea4558e8aaaf4d54c8a590b,1,20,20,40,2,2014-10-24 17:59:01,2014-10-24 17:59:01
e76dd6d869339b1bcea4558e8aaaf4d54c8a590b...4b8bda6ef0d2be3324bc4e1bdd68513f372a4d28,1,2,0,2,1,2014-10-24 18:01:17,2014-10-24 18:01:17
4b8bda6ef0d2be3324bc4e1bdd68513f372a4d28...a5bd166b5c633c3eaf579414bb3914db33bbdd50,1,1,1,2,1,2014-10-24 18:06:15,2014-10-24 18:06:15
a5bd166b5c633c3eaf579414bb3914db33bbdd50...ea5d9dffcda3b7e505ef049f17300d94f86a3e9a,1,20,20,40,2,2014-10-24 18:09:09,2014-10-24 18:09:09
ef68e0968fffc768358e811365d865f0f0b17c17...4ffeffd3c1c0b82c7b10c612e8512c23cae20c38,1,1,1,2,1,2014-10-24 17:17:52,2014-10-24 02:43:20
4ffeffd3c1c0b82c7b10c612e8512c23cae20c38...dffb80e37c41cc5a716f25b4f22ebdf66a526319,1,1,3,4,2,2014-10-24 17:22:35,2014-10-24 06:18:13
dffb80e37c41cc5a716f25b4f22ebdf66a526319...7ceb0a7e2a690ebeeb6a0efeb6f6e8d43c14f569,1,1,1,2,1,2014-10-24 17:24:20,2014-10-24 17:22:54
7ceb0a7e2a690ebeeb6a0efeb6f6e8d43c14f569...84e3b0d1a2201e3206e307b4f5831c06f9457df9,2,3,7,10,3,2014-10-24 18:31:23,2014-10-24 18:31:23
84e3b0d1a2201e3206e307b4f5831c06f9457df9...927388b3310f91c324844343d3585ece05be2f39,1,12,0,12,1,2014-10-24 18:52:28,2014-10-24 18:51:45
927388b3310f91c324844343d3585ece05be2f39...6c9335957ba0c6e24312c63323b45823a60e7cf7,1,1,1,2,1,2014-10-24 19:06:15,2014-10-24 19:06:15
6c9335957ba0c6e24312c63323b45823a60e7cf7...86f0572b0fd7fbf3137c987e64b3119525361015,1,3,4,7,2,2014-10-24 19:07:40,2014-10-24 19:07:21
86f0572b0fd7fbf3137c987e64b3119525361015...36d9b3d4aad85c35fb34d20e0363c2370aab8285,1,1,1,2,1,2014-10-24 19:20:23,2014-10-24 19:09:42
36d9b3d4aad85c35fb34d20e0363c2370aab8285...01fa9843ac71f5ecb8a9dfbdf06037b08bef00eb,1,51,0,51,5,2014-10-24 20:19:36,2014-10-24 20:19:36
01fa9843ac71f5ecb8a9dfbdf06037b08bef00eb...768812cf02adfc854297336a4ae7a778c71c5365,1,6,1,7,1,2014-10-24 20:21:34,2014-10-24 20:21:18
768812cf02adfc854297336a4ae7a778c71c5365...1ec5d85fd18ea71e9ac5ff3287a2290f26fdcb03,1,20,20,40,2,2014-10-24 20:28:22,2014-10-24 20:28:22
1ec5d85fd18ea71e9ac5ff3287a2290f26fdcb03...814877409923bbf135b9bc4e07817cbca6e3f1da,2,10,7,17,4,2014-10-24 21:01:21,2014-10-24 21:01:21
814877409923bbf135b9bc4e07817cbca6e3f1da...321f6b3ffc5b1bb34cf9b09c23a015401501ad99,1,1,1,2,1,2014-10-24 21:38:11,2014-10-24 21:38:11
321f6b3ffc5b1bb34cf9b09c23a015401501ad99...895820440a5d7fc6a6ba979dc890d681aacda67b,4,6,6,12,4,2014-10-24 22:16:58,2014-10-24 22:16:58
895820440a5d7fc6a6ba979dc890d681aacda67b...745eab52c475b2ad9c132fdac71f242e5c8c14b3,1,1,1,2,1,2014-10-24 22:44:01,2014-10-24 22:14:50
745eab52c475b2ad9c132fdac71f242e5c8c14b3...bfff82c0b4ae02ef104713f49585d25767de078a,1,5,8,13,5,2014-10-24 22:44:02,2014-10-24 22:43:50
eb33978b60ba6ebb170e5d5cf2c16fac0eec36d8...a4d5e95bb1439275ae898d83d61dab515c412e71,1,3,4,7,1,2015-03-09 20:36:23,2015-03-09 20:36:23
a4d5e95bb1439275ae898d83d61dab515c412e71...4dafb236affa5e571668a4b6cda558959cf1186d,1,2,2,4,2,2015-03-09 20:37:45,2015-03-09 20:37:45
4dafb236affa5e571668a4b6cda558959cf1186d...a6d4e984078fa9198a3c6d9fc0dc67792aa61ade,2,0,60,60,4,2015-03-09 20:39:44,2015-03-09 20:39:44
a6d4e984078fa9198a3c6d9fc0dc67792aa61ade...395f65859b19f8cbefa8b763c93a3b4eca384287,1,12,0,12,2,2015-03-09 20:40:26,2015-03-09 20:40:26
b652770229dc3edc8daacef041b9ab9aac5a0238...c6ea68f9b321a8012c5b9173e8bacfbcfec0ca27,6,29,5,34,8,2015-03-13 00:57:27,2015-03-12 01:21:19
c6ea68f9b321a8012c5b9173e8bacfbcfec0ca27...d770d813997cdc179daed74e28e422c2dc737298,6,6,6,12,6,2015-03-13 01:03:11,2015-03-13 00:59:44
d770d813997cdc179daed74e28e422c2dc737298...d591a288e188747a7bcbb36af41619ce27eede5b,1,7,1,8,1,2015-03-14 01:49:30,2015-03-14 01:49:30
d591a288e188747a7bcbb36af41619ce27eede5b...1d8e5f7a4ec5b8b51333eccfc58e36d1bad3a241,2,2,2,4,2,2015-03-16 19:31:50,2015-03-16 19:31:50
1d8e5f7a4ec5b8b51333eccfc58e36d1bad3a241...04228e06c0fd510f6d959dd512a478a20eef228f,2,23,2,25,18,2015-03-17 17:28:32,2015-03-17 17:28:32
b652770229dc3edc8daacef041b9ab9aac5a0238...8476491cce7fa0aabc998839579686604ac4c317,2,18,4,22,3,2015-03-12 02:07:13,2015-03-12 01:21:19
8476491cce7fa0aabc998839579686604ac4c317...075efa68a3e23ea6e7f5a8f2aeee47dcf5889a15,1,7,0,7,1,2015-03-12 02:13:15,2015-03-12 02:13:15
075efa68a3e23ea6e7f5a8f2aeee47dcf5889a15...28ad1bedf0845299b3e98e2f0349aff11598cb10,2,2,2,4,2,2015-03-12 17:36:05,2015-03-12 17:36:05
28ad1bedf0845299b3e98e2f0349aff11598cb10...01b1207e5de0db8f3bba551b153bce8b32c9de83,2,8,7,15,2,2015-03-12 23:26:11,2015-03-12 23:26:11
01b1207e5de0db8f3bba551b153bce8b32c9de83...5d813f45c41384c82b9c85b9a7a62ea16b62f793,1,3,0,3,1,2015-03-12 23:33:09,2015-03-12 23:33:09
5d813f45c41384c82b9c85b9a7a62ea16b62f793...1cb0644e18d86de6282c9b9e419ae8709928ca46,1,3,4,7,2,2015-03-13 00:56:14,2015-03-13 00:56:14
425ac62a1c206f10f98d73a91187cf9ea7324ea5...fda7524ff866ceb9bd4e1e8f15fa9dae25777859,1,4,0,4,1,2014-12-07 21:08:04,2014-10-20 20:30:39
fda7524ff866ceb9bd4e1e8f15fa9dae25777859...d6fd5c21bcce443bf72e039c94eaa01fa7ebfaf7,3,10,3,13,4,2014-12-07 21:30:38,2014-12-07 21:30:38
425ac62a1c206f10f98d73a91187cf9ea7324ea5...621262911e23ddbd10af85f65cef1f15c8cf89f8,3,37,10,47,3,2014-12-07 01:18:29,2014-12-06 01:59:54
621262911e23ddbd10af85f65cef1f15c8cf89f8...c4176547b6dfce0c29f9b29c25dbb52b535a5738,1,1,1,2,1,2014-12-07 01:18:29,2014-12-07 01:16:46
c2730e4ce6f0e94dcaa4f04859fc6ee3ceba0b5c...3b6f3ce681caa84fed4cf1c1255e88082b1814da,3,19,18,37,15,2014-10-28 17:12:51,2014-10-28 17:12:51
c2730e4ce6f0e94dcaa4f04859fc6ee3ceba0b5c...3dbad553b5b1bd4952258f78cccbaa2e221c645f,1,7,0,7,2,2014-10-28 17:03:29,2014-10-28 17:03:00
bfff82c0b4ae02ef104713f49585d25767de078a...15960d1f7842fc6545c0954b45252273585472ea,1,23,2,25,2,2014-10-24 23:14:45,2014-10-24 23:13:06
15960d1f7842fc6545c0954b45252273585472ea...060bde403a151b832a193fbbf7fb67ddbfeab47d,2,2,1,3,2,2014-10-25 22:15:37,2014-10-25 22:15:37
060bde403a151b832a193fbbf7fb67ddbfeab47d...70bcf8e0637e08ae0610f45d38d5281b0dca1208,1,12,13,25,2,2014-10-25 22:54:37,2014-10-25 22:54:16
70bcf8e0637e08ae0610f45d38d5281b0dca1208...402510d276fe57cfe5880c6a071706191b4bd5e5,1,1,1,2,1,2014-10-25 23:57:35,2014-10-25 23:57:35
bfff82c0b4ae02ef104713f49585d25767de078a...d40ec7cafe0d21bcb172132070d1e90850a41b3d,1,21,2,23,2,2014-10-24 23:10:46,2014-10-24 23:01:54
d98733eee6e40c06b23781eb1533a3d83bc6838c...590af5e8c26b0b001c6eb5b4de1a4ba5af089920,5,8,61,69,12,2015-03-09 22:10:50,2015-03-09 21:33:08
590af5e8c26b0b001c6eb5b4de1a4ba5af089920...4c6c1d71ff6a63f38b6195614a3db88481013937,1,17,11,28,4,2015-03-09 23:15:19,2015-03-01 23:53:18
4c6c1d71ff6a63f38b6195614a3db88481013937...2ecbb5b96df885d7512fac8105772f642c383fa0,1,0,15,15,8,2015-03-10 03:30:43,2015-03-10 03:30:43
2ecbb5b96df885d7512fac8105772f642c383fa0...da159885f4f90cb78bbf0cae655656df4f184ad5,3,136,51,187,36,2015-03-10 03:49:59,2015-03-10 03:47:42
da159885f4f90cb78bbf0cae655656df4f184ad5...f207371bc07b1238da2ebf0dc1aa1b892088bc74,2,9,16,25,8,2015-03-10 05:31:49,2015-03-10 05:31:49
04228e06c0fd510f6d959dd512a478a20eef228f...efdfe62331b8d83490820f2a9b2a9aa91fb47f70,3,12,5,17,3,2015-03-17 17:56:33,2015-03-17 17:55:02
27af08c78b592cc79205c1edd9b73d06a8e0cb67...3aadefa71d2f8a6e6d30d627a253c3c73c80d2de,4,5,4,9,4,2014-12-08 22:01:03,2014-12-08 22:01:03
c4176547b6dfce0c29f9b29c25dbb52b535a5738...815296e94f65a00190ce15b083b89c250bf57bf2,1,65,42,107,16,2014-12-08 00:34:27,2014-12-08 00:34:27
815296e94f65a00190ce15b083b89c250bf57bf2...76a18323551f49e02a6fdbc49961c504fcda734d,2,66,57,123,18,2014-12-08 01:00:36,2014-12-08 01:00:36
76a18323551f49e02a6fdbc49961c504fcda734d...292878ba6b5d49cb7afdaf967812d8c040736940,1,7,9,16,3,2014-12-08 18:43:04,2014-12-08 18:43:04
292878ba6b5d49cb7afdaf967812d8c040736940...14795c897bd5184431dd9377138a216e52abdb49,1,4,0,4,1,2014-12-08 18:51:39,2014-12-08 18:51:39
c4176547b6dfce0c29f9b29c25dbb52b535a5738...24d8fec98f4999dc954f19519f174dffba785e50,2,4,1,5,2,2014-12-07 17:34:45,2014-12-07 17:34:45
24d8fec98f4999dc954f19519f174dffba785e50...ac55f3c3d6f9ec1b8b598d4d4b5543f3c3fd38dd,1,65,42,107,16,2014-12-08 18:55:41,2014-12-08 00:34:27
ac55f3c3d6f9ec1b8b598d4d4b5543f3c3fd38dd...a4a29b87a16351c59426951085a8ebaf70548489,2,66,57,123,18,2014-12-08 18:55:41,2014-12-08 01:00:36
a4a29b87a16351c59426951085a8ebaf70548489...398f6e0a12587bdf43fa70a86b3c25bebbf32b47,1,7,9,16,3,2014-12-08 18:55:41,2014-12-08 18:43:04
398f6e0a12587bdf43fa70a86b3c25bebbf32b47...c4584074409062881e9a5bd92afb3c850537b211,1,4,0,4,1,2014-12-08 18:55:41,2014-12-08 18:51:39
c4176547b6dfce0c29f9b29c25dbb52b535a5738...5b88474e0cd7df44c436723fabe2fbdb4afd15f1,1,2,2,4,2,2014-12-07 17:31:09,2014-12-07 17:31:09
d74c291b997df0bf4661d568f0caabdf958adcce...b033a151bd4dfe69993ea0171a9ab1b8b3be47dd,2,2,2,4,2,2014-10-28 17:14:54,2014-10-28 17:14:54
3dbad553b5b1bd4952258f78cccbaa2e221c645f...5103fbe197c529ca431dee5bfdcf1c09a4fff91b,1,3,0,3,1,2014-10-28 17:12:23,2014-10-28 17:11:51
402510d276fe57cfe5880c6a071706191b4bd5e5...b0d47e10bc6a2c36a339da65a9b888e3df9d8133,1,6,0,6,1,2014-10-26 17:50:41,2014-10-26 17:50:41
b0d47e10bc6a2c36a339da65a9b888e3df9d8133...dd8bc66dcbeb9018e6635b10809f74254a96a3d7,2,23,8,31,3,2014-10-27 16:25:19,2014-10-27 16:06:41
dd8bc66dcbeb9018e6635b10809f74254a96a3d7...9144eec671111811a2d28bea9511f62c499cfd93,1,2,5,7,3,2014-10-27 16:25:19,2014-10-27 16:24:35
9144eec671111811a2d28bea9511f62c499cfd93...3ea18e092b074f231e3c8a43296e1f41b0daa1c9,1,2,0,2,2,2014-10-27 16:25:19,2014-10-27 16:25:06
402510d276fe57cfe5880c6a071706191b4bd5e5...82a08333b5d89909dcb8607fe93aec89ab013e45,3,14,3,17,7,2014-10-26 15:53:17,2014-10-26 15:47:48
ebe7c1a08b1310501a068d3cf212a2235f44cae4...cfb21f43e50796316b39ce5433e3aab3c02712e8,23,4097,4039,8136,24,2015-03-17 18:18:57,2015-03-17 17:56:08
cfb21f43e50796316b39ce5433e3aab3c02712e8...1717573f01599134fa70f00a596af96e5338c9f8,8,391,0,391,18,2015-03-17 19:06:10,2015-03-17 18:48:22
1717573f01599134fa70f00a596af96e5338c9f8...8409919bb6845b145b1c43cf314f3dd8c759d693,1,1,0,1,1,2015-03-17 19:14:16,2015-03-17 19:14:16
8409919bb6845b145b1c43cf314f3dd8c759d693...ff8b47abb03a49c4e34fbaba97ec2d7c4cc63409,1,3,9,12,2,2015-03-17 19:17:28,2015-03-17 19:17:28
ff8b47abb03a49c4e34fbaba97ec2d7c4cc63409...616649d49274506123d21f7acdfbbf5755ddff44,3,3,3,6,3,2015-03-17 19:22:32,2015-03-17 19:22:32
616649d49274506123d21f7acdfbbf5755ddff44...bc4392ed54b2bebbb809bd57b3cd505b83d94dd5,1,6,3,9,1,2015-03-17 20:01:43,2015-03-17 20:01:43
bc4392ed54b2bebbb809bd57b3cd505b83d94dd5...765aef5e3562d0121d2ccd9553878d36fb4e5e16,1,1,1,2,1,2015-03-17 20:01:56,2015-03-17 20:01:56
765aef5e3562d0121d2ccd9553878d36fb4e5e16...4daaa76b1291f8331cb727610d4aa79eae64b31e,117,117,118,235,117,2015-03-17 20:06:07,2015-03-17 20:05:06
c4584074409062881e9a5bd92afb3c850537b211...c9fdcaa6736b12980f3a01339baca32c33f1ba67,2,45,25,70,3,2014-12-08 21:22:35,2014-12-08 21:22:07
b033a151bd4dfe69993ea0171a9ab1b8b3be47dd...2248a0174a67f6762d3c14fe84a32ce4e8e390f1,5,18,11,29,8,2014-10-28 17:34:59,2014-10-28 17:33:53
7a58387defff2edbb9bdc70f77cf29c348370ee8...cd0b347b86eeb27e1ceaf0361486fc2e42197c05,4,41,5,46,8,2014-10-28 23:27:01,2014-10-28 23:27:01
3ea18e092b074f231e3c8a43296e1f41b0daa1c9...1af84bf437018220f127505e8de3f2e33cf7d43e,1,1,1,2,1,2014-10-27 19:03:23,2014-10-27 19:03:23
1af84bf437018220f127505e8de3f2e33cf7d43e...180ef5408a442afabcd20ea457042628b2c607a7,5,62,439,501,27,2014-10-27 19:57:16,2014-10-27 19:56:12
180ef5408a442afabcd20ea457042628b2c607a7...5cab3e975d8e6d44bef8951fd43e1e450f5352c5,1,3,0,3,1,2014-10-27 20:15:49,2014-10-27 20:15:49
5cab3e975d8e6d44bef8951fd43e1e450f5352c5...89971d6205dfbe1d8620b88868fb8c65784daaf5,4,60,5,65,5,2014-10-28 00:11:50,2014-10-27 18:23:57
89971d6205dfbe1d8620b88868fb8c65784daaf5...9cdbe37cb95b29128f31dd7963a18fb359964050,1,11,5,16,4,2014-10-28 00:37:19,2014-10-28 00:37:19
9cdbe37cb95b29128f31dd7963a18fb359964050...971427c4f7c9600afe1cd3f4b666a81f60071fb4,3,33,4,37,5,2014-10-28 01:00:16,2014-10-28 01:00:16
971427c4f7c9600afe1cd3f4b666a81f60071fb4...54ac7cf953c7dd6e39f815c2df69f00a9ece41ca,1,5,1,6,1,2014-10-28 01:03:25,2014-10-28 01:03:25
54ac7cf953c7dd6e39f815c2df69f00a9ece41ca...dd5cf68ab19bc05c1d0655c0d31bd2ad5560b4cd,1,18,7,25,5,2014-10-28 01:35:26,2014-10-28 01:35:26
dd5cf68ab19bc05c1d0655c0d31bd2ad5560b4cd...10fc6ec6207436a162d6c1ce3fa663865d3a7ec6,1,3,1,4,1,2014-10-28 02:26:34,2014-10-28 02:26:34
10fc6ec6207436a162d6c1ce3fa663865d3a7ec6...925a1fd79a6fbbfc1ecf078396fae73bc2a57005,1,2,12,14,3,2014-10-28 04:11:07,2014-10-28 04:11:01
925a1fd79a6fbbfc1ecf078396fae73bc2a57005...4cc2361cdf992cbae84810ef1bb8b0568b38bbbc,1,1,1,2,1,2014-10-28 04:23:36,2014-10-28 04:23:36
4cc2361cdf992cbae84810ef1bb8b0568b38bbbc...b2129ba561617f04aac2c1f11ce0c7e0c96e1388,1,1,1,2,1,2014-10-28 04:35:49,2014-10-28 04:35:49
b2129ba561617f04aac2c1f11ce0c7e0c96e1388...848180b0f78f7c50228b1c5d007956734c782fc5,233,5538,0,5538,93,2014-10-28 04:55:09,2014-10-28 04:55:09
848180b0f78f7c50228b1c5d007956734c782fc5...0aff67aef2f65cd670a3815f3b8f8d649d9a04e3,1,3,0,3,1,2014-10-28 04:57:41,2014-10-28 04:57:32
0aff67aef2f65cd670a3815f3b8f8d649d9a04e3...dd4dbf6d4062ebcd6891d8f48cd555ada3238b92,27,0,0,0,0,2014-10-28 05:00:26,2014-10-28 05:00:26
dd4dbf6d4062ebcd6891d8f48cd555ada3238b92...f9ef2cf69f88c013dd17ef879d50901d9178070f,2,27,0,27,3,2014-10-28 06:36:17,2014-10-28 06:36:17
f9ef2cf69f88c013dd17ef879d50901d9178070f...999fab8dc6d14fdabb751b5d30ec5a0bdc1ae02c,1,6,0,6,6,2014-10-28 06:59:50,2014-10-28 06:59:44
999fab8dc6d14fdabb751b5d30ec5a0bdc1ae02c...171916dbddf3b18f51a6706ae23fd025b07bb174,1,13,0,13,3,2014-10-28 07:08:05,2014-10-28 07:08:05
171916dbddf3b18f51a6706ae23fd025b07bb174...dc008d231650801cc0d4becf223cda4af61d061d,6,168,79,247,23,2014-10-28 09:28:35,2014-10-16 22:28:43
dc008d231650801cc0d4becf223cda4af61d061d...a629c465437b51b9a179dda73125a540dd984637,46,1811,408,2219,42,2014-10-28 09:28:35,2014-10-23 06:49:25
a629c465437b51b9a179dda73125a540dd984637...c41269161bfaf1cf600cef187cf594e56ce2ae00,31,60,40,100,15,2014-10-28 09:28:35,2014-10-23 17:50:57
c41269161bfaf1cf600cef187cf594e56ce2ae00...ad65820088d21a8f413abdc2cc2212d124a869d0,2,33,13,46,7,2014-10-28 09:28:35,2014-10-23 18:00:01
ad65820088d21a8f413abdc2cc2212d124a869d0...c65a13f330c57f997e9e0f7d0b1bbb6738930f56,2,36,9,45,14,2014-10-28 09:28:35,2014-10-23 18:26:44
c65a13f330c57f997e9e0f7d0b1bbb6738930f56...898ed0c7779ba3d3346456d7723ea4461a34d22c,13,54,97,151,24,2014-10-28 09:28:35,2014-10-23 20:39:12
898ed0c7779ba3d3346456d7723ea4461a34d22c...a54b64a1377bac950d98574d32229a9223b2ce61,5,211,159,370,84,2014-10-28 09:28:35,2014-10-24 22:16:06
a54b64a1377bac950d98574d32229a9223b2ce61...e7a4ae626892b9ea3d4fe45d2966902ca1ba13b7,8,49,44,93,24,2014-10-28 09:28:35,2014-10-25 00:53:24
e7a4ae626892b9ea3d4fe45d2966902ca1ba13b7...bf575edb1d2c3994ebeac169896a0d2489d06460,2,25,17,42,10,2014-10-28 09:28:35,2014-10-25 01:55:48
bf575edb1d2c3994ebeac169896a0d2489d06460...c15b2bb718664ec4d4bee52ae9b5db852a5fc9a8,3,11,2,13,3,2014-10-28 09:28:36,2014-10-25 02:01:00
c15b2bb718664ec4d4bee52ae9b5db852a5fc9a8...c5e2d6bf18391d68f3e8ef989339c494021a3930,1,2,1,3,2,2014-10-28 09:28:36,2014-10-25 02:15:26
c5e2d6bf18391d68f3e8ef989339c494021a3930...57c4d46b8ef3dcc0c1770db9047dd278bc866958,1,2,2,4,2,2014-10-28 09:28:36,2014-10-27 01:30:51
57c4d46b8ef3dcc0c1770db9047dd278bc866958...7a124f7ccb0dfb157baf33dd5a15e7b3764827a4,6,23,19,42,16,2014-10-28 09:28:36,2014-10-27 02:25:16
7a124f7ccb0dfb157baf33dd5a15e7b3764827a4...12a0aab5717195a13aabcad2d74230ea866bf829,1,3,3,6,1,2014-10-28 09:28:36,2014-10-27 04:52:10
12a0aab5717195a13aabcad2d74230ea866bf829...e7c4175676733bc5ac9b7e3ab7ad07d86a379a73,2,10,0,10,2,2014-10-28 09:28:36,2014-10-27 04:55:29
e7c4175676733bc5ac9b7e3ab7ad07d86a379a73...cae3e72c6dca33453f67f4ef5fdbc7b3f9a22268,4,13,6,19,5,2014-10-28 09:28:36,2014-10-27 05:01:32
cae3e72c6dca33453f67f4ef5fdbc7b3f9a22268...15b705d59c681a7374030c61a18b47e733597374,4,130,6,136,6,2014-10-28 09:28:36,2014-10-27 08:10:28
15b705d59c681a7374030c61a18b47e733597374...cc3f54956ad13c958e5f8906fbe23a94f360f75e,2,25,21,46,13,2014-10-28 09:28:36,2014-10-27 16:44:17
cc3f54956ad13c958e5f8906fbe23a94f360f75e...13d564be5f9733c2cdb4cc7bc71590ddee49602b,7,47,11,58,12,2014-10-28 09:28:36,2014-10-27 17:17:08
13d564be5f9733c2cdb4cc7bc71590ddee49602b...46835995553802c3eacb4422f70022f016c75c68,5,21,70,91,8,2014-10-28 09:28:36,2014-10-27 17:31:29
46835995553802c3eacb4422f70022f016c75c68...436d3b6c975bb14f11d83688558f04b2d5f5a49b,7,22,13,35,13,2014-10-28 09:28:36,2014-10-27 17:54:08
436d3b6c975bb14f11d83688558f04b2d5f5a49b...4fa507539f473474bb0ea77a9a2d803d43c9cedd,3,29,3,32,4,2014-10-28 09:28:36,2014-10-27 18:01:41
4fa507539f473474bb0ea77a9a2d803d43c9cedd...7a4fa50b033004cf2fb53969d196c014ba26dfe7,3,15,12,27,3,2014-10-28 09:28:36,2014-10-27 18:42:38
7a4fa50b033004cf2fb53969d196c014ba26dfe7...924d30deb364cb3eced8341688b299158c93e5cd,1,1,1,2,1,2014-10-28 09:28:36,2014-10-27 18:55:02
924d30deb364cb3eced8341688b299158c93e5cd...79a71975dd461f19170f8249ec6c27a784b3dc40,4,57,34,91,18,2014-10-28 09:28:37,2014-10-27 19:32:03
79a71975dd461f19170f8249ec6c27a784b3dc40...ccd8a5590044b9b1ffd9f967be2a503ee2f4a00d,1,8,1,9,1,2014-10-28 09:28:37,2014-10-27 19:31:51
ccd8a5590044b9b1ffd9f967be2a503ee2f4a00d...a7a18ea1b5057540c41e7e5632c6fa75bf9e4945,4,94,69,163,34,2014-10-28 09:28:37,2014-10-27 20:03:31
a7a18ea1b5057540c41e7e5632c6fa75bf9e4945...41fa4e651b26a8bb959ef55dabf485be337a29da,2,4,2,6,3,2014-10-28 09:28:37,2014-10-27 20:22:44
41fa4e651b26a8bb959ef55dabf485be337a29da...89a069dceeea3f22d0e4a201e383b0729ad3a787,1,1,2,3,2,2014-10-28 09:28:37,2014-10-27 20:42:02
89a069dceeea3f22d0e4a201e383b0729ad3a787...fc47ee66adfa88cf7931e34ad924f5471139414a,3,18,12,30,6,2014-10-28 09:28:37,2014-10-27 21:00:47
fc47ee66adfa88cf7931e34ad924f5471139414a...b6132e9b23c2fefab83b39aea0a780b80af13b23,2,45,20,65,3,2014-10-28 09:28:37,2014-10-27 21:24:01
b6132e9b23c2fefab83b39aea0a780b80af13b23...7050ce68938a8185a4d1e898dc32324ed8fbda05,2,7,7,14,6,2014-10-28 09:28:37,2014-10-27 22:01:42
7050ce68938a8185a4d1e898dc32324ed8fbda05...8f3ac8fb590516ef8fd4dfebff972c312942c829,3,44,1,45,3,2014-10-28 09:28:37,2014-10-27 05:55:23
8f3ac8fb590516ef8fd4dfebff972c312942c829...aa1fa4449fe27eb6cc92d629c44a5b03490e4208,1,1,1,2,1,2014-10-28 09:28:37,2014-10-27 22:10:46
aa1fa4449fe27eb6cc92d629c44a5b03490e4208...090b4d16d5c7ff87e7ea3dd07bcda9c6fcc0d9c3,2,69,40,109,2,2014-10-28 09:28:37,2014-10-27 23:55:16
090b4d16d5c7ff87e7ea3dd07bcda9c6fcc0d9c3...0865fa732bb6b5030bb210269654f3288ab2bb7a,3,11,16,27,12,2014-10-28 09:28:37,2014-10-28 00:15:32
0865fa732bb6b5030bb210269654f3288ab2bb7a...ba51494e1d7d65927f2d31d1fd2db21d0126a37a,2,7,5,12,2,2014-10-28 09:28:37,2014-10-28 00:16:36
ba51494e1d7d65927f2d31d1fd2db21d0126a37a...2221234c2826d2f2a0d896767d52d56542ddf125,3,50,2,52,3,2014-10-28 09:28:37,2014-10-28 00:37:25
2221234c2826d2f2a0d896767d52d56542ddf125...2e2bc6648e308b0c6726b5df1fd6f216d153c22f,1,6,2,8,1,2014-10-28 09:28:37,2014-10-28 00:49:19
2e2bc6648e308b0c6726b5df1fd6f216d153c22f...8ccf52ab78d654fbdd2ee175b54484362f934297,3,51,2,53,4,2014-10-28 09:28:37,2014-10-28 00:56:55
8ccf52ab78d654fbdd2ee175b54484362f934297...b5038e7253f014e80f8264cf86224d6da4332bbb,1,7,7,14,2,2014-10-28 09:28:38,2014-10-28 01:47:39
b5038e7253f014e80f8264cf86224d6da4332bbb...f38321a33780e6329e90a9bc0b66625c0b02ef8f,2,3,3,6,3,2014-10-28 09:28:38,2014-10-28 01:49:10
3ea18e092b074f231e3c8a43296e1f41b0daa1c9...538307832b8c694c39fc40fced8925238e535d2c,4,38,3,41,5,2014-10-27 18:23:57,2014-10-27 18:23:57
538307832b8c694c39fc40fced8925238e535d2c...796d778965a51e56675be65e582a6b79cabc95aa,1,12,5,17,1,2014-10-27 18:36:20,2014-10-27 18:36:20
796d778965a51e56675be65e582a6b79cabc95aa...0932dae211c25ab049e4ce38082dc511477f6481,1,2,3,5,2,2014-10-27 20:26:02,2014-10-27 20:26:02
0932dae211c25ab049e4ce38082dc511477f6481...40bfdd7d0d78e036b2b2deead97d23260ee9604d,1,1,3,4,1,2014-10-27 20:26:13,2014-10-27 20:26:13
40bfdd7d0d78e036b2b2deead97d23260ee9604d...6fcbf0475b4747d147947da33030cd6ff09615cc,1,29,19,48,3,2014-10-27 21:58:26,2014-10-27 21:56:56
6fcbf0475b4747d147947da33030cd6ff09615cc...5cef37bef6c271099af18b95f2594588f24cb8fa,1,13,1,14,4,2014-10-27 22:02:12,2014-10-27 22:02:12
5cef37bef6c271099af18b95f2594588f24cb8fa...323acd58a18abbdd31e5fa01c4a00a98a2bb379b,1,2,2,4,1,2014-10-27 22:39:13,2014-10-27 22:39:13
323acd58a18abbdd31e5fa01c4a00a98a2bb379b...2ca59940c3601fd1070b3b716e41b8ab74823e5e,6,62,10,72,9,2014-10-27 22:40:31,2014-10-27 22:32:24
2ca59940c3601fd1070b3b716e41b8ab74823e5e...c12b84ac63420b8d68d67927710fe153e22873a1,1,1,1,2,1,2014-10-27 22:40:31,2014-10-27 22:34:06
c12b84ac63420b8d68d67927710fe153e22873a1...e614edada8d4c45110bc4cfd0d94df782fa8ca80,1,1,1,2,1,2014-10-27 22:40:31,2014-10-27 22:35:58
e614edada8d4c45110bc4cfd0d94df782fa8ca80...459e6227c3c7ef641359bf492c341cc127a4fe9b,1,1,1,2,1,2014-10-27 22:54:53,2014-10-27 22:54:53
4daaa76b1291f8331cb727610d4aa79eae64b31e...e95cc580316b94e2969e522921bb6b7b6c347de6,1,2,1,3,2,2015-03-18 07:26:38,2015-03-12 19:46:46
e95cc580316b94e2969e522921bb6b7b6c347de6...92ba69e860e10717d31d3d4239145c29b1d6a113,3,9,2,11,3,2015-03-18 07:29:35,2015-03-18 07:29:35
92ba69e860e10717d31d3d4239145c29b1d6a113...2f1ee9f9fb25d9f8f708372e086149560939cb00,1,7,1,8,1,2015-03-18 07:35:23,2015-03-18 07:35:23
2f1ee9f9fb25d9f8f708372e086149560939cb00...722242dd891d5defb7ddce2984bcb2ebfbdb86b8,1,1,1,2,1,2015-03-18 07:48:06,2015-03-18 07:48:06
4daaa76b1291f8331cb727610d4aa79eae64b31e...e84f5d7c74269c75d664cb662ec966477c2849b3,11,271,271,542,18,2015-03-17 20:31:29,2015-03-17 20:31:09
2248a0174a67f6762d3c14fe84a32ce4e8e390f1...e5ba6630e61990e0fa6141d34924aef43f66df80,1,2,0,2,1,2014-11-03 19:16:09,2014-11-03 19:16:09
e5ba6630e61990e0fa6141d34924aef43f66df80...e83b9716a48af89bbd25c16f4a30b1b90a1e8d96,1,9,0,9,4,2014-11-03 19:20:09,2014-11-03 19:20:09
d75e70b0d64779c25505e2d7d81a474321f74ea8...865fdce33cade03eba2975c474908483de52e588,6,6,6,12,6,2015-03-18 07:53:26,2015-03-18 07:53:26
e84f5d7c74269c75d664cb662ec966477c2849b3...7bf8665163253a049c05828440f7f452862d8f36,1,1,1,2,1,2015-03-17 20:33:27,2015-03-17 20:33:27
